縣市,鄉鎮市區,開票所,同意票,不同意票,有效票,無效票,投票數,投票權人數,投票率,投票權人數百分比,總數
臺北市,松山區,0527,702,172,874,49,923,1583,58.31%,44.35%,1
臺北市,松山區,0528,712,197,909,72,981,1691,58.01%,42.11%,1
臺北市,松山區,0529,605,146,751,42,793,1386,57.22%,43.65%,1
臺北市,松山區,0530,575,191,766,60,826,1362,60.65%,42.22%,1
臺北市,松山區,0531,594,194,788,54,842,1399,60.19%,42.46%,1
臺北市,松山區,0532,552,201,753,52,805,1324,60.8%,41.69%,1
臺北市,松山區,0533,560,213,773,57,830,1296,64.04%,43.21%,1
臺北市,松山區,0534,587,214,801,49,850,1386,61.33%,42.35%,1
臺北市,松山區,0535,674,228,902,77,979,1529,64.03%,44.08%,1
臺北市,松山區,0536,619,160,779,38,817,1416,57.7%,43.71%,1
臺北市,松山區,0537,648,194,842,64,906,1619,55.96%,40.02%,1
臺北市,松山區,0538,579,202,781,57,838,1386,60.46%,41.77%,1
臺北市,松山區,0539,646,196,842,47,889,1380,64.42%,46.81%,1
臺北市,松山區,0540,579,188,767,45,812,1357,59.84%,42.67%,1
臺北市,松山區,0541,608,157,765,52,817,1296,63.04%,46.91%,1
臺北市,松山區,0542,727,180,907,74,981,1632,60.11%,44.55%,1
臺北市,松山區,0543,597,181,778,45,823,1414,58.2%,42.22%,1
臺北市,松山區,0544,594,202,796,51,847,1404,60.33%,42.31%,1
臺北市,松山區,0545,615,160,775,74,849,1365,62.2%,45.05%,1
臺北市,松山區,0546,595,199,794,67,861,1431,60.17%,41.58%,1
臺北市,松山區,0547,621,217,838,64,902,1483,60.82%,41.87%,1
臺北市,松山區,0548,596,165,761,51,812,1293,62.8%,46.09%,1
臺北市,松山區,0549,601,155,756,49,805,1410,57.09%,42.62%,1
臺北市,松山區,0550,582,164,746,46,792,1307,60.6%,44.53%,1
臺北市,松山區,0551,531,201,732,55,787,1242,63.37%,42.75%,1
臺北市,松山區,0552,537,164,701,27,728,1192,61.07%,45.05%,1
臺北市,松山區,0553,562,181,743,55,798,1276,62.54%,44.04%,1
臺北市,松山區,0554,492,175,667,31,698,1201,58.12%,40.97%,1
臺北市,松山區,0555,573,174,747,45,792,1318,60.09%,43.47%,1
臺北市,松山區,0556,509,173,682,41,723,1157,62.49%,43.99%,1
臺北市,松山區,0557,465,182,647,13,660,1157,57.04%,40.19%,1
臺北市,松山區,0558,621,156,777,56,833,1357,61.39%,45.76%,1
臺北市,松山區,0559,451,132,583,32,615,1215,50.62%,37.12%,1
臺北市,松山區,0560,559,186,745,34,779,1345,57.92%,41.56%,1
臺北市,松山區,0561,531,176,707,41,748,1237,60.47%,42.93%,1
臺北市,松山區,0562,718,134,852,32,884,1393,63.46%,51.54%,1
臺北市,松山區,0563,603,205,808,47,855,1331,64.24%,45.3%,1
臺北市,松山區,0564,715,204,919,55,974,1550,62.84%,46.13%,1
臺北市,松山區,0565,612,115,727,15,742,1308,56.73%,46.79%,1
臺北市,松山區,0566,714,115,829,45,874,1490,58.66%,47.92%,1
臺北市,松山區,0567,672,175,847,45,892,1406,63.44%,47.8%,1
臺北市,松山區,0568,537,190,727,41,768,1191,64.48%,45.09%,1
臺北市,松山區,0569,453,167,620,37,657,1095,60%,41.37%,1
臺北市,松山區,0570,494,168,662,44,706,1198,58.93%,41.24%,1
臺北市,松山區,0571,545,152,697,48,745,1265,58.89%,43.08%,1
臺北市,松山區,0572,513,162,675,44,719,1225,58.69%,41.88%,1
臺北市,松山區,0573,752,246,998,52,1050,1698,61.84%,44.29%,1
臺北市,松山區,0574,777,205,982,56,1038,1819,57.06%,42.72%,1
臺北市,松山區,0575,766,233,999,61,1060,1754,60.43%,43.67%,1
臺北市,松山區,0576,586,221,807,38,845,1361,62.09%,43.06%,1
臺北市,松山區,0577,553,151,704,28,732,1189,61.56%,46.51%,1
臺北市,松山區,0578,515,180,695,51,746,1214,61.45%,42.42%,1
臺北市,松山區,0579,544,157,701,61,762,1284,59.35%,42.37%,1
臺北市,松山區,0580,574,178,752,49,801,1297,61.76%,44.26%,1
臺北市,松山區,0581,527,194,721,33,754,1330,56.69%,39.62%,1
臺北市,松山區,0582,655,155,810,54,864,1396,61.89%,46.92%,1
臺北市,松山區,0583,647,149,796,27,823,1480,55.61%,43.72%,1
臺北市,松山區,0584,650,178,828,34,862,1419,60.75%,45.81%,1
臺北市,松山區,0585,615,171,786,58,844,1390,60.72%,44.24%,1
臺北市,松山區,0586,664,202,866,47,913,1525,59.87%,43.54%,1
臺北市,松山區,0587,663,199,862,39,901,1633,55.17%,40.6%,1
臺北市,松山區,0588,625,216,841,49,890,2677,33.25%,23.35%,1
臺北市,松山區,0589,530,183,713,62,775,1281,60.5%,41.37%,1
臺北市,松山區,0590,491,175,666,52,718,1469,48.88%,33.42%,1
臺北市,松山區,0591,675,219,894,70,964,1700,56.71%,39.71%,1
臺北市,松山區,0592,605,173,778,38,816,1503,54.29%,40.25%,1
臺北市,松山區,0593,529,168,697,46,743,1309,56.76%,40.41%,1
臺北市,松山區,0594,592,178,770,64,834,1376,60.61%,43.02%,1
臺北市,松山區,0595,678,214,892,52,944,1654,57.07%,40.99%,1
臺北市,松山區,0596,635,196,831,79,910,1601,56.84%,39.66%,1
臺北市,松山區,0597,695,145,840,38,878,1496,58.69%,46.46%,1
臺北市,松山區,0598,735,204,939,74,1013,1598,63.39%,45.99%,1
臺北市,松山區,0599,784,211,995,60,1055,1751,60.25%,44.77%,1
臺北市,松山區,0600,771,155,926,43,969,1557,62.24%,49.52%,1
臺北市,松山區,0601,900,169,1069,49,1118,1686,66.31%,53.38%,1
臺北市,松山區,0602,874,127,1001,51,1052,1707,61.63%,51.2%,1
臺北市,松山區,0603,1038,86,1124,66,1190,1854,64.19%,55.99%,1
臺北市,松山區,0604,709,221,930,48,978,1740,56.21%,40.75%,1
臺北市,松山區,0605,607,209,816,70,886,1494,59.3%,40.63%,1
臺北市,松山區,0606,652,174,826,47,873,1453,60.08%,44.87%,1
臺北市,松山區,0607,619,194,813,52,865,1458,59.33%,42.46%,1
臺北市,松山區,0608,645,196,841,52,893,1536,58.14%,41.99%,1
臺北市,松山區,0609,637,205,842,40,882,1463,60.29%,43.54%,1
臺北市,松山區,0610,696,222,918,40,958,1790,53.52%,38.88%,1
臺北市,松山區,0611,670,284,954,53,1007,1679,59.98%,39.9%,1
臺北市,松山區,0612,646,222,868,74,942,1785,52.77%,36.19%,1
臺北市,松山區,0613,693,246,939,71,1010,1793,56.33%,38.65%,1
臺北市,松山區,0614,585,192,777,44,821,1381,59.45%,42.36%,1
臺北市,松山區,0615,570,156,726,47,773,1279,60.44%,44.57%,1
臺北市,松山區,0616,717,227,944,70,1014,1681,60.32%,42.65%,1
臺北市,松山區,0617,575,153,728,46,774,1232,62.82%,46.67%,1
臺北市,松山區,0618,628,198,826,59,885,1533,57.73%,40.97%,1
臺北市,松山區,0619,652,238,890,55,945,1540,61.36%,42.34%,1
臺北市,松山區,0620,672,236,908,48,956,1716,55.71%,39.16%,1
臺北市,松山區,0621,637,236,873,51,924,1664,55.53%,38.28%,1
臺北市,松山區,0622,565,172,737,39,776,1350,57.48%,41.85%,1
臺北市,松山區,0623,758,241,999,47,1046,1837,56.94%,41.26%,1
臺北市,松山區,0624,595,185,780,76,856,1558,54.94%,38.19%,1
臺北市,松山區,0625,637,182,819,51,870,1420,61.27%,44.86%,1
臺北市,松山區,0626,624,168,792,50,842,1474,57.12%,42.33%,1
臺北市,松山區,0627,640,217,857,52,909,1591,57.13%,40.23%,1
臺北市,松山區,0628,727,213,940,59,999,1726,57.88%,42.12%,1
臺北市,松山區,0629,604,203,807,41,848,1452,58.4%,41.6%,1
臺北市,松山區,0630,579,206,785,46,831,1482,56.07%,39.07%,1
臺北市,松山區,0631,598,220,818,47,865,1460,59.25%,40.96%,1
臺北市,松山區,0632,553,194,747,53,800,1398,57.22%,39.56%,1
臺北市,松山區,0633,618,186,804,46,850,1423,59.73%,43.43%,1
臺北市,松山區,0634,563,149,712,20,732,1226,59.71%,45.92%,1
臺北市,松山區,0635,516,142,658,46,704,1158,60.79%,44.56%,1
臺北市,松山區,0636,591,188,779,43,822,1426,57.64%,41.44%,1
臺北市,松山區,0637,511,160,671,21,692,1177,58.79%,43.42%,1
臺北市,松山區,0638,542,197,739,57,796,1363,58.4%,39.77%,1
臺北市,松山區,0639,557,173,730,41,771,1240,62.18%,44.92%,1
臺北市,松山區,0640,609,187,796,57,853,1375,62.04%,44.29%,1
臺北市,松山區,0641,593,187,780,44,824,1377,59.84%,43.06%,1
臺北市,松山區,0642,500,144,644,28,672,1225,54.86%,40.82%,1
臺北市,松山區,0643,434,174,608,38,646,1017,63.52%,42.67%,1
臺北市,信義區,0644,592,173,765,30,795,2476,32.11%,23.91%,1
臺北市,信義區,0645,713,137,850,21,871,1381,63.07%,51.63%,1
臺北市,信義區,0646,639,124,763,56,819,1294,63.29%,49.38%,1
臺北市,信義區,0647,580,174,754,43,797,1351,58.99%,42.93%,1
臺北市,信義區,0648,578,145,723,40,763,1296,58.87%,44.6%,1
臺北市,信義區,0649,598,153,751,51,802,1302,61.6%,45.93%,1
臺北市,信義區,0650,414,109,523,64,587,1025,57.27%,40.39%,1
臺北市,信義區,0651,569,178,747,33,780,1421,54.89%,40.04%,1
臺北市,信義區,0652,629,175,804,45,849,1501,56.56%,41.91%,1
臺北市,信義區,0653,593,182,775,38,813,1575,51.62%,37.65%,1
臺北市,信義區,0654,675,165,840,28,868,1516,57.26%,44.53%,1
臺北市,信義區,0655,605,173,778,28,806,1382,58.32%,43.78%,1
臺北市,信義區,0656,477,128,605,52,657,1128,58.24%,42.29%,1
臺北市,信義區,0657,555,185,740,53,793,1397,56.76%,39.73%,1
臺北市,信義區,0658,582,159,741,47,788,1161,67.87%,50.13%,1
臺北市,信義區,0659,647,102,749,40,789,1368,57.68%,47.3%,1
臺北市,信義區,0660,480,116,596,26,622,1049,59.29%,45.76%,1
臺北市,信義區,0661,562,161,723,42,765,1308,58.49%,42.97%,1
臺北市,信義區,0662,516,159,675,52,727,1154,63%,44.71%,1
臺北市,信義區,0663,481,162,643,22,665,1078,61.69%,44.62%,1
臺北市,信義區,0664,579,175,754,54,808,1375,58.76%,42.11%,1
臺北市,信義區,0665,624,187,811,46,857,1448,59.19%,43.09%,1
臺北市,信義區,0666,552,168,720,26,746,1250,59.68%,44.16%,1
臺北市,信義區,0667,607,179,786,35,821,1381,59.45%,43.95%,1
臺北市,信義區,0668,545,155,700,51,751,1213,61.91%,44.93%,1
臺北市,信義區,0669,599,211,810,43,853,1373,62.13%,43.63%,1
臺北市,信義區,0670,546,163,709,43,752,1226,61.34%,44.54%,1
臺北市,信義區,0671,473,154,627,25,652,1117,58.37%,42.35%,1
臺北市,信義區,0672,521,133,654,45,699,1123,62.24%,46.39%,1
臺北市,信義區,0673,529,154,683,44,727,1200,60.58%,44.08%,1
臺北市,信義區,0674,527,150,677,33,710,1335,53.18%,39.48%,1
臺北市,信義區,0675,546,149,695,34,729,1332,54.73%,40.99%,1
臺北市,信義區,0676,740,217,957,70,1027,1648,62.32%,44.9%,1
臺北市,信義區,0677,611,196,807,71,878,1542,56.94%,39.62%,1
臺北市,信義區,0678,504,168,672,60,732,1228,59.61%,41.04%,1
臺北市,信義區,0679,681,256,937,59,996,1731,57.54%,39.34%,1
臺北市,信義區,0680,625,165,790,44,834,1403,59.44%,44.55%,1
臺北市,信義區,0681,766,219,985,85,1070,1929,55.47%,39.71%,1
臺北市,信義區,0682,578,167,745,51,796,1300,61.23%,44.46%,1
臺北市,信義區,0683,590,155,745,37,782,1486,52.62%,39.7%,1
臺北市,信義區,0684,539,171,710,63,773,1532,50.46%,35.18%,1
臺北市,信義區,0685,597,207,804,62,866,1387,62.44%,43.04%,1
臺北市,信義區,0686,462,132,594,63,657,1195,54.98%,38.66%,1
臺北市,信義區,0687,433,117,550,39,589,1068,55.15%,40.54%,1
臺北市,信義區,0688,459,160,619,49,668,1273,52.47%,36.06%,1
臺北市,信義區,0689,609,169,778,62,840,1329,63.21%,45.82%,1
臺北市,信義區,0690,513,148,661,50,711,1311,54.23%,39.13%,1
臺北市,信義區,0691,497,150,647,54,701,1258,55.72%,39.51%,1
臺北市,信義區,0692,533,173,706,68,774,1277,60.61%,41.74%,1
臺北市,信義區,0693,592,167,759,54,813,1285,63.27%,46.07%,1
臺北市,信義區,0694,515,181,696,46,742,1161,63.91%,44.36%,1
臺北市,信義區,0695,509,176,685,42,727,1299,55.97%,39.18%,1
臺北市,信義區,0696,523,152,675,43,718,1243,57.76%,42.08%,1
臺北市,信義區,0697,497,165,662,31,693,1197,57.89%,41.52%,1
臺北市,信義區,0698,550,189,739,24,763,1224,62.34%,44.93%,1
臺北市,信義區,0699,454,129,583,44,627,1147,54.66%,39.58%,1
臺北市,信義區,0700,450,128,578,20,598,1045,57.22%,43.06%,1
臺北市,信義區,0701,533,118,651,23,674,1096,61.5%,48.63%,1
臺北市,信義區,0702,476,145,621,11,632,1115,56.68%,42.69%,1
臺北市,信義區,0703,444,155,599,43,642,1117,57.48%,39.75%,1
臺北市,信義區,0704,395,110,505,26,531,1019,52.11%,38.76%,1
臺北市,信義區,0705,601,138,739,53,792,1346,58.84%,44.65%,1
臺北市,信義區,0706,595,144,739,46,785,1405,55.87%,42.35%,1
臺北市,信義區,0707,582,171,753,40,793,1356,58.48%,42.92%,1
臺北市,信義區,0708,584,186,770,31,801,1250,64.08%,46.72%,1
臺北市,信義區,0709,576,158,734,43,777,1254,61.96%,45.93%,1
臺北市,信義區,0710,576,142,718,33,751,1317,57.02%,43.74%,1
臺北市,信義區,0711,584,172,756,48,804,1271,63.26%,45.95%,1
臺北市,信義區,0712,393,125,518,31,549,979,56.08%,40.14%,1
臺北市,信義區,0713,413,120,533,41,574,1025,56%,40.29%,1
臺北市,信義區,0714,579,139,718,32,750,1512,49.6%,38.29%,1
臺北市,信義區,0715,649,204,853,37,890,1483,60.01%,43.76%,1
臺北市,信義區,0716,617,175,792,40,832,1359,61.22%,45.4%,1
臺北市,信義區,0717,620,184,804,23,827,1387,59.63%,44.7%,1
臺北市,信義區,0718,579,178,757,29,786,1455,54.02%,39.79%,1
臺北市,信義區,0719,602,210,812,31,843,1461,57.7%,41.2%,1
臺北市,信義區,0720,686,181,867,49,916,1532,59.79%,44.78%,1
臺北市,信義區,0721,477,150,627,42,669,1043,64.14%,45.73%,1
臺北市,信義區,0722,380,128,508,45,553,875,63.2%,43.43%,1
臺北市,信義區,0723,399,99,498,22,520,927,56.09%,43.04%,1
臺北市,信義區,0724,465,150,615,68,683,1119,61.04%,41.55%,1
臺北市,信義區,0725,606,200,806,58,864,1463,59.06%,41.42%,1
臺北市,信義區,0726,572,205,777,42,819,1293,63.34%,44.24%,1
臺北市,信義區,0727,646,177,823,56,879,1553,56.6%,41.6%,1
臺北市,信義區,0728,182,562,744,35,779,1360,57.28%,13.38%,1
臺北市,信義區,0729,599,167,766,68,834,1392,59.91%,43.03%,1
臺北市,信義區,0730,598,167,765,23,788,1377,57.23%,43.43%,1
臺北市,信義區,0731,586,170,756,17,773,1377,56.14%,42.56%,1
臺北市,信義區,0732,453,189,642,29,671,1269,52.88%,35.7%,1
臺北市,信義區,0733,624,154,778,65,843,1407,59.91%,44.35%,1
臺北市,信義區,0734,492,153,645,39,684,1172,58.36%,41.98%,1
臺北市,信義區,0735,527,126,653,23,676,1182,57.19%,44.59%,1
臺北市,信義區,0736,528,167,695,58,753,1255,60%,42.07%,1
臺北市,信義區,0737,658,175,833,37,870,1689,51.51%,38.96%,1
臺北市,信義區,0738,648,187,835,30,865,1605,53.89%,40.37%,1
臺北市,信義區,0739,501,123,624,36,660,1143,57.74%,43.83%,1
臺北市,信義區,0740,583,157,740,37,777,1440,53.96%,40.49%,1
臺北市,信義區,0741,643,166,809,52,861,1495,57.59%,43.01%,1
臺北市,信義區,0742,665,191,856,56,912,1514,60.24%,43.92%,1
臺北市,信義區,0743,591,141,732,53,785,1449,54.18%,40.79%,1
臺北市,信義區,0744,618,172,790,59,849,1401,60.6%,44.11%,1
臺北市,信義區,0745,483,119,602,24,626,1181,53.01%,40.9%,1
臺北市,信義區,0746,674,160,834,16,850,1376,61.77%,48.98%,1
臺北市,信義區,0747,643,179,822,49,871,1422,61.25%,45.22%,1
臺北市,信義區,0748,580,125,705,20,725,1267,57.22%,45.78%,1
臺北市,信義區,0749,486,141,627,26,653,1220,53.52%,39.84%,1
臺北市,信義區,0750,606,165,771,24,795,1562,50.9%,38.8%,1
臺北市,信義區,0751,605,158,763,27,790,1455,54.3%,41.58%,1
臺北市,信義區,0752,664,168,832,47,879,1605,54.77%,41.37%,1
臺北市,信義區,0753,793,163,956,25,981,1626,60.33%,48.77%,1
臺北市,信義區,0754,702,179,881,52,933,1561,59.77%,44.97%,1
臺北市,信義區,0755,563,156,719,27,746,1547,48.22%,36.39%,1
臺北市,信義區,0756,592,138,730,31,761,1336,56.96%,44.31%,1
臺北市,信義區,0757,511,118,629,42,671,1314,51.07%,38.89%,1
臺北市,信義區,0758,522,132,654,44,698,1297,53.82%,40.25%,1
臺北市,信義區,0759,541,157,698,60,758,1366,55.49%,39.6%,1
臺北市,信義區,0760,597,203,800,41,841,1472,57.13%,40.56%,1
臺北市,信義區,0761,634,154,788,49,837,1450,57.72%,43.72%,1
臺北市,信義區,0762,561,158,719,53,772,1328,58.13%,42.24%,1
臺北市,信義區,0763,608,192,800,57,857,1399,61.26%,43.46%,1
臺北市,信義區,0764,580,186,766,76,842,1373,61.33%,42.24%,1
臺北市,信義區,0765,472,105,577,30,607,1099,55.23%,42.95%,1
臺北市,信義區,0766,515,150,665,43,708,1226,57.75%,42.01%,1
臺北市,信義區,0767,533,118,651,22,673,1267,53.12%,42.07%,1
臺北市,信義區,0768,651,198,849,59,908,1531,59.31%,42.52%,1
臺北市,信義區,0769,655,170,825,48,873,1438,60.71%,45.55%,1
臺北市,信義區,0770,681,174,855,31,886,1657,53.47%,41.1%,1
臺北市,信義區,0771,702,217,919,51,970,1621,59.84%,43.31%,1
臺北市,信義區,0772,639,215,854,26,880,1508,58.36%,42.37%,1
臺北市,信義區,0773,594,180,774,35,809,1334,60.64%,44.53%,1
臺北市,信義區,0774,424,121,545,47,592,1246,47.51%,34.03%,1
臺北市,信義區,0775,546,167,713,43,756,1196,63.21%,45.65%,1
臺北市,信義區,0776,535,160,695,21,716,1220,58.69%,43.85%,1
臺北市,信義區,0777,634,178,812,28,840,1538,54.62%,41.22%,1
臺北市,信義區,0778,670,181,851,62,913,1565,58.34%,42.81%,1
臺北市,信義區,0779,617,172,789,89,878,1621,54.16%,38.06%,1
臺北市,信義區,0780,619,165,784,54,838,1486,56.39%,41.66%,1
臺北市,信義區,0781,631,143,774,29,803,1507,53.28%,41.87%,1
臺北市,信義區,0782,653,185,838,59,897,1516,59.17%,43.07%,1
臺北市,信義區,0783,597,156,753,66,819,1287,63.64%,46.39%,1
臺北市,信義區,0784,392,122,514,47,561,1050,53.43%,37.33%,1
臺北市,信義區,0785,370,91,461,36,497,801,62.05%,46.19%,1
臺北市,大安區,1214,457,160,617,29,646,1184,54.56%,38.6%,1
臺北市,大安區,1215,469,145,614,38,652,1197,54.47%,39.18%,1
臺北市,大安區,1216,504,168,672,25,697,1221,57.08%,41.28%,1
臺北市,大安區,1217,578,132,710,29,739,1246,59.31%,46.39%,1
臺北市,大安區,1218,652,222,874,45,919,1478,62.18%,44.11%,1
臺北市,大安區,1219,505,191,696,56,752,1314,57.23%,38.43%,1
臺北市,大安區,1220,691,223,914,47,961,1594,60.29%,43.35%,1
臺北市,大安區,1221,610,215,825,28,853,1429,59.69%,42.69%,1
臺北市,大安區,1222,661,190,851,26,877,1452,60.4%,45.52%,1
臺北市,大安區,1223,627,229,856,29,885,1551,57.06%,40.43%,1
臺北市,大安區,1224,598,175,773,54,827,1335,61.95%,44.79%,1
臺北市,大安區,1225,474,138,612,29,641,1196,53.6%,39.63%,1
臺北市,大安區,1226,505,197,702,30,732,1339,54.67%,37.71%,1
臺北市,大安區,1227,559,213,772,33,805,1448,55.59%,38.6%,1
臺北市,大安區,1228,580,164,744,54,798,1373,58.12%,42.24%,1
臺北市,大安區,1229,594,174,768,71,839,1439,58.3%,41.28%,1
臺北市,大安區,1230,444,162,606,12,618,1174,52.64%,37.82%,1
臺北市,大安區,1231,420,158,578,24,602,1144,52.62%,36.71%,1
臺北市,大安區,1232,448,118,566,34,600,1119,53.62%,40.04%,1
臺北市,大安區,1233,357,105,462,37,499,1024,48.73%,34.86%,1
臺北市,大安區,1234,492,116,608,20,628,1032,60.85%,47.67%,1
臺北市,大安區,1235,646,108,754,40,794,1319,60.2%,48.98%,1
臺北市,大安區,1236,623,172,795,45,840,1369,61.36%,45.51%,1
臺北市,大安區,1237,518,229,747,54,801,1347,59.47%,38.46%,1
臺北市,大安區,1238,556,257,813,50,863,1655,52.15%,33.6%,1
臺北市,大安區,1239,569,203,772,33,805,1595,50.47%,35.67%,1
臺北市,大安區,1240,552,186,738,40,778,1429,54.44%,38.63%,1
臺北市,大安區,1241,496,161,657,25,682,1309,52.1%,37.89%,1
臺北市,大安區,1242,559,224,783,42,825,1508,54.71%,37.07%,1
臺北市,大安區,1243,492,194,686,33,719,1310,54.89%,37.56%,1
臺北市,大安區,1244,439,163,602,34,636,1233,51.58%,35.6%,1
臺北市,大安區,1245,482,160,642,49,691,1287,53.69%,37.45%,1
臺北市,大安區,1246,405,158,563,34,597,1147,52.05%,35.31%,1
臺北市,大安區,1247,476,166,642,33,675,1260,53.57%,37.78%,1
臺北市,大安區,1248,558,163,721,41,762,1377,55.34%,40.52%,1
臺北市,大安區,1249,485,167,652,62,714,1284,55.61%,37.77%,1
臺北市,大安區,1250,484,159,643,28,671,1314,51.07%,36.83%,1
臺北市,大安區,1251,487,160,647,32,679,1273,53.34%,38.26%,1
臺北市,大安區,1252,472,172,644,23,667,1146,58.2%,41.19%,1
臺北市,大安區,1253,541,186,727,29,756,1285,58.83%,42.1%,1
臺北市,大安區,1254,559,188,747,35,782,1297,60.29%,43.1%,1
臺北市,大安區,1255,525,131,656,30,686,1101,62.31%,47.68%,1
臺北市,大安區,1256,524,187,711,52,763,1310,58.24%,40%,1
臺北市,大安區,1257,571,216,787,58,845,1365,61.9%,41.83%,1
臺北市,大安區,1258,559,191,750,28,778,1372,56.71%,40.74%,1
臺北市,大安區,1259,508,169,677,26,703,1189,59.13%,42.72%,1
臺北市,大安區,1260,525,180,705,42,747,1256,59.47%,41.8%,1
臺北市,大安區,1261,493,170,663,35,698,1151,60.64%,42.83%,1
臺北市,大安區,1262,705,193,898,37,935,1501,62.29%,46.97%,1
臺北市,大安區,1263,666,196,862,45,907,1520,59.67%,43.82%,1
臺北市,大安區,1264,652,246,898,55,953,1529,62.33%,42.64%,1
臺北市,大安區,1265,675,234,909,50,959,1579,60.73%,42.75%,1
臺北市,大安區,1266,476,168,644,35,679,2619,25.93%,18.17%,1
臺北市,大安區,1267,557,185,742,21,763,1290,59.15%,43.18%,1
臺北市,大安區,1268,563,210,773,31,804,1307,61.51%,43.08%,1
臺北市,大安區,1269,648,182,830,33,863,1489,57.96%,43.52%,1
臺北市,大安區,1270,511,139,650,35,685,1097,62.44%,46.58%,1
臺北市,大安區,1271,559,179,738,39,777,1328,58.51%,42.09%,1
臺北市,大安區,1272,490,174,664,20,684,1189,57.53%,41.21%,1
臺北市,大安區,1273,524,190,714,27,741,1270,58.35%,41.26%,1
臺北市,大安區,1274,534,205,739,18,757,1349,56.12%,39.58%,1
臺北市,大安區,1275,516,171,687,31,718,1292,55.57%,39.94%,1
臺北市,大安區,1276,589,184,773,35,808,1314,61.49%,44.82%,1
臺北市,大安區,1277,500,180,680,49,729,1200,60.75%,41.67%,1
臺北市,大安區,1278,630,230,860,43,903,1558,57.96%,40.44%,1
臺北市,大安區,1279,630,228,858,40,898,1561,57.53%,40.36%,1
臺北市,大安區,1280,632,178,810,44,854,1446,59.06%,43.71%,1
臺北市,大安區,1281,640,211,851,34,885,1499,59.04%,42.7%,1
臺北市,大安區,1282,618,206,824,36,860,1467,58.62%,42.13%,1
臺北市,大安區,1283,605,187,792,50,842,1511,55.72%,40.04%,1
臺北市,大安區,1284,685,221,906,56,962,1600,60.12%,42.81%,1
臺北市,大安區,1285,636,253,889,43,932,1573,59.25%,40.43%,1
臺北市,大安區,1286,653,193,846,50,896,1467,61.08%,44.51%,1
臺北市,大安區,1287,598,143,741,61,802,1358,59.06%,44.04%,1
臺北市,大安區,1288,636,204,840,61,901,1568,57.46%,40.56%,1
臺北市,大安區,1289,593,199,792,45,837,1411,59.32%,42.03%,1
臺北市,大安區,1290,626,195,821,29,850,1554,54.7%,40.28%,1
臺北市,大安區,1291,620,110,730,33,763,1345,56.73%,46.1%,1
臺北市,大安區,1292,659,146,805,27,832,1435,57.98%,45.92%,1
臺北市,大安區,1293,710,188,898,27,925,1481,62.46%,47.94%,1
臺北市,大安區,1294,727,160,887,34,921,1451,63.47%,50.1%,1
臺北市,大安區,1295,638,223,861,62,923,1566,58.94%,40.74%,1
臺北市,大安區,1296,638,214,852,38,890,1525,58.36%,41.84%,1
臺北市,大安區,1297,532,168,700,41,741,1336,55.46%,39.82%,1
臺北市,大安區,1298,604,206,810,57,867,1483,58.46%,40.73%,1
臺北市,大安區,1299,534,144,678,31,709,1396,50.79%,38.25%,1
臺北市,大安區,1300,605,198,803,59,862,1406,61.31%,43.03%,1
臺北市,大安區,1301,621,180,801,34,835,1434,58.23%,43.31%,1
臺北市,大安區,1302,533,178,711,36,747,1288,58%,41.38%,1
臺北市,大安區,1303,616,178,794,36,830,1407,58.99%,43.78%,1
臺北市,大安區,1304,585,190,775,38,813,1514,53.7%,38.64%,1
臺北市,大安區,1305,568,146,714,58,772,1550,49.81%,36.65%,1
臺北市,大安區,1306,634,87,721,50,771,1490,51.74%,42.55%,1
臺北市,大安區,1307,535,143,678,30,708,1284,55.14%,41.67%,1
臺北市,大安區,1308,505,131,636,42,678,1129,60.05%,44.73%,1
臺北市,大安區,1309,512,162,674,30,704,1193,59.01%,42.92%,1
臺北市,大安區,1310,413,147,560,39,599,1057,56.67%,39.07%,1
臺北市,大安區,1311,551,175,726,50,776,1361,57.02%,40.48%,1
臺北市,大安區,1312,582,150,732,61,793,1412,56.16%,41.22%,1
臺北市,大安區,1313,511,159,670,47,717,1423,50.39%,35.91%,1
臺北市,大安區,1314,517,148,665,70,735,1257,58.47%,41.13%,1
臺北市,大安區,1315,504,161,665,37,702,1133,61.96%,44.48%,1
臺北市,大安區,1316,432,142,574,29,603,1077,55.99%,40.11%,1
臺北市,大安區,1317,567,174,741,39,780,1300,60%,43.62%,1
臺北市,大安區,1318,597,169,766,55,821,1319,62.24%,45.26%,1
臺北市,大安區,1319,555,135,690,71,761,1265,60.16%,43.87%,1
臺北市,大安區,1320,499,155,654,27,681,1265,53.83%,39.45%,1
臺北市,大安區,1321,504,115,619,34,653,1103,59.2%,45.69%,1
臺北市,大安區,1322,614,133,747,42,789,1341,58.84%,45.79%,1
臺北市,大安區,1323,631,144,775,49,824,1357,60.72%,46.5%,1
臺北市,大安區,1324,544,161,705,41,746,1260,59.21%,43.17%,1
臺北市,大安區,1325,566,162,728,42,770,1295,59.46%,43.71%,1
臺北市,大安區,1326,550,162,712,26,738,1399,52.75%,39.31%,1
臺北市,大安區,1327,486,145,631,36,667,1150,58%,42.26%,1
臺北市,大安區,1328,541,140,681,34,715,1351,52.92%,40.04%,1
臺北市,大安區,1329,570,171,741,50,791,1341,58.99%,42.51%,1
臺北市,大安區,1330,560,47,607,21,628,1129,55.62%,49.6%,1
臺北市,大安區,1331,584,143,727,31,758,1328,57.08%,43.98%,1
臺北市,大安區,1332,799,137,936,39,975,1557,62.62%,51.32%,1
臺北市,大安區,1333,711,165,876,46,922,1461,63.11%,48.67%,1
臺北市,大安區,1334,611,171,782,34,816,1589,51.35%,38.45%,1
臺北市,大安區,1335,652,135,787,44,831,1473,56.42%,44.26%,1
臺北市,大安區,1336,609,188,797,42,839,1479,56.73%,41.18%,1
臺北市,大安區,1337,372,122,494,29,523,833,62.79%,44.66%,1
臺北市,大安區,1338,436,101,537,27,564,999,56.46%,43.64%,1
臺北市,大安區,1339,785,214,999,42,1041,1757,59.25%,44.68%,1
臺北市,大安區,1340,685,201,886,37,923,1573,58.68%,43.55%,1
臺北市,大安區,1341,707,229,936,44,980,1587,61.75%,44.55%,1
臺北市,大安區,1342,634,225,859,55,914,1496,61.1%,42.38%,1
臺北市,大安區,1343,598,203,801,44,845,1440,58.68%,41.53%,1
臺北市,大安區,1344,667,226,893,61,954,1578,60.46%,42.27%,1
臺北市,大安區,1345,494,181,675,32,707,1223,57.81%,40.39%,1
臺北市,大安區,1346,460,162,622,21,643,1119,57.46%,41.11%,1
臺北市,大安區,1347,550,172,722,40,762,1252,60.86%,43.93%,1
臺北市,大安區,1348,644,232,876,46,922,1576,58.5%,40.86%,1
臺北市,大安區,1349,574,190,764,38,802,1425,56.28%,40.28%,1
臺北市,大安區,1350,548,197,745,29,774,1450,53.38%,37.79%,1
臺北市,大安區,1351,577,194,771,38,809,1444,56.02%,39.96%,1
臺北市,大安區,1352,594,198,792,33,825,1337,61.71%,44.43%,1
臺北市,大安區,1353,580,157,737,31,768,1417,54.2%,40.93%,1
臺北市,大安區,1354,529,153,682,45,727,1250,58.16%,42.32%,1
臺北市,大安區,1355,490,139,629,51,680,1176,57.82%,41.67%,1
臺北市,大安區,1356,578,157,735,48,783,1257,62.29%,45.98%,1
臺北市,大安區,1357,539,158,697,50,747,1257,59.43%,42.88%,1
臺北市,大安區,1358,486,147,633,27,660,1148,57.49%,42.33%,1
臺北市,大安區,1359,587,174,761,59,820,1418,57.83%,41.4%,1
臺北市,大安區,1360,430,117,547,26,573,1028,55.74%,41.83%,1
臺北市,大安區,1361,628,211,839,49,888,1445,61.45%,43.46%,1
臺北市,大安區,1362,599,163,762,49,811,1361,59.59%,44.01%,1
臺北市,大安區,1363,577,189,766,56,822,1343,61.21%,42.96%,1
臺北市,大安區,1364,547,156,703,50,753,1267,59.43%,43.17%,1
臺北市,大安區,1365,544,167,711,40,751,1380,54.42%,39.42%,1
臺北市,大安區,1366,623,177,800,54,854,1524,56.04%,40.88%,1
臺北市,大安區,1367,638,180,818,40,858,1470,58.37%,43.4%,1
臺北市,大安區,1368,531,122,653,46,699,1318,53.03%,40.29%,1
臺北市,大安區,1369,560,163,723,42,765,1430,53.5%,39.16%,1
臺北市,大安區,1370,569,186,755,42,797,1386,57.5%,41.05%,1
臺北市,大安區,1371,560,181,741,29,770,1438,53.55%,38.94%,1
臺北市,大安區,1372,479,150,629,24,653,1270,51.42%,37.72%,1
臺北市,大安區,1373,559,157,716,60,776,1395,55.63%,40.07%,1
臺北市,大安區,1374,537,156,693,45,738,1292,57.12%,41.56%,1
臺北市,大安區,1375,507,180,687,46,733,1310,55.95%,38.7%,1
臺北市,大安區,1376,511,185,696,42,738,1319,55.95%,38.74%,1
臺北市,大安區,1377,561,202,763,22,785,1355,57.93%,41.4%,1
臺北市,大安區,1378,511,144,655,29,684,1312,52.13%,38.95%,1
臺北市,大安區,1379,566,149,715,29,744,1335,55.73%,42.4%,1
臺北市,大安區,1380,555,197,752,31,783,1489,52.59%,37.27%,1
臺北市,大安區,1381,561,158,719,26,745,1307,57%,42.92%,1
臺北市,大安區,1382,495,184,679,19,698,1328,52.56%,37.27%,1
臺北市,大安區,1383,499,157,656,11,667,1277,52.23%,39.08%,1
臺北市,大安區,1384,543,166,709,40,749,1314,57%,41.32%,1
臺北市,大安區,1385,509,206,715,50,765,1270,60.24%,40.08%,1
臺北市,大安區,1386,518,182,700,58,758,1308,57.95%,39.6%,1
臺北市,大安區,1387,497,151,648,26,674,1138,59.23%,43.67%,1
臺北市,大安區,1388,565,142,707,31,738,1333,55.36%,42.39%,1
臺北市,大安區,1389,481,164,645,42,687,1176,58.42%,40.9%,1
臺北市,大安區,1390,532,174,706,49,755,1311,57.59%,40.58%,1
臺北市,大安區,1391,521,173,694,28,722,1295,55.75%,40.23%,1
臺北市,大安區,1392,605,175,780,48,828,1421,58.27%,42.58%,1
臺北市,大安區,1393,564,179,743,39,782,1409,55.5%,40.03%,1
臺北市,大安區,1394,622,179,801,34,835,1434,58.23%,43.38%,1
臺北市,大安區,1395,552,178,730,52,782,1449,53.97%,38.1%,1
臺北市,大安區,1396,540,164,704,53,757,1284,58.96%,42.06%,1
臺北市,大安區,1397,546,143,689,33,722,1248,57.85%,43.75%,1
臺北市,大安區,1398,532,178,710,29,739,1119,66.04%,47.54%,1
臺北市,大安區,1399,404,97,501,35,536,883,60.7%,45.75%,1
臺北市,大安區,1400,250,70,320,40,360,630,57.14%,39.68%,1
臺北市,大安區,1401,327,125,452,32,484,814,59.46%,40.17%,1
臺北市,中山區,0786,655,170,825,41,866,1522,56.9%,43.04%,1
臺北市,中山區,0787,510,193,703,37,740,1332,55.56%,38.29%,1
臺北市,中山區,0788,588,194,782,54,836,1656,50.48%,35.51%,1
臺北市,中山區,0789,492,171,663,48,711,1367,52.01%,35.99%,1
臺北市,中山區,0790,620,211,831,57,888,1732,51.27%,35.8%,1
臺北市,中山區,0791,695,184,879,58,937,1634,57.34%,42.53%,1
臺北市,中山區,0792,611,231,842,52,894,1650,54.18%,37.03%,1
臺北市,中山區,0793,559,217,776,37,813,1392,58.41%,40.16%,1
臺北市,中山區,0794,496,196,692,34,726,1177,61.68%,42.14%,1
臺北市,中山區,0795,613,199,812,55,867,1477,58.7%,41.5%,1
臺北市,中山區,0796,398,133,531,50,581,1063,54.66%,37.44%,1
臺北市,中山區,0797,523,140,663,42,705,1296,54.4%,40.35%,1
臺北市,中山區,0798,542,139,681,30,711,1330,53.46%,40.75%,1
臺北市,中山區,0799,537,216,753,52,805,1483,54.28%,36.21%,1
臺北市,中山區,0800,619,169,788,43,831,1542,53.89%,40.14%,1
臺北市,中山區,0801,670,204,874,66,940,1710,54.97%,39.18%,1
臺北市,中山區,0802,472,166,638,32,670,1315,50.95%,35.89%,1
臺北市,中山區,0803,484,150,634,66,700,1245,56.22%,38.88%,1
臺北市,中山區,0804,518,129,647,37,684,1262,54.2%,41.05%,1
臺北市,中山區,0805,594,218,812,58,870,1518,57.31%,39.13%,1
臺北市,中山區,0806,608,202,810,69,879,1522,57.75%,39.95%,1
臺北市,中山區,0807,525,227,752,76,828,1580,52.41%,33.23%,1
臺北市,中山區,0808,626,185,811,37,848,1529,55.46%,40.94%,1
臺北市,中山區,0809,460,162,622,43,665,1221,54.46%,37.67%,1
臺北市,中山區,0810,507,163,670,55,725,1221,59.38%,41.52%,1
臺北市,中山區,0811,446,99,545,29,574,1139,50.4%,39.16%,1
臺北市,中山區,0812,534,199,733,69,802,1407,57%,37.95%,1
臺北市,中山區,0813,551,146,697,40,737,1321,55.79%,41.71%,1
臺北市,中山區,0814,583,163,746,42,788,1578,49.94%,36.95%,1
臺北市,中山區,0815,656,182,838,51,889,1739,51.12%,37.72%,1
臺北市,中山區,0816,605,202,807,52,859,1637,52.47%,36.96%,1
臺北市,中山區,0817,579,192,771,73,844,1541,54.77%,37.57%,1
臺北市,中山區,0818,503,161,664,56,720,1210,59.5%,41.57%,1
臺北市,中山區,0819,506,168,674,48,722,1331,54.24%,38.02%,1
臺北市,中山區,0820,456,134,590,60,650,1224,53.1%,37.25%,1
臺北市,中山區,0821,651,188,839,65,904,1585,57.03%,41.07%,1
臺北市,中山區,0822,641,229,870,80,950,1523,62.38%,42.09%,1
臺北市,中山區,0823,614,166,780,58,838,1368,61.26%,44.88%,1
臺北市,中山區,0824,837,138,975,55,1030,1805,57.06%,46.37%,1
臺北市,中山區,0825,681,107,788,39,827,1404,58.9%,48.5%,1
臺北市,中山區,0826,753,266,1019,47,1066,1708,62.41%,44.09%,1
臺北市,中山區,0827,641,191,832,57,889,1451,61.27%,44.18%,1
臺北市,中山區,0828,731,223,954,81,1035,1684,61.46%,43.41%,1
臺北市,中山區,0829,689,162,851,38,889,1585,56.09%,43.47%,1
臺北市,中山區,0830,581,186,767,70,837,1391,60.17%,41.77%,1
臺北市,中山區,0831,650,191,841,72,913,1375,66.4%,47.27%,1
臺北市,中山區,0832,653,212,865,19,884,1472,60.05%,44.36%,1
臺北市,中山區,0833,542,152,694,46,740,1327,55.76%,40.84%,1
臺北市,中山區,0834,640,143,783,35,818,1401,58.39%,45.68%,1
臺北市,中山區,0835,614,167,781,54,835,1423,58.68%,43.15%,1
臺北市,中山區,0836,630,245,875,48,923,1569,58.83%,40.15%,1
臺北市,中山區,0837,690,226,916,34,950,1651,57.54%,41.79%,1
臺北市,中山區,0838,749,103,852,31,883,1624,54.37%,46.12%,1
臺北市,中山區,0839,732,254,986,57,1043,1713,60.89%,42.73%,1
臺北市,中山區,0840,746,188,934,50,984,1647,59.74%,45.29%,1
臺北市,中山區,0841,693,217,910,46,956,1762,54.26%,39.33%,1
臺北市,中山區,0842,666,152,818,43,861,1399,61.54%,47.61%,1
臺北市,中山區,0843,672,193,865,47,912,1489,61.25%,45.13%,1
臺北市,中山區,0844,596,179,775,35,810,1269,63.83%,46.97%,1
臺北市,中山區,0845,478,108,586,44,630,998,63.13%,47.9%,1
臺北市,中山區,0846,612,156,768,58,826,1472,56.11%,41.58%,1
臺北市,中山區,0847,539,213,752,55,807,1517,53.2%,35.53%,1
臺北市,中山區,0848,736,208,944,76,1020,1704,59.86%,43.19%,1
臺北市,中山區,0849,586,280,866,67,933,1603,58.2%,36.56%,1
臺北市,中山區,0850,538,167,705,78,783,1432,54.68%,37.57%,1
臺北市,中山區,0851,613,218,831,64,895,1500,59.67%,40.87%,1
臺北市,中山區,0852,575,181,756,40,796,1332,59.76%,43.17%,1
臺北市,中山區,0853,598,225,823,54,877,1450,60.48%,41.24%,1
臺北市,中山區,0854,596,212,808,51,859,1434,59.9%,41.56%,1
臺北市,中山區,0855,539,195,734,31,765,1419,53.91%,37.98%,1
臺北市,中山區,0856,479,194,673,41,714,1292,55.26%,37.07%,1
臺北市,中山區,0857,573,204,777,57,834,1526,54.65%,37.55%,1
臺北市,中山區,0858,533,187,720,59,779,1582,49.24%,33.69%,1
臺北市,中山區,0859,567,187,754,70,824,1588,51.89%,35.71%,1
臺北市,中山區,0860,566,196,762,77,839,1463,57.35%,38.69%,1
臺北市,中山區,0861,522,204,726,59,785,1533,51.21%,34.05%,1
臺北市,中山區,0862,352,131,483,55,538,944,56.99%,37.29%,1
臺北市,中山區,0863,737,278,1015,72,1087,1745,62.29%,42.23%,1
臺北市,中山區,0864,581,207,788,53,841,1679,50.09%,34.6%,1
臺北市,中山區,0865,562,188,750,53,803,3419,23.49%,16.44%,1
臺北市,中山區,0866,570,185,755,75,830,1387,59.84%,41.1%,1
臺北市,中山區,0867,699,209,908,71,979,1672,58.55%,41.81%,1
臺北市,中山區,0868,519,175,694,74,768,1319,58.23%,39.35%,1
臺北市,中山區,0869,532,172,704,60,764,1364,56.01%,39%,1
臺北市,中山區,0870,574,186,760,51,811,1461,55.51%,39.29%,1
臺北市,中山區,0871,484,167,651,44,695,1173,59.25%,41.26%,1
臺北市,中山區,0872,440,135,575,50,625,1171,53.37%,37.57%,1
臺北市,中山區,0873,514,179,693,51,744,1310,56.79%,39.24%,1
臺北市,中山區,0874,621,159,780,46,826,1373,60.16%,45.23%,1
臺北市,中山區,0875,556,173,729,33,762,1290,59.07%,43.1%,1
臺北市,中山區,0876,573,184,757,62,819,1346,60.85%,42.57%,1
臺北市,中山區,0877,598,228,826,70,896,1468,61.04%,40.74%,1
臺北市,中山區,0878,515,151,666,38,704,1178,59.76%,43.72%,1
臺北市,中山區,0879,681,235,916,59,975,1654,58.95%,41.17%,1
臺北市,中山區,0880,612,179,791,68,859,1464,58.67%,41.8%,1
臺北市,中山區,0881,541,213,754,34,788,1450,54.34%,37.31%,1
臺北市,中山區,0882,590,213,803,68,871,1534,56.78%,38.46%,1
臺北市,中山區,0883,678,234,912,39,951,1703,55.84%,39.81%,1
臺北市,中山區,0884,650,213,863,83,946,1610,58.76%,40.37%,1
臺北市,中山區,0885,608,241,849,77,926,1653,56.02%,36.78%,1
臺北市,中山區,0886,658,280,938,67,1005,1694,59.33%,38.84%,1
臺北市,中山區,0887,628,222,850,66,916,1623,56.44%,38.69%,1
臺北市,中山區,0888,621,266,887,62,949,1618,58.65%,38.38%,1
臺北市,中山區,0889,592,225,817,53,870,1583,54.96%,37.4%,1
臺北市,中山區,0890,629,266,895,68,963,1605,60%,39.19%,1
臺北市,中山區,0891,600,228,828,52,880,1398,62.95%,42.92%,1
臺北市,中山區,0892,686,234,920,61,981,1526,64.29%,44.95%,1
臺北市,中山區,0893,603,242,845,60,905,1555,58.2%,38.78%,1
臺北市,中山區,0894,646,194,840,45,885,1597,55.42%,40.45%,1
臺北市,中山區,0895,625,227,852,79,931,1587,58.66%,39.38%,1
臺北市,中山區,0896,693,198,891,65,956,1587,60.24%,43.67%,1
臺北市,中山區,0897,646,219,865,77,942,1546,60.93%,41.79%,1
臺北市,中山區,0898,550,150,700,52,752,1322,56.88%,41.6%,1
臺北市,中山區,0899,533,161,694,45,739,1267,58.33%,42.07%,1
臺北市,中山區,0900,526,132,658,20,678,1210,56.03%,43.47%,1
臺北市,中山區,0901,546,143,689,57,746,1295,57.61%,42.16%,1
臺北市,中山區,0902,650,181,831,57,888,1467,60.53%,44.31%,1
臺北市,中山區,0903,700,156,856,43,899,1491,60.3%,46.95%,1
臺北市,中山區,0904,839,136,975,59,1034,1516,68.21%,55.34%,1
臺北市,中山區,0905,526,183,709,40,749,1384,54.12%,38.01%,1
臺北市,中山區,0906,509,172,681,45,726,1138,63.8%,44.73%,1
臺北市,中山區,0907,560,203,763,35,798,1513,52.74%,37.01%,1
臺北市,中山區,0908,677,186,863,60,923,1559,59.2%,43.43%,1
臺北市,中山區,0909,607,195,802,73,875,1429,61.23%,42.48%,1
臺北市,中山區,0910,538,198,736,35,771,1245,61.93%,43.21%,1
臺北市,中山區,0911,543,170,713,48,761,1214,62.69%,44.73%,1
臺北市,中山區,0912,574,216,790,45,835,1394,59.9%,41.18%,1
臺北市,中山區,0913,529,136,665,20,685,1336,51.27%,39.6%,1
臺北市,中山區,0914,483,192,675,42,717,1227,58.44%,39.36%,1
臺北市,中山區,0915,583,196,779,38,817,1382,59.12%,42.19%,1
臺北市,中山區,0916,586,178,764,63,827,1436,57.59%,40.81%,1
臺北市,中山區,0917,539,166,705,31,736,1405,52.38%,38.36%,1
臺北市,中山區,0918,554,136,690,36,726,1259,57.66%,44%,1
臺北市,中正區,1001,553,192,745,39,784,1308,59.94%,42.28%,1
臺北市,中正區,1002,501,166,667,70,737,1317,55.96%,38.04%,1
臺北市,中正區,1003,515,113,628,33,661,1069,61.83%,48.18%,1
臺北市,中正區,1004,490,101,591,41,632,1128,56.03%,43.44%,1
臺北市,中正區,1005,437,157,594,49,643,1053,61.06%,41.5%,1
臺北市,中正區,1006,442,137,579,22,601,1048,57.35%,42.18%,1
臺北市,中正區,1007,561,123,684,52,736,1297,56.75%,43.25%,1
臺北市,中正區,1008,571,123,694,23,717,1193,60.1%,47.86%,1
臺北市,中正區,1009,687,232,919,52,971,1500,64.73%,45.8%,1
臺北市,中正區,1010,548,162,710,36,746,1346,55.42%,40.71%,1
臺北市,中正區,1011,541,164,705,23,728,1283,56.74%,42.17%,1
臺北市,中正區,1012,620,161,781,45,826,1450,56.97%,42.76%,1
臺北市,中正區,1013,601,206,807,44,851,1433,59.39%,41.94%,1
臺北市,中正區,1014,603,211,814,45,859,1309,65.62%,46.07%,1
臺北市,中正區,1015,603,175,778,32,810,1386,58.44%,43.51%,1
臺北市,中正區,1016,526,161,687,45,732,1201,60.95%,43.8%,1
臺北市,中正區,1017,596,174,770,48,818,1336,61.23%,44.61%,1
臺北市,中正區,1018,566,215,781,48,829,1358,61.05%,41.68%,1
臺北市,中正區,1019,500,165,665,49,714,1177,60.66%,42.48%,1
臺北市,中正區,1020,595,161,756,31,787,1236,63.67%,48.14%,1
臺北市,中正區,1021,610,199,809,48,857,1478,57.98%,41.27%,1
臺北市,中正區,1022,649,193,842,31,873,1474,59.23%,44.03%,1
臺北市,中正區,1023,487,163,650,40,690,1172,58.87%,41.55%,1
臺北市,中正區,1024,549,187,736,35,771,1310,58.85%,41.91%,1
臺北市,中正區,1025,563,143,706,55,761,1263,60.25%,44.58%,1
臺北市,中正區,1026,479,177,656,45,701,1169,59.97%,40.98%,1
臺北市,中正區,1027,620,125,745,29,774,1391,55.64%,44.57%,1
臺北市,中正區,1028,507,143,650,30,680,1201,56.62%,42.21%,1
臺北市,中正區,1029,564,180,744,41,785,1324,59.29%,42.6%,1
臺北市,中正區,1030,475,148,623,60,683,1216,56.17%,39.06%,1
臺北市,中正區,1031,493,144,637,44,681,1183,57.57%,41.67%,1
臺北市,中正區,1032,600,214,814,75,889,1469,60.52%,40.84%,1
臺北市,中正區,1033,594,171,765,54,819,1411,58.04%,42.1%,1
臺北市,中正區,1034,598,169,767,77,844,1398,60.37%,42.78%,1
臺北市,中正區,1035,624,152,776,68,844,1479,57.07%,42.19%,1
臺北市,中正區,1036,677,149,826,77,903,1620,55.74%,41.79%,1
臺北市,中正區,1037,438,131,569,18,587,1041,56.39%,42.07%,1
臺北市,中正區,1038,410,158,568,14,582,1056,55.11%,38.83%,1
臺北市,中正區,1039,482,155,637,41,678,1063,63.78%,45.34%,1
臺北市,中正區,1040,535,151,686,60,746,1591,46.89%,33.63%,1
臺北市,中正區,1041,499,138,637,71,708,1502,47.14%,33.22%,1
臺北市,中正區,1042,518,126,644,70,714,1331,53.64%,38.92%,1
臺北市,中正區,1043,588,164,752,66,818,1441,56.77%,40.8%,1
臺北市,中正區,1044,571,161,732,56,788,1273,61.9%,44.85%,1
臺北市,中正區,1045,478,150,628,56,684,1133,60.37%,42.19%,1
臺北市,中正區,1046,515,135,650,39,689,1156,59.6%,44.55%,1
臺北市,中正區,1047,548,191,739,58,797,1377,57.88%,39.8%,1
臺北市,中正區,1048,530,178,708,70,778,1266,61.45%,41.86%,1
臺北市,中正區,1049,526,135,661,48,709,1111,63.82%,47.34%,1
臺北市,中正區,1050,491,141,632,26,658,1124,58.54%,43.68%,1
臺北市,中正區,1051,645,158,803,43,846,1373,61.62%,46.98%,1
臺北市,中正區,1052,604,182,786,50,836,1351,61.88%,44.71%,1
臺北市,中正區,1053,642,201,843,35,878,1495,58.73%,42.94%,1
臺北市,中正區,1054,716,198,914,55,969,1436,67.48%,49.86%,1
臺北市,中正區,1055,664,166,830,34,864,1516,56.99%,43.8%,1
臺北市,中正區,1056,589,172,761,43,804,1374,58.52%,42.87%,1
臺北市,中正區,1057,604,177,781,47,828,1522,54.4%,39.68%,1
臺北市,中正區,1058,579,175,754,39,793,1336,59.36%,43.34%,1
臺北市,中正區,1059,671,197,868,41,909,1551,58.61%,43.26%,1
臺北市,中正區,1060,660,225,885,67,952,1594,59.72%,41.41%,1
臺北市,中正區,1061,599,207,806,70,876,1503,58.28%,39.85%,1
臺北市,中正區,1062,642,176,818,46,864,1455,59.38%,44.12%,1
臺北市,中正區,1063,635,184,819,25,844,1439,58.65%,44.13%,1
臺北市,中正區,1064,629,191,820,44,864,1469,58.82%,42.82%,1
臺北市,中正區,1065,675,148,823,39,862,1430,60.28%,47.2%,1
臺北市,中正區,1066,645,188,833,52,885,1444,61.29%,44.67%,1
臺北市,中正區,1067,554,155,709,21,730,1254,58.21%,44.18%,1
臺北市,中正區,1068,428,99,527,47,574,932,61.59%,45.92%,1
臺北市,中正區,1069,447,151,598,46,644,1055,61.04%,42.37%,1
臺北市,中正區,1070,519,167,686,35,721,1226,58.81%,42.33%,1
臺北市,中正區,1071,526,158,684,48,732,1390,52.66%,37.84%,1
臺北市,中正區,1072,575,158,733,42,775,1336,58.01%,43.04%,1
臺北市,中正區,1073,513,188,701,49,750,1419,52.85%,36.15%,1
臺北市,中正區,1074,592,206,798,47,845,1361,62.09%,43.5%,1
臺北市,中正區,1075,900,192,1092,49,1141,2520,45.28%,35.71%,1
臺北市,中正區,1076,515,166,681,21,702,1224,57.35%,42.08%,1
臺北市,中正區,1077,483,167,650,5,655,1272,51.49%,37.97%,1
臺北市,中正區,1078,515,253,768,42,810,1400,57.86%,36.79%,1
臺北市,中正區,1079,508,184,692,30,722,1319,54.74%,38.51%,1
臺北市,中正區,1080,536,176,712,46,758,1232,61.53%,43.51%,1
臺北市,中正區,1081,587,171,758,41,799,1265,63.16%,46.4%,1
臺北市,中正區,1082,502,146,648,27,675,1055,63.98%,47.58%,1
臺北市,中正區,1083,390,149,539,27,566,954,59.33%,40.88%,1
臺北市,中正區,1084,454,125,579,33,612,1018,60.12%,44.6%,1
臺北市,中正區,1085,593,188,781,48,829,1431,57.93%,41.44%,1
臺北市,中正區,1086,464,154,618,52,670,1271,52.71%,36.51%,1
臺北市,中正區,1087,415,154,569,44,613,983,62.36%,42.22%,1
臺北市,中正區,1088,622,234,856,44,900,1594,56.46%,39.02%,1
臺北市,中正區,1089,747,65,812,53,865,1565,55.27%,47.73%,1
臺北市,中正區,1090,691,216,907,38,945,1650,57.27%,41.88%,1
臺北市,中正區,1091,617,219,836,44,880,1600,55%,38.56%,1
臺北市,中正區,1092,559,195,754,24,778,1391,55.93%,40.19%,1
臺北市,中正區,1093,703,255,958,42,1000,1769,56.53%,39.74%,1
臺北市,中正區,1094,580,244,824,54,878,1487,59.05%,39%,1
臺北市,中正區,1095,554,195,749,41,790,1291,61.19%,42.91%,1
臺北市,中正區,1096,527,214,741,33,774,1289,60.05%,40.88%,1
臺北市,大同區,0919,488,191,679,72,751,1261,59.56%,38.7%,1
臺北市,大同區,0920,545,227,772,61,833,1352,61.61%,40.31%,1
臺北市,大同區,0921,566,209,775,61,836,1462,57.18%,38.71%,1
臺北市,大同區,0922,618,185,803,64,867,1510,57.42%,40.93%,1
臺北市,大同區,0923,530,211,741,36,777,1496,51.94%,35.43%,1
臺北市,大同區,0924,520,183,703,49,752,1329,56.58%,39.13%,1
臺北市,大同區,0925,519,174,693,73,766,1307,58.61%,39.71%,1
臺北市,大同區,0926,440,137,577,52,629,1065,59.06%,41.31%,1
臺北市,大同區,0927,424,153,577,37,614,1085,56.59%,39.08%,1
臺北市,大同區,0928,421,186,607,52,659,1047,62.94%,40.21%,1
臺北市,大同區,0929,452,142,594,37,631,1215,51.93%,37.2%,1
臺北市,大同區,0930,457,194,651,33,684,1117,61.24%,40.91%,1
臺北市,大同區,0931,506,160,666,66,732,1186,61.72%,42.66%,1
臺北市,大同區,0932,473,191,664,57,721,1185,60.84%,39.92%,1
臺北市,大同區,0933,546,172,718,43,761,1359,56%,40.18%,1
臺北市,大同區,0934,508,174,682,33,715,1273,56.17%,39.91%,1
臺北市,大同區,0935,567,171,738,52,790,1291,61.19%,43.92%,1
臺北市,大同區,0936,487,180,667,43,710,1288,55.12%,37.81%,1
臺北市,大同區,0937,542,182,724,51,775,1245,62.25%,43.53%,1
臺北市,大同區,0938,553,182,735,58,793,1261,62.89%,43.85%,1
臺北市,大同區,0939,529,170,699,29,728,1348,54.01%,39.24%,1
臺北市,大同區,0940,640,254,894,86,980,1676,58.47%,38.19%,1
臺北市,大同區,0941,567,186,753,50,803,1311,61.25%,43.25%,1
臺北市,大同區,0942,541,171,712,80,792,1316,60.18%,41.11%,1
臺北市,大同區,0943,556,199,755,71,826,1409,58.62%,39.46%,1
臺北市,大同區,0944,592,218,810,63,873,1436,60.79%,41.23%,1
臺北市,大同區,0945,541,232,773,62,835,1408,59.3%,38.42%,1
臺北市,大同區,0946,492,194,686,45,731,1276,57.29%,38.56%,1
臺北市,大同區,0947,491,119,610,16,626,1110,56.4%,44.23%,1
臺北市,大同區,0948,522,197,719,36,755,1324,57.02%,39.43%,1
臺北市,大同區,0949,405,134,539,49,588,1016,57.87%,39.86%,1
臺北市,大同區,0950,444,158,602,38,640,1028,62.26%,43.19%,1
臺北市,大同區,0951,514,155,669,54,723,1158,62.44%,44.39%,1
臺北市,大同區,0952,497,142,639,59,698,1138,61.34%,43.67%,1
臺北市,大同區,0953,514,161,675,62,737,1214,60.71%,42.34%,1
臺北市,大同區,0954,428,159,587,28,615,1090,56.42%,39.27%,1
臺北市,大同區,0955,595,176,771,58,829,1305,63.52%,45.59%,1
臺北市,大同區,0956,460,132,592,29,621,1167,53.21%,39.42%,1
臺北市,大同區,0957,476,156,632,53,685,1148,59.67%,41.46%,1
臺北市,大同區,0958,523,149,672,51,723,1203,60.1%,43.47%,1
臺北市,大同區,0959,532,192,724,43,767,1441,53.23%,36.92%,1
臺北市,大同區,0960,549,210,759,64,823,1315,62.59%,41.75%,1
臺北市,大同區,0961,561,164,725,72,797,1393,57.21%,40.27%,1
臺北市,大同區,0962,529,174,703,59,762,1278,59.62%,41.39%,1
臺北市,大同區,0963,467,147,614,51,665,1246,53.37%,37.48%,1
臺北市,大同區,0964,433,155,588,68,656,1142,57.44%,37.92%,1
臺北市,大同區,0965,568,196,764,56,820,1336,61.38%,42.51%,1
臺北市,大同區,0966,565,205,770,64,834,1363,61.19%,41.45%,1
臺北市,大同區,0967,598,194,792,36,828,1476,56.1%,40.51%,1
臺北市,大同區,0968,559,224,783,52,835,1418,58.89%,39.42%,1
臺北市,大同區,0969,555,190,745,34,779,1460,53.36%,38.01%,1
臺北市,大同區,0970,407,154,561,51,612,1222,50.08%,33.31%,1
臺北市,大同區,0971,425,140,565,88,653,1246,52.41%,34.11%,1
臺北市,大同區,0972,487,207,694,71,765,1256,60.91%,38.77%,1
臺北市,大同區,0973,536,170,706,31,737,1289,57.18%,41.58%,1
臺北市,大同區,0974,500,178,678,23,701,1340,52.31%,37.31%,1
臺北市,大同區,0975,554,220,774,64,838,1555,53.89%,35.63%,1
臺北市,大同區,0976,582,168,750,70,820,2459,33.35%,23.67%,1
臺北市,大同區,0977,356,123,479,58,537,1108,48.47%,32.13%,1
臺北市,大同區,0978,317,114,431,53,484,867,55.82%,36.56%,1
臺北市,大同區,0979,548,211,759,60,819,1329,61.63%,41.23%,1
臺北市,大同區,0980,452,170,622,31,653,1162,56.2%,38.9%,1
臺北市,大同區,0981,525,191,716,69,785,1434,54.74%,36.61%,1
臺北市,大同區,0982,548,177,725,64,789,1351,58.4%,40.56%,1
臺北市,大同區,0983,545,205,750,43,793,1531,51.8%,35.6%,1
臺北市,大同區,0984,522,200,722,18,740,1507,49.1%,34.64%,1
臺北市,大同區,0985,565,220,785,56,841,1488,56.52%,37.97%,1
臺北市,大同區,0986,578,186,764,88,852,1384,61.56%,41.76%,1
臺北市,大同區,0987,586,181,767,79,846,1460,57.95%,40.14%,1
臺北市,大同區,0988,590,191,781,62,843,1371,61.49%,43.03%,1
臺北市,大同區,0989,559,189,748,35,783,1439,54.41%,38.85%,1
臺北市,大同區,0990,533,220,753,73,826,1376,60.03%,38.74%,1
臺北市,大同區,0991,513,176,689,83,772,1366,56.52%,37.55%,1
臺北市,大同區,0992,526,201,727,59,786,1218,64.53%,43.19%,1
臺北市,大同區,0993,527,142,669,59,728,1235,58.95%,42.67%,1
臺北市,大同區,0994,544,145,689,28,717,1364,52.57%,39.88%,1
臺北市,大同區,0995,604,212,816,79,895,1408,63.57%,42.9%,1
臺北市,大同區,0996,584,200,784,62,846,1450,58.34%,40.28%,1
臺北市,大同區,0997,619,200,819,68,887,1429,62.07%,43.32%,1
臺北市,大同區,0998,482,168,650,65,715,1170,61.11%,41.2%,1
臺北市,大同區,0999,464,190,654,79,733,1245,58.88%,37.27%,1
臺北市,大同區,1000,514,203,717,69,786,1215,64.69%,42.3%,1
臺北市,萬華區,1097,568,185,753,56,809,1305,61.99%,43.52%,1
臺北市,萬華區,1098,395,141,536,69,605,1183,51.14%,33.39%,1
臺北市,萬華區,1099,474,130,604,30,634,1176,53.91%,40.31%,1
臺北市,萬華區,1100,412,150,562,30,592,1169,50.64%,35.24%,1
臺北市,萬華區,1101,500,188,688,46,734,1457,50.38%,34.32%,1
臺北市,萬華區,1102,506,180,686,64,750,1563,47.98%,32.37%,1
臺北市,萬華區,1103,608,192,800,36,836,1771,47.2%,34.33%,1
臺北市,萬華區,1104,588,193,781,53,834,1615,51.64%,36.41%,1
臺北市,萬華區,1105,564,182,746,78,824,1478,55.75%,38.16%,1
臺北市,萬華區,1106,569,175,744,27,771,1462,52.74%,38.92%,1
臺北市,萬華區,1107,517,149,666,69,735,1507,48.77%,34.31%,1
臺北市,萬華區,1108,537,207,744,51,795,1347,59.02%,39.87%,1
臺北市,萬華區,1109,492,177,669,54,723,1367,52.89%,35.99%,1
臺北市,萬華區,1110,522,208,730,51,781,1277,61.16%,40.88%,1
臺北市,萬華區,1111,525,227,752,50,802,1395,57.49%,37.63%,1
臺北市,萬華區,1112,530,193,723,55,778,1450,53.66%,36.55%,1
臺北市,萬華區,1113,487,154,641,51,692,1340,51.64%,36.34%,1
臺北市,萬華區,1114,448,165,613,52,665,1242,53.54%,36.07%,1
臺北市,萬華區,1115,449,184,633,78,711,1286,55.29%,34.91%,1
臺北市,萬華區,1116,501,148,649,50,699,1324,52.79%,37.84%,1
臺北市,萬華區,1117,557,223,780,78,858,1619,53%,34.4%,1
臺北市,萬華區,1118,436,170,606,68,674,1352,49.85%,32.25%,1
臺北市,萬華區,1119,511,186,697,54,751,1440,52.15%,35.49%,1
臺北市,萬華區,1120,486,179,665,51,716,1194,59.97%,40.7%,1
臺北市,萬華區,1121,475,143,618,73,691,1083,63.8%,43.86%,1
臺北市,萬華區,1122,442,166,608,69,677,1237,54.73%,35.73%,1
臺北市,萬華區,1123,616,210,826,60,886,1625,54.52%,37.91%,1
臺北市,萬華區,1124,539,190,729,72,801,1324,60.5%,40.71%,1
臺北市,萬華區,1125,559,175,734,58,792,1352,58.58%,41.35%,1
臺北市,萬華區,1126,490,193,683,57,740,2630,28.14%,18.63%,1
臺北市,萬華區,1127,606,225,831,69,900,1504,59.84%,40.29%,1
臺北市,萬華區,1128,515,193,708,64,772,1425,54.18%,36.14%,1
臺北市,萬華區,1129,542,181,723,79,802,1591,50.41%,34.07%,1
臺北市,萬華區,1130,578,145,723,81,804,1474,54.55%,39.21%,1
臺北市,萬華區,1131,575,166,741,83,824,1612,51.12%,35.67%,1
臺北市,萬華區,1132,559,182,741,65,806,1447,55.7%,38.63%,1
臺北市,萬華區,1133,639,174,813,53,866,1491,58.08%,42.86%,1
臺北市,萬華區,1134,635,190,825,55,880,1500,58.67%,42.33%,1
臺北市,萬華區,1135,664,199,863,71,934,1582,59.04%,41.97%,1
臺北市,萬華區,1136,612,202,814,102,916,1623,56.44%,37.71%,1
臺北市,萬華區,1137,466,157,623,32,655,1228,53.34%,37.95%,1
臺北市,萬華區,1138,510,153,663,64,727,1268,57.33%,40.22%,1
臺北市,萬華區,1139,511,154,665,62,727,1207,60.23%,42.34%,1
臺北市,萬華區,1140,499,175,674,39,713,1188,60.02%,42%,1
臺北市,萬華區,1141,551,187,738,54,792,1474,53.73%,37.38%,1
臺北市,萬華區,1142,471,102,573,23,596,1304,45.71%,36.12%,1
臺北市,萬華區,1143,334,78,412,45,457,1082,42.24%,30.87%,1
臺北市,萬華區,1144,365,142,507,42,549,1052,52.19%,34.7%,1
臺北市,萬華區,1145,411,165,576,57,633,1135,55.77%,36.21%,1
臺北市,萬華區,1146,450,184,634,59,693,1225,56.57%,36.73%,1
臺北市,萬華區,1147,585,181,766,68,834,1583,52.68%,36.96%,1
臺北市,萬華區,1148,533,190,723,54,777,1403,55.38%,37.99%,1
臺北市,萬華區,1149,550,195,745,64,809,1406,57.54%,39.12%,1
臺北市,萬華區,1150,575,183,758,56,814,1401,58.1%,41.04%,1
臺北市,萬華區,1151,484,151,635,66,701,1188,59.01%,40.74%,1
臺北市,萬華區,1152,572,192,764,80,844,1597,52.85%,35.82%,1
臺北市,萬華區,1153,554,169,723,69,792,1290,61.4%,42.95%,1
臺北市,萬華區,1154,602,203,805,22,827,1746,47.37%,34.48%,1
臺北市,萬華區,1155,544,168,712,41,753,1595,47.21%,34.11%,1
臺北市,萬華區,1156,727,96,823,109,932,1701,54.79%,42.74%,1
臺北市,萬華區,1157,419,159,578,85,663,1339,49.51%,31.29%,1
臺北市,萬華區,1158,514,143,657,76,733,1484,49.39%,34.64%,1
臺北市,萬華區,1159,637,196,833,79,912,1604,56.86%,39.71%,1
臺北市,萬華區,1160,479,171,650,41,691,1197,57.73%,40.02%,1
臺北市,萬華區,1161,485,178,663,76,739,1347,54.86%,36.01%,1
臺北市,萬華區,1162,575,156,731,48,779,1223,63.7%,47.02%,1
臺北市,萬華區,1163,443,120,563,39,602,1036,58.11%,42.76%,1
臺北市,萬華區,1164,442,156,598,67,665,1035,64.25%,42.71%,1
臺北市,萬華區,1165,506,139,645,55,700,1141,61.35%,44.35%,1
臺北市,萬華區,1166,550,152,702,36,738,1271,58.06%,43.27%,1
臺北市,萬華區,1167,531,185,716,88,804,1328,60.54%,39.98%,1
臺北市,萬華區,1168,539,176,715,40,755,1286,58.71%,41.91%,1
臺北市,萬華區,1169,687,220,907,89,996,1679,59.32%,40.92%,1
臺北市,萬華區,1170,648,196,844,69,913,1619,56.39%,40.02%,1
臺北市,萬華區,1171,609,133,742,70,812,1625,49.97%,37.48%,1
臺北市,萬華區,1172,663,213,876,73,949,1623,58.47%,40.85%,1
臺北市,萬華區,1173,505,146,651,70,721,1280,56.33%,39.45%,1
臺北市,萬華區,1174,649,176,825,66,891,1608,55.41%,40.36%,1
臺北市,萬華區,1175,592,198,790,62,852,1453,58.64%,40.74%,1
臺北市,萬華區,1176,654,199,853,57,910,1472,61.82%,44.43%,1
臺北市,萬華區,1177,570,191,761,35,796,1373,57.98%,41.51%,1
臺北市,萬華區,1178,546,152,698,73,771,1394,55.31%,39.17%,1
臺北市,萬華區,1179,547,148,695,33,728,1427,51.02%,38.33%,1
臺北市,萬華區,1180,555,207,762,61,823,1342,61.33%,41.36%,1
臺北市,萬華區,1181,654,194,848,82,930,1569,59.27%,41.68%,1
臺北市,萬華區,1182,523,172,695,55,750,1514,49.54%,34.54%,1
臺北市,萬華區,1183,611,173,784,42,826,1720,48.02%,35.52%,1
臺北市,萬華區,1184,641,202,843,77,920,1461,62.97%,43.87%,1
臺北市,萬華區,1185,490,156,646,32,678,1264,53.64%,38.77%,1
臺北市,萬華區,1186,572,192,764,57,821,1334,61.54%,42.88%,1
臺北市,萬華區,1187,586,189,775,39,814,1446,56.29%,40.53%,1
臺北市,萬華區,1188,491,144,635,41,676,1307,51.72%,37.57%,1
臺北市,萬華區,1189,586,167,753,84,837,1420,58.94%,41.27%,1
臺北市,萬華區,1190,544,160,704,34,738,1427,51.72%,38.12%,1
臺北市,萬華區,1191,403,99,502,42,544,956,56.9%,42.15%,1
臺北市,萬華區,1192,579,150,729,65,794,1352,58.73%,42.83%,1
臺北市,萬華區,1193,597,125,722,54,776,1370,56.64%,43.58%,1
臺北市,萬華區,1194,601,91,692,41,733,1222,59.98%,49.18%,1
臺北市,萬華區,1195,619,107,726,52,778,1375,56.58%,45.02%,1
臺北市,萬華區,1196,528,269,797,62,859,1463,58.71%,36.09%,1
臺北市,萬華區,1197,581,155,736,43,779,1527,51.02%,38.05%,1
臺北市,萬華區,1198,626,126,752,52,804,1485,54.14%,42.15%,1
臺北市,萬華區,1199,805,133,938,43,981,1591,61.66%,50.6%,1
臺北市,萬華區,1200,729,153,882,34,916,1394,65.71%,52.3%,1
臺北市,萬華區,1201,661,160,821,38,859,1522,56.44%,43.43%,1
臺北市,萬華區,1202,816,149,965,38,1003,1661,60.39%,49.13%,1
臺北市,萬華區,1203,750,161,911,26,937,1561,60.03%,48.05%,1
臺北市,萬華區,1204,676,171,847,53,900,1406,64.01%,48.08%,1
臺北市,萬華區,1205,508,144,652,40,692,1498,46.19%,33.91%,1
臺北市,萬華區,1206,488,148,636,67,703,1478,47.56%,33.02%,1
臺北市,萬華區,1207,456,132,588,67,655,1170,55.98%,38.97%,1
臺北市,萬華區,1208,636,137,773,44,817,1376,59.38%,46.22%,1
臺北市,萬華區,1209,492,99,591,21,612,1093,55.99%,45.01%,1
臺北市,萬華區,1210,495,128,623,58,681,1084,62.82%,45.66%,1
臺北市,萬華區,1211,507,120,627,49,676,1119,60.41%,45.31%,1
臺北市,萬華區,1212,646,169,815,44,859,1381,62.2%,46.78%,1
臺北市,萬華區,1213,621,155,776,40,816,1396,58.45%,44.48%,1
臺北市,文山區,1402,612,218,830,33,863,1539,56.08%,39.77%,1
臺北市,文山區,1403,623,153,776,42,818,1548,52.84%,40.25%,1
臺北市,文山區,1404,621,212,833,68,901,1493,60.35%,41.59%,1
臺北市,文山區,1405,726,212,938,54,992,1648,60.19%,44.05%,1
臺北市,文山區,1406,667,175,842,55,897,1544,58.1%,43.2%,1
臺北市,文山區,1407,698,154,852,57,909,1557,58.38%,44.83%,1
臺北市,文山區,1408,657,145,802,46,848,1514,56.01%,43.39%,1
臺北市,文山區,1409,742,180,922,64,986,1540,64.03%,48.18%,1
臺北市,文山區,1410,681,179,860,48,908,1466,61.94%,46.45%,1
臺北市,文山區,1411,677,177,854,38,892,1444,61.77%,46.88%,1
臺北市,文山區,1412,636,189,825,57,882,1455,60.62%,43.71%,1
臺北市,文山區,1413,558,191,749,57,806,1440,55.97%,38.75%,1
臺北市,文山區,1414,636,169,805,55,860,1398,61.52%,45.49%,1
臺北市,文山區,1415,583,154,737,28,765,1412,54.18%,41.29%,1
臺北市,文山區,1416,615,164,779,44,823,1426,57.71%,43.13%,1
臺北市,文山區,1417,617,186,803,50,853,1437,59.36%,42.94%,1
臺北市,文山區,1418,617,150,767,43,810,1340,60.45%,46.04%,1
臺北市,文山區,1419,670,183,853,30,883,1568,56.31%,42.73%,1
臺北市,文山區,1420,592,158,750,27,777,1372,56.63%,43.15%,1
臺北市,文山區,1421,442,124,566,31,597,1046,57.07%,42.26%,1
臺北市,文山區,1422,536,154,690,45,735,1274,57.69%,42.07%,1
臺北市,文山區,1423,569,156,725,36,761,1324,57.48%,42.98%,1
臺北市,文山區,1424,715,223,938,50,988,1722,57.38%,41.52%,1
臺北市,文山區,1425,781,206,987,58,1045,1737,60.16%,44.96%,1
臺北市,文山區,1426,676,150,826,23,849,1370,61.97%,49.34%,1
臺北市,文山區,1427,630,200,830,51,881,1495,58.93%,42.14%,1
臺北市,文山區,1428,588,164,752,49,801,1328,60.32%,44.28%,1
臺北市,文山區,1429,506,145,651,57,708,1138,62.21%,44.46%,1
臺北市,文山區,1430,671,165,836,40,876,1471,59.55%,45.62%,1
臺北市,文山區,1431,529,149,678,35,713,1144,62.33%,46.24%,1
臺北市,文山區,1432,547,160,707,49,756,1176,64.29%,46.51%,1
臺北市,文山區,1433,539,172,711,49,760,1212,62.71%,44.47%,1
臺北市,文山區,1434,570,149,719,31,750,1214,61.78%,46.95%,1
臺北市,文山區,1435,465,172,637,38,675,1170,57.69%,39.74%,1
臺北市,文山區,1436,551,201,752,46,798,1308,61.01%,42.13%,1
臺北市,文山區,1437,522,150,672,53,725,1190,60.92%,43.87%,1
臺北市,文山區,1438,487,131,618,48,666,1110,60%,43.87%,1
臺北市,文山區,1439,653,181,834,57,891,1512,58.93%,43.19%,1
臺北市,文山區,1440,684,117,801,59,860,1387,62%,49.32%,1
臺北市,文山區,1441,605,155,760,51,811,1355,59.85%,44.65%,1
臺北市,文山區,1442,575,197,772,53,825,1370,60.22%,41.97%,1
臺北市,文山區,1443,636,157,793,64,857,1484,57.75%,42.86%,1
臺北市,文山區,1444,772,213,985,58,1043,1786,58.4%,43.23%,1
臺北市,文山區,1445,595,125,720,45,765,1260,60.71%,47.22%,1
臺北市,文山區,1446,578,171,749,27,776,1194,64.99%,48.41%,1
臺北市,文山區,1447,631,189,820,44,864,1444,59.83%,43.7%,1
臺北市,文山區,1448,694,153,847,52,899,1495,60.13%,46.42%,1
臺北市,文山區,1449,691,137,828,53,881,1446,60.93%,47.79%,1
臺北市,文山區,1450,625,154,779,78,857,1450,59.1%,43.1%,1
臺北市,文山區,1451,701,155,856,52,908,1486,61.1%,47.17%,1
臺北市,文山區,1452,582,151,733,39,772,1259,61.32%,46.23%,1
臺北市,文山區,1453,626,166,792,19,811,1317,61.58%,47.53%,1
臺北市,文山區,1454,627,161,788,42,830,1321,62.83%,47.46%,1
臺北市,文山區,1455,640,168,808,54,862,1475,58.44%,43.39%,1
臺北市,文山區,1456,546,140,686,48,734,1271,57.75%,42.96%,1
臺北市,文山區,1457,696,229,925,43,968,1609,60.16%,43.26%,1
臺北市,文山區,1458,655,145,800,29,829,1501,55.23%,43.64%,1
臺北市,文山區,1459,403,109,512,39,551,997,55.27%,40.42%,1
臺北市,文山區,1460,528,121,649,33,682,1052,64.83%,50.19%,1
臺北市,文山區,1461,594,134,728,36,764,1247,61.27%,47.63%,1
臺北市,文山區,1462,687,152,839,47,886,1167,75.92%,58.87%,1
臺北市,文山區,1463,569,170,739,36,775,1280,60.55%,44.45%,1
臺北市,文山區,1464,555,119,674,38,712,1153,61.75%,48.14%,1
臺北市,文山區,1465,737,71,808,47,855,1557,54.91%,47.33%,1
臺北市,文山區,1466,655,153,808,55,863,1444,59.76%,45.36%,1
臺北市,文山區,1467,734,151,885,51,936,1459,64.15%,50.31%,1
臺北市,文山區,1468,655,161,816,52,868,1357,63.96%,48.27%,1
臺北市,文山區,1469,596,157,753,41,794,1194,66.5%,49.92%,1
臺北市,文山區,1470,576,137,713,52,765,1184,64.61%,48.65%,1
臺北市,文山區,1471,517,147,664,51,715,1119,63.9%,46.2%,1
臺北市,文山區,1472,662,154,816,47,863,1350,63.93%,49.04%,1
臺北市,文山區,1473,634,159,793,51,844,1502,56.19%,42.21%,1
臺北市,文山區,1474,693,159,852,55,907,1511,60.03%,45.86%,1
臺北市,文山區,1475,709,183,892,39,931,1481,62.86%,47.87%,1
臺北市,文山區,1476,730,164,894,39,933,1477,63.17%,49.42%,1
臺北市,文山區,1477,595,155,750,51,801,1294,61.9%,45.98%,1
臺北市,文山區,1478,532,146,678,32,710,1040,68.27%,51.15%,1
臺北市,文山區,1479,628,161,789,41,830,1323,62.74%,47.47%,1
臺北市,文山區,1480,498,160,658,52,710,1153,61.58%,43.19%,1
臺北市,文山區,1481,686,162,848,58,906,1525,59.41%,44.98%,1
臺北市,文山區,1482,604,145,749,51,800,1412,56.66%,42.78%,1
臺北市,文山區,1483,678,200,878,56,934,1473,63.41%,46.03%,1
臺北市,文山區,1484,651,201,852,28,880,1486,59.22%,43.81%,1
臺北市,文山區,1485,793,168,961,53,1014,1616,62.75%,49.07%,1
臺北市,文山區,1486,708,181,889,57,946,1489,63.53%,47.55%,1
臺北市,文山區,1487,627,168,795,54,849,1414,60.04%,44.34%,1
臺北市,文山區,1488,734,177,911,56,967,1494,64.73%,49.13%,1
臺北市,文山區,1489,720,185,905,50,955,1547,61.73%,46.54%,1
臺北市,文山區,1490,689,218,907,60,967,1587,60.93%,43.42%,1
臺北市,文山區,1491,748,185,933,33,966,1515,63.76%,49.37%,1
臺北市,文山區,1492,725,203,928,57,985,1573,62.62%,46.09%,1
臺北市,文山區,1493,743,176,919,38,957,1542,62.06%,48.18%,1
臺北市,文山區,1494,603,147,750,62,812,1465,55.43%,41.16%,1
臺北市,文山區,1495,228,85,313,29,342,699,48.93%,32.62%,1
臺北市,文山區,1496,519,133,652,58,710,1372,51.75%,37.83%,1
臺北市,文山區,1497,563,128,691,59,750,1448,51.8%,38.88%,1
臺北市,文山區,1498,687,172,859,54,913,1548,58.98%,44.38%,1
臺北市,文山區,1499,687,171,858,38,896,1501,59.69%,45.77%,1
臺北市,文山區,1500,733,175,908,40,948,1560,60.77%,46.99%,1
臺北市,文山區,1501,688,180,868,40,908,1567,57.95%,43.91%,1
臺北市,文山區,1502,705,163,868,48,916,1554,58.94%,45.37%,1
臺北市,文山區,1503,693,169,862,54,916,1544,59.33%,44.88%,1
臺北市,文山區,1504,726,157,883,48,931,1528,60.93%,47.51%,1
臺北市,文山區,1505,742,192,934,34,968,1543,62.73%,48.09%,1
臺北市,文山區,1506,695,210,905,59,964,2754,35%,25.24%,1
臺北市,文山區,1507,649,175,824,70,894,1709,52.31%,37.98%,1
臺北市,文山區,1508,630,168,798,72,870,1515,57.43%,41.58%,1
臺北市,文山區,1509,623,171,794,66,860,1571,54.74%,39.66%,1
臺北市,文山區,1510,667,175,842,65,907,1578,57.48%,42.27%,1
臺北市,文山區,1511,591,174,765,58,823,1454,56.6%,40.65%,1
臺北市,文山區,1512,625,168,793,61,854,1436,59.47%,43.52%,1
臺北市,文山區,1513,653,169,822,54,876,1402,62.48%,46.58%,1
臺北市,文山區,1514,517,141,658,42,700,1117,62.67%,46.28%,1
臺北市,文山區,1515,469,121,590,59,649,1094,59.32%,42.87%,1
臺北市,文山區,1516,508,132,640,46,686,1070,64.11%,47.48%,1
臺北市,文山區,1517,660,147,807,35,842,1319,63.84%,50.04%,1
臺北市,文山區,1518,595,141,736,50,786,1226,64.11%,48.53%,1
臺北市,文山區,1519,596,146,742,43,785,1385,56.68%,43.03%,1
臺北市,文山區,1520,629,176,805,52,857,1416,60.52%,44.42%,1
臺北市,文山區,1521,788,63,851,48,899,1412,63.67%,55.81%,1
臺北市,文山區,1522,622,187,809,61,870,1535,56.68%,40.52%,1
臺北市,文山區,1523,802,198,1000,49,1049,1654,63.42%,48.49%,1
臺北市,文山區,1524,552,126,678,39,717,1156,62.02%,47.75%,1
臺北市,文山區,1525,594,134,728,45,773,1231,62.79%,48.25%,1
臺北市,文山區,1526,548,132,680,47,727,1218,59.69%,44.99%,1
臺北市,文山區,1527,593,132,725,31,756,1176,64.29%,50.43%,1
臺北市,文山區,1528,636,181,817,29,846,1392,60.78%,45.69%,1
臺北市,文山區,1529,553,148,701,93,794,1323,60.02%,41.8%,1
臺北市,文山區,1530,524,166,690,53,743,1297,57.29%,40.4%,1
臺北市,文山區,1531,615,138,753,65,818,1296,63.12%,47.45%,1
臺北市,文山區,1532,674,195,869,62,931,1613,57.72%,41.79%,1
臺北市,文山區,1533,749,215,964,63,1027,1697,60.52%,44.14%,1
臺北市,文山區,1534,710,156,866,70,936,1579,59.28%,44.97%,1
臺北市,文山區,1535,629,161,790,46,836,1320,63.33%,47.65%,1
臺北市,文山區,1536,646,145,791,31,822,1438,57.16%,44.92%,1
臺北市,文山區,1537,615,149,764,29,793,1465,54.13%,41.98%,1
臺北市,文山區,1538,690,232,922,65,987,1646,59.96%,41.92%,1
臺北市,文山區,1539,579,157,736,44,780,1286,60.65%,45.02%,1
臺北市,文山區,1540,558,151,709,40,749,1219,61.44%,45.78%,1
臺北市,文山區,1541,586,171,757,46,803,1292,62.15%,45.36%,1
臺北市,文山區,1542,626,163,789,58,847,1489,56.88%,42.04%,1
臺北市,文山區,1543,713,206,919,64,983,1611,61.02%,44.26%,1
臺北市,文山區,1544,584,76,660,51,711,1549,45.9%,37.7%,1
臺北市,文山區,1545,705,170,875,63,938,1678,55.9%,42.01%,1
臺北市,文山區,1546,688,190,878,67,945,1660,56.93%,41.45%,1
臺北市,文山區,1547,682,177,859,32,891,1816,49.06%,37.56%,1
臺北市,文山區,1548,405,124,529,36,565,985,57.36%,41.12%,1
臺北市,文山區,1549,662,131,793,26,819,1314,62.33%,50.38%,1
臺北市,文山區,1550,495,134,629,36,665,1018,65.32%,48.62%,1
臺北市,文山區,1551,685,202,887,45,932,1578,59.06%,43.41%,1
臺北市,文山區,1552,650,183,833,26,859,1457,58.96%,44.61%,1
臺北市,文山區,1553,616,150,766,52,818,1326,61.69%,46.46%,1
臺北市,文山區,1554,636,164,800,54,854,1393,61.31%,45.66%,1
臺北市,文山區,1555,569,158,727,61,788,1377,57.23%,41.32%,1
臺北市,文山區,1556,646,184,830,39,869,1448,60.01%,44.61%,1
臺北市,文山區,1557,688,178,866,47,913,1447,63.1%,47.55%,1
臺北市,文山區,1558,837,233,1070,60,1130,1739,64.98%,48.13%,1
臺北市,文山區,1559,682,156,838,37,875,1457,60.05%,46.81%,1
臺北市,文山區,1560,588,159,747,45,792,1288,61.49%,45.65%,1
臺北市,文山區,1561,504,141,645,69,714,1301,54.88%,38.74%,1
臺北市,文山區,1562,315,106,421,52,473,865,54.68%,36.42%,1
臺北市,文山區,1563,297,104,401,38,439,789,55.64%,37.64%,1
臺北市,南港區,0455,495,138,633,29,662,1280,51.72%,38.67%,1
臺北市,南港區,0456,557,163,720,28,748,1351,55.37%,41.23%,1
臺北市,南港區,0457,584,149,733,42,775,1345,57.62%,43.42%,1
臺北市,南港區,0458,515,184,699,47,746,1679,44.43%,30.67%,1
臺北市,南港區,0459,613,214,827,77,904,1680,53.81%,36.49%,1
臺北市,南港區,0460,626,160,786,49,835,1635,51.07%,38.29%,1
臺北市,南港區,0461,587,178,765,46,811,1459,55.59%,40.23%,1
臺北市,南港區,0462,720,196,916,32,948,1706,55.57%,42.2%,1
臺北市,南港區,0463,656,185,841,103,944,1674,56.39%,39.19%,1
臺北市,南港區,0464,754,53,807,20,827,1491,55.47%,50.57%,1
臺北市,南港區,0465,521,142,663,42,705,1086,64.92%,47.97%,1
臺北市,南港區,0466,575,147,722,57,779,1202,64.81%,47.84%,1
臺北市,南港區,0467,508,157,665,59,724,1198,60.43%,42.4%,1
臺北市,南港區,0468,543,163,706,33,739,1430,51.68%,37.97%,1
臺北市,南港區,0469,520,210,730,56,786,1275,61.65%,40.78%,1
臺北市,南港區,0470,634,181,815,52,867,1344,64.51%,47.17%,1
臺北市,南港區,0471,594,183,777,43,820,1391,58.95%,42.7%,1
臺北市,南港區,0472,656,136,792,30,822,1342,61.25%,48.88%,1
臺北市,南港區,0473,568,150,718,38,756,1389,54.43%,40.89%,1
臺北市,南港區,0474,621,192,813,40,853,1426,59.82%,43.55%,1
臺北市,南港區,0475,665,129,794,22,816,1359,60.04%,48.93%,1
臺北市,南港區,0476,581,158,739,53,792,1366,57.98%,42.53%,1
臺北市,南港區,0477,647,165,812,26,838,1441,58.15%,44.9%,1
臺北市,南港區,0478,582,193,775,61,836,1529,54.68%,38.06%,1
臺北市,南港區,0479,623,180,803,51,854,1618,52.78%,38.5%,1
臺北市,南港區,0480,527,161,688,64,752,1545,48.67%,34.11%,1
臺北市,南港區,0481,663,180,843,56,899,1569,57.3%,42.26%,1
臺北市,南港區,0482,637,161,798,36,834,1661,50.21%,38.35%,1
臺北市,南港區,0483,558,182,740,52,792,1518,52.17%,36.76%,1
臺北市,南港區,0484,679,208,887,69,956,1552,61.6%,43.75%,1
臺北市,南港區,0485,660,168,828,27,855,1658,51.57%,39.81%,1
臺北市,南港區,0486,670,210,880,58,938,1608,58.33%,41.67%,1
臺北市,南港區,0487,595,167,762,39,801,1475,54.31%,40.34%,1
臺北市,南港區,0488,782,232,1014,44,1058,1722,61.44%,45.41%,1
臺北市,南港區,0489,660,192,852,31,883,1383,63.85%,47.72%,1
臺北市,南港區,0490,626,153,779,45,824,1397,58.98%,44.81%,1
臺北市,南港區,0491,588,162,750,56,806,1352,59.62%,43.49%,1
臺北市,南港區,0492,602,161,763,46,809,1344,60.19%,44.79%,1
臺北市,南港區,0493,517,172,689,28,717,1385,51.77%,37.33%,1
臺北市,南港區,0494,575,166,741,49,790,1399,56.47%,41.1%,1
臺北市,南港區,0495,517,158,675,38,713,1381,51.63%,37.44%,1
臺北市,南港區,0496,636,185,821,41,862,1548,55.68%,41.09%,1
臺北市,南港區,0497,493,117,610,31,641,1190,53.87%,41.43%,1
臺北市,南港區,0498,630,196,826,38,864,1490,57.99%,42.28%,1
臺北市,南港區,0499,494,144,638,24,662,1096,60.4%,45.07%,1
臺北市,南港區,0500,573,151,724,24,748,1238,60.42%,46.28%,1
臺北市,南港區,0501,586,150,736,29,765,1271,60.19%,46.11%,1
臺北市,南港區,0502,493,129,622,49,671,1146,58.55%,43.02%,1
臺北市,南港區,0503,488,170,658,38,696,1232,56.49%,39.61%,1
臺北市,南港區,0504,627,167,794,28,822,1649,49.85%,38.02%,1
臺北市,南港區,0505,743,192,935,49,984,1688,58.29%,44.02%,1
臺北市,南港區,0506,664,187,851,39,890,1503,59.21%,44.18%,1
臺北市,南港區,0507,618,194,812,35,847,1542,54.93%,40.08%,1
臺北市,南港區,0508,634,181,815,53,868,1463,59.33%,43.34%,1
臺北市,南港區,0509,517,162,679,74,753,1195,63.01%,43.26%,1
臺北市,南港區,0510,509,214,723,15,738,1254,58.85%,40.59%,1
臺北市,南港區,0511,604,130,734,48,782,1356,57.67%,44.54%,1
臺北市,南港區,0512,598,180,778,56,834,1363,61.19%,43.87%,1
臺北市,南港區,0513,614,170,784,44,828,1317,62.87%,46.62%,1
臺北市,南港區,0514,587,152,739,31,770,1331,57.85%,44.1%,1
臺北市,南港區,0515,662,204,866,64,930,1610,57.76%,41.12%,1
臺北市,南港區,0516,629,182,811,27,838,1542,54.35%,40.79%,1
臺北市,南港區,0517,667,198,865,68,933,1581,59.01%,42.19%,1
臺北市,南港區,0518,574,146,720,43,763,1225,62.29%,46.86%,1
臺北市,南港區,0519,583,167,750,52,802,1264,63.45%,46.12%,1
臺北市,南港區,0520,730,195,925,81,1006,1649,61.01%,44.27%,1
臺北市,南港區,0521,594,134,728,23,751,1267,59.27%,46.88%,1
臺北市,南港區,0522,590,139,729,38,767,1336,57.41%,44.16%,1
臺北市,南港區,0523,554,131,685,27,712,1162,61.27%,47.68%,1
臺北市,南港區,0524,463,117,580,30,610,1045,58.37%,44.31%,1
臺北市,南港區,0525,649,158,807,56,863,1351,63.88%,48.04%,1
臺北市,南港區,0526,613,128,741,29,770,1358,56.7%,45.14%,1
臺北市,內湖區,0305,628,175,803,34,837,1661,50.39%,37.81%,1
臺北市,內湖區,0306,610,219,829,64,893,1602,55.74%,38.08%,1
臺北市,內湖區,0307,717,195,912,99,1011,1655,61.09%,43.32%,1
臺北市,內湖區,0308,682,217,899,51,950,1582,60.05%,43.11%,1
臺北市,內湖區,0309,701,183,884,37,921,1688,54.56%,41.53%,1
臺北市,內湖區,0310,621,314,935,58,993,1737,57.17%,35.75%,1
臺北市,內湖區,0311,788,213,1001,63,1064,1809,58.82%,43.56%,1
臺北市,內湖區,0312,567,160,727,59,786,1376,57.12%,41.21%,1
臺北市,內湖區,0313,770,199,969,91,1060,1747,60.68%,44.08%,1
臺北市,內湖區,0314,621,185,806,27,833,1389,59.97%,44.71%,1
臺北市,內湖區,0315,681,179,860,43,903,1454,62.1%,46.84%,1
臺北市,內湖區,0316,645,232,877,54,931,1468,63.42%,43.94%,1
臺北市,內湖區,0317,734,224,958,46,1004,1603,62.63%,45.79%,1
臺北市,內湖區,0318,729,226,955,31,986,1795,54.93%,40.61%,1
臺北市,內湖區,0319,795,229,1024,60,1084,1737,62.41%,45.77%,1
臺北市,內湖區,0320,748,215,963,80,1043,1744,59.81%,42.89%,1
臺北市,內湖區,0321,720,192,912,64,976,1661,58.76%,43.35%,1
臺北市,內湖區,0322,636,232,868,50,918,1577,58.21%,40.33%,1
臺北市,內湖區,0323,675,206,881,26,907,1494,60.71%,45.18%,1
臺北市,內湖區,0324,703,187,890,60,950,1626,58.43%,43.23%,1
臺北市,內湖區,0325,702,198,900,72,972,1641,59.23%,42.78%,1
臺北市,內湖區,0326,680,178,858,62,920,1554,59.2%,43.76%,1
臺北市,內湖區,0327,772,240,1012,55,1067,1728,61.75%,44.68%,1
臺北市,內湖區,0328,718,207,925,58,983,1736,56.62%,41.36%,1
臺北市,內湖區,0329,600,290,890,44,934,1461,63.93%,41.07%,1
臺北市,內湖區,0330,646,186,832,41,873,1509,57.85%,42.81%,1
臺北市,內湖區,0331,537,201,738,25,763,1358,56.19%,39.54%,1
臺北市,內湖區,0332,753,196,949,42,991,1761,56.27%,42.76%,1
臺北市,內湖區,0333,702,197,899,33,932,1651,56.45%,42.52%,1
臺北市,內湖區,0334,817,192,1009,71,1080,1809,59.7%,45.16%,1
臺北市,內湖區,0335,781,188,969,58,1027,1773,57.92%,44.05%,1
臺北市,內湖區,0336,794,199,993,50,1043,1890,55.19%,42.01%,1
臺北市,內湖區,0337,804,273,1077,62,1139,1760,64.72%,45.68%,1
臺北市,內湖區,0338,751,186,937,35,972,1645,59.09%,45.65%,1
臺北市,內湖區,0339,632,156,788,25,813,1324,61.4%,47.73%,1
臺北市,內湖區,0340,515,122,637,32,669,1072,62.41%,48.04%,1
臺北市,內湖區,0341,457,355,812,39,851,1509,56.39%,30.28%,1
臺北市,內湖區,0342,712,222,934,58,992,1715,57.84%,41.52%,1
臺北市,內湖區,0343,762,219,981,57,1038,1774,58.51%,42.95%,1
臺北市,內湖區,0344,818,248,1066,67,1133,1796,63.08%,45.55%,1
臺北市,內湖區,0345,734,241,975,36,1011,1784,56.67%,41.14%,1
臺北市,內湖區,0346,599,218,817,61,878,1417,61.96%,42.27%,1
臺北市,內湖區,0347,695,236,931,40,971,1699,57.15%,40.91%,1
臺北市,內湖區,0348,788,235,1023,56,1079,1719,62.77%,45.84%,1
臺北市,內湖區,0349,718,234,952,28,980,1715,57.14%,41.87%,1
臺北市,內湖區,0350,627,163,790,34,824,1634,50.43%,38.37%,1
臺北市,內湖區,0351,587,156,743,74,817,1435,56.93%,40.91%,1
臺北市,內湖區,0352,632,151,783,27,810,1440,56.25%,43.89%,1
臺北市,內湖區,0353,674,176,850,30,880,1446,60.86%,46.61%,1
臺北市,內湖區,0354,659,179,838,60,898,1657,54.19%,39.77%,1
臺北市,內湖區,0355,558,151,709,70,779,1261,61.78%,44.25%,1
臺北市,內湖區,0356,152,56,208,28,236,456,51.75%,33.33%,1
臺北市,內湖區,0357,712,190,902,40,942,1433,65.74%,49.69%,1
臺北市,內湖區,0358,643,215,858,39,897,1485,60.4%,43.3%,1
臺北市,內湖區,0359,676,194,870,41,911,1590,57.3%,42.52%,1
臺北市,內湖區,0360,584,145,729,52,781,1219,64.07%,47.91%,1
臺北市,內湖區,0361,723,190,913,58,971,1732,56.06%,41.74%,1
臺北市,內湖區,0362,801,170,971,29,1000,1727,57.9%,46.38%,1
臺北市,內湖區,0363,714,201,915,55,970,1637,59.25%,43.62%,1
臺北市,內湖區,0364,619,167,786,47,833,1453,57.33%,42.6%,1
臺北市,內湖區,0365,690,179,869,30,899,1617,55.6%,42.67%,1
臺北市,內湖區,0366,709,163,872,27,899,1604,56.05%,44.2%,1
臺北市,內湖區,0367,657,195,852,33,885,1406,62.94%,46.73%,1
臺北市,內湖區,0368,584,183,767,43,810,1353,59.87%,43.16%,1
臺北市,內湖區,0369,797,191,988,52,1040,1724,60.32%,46.23%,1
臺北市,內湖區,0370,602,186,788,44,832,1378,60.38%,43.69%,1
臺北市,內湖區,0371,658,152,810,39,849,1403,60.51%,46.9%,1
臺北市,內湖區,0372,658,168,826,35,861,1547,55.66%,42.53%,1
臺北市,內湖區,0373,738,238,976,55,1031,1718,60.01%,42.96%,1
臺北市,內湖區,0374,748,238,986,50,1036,1813,57.14%,41.26%,1
臺北市,內湖區,0375,819,233,1052,64,1116,1791,62.31%,45.73%,1
臺北市,內湖區,0376,826,247,1073,52,1125,1855,60.65%,44.53%,1
臺北市,內湖區,0377,770,190,960,32,992,1731,57.31%,44.48%,1
臺北市,內湖區,0378,767,196,963,57,1020,1593,64.03%,48.15%,1
臺北市,內湖區,0379,795,160,955,56,1011,1869,54.09%,42.54%,1
臺北市,內湖區,0380,767,191,958,57,1015,1687,60.17%,45.47%,1
臺北市,內湖區,0381,650,209,859,33,892,1530,58.3%,42.48%,1
臺北市,內湖區,0382,602,143,745,55,800,1300,61.54%,46.31%,1
臺北市,內湖區,0383,665,133,798,45,843,1314,64.16%,50.61%,1
臺北市,內湖區,0384,546,154,700,28,728,1433,50.8%,38.1%,1
臺北市,內湖區,0385,621,125,746,45,791,1450,54.55%,42.83%,1
臺北市,內湖區,0386,679,179,858,67,925,1608,57.52%,42.23%,1
臺北市,內湖區,0387,641,151,792,42,834,1414,58.98%,45.33%,1
臺北市,內湖區,0388,647,176,823,41,864,1492,57.91%,43.36%,1
臺北市,內湖區,0389,609,161,770,34,804,1528,52.62%,39.86%,1
臺北市,內湖區,0390,721,206,927,50,977,1692,57.74%,42.61%,1
臺北市,內湖區,0391,668,205,873,52,925,1556,59.45%,42.93%,1
臺北市,內湖區,0392,680,186,866,27,893,1637,54.55%,41.54%,1
臺北市,內湖區,0393,686,215,901,44,945,1749,54.03%,39.22%,1
臺北市,內湖區,0394,504,134,638,36,674,1220,55.25%,41.31%,1
臺北市,內湖區,0395,659,204,863,57,920,1600,57.5%,41.19%,1
臺北市,內湖區,0396,639,161,800,49,849,1473,57.64%,43.38%,1
臺北市,內湖區,0397,619,184,803,58,861,1498,57.48%,41.32%,1
臺北市,內湖區,0398,692,155,847,44,891,1557,57.23%,44.44%,1
臺北市,內湖區,0399,675,186,861,38,899,1674,53.7%,40.32%,1
臺北市,內湖區,0400,776,209,985,49,1034,1728,59.84%,44.91%,1
臺北市,內湖區,0401,260,98,358,40,398,788,50.51%,32.99%,1
臺北市,內湖區,0402,571,232,803,66,869,1542,56.36%,37.03%,1
臺北市,內湖區,0403,596,189,785,58,843,1676,50.3%,35.56%,1
臺北市,內湖區,0404,481,183,664,23,687,1360,50.51%,35.37%,1
臺北市,內湖區,0405,612,149,761,30,791,1259,62.83%,48.61%,1
臺北市,內湖區,0406,567,130,697,15,712,1301,54.73%,43.58%,1
臺北市,內湖區,0407,454,154,608,35,643,1251,51.4%,36.29%,1
臺北市,內湖區,0408,619,168,787,63,850,1502,56.59%,41.21%,1
臺北市,內湖區,0409,679,169,848,42,890,1596,55.76%,42.54%,1
臺北市,內湖區,0410,710,200,910,21,931,1649,56.46%,43.06%,1
臺北市,內湖區,0411,744,174,918,57,975,1774,54.96%,41.94%,1
臺北市,內湖區,0412,688,187,875,43,918,1746,52.58%,39.4%,1
臺北市,內湖區,0413,613,159,772,25,797,1473,54.11%,41.62%,1
臺北市,內湖區,0414,710,188,898,71,969,2824,34.31%,25.14%,1
臺北市,內湖區,0415,671,233,904,48,952,1849,51.49%,36.29%,1
臺北市,內湖區,0416,601,176,777,69,846,1530,55.29%,39.28%,1
臺北市,內湖區,0417,682,194,876,61,937,1656,56.58%,41.18%,1
臺北市,內湖區,0418,609,199,808,41,849,1457,58.27%,41.8%,1
臺北市,內湖區,0419,752,204,956,57,1013,1695,59.76%,44.37%,1
臺北市,內湖區,0420,744,201,945,39,984,1663,59.17%,44.74%,1
臺北市,內湖區,0421,709,181,890,54,944,1654,57.07%,42.87%,1
臺北市,內湖區,0422,726,200,926,54,980,1642,59.68%,44.21%,1
臺北市,內湖區,0423,708,208,916,38,954,1685,56.62%,42.02%,1
臺北市,內湖區,0424,745,245,990,56,1046,1862,56.18%,40.01%,1
臺北市,內湖區,0425,847,222,1069,59,1128,1900,59.37%,44.58%,1
臺北市,內湖區,0426,847,221,1068,67,1135,1790,63.41%,47.32%,1
臺北市,內湖區,0427,610,145,755,59,814,1417,57.45%,43.05%,1
臺北市,內湖區,0428,707,207,914,52,966,1694,57.02%,41.74%,1
臺北市,內湖區,0429,664,182,846,67,913,1676,54.47%,39.62%,1
臺北市,內湖區,0430,670,216,886,26,912,1643,55.51%,40.78%,1
臺北市,內湖區,0431,696,184,880,50,930,1588,58.56%,43.83%,1
臺北市,內湖區,0432,719,176,895,58,953,1603,59.45%,44.85%,1
臺北市,內湖區,0433,730,169,899,46,945,1629,58.01%,44.81%,1
臺北市,內湖區,0434,773,186,959,54,1013,1646,61.54%,46.96%,1
臺北市,內湖區,0435,784,207,991,50,1041,1883,55.28%,41.64%,1
臺北市,內湖區,0436,590,175,765,53,818,1434,57.04%,41.14%,1
臺北市,內湖區,0437,619,147,766,35,801,1418,56.49%,43.65%,1
臺北市,內湖區,0438,603,149,752,65,817,1373,59.5%,43.92%,1
臺北市,內湖區,0439,605,143,748,69,817,1349,60.56%,44.85%,1
臺北市,內湖區,0440,680,194,874,60,934,1511,61.81%,45%,1
臺北市,內湖區,0441,722,180,902,64,966,1563,61.8%,46.19%,1
臺北市,內湖區,0442,681,174,855,49,904,1550,58.32%,43.94%,1
臺北市,內湖區,0443,472,130,602,52,654,1157,56.53%,40.8%,1
臺北市,內湖區,0444,720,247,967,50,1017,1768,57.52%,40.72%,1
臺北市,內湖區,0445,745,174,919,54,973,1664,58.47%,44.77%,1
臺北市,內湖區,0446,738,215,953,69,1022,1743,58.63%,42.34%,1
臺北市,內湖區,0447,672,169,841,24,865,1480,58.45%,45.41%,1
臺北市,內湖區,0448,693,223,916,57,973,1589,61.23%,43.61%,1
臺北市,內湖區,0449,592,167,759,34,793,1371,57.84%,43.18%,1
臺北市,內湖區,0450,728,200,928,46,974,1575,61.84%,46.22%,1
臺北市,內湖區,0451,634,151,785,14,799,1377,58.02%,46.04%,1
臺北市,內湖區,0452,713,194,907,65,972,1469,66.17%,48.54%,1
臺北市,內湖區,0453,709,209,918,21,939,1529,61.41%,46.37%,1
臺北市,內湖區,0454,752,197,949,56,1005,1649,60.95%,45.6%,1
臺北市,士林區,0142,613,243,856,83,939,1695,55.4%,36.17%,1
臺北市,士林區,0143,706,216,922,93,1015,1720,59.01%,41.05%,1
臺北市,士林區,0144,519,150,669,76,745,1288,57.84%,40.3%,1
臺北市,士林區,0145,576,220,796,63,859,1546,55.56%,37.26%,1
臺北市,士林區,0146,303,77,380,31,411,652,63.04%,46.47%,1
臺北市,士林區,0147,352,95,447,38,485,870,55.75%,40.46%,1
臺北市,士林區,0148,442,214,656,50,706,1137,62.09%,38.87%,1
臺北市,士林區,0149,444,157,601,63,664,1050,63.24%,42.29%,1
臺北市,士林區,0150,449,134,583,59,642,1031,62.27%,43.55%,1
臺北市,士林區,0151,442,159,601,33,634,1075,58.98%,41.12%,1
臺北市,士林區,0152,363,108,471,49,520,2175,23.91%,16.69%,1
臺北市,士林區,0153,678,202,880,70,950,1775,53.52%,38.2%,1
臺北市,士林區,0154,731,107,838,44,882,1669,52.85%,43.8%,1
臺北市,士林區,0155,689,260,949,68,1017,1665,61.08%,41.38%,1
臺北市,士林區,0156,683,272,955,65,1020,1648,61.89%,41.44%,1
臺北市,士林區,0157,521,157,678,30,708,1246,56.82%,41.81%,1
臺北市,士林區,0158,541,194,735,77,812,1419,57.22%,38.13%,1
臺北市,士林區,0159,515,183,698,77,775,1327,58.4%,38.81%,1
臺北市,士林區,0160,643,254,897,79,976,1573,62.05%,40.88%,1
臺北市,士林區,0161,628,170,798,73,871,1470,59.25%,42.72%,1
臺北市,士林區,0162,695,253,948,27,975,1775,54.93%,39.15%,1
臺北市,士林區,0163,705,233,938,55,993,1692,58.69%,41.67%,1
臺北市,士林區,0164,749,263,1012,56,1068,1842,57.98%,40.66%,1
臺北市,士林區,0165,512,153,665,50,715,1166,61.32%,43.91%,1
臺北市,士林區,0166,601,197,798,76,874,1687,51.81%,35.63%,1
臺北市,士林區,0167,634,215,849,71,920,1624,56.65%,39.04%,1
臺北市,士林區,0168,622,204,826,97,923,1477,62.49%,42.11%,1
臺北市,士林區,0169,500,199,699,52,751,1250,60.08%,40%,1
臺北市,士林區,0170,580,185,765,92,857,1434,59.76%,40.45%,1
臺北市,士林區,0171,602,208,810,62,872,1452,60.06%,41.46%,1
臺北市,士林區,0172,670,221,891,70,961,1533,62.69%,43.71%,1
臺北市,士林區,0173,652,198,850,77,927,1515,61.19%,43.04%,1
臺北市,士林區,0174,494,178,672,59,731,1203,60.76%,41.06%,1
臺北市,士林區,0175,652,194,846,81,927,1487,62.34%,43.85%,1
臺北市,士林區,0176,514,161,675,37,712,1252,56.87%,41.05%,1
臺北市,士林區,0177,595,205,800,58,858,1536,55.86%,38.74%,1
臺北市,士林區,0178,589,277,866,77,943,1556,60.6%,37.85%,1
臺北市,士林區,0179,618,209,827,52,879,1511,58.17%,40.9%,1
臺北市,士林區,0180,665,228,893,74,967,1572,61.51%,42.3%,1
臺北市,士林區,0181,693,187,880,79,959,1668,57.49%,41.55%,1
臺北市,士林區,0182,668,189,857,102,959,1685,56.91%,39.64%,1
臺北市,士林區,0183,626,188,814,73,887,1568,56.57%,39.92%,1
臺北市,士林區,0184,508,174,682,47,729,1327,54.94%,38.28%,1
臺北市,士林區,0185,520,156,676,42,718,1338,53.66%,38.86%,1
臺北市,士林區,0186,564,181,745,60,805,1515,53.14%,37.23%,1
臺北市,士林區,0187,618,188,806,69,875,1452,60.26%,42.56%,1
臺北市,士林區,0188,606,181,787,60,847,1448,58.49%,41.85%,1
臺北市,士林區,0189,628,205,833,56,889,1521,58.45%,41.29%,1
臺北市,士林區,0190,561,217,778,41,819,1461,56.06%,38.4%,1
臺北市,士林區,0191,547,217,764,68,832,1541,53.99%,35.5%,1
臺北市,士林區,0192,499,192,691,59,750,1611,46.55%,30.97%,1
臺北市,士林區,0193,624,202,826,75,901,1595,56.49%,39.12%,1
臺北市,士林區,0194,647,180,827,39,866,1685,51.39%,38.4%,1
臺北市,士林區,0195,660,226,886,84,970,1816,53.41%,36.34%,1
臺北市,士林區,0196,639,230,869,91,960,1687,56.91%,37.88%,1
臺北市,士林區,0197,643,202,845,88,933,1646,56.68%,39.06%,1
臺北市,士林區,0198,644,174,818,64,882,1643,53.68%,39.2%,1
臺北市,士林區,0199,733,177,910,57,967,1687,57.32%,43.45%,1
臺北市,士林區,0200,667,226,893,79,972,1655,58.73%,40.3%,1
臺北市,士林區,0201,646,240,886,30,916,1779,51.49%,36.31%,1
臺北市,士林區,0202,740,266,1006,68,1074,1855,57.9%,39.89%,1
臺北市,士林區,0203,547,176,723,58,781,1350,57.85%,40.52%,1
臺北市,士林區,0204,548,158,706,30,736,1455,50.58%,37.66%,1
臺北市,士林區,0205,485,161,646,74,720,1497,48.1%,32.4%,1
臺北市,士林區,0206,442,161,603,64,667,1398,47.71%,31.62%,1
臺北市,士林區,0207,699,247,946,80,1026,1747,58.73%,40.01%,1
臺北市,士林區,0208,564,182,746,81,827,1465,56.45%,38.5%,1
臺北市,士林區,0209,585,210,795,71,866,1530,56.6%,38.24%,1
臺北市,士林區,0210,671,213,884,83,967,1855,52.13%,36.17%,1
臺北市,士林區,0211,550,195,745,78,823,1444,56.99%,38.09%,1
臺北市,士林區,0212,572,174,746,85,831,1563,53.17%,36.6%,1
臺北市,士林區,0213,574,195,769,78,847,1482,57.15%,38.73%,1
臺北市,士林區,0214,565,199,764,98,862,1552,55.54%,36.4%,1
臺北市,士林區,0215,704,228,932,78,1010,1790,56.42%,39.33%,1
臺北市,士林區,0216,599,172,771,83,854,1628,52.46%,36.79%,1
臺北市,士林區,0217,590,90,680,78,758,1337,56.69%,44.13%,1
臺北市,士林區,0218,682,214,896,93,989,1750,56.51%,38.97%,1
臺北市,士林區,0219,592,197,789,105,894,1668,53.6%,35.49%,1
臺北市,士林區,0220,433,153,586,83,669,1403,47.68%,30.86%,1
臺北市,士林區,0221,441,204,645,58,703,1468,47.89%,30.04%,1
臺北市,士林區,0222,480,175,655,41,696,1471,47.31%,32.63%,1
臺北市,士林區,0223,611,179,790,94,884,1666,53.06%,36.67%,1
臺北市,士林區,0224,559,203,762,61,823,1587,51.86%,35.22%,1
臺北市,士林區,0225,667,214,881,71,952,1987,47.91%,33.57%,1
臺北市,士林區,0226,470,132,602,22,624,1271,49.1%,36.98%,1
臺北市,士林區,0227,738,223,961,75,1036,1728,59.95%,42.71%,1
臺北市,士林區,0228,688,217,905,72,977,1630,59.94%,42.21%,1
臺北市,士林區,0229,657,235,892,61,953,1619,58.86%,40.58%,1
臺北市,士林區,0230,598,177,775,43,818,1425,57.4%,41.96%,1
臺北市,士林區,0231,693,235,928,69,997,1623,61.43%,42.7%,1
臺北市,士林區,0232,639,233,872,50,922,1564,58.95%,40.86%,1
臺北市,士林區,0233,636,201,837,201,1038,1376,75.44%,46.22%,1
臺北市,士林區,0234,733,164,897,43,940,1517,61.96%,48.32%,1
臺北市,士林區,0235,638,235,873,43,916,1729,52.98%,36.9%,1
臺北市,士林區,0236,692,185,877,49,926,1511,61.28%,45.8%,1
臺北市,士林區,0237,787,230,1017,52,1069,1811,59.03%,43.46%,1
臺北市,士林區,0238,646,173,819,44,863,1533,56.29%,42.14%,1
臺北市,士林區,0239,786,227,1013,61,1074,1657,64.82%,47.44%,1
臺北市,士林區,0240,633,170,803,44,847,1499,56.5%,42.23%,1
臺北市,士林區,0241,586,158,744,65,809,1402,57.7%,41.8%,1
臺北市,士林區,0242,552,211,763,68,831,1273,65.28%,43.36%,1
臺北市,士林區,0243,546,165,711,49,760,1273,59.7%,42.89%,1
臺北市,士林區,0244,522,198,720,54,774,1316,58.81%,39.67%,1
臺北市,士林區,0245,672,217,889,68,957,1659,57.69%,40.51%,1
臺北市,士林區,0246,676,240,916,41,957,1749,54.72%,38.65%,1
臺北市,士林區,0247,595,220,815,70,885,1552,57.02%,38.34%,1
臺北市,士林區,0248,671,175,846,50,896,1529,58.6%,43.88%,1
臺北市,士林區,0249,655,217,872,37,909,1644,55.29%,39.84%,1
臺北市,士林區,0250,707,238,945,62,1007,1779,56.6%,39.74%,1
臺北市,士林區,0251,635,225,860,50,910,1597,56.98%,39.76%,1
臺北市,士林區,0252,578,186,764,70,834,1454,57.36%,39.75%,1
臺北市,士林區,0253,662,252,914,48,962,1582,60.81%,41.85%,1
臺北市,士林區,0254,649,205,854,47,901,1518,59.35%,42.75%,1
臺北市,士林區,0255,555,190,745,26,771,1501,51.37%,36.98%,1
臺北市,士林區,0256,606,197,803,51,854,1420,60.14%,42.68%,1
臺北市,士林區,0257,616,188,804,63,867,1494,58.03%,41.23%,1
臺北市,士林區,0258,685,215,900,58,958,1568,61.1%,43.69%,1
臺北市,士林區,0259,517,206,723,42,765,1208,63.33%,42.8%,1
臺北市,士林區,0260,704,240,944,68,1012,1826,55.42%,38.55%,1
臺北市,士林區,0261,653,222,875,61,936,1647,56.83%,39.65%,1
臺北市,士林區,0262,679,198,877,66,943,1654,57.01%,41.05%,1
臺北市,士林區,0263,676,202,878,47,925,1550,59.68%,43.61%,1
臺北市,士林區,0264,574,188,762,53,815,1298,62.79%,44.22%,1
臺北市,士林區,0265,558,185,743,51,794,1297,61.22%,43.02%,1
臺北市,士林區,0266,557,157,714,49,763,1352,56.43%,41.2%,1
臺北市,士林區,0267,608,214,822,49,871,1522,57.23%,39.95%,1
臺北市,士林區,0268,577,246,823,88,911,1602,56.87%,36.02%,1
臺北市,士林區,0269,549,223,772,63,835,1441,57.95%,38.1%,1
臺北市,士林區,0270,503,171,674,26,700,1325,52.83%,37.96%,1
臺北市,士林區,0271,642,209,851,48,899,1567,57.37%,40.97%,1
臺北市,士林區,0272,600,210,810,34,844,1518,55.6%,39.53%,1
臺北市,士林區,0273,667,223,890,54,944,1549,60.94%,43.06%,1
臺北市,士林區,0274,660,228,888,34,922,1652,55.81%,39.95%,1
臺北市,士林區,0275,768,221,989,74,1063,1766,60.19%,43.49%,1
臺北市,士林區,0276,638,220,858,31,889,1638,54.27%,38.95%,1
臺北市,士林區,0277,657,186,843,53,896,1491,60.09%,44.06%,1
臺北市,士林區,0278,638,198,836,38,874,1521,57.46%,41.95%,1
臺北市,士林區,0279,604,165,769,56,825,1351,61.07%,44.71%,1
臺北市,士林區,0280,654,220,874,34,908,1742,52.12%,37.54%,1
臺北市,士林區,0281,630,220,850,63,913,1585,57.6%,39.75%,1
臺北市,士林區,0282,644,191,835,54,889,1521,58.45%,42.34%,1
臺北市,士林區,0283,623,192,815,49,864,1543,55.99%,40.38%,1
臺北市,士林區,0284,607,179,786,45,831,1404,59.19%,43.23%,1
臺北市,士林區,0285,637,214,851,44,895,1541,58.08%,41.34%,1
臺北市,士林區,0286,633,194,827,62,889,1584,56.12%,39.96%,1
臺北市,士林區,0287,625,224,849,59,908,1519,59.78%,41.15%,1
臺北市,士林區,0288,547,189,736,30,766,1482,51.69%,36.91%,1
臺北市,士林區,0289,505,154,659,57,716,1243,57.6%,40.63%,1
臺北市,士林區,0290,451,160,611,53,664,1156,57.44%,39.01%,1
臺北市,士林區,0291,452,161,613,69,682,1262,54.04%,35.82%,1
臺北市,士林區,0292,353,138,491,40,531,889,59.73%,39.71%,1
臺北市,士林區,0293,337,200,537,46,583,858,67.95%,39.28%,1
臺北市,士林區,0294,328,156,484,51,535,945,56.61%,34.71%,1
臺北市,士林區,0295,370,110,480,32,512,960,53.33%,38.54%,1
臺北市,士林區,0296,359,93,452,44,496,876,56.62%,40.98%,1
臺北市,士林區,0297,234,100,334,29,363,556,65.29%,42.09%,1
臺北市,士林區,0298,396,115,511,61,572,919,62.24%,43.09%,1
臺北市,士林區,0299,568,231,799,102,901,1360,66.25%,41.76%,1
臺北市,士林區,0300,534,202,736,90,826,1355,60.96%,39.41%,1
臺北市,士林區,0301,548,151,699,44,743,1252,59.35%,43.77%,1
臺北市,士林區,0302,561,128,689,50,739,1182,62.52%,47.46%,1
臺北市,士林區,0303,516,130,646,29,675,1431,47.17%,36.06%,1
臺北市,士林區,0304,485,144,629,36,665,1240,53.63%,39.11%,1
臺北市,北投區,0001,556,178,734,68,802,1313,61.08%,42.35%,1
臺北市,北投區,0002,582,237,819,45,864,1403,61.58%,41.48%,1
臺北市,北投區,0003,427,184,611,55,666,1081,61.61%,39.5%,1
臺北市,北投區,0004,510,164,674,52,726,1209,60.05%,42.18%,1
臺北市,北投區,0005,530,188,718,54,772,1326,58.22%,39.97%,1
臺北市,北投區,0006,525,178,703,62,765,1263,60.57%,41.57%,1
臺北市,北投區,0007,670,222,892,59,951,1580,60.19%,42.41%,1
臺北市,北投區,0008,672,211,883,45,928,1577,58.85%,42.61%,1
臺北市,北投區,0009,632,183,815,70,885,1483,59.68%,42.62%,1
臺北市,北投區,0010,605,166,771,42,813,1461,55.65%,41.41%,1
臺北市,北投區,0011,571,198,769,71,840,1466,57.3%,38.95%,1
臺北市,北投區,0012,689,205,894,63,957,1620,59.07%,42.53%,1
臺北市,北投區,0013,593,174,767,29,796,1543,51.59%,38.43%,1
臺北市,北投區,0014,561,185,746,69,815,1513,53.87%,37.08%,1
臺北市,北投區,0015,645,173,818,48,866,1534,56.45%,42.05%,1
臺北市,北投區,0016,722,185,907,75,982,1650,59.52%,43.76%,1
臺北市,北投區,0017,651,174,825,43,868,1533,56.62%,42.47%,1
臺北市,北投區,0018,670,214,884,53,937,1702,55.05%,39.37%,1
臺北市,北投區,0019,678,239,917,55,972,1721,56.48%,39.4%,1
臺北市,北投區,0020,644,252,896,64,960,1575,60.95%,40.89%,1
臺北市,北投區,0021,632,196,828,74,902,1530,58.95%,41.31%,1
臺北市,北投區,0022,725,210,935,67,1002,1728,57.99%,41.96%,1
臺北市,北投區,0023,697,207,904,73,977,1702,57.4%,40.95%,1
臺北市,北投區,0024,652,232,884,72,956,1696,56.37%,38.44%,1
臺北市,北投區,0025,592,170,762,36,798,1684,47.39%,35.15%,1
臺北市,北投區,0026,750,205,955,73,1028,1717,59.87%,43.68%,1
臺北市,北投區,0027,664,210,874,45,919,1605,57.26%,41.37%,1
臺北市,北投區,0028,717,214,931,53,984,1723,57.11%,41.61%,1
臺北市,北投區,0029,683,233,916,62,978,1597,61.24%,42.77%,1
臺北市,北投區,0030,677,235,912,50,962,1700,56.59%,39.82%,1
臺北市,北投區,0031,578,192,770,43,813,1544,52.66%,37.44%,1
臺北市,北投區,0032,618,194,812,58,870,1635,53.21%,37.8%,1
臺北市,北投區,0033,639,181,820,37,857,1495,57.32%,42.74%,1
臺北市,北投區,0034,685,213,898,32,930,1619,57.44%,42.31%,1
臺北市,北投區,0035,657,250,907,49,956,1683,56.8%,39.04%,1
臺北市,北投區,0036,618,187,805,65,870,1662,52.35%,37.18%,1
臺北市,北投區,0037,654,201,855,42,897,1850,48.49%,35.35%,1
臺北市,北投區,0038,615,211,826,26,852,1674,50.9%,36.74%,1
臺北市,北投區,0039,681,180,861,55,916,1511,60.62%,45.07%,1
臺北市,北投區,0040,551,179,730,26,756,1393,54.27%,39.55%,1
臺北市,北投區,0041,603,150,753,57,810,1279,63.33%,47.15%,1
臺北市,北投區,0042,471,114,585,36,621,1122,55.35%,41.98%,1
臺北市,北投區,0043,646,157,803,56,859,1238,69.39%,52.18%,1
臺北市,北投區,0044,651,201,852,60,912,1477,61.75%,44.08%,1
臺北市,北投區,0045,650,190,840,72,912,1495,61%,43.48%,1
臺北市,北投區,0046,672,200,872,45,917,1469,62.42%,45.75%,1
臺北市,北投區,0047,640,161,801,59,860,1462,58.82%,43.78%,1
臺北市,北投區,0048,618,163,781,69,850,1431,59.4%,43.19%,1
臺北市,北投區,0049,583,109,692,46,738,1486,49.66%,39.23%,1
臺北市,北投區,0050,615,206,821,60,881,1449,60.8%,42.44%,1
臺北市,北投區,0051,606,188,794,37,831,1456,57.07%,41.62%,1
臺北市,北投區,0052,527,166,693,34,727,1311,55.45%,40.2%,1
臺北市,北投區,0053,564,154,718,64,782,1356,57.67%,41.59%,1
臺北市,北投區,0054,544,182,726,38,764,1338,57.1%,40.66%,1
臺北市,北投區,0055,636,183,819,31,850,1525,55.74%,41.7%,1
臺北市,北投區,0056,635,186,821,47,868,1620,53.58%,39.2%,1
臺北市,北投區,0057,599,145,744,32,776,1499,51.77%,39.96%,1
臺北市,北投區,0058,678,160,838,36,874,1497,58.38%,45.29%,1
臺北市,北投區,0059,652,202,854,60,914,1624,56.28%,40.15%,1
臺北市,北投區,0060,590,164,754,85,839,1536,54.62%,38.41%,1
臺北市,北投區,0061,624,194,818,82,900,1469,61.27%,42.48%,1
臺北市,北投區,0062,619,216,835,54,889,1598,55.63%,38.74%,1
臺北市,北投區,0063,665,207,872,37,909,1690,53.79%,39.35%,1
臺北市,北投區,0064,613,195,808,98,906,1599,56.66%,38.34%,1
臺北市,北投區,0065,652,211,863,71,934,1634,57.16%,39.9%,1
臺北市,北投區,0066,610,214,824,55,879,1660,52.95%,36.75%,1
臺北市,北投區,0067,710,217,927,64,991,1900,52.16%,37.37%,1
臺北市,北投區,0068,728,237,965,61,1026,1797,57.1%,40.51%,1
臺北市,北投區,0069,719,260,979,77,1056,1832,57.64%,39.25%,1
臺北市,北投區,0070,751,232,983,63,1046,1784,58.63%,42.1%,1
臺北市,北投區,0071,709,241,950,57,1007,1732,58.14%,40.94%,1
臺北市,北投區,0072,393,102,495,60,555,2035,27.27%,19.31%,1
臺北市,北投區,0073,607,181,788,76,864,1504,57.45%,40.36%,1
臺北市,北投區,0074,720,200,920,79,999,1683,59.36%,42.78%,1
臺北市,北投區,0075,613,206,819,83,902,1635,55.17%,37.49%,1
臺北市,北投區,0076,634,197,831,69,900,1613,55.8%,39.31%,1
臺北市,北投區,0077,589,144,733,37,770,1483,51.92%,39.72%,1
臺北市,北投區,0078,588,207,795,46,841,1500,56.07%,39.2%,1
臺北市,北投區,0079,614,183,797,70,867,1483,58.46%,41.4%,1
臺北市,北投區,0080,601,210,811,62,873,1544,56.54%,38.92%,1
臺北市,北投區,0081,528,151,679,75,754,1532,49.22%,34.46%,1
臺北市,北投區,0082,726,232,958,68,1026,1819,56.4%,39.91%,1
臺北市,北投區,0083,624,258,882,80,962,1863,51.64%,33.49%,1
臺北市,北投區,0084,623,234,857,31,888,1872,47.44%,33.28%,1
臺北市,北投區,0085,617,202,819,59,878,1627,53.96%,37.92%,1
臺北市,北投區,0086,647,192,839,38,877,1696,51.71%,38.15%,1
臺北市,北投區,0087,709,240,949,61,1010,1841,54.86%,38.51%,1
臺北市,北投區,0088,536,154,690,62,752,1324,56.8%,40.48%,1
臺北市,北投區,0089,591,149,740,45,785,1504,52.19%,39.3%,1
臺北市,北投區,0090,611,178,789,57,846,1511,55.99%,40.44%,1
臺北市,北投區,0091,649,248,897,51,948,1615,58.7%,40.19%,1
臺北市,北投區,0092,492,132,624,38,662,1270,52.13%,38.74%,1
臺北市,北投區,0093,516,170,686,37,723,1492,48.46%,34.58%,1
臺北市,北投區,0094,514,192,706,49,755,1429,52.83%,35.97%,1
臺北市,北投區,0095,621,167,788,23,811,1567,51.75%,39.63%,1
臺北市,北投區,0096,555,174,729,49,778,1388,56.05%,39.99%,1
臺北市,北投區,0097,538,165,703,25,728,1448,50.28%,37.15%,1
臺北市,北投區,0098,498,171,669,55,724,1356,53.39%,36.73%,1
臺北市,北投區,0099,542,144,686,47,733,1308,56.04%,41.44%,1
臺北市,北投區,0100,497,138,635,52,687,1165,58.97%,42.66%,1
臺北市,北投區,0101,611,157,768,67,835,1429,58.43%,42.76%,1
臺北市,北投區,0102,601,148,749,36,785,1472,53.33%,40.83%,1
臺北市,北投區,0103,670,201,871,64,935,1508,62%,44.43%,1
臺北市,北投區,0104,586,193,779,61,840,1480,56.76%,39.59%,1
臺北市,北投區,0105,425,144,569,47,616,1142,53.94%,37.22%,1
臺北市,北投區,0106,615,159,774,47,821,1554,52.83%,39.58%,1
臺北市,北投區,0107,699,206,905,93,998,1669,59.8%,41.88%,1
臺北市,北投區,0108,768,207,975,75,1050,1823,57.6%,42.13%,1
臺北市,北投區,0109,682,168,850,101,951,1739,54.69%,39.22%,1
臺北市,北投區,0110,696,192,888,64,952,1771,53.75%,39.3%,1
臺北市,北投區,0111,572,153,725,50,775,1468,52.79%,38.96%,1
臺北市,北投區,0112,585,175,760,42,802,1469,54.59%,39.82%,1
臺北市,北投區,0113,568,100,668,43,711,1094,64.99%,51.92%,1
臺北市,北投區,0114,544,115,659,42,701,1101,63.67%,49.41%,1
臺北市,北投區,0115,742,69,811,55,866,1422,60.9%,52.18%,1
臺北市,北投區,0116,600,119,719,57,776,1390,55.83%,43.17%,1
臺北市,北投區,0117,555,157,712,67,779,1307,59.6%,42.46%,1
臺北市,北投區,0118,536,153,689,81,770,1215,63.37%,44.12%,1
臺北市,北投區,0119,637,166,803,42,845,1642,51.46%,38.79%,1
臺北市,北投區,0120,659,136,795,34,829,1623,51.08%,40.6%,1
臺北市,北投區,0121,653,177,830,65,895,1621,55.21%,40.28%,1
臺北市,北投區,0122,551,165,716,21,737,1367,53.91%,40.31%,1
臺北市,北投區,0123,477,183,660,57,717,1309,54.77%,36.44%,1
臺北市,北投區,0124,571,168,739,32,771,1356,56.86%,42.11%,1
臺北市,北投區,0125,545,152,697,54,751,1365,55.02%,39.93%,1
臺北市,北投區,0126,601,209,810,47,857,1613,53.13%,37.26%,1
臺北市,北投區,0127,553,170,723,39,762,1590,47.92%,34.78%,1
臺北市,北投區,0128,687,216,903,67,970,1662,58.36%,41.34%,1
臺北市,北投區,0129,660,213,873,58,931,1622,57.4%,40.69%,1
臺北市,北投區,0130,670,264,934,43,977,1820,53.68%,36.81%,1
臺北市,北投區,0131,667,204,871,67,938,1615,58.08%,41.3%,1
臺北市,北投區,0132,532,150,682,70,752,1612,46.65%,33%,1
臺北市,北投區,0133,745,90,835,78,913,1652,55.27%,45.1%,1
臺北市,北投區,0134,684,195,879,33,912,1666,54.74%,41.06%,1
臺北市,北投區,0135,632,203,835,51,886,1641,53.99%,38.51%,1
臺北市,北投區,0136,215,64,279,40,319,528,60.42%,40.72%,1
臺北市,北投區,0137,531,178,709,75,784,1642,47.75%,32.34%,1
臺北市,北投區,0138,347,87,434,35,469,829,56.57%,41.86%,1
臺北市,北投區,0139,280,71,351,31,382,690,55.36%,40.58%,1
臺北市,北投區,0140,416,116,532,52,584,1067,54.73%,38.99%,1
臺北市,北投區,0141,366,90,456,51,507,892,56.84%,41.03%,1
新北市,板橋區,0894,514,183,697,72,769,1388,55.4%,37.03%,1
新北市,板橋區,0895,517,195,712,49,761,1294,58.81%,39.95%,1
新北市,板橋區,0896,291,88,379,18,397,667,59.52%,43.63%,1
新北市,板橋區,0897,321,112,433,41,474,898,52.78%,35.75%,1
新北市,板橋區,0898,363,107,470,34,504,829,60.8%,43.79%,1
新北市,板橋區,0899,345,75,420,40,460,739,62.25%,46.68%,1
新北市,板橋區,0900,431,143,574,55,629,1035,60.77%,41.64%,1
新北市,板橋區,0901,570,158,728,34,762,1713,44.48%,33.27%,1
新北市,板橋區,0902,246,63,309,18,327,658,49.7%,37.39%,1
新北市,板橋區,0903,497,144,641,93,734,1312,55.95%,37.88%,1
新北市,板橋區,0904,535,164,699,64,763,1492,51.14%,35.86%,1
新北市,板橋區,0905,496,179,675,65,740,1393,53.12%,35.61%,1
新北市,板橋區,0906,602,216,818,61,879,4742,18.54%,12.7%,1
新北市,板橋區,0907,565,152,717,36,753,1439,52.33%,39.26%,1
新北市,板橋區,0908,494,150,644,71,715,1187,60.24%,41.62%,1
新北市,板橋區,0909,455,123,578,33,611,1122,54.46%,40.55%,1
新北市,板橋區,0910,567,157,724,59,783,1363,57.45%,41.6%,1
新北市,板橋區,0911,454,142,596,52,648,1093,59.29%,41.54%,1
新北市,板橋區,0912,541,175,716,51,767,1331,57.63%,40.65%,1
新北市,板橋區,0913,455,132,587,54,641,1026,62.48%,44.35%,1
新北市,板橋區,0914,518,137,655,70,725,1244,58.28%,41.64%,1
新北市,板橋區,0915,469,141,610,80,690,1268,54.42%,36.99%,1
新北市,板橋區,0916,463,145,608,40,648,1313,49.35%,35.26%,1
新北市,板橋區,0917,533,145,678,52,730,1196,61.04%,44.57%,1
新北市,板橋區,0918,563,162,725,49,774,1137,68.07%,49.52%,1
新北市,板橋區,0919,568,180,748,57,805,1269,63.44%,44.76%,1
新北市,板橋區,0920,506,134,640,27,667,1117,59.71%,45.3%,1
新北市,板橋區,0921,488,114,602,57,659,1042,63.24%,46.83%,1
新北市,板橋區,0922,520,162,682,77,759,1257,60.38%,41.37%,1
新北市,板橋區,0923,505,139,644,79,723,1216,59.46%,41.53%,1
新北市,板橋區,0924,473,124,597,60,657,1126,58.35%,42.01%,1
新北市,板橋區,0925,604,176,780,64,844,1290,65.43%,46.82%,1
新北市,板橋區,0926,455,128,583,13,596,1215,49.05%,37.45%,1
新北市,板橋區,0927,411,129,540,27,567,1099,51.59%,37.4%,1
新北市,板橋區,0928,700,126,826,44,870,1329,65.46%,52.67%,1
新北市,板橋區,0929,479,94,573,34,607,996,60.94%,48.09%,1
新北市,板橋區,0930,456,123,579,41,620,1047,59.22%,43.55%,1
新北市,板橋區,0931,547,156,703,62,765,1272,60.14%,43%,1
新北市,板橋區,0932,540,150,690,55,745,1252,59.5%,43.13%,1
新北市,板橋區,0933,502,161,663,68,731,1238,59.05%,40.55%,1
新北市,板橋區,0934,637,168,805,78,883,1389,63.57%,45.86%,1
新北市,板橋區,0935,499,172,671,72,743,1194,62.23%,41.79%,1
新北市,板橋區,0936,412,111,523,59,582,1093,53.25%,37.69%,1
新北市,板橋區,0937,447,136,583,74,657,1148,57.23%,38.94%,1
新北市,板橋區,0938,536,154,690,44,734,1268,57.89%,42.27%,1
新北市,板橋區,0939,494,153,647,71,718,1230,58.37%,40.16%,1
新北市,板橋區,0940,408,115,523,53,576,1012,56.92%,40.32%,1
新北市,板橋區,0941,343,96,439,47,486,811,59.93%,42.29%,1
新北市,板橋區,0942,519,156,675,77,752,1197,62.82%,43.36%,1
新北市,板橋區,0943,459,121,580,29,609,1142,53.33%,40.19%,1
新北市,板橋區,0944,486,150,636,57,693,1222,56.71%,39.77%,1
新北市,板橋區,0945,361,101,462,44,506,796,63.57%,45.35%,1
新北市,板橋區,0946,465,106,571,76,647,997,64.89%,46.64%,1
新北市,板橋區,0947,388,169,557,30,587,1011,58.06%,38.38%,1
新北市,板橋區,0948,460,143,603,64,667,1157,57.65%,39.76%,1
新北市,板橋區,0949,450,125,575,60,635,1040,61.06%,43.27%,1
新北市,板橋區,0950,530,136,666,42,708,1173,60.36%,45.18%,1
新北市,板橋區,0951,476,140,616,28,644,1193,53.98%,39.9%,1
新北市,板橋區,0952,533,156,689,40,729,1255,58.09%,42.47%,1
新北市,板橋區,0953,513,179,692,60,752,1306,57.58%,39.28%,1
新北市,板橋區,0954,441,123,564,15,579,1050,55.14%,42%,1
新北市,板橋區,0955,379,129,508,33,541,942,57.43%,40.23%,1
新北市,板橋區,0956,492,161,653,58,711,1133,62.75%,43.42%,1
新北市,板橋區,0957,527,148,675,52,727,1251,58.11%,42.13%,1
新北市,板橋區,0958,575,153,728,39,767,1293,59.32%,44.47%,1
新北市,板橋區,0959,433,152,585,67,652,1208,53.97%,35.84%,1
新北市,板橋區,0960,484,151,635,75,710,1223,58.05%,39.57%,1
新北市,板橋區,0961,422,127,549,55,604,1061,56.93%,39.77%,1
新北市,板橋區,0962,643,164,807,46,853,1515,56.3%,42.44%,1
新北市,板橋區,0963,530,158,688,67,755,1225,61.63%,43.27%,1
新北市,板橋區,0964,563,116,679,30,709,1120,63.3%,50.27%,1
新北市,板橋區,0965,523,124,647,40,687,1091,62.97%,47.94%,1
新北市,板橋區,0966,695,114,809,43,852,1385,61.52%,50.18%,1
新北市,板橋區,0967,535,188,723,70,793,1283,61.81%,41.7%,1
新北市,板橋區,0968,479,146,625,93,718,1204,59.63%,39.78%,1
新北市,板橋區,0969,559,139,698,59,757,1191,63.56%,46.94%,1
新北市,板橋區,0970,474,148,622,64,686,1078,63.64%,43.97%,1
新北市,板橋區,0971,540,178,718,78,796,1351,58.92%,39.97%,1
新北市,板橋區,0972,549,161,710,68,778,1322,58.85%,41.53%,1
新北市,板橋區,0973,351,116,467,61,528,868,60.83%,40.44%,1
新北市,板橋區,0974,450,165,615,76,691,1029,67.15%,43.73%,1
新北市,板橋區,0975,691,204,895,40,935,1602,58.36%,43.13%,1
新北市,板橋區,0976,568,182,750,69,819,1362,60.13%,41.7%,1
新北市,板橋區,0977,663,208,871,91,962,1698,56.65%,39.05%,1
新北市,板橋區,0978,646,154,800,48,848,1495,56.72%,43.21%,1
新北市,板橋區,0979,531,229,760,85,845,1522,55.52%,34.89%,1
新北市,板橋區,0980,544,138,682,72,754,1279,58.95%,42.53%,1
新北市,板橋區,0981,511,151,662,64,726,1559,46.57%,32.78%,1
新北市,板橋區,0982,538,187,725,104,829,1537,53.94%,35%,1
新北市,板橋區,0983,520,175,695,92,787,1531,51.4%,33.96%,1
新北市,板橋區,0984,648,208,856,38,894,1720,51.98%,37.67%,1
新北市,板橋區,0985,431,125,556,43,599,1165,51.42%,37%,1
新北市,板橋區,0986,793,203,996,64,1060,1857,57.08%,42.7%,1
新北市,板橋區,0987,427,133,560,71,631,1078,58.53%,39.61%,1
新北市,板橋區,0988,431,152,583,26,609,1177,51.74%,36.62%,1
新北市,板橋區,0989,734,222,956,62,1018,1798,56.62%,40.82%,1
新北市,板橋區,0990,603,167,770,110,880,1455,60.48%,41.44%,1
新北市,板橋區,0991,519,177,696,68,764,1245,61.37%,41.69%,1
新北市,板橋區,0992,601,234,835,96,931,1704,54.64%,35.27%,1
新北市,板橋區,0993,692,185,877,44,921,1600,57.56%,43.25%,1
新北市,板橋區,0994,509,160,669,40,709,1409,50.32%,36.12%,1
新北市,板橋區,0995,476,170,646,60,706,1286,54.9%,37.01%,1
新北市,板橋區,0996,394,150,544,124,668,1359,49.15%,28.99%,1
新北市,板橋區,0997,430,146,576,54,630,1188,53.03%,36.2%,1
新北市,板橋區,0998,600,177,777,59,836,1627,51.38%,36.88%,1
新北市,板橋區,0999,552,163,715,37,752,1633,46.05%,33.8%,1
新北市,板橋區,1000,761,224,985,107,1092,1814,60.2%,41.95%,1
新北市,板橋區,1001,719,224,943,87,1030,1810,56.91%,39.72%,1
新北市,板橋區,1002,444,131,575,83,658,1133,58.08%,39.19%,1
新北市,板橋區,1003,331,100,431,42,473,841,56.24%,39.36%,1
新北市,板橋區,1004,459,138,597,61,658,1050,62.67%,43.71%,1
新北市,板橋區,1005,419,137,556,79,635,1130,56.19%,37.08%,1
新北市,板橋區,1006,452,136,588,72,660,1056,62.5%,42.8%,1
新北市,板橋區,1007,421,126,547,32,579,1129,51.28%,37.29%,1
新北市,板橋區,1008,671,215,886,88,974,1713,56.86%,39.17%,1
新北市,板橋區,1009,665,202,867,76,943,1622,58.14%,41%,1
新北市,板橋區,1010,659,168,827,64,891,1427,62.44%,46.18%,1
新北市,板橋區,1011,696,171,867,29,896,1471,60.91%,47.31%,1
新北市,板橋區,1012,425,58,483,25,508,1076,47.21%,39.5%,1
新北市,板橋區,1013,343,97,440,16,456,979,46.58%,35.04%,1
新北市,板橋區,1014,509,123,632,34,666,1079,61.72%,47.17%,1
新北市,板橋區,1015,306,102,408,63,471,828,56.88%,36.96%,1
新北市,板橋區,1016,315,131,446,67,513,820,62.56%,38.41%,1
新北市,板橋區,1017,402,125,527,42,569,989,57.53%,40.65%,1
新北市,板橋區,1018,386,146,532,68,600,1023,58.65%,37.73%,1
新北市,板橋區,1019,391,135,526,35,561,1044,53.74%,37.45%,1
新北市,板橋區,1020,381,120,501,70,571,968,58.99%,39.36%,1
新北市,板橋區,1021,494,164,658,35,693,1222,56.71%,40.43%,1
新北市,板橋區,1022,548,155,703,48,751,1385,54.22%,39.57%,1
新北市,板橋區,1023,591,193,784,70,854,1585,53.88%,37.29%,1
新北市,板橋區,1024,688,225,913,91,1004,1840,54.57%,37.39%,1
新北市,板橋區,1025,736,266,1002,104,1106,1806,61.24%,40.75%,1
新北市,板橋區,1026,581,191,772,86,858,1506,56.97%,38.58%,1
新北市,板橋區,1027,578,167,745,96,841,1476,56.98%,39.16%,1
新北市,板橋區,1028,623,168,791,83,874,1500,58.27%,41.53%,1
新北市,板橋區,1029,489,140,629,65,694,1096,63.32%,44.62%,1
新北市,板橋區,1030,389,135,524,79,603,963,62.62%,40.39%,1
新北市,板橋區,1031,607,194,801,41,842,1601,52.59%,37.91%,1
新北市,板橋區,1032,640,204,844,81,925,1507,61.38%,42.47%,1
新北市,板橋區,1033,543,200,743,78,821,1315,62.43%,41.29%,1
新北市,板橋區,1034,438,157,595,34,629,1178,53.4%,37.18%,1
新北市,板橋區,1035,783,215,998,89,1087,1822,59.66%,42.97%,1
新北市,板橋區,1036,677,231,908,91,999,1605,62.24%,42.18%,1
新北市,板橋區,1037,669,207,876,20,896,1549,57.84%,43.19%,1
新北市,板橋區,1038,859,243,1102,53,1155,1948,59.29%,44.1%,1
新北市,板橋區,1039,783,210,993,33,1026,1935,53.02%,40.47%,1
新北市,板橋區,1040,401,126,527,47,574,1097,52.32%,36.55%,1
新北市,板橋區,1041,407,137,544,52,596,1095,54.43%,37.17%,1
新北市,板橋區,1042,606,220,826,99,925,1678,55.13%,36.11%,1
新北市,板橋區,1043,667,198,865,100,965,1750,55.14%,38.11%,1
新北市,板橋區,1044,460,147,607,58,665,1187,56.02%,38.75%,1
新北市,板橋區,1045,475,162,637,31,668,1154,57.89%,41.16%,1
新北市,板橋區,1046,512,154,666,41,707,1262,56.02%,40.57%,1
新北市,板橋區,1047,487,142,629,90,719,1271,56.57%,38.32%,1
新北市,板橋區,1048,532,175,707,98,805,1410,57.09%,37.73%,1
新北市,板橋區,1049,643,176,819,90,909,1745,52.09%,36.85%,1
新北市,板橋區,1050,678,248,926,135,1061,1867,56.83%,36.31%,1
新北市,板橋區,1051,739,205,944,101,1045,1753,59.61%,42.16%,1
新北市,板橋區,1052,503,153,656,68,724,1204,60.13%,41.78%,1
新北市,板橋區,1053,593,200,793,71,864,1614,53.53%,36.74%,1
新北市,板橋區,1054,516,170,686,54,740,1237,59.82%,41.71%,1
新北市,板橋區,1055,541,186,727,76,803,1361,59%,39.75%,1
新北市,板橋區,1056,468,173,641,40,681,1243,54.79%,37.65%,1
新北市,板橋區,1057,544,177,721,34,755,1515,49.83%,35.91%,1
新北市,板橋區,1058,621,204,825,82,907,1515,59.87%,40.99%,1
新北市,板橋區,1059,395,123,518,64,582,949,61.33%,41.62%,1
新北市,板橋區,1060,633,195,828,73,901,1629,55.31%,38.86%,1
新北市,板橋區,1061,407,224,631,51,682,1238,55.09%,32.88%,1
新北市,板橋區,1062,280,63,343,38,381,901,42.29%,31.08%,1
新北市,板橋區,1063,613,159,772,84,856,1475,58.03%,41.56%,1
新北市,板橋區,1064,546,195,741,85,826,1481,55.77%,36.87%,1
新北市,板橋區,1065,657,189,846,76,922,1800,51.22%,36.5%,1
新北市,板橋區,1066,664,222,886,71,957,1630,58.71%,40.74%,1
新北市,板橋區,1067,566,152,718,56,774,1298,59.63%,43.61%,1
新北市,板橋區,1068,368,109,477,44,521,874,59.61%,42.11%,1
新北市,板橋區,1069,384,114,498,20,518,992,52.22%,38.71%,1
新北市,板橋區,1070,472,142,614,20,634,1034,61.32%,45.65%,1
新北市,板橋區,1071,551,220,771,86,857,1451,59.06%,37.97%,1
新北市,板橋區,1072,475,151,626,50,676,1130,59.82%,42.04%,1
新北市,板橋區,1073,611,182,793,54,847,1440,58.82%,42.43%,1
新北市,板橋區,1074,601,218,819,89,908,1531,59.31%,39.26%,1
新北市,板橋區,1075,589,196,785,69,854,1349,63.31%,43.66%,1
新北市,板橋區,1076,534,186,720,44,764,1593,47.96%,33.52%,1
新北市,板橋區,1077,508,124,632,37,669,1174,56.98%,43.27%,1
新北市,板橋區,1078,485,152,637,58,695,1228,56.6%,39.5%,1
新北市,板橋區,1079,462,165,627,42,669,1187,56.36%,38.92%,1
新北市,板橋區,1080,362,113,475,61,536,870,61.61%,41.61%,1
新北市,板橋區,1081,964,214,1178,42,1220,2033,60.01%,47.42%,1
新北市,板橋區,1082,522,195,717,53,770,1418,54.3%,36.81%,1
新北市,板橋區,1083,411,159,570,49,619,1075,57.58%,38.23%,1
新北市,板橋區,1084,595,151,746,46,792,1515,52.28%,39.27%,1
新北市,板橋區,1085,530,157,687,47,734,1182,62.1%,44.84%,1
新北市,板橋區,1086,740,218,958,90,1048,1893,55.36%,39.09%,1
新北市,板橋區,1087,479,180,659,64,723,1302,55.53%,36.79%,1
新北市,板橋區,1088,512,153,665,47,712,1366,52.12%,37.48%,1
新北市,板橋區,1089,569,167,736,90,826,1318,62.67%,43.17%,1
新北市,板橋區,1090,468,152,620,43,663,1200,55.25%,39%,1
新北市,板橋區,1091,800,282,1082,53,1135,2028,55.97%,39.45%,1
新北市,板橋區,1092,679,232,911,113,1024,1746,58.65%,38.89%,1
新北市,板橋區,1093,745,192,937,33,970,1954,49.64%,38.13%,1
新北市,板橋區,1094,576,184,760,67,827,1474,56.11%,39.08%,1
新北市,板橋區,1095,541,173,714,66,780,1418,55.01%,38.15%,1
新北市,板橋區,1096,655,226,881,79,960,1563,61.42%,41.91%,1
新北市,板橋區,1097,664,216,880,103,983,1780,55.22%,37.3%,1
新北市,板橋區,1098,671,201,872,51,923,1707,54.07%,39.31%,1
新北市,板橋區,1099,250,53,303,12,315,906,34.77%,27.59%,1
新北市,板橋區,1100,391,131,522,66,588,1030,57.09%,37.96%,1
新北市,板橋區,1101,457,144,601,46,647,1115,58.03%,40.99%,1
新北市,板橋區,1102,737,184,921,33,954,1836,51.96%,40.14%,1
新北市,板橋區,1103,736,206,942,99,1041,1881,55.34%,39.13%,1
新北市,板橋區,1104,661,209,870,50,920,1688,54.5%,39.16%,1
新北市,板橋區,1105,768,222,990,46,1036,1760,58.86%,43.64%,1
新北市,板橋區,1106,459,145,604,50,654,1044,62.64%,43.97%,1
新北市,板橋區,1107,441,160,601,45,646,1043,61.94%,42.28%,1
新北市,板橋區,1108,498,138,636,49,685,1099,62.33%,45.31%,1
新北市,板橋區,1109,490,181,671,54,725,1260,57.54%,38.89%,1
新北市,板橋區,1110,465,144,609,48,657,1131,58.09%,41.11%,1
新北市,板橋區,1111,494,164,658,60,718,1225,58.61%,40.33%,1
新北市,板橋區,1112,661,183,844,56,900,1455,61.86%,45.43%,1
新北市,板橋區,1113,463,184,647,66,713,1267,56.27%,36.54%,1
新北市,板橋區,1114,369,154,523,61,584,972,60.08%,37.96%,1
新北市,板橋區,1115,411,139,550,40,590,994,59.36%,41.35%,1
新北市,板橋區,1116,479,130,609,21,630,1111,56.71%,43.11%,1
新北市,板橋區,1117,554,159,713,74,787,1177,66.86%,47.07%,1
新北市,板橋區,1118,631,162,793,67,860,1544,55.7%,40.87%,1
新北市,板橋區,1119,408,107,515,80,595,1021,58.28%,39.96%,1
新北市,板橋區,1120,416,123,539,53,592,1040,56.92%,40%,1
新北市,板橋區,1121,596,190,786,29,815,1504,54.19%,39.63%,1
新北市,板橋區,1122,541,157,698,45,743,1373,54.12%,39.4%,1
新北市,板橋區,1123,526,143,669,31,700,1210,57.85%,43.47%,1
新北市,板橋區,1124,684,190,874,86,960,1809,53.07%,37.81%,1
新北市,板橋區,1125,658,182,840,78,918,1551,59.19%,42.42%,1
新北市,板橋區,1126,614,157,771,37,808,1408,57.39%,43.61%,1
新北市,板橋區,1127,577,137,714,28,742,1285,57.74%,44.9%,1
新北市,板橋區,1128,499,142,641,44,685,1102,62.16%,45.28%,1
新北市,板橋區,1129,520,155,675,32,707,1399,50.54%,37.17%,1
新北市,板橋區,1130,670,183,853,105,958,1692,56.62%,39.6%,1
新北市,板橋區,1131,711,214,925,38,963,1625,59.26%,43.75%,1
新北市,板橋區,1132,706,220,926,113,1039,1712,60.69%,41.24%,1
新北市,板橋區,1133,522,148,670,34,704,1246,56.5%,41.89%,1
新北市,板橋區,1134,602,184,786,36,822,1471,55.88%,40.92%,1
新北市,板橋區,1135,756,171,927,65,992,1761,56.33%,42.93%,1
新北市,板橋區,1136,588,200,788,78,866,1499,57.77%,39.23%,1
新北市,板橋區,1137,555,186,741,60,801,1528,52.42%,36.32%,1
新北市,板橋區,1138,618,194,812,65,877,1536,57.1%,40.23%,1
新北市,板橋區,1139,627,201,828,58,886,1550,57.16%,40.45%,1
新北市,板橋區,1140,820,281,1101,94,1195,2050,58.29%,40%,1
新北市,板橋區,1141,561,156,717,54,771,1300,59.31%,43.15%,1
新北市,板橋區,1142,634,192,826,54,880,1537,57.25%,41.25%,1
新北市,板橋區,1143,476,155,631,25,656,1341,48.92%,35.5%,1
新北市,板橋區,1144,669,201,870,29,899,1606,55.98%,41.66%,1
新北市,板橋區,1145,526,160,686,41,727,1433,50.73%,36.71%,1
新北市,板橋區,1146,617,173,790,43,833,1685,49.44%,36.62%,1
新北市,板橋區,1147,534,166,700,65,765,1248,61.3%,42.79%,1
新北市,板橋區,1148,486,110,596,51,647,1172,55.2%,41.47%,1
新北市,板橋區,1149,545,169,714,31,745,1640,45.43%,33.23%,1
新北市,板橋區,1150,573,143,716,45,761,1428,53.29%,40.13%,1
新北市,板橋區,1151,616,185,801,74,875,1527,57.3%,40.34%,1
新北市,板橋區,1152,582,169,751,39,790,1350,58.52%,43.11%,1
新北市,板橋區,1153,667,171,838,59,897,1582,56.7%,42.16%,1
新北市,板橋區,1154,435,118,553,52,605,919,65.83%,47.33%,1
新北市,板橋區,1155,400,95,495,21,516,930,55.48%,43.01%,1
新北市,板橋區,1156,465,104,569,32,601,974,61.7%,47.74%,1
新北市,板橋區,1157,800,153,953,52,1005,1732,58.03%,46.19%,1
新北市,板橋區,1158,596,159,755,54,809,1438,56.26%,41.45%,1
新北市,板橋區,1159,644,219,863,101,964,1777,54.25%,36.24%,1
新北市,板橋區,1160,629,190,819,58,877,1764,49.72%,35.66%,1
新北市,板橋區,1161,507,154,661,26,687,1289,53.3%,39.33%,1
新北市,板橋區,1162,501,130,631,40,671,1182,56.77%,42.39%,1
新北市,板橋區,1163,478,161,639,67,706,1174,60.14%,40.72%,1
新北市,板橋區,1164,683,214,897,111,1008,1870,53.9%,36.52%,1
新北市,板橋區,1165,780,221,1001,62,1063,1842,57.71%,42.35%,1
新北市,板橋區,1166,465,106,571,62,633,1094,57.86%,42.5%,1
新北市,板橋區,1167,485,139,624,51,675,1228,54.97%,39.5%,1
新北市,板橋區,1168,348,145,493,49,542,998,54.31%,34.87%,1
新北市,板橋區,1169,305,129,434,41,475,862,55.1%,35.38%,1
新北市,板橋區,1170,581,209,790,54,844,1622,52.03%,35.82%,1
新北市,板橋區,1171,523,138,661,68,729,1205,60.5%,43.4%,1
新北市,板橋區,1172,657,200,857,47,904,1787,50.59%,36.77%,1
新北市,板橋區,1173,692,177,869,47,916,1610,56.89%,42.98%,1
新北市,板橋區,1174,943,286,1229,51,1280,2216,57.76%,42.55%,1
新北市,板橋區,1175,943,271,1214,61,1275,2294,55.58%,41.11%,1
新北市,板橋區,1176,783,220,1003,91,1094,2090,52.34%,37.46%,1
新北市,板橋區,1177,511,118,629,36,665,1356,49.04%,37.68%,1
新北市,板橋區,1178,486,122,608,35,643,1067,60.26%,45.55%,1
新北市,板橋區,1179,422,202,624,54,678,1319,51.4%,31.99%,1
新北市,板橋區,1180,480,142,622,56,678,1316,51.52%,36.47%,1
新北市,板橋區,1181,431,146,577,71,648,1195,54.23%,36.07%,1
新北市,板橋區,1182,339,104,443,32,475,857,55.43%,39.56%,1
新北市,板橋區,1183,516,169,685,80,765,1417,53.99%,36.41%,1
新北市,板橋區,1184,608,210,818,82,900,1560,57.69%,38.97%,1
新北市,板橋區,1185,727,178,905,81,986,1747,56.44%,41.61%,1
新北市,板橋區,1186,514,194,708,52,760,1176,64.63%,43.71%,1
新北市,板橋區,1187,455,156,611,30,641,1101,58.22%,41.33%,1
新北市,板橋區,1188,590,188,778,29,807,1458,55.35%,40.47%,1
新北市,板橋區,1189,564,179,743,52,795,1630,48.77%,34.6%,1
新北市,板橋區,1190,565,228,793,99,892,1611,55.37%,35.07%,1
新北市,板橋區,1191,419,140,559,32,591,1139,51.89%,36.79%,1
新北市,板橋區,1192,487,104,591,32,623,1120,55.63%,43.48%,1
新北市,板橋區,1193,443,125,568,85,653,1022,63.89%,43.35%,1
新北市,板橋區,1194,439,130,569,69,638,1049,60.82%,41.85%,1
新北市,板橋區,1195,440,115,555,28,583,1007,57.89%,43.69%,1
新北市,板橋區,1196,604,137,741,35,776,1393,55.71%,43.36%,1
新北市,板橋區,1197,122,48,170,30,200,474,42.19%,25.74%,1
新北市,板橋區,1198,206,63,269,29,298,500,59.6%,41.2%,1
新北市,板橋區,1199,457,143,600,43,643,1177,54.63%,38.83%,1
新北市,板橋區,1200,463,130,593,36,629,1186,53.04%,39.04%,1
新北市,板橋區,1201,480,154,634,63,697,1139,61.19%,42.14%,1
新北市,板橋區,1202,687,205,892,71,963,1750,55.03%,39.26%,1
新北市,板橋區,1203,879,248,1127,37,1164,3451,33.73%,25.47%,1
新北市,板橋區,1204,600,179,779,78,857,1620,52.9%,37.04%,1
新北市,板橋區,1205,323,86,409,24,433,903,47.95%,35.77%,1
新北市,板橋區,1206,499,166,665,55,720,1232,58.44%,40.5%,1
新北市,板橋區,1207,317,103,420,28,448,975,45.95%,32.51%,1
新北市,板橋區,1208,478,134,612,33,645,1224,52.7%,39.05%,1
新北市,板橋區,1209,537,131,668,40,708,1291,54.84%,41.6%,1
新北市,板橋區,1210,632,201,833,44,877,1828,47.98%,34.57%,1
新北市,板橋區,1211,630,165,795,57,852,1725,49.39%,36.52%,1
新北市,板橋區,1212,387,109,496,25,521,1085,48.02%,35.67%,1
新北市,板橋區,1213,891,250,1141,80,1221,2357,51.8%,37.8%,1
新北市,板橋區,1214,623,167,790,37,827,1560,53.01%,39.94%,1
新北市,板橋區,1215,757,156,913,32,945,2201,42.94%,34.39%,1
新北市,板橋區,1216,619,175,794,63,857,1626,52.71%,38.07%,1
新北市,板橋區,1217,621,154,775,51,826,1786,46.25%,34.77%,1
新北市,板橋區,1218,669,198,867,56,923,1763,52.35%,37.95%,1
新北市,板橋區,1219,635,168,803,34,837,1744,47.99%,36.41%,1
新北市,板橋區,1220,625,164,789,61,850,1645,51.67%,37.99%,1
新北市,板橋區,1221,716,148,864,37,901,1861,48.41%,38.47%,1
新北市,板橋區,1222,571,176,747,30,777,1596,48.68%,35.78%,1
新北市,板橋區,1223,723,227,950,65,1015,1871,54.25%,38.64%,1
新北市,板橋區,1224,807,191,998,65,1063,1938,54.85%,41.64%,1
新北市,板橋區,1225,762,199,961,51,1012,1827,55.39%,41.71%,1
新北市,板橋區,1226,545,127,672,37,709,1359,52.17%,40.1%,1
新北市,板橋區,1227,678,137,815,67,882,1613,54.68%,42.03%,1
新北市,板橋區,1228,615,189,804,79,883,1566,56.39%,39.27%,1
新北市,板橋區,1229,681,192,873,45,918,1552,59.15%,43.88%,1
新北市,板橋區,1230,706,215,921,41,962,1885,51.03%,37.45%,1
新北市,板橋區,1231,684,227,911,72,983,1893,51.93%,36.13%,1
新北市,三重區,0659,577,159,736,71,807,1509,53.48%,38.24%,1
新北市,三重區,0660,655,198,853,67,920,1591,57.83%,41.17%,1
新北市,三重區,0661,677,204,881,71,952,1653,57.59%,40.96%,1
新北市,三重區,0662,552,194,746,79,825,1392,59.27%,39.66%,1
新北市,三重區,0663,618,165,783,97,880,1451,60.65%,42.59%,1
新北市,三重區,0664,505,170,675,86,761,1329,57.26%,38%,1
新北市,三重區,0665,621,162,783,49,832,1459,57.03%,42.56%,1
新北市,三重區,0666,417,135,552,62,614,1024,59.96%,40.72%,1
新北市,三重區,0667,435,144,579,62,641,1066,60.13%,40.81%,1
新北市,三重區,0668,395,107,502,64,566,856,66.12%,46.14%,1
新北市,三重區,0669,296,101,397,42,439,764,57.46%,38.74%,1
新北市,三重區,0670,337,121,458,48,506,821,61.63%,41.05%,1
新北市,三重區,0671,670,241,911,70,981,1887,51.99%,35.51%,1
新北市,三重區,0672,607,201,808,57,865,1646,52.55%,36.88%,1
新北市,三重區,0673,154,39,193,17,210,358,58.66%,43.02%,1
新北市,三重區,0674,458,119,577,44,621,1039,59.77%,44.08%,1
新北市,三重區,0675,444,170,614,42,656,1114,58.89%,39.86%,1
新北市,三重區,0676,662,215,877,57,934,1588,58.82%,41.69%,1
新北市,三重區,0677,649,198,847,62,909,1702,53.41%,38.13%,1
新北市,三重區,0678,539,191,730,63,793,1288,61.57%,41.85%,1
新北市,三重區,0679,673,249,922,65,987,1629,60.59%,41.31%,1
新北市,三重區,0680,762,209,971,73,1044,1861,56.1%,40.95%,1
新北市,三重區,0681,634,204,838,53,891,1727,51.59%,36.71%,1
新北市,三重區,0682,732,215,947,56,1003,1813,55.32%,40.38%,1
新北市,三重區,0683,651,178,829,78,907,1595,56.87%,40.82%,1
新北市,三重區,0684,601,199,800,71,871,1513,57.57%,39.72%,1
新北市,三重區,0685,554,216,770,53,823,4433,18.57%,12.5%,1
新北市,三重區,0686,529,167,696,49,745,1283,58.07%,41.23%,1
新北市,三重區,0687,621,193,814,57,871,1430,60.91%,43.43%,1
新北市,三重區,0688,597,199,796,34,830,1357,61.16%,43.99%,1
新北市,三重區,0689,403,121,524,46,570,963,59.19%,41.85%,1
新北市,三重區,0690,355,107,462,53,515,883,58.32%,40.2%,1
新北市,三重區,0691,584,168,752,102,854,1494,57.16%,39.09%,1
新北市,三重區,0692,664,200,864,91,955,1616,59.1%,41.09%,1
新北市,三重區,0693,532,155,687,76,763,1329,57.41%,40.03%,1
新北市,三重區,0694,553,194,747,58,805,1289,62.45%,42.9%,1
新北市,三重區,0695,514,199,713,87,800,1380,57.97%,37.25%,1
新北市,三重區,0696,713,176,889,54,943,1668,56.53%,42.75%,1
新北市,三重區,0697,536,162,698,78,776,1226,63.3%,43.72%,1
新北市,三重區,0698,585,180,765,69,834,1421,58.69%,41.17%,1
新北市,三重區,0699,582,157,739,61,800,1364,58.65%,42.67%,1
新北市,三重區,0700,521,166,687,46,733,1232,59.5%,42.29%,1
新北市,三重區,0701,547,171,718,60,778,1248,62.34%,43.83%,1
新北市,三重區,0702,490,197,687,68,755,1256,60.11%,39.01%,1
新北市,三重區,0703,635,222,857,75,932,1506,61.89%,42.16%,1
新北市,三重區,0704,706,224,930,62,992,1669,59.44%,42.3%,1
新北市,三重區,0705,519,150,669,97,766,1308,58.56%,39.68%,1
新北市,三重區,0706,616,159,775,53,828,1263,65.56%,48.77%,1
新北市,三重區,0707,572,183,755,183,938,1471,63.77%,38.89%,1
新北市,三重區,0708,556,204,760,112,872,1447,60.26%,38.42%,1
新北市,三重區,0709,572,189,761,71,832,1693,49.14%,33.79%,1
新北市,三重區,0710,779,230,1009,73,1082,2015,53.7%,38.66%,1
新北市,三重區,0711,655,196,851,97,948,1812,52.32%,36.15%,1
新北市,三重區,0712,533,171,704,53,757,1509,50.17%,35.32%,1
新北市,三重區,0713,594,173,767,65,832,1439,57.82%,41.28%,1
新北市,三重區,0714,578,174,752,67,819,1437,56.99%,40.22%,1
新北市,三重區,0715,642,216,858,62,920,1697,54.21%,37.83%,1
新北市,三重區,0716,693,172,865,50,915,1793,51.03%,38.65%,1
新北市,三重區,0717,688,211,899,60,959,1603,59.83%,42.92%,1
新北市,三重區,0718,455,138,593,41,634,1166,54.37%,39.02%,1
新北市,三重區,0719,486,133,619,45,664,1126,58.97%,43.16%,1
新北市,三重區,0720,451,134,585,63,648,1291,50.19%,34.93%,1
新北市,三重區,0721,595,202,797,100,897,1597,56.17%,37.26%,1
新北市,三重區,0722,459,131,590,72,662,1081,61.24%,42.46%,1
新北市,三重區,0723,385,141,526,62,588,911,64.54%,42.26%,1
新北市,三重區,0724,609,174,783,56,839,1719,48.81%,35.43%,1
新北市,三重區,0725,482,159,641,83,724,1289,56.17%,37.39%,1
新北市,三重區,0726,519,187,706,97,803,1318,60.93%,39.38%,1
新北市,三重區,0727,641,223,864,80,944,1822,51.81%,35.18%,1
新北市,三重區,0728,424,166,590,100,690,1185,58.23%,35.78%,1
新北市,三重區,0729,502,133,635,87,722,1369,52.74%,36.67%,1
新北市,三重區,0730,636,186,822,69,891,1507,59.12%,42.2%,1
新北市,三重區,0731,374,115,489,63,552,926,59.61%,40.39%,1
新北市,三重區,0732,342,100,442,21,463,950,48.74%,36%,1
新北市,三重區,0733,612,200,812,79,891,1678,53.1%,36.47%,1
新北市,三重區,0734,435,124,559,79,638,1117,57.12%,38.94%,1
新北市,三重區,0735,490,143,633,63,696,1318,52.81%,37.18%,1
新北市,三重區,0736,537,170,707,46,753,1388,54.25%,38.69%,1
新北市,三重區,0737,395,126,521,77,598,1026,58.28%,38.5%,1
新北市,三重區,0738,473,149,622,49,671,1096,61.22%,43.16%,1
新北市,三重區,0739,412,126,538,35,573,967,59.26%,42.61%,1
新北市,三重區,0740,668,239,907,75,982,1871,52.49%,35.7%,1
新北市,三重區,0741,669,179,848,85,933,1663,56.1%,40.23%,1
新北市,三重區,0742,474,129,603,32,635,1208,52.57%,39.24%,1
新北市,三重區,0743,480,183,663,57,720,1398,51.5%,34.33%,1
新北市,三重區,0744,407,129,536,33,569,1078,52.78%,37.76%,1
新北市,三重區,0745,397,123,520,66,586,1102,53.18%,36.03%,1
新北市,三重區,0746,506,176,682,85,767,1393,55.06%,36.32%,1
新北市,三重區,0747,526,143,669,74,743,1251,59.39%,42.05%,1
新北市,三重區,0748,554,165,719,66,785,1234,63.61%,44.89%,1
新北市,三重區,0749,655,222,877,82,959,1661,57.74%,39.43%,1
新北市,三重區,0750,632,195,827,80,907,1590,57.04%,39.75%,1
新北市,三重區,0751,463,162,625,76,701,1182,59.31%,39.17%,1
新北市,三重區,0752,541,200,741,77,818,1369,59.75%,39.52%,1
新北市,三重區,0753,524,178,702,56,758,1222,62.03%,42.88%,1
新北市,三重區,0754,464,172,636,104,740,1304,56.75%,35.58%,1
新北市,三重區,0755,395,119,514,52,566,1054,53.7%,37.48%,1
新北市,三重區,0756,605,230,835,80,915,1635,55.96%,37%,1
新北市,三重區,0757,667,188,855,79,934,1779,52.5%,37.49%,1
新北市,三重區,0758,666,182,848,86,934,1633,57.2%,40.78%,1
新北市,三重區,0759,452,133,585,54,639,1107,57.72%,40.83%,1
新北市,三重區,0760,450,135,585,48,633,1021,62%,44.07%,1
新北市,三重區,0761,560,194,754,101,855,1649,51.85%,33.96%,1
新北市,三重區,0762,348,109,457,39,496,874,56.75%,39.82%,1
新北市,三重區,0763,538,173,711,112,823,1402,58.7%,38.37%,1
新北市,三重區,0764,574,198,772,93,865,1713,50.5%,33.51%,1
新北市,三重區,0765,330,105,435,54,489,973,50.26%,33.92%,1
新北市,三重區,0766,409,147,556,59,615,1038,59.25%,39.4%,1
新北市,三重區,0767,650,195,845,96,941,1833,51.34%,35.46%,1
新北市,三重區,0768,311,102,413,45,458,817,56.06%,38.07%,1
新北市,三重區,0769,567,180,747,80,827,1387,59.63%,40.88%,1
新北市,三重區,0770,346,91,437,32,469,784,59.82%,44.13%,1
新北市,三重區,0771,398,131,529,31,560,1096,51.09%,36.31%,1
新北市,三重區,0772,492,139,631,62,693,1163,59.59%,42.3%,1
新北市,三重區,0773,724,193,917,62,979,1868,52.41%,38.76%,1
新北市,三重區,0774,411,133,544,71,615,1117,55.06%,36.79%,1
新北市,三重區,0775,343,102,445,54,499,934,53.43%,36.72%,1
新北市,三重區,0776,492,173,665,76,741,1412,52.48%,34.84%,1
新北市,三重區,0777,500,120,620,50,670,1062,63.09%,47.08%,1
新北市,三重區,0778,354,82,436,76,512,891,57.46%,39.73%,1
新北市,三重區,0779,428,123,551,88,639,936,68.27%,45.73%,1
新北市,三重區,0780,392,134,526,72,598,1085,55.12%,36.13%,1
新北市,三重區,0781,354,132,486,22,508,1065,47.7%,33.24%,1
新北市,三重區,0782,555,184,739,66,805,1398,57.58%,39.7%,1
新北市,三重區,0783,627,198,825,58,883,1550,56.97%,40.45%,1
新北市,三重區,0784,608,199,807,98,905,1674,54.06%,36.32%,1
新北市,三重區,0785,496,142,638,73,711,1215,58.52%,40.82%,1
新北市,三重區,0786,589,220,809,75,884,1606,55.04%,36.67%,1
新北市,三重區,0787,493,111,604,56,660,1182,55.84%,41.71%,1
新北市,三重區,0788,498,142,640,88,728,1238,58.8%,40.23%,1
新北市,三重區,0789,560,175,735,63,798,1342,59.46%,41.73%,1
新北市,三重區,0790,580,180,760,59,819,1408,58.17%,41.19%,1
新北市,三重區,0791,696,188,884,103,987,1770,55.76%,39.32%,1
新北市,三重區,0792,367,121,488,61,549,940,58.4%,39.04%,1
新北市,三重區,0793,366,118,484,24,508,975,52.1%,37.54%,1
新北市,三重區,0794,577,170,747,54,801,1507,53.15%,38.29%,1
新北市,三重區,0795,553,184,737,76,813,1419,57.29%,38.97%,1
新北市,三重區,0796,523,136,659,57,716,1257,56.96%,41.61%,1
新北市,三重區,0797,601,230,831,90,921,1619,56.89%,37.12%,1
新北市,三重區,0798,673,191,864,88,952,1745,54.56%,38.57%,1
新北市,三重區,0799,579,207,786,72,858,1519,56.48%,38.12%,1
新北市,三重區,0800,621,186,807,82,889,1682,52.85%,36.92%,1
新北市,三重區,0801,703,219,922,68,990,1697,58.34%,41.43%,1
新北市,三重區,0802,405,95,500,78,578,1073,53.87%,37.74%,1
新北市,三重區,0803,347,107,454,56,510,924,55.19%,37.55%,1
新北市,三重區,0804,541,160,701,56,757,1613,46.93%,33.54%,1
新北市,三重區,0805,398,97,495,58,553,1034,53.48%,38.49%,1
新北市,三重區,0806,429,145,574,70,644,1118,57.6%,38.37%,1
新北市,三重區,0807,463,166,629,82,711,1269,56.03%,36.49%,1
新北市,三重區,0808,351,130,481,69,550,990,55.56%,35.45%,1
新北市,三重區,0809,510,160,670,85,755,1336,56.51%,38.17%,1
新北市,三重區,0810,649,184,833,63,896,1601,55.97%,40.54%,1
新北市,三重區,0811,611,258,869,82,951,1581,60.15%,38.65%,1
新北市,三重區,0812,554,162,716,65,781,1345,58.07%,41.19%,1
新北市,三重區,0813,499,198,697,56,753,1226,61.42%,40.7%,1
新北市,三重區,0814,628,146,774,93,867,1650,52.55%,38.06%,1
新北市,三重區,0815,469,120,589,67,656,1140,57.54%,41.14%,1
新北市,三重區,0816,633,169,802,41,843,1639,51.43%,38.62%,1
新北市,三重區,0817,670,194,864,84,948,1699,55.8%,39.43%,1
新北市,三重區,0818,700,202,902,92,994,1501,66.22%,46.64%,1
新北市,三重區,0819,611,189,800,70,870,1538,56.57%,39.73%,1
新北市,三重區,0820,590,160,750,93,843,1540,54.74%,38.31%,1
新北市,三重區,0821,518,142,660,61,721,1276,56.5%,40.6%,1
新北市,三重區,0822,559,207,766,70,836,1539,54.32%,36.32%,1
新北市,三重區,0823,496,155,651,52,703,1170,60.09%,42.39%,1
新北市,三重區,0824,427,169,596,42,638,1120,56.96%,38.13%,1
新北市,三重區,0825,715,200,915,94,1009,1789,56.4%,39.97%,1
新北市,三重區,0826,539,198,737,71,808,1520,53.16%,35.46%,1
新北市,三重區,0827,696,239,935,82,1017,1821,55.85%,38.22%,1
新北市,三重區,0828,551,162,713,83,796,1407,56.57%,39.16%,1
新北市,三重區,0829,594,174,768,67,835,1491,56%,39.84%,1
新北市,三重區,0830,574,175,749,76,825,1381,59.74%,41.56%,1
新北市,三重區,0831,478,147,625,89,714,1222,58.43%,39.12%,1
新北市,三重區,0832,743,207,950,65,1015,1938,52.37%,38.34%,1
新北市,三重區,0833,740,78,818,50,868,1639,52.96%,45.15%,1
新北市,三重區,0834,665,151,816,89,905,1614,56.07%,41.2%,1
新北市,三重區,0835,677,188,865,76,941,1709,55.06%,39.61%,1
新北市,三重區,0836,646,182,828,79,907,1753,51.74%,36.85%,1
新北市,三重區,0837,528,210,738,81,819,1398,58.58%,37.77%,1
新北市,三重區,0838,623,206,829,92,921,1706,53.99%,36.52%,1
新北市,三重區,0839,646,208,854,71,925,1614,57.31%,40.02%,1
新北市,三重區,0840,620,206,826,68,894,1591,56.19%,38.97%,1
新北市,三重區,0841,617,190,807,64,871,1627,53.53%,37.92%,1
新北市,三重區,0842,580,194,774,92,866,1505,57.54%,38.54%,1
新北市,三重區,0843,554,150,704,50,754,1331,56.65%,41.62%,1
新北市,三重區,0844,603,153,756,54,810,1678,48.27%,35.94%,1
新北市,三重區,0845,604,177,781,65,846,1498,56.48%,40.32%,1
新北市,三重區,0846,744,238,982,78,1060,1800,58.89%,41.33%,1
新北市,三重區,0847,602,183,785,53,838,1703,49.21%,35.35%,1
新北市,三重區,0848,728,199,927,57,984,1975,49.82%,36.86%,1
新北市,三重區,0849,679,235,914,70,984,1894,51.95%,35.85%,1
新北市,三重區,0850,585,181,766,58,824,1405,58.65%,41.64%,1
新北市,三重區,0851,529,168,697,46,743,1293,57.46%,40.91%,1
新北市,三重區,0852,500,165,665,62,727,1259,57.74%,39.71%,1
新北市,三重區,0853,477,149,626,82,708,1144,61.89%,41.7%,1
新北市,三重區,0854,525,162,687,80,767,1254,61.16%,41.87%,1
新北市,三重區,0855,533,143,676,68,744,1313,56.66%,40.59%,1
新北市,三重區,0856,587,197,784,85,869,1594,54.52%,36.83%,1
新北市,三重區,0857,697,207,904,76,980,1775,55.21%,39.27%,1
新北市,三重區,0858,569,178,747,101,848,1516,55.94%,37.53%,1
新北市,三重區,0859,552,167,719,102,821,1315,62.43%,41.98%,1
新北市,三重區,0860,338,114,452,67,519,843,61.57%,40.09%,1
新北市,三重區,0861,433,110,543,64,607,1160,52.33%,37.33%,1
新北市,三重區,0862,435,121,556,60,616,1052,58.56%,41.35%,1
新北市,三重區,0863,454,153,607,64,671,1054,63.66%,43.07%,1
新北市,三重區,0864,389,138,527,62,589,997,59.08%,39.02%,1
新北市,三重區,0865,334,122,456,43,499,936,53.31%,35.68%,1
新北市,三重區,0866,619,191,810,99,909,1658,54.83%,37.33%,1
新北市,三重區,0867,541,188,729,82,811,1496,54.21%,36.16%,1
新北市,三重區,0868,466,132,598,62,660,1064,62.03%,43.8%,1
新北市,三重區,0869,501,141,642,62,704,1152,61.11%,43.49%,1
新北市,三重區,0870,583,152,735,48,783,1532,51.11%,38.05%,1
新北市,三重區,0871,476,121,597,39,636,1338,47.53%,35.58%,1
新北市,三重區,0872,525,163,688,77,765,1303,58.71%,40.29%,1
新北市,三重區,0873,588,145,733,86,819,1369,59.82%,42.95%,1
新北市,三重區,0874,594,158,752,84,836,1491,56.07%,39.84%,1
新北市,三重區,0875,637,196,833,115,948,1821,52.06%,34.98%,1
新北市,三重區,0876,699,198,897,69,966,1906,50.68%,36.67%,1
新北市,三重區,0877,690,273,963,78,1041,1842,56.51%,37.46%,1
新北市,三重區,0878,336,90,426,46,472,878,53.76%,38.27%,1
新北市,三重區,0879,425,136,561,62,623,963,64.69%,44.13%,1
新北市,三重區,0880,470,154,624,31,655,1381,47.43%,34.03%,1
新北市,三重區,0881,600,159,759,74,833,1681,49.55%,35.69%,1
新北市,三重區,0882,565,177,742,48,790,1548,51.03%,36.5%,1
新北市,三重區,0883,613,205,818,76,894,1542,57.98%,39.75%,1
新北市,三重區,0884,611,186,797,73,870,1557,55.88%,39.24%,1
新北市,三重區,0885,685,166,851,46,897,1661,54%,41.24%,1
新北市,三重區,0886,800,215,1015,39,1054,2024,52.08%,39.53%,1
新北市,三重區,0887,618,107,725,66,791,1588,49.81%,38.92%,1
新北市,三重區,0888,616,200,816,122,938,1706,54.98%,36.11%,1
新北市,三重區,0889,549,177,726,57,783,1341,58.39%,40.94%,1
新北市,三重區,0890,381,107,488,49,537,1025,52.39%,37.17%,1
新北市,三重區,0891,540,147,687,77,764,1339,57.06%,40.33%,1
新北市,三重區,0892,636,214,850,108,958,1725,55.54%,36.87%,1
新北市,三重區,0893,772,190,962,80,1042,1826,57.06%,42.28%,1
新北市,中和區,1232,585,190,775,69,844,1630,51.78%,35.89%,1
新北市,中和區,1233,741,195,936,54,990,1775,55.77%,41.75%,1
新北市,中和區,1234,690,184,874,41,915,1844,49.62%,37.42%,1
新北市,中和區,1235,484,132,616,28,644,1019,63.2%,47.5%,1
新北市,中和區,1236,533,120,653,37,690,1138,60.63%,46.84%,1
新北市,中和區,1237,739,171,910,44,954,1878,50.8%,39.35%,1
新北市,中和區,1238,888,191,1079,53,1132,1980,57.17%,44.85%,1
新北市,中和區,1239,751,205,956,76,1032,1844,55.97%,40.73%,1
新北市,中和區,1240,893,214,1107,44,1151,2085,55.2%,42.83%,1
新北市,中和區,1241,616,165,781,52,833,1498,55.61%,41.12%,1
新北市,中和區,1242,706,205,911,42,953,1761,54.12%,40.09%,1
新北市,中和區,1243,512,123,635,38,673,1254,53.67%,40.83%,1
新北市,中和區,1244,605,135,740,47,787,1343,58.6%,45.05%,1
新北市,中和區,1245,738,197,935,34,969,1789,54.16%,41.25%,1
新北市,中和區,1246,834,210,1044,45,1089,2000,54.45%,41.7%,1
新北市,中和區,1247,683,221,904,45,949,1953,48.59%,34.97%,1
新北市,中和區,1248,669,207,876,70,946,1712,55.26%,39.08%,1
新北市,中和區,1249,699,150,849,54,903,1582,57.08%,44.18%,1
新北市,中和區,1250,708,184,892,59,951,1742,54.59%,40.64%,1
新北市,中和區,1251,689,180,869,47,916,1493,61.35%,46.15%,1
新北市,中和區,1252,515,135,650,52,702,1352,51.92%,38.09%,1
新北市,中和區,1253,554,136,690,47,737,1244,59.24%,44.53%,1
新北市,中和區,1254,589,168,757,61,818,1394,58.68%,42.25%,1
新北市,中和區,1255,634,180,814,26,840,1917,43.82%,33.07%,1
新北市,中和區,1256,667,203,870,92,962,1830,52.57%,36.45%,1
新北市,中和區,1257,465,139,604,57,661,1124,58.81%,41.37%,1
新北市,中和區,1258,509,142,651,40,691,1412,48.94%,36.05%,1
新北市,中和區,1259,528,161,689,52,741,1356,54.65%,38.94%,1
新北市,中和區,1260,537,159,696,48,744,1425,52.21%,37.68%,1
新北市,中和區,1261,534,148,682,75,757,1259,60.13%,42.41%,1
新北市,中和區,1262,512,150,662,66,728,1256,57.96%,40.76%,1
新北市,中和區,1263,589,161,750,41,791,1423,55.59%,41.39%,1
新北市,中和區,1264,537,118,655,57,712,1221,58.31%,43.98%,1
新北市,中和區,1265,671,202,873,67,940,1858,50.59%,36.11%,1
新北市,中和區,1266,708,173,881,51,932,1804,51.66%,39.25%,1
新北市,中和區,1267,691,209,900,44,944,1669,56.56%,41.4%,1
新北市,中和區,1268,629,159,788,48,836,1485,56.3%,42.36%,1
新北市,中和區,1269,428,124,552,53,605,1005,60.2%,42.59%,1
新北市,中和區,1270,524,157,681,67,748,1175,63.66%,44.6%,1
新北市,中和區,1271,520,119,639,50,689,1171,58.84%,44.41%,1
新北市,中和區,1272,655,172,827,30,857,1746,49.08%,37.51%,1
新北市,中和區,1273,575,163,738,41,779,1555,50.1%,36.98%,1
新北市,中和區,1274,472,116,588,43,631,1112,56.74%,42.45%,1
新北市,中和區,1275,816,191,1007,44,1051,1780,59.04%,45.84%,1
新北市,中和區,1276,803,185,988,46,1034,1918,53.91%,41.87%,1
新北市,中和區,1277,577,160,737,30,767,1689,45.41%,34.16%,1
新北市,中和區,1278,768,202,970,30,1000,1781,56.15%,43.12%,1
新北市,中和區,1279,583,162,745,49,794,1419,55.95%,41.09%,1
新北市,中和區,1280,542,142,684,39,723,1344,53.79%,40.33%,1
新北市,中和區,1281,825,231,1056,64,1120,1804,62.08%,45.73%,1
新北市,中和區,1282,673,205,878,79,957,1788,53.52%,37.64%,1
新北市,中和區,1283,745,192,937,62,999,1793,55.72%,41.55%,1
新北市,中和區,1284,578,144,722,65,787,1352,58.21%,42.75%,1
新北市,中和區,1285,806,158,964,56,1020,1813,56.26%,44.46%,1
新北市,中和區,1286,621,140,761,42,803,1288,62.34%,48.21%,1
新北市,中和區,1287,481,138,619,41,660,1186,55.65%,40.56%,1
新北市,中和區,1288,462,148,610,10,620,1237,50.12%,37.35%,1
新北市,中和區,1289,572,144,716,49,765,1406,54.41%,40.68%,1
新北市,中和區,1290,595,140,735,73,808,1442,56.03%,41.26%,1
新北市,中和區,1291,455,125,580,56,636,1040,61.15%,43.75%,1
新北市,中和區,1292,569,171,740,46,786,1292,60.84%,44.04%,1
新北市,中和區,1293,702,217,919,64,983,1811,54.28%,38.76%,1
新北市,中和區,1294,728,173,901,111,1012,1789,56.57%,40.69%,1
新北市,中和區,1295,446,84,530,35,565,859,65.77%,51.92%,1
新北市,中和區,1296,516,78,594,32,626,972,64.4%,53.09%,1
新北市,中和區,1297,556,156,712,53,765,1346,56.84%,41.31%,1
新北市,中和區,1298,433,130,563,37,600,1034,58.03%,41.88%,1
新北市,中和區,1299,605,140,745,51,796,1387,57.39%,43.62%,1
新北市,中和區,1300,854,218,1072,100,1172,2067,56.7%,41.32%,1
新北市,中和區,1301,571,173,744,62,806,1670,48.26%,34.19%,1
新北市,中和區,1302,484,117,601,57,658,1166,56.43%,41.51%,1
新北市,中和區,1303,437,98,535,40,575,963,59.71%,45.38%,1
新北市,中和區,1304,409,116,525,35,560,1070,52.34%,38.22%,1
新北市,中和區,1305,542,152,694,45,739,1319,56.03%,41.09%,1
新北市,中和區,1306,667,156,823,64,887,1438,61.68%,46.38%,1
新北市,中和區,1307,721,154,875,34,909,1808,50.28%,39.88%,1
新北市,中和區,1308,498,88,586,23,609,1191,51.13%,41.81%,1
新北市,中和區,1309,669,170,839,65,904,1632,55.39%,40.99%,1
新北市,中和區,1310,715,146,861,46,907,1765,51.39%,40.51%,1
新北市,中和區,1311,573,94,667,33,700,1168,59.93%,49.06%,1
新北市,中和區,1312,503,110,613,24,637,1176,54.17%,42.77%,1
新北市,中和區,1313,782,153,935,54,989,1565,63.19%,49.97%,1
新北市,中和區,1314,620,139,759,48,807,1578,51.14%,39.29%,1
新北市,中和區,1315,859,166,1025,38,1063,2029,52.39%,42.34%,1
新北市,中和區,1316,403,85,488,34,522,905,57.68%,44.53%,1
新北市,中和區,1317,327,76,403,41,444,839,52.92%,38.97%,1
新北市,中和區,1318,318,88,406,32,438,762,57.48%,41.73%,1
新北市,中和區,1319,485,149,634,69,703,1420,49.51%,34.15%,1
新北市,中和區,1320,510,125,635,60,695,1272,54.64%,40.09%,1
新北市,中和區,1321,784,201,985,76,1061,1976,53.69%,39.68%,1
新北市,中和區,1322,749,152,901,52,953,1779,53.57%,42.1%,1
新北市,中和區,1323,524,123,647,58,705,1454,48.49%,36.04%,1
新北市,中和區,1324,559,116,675,31,706,1374,51.38%,40.68%,1
新北市,中和區,1325,542,105,647,48,695,1369,50.77%,39.59%,1
新北市,中和區,1326,619,147,766,56,822,1501,54.76%,41.24%,1
新北市,中和區,1327,424,115,539,59,598,920,65%,46.09%,1
新北市,中和區,1328,472,119,591,62,653,1050,62.19%,44.95%,1
新北市,中和區,1329,134,44,178,20,198,321,61.68%,41.74%,1
新北市,中和區,1330,414,138,552,62,614,1474,41.66%,28.09%,1
新北市,中和區,1331,630,135,765,71,836,1461,57.22%,43.12%,1
新北市,中和區,1332,651,156,807,52,859,1621,52.99%,40.16%,1
新北市,中和區,1333,559,194,753,68,821,1327,61.87%,42.13%,1
新北市,中和區,1334,323,89,412,35,447,775,57.68%,41.68%,1
新北市,中和區,1335,734,184,918,42,960,1916,50.1%,38.31%,1
新北市,中和區,1336,727,182,909,69,978,1901,51.45%,38.24%,1
新北市,中和區,1337,558,156,714,38,752,4411,17.05%,12.65%,1
新北市,中和區,1338,504,140,644,21,665,1212,54.87%,41.58%,1
新北市,中和區,1339,476,132,608,42,650,1126,57.73%,42.27%,1
新北市,中和區,1340,601,146,747,26,773,1507,51.29%,39.88%,1
新北市,中和區,1341,640,153,793,28,821,1519,54.05%,42.13%,1
新北市,中和區,1342,638,154,792,49,841,1467,57.33%,43.49%,1
新北市,中和區,1343,648,160,808,74,882,1453,60.7%,44.6%,1
新北市,中和區,1344,605,168,773,50,823,1364,60.34%,44.35%,1
新北市,中和區,1345,556,119,675,54,729,1302,55.99%,42.7%,1
新北市,中和區,1346,574,127,701,42,743,1627,45.67%,35.28%,1
新北市,中和區,1347,567,151,718,45,763,1503,50.77%,37.72%,1
新北市,中和區,1348,539,140,679,33,712,1392,51.15%,38.72%,1
新北市,中和區,1349,495,102,597,39,636,1067,59.61%,46.39%,1
新北市,中和區,1350,626,179,805,57,862,1623,53.11%,38.57%,1
新北市,中和區,1351,537,133,670,35,705,1208,58.36%,44.45%,1
新北市,中和區,1352,672,173,845,48,893,1991,44.85%,33.75%,1
新北市,中和區,1353,714,130,844,58,902,1932,46.69%,36.96%,1
新北市,中和區,1354,470,110,580,43,623,947,65.79%,49.63%,1
新北市,中和區,1355,692,195,887,76,963,1660,58.01%,41.69%,1
新北市,中和區,1356,577,147,724,62,786,1574,49.94%,36.66%,1
新北市,中和區,1357,802,211,1013,66,1079,2136,50.51%,37.55%,1
新北市,中和區,1358,522,179,701,80,781,1462,53.42%,35.7%,1
新北市,中和區,1359,592,133,725,83,808,1548,52.2%,38.24%,1
新北市,中和區,1360,355,79,434,23,457,692,66.04%,51.3%,1
新北市,中和區,1361,592,115,707,63,770,1221,63.06%,48.48%,1
新北市,中和區,1362,557,173,730,56,786,1331,59.05%,41.85%,1
新北市,中和區,1363,450,105,555,48,603,984,61.28%,45.73%,1
新北市,中和區,1364,693,192,885,59,944,1871,50.45%,37.04%,1
新北市,中和區,1365,507,125,632,44,676,1279,52.85%,39.64%,1
新北市,中和區,1366,684,189,873,55,928,1629,56.97%,41.99%,1
新北市,中和區,1367,649,155,804,37,841,1482,56.75%,43.79%,1
新北市,中和區,1368,748,191,939,59,998,1715,58.19%,43.62%,1
新北市,中和區,1369,805,217,1022,66,1088,1952,55.74%,41.24%,1
新北市,中和區,1370,299,67,366,38,404,686,58.89%,43.59%,1
新北市,中和區,1371,532,190,722,33,755,1577,47.88%,33.73%,1
新北市,中和區,1372,522,116,638,10,648,1158,55.96%,45.08%,1
新北市,中和區,1373,584,132,716,24,740,1195,61.92%,48.87%,1
新北市,中和區,1374,513,130,643,32,675,1054,64.04%,48.67%,1
新北市,中和區,1375,285,76,361,30,391,612,63.89%,46.57%,1
新北市,中和區,1376,724,169,893,36,929,1668,55.7%,43.41%,1
新北市,中和區,1377,478,143,621,64,685,1071,63.96%,44.63%,1
新北市,中和區,1378,576,168,744,54,798,1169,68.26%,49.27%,1
新北市,中和區,1379,542,147,689,49,738,1370,53.87%,39.56%,1
新北市,中和區,1380,687,187,874,76,950,1574,60.36%,43.65%,1
新北市,中和區,1381,931,193,1124,34,1158,2614,44.3%,35.62%,1
新北市,中和區,1382,627,192,819,44,863,1477,58.43%,42.45%,1
新北市,中和區,1383,431,115,546,65,611,1041,58.69%,41.4%,1
新北市,中和區,1384,582,128,710,51,761,1538,49.48%,37.84%,1
新北市,中和區,1385,605,191,796,55,851,1599,53.22%,37.84%,1
新北市,中和區,1386,657,205,862,77,939,1586,59.21%,41.42%,1
新北市,中和區,1387,725,222,947,90,1037,1726,60.08%,42%,1
新北市,中和區,1388,807,240,1047,88,1135,1854,61.22%,43.53%,1
新北市,中和區,1389,662,172,834,60,894,1472,60.73%,44.97%,1
新北市,中和區,1390,635,162,797,69,866,1430,60.56%,44.41%,1
新北市,中和區,1391,677,159,836,55,891,1488,59.88%,45.5%,1
新北市,中和區,1392,497,153,650,29,679,1251,54.28%,39.73%,1
新北市,中和區,1393,667,153,820,44,864,1487,58.1%,44.86%,1
新北市,中和區,1394,494,156,650,94,744,1328,56.02%,37.2%,1
新北市,中和區,1395,539,110,649,47,696,1128,61.7%,47.78%,1
新北市,中和區,1396,505,119,624,32,656,1008,65.08%,50.1%,1
新北市,中和區,1397,760,214,974,38,1012,1786,56.66%,42.55%,1
新北市,中和區,1398,889,226,1115,82,1197,2219,53.94%,40.06%,1
新北市,中和區,1399,480,149,629,37,666,1322,50.38%,36.31%,1
新北市,中和區,1400,592,152,744,29,773,1495,51.71%,39.6%,1
新北市,中和區,1401,531,175,706,49,755,1414,53.39%,37.55%,1
新北市,中和區,1402,705,192,897,71,968,1681,57.58%,41.94%,1
新北市,中和區,1403,559,143,702,50,752,1361,55.25%,41.07%,1
新北市,中和區,1404,561,174,735,67,802,1442,55.62%,38.9%,1
新北市,中和區,1405,519,164,683,27,710,1383,51.34%,37.53%,1
新北市,中和區,1406,566,169,735,36,771,1264,61%,44.78%,1
新北市,中和區,1407,740,222,962,116,1078,1810,59.56%,40.88%,1
新北市,中和區,1408,701,196,897,47,944,1951,48.39%,35.93%,1
新北市,中和區,1409,597,124,721,47,768,1582,48.55%,37.74%,1
新北市,中和區,1410,937,124,1061,91,1152,1945,59.23%,48.17%,1
新北市,中和區,1411,609,140,749,53,802,1390,57.7%,43.81%,1
新北市,中和區,1412,496,135,631,18,649,1161,55.9%,42.72%,1
新北市,中和區,1413,672,77,749,39,788,1399,56.33%,48.03%,1
新北市,中和區,1414,432,117,549,27,576,1070,53.83%,40.37%,1
新北市,中和區,1415,461,131,592,25,617,1169,52.78%,39.44%,1
新北市,中和區,1416,550,141,691,74,765,1214,63.01%,45.3%,1
新北市,中和區,1417,614,140,754,68,822,1398,58.8%,43.92%,1
新北市,中和區,1418,450,120,570,33,603,1049,57.48%,42.9%,1
新北市,中和區,1419,599,159,758,49,807,1324,60.95%,45.24%,1
新北市,中和區,1420,608,168,776,36,812,1765,46.01%,34.45%,1
新北市,中和區,1421,656,177,833,46,879,1709,51.43%,38.39%,1
新北市,中和區,1422,494,141,635,61,696,1186,58.68%,41.65%,1
新北市,中和區,1423,550,164,714,56,770,1318,58.42%,41.73%,1
新北市,中和區,1424,598,178,776,41,817,1430,57.13%,41.82%,1
新北市,中和區,1425,542,138,680,54,734,1637,44.84%,33.11%,1
新北市,中和區,1426,511,140,651,58,709,1283,55.26%,39.83%,1
新北市,中和區,1427,531,160,691,48,739,1310,56.41%,40.53%,1
新北市,中和區,1428,561,141,702,55,757,1301,58.19%,43.12%,1
新北市,中和區,1429,699,204,903,63,966,1681,57.47%,41.58%,1
新北市,中和區,1430,581,159,740,41,781,1384,56.43%,41.98%,1
新北市,中和區,1431,493,134,627,59,686,1187,57.79%,41.53%,1
新北市,中和區,1432,605,175,780,3,783,1779,44.01%,34.01%,1
新北市,中和區,1433,756,161,917,52,969,1712,56.6%,44.16%,1
新北市,中和區,1434,591,155,746,51,797,1462,54.51%,40.42%,1
新北市,中和區,1435,734,192,926,41,967,1824,53.02%,40.24%,1
新北市,中和區,1436,544,165,709,69,778,1389,56.01%,39.16%,1
新北市,中和區,1437,630,164,794,43,837,1434,58.37%,43.93%,1
新北市,中和區,1438,808,165,973,63,1036,1953,53.05%,41.37%,1
新北市,中和區,1439,799,226,1025,75,1100,2002,54.95%,39.91%,1
新北市,中和區,1440,751,160,911,45,956,1858,51.45%,40.42%,1
新北市,中和區,1441,740,165,905,23,928,1801,51.53%,41.09%,1
新北市,中和區,1442,723,180,903,65,968,1691,57.24%,42.76%,1
新北市,中和區,1443,595,161,756,50,806,1363,59.13%,43.65%,1
新北市,中和區,1444,599,123,722,30,752,1220,61.64%,49.1%,1
新北市,中和區,1445,665,142,807,32,839,1365,61.47%,48.72%,1
新北市,中和區,1446,515,115,630,33,663,1178,56.28%,43.72%,1
新北市,中和區,1447,375,93,468,36,504,830,60.72%,45.18%,1
新北市,中和區,1448,464,122,586,53,639,1197,53.38%,38.76%,1
新北市,中和區,1449,573,169,742,54,796,1369,58.14%,41.86%,1
新北市,中和區,1450,599,145,744,51,795,1336,59.51%,44.84%,1
新北市,中和區,1451,654,149,803,57,860,1377,62.45%,47.49%,1
新北市,中和區,1452,637,178,815,67,882,1499,58.84%,42.49%,1
新北市,中和區,1453,749,173,922,48,970,1689,57.43%,44.35%,1
新北市,中和區,1454,574,170,744,56,800,1323,60.47%,43.39%,1
新北市,中和區,1455,489,145,634,42,676,1079,62.65%,45.32%,1
新北市,中和區,1456,647,185,832,67,899,1545,58.19%,41.88%,1
新北市,中和區,1457,512,162,674,65,739,1326,55.73%,38.61%,1
新北市,中和區,1458,576,161,737,42,779,1443,53.98%,39.92%,1
新北市,中和區,1459,749,157,906,32,938,1712,54.79%,43.75%,1
新北市,中和區,1460,803,182,985,58,1043,1916,54.44%,41.91%,1
新北市,中和區,1461,402,103,505,36,541,863,62.69%,46.58%,1
新北市,中和區,1462,585,148,733,13,746,1203,62.01%,48.63%,1
新北市,中和區,1463,645,134,779,17,796,1483,53.67%,43.49%,1
新北市,中和區,1464,666,140,806,31,837,1575,53.14%,42.29%,1
新北市,中和區,1465,515,142,657,64,721,1432,50.35%,35.96%,1
新北市,中和區,1466,614,134,748,59,807,1441,56%,42.61%,1
新北市,中和區,1467,551,149,700,55,755,1269,59.5%,43.42%,1
新北市,中和區,1468,630,137,767,39,806,1363,59.13%,46.22%,1
新北市,中和區,1469,506,84,590,34,624,1089,57.3%,46.46%,1
新北市,中和區,1470,433,139,572,31,603,1171,51.49%,36.98%,1
新北市,中和區,1471,515,93,608,35,643,1150,55.91%,44.78%,1
新北市,中和區,1472,572,132,704,23,727,1154,63%,49.57%,1
新北市,中和區,1473,517,104,621,37,658,1067,61.67%,48.45%,1
新北市,中和區,1474,631,148,779,44,823,1526,53.93%,41.35%,1
新北市,中和區,1475,643,147,790,52,842,1447,58.19%,44.44%,1
新北市,永和區,1476,656,186,842,79,921,1554,59.27%,42.21%,1
新北市,永和區,1477,473,98,571,22,593,1065,55.68%,44.41%,1
新北市,永和區,1478,417,83,500,42,542,854,63.47%,48.83%,1
新北市,永和區,1479,571,129,700,60,760,1253,60.65%,45.57%,1
新北市,永和區,1480,718,202,920,43,963,1733,55.57%,41.43%,1
新北市,永和區,1481,651,182,833,60,893,1581,56.48%,41.18%,1
新北市,永和區,1482,725,171,896,56,952,1735,54.87%,41.79%,1
新北市,永和區,1483,684,123,807,24,831,1563,53.17%,43.76%,1
新北市,永和區,1484,715,201,916,63,979,1650,59.33%,43.33%,1
新北市,永和區,1485,649,126,775,47,822,1454,56.53%,44.64%,1
新北市,永和區,1486,600,162,762,60,822,1568,52.42%,38.27%,1
新北市,永和區,1487,605,147,752,44,796,1444,55.12%,41.9%,1
新北市,永和區,1488,451,125,576,48,624,1140,54.74%,39.56%,1
新北市,永和區,1489,544,132,676,55,731,1188,61.53%,45.79%,1
新北市,永和區,1490,623,169,792,62,854,1516,56.33%,41.09%,1
新北市,永和區,1491,594,124,718,62,780,1397,55.83%,42.52%,1
新北市,永和區,1492,618,140,758,42,800,1438,55.63%,42.98%,1
新北市,永和區,1493,502,108,610,39,649,1084,59.87%,46.31%,1
新北市,永和區,1494,501,14,515,28,543,941,57.7%,53.24%,1
新北市,永和區,1495,678,138,816,49,865,1598,54.13%,42.43%,1
新北市,永和區,1496,609,176,785,32,817,2842,28.75%,21.43%,1
新北市,永和區,1497,564,176,740,47,787,1261,62.41%,44.73%,1
新北市,永和區,1498,695,184,879,47,926,1449,63.91%,47.96%,1
新北市,永和區,1499,654,182,836,48,884,1511,58.5%,43.28%,1
新北市,永和區,1500,716,152,868,59,927,1470,63.06%,48.71%,1
新北市,永和區,1501,689,172,861,47,908,1580,57.47%,43.61%,1
新北市,永和區,1502,693,162,855,45,900,1438,62.59%,48.19%,1
新北市,永和區,1503,636,138,774,32,806,1305,61.76%,48.74%,1
新北市,永和區,1504,494,108,602,30,632,1046,60.42%,47.23%,1
新北市,永和區,1505,680,170,850,27,877,1566,56%,43.42%,1
新北市,永和區,1506,646,178,824,36,860,1468,58.58%,44.01%,1
新北市,永和區,1507,653,155,808,44,852,1305,65.29%,50.04%,1
新北市,永和區,1508,533,138,671,34,705,1181,59.7%,45.13%,1
新北市,永和區,1509,780,100,880,55,935,1720,54.36%,45.35%,1
新北市,永和區,1510,504,154,658,25,683,1103,61.92%,45.69%,1
新北市,永和區,1511,735,158,893,79,972,1649,58.94%,44.57%,1
新北市,永和區,1512,547,170,717,37,754,1206,62.52%,45.36%,1
新北市,永和區,1513,676,176,852,50,902,1506,59.89%,44.89%,1
新北市,永和區,1514,630,159,789,67,856,1488,57.53%,42.34%,1
新北市,永和區,1515,582,148,730,64,794,1288,61.65%,45.19%,1
新北市,永和區,1516,542,155,697,38,735,1413,52.02%,38.36%,1
新北市,永和區,1517,572,141,713,59,772,1329,58.09%,43.04%,1
新北市,永和區,1518,687,154,841,42,883,1436,61.49%,47.84%,1
新北市,永和區,1519,484,131,615,49,664,1112,59.71%,43.53%,1
新北市,永和區,1520,584,119,703,39,742,1100,67.45%,53.09%,1
新北市,永和區,1521,732,178,910,51,961,1545,62.2%,47.38%,1
新北市,永和區,1522,640,129,769,34,803,1436,55.92%,44.57%,1
新北市,永和區,1523,843,177,1020,62,1082,1731,62.51%,48.7%,1
新北市,永和區,1524,787,227,1014,80,1094,1762,62.09%,44.67%,1
新北市,永和區,1525,552,148,700,44,744,1320,56.36%,41.82%,1
新北市,永和區,1526,480,129,609,13,622,1297,47.96%,37.01%,1
新北市,永和區,1527,735,200,935,89,1024,1798,56.95%,40.88%,1
新北市,永和區,1528,643,195,838,66,904,1491,60.63%,43.13%,1
新北市,永和區,1529,582,114,696,23,719,1223,58.79%,47.59%,1
新北市,永和區,1530,477,137,614,52,666,1108,60.11%,43.05%,1
新北市,永和區,1531,612,187,799,61,860,1408,61.08%,43.47%,1
新北市,永和區,1532,562,157,719,54,773,1265,61.11%,44.43%,1
新北市,永和區,1533,465,110,575,28,603,1115,54.08%,41.7%,1
新北市,永和區,1534,528,137,665,63,728,1133,64.25%,46.6%,1
新北市,永和區,1535,515,151,666,58,724,1217,59.49%,42.32%,1
新北市,永和區,1536,695,200,895,57,952,1713,55.58%,40.57%,1
新北市,永和區,1537,722,158,880,61,941,1721,54.68%,41.95%,1
新北市,永和區,1538,540,144,684,65,749,1327,56.44%,40.69%,1
新北市,永和區,1539,600,144,744,34,778,1257,61.89%,47.73%,1
新北市,永和區,1540,652,145,797,53,850,1348,63.06%,48.37%,1
新北市,永和區,1541,733,150,883,48,931,1461,63.72%,50.17%,1
新北市,永和區,1542,612,144,756,58,814,1368,59.5%,44.74%,1
新北市,永和區,1543,541,115,656,57,713,1234,57.78%,43.84%,1
新北市,永和區,1544,569,136,705,59,764,1303,58.63%,43.67%,1
新北市,永和區,1545,657,135,792,23,815,1516,53.76%,43.34%,1
新北市,永和區,1546,641,176,817,72,889,1422,62.52%,45.08%,1
新北市,永和區,1547,470,117,587,31,618,991,62.36%,47.43%,1
新北市,永和區,1548,479,115,594,40,634,1016,62.4%,47.15%,1
新北市,永和區,1549,532,122,654,38,692,1146,60.38%,46.42%,1
新北市,永和區,1550,477,117,594,26,620,1043,59.44%,45.73%,1
新北市,永和區,1551,558,134,692,28,720,1210,59.5%,46.12%,1
新北市,永和區,1552,717,175,892,34,926,1630,56.81%,43.99%,1
新北市,永和區,1553,512,115,627,27,654,1092,59.89%,46.89%,1
新北市,永和區,1554,836,211,1047,58,1105,1872,59.03%,44.66%,1
新北市,永和區,1555,764,188,952,40,992,1781,55.7%,42.9%,1
新北市,永和區,1556,475,123,598,46,644,1049,61.39%,45.28%,1
新北市,永和區,1557,694,65,759,38,797,1285,62.02%,54.01%,1
新北市,永和區,1558,555,150,705,32,737,1209,60.96%,45.91%,1
新北市,永和區,1559,519,154,673,31,704,1132,62.19%,45.85%,1
新北市,永和區,1560,584,181,765,51,816,1287,63.4%,45.38%,1
新北市,永和區,1561,510,115,625,45,670,1068,62.73%,47.75%,1
新北市,永和區,1562,519,130,649,47,696,1098,63.39%,47.27%,1
新北市,永和區,1563,557,148,705,54,759,1222,62.11%,45.58%,1
新北市,永和區,1564,516,138,654,59,713,1157,61.62%,44.6%,1
新北市,永和區,1565,557,153,710,57,767,1168,65.67%,47.69%,1
新北市,永和區,1566,535,159,694,56,750,1283,58.46%,41.7%,1
新北市,永和區,1567,585,163,748,48,796,1372,58.02%,42.64%,1
新北市,永和區,1568,878,185,1063,46,1109,1876,59.12%,46.8%,1
新北市,永和區,1569,756,175,931,68,999,1576,63.39%,47.97%,1
新北市,永和區,1570,749,197,946,51,997,1661,60.02%,45.09%,1
新北市,永和區,1571,792,183,975,31,1006,1808,55.64%,43.81%,1
新北市,永和區,1572,802,201,1003,47,1050,1898,55.32%,42.26%,1
新北市,永和區,1573,680,194,874,53,927,1508,61.47%,45.09%,1
新北市,永和區,1574,616,143,759,69,828,1341,61.74%,45.94%,1
新北市,永和區,1575,623,159,782,52,834,1422,58.65%,43.81%,1
新北市,永和區,1576,537,115,652,29,681,1177,57.86%,45.62%,1
新北市,永和區,1577,682,170,852,71,923,1557,59.28%,43.8%,1
新北市,永和區,1578,592,186,778,46,824,1491,55.26%,39.7%,1
新北市,永和區,1579,671,176,847,54,901,1586,56.81%,42.31%,1
新北市,永和區,1580,534,145,679,22,701,1313,53.39%,40.67%,1
新北市,永和區,1581,679,191,870,65,935,1636,57.15%,41.5%,1
新北市,永和區,1582,662,191,853,62,915,1598,57.26%,41.43%,1
新北市,永和區,1583,743,183,926,49,975,1609,60.6%,46.18%,1
新北市,永和區,1584,629,180,809,43,852,1375,61.96%,45.75%,1
新北市,永和區,1585,807,174,981,56,1037,1648,62.92%,48.97%,1
新北市,永和區,1586,485,124,609,39,648,1077,60.17%,45.03%,1
新北市,永和區,1587,520,148,668,35,703,1157,60.76%,44.94%,1
新北市,永和區,1588,635,180,815,38,853,1339,63.7%,47.42%,1
新北市,永和區,1589,638,138,776,18,794,1306,60.8%,48.85%,1
新北市,永和區,1590,630,131,761,25,786,1236,63.59%,50.97%,1
新北市,永和區,1591,555,122,677,24,701,1133,61.87%,48.98%,1
新北市,永和區,1592,685,132,817,46,863,1425,60.56%,48.07%,1
新北市,永和區,1593,813,209,1022,81,1103,1938,56.91%,41.95%,1
新北市,永和區,1594,697,195,892,64,956,1607,59.49%,43.37%,1
新北市,永和區,1595,402,87,489,38,527,853,61.78%,47.13%,1
新北市,永和區,1596,313,64,377,49,426,768,55.47%,40.76%,1
新北市,永和區,1597,324,57,381,29,410,893,45.91%,36.28%,1
新北市,永和區,1598,340,52,392,44,436,743,58.68%,45.76%,1
新北市,永和區,1599,528,139,667,46,713,1155,61.73%,45.71%,1
新北市,永和區,1600,596,139,735,47,782,1263,61.92%,47.19%,1
新北市,永和區,1601,581,117,698,29,727,1189,61.14%,48.86%,1
新北市,永和區,1602,572,120,692,44,736,1346,54.68%,42.5%,1
新北市,永和區,1603,580,147,727,46,773,1368,56.51%,42.4%,1
新北市,永和區,1604,470,125,595,18,613,1043,58.77%,45.06%,1
新北市,永和區,1605,754,223,977,44,1021,1709,59.74%,44.12%,1
新北市,永和區,1606,369,89,458,18,476,879,54.15%,41.98%,1
新北市,永和區,1607,397,111,508,33,541,904,59.85%,43.92%,1
新北市,永和區,1608,587,135,722,48,770,1221,63.06%,48.08%,1
新北市,永和區,1609,458,124,582,50,632,1018,62.08%,44.99%,1
新北市,永和區,1610,671,158,829,34,863,1551,55.64%,43.26%,1
新北市,永和區,1611,646,156,802,54,856,1428,59.94%,45.24%,1
新北市,永和區,1612,468,126,594,56,650,1044,62.26%,44.83%,1
新北市,永和區,1613,456,106,562,40,602,967,62.25%,47.16%,1
新北市,新莊區,0302,428,173,601,59,660,1123,58.77%,38.11%,1
新北市,新莊區,0303,508,187,695,67,762,1278,59.62%,39.75%,1
新北市,新莊區,0304,534,145,679,59,738,1163,63.46%,45.92%,1
新北市,新莊區,0305,516,181,697,56,753,1228,61.32%,42.02%,1
新北市,新莊區,0306,474,177,651,59,710,1211,58.63%,39.14%,1
新北市,新莊區,0307,458,183,641,57,698,1176,59.35%,38.95%,1
新北市,新莊區,0308,677,207,884,57,941,1536,61.26%,44.08%,1
新北市,新莊區,0309,691,176,867,66,933,1486,62.79%,46.5%,1
新北市,新莊區,0310,695,213,908,73,981,1513,64.84%,45.94%,1
新北市,新莊區,0311,588,221,809,80,889,1395,63.73%,42.15%,1
新北市,新莊區,0312,545,144,689,81,770,1353,56.91%,40.28%,1
新北市,新莊區,0313,605,194,799,72,871,1409,61.82%,42.94%,1
新北市,新莊區,0314,616,146,762,36,798,1478,53.99%,41.68%,1
新北市,新莊區,0315,380,136,516,59,575,921,62.43%,41.26%,1
新北市,新莊區,0316,406,157,563,48,611,971,62.92%,41.81%,1
新北市,新莊區,0317,718,174,892,70,962,1534,62.71%,46.81%,1
新北市,新莊區,0318,595,180,775,50,825,1516,54.42%,39.25%,1
新北市,新莊區,0319,280,95,375,35,410,697,58.82%,40.17%,1
新北市,新莊區,0320,543,119,662,40,702,1235,56.84%,43.97%,1
新北市,新莊區,0321,452,143,595,43,638,1138,56.06%,39.72%,1
新北市,新莊區,0322,405,120,525,28,553,1063,52.02%,38.1%,1
新北市,新莊區,0323,575,201,776,65,841,3399,24.74%,16.92%,1
新北市,新莊區,0324,676,181,857,78,935,1575,59.37%,42.92%,1
新北市,新莊區,0325,702,229,931,76,1007,1615,62.35%,43.47%,1
新北市,新莊區,0326,590,194,784,67,851,1612,52.79%,36.6%,1
新北市,新莊區,0327,576,186,762,78,840,1514,55.48%,38.04%,1
新北市,新莊區,0328,501,153,654,30,684,1382,49.49%,36.25%,1
新北市,新莊區,0329,599,177,776,54,830,1475,56.27%,40.61%,1
新北市,新莊區,0330,626,174,800,26,826,1462,56.5%,42.82%,1
新北市,新莊區,0331,585,165,750,38,788,1426,55.26%,41.02%,1
新北市,新莊區,0332,539,190,729,61,790,1421,55.59%,37.93%,1
新北市,新莊區,0333,636,171,807,49,856,1536,55.73%,41.41%,1
新北市,新莊區,0334,684,187,871,50,921,1587,58.03%,43.1%,1
新北市,新莊區,0335,292,81,373,17,390,749,52.07%,38.99%,1
新北市,新莊區,0336,579,141,720,46,766,1276,60.03%,45.38%,1
新北市,新莊區,0337,517,154,671,37,708,1303,54.34%,39.68%,1
新北市,新莊區,0338,560,152,712,59,771,1259,61.24%,44.48%,1
新北市,新莊區,0339,585,141,726,51,777,1291,60.19%,45.31%,1
新北市,新莊區,0340,661,155,816,31,847,1493,56.73%,44.27%,1
新北市,新莊區,0341,621,201,822,53,875,1507,58.06%,41.21%,1
新北市,新莊區,0342,623,154,777,23,800,1456,54.95%,42.79%,1
新北市,新莊區,0343,594,156,750,31,781,1396,55.95%,42.55%,1
新北市,新莊區,0344,469,150,619,61,680,1351,50.33%,34.72%,1
新北市,新莊區,0345,571,157,728,67,795,1403,56.66%,40.7%,1
新北市,新莊區,0346,576,186,762,70,832,1497,55.58%,38.48%,1
新北市,新莊區,0347,538,157,695,79,774,1272,60.85%,42.3%,1
新北市,新莊區,0348,460,121,581,39,620,1269,48.86%,36.25%,1
新北市,新莊區,0349,540,167,707,50,757,1335,56.7%,40.45%,1
新北市,新莊區,0350,596,162,758,35,793,1300,61%,45.85%,1
新北市,新莊區,0351,606,130,736,44,780,1286,60.65%,47.12%,1
新北市,新莊區,0352,615,157,772,52,824,1255,65.66%,49%,1
新北市,新莊區,0353,624,176,800,92,892,1558,57.25%,40.05%,1
新北市,新莊區,0354,617,176,793,72,865,1567,55.2%,39.37%,1
新北市,新莊區,0355,675,190,865,72,937,1603,58.45%,42.11%,1
新北市,新莊區,0356,630,182,812,40,852,1538,55.4%,40.96%,1
新北市,新莊區,0357,659,231,890,59,949,1671,56.79%,39.44%,1
新北市,新莊區,0358,616,203,819,49,868,1698,51.12%,36.28%,1
新北市,新莊區,0359,683,203,886,51,937,1545,60.65%,44.21%,1
新北市,新莊區,0360,710,203,913,117,1030,1696,60.73%,41.86%,1
新北市,新莊區,0361,604,190,794,104,898,1626,55.23%,37.15%,1
新北市,新莊區,0362,439,124,563,62,625,1170,53.42%,37.52%,1
新北市,新莊區,0363,473,146,619,99,718,1236,58.09%,38.27%,1
新北市,新莊區,0364,415,114,529,66,595,1071,55.56%,38.75%,1
新北市,新莊區,0365,437,154,591,53,644,1129,57.04%,38.71%,1
新北市,新莊區,0366,661,203,864,50,914,1586,57.63%,41.68%,1
新北市,新莊區,0367,584,181,765,64,829,1597,51.91%,36.57%,1
新北市,新莊區,0368,529,174,703,110,813,1573,51.68%,33.63%,1
新北市,新莊區,0369,452,130,582,51,633,1225,51.67%,36.9%,1
新北市,新莊區,0370,463,113,576,37,613,1217,50.37%,38.04%,1
新北市,新莊區,0371,617,188,805,85,890,1571,56.65%,39.27%,1
新北市,新莊區,0372,623,165,788,73,861,1594,54.02%,39.08%,1
新北市,新莊區,0373,606,192,798,62,860,1583,54.33%,38.28%,1
新北市,新莊區,0374,563,141,704,54,758,1245,60.88%,45.22%,1
新北市,新莊區,0375,467,162,629,52,681,1203,56.61%,38.82%,1
新北市,新莊區,0376,592,156,748,51,799,1265,63.16%,46.8%,1
新北市,新莊區,0377,527,157,684,66,750,1255,59.76%,41.99%,1
新北市,新莊區,0378,532,173,705,48,753,1287,58.51%,41.34%,1
新北市,新莊區,0379,496,183,679,53,732,1167,62.72%,42.5%,1
新北市,新莊區,0380,505,140,645,68,713,1299,54.89%,38.88%,1
新北市,新莊區,0381,499,147,646,52,698,1207,57.83%,41.34%,1
新北市,新莊區,0382,606,166,772,53,825,1415,58.3%,42.83%,1
新北市,新莊區,0383,517,194,711,72,783,1342,58.35%,38.52%,1
新北市,新莊區,0384,494,176,670,91,761,1341,56.75%,36.84%,1
新北市,新莊區,0385,504,139,643,72,715,1247,57.34%,40.42%,1
新北市,新莊區,0386,521,99,620,30,650,984,66.06%,52.95%,1
新北市,新莊區,0387,477,119,596,47,643,1043,61.65%,45.73%,1
新北市,新莊區,0388,532,179,711,43,754,1135,66.43%,46.87%,1
新北市,新莊區,0389,501,140,641,45,686,1185,57.89%,42.28%,1
新北市,新莊區,0390,560,164,724,52,776,1346,57.65%,41.6%,1
新北市,新莊區,0391,560,174,734,84,818,1372,59.62%,40.82%,1
新北市,新莊區,0392,586,173,759,68,827,1350,61.26%,43.41%,1
新北市,新莊區,0393,472,171,643,82,725,1307,55.47%,36.11%,1
新北市,新莊區,0394,529,155,684,92,776,1353,57.35%,39.1%,1
新北市,新莊區,0395,521,164,685,83,768,1287,59.67%,40.48%,1
新北市,新莊區,0396,523,132,655,36,691,1567,44.1%,33.38%,1
新北市,新莊區,0397,715,214,929,90,1019,1709,59.63%,41.84%,1
新北市,新莊區,0398,614,138,752,37,789,1616,48.82%,38%,1
新北市,新莊區,0399,571,170,741,70,811,1628,49.82%,35.07%,1
新北市,新莊區,0400,499,142,641,65,706,1148,61.5%,43.47%,1
新北市,新莊區,0401,495,160,655,12,667,1201,55.54%,41.22%,1
新北市,新莊區,0402,515,158,673,55,728,1135,64.14%,45.37%,1
新北市,新莊區,0403,646,220,866,56,922,1495,61.67%,43.21%,1
新北市,新莊區,0404,643,198,841,67,908,1486,61.1%,43.27%,1
新北市,新莊區,0405,700,172,872,49,921,1483,62.1%,47.2%,1
新北市,新莊區,0406,660,150,810,51,861,1553,55.44%,42.5%,1
新北市,新莊區,0407,764,203,967,37,1004,1625,61.78%,47.02%,1
新北市,新莊區,0408,710,176,886,36,922,1671,55.18%,42.49%,1
新北市,新莊區,0409,606,186,792,74,866,1389,62.35%,43.63%,1
新北市,新莊區,0410,531,162,693,36,729,1272,57.31%,41.75%,1
新北市,新莊區,0411,668,160,828,50,878,1409,62.31%,47.41%,1
新北市,新莊區,0412,578,200,778,38,816,1372,59.48%,42.13%,1
新北市,新莊區,0413,384,120,504,56,560,955,58.64%,40.21%,1
新北市,新莊區,0414,359,112,471,68,539,952,56.62%,37.71%,1
新北市,新莊區,0415,573,174,747,39,786,1412,55.67%,40.58%,1
新北市,新莊區,0416,550,208,758,64,822,1415,58.09%,38.87%,1
新北市,新莊區,0417,598,191,789,65,854,1421,60.1%,42.08%,1
新北市,新莊區,0418,571,174,745,63,808,1293,62.49%,44.16%,1
新北市,新莊區,0419,565,157,722,22,744,1475,50.44%,38.31%,1
新北市,新莊區,0420,587,157,744,74,818,1429,57.24%,41.08%,1
新北市,新莊區,0421,623,158,781,62,843,1481,56.92%,42.07%,1
新北市,新莊區,0422,634,164,798,90,888,1472,60.33%,43.07%,1
新北市,新莊區,0423,640,184,824,41,865,1474,58.68%,43.42%,1
新北市,新莊區,0424,633,183,816,26,842,1462,57.59%,43.3%,1
新北市,新莊區,0425,649,192,841,42,883,1484,59.5%,43.73%,1
新北市,新莊區,0426,629,157,786,51,837,1461,57.29%,43.05%,1
新北市,新莊區,0427,639,161,800,34,834,1444,57.76%,44.25%,1
新北市,新莊區,0428,654,159,813,29,842,1437,58.59%,45.51%,1
新北市,新莊區,0429,618,178,796,37,833,1641,50.76%,37.66%,1
新北市,新莊區,0430,608,197,805,37,842,1633,51.56%,37.23%,1
新北市,新莊區,0431,653,177,830,24,854,1531,55.78%,42.65%,1
新北市,新莊區,0432,675,167,842,62,904,1517,59.59%,44.5%,1
新北市,新莊區,0433,595,174,769,55,824,1487,55.41%,40.01%,1
新北市,新莊區,0434,672,159,831,53,884,1560,56.67%,43.08%,1
新北市,新莊區,0435,623,202,825,68,893,1584,56.38%,39.33%,1
新北市,新莊區,0436,654,179,833,34,867,1602,54.12%,40.82%,1
新北市,新莊區,0437,311,122,433,51,484,818,59.17%,38.02%,1
新北市,新莊區,0438,552,165,717,62,779,1633,47.7%,33.8%,1
新北市,新莊區,0439,608,207,815,73,888,1652,53.75%,36.8%,1
新北市,新莊區,0440,575,180,755,70,825,1498,55.07%,38.38%,1
新北市,新莊區,0441,533,159,692,51,743,1379,53.88%,38.65%,1
新北市,新莊區,0442,594,166,760,49,809,1381,58.58%,43.01%,1
新北市,新莊區,0443,650,183,833,72,905,1535,58.96%,42.35%,1
新北市,新莊區,0444,665,207,872,69,941,1492,63.07%,44.57%,1
新北市,新莊區,0445,652,176,828,82,910,1450,62.76%,44.97%,1
新北市,新莊區,0446,472,134,606,51,657,1107,59.35%,42.64%,1
新北市,新莊區,0447,471,132,603,57,660,1063,62.09%,44.31%,1
新北市,新莊區,0448,446,162,608,63,671,1143,58.71%,39.02%,1
新北市,新莊區,0449,509,150,659,96,755,1341,56.3%,37.96%,1
新北市,新莊區,0450,455,125,580,45,625,1063,58.8%,42.8%,1
新北市,新莊區,0451,450,156,606,52,658,1096,60.04%,41.06%,1
新北市,新莊區,0452,548,155,703,44,747,1309,57.07%,41.86%,1
新北市,新莊區,0453,510,179,689,45,734,1216,60.36%,41.94%,1
新北市,新莊區,0454,503,138,641,43,684,1278,53.52%,39.36%,1
新北市,新莊區,0455,514,186,700,72,772,1352,57.1%,38.02%,1
新北市,新莊區,0456,464,157,621,57,678,1298,52.23%,35.75%,1
新北市,新莊區,0457,437,125,562,50,612,1042,58.73%,41.94%,1
新北市,新莊區,0458,335,103,438,25,463,881,52.55%,38.02%,1
新北市,新莊區,0459,498,170,668,52,720,1109,64.92%,44.91%,1
新北市,新莊區,0460,515,149,664,53,717,1291,55.54%,39.89%,1
新北市,新莊區,0461,515,144,659,25,684,1293,52.9%,39.83%,1
新北市,新莊區,0462,535,185,720,66,786,1336,58.83%,40.04%,1
新北市,新莊區,0463,562,135,697,48,745,1384,53.83%,40.61%,1
新北市,新莊區,0464,498,89,587,22,609,1231,49.47%,40.45%,1
新北市,新莊區,0465,420,93,513,32,545,940,57.98%,44.68%,1
新北市,新莊區,0466,502,167,669,96,765,1369,55.88%,36.67%,1
新北市,新莊區,0467,557,158,715,65,780,1384,56.36%,40.25%,1
新北市,新莊區,0468,493,173,666,72,738,1272,58.02%,38.76%,1
新北市,新莊區,0469,483,112,595,42,637,1073,59.37%,45.01%,1
新北市,新莊區,0470,432,135,567,33,600,1058,56.71%,40.83%,1
新北市,新莊區,0471,629,169,798,24,822,1528,53.8%,41.16%,1
新北市,新莊區,0472,529,110,639,40,679,1244,54.58%,42.52%,1
新北市,新莊區,0473,543,131,674,51,725,1356,53.47%,40.04%,1
新北市,新莊區,0474,484,97,581,29,610,1164,52.41%,41.58%,1
新北市,新莊區,0475,636,139,775,65,840,1423,59.03%,44.69%,1
新北市,新莊區,0476,578,161,739,35,774,1250,61.92%,46.24%,1
新北市,新莊區,0477,512,144,656,34,690,1252,55.11%,40.89%,1
新北市,新莊區,0478,414,113,527,27,554,1022,54.21%,40.51%,1
新北市,新莊區,0479,389,135,524,39,563,959,58.71%,40.56%,1
新北市,新莊區,0480,215,685,900,53,953,1646,57.9%,13.06%,1
新北市,新莊區,0481,638,166,804,64,868,1551,55.96%,41.13%,1
新北市,新莊區,0482,664,187,851,53,904,1526,59.24%,43.51%,1
新北市,新莊區,0483,634,186,820,30,850,1518,55.99%,41.77%,1
新北市,新莊區,0484,686,171,857,46,903,1547,58.37%,44.34%,1
新北市,新莊區,0485,575,169,744,81,825,1505,54.82%,38.21%,1
新北市,新莊區,0486,551,190,741,82,823,1527,53.9%,36.08%,1
新北市,新莊區,0487,556,167,723,58,781,1482,52.7%,37.52%,1
新北市,新莊區,0488,606,146,752,67,819,1586,51.64%,38.21%,1
新北市,新莊區,0489,416,135,551,68,619,1065,58.12%,39.06%,1
新北市,新莊區,0490,491,134,625,46,671,1040,64.52%,47.21%,1
新北市,新莊區,0491,431,135,566,45,611,1090,56.06%,39.54%,1
新北市,新莊區,0492,439,128,567,54,621,1071,57.98%,40.99%,1
新北市,新莊區,0493,625,193,818,33,851,1704,49.94%,36.68%,1
新北市,新莊區,0494,625,157,782,37,819,1698,48.23%,36.81%,1
新北市,新莊區,0495,636,157,793,56,849,1362,62.33%,46.7%,1
新北市,新莊區,0496,574,167,741,40,781,1350,57.85%,42.52%,1
新北市,新莊區,0497,705,201,906,65,971,1689,57.49%,41.74%,1
新北市,新莊區,0498,691,171,862,70,932,1612,57.82%,42.87%,1
新北市,新莊區,0499,488,135,623,61,684,1130,60.53%,43.19%,1
新北市,新莊區,0500,478,148,626,68,694,1111,62.47%,43.02%,1
新北市,新莊區,0501,610,175,785,44,829,1539,53.87%,39.64%,1
新北市,新莊區,0502,631,211,842,37,879,1586,55.42%,39.79%,1
新北市,新莊區,0503,657,199,856,77,933,1631,57.2%,40.28%,1
新北市,新莊區,0504,627,176,803,57,860,1540,55.84%,40.71%,1
新北市,新莊區,0505,469,181,650,48,698,1388,50.29%,33.79%,1
新北市,新莊區,0506,479,159,638,74,712,1388,51.3%,34.51%,1
新北市,新莊區,0507,479,148,627,64,691,1387,49.82%,34.53%,1
新北市,新莊區,0508,473,123,596,36,632,1181,53.51%,40.05%,1
新北市,新莊區,0509,443,170,613,59,672,1135,59.21%,39.03%,1
新北市,新莊區,0510,453,162,615,56,671,1173,57.2%,38.62%,1
新北市,新莊區,0511,518,152,670,35,705,1215,58.02%,42.63%,1
新北市,新莊區,0512,632,186,818,48,866,1488,58.2%,42.47%,1
新北市,新莊區,0513,594,175,769,61,830,1444,57.48%,41.14%,1
新北市,新莊區,0514,604,177,781,48,829,1499,55.3%,40.29%,1
新北市,新莊區,0515,585,188,773,29,802,1449,55.35%,40.37%,1
新北市,新莊區,0516,666,180,846,77,923,1640,56.28%,40.61%,1
新北市,新莊區,0517,625,199,824,79,903,1648,54.79%,37.92%,1
新北市,新莊區,0518,515,156,671,51,722,1371,52.66%,37.56%,1
新北市,新莊區,0519,521,181,702,69,771,1400,55.07%,37.21%,1
新北市,新莊區,0520,587,152,739,71,810,1457,55.59%,40.29%,1
新北市,新莊區,0521,564,169,733,16,749,1502,49.87%,37.55%,1
新北市,新莊區,0522,561,152,713,70,783,1412,55.45%,39.73%,1
新北市,新莊區,0523,528,140,668,63,731,1318,55.46%,40.06%,1
新北市,新莊區,0524,593,177,770,61,831,1411,58.89%,42.03%,1
新北市,新莊區,0525,548,147,695,28,723,1262,57.29%,43.42%,1
新北市,新莊區,0526,594,113,707,36,743,1228,60.5%,48.37%,1
新北市,新莊區,0527,754,190,944,78,1022,1748,58.47%,43.14%,1
新北市,新莊區,0528,767,191,958,70,1028,1761,58.38%,43.55%,1
新北市,新莊區,0529,488,152,640,64,704,1326,53.09%,36.8%,1
新北市,新莊區,0530,460,146,606,64,670,1344,49.85%,34.23%,1
新北市,新莊區,0531,590,130,720,47,767,1355,56.61%,43.54%,1
新北市,新莊區,0532,546,148,694,66,760,1306,58.19%,41.81%,1
新北市,新莊區,0533,600,161,761,38,799,1349,59.23%,44.48%,1
新北市,新莊區,0534,539,127,666,42,708,1265,55.97%,42.61%,1
新北市,新莊區,0535,562,143,705,64,769,1282,59.98%,43.84%,1
新北市,新莊區,0536,575,118,693,54,747,1237,60.39%,46.48%,1
新北市,新莊區,0537,559,132,691,23,714,1301,54.88%,42.97%,1
新北市,新莊區,0538,529,137,666,57,723,1262,57.29%,41.92%,1
新北市,新莊區,0539,538,136,674,49,723,1270,56.93%,42.36%,1
新北市,新莊區,0540,479,171,650,72,722,1245,57.99%,38.47%,1
新北市,新莊區,0541,440,175,615,72,687,1220,56.31%,36.07%,1
新北市,新莊區,0542,509,120,629,41,670,1245,53.82%,40.88%,1
新北市,新莊區,0543,466,123,589,48,637,1212,52.56%,38.45%,1
新北市,新莊區,0544,493,135,628,55,683,1253,54.51%,39.35%,1
新北市,新莊區,0545,479,140,619,56,675,1272,53.07%,37.66%,1
新北市,新莊區,0546,567,126,693,31,724,1227,59.01%,46.21%,1
新北市,新莊區,0547,503,130,633,41,674,1126,59.86%,44.67%,1
新北市,新莊區,0548,522,155,677,43,720,1240,58.06%,42.1%,1
新北市,新莊區,0549,620,162,782,47,829,1460,56.78%,42.47%,1
新北市,新莊區,0550,421,141,562,39,601,1072,56.06%,39.27%,1
新北市,新莊區,0551,414,121,535,46,581,1127,51.55%,36.73%,1
新北市,新莊區,0552,592,149,741,32,773,1332,58.03%,44.44%,1
新北市,新莊區,0553,513,153,666,18,684,1341,51.01%,38.26%,1
新北市,新莊區,0554,354,104,458,24,482,1140,42.28%,31.05%,1
新北市,新店區,1987,668,149,817,59,876,1603,54.65%,41.67%,1
新北市,新店區,1988,829,203,1032,48,1080,1921,56.22%,43.15%,1
新北市,新店區,1989,446,113,559,23,582,1082,53.79%,41.22%,1
新北市,新店區,1990,513,153,666,51,717,1235,58.06%,41.54%,1
新北市,新店區,1991,733,145,878,35,913,1568,58.23%,46.75%,1
新北市,新店區,1992,319,104,423,32,455,771,59.01%,41.37%,1
新北市,新店區,1993,490,163,653,43,696,1256,55.41%,39.01%,1
新北市,新店區,1994,439,112,551,50,601,1008,59.62%,43.55%,1
新北市,新店區,1995,704,134,838,48,886,1515,58.48%,46.47%,1
新北市,新店區,1996,787,174,961,53,1014,1637,61.94%,48.08%,1
新北市,新店區,1997,662,187,849,50,899,1549,58.04%,42.74%,1
新北市,新店區,1998,987,199,1186,66,1252,2011,62.26%,49.08%,1
新北市,新店區,1999,642,169,811,88,899,1554,57.85%,41.31%,1
新北市,新店區,2000,747,172,919,64,983,1770,55.54%,42.2%,1
新北市,新店區,2001,603,132,735,47,782,1316,59.42%,45.82%,1
新北市,新店區,2002,472,126,598,43,641,1126,56.93%,41.92%,1
新北市,新店區,2003,581,154,735,58,793,1460,54.32%,39.79%,1
新北市,新店區,2004,693,184,877,58,935,1584,59.03%,43.75%,1
新北市,新店區,2005,625,155,780,48,828,1449,57.14%,43.13%,1
新北市,新店區,2006,747,151,898,53,951,1520,62.57%,49.14%,1
新北市,新店區,2007,852,184,1036,36,1072,1821,58.87%,46.79%,1
新北市,新店區,2008,827,216,1043,51,1094,1956,55.93%,42.28%,1
新北市,新店區,2009,730,191,921,58,979,1665,58.8%,43.84%,1
新北市,新店區,2010,740,175,915,49,964,1588,60.71%,46.6%,1
新北市,新店區,2011,643,179,822,23,845,1519,55.63%,42.33%,1
新北市,新店區,2012,561,148,709,39,748,1185,63.12%,47.34%,1
新北市,新店區,2013,533,135,668,23,691,1095,63.11%,48.68%,1
新北市,新店區,2014,508,127,635,55,690,1106,62.39%,45.93%,1
新北市,新店區,2015,306,82,388,20,408,2700,15.11%,11.33%,1
新北市,新店區,2016,458,103,561,26,587,995,58.99%,46.03%,1
新北市,新店區,2017,517,116,633,40,673,1168,57.62%,44.26%,1
新北市,新店區,2018,588,114,702,58,760,1123,67.68%,52.36%,1
新北市,新店區,2019,510,147,657,46,703,1085,64.79%,47%,1
新北市,新店區,2020,665,165,830,52,882,1412,62.46%,47.1%,1
新北市,新店區,2021,770,154,924,61,985,1659,59.37%,46.41%,1
新北市,新店區,2022,597,116,713,53,766,1198,63.94%,49.83%,1
新北市,新店區,2023,586,128,714,29,743,1376,54%,42.59%,1
新北市,新店區,2024,548,128,676,34,710,1300,54.62%,42.15%,1
新北市,新店區,2025,555,126,681,44,725,1238,58.56%,44.83%,1
新北市,新店區,2026,565,134,699,28,727,1388,52.38%,40.71%,1
新北市,新店區,2027,440,105,545,41,586,933,62.81%,47.16%,1
新北市,新店區,2028,437,112,549,32,581,908,63.99%,48.13%,1
新北市,新店區,2029,681,163,844,67,911,1582,57.59%,43.05%,1
新北市,新店區,2030,601,131,732,45,777,1247,62.31%,48.2%,1
新北市,新店區,2031,449,98,547,53,600,971,61.79%,46.24%,1
新北市,新店區,2032,552,98,650,48,698,1145,60.96%,48.21%,1
新北市,新店區,2033,655,130,785,52,837,1392,60.13%,47.05%,1
新北市,新店區,2034,706,156,862,52,914,1452,62.95%,48.62%,1
新北市,新店區,2035,616,163,779,55,834,1440,57.92%,42.78%,1
新北市,新店區,2036,754,180,934,88,1022,1786,57.22%,42.22%,1
新北市,新店區,2037,837,169,1006,56,1062,1825,58.19%,45.86%,1
新北市,新店區,2038,710,143,853,28,881,1477,59.65%,48.07%,1
新北市,新店區,2039,786,192,978,50,1028,1750,58.74%,44.91%,1
新北市,新店區,2040,795,162,957,68,1025,1792,57.2%,44.36%,1
新北市,新店區,2041,897,154,1051,66,1117,1979,56.44%,45.33%,1
新北市,新店區,2042,393,83,476,24,500,826,60.53%,47.58%,1
新北市,新店區,2043,923,176,1099,43,1142,1924,59.36%,47.97%,1
新北市,新店區,2044,667,147,814,28,842,1383,60.88%,48.23%,1
新北市,新店區,2045,310,80,390,38,428,830,51.57%,37.35%,1
新北市,新店區,2046,842,182,1024,37,1061,1759,60.32%,47.87%,1
新北市,新店區,2047,923,244,1167,53,1220,1957,62.34%,47.16%,1
新北市,新店區,2048,717,154,871,23,894,1481,60.36%,48.41%,1
新北市,新店區,2049,696,155,851,68,919,1552,59.21%,44.85%,1
新北市,新店區,2050,705,73,778,66,844,1467,57.53%,48.06%,1
新北市,新店區,2051,622,136,758,39,797,1371,58.13%,45.37%,1
新北市,新店區,2052,459,98,557,41,598,991,60.34%,46.32%,1
新北市,新店區,2053,565,128,693,53,746,1231,60.6%,45.9%,1
新北市,新店區,2054,755,186,941,56,997,1701,58.61%,44.39%,1
新北市,新店區,2055,727,207,934,44,978,1707,57.29%,42.59%,1
新北市,新店區,2056,798,167,965,34,999,1773,56.35%,45.01%,1
新北市,新店區,2057,756,193,949,39,988,1866,52.95%,40.51%,1
新北市,新店區,2058,813,177,990,40,1030,1735,59.37%,46.86%,1
新北市,新店區,2059,781,207,988,50,1038,1632,63.6%,47.86%,1
新北市,新店區,2060,744,144,888,54,942,1591,59.21%,46.76%,1
新北市,新店區,2061,626,119,745,70,815,1495,54.52%,41.87%,1
新北市,新店區,2062,604,118,722,29,751,1511,49.7%,39.97%,1
新北市,新店區,2063,537,142,679,57,736,1260,58.41%,42.62%,1
新北市,新店區,2064,916,205,1121,46,1167,1948,59.91%,47.02%,1
新北市,新店區,2065,740,185,925,49,974,1582,61.57%,46.78%,1
新北市,新店區,2066,560,144,704,58,762,1315,57.95%,42.59%,1
新北市,新店區,2067,742,58,800,46,846,1562,54.16%,47.5%,1
新北市,新店區,2068,953,185,1138,28,1166,1982,58.83%,48.08%,1
新北市,新店區,2069,677,170,847,52,899,1518,59.22%,44.6%,1
新北市,新店區,2070,778,157,935,35,970,1735,55.91%,44.84%,1
新北市,新店區,2071,760,149,909,54,963,1716,56.12%,44.29%,1
新北市,新店區,2072,703,165,868,55,923,1580,58.42%,44.49%,1
新北市,新店區,2073,633,166,799,45,844,1358,62.15%,46.61%,1
新北市,新店區,2074,703,211,914,88,1002,1610,62.24%,43.66%,1
新北市,新店區,2075,556,174,730,43,773,1383,55.89%,40.2%,1
新北市,新店區,2076,706,162,868,36,904,1596,56.64%,44.24%,1
新北市,新店區,2077,573,113,686,38,724,1360,53.24%,42.13%,1
新北市,新店區,2078,503,71,574,19,593,1160,51.12%,43.36%,1
新北市,新店區,2079,639,92,731,35,766,1236,61.97%,51.7%,1
新北市,新店區,2080,654,114,768,26,794,1234,64.34%,53%,1
新北市,新店區,2081,684,174,858,59,917,1579,58.07%,43.32%,1
新北市,新店區,2082,571,93,664,45,709,1241,57.13%,46.01%,1
新北市,新店區,2083,537,138,675,29,704,1275,55.22%,42.12%,1
新北市,新店區,2084,492,106,598,48,646,1214,53.21%,40.53%,1
新北市,新店區,2085,578,151,729,60,789,1578,50%,36.63%,1
新北市,新店區,2086,584,162,746,48,794,1442,55.06%,40.5%,1
新北市,新店區,2087,541,147,688,76,764,1475,51.8%,36.68%,1
新北市,新店區,2088,698,178,876,48,924,1580,58.48%,44.18%,1
新北市,新店區,2089,636,158,794,38,832,1585,52.49%,40.13%,1
新北市,新店區,2090,664,164,828,60,888,1586,55.99%,41.87%,1
新北市,新店區,2091,803,200,1003,70,1073,1931,55.57%,41.58%,1
新北市,新店區,2092,533,116,649,34,683,1239,55.13%,43.02%,1
新北市,新店區,2093,798,190,988,60,1048,1892,55.39%,42.18%,1
新北市,新店區,2094,595,147,742,50,792,1529,51.8%,38.91%,1
新北市,新店區,2095,621,118,739,49,788,1358,58.03%,45.73%,1
新北市,新店區,2096,734,194,928,44,972,1905,51.02%,38.53%,1
新北市,新店區,2097,773,177,950,40,990,1885,52.52%,41.01%,1
新北市,新店區,2098,556,121,677,56,733,1345,54.5%,41.34%,1
新北市,新店區,2099,591,135,726,66,792,1387,57.1%,42.61%,1
新北市,新店區,2100,849,165,1014,65,1079,1960,55.05%,43.32%,1
新北市,新店區,2101,779,172,951,76,1027,1837,55.91%,42.41%,1
新北市,新店區,2102,705,193,898,48,946,1662,56.92%,42.42%,1
新北市,新店區,2103,771,169,940,55,995,1617,61.53%,47.68%,1
新北市,新店區,2104,735,186,921,35,956,1704,56.1%,43.13%,1
新北市,新店區,2105,735,181,916,71,987,1835,53.79%,40.05%,1
新北市,新店區,2106,805,201,1006,78,1084,2009,53.96%,40.07%,1
新北市,新店區,2107,594,166,760,52,812,1450,56%,40.97%,1
新北市,新店區,2108,763,149,912,46,958,1726,55.5%,44.21%,1
新北市,新店區,2109,727,184,911,60,971,1797,54.03%,40.46%,1
新北市,新店區,2110,743,172,915,40,955,1739,54.92%,42.73%,1
新北市,新店區,2111,682,127,809,36,845,1523,55.48%,44.78%,1
新北市,新店區,2112,724,125,849,26,875,1642,53.29%,44.09%,1
新北市,新店區,2113,725,165,890,19,909,1644,55.29%,44.1%,1
新北市,新店區,2114,638,158,796,39,835,1662,50.24%,38.39%,1
新北市,新店區,2115,908,211,1119,60,1179,2067,57.04%,43.93%,1
新北市,新店區,2116,628,169,797,37,834,1870,44.6%,33.58%,1
新北市,新店區,2117,843,158,1001,59,1060,1982,53.48%,42.53%,1
新北市,新店區,2118,700,135,835,38,873,1546,56.47%,45.28%,1
新北市,新店區,2119,801,197,998,33,1031,1712,60.22%,46.79%,1
新北市,新店區,2120,701,157,858,26,884,1423,62.12%,49.26%,1
新北市,新店區,2121,757,181,938,71,1009,1666,60.56%,45.44%,1
新北市,新店區,2122,843,193,1036,60,1096,1769,61.96%,47.65%,1
新北市,新店區,2123,377,125,502,39,541,1079,50.14%,34.94%,1
新北市,新店區,2124,445,107,552,33,585,1140,51.32%,39.04%,1
新北市,新店區,2125,757,183,940,59,999,1825,54.74%,41.48%,1
新北市,新店區,2126,537,141,678,34,712,1178,60.44%,45.59%,1
新北市,新店區,2127,623,132,755,38,793,1463,54.2%,42.58%,1
新北市,新店區,2128,514,110,624,33,657,1152,57.03%,44.62%,1
新北市,新店區,2129,749,141,890,29,919,2008,45.77%,37.3%,1
新北市,新店區,2130,800,133,933,40,973,2120,45.9%,37.74%,1
新北市,新店區,2131,556,101,657,18,675,1153,58.54%,48.22%,1
新北市,新店區,2132,642,150,792,43,835,1573,53.08%,40.81%,1
新北市,新店區,2133,691,196,887,75,962,1992,48.29%,34.69%,1
新北市,新店區,2134,605,165,770,47,817,1668,48.98%,36.27%,1
新北市,新店區,2135,584,157,741,54,795,1617,49.17%,36.12%,1
新北市,新店區,2136,808,190,998,81,1079,2013,53.6%,40.14%,1
新北市,新店區,2137,849,80,929,57,986,1791,55.05%,47.4%,1
新北市,新店區,2138,701,167,868,50,918,1624,56.53%,43.17%,1
新北市,新店區,2139,576,104,680,33,713,1178,60.53%,48.9%,1
新北市,新店區,2140,617,103,720,27,747,1277,58.5%,48.32%,1
新北市,新店區,2141,838,168,1006,57,1063,1879,56.57%,44.6%,1
新北市,新店區,2142,303,104,407,30,437,939,46.54%,32.27%,1
新北市,新店區,2143,397,112,509,38,547,960,56.98%,41.35%,1
新北市,新店區,2144,673,168,841,32,873,1434,60.88%,46.93%,1
新北市,新店區,2145,702,196,898,59,957,1838,52.07%,38.19%,1
新北市,新店區,2146,626,135,761,54,815,1453,56.09%,43.08%,1
新北市,新店區,2147,631,150,781,49,830,1549,53.58%,40.74%,1
新北市,新店區,2148,844,181,1025,51,1076,1860,57.85%,45.38%,1
新北市,新店區,2149,672,167,839,38,877,1743,50.32%,38.55%,1
新北市,新店區,2150,572,132,704,31,735,1122,65.51%,50.98%,1
新北市,新店區,2151,649,130,779,32,811,1468,55.25%,44.21%,1
新北市,新店區,2152,803,113,916,43,959,1763,54.4%,45.55%,1
新北市,新店區,2153,536,141,677,35,712,1344,52.98%,39.88%,1
新北市,新店區,2154,298,60,358,48,406,753,53.92%,39.58%,1
新北市,新店區,2155,215,70,285,9,294,602,48.84%,35.71%,1
新北市,新店區,2156,829,265,1094,72,1166,2237,52.12%,37.06%,1
新北市,新店區,2157,420,134,554,32,586,1096,53.47%,38.32%,1
新北市,新店區,2158,384,108,492,46,538,1143,47.07%,33.6%,1
新北市,新店區,2159,566,182,748,77,825,1569,52.58%,36.07%,1
新北市,新店區,2160,475,150,625,65,690,1284,53.74%,36.99%,1
新北市,新店區,2161,93,31,124,10,134,439,30.52%,21.18%,1
新北市,新店區,2162,274,121,395,38,433,750,57.73%,36.53%,1
新北市,樹林區,1614,506,175,681,60,741,1408,52.63%,35.94%,1
新北市,樹林區,1615,481,166,647,32,679,1310,51.83%,36.72%,1
新北市,樹林區,1616,534,155,689,65,754,1534,49.15%,34.81%,1
新北市,樹林區,1617,474,138,612,59,671,1211,55.41%,39.14%,1
新北市,樹林區,1618,471,143,614,41,655,1125,58.22%,41.87%,1
新北市,樹林區,1619,478,153,631,48,679,1134,59.88%,42.15%,1
新北市,樹林區,1620,625,188,813,86,899,1897,47.39%,32.95%,1
新北市,樹林區,1621,656,189,845,65,910,1716,53.03%,38.23%,1
新北市,樹林區,1622,321,95,416,42,458,736,62.23%,43.61%,1
新北市,樹林區,1623,509,145,654,35,689,1137,60.6%,44.77%,1
新北市,樹林區,1624,567,179,746,52,798,1542,51.75%,36.77%,1
新北市,樹林區,1625,564,179,743,62,805,1470,54.76%,38.37%,1
新北市,樹林區,1626,507,147,654,26,680,1456,46.7%,34.82%,1
新北市,樹林區,1627,458,128,586,28,614,1124,54.63%,40.75%,1
新北市,樹林區,1628,481,146,627,30,657,1235,53.2%,38.95%,1
新北市,樹林區,1629,470,171,641,30,671,1212,55.36%,38.78%,1
新北市,樹林區,1630,465,115,580,45,625,1223,51.1%,38.02%,1
新北市,樹林區,1631,468,188,656,80,736,1335,55.13%,35.06%,1
新北市,樹林區,1632,474,153,627,35,662,1206,54.89%,39.3%,1
新北市,樹林區,1633,472,159,631,77,708,1927,36.74%,24.49%,1
新北市,樹林區,1634,360,122,482,38,520,914,56.89%,39.39%,1
新北市,樹林區,1635,601,181,782,55,837,1456,57.49%,41.28%,1
新北市,樹林區,1636,545,145,690,48,738,1409,52.38%,38.68%,1
新北市,樹林區,1637,621,213,834,64,898,1500,59.87%,41.4%,1
新北市,樹林區,1638,694,114,808,59,867,1545,56.12%,44.92%,1
新北市,樹林區,1639,558,184,742,28,770,1483,51.92%,37.63%,1
新北市,樹林區,1640,595,163,758,37,795,1524,52.17%,39.04%,1
新北市,樹林區,1641,592,166,758,37,795,1431,55.56%,41.37%,1
新北市,樹林區,1642,455,137,592,64,656,1181,55.55%,38.53%,1
新北市,樹林區,1643,449,141,590,61,651,1116,58.33%,40.23%,1
新北市,樹林區,1644,398,131,529,36,565,1077,52.46%,36.95%,1
新北市,樹林區,1645,402,111,513,20,533,1103,48.32%,36.45%,1
新北市,樹林區,1646,576,139,715,60,775,1385,55.96%,41.59%,1
新北市,樹林區,1647,470,141,611,52,663,1266,52.37%,37.12%,1
新北市,樹林區,1648,460,138,598,50,648,1195,54.23%,38.49%,1
新北市,樹林區,1649,487,138,625,52,677,1254,53.99%,38.84%,1
新北市,樹林區,1650,527,149,676,47,723,1263,57.24%,41.73%,1
新北市,樹林區,1651,659,178,837,75,912,1473,61.91%,44.74%,1
新北市,樹林區,1652,369,100,469,27,496,870,57.01%,42.41%,1
新北市,樹林區,1653,553,198,751,66,817,1338,61.06%,41.33%,1
新北市,樹林區,1654,393,107,500,30,530,1010,52.48%,38.91%,1
新北市,樹林區,1655,708,192,900,74,974,1658,58.75%,42.7%,1
新北市,樹林區,1656,673,238,911,56,967,1538,62.87%,43.76%,1
新北市,樹林區,1657,649,146,795,87,882,1405,62.78%,46.19%,1
新北市,樹林區,1658,607,225,832,56,888,1587,55.95%,38.25%,1
新北市,樹林區,1659,615,204,819,53,872,1566,55.68%,39.27%,1
新北市,樹林區,1660,406,91,497,12,509,997,51.05%,40.72%,1
新北市,樹林區,1661,478,144,622,51,673,1187,56.7%,40.27%,1
新北市,樹林區,1662,411,117,528,51,579,1061,54.57%,38.74%,1
新北市,樹林區,1663,731,176,907,46,953,1701,56.03%,42.97%,1
新北市,樹林區,1664,539,120,659,64,723,1278,56.57%,42.18%,1
新北市,樹林區,1665,620,176,796,66,862,1433,60.15%,43.27%,1
新北市,樹林區,1666,559,165,724,53,777,1306,59.49%,42.8%,1
新北市,樹林區,1667,547,166,713,62,775,1268,61.12%,43.14%,1
新北市,樹林區,1668,536,164,700,35,735,1281,57.38%,41.84%,1
新北市,樹林區,1669,523,142,665,50,715,1200,59.58%,43.58%,1
新北市,樹林區,1670,562,177,739,29,768,1491,51.51%,37.69%,1
新北市,樹林區,1671,416,112,528,26,554,1066,51.97%,39.02%,1
新北市,樹林區,1672,397,101,498,6,504,877,57.47%,45.27%,1
新北市,樹林區,1673,639,171,810,65,875,1616,54.15%,39.54%,1
新北市,樹林區,1674,533,149,682,60,742,1589,46.7%,33.54%,1
新北市,樹林區,1675,529,208,737,57,794,1367,58.08%,38.7%,1
新北市,樹林區,1676,501,145,646,42,688,1144,60.14%,43.79%,1
新北市,樹林區,1677,426,103,529,31,560,1059,52.88%,40.23%,1
新北市,樹林區,1678,468,155,623,53,676,1224,55.23%,38.24%,1
新北市,樹林區,1679,412,127,539,40,579,1141,50.74%,36.11%,1
新北市,樹林區,1680,456,112,568,25,593,1396,42.48%,32.66%,1
新北市,樹林區,1681,447,148,595,39,634,1157,54.8%,38.63%,1
新北市,樹林區,1682,517,183,700,74,774,1498,51.67%,34.51%,1
新北市,樹林區,1683,584,173,757,73,830,1514,54.82%,38.57%,1
新北市,樹林區,1684,576,149,725,57,782,1546,50.58%,37.26%,1
新北市,樹林區,1685,561,173,734,51,785,1392,56.39%,40.3%,1
新北市,樹林區,1686,696,133,829,44,873,1566,55.75%,44.44%,1
新北市,樹林區,1687,650,163,813,28,841,1566,53.7%,41.51%,1
新北市,樹林區,1688,608,165,773,50,823,1517,54.25%,40.08%,1
新北市,樹林區,1689,612,161,773,38,811,1481,54.76%,41.32%,1
新北市,樹林區,1690,491,153,644,38,682,1261,54.08%,38.94%,1
新北市,樹林區,1691,465,115,580,26,606,1163,52.11%,39.98%,1
新北市,樹林區,1692,713,213,926,78,1004,1661,60.45%,42.93%,1
新北市,樹林區,1693,629,214,843,53,896,1585,56.53%,39.68%,1
新北市,樹林區,1694,457,123,580,36,616,1018,60.51%,44.89%,1
新北市,樹林區,1695,505,129,634,65,699,1247,56.05%,40.5%,1
新北市,樹林區,1696,569,114,683,70,753,1390,54.17%,40.94%,1
新北市,樹林區,1697,545,157,702,39,741,1293,57.31%,42.15%,1
新北市,樹林區,1698,468,164,632,41,673,1301,51.73%,35.97%,1
新北市,樹林區,1699,586,203,789,64,853,1606,53.11%,36.49%,1
新北市,樹林區,1700,481,193,674,68,742,1277,58.1%,37.67%,1
新北市,樹林區,1701,483,151,634,69,703,1219,57.67%,39.62%,1
新北市,樹林區,1702,562,136,698,36,734,1454,50.48%,38.65%,1
新北市,樹林區,1703,528,134,662,38,700,1314,53.27%,40.18%,1
新北市,樹林區,1704,485,123,608,32,640,1008,63.49%,48.12%,1
新北市,樹林區,1705,635,139,774,72,846,1574,53.75%,40.34%,1
新北市,樹林區,1706,576,158,734,33,767,1364,56.23%,42.23%,1
新北市,樹林區,1707,573,203,776,74,850,1677,50.69%,34.17%,1
新北市,樹林區,1708,536,151,687,34,721,1683,42.84%,31.85%,1
新北市,樹林區,1709,623,163,786,49,835,1452,57.51%,42.91%,1
新北市,樹林區,1710,724,160,884,36,920,1592,57.79%,45.48%,1
新北市,樹林區,1711,731,152,883,48,931,1619,57.5%,45.15%,1
新北市,樹林區,1712,878,94,972,42,1014,1642,61.75%,53.47%,1
新北市,樹林區,1713,587,144,731,26,757,1357,55.78%,43.26%,1
新北市,樹林區,1714,644,225,869,107,976,1638,59.58%,39.32%,1
新北市,樹林區,1715,617,181,798,55,853,1592,53.58%,38.76%,1
新北市,樹林區,1716,683,146,829,55,884,1521,58.12%,44.9%,1
新北市,樹林區,1717,765,206,971,57,1028,1707,60.22%,44.82%,1
新北市,樹林區,1718,762,194,956,64,1020,1741,58.59%,43.77%,1
新北市,樹林區,1719,715,161,876,32,908,1655,54.86%,43.2%,1
新北市,樹林區,1720,678,178,856,60,916,1775,51.61%,38.2%,1
新北市,樹林區,1721,757,164,921,69,990,1781,55.59%,42.5%,1
新北市,樹林區,1722,522,138,660,51,711,1565,45.43%,33.35%,1
新北市,樹林區,1723,347,117,464,40,504,936,53.85%,37.07%,1
新北市,樹林區,1724,410,128,538,17,555,1030,53.88%,39.81%,1
新北市,鶯歌區,1725,198,80,278,16,294,515,57.09%,38.45%,1
新北市,鶯歌區,1726,405,130,535,44,579,965,60%,41.97%,1
新北市,鶯歌區,1727,766,201,967,94,1061,1931,54.95%,39.67%,1
新北市,鶯歌區,1728,646,182,828,57,885,1797,49.25%,35.95%,1
新北市,鶯歌區,1729,435,125,560,32,592,1057,56.01%,41.15%,1
新北市,鶯歌區,1730,361,105,466,13,479,962,49.79%,37.53%,1
新北市,鶯歌區,1731,421,125,546,34,580,934,62.1%,45.07%,1
新北市,鶯歌區,1732,656,325,981,75,1056,1742,60.62%,37.66%,1
新北市,鶯歌區,1733,621,181,802,58,860,1634,52.63%,38%,1
新北市,鶯歌區,1734,624,163,787,36,823,1676,49.11%,37.23%,1
新北市,鶯歌區,1735,792,249,1041,87,1128,2052,54.97%,38.6%,1
新北市,鶯歌區,1736,667,198,865,35,900,1977,45.52%,33.74%,1
新北市,鶯歌區,1737,758,225,983,35,1018,1957,52.02%,38.73%,1
新北市,鶯歌區,1738,260,98,358,23,381,850,44.82%,30.59%,1
新北市,鶯歌區,1739,680,180,860,53,913,1782,51.23%,38.16%,1
新北市,鶯歌區,1740,615,128,743,48,791,1496,52.87%,41.11%,1
新北市,鶯歌區,1741,708,239,947,41,988,2071,47.71%,34.19%,1
新北市,鶯歌區,1742,569,170,739,51,790,1753,45.07%,32.46%,1
新北市,鶯歌區,1743,672,157,829,42,871,1737,50.14%,38.69%,1
新北市,鶯歌區,1744,633,140,773,64,837,1669,50.15%,37.93%,1
新北市,鶯歌區,1745,610,167,777,45,822,1842,44.63%,33.12%,1
新北市,鶯歌區,1746,525,165,690,48,738,1454,50.76%,36.11%,1
新北市,鶯歌區,1747,358,104,462,38,500,942,53.08%,38%,1
新北市,鶯歌區,1748,477,167,644,60,704,1317,53.45%,36.22%,1
新北市,鶯歌區,1749,320,87,407,19,426,949,44.89%,33.72%,1
新北市,鶯歌區,1750,602,177,779,65,844,1440,58.61%,41.81%,1
新北市,鶯歌區,1751,691,221,912,79,991,1809,54.78%,38.2%,1
新北市,鶯歌區,1752,717,206,923,63,986,1758,56.09%,40.78%,1
新北市,鶯歌區,1753,637,167,804,58,862,1589,54.25%,40.09%,1
新北市,鶯歌區,1754,458,136,594,36,630,1067,59.04%,42.92%,1
新北市,鶯歌區,1755,467,141,608,34,642,1092,58.79%,42.77%,1
新北市,鶯歌區,1756,746,166,912,40,952,1730,55.03%,43.12%,1
新北市,鶯歌區,1757,546,116,662,51,713,1281,55.66%,42.62%,1
新北市,鶯歌區,1758,567,155,722,43,765,1238,61.79%,45.8%,1
新北市,鶯歌區,1759,630,162,792,77,869,1568,55.42%,40.18%,1
新北市,鶯歌區,1760,508,126,634,50,684,1271,53.82%,39.97%,1
新北市,鶯歌區,1761,367,98,465,25,490,1183,41.42%,31.02%,1
新北市,鶯歌區,1762,386,74,460,22,482,1026,46.98%,37.62%,1
新北市,鶯歌區,1763,635,168,803,38,841,1721,48.87%,36.9%,1
新北市,鶯歌區,1764,478,149,627,62,689,1317,52.32%,36.29%,1
新北市,鶯歌區,1765,442,136,578,48,626,1046,59.85%,42.26%,1
新北市,鶯歌區,1766,487,156,643,44,687,1144,60.05%,42.57%,1
新北市,鶯歌區,1767,385,237,622,60,682,1336,51.05%,28.82%,1
新北市,鶯歌區,1768,528,127,655,22,677,1479,45.77%,35.7%,1
新北市,鶯歌區,1769,618,217,835,57,892,1736,51.38%,35.6%,1
新北市,鶯歌區,1770,586,163,749,61,810,1389,58.32%,42.19%,1
新北市,鶯歌區,1771,758,198,956,78,1034,1956,52.86%,38.75%,1
新北市,鶯歌區,1772,513,181,694,45,739,1371,53.9%,37.42%,1
新北市,鶯歌區,1773,561,137,698,35,733,1810,40.5%,30.99%,1
新北市,鶯歌區,1774,77,19,96,3,99,227,43.61%,33.92%,1
新北市,三峽區,1917,130,36,166,22,188,274,68.61%,47.45%,1
新北市,三峽區,1918,227,54,281,41,322,583,55.23%,38.94%,1
新北市,三峽區,1919,542,191,733,30,763,1765,43.23%,30.71%,1
新北市,三峽區,1920,638,210,848,56,904,1714,52.74%,37.22%,1
新北市,三峽區,1921,523,130,653,27,680,1355,50.18%,38.6%,1
新北市,三峽區,1922,579,125,704,41,745,1329,56.06%,43.57%,1
新北市,三峽區,1923,398,117,515,39,554,1059,52.31%,37.58%,1
新北市,三峽區,1924,547,173,720,60,780,1364,57.18%,40.1%,1
新北市,三峽區,1925,441,149,590,56,646,1098,58.83%,40.16%,1
新北市,三峽區,1926,507,145,652,58,710,1296,54.78%,39.12%,1
新北市,三峽區,1927,459,152,611,52,663,1240,53.47%,37.02%,1
新北市,三峽區,1928,598,164,762,47,809,1531,52.84%,39.06%,1
新北市,三峽區,1929,540,121,661,35,696,1444,48.2%,37.4%,1
新北市,三峽區,1930,511,143,654,72,726,1347,53.9%,37.94%,1
新北市,三峽區,1931,598,129,727,52,779,1455,53.54%,41.1%,1
新北市,三峽區,1932,534,137,671,39,710,1556,45.63%,34.32%,1
新北市,三峽區,1933,441,113,554,38,592,1390,42.59%,31.73%,1
新北市,三峽區,1934,619,150,769,50,819,1532,53.46%,40.4%,1
新北市,三峽區,1935,489,120,609,61,670,1377,48.66%,35.51%,1
新北市,三峽區,1936,659,180,839,54,893,1731,51.59%,38.07%,1
新北市,三峽區,1937,621,195,816,33,849,1705,49.79%,36.42%,1
新北市,三峽區,1938,677,155,832,35,867,1590,54.53%,42.58%,1
新北市,三峽區,1939,707,186,893,29,922,1650,55.88%,42.85%,1
新北市,三峽區,1940,602,149,751,35,786,1441,54.55%,41.78%,1
新北市,三峽區,1941,657,131,788,25,813,1404,57.91%,46.79%,1
新北市,三峽區,1942,602,134,736,34,770,1295,59.46%,46.49%,1
新北市,三峽區,1943,478,139,617,31,648,1348,48.07%,35.46%,1
新北市,三峽區,1944,664,167,831,21,852,1579,53.96%,42.05%,1
新北市,三峽區,1945,589,143,732,29,761,1435,53.03%,41.05%,1
新北市,三峽區,1946,764,162,926,33,959,1659,57.81%,46.05%,1
新北市,三峽區,1947,712,159,871,45,916,1512,60.58%,47.09%,1
新北市,三峽區,1948,632,160,792,52,844,1463,57.69%,43.2%,1
新北市,三峽區,1949,663,149,812,23,835,1465,57%,45.26%,1
新北市,三峽區,1950,124,686,810,28,838,1463,57.28%,8.48%,1
新北市,三峽區,1951,639,139,778,43,821,1443,56.9%,44.28%,1
新北市,三峽區,1952,609,161,770,53,823,1634,50.37%,37.27%,1
新北市,三峽區,1953,661,198,859,54,913,1716,53.21%,38.52%,1
新北市,三峽區,1954,636,162,798,67,865,1675,51.64%,37.97%,1
新北市,三峽區,1955,534,129,663,57,720,1649,43.66%,32.38%,1
新北市,三峽區,1956,567,149,716,70,786,1489,52.79%,38.08%,1
新北市,三峽區,1957,648,166,814,49,863,1771,48.73%,36.59%,1
新北市,三峽區,1958,716,160,876,60,936,1726,54.23%,41.48%,1
新北市,三峽區,1959,526,141,667,60,727,1363,53.34%,38.59%,1
新北市,三峽區,1960,650,149,799,40,839,1624,51.66%,40.02%,1
新北市,三峽區,1961,537,162,699,49,748,1352,55.33%,39.72%,1
新北市,三峽區,1962,454,127,581,26,607,1608,37.75%,28.23%,1
新北市,三峽區,1963,561,161,722,55,777,1458,53.29%,38.48%,1
新北市,三峽區,1964,587,150,737,42,779,1641,47.47%,35.77%,1
新北市,三峽區,1965,525,176,701,103,804,1530,52.55%,34.31%,1
新北市,三峽區,1966,449,124,573,57,630,1389,45.36%,32.33%,1
新北市,三峽區,1967,473,126,599,67,666,1315,50.65%,35.97%,1
新北市,三峽區,1968,442,87,529,39,568,934,60.81%,47.32%,1
新北市,三峽區,1969,437,120,557,35,592,1270,46.61%,34.41%,1
新北市,三峽區,1970,311,106,417,40,457,929,49.19%,33.48%,1
新北市,三峽區,1971,376,108,484,17,501,1035,48.41%,36.33%,1
新北市,三峽區,1972,170,39,209,17,226,502,45.02%,33.86%,1
新北市,三峽區,1973,274,79,353,54,407,836,48.68%,32.78%,1
新北市,三峽區,1974,208,64,272,54,326,669,48.73%,31.09%,1
新北市,三峽區,1975,292,74,366,64,430,733,58.66%,39.84%,1
新北市,三峽區,1976,702,177,879,58,937,1560,60.06%,45%,1
新北市,三峽區,1977,615,175,790,50,840,1638,51.28%,37.55%,1
新北市,三峽區,1978,490,123,613,48,661,1394,47.42%,35.15%,1
新北市,三峽區,1979,313,84,397,48,445,771,57.72%,40.6%,1
新北市,三峽區,1980,461,164,625,35,660,1367,48.28%,33.72%,1
新北市,三峽區,1981,453,123,576,69,645,1241,51.97%,36.5%,1
新北市,三峽區,1982,553,136,689,24,713,1520,46.91%,36.38%,1
新北市,三峽區,1983,388,115,503,53,556,873,63.69%,44.44%,1
新北市,三峽區,1984,240,86,326,48,374,768,48.7%,31.25%,1
新北市,三峽區,1985,378,97,475,35,510,1097,46.49%,34.46%,1
新北市,三峽區,1986,392,108,500,67,567,1322,42.89%,29.65%,1
新北市,淡水區,0029,191,69,260,27,287,544,52.76%,35.11%,1
新北市,淡水區,0030,416,110,526,53,579,1044,55.46%,39.85%,1
新北市,淡水區,0031,553,132,685,38,723,1462,49.45%,37.82%,1
新北市,淡水區,0032,554,180,734,62,796,1525,52.2%,36.33%,1
新北市,淡水區,0033,338,88,426,41,467,986,47.36%,34.28%,1
新北市,淡水區,0034,306,105,411,32,443,806,54.96%,37.97%,1
新北市,淡水區,0035,454,134,588,69,657,1173,56.01%,38.7%,1
新北市,淡水區,0036,464,120,584,41,625,1343,46.54%,34.55%,1
新北市,淡水區,0037,350,103,453,34,487,1153,42.24%,30.36%,1
新北市,淡水區,0038,260,119,379,38,417,874,47.71%,29.75%,1
新北市,淡水區,0039,377,130,507,79,586,1063,55.13%,35.47%,1
新北市,淡水區,0040,449,129,578,39,617,1309,47.14%,34.3%,1
新北市,淡水區,0041,490,156,646,47,693,1290,53.72%,37.98%,1
新北市,淡水區,0042,720,189,909,39,948,1675,56.6%,42.99%,1
新北市,淡水區,0043,641,190,831,48,879,1589,55.32%,40.34%,1
新北市,淡水區,0044,720,185,905,43,948,1624,58.37%,44.33%,1
新北市,淡水區,0045,481,137,618,41,659,1241,53.1%,38.76%,1
新北市,淡水區,0046,503,160,663,47,710,1317,53.91%,38.19%,1
新北市,淡水區,0047,510,46,556,36,592,1225,48.33%,41.63%,1
新北市,淡水區,0048,585,147,732,39,771,1426,54.07%,41.02%,1
新北市,淡水區,0049,682,201,883,53,936,1610,58.14%,42.36%,1
新北市,淡水區,0050,808,219,1027,40,1067,1982,53.83%,40.77%,1
新北市,淡水區,0051,661,184,845,49,894,1924,46.47%,34.36%,1
新北市,淡水區,0052,663,201,864,51,915,1822,50.22%,36.39%,1
新北市,淡水區,0053,507,150,657,77,734,1232,59.58%,41.15%,1
新北市,淡水區,0054,655,184,839,63,902,1588,56.8%,41.25%,1
新北市,淡水區,0055,694,160,854,50,904,1784,50.67%,38.9%,1
新北市,淡水區,0056,619,228,847,80,927,1762,52.61%,35.13%,1
新北市,淡水區,0057,620,152,772,45,817,1546,52.85%,40.1%,1
新北市,淡水區,0058,731,230,961,53,1014,1897,53.45%,38.53%,1
新北市,淡水區,0059,606,148,754,44,798,1489,53.59%,40.7%,1
新北市,淡水區,0060,636,172,808,51,859,1679,51.16%,37.88%,1
新北市,淡水區,0061,617,185,802,41,843,1693,49.79%,36.44%,1
新北市,淡水區,0062,616,157,773,21,794,1674,47.43%,36.8%,1
新北市,淡水區,0063,543,156,699,27,726,1330,54.59%,40.83%,1
新北市,淡水區,0064,625,120,745,21,766,1467,52.22%,42.6%,1
新北市,淡水區,0065,770,164,934,44,978,1837,53.24%,41.92%,1
新北市,淡水區,0066,506,121,627,25,652,1924,33.89%,26.3%,1
新北市,淡水區,0067,898,222,1120,35,1155,2340,49.36%,38.38%,1
新北市,淡水區,0068,609,137,746,47,793,1704,46.54%,35.74%,1
新北市,淡水區,0069,528,152,680,39,719,1363,52.75%,38.74%,1
新北市,淡水區,0070,1006,346,1352,47,1399,3068,45.6%,32.79%,1
新北市,淡水區,0071,583,126,709,31,740,1528,48.43%,38.15%,1
新北市,淡水區,0072,573,173,746,59,805,1600,50.31%,35.81%,1
新北市,淡水區,0073,782,197,979,66,1045,1874,55.76%,41.73%,1
新北市,淡水區,0074,611,154,765,68,833,1567,53.16%,38.99%,1
新北市,淡水區,0075,496,163,659,39,698,1245,56.06%,39.84%,1
新北市,淡水區,0076,469,131,600,30,630,1211,52.02%,38.73%,1
新北市,淡水區,0077,819,206,1025,48,1073,1992,53.87%,41.11%,1
新北市,淡水區,0078,828,194,1022,41,1063,2028,52.42%,40.83%,1
新北市,淡水區,0079,562,146,708,72,780,1373,56.81%,40.93%,1
新北市,淡水區,0080,724,157,881,33,914,1732,52.77%,41.8%,1
新北市,淡水區,0081,541,171,712,48,760,1519,50.03%,35.62%,1
新北市,淡水區,0082,625,167,792,23,815,1727,47.19%,36.19%,1
新北市,淡水區,0083,530,141,671,35,706,1297,54.43%,40.86%,1
新北市,淡水區,0084,415,95,510,61,571,1066,53.56%,38.93%,1
新北市,淡水區,0085,567,146,713,52,765,1387,55.16%,40.88%,1
新北市,淡水區,0086,761,222,983,54,1037,1909,54.32%,39.86%,1
新北市,淡水區,0087,704,181,885,62,947,1770,53.5%,39.77%,1
新北市,淡水區,0088,762,194,956,70,1026,2049,50.07%,37.19%,1
新北市,淡水區,0089,676,194,870,34,904,1680,53.81%,40.24%,1
新北市,淡水區,0090,575,203,778,65,843,1433,58.83%,40.13%,1
新北市,淡水區,0091,544,141,685,42,727,1365,53.26%,39.85%,1
新北市,淡水區,0092,605,159,764,54,818,1452,56.34%,41.67%,1
新北市,淡水區,0093,756,150,906,58,964,1804,53.44%,41.91%,1
新北市,淡水區,0094,514,138,652,47,699,1322,52.87%,38.88%,1
新北市,淡水區,0095,818,179,997,32,1029,2019,50.97%,40.52%,1
新北市,淡水區,0096,752,176,928,47,975,1696,57.49%,44.34%,1
新北市,淡水區,0097,634,209,843,36,879,1576,55.77%,40.23%,1
新北市,淡水區,0098,760,195,955,48,1003,1781,56.32%,42.67%,1
新北市,淡水區,0099,686,231,917,54,971,1665,58.32%,41.2%,1
新北市,淡水區,0100,886,126,1012,60,1072,2013,53.25%,44.01%,1
新北市,淡水區,0101,423,137,560,33,593,1108,53.52%,38.18%,1
新北市,淡水區,0102,507,152,659,53,712,1305,54.56%,38.85%,1
新北市,淡水區,0103,456,150,606,22,628,1199,52.38%,38.03%,1
新北市,淡水區,0104,795,202,997,63,1060,2017,52.55%,39.41%,1
新北市,淡水區,0105,665,299,964,67,1031,2125,48.52%,31.29%,1
新北市,淡水區,0106,430,132,562,24,586,1289,45.46%,33.36%,1
新北市,淡水區,0107,580,158,738,45,783,1319,59.36%,43.97%,1
新北市,淡水區,0108,436,106,542,22,564,1051,53.66%,41.48%,1
新北市,淡水區,0109,542,135,677,39,716,1348,53.12%,40.21%,1
新北市,淡水區,0110,411,118,529,35,564,1106,50.99%,37.16%,1
新北市,淡水區,0111,295,95,390,31,421,717,58.72%,41.14%,1
新北市,淡水區,0112,518,169,687,28,715,1385,51.62%,37.4%,1
新北市,淡水區,0113,351,121,472,32,504,841,59.93%,41.74%,1
新北市,淡水區,0114,277,70,347,31,378,665,56.84%,41.65%,1
新北市,淡水區,0115,181,49,230,20,250,419,59.67%,43.2%,1
新北市,淡水區,0116,667,183,850,32,882,1599,55.16%,41.71%,1
新北市,淡水區,0117,638,182,820,57,877,1670,52.51%,38.2%,1
新北市,淡水區,0118,703,194,897,58,955,1683,56.74%,41.77%,1
新北市,淡水區,0119,580,162,742,54,796,1577,50.48%,36.78%,1
新北市,淡水區,0120,604,158,762,52,814,1618,50.31%,37.33%,1
新北市,淡水區,0121,788,195,983,41,1024,2214,46.25%,35.59%,1
新北市,淡水區,0122,698,191,889,64,953,1832,52.02%,38.1%,1
新北市,淡水區,0123,818,222,1040,66,1106,2123,52.1%,38.53%,1
新北市,淡水區,0124,1077,176,1253,33,1286,2998,42.9%,35.92%,1
新北市,汐止區,2336,615,164,779,77,856,1595,53.67%,38.56%,1
新北市,汐止區,2337,521,141,662,43,705,1262,55.86%,41.28%,1
新北市,汐止區,2338,379,103,482,59,541,917,59%,41.33%,1
新北市,汐止區,2339,780,225,1005,61,1066,1929,55.26%,40.44%,1
新北市,汐止區,2340,887,223,1110,68,1178,2227,52.9%,39.83%,1
新北市,汐止區,2341,429,157,586,60,646,1143,56.52%,37.53%,1
新北市,汐止區,2342,565,153,718,41,759,1367,55.52%,41.33%,1
新北市,汐止區,2343,113,40,153,20,173,322,53.73%,35.09%,1
新北市,汐止區,2344,612,169,781,9,790,1460,54.11%,41.92%,1
新北市,汐止區,2345,609,198,807,68,875,1719,50.9%,35.43%,1
新北市,汐止區,2346,611,160,771,58,829,1661,49.91%,36.79%,1
新北市,汐止區,2347,667,168,835,67,902,1590,56.73%,41.95%,1
新北市,汐止區,2348,664,155,819,52,871,1599,54.47%,41.53%,1
新北市,汐止區,2349,742,178,920,48,968,1749,55.35%,42.42%,1
新北市,汐止區,2350,246,86,332,24,356,1809,19.68%,13.6%,1
新北市,汐止區,2351,440,258,698,33,731,1601,45.66%,27.48%,1
新北市,汐止區,2352,545,128,673,65,738,1387,53.21%,39.29%,1
新北市,汐止區,2353,707,208,915,83,998,1779,56.1%,39.74%,1
新北市,汐止區,2354,876,207,1083,72,1155,2074,55.69%,42.24%,1
新北市,汐止區,2355,843,220,1063,47,1110,2072,53.57%,40.69%,1
新北市,汐止區,2356,902,268,1170,57,1227,2120,57.88%,42.55%,1
新北市,汐止區,2357,791,209,1000,40,1040,1952,53.28%,40.52%,1
新北市,汐止區,2358,632,177,809,67,876,1654,52.96%,38.21%,1
新北市,汐止區,2359,556,140,696,62,758,1444,52.49%,38.5%,1
新北市,汐止區,2360,717,205,922,40,962,1627,59.13%,44.07%,1
新北市,汐止區,2361,654,175,829,75,904,1751,51.63%,37.35%,1
新北市,汐止區,2362,823,213,1036,48,1084,2066,52.47%,39.84%,1
新北市,汐止區,2363,645,173,818,49,867,1941,44.67%,33.23%,1
新北市,汐止區,2364,677,218,895,45,940,1906,49.32%,35.52%,1
新北市,汐止區,2365,517,137,654,64,718,1363,52.68%,37.93%,1
新北市,汐止區,2366,496,149,645,50,695,1368,50.8%,36.26%,1
新北市,汐止區,2367,423,137,560,51,611,1233,49.55%,34.31%,1
新北市,汐止區,2368,597,141,738,23,761,1554,48.97%,38.42%,1
新北市,汐止區,2369,617,190,807,31,838,1700,49.29%,36.29%,1
新北市,汐止區,2370,491,110,601,27,628,1124,55.87%,43.68%,1
新北市,汐止區,2371,806,198,1004,80,1084,1900,57.05%,42.42%,1
新北市,汐止區,2372,852,181,1033,58,1091,2050,53.22%,41.56%,1
新北市,汐止區,2373,469,142,611,53,664,1244,53.38%,37.7%,1
新北市,汐止區,2374,493,130,623,38,661,1320,50.08%,37.35%,1
新北市,汐止區,2375,611,174,785,45,830,1473,56.35%,41.48%,1
新北市,汐止區,2376,732,191,923,69,992,1802,55.05%,40.62%,1
新北市,汐止區,2377,591,114,705,37,742,1266,58.61%,46.68%,1
新北市,汐止區,2378,532,142,674,62,736,1481,49.7%,35.92%,1
新北市,汐止區,2379,554,154,708,61,769,1497,51.37%,37.01%,1
新北市,汐止區,2380,231,52,283,20,303,556,54.5%,41.55%,1
新北市,汐止區,2381,713,188,901,55,956,1913,49.97%,37.27%,1
新北市,汐止區,2382,791,180,971,42,1013,2027,49.98%,39.02%,1
新北市,汐止區,2383,750,160,910,33,943,1927,48.94%,38.92%,1
新北市,汐止區,2384,253,92,345,44,389,696,55.89%,36.35%,1
新北市,汐止區,2385,775,217,992,60,1052,2127,49.46%,36.44%,1
新北市,汐止區,2386,577,145,722,50,772,1642,47.02%,35.14%,1
新北市,汐止區,2387,699,216,915,80,995,1912,52.04%,36.56%,1
新北市,汐止區,2388,634,184,818,58,876,1893,46.28%,33.49%,1
新北市,汐止區,2389,516,137,653,60,713,1466,48.64%,35.2%,1
新北市,汐止區,2390,566,136,702,82,784,1538,50.98%,36.8%,1
新北市,汐止區,2391,602,137,739,43,782,1550,50.45%,38.84%,1
新北市,汐止區,2392,523,159,682,52,734,1456,50.41%,35.92%,1
新北市,汐止區,2393,405,117,522,49,571,947,60.3%,42.77%,1
新北市,汐止區,2394,348,135,483,26,509,923,55.15%,37.7%,1
新北市,汐止區,2395,719,209,928,99,1027,2043,50.27%,35.19%,1
新北市,汐止區,2396,658,209,867,89,956,2012,47.51%,32.7%,1
新北市,汐止區,2397,506,131,637,35,672,1471,45.68%,34.4%,1
新北市,汐止區,2398,623,139,762,52,814,1603,50.78%,38.86%,1
新北市,汐止區,2399,605,162,767,57,824,1530,53.86%,39.54%,1
新北市,汐止區,2400,646,183,829,28,857,1988,43.11%,32.49%,1
新北市,汐止區,2401,819,210,1029,59,1088,2198,49.5%,37.26%,1
新北市,汐止區,2402,638,168,806,64,870,1712,50.82%,37.27%,1
新北市,汐止區,2403,751,188,939,66,1005,1806,55.65%,41.58%,1
新北市,汐止區,2404,613,142,755,77,832,1576,52.79%,38.9%,1
新北市,汐止區,2405,597,150,747,27,774,1511,51.22%,39.51%,1
新北市,汐止區,2406,607,158,765,35,800,1691,47.31%,35.9%,1
新北市,汐止區,2407,660,169,829,44,873,1636,53.36%,40.34%,1
新北市,汐止區,2408,633,157,790,76,866,1676,51.67%,37.77%,1
新北市,汐止區,2409,501,116,617,37,654,1264,51.74%,39.64%,1
新北市,汐止區,2410,467,101,568,30,598,1165,51.33%,40.09%,1
新北市,汐止區,2411,661,176,837,55,892,1765,50.54%,37.45%,1
新北市,汐止區,2412,596,161,757,33,790,1815,43.53%,32.84%,1
新北市,汐止區,2413,633,189,822,62,884,1778,49.72%,35.6%,1
新北市,汐止區,2414,637,158,795,78,873,1580,55.25%,40.32%,1
新北市,汐止區,2415,586,172,758,50,808,1516,53.3%,38.65%,1
新北市,汐止區,2416,514,139,653,47,700,1425,49.12%,36.07%,1
新北市,汐止區,2417,575,146,721,36,757,1388,54.54%,41.43%,1
新北市,汐止區,2418,561,162,723,53,776,1436,54.04%,39.07%,1
新北市,汐止區,2419,645,157,802,36,838,1591,52.67%,40.54%,1
新北市,汐止區,2420,619,148,767,46,813,1639,49.6%,37.77%,1
新北市,汐止區,2421,532,131,663,18,681,1394,48.85%,38.16%,1
新北市,汐止區,2422,728,209,937,49,986,2035,48.45%,35.77%,1
新北市,汐止區,2423,744,165,909,56,965,1895,50.92%,39.26%,1
新北市,汐止區,2424,644,111,755,20,775,1374,56.4%,46.87%,1
新北市,汐止區,2425,490,107,597,29,626,1061,59%,46.18%,1
新北市,汐止區,2426,672,129,801,27,828,1312,63.11%,51.22%,1
新北市,汐止區,2427,640,166,806,43,849,1548,54.84%,41.34%,1
新北市,汐止區,2428,582,159,741,31,772,1350,57.19%,43.11%,1
新北市,汐止區,2429,608,174,782,32,814,1499,54.3%,40.56%,1
新北市,汐止區,2430,586,142,728,59,787,1366,57.61%,42.9%,1
新北市,汐止區,2431,551,154,705,61,766,1335,57.38%,41.27%,1
新北市,汐止區,2432,608,143,751,55,806,1324,60.88%,45.92%,1
新北市,汐止區,2433,562,148,710,70,780,1286,60.65%,43.7%,1
新北市,汐止區,2434,456,135,591,46,637,1155,55.15%,39.48%,1
新北市,汐止區,2435,767,218,985,50,1035,1682,61.53%,45.6%,1
新北市,汐止區,2436,699,169,868,56,924,1494,61.85%,46.79%,1
新北市,汐止區,2437,460,171,631,66,697,1166,59.78%,39.45%,1
新北市,汐止區,2438,858,246,1104,114,1218,2184,55.77%,39.29%,1
新北市,汐止區,2439,794,232,1026,82,1108,2031,54.55%,39.09%,1
新北市,汐止區,2440,716,193,909,69,978,1759,55.6%,40.7%,1
新北市,汐止區,2441,644,194,838,55,893,1577,56.63%,40.84%,1
新北市,汐止區,2442,560,130,690,19,709,1364,51.98%,41.06%,1
新北市,汐止區,2443,581,166,747,36,783,1401,55.89%,41.47%,1
新北市,汐止區,2444,479,156,635,58,693,1173,59.08%,40.84%,1
新北市,汐止區,2445,469,86,555,23,578,993,58.21%,47.23%,1
新北市,汐止區,2446,635,167,802,29,831,1587,52.36%,40.01%,1
新北市,瑞芳區,2220,306,80,386,34,420,725,57.93%,42.21%,1
新北市,瑞芳區,2221,445,102,547,53,600,1074,55.87%,41.43%,1
新北市,瑞芳區,2222,326,72,398,23,421,825,51.03%,39.52%,1
新北市,瑞芳區,2223,490,137,627,37,664,1242,53.46%,39.45%,1
新北市,瑞芳區,2224,241,59,300,26,326,598,54.52%,40.3%,1
新北市,瑞芳區,2225,331,92,423,43,466,872,53.44%,37.96%,1
新北市,瑞芳區,2226,262,68,330,36,366,760,48.16%,34.47%,1
新北市,瑞芳區,2227,458,126,584,34,618,1330,46.47%,34.44%,1
新北市,瑞芳區,2228,554,161,715,60,775,1683,46.05%,32.92%,1
新北市,瑞芳區,2229,378,100,478,40,518,980,52.86%,38.57%,1
新北市,瑞芳區,2230,359,101,460,42,502,946,53.07%,37.95%,1
新北市,瑞芳區,2231,470,109,579,21,600,1375,43.64%,34.18%,1
新北市,瑞芳區,2232,632,154,786,34,820,1671,49.07%,37.82%,1
新北市,瑞芳區,2233,324,71,395,22,417,978,42.64%,33.13%,1
新北市,瑞芳區,2234,206,80,286,29,315,645,48.84%,31.94%,1
新北市,瑞芳區,2235,383,123,506,52,558,1089,51.24%,35.17%,1
新北市,瑞芳區,2236,88,22,110,11,121,286,42.31%,30.77%,1
新北市,瑞芳區,2237,160,44,204,27,231,461,50.11%,34.71%,1
新北市,瑞芳區,2238,95,26,121,16,137,274,50%,34.67%,1
新北市,瑞芳區,2239,64,18,82,11,93,155,60%,41.29%,1
新北市,瑞芳區,2240,325,86,411,38,449,817,54.96%,39.78%,1
新北市,瑞芳區,2241,322,103,425,39,464,884,52.49%,36.43%,1
新北市,瑞芳區,2242,456,110,566,52,618,1333,46.36%,34.21%,1
新北市,瑞芳區,2243,189,38,227,5,232,607,38.22%,31.14%,1
新北市,瑞芳區,2244,408,101,509,33,542,1045,51.87%,39.04%,1
新北市,瑞芳區,2245,269,54,323,40,363,673,53.94%,39.97%,1
新北市,瑞芳區,2246,176,43,219,12,231,618,37.38%,28.48%,1
新北市,瑞芳區,2247,377,87,464,27,491,1063,46.19%,35.47%,1
新北市,瑞芳區,2248,339,87,426,39,465,860,54.07%,39.42%,1
新北市,瑞芳區,2249,101,27,128,3,131,432,30.32%,23.38%,1
新北市,瑞芳區,2250,121,38,159,9,168,445,37.75%,27.19%,1
新北市,瑞芳區,2251,110,16,126,7,133,318,41.82%,34.59%,1
新北市,瑞芳區,2252,59,9,68,9,77,159,48.43%,37.11%,1
新北市,瑞芳區,2253,95,33,128,17,145,337,43.03%,28.19%,1
新北市,瑞芳區,2254,69,23,92,6,98,180,54.44%,38.33%,1
新北市,瑞芳區,2255,57,11,68,13,81,187,43.32%,30.48%,1
新北市,瑞芳區,2256,131,41,172,19,191,369,51.76%,35.5%,1
新北市,瑞芳區,2257,121,50,171,15,186,335,55.52%,36.12%,1
新北市,瑞芳區,2258,151,32,183,16,199,470,42.34%,32.13%,1
新北市,瑞芳區,2259,83,27,110,5,115,297,38.72%,27.95%,1
新北市,瑞芳區,2260,138,22,160,4,164,267,61.42%,51.69%,1
新北市,瑞芳區,2261,165,46,211,9,220,876,25.11%,18.84%,1
新北市,瑞芳區,2262,317,102,419,29,448,1241,36.1%,25.54%,1
新北市,瑞芳區,2263,343,133,476,58,534,998,53.51%,34.37%,1
新北市,瑞芳區,2264,335,110,445,54,499,948,52.64%,35.34%,1
新北市,瑞芳區,2265,382,103,485,27,512,1308,39.14%,29.2%,1
新北市,土城區,1775,569,165,734,69,803,1505,53.36%,37.81%,1
新北市,土城區,1776,580,124,704,37,741,1242,59.66%,46.7%,1
新北市,土城區,1777,537,148,685,28,713,1206,59.12%,44.53%,1
新北市,土城區,1778,548,181,729,76,805,1474,54.61%,37.18%,1
新北市,土城區,1779,525,164,689,62,751,1489,50.44%,35.26%,1
新北市,土城區,1780,614,189,803,56,859,1675,51.28%,36.66%,1
新北市,土城區,1781,597,166,763,57,820,1499,54.7%,39.83%,1
新北市,土城區,1782,610,116,726,43,769,1495,51.44%,40.8%,1
新北市,土城區,1783,512,171,683,77,760,1411,53.86%,36.29%,1
新北市,土城區,1784,505,139,644,57,701,1378,50.87%,36.65%,1
新北市,土城區,1785,488,131,619,48,667,1256,53.11%,38.85%,1
新北市,土城區,1786,554,170,724,65,789,1379,57.22%,40.17%,1
新北市,土城區,1787,548,155,703,59,762,1424,53.51%,38.48%,1
新北市,土城區,1788,563,163,726,59,785,1455,53.95%,38.69%,1
新北市,土城區,1789,525,169,694,42,736,1419,51.87%,37%,1
新北市,土城區,1790,629,145,774,38,812,1357,59.84%,46.35%,1
新北市,土城區,1791,596,159,755,46,801,1501,53.36%,39.71%,1
新北市,土城區,1792,488,140,628,65,693,1206,57.46%,40.46%,1
新北市,土城區,1793,521,162,683,46,729,1255,58.09%,41.51%,1
新北市,土城區,1794,685,204,889,80,969,1869,51.85%,36.65%,1
新北市,土城區,1795,505,152,657,39,696,1292,53.87%,39.09%,1
新北市,土城區,1796,483,125,608,31,639,1324,48.26%,36.48%,1
新北市,土城區,1797,436,129,565,47,612,1155,52.99%,37.75%,1
新北市,土城區,1798,475,122,597,54,651,1183,55.03%,40.15%,1
新北市,土城區,1799,380,96,476,46,522,2518,20.73%,15.09%,1
新北市,土城區,1800,465,120,585,47,632,1218,51.89%,38.18%,1
新北市,土城區,1801,481,96,577,70,647,1133,57.11%,42.45%,1
新北市,土城區,1802,349,108,457,37,494,894,55.26%,39.04%,1
新北市,土城區,1803,379,110,489,58,547,931,58.75%,40.71%,1
新北市,土城區,1804,943,157,1100,52,1152,1820,63.3%,51.81%,1
新北市,土城區,1805,541,118,659,29,688,1320,52.12%,40.98%,1
新北市,土城區,1806,452,155,607,48,655,1241,52.78%,36.42%,1
新北市,土城區,1807,545,147,692,64,756,1414,53.47%,38.54%,1
新北市,土城區,1808,586,145,731,54,785,1378,56.97%,42.53%,1
新北市,土城區,1809,598,165,763,62,825,1421,58.06%,42.08%,1
新北市,土城區,1810,554,124,678,45,723,1340,53.96%,41.34%,1
新北市,土城區,1811,500,138,638,40,678,1144,59.27%,43.71%,1
新北市,土城區,1812,513,154,667,57,724,1268,57.1%,40.46%,1
新北市,土城區,1813,496,131,627,65,692,1196,57.86%,41.47%,1
新北市,土城區,1814,571,159,730,48,778,1308,59.48%,43.65%,1
新北市,土城區,1815,520,117,637,34,671,1175,57.11%,44.26%,1
新北市,土城區,1816,502,141,643,61,704,1230,57.24%,40.81%,1
新北市,土城區,1817,509,175,684,79,763,1342,56.86%,37.93%,1
新北市,土城區,1818,540,152,692,52,744,1268,58.68%,42.59%,1
新北市,土城區,1819,533,173,706,65,771,1227,62.84%,43.44%,1
新北市,土城區,1820,532,168,700,79,779,1356,57.45%,39.23%,1
新北市,土城區,1821,606,167,773,65,838,1496,56.02%,40.51%,1
新北市,土城區,1822,520,145,665,80,745,1309,56.91%,39.72%,1
新北市,土城區,1823,459,169,628,64,692,1175,58.89%,39.06%,1
新北市,土城區,1824,460,159,619,75,694,1237,56.1%,37.19%,1
新北市,土城區,1825,529,132,661,59,720,1256,57.32%,42.12%,1
新北市,土城區,1826,502,128,630,35,665,1228,54.15%,40.88%,1
新北市,土城區,1827,456,138,594,71,665,1182,56.26%,38.58%,1
新北市,土城區,1828,635,150,785,49,834,1558,53.53%,40.76%,1
新北市,土城區,1829,489,117,606,56,662,1160,57.07%,42.16%,1
新北市,土城區,1830,525,165,690,72,762,1357,56.15%,38.69%,1
新北市,土城區,1831,532,173,705,92,797,1464,54.44%,36.34%,1
新北市,土城區,1832,468,148,616,78,694,1335,51.99%,35.06%,1
新北市,土城區,1833,501,145,646,79,725,1346,53.86%,37.22%,1
新北市,土城區,1834,602,209,811,51,862,1435,60.07%,41.95%,1
新北市,土城區,1835,674,172,846,57,903,1639,55.09%,41.12%,1
新北市,土城區,1836,705,219,924,55,979,1728,56.66%,40.8%,1
新北市,土城區,1837,565,155,720,35,755,1665,45.35%,33.93%,1
新北市,土城區,1838,565,159,724,82,806,1333,60.47%,42.39%,1
新北市,土城區,1839,670,185,855,48,903,1567,57.63%,42.76%,1
新北市,土城區,1840,594,190,784,82,866,1576,54.95%,37.69%,1
新北市,土城區,1841,620,149,769,63,832,1458,57.06%,42.52%,1
新北市,土城區,1842,608,186,794,76,870,1517,57.35%,40.08%,1
新北市,土城區,1843,630,169,799,45,844,1489,56.68%,42.31%,1
新北市,土城區,1844,616,177,793,48,841,1463,57.48%,42.11%,1
新北市,土城區,1845,661,161,822,26,848,1584,53.54%,41.73%,1
新北市,土城區,1846,599,157,756,48,804,1464,54.92%,40.92%,1
新北市,土城區,1847,640,198,838,61,899,1598,56.26%,40.05%,1
新北市,土城區,1848,557,167,724,81,805,1500,53.67%,37.13%,1
新北市,土城區,1849,638,155,793,48,841,1542,54.54%,41.37%,1
新北市,土城區,1850,698,197,895,63,958,1619,59.17%,43.11%,1
新北市,土城區,1851,571,144,715,34,749,1521,49.24%,37.54%,1
新北市,土城區,1852,674,190,864,41,905,1691,53.52%,39.86%,1
新北市,土城區,1853,656,172,828,52,880,1657,53.11%,39.59%,1
新北市,土城區,1854,746,233,979,44,1023,1772,57.73%,42.1%,1
新北市,土城區,1855,597,160,757,21,778,1423,54.67%,41.95%,1
新北市,土城區,1856,565,203,768,43,811,1321,61.39%,42.77%,1
新北市,土城區,1857,524,283,807,56,863,1429,60.39%,36.67%,1
新北市,土城區,1858,555,167,722,52,774,1445,53.56%,38.41%,1
新北市,土城區,1859,659,166,825,55,880,1520,57.89%,43.36%,1
新北市,土城區,1860,511,130,641,33,674,1484,45.42%,34.43%,1
新北市,土城區,1861,545,150,695,32,727,1362,53.38%,40.01%,1
新北市,土城區,1862,513,124,637,37,674,1262,53.41%,40.65%,1
新北市,土城區,1863,557,169,726,45,771,1343,57.41%,41.47%,1
新北市,土城區,1864,439,164,603,52,655,1337,48.99%,32.83%,1
新北市,土城區,1865,423,117,540,50,590,1325,44.53%,31.92%,1
新北市,土城區,1866,511,156,667,42,709,1390,51.01%,36.76%,1
新北市,土城區,1867,612,150,762,68,830,1534,54.11%,39.9%,1
新北市,土城區,1868,550,165,715,73,788,1484,53.1%,37.06%,1
新北市,土城區,1869,569,153,722,76,798,1532,52.09%,37.14%,1
新北市,土城區,1870,610,160,770,75,845,1507,56.07%,40.48%,1
新北市,土城區,1871,648,161,809,57,866,1550,55.87%,41.81%,1
新北市,土城區,1872,639,166,805,54,859,1567,54.82%,40.78%,1
新北市,土城區,1873,584,169,753,30,783,1367,57.28%,42.72%,1
新北市,土城區,1874,513,122,635,58,693,1293,53.6%,39.68%,1
新北市,土城區,1875,543,173,716,69,785,1402,55.99%,38.73%,1
新北市,土城區,1876,546,158,704,52,756,1379,54.82%,39.59%,1
新北市,土城區,1877,552,158,710,47,757,1471,51.46%,37.53%,1
新北市,土城區,1878,550,147,697,50,747,1410,52.98%,39.01%,1
新北市,土城區,1879,585,187,772,56,828,1542,53.7%,37.94%,1
新北市,土城區,1880,480,150,630,53,683,1238,55.17%,38.77%,1
新北市,土城區,1881,502,133,635,42,677,1301,52.04%,38.59%,1
新北市,土城區,1882,641,161,802,40,842,1311,64.23%,48.89%,1
新北市,土城區,1883,557,147,704,32,736,1511,48.71%,36.86%,1
新北市,土城區,1884,577,172,749,67,816,1531,53.3%,37.69%,1
新北市,土城區,1885,622,164,786,67,853,1638,52.08%,37.97%,1
新北市,土城區,1886,79,170,249,40,289,1335,21.65%,5.92%,1
新北市,土城區,1887,606,154,760,43,803,1459,55.04%,41.54%,1
新北市,土城區,1888,609,169,778,31,809,1489,54.33%,40.9%,1
新北市,土城區,1889,730,182,912,12,924,1774,52.09%,41.15%,1
新北市,土城區,1890,758,165,923,54,977,1792,54.52%,42.3%,1
新北市,土城區,1891,764,181,945,70,1015,1798,56.45%,42.49%,1
新北市,土城區,1892,504,148,652,53,705,1312,53.73%,38.41%,1
新北市,土城區,1893,493,124,617,59,676,1301,51.96%,37.89%,1
新北市,土城區,1894,474,135,609,57,666,1254,53.11%,37.8%,1
新北市,土城區,1895,462,122,584,37,621,1215,51.11%,38.02%,1
新北市,土城區,1896,595,140,735,59,794,1448,54.83%,41.09%,1
新北市,土城區,1897,497,147,644,67,711,1321,53.82%,37.62%,1
新北市,土城區,1898,393,137,530,73,603,1150,52.43%,34.17%,1
新北市,土城區,1899,477,168,645,54,699,1425,49.05%,33.47%,1
新北市,土城區,1900,556,191,747,64,811,1366,59.37%,40.7%,1
新北市,土城區,1901,550,131,681,50,731,1292,56.58%,42.57%,1
新北市,土城區,1902,529,119,648,71,719,1317,54.59%,40.17%,1
新北市,土城區,1903,544,147,691,62,753,1324,56.87%,41.09%,1
新北市,土城區,1904,468,120,588,3,591,1189,49.71%,39.36%,1
新北市,土城區,1905,496,141,637,74,711,1223,58.14%,40.56%,1
新北市,土城區,1906,621,142,763,51,814,1550,52.52%,40.06%,1
新北市,土城區,1907,656,179,835,75,910,1606,56.66%,40.85%,1
新北市,土城區,1908,597,177,774,53,827,1509,54.8%,39.56%,1
新北市,土城區,1909,609,154,763,64,827,1529,54.09%,39.83%,1
新北市,土城區,1910,540,140,680,85,765,1458,52.47%,37.04%,1
新北市,土城區,1911,577,187,764,77,841,1468,57.29%,39.31%,1
新北市,土城區,1912,585,168,753,50,803,1495,53.71%,39.13%,1
新北市,土城區,1913,505,170,675,65,740,1303,56.79%,38.76%,1
新北市,土城區,1914,569,142,711,57,768,1365,56.26%,41.68%,1
新北市,土城區,1915,580,157,737,83,820,1476,55.56%,39.3%,1
新北市,土城區,1916,669,130,799,42,841,1519,55.37%,44.04%,1
新北市,蘆洲區,0555,620,201,821,96,917,1600,57.31%,38.75%,1
新北市,蘆洲區,0556,593,199,792,67,859,1549,55.46%,38.28%,1
新北市,蘆洲區,0557,617,173,790,98,888,1516,58.58%,40.7%,1
新北市,蘆洲區,0558,533,159,692,82,774,1404,55.13%,37.96%,1
新北市,蘆洲區,0559,507,156,663,88,751,1381,54.38%,36.71%,1
新北市,蘆洲區,0560,647,142,789,49,838,1485,56.43%,43.57%,1
新北市,蘆洲區,0561,513,133,646,44,690,1779,38.79%,28.84%,1
新北市,蘆洲區,0562,570,334,904,58,962,1797,53.53%,31.72%,1
新北市,蘆洲區,0563,559,164,723,69,792,1364,58.06%,40.98%,1
新北市,蘆洲區,0564,649,189,838,73,911,1635,55.72%,39.69%,1
新北市,蘆洲區,0565,539,157,696,47,743,1567,47.42%,34.4%,1
新北市,蘆洲區,0566,590,169,759,54,813,1524,53.35%,38.71%,1
新北市,蘆洲區,0567,585,172,757,70,827,1612,51.3%,36.29%,1
新北市,蘆洲區,0568,635,180,815,62,877,1674,52.39%,37.93%,1
新北市,蘆洲區,0569,644,194,838,62,900,1838,48.97%,35.04%,1
新北市,蘆洲區,0570,588,187,775,47,822,1814,45.31%,32.41%,1
新北市,蘆洲區,0571,514,208,722,49,771,1473,52.34%,34.89%,1
新北市,蘆洲區,0572,609,137,746,56,802,1465,54.74%,41.57%,1
新北市,蘆洲區,0573,668,192,860,87,947,1652,57.32%,40.44%,1
新北市,蘆洲區,0574,624,191,815,90,905,1650,54.85%,37.82%,1
新北市,蘆洲區,0575,704,166,870,44,914,1656,55.19%,42.51%,1
新北市,蘆洲區,0576,568,194,762,58,820,1571,52.2%,36.16%,1
新北市,蘆洲區,0577,527,213,740,79,819,1523,53.78%,34.6%,1
新北市,蘆洲區,0578,577,167,744,46,790,1475,53.56%,39.12%,1
新北市,蘆洲區,0579,529,124,653,69,722,1367,52.82%,38.7%,1
新北市,蘆洲區,0580,609,190,799,54,853,1514,56.34%,40.22%,1
新北市,蘆洲區,0581,760,237,997,57,1054,1791,58.85%,42.43%,1
新北市,蘆洲區,0582,707,276,983,55,1038,1714,60.56%,41.25%,1
新北市,蘆洲區,0583,781,187,968,41,1009,1780,56.69%,43.88%,1
新北市,蘆洲區,0584,694,220,914,50,964,1713,56.28%,40.51%,1
新北市,蘆洲區,0585,723,216,939,49,988,1720,57.44%,42.03%,1
新北市,蘆洲區,0586,747,173,920,50,970,1766,54.93%,42.3%,1
新北市,蘆洲區,0587,630,184,814,69,883,1623,54.41%,38.82%,1
新北市,蘆洲區,0588,688,209,897,51,948,1740,54.48%,39.54%,1
新北市,蘆洲區,0589,743,207,950,68,1018,1759,57.87%,42.24%,1
新北市,蘆洲區,0590,722,221,943,81,1024,1775,57.69%,40.68%,1
新北市,蘆洲區,0591,790,223,1013,76,1089,1909,57.05%,41.38%,1
新北市,蘆洲區,0592,732,224,956,96,1052,1805,58.28%,40.55%,1
新北市,蘆洲區,0593,629,190,819,49,868,1642,52.86%,38.31%,1
新北市,蘆洲區,0594,651,205,856,59,915,1713,53.42%,38%,1
新北市,蘆洲區,0595,619,214,833,64,897,1746,51.37%,35.45%,1
新北市,蘆洲區,0596,621,189,810,65,875,1596,54.82%,38.91%,1
新北市,蘆洲區,0597,554,143,697,58,755,1434,52.65%,38.63%,1
新北市,蘆洲區,0598,541,182,723,71,794,1450,54.76%,37.31%,1
新北市,蘆洲區,0599,572,161,733,26,759,1543,49.19%,37.07%,1
新北市,蘆洲區,0600,617,154,771,49,820,1525,53.77%,40.46%,1
新北市,蘆洲區,0601,513,140,653,79,732,1419,51.59%,36.15%,1
新北市,蘆洲區,0602,518,166,684,56,740,1298,57.01%,39.91%,1
新北市,蘆洲區,0603,492,146,638,68,706,1304,54.14%,37.73%,1
新北市,蘆洲區,0604,675,221,896,72,968,1806,53.6%,37.38%,1
新北市,蘆洲區,0605,703,211,914,79,993,1910,51.99%,36.81%,1
新北市,蘆洲區,0606,595,185,780,67,847,1873,45.22%,31.77%,1
新北市,蘆洲區,0607,596,189,785,57,842,1785,47.17%,33.39%,1
新北市,蘆洲區,0608,604,197,801,66,867,1760,49.26%,34.32%,1
新北市,蘆洲區,0609,766,182,948,73,1021,1841,55.46%,41.61%,1
新北市,蘆洲區,0610,662,174,836,40,876,1855,47.22%,35.69%,1
新北市,蘆洲區,0611,506,147,653,77,730,1450,50.34%,34.9%,1
新北市,蘆洲區,0612,569,184,753,76,829,1585,52.3%,35.9%,1
新北市,蘆洲區,0613,544,147,691,96,787,1541,51.07%,35.3%,1
新北市,蘆洲區,0614,630,160,790,68,858,1626,52.77%,38.75%,1
新北市,蘆洲區,0615,498,155,653,63,716,1241,57.7%,40.13%,1
新北市,蘆洲區,0616,626,183,809,70,879,1634,53.79%,38.31%,1
新北市,蘆洲區,0617,609,191,800,69,869,1573,55.24%,38.72%,1
新北市,蘆洲區,0618,640,222,862,49,911,1619,56.27%,39.53%,1
新北市,蘆洲區,0619,728,207,935,95,1030,1878,54.85%,38.76%,1
新北市,蘆洲區,0620,677,200,877,90,967,1797,53.81%,37.67%,1
新北市,蘆洲區,0621,733,235,968,42,1010,1816,55.62%,40.36%,1
新北市,蘆洲區,0622,525,186,711,84,795,1344,59.15%,39.06%,1
新北市,蘆洲區,0623,591,237,828,57,885,1492,59.32%,39.61%,1
新北市,蘆洲區,0624,723,215,938,113,1051,1959,53.65%,36.91%,1
新北市,蘆洲區,0625,576,209,785,97,882,1611,54.75%,35.75%,1
新北市,蘆洲區,0626,609,208,817,85,902,1574,57.31%,38.69%,1
新北市,蘆洲區,0627,672,182,854,72,926,1653,56.02%,40.65%,1
新北市,蘆洲區,0628,764,225,989,64,1053,3085,34.13%,24.76%,1
新北市,蘆洲區,0629,663,230,893,76,969,1812,53.48%,36.59%,1
新北市,蘆洲區,0630,498,174,672,64,736,1332,55.26%,37.39%,1
新北市,蘆洲區,0631,527,164,691,86,777,1648,47.15%,31.98%,1
新北市,蘆洲區,0632,520,141,661,29,690,1355,50.92%,38.38%,1
新北市,蘆洲區,0633,519,143,662,44,706,1371,51.5%,37.86%,1
新北市,蘆洲區,0634,412,158,570,69,639,1111,57.52%,37.08%,1
新北市,蘆洲區,0635,465,158,623,76,699,1176,59.44%,39.54%,1
新北市,蘆洲區,0636,635,192,827,64,891,1602,55.62%,39.64%,1
新北市,蘆洲區,0637,456,178,634,60,694,1361,50.99%,33.5%,1
新北市,蘆洲區,0638,602,159,761,67,828,1530,54.12%,39.35%,1
新北市,蘆洲區,0639,356,105,461,67,528,925,57.08%,38.49%,1
新北市,蘆洲區,0640,698,214,912,83,995,1851,53.75%,37.71%,1
新北市,蘆洲區,0641,619,194,813,63,876,1791,48.91%,34.56%,1
新北市,蘆洲區,0642,664,181,845,72,917,1853,49.49%,35.83%,1
新北市,蘆洲區,0643,628,181,809,52,861,1758,48.98%,35.72%,1
新北市,蘆洲區,0644,688,196,884,84,968,1798,53.84%,38.26%,1
新北市,蘆洲區,0645,646,192,838,59,897,1645,54.53%,39.27%,1
新北市,蘆洲區,0646,573,162,735,57,792,1612,49.13%,35.55%,1
新北市,蘆洲區,0647,599,177,776,82,858,1784,48.09%,33.58%,1
新北市,蘆洲區,0648,562,163,725,63,788,1701,46.33%,33.04%,1
新北市,蘆洲區,0649,604,161,765,45,810,1581,51.23%,38.2%,1
新北市,蘆洲區,0650,584,200,784,60,844,1534,55.02%,38.07%,1
新北市,蘆洲區,0651,641,211,852,69,921,1620,56.85%,39.57%,1
新北市,蘆洲區,0652,640,173,813,73,886,1494,59.3%,42.84%,1
新北市,蘆洲區,0653,470,134,604,53,657,1183,55.54%,39.73%,1
新北市,蘆洲區,0654,374,145,519,53,572,985,58.07%,37.97%,1
新北市,蘆洲區,0655,589,194,783,84,867,1673,51.82%,35.21%,1
新北市,蘆洲區,0656,646,193,839,103,942,1688,55.81%,38.27%,1
新北市,蘆洲區,0657,392,140,532,52,584,1249,46.76%,31.39%,1
新北市,蘆洲區,0658,535,170,705,73,778,1476,52.71%,36.25%,1
新北市,五股區,0207,512,184,696,95,791,1456,54.33%,35.16%,1
新北市,五股區,0208,540,172,712,71,783,1482,52.83%,36.44%,1
新北市,五股區,0209,486,182,668,54,722,1287,56.1%,37.76%,1
新北市,五股區,0210,345,169,514,39,553,1106,50%,31.19%,1
新北市,五股區,0211,405,154,559,77,636,1283,49.57%,31.57%,1
新北市,五股區,0212,657,200,857,54,911,1833,49.7%,35.84%,1
新北市,五股區,0213,481,123,604,51,655,1141,57.41%,42.16%,1
新北市,五股區,0214,187,64,251,32,283,463,61.12%,40.39%,1
新北市,五股區,0215,687,201,888,55,943,1786,52.8%,38.47%,1
新北市,五股區,0216,559,246,805,39,844,1660,50.84%,33.67%,1
新北市,五股區,0217,554,202,756,87,843,1534,54.95%,36.11%,1
新北市,五股區,0218,501,140,641,82,723,1285,56.26%,38.99%,1
新北市,五股區,0219,656,199,855,109,964,1832,52.62%,35.81%,1
新北市,五股區,0220,593,160,753,42,795,1542,51.56%,38.46%,1
新北市,五股區,0221,621,188,809,48,857,1897,45.18%,32.74%,1
新北市,五股區,0222,669,187,856,101,957,1964,48.73%,34.06%,1
新北市,五股區,0223,618,186,804,81,885,1779,49.75%,34.74%,1
新北市,五股區,0224,643,169,812,82,894,1735,51.53%,37.06%,1
新北市,五股區,0225,832,240,1072,52,1124,2299,48.89%,36.19%,1
新北市,五股區,0226,623,161,784,60,844,1755,48.09%,35.5%,1
新北市,五股區,0227,657,180,837,69,906,1674,54.12%,39.25%,1
新北市,五股區,0228,644,191,835,82,917,1661,55.21%,38.77%,1
新北市,五股區,0229,410,144,554,41,595,1281,46.45%,32.01%,1
新北市,五股區,0230,578,182,760,83,843,1566,53.83%,36.91%,1
新北市,五股區,0231,520,139,659,39,698,1560,44.74%,33.33%,1
新北市,五股區,0232,643,170,813,42,855,1622,52.71%,39.64%,1
新北市,五股區,0233,702,196,898,51,949,1779,53.34%,39.46%,1
新北市,五股區,0234,543,149,692,75,767,1487,51.58%,36.52%,1
新北市,五股區,0235,642,164,806,51,857,1567,54.69%,40.97%,1
新北市,五股區,0236,376,105,481,35,516,1333,38.71%,28.21%,1
新北市,五股區,0237,537,160,697,60,757,1263,59.94%,42.52%,1
新北市,五股區,0238,524,160,684,78,762,1314,57.99%,39.88%,1
新北市,五股區,0239,564,149,713,41,754,1513,49.83%,37.28%,1
新北市,五股區,0240,604,176,780,34,814,1517,53.66%,39.82%,1
新北市,五股區,0241,608,190,798,73,871,1613,54%,37.69%,1
新北市,五股區,0242,625,174,799,70,869,1616,53.77%,38.68%,1
新北市,五股區,0243,601,191,792,73,865,1616,53.53%,37.19%,1
新北市,五股區,0244,647,195,842,76,918,1689,54.35%,38.31%,1
新北市,五股區,0245,726,192,918,26,944,1894,49.84%,38.33%,1
新北市,五股區,0246,530,166,696,66,762,1210,62.98%,43.8%,1
新北市,五股區,0247,612,177,789,57,846,1643,51.49%,37.25%,1
新北市,五股區,0248,566,144,710,31,741,1441,51.42%,39.28%,1
新北市,五股區,0249,572,128,700,51,751,1305,57.55%,43.83%,1
新北市,五股區,0250,534,127,661,59,720,1170,61.54%,45.64%,1
新北市,五股區,0251,661,137,798,53,851,1397,60.92%,47.32%,1
新北市,五股區,0252,626,114,740,56,796,1312,60.67%,47.71%,1
新北市,五股區,0253,465,79,544,30,574,1127,50.93%,41.26%,1
新北市,五股區,0254,493,65,558,43,601,1154,52.08%,42.72%,1
新北市,泰山區,0255,221,72,293,34,327,643,50.86%,34.37%,1
新北市,泰山區,0256,91,18,109,5,114,186,61.29%,48.92%,1
新北市,泰山區,0257,535,148,683,45,728,1457,49.97%,36.72%,1
新北市,泰山區,0258,666,160,826,62,888,1594,55.71%,41.78%,1
新北市,泰山區,0259,632,116,748,53,801,1598,50.13%,39.55%,1
新北市,泰山區,0260,569,135,704,46,750,1503,49.9%,37.86%,1
新北市,泰山區,0261,552,141,693,55,748,1436,52.09%,38.44%,1
新北市,泰山區,0262,536,175,711,51,762,1384,55.06%,38.73%,1
新北市,泰山區,0263,490,146,636,51,687,1231,55.81%,39.81%,1
新北市,泰山區,0264,481,149,630,25,655,1295,50.58%,37.14%,1
新北市,泰山區,0265,657,171,828,69,897,1563,57.39%,42.03%,1
新北市,泰山區,0266,716,154,870,67,937,1610,58.2%,44.47%,1
新北市,泰山區,0267,485,155,640,33,673,1253,53.71%,38.71%,1
新北市,泰山區,0268,491,132,623,41,664,1294,51.31%,37.94%,1
新北市,泰山區,0269,577,165,742,47,789,1354,58.27%,42.61%,1
新北市,泰山區,0270,521,120,641,36,677,1259,53.77%,41.38%,1
新北市,泰山區,0271,516,154,670,27,697,1252,55.67%,41.21%,1
新北市,泰山區,0272,432,105,537,26,563,1094,51.46%,39.49%,1
新北市,泰山區,0273,626,207,833,57,890,1590,55.97%,39.37%,1
新北市,泰山區,0274,730,96,826,82,908,1634,55.57%,44.68%,1
新北市,泰山區,0275,521,163,684,45,729,1536,47.46%,33.92%,1
新北市,泰山區,0276,650,177,827,58,885,1534,57.69%,42.37%,1
新北市,泰山區,0277,724,161,885,62,947,1545,61.29%,46.86%,1
新北市,泰山區,0278,608,130,738,44,782,1399,55.9%,43.46%,1
新北市,泰山區,0279,532,136,668,28,696,1315,52.93%,40.46%,1
新北市,泰山區,0280,546,134,680,54,734,1201,61.12%,45.46%,1
新北市,泰山區,0281,468,134,602,55,657,1182,55.58%,39.59%,1
新北市,泰山區,0282,656,157,813,58,871,1665,52.31%,39.4%,1
新北市,泰山區,0283,719,219,938,71,1009,1855,54.39%,38.76%,1
新北市,泰山區,0284,710,224,934,93,1027,1866,55.04%,38.05%,1
新北市,泰山區,0285,771,203,974,56,1030,1935,53.23%,39.84%,1
新北市,泰山區,0286,613,158,771,48,819,1589,51.54%,38.58%,1
新北市,泰山區,0287,452,103,555,36,591,1152,51.3%,39.24%,1
新北市,泰山區,0288,430,147,577,48,625,1114,56.1%,38.6%,1
新北市,泰山區,0289,477,123,600,47,647,1040,62.21%,45.87%,1
新北市,泰山區,0290,448,108,556,41,597,1003,59.52%,44.67%,1
新北市,泰山區,0291,399,142,541,25,566,975,58.05%,40.92%,1
新北市,泰山區,0292,558,183,741,44,785,1440,54.51%,38.75%,1
新北市,泰山區,0293,580,154,734,23,757,1480,51.15%,39.19%,1
新北市,泰山區,0294,497,142,639,41,680,1211,56.15%,41.04%,1
新北市,泰山區,0295,486,145,631,35,666,1237,53.84%,39.29%,1
新北市,泰山區,0296,424,113,537,41,578,1069,54.07%,39.66%,1
新北市,泰山區,0297,761,168,929,63,992,1680,59.05%,45.3%,1
新北市,泰山區,0298,676,200,876,40,916,1651,55.48%,40.94%,1
新北市,泰山區,0299,546,150,696,30,726,1420,51.13%,38.45%,1
新北市,泰山區,0300,559,162,721,33,754,1337,56.39%,41.81%,1
新北市,泰山區,0301,685,192,877,42,919,1591,57.76%,43.05%,1
新北市,林口區,0145,455,148,603,73,676,1268,53.31%,35.88%,1
新北市,林口區,0146,413,144,557,50,607,1171,51.84%,35.27%,1
新北市,林口區,0147,490,152,642,58,700,1218,57.47%,40.23%,1
新北市,林口區,0148,672,190,862,54,916,1788,51.23%,37.58%,1
新北市,林口區,0149,602,165,767,61,828,1625,50.95%,37.05%,1
新北市,林口區,0150,544,148,692,63,755,1448,52.14%,37.57%,1
新北市,林口區,0151,454,147,601,83,684,1328,51.51%,34.19%,1
新北市,林口區,0152,505,130,635,70,705,1523,46.29%,33.16%,1
新北市,林口區,0153,519,114,633,50,683,1245,54.86%,41.69%,1
新北市,林口區,0154,647,135,782,43,825,1329,62.08%,48.68%,1
新北市,林口區,0155,657,165,822,34,856,1465,58.43%,44.85%,1
新北市,林口區,0156,615,155,770,35,805,1369,58.8%,44.92%,1
新北市,林口區,0157,560,174,734,52,786,1346,58.4%,41.6%,1
新北市,林口區,0158,440,148,588,61,649,1181,54.95%,37.26%,1
新北市,林口區,0159,568,201,769,28,797,1291,61.74%,44%,1
新北市,林口區,0160,479,150,629,45,674,1213,55.56%,39.49%,1
新北市,林口區,0161,561,132,693,39,732,1256,58.28%,44.67%,1
新北市,林口區,0162,448,151,599,44,643,1185,54.26%,37.81%,1
新北市,林口區,0163,549,147,696,41,737,1361,54.15%,40.34%,1
新北市,林口區,0164,765,110,875,22,897,1756,51.08%,43.56%,1
新北市,林口區,0165,670,158,828,32,860,1676,51.31%,39.98%,1
新北市,林口區,0166,689,160,849,22,871,1540,56.56%,44.74%,1
新北市,林口區,0167,681,129,810,41,851,1569,54.24%,43.4%,1
新北市,林口區,0168,658,146,804,32,836,1514,55.22%,43.46%,1
新北市,林口區,0169,561,109,670,24,694,1193,58.17%,47.02%,1
新北市,林口區,0170,711,171,882,30,912,1610,56.65%,44.16%,1
新北市,林口區,0171,609,136,745,30,775,1338,57.92%,45.52%,1
新北市,林口區,0172,488,129,617,37,654,1141,57.32%,42.77%,1
新北市,林口區,0173,560,140,700,38,738,1307,56.47%,42.85%,1
新北市,林口區,0174,584,149,733,28,761,1327,57.35%,44.01%,1
新北市,林口區,0175,562,144,706,37,743,1285,57.82%,43.74%,1
新北市,林口區,0176,608,182,790,45,835,1481,56.38%,41.05%,1
新北市,林口區,0177,660,169,829,29,858,1510,56.82%,43.71%,1
新北市,林口區,0178,720,187,907,47,954,1785,53.45%,40.34%,1
新北市,林口區,0179,747,190,937,34,971,1792,54.19%,41.69%,1
新北市,林口區,0180,678,149,827,29,856,1517,56.43%,44.69%,1
新北市,林口區,0181,715,152,867,32,899,1564,57.48%,45.72%,1
新北市,林口區,0182,721,130,851,44,895,1560,57.37%,46.22%,1
新北市,林口區,0183,640,167,807,33,840,1544,54.4%,41.45%,1
新北市,林口區,0184,676,143,819,39,858,1593,53.86%,42.44%,1
新北市,林口區,0185,648,124,772,31,803,1431,56.11%,45.28%,1
新北市,林口區,0186,628,166,794,40,834,1571,53.09%,39.97%,1
新北市,林口區,0187,631,155,786,37,823,1439,57.19%,43.85%,1
新北市,林口區,0188,614,180,794,49,843,1451,58.1%,42.32%,1
新北市,林口區,0189,623,168,791,49,840,1391,60.39%,44.79%,1
新北市,林口區,0190,627,155,782,30,812,1461,55.58%,42.92%,1
新北市,林口區,0191,705,176,881,32,913,1691,53.99%,41.69%,1
新北市,林口區,0192,602,197,799,50,849,1524,55.71%,39.5%,1
新北市,林口區,0193,659,146,805,33,838,1343,62.4%,49.07%,1
新北市,林口區,0194,654,146,800,37,837,1398,59.87%,46.78%,1
新北市,林口區,0195,606,158,764,48,812,1380,58.84%,43.91%,1
新北市,林口區,0196,543,169,712,55,767,1367,56.11%,39.72%,1
新北市,林口區,0197,532,198,730,35,765,1350,56.67%,39.41%,1
新北市,林口區,0198,529,131,660,39,699,1194,58.54%,44.3%,1
新北市,林口區,0199,513,166,679,58,737,1344,54.84%,38.17%,1
新北市,林口區,0200,492,128,620,33,653,1154,56.59%,42.63%,1
新北市,林口區,0201,517,137,654,40,694,1119,62.02%,46.2%,1
新北市,林口區,0202,338,119,457,44,501,1026,48.83%,32.94%,1
新北市,林口區,0203,459,164,623,49,672,1210,55.54%,37.93%,1
新北市,林口區,0204,349,110,459,54,513,912,56.25%,38.27%,1
新北市,林口區,0205,316,128,444,36,480,824,58.25%,38.35%,1
新北市,林口區,0206,576,167,743,88,831,1411,58.89%,40.82%,1
新北市,深坑區,2163,435,120,555,30,585,1142,51.23%,38.09%,1
新北市,深坑區,2164,463,153,616,52,668,1139,58.65%,40.65%,1
新北市,深坑區,2165,385,128,513,60,573,1065,53.8%,36.15%,1
新北市,深坑區,2166,530,126,656,50,706,1400,50.43%,37.86%,1
新北市,深坑區,2167,509,135,644,33,677,1330,50.9%,38.27%,1
新北市,深坑區,2168,513,122,635,38,673,1380,48.77%,37.17%,1
新北市,深坑區,2169,506,128,634,29,663,1496,44.32%,33.82%,1
新北市,深坑區,2170,631,162,793,68,861,1508,57.1%,41.84%,1
新北市,深坑區,2171,679,185,864,59,923,1624,56.83%,41.81%,1
新北市,深坑區,2172,872,228,1100,63,1163,2165,53.72%,40.28%,1
新北市,深坑區,2173,701,212,913,65,978,1790,54.64%,39.16%,1
新北市,深坑區,2174,288,70,358,23,381,782,48.72%,36.83%,1
新北市,深坑區,2175,518,126,644,21,665,1164,57.13%,44.5%,1
新北市,深坑區,2176,579,156,735,65,800,1344,59.52%,43.08%,1
新北市,深坑區,2177,340,88,428,27,455,739,61.57%,46.01%,1
新北市,深坑區,2178,244,62,306,33,339,556,60.97%,43.88%,1
新北市,石碇區,2179,158,60,218,23,241,391,61.64%,40.41%,1
新北市,石碇區,2180,272,85,357,41,398,789,50.44%,34.47%,1
新北市,石碇區,2181,191,60,251,25,276,662,41.69%,28.85%,1
新北市,石碇區,2182,107,35,142,12,154,310,49.68%,34.52%,1
新北市,石碇區,2183,106,29,135,13,148,280,52.86%,37.86%,1
新北市,石碇區,2184,25,8,33,5,38,93,40.86%,26.88%,1
新北市,石碇區,2185,205,56,261,48,309,683,45.24%,30.01%,1
新北市,石碇區,2186,158,33,191,11,202,323,62.54%,48.92%,1
新北市,石碇區,2187,191,58,249,7,256,726,35.26%,26.31%,1
新北市,石碇區,2188,203,77,280,35,315,591,53.3%,34.35%,1
新北市,石碇區,2189,128,39,167,22,189,282,67.02%,45.39%,1
新北市,石碇區,2190,237,62,299,12,311,788,39.47%,30.08%,1
新北市,石碇區,2191,377,117,494,55,549,943,58.22%,39.98%,1
新北市,坪林區,2192,482,108,590,43,633,1248,50.72%,38.62%,1
新北市,坪林區,2193,200,50,250,41,291,612,47.55%,32.68%,1
新北市,坪林區,2194,434,120,554,96,650,1141,56.97%,38.04%,1
新北市,坪林區,2195,116,33,149,9,158,417,37.89%,27.82%,1
新北市,坪林區,2196,222,65,287,43,330,595,55.46%,37.31%,1
新北市,坪林區,2197,108,27,135,17,152,248,61.29%,43.55%,1
新北市,坪林區,2198,120,34,154,8,162,338,47.93%,35.5%,1
新北市,坪林區,2199,160,30,190,16,206,478,43.1%,33.47%,1
新北市,坪林區,2200,101,34,135,12,147,390,37.69%,25.9%,1
新北市,坪林區,2201,132,34,166,26,192,424,45.28%,31.13%,1
新北市,三芝區,0011,109,29,138,10,148,312,47.44%,34.94%,1
新北市,三芝區,0012,525,111,636,37,673,1421,47.36%,36.95%,1
新北市,三芝區,0013,587,156,743,58,801,1557,51.45%,37.7%,1
新北市,三芝區,0014,694,169,863,59,922,1828,50.44%,37.96%,1
新北市,三芝區,0015,383,113,496,44,540,1060,50.94%,36.13%,1
新北市,三芝區,0016,252,69,321,35,356,819,43.47%,30.77%,1
新北市,三芝區,0017,535,144,679,37,716,1701,42.09%,31.45%,1
新北市,三芝區,0018,596,165,761,76,837,1740,48.1%,34.25%,1
新北市,三芝區,0019,480,141,621,49,670,1451,46.18%,33.08%,1
新北市,三芝區,0020,411,111,522,53,575,1248,46.07%,32.93%,1
新北市,三芝區,0021,232,71,303,13,316,629,50.24%,36.88%,1
新北市,三芝區,0022,177,35,212,21,233,504,46.23%,35.12%,1
新北市,三芝區,0023,225,66,291,17,308,698,44.13%,32.23%,1
新北市,三芝區,0024,726,176,902,51,953,2069,46.06%,35.09%,1
新北市,三芝區,0025,297,83,380,34,414,784,52.81%,37.88%,1
新北市,三芝區,0026,170,70,240,23,263,522,50.38%,32.57%,1
新北市,三芝區,0027,192,66,258,47,305,587,51.96%,32.71%,1
新北市,三芝區,0028,408,152,560,40,600,1189,50.46%,34.31%,1
新北市,石門區,0001,402,126,528,51,579,1121,51.65%,35.86%,1
新北市,石門區,0002,471,130,601,70,671,1389,48.31%,33.91%,1
新北市,石門區,0003,353,83,436,55,491,933,52.63%,37.83%,1
新北市,石門區,0004,450,107,557,61,618,1244,49.68%,36.17%,1
新北市,石門區,0005,342,86,428,56,484,883,54.81%,38.73%,1
新北市,石門區,0006,612,155,767,56,823,1564,52.62%,39.13%,1
新北市,石門區,0007,574,157,731,64,795,1500,53%,38.27%,1
新北市,石門區,0008,115,22,137,14,151,328,46.04%,35.06%,1
新北市,石門區,0009,289,70,359,44,403,651,61.9%,44.39%,1
新北市,石門區,0010,291,82,373,38,411,915,44.92%,31.8%,1
新北市,八里區,0125,530,150,680,63,743,1498,49.6%,35.38%,1
新北市,八里區,0126,683,170,853,38,891,1939,45.95%,35.22%,1
新北市,八里區,0127,564,174,738,70,808,1516,53.3%,37.2%,1
新北市,八里區,0128,694,186,880,65,945,1642,57.55%,42.27%,1
新北市,八里區,0129,667,186,853,87,940,1927,48.78%,34.61%,1
新北市,八里區,0130,519,124,643,48,691,1276,54.15%,40.67%,1
新北市,八里區,0131,585,156,741,44,785,1349,58.19%,43.37%,1
新北市,八里區,0132,576,146,722,64,786,1403,56.02%,41.05%,1
新北市,八里區,0133,638,190,828,59,887,1644,53.95%,38.81%,1
新北市,八里區,0134,725,193,918,63,981,1853,52.94%,39.13%,1
新北市,八里區,0135,763,194,957,88,1045,1793,58.28%,42.55%,1
新北市,八里區,0136,638,197,835,49,884,1644,53.77%,38.81%,1
新北市,八里區,0137,716,184,900,64,964,1846,52.22%,38.79%,1
新北市,八里區,0138,511,148,659,58,717,1346,53.27%,37.96%,1
新北市,八里區,0139,626,192,818,54,872,1621,53.79%,38.62%,1
新北市,八里區,0140,693,180,873,68,941,2110,44.6%,32.84%,1
新北市,八里區,0141,713,198,911,89,1000,1967,50.84%,36.25%,1
新北市,八里區,0142,664,184,848,49,897,1626,55.17%,40.84%,1
新北市,八里區,0143,601,169,770,61,831,1514,54.89%,39.7%,1
新北市,八里區,0144,578,172,750,82,832,1456,57.14%,39.7%,1
新北市,平溪區,2208,133,45,178,9,187,384,48.7%,34.64%,1
新北市,平溪區,2209,77,16,93,3,96,232,41.38%,33.19%,1
新北市,平溪區,2210,96,31,127,13,140,249,56.22%,38.55%,1
新北市,平溪區,2211,171,52,223,30,253,458,55.24%,37.34%,1
新北市,平溪區,2212,83,30,113,16,129,232,55.6%,35.78%,1
新北市,平溪區,2213,193,50,243,16,259,635,40.79%,30.39%,1
新北市,平溪區,2214,165,47,212,25,237,427,55.5%,38.64%,1
新北市,平溪區,2215,241,64,305,37,342,862,39.68%,27.96%,1
新北市,平溪區,2216,53,16,69,4,73,147,49.66%,36.05%,1
新北市,平溪區,2217,98,24,122,13,135,365,36.99%,26.85%,1
新北市,平溪區,2218,47,15,62,8,70,153,45.75%,30.72%,1
新北市,平溪區,2219,71,22,93,16,109,177,61.58%,40.11%,1
新北市,雙溪區,2266,162,30,192,22,214,455,47.03%,35.6%,1
新北市,雙溪區,2267,113,23,136,12,148,286,51.75%,39.51%,1
新北市,雙溪區,2268,204,48,252,24,276,496,55.65%,41.13%,1
新北市,雙溪區,2269,121,28,149,11,160,383,41.78%,31.59%,1
新北市,雙溪區,2270,255,82,337,40,377,887,42.5%,28.75%,1
新北市,雙溪區,2271,193,48,241,35,276,652,42.33%,29.6%,1
新北市,雙溪區,2272,124,30,154,13,167,333,50.15%,37.24%,1
新北市,雙溪區,2273,227,62,289,27,316,642,49.22%,35.36%,1
新北市,雙溪區,2274,90,34,124,11,135,282,47.87%,31.91%,1
新北市,雙溪區,2275,182,65,247,21,268,621,43.16%,29.31%,1
新北市,雙溪區,2276,128,28,156,10,166,422,39.34%,30.33%,1
新北市,雙溪區,2277,82,32,114,20,134,369,36.31%,22.22%,1
新北市,雙溪區,2278,48,8,56,9,65,120,54.17%,40%,1
新北市,雙溪區,2279,100,20,120,14,134,271,49.45%,36.9%,1
新北市,雙溪區,2280,147,40,187,25,212,362,58.56%,40.61%,1
新北市,雙溪區,2281,130,35,165,28,193,371,52.02%,35.04%,1
新北市,雙溪區,2282,433,124,557,51,608,1047,58.07%,41.36%,1
新北市,貢寮區,2283,310,82,392,43,435,876,49.66%,35.39%,1
新北市,貢寮區,2284,147,48,195,22,217,433,50.12%,33.95%,1
新北市,貢寮區,2285,147,36,183,15,198,516,38.37%,28.49%,1
新北市,貢寮區,2286,100,29,129,20,149,373,39.95%,26.81%,1
新北市,貢寮區,2287,93,38,131,18,149,313,47.6%,29.71%,1
新北市,貢寮區,2288,179,44,223,11,234,485,48.25%,36.91%,1
新北市,貢寮區,2289,119,60,179,32,211,415,50.84%,28.67%,1
新北市,貢寮區,2290,240,68,308,14,322,812,39.66%,29.56%,1
新北市,貢寮區,2291,277,102,379,33,412,861,47.85%,32.17%,1
新北市,貢寮區,2292,173,58,231,31,262,676,38.76%,25.59%,1
新北市,貢寮區,2293,265,93,358,29,387,1091,35.47%,24.29%,1
新北市,貢寮區,2294,247,91,338,49,387,955,40.52%,25.86%,1
新北市,貢寮區,2295,219,50,269,11,280,769,36.41%,28.48%,1
新北市,貢寮區,2296,305,118,423,41,464,962,48.23%,31.7%,1
新北市,貢寮區,2297,143,39,182,12,194,390,49.74%,36.67%,1
新北市,貢寮區,2298,110,36,146,2,148,349,42.41%,31.52%,1
新北市,貢寮區,2299,125,45,170,27,197,508,38.78%,24.61%,1
新北市,貢寮區,2300,110,38,148,13,161,495,32.53%,22.22%,1
新北市,金山區,2301,194,39,233,29,262,481,54.47%,40.33%,1
新北市,金山區,2302,267,81,348,31,379,715,53.01%,37.34%,1
新北市,金山區,2303,147,42,189,25,214,481,44.49%,30.56%,1
新北市,金山區,2304,601,138,739,87,826,1792,46.09%,33.54%,1
新北市,金山區,2305,627,210,837,72,909,1781,51.04%,35.2%,1
新北市,金山區,2306,817,194,1011,55,1066,2010,53.03%,40.65%,1
新北市,金山區,2307,563,145,708,55,763,1572,48.54%,35.81%,1
新北市,金山區,2308,673,163,836,71,907,1777,51.04%,37.87%,1
新北市,金山區,2309,570,137,707,67,774,1631,47.46%,34.95%,1
新北市,金山區,2310,318,82,400,35,435,828,52.54%,38.41%,1
新北市,金山區,2311,327,93,420,29,449,888,50.56%,36.82%,1
新北市,金山區,2312,405,133,538,69,607,1211,50.12%,33.44%,1
新北市,金山區,2313,173,50,223,16,239,416,57.45%,41.59%,1
新北市,金山區,2314,277,78,355,43,398,682,58.36%,40.62%,1
新北市,金山區,2315,238,62,300,48,348,644,54.04%,36.96%,1
新北市,金山區,2316,289,78,367,42,409,830,49.28%,34.82%,1
新北市,金山區,2317,65,23,88,11,99,188,52.66%,34.57%,1
新北市,金山區,2318,159,70,229,30,259,469,55.22%,33.9%,1
新北市,金山區,2319,143,42,185,28,213,582,36.6%,24.57%,1
新北市,萬里區,2320,528,121,649,46,695,1286,54.04%,41.06%,1
新北市,萬里區,2321,618,177,795,64,859,1576,54.51%,39.21%,1
新北市,萬里區,2322,520,127,647,46,693,1447,47.89%,35.94%,1
新北市,萬里區,2323,474,121,595,74,669,1466,45.63%,32.33%,1
新北市,萬里區,2324,406,120,526,60,586,1369,42.8%,29.66%,1
新北市,萬里區,2325,342,78,420,55,475,1215,39.09%,28.15%,1
新北市,萬里區,2326,503,129,632,57,689,1317,52.32%,38.19%,1
新北市,萬里區,2327,528,122,650,69,719,1676,42.9%,31.5%,1
新北市,萬里區,2328,525,135,660,79,739,1550,47.68%,33.87%,1
新北市,萬里區,2329,422,111,533,51,584,945,61.8%,44.66%,1
新北市,萬里區,2330,697,186,883,75,958,1760,54.43%,39.6%,1
新北市,萬里區,2331,221,47,268,20,288,570,50.53%,38.77%,1
新北市,萬里區,2332,307,110,417,27,444,952,46.64%,32.25%,1
新北市,萬里區,2333,263,80,343,52,395,674,58.61%,39.02%,1
新北市,萬里區,2334,151,34,185,23,208,405,51.36%,37.28%,1
新北市,萬里區,2335,378,113,491,56,547,1089,50.23%,34.71%,1
新北市,烏來區,2202,701,168,869,57,926,1568,59.06%,44.71%,1
新北市,烏來區,2203,452,108,560,21,581,1198,48.5%,37.73%,1
新北市,烏來區,2204,429,92,521,25,546,1169,46.71%,36.7%,1
新北市,烏來區,2205,90,22,112,2,114,228,50%,39.47%,1
新北市,烏來區,2206,189,40,229,34,263,486,54.12%,38.89%,1
新北市,烏來區,2207,211,40,251,22,273,615,44.39%,34.31%,1
桃園市,桃園區,0001,578,175,753,51,804,1593,50.47%,36.28%,1
桃園市,桃園區,0002,621,197,818,33,851,1934,44%,32.11%,1
桃園市,桃園區,0003,688,173,861,53,914,1661,55.03%,41.42%,1
桃園市,桃園區,0004,533,140,673,21,694,1448,47.93%,36.81%,1
桃園市,桃園區,0005,722,186,908,39,947,1974,47.97%,36.58%,1
桃園市,桃園區,0006,618,174,792,76,868,1882,46.12%,32.84%,1
桃園市,桃園區,0007,636,191,827,53,880,1800,48.89%,35.33%,1
桃園市,桃園區,0008,650,175,825,46,871,1598,54.51%,40.68%,1
桃園市,桃園區,0009,546,163,709,61,770,1626,47.36%,33.58%,1
桃園市,桃園區,0010,555,159,714,50,764,1590,48.05%,34.91%,1
桃園市,桃園區,0011,586,183,769,62,831,1637,50.76%,35.8%,1
桃園市,桃園區,0012,665,207,872,60,932,1943,47.97%,34.23%,1
桃園市,桃園區,0013,550,183,733,41,774,1482,52.23%,37.11%,1
桃園市,桃園區,0014,567,152,719,58,777,1423,54.6%,39.85%,1
桃園市,桃園區,0015,615,167,782,51,833,1509,55.2%,40.76%,1
桃園市,桃園區,0016,674,142,816,33,849,1567,54.18%,43.01%,1
桃園市,桃園區,0017,536,127,663,45,708,1305,54.25%,41.07%,1
桃園市,桃園區,0018,513,130,643,36,679,1416,47.95%,36.23%,1
桃園市,桃園區,0019,607,168,775,36,811,1439,56.36%,42.18%,1
桃園市,桃園區,0020,536,196,732,49,781,1399,55.83%,38.31%,1
桃園市,桃園區,0021,637,178,815,45,860,1540,55.84%,41.36%,1
桃園市,桃園區,0022,627,135,762,39,801,1638,48.9%,38.28%,1
桃園市,桃園區,0023,473,127,600,39,639,1228,52.04%,38.52%,1
桃園市,桃園區,0024,621,149,770,57,827,1649,50.15%,37.66%,1
桃園市,桃園區,0025,617,179,796,37,833,1601,52.03%,38.54%,1
桃園市,桃園區,0026,529,149,678,67,745,1477,50.44%,35.82%,1
桃園市,桃園區,0027,589,156,745,35,780,1503,51.9%,39.19%,1
桃園市,桃園區,0028,535,184,719,72,791,1375,57.53%,38.91%,1
桃園市,桃園區,0029,666,222,888,50,938,1743,53.82%,38.21%,1
桃園市,桃園區,0030,644,200,844,65,909,1862,48.82%,34.59%,1
桃園市,桃園區,0031,666,183,849,53,902,1728,52.2%,38.54%,1
桃園市,桃園區,0032,269,77,346,15,361,690,52.32%,38.99%,1
桃園市,桃園區,0033,368,111,479,36,515,852,60.45%,43.19%,1
桃園市,桃園區,0034,548,175,723,54,777,1353,57.43%,40.5%,1
桃園市,桃園區,0035,479,119,598,32,630,1698,37.1%,28.21%,1
桃園市,桃園區,0036,516,165,681,59,740,1452,50.96%,35.54%,1
桃園市,桃園區,0037,606,206,812,58,870,1681,51.75%,36.05%,1
桃園市,桃園區,0038,590,203,793,61,854,1669,51.17%,35.35%,1
桃園市,桃園區,0039,616,194,810,54,864,1530,56.47%,40.26%,1
桃園市,桃園區,0040,611,194,805,48,853,1582,53.92%,38.62%,1
桃園市,桃園區,0041,580,137,717,45,762,1587,48.02%,36.55%,1
桃園市,桃園區,0042,551,196,747,59,806,1451,55.55%,37.97%,1
桃園市,桃園區,0043,497,183,680,46,726,1582,45.89%,31.42%,1
桃園市,桃園區,0044,389,151,540,44,584,1028,56.81%,37.84%,1
桃園市,桃園區,0045,719,161,880,86,966,1934,49.95%,37.18%,1
桃園市,桃園區,0046,301,204,505,46,551,1016,54.23%,29.63%,1
桃園市,桃園區,0047,425,122,547,33,580,1079,53.75%,39.39%,1
桃園市,桃園區,0048,664,173,837,33,870,1837,47.36%,36.15%,1
桃園市,桃園區,0049,525,173,698,58,756,1390,54.39%,37.77%,1
桃園市,桃園區,0050,515,238,753,38,791,1489,53.12%,34.59%,1
桃園市,桃園區,0051,756,226,982,27,1009,1821,55.41%,41.52%,1
桃園市,桃園區,0052,568,137,705,24,729,1563,46.64%,36.34%,1
桃園市,桃園區,0053,715,169,884,31,915,1697,53.92%,42.13%,1
桃園市,桃園區,0054,718,182,900,38,938,1740,53.91%,41.26%,1
桃園市,桃園區,0055,639,167,806,42,848,1626,52.15%,39.3%,1
桃園市,桃園區,0056,548,115,663,14,677,1239,54.64%,44.23%,1
桃園市,桃園區,0057,720,177,897,42,939,1766,53.17%,40.77%,1
桃園市,桃園區,0058,606,179,785,48,833,1555,53.57%,38.97%,1
桃園市,桃園區,0059,709,207,916,41,957,1831,52.27%,38.72%,1
桃園市,桃園區,0060,505,127,632,33,665,1115,59.64%,45.29%,1
桃園市,桃園區,0061,594,226,820,39,859,1562,54.99%,38.03%,1
桃園市,桃園區,0062,679,172,851,43,894,1744,51.26%,38.93%,1
桃園市,桃園區,0063,614,194,808,49,857,1838,46.63%,33.41%,1
桃園市,桃園區,0064,726,227,953,71,1024,1889,54.21%,38.43%,1
桃園市,桃園區,0065,707,178,885,53,938,1985,47.25%,35.62%,1
桃園市,桃園區,0066,663,171,834,41,875,1524,57.41%,43.5%,1
桃園市,桃園區,0067,681,144,825,47,872,1425,61.19%,47.79%,1
桃園市,桃園區,0068,705,181,886,38,924,1606,57.53%,43.9%,1
桃園市,桃園區,0069,892,212,1104,32,1136,2056,55.25%,43.39%,1
桃園市,桃園區,0070,876,203,1079,33,1112,2010,55.32%,43.58%,1
桃園市,桃園區,0071,870,186,1056,53,1109,2245,49.4%,38.75%,1
桃園市,桃園區,0072,628,176,804,37,841,1590,52.89%,39.5%,1
桃園市,桃園區,0073,701,180,881,30,911,1536,59.31%,45.64%,1
桃園市,桃園區,0074,676,205,881,60,941,1949,48.28%,34.68%,1
桃園市,桃園區,0075,742,180,922,49,971,1965,49.41%,37.76%,1
桃園市,桃園區,0076,834,187,1021,63,1084,2414,44.9%,34.55%,1
桃園市,桃園區,0077,751,181,932,58,990,1942,50.98%,38.67%,1
桃園市,桃園區,0078,844,219,1063,48,1111,2156,51.53%,39.15%,1
桃園市,桃園區,0079,549,189,738,49,787,1404,56.05%,39.1%,1
桃園市,桃園區,0080,542,131,673,25,698,1194,58.46%,45.39%,1
桃園市,桃園區,0081,554,207,761,67,828,1449,57.14%,38.23%,1
桃園市,桃園區,0082,610,189,799,73,872,1803,48.36%,33.83%,1
桃園市,桃園區,0083,648,203,851,47,898,1692,53.07%,38.3%,1
桃園市,桃園區,0084,723,216,939,50,989,1913,51.7%,37.79%,1
桃園市,桃園區,0085,671,210,881,62,943,1815,51.96%,36.97%,1
桃園市,桃園區,0086,417,127,544,42,586,1173,49.96%,35.55%,1
桃園市,桃園區,0087,449,83,532,22,554,1162,47.68%,38.64%,1
桃園市,桃園區,0088,392,104,496,57,553,1194,46.31%,32.83%,1
桃園市,桃園區,0089,662,193,855,49,904,1695,53.33%,39.06%,1
桃園市,桃園區,0090,687,170,857,40,897,1797,49.92%,38.23%,1
桃園市,桃園區,0091,649,132,781,34,815,1592,51.19%,40.77%,1
桃園市,桃園區,0092,663,168,831,67,898,1780,50.45%,37.25%,1
桃園市,桃園區,0093,668,169,837,34,871,1904,45.75%,35.08%,1
桃園市,桃園區,0094,763,186,949,26,975,2021,48.24%,37.75%,1
桃園市,桃園區,0095,613,137,750,41,791,1545,51.2%,39.68%,1
桃園市,桃園區,0096,624,128,752,31,783,1617,48.42%,38.59%,1
桃園市,桃園區,0097,671,146,817,35,852,1683,50.62%,39.87%,1
桃園市,桃園區,0098,765,184,949,51,1000,1834,54.53%,41.71%,1
桃園市,桃園區,0099,730,188,918,38,956,2055,46.52%,35.52%,1
桃園市,桃園區,0100,703,157,860,26,886,1828,48.47%,38.46%,1
桃園市,桃園區,0101,707,172,879,37,916,1873,48.91%,37.75%,1
桃園市,桃園區,0102,594,131,725,38,763,3687,20.69%,16.11%,1
桃園市,桃園區,0103,710,184,894,7,901,1850,48.7%,38.38%,1
桃園市,桃園區,0104,712,158,870,44,914,1827,50.03%,38.97%,1
桃園市,桃園區,0105,525,128,653,37,690,1149,60.05%,45.69%,1
桃園市,桃園區,0106,458,124,582,38,620,1061,58.44%,43.17%,1
桃園市,桃園區,0107,651,162,813,34,847,1831,46.26%,35.55%,1
桃園市,桃園區,0108,819,205,1024,58,1082,2168,49.91%,37.78%,1
桃園市,桃園區,0109,705,181,886,30,916,1874,48.88%,37.62%,1
桃園市,桃園區,0110,531,143,674,24,698,1524,45.8%,34.84%,1
桃園市,桃園區,0111,625,156,781,32,813,1528,53.21%,40.9%,1
桃園市,桃園區,0112,610,152,762,44,806,1489,54.13%,40.97%,1
桃園市,桃園區,0113,481,137,618,62,680,1308,51.99%,36.77%,1
桃園市,桃園區,0114,592,157,749,55,804,1583,50.79%,37.4%,1
桃園市,桃園區,0115,620,206,826,54,880,1618,54.39%,38.32%,1
桃園市,桃園區,0116,740,227,967,66,1033,2127,48.57%,34.79%,1
桃園市,桃園區,0117,746,190,936,22,958,2033,47.12%,36.69%,1
桃園市,桃園區,0118,819,202,1021,36,1057,2098,50.38%,39.04%,1
桃園市,桃園區,0119,869,220,1089,74,1163,2126,54.7%,40.87%,1
桃園市,桃園區,0120,734,170,904,43,947,1917,49.4%,38.29%,1
桃園市,桃園區,0121,744,179,923,47,970,1997,48.57%,37.26%,1
桃園市,桃園區,0122,875,96,971,41,1012,1929,52.46%,45.36%,1
桃園市,桃園區,0123,640,177,817,41,858,1691,50.74%,37.85%,1
桃園市,桃園區,0124,761,164,925,36,961,1900,50.58%,40.05%,1
桃園市,桃園區,0125,709,164,873,60,933,1761,52.98%,40.26%,1
桃園市,桃園區,0126,712,198,910,33,943,1922,49.06%,37.04%,1
桃園市,桃園區,0127,749,162,911,45,956,1995,47.92%,37.54%,1
桃園市,桃園區,0128,411,123,534,43,577,1063,54.28%,38.66%,1
桃園市,桃園區,0129,556,126,682,48,730,1412,51.7%,39.38%,1
桃園市,桃園區,0130,716,187,903,22,925,1746,52.98%,41.01%,1
桃園市,桃園區,0131,572,182,754,58,812,1689,48.08%,33.87%,1
桃園市,桃園區,0132,479,146,625,33,658,1542,42.67%,31.06%,1
桃園市,桃園區,0133,529,138,667,42,709,1437,49.34%,36.81%,1
桃園市,桃園區,0134,617,167,784,38,822,1679,48.96%,36.75%,1
桃園市,桃園區,0135,623,190,813,63,876,1886,46.45%,33.03%,1
桃園市,桃園區,0136,661,165,826,65,891,1657,53.77%,39.89%,1
桃園市,桃園區,0137,528,146,674,15,689,1349,51.07%,39.14%,1
桃園市,桃園區,0138,818,78,896,38,934,1805,51.75%,45.32%,1
桃園市,桃園區,0139,677,180,857,70,927,1846,50.22%,36.67%,1
桃園市,桃園區,0140,568,158,726,46,772,1644,46.96%,34.55%,1
桃園市,桃園區,0141,584,163,747,57,804,1674,48.03%,34.89%,1
桃園市,桃園區,0142,635,202,837,47,884,1737,50.89%,36.56%,1
桃園市,桃園區,0143,594,186,780,54,834,1566,53.26%,37.93%,1
桃園市,桃園區,0144,623,163,786,41,827,1517,54.52%,41.07%,1
桃園市,桃園區,0145,566,146,712,34,746,1619,46.08%,34.96%,1
桃園市,桃園區,0146,636,245,881,27,908,1774,51.18%,35.85%,1
桃園市,桃園區,0147,687,148,835,35,870,1666,52.22%,41.24%,1
桃園市,桃園區,0148,608,160,768,26,794,1528,51.96%,39.79%,1
桃園市,桃園區,0149,644,198,842,43,885,1709,51.78%,37.68%,1
桃園市,桃園區,0150,659,167,826,34,860,1719,50.03%,38.34%,1
桃園市,桃園區,0151,531,150,681,50,731,1569,46.59%,33.84%,1
桃園市,桃園區,0152,558,149,707,36,743,1505,49.37%,37.08%,1
桃園市,桃園區,0153,547,160,707,48,755,1496,50.47%,36.56%,1
桃園市,桃園區,0154,622,140,762,40,802,1505,53.29%,41.33%,1
桃園市,桃園區,0155,699,165,864,45,909,1807,50.3%,38.68%,1
桃園市,桃園區,0156,727,175,902,44,946,1857,50.94%,39.15%,1
桃園市,桃園區,0157,658,174,832,59,891,1589,56.07%,41.41%,1
桃園市,桃園區,0158,772,224,996,44,1040,2088,49.81%,36.97%,1
桃園市,桃園區,0159,738,173,911,37,948,1893,50.08%,38.99%,1
桃園市,桃園區,0160,437,118,555,37,592,1303,45.43%,33.54%,1
桃園市,桃園區,0161,547,169,716,38,754,1416,53.25%,38.63%,1
桃園市,桃園區,0162,499,130,629,33,662,1351,49%,36.94%,1
桃園市,桃園區,0163,628,143,771,38,809,1659,48.76%,37.85%,1
桃園市,桃園區,0164,790,171,961,49,1010,2103,48.03%,37.57%,1
桃園市,桃園區,0165,721,179,900,58,958,1943,49.31%,37.11%,1
桃園市,桃園區,0166,722,200,922,52,974,1927,50.54%,37.47%,1
桃園市,桃園區,0167,671,151,822,52,874,1929,45.31%,34.78%,1
桃園市,桃園區,0168,930,247,1177,45,1222,2204,55.44%,42.2%,1
桃園市,桃園區,0169,682,217,899,31,930,2033,45.75%,33.55%,1
桃園市,桃園區,0170,670,151,821,20,841,1656,50.79%,40.46%,1
桃園市,桃園區,0171,609,177,786,60,846,1712,49.42%,35.57%,1
桃園市,桃園區,0172,656,172,828,48,876,1738,50.4%,37.74%,1
桃園市,桃園區,0173,718,105,823,23,846,1432,59.08%,50.14%,1
桃園市,桃園區,0174,637,137,774,47,821,1421,57.78%,44.83%,1
桃園市,桃園區,0175,520,145,665,26,691,1344,51.41%,38.69%,1
桃園市,桃園區,0176,686,173,859,41,900,1942,46.34%,35.32%,1
桃園市,桃園區,0177,776,181,957,43,1000,2001,49.98%,38.78%,1
桃園市,桃園區,0178,682,155,837,25,862,1941,44.41%,35.14%,1
桃園市,桃園區,0179,671,180,851,50,901,1702,52.94%,39.42%,1
桃園市,桃園區,0180,624,155,779,42,821,1589,51.67%,39.27%,1
桃園市,桃園區,0181,612,136,748,35,783,1544,50.71%,39.64%,1
桃園市,桃園區,0182,587,158,745,32,777,1860,41.77%,31.56%,1
桃園市,桃園區,0183,639,170,809,58,867,1726,50.23%,37.02%,1
桃園市,桃園區,0184,640,189,829,39,868,1798,48.28%,35.6%,1
桃園市,桃園區,0185,718,206,924,37,961,1925,49.92%,37.3%,1
桃園市,桃園區,0186,679,226,905,42,947,1945,48.69%,34.91%,1
桃園市,桃園區,0187,587,191,778,48,826,1764,46.83%,33.28%,1
桃園市,桃園區,0188,772,197,969,62,1031,1899,54.29%,40.65%,1
桃園市,桃園區,0189,554,137,691,21,712,1415,50.32%,39.15%,1
桃園市,桃園區,0190,660,157,817,33,850,1790,47.49%,36.87%,1
桃園市,桃園區,0191,515,156,671,25,696,1693,41.11%,30.42%,1
桃園市,桃園區,0192,684,188,872,55,927,1916,48.38%,35.7%,1
桃園市,桃園區,0193,483,145,628,31,659,1434,45.96%,33.68%,1
桃園市,桃園區,0194,616,188,804,44,848,1494,56.76%,41.23%,1
桃園市,桃園區,0195,510,155,665,54,719,1311,54.84%,38.9%,1
桃園市,桃園區,0196,542,187,729,42,771,1476,52.24%,36.72%,1
桃園市,桃園區,0197,593,188,781,47,828,1484,55.8%,39.96%,1
桃園市,桃園區,0198,585,143,728,44,772,1514,50.99%,38.64%,1
桃園市,桃園區,0199,568,126,694,60,754,1446,52.14%,39.28%,1
桃園市,桃園區,0200,562,147,709,19,728,1573,46.28%,35.73%,1
桃園市,桃園區,0201,552,132,684,39,723,1564,46.23%,35.29%,1
桃園市,桃園區,0202,405,124,529,40,569,1015,56.06%,39.9%,1
桃園市,桃園區,0203,383,91,474,26,500,955,52.36%,40.1%,1
桃園市,桃園區,0204,690,165,855,41,896,1796,49.89%,38.42%,1
桃園市,桃園區,0205,750,157,907,29,936,1878,49.84%,39.94%,1
桃園市,桃園區,0206,629,176,805,40,845,1729,48.87%,36.38%,1
桃園市,桃園區,0207,641,151,792,26,818,1843,44.38%,34.78%,1
桃園市,桃園區,0208,608,140,748,34,782,1817,43.04%,33.46%,1
桃園市,桃園區,0209,387,129,516,35,551,979,56.28%,39.53%,1
桃園市,桃園區,0210,552,137,689,30,719,1363,52.75%,40.5%,1
桃園市,桃園區,0211,626,118,744,13,757,1546,48.97%,40.49%,1
桃園市,桃園區,0212,514,111,625,32,657,1308,50.23%,39.3%,1
桃園市,桃園區,0213,807,200,1007,62,1069,2164,49.4%,37.29%,1
桃園市,桃園區,0214,705,216,921,48,969,2020,47.97%,34.9%,1
桃園市,桃園區,0215,661,146,807,46,853,1924,44.33%,34.36%,1
桃園市,桃園區,0216,701,159,860,44,904,2088,43.3%,33.57%,1
桃園市,中壢區,0591,605,85,690,45,735,1401,52.46%,43.18%,1
桃園市,中壢區,0592,666,188,854,46,900,1798,50.06%,37.04%,1
桃園市,中壢區,0593,579,146,725,47,772,1642,47.02%,35.26%,1
桃園市,中壢區,0594,666,173,839,44,883,1670,52.87%,39.88%,1
桃園市,中壢區,0595,606,164,770,21,791,1456,54.33%,41.62%,1
桃園市,中壢區,0596,721,144,865,51,916,1531,59.83%,47.09%,1
桃園市,中壢區,0597,738,153,891,41,932,1623,57.42%,45.47%,1
桃園市,中壢區,0598,729,131,860,34,894,1953,45.78%,37.33%,1
桃園市,中壢區,0599,520,114,634,23,657,1155,56.88%,45.02%,1
桃園市,中壢區,0600,669,135,804,42,846,1800,47%,37.17%,1
桃園市,中壢區,0601,697,121,818,33,851,1757,48.43%,39.67%,1
桃園市,中壢區,0602,580,130,710,47,757,1281,59.09%,45.28%,1
桃園市,中壢區,0603,638,159,797,31,828,1462,56.63%,43.64%,1
桃園市,中壢區,0604,585,133,718,54,772,1560,49.49%,37.5%,1
桃園市,中壢區,0605,722,170,892,33,925,1602,57.74%,45.07%,1
桃園市,中壢區,0606,502,114,616,29,645,1006,64.12%,49.9%,1
桃園市,中壢區,0607,655,137,792,25,817,1474,55.43%,44.44%,1
桃園市,中壢區,0608,664,156,820,68,888,1627,54.58%,40.81%,1
桃園市,中壢區,0609,650,171,821,38,859,1519,56.55%,42.79%,1
桃園市,中壢區,0610,639,140,779,70,849,1526,55.64%,41.87%,1
桃園市,中壢區,0611,688,119,807,66,873,1618,53.96%,42.52%,1
桃園市,中壢區,0612,720,133,853,50,903,1554,58.11%,46.33%,1
桃園市,中壢區,0613,739,120,859,70,929,1706,54.45%,43.32%,1
桃園市,中壢區,0614,817,170,987,36,1023,1818,56.27%,44.94%,1
桃園市,中壢區,0615,875,53,928,39,967,1991,48.57%,43.95%,1
桃園市,中壢區,0616,691,117,808,31,839,1609,52.14%,42.95%,1
桃園市,中壢區,0617,540,76,616,17,633,1329,47.63%,40.63%,1
桃園市,中壢區,0618,603,126,729,63,792,1587,49.91%,38%,1
桃園市,中壢區,0619,800,162,962,32,994,1955,50.84%,40.92%,1
桃園市,中壢區,0620,657,188,845,38,883,1711,51.61%,38.4%,1
桃園市,中壢區,0621,672,150,822,49,871,1712,50.88%,39.25%,1
桃園市,中壢區,0622,657,134,791,43,834,1448,57.6%,45.37%,1
桃園市,中壢區,0623,631,147,778,40,818,1605,50.97%,39.31%,1
桃園市,中壢區,0624,601,137,738,14,752,1633,46.05%,36.8%,1
桃園市,中壢區,0625,805,158,963,53,1016,1795,56.6%,44.85%,1
桃園市,中壢區,0626,725,159,884,30,914,1689,54.11%,42.92%,1
桃園市,中壢區,0627,607,30,637,33,670,1201,55.79%,50.54%,1
桃園市,中壢區,0628,537,138,675,34,709,1353,52.4%,39.69%,1
桃園市,中壢區,0629,625,138,763,32,795,1587,50.09%,39.38%,1
桃園市,中壢區,0630,786,170,956,50,1006,1883,53.43%,41.74%,1
桃園市,中壢區,0631,556,159,715,32,747,1448,51.59%,38.4%,1
桃園市,中壢區,0632,765,156,921,33,954,1810,52.71%,42.27%,1
桃園市,中壢區,0633,744,177,921,59,980,1916,51.15%,38.83%,1
桃園市,中壢區,0634,523,126,649,21,670,1177,56.92%,44.44%,1
桃園市,中壢區,0635,625,168,793,39,832,1410,59.01%,44.33%,1
桃園市,中壢區,0636,553,137,690,18,708,1368,51.75%,40.42%,1
桃園市,中壢區,0637,664,150,814,45,859,1424,60.32%,46.63%,1
桃園市,中壢區,0638,687,157,844,34,878,1573,55.82%,43.67%,1
桃園市,中壢區,0639,491,123,614,28,642,1152,55.73%,42.62%,1
桃園市,中壢區,0640,484,139,623,10,633,1178,53.74%,41.09%,1
桃園市,中壢區,0641,773,198,971,59,1030,1966,52.39%,39.32%,1
桃園市,中壢區,0642,546,131,677,30,707,3474,20.35%,15.72%,1
桃園市,中壢區,0643,865,204,1069,52,1121,2099,53.41%,41.21%,1
桃園市,中壢區,0644,183,419,602,37,639,1178,54.24%,15.53%,1
桃園市,中壢區,0645,640,166,806,51,857,1397,61.35%,45.81%,1
桃園市,中壢區,0646,681,182,863,58,921,1669,55.18%,40.8%,1
桃園市,中壢區,0647,796,168,964,52,1016,2087,48.68%,38.14%,1
桃園市,中壢區,0648,734,192,926,46,972,1900,51.16%,38.63%,1
桃園市,中壢區,0649,562,121,683,24,707,1640,43.11%,34.27%,1
桃園市,中壢區,0650,469,99,568,27,595,994,59.86%,47.18%,1
桃園市,中壢區,0651,581,99,680,49,729,1131,64.46%,51.37%,1
桃園市,中壢區,0652,745,166,911,43,954,1625,58.71%,45.85%,1
桃園市,中壢區,0653,640,182,822,36,858,1384,61.99%,46.24%,1
桃園市,中壢區,0654,652,155,807,46,853,1588,53.72%,41.06%,1
桃園市,中壢區,0655,631,119,750,32,782,1445,54.12%,43.67%,1
桃園市,中壢區,0656,618,132,750,43,793,1743,45.5%,35.46%,1
桃園市,中壢區,0657,697,122,819,33,852,1812,47.02%,38.47%,1
桃園市,中壢區,0658,607,129,736,54,790,1546,51.1%,39.26%,1
桃園市,中壢區,0659,537,110,647,42,689,1290,53.41%,41.63%,1
桃園市,中壢區,0660,798,159,957,83,1040,2145,48.48%,37.2%,1
桃園市,中壢區,0661,544,135,679,38,717,1451,49.41%,37.49%,1
桃園市,中壢區,0662,628,121,749,32,781,1489,52.45%,42.18%,1
桃園市,中壢區,0663,367,67,434,24,458,827,55.38%,44.38%,1
桃園市,中壢區,0664,606,103,709,30,739,1442,51.25%,42.02%,1
桃園市,中壢區,0665,681,147,828,16,844,1842,45.82%,36.97%,1
桃園市,中壢區,0666,569,112,681,21,702,1520,46.18%,37.43%,1
桃園市,中壢區,0667,637,136,773,40,813,1764,46.09%,36.11%,1
桃園市,中壢區,0668,659,139,798,25,823,1488,55.31%,44.29%,1
桃園市,中壢區,0669,649,154,803,42,845,1593,53.04%,40.74%,1
桃園市,中壢區,0670,641,132,773,30,803,1505,53.36%,42.59%,1
桃園市,中壢區,0671,673,144,817,28,845,1661,50.87%,40.52%,1
桃園市,中壢區,0672,666,125,791,26,817,1492,54.76%,44.64%,1
桃園市,中壢區,0673,467,119,586,30,616,1249,49.32%,37.39%,1
桃園市,中壢區,0674,560,118,678,26,704,1257,56.01%,44.55%,1
桃園市,中壢區,0675,639,156,795,68,863,1659,52.02%,38.52%,1
桃園市,中壢區,0676,787,144,931,62,993,1815,54.71%,43.36%,1
桃園市,中壢區,0677,673,143,816,39,855,1702,50.24%,39.54%,1
桃園市,中壢區,0678,629,156,785,21,806,1541,52.3%,40.82%,1
桃園市,中壢區,0679,663,122,785,34,819,1659,49.37%,39.96%,1
桃園市,中壢區,0680,753,131,884,81,965,1874,51.49%,40.18%,1
桃園市,中壢區,0681,646,116,762,39,801,1603,49.97%,40.3%,1
桃園市,中壢區,0682,676,163,839,39,878,1735,50.61%,38.96%,1
桃園市,中壢區,0683,723,158,881,19,900,1815,49.59%,39.83%,1
桃園市,中壢區,0684,610,183,793,34,827,1873,44.15%,32.57%,1
桃園市,中壢區,0685,773,142,915,51,966,1739,55.55%,44.45%,1
桃園市,中壢區,0686,675,128,803,31,834,1709,48.8%,39.5%,1
桃園市,中壢區,0687,701,175,876,36,912,1655,55.11%,42.36%,1
桃園市,中壢區,0688,724,114,838,43,881,1664,52.94%,43.51%,1
桃園市,中壢區,0689,405,83,488,25,513,1087,47.19%,37.26%,1
桃園市,中壢區,0690,456,98,554,49,603,1065,56.62%,42.82%,1
桃園市,中壢區,0691,745,172,917,76,993,1844,53.85%,40.4%,1
桃園市,中壢區,0692,442,89,531,45,576,1220,47.21%,36.23%,1
桃園市,中壢區,0693,497,125,622,31,653,1219,53.57%,40.77%,1
桃園市,中壢區,0694,513,132,645,48,693,1260,55%,40.71%,1
桃園市,中壢區,0695,673,185,858,69,927,1594,58.16%,42.22%,1
桃園市,中壢區,0696,673,192,865,73,938,1733,54.13%,38.83%,1
桃園市,中壢區,0697,830,155,985,53,1038,1979,52.45%,41.94%,1
桃園市,中壢區,0698,661,161,822,22,844,1621,52.07%,40.78%,1
桃園市,中壢區,0699,577,162,739,36,775,1391,55.72%,41.48%,1
桃園市,中壢區,0700,675,134,809,29,838,1531,54.74%,44.09%,1
桃園市,中壢區,0701,733,158,891,43,934,1943,48.07%,37.73%,1
桃園市,中壢區,0702,579,116,695,19,714,1363,52.38%,42.48%,1
桃園市,中壢區,0703,769,162,931,57,988,2172,45.49%,35.41%,1
桃園市,中壢區,0704,730,109,839,40,879,1798,48.89%,40.6%,1
桃園市,中壢區,0705,663,143,806,18,824,1671,49.31%,39.68%,1
桃園市,中壢區,0706,764,167,931,40,971,1969,49.31%,38.8%,1
桃園市,中壢區,0707,777,161,938,47,985,1563,63.02%,49.71%,1
桃園市,中壢區,0708,784,149,933,40,973,1762,55.22%,44.49%,1
桃園市,中壢區,0709,651,114,765,45,810,1923,42.12%,33.85%,1
桃園市,中壢區,0710,678,154,832,64,896,1572,57%,43.13%,1
桃園市,中壢區,0711,795,176,971,41,1012,1850,54.7%,42.97%,1
桃園市,中壢區,0712,635,126,761,56,817,1583,51.61%,40.11%,1
桃園市,中壢區,0713,648,191,839,50,889,1735,51.24%,37.35%,1
桃園市,中壢區,0714,520,115,635,36,671,1292,51.93%,40.25%,1
桃園市,中壢區,0715,528,107,635,21,656,1265,51.86%,41.74%,1
桃園市,中壢區,0716,663,198,861,36,897,1798,49.89%,36.87%,1
桃園市,中壢區,0717,812,176,988,51,1039,1822,57.03%,44.57%,1
桃園市,中壢區,0718,661,163,824,20,844,1613,52.32%,40.98%,1
桃園市,中壢區,0719,580,145,725,31,756,1405,53.81%,41.28%,1
桃園市,中壢區,0720,708,204,912,62,974,1730,56.3%,40.92%,1
桃園市,中壢區,0721,672,122,794,34,828,1384,59.83%,48.55%,1
桃園市,中壢區,0722,475,133,608,19,627,1122,55.88%,42.34%,1
桃園市,中壢區,0723,460,110,570,32,602,992,60.69%,46.37%,1
桃園市,中壢區,0724,698,180,878,42,920,1820,50.55%,38.35%,1
桃園市,中壢區,0725,723,162,885,47,932,1847,50.46%,39.14%,1
桃園市,中壢區,0726,584,125,709,53,762,1302,58.53%,44.85%,1
桃園市,中壢區,0727,531,121,652,33,685,1203,56.94%,44.14%,1
桃園市,中壢區,0728,587,157,744,16,760,1226,61.99%,47.88%,1
桃園市,中壢區,0729,550,132,682,44,726,1234,58.83%,44.57%,1
桃園市,中壢區,0730,762,141,903,50,953,2023,47.11%,37.67%,1
桃園市,中壢區,0731,582,136,718,16,734,1555,47.2%,37.43%,1
桃園市,中壢區,0732,726,196,922,57,979,1951,50.18%,37.21%,1
桃園市,中壢區,0733,609,142,751,49,800,1383,57.85%,44.03%,1
桃園市,中壢區,0734,524,133,657,48,705,1164,60.57%,45.02%,1
桃園市,中壢區,0735,643,141,784,27,811,1482,54.72%,43.39%,1
桃園市,中壢區,0736,701,200,901,48,949,1770,53.62%,39.6%,1
桃園市,中壢區,0737,731,194,925,66,991,1703,58.19%,42.92%,1
桃園市,中壢區,0738,733,169,902,67,969,1841,52.63%,39.82%,1
桃園市,中壢區,0739,830,191,1021,40,1061,1941,54.66%,42.76%,1
桃園市,中壢區,0740,890,186,1076,42,1118,2029,55.1%,43.86%,1
桃園市,中壢區,0741,716,152,868,30,898,1636,54.89%,43.77%,1
桃園市,中壢區,0742,692,155,847,23,870,1528,56.94%,45.29%,1
桃園市,中壢區,0743,810,211,1021,82,1103,2289,48.19%,35.39%,1
桃園市,中壢區,0744,738,200,938,52,990,2020,49.01%,36.53%,1
桃園市,中壢區,0745,826,175,1001,50,1051,2027,51.85%,40.75%,1
桃園市,中壢區,0746,650,154,804,27,831,1883,44.13%,34.52%,1
桃園市,中壢區,0747,798,183,981,46,1027,2080,49.38%,38.37%,1
桃園市,中壢區,0748,242,69,311,15,326,646,50.46%,37.46%,1
桃園市,中壢區,0749,847,211,1058,55,1113,1780,62.53%,47.58%,1
桃園市,中壢區,0750,622,128,750,23,773,1372,56.34%,45.34%,1
桃園市,中壢區,0751,699,207,906,42,948,1668,56.83%,41.91%,1
桃園市,中壢區,0752,779,166,945,47,992,1987,49.92%,39.2%,1
桃園市,中壢區,0753,622,163,785,24,809,1520,53.22%,40.92%,1
桃園市,中壢區,0754,329,99,428,35,463,852,54.34%,38.62%,1
桃園市,中壢區,0755,501,120,621,43,664,1209,54.92%,41.44%,1
桃園市,中壢區,0756,581,141,722,72,794,1481,53.61%,39.23%,1
桃園市,中壢區,0757,594,125,719,20,739,1564,47.25%,37.98%,1
桃園市,中壢區,0758,800,205,1005,55,1060,1957,54.16%,40.88%,1
桃園市,中壢區,0759,519,163,682,57,739,1223,60.43%,42.44%,1
桃園市,中壢區,0760,487,146,633,35,668,1182,56.51%,41.2%,1
桃園市,中壢區,0761,460,129,589,39,628,1066,58.91%,43.15%,1
桃園市,中壢區,0762,732,173,905,56,961,1701,56.5%,43.03%,1
桃園市,中壢區,0763,367,101,468,33,501,943,53.13%,38.92%,1
桃園市,中壢區,0764,325,87,412,30,442,731,60.47%,44.46%,1
桃園市,中壢區,0765,365,88,453,33,486,851,57.11%,42.89%,1
桃園市,中壢區,0766,388,118,506,40,546,1011,54.01%,38.38%,1
桃園市,中壢區,0767,617,170,787,44,831,1532,54.24%,40.27%,1
桃園市,中壢區,0768,423,90,513,48,561,1028,54.57%,41.15%,1
桃園市,中壢區,0769,484,149,633,39,672,1157,58.08%,41.83%,1
桃園市,中壢區,0770,600,198,798,42,840,1591,52.8%,37.71%,1
桃園市,中壢區,0771,780,190,970,51,1021,2156,47.36%,36.18%,1
桃園市,中壢區,0772,514,129,643,29,672,1479,45.44%,34.75%,1
桃園市,中壢區,0773,726,160,886,40,926,1780,52.02%,40.79%,1
桃園市,中壢區,0774,680,155,835,55,890,1651,53.91%,41.19%,1
桃園市,中壢區,0775,744,207,951,38,989,1870,52.89%,39.79%,1
桃園市,中壢區,0776,681,155,836,33,869,1913,45.43%,35.6%,1
桃園市,中壢區,0777,573,141,714,32,746,1609,46.36%,35.61%,1
桃園市,中壢區,0778,587,143,730,30,760,1539,49.38%,38.14%,1
桃園市,中壢區,0779,550,167,717,40,757,1426,53.09%,38.57%,1
桃園市,中壢區,0780,578,163,741,28,769,1618,47.53%,35.72%,1
桃園市,中壢區,0781,571,161,732,52,784,1441,54.41%,39.63%,1
桃園市,中壢區,0782,660,148,808,35,843,1528,55.17%,43.19%,1
桃園市,中壢區,0783,640,191,831,52,883,1683,52.47%,38.03%,1
桃園市,中壢區,0784,796,205,1001,73,1074,1945,55.22%,40.93%,1
桃園市,中壢區,0785,570,181,751,58,809,1534,52.74%,37.16%,1
桃園市,中壢區,0786,662,185,847,63,910,1810,50.28%,36.57%,1
桃園市,中壢區,0787,393,124,517,45,562,1097,51.23%,35.82%,1
桃園市,中壢區,0788,714,188,902,31,933,1917,48.67%,37.25%,1
桃園市,中壢區,0789,707,197,904,49,953,1858,51.29%,38.05%,1
桃園市,中壢區,0790,649,161,810,32,842,1576,53.43%,41.18%,1
桃園市,中壢區,0791,611,183,794,30,824,1478,55.75%,41.34%,1
桃園市,中壢區,0792,610,193,803,37,840,1589,52.86%,38.39%,1
桃園市,中壢區,0793,785,242,1027,87,1114,2037,54.69%,38.54%,1
桃園市,中壢區,0794,519,134,653,43,696,1158,60.1%,44.82%,1
桃園市,中壢區,0795,764,230,994,66,1060,1967,53.89%,38.84%,1
桃園市,中壢區,0796,682,170,852,72,924,1830,50.49%,37.27%,1
桃園市,中壢區,0797,640,196,836,69,905,1856,48.76%,34.48%,1
桃園市,中壢區,0798,797,162,959,86,1045,2068,50.53%,38.54%,1
桃園市,中壢區,0799,674,175,849,44,893,2152,41.5%,31.32%,1
桃園市,中壢區,0800,730,203,933,55,988,2158,45.78%,33.83%,1
桃園市,大溪區,0522,555,208,763,62,825,1477,55.86%,37.58%,1
桃園市,大溪區,0523,382,118,500,43,543,1006,53.98%,37.97%,1
桃園市,大溪區,0524,569,170,739,77,816,1553,52.54%,36.64%,1
桃園市,大溪區,0525,614,180,794,71,865,1597,54.16%,38.45%,1
桃園市,大溪區,0526,536,137,673,58,731,1358,53.83%,39.47%,1
桃園市,大溪區,0527,549,151,700,50,750,1585,47.32%,34.64%,1
桃園市,大溪區,0528,616,176,792,43,835,1612,51.8%,38.21%,1
桃園市,大溪區,0529,558,129,687,17,704,1555,45.27%,35.88%,1
桃園市,大溪區,0530,539,173,712,62,774,1282,60.37%,42.04%,1
桃園市,大溪區,0531,543,130,673,59,732,1392,52.59%,39.01%,1
桃園市,大溪區,0532,501,163,664,54,718,1422,50.49%,35.23%,1
桃園市,大溪區,0533,573,152,725,63,788,1448,54.42%,39.57%,1
桃園市,大溪區,0534,551,167,718,56,774,1269,60.99%,43.42%,1
桃園市,大溪區,0535,379,144,523,68,591,977,60.49%,38.79%,1
桃園市,大溪區,0536,535,181,716,37,753,1359,55.41%,39.37%,1
桃園市,大溪區,0537,465,161,626,64,690,1135,60.79%,40.97%,1
桃園市,大溪區,0538,239,78,317,35,352,660,53.33%,36.21%,1
桃園市,大溪區,0539,376,108,484,38,522,1056,49.43%,35.61%,1
桃園市,大溪區,0540,494,104,598,52,650,1263,51.46%,39.11%,1
桃園市,大溪區,0541,279,81,360,36,396,717,55.23%,38.91%,1
桃園市,大溪區,0542,367,139,506,20,526,1299,40.49%,28.25%,1
桃園市,大溪區,0543,391,102,493,46,539,976,55.23%,40.06%,1
桃園市,大溪區,0544,351,108,459,45,504,938,53.73%,37.42%,1
桃園市,大溪區,0545,287,86,373,33,406,832,48.8%,34.5%,1
桃園市,大溪區,0546,289,73,362,24,386,866,44.57%,33.37%,1
桃園市,大溪區,0547,217,80,297,35,332,694,47.84%,31.27%,1
桃園市,大溪區,0548,442,177,619,40,659,1410,46.74%,31.35%,1
桃園市,大溪區,0549,455,133,588,58,646,1303,49.58%,34.92%,1
桃園市,大溪區,0550,452,102,554,35,589,1125,52.36%,40.18%,1
桃園市,大溪區,0551,495,105,600,36,636,1170,54.36%,42.31%,1
桃園市,大溪區,0552,563,155,718,43,761,1308,58.18%,43.04%,1
桃園市,大溪區,0553,433,131,564,55,619,1094,56.58%,39.58%,1
桃園市,大溪區,0554,920,164,1084,61,1145,2153,53.18%,42.73%,1
桃園市,大溪區,0555,564,71,635,43,678,1173,57.8%,48.08%,1
桃園市,大溪區,0556,556,124,680,25,705,1369,51.5%,40.61%,1
桃園市,大溪區,0557,572,117,689,55,744,1446,51.45%,39.56%,1
桃園市,大溪區,0558,495,81,576,50,626,1406,44.52%,35.21%,1
桃園市,大溪區,0559,687,143,830,29,859,1592,53.96%,43.15%,1
桃園市,大溪區,0560,612,168,780,71,851,1497,56.85%,40.88%,1
桃園市,大溪區,0561,653,167,820,92,912,1559,58.5%,41.89%,1
桃園市,大溪區,0562,649,152,801,23,824,1684,48.93%,38.54%,1
桃園市,大溪區,0563,844,79,923,58,981,1959,50.08%,43.08%,1
桃園市,大溪區,0564,560,143,703,74,777,1369,56.76%,40.91%,1
桃園市,大溪區,0565,592,136,728,66,794,1431,55.49%,41.37%,1
桃園市,大溪區,0566,494,129,623,25,648,1657,39.11%,29.81%,1
桃園市,大溪區,0567,441,126,567,30,597,1387,43.04%,31.8%,1
桃園市,大溪區,0568,423,102,525,42,567,1085,52.26%,38.99%,1
桃園市,大溪區,0569,599,140,739,52,791,1403,56.38%,42.69%,1
桃園市,大溪區,0570,545,151,696,88,784,1511,51.89%,36.07%,1
桃園市,大溪區,0571,534,178,712,85,797,1719,46.36%,31.06%,1
桃園市,大溪區,0572,541,166,707,84,791,1717,46.07%,31.51%,1
桃園市,大溪區,0573,458,124,582,68,650,1207,53.85%,37.95%,1
桃園市,大溪區,0574,511,94,605,67,672,1188,56.57%,43.01%,1
桃園市,大溪區,0575,528,148,676,29,705,1514,46.57%,34.87%,1
桃園市,大溪區,0576,646,144,790,66,856,1529,55.98%,42.25%,1
桃園市,大溪區,0577,574,121,695,45,740,1260,58.73%,45.56%,1
桃園市,大溪區,0578,357,95,452,19,471,831,56.68%,42.96%,1
桃園市,大溪區,0579,584,146,730,47,777,1407,55.22%,41.51%,1
桃園市,大溪區,0580,524,132,656,65,721,1494,48.26%,35.07%,1
桃園市,楊梅區,0926,526,131,657,50,707,1269,55.71%,41.45%,1
桃園市,楊梅區,0927,599,125,724,42,766,1246,61.48%,48.07%,1
桃園市,楊梅區,0928,657,129,786,34,820,1408,58.24%,46.66%,1
桃園市,楊梅區,0929,601,144,745,55,800,1434,55.79%,41.91%,1
桃園市,楊梅區,0930,601,122,723,45,768,1515,50.69%,39.67%,1
桃園市,楊梅區,0931,615,140,755,43,798,1657,48.16%,37.12%,1
桃園市,楊梅區,0932,523,104,627,24,651,1137,57.26%,46%,1
桃園市,楊梅區,0933,884,179,1063,36,1099,2211,49.71%,39.98%,1
桃園市,楊梅區,0934,771,189,960,31,991,2008,49.35%,38.4%,1
桃園市,楊梅區,0935,793,190,983,36,1019,1911,53.32%,41.5%,1
桃園市,楊梅區,0936,598,168,766,48,814,1449,56.18%,41.27%,1
桃園市,楊梅區,0937,653,159,812,53,865,1877,46.08%,34.79%,1
桃園市,楊梅區,0938,725,173,898,56,954,1988,47.99%,36.47%,1
桃園市,楊梅區,0939,791,168,959,28,987,1931,51.11%,40.96%,1
桃園市,楊梅區,0940,760,158,918,31,949,1938,48.97%,39.22%,1
桃園市,楊梅區,0941,742,115,857,25,882,1677,52.59%,44.25%,1
桃園市,楊梅區,0942,733,157,890,32,922,1848,49.89%,39.66%,1
桃園市,楊梅區,0943,742,171,913,31,944,1882,50.16%,39.43%,1
桃園市,楊梅區,0944,479,103,582,21,603,1541,39.13%,31.08%,1
桃園市,楊梅區,0945,748,152,900,37,937,1938,48.35%,38.6%,1
桃園市,楊梅區,0946,554,111,665,16,681,1562,43.6%,35.47%,1
桃園市,楊梅區,0947,886,238,1124,56,1180,2125,55.53%,41.69%,1
桃園市,楊梅區,0948,692,155,847,41,888,1516,58.58%,45.65%,1
桃園市,楊梅區,0949,700,160,860,29,889,1807,49.2%,38.74%,1
桃園市,楊梅區,0950,744,205,949,41,990,2101,47.12%,35.41%,1
桃園市,楊梅區,0951,940,84,1024,47,1071,2054,52.14%,45.76%,1
桃園市,楊梅區,0952,852,146,998,30,1028,2226,46.18%,38.27%,1
桃園市,楊梅區,0953,602,127,729,13,742,1405,52.81%,42.85%,1
桃園市,楊梅區,0954,661,170,831,42,873,1843,47.37%,35.87%,1
桃園市,楊梅區,0955,796,186,982,53,1035,2324,44.54%,34.25%,1
桃園市,楊梅區,0956,802,48,850,25,875,1713,51.08%,46.82%,1
桃園市,楊梅區,0957,737,149,886,49,935,1587,58.92%,46.44%,1
桃園市,楊梅區,0958,622,129,751,24,775,1416,54.73%,43.93%,1
桃園市,楊梅區,0959,699,141,840,31,871,1591,54.75%,43.93%,1
桃園市,楊梅區,0960,770,182,952,49,1001,1943,51.52%,39.63%,1
桃園市,楊梅區,0961,704,169,873,33,906,1762,51.42%,39.95%,1
桃園市,楊梅區,0962,442,105,547,26,573,1083,52.91%,40.81%,1
桃園市,楊梅區,0963,809,188,997,53,1050,2027,51.8%,39.91%,1
桃園市,楊梅區,0964,535,137,672,57,729,1274,57.22%,41.99%,1
桃園市,楊梅區,0965,608,124,732,49,781,1359,57.47%,44.74%,1
桃園市,楊梅區,0966,648,157,805,56,861,2444,35.23%,26.51%,1
桃園市,楊梅區,0967,806,169,975,29,1004,2298,43.69%,35.07%,1
桃園市,楊梅區,0968,848,198,1046,41,1087,2222,48.92%,38.16%,1
桃園市,楊梅區,0969,638,149,787,59,846,1610,52.55%,39.63%,1
桃園市,楊梅區,0970,638,146,784,81,865,1627,53.17%,39.21%,1
桃園市,楊梅區,0971,653,160,813,51,864,1589,54.37%,41.1%,1
桃園市,楊梅區,0972,700,160,860,75,935,1758,53.19%,39.82%,1
桃園市,楊梅區,0973,595,145,740,47,787,1776,44.31%,33.5%,1
桃園市,楊梅區,0974,366,81,447,23,470,1000,47%,36.6%,1
桃園市,楊梅區,0975,811,166,977,73,1050,2290,45.85%,35.41%,1
桃園市,楊梅區,0976,631,145,776,42,818,1551,52.74%,40.68%,1
桃園市,楊梅區,0977,706,148,854,66,920,1861,49.44%,37.94%,1
桃園市,楊梅區,0978,394,105,499,38,537,1141,47.06%,34.53%,1
桃園市,楊梅區,0979,676,143,819,43,862,1785,48.29%,37.87%,1
桃園市,楊梅區,0980,601,141,742,57,799,1498,53.34%,40.12%,1
桃園市,楊梅區,0981,346,235,581,41,622,1187,52.4%,29.15%,1
桃園市,楊梅區,0982,522,131,653,55,708,1270,55.75%,41.1%,1
桃園市,楊梅區,0983,601,113,714,41,755,1424,53.02%,42.21%,1
桃園市,楊梅區,0984,620,27,647,23,670,1273,52.63%,48.7%,1
桃園市,楊梅區,0985,500,161,661,27,688,1534,44.85%,32.59%,1
桃園市,楊梅區,0986,592,163,755,60,815,1783,45.71%,33.2%,1
桃園市,楊梅區,0987,680,108,788,21,809,1709,47.34%,39.79%,1
桃園市,楊梅區,0988,672,153,825,59,884,1920,46.04%,35%,1
桃園市,楊梅區,0989,487,109,596,29,625,1194,52.35%,40.79%,1
桃園市,楊梅區,0990,591,135,726,19,745,1408,52.91%,41.97%,1
桃園市,楊梅區,0991,608,127,735,32,767,1737,44.16%,35%,1
桃園市,楊梅區,0992,759,149,908,32,940,1920,48.96%,39.53%,1
桃園市,楊梅區,0993,483,140,623,32,655,1234,53.08%,39.14%,1
桃園市,楊梅區,0994,617,162,779,50,829,1491,55.6%,41.38%,1
桃園市,楊梅區,0995,715,178,893,52,945,2020,46.78%,35.4%,1
桃園市,楊梅區,0996,647,155,802,32,834,1863,44.77%,34.73%,1
桃園市,楊梅區,0997,671,149,820,55,875,1692,51.71%,39.66%,1
桃園市,楊梅區,0998,673,149,822,28,850,1686,50.42%,39.92%,1
桃園市,楊梅區,0999,659,175,834,53,887,1626,54.55%,40.53%,1
桃園市,楊梅區,1000,695,131,826,17,843,1557,54.14%,44.64%,1
桃園市,楊梅區,1001,711,166,877,51,928,1603,57.89%,44.35%,1
桃園市,楊梅區,1002,700,160,860,69,929,1889,49.18%,37.06%,1
桃園市,楊梅區,1003,623,140,763,30,793,1448,54.77%,43.02%,1
桃園市,楊梅區,1004,578,142,720,44,764,1351,56.55%,42.78%,1
桃園市,楊梅區,1005,580,126,706,55,761,1313,57.96%,44.17%,1
桃園市,楊梅區,1006,650,192,842,33,875,1689,51.81%,38.48%,1
桃園市,楊梅區,1007,722,182,904,30,934,2063,45.27%,35%,1
桃園市,蘆竹區,0396,462,164,626,75,701,1358,51.62%,34.02%,1
桃園市,蘆竹區,0397,493,192,685,85,770,1538,50.07%,32.05%,1
桃園市,蘆竹區,0398,646,169,815,62,877,2118,41.41%,30.5%,1
桃園市,蘆竹區,0399,688,180,868,61,929,1673,55.53%,41.12%,1
桃園市,蘆竹區,0400,578,170,748,30,778,1500,51.87%,38.53%,1
桃園市,蘆竹區,0401,669,190,859,47,906,1699,53.33%,39.38%,1
桃園市,蘆竹區,0402,882,199,1081,59,1140,2250,50.67%,39.2%,1
桃園市,蘆竹區,0403,805,206,1011,24,1035,2354,43.97%,34.2%,1
桃園市,蘆竹區,0404,491,131,622,24,646,1446,44.67%,33.96%,1
桃園市,蘆竹區,0405,548,151,699,54,753,1623,46.4%,33.76%,1
桃園市,蘆竹區,0406,642,141,783,35,818,1747,46.82%,36.75%,1
桃園市,蘆竹區,0407,744,208,952,69,1021,1988,51.36%,37.42%,1
桃園市,蘆竹區,0408,566,146,712,42,754,1437,52.47%,39.39%,1
桃園市,蘆竹區,0409,609,176,785,68,853,1532,55.68%,39.75%,1
桃園市,蘆竹區,0410,541,103,644,46,690,1447,47.68%,37.39%,1
桃園市,蘆竹區,0411,799,233,1032,59,1091,2189,49.84%,36.5%,1
桃園市,蘆竹區,0412,890,101,991,60,1051,2498,42.07%,35.63%,1
桃園市,蘆竹區,0413,499,160,659,28,687,1322,51.97%,37.75%,1
桃園市,蘆竹區,0414,576,183,759,86,845,1991,42.44%,28.93%,1
桃園市,蘆竹區,0415,691,218,909,77,986,2097,47.02%,32.95%,1
桃園市,蘆竹區,0416,649,168,817,30,847,1558,54.36%,41.66%,1
桃園市,蘆竹區,0417,748,199,947,51,998,1891,52.78%,39.56%,1
桃園市,蘆竹區,0418,598,135,733,39,772,1590,48.55%,37.61%,1
桃園市,蘆竹區,0419,798,229,1027,46,1073,2404,44.63%,33.19%,1
桃園市,蘆竹區,0420,945,256,1201,49,1250,2522,49.56%,37.47%,1
桃園市,蘆竹區,0421,648,160,808,34,842,1633,51.56%,39.68%,1
桃園市,蘆竹區,0422,661,164,825,51,876,1715,51.08%,38.54%,1
桃園市,蘆竹區,0423,738,206,944,34,978,2215,44.15%,33.32%,1
桃園市,蘆竹區,0424,757,176,933,47,980,2029,48.3%,37.31%,1
桃園市,蘆竹區,0425,642,153,795,41,836,1731,48.3%,37.09%,1
桃園市,蘆竹區,0426,717,171,888,36,924,1820,50.77%,39.4%,1
桃園市,蘆竹區,0427,656,147,803,72,875,1633,53.58%,40.17%,1
桃園市,蘆竹區,0428,523,164,687,20,707,1668,42.39%,31.35%,1
桃園市,蘆竹區,0429,653,142,795,31,826,1493,55.32%,43.74%,1
桃園市,蘆竹區,0430,692,200,892,69,961,1864,51.56%,37.12%,1
桃園市,蘆竹區,0431,576,178,754,25,779,1703,45.74%,33.82%,1
桃園市,蘆竹區,0432,682,196,878,33,911,1893,48.12%,36.03%,1
桃園市,蘆竹區,0433,765,226,991,68,1059,1922,55.1%,39.8%,1
桃園市,蘆竹區,0434,561,143,704,32,736,1393,52.84%,40.27%,1
桃園市,蘆竹區,0435,548,147,695,39,734,1338,54.86%,40.96%,1
桃園市,蘆竹區,0436,646,168,814,41,855,1688,50.65%,38.27%,1
桃園市,蘆竹區,0437,521,162,683,68,751,1462,51.37%,35.64%,1
桃園市,蘆竹區,0438,440,146,586,27,613,1232,49.76%,35.71%,1
桃園市,蘆竹區,0439,497,116,613,34,647,1356,47.71%,36.65%,1
桃園市,蘆竹區,0440,542,123,665,48,713,1181,60.37%,45.89%,1
桃園市,蘆竹區,0441,366,119,485,22,507,1199,42.29%,30.53%,1
桃園市,蘆竹區,0442,729,157,886,34,920,1710,53.8%,42.63%,1
桃園市,蘆竹區,0443,545,127,672,38,710,1423,49.89%,38.3%,1
桃園市,蘆竹區,0444,601,174,775,38,813,1522,53.42%,39.49%,1
桃園市,蘆竹區,0445,668,158,826,49,875,1639,53.39%,40.76%,1
桃園市,蘆竹區,0446,782,204,986,40,1026,2055,49.93%,38.05%,1
桃園市,蘆竹區,0447,826,225,1051,37,1088,2178,49.95%,37.92%,1
桃園市,蘆竹區,0448,719,164,883,34,917,1709,53.66%,42.07%,1
桃園市,蘆竹區,0449,699,171,870,43,913,1667,54.77%,41.93%,1
桃園市,蘆竹區,0450,729,184,913,34,947,1745,54.27%,41.78%,1
桃園市,蘆竹區,0451,806,210,1016,53,1069,1967,54.35%,40.98%,1
桃園市,蘆竹區,0452,766,191,957,35,992,1802,55.05%,42.51%,1
桃園市,蘆竹區,0453,992,258,1250,52,1302,2727,47.74%,36.38%,1
桃園市,蘆竹區,0454,660,169,829,34,863,1868,46.2%,35.33%,1
桃園市,蘆竹區,0455,573,159,732,42,774,1537,50.36%,37.28%,1
桃園市,蘆竹區,0456,611,190,801,41,842,1616,52.1%,37.81%,1
桃園市,蘆竹區,0457,609,189,798,56,854,1483,57.59%,41.07%,1
桃園市,蘆竹區,0458,651,142,793,54,847,1689,50.15%,38.54%,1
桃園市,蘆竹區,0459,394,112,506,55,561,1318,42.56%,29.89%,1
桃園市,蘆竹區,0460,501,159,660,98,758,1203,63.01%,41.65%,1
桃園市,蘆竹區,0461,600,169,769,30,799,1771,45.12%,33.88%,1
桃園市,蘆竹區,0462,567,202,769,90,859,1832,46.89%,30.95%,1
桃園市,蘆竹區,0463,593,198,791,98,889,1763,50.43%,33.64%,1
桃園市,蘆竹區,0464,421,152,573,21,594,1497,39.68%,28.12%,1
桃園市,蘆竹區,0465,666,205,871,118,989,1671,59.19%,39.86%,1
桃園市,蘆竹區,0466,363,98,461,72,533,929,57.37%,39.07%,1
桃園市,蘆竹區,0467,561,193,754,115,869,1559,55.74%,35.98%,1
桃園市,蘆竹區,0468,585,128,713,34,747,1497,49.9%,39.08%,1
桃園市,蘆竹區,0469,641,184,825,88,913,1441,63.36%,44.48%,1
桃園市,蘆竹區,0470,535,153,688,49,737,1465,50.31%,36.52%,1
桃園市,蘆竹區,0471,360,124,484,45,529,1029,51.41%,34.99%,1
桃園市,大園區,0472,507,147,654,50,704,1538,45.77%,32.96%,1
桃園市,大園區,0473,464,134,598,29,627,1616,38.8%,28.71%,1
桃園市,大園區,0474,584,188,772,49,821,1437,57.13%,40.64%,1
桃園市,大園區,0475,626,171,797,41,838,1554,53.93%,40.28%,1
桃園市,大園區,0476,470,132,602,37,639,1237,51.66%,38%,1
桃園市,大園區,0477,511,118,629,65,694,1347,51.52%,37.94%,1
桃園市,大園區,0478,456,126,582,27,609,1261,48.3%,36.16%,1
桃園市,大園區,0479,479,114,593,43,636,1256,50.64%,38.14%,1
桃園市,大園區,0480,464,122,586,32,618,1370,45.11%,33.87%,1
桃園市,大園區,0481,541,159,700,44,744,1610,46.21%,33.6%,1
桃園市,大園區,0482,511,151,662,48,710,1419,50.04%,36.01%,1
桃園市,大園區,0483,476,125,601,20,621,1588,39.11%,29.97%,1
桃園市,大園區,0484,608,160,768,38,806,1612,50%,37.72%,1
桃園市,大園區,0485,521,148,669,42,711,1440,49.38%,36.18%,1
桃園市,大園區,0486,480,133,613,33,646,1326,48.72%,36.2%,1
桃園市,大園區,0487,628,141,769,51,820,1455,56.36%,43.16%,1
桃園市,大園區,0488,607,169,776,61,837,1562,53.59%,38.86%,1
桃園市,大園區,0489,543,140,683,30,713,1284,55.53%,42.29%,1
桃園市,大園區,0490,522,141,663,23,686,1454,47.18%,35.9%,1
桃園市,大園區,0491,586,149,735,23,758,1490,50.87%,39.33%,1
桃園市,大園區,0492,511,154,665,46,711,1617,43.97%,31.6%,1
桃園市,大園區,0493,553,157,710,90,800,1594,50.19%,34.69%,1
桃園市,大園區,0494,606,173,779,61,840,1650,50.91%,36.73%,1
桃園市,大園區,0495,502,142,644,20,664,1467,45.26%,34.22%,1
桃園市,大園區,0496,546,160,706,35,741,1494,49.6%,36.55%,1
桃園市,大園區,0497,574,142,716,57,773,1538,50.26%,37.32%,1
桃園市,大園區,0498,511,134,645,22,667,1397,47.75%,36.58%,1
桃園市,大園區,0499,586,149,735,16,751,1637,45.88%,35.8%,1
桃園市,大園區,0500,519,128,647,55,702,1452,48.35%,35.74%,1
桃園市,大園區,0501,588,156,744,46,790,1414,55.87%,41.58%,1
桃園市,大園區,0502,583,179,762,44,806,1670,48.26%,34.91%,1
桃園市,大園區,0503,573,153,726,17,743,1701,43.68%,33.69%,1
桃園市,大園區,0504,528,166,694,40,734,1813,40.49%,29.12%,1
桃園市,大園區,0505,568,150,718,48,766,1687,45.41%,33.67%,1
桃園市,大園區,0506,749,56,805,11,816,1650,49.45%,45.39%,1
桃園市,大園區,0507,651,175,826,48,874,1556,56.17%,41.84%,1
桃園市,大園區,0508,620,157,777,38,815,1844,44.2%,33.62%,1
桃園市,大園區,0509,475,116,591,62,653,1336,48.88%,35.55%,1
桃園市,大園區,0510,537,182,719,66,785,1414,55.52%,37.98%,1
桃園市,大園區,0511,541,146,687,48,735,1238,59.37%,43.7%,1
桃園市,大園區,0512,545,145,690,49,739,1227,60.23%,44.42%,1
桃園市,大園區,0513,424,138,562,20,582,1199,48.54%,35.36%,1
桃園市,大園區,0514,433,38,471,27,498,1349,36.92%,32.1%,1
桃園市,大園區,0515,414,109,523,29,552,1120,49.29%,36.96%,1
桃園市,大園區,0516,407,107,514,31,545,1080,50.46%,37.69%,1
桃園市,大園區,0517,491,131,622,36,658,1341,49.07%,36.61%,1
桃園市,大園區,0518,507,169,676,33,709,1345,52.71%,37.7%,1
桃園市,大園區,0519,548,134,682,43,725,1565,46.33%,35.02%,1
桃園市,大園區,0520,483,151,634,23,657,1519,43.25%,31.8%,1
桃園市,大園區,0521,737,190,927,58,985,2130,46.24%,34.6%,1
桃園市,龜山區,0217,404,61,465,17,482,874,55.15%,46.22%,1
桃園市,龜山區,0218,845,160,1005,66,1071,2014,53.18%,41.96%,1
桃園市,龜山區,0219,810,195,1005,28,1033,2145,48.16%,37.76%,1
桃園市,龜山區,0220,793,97,890,55,945,1744,54.19%,45.47%,1
桃園市,龜山區,0221,821,134,955,56,1011,1885,53.63%,43.55%,1
桃園市,龜山區,0222,562,139,701,54,755,1546,48.84%,36.35%,1
桃園市,龜山區,0223,595,174,769,55,824,1684,48.93%,35.33%,1
桃園市,龜山區,0224,478,156,634,27,661,1477,44.75%,32.36%,1
桃園市,龜山區,0225,669,128,797,56,853,1528,55.82%,43.78%,1
桃園市,龜山區,0226,213,64,277,14,291,1428,20.38%,14.92%,1
桃園市,龜山區,0227,625,154,779,57,836,1525,54.82%,40.98%,1
桃園市,龜山區,0228,430,130,560,45,605,1041,58.12%,41.31%,1
桃園市,龜山區,0229,484,160,644,40,684,1404,48.72%,34.47%,1
桃園市,龜山區,0230,589,168,757,54,811,1478,54.87%,39.85%,1
桃園市,龜山區,0231,816,233,1049,62,1111,2178,51.01%,37.47%,1
桃園市,龜山區,0232,617,185,802,91,893,1672,53.41%,36.9%,1
桃園市,龜山區,0233,532,113,645,39,684,1376,49.71%,38.66%,1
桃園市,龜山區,0234,540,163,703,47,750,1480,50.68%,36.49%,1
桃園市,龜山區,0235,521,133,654,35,689,1258,54.77%,41.41%,1
桃園市,龜山區,0236,588,121,709,28,737,1464,50.34%,40.16%,1
桃園市,龜山區,0237,663,189,852,84,936,1844,50.76%,35.95%,1
桃園市,龜山區,0238,457,125,582,21,603,1169,51.58%,39.09%,1
桃園市,龜山區,0239,561,150,711,23,734,1921,38.21%,29.2%,1
桃園市,龜山區,0240,603,162,765,26,791,1694,46.69%,35.6%,1
桃園市,龜山區,0241,741,191,932,52,984,1771,55.56%,41.84%,1
桃園市,龜山區,0242,570,161,731,51,782,1665,46.97%,34.23%,1
桃園市,龜山區,0243,514,70,584,56,640,1439,44.48%,35.72%,1
桃園市,龜山區,0244,560,163,723,67,790,1728,45.72%,32.41%,1
桃園市,龜山區,0245,692,171,863,42,905,1788,50.62%,38.7%,1
桃園市,龜山區,0246,507,143,650,48,698,1465,47.65%,34.61%,1
桃園市,龜山區,0247,517,124,641,46,687,1659,41.41%,31.16%,1
桃園市,龜山區,0248,551,150,701,34,735,1693,43.41%,32.55%,1
桃園市,龜山區,0249,517,132,649,19,668,1818,36.74%,28.44%,1
桃園市,龜山區,0250,589,223,812,72,884,1752,50.46%,33.62%,1
桃園市,龜山區,0251,653,194,847,33,880,1818,48.4%,35.92%,1
桃園市,龜山區,0252,560,138,698,29,727,1499,48.5%,37.36%,1
桃園市,龜山區,0253,704,196,900,56,956,1916,49.9%,36.74%,1
桃園市,龜山區,0254,659,199,858,41,899,1804,49.83%,36.53%,1
桃園市,龜山區,0255,725,226,951,42,993,2127,46.69%,34.09%,1
桃園市,龜山區,0256,356,121,477,60,537,1005,53.43%,35.42%,1
桃園市,龜山區,0257,592,135,727,33,760,1449,52.45%,40.86%,1
桃園市,龜山區,0258,501,157,658,61,719,1498,48%,33.44%,1
桃園市,龜山區,0259,704,211,915,46,961,2149,44.72%,32.76%,1
桃園市,龜山區,0260,518,119,637,18,655,1771,36.98%,29.25%,1
桃園市,龜山區,0261,316,89,405,22,427,841,50.77%,37.57%,1
桃園市,龜山區,0262,736,246,982,64,1046,2284,45.8%,32.22%,1
桃園市,龜山區,0263,448,144,592,59,651,1228,53.01%,36.48%,1
桃園市,龜山區,0264,681,155,836,43,879,1979,44.42%,34.41%,1
桃園市,龜山區,0265,482,114,596,28,624,1378,45.28%,34.98%,1
桃園市,龜山區,0266,373,115,488,44,532,1061,50.14%,35.16%,1
桃園市,龜山區,0267,680,172,852,47,899,1917,46.9%,35.47%,1
桃園市,龜山區,0268,708,164,872,30,902,1540,58.57%,45.97%,1
桃園市,龜山區,0269,613,133,746,20,766,1433,53.45%,42.78%,1
桃園市,龜山區,0270,530,173,703,20,723,1455,49.69%,36.43%,1
桃園市,龜山區,0271,905,247,1152,70,1222,2280,53.6%,39.69%,1
桃園市,龜山區,0272,606,196,802,35,837,1668,50.18%,36.33%,1
桃園市,龜山區,0273,652,205,857,38,895,1885,47.48%,34.59%,1
桃園市,龜山區,0274,666,202,868,35,903,1849,48.84%,36.02%,1
桃園市,龜山區,0275,635,268,903,37,940,1704,55.16%,37.27%,1
桃園市,龜山區,0276,453,129,582,34,616,1156,53.29%,39.19%,1
桃園市,龜山區,0277,674,154,828,52,880,2114,41.63%,31.88%,1
桃園市,龜山區,0278,649,182,831,29,860,1943,44.26%,33.4%,1
桃園市,龜山區,0279,615,177,792,43,835,1800,46.39%,34.17%,1
桃園市,龜山區,0280,714,199,913,52,965,2020,47.77%,35.35%,1
桃園市,龜山區,0281,568,126,694,37,731,1319,55.42%,43.06%,1
桃園市,龜山區,0282,876,247,1123,46,1169,2229,52.45%,39.3%,1
桃園市,龜山區,0283,690,223,913,21,934,1992,46.89%,34.64%,1
桃園市,龜山區,0284,786,210,996,53,1049,2237,46.89%,35.14%,1
桃園市,龜山區,0285,809,181,990,33,1023,2133,47.96%,37.93%,1
桃園市,龜山區,0286,822,224,1046,59,1105,2187,50.53%,37.59%,1
桃園市,龜山區,0287,718,176,894,58,952,1959,48.6%,36.65%,1
桃園市,龜山區,0288,606,220,826,40,866,1910,45.34%,31.73%,1
桃園市,龜山區,0289,661,225,886,92,978,1840,53.15%,35.92%,1
桃園市,龜山區,0290,855,225,1080,48,1128,2266,49.78%,37.73%,1
桃園市,龜山區,0291,867,162,1029,28,1057,2387,44.28%,36.32%,1
桃園市,龜山區,0292,613,150,763,22,785,1692,46.39%,36.23%,1
桃園市,龜山區,0293,355,89,444,16,460,904,50.88%,39.27%,1
桃園市,龜山區,0294,628,129,757,25,782,1469,53.23%,42.75%,1
桃園市,八德區,0295,610,146,756,90,846,1761,48.04%,34.64%,1
桃園市,八德區,0296,561,142,703,17,720,1804,39.91%,31.1%,1
桃園市,八德區,0297,378,102,480,32,512,1813,28.24%,20.85%,1
桃園市,八德區,0298,631,141,772,37,809,1784,45.35%,35.37%,1
桃園市,八德區,0299,794,125,919,47,966,2257,42.8%,35.18%,1
桃園市,八德區,0300,596,116,712,29,741,1857,39.9%,32.09%,1
桃園市,八德區,0301,784,168,952,44,996,2261,44.05%,34.67%,1
桃園市,八德區,0302,740,193,933,55,988,1903,51.92%,38.89%,1
桃園市,八德區,0303,750,161,911,66,977,1955,49.97%,38.36%,1
桃園市,八德區,0304,559,131,690,18,708,1665,42.52%,33.57%,1
桃園市,八德區,0305,564,169,733,50,783,1431,54.72%,39.41%,1
桃園市,八德區,0306,518,128,646,37,683,1263,54.08%,41.01%,1
桃園市,八德區,0307,662,164,826,62,888,1583,56.1%,41.82%,1
桃園市,八德區,0308,534,120,654,30,684,1246,54.9%,42.86%,1
桃園市,八德區,0309,553,146,699,31,730,1356,53.83%,40.78%,1
桃園市,八德區,0310,670,161,831,73,904,1630,55.46%,41.1%,1
桃園市,八德區,0311,595,114,709,31,740,1586,46.66%,37.52%,1
桃園市,八德區,0312,625,169,794,61,855,1649,51.85%,37.9%,1
桃園市,八德區,0313,657,146,803,91,894,1910,46.81%,34.4%,1
桃園市,八德區,0314,641,177,818,72,890,1612,55.21%,39.76%,1
桃園市,八德區,0315,687,127,814,40,854,1640,52.07%,41.89%,1
桃園市,八德區,0316,481,148,629,38,667,1303,51.19%,36.91%,1
桃園市,八德區,0317,615,141,756,51,807,1413,57.11%,43.52%,1
桃園市,八德區,0318,640,178,818,47,865,1711,50.56%,37.41%,1
桃園市,八德區,0319,635,131,766,66,832,1562,53.27%,40.65%,1
桃園市,八德區,0320,682,142,824,59,883,1735,50.89%,39.31%,1
桃園市,八德區,0321,650,156,806,38,844,1658,50.9%,39.2%,1
桃園市,八德區,0322,439,132,571,38,609,1022,59.59%,42.95%,1
桃園市,八德區,0323,581,142,723,47,770,1673,46.03%,34.73%,1
桃園市,八德區,0324,628,150,778,34,812,1741,46.64%,36.07%,1
桃園市,八德區,0325,798,223,1021,62,1083,2110,51.33%,37.82%,1
桃園市,八德區,0326,501,83,584,23,607,1145,53.01%,43.76%,1
桃園市,八德區,0327,279,89,368,30,398,1010,39.41%,27.62%,1
桃園市,八德區,0328,617,157,774,19,793,1848,42.91%,33.39%,1
桃園市,八德區,0329,534,143,677,43,720,1334,53.97%,40.03%,1
桃園市,八德區,0330,438,115,553,27,580,1349,42.99%,32.47%,1
桃園市,八德區,0331,578,151,729,35,764,1341,56.97%,43.1%,1
桃園市,八德區,0332,519,112,631,50,681,1178,57.81%,44.06%,1
桃園市,八德區,0333,544,158,702,37,739,1374,53.78%,39.59%,1
桃園市,八德區,0334,497,171,668,71,739,1462,50.55%,33.99%,1
桃園市,八德區,0335,733,61,794,49,843,1943,43.39%,37.73%,1
桃園市,八德區,0336,533,151,684,77,761,1928,39.47%,27.65%,1
桃園市,八德區,0337,449,147,596,27,623,1403,44.4%,32%,1
桃園市,八德區,0338,582,167,749,51,800,1672,47.85%,34.81%,1
桃園市,八德區,0339,665,202,867,35,902,1947,46.33%,34.16%,1
桃園市,八德區,0340,453,135,588,39,627,1200,52.25%,37.75%,1
桃園市,八德區,0341,641,182,823,71,894,1895,47.18%,33.83%,1
桃園市,八德區,0342,665,192,857,62,919,1988,46.23%,33.45%,1
桃園市,八德區,0343,760,222,982,60,1042,2006,51.94%,37.89%,1
桃園市,八德區,0344,697,204,901,13,914,2061,44.35%,33.82%,1
桃園市,八德區,0345,659,238,897,65,962,2108,45.64%,31.26%,1
桃園市,八德區,0346,673,164,837,54,891,1862,47.85%,36.14%,1
桃園市,八德區,0347,626,161,787,32,819,1681,48.72%,37.24%,1
桃園市,八德區,0348,503,147,650,63,713,1317,54.14%,38.19%,1
桃園市,八德區,0349,886,215,1101,63,1164,2093,55.61%,42.33%,1
桃園市,八德區,0350,596,199,795,56,851,1499,56.77%,39.76%,1
桃園市,八德區,0351,676,177,853,54,907,1782,50.9%,37.93%,1
桃園市,八德區,0352,710,156,866,33,899,1763,50.99%,40.27%,1
桃園市,八德區,0353,493,122,615,53,668,1226,54.49%,40.21%,1
桃園市,八德區,0354,552,148,700,38,738,1311,56.29%,42.11%,1
桃園市,八德區,0355,500,107,607,36,643,1170,54.96%,42.74%,1
桃園市,八德區,0356,563,120,683,29,712,1313,54.23%,42.88%,1
桃園市,八德區,0357,507,117,624,25,649,1186,54.72%,42.75%,1
桃園市,八德區,0358,539,133,672,49,721,1481,48.68%,36.39%,1
桃園市,八德區,0359,774,189,963,62,1025,1998,51.3%,38.74%,1
桃園市,八德區,0360,386,91,477,30,507,916,55.35%,42.14%,1
桃園市,八德區,0361,720,161,881,47,928,1943,47.76%,37.06%,1
桃園市,八德區,0362,804,147,951,39,990,2076,47.69%,38.73%,1
桃園市,八德區,0363,528,138,666,64,730,1363,53.56%,38.74%,1
桃園市,八德區,0364,570,163,733,54,787,1491,52.78%,38.23%,1
桃園市,八德區,0365,550,152,702,67,769,1474,52.17%,37.31%,1
桃園市,八德區,0366,136,26,162,13,175,718,24.37%,18.94%,1
桃園市,八德區,0367,528,156,684,8,692,1386,49.93%,38.1%,1
桃園市,八德區,0368,579,125,704,67,771,1487,51.85%,38.94%,1
桃園市,八德區,0369,628,114,742,68,810,1552,52.19%,40.46%,1
桃園市,八德區,0370,84,475,559,54,613,1255,48.84%,6.69%,1
桃園市,八德區,0371,626,150,776,63,839,1505,55.75%,41.59%,1
桃園市,八德區,0372,488,149,637,64,701,1436,48.82%,33.98%,1
桃園市,八德區,0373,605,205,810,67,877,1618,54.2%,37.39%,1
桃園市,八德區,0374,667,128,795,69,864,1685,51.28%,39.58%,1
桃園市,八德區,0375,648,140,788,52,840,1835,45.78%,35.31%,1
桃園市,八德區,0376,724,157,881,56,937,1881,49.81%,38.49%,1
桃園市,八德區,0377,619,168,787,47,834,1766,47.23%,35.05%,1
桃園市,八德區,0378,692,162,854,68,922,1817,50.74%,38.08%,1
桃園市,八德區,0379,936,159,1095,34,1129,2198,51.36%,42.58%,1
桃園市,八德區,0380,691,166,857,49,906,1732,52.31%,39.9%,1
桃園市,八德區,0381,829,221,1050,33,1083,2089,51.84%,39.68%,1
桃園市,八德區,0382,525,117,642,31,673,1257,53.54%,41.77%,1
桃園市,八德區,0383,488,120,608,48,656,1267,51.78%,38.52%,1
桃園市,八德區,0384,616,126,742,23,765,1427,53.61%,43.17%,1
桃園市,八德區,0385,723,192,915,52,967,1685,57.39%,42.91%,1
桃園市,八德區,0386,695,199,894,50,944,1748,54%,39.76%,1
桃園市,八德區,0387,902,174,1076,49,1125,1650,68.18%,54.67%,1
桃園市,八德區,0388,563,167,730,56,786,1478,53.18%,38.09%,1
桃園市,八德區,0389,657,153,810,53,863,1607,53.7%,40.88%,1
桃園市,八德區,0390,744,203,947,68,1015,1841,55.13%,40.41%,1
桃園市,八德區,0391,799,195,994,64,1058,2082,50.82%,38.38%,1
桃園市,八德區,0392,696,155,851,49,900,1959,45.94%,35.53%,1
桃園市,八德區,0393,900,196,1096,53,1149,2209,52.01%,40.74%,1
桃園市,八德區,0394,777,146,923,50,973,1864,52.2%,41.68%,1
桃園市,八德區,0395,735,204,939,59,998,2000,49.9%,36.75%,1
桃園市,龍潭區,1008,568,139,707,30,737,1482,49.73%,38.33%,1
桃園市,龍潭區,1009,590,136,726,46,772,1528,50.52%,38.61%,1
桃園市,龍潭區,1010,593,134,727,45,772,1503,51.36%,39.45%,1
桃園市,龍潭區,1011,607,140,747,47,794,1568,50.64%,38.71%,1
桃園市,龍潭區,1012,469,104,573,59,632,1216,51.97%,38.57%,1
桃園市,龍潭區,1013,708,172,880,69,949,2088,45.45%,33.91%,1
桃園市,龍潭區,1014,841,186,1027,73,1100,1987,55.36%,42.33%,1
桃園市,龍潭區,1015,722,141,863,45,908,1586,57.25%,45.52%,1
桃園市,龍潭區,1016,435,141,576,39,615,1221,50.37%,35.63%,1
桃園市,龍潭區,1017,484,118,602,44,646,1134,56.97%,42.68%,1
桃園市,龍潭區,1018,740,182,922,52,974,2081,46.8%,35.56%,1
桃園市,龍潭區,1019,704,150,854,30,884,1925,45.92%,36.57%,1
桃園市,龍潭區,1020,934,157,1091,32,1123,2095,53.6%,44.58%,1
桃園市,龍潭區,1021,945,167,1112,48,1160,2040,56.86%,46.32%,1
桃園市,龍潭區,1022,677,149,826,51,877,1790,48.99%,37.82%,1
桃園市,龍潭區,1023,728,216,944,77,1021,1872,54.54%,38.89%,1
桃園市,龍潭區,1024,729,167,896,65,961,1726,55.68%,42.24%,1
桃園市,龍潭區,1025,749,170,919,58,977,1792,54.52%,41.8%,1
桃園市,龍潭區,1026,580,117,697,38,735,1398,52.58%,41.49%,1
桃園市,龍潭區,1027,502,122,624,41,665,1345,49.44%,37.32%,1
桃園市,龍潭區,1028,602,126,728,40,768,1409,54.51%,42.73%,1
桃園市,龍潭區,1029,488,122,610,26,636,1362,46.7%,35.83%,1
桃園市,龍潭區,1030,691,193,884,52,936,1650,56.73%,41.88%,1
桃園市,龍潭區,1031,657,137,794,38,832,1597,52.1%,41.14%,1
桃園市,龍潭區,1032,570,143,713,24,737,1410,52.27%,40.43%,1
桃園市,龍潭區,1033,530,135,665,44,709,1275,55.61%,41.57%,1
桃園市,龍潭區,1034,810,220,1030,60,1090,1909,57.1%,42.43%,1
桃園市,龍潭區,1035,868,188,1056,34,1090,2024,53.85%,42.89%,1
桃園市,龍潭區,1036,839,182,1021,55,1076,2002,53.75%,41.91%,1
桃園市,龍潭區,1037,788,174,962,47,1009,1786,56.49%,44.12%,1
桃園市,龍潭區,1038,739,163,902,52,954,1756,54.33%,42.08%,1
桃園市,龍潭區,1039,909,53,962,37,999,1830,54.59%,49.67%,1
桃園市,龍潭區,1040,804,167,971,29,1000,1697,58.93%,47.38%,1
桃園市,龍潭區,1041,697,101,798,30,828,1519,54.51%,45.89%,1
桃園市,龍潭區,1042,707,152,859,30,889,1805,49.25%,39.17%,1
桃園市,龍潭區,1043,644,141,785,27,812,1792,45.31%,35.94%,1
桃園市,龍潭區,1044,672,142,814,65,879,1500,58.6%,44.8%,1
桃園市,龍潭區,1045,548,116,664,29,693,1427,48.56%,38.4%,1
桃園市,龍潭區,1046,484,120,604,46,650,1444,45.01%,33.52%,1
桃園市,龍潭區,1047,520,116,636,35,671,1321,50.79%,39.36%,1
桃園市,龍潭區,1048,561,135,696,31,727,1215,59.84%,46.17%,1
桃園市,龍潭區,1049,530,111,641,53,694,1297,53.51%,40.86%,1
桃園市,龍潭區,1050,546,113,659,19,678,1407,48.19%,38.81%,1
桃園市,龍潭區,1051,578,153,731,43,774,1564,49.49%,36.96%,1
桃園市,龍潭區,1052,516,122,638,63,701,1317,53.23%,39.18%,1
桃園市,龍潭區,1053,385,81,466,42,508,1023,49.66%,37.63%,1
桃園市,龍潭區,1054,699,172,871,47,918,1721,53.34%,40.62%,1
桃園市,龍潭區,1055,768,151,919,56,975,1764,55.27%,43.54%,1
桃園市,龍潭區,1056,609,144,753,51,804,1499,53.64%,40.63%,1
桃園市,龍潭區,1057,798,159,957,41,998,2151,46.4%,37.1%,1
桃園市,龍潭區,1058,697,121,818,28,846,1524,55.51%,45.73%,1
桃園市,龍潭區,1059,690,143,833,31,864,1456,59.34%,47.39%,1
桃園市,龍潭區,1060,949,138,1087,29,1116,1847,60.42%,51.38%,1
桃園市,龍潭區,1061,936,157,1093,33,1126,1899,59.29%,49.29%,1
桃園市,龍潭區,1062,746,146,892,37,929,1725,53.86%,43.25%,1
桃園市,龍潭區,1063,797,165,962,50,1012,1665,60.78%,47.87%,1
桃園市,龍潭區,1064,649,132,781,30,811,1649,49.18%,39.36%,1
桃園市,龍潭區,1065,591,110,701,35,736,1539,47.82%,38.4%,1
桃園市,龍潭區,1066,676,161,837,46,883,1541,57.3%,43.87%,1
桃園市,龍潭區,1067,568,143,711,39,750,1375,54.55%,41.31%,1
桃園市,龍潭區,1068,611,146,757,28,785,1453,54.03%,42.05%,1
桃園市,龍潭區,1069,451,117,568,42,610,1074,56.8%,41.99%,1
桃園市,龍潭區,1070,622,118,740,15,755,1299,58.12%,47.88%,1
桃園市,龍潭區,1071,232,65,297,21,318,678,46.9%,34.22%,1
桃園市,平鎮區,0801,534,145,679,43,722,1487,48.55%,35.91%,1
桃園市,平鎮區,0802,587,124,711,49,760,1453,52.31%,40.4%,1
桃園市,平鎮區,0803,613,159,772,40,812,1491,54.46%,41.11%,1
桃園市,平鎮區,0804,507,143,650,49,699,1346,51.93%,37.67%,1
桃園市,平鎮區,0805,663,152,815,38,853,1660,51.39%,39.94%,1
桃園市,平鎮區,0806,693,157,850,34,884,1921,46.02%,36.07%,1
桃園市,平鎮區,0807,850,159,1009,57,1066,1974,54%,43.06%,1
桃園市,平鎮區,0808,725,174,899,35,934,1867,50.03%,38.83%,1
桃園市,平鎮區,0809,729,151,880,41,921,1786,51.57%,40.82%,1
桃園市,平鎮區,0810,548,116,664,22,686,1634,41.98%,33.54%,1
桃園市,平鎮區,0811,469,100,569,15,584,1080,54.07%,43.43%,1
桃園市,平鎮區,0812,640,137,777,19,796,1514,52.58%,42.27%,1
桃園市,平鎮區,0813,681,142,823,58,881,1918,45.93%,35.51%,1
桃園市,平鎮區,0814,455,140,595,63,658,1182,55.67%,38.49%,1
桃園市,平鎮區,0815,623,146,769,35,804,1667,48.23%,37.37%,1
桃園市,平鎮區,0816,585,147,732,32,764,1640,46.59%,35.67%,1
桃園市,平鎮區,0817,635,153,788,29,817,1603,50.97%,39.61%,1
桃園市,平鎮區,0818,691,145,836,11,847,1556,54.43%,44.41%,1
桃園市,平鎮區,0819,665,131,796,33,829,1697,48.85%,39.19%,1
桃園市,平鎮區,0820,424,82,506,18,524,1130,46.37%,37.52%,1
桃園市,平鎮區,0821,473,120,593,33,626,1196,52.34%,39.55%,1
桃園市,平鎮區,0822,683,159,842,30,872,1685,51.75%,40.53%,1
桃園市,平鎮區,0823,639,175,814,44,858,1532,56.01%,41.71%,1
桃園市,平鎮區,0824,670,101,771,31,802,1564,51.28%,42.84%,1
桃園市,平鎮區,0825,604,126,730,30,760,1824,41.67%,33.11%,1
桃園市,平鎮區,0826,701,182,883,24,907,1912,47.44%,36.66%,1
桃園市,平鎮區,0827,411,107,518,42,560,1048,53.44%,39.22%,1
桃園市,平鎮區,0828,544,116,660,44,704,1259,55.92%,43.21%,1
桃園市,平鎮區,0829,432,99,531,15,546,1061,51.46%,40.72%,1
桃園市,平鎮區,0830,512,102,614,25,639,1072,59.61%,47.76%,1
桃園市,平鎮區,0831,677,166,843,51,894,1788,50%,37.86%,1
桃園市,平鎮區,0832,672,103,775,22,797,1510,52.78%,44.5%,1
桃園市,平鎮區,0833,565,137,702,38,740,1403,52.74%,40.27%,1
桃園市,平鎮區,0834,583,136,719,48,767,1407,54.51%,41.44%,1
桃園市,平鎮區,0835,772,200,972,44,1016,1901,53.45%,40.61%,1
桃園市,平鎮區,0836,721,161,882,31,913,1994,45.79%,36.16%,1
桃園市,平鎮區,0837,676,182,858,42,900,1730,52.02%,39.08%,1
桃園市,平鎮區,0838,767,190,957,47,1004,1905,52.7%,40.26%,1
桃園市,平鎮區,0839,720,89,809,26,835,1723,48.46%,41.79%,1
桃園市,平鎮區,0840,530,138,668,48,716,1307,54.78%,40.55%,1
桃園市,平鎮區,0841,552,142,694,40,734,1337,54.9%,41.29%,1
桃園市,平鎮區,0842,491,104,595,39,634,980,64.69%,50.1%,1
桃園市,平鎮區,0843,704,173,877,55,932,1818,51.27%,38.72%,1
桃園市,平鎮區,0844,579,170,749,54,803,1463,54.89%,39.58%,1
桃園市,平鎮區,0845,555,128,683,21,704,1213,58.04%,45.75%,1
桃園市,平鎮區,0846,462,116,578,38,616,1085,56.77%,42.58%,1
桃園市,平鎮區,0847,553,130,683,37,720,1458,49.38%,37.93%,1
桃園市,平鎮區,0848,574,157,731,47,778,1408,55.26%,40.77%,1
桃園市,平鎮區,0849,530,141,671,48,719,1396,51.5%,37.97%,1
桃園市,平鎮區,0850,510,131,641,25,666,1044,63.79%,48.85%,1
桃園市,平鎮區,0851,505,98,603,10,613,1124,54.54%,44.93%,1
桃園市,平鎮區,0852,648,244,892,24,916,1517,60.38%,42.72%,1
桃園市,平鎮區,0853,644,139,783,28,811,1571,51.62%,40.99%,1
桃園市,平鎮區,0854,769,164,933,30,963,1752,54.97%,43.89%,1
桃園市,平鎮區,0855,712,114,826,29,855,1434,59.62%,49.65%,1
桃園市,平鎮區,0856,753,191,944,39,983,1710,57.49%,44.04%,1
桃園市,平鎮區,0857,674,152,826,34,860,1555,55.31%,43.34%,1
桃園市,平鎮區,0858,741,190,931,32,963,2051,46.95%,36.13%,1
桃園市,平鎮區,0859,595,167,762,24,786,1477,53.22%,40.28%,1
桃園市,平鎮區,0860,611,143,754,25,779,1501,51.9%,40.71%,1
桃園市,平鎮區,0861,570,150,720,58,778,1405,55.37%,40.57%,1
桃園市,平鎮區,0862,652,166,818,55,873,1656,52.72%,39.37%,1
桃園市,平鎮區,0863,681,181,862,29,891,1921,46.38%,35.45%,1
桃園市,平鎮區,0864,667,118,785,21,806,1717,46.94%,38.85%,1
桃園市,平鎮區,0865,524,159,683,35,718,1319,54.44%,39.73%,1
桃園市,平鎮區,0866,665,163,828,56,884,1745,50.66%,38.11%,1
桃園市,平鎮區,0867,712,181,893,49,942,1721,54.74%,41.37%,1
桃園市,平鎮區,0868,521,115,636,23,659,1206,54.64%,43.2%,1
桃園市,平鎮區,0869,608,140,748,31,779,1202,64.81%,50.58%,1
桃園市,平鎮區,0870,526,133,659,46,705,1208,58.36%,43.54%,1
桃園市,平鎮區,0871,537,171,708,35,743,1267,58.64%,42.38%,1
桃園市,平鎮區,0872,499,89,588,20,608,1094,55.58%,45.61%,1
桃園市,平鎮區,0873,607,159,766,51,817,1394,58.61%,43.54%,1
桃園市,平鎮區,0874,583,111,694,16,710,1215,58.44%,47.98%,1
桃園市,平鎮區,0875,451,93,544,37,581,1010,57.52%,44.65%,1
桃園市,平鎮區,0876,532,139,671,31,702,1261,55.67%,42.19%,1
桃園市,平鎮區,0877,708,31,739,26,765,1314,58.22%,53.88%,1
桃園市,平鎮區,0878,309,78,387,34,421,722,58.31%,42.8%,1
桃園市,平鎮區,0879,309,117,426,26,452,839,53.87%,36.83%,1
桃園市,平鎮區,0880,575,151,726,22,748,1399,53.47%,41.1%,1
桃園市,平鎮區,0881,747,190,937,48,985,1968,50.05%,37.96%,1
桃園市,平鎮區,0882,690,170,860,34,894,1672,53.47%,41.27%,1
桃園市,平鎮區,0883,498,128,626,24,650,2213,29.37%,22.5%,1
桃園市,平鎮區,0884,454,111,565,22,587,949,61.85%,47.84%,1
桃園市,平鎮區,0885,726,188,914,49,963,1621,59.41%,44.79%,1
桃園市,平鎮區,0886,675,138,813,29,842,1643,51.25%,41.08%,1
桃園市,平鎮區,0887,766,194,960,48,1008,1844,54.66%,41.54%,1
桃園市,平鎮區,0888,736,175,911,35,946,1752,54%,42.01%,1
桃園市,平鎮區,0889,593,147,740,42,782,1577,49.59%,37.6%,1
桃園市,平鎮區,0890,668,153,821,24,845,1517,55.7%,44.03%,1
桃園市,平鎮區,0891,441,135,576,35,611,1039,58.81%,42.44%,1
桃園市,平鎮區,0892,583,146,729,47,776,1318,58.88%,44.23%,1
桃園市,平鎮區,0893,686,142,828,34,862,1636,52.69%,41.93%,1
桃園市,平鎮區,0894,546,160,706,59,765,1316,58.13%,41.49%,1
桃園市,平鎮區,0895,629,158,787,30,817,1474,55.43%,42.67%,1
桃園市,平鎮區,0896,542,120,662,40,702,1480,47.43%,36.62%,1
桃園市,平鎮區,0897,670,12,682,23,705,1330,53.01%,50.38%,1
桃園市,平鎮區,0898,539,116,655,24,679,1228,55.29%,43.89%,1
桃園市,平鎮區,0899,602,169,771,35,806,1377,58.53%,43.72%,1
桃園市,平鎮區,0900,562,133,695,26,721,1198,60.18%,46.91%,1
桃園市,平鎮區,0901,478,243,721,24,745,1231,60.52%,38.83%,1
桃園市,平鎮區,0902,506,147,653,58,711,1243,57.2%,40.71%,1
桃園市,平鎮區,0903,568,226,794,45,839,1590,52.77%,35.72%,1
桃園市,平鎮區,0904,543,152,695,41,736,1366,53.88%,39.75%,1
桃園市,平鎮區,0905,567,107,674,41,715,1332,53.68%,42.57%,1
桃園市,平鎮區,0906,446,96,542,24,566,1201,47.13%,37.14%,1
桃園市,平鎮區,0907,598,134,732,35,767,1668,45.98%,35.85%,1
桃園市,平鎮區,0908,543,109,652,56,708,1351,52.41%,40.19%,1
桃園市,平鎮區,0909,522,118,640,22,662,1460,45.34%,35.75%,1
桃園市,平鎮區,0910,743,146,889,38,927,1841,50.35%,40.36%,1
桃園市,平鎮區,0911,561,111,672,20,692,1475,46.92%,38.03%,1
桃園市,平鎮區,0912,440,93,533,25,558,1011,55.19%,43.52%,1
桃園市,平鎮區,0913,385,100,485,31,516,1052,49.05%,36.6%,1
桃園市,平鎮區,0914,534,122,656,51,707,1154,61.27%,46.27%,1
桃園市,平鎮區,0915,633,141,774,22,796,1645,48.39%,38.48%,1
桃園市,平鎮區,0916,575,156,731,42,773,1539,50.23%,37.36%,1
桃園市,平鎮區,0917,581,103,684,64,748,1385,54.01%,41.95%,1
桃園市,平鎮區,0918,605,112,717,32,749,1395,53.69%,43.37%,1
桃園市,平鎮區,0919,676,142,818,30,848,1711,49.56%,39.51%,1
桃園市,平鎮區,0920,653,131,784,49,833,1631,51.07%,40.04%,1
桃園市,平鎮區,0921,516,73,589,14,603,1110,54.32%,46.49%,1
桃園市,平鎮區,0922,846,152,998,46,1044,1931,54.07%,43.81%,1
桃園市,平鎮區,0923,486,93,579,38,617,1127,54.75%,43.12%,1
桃園市,平鎮區,0924,628,95,723,65,788,1414,55.73%,44.41%,1
桃園市,平鎮區,0925,686,117,803,37,840,1609,52.21%,42.64%,1
桃園市,新屋區,1072,605,131,736,23,759,1306,58.12%,46.32%,1
桃園市,新屋區,1073,634,194,828,38,866,1556,55.66%,40.75%,1
桃園市,新屋區,1074,849,210,1059,53,1112,1849,60.14%,45.92%,1
桃園市,新屋區,1075,912,250,1162,64,1226,2096,58.49%,43.51%,1
桃園市,新屋區,1076,572,171,743,53,796,1517,52.47%,37.71%,1
桃園市,新屋區,1077,911,229,1140,55,1195,2095,57.04%,43.48%,1
桃園市,新屋區,1078,652,174,826,35,861,1856,46.39%,35.13%,1
桃園市,新屋區,1079,824,204,1028,58,1086,1986,54.68%,41.49%,1
桃園市,新屋區,1080,546,126,672,25,697,1425,48.91%,38.32%,1
桃園市,新屋區,1081,517,124,641,37,678,1385,48.95%,37.33%,1
桃園市,新屋區,1082,566,170,736,45,781,1271,61.45%,44.53%,1
桃園市,新屋區,1083,516,137,653,29,682,1271,53.66%,40.6%,1
桃園市,新屋區,1084,489,168,657,46,703,1234,56.97%,39.63%,1
桃園市,新屋區,1085,440,114,554,51,605,1085,55.76%,40.55%,1
桃園市,新屋區,1086,859,180,1039,37,1076,1992,54.02%,43.12%,1
桃園市,新屋區,1087,917,211,1128,61,1189,2032,58.51%,45.13%,1
桃園市,新屋區,1088,515,136,651,56,707,1291,54.76%,39.89%,1
桃園市,新屋區,1089,525,124,649,30,679,1401,48.47%,37.47%,1
桃園市,新屋區,1090,457,148,605,42,647,1106,58.5%,41.32%,1
桃園市,新屋區,1091,343,100,443,11,454,908,50%,37.78%,1
桃園市,新屋區,1092,301,74,375,33,408,663,61.54%,45.4%,1
桃園市,新屋區,1093,412,118,530,48,578,1088,53.13%,37.87%,1
桃園市,新屋區,1094,481,139,620,47,667,1050,63.52%,45.81%,1
桃園市,新屋區,1095,398,90,488,19,507,896,56.58%,44.42%,1
桃園市,新屋區,1096,611,135,746,74,820,1369,59.9%,44.63%,1
桃園市,新屋區,1097,344,107,451,32,483,995,48.54%,34.57%,1
桃園市,新屋區,1098,315,73,388,17,405,741,54.66%,42.51%,1
桃園市,新屋區,1099,402,124,526,56,582,943,61.72%,42.63%,1
桃園市,新屋區,1100,618,191,809,74,883,1714,51.52%,36.06%,1
桃園市,新屋區,1101,559,119,678,18,696,1340,51.94%,41.72%,1
桃園市,觀音區,1102,475,116,591,28,619,1371,45.15%,34.65%,1
桃園市,觀音區,1103,431,101,532,25,557,1362,40.9%,31.64%,1
桃園市,觀音區,1104,367,90,457,72,529,997,53.06%,36.81%,1
桃園市,觀音區,1105,498,121,619,25,644,1407,45.77%,35.39%,1
桃園市,觀音區,1106,691,153,844,29,873,1692,51.6%,40.84%,1
桃園市,觀音區,1107,512,108,620,22,642,1279,50.2%,40.03%,1
桃園市,觀音區,1108,318,71,389,18,407,791,51.45%,40.2%,1
桃園市,觀音區,1109,377,90,467,36,503,892,56.39%,42.26%,1
桃園市,觀音區,1110,408,100,508,24,532,886,60.05%,46.05%,1
桃園市,觀音區,1111,279,87,366,32,398,712,55.9%,39.19%,1
桃園市,觀音區,1112,561,163,724,88,812,1609,50.47%,34.87%,1
桃園市,觀音區,1113,510,148,658,47,705,1274,55.34%,40.03%,1
桃園市,觀音區,1114,451,107,558,17,575,1351,42.56%,33.38%,1
桃園市,觀音區,1115,547,127,674,54,728,1262,57.69%,43.34%,1
桃園市,觀音區,1116,506,137,643,62,705,1242,56.76%,40.74%,1
桃園市,觀音區,1117,551,157,708,64,772,1461,52.84%,37.71%,1
桃園市,觀音區,1118,606,169,775,40,815,1613,50.53%,37.57%,1
桃園市,觀音區,1119,574,181,755,41,796,1479,53.82%,38.81%,1
桃園市,觀音區,1120,535,158,693,48,741,1552,47.74%,34.47%,1
桃園市,觀音區,1121,561,167,728,25,753,1517,49.64%,36.98%,1
桃園市,觀音區,1122,611,172,783,53,836,1691,49.44%,36.13%,1
桃園市,觀音區,1123,485,125,610,18,628,1157,54.28%,41.92%,1
桃園市,觀音區,1124,539,157,696,46,742,1455,51%,37.04%,1
桃園市,觀音區,1125,474,105,579,25,604,1150,52.52%,41.22%,1
桃園市,觀音區,1126,455,136,591,36,627,1112,56.38%,40.92%,1
桃園市,觀音區,1127,473,113,586,20,606,1251,48.44%,37.81%,1
桃園市,觀音區,1128,557,137,694,90,784,1446,54.22%,38.52%,1
桃園市,觀音區,1129,547,164,711,80,791,1493,52.98%,36.64%,1
桃園市,觀音區,1130,529,128,657,45,702,1339,52.43%,39.51%,1
桃園市,觀音區,1131,509,112,621,31,652,1137,57.34%,44.77%,1
桃園市,觀音區,1132,407,76,483,41,524,1043,50.24%,39.02%,1
桃園市,觀音區,1133,344,86,430,31,461,993,46.42%,34.64%,1
桃園市,觀音區,1134,350,113,463,20,483,975,49.54%,35.9%,1
桃園市,觀音區,1135,650,167,817,49,866,2029,42.68%,32.04%,1
桃園市,觀音區,1136,706,202,908,34,942,1765,53.37%,40%,1
桃園市,觀音區,1137,688,184,872,46,918,1809,50.75%,38.03%,1
桃園市,觀音區,1138,714,153,867,43,910,1869,48.69%,38.2%,1
桃園市,觀音區,1139,628,134,762,51,813,1870,43.48%,33.58%,1
桃園市,觀音區,1140,508,141,649,37,686,1932,35.51%,26.29%,1
桃園市,觀音區,1141,276,81,357,8,365,899,40.6%,30.7%,1
桃園市,觀音區,1142,306,89,395,15,410,985,41.62%,31.07%,1
桃園市,復興區,0581,796,205,1001,98,1099,1991,55.2%,39.98%,1
桃園市,復興區,0582,574,143,717,65,782,1392,56.18%,41.24%,1
桃園市,復興區,0583,230,48,278,14,292,564,51.77%,40.78%,1
桃園市,復興區,0584,251,67,318,23,341,716,47.63%,35.06%,1
桃園市,復興區,0585,450,117,567,61,628,1016,61.81%,44.29%,1
桃園市,復興區,0586,195,54,249,13,262,669,39.16%,29.15%,1
桃園市,復興區,0587,277,58,335,19,354,760,46.58%,36.45%,1
桃園市,復興區,0588,326,11,337,20,357,751,47.54%,43.41%,1
桃園市,復興區,0589,189,36,225,7,232,683,33.97%,27.67%,1
桃園市,復興區,0590,452,104,556,35,591,1224,48.28%,36.93%,1
臺中市,中區,1070,756,191,947,79,1026,1652,62.11%,45.76%,1
臺中市,中區,1071,614,199,813,40,853,1531,55.72%,40.1%,1
臺中市,中區,1072,602,162,764,24,788,1431,55.07%,42.07%,1
臺中市,中區,1073,469,108,577,36,613,1060,57.83%,44.25%,1
臺中市,中區,1074,411,93,504,45,549,982,55.91%,41.85%,1
臺中市,中區,1075,495,145,640,47,687,1191,57.68%,41.56%,1
臺中市,中區,1076,363,108,471,24,495,855,57.89%,42.46%,1
臺中市,中區,1077,410,93,503,28,531,1135,46.78%,36.12%,1
臺中市,中區,1078,334,52,386,13,399,705,56.6%,47.38%,1
臺中市,中區,1079,459,110,569,31,600,1009,59.46%,45.49%,1
臺中市,中區,1080,510,139,649,74,723,1304,55.44%,39.11%,1
臺中市,中區,1081,709,141,850,27,877,1841,47.64%,38.51%,1
臺中市,東區,1148,330,89,419,19,438,1138,38.49%,29%,1
臺中市,東區,1149,432,109,541,21,562,984,57.11%,43.9%,1
臺中市,東區,1150,398,93,491,29,520,877,59.29%,45.38%,1
臺中市,東區,1151,485,157,642,41,683,1070,63.83%,45.33%,1
臺中市,東區,1152,490,144,634,45,679,1106,61.39%,44.3%,1
臺中市,東區,1153,411,123,534,43,577,953,60.55%,43.13%,1
臺中市,東區,1154,547,131,678,18,696,1195,58.24%,45.77%,1
臺中市,東區,1155,549,123,672,33,705,1251,56.35%,43.88%,1
臺中市,東區,1156,454,167,621,44,665,1190,55.88%,38.15%,1
臺中市,東區,1157,574,165,739,49,788,1394,56.53%,41.18%,1
臺中市,東區,1158,625,204,829,51,880,1443,60.98%,43.31%,1
臺中市,東區,1159,313,86,399,36,435,762,57.09%,41.08%,1
臺中市,東區,1160,537,138,675,47,722,1140,63.33%,47.11%,1
臺中市,東區,1161,594,102,696,62,758,1211,62.59%,49.05%,1
臺中市,東區,1162,397,66,463,21,484,755,64.11%,52.58%,1
臺中市,東區,1163,609,171,780,57,837,1491,56.14%,40.85%,1
臺中市,東區,1164,392,114,506,29,535,1000,53.5%,39.2%,1
臺中市,東區,1165,492,142,634,43,677,1114,60.77%,44.17%,1
臺中市,東區,1166,465,120,585,35,620,1101,56.31%,42.23%,1
臺中市,東區,1167,556,143,699,57,756,1169,64.67%,47.56%,1
臺中市,東區,1168,606,133,739,66,805,1283,62.74%,47.23%,1
臺中市,東區,1169,560,146,706,32,738,1168,63.18%,47.95%,1
臺中市,東區,1170,548,165,713,32,745,1386,53.75%,39.54%,1
臺中市,東區,1171,688,185,873,51,924,1557,59.34%,44.19%,1
臺中市,東區,1172,577,179,756,60,816,1380,59.13%,41.81%,1
臺中市,東區,1173,754,172,926,43,969,1674,57.89%,45.04%,1
臺中市,東區,1174,766,189,955,39,994,1604,61.97%,47.76%,1
臺中市,東區,1175,814,222,1036,54,1090,1815,60.06%,44.85%,1
臺中市,東區,1176,713,182,895,46,941,1700,55.35%,41.94%,1
臺中市,東區,1177,698,159,857,55,912,1592,57.29%,43.84%,1
臺中市,東區,1178,799,183,982,51,1033,1850,55.84%,43.19%,1
臺中市,東區,1179,612,107,719,30,749,1252,59.82%,48.88%,1
臺中市,東區,1180,605,150,755,38,793,1250,63.44%,48.4%,1
臺中市,東區,1181,584,114,698,53,751,1241,60.52%,47.06%,1
臺中市,東區,1182,510,149,659,47,706,1318,53.57%,38.69%,1
臺中市,東區,1183,573,118,691,42,733,1288,56.91%,44.49%,1
臺中市,東區,1184,673,144,817,78,895,1442,62.07%,46.67%,1
臺中市,東區,1185,533,134,667,45,712,1202,59.23%,44.34%,1
臺中市,東區,1186,696,113,809,49,858,1452,59.09%,47.93%,1
臺中市,東區,1187,657,150,807,29,836,1480,56.49%,44.39%,1
臺中市,東區,1188,832,115,947,38,985,1736,56.74%,47.93%,1
臺中市,東區,1189,356,101,457,39,496,867,57.21%,41.06%,1
臺中市,東區,1190,707,132,839,42,881,1693,52.04%,41.76%,1
臺中市,東區,1191,710,163,873,67,940,1538,61.12%,46.16%,1
臺中市,東區,1192,701,215,916,83,999,1593,62.71%,44.01%,1
臺中市,東區,1193,651,138,789,24,813,1481,54.9%,43.96%,1
臺中市,東區,1194,671,149,820,42,862,1414,60.96%,47.45%,1
臺中市,東區,1195,550,133,683,28,711,1297,54.82%,42.41%,1
臺中市,東區,1196,601,167,768,64,832,1394,59.68%,43.11%,1
臺中市,南區,1197,425,109,534,39,573,937,61.15%,45.36%,1
臺中市,南區,1198,476,140,616,40,656,1001,65.53%,47.55%,1
臺中市,南區,1199,610,152,762,61,823,1249,65.89%,48.84%,1
臺中市,南區,1200,605,165,770,49,819,1202,68.14%,50.33%,1
臺中市,南區,1201,528,142,670,45,715,1130,63.27%,46.73%,1
臺中市,南區,1202,568,168,736,47,783,1239,63.2%,45.84%,1
臺中市,南區,1203,528,142,670,58,728,1238,58.8%,42.65%,1
臺中市,南區,1204,557,174,731,56,787,1272,61.87%,43.79%,1
臺中市,南區,1205,559,166,725,40,765,1273,60.09%,43.91%,1
臺中市,南區,1206,642,100,742,63,805,1317,61.12%,48.75%,1
臺中市,南區,1207,598,150,748,40,788,1160,67.93%,51.55%,1
臺中市,南區,1208,567,163,730,55,785,1205,65.15%,47.05%,1
臺中市,南區,1209,520,128,648,37,685,1111,61.66%,46.8%,1
臺中市,南區,1210,687,193,880,44,924,1407,65.67%,48.83%,1
臺中市,南區,1211,632,173,805,48,853,1419,60.11%,44.54%,1
臺中市,南區,1212,529,146,675,62,737,1157,63.7%,45.72%,1
臺中市,南區,1213,620,149,769,31,800,1415,56.54%,43.82%,1
臺中市,南區,1214,634,166,800,46,846,1289,65.63%,49.19%,1
臺中市,南區,1215,660,157,817,56,873,1454,60.04%,45.39%,1
臺中市,南區,1216,692,117,809,55,864,1491,57.95%,46.41%,1
臺中市,南區,1217,659,138,797,30,827,1394,59.33%,47.27%,1
臺中市,南區,1218,635,173,808,49,857,1430,59.93%,44.41%,1
臺中市,南區,1219,616,155,771,66,837,1342,62.37%,45.9%,1
臺中市,南區,1220,622,180,802,82,884,1304,67.79%,47.7%,1
臺中市,南區,1221,578,138,716,30,746,1190,62.69%,48.57%,1
臺中市,南區,1222,587,113,700,56,756,1273,59.39%,46.11%,1
臺中市,南區,1223,690,154,844,62,906,1387,65.32%,49.75%,1
臺中市,南區,1224,621,156,777,35,812,1356,59.88%,45.8%,1
臺中市,南區,1225,624,144,768,47,815,1304,62.5%,47.85%,1
臺中市,南區,1226,614,153,767,24,791,1256,62.98%,48.89%,1
臺中市,南區,1227,659,179,838,25,863,1364,63.27%,48.31%,1
臺中市,南區,1228,591,184,775,71,846,1361,62.16%,43.42%,1
臺中市,南區,1229,704,142,846,22,868,1407,61.69%,50.04%,1
臺中市,南區,1230,595,150,745,53,798,1308,61.01%,45.49%,1
臺中市,南區,1231,574,125,699,34,733,1250,58.64%,45.92%,1
臺中市,南區,1232,549,155,704,36,740,1284,57.63%,42.76%,1
臺中市,南區,1233,547,155,702,51,753,1175,64.09%,46.55%,1
臺中市,南區,1234,576,162,738,31,769,1158,66.41%,49.74%,1
臺中市,南區,1235,532,136,668,45,713,1168,61.04%,45.55%,1
臺中市,南區,1236,830,161,991,45,1036,1626,63.71%,51.05%,1
臺中市,南區,1237,664,184,848,32,880,2115,41.61%,31.39%,1
臺中市,南區,1238,808,159,967,38,1005,1805,55.68%,44.76%,1
臺中市,南區,1239,762,156,918,28,946,1695,55.81%,44.96%,1
臺中市,南區,1240,817,175,992,47,1039,1643,63.24%,49.73%,1
臺中市,南區,1241,677,180,857,32,889,1423,62.47%,47.58%,1
臺中市,南區,1242,722,155,877,41,918,1542,59.53%,46.82%,1
臺中市,南區,1243,739,139,878,27,905,1533,59.03%,48.21%,1
臺中市,南區,1244,755,170,925,64,989,1531,64.6%,49.31%,1
臺中市,南區,1245,570,139,709,30,739,1392,53.09%,40.95%,1
臺中市,南區,1246,716,155,871,46,917,1592,57.6%,44.97%,1
臺中市,南區,1247,685,165,850,43,893,1431,62.4%,47.87%,1
臺中市,南區,1248,748,192,940,43,983,1799,54.64%,41.58%,1
臺中市,南區,1249,862,174,1036,48,1084,1708,63.47%,50.47%,1
臺中市,南區,1250,766,171,937,45,982,1700,57.76%,45.06%,1
臺中市,南區,1251,853,191,1044,42,1086,1751,62.02%,48.72%,1
臺中市,南區,1252,980,219,1199,55,1254,2109,59.46%,46.47%,1
臺中市,南區,1253,781,171,952,53,1005,1697,59.22%,46.02%,1
臺中市,南區,1254,674,141,815,46,861,1456,59.13%,46.29%,1
臺中市,南區,1255,888,208,1096,51,1147,1726,66.45%,51.45%,1
臺中市,南區,1256,858,171,1029,53,1082,1723,62.8%,49.8%,1
臺中市,南區,1257,749,170,919,54,973,1569,62.01%,47.74%,1
臺中市,南區,1258,622,131,753,39,792,1274,62.17%,48.82%,1
臺中市,南區,1259,718,167,885,33,918,1390,66.04%,51.65%,1
臺中市,南區,1260,664,155,819,30,849,1295,65.56%,51.27%,1
臺中市,南區,1261,624,135,759,46,805,1312,61.36%,47.56%,1
臺中市,南區,1262,717,154,871,30,901,1417,63.59%,50.6%,1
臺中市,南區,1263,681,136,817,35,852,1230,69.27%,55.37%,1
臺中市,南區,1264,583,143,726,55,781,1308,59.71%,44.57%,1
臺中市,南區,1265,634,171,805,70,875,1467,59.65%,43.22%,1
臺中市,南區,1266,695,123,818,36,854,1399,61.04%,49.68%,1
臺中市,南區,1267,537,146,683,50,733,1207,60.73%,44.49%,1
臺中市,南區,1268,613,124,737,34,771,1317,58.54%,46.55%,1
臺中市,南區,1269,687,191,878,37,915,1563,58.54%,43.95%,1
臺中市,南區,1270,629,111,740,30,770,1221,63.06%,51.52%,1
臺中市,西區,1082,397,87,484,28,512,1400,36.57%,28.36%,1
臺中市,西區,1083,413,111,524,19,543,861,63.07%,47.97%,1
臺中市,西區,1084,636,167,803,45,848,1416,59.89%,44.92%,1
臺中市,西區,1085,466,131,597,38,635,1020,62.25%,45.69%,1
臺中市,西區,1086,381,113,494,18,512,778,65.81%,48.97%,1
臺中市,西區,1087,614,145,759,43,802,1465,54.74%,41.91%,1
臺中市,西區,1088,449,120,569,14,583,1017,57.33%,44.15%,1
臺中市,西區,1089,395,113,508,22,530,868,61.06%,45.51%,1
臺中市,西區,1090,617,149,766,37,803,1251,64.19%,49.32%,1
臺中市,西區,1091,506,136,642,41,683,1044,65.42%,48.47%,1
臺中市,西區,1092,663,167,830,24,854,1487,57.43%,44.59%,1
臺中市,西區,1093,690,171,861,45,906,1573,57.6%,43.87%,1
臺中市,西區,1094,793,193,986,61,1047,1731,60.49%,45.81%,1
臺中市,西區,1095,559,143,702,19,721,1209,59.64%,46.24%,1
臺中市,西區,1096,696,159,855,33,888,1564,56.78%,44.5%,1
臺中市,西區,1097,557,140,697,34,731,1175,62.21%,47.4%,1
臺中市,西區,1098,670,154,824,18,842,1505,55.95%,44.52%,1
臺中市,西區,1099,640,181,821,27,848,1418,59.8%,45.13%,1
臺中市,西區,1100,528,131,659,15,674,1497,45.02%,35.27%,1
臺中市,西區,1101,536,177,713,41,754,1260,59.84%,42.54%,1
臺中市,西區,1102,608,197,805,46,851,1399,60.83%,43.46%,1
臺中市,西區,1103,628,165,793,35,828,1447,57.22%,43.4%,1
臺中市,西區,1104,726,203,929,53,982,1683,58.35%,43.14%,1
臺中市,西區,1105,715,192,907,48,955,1585,60.25%,45.11%,1
臺中市,西區,1106,748,147,895,35,930,1557,59.73%,48.04%,1
臺中市,西區,1107,693,162,855,51,906,1663,54.48%,41.67%,1
臺中市,西區,1108,826,240,1066,54,1120,1921,58.3%,43%,1
臺中市,西區,1109,762,213,975,32,1007,1952,51.59%,39.04%,1
臺中市,西區,1110,727,186,913,39,952,1708,55.74%,42.56%,1
臺中市,西區,1111,584,113,697,17,714,1131,63.13%,51.64%,1
臺中市,西區,1112,923,68,991,42,1033,1916,53.91%,48.17%,1
臺中市,西區,1113,600,151,751,22,773,1275,60.63%,47.06%,1
臺中市,西區,1114,732,172,904,57,961,1822,52.74%,40.18%,1
臺中市,西區,1115,613,154,767,40,807,1374,58.73%,44.61%,1
臺中市,西區,1116,473,125,598,60,658,1129,58.28%,41.9%,1
臺中市,西區,1117,477,157,634,30,664,1201,55.29%,39.72%,1
臺中市,西區,1118,683,182,865,61,926,1639,56.5%,41.67%,1
臺中市,西區,1119,808,215,1023,66,1089,1863,58.45%,43.37%,1
臺中市,西區,1120,636,148,784,40,824,1287,64.02%,49.42%,1
臺中市,西區,1121,686,186,872,43,915,1504,60.84%,45.61%,1
臺中市,西區,1122,558,149,707,55,762,1308,58.26%,42.66%,1
臺中市,西區,1123,649,146,795,52,847,1433,59.11%,45.29%,1
臺中市,西區,1124,611,175,786,30,816,1450,56.28%,42.14%,1
臺中市,西區,1125,715,168,883,40,923,1465,63%,48.81%,1
臺中市,西區,1126,704,235,939,60,999,1818,54.95%,38.72%,1
臺中市,西區,1127,729,265,994,52,1046,1782,58.7%,40.91%,1
臺中市,西區,1128,627,191,818,40,858,1428,60.08%,43.91%,1
臺中市,西區,1129,547,141,688,40,728,1366,53.29%,40.04%,1
臺中市,西區,1130,654,156,810,37,847,1498,56.54%,43.66%,1
臺中市,西區,1131,652,129,781,34,815,1350,60.37%,48.3%,1
臺中市,西區,1132,647,132,779,27,806,1339,60.19%,48.32%,1
臺中市,西區,1133,768,159,927,40,967,1613,59.95%,47.61%,1
臺中市,西區,1134,648,158,806,44,850,1454,58.46%,44.57%,1
臺中市,西區,1135,731,190,921,36,957,1597,59.92%,45.77%,1
臺中市,西區,1136,683,174,857,36,893,1411,63.29%,48.41%,1
臺中市,西區,1137,658,171,829,60,889,1493,59.54%,44.07%,1
臺中市,西區,1138,769,161,930,48,978,1600,61.13%,48.06%,1
臺中市,西區,1139,715,200,915,51,966,1710,56.49%,41.81%,1
臺中市,西區,1140,514,136,650,26,676,1139,59.35%,45.13%,1
臺中市,西區,1141,522,128,650,32,682,1105,61.72%,47.24%,1
臺中市,西區,1142,649,172,821,43,864,1498,57.68%,43.32%,1
臺中市,西區,1143,705,203,908,35,943,1921,49.09%,36.7%,1
臺中市,西區,1144,569,161,730,50,780,1340,58.21%,42.46%,1
臺中市,西區,1145,711,197,908,19,927,1536,60.35%,46.29%,1
臺中市,西區,1146,563,176,739,66,805,1361,59.15%,41.37%,1
臺中市,西區,1147,703,159,862,30,892,1430,62.38%,49.16%,1
臺中市,北區,0983,571,158,729,27,756,1437,52.61%,39.74%,1
臺中市,北區,0984,647,218,865,65,930,1708,54.45%,37.88%,1
臺中市,北區,0985,419,91,510,32,542,1051,51.57%,39.87%,1
臺中市,北區,0986,448,107,555,30,585,996,58.73%,44.98%,1
臺中市,北區,0987,724,119,843,20,863,1504,57.38%,48.14%,1
臺中市,北區,0988,441,111,552,53,605,975,62.05%,45.23%,1
臺中市,北區,0989,401,98,499,24,523,886,59.03%,45.26%,1
臺中市,北區,0990,423,106,529,41,570,1276,44.67%,33.15%,1
臺中市,北區,0991,358,96,454,30,484,938,51.6%,38.17%,1
臺中市,北區,0992,577,129,706,64,770,1404,54.84%,41.1%,1
臺中市,北區,0993,430,109,539,20,559,996,56.12%,43.17%,1
臺中市,北區,0994,337,111,448,44,492,869,56.62%,38.78%,1
臺中市,北區,0995,323,88,411,17,428,704,60.8%,45.88%,1
臺中市,北區,0996,447,78,525,20,545,979,55.67%,45.66%,1
臺中市,北區,0997,325,66,391,13,404,773,52.26%,42.04%,1
臺中市,北區,0998,369,63,432,18,450,759,59.29%,48.62%,1
臺中市,北區,0999,697,110,807,37,844,1438,58.69%,48.47%,1
臺中市,北區,1000,529,84,613,14,627,1212,51.73%,43.65%,1
臺中市,北區,1001,756,174,930,41,971,1731,56.09%,43.67%,1
臺中市,北區,1002,705,155,860,29,889,1445,61.52%,48.79%,1
臺中市,北區,1003,791,193,984,39,1023,1855,55.15%,42.64%,1
臺中市,北區,1004,698,120,818,53,871,1728,50.41%,40.39%,1
臺中市,北區,1005,745,175,920,45,965,1878,51.38%,39.67%,1
臺中市,北區,1006,695,179,874,63,937,1793,52.26%,38.76%,1
臺中市,北區,1007,790,53,843,54,897,1555,57.68%,50.8%,1
臺中市,北區,1008,674,150,824,28,852,1761,48.38%,38.27%,1
臺中市,北區,1009,695,136,831,27,858,1579,54.34%,44.02%,1
臺中市,北區,1010,931,193,1124,65,1189,2192,54.24%,42.47%,1
臺中市,北區,1011,721,160,881,50,931,1560,59.68%,46.22%,1
臺中市,北區,1012,632,178,810,44,854,1476,57.86%,42.82%,1
臺中市,北區,1013,485,106,591,31,622,1006,61.83%,48.21%,1
臺中市,北區,1014,624,150,774,36,810,1403,57.73%,44.48%,1
臺中市,北區,1015,549,151,700,23,723,1446,50%,37.97%,1
臺中市,北區,1016,611,162,773,42,815,1460,55.82%,41.85%,1
臺中市,北區,1017,546,120,666,21,687,1233,55.72%,44.28%,1
臺中市,北區,1018,531,123,654,20,674,1027,65.63%,51.7%,1
臺中市,北區,1019,538,131,669,22,691,1207,57.25%,44.57%,1
臺中市,北區,1020,549,132,681,30,711,1167,60.93%,47.04%,1
臺中市,北區,1021,493,126,619,23,642,1150,55.83%,42.87%,1
臺中市,北區,1022,476,121,597,30,627,1061,59.1%,44.86%,1
臺中市,北區,1023,441,129,570,20,590,1005,58.71%,43.88%,1
臺中市,北區,1024,546,133,679,22,701,1250,56.08%,43.68%,1
臺中市,北區,1025,645,159,804,51,855,1448,59.05%,44.54%,1
臺中市,北區,1026,649,130,779,60,839,1379,60.84%,47.06%,1
臺中市,北區,1027,707,192,899,59,958,1652,57.99%,42.8%,1
臺中市,北區,1028,795,175,970,40,1010,1867,54.1%,42.58%,1
臺中市,北區,1029,423,103,526,20,546,2078,26.28%,20.36%,1
臺中市,北區,1030,739,154,893,46,939,1562,60.12%,47.31%,1
臺中市,北區,1031,646,126,772,35,807,1430,56.43%,45.17%,1
臺中市,北區,1032,885,236,1121,38,1159,2018,57.43%,43.86%,1
臺中市,北區,1033,666,156,822,31,853,1710,49.88%,38.95%,1
臺中市,北區,1034,629,126,755,33,788,1432,55.03%,43.92%,1
臺中市,北區,1035,540,132,672,26,698,1157,60.33%,46.67%,1
臺中市,北區,1036,551,109,660,23,683,1188,57.49%,46.38%,1
臺中市,北區,1037,631,143,774,25,799,1419,56.31%,44.47%,1
臺中市,北區,1038,686,160,846,26,872,1653,52.75%,41.5%,1
臺中市,北區,1039,549,144,693,36,729,1233,59.12%,44.53%,1
臺中市,北區,1040,669,28,697,16,713,1243,57.36%,53.82%,1
臺中市,北區,1041,543,72,615,22,637,1219,52.26%,44.54%,1
臺中市,北區,1042,546,161,707,49,756,1272,59.43%,42.92%,1
臺中市,北區,1043,582,137,719,20,739,1285,57.51%,45.29%,1
臺中市,北區,1044,777,207,984,44,1028,1780,57.75%,43.65%,1
臺中市,北區,1045,579,136,715,27,742,1461,50.79%,39.63%,1
臺中市,北區,1046,639,134,773,56,829,1310,63.28%,48.78%,1
臺中市,北區,1047,708,160,868,29,897,1669,53.74%,42.42%,1
臺中市,北區,1048,870,189,1059,52,1111,1932,57.51%,45.03%,1
臺中市,北區,1049,714,185,899,36,935,1682,55.59%,42.45%,1
臺中市,北區,1050,736,219,955,43,998,1891,52.78%,38.92%,1
臺中市,北區,1051,783,210,993,70,1063,1882,56.48%,41.6%,1
臺中市,北區,1052,504,118,622,30,652,1159,56.26%,43.49%,1
臺中市,北區,1053,643,170,813,50,863,1553,55.57%,41.4%,1
臺中市,北區,1054,669,162,831,51,882,1607,54.88%,41.63%,1
臺中市,北區,1055,732,216,948,39,987,1773,55.67%,41.29%,1
臺中市,北區,1056,655,170,825,52,877,1524,57.55%,42.98%,1
臺中市,北區,1057,747,196,943,58,1001,1613,62.06%,46.31%,1
臺中市,北區,1058,885,182,1067,50,1117,1877,59.51%,47.15%,1
臺中市,北區,1059,793,187,980,52,1032,1792,57.59%,44.25%,1
臺中市,北區,1060,626,152,778,45,823,1392,59.12%,44.97%,1
臺中市,北區,1061,565,125,690,34,724,1297,55.82%,43.56%,1
臺中市,北區,1062,700,202,902,30,932,1556,59.9%,44.99%,1
臺中市,北區,1063,628,171,799,28,827,1497,55.24%,41.95%,1
臺中市,北區,1064,677,141,818,45,863,1550,55.68%,43.68%,1
臺中市,北區,1065,599,159,758,33,791,1434,55.16%,41.77%,1
臺中市,北區,1066,795,193,988,48,1036,1793,57.78%,44.34%,1
臺中市,北區,1067,808,195,1003,33,1036,1866,55.52%,43.3%,1
臺中市,北區,1068,604,128,732,67,799,1346,59.36%,44.87%,1
臺中市,北區,1069,546,129,675,54,729,1267,57.54%,43.09%,1
臺中市,西屯區,0625,761,201,962,50,1012,1638,61.78%,46.46%,1
臺中市,西屯區,0626,570,136,706,27,733,1335,54.91%,42.7%,1
臺中市,西屯區,0627,833,172,1005,50,1055,1776,59.4%,46.9%,1
臺中市,西屯區,0628,601,156,757,17,774,1351,57.29%,44.49%,1
臺中市,西屯區,0629,603,175,778,41,819,1338,61.21%,45.07%,1
臺中市,西屯區,0630,696,161,857,32,889,1582,56.19%,43.99%,1
臺中市,西屯區,0631,730,137,867,25,892,1710,52.16%,42.69%,1
臺中市,西屯區,0632,632,176,808,46,854,1595,53.54%,39.62%,1
臺中市,西屯區,0633,772,117,889,50,939,1585,59.24%,48.71%,1
臺中市,西屯區,0634,705,216,921,58,979,1749,55.97%,40.31%,1
臺中市,西屯區,0635,875,163,1038,48,1086,1877,57.86%,46.62%,1
臺中市,西屯區,0636,718,179,897,29,926,1697,54.57%,42.31%,1
臺中市,西屯區,0637,700,158,858,44,902,1480,60.95%,47.3%,1
臺中市,西屯區,0638,740,185,925,48,973,1483,65.61%,49.9%,1
臺中市,西屯區,0639,683,173,856,40,896,2484,36.07%,27.5%,1
臺中市,西屯區,0640,378,99,477,46,523,781,66.97%,48.4%,1
臺中市,西屯區,0641,678,154,832,57,889,1477,60.19%,45.9%,1
臺中市,西屯區,0642,809,156,965,36,1001,1784,56.11%,45.35%,1
臺中市,西屯區,0643,801,143,944,22,966,1686,57.3%,47.51%,1
臺中市,西屯區,0644,760,171,931,31,962,1692,56.86%,44.92%,1
臺中市,西屯區,0645,745,129,874,21,895,1659,53.95%,44.91%,1
臺中市,西屯區,0646,780,137,917,32,949,1648,57.58%,47.33%,1
臺中市,西屯區,0647,747,165,912,28,940,1536,61.2%,48.63%,1
臺中市,西屯區,0648,784,174,958,41,999,1666,59.96%,47.06%,1
臺中市,西屯區,0649,661,146,807,45,852,1428,59.66%,46.29%,1
臺中市,西屯區,0650,797,153,950,37,987,1810,54.53%,44.03%,1
臺中市,西屯區,0651,741,123,864,33,897,1574,56.99%,47.08%,1
臺中市,西屯區,0652,746,167,913,22,935,1650,56.67%,45.21%,1
臺中市,西屯區,0653,750,162,912,59,971,1681,57.76%,44.62%,1
臺中市,西屯區,0654,711,176,887,47,934,1656,56.4%,42.93%,1
臺中市,西屯區,0655,591,119,710,51,761,1243,61.22%,47.55%,1
臺中市,西屯區,0656,721,161,882,54,936,1471,63.63%,49.01%,1
臺中市,西屯區,0657,734,138,872,29,901,1431,62.96%,51.29%,1
臺中市,西屯區,0658,758,189,947,30,977,1714,57%,44.22%,1
臺中市,西屯區,0659,645,145,790,52,842,1424,59.13%,45.29%,1
臺中市,西屯區,0660,542,122,664,34,698,1176,59.35%,46.09%,1
臺中市,西屯區,0661,672,151,823,60,883,1456,60.65%,46.15%,1
臺中市,西屯區,0662,745,143,888,45,933,1451,64.3%,51.34%,1
臺中市,西屯區,0663,574,100,674,24,698,1063,65.66%,54%,1
臺中市,西屯區,0664,619,134,753,42,795,1357,58.59%,45.62%,1
臺中市,西屯區,0665,704,97,801,51,852,1355,62.88%,51.96%,1
臺中市,西屯區,0666,711,120,831,19,850,1384,61.42%,51.37%,1
臺中市,西屯區,0667,746,174,920,46,966,1613,59.89%,46.25%,1
臺中市,西屯區,0668,681,180,861,49,910,1562,58.26%,43.6%,1
臺中市,西屯區,0669,563,172,735,59,794,1219,65.14%,46.19%,1
臺中市,西屯區,0670,521,156,677,40,717,1235,58.06%,42.19%,1
臺中市,西屯區,0671,494,139,633,50,683,1131,60.39%,43.68%,1
臺中市,西屯區,0672,718,167,885,47,932,1494,62.38%,48.06%,1
臺中市,西屯區,0673,623,130,753,17,770,1325,58.11%,47.02%,1
臺中市,西屯區,0674,647,157,804,22,826,1386,59.6%,46.68%,1
臺中市,西屯區,0675,792,218,1010,63,1073,1816,59.09%,43.61%,1
臺中市,西屯區,0676,738,154,892,42,934,1734,53.86%,42.56%,1
臺中市,西屯區,0677,825,188,1013,53,1066,1777,59.99%,46.43%,1
臺中市,西屯區,0678,760,188,948,56,1004,1818,55.23%,41.8%,1
臺中市,西屯區,0679,734,156,890,74,964,1699,56.74%,43.2%,1
臺中市,西屯區,0680,680,162,842,43,885,1715,51.6%,39.65%,1
臺中市,西屯區,0681,712,139,851,41,892,1654,53.93%,43.05%,1
臺中市,西屯區,0682,702,160,862,23,885,1636,54.1%,42.91%,1
臺中市,西屯區,0683,550,149,699,22,721,1298,55.55%,42.37%,1
臺中市,西屯區,0684,636,162,798,41,839,1391,60.32%,45.72%,1
臺中市,西屯區,0685,858,188,1046,47,1093,1853,58.99%,46.3%,1
臺中市,西屯區,0686,787,164,951,56,1007,1820,55.33%,43.24%,1
臺中市,西屯區,0687,823,175,998,43,1041,1809,57.55%,45.49%,1
臺中市,西屯區,0688,659,139,798,44,842,1352,62.28%,48.74%,1
臺中市,西屯區,0689,663,158,821,58,879,1521,57.79%,43.59%,1
臺中市,西屯區,0690,685,172,857,46,903,1486,60.77%,46.1%,1
臺中市,西屯區,0691,750,191,941,42,983,1674,58.72%,44.8%,1
臺中市,西屯區,0692,761,193,954,54,1008,1610,62.61%,47.27%,1
臺中市,西屯區,0693,771,169,940,42,982,1695,57.94%,45.49%,1
臺中市,西屯區,0694,737,155,892,53,945,1684,56.12%,43.76%,1
臺中市,西屯區,0695,575,144,719,24,743,1221,60.85%,47.09%,1
臺中市,西屯區,0696,656,150,806,43,849,1252,67.81%,52.4%,1
臺中市,西屯區,0697,611,148,759,49,808,1301,62.11%,46.96%,1
臺中市,西屯區,0698,564,71,635,31,666,1049,63.49%,53.77%,1
臺中市,西屯區,0699,548,84,632,43,675,1113,60.65%,49.24%,1
臺中市,西屯區,0700,680,119,799,48,847,1557,54.4%,43.67%,1
臺中市,西屯區,0701,702,164,866,42,908,1640,55.37%,42.8%,1
臺中市,西屯區,0702,690,177,867,66,933,1402,66.55%,49.22%,1
臺中市,西屯區,0703,686,151,837,69,906,1717,52.77%,39.95%,1
臺中市,西屯區,0704,755,152,907,58,965,1688,57.17%,44.73%,1
臺中市,西屯區,0705,525,135,660,59,719,1168,61.56%,44.95%,1
臺中市,西屯區,0706,750,148,898,44,942,1729,54.48%,43.38%,1
臺中市,西屯區,0707,834,183,1017,42,1059,2007,52.77%,41.55%,1
臺中市,西屯區,0708,587,136,723,74,797,1296,61.5%,45.29%,1
臺中市,西屯區,0709,417,102,519,17,536,1068,50.19%,39.04%,1
臺中市,西屯區,0710,715,131,846,61,907,1707,53.13%,41.89%,1
臺中市,西屯區,0711,761,160,921,43,964,1636,58.92%,46.52%,1
臺中市,西屯區,0712,662,144,806,39,845,1761,47.98%,37.59%,1
臺中市,西屯區,0713,590,135,725,40,765,1314,58.22%,44.9%,1
臺中市,西屯區,0714,615,135,750,36,786,1233,63.75%,49.88%,1
臺中市,西屯區,0715,655,148,803,48,851,1549,54.94%,42.29%,1
臺中市,西屯區,0716,726,122,848,29,877,1639,53.51%,44.3%,1
臺中市,西屯區,0717,632,136,768,45,813,1486,54.71%,42.53%,1
臺中市,西屯區,0718,803,168,971,18,989,1806,54.76%,44.46%,1
臺中市,西屯區,0719,636,134,770,22,792,1451,54.58%,43.83%,1
臺中市,西屯區,0720,626,110,736,30,766,1302,58.83%,48.08%,1
臺中市,西屯區,0721,644,156,800,42,842,1353,62.23%,47.6%,1
臺中市,西屯區,0722,1001,203,1204,51,1255,2162,58.05%,46.3%,1
臺中市,西屯區,0723,668,143,811,54,865,1520,56.91%,43.95%,1
臺中市,西屯區,0724,862,151,1013,30,1043,1935,53.9%,44.55%,1
臺中市,西屯區,0725,809,190,999,46,1045,1847,56.58%,43.8%,1
臺中市,西屯區,0726,795,187,982,27,1009,1738,58.06%,45.74%,1
臺中市,西屯區,0727,791,171,962,43,1005,1640,61.28%,48.23%,1
臺中市,西屯區,0728,841,221,1062,35,1097,1908,57.49%,44.08%,1
臺中市,西屯區,0729,649,136,785,27,812,1402,57.92%,46.29%,1
臺中市,西屯區,0730,626,154,780,25,805,1515,53.14%,41.32%,1
臺中市,西屯區,0731,612,120,732,42,774,1541,50.23%,39.71%,1
臺中市,西屯區,0732,652,146,798,38,836,1502,55.66%,43.41%,1
臺中市,西屯區,0733,676,186,862,45,907,1526,59.44%,44.3%,1
臺中市,西屯區,0734,668,137,805,59,864,1425,60.63%,46.88%,1
臺中市,西屯區,0735,646,150,796,37,833,1334,62.44%,48.43%,1
臺中市,西屯區,0736,780,184,964,26,990,1649,60.04%,47.3%,1
臺中市,西屯區,0737,668,152,820,27,847,1566,54.09%,42.66%,1
臺中市,西屯區,0738,794,161,955,38,993,1629,60.96%,48.74%,1
臺中市,西屯區,0739,722,204,926,32,958,1628,58.85%,44.35%,1
臺中市,西屯區,0740,719,136,855,32,887,1442,61.51%,49.86%,1
臺中市,西屯區,0741,506,121,627,44,671,1206,55.64%,41.96%,1
臺中市,西屯區,0742,489,147,636,45,681,1086,62.71%,45.03%,1
臺中市,西屯區,0743,533,119,652,29,681,1088,62.59%,48.99%,1
臺中市,西屯區,0744,534,116,650,28,678,1140,59.47%,46.84%,1
臺中市,南屯區,0745,586,165,751,56,807,1321,61.09%,44.36%,1
臺中市,南屯區,0746,620,170,790,55,845,1346,62.78%,46.06%,1
臺中市,南屯區,0747,634,177,811,47,858,1428,60.08%,44.4%,1
臺中市,南屯區,0748,663,136,799,37,836,1442,57.98%,45.98%,1
臺中市,南屯區,0749,746,138,884,22,906,1408,64.35%,52.98%,1
臺中市,南屯區,0750,705,129,834,25,859,1404,61.18%,50.21%,1
臺中市,南屯區,0751,676,134,810,51,861,1354,63.59%,49.93%,1
臺中市,南屯區,0752,620,170,790,46,836,1332,62.76%,46.55%,1
臺中市,南屯區,0753,725,165,890,36,926,1463,63.29%,49.56%,1
臺中市,南屯區,0754,654,156,810,46,856,1413,60.58%,46.28%,1
臺中市,南屯區,0755,606,129,735,39,774,1218,63.55%,49.75%,1
臺中市,南屯區,0756,598,140,738,25,763,1308,58.33%,45.72%,1
臺中市,南屯區,0757,745,174,919,42,961,1527,62.93%,48.79%,1
臺中市,南屯區,0758,613,157,770,31,801,1294,61.9%,47.37%,1
臺中市,南屯區,0759,616,155,771,44,815,1516,53.76%,40.63%,1
臺中市,南屯區,0760,711,157,868,78,946,1529,61.87%,46.5%,1
臺中市,南屯區,0761,630,168,798,60,858,1397,61.42%,45.1%,1
臺中市,南屯區,0762,619,140,759,30,789,1406,56.12%,44.03%,1
臺中市,南屯區,0763,627,149,776,49,825,1497,55.11%,41.88%,1
臺中市,南屯區,0764,606,142,748,69,817,1424,57.37%,42.56%,1
臺中市,南屯區,0765,561,134,695,33,728,1488,48.92%,37.7%,1
臺中市,南屯區,0766,293,78,371,37,408,608,67.11%,48.19%,1
臺中市,南屯區,0767,365,111,476,52,528,813,64.94%,44.9%,1
臺中市,南屯區,0768,444,137,581,55,636,1190,53.45%,37.31%,1
臺中市,南屯區,0769,527,108,635,29,664,1174,56.56%,44.89%,1
臺中市,南屯區,0770,586,115,701,23,724,1224,59.15%,47.88%,1
臺中市,南屯區,0771,550,114,664,36,700,1466,47.75%,37.52%,1
臺中市,南屯區,0772,457,95,552,21,573,1333,42.99%,34.28%,1
臺中市,南屯區,0773,379,90,469,51,520,814,63.88%,46.56%,1
臺中市,南屯區,0774,586,144,730,55,785,1436,54.67%,40.81%,1
臺中市,南屯區,0775,692,163,855,52,907,1515,59.87%,45.68%,1
臺中市,南屯區,0776,649,118,767,37,804,1545,52.04%,42.01%,1
臺中市,南屯區,0777,646,133,779,35,814,1383,58.86%,46.71%,1
臺中市,南屯區,0778,697,123,820,37,857,1433,59.8%,48.64%,1
臺中市,南屯區,0779,468,123,591,34,625,1134,55.11%,41.27%,1
臺中市,南屯區,0780,634,94,728,34,762,1216,62.66%,52.14%,1
臺中市,南屯區,0781,542,129,671,64,735,1271,57.83%,42.64%,1
臺中市,南屯區,0782,521,116,637,28,665,1203,55.28%,43.31%,1
臺中市,南屯區,0783,577,142,719,23,742,1268,58.52%,45.5%,1
臺中市,南屯區,0784,628,154,782,52,834,1390,60%,45.18%,1
臺中市,南屯區,0785,629,150,779,38,817,1397,58.48%,45.03%,1
臺中市,南屯區,0786,672,188,860,62,922,1607,57.37%,41.82%,1
臺中市,南屯區,0787,750,158,908,34,942,1582,59.54%,47.41%,1
臺中市,南屯區,0788,760,165,925,42,967,1611,60.02%,47.18%,1
臺中市,南屯區,0789,622,184,806,36,842,1322,63.69%,47.05%,1
臺中市,南屯區,0790,684,143,827,32,859,1321,65.03%,51.78%,1
臺中市,南屯區,0791,650,120,770,41,811,1360,59.63%,47.79%,1
臺中市,南屯區,0792,665,136,801,13,814,1361,59.81%,48.86%,1
臺中市,南屯區,0793,616,143,759,33,792,1257,63.01%,49.01%,1
臺中市,南屯區,0794,623,133,756,26,782,1207,64.79%,51.62%,1
臺中市,南屯區,0795,667,126,793,23,816,1282,63.65%,52.03%,1
臺中市,南屯區,0796,654,137,791,27,818,1248,65.54%,52.4%,1
臺中市,南屯區,0797,675,140,815,37,852,1304,65.34%,51.76%,1
臺中市,南屯區,0798,590,121,711,33,744,1214,61.29%,48.6%,1
臺中市,南屯區,0799,555,114,669,39,708,1102,64.25%,50.36%,1
臺中市,南屯區,0800,850,169,1019,32,1051,1630,64.48%,52.15%,1
臺中市,南屯區,0801,677,124,801,32,833,1333,62.49%,50.79%,1
臺中市,南屯區,0802,651,144,795,29,824,1292,63.78%,50.39%,1
臺中市,南屯區,0803,617,129,746,37,783,1272,61.56%,48.51%,1
臺中市,南屯區,0804,670,110,780,39,819,1345,60.89%,49.81%,1
臺中市,南屯區,0805,524,135,659,28,687,981,70.03%,53.41%,1
臺中市,南屯區,0806,530,130,660,44,704,1097,64.18%,48.31%,1
臺中市,南屯區,0807,510,114,624,25,649,991,65.49%,51.46%,1
臺中市,南屯區,0808,552,131,683,27,710,1170,60.68%,47.18%,1
臺中市,南屯區,0809,585,125,710,41,751,1171,64.13%,49.96%,1
臺中市,南屯區,0810,587,162,749,57,806,1349,59.75%,43.51%,1
臺中市,南屯區,0811,685,155,840,34,874,1368,63.89%,50.07%,1
臺中市,南屯區,0812,635,150,785,33,818,1263,64.77%,50.28%,1
臺中市,南屯區,0813,746,183,929,39,968,1547,62.57%,48.22%,1
臺中市,南屯區,0814,772,175,947,42,989,1649,59.98%,46.82%,1
臺中市,南屯區,0815,720,165,885,33,918,1629,56.35%,44.2%,1
臺中市,南屯區,0816,642,176,818,41,859,1580,54.37%,40.63%,1
臺中市,南屯區,0817,752,169,921,26,947,1444,65.58%,52.08%,1
臺中市,南屯區,0818,659,143,802,23,825,1413,58.39%,46.64%,1
臺中市,南屯區,0819,649,127,776,29,805,1377,58.46%,47.13%,1
臺中市,南屯區,0820,682,206,888,45,933,1527,61.1%,44.66%,1
臺中市,南屯區,0821,659,145,804,33,837,1335,62.7%,49.36%,1
臺中市,南屯區,0822,831,172,1003,31,1034,1544,66.97%,53.82%,1
臺中市,南屯區,0823,715,215,930,43,973,1482,65.65%,48.25%,1
臺中市,南屯區,0824,689,182,871,57,928,1488,62.37%,46.3%,1
臺中市,南屯區,0825,608,174,782,33,815,1538,52.99%,39.53%,1
臺中市,南屯區,0826,803,185,988,69,1057,1674,63.14%,47.97%,1
臺中市,南屯區,0827,655,166,821,42,863,1996,43.24%,32.82%,1
臺中市,南屯區,0828,721,145,866,55,921,1514,60.83%,47.62%,1
臺中市,南屯區,0829,607,130,737,46,783,1217,64.34%,49.88%,1
臺中市,南屯區,0830,604,143,747,55,802,1347,59.54%,44.84%,1
臺中市,南屯區,0831,521,125,646,34,680,1109,61.32%,46.98%,1
臺中市,南屯區,0832,703,143,846,51,897,1546,58.02%,45.47%,1
臺中市,南屯區,0833,689,176,865,40,905,1408,64.28%,48.93%,1
臺中市,南屯區,0834,466,102,568,18,586,1057,55.44%,44.09%,1
臺中市,南屯區,0835,518,128,646,47,693,1133,61.17%,45.72%,1
臺中市,南屯區,0836,618,129,747,26,773,1278,60.49%,48.36%,1
臺中市,南屯區,0837,582,138,720,34,754,1144,65.91%,50.87%,1
臺中市,南屯區,0838,508,153,661,37,698,1140,61.23%,44.56%,1
臺中市,南屯區,0839,575,135,710,31,741,1171,63.28%,49.1%,1
臺中市,南屯區,0840,645,156,801,37,838,1303,64.31%,49.5%,1
臺中市,南屯區,0841,588,145,733,40,773,1402,55.14%,41.94%,1
臺中市,南屯區,0842,706,164,870,41,911,1571,57.99%,44.94%,1
臺中市,南屯區,0843,542,150,692,40,732,1139,64.27%,47.59%,1
臺中市,南屯區,0844,607,133,740,40,780,1216,64.14%,49.92%,1
臺中市,南屯區,0845,583,118,701,38,739,1162,63.6%,50.17%,1
臺中市,北屯區,0846,788,178,966,60,1026,1670,61.44%,47.19%,1
臺中市,北屯區,0847,715,155,870,61,931,1706,54.57%,41.91%,1
臺中市,北屯區,0848,646,169,815,69,884,1507,58.66%,42.87%,1
臺中市,北屯區,0849,735,200,935,47,982,1652,59.44%,44.49%,1
臺中市,北屯區,0850,458,91,549,25,574,1107,51.85%,41.37%,1
臺中市,北屯區,0851,881,197,1078,78,1156,2151,53.74%,40.96%,1
臺中市,北屯區,0852,780,148,928,25,953,1612,59.12%,48.39%,1
臺中市,北屯區,0853,774,161,935,44,979,1743,56.17%,44.41%,1
臺中市,北屯區,0854,863,198,1061,42,1103,2099,52.55%,41.11%,1
臺中市,北屯區,0855,753,139,892,0,892,1595,55.92%,47.21%,1
臺中市,北屯區,0856,791,168,959,55,1014,1923,52.73%,41.13%,1
臺中市,北屯區,0857,713,146,859,54,913,1641,55.64%,43.45%,1
臺中市,北屯區,0858,582,124,706,25,731,1157,63.18%,50.3%,1
臺中市,北屯區,0859,538,89,627,37,664,1041,63.78%,51.68%,1
臺中市,北屯區,0860,640,163,803,46,849,1563,54.32%,40.95%,1
臺中市,北屯區,0861,640,140,780,60,840,1559,53.88%,41.05%,1
臺中市,北屯區,0862,587,97,684,17,701,1411,49.68%,41.6%,1
臺中市,北屯區,0863,829,175,1004,34,1038,1761,58.94%,47.08%,1
臺中市,北屯區,0864,646,159,805,50,855,1361,62.82%,47.47%,1
臺中市,北屯區,0865,802,194,996,60,1056,1852,57.02%,43.3%,1
臺中市,北屯區,0866,888,180,1068,39,1107,1928,57.42%,46.06%,1
臺中市,北屯區,0867,749,179,928,29,957,1492,64.14%,50.2%,1
臺中市,北屯區,0868,860,182,1042,56,1098,1998,54.95%,43.04%,1
臺中市,北屯區,0869,622,165,787,38,825,1272,64.86%,48.9%,1
臺中市,北屯區,0870,633,139,772,40,812,1317,61.66%,48.06%,1
臺中市,北屯區,0871,515,140,655,64,719,1327,54.18%,38.81%,1
臺中市,北屯區,0872,519,131,650,26,676,1280,52.81%,40.55%,1
臺中市,北屯區,0873,762,164,926,54,980,1865,52.55%,40.86%,1
臺中市,北屯區,0874,613,119,732,51,783,1230,63.66%,49.84%,1
臺中市,北屯區,0875,571,113,684,43,727,1356,53.61%,42.11%,1
臺中市,北屯區,0876,791,147,938,53,991,1732,57.22%,45.67%,1
臺中市,北屯區,0877,760,147,907,37,944,1586,59.52%,47.92%,1
臺中市,北屯區,0878,647,130,777,35,812,1441,56.35%,44.9%,1
臺中市,北屯區,0879,865,193,1058,54,1112,2045,54.38%,42.3%,1
臺中市,北屯區,0880,741,198,939,68,1007,1914,52.61%,38.71%,1
臺中市,北屯區,0881,859,170,1029,58,1087,1918,56.67%,44.79%,1
臺中市,北屯區,0882,906,145,1051,33,1084,2079,52.14%,43.58%,1
臺中市,北屯區,0883,902,208,1110,63,1173,2040,57.5%,44.22%,1
臺中市,北屯區,0884,812,145,957,52,1009,2027,49.78%,40.06%,1
臺中市,北屯區,0885,614,130,744,45,789,1402,56.28%,43.79%,1
臺中市,北屯區,0886,842,176,1018,45,1063,1826,58.21%,46.11%,1
臺中市,北屯區,0887,902,158,1060,26,1086,2162,50.23%,41.72%,1
臺中市,北屯區,0888,886,204,1090,22,1112,2332,47.68%,37.99%,1
臺中市,北屯區,0889,450,93,543,37,580,985,58.88%,45.69%,1
臺中市,北屯區,0890,675,220,895,28,923,2037,45.31%,33.14%,1
臺中市,北屯區,0891,489,101,590,42,632,1032,61.24%,47.38%,1
臺中市,北屯區,0892,499,95,594,30,624,1062,58.76%,46.99%,1
臺中市,北屯區,0893,381,91,472,49,521,909,57.32%,41.91%,1
臺中市,北屯區,0894,702,127,829,43,872,1445,60.35%,48.58%,1
臺中市,北屯區,0895,769,173,942,39,981,1842,53.26%,41.75%,1
臺中市,北屯區,0896,572,117,689,28,717,1187,60.4%,48.19%,1
臺中市,北屯區,0897,655,153,808,30,838,1456,57.55%,44.99%,1
臺中市,北屯區,0898,809,198,1007,65,1072,1866,57.45%,43.35%,1
臺中市,北屯區,0899,702,148,850,47,897,1667,53.81%,42.11%,1
臺中市,北屯區,0900,768,164,932,21,953,1683,56.63%,45.63%,1
臺中市,北屯區,0901,713,166,879,22,901,1642,54.87%,43.42%,1
臺中市,北屯區,0902,681,144,825,17,842,1475,57.08%,46.17%,1
臺中市,北屯區,0903,739,116,855,29,884,1644,53.77%,44.95%,1
臺中市,北屯區,0904,791,137,928,25,953,1603,59.45%,49.34%,1
臺中市,北屯區,0905,899,200,1099,58,1157,1949,59.36%,46.13%,1
臺中市,北屯區,0906,896,186,1082,37,1119,1790,62.51%,50.06%,1
臺中市,北屯區,0907,667,147,814,36,850,1440,59.03%,46.32%,1
臺中市,北屯區,0908,742,187,929,44,973,1601,60.77%,46.35%,1
臺中市,北屯區,0909,643,162,805,53,858,1527,56.19%,42.11%,1
臺中市,北屯區,0910,668,176,844,47,891,1675,53.19%,39.88%,1
臺中市,北屯區,0911,611,138,749,41,790,1579,50.03%,38.7%,1
臺中市,北屯區,0912,681,128,809,75,884,1524,58.01%,44.69%,1
臺中市,北屯區,0913,713,148,861,55,916,1677,54.62%,42.52%,1
臺中市,北屯區,0914,707,149,856,49,905,1599,56.6%,44.22%,1
臺中市,北屯區,0915,661,170,831,55,886,1458,60.77%,45.34%,1
臺中市,北屯區,0916,741,155,896,50,946,1571,60.22%,47.17%,1
臺中市,北屯區,0917,691,184,875,62,937,1579,59.34%,43.76%,1
臺中市,北屯區,0918,828,208,1036,50,1086,1849,58.73%,44.78%,1
臺中市,北屯區,0919,753,169,922,42,964,1682,57.31%,44.77%,1
臺中市,北屯區,0920,788,148,936,31,967,1760,54.94%,44.77%,1
臺中市,北屯區,0921,758,168,926,64,990,1699,58.27%,44.61%,1
臺中市,北屯區,0922,780,174,954,48,1002,1626,61.62%,47.97%,1
臺中市,北屯區,0923,675,206,881,10,891,1491,59.76%,45.27%,1
臺中市,北屯區,0924,679,179,858,31,889,1640,54.21%,41.4%,1
臺中市,北屯區,0925,885,195,1080,55,1135,2052,55.31%,43.13%,1
臺中市,北屯區,0926,836,192,1028,44,1072,1875,57.17%,44.59%,1
臺中市,北屯區,0927,687,151,838,21,859,1559,55.1%,44.07%,1
臺中市,北屯區,0928,659,155,814,69,883,1480,59.66%,44.53%,1
臺中市,北屯區,0929,617,172,789,52,841,1397,60.2%,44.17%,1
臺中市,北屯區,0930,850,206,1056,41,1097,1889,58.07%,45%,1
臺中市,北屯區,0931,709,205,914,57,971,1728,56.19%,41.03%,1
臺中市,北屯區,0932,666,162,828,63,891,1592,55.97%,41.83%,1
臺中市,北屯區,0933,706,146,852,67,919,1656,55.5%,42.63%,1
臺中市,北屯區,0934,631,138,769,55,824,1524,54.07%,41.4%,1
臺中市,北屯區,0935,664,175,839,42,881,1502,58.66%,44.21%,1
臺中市,北屯區,0936,780,175,955,35,990,1772,55.87%,44.02%,1
臺中市,北屯區,0937,701,89,790,36,826,1461,56.54%,47.98%,1
臺中市,北屯區,0938,732,141,873,22,895,1769,50.59%,41.38%,1
臺中市,北屯區,0939,840,220,1060,68,1128,1894,59.56%,44.35%,1
臺中市,北屯區,0940,796,213,1009,58,1067,2033,52.48%,39.15%,1
臺中市,北屯區,0941,824,200,1024,40,1064,1947,54.65%,42.32%,1
臺中市,北屯區,0942,926,269,1195,60,1255,2188,57.36%,42.32%,1
臺中市,北屯區,0943,785,178,963,37,1000,1661,60.2%,47.26%,1
臺中市,北屯區,0944,762,166,928,46,974,1667,58.43%,45.71%,1
臺中市,北屯區,0945,760,161,921,39,960,1728,55.56%,43.98%,1
臺中市,北屯區,0946,726,145,871,38,909,1688,53.85%,43.01%,1
臺中市,北屯區,0947,686,142,828,24,852,1475,57.76%,46.51%,1
臺中市,北屯區,0948,823,180,1003,32,1035,1681,61.57%,48.96%,1
臺中市,北屯區,0949,970,198,1168,46,1214,2078,58.42%,46.68%,1
臺中市,北屯區,0950,910,206,1116,45,1161,2059,56.39%,44.2%,1
臺中市,北屯區,0951,829,176,1005,38,1043,1792,58.2%,46.26%,1
臺中市,北屯區,0952,819,193,1012,32,1044,2974,35.1%,27.54%,1
臺中市,北屯區,0953,466,115,581,46,627,1072,58.49%,43.47%,1
臺中市,北屯區,0954,835,418,1253,51,1304,2099,62.12%,39.78%,1
臺中市,北屯區,0955,901,220,1121,44,1165,1823,63.91%,49.42%,1
臺中市,北屯區,0956,973,193,1166,69,1235,2022,61.08%,48.12%,1
臺中市,北屯區,0957,904,194,1098,31,1129,1992,56.68%,45.38%,1
臺中市,北屯區,0958,742,181,923,56,979,1585,61.77%,46.81%,1
臺中市,北屯區,0959,737,178,915,46,961,1565,61.41%,47.09%,1
臺中市,北屯區,0960,709,141,850,45,895,1780,50.28%,39.83%,1
臺中市,北屯區,0961,894,208,1102,51,1153,1874,61.53%,47.71%,1
臺中市,北屯區,0962,858,149,1007,42,1049,1755,59.77%,48.89%,1
臺中市,北屯區,0963,810,159,969,37,1006,1497,67.2%,54.11%,1
臺中市,北屯區,0964,772,162,934,52,986,1567,62.92%,49.27%,1
臺中市,北屯區,0965,737,126,863,42,905,1624,55.73%,45.38%,1
臺中市,北屯區,0966,773,169,942,43,985,1614,61.03%,47.89%,1
臺中市,北屯區,0967,747,143,890,22,912,1595,57.18%,46.83%,1
臺中市,北屯區,0968,764,121,885,64,949,1782,53.25%,42.87%,1
臺中市,北屯區,0969,550,113,663,24,687,1357,50.63%,40.53%,1
臺中市,北屯區,0970,469,96,565,58,623,1071,58.17%,43.79%,1
臺中市,北屯區,0971,591,127,718,42,760,1372,55.39%,43.08%,1
臺中市,北屯區,0972,655,139,794,54,848,1415,59.93%,46.29%,1
臺中市,北屯區,0973,858,184,1042,62,1104,1789,61.71%,47.96%,1
臺中市,北屯區,0974,933,188,1121,72,1193,1907,62.56%,48.93%,1
臺中市,北屯區,0975,947,186,1133,53,1186,2008,59.06%,47.16%,1
臺中市,北屯區,0976,689,142,831,47,878,1541,56.98%,44.71%,1
臺中市,北屯區,0977,769,172,941,54,995,1669,59.62%,46.08%,1
臺中市,北屯區,0978,775,156,931,25,956,1685,56.74%,45.99%,1
臺中市,北屯區,0979,805,202,1007,54,1061,1785,59.44%,45.1%,1
臺中市,北屯區,0980,751,173,924,55,979,1596,61.34%,47.06%,1
臺中市,北屯區,0981,803,189,992,54,1046,1731,60.43%,46.39%,1
臺中市,北屯區,0982,641,151,792,59,851,1496,56.89%,42.85%,1
臺中市,豐原區,0394,400,121,521,39,560,983,56.97%,40.69%,1
臺中市,豐原區,0395,572,153,725,58,783,1309,59.82%,43.7%,1
臺中市,豐原區,0396,485,156,641,57,698,1116,62.54%,43.46%,1
臺中市,豐原區,0397,457,114,571,37,608,945,64.34%,48.36%,1
臺中市,豐原區,0398,359,135,494,57,551,850,64.82%,42.24%,1
臺中市,豐原區,0399,367,88,455,34,489,760,64.34%,48.29%,1
臺中市,豐原區,0400,719,176,895,12,907,1617,56.09%,44.47%,1
臺中市,豐原區,0401,704,144,848,46,894,1677,53.31%,41.98%,1
臺中市,豐原區,0402,883,197,1080,37,1117,1771,63.07%,49.86%,1
臺中市,豐原區,0403,462,128,590,72,662,1145,57.82%,40.35%,1
臺中市,豐原區,0404,618,126,744,26,770,1362,56.53%,45.37%,1
臺中市,豐原區,0405,661,133,794,41,835,1389,60.12%,47.59%,1
臺中市,豐原區,0406,703,177,880,60,940,1530,61.44%,45.95%,1
臺中市,豐原區,0407,646,161,807,76,883,1471,60.03%,43.92%,1
臺中市,豐原區,0408,616,165,781,74,855,1410,60.64%,43.69%,1
臺中市,豐原區,0409,490,131,621,47,668,1162,57.49%,42.17%,1
臺中市,豐原區,0410,740,169,909,34,943,1656,56.94%,44.69%,1
臺中市,豐原區,0411,799,194,993,51,1044,1838,56.8%,43.47%,1
臺中市,豐原區,0412,717,171,888,56,944,1666,56.66%,43.04%,1
臺中市,豐原區,0413,825,193,1018,80,1098,1821,60.3%,45.3%,1
臺中市,豐原區,0414,927,220,1147,64,1211,1821,66.5%,50.91%,1
臺中市,豐原區,0415,696,188,884,30,914,1647,55.49%,42.26%,1
臺中市,豐原區,0416,595,177,772,66,838,1256,66.72%,47.37%,1
臺中市,豐原區,0417,777,172,949,49,998,1552,64.3%,50.06%,1
臺中市,豐原區,0418,810,188,998,44,1042,1793,58.11%,45.18%,1
臺中市,豐原區,0419,401,107,508,37,545,759,71.81%,52.83%,1
臺中市,豐原區,0420,283,103,386,37,423,642,65.89%,44.08%,1
臺中市,豐原區,0421,702,166,868,28,896,1528,58.64%,45.94%,1
臺中市,豐原區,0422,871,208,1079,62,1141,1788,63.81%,48.71%,1
臺中市,豐原區,0423,814,198,1012,70,1082,1663,65.06%,48.95%,1
臺中市,豐原區,0424,640,177,817,54,871,1260,69.13%,50.79%,1
臺中市,豐原區,0425,415,76,491,31,522,902,57.87%,46.01%,1
臺中市,豐原區,0426,587,112,699,30,729,1357,53.72%,43.26%,1
臺中市,豐原區,0427,777,151,928,36,964,1592,60.55%,48.81%,1
臺中市,豐原區,0428,882,153,1035,69,1104,1873,58.94%,47.09%,1
臺中市,豐原區,0429,850,156,1006,54,1060,1867,56.78%,45.53%,1
臺中市,豐原區,0430,791,198,989,71,1060,1823,58.15%,43.39%,1
臺中市,豐原區,0431,792,174,966,63,1029,1962,52.45%,40.37%,1
臺中市,豐原區,0432,1074,275,1349,74,1423,2313,61.52%,46.43%,1
臺中市,豐原區,0433,711,180,891,50,941,1510,62.32%,47.09%,1
臺中市,豐原區,0434,833,204,1037,67,1104,1824,60.53%,45.67%,1
臺中市,豐原區,0435,595,200,795,30,825,1363,60.53%,43.65%,1
臺中市,豐原區,0436,161,755,916,0,916,1535,59.67%,10.49%,1
臺中市,豐原區,0437,661,196,857,53,910,1457,62.46%,45.37%,1
臺中市,豐原區,0438,545,150,695,35,730,1184,61.66%,46.03%,1
臺中市,豐原區,0439,885,166,1051,63,1114,2299,48.46%,38.49%,1
臺中市,豐原區,0440,888,195,1083,70,1153,1940,59.43%,45.77%,1
臺中市,豐原區,0441,901,188,1089,56,1145,2067,55.39%,43.59%,1
臺中市,豐原區,0442,891,183,1074,80,1154,2038,56.62%,43.72%,1
臺中市,豐原區,0443,778,215,993,53,1046,1835,57%,42.4%,1
臺中市,豐原區,0444,821,242,1063,74,1137,1979,57.45%,41.49%,1
臺中市,豐原區,0445,882,178,1060,67,1127,2014,55.96%,43.79%,1
臺中市,豐原區,0446,980,242,1222,100,1322,2257,58.57%,43.42%,1
臺中市,豐原區,0447,663,152,815,73,888,1406,63.16%,47.16%,1
臺中市,豐原區,0448,649,159,808,44,852,1418,60.08%,45.77%,1
臺中市,豐原區,0449,903,166,1069,69,1138,1772,64.22%,50.96%,1
臺中市,豐原區,0450,574,144,718,42,760,1202,63.23%,47.75%,1
臺中市,豐原區,0451,680,173,853,38,891,1447,61.58%,46.99%,1
臺中市,豐原區,0452,809,206,1015,69,1084,1758,61.66%,46.02%,1
臺中市,豐原區,0453,741,188,929,56,985,1546,63.71%,47.93%,1
臺中市,豐原區,0454,914,160,1074,50,1124,1815,61.93%,50.36%,1
臺中市,豐原區,0455,883,237,1120,51,1171,1932,60.61%,45.7%,1
臺中市,豐原區,0456,872,202,1074,58,1132,1770,63.95%,49.27%,1
臺中市,豐原區,0457,710,131,841,36,877,1560,56.22%,45.51%,1
臺中市,豐原區,0458,824,191,1015,33,1048,1810,57.9%,45.52%,1
臺中市,豐原區,0459,796,181,977,50,1027,1653,62.13%,48.15%,1
臺中市,豐原區,0460,673,135,808,57,865,1444,59.9%,46.61%,1
臺中市,豐原區,0461,639,136,775,51,826,1318,62.67%,48.48%,1
臺中市,豐原區,0462,682,187,869,79,948,1566,60.54%,43.55%,1
臺中市,豐原區,0463,788,166,954,67,1021,1748,58.41%,45.08%,1
臺中市,豐原區,0464,732,162,894,76,970,1772,54.74%,41.31%,1
臺中市,豐原區,0465,744,190,934,74,1008,1721,58.57%,43.23%,1
臺中市,豐原區,0466,720,185,905,48,953,1578,60.39%,45.63%,1
臺中市,豐原區,0467,784,224,1008,76,1084,1859,58.31%,42.17%,1
臺中市,豐原區,0468,647,172,819,46,865,1479,58.49%,43.75%,1
臺中市,豐原區,0469,850,205,1055,42,1097,1889,58.07%,45%,1
臺中市,豐原區,0470,841,154,995,37,1032,1803,57.24%,46.64%,1
臺中市,豐原區,0471,591,173,764,57,821,1421,57.78%,41.59%,1
臺中市,豐原區,0472,710,228,938,63,1001,1585,63.15%,44.79%,1
臺中市,豐原區,0473,871,183,1054,66,1120,1774,63.13%,49.1%,1
臺中市,豐原區,0474,969,222,1191,70,1261,2132,59.15%,45.45%,1
臺中市,豐原區,0475,674,164,838,66,904,1515,59.67%,44.49%,1
臺中市,豐原區,0476,560,124,684,19,703,1359,51.73%,41.21%,1
臺中市,豐原區,0477,437,104,541,54,595,948,62.76%,46.1%,1
臺中市,豐原區,0478,508,158,666,45,711,1134,62.7%,44.8%,1
臺中市,豐原區,0479,554,145,699,50,749,1114,67.24%,49.73%,1
臺中市,豐原區,0480,464,130,594,44,638,1050,60.76%,44.19%,1
臺中市,豐原區,0481,588,143,731,43,774,1182,65.48%,49.75%,1
臺中市,東勢區,1513,552,125,677,48,725,1299,55.81%,42.49%,1
臺中市,東勢區,1514,410,110,520,44,564,1007,56.01%,40.71%,1
臺中市,東勢區,1515,343,74,417,63,480,859,55.88%,39.93%,1
臺中市,東勢區,1516,473,123,596,61,657,991,66.3%,47.73%,1
臺中市,東勢區,1517,322,90,412,23,435,863,50.41%,37.31%,1
臺中市,東勢區,1518,653,165,818,105,923,1628,56.7%,40.11%,1
臺中市,東勢區,1519,513,137,650,49,699,1335,52.36%,38.43%,1
臺中市,東勢區,1520,530,118,648,50,698,1092,63.92%,48.53%,1
臺中市,東勢區,1521,494,129,623,46,669,1050,63.71%,47.05%,1
臺中市,東勢區,1522,646,134,780,45,825,1431,57.65%,45.14%,1
臺中市,東勢區,1523,638,135,773,52,825,1372,60.13%,46.5%,1
臺中市,東勢區,1524,647,139,786,48,834,1412,59.07%,45.82%,1
臺中市,東勢區,1525,386,80,466,52,518,878,59%,43.96%,1
臺中市,東勢區,1526,541,142,683,70,753,1475,51.05%,36.68%,1
臺中市,東勢區,1527,380,63,443,22,465,872,53.33%,43.58%,1
臺中市,東勢區,1528,420,97,517,52,569,1006,56.56%,41.75%,1
臺中市,東勢區,1529,537,121,658,18,676,1222,55.32%,43.94%,1
臺中市,東勢區,1530,608,150,758,55,813,1228,66.21%,49.51%,1
臺中市,東勢區,1531,477,113,590,28,618,1036,59.65%,46.04%,1
臺中市,東勢區,1532,454,109,563,27,590,977,60.39%,46.47%,1
臺中市,東勢區,1533,616,111,727,34,761,1395,54.55%,44.16%,1
臺中市,東勢區,1534,525,137,662,77,739,1169,63.22%,44.91%,1
臺中市,東勢區,1535,477,114,591,50,641,1027,62.41%,46.45%,1
臺中市,東勢區,1536,470,82,552,27,579,984,58.84%,47.76%,1
臺中市,東勢區,1537,486,80,566,35,601,866,69.4%,56.12%,1
臺中市,東勢區,1538,483,101,584,54,638,1031,61.88%,46.85%,1
臺中市,東勢區,1539,451,78,529,47,576,865,66.59%,52.14%,1
臺中市,東勢區,1540,666,113,779,70,849,1357,62.56%,49.08%,1
臺中市,東勢區,1541,360,64,424,24,448,736,60.87%,48.91%,1
臺中市,東勢區,1542,596,124,720,50,770,1314,58.6%,45.36%,1
臺中市,東勢區,1543,655,157,812,97,909,1677,54.2%,39.06%,1
臺中市,東勢區,1544,448,94,542,33,575,950,60.53%,47.16%,1
臺中市,東勢區,1545,476,105,581,48,629,1007,62.46%,47.27%,1
臺中市,東勢區,1546,416,159,575,45,620,1214,51.07%,34.27%,1
臺中市,東勢區,1547,397,94,491,29,520,907,57.33%,43.77%,1
臺中市,東勢區,1548,363,103,466,34,500,902,55.43%,40.24%,1
臺中市,東勢區,1549,249,61,310,9,319,720,44.31%,34.58%,1
臺中市,東勢區,1550,231,64,295,10,305,666,45.8%,34.68%,1
臺中市,東勢區,1551,569,116,685,52,737,1361,54.15%,41.81%,1
臺中市,大甲區,0001,584,152,736,70,806,1356,59.44%,43.07%,1
臺中市,大甲區,0002,494,115,609,50,659,1059,62.23%,46.65%,1
臺中市,大甲區,0003,307,106,413,27,440,694,63.4%,44.24%,1
臺中市,大甲區,0004,368,126,494,23,517,874,59.15%,42.11%,1
臺中市,大甲區,0005,318,81,399,30,429,763,56.23%,41.68%,1
臺中市,大甲區,0006,424,88,512,35,547,856,63.9%,49.53%,1
臺中市,大甲區,0007,536,163,699,36,735,1249,58.85%,42.91%,1
臺中市,大甲區,0008,382,82,464,32,496,922,53.8%,41.43%,1
臺中市,大甲區,0009,533,125,658,35,693,1189,58.28%,44.83%,1
臺中市,大甲區,0010,530,103,633,49,682,1065,64.04%,49.77%,1
臺中市,大甲區,0011,580,151,731,73,804,1252,64.22%,46.33%,1
臺中市,大甲區,0012,436,135,571,33,604,1057,57.14%,41.25%,1
臺中市,大甲區,0013,453,110,563,31,594,1031,57.61%,43.94%,1
臺中市,大甲區,0014,481,150,631,40,671,1060,63.3%,45.38%,1
臺中市,大甲區,0015,572,142,714,51,765,1311,58.35%,43.63%,1
臺中市,大甲區,0016,648,126,774,44,818,1424,57.44%,45.51%,1
臺中市,大甲區,0017,750,73,823,58,881,1670,52.75%,44.91%,1
臺中市,大甲區,0018,362,70,432,44,476,812,58.62%,44.58%,1
臺中市,大甲區,0019,399,87,486,21,507,863,58.75%,46.23%,1
臺中市,大甲區,0020,735,171,906,42,948,1598,59.32%,45.99%,1
臺中市,大甲區,0021,720,155,875,36,911,1588,57.37%,45.34%,1
臺中市,大甲區,0022,503,136,639,52,691,1197,57.73%,42.02%,1
臺中市,大甲區,0023,425,114,539,76,615,1106,55.61%,38.43%,1
臺中市,大甲區,0024,422,101,523,48,571,903,63.23%,46.73%,1
臺中市,大甲區,0025,392,123,515,29,544,869,62.6%,45.11%,1
臺中市,大甲區,0026,588,165,753,24,777,1350,57.56%,43.56%,1
臺中市,大甲區,0027,498,124,622,65,687,1144,60.05%,43.53%,1
臺中市,大甲區,0028,552,133,685,48,733,1208,60.68%,45.7%,1
臺中市,大甲區,0029,698,179,877,33,910,1567,58.07%,44.54%,1
臺中市,大甲區,0030,628,130,758,30,788,1246,63.24%,50.4%,1
臺中市,大甲區,0031,342,92,434,38,472,767,61.54%,44.59%,1
臺中市,大甲區,0032,361,77,438,41,479,790,60.63%,45.7%,1
臺中市,大甲區,0033,458,93,551,28,579,972,59.57%,47.12%,1
臺中市,大甲區,0034,591,125,716,51,767,1388,55.26%,42.58%,1
臺中市,大甲區,0035,541,131,672,34,706,1331,53.04%,40.65%,1
臺中市,大甲區,0036,552,131,683,40,723,1167,61.95%,47.3%,1
臺中市,大甲區,0037,867,171,1038,62,1100,1934,56.88%,44.83%,1
臺中市,大甲區,0038,489,124,613,46,659,1263,52.18%,38.72%,1
臺中市,大甲區,0039,621,158,779,50,829,1390,59.64%,44.68%,1
臺中市,大甲區,0040,427,107,534,27,561,1186,47.3%,36%,1
臺中市,大甲區,0041,612,136,748,27,775,1397,55.48%,43.81%,1
臺中市,大甲區,0042,408,74,482,15,497,1173,42.37%,34.78%,1
臺中市,大甲區,0043,568,139,707,66,773,1398,55.29%,40.63%,1
臺中市,大甲區,0044,443,144,587,53,640,1228,52.12%,36.07%,1
臺中市,大甲區,0045,506,134,640,41,681,1258,54.13%,40.22%,1
臺中市,大甲區,0046,613,138,751,35,786,1435,54.77%,42.72%,1
臺中市,大甲區,0047,615,178,793,47,840,1532,54.83%,40.14%,1
臺中市,大甲區,0048,284,62,346,30,376,652,57.67%,43.56%,1
臺中市,大甲區,0049,315,81,396,26,422,870,48.51%,36.21%,1
臺中市,大甲區,0050,333,99,432,28,460,891,51.63%,37.37%,1
臺中市,大甲區,0051,349,72,421,30,451,784,57.53%,44.52%,1
臺中市,大甲區,0052,534,136,670,75,745,1368,54.46%,39.04%,1
臺中市,大甲區,0053,437,116,553,48,601,1126,53.37%,38.81%,1
臺中市,大甲區,0054,538,124,662,68,730,1486,49.13%,36.2%,1
臺中市,清水區,0091,447,114,561,19,580,1076,53.9%,41.54%,1
臺中市,清水區,0092,472,106,578,47,625,953,65.58%,49.53%,1
臺中市,清水區,0093,418,117,535,38,573,914,62.69%,45.73%,1
臺中市,清水區,0094,561,135,696,37,733,1143,64.13%,49.08%,1
臺中市,清水區,0095,307,98,405,20,425,680,62.5%,45.15%,1
臺中市,清水區,0096,425,95,520,38,558,904,61.73%,47.01%,1
臺中市,清水區,0097,436,107,543,32,575,893,64.39%,48.82%,1
臺中市,清水區,0098,712,172,884,34,918,1577,58.21%,45.15%,1
臺中市,清水區,0099,316,67,383,26,409,690,59.28%,45.8%,1
臺中市,清水區,0100,181,53,234,13,247,403,61.29%,44.91%,1
臺中市,清水區,0101,644,148,792,52,844,1413,59.73%,45.58%,1
臺中市,清水區,0102,338,92,430,35,465,777,59.85%,43.5%,1
臺中市,清水區,0103,613,151,764,27,791,1313,60.24%,46.69%,1
臺中市,清水區,0104,693,161,854,45,899,1439,62.47%,48.16%,1
臺中市,清水區,0105,533,123,656,23,679,1265,53.68%,42.13%,1
臺中市,清水區,0106,626,139,765,29,794,1277,62.18%,49.02%,1
臺中市,清水區,0107,628,105,733,37,770,1276,60.34%,49.22%,1
臺中市,清水區,0108,734,104,838,27,865,1376,62.86%,53.34%,1
臺中市,清水區,0109,649,132,781,25,806,1291,62.43%,50.27%,1
臺中市,清水區,0110,697,163,860,57,917,1510,60.73%,46.16%,1
臺中市,清水區,0111,720,147,867,63,930,1524,61.02%,47.24%,1
臺中市,清水區,0112,611,131,742,40,782,1474,53.05%,41.45%,1
臺中市,清水區,0113,679,139,818,42,860,1507,57.07%,45.06%,1
臺中市,清水區,0114,636,159,795,66,861,1321,65.18%,48.15%,1
臺中市,清水區,0115,474,110,584,19,603,1157,52.12%,40.97%,1
臺中市,清水區,0116,591,129,720,30,750,1255,59.76%,47.09%,1
臺中市,清水區,0117,382,94,476,22,498,881,56.53%,43.36%,1
臺中市,清水區,0118,532,91,623,44,667,1083,61.59%,49.12%,1
臺中市,清水區,0119,481,78,559,22,581,951,61.09%,50.58%,1
臺中市,清水區,0120,611,129,740,42,782,1424,54.92%,42.91%,1
臺中市,清水區,0121,488,132,620,55,675,1233,54.74%,39.58%,1
臺中市,清水區,0122,467,111,578,52,630,1288,48.91%,36.26%,1
臺中市,清水區,0123,556,117,673,46,719,1200,59.92%,46.33%,1
臺中市,清水區,0124,811,108,919,40,959,1609,59.6%,50.4%,1
臺中市,清水區,0125,579,113,692,19,711,1136,62.59%,50.97%,1
臺中市,清水區,0126,573,103,676,50,726,1302,55.76%,44.01%,1
臺中市,清水區,0127,588,106,694,80,774,1373,56.37%,42.83%,1
臺中市,清水區,0128,462,130,592,64,656,1257,52.19%,36.75%,1
臺中市,清水區,0129,468,97,565,47,612,1184,51.69%,39.53%,1
臺中市,清水區,0130,578,116,694,54,748,1322,56.58%,43.72%,1
臺中市,清水區,0131,474,110,584,38,622,1193,52.14%,39.73%,1
臺中市,清水區,0132,391,115,506,37,543,927,58.58%,42.18%,1
臺中市,清水區,0133,509,121,630,40,670,1073,62.44%,47.44%,1
臺中市,清水區,0134,517,138,655,64,719,1163,61.82%,44.45%,1
臺中市,清水區,0135,355,59,414,63,477,855,55.79%,41.52%,1
臺中市,清水區,0136,352,98,450,56,506,902,56.1%,39.02%,1
臺中市,清水區,0137,622,139,761,52,813,1415,57.46%,43.96%,1
臺中市,清水區,0138,431,122,553,26,579,1066,54.32%,40.43%,1
臺中市,清水區,0139,605,135,740,52,792,1391,56.94%,43.49%,1
臺中市,清水區,0140,598,136,734,31,765,1449,52.8%,41.27%,1
臺中市,清水區,0141,628,151,779,50,829,1377,60.2%,45.61%,1
臺中市,清水區,0142,651,143,794,49,843,1423,59.24%,45.75%,1
臺中市,清水區,0143,729,168,897,40,937,1624,57.7%,44.89%,1
臺中市,清水區,0144,582,109,691,60,751,1358,55.3%,42.86%,1
臺中市,清水區,0145,640,137,777,72,849,1464,57.99%,43.72%,1
臺中市,清水區,0146,548,141,689,58,747,1211,61.68%,45.25%,1
臺中市,清水區,0147,621,117,738,25,763,1456,52.4%,42.65%,1
臺中市,清水區,0148,558,102,660,62,722,1162,62.13%,48.02%,1
臺中市,清水區,0149,678,137,815,56,871,1368,63.67%,49.56%,1
臺中市,沙鹿區,0186,593,108,701,38,739,1380,53.55%,42.97%,1
臺中市,沙鹿區,0187,389,96,485,35,520,852,61.03%,45.66%,1
臺中市,沙鹿區,0188,562,132,694,32,726,1176,61.73%,47.79%,1
臺中市,沙鹿區,0189,441,137,578,67,645,958,67.33%,46.03%,1
臺中市,沙鹿區,0190,249,70,319,17,336,488,68.85%,51.02%,1
臺中市,沙鹿區,0191,510,148,658,32,690,1177,58.62%,43.33%,1
臺中市,沙鹿區,0192,552,136,688,48,736,1285,57.28%,42.96%,1
臺中市,沙鹿區,0193,687,184,871,67,938,1736,54.03%,39.57%,1
臺中市,沙鹿區,0194,735,196,931,57,988,1628,60.69%,45.15%,1
臺中市,沙鹿區,0195,613,151,764,26,790,1469,53.78%,41.73%,1
臺中市,沙鹿區,0196,665,162,827,45,872,1423,61.28%,46.73%,1
臺中市,沙鹿區,0197,647,157,804,59,863,1444,59.76%,44.81%,1
臺中市,沙鹿區,0198,627,155,782,78,860,1469,58.54%,42.68%,1
臺中市,沙鹿區,0199,845,193,1038,80,1118,1902,58.78%,44.43%,1
臺中市,沙鹿區,0200,748,192,940,43,983,1675,58.69%,44.66%,1
臺中市,沙鹿區,0201,474,113,587,48,635,1098,57.83%,43.17%,1
臺中市,沙鹿區,0202,598,277,875,58,933,1539,60.62%,38.86%,1
臺中市,沙鹿區,0203,601,153,754,32,786,1329,59.14%,45.22%,1
臺中市,沙鹿區,0204,503,149,652,45,697,1255,55.54%,40.08%,1
臺中市,沙鹿區,0205,658,179,837,49,886,1507,58.79%,43.66%,1
臺中市,沙鹿區,0206,644,153,797,71,868,1463,59.33%,44.02%,1
臺中市,沙鹿區,0207,542,113,655,52,707,1279,55.28%,42.38%,1
臺中市,沙鹿區,0208,437,66,503,30,533,1024,52.05%,42.68%,1
臺中市,沙鹿區,0209,575,112,687,67,754,1388,54.32%,41.43%,1
臺中市,沙鹿區,0210,498,119,617,35,652,1074,60.71%,46.37%,1
臺中市,沙鹿區,0211,510,114,624,31,655,1072,61.1%,47.57%,1
臺中市,沙鹿區,0212,505,123,628,61,689,1107,62.24%,45.62%,1
臺中市,沙鹿區,0213,784,157,941,47,988,1947,50.74%,40.27%,1
臺中市,沙鹿區,0214,683,157,840,57,897,1682,53.33%,40.61%,1
臺中市,沙鹿區,0215,786,116,902,48,950,1633,58.18%,48.13%,1
臺中市,沙鹿區,0216,614,144,758,47,805,1533,52.51%,40.05%,1
臺中市,沙鹿區,0217,584,137,721,34,755,1605,47.04%,36.39%,1
臺中市,沙鹿區,0218,712,129,841,26,867,1694,51.18%,42.03%,1
臺中市,沙鹿區,0219,672,159,831,43,874,1628,53.69%,41.28%,1
臺中市,沙鹿區,0220,749,178,927,24,951,1665,57.12%,44.98%,1
臺中市,沙鹿區,0221,714,148,862,47,909,1651,55.06%,43.25%,1
臺中市,沙鹿區,0222,560,98,658,30,688,1108,62.09%,50.54%,1
臺中市,沙鹿區,0223,548,116,664,36,700,1142,61.3%,47.99%,1
臺中市,沙鹿區,0224,473,97,570,28,598,1039,57.56%,45.52%,1
臺中市,沙鹿區,0225,774,169,943,70,1013,1840,55.05%,42.07%,1
臺中市,沙鹿區,0226,830,176,1006,30,1036,1872,55.34%,44.34%,1
臺中市,沙鹿區,0227,644,149,793,50,843,1558,54.11%,41.34%,1
臺中市,沙鹿區,0228,722,133,855,43,898,1739,51.64%,41.52%,1
臺中市,沙鹿區,0229,658,151,809,32,841,1672,50.3%,39.35%,1
臺中市,沙鹿區,0230,728,152,880,28,908,1634,55.57%,44.55%,1
臺中市,沙鹿區,0231,643,142,785,44,829,1616,51.3%,39.79%,1
臺中市,沙鹿區,0232,683,175,858,47,905,1593,56.81%,42.88%,1
臺中市,沙鹿區,0233,432,69,501,25,526,981,53.62%,44.04%,1
臺中市,沙鹿區,0234,822,165,987,45,1032,1740,59.31%,47.24%,1
臺中市,沙鹿區,0235,582,123,705,59,764,1247,61.27%,46.67%,1
臺中市,沙鹿區,0236,506,81,587,13,600,1047,57.31%,48.33%,1
臺中市,沙鹿區,0237,488,120,608,58,666,1119,59.52%,43.61%,1
臺中市,沙鹿區,0238,435,96,531,15,546,1025,53.27%,42.44%,1
臺中市,梧棲區,0150,655,164,819,50,869,1541,56.39%,42.5%,1
臺中市,梧棲區,0151,691,148,839,42,881,1581,55.72%,43.71%,1
臺中市,梧棲區,0152,471,127,598,39,637,1083,58.82%,43.49%,1
臺中市,梧棲區,0153,407,95,502,27,529,876,60.39%,46.46%,1
臺中市,梧棲區,0154,441,123,564,55,619,1043,59.35%,42.28%,1
臺中市,梧棲區,0155,585,157,742,38,780,1502,51.93%,38.95%,1
臺中市,梧棲區,0156,626,126,752,33,785,1384,56.72%,45.23%,1
臺中市,梧棲區,0157,262,72,334,24,358,517,69.25%,50.68%,1
臺中市,梧棲區,0158,575,121,696,50,746,1169,63.82%,49.19%,1
臺中市,梧棲區,0159,371,122,493,31,524,863,60.72%,42.99%,1
臺中市,梧棲區,0160,502,101,603,38,641,1277,50.2%,39.31%,1
臺中市,梧棲區,0161,693,203,896,41,937,1742,53.79%,39.78%,1
臺中市,梧棲區,0162,556,184,740,52,792,1342,59.02%,41.43%,1
臺中市,梧棲區,0163,736,210,946,74,1020,1767,57.72%,41.65%,1
臺中市,梧棲區,0164,578,153,731,53,784,1542,50.84%,37.48%,1
臺中市,梧棲區,0165,707,142,849,48,897,1636,54.83%,43.22%,1
臺中市,梧棲區,0166,732,147,879,58,937,1796,52.17%,40.76%,1
臺中市,梧棲區,0167,594,130,724,73,797,1450,54.97%,40.97%,1
臺中市,梧棲區,0168,608,141,749,102,851,1548,54.97%,39.28%,1
臺中市,梧棲區,0169,643,122,765,37,802,1366,58.71%,47.07%,1
臺中市,梧棲區,0170,493,94,587,26,613,955,64.19%,51.62%,1
臺中市,梧棲區,0171,532,131,663,54,717,1305,54.94%,40.77%,1
臺中市,梧棲區,0172,581,123,704,29,733,1239,59.16%,46.89%,1
臺中市,梧棲區,0173,509,103,612,55,667,1079,61.82%,47.17%,1
臺中市,梧棲區,0174,545,111,656,24,680,1220,55.74%,44.67%,1
臺中市,梧棲區,0175,696,179,875,64,939,1544,60.82%,45.08%,1
臺中市,梧棲區,0176,672,163,835,46,881,1460,60.34%,46.03%,1
臺中市,梧棲區,0177,616,130,746,38,784,1292,60.68%,47.68%,1
臺中市,梧棲區,0178,559,118,677,62,739,1300,56.85%,43%,1
臺中市,梧棲區,0179,623,165,788,47,835,1555,53.7%,40.06%,1
臺中市,梧棲區,0180,417,115,532,39,571,1031,55.38%,40.45%,1
臺中市,梧棲區,0181,588,134,722,50,772,1277,60.45%,46.05%,1
臺中市,梧棲區,0182,411,123,534,39,573,1037,55.26%,39.63%,1
臺中市,梧棲區,0183,536,127,663,44,707,1187,59.56%,45.16%,1
臺中市,梧棲區,0184,592,124,716,39,755,1399,53.97%,42.32%,1
臺中市,梧棲區,0185,500,103,603,38,641,1135,56.48%,44.05%,1
臺中市,后里區,0357,441,69,510,34,544,852,63.85%,51.76%,1
臺中市,后里區,0358,486,107,593,55,648,1135,57.09%,42.82%,1
臺中市,后里區,0359,428,113,541,37,578,1079,53.57%,39.67%,1
臺中市,后里區,0360,731,141,872,46,918,1539,59.65%,47.5%,1
臺中市,后里區,0361,720,134,854,70,924,1591,58.08%,45.25%,1
臺中市,后里區,0362,549,115,664,45,709,1376,51.53%,39.9%,1
臺中市,后里區,0363,572,122,694,22,716,1298,55.16%,44.07%,1
臺中市,后里區,0364,624,158,782,72,854,1428,59.8%,43.7%,1
臺中市,后里區,0365,598,141,739,43,782,1178,66.38%,50.76%,1
臺中市,后里區,0366,501,104,605,53,658,1095,60.09%,45.75%,1
臺中市,后里區,0367,419,90,509,23,532,963,55.24%,43.51%,1
臺中市,后里區,0368,506,112,618,40,658,1163,56.58%,43.51%,1
臺中市,后里區,0369,490,102,592,28,620,1018,60.9%,48.13%,1
臺中市,后里區,0370,439,75,514,38,552,854,64.64%,51.41%,1
臺中市,后里區,0371,630,137,767,47,814,1485,54.81%,42.42%,1
臺中市,后里區,0372,683,132,815,41,856,1355,63.17%,50.41%,1
臺中市,后里區,0373,348,75,423,40,463,840,55.12%,41.43%,1
臺中市,后里區,0374,506,136,642,47,689,1146,60.12%,44.15%,1
臺中市,后里區,0375,802,160,962,58,1020,1669,61.11%,48.05%,1
臺中市,后里區,0376,786,173,959,86,1045,1673,62.46%,46.98%,1
臺中市,后里區,0377,676,152,828,37,865,1493,57.94%,45.28%,1
臺中市,后里區,0378,477,121,598,52,650,1052,61.79%,45.34%,1
臺中市,后里區,0379,373,87,460,17,477,909,52.48%,41.03%,1
臺中市,后里區,0380,499,108,607,63,670,1091,61.41%,45.74%,1
臺中市,后里區,0381,642,146,788,42,830,1342,61.85%,47.84%,1
臺中市,后里區,0382,460,133,593,55,648,1138,56.94%,40.42%,1
臺中市,后里區,0383,456,96,552,41,593,977,60.7%,46.67%,1
臺中市,后里區,0384,581,140,721,27,748,1584,47.22%,36.68%,1
臺中市,后里區,0385,405,94,499,25,524,915,57.27%,44.26%,1
臺中市,后里區,0386,559,118,677,59,736,1225,60.08%,45.63%,1
臺中市,后里區,0387,680,133,813,37,850,1552,54.77%,43.81%,1
臺中市,后里區,0388,692,155,847,20,867,1600,54.19%,43.25%,1
臺中市,后里區,0389,416,86,502,33,535,942,56.79%,44.16%,1
臺中市,后里區,0390,394,108,502,24,526,943,55.78%,41.78%,1
臺中市,后里區,0391,451,77,528,32,560,1055,53.08%,42.75%,1
臺中市,后里區,0392,469,111,580,51,631,1067,59.14%,43.96%,1
臺中市,后里區,0393,533,135,668,47,715,1340,53.36%,39.78%,1
臺中市,神岡區,0482,783,165,948,57,1005,1684,59.68%,46.5%,1
臺中市,神岡區,0483,720,153,873,52,925,1559,59.33%,46.18%,1
臺中市,神岡區,0484,463,128,591,24,615,1095,56.16%,42.28%,1
臺中市,神岡區,0485,538,116,654,55,709,1044,67.91%,51.53%,1
臺中市,神岡區,0486,626,162,788,65,853,1310,65.11%,47.79%,1
臺中市,神岡區,0487,602,147,749,77,826,1294,63.83%,46.52%,1
臺中市,神岡區,0488,507,132,639,45,684,1143,59.84%,44.36%,1
臺中市,神岡區,0489,455,132,587,45,632,1022,61.84%,44.52%,1
臺中市,神岡區,0490,524,126,650,43,693,1269,54.61%,41.29%,1
臺中市,神岡區,0491,415,69,484,27,511,1085,47.1%,38.25%,1
臺中市,神岡區,0492,410,123,533,61,594,942,63.06%,43.52%,1
臺中市,神岡區,0493,478,137,615,25,640,1154,55.46%,41.42%,1
臺中市,神岡區,0494,558,169,727,41,768,1390,55.25%,40.14%,1
臺中市,神岡區,0495,642,151,793,75,868,1372,63.27%,46.79%,1
臺中市,神岡區,0496,507,127,634,46,680,1328,51.2%,38.18%,1
臺中市,神岡區,0497,417,119,536,27,563,1038,54.24%,40.17%,1
臺中市,神岡區,0498,628,129,757,30,787,1452,54.2%,43.25%,1
臺中市,神岡區,0499,736,161,897,65,962,1551,62.02%,47.45%,1
臺中市,神岡區,0500,672,143,815,46,861,1567,54.95%,42.88%,1
臺中市,神岡區,0501,634,161,795,42,837,1449,57.76%,43.75%,1
臺中市,神岡區,0502,504,121,625,19,644,1246,51.69%,40.45%,1
臺中市,神岡區,0503,654,154,808,46,854,1431,59.68%,45.7%,1
臺中市,神岡區,0504,539,147,686,49,735,1163,63.2%,46.35%,1
臺中市,神岡區,0505,691,157,848,53,901,1402,64.27%,49.29%,1
臺中市,神岡區,0506,589,127,716,36,752,1271,59.17%,46.34%,1
臺中市,神岡區,0507,546,137,683,43,726,1198,60.6%,45.58%,1
臺中市,神岡區,0508,616,130,746,57,803,1312,61.2%,46.95%,1
臺中市,神岡區,0509,685,153,838,64,902,1590,56.73%,43.08%,1
臺中市,神岡區,0510,563,123,686,38,724,1324,54.68%,42.52%,1
臺中市,神岡區,0511,679,43,722,42,764,1415,53.99%,47.99%,1
臺中市,神岡區,0512,722,174,896,42,938,1483,63.25%,48.69%,1
臺中市,神岡區,0513,553,147,700,27,727,1402,51.85%,39.44%,1
臺中市,神岡區,0514,549,127,676,35,711,1275,55.76%,43.06%,1
臺中市,神岡區,0515,490,143,633,74,707,1288,54.89%,38.04%,1
臺中市,神岡區,0516,451,126,577,42,619,1080,57.31%,41.76%,1
臺中市,神岡區,0517,568,126,694,27,721,1344,53.65%,42.26%,1
臺中市,神岡區,0518,482,130,612,51,663,1061,62.49%,45.43%,1
臺中市,神岡區,0519,564,139,703,42,745,1176,63.35%,47.96%,1
臺中市,神岡區,0520,570,156,726,51,777,1244,62.46%,45.82%,1
臺中市,神岡區,0521,638,164,802,48,850,1318,64.49%,48.41%,1
臺中市,神岡區,0522,614,137,751,46,797,1471,54.18%,41.74%,1
臺中市,神岡區,0523,641,163,804,70,874,1323,66.06%,48.45%,1
臺中市,潭子區,0570,586,161,747,39,786,1306,60.18%,44.87%,1
臺中市,潭子區,0571,520,126,646,41,687,1128,60.9%,46.1%,1
臺中市,潭子區,0572,567,135,702,46,748,1159,64.54%,48.92%,1
臺中市,潭子區,0573,785,156,941,60,1001,1630,61.41%,48.16%,1
臺中市,潭子區,0574,705,145,850,27,877,1532,57.25%,46.02%,1
臺中市,潭子區,0575,672,158,830,36,866,1677,51.64%,40.07%,1
臺中市,潭子區,0576,704,169,873,53,926,1744,53.1%,40.37%,1
臺中市,潭子區,0577,766,210,976,57,1033,1795,57.55%,42.67%,1
臺中市,潭子區,0578,536,112,648,26,674,1171,57.56%,45.77%,1
臺中市,潭子區,0579,642,141,783,33,816,1427,57.18%,44.99%,1
臺中市,潭子區,0580,754,168,922,65,987,1709,57.75%,44.12%,1
臺中市,潭子區,0581,777,171,948,35,983,1723,57.05%,45.1%,1
臺中市,潭子區,0582,783,160,943,43,986,1782,55.33%,43.94%,1
臺中市,潭子區,0583,601,127,728,39,767,1407,54.51%,42.71%,1
臺中市,潭子區,0584,786,179,965,39,1004,1771,56.69%,44.38%,1
臺中市,潭子區,0585,832,185,1017,67,1084,1795,60.39%,46.35%,1
臺中市,潭子區,0586,790,173,963,47,1010,1612,62.66%,49.01%,1
臺中市,潭子區,0587,822,174,996,37,1033,1894,54.54%,43.4%,1
臺中市,潭子區,0588,734,179,913,39,952,1689,56.36%,43.46%,1
臺中市,潭子區,0589,604,145,749,47,796,1525,52.2%,39.61%,1
臺中市,潭子區,0590,684,174,858,36,894,1622,55.12%,42.17%,1
臺中市,潭子區,0591,539,124,663,62,725,1200,60.42%,44.92%,1
臺中市,潭子區,0592,591,117,708,12,720,1355,53.14%,43.62%,1
臺中市,潭子區,0593,782,154,936,29,965,1777,54.31%,44.01%,1
臺中市,潭子區,0594,873,179,1052,27,1079,1923,56.11%,45.4%,1
臺中市,潭子區,0595,717,143,860,65,925,1674,55.26%,42.83%,1
臺中市,潭子區,0596,708,158,866,45,911,1451,62.78%,48.79%,1
臺中市,潭子區,0597,646,170,816,59,875,1486,58.88%,43.47%,1
臺中市,潭子區,0598,692,163,855,60,915,1511,60.56%,45.8%,1
臺中市,潭子區,0599,811,139,950,42,992,1666,59.54%,48.68%,1
臺中市,潭子區,0600,770,147,917,69,986,1750,56.34%,44%,1
臺中市,潭子區,0601,637,126,763,46,809,1437,56.3%,44.33%,1
臺中市,潭子區,0602,776,166,942,32,974,1735,56.14%,44.73%,1
臺中市,潭子區,0603,695,156,851,57,908,1612,56.33%,43.11%,1
臺中市,潭子區,0604,578,104,682,24,706,1143,61.77%,50.57%,1
臺中市,潭子區,0605,899,189,1088,34,1122,2096,53.53%,42.89%,1
臺中市,潭子區,0606,693,183,876,60,936,1549,60.43%,44.74%,1
臺中市,潭子區,0607,704,154,858,33,891,1573,56.64%,44.76%,1
臺中市,潭子區,0608,687,131,818,29,847,1585,53.44%,43.34%,1
臺中市,潭子區,0609,697,148,845,38,883,1572,56.17%,44.34%,1
臺中市,潭子區,0610,827,156,983,46,1029,1738,59.21%,47.58%,1
臺中市,潭子區,0611,809,163,972,68,1040,1883,55.23%,42.96%,1
臺中市,潭子區,0612,614,160,774,26,800,1401,57.1%,43.83%,1
臺中市,潭子區,0613,655,144,799,43,842,1352,62.28%,48.45%,1
臺中市,潭子區,0614,979,195,1174,67,1241,2085,59.52%,46.95%,1
臺中市,潭子區,0615,957,215,1172,69,1241,2047,60.63%,46.75%,1
臺中市,潭子區,0616,662,195,857,17,874,1673,52.24%,39.57%,1
臺中市,潭子區,0617,850,190,1040,77,1117,1874,59.61%,45.36%,1
臺中市,潭子區,0618,454,134,588,47,635,1051,60.42%,43.2%,1
臺中市,潭子區,0619,655,180,835,49,884,1674,52.81%,39.13%,1
臺中市,潭子區,0620,839,179,1018,61,1079,1831,58.93%,45.82%,1
臺中市,潭子區,0621,823,203,1026,58,1084,2003,54.12%,41.09%,1
臺中市,潭子區,0622,674,152,826,36,862,1535,56.16%,43.91%,1
臺中市,潭子區,0623,881,199,1080,91,1171,2286,51.22%,38.54%,1
臺中市,潭子區,0624,745,189,934,63,997,1861,53.57%,40.03%,1
臺中市,大雅區,0524,919,175,1094,68,1162,2027,57.33%,45.34%,1
臺中市,大雅區,0525,777,188,965,27,992,1967,50.43%,39.5%,1
臺中市,大雅區,0526,818,172,990,36,1026,1912,53.66%,42.78%,1
臺中市,大雅區,0527,723,173,896,47,943,1537,61.35%,47.04%,1
臺中市,大雅區,0528,667,185,852,49,901,1439,62.61%,46.35%,1
臺中市,大雅區,0529,648,139,787,50,837,1402,59.7%,46.22%,1
臺中市,大雅區,0530,862,202,1064,31,1095,2013,54.4%,42.82%,1
臺中市,大雅區,0531,858,197,1055,64,1119,1917,58.37%,44.76%,1
臺中市,大雅區,0532,879,183,1062,34,1096,2011,54.5%,43.71%,1
臺中市,大雅區,0533,264,185,449,46,495,1887,26.23%,13.99%,1
臺中市,大雅區,0534,662,189,851,51,902,1480,60.95%,44.73%,1
臺中市,大雅區,0535,816,172,988,47,1035,1816,56.99%,44.93%,1
臺中市,大雅區,0536,741,181,922,63,985,1898,51.9%,39.04%,1
臺中市,大雅區,0537,915,167,1082,68,1150,2008,57.27%,45.57%,1
臺中市,大雅區,0538,926,168,1094,52,1146,1976,58%,46.86%,1
臺中市,大雅區,0539,786,150,936,41,977,1673,58.4%,46.98%,1
臺中市,大雅區,0540,672,163,835,32,867,1409,61.53%,47.69%,1
臺中市,大雅區,0541,645,141,786,18,804,1382,58.18%,46.67%,1
臺中市,大雅區,0542,725,140,865,63,928,1635,56.76%,44.34%,1
臺中市,大雅區,0543,729,154,883,40,923,1565,58.98%,46.58%,1
臺中市,大雅區,0544,644,154,798,40,838,1528,54.84%,42.15%,1
臺中市,大雅區,0545,816,167,983,45,1028,1963,52.37%,41.57%,1
臺中市,大雅區,0546,835,189,1024,36,1060,2073,51.13%,40.28%,1
臺中市,大雅區,0547,861,190,1051,44,1095,1984,55.19%,43.4%,1
臺中市,大雅區,0548,743,143,886,52,938,1688,55.57%,44.02%,1
臺中市,大雅區,0549,604,150,754,48,802,1387,57.82%,43.55%,1
臺中市,大雅區,0550,776,186,962,72,1034,1701,60.79%,45.62%,1
臺中市,大雅區,0551,728,154,882,89,971,1721,56.42%,42.3%,1
臺中市,大雅區,0552,690,134,824,39,863,1879,45.93%,36.72%,1
臺中市,大雅區,0553,768,166,934,48,982,1568,62.63%,48.98%,1
臺中市,大雅區,0554,745,209,954,56,1010,1761,57.35%,42.31%,1
臺中市,大雅區,0555,808,197,1005,59,1064,1752,60.73%,46.12%,1
臺中市,大雅區,0556,587,135,722,37,759,1264,60.05%,46.44%,1
臺中市,大雅區,0557,644,127,771,38,809,1302,62.14%,49.46%,1
臺中市,大雅區,0558,633,141,774,54,828,1449,57.14%,43.69%,1
臺中市,大雅區,0559,783,138,921,70,991,1621,61.14%,48.3%,1
臺中市,大雅區,0560,705,146,851,75,926,1647,56.22%,42.81%,1
臺中市,大雅區,0561,636,126,762,25,787,1441,54.61%,44.14%,1
臺中市,大雅區,0562,650,122,772,21,793,1460,54.32%,44.52%,1
臺中市,大雅區,0563,893,234,1127,65,1192,1832,65.07%,48.74%,1
臺中市,大雅區,0564,670,148,818,52,870,1371,63.46%,48.87%,1
臺中市,大雅區,0565,539,146,685,13,698,1418,49.22%,38.01%,1
臺中市,大雅區,0566,694,134,828,32,860,1473,58.38%,47.11%,1
臺中市,大雅區,0567,612,133,745,47,792,1335,59.33%,45.84%,1
臺中市,大雅區,0568,777,149,926,52,978,1733,56.43%,44.84%,1
臺中市,大雅區,0569,735,127,862,100,962,1884,51.06%,39.01%,1
臺中市,新社區,1562,420,112,532,22,554,1011,54.8%,41.54%,1
臺中市,新社區,1563,504,129,633,39,672,1195,56.23%,42.18%,1
臺中市,新社區,1564,503,108,611,20,631,1053,59.92%,47.77%,1
臺中市,新社區,1565,304,84,388,15,403,961,41.94%,31.63%,1
臺中市,新社區,1566,362,91,453,17,470,919,51.14%,39.39%,1
臺中市,新社區,1567,642,142,784,55,839,1367,61.38%,46.96%,1
臺中市,新社區,1568,402,102,504,22,526,1010,52.08%,39.8%,1
臺中市,新社區,1569,415,101,516,42,558,1169,47.73%,35.5%,1
臺中市,新社區,1570,393,121,514,48,562,989,56.83%,39.74%,1
臺中市,新社區,1571,384,70,454,13,467,894,52.24%,42.95%,1
臺中市,新社區,1572,387,76,463,16,479,1033,46.37%,37.46%,1
臺中市,新社區,1573,342,75,417,23,440,1058,41.59%,32.33%,1
臺中市,新社區,1574,290,80,370,21,391,845,46.27%,34.32%,1
臺中市,新社區,1575,296,69,365,24,389,576,67.53%,51.39%,1
臺中市,新社區,1576,458,109,567,59,626,1229,50.94%,37.27%,1
臺中市,新社區,1577,304,71,375,26,401,890,45.06%,34.16%,1
臺中市,新社區,1578,301,69,370,28,398,781,50.96%,38.54%,1
臺中市,新社區,1579,526,86,612,67,679,1244,54.58%,42.28%,1
臺中市,新社區,1580,64,7,71,8,79,213,37.09%,30.05%,1
臺中市,新社區,1581,234,51,285,23,308,676,45.56%,34.62%,1
臺中市,新社區,1582,214,42,256,22,278,585,47.52%,36.58%,1
臺中市,新社區,1583,414,74,488,38,526,938,56.08%,44.14%,1
臺中市,新社區,1584,87,20,107,3,110,224,49.11%,38.84%,1
臺中市,石岡區,1552,548,140,688,42,730,1244,58.68%,44.05%,1
臺中市,石岡區,1553,665,160,825,5,830,1539,53.93%,43.21%,1
臺中市,石岡區,1554,517,153,670,40,710,1202,59.07%,43.01%,1
臺中市,石岡區,1555,519,114,633,64,697,1272,54.8%,40.8%,1
臺中市,石岡區,1556,298,63,361,30,391,652,59.97%,45.71%,1
臺中市,石岡區,1557,717,169,886,71,957,1457,65.68%,49.21%,1
臺中市,石岡區,1558,785,189,974,62,1036,1836,56.43%,42.76%,1
臺中市,石岡區,1559,431,101,532,48,580,1001,57.94%,43.06%,1
臺中市,石岡區,1560,681,154,835,62,897,1448,61.95%,47.03%,1
臺中市,石岡區,1561,574,136,710,53,763,1229,62.08%,46.7%,1
臺中市,外埔區,0071,446,119,565,37,602,1059,56.85%,42.12%,1
臺中市,外埔區,0072,462,103,565,23,588,1013,58.05%,45.61%,1
臺中市,外埔區,0073,555,113,668,45,713,1150,62%,48.26%,1
臺中市,外埔區,0074,942,170,1112,62,1174,1855,63.29%,50.78%,1
臺中市,外埔區,0075,622,141,763,31,794,1327,59.83%,46.87%,1
臺中市,外埔區,0076,710,128,838,42,880,1453,60.56%,48.86%,1
臺中市,外埔區,0077,715,143,858,67,925,1653,55.96%,43.25%,1
臺中市,外埔區,0078,692,142,834,39,873,1615,54.06%,42.85%,1
臺中市,外埔區,0079,593,152,745,31,776,1470,52.79%,40.34%,1
臺中市,外埔區,0080,689,178,867,46,913,1559,58.56%,44.19%,1
臺中市,外埔區,0081,804,186,990,80,1070,1902,56.26%,42.27%,1
臺中市,外埔區,0082,557,134,691,39,730,1138,64.15%,48.95%,1
臺中市,外埔區,0083,506,107,613,65,678,1065,63.66%,47.51%,1
臺中市,外埔區,0084,615,129,744,32,776,1243,62.43%,49.48%,1
臺中市,外埔區,0085,398,88,486,44,530,962,55.09%,41.37%,1
臺中市,外埔區,0086,512,103,615,37,652,1169,55.77%,43.8%,1
臺中市,外埔區,0087,599,131,730,52,782,1216,64.31%,49.26%,1
臺中市,外埔區,0088,605,132,737,41,778,1391,55.93%,43.49%,1
臺中市,外埔區,0089,652,185,837,69,906,1616,56.06%,40.35%,1
臺中市,外埔區,0090,442,83,525,30,555,1203,46.13%,36.74%,1
臺中市,大安區,0055,446,73,519,53,572,1068,53.56%,41.76%,1
臺中市,大安區,0056,453,102,555,58,613,1050,58.38%,43.14%,1
臺中市,大安區,0057,547,143,690,60,750,1246,60.19%,43.9%,1
臺中市,大安區,0058,584,151,735,49,784,1397,56.12%,41.8%,1
臺中市,大安區,0059,577,135,712,53,765,1227,62.35%,47.03%,1
臺中市,大安區,0060,518,110,628,65,693,1170,59.23%,44.27%,1
臺中市,大安區,0061,453,107,560,35,595,914,65.1%,49.56%,1
臺中市,大安區,0062,259,50,309,36,345,667,51.72%,38.83%,1
臺中市,大安區,0063,366,82,448,38,486,890,54.61%,41.12%,1
臺中市,大安區,0064,525,144,669,60,729,1289,56.56%,40.73%,1
臺中市,大安區,0065,171,45,216,25,241,455,52.97%,37.58%,1
臺中市,大安區,0066,445,112,557,31,588,1028,57.2%,43.29%,1
臺中市,大安區,0067,659,135,794,67,861,1446,59.54%,45.57%,1
臺中市,大安區,0068,350,72,422,26,448,688,65.12%,50.87%,1
臺中市,大安區,0069,491,109,600,49,649,1062,61.11%,46.23%,1
臺中市,大安區,0070,444,121,565,29,594,923,64.36%,48.1%,1
臺中市,烏日區,0317,674,179,853,54,907,1480,61.28%,45.54%,1
臺中市,烏日區,0318,860,196,1056,68,1124,1841,61.05%,46.71%,1
臺中市,烏日區,0319,753,188,941,58,999,1751,57.05%,43%,1
臺中市,烏日區,0320,727,168,895,64,959,1547,61.99%,46.99%,1
臺中市,烏日區,0321,831,182,1013,44,1057,1836,57.57%,45.26%,1
臺中市,烏日區,0322,589,156,745,85,830,1239,66.99%,47.54%,1
臺中市,烏日區,0323,540,137,677,65,742,1295,57.3%,41.7%,1
臺中市,烏日區,0324,545,129,674,37,711,1263,56.29%,43.15%,1
臺中市,烏日區,0325,721,155,876,30,906,1622,55.86%,44.45%,1
臺中市,烏日區,0326,784,176,960,76,1036,1822,56.86%,43.03%,1
臺中市,烏日區,0327,881,175,1056,52,1108,1966,56.36%,44.81%,1
臺中市,烏日區,0328,746,156,902,47,949,1615,58.76%,46.19%,1
臺中市,烏日區,0329,585,134,719,30,749,1232,60.8%,47.48%,1
臺中市,烏日區,0330,613,114,727,26,753,1347,55.9%,45.51%,1
臺中市,烏日區,0331,492,93,585,35,620,1165,53.22%,42.23%,1
臺中市,烏日區,0332,781,167,948,37,985,1664,59.19%,46.94%,1
臺中市,烏日區,0333,585,137,722,52,774,1230,62.93%,47.56%,1
臺中市,烏日區,0334,715,202,917,72,989,1574,62.83%,45.43%,1
臺中市,烏日區,0335,685,195,880,39,919,1452,63.29%,47.18%,1
臺中市,烏日區,0336,767,161,928,50,978,1879,52.05%,40.82%,1
臺中市,烏日區,0337,689,171,860,37,897,1601,56.03%,43.04%,1
臺中市,烏日區,0338,725,183,908,43,951,1546,61.51%,46.9%,1
臺中市,烏日區,0339,722,180,902,32,934,1866,50.05%,38.69%,1
臺中市,烏日區,0340,849,236,1085,67,1152,1938,59.44%,43.81%,1
臺中市,烏日區,0341,792,195,987,55,1042,1759,59.24%,45.03%,1
臺中市,烏日區,0342,859,235,1094,54,1148,2061,55.7%,41.68%,1
臺中市,烏日區,0343,775,180,955,44,999,1691,59.08%,45.83%,1
臺中市,烏日區,0344,484,158,642,37,679,1039,65.35%,46.58%,1
臺中市,烏日區,0345,548,153,701,27,728,1221,59.62%,44.88%,1
臺中市,烏日區,0346,752,74,826,73,899,1650,54.48%,45.58%,1
臺中市,烏日區,0347,436,113,549,33,582,937,62.11%,46.53%,1
臺中市,烏日區,0348,566,114,680,49,729,1220,59.75%,46.39%,1
臺中市,烏日區,0349,844,202,1046,104,1150,2139,53.76%,39.46%,1
臺中市,烏日區,0350,657,157,814,60,874,1371,63.75%,47.92%,1
臺中市,烏日區,0351,581,130,711,44,755,1277,59.12%,45.5%,1
臺中市,烏日區,0352,703,184,887,52,939,1708,54.98%,41.16%,1
臺中市,烏日區,0353,895,182,1077,63,1140,2048,55.66%,43.7%,1
臺中市,烏日區,0354,667,166,833,79,912,1632,55.88%,40.87%,1
臺中市,烏日區,0355,607,144,751,54,805,1327,60.66%,45.74%,1
臺中市,烏日區,0356,354,86,440,59,499,854,58.43%,41.45%,1
臺中市,大肚區,0284,623,138,761,28,789,1415,55.76%,44.03%,1
臺中市,大肚區,0285,563,138,701,45,746,1392,53.59%,40.45%,1
臺中市,大肚區,0286,712,159,871,50,921,1520,60.59%,46.84%,1
臺中市,大肚區,0287,421,113,534,49,583,862,67.63%,48.84%,1
臺中市,大肚區,0288,589,140,729,48,777,1256,61.86%,46.89%,1
臺中市,大肚區,0289,560,139,699,48,747,1292,57.82%,43.34%,1
臺中市,大肚區,0290,473,111,584,32,616,1010,60.99%,46.83%,1
臺中市,大肚區,0291,676,168,844,74,918,1485,61.82%,45.52%,1
臺中市,大肚區,0292,587,114,701,57,758,1190,63.7%,49.33%,1
臺中市,大肚區,0293,569,123,692,52,744,1250,59.52%,45.52%,1
臺中市,大肚區,0294,560,178,738,42,780,1310,59.54%,42.75%,1
臺中市,大肚區,0295,569,127,696,40,736,1294,56.88%,43.97%,1
臺中市,大肚區,0296,838,194,1032,50,1082,1734,62.4%,48.33%,1
臺中市,大肚區,0297,572,127,699,49,748,1316,56.84%,43.47%,1
臺中市,大肚區,0298,383,96,479,32,511,854,59.84%,44.85%,1
臺中市,大肚區,0299,628,145,773,24,797,1273,62.61%,49.33%,1
臺中市,大肚區,0300,431,83,514,17,531,851,62.4%,50.65%,1
臺中市,大肚區,0301,746,127,873,35,908,1629,55.74%,45.79%,1
臺中市,大肚區,0302,735,141,876,95,971,1709,56.82%,43.01%,1
臺中市,大肚區,0303,402,72,474,36,510,953,53.52%,42.18%,1
臺中市,大肚區,0304,620,154,774,38,812,1336,60.78%,46.41%,1
臺中市,大肚區,0305,828,251,1079,63,1142,2113,54.05%,39.19%,1
臺中市,大肚區,0306,775,161,936,81,1017,1730,58.79%,44.8%,1
臺中市,大肚區,0307,744,177,921,25,946,1692,55.91%,43.97%,1
臺中市,大肚區,0308,802,142,944,41,985,1747,56.38%,45.91%,1
臺中市,大肚區,0309,780,121,901,57,958,1672,57.3%,46.65%,1
臺中市,大肚區,0310,678,164,842,40,882,1675,52.66%,40.48%,1
臺中市,大肚區,0311,727,161,888,51,939,1673,56.13%,43.45%,1
臺中市,大肚區,0312,740,173,913,39,952,1636,58.19%,45.23%,1
臺中市,大肚區,0313,666,190,856,86,942,1753,53.74%,37.99%,1
臺中市,大肚區,0314,531,119,650,28,678,1343,50.48%,39.54%,1
臺中市,大肚區,0315,758,162,920,51,971,1822,53.29%,41.6%,1
臺中市,大肚區,0316,804,168,972,60,1032,1670,61.8%,48.14%,1
臺中市,龍井區,0239,785,191,976,74,1050,1758,59.73%,44.65%,1
臺中市,龍井區,0240,558,138,696,34,730,1275,57.25%,43.76%,1
臺中市,龍井區,0241,512,129,641,27,668,1379,48.44%,37.13%,1
臺中市,龍井區,0242,555,133,688,60,748,1403,53.31%,39.56%,1
臺中市,龍井區,0243,408,110,518,45,563,974,57.8%,41.89%,1
臺中市,龍井區,0244,17,484,501,38,539,901,59.82%,1.89%,1
臺中市,龍井區,0245,763,166,929,58,987,1779,55.48%,42.89%,1
臺中市,龍井區,0246,740,171,911,45,956,1609,59.42%,45.99%,1
臺中市,龍井區,0247,415,101,516,19,535,1038,51.54%,39.98%,1
臺中市,龍井區,0248,615,139,754,51,805,1328,60.62%,46.31%,1
臺中市,龍井區,0249,422,106,528,34,562,921,61.02%,45.82%,1
臺中市,龍井區,0250,637,160,797,47,844,1609,52.45%,39.59%,1
臺中市,龍井區,0251,453,104,557,16,573,1227,46.7%,36.92%,1
臺中市,龍井區,0252,548,121,669,55,724,1278,56.65%,42.88%,1
臺中市,龍井區,0253,298,99,397,17,414,914,45.3%,32.6%,1
臺中市,龍井區,0254,626,129,755,40,795,1678,47.38%,37.31%,1
臺中市,龍井區,0255,464,128,592,32,624,1233,50.61%,37.63%,1
臺中市,龍井區,0256,639,155,794,65,859,1520,56.51%,42.04%,1
臺中市,龍井區,0257,778,164,942,27,969,1905,50.87%,40.84%,1
臺中市,龍井區,0258,646,200,846,54,900,1520,59.21%,42.5%,1
臺中市,龍井區,0259,561,124,685,63,748,1385,54.01%,40.51%,1
臺中市,龍井區,0260,471,124,595,37,632,1212,52.15%,38.86%,1
臺中市,龍井區,0261,639,151,790,21,811,1432,56.63%,44.62%,1
臺中市,龍井區,0262,671,163,834,32,866,1663,52.07%,40.35%,1
臺中市,龍井區,0263,579,137,716,34,750,1422,52.74%,40.72%,1
臺中市,龍井區,0264,594,162,756,57,813,1616,50.31%,36.76%,1
臺中市,龍井區,0265,670,132,802,45,847,1422,59.56%,47.12%,1
臺中市,龍井區,0266,546,129,675,15,690,1165,59.23%,46.87%,1
臺中市,龍井區,0267,694,187,881,19,900,1624,55.42%,42.73%,1
臺中市,龍井區,0268,690,166,856,43,899,1613,55.73%,42.78%,1
臺中市,龍井區,0269,439,110,549,37,586,943,62.14%,46.55%,1
臺中市,龍井區,0270,638,144,782,69,851,1595,53.35%,40%,1
臺中市,龍井區,0271,662,166,828,60,888,1508,58.89%,43.9%,1
臺中市,龍井區,0272,592,154,746,38,784,1479,53.01%,40.03%,1
臺中市,龍井區,0273,669,164,833,41,874,1509,57.92%,44.33%,1
臺中市,龍井區,0274,714,173,887,55,942,1582,59.54%,45.13%,1
臺中市,龍井區,0275,779,154,933,42,975,1725,56.52%,45.16%,1
臺中市,龍井區,0276,760,124,884,31,915,1616,56.62%,47.03%,1
臺中市,龍井區,0277,773,156,929,43,972,1657,58.66%,46.65%,1
臺中市,龍井區,0278,802,179,981,54,1035,1774,58.34%,45.21%,1
臺中市,龍井區,0279,762,221,983,54,1037,1701,60.96%,44.8%,1
臺中市,龍井區,0280,512,116,628,34,662,1121,59.05%,45.67%,1
臺中市,龍井區,0281,462,119,581,39,620,987,62.82%,46.81%,1
臺中市,龍井區,0282,517,148,665,48,713,1206,59.12%,42.87%,1
臺中市,龍井區,0283,672,140,812,35,847,1378,61.47%,48.77%,1
臺中市,霧峰區,1470,568,135,703,37,740,1205,61.41%,47.14%,1
臺中市,霧峰區,1471,688,192,880,43,923,1620,56.98%,42.47%,1
臺中市,霧峰區,1472,761,143,904,50,954,1559,61.19%,48.81%,1
臺中市,霧峰區,1473,743,154,897,56,953,1660,57.41%,44.76%,1
臺中市,霧峰區,1474,779,161,940,45,985,1602,61.49%,48.63%,1
臺中市,霧峰區,1475,554,128,682,47,729,1325,55.02%,41.81%,1
臺中市,霧峰區,1476,692,141,833,52,885,1515,58.42%,45.68%,1
臺中市,霧峰區,1477,641,167,808,61,869,1561,55.67%,41.06%,1
臺中市,霧峰區,1478,686,171,857,52,909,1691,53.76%,40.57%,1
臺中市,霧峰區,1479,652,184,836,44,880,1486,59.22%,43.88%,1
臺中市,霧峰區,1480,446,115,561,51,612,975,62.77%,45.74%,1
臺中市,霧峰區,1481,670,124,794,65,859,1358,63.25%,49.34%,1
臺中市,霧峰區,1482,589,134,723,33,756,1141,66.26%,51.62%,1
臺中市,霧峰區,1483,409,95,504,58,562,855,65.73%,47.84%,1
臺中市,霧峰區,1484,526,129,655,64,719,1202,59.82%,43.76%,1
臺中市,霧峰區,1485,467,90,557,44,601,1078,55.75%,43.32%,1
臺中市,霧峰區,1486,605,178,783,61,844,1456,57.97%,41.55%,1
臺中市,霧峰區,1487,759,156,915,47,962,1573,61.16%,48.25%,1
臺中市,霧峰區,1488,745,149,894,49,943,1591,59.27%,46.83%,1
臺中市,霧峰區,1489,607,117,724,55,779,1214,64.17%,50%,1
臺中市,霧峰區,1490,538,130,668,55,723,1267,57.06%,42.46%,1
臺中市,霧峰區,1491,607,97,704,56,760,1277,59.51%,47.53%,1
臺中市,霧峰區,1492,583,144,727,51,778,1366,56.95%,42.68%,1
臺中市,霧峰區,1493,518,128,646,42,688,994,69.22%,52.11%,1
臺中市,霧峰區,1494,398,102,500,41,541,863,62.69%,46.12%,1
臺中市,霧峰區,1495,562,132,694,41,735,1274,57.69%,44.11%,1
臺中市,霧峰區,1496,492,128,620,60,680,1162,58.52%,42.34%,1
臺中市,霧峰區,1497,590,123,713,62,775,1252,61.9%,47.12%,1
臺中市,霧峰區,1498,579,158,737,53,790,1322,59.76%,43.8%,1
臺中市,霧峰區,1499,533,120,653,56,709,1116,63.53%,47.76%,1
臺中市,霧峰區,1500,538,125,663,69,732,1156,63.32%,46.54%,1
臺中市,霧峰區,1501,581,109,690,52,742,1147,64.69%,50.65%,1
臺中市,霧峰區,1502,486,99,585,43,628,928,67.67%,52.37%,1
臺中市,霧峰區,1503,553,128,681,47,728,1296,56.17%,42.67%,1
臺中市,霧峰區,1504,526,128,654,64,718,1314,54.64%,40.03%,1
臺中市,霧峰區,1505,613,138,751,57,808,1328,60.84%,46.16%,1
臺中市,霧峰區,1506,437,101,538,54,592,989,59.86%,44.19%,1
臺中市,霧峰區,1507,509,118,627,52,679,1088,62.41%,46.78%,1
臺中市,霧峰區,1508,696,101,797,60,857,1363,62.88%,51.06%,1
臺中市,霧峰區,1509,746,160,906,60,966,1573,61.41%,47.43%,1
臺中市,霧峰區,1510,480,105,585,65,650,1117,58.19%,42.97%,1
臺中市,霧峰區,1511,637,167,804,58,862,1342,64.23%,47.47%,1
臺中市,霧峰區,1512,488,131,619,64,683,1024,66.7%,47.66%,1
臺中市,太平區,1271,731,171,902,91,993,1821,54.53%,40.14%,1
臺中市,太平區,1272,663,141,804,35,839,1680,49.94%,39.46%,1
臺中市,太平區,1273,818,221,1039,90,1129,1947,57.99%,42.01%,1
臺中市,太平區,1274,822,217,1039,111,1150,1910,60.21%,43.04%,1
臺中市,太平區,1275,789,189,978,41,1019,1894,53.8%,41.66%,1
臺中市,太平區,1276,826,174,1000,52,1052,1953,53.87%,42.29%,1
臺中市,太平區,1277,778,212,990,72,1062,1846,57.53%,42.15%,1
臺中市,太平區,1278,693,145,838,39,877,1493,58.74%,46.42%,1
臺中市,太平區,1279,687,156,843,57,900,1605,56.07%,42.8%,1
臺中市,太平區,1280,770,150,920,28,948,1619,58.55%,47.56%,1
臺中市,太平區,1281,828,206,1034,69,1103,2011,54.85%,41.17%,1
臺中市,太平區,1282,851,165,1016,41,1057,2056,51.41%,41.39%,1
臺中市,太平區,1283,788,173,961,62,1023,1876,54.53%,42%,1
臺中市,太平區,1284,750,164,914,69,983,1815,54.16%,41.32%,1
臺中市,太平區,1285,516,156,672,41,713,1281,55.66%,40.28%,1
臺中市,太平區,1286,474,135,609,43,652,1004,64.94%,47.21%,1
臺中市,太平區,1287,849,213,1062,63,1125,1886,59.65%,45.02%,1
臺中市,太平區,1288,625,175,800,60,860,1431,60.1%,43.68%,1
臺中市,太平區,1289,771,213,984,67,1051,1930,54.46%,39.95%,1
臺中市,太平區,1290,827,216,1043,75,1118,2164,51.66%,38.22%,1
臺中市,太平區,1291,842,183,1025,92,1117,2048,54.54%,41.11%,1
臺中市,太平區,1292,830,187,1017,63,1080,2035,53.07%,40.79%,1
臺中市,太平區,1293,685,160,845,90,935,1685,55.49%,40.65%,1
臺中市,太平區,1294,922,91,1013,67,1080,2185,49.43%,42.2%,1
臺中市,太平區,1295,495,103,598,23,621,1176,52.81%,42.09%,1
臺中市,太平區,1296,667,160,827,46,873,1597,54.66%,41.77%,1
臺中市,太平區,1297,555,119,674,67,741,1378,53.77%,40.28%,1
臺中市,太平區,1298,623,144,767,41,808,1546,52.26%,40.3%,1
臺中市,太平區,1299,695,188,883,77,960,1890,50.79%,36.77%,1
臺中市,太平區,1300,452,89,541,53,594,1053,56.41%,42.92%,1
臺中市,太平區,1301,758,123,881,74,955,1582,60.37%,47.91%,1
臺中市,太平區,1302,772,177,949,57,1006,1699,59.21%,45.44%,1
臺中市,太平區,1303,629,139,768,50,818,1493,54.79%,42.13%,1
臺中市,太平區,1304,435,107,542,33,575,1063,54.09%,40.92%,1
臺中市,太平區,1305,550,99,649,42,691,1117,61.86%,49.24%,1
臺中市,太平區,1306,533,89,622,36,658,1084,60.7%,49.17%,1
臺中市,太平區,1307,710,155,865,28,893,1776,50.28%,39.98%,1
臺中市,太平區,1308,723,169,892,40,932,1729,53.9%,41.82%,1
臺中市,太平區,1309,626,132,758,47,805,1658,48.55%,37.76%,1
臺中市,太平區,1310,883,141,1024,50,1074,2010,53.43%,43.93%,1
臺中市,太平區,1311,745,129,874,63,937,1752,53.48%,42.52%,1
臺中市,太平區,1312,747,179,926,71,997,1654,60.28%,45.16%,1
臺中市,太平區,1313,618,127,745,32,777,1951,39.83%,31.68%,1
臺中市,太平區,1314,1036,247,1283,81,1364,2170,62.86%,47.74%,1
臺中市,太平區,1315,1013,256,1269,41,1310,2231,58.72%,45.41%,1
臺中市,太平區,1316,731,144,875,36,911,1623,56.13%,45.04%,1
臺中市,太平區,1317,575,140,715,46,761,1548,49.16%,37.14%,1
臺中市,太平區,1318,579,157,736,55,791,1442,54.85%,40.15%,1
臺中市,太平區,1319,559,130,689,32,721,1501,48.03%,37.24%,1
臺中市,太平區,1320,769,173,942,26,968,2025,47.8%,37.98%,1
臺中市,太平區,1321,772,179,951,58,1009,1885,53.53%,40.95%,1
臺中市,太平區,1322,795,194,989,72,1061,2155,49.23%,36.89%,1
臺中市,太平區,1323,666,160,826,43,869,1775,48.96%,37.52%,1
臺中市,太平區,1324,709,147,856,75,931,2021,46.07%,35.08%,1
臺中市,太平區,1325,928,189,1117,72,1189,2075,57.3%,44.72%,1
臺中市,太平區,1326,708,156,864,39,903,1723,52.41%,41.09%,1
臺中市,太平區,1327,894,166,1060,51,1111,2049,54.22%,43.63%,1
臺中市,太平區,1328,623,126,749,31,780,1415,55.12%,44.03%,1
臺中市,太平區,1329,765,179,944,41,985,1778,55.4%,43.03%,1
臺中市,太平區,1330,679,177,856,51,907,1706,53.17%,39.8%,1
臺中市,太平區,1331,895,200,1095,52,1147,2090,54.88%,42.82%,1
臺中市,太平區,1332,827,163,990,49,1039,2093,49.64%,39.51%,1
臺中市,太平區,1333,638,115,753,38,791,1688,46.86%,37.8%,1
臺中市,太平區,1334,623,93,716,39,755,1488,50.74%,41.87%,1
臺中市,太平區,1335,747,171,918,54,972,1667,58.31%,44.81%,1
臺中市,太平區,1336,751,190,941,75,1016,1793,56.66%,41.89%,1
臺中市,太平區,1337,889,144,1033,34,1067,1903,56.07%,46.72%,1
臺中市,太平區,1338,787,177,964,59,1023,1834,55.78%,42.91%,1
臺中市,太平區,1339,668,116,784,26,810,1526,53.08%,43.77%,1
臺中市,太平區,1340,755,138,893,24,917,1483,61.83%,50.91%,1
臺中市,太平區,1341,777,146,923,27,950,1694,56.08%,45.87%,1
臺中市,太平區,1342,758,168,926,7,933,1952,47.8%,38.83%,1
臺中市,太平區,1343,841,199,1040,32,1072,1995,53.73%,42.16%,1
臺中市,太平區,1344,617,120,737,25,762,1311,58.12%,47.06%,1
臺中市,太平區,1345,835,144,979,37,1016,1537,66.1%,54.33%,1
臺中市,太平區,1346,756,160,916,47,963,1974,48.78%,38.3%,1
臺中市,太平區,1347,811,159,970,48,1018,1828,55.69%,44.37%,1
臺中市,太平區,1348,857,185,1042,31,1073,2191,48.97%,39.11%,1
臺中市,太平區,1349,716,176,892,79,971,1825,53.21%,39.23%,1
臺中市,太平區,1350,592,147,739,18,757,1559,48.56%,37.97%,1
臺中市,太平區,1351,518,104,622,66,688,1225,56.16%,42.29%,1
臺中市,太平區,1352,725,154,879,58,937,1678,55.84%,43.21%,1
臺中市,太平區,1353,578,163,741,62,803,1501,53.5%,38.51%,1
臺中市,太平區,1354,672,184,856,73,929,1450,64.07%,46.34%,1
臺中市,太平區,1355,840,189,1029,73,1102,2126,51.83%,39.51%,1
臺中市,太平區,1356,338,71,409,36,445,699,63.66%,48.35%,1
臺中市,太平區,1357,501,139,640,29,669,1428,46.85%,35.08%,1
臺中市,太平區,1358,742,153,895,67,962,1666,57.74%,44.54%,1
臺中市,太平區,1359,494,152,646,45,691,1241,55.68%,39.81%,1
臺中市,太平區,1360,570,137,707,52,759,1266,59.95%,45.02%,1
臺中市,太平區,1361,514,120,634,34,668,1166,57.29%,44.08%,1
臺中市,太平區,1362,797,182,979,65,1044,1790,58.32%,44.53%,1
臺中市,太平區,1363,600,164,764,43,807,1754,46.01%,34.21%,1
臺中市,大里區,1364,633,159,792,44,836,1614,51.8%,39.22%,1
臺中市,大里區,1365,638,134,772,28,800,1599,50.03%,39.9%,1
臺中市,大里區,1366,667,161,828,41,869,1715,50.67%,38.89%,1
臺中市,大里區,1367,559,132,691,23,714,1264,56.49%,44.22%,1
臺中市,大里區,1368,584,122,706,34,740,1416,52.26%,41.24%,1
臺中市,大里區,1369,515,102,617,25,642,1188,54.04%,43.35%,1
臺中市,大里區,1370,537,136,673,49,722,1359,53.13%,39.51%,1
臺中市,大里區,1371,634,144,778,60,838,1457,57.52%,43.51%,1
臺中市,大里區,1372,640,145,785,43,828,1403,59.02%,45.62%,1
臺中市,大里區,1373,701,174,875,47,922,1697,54.33%,41.31%,1
臺中市,大里區,1374,795,215,1010,75,1085,1811,59.91%,43.9%,1
臺中市,大里區,1375,740,183,923,57,980,1830,53.55%,40.44%,1
臺中市,大里區,1376,725,173,898,67,965,2228,43.31%,32.54%,1
臺中市,大里區,1377,885,180,1065,75,1140,1997,57.09%,44.32%,1
臺中市,大里區,1378,1044,211,1255,42,1297,2033,63.8%,51.35%,1
臺中市,大里區,1379,777,240,1017,33,1050,1835,57.22%,42.34%,1
臺中市,大里區,1380,569,127,696,23,719,1268,56.7%,44.87%,1
臺中市,大里區,1381,711,169,880,47,927,1645,56.35%,43.22%,1
臺中市,大里區,1382,724,155,879,22,901,1561,57.72%,46.38%,1
臺中市,大里區,1383,706,120,826,30,856,1301,65.8%,54.27%,1
臺中市,大里區,1384,725,105,830,60,890,1621,54.9%,44.73%,1
臺中市,大里區,1385,696,198,894,68,962,1797,53.53%,38.73%,1
臺中市,大里區,1386,503,118,621,24,645,1230,52.44%,40.89%,1
臺中市,大里區,1387,627,142,769,52,821,1488,55.17%,42.14%,1
臺中市,大里區,1388,568,164,732,62,794,1459,54.42%,38.93%,1
臺中市,大里區,1389,711,168,879,54,933,1647,56.65%,43.17%,1
臺中市,大里區,1390,503,122,625,61,686,1100,62.36%,45.73%,1
臺中市,大里區,1391,641,120,761,46,807,1410,57.23%,45.46%,1
臺中市,大里區,1392,734,162,896,61,957,1807,52.96%,40.62%,1
臺中市,大里區,1393,568,140,708,50,758,1331,56.95%,42.67%,1
臺中市,大里區,1394,739,181,920,49,969,1801,53.8%,41.03%,1
臺中市,大里區,1395,777,146,923,43,966,1909,50.6%,40.7%,1
臺中市,大里區,1396,640,151,791,71,862,1699,50.74%,37.67%,1
臺中市,大里區,1397,728,156,884,57,941,1627,57.84%,44.74%,1
臺中市,大里區,1398,815,162,977,60,1037,1912,54.24%,42.63%,1
臺中市,大里區,1399,717,161,878,62,940,1753,53.62%,40.9%,1
臺中市,大里區,1400,672,159,831,46,877,1602,54.74%,41.95%,1
臺中市,大里區,1401,490,121,611,49,660,1144,57.69%,42.83%,1
臺中市,大里區,1402,692,219,911,51,962,1655,58.13%,41.81%,1
臺中市,大里區,1403,603,168,771,37,808,1438,56.19%,41.93%,1
臺中市,大里區,1404,439,106,545,46,591,1000,59.1%,43.9%,1
臺中市,大里區,1405,748,147,895,68,963,1711,56.28%,43.72%,1
臺中市,大里區,1406,750,120,870,10,880,1698,51.83%,44.17%,1
臺中市,大里區,1407,831,170,1001,71,1072,1914,56.01%,43.42%,1
臺中市,大里區,1408,648,149,797,28,825,1465,56.31%,44.23%,1
臺中市,大里區,1409,676,162,838,64,902,1581,57.05%,42.76%,1
臺中市,大里區,1410,670,164,834,60,894,1509,59.24%,44.4%,1
臺中市,大里區,1411,664,122,786,34,820,1570,52.23%,42.29%,1
臺中市,大里區,1412,631,155,786,40,826,1425,57.96%,44.28%,1
臺中市,大里區,1413,612,146,758,63,821,1384,59.32%,44.22%,1
臺中市,大里區,1414,431,118,549,36,585,1204,48.59%,35.8%,1
臺中市,大里區,1415,662,155,817,31,848,1761,48.15%,37.59%,1
臺中市,大里區,1416,565,110,675,26,701,1473,47.59%,38.36%,1
臺中市,大里區,1417,738,159,897,50,947,1675,56.54%,44.06%,1
臺中市,大里區,1418,798,136,934,54,988,1755,56.3%,45.47%,1
臺中市,大里區,1419,596,166,762,77,839,1593,52.67%,37.41%,1
臺中市,大里區,1420,739,198,937,61,998,1799,55.48%,41.08%,1
臺中市,大里區,1421,664,167,831,80,911,1606,56.72%,41.34%,1
臺中市,大里區,1422,746,193,939,44,983,1875,52.43%,39.79%,1
臺中市,大里區,1423,725,179,904,50,954,1670,57.13%,43.41%,1
臺中市,大里區,1424,770,192,962,44,1006,1898,53%,40.57%,1
臺中市,大里區,1425,659,182,841,28,869,1679,51.76%,39.25%,1
臺中市,大里區,1426,559,138,697,54,751,1373,54.7%,40.71%,1
臺中市,大里區,1427,574,123,697,55,752,1299,57.89%,44.19%,1
臺中市,大里區,1428,635,139,774,39,813,1430,56.85%,44.41%,1
臺中市,大里區,1429,885,209,1094,43,1137,1805,62.99%,49.03%,1
臺中市,大里區,1430,922,210,1132,25,1157,1806,64.06%,51.05%,1
臺中市,大里區,1431,965,180,1145,45,1190,1826,65.17%,52.85%,1
臺中市,大里區,1432,948,189,1137,40,1177,1805,65.21%,52.52%,1
臺中市,大里區,1433,922,184,1106,43,1149,1907,60.25%,48.35%,1
臺中市,大里區,1434,551,110,661,42,703,1103,63.74%,49.95%,1
臺中市,大里區,1435,612,130,742,51,793,1419,55.88%,43.13%,1
臺中市,大里區,1436,581,140,721,72,793,1434,55.3%,40.52%,1
臺中市,大里區,1437,698,152,850,34,884,1875,47.15%,37.23%,1
臺中市,大里區,1438,774,231,1005,49,1054,1862,56.61%,41.57%,1
臺中市,大里區,1439,777,170,947,28,975,1850,52.7%,42%,1
臺中市,大里區,1440,693,179,872,63,935,1622,57.64%,42.73%,1
臺中市,大里區,1441,788,175,963,55,1018,1638,62.15%,48.11%,1
臺中市,大里區,1442,754,188,942,73,1015,1633,62.16%,46.17%,1
臺中市,大里區,1443,725,182,907,35,942,1662,56.68%,43.62%,1
臺中市,大里區,1444,924,164,1088,41,1129,1917,58.89%,48.2%,1
臺中市,大里區,1445,637,188,825,75,900,1701,52.91%,37.45%,1
臺中市,大里區,1446,625,152,777,55,832,1549,53.71%,40.35%,1
臺中市,大里區,1447,724,155,879,58,937,1567,59.8%,46.2%,1
臺中市,大里區,1448,712,151,863,45,908,1614,56.26%,44.11%,1
臺中市,大里區,1449,777,189,966,78,1044,1811,57.65%,42.9%,1
臺中市,大里區,1450,566,146,712,38,750,1336,56.14%,42.37%,1
臺中市,大里區,1451,725,169,894,40,934,1759,53.1%,41.22%,1
臺中市,大里區,1452,688,178,866,71,937,1783,52.55%,38.59%,1
臺中市,大里區,1453,650,171,821,64,885,1736,50.98%,37.44%,1
臺中市,大里區,1454,799,185,984,61,1045,1874,55.76%,42.64%,1
臺中市,大里區,1455,833,198,1031,38,1069,1889,56.59%,44.1%,1
臺中市,大里區,1456,797,189,986,55,1041,1947,53.47%,40.93%,1
臺中市,大里區,1457,880,202,1082,48,1130,1938,58.31%,45.41%,1
臺中市,大里區,1458,780,183,963,61,1024,1836,55.77%,42.48%,1
臺中市,大里區,1459,786,193,979,68,1047,1913,54.73%,41.09%,1
臺中市,大里區,1460,745,197,942,75,1017,1913,53.16%,38.94%,1
臺中市,大里區,1461,792,169,961,52,1013,1937,52.3%,40.89%,1
臺中市,大里區,1462,642,142,784,35,819,1508,54.31%,42.57%,1
臺中市,大里區,1463,618,144,762,19,781,1340,58.28%,46.12%,1
臺中市,大里區,1464,760,158,918,47,965,1656,58.27%,45.89%,1
臺中市,大里區,1465,557,130,687,42,729,1290,56.51%,43.18%,1
臺中市,大里區,1466,737,152,889,35,924,1655,55.83%,44.53%,1
臺中市,大里區,1467,490,105,595,18,613,1260,48.65%,38.89%,1
臺中市,大里區,1468,579,129,708,36,744,1247,59.66%,46.43%,1
臺中市,大里區,1469,640,179,819,47,866,1548,55.94%,41.34%,1
臺中市,和平區,1585,460,121,581,32,613,956,64.12%,48.12%,1
臺中市,和平區,1586,480,100,580,47,627,963,65.11%,49.84%,1
臺中市,和平區,1587,205,39,244,14,258,456,56.58%,44.96%,1
臺中市,和平區,1588,517,89,606,31,637,1011,63.01%,51.14%,1
臺中市,和平區,1589,303,58,361,13,374,636,58.81%,47.64%,1
臺中市,和平區,1590,105,16,121,6,127,270,47.04%,38.89%,1
臺中市,和平區,1591,306,30,336,21,357,460,77.61%,66.52%,1
臺中市,和平區,1592,197,34,231,11,242,321,75.39%,61.37%,1
臺中市,和平區,1593,388,83,471,25,496,783,63.35%,49.55%,1
臺中市,和平區,1594,150,32,182,18,200,336,59.52%,44.64%,1
臺中市,和平區,1595,250,46,296,13,309,451,68.51%,55.43%,1
臺中市,和平區,1596,144,34,178,13,191,366,52.19%,39.34%,1
臺中市,和平區,1597,282,43,325,8,333,771,43.19%,36.58%,1
臺中市,和平區,1598,250,42,292,26,318,574,55.4%,43.55%,1
臺中市,和平區,1599,122,35,157,12,169,274,61.68%,44.53%,1
臺中市,和平區,1600,69,15,84,2,86,157,54.78%,43.95%,1
臺中市,和平區,1601,277,47,324,17,341,713,47.83%,38.85%,1
臺南市,新營區,0116,584,147,731,55,786,1693,46.43%,34.49%,1
臺南市,新營區,0117,652,162,814,54,868,1561,55.61%,41.77%,1
臺南市,新營區,0118,567,178,745,56,801,1487,53.87%,38.13%,1
臺南市,新營區,0119,464,118,582,31,613,1232,49.76%,37.66%,1
臺南市,新營區,0120,392,104,496,31,527,1067,49.39%,36.74%,1
臺南市,新營區,0121,452,133,585,37,622,1419,43.83%,31.85%,1
臺南市,新營區,0122,606,133,739,23,762,1466,51.98%,41.34%,1
臺南市,新營區,0123,393,128,521,45,566,932,60.73%,42.17%,1
臺南市,新營區,0124,339,112,451,29,480,1099,43.68%,30.85%,1
臺南市,新營區,0125,253,65,318,27,345,757,45.57%,33.42%,1
臺南市,新營區,0126,368,96,464,33,497,888,55.97%,41.44%,1
臺南市,新營區,0127,398,129,527,14,541,1115,48.52%,35.7%,1
臺南市,新營區,0128,313,92,405,23,428,937,45.68%,33.4%,1
臺南市,新營區,0129,486,153,639,36,675,1387,48.67%,35.04%,1
臺南市,新營區,0130,562,148,710,43,753,1526,49.34%,36.83%,1
臺南市,新營區,0131,539,148,687,37,724,1301,55.65%,41.43%,1
臺南市,新營區,0132,644,157,801,64,865,1538,56.24%,41.87%,1
臺南市,新營區,0133,657,152,809,42,851,1584,53.72%,41.48%,1
臺南市,新營區,0134,619,239,858,37,895,1583,56.54%,39.1%,1
臺南市,新營區,0135,628,159,787,39,826,1530,53.99%,41.05%,1
臺南市,新營區,0136,487,148,635,47,682,1193,57.17%,40.82%,1
臺南市,新營區,0137,401,94,495,13,508,1439,35.3%,27.87%,1
臺南市,新營區,0138,608,144,752,52,804,1438,55.91%,42.28%,1
臺南市,新營區,0139,137,51,188,21,209,359,58.22%,38.16%,1
臺南市,新營區,0140,342,116,458,31,489,1233,39.66%,27.74%,1
臺南市,新營區,0141,394,79,473,18,491,1227,40.02%,32.11%,1
臺南市,新營區,0142,443,91,534,29,563,1320,42.65%,33.56%,1
臺南市,新營區,0143,564,169,733,27,760,1930,39.38%,29.22%,1
臺南市,新營區,0144,586,146,732,55,787,1501,52.43%,39.04%,1
臺南市,新營區,0145,555,117,672,42,714,1475,48.41%,37.63%,1
臺南市,新營區,0146,718,157,875,54,929,1753,52.99%,40.96%,1
臺南市,新營區,0147,646,158,804,40,844,1748,48.28%,36.96%,1
臺南市,新營區,0148,664,169,833,45,878,1741,50.43%,38.14%,1
臺南市,新營區,0149,531,117,648,26,674,1433,47.03%,37.06%,1
臺南市,新營區,0150,603,160,763,64,827,1595,51.85%,37.81%,1
臺南市,新營區,0151,309,78,387,17,404,959,42.13%,32.22%,1
臺南市,新營區,0152,644,164,808,76,884,1865,47.4%,34.53%,1
臺南市,新營區,0153,552,144,696,85,781,1678,46.54%,32.9%,1
臺南市,新營區,0154,450,111,561,53,614,1373,44.72%,32.77%,1
臺南市,新營區,0155,361,130,491,23,514,1431,35.92%,25.23%,1
臺南市,新營區,0156,74,17,91,3,94,291,32.3%,25.43%,1
臺南市,新營區,0157,620,180,800,38,838,1749,47.91%,35.45%,1
臺南市,新營區,0158,616,157,773,48,821,1862,44.09%,33.08%,1
臺南市,新營區,0159,715,169,884,93,977,1821,53.65%,39.26%,1
臺南市,新營區,0160,616,172,788,59,847,1845,45.91%,33.39%,1
臺南市,新營區,0161,140,38,178,10,188,542,34.69%,25.83%,1
臺南市,新營區,0162,96,30,126,8,134,402,33.33%,23.88%,1
臺南市,新營區,0163,260,91,351,59,410,703,58.32%,36.98%,1
臺南市,新營區,0164,286,93,379,39,418,941,44.42%,30.39%,1
臺南市,鹽水區,0085,375,111,486,65,551,1037,53.13%,36.16%,1
臺南市,鹽水區,0086,180,58,238,19,257,480,53.54%,37.5%,1
臺南市,鹽水區,0087,270,77,347,30,377,636,59.28%,42.45%,1
臺南市,鹽水區,0088,93,44,137,9,146,321,45.48%,28.97%,1
臺南市,鹽水區,0089,202,58,260,34,294,497,59.15%,40.64%,1
臺南市,鹽水區,0090,312,88,400,15,415,759,54.68%,41.11%,1
臺南市,鹽水區,0091,125,19,144,18,162,341,47.51%,36.66%,1
臺南市,鹽水區,0092,186,58,244,28,272,507,53.65%,36.69%,1
臺南市,鹽水區,0093,255,77,332,23,355,863,41.14%,29.55%,1
臺南市,鹽水區,0094,463,125,588,21,609,1373,44.36%,33.72%,1
臺南市,鹽水區,0095,557,131,688,60,748,1507,49.64%,36.96%,1
臺南市,鹽水區,0096,490,161,651,74,725,1374,52.77%,35.66%,1
臺南市,鹽水區,0097,402,112,514,48,562,1244,45.18%,32.32%,1
臺南市,鹽水區,0098,365,109,474,61,535,1022,52.35%,35.71%,1
臺南市,鹽水區,0099,220,62,282,41,323,921,35.07%,23.89%,1
臺南市,鹽水區,0100,289,128,417,40,457,847,53.96%,34.12%,1
臺南市,鹽水區,0101,166,47,213,4,217,736,29.48%,22.55%,1
臺南市,鹽水區,0102,240,80,320,14,334,761,43.89%,31.54%,1
臺南市,鹽水區,0103,97,29,126,11,137,285,48.07%,34.04%,1
臺南市,鹽水區,0104,141,51,192,34,226,493,45.84%,28.6%,1
臺南市,鹽水區,0105,158,37,195,23,218,621,35.1%,25.44%,1
臺南市,鹽水區,0106,92,21,113,11,124,392,31.63%,23.47%,1
臺南市,鹽水區,0107,305,74,379,29,408,925,44.11%,32.97%,1
臺南市,鹽水區,0108,214,66,280,28,308,728,42.31%,29.4%,1
臺南市,鹽水區,0109,49,13,62,18,80,214,37.38%,22.9%,1
臺南市,鹽水區,0110,143,24,167,7,174,387,44.96%,36.95%,1
臺南市,鹽水區,0111,96,35,131,19,150,301,49.83%,31.89%,1
臺南市,鹽水區,0112,192,67,259,26,285,755,37.75%,25.43%,1
臺南市,鹽水區,0113,92,35,127,17,144,365,39.45%,25.21%,1
臺南市,鹽水區,0114,280,80,360,30,390,935,41.71%,29.95%,1
臺南市,鹽水區,0115,148,38,186,27,213,494,43.12%,29.96%,1
臺南市,白河區,0030,414,122,536,86,622,1176,52.89%,35.2%,1
臺南市,白河區,0031,199,49,248,18,266,546,48.72%,36.45%,1
臺南市,白河區,0032,321,105,426,34,460,859,53.55%,37.37%,1
臺南市,白河區,0033,371,104,475,38,513,946,54.23%,39.22%,1
臺南市,白河區,0034,379,123,502,38,540,1116,48.39%,33.96%,1
臺南市,白河區,0035,367,96,463,33,496,1397,35.5%,26.27%,1
臺南市,白河區,0036,202,57,259,17,276,756,36.51%,26.72%,1
臺南市,白河區,0037,298,79,377,44,421,871,48.34%,34.21%,1
臺南市,白河區,0038,304,97,401,38,439,897,48.94%,33.89%,1
臺南市,白河區,0039,171,53,224,35,259,784,33.04%,21.81%,1
臺南市,白河區,0040,168,49,217,15,232,572,40.56%,29.37%,1
臺南市,白河區,0041,100,26,126,9,135,457,29.54%,21.88%,1
臺南市,白河區,0042,146,36,182,15,197,600,32.83%,24.33%,1
臺南市,白河區,0043,87,13,100,7,107,375,28.53%,23.2%,1
臺南市,白河區,0044,88,24,112,10,122,508,24.02%,17.32%,1
臺南市,白河區,0045,114,49,163,13,176,631,27.89%,18.07%,1
臺南市,白河區,0046,75,22,97,13,110,391,28.13%,19.18%,1
臺南市,白河區,0047,167,57,224,14,238,799,29.79%,20.9%,1
臺南市,白河區,0048,104,31,135,18,153,506,30.24%,20.55%,1
臺南市,白河區,0049,225,74,299,29,328,832,39.42%,27.04%,1
臺南市,白河區,0050,369,117,486,31,517,1179,43.85%,31.3%,1
臺南市,白河區,0051,171,53,224,11,235,744,31.59%,22.98%,1
臺南市,白河區,0052,175,60,235,15,250,699,35.77%,25.04%,1
臺南市,白河區,0053,149,51,200,14,214,633,33.81%,23.54%,1
臺南市,白河區,0054,305,100,405,53,458,859,53.32%,35.51%,1
臺南市,白河區,0055,253,79,332,47,379,884,42.87%,28.62%,1
臺南市,白河區,0056,151,33,184,9,193,740,26.08%,20.41%,1
臺南市,白河區,0057,377,113,490,54,544,1334,40.78%,28.26%,1
臺南市,白河區,0058,219,76,295,57,352,723,48.69%,30.29%,1
臺南市,白河區,0059,226,83,309,64,373,682,54.69%,33.14%,1
臺南市,白河區,0060,278,113,391,47,438,855,51.23%,32.51%,1
臺南市,白河區,0061,142,50,192,19,211,543,38.86%,26.15%,1
臺南市,柳營區,0165,400,114,514,45,559,1166,47.94%,34.31%,1
臺南市,柳營區,0166,229,87,316,14,330,625,52.8%,36.64%,1
臺南市,柳營區,0167,225,57,282,24,306,738,41.46%,30.49%,1
臺南市,柳營區,0168,334,79,413,18,431,834,51.68%,40.05%,1
臺南市,柳營區,0169,332,124,456,39,495,1104,44.84%,30.07%,1
臺南市,柳營區,0170,311,83,394,21,415,1015,40.89%,30.64%,1
臺南市,柳營區,0171,655,160,815,119,934,1720,54.3%,38.08%,1
臺南市,柳營區,0172,476,115,591,64,655,1391,47.09%,34.22%,1
臺南市,柳營區,0173,145,32,177,8,185,425,43.53%,34.12%,1
臺南市,柳營區,0174,87,17,104,19,123,318,38.68%,27.36%,1
臺南市,柳營區,0175,254,78,332,40,372,753,49.4%,33.73%,1
臺南市,柳營區,0176,252,59,311,33,344,730,47.12%,34.52%,1
臺南市,柳營區,0177,247,66,313,36,349,725,48.14%,34.07%,1
臺南市,柳營區,0178,303,74,377,39,416,787,52.86%,38.5%,1
臺南市,柳營區,0179,104,36,140,30,170,297,57.24%,35.02%,1
臺南市,柳營區,0180,273,56,329,39,368,673,54.68%,40.56%,1
臺南市,柳營區,0181,244,58,302,56,358,640,55.94%,38.13%,1
臺南市,柳營區,0182,192,63,255,26,281,660,42.58%,29.09%,1
臺南市,柳營區,0183,376,89,465,42,507,1212,41.83%,31.02%,1
臺南市,柳營區,0184,70,16,86,4,90,202,44.55%,34.65%,1
臺南市,柳營區,0185,340,88,428,75,503,1049,47.95%,32.41%,1
臺南市,柳營區,0186,55,12,67,2,69,158,43.67%,34.81%,1
臺南市,柳營區,0187,307,93,400,64,464,921,50.38%,33.33%,1
臺南市,柳營區,0188,155,33,188,19,207,504,41.07%,30.75%,1
臺南市,柳營區,0189,50,11,61,4,65,157,41.4%,31.85%,1
臺南市,後壁區,0001,288,73,361,65,426,743,57.34%,38.76%,1
臺南市,後壁區,0002,330,73,403,21,424,898,47.22%,36.75%,1
臺南市,後壁區,0003,234,79,313,51,364,786,46.31%,29.77%,1
臺南市,後壁區,0004,163,50,213,58,271,534,50.75%,30.52%,1
臺南市,後壁區,0005,354,104,458,70,528,1034,51.06%,34.24%,1
臺南市,後壁區,0006,55,32,87,19,106,232,45.69%,23.71%,1
臺南市,後壁區,0007,150,42,192,41,233,479,48.64%,31.32%,1
臺南市,後壁區,0008,267,75,342,25,367,837,43.85%,31.9%,1
臺南市,後壁區,0009,287,95,382,33,415,1085,38.25%,26.45%,1
臺南市,後壁區,0010,300,61,361,23,384,1157,33.19%,25.93%,1
臺南市,後壁區,0011,269,55,324,60,384,755,50.86%,35.63%,1
臺南市,後壁區,0012,160,54,214,32,246,458,53.71%,34.93%,1
臺南市,後壁區,0013,116,27,143,29,172,371,46.36%,31.27%,1
臺南市,後壁區,0014,205,70,275,49,324,676,47.93%,30.33%,1
臺南市,後壁區,0015,128,35,163,27,190,428,44.39%,29.91%,1
臺南市,後壁區,0016,138,43,181,12,193,547,35.28%,25.23%,1
臺南市,後壁區,0017,123,57,180,51,231,455,50.77%,27.03%,1
臺南市,後壁區,0018,245,85,330,70,400,984,40.65%,24.9%,1
臺南市,後壁區,0019,143,39,182,31,213,483,44.1%,29.61%,1
臺南市,後壁區,0020,165,26,191,32,223,536,41.6%,30.78%,1
臺南市,後壁區,0021,234,55,289,13,302,958,31.52%,24.43%,1
臺南市,後壁區,0022,178,42,220,33,253,441,57.37%,40.36%,1
臺南市,後壁區,0023,226,69,295,63,358,677,52.88%,33.38%,1
臺南市,後壁區,0024,354,87,441,78,519,996,52.11%,35.54%,1
臺南市,後壁區,0025,374,117,491,31,522,1255,41.59%,29.8%,1
臺南市,後壁區,0026,213,55,268,15,283,678,41.74%,31.42%,1
臺南市,後壁區,0027,145,40,185,9,194,553,35.08%,26.22%,1
臺南市,後壁區,0028,148,41,189,14,203,616,32.95%,24.03%,1
臺南市,後壁區,0029,392,108,500,28,528,1189,44.41%,32.97%,1
臺南市,東山區,0062,436,123,559,62,621,1401,44.33%,31.12%,1
臺南市,東山區,0063,354,79,433,29,462,1185,38.99%,29.87%,1
臺南市,東山區,0064,342,121,463,63,526,1303,40.37%,26.25%,1
臺南市,東山區,0065,199,59,258,32,290,732,39.62%,27.19%,1
臺南市,東山區,0066,185,52,237,34,271,721,37.59%,25.66%,1
臺南市,東山區,0067,256,92,348,46,394,1104,35.69%,23.19%,1
臺南市,東山區,0068,265,74,339,23,362,943,38.39%,28.1%,1
臺南市,東山區,0069,115,20,135,4,139,653,21.29%,17.61%,1
臺南市,東山區,0070,178,43,221,69,290,596,48.66%,29.87%,1
臺南市,東山區,0071,241,85,326,65,391,878,44.53%,27.45%,1
臺南市,東山區,0072,191,70,261,58,319,771,41.37%,24.77%,1
臺南市,東山區,0073,145,38,183,26,209,483,43.27%,30.02%,1
臺南市,東山區,0074,207,48,255,38,293,640,45.78%,32.34%,1
臺南市,東山區,0075,72,21,93,2,95,425,22.35%,16.94%,1
臺南市,東山區,0076,105,22,127,17,144,394,36.55%,26.65%,1
臺南市,東山區,0077,123,36,159,26,185,373,49.6%,32.98%,1
臺南市,東山區,0078,281,75,356,33,389,1257,30.95%,22.35%,1
臺南市,東山區,0079,149,40,189,7,196,887,22.1%,16.8%,1
臺南市,東山區,0080,119,28,147,12,159,658,24.16%,18.09%,1
臺南市,東山區,0081,212,69,281,26,307,1101,27.88%,19.26%,1
臺南市,東山區,0082,182,59,241,18,259,1057,24.5%,17.22%,1
臺南市,東山區,0083,204,56,260,43,303,639,47.42%,31.92%,1
臺南市,東山區,0084,78,29,107,10,117,270,43.33%,28.89%,1
臺南市,麻豆區,0381,419,130,549,47,596,1205,49.46%,34.77%,1
臺南市,麻豆區,0382,246,85,331,37,368,660,55.76%,37.27%,1
臺南市,麻豆區,0383,174,83,257,15,272,523,52.01%,33.27%,1
臺南市,麻豆區,0384,564,173,737,37,774,1597,48.47%,35.32%,1
臺南市,麻豆區,0385,490,158,648,53,701,1262,55.55%,38.83%,1
臺南市,麻豆區,0386,526,171,697,43,740,1325,55.85%,39.7%,1
臺南市,麻豆區,0387,483,141,624,31,655,1384,47.33%,34.9%,1
臺南市,麻豆區,0388,395,139,534,21,555,1121,49.51%,35.24%,1
臺南市,麻豆區,0389,328,125,453,15,468,1021,45.84%,32.13%,1
臺南市,麻豆區,0390,314,111,425,36,461,954,48.32%,32.91%,1
臺南市,麻豆區,0391,442,158,600,32,632,1513,41.77%,29.21%,1
臺南市,麻豆區,0392,536,156,692,41,733,1726,42.47%,31.05%,1
臺南市,麻豆區,0393,664,162,826,60,886,1804,49.11%,36.81%,1
臺南市,麻豆區,0394,338,130,468,26,494,1106,44.67%,30.56%,1
臺南市,麻豆區,0395,520,163,683,44,727,1503,48.37%,34.6%,1
臺南市,麻豆區,0396,468,140,608,49,657,1302,50.46%,35.94%,1
臺南市,麻豆區,0397,223,62,285,14,299,645,46.36%,34.57%,1
臺南市,麻豆區,0398,311,103,414,23,437,777,56.24%,40.03%,1
臺南市,麻豆區,0399,519,157,676,39,715,1612,44.35%,32.2%,1
臺南市,麻豆區,0400,222,57,279,15,294,718,40.95%,30.92%,1
臺南市,麻豆區,0401,496,143,639,22,661,1656,39.92%,29.95%,1
臺南市,麻豆區,0402,458,135,593,69,662,1355,48.86%,33.8%,1
臺南市,麻豆區,0403,274,61,335,28,363,977,37.15%,28.05%,1
臺南市,麻豆區,0404,305,97,402,33,435,1012,42.98%,30.14%,1
臺南市,麻豆區,0405,230,73,303,21,324,626,51.76%,36.74%,1
臺南市,麻豆區,0406,100,28,128,4,132,467,28.27%,21.41%,1
臺南市,麻豆區,0407,394,126,520,19,539,1260,42.78%,31.27%,1
臺南市,麻豆區,0408,396,118,514,41,555,1111,49.95%,35.64%,1
臺南市,麻豆區,0409,207,62,269,16,285,550,51.82%,37.64%,1
臺南市,麻豆區,0410,267,98,365,38,403,798,50.5%,33.46%,1
臺南市,麻豆區,0411,343,89,432,75,507,852,59.51%,40.26%,1
臺南市,麻豆區,0412,240,65,305,11,316,830,38.07%,28.92%,1
臺南市,麻豆區,0413,286,78,364,13,377,941,40.06%,30.39%,1
臺南市,麻豆區,0414,400,125,525,33,558,1158,48.19%,34.54%,1
臺南市,麻豆區,0415,190,60,250,9,259,612,42.32%,31.05%,1
臺南市,下營區,0343,452,119,571,46,617,1558,39.6%,29.01%,1
臺南市,下營區,0344,298,96,394,27,421,1112,37.86%,26.8%,1
臺南市,下營區,0345,288,76,364,58,422,893,47.26%,32.25%,1
臺南市,下營區,0346,464,125,589,49,638,1623,39.31%,28.59%,1
臺南市,下營區,0347,529,147,676,86,762,1568,48.6%,33.74%,1
臺南市,下營區,0348,356,99,455,50,505,985,51.27%,36.14%,1
臺南市,下營區,0349,318,59,377,18,395,953,41.45%,33.37%,1
臺南市,下營區,0350,335,92,427,29,456,1031,44.23%,32.49%,1
臺南市,下營區,0351,404,124,528,67,595,1077,55.25%,37.51%,1
臺南市,下營區,0352,182,63,245,35,280,703,39.83%,25.89%,1
臺南市,下營區,0353,252,66,318,21,339,854,39.7%,29.51%,1
臺南市,下營區,0354,398,111,509,45,554,1164,47.59%,34.19%,1
臺南市,下營區,0355,339,88,427,20,447,1091,40.97%,31.07%,1
臺南市,下營區,0356,346,82,428,61,489,959,50.99%,36.08%,1
臺南市,下營區,0357,321,74,395,30,425,935,45.45%,34.33%,1
臺南市,下營區,0358,319,85,404,43,447,893,50.06%,35.72%,1
臺南市,下營區,0359,476,114,590,77,667,1293,51.59%,36.81%,1
臺南市,下營區,0360,385,139,524,102,626,1185,52.83%,32.49%,1
臺南市,下營區,0361,272,68,340,18,358,1070,33.46%,25.42%,1
臺南市,六甲區,0362,309,102,411,53,464,819,56.65%,37.73%,1
臺南市,六甲區,0363,227,66,293,21,314,645,48.68%,35.19%,1
臺南市,六甲區,0364,476,118,594,47,641,1444,44.39%,32.96%,1
臺南市,六甲區,0365,441,128,569,59,628,1554,40.41%,28.38%,1
臺南市,六甲區,0366,345,91,436,45,481,1171,41.08%,29.46%,1
臺南市,六甲區,0367,437,144,581,66,647,1351,47.89%,32.35%,1
臺南市,六甲區,0368,290,107,397,68,465,1010,46.04%,28.71%,1
臺南市,六甲區,0369,297,75,372,60,432,919,47.01%,32.32%,1
臺南市,六甲區,0370,443,139,582,68,650,1369,47.48%,32.36%,1
臺南市,六甲區,0371,347,96,443,57,500,976,51.23%,35.55%,1
臺南市,六甲區,0372,373,126,499,57,556,1015,54.78%,36.75%,1
臺南市,六甲區,0373,365,117,482,30,512,1176,43.54%,31.04%,1
臺南市,六甲區,0374,317,109,426,54,480,939,51.12%,33.76%,1
臺南市,六甲區,0375,236,88,324,45,369,712,51.83%,33.15%,1
臺南市,六甲區,0376,324,91,415,42,457,881,51.87%,36.78%,1
臺南市,六甲區,0377,486,146,632,58,690,1184,58.28%,41.05%,1
臺南市,六甲區,0378,237,91,328,34,362,599,60.43%,39.57%,1
臺南市,六甲區,0379,164,45,209,11,220,759,28.99%,21.61%,1
臺南市,六甲區,0380,160,55,215,29,244,621,39.29%,25.76%,1
臺南市,官田區,0416,345,108,453,13,466,1104,42.21%,31.25%,1
臺南市,官田區,0417,328,101,429,45,474,965,49.12%,33.99%,1
臺南市,官田區,0418,498,138,636,41,677,1402,48.29%,35.52%,1
臺南市,官田區,0419,607,207,814,90,904,1653,54.69%,36.72%,1
臺南市,官田區,0420,281,104,385,51,436,966,45.13%,29.09%,1
臺南市,官田區,0421,77,31,108,14,122,284,42.96%,27.11%,1
臺南市,官田區,0422,84,20,104,5,109,402,27.11%,20.9%,1
臺南市,官田區,0423,344,109,453,8,461,982,46.95%,35.03%,1
臺南市,官田區,0424,285,91,376,27,403,975,41.33%,29.23%,1
臺南市,官田區,0425,272,87,359,39,398,802,49.63%,33.92%,1
臺南市,官田區,0426,424,119,543,51,594,1118,53.13%,37.92%,1
臺南市,官田區,0427,510,146,656,30,686,1455,47.15%,35.05%,1
臺南市,官田區,0428,425,131,556,30,586,1208,48.51%,35.18%,1
臺南市,官田區,0429,382,135,517,59,576,1293,44.55%,29.54%,1
臺南市,官田區,0430,169,51,220,19,239,607,39.37%,27.84%,1
臺南市,官田區,0431,156,49,205,34,239,501,47.7%,31.14%,1
臺南市,官田區,0432,262,80,342,54,396,728,54.4%,35.99%,1
臺南市,官田區,0433,258,102,360,16,376,842,44.66%,30.64%,1
臺南市,官田區,0434,170,67,237,38,275,515,53.4%,33.01%,1
臺南市,官田區,0435,250,59,309,17,326,873,37.34%,28.64%,1
臺南市,大內區,0436,208,64,272,52,324,759,42.69%,27.4%,1
臺南市,大內區,0437,66,15,81,2,83,262,31.68%,25.19%,1
臺南市,大內區,0438,163,33,196,14,210,646,32.51%,25.23%,1
臺南市,大內區,0439,412,101,513,70,583,1473,39.58%,27.97%,1
臺南市,大內區,0440,352,71,423,68,491,915,53.66%,38.47%,1
臺南市,大內區,0441,302,90,392,36,428,779,54.94%,38.77%,1
臺南市,大內區,0442,258,77,335,53,388,637,60.91%,40.5%,1
臺南市,大內區,0443,289,93,382,35,417,993,41.99%,29.1%,1
臺南市,大內區,0444,307,64,371,38,409,766,53.39%,40.08%,1
臺南市,大內區,0445,318,55,373,37,410,841,48.75%,37.81%,1
臺南市,大內區,0446,193,45,238,45,283,583,48.54%,33.1%,1
臺南市,佳里區,0282,532,171,703,67,770,1391,55.36%,38.25%,1
臺南市,佳里區,0283,351,99,450,32,482,829,58.14%,42.34%,1
臺南市,佳里區,0284,465,125,590,20,610,1401,43.54%,33.19%,1
臺南市,佳里區,0285,471,108,579,19,598,1452,41.18%,32.44%,1
臺南市,佳里區,0286,527,148,675,58,733,1382,53.04%,38.13%,1
臺南市,佳里區,0287,560,133,693,73,766,1463,52.36%,38.28%,1
臺南市,佳里區,0288,460,110,570,41,611,1280,47.73%,35.94%,1
臺南市,佳里區,0289,574,162,736,68,804,1486,54.1%,38.63%,1
臺南市,佳里區,0290,531,153,684,70,754,1378,54.72%,38.53%,1
臺南市,佳里區,0291,578,161,739,60,799,1505,53.09%,38.41%,1
臺南市,佳里區,0292,717,160,877,88,965,1860,51.88%,38.55%,1
臺南市,佳里區,0293,451,112,563,70,633,1134,55.82%,39.77%,1
臺南市,佳里區,0294,545,151,696,64,760,1426,53.3%,38.22%,1
臺南市,佳里區,0295,706,160,866,59,925,1779,52%,39.69%,1
臺南市,佳里區,0296,796,181,977,59,1036,1906,54.35%,41.76%,1
臺南市,佳里區,0297,517,139,656,48,704,1425,49.4%,36.28%,1
臺南市,佳里區,0298,488,121,609,46,655,1255,52.19%,38.88%,1
臺南市,佳里區,0299,532,136,668,73,741,1524,48.62%,34.91%,1
臺南市,佳里區,0300,612,156,768,45,813,1631,49.85%,37.52%,1
臺南市,佳里區,0301,685,148,833,29,862,1546,55.76%,44.31%,1
臺南市,佳里區,0302,534,126,660,42,702,1187,59.14%,44.99%,1
臺南市,佳里區,0303,532,133,665,41,706,1381,51.12%,38.52%,1
臺南市,佳里區,0304,507,129,636,16,652,1364,47.8%,37.17%,1
臺南市,佳里區,0305,496,153,649,27,676,1314,51.45%,37.75%,1
臺南市,佳里區,0306,441,137,578,55,633,1164,54.38%,37.89%,1
臺南市,佳里區,0307,352,110,462,50,512,961,53.28%,36.63%,1
臺南市,佳里區,0308,520,18,538,47,585,1218,48.03%,42.69%,1
臺南市,佳里區,0309,338,112,450,19,469,919,51.03%,36.78%,1
臺南市,佳里區,0310,254,65,319,25,344,689,49.93%,36.87%,1
臺南市,佳里區,0311,110,48,158,10,168,383,43.86%,28.72%,1
臺南市,佳里區,0312,502,160,662,51,713,1507,47.31%,33.31%,1
臺南市,佳里區,0313,244,63,307,37,344,702,49%,34.76%,1
臺南市,佳里區,0314,355,98,453,42,495,907,54.58%,39.14%,1
臺南市,佳里區,0315,380,125,505,45,550,937,58.7%,40.55%,1
臺南市,佳里區,0316,401,135,536,10,546,1030,53.01%,38.93%,1
臺南市,佳里區,0317,358,100,458,45,503,981,51.27%,36.49%,1
臺南市,佳里區,0318,267,59,326,22,348,787,44.22%,33.93%,1
臺南市,佳里區,0319,566,120,686,73,759,1513,50.17%,37.41%,1
臺南市,佳里區,0320,216,54,270,19,289,714,40.48%,30.25%,1
臺南市,佳里區,0321,253,75,328,40,368,745,49.4%,33.96%,1
臺南市,佳里區,0322,283,106,389,28,417,951,43.85%,29.76%,1
臺南市,學甲區,0208,299,121,420,59,479,862,55.57%,34.69%,1
臺南市,學甲區,0209,237,87,324,10,334,611,54.66%,38.79%,1
臺南市,學甲區,0210,334,109,443,29,472,936,50.43%,35.68%,1
臺南市,學甲區,0211,350,120,470,31,501,1066,47%,32.83%,1
臺南市,學甲區,0212,337,110,447,31,478,869,55.01%,38.78%,1
臺南市,學甲區,0213,232,58,290,35,325,635,51.18%,36.54%,1
臺南市,學甲區,0214,288,57,345,21,366,822,44.53%,35.04%,1
臺南市,學甲區,0215,134,33,167,18,185,443,41.76%,30.25%,1
臺南市,學甲區,0216,517,133,650,36,686,1370,50.07%,37.74%,1
臺南市,學甲區,0217,402,146,548,54,602,1117,53.89%,35.99%,1
臺南市,學甲區,0218,476,126,602,78,680,1365,49.82%,34.87%,1
臺南市,學甲區,0219,514,128,642,72,714,1489,47.95%,34.52%,1
臺南市,學甲區,0220,156,54,210,42,252,627,40.19%,24.88%,1
臺南市,學甲區,0221,367,86,453,47,500,1052,47.53%,34.89%,1
臺南市,學甲區,0222,423,104,527,21,548,1183,46.32%,35.76%,1
臺南市,學甲區,0223,285,79,364,27,391,979,39.94%,29.11%,1
臺南市,學甲區,0224,364,123,487,66,553,1241,44.56%,29.33%,1
臺南市,學甲區,0225,242,48,290,23,313,843,37.13%,28.71%,1
臺南市,學甲區,0226,189,55,244,35,279,580,48.1%,32.59%,1
臺南市,學甲區,0227,227,44,271,19,290,832,34.86%,27.28%,1
臺南市,學甲區,0228,89,48,137,5,142,406,34.98%,21.92%,1
臺南市,學甲區,0229,301,81,382,42,424,818,51.83%,36.8%,1
臺南市,學甲區,0230,281,81,362,17,379,1052,36.03%,26.71%,1
臺南市,學甲區,0231,161,55,216,11,227,578,39.27%,27.85%,1
臺南市,學甲區,0232,105,39,144,23,167,430,38.84%,24.42%,1
臺南市,學甲區,0233,134,20,154,10,164,361,45.43%,37.12%,1
臺南市,西港區,0323,342,81,423,18,441,933,47.27%,36.66%,1
臺南市,西港區,0324,321,115,436,22,458,901,50.83%,35.63%,1
臺南市,西港區,0325,448,114,562,23,585,1314,44.52%,34.09%,1
臺南市,西港區,0326,486,133,619,71,690,1349,51.15%,36.03%,1
臺南市,西港區,0327,398,116,514,45,559,1014,55.13%,39.25%,1
臺南市,西港區,0328,538,126,664,36,700,1900,36.84%,28.32%,1
臺南市,西港區,0329,537,132,669,53,722,1663,43.42%,32.29%,1
臺南市,西港區,0330,203,78,281,13,294,738,39.84%,27.51%,1
臺南市,西港區,0331,483,110,593,52,645,1211,53.26%,39.88%,1
臺南市,西港區,0332,114,40,154,25,179,382,46.86%,29.84%,1
臺南市,西港區,0333,246,66,312,14,326,786,41.48%,31.3%,1
臺南市,西港區,0334,274,71,345,15,360,838,42.96%,32.7%,1
臺南市,西港區,0335,409,116,525,41,566,1449,39.06%,28.23%,1
臺南市,西港區,0336,429,106,535,24,559,1479,37.8%,29.01%,1
臺南市,西港區,0337,287,65,352,68,420,763,55.05%,37.61%,1
臺南市,西港區,0338,386,110,496,24,520,1297,40.09%,29.76%,1
臺南市,西港區,0339,433,130,563,34,597,1393,42.86%,31.08%,1
臺南市,西港區,0340,257,77,334,16,350,958,36.53%,26.83%,1
臺南市,西港區,0341,147,34,181,19,200,391,51.15%,37.6%,1
臺南市,西港區,0342,291,78,369,52,421,805,52.3%,36.15%,1
臺南市,七股區,0258,166,42,208,15,223,534,41.76%,31.09%,1
臺南市,七股區,0259,178,60,238,14,252,508,49.61%,35.04%,1
臺南市,七股區,0260,161,34,195,5,200,665,30.08%,24.21%,1
臺南市,七股區,0261,256,55,311,21,332,834,39.81%,30.7%,1
臺南市,七股區,0262,226,54,280,16,296,810,36.54%,27.9%,1
臺南市,七股區,0263,114,29,143,7,150,480,31.25%,23.75%,1
臺南市,七股區,0264,122,26,148,4,152,445,34.16%,27.42%,1
臺南市,七股區,0265,130,38,168,10,178,680,26.18%,19.12%,1
臺南市,七股區,0266,192,44,236,9,245,838,29.24%,22.91%,1
臺南市,七股區,0267,183,45,228,18,246,780,31.54%,23.46%,1
臺南市,七股區,0268,133,32,165,17,182,350,52%,38%,1
臺南市,七股區,0269,349,106,455,62,517,907,57%,38.48%,1
臺南市,七股區,0270,239,57,296,16,312,780,40%,30.64%,1
臺南市,七股區,0271,518,116,634,40,674,1658,40.65%,31.24%,1
臺南市,七股區,0272,280,67,347,32,379,913,41.51%,30.67%,1
臺南市,七股區,0273,428,107,535,54,589,1202,49%,35.61%,1
臺南市,七股區,0274,194,36,230,6,236,696,33.91%,27.87%,1
臺南市,七股區,0275,210,61,271,32,303,647,46.83%,32.46%,1
臺南市,七股區,0276,269,68,337,48,385,622,61.9%,43.25%,1
臺南市,七股區,0277,459,122,581,86,667,1175,56.77%,39.06%,1
臺南市,七股區,0278,215,64,279,21,300,698,42.98%,30.8%,1
臺南市,七股區,0279,340,102,442,66,508,983,51.68%,34.59%,1
臺南市,七股區,0280,323,116,439,38,477,1366,34.92%,23.65%,1
臺南市,七股區,0281,403,120,523,78,601,1379,43.58%,29.22%,1
臺南市,將軍區,0234,420,130,550,70,620,1110,55.86%,37.84%,1
臺南市,將軍區,0235,481,117,598,25,623,1418,43.94%,33.92%,1
臺南市,將軍區,0236,326,80,406,19,425,969,43.86%,33.64%,1
臺南市,將軍區,0237,205,58,263,36,299,519,57.61%,39.5%,1
臺南市,將軍區,0238,358,127,485,16,501,1106,45.3%,32.37%,1
臺南市,將軍區,0239,170,55,225,42,267,542,49.26%,31.37%,1
臺南市,將軍區,0240,81,24,105,11,116,315,36.83%,25.71%,1
臺南市,將軍區,0241,79,38,117,20,137,584,23.46%,13.53%,1
臺南市,將軍區,0242,136,31,167,7,174,398,43.72%,34.17%,1
臺南市,將軍區,0243,168,41,209,13,222,608,36.51%,27.63%,1
臺南市,將軍區,0244,150,49,199,15,214,442,48.42%,33.94%,1
臺南市,將軍區,0245,155,49,204,11,215,650,33.08%,23.85%,1
臺南市,將軍區,0246,132,35,167,14,181,573,31.59%,23.04%,1
臺南市,將軍區,0247,155,40,195,9,204,617,33.06%,25.12%,1
臺南市,將軍區,0248,181,47,228,29,257,573,44.85%,31.59%,1
臺南市,將軍區,0249,150,38,188,24,212,434,48.85%,34.56%,1
臺南市,將軍區,0250,228,58,286,14,300,849,35.34%,26.86%,1
臺南市,將軍區,0251,179,46,225,28,253,645,39.22%,27.75%,1
臺南市,將軍區,0252,172,44,216,27,243,690,35.22%,24.93%,1
臺南市,將軍區,0253,145,32,177,7,184,663,27.75%,21.87%,1
臺南市,將軍區,0254,300,73,373,29,402,1175,34.21%,25.53%,1
臺南市,將軍區,0255,201,44,245,28,273,837,32.62%,24.01%,1
臺南市,將軍區,0256,339,102,441,115,556,1061,52.4%,31.95%,1
臺南市,將軍區,0257,233,48,281,22,303,976,31.05%,23.87%,1
臺南市,北門區,0190,123,61,184,14,198,484,40.91%,25.41%,1
臺南市,北門區,0191,123,25,148,15,163,401,40.65%,30.67%,1
臺南市,北門區,0192,119,26,145,6,151,456,33.11%,26.1%,1
臺南市,北門區,0193,152,33,185,15,200,382,52.36%,39.79%,1
臺南市,北門區,0194,124,31,155,20,175,356,49.16%,34.83%,1
臺南市,北門區,0195,99,29,128,6,134,389,34.45%,25.45%,1
臺南市,北門區,0196,227,55,282,5,287,742,38.68%,30.59%,1
臺南市,北門區,0197,179,39,218,11,229,599,38.23%,29.88%,1
臺南市,北門區,0198,174,46,220,23,243,594,40.91%,29.29%,1
臺南市,北門區,0199,173,46,219,25,244,572,42.66%,30.24%,1
臺南市,北門區,0200,68,22,90,4,94,318,29.56%,21.38%,1
臺南市,北門區,0201,128,34,162,13,175,473,37%,27.06%,1
臺南市,北門區,0202,213,50,263,17,280,954,29.35%,22.33%,1
臺南市,北門區,0203,294,56,350,38,388,737,52.65%,39.89%,1
臺南市,北門區,0204,157,44,201,16,217,679,31.96%,23.12%,1
臺南市,北門區,0205,126,42,168,28,196,521,37.62%,24.18%,1
臺南市,北門區,0206,150,41,191,16,207,632,32.75%,23.73%,1
臺南市,北門區,0207,162,34,196,14,210,636,33.02%,25.47%,1
臺南市,新化區,0581,340,74,414,38,452,746,60.59%,45.58%,1
臺南市,新化區,0582,458,149,607,43,650,1102,58.98%,41.56%,1
臺南市,新化區,0583,154,37,191,23,214,370,57.84%,41.62%,1
臺南市,新化區,0584,381,111,492,75,567,947,59.87%,40.23%,1
臺南市,新化區,0585,436,110,546,64,610,1154,52.86%,37.78%,1
臺南市,新化區,0586,424,120,544,63,607,1082,56.1%,39.19%,1
臺南市,新化區,0587,432,116,548,63,611,1075,56.84%,40.19%,1
臺南市,新化區,0588,248,63,311,26,337,640,52.66%,38.75%,1
臺南市,新化區,0589,138,42,180,19,199,410,48.54%,33.66%,1
臺南市,新化區,0590,196,46,242,28,270,533,50.66%,36.77%,1
臺南市,新化區,0591,310,91,401,26,427,836,51.08%,37.08%,1
臺南市,新化區,0592,303,83,386,32,418,978,42.74%,30.98%,1
臺南市,新化區,0593,497,157,654,50,704,1348,52.23%,36.87%,1
臺南市,新化區,0594,388,98,486,49,535,1015,52.71%,38.23%,1
臺南市,新化區,0595,425,106,531,35,566,1228,46.09%,34.61%,1
臺南市,新化區,0596,311,93,404,48,452,789,57.29%,39.42%,1
臺南市,新化區,0597,365,114,479,24,503,1022,49.22%,35.71%,1
臺南市,新化區,0598,365,85,450,27,477,1021,46.72%,35.75%,1
臺南市,新化區,0599,499,142,641,65,706,1229,57.45%,40.6%,1
臺南市,新化區,0600,435,118,553,22,575,1153,49.87%,37.73%,1
臺南市,新化區,0601,295,81,376,22,398,1012,39.33%,29.15%,1
臺南市,新化區,0602,576,141,717,76,793,1458,54.39%,39.51%,1
臺南市,新化區,0603,657,183,840,68,908,1645,55.2%,39.94%,1
臺南市,新化區,0604,415,109,524,62,586,1016,57.68%,40.85%,1
臺南市,新化區,0605,204,52,256,11,267,559,47.76%,36.49%,1
臺南市,新化區,0606,503,136,639,37,676,1222,55.32%,41.16%,1
臺南市,新化區,0607,679,173,852,65,917,1562,58.71%,43.47%,1
臺南市,新化區,0608,327,83,410,38,448,994,45.07%,32.9%,1
臺南市,新化區,0609,362,107,469,92,561,1013,55.38%,35.74%,1
臺南市,新化區,0610,446,150,596,75,671,1197,56.06%,37.26%,1
臺南市,新化區,0611,336,121,457,51,508,1021,49.76%,32.91%,1
臺南市,新化區,0612,457,108,565,81,646,1428,45.24%,32%,1
臺南市,新化區,0613,138,44,182,33,215,456,47.15%,30.26%,1
臺南市,新化區,0614,399,118,517,59,576,1037,55.54%,38.48%,1
臺南市,新化區,0615,417,117,534,78,612,1097,55.79%,38.01%,1
臺南市,新化區,0616,330,109,439,58,497,902,55.1%,36.59%,1
臺南市,新化區,0617,322,93,415,93,508,999,50.85%,32.23%,1
臺南市,善化區,0492,355,106,461,31,492,1132,43.46%,31.36%,1
臺南市,善化區,0493,642,199,841,66,907,1845,49.16%,34.8%,1
臺南市,善化區,0494,746,207,953,95,1048,2090,50.14%,35.69%,1
臺南市,善化區,0495,645,146,791,80,871,1582,55.06%,40.77%,1
臺南市,善化區,0496,734,229,963,78,1041,1901,54.76%,38.61%,1
臺南市,善化區,0497,657,193,850,61,911,1818,50.11%,36.14%,1
臺南市,善化區,0498,604,183,787,71,858,1639,52.35%,36.85%,1
臺南市,善化區,0499,422,130,552,42,594,1061,55.98%,39.77%,1
臺南市,善化區,0500,685,190,875,105,980,1786,54.87%,38.35%,1
臺南市,善化區,0501,425,121,546,34,580,1147,50.57%,37.05%,1
臺南市,善化區,0502,541,174,715,72,787,1581,49.78%,34.22%,1
臺南市,善化區,0503,405,154,559,94,653,1240,52.66%,32.66%,1
臺南市,善化區,0504,458,166,624,26,650,1743,37.29%,26.28%,1
臺南市,善化區,0505,479,163,642,51,693,1246,55.62%,38.44%,1
臺南市,善化區,0506,314,117,431,27,458,961,47.66%,32.67%,1
臺南市,善化區,0507,312,97,409,13,422,938,44.99%,33.26%,1
臺南市,善化區,0508,246,80,326,17,343,722,47.51%,34.07%,1
臺南市,善化區,0509,339,89,428,21,449,1062,42.28%,31.92%,1
臺南市,善化區,0510,608,162,770,91,861,1715,50.2%,35.45%,1
臺南市,善化區,0511,368,115,483,54,537,1120,47.95%,32.86%,1
臺南市,善化區,0512,283,105,388,41,429,865,49.6%,32.72%,1
臺南市,善化區,0513,559,194,753,63,816,1574,51.84%,35.51%,1
臺南市,善化區,0514,487,135,622,70,692,1535,45.08%,31.73%,1
臺南市,善化區,0515,378,139,517,61,578,1106,52.26%,34.18%,1
臺南市,善化區,0516,457,151,608,40,648,1402,46.22%,32.6%,1
臺南市,善化區,0517,587,198,785,83,868,1458,59.53%,40.26%,1
臺南市,善化區,0518,462,129,591,45,636,1380,46.09%,33.48%,1
臺南市,善化區,0519,488,145,633,9,642,1232,52.11%,39.61%,1
臺南市,善化區,0520,448,115,563,12,575,1069,53.79%,41.91%,1
臺南市,新市區,0545,344,84,428,22,450,960,46.88%,35.83%,1
臺南市,新市區,0546,460,146,606,45,651,1118,58.23%,41.14%,1
臺南市,新市區,0547,308,83,391,23,414,850,48.71%,36.24%,1
臺南市,新市區,0548,484,113,597,64,661,1241,53.26%,39%,1
臺南市,新市區,0549,505,155,660,40,700,1297,53.97%,38.94%,1
臺南市,新市區,0550,418,80,498,43,541,962,56.24%,43.45%,1
臺南市,新市區,0551,392,248,640,57,697,1237,56.35%,31.69%,1
臺南市,新市區,0552,512,149,661,49,710,1326,53.54%,38.61%,1
臺南市,新市區,0553,476,154,630,64,694,1211,57.31%,39.31%,1
臺南市,新市區,0554,450,159,609,46,655,1305,50.19%,34.48%,1
臺南市,新市區,0555,239,76,315,61,376,688,54.65%,34.74%,1
臺南市,新市區,0556,356,121,477,35,512,911,56.2%,39.08%,1
臺南市,新市區,0557,515,157,672,45,717,1525,47.02%,33.77%,1
臺南市,新市區,0558,336,76,412,3,415,1091,38.04%,30.8%,1
臺南市,新市區,0559,429,113,542,21,563,1122,50.18%,38.24%,1
臺南市,新市區,0560,372,104,476,26,502,1049,47.86%,35.46%,1
臺南市,新市區,0561,479,145,624,27,651,1564,41.62%,30.63%,1
臺南市,新市區,0562,597,155,752,56,808,1515,53.33%,39.41%,1
臺南市,新市區,0563,492,142,634,32,666,1378,48.33%,35.7%,1
臺南市,新市區,0564,364,91,455,59,514,827,62.15%,44.01%,1
臺南市,新市區,0565,401,121,522,87,609,960,63.44%,41.77%,1
臺南市,新市區,0566,340,102,442,56,498,951,52.37%,35.75%,1
臺南市,新市區,0567,369,258,627,69,696,1264,55.06%,29.19%,1
臺南市,新市區,0568,440,130,570,26,596,1173,50.81%,37.51%,1
臺南市,新市區,0569,269,93,362,21,383,684,55.99%,39.33%,1
臺南市,新市區,0570,452,121,573,74,647,1055,61.33%,42.84%,1
臺南市,新市區,0571,497,135,632,52,684,1122,60.96%,44.3%,1
臺南市,安定區,0521,527,155,682,84,766,1251,61.23%,42.13%,1
臺南市,安定區,0522,332,102,434,39,473,899,52.61%,36.93%,1
臺南市,安定區,0523,398,122,520,82,602,1106,54.43%,35.99%,1
臺南市,安定區,0524,352,118,470,55,525,948,55.38%,37.13%,1
臺南市,安定區,0525,479,156,635,31,666,1442,46.19%,33.22%,1
臺南市,安定區,0526,449,149,598,44,642,1385,46.35%,32.42%,1
臺南市,安定區,0527,325,83,408,51,459,801,57.3%,40.57%,1
臺南市,安定區,0528,234,68,302,32,334,736,45.38%,31.79%,1
臺南市,安定區,0529,287,76,363,38,401,781,51.34%,36.75%,1
臺南市,安定區,0530,302,92,394,20,414,795,52.08%,37.99%,1
臺南市,安定區,0531,371,93,464,40,504,862,58.47%,43.04%,1
臺南市,安定區,0532,531,132,663,31,694,1487,46.67%,35.71%,1
臺南市,安定區,0533,519,128,647,26,673,1385,48.59%,37.47%,1
臺南市,安定區,0534,473,166,639,33,672,1518,44.27%,31.16%,1
臺南市,安定區,0535,450,124,574,62,636,1094,58.14%,41.13%,1
臺南市,安定區,0536,562,203,765,117,882,1590,55.47%,35.35%,1
臺南市,安定區,0537,302,82,384,35,419,754,55.57%,40.05%,1
臺南市,安定區,0538,275,83,358,44,402,716,56.15%,38.41%,1
臺南市,安定區,0539,580,170,750,63,813,1492,54.49%,38.87%,1
臺南市,安定區,0540,373,93,466,49,515,943,54.61%,39.55%,1
臺南市,安定區,0541,438,104,542,32,574,1157,49.61%,37.86%,1
臺南市,安定區,0542,508,148,656,111,767,1384,55.42%,36.71%,1
臺南市,安定區,0543,364,107,471,50,521,967,53.88%,37.64%,1
臺南市,安定區,0544,244,47,291,30,321,611,52.54%,39.93%,1
臺南市,山上區,0572,240,58,298,60,358,855,41.87%,28.07%,1
臺南市,山上區,0573,221,57,278,37,315,836,37.68%,26.44%,1
臺南市,山上區,0574,239,87,326,39,365,753,48.47%,31.74%,1
臺南市,山上區,0575,257,73,330,43,373,788,47.34%,32.61%,1
臺南市,山上區,0576,364,84,448,42,490,984,49.8%,36.99%,1
臺南市,山上區,0577,283,93,376,10,386,972,39.71%,29.12%,1
臺南市,山上區,0578,124,28,152,5,157,553,28.39%,22.42%,1
臺南市,山上區,0579,111,25,136,5,141,378,37.3%,29.37%,1
臺南市,山上區,0580,121,37,158,23,181,392,46.17%,30.87%,1
臺南市,玉井區,0466,444,104,548,28,576,1242,46.38%,35.75%,1
臺南市,玉井區,0467,447,99,546,42,588,1141,51.53%,39.18%,1
臺南市,玉井區,0468,234,66,300,21,321,698,45.99%,33.52%,1
臺南市,玉井區,0469,298,84,382,22,404,849,47.59%,35.1%,1
臺南市,玉井區,0470,391,67,458,48,506,949,53.32%,41.2%,1
臺南市,玉井區,0471,229,54,283,18,301,618,48.71%,37.06%,1
臺南市,玉井區,0472,184,41,225,4,229,594,38.55%,30.98%,1
臺南市,玉井區,0473,291,73,364,9,373,927,40.24%,31.39%,1
臺南市,玉井區,0474,188,36,224,47,271,512,52.93%,36.72%,1
臺南市,玉井區,0475,167,44,211,31,242,509,47.54%,32.81%,1
臺南市,玉井區,0476,187,53,240,20,260,496,52.42%,37.7%,1
臺南市,玉井區,0477,242,68,310,9,319,759,42.03%,31.88%,1
臺南市,玉井區,0478,180,48,228,11,239,669,35.72%,26.91%,1
臺南市,玉井區,0479,255,60,315,68,383,787,48.67%,32.4%,1
臺南市,玉井區,0480,179,62,241,40,281,620,45.32%,28.87%,1
臺南市,玉井區,0481,362,87,449,52,501,987,50.76%,36.68%,1
臺南市,楠西區,0447,335,94,429,47,476,978,48.67%,34.25%,1
臺南市,楠西區,0448,334,95,429,44,473,870,54.37%,38.39%,1
臺南市,楠西區,0449,244,79,323,11,334,1160,28.79%,21.03%,1
臺南市,楠西區,0450,207,53,260,23,283,699,40.49%,29.61%,1
臺南市,楠西區,0451,266,55,321,14,335,990,33.84%,26.87%,1
臺南市,楠西區,0452,297,72,369,25,394,928,42.46%,32%,1
臺南市,楠西區,0453,219,44,263,47,310,660,46.97%,33.18%,1
臺南市,楠西區,0454,388,115,503,72,575,1187,48.44%,32.69%,1
臺南市,楠西區,0455,357,89,446,29,475,1056,44.98%,33.81%,1
臺南市,南化區,0456,252,72,324,42,366,690,53.04%,36.52%,1
臺南市,南化區,0457,252,76,328,53,381,695,54.82%,36.26%,1
臺南市,南化區,0458,248,71,319,39,358,806,44.42%,30.77%,1
臺南市,南化區,0459,191,38,229,40,269,654,41.13%,29.2%,1
臺南市,南化區,0460,198,53,251,31,282,783,36.02%,25.29%,1
臺南市,南化區,0461,135,48,183,22,205,425,48.24%,31.76%,1
臺南市,南化區,0462,196,48,244,30,274,559,49.02%,35.06%,1
臺南市,南化區,0463,359,84,443,25,468,1189,39.36%,30.19%,1
臺南市,南化區,0464,381,112,493,34,527,1044,50.48%,36.49%,1
臺南市,南化區,0465,369,92,461,27,488,941,51.86%,39.21%,1
臺南市,左鎮區,0482,133,31,164,23,187,392,47.7%,33.93%,1
臺南市,左鎮區,0483,250,43,293,42,335,644,52.02%,38.82%,1
臺南市,左鎮區,0484,128,36,164,18,182,468,38.89%,27.35%,1
臺南市,左鎮區,0485,198,66,264,48,312,753,41.43%,26.29%,1
臺南市,左鎮區,0486,102,27,129,28,157,345,45.51%,29.57%,1
臺南市,左鎮區,0487,120,30,150,15,165,393,41.98%,30.53%,1
臺南市,左鎮區,0488,126,32,158,14,172,420,40.95%,30%,1
臺南市,左鎮區,0489,82,25,107,8,115,313,36.74%,26.2%,1
臺南市,左鎮區,0490,48,11,59,5,64,186,34.41%,25.81%,1
臺南市,左鎮區,0491,128,47,175,45,220,504,43.65%,25.4%,1
臺南市,仁德區,1188,488,152,640,80,720,1318,54.63%,37.03%,1
臺南市,仁德區,1189,559,141,700,69,769,1406,54.69%,39.76%,1
臺南市,仁德區,1190,524,153,677,86,763,1465,52.08%,35.77%,1
臺南市,仁德區,1191,490,154,644,72,716,1192,60.07%,41.11%,1
臺南市,仁德區,1192,597,158,755,67,822,1429,57.52%,41.78%,1
臺南市,仁德區,1193,453,159,612,111,723,1320,54.77%,34.32%,1
臺南市,仁德區,1194,598,131,729,92,821,1373,59.8%,43.55%,1
臺南市,仁德區,1195,533,160,693,65,758,1330,56.99%,40.08%,1
臺南市,仁德區,1196,704,188,892,26,918,1687,54.42%,41.73%,1
臺南市,仁德區,1197,529,167,696,58,754,1491,50.57%,35.48%,1
臺南市,仁德區,1198,395,109,504,34,538,1151,46.74%,34.32%,1
臺南市,仁德區,1199,581,110,691,24,715,1407,50.82%,41.29%,1
臺南市,仁德區,1200,608,170,778,48,826,1465,56.38%,41.5%,1
臺南市,仁德區,1201,531,175,706,43,749,1335,56.1%,39.78%,1
臺南市,仁德區,1202,544,176,720,63,783,1490,52.55%,36.51%,1
臺南市,仁德區,1203,611,183,794,58,852,1453,58.64%,42.05%,1
臺南市,仁德區,1204,352,100,452,30,482,990,48.69%,35.56%,1
臺南市,仁德區,1205,631,172,803,78,881,1573,56.01%,40.11%,1
臺南市,仁德區,1206,372,132,504,61,565,1031,54.8%,36.08%,1
臺南市,仁德區,1207,456,133,589,31,620,1194,51.93%,38.19%,1
臺南市,仁德區,1208,470,125,595,53,648,1268,51.1%,37.07%,1
臺南市,仁德區,1209,339,128,467,42,509,929,54.79%,36.49%,1
臺南市,仁德區,1210,396,100,496,12,508,1145,44.37%,34.59%,1
臺南市,仁德區,1211,499,141,640,66,706,1413,49.96%,35.31%,1
臺南市,仁德區,1212,546,137,683,103,786,1465,53.65%,37.27%,1
臺南市,仁德區,1213,569,176,745,51,796,1390,57.27%,40.94%,1
臺南市,仁德區,1214,536,155,691,69,760,1396,54.44%,38.4%,1
臺南市,仁德區,1215,738,204,942,50,992,1906,52.05%,38.72%,1
臺南市,仁德區,1216,584,151,735,37,772,1546,49.94%,37.77%,1
臺南市,仁德區,1217,502,138,640,28,668,1546,43.21%,32.47%,1
臺南市,仁德區,1218,554,139,693,49,742,1399,53.04%,39.6%,1
臺南市,仁德區,1219,643,174,817,107,924,1748,52.86%,36.78%,1
臺南市,仁德區,1220,472,130,602,40,642,1140,56.32%,41.4%,1
臺南市,仁德區,1221,461,112,573,27,600,1277,46.99%,36.1%,1
臺南市,仁德區,1222,467,121,588,51,639,1019,62.71%,45.83%,1
臺南市,仁德區,1223,470,140,610,39,649,1414,45.9%,33.24%,1
臺南市,仁德區,1224,450,118,568,28,596,1349,44.18%,33.36%,1
臺南市,仁德區,1225,518,153,671,31,702,1471,47.72%,35.21%,1
臺南市,仁德區,1226,484,144,628,19,647,1324,48.87%,36.56%,1
臺南市,仁德區,1227,497,92,589,38,627,1310,47.86%,37.94%,1
臺南市,仁德區,1228,223,62,285,26,311,554,56.14%,40.25%,1
臺南市,仁德區,1229,618,97,715,33,748,1395,53.62%,44.3%,1
臺南市,仁德區,1230,482,112,594,19,613,1264,48.5%,38.13%,1
臺南市,仁德區,1231,417,119,536,79,615,1180,52.12%,35.34%,1
臺南市,仁德區,1232,277,94,371,38,409,928,44.07%,29.85%,1
臺南市,仁德區,1233,200,198,398,21,419,965,43.42%,20.73%,1
臺南市,仁德區,1234,365,103,468,28,496,1119,44.33%,32.62%,1
臺南市,仁德區,1235,442,130,572,75,647,1206,53.65%,36.65%,1
臺南市,仁德區,1236,466,136,602,38,640,1466,43.66%,31.79%,1
臺南市,歸仁區,1237,563,154,717,79,796,1560,51.03%,36.09%,1
臺南市,歸仁區,1238,584,183,767,67,834,1383,60.3%,42.23%,1
臺南市,歸仁區,1239,552,173,725,42,767,1491,51.44%,37.02%,1
臺南市,歸仁區,1240,479,172,651,72,723,1482,48.79%,32.32%,1
臺南市,歸仁區,1241,494,149,643,33,676,1330,50.83%,37.14%,1
臺南市,歸仁區,1242,552,180,732,48,780,1399,55.75%,39.46%,1
臺南市,歸仁區,1243,506,149,655,26,681,1416,48.09%,35.73%,1
臺南市,歸仁區,1244,406,122,528,33,561,1336,41.99%,30.39%,1
臺南市,歸仁區,1245,391,122,513,73,586,1183,49.54%,33.05%,1
臺南市,歸仁區,1246,419,117,536,22,558,1237,45.11%,33.87%,1
臺南市,歸仁區,1247,442,119,561,72,633,1133,55.87%,39.01%,1
臺南市,歸仁區,1248,414,123,537,34,571,1149,49.7%,36.03%,1
臺南市,歸仁區,1249,413,138,551,7,558,1105,50.5%,37.38%,1
臺南市,歸仁區,1250,407,132,539,62,601,1099,54.69%,37.03%,1
臺南市,歸仁區,1251,422,127,549,81,630,1082,58.23%,39%,1
臺南市,歸仁區,1252,582,150,732,55,787,1519,51.81%,38.31%,1
臺南市,歸仁區,1253,572,188,760,74,834,1467,56.85%,38.99%,1
臺南市,歸仁區,1254,391,128,519,51,570,1090,52.29%,35.87%,1
臺南市,歸仁區,1255,406,108,514,33,547,1131,48.36%,35.9%,1
臺南市,歸仁區,1256,395,91,486,32,518,1080,47.96%,36.57%,1
臺南市,歸仁區,1257,350,109,459,26,485,1121,43.26%,31.22%,1
臺南市,歸仁區,1258,481,153,634,85,719,1336,53.82%,36%,1
臺南市,歸仁區,1259,402,139,541,74,615,1128,54.52%,35.64%,1
臺南市,歸仁區,1260,382,117,499,27,526,1055,49.86%,36.21%,1
臺南市,歸仁區,1261,416,128,544,32,576,1102,52.27%,37.75%,1
臺南市,歸仁區,1262,426,111,537,41,578,1068,54.12%,39.89%,1
臺南市,歸仁區,1263,391,128,519,73,592,1033,57.31%,37.85%,1
臺南市,歸仁區,1264,501,137,638,32,670,1772,37.81%,28.27%,1
臺南市,歸仁區,1265,526,169,695,71,766,1399,54.75%,37.6%,1
臺南市,歸仁區,1266,591,154,745,26,771,1544,49.94%,38.28%,1
臺南市,歸仁區,1267,220,58,278,8,286,684,41.81%,32.16%,1
臺南市,歸仁區,1268,329,115,444,40,484,839,57.69%,39.21%,1
臺南市,歸仁區,1269,389,134,523,60,583,1014,57.5%,38.36%,1
臺南市,歸仁區,1270,511,144,655,36,691,1906,36.25%,26.81%,1
臺南市,歸仁區,1271,483,157,640,69,709,1245,56.95%,38.8%,1
臺南市,歸仁區,1272,396,125,521,35,556,1048,53.05%,37.79%,1
臺南市,歸仁區,1273,429,114,543,23,566,1175,48.17%,36.51%,1
臺南市,歸仁區,1274,458,147,605,31,636,1411,45.07%,32.46%,1
臺南市,歸仁區,1275,628,173,801,51,852,1514,56.27%,41.48%,1
臺南市,歸仁區,1276,651,176,827,74,901,1678,53.69%,38.8%,1
臺南市,歸仁區,1277,384,92,476,35,511,949,53.85%,40.46%,1
臺南市,歸仁區,1278,399,133,532,62,594,1009,58.87%,39.54%,1
臺南市,歸仁區,1279,427,148,575,6,581,984,59.04%,43.39%,1
臺南市,歸仁區,1280,320,83,403,42,445,756,58.86%,42.33%,1
臺南市,歸仁區,1281,634,174,808,66,874,1478,59.13%,42.9%,1
臺南市,歸仁區,1282,617,170,787,70,857,1467,58.42%,42.06%,1
臺南市,關廟區,1283,342,113,455,30,485,982,49.39%,34.83%,1
臺南市,關廟區,1284,490,127,617,46,663,1156,57.35%,42.39%,1
臺南市,關廟區,1285,343,92,435,27,462,1006,45.92%,34.1%,1
臺南市,關廟區,1286,409,163,572,58,630,1043,60.4%,39.21%,1
臺南市,關廟區,1287,390,109,499,82,581,1012,57.41%,38.54%,1
臺南市,關廟區,1288,324,86,410,25,435,1013,42.94%,31.98%,1
臺南市,關廟區,1289,496,115,611,31,642,1294,49.61%,38.33%,1
臺南市,關廟區,1290,450,125,575,39,614,1264,48.58%,35.6%,1
臺南市,關廟區,1291,433,116,549,43,592,1166,50.77%,37.14%,1
臺南市,關廟區,1292,340,103,443,20,463,1018,45.48%,33.4%,1
臺南市,關廟區,1293,235,66,301,40,341,733,46.52%,32.06%,1
臺南市,關廟區,1294,446,125,571,35,606,1093,55.44%,40.81%,1
臺南市,關廟區,1295,449,92,541,26,567,1081,52.45%,41.54%,1
臺南市,關廟區,1296,398,128,526,44,570,978,58.28%,40.7%,1
臺南市,關廟區,1297,356,126,482,21,503,1116,45.07%,31.9%,1
臺南市,關廟區,1298,364,103,467,51,518,972,53.29%,37.45%,1
臺南市,關廟區,1299,389,128,517,86,603,1045,57.7%,37.22%,1
臺南市,關廟區,1300,339,87,426,32,458,872,52.52%,38.88%,1
臺南市,關廟區,1301,407,121,528,40,568,1007,56.41%,40.42%,1
臺南市,關廟區,1302,294,102,396,60,456,763,59.76%,38.53%,1
臺南市,關廟區,1303,237,64,301,33,334,630,53.02%,37.62%,1
臺南市,關廟區,1304,364,131,495,58,553,959,57.66%,37.96%,1
臺南市,關廟區,1305,432,100,532,27,559,1123,49.78%,38.47%,1
臺南市,關廟區,1306,294,93,387,70,457,804,56.84%,36.57%,1
臺南市,關廟區,1307,248,71,319,18,337,720,46.81%,34.44%,1
臺南市,關廟區,1308,277,56,333,17,350,843,41.52%,32.86%,1
臺南市,關廟區,1309,123,34,157,10,167,358,46.65%,34.36%,1
臺南市,關廟區,1310,288,77,365,61,426,797,53.45%,36.14%,1
臺南市,關廟區,1311,225,57,282,14,296,709,41.75%,31.73%,1
臺南市,關廟區,1312,302,85,387,17,404,904,44.69%,33.41%,1
臺南市,關廟區,1313,350,89,439,22,461,963,47.87%,36.34%,1
臺南市,關廟區,1314,182,54,236,7,243,489,49.69%,37.22%,1
臺南市,龍崎區,1315,360,108,468,62,530,1047,50.62%,34.38%,1
臺南市,龍崎區,1316,198,52,250,23,273,630,43.33%,31.43%,1
臺南市,龍崎區,1317,38,8,46,3,49,141,34.75%,26.95%,1
臺南市,龍崎區,1318,117,42,159,15,174,367,47.41%,31.88%,1
臺南市,龍崎區,1319,119,27,146,14,160,337,47.48%,35.31%,1
臺南市,龍崎區,1320,88,27,115,8,123,318,38.68%,27.67%,1
臺南市,龍崎區,1321,164,27,191,22,213,427,49.88%,38.41%,1
臺南市,龍崎區,1322,117,39,156,17,173,446,38.79%,26.23%,1
臺南市,永康區,0708,560,142,702,62,764,1398,54.65%,40.06%,1
臺南市,永康區,0709,450,148,598,31,629,1478,42.56%,30.45%,1
臺南市,永康區,0710,532,146,678,39,717,1442,49.72%,36.89%,1
臺南市,永康區,0711,487,132,619,45,664,1353,49.08%,35.99%,1
臺南市,永康區,0712,417,116,533,28,561,1160,48.36%,35.95%,1
臺南市,永康區,0713,451,115,566,29,595,1122,53.03%,40.2%,1
臺南市,永康區,0714,418,129,547,13,560,1165,48.07%,35.88%,1
臺南市,永康區,0715,484,133,617,40,657,1317,49.89%,36.75%,1
臺南市,永康區,0716,535,124,659,45,704,1376,51.16%,38.88%,1
臺南市,永康區,0717,542,146,688,38,726,1361,53.34%,39.82%,1
臺南市,永康區,0718,575,180,755,43,798,1374,58.08%,41.85%,1
臺南市,永康區,0719,579,193,772,60,832,1709,48.68%,33.88%,1
臺南市,永康區,0720,615,162,777,56,833,1717,48.51%,35.82%,1
臺南市,永康區,0721,602,192,794,45,839,1759,47.7%,34.22%,1
臺南市,永康區,0722,619,166,785,53,838,1636,51.22%,37.84%,1
臺南市,永康區,0723,547,138,685,70,755,1442,52.36%,37.93%,1
臺南市,永康區,0724,584,149,733,45,778,1545,50.36%,37.8%,1
臺南市,永康區,0725,605,138,743,43,786,1565,50.22%,38.66%,1
臺南市,永康區,0726,588,177,765,47,812,1684,48.22%,34.92%,1
臺南市,永康區,0727,556,134,690,28,718,1548,46.38%,35.92%,1
臺南市,永康區,0728,551,149,700,41,741,1389,53.35%,39.67%,1
臺南市,永康區,0729,525,137,662,55,717,1369,52.37%,38.35%,1
臺南市,永康區,0730,529,150,679,86,765,1415,54.06%,37.39%,1
臺南市,永康區,0731,448,128,576,16,592,1386,42.71%,32.32%,1
臺南市,永康區,0732,323,56,379,7,386,1747,22.1%,18.49%,1
臺南市,永康區,0733,552,152,704,55,759,1485,51.11%,37.17%,1
臺南市,永康區,0734,644,169,813,73,886,1747,50.72%,36.86%,1
臺南市,永康區,0735,546,154,700,45,745,1744,42.72%,31.31%,1
臺南市,永康區,0736,643,143,786,36,822,1797,45.74%,35.78%,1
臺南市,永康區,0737,724,177,901,61,962,1800,53.44%,40.22%,1
臺南市,永康區,0738,642,144,786,22,808,1720,46.98%,37.33%,1
臺南市,永康區,0739,685,188,873,44,917,1708,53.69%,40.11%,1
臺南市,永康區,0740,612,168,780,30,810,1519,53.32%,40.29%,1
臺南市,永康區,0741,573,178,751,87,838,1497,55.98%,38.28%,1
臺南市,永康區,0742,568,132,700,21,721,1509,47.78%,37.64%,1
臺南市,永康區,0743,653,173,826,73,899,1542,58.3%,42.35%,1
臺南市,永康區,0744,667,147,814,23,837,1536,54.49%,43.42%,1
臺南市,永康區,0745,591,177,768,55,823,1531,53.76%,38.6%,1
臺南市,永康區,0746,552,158,710,49,759,1327,57.2%,41.6%,1
臺南市,永康區,0747,555,160,715,23,738,1456,50.69%,38.12%,1
臺南市,永康區,0748,571,156,727,47,774,1396,55.44%,40.9%,1
臺南市,永康區,0749,591,183,774,68,842,1636,51.47%,36.12%,1
臺南市,永康區,0750,631,172,803,53,856,1592,53.77%,39.64%,1
臺南市,永康區,0751,728,194,922,34,956,2017,47.4%,36.09%,1
臺南市,永康區,0752,262,78,340,11,351,672,52.23%,38.99%,1
臺南市,永康區,0753,541,157,698,29,727,1611,45.13%,33.58%,1
臺南市,永康區,0754,580,158,738,50,788,1502,52.46%,38.62%,1
臺南市,永康區,0755,566,140,706,20,726,1660,43.73%,34.1%,1
臺南市,永康區,0756,510,142,652,30,682,1561,43.69%,32.67%,1
臺南市,永康區,0757,544,169,713,26,739,1590,46.48%,34.21%,1
臺南市,永康區,0758,343,104,447,12,459,924,49.68%,37.12%,1
臺南市,永康區,0759,407,98,505,28,533,938,56.82%,43.39%,1
臺南市,永康區,0760,415,90,505,33,538,957,56.22%,43.36%,1
臺南市,永康區,0761,183,56,239,36,275,496,55.44%,36.9%,1
臺南市,永康區,0762,638,202,840,64,904,1717,52.65%,37.16%,1
臺南市,永康區,0763,534,174,708,34,742,1615,45.94%,33.07%,1
臺南市,永康區,0764,554,161,715,28,743,1554,47.81%,35.65%,1
臺南市,永康區,0765,416,113,529,27,556,1196,46.49%,34.78%,1
臺南市,永康區,0766,490,136,626,39,665,1274,52.2%,38.46%,1
臺南市,永康區,0767,481,133,614,39,653,1215,53.74%,39.59%,1
臺南市,永康區,0768,547,161,708,24,732,1457,50.24%,37.54%,1
臺南市,永康區,0769,578,143,721,18,739,1451,50.93%,39.83%,1
臺南市,永康區,0770,447,162,609,74,683,1423,48%,31.41%,1
臺南市,永康區,0771,550,157,707,35,742,1394,53.23%,39.45%,1
臺南市,永康區,0772,370,106,476,40,516,890,57.98%,41.57%,1
臺南市,永康區,0773,416,139,555,55,610,1018,59.92%,40.86%,1
臺南市,永康區,0774,142,49,191,23,214,368,58.15%,38.59%,1
臺南市,永康區,0775,501,160,661,50,711,1208,58.86%,41.47%,1
臺南市,永康區,0776,380,143,523,38,561,1187,47.26%,32.01%,1
臺南市,永康區,0777,525,142,667,34,701,1381,50.76%,38.02%,1
臺南市,永康區,0778,517,145,662,68,730,1405,51.96%,36.8%,1
臺南市,永康區,0779,516,140,656,66,722,1445,49.97%,35.71%,1
臺南市,永康區,0780,621,165,786,63,849,1687,50.33%,36.81%,1
臺南市,永康區,0781,499,153,652,28,680,1535,44.3%,32.51%,1
臺南市,永康區,0782,631,152,783,53,836,1542,54.22%,40.92%,1
臺南市,永康區,0783,616,160,776,36,812,1618,50.19%,38.07%,1
臺南市,永康區,0784,586,124,710,34,744,1338,55.61%,43.8%,1
臺南市,永康區,0785,503,167,670,68,738,1285,57.43%,39.14%,1
臺南市,永康區,0786,433,124,557,25,582,1240,46.94%,34.92%,1
臺南市,永康區,0787,478,125,603,66,669,1343,49.81%,35.59%,1
臺南市,永康區,0788,555,158,713,48,761,1327,57.35%,41.82%,1
臺南市,永康區,0789,594,166,760,51,811,1565,51.82%,37.96%,1
臺南市,永康區,0790,593,145,738,82,820,1476,55.56%,40.18%,1
臺南市,永康區,0791,556,160,716,45,761,1476,51.56%,37.67%,1
臺南市,永康區,0792,590,194,784,49,833,1463,56.94%,40.33%,1
臺南市,永康區,0793,381,120,501,73,574,983,58.39%,38.76%,1
臺南市,永康區,0794,445,121,566,80,646,1116,57.89%,39.87%,1
臺南市,永康區,0795,407,106,513,74,587,1117,52.55%,36.44%,1
臺南市,永康區,0796,349,124,473,28,501,1069,46.87%,32.65%,1
臺南市,永康區,0797,524,134,658,39,697,1180,59.07%,44.41%,1
臺南市,永康區,0798,454,99,553,90,643,1176,54.68%,38.61%,1
臺南市,永康區,0799,411,139,550,58,608,1158,52.5%,35.49%,1
臺南市,永康區,0800,483,146,629,78,707,1208,58.53%,39.98%,1
臺南市,永康區,0801,543,170,713,88,801,1501,53.36%,36.18%,1
臺南市,永康區,0802,508,159,667,39,706,1298,54.39%,39.14%,1
臺南市,永康區,0803,582,147,729,35,764,1542,49.55%,37.74%,1
臺南市,永康區,0804,630,174,804,53,857,1537,55.76%,40.99%,1
臺南市,永康區,0805,594,153,747,71,818,1359,60.19%,43.71%,1
臺南市,永康區,0806,370,106,476,41,517,1139,45.39%,32.48%,1
臺南市,永康區,0807,398,129,527,47,574,1158,49.57%,34.37%,1
臺南市,永康區,0808,533,172,705,70,775,1538,50.39%,34.66%,1
臺南市,永康區,0809,420,101,521,20,541,1166,46.4%,36.02%,1
臺南市,永康區,0810,440,106,546,26,572,1228,46.58%,35.83%,1
臺南市,永康區,0811,482,144,626,54,680,1200,56.67%,40.17%,1
臺南市,永康區,0812,334,255,589,44,633,1131,55.97%,29.53%,1
臺南市,永康區,0813,434,114,548,30,578,1147,50.39%,37.84%,1
臺南市,永康區,0814,525,146,671,56,727,1442,50.42%,36.41%,1
臺南市,永康區,0815,448,119,567,26,593,1325,44.75%,33.81%,1
臺南市,永康區,0816,412,116,528,37,565,1260,44.84%,32.7%,1
臺南市,永康區,0817,579,169,748,51,799,1631,48.99%,35.5%,1
臺南市,永康區,0818,584,134,718,50,768,1549,49.58%,37.7%,1
臺南市,永康區,0819,588,183,771,36,807,1666,48.44%,35.29%,1
臺南市,永康區,0820,374,89,463,34,497,1012,49.11%,36.96%,1
臺南市,永康區,0821,327,71,398,22,420,976,43.03%,33.5%,1
臺南市,永康區,0822,217,43,260,21,281,531,52.92%,40.87%,1
臺南市,永康區,0823,350,78,428,45,473,859,55.06%,40.75%,1
臺南市,永康區,0824,348,83,431,33,464,937,49.52%,37.14%,1
臺南市,永康區,0825,523,131,654,43,697,1307,53.33%,40.02%,1
臺南市,永康區,0826,538,111,649,26,675,1482,45.55%,36.3%,1
臺南市,永康區,0827,463,120,583,33,616,1341,45.94%,34.53%,1
臺南市,永康區,0828,523,134,657,44,701,1376,50.94%,38.01%,1
臺南市,永康區,0829,511,132,643,48,691,1390,49.71%,36.76%,1
臺南市,永康區,0830,595,188,783,48,831,1534,54.17%,38.79%,1
臺南市,永康區,0831,617,138,755,47,802,1460,54.93%,42.26%,1
臺南市,永康區,0832,544,114,658,26,684,1383,49.46%,39.33%,1
臺南市,永康區,0833,480,130,610,47,657,1299,50.58%,36.95%,1
臺南市,永康區,0834,526,135,661,34,695,1264,54.98%,41.61%,1
臺南市,永康區,0835,569,142,711,54,765,1355,56.46%,41.99%,1
臺南市,永康區,0836,523,124,647,28,675,1414,47.74%,36.99%,1
臺南市,永康區,0837,476,121,597,31,628,1109,56.63%,42.92%,1
臺南市,永康區,0838,433,110,543,44,587,1151,51%,37.62%,1
臺南市,永康區,0839,500,112,612,48,660,1026,64.33%,48.73%,1
臺南市,永康區,0840,381,95,476,24,500,1071,46.69%,35.57%,1
臺南市,永康區,0841,633,188,821,48,869,1387,62.65%,45.64%,1
臺南市,永康區,0842,574,186,760,44,804,1377,58.39%,41.68%,1
臺南市,永康區,0843,629,201,830,65,895,1687,53.05%,37.29%,1
臺南市,永康區,0844,609,189,798,44,842,1700,49.53%,35.82%,1
臺南市,永康區,0845,584,167,751,46,797,1444,55.19%,40.44%,1
臺南市,永康區,0846,575,136,711,44,755,1485,50.84%,38.72%,1
臺南市,永康區,0847,599,165,764,38,802,1717,46.71%,34.89%,1
臺南市,永康區,0848,588,158,746,51,797,1701,46.85%,34.57%,1
臺南市,永康區,0849,506,132,638,31,669,1382,48.41%,36.61%,1
臺南市,東區,1095,758,230,988,59,1047,2681,39.05%,28.27%,1
臺南市,東區,1096,645,214,859,36,895,1811,49.42%,35.62%,1
臺南市,東區,1097,626,219,845,87,932,1491,62.51%,41.99%,1
臺南市,東區,1098,535,169,704,51,755,1378,54.79%,38.82%,1
臺南市,東區,1099,624,184,808,65,873,1552,56.25%,40.21%,1
臺南市,東區,1100,533,190,723,33,756,1326,57.01%,40.2%,1
臺南市,東區,1101,638,189,827,71,898,1594,56.34%,40.03%,1
臺南市,東區,1102,650,232,882,58,940,1639,57.35%,39.66%,1
臺南市,東區,1103,661,203,864,59,923,1724,53.54%,38.34%,1
臺南市,東區,1104,626,202,828,79,907,1629,55.68%,38.43%,1
臺南市,東區,1105,572,146,718,34,752,1399,53.75%,40.89%,1
臺南市,東區,1106,622,161,783,37,820,1534,53.46%,40.55%,1
臺南市,東區,1107,685,194,879,58,937,1656,56.58%,41.36%,1
臺南市,東區,1108,539,127,666,62,728,1322,55.07%,40.77%,1
臺南市,東區,1109,648,186,834,37,871,1620,53.77%,40%,1
臺南市,東區,1110,633,137,770,37,807,1331,60.63%,47.56%,1
臺南市,東區,1111,416,122,538,46,584,1039,56.21%,40.04%,1
臺南市,東區,1112,432,126,558,29,587,1257,46.7%,34.37%,1
臺南市,東區,1113,732,210,942,104,1046,2067,50.6%,35.41%,1
臺南市,東區,1114,902,190,1092,35,1127,2153,52.35%,41.9%,1
臺南市,東區,1115,936,221,1157,68,1225,2363,51.84%,39.61%,1
臺南市,東區,1116,582,156,738,45,783,1427,54.87%,40.78%,1
臺南市,東區,1117,627,186,813,34,847,1555,54.47%,40.32%,1
臺南市,東區,1118,700,190,890,61,951,2115,44.96%,33.1%,1
臺南市,東區,1119,837,233,1070,84,1154,2340,49.32%,35.77%,1
臺南市,東區,1120,958,316,1274,67,1341,2474,54.2%,38.72%,1
臺南市,東區,1121,915,248,1163,73,1236,2391,51.69%,38.27%,1
臺南市,東區,1122,637,236,873,58,931,1673,55.65%,38.08%,1
臺南市,東區,1123,584,189,773,43,816,1594,51.19%,36.64%,1
臺南市,東區,1124,664,199,863,57,920,1607,57.25%,41.32%,1
臺南市,東區,1125,928,225,1153,37,1190,2087,57.02%,44.47%,1
臺南市,東區,1126,1023,279,1302,46,1348,2369,56.9%,43.18%,1
臺南市,東區,1127,612,193,805,101,906,1696,53.42%,36.08%,1
臺南市,東區,1128,590,210,800,46,846,1612,52.48%,36.6%,1
臺南市,東區,1129,602,200,802,73,875,1708,51.23%,35.25%,1
臺南市,東區,1130,620,183,803,54,857,1560,54.94%,39.74%,1
臺南市,東區,1131,702,222,924,63,987,1854,53.24%,37.86%,1
臺南市,東區,1132,773,261,1034,43,1077,2278,47.28%,33.93%,1
臺南市,東區,1133,776,222,998,52,1050,2093,50.17%,37.08%,1
臺南市,東區,1134,959,249,1208,70,1278,2242,57%,42.77%,1
臺南市,東區,1135,509,135,644,46,690,1152,59.9%,44.18%,1
臺南市,東區,1136,612,161,773,23,796,1318,60.39%,46.43%,1
臺南市,東區,1137,886,242,1128,51,1179,2200,53.59%,40.27%,1
臺南市,東區,1138,862,237,1099,44,1143,1960,58.32%,43.98%,1
臺南市,東區,1139,559,178,737,42,779,1489,52.32%,37.54%,1
臺南市,東區,1140,538,187,725,69,794,1443,55.02%,37.28%,1
臺南市,東區,1141,627,225,852,53,905,1498,60.41%,41.86%,1
臺南市,東區,1142,632,217,849,27,876,1622,54.01%,38.96%,1
臺南市,東區,1143,719,206,925,37,962,1738,55.35%,41.37%,1
臺南市,東區,1144,544,179,723,69,792,1501,52.76%,36.24%,1
臺南市,東區,1145,561,201,762,63,825,1482,55.67%,37.85%,1
臺南市,東區,1146,628,211,839,44,883,1829,48.28%,34.34%,1
臺南市,東區,1147,685,207,892,68,960,1764,54.42%,38.83%,1
臺南市,東區,1148,610,170,780,42,822,1427,57.6%,42.75%,1
臺南市,東區,1149,534,174,708,63,771,1427,54.03%,37.42%,1
臺南市,東區,1150,589,143,732,49,781,1388,56.27%,42.44%,1
臺南市,東區,1151,469,182,651,35,686,1131,60.65%,41.47%,1
臺南市,東區,1152,370,116,486,48,534,1000,53.4%,37%,1
臺南市,東區,1153,392,118,510,40,550,996,55.22%,39.36%,1
臺南市,東區,1154,332,120,452,46,498,935,53.26%,35.51%,1
臺南市,東區,1155,313,152,465,80,545,947,57.55%,33.05%,1
臺南市,東區,1156,407,152,559,19,578,1090,53.03%,37.34%,1
臺南市,東區,1157,307,119,426,50,476,896,53.13%,34.26%,1
臺南市,東區,1158,588,204,792,28,820,1589,51.6%,37%,1
臺南市,東區,1159,609,180,789,50,839,1497,56.05%,40.68%,1
臺南市,東區,1160,490,174,664,58,722,1386,52.09%,35.35%,1
臺南市,東區,1161,410,146,556,19,575,1101,52.23%,37.24%,1
臺南市,東區,1162,509,203,712,59,771,1332,57.88%,38.21%,1
臺南市,東區,1163,489,117,606,59,665,1185,56.12%,41.27%,1
臺南市,東區,1164,522,157,679,57,736,1262,58.32%,41.36%,1
臺南市,東區,1165,551,165,716,41,757,1517,49.9%,36.32%,1
臺南市,東區,1166,491,142,633,76,709,1287,55.09%,38.15%,1
臺南市,東區,1167,655,194,849,68,917,1657,55.34%,39.53%,1
臺南市,東區,1168,849,268,1117,104,1221,2238,54.56%,37.94%,1
臺南市,東區,1169,796,292,1088,61,1149,2246,51.16%,35.44%,1
臺南市,東區,1170,820,243,1063,60,1123,2191,51.26%,37.43%,1
臺南市,東區,1171,775,236,1011,66,1077,2063,52.21%,37.57%,1
臺南市,東區,1172,904,267,1171,84,1255,2177,57.65%,41.53%,1
臺南市,東區,1173,776,207,983,91,1074,1863,57.65%,41.65%,1
臺南市,東區,1174,903,237,1140,45,1185,2185,54.23%,41.33%,1
臺南市,東區,1175,583,177,760,52,812,1721,47.18%,33.88%,1
臺南市,東區,1176,586,185,771,93,864,1556,55.53%,37.66%,1
臺南市,東區,1177,683,188,871,49,920,1602,57.43%,42.63%,1
臺南市,東區,1178,573,144,717,84,801,1523,52.59%,37.62%,1
臺南市,東區,1179,462,167,629,57,686,1382,49.64%,33.43%,1
臺南市,東區,1180,570,177,747,38,785,1486,52.83%,38.36%,1
臺南市,東區,1181,551,247,798,71,869,1560,55.71%,35.32%,1
臺南市,東區,1182,563,203,766,73,839,1684,49.82%,33.43%,1
臺南市,東區,1183,614,246,860,50,910,1653,55.05%,37.14%,1
臺南市,東區,1184,580,235,815,20,835,1554,53.73%,37.32%,1
臺南市,東區,1185,568,182,750,34,784,1408,55.68%,40.34%,1
臺南市,東區,1186,873,275,1148,41,1189,2084,57.05%,41.89%,1
臺南市,東區,1187,726,226,952,79,1031,1896,54.38%,38.29%,1
臺南市,南區,1015,491,135,626,43,669,1221,54.79%,40.21%,1
臺南市,南區,1016,708,215,923,81,1004,2171,46.25%,32.61%,1
臺南市,南區,1017,492,130,622,42,664,1150,57.74%,42.78%,1
臺南市,南區,1018,474,106,580,32,612,1122,54.55%,42.25%,1
臺南市,南區,1019,490,145,635,49,684,1444,47.37%,33.93%,1
臺南市,南區,1020,605,194,799,64,863,1765,48.9%,34.28%,1
臺南市,南區,1021,499,179,678,55,733,1298,56.47%,38.44%,1
臺南市,南區,1022,622,141,763,37,800,1458,54.87%,42.66%,1
臺南市,南區,1023,741,143,884,34,918,1940,47.32%,38.2%,1
臺南市,南區,1024,586,194,780,70,850,1637,51.92%,35.8%,1
臺南市,南區,1025,292,83,375,15,390,871,44.78%,33.52%,1
臺南市,南區,1026,239,76,315,19,334,589,56.71%,40.58%,1
臺南市,南區,1027,362,118,480,44,524,801,65.42%,45.19%,1
臺南市,南區,1028,402,108,510,58,568,990,57.37%,40.61%,1
臺南市,南區,1029,527,156,683,54,737,1222,60.31%,43.13%,1
臺南市,南區,1030,402,120,522,77,599,997,60.08%,40.32%,1
臺南市,南區,1031,391,160,551,38,589,1204,48.92%,32.48%,1
臺南市,南區,1032,491,177,668,31,699,1570,44.52%,31.27%,1
臺南市,南區,1033,452,167,619,51,670,1222,54.83%,36.99%,1
臺南市,南區,1034,351,112,463,29,492,1076,45.72%,32.62%,1
臺南市,南區,1035,377,159,536,27,563,1127,49.96%,33.45%,1
臺南市,南區,1036,422,144,566,53,619,1135,54.54%,37.18%,1
臺南市,南區,1037,449,154,603,66,669,1263,52.97%,35.55%,1
臺南市,南區,1038,342,113,455,33,488,1014,48.13%,33.73%,1
臺南市,南區,1039,547,208,755,76,831,1491,55.73%,36.69%,1
臺南市,南區,1040,672,195,867,43,910,1815,50.14%,37.02%,1
臺南市,南區,1041,498,148,646,26,672,1398,48.07%,35.62%,1
臺南市,南區,1042,650,195,845,50,895,2107,42.48%,30.85%,1
臺南市,南區,1043,650,210,860,70,930,1587,58.6%,40.96%,1
臺南市,南區,1044,575,205,780,89,869,1626,53.44%,35.36%,1
臺南市,南區,1045,561,212,773,42,815,1761,46.28%,31.86%,1
臺南市,南區,1046,591,185,776,90,866,1630,53.13%,36.26%,1
臺南市,南區,1047,577,193,770,58,828,1542,53.7%,37.42%,1
臺南市,南區,1048,515,163,678,92,770,1464,52.6%,35.18%,1
臺南市,南區,1049,572,224,796,108,904,1727,52.35%,33.12%,1
臺南市,南區,1050,443,145,588,58,646,1085,59.54%,40.83%,1
臺南市,南區,1051,336,98,434,20,454,939,48.35%,35.78%,1
臺南市,南區,1052,459,132,591,83,674,1419,47.5%,32.35%,1
臺南市,南區,1053,466,135,601,65,666,1333,49.96%,34.96%,1
臺南市,南區,1054,522,143,665,62,727,1465,49.62%,35.63%,1
臺南市,南區,1055,391,131,522,27,549,1099,49.95%,35.58%,1
臺南市,南區,1056,412,102,514,22,536,1133,47.31%,36.36%,1
臺南市,南區,1057,456,148,604,105,709,1375,51.56%,33.16%,1
臺南市,南區,1058,560,174,734,38,772,1781,43.35%,31.44%,1
臺南市,南區,1059,630,183,813,62,875,1542,56.74%,40.86%,1
臺南市,南區,1060,504,160,664,42,706,1486,47.51%,33.92%,1
臺南市,南區,1061,601,213,814,91,905,1640,55.18%,36.65%,1
臺南市,南區,1062,514,196,710,53,763,1701,44.86%,30.22%,1
臺南市,南區,1063,499,141,640,107,747,1541,48.48%,32.38%,1
臺南市,南區,1064,724,186,910,108,1018,2027,50.22%,35.72%,1
臺南市,南區,1065,724,219,943,90,1033,1774,58.23%,40.81%,1
臺南市,南區,1066,558,203,761,69,830,1613,51.46%,34.59%,1
臺南市,南區,1067,580,186,766,29,795,1707,46.57%,33.98%,1
臺南市,南區,1068,378,126,504,28,532,1657,32.11%,22.81%,1
臺南市,南區,1069,401,126,527,50,577,1077,53.57%,37.23%,1
臺南市,南區,1070,467,119,586,40,626,1185,52.83%,39.41%,1
臺南市,南區,1071,445,150,595,62,657,1249,52.6%,35.63%,1
臺南市,南區,1072,623,176,799,41,840,1985,42.32%,31.39%,1
臺南市,南區,1073,592,227,819,86,905,2017,44.87%,29.35%,1
臺南市,南區,1074,532,218,750,91,841,1717,48.98%,30.98%,1
臺南市,南區,1075,355,106,461,45,506,929,54.47%,38.21%,1
臺南市,南區,1076,262,104,366,28,394,695,56.69%,37.7%,1
臺南市,南區,1077,311,82,393,30,423,997,42.43%,31.19%,1
臺南市,南區,1078,252,50,302,29,331,784,42.22%,32.14%,1
臺南市,南區,1079,454,126,580,67,647,1119,57.82%,40.57%,1
臺南市,南區,1080,289,106,395,33,428,1054,40.61%,27.42%,1
臺南市,南區,1081,409,125,534,105,639,1245,51.33%,32.85%,1
臺南市,南區,1082,631,194,825,93,918,2064,44.48%,30.57%,1
臺南市,南區,1083,557,177,734,32,766,2056,37.26%,27.09%,1
臺南市,南區,1084,422,123,545,26,571,1373,41.59%,30.74%,1
臺南市,南區,1085,270,101,371,37,408,1002,40.72%,26.95%,1
臺南市,南區,1086,273,101,374,67,441,760,58.03%,35.92%,1
臺南市,南區,1087,362,125,487,75,562,1031,54.51%,35.11%,1
臺南市,南區,1088,265,89,354,54,408,744,54.84%,35.62%,1
臺南市,南區,1089,436,132,568,72,640,1186,53.96%,36.76%,1
臺南市,南區,1090,492,167,659,82,741,1358,54.57%,36.23%,1
臺南市,南區,1091,257,99,356,34,390,897,43.48%,28.65%,1
臺南市,南區,1092,444,145,589,70,659,1265,52.09%,35.1%,1
臺南市,南區,1093,331,110,441,41,482,1093,44.1%,30.28%,1
臺南市,南區,1094,395,107,502,28,530,1016,52.17%,38.88%,1
臺南市,北區,0850,654,176,830,79,909,1793,50.7%,36.48%,1
臺南市,北區,0851,553,175,728,52,780,1708,45.67%,32.38%,1
臺南市,北區,0852,391,97,488,22,510,997,51.15%,39.22%,1
臺南市,北區,0853,480,137,617,33,650,1452,44.77%,33.06%,1
臺南市,北區,0854,493,149,642,18,660,1351,48.85%,36.49%,1
臺南市,北區,0855,572,185,757,68,825,1323,62.36%,43.24%,1
臺南市,北區,0856,408,142,550,33,583,1073,54.33%,38.02%,1
臺南市,北區,0857,441,133,574,36,610,1138,53.6%,38.75%,1
臺南市,北區,0858,454,125,579,35,614,1189,51.64%,38.18%,1
臺南市,北區,0859,561,146,707,35,742,1262,58.8%,44.45%,1
臺南市,北區,0860,449,120,569,26,595,1017,58.51%,44.15%,1
臺南市,北區,0861,314,96,410,20,430,847,50.77%,37.07%,1
臺南市,北區,0862,472,112,584,41,625,1076,58.09%,43.87%,1
臺南市,北區,0863,393,139,532,34,566,954,59.33%,41.19%,1
臺南市,北區,0864,509,118,627,62,689,1300,53%,39.15%,1
臺南市,北區,0865,555,120,675,54,729,1390,52.45%,39.93%,1
臺南市,北區,0866,547,149,696,44,740,1318,56.15%,41.5%,1
臺南市,北區,0867,369,110,479,16,495,974,50.82%,37.89%,1
臺南市,北區,0868,387,109,496,19,515,990,52.02%,39.09%,1
臺南市,北區,0869,418,157,575,24,599,1016,58.96%,41.14%,1
臺南市,北區,0870,381,157,538,47,585,1053,55.56%,36.18%,1
臺南市,北區,0871,508,183,691,70,761,1466,51.91%,34.65%,1
臺南市,北區,0872,589,186,775,70,845,1535,55.05%,38.37%,1
臺南市,北區,0873,557,180,737,65,802,1544,51.94%,36.08%,1
臺南市,北區,0874,716,198,914,61,975,1760,55.4%,40.68%,1
臺南市,北區,0875,427,157,584,36,620,1372,45.19%,31.12%,1
臺南市,北區,0876,434,112,546,40,586,1002,58.48%,43.31%,1
臺南市,北區,0877,488,146,634,44,678,1171,57.9%,41.67%,1
臺南市,北區,0878,484,94,578,25,603,1285,46.93%,37.67%,1
臺南市,北區,0879,426,81,507,35,542,1036,52.32%,41.12%,1
臺南市,北區,0880,573,125,698,48,746,1392,53.59%,41.16%,1
臺南市,北區,0881,437,142,579,55,634,1147,55.27%,38.1%,1
臺南市,北區,0882,148,470,618,39,657,1526,43.05%,9.7%,1
臺南市,北區,0883,549,185,734,41,775,1559,49.71%,35.21%,1
臺南市,北區,0884,335,116,451,63,514,892,57.62%,37.56%,1
臺南市,北區,0885,336,97,433,46,479,937,51.12%,35.86%,1
臺南市,北區,0886,550,187,737,92,829,1449,57.21%,37.96%,1
臺南市,北區,0887,417,130,547,24,571,1160,49.22%,35.95%,1
臺南市,北區,0888,386,131,517,75,592,1567,37.78%,24.63%,1
臺南市,北區,0889,473,173,646,61,707,1346,52.53%,35.14%,1
臺南市,北區,0890,506,145,651,13,664,1451,45.76%,34.87%,1
臺南市,北區,0891,533,156,689,44,733,1522,48.16%,35.02%,1
臺南市,北區,0892,451,145,596,33,629,1278,49.22%,35.29%,1
臺南市,北區,0893,391,138,529,62,591,1164,50.77%,33.59%,1
臺南市,北區,0894,364,117,481,20,501,1091,45.92%,33.36%,1
臺南市,北區,0895,339,115,454,31,485,993,48.84%,34.14%,1
臺南市,北區,0896,330,115,445,39,484,1119,43.25%,29.49%,1
臺南市,北區,0897,635,201,836,86,922,1685,54.72%,37.69%,1
臺南市,北區,0898,518,161,679,20,699,1368,51.1%,37.87%,1
臺南市,北區,0899,534,150,684,58,742,1389,53.42%,38.44%,1
臺南市,北區,0900,629,156,785,24,809,1469,55.07%,42.82%,1
臺南市,北區,0901,687,191,878,70,948,1655,57.28%,41.51%,1
臺南市,北區,0902,527,152,679,32,711,1261,56.38%,41.79%,1
臺南市,北區,0903,563,152,715,26,741,1490,49.73%,37.79%,1
臺南市,北區,0904,601,180,781,45,826,1436,57.52%,41.85%,1
臺南市,北區,0905,548,165,713,69,782,1340,58.36%,40.9%,1
臺南市,北區,0906,573,182,755,37,792,1464,54.1%,39.14%,1
臺南市,北區,0907,645,185,830,31,861,1513,56.91%,42.63%,1
臺南市,北區,0908,707,197,904,23,927,1709,54.24%,41.37%,1
臺南市,北區,0909,678,188,866,43,909,1517,59.92%,44.69%,1
臺南市,北區,0910,586,216,802,20,822,1598,51.44%,36.67%,1
臺南市,北區,0911,515,169,684,52,736,1399,52.61%,36.81%,1
臺南市,北區,0912,442,147,589,47,636,1214,52.39%,36.41%,1
臺南市,北區,0913,446,121,567,27,594,1064,55.83%,41.92%,1
臺南市,北區,0914,489,159,648,52,700,1148,60.98%,42.6%,1
臺南市,北區,0915,547,175,722,36,758,1391,54.49%,39.32%,1
臺南市,北區,0916,660,162,822,45,867,1584,54.73%,41.67%,1
臺南市,北區,0917,675,175,850,38,888,1595,55.67%,42.32%,1
臺南市,北區,0918,543,155,698,32,730,1397,52.25%,38.87%,1
臺南市,北區,0919,640,184,824,60,884,1662,53.19%,38.51%,1
臺南市,北區,0920,607,168,775,29,804,1634,49.2%,37.15%,1
臺南市,北區,0921,716,209,925,90,1015,1793,56.61%,39.93%,1
臺南市,北區,0922,723,223,946,48,994,1872,53.1%,38.62%,1
臺南市,北區,0923,680,225,905,101,1006,1874,53.68%,36.29%,1
臺南市,北區,0924,648,178,826,71,897,1760,50.97%,36.82%,1
臺南市,北區,0925,643,189,832,56,888,1753,50.66%,36.68%,1
臺南市,北區,0926,463,136,599,34,633,1502,42.14%,30.83%,1
臺南市,北區,0927,552,178,730,49,779,1470,52.99%,37.55%,1
臺南市,北區,0928,451,162,613,91,704,1319,53.37%,34.19%,1
臺南市,北區,0929,760,203,963,69,1032,1876,55.01%,40.51%,1
臺南市,北區,0930,627,212,839,40,879,1720,51.1%,36.45%,1
臺南市,安南區,0618,983,270,1253,47,1300,2549,51%,38.56%,1
臺南市,安南區,0619,826,239,1065,73,1138,2321,49.03%,35.59%,1
臺南市,安南區,0620,878,239,1117,73,1190,2156,55.19%,40.72%,1
臺南市,安南區,0621,680,208,888,81,969,1662,58.3%,40.91%,1
臺南市,安南區,0622,603,164,767,106,873,1512,57.74%,39.88%,1
臺南市,安南區,0623,575,174,749,72,821,1625,50.52%,35.38%,1
臺南市,安南區,0624,698,196,894,50,944,2143,44.05%,32.57%,1
臺南市,安南區,0625,977,255,1232,94,1326,2457,53.97%,39.76%,1
臺南市,安南區,0626,838,251,1089,109,1198,2148,55.77%,39.01%,1
臺南市,安南區,0627,875,255,1130,95,1225,2364,51.82%,37.01%,1
臺南市,安南區,0628,640,181,821,44,865,1868,46.31%,34.26%,1
臺南市,安南區,0629,768,196,964,79,1043,1797,58.04%,42.74%,1
臺南市,安南區,0630,916,245,1161,63,1224,2268,53.97%,40.39%,1
臺南市,安南區,0631,728,200,928,82,1010,2291,44.09%,31.78%,1
臺南市,安南區,0632,848,217,1065,79,1144,2255,50.73%,37.61%,1
臺南市,安南區,0633,640,212,852,81,933,1940,48.09%,32.99%,1
臺南市,安南區,0634,767,228,995,44,1039,2013,51.61%,38.1%,1
臺南市,安南區,0635,772,190,962,77,1039,2024,51.33%,38.14%,1
臺南市,安南區,0636,670,218,888,92,980,1613,60.76%,41.54%,1
臺南市,安南區,0637,426,121,547,41,588,1178,49.92%,36.16%,1
臺南市,安南區,0638,802,232,1034,80,1114,2143,51.98%,37.42%,1
臺南市,安南區,0639,635,236,871,93,964,1721,56.01%,36.9%,1
臺南市,安南區,0640,729,203,932,74,1006,1773,56.74%,41.12%,1
臺南市,安南區,0641,538,159,697,25,722,1428,50.56%,37.68%,1
臺南市,安南區,0642,635,189,824,67,891,1626,54.8%,39.05%,1
臺南市,安南區,0643,509,163,672,59,731,1358,53.83%,37.48%,1
臺南市,安南區,0644,628,155,783,58,841,1447,58.12%,43.4%,1
臺南市,安南區,0645,537,148,685,86,771,1358,56.77%,39.54%,1
臺南市,安南區,0646,714,227,941,60,1001,2116,47.31%,33.74%,1
臺南市,安南區,0647,794,223,1017,47,1064,2321,45.84%,34.21%,1
臺南市,安南區,0648,773,193,966,49,1015,2117,47.95%,36.51%,1
臺南市,安南區,0649,649,229,878,73,951,1927,49.35%,33.68%,1
臺南市,安南區,0650,765,235,1000,142,1142,2242,50.94%,34.12%,1
臺南市,安南區,0651,813,228,1041,53,1094,2334,46.87%,34.83%,1
臺南市,安南區,0652,698,224,922,68,990,1822,54.34%,38.31%,1
臺南市,安南區,0653,668,236,904,103,1007,1813,55.54%,36.85%,1
臺南市,安南區,0654,827,220,1047,114,1161,2188,53.06%,37.8%,1
臺南市,安南區,0655,845,219,1064,107,1171,2399,48.81%,35.22%,1
臺南市,安南區,0656,732,220,952,75,1027,2247,45.71%,32.58%,1
臺南市,安南區,0657,493,153,646,74,720,1165,61.8%,42.32%,1
臺南市,安南區,0658,551,154,705,60,765,1539,49.71%,35.8%,1
臺南市,安南區,0659,686,221,907,111,1018,1835,55.48%,37.38%,1
臺南市,安南區,0660,642,221,863,105,968,1797,53.87%,35.73%,1
臺南市,安南區,0661,737,238,975,105,1080,2223,48.58%,33.15%,1
臺南市,安南區,0662,417,138,555,65,620,977,63.46%,42.68%,1
臺南市,安南區,0663,563,149,712,41,753,1642,45.86%,34.29%,1
臺南市,安南區,0664,677,186,863,75,938,1697,55.27%,39.89%,1
臺南市,安南區,0665,676,174,850,58,908,1966,46.19%,34.38%,1
臺南市,安南區,0666,476,151,627,70,697,1319,52.84%,36.09%,1
臺南市,安南區,0667,638,213,851,79,930,1909,48.72%,33.42%,1
臺南市,安南區,0668,698,177,875,67,942,1763,53.43%,39.59%,1
臺南市,安南區,0669,355,103,458,55,513,965,53.16%,36.79%,1
臺南市,安南區,0670,491,110,601,94,695,1547,44.93%,31.74%,1
臺南市,安南區,0671,623,204,827,71,898,1784,50.34%,34.92%,1
臺南市,安南區,0672,732,219,951,66,1017,2145,47.41%,34.13%,1
臺南市,安南區,0673,986,240,1226,72,1298,2443,53.13%,40.36%,1
臺南市,安南區,0674,810,244,1054,67,1121,2565,43.7%,31.58%,1
臺南市,安南區,0675,914,274,1188,97,1285,2480,51.81%,36.85%,1
臺南市,安南區,0676,747,204,951,104,1055,2349,44.91%,31.8%,1
臺南市,安南區,0677,805,254,1059,89,1148,2168,52.95%,37.13%,1
臺南市,安南區,0678,607,154,761,62,823,1630,50.49%,37.24%,1
臺南市,安南區,0679,526,145,671,51,722,1675,43.1%,31.4%,1
臺南市,安南區,0680,713,179,892,117,1009,1627,62.02%,43.82%,1
臺南市,安南區,0681,538,184,722,61,783,1493,52.44%,36.03%,1
臺南市,安南區,0682,515,185,700,84,784,1397,56.12%,36.86%,1
臺南市,安南區,0683,528,141,669,61,730,1416,51.55%,37.29%,1
臺南市,安南區,0684,550,161,711,28,739,1460,50.62%,37.67%,1
臺南市,安南區,0685,699,210,909,51,960,2222,43.2%,31.46%,1
臺南市,安南區,0686,778,210,988,107,1095,2070,52.9%,37.58%,1
臺南市,安南區,0687,678,205,883,70,953,1739,54.8%,38.99%,1
臺南市,安南區,0688,657,178,835,102,937,1830,51.2%,35.9%,1
臺南市,安南區,0689,743,230,973,81,1054,1803,58.46%,41.21%,1
臺南市,安南區,0690,702,237,939,74,1013,1800,56.28%,39%,1
臺南市,安南區,0691,578,196,774,75,849,1815,46.78%,31.85%,1
臺南市,安南區,0692,648,168,816,42,858,1846,46.48%,35.1%,1
臺南市,安南區,0693,366,129,495,57,552,905,60.99%,40.44%,1
臺南市,安南區,0694,457,115,572,89,661,1073,61.6%,42.59%,1
臺南市,安南區,0695,658,175,833,76,909,1579,57.57%,41.67%,1
臺南市,安南區,0696,647,199,846,119,965,1876,51.44%,34.49%,1
臺南市,安南區,0697,422,122,544,56,600,1194,50.25%,35.34%,1
臺南市,安南區,0698,410,103,513,30,543,1475,36.81%,27.8%,1
臺南市,安南區,0699,491,122,613,27,640,1380,46.38%,35.58%,1
臺南市,安南區,0700,456,144,600,39,639,1462,43.71%,31.19%,1
臺南市,安南區,0701,423,106,529,67,596,1044,57.09%,40.52%,1
臺南市,安南區,0702,260,80,340,55,395,603,65.51%,43.12%,1
臺南市,安南區,0703,277,94,371,27,398,690,57.68%,40.14%,1
臺南市,安南區,0704,490,158,648,68,716,1447,49.48%,33.86%,1
臺南市,安南區,0705,431,118,549,48,597,910,65.6%,47.36%,1
臺南市,安南區,0706,632,164,796,95,891,1850,48.16%,34.16%,1
臺南市,安南區,0707,648,168,816,56,872,1501,58.09%,43.17%,1
臺南市,安平區,0983,679,202,881,83,964,1753,54.99%,38.73%,1
臺南市,安平區,0984,718,175,893,55,948,1859,51%,38.62%,1
臺南市,安平區,0985,594,160,754,53,807,1382,58.39%,42.98%,1
臺南市,安平區,0986,903,274,1177,75,1252,2547,49.16%,35.45%,1
臺南市,安平區,0987,928,264,1192,58,1250,2407,51.93%,38.55%,1
臺南市,安平區,0988,695,188,883,49,932,2070,45.02%,33.57%,1
臺南市,安平區,0989,764,257,1021,41,1062,2132,49.81%,35.83%,1
臺南市,安平區,0990,561,168,729,27,756,1450,52.14%,38.69%,1
臺南市,安平區,0991,575,166,741,29,770,1605,47.98%,35.83%,1
臺南市,安平區,0992,668,198,866,74,940,1755,53.56%,38.06%,1
臺南市,安平區,0993,593,169,762,51,813,1728,47.05%,34.32%,1
臺南市,安平區,0994,512,171,683,35,718,1754,40.94%,29.19%,1
臺南市,安平區,0995,645,171,816,56,872,1686,51.72%,38.26%,1
臺南市,安平區,0996,729,212,941,50,991,1843,53.77%,39.56%,1
臺南市,安平區,0997,628,196,824,46,870,1565,55.59%,40.13%,1
臺南市,安平區,0998,511,126,637,32,669,1288,51.94%,39.67%,1
臺南市,安平區,0999,560,187,747,23,770,1653,46.58%,33.88%,1
臺南市,安平區,1000,628,144,772,26,798,1697,47.02%,37.01%,1
臺南市,安平區,1001,762,200,962,45,1007,2154,46.75%,35.38%,1
臺南市,安平區,1002,766,203,969,56,1025,2107,48.65%,36.36%,1
臺南市,安平區,1003,665,190,855,66,921,1675,54.99%,39.7%,1
臺南市,安平區,1004,704,250,954,58,1012,1979,51.14%,35.57%,1
臺南市,安平區,1005,573,184,757,35,792,1602,49.44%,35.77%,1
臺南市,安平區,1006,597,155,752,51,803,1586,50.63%,37.64%,1
臺南市,安平區,1007,125,42,167,11,178,438,40.64%,28.54%,1
臺南市,安平區,1008,622,192,814,82,896,1780,50.34%,34.94%,1
臺南市,安平區,1009,533,185,718,33,751,1623,46.27%,32.84%,1
臺南市,安平區,1010,707,246,953,104,1057,2157,49%,32.78%,1
臺南市,安平區,1011,407,148,555,47,602,1286,46.81%,31.65%,1
臺南市,安平區,1012,520,182,702,80,782,1492,52.41%,34.85%,1
臺南市,安平區,1013,409,121,530,35,565,1325,42.64%,30.87%,1
臺南市,安平區,1014,706,196,902,83,985,2001,49.23%,35.28%,1
臺南市,中西區,0931,493,184,677,57,734,1332,55.11%,37.01%,1
臺南市,中西區,0932,478,160,638,74,712,1246,57.14%,38.36%,1
臺南市,中西區,0933,446,167,613,56,669,1276,52.43%,34.95%,1
臺南市,中西區,0934,629,200,829,58,887,1583,56.03%,39.73%,1
臺南市,中西區,0935,583,198,781,54,835,1464,57.04%,39.82%,1
臺南市,中西區,0936,467,137,604,24,628,1234,50.89%,37.84%,1
臺南市,中西區,0937,533,205,738,47,785,1368,57.38%,38.96%,1
臺南市,中西區,0938,428,138,566,32,598,1322,45.23%,32.38%,1
臺南市,中西區,0939,408,174,582,59,641,1216,52.71%,33.55%,1
臺南市,中西區,0940,429,195,624,41,665,1289,51.59%,33.28%,1
臺南市,中西區,0941,491,153,644,49,693,1237,56.02%,39.69%,1
臺南市,中西區,0942,374,144,518,33,551,1189,46.34%,31.46%,1
臺南市,中西區,0943,439,167,606,67,673,1201,56.04%,36.55%,1
臺南市,中西區,0944,444,131,575,61,636,1065,59.72%,41.69%,1
臺南市,中西區,0945,425,126,551,45,596,1055,56.49%,40.28%,1
臺南市,中西區,0946,518,150,668,43,711,1170,60.77%,44.27%,1
臺南市,中西區,0947,555,162,717,40,757,1280,59.14%,43.36%,1
臺南市,中西區,0948,479,168,647,42,689,1223,56.34%,39.17%,1
臺南市,中西區,0949,538,151,689,65,754,1292,58.36%,41.64%,1
臺南市,中西區,0950,412,139,551,17,568,993,57.2%,41.49%,1
臺南市,中西區,0951,580,201,781,47,828,1541,53.73%,37.64%,1
臺南市,中西區,0952,694,216,910,76,986,1652,59.69%,42.01%,1
臺南市,中西區,0953,495,159,654,33,687,1212,56.68%,40.84%,1
臺南市,中西區,0954,651,205,856,67,923,1621,56.94%,40.16%,1
臺南市,中西區,0955,630,231,861,45,906,1660,54.58%,37.95%,1
臺南市,中西區,0956,603,200,803,60,863,1595,54.11%,37.81%,1
臺南市,中西區,0957,519,184,703,59,762,1436,53.06%,36.14%,1
臺南市,中西區,0958,487,173,660,62,722,1265,57.08%,38.5%,1
臺南市,中西區,0959,371,105,476,50,526,856,61.45%,43.34%,1
臺南市,中西區,0960,392,170,562,53,615,1168,52.65%,33.56%,1
臺南市,中西區,0961,456,159,615,43,658,1134,58.02%,40.21%,1
臺南市,中西區,0962,403,148,551,60,611,995,61.41%,40.5%,1
臺南市,中西區,0963,622,136,758,43,801,1313,61.01%,47.37%,1
臺南市,中西區,0964,540,156,696,52,748,1265,59.13%,42.69%,1
臺南市,中西區,0965,455,146,601,50,651,1215,53.58%,37.45%,1
臺南市,中西區,0966,497,128,625,58,683,1248,54.73%,39.82%,1
臺南市,中西區,0967,235,97,332,45,377,687,54.88%,34.21%,1
臺南市,中西區,0968,423,141,564,70,634,1139,55.66%,37.14%,1
臺南市,中西區,0969,400,122,522,44,566,971,58.29%,41.19%,1
臺南市,中西區,0970,364,120,484,59,543,1254,43.3%,29.03%,1
臺南市,中西區,0971,391,102,493,37,530,979,54.14%,39.94%,1
臺南市,中西區,0972,624,191,815,72,887,1745,50.83%,35.76%,1
臺南市,中西區,0973,374,154,528,51,579,1074,53.91%,34.82%,1
臺南市,中西區,0974,493,171,664,45,709,1436,49.37%,34.33%,1
臺南市,中西區,0975,314,120,434,55,489,865,56.53%,36.3%,1
臺南市,中西區,0976,453,132,585,51,636,1164,54.64%,38.92%,1
臺南市,中西區,0977,412,161,573,24,597,1285,46.46%,32.06%,1
臺南市,中西區,0978,400,139,539,52,591,1078,54.82%,37.11%,1
臺南市,中西區,0979,515,157,672,54,726,1704,42.61%,30.22%,1
臺南市,中西區,0980,514,156,670,83,753,1296,58.1%,39.66%,1
臺南市,中西區,0981,447,130,577,42,619,1128,54.88%,39.63%,1
臺南市,中西區,0982,482,151,633,45,678,1245,54.46%,38.71%,1
高雄市,鹽埕區,0845,548,212,760,48,808,1304,61.96%,42.02%,1
高雄市,鹽埕區,0846,154,40,194,23,217,357,60.78%,43.14%,1
高雄市,鹽埕區,0847,254,95,349,26,375,651,57.6%,39.02%,1
高雄市,鹽埕區,0848,460,152,612,26,638,1322,48.26%,34.8%,1
高雄市,鹽埕區,0849,445,128,573,20,593,1056,56.16%,42.14%,1
高雄市,鹽埕區,0850,363,128,491,21,512,904,56.64%,40.15%,1
高雄市,鹽埕區,0851,442,132,574,30,604,1130,53.45%,39.12%,1
高雄市,鹽埕區,0852,401,81,482,19,501,840,59.64%,47.74%,1
高雄市,鹽埕區,0853,297,106,403,32,435,616,70.62%,48.21%,1
高雄市,鹽埕區,0854,491,179,670,45,715,1397,51.18%,35.15%,1
高雄市,鹽埕區,0855,279,124,403,16,419,766,54.7%,36.42%,1
高雄市,鹽埕區,0856,354,110,464,44,508,839,60.55%,42.19%,1
高雄市,鹽埕區,0857,340,118,458,15,473,805,58.76%,42.24%,1
高雄市,鹽埕區,0858,288,83,371,23,394,750,52.53%,38.4%,1
高雄市,鹽埕區,0859,366,131,497,35,532,986,53.96%,37.12%,1
高雄市,鹽埕區,0860,372,107,479,16,495,1068,46.35%,34.83%,1
高雄市,鹽埕區,0861,424,153,577,55,632,1060,59.62%,40%,1
高雄市,鹽埕區,0862,302,102,404,37,441,805,54.78%,37.52%,1
高雄市,鹽埕區,0863,382,116,498,19,517,1073,48.18%,35.6%,1
高雄市,鹽埕區,0864,329,106,435,30,465,921,50.49%,35.72%,1
高雄市,鹽埕區,0865,455,143,598,22,620,1171,52.95%,38.86%,1
高雄市,鹽埕區,0866,231,88,319,18,337,594,56.73%,38.89%,1
高雄市,鹽埕區,0867,252,78,330,17,347,592,58.61%,42.57%,1
高雄市,鹽埕區,0868,208,85,293,15,308,610,50.49%,34.1%,1
高雄市,鼓山區,0768,379,90,469,21,490,959,51.09%,39.52%,1
高雄市,鼓山區,0769,494,115,609,46,655,1000,65.5%,49.4%,1
高雄市,鼓山區,0770,391,99,490,13,503,910,55.27%,42.97%,1
高雄市,鼓山區,0771,551,106,657,54,711,1085,65.53%,50.78%,1
高雄市,鼓山區,0772,517,146,663,46,709,1484,47.78%,34.84%,1
高雄市,鼓山區,0773,646,138,784,27,811,1393,58.22%,46.37%,1
高雄市,鼓山區,0774,655,132,787,62,849,1270,66.85%,51.57%,1
高雄市,鼓山區,0775,416,111,527,49,576,1055,54.6%,39.43%,1
高雄市,鼓山區,0776,462,163,625,30,655,1172,55.89%,39.42%,1
高雄市,鼓山區,0777,511,174,685,48,733,1175,62.38%,43.49%,1
高雄市,鼓山區,0778,527,166,693,46,739,1274,58.01%,41.37%,1
高雄市,鼓山區,0779,394,109,503,52,555,1085,51.15%,36.31%,1
高雄市,鼓山區,0780,643,142,785,69,854,1470,58.1%,43.74%,1
高雄市,鼓山區,0781,421,162,583,51,634,974,65.09%,43.22%,1
高雄市,鼓山區,0782,541,176,717,88,805,1275,63.14%,42.43%,1
高雄市,鼓山區,0783,479,154,633,56,689,1206,57.13%,39.72%,1
高雄市,鼓山區,0784,512,156,668,30,698,1238,56.38%,41.36%,1
高雄市,鼓山區,0785,440,40,480,16,496,721,68.79%,61.03%,1
高雄市,鼓山區,0786,483,132,615,28,643,1220,52.7%,39.59%,1
高雄市,鼓山區,0787,679,187,866,49,915,1966,46.54%,34.54%,1
高雄市,鼓山區,0788,615,220,835,69,904,1722,52.5%,35.71%,1
高雄市,鼓山區,0789,675,168,843,26,869,1720,50.52%,39.24%,1
高雄市,鼓山區,0790,545,151,696,105,801,1287,62.24%,42.35%,1
高雄市,鼓山區,0791,447,132,579,46,625,1369,45.65%,32.65%,1
高雄市,鼓山區,0792,580,135,715,27,742,1222,60.72%,47.46%,1
高雄市,鼓山區,0793,712,175,887,53,940,1770,53.11%,40.23%,1
高雄市,鼓山區,0794,798,231,1029,36,1065,1860,57.26%,42.9%,1
高雄市,鼓山區,0795,667,319,986,52,1038,1857,55.9%,35.92%,1
高雄市,鼓山區,0796,791,232,1023,47,1070,1841,58.12%,42.97%,1
高雄市,鼓山區,0797,846,212,1058,67,1125,1830,61.48%,46.23%,1
高雄市,鼓山區,0798,790,217,1007,65,1072,1809,59.26%,43.67%,1
高雄市,鼓山區,0799,873,225,1098,37,1135,1894,59.93%,46.09%,1
高雄市,鼓山區,0800,875,246,1121,30,1151,1882,61.16%,46.49%,1
高雄市,鼓山區,0801,874,282,1156,59,1215,1894,64.15%,46.15%,1
高雄市,鼓山區,0802,781,185,966,40,1006,1745,57.65%,44.76%,1
高雄市,鼓山區,0803,815,205,1020,19,1039,1887,55.06%,43.19%,1
高雄市,鼓山區,0804,911,260,1171,59,1230,1891,65.04%,48.18%,1
高雄市,鼓山區,0805,868,241,1109,55,1164,1903,61.17%,45.61%,1
高雄市,鼓山區,0806,864,295,1159,50,1209,1998,60.51%,43.24%,1
高雄市,鼓山區,0807,919,205,1124,48,1172,1912,61.3%,48.06%,1
高雄市,鼓山區,0808,890,243,1133,67,1200,1923,62.4%,46.28%,1
高雄市,鼓山區,0809,886,252,1138,29,1167,1888,61.81%,46.93%,1
高雄市,鼓山區,0810,898,224,1122,20,1142,1873,60.97%,47.94%,1
高雄市,鼓山區,0811,975,280,1255,50,1305,1959,66.62%,49.77%,1
高雄市,鼓山區,0812,959,228,1187,48,1235,1897,65.1%,50.55%,1
高雄市,鼓山區,0813,1119,273,1392,43,1435,2362,60.75%,47.38%,1
高雄市,鼓山區,0814,859,235,1094,71,1165,1850,62.97%,46.43%,1
高雄市,鼓山區,0815,902,242,1144,34,1178,1928,61.1%,46.78%,1
高雄市,鼓山區,0816,873,192,1065,32,1097,1937,56.63%,45.07%,1
高雄市,鼓山區,0817,966,222,1188,74,1262,2123,59.44%,45.5%,1
高雄市,鼓山區,0818,813,232,1045,40,1085,1861,58.3%,43.69%,1
高雄市,鼓山區,0819,882,183,1065,27,1092,1892,57.72%,46.62%,1
高雄市,鼓山區,0820,989,259,1248,55,1303,2147,60.69%,46.06%,1
高雄市,鼓山區,0821,898,211,1109,51,1160,1897,61.15%,47.34%,1
高雄市,鼓山區,0822,886,238,1124,32,1156,2041,56.64%,43.41%,1
高雄市,鼓山區,0823,589,131,720,56,776,1309,59.28%,45%,1
高雄市,鼓山區,0824,824,226,1050,59,1109,1867,59.4%,44.13%,1
高雄市,鼓山區,0825,598,145,743,39,782,1152,67.88%,51.91%,1
高雄市,鼓山區,0826,673,178,851,50,901,1404,64.17%,47.93%,1
高雄市,鼓山區,0827,327,97,424,24,448,1210,37.02%,27.02%,1
高雄市,鼓山區,0828,423,153,576,51,627,1135,55.24%,37.27%,1
高雄市,鼓山區,0829,441,135,576,86,662,1831,36.16%,24.09%,1
高雄市,鼓山區,0830,535,150,685,72,757,1288,58.77%,41.54%,1
高雄市,鼓山區,0831,493,123,616,34,650,1241,52.38%,39.73%,1
高雄市,鼓山區,0832,597,150,747,78,825,1342,61.48%,44.49%,1
高雄市,鼓山區,0833,599,172,771,96,867,1422,60.97%,42.12%,1
高雄市,鼓山區,0834,648,169,817,100,917,1453,63.11%,44.6%,1
高雄市,鼓山區,0835,265,90,355,43,398,616,64.61%,43.02%,1
高雄市,鼓山區,0836,304,119,423,80,503,834,60.31%,36.45%,1
高雄市,鼓山區,0837,382,117,499,115,614,969,63.36%,39.42%,1
高雄市,鼓山區,0838,367,117,484,87,571,978,58.38%,37.53%,1
高雄市,鼓山區,0839,294,113,407,79,486,760,63.95%,38.68%,1
高雄市,鼓山區,0840,536,139,675,70,745,1248,59.7%,42.95%,1
高雄市,鼓山區,0841,386,148,534,33,567,1143,49.61%,33.77%,1
高雄市,鼓山區,0842,441,149,590,80,670,1358,49.34%,32.47%,1
高雄市,鼓山區,0843,398,91,489,18,507,1036,48.94%,38.42%,1
高雄市,鼓山區,0844,209,71,280,20,300,580,51.72%,36.03%,1
高雄市,左營區,0534,639,179,818,58,876,2604,33.64%,24.54%,1
高雄市,左營區,0535,427,140,567,81,648,1037,62.49%,41.18%,1
高雄市,左營區,0536,240,66,306,47,353,542,65.13%,44.28%,1
高雄市,左營區,0537,257,79,336,53,389,635,61.26%,40.47%,1
高雄市,左營區,0538,181,41,222,20,242,518,46.72%,34.94%,1
高雄市,左營區,0539,284,94,378,62,440,813,54.12%,34.93%,1
高雄市,左營區,0540,329,132,461,82,543,889,61.08%,37.01%,1
高雄市,左營區,0541,300,97,397,74,471,731,64.43%,41.04%,1
高雄市,左營區,0542,563,177,740,48,788,1592,49.5%,35.36%,1
高雄市,左營區,0543,727,228,955,56,1011,1709,59.16%,42.54%,1
高雄市,左營區,0544,758,123,881,62,943,1588,59.38%,47.73%,1
高雄市,左營區,0545,176,14,190,6,196,358,54.75%,49.16%,1
高雄市,左營區,0546,403,40,443,13,456,666,68.47%,60.51%,1
高雄市,左營區,0547,754,161,915,72,987,1748,56.46%,43.14%,1
高雄市,左營區,0548,556,186,742,25,767,1196,64.13%,46.49%,1
高雄市,左營區,0549,565,148,713,66,779,1240,62.82%,45.56%,1
高雄市,左營區,0550,726,92,818,46,864,1402,61.63%,51.78%,1
高雄市,左營區,0551,643,78,721,28,749,1173,63.85%,54.82%,1
高雄市,左營區,0552,373,65,438,21,459,641,71.61%,58.19%,1
高雄市,左營區,0553,336,140,476,45,521,951,54.78%,35.33%,1
高雄市,左營區,0554,284,88,372,46,418,732,57.1%,38.8%,1
高雄市,左營區,0555,125,42,167,12,179,339,52.8%,36.87%,1
高雄市,左營區,0556,221,55,276,16,292,519,56.26%,42.58%,1
高雄市,左營區,0557,206,76,282,60,342,514,66.54%,40.08%,1
高雄市,左營區,0558,316,81,397,61,458,720,63.61%,43.89%,1
高雄市,左營區,0559,163,57,220,49,269,411,65.45%,39.66%,1
高雄市,左營區,0560,258,96,354,43,397,603,65.84%,42.79%,1
高雄市,左營區,0561,353,125,478,79,557,904,61.62%,39.05%,1
高雄市,左營區,0562,484,130,614,44,658,1318,49.92%,36.72%,1
高雄市,左營區,0563,347,116,463,25,488,966,50.52%,35.92%,1
高雄市,左營區,0564,686,120,806,40,846,1440,58.75%,47.64%,1
高雄市,左營區,0565,913,136,1049,44,1093,1990,54.92%,45.88%,1
高雄市,左營區,0566,567,70,637,32,669,1090,61.38%,52.02%,1
高雄市,左營區,0567,623,98,721,72,793,1272,62.34%,48.98%,1
高雄市,左營區,0568,776,170,946,29,975,1558,62.58%,49.81%,1
高雄市,左營區,0569,745,181,926,38,964,1501,64.22%,49.63%,1
高雄市,左營區,0570,199,40,239,8,247,360,68.61%,55.28%,1
高雄市,左營區,0571,700,73,773,35,808,1335,60.52%,52.43%,1
高雄市,左營區,0572,664,106,770,22,792,1359,58.28%,48.86%,1
高雄市,左營區,0573,703,152,855,58,913,1487,61.4%,47.28%,1
高雄市,左營區,0574,731,139,870,57,927,1637,56.63%,44.65%,1
高雄市,左營區,0575,763,154,917,44,961,1553,61.88%,49.13%,1
高雄市,左營區,0576,726,196,922,72,994,1564,63.55%,46.42%,1
高雄市,左營區,0577,864,231,1095,58,1153,1788,64.49%,48.32%,1
高雄市,左營區,0578,936,219,1155,101,1256,2028,61.93%,46.15%,1
高雄市,左營區,0579,901,239,1140,96,1236,2037,60.68%,44.23%,1
高雄市,左營區,0580,990,244,1234,58,1292,2101,61.49%,47.12%,1
高雄市,左營區,0581,1034,127,1161,64,1225,2018,60.7%,51.24%,1
高雄市,左營區,0582,851,293,1144,96,1240,1925,64.42%,44.21%,1
高雄市,左營區,0583,834,257,1091,37,1128,1989,56.71%,41.93%,1
高雄市,左營區,0584,703,177,880,42,922,1780,51.8%,39.49%,1
高雄市,左營區,0585,807,237,1044,35,1079,1778,60.69%,45.39%,1
高雄市,左營區,0586,698,181,879,33,912,1496,60.96%,46.66%,1
高雄市,左營區,0587,707,200,907,55,962,1538,62.55%,45.97%,1
高雄市,左營區,0588,933,250,1183,70,1253,2058,60.88%,45.34%,1
高雄市,左營區,0589,889,251,1140,34,1174,1992,58.94%,44.63%,1
高雄市,左營區,0590,942,250,1192,75,1267,2058,61.56%,45.77%,1
高雄市,左營區,0591,969,244,1213,53,1266,2090,60.57%,46.36%,1
高雄市,左營區,0592,899,283,1182,43,1225,2157,56.79%,41.68%,1
高雄市,左營區,0593,1000,263,1263,47,1310,2096,62.5%,47.71%,1
高雄市,左營區,0594,954,290,1244,88,1332,2101,63.4%,45.41%,1
高雄市,左營區,0595,735,186,921,73,994,1649,60.28%,44.57%,1
高雄市,左營區,0596,619,185,804,91,895,1516,59.04%,40.83%,1
高雄市,左營區,0597,733,209,942,97,1039,1678,61.92%,43.68%,1
高雄市,左營區,0598,831,243,1074,76,1150,1898,60.59%,43.78%,1
高雄市,左營區,0599,789,211,1000,58,1058,1837,57.59%,42.95%,1
高雄市,左營區,0600,891,135,1026,24,1050,1922,54.63%,46.36%,1
高雄市,左營區,0601,858,206,1064,58,1122,1785,62.86%,48.07%,1
高雄市,左營區,0602,839,194,1033,31,1064,1886,56.42%,44.49%,1
高雄市,左營區,0603,892,214,1106,49,1155,1895,60.95%,47.07%,1
高雄市,左營區,0604,871,206,1077,36,1113,1831,60.79%,47.57%,1
高雄市,左營區,0605,921,214,1135,41,1176,2050,57.37%,44.93%,1
高雄市,左營區,0606,1145,288,1433,48,1481,2251,65.79%,50.87%,1
高雄市,左營區,0607,1011,268,1279,38,1317,2126,61.95%,47.55%,1
高雄市,左營區,0608,820,198,1018,34,1052,1928,54.56%,42.53%,1
高雄市,左營區,0609,917,251,1168,60,1228,2166,56.69%,42.34%,1
高雄市,左營區,0610,938,220,1158,60,1218,2031,59.97%,46.18%,1
高雄市,左營區,0611,946,225,1171,66,1237,1987,62.25%,47.61%,1
高雄市,左營區,0612,1032,248,1280,41,1321,2166,60.99%,47.65%,1
高雄市,左營區,0613,817,261,1078,59,1137,1856,61.26%,44.02%,1
高雄市,左營區,0614,997,354,1351,49,1400,2289,61.16%,43.56%,1
高雄市,左營區,0615,924,192,1116,48,1164,1973,59%,46.83%,1
高雄市,左營區,0616,827,210,1037,90,1127,1818,61.99%,45.49%,1
高雄市,左營區,0617,676,185,861,32,893,1565,57.06%,43.19%,1
高雄市,左營區,0618,817,191,1008,40,1048,1608,65.17%,50.81%,1
高雄市,左營區,0619,904,214,1118,58,1176,1812,64.9%,49.89%,1
高雄市,左營區,0620,795,181,976,21,997,1821,54.75%,43.66%,1
高雄市,左營區,0621,892,243,1135,60,1195,1907,62.66%,46.78%,1
高雄市,左營區,0622,866,157,1023,50,1073,1812,59.22%,47.79%,1
高雄市,左營區,0623,886,227,1113,40,1153,1833,62.9%,48.34%,1
高雄市,左營區,0624,861,221,1082,62,1144,1850,61.84%,46.54%,1
高雄市,左營區,0625,788,174,962,63,1025,1738,58.98%,45.34%,1
高雄市,左營區,0626,949,200,1149,59,1208,1864,64.81%,50.91%,1
高雄市,左營區,0627,900,237,1137,51,1188,1887,62.96%,47.69%,1
高雄市,左營區,0628,833,175,1008,31,1039,1870,55.56%,44.55%,1
高雄市,左營區,0629,878,172,1050,33,1083,1866,58.04%,47.05%,1
高雄市,左營區,0630,838,207,1045,16,1061,1862,56.98%,45.01%,1
高雄市,左營區,0631,876,185,1061,34,1095,1816,60.3%,48.24%,1
高雄市,左營區,0632,844,205,1049,47,1096,1833,59.79%,46.04%,1
高雄市,左營區,0633,770,226,996,56,1052,1676,62.77%,45.94%,1
高雄市,左營區,0634,867,202,1069,61,1130,1843,61.31%,47.04%,1
高雄市,左營區,0635,889,223,1112,41,1153,1872,61.59%,47.49%,1
高雄市,左營區,0636,1047,243,1290,47,1337,2259,59.19%,46.35%,1
高雄市,楠梓區,0435,616,157,773,48,821,1309,62.72%,47.06%,1
高雄市,楠梓區,0436,611,178,789,34,823,1408,58.45%,43.39%,1
高雄市,楠梓區,0437,808,227,1035,60,1095,1851,59.16%,43.65%,1
高雄市,楠梓區,0438,687,224,911,67,978,1578,61.98%,43.54%,1
高雄市,楠梓區,0439,745,189,934,38,972,1715,56.68%,43.44%,1
高雄市,楠梓區,0440,680,172,852,35,887,1611,55.06%,42.21%,1
高雄市,楠梓區,0441,856,180,1036,73,1109,2024,54.79%,42.29%,1
高雄市,楠梓區,0442,761,199,960,43,1003,1890,53.07%,40.26%,1
高雄市,楠梓區,0443,671,183,854,31,885,1762,50.23%,38.08%,1
高雄市,楠梓區,0444,757,212,969,69,1038,1888,54.98%,40.1%,1
高雄市,楠梓區,0445,760,196,956,79,1035,1822,56.81%,41.71%,1
高雄市,楠梓區,0446,748,223,971,70,1041,1846,56.39%,40.52%,1
高雄市,楠梓區,0447,570,142,712,75,787,1268,62.07%,44.95%,1
高雄市,楠梓區,0448,592,158,750,54,804,1240,64.84%,47.74%,1
高雄市,楠梓區,0449,649,199,848,33,881,1432,61.52%,45.32%,1
高雄市,楠梓區,0450,656,142,798,61,859,1490,57.65%,44.03%,1
高雄市,楠梓區,0451,700,160,860,61,921,1464,62.91%,47.81%,1
高雄市,楠梓區,0452,558,181,739,79,818,1435,57%,38.89%,1
高雄市,楠梓區,0453,641,173,814,82,896,1602,55.93%,40.01%,1
高雄市,楠梓區,0454,613,171,784,52,836,1500,55.73%,40.87%,1
高雄市,楠梓區,0455,631,192,823,107,930,1591,58.45%,39.66%,1
高雄市,楠梓區,0456,440,159,599,59,658,1669,39.42%,26.36%,1
高雄市,楠梓區,0457,643,194,837,61,898,1469,61.13%,43.77%,1
高雄市,楠梓區,0458,631,169,800,88,888,1559,56.96%,40.47%,1
高雄市,楠梓區,0459,638,202,840,91,931,1638,56.84%,38.95%,1
高雄市,楠梓區,0460,842,228,1070,82,1152,1960,58.78%,42.96%,1
高雄市,楠梓區,0461,787,232,1019,128,1147,1912,59.99%,41.16%,1
高雄市,楠梓區,0462,678,158,836,63,899,1559,57.67%,43.49%,1
高雄市,楠梓區,0463,610,143,753,51,804,1423,56.5%,42.87%,1
高雄市,楠梓區,0464,754,197,951,13,964,1696,56.84%,44.46%,1
高雄市,楠梓區,0465,528,198,726,160,886,1493,59.34%,35.37%,1
高雄市,楠梓區,0466,624,206,830,90,920,1527,60.25%,40.86%,1
高雄市,楠梓區,0467,403,159,562,86,648,1020,63.53%,39.51%,1
高雄市,楠梓區,0468,469,155,624,80,704,1197,58.81%,39.18%,1
高雄市,楠梓區,0469,519,224,743,89,832,1528,54.45%,33.97%,1
高雄市,楠梓區,0470,647,228,875,110,985,1918,51.36%,33.73%,1
高雄市,楠梓區,0471,551,172,723,100,823,1458,56.45%,37.79%,1
高雄市,楠梓區,0472,763,232,995,106,1101,1790,61.51%,42.63%,1
高雄市,楠梓區,0473,834,220,1054,85,1139,1845,61.73%,45.2%,1
高雄市,楠梓區,0474,922,196,1118,77,1195,2037,58.66%,45.26%,1
高雄市,楠梓區,0475,868,180,1048,60,1108,1964,56.42%,44.2%,1
高雄市,楠梓區,0476,874,201,1075,35,1110,2006,55.33%,43.57%,1
高雄市,楠梓區,0477,835,207,1042,64,1106,1951,56.69%,42.8%,1
高雄市,楠梓區,0478,819,193,1012,71,1083,1951,55.51%,41.98%,1
高雄市,楠梓區,0479,921,198,1119,74,1193,2008,59.41%,45.87%,1
高雄市,楠梓區,0480,884,196,1080,85,1165,1923,60.58%,45.97%,1
高雄市,楠梓區,0481,895,197,1092,53,1145,1921,59.6%,46.59%,1
高雄市,楠梓區,0482,414,131,545,40,585,832,70.31%,49.76%,1
高雄市,楠梓區,0483,451,187,638,53,691,1156,59.78%,39.01%,1
高雄市,楠梓區,0484,441,179,620,63,683,1125,60.71%,39.2%,1
高雄市,楠梓區,0485,456,159,615,60,675,1060,63.68%,43.02%,1
高雄市,楠梓區,0486,676,171,847,71,918,1502,61.12%,45.01%,1
高雄市,楠梓區,0487,568,197,765,93,858,1404,61.11%,40.46%,1
高雄市,楠梓區,0488,588,169,757,70,827,1552,53.29%,37.89%,1
高雄市,楠梓區,0489,529,182,711,71,782,1460,53.56%,36.23%,1
高雄市,楠梓區,0490,533,127,660,61,721,1315,54.83%,40.53%,1
高雄市,楠梓區,0491,464,136,600,69,669,1062,62.99%,43.69%,1
高雄市,楠梓區,0492,483,110,593,67,660,1078,61.22%,44.81%,1
高雄市,楠梓區,0493,407,118,525,87,612,914,66.96%,44.53%,1
高雄市,楠梓區,0494,478,137,615,94,709,1064,66.64%,44.92%,1
高雄市,楠梓區,0495,728,222,950,91,1041,1705,61.06%,42.7%,1
高雄市,楠梓區,0496,819,160,979,68,1047,1728,60.59%,47.4%,1
高雄市,楠梓區,0497,904,181,1085,73,1158,1917,60.41%,47.16%,1
高雄市,楠梓區,0498,568,149,717,99,816,1439,56.71%,39.47%,1
高雄市,楠梓區,0499,594,117,711,77,788,1287,61.23%,46.15%,1
高雄市,楠梓區,0500,705,167,872,77,949,1504,63.1%,46.88%,1
高雄市,楠梓區,0501,695,152,847,76,923,1405,65.69%,49.47%,1
高雄市,楠梓區,0502,641,65,706,80,786,1287,61.07%,49.81%,1
高雄市,楠梓區,0503,585,167,752,57,809,1295,62.47%,45.17%,1
高雄市,楠梓區,0504,676,199,875,58,933,1483,62.91%,45.58%,1
高雄市,楠梓區,0505,818,201,1019,74,1093,1649,66.28%,49.61%,1
高雄市,楠梓區,0506,469,103,572,78,650,998,65.13%,46.99%,1
高雄市,楠梓區,0507,476,124,600,69,669,1025,65.27%,46.44%,1
高雄市,楠梓區,0508,810,208,1018,80,1098,1671,65.71%,48.47%,1
高雄市,楠梓區,0509,653,201,854,102,956,1453,65.79%,44.94%,1
高雄市,楠梓區,0510,721,187,908,92,1000,1673,59.77%,43.1%,1
高雄市,楠梓區,0511,724,167,891,58,949,1653,57.41%,43.8%,1
高雄市,楠梓區,0512,456,131,587,54,641,1034,61.99%,44.1%,1
高雄市,楠梓區,0513,583,136,719,58,777,1127,68.94%,51.73%,1
高雄市,楠梓區,0514,641,177,818,95,913,1575,57.97%,40.7%,1
高雄市,楠梓區,0515,725,175,900,68,968,1559,62.09%,46.5%,1
高雄市,楠梓區,0516,594,150,744,61,805,1378,58.42%,43.11%,1
高雄市,楠梓區,0517,746,217,963,82,1045,1714,60.97%,43.52%,1
高雄市,楠梓區,0518,762,198,960,88,1048,1721,60.89%,44.28%,1
高雄市,楠梓區,0519,708,201,909,67,976,1628,59.95%,43.49%,1
高雄市,楠梓區,0520,804,188,992,89,1081,1590,67.99%,50.57%,1
高雄市,楠梓區,0521,743,181,924,72,996,1628,61.18%,45.64%,1
高雄市,楠梓區,0522,881,193,1074,53,1127,1739,64.81%,50.66%,1
高雄市,楠梓區,0523,807,183,990,73,1063,1642,64.74%,49.15%,1
高雄市,楠梓區,0524,737,162,899,89,988,1766,55.95%,41.73%,1
高雄市,楠梓區,0525,643,143,786,74,860,1482,58.03%,43.39%,1
高雄市,楠梓區,0526,750,127,877,38,915,1749,52.32%,42.88%,1
高雄市,楠梓區,0527,710,201,911,53,964,1591,60.59%,44.63%,1
高雄市,楠梓區,0528,767,182,949,45,994,1545,64.34%,49.64%,1
高雄市,楠梓區,0529,834,193,1027,43,1070,1651,64.81%,50.51%,1
高雄市,楠梓區,0530,816,163,979,64,1043,1646,63.37%,49.57%,1
高雄市,楠梓區,0531,657,189,846,82,928,1496,62.03%,43.92%,1
高雄市,楠梓區,0532,547,161,708,92,800,1403,57.02%,38.99%,1
高雄市,楠梓區,0533,700,176,876,59,935,1624,57.57%,43.1%,1
高雄市,三民區,0887,772,220,992,93,1085,1893,57.32%,40.78%,1
高雄市,三民區,0888,755,212,967,101,1068,1982,53.88%,38.09%,1
高雄市,三民區,0889,723,165,888,82,970,1661,58.4%,43.53%,1
高雄市,三民區,0890,785,192,977,27,1004,1894,53.01%,41.45%,1
高雄市,三民區,0891,784,195,979,65,1044,1839,56.77%,42.63%,1
高雄市,三民區,0892,850,234,1084,71,1155,2014,57.35%,42.2%,1
高雄市,三民區,0893,788,205,993,123,1116,1897,58.83%,41.54%,1
高雄市,三民區,0894,747,237,984,53,1037,2016,51.44%,37.05%,1
高雄市,三民區,0895,771,213,984,52,1036,1924,53.85%,40.07%,1
高雄市,三民區,0896,764,205,969,63,1032,1749,59.01%,43.68%,1
高雄市,三民區,0897,865,224,1089,79,1168,1845,63.31%,46.88%,1
高雄市,三民區,0898,676,179,855,44,899,1724,52.15%,39.21%,1
高雄市,三民區,0899,818,201,1019,51,1070,1889,56.64%,43.3%,1
高雄市,三民區,0900,685,192,877,72,949,1622,58.51%,42.23%,1
高雄市,三民區,0901,774,245,1019,41,1060,1870,56.68%,41.39%,1
高雄市,三民區,0902,656,228,884,74,958,1523,62.9%,43.07%,1
高雄市,三民區,0903,724,224,948,75,1023,2006,51%,36.09%,1
高雄市,三民區,0904,949,277,1226,76,1302,2076,62.72%,45.71%,1
高雄市,三民區,0905,802,340,1142,33,1175,2073,56.68%,38.69%,1
高雄市,三民區,0906,919,211,1130,68,1198,2045,58.58%,44.94%,1
高雄市,三民區,0907,756,205,961,77,1038,2070,50.14%,36.52%,1
高雄市,三民區,0908,795,261,1056,71,1127,2035,55.38%,39.07%,1
高雄市,三民區,0909,948,274,1222,61,1283,2075,61.83%,45.69%,1
高雄市,三民區,0910,946,212,1158,39,1197,2053,58.3%,46.08%,1
高雄市,三民區,0911,989,237,1226,78,1304,2063,63.21%,47.94%,1
高雄市,三民區,0912,1031,260,1291,62,1353,2143,63.14%,48.11%,1
高雄市,三民區,0913,733,262,995,87,1082,1746,61.97%,41.98%,1
高雄市,三民區,0914,642,194,836,29,865,1735,49.86%,37%,1
高雄市,三民區,0915,668,178,846,69,915,1655,55.29%,40.36%,1
高雄市,三民區,0916,712,171,883,61,944,1583,59.63%,44.98%,1
高雄市,三民區,0917,785,181,966,52,1018,1800,56.56%,43.61%,1
高雄市,三民區,0918,763,212,975,40,1015,1730,58.67%,44.1%,1
高雄市,三民區,0919,715,208,923,30,953,1715,55.57%,41.69%,1
高雄市,三民區,0920,711,237,948,59,1007,1691,59.55%,42.05%,1
高雄市,三民區,0921,844,201,1045,58,1103,1865,59.14%,45.25%,1
高雄市,三民區,0922,512,142,654,37,691,1073,64.4%,47.72%,1
高雄市,三民區,0923,436,138,574,63,637,917,69.47%,47.55%,1
高雄市,三民區,0924,785,133,918,58,976,1647,59.26%,47.66%,1
高雄市,三民區,0925,720,217,937,70,1007,1654,60.88%,43.53%,1
高雄市,三民區,0926,752,209,961,49,1010,1639,61.62%,45.88%,1
高雄市,三民區,0927,827,213,1040,63,1103,1833,60.17%,45.12%,1
高雄市,三民區,0928,651,191,842,42,884,1362,64.9%,47.8%,1
高雄市,三民區,0929,721,203,924,63,987,1557,63.39%,46.31%,1
高雄市,三民區,0930,674,198,872,27,899,1482,60.66%,45.48%,1
高雄市,三民區,0931,707,217,924,44,968,1563,61.93%,45.23%,1
高雄市,三民區,0932,658,208,866,34,900,1497,60.12%,43.95%,1
高雄市,三民區,0933,705,209,914,42,956,1523,62.77%,46.29%,1
高雄市,三民區,0934,622,189,811,56,867,1293,67.05%,48.11%,1
高雄市,三民區,0935,780,210,990,59,1049,1662,63.12%,46.93%,1
高雄市,三民區,0936,607,193,800,62,862,1441,59.82%,42.12%,1
高雄市,三民區,0937,647,200,847,49,896,1326,67.57%,48.79%,1
高雄市,三民區,0938,693,223,916,33,949,1476,64.3%,46.95%,1
高雄市,三民區,0939,756,203,959,32,991,1968,50.36%,38.41%,1
高雄市,三民區,0940,616,175,791,28,819,1618,50.62%,38.07%,1
高雄市,三民區,0941,814,218,1032,56,1088,1873,58.09%,43.46%,1
高雄市,三民區,0942,674,151,825,71,896,1487,60.26%,45.33%,1
高雄市,三民區,0943,639,223,862,25,887,1640,54.09%,38.96%,1
高雄市,三民區,0944,775,192,967,35,1002,1889,53.04%,41.03%,1
高雄市,三民區,0945,802,197,999,45,1044,1969,53.02%,40.73%,1
高雄市,三民區,0946,593,193,786,95,881,1466,60.1%,40.45%,1
高雄市,三民區,0947,763,215,978,65,1043,1697,61.46%,44.96%,1
高雄市,三民區,0948,767,190,957,71,1028,1663,61.82%,46.12%,1
高雄市,三民區,0949,711,197,908,49,957,1649,58.04%,43.12%,1
高雄市,三民區,0950,609,177,786,45,831,1486,55.92%,40.98%,1
高雄市,三民區,0951,587,182,769,30,799,1495,53.44%,39.26%,1
高雄市,三民區,0952,748,190,938,28,966,1548,62.4%,48.32%,1
高雄市,三民區,0953,622,182,804,29,833,1493,55.79%,41.66%,1
高雄市,三民區,0954,688,175,863,30,893,1445,61.8%,47.61%,1
高雄市,三民區,0955,670,148,818,43,861,1529,56.31%,43.82%,1
高雄市,三民區,0956,644,155,799,31,830,1506,55.11%,42.76%,1
高雄市,三民區,0957,731,177,908,60,968,1549,62.49%,47.19%,1
高雄市,三民區,0958,772,93,865,72,937,1620,57.84%,47.65%,1
高雄市,三民區,0959,715,208,923,61,984,1550,63.48%,46.13%,1
高雄市,三民區,0960,683,201,884,56,940,1488,63.17%,45.9%,1
高雄市,三民區,0961,614,160,774,57,831,1335,62.25%,45.99%,1
高雄市,三民區,0962,603,155,758,58,816,1332,61.26%,45.27%,1
高雄市,三民區,0963,761,227,988,94,1082,1764,61.34%,43.14%,1
高雄市,三民區,0964,766,229,995,47,1042,1811,57.54%,42.3%,1
高雄市,三民區,0965,768,233,1001,73,1074,1693,63.44%,45.36%,1
高雄市,三民區,0966,789,247,1036,84,1120,1684,66.51%,46.85%,1
高雄市,三民區,0967,621,153,774,68,842,1464,57.51%,42.42%,1
高雄市,三民區,0968,844,222,1066,40,1106,1719,64.34%,49.1%,1
高雄市,三民區,0969,736,223,959,39,998,1749,57.06%,42.08%,1
高雄市,三民區,0970,808,187,995,44,1039,1908,54.45%,42.35%,1
高雄市,三民區,0971,735,170,905,62,967,1573,61.47%,46.73%,1
高雄市,三民區,0972,680,199,879,50,929,1628,57.06%,41.77%,1
高雄市,三民區,0973,488,164,652,53,705,1377,51.2%,35.44%,1
高雄市,三民區,0974,718,193,911,57,968,1530,63.27%,46.93%,1
高雄市,三民區,0975,485,129,614,52,666,1188,56.06%,40.82%,1
高雄市,三民區,0976,601,184,785,39,824,2791,29.52%,21.53%,1
高雄市,三民區,0977,814,207,1021,62,1083,1840,58.86%,44.24%,1
高雄市,三民區,0978,740,221,961,98,1059,1671,63.38%,44.28%,1
高雄市,三民區,0979,693,223,916,64,980,1624,60.34%,42.67%,1
高雄市,三民區,0980,770,218,988,70,1058,1555,68.04%,49.52%,1
高雄市,三民區,0981,726,209,935,48,983,1489,66.02%,48.76%,1
高雄市,三民區,0982,777,194,971,67,1038,1662,62.45%,46.75%,1
高雄市,三民區,0983,708,187,895,24,919,1639,56.07%,43.2%,1
高雄市,三民區,0984,764,237,1001,86,1087,1872,58.07%,40.81%,1
高雄市,三民區,0985,832,209,1041,92,1133,1968,57.57%,42.28%,1
高雄市,三民區,0986,538,135,673,113,786,1471,53.43%,36.57%,1
高雄市,三民區,0987,630,181,811,68,879,1534,57.3%,41.07%,1
高雄市,三民區,0988,636,182,818,88,906,1659,54.61%,38.34%,1
高雄市,三民區,0989,675,171,846,46,892,1815,49.15%,37.19%,1
高雄市,三民區,0990,728,189,917,58,975,1808,53.93%,40.27%,1
高雄市,三民區,0991,463,138,601,36,637,1224,52.04%,37.83%,1
高雄市,三民區,0992,561,168,729,39,768,1406,54.62%,39.9%,1
高雄市,三民區,0993,380,106,486,32,518,945,54.81%,40.21%,1
高雄市,三民區,0994,409,146,555,42,597,944,63.24%,43.33%,1
高雄市,三民區,0995,660,230,890,80,970,1669,58.12%,39.54%,1
高雄市,三民區,0996,588,240,828,84,912,1473,61.91%,39.92%,1
高雄市,三民區,0997,692,197,889,68,957,1876,51.01%,36.89%,1
高雄市,三民區,0998,449,143,592,63,655,1682,38.94%,26.69%,1
高雄市,三民區,0999,703,209,912,48,960,1791,53.6%,39.25%,1
高雄市,三民區,1000,781,244,1025,66,1091,1808,60.34%,43.2%,1
高雄市,三民區,1001,729,200,929,61,990,1798,55.06%,40.55%,1
高雄市,三民區,1002,907,272,1179,75,1254,2030,61.77%,44.68%,1
高雄市,三民區,1003,892,220,1112,30,1142,2034,56.15%,43.85%,1
高雄市,三民區,1004,882,222,1104,37,1141,1998,57.11%,44.14%,1
高雄市,三民區,1005,730,219,949,39,988,1914,51.62%,38.14%,1
高雄市,三民區,1006,794,214,1008,52,1060,1965,53.94%,40.41%,1
高雄市,三民區,1007,746,250,996,97,1093,1885,57.98%,39.58%,1
高雄市,三民區,1008,575,139,714,12,726,1220,59.51%,47.13%,1
高雄市,三民區,1009,410,149,559,75,634,1057,59.98%,38.79%,1
高雄市,三民區,1010,470,149,619,29,648,1434,45.19%,32.78%,1
高雄市,三民區,1011,478,118,596,49,645,1350,47.78%,35.41%,1
高雄市,三民區,1012,294,83,377,25,402,872,46.1%,33.72%,1
高雄市,三民區,1013,361,107,468,20,488,954,51.15%,37.84%,1
高雄市,三民區,1014,758,175,933,25,958,1689,56.72%,44.88%,1
高雄市,三民區,1015,582,159,741,24,765,1390,55.04%,41.87%,1
高雄市,三民區,1016,542,184,726,79,805,1336,60.25%,40.57%,1
高雄市,三民區,1017,670,224,894,58,952,1437,66.25%,46.62%,1
高雄市,三民區,1018,630,176,806,31,837,1452,57.64%,43.39%,1
高雄市,三民區,1019,644,207,851,83,934,1513,61.73%,42.56%,1
高雄市,三民區,1020,628,220,848,105,953,1467,64.96%,42.81%,1
高雄市,三民區,1021,616,238,854,82,936,1381,67.78%,44.61%,1
高雄市,三民區,1022,435,163,598,56,654,1117,58.55%,38.94%,1
高雄市,三民區,1023,594,178,772,37,809,1327,60.96%,44.76%,1
高雄市,三民區,1024,558,176,734,38,772,1304,59.2%,42.79%,1
高雄市,三民區,1025,528,203,731,38,769,1483,51.85%,35.6%,1
高雄市,三民區,1026,609,241,850,52,902,1473,61.24%,41.34%,1
高雄市,三民區,1027,435,128,563,37,600,980,61.22%,44.39%,1
高雄市,三民區,1028,616,187,803,68,871,1409,61.82%,43.72%,1
高雄市,三民區,1029,508,191,699,51,750,1230,60.98%,41.3%,1
高雄市,三民區,1030,455,163,618,65,683,1024,66.7%,44.43%,1
高雄市,三民區,1031,489,174,663,54,717,1130,63.45%,43.27%,1
高雄市,三民區,1032,696,237,933,38,971,1889,51.4%,36.84%,1
高雄市,三民區,1033,572,210,782,36,818,1427,57.32%,40.08%,1
高雄市,三民區,1034,356,93,449,20,469,791,59.29%,45.01%,1
高雄市,三民區,1035,504,167,671,88,759,1079,70.34%,46.71%,1
高雄市,三民區,1036,576,237,813,80,893,1492,59.85%,38.61%,1
高雄市,三民區,1037,432,159,591,68,659,1020,64.61%,42.35%,1
高雄市,三民區,1038,422,140,562,13,575,1001,57.44%,42.16%,1
高雄市,三民區,1039,656,202,858,52,910,1581,57.56%,41.49%,1
高雄市,三民區,1040,562,211,773,50,823,1471,55.95%,38.21%,1
高雄市,三民區,1041,488,143,631,26,657,1151,57.08%,42.4%,1
高雄市,三民區,1042,582,202,784,66,850,1334,63.72%,43.63%,1
高雄市,三民區,1043,557,161,718,53,771,1275,60.47%,43.69%,1
高雄市,三民區,1044,536,174,710,50,760,1688,45.02%,31.75%,1
高雄市,三民區,1045,485,171,656,39,695,1214,57.25%,39.95%,1
高雄市,三民區,1046,541,152,693,30,723,1149,62.92%,47.08%,1
高雄市,三民區,1047,695,232,927,99,1026,1667,61.55%,41.69%,1
高雄市,三民區,1048,645,220,865,45,910,1786,50.95%,36.11%,1
高雄市,三民區,1049,376,139,515,23,538,896,60.04%,41.96%,1
高雄市,三民區,1050,426,101,527,54,581,925,62.81%,46.05%,1
高雄市,三民區,1051,312,100,412,52,464,684,67.84%,45.61%,1
高雄市,三民區,1052,444,156,600,57,657,981,66.97%,45.26%,1
高雄市,三民區,1053,492,169,661,95,756,1383,54.66%,35.57%,1
高雄市,三民區,1054,543,192,735,58,793,1382,57.38%,39.29%,1
高雄市,三民區,1055,340,85,425,27,452,808,55.94%,42.08%,1
高雄市,三民區,1056,502,170,672,32,704,1197,58.81%,41.94%,1
高雄市,三民區,1057,541,162,703,56,759,1344,56.47%,40.25%,1
高雄市,三民區,1058,533,216,749,65,814,1344,60.57%,39.66%,1
高雄市,三民區,1059,596,175,771,20,791,1359,58.2%,43.86%,1
高雄市,三民區,1060,486,143,629,53,682,1073,63.56%,45.29%,1
高雄市,三民區,1061,477,138,615,55,670,1186,56.49%,40.22%,1
高雄市,三民區,1062,709,241,950,85,1035,1749,59.18%,40.54%,1
高雄市,三民區,1063,332,99,431,18,449,877,51.2%,37.86%,1
高雄市,三民區,1064,600,206,806,105,911,1402,64.98%,42.8%,1
高雄市,三民區,1065,364,103,467,23,490,769,63.72%,47.33%,1
高雄市,三民區,1066,534,145,679,67,746,1207,61.81%,44.24%,1
高雄市,三民區,1067,459,135,594,52,646,1270,50.87%,36.14%,1
高雄市,三民區,1068,518,146,664,60,724,1248,58.01%,41.51%,1
高雄市,三民區,1069,553,146,699,86,785,1263,62.15%,43.78%,1
高雄市,三民區,1070,465,139,604,37,641,1101,58.22%,42.23%,1
高雄市,三民區,1071,490,130,620,32,652,1116,58.42%,43.91%,1
高雄市,三民區,1072,483,148,631,33,664,1152,57.64%,41.93%,1
高雄市,三民區,1073,455,131,586,77,663,1057,62.72%,43.05%,1
高雄市,三民區,1074,359,107,466,52,518,971,53.35%,36.97%,1
高雄市,三民區,1075,411,138,549,25,574,1062,54.05%,38.7%,1
高雄市,新興區,1098,342,111,453,35,488,828,58.94%,41.3%,1
高雄市,新興區,1099,441,130,571,63,634,963,65.84%,45.79%,1
高雄市,新興區,1100,426,123,549,29,578,1075,53.77%,39.63%,1
高雄市,新興區,1101,634,191,825,29,854,1488,57.39%,42.61%,1
高雄市,新興區,1102,632,166,798,42,840,1438,58.41%,43.95%,1
高雄市,新興區,1103,467,142,609,31,640,1049,61.01%,44.52%,1
高雄市,新興區,1104,596,226,822,97,919,1378,66.69%,43.25%,1
高雄市,新興區,1105,308,91,399,37,436,666,65.47%,46.25%,1
高雄市,新興區,1106,403,147,550,27,577,981,58.82%,41.08%,1
高雄市,新興區,1107,425,150,575,33,608,933,65.17%,45.55%,1
高雄市,新興區,1108,429,112,541,29,570,987,57.75%,43.47%,1
高雄市,新興區,1109,463,109,572,42,614,988,62.15%,46.86%,1
高雄市,新興區,1110,343,94,437,45,482,735,65.58%,46.67%,1
高雄市,新興區,1111,554,192,746,33,779,1317,59.15%,42.07%,1
高雄市,新興區,1112,315,78,393,17,410,800,51.25%,39.38%,1
高雄市,新興區,1113,432,129,561,43,604,968,62.4%,44.63%,1
高雄市,新興區,1114,416,115,531,27,558,913,61.12%,45.56%,1
高雄市,新興區,1115,604,226,830,27,857,1389,61.7%,43.48%,1
高雄市,新興區,1116,593,182,775,51,826,1228,67.26%,48.29%,1
高雄市,新興區,1117,535,151,686,80,766,1211,63.25%,44.18%,1
高雄市,新興區,1118,504,128,632,16,648,1101,58.86%,45.78%,1
高雄市,新興區,1119,358,91,449,19,468,752,62.23%,47.61%,1
高雄市,新興區,1120,424,136,560,57,617,873,70.68%,48.57%,1
高雄市,新興區,1121,669,258,927,43,970,1609,60.29%,41.58%,1
高雄市,新興區,1122,785,242,1027,61,1088,1736,62.67%,45.22%,1
高雄市,新興區,1123,538,138,676,28,704,1258,55.96%,42.77%,1
高雄市,新興區,1124,475,153,628,58,686,1105,62.08%,42.99%,1
高雄市,新興區,1125,364,115,479,53,532,851,62.51%,42.77%,1
高雄市,新興區,1126,447,146,593,41,634,1011,62.71%,44.21%,1
高雄市,新興區,1127,395,153,548,69,617,888,69.48%,44.48%,1
高雄市,新興區,1128,430,117,547,32,579,1005,57.61%,42.79%,1
高雄市,新興區,1129,442,137,579,19,598,1375,43.49%,32.15%,1
高雄市,新興區,1130,605,191,796,57,853,1388,61.46%,43.59%,1
高雄市,新興區,1131,303,75,378,50,428,719,59.53%,42.14%,1
高雄市,新興區,1132,427,144,571,77,648,1077,60.17%,39.65%,1
高雄市,新興區,1133,311,96,407,17,424,875,48.46%,35.54%,1
高雄市,新興區,1134,367,112,479,23,502,936,53.63%,39.21%,1
高雄市,新興區,1135,382,109,491,62,553,944,58.58%,40.47%,1
高雄市,新興區,1136,312,94,406,32,438,833,52.58%,37.45%,1
高雄市,新興區,1137,296,99,395,13,408,708,57.63%,41.81%,1
高雄市,新興區,1138,338,67,405,18,423,741,57.09%,45.61%,1
高雄市,新興區,1139,426,170,596,36,632,1235,51.17%,34.49%,1
高雄市,前金區,1076,256,76,332,18,350,673,52.01%,38.04%,1
高雄市,前金區,1077,483,112,595,25,620,1022,60.67%,47.26%,1
高雄市,前金區,1078,541,132,673,41,714,1324,53.93%,40.86%,1
高雄市,前金區,1079,353,105,458,50,508,839,60.55%,42.07%,1
高雄市,前金區,1080,373,144,517,74,591,975,60.62%,38.26%,1
高雄市,前金區,1081,805,190,995,70,1065,1806,58.97%,44.57%,1
高雄市,前金區,1082,753,225,978,43,1021,1781,57.33%,42.28%,1
高雄市,前金區,1083,317,96,413,37,450,717,62.76%,44.21%,1
高雄市,前金區,1084,464,137,601,12,613,1097,55.88%,42.3%,1
高雄市,前金區,1085,670,214,884,33,917,1633,56.15%,41.03%,1
高雄市,前金區,1086,360,117,477,37,514,759,67.72%,47.43%,1
高雄市,前金區,1087,417,149,566,56,622,948,65.61%,43.99%,1
高雄市,前金區,1088,345,141,486,77,563,1009,55.8%,34.19%,1
高雄市,前金區,1089,420,117,537,32,569,945,60.21%,44.44%,1
高雄市,前金區,1090,331,99,430,26,456,772,59.07%,42.88%,1
高雄市,前金區,1091,352,111,463,26,489,757,64.6%,46.5%,1
高雄市,前金區,1092,475,130,605,41,646,1047,61.7%,45.37%,1
高雄市,前金區,1093,421,154,575,48,623,985,63.25%,42.74%,1
高雄市,前金區,1094,557,318,875,26,901,1674,53.82%,33.27%,1
高雄市,前金區,1095,448,136,584,31,615,1088,56.53%,41.18%,1
高雄市,前金區,1096,416,130,546,55,601,893,67.3%,46.58%,1
高雄市,前金區,1097,465,148,613,42,655,1184,55.32%,39.27%,1
高雄市,苓雅區,1140,315,104,419,30,449,718,62.53%,43.87%,1
高雄市,苓雅區,1141,655,145,800,46,846,1492,56.7%,43.9%,1
高雄市,苓雅區,1142,539,144,683,47,730,1210,60.33%,44.55%,1
高雄市,苓雅區,1143,603,159,762,30,792,1617,48.98%,37.29%,1
高雄市,苓雅區,1144,636,162,798,80,878,1428,61.48%,44.54%,1
高雄市,苓雅區,1145,514,173,687,51,738,1444,51.11%,35.6%,1
高雄市,苓雅區,1146,599,193,792,77,869,1452,59.85%,41.25%,1
高雄市,苓雅區,1147,237,79,316,39,355,554,64.08%,42.78%,1
高雄市,苓雅區,1148,369,133,502,19,521,950,54.84%,38.84%,1
高雄市,苓雅區,1149,369,131,500,18,518,978,52.97%,37.73%,1
高雄市,苓雅區,1150,608,196,804,36,840,1673,50.21%,36.34%,1
高雄市,苓雅區,1151,770,244,1014,59,1073,2045,52.47%,37.65%,1
高雄市,苓雅區,1152,378,143,521,69,590,939,62.83%,40.26%,1
高雄市,苓雅區,1153,515,140,655,37,692,1284,53.89%,40.11%,1
高雄市,苓雅區,1154,405,111,516,27,543,908,59.8%,44.6%,1
高雄市,苓雅區,1155,348,96,444,16,460,838,54.89%,41.53%,1
高雄市,苓雅區,1156,552,180,732,39,771,1267,60.85%,43.57%,1
高雄市,苓雅區,1157,65,147,212,51,263,994,26.46%,6.54%,1
高雄市,苓雅區,1158,266,114,380,21,401,774,51.81%,34.37%,1
高雄市,苓雅區,1159,494,137,631,27,658,1121,58.7%,44.07%,1
高雄市,苓雅區,1160,589,212,801,65,866,1474,58.75%,39.96%,1
高雄市,苓雅區,1161,655,216,871,71,942,1525,61.77%,42.95%,1
高雄市,苓雅區,1162,594,30,624,32,656,1147,57.19%,51.79%,1
高雄市,苓雅區,1163,455,144,599,36,635,1014,62.62%,44.87%,1
高雄市,苓雅區,1164,615,232,847,59,906,1496,60.56%,41.11%,1
高雄市,苓雅區,1165,670,202,872,69,941,1499,62.78%,44.7%,1
高雄市,苓雅區,1166,521,142,663,31,694,1138,60.98%,45.78%,1
高雄市,苓雅區,1167,419,119,538,41,579,839,69.01%,49.94%,1
高雄市,苓雅區,1168,529,142,671,43,714,2088,34.2%,25.34%,1
高雄市,苓雅區,1169,704,223,927,39,966,1648,58.62%,42.72%,1
高雄市,苓雅區,1170,676,208,884,68,952,1623,58.66%,41.65%,1
高雄市,苓雅區,1171,805,364,1169,58,1227,1932,63.51%,41.67%,1
高雄市,苓雅區,1172,587,150,737,24,761,1127,67.52%,52.09%,1
高雄市,苓雅區,1173,585,164,749,25,774,1156,66.96%,50.61%,1
高雄市,苓雅區,1174,671,196,867,36,903,1465,61.64%,45.8%,1
高雄市,苓雅區,1175,268,64,332,29,361,690,52.32%,38.84%,1
高雄市,苓雅區,1176,492,146,638,93,731,1283,56.98%,38.35%,1
高雄市,苓雅區,1177,600,185,785,75,860,1432,60.06%,41.9%,1
高雄市,苓雅區,1178,579,156,735,48,783,1313,59.63%,44.1%,1
高雄市,苓雅區,1179,606,201,807,24,831,1579,52.63%,38.38%,1
高雄市,苓雅區,1180,570,197,767,67,834,1385,60.22%,41.16%,1
高雄市,苓雅區,1181,654,169,823,63,886,1449,61.15%,45.13%,1
高雄市,苓雅區,1182,860,235,1095,48,1143,1834,62.32%,46.89%,1
高雄市,苓雅區,1183,641,199,840,58,898,1436,62.53%,44.64%,1
高雄市,苓雅區,1184,673,188,861,55,916,1431,64.01%,47.03%,1
高雄市,苓雅區,1185,588,185,773,16,789,1248,63.22%,47.12%,1
高雄市,苓雅區,1186,707,186,893,39,932,1470,63.4%,48.1%,1
高雄市,苓雅區,1187,743,193,936,82,1018,1540,66.1%,48.25%,1
高雄市,苓雅區,1188,637,192,829,30,859,1374,62.52%,46.36%,1
高雄市,苓雅區,1189,409,121,530,24,554,839,66.03%,48.75%,1
高雄市,苓雅區,1190,519,134,653,36,689,1022,67.42%,50.78%,1
高雄市,苓雅區,1191,532,132,664,15,679,1062,63.94%,50.09%,1
高雄市,苓雅區,1192,483,143,626,21,647,1078,60.02%,44.81%,1
高雄市,苓雅區,1193,519,174,693,25,718,1117,64.28%,46.46%,1
高雄市,苓雅區,1194,690,203,893,43,936,1516,61.74%,45.51%,1
高雄市,苓雅區,1195,559,215,774,114,888,1440,61.67%,38.82%,1
高雄市,苓雅區,1196,358,117,475,37,512,839,61.03%,42.67%,1
高雄市,苓雅區,1197,359,100,459,27,486,888,54.73%,40.43%,1
高雄市,苓雅區,1198,501,159,660,31,691,1101,62.76%,45.5%,1
高雄市,苓雅區,1199,485,166,651,63,714,1004,71.12%,48.31%,1
高雄市,苓雅區,1200,624,185,809,64,873,1427,61.18%,43.73%,1
高雄市,苓雅區,1201,502,157,659,31,690,1168,59.08%,42.98%,1
高雄市,苓雅區,1202,557,179,736,59,795,1184,67.15%,47.04%,1
高雄市,苓雅區,1203,442,137,579,35,614,974,63.04%,45.38%,1
高雄市,苓雅區,1204,331,95,426,14,440,849,51.83%,38.99%,1
高雄市,苓雅區,1205,822,222,1044,52,1096,1821,60.19%,45.14%,1
高雄市,苓雅區,1206,587,178,765,54,819,1306,62.71%,44.95%,1
高雄市,苓雅區,1207,540,163,703,26,729,1185,61.52%,45.57%,1
高雄市,苓雅區,1208,583,196,779,50,829,1415,58.59%,41.2%,1
高雄市,苓雅區,1209,455,137,592,40,632,962,65.7%,47.3%,1
高雄市,苓雅區,1210,394,125,519,70,589,964,61.1%,40.87%,1
高雄市,苓雅區,1211,659,204,863,35,898,1524,58.92%,43.24%,1
高雄市,苓雅區,1212,611,236,847,30,877,1455,60.27%,41.99%,1
高雄市,苓雅區,1213,478,154,632,41,673,1272,52.91%,37.58%,1
高雄市,苓雅區,1214,500,144,644,30,674,1256,53.66%,39.81%,1
高雄市,苓雅區,1215,508,130,638,34,672,1203,55.86%,42.23%,1
高雄市,苓雅區,1216,500,119,619,20,639,1062,60.17%,47.08%,1
高雄市,苓雅區,1217,379,125,504,64,568,850,66.82%,44.59%,1
高雄市,苓雅區,1218,445,146,591,87,678,1010,67.13%,44.06%,1
高雄市,苓雅區,1219,483,117,600,31,631,1118,56.44%,43.2%,1
高雄市,苓雅區,1220,421,115,536,56,592,937,63.18%,44.93%,1
高雄市,苓雅區,1221,551,156,707,30,737,1493,49.36%,36.91%,1
高雄市,苓雅區,1222,540,138,678,30,708,1183,59.85%,45.65%,1
高雄市,苓雅區,1223,508,117,625,33,658,1318,49.92%,38.54%,1
高雄市,苓雅區,1224,553,188,741,52,793,1362,58.22%,40.6%,1
高雄市,苓雅區,1225,434,143,577,88,665,1102,60.34%,39.38%,1
高雄市,苓雅區,1226,625,178,803,69,872,1481,58.88%,42.2%,1
高雄市,苓雅區,1227,399,125,524,58,582,878,66.29%,45.44%,1
高雄市,苓雅區,1228,331,111,442,21,463,908,50.99%,36.45%,1
高雄市,苓雅區,1229,502,136,638,50,688,1056,65.15%,47.54%,1
高雄市,苓雅區,1230,418,122,540,39,579,1091,53.07%,38.31%,1
高雄市,苓雅區,1231,440,143,583,25,608,976,62.3%,45.08%,1
高雄市,苓雅區,1232,490,171,661,45,706,1063,66.42%,46.1%,1
高雄市,苓雅區,1233,680,187,867,70,937,1484,63.14%,45.82%,1
高雄市,苓雅區,1234,523,222,745,33,778,1290,60.31%,40.54%,1
高雄市,苓雅區,1235,779,220,999,63,1062,1740,61.03%,44.77%,1
高雄市,苓雅區,1236,777,197,974,68,1042,1594,65.37%,48.75%,1
高雄市,苓雅區,1237,729,168,897,25,922,1648,55.95%,44.24%,1
高雄市,苓雅區,1238,588,150,738,62,800,1236,64.72%,47.57%,1
高雄市,苓雅區,1239,534,164,698,45,743,1211,61.35%,44.1%,1
高雄市,苓雅區,1240,527,164,691,31,722,1283,56.27%,41.08%,1
高雄市,苓雅區,1241,797,244,1041,86,1127,1804,62.47%,44.18%,1
高雄市,苓雅區,1242,783,242,1025,63,1088,1718,63.33%,45.58%,1
高雄市,苓雅區,1243,596,163,759,56,815,1297,62.84%,45.95%,1
高雄市,苓雅區,1244,613,194,807,84,891,1449,61.49%,42.31%,1
高雄市,苓雅區,1245,577,178,755,30,785,1307,60.06%,44.15%,1
高雄市,苓雅區,1246,551,149,700,51,751,1184,63.43%,46.54%,1
高雄市,苓雅區,1247,579,185,764,80,844,1250,67.52%,46.32%,1
高雄市,苓雅區,1248,507,170,677,36,713,1248,57.13%,40.63%,1
高雄市,苓雅區,1249,574,155,729,26,755,1283,58.85%,44.74%,1
高雄市,苓雅區,1250,513,124,637,30,667,1121,59.5%,45.76%,1
高雄市,苓雅區,1251,540,171,711,26,737,1258,58.59%,42.93%,1
高雄市,苓雅區,1252,588,144,732,33,765,1339,57.13%,43.91%,1
高雄市,苓雅區,1253,770,268,1038,60,1098,1986,55.29%,38.77%,1
高雄市,苓雅區,1254,451,112,563,34,597,1028,58.07%,43.87%,1
高雄市,苓雅區,1255,432,119,551,18,569,948,60.02%,45.57%,1
高雄市,前鎮區,1484,554,222,776,130,906,1809,50.08%,30.62%,1
高雄市,前鎮區,1485,698,232,930,91,1021,1835,55.64%,38.04%,1
高雄市,前鎮區,1486,592,173,765,78,843,1890,44.6%,31.32%,1
高雄市,前鎮區,1487,706,206,912,66,978,2013,48.58%,35.07%,1
高雄市,前鎮區,1488,654,219,873,75,948,1776,53.38%,36.82%,1
高雄市,前鎮區,1489,549,186,735,96,831,1705,48.74%,32.2%,1
高雄市,前鎮區,1490,271,75,346,76,422,672,62.8%,40.33%,1
高雄市,前鎮區,1491,577,176,753,92,845,1726,48.96%,33.43%,1
高雄市,前鎮區,1492,663,182,845,35,880,1597,55.1%,41.52%,1
高雄市,前鎮區,1493,698,220,918,82,1000,1690,59.17%,41.3%,1
高雄市,前鎮區,1494,480,133,613,73,686,1080,63.52%,44.44%,1
高雄市,前鎮區,1495,530,169,699,66,765,1159,66.01%,45.73%,1
高雄市,前鎮區,1496,501,138,639,74,713,1314,54.26%,38.13%,1
高雄市,前鎮區,1497,405,90,495,65,560,896,62.5%,45.2%,1
高雄市,前鎮區,1498,428,127,555,39,594,1002,59.28%,42.71%,1
高雄市,前鎮區,1499,731,223,954,112,1066,2765,38.55%,26.44%,1
高雄市,前鎮區,1500,260,49,309,69,378,600,63%,43.33%,1
高雄市,前鎮區,1501,353,116,469,48,517,1466,35.27%,24.08%,1
高雄市,前鎮區,1502,551,160,711,46,757,1449,52.24%,38.03%,1
高雄市,前鎮區,1503,381,107,488,57,545,991,54.99%,38.45%,1
高雄市,前鎮區,1504,533,142,675,79,754,1248,60.42%,42.71%,1
高雄市,前鎮區,1505,456,123,579,100,679,1066,63.7%,42.78%,1
高雄市,前鎮區,1506,233,64,297,33,330,706,46.74%,33%,1
高雄市,前鎮區,1507,255,77,332,37,369,713,51.75%,35.76%,1
高雄市,前鎮區,1508,470,167,637,43,680,1344,50.6%,34.97%,1
高雄市,前鎮區,1509,344,119,463,54,517,856,60.4%,40.19%,1
高雄市,前鎮區,1510,286,113,399,42,441,873,50.52%,32.76%,1
高雄市,前鎮區,1511,409,110,519,49,568,1114,50.99%,36.71%,1
高雄市,前鎮區,1512,362,120,482,21,503,1112,45.23%,32.55%,1
高雄市,前鎮區,1513,396,125,521,64,585,1044,56.03%,37.93%,1
高雄市,前鎮區,1514,349,113,462,54,516,940,54.89%,37.13%,1
高雄市,前鎮區,1515,492,136,628,74,702,1342,52.31%,36.66%,1
高雄市,前鎮區,1516,673,192,865,62,927,1402,66.12%,48%,1
高雄市,前鎮區,1517,577,179,756,42,798,1320,60.45%,43.71%,1
高雄市,前鎮區,1518,384,118,502,70,572,958,59.71%,40.08%,1
高雄市,前鎮區,1519,658,166,824,44,868,1276,68.03%,51.57%,1
高雄市,前鎮區,1520,657,157,814,97,911,1459,62.44%,45.03%,1
高雄市,前鎮區,1521,239,101,340,20,360,761,47.31%,31.41%,1
高雄市,前鎮區,1522,404,134,538,23,561,1093,51.33%,36.96%,1
高雄市,前鎮區,1523,783,136,919,42,961,1521,63.18%,51.48%,1
高雄市,前鎮區,1524,767,146,913,45,958,1557,61.53%,49.26%,1
高雄市,前鎮區,1525,766,143,909,78,987,1821,54.2%,42.06%,1
高雄市,前鎮區,1526,583,115,698,39,737,1066,69.14%,54.69%,1
高雄市,前鎮區,1527,577,84,661,21,682,1046,65.2%,55.16%,1
高雄市,前鎮區,1528,686,251,937,55,992,1709,58.05%,40.14%,1
高雄市,前鎮區,1529,737,239,976,88,1064,1723,61.75%,42.77%,1
高雄市,前鎮區,1530,556,178,734,53,787,1202,65.47%,46.26%,1
高雄市,前鎮區,1531,577,219,796,42,838,1279,65.52%,45.11%,1
高雄市,前鎮區,1532,730,199,929,49,978,1513,64.64%,48.25%,1
高雄市,前鎮區,1533,578,112,690,18,708,1260,56.19%,45.87%,1
高雄市,前鎮區,1534,506,158,664,84,748,1139,65.67%,44.42%,1
高雄市,前鎮區,1535,547,164,711,49,760,1140,66.67%,47.98%,1
高雄市,前鎮區,1536,642,204,846,73,919,1462,62.86%,43.91%,1
高雄市,前鎮區,1537,611,178,789,53,842,1359,61.96%,44.96%,1
高雄市,前鎮區,1538,701,262,963,97,1060,2037,52.04%,34.41%,1
高雄市,前鎮區,1539,591,145,736,28,764,1410,54.18%,41.91%,1
高雄市,前鎮區,1540,524,183,707,23,730,1307,55.85%,40.09%,1
高雄市,前鎮區,1541,593,211,804,87,891,1512,58.93%,39.22%,1
高雄市,前鎮區,1542,613,222,835,81,916,1491,61.44%,41.11%,1
高雄市,前鎮區,1543,672,188,860,91,951,1621,58.67%,41.46%,1
高雄市,前鎮區,1544,588,147,735,72,807,1522,53.02%,38.63%,1
高雄市,前鎮區,1545,659,223,882,65,947,1593,59.45%,41.37%,1
高雄市,前鎮區,1546,816,235,1051,92,1143,1885,60.64%,43.29%,1
高雄市,前鎮區,1547,827,254,1081,90,1171,1870,62.62%,44.22%,1
高雄市,前鎮區,1548,576,195,771,31,802,1388,57.78%,41.5%,1
高雄市,前鎮區,1549,577,165,742,68,810,1348,60.09%,42.8%,1
高雄市,前鎮區,1550,529,136,665,111,776,1341,57.87%,39.45%,1
高雄市,前鎮區,1551,609,213,822,41,863,1364,63.27%,44.65%,1
高雄市,前鎮區,1552,567,183,750,79,829,1367,60.64%,41.48%,1
高雄市,前鎮區,1553,513,181,694,85,779,1326,58.75%,38.69%,1
高雄市,前鎮區,1554,456,113,569,44,613,1059,57.88%,43.06%,1
高雄市,前鎮區,1555,519,118,637,26,663,1119,59.25%,46.38%,1
高雄市,前鎮區,1556,598,184,782,42,824,1565,52.65%,38.21%,1
高雄市,前鎮區,1557,721,105,826,77,903,1549,58.3%,46.55%,1
高雄市,前鎮區,1558,823,230,1053,43,1096,1691,64.81%,48.67%,1
高雄市,前鎮區,1559,845,214,1059,46,1105,1837,60.15%,46%,1
高雄市,前鎮區,1560,512,132,644,24,668,1092,61.17%,46.89%,1
高雄市,前鎮區,1561,498,149,647,58,705,1126,62.61%,44.23%,1
高雄市,前鎮區,1562,489,134,623,83,706,1215,58.11%,40.25%,1
高雄市,前鎮區,1563,618,204,822,31,853,1443,59.11%,42.83%,1
高雄市,前鎮區,1564,713,221,934,28,962,1448,66.44%,49.24%,1
高雄市,前鎮區,1565,732,184,916,93,1009,1648,61.23%,44.42%,1
高雄市,前鎮區,1566,616,189,805,88,893,1603,55.71%,38.43%,1
高雄市,前鎮區,1567,600,144,744,34,778,1596,48.75%,37.59%,1
高雄市,前鎮區,1568,534,134,668,41,709,1450,48.9%,36.83%,1
高雄市,前鎮區,1569,599,144,743,94,837,1510,55.43%,39.67%,1
高雄市,前鎮區,1570,708,231,939,94,1033,1647,62.72%,42.99%,1
高雄市,前鎮區,1571,565,133,698,72,770,1342,57.38%,42.1%,1
高雄市,前鎮區,1572,548,137,685,51,736,1384,53.18%,39.6%,1
高雄市,前鎮區,1573,623,140,763,75,838,1479,56.66%,42.12%,1
高雄市,前鎮區,1574,663,172,835,39,874,1546,56.53%,42.88%,1
高雄市,前鎮區,1575,700,196,896,72,968,1595,60.69%,43.89%,1
高雄市,前鎮區,1576,549,123,672,69,741,1201,61.7%,45.71%,1
高雄市,前鎮區,1577,432,119,551,25,576,1082,53.23%,39.93%,1
高雄市,前鎮區,1578,397,101,498,43,541,996,54.32%,39.86%,1
高雄市,前鎮區,1579,381,112,493,84,577,932,61.91%,40.88%,1
高雄市,前鎮區,1580,479,158,637,51,688,1146,60.03%,41.8%,1
高雄市,前鎮區,1581,482,133,615,33,648,1096,59.12%,43.98%,1
高雄市,前鎮區,1582,651,141,792,21,813,1332,61.04%,48.87%,1
高雄市,前鎮區,1583,479,152,631,40,671,1175,57.11%,40.77%,1
高雄市,前鎮區,1584,426,111,537,62,599,986,60.75%,43.2%,1
高雄市,前鎮區,1585,588,156,744,79,823,1316,62.54%,44.68%,1
高雄市,前鎮區,1586,569,177,746,65,811,1559,52.02%,36.5%,1
高雄市,前鎮區,1587,698,210,908,79,987,1622,60.85%,43.03%,1
高雄市,前鎮區,1588,553,126,679,37,716,1310,54.66%,42.21%,1
高雄市,前鎮區,1589,525,169,694,104,798,1299,61.43%,40.42%,1
高雄市,前鎮區,1590,567,153,720,73,793,1191,66.58%,47.61%,1
高雄市,前鎮區,1591,560,124,684,29,713,1375,51.85%,40.73%,1
高雄市,前鎮區,1592,574,149,723,36,759,1338,56.73%,42.9%,1
高雄市,前鎮區,1593,464,143,607,26,633,1175,53.87%,39.49%,1
高雄市,前鎮區,1594,580,139,719,27,746,1357,54.97%,42.74%,1
高雄市,前鎮區,1595,528,183,711,61,772,1187,65.04%,44.48%,1
高雄市,前鎮區,1596,480,131,611,49,660,1164,56.7%,41.24%,1
高雄市,前鎮區,1597,549,150,699,65,764,1219,62.67%,45.04%,1
高雄市,前鎮區,1598,565,186,751,25,776,1428,54.34%,39.57%,1
高雄市,前鎮區,1599,579,194,773,108,881,1495,58.93%,38.73%,1
高雄市,前鎮區,1600,707,160,867,41,908,1531,59.31%,46.18%,1
高雄市,前鎮區,1601,648,163,811,86,897,1509,59.44%,42.94%,1
高雄市,前鎮區,1602,633,187,820,75,895,1591,56.25%,39.79%,1
高雄市,旗津區,0869,440,172,612,118,730,1177,62.02%,37.38%,1
高雄市,旗津區,0870,388,104,492,50,542,1109,48.87%,34.99%,1
高雄市,旗津區,0871,508,173,681,29,710,1642,43.24%,30.94%,1
高雄市,旗津區,0872,445,109,554,106,660,1209,54.59%,36.81%,1
高雄市,旗津區,0873,353,115,468,54,522,1112,46.94%,31.74%,1
高雄市,旗津區,0874,546,202,748,101,849,1483,57.25%,36.82%,1
高雄市,旗津區,0875,487,96,583,31,614,1460,42.05%,33.36%,1
高雄市,旗津區,0876,601,223,824,159,983,1572,62.53%,38.23%,1
高雄市,旗津區,0877,476,117,593,30,623,1384,45.01%,34.39%,1
高雄市,旗津區,0878,459,133,592,41,633,1390,45.54%,33.02%,1
高雄市,旗津區,0879,403,136,539,62,601,1239,48.51%,32.53%,1
高雄市,旗津區,0880,663,245,908,130,1038,2045,50.76%,32.42%,1
高雄市,旗津區,0881,290,102,392,23,415,893,46.47%,32.47%,1
高雄市,旗津區,0882,603,236,839,137,976,1866,52.3%,32.32%,1
高雄市,旗津區,0883,504,182,686,34,720,1874,38.42%,26.89%,1
高雄市,旗津區,0884,300,88,388,67,455,893,50.95%,33.59%,1
高雄市,旗津區,0885,420,166,586,41,627,1215,51.6%,34.57%,1
高雄市,旗津區,0886,446,107,553,48,601,1297,46.34%,34.39%,1
高雄市,小港區,1603,520,128,648,48,696,1108,62.82%,46.93%,1
高雄市,小港區,1604,523,145,668,60,728,1171,62.17%,44.66%,1
高雄市,小港區,1605,690,249,939,26,965,1557,61.98%,44.32%,1
高雄市,小港區,1606,679,160,839,21,860,1668,51.56%,40.71%,1
高雄市,小港區,1607,661,34,695,24,719,1183,60.78%,55.87%,1
高雄市,小港區,1608,590,161,751,27,778,1372,56.71%,43%,1
高雄市,小港區,1609,776,214,990,53,1043,1737,60.05%,44.67%,1
高雄市,小港區,1610,592,238,830,69,899,1586,56.68%,37.33%,1
高雄市,小港區,1611,614,147,761,75,836,1558,53.66%,39.41%,1
高雄市,小港區,1612,595,182,777,69,846,1284,65.89%,46.34%,1
高雄市,小港區,1613,576,164,740,57,797,1249,63.81%,46.12%,1
高雄市,小港區,1614,797,211,1008,118,1126,2400,46.92%,33.21%,1
高雄市,小港區,1615,493,167,660,45,705,1181,59.7%,41.74%,1
高雄市,小港區,1616,457,121,578,31,609,1079,56.44%,42.35%,1
高雄市,小港區,1617,577,168,745,38,783,1335,58.65%,43.22%,1
高雄市,小港區,1618,568,139,707,59,766,1241,61.72%,45.77%,1
高雄市,小港區,1619,627,182,809,63,872,1513,57.63%,41.44%,1
高雄市,小港區,1620,606,158,764,67,831,1349,61.6%,44.92%,1
高雄市,小港區,1621,600,178,778,46,824,1483,55.56%,40.46%,1
高雄市,小港區,1622,649,154,803,30,833,1451,57.41%,44.73%,1
高雄市,小港區,1623,495,135,630,25,655,1241,52.78%,39.89%,1
高雄市,小港區,1624,571,204,775,68,843,1262,66.8%,45.25%,1
高雄市,小港區,1625,780,226,1006,94,1100,1813,60.67%,43.02%,1
高雄市,小港區,1626,704,162,866,39,905,1877,48.22%,37.51%,1
高雄市,小港區,1627,570,173,743,29,772,1391,55.5%,40.98%,1
高雄市,小港區,1628,637,187,824,32,856,1453,58.91%,43.84%,1
高雄市,小港區,1629,586,192,778,42,820,1374,59.68%,42.65%,1
高雄市,小港區,1630,564,163,727,60,787,1348,58.38%,41.84%,1
高雄市,小港區,1631,622,152,774,63,837,1334,62.74%,46.63%,1
高雄市,小港區,1632,585,173,758,37,795,1433,55.48%,40.82%,1
高雄市,小港區,1633,548,157,705,19,724,1448,50%,37.85%,1
高雄市,小港區,1634,773,108,881,76,957,1488,64.31%,51.95%,1
高雄市,小港區,1635,578,147,725,63,788,1278,61.66%,45.23%,1
高雄市,小港區,1636,663,177,840,57,897,1306,68.68%,50.77%,1
高雄市,小港區,1637,704,194,898,75,973,1625,59.88%,43.32%,1
高雄市,小港區,1638,754,206,960,83,1043,1640,63.6%,45.98%,1
高雄市,小港區,1639,657,167,824,52,876,1506,58.17%,43.63%,1
高雄市,小港區,1640,576,161,737,58,795,1438,55.29%,40.06%,1
高雄市,小港區,1641,566,137,703,34,737,1105,66.7%,51.22%,1
高雄市,小港區,1642,513,116,629,18,647,1167,55.44%,43.96%,1
高雄市,小港區,1643,672,151,823,31,854,1420,60.14%,47.32%,1
高雄市,小港區,1644,682,159,841,67,908,1380,65.8%,49.42%,1
高雄市,小港區,1645,568,107,675,28,703,1239,56.74%,45.84%,1
高雄市,小港區,1646,705,195,900,60,960,1563,61.42%,45.11%,1
高雄市,小港區,1647,721,188,909,71,980,1644,59.61%,43.86%,1
高雄市,小港區,1648,799,208,1007,76,1083,1895,57.15%,42.16%,1
高雄市,小港區,1649,707,187,894,93,987,1748,56.46%,40.45%,1
高雄市,小港區,1650,618,254,872,99,971,1579,61.49%,39.14%,1
高雄市,小港區,1651,884,251,1135,55,1190,2135,55.74%,41.41%,1
高雄市,小港區,1652,719,206,925,83,1008,1728,58.33%,41.61%,1
高雄市,小港區,1653,833,179,1012,47,1059,2022,52.37%,41.2%,1
高雄市,小港區,1654,482,104,586,23,609,1329,45.82%,36.27%,1
高雄市,小港區,1655,537,144,681,43,724,1320,54.85%,40.68%,1
高雄市,小港區,1656,539,149,688,88,776,1267,61.25%,42.54%,1
高雄市,小港區,1657,577,178,755,71,826,1298,63.64%,44.45%,1
高雄市,小港區,1658,598,157,755,32,787,1289,61.06%,46.39%,1
高雄市,小港區,1659,688,175,863,44,907,1534,59.13%,44.85%,1
高雄市,小港區,1660,655,182,837,39,876,1494,58.63%,43.84%,1
高雄市,小港區,1661,562,192,754,74,828,1377,60.13%,40.81%,1
高雄市,小港區,1662,669,123,792,70,862,1344,64.14%,49.78%,1
高雄市,小港區,1663,629,161,790,71,861,1508,57.1%,41.71%,1
高雄市,小港區,1664,536,202,738,29,767,1400,54.79%,38.29%,1
高雄市,小港區,1665,673,144,817,65,882,1457,60.54%,46.19%,1
高雄市,小港區,1666,582,161,743,31,774,1392,55.6%,41.81%,1
高雄市,小港區,1667,790,227,1017,68,1085,1983,54.72%,39.84%,1
高雄市,小港區,1668,528,105,633,28,661,1204,54.9%,43.85%,1
高雄市,小港區,1669,567,140,707,53,760,1300,58.46%,43.62%,1
高雄市,小港區,1670,805,257,1062,92,1154,1857,62.14%,43.35%,1
高雄市,小港區,1671,688,160,848,34,882,1566,56.32%,43.93%,1
高雄市,小港區,1672,635,164,799,85,884,1343,65.82%,47.28%,1
高雄市,小港區,1673,568,149,717,87,804,1236,65.05%,45.95%,1
高雄市,小港區,1674,691,193,884,94,978,1564,62.53%,44.18%,1
高雄市,小港區,1675,607,226,833,13,846,1484,57.01%,40.9%,1
高雄市,小港區,1676,603,184,787,40,827,1477,55.99%,40.83%,1
高雄市,小港區,1677,686,195,881,37,918,1482,61.94%,46.29%,1
高雄市,小港區,1678,686,194,880,39,919,1708,53.81%,40.16%,1
高雄市,小港區,1679,752,248,1000,67,1067,1867,57.15%,40.28%,1
高雄市,小港區,1680,658,156,814,25,839,1709,49.09%,38.5%,1
高雄市,小港區,1681,546,171,717,64,781,1425,54.81%,38.32%,1
高雄市,小港區,1682,593,156,749,50,799,1696,47.11%,34.96%,1
高雄市,小港區,1683,530,152,682,77,759,1522,49.87%,34.82%,1
高雄市,小港區,1684,638,178,816,88,904,1531,59.05%,41.67%,1
高雄市,小港區,1685,809,271,1080,142,1222,2215,55.17%,36.52%,1
高雄市,小港區,1686,589,166,755,31,786,1515,51.88%,38.88%,1
高雄市,小港區,1687,516,171,687,41,728,1535,47.43%,33.62%,1
高雄市,小港區,1688,512,145,657,32,689,1276,54%,40.13%,1
高雄市,小港區,1689,432,126,558,36,594,1217,48.81%,35.5%,1
高雄市,小港區,1690,600,167,767,78,845,1707,49.5%,35.15%,1
高雄市,小港區,1691,674,232,906,115,1021,1920,53.18%,35.1%,1
高雄市,鳳山區,1256,505,152,657,52,709,1080,65.65%,46.76%,1
高雄市,鳳山區,1257,384,94,478,37,515,819,62.88%,46.89%,1
高雄市,鳳山區,1258,380,84,464,67,531,851,62.4%,44.65%,1
高雄市,鳳山區,1259,482,150,632,39,671,1075,62.42%,44.84%,1
高雄市,鳳山區,1260,579,140,719,33,752,1223,61.49%,47.34%,1
高雄市,鳳山區,1261,551,154,705,40,745,1207,61.72%,45.65%,1
高雄市,鳳山區,1262,522,173,695,38,733,1339,54.74%,38.98%,1
高雄市,鳳山區,1263,473,101,574,39,613,1188,51.6%,39.81%,1
高雄市,鳳山區,1264,490,95,585,55,640,1055,60.66%,46.45%,1
高雄市,鳳山區,1265,467,102,569,68,637,1109,57.44%,42.11%,1
高雄市,鳳山區,1266,382,97,479,39,518,756,68.52%,50.53%,1
高雄市,鳳山區,1267,491,117,608,36,644,1182,54.48%,41.54%,1
高雄市,鳳山區,1268,654,156,810,78,888,1496,59.36%,43.72%,1
高雄市,鳳山區,1269,785,194,979,65,1044,2094,49.86%,37.49%,1
高雄市,鳳山區,1270,704,176,880,27,907,1672,54.25%,42.11%,1
高雄市,鳳山區,1271,752,172,924,29,953,1761,54.12%,42.7%,1
高雄市,鳳山區,1272,637,162,799,61,860,1450,59.31%,43.93%,1
高雄市,鳳山區,1273,566,148,714,38,752,1455,51.68%,38.9%,1
高雄市,鳳山區,1274,523,148,671,61,732,1234,59.32%,42.38%,1
高雄市,鳳山區,1275,797,307,1104,66,1170,1713,68.3%,46.53%,1
高雄市,鳳山區,1276,708,139,847,29,876,1698,51.59%,41.7%,1
高雄市,鳳山區,1277,540,164,704,68,772,1247,61.91%,43.3%,1
高雄市,鳳山區,1278,474,137,611,47,658,1087,60.53%,43.61%,1
高雄市,鳳山區,1279,555,130,685,20,705,1199,58.8%,46.29%,1
高雄市,鳳山區,1280,752,94,846,53,899,1559,57.67%,48.24%,1
高雄市,鳳山區,1281,561,126,687,41,728,1233,59.04%,45.5%,1
高雄市,鳳山區,1282,563,147,710,48,758,1277,59.36%,44.09%,1
高雄市,鳳山區,1283,672,119,791,20,811,1481,54.76%,45.37%,1
高雄市,鳳山區,1284,566,154,720,16,736,1154,63.78%,49.05%,1
高雄市,鳳山區,1285,676,191,867,31,898,1475,60.88%,45.83%,1
高雄市,鳳山區,1286,499,114,613,33,646,1247,51.8%,40.02%,1
高雄市,鳳山區,1287,607,166,773,76,849,1538,55.2%,39.47%,1
高雄市,鳳山區,1288,436,142,578,36,614,1097,55.97%,39.74%,1
高雄市,鳳山區,1289,451,145,596,25,621,1221,50.86%,36.94%,1
高雄市,鳳山區,1290,533,146,679,54,733,1075,68.19%,49.58%,1
高雄市,鳳山區,1291,805,210,1015,42,1057,1751,60.37%,45.97%,1
高雄市,鳳山區,1292,795,208,1003,44,1047,1758,59.56%,45.22%,1
高雄市,鳳山區,1293,754,199,953,82,1035,1749,59.18%,43.11%,1
高雄市,鳳山區,1294,771,163,934,21,955,1746,54.7%,44.16%,1
高雄市,鳳山區,1295,747,167,914,49,963,1712,56.25%,43.63%,1
高雄市,鳳山區,1296,588,128,716,37,753,1247,60.38%,47.15%,1
高雄市,鳳山區,1297,613,190,803,54,857,1409,60.82%,43.51%,1
高雄市,鳳山區,1298,595,159,754,52,806,1347,59.84%,44.17%,1
高雄市,鳳山區,1299,759,195,954,27,981,1771,55.39%,42.86%,1
高雄市,鳳山區,1300,698,157,855,16,871,1537,56.67%,45.41%,1
高雄市,鳳山區,1301,746,173,919,27,946,1605,58.94%,46.48%,1
高雄市,鳳山區,1302,627,144,771,52,823,1375,59.85%,45.6%,1
高雄市,鳳山區,1303,640,167,807,65,872,1393,62.6%,45.94%,1
高雄市,鳳山區,1304,654,176,830,27,857,1584,54.1%,41.29%,1
高雄市,鳳山區,1305,241,93,334,20,354,618,57.28%,39%,1
高雄市,鳳山區,1306,203,36,239,11,250,423,59.1%,47.99%,1
高雄市,鳳山區,1307,544,162,706,59,765,1312,58.31%,41.46%,1
高雄市,鳳山區,1308,329,95,424,30,454,769,59.04%,42.78%,1
高雄市,鳳山區,1309,591,136,727,21,748,1213,61.67%,48.72%,1
高雄市,鳳山區,1310,548,136,684,34,718,1107,64.86%,49.5%,1
高雄市,鳳山區,1311,511,168,679,30,709,1188,59.68%,43.01%,1
高雄市,鳳山區,1312,528,162,690,41,731,1183,61.79%,44.63%,1
高雄市,鳳山區,1313,546,179,725,55,780,1264,61.71%,43.2%,1
高雄市,鳳山區,1314,363,124,487,30,517,882,58.62%,41.16%,1
高雄市,鳳山區,1315,506,151,657,46,703,1007,69.81%,50.25%,1
高雄市,鳳山區,1316,358,100,458,75,533,853,62.49%,41.97%,1
高雄市,鳳山區,1317,322,97,419,54,473,1660,28.49%,19.4%,1
高雄市,鳳山區,1318,514,138,652,37,689,1124,61.3%,45.73%,1
高雄市,鳳山區,1319,465,167,632,60,692,1112,62.23%,41.82%,1
高雄市,鳳山區,1320,486,130,616,40,656,1182,55.5%,41.12%,1
高雄市,鳳山區,1321,464,118,582,45,627,875,71.66%,53.03%,1
高雄市,鳳山區,1322,441,154,595,44,639,1040,61.44%,42.4%,1
高雄市,鳳山區,1323,514,157,671,26,697,1094,63.71%,46.98%,1
高雄市,鳳山區,1324,525,173,698,61,759,1217,62.37%,43.14%,1
高雄市,鳳山區,1325,491,137,628,38,666,974,68.38%,50.41%,1
高雄市,鳳山區,1326,469,92,561,39,600,987,60.79%,47.52%,1
高雄市,鳳山區,1327,612,143,755,21,776,1210,64.13%,50.58%,1
高雄市,鳳山區,1328,578,186,764,65,829,1391,59.6%,41.55%,1
高雄市,鳳山區,1329,458,136,594,22,616,1241,49.64%,36.91%,1
高雄市,鳳山區,1330,483,113,596,48,644,1000,64.4%,48.3%,1
高雄市,鳳山區,1331,511,109,620,44,664,1092,60.81%,46.79%,1
高雄市,鳳山區,1332,612,150,762,48,810,1308,61.93%,46.79%,1
高雄市,鳳山區,1333,481,112,593,55,648,1031,62.85%,46.65%,1
高雄市,鳳山區,1334,514,172,686,59,745,1159,64.28%,44.35%,1
高雄市,鳳山區,1335,491,119,610,63,673,1127,59.72%,43.57%,1
高雄市,鳳山區,1336,565,183,748,45,793,1109,71.51%,50.95%,1
高雄市,鳳山區,1337,895,233,1128,64,1192,1879,63.44%,47.63%,1
高雄市,鳳山區,1338,941,208,1149,49,1198,1803,66.44%,52.19%,1
高雄市,鳳山區,1339,842,174,1016,88,1104,2045,53.99%,41.17%,1
高雄市,鳳山區,1340,596,164,760,58,818,1432,57.12%,41.62%,1
高雄市,鳳山區,1341,423,95,518,20,538,1033,52.08%,40.95%,1
高雄市,鳳山區,1342,551,169,720,82,802,1253,64.01%,43.97%,1
高雄市,鳳山區,1343,546,156,702,24,726,1217,59.65%,44.86%,1
高雄市,鳳山區,1344,620,139,759,48,807,1267,63.69%,48.93%,1
高雄市,鳳山區,1345,510,137,647,42,689,1251,55.08%,40.77%,1
高雄市,鳳山區,1346,706,157,863,75,938,1563,60.01%,45.17%,1
高雄市,鳳山區,1347,910,189,1099,62,1161,1888,61.49%,48.2%,1
高雄市,鳳山區,1348,597,176,773,63,836,1368,61.11%,43.64%,1
高雄市,鳳山區,1349,659,158,817,42,859,1588,54.09%,41.5%,1
高雄市,鳳山區,1350,646,104,750,51,801,1255,63.82%,51.47%,1
高雄市,鳳山區,1351,551,146,697,67,764,1264,60.44%,43.59%,1
高雄市,鳳山區,1352,585,142,727,72,799,1291,61.89%,45.31%,1
高雄市,鳳山區,1353,555,108,663,39,702,1224,57.35%,45.34%,1
高雄市,鳳山區,1354,590,129,719,40,759,1296,58.56%,45.52%,1
高雄市,鳳山區,1355,406,99,505,51,556,826,67.31%,49.15%,1
高雄市,鳳山區,1356,567,138,705,44,749,1229,60.94%,46.14%,1
高雄市,鳳山區,1357,726,130,856,47,903,1467,61.55%,49.49%,1
高雄市,鳳山區,1358,550,134,684,61,745,1218,61.17%,45.16%,1
高雄市,鳳山區,1359,898,240,1138,75,1213,2173,55.82%,41.33%,1
高雄市,鳳山區,1360,1001,250,1251,68,1319,2255,58.49%,44.39%,1
高雄市,鳳山區,1361,718,165,883,41,924,1556,59.38%,46.14%,1
高雄市,鳳山區,1362,630,164,794,53,847,1521,55.69%,41.42%,1
高雄市,鳳山區,1363,571,124,695,40,735,1407,52.24%,40.58%,1
高雄市,鳳山區,1364,720,155,875,63,938,1542,60.83%,46.69%,1
高雄市,鳳山區,1365,640,125,765,22,787,1502,52.4%,42.61%,1
高雄市,鳳山區,1366,629,144,773,52,825,1320,62.5%,47.65%,1
高雄市,鳳山區,1367,711,93,804,31,835,1507,55.41%,47.18%,1
高雄市,鳳山區,1368,687,103,790,84,874,1284,68.07%,53.5%,1
高雄市,鳳山區,1369,610,140,750,40,790,1441,54.82%,42.33%,1
高雄市,鳳山區,1370,705,126,831,82,913,1485,61.48%,47.47%,1
高雄市,鳳山區,1371,457,175,632,68,700,1205,58.09%,37.93%,1
高雄市,鳳山區,1372,528,146,674,21,695,1284,54.13%,41.12%,1
高雄市,鳳山區,1373,563,193,756,69,825,1326,62.22%,42.46%,1
高雄市,鳳山區,1374,469,148,617,24,641,1096,58.49%,42.79%,1
高雄市,鳳山區,1375,512,170,682,74,756,1182,63.96%,43.32%,1
高雄市,鳳山區,1376,502,137,639,55,694,1017,68.24%,49.36%,1
高雄市,鳳山區,1377,463,165,628,81,709,1198,59.18%,38.65%,1
高雄市,鳳山區,1378,470,148,618,33,651,1281,50.82%,36.69%,1
高雄市,鳳山區,1379,627,187,814,43,857,1358,63.11%,46.17%,1
高雄市,鳳山區,1380,617,151,768,40,808,1226,65.91%,50.33%,1
高雄市,鳳山區,1381,524,125,649,62,711,1098,64.75%,47.72%,1
高雄市,鳳山區,1382,536,146,682,38,720,1200,60%,44.67%,1
高雄市,鳳山區,1383,404,104,508,44,552,942,58.6%,42.89%,1
高雄市,鳳山區,1384,501,120,621,34,655,1206,54.31%,41.54%,1
高雄市,鳳山區,1385,565,148,713,35,748,1159,64.54%,48.75%,1
高雄市,鳳山區,1386,659,167,826,55,881,1401,62.88%,47.04%,1
高雄市,鳳山區,1387,618,171,789,23,812,1525,53.25%,40.52%,1
高雄市,鳳山區,1388,557,170,727,41,768,1345,57.1%,41.41%,1
高雄市,鳳山區,1389,544,149,693,39,732,1180,62.03%,46.1%,1
高雄市,鳳山區,1390,439,117,556,26,582,1106,52.62%,39.69%,1
高雄市,鳳山區,1391,679,181,860,60,920,1442,63.8%,47.09%,1
高雄市,鳳山區,1392,633,177,810,46,856,1376,62.21%,46%,1
高雄市,鳳山區,1393,539,157,696,29,725,1243,58.33%,43.36%,1
高雄市,鳳山區,1394,627,124,751,23,774,1361,56.87%,46.07%,1
高雄市,鳳山區,1395,615,194,809,73,882,1416,62.29%,43.43%,1
高雄市,鳳山區,1396,735,204,939,75,1014,1536,66.02%,47.85%,1
高雄市,鳳山區,1397,544,155,699,24,723,1388,52.09%,39.19%,1
高雄市,鳳山區,1398,545,153,698,73,771,1241,62.13%,43.92%,1
高雄市,鳳山區,1399,667,162,829,51,880,1394,63.13%,47.85%,1
高雄市,鳳山區,1400,599,146,745,28,773,1188,65.07%,50.42%,1
高雄市,鳳山區,1401,474,150,624,39,663,1112,59.62%,42.63%,1
高雄市,鳳山區,1402,540,185,725,56,781,1198,65.19%,45.08%,1
高雄市,鳳山區,1403,619,182,801,44,845,1475,57.29%,41.97%,1
高雄市,鳳山區,1404,493,120,613,30,643,1216,52.88%,40.54%,1
高雄市,鳳山區,1405,475,144,619,35,654,1318,49.62%,36.04%,1
高雄市,鳳山區,1406,635,157,792,23,815,1465,55.63%,43.34%,1
高雄市,鳳山區,1407,506,143,649,37,686,1314,52.21%,38.51%,1
高雄市,鳳山區,1408,639,151,790,24,814,1649,49.36%,38.75%,1
高雄市,鳳山區,1409,625,175,800,93,893,1601,55.78%,39.04%,1
高雄市,鳳山區,1410,473,130,603,25,628,1155,54.37%,40.95%,1
高雄市,鳳山區,1411,457,121,578,62,640,1050,60.95%,43.52%,1
高雄市,鳳山區,1412,553,134,687,24,711,1417,50.18%,39.03%,1
高雄市,鳳山區,1413,656,164,820,63,883,1525,57.9%,43.02%,1
高雄市,鳳山區,1414,681,181,862,63,925,1514,61.1%,44.98%,1
高雄市,鳳山區,1415,547,107,654,49,703,1190,59.08%,45.97%,1
高雄市,鳳山區,1416,567,122,689,23,712,1325,53.74%,42.79%,1
高雄市,鳳山區,1417,472,122,594,60,654,1049,62.35%,45%,1
高雄市,鳳山區,1418,477,86,563,34,597,1026,58.19%,46.49%,1
高雄市,鳳山區,1419,498,168,666,54,720,1152,62.5%,43.23%,1
高雄市,鳳山區,1420,493,127,620,23,643,1254,51.28%,39.31%,1
高雄市,鳳山區,1421,597,171,768,106,874,1688,51.78%,35.37%,1
高雄市,鳳山區,1422,707,146,853,67,920,1657,55.52%,42.67%,1
高雄市,鳳山區,1423,811,54,865,43,908,1729,52.52%,46.91%,1
高雄市,鳳山區,1424,741,185,926,52,978,1628,60.07%,45.52%,1
高雄市,鳳山區,1425,732,177,909,19,928,1891,49.07%,38.71%,1
高雄市,鳳山區,1426,863,167,1030,55,1085,1594,68.07%,54.14%,1
高雄市,鳳山區,1427,674,144,818,19,837,1342,62.37%,50.22%,1
高雄市,鳳山區,1428,716,189,905,42,947,1448,65.4%,49.45%,1
高雄市,鳳山區,1429,632,167,799,69,868,1405,61.78%,44.98%,1
高雄市,鳳山區,1430,484,153,637,77,714,1097,65.09%,44.12%,1
高雄市,鳳山區,1431,531,199,730,87,817,1248,65.46%,42.55%,1
高雄市,鳳山區,1432,519,173,692,70,762,1225,62.2%,42.37%,1
高雄市,鳳山區,1433,487,149,636,37,673,1214,55.44%,40.12%,1
高雄市,鳳山區,1434,1052,134,1186,88,1274,2032,62.7%,51.77%,1
高雄市,鳳山區,1435,861,204,1065,80,1145,1927,59.42%,44.68%,1
高雄市,鳳山區,1436,991,234,1225,72,1297,2097,61.85%,47.26%,1
高雄市,鳳山區,1437,384,128,512,54,566,968,58.47%,39.67%,1
高雄市,鳳山區,1438,488,120,608,68,676,1200,56.33%,40.67%,1
高雄市,鳳山區,1439,459,143,602,68,670,1101,60.85%,41.69%,1
高雄市,鳳山區,1440,535,166,701,42,743,1369,54.27%,39.08%,1
高雄市,鳳山區,1441,643,189,832,76,908,1542,58.88%,41.7%,1
高雄市,鳳山區,1442,707,185,892,58,950,1536,61.85%,46.03%,1
高雄市,鳳山區,1443,521,167,688,30,718,1382,51.95%,37.7%,1
高雄市,鳳山區,1444,585,194,779,97,876,1452,60.33%,40.29%,1
高雄市,鳳山區,1445,468,107,575,52,627,1058,59.26%,44.23%,1
高雄市,鳳山區,1446,477,106,583,52,635,976,65.06%,48.87%,1
高雄市,鳳山區,1447,598,159,757,39,796,1545,51.52%,38.71%,1
高雄市,鳳山區,1448,465,155,620,53,673,1143,58.88%,40.68%,1
高雄市,鳳山區,1449,254,64,318,15,333,1301,25.6%,19.52%,1
高雄市,鳳山區,1450,426,135,561,27,588,1250,47.04%,34.08%,1
高雄市,鳳山區,1451,524,127,651,56,707,1208,58.53%,43.38%,1
高雄市,鳳山區,1452,523,126,649,91,740,1202,61.56%,43.51%,1
高雄市,鳳山區,1453,632,153,785,73,858,1499,57.24%,42.16%,1
高雄市,鳳山區,1454,633,164,797,51,848,1522,55.72%,41.59%,1
高雄市,鳳山區,1455,520,141,661,56,717,1125,63.73%,46.22%,1
高雄市,鳳山區,1456,581,141,722,40,762,1307,58.3%,44.45%,1
高雄市,鳳山區,1457,564,195,759,71,830,1405,59.07%,40.14%,1
高雄市,鳳山區,1458,541,147,688,72,760,1252,60.7%,43.21%,1
高雄市,鳳山區,1459,613,142,755,31,786,1291,60.88%,47.48%,1
高雄市,鳳山區,1460,419,104,523,69,592,938,63.11%,44.67%,1
高雄市,鳳山區,1461,753,231,984,52,1036,1783,58.1%,42.23%,1
高雄市,鳳山區,1462,519,105,624,37,661,1105,59.82%,46.97%,1
高雄市,鳳山區,1463,545,171,716,89,805,1392,57.83%,39.15%,1
高雄市,鳳山區,1464,624,165,789,41,830,1244,66.72%,50.16%,1
高雄市,鳳山區,1465,448,142,590,56,646,1154,55.98%,38.82%,1
高雄市,鳳山區,1466,490,147,637,62,699,1153,60.62%,42.5%,1
高雄市,鳳山區,1467,419,110,529,21,550,1148,47.91%,36.5%,1
高雄市,鳳山區,1468,555,150,705,121,826,1432,57.68%,38.76%,1
高雄市,鳳山區,1469,419,143,562,25,587,1429,41.08%,29.32%,1
高雄市,鳳山區,1470,627,155,782,27,809,1479,54.7%,42.39%,1
高雄市,鳳山區,1471,454,131,585,54,639,1026,62.28%,44.25%,1
高雄市,鳳山區,1472,429,156,585,90,675,993,67.98%,43.2%,1
高雄市,鳳山區,1473,433,108,541,70,611,947,64.52%,45.72%,1
高雄市,鳳山區,1474,447,86,533,66,599,1042,57.49%,42.9%,1
高雄市,鳳山區,1475,471,129,600,61,661,1098,60.2%,42.9%,1
高雄市,鳳山區,1476,488,138,626,23,649,1284,50.55%,38.01%,1
高雄市,鳳山區,1477,471,148,619,48,667,1242,53.7%,37.92%,1
高雄市,鳳山區,1478,482,130,612,77,689,1093,63.04%,44.1%,1
高雄市,鳳山區,1479,521,179,700,48,748,1353,55.28%,38.51%,1
高雄市,鳳山區,1480,525,144,669,26,695,1353,51.37%,38.8%,1
高雄市,鳳山區,1481,572,163,735,65,800,1309,61.12%,43.7%,1
高雄市,鳳山區,1482,707,178,885,55,940,1627,57.78%,43.45%,1
高雄市,鳳山區,1483,589,158,747,88,835,1372,60.86%,42.93%,1
高雄市,林園區,1773,532,141,673,87,760,1262,60.22%,42.16%,1
高雄市,林園區,1774,568,183,751,68,819,1562,52.43%,36.36%,1
高雄市,林園區,1775,460,106,566,30,596,1078,55.29%,42.67%,1
高雄市,林園區,1776,438,129,567,59,626,979,63.94%,44.74%,1
高雄市,林園區,1777,492,134,626,50,676,1195,56.57%,41.17%,1
高雄市,林園區,1778,529,160,689,65,754,1380,54.64%,38.33%,1
高雄市,林園區,1779,495,156,651,74,725,1280,56.64%,38.67%,1
高雄市,林園區,1780,480,150,630,24,654,1269,51.54%,37.83%,1
高雄市,林園區,1781,510,137,647,19,666,1568,42.47%,32.53%,1
高雄市,林園區,1782,537,78,615,68,683,1226,55.71%,43.8%,1
高雄市,林園區,1783,601,131,732,58,790,1480,53.38%,40.61%,1
高雄市,林園區,1784,635,168,803,54,857,1459,58.74%,43.52%,1
高雄市,林園區,1785,608,159,767,43,810,1593,50.85%,38.17%,1
高雄市,林園區,1786,360,100,460,74,534,895,59.66%,40.22%,1
高雄市,林園區,1787,421,121,542,34,576,1110,51.89%,37.93%,1
高雄市,林園區,1788,510,150,660,65,725,1348,53.78%,37.83%,1
高雄市,林園區,1789,380,115,495,55,550,912,60.31%,41.67%,1
高雄市,林園區,1790,488,145,633,69,702,1085,64.7%,44.98%,1
高雄市,林園區,1791,385,91,476,30,506,955,52.98%,40.31%,1
高雄市,林園區,1792,396,92,488,55,543,879,61.77%,45.05%,1
高雄市,林園區,1793,459,114,573,66,639,1103,57.93%,41.61%,1
高雄市,林園區,1794,489,127,616,73,689,1054,65.37%,46.39%,1
高雄市,林園區,1795,443,122,565,24,589,1292,45.59%,34.29%,1
高雄市,林園區,1796,586,135,721,25,746,1683,44.33%,34.82%,1
高雄市,林園區,1797,260,54,314,36,350,607,57.66%,42.83%,1
高雄市,林園區,1798,394,129,523,69,592,1012,58.5%,38.93%,1
高雄市,林園區,1799,460,105,565,51,616,1046,58.89%,43.98%,1
高雄市,林園區,1800,329,70,399,18,417,914,45.62%,36%,1
高雄市,林園區,1801,599,148,747,69,816,1405,58.08%,42.63%,1
高雄市,林園區,1802,560,161,721,67,788,1299,60.66%,43.11%,1
高雄市,林園區,1803,513,77,590,31,621,1170,53.08%,43.85%,1
高雄市,林園區,1804,422,136,558,36,594,1299,45.73%,32.49%,1
高雄市,林園區,1805,411,127,538,43,581,1031,56.35%,39.86%,1
高雄市,林園區,1806,316,100,416,15,431,849,50.77%,37.22%,1
高雄市,林園區,1807,278,111,389,64,453,838,54.06%,33.17%,1
高雄市,林園區,1808,395,93,488,28,516,938,55.01%,42.11%,1
高雄市,林園區,1809,388,75,463,43,506,1051,48.14%,36.92%,1
高雄市,林園區,1810,328,97,425,53,478,786,60.81%,41.73%,1
高雄市,林園區,1811,384,100,484,74,558,894,62.42%,42.95%,1
高雄市,林園區,1812,220,42,262,15,277,749,36.98%,29.37%,1
高雄市,林園區,1813,650,171,821,41,862,1485,58.05%,43.77%,1
高雄市,林園區,1814,615,212,827,89,916,1478,61.98%,41.61%,1
高雄市,林園區,1815,615,150,765,90,855,1345,63.57%,45.72%,1
高雄市,林園區,1816,384,129,513,62,575,1038,55.39%,36.99%,1
高雄市,林園區,1817,503,158,661,33,694,1203,57.69%,41.81%,1
高雄市,林園區,1818,459,133,592,24,616,1138,54.13%,40.33%,1
高雄市,林園區,1819,398,87,485,19,504,1025,49.17%,38.83%,1
高雄市,林園區,1820,568,141,709,77,786,1341,58.61%,42.36%,1
高雄市,林園區,1821,417,103,520,24,544,1218,44.66%,34.24%,1
高雄市,林園區,1822,357,96,453,22,475,1147,41.41%,31.12%,1
高雄市,林園區,1823,369,100,469,18,487,1176,41.41%,31.38%,1
高雄市,大寮區,1692,248,73,321,30,351,727,48.28%,34.11%,1
高雄市,大寮區,1693,237,78,315,18,333,718,46.38%,33.01%,1
高雄市,大寮區,1694,496,119,615,43,658,1340,49.1%,37.01%,1
高雄市,大寮區,1695,538,155,693,46,739,1575,46.92%,34.16%,1
高雄市,大寮區,1696,187,49,236,26,262,444,59.01%,42.12%,1
高雄市,大寮區,1697,819,187,1006,50,1056,2374,44.48%,34.5%,1
高雄市,大寮區,1698,515,135,650,72,722,1291,55.93%,39.89%,1
高雄市,大寮區,1699,579,157,736,70,806,1400,57.57%,41.36%,1
高雄市,大寮區,1700,552,155,707,31,738,1390,53.09%,39.71%,1
高雄市,大寮區,1701,539,168,707,74,781,1401,55.75%,38.47%,1
高雄市,大寮區,1702,453,126,579,30,609,1199,50.79%,37.78%,1
高雄市,大寮區,1703,422,130,552,29,581,1210,48.02%,34.88%,1
高雄市,大寮區,1704,479,142,621,43,664,1195,55.56%,40.08%,1
高雄市,大寮區,1705,452,105,557,23,580,1166,49.74%,38.77%,1
高雄市,大寮區,1706,539,160,699,44,743,1353,54.92%,39.84%,1
高雄市,大寮區,1707,450,127,577,67,644,1052,61.22%,42.78%,1
高雄市,大寮區,1708,333,97,430,24,454,1024,44.34%,32.52%,1
高雄市,大寮區,1709,472,151,623,31,654,1189,55%,39.7%,1
高雄市,大寮區,1710,665,166,831,85,916,1512,60.58%,43.98%,1
高雄市,大寮區,1711,633,172,805,69,874,1633,53.52%,38.76%,1
高雄市,大寮區,1712,533,146,679,39,718,1214,59.14%,43.9%,1
高雄市,大寮區,1713,573,148,721,81,802,1258,63.75%,45.55%,1
高雄市,大寮區,1714,545,178,723,25,748,1323,56.54%,41.19%,1
高雄市,大寮區,1715,595,112,707,49,756,1253,60.34%,47.49%,1
高雄市,大寮區,1716,479,110,589,54,643,1035,62.13%,46.28%,1
高雄市,大寮區,1717,447,126,573,29,602,1106,54.43%,40.42%,1
高雄市,大寮區,1718,506,138,644,40,684,1195,57.24%,42.34%,1
高雄市,大寮區,1719,440,113,553,35,588,1051,55.95%,41.86%,1
高雄市,大寮區,1720,611,157,768,83,851,1425,59.72%,42.88%,1
高雄市,大寮區,1721,655,196,851,58,909,1635,55.6%,40.06%,1
高雄市,大寮區,1722,564,184,748,58,806,1359,59.31%,41.5%,1
高雄市,大寮區,1723,614,134,748,56,804,1361,59.07%,45.11%,1
高雄市,大寮區,1724,699,176,875,42,917,1629,56.29%,42.91%,1
高雄市,大寮區,1725,661,169,830,49,879,1518,57.91%,43.54%,1
高雄市,大寮區,1726,654,163,817,74,891,1620,55%,40.37%,1
高雄市,大寮區,1727,658,174,832,27,859,1648,52.12%,39.93%,1
高雄市,大寮區,1728,595,139,734,55,789,1385,56.97%,42.96%,1
高雄市,大寮區,1729,569,159,728,27,755,1435,52.61%,39.65%,1
高雄市,大寮區,1730,405,138,543,22,565,1046,54.02%,38.72%,1
高雄市,大寮區,1731,280,104,384,33,417,789,52.85%,35.49%,1
高雄市,大寮區,1732,361,101,462,30,492,909,54.13%,39.71%,1
高雄市,大寮區,1733,304,101,405,28,433,733,59.07%,41.47%,1
高雄市,大寮區,1734,595,169,764,73,837,1553,53.9%,38.31%,1
高雄市,大寮區,1735,382,87,469,29,498,922,54.01%,41.43%,1
高雄市,大寮區,1736,398,116,514,72,586,1012,57.91%,39.33%,1
高雄市,大寮區,1737,373,104,477,65,542,968,55.99%,38.53%,1
高雄市,大寮區,1738,390,114,504,47,551,1021,53.97%,38.2%,1
高雄市,大寮區,1739,532,139,671,76,747,1554,48.07%,34.23%,1
高雄市,大寮區,1740,487,148,635,52,687,1120,61.34%,43.48%,1
高雄市,大寮區,1741,661,43,704,61,765,1225,62.45%,53.96%,1
高雄市,大寮區,1742,381,104,485,27,512,1320,38.79%,28.86%,1
高雄市,大寮區,1743,548,142,690,51,741,1317,56.26%,41.61%,1
高雄市,大寮區,1744,452,121,573,24,597,1119,53.35%,40.39%,1
高雄市,大寮區,1745,539,134,673,48,721,1190,60.59%,45.29%,1
高雄市,大寮區,1746,559,145,704,51,755,1229,61.43%,45.48%,1
高雄市,大寮區,1747,572,135,707,47,754,1178,64.01%,48.56%,1
高雄市,大寮區,1748,614,150,764,28,792,1272,62.26%,48.27%,1
高雄市,大寮區,1749,599,149,748,20,768,1413,54.35%,42.39%,1
高雄市,大寮區,1750,555,135,690,49,739,1185,62.36%,46.84%,1
高雄市,大寮區,1751,248,46,294,6,300,553,54.25%,44.85%,1
高雄市,大寮區,1752,432,117,549,75,624,1121,55.66%,38.54%,1
高雄市,大寮區,1753,529,129,658,26,684,1227,55.75%,43.11%,1
高雄市,大寮區,1754,508,139,647,70,717,1058,67.77%,48.02%,1
高雄市,大寮區,1755,511,149,660,35,695,1209,57.49%,42.27%,1
高雄市,大寮區,1756,487,120,607,23,630,1100,57.27%,44.27%,1
高雄市,大寮區,1757,440,119,559,27,586,1122,52.23%,39.22%,1
高雄市,大寮區,1758,432,136,568,75,643,983,65.41%,43.95%,1
高雄市,大寮區,1759,449,128,577,23,600,1192,50.34%,37.67%,1
高雄市,大寮區,1760,281,70,351,35,386,719,53.69%,39.08%,1
高雄市,大寮區,1761,352,91,443,42,485,829,58.5%,42.46%,1
高雄市,大寮區,1762,365,94,459,74,533,771,69.13%,47.34%,1
高雄市,大寮區,1763,446,142,588,94,682,1075,63.44%,41.49%,1
高雄市,大寮區,1764,542,155,697,83,780,1280,60.94%,42.34%,1
高雄市,大寮區,1765,471,148,619,73,692,1179,58.69%,39.95%,1
高雄市,大寮區,1766,472,129,601,27,628,1210,51.9%,39.01%,1
高雄市,大寮區,1767,91,17,108,8,116,189,61.38%,48.15%,1
高雄市,大寮區,1768,551,138,689,63,752,1228,61.24%,44.87%,1
高雄市,大寮區,1769,528,109,637,41,678,1170,57.95%,45.13%,1
高雄市,大寮區,1770,680,137,817,56,873,1416,61.65%,48.02%,1
高雄市,大寮區,1771,810,51,861,100,961,1482,64.84%,54.66%,1
高雄市,大寮區,1772,641,121,762,58,820,1478,55.48%,43.37%,1
高雄市,大樹區,0736,551,169,720,23,743,1386,53.61%,39.75%,1
高雄市,大樹區,0737,664,152,816,21,837,1315,63.65%,50.49%,1
高雄市,大樹區,0738,993,251,1244,72,1316,2461,53.47%,40.35%,1
高雄市,大樹區,0739,511,125,636,32,668,1274,52.43%,40.11%,1
高雄市,大樹區,0740,533,120,653,61,714,1265,56.44%,42.13%,1
高雄市,大樹區,0741,610,156,766,67,833,1504,55.39%,40.56%,1
高雄市,大樹區,0742,372,121,493,20,513,1049,48.9%,35.46%,1
高雄市,大樹區,0743,620,140,760,69,829,1573,52.7%,39.42%,1
高雄市,大樹區,0744,412,79,491,31,522,1121,46.57%,36.75%,1
高雄市,大樹區,0745,504,145,649,51,700,1207,58%,41.76%,1
高雄市,大樹區,0746,444,124,568,23,591,1134,52.12%,39.15%,1
高雄市,大樹區,0747,461,151,612,41,653,1124,58.1%,41.01%,1
高雄市,大樹區,0748,496,131,627,90,717,1259,56.95%,39.4%,1
高雄市,大樹區,0749,502,131,633,68,701,1105,63.44%,45.43%,1
高雄市,大樹區,0750,457,128,585,59,644,1128,57.09%,40.51%,1
高雄市,大樹區,0751,394,113,507,89,596,1079,55.24%,36.52%,1
高雄市,大樹區,0752,376,93,469,38,507,1025,49.46%,36.68%,1
高雄市,大樹區,0753,379,96,475,55,530,950,55.79%,39.89%,1
高雄市,大樹區,0754,542,177,719,93,812,1433,56.66%,37.82%,1
高雄市,大樹區,0755,284,71,355,21,376,794,47.36%,35.77%,1
高雄市,大樹區,0756,206,73,279,12,291,781,37.26%,26.38%,1
高雄市,大樹區,0757,442,139,581,21,602,1318,45.68%,33.54%,1
高雄市,大樹區,0758,290,72,362,42,404,736,54.89%,39.4%,1
高雄市,大樹區,0759,341,114,455,23,478,1047,45.65%,32.57%,1
高雄市,大樹區,0760,520,153,673,75,748,1271,58.85%,40.91%,1
高雄市,大樹區,0761,404,123,527,30,557,1186,46.96%,34.06%,1
高雄市,大樹區,0762,415,112,527,46,573,1007,56.9%,41.21%,1
高雄市,大樹區,0763,363,92,455,57,512,859,59.6%,42.26%,1
高雄市,大樹區,0764,271,46,317,16,333,735,45.31%,36.87%,1
高雄市,大樹區,0765,451,115,566,72,638,1046,60.99%,43.12%,1
高雄市,大樹區,0766,553,56,609,42,651,880,73.98%,62.84%,1
高雄市,大樹區,0767,273,66,339,20,359,720,49.86%,37.92%,1
高雄市,大社區,0637,353,106,459,73,532,950,56%,37.16%,1
高雄市,大社區,0638,484,128,612,45,657,1306,50.31%,37.06%,1
高雄市,大社區,0639,648,140,788,35,823,1856,44.34%,34.91%,1
高雄市,大社區,0640,148,423,571,63,634,986,64.3%,15.01%,1
高雄市,大社區,0641,401,114,515,58,573,1116,51.34%,35.93%,1
高雄市,大社區,0642,543,191,734,72,806,1253,64.33%,43.34%,1
高雄市,大社區,0643,479,201,680,48,728,1613,45.13%,29.7%,1
高雄市,大社區,0644,551,174,725,48,773,1455,53.13%,37.87%,1
高雄市,大社區,0645,688,242,930,47,977,1674,58.36%,41.1%,1
高雄市,大社區,0646,444,97,541,66,607,1004,60.46%,44.22%,1
高雄市,大社區,0647,360,105,465,34,499,879,56.77%,40.96%,1
高雄市,大社區,0648,268,124,392,14,406,778,52.19%,34.45%,1
高雄市,大社區,0649,475,138,613,62,675,1110,60.81%,42.79%,1
高雄市,大社區,0650,577,166,743,53,796,1432,55.59%,40.29%,1
高雄市,大社區,0651,632,168,800,49,849,1466,57.91%,43.11%,1
高雄市,大社區,0652,599,222,821,89,910,1383,65.8%,43.31%,1
高雄市,大社區,0653,726,177,903,78,981,1645,59.64%,44.13%,1
高雄市,大社區,0654,556,182,738,45,783,1555,50.35%,35.76%,1
高雄市,大社區,0655,712,218,930,82,1012,1750,57.83%,40.69%,1
高雄市,大社區,0656,467,129,596,55,651,1111,58.6%,42.03%,1
高雄市,大社區,0657,492,136,628,69,697,1133,61.52%,43.42%,1
高雄市,大社區,0658,401,100,501,36,537,912,58.88%,43.97%,1
高雄市,大社區,0659,246,73,319,17,336,745,45.1%,33.02%,1
高雄市,大社區,0660,394,113,507,33,540,934,57.82%,42.18%,1
高雄市,仁武區,0661,832,218,1050,51,1101,1777,61.96%,46.82%,1
高雄市,仁武區,0662,1036,270,1306,69,1375,2273,60.49%,45.58%,1
高雄市,仁武區,0663,662,172,834,80,914,1384,66.04%,47.83%,1
高雄市,仁武區,0664,494,137,631,58,689,1170,58.89%,42.22%,1
高雄市,仁武區,0665,585,170,755,60,815,1216,67.02%,48.11%,1
高雄市,仁武區,0666,700,164,864,22,886,1598,55.44%,43.8%,1
高雄市,仁武區,0667,1066,219,1285,42,1327,2143,61.92%,49.74%,1
高雄市,仁武區,0668,545,145,690,58,748,1300,57.54%,41.92%,1
高雄市,仁武區,0669,573,164,737,74,811,1338,60.61%,42.83%,1
高雄市,仁武區,0670,464,149,613,21,634,1217,52.1%,38.13%,1
高雄市,仁武區,0671,424,121,545,71,616,1202,51.25%,35.27%,1
高雄市,仁武區,0672,537,136,673,42,715,1404,50.93%,38.25%,1
高雄市,仁武區,0673,328,102,430,50,480,830,57.83%,39.52%,1
高雄市,仁武區,0674,566,168,734,39,773,1802,42.9%,31.41%,1
高雄市,仁武區,0675,768,151,919,67,986,1877,52.53%,40.92%,1
高雄市,仁武區,0676,628,157,785,41,826,1738,47.53%,36.13%,1
高雄市,仁武區,0677,640,163,803,53,856,1549,55.26%,41.32%,1
高雄市,仁武區,0678,685,189,874,52,926,1579,58.64%,43.38%,1
高雄市,仁武區,0679,584,127,711,32,743,1406,52.84%,41.54%,1
高雄市,仁武區,0680,661,130,791,30,821,1461,56.19%,45.24%,1
高雄市,仁武區,0681,588,180,768,52,820,1311,62.55%,44.85%,1
高雄市,仁武區,0682,587,132,719,30,749,1373,54.55%,42.75%,1
高雄市,仁武區,0683,333,134,467,20,487,1035,47.05%,32.17%,1
高雄市,仁武區,0684,436,154,590,39,629,1181,53.26%,36.92%,1
高雄市,仁武區,0685,685,165,850,45,895,1670,53.59%,41.02%,1
高雄市,仁武區,0686,634,186,820,31,851,1576,54%,40.23%,1
高雄市,仁武區,0687,739,171,910,66,976,1576,61.93%,46.89%,1
高雄市,仁武區,0688,904,218,1122,46,1168,1915,60.99%,47.21%,1
高雄市,仁武區,0689,761,157,918,25,943,1758,53.64%,43.29%,1
高雄市,仁武區,0690,929,202,1131,62,1193,1892,63.05%,49.1%,1
高雄市,仁武區,0691,934,221,1155,69,1224,2025,60.44%,46.12%,1
高雄市,仁武區,0692,975,204,1179,60,1239,2014,61.52%,48.41%,1
高雄市,仁武區,0693,750,189,939,59,998,1473,67.75%,50.92%,1
高雄市,仁武區,0694,378,98,476,36,512,979,52.3%,38.61%,1
高雄市,仁武區,0695,406,97,503,23,526,944,55.72%,43.01%,1
高雄市,仁武區,0696,490,128,618,82,700,1153,60.71%,42.5%,1
高雄市,仁武區,0697,528,133,661,41,702,1328,52.86%,39.76%,1
高雄市,仁武區,0698,688,229,917,73,990,1657,59.75%,41.52%,1
高雄市,仁武區,0699,605,140,745,72,817,1545,52.88%,39.16%,1
高雄市,仁武區,0700,635,180,815,56,871,1417,61.47%,44.81%,1
高雄市,仁武區,0701,776,206,982,43,1025,1602,63.98%,48.44%,1
高雄市,仁武區,0702,861,231,1092,76,1168,1823,64.07%,47.23%,1
高雄市,仁武區,0703,805,232,1037,35,1072,1914,56.01%,42.06%,1
高雄市,仁武區,0704,875,203,1078,52,1130,1992,56.73%,43.93%,1
高雄市,仁武區,0705,818,201,1019,49,1068,2045,52.22%,40%,1
高雄市,仁武區,0706,912,234,1146,63,1209,1982,61%,46.01%,1
高雄市,仁武區,0707,855,250,1105,58,1163,2167,53.67%,39.46%,1
高雄市,鳥松區,0708,694,235,929,63,992,1678,59.12%,41.36%,1
高雄市,鳥松區,0709,663,186,849,65,914,1682,54.34%,39.42%,1
高雄市,鳥松區,0710,533,161,694,49,743,1225,60.65%,43.51%,1
高雄市,鳥松區,0711,516,153,669,62,731,1322,55.3%,39.03%,1
高雄市,鳥松區,0712,534,145,679,58,737,1215,60.66%,43.95%,1
高雄市,鳥松區,0713,687,217,904,48,952,1779,53.51%,38.62%,1
高雄市,鳥松區,0714,525,188,713,17,730,1129,64.66%,46.5%,1
高雄市,鳥松區,0715,624,170,794,62,856,1374,62.3%,45.41%,1
高雄市,鳥松區,0716,411,179,590,33,623,1089,57.21%,37.74%,1
高雄市,鳥松區,0717,971,315,1286,71,1357,2219,61.15%,43.76%,1
高雄市,鳥松區,0718,679,214,893,33,926,1634,56.67%,41.55%,1
高雄市,鳥松區,0719,746,175,921,65,986,1553,63.49%,48.04%,1
高雄市,鳥松區,0720,725,222,947,48,995,1572,63.3%,46.12%,1
高雄市,鳥松區,0721,772,242,1014,45,1059,1688,62.74%,45.73%,1
高雄市,鳥松區,0722,690,257,947,38,985,1626,60.58%,42.44%,1
高雄市,鳥松區,0723,817,222,1039,72,1111,1744,63.7%,46.85%,1
高雄市,鳥松區,0724,492,135,627,57,684,1230,55.61%,40%,1
高雄市,鳥松區,0725,538,141,679,95,774,1201,64.45%,44.8%,1
高雄市,鳥松區,0726,524,143,667,48,715,1117,64.01%,46.91%,1
高雄市,鳥松區,0727,516,138,654,61,715,1255,56.97%,41.12%,1
高雄市,鳥松區,0728,545,149,694,41,735,1432,51.33%,38.06%,1
高雄市,鳥松區,0729,521,154,675,29,704,1370,51.39%,38.03%,1
高雄市,鳥松區,0730,653,146,799,54,853,1364,62.54%,47.87%,1
高雄市,鳥松區,0731,464,128,592,57,649,1041,62.34%,44.57%,1
高雄市,鳥松區,0732,366,103,469,38,507,702,72.22%,52.14%,1
高雄市,鳥松區,0733,499,159,658,73,731,1212,60.31%,41.17%,1
高雄市,鳥松區,0734,572,128,700,52,752,1289,58.34%,44.38%,1
高雄市,鳥松區,0735,703,191,894,33,927,1449,63.98%,48.52%,1
高雄市,岡山區,0261,671,158,829,44,873,1345,64.91%,49.89%,1
高雄市,岡山區,0262,334,109,443,21,464,1045,44.4%,31.96%,1
高雄市,岡山區,0263,494,99,593,46,639,1051,60.8%,47%,1
高雄市,岡山區,0264,426,96,522,19,541,917,59%,46.46%,1
高雄市,岡山區,0265,435,133,568,34,602,934,64.45%,46.57%,1
高雄市,岡山區,0266,501,134,635,53,688,1097,62.72%,45.67%,1
高雄市,岡山區,0267,617,144,761,41,802,1208,66.39%,51.08%,1
高雄市,岡山區,0268,521,168,689,75,764,1159,65.92%,44.95%,1
高雄市,岡山區,0269,436,133,569,54,623,1018,61.2%,42.83%,1
高雄市,岡山區,0270,480,132,612,39,651,1316,49.47%,36.47%,1
高雄市,岡山區,0271,607,138,745,32,777,1345,57.77%,45.13%,1
高雄市,岡山區,0272,588,169,757,49,806,1295,62.24%,45.41%,1
高雄市,岡山區,0273,624,160,784,57,841,1425,59.02%,43.79%,1
高雄市,岡山區,0274,551,116,667,41,708,1328,53.31%,41.49%,1
高雄市,岡山區,0275,619,155,774,25,799,1382,57.81%,44.79%,1
高雄市,岡山區,0276,673,132,805,23,828,1381,59.96%,48.73%,1
高雄市,岡山區,0277,546,145,691,72,763,1282,59.52%,42.59%,1
高雄市,岡山區,0278,511,156,667,22,689,1240,55.56%,41.21%,1
高雄市,岡山區,0279,617,117,734,60,794,1327,59.83%,46.5%,1
高雄市,岡山區,0280,751,157,908,55,963,1736,55.47%,43.26%,1
高雄市,岡山區,0281,680,201,881,69,950,1566,60.66%,43.42%,1
高雄市,岡山區,0282,776,156,932,29,961,1779,54.02%,43.62%,1
高雄市,岡山區,0283,737,189,926,64,990,1593,62.15%,46.26%,1
高雄市,岡山區,0284,680,176,856,61,917,1480,61.96%,45.95%,1
高雄市,岡山區,0285,611,164,775,35,810,1364,59.38%,44.79%,1
高雄市,岡山區,0286,641,175,816,47,863,1410,61.21%,45.46%,1
高雄市,岡山區,0287,560,167,727,61,788,1148,68.64%,48.78%,1
高雄市,岡山區,0288,273,85,358,47,405,625,64.8%,43.68%,1
高雄市,岡山區,0289,454,102,556,39,595,969,61.4%,46.85%,1
高雄市,岡山區,0290,393,117,510,17,527,861,61.21%,45.64%,1
高雄市,岡山區,0291,330,83,413,17,430,823,52.25%,40.1%,1
高雄市,岡山區,0292,407,130,537,58,595,889,66.93%,45.78%,1
高雄市,岡山區,0293,565,155,720,56,776,1283,60.48%,44.04%,1
高雄市,岡山區,0294,638,143,781,44,825,1512,54.56%,42.2%,1
高雄市,岡山區,0295,477,137,614,58,672,983,68.36%,48.52%,1
高雄市,岡山區,0296,567,134,701,49,750,1262,59.43%,44.93%,1
高雄市,岡山區,0297,481,137,618,60,678,1096,61.86%,43.89%,1
高雄市,岡山區,0298,477,127,604,43,647,1066,60.69%,44.75%,1
高雄市,岡山區,0299,516,111,627,38,665,1188,55.98%,43.43%,1
高雄市,岡山區,0300,622,160,782,59,841,1360,61.84%,45.74%,1
高雄市,岡山區,0301,632,162,794,33,827,1363,60.67%,46.37%,1
高雄市,岡山區,0302,656,163,819,56,875,1352,64.72%,48.52%,1
高雄市,岡山區,0303,649,160,809,60,869,1460,59.52%,44.45%,1
高雄市,岡山區,0304,582,145,727,50,777,1272,61.08%,45.75%,1
高雄市,岡山區,0305,520,130,650,49,699,1080,64.72%,48.15%,1
高雄市,岡山區,0306,553,152,705,74,779,1255,62.07%,44.06%,1
高雄市,岡山區,0307,456,124,580,49,629,938,67.06%,48.61%,1
高雄市,岡山區,0308,613,134,747,47,794,1237,64.19%,49.56%,1
高雄市,岡山區,0309,516,156,672,33,705,1413,49.89%,36.52%,1
高雄市,岡山區,0310,321,96,417,18,435,765,56.86%,41.96%,1
高雄市,岡山區,0311,501,142,643,34,677,1043,64.91%,48.03%,1
高雄市,岡山區,0312,329,68,397,30,427,844,50.59%,38.98%,1
高雄市,岡山區,0313,532,163,695,33,728,993,73.31%,53.58%,1
高雄市,岡山區,0314,471,129,600,70,670,1038,64.55%,45.38%,1
高雄市,岡山區,0315,446,143,589,69,658,1070,61.5%,41.68%,1
高雄市,岡山區,0316,571,40,611,70,681,1023,66.57%,55.82%,1
高雄市,岡山區,0317,571,164,735,30,765,1349,56.71%,42.33%,1
高雄市,岡山區,0318,591,155,746,41,787,1452,54.2%,40.7%,1
高雄市,岡山區,0319,142,48,190,14,204,301,67.77%,47.18%,1
高雄市,岡山區,0320,330,102,432,80,512,756,67.72%,43.65%,1
高雄市,岡山區,0321,255,78,333,14,347,733,47.34%,34.79%,1
高雄市,岡山區,0322,409,110,519,72,591,854,69.2%,47.89%,1
高雄市,岡山區,0323,289,69,358,19,377,866,43.53%,33.37%,1
高雄市,岡山區,0324,396,109,505,59,564,978,57.67%,40.49%,1
高雄市,岡山區,0325,679,104,783,36,819,1336,61.3%,50.82%,1
高雄市,岡山區,0326,672,71,743,19,762,1218,62.56%,55.17%,1
高雄市,岡山區,0327,187,54,241,17,258,341,75.66%,54.84%,1
高雄市,岡山區,0328,635,53,688,26,714,955,74.76%,66.49%,1
高雄市,岡山區,0329,573,58,631,18,649,940,69.04%,60.96%,1
高雄市,岡山區,0330,421,111,532,43,575,851,67.57%,49.47%,1
高雄市,岡山區,0331,446,65,511,23,534,762,70.08%,58.53%,1
高雄市,岡山區,0332,177,51,228,13,241,318,75.79%,55.66%,1
高雄市,橋頭區,0404,458,141,599,69,668,1005,66.47%,45.57%,1
高雄市,橋頭區,0405,478,149,627,51,678,1073,63.19%,44.55%,1
高雄市,橋頭區,0406,479,129,608,37,645,1129,57.13%,42.43%,1
高雄市,橋頭區,0407,536,167,703,78,781,1244,62.78%,43.09%,1
高雄市,橋頭區,0408,457,125,582,37,619,1091,56.74%,41.89%,1
高雄市,橋頭區,0409,647,160,807,52,859,1329,64.64%,48.68%,1
高雄市,橋頭區,0410,499,166,665,42,707,1140,62.02%,43.77%,1
高雄市,橋頭區,0411,503,180,683,72,755,1220,61.89%,41.23%,1
高雄市,橋頭區,0412,493,158,651,59,710,1047,67.81%,47.09%,1
高雄市,橋頭區,0413,520,168,688,96,784,1315,59.62%,39.54%,1
高雄市,橋頭區,0414,261,91,352,34,386,691,55.86%,37.77%,1
高雄市,橋頭區,0415,310,102,412,65,477,720,66.25%,43.06%,1
高雄市,橋頭區,0416,521,157,678,67,745,1192,62.5%,43.71%,1
高雄市,橋頭區,0417,599,184,783,53,836,1318,63.43%,45.45%,1
高雄市,橋頭區,0418,359,85,444,47,491,761,64.52%,47.17%,1
高雄市,橋頭區,0419,421,111,532,24,556,973,57.14%,43.27%,1
高雄市,橋頭區,0420,262,70,332,30,362,587,61.67%,44.63%,1
高雄市,橋頭區,0421,364,120,484,43,527,812,64.9%,44.83%,1
高雄市,橋頭區,0422,150,51,201,13,214,343,62.39%,43.73%,1
高雄市,橋頭區,0423,640,141,781,30,811,1266,64.06%,50.55%,1
高雄市,橋頭區,0424,515,138,653,86,739,1128,65.51%,45.66%,1
高雄市,橋頭區,0425,401,101,502,61,563,884,63.69%,45.36%,1
高雄市,橋頭區,0426,498,122,620,70,690,1187,58.13%,41.95%,1
高雄市,橋頭區,0427,549,155,704,74,778,1259,61.8%,43.61%,1
高雄市,橋頭區,0428,524,153,677,74,751,1361,55.18%,38.5%,1
高雄市,橋頭區,0429,249,74,323,29,352,671,52.46%,37.11%,1
高雄市,橋頭區,0430,549,158,707,69,776,1215,63.87%,45.19%,1
高雄市,橋頭區,0431,511,192,703,102,805,1255,64.14%,40.72%,1
高雄市,橋頭區,0432,574,158,732,58,790,1219,64.81%,47.09%,1
高雄市,橋頭區,0433,562,150,712,36,748,1372,54.52%,40.96%,1
高雄市,橋頭區,0434,223,67,290,11,301,758,39.71%,29.42%,1
高雄市,燕巢區,0333,465,115,580,76,656,1152,56.94%,40.36%,1
高雄市,燕巢區,0334,478,133,611,22,633,1120,56.52%,42.68%,1
高雄市,燕巢區,0335,448,136,584,56,640,974,65.71%,46%,1
高雄市,燕巢區,0336,398,115,513,20,533,1019,52.31%,39.06%,1
高雄市,燕巢區,0337,393,131,524,72,596,1058,56.33%,37.15%,1
高雄市,燕巢區,0338,312,83,395,35,430,1017,42.28%,30.68%,1
高雄市,燕巢區,0339,35,5,40,1,41,259,15.83%,13.51%,1
高雄市,燕巢區,0340,456,96,552,62,614,926,66.31%,49.24%,1
高雄市,燕巢區,0341,236,54,290,19,309,624,49.52%,37.82%,1
高雄市,燕巢區,0342,518,140,658,59,717,1102,65.06%,47.01%,1
高雄市,燕巢區,0343,426,107,533,45,578,1072,53.92%,39.74%,1
高雄市,燕巢區,0344,552,162,714,59,773,1361,56.8%,40.56%,1
高雄市,燕巢區,0345,212,43,255,32,287,472,60.81%,44.92%,1
高雄市,燕巢區,0346,445,130,575,53,628,1197,52.46%,37.18%,1
高雄市,燕巢區,0347,522,136,658,81,739,1134,65.17%,46.03%,1
高雄市,燕巢區,0348,439,124,563,42,605,1148,52.7%,38.24%,1
高雄市,燕巢區,0349,495,95,590,65,655,1207,54.27%,41.01%,1
高雄市,燕巢區,0350,667,165,832,42,874,1402,62.34%,47.57%,1
高雄市,燕巢區,0351,422,114,536,71,607,1000,60.7%,42.2%,1
高雄市,燕巢區,0352,487,125,612,69,681,1110,61.35%,43.87%,1
高雄市,燕巢區,0353,560,122,682,60,742,1291,57.47%,43.38%,1
高雄市,燕巢區,0354,318,92,410,76,486,797,60.98%,39.9%,1
高雄市,燕巢區,0355,394,116,510,56,566,1098,51.55%,35.88%,1
高雄市,燕巢區,0356,538,146,684,67,751,1393,53.91%,38.62%,1
高雄市,燕巢區,0357,367,74,441,19,460,1079,42.63%,34.01%,1
高雄市,田寮區,0237,111,25,136,5,141,369,38.21%,30.08%,1
高雄市,田寮區,0238,193,55,248,21,269,656,41.01%,29.42%,1
高雄市,田寮區,0239,89,17,106,10,116,406,28.57%,21.92%,1
高雄市,田寮區,0240,125,46,171,17,188,380,49.47%,32.89%,1
高雄市,田寮區,0241,136,37,173,19,192,379,50.66%,35.88%,1
高雄市,田寮區,0242,224,69,293,56,349,625,55.84%,35.84%,1
高雄市,田寮區,0243,335,77,412,20,432,946,45.67%,35.41%,1
高雄市,田寮區,0244,250,74,324,50,374,794,47.1%,31.49%,1
高雄市,田寮區,0245,111,35,146,22,168,382,43.98%,29.06%,1
高雄市,田寮區,0246,110,49,159,40,199,513,38.79%,21.44%,1
高雄市,田寮區,0247,200,70,270,21,291,601,48.42%,33.28%,1
高雄市,田寮區,0248,235,67,302,59,361,620,58.23%,37.9%,1
高雄市,阿蓮區,0216,406,150,556,41,597,1299,45.96%,31.25%,1
高雄市,阿蓮區,0217,420,117,537,41,578,1107,52.21%,37.94%,1
高雄市,阿蓮區,0218,312,94,406,31,437,898,48.66%,34.74%,1
高雄市,阿蓮區,0219,452,142,594,80,674,1259,53.53%,35.9%,1
高雄市,阿蓮區,0220,608,148,756,47,803,1579,50.85%,38.51%,1
高雄市,阿蓮區,0221,242,68,310,5,315,564,55.85%,42.91%,1
高雄市,阿蓮區,0222,354,97,451,45,496,768,64.58%,46.09%,1
高雄市,阿蓮區,0223,477,115,592,43,635,1092,58.15%,43.68%,1
高雄市,阿蓮區,0224,429,139,568,55,623,1099,56.69%,39.04%,1
高雄市,阿蓮區,0225,488,107,595,24,619,1134,54.59%,43.03%,1
高雄市,阿蓮區,0226,575,170,745,28,773,1561,49.52%,36.84%,1
高雄市,阿蓮區,0227,603,214,817,82,899,1533,58.64%,39.33%,1
高雄市,阿蓮區,0228,410,117,527,26,553,1116,49.55%,36.74%,1
高雄市,阿蓮區,0229,397,113,510,38,548,1054,51.99%,37.67%,1
高雄市,阿蓮區,0230,492,131,623,58,681,1260,54.05%,39.05%,1
高雄市,阿蓮區,0231,583,137,720,72,792,1504,52.66%,38.76%,1
高雄市,阿蓮區,0232,299,79,378,16,394,848,46.46%,35.26%,1
高雄市,阿蓮區,0233,327,76,403,21,424,823,51.52%,39.73%,1
高雄市,阿蓮區,0234,424,99,523,30,553,1021,54.16%,41.53%,1
高雄市,阿蓮區,0235,643,152,795,39,834,1715,48.63%,37.49%,1
高雄市,阿蓮區,0236,485,149,634,49,683,1300,52.54%,37.31%,1
高雄市,路竹區,0175,393,96,489,29,518,1026,50.49%,38.3%,1
高雄市,路竹區,0176,431,126,557,70,627,1069,58.65%,40.32%,1
高雄市,路竹區,0177,472,148,620,69,689,1127,61.14%,41.88%,1
高雄市,路竹區,0178,465,124,589,75,664,1179,56.32%,39.44%,1
高雄市,路竹區,0179,464,150,614,88,702,1237,56.75%,37.51%,1
高雄市,路竹區,0180,461,130,591,65,656,1096,59.85%,42.06%,1
高雄市,路竹區,0181,570,155,725,72,797,1272,62.66%,44.81%,1
高雄市,路竹區,0182,494,143,637,57,694,1182,58.71%,41.79%,1
高雄市,路竹區,0183,489,116,605,48,653,1127,57.94%,43.39%,1
高雄市,路竹區,0184,409,118,527,44,571,956,59.73%,42.78%,1
高雄市,路竹區,0185,469,144,613,50,663,1132,58.57%,41.43%,1
高雄市,路竹區,0186,476,104,580,75,655,1025,63.9%,46.44%,1
高雄市,路竹區,0187,398,96,494,28,522,1007,51.84%,39.52%,1
高雄市,路竹區,0188,513,119,632,61,693,1301,53.27%,39.43%,1
高雄市,路竹區,0189,381,90,471,34,505,885,57.06%,43.05%,1
高雄市,路竹區,0190,272,101,373,18,391,837,46.71%,32.5%,1
高雄市,路竹區,0191,400,105,505,60,565,930,60.75%,43.01%,1
高雄市,路竹區,0192,280,75,355,47,402,781,51.47%,35.85%,1
高雄市,路竹區,0193,412,132,544,63,607,1023,59.34%,40.27%,1
高雄市,路竹區,0194,770,185,955,78,1033,1763,58.59%,43.68%,1
高雄市,路竹區,0195,626,222,848,56,904,1637,55.22%,38.24%,1
高雄市,路竹區,0196,414,136,550,37,587,1070,54.86%,38.69%,1
高雄市,路竹區,0197,502,134,636,72,708,1177,60.15%,42.65%,1
高雄市,路竹區,0198,389,165,554,38,592,1007,58.79%,38.63%,1
高雄市,路竹區,0199,432,124,556,30,586,1026,57.12%,42.11%,1
高雄市,路竹區,0200,427,118,545,35,580,1017,57.03%,41.99%,1
高雄市,路竹區,0201,529,151,680,53,733,1264,57.99%,41.85%,1
高雄市,路竹區,0202,496,121,617,44,661,1089,60.7%,45.55%,1
高雄市,路竹區,0203,340,110,450,41,491,851,57.7%,39.95%,1
高雄市,路竹區,0204,441,138,579,43,622,1011,61.52%,43.62%,1
高雄市,路竹區,0205,437,138,575,29,604,937,64.46%,46.64%,1
高雄市,路竹區,0206,276,88,364,14,378,820,46.1%,33.66%,1
高雄市,路竹區,0207,439,114,553,27,580,910,63.74%,48.24%,1
高雄市,路竹區,0208,334,111,445,48,493,867,56.86%,38.52%,1
高雄市,路竹區,0209,386,108,494,33,527,937,56.24%,41.2%,1
高雄市,路竹區,0210,385,104,489,23,512,900,56.89%,42.78%,1
高雄市,路竹區,0211,388,108,496,56,552,900,61.33%,43.11%,1
高雄市,路竹區,0212,430,81,511,35,546,918,59.48%,46.84%,1
高雄市,路竹區,0213,403,114,517,41,558,870,64.14%,46.32%,1
高雄市,路竹區,0214,525,148,673,48,721,1150,62.7%,45.65%,1
高雄市,路竹區,0215,743,175,918,63,981,1537,63.83%,48.34%,1
高雄市,湖內區,0151,388,122,510,38,548,1112,49.28%,34.89%,1
高雄市,湖內區,0152,392,103,495,82,577,1017,56.74%,38.54%,1
高雄市,湖內區,0153,285,90,375,29,404,796,50.75%,35.8%,1
高雄市,湖內區,0154,484,129,613,32,645,1079,59.78%,44.86%,1
高雄市,湖內區,0155,441,145,586,26,612,1115,54.89%,39.55%,1
高雄市,湖內區,0156,507,134,641,39,680,1311,51.87%,38.67%,1
高雄市,湖內區,0157,508,133,641,34,675,1319,51.18%,38.51%,1
高雄市,湖內區,0158,559,155,714,70,784,1244,63.02%,44.94%,1
高雄市,湖內區,0159,553,162,715,50,765,1227,62.35%,45.07%,1
高雄市,湖內區,0160,527,118,645,64,709,1163,60.96%,45.31%,1
高雄市,湖內區,0161,432,125,557,32,589,981,60.04%,44.04%,1
高雄市,湖內區,0162,304,72,376,16,392,780,50.26%,38.97%,1
高雄市,湖內區,0163,339,83,422,52,474,832,56.97%,40.75%,1
高雄市,湖內區,0164,460,139,599,36,635,1017,62.44%,45.23%,1
高雄市,湖內區,0165,457,114,571,21,592,1051,56.33%,43.48%,1
高雄市,湖內區,0166,354,100,454,31,485,941,51.54%,37.62%,1
高雄市,湖內區,0167,322,101,423,53,476,863,55.16%,37.31%,1
高雄市,湖內區,0168,455,121,576,52,628,1160,54.14%,39.22%,1
高雄市,湖內區,0169,337,94,431,23,454,1090,41.65%,30.92%,1
高雄市,湖內區,0170,436,152,588,56,644,1122,57.4%,38.86%,1
高雄市,湖內區,0171,390,83,473,28,501,1123,44.61%,34.73%,1
高雄市,湖內區,0172,261,69,330,27,357,684,52.19%,38.16%,1
高雄市,湖內區,0173,458,120,578,27,605,1249,48.44%,36.67%,1
高雄市,湖內區,0174,461,127,588,49,637,1453,43.84%,31.73%,1
高雄市,茄萣區,0130,310,91,401,22,423,976,43.34%,31.76%,1
高雄市,茄萣區,0131,311,114,425,59,484,887,54.57%,35.06%,1
高雄市,茄萣區,0132,625,184,809,30,839,1710,49.06%,36.55%,1
高雄市,茄萣區,0133,398,119,517,44,561,1280,43.83%,31.09%,1
高雄市,茄萣區,0134,513,171,684,30,714,1314,54.34%,39.04%,1
高雄市,茄萣區,0135,506,150,656,17,673,1157,58.17%,43.73%,1
高雄市,茄萣區,0136,652,211,863,118,981,1785,54.96%,36.53%,1
高雄市,茄萣區,0137,282,109,391,92,483,838,57.64%,33.65%,1
高雄市,茄萣區,0138,536,173,709,84,793,1249,63.49%,42.91%,1
高雄市,茄萣區,0139,394,116,510,98,608,1116,54.48%,35.3%,1
高雄市,茄萣區,0140,327,94,421,51,472,978,48.26%,33.44%,1
高雄市,茄萣區,0141,335,113,448,46,494,1125,43.91%,29.78%,1
高雄市,茄萣區,0142,384,153,537,82,619,1139,54.35%,33.71%,1
高雄市,茄萣區,0143,508,149,657,107,764,1363,56.05%,37.27%,1
高雄市,茄萣區,0144,607,216,823,103,926,1598,57.95%,37.98%,1
高雄市,茄萣區,0145,407,124,531,68,599,1111,53.92%,36.63%,1
高雄市,茄萣區,0146,272,93,365,49,414,925,44.76%,29.41%,1
高雄市,茄萣區,0147,417,133,550,65,615,1148,53.57%,36.32%,1
高雄市,茄萣區,0148,453,156,609,49,658,1353,48.63%,33.48%,1
高雄市,茄萣區,0149,495,160,655,64,719,1331,54.02%,37.19%,1
高雄市,茄萣區,0150,629,190,819,66,885,1829,48.39%,34.39%,1
高雄市,永安區,0249,370,90,460,38,498,756,65.87%,48.94%,1
高雄市,永安區,0250,330,111,441,71,512,818,62.59%,40.34%,1
高雄市,永安區,0251,424,126,550,45,595,866,68.71%,48.96%,1
高雄市,永安區,0252,414,135,549,64,613,951,64.46%,43.53%,1
高雄市,永安區,0253,421,137,558,64,622,992,62.7%,42.44%,1
高雄市,永安區,0254,218,70,288,19,307,682,45.01%,31.96%,1
高雄市,永安區,0255,281,76,357,23,380,665,57.14%,42.26%,1
高雄市,永安區,0256,141,46,187,16,203,371,54.72%,38.01%,1
高雄市,永安區,0257,509,151,660,68,728,1114,65.35%,45.69%,1
高雄市,永安區,0258,651,186,837,39,876,1418,61.78%,45.91%,1
高雄市,永安區,0259,687,202,889,76,965,1477,65.34%,46.51%,1
高雄市,永安區,0260,869,235,1104,83,1187,1891,62.77%,45.95%,1
高雄市,彌陀區,0358,504,166,670,78,748,1246,60.03%,40.45%,1
高雄市,彌陀區,0359,366,121,487,60,547,885,61.81%,41.36%,1
高雄市,彌陀區,0360,440,142,582,64,646,955,67.64%,46.07%,1
高雄市,彌陀區,0361,199,71,270,44,314,534,58.8%,37.27%,1
高雄市,彌陀區,0362,320,95,415,30,445,738,60.3%,43.36%,1
高雄市,彌陀區,0363,425,108,533,42,575,855,67.25%,49.71%,1
高雄市,彌陀區,0364,400,53,453,104,557,877,63.51%,45.61%,1
高雄市,彌陀區,0365,339,92,431,72,503,781,64.4%,43.41%,1
高雄市,彌陀區,0366,328,102,430,33,463,808,57.3%,40.59%,1
高雄市,彌陀區,0367,326,93,419,35,454,904,50.22%,36.06%,1
高雄市,彌陀區,0368,344,98,442,57,499,825,60.48%,41.7%,1
高雄市,彌陀區,0369,334,111,445,73,518,941,55.05%,35.49%,1
高雄市,彌陀區,0370,414,119,533,36,569,1013,56.17%,40.87%,1
高雄市,彌陀區,0371,464,114,578,64,642,1024,62.7%,45.31%,1
高雄市,彌陀區,0372,348,65,413,22,435,861,50.52%,40.42%,1
高雄市,彌陀區,0373,503,150,653,72,725,1163,62.34%,43.25%,1
高雄市,彌陀區,0374,552,147,699,91,790,1216,64.97%,45.39%,1
高雄市,彌陀區,0375,421,118,539,83,622,861,72.24%,48.9%,1
高雄市,梓官區,0376,402,204,606,68,674,1061,63.52%,37.89%,1
高雄市,梓官區,0377,438,127,565,71,636,1063,59.83%,41.2%,1
高雄市,梓官區,0378,389,120,509,33,542,969,55.93%,40.14%,1
高雄市,梓官區,0379,390,127,517,21,538,1078,49.91%,36.18%,1
高雄市,梓官區,0380,341,117,458,62,520,838,62.05%,40.69%,1
高雄市,梓官區,0381,270,86,356,23,379,611,62.03%,44.19%,1
高雄市,梓官區,0382,322,82,404,32,436,782,55.75%,41.18%,1
高雄市,梓官區,0383,671,186,857,86,943,1451,64.99%,46.24%,1
高雄市,梓官區,0384,426,149,575,27,602,1144,52.62%,37.24%,1
高雄市,梓官區,0385,353,108,461,14,475,975,48.72%,36.21%,1
高雄市,梓官區,0386,538,148,686,48,734,1317,55.73%,40.85%,1
高雄市,梓官區,0387,522,154,676,77,753,1218,61.82%,42.86%,1
高雄市,梓官區,0388,459,125,584,35,619,1073,57.69%,42.78%,1
高雄市,梓官區,0389,403,87,490,82,572,1112,51.44%,36.24%,1
高雄市,梓官區,0390,269,93,362,37,399,715,55.8%,37.62%,1
高雄市,梓官區,0391,602,38,640,54,694,1311,52.94%,45.92%,1
高雄市,梓官區,0392,363,111,474,32,506,939,53.89%,38.66%,1
高雄市,梓官區,0393,377,101,478,37,515,824,62.5%,45.75%,1
高雄市,梓官區,0394,538,53,591,104,695,1052,66.06%,51.14%,1
高雄市,梓官區,0395,433,112,545,101,646,1020,63.33%,42.45%,1
高雄市,梓官區,0396,471,137,608,37,645,1260,51.19%,37.38%,1
高雄市,梓官區,0397,635,171,806,46,852,1595,53.42%,39.81%,1
高雄市,梓官區,0398,364,96,460,35,495,829,59.71%,43.91%,1
高雄市,梓官區,0399,616,149,765,30,795,1532,51.89%,40.21%,1
高雄市,梓官區,0400,527,158,685,74,759,1195,63.51%,44.1%,1
高雄市,梓官區,0401,491,137,628,79,707,1143,61.85%,42.96%,1
高雄市,梓官區,0402,523,150,673,61,734,1186,61.89%,44.1%,1
高雄市,梓官區,0403,627,134,761,42,803,1732,46.36%,36.2%,1
高雄市,旗山區,0060,487,94,581,52,633,1060,59.72%,45.94%,1
高雄市,旗山區,0061,434,108,542,48,590,1125,52.44%,38.58%,1
高雄市,旗山區,0062,507,112,619,26,645,1100,58.64%,46.09%,1
高雄市,旗山區,0063,552,137,689,23,712,1238,57.51%,44.59%,1
高雄市,旗山區,0064,413,86,499,23,522,933,55.95%,44.27%,1
高雄市,旗山區,0065,261,67,328,16,344,727,47.32%,35.9%,1
高雄市,旗山區,0066,439,105,544,51,595,1071,55.56%,40.99%,1
高雄市,旗山區,0067,284,68,352,30,382,744,51.34%,38.17%,1
高雄市,旗山區,0068,375,110,485,29,514,1100,46.73%,34.09%,1
高雄市,旗山區,0069,140,38,178,15,193,369,52.3%,37.94%,1
高雄市,旗山區,0070,278,85,363,10,373,888,42%,31.31%,1
高雄市,旗山區,0071,145,50,195,7,202,510,39.61%,28.43%,1
高雄市,旗山區,0072,422,139,561,84,645,1042,61.9%,40.5%,1
高雄市,旗山區,0073,307,82,389,45,434,791,54.87%,38.81%,1
高雄市,旗山區,0074,381,109,490,73,563,939,59.96%,40.58%,1
高雄市,旗山區,0075,433,129,562,35,597,1218,49.01%,35.55%,1
高雄市,旗山區,0076,51,22,73,22,95,178,53.37%,28.65%,1
高雄市,旗山區,0077,416,116,532,56,588,946,62.16%,43.97%,1
高雄市,旗山區,0078,372,132,504,32,536,1025,52.29%,36.29%,1
高雄市,旗山區,0079,453,99,552,74,626,1040,60.19%,43.56%,1
高雄市,旗山區,0080,400,124,524,50,574,900,63.78%,44.44%,1
高雄市,旗山區,0081,245,66,311,20,331,663,49.92%,36.95%,1
高雄市,旗山區,0082,382,90,472,58,530,954,55.56%,40.04%,1
高雄市,旗山區,0083,409,105,514,35,549,1060,51.79%,38.58%,1
高雄市,旗山區,0084,480,129,609,53,662,1110,59.64%,43.24%,1
高雄市,旗山區,0085,455,129,584,45,629,1062,59.23%,42.84%,1
高雄市,旗山區,0086,473,113,586,36,622,1151,54.04%,41.09%,1
高雄市,旗山區,0087,102,35,137,27,164,266,61.65%,38.35%,1
高雄市,旗山區,0088,265,91,356,34,390,633,61.61%,41.86%,1
高雄市,旗山區,0089,454,139,593,30,623,1307,47.67%,34.74%,1
高雄市,旗山區,0090,257,105,362,63,425,754,56.37%,34.08%,1
高雄市,旗山區,0091,588,50,638,99,737,1296,56.87%,45.37%,1
高雄市,旗山區,0092,270,77,347,19,366,839,43.62%,32.18%,1
高雄市,旗山區,0093,535,163,698,51,749,1329,56.36%,40.26%,1
高雄市,旗山區,0094,272,69,341,29,370,628,58.92%,43.31%,1
高雄市,美濃區,0095,485,134,619,69,688,1175,58.55%,41.28%,1
高雄市,美濃區,0096,519,146,665,26,691,1438,48.05%,36.09%,1
高雄市,美濃區,0097,285,78,363,43,406,989,41.05%,28.82%,1
高雄市,美濃區,0098,595,161,756,66,822,1427,57.6%,41.7%,1
高雄市,美濃區,0099,547,131,678,61,739,1309,56.46%,41.79%,1
高雄市,美濃區,0100,534,138,672,93,765,1263,60.57%,42.28%,1
高雄市,美濃區,0101,450,98,548,53,601,997,60.28%,45.14%,1
高雄市,美濃區,0102,470,101,571,46,617,1064,57.99%,44.17%,1
高雄市,美濃區,0103,598,142,740,70,810,1498,54.07%,39.92%,1
高雄市,美濃區,0104,484,105,589,67,656,1119,58.62%,43.25%,1
高雄市,美濃區,0105,436,105,541,61,602,1031,58.39%,42.29%,1
高雄市,美濃區,0106,555,146,701,73,774,1437,53.86%,38.62%,1
高雄市,美濃區,0107,438,117,555,53,608,1071,56.77%,40.9%,1
高雄市,美濃區,0108,283,63,346,35,381,687,55.46%,41.19%,1
高雄市,美濃區,0109,241,63,304,17,321,775,41.42%,31.1%,1
高雄市,美濃區,0110,471,157,628,66,694,1353,51.29%,34.81%,1
高雄市,美濃區,0111,423,110,533,50,583,1191,48.95%,35.52%,1
高雄市,美濃區,0112,311,84,395,33,428,906,47.24%,34.33%,1
高雄市,美濃區,0113,534,122,656,35,691,1178,58.66%,45.33%,1
高雄市,美濃區,0114,455,104,559,27,586,1252,46.81%,36.34%,1
高雄市,美濃區,0115,656,163,819,52,871,1549,56.23%,42.35%,1
高雄市,美濃區,0116,419,86,505,44,549,1088,50.46%,38.51%,1
高雄市,美濃區,0117,463,128,591,44,635,1116,56.9%,41.49%,1
高雄市,美濃區,0118,382,115,497,30,527,977,53.94%,39.1%,1
高雄市,美濃區,0119,350,100,450,60,510,816,62.5%,42.89%,1
高雄市,美濃區,0120,341,61,402,28,430,955,45.03%,35.71%,1
高雄市,美濃區,0121,394,99,493,56,549,943,58.22%,41.78%,1
高雄市,美濃區,0122,519,142,661,39,700,1371,51.06%,37.86%,1
高雄市,美濃區,0123,331,119,450,62,512,919,55.71%,36.02%,1
高雄市,美濃區,0124,390,126,516,46,562,915,61.42%,42.62%,1
高雄市,美濃區,0125,316,82,398,58,456,828,55.07%,38.16%,1
高雄市,美濃區,0126,201,62,263,54,317,674,47.03%,29.82%,1
高雄市,六龜區,0020,250,93,343,28,371,760,48.82%,32.89%,1
高雄市,六龜區,0021,203,73,276,31,307,666,46.1%,30.48%,1
高雄市,六龜區,0022,279,78,357,42,399,704,56.68%,39.63%,1
高雄市,六龜區,0023,354,104,458,51,509,1003,50.75%,35.29%,1
高雄市,六龜區,0024,447,109,556,97,653,1382,47.25%,32.34%,1
高雄市,六龜區,0025,277,77,354,68,422,986,42.8%,28.09%,1
高雄市,六龜區,0026,371,109,480,45,525,1046,50.19%,35.47%,1
高雄市,六龜區,0027,248,81,329,53,382,812,47.04%,30.54%,1
高雄市,六龜區,0028,465,130,595,70,665,1431,46.47%,32.49%,1
高雄市,六龜區,0029,342,66,408,69,477,912,52.3%,37.5%,1
高雄市,六龜區,0030,364,127,491,44,535,1472,36.35%,24.73%,1
高雄市,六龜區,0031,92,28,120,23,143,327,43.73%,28.13%,1
高雄市,甲仙區,0013,124,30,154,7,161,472,34.11%,26.27%,1
高雄市,甲仙區,0014,411,93,504,50,554,882,62.81%,46.6%,1
高雄市,甲仙區,0015,259,57,316,38,354,668,52.99%,38.77%,1
高雄市,甲仙區,0016,537,146,683,111,794,1581,50.22%,33.97%,1
高雄市,甲仙區,0017,169,36,205,8,213,673,31.65%,25.11%,1
高雄市,甲仙區,0018,203,41,244,34,278,607,45.8%,33.44%,1
高雄市,甲仙區,0019,190,41,231,12,243,534,45.51%,35.58%,1
高雄市,杉林區,0032,211,61,272,44,316,640,49.38%,32.97%,1
高雄市,杉林區,0033,215,55,270,24,294,696,42.24%,30.89%,1
高雄市,杉林區,0034,302,107,409,38,447,1284,34.81%,23.52%,1
高雄市,杉林區,0035,289,90,379,57,436,1027,42.45%,28.14%,1
高雄市,杉林區,0036,168,37,205,25,230,482,47.72%,34.85%,1
高雄市,杉林區,0037,602,186,788,113,901,1627,55.38%,37%,1
高雄市,杉林區,0038,543,135,678,32,710,1630,43.56%,33.31%,1
高雄市,杉林區,0039,242,85,327,20,347,973,35.66%,24.87%,1
高雄市,杉林區,0040,284,81,365,24,389,987,39.41%,28.77%,1
高雄市,杉林區,0041,445,144,589,74,663,1261,52.58%,35.29%,1
高雄市,內門區,0042,303,82,385,55,440,969,45.41%,31.27%,1
高雄市,內門區,0043,187,43,230,17,247,652,37.88%,28.68%,1
高雄市,內門區,0044,314,115,429,83,512,961,53.28%,32.67%,1
高雄市,內門區,0045,138,18,156,6,162,426,38.03%,32.39%,1
高雄市,內門區,0046,135,29,164,16,180,398,45.23%,33.92%,1
高雄市,內門區,0047,165,38,203,16,219,508,43.11%,32.48%,1
高雄市,內門區,0048,399,95,494,78,572,980,58.37%,40.71%,1
高雄市,內門區,0049,371,117,488,45,533,1225,43.51%,30.29%,1
高雄市,內門區,0050,608,198,806,140,946,1722,54.94%,35.31%,1
高雄市,內門區,0051,172,73,245,30,275,560,49.11%,30.71%,1
高雄市,內門區,0052,227,62,289,21,310,801,38.7%,28.34%,1
高雄市,內門區,0053,149,47,196,19,215,423,50.83%,35.22%,1
高雄市,內門區,0054,151,52,203,33,236,497,47.48%,30.38%,1
高雄市,內門區,0055,211,73,284,32,316,677,46.68%,31.17%,1
高雄市,內門區,0056,150,36,186,10,196,593,33.05%,25.3%,1
高雄市,內門區,0057,151,52,203,45,248,597,41.54%,25.29%,1
高雄市,內門區,0058,106,23,129,9,138,343,40.23%,30.9%,1
高雄市,內門區,0059,244,80,324,42,366,670,54.63%,36.42%,1
高雄市,茂林區,0127,265,59,324,32,356,507,70.22%,52.27%,1
高雄市,茂林區,0128,200,39,239,19,258,382,67.54%,52.36%,1
高雄市,茂林區,0129,344,68,412,28,440,726,60.61%,47.38%,1
高雄市,桃源區,0001,60,16,76,0,76,264,28.79%,22.73%,1
高雄市,桃源區,0002,122,33,155,16,171,233,73.39%,52.36%,1
高雄市,桃源區,0003,143,24,167,7,174,279,62.37%,51.25%,1
高雄市,桃源區,0004,73,33,106,3,109,223,48.88%,32.74%,1
高雄市,桃源區,0005,243,55,298,12,310,783,39.59%,31.03%,1
高雄市,桃源區,0006,197,35,232,8,240,632,37.97%,31.17%,1
高雄市,桃源區,0007,319,64,383,32,415,612,67.81%,52.12%,1
高雄市,桃源區,0008,182,45,227,21,248,472,52.54%,38.56%,1
高雄市,那瑪夏區,0009,249,65,314,14,328,741,44.26%,33.6%,1
高雄市,那瑪夏區,0010,273,84,357,64,421,585,71.97%,46.67%,1
高雄市,那瑪夏區,0011,339,65,404,60,464,609,76.19%,55.67%,1
高雄市,那瑪夏區,0012,118,40,158,6,164,489,33.54%,24.13%,1
新竹縣,竹北市,0001,677,154,831,23,854,1319,64.75%,51.33%,1
新竹縣,竹北市,0002,604,169,773,28,801,1321,60.64%,45.72%,1
新竹縣,竹北市,0003,602,164,766,32,798,1272,62.74%,47.33%,1
新竹縣,竹北市,0004,672,139,811,31,842,1467,57.4%,45.81%,1
新竹縣,竹北市,0005,530,148,678,13,691,1226,56.36%,43.23%,1
新竹縣,竹北市,0006,617,164,781,15,796,1412,56.37%,43.7%,1
新竹縣,竹北市,0007,695,170,865,9,874,1400,62.43%,49.64%,1
新竹縣,竹北市,0008,657,193,850,28,878,1415,62.05%,46.43%,1
新竹縣,竹北市,0009,615,148,763,26,789,1361,57.97%,45.19%,1
新竹縣,竹北市,0010,650,159,809,19,828,1515,54.65%,42.9%,1
新竹縣,竹北市,0011,678,185,863,23,886,1495,59.26%,45.35%,1
新竹縣,竹北市,0012,630,186,816,22,838,1417,59.14%,44.46%,1
新竹縣,竹北市,0013,642,213,855,29,884,1548,57.11%,41.47%,1
新竹縣,竹北市,0014,568,190,758,26,784,1434,54.67%,39.61%,1
新竹縣,竹北市,0015,605,171,776,32,808,1385,58.34%,43.68%,1
新竹縣,竹北市,0016,614,147,761,30,791,1247,63.43%,49.24%,1
新竹縣,竹北市,0017,593,184,777,19,796,1373,57.98%,43.19%,1
新竹縣,竹北市,0018,657,177,834,23,857,1345,63.72%,48.85%,1
新竹縣,竹北市,0019,529,104,633,36,669,1165,57.42%,45.41%,1
新竹縣,竹北市,0020,564,145,709,36,745,1164,64%,48.45%,1
新竹縣,竹北市,0021,568,152,720,34,754,1212,62.21%,46.86%,1
新竹縣,竹北市,0022,601,129,730,28,758,1507,50.3%,39.88%,1
新竹縣,竹北市,0023,657,216,873,35,908,1576,57.61%,41.69%,1
新竹縣,竹北市,0024,644,156,800,28,828,1464,56.56%,43.99%,1
新竹縣,竹北市,0025,638,151,789,28,817,1428,57.21%,44.68%,1
新竹縣,竹北市,0026,532,179,711,18,729,1442,50.55%,36.89%,1
新竹縣,竹北市,0027,646,143,789,50,839,1415,59.29%,45.65%,1
新竹縣,竹北市,0028,669,162,831,17,848,1666,50.9%,40.16%,1
新竹縣,竹北市,0029,699,197,896,41,937,1751,53.51%,39.92%,1
新竹縣,竹北市,0030,558,146,704,30,734,1196,61.37%,46.66%,1
新竹縣,竹北市,0031,576,146,722,20,742,1235,60.08%,46.64%,1
新竹縣,竹北市,0032,527,134,661,21,682,1204,56.64%,43.77%,1
新竹縣,竹北市,0033,629,137,766,27,793,1308,60.63%,48.09%,1
新竹縣,竹北市,0034,547,141,688,14,702,1233,56.93%,44.36%,1
新竹縣,竹北市,0035,525,122,647,25,672,1129,59.52%,46.5%,1
新竹縣,竹北市,0036,543,94,637,22,659,1069,61.65%,50.8%,1
新竹縣,竹北市,0037,567,108,675,36,711,1114,63.82%,50.9%,1
新竹縣,竹北市,0038,530,116,646,24,670,1103,60.74%,48.05%,1
新竹縣,竹北市,0039,532,112,644,26,670,1029,65.11%,51.7%,1
新竹縣,竹北市,0040,555,145,700,32,732,1133,64.61%,48.98%,1
新竹縣,竹北市,0041,600,132,732,24,756,1301,58.11%,46.12%,1
新竹縣,竹北市,0042,813,182,995,49,1044,1798,58.06%,45.22%,1
新竹縣,竹北市,0043,656,158,814,34,848,1427,59.43%,45.97%,1
新竹縣,竹北市,0044,722,154,876,35,911,1462,62.31%,49.38%,1
新竹縣,竹北市,0045,672,157,829,27,856,1342,63.79%,50.07%,1
新竹縣,竹北市,0046,722,143,865,29,894,1480,60.41%,48.78%,1
新竹縣,竹北市,0047,735,169,904,24,928,1645,56.41%,44.68%,1
新竹縣,竹北市,0048,628,153,781,22,803,1256,63.93%,50%,1
新竹縣,竹北市,0049,545,145,690,30,720,1181,60.97%,46.15%,1
新竹縣,竹北市,0050,674,147,821,41,862,1329,64.86%,50.71%,1
新竹縣,竹北市,0051,602,153,755,24,779,1228,63.44%,49.02%,1
新竹縣,竹北市,0052,671,175,846,30,876,1552,56.44%,43.23%,1
新竹縣,竹北市,0053,679,183,862,31,893,1480,60.34%,45.88%,1
新竹縣,竹北市,0054,598,172,770,31,801,1487,53.87%,40.22%,1
新竹縣,竹北市,0055,623,146,769,38,807,1470,54.9%,42.38%,1
新竹縣,竹北市,0056,619,136,755,31,786,1477,53.22%,41.91%,1
新竹縣,竹北市,0057,757,183,940,42,982,1611,60.96%,46.99%,1
新竹縣,竹北市,0058,682,165,847,59,906,1555,58.26%,43.86%,1
新竹縣,竹北市,0059,629,135,764,36,800,1468,54.5%,42.85%,1
新竹縣,竹北市,0060,692,156,848,47,895,1509,59.31%,45.86%,1
新竹縣,竹北市,0061,680,167,847,45,892,1602,55.68%,42.45%,1
新竹縣,竹北市,0062,659,159,818,48,866,1448,59.81%,45.51%,1
新竹縣,竹北市,0063,612,130,742,53,795,1318,60.32%,46.43%,1
新竹縣,竹北市,0064,778,171,949,52,1001,1634,61.26%,47.61%,1
新竹縣,竹北市,0065,568,158,726,46,772,1345,57.4%,42.23%,1
新竹縣,竹北市,0066,504,103,607,27,634,958,66.18%,52.61%,1
新竹縣,竹北市,0067,548,121,669,33,702,1112,63.13%,49.28%,1
新竹縣,竹北市,0068,476,134,610,59,669,1134,58.99%,41.98%,1
新竹縣,竹北市,0069,671,156,827,26,853,1483,57.52%,45.25%,1
新竹縣,竹北市,0070,578,134,712,37,749,1332,56.23%,43.39%,1
新竹縣,竹北市,0071,596,138,734,28,762,1482,51.42%,40.22%,1
新竹縣,竹北市,0072,465,134,599,21,620,1449,42.79%,32.09%,1
新竹縣,竹北市,0073,572,122,694,22,716,1319,54.28%,43.37%,1
新竹縣,竹北市,0074,559,133,692,32,724,1332,54.35%,41.97%,1
新竹縣,竹北市,0075,558,150,708,42,750,1412,53.12%,39.52%,1
新竹縣,竹北市,0076,672,159,831,46,877,1640,53.48%,40.98%,1
新竹縣,竹北市,0077,572,141,713,43,756,1323,57.14%,43.24%,1
新竹縣,竹北市,0078,649,155,804,47,851,1428,59.59%,45.45%,1
新竹縣,竹北市,0079,696,156,852,46,898,1533,58.58%,45.4%,1
新竹縣,竹北市,0080,556,114,670,27,697,1346,51.78%,41.31%,1
新竹縣,竹北市,0081,504,114,618,51,669,1219,54.88%,41.35%,1
新竹縣,竹北市,0082,674,161,835,57,892,1466,60.85%,45.98%,1
新竹縣,竹北市,0083,486,116,602,30,632,1147,55.1%,42.37%,1
新竹縣,竹北市,0084,591,126,717,35,752,1529,49.18%,38.65%,1
新竹縣,竹北市,0085,697,136,833,45,878,1522,57.69%,45.8%,1
新竹縣,竹北市,0086,638,145,783,46,829,1383,59.94%,46.13%,1
新竹縣,竹北市,0087,686,178,864,32,896,1569,57.11%,43.72%,1
新竹縣,竹北市,0088,629,130,759,25,784,1506,52.06%,41.77%,1
新竹縣,竹北市,0089,373,93,466,40,506,877,57.7%,42.53%,1
新竹縣,竹北市,0090,472,113,585,40,625,1074,58.19%,43.95%,1
新竹縣,竹北市,0091,537,132,669,33,702,1089,64.46%,49.31%,1
新竹縣,竹北市,0092,592,143,735,58,793,1336,59.36%,44.31%,1
新竹縣,竹北市,0093,418,120,538,63,601,1058,56.81%,39.51%,1
新竹縣,竹北市,0094,455,120,575,51,626,937,66.81%,48.56%,1
新竹縣,竹北市,0095,524,132,656,36,692,1206,57.38%,43.45%,1
新竹縣,竹北市,0096,492,142,634,47,681,1205,56.51%,40.83%,1
新竹縣,竹北市,0097,773,196,969,59,1028,1718,59.84%,44.99%,1
新竹縣,竹北市,0098,366,112,478,45,523,917,57.03%,39.91%,1
新竹縣,竹北市,0099,293,83,376,28,404,668,60.48%,43.86%,1
新竹縣,竹北市,0100,340,83,423,30,453,824,54.98%,41.26%,1
新竹縣,竹北市,0101,316,83,399,65,464,782,59.34%,40.41%,1
新竹縣,竹北市,0102,435,110,545,55,600,977,61.41%,44.52%,1
新竹縣,竹北市,0103,345,86,431,15,446,937,47.6%,36.82%,1
新竹縣,竹東鎮,0104,121,24,145,7,152,309,49.19%,39.16%,1
新竹縣,竹東鎮,0105,145,46,191,24,215,416,51.68%,34.86%,1
新竹縣,竹東鎮,0106,155,33,188,4,192,386,49.74%,40.16%,1
新竹縣,竹東鎮,0107,367,79,446,21,467,950,49.16%,38.63%,1
新竹縣,竹東鎮,0108,535,107,642,15,657,1275,51.53%,41.96%,1
新竹縣,竹東鎮,0109,509,116,625,32,657,1213,54.16%,41.96%,1
新竹縣,竹東鎮,0110,697,134,831,34,865,1548,55.88%,45.03%,1
新竹縣,竹東鎮,0111,510,87,597,26,623,1246,50%,40.93%,1
新竹縣,竹東鎮,0112,444,94,538,37,575,1252,45.93%,35.46%,1
新竹縣,竹東鎮,0113,573,101,674,44,718,1359,52.83%,42.16%,1
新竹縣,竹東鎮,0114,502,131,633,36,669,1255,53.31%,40%,1
新竹縣,竹東鎮,0115,598,123,721,29,750,1304,57.52%,45.86%,1
新竹縣,竹東鎮,0116,575,121,696,33,729,1292,56.42%,44.5%,1
新竹縣,竹東鎮,0117,456,84,540,14,554,1111,49.86%,41.04%,1
新竹縣,竹東鎮,0118,410,76,486,36,522,880,59.32%,46.59%,1
新竹縣,竹東鎮,0119,313,63,376,16,392,670,58.51%,46.72%,1
新竹縣,竹東鎮,0120,582,113,695,30,725,1244,58.28%,46.78%,1
新竹縣,竹東鎮,0121,462,101,563,44,607,1126,53.91%,41.03%,1
新竹縣,竹東鎮,0122,456,95,551,38,589,1073,54.89%,42.5%,1
新竹縣,竹東鎮,0123,516,140,656,39,695,1215,57.2%,42.47%,1
新竹縣,竹東鎮,0124,561,84,645,15,660,1155,57.14%,48.57%,1
新竹縣,竹東鎮,0125,353,92,445,40,485,852,56.92%,41.43%,1
新竹縣,竹東鎮,0126,384,111,495,31,526,875,60.11%,43.89%,1
新竹縣,竹東鎮,0127,496,125,621,33,654,1070,61.12%,46.36%,1
新竹縣,竹東鎮,0128,286,68,354,24,378,704,53.69%,40.63%,1
新竹縣,竹東鎮,0129,293,58,351,31,382,951,40.17%,30.81%,1
新竹縣,竹東鎮,0130,432,104,536,19,555,984,56.4%,43.9%,1
新竹縣,竹東鎮,0131,380,82,462,10,472,1113,42.41%,34.14%,1
新竹縣,竹東鎮,0132,265,71,336,20,356,595,59.83%,44.54%,1
新竹縣,竹東鎮,0133,334,94,428,40,468,762,61.42%,43.83%,1
新竹縣,竹東鎮,0134,319,88,407,15,422,763,55.31%,41.81%,1
新竹縣,竹東鎮,0135,307,98,405,15,420,813,51.66%,37.76%,1
新竹縣,竹東鎮,0136,480,117,597,22,619,1310,47.25%,36.64%,1
新竹縣,竹東鎮,0137,552,116,668,36,704,1434,49.09%,38.49%,1
新竹縣,竹東鎮,0138,485,123,608,31,639,1131,56.5%,42.88%,1
新竹縣,竹東鎮,0139,424,81,505,23,528,967,54.6%,43.85%,1
新竹縣,竹東鎮,0140,455,125,580,32,612,1196,51.17%,38.04%,1
新竹縣,竹東鎮,0141,512,108,620,34,654,1154,56.67%,44.37%,1
新竹縣,竹東鎮,0142,315,87,402,37,439,715,61.4%,44.06%,1
新竹縣,竹東鎮,0143,284,87,371,10,381,685,55.62%,41.46%,1
新竹縣,竹東鎮,0144,554,120,674,44,718,1352,53.11%,40.98%,1
新竹縣,竹東鎮,0145,630,116,746,60,806,1407,57.29%,44.78%,1
新竹縣,竹東鎮,0146,581,148,729,1,730,1362,53.6%,42.66%,1
新竹縣,竹東鎮,0147,600,115,715,37,752,1330,56.54%,45.11%,1
新竹縣,竹東鎮,0148,592,152,744,49,793,1441,55.03%,41.08%,1
新竹縣,竹東鎮,0149,503,111,614,12,626,1248,50.16%,40.3%,1
新竹縣,竹東鎮,0150,434,102,536,29,565,1263,44.73%,34.36%,1
新竹縣,竹東鎮,0151,466,103,569,21,590,1232,47.89%,37.82%,1
新竹縣,竹東鎮,0152,421,100,521,20,541,1143,47.33%,36.83%,1
新竹縣,竹東鎮,0153,658,142,800,30,830,1529,54.28%,43.03%,1
新竹縣,竹東鎮,0154,483,111,594,32,626,1140,54.91%,42.37%,1
新竹縣,竹東鎮,0155,271,76,347,17,364,570,63.86%,47.54%,1
新竹縣,竹東鎮,0156,519,115,634,22,656,1345,48.77%,38.59%,1
新竹縣,竹東鎮,0157,536,134,670,61,731,1381,52.93%,38.81%,1
新竹縣,竹東鎮,0158,603,111,714,50,764,1379,55.4%,43.73%,1
新竹縣,竹東鎮,0159,455,103,558,43,601,1033,58.18%,44.05%,1
新竹縣,竹東鎮,0160,455,99,554,27,581,1066,54.5%,42.68%,1
新竹縣,竹東鎮,0161,416,100,516,38,554,938,59.06%,44.35%,1
新竹縣,竹東鎮,0162,447,99,546,40,586,952,61.55%,46.95%,1
新竹縣,竹東鎮,0163,685,158,843,41,884,1468,60.22%,46.66%,1
新竹縣,竹東鎮,0164,737,197,934,42,976,1915,50.97%,38.49%,1
新竹縣,竹東鎮,0165,480,115,595,37,632,1220,51.8%,39.34%,1
新竹縣,竹東鎮,0166,414,94,508,23,531,1166,45.54%,35.51%,1
新竹縣,竹東鎮,0167,556,131,687,25,712,1492,47.72%,37.27%,1
新竹縣,竹東鎮,0168,448,164,612,40,652,1245,52.37%,35.98%,1
新竹縣,竹東鎮,0169,472,119,591,34,625,1083,57.71%,43.58%,1
新竹縣,竹東鎮,0170,461,115,576,29,605,1102,54.9%,41.83%,1
新竹縣,竹東鎮,0171,454,103,557,20,577,1068,54.03%,42.51%,1
新竹縣,竹東鎮,0172,475,121,596,29,625,1097,56.97%,43.3%,1
新竹縣,竹東鎮,0173,375,83,458,21,479,962,49.79%,38.98%,1
新竹縣,竹東鎮,0174,383,111,494,24,518,909,56.99%,42.13%,1
新竹縣,竹東鎮,0175,234,45,279,23,302,603,50.08%,38.81%,1
新竹縣,新埔鎮,0176,462,86,548,38,586,983,59.61%,47%,1
新竹縣,新埔鎮,0177,261,81,342,27,369,597,61.81%,43.72%,1
新竹縣,新埔鎮,0178,478,100,578,17,595,1070,55.61%,44.67%,1
新竹縣,新埔鎮,0179,410,83,493,33,526,935,56.26%,43.85%,1
新竹縣,新埔鎮,0180,326,81,407,26,433,753,57.5%,43.29%,1
新竹縣,新埔鎮,0181,440,93,533,18,551,838,65.75%,52.51%,1
新竹縣,新埔鎮,0182,404,84,488,32,520,924,56.28%,43.72%,1
新竹縣,新埔鎮,0183,356,66,422,26,448,905,49.5%,39.34%,1
新竹縣,新埔鎮,0184,419,98,517,21,538,948,56.75%,44.2%,1
新竹縣,新埔鎮,0185,455,98,553,41,594,1017,58.41%,44.74%,1
新竹縣,新埔鎮,0186,548,127,675,38,713,1176,60.63%,46.6%,1
新竹縣,新埔鎮,0187,487,153,640,58,698,1122,62.21%,43.4%,1
新竹縣,新埔鎮,0188,345,95,440,14,454,1022,44.42%,33.76%,1
新竹縣,新埔鎮,0189,535,134,669,42,711,1429,49.76%,37.44%,1
新竹縣,新埔鎮,0190,221,54,275,30,305,451,67.63%,49%,1
新竹縣,新埔鎮,0191,284,95,379,31,410,724,56.63%,39.23%,1
新竹縣,新埔鎮,0192,292,70,362,30,392,617,63.53%,47.33%,1
新竹縣,新埔鎮,0193,501,129,630,48,678,1144,59.27%,43.79%,1
新竹縣,新埔鎮,0194,494,117,611,45,656,1139,57.59%,43.37%,1
新竹縣,新埔鎮,0195,390,76,466,15,481,861,55.87%,45.3%,1
新竹縣,新埔鎮,0196,439,99,538,19,557,1093,50.96%,40.16%,1
新竹縣,新埔鎮,0197,371,102,473,35,508,978,51.94%,37.93%,1
新竹縣,新埔鎮,0198,403,77,480,26,506,1040,48.65%,38.75%,1
新竹縣,新埔鎮,0199,462,117,579,41,620,1160,53.45%,39.83%,1
新竹縣,新埔鎮,0200,452,96,548,27,575,950,60.53%,47.58%,1
新竹縣,新埔鎮,0201,388,82,470,27,497,882,56.35%,43.99%,1
新竹縣,新埔鎮,0202,530,151,681,57,738,1281,57.61%,41.37%,1
新竹縣,新埔鎮,0203,507,104,611,40,651,1212,53.71%,41.83%,1
新竹縣,新埔鎮,0204,362,85,447,38,485,1013,47.88%,35.74%,1
新竹縣,新埔鎮,0205,305,66,371,31,402,630,63.81%,48.41%,1
新竹縣,關西鎮,0206,248,35,283,24,307,480,63.96%,51.67%,1
新竹縣,關西鎮,0207,407,102,509,32,541,903,59.91%,45.07%,1
新竹縣,關西鎮,0208,453,110,563,31,594,1020,58.24%,44.41%,1
新竹縣,關西鎮,0209,293,67,360,17,377,705,53.48%,41.56%,1
新竹縣,關西鎮,0210,438,110,548,29,577,1056,54.64%,41.48%,1
新竹縣,關西鎮,0211,532,129,661,39,700,1275,54.9%,41.73%,1
新竹縣,關西鎮,0212,582,130,712,42,754,1287,58.59%,45.22%,1
新竹縣,關西鎮,0213,361,80,441,25,466,771,60.44%,46.82%,1
新竹縣,關西鎮,0214,427,104,531,38,569,1046,54.4%,40.82%,1
新竹縣,關西鎮,0215,440,127,567,35,602,1030,58.45%,42.72%,1
新竹縣,關西鎮,0216,548,103,651,36,687,1208,56.87%,45.36%,1
新竹縣,關西鎮,0217,429,64,493,37,530,1095,48.4%,39.18%,1
新竹縣,關西鎮,0218,534,144,678,33,711,1350,52.67%,39.56%,1
新竹縣,關西鎮,0219,427,85,512,24,536,846,63.36%,50.47%,1
新竹縣,關西鎮,0220,559,129,688,55,743,1362,54.55%,41.04%,1
新竹縣,關西鎮,0221,340,83,423,24,447,903,49.5%,37.65%,1
新竹縣,關西鎮,0222,202,49,251,16,267,551,48.46%,36.66%,1
新竹縣,關西鎮,0223,148,32,180,11,191,461,41.43%,32.1%,1
新竹縣,關西鎮,0224,245,46,291,28,319,572,55.77%,42.83%,1
新竹縣,關西鎮,0225,377,108,485,22,507,943,53.76%,39.98%,1
新竹縣,關西鎮,0226,330,104,434,35,469,808,58.04%,40.84%,1
新竹縣,關西鎮,0227,469,92,561,21,582,923,63.06%,50.81%,1
新竹縣,關西鎮,0228,415,84,499,35,534,903,59.14%,45.96%,1
新竹縣,關西鎮,0229,439,98,537,39,576,977,58.96%,44.93%,1
新竹縣,關西鎮,0230,372,101,473,32,505,824,61.29%,45.15%,1
新竹縣,關西鎮,0231,270,57,327,16,343,559,61.36%,48.3%,1
新竹縣,關西鎮,0232,429,78,507,27,534,854,62.53%,50.23%,1
新竹縣,湖口鄉,0233,526,143,669,37,706,1393,50.68%,37.76%,1
新竹縣,湖口鄉,0234,662,180,842,26,868,1505,57.67%,43.99%,1
新竹縣,湖口鄉,0235,574,161,735,25,760,1188,63.97%,48.32%,1
新竹縣,湖口鄉,0236,539,141,680,46,726,1267,57.3%,42.54%,1
新竹縣,湖口鄉,0237,731,166,897,34,931,1668,55.82%,43.82%,1
新竹縣,湖口鄉,0238,767,183,950,49,999,1719,58.12%,44.62%,1
新竹縣,湖口鄉,0239,550,129,679,39,718,1162,61.79%,47.33%,1
新竹縣,湖口鄉,0240,730,164,894,43,937,1833,51.12%,39.83%,1
新竹縣,湖口鄉,0241,617,161,778,41,819,1444,56.72%,42.73%,1
新竹縣,湖口鄉,0242,639,126,765,73,838,1347,62.21%,47.44%,1
新竹縣,湖口鄉,0243,562,109,671,15,686,1202,57.07%,46.76%,1
新竹縣,湖口鄉,0244,387,95,482,37,519,851,60.99%,45.48%,1
新竹縣,湖口鄉,0245,577,141,718,50,768,1272,60.38%,45.36%,1
新竹縣,湖口鄉,0246,556,127,683,38,721,1275,56.55%,43.61%,1
新竹縣,湖口鄉,0247,737,190,927,45,972,1560,62.31%,47.24%,1
新竹縣,湖口鄉,0248,521,139,660,72,732,1147,63.82%,45.42%,1
新竹縣,湖口鄉,0249,773,155,928,48,976,1729,56.45%,44.71%,1
新竹縣,湖口鄉,0250,579,132,711,43,754,1402,53.78%,41.3%,1
新竹縣,湖口鄉,0251,540,115,655,53,708,1183,59.85%,45.65%,1
新竹縣,湖口鄉,0252,614,123,737,39,776,1282,60.53%,47.89%,1
新竹縣,湖口鄉,0253,610,146,756,47,803,1335,60.15%,45.69%,1
新竹縣,湖口鄉,0254,717,170,887,40,927,1493,62.09%,48.02%,1
新竹縣,湖口鄉,0255,809,163,972,16,988,1877,52.64%,43.1%,1
新竹縣,湖口鄉,0256,526,114,640,32,672,1082,62.11%,48.61%,1
新竹縣,湖口鄉,0257,492,152,644,42,686,1115,61.52%,44.13%,1
新竹縣,湖口鄉,0258,469,100,569,32,601,1193,50.38%,39.31%,1
新竹縣,湖口鄉,0259,813,151,964,38,1002,1947,51.46%,41.76%,1
新竹縣,湖口鄉,0260,495,135,630,48,678,1125,60.27%,44%,1
新竹縣,湖口鄉,0261,461,105,566,45,611,1050,58.19%,43.9%,1
新竹縣,湖口鄉,0262,783,170,953,46,999,1733,57.65%,45.18%,1
新竹縣,湖口鄉,0263,597,127,724,35,759,1284,59.11%,46.5%,1
新竹縣,湖口鄉,0264,515,90,605,26,631,1062,59.42%,48.49%,1
新竹縣,湖口鄉,0265,689,126,815,48,863,1547,55.79%,44.54%,1
新竹縣,湖口鄉,0266,570,131,701,36,737,1494,49.33%,38.15%,1
新竹縣,湖口鄉,0267,640,125,765,24,789,1634,48.29%,39.17%,1
新竹縣,湖口鄉,0268,564,85,649,18,667,1444,46.19%,39.06%,1
新竹縣,湖口鄉,0269,548,124,672,22,694,1324,52.42%,41.39%,1
新竹縣,湖口鄉,0270,463,108,571,30,601,1058,56.81%,43.76%,1
新竹縣,湖口鄉,0271,406,76,482,24,506,1220,41.48%,33.28%,1
新竹縣,湖口鄉,0272,571,142,713,33,746,1333,55.96%,42.84%,1
新竹縣,湖口鄉,0273,593,124,717,49,766,1461,52.43%,40.59%,1
新竹縣,湖口鄉,0274,581,144,725,21,746,1429,52.2%,40.66%,1
新竹縣,湖口鄉,0275,570,117,687,18,705,1506,46.81%,37.85%,1
新竹縣,湖口鄉,0276,535,100,635,35,670,1103,60.74%,48.5%,1
新竹縣,湖口鄉,0277,541,165,706,35,741,1495,49.57%,36.19%,1
新竹縣,湖口鄉,0278,337,67,404,30,434,752,57.71%,44.81%,1
新竹縣,湖口鄉,0279,429,90,519,25,544,986,55.17%,43.51%,1
新竹縣,新豐鄉,0280,419,107,526,51,577,1080,53.43%,38.8%,1
新竹縣,新豐鄉,0281,329,115,444,24,468,887,52.76%,37.09%,1
新竹縣,新豐鄉,0282,399,107,506,29,535,954,56.08%,41.82%,1
新竹縣,新豐鄉,0283,422,100,522,26,548,1003,54.64%,42.07%,1
新竹縣,新豐鄉,0284,467,103,570,34,604,1106,54.61%,42.22%,1
新竹縣,新豐鄉,0285,497,130,627,32,659,1123,58.68%,44.26%,1
新竹縣,新豐鄉,0286,385,98,483,39,522,891,58.59%,43.21%,1
新竹縣,新豐鄉,0287,334,82,416,24,440,874,50.34%,38.22%,1
新竹縣,新豐鄉,0288,331,98,429,30,459,824,55.7%,40.17%,1
新竹縣,新豐鄉,0289,384,83,467,22,489,975,50.15%,39.38%,1
新竹縣,新豐鄉,0290,349,80,429,48,477,847,56.32%,41.2%,1
新竹縣,新豐鄉,0291,598,156,754,79,833,1477,56.4%,40.49%,1
新竹縣,新豐鄉,0292,451,160,611,50,661,1266,52.21%,35.62%,1
新竹縣,新豐鄉,0293,390,103,493,66,559,1029,54.32%,37.9%,1
新竹縣,新豐鄉,0294,391,135,526,49,575,1063,54.09%,36.78%,1
新竹縣,新豐鄉,0295,455,104,559,27,586,1055,55.55%,43.13%,1
新竹縣,新豐鄉,0296,683,105,788,19,807,1445,55.85%,47.27%,1
新竹縣,新豐鄉,0297,692,142,834,31,865,1413,61.22%,48.97%,1
新竹縣,新豐鄉,0298,473,115,588,30,618,971,63.65%,48.71%,1
新竹縣,新豐鄉,0299,536,86,622,26,648,1135,57.09%,47.22%,1
新竹縣,新豐鄉,0300,514,129,643,37,680,1269,53.59%,40.5%,1
新竹縣,新豐鄉,0301,540,138,678,32,710,1257,56.48%,42.96%,1
新竹縣,新豐鄉,0302,775,155,930,42,972,1662,58.48%,46.63%,1
新竹縣,新豐鄉,0303,595,166,761,12,773,1486,52.02%,40.04%,1
新竹縣,新豐鄉,0304,490,119,609,58,667,1067,62.51%,45.92%,1
新竹縣,新豐鄉,0305,608,125,733,53,786,1302,60.37%,46.7%,1
新竹縣,新豐鄉,0306,570,158,728,60,788,1410,55.89%,40.43%,1
新竹縣,新豐鄉,0307,523,132,655,40,695,1267,54.85%,41.28%,1
新竹縣,新豐鄉,0308,484,107,591,41,632,1258,50.24%,38.47%,1
新竹縣,新豐鄉,0309,467,106,573,20,593,1217,48.73%,38.37%,1
新竹縣,新豐鄉,0310,614,152,766,36,802,1456,55.08%,42.17%,1
新竹縣,新豐鄉,0311,541,108,649,31,680,1157,58.77%,46.76%,1
新竹縣,新豐鄉,0312,442,101,543,29,572,1089,52.53%,40.59%,1
新竹縣,新豐鄉,0313,522,110,632,16,648,1160,55.86%,45%,1
新竹縣,新豐鄉,0314,493,96,589,19,608,976,62.3%,50.51%,1
新竹縣,新豐鄉,0315,634,138,772,38,810,1443,56.13%,43.94%,1
新竹縣,新豐鄉,0316,479,125,604,21,625,1247,50.12%,38.41%,1
新竹縣,新豐鄉,0317,638,128,766,23,789,1411,55.92%,45.22%,1
新竹縣,新豐鄉,0318,585,110,695,41,736,1238,59.45%,47.25%,1
新竹縣,芎林鄉,0319,176,58,234,9,243,417,58.27%,42.21%,1
新竹縣,芎林鄉,0320,275,75,350,22,372,534,69.66%,51.5%,1
新竹縣,芎林鄉,0321,431,104,535,30,565,963,58.67%,44.76%,1
新竹縣,芎林鄉,0322,194,56,250,21,271,418,64.83%,46.41%,1
新竹縣,芎林鄉,0323,548,131,679,41,720,1312,54.88%,41.77%,1
新竹縣,芎林鄉,0324,507,129,636,41,677,1354,50%,37.44%,1
新竹縣,芎林鄉,0325,342,90,432,38,470,785,59.87%,43.57%,1
新竹縣,芎林鄉,0326,377,78,455,34,489,797,61.36%,47.3%,1
新竹縣,芎林鄉,0327,284,68,352,22,374,623,60.03%,45.59%,1
新竹縣,芎林鄉,0328,321,84,405,30,435,759,57.31%,42.29%,1
新竹縣,芎林鄉,0329,499,113,612,33,645,1272,50.71%,39.23%,1
新竹縣,芎林鄉,0330,529,108,637,36,673,1129,59.61%,46.86%,1
新竹縣,芎林鄉,0331,328,90,418,27,445,713,62.41%,46%,1
新竹縣,芎林鄉,0332,390,91,481,40,521,839,62.1%,46.48%,1
新竹縣,芎林鄉,0333,559,142,701,32,733,1123,65.27%,49.78%,1
新竹縣,芎林鄉,0334,462,100,562,16,578,981,58.92%,47.09%,1
新竹縣,芎林鄉,0335,468,142,610,46,656,1078,60.85%,43.41%,1
新竹縣,芎林鄉,0336,462,106,568,28,596,1094,54.48%,42.23%,1
新竹縣,芎林鄉,0337,479,130,609,46,655,1102,59.44%,43.47%,1
新竹縣,橫山鄉,0338,569,137,706,46,752,1231,61.09%,46.22%,1
新竹縣,橫山鄉,0339,470,111,581,44,625,1041,60.04%,45.15%,1
新竹縣,橫山鄉,0340,520,134,654,32,686,1132,60.6%,45.94%,1
新竹縣,橫山鄉,0341,395,76,471,34,505,859,58.79%,45.98%,1
新竹縣,橫山鄉,0342,81,22,103,14,117,204,57.35%,39.71%,1
新竹縣,橫山鄉,0343,72,19,91,9,100,222,45.05%,32.43%,1
新竹縣,橫山鄉,0344,154,41,195,22,217,338,64.2%,45.56%,1
新竹縣,橫山鄉,0345,389,72,461,31,492,916,53.71%,42.47%,1
新竹縣,橫山鄉,0346,193,35,228,10,238,573,41.54%,33.68%,1
新竹縣,橫山鄉,0347,141,35,176,12,188,275,68.36%,51.27%,1
新竹縣,橫山鄉,0348,172,39,211,15,226,463,48.81%,37.15%,1
新竹縣,橫山鄉,0349,333,67,400,38,438,690,63.48%,48.26%,1
新竹縣,橫山鄉,0350,100,30,130,11,141,288,48.96%,34.72%,1
新竹縣,橫山鄉,0351,342,76,418,24,442,685,64.53%,49.93%,1
新竹縣,橫山鄉,0352,415,94,509,28,537,868,61.87%,47.81%,1
新竹縣,橫山鄉,0353,727,178,905,60,965,1561,61.82%,46.57%,1
新竹縣,北埔鄉,0354,442,105,547,17,564,1158,48.7%,38.17%,1
新竹縣,北埔鄉,0355,543,146,689,44,733,1238,59.21%,43.86%,1
新竹縣,北埔鄉,0356,248,71,319,18,337,580,58.1%,42.76%,1
新竹縣,北埔鄉,0357,422,92,514,25,539,931,57.89%,45.33%,1
新竹縣,北埔鄉,0358,724,146,870,60,930,1653,56.26%,43.8%,1
新竹縣,北埔鄉,0359,376,80,456,27,483,845,57.16%,44.5%,1
新竹縣,北埔鄉,0360,167,32,199,9,208,384,54.17%,43.49%,1
新竹縣,北埔鄉,0361,349,61,410,9,419,763,54.91%,45.74%,1
新竹縣,北埔鄉,0362,142,30,172,13,185,333,55.56%,42.64%,1
新竹縣,北埔鄉,0363,122,19,141,5,146,295,49.49%,41.36%,1
新竹縣,寶山鄉,0364,503,121,624,43,667,1158,57.6%,43.44%,1
新竹縣,寶山鄉,0365,632,167,799,24,823,1437,57.27%,43.98%,1
新竹縣,寶山鄉,0366,631,161,792,45,837,1470,56.94%,42.93%,1
新竹縣,寶山鄉,0367,521,141,662,46,708,1170,60.51%,44.53%,1
新竹縣,寶山鄉,0368,838,208,1046,54,1100,1900,57.89%,44.11%,1
新竹縣,寶山鄉,0369,412,101,513,24,537,1056,50.85%,39.02%,1
新竹縣,寶山鄉,0370,562,146,708,49,757,1205,62.82%,46.64%,1
新竹縣,寶山鄉,0371,345,67,412,28,440,766,57.44%,45.04%,1
新竹縣,寶山鄉,0372,413,72,485,32,517,846,61.11%,48.82%,1
新竹縣,寶山鄉,0373,372,89,461,28,489,804,60.82%,46.27%,1
新竹縣,寶山鄉,0374,288,60,348,13,361,607,59.47%,47.45%,1
新竹縣,寶山鄉,0375,256,84,340,12,352,554,63.54%,46.21%,1
新竹縣,峨眉鄉,0376,427,98,525,45,570,879,64.85%,48.58%,1
新竹縣,峨眉鄉,0377,309,82,391,40,431,683,63.1%,45.24%,1
新竹縣,峨眉鄉,0378,267,78,345,20,365,604,60.43%,44.21%,1
新竹縣,峨眉鄉,0379,145,36,181,18,199,339,58.7%,42.77%,1
新竹縣,峨眉鄉,0380,82,26,108,6,114,276,41.3%,29.71%,1
新竹縣,峨眉鄉,0381,639,143,782,75,857,1406,60.95%,45.45%,1
新竹縣,峨眉鄉,0382,219,46,265,24,289,462,62.55%,47.4%,1
新竹縣,峨眉鄉,0383,150,61,211,14,225,419,53.7%,35.8%,1
新竹縣,尖石鄉,0384,141,36,177,8,185,474,39.03%,29.75%,1
新竹縣,尖石鄉,0385,140,22,162,6,168,357,47.06%,39.22%,1
新竹縣,尖石鄉,0386,80,16,96,14,110,225,48.89%,35.56%,1
新竹縣,尖石鄉,0387,130,33,163,5,168,374,44.92%,34.76%,1
新竹縣,尖石鄉,0388,250,48,298,7,305,773,39.46%,32.34%,1
新竹縣,尖石鄉,0389,160,36,196,16,212,490,43.27%,32.65%,1
新竹縣,尖石鄉,0390,141,35,176,4,180,531,33.9%,26.55%,1
新竹縣,尖石鄉,0391,211,44,255,5,260,660,39.39%,31.97%,1
新竹縣,尖石鄉,0392,250,93,343,57,400,613,65.25%,40.78%,1
新竹縣,尖石鄉,0393,206,49,255,2,257,593,43.34%,34.74%,1
新竹縣,尖石鄉,0394,191,48,239,19,258,575,44.87%,33.22%,1
新竹縣,尖石鄉,0395,68,9,77,7,84,126,66.67%,53.97%,1
新竹縣,尖石鄉,0396,132,29,161,4,165,499,33.07%,26.45%,1
新竹縣,尖石鄉,0397,153,51,204,14,218,785,27.77%,19.49%,1
新竹縣,尖石鄉,0398,105,16,121,42,163,289,56.4%,36.33%,1
新竹縣,五峰鄉,0399,255,74,329,28,357,672,53.13%,37.95%,1
新竹縣,五峰鄉,0400,228,63,291,12,303,713,42.5%,31.98%,1
新竹縣,五峰鄉,0401,158,32,190,6,196,594,33%,26.6%,1
新竹縣,五峰鄉,0402,285,63,348,18,366,896,40.85%,31.81%,1
新竹縣,五峰鄉,0403,210,66,276,5,281,727,38.65%,28.89%,1
新竹縣,五峰鄉,0404,106,33,139,6,145,395,36.71%,26.84%,1
苗栗縣,苗栗市,0001,509,88,597,28,625,1087,57.5%,46.83%,1
苗栗縣,苗栗市,0002,456,82,538,33,571,1018,56.09%,44.79%,1
苗栗縣,苗栗市,0003,522,95,617,17,634,1156,54.84%,45.16%,1
苗栗縣,苗栗市,0004,496,88,584,27,611,1118,54.65%,44.36%,1
苗栗縣,苗栗市,0005,487,115,602,41,643,1084,59.32%,44.93%,1
苗栗縣,苗栗市,0006,572,113,685,33,718,1203,59.68%,47.55%,1
苗栗縣,苗栗市,0007,628,114,742,33,775,1306,59.34%,48.09%,1
苗栗縣,苗栗市,0008,537,141,678,38,716,1193,60.02%,45.01%,1
苗栗縣,苗栗市,0009,529,108,637,19,656,1115,58.83%,47.44%,1
苗栗縣,苗栗市,0010,540,106,646,39,685,1119,61.22%,48.26%,1
苗栗縣,苗栗市,0011,530,138,668,28,696,1132,61.48%,46.82%,1
苗栗縣,苗栗市,0012,598,112,710,31,741,1289,57.49%,46.39%,1
苗栗縣,苗栗市,0013,619,111,730,29,759,1264,60.05%,48.97%,1
苗栗縣,苗栗市,0014,396,77,473,19,492,870,56.55%,45.52%,1
苗栗縣,苗栗市,0015,406,80,486,27,513,1008,50.89%,40.28%,1
苗栗縣,苗栗市,0016,451,94,545,24,569,1078,52.78%,41.84%,1
苗栗縣,苗栗市,0017,520,105,625,20,645,1077,59.89%,48.28%,1
苗栗縣,苗栗市,0018,386,88,474,33,507,880,57.61%,43.86%,1
苗栗縣,苗栗市,0019,364,94,458,45,503,894,56.26%,40.72%,1
苗栗縣,苗栗市,0020,239,47,286,18,304,522,58.24%,45.79%,1
苗栗縣,苗栗市,0021,661,160,821,50,871,1376,63.3%,48.04%,1
苗栗縣,苗栗市,0022,611,112,723,27,750,1391,53.92%,43.93%,1
苗栗縣,苗栗市,0023,492,109,601,47,648,1081,59.94%,45.51%,1
苗栗縣,苗栗市,0024,551,128,679,30,709,1272,55.74%,43.32%,1
苗栗縣,苗栗市,0025,546,130,676,34,710,1112,63.85%,49.1%,1
苗栗縣,苗栗市,0026,438,89,527,17,544,813,66.91%,53.87%,1
苗栗縣,苗栗市,0027,329,89,418,19,437,767,56.98%,42.89%,1
苗栗縣,苗栗市,0028,444,102,546,17,563,1010,55.74%,43.96%,1
苗栗縣,苗栗市,0029,535,99,634,32,666,1182,56.35%,45.26%,1
苗栗縣,苗栗市,0030,445,93,538,17,555,965,57.51%,46.11%,1
苗栗縣,苗栗市,0031,293,58,351,13,364,607,59.97%,48.27%,1
苗栗縣,苗栗市,0032,478,103,581,31,612,990,61.82%,48.28%,1
苗栗縣,苗栗市,0033,510,114,624,42,666,1230,54.15%,41.46%,1
苗栗縣,苗栗市,0034,635,126,761,32,793,1372,57.8%,46.28%,1
苗栗縣,苗栗市,0035,573,99,672,33,705,1213,58.12%,47.24%,1
苗栗縣,苗栗市,0036,593,100,693,31,724,1272,56.92%,46.62%,1
苗栗縣,苗栗市,0037,597,127,724,26,750,1221,61.43%,48.89%,1
苗栗縣,苗栗市,0038,490,123,613,32,645,1104,58.42%,44.38%,1
苗栗縣,苗栗市,0039,495,92,587,18,605,1171,51.67%,42.27%,1
苗栗縣,苗栗市,0040,608,141,749,35,784,1392,56.32%,43.68%,1
苗栗縣,苗栗市,0041,609,150,759,36,795,1356,58.63%,44.91%,1
苗栗縣,苗栗市,0042,626,129,755,48,803,1387,57.89%,45.13%,1
苗栗縣,苗栗市,0043,551,106,657,34,691,1206,57.3%,45.69%,1
苗栗縣,苗栗市,0044,481,123,604,34,638,1004,63.55%,47.91%,1
苗栗縣,苗栗市,0045,509,131,640,33,673,1202,55.99%,42.35%,1
苗栗縣,苗栗市,0046,505,113,618,24,642,1052,61.03%,48%,1
苗栗縣,苗栗市,0047,430,91,521,22,543,873,62.2%,49.26%,1
苗栗縣,苗栗市,0048,524,110,634,19,653,975,66.97%,53.74%,1
苗栗縣,苗栗市,0049,514,99,613,30,643,1003,64.11%,51.25%,1
苗栗縣,苗栗市,0050,472,90,562,19,581,1000,58.1%,47.2%,1
苗栗縣,苗栗市,0051,481,81,562,28,590,1047,56.35%,45.94%,1
苗栗縣,苗栗市,0052,509,84,593,33,626,1025,61.07%,49.66%,1
苗栗縣,苗栗市,0053,499,98,597,14,611,1130,54.07%,44.16%,1
苗栗縣,苗栗市,0054,534,99,633,21,654,1146,57.07%,46.6%,1
苗栗縣,苗栗市,0055,654,136,790,44,834,1432,58.24%,45.67%,1
苗栗縣,苗栗市,0056,557,110,667,29,696,1492,46.65%,37.33%,1
苗栗縣,苗栗市,0057,540,125,665,25,690,1125,61.33%,48%,1
苗栗縣,苗栗市,0058,549,116,665,30,695,1241,56%,44.24%,1
苗栗縣,苗栗市,0059,597,132,729,38,767,1278,60.02%,46.71%,1
苗栗縣,苗栗市,0060,584,107,691,22,713,1293,55.14%,45.17%,1
苗栗縣,苗栗市,0061,559,125,684,28,712,1342,53.06%,41.65%,1
苗栗縣,苗栗市,0062,365,90,455,25,480,857,56.01%,42.59%,1
苗栗縣,苗栗市,0063,507,105,612,35,647,1180,54.83%,42.97%,1
苗栗縣,苗栗市,0064,490,114,604,32,636,1072,59.33%,45.71%,1
苗栗縣,苗栗市,0065,399,64,463,19,482,912,52.85%,43.75%,1
苗栗縣,苗栗市,0066,327,73,400,26,426,796,53.52%,41.08%,1
苗栗縣,苗栗市,0067,334,78,412,18,430,869,49.48%,38.43%,1
苗栗縣,苑裡鎮,0183,345,130,475,47,522,873,59.79%,39.52%,1
苗栗縣,苑裡鎮,0184,590,157,747,42,789,1346,58.62%,43.83%,1
苗栗縣,苑裡鎮,0185,438,128,566,52,618,951,64.98%,46.06%,1
苗栗縣,苑裡鎮,0186,235,71,306,13,319,615,51.87%,38.21%,1
苗栗縣,苑裡鎮,0187,372,110,482,67,549,878,62.53%,42.37%,1
苗栗縣,苑裡鎮,0188,346,94,440,28,468,767,61.02%,45.11%,1
苗栗縣,苑裡鎮,0189,299,99,398,35,433,776,55.8%,38.53%,1
苗栗縣,苑裡鎮,0190,458,116,574,59,633,1231,51.42%,37.21%,1
苗栗縣,苑裡鎮,0191,483,148,631,40,671,1145,58.6%,42.18%,1
苗栗縣,苑裡鎮,0192,344,90,434,34,468,850,55.06%,40.47%,1
苗栗縣,苑裡鎮,0193,399,132,531,48,579,1052,55.04%,37.93%,1
苗栗縣,苑裡鎮,0194,460,141,601,38,639,1114,57.36%,41.29%,1
苗栗縣,苑裡鎮,0195,476,140,616,59,675,1136,59.42%,41.9%,1
苗栗縣,苑裡鎮,0196,482,138,620,42,662,1194,55.44%,40.37%,1
苗栗縣,苑裡鎮,0197,684,165,849,53,902,1579,57.12%,43.32%,1
苗栗縣,苑裡鎮,0198,513,144,657,54,711,1149,61.88%,44.65%,1
苗栗縣,苑裡鎮,0199,452,136,588,52,640,1057,60.55%,42.76%,1
苗栗縣,苑裡鎮,0200,414,108,522,17,539,1101,48.96%,37.6%,1
苗栗縣,苑裡鎮,0201,287,95,382,42,424,912,46.49%,31.47%,1
苗栗縣,苑裡鎮,0202,254,77,331,33,364,652,55.83%,38.96%,1
苗栗縣,苑裡鎮,0203,572,148,720,59,779,1348,57.79%,42.43%,1
苗栗縣,苑裡鎮,0204,239,83,322,21,343,733,46.79%,32.61%,1
苗栗縣,苑裡鎮,0205,259,57,316,12,328,662,49.55%,39.12%,1
苗栗縣,苑裡鎮,0206,390,83,473,43,516,893,57.78%,43.67%,1
苗栗縣,苑裡鎮,0207,414,88,502,43,545,910,59.89%,45.49%,1
苗栗縣,苑裡鎮,0208,489,138,627,67,694,1270,54.65%,38.5%,1
苗栗縣,苑裡鎮,0209,219,49,268,24,292,545,53.58%,40.18%,1
苗栗縣,苑裡鎮,0210,369,81,450,52,502,792,63.38%,46.59%,1
苗栗縣,苑裡鎮,0211,297,86,383,34,417,726,57.44%,40.91%,1
苗栗縣,苑裡鎮,0212,266,59,325,16,341,827,41.23%,32.16%,1
苗栗縣,苑裡鎮,0213,326,88,414,49,463,782,59.21%,41.69%,1
苗栗縣,苑裡鎮,0214,320,90,410,25,435,788,55.2%,40.61%,1
苗栗縣,苑裡鎮,0215,327,94,421,40,461,846,54.49%,38.65%,1
苗栗縣,苑裡鎮,0216,359,102,461,43,504,828,60.87%,43.36%,1
苗栗縣,苑裡鎮,0217,419,99,518,32,550,943,58.32%,44.43%,1
苗栗縣,苑裡鎮,0218,478,129,607,25,632,1082,58.41%,44.18%,1
苗栗縣,苑裡鎮,0219,528,166,694,55,749,1234,60.7%,42.79%,1
苗栗縣,苑裡鎮,0220,589,143,732,52,784,1434,54.67%,41.07%,1
苗栗縣,苑裡鎮,0221,428,105,533,35,568,987,57.55%,43.36%,1
苗栗縣,苑裡鎮,0222,379,144,523,39,562,882,63.72%,42.97%,1
苗栗縣,通霄鎮,0149,429,150,579,72,651,1142,57.01%,37.57%,1
苗栗縣,通霄鎮,0150,381,129,510,62,572,884,64.71%,43.1%,1
苗栗縣,通霄鎮,0151,412,127,539,60,599,1068,56.09%,38.58%,1
苗栗縣,通霄鎮,0152,402,125,527,39,566,1009,56.1%,39.84%,1
苗栗縣,通霄鎮,0153,385,131,516,45,561,859,65.31%,44.82%,1
苗栗縣,通霄鎮,0154,518,41,559,42,601,1040,57.79%,49.81%,1
苗栗縣,通霄鎮,0155,320,89,409,11,420,1008,41.67%,31.75%,1
苗栗縣,通霄鎮,0156,273,83,356,52,408,686,59.48%,39.8%,1
苗栗縣,通霄鎮,0157,333,119,452,51,503,761,66.1%,43.76%,1
苗栗縣,通霄鎮,0158,292,82,374,23,397,790,50.25%,36.96%,1
苗栗縣,通霄鎮,0159,352,128,480,50,530,966,54.87%,36.44%,1
苗栗縣,通霄鎮,0160,350,98,448,55,503,972,51.75%,36.01%,1
苗栗縣,通霄鎮,0161,295,87,382,50,432,771,56.03%,38.26%,1
苗栗縣,通霄鎮,0162,235,62,297,31,328,758,43.27%,31%,1
苗栗縣,通霄鎮,0163,403,142,545,37,582,1078,53.99%,37.38%,1
苗栗縣,通霄鎮,0164,135,40,175,24,199,459,43.36%,29.41%,1
苗栗縣,通霄鎮,0165,322,82,404,45,449,894,50.22%,36.02%,1
苗栗縣,通霄鎮,0166,120,31,151,8,159,402,39.55%,29.85%,1
苗栗縣,通霄鎮,0167,313,92,405,29,434,802,54.11%,39.03%,1
苗栗縣,通霄鎮,0168,254,69,323,24,347,684,50.73%,37.13%,1
苗栗縣,通霄鎮,0169,313,90,403,37,440,943,46.66%,33.19%,1
苗栗縣,通霄鎮,0170,316,101,417,60,477,790,60.38%,40%,1
苗栗縣,通霄鎮,0171,260,59,319,12,331,673,49.18%,38.63%,1
苗栗縣,通霄鎮,0172,483,114,597,51,648,1232,52.6%,39.2%,1
苗栗縣,通霄鎮,0173,544,148,692,64,756,1286,58.79%,42.3%,1
苗栗縣,通霄鎮,0174,259,90,349,38,387,649,59.63%,39.91%,1
苗栗縣,通霄鎮,0175,286,78,364,22,386,769,50.2%,37.19%,1
苗栗縣,通霄鎮,0176,430,138,568,62,630,1148,54.88%,37.46%,1
苗栗縣,通霄鎮,0177,387,128,515,60,575,1138,50.53%,34.01%,1
苗栗縣,通霄鎮,0178,377,123,500,43,543,1121,48.44%,33.63%,1
苗栗縣,通霄鎮,0179,326,83,409,18,427,769,55.53%,42.39%,1
苗栗縣,通霄鎮,0180,201,81,282,15,297,616,48.21%,32.63%,1
苗栗縣,通霄鎮,0181,322,81,403,34,437,799,54.69%,40.3%,1
苗栗縣,通霄鎮,0182,286,61,347,25,372,743,50.07%,38.49%,1
苗栗縣,竹南鎮,0270,475,144,619,32,651,1086,59.94%,43.74%,1
苗栗縣,竹南鎮,0271,375,80,455,31,486,826,58.84%,45.4%,1
苗栗縣,竹南鎮,0272,409,98,507,46,553,1051,52.62%,38.92%,1
苗栗縣,竹南鎮,0273,573,121,694,40,734,1235,59.43%,46.4%,1
苗栗縣,竹南鎮,0274,441,115,556,58,614,1016,60.43%,43.41%,1
苗栗縣,竹南鎮,0275,572,169,741,55,796,1472,54.08%,38.86%,1
苗栗縣,竹南鎮,0276,494,115,609,27,636,1301,48.89%,37.97%,1
苗栗縣,竹南鎮,0277,581,160,741,38,779,1544,50.45%,37.63%,1
苗栗縣,竹南鎮,0278,639,162,801,29,830,1512,54.89%,42.26%,1
苗栗縣,竹南鎮,0279,568,158,726,48,774,1463,52.9%,38.82%,1
苗栗縣,竹南鎮,0280,433,105,538,30,568,1073,52.94%,40.35%,1
苗栗縣,竹南鎮,0281,649,151,800,34,834,1453,57.4%,44.67%,1
苗栗縣,竹南鎮,0282,593,128,721,33,754,1245,60.56%,47.63%,1
苗栗縣,竹南鎮,0283,710,153,863,26,889,1487,59.78%,47.75%,1
苗栗縣,竹南鎮,0284,431,134,565,40,605,1018,59.43%,42.34%,1
苗栗縣,竹南鎮,0285,501,129,630,26,656,1105,59.37%,45.34%,1
苗栗縣,竹南鎮,0286,511,148,659,41,700,1322,52.95%,38.65%,1
苗栗縣,竹南鎮,0287,516,123,639,21,660,1140,57.89%,45.26%,1
苗栗縣,竹南鎮,0288,514,108,622,33,655,1067,61.39%,48.17%,1
苗栗縣,竹南鎮,0289,546,133,679,38,717,1136,63.12%,48.06%,1
苗栗縣,竹南鎮,0290,509,100,609,44,653,1253,52.11%,40.62%,1
苗栗縣,竹南鎮,0291,386,87,473,40,513,963,53.27%,40.08%,1
苗栗縣,竹南鎮,0292,407,109,516,40,556,1021,54.46%,39.86%,1
苗栗縣,竹南鎮,0293,521,126,647,45,692,1154,59.97%,45.15%,1
苗栗縣,竹南鎮,0294,455,118,573,23,596,1042,57.2%,43.67%,1
苗栗縣,竹南鎮,0295,584,125,709,34,743,1293,57.46%,45.17%,1
苗栗縣,竹南鎮,0296,382,81,463,17,480,816,58.82%,46.81%,1
苗栗縣,竹南鎮,0297,432,92,524,38,562,989,56.83%,43.68%,1
苗栗縣,竹南鎮,0298,551,97,648,29,677,1122,60.34%,49.11%,1
苗栗縣,竹南鎮,0299,393,94,487,36,523,1111,47.07%,35.37%,1
苗栗縣,竹南鎮,0300,485,87,572,44,616,1036,59.46%,46.81%,1
苗栗縣,竹南鎮,0301,430,101,531,29,560,1112,50.36%,38.67%,1
苗栗縣,竹南鎮,0302,591,91,682,18,700,1348,51.93%,43.84%,1
苗栗縣,竹南鎮,0303,506,115,621,21,642,1114,57.63%,45.42%,1
苗栗縣,竹南鎮,0304,481,149,630,40,670,1119,59.87%,42.98%,1
苗栗縣,竹南鎮,0305,389,86,475,26,501,878,57.06%,44.31%,1
苗栗縣,竹南鎮,0306,505,101,606,45,651,1059,61.47%,47.69%,1
苗栗縣,竹南鎮,0307,364,111,475,40,515,869,59.26%,41.89%,1
苗栗縣,竹南鎮,0308,327,92,419,23,442,800,55.25%,40.88%,1
苗栗縣,竹南鎮,0309,548,130,678,34,712,1165,61.12%,47.04%,1
苗栗縣,竹南鎮,0310,347,81,428,34,462,791,58.41%,43.87%,1
苗栗縣,竹南鎮,0311,266,83,349,24,373,677,55.1%,39.29%,1
苗栗縣,竹南鎮,0312,390,86,476,41,517,797,64.87%,48.93%,1
苗栗縣,竹南鎮,0313,520,100,620,33,653,1191,54.83%,43.66%,1
苗栗縣,竹南鎮,0314,422,97,519,16,535,1027,52.09%,41.09%,1
苗栗縣,竹南鎮,0315,611,129,740,51,791,1341,58.99%,45.56%,1
苗栗縣,竹南鎮,0316,540,112,652,51,703,1378,51.02%,39.19%,1
苗栗縣,竹南鎮,0317,521,133,654,27,681,1216,56%,42.85%,1
苗栗縣,竹南鎮,0318,638,154,792,30,822,1570,52.36%,40.64%,1
苗栗縣,竹南鎮,0319,244,58,302,28,330,538,61.34%,45.35%,1
苗栗縣,竹南鎮,0320,439,93,532,13,545,1166,46.74%,37.65%,1
苗栗縣,竹南鎮,0321,579,166,745,31,776,1488,52.15%,38.91%,1
苗栗縣,竹南鎮,0322,585,113,698,22,720,1449,49.69%,40.37%,1
苗栗縣,竹南鎮,0323,473,124,597,64,661,1182,55.92%,40.02%,1
苗栗縣,竹南鎮,0324,474,134,608,60,668,1175,56.85%,40.34%,1
苗栗縣,竹南鎮,0325,420,100,520,37,557,983,56.66%,42.73%,1
苗栗縣,竹南鎮,0326,245,41,286,23,309,492,62.8%,49.8%,1
苗栗縣,竹南鎮,0327,461,128,589,33,622,1074,57.91%,42.92%,1
苗栗縣,竹南鎮,0328,315,113,428,40,468,852,54.93%,36.97%,1
苗栗縣,竹南鎮,0329,542,120,662,29,691,1297,53.28%,41.79%,1
苗栗縣,竹南鎮,0330,412,105,517,41,558,1028,54.28%,40.08%,1
苗栗縣,頭份市,0331,362,89,451,46,497,915,54.32%,39.56%,1
苗栗縣,頭份市,0332,557,140,697,38,735,1292,56.89%,43.11%,1
苗栗縣,頭份市,0333,117,411,528,24,552,928,59.48%,12.61%,1
苗栗縣,頭份市,0334,331,64,395,11,406,835,48.62%,39.64%,1
苗栗縣,頭份市,0335,459,101,560,27,587,1070,54.86%,42.9%,1
苗栗縣,頭份市,0336,336,82,418,12,430,879,48.92%,38.23%,1
苗栗縣,頭份市,0337,398,99,497,41,538,1039,51.78%,38.31%,1
苗栗縣,頭份市,0338,500,109,609,49,658,1129,58.28%,44.29%,1
苗栗縣,頭份市,0339,446,91,537,35,572,1041,54.95%,42.84%,1
苗栗縣,頭份市,0340,573,159,732,57,789,1546,51.03%,37.06%,1
苗栗縣,頭份市,0341,319,115,434,29,463,935,49.52%,34.12%,1
苗栗縣,頭份市,0342,449,126,575,42,617,1180,52.29%,38.05%,1
苗栗縣,頭份市,0343,598,119,717,40,757,1499,50.5%,39.89%,1
苗栗縣,頭份市,0344,339,50,389,15,404,747,54.08%,45.38%,1
苗栗縣,頭份市,0345,590,140,730,18,748,1406,53.2%,41.96%,1
苗栗縣,頭份市,0346,499,124,623,48,671,1193,56.24%,41.83%,1
苗栗縣,頭份市,0347,409,113,522,30,552,948,58.23%,43.14%,1
苗栗縣,頭份市,0348,368,69,437,27,464,869,53.39%,42.35%,1
苗栗縣,頭份市,0349,510,124,634,32,666,1142,58.32%,44.66%,1
苗栗縣,頭份市,0350,543,133,676,22,698,1286,54.28%,42.22%,1
苗栗縣,頭份市,0351,416,88,504,32,536,903,59.36%,46.07%,1
苗栗縣,頭份市,0352,567,129,696,39,735,1186,61.97%,47.81%,1
苗栗縣,頭份市,0353,488,80,568,20,588,1016,57.87%,48.03%,1
苗栗縣,頭份市,0354,435,97,532,28,560,985,56.85%,44.16%,1
苗栗縣,頭份市,0355,450,87,537,27,564,1037,54.39%,43.39%,1
苗栗縣,頭份市,0356,365,72,437,27,464,947,49%,38.54%,1
苗栗縣,頭份市,0357,409,77,486,33,519,890,58.31%,45.96%,1
苗栗縣,頭份市,0358,288,86,374,32,406,646,62.85%,44.58%,1
苗栗縣,頭份市,0359,409,129,538,42,580,975,59.49%,41.95%,1
苗栗縣,頭份市,0360,303,74,377,15,392,1015,38.62%,29.85%,1
苗栗縣,頭份市,0361,656,160,816,48,864,1399,61.76%,46.89%,1
苗栗縣,頭份市,0362,520,125,645,40,685,1143,59.93%,45.49%,1
苗栗縣,頭份市,0363,508,118,626,43,669,1030,64.95%,49.32%,1
苗栗縣,頭份市,0364,614,126,740,32,772,1338,57.7%,45.89%,1
苗栗縣,頭份市,0365,629,128,757,15,772,1450,53.24%,43.38%,1
苗栗縣,頭份市,0366,504,83,587,18,605,1042,58.06%,48.37%,1
苗栗縣,頭份市,0367,636,131,767,30,797,1326,60.11%,47.96%,1
苗栗縣,頭份市,0368,656,119,775,26,801,1270,63.07%,51.65%,1
苗栗縣,頭份市,0369,557,122,679,34,713,1288,55.36%,43.25%,1
苗栗縣,頭份市,0370,573,108,681,34,715,1243,57.52%,46.1%,1
苗栗縣,頭份市,0371,611,116,727,25,752,1280,58.75%,47.73%,1
苗栗縣,頭份市,0372,698,157,855,51,906,1618,56%,43.14%,1
苗栗縣,頭份市,0373,748,152,900,33,933,1759,53.04%,42.52%,1
苗栗縣,頭份市,0374,586,128,714,36,750,1264,59.34%,46.36%,1
苗栗縣,頭份市,0375,616,117,733,32,765,1326,57.69%,46.46%,1
苗栗縣,頭份市,0376,721,127,848,29,877,1551,56.54%,46.49%,1
苗栗縣,頭份市,0377,638,138,776,35,811,1574,51.52%,40.53%,1
苗栗縣,頭份市,0378,560,128,688,31,719,1262,56.97%,44.37%,1
苗栗縣,頭份市,0379,545,105,650,36,686,1171,58.58%,46.54%,1
苗栗縣,頭份市,0380,535,122,657,36,693,1074,64.53%,49.81%,1
苗栗縣,頭份市,0381,535,140,675,28,703,1141,61.61%,46.89%,1
苗栗縣,頭份市,0382,557,141,698,32,730,1259,57.98%,44.24%,1
苗栗縣,頭份市,0383,522,104,626,29,655,1186,55.23%,44.01%,1
苗栗縣,頭份市,0384,458,101,559,24,583,1121,52.01%,40.86%,1
苗栗縣,頭份市,0385,378,88,466,20,486,847,57.38%,44.63%,1
苗栗縣,頭份市,0386,467,107,574,24,598,993,60.22%,47.03%,1
苗栗縣,頭份市,0387,440,105,545,25,570,1055,54.03%,41.71%,1
苗栗縣,頭份市,0388,654,125,779,47,826,1655,49.91%,39.52%,1
苗栗縣,頭份市,0389,776,153,929,60,989,1799,54.97%,43.14%,1
苗栗縣,頭份市,0390,518,116,634,28,662,1141,58.02%,45.4%,1
苗栗縣,頭份市,0391,580,160,740,41,781,1431,54.58%,40.53%,1
苗栗縣,頭份市,0392,522,105,627,23,650,1412,46.03%,36.97%,1
苗栗縣,頭份市,0393,425,105,530,34,564,1074,52.51%,39.57%,1
苗栗縣,頭份市,0394,587,116,703,39,742,1245,59.6%,47.15%,1
苗栗縣,頭份市,0395,585,167,752,48,800,1344,59.52%,43.53%,1
苗栗縣,頭份市,0396,655,142,797,46,843,1363,61.85%,48.06%,1
苗栗縣,頭份市,0397,421,99,520,42,562,898,62.58%,46.88%,1
苗栗縣,頭份市,0398,532,127,659,49,708,1182,59.9%,45.01%,1
苗栗縣,頭份市,0399,598,145,743,30,773,1413,54.71%,42.32%,1
苗栗縣,頭份市,0400,468,121,589,27,616,991,62.16%,47.23%,1
苗栗縣,頭份市,0401,521,142,663,32,695,1180,58.9%,44.15%,1
苗栗縣,後龍鎮,0223,236,74,310,31,341,590,57.8%,40%,1
苗栗縣,後龍鎮,0224,406,105,511,47,558,883,63.19%,45.98%,1
苗栗縣,後龍鎮,0225,348,97,445,49,494,793,62.3%,43.88%,1
苗栗縣,後龍鎮,0226,311,98,409,30,439,732,59.97%,42.49%,1
苗栗縣,後龍鎮,0227,237,88,325,33,358,592,60.47%,40.03%,1
苗栗縣,後龍鎮,0228,477,145,622,41,663,1113,59.57%,42.86%,1
苗栗縣,後龍鎮,0229,516,111,627,50,677,1195,56.65%,43.18%,1
苗栗縣,後龍鎮,0230,477,102,579,41,620,997,62.19%,47.84%,1
苗栗縣,後龍鎮,0231,328,78,406,29,435,913,47.65%,35.93%,1
苗栗縣,後龍鎮,0232,241,66,307,28,335,641,52.26%,37.6%,1
苗栗縣,後龍鎮,0233,330,76,406,31,437,848,51.53%,38.92%,1
苗栗縣,後龍鎮,0234,486,140,626,76,702,1264,55.54%,38.45%,1
苗栗縣,後龍鎮,0235,364,92,456,33,489,965,50.67%,37.72%,1
苗栗縣,後龍鎮,0236,641,151,792,60,852,1216,70.07%,52.71%,1
苗栗縣,後龍鎮,0237,416,89,505,28,533,977,54.55%,42.58%,1
苗栗縣,後龍鎮,0238,320,102,422,53,475,943,50.37%,33.93%,1
苗栗縣,後龍鎮,0239,352,118,470,51,521,910,57.25%,38.68%,1
苗栗縣,後龍鎮,0240,352,77,429,45,474,851,55.7%,41.36%,1
苗栗縣,後龍鎮,0241,335,82,417,33,450,725,62.07%,46.21%,1
苗栗縣,後龍鎮,0242,281,68,349,40,389,650,59.85%,43.23%,1
苗栗縣,後龍鎮,0243,254,68,322,46,368,706,52.12%,35.98%,1
苗栗縣,後龍鎮,0244,292,88,380,51,431,748,57.62%,39.04%,1
苗栗縣,後龍鎮,0245,277,63,340,35,375,801,46.82%,34.58%,1
苗栗縣,後龍鎮,0246,448,129,577,48,625,1107,56.46%,40.47%,1
苗栗縣,後龍鎮,0247,473,121,594,55,649,1197,54.22%,39.52%,1
苗栗縣,後龍鎮,0248,392,93,485,41,526,1036,50.77%,37.84%,1
苗栗縣,後龍鎮,0249,281,92,373,39,412,913,45.13%,30.78%,1
苗栗縣,後龍鎮,0250,325,77,402,38,440,719,61.2%,45.2%,1
苗栗縣,後龍鎮,0251,419,94,513,86,599,1037,57.76%,40.41%,1
苗栗縣,後龍鎮,0252,234,57,291,15,306,601,50.92%,38.94%,1
苗栗縣,後龍鎮,0253,411,125,536,42,578,1269,45.55%,32.39%,1
苗栗縣,後龍鎮,0254,263,71,334,22,356,735,48.44%,35.78%,1
苗栗縣,後龍鎮,0255,99,36,135,9,144,422,34.12%,23.46%,1
苗栗縣,後龍鎮,0256,264,74,338,20,358,625,57.28%,42.24%,1
苗栗縣,後龍鎮,0257,402,123,525,50,575,1234,46.6%,32.58%,1
苗栗縣,卓蘭鎮,0442,468,76,544,42,586,961,60.98%,48.7%,1
苗栗縣,卓蘭鎮,0443,414,108,522,50,572,1017,56.24%,40.71%,1
苗栗縣,卓蘭鎮,0444,498,151,649,51,700,1095,63.93%,45.48%,1
苗栗縣,卓蘭鎮,0445,341,82,423,24,447,745,60%,45.77%,1
苗栗縣,卓蘭鎮,0446,325,80,405,24,429,783,54.79%,41.51%,1
苗栗縣,卓蘭鎮,0447,281,59,340,16,356,745,47.79%,37.72%,1
苗栗縣,卓蘭鎮,0448,383,77,460,22,482,999,48.25%,38.34%,1
苗栗縣,卓蘭鎮,0449,324,66,390,28,418,671,62.3%,48.29%,1
苗栗縣,卓蘭鎮,0450,358,80,438,41,479,734,65.26%,48.77%,1
苗栗縣,卓蘭鎮,0451,398,95,493,43,536,865,61.97%,46.01%,1
苗栗縣,卓蘭鎮,0452,381,103,484,36,520,828,62.8%,46.01%,1
苗栗縣,卓蘭鎮,0453,181,36,217,27,244,386,63.21%,46.89%,1
苗栗縣,卓蘭鎮,0454,328,80,408,36,444,688,64.53%,47.67%,1
苗栗縣,卓蘭鎮,0455,348,109,457,34,491,792,61.99%,43.94%,1
苗栗縣,卓蘭鎮,0456,330,79,409,21,430,729,58.98%,45.27%,1
苗栗縣,卓蘭鎮,0457,388,100,488,24,512,1093,46.84%,35.5%,1
苗栗縣,卓蘭鎮,0458,287,51,338,7,345,615,56.1%,46.67%,1
苗栗縣,卓蘭鎮,0459,39,2,41,2,43,86,50%,45.35%,1
苗栗縣,卓蘭鎮,0460,410,87,497,10,507,940,53.94%,43.62%,1
苗栗縣,大湖鄉,0420,312,70,382,21,403,744,54.17%,41.94%,1
苗栗縣,大湖鄉,0421,388,73,461,24,485,881,55.05%,44.04%,1
苗栗縣,大湖鄉,0422,253,53,306,33,339,596,56.88%,42.45%,1
苗栗縣,大湖鄉,0423,477,121,598,54,652,1260,51.75%,37.86%,1
苗栗縣,大湖鄉,0424,362,71,433,22,455,867,52.48%,41.75%,1
苗栗縣,大湖鄉,0425,407,72,479,31,510,923,55.25%,44.1%,1
苗栗縣,大湖鄉,0426,528,137,665,72,737,1395,52.83%,37.85%,1
苗栗縣,大湖鄉,0427,149,38,187,15,202,561,36.01%,26.56%,1
苗栗縣,大湖鄉,0428,274,77,351,19,370,638,57.99%,42.95%,1
苗栗縣,大湖鄉,0429,299,69,368,32,400,754,53.05%,39.66%,1
苗栗縣,大湖鄉,0430,186,48,234,13,247,501,49.3%,37.13%,1
苗栗縣,大湖鄉,0431,270,55,325,33,358,652,54.91%,41.41%,1
苗栗縣,大湖鄉,0432,313,75,388,20,408,843,48.4%,37.13%,1
苗栗縣,大湖鄉,0433,449,91,540,38,578,1020,56.67%,44.02%,1
苗栗縣,大湖鄉,0434,461,87,548,31,579,1018,56.88%,45.28%,1
苗栗縣,公館鄉,0068,365,112,477,43,520,789,65.91%,46.26%,1
苗栗縣,公館鄉,0069,405,84,489,32,521,792,65.78%,51.14%,1
苗栗縣,公館鄉,0070,505,147,652,65,717,1117,64.19%,45.21%,1
苗栗縣,公館鄉,0071,574,157,731,54,785,1255,62.55%,45.74%,1
苗栗縣,公館鄉,0072,532,118,650,34,684,1141,59.95%,46.63%,1
苗栗縣,公館鄉,0073,532,125,657,30,687,1172,58.62%,45.39%,1
苗栗縣,公館鄉,0074,542,120,662,33,695,1100,63.18%,49.27%,1
苗栗縣,公館鄉,0075,496,115,611,41,652,1232,52.92%,40.26%,1
苗栗縣,公館鄉,0076,431,96,527,42,569,1081,52.64%,39.87%,1
苗栗縣,公館鄉,0077,628,101,729,46,775,1250,62%,50.24%,1
苗栗縣,公館鄉,0078,480,118,598,33,631,1081,58.37%,44.4%,1
苗栗縣,公館鄉,0079,403,100,503,50,553,964,57.37%,41.8%,1
苗栗縣,公館鄉,0080,459,126,585,47,632,1038,60.89%,44.22%,1
苗栗縣,公館鄉,0081,159,53,212,15,227,360,63.06%,44.17%,1
苗栗縣,公館鄉,0082,362,93,455,43,498,865,57.57%,41.85%,1
苗栗縣,公館鄉,0083,496,122,618,34,652,1166,55.92%,42.54%,1
苗栗縣,公館鄉,0084,333,81,414,16,430,719,59.81%,46.31%,1
苗栗縣,公館鄉,0085,326,76,402,33,435,788,55.2%,41.37%,1
苗栗縣,公館鄉,0086,140,35,175,27,202,303,66.67%,46.2%,1
苗栗縣,公館鄉,0087,614,142,756,38,794,1322,60.06%,46.44%,1
苗栗縣,公館鄉,0088,401,97,498,37,535,933,57.34%,42.98%,1
苗栗縣,公館鄉,0089,616,131,747,45,792,1455,54.43%,42.34%,1
苗栗縣,公館鄉,0090,753,181,934,65,999,1615,61.86%,46.63%,1
苗栗縣,公館鄉,0091,628,134,762,43,805,1451,55.48%,43.28%,1
苗栗縣,公館鄉,0092,666,166,832,50,882,1462,60.33%,45.55%,1
苗栗縣,公館鄉,0093,552,144,696,41,737,1317,55.96%,41.91%,1
苗栗縣,公館鄉,0094,103,20,123,8,131,221,59.28%,46.61%,1
苗栗縣,公館鄉,0095,133,33,166,9,175,329,53.19%,40.43%,1
苗栗縣,銅鑼鄉,0108,438,85,523,25,548,887,61.78%,49.38%,1
苗栗縣,銅鑼鄉,0109,492,101,593,37,630,1052,59.89%,46.77%,1
苗栗縣,銅鑼鄉,0110,648,151,799,27,826,1347,61.32%,48.11%,1
苗栗縣,銅鑼鄉,0111,529,116,645,27,672,1177,57.09%,44.94%,1
苗栗縣,銅鑼鄉,0112,528,122,650,33,683,1268,53.86%,41.64%,1
苗栗縣,銅鑼鄉,0113,440,111,551,26,577,1185,48.69%,37.13%,1
苗栗縣,銅鑼鄉,0114,484,79,563,33,596,1029,57.92%,47.04%,1
苗栗縣,銅鑼鄉,0115,421,74,495,26,521,905,57.57%,46.52%,1
苗栗縣,銅鑼鄉,0116,347,92,439,27,466,750,62.13%,46.27%,1
苗栗縣,銅鑼鄉,0117,437,95,532,32,564,1080,52.22%,40.46%,1
苗栗縣,銅鑼鄉,0118,450,118,568,33,601,1108,54.24%,40.61%,1
苗栗縣,銅鑼鄉,0119,376,56,432,25,457,862,53.02%,43.62%,1
苗栗縣,銅鑼鄉,0120,500,125,625,22,647,1216,53.21%,41.12%,1
苗栗縣,銅鑼鄉,0121,223,54,277,26,303,588,51.53%,37.93%,1
苗栗縣,銅鑼鄉,0122,165,43,208,26,234,429,54.55%,38.46%,1
苗栗縣,銅鑼鄉,0123,248,50,298,19,317,541,58.6%,45.84%,1
苗栗縣,南庄鄉,0411,473,115,588,51,639,1155,55.32%,40.95%,1
苗栗縣,南庄鄉,0412,252,72,324,43,367,650,56.46%,38.77%,1
苗栗縣,南庄鄉,0413,407,234,641,58,699,1353,51.66%,30.08%,1
苗栗縣,南庄鄉,0414,276,50,326,29,355,813,43.67%,33.95%,1
苗栗縣,南庄鄉,0415,274,61,335,22,357,837,42.65%,32.74%,1
苗栗縣,南庄鄉,0416,446,103,549,25,574,1093,52.52%,40.81%,1
苗栗縣,南庄鄉,0417,390,130,520,50,570,1048,54.39%,37.21%,1
苗栗縣,南庄鄉,0418,340,80,420,27,447,872,51.26%,38.99%,1
苗栗縣,南庄鄉,0419,246,48,294,6,300,963,31.15%,25.55%,1
苗栗縣,頭屋鄉,0096,751,98,849,44,893,1335,66.89%,56.25%,1
苗栗縣,頭屋鄉,0097,637,144,781,48,829,1168,70.98%,54.54%,1
苗栗縣,頭屋鄉,0098,386,110,496,20,516,792,65.15%,48.74%,1
苗栗縣,頭屋鄉,0099,515,105,620,38,658,918,71.68%,56.1%,1
苗栗縣,頭屋鄉,0100,364,74,438,24,462,725,63.72%,50.21%,1
苗栗縣,頭屋鄉,0101,445,89,534,22,556,899,61.85%,49.5%,1
苗栗縣,頭屋鄉,0102,139,32,171,10,181,369,49.05%,37.67%,1
苗栗縣,頭屋鄉,0103,377,110,487,17,504,844,59.72%,44.67%,1
苗栗縣,頭屋鄉,0104,469,99,568,25,593,1007,58.89%,46.57%,1
苗栗縣,頭屋鄉,0105,394,78,472,28,500,794,62.97%,49.62%,1
苗栗縣,頭屋鄉,0106,120,23,143,14,157,211,74.41%,56.87%,1
苗栗縣,頭屋鄉,0107,169,50,219,18,237,328,72.26%,51.52%,1
苗栗縣,三義鄉,0124,405,84,489,34,523,853,61.31%,47.48%,1
苗栗縣,三義鄉,0125,500,88,588,23,611,983,62.16%,50.86%,1
苗栗縣,三義鄉,0126,509,104,613,35,648,1080,60%,47.13%,1
苗栗縣,三義鄉,0127,514,112,626,22,648,1216,53.29%,42.27%,1
苗栗縣,三義鄉,0128,493,85,578,25,603,1017,59.29%,48.48%,1
苗栗縣,三義鄉,0129,504,96,600,32,632,1180,53.56%,42.71%,1
苗栗縣,三義鄉,0130,573,96,669,15,684,1198,57.1%,47.83%,1
苗栗縣,三義鄉,0131,185,39,224,17,241,417,57.79%,44.36%,1
苗栗縣,三義鄉,0132,386,96,482,33,515,991,51.97%,38.95%,1
苗栗縣,三義鄉,0133,389,88,477,12,489,834,58.63%,46.64%,1
苗栗縣,三義鄉,0134,276,66,342,24,366,622,58.84%,44.37%,1
苗栗縣,三義鄉,0135,348,79,427,32,459,749,61.28%,46.46%,1
苗栗縣,三義鄉,0136,364,75,439,21,460,692,66.47%,52.6%,1
苗栗縣,三義鄉,0137,406,94,500,35,535,759,70.49%,53.49%,1
苗栗縣,三義鄉,0138,258,54,312,23,335,629,53.26%,41.02%,1
苗栗縣,三義鄉,0139,278,78,356,30,386,669,57.7%,41.55%,1
苗栗縣,西湖鄉,0140,253,58,311,14,325,601,54.08%,42.1%,1
苗栗縣,西湖鄉,0141,277,45,322,19,341,566,60.25%,48.94%,1
苗栗縣,西湖鄉,0142,371,93,464,26,490,843,58.13%,44.01%,1
苗栗縣,西湖鄉,0143,259,70,329,13,342,648,52.78%,39.97%,1
苗栗縣,西湖鄉,0144,360,95,455,19,474,936,50.64%,38.46%,1
苗栗縣,西湖鄉,0145,199,42,241,6,247,461,53.58%,43.17%,1
苗栗縣,西湖鄉,0146,237,45,282,13,295,515,57.28%,46.02%,1
苗栗縣,西湖鄉,0147,464,102,566,49,615,1141,53.9%,40.67%,1
苗栗縣,西湖鄉,0148,304,67,371,25,396,671,59.02%,45.31%,1
苗栗縣,造橋鄉,0258,590,122,712,52,764,1171,65.24%,50.38%,1
苗栗縣,造橋鄉,0259,403,89,492,33,525,889,59.06%,45.33%,1
苗栗縣,造橋鄉,0260,186,32,218,18,236,479,49.27%,38.83%,1
苗栗縣,造橋鄉,0261,451,107,558,44,602,1024,58.79%,44.04%,1
苗栗縣,造橋鄉,0262,447,156,603,54,657,1214,54.12%,36.82%,1
苗栗縣,造橋鄉,0263,426,97,523,39,562,1071,52.47%,39.78%,1
苗栗縣,造橋鄉,0264,452,103,555,51,606,1157,52.38%,39.07%,1
苗栗縣,造橋鄉,0265,224,47,271,26,297,512,58.01%,43.75%,1
苗栗縣,造橋鄉,0266,245,44,289,21,310,491,63.14%,49.9%,1
苗栗縣,造橋鄉,0267,581,131,712,54,766,1272,60.22%,45.68%,1
苗栗縣,造橋鄉,0268,333,85,418,33,451,785,57.45%,42.42%,1
苗栗縣,造橋鄉,0269,406,143,549,90,639,962,66.42%,42.2%,1
苗栗縣,三灣鄉,0402,462,97,559,36,595,996,59.74%,46.39%,1
苗栗縣,三灣鄉,0403,495,137,632,59,691,1205,57.34%,41.08%,1
苗栗縣,三灣鄉,0404,274,80,354,33,387,635,60.94%,43.15%,1
苗栗縣,三灣鄉,0405,351,103,454,39,493,862,57.19%,40.72%,1
苗栗縣,三灣鄉,0406,92,17,109,9,118,238,49.58%,38.66%,1
苗栗縣,三灣鄉,0407,215,55,270,23,293,541,54.16%,39.74%,1
苗栗縣,三灣鄉,0408,217,59,276,22,298,578,51.56%,37.54%,1
苗栗縣,三灣鄉,0409,192,60,252,26,278,405,68.64%,47.41%,1
苗栗縣,三灣鄉,0410,166,43,209,13,222,392,56.63%,42.35%,1
苗栗縣,獅潭鄉,0435,108,13,121,6,127,328,38.72%,32.93%,1
苗栗縣,獅潭鄉,0436,178,40,218,30,248,565,43.89%,31.5%,1
苗栗縣,獅潭鄉,0437,389,86,475,49,524,911,57.52%,42.7%,1
苗栗縣,獅潭鄉,0438,197,54,251,17,268,568,47.18%,34.68%,1
苗栗縣,獅潭鄉,0439,265,56,321,20,341,580,58.79%,45.69%,1
苗栗縣,獅潭鄉,0440,139,22,161,5,166,333,49.85%,41.74%,1
苗栗縣,獅潭鄉,0441,276,53,329,16,345,683,50.51%,40.41%,1
苗栗縣,泰安鄉,0461,109,28,137,10,147,325,45.23%,33.54%,1
苗栗縣,泰安鄉,0462,207,56,263,22,285,484,58.88%,42.77%,1
苗栗縣,泰安鄉,0463,344,98,442,44,486,666,72.97%,51.65%,1
苗栗縣,泰安鄉,0464,282,70,352,38,390,574,67.94%,49.13%,1
苗栗縣,泰安鄉,0465,138,22,160,11,171,333,51.35%,41.44%,1
苗栗縣,泰安鄉,0466,272,51,323,12,335,495,67.68%,54.95%,1
苗栗縣,泰安鄉,0467,290,70,360,32,392,544,72.06%,53.31%,1
苗栗縣,泰安鄉,0468,173,48,221,15,236,500,47.2%,34.6%,1
苗栗縣,泰安鄉,0469,332,96,428,51,479,670,71.49%,49.55%,1
苗栗縣,泰安鄉,0470,371,77,448,5,453,589,76.91%,62.99%,1
彰化縣,彰化市,0001,382,98,480,33,513,871,58.9%,43.86%,1
彰化縣,彰化市,0002,263,65,328,34,362,751,48.2%,35.02%,1
彰化縣,彰化市,0003,450,120,570,38,608,923,65.87%,48.75%,1
彰化縣,彰化市,0004,323,116,439,45,484,779,62.13%,41.46%,1
彰化縣,彰化市,0005,345,100,445,36,481,779,61.75%,44.29%,1
彰化縣,彰化市,0006,293,90,383,41,424,720,58.89%,40.69%,1
彰化縣,彰化市,0007,318,92,410,35,445,749,59.41%,42.46%,1
彰化縣,彰化市,0008,385,82,467,33,500,767,65.19%,50.2%,1
彰化縣,彰化市,0009,463,131,594,59,653,1047,62.37%,44.22%,1
彰化縣,彰化市,0010,426,119,545,37,582,1027,56.67%,41.48%,1
彰化縣,彰化市,0011,521,132,653,62,715,1249,57.25%,41.71%,1
彰化縣,彰化市,0012,511,146,657,40,697,1136,61.36%,44.98%,1
彰化縣,彰化市,0013,533,135,668,55,723,1169,61.85%,45.59%,1
彰化縣,彰化市,0014,362,96,458,25,483,766,63.05%,47.26%,1
彰化縣,彰化市,0015,284,72,356,22,378,643,58.79%,44.17%,1
彰化縣,彰化市,0016,566,121,687,55,742,1251,59.31%,45.24%,1
彰化縣,彰化市,0017,366,111,477,31,508,1301,39.05%,28.13%,1
彰化縣,彰化市,0018,595,132,727,41,768,1280,60%,46.48%,1
彰化縣,彰化市,0019,559,127,686,40,726,1179,61.58%,47.41%,1
彰化縣,彰化市,0020,537,119,656,32,688,1168,58.9%,45.98%,1
彰化縣,彰化市,0021,536,135,671,44,715,1218,58.7%,44.01%,1
彰化縣,彰化市,0022,688,132,820,50,870,1351,64.4%,50.93%,1
彰化縣,彰化市,0023,530,163,693,29,722,1204,59.97%,44.02%,1
彰化縣,彰化市,0024,567,122,689,18,707,1189,59.46%,47.69%,1
彰化縣,彰化市,0025,509,125,634,52,686,1207,56.84%,42.17%,1
彰化縣,彰化市,0026,544,95,639,52,691,1161,59.52%,46.86%,1
彰化縣,彰化市,0027,454,162,616,38,654,1166,56.09%,38.94%,1
彰化縣,彰化市,0028,643,143,786,48,834,1362,61.23%,47.21%,1
彰化縣,彰化市,0029,559,173,732,38,770,1236,62.3%,45.23%,1
彰化縣,彰化市,0030,491,122,613,41,654,1065,61.41%,46.1%,1
彰化縣,彰化市,0031,537,131,668,55,723,1199,60.3%,44.79%,1
彰化縣,彰化市,0032,561,152,713,31,744,1233,60.34%,45.5%,1
彰化縣,彰化市,0033,573,119,692,29,721,1245,57.91%,46.02%,1
彰化縣,彰化市,0034,519,151,670,34,704,1153,61.06%,45.01%,1
彰化縣,彰化市,0035,441,110,551,42,593,1045,56.75%,42.2%,1
彰化縣,彰化市,0036,476,137,613,19,632,1097,57.61%,43.39%,1
彰化縣,彰化市,0037,521,131,652,40,692,1190,58.15%,43.78%,1
彰化縣,彰化市,0038,510,143,653,40,693,1106,62.66%,46.11%,1
彰化縣,彰化市,0039,510,120,630,32,662,1097,60.35%,46.49%,1
彰化縣,彰化市,0040,464,133,597,44,641,1048,61.16%,44.27%,1
彰化縣,彰化市,0041,485,103,588,30,618,980,63.06%,49.49%,1
彰化縣,彰化市,0042,324,98,422,22,444,707,62.8%,45.83%,1
彰化縣,彰化市,0043,366,91,457,32,489,809,60.44%,45.24%,1
彰化縣,彰化市,0044,447,135,582,48,630,1008,62.5%,44.35%,1
彰化縣,彰化市,0045,360,103,463,50,513,901,56.94%,39.96%,1
彰化縣,彰化市,0046,408,111,519,29,548,951,57.62%,42.9%,1
彰化縣,彰化市,0047,499,117,616,33,649,1076,60.32%,46.38%,1
彰化縣,彰化市,0048,394,135,529,34,563,1022,55.09%,38.55%,1
彰化縣,彰化市,0049,380,109,489,46,535,894,59.84%,42.51%,1
彰化縣,彰化市,0050,454,134,588,38,626,1016,61.61%,44.69%,1
彰化縣,彰化市,0051,340,111,451,44,495,771,64.2%,44.1%,1
彰化縣,彰化市,0052,366,118,484,43,527,868,60.71%,42.17%,1
彰化縣,彰化市,0053,487,142,629,60,689,1135,60.7%,42.91%,1
彰化縣,彰化市,0054,363,132,495,61,556,910,61.1%,39.89%,1
彰化縣,彰化市,0055,442,128,570,33,603,1004,60.06%,44.02%,1
彰化縣,彰化市,0056,508,118,626,45,671,1077,62.3%,47.17%,1
彰化縣,彰化市,0057,644,131,775,53,828,1258,65.82%,51.19%,1
彰化縣,彰化市,0058,512,108,620,32,652,1025,63.61%,49.95%,1
彰化縣,彰化市,0059,565,122,687,56,743,1177,63.13%,48%,1
彰化縣,彰化市,0060,553,121,674,43,717,1262,56.81%,43.82%,1
彰化縣,彰化市,0061,572,134,706,51,757,1209,62.61%,47.31%,1
彰化縣,彰化市,0062,507,120,627,34,661,1041,63.5%,48.7%,1
彰化縣,彰化市,0063,516,111,627,38,665,1075,61.86%,48%,1
彰化縣,彰化市,0064,439,93,532,59,591,1029,57.43%,42.66%,1
彰化縣,彰化市,0065,496,129,625,74,699,1203,58.1%,41.23%,1
彰化縣,彰化市,0066,431,116,547,38,585,1014,57.69%,42.5%,1
彰化縣,彰化市,0067,483,126,609,37,646,1069,60.43%,45.18%,1
彰化縣,彰化市,0068,390,83,473,24,497,969,51.29%,40.25%,1
彰化縣,彰化市,0069,445,110,555,38,593,1105,53.67%,40.27%,1
彰化縣,彰化市,0070,469,114,583,40,623,981,63.51%,47.81%,1
彰化縣,彰化市,0071,500,237,737,52,789,1095,72.05%,45.66%,1
彰化縣,彰化市,0072,534,122,656,23,679,1087,62.47%,49.13%,1
彰化縣,彰化市,0073,472,128,600,37,637,1050,60.67%,44.95%,1
彰化縣,彰化市,0074,582,138,720,52,772,1252,61.66%,46.49%,1
彰化縣,彰化市,0075,473,111,584,34,618,1113,55.53%,42.5%,1
彰化縣,彰化市,0076,494,114,608,27,635,1009,62.93%,48.96%,1
彰化縣,彰化市,0077,436,107,543,35,578,999,57.86%,43.64%,1
彰化縣,彰化市,0078,439,106,545,25,570,997,57.17%,44.03%,1
彰化縣,彰化市,0079,566,141,707,41,748,1145,65.33%,49.43%,1
彰化縣,彰化市,0080,558,136,694,24,718,1227,58.52%,45.48%,1
彰化縣,彰化市,0081,561,158,719,33,752,1208,62.25%,46.44%,1
彰化縣,彰化市,0082,730,157,887,40,927,1598,58.01%,45.68%,1
彰化縣,彰化市,0083,425,87,512,37,549,890,61.69%,47.75%,1
彰化縣,彰化市,0084,540,135,675,32,707,1104,64.04%,48.91%,1
彰化縣,彰化市,0085,498,109,607,25,632,1097,57.61%,45.4%,1
彰化縣,彰化市,0086,356,77,433,34,467,799,58.45%,44.56%,1
彰化縣,彰化市,0087,474,99,573,46,619,1000,61.9%,47.4%,1
彰化縣,彰化市,0088,481,126,607,67,674,1153,58.46%,41.72%,1
彰化縣,彰化市,0089,442,117,559,44,603,977,61.72%,45.24%,1
彰化縣,彰化市,0090,501,143,644,52,696,1201,57.95%,41.72%,1
彰化縣,彰化市,0091,456,160,616,47,663,1057,62.72%,43.14%,1
彰化縣,彰化市,0092,513,144,657,68,725,1238,58.56%,41.44%,1
彰化縣,彰化市,0093,550,153,703,44,747,1210,61.74%,45.45%,1
彰化縣,彰化市,0094,492,107,599,37,636,1026,61.99%,47.95%,1
彰化縣,彰化市,0095,534,121,655,36,691,1061,65.13%,50.33%,1
彰化縣,彰化市,0096,540,134,674,49,723,1213,59.6%,44.52%,1
彰化縣,彰化市,0097,578,152,730,38,768,1264,60.76%,45.73%,1
彰化縣,彰化市,0098,317,100,417,46,463,691,67%,45.88%,1
彰化縣,彰化市,0099,413,121,534,42,576,893,64.5%,46.25%,1
彰化縣,彰化市,0100,314,96,410,47,457,733,62.35%,42.84%,1
彰化縣,彰化市,0101,301,110,411,33,444,692,64.16%,43.5%,1
彰化縣,彰化市,0102,325,78,403,31,434,728,59.62%,44.64%,1
彰化縣,彰化市,0103,368,111,479,33,512,773,66.24%,47.61%,1
彰化縣,彰化市,0104,386,90,476,14,490,975,50.26%,39.59%,1
彰化縣,彰化市,0105,397,114,511,44,555,908,61.12%,43.72%,1
彰化縣,彰化市,0106,505,159,664,6,670,1156,57.96%,43.69%,1
彰化縣,彰化市,0107,544,161,705,49,754,1235,61.05%,44.05%,1
彰化縣,彰化市,0108,567,146,713,51,764,1376,55.52%,41.21%,1
彰化縣,彰化市,0109,607,149,756,33,789,1389,56.8%,43.7%,1
彰化縣,彰化市,0110,396,121,517,42,559,846,66.08%,46.81%,1
彰化縣,彰化市,0111,424,100,524,30,554,859,64.49%,49.36%,1
彰化縣,彰化市,0112,338,119,457,28,485,781,62.1%,43.28%,1
彰化縣,彰化市,0113,379,105,484,34,518,875,59.2%,43.31%,1
彰化縣,彰化市,0114,347,109,456,29,485,816,59.44%,42.52%,1
彰化縣,彰化市,0115,305,92,397,38,435,687,63.32%,44.4%,1
彰化縣,彰化市,0116,352,87,439,34,473,727,65.06%,48.42%,1
彰化縣,彰化市,0117,303,96,399,26,425,662,64.2%,45.77%,1
彰化縣,彰化市,0118,303,81,384,21,405,633,63.98%,47.87%,1
彰化縣,彰化市,0119,417,133,550,37,587,906,64.79%,46.03%,1
彰化縣,彰化市,0120,353,98,451,39,490,853,57.44%,41.38%,1
彰化縣,彰化市,0121,478,129,607,37,644,1027,62.71%,46.54%,1
彰化縣,彰化市,0122,489,101,590,43,633,993,63.75%,49.24%,1
彰化縣,彰化市,0123,376,102,478,45,523,848,61.67%,44.34%,1
彰化縣,彰化市,0124,559,123,682,22,704,1118,62.97%,50%,1
彰化縣,彰化市,0125,540,147,687,74,761,1263,60.25%,42.76%,1
彰化縣,彰化市,0126,626,132,758,39,797,1268,62.85%,49.37%,1
彰化縣,彰化市,0127,569,146,715,57,772,1258,61.37%,45.23%,1
彰化縣,彰化市,0128,580,136,716,29,745,1212,61.47%,47.85%,1
彰化縣,彰化市,0129,427,95,522,51,573,924,62.01%,46.21%,1
彰化縣,彰化市,0130,456,113,569,28,597,939,63.58%,48.56%,1
彰化縣,彰化市,0131,464,125,589,56,645,953,67.68%,48.69%,1
彰化縣,彰化市,0132,511,99,610,40,650,981,66.26%,52.09%,1
彰化縣,彰化市,0133,579,134,713,66,779,1249,62.37%,46.36%,1
彰化縣,彰化市,0134,365,95,460,50,510,817,62.42%,44.68%,1
彰化縣,彰化市,0135,386,101,487,46,533,872,61.12%,44.27%,1
彰化縣,彰化市,0136,308,63,371,28,399,689,57.91%,44.7%,1
彰化縣,彰化市,0137,569,118,687,28,715,1156,61.85%,49.22%,1
彰化縣,彰化市,0138,583,124,707,31,738,1291,57.16%,45.16%,1
彰化縣,彰化市,0139,516,116,632,27,659,1139,57.86%,45.3%,1
彰化縣,彰化市,0140,538,115,653,42,695,1125,61.78%,47.82%,1
彰化縣,彰化市,0141,546,104,650,53,703,1258,55.88%,43.4%,1
彰化縣,彰化市,0142,510,116,626,37,663,1123,59.04%,45.41%,1
彰化縣,彰化市,0143,517,138,655,46,701,1175,59.66%,44%,1
彰化縣,彰化市,0144,417,124,541,29,570,862,66.13%,48.38%,1
彰化縣,彰化市,0145,377,112,489,39,528,872,60.55%,43.23%,1
彰化縣,彰化市,0146,456,110,566,15,581,897,64.77%,50.84%,1
彰化縣,彰化市,0147,450,88,538,21,559,1003,55.73%,44.87%,1
彰化縣,彰化市,0148,393,93,486,22,508,915,55.52%,42.95%,1
彰化縣,彰化市,0149,501,125,626,42,668,1158,57.69%,43.26%,1
彰化縣,彰化市,0150,533,115,648,36,684,1084,63.1%,49.17%,1
彰化縣,彰化市,0151,575,146,721,59,780,1372,56.85%,41.91%,1
彰化縣,彰化市,0152,498,137,635,42,677,1113,60.83%,44.74%,1
彰化縣,彰化市,0153,402,81,483,24,507,800,63.38%,50.25%,1
彰化縣,彰化市,0154,402,109,511,42,553,885,62.49%,45.42%,1
彰化縣,彰化市,0155,487,106,593,13,606,1000,60.6%,48.7%,1
彰化縣,彰化市,0156,487,99,586,43,629,1159,54.27%,42.02%,1
彰化縣,彰化市,0157,497,108,605,36,641,1123,57.08%,44.26%,1
彰化縣,彰化市,0158,398,144,542,61,603,907,66.48%,43.88%,1
彰化縣,彰化市,0159,401,95,496,65,561,989,56.72%,40.55%,1
彰化縣,彰化市,0160,457,115,572,66,638,1012,63.04%,45.16%,1
彰化縣,彰化市,0161,418,101,519,27,546,1033,52.86%,40.46%,1
彰化縣,彰化市,0162,526,114,640,40,680,1116,60.93%,47.13%,1
彰化縣,彰化市,0163,565,118,683,26,709,1154,61.44%,48.96%,1
彰化縣,彰化市,0164,514,117,631,36,667,1064,62.69%,48.31%,1
彰化縣,彰化市,0165,362,105,467,36,503,770,65.32%,47.01%,1
彰化縣,彰化市,0166,402,131,533,24,557,889,62.65%,45.22%,1
彰化縣,彰化市,0167,368,81,449,53,502,786,63.87%,46.82%,1
彰化縣,彰化市,0168,427,140,567,52,619,1120,55.27%,38.13%,1
彰化縣,彰化市,0169,538,110,648,29,677,1269,53.35%,42.4%,1
彰化縣,彰化市,0170,527,132,659,46,705,1159,60.83%,45.47%,1
彰化縣,彰化市,0171,519,154,673,54,727,1184,61.4%,43.83%,1
彰化縣,彰化市,0172,465,132,597,38,635,1089,58.31%,42.7%,1
彰化縣,彰化市,0173,421,116,537,52,589,968,60.85%,43.49%,1
彰化縣,彰化市,0174,430,87,517,28,545,930,58.6%,46.24%,1
彰化縣,彰化市,0175,449,115,564,31,595,973,61.15%,46.15%,1
彰化縣,彰化市,0176,451,125,576,31,607,1184,51.27%,38.09%,1
彰化縣,彰化市,0177,444,120,564,51,615,1002,61.38%,44.31%,1
彰化縣,彰化市,0178,520,98,618,22,640,1148,55.75%,45.3%,1
彰化縣,彰化市,0179,494,105,599,47,646,1112,58.09%,44.42%,1
彰化縣,彰化市,0180,488,89,577,44,621,907,68.47%,53.8%,1
彰化縣,彰化市,0181,526,97,623,58,681,1112,61.24%,47.3%,1
彰化縣,彰化市,0182,315,73,388,36,424,823,51.52%,38.27%,1
彰化縣,彰化市,0183,587,97,684,71,755,1276,59.17%,46%,1
彰化縣,彰化市,0184,485,115,600,59,659,1161,56.76%,41.77%,1
彰化縣,鹿港鎮,0243,503,155,658,53,711,1140,62.37%,44.12%,1
彰化縣,鹿港鎮,0244,214,61,275,29,304,511,59.49%,41.88%,1
彰化縣,鹿港鎮,0245,304,71,375,25,400,857,46.67%,35.47%,1
彰化縣,鹿港鎮,0246,435,119,554,55,609,946,64.38%,45.98%,1
彰化縣,鹿港鎮,0247,425,103,528,35,563,945,59.58%,44.97%,1
彰化縣,鹿港鎮,0248,483,115,598,50,648,1097,59.07%,44.03%,1
彰化縣,鹿港鎮,0249,545,127,672,38,710,1479,48.01%,36.85%,1
彰化縣,鹿港鎮,0250,622,149,771,82,853,1425,59.86%,43.65%,1
彰化縣,鹿港鎮,0251,396,98,494,68,562,880,63.86%,45%,1
彰化縣,鹿港鎮,0252,459,132,591,67,658,1183,55.62%,38.8%,1
彰化縣,鹿港鎮,0253,451,122,573,72,645,1047,61.6%,43.08%,1
彰化縣,鹿港鎮,0254,426,114,540,22,562,1097,51.23%,38.83%,1
彰化縣,鹿港鎮,0255,449,98,547,46,593,1030,57.57%,43.59%,1
彰化縣,鹿港鎮,0256,509,115,624,42,666,1161,57.36%,43.84%,1
彰化縣,鹿港鎮,0257,232,56,288,52,340,540,62.96%,42.96%,1
彰化縣,鹿港鎮,0258,474,127,601,44,645,1135,56.83%,41.76%,1
彰化縣,鹿港鎮,0259,481,128,609,57,666,1155,57.66%,41.65%,1
彰化縣,鹿港鎮,0260,538,115,653,43,696,1127,61.76%,47.74%,1
彰化縣,鹿港鎮,0261,445,131,576,47,623,1045,59.62%,42.58%,1
彰化縣,鹿港鎮,0262,452,149,601,64,665,1127,59.01%,40.11%,1
彰化縣,鹿港鎮,0263,549,145,694,77,771,1178,65.45%,46.6%,1
彰化縣,鹿港鎮,0264,124,28,152,17,169,284,59.51%,43.66%,1
彰化縣,鹿港鎮,0265,236,74,310,35,345,584,59.08%,40.41%,1
彰化縣,鹿港鎮,0266,312,83,395,38,433,659,65.71%,47.34%,1
彰化縣,鹿港鎮,0267,368,101,469,16,485,915,53.01%,40.22%,1
彰化縣,鹿港鎮,0268,487,123,610,64,674,1079,62.47%,45.13%,1
彰化縣,鹿港鎮,0269,534,127,661,69,730,1129,64.66%,47.3%,1
彰化縣,鹿港鎮,0270,508,128,636,67,703,1273,55.22%,39.91%,1
彰化縣,鹿港鎮,0271,282,52,334,37,371,706,52.55%,39.94%,1
彰化縣,鹿港鎮,0272,442,95,537,93,630,1137,55.41%,38.87%,1
彰化縣,鹿港鎮,0273,495,120,615,47,662,1195,55.4%,41.42%,1
彰化縣,鹿港鎮,0274,504,111,615,46,661,1225,53.96%,41.14%,1
彰化縣,鹿港鎮,0275,478,97,575,55,630,957,65.83%,49.95%,1
彰化縣,鹿港鎮,0276,274,64,338,64,402,758,53.03%,36.15%,1
彰化縣,鹿港鎮,0277,303,65,368,62,430,723,59.47%,41.91%,1
彰化縣,鹿港鎮,0278,443,63,506,31,537,984,54.57%,45.02%,1
彰化縣,鹿港鎮,0279,488,105,593,52,645,1018,63.36%,47.94%,1
彰化縣,鹿港鎮,0280,479,116,595,50,645,1165,55.36%,41.12%,1
彰化縣,鹿港鎮,0281,472,98,570,44,614,1161,52.89%,40.65%,1
彰化縣,鹿港鎮,0282,418,96,514,42,556,1020,54.51%,40.98%,1
彰化縣,鹿港鎮,0283,447,114,561,54,615,1068,57.58%,41.85%,1
彰化縣,鹿港鎮,0284,467,99,566,39,605,1024,59.08%,45.61%,1
彰化縣,鹿港鎮,0285,414,101,515,84,599,974,61.5%,42.51%,1
彰化縣,鹿港鎮,0286,607,129,736,80,816,1505,54.22%,40.33%,1
彰化縣,鹿港鎮,0287,477,89,566,37,603,1092,55.22%,43.68%,1
彰化縣,鹿港鎮,0288,572,117,689,53,742,1223,60.67%,46.77%,1
彰化縣,鹿港鎮,0289,575,117,692,39,731,1572,46.5%,36.58%,1
彰化縣,鹿港鎮,0290,469,104,573,46,619,1003,61.71%,46.76%,1
彰化縣,鹿港鎮,0291,439,86,525,30,555,933,59.49%,47.05%,1
彰化縣,鹿港鎮,0292,479,129,608,55,663,1093,60.66%,43.82%,1
彰化縣,鹿港鎮,0293,386,101,487,18,505,907,55.68%,42.56%,1
彰化縣,鹿港鎮,0294,498,130,628,44,672,1219,55.13%,40.85%,1
彰化縣,鹿港鎮,0295,684,145,829,58,887,1397,63.49%,48.96%,1
彰化縣,鹿港鎮,0296,550,138,688,33,721,1229,58.67%,44.75%,1
彰化縣,鹿港鎮,0297,642,102,744,39,783,1444,54.22%,44.46%,1
彰化縣,鹿港鎮,0298,525,151,676,58,734,1227,59.82%,42.79%,1
彰化縣,鹿港鎮,0299,519,133,652,59,711,1187,59.9%,43.72%,1
彰化縣,鹿港鎮,0300,555,108,663,21,684,1296,52.78%,42.82%,1
彰化縣,鹿港鎮,0301,523,160,683,70,753,1451,51.9%,36.04%,1
彰化縣,鹿港鎮,0302,530,140,670,65,735,1299,56.58%,40.8%,1
彰化縣,鹿港鎮,0303,635,126,761,40,801,1298,61.71%,48.92%,1
彰化縣,鹿港鎮,0304,639,150,789,50,839,1458,57.54%,43.83%,1
彰化縣,鹿港鎮,0305,485,136,621,46,667,1138,58.61%,42.62%,1
彰化縣,鹿港鎮,0306,507,117,624,58,682,1170,58.29%,43.33%,1
彰化縣,鹿港鎮,0307,556,130,686,55,741,1221,60.69%,45.54%,1
彰化縣,和美鎮,0373,542,143,685,54,739,1341,55.11%,40.42%,1
彰化縣,和美鎮,0374,594,125,719,51,770,1480,52.03%,40.14%,1
彰化縣,和美鎮,0375,655,161,816,37,853,1529,55.79%,42.84%,1
彰化縣,和美鎮,0376,654,162,816,20,836,1711,48.86%,38.22%,1
彰化縣,和美鎮,0377,454,123,577,37,614,1057,58.09%,42.95%,1
彰化縣,和美鎮,0378,469,103,572,38,610,1032,59.11%,45.45%,1
彰化縣,和美鎮,0379,473,92,565,61,626,1015,61.67%,46.6%,1
彰化縣,和美鎮,0380,548,137,685,46,731,1209,60.46%,45.33%,1
彰化縣,和美鎮,0381,182,47,229,22,251,430,58.37%,42.33%,1
彰化縣,和美鎮,0382,374,78,452,15,467,856,54.56%,43.69%,1
彰化縣,和美鎮,0383,475,82,557,26,583,966,60.35%,49.17%,1
彰化縣,和美鎮,0384,435,129,564,19,583,1059,55.05%,41.08%,1
彰化縣,和美鎮,0385,488,115,603,35,638,1117,57.12%,43.69%,1
彰化縣,和美鎮,0386,444,108,552,42,594,1066,55.72%,41.65%,1
彰化縣,和美鎮,0387,510,121,631,42,673,1252,53.75%,40.73%,1
彰化縣,和美鎮,0388,632,132,764,42,806,1528,52.75%,41.36%,1
彰化縣,和美鎮,0389,373,97,470,27,497,826,60.17%,45.16%,1
彰化縣,和美鎮,0390,391,67,458,21,479,854,56.09%,45.78%,1
彰化縣,和美鎮,0391,573,113,686,54,740,1387,53.35%,41.31%,1
彰化縣,和美鎮,0392,362,91,453,24,477,765,62.35%,47.32%,1
彰化縣,和美鎮,0393,595,109,704,46,750,1438,52.16%,41.38%,1
彰化縣,和美鎮,0394,630,135,765,66,831,1396,59.53%,45.13%,1
彰化縣,和美鎮,0395,272,87,359,20,379,658,57.6%,41.34%,1
彰化縣,和美鎮,0396,398,80,478,36,514,809,63.54%,49.2%,1
彰化縣,和美鎮,0397,384,89,473,9,482,932,51.72%,41.2%,1
彰化縣,和美鎮,0398,368,80,448,38,486,888,54.73%,41.44%,1
彰化縣,和美鎮,0399,510,149,659,40,699,1144,61.1%,44.58%,1
彰化縣,和美鎮,0400,486,86,572,38,610,1077,56.64%,45.13%,1
彰化縣,和美鎮,0401,530,126,656,51,707,1349,52.41%,39.29%,1
彰化縣,和美鎮,0402,549,130,679,44,723,1155,62.6%,47.53%,1
彰化縣,和美鎮,0403,542,117,659,36,695,1253,55.47%,43.26%,1
彰化縣,和美鎮,0404,548,97,645,40,685,1252,54.71%,43.77%,1
彰化縣,和美鎮,0405,634,125,759,23,782,1474,53.05%,43.01%,1
彰化縣,和美鎮,0406,558,102,660,33,693,1396,49.64%,39.97%,1
彰化縣,和美鎮,0407,577,113,690,38,728,1348,54.01%,42.8%,1
彰化縣,和美鎮,0408,481,114,595,25,620,999,62.06%,48.15%,1
彰化縣,和美鎮,0409,397,108,505,42,547,911,60.04%,43.58%,1
彰化縣,和美鎮,0410,418,139,557,32,589,1005,58.61%,41.59%,1
彰化縣,和美鎮,0411,422,102,524,38,562,967,58.12%,43.64%,1
彰化縣,和美鎮,0412,571,153,724,38,762,1308,58.26%,43.65%,1
彰化縣,和美鎮,0413,570,143,713,33,746,1324,56.34%,43.05%,1
彰化縣,和美鎮,0414,461,152,613,43,656,1102,59.53%,41.83%,1
彰化縣,和美鎮,0415,530,33,563,46,609,1124,54.18%,47.15%,1
彰化縣,和美鎮,0416,540,117,657,46,703,1211,58.05%,44.59%,1
彰化縣,和美鎮,0417,436,120,556,30,586,884,66.29%,49.32%,1
彰化縣,和美鎮,0418,448,146,594,57,651,1119,58.18%,40.04%,1
彰化縣,和美鎮,0419,561,118,679,54,733,1300,56.38%,43.15%,1
彰化縣,和美鎮,0420,466,103,569,37,606,1104,54.89%,42.21%,1
彰化縣,和美鎮,0421,563,134,697,41,738,1213,60.84%,46.41%,1
彰化縣,和美鎮,0422,408,121,529,44,573,1127,50.84%,36.2%,1
彰化縣,和美鎮,0423,384,86,470,51,521,919,56.69%,41.78%,1
彰化縣,和美鎮,0424,443,105,548,48,596,987,60.39%,44.88%,1
彰化縣,和美鎮,0425,431,128,559,32,591,958,61.69%,44.99%,1
彰化縣,和美鎮,0426,603,137,740,49,789,1362,57.93%,44.27%,1
彰化縣,和美鎮,0427,627,139,766,28,794,1461,54.35%,42.92%,1
彰化縣,和美鎮,0428,632,140,772,28,800,1405,56.94%,44.98%,1
彰化縣,和美鎮,0429,385,107,492,29,521,860,60.58%,44.77%,1
彰化縣,和美鎮,0430,380,77,457,15,472,875,53.94%,43.43%,1
彰化縣,和美鎮,0431,369,96,465,39,504,871,57.86%,42.37%,1
彰化縣,和美鎮,0432,416,96,512,38,550,883,62.29%,47.11%,1
彰化縣,和美鎮,0433,474,132,606,57,663,1224,54.17%,38.73%,1
彰化縣,和美鎮,0434,444,108,552,46,598,1075,55.63%,41.3%,1
彰化縣,和美鎮,0435,410,100,510,34,544,956,56.9%,42.89%,1
彰化縣,和美鎮,0436,428,106,534,46,580,1037,55.93%,41.27%,1
彰化縣,和美鎮,0437,445,101,546,19,565,1011,55.89%,44.02%,1
彰化縣,和美鎮,0438,414,106,520,50,570,1023,55.72%,40.47%,1
彰化縣,和美鎮,0439,302,67,369,22,391,719,54.38%,42%,1
彰化縣,和美鎮,0440,377,94,471,46,517,913,56.63%,41.29%,1
彰化縣,線西鄉,0469,482,103,585,25,610,1071,56.96%,45%,1
彰化縣,線西鄉,0470,536,115,651,37,688,1166,59.01%,45.97%,1
彰化縣,線西鄉,0471,574,115,689,63,752,1269,59.26%,45.23%,1
彰化縣,線西鄉,0472,488,121,609,43,652,1138,57.29%,42.88%,1
彰化縣,線西鄉,0473,534,117,651,68,719,1128,63.74%,47.34%,1
彰化縣,線西鄉,0474,569,115,684,80,764,1275,59.92%,44.63%,1
彰化縣,線西鄉,0475,543,106,649,58,707,1187,59.56%,45.75%,1
彰化縣,線西鄉,0476,454,104,558,45,603,991,60.85%,45.81%,1
彰化縣,線西鄉,0477,402,101,503,58,561,938,59.81%,42.86%,1
彰化縣,線西鄉,0478,515,118,633,46,679,1276,53.21%,40.36%,1
彰化縣,線西鄉,0479,591,118,709,47,756,1285,58.83%,45.99%,1
彰化縣,線西鄉,0480,673,134,807,67,874,1341,65.18%,50.19%,1
彰化縣,伸港鄉,0441,480,81,561,31,592,1182,50.08%,40.61%,1
彰化縣,伸港鄉,0442,584,96,680,37,717,1166,61.49%,50.09%,1
彰化縣,伸港鄉,0443,431,87,518,41,559,966,57.87%,44.62%,1
彰化縣,伸港鄉,0444,368,79,447,40,487,873,55.78%,42.15%,1
彰化縣,伸港鄉,0445,368,84,452,40,492,812,60.59%,45.32%,1
彰化縣,伸港鄉,0446,385,77,462,30,492,875,56.23%,44%,1
彰化縣,伸港鄉,0447,383,76,459,45,504,904,55.75%,42.37%,1
彰化縣,伸港鄉,0448,430,89,519,41,560,1008,55.56%,42.66%,1
彰化縣,伸港鄉,0449,524,113,637,49,686,1154,59.45%,45.41%,1
彰化縣,伸港鄉,0450,580,137,717,67,784,1486,52.76%,39.03%,1
彰化縣,伸港鄉,0451,463,92,555,53,608,1095,55.53%,42.28%,1
彰化縣,伸港鄉,0452,484,52,536,23,559,1087,51.43%,44.53%,1
彰化縣,伸港鄉,0453,487,107,594,53,647,1085,59.63%,44.88%,1
彰化縣,伸港鄉,0454,434,72,506,37,543,908,59.8%,47.8%,1
彰化縣,伸港鄉,0455,621,99,720,37,757,1264,59.89%,49.13%,1
彰化縣,伸港鄉,0456,348,75,423,47,470,854,55.04%,40.75%,1
彰化縣,伸港鄉,0457,336,62,398,29,427,846,50.47%,39.72%,1
彰化縣,伸港鄉,0458,421,95,516,93,609,1143,53.28%,36.83%,1
彰化縣,伸港鄉,0459,592,128,720,29,749,1357,55.2%,43.63%,1
彰化縣,伸港鄉,0460,533,154,687,75,762,1349,56.49%,39.51%,1
彰化縣,伸港鄉,0461,509,121,630,46,676,1154,58.58%,44.11%,1
彰化縣,伸港鄉,0462,536,127,663,33,696,1279,54.42%,41.91%,1
彰化縣,伸港鄉,0463,601,127,728,49,777,1317,59%,45.63%,1
彰化縣,伸港鄉,0464,459,104,563,43,606,990,61.21%,46.36%,1
彰化縣,伸港鄉,0465,397,74,471,31,502,852,58.92%,46.6%,1
彰化縣,伸港鄉,0466,616,27,643,32,675,1178,57.3%,52.29%,1
彰化縣,伸港鄉,0467,444,107,551,70,621,1088,57.08%,40.81%,1
彰化縣,伸港鄉,0468,486,108,594,53,647,1135,57%,42.82%,1
彰化縣,福興鄉,0308,508,182,690,52,742,1363,54.44%,37.27%,1
彰化縣,福興鄉,0309,348,90,438,34,472,821,57.49%,42.39%,1
彰化縣,福興鄉,0310,495,97,592,67,659,1256,52.47%,39.41%,1
彰化縣,福興鄉,0311,410,130,540,93,633,1166,54.29%,35.16%,1
彰化縣,福興鄉,0312,586,120,706,57,763,1464,52.12%,40.03%,1
彰化縣,福興鄉,0313,491,130,621,43,664,1251,53.08%,39.25%,1
彰化縣,福興鄉,0314,570,143,713,61,774,1465,52.83%,38.91%,1
彰化縣,福興鄉,0315,346,94,440,29,469,960,48.85%,36.04%,1
彰化縣,福興鄉,0316,504,129,633,82,715,1323,54.04%,38.1%,1
彰化縣,福興鄉,0317,538,155,693,60,753,1365,55.16%,39.41%,1
彰化縣,福興鄉,0318,466,156,622,33,655,1458,44.92%,31.96%,1
彰化縣,福興鄉,0319,530,167,697,91,788,1492,52.82%,35.52%,1
彰化縣,福興鄉,0320,322,80,402,23,425,888,47.86%,36.26%,1
彰化縣,福興鄉,0321,445,125,570,58,628,1054,59.58%,42.22%,1
彰化縣,福興鄉,0322,372,101,473,49,522,1043,50.05%,35.67%,1
彰化縣,福興鄉,0323,511,162,673,66,739,1340,55.15%,38.13%,1
彰化縣,福興鄉,0324,405,111,516,40,556,1085,51.24%,37.33%,1
彰化縣,福興鄉,0325,529,125,654,50,704,1392,50.57%,38%,1
彰化縣,福興鄉,0326,580,114,694,80,774,1316,58.81%,44.07%,1
彰化縣,福興鄉,0327,556,156,712,48,760,1255,60.56%,44.3%,1
彰化縣,福興鄉,0328,504,120,624,48,672,1101,61.04%,45.78%,1
彰化縣,福興鄉,0329,490,88,578,78,656,1167,56.21%,41.99%,1
彰化縣,福興鄉,0330,532,123,655,82,737,1393,52.91%,38.19%,1
彰化縣,福興鄉,0331,516,117,633,59,692,1216,56.91%,42.43%,1
彰化縣,福興鄉,0332,491,86,577,55,632,1063,59.45%,46.19%,1
彰化縣,福興鄉,0333,513,125,638,68,706,1306,54.06%,39.28%,1
彰化縣,福興鄉,0334,422,120,542,53,595,1287,46.23%,32.79%,1
彰化縣,福興鄉,0335,398,120,518,40,558,994,56.14%,40.04%,1
彰化縣,福興鄉,0336,546,124,670,71,741,1311,56.52%,41.65%,1
彰化縣,福興鄉,0337,398,95,493,56,549,926,59.29%,42.98%,1
彰化縣,福興鄉,0338,379,96,475,46,521,995,52.36%,38.09%,1
彰化縣,福興鄉,0339,500,113,613,78,691,1079,64.04%,46.34%,1
彰化縣,福興鄉,0340,426,102,528,77,605,1150,52.61%,37.04%,1
彰化縣,秀水鄉,0341,483,110,593,75,668,1066,62.66%,45.31%,1
彰化縣,秀水鄉,0342,274,85,359,38,397,620,64.03%,44.19%,1
彰化縣,秀水鄉,0343,341,86,427,15,442,876,50.46%,38.93%,1
彰化縣,秀水鄉,0344,550,147,697,41,738,1196,61.71%,45.99%,1
彰化縣,秀水鄉,0345,599,147,746,44,790,1369,57.71%,43.75%,1
彰化縣,秀水鄉,0346,555,154,709,46,755,1273,59.31%,43.6%,1
彰化縣,秀水鄉,0347,619,138,757,48,805,1433,56.18%,43.2%,1
彰化縣,秀水鄉,0348,435,115,550,20,570,967,58.95%,44.98%,1
彰化縣,秀水鄉,0349,407,106,513,22,535,921,58.09%,44.19%,1
彰化縣,秀水鄉,0350,329,74,403,30,433,689,62.84%,47.75%,1
彰化縣,秀水鄉,0351,290,88,378,43,421,688,61.19%,42.15%,1
彰化縣,秀水鄉,0352,582,148,730,52,782,1252,62.46%,46.49%,1
彰化縣,秀水鄉,0353,521,126,647,35,682,1281,53.24%,40.67%,1
彰化縣,秀水鄉,0354,317,82,399,20,419,754,55.57%,42.04%,1
彰化縣,秀水鄉,0355,430,102,532,50,582,1024,56.84%,41.99%,1
彰化縣,秀水鄉,0356,605,128,733,29,762,1433,53.18%,42.22%,1
彰化縣,秀水鄉,0357,655,173,828,45,873,1366,63.91%,47.95%,1
彰化縣,秀水鄉,0358,397,107,504,41,545,895,60.89%,44.36%,1
彰化縣,秀水鄉,0359,558,125,683,71,754,1386,54.4%,40.26%,1
彰化縣,秀水鄉,0360,385,105,490,55,545,896,60.83%,42.97%,1
彰化縣,秀水鄉,0361,382,113,495,34,529,804,65.8%,47.51%,1
彰化縣,秀水鄉,0362,411,80,491,26,517,827,62.52%,49.7%,1
彰化縣,秀水鄉,0363,447,96,543,50,593,996,59.54%,44.88%,1
彰化縣,秀水鄉,0364,466,101,567,49,616,931,66.17%,50.05%,1
彰化縣,秀水鄉,0365,297,78,375,30,405,715,56.64%,41.54%,1
彰化縣,秀水鄉,0366,550,163,713,54,767,1229,62.41%,44.75%,1
彰化縣,秀水鄉,0367,350,81,431,27,458,890,51.46%,39.33%,1
彰化縣,秀水鄉,0368,371,103,474,35,509,811,62.76%,45.75%,1
彰化縣,秀水鄉,0369,349,104,453,33,486,786,61.83%,44.4%,1
彰化縣,秀水鄉,0370,419,93,512,30,542,931,58.22%,45.01%,1
彰化縣,秀水鄉,0371,563,139,702,66,768,1265,60.71%,44.51%,1
彰化縣,秀水鄉,0372,353,72,425,35,460,824,55.83%,42.84%,1
彰化縣,花壇鄉,0185,389,107,496,43,539,901,59.82%,43.17%,1
彰化縣,花壇鄉,0186,495,107,602,30,632,1042,60.65%,47.5%,1
彰化縣,花壇鄉,0187,534,107,641,18,659,1314,50.15%,40.64%,1
彰化縣,花壇鄉,0188,345,96,441,48,489,808,60.52%,42.7%,1
彰化縣,花壇鄉,0189,420,118,538,50,588,1019,57.7%,41.22%,1
彰化縣,花壇鄉,0190,485,147,632,69,701,1144,61.28%,42.4%,1
彰化縣,花壇鄉,0191,582,63,645,81,726,1240,58.55%,46.94%,1
彰化縣,花壇鄉,0192,638,163,801,81,882,1425,61.89%,44.77%,1
彰化縣,花壇鄉,0193,498,123,621,65,686,1095,62.65%,45.48%,1
彰化縣,花壇鄉,0194,401,107,508,38,546,910,60%,44.07%,1
彰化縣,花壇鄉,0195,434,114,548,29,577,982,58.76%,44.2%,1
彰化縣,花壇鄉,0196,426,122,548,22,570,1070,53.27%,39.81%,1
彰化縣,花壇鄉,0197,285,66,351,20,371,700,53%,40.71%,1
彰化縣,花壇鄉,0198,368,91,459,41,500,764,65.45%,48.17%,1
彰化縣,花壇鄉,0199,430,125,555,48,603,953,63.27%,45.12%,1
彰化縣,花壇鄉,0200,434,95,529,26,555,974,56.98%,44.56%,1
彰化縣,花壇鄉,0201,460,127,587,61,648,1111,58.33%,41.4%,1
彰化縣,花壇鄉,0202,508,102,610,63,673,1101,61.13%,46.14%,1
彰化縣,花壇鄉,0203,473,92,565,43,608,1110,54.77%,42.61%,1
彰化縣,花壇鄉,0204,560,116,676,59,735,1262,58.24%,44.37%,1
彰化縣,花壇鄉,0205,471,144,615,26,641,1103,58.11%,42.7%,1
彰化縣,花壇鄉,0206,483,137,620,77,697,1347,51.74%,35.86%,1
彰化縣,花壇鄉,0207,470,107,577,57,634,1169,54.23%,40.21%,1
彰化縣,花壇鄉,0208,572,139,711,53,764,1274,59.97%,44.9%,1
彰化縣,花壇鄉,0209,622,126,748,43,791,1280,61.8%,48.59%,1
彰化縣,花壇鄉,0210,569,104,673,48,721,1244,57.96%,45.74%,1
彰化縣,花壇鄉,0211,482,139,621,58,679,1159,58.58%,41.59%,1
彰化縣,花壇鄉,0212,512,107,619,40,659,1042,63.24%,49.14%,1
彰化縣,花壇鄉,0213,465,116,581,43,624,1111,56.17%,41.85%,1
彰化縣,花壇鄉,0214,415,106,521,46,567,893,63.49%,46.47%,1
彰化縣,花壇鄉,0215,401,102,503,62,565,953,59.29%,42.08%,1
彰化縣,花壇鄉,0216,398,83,481,36,517,987,52.38%,40.32%,1
彰化縣,花壇鄉,0217,432,110,542,56,598,925,64.65%,46.7%,1
彰化縣,花壇鄉,0218,423,76,499,24,523,951,54.99%,44.48%,1
彰化縣,花壇鄉,0219,406,110,516,28,544,955,56.96%,42.51%,1
彰化縣,花壇鄉,0220,363,89,452,28,480,895,53.63%,40.56%,1
彰化縣,花壇鄉,0221,304,76,380,32,412,711,57.95%,42.76%,1
彰化縣,芬園鄉,0222,411,76,487,47,534,958,55.74%,42.9%,1
彰化縣,芬園鄉,0223,327,73,400,54,454,794,57.18%,41.18%,1
彰化縣,芬園鄉,0224,543,122,665,82,747,1415,52.79%,38.37%,1
彰化縣,芬園鄉,0225,428,112,540,29,569,927,61.38%,46.17%,1
彰化縣,芬園鄉,0226,371,67,438,36,474,831,57.04%,44.65%,1
彰化縣,芬園鄉,0227,243,55,298,22,320,570,56.14%,42.63%,1
彰化縣,芬園鄉,0228,466,123,589,46,635,1227,51.75%,37.98%,1
彰化縣,芬園鄉,0229,504,108,612,68,680,1238,54.93%,40.71%,1
彰化縣,芬園鄉,0230,579,144,723,62,785,1362,57.64%,42.51%,1
彰化縣,芬園鄉,0231,411,106,517,64,581,989,58.75%,41.56%,1
彰化縣,芬園鄉,0232,514,103,617,49,666,1054,63.19%,48.77%,1
彰化縣,芬園鄉,0233,308,63,371,27,398,607,65.57%,50.74%,1
彰化縣,芬園鄉,0234,406,89,495,39,534,882,60.54%,46.03%,1
彰化縣,芬園鄉,0235,433,96,529,31,560,1143,48.99%,37.88%,1
彰化縣,芬園鄉,0236,233,46,279,22,301,661,45.54%,35.25%,1
彰化縣,芬園鄉,0237,323,83,406,3,409,838,48.81%,38.54%,1
彰化縣,芬園鄉,0238,308,103,411,32,443,847,52.3%,36.36%,1
彰化縣,芬園鄉,0239,435,95,530,62,592,987,59.98%,44.07%,1
彰化縣,芬園鄉,0240,416,145,561,69,630,1217,51.77%,34.18%,1
彰化縣,芬園鄉,0241,295,79,374,69,443,865,51.21%,34.1%,1
彰化縣,芬園鄉,0242,392,88,480,47,527,996,52.91%,39.36%,1
彰化縣,員林市,0481,462,77,539,21,560,1087,51.52%,42.5%,1
彰化縣,員林市,0482,522,145,667,34,701,1353,51.81%,38.58%,1
彰化縣,員林市,0483,510,135,645,57,702,1313,53.47%,38.84%,1
彰化縣,員林市,0484,477,94,571,32,603,1328,45.41%,35.92%,1
彰化縣,員林市,0485,436,136,572,29,601,1055,56.97%,41.33%,1
彰化縣,員林市,0486,401,85,486,38,524,959,54.64%,41.81%,1
彰化縣,員林市,0487,330,88,418,33,451,772,58.42%,42.75%,1
彰化縣,員林市,0488,373,96,469,40,509,831,61.25%,44.89%,1
彰化縣,員林市,0489,269,63,332,12,344,854,40.28%,31.5%,1
彰化縣,員林市,0490,385,109,494,38,532,1190,44.71%,32.35%,1
彰化縣,員林市,0491,318,60,378,16,394,726,54.27%,43.8%,1
彰化縣,員林市,0492,449,125,574,56,630,1124,56.05%,39.95%,1
彰化縣,員林市,0493,318,77,395,58,453,860,52.67%,36.98%,1
彰化縣,員林市,0494,533,112,645,36,681,1122,60.7%,47.5%,1
彰化縣,員林市,0495,471,122,593,44,637,1075,59.26%,43.81%,1
彰化縣,員林市,0496,370,116,486,64,550,993,55.39%,37.26%,1
彰化縣,員林市,0497,389,90,479,26,505,967,52.22%,40.23%,1
彰化縣,員林市,0498,381,143,524,53,577,1008,57.24%,37.8%,1
彰化縣,員林市,0499,314,98,412,45,457,804,56.84%,39.05%,1
彰化縣,員林市,0500,365,90,455,29,484,867,55.82%,42.1%,1
彰化縣,員林市,0501,370,72,442,27,469,885,52.99%,41.81%,1
彰化縣,員林市,0502,384,73,457,15,472,1097,43.03%,35%,1
彰化縣,員林市,0503,518,120,638,30,668,1255,53.23%,41.27%,1
彰化縣,員林市,0504,436,129,565,49,614,1063,57.76%,41.02%,1
彰化縣,員林市,0505,296,198,494,24,518,925,56%,32%,1
彰化縣,員林市,0506,400,120,520,35,555,947,58.61%,42.24%,1
彰化縣,員林市,0507,408,113,521,27,548,916,59.83%,44.54%,1
彰化縣,員林市,0508,364,83,447,31,478,862,55.45%,42.23%,1
彰化縣,員林市,0509,422,123,545,18,563,987,57.04%,42.76%,1
彰化縣,員林市,0510,451,103,554,41,595,1085,54.84%,41.57%,1
彰化縣,員林市,0511,514,104,618,21,639,1110,57.57%,46.31%,1
彰化縣,員林市,0512,437,105,542,17,559,1095,51.05%,39.91%,1
彰化縣,員林市,0513,592,154,746,36,782,1278,61.19%,46.32%,1
彰化縣,員林市,0514,507,109,616,37,653,1109,58.88%,45.72%,1
彰化縣,員林市,0515,427,112,539,63,602,1055,57.06%,40.47%,1
彰化縣,員林市,0516,365,109,474,28,502,876,57.31%,41.67%,1
彰化縣,員林市,0517,383,128,511,45,556,1115,49.87%,34.35%,1
彰化縣,員林市,0518,532,112,644,45,689,1186,58.09%,44.86%,1
彰化縣,員林市,0519,460,102,562,38,600,995,60.3%,46.23%,1
彰化縣,員林市,0520,400,100,500,13,513,999,51.35%,40.04%,1
彰化縣,員林市,0521,500,132,632,27,659,1201,54.87%,41.63%,1
彰化縣,員林市,0522,574,129,703,29,732,1342,54.55%,42.77%,1
彰化縣,員林市,0523,444,107,551,26,577,1086,53.13%,40.88%,1
彰化縣,員林市,0524,337,95,432,27,459,854,53.75%,39.46%,1
彰化縣,員林市,0525,454,108,562,28,590,1064,55.45%,42.67%,1
彰化縣,員林市,0526,399,108,507,11,518,879,58.93%,45.39%,1
彰化縣,員林市,0527,444,84,528,33,561,827,67.84%,53.69%,1
彰化縣,員林市,0528,365,79,444,13,457,867,52.71%,42.1%,1
彰化縣,員林市,0529,513,128,641,37,678,1201,56.45%,42.71%,1
彰化縣,員林市,0530,479,122,601,40,641,1106,57.96%,43.31%,1
彰化縣,員林市,0531,348,114,462,41,503,845,59.53%,41.18%,1
彰化縣,員林市,0532,394,98,492,33,525,894,58.72%,44.07%,1
彰化縣,員林市,0533,381,89,470,31,501,849,59.01%,44.88%,1
彰化縣,員林市,0534,339,93,432,42,474,747,63.45%,45.38%,1
彰化縣,員林市,0535,407,117,524,27,551,884,62.33%,46.04%,1
彰化縣,員林市,0536,363,81,444,33,477,900,53%,40.33%,1
彰化縣,員林市,0537,412,107,519,27,546,1040,52.5%,39.62%,1
彰化縣,員林市,0538,325,118,443,19,462,831,55.6%,39.11%,1
彰化縣,員林市,0539,270,74,344,35,379,591,64.13%,45.69%,1
彰化縣,員林市,0540,534,146,680,43,723,1330,54.36%,40.15%,1
彰化縣,員林市,0541,571,125,696,29,725,1295,55.98%,44.09%,1
彰化縣,員林市,0542,537,131,668,47,715,1283,55.73%,41.86%,1
彰化縣,員林市,0543,416,116,532,35,567,943,60.13%,44.11%,1
彰化縣,員林市,0544,623,182,805,42,847,1388,61.02%,44.88%,1
彰化縣,員林市,0545,526,120,646,31,677,1176,57.57%,44.73%,1
彰化縣,員林市,0546,334,68,402,10,412,867,47.52%,38.52%,1
彰化縣,員林市,0547,442,136,578,43,621,1121,55.4%,39.43%,1
彰化縣,員林市,0548,491,101,592,39,631,1190,53.03%,41.26%,1
彰化縣,員林市,0549,419,110,529,36,565,945,59.79%,44.34%,1
彰化縣,員林市,0550,418,95,513,32,545,906,60.15%,46.14%,1
彰化縣,員林市,0551,414,137,551,45,596,978,60.94%,42.33%,1
彰化縣,員林市,0552,433,81,514,42,556,949,58.59%,45.63%,1
彰化縣,員林市,0553,439,85,524,28,552,949,58.17%,46.26%,1
彰化縣,員林市,0554,439,93,532,29,561,1006,55.77%,43.64%,1
彰化縣,員林市,0555,386,101,487,41,528,889,59.39%,43.42%,1
彰化縣,員林市,0556,413,118,531,21,552,923,59.8%,44.75%,1
彰化縣,員林市,0557,563,146,709,37,746,1209,61.7%,46.57%,1
彰化縣,員林市,0558,478,134,612,38,650,1075,60.47%,44.47%,1
彰化縣,員林市,0559,650,142,792,33,825,1342,61.48%,48.44%,1
彰化縣,員林市,0560,508,137,645,43,688,1039,66.22%,48.89%,1
彰化縣,員林市,0561,467,110,577,53,630,1131,55.7%,41.29%,1
彰化縣,員林市,0562,534,127,661,39,700,1356,51.62%,39.38%,1
彰化縣,員林市,0563,587,131,718,51,769,1370,56.13%,42.85%,1
彰化縣,員林市,0564,465,127,592,40,632,1090,57.98%,42.66%,1
彰化縣,員林市,0565,412,98,510,22,532,821,64.8%,50.18%,1
彰化縣,員林市,0566,412,94,506,35,541,910,59.45%,45.27%,1
彰化縣,員林市,0567,515,131,646,44,690,1203,57.36%,42.81%,1
彰化縣,員林市,0568,586,144,730,48,778,1378,56.46%,42.53%,1
彰化縣,員林市,0569,590,154,744,29,773,1352,57.17%,43.64%,1
彰化縣,員林市,0570,475,151,626,21,647,1060,61.04%,44.81%,1
彰化縣,員林市,0571,566,116,682,38,720,1317,54.67%,42.98%,1
彰化縣,員林市,0572,443,128,571,40,611,1120,54.55%,39.55%,1
彰化縣,員林市,0573,422,93,515,41,556,1025,54.24%,41.17%,1
彰化縣,員林市,0574,465,120,585,45,630,1097,57.43%,42.39%,1
彰化縣,員林市,0575,387,109,496,34,530,859,61.7%,45.05%,1
彰化縣,員林市,0576,344,90,434,33,467,837,55.79%,41.1%,1
彰化縣,員林市,0577,506,129,635,52,687,1090,63.03%,46.42%,1
彰化縣,員林市,0578,432,116,548,62,610,1073,56.85%,40.26%,1
彰化縣,溪湖鎮,0640,485,145,630,48,678,1221,55.53%,39.72%,1
彰化縣,溪湖鎮,0641,297,77,374,35,409,638,64.11%,46.55%,1
彰化縣,溪湖鎮,0642,376,66,442,43,485,817,59.36%,46.02%,1
彰化縣,溪湖鎮,0643,458,90,548,39,587,968,60.64%,47.31%,1
彰化縣,溪湖鎮,0644,227,51,278,17,295,448,65.85%,50.67%,1
彰化縣,溪湖鎮,0645,430,105,535,29,564,1123,50.22%,38.29%,1
彰化縣,溪湖鎮,0646,471,142,613,44,657,1166,56.35%,40.39%,1
彰化縣,溪湖鎮,0647,468,120,588,30,618,1151,53.69%,40.66%,1
彰化縣,溪湖鎮,0648,557,127,684,39,723,1249,57.89%,44.6%,1
彰化縣,溪湖鎮,0649,503,123,626,51,677,1146,59.08%,43.89%,1
彰化縣,溪湖鎮,0650,529,124,653,53,706,1199,58.88%,44.12%,1
彰化縣,溪湖鎮,0651,385,90,475,46,521,895,58.21%,43.02%,1
彰化縣,溪湖鎮,0652,437,113,550,16,566,964,58.71%,45.33%,1
彰化縣,溪湖鎮,0653,384,90,474,24,498,851,58.52%,45.12%,1
彰化縣,溪湖鎮,0654,466,109,575,37,612,1072,57.09%,43.47%,1
彰化縣,溪湖鎮,0655,513,107,620,48,668,1113,60.02%,46.09%,1
彰化縣,溪湖鎮,0656,494,128,622,32,654,1090,60%,45.32%,1
彰化縣,溪湖鎮,0657,583,95,678,38,716,1193,60.02%,48.87%,1
彰化縣,溪湖鎮,0658,448,95,543,48,591,952,62.08%,47.06%,1
彰化縣,溪湖鎮,0659,493,123,616,61,677,1172,57.76%,42.06%,1
彰化縣,溪湖鎮,0660,458,99,557,35,592,1027,57.64%,44.6%,1
彰化縣,溪湖鎮,0661,579,120,699,47,746,1188,62.79%,48.74%,1
彰化縣,溪湖鎮,0662,554,149,703,49,752,1403,53.6%,39.49%,1
彰化縣,溪湖鎮,0663,501,141,642,73,715,1397,51.18%,35.86%,1
彰化縣,溪湖鎮,0664,710,147,857,51,908,1636,55.5%,43.4%,1
彰化縣,溪湖鎮,0665,563,139,702,73,775,1298,59.71%,43.37%,1
彰化縣,溪湖鎮,0666,557,96,653,46,699,1214,57.58%,45.88%,1
彰化縣,溪湖鎮,0667,589,142,731,45,776,1297,59.83%,45.41%,1
彰化縣,溪湖鎮,0668,457,99,556,49,605,968,62.5%,47.21%,1
彰化縣,溪湖鎮,0669,370,98,468,35,503,839,59.95%,44.1%,1
彰化縣,溪湖鎮,0670,387,125,512,37,549,907,60.53%,42.67%,1
彰化縣,溪湖鎮,0671,330,91,421,19,440,898,49%,36.75%,1
彰化縣,溪湖鎮,0672,344,76,420,29,449,650,69.08%,52.92%,1
彰化縣,溪湖鎮,0673,526,128,654,83,737,1279,57.62%,41.13%,1
彰化縣,溪湖鎮,0674,329,93,422,44,466,730,63.84%,45.07%,1
彰化縣,溪湖鎮,0675,634,120,754,61,815,1407,57.92%,45.06%,1
彰化縣,溪湖鎮,0676,437,141,578,59,637,1273,50.04%,34.33%,1
彰化縣,溪湖鎮,0677,414,101,515,24,539,988,54.55%,41.9%,1
彰化縣,溪湖鎮,0678,348,85,433,48,481,754,63.79%,46.15%,1
彰化縣,溪湖鎮,0679,353,127,480,45,525,1052,49.9%,33.56%,1
彰化縣,溪湖鎮,0680,513,77,590,31,621,1149,54.05%,44.65%,1
彰化縣,溪湖鎮,0681,609,182,791,71,862,1365,63.15%,44.62%,1
彰化縣,田中鎮,0742,311,79,390,86,476,854,55.74%,36.42%,1
彰化縣,田中鎮,0743,369,76,445,46,491,963,50.99%,38.32%,1
彰化縣,田中鎮,0744,28,12,40,5,45,175,25.71%,16%,1
彰化縣,田中鎮,0745,292,68,360,34,394,739,53.32%,39.51%,1
彰化縣,田中鎮,0746,328,78,406,32,438,826,53.03%,39.71%,1
彰化縣,田中鎮,0747,320,84,404,42,446,741,60.19%,43.18%,1
彰化縣,田中鎮,0748,173,33,206,9,215,506,42.49%,34.19%,1
彰化縣,田中鎮,0749,367,100,467,52,519,1001,51.85%,36.66%,1
彰化縣,田中鎮,0750,544,128,672,74,746,1281,58.24%,42.47%,1
彰化縣,田中鎮,0751,439,109,548,46,594,1035,57.39%,42.42%,1
彰化縣,田中鎮,0752,565,167,732,48,780,1327,58.78%,42.58%,1
彰化縣,田中鎮,0753,389,98,487,32,519,844,61.49%,46.09%,1
彰化縣,田中鎮,0754,385,93,478,44,522,913,57.17%,42.17%,1
彰化縣,田中鎮,0755,298,66,364,39,403,613,65.74%,48.61%,1
彰化縣,田中鎮,0756,594,152,746,70,816,1382,59.04%,42.98%,1
彰化縣,田中鎮,0757,523,106,629,45,674,1034,65.18%,50.58%,1
彰化縣,田中鎮,0758,460,116,576,41,617,935,65.99%,49.2%,1
彰化縣,田中鎮,0759,530,68,598,53,651,1301,50.04%,40.74%,1
彰化縣,田中鎮,0760,490,133,623,36,659,1100,59.91%,44.55%,1
彰化縣,田中鎮,0761,472,118,590,50,640,1071,59.76%,44.07%,1
彰化縣,田中鎮,0762,521,146,667,57,724,1163,62.25%,44.8%,1
彰化縣,田中鎮,0763,394,101,495,39,534,809,66.01%,48.7%,1
彰化縣,田中鎮,0764,612,30,642,56,698,1155,60.43%,52.99%,1
彰化縣,田中鎮,0765,518,127,645,84,729,1270,57.4%,40.79%,1
彰化縣,田中鎮,0766,370,86,456,40,496,870,57.01%,42.53%,1
彰化縣,田中鎮,0767,313,79,392,30,422,736,57.34%,42.53%,1
彰化縣,田中鎮,0768,500,145,645,48,693,1335,51.91%,37.45%,1
彰化縣,田中鎮,0769,353,94,447,44,491,876,56.05%,40.3%,1
彰化縣,田中鎮,0770,331,107,438,52,490,898,54.57%,36.86%,1
彰化縣,田中鎮,0771,592,143,735,19,754,1298,58.09%,45.61%,1
彰化縣,田中鎮,0772,576,166,742,71,813,1451,56.03%,39.7%,1
彰化縣,田中鎮,0773,625,150,775,60,835,1475,56.61%,42.37%,1
彰化縣,田中鎮,0774,275,80,355,46,401,766,52.35%,35.9%,1
彰化縣,田中鎮,0775,346,54,400,39,439,810,54.2%,42.72%,1
彰化縣,田中鎮,0776,398,114,512,57,569,953,59.71%,41.76%,1
彰化縣,田中鎮,0777,395,98,493,61,554,885,62.6%,44.63%,1
彰化縣,大村鄉,0579,671,176,847,54,901,1426,63.18%,47.05%,1
彰化縣,大村鄉,0580,819,177,996,79,1075,1726,62.28%,47.45%,1
彰化縣,大村鄉,0581,358,101,459,46,505,797,63.36%,44.92%,1
彰化縣,大村鄉,0582,319,77,396,17,413,745,55.44%,42.82%,1
彰化縣,大村鄉,0583,518,113,631,61,692,1125,61.51%,46.04%,1
彰化縣,大村鄉,0584,616,153,769,90,859,1486,57.81%,41.45%,1
彰化縣,大村鄉,0585,636,142,778,57,835,1426,58.56%,44.6%,1
彰化縣,大村鄉,0586,368,119,487,36,523,824,63.47%,44.66%,1
彰化縣,大村鄉,0587,458,104,562,39,601,1177,51.06%,38.91%,1
彰化縣,大村鄉,0588,660,153,813,68,881,1478,59.61%,44.65%,1
彰化縣,大村鄉,0589,306,84,390,16,406,779,52.12%,39.28%,1
彰化縣,大村鄉,0590,381,83,464,46,510,812,62.81%,46.92%,1
彰化縣,大村鄉,0591,510,105,615,33,648,1161,55.81%,43.93%,1
彰化縣,大村鄉,0592,517,116,633,23,656,1238,52.99%,41.76%,1
彰化縣,大村鄉,0593,530,149,679,47,726,1259,57.66%,42.1%,1
彰化縣,大村鄉,0594,623,148,771,49,820,1412,58.07%,44.12%,1
彰化縣,大村鄉,0595,627,137,764,23,787,1401,56.17%,44.75%,1
彰化縣,大村鄉,0596,631,144,775,65,840,1395,60.22%,45.23%,1
彰化縣,大村鄉,0597,418,125,543,58,601,996,60.34%,41.97%,1
彰化縣,大村鄉,0598,467,110,577,34,611,1047,58.36%,44.6%,1
彰化縣,大村鄉,0599,452,96,548,37,585,985,59.39%,45.89%,1
彰化縣,大村鄉,0600,497,125,622,36,658,1054,62.43%,47.15%,1
彰化縣,大村鄉,0601,544,125,669,42,711,1200,59.25%,45.33%,1
彰化縣,大村鄉,0602,446,104,550,68,618,1003,61.62%,44.47%,1
彰化縣,大村鄉,0603,419,114,533,40,573,1046,54.78%,40.06%,1
彰化縣,大村鄉,0604,550,114,664,48,712,1189,59.88%,46.26%,1
彰化縣,大村鄉,0605,552,106,658,53,711,1305,54.48%,42.3%,1
彰化縣,埔鹽鄉,0682,442,109,551,42,593,958,61.9%,46.14%,1
彰化縣,埔鹽鄉,0683,373,89,462,30,492,754,65.25%,49.47%,1
彰化縣,埔鹽鄉,0684,371,103,474,27,501,757,66.18%,49.01%,1
彰化縣,埔鹽鄉,0685,373,97,470,32,502,806,62.28%,46.28%,1
彰化縣,埔鹽鄉,0686,603,107,710,51,761,1280,59.45%,47.11%,1
彰化縣,埔鹽鄉,0687,421,87,508,40,548,928,59.05%,45.37%,1
彰化縣,埔鹽鄉,0688,415,122,537,56,593,895,66.26%,46.37%,1
彰化縣,埔鹽鄉,0689,373,100,473,53,526,815,64.54%,45.77%,1
彰化縣,埔鹽鄉,0690,433,92,525,35,560,957,58.52%,45.25%,1
彰化縣,埔鹽鄉,0691,580,106,686,100,786,1338,58.74%,43.35%,1
彰化縣,埔鹽鄉,0692,484,113,597,38,635,1106,57.41%,43.76%,1
彰化縣,埔鹽鄉,0693,363,75,438,35,473,690,68.55%,52.61%,1
彰化縣,埔鹽鄉,0694,537,117,654,50,704,1230,57.24%,43.66%,1
彰化縣,埔鹽鄉,0695,387,76,463,23,486,847,57.38%,45.69%,1
彰化縣,埔鹽鄉,0696,448,98,546,16,562,897,62.65%,49.94%,1
彰化縣,埔鹽鄉,0697,384,102,486,43,529,882,59.98%,43.54%,1
彰化縣,埔鹽鄉,0698,558,120,678,38,716,1180,60.68%,47.29%,1
彰化縣,埔鹽鄉,0699,488,143,631,74,705,1215,58.02%,40.16%,1
彰化縣,埔鹽鄉,0700,236,23,259,22,281,422,66.59%,55.92%,1
彰化縣,埔鹽鄉,0701,509,69,578,42,620,1106,56.06%,46.02%,1
彰化縣,埔鹽鄉,0702,402,101,503,60,563,874,64.42%,46%,1
彰化縣,埔鹽鄉,0703,627,152,779,83,862,1445,59.65%,43.39%,1
彰化縣,埔鹽鄉,0704,393,91,484,60,544,875,62.17%,44.91%,1
彰化縣,埔鹽鄉,0705,332,68,400,47,447,837,53.41%,39.67%,1
彰化縣,埔鹽鄉,0706,324,61,385,27,412,685,60.15%,47.3%,1
彰化縣,埔鹽鄉,0707,359,75,434,33,467,733,63.71%,48.98%,1
彰化縣,埔鹽鄉,0708,321,102,423,72,495,798,62.03%,40.23%,1
彰化縣,埔鹽鄉,0709,606,137,743,52,795,1381,57.57%,43.88%,1
彰化縣,埔鹽鄉,0710,534,130,664,42,706,1335,52.88%,40%,1
彰化縣,埔心鄉,0711,516,118,634,75,709,1139,62.25%,45.3%,1
彰化縣,埔心鄉,0712,520,128,648,76,724,1217,59.49%,42.73%,1
彰化縣,埔心鄉,0713,564,139,703,60,763,1248,61.14%,45.19%,1
彰化縣,埔心鄉,0714,550,174,724,74,798,1248,63.94%,44.07%,1
彰化縣,埔心鄉,0715,396,126,522,42,564,916,61.57%,43.23%,1
彰化縣,埔心鄉,0716,302,82,384,27,411,625,65.76%,48.32%,1
彰化縣,埔心鄉,0717,514,144,658,74,732,1271,57.59%,40.44%,1
彰化縣,埔心鄉,0718,288,63,351,25,376,608,61.84%,47.37%,1
彰化縣,埔心鄉,0719,532,135,667,65,732,1132,64.66%,47%,1
彰化縣,埔心鄉,0720,456,129,585,53,638,1027,62.12%,44.4%,1
彰化縣,埔心鄉,0721,431,114,545,45,590,926,63.71%,46.54%,1
彰化縣,埔心鄉,0722,335,91,426,56,482,778,61.95%,43.06%,1
彰化縣,埔心鄉,0723,310,82,392,33,425,660,64.39%,46.97%,1
彰化縣,埔心鄉,0724,620,147,767,53,820,1330,61.65%,46.62%,1
彰化縣,埔心鄉,0725,433,119,552,26,578,991,58.32%,43.69%,1
彰化縣,埔心鄉,0726,445,110,555,33,588,985,59.7%,45.18%,1
彰化縣,埔心鄉,0727,444,115,559,36,595,1034,57.54%,42.94%,1
彰化縣,埔心鄉,0728,285,70,355,40,395,612,64.54%,46.57%,1
彰化縣,埔心鄉,0729,595,132,727,63,790,1236,63.92%,48.14%,1
彰化縣,埔心鄉,0730,332,108,440,46,486,775,62.71%,42.84%,1
彰化縣,埔心鄉,0731,348,107,455,41,496,738,67.21%,47.15%,1
彰化縣,埔心鄉,0732,458,143,601,39,640,1036,61.78%,44.21%,1
彰化縣,埔心鄉,0733,375,114,489,69,558,975,57.23%,38.46%,1
彰化縣,埔心鄉,0734,352,130,482,42,524,885,59.21%,39.77%,1
彰化縣,埔心鄉,0735,404,131,535,54,589,939,62.73%,43.02%,1
彰化縣,埔心鄉,0736,303,71,374,38,412,689,59.8%,43.98%,1
彰化縣,埔心鄉,0737,302,61,363,25,388,659,58.88%,45.83%,1
彰化縣,埔心鄉,0738,371,88,459,37,496,910,54.51%,40.77%,1
彰化縣,埔心鄉,0739,613,201,814,78,892,1352,65.98%,45.34%,1
彰化縣,埔心鄉,0740,320,89,409,33,442,759,58.23%,42.16%,1
彰化縣,埔心鄉,0741,439,83,522,45,567,942,60.19%,46.6%,1
彰化縣,永靖鄉,0606,493,101,594,68,662,1255,52.75%,39.28%,1
彰化縣,永靖鄉,0607,401,92,493,49,542,889,60.97%,45.11%,1
彰化縣,永靖鄉,0608,433,105,538,39,577,1026,56.24%,42.2%,1
彰化縣,永靖鄉,0609,326,84,410,40,450,724,62.15%,45.03%,1
彰化縣,永靖鄉,0610,409,104,513,39,552,924,59.74%,44.26%,1
彰化縣,永靖鄉,0611,295,86,381,39,420,659,63.73%,44.76%,1
彰化縣,永靖鄉,0612,320,85,405,27,432,734,58.86%,43.6%,1
彰化縣,永靖鄉,0613,267,65,332,21,353,758,46.57%,35.22%,1
彰化縣,永靖鄉,0614,408,97,505,43,548,848,64.62%,48.11%,1
彰化縣,永靖鄉,0615,531,158,689,77,766,1404,54.56%,37.82%,1
彰化縣,永靖鄉,0616,401,105,506,43,549,792,69.32%,50.63%,1
彰化縣,永靖鄉,0617,320,80,400,44,444,695,63.88%,46.04%,1
彰化縣,永靖鄉,0618,399,70,469,40,509,821,62%,48.6%,1
彰化縣,永靖鄉,0619,491,113,604,66,670,1064,62.97%,46.15%,1
彰化縣,永靖鄉,0620,343,111,454,31,485,840,57.74%,40.83%,1
彰化縣,永靖鄉,0621,481,136,617,41,658,1079,60.98%,44.58%,1
彰化縣,永靖鄉,0622,496,121,617,37,654,1048,62.4%,47.33%,1
彰化縣,永靖鄉,0623,473,102,575,35,610,960,63.54%,49.27%,1
彰化縣,永靖鄉,0624,356,95,451,28,479,798,60.03%,44.61%,1
彰化縣,永靖鄉,0625,398,109,507,24,531,796,66.71%,50%,1
彰化縣,永靖鄉,0626,271,69,340,38,378,662,57.1%,40.94%,1
彰化縣,永靖鄉,0627,434,128,562,47,609,1040,58.56%,41.73%,1
彰化縣,永靖鄉,0628,433,110,543,44,587,1025,57.27%,42.24%,1
彰化縣,永靖鄉,0629,657,147,804,57,861,1357,63.45%,48.42%,1
彰化縣,永靖鄉,0630,550,121,671,74,745,1236,60.28%,44.5%,1
彰化縣,永靖鄉,0631,342,88,430,43,473,871,54.31%,39.27%,1
彰化縣,永靖鄉,0632,281,63,344,39,383,706,54.25%,39.8%,1
彰化縣,永靖鄉,0633,376,82,458,27,485,770,62.99%,48.83%,1
彰化縣,永靖鄉,0634,330,80,410,30,440,669,65.77%,49.33%,1
彰化縣,永靖鄉,0635,363,88,451,44,495,862,57.42%,42.11%,1
彰化縣,永靖鄉,0636,356,84,440,32,472,847,55.73%,42.03%,1
彰化縣,永靖鄉,0637,321,63,384,45,429,668,64.22%,48.05%,1
彰化縣,永靖鄉,0638,426,92,518,26,544,1073,50.7%,39.7%,1
彰化縣,永靖鄉,0639,451,142,593,59,652,1339,48.69%,33.68%,1
彰化縣,社頭鄉,0778,316,109,425,38,463,791,58.53%,39.95%,1
彰化縣,社頭鄉,0779,415,109,524,36,560,984,56.91%,42.17%,1
彰化縣,社頭鄉,0780,386,109,495,16,511,990,51.62%,38.99%,1
彰化縣,社頭鄉,0781,455,122,577,52,629,1016,61.91%,44.78%,1
彰化縣,社頭鄉,0782,492,136,628,31,659,1091,60.4%,45.1%,1
彰化縣,社頭鄉,0783,536,141,677,66,743,1236,60.11%,43.37%,1
彰化縣,社頭鄉,0784,530,90,620,29,649,1203,53.95%,44.06%,1
彰化縣,社頭鄉,0785,313,91,404,24,428,753,56.84%,41.57%,1
彰化縣,社頭鄉,0786,273,83,356,30,386,725,53.24%,37.66%,1
彰化縣,社頭鄉,0787,446,109,555,69,624,1023,61%,43.6%,1
彰化縣,社頭鄉,0788,264,80,344,34,378,562,67.26%,46.98%,1
彰化縣,社頭鄉,0789,435,111,546,32,578,1049,55.1%,41.47%,1
彰化縣,社頭鄉,0790,422,101,523,36,559,933,59.91%,45.23%,1
彰化縣,社頭鄉,0791,448,112,560,45,605,990,61.11%,45.25%,1
彰化縣,社頭鄉,0792,425,100,525,37,562,1076,52.23%,39.5%,1
彰化縣,社頭鄉,0793,341,88,429,19,448,742,60.38%,45.96%,1
彰化縣,社頭鄉,0794,279,65,344,18,362,672,53.87%,41.52%,1
彰化縣,社頭鄉,0795,495,96,591,37,628,1235,50.85%,40.08%,1
彰化縣,社頭鄉,0796,317,97,414,37,451,750,60.13%,42.27%,1
彰化縣,社頭鄉,0797,360,95,455,30,485,895,54.19%,40.22%,1
彰化縣,社頭鄉,0798,313,52,365,21,386,688,56.1%,45.49%,1
彰化縣,社頭鄉,0799,367,76,443,34,477,870,54.83%,42.18%,1
彰化縣,社頭鄉,0800,532,124,656,23,679,1140,59.56%,46.67%,1
彰化縣,社頭鄉,0801,415,134,549,34,583,985,59.19%,42.13%,1
彰化縣,社頭鄉,0802,606,131,737,49,786,1266,62.09%,47.87%,1
彰化縣,社頭鄉,0803,399,115,514,38,552,937,58.91%,42.58%,1
彰化縣,社頭鄉,0804,538,109,647,43,690,1219,56.6%,44.13%,1
彰化縣,社頭鄉,0805,472,129,601,70,671,1165,57.6%,40.52%,1
彰化縣,社頭鄉,0806,428,110,538,46,584,986,59.23%,43.41%,1
彰化縣,社頭鄉,0807,333,95,428,30,458,724,63.26%,45.99%,1
彰化縣,社頭鄉,0808,471,79,550,40,590,1015,58.13%,46.4%,1
彰化縣,社頭鄉,0809,423,118,541,31,572,1116,51.25%,37.9%,1
彰化縣,社頭鄉,0810,400,121,521,53,574,1061,54.1%,37.7%,1
彰化縣,社頭鄉,0811,448,111,559,43,602,992,60.69%,45.16%,1
彰化縣,社頭鄉,0812,429,116,545,26,571,1092,52.29%,39.29%,1
彰化縣,社頭鄉,0813,367,94,461,44,505,828,60.99%,44.32%,1
彰化縣,社頭鄉,0814,296,76,372,53,425,787,54%,37.61%,1
彰化縣,社頭鄉,0815,267,55,322,22,344,719,47.84%,37.13%,1
彰化縣,二水鄉,0816,410,131,541,66,607,1028,59.05%,39.88%,1
彰化縣,二水鄉,0817,307,79,386,47,433,689,62.84%,44.56%,1
彰化縣,二水鄉,0818,325,99,424,46,470,871,53.96%,37.31%,1
彰化縣,二水鄉,0819,426,83,509,52,561,953,58.87%,44.7%,1
彰化縣,二水鄉,0820,209,82,291,49,340,624,54.49%,33.49%,1
彰化縣,二水鄉,0821,310,77,387,41,428,645,66.36%,48.06%,1
彰化縣,二水鄉,0822,494,115,609,40,649,986,65.82%,50.1%,1
彰化縣,二水鄉,0823,434,122,556,63,619,943,65.64%,46.02%,1
彰化縣,二水鄉,0824,204,57,261,2,263,455,57.8%,44.84%,1
彰化縣,二水鄉,0825,401,117,518,38,556,831,66.91%,48.26%,1
彰化縣,二水鄉,0826,380,88,468,33,501,831,60.29%,45.73%,1
彰化縣,二水鄉,0827,400,130,530,21,551,1013,54.39%,39.49%,1
彰化縣,二水鄉,0828,312,123,435,70,505,796,63.44%,39.2%,1
彰化縣,二水鄉,0829,319,86,405,50,455,781,58.26%,40.85%,1
彰化縣,二水鄉,0830,258,73,331,18,349,692,50.43%,37.28%,1
彰化縣,二水鄉,0831,271,69,340,30,370,635,58.27%,42.68%,1
彰化縣,二水鄉,0832,223,76,299,28,327,566,57.77%,39.4%,1
彰化縣,北斗鎮,0833,358,84,442,72,514,925,55.57%,38.7%,1
彰化縣,北斗鎮,0834,385,94,479,52,531,869,61.1%,44.3%,1
彰化縣,北斗鎮,0835,396,114,510,42,552,855,64.56%,46.32%,1
彰化縣,北斗鎮,0836,494,133,627,46,673,1065,63.19%,46.38%,1
彰化縣,北斗鎮,0837,343,98,441,60,501,828,60.51%,41.43%,1
彰化縣,北斗鎮,0838,505,117,622,51,673,1124,59.88%,44.93%,1
彰化縣,北斗鎮,0839,496,124,620,46,666,1096,60.77%,45.26%,1
彰化縣,北斗鎮,0840,530,135,665,42,707,1213,58.29%,43.69%,1
彰化縣,北斗鎮,0841,470,106,576,69,645,1164,55.41%,40.38%,1
彰化縣,北斗鎮,0842,308,70,378,27,405,730,55.48%,42.19%,1
彰化縣,北斗鎮,0843,383,88,471,27,498,878,56.72%,43.62%,1
彰化縣,北斗鎮,0844,394,83,477,34,511,833,61.34%,47.3%,1
彰化縣,北斗鎮,0845,441,95,536,33,569,957,59.46%,46.08%,1
彰化縣,北斗鎮,0846,332,77,409,30,439,783,56.07%,42.4%,1
彰化縣,北斗鎮,0847,228,58,286,28,314,573,54.8%,39.79%,1
彰化縣,北斗鎮,0848,271,74,345,38,383,672,56.99%,40.33%,1
彰化縣,北斗鎮,0849,266,73,339,39,378,695,54.39%,38.27%,1
彰化縣,北斗鎮,0850,290,76,366,35,401,747,53.68%,38.82%,1
彰化縣,北斗鎮,0851,322,65,387,23,410,643,63.76%,50.08%,1
彰化縣,北斗鎮,0852,296,70,366,40,406,662,61.33%,44.71%,1
彰化縣,北斗鎮,0853,501,129,630,54,684,1085,63.04%,46.18%,1
彰化縣,北斗鎮,0854,491,120,611,54,665,1121,59.32%,43.8%,1
彰化縣,北斗鎮,0855,388,82,470,38,508,830,61.2%,46.75%,1
彰化縣,北斗鎮,0856,402,104,506,40,546,975,56%,41.23%,1
彰化縣,北斗鎮,0857,506,123,629,31,660,1212,54.46%,41.75%,1
彰化縣,北斗鎮,0858,582,128,710,70,780,1302,59.91%,44.7%,1
彰化縣,北斗鎮,0859,410,89,499,32,531,1077,49.3%,38.07%,1
彰化縣,北斗鎮,0860,369,76,445,61,506,917,55.18%,40.24%,1
彰化縣,北斗鎮,0861,342,83,425,32,457,825,55.39%,41.45%,1
彰化縣,北斗鎮,0862,416,91,507,48,555,937,59.23%,44.4%,1
彰化縣,二林鎮,0942,236,54,290,22,312,731,42.68%,32.28%,1
彰化縣,二林鎮,0943,437,104,541,46,587,1025,57.27%,42.63%,1
彰化縣,二林鎮,0944,329,102,431,21,452,784,57.65%,41.96%,1
彰化縣,二林鎮,0945,380,99,479,36,515,892,57.74%,42.6%,1
彰化縣,二林鎮,0946,507,149,656,61,717,1256,57.09%,40.37%,1
彰化縣,二林鎮,0947,430,88,518,52,570,1043,54.65%,41.23%,1
彰化縣,二林鎮,0948,495,114,609,40,649,1076,60.32%,46%,1
彰化縣,二林鎮,0949,477,101,578,57,635,1082,58.69%,44.09%,1
彰化縣,二林鎮,0950,564,137,701,57,758,1427,53.12%,39.52%,1
彰化縣,二林鎮,0951,373,86,459,67,526,1030,51.07%,36.21%,1
彰化縣,二林鎮,0952,373,106,479,55,534,1033,51.69%,36.11%,1
彰化縣,二林鎮,0953,413,85,498,50,548,977,56.09%,42.27%,1
彰化縣,二林鎮,0954,259,65,324,27,351,683,51.39%,37.92%,1
彰化縣,二林鎮,0955,382,88,470,40,510,975,52.31%,39.18%,1
彰化縣,二林鎮,0956,429,97,526,70,596,1336,44.61%,32.11%,1
彰化縣,二林鎮,0957,329,96,425,60,485,1019,47.6%,32.29%,1
彰化縣,二林鎮,0958,309,86,395,46,441,1003,43.97%,30.81%,1
彰化縣,二林鎮,0959,493,94,587,59,646,1151,56.13%,42.83%,1
彰化縣,二林鎮,0960,655,158,813,96,909,1598,56.88%,40.99%,1
彰化縣,二林鎮,0961,598,144,742,54,796,1488,53.49%,40.19%,1
彰化縣,二林鎮,0962,780,73,853,53,906,1771,51.16%,44.04%,1
彰化縣,二林鎮,0963,428,115,543,43,586,1360,43.09%,31.47%,1
彰化縣,二林鎮,0964,557,134,691,62,753,1613,46.68%,34.53%,1
彰化縣,二林鎮,0965,455,101,556,78,634,1228,51.63%,37.05%,1
彰化縣,二林鎮,0966,356,60,416,22,438,771,56.81%,46.17%,1
彰化縣,二林鎮,0967,359,100,459,39,498,858,58.04%,41.84%,1
彰化縣,二林鎮,0968,245,51,296,1,297,661,44.93%,37.07%,1
彰化縣,二林鎮,0969,451,104,555,67,622,1268,49.05%,35.57%,1
彰化縣,二林鎮,0970,390,88,478,28,506,1081,46.81%,36.08%,1
彰化縣,二林鎮,0971,453,97,550,33,583,1213,48.06%,37.35%,1
彰化縣,二林鎮,0972,548,126,674,68,742,1328,55.87%,41.27%,1
彰化縣,二林鎮,0973,373,90,463,71,534,1118,47.76%,33.36%,1
彰化縣,二林鎮,0974,389,100,489,45,534,1157,46.15%,33.62%,1
彰化縣,二林鎮,0975,348,94,442,46,488,972,50.21%,35.8%,1
彰化縣,二林鎮,0976,358,84,442,43,485,902,53.77%,39.69%,1
彰化縣,二林鎮,0977,562,133,695,98,793,1273,62.29%,44.15%,1
彰化縣,二林鎮,0978,414,95,509,39,548,1087,50.41%,38.09%,1
彰化縣,二林鎮,0979,397,105,502,76,578,987,58.56%,40.22%,1
彰化縣,二林鎮,0980,204,65,269,24,293,719,40.75%,28.37%,1
彰化縣,田尾鄉,0863,474,145,619,39,658,1284,51.25%,36.92%,1
彰化縣,田尾鄉,0864,518,147,665,60,725,1187,61.08%,43.64%,1
彰化縣,田尾鄉,0865,445,124,569,40,609,1033,58.95%,43.08%,1
彰化縣,田尾鄉,0866,322,66,388,38,426,696,61.21%,46.26%,1
彰化縣,田尾鄉,0867,422,82,504,32,536,872,61.47%,48.39%,1
彰化縣,田尾鄉,0868,298,43,341,21,362,680,53.24%,43.82%,1
彰化縣,田尾鄉,0869,383,126,509,45,554,875,63.31%,43.77%,1
彰化縣,田尾鄉,0870,476,139,615,87,702,1337,52.51%,35.6%,1
彰化縣,田尾鄉,0871,658,133,791,47,838,1376,60.9%,47.82%,1
彰化縣,田尾鄉,0872,586,113,699,38,737,1186,62.14%,49.41%,1
彰化縣,田尾鄉,0873,467,94,561,44,605,874,69.22%,53.43%,1
彰化縣,田尾鄉,0874,255,74,329,27,356,647,55.02%,39.41%,1
彰化縣,田尾鄉,0875,419,107,526,42,568,959,59.23%,43.69%,1
彰化縣,田尾鄉,0876,101,31,132,10,142,263,53.99%,38.4%,1
彰化縣,田尾鄉,0877,245,63,308,26,334,618,54.05%,39.64%,1
彰化縣,田尾鄉,0878,428,120,548,32,580,938,61.83%,45.63%,1
彰化縣,田尾鄉,0879,449,75,524,39,563,880,63.98%,51.02%,1
彰化縣,田尾鄉,0880,312,84,396,34,430,804,53.48%,38.81%,1
彰化縣,田尾鄉,0881,238,67,305,21,326,592,55.07%,40.2%,1
彰化縣,田尾鄉,0882,499,109,608,73,681,1079,63.11%,46.25%,1
彰化縣,田尾鄉,0883,588,148,736,44,780,1336,58.38%,44.01%,1
彰化縣,田尾鄉,0884,492,112,604,47,651,1198,54.34%,41.07%,1
彰化縣,田尾鄉,0885,248,71,319,35,354,621,57%,39.94%,1
彰化縣,田尾鄉,0886,305,78,383,26,409,760,53.82%,40.13%,1
彰化縣,田尾鄉,0887,498,136,634,67,701,1084,64.67%,45.94%,1
彰化縣,埤頭鄉,0888,417,107,524,58,582,1178,49.41%,35.4%,1
彰化縣,埤頭鄉,0889,225,400,625,43,668,1290,51.78%,17.44%,1
彰化縣,埤頭鄉,0890,385,84,469,57,526,973,54.06%,39.57%,1
彰化縣,埤頭鄉,0891,289,93,382,33,415,783,53%,36.91%,1
彰化縣,埤頭鄉,0892,295,71,366,48,414,733,56.48%,40.25%,1
彰化縣,埤頭鄉,0893,365,93,458,67,525,899,58.4%,40.6%,1
彰化縣,埤頭鄉,0894,403,95,498,48,546,965,56.58%,41.76%,1
彰化縣,埤頭鄉,0895,554,106,660,50,710,1356,52.36%,40.86%,1
彰化縣,埤頭鄉,0896,514,108,622,65,687,1265,54.31%,40.63%,1
彰化縣,埤頭鄉,0897,390,88,478,59,537,877,61.23%,44.47%,1
彰化縣,埤頭鄉,0898,274,59,333,49,382,705,54.18%,38.87%,1
彰化縣,埤頭鄉,0899,489,108,597,40,637,1062,59.98%,46.05%,1
彰化縣,埤頭鄉,0900,554,130,684,56,740,1300,56.92%,42.62%,1
彰化縣,埤頭鄉,0901,396,78,474,61,535,923,57.96%,42.9%,1
彰化縣,埤頭鄉,0902,408,99,507,33,540,1085,49.77%,37.6%,1
彰化縣,埤頭鄉,0903,498,102,600,53,653,1103,59.2%,45.15%,1
彰化縣,埤頭鄉,0904,272,70,342,33,375,735,51.02%,37.01%,1
彰化縣,埤頭鄉,0905,220,58,278,38,316,574,55.05%,38.33%,1
彰化縣,埤頭鄉,0906,288,52,340,43,383,767,49.93%,37.55%,1
彰化縣,埤頭鄉,0907,271,78,349,58,407,737,55.22%,36.77%,1
彰化縣,埤頭鄉,0908,318,118,436,54,490,1058,46.31%,30.06%,1
彰化縣,埤頭鄉,0909,279,81,360,66,426,826,51.57%,33.78%,1
彰化縣,埤頭鄉,0910,381,94,475,72,547,1082,50.55%,35.21%,1
彰化縣,埤頭鄉,0911,326,72,398,48,446,737,60.52%,44.23%,1
彰化縣,埤頭鄉,0912,284,67,351,22,373,711,52.46%,39.94%,1
彰化縣,埤頭鄉,0913,392,136,528,65,593,1043,56.86%,37.58%,1
彰化縣,埤頭鄉,0914,332,81,413,24,437,910,48.02%,36.48%,1
彰化縣,芳苑鄉,0998,225,54,279,51,330,940,35.11%,23.94%,1
彰化縣,芳苑鄉,0999,104,25,129,23,152,403,37.72%,25.81%,1
彰化縣,芳苑鄉,1000,276,61,337,36,373,756,49.34%,36.51%,1
彰化縣,芳苑鄉,1001,118,34,152,26,178,548,32.48%,21.53%,1
彰化縣,芳苑鄉,1002,380,81,461,58,519,997,52.06%,38.11%,1
彰化縣,芳苑鄉,1003,408,108,516,70,586,1300,45.08%,31.38%,1
彰化縣,芳苑鄉,1004,323,66,389,53,442,859,51.46%,37.6%,1
彰化縣,芳苑鄉,1005,268,63,331,16,347,734,47.28%,36.51%,1
彰化縣,芳苑鄉,1006,245,34,279,25,304,636,47.8%,38.52%,1
彰化縣,芳苑鄉,1007,251,63,314,65,379,808,46.91%,31.06%,1
彰化縣,芳苑鄉,1008,216,37,253,42,295,668,44.16%,32.34%,1
彰化縣,芳苑鄉,1009,275,73,348,29,377,744,50.67%,36.96%,1
彰化縣,芳苑鄉,1010,323,76,399,86,485,1026,47.27%,31.48%,1
彰化縣,芳苑鄉,1011,168,37,205,9,214,586,36.52%,28.67%,1
彰化縣,芳苑鄉,1012,222,51,273,40,313,593,52.78%,37.44%,1
彰化縣,芳苑鄉,1013,356,109,465,113,578,1071,53.97%,33.24%,1
彰化縣,芳苑鄉,1014,363,84,447,114,561,1060,52.92%,34.25%,1
彰化縣,芳苑鄉,1015,241,50,291,24,315,708,44.49%,34.04%,1
彰化縣,芳苑鄉,1016,226,67,293,61,354,735,48.16%,30.75%,1
彰化縣,芳苑鄉,1017,220,53,273,58,331,571,57.97%,38.53%,1
彰化縣,芳苑鄉,1018,239,37,276,32,308,729,42.25%,32.78%,1
彰化縣,芳苑鄉,1019,224,60,284,64,348,674,51.63%,33.23%,1
彰化縣,芳苑鄉,1020,313,85,398,40,438,846,51.77%,37%,1
彰化縣,芳苑鄉,1021,326,76,402,51,453,806,56.2%,40.45%,1
彰化縣,芳苑鄉,1022,124,34,158,8,166,470,35.32%,26.38%,1
彰化縣,芳苑鄉,1023,466,74,540,74,614,1124,54.63%,41.46%,1
彰化縣,芳苑鄉,1024,110,17,127,25,152,317,47.95%,34.7%,1
彰化縣,芳苑鄉,1025,351,87,438,55,493,1158,42.57%,30.31%,1
彰化縣,芳苑鄉,1026,334,75,409,19,428,967,44.26%,34.54%,1
彰化縣,芳苑鄉,1027,293,60,353,41,394,762,51.71%,38.45%,1
彰化縣,芳苑鄉,1028,341,82,423,54,477,1086,43.92%,31.4%,1
彰化縣,芳苑鄉,1029,286,60,346,21,367,747,49.13%,38.29%,1
彰化縣,芳苑鄉,1030,197,40,237,28,265,653,40.58%,30.17%,1
彰化縣,芳苑鄉,1031,362,89,451,61,512,872,58.72%,41.51%,1
彰化縣,芳苑鄉,1032,567,127,694,49,743,1235,60.16%,45.91%,1
彰化縣,芳苑鄉,1033,408,171,579,64,643,1102,58.35%,37.02%,1
彰化縣,大城鄉,0981,301,69,370,29,399,1288,30.98%,23.37%,1
彰化縣,大城鄉,0982,277,74,351,74,425,1104,38.5%,25.09%,1
彰化縣,大城鄉,0983,380,95,475,62,537,964,55.71%,39.42%,1
彰化縣,大城鄉,0984,438,110,548,59,607,1312,46.27%,33.38%,1
彰化縣,大城鄉,0985,243,61,304,62,366,853,42.91%,28.49%,1
彰化縣,大城鄉,0986,132,28,160,21,181,518,34.94%,25.48%,1
彰化縣,大城鄉,0987,182,42,224,25,249,574,43.38%,31.71%,1
彰化縣,大城鄉,0988,181,56,237,31,268,702,38.18%,25.78%,1
彰化縣,大城鄉,0989,78,23,101,15,116,376,30.85%,20.74%,1
彰化縣,大城鄉,0990,163,32,195,19,214,693,30.88%,23.52%,1
彰化縣,大城鄉,0991,270,66,336,48,384,877,43.79%,30.79%,1
彰化縣,大城鄉,0992,126,40,166,18,184,655,28.09%,19.24%,1
彰化縣,大城鄉,0993,327,48,375,30,405,1103,36.72%,29.65%,1
彰化縣,大城鄉,0994,305,74,379,30,409,1192,34.31%,25.59%,1
彰化縣,大城鄉,0995,273,60,333,28,361,917,39.37%,29.77%,1
彰化縣,大城鄉,0996,168,30,198,27,225,686,32.8%,24.49%,1
彰化縣,大城鄉,0997,209,45,254,20,274,899,30.48%,23.25%,1
彰化縣,竹塘鄉,1034,482,114,596,72,668,1168,57.19%,41.27%,1
彰化縣,竹塘鄉,1035,382,116,498,40,538,965,55.75%,39.59%,1
彰化縣,竹塘鄉,1036,416,125,541,56,597,960,62.19%,43.33%,1
彰化縣,竹塘鄉,1037,338,90,428,55,483,743,65.01%,45.49%,1
彰化縣,竹塘鄉,1038,243,56,299,38,337,751,44.87%,32.36%,1
彰化縣,竹塘鄉,1039,271,66,337,43,380,792,47.98%,34.22%,1
彰化縣,竹塘鄉,1040,234,62,296,13,309,733,42.16%,31.92%,1
彰化縣,竹塘鄉,1041,242,55,297,50,347,657,52.82%,36.83%,1
彰化縣,竹塘鄉,1042,416,81,497,31,528,1063,49.67%,39.13%,1
彰化縣,竹塘鄉,1043,454,104,558,76,634,1114,56.91%,40.75%,1
彰化縣,竹塘鄉,1044,218,78,296,46,342,506,67.59%,43.08%,1
彰化縣,竹塘鄉,1045,294,80,374,45,419,823,50.91%,35.72%,1
彰化縣,竹塘鄉,1046,225,73,298,31,329,654,50.31%,34.4%,1
彰化縣,竹塘鄉,1047,178,40,218,26,244,577,42.29%,30.85%,1
彰化縣,竹塘鄉,1048,278,78,356,51,407,772,52.72%,36.01%,1
彰化縣,竹塘鄉,1049,166,46,212,37,249,543,45.86%,30.57%,1
彰化縣,溪州鄉,0915,327,68,395,36,431,778,55.4%,42.03%,1
彰化縣,溪州鄉,0916,364,109,473,23,496,1061,46.75%,34.31%,1
彰化縣,溪州鄉,0917,225,66,291,33,324,701,46.22%,32.1%,1
彰化縣,溪州鄉,0918,376,101,477,53,530,879,60.3%,42.78%,1
彰化縣,溪州鄉,0919,303,87,390,41,431,654,65.9%,46.33%,1
彰化縣,溪州鄉,0920,371,83,454,35,489,878,55.69%,42.26%,1
彰化縣,溪州鄉,0921,423,114,537,43,580,942,61.57%,44.9%,1
彰化縣,溪州鄉,0922,359,78,437,32,469,871,53.85%,41.22%,1
彰化縣,溪州鄉,0923,396,97,493,25,518,1047,49.47%,37.82%,1
彰化縣,溪州鄉,0924,372,81,453,50,503,858,58.62%,43.36%,1
彰化縣,溪州鄉,0925,462,114,576,65,641,1409,45.49%,32.79%,1
彰化縣,溪州鄉,0926,277,80,357,22,379,792,47.85%,34.97%,1
彰化縣,溪州鄉,0927,249,87,336,50,386,714,54.06%,34.87%,1
彰化縣,溪州鄉,0928,375,107,482,55,537,1109,48.42%,33.81%,1
彰化縣,溪州鄉,0929,290,91,381,43,424,962,44.07%,30.15%,1
彰化縣,溪州鄉,0930,376,95,471,56,527,1157,45.55%,32.5%,1
彰化縣,溪州鄉,0931,368,80,448,42,490,952,51.47%,38.66%,1
彰化縣,溪州鄉,0932,340,98,438,39,477,887,53.78%,38.33%,1
彰化縣,溪州鄉,0933,270,67,337,43,380,866,43.88%,31.18%,1
彰化縣,溪州鄉,0934,327,86,413,68,481,1010,47.62%,32.38%,1
彰化縣,溪州鄉,0935,303,93,396,26,422,853,49.47%,35.52%,1
彰化縣,溪州鄉,0936,298,75,373,63,436,843,51.72%,35.35%,1
彰化縣,溪州鄉,0937,186,47,233,11,244,711,34.32%,26.16%,1
彰化縣,溪州鄉,0938,313,89,402,65,467,851,54.88%,36.78%,1
彰化縣,溪州鄉,0939,301,76,377,29,406,883,45.98%,34.09%,1
彰化縣,溪州鄉,0940,420,103,523,50,573,1247,45.95%,33.68%,1
彰化縣,溪州鄉,0941,598,157,755,79,834,1490,55.97%,40.13%,1
南投縣,南投市,0001,425,99,524,24,548,927,59.12%,45.85%,1
南投縣,南投市,0002,340,87,427,27,454,667,68.07%,50.97%,1
南投縣,南投市,0003,377,75,452,25,477,773,61.71%,48.77%,1
南投縣,南投市,0004,383,95,478,35,513,818,62.71%,46.82%,1
南投縣,南投市,0005,272,63,335,21,356,525,67.81%,51.81%,1
南投縣,南投市,0006,275,77,352,29,381,575,66.26%,47.83%,1
南投縣,南投市,0007,191,52,243,10,253,368,68.75%,51.9%,1
南投縣,南投市,0008,466,112,578,54,632,956,66.11%,48.74%,1
南投縣,南投市,0009,522,112,634,22,656,1245,52.69%,41.93%,1
南投縣,南投市,0010,996,122,1118,22,1140,1484,76.82%,67.12%,1
南投縣,南投市,0011,622,121,743,36,779,1191,65.41%,52.23%,1
南投縣,南投市,0012,715,150,865,51,916,1506,60.82%,47.48%,1
南投縣,南投市,0013,502,140,642,33,675,1070,63.08%,46.92%,1
南投縣,南投市,0014,327,65,392,26,418,670,62.39%,48.81%,1
南投縣,南投市,0015,534,121,655,38,693,1050,66%,50.86%,1
南投縣,南投市,0016,468,99,567,47,614,1122,54.72%,41.71%,1
南投縣,南投市,0017,419,108,527,31,558,984,56.71%,42.58%,1
南投縣,南投市,0018,552,102,654,22,676,1062,63.65%,51.98%,1
南投縣,南投市,0019,486,107,593,45,638,1053,60.59%,46.15%,1
南投縣,南投市,0020,325,347,672,30,702,1104,63.59%,29.44%,1
南投縣,南投市,0021,542,112,654,37,691,1192,57.97%,45.47%,1
南投縣,南投市,0022,419,92,511,36,547,960,56.98%,43.65%,1
南投縣,南投市,0023,435,82,517,41,558,906,61.59%,48.01%,1
南投縣,南投市,0024,445,104,549,42,591,957,61.76%,46.5%,1
南投縣,南投市,0025,480,132,612,40,652,997,65.4%,48.14%,1
南投縣,南投市,0026,483,108,591,36,627,1008,62.2%,47.92%,1
南投縣,南投市,0027,534,119,653,33,686,1164,58.93%,45.88%,1
南投縣,南投市,0028,293,43,336,18,354,587,60.31%,49.91%,1
南投縣,南投市,0029,284,89,373,29,402,734,54.77%,38.69%,1
南投縣,南投市,0030,319,70,389,33,422,724,58.29%,44.06%,1
南投縣,南投市,0031,482,85,567,29,596,1003,59.42%,48.06%,1
南投縣,南投市,0032,626,123,749,42,791,1356,58.33%,46.17%,1
南投縣,南投市,0033,588,119,707,40,747,1373,54.41%,42.83%,1
南投縣,南投市,0034,621,151,772,34,806,1452,55.51%,42.77%,1
南投縣,南投市,0035,162,26,188,9,197,362,54.42%,44.75%,1
南投縣,南投市,0036,170,40,210,24,234,389,60.15%,43.7%,1
南投縣,南投市,0037,643,146,789,42,831,1276,65.13%,50.39%,1
南投縣,南投市,0038,543,125,668,37,705,1089,64.74%,49.86%,1
南投縣,南投市,0039,458,95,553,40,593,921,64.39%,49.73%,1
南投縣,南投市,0040,514,95,609,25,634,892,71.08%,57.62%,1
南投縣,南投市,0041,567,84,651,36,687,1050,65.43%,54%,1
南投縣,南投市,0042,573,91,664,19,683,1078,63.36%,53.15%,1
南投縣,南投市,0043,543,89,632,35,667,1078,61.87%,50.37%,1
南投縣,南投市,0044,500,99,599,23,622,861,72.24%,58.07%,1
南投縣,南投市,0045,565,107,672,55,727,1221,59.54%,46.27%,1
南投縣,南投市,0046,515,107,622,24,646,1105,58.46%,46.61%,1
南投縣,南投市,0047,587,137,724,29,753,1230,61.22%,47.72%,1
南投縣,南投市,0048,564,86,650,25,675,1092,61.81%,51.65%,1
南投縣,南投市,0049,686,110,796,25,821,1286,63.84%,53.34%,1
南投縣,南投市,0050,358,63,421,29,450,655,68.7%,54.66%,1
南投縣,南投市,0051,366,85,451,24,475,719,66.06%,50.9%,1
南投縣,南投市,0052,340,56,396,21,417,720,57.92%,47.22%,1
南投縣,南投市,0053,272,54,326,16,342,509,67.19%,53.44%,1
南投縣,南投市,0054,231,38,269,10,279,492,56.71%,46.95%,1
南投縣,南投市,0055,315,45,360,17,377,616,61.2%,51.14%,1
南投縣,南投市,0056,519,87,606,30,636,1010,62.97%,51.39%,1
南投縣,南投市,0057,439,55,494,17,511,848,60.26%,51.77%,1
南投縣,南投市,0058,675,147,822,65,887,1387,63.95%,48.67%,1
南投縣,南投市,0059,632,137,769,34,803,1245,64.5%,50.76%,1
南投縣,南投市,0060,556,107,663,27,690,1199,57.55%,46.37%,1
南投縣,南投市,0061,598,139,737,40,777,1288,60.33%,46.43%,1
南投縣,南投市,0062,480,104,584,40,624,1040,60%,46.15%,1
南投縣,南投市,0063,510,107,617,47,664,1070,62.06%,47.66%,1
南投縣,南投市,0064,673,116,789,33,822,1299,63.28%,51.81%,1
南投縣,南投市,0065,571,118,689,30,719,1122,64.08%,50.89%,1
南投縣,南投市,0066,664,138,802,40,842,1414,59.55%,46.96%,1
南投縣,南投市,0067,528,97,625,36,661,1121,58.97%,47.1%,1
南投縣,南投市,0068,648,145,793,24,817,1434,56.97%,45.19%,1
南投縣,南投市,0069,611,130,741,32,773,1393,55.49%,43.86%,1
南投縣,南投市,0070,462,115,577,14,591,1059,55.81%,43.63%,1
南投縣,南投市,0071,553,119,672,33,705,1218,57.88%,45.4%,1
南投縣,南投市,0072,543,108,651,17,668,1293,51.66%,42%,1
南投縣,南投市,0073,535,115,650,37,687,1337,51.38%,40.01%,1
南投縣,南投市,0074,412,107,519,27,546,876,62.33%,47.03%,1
南投縣,南投市,0075,438,99,537,26,563,971,57.98%,45.11%,1
南投縣,南投市,0076,429,134,563,30,593,1012,58.6%,42.39%,1
南投縣,南投市,0077,421,77,498,38,536,973,55.09%,43.27%,1
南投縣,南投市,0078,475,122,597,32,629,1002,62.77%,47.41%,1
南投縣,南投市,0079,455,115,570,38,608,1024,59.38%,44.43%,1
南投縣,南投市,0080,398,108,506,88,594,1122,52.94%,35.47%,1
南投縣,南投市,0081,280,85,365,32,397,790,50.25%,35.44%,1
南投縣,南投市,0082,210,40,250,24,274,647,42.35%,32.46%,1
南投縣,南投市,0083,408,81,489,41,530,950,55.79%,42.95%,1
南投縣,南投市,0084,410,75,485,22,507,980,51.73%,41.84%,1
南投縣,埔里鎮,0085,393,73,466,35,501,828,60.51%,47.46%,1
南投縣,埔里鎮,0086,366,80,446,39,485,786,61.7%,46.56%,1
南投縣,埔里鎮,0087,470,102,572,37,609,1062,57.34%,44.26%,1
南投縣,埔里鎮,0088,608,121,729,39,768,1201,63.95%,50.62%,1
南投縣,埔里鎮,0089,605,134,739,32,771,1415,54.49%,42.76%,1
南投縣,埔里鎮,0090,580,106,686,26,712,1282,55.54%,45.24%,1
南投縣,埔里鎮,0091,394,66,460,38,498,859,57.97%,45.87%,1
南投縣,埔里鎮,0092,563,124,687,62,749,1288,58.15%,43.71%,1
南投縣,埔里鎮,0093,625,113,738,27,765,1330,57.52%,46.99%,1
南投縣,埔里鎮,0094,609,112,721,45,766,1416,54.1%,43.01%,1
南投縣,埔里鎮,0095,491,103,594,39,633,1283,49.34%,38.27%,1
南投縣,埔里鎮,0096,600,27,627,71,698,1151,60.64%,52.13%,1
南投縣,埔里鎮,0097,498,105,603,31,634,1193,53.14%,41.74%,1
南投縣,埔里鎮,0098,665,129,794,56,850,1471,57.78%,45.21%,1
南投縣,埔里鎮,0099,413,68,481,52,533,1044,51.05%,39.56%,1
南投縣,埔里鎮,0100,521,99,620,49,669,1122,59.63%,46.43%,1
南投縣,埔里鎮,0101,569,109,678,47,725,1129,64.22%,50.4%,1
南投縣,埔里鎮,0102,393,78,471,14,485,901,53.83%,43.62%,1
南投縣,埔里鎮,0103,427,77,504,43,547,997,54.86%,42.83%,1
南投縣,埔里鎮,0104,532,112,644,40,684,1209,56.58%,44%,1
南投縣,埔里鎮,0105,429,87,516,30,546,838,65.16%,51.19%,1
南投縣,埔里鎮,0106,481,90,571,42,613,1226,50%,39.23%,1
南投縣,埔里鎮,0107,613,130,743,42,785,1263,62.15%,48.54%,1
南投縣,埔里鎮,0108,524,86,610,29,639,1045,61.15%,50.14%,1
南投縣,埔里鎮,0109,566,91,657,37,694,1120,61.96%,50.54%,1
南投縣,埔里鎮,0110,528,124,652,40,692,1062,65.16%,49.72%,1
南投縣,埔里鎮,0111,474,83,557,28,585,1022,57.24%,46.38%,1
南投縣,埔里鎮,0112,466,104,570,28,598,1051,56.9%,44.34%,1
南投縣,埔里鎮,0113,488,96,584,32,616,1106,55.7%,44.12%,1
南投縣,埔里鎮,0114,493,89,582,18,600,1098,54.64%,44.9%,1
南投縣,埔里鎮,0115,525,77,602,31,633,1067,59.33%,49.2%,1
南投縣,埔里鎮,0116,305,70,375,55,430,725,59.31%,42.07%,1
南投縣,埔里鎮,0117,435,76,511,25,536,905,59.23%,48.07%,1
南投縣,埔里鎮,0118,498,101,599,41,640,1179,54.28%,42.24%,1
南投縣,埔里鎮,0119,357,102,459,33,492,944,52.12%,37.82%,1
南投縣,埔里鎮,0120,203,41,244,25,269,465,57.85%,43.66%,1
南投縣,埔里鎮,0121,500,97,597,42,639,1133,56.4%,44.13%,1
南投縣,埔里鎮,0122,456,84,540,38,578,1100,52.55%,41.45%,1
南投縣,埔里鎮,0123,516,112,628,49,677,1155,58.61%,44.68%,1
南投縣,埔里鎮,0124,513,118,631,39,670,1254,53.43%,40.91%,1
南投縣,埔里鎮,0125,541,103,644,54,698,1296,53.86%,41.74%,1
南投縣,埔里鎮,0126,489,136,625,37,662,1023,64.71%,47.8%,1
南投縣,埔里鎮,0127,395,51,446,18,464,964,48.13%,40.98%,1
南投縣,埔里鎮,0128,457,84,541,28,569,986,57.71%,46.35%,1
南投縣,埔里鎮,0129,491,103,594,22,616,1016,60.63%,48.33%,1
南投縣,埔里鎮,0130,388,102,490,42,532,898,59.24%,43.21%,1
南投縣,埔里鎮,0131,464,94,558,36,594,980,60.61%,47.35%,1
南投縣,埔里鎮,0132,344,99,443,22,465,933,49.84%,36.87%,1
南投縣,埔里鎮,0133,490,126,616,34,650,929,69.97%,52.74%,1
南投縣,埔里鎮,0134,454,98,552,38,590,1032,57.17%,43.99%,1
南投縣,埔里鎮,0135,118,18,136,12,148,315,46.98%,37.46%,1
南投縣,埔里鎮,0136,552,120,672,44,716,1363,52.53%,40.5%,1
南投縣,埔里鎮,0137,350,59,409,29,438,725,60.41%,48.28%,1
南投縣,埔里鎮,0138,313,94,407,21,428,705,60.71%,44.4%,1
南投縣,埔里鎮,0139,390,70,460,29,489,751,65.11%,51.93%,1
南投縣,埔里鎮,0140,427,76,503,31,534,932,57.3%,45.82%,1
南投縣,埔里鎮,0141,435,102,537,31,568,956,59.41%,45.5%,1
南投縣,埔里鎮,0142,68,30,98,13,111,376,29.52%,18.09%,1
南投縣,埔里鎮,0143,298,71,369,38,407,682,59.68%,43.7%,1
南投縣,埔里鎮,0144,558,37,595,53,648,990,65.45%,56.36%,1
南投縣,埔里鎮,0145,500,105,605,69,674,1324,50.91%,37.76%,1
南投縣,埔里鎮,0146,107,26,133,13,146,298,48.99%,35.91%,1
南投縣,埔里鎮,0147,511,86,597,55,652,1170,55.73%,43.68%,1
南投縣,埔里鎮,0148,270,61,331,22,353,604,58.44%,44.7%,1
南投縣,埔里鎮,0149,420,106,526,30,556,999,55.66%,42.04%,1
南投縣,埔里鎮,0150,369,59,428,25,453,923,49.08%,39.98%,1
南投縣,埔里鎮,0151,424,85,509,27,536,887,60.43%,47.8%,1
南投縣,埔里鎮,0152,396,96,492,24,516,981,52.6%,40.37%,1
南投縣,草屯鎮,0153,487,98,585,17,602,998,60.32%,48.8%,1
南投縣,草屯鎮,0154,499,102,601,23,624,1127,55.37%,44.28%,1
南投縣,草屯鎮,0155,500,205,705,24,729,1401,52.03%,35.69%,1
南投縣,草屯鎮,0156,434,144,578,35,613,1110,55.23%,39.1%,1
南投縣,草屯鎮,0157,578,142,720,40,760,1285,59.14%,44.98%,1
南投縣,草屯鎮,0158,418,87,505,28,533,936,56.94%,44.66%,1
南投縣,草屯鎮,0159,487,128,615,46,661,1141,57.93%,42.68%,1
南投縣,草屯鎮,0160,340,81,421,23,444,705,62.98%,48.23%,1
南投縣,草屯鎮,0161,524,123,647,17,664,1121,59.23%,46.74%,1
南投縣,草屯鎮,0162,440,116,556,31,587,877,66.93%,50.17%,1
南投縣,草屯鎮,0163,647,137,784,40,824,1401,58.82%,46.18%,1
南投縣,草屯鎮,0164,532,123,655,40,695,1267,54.85%,41.99%,1
南投縣,草屯鎮,0165,577,84,661,60,721,1214,59.39%,47.53%,1
南投縣,草屯鎮,0166,553,128,681,65,746,1259,59.25%,43.92%,1
南投縣,草屯鎮,0167,711,133,844,26,870,1442,60.33%,49.31%,1
南投縣,草屯鎮,0168,613,107,720,42,762,1273,59.86%,48.15%,1
南投縣,草屯鎮,0169,528,91,619,35,654,1145,57.12%,46.11%,1
南投縣,草屯鎮,0170,577,110,687,24,711,1279,55.59%,45.11%,1
南投縣,草屯鎮,0171,515,96,611,28,639,1158,55.18%,44.47%,1
南投縣,草屯鎮,0172,727,112,839,46,885,1335,66.29%,54.46%,1
南投縣,草屯鎮,0173,605,126,731,32,763,1178,64.77%,51.36%,1
南投縣,草屯鎮,0174,673,70,743,39,782,1327,58.93%,50.72%,1
南投縣,草屯鎮,0175,462,109,571,19,590,1000,59%,46.2%,1
南投縣,草屯鎮,0176,584,100,684,26,710,1257,56.48%,46.46%,1
南投縣,草屯鎮,0177,449,90,539,23,562,883,63.65%,50.85%,1
南投縣,草屯鎮,0178,504,101,605,26,631,1121,56.29%,44.96%,1
南投縣,草屯鎮,0179,498,93,591,30,621,1043,59.54%,47.75%,1
南投縣,草屯鎮,0180,491,94,585,20,605,979,61.8%,50.15%,1
南投縣,草屯鎮,0181,420,79,499,24,523,1048,49.9%,40.08%,1
南投縣,草屯鎮,0182,435,92,527,41,568,1009,56.29%,43.11%,1
南投縣,草屯鎮,0183,503,85,588,17,605,1138,53.16%,44.2%,1
南投縣,草屯鎮,0184,489,152,641,31,672,1197,56.14%,40.85%,1
南投縣,草屯鎮,0185,634,133,767,37,804,1364,58.94%,46.48%,1
南投縣,草屯鎮,0186,511,92,603,40,643,1059,60.72%,48.25%,1
南投縣,草屯鎮,0187,464,150,614,39,653,1108,58.94%,41.88%,1
南投縣,草屯鎮,0188,398,74,472,29,501,879,57%,45.28%,1
南投縣,草屯鎮,0189,442,85,527,38,565,957,59.04%,46.19%,1
南投縣,草屯鎮,0190,520,118,638,21,659,1395,47.24%,37.28%,1
南投縣,草屯鎮,0191,537,110,647,35,682,1101,61.94%,48.77%,1
南投縣,草屯鎮,0192,547,119,666,35,701,1297,54.05%,42.17%,1
南投縣,草屯鎮,0193,291,74,365,25,390,877,44.47%,33.18%,1
南投縣,草屯鎮,0194,519,125,644,41,685,1376,49.78%,37.72%,1
南投縣,草屯鎮,0195,515,96,611,40,651,1008,64.58%,51.09%,1
南投縣,草屯鎮,0196,528,98,626,38,664,1080,61.48%,48.89%,1
南投縣,草屯鎮,0197,418,102,520,43,563,1017,55.36%,41.1%,1
南投縣,草屯鎮,0198,459,111,570,43,613,961,63.79%,47.76%,1
南投縣,草屯鎮,0199,549,116,665,44,709,1160,61.12%,47.33%,1
南投縣,草屯鎮,0200,508,110,618,26,644,1121,57.45%,45.32%,1
南投縣,草屯鎮,0201,551,121,672,29,701,1243,56.4%,44.33%,1
南投縣,草屯鎮,0202,407,122,529,21,550,932,59.01%,43.67%,1
南投縣,草屯鎮,0203,655,161,816,42,858,1323,64.85%,49.51%,1
南投縣,草屯鎮,0204,590,145,735,33,768,1518,50.59%,38.87%,1
南投縣,草屯鎮,0205,403,126,529,40,569,923,61.65%,43.66%,1
南投縣,草屯鎮,0206,396,103,499,31,530,970,54.64%,40.82%,1
南投縣,草屯鎮,0207,417,121,538,27,565,1026,55.07%,40.64%,1
南投縣,草屯鎮,0208,611,144,755,70,825,1466,56.28%,41.68%,1
南投縣,草屯鎮,0209,527,112,639,35,674,1180,57.12%,44.66%,1
南投縣,草屯鎮,0210,474,122,596,18,614,1006,61.03%,47.12%,1
南投縣,草屯鎮,0211,397,78,475,31,506,1000,50.6%,39.7%,1
南投縣,草屯鎮,0212,543,118,661,27,688,1128,60.99%,48.14%,1
南投縣,草屯鎮,0213,255,70,325,11,336,623,53.93%,40.93%,1
南投縣,草屯鎮,0214,286,87,373,48,421,707,59.55%,40.45%,1
南投縣,草屯鎮,0215,297,66,363,24,387,719,53.82%,41.31%,1
南投縣,草屯鎮,0216,205,33,238,20,258,527,48.96%,38.9%,1
南投縣,草屯鎮,0217,541,115,656,52,708,1183,59.85%,45.73%,1
南投縣,草屯鎮,0218,416,81,497,26,523,869,60.18%,47.87%,1
南投縣,草屯鎮,0219,447,100,547,10,557,1132,49.2%,39.49%,1
南投縣,草屯鎮,0220,422,100,522,44,566,949,59.64%,44.47%,1
南投縣,草屯鎮,0221,458,105,563,11,574,965,59.48%,47.46%,1
南投縣,草屯鎮,0222,419,111,530,32,562,1068,52.62%,39.23%,1
南投縣,草屯鎮,0223,477,115,592,34,626,1024,61.13%,46.58%,1
南投縣,草屯鎮,0224,272,53,325,27,352,642,54.83%,42.37%,1
南投縣,草屯鎮,0225,423,78,501,37,538,1017,52.9%,41.59%,1
南投縣,草屯鎮,0226,494,90,584,38,622,1092,56.96%,45.24%,1
南投縣,草屯鎮,0227,499,105,604,50,654,1170,55.9%,42.65%,1
南投縣,草屯鎮,0228,504,100,604,58,662,1106,59.86%,45.57%,1
南投縣,竹山鎮,0229,538,120,658,46,704,1170,60.17%,45.98%,1
南投縣,竹山鎮,0230,392,101,493,39,532,850,62.59%,46.12%,1
南投縣,竹山鎮,0231,253,60,313,29,342,621,55.07%,40.74%,1
南投縣,竹山鎮,0232,390,83,473,25,498,905,55.03%,43.09%,1
南投縣,竹山鎮,0233,427,82,509,47,556,1099,50.59%,38.85%,1
南投縣,竹山鎮,0234,480,105,585,56,641,1214,52.8%,39.54%,1
南投縣,竹山鎮,0235,602,119,721,56,777,1287,60.37%,46.78%,1
南投縣,竹山鎮,0236,528,113,641,46,687,1191,57.68%,44.33%,1
南投縣,竹山鎮,0237,363,108,471,66,537,1118,48.03%,32.47%,1
南投縣,竹山鎮,0238,571,124,695,26,721,1278,56.42%,44.68%,1
南投縣,竹山鎮,0239,498,127,625,50,675,1153,58.54%,43.19%,1
南投縣,竹山鎮,0240,81,501,582,67,649,1243,52.21%,6.52%,1
南投縣,竹山鎮,0241,577,97,674,47,721,1308,55.12%,44.11%,1
南投縣,竹山鎮,0242,540,138,678,42,720,1358,53.02%,39.76%,1
南投縣,竹山鎮,0243,440,86,526,46,572,1044,54.79%,42.15%,1
南投縣,竹山鎮,0244,254,41,295,26,321,511,62.82%,49.71%,1
南投縣,竹山鎮,0245,306,46,352,8,360,682,52.79%,44.87%,1
南投縣,竹山鎮,0246,360,103,463,23,486,989,49.14%,36.4%,1
南投縣,竹山鎮,0247,594,120,714,31,745,1378,54.06%,43.11%,1
南投縣,竹山鎮,0248,82,25,107,4,111,217,51.15%,37.79%,1
南投縣,竹山鎮,0249,217,46,263,25,288,479,60.13%,45.3%,1
南投縣,竹山鎮,0250,143,41,184,14,198,430,46.05%,33.26%,1
南投縣,竹山鎮,0251,147,604,751,56,807,1437,56.16%,10.23%,1
南投縣,竹山鎮,0252,585,144,729,42,771,1286,59.95%,45.49%,1
南投縣,竹山鎮,0253,511,110,621,35,656,1080,60.74%,47.31%,1
南投縣,竹山鎮,0254,458,104,562,33,595,1070,55.61%,42.8%,1
南投縣,竹山鎮,0255,595,107,702,44,746,1295,57.61%,45.95%,1
南投縣,竹山鎮,0256,453,108,561,28,589,1047,56.26%,43.27%,1
南投縣,竹山鎮,0257,562,126,688,33,721,1300,55.46%,43.23%,1
南投縣,竹山鎮,0258,327,79,406,22,428,908,47.14%,36.01%,1
南投縣,竹山鎮,0259,295,85,380,41,421,821,51.28%,35.93%,1
南投縣,竹山鎮,0260,585,141,726,39,765,1320,57.95%,44.32%,1
南投縣,竹山鎮,0261,374,85,459,30,489,967,50.57%,38.68%,1
南投縣,竹山鎮,0262,234,38,272,18,290,595,48.74%,39.33%,1
南投縣,竹山鎮,0263,337,80,417,57,474,859,55.18%,39.23%,1
南投縣,竹山鎮,0264,470,120,590,58,648,1196,54.18%,39.3%,1
南投縣,竹山鎮,0265,279,60,339,30,369,649,56.86%,42.99%,1
南投縣,竹山鎮,0266,558,135,693,50,743,1341,55.41%,41.61%,1
南投縣,竹山鎮,0267,442,103,545,66,611,1222,50%,36.17%,1
南投縣,竹山鎮,0268,264,57,321,26,347,602,57.64%,43.85%,1
南投縣,竹山鎮,0269,263,54,317,29,346,617,56.08%,42.63%,1
南投縣,竹山鎮,0270,350,89,439,51,490,793,61.79%,44.14%,1
南投縣,竹山鎮,0271,399,78,477,18,495,922,53.69%,43.28%,1
南投縣,竹山鎮,0272,150,25,175,19,194,366,53.01%,40.98%,1
南投縣,竹山鎮,0273,193,23,216,9,225,509,44.2%,37.92%,1
南投縣,竹山鎮,0274,83,12,95,9,104,193,53.89%,43.01%,1
南投縣,竹山鎮,0275,191,41,232,19,251,406,61.82%,47.04%,1
南投縣,竹山鎮,0276,188,41,229,23,252,495,50.91%,37.98%,1
南投縣,竹山鎮,0277,85,12,97,9,106,307,34.53%,27.69%,1
南投縣,竹山鎮,0278,186,29,215,19,234,440,53.18%,42.27%,1
南投縣,竹山鎮,0279,232,42,274,39,313,577,54.25%,40.21%,1
南投縣,竹山鎮,0280,124,55,179,34,213,486,43.83%,25.51%,1
南投縣,竹山鎮,0281,103,29,132,16,148,403,36.72%,25.56%,1
南投縣,集集鎮,0282,509,86,595,49,644,1070,60.19%,47.57%,1
南投縣,集集鎮,0283,439,99,538,23,561,918,61.11%,47.82%,1
南投縣,集集鎮,0284,264,58,322,26,348,581,59.9%,45.44%,1
南投縣,集集鎮,0285,556,120,676,38,714,1194,59.8%,46.57%,1
南投縣,集集鎮,0286,157,42,199,21,220,488,45.08%,32.17%,1
南投縣,集集鎮,0287,233,45,278,35,313,504,62.1%,46.23%,1
南投縣,集集鎮,0288,390,97,487,76,563,910,61.87%,42.86%,1
南投縣,集集鎮,0289,360,73,433,52,485,773,62.74%,46.57%,1
南投縣,集集鎮,0290,298,79,377,25,402,709,56.7%,42.03%,1
南投縣,集集鎮,0291,420,87,507,24,531,960,55.31%,43.75%,1
南投縣,集集鎮,0292,199,57,256,19,275,503,54.67%,39.56%,1
南投縣,集集鎮,0293,31,159,190,21,211,419,50.36%,7.4%,1
南投縣,集集鎮,0294,212,43,255,9,264,582,45.36%,36.43%,1
南投縣,名間鄉,0295,537,142,679,51,730,1050,69.52%,51.14%,1
南投縣,名間鄉,0296,416,95,511,43,554,920,60.22%,45.22%,1
南投縣,名間鄉,0297,361,78,439,35,474,727,65.2%,49.66%,1
南投縣,名間鄉,0298,441,80,521,32,553,861,64.23%,51.22%,1
南投縣,名間鄉,0299,409,81,490,30,520,897,57.97%,45.6%,1
南投縣,名間鄉,0300,493,116,609,39,648,1055,61.42%,46.73%,1
南投縣,名間鄉,0301,531,111,642,56,698,1184,58.95%,44.85%,1
南投縣,名間鄉,0302,322,89,411,35,446,783,56.96%,41.12%,1
南投縣,名間鄉,0303,368,81,449,40,489,781,62.61%,47.12%,1
南投縣,名間鄉,0304,417,78,495,36,531,977,54.35%,42.68%,1
南投縣,名間鄉,0305,409,94,503,59,562,1015,55.37%,40.3%,1
南投縣,名間鄉,0306,429,95,524,22,546,914,59.74%,46.94%,1
南投縣,名間鄉,0307,441,105,546,17,563,1028,54.77%,42.9%,1
南投縣,名間鄉,0308,477,105,582,31,613,1018,60.22%,46.86%,1
南投縣,名間鄉,0309,561,133,694,62,756,1274,59.34%,44.03%,1
南投縣,名間鄉,0310,329,87,416,38,454,755,60.13%,43.58%,1
南投縣,名間鄉,0311,440,106,546,46,592,895,66.15%,49.16%,1
南投縣,名間鄉,0312,442,56,498,25,523,892,58.63%,49.55%,1
南投縣,名間鄉,0313,402,92,494,57,551,951,57.94%,42.27%,1
南投縣,名間鄉,0314,535,130,665,59,724,1261,57.41%,42.43%,1
南投縣,名間鄉,0315,313,94,407,36,443,768,57.68%,40.76%,1
南投縣,名間鄉,0316,416,115,531,53,584,962,60.71%,43.24%,1
南投縣,名間鄉,0317,383,94,477,56,533,867,61.48%,44.18%,1
南投縣,名間鄉,0318,408,94,502,62,564,930,60.65%,43.87%,1
南投縣,名間鄉,0319,256,75,331,57,388,641,60.53%,39.94%,1
南投縣,名間鄉,0320,204,50,254,27,281,530,53.02%,38.49%,1
南投縣,名間鄉,0321,394,98,492,63,555,931,59.61%,42.32%,1
南投縣,名間鄉,0322,507,112,619,52,671,1127,59.54%,44.99%,1
南投縣,名間鄉,0323,211,50,261,33,294,443,66.37%,47.63%,1
南投縣,名間鄉,0324,402,91,493,39,532,870,61.15%,46.21%,1
南投縣,名間鄉,0325,274,60,334,56,390,621,62.8%,44.12%,1
南投縣,名間鄉,0326,454,114,568,37,605,1179,51.31%,38.51%,1
南投縣,名間鄉,0327,441,73,514,44,558,881,63.34%,50.06%,1
南投縣,名間鄉,0328,451,93,544,52,596,876,68.04%,51.48%,1
南投縣,名間鄉,0329,345,69,414,60,474,783,60.54%,44.06%,1
南投縣,名間鄉,0330,326,54,380,39,419,778,53.86%,41.9%,1
南投縣,名間鄉,0331,401,97,498,43,541,983,55.04%,40.79%,1
南投縣,鹿谷鄉,0332,383,64,447,37,484,934,51.82%,41.01%,1
南投縣,鹿谷鄉,0333,403,93,496,41,537,940,57.13%,42.87%,1
南投縣,鹿谷鄉,0334,347,83,430,25,455,852,53.4%,40.73%,1
南投縣,鹿谷鄉,0335,167,24,191,16,207,451,45.9%,37.03%,1
南投縣,鹿谷鄉,0336,386,71,457,32,489,810,60.37%,47.65%,1
南投縣,鹿谷鄉,0337,562,107,669,43,712,1142,62.35%,49.21%,1
南投縣,鹿谷鄉,0338,285,57,342,21,363,766,47.39%,37.21%,1
南投縣,鹿谷鄉,0339,396,80,476,41,517,884,58.48%,44.8%,1
南投縣,鹿谷鄉,0340,333,96,429,30,459,811,56.6%,41.06%,1
南投縣,鹿谷鄉,0341,207,49,256,20,276,581,47.5%,35.63%,1
南投縣,鹿谷鄉,0342,221,54,275,19,294,578,50.87%,38.24%,1
南投縣,鹿谷鄉,0343,226,35,261,18,279,467,59.74%,48.39%,1
南投縣,鹿谷鄉,0344,283,42,325,21,346,622,55.63%,45.5%,1
南投縣,鹿谷鄉,0345,294,66,360,21,381,740,51.49%,39.73%,1
南投縣,鹿谷鄉,0346,311,85,396,35,431,767,56.19%,40.55%,1
南投縣,鹿谷鄉,0347,401,87,488,42,530,909,58.31%,44.11%,1
南投縣,鹿谷鄉,0348,291,54,345,25,370,713,51.89%,40.81%,1
南投縣,鹿谷鄉,0349,266,42,308,28,336,717,46.86%,37.1%,1
南投縣,鹿谷鄉,0350,295,74,369,31,400,794,50.38%,37.15%,1
南投縣,鹿谷鄉,0351,251,70,321,14,335,726,46.14%,34.57%,1
南投縣,鹿谷鄉,0352,235,50,285,27,312,737,42.33%,31.89%,1
南投縣,中寮鄉,0353,371,88,459,46,505,822,61.44%,45.13%,1
南投縣,中寮鄉,0354,123,22,145,10,155,253,61.26%,48.62%,1
南投縣,中寮鄉,0355,75,14,89,6,95,221,42.99%,33.94%,1
南投縣,中寮鄉,0356,130,24,154,2,156,353,44.19%,36.83%,1
南投縣,中寮鄉,0357,164,43,207,29,236,427,55.27%,38.41%,1
南投縣,中寮鄉,0358,172,42,214,13,227,406,55.91%,42.36%,1
南投縣,中寮鄉,0359,115,33,148,12,160,307,52.12%,37.46%,1
南投縣,中寮鄉,0360,308,60,368,32,400,661,60.51%,46.6%,1
南投縣,中寮鄉,0361,143,32,175,18,193,290,66.55%,49.31%,1
南投縣,中寮鄉,0362,437,112,549,23,572,973,58.79%,44.91%,1
南投縣,中寮鄉,0363,352,77,429,26,455,754,60.34%,46.68%,1
南投縣,中寮鄉,0364,277,64,341,27,368,662,55.59%,41.84%,1
南投縣,中寮鄉,0365,185,30,215,14,229,490,46.73%,37.76%,1
南投縣,中寮鄉,0366,134,26,160,15,175,335,52.24%,40%,1
南投縣,中寮鄉,0367,468,71,539,36,575,990,58.08%,47.27%,1
南投縣,中寮鄉,0368,209,64,273,19,292,461,63.34%,45.34%,1
南投縣,中寮鄉,0369,276,71,347,32,379,614,61.73%,44.95%,1
南投縣,中寮鄉,0370,368,84,452,64,516,895,57.65%,41.12%,1
南投縣,中寮鄉,0371,190,44,234,32,266,465,57.2%,40.86%,1
南投縣,中寮鄉,0372,284,69,353,49,402,682,58.94%,41.64%,1
南投縣,中寮鄉,0373,221,40,261,42,303,490,61.84%,45.1%,1
南投縣,中寮鄉,0374,282,69,351,45,396,643,61.59%,43.86%,1
南投縣,中寮鄉,0375,221,45,266,18,284,459,61.87%,48.15%,1
南投縣,中寮鄉,0376,196,48,244,23,267,528,50.57%,37.12%,1
南投縣,魚池鄉,0377,397,85,482,39,521,922,56.51%,43.06%,1
南投縣,魚池鄉,0378,465,131,596,50,646,1098,58.83%,42.35%,1
南投縣,魚池鄉,0379,290,70,360,26,386,720,53.61%,40.28%,1
南投縣,魚池鄉,0380,381,92,473,34,507,860,58.95%,44.3%,1
南投縣,魚池鄉,0381,196,44,240,21,261,514,50.78%,38.13%,1
南投縣,魚池鄉,0382,228,48,276,7,283,574,49.3%,39.72%,1
南投縣,魚池鄉,0383,502,127,629,45,674,1249,53.96%,40.19%,1
南投縣,魚池鄉,0384,149,27,176,16,192,293,65.53%,50.85%,1
南投縣,魚池鄉,0385,207,53,260,18,278,513,54.19%,40.35%,1
南投縣,魚池鄉,0386,67,27,94,8,102,186,54.84%,36.02%,1
南投縣,魚池鄉,0387,317,84,401,29,430,841,51.13%,37.69%,1
南投縣,魚池鄉,0388,122,33,155,13,168,270,62.22%,45.19%,1
南投縣,魚池鄉,0389,108,29,137,15,152,275,55.27%,39.27%,1
南投縣,魚池鄉,0390,95,25,120,10,130,282,46.1%,33.69%,1
南投縣,魚池鄉,0391,150,29,179,8,187,392,47.7%,38.27%,1
南投縣,魚池鄉,0392,241,38,279,24,303,556,54.5%,43.35%,1
南投縣,魚池鄉,0393,71,13,84,12,96,176,54.55%,40.34%,1
南投縣,魚池鄉,0394,214,41,255,16,271,578,46.89%,37.02%,1
南投縣,魚池鄉,0395,161,46,207,17,224,439,51.03%,36.67%,1
南投縣,魚池鄉,0396,407,67,474,26,500,844,59.24%,48.22%,1
南投縣,魚池鄉,0397,387,43,430,36,466,868,53.69%,44.59%,1
南投縣,魚池鄉,0398,155,16,171,18,189,405,46.67%,38.27%,1
南投縣,魚池鄉,0399,215,69,284,21,305,537,56.8%,40.04%,1
南投縣,魚池鄉,0400,142,28,170,14,184,335,54.93%,42.39%,1
南投縣,魚池鄉,0401,79,12,91,13,104,231,45.02%,34.2%,1
南投縣,國姓鄉,0402,457,95,552,48,600,964,62.24%,47.41%,1
南投縣,國姓鄉,0403,322,70,392,24,416,736,56.52%,43.75%,1
南投縣,國姓鄉,0404,362,67,429,44,473,801,59.05%,45.19%,1
南投縣,國姓鄉,0405,444,75,519,10,529,964,54.88%,46.06%,1
南投縣,國姓鄉,0406,302,58,360,26,386,686,56.27%,44.02%,1
南投縣,國姓鄉,0407,280,53,333,29,362,661,54.77%,42.36%,1
南投縣,國姓鄉,0408,290,56,346,35,381,730,52.19%,39.73%,1
南投縣,國姓鄉,0409,308,79,387,47,434,774,56.07%,39.79%,1
南投縣,國姓鄉,0410,327,82,409,14,423,706,59.92%,46.32%,1
南投縣,國姓鄉,0411,417,118,535,39,574,1012,56.72%,41.21%,1
南投縣,國姓鄉,0412,289,81,370,21,391,868,45.05%,33.29%,1
南投縣,國姓鄉,0413,478,62,540,21,561,918,61.11%,52.07%,1
南投縣,國姓鄉,0414,407,76,483,44,527,937,56.24%,43.44%,1
南投縣,國姓鄉,0415,327,72,399,52,451,815,55.34%,40.12%,1
南投縣,國姓鄉,0416,528,109,637,43,680,1134,59.96%,46.56%,1
南投縣,國姓鄉,0417,296,66,362,17,379,714,53.08%,41.46%,1
南投縣,國姓鄉,0418,464,109,573,40,613,1095,55.98%,42.37%,1
南投縣,國姓鄉,0419,181,37,218,19,237,448,52.9%,40.4%,1
南投縣,國姓鄉,0420,452,82,534,36,570,1064,53.57%,42.48%,1
南投縣,國姓鄉,0421,234,43,277,20,297,570,52.11%,41.05%,1
南投縣,水里鄉,0422,330,60,390,30,420,757,55.48%,43.59%,1
南投縣,水里鄉,0423,244,41,285,29,314,554,56.68%,44.04%,1
南投縣,水里鄉,0424,426,113,539,39,578,999,57.86%,42.64%,1
南投縣,水里鄉,0425,250,46,296,16,312,616,50.65%,40.58%,1
南投縣,水里鄉,0426,411,74,485,25,510,875,58.29%,46.97%,1
南投縣,水里鄉,0427,232,41,273,9,282,480,58.75%,48.33%,1
南投縣,水里鄉,0428,184,39,223,23,246,450,54.67%,40.89%,1
南投縣,水里鄉,0429,265,51,316,38,354,643,55.05%,41.21%,1
南投縣,水里鄉,0430,455,104,559,29,588,1004,58.57%,45.32%,1
南投縣,水里鄉,0431,322,57,379,18,397,741,53.58%,43.45%,1
南投縣,水里鄉,0432,344,107,451,19,470,802,58.6%,42.89%,1
南投縣,水里鄉,0433,480,115,595,45,640,998,64.13%,48.1%,1
南投縣,水里鄉,0434,306,83,389,50,439,800,54.88%,38.25%,1
南投縣,水里鄉,0435,267,76,343,21,364,589,61.8%,45.33%,1
南投縣,水里鄉,0436,340,82,422,46,468,887,52.76%,38.33%,1
南投縣,水里鄉,0437,491,95,586,49,635,1217,52.18%,40.35%,1
南投縣,水里鄉,0438,61,11,72,0,72,205,35.12%,29.76%,1
南投縣,水里鄉,0439,160,28,188,21,209,330,63.33%,48.48%,1
南投縣,水里鄉,0440,434,98,532,28,560,1100,50.91%,39.45%,1
南投縣,水里鄉,0441,80,8,88,3,91,275,33.09%,29.09%,1
南投縣,水里鄉,0442,107,17,124,5,129,318,40.57%,33.65%,1
南投縣,水里鄉,0443,322,76,398,46,444,818,54.28%,39.36%,1
南投縣,信義鄉,0444,473,113,586,95,681,1201,56.7%,39.38%,1
南投縣,信義鄉,0445,131,19,150,16,166,329,50.46%,39.82%,1
南投縣,信義鄉,0446,181,65,246,18,264,516,51.16%,35.08%,1
南投縣,信義鄉,0447,137,34,171,20,191,424,45.05%,32.31%,1
南投縣,信義鄉,0448,129,17,146,6,152,321,47.35%,40.19%,1
南投縣,信義鄉,0449,292,56,348,29,377,648,58.18%,45.06%,1
南投縣,信義鄉,0450,261,69,330,94,424,584,72.6%,44.69%,1
南投縣,信義鄉,0451,270,51,321,15,336,1376,24.42%,19.62%,1
南投縣,信義鄉,0452,319,79,398,21,419,979,42.8%,32.58%,1
南投縣,信義鄉,0453,250,66,316,76,392,530,73.96%,47.17%,1
南投縣,信義鄉,0454,348,84,432,51,483,961,50.26%,36.21%,1
南投縣,信義鄉,0455,199,36,235,20,255,464,54.96%,42.89%,1
南投縣,信義鄉,0456,228,48,276,27,303,517,58.61%,44.1%,1
南投縣,信義鄉,0457,61,17,78,9,87,149,58.39%,40.94%,1
南投縣,信義鄉,0458,468,135,603,148,751,1020,73.63%,45.88%,1
南投縣,信義鄉,0459,377,96,473,162,635,929,68.35%,40.58%,1
南投縣,信義鄉,0460,92,24,116,7,123,274,44.89%,33.58%,1
南投縣,信義鄉,0461,472,91,563,66,629,900,69.89%,52.44%,1
南投縣,信義鄉,0462,311,86,397,54,451,617,73.1%,50.41%,1
南投縣,信義鄉,0463,247,73,320,27,347,560,61.96%,44.11%,1
南投縣,仁愛鄉,0464,402,87,489,29,518,973,53.24%,41.32%,1
南投縣,仁愛鄉,0465,116,21,137,13,150,296,50.68%,39.19%,1
南投縣,仁愛鄉,0466,337,48,385,13,398,900,44.22%,37.44%,1
南投縣,仁愛鄉,0467,238,43,281,17,298,460,64.78%,51.74%,1
南投縣,仁愛鄉,0468,151,28,179,4,183,305,60%,49.51%,1
南投縣,仁愛鄉,0469,18,0,18,2,20,58,34.48%,31.03%,1
南投縣,仁愛鄉,0470,304,53,357,11,368,952,38.66%,31.93%,1
南投縣,仁愛鄉,0471,134,99,233,4,237,679,34.9%,19.73%,1
南投縣,仁愛鄉,0472,265,52,317,52,369,623,59.23%,42.54%,1
南投縣,仁愛鄉,0473,123,37,160,2,162,597,27.14%,20.6%,1
南投縣,仁愛鄉,0474,191,36,227,20,247,384,64.32%,49.74%,1
南投縣,仁愛鄉,0475,47,11,58,4,62,121,51.24%,38.84%,1
南投縣,仁愛鄉,0476,112,15,127,5,132,264,50%,42.42%,1
南投縣,仁愛鄉,0477,287,58,345,37,382,509,75.05%,56.39%,1
南投縣,仁愛鄉,0478,147,36,183,24,207,338,61.24%,43.49%,1
南投縣,仁愛鄉,0479,82,6,88,4,92,169,54.44%,48.52%,1
南投縣,仁愛鄉,0480,229,41,270,23,293,613,47.8%,37.36%,1
南投縣,仁愛鄉,0481,134,40,174,16,190,404,47.03%,33.17%,1
南投縣,仁愛鄉,0482,60,12,72,5,77,134,57.46%,44.78%,1
南投縣,仁愛鄉,0483,244,85,329,61,390,630,61.9%,38.73%,1
南投縣,仁愛鄉,0484,230,57,287,6,293,763,38.4%,30.14%,1
南投縣,仁愛鄉,0485,462,66,528,36,564,889,63.44%,51.97%,1
南投縣,仁愛鄉,0486,315,76,391,47,438,672,65.18%,46.88%,1
南投縣,仁愛鄉,0487,204,49,253,19,272,447,60.85%,45.64%,1
南投縣,仁愛鄉,0488,255,34,289,13,302,409,73.84%,62.35%,1
雲林縣,斗六市,0411,266,63,329,9,338,644,52.48%,41.3%,1
雲林縣,斗六市,0412,247,73,320,21,341,617,55.27%,40.03%,1
雲林縣,斗六市,0413,381,90,471,30,501,764,65.58%,49.87%,1
雲林縣,斗六市,0414,336,122,458,29,487,784,62.12%,42.86%,1
雲林縣,斗六市,0415,302,107,409,28,437,760,57.5%,39.74%,1
雲林縣,斗六市,0416,868,207,1075,59,1134,1881,60.29%,46.15%,1
雲林縣,斗六市,0417,754,190,944,48,992,1829,54.24%,41.22%,1
雲林縣,斗六市,0418,609,123,732,41,773,1255,61.59%,48.53%,1
雲林縣,斗六市,0419,576,98,674,29,703,1090,64.5%,52.84%,1
雲林縣,斗六市,0420,521,116,637,37,674,1103,61.11%,47.23%,1
雲林縣,斗六市,0421,551,114,665,40,705,1176,59.95%,46.85%,1
雲林縣,斗六市,0422,686,138,824,21,845,1529,55.26%,44.87%,1
雲林縣,斗六市,0423,635,112,747,40,787,1335,58.95%,47.57%,1
雲林縣,斗六市,0424,802,181,983,54,1037,1770,58.59%,45.31%,1
雲林縣,斗六市,0425,550,165,715,29,744,1308,56.88%,42.05%,1
雲林縣,斗六市,0426,915,190,1105,70,1175,2171,54.12%,42.15%,1
雲林縣,斗六市,0427,524,139,663,43,706,1193,59.18%,43.92%,1
雲林縣,斗六市,0428,757,174,931,49,980,1572,62.34%,48.16%,1
雲林縣,斗六市,0429,419,108,527,27,554,1009,54.91%,41.53%,1
雲林縣,斗六市,0430,586,118,704,40,744,1195,62.26%,49.04%,1
雲林縣,斗六市,0431,635,173,808,54,862,1415,60.92%,44.88%,1
雲林縣,斗六市,0432,491,151,642,35,677,1101,61.49%,44.6%,1
雲林縣,斗六市,0433,668,175,843,31,874,1648,53.03%,40.53%,1
雲林縣,斗六市,0434,643,129,772,32,804,1588,50.63%,40.49%,1
雲林縣,斗六市,0435,656,142,798,29,827,1392,59.41%,47.13%,1
雲林縣,斗六市,0436,649,148,797,33,830,1422,58.37%,45.64%,1
雲林縣,斗六市,0437,455,80,535,27,562,1187,47.35%,38.33%,1
雲林縣,斗六市,0438,453,110,563,29,592,1142,51.84%,39.67%,1
雲林縣,斗六市,0439,686,152,838,51,889,1421,62.56%,48.28%,1
雲林縣,斗六市,0440,554,141,695,25,720,1261,57.1%,43.93%,1
雲林縣,斗六市,0441,600,155,755,32,787,1506,52.26%,39.84%,1
雲林縣,斗六市,0442,556,126,682,32,714,1214,58.81%,45.8%,1
雲林縣,斗六市,0443,642,163,805,64,869,1362,63.8%,47.14%,1
雲林縣,斗六市,0444,458,123,581,14,595,1097,54.24%,41.75%,1
雲林縣,斗六市,0445,567,127,694,28,722,1262,57.21%,44.93%,1
雲林縣,斗六市,0446,499,106,605,28,633,1154,54.85%,43.24%,1
雲林縣,斗六市,0447,374,82,456,51,507,847,59.86%,44.16%,1
雲林縣,斗六市,0448,638,153,791,32,823,1439,57.19%,44.34%,1
雲林縣,斗六市,0449,817,192,1009,50,1059,1747,60.62%,46.77%,1
雲林縣,斗六市,0450,628,136,764,44,808,1418,56.98%,44.29%,1
雲林縣,斗六市,0451,400,188,588,44,632,1112,56.83%,35.97%,1
雲林縣,斗六市,0452,600,113,713,38,751,1302,57.68%,46.08%,1
雲林縣,斗六市,0453,313,91,404,23,427,669,63.83%,46.79%,1
雲林縣,斗六市,0454,326,72,398,32,430,752,57.18%,43.35%,1
雲林縣,斗六市,0455,615,119,734,23,757,1450,52.21%,42.41%,1
雲林縣,斗六市,0456,220,62,282,37,319,555,57.48%,39.64%,1
雲林縣,斗六市,0457,599,123,722,44,766,1470,52.11%,40.75%,1
雲林縣,斗六市,0458,480,51,531,32,563,927,60.73%,51.78%,1
雲林縣,斗六市,0459,873,180,1053,50,1103,1893,58.27%,46.12%,1
雲林縣,斗六市,0460,706,196,902,85,987,1708,57.79%,41.33%,1
雲林縣,斗六市,0461,673,159,832,37,869,1773,49.01%,37.96%,1
雲林縣,斗六市,0462,647,149,796,45,841,1412,59.56%,45.82%,1
雲林縣,斗六市,0463,608,193,801,28,829,1354,61.23%,44.9%,1
雲林縣,斗六市,0464,532,135,667,25,692,1267,54.62%,41.99%,1
雲林縣,斗六市,0465,505,148,653,26,679,1273,53.34%,39.67%,1
雲林縣,斗六市,0466,677,157,834,72,906,1748,51.83%,38.73%,1
雲林縣,斗六市,0467,503,159,662,66,728,1238,58.8%,40.63%,1
雲林縣,斗六市,0468,691,147,838,54,892,1648,54.13%,41.93%,1
雲林縣,斗六市,0469,678,177,855,62,917,1520,60.33%,44.61%,1
雲林縣,斗六市,0470,428,105,533,30,563,1087,51.79%,39.37%,1
雲林縣,斗六市,0471,827,188,1015,58,1073,1904,56.36%,43.43%,1
雲林縣,斗六市,0472,321,65,386,38,424,702,60.4%,45.73%,1
雲林縣,斗六市,0473,446,141,587,54,641,1111,57.7%,40.14%,1
雲林縣,斗六市,0474,396,107,503,30,533,1123,47.46%,35.26%,1
雲林縣,斗六市,0475,464,99,563,25,588,1146,51.31%,40.49%,1
雲林縣,斗六市,0476,711,172,883,48,931,1786,52.13%,39.81%,1
雲林縣,斗六市,0477,412,126,538,42,580,1023,56.7%,40.27%,1
雲林縣,斗六市,0478,830,232,1062,86,1148,2072,55.41%,40.06%,1
雲林縣,斗六市,0479,439,115,554,20,574,1128,50.89%,38.92%,1
雲林縣,斗南鎮,0498,541,106,647,40,687,1166,58.92%,46.4%,1
雲林縣,斗南鎮,0499,518,140,658,30,688,1135,60.62%,45.64%,1
雲林縣,斗南鎮,0500,460,112,572,29,601,975,61.64%,47.18%,1
雲林縣,斗南鎮,0501,661,151,812,42,854,1459,58.53%,45.31%,1
雲林縣,斗南鎮,0502,590,160,750,42,792,1351,58.62%,43.67%,1
雲林縣,斗南鎮,0503,565,123,688,49,737,1321,55.79%,42.77%,1
雲林縣,斗南鎮,0504,366,80,446,50,496,907,54.69%,40.35%,1
雲林縣,斗南鎮,0505,674,156,830,88,918,1473,62.32%,45.76%,1
雲林縣,斗南鎮,0506,564,181,745,57,802,1277,62.8%,44.17%,1
雲林縣,斗南鎮,0507,506,152,658,91,749,1333,56.19%,37.96%,1
雲林縣,斗南鎮,0508,305,68,373,36,409,777,52.64%,39.25%,1
雲林縣,斗南鎮,0509,331,112,443,35,478,877,54.5%,37.74%,1
雲林縣,斗南鎮,0510,367,81,448,42,490,899,54.51%,40.82%,1
雲林縣,斗南鎮,0511,224,54,278,37,315,688,45.78%,32.56%,1
雲林縣,斗南鎮,0512,417,84,501,33,534,1147,46.56%,36.36%,1
雲林縣,斗南鎮,0513,646,211,857,85,942,1709,55.12%,37.8%,1
雲林縣,斗南鎮,0514,453,138,591,38,629,1042,60.36%,43.47%,1
雲林縣,斗南鎮,0515,635,177,812,59,871,1631,53.4%,38.93%,1
雲林縣,斗南鎮,0516,773,176,949,80,1029,1702,60.46%,45.42%,1
雲林縣,斗南鎮,0517,641,208,849,63,912,1564,58.31%,40.98%,1
雲林縣,斗南鎮,0518,328,75,403,23,426,910,46.81%,36.04%,1
雲林縣,斗南鎮,0519,677,143,820,49,869,1276,68.1%,53.06%,1
雲林縣,斗南鎮,0520,302,61,363,22,385,897,42.92%,33.67%,1
雲林縣,斗南鎮,0521,309,85,394,29,423,803,52.68%,38.48%,1
雲林縣,斗南鎮,0522,364,90,454,50,504,866,58.2%,42.03%,1
雲林縣,斗南鎮,0523,355,95,450,52,502,852,58.92%,41.67%,1
雲林縣,斗南鎮,0524,273,63,336,43,379,671,56.48%,40.69%,1
雲林縣,斗南鎮,0525,382,99,481,22,503,981,51.27%,38.94%,1
雲林縣,斗南鎮,0526,385,107,492,27,519,1129,45.97%,34.1%,1
雲林縣,斗南鎮,0527,672,172,844,93,937,1586,59.08%,42.37%,1
雲林縣,斗南鎮,0528,591,154,745,8,753,1243,60.58%,47.55%,1
雲林縣,斗南鎮,0529,349,94,443,18,461,984,46.85%,35.47%,1
雲林縣,斗南鎮,0530,580,164,744,67,811,1507,53.82%,38.49%,1
雲林縣,虎尾鎮,0109,559,142,701,43,744,1347,55.23%,41.5%,1
雲林縣,虎尾鎮,0110,533,155,688,51,739,1258,58.74%,42.37%,1
雲林縣,虎尾鎮,0111,309,89,398,27,425,785,54.14%,39.36%,1
雲林縣,虎尾鎮,0112,306,90,396,42,438,890,49.21%,34.38%,1
雲林縣,虎尾鎮,0113,606,163,769,47,816,1413,57.75%,42.89%,1
雲林縣,虎尾鎮,0114,651,158,809,51,860,1431,60.1%,45.49%,1
雲林縣,虎尾鎮,0115,483,127,610,50,660,1224,53.92%,39.46%,1
雲林縣,虎尾鎮,0116,478,127,605,37,642,1325,48.45%,36.08%,1
雲林縣,虎尾鎮,0117,397,108,505,63,568,941,60.36%,42.19%,1
雲林縣,虎尾鎮,0118,681,154,835,21,856,1613,53.07%,42.22%,1
雲林縣,虎尾鎮,0119,612,173,785,35,820,1641,49.97%,37.29%,1
雲林縣,虎尾鎮,0120,570,128,698,45,743,1200,61.92%,47.5%,1
雲林縣,虎尾鎮,0121,524,154,678,78,756,1294,58.42%,40.49%,1
雲林縣,虎尾鎮,0122,554,124,678,35,713,1273,56.01%,43.52%,1
雲林縣,虎尾鎮,0123,659,151,810,46,856,1438,59.53%,45.83%,1
雲林縣,虎尾鎮,0124,628,127,755,32,787,1361,57.83%,46.14%,1
雲林縣,虎尾鎮,0125,648,183,831,37,868,1444,60.11%,44.88%,1
雲林縣,虎尾鎮,0126,708,185,893,36,929,1490,62.35%,47.52%,1
雲林縣,虎尾鎮,0127,623,165,788,47,835,1307,63.89%,47.67%,1
雲林縣,虎尾鎮,0128,360,112,472,17,489,967,50.57%,37.23%,1
雲林縣,虎尾鎮,0129,745,171,916,47,963,1865,51.64%,39.95%,1
雲林縣,虎尾鎮,0130,745,228,973,45,1018,1880,54.15%,39.63%,1
雲林縣,虎尾鎮,0131,414,115,529,38,567,1099,51.59%,37.67%,1
雲林縣,虎尾鎮,0132,369,103,472,15,487,901,54.05%,40.95%,1
雲林縣,虎尾鎮,0133,425,93,518,47,565,1120,50.45%,37.95%,1
雲林縣,虎尾鎮,0134,192,42,234,8,242,545,44.4%,35.23%,1
雲林縣,虎尾鎮,0135,545,144,689,59,748,1420,52.68%,38.38%,1
雲林縣,虎尾鎮,0136,461,108,569,31,600,1248,48.08%,36.94%,1
雲林縣,虎尾鎮,0137,316,85,401,16,417,799,52.19%,39.55%,1
雲林縣,虎尾鎮,0138,312,86,398,48,446,836,53.35%,37.32%,1
雲林縣,虎尾鎮,0139,313,91,404,44,448,924,48.48%,33.87%,1
雲林縣,虎尾鎮,0140,511,156,667,27,694,1648,42.11%,31.01%,1
雲林縣,虎尾鎮,0141,508,165,673,99,772,1616,47.77%,31.44%,1
雲林縣,虎尾鎮,0142,528,170,698,50,748,1546,48.38%,34.15%,1
雲林縣,虎尾鎮,0143,489,102,591,34,625,1283,48.71%,38.11%,1
雲林縣,虎尾鎮,0144,375,105,480,34,514,1078,47.68%,34.79%,1
雲林縣,虎尾鎮,0145,442,107,549,50,599,1313,45.62%,33.66%,1
雲林縣,虎尾鎮,0146,432,128,560,34,594,1284,46.26%,33.64%,1
雲林縣,虎尾鎮,0147,517,130,647,81,728,1356,53.69%,38.13%,1
雲林縣,虎尾鎮,0148,585,134,719,79,798,1504,53.06%,38.9%,1
雲林縣,虎尾鎮,0149,398,105,503,36,539,1224,44.04%,32.52%,1
雲林縣,虎尾鎮,0150,537,115,652,56,708,1509,46.92%,35.59%,1
雲林縣,虎尾鎮,0151,211,95,306,57,363,855,42.46%,24.68%,1
雲林縣,虎尾鎮,0152,492,145,637,81,718,1549,46.35%,31.76%,1
雲林縣,虎尾鎮,0153,294,66,360,31,391,851,45.95%,34.55%,1
雲林縣,虎尾鎮,0154,476,86,562,74,636,1272,50%,37.42%,1
雲林縣,西螺鎮,0340,566,70,636,60,696,1590,43.77%,35.6%,1
雲林縣,西螺鎮,0341,688,211,899,85,984,1741,56.52%,39.52%,1
雲林縣,西螺鎮,0342,521,123,644,53,697,1080,64.54%,48.24%,1
雲林縣,西螺鎮,0343,487,111,598,48,646,1040,62.12%,46.83%,1
雲林縣,西螺鎮,0344,578,134,712,28,740,1346,54.98%,42.94%,1
雲林縣,西螺鎮,0345,670,158,828,48,876,1625,53.91%,41.23%,1
雲林縣,西螺鎮,0346,165,42,207,11,218,354,61.58%,46.61%,1
雲林縣,西螺鎮,0347,220,60,280,38,318,580,54.83%,37.93%,1
雲林縣,西螺鎮,0348,267,76,343,30,373,591,63.11%,45.18%,1
雲林縣,西螺鎮,0349,438,129,567,52,619,1050,58.95%,41.71%,1
雲林縣,西螺鎮,0350,496,153,649,57,706,1147,61.55%,43.24%,1
雲林縣,西螺鎮,0351,639,158,797,65,862,1602,53.81%,39.89%,1
雲林縣,西螺鎮,0352,558,147,705,50,755,1452,52%,38.43%,1
雲林縣,西螺鎮,0353,610,203,813,81,894,1578,56.65%,38.66%,1
雲林縣,西螺鎮,0354,525,101,626,21,647,1305,49.58%,40.23%,1
雲林縣,西螺鎮,0355,425,136,561,36,597,1327,44.99%,32.03%,1
雲林縣,西螺鎮,0356,566,162,728,51,779,1516,51.39%,37.34%,1
雲林縣,西螺鎮,0357,243,66,309,23,332,828,40.1%,29.35%,1
雲林縣,西螺鎮,0358,211,54,265,18,283,788,35.91%,26.78%,1
雲林縣,西螺鎮,0359,289,94,383,67,450,863,52.14%,33.49%,1
雲林縣,西螺鎮,0360,343,107,450,65,515,984,52.34%,34.86%,1
雲林縣,西螺鎮,0361,514,161,675,138,813,1514,53.7%,33.95%,1
雲林縣,西螺鎮,0362,301,113,414,52,466,870,53.56%,34.6%,1
雲林縣,西螺鎮,0363,375,90,465,51,516,971,53.14%,38.62%,1
雲林縣,西螺鎮,0364,399,132,531,51,582,1304,44.63%,30.6%,1
雲林縣,西螺鎮,0365,263,50,313,34,347,726,47.8%,36.23%,1
雲林縣,西螺鎮,0366,329,78,407,42,449,823,54.56%,39.98%,1
雲林縣,西螺鎮,0367,275,55,330,16,346,886,39.05%,31.04%,1
雲林縣,西螺鎮,0368,478,131,609,76,685,1373,49.89%,34.81%,1
雲林縣,西螺鎮,0369,377,95,472,59,531,983,54.02%,38.35%,1
雲林縣,西螺鎮,0370,390,103,493,52,545,1014,53.75%,38.46%,1
雲林縣,西螺鎮,0371,316,80,396,82,478,939,50.91%,33.65%,1
雲林縣,西螺鎮,0372,306,80,386,42,428,866,49.42%,35.33%,1
雲林縣,西螺鎮,0373,490,134,624,98,722,1486,48.59%,32.97%,1
雲林縣,土庫鎮,0080,354,101,455,57,512,809,63.29%,43.76%,1
雲林縣,土庫鎮,0081,363,114,477,62,539,896,60.16%,40.51%,1
雲林縣,土庫鎮,0082,280,81,361,37,398,687,57.93%,40.76%,1
雲林縣,土庫鎮,0083,362,77,439,31,470,702,66.95%,51.57%,1
雲林縣,土庫鎮,0084,491,110,601,35,636,1032,61.63%,47.58%,1
雲林縣,土庫鎮,0085,243,71,314,57,371,697,53.23%,34.86%,1
雲林縣,土庫鎮,0086,157,34,191,34,225,427,52.69%,36.77%,1
雲林縣,土庫鎮,0087,618,169,787,55,842,1451,58.03%,42.59%,1
雲林縣,土庫鎮,0088,538,154,692,26,718,1283,55.96%,41.93%,1
雲林縣,土庫鎮,0089,201,71,272,7,279,634,44.01%,31.7%,1
雲林縣,土庫鎮,0090,304,84,388,33,421,796,52.89%,38.19%,1
雲林縣,土庫鎮,0091,231,54,285,45,330,745,44.3%,31.01%,1
雲林縣,土庫鎮,0092,200,70,270,18,288,576,50%,34.72%,1
雲林縣,土庫鎮,0093,243,58,301,55,356,743,47.91%,32.71%,1
雲林縣,土庫鎮,0094,175,49,224,12,236,534,44.19%,32.77%,1
雲林縣,土庫鎮,0095,367,100,467,79,546,1199,45.54%,30.61%,1
雲林縣,土庫鎮,0096,357,113,470,69,539,1077,50.05%,33.15%,1
雲林縣,土庫鎮,0097,249,52,301,32,333,819,40.66%,30.4%,1
雲林縣,土庫鎮,0098,256,70,326,42,368,684,53.8%,37.43%,1
雲林縣,土庫鎮,0099,312,91,403,53,456,843,54.09%,37.01%,1
雲林縣,土庫鎮,0100,321,89,410,75,485,916,52.95%,35.04%,1
雲林縣,土庫鎮,0101,303,110,413,50,463,948,48.84%,31.96%,1
雲林縣,土庫鎮,0102,340,91,431,35,466,914,50.98%,37.2%,1
雲林縣,土庫鎮,0103,332,66,398,66,464,860,53.95%,38.6%,1
雲林縣,土庫鎮,0104,312,100,412,59,471,929,50.7%,33.58%,1
雲林縣,土庫鎮,0105,283,83,366,51,417,875,47.66%,32.34%,1
雲林縣,土庫鎮,0106,270,59,329,32,361,896,40.29%,30.13%,1
雲林縣,土庫鎮,0107,226,63,289,52,341,757,45.05%,29.85%,1
雲林縣,土庫鎮,0108,214,70,284,43,327,683,47.88%,31.33%,1
雲林縣,北港鎮,0256,285,84,369,58,427,724,58.98%,39.36%,1
雲林縣,北港鎮,0257,287,79,366,61,427,688,62.06%,41.72%,1
雲林縣,北港鎮,0258,182,43,225,41,266,452,58.85%,40.27%,1
雲林縣,北港鎮,0259,334,105,439,68,507,866,58.55%,38.57%,1
雲林縣,北港鎮,0260,121,36,157,20,177,336,52.68%,36.01%,1
雲林縣,北港鎮,0261,156,31,187,30,217,395,54.94%,39.49%,1
雲林縣,北港鎮,0262,172,38,210,27,237,376,63.03%,45.74%,1
雲林縣,北港鎮,0263,379,116,495,50,545,950,57.37%,39.89%,1
雲林縣,北港鎮,0264,207,69,276,44,320,512,62.5%,40.43%,1
雲林縣,北港鎮,0265,135,36,171,27,198,324,61.11%,41.67%,1
雲林縣,北港鎮,0266,209,58,267,31,298,546,54.58%,38.28%,1
雲林縣,北港鎮,0267,188,48,236,22,258,433,59.58%,43.42%,1
雲林縣,北港鎮,0268,277,93,370,61,431,751,57.39%,36.88%,1
雲林縣,北港鎮,0269,196,51,247,26,273,442,61.76%,44.34%,1
雲林縣,北港鎮,0270,485,118,603,63,666,1151,57.86%,42.14%,1
雲林縣,北港鎮,0271,507,143,650,61,711,1224,58.09%,41.42%,1
雲林縣,北港鎮,0272,477,118,595,50,645,1211,53.26%,39.39%,1
雲林縣,北港鎮,0273,535,135,670,84,754,1326,56.86%,40.35%,1
雲林縣,北港鎮,0274,332,99,431,47,478,744,64.25%,44.62%,1
雲林縣,北港鎮,0275,457,108,565,62,627,977,64.18%,46.78%,1
雲林縣,北港鎮,0276,347,113,460,66,526,960,54.79%,36.15%,1
雲林縣,北港鎮,0277,136,30,166,6,172,494,34.82%,27.53%,1
雲林縣,北港鎮,0278,591,143,734,52,786,1364,57.62%,43.33%,1
雲林縣,北港鎮,0279,468,112,580,59,639,1123,56.9%,41.67%,1
雲林縣,北港鎮,0280,589,164,753,65,818,1451,56.37%,40.59%,1
雲林縣,北港鎮,0281,496,131,627,65,692,1162,59.55%,42.69%,1
雲林縣,北港鎮,0282,401,142,543,42,585,1130,51.77%,35.49%,1
雲林縣,北港鎮,0283,407,116,523,45,568,1149,49.43%,35.42%,1
雲林縣,北港鎮,0284,160,44,204,36,240,533,45.03%,30.02%,1
雲林縣,北港鎮,0285,190,55,245,21,266,433,61.43%,43.88%,1
雲林縣,北港鎮,0286,145,24,169,9,178,377,47.21%,38.46%,1
雲林縣,北港鎮,0287,254,71,325,23,348,809,43.02%,31.4%,1
雲林縣,北港鎮,0288,449,119,568,75,643,1397,46.03%,32.14%,1
雲林縣,北港鎮,0289,346,93,439,89,528,1145,46.11%,30.22%,1
雲林縣,北港鎮,0290,193,58,251,62,313,828,37.8%,23.31%,1
雲林縣,北港鎮,0291,155,43,198,22,220,557,39.5%,27.83%,1
雲林縣,北港鎮,0292,338,113,451,48,499,1060,47.08%,31.89%,1
雲林縣,北港鎮,0293,185,64,249,30,279,577,48.35%,32.06%,1
雲林縣,北港鎮,0294,262,82,344,66,410,931,44.04%,28.14%,1
雲林縣,北港鎮,0295,401,104,505,44,549,1018,53.93%,39.39%,1
雲林縣,北港鎮,0296,403,119,522,26,548,1032,53.1%,39.05%,1
雲林縣,古坑鄉,0531,435,118,553,61,614,1126,54.53%,38.63%,1
雲林縣,古坑鄉,0532,393,82,475,46,521,994,52.41%,39.54%,1
雲林縣,古坑鄉,0533,538,170,708,48,756,1517,49.84%,35.46%,1
雲林縣,古坑鄉,0534,525,127,652,42,694,1302,53.3%,40.32%,1
雲林縣,古坑鄉,0535,642,172,814,53,867,1772,48.93%,36.23%,1
雲林縣,古坑鄉,0536,440,128,568,77,645,1122,57.49%,39.22%,1
雲林縣,古坑鄉,0537,70,19,89,4,93,304,30.59%,23.03%,1
雲林縣,古坑鄉,0538,492,109,601,77,678,1169,58%,42.09%,1
雲林縣,古坑鄉,0539,453,125,578,68,646,1255,51.47%,36.1%,1
雲林縣,古坑鄉,0540,468,144,612,40,652,1078,60.48%,43.41%,1
雲林縣,古坑鄉,0541,345,70,415,24,439,943,46.55%,36.59%,1
雲林縣,古坑鄉,0542,480,124,604,66,670,1300,51.54%,36.92%,1
雲林縣,古坑鄉,0543,348,84,432,46,478,964,49.59%,36.1%,1
雲林縣,古坑鄉,0544,461,109,570,46,616,1144,53.85%,40.3%,1
雲林縣,古坑鄉,0545,601,121,722,64,786,1482,53.04%,40.55%,1
雲林縣,古坑鄉,0546,294,54,348,37,385,688,55.96%,42.73%,1
雲林縣,古坑鄉,0547,356,90,446,45,491,998,49.2%,35.67%,1
雲林縣,古坑鄉,0548,481,127,608,43,651,1140,57.11%,42.19%,1
雲林縣,古坑鄉,0549,427,114,541,48,589,1102,53.45%,38.75%,1
雲林縣,古坑鄉,0550,375,102,477,20,497,956,51.99%,39.23%,1
雲林縣,古坑鄉,0551,258,81,339,25,364,695,52.37%,37.12%,1
雲林縣,古坑鄉,0552,372,190,562,17,579,1233,46.96%,30.17%,1
雲林縣,古坑鄉,0553,77,25,102,4,106,285,37.19%,27.02%,1
雲林縣,古坑鄉,0554,204,52,256,10,266,734,36.24%,27.79%,1
雲林縣,古坑鄉,0555,431,118,549,84,633,1150,55.04%,37.48%,1
雲林縣,古坑鄉,0556,160,51,211,19,230,453,50.77%,35.32%,1
雲林縣,古坑鄉,0557,195,51,246,31,277,571,48.51%,34.15%,1
雲林縣,大埤鄉,0480,301,68,369,34,403,750,53.73%,40.13%,1
雲林縣,大埤鄉,0481,247,78,325,25,350,719,48.68%,34.35%,1
雲林縣,大埤鄉,0482,237,55,292,20,312,603,51.74%,39.3%,1
雲林縣,大埤鄉,0483,331,132,463,56,519,1106,46.93%,29.93%,1
雲林縣,大埤鄉,0484,547,153,700,71,771,1495,51.57%,36.59%,1
雲林縣,大埤鄉,0485,255,70,325,31,356,600,59.33%,42.5%,1
雲林縣,大埤鄉,0486,422,120,542,47,589,1004,58.67%,42.03%,1
雲林縣,大埤鄉,0487,259,84,343,19,362,948,38.19%,27.32%,1
雲林縣,大埤鄉,0488,634,138,772,59,831,1539,54%,41.2%,1
雲林縣,大埤鄉,0489,509,114,623,63,686,1430,47.97%,35.59%,1
雲林縣,大埤鄉,0490,157,46,203,30,233,465,50.11%,33.76%,1
雲林縣,大埤鄉,0491,487,107,594,50,644,1307,49.27%,37.26%,1
雲林縣,大埤鄉,0492,163,54,217,23,240,474,50.63%,34.39%,1
雲林縣,大埤鄉,0493,492,156,648,81,729,1220,59.75%,40.33%,1
雲林縣,大埤鄉,0494,257,67,324,19,343,733,46.79%,35.06%,1
雲林縣,大埤鄉,0495,268,63,331,34,365,681,53.6%,39.35%,1
雲林縣,大埤鄉,0496,211,56,267,29,296,712,41.57%,29.63%,1
雲林縣,大埤鄉,0497,211,90,301,47,348,723,48.13%,29.18%,1
雲林縣,莿桐鄉,0374,576,195,771,79,850,1507,56.4%,38.22%,1
雲林縣,莿桐鄉,0375,528,126,654,42,696,1300,53.54%,40.62%,1
雲林縣,莿桐鄉,0376,515,165,680,83,763,1272,59.98%,40.49%,1
雲林縣,莿桐鄉,0377,294,102,396,62,458,861,53.19%,34.15%,1
雲林縣,莿桐鄉,0378,521,146,667,65,732,1565,46.77%,33.29%,1
雲林縣,莿桐鄉,0379,199,58,257,20,277,577,48.01%,34.49%,1
雲林縣,莿桐鄉,0380,179,78,257,44,301,636,47.33%,28.14%,1
雲林縣,莿桐鄉,0381,379,116,495,78,573,1110,51.62%,34.14%,1
雲林縣,莿桐鄉,0382,400,122,522,65,587,973,60.33%,41.11%,1
雲林縣,莿桐鄉,0383,372,110,482,67,549,985,55.74%,37.77%,1
雲林縣,莿桐鄉,0384,694,213,907,103,1010,1707,59.17%,40.66%,1
雲林縣,莿桐鄉,0385,496,144,640,89,729,1284,56.78%,38.63%,1
雲林縣,莿桐鄉,0386,496,168,664,72,736,1293,56.92%,38.36%,1
雲林縣,莿桐鄉,0387,360,92,452,58,510,900,56.67%,40%,1
雲林縣,莿桐鄉,0388,407,114,521,98,619,1040,59.52%,39.13%,1
雲林縣,莿桐鄉,0389,443,110,553,29,582,1165,49.96%,38.03%,1
雲林縣,莿桐鄉,0390,333,102,435,57,492,871,56.49%,38.23%,1
雲林縣,莿桐鄉,0391,391,95,486,49,535,885,60.45%,44.18%,1
雲林縣,莿桐鄉,0392,510,149,659,71,730,1489,49.03%,34.25%,1
雲林縣,莿桐鄉,0393,467,117,584,92,676,1347,50.19%,34.67%,1
雲林縣,莿桐鄉,0394,465,138,603,64,667,1150,58%,40.43%,1
雲林縣,莿桐鄉,0395,279,67,346,41,387,653,59.26%,42.73%,1
雲林縣,林內鄉,0396,466,131,597,58,655,1036,63.22%,44.98%,1
雲林縣,林內鄉,0397,612,137,749,87,836,1490,56.11%,41.07%,1
雲林縣,林內鄉,0398,577,143,720,83,803,1491,53.86%,38.7%,1
雲林縣,林內鄉,0399,240,57,297,56,353,671,52.61%,35.77%,1
雲林縣,林內鄉,0400,606,148,754,109,863,1436,60.1%,42.2%,1
雲林縣,林內鄉,0401,313,77,390,52,442,751,58.85%,41.68%,1
雲林縣,林內鄉,0402,206,63,269,24,293,535,54.77%,38.5%,1
雲林縣,林內鄉,0403,280,64,344,43,387,811,47.72%,34.53%,1
雲林縣,林內鄉,0404,536,145,681,85,766,1339,57.21%,40.03%,1
雲林縣,林內鄉,0405,510,114,624,75,699,1286,54.35%,39.66%,1
雲林縣,林內鄉,0406,242,77,319,36,355,646,54.95%,37.46%,1
雲林縣,林內鄉,0407,443,129,572,78,650,1158,56.13%,38.26%,1
雲林縣,林內鄉,0408,448,111,559,56,615,1090,56.42%,41.1%,1
雲林縣,林內鄉,0409,403,109,512,69,581,950,61.16%,42.42%,1
雲林縣,林內鄉,0410,320,96,416,31,447,861,51.92%,37.17%,1
雲林縣,二崙鄉,0317,468,139,607,37,644,1463,44.02%,31.99%,1
雲林縣,二崙鄉,0318,549,175,724,52,776,1738,44.65%,31.59%,1
雲林縣,二崙鄉,0319,187,57,244,51,295,625,47.2%,29.92%,1
雲林縣,二崙鄉,0320,350,83,433,67,500,1018,49.12%,34.38%,1
雲林縣,二崙鄉,0321,122,30,152,4,156,448,34.82%,27.23%,1
雲林縣,二崙鄉,0322,278,81,359,38,397,1048,37.88%,26.53%,1
雲林縣,二崙鄉,0323,426,132,558,74,632,1161,54.44%,36.69%,1
雲林縣,二崙鄉,0324,349,114,463,43,506,991,51.06%,35.22%,1
雲林縣,二崙鄉,0325,331,102,433,65,498,849,58.66%,38.99%,1
雲林縣,二崙鄉,0326,306,92,398,52,450,890,50.56%,34.38%,1
雲林縣,二崙鄉,0327,482,129,611,98,709,1427,49.68%,33.78%,1
雲林縣,二崙鄉,0328,291,92,383,32,415,891,46.58%,32.66%,1
雲林縣,二崙鄉,0329,220,67,287,28,315,757,41.61%,29.06%,1
雲林縣,二崙鄉,0330,472,151,623,103,726,1497,48.5%,31.53%,1
雲林縣,二崙鄉,0331,349,137,486,69,555,1171,47.4%,29.8%,1
雲林縣,二崙鄉,0332,265,85,350,53,403,686,58.75%,38.63%,1
雲林縣,二崙鄉,0333,226,68,294,92,386,864,44.68%,26.16%,1
雲林縣,二崙鄉,0334,423,125,548,67,615,1073,57.32%,39.42%,1
雲林縣,二崙鄉,0335,203,49,252,22,274,696,39.37%,29.17%,1
雲林縣,二崙鄉,0336,311,80,391,53,444,1271,34.93%,24.47%,1
雲林縣,二崙鄉,0337,261,93,354,53,407,912,44.63%,28.62%,1
雲林縣,二崙鄉,0338,243,98,341,35,376,861,43.67%,28.22%,1
雲林縣,二崙鄉,0339,291,102,393,59,452,1030,43.88%,28.25%,1
雲林縣,崙背鄉,0297,456,129,585,69,654,1176,55.61%,38.78%,1
雲林縣,崙背鄉,0298,500,150,650,43,693,1439,48.16%,34.75%,1
雲林縣,崙背鄉,0299,442,96,538,60,598,1027,58.23%,43.04%,1
雲林縣,崙背鄉,0300,519,125,644,46,690,1259,54.81%,41.22%,1
雲林縣,崙背鄉,0301,375,114,489,31,520,1058,49.15%,35.44%,1
雲林縣,崙背鄉,0302,320,98,418,29,447,998,44.79%,32.06%,1
雲林縣,崙背鄉,0303,321,92,413,36,449,968,46.38%,33.16%,1
雲林縣,崙背鄉,0304,384,120,504,47,551,1055,52.23%,36.4%,1
雲林縣,崙背鄉,0305,401,150,551,69,620,1315,47.15%,30.49%,1
雲林縣,崙背鄉,0306,220,75,295,27,322,1027,31.35%,21.42%,1
雲林縣,崙背鄉,0307,393,112,505,82,587,997,58.88%,39.42%,1
雲林縣,崙背鄉,0308,261,128,389,35,424,807,52.54%,32.34%,1
雲林縣,崙背鄉,0309,189,77,266,18,284,698,40.69%,27.08%,1
雲林縣,崙背鄉,0310,220,97,317,49,366,804,45.52%,27.36%,1
雲林縣,崙背鄉,0311,274,93,367,40,407,867,46.94%,31.6%,1
雲林縣,崙背鄉,0312,261,52,313,26,339,886,38.26%,29.46%,1
雲林縣,崙背鄉,0313,399,121,520,91,611,1476,41.4%,27.03%,1
雲林縣,崙背鄉,0314,263,68,331,43,374,1159,32.27%,22.69%,1
雲林縣,崙背鄉,0315,432,130,562,98,660,1220,54.1%,35.41%,1
雲林縣,崙背鄉,0316,295,79,374,31,405,814,49.75%,36.24%,1
雲林縣,麥寮鄉,0001,438,131,569,68,637,1497,42.55%,29.26%,1
雲林縣,麥寮鄉,0002,619,197,816,56,872,1738,50.17%,35.62%,1
雲林縣,麥寮鄉,0003,655,218,873,84,957,1921,49.82%,34.1%,1
雲林縣,麥寮鄉,0004,592,173,765,64,829,1832,45.25%,32.31%,1
雲林縣,麥寮鄉,0005,421,118,539,67,606,1340,45.22%,31.42%,1
雲林縣,麥寮鄉,0006,364,117,481,70,551,1138,48.42%,31.99%,1
雲林縣,麥寮鄉,0007,538,157,695,61,756,1551,48.74%,34.69%,1
雲林縣,麥寮鄉,0008,191,78,269,42,311,715,43.5%,26.71%,1
雲林縣,麥寮鄉,0009,324,118,442,48,490,1194,41.04%,27.14%,1
雲林縣,麥寮鄉,0010,326,106,432,57,489,1023,47.8%,31.87%,1
雲林縣,麥寮鄉,0011,429,113,542,45,587,1558,37.68%,27.54%,1
雲林縣,麥寮鄉,0012,304,137,441,34,475,1187,40.02%,25.61%,1
雲林縣,麥寮鄉,0013,288,100,388,32,420,983,42.73%,29.3%,1
雲林縣,麥寮鄉,0014,445,147,592,74,666,1363,48.86%,32.65%,1
雲林縣,麥寮鄉,0015,506,162,668,88,756,1596,47.37%,31.7%,1
雲林縣,麥寮鄉,0016,604,149,753,109,862,1469,58.68%,41.12%,1
雲林縣,麥寮鄉,0017,288,83,371,48,419,964,43.46%,29.88%,1
雲林縣,麥寮鄉,0018,304,74,378,51,429,1038,41.33%,29.29%,1
雲林縣,麥寮鄉,0019,454,96,550,70,620,1230,50.41%,36.91%,1
雲林縣,麥寮鄉,0020,476,137,613,55,668,1329,50.26%,35.82%,1
雲林縣,麥寮鄉,0021,385,130,515,87,602,1129,53.32%,34.1%,1
雲林縣,麥寮鄉,0022,470,129,599,86,685,1241,55.2%,37.87%,1
雲林縣,麥寮鄉,0023,571,142,713,93,806,1471,54.79%,38.82%,1
雲林縣,麥寮鄉,0024,428,129,557,69,626,1107,56.55%,38.66%,1
雲林縣,麥寮鄉,0025,607,231,838,79,917,1636,56.05%,37.1%,1
雲林縣,麥寮鄉,0026,599,166,765,62,827,1755,47.12%,34.13%,1
雲林縣,麥寮鄉,0027,434,123,557,43,600,1158,51.81%,37.48%,1
雲林縣,麥寮鄉,0028,377,98,475,39,514,956,53.77%,39.44%,1
雲林縣,東勢鄉,0051,384,99,483,53,536,1207,44.41%,31.81%,1
雲林縣,東勢鄉,0052,247,51,298,28,326,540,60.37%,45.74%,1
雲林縣,東勢鄉,0053,259,82,341,30,371,896,41.41%,28.91%,1
雲林縣,東勢鄉,0054,280,66,346,47,393,728,53.98%,38.46%,1
雲林縣,東勢鄉,0055,625,168,793,75,868,1533,56.62%,40.77%,1
雲林縣,東勢鄉,0056,488,134,622,92,714,1203,59.35%,40.57%,1
雲林縣,東勢鄉,0057,251,83,334,57,391,817,47.86%,30.72%,1
雲林縣,東勢鄉,0058,241,50,291,34,325,546,59.52%,44.14%,1
雲林縣,東勢鄉,0059,285,83,368,70,438,853,51.35%,33.41%,1
雲林縣,東勢鄉,0060,215,79,294,65,359,856,41.94%,25.12%,1
雲林縣,東勢鄉,0061,310,80,390,56,446,923,48.32%,33.59%,1
雲林縣,東勢鄉,0062,352,86,438,54,492,1022,48.14%,34.44%,1
雲林縣,東勢鄉,0063,183,35,218,22,240,634,37.85%,28.86%,1
雲林縣,東勢鄉,0064,118,22,140,21,161,394,40.86%,29.95%,1
雲林縣,東勢鄉,0065,304,63,367,38,405,1087,37.26%,27.97%,1
雲林縣,褒忠鄉,0066,363,85,448,62,510,923,55.25%,39.33%,1
雲林縣,褒忠鄉,0067,430,107,537,47,584,993,58.81%,43.3%,1
雲林縣,褒忠鄉,0068,280,81,361,30,391,748,52.27%,37.43%,1
雲林縣,褒忠鄉,0069,257,66,323,20,343,702,48.86%,36.61%,1
雲林縣,褒忠鄉,0070,269,65,334,22,356,752,47.34%,35.77%,1
雲林縣,褒忠鄉,0071,302,74,376,28,404,756,53.44%,39.95%,1
雲林縣,褒忠鄉,0072,186,52,238,14,252,490,51.43%,37.96%,1
雲林縣,褒忠鄉,0073,307,94,401,32,433,1034,41.88%,29.69%,1
雲林縣,褒忠鄉,0074,170,39,209,22,231,470,49.15%,36.17%,1
雲林縣,褒忠鄉,0075,266,82,348,26,374,737,50.75%,36.09%,1
雲林縣,褒忠鄉,0076,326,82,408,31,439,878,50%,37.13%,1
雲林縣,褒忠鄉,0077,261,77,338,52,390,778,50.13%,33.55%,1
雲林縣,褒忠鄉,0078,400,119,519,63,582,1224,47.55%,32.68%,1
雲林縣,褒忠鄉,0079,252,104,356,62,418,896,46.65%,28.13%,1
雲林縣,臺西鄉,0029,521,91,612,65,677,1238,54.68%,42.08%,1
雲林縣,臺西鄉,0030,378,95,473,49,522,1091,47.85%,34.65%,1
雲林縣,臺西鄉,0031,401,109,510,67,577,1098,52.55%,36.52%,1
雲林縣,臺西鄉,0032,309,86,395,42,437,1048,41.7%,29.48%,1
雲林縣,臺西鄉,0033,347,81,428,64,492,1025,48%,33.85%,1
雲林縣,臺西鄉,0034,304,71,375,57,432,850,50.82%,35.76%,1
雲林縣,臺西鄉,0035,413,143,556,85,641,1460,43.9%,28.29%,1
雲林縣,臺西鄉,0036,273,91,364,73,437,1180,37.03%,23.14%,1
雲林縣,臺西鄉,0037,166,34,200,35,235,710,33.1%,23.38%,1
雲林縣,臺西鄉,0038,160,41,201,11,212,620,34.19%,25.81%,1
雲林縣,臺西鄉,0039,150,34,184,29,213,449,47.44%,33.41%,1
雲林縣,臺西鄉,0040,184,50,234,43,277,687,40.32%,26.78%,1
雲林縣,臺西鄉,0041,391,99,490,67,557,1247,44.67%,31.36%,1
雲林縣,臺西鄉,0042,160,24,184,22,206,583,35.33%,27.44%,1
雲林縣,臺西鄉,0043,370,107,477,49,526,1042,50.48%,35.51%,1
雲林縣,臺西鄉,0044,156,34,190,29,219,472,46.4%,33.05%,1
雲林縣,臺西鄉,0045,416,101,517,27,544,1409,38.61%,29.52%,1
雲林縣,臺西鄉,0046,375,96,471,90,561,1061,52.87%,35.34%,1
雲林縣,臺西鄉,0047,281,78,359,38,397,993,39.98%,28.3%,1
雲林縣,臺西鄉,0048,308,105,413,79,492,1013,48.57%,30.4%,1
雲林縣,臺西鄉,0049,418,116,534,48,582,1233,47.2%,33.9%,1
雲林縣,臺西鄉,0050,198,42,240,24,264,616,42.86%,32.14%,1
雲林縣,元長鄉,0180,319,84,403,37,440,915,48.09%,34.86%,1
雲林縣,元長鄉,0181,409,122,531,34,565,1284,44%,31.85%,1
雲林縣,元長鄉,0182,366,97,463,45,508,1150,44.17%,31.83%,1
雲林縣,元長鄉,0183,211,63,274,47,321,744,43.15%,28.36%,1
雲林縣,元長鄉,0184,268,69,337,54,391,790,49.49%,33.92%,1
雲林縣,元長鄉,0185,358,121,479,76,555,1356,40.93%,26.4%,1
雲林縣,元長鄉,0186,214,77,291,65,356,739,48.17%,28.96%,1
雲林縣,元長鄉,0187,228,103,331,33,364,965,37.72%,23.63%,1
雲林縣,元長鄉,0188,299,95,394,70,464,1080,42.96%,27.69%,1
雲林縣,元長鄉,0189,272,66,338,44,382,948,40.3%,28.69%,1
雲林縣,元長鄉,0190,154,57,211,32,243,762,31.89%,20.21%,1
雲林縣,元長鄉,0191,198,46,244,25,269,582,46.22%,34.02%,1
雲林縣,元長鄉,0192,230,61,291,14,305,865,35.26%,26.59%,1
雲林縣,元長鄉,0193,61,10,71,6,77,362,21.27%,16.85%,1
雲林縣,元長鄉,0194,301,90,391,34,425,1162,36.57%,25.9%,1
雲林縣,元長鄉,0195,437,130,567,45,612,1527,40.08%,28.62%,1
雲林縣,元長鄉,0196,316,105,421,66,487,1006,48.41%,31.41%,1
雲林縣,元長鄉,0197,261,64,325,24,349,855,40.82%,30.53%,1
雲林縣,元長鄉,0198,382,101,483,74,557,1181,47.16%,32.35%,1
雲林縣,元長鄉,0199,253,64,317,39,356,864,41.2%,29.28%,1
雲林縣,元長鄉,0200,169,59,228,36,264,667,39.58%,25.34%,1
雲林縣,元長鄉,0201,238,75,313,29,342,878,38.95%,27.11%,1
雲林縣,元長鄉,0202,137,24,161,11,172,610,28.2%,22.46%,1
雲林縣,元長鄉,0203,253,81,334,64,398,837,47.55%,30.23%,1
雲林縣,元長鄉,0204,249,64,313,39,352,701,50.21%,35.52%,1
雲林縣,四湖鄉,0155,323,89,412,66,478,1082,44.18%,29.85%,1
雲林縣,四湖鄉,0156,247,68,315,48,363,676,53.7%,36.54%,1
雲林縣,四湖鄉,0157,319,67,386,19,405,862,46.98%,37.01%,1
雲林縣,四湖鄉,0158,113,27,140,20,160,477,33.54%,23.69%,1
雲林縣,四湖鄉,0159,374,98,472,30,502,952,52.73%,39.29%,1
雲林縣,四湖鄉,0160,168,53,221,13,234,650,36%,25.85%,1
雲林縣,四湖鄉,0161,300,87,387,16,403,969,41.59%,30.96%,1
雲林縣,四湖鄉,0162,248,91,339,33,372,925,40.22%,26.81%,1
雲林縣,四湖鄉,0163,301,60,361,18,379,914,41.47%,32.93%,1
雲林縣,四湖鄉,0164,151,41,192,49,241,759,31.75%,19.89%,1
雲林縣,四湖鄉,0165,313,86,399,47,446,1219,36.59%,25.68%,1
雲林縣,四湖鄉,0166,224,48,272,47,319,937,34.04%,23.91%,1
雲林縣,四湖鄉,0167,165,37,202,15,217,773,28.07%,21.35%,1
雲林縣,四湖鄉,0168,141,41,182,43,225,555,40.54%,25.41%,1
雲林縣,四湖鄉,0169,205,64,269,28,297,876,33.9%,23.4%,1
雲林縣,四湖鄉,0170,102,16,118,21,139,360,38.61%,28.33%,1
雲林縣,四湖鄉,0171,171,41,212,51,263,885,29.72%,19.32%,1
雲林縣,四湖鄉,0172,198,50,248,38,286,833,34.33%,23.77%,1
雲林縣,四湖鄉,0173,161,121,282,39,321,785,40.89%,20.51%,1
雲林縣,四湖鄉,0174,227,65,292,44,336,705,47.66%,32.2%,1
雲林縣,四湖鄉,0175,204,52,256,26,282,927,30.42%,22.01%,1
雲林縣,四湖鄉,0176,246,61,307,69,376,1058,35.54%,23.25%,1
雲林縣,四湖鄉,0177,268,79,347,58,405,1071,37.82%,25.02%,1
雲林縣,四湖鄉,0178,201,52,253,14,267,1022,26.13%,19.67%,1
雲林縣,四湖鄉,0179,182,58,240,37,277,711,38.96%,25.6%,1
雲林縣,口湖鄉,0205,388,124,512,63,575,1134,50.71%,34.22%,1
雲林縣,口湖鄉,0206,458,111,569,97,666,1225,54.37%,37.39%,1
雲林縣,口湖鄉,0207,182,51,233,38,271,647,41.89%,28.13%,1
雲林縣,口湖鄉,0208,247,65,312,27,339,709,47.81%,34.84%,1
雲林縣,口湖鄉,0209,280,76,356,70,426,900,47.33%,31.11%,1
雲林縣,口湖鄉,0210,330,100,430,63,493,1011,48.76%,32.64%,1
雲林縣,口湖鄉,0211,401,95,496,24,520,1437,36.19%,27.91%,1
雲林縣,口湖鄉,0212,187,49,236,9,245,848,28.89%,22.05%,1
雲林縣,口湖鄉,0213,322,93,415,33,448,1193,37.55%,26.99%,1
雲林縣,口湖鄉,0214,181,45,226,62,288,759,37.94%,23.85%,1
雲林縣,口湖鄉,0215,249,68,317,50,367,815,45.03%,30.55%,1
雲林縣,口湖鄉,0216,484,131,615,90,705,1460,48.29%,33.15%,1
雲林縣,口湖鄉,0217,123,31,154,11,165,556,29.68%,22.12%,1
雲林縣,口湖鄉,0218,524,110,634,63,697,1532,45.5%,34.2%,1
雲林縣,口湖鄉,0219,253,88,341,18,359,847,42.38%,29.87%,1
雲林縣,口湖鄉,0220,134,24,158,24,182,374,48.66%,35.83%,1
雲林縣,口湖鄉,0221,488,166,654,176,830,1508,55.04%,32.36%,1
雲林縣,口湖鄉,0222,373,79,452,70,522,951,54.89%,39.22%,1
雲林縣,口湖鄉,0223,323,122,445,80,525,910,57.69%,35.49%,1
雲林縣,口湖鄉,0224,367,88,455,52,507,879,57.68%,41.75%,1
雲林縣,口湖鄉,0225,360,97,457,129,586,1213,48.31%,29.68%,1
雲林縣,口湖鄉,0226,326,77,403,54,457,952,48%,34.24%,1
雲林縣,口湖鄉,0227,251,76,327,61,388,720,53.89%,34.86%,1
雲林縣,口湖鄉,0228,256,78,334,32,366,1006,36.38%,25.45%,1
雲林縣,口湖鄉,0229,161,36,197,9,206,607,33.94%,26.52%,1
雲林縣,水林鄉,0230,427,115,542,60,602,1355,44.43%,31.51%,1
雲林縣,水林鄉,0231,304,84,388,16,404,887,45.55%,34.27%,1
雲林縣,水林鄉,0232,486,113,599,59,658,1234,53.32%,39.38%,1
雲林縣,水林鄉,0233,266,58,324,22,346,763,45.35%,34.86%,1
雲林縣,水林鄉,0234,193,70,263,44,307,721,42.58%,26.77%,1
雲林縣,水林鄉,0235,175,40,215,10,225,647,34.78%,27.05%,1
雲林縣,水林鄉,0236,283,91,374,59,433,989,43.78%,28.61%,1
雲林縣,水林鄉,0237,217,61,278,25,303,837,36.2%,25.93%,1
雲林縣,水林鄉,0238,286,66,352,17,369,1081,34.14%,26.46%,1
雲林縣,水林鄉,0239,212,60,272,44,316,704,44.89%,30.11%,1
雲林縣,水林鄉,0240,310,98,408,82,490,1006,48.71%,30.82%,1
雲林縣,水林鄉,0241,201,46,247,12,259,651,39.78%,30.88%,1
雲林縣,水林鄉,0242,166,42,208,27,235,607,38.71%,27.35%,1
雲林縣,水林鄉,0243,278,92,370,59,429,1033,41.53%,26.91%,1
雲林縣,水林鄉,0244,151,35,186,11,197,631,31.22%,23.93%,1
雲林縣,水林鄉,0245,282,79,361,54,415,961,43.18%,29.34%,1
雲林縣,水林鄉,0246,254,87,341,77,418,951,43.95%,26.71%,1
雲林縣,水林鄉,0247,261,73,334,25,359,838,42.84%,31.15%,1
雲林縣,水林鄉,0248,322,83,405,95,500,1055,47.39%,30.52%,1
雲林縣,水林鄉,0249,105,30,135,32,167,512,32.62%,20.51%,1
雲林縣,水林鄉,0250,174,36,210,19,229,671,34.13%,25.93%,1
雲林縣,水林鄉,0251,132,38,170,43,213,693,30.74%,19.05%,1
雲林縣,水林鄉,0252,144,48,192,47,239,689,34.69%,20.9%,1
雲林縣,水林鄉,0253,331,94,425,68,493,1022,48.24%,32.39%,1
雲林縣,水林鄉,0254,341,90,431,38,469,1191,39.38%,28.63%,1
雲林縣,水林鄉,0255,298,65,363,41,404,779,51.86%,38.25%,1
嘉義縣,太保市,0001,481,114,595,82,677,1210,55.95%,39.75%,1
嘉義縣,太保市,0002,433,109,542,35,577,1076,53.62%,40.24%,1
嘉義縣,太保市,0003,160,45,205,29,234,488,47.95%,32.79%,1
嘉義縣,太保市,0004,484,162,646,67,713,1475,48.34%,32.81%,1
嘉義縣,太保市,0005,263,60,323,32,355,790,44.94%,33.29%,1
嘉義縣,太保市,0006,321,75,396,44,440,883,49.83%,36.35%,1
嘉義縣,太保市,0007,280,51,331,51,382,758,50.4%,36.94%,1
嘉義縣,太保市,0008,112,32,144,7,151,389,38.82%,28.79%,1
嘉義縣,太保市,0009,340,113,453,55,508,1101,46.14%,30.88%,1
嘉義縣,太保市,0010,322,79,401,10,411,853,48.18%,37.75%,1
嘉義縣,太保市,0011,56,23,79,13,92,224,41.07%,25%,1
嘉義縣,太保市,0012,215,46,261,57,318,662,48.04%,32.48%,1
嘉義縣,太保市,0013,758,164,922,41,963,1630,59.08%,46.5%,1
嘉義縣,太保市,0014,312,81,393,27,420,913,46%,34.17%,1
嘉義縣,太保市,0015,343,75,418,15,433,779,55.58%,44.03%,1
嘉義縣,太保市,0016,459,143,602,102,704,1278,55.09%,35.92%,1
嘉義縣,太保市,0017,279,77,356,29,385,819,47.01%,34.07%,1
嘉義縣,太保市,0018,578,152,730,40,770,1573,48.95%,36.75%,1
嘉義縣,太保市,0019,193,37,230,29,259,481,53.85%,40.12%,1
嘉義縣,太保市,0020,111,23,134,6,140,245,57.14%,45.31%,1
嘉義縣,太保市,0021,127,26,153,16,169,317,53.31%,40.06%,1
嘉義縣,太保市,0022,93,17,110,7,117,258,45.35%,36.05%,1
嘉義縣,太保市,0023,229,49,278,55,333,611,54.5%,37.48%,1
嘉義縣,太保市,0024,571,213,784,44,828,1526,54.26%,37.42%,1
嘉義縣,太保市,0025,469,156,625,30,655,1196,54.77%,39.21%,1
嘉義縣,太保市,0026,582,181,763,84,847,1536,55.14%,37.89%,1
嘉義縣,太保市,0027,570,171,741,85,826,1481,55.77%,38.49%,1
嘉義縣,太保市,0028,583,146,729,62,791,1450,54.55%,40.21%,1
嘉義縣,太保市,0029,283,86,369,21,390,840,46.43%,33.69%,1
嘉義縣,太保市,0030,361,118,479,22,501,989,50.66%,36.5%,1
嘉義縣,太保市,0031,606,144,750,95,845,1529,55.26%,39.63%,1
嘉義縣,太保市,0032,587,180,767,78,845,1511,55.92%,38.85%,1
嘉義縣,太保市,0033,212,69,281,41,322,697,46.2%,30.42%,1
嘉義縣,朴子市,0233,477,116,593,49,642,1183,54.27%,40.32%,1
嘉義縣,朴子市,0234,270,104,374,45,419,755,55.5%,35.76%,1
嘉義縣,朴子市,0235,502,125,627,42,669,1253,53.39%,40.06%,1
嘉義縣,朴子市,0236,461,115,576,66,642,1078,59.55%,42.76%,1
嘉義縣,朴子市,0237,467,142,609,76,685,1117,61.32%,41.81%,1
嘉義縣,朴子市,0238,160,50,210,20,230,387,59.43%,41.34%,1
嘉義縣,朴子市,0239,302,14,316,43,359,633,56.71%,47.71%,1
嘉義縣,朴子市,0240,249,76,325,36,361,650,55.54%,38.31%,1
嘉義縣,朴子市,0241,371,96,467,50,517,825,62.67%,44.97%,1
嘉義縣,朴子市,0242,312,80,392,52,444,810,54.81%,38.52%,1
嘉義縣,朴子市,0243,393,92,485,62,547,940,58.19%,41.81%,1
嘉義縣,朴子市,0244,326,99,425,53,478,905,52.82%,36.02%,1
嘉義縣,朴子市,0245,537,167,704,58,762,1605,47.48%,33.46%,1
嘉義縣,朴子市,0246,632,152,784,61,845,1479,57.13%,42.73%,1
嘉義縣,朴子市,0247,486,149,635,64,699,1218,57.39%,39.9%,1
嘉義縣,朴子市,0248,610,179,789,67,856,1496,57.22%,40.78%,1
嘉義縣,朴子市,0249,240,78,318,34,352,667,52.77%,35.98%,1
嘉義縣,朴子市,0250,167,52,219,26,245,627,39.07%,26.63%,1
嘉義縣,朴子市,0251,267,82,349,46,395,791,49.94%,33.75%,1
嘉義縣,朴子市,0252,361,110,471,102,573,1034,55.42%,34.91%,1
嘉義縣,朴子市,0253,606,166,772,29,801,1710,46.84%,35.44%,1
嘉義縣,朴子市,0254,581,131,712,46,758,1671,45.36%,34.77%,1
嘉義縣,朴子市,0255,463,100,563,51,614,1547,39.69%,29.93%,1
嘉義縣,朴子市,0256,449,133,582,61,643,1602,40.14%,28.03%,1
嘉義縣,朴子市,0257,584,120,704,32,736,1302,56.53%,44.85%,1
嘉義縣,朴子市,0258,262,69,331,45,376,740,50.81%,35.41%,1
嘉義縣,朴子市,0259,447,106,553,66,619,1054,58.73%,42.41%,1
嘉義縣,朴子市,0260,261,74,335,15,350,907,38.59%,28.78%,1
嘉義縣,朴子市,0261,209,59,268,36,304,720,42.22%,29.03%,1
嘉義縣,朴子市,0262,93,30,123,24,147,251,58.57%,37.05%,1
嘉義縣,朴子市,0263,211,49,260,74,334,767,43.55%,27.51%,1
嘉義縣,朴子市,0264,236,105,341,48,389,702,55.41%,33.62%,1
嘉義縣,朴子市,0265,320,108,428,57,485,1038,46.72%,30.83%,1
嘉義縣,朴子市,0266,276,86,362,27,389,1228,31.68%,22.48%,1
嘉義縣,朴子市,0267,165,41,206,51,257,499,51.5%,33.07%,1
嘉義縣,布袋鎮,0325,216,43,259,34,293,614,47.72%,35.18%,1
嘉義縣,布袋鎮,0326,126,22,148,18,166,372,44.62%,33.87%,1
嘉義縣,布袋鎮,0327,339,68,407,98,505,914,55.25%,37.09%,1
嘉義縣,布袋鎮,0328,435,104,539,94,633,1198,52.84%,36.31%,1
嘉義縣,布袋鎮,0329,364,74,438,83,521,1113,46.81%,32.7%,1
嘉義縣,布袋鎮,0330,362,98,460,78,538,992,54.23%,36.49%,1
嘉義縣,布袋鎮,0331,248,61,309,16,325,689,47.17%,35.99%,1
嘉義縣,布袋鎮,0332,303,87,390,68,458,882,51.93%,34.35%,1
嘉義縣,布袋鎮,0333,269,72,341,38,379,731,51.85%,36.8%,1
嘉義縣,布袋鎮,0334,308,72,380,34,414,779,53.15%,39.54%,1
嘉義縣,布袋鎮,0335,243,55,298,42,340,762,44.62%,31.89%,1
嘉義縣,布袋鎮,0336,375,95,470,50,520,1184,43.92%,31.67%,1
嘉義縣,布袋鎮,0337,363,126,489,67,556,1423,39.07%,25.51%,1
嘉義縣,布袋鎮,0338,366,100,466,65,531,1351,39.3%,27.09%,1
嘉義縣,布袋鎮,0339,80,20,100,7,107,275,38.91%,29.09%,1
嘉義縣,布袋鎮,0340,67,28,95,14,109,243,44.86%,27.57%,1
嘉義縣,布袋鎮,0341,221,58,279,84,363,661,54.92%,33.43%,1
嘉義縣,布袋鎮,0342,386,106,492,50,542,1145,47.34%,33.71%,1
嘉義縣,布袋鎮,0343,285,98,383,31,414,936,44.23%,30.45%,1
嘉義縣,布袋鎮,0344,320,88,408,45,453,958,47.29%,33.4%,1
嘉義縣,布袋鎮,0345,95,24,119,15,134,298,44.97%,31.88%,1
嘉義縣,布袋鎮,0346,168,40,208,35,243,428,56.78%,39.25%,1
嘉義縣,布袋鎮,0347,39,7,46,4,50,121,41.32%,32.23%,1
嘉義縣,布袋鎮,0348,37,7,44,5,49,174,28.16%,21.26%,1
嘉義縣,布袋鎮,0349,316,82,398,53,451,953,47.32%,33.16%,1
嘉義縣,布袋鎮,0350,479,136,615,77,692,1292,53.56%,37.07%,1
嘉義縣,布袋鎮,0351,425,110,535,67,602,1127,53.42%,37.71%,1
嘉義縣,布袋鎮,0352,428,111,539,37,576,1244,46.3%,34.41%,1
嘉義縣,布袋鎮,0353,329,95,424,28,452,1106,40.87%,29.75%,1
嘉義縣,大林鎮,0169,169,61,230,34,264,483,54.66%,34.99%,1
嘉義縣,大林鎮,0170,744,199,943,68,1011,1823,55.46%,40.81%,1
嘉義縣,大林鎮,0171,369,116,485,23,508,955,53.19%,38.64%,1
嘉義縣,大林鎮,0172,517,150,667,46,713,1436,49.65%,36%,1
嘉義縣,大林鎮,0173,535,128,663,57,720,1390,51.8%,38.49%,1
嘉義縣,大林鎮,0174,603,163,766,79,845,1512,55.89%,39.88%,1
嘉義縣,大林鎮,0175,623,181,804,55,859,1536,55.92%,40.56%,1
嘉義縣,大林鎮,0176,412,95,507,37,544,1165,46.7%,35.36%,1
嘉義縣,大林鎮,0177,724,202,926,79,1005,1730,58.09%,41.85%,1
嘉義縣,大林鎮,0178,173,48,221,15,236,602,39.2%,28.74%,1
嘉義縣,大林鎮,0179,222,74,296,62,358,716,50%,31.01%,1
嘉義縣,大林鎮,0180,153,39,192,10,202,625,32.32%,24.48%,1
嘉義縣,大林鎮,0181,54,13,67,1,68,193,35.23%,27.98%,1
嘉義縣,大林鎮,0182,528,156,684,67,751,1642,45.74%,32.16%,1
嘉義縣,大林鎮,0183,530,157,687,69,756,1465,51.6%,36.18%,1
嘉義縣,大林鎮,0184,302,62,364,46,410,928,44.18%,32.54%,1
嘉義縣,大林鎮,0185,109,27,136,23,159,361,44.04%,30.19%,1
嘉義縣,大林鎮,0186,258,73,331,22,353,814,43.37%,31.7%,1
嘉義縣,大林鎮,0187,536,148,684,35,719,1579,45.54%,33.95%,1
嘉義縣,大林鎮,0188,804,152,956,92,1048,2041,51.35%,39.39%,1
嘉義縣,大林鎮,0189,329,92,421,54,475,931,51.02%,35.34%,1
嘉義縣,大林鎮,0190,260,48,308,37,345,675,51.11%,38.52%,1
嘉義縣,大林鎮,0191,237,51,288,28,316,655,48.24%,36.18%,1
嘉義縣,大林鎮,0192,303,62,365,38,403,833,48.38%,36.37%,1
嘉義縣,大林鎮,0193,343,108,451,49,500,832,60.1%,41.23%,1
嘉義縣,民雄鄉,0093,527,146,673,57,730,1267,57.62%,41.59%,1
嘉義縣,民雄鄉,0094,381,109,490,34,524,1030,50.87%,36.99%,1
嘉義縣,民雄鄉,0095,664,187,851,88,939,1590,59.06%,41.76%,1
嘉義縣,民雄鄉,0096,628,150,778,37,815,1673,48.71%,37.54%,1
嘉義縣,民雄鄉,0097,683,211,894,80,974,1718,56.69%,39.76%,1
嘉義縣,民雄鄉,0098,447,117,564,50,614,1040,59.04%,42.98%,1
嘉義縣,民雄鄉,0099,420,107,527,65,592,1100,53.82%,38.18%,1
嘉義縣,民雄鄉,0100,532,188,720,79,799,1559,51.25%,34.12%,1
嘉義縣,民雄鄉,0101,648,198,846,92,938,1862,50.38%,34.8%,1
嘉義縣,民雄鄉,0102,575,167,742,67,809,1435,56.38%,40.07%,1
嘉義縣,民雄鄉,0103,564,199,763,144,907,1751,51.8%,32.21%,1
嘉義縣,民雄鄉,0104,372,91,463,57,520,933,55.73%,39.87%,1
嘉義縣,民雄鄉,0105,334,124,458,58,516,827,62.39%,40.39%,1
嘉義縣,民雄鄉,0106,261,79,340,51,391,843,46.38%,30.96%,1
嘉義縣,民雄鄉,0107,660,206,866,71,937,1774,52.82%,37.2%,1
嘉義縣,民雄鄉,0108,122,41,163,19,182,385,47.27%,31.69%,1
嘉義縣,民雄鄉,0109,548,158,706,40,746,1306,57.12%,41.96%,1
嘉義縣,民雄鄉,0110,208,70,278,42,320,535,59.81%,38.88%,1
嘉義縣,民雄鄉,0111,416,117,533,80,613,1055,58.1%,39.43%,1
嘉義縣,民雄鄉,0112,567,161,728,66,794,1476,53.79%,38.41%,1
嘉義縣,民雄鄉,0113,580,150,730,64,794,1583,50.16%,36.64%,1
嘉義縣,民雄鄉,0114,237,74,311,32,343,758,45.25%,31.27%,1
嘉義縣,民雄鄉,0115,489,127,616,58,674,1354,49.78%,36.12%,1
嘉義縣,民雄鄉,0116,479,139,618,66,684,1202,56.91%,39.85%,1
嘉義縣,民雄鄉,0117,457,144,601,45,646,1175,54.98%,38.89%,1
嘉義縣,民雄鄉,0118,519,149,668,57,725,1423,50.95%,36.47%,1
嘉義縣,民雄鄉,0119,654,145,799,46,845,1612,52.42%,40.57%,1
嘉義縣,民雄鄉,0120,673,208,881,40,921,1695,54.34%,39.71%,1
嘉義縣,民雄鄉,0121,573,142,715,43,758,1665,45.53%,34.41%,1
嘉義縣,民雄鄉,0122,361,72,433,57,490,1019,48.09%,35.43%,1
嘉義縣,民雄鄉,0123,507,136,643,63,706,1352,52.22%,37.5%,1
嘉義縣,民雄鄉,0124,625,194,819,70,889,1620,54.88%,38.58%,1
嘉義縣,民雄鄉,0125,333,107,440,33,473,943,50.16%,35.31%,1
嘉義縣,民雄鄉,0126,544,194,738,55,793,1720,46.1%,31.63%,1
嘉義縣,民雄鄉,0127,630,224,854,100,954,1875,50.88%,33.6%,1
嘉義縣,民雄鄉,0128,524,148,672,56,728,1305,55.79%,40.15%,1
嘉義縣,民雄鄉,0129,507,163,670,68,738,1441,51.21%,35.18%,1
嘉義縣,民雄鄉,0130,522,159,681,71,752,1413,53.22%,36.94%,1
嘉義縣,民雄鄉,0131,579,166,745,79,824,1560,52.82%,37.12%,1
嘉義縣,民雄鄉,0132,777,222,999,115,1114,2004,55.59%,38.77%,1
嘉義縣,民雄鄉,0133,586,143,729,67,796,1354,58.79%,43.28%,1
嘉義縣,民雄鄉,0134,442,116,558,40,598,1076,55.58%,41.08%,1
嘉義縣,民雄鄉,0135,593,188,781,131,912,1629,55.99%,36.4%,1
嘉義縣,民雄鄉,0136,720,193,913,81,994,1977,50.28%,36.42%,1
嘉義縣,民雄鄉,0137,427,171,598,90,688,1295,53.13%,32.97%,1
嘉義縣,溪口鄉,0194,513,140,653,95,748,1318,56.75%,38.92%,1
嘉義縣,溪口鄉,0195,270,69,339,52,391,677,57.75%,39.88%,1
嘉義縣,溪口鄉,0196,142,41,183,16,199,417,47.72%,34.05%,1
嘉義縣,溪口鄉,0197,104,27,131,16,147,273,53.85%,38.1%,1
嘉義縣,溪口鄉,0198,346,124,470,58,528,908,58.15%,38.11%,1
嘉義縣,溪口鄉,0199,117,33,150,11,161,386,41.71%,30.31%,1
嘉義縣,溪口鄉,0200,388,123,511,68,579,1039,55.73%,37.34%,1
嘉義縣,溪口鄉,0201,220,53,273,55,328,708,46.33%,31.07%,1
嘉義縣,溪口鄉,0202,281,91,372,19,391,909,43.01%,30.91%,1
嘉義縣,溪口鄉,0203,301,85,386,43,429,786,54.58%,38.3%,1
嘉義縣,溪口鄉,0204,251,84,335,47,382,807,47.34%,31.1%,1
嘉義縣,溪口鄉,0205,336,79,415,17,432,1168,36.99%,28.77%,1
嘉義縣,溪口鄉,0206,364,134,498,87,585,1052,55.61%,34.6%,1
嘉義縣,溪口鄉,0207,174,62,236,49,285,565,50.44%,30.8%,1
嘉義縣,溪口鄉,0208,151,30,181,24,205,388,52.84%,38.92%,1
嘉義縣,溪口鄉,0209,214,43,257,24,281,701,40.09%,30.53%,1
嘉義縣,溪口鄉,0210,274,86,360,35,395,1003,39.38%,27.32%,1
嘉義縣,新港鄉,0138,420,104,524,33,557,1087,51.24%,38.64%,1
嘉義縣,新港鄉,0139,531,131,662,73,735,1116,65.86%,47.58%,1
嘉義縣,新港鄉,0140,284,76,360,48,408,740,55.14%,38.38%,1
嘉義縣,新港鄉,0141,277,87,364,72,436,827,52.72%,33.49%,1
嘉義縣,新港鄉,0142,290,93,383,48,431,704,61.22%,41.19%,1
嘉義縣,新港鄉,0143,319,105,424,49,473,768,61.59%,41.54%,1
嘉義縣,新港鄉,0144,312,98,410,45,455,761,59.79%,41%,1
嘉義縣,新港鄉,0145,288,77,365,67,432,850,50.82%,33.88%,1
嘉義縣,新港鄉,0146,464,152,616,77,693,1327,52.22%,34.97%,1
嘉義縣,新港鄉,0147,286,65,351,65,416,756,55.03%,37.83%,1
嘉義縣,新港鄉,0148,312,64,376,85,461,816,56.5%,38.24%,1
嘉義縣,新港鄉,0149,198,72,270,32,302,667,45.28%,29.69%,1
嘉義縣,新港鄉,0150,327,106,433,47,480,942,50.96%,34.71%,1
嘉義縣,新港鄉,0151,289,85,374,64,438,918,47.71%,31.48%,1
嘉義縣,新港鄉,0152,163,47,210,13,223,554,40.25%,29.42%,1
嘉義縣,新港鄉,0153,300,92,392,45,437,929,47.04%,32.29%,1
嘉義縣,新港鄉,0154,137,34,171,34,205,487,42.09%,28.13%,1
嘉義縣,新港鄉,0155,179,52,231,39,270,487,55.44%,36.76%,1
嘉義縣,新港鄉,0156,237,107,344,51,395,836,47.25%,28.35%,1
嘉義縣,新港鄉,0157,288,112,400,65,465,845,55.03%,34.08%,1
嘉義縣,新港鄉,0158,322,85,407,45,452,834,54.2%,38.61%,1
嘉義縣,新港鄉,0159,288,79,367,58,425,753,56.44%,38.25%,1
嘉義縣,新港鄉,0160,475,157,632,66,698,1328,52.56%,35.77%,1
嘉義縣,新港鄉,0161,385,108,493,58,551,969,56.86%,39.73%,1
嘉義縣,新港鄉,0162,422,120,542,74,616,1043,59.06%,40.46%,1
嘉義縣,新港鄉,0163,606,166,772,67,839,1400,59.93%,43.29%,1
嘉義縣,新港鄉,0164,256,56,312,31,343,1017,33.73%,25.17%,1
嘉義縣,新港鄉,0165,344,114,458,49,507,1132,44.79%,30.39%,1
嘉義縣,新港鄉,0166,353,117,470,67,537,1037,51.78%,34.04%,1
嘉義縣,新港鄉,0167,214,70,284,49,333,563,59.15%,38.01%,1
嘉義縣,新港鄉,0168,305,83,388,20,408,849,48.06%,35.92%,1
嘉義縣,六腳鄉,0268,348,92,440,38,478,1165,41.03%,29.87%,1
嘉義縣,六腳鄉,0269,205,38,243,19,262,825,31.76%,24.85%,1
嘉義縣,六腳鄉,0270,268,58,326,34,360,850,42.35%,31.53%,1
嘉義縣,六腳鄉,0271,83,30,113,19,132,222,59.46%,37.39%,1
嘉義縣,六腳鄉,0272,401,124,525,60,585,1216,48.11%,32.98%,1
嘉義縣,六腳鄉,0273,309,75,384,51,435,1200,36.25%,25.75%,1
嘉義縣,六腳鄉,0274,269,79,348,61,409,877,46.64%,30.67%,1
嘉義縣,六腳鄉,0275,189,41,230,43,273,644,42.39%,29.35%,1
嘉義縣,六腳鄉,0276,147,41,188,17,205,594,34.51%,24.75%,1
嘉義縣,六腳鄉,0277,32,4,36,2,38,167,22.75%,19.16%,1
嘉義縣,六腳鄉,0278,43,24,67,1,68,204,33.33%,21.08%,1
嘉義縣,六腳鄉,0279,68,14,82,8,90,234,38.46%,29.06%,1
嘉義縣,六腳鄉,0280,93,21,114,7,121,361,33.52%,25.76%,1
嘉義縣,六腳鄉,0281,214,61,275,54,329,592,55.57%,36.15%,1
嘉義縣,六腳鄉,0282,200,72,272,38,310,619,50.08%,32.31%,1
嘉義縣,六腳鄉,0283,184,38,222,47,269,714,37.68%,25.77%,1
嘉義縣,六腳鄉,0284,351,77,428,57,485,1051,46.15%,33.4%,1
嘉義縣,六腳鄉,0285,323,97,420,62,482,934,51.61%,34.58%,1
嘉義縣,六腳鄉,0286,358,90,448,63,511,1044,48.95%,34.29%,1
嘉義縣,六腳鄉,0287,422,117,539,42,581,1476,39.36%,28.59%,1
嘉義縣,六腳鄉,0288,158,35,193,22,215,618,34.79%,25.57%,1
嘉義縣,六腳鄉,0289,91,21,112,50,162,478,33.89%,19.04%,1
嘉義縣,六腳鄉,0290,147,42,189,43,232,642,36.14%,22.9%,1
嘉義縣,六腳鄉,0291,194,55,249,12,261,883,29.56%,21.97%,1
嘉義縣,六腳鄉,0292,279,27,306,4,310,739,41.95%,37.75%,1
嘉義縣,六腳鄉,0293,144,46,190,25,215,554,38.81%,25.99%,1
嘉義縣,六腳鄉,0294,139,42,181,19,200,649,30.82%,21.42%,1
嘉義縣,六腳鄉,0295,168,31,199,32,231,689,33.53%,24.38%,1
嘉義縣,六腳鄉,0296,107,39,146,25,171,455,37.58%,23.52%,1
嘉義縣,六腳鄉,0297,24,9,33,4,37,125,29.6%,19.2%,1
嘉義縣,東石鄉,0298,545,148,693,105,798,1915,41.67%,28.46%,1
嘉義縣,東石鄉,0299,241,66,307,60,367,938,39.13%,25.69%,1
嘉義縣,東石鄉,0300,262,77,339,36,375,1366,27.45%,19.18%,1
嘉義縣,東石鄉,0301,428,130,558,8,566,1676,33.77%,25.54%,1
嘉義縣,東石鄉,0302,289,85,374,92,466,1151,40.49%,25.11%,1
嘉義縣,東石鄉,0303,189,53,242,79,321,716,44.83%,26.4%,1
嘉義縣,東石鄉,0304,94,21,115,9,124,387,32.04%,24.29%,1
嘉義縣,東石鄉,0305,178,36,214,12,226,864,26.16%,20.6%,1
嘉義縣,東石鄉,0306,195,56,251,15,266,910,29.23%,21.43%,1
嘉義縣,東石鄉,0307,177,48,225,15,240,760,31.58%,23.29%,1
嘉義縣,東石鄉,0308,52,22,74,11,85,166,51.2%,31.33%,1
嘉義縣,東石鄉,0309,51,12,63,14,77,212,36.32%,24.06%,1
嘉義縣,東石鄉,0310,227,54,281,41,322,993,32.43%,22.86%,1
嘉義縣,東石鄉,0311,76,19,95,14,109,306,35.62%,24.84%,1
嘉義縣,東石鄉,0312,242,69,311,100,411,1046,39.29%,23.14%,1
嘉義縣,東石鄉,0313,46,15,61,29,90,235,38.3%,19.57%,1
嘉義縣,東石鄉,0314,343,104,447,106,553,1226,45.11%,27.98%,1
嘉義縣,東石鄉,0315,233,66,299,62,361,843,42.82%,27.64%,1
嘉義縣,東石鄉,0316,198,49,247,31,278,693,40.12%,28.57%,1
嘉義縣,東石鄉,0317,285,64,349,63,412,839,49.11%,33.97%,1
嘉義縣,東石鄉,0318,112,19,131,14,145,363,39.94%,30.85%,1
嘉義縣,東石鄉,0319,81,18,99,9,108,321,33.64%,25.23%,1
嘉義縣,東石鄉,0320,377,119,496,99,595,1083,54.94%,34.81%,1
嘉義縣,東石鄉,0321,272,85,357,54,411,901,45.62%,30.19%,1
嘉義縣,東石鄉,0322,274,59,333,32,365,1216,30.02%,22.53%,1
嘉義縣,東石鄉,0323,148,56,204,45,249,418,59.57%,35.41%,1
嘉義縣,東石鄉,0324,120,26,146,9,155,371,41.78%,32.35%,1
嘉義縣,義竹鄉,0354,170,33,203,27,230,482,47.72%,35.27%,1
嘉義縣,義竹鄉,0355,93,21,114,17,131,223,58.74%,41.7%,1
嘉義縣,義竹鄉,0356,569,163,732,78,810,1529,52.98%,37.21%,1
嘉義縣,義竹鄉,0357,465,113,578,74,652,1175,55.49%,39.57%,1
嘉義縣,義竹鄉,0358,390,103,493,50,543,886,61.29%,44.02%,1
嘉義縣,義竹鄉,0359,228,69,297,38,335,743,45.09%,30.69%,1
嘉義縣,義竹鄉,0360,454,130,584,90,674,1236,54.53%,36.73%,1
嘉義縣,義竹鄉,0361,146,25,171,23,194,377,51.46%,38.73%,1
嘉義縣,義竹鄉,0362,110,22,132,20,152,338,44.97%,32.54%,1
嘉義縣,義竹鄉,0363,45,12,57,2,59,102,57.84%,44.12%,1
嘉義縣,義竹鄉,0364,244,57,301,26,327,763,42.86%,31.98%,1
嘉義縣,義竹鄉,0365,161,49,210,30,240,429,55.94%,37.53%,1
嘉義縣,義竹鄉,0366,150,38,188,18,206,427,48.24%,35.13%,1
嘉義縣,義竹鄉,0367,208,67,275,55,330,607,54.37%,34.27%,1
嘉義縣,義竹鄉,0368,504,113,617,43,660,1486,44.41%,33.92%,1
嘉義縣,義竹鄉,0369,316,98,414,60,474,835,56.77%,37.84%,1
嘉義縣,義竹鄉,0370,231,60,291,62,353,816,43.26%,28.31%,1
嘉義縣,義竹鄉,0371,242,80,322,59,381,833,45.74%,29.05%,1
嘉義縣,義竹鄉,0372,156,42,198,13,211,433,48.73%,36.03%,1
嘉義縣,義竹鄉,0373,188,40,228,8,236,558,42.29%,33.69%,1
嘉義縣,義竹鄉,0374,210,65,275,35,310,602,51.5%,34.88%,1
嘉義縣,義竹鄉,0375,41,9,50,1,51,140,36.43%,29.29%,1
嘉義縣,義竹鄉,0376,119,30,149,26,175,393,44.53%,30.28%,1
嘉義縣,義竹鄉,0377,217,41,258,25,283,585,48.38%,37.09%,1
嘉義縣,義竹鄉,0378,123,29,152,9,161,526,30.61%,23.38%,1
嘉義縣,義竹鄉,0379,38,17,55,12,67,123,54.47%,30.89%,1
嘉義縣,鹿草鄉,0034,141,51,192,48,240,522,45.98%,27.01%,1
嘉義縣,鹿草鄉,0035,200,55,255,44,299,563,53.11%,35.52%,1
嘉義縣,鹿草鄉,0036,424,133,557,81,638,1304,48.93%,32.52%,1
嘉義縣,鹿草鄉,0037,436,156,592,65,657,1312,50.08%,33.23%,1
嘉義縣,鹿草鄉,0038,101,26,127,1,128,320,40%,31.56%,1
嘉義縣,鹿草鄉,0039,88,18,106,4,110,418,26.32%,21.05%,1
嘉義縣,鹿草鄉,0040,305,71,376,61,437,1025,42.63%,29.76%,1
嘉義縣,鹿草鄉,0041,129,35,164,21,185,451,41.02%,28.6%,1
嘉義縣,鹿草鄉,0042,278,70,348,95,443,830,53.37%,33.49%,1
嘉義縣,鹿草鄉,0043,315,91,406,83,489,1050,46.57%,30%,1
嘉義縣,鹿草鄉,0044,283,60,343,57,400,972,41.15%,29.12%,1
嘉義縣,鹿草鄉,0045,296,76,372,68,440,962,45.74%,30.77%,1
嘉義縣,鹿草鄉,0046,256,65,321,55,376,678,55.46%,37.76%,1
嘉義縣,鹿草鄉,0047,86,21,107,28,135,262,51.53%,32.82%,1
嘉義縣,鹿草鄉,0048,270,69,339,50,389,906,42.94%,29.8%,1
嘉義縣,鹿草鄉,0049,78,16,94,11,105,306,34.31%,25.49%,1
嘉義縣,鹿草鄉,0050,364,102,466,68,534,1062,50.28%,34.27%,1
嘉義縣,鹿草鄉,0051,119,54,173,22,195,373,52.28%,31.9%,1
嘉義縣,鹿草鄉,0052,121,31,152,23,175,324,54.01%,37.35%,1
嘉義縣,鹿草鄉,0053,107,20,127,19,146,297,49.16%,36.03%,1
嘉義縣,水上鄉,0054,377,100,477,26,503,1024,49.12%,36.82%,1
嘉義縣,水上鄉,0055,429,129,558,54,612,1015,60.3%,42.27%,1
嘉義縣,水上鄉,0056,682,195,877,63,940,1932,48.65%,35.3%,1
嘉義縣,水上鄉,0057,490,140,630,49,679,1170,58.03%,41.88%,1
嘉義縣,水上鄉,0058,552,136,688,77,765,1305,58.62%,42.3%,1
嘉義縣,水上鄉,0059,426,131,557,59,616,1242,49.6%,34.3%,1
嘉義縣,水上鄉,0060,107,35,142,18,160,324,49.38%,33.02%,1
嘉義縣,水上鄉,0061,233,69,302,22,324,622,52.09%,37.46%,1
嘉義縣,水上鄉,0062,448,101,549,89,638,1216,52.47%,36.84%,1
嘉義縣,水上鄉,0063,420,105,525,33,558,1020,54.71%,41.18%,1
嘉義縣,水上鄉,0064,352,91,443,37,480,771,62.26%,45.65%,1
嘉義縣,水上鄉,0065,202,50,252,24,276,441,62.59%,45.8%,1
嘉義縣,水上鄉,0066,285,73,358,48,406,626,64.86%,45.53%,1
嘉義縣,水上鄉,0067,238,66,304,33,337,570,59.12%,41.75%,1
嘉義縣,水上鄉,0068,126,44,170,22,192,368,52.17%,34.24%,1
嘉義縣,水上鄉,0069,339,103,442,92,534,1037,51.49%,32.69%,1
嘉義縣,水上鄉,0070,391,116,507,68,575,1065,53.99%,36.71%,1
嘉義縣,水上鄉,0071,332,104,436,72,508,802,63.34%,41.4%,1
嘉義縣,水上鄉,0072,670,202,872,40,912,1948,46.82%,34.39%,1
嘉義縣,水上鄉,0073,359,101,460,61,521,1028,50.68%,34.92%,1
嘉義縣,水上鄉,0074,279,67,346,25,371,641,57.88%,43.53%,1
嘉義縣,水上鄉,0075,174,37,211,14,225,408,55.15%,42.65%,1
嘉義縣,水上鄉,0076,309,105,414,43,457,794,57.56%,38.92%,1
嘉義縣,水上鄉,0077,175,56,231,38,269,569,47.28%,30.76%,1
嘉義縣,水上鄉,0078,315,97,412,39,451,806,55.96%,39.08%,1
嘉義縣,水上鄉,0079,412,97,509,42,551,960,57.4%,42.92%,1
嘉義縣,水上鄉,0080,769,235,1004,108,1112,2035,54.64%,37.79%,1
嘉義縣,水上鄉,0081,694,225,919,91,1010,1987,50.83%,34.93%,1
嘉義縣,水上鄉,0082,462,118,580,21,601,1154,52.08%,40.03%,1
嘉義縣,水上鄉,0083,791,240,1031,77,1108,2208,50.18%,35.82%,1
嘉義縣,水上鄉,0084,668,206,874,62,936,2102,44.53%,31.78%,1
嘉義縣,水上鄉,0085,465,126,591,61,652,1309,49.81%,35.52%,1
嘉義縣,水上鄉,0086,622,205,827,80,907,1671,54.28%,37.22%,1
嘉義縣,水上鄉,0087,320,82,402,40,442,822,53.77%,38.93%,1
嘉義縣,水上鄉,0088,578,203,781,54,835,1772,47.12%,32.62%,1
嘉義縣,水上鄉,0089,673,229,902,87,989,1919,51.54%,35.07%,1
嘉義縣,水上鄉,0090,267,72,339,27,366,912,40.13%,29.28%,1
嘉義縣,水上鄉,0091,365,83,448,23,471,992,47.48%,36.79%,1
嘉義縣,水上鄉,0092,354,128,482,81,563,1270,44.33%,27.87%,1
嘉義縣,中埔鄉,0380,305,84,389,13,402,1046,38.43%,29.16%,1
嘉義縣,中埔鄉,0381,584,162,746,91,837,1788,46.81%,32.66%,1
嘉義縣,中埔鄉,0382,526,194,720,47,767,1730,44.34%,30.4%,1
嘉義縣,中埔鄉,0383,552,157,709,63,772,1581,48.83%,34.91%,1
嘉義縣,中埔鄉,0384,487,148,635,44,679,1594,42.6%,30.55%,1
嘉義縣,中埔鄉,0385,640,194,834,48,882,1801,48.97%,35.54%,1
嘉義縣,中埔鄉,0386,678,160,838,79,917,1862,49.25%,36.41%,1
嘉義縣,中埔鄉,0387,571,171,742,33,775,1803,42.98%,31.67%,1
嘉義縣,中埔鄉,0388,557,151,708,60,768,1481,51.86%,37.61%,1
嘉義縣,中埔鄉,0389,515,139,654,64,718,1366,52.56%,37.7%,1
嘉義縣,中埔鄉,0390,476,159,635,74,709,1599,44.34%,29.77%,1
嘉義縣,中埔鄉,0391,428,116,544,38,582,1196,48.66%,35.79%,1
嘉義縣,中埔鄉,0392,566,168,734,85,819,1809,45.27%,31.29%,1
嘉義縣,中埔鄉,0393,318,104,422,29,451,953,47.32%,33.37%,1
嘉義縣,中埔鄉,0394,464,138,602,66,668,1441,46.36%,32.2%,1
嘉義縣,中埔鄉,0395,627,170,797,68,865,1882,45.96%,33.32%,1
嘉義縣,中埔鄉,0396,379,99,478,25,503,1470,34.22%,25.78%,1
嘉義縣,中埔鄉,0397,552,118,670,80,750,1699,44.14%,32.49%,1
嘉義縣,中埔鄉,0398,134,24,158,15,173,422,41%,31.75%,1
嘉義縣,中埔鄉,0399,338,106,444,70,514,1030,49.9%,32.82%,1
嘉義縣,中埔鄉,0400,266,78,344,47,391,879,44.48%,30.26%,1
嘉義縣,中埔鄉,0401,247,59,306,12,318,828,38.41%,29.83%,1
嘉義縣,中埔鄉,0402,361,82,443,54,497,881,56.41%,40.98%,1
嘉義縣,中埔鄉,0403,95,36,131,17,148,296,50%,32.09%,1
嘉義縣,中埔鄉,0404,287,101,388,91,479,979,48.93%,29.32%,1
嘉義縣,中埔鄉,0405,377,111,488,35,523,1268,41.25%,29.73%,1
嘉義縣,中埔鄉,0406,137,40,177,11,188,670,28.06%,20.45%,1
嘉義縣,中埔鄉,0407,293,78,371,60,431,754,57.16%,38.86%,1
嘉義縣,中埔鄉,0408,257,60,317,39,356,648,54.94%,39.66%,1
嘉義縣,中埔鄉,0409,217,57,274,19,293,741,39.54%,29.28%,1
嘉義縣,中埔鄉,0410,181,28,209,4,213,518,41.12%,34.94%,1
嘉義縣,中埔鄉,0411,152,54,206,35,241,482,50%,31.54%,1
嘉義縣,中埔鄉,0412,112,23,135,8,143,348,41.09%,32.18%,1
嘉義縣,中埔鄉,0413,106,25,131,14,145,294,49.32%,36.05%,1
嘉義縣,竹崎鄉,0414,473,126,599,43,642,1312,48.93%,36.05%,1
嘉義縣,竹崎鄉,0415,487,109,596,25,621,1210,51.32%,40.25%,1
嘉義縣,竹崎鄉,0416,390,108,498,56,554,991,55.9%,39.35%,1
嘉義縣,竹崎鄉,0417,438,116,554,42,596,1207,49.38%,36.29%,1
嘉義縣,竹崎鄉,0418,203,84,287,15,302,752,40.16%,26.99%,1
嘉義縣,竹崎鄉,0419,323,103,426,57,483,833,57.98%,38.78%,1
嘉義縣,竹崎鄉,0420,459,149,608,80,688,1220,56.39%,37.62%,1
嘉義縣,竹崎鄉,0421,258,59,317,18,335,616,54.38%,41.88%,1
嘉義縣,竹崎鄉,0422,356,113,469,59,528,1031,51.21%,34.53%,1
嘉義縣,竹崎鄉,0423,423,114,537,129,666,1292,51.55%,32.74%,1
嘉義縣,竹崎鄉,0424,813,211,1024,69,1093,1995,54.79%,40.75%,1
嘉義縣,竹崎鄉,0425,672,180,852,25,877,1996,43.94%,33.67%,1
嘉義縣,竹崎鄉,0426,536,141,677,80,757,1449,52.24%,36.99%,1
嘉義縣,竹崎鄉,0427,536,123,659,33,692,1420,48.73%,37.75%,1
嘉義縣,竹崎鄉,0428,595,179,774,65,839,1590,52.77%,37.42%,1
嘉義縣,竹崎鄉,0429,274,78,352,39,391,771,50.71%,35.54%,1
嘉義縣,竹崎鄉,0430,307,120,427,55,482,1014,47.53%,30.28%,1
嘉義縣,竹崎鄉,0431,72,24,96,11,107,327,32.72%,22.02%,1
嘉義縣,竹崎鄉,0432,260,66,326,30,356,687,51.82%,37.85%,1
嘉義縣,竹崎鄉,0433,217,51,268,23,291,641,45.4%,33.85%,1
嘉義縣,竹崎鄉,0434,183,34,217,6,223,474,47.05%,38.61%,1
嘉義縣,竹崎鄉,0435,138,19,157,30,187,383,48.83%,36.03%,1
嘉義縣,竹崎鄉,0436,263,56,319,55,374,619,60.42%,42.49%,1
嘉義縣,竹崎鄉,0437,76,12,88,10,98,214,45.79%,35.51%,1
嘉義縣,竹崎鄉,0438,551,163,714,103,817,1568,52.1%,35.14%,1
嘉義縣,竹崎鄉,0439,204,50,254,37,291,658,44.22%,31%,1
嘉義縣,竹崎鄉,0440,171,52,223,31,254,434,58.53%,39.4%,1
嘉義縣,竹崎鄉,0441,350,83,433,57,490,917,53.44%,38.17%,1
嘉義縣,竹崎鄉,0442,318,109,427,43,470,981,47.91%,32.42%,1
嘉義縣,竹崎鄉,0443,233,59,292,20,312,789,39.54%,29.53%,1
嘉義縣,竹崎鄉,0444,23,2,25,3,28,108,25.93%,21.3%,1
嘉義縣,竹崎鄉,0445,42,5,47,2,49,235,20.85%,17.87%,1
嘉義縣,竹崎鄉,0446,100,31,131,5,136,331,41.09%,30.21%,1
嘉義縣,竹崎鄉,0447,188,70,258,15,273,450,60.67%,41.78%,1
嘉義縣,竹崎鄉,0448,140,26,166,7,173,462,37.45%,30.3%,1
嘉義縣,竹崎鄉,0449,75,14,89,15,104,251,41.43%,29.88%,1
嘉義縣,梅山鄉,0211,379,106,485,31,516,1041,49.57%,36.41%,1
嘉義縣,梅山鄉,0212,487,161,648,84,732,1245,58.8%,39.12%,1
嘉義縣,梅山鄉,0213,409,102,511,54,565,917,61.61%,44.6%,1
嘉義縣,梅山鄉,0214,450,128,578,52,630,1189,52.99%,37.85%,1
嘉義縣,梅山鄉,0215,571,146,717,69,786,1388,56.63%,41.14%,1
嘉義縣,梅山鄉,0216,709,172,881,69,950,1827,52%,38.81%,1
嘉義縣,梅山鄉,0217,238,66,304,39,343,545,62.94%,43.67%,1
嘉義縣,梅山鄉,0218,121,27,148,35,183,407,44.96%,29.73%,1
嘉義縣,梅山鄉,0219,227,86,313,26,339,636,53.3%,35.69%,1
嘉義縣,梅山鄉,0220,218,63,281,48,329,576,57.12%,37.85%,1
嘉義縣,梅山鄉,0221,647,175,822,89,911,1674,54.42%,38.65%,1
嘉義縣,梅山鄉,0222,279,69,348,11,359,858,41.84%,32.52%,1
嘉義縣,梅山鄉,0223,200,93,293,41,334,526,63.5%,38.02%,1
嘉義縣,梅山鄉,0224,116,33,149,31,180,372,48.39%,31.18%,1
嘉義縣,梅山鄉,0225,194,36,230,24,254,506,50.2%,38.34%,1
嘉義縣,梅山鄉,0226,229,41,270,34,304,433,70.21%,52.89%,1
嘉義縣,梅山鄉,0227,121,26,147,14,161,404,39.85%,29.95%,1
嘉義縣,梅山鄉,0228,97,27,124,21,145,293,49.49%,33.11%,1
嘉義縣,梅山鄉,0229,329,75,404,43,447,712,62.78%,46.21%,1
嘉義縣,梅山鄉,0230,258,82,340,33,373,602,61.96%,42.86%,1
嘉義縣,梅山鄉,0231,182,46,228,22,250,515,48.54%,35.34%,1
嘉義縣,梅山鄉,0232,127,25,152,12,164,417,39.33%,30.46%,1
嘉義縣,番路鄉,0450,499,136,635,71,706,1174,60.14%,42.5%,1
嘉義縣,番路鄉,0451,199,45,244,13,257,449,57.24%,44.32%,1
嘉義縣,番路鄉,0452,326,73,399,43,442,753,58.7%,43.29%,1
嘉義縣,番路鄉,0453,186,46,232,28,260,551,47.19%,33.76%,1
嘉義縣,番路鄉,0454,749,170,919,82,1001,1791,55.89%,41.82%,1
嘉義縣,番路鄉,0455,353,124,477,61,538,849,63.37%,41.58%,1
嘉義縣,番路鄉,0456,350,90,440,49,489,866,56.47%,40.42%,1
嘉義縣,番路鄉,0457,348,60,408,31,439,800,54.88%,43.5%,1
嘉義縣,番路鄉,0458,155,58,213,37,250,444,56.31%,34.91%,1
嘉義縣,番路鄉,0459,182,43,225,19,244,635,38.43%,28.66%,1
嘉義縣,番路鄉,0460,112,19,131,12,143,319,44.83%,35.11%,1
嘉義縣,番路鄉,0461,310,40,350,27,377,642,58.72%,48.29%,1
嘉義縣,番路鄉,0462,165,37,202,26,228,509,44.79%,32.42%,1
嘉義縣,番路鄉,0463,68,10,78,0,78,162,48.15%,41.98%,1
嘉義縣,番路鄉,0464,87,17,104,9,113,212,53.3%,41.04%,1
嘉義縣,大埔鄉,0465,568,147,715,87,802,1468,54.63%,38.69%,1
嘉義縣,大埔鄉,0466,92,4,96,15,111,320,34.69%,28.75%,1
嘉義縣,大埔鄉,0467,119,40,159,8,167,304,54.93%,39.14%,1
嘉義縣,大埔鄉,0468,74,15,89,4,93,184,50.54%,40.22%,1
嘉義縣,大埔鄉,0469,106,37,143,11,154,234,65.81%,45.3%,1
嘉義縣,大埔鄉,0470,186,41,227,9,236,495,47.68%,37.58%,1
嘉義縣,大埔鄉,0471,81,19,100,2,102,199,51.26%,40.7%,1
嘉義縣,大埔鄉,0472,71,20,91,10,101,226,44.69%,31.42%,1
嘉義縣,大埔鄉,0473,258,69,327,21,348,569,61.16%,45.34%,1
嘉義縣,阿里山鄉,0474,130,29,159,8,167,371,45.01%,35.04%,1
嘉義縣,阿里山鄉,0475,65,10,75,9,84,197,42.64%,32.99%,1
嘉義縣,阿里山鄉,0476,61,5,66,3,69,152,45.39%,40.13%,1
嘉義縣,阿里山鄉,0477,59,10,69,5,74,231,32.03%,25.54%,1
嘉義縣,阿里山鄉,0478,16,4,20,1,21,72,29.17%,22.22%,1
嘉義縣,阿里山鄉,0479,98,12,110,3,113,311,36.33%,31.51%,1
嘉義縣,阿里山鄉,0480,128,22,150,14,164,306,53.59%,41.83%,1
嘉義縣,阿里山鄉,0481,342,62,404,7,411,970,42.37%,35.26%,1
嘉義縣,阿里山鄉,0482,23,70,93,361,454,827,54.9%,2.78%,1
嘉義縣,阿里山鄉,0483,92,20,112,2,114,238,47.9%,38.66%,1
嘉義縣,阿里山鄉,0484,87,23,110,7,117,479,24.43%,18.16%,1
嘉義縣,阿里山鄉,0485,77,12,89,5,94,291,32.3%,26.46%,1
嘉義縣,阿里山鄉,0486,117,18,135,22,157,246,63.82%,47.56%,1
屏東縣,屏東市,0001,82,36,118,10,128,237,54.01%,34.6%,1
屏東縣,屏東市,0002,100,39,139,26,165,294,56.12%,34.01%,1
屏東縣,屏東市,0003,206,77,283,12,295,582,50.69%,35.4%,1
屏東縣,屏東市,0004,281,91,372,25,397,713,55.68%,39.41%,1
屏東縣,屏東市,0005,213,69,282,33,315,572,55.07%,37.24%,1
屏東縣,屏東市,0006,210,57,267,13,280,455,61.54%,46.15%,1
屏東縣,屏東市,0007,123,19,142,1,143,249,57.43%,49.4%,1
屏東縣,屏東市,0008,392,115,507,31,538,1315,40.91%,29.81%,1
屏東縣,屏東市,0009,414,170,584,38,622,1373,45.3%,30.15%,1
屏東縣,屏東市,0010,312,86,398,40,438,713,61.43%,43.76%,1
屏東縣,屏東市,0011,248,69,317,48,365,573,63.7%,43.28%,1
屏東縣,屏東市,0012,128,48,176,23,199,297,67%,43.1%,1
屏東縣,屏東市,0013,202,56,258,23,281,409,68.7%,49.39%,1
屏東縣,屏東市,0014,98,44,142,18,160,286,55.94%,34.27%,1
屏東縣,屏東市,0015,150,55,205,19,224,421,53.21%,35.63%,1
屏東縣,屏東市,0016,232,78,310,13,323,569,56.77%,40.77%,1
屏東縣,屏東市,0017,155,76,231,18,249,459,54.25%,33.77%,1
屏東縣,屏東市,0018,294,100,394,19,413,672,61.46%,43.75%,1
屏東縣,屏東市,0019,276,103,379,44,423,668,63.32%,41.32%,1
屏東縣,屏東市,0020,170,51,221,14,235,411,57.18%,41.36%,1
屏東縣,屏東市,0021,295,110,405,34,439,768,57.16%,38.41%,1
屏東縣,屏東市,0022,335,72,407,29,436,786,55.47%,42.62%,1
屏東縣,屏東市,0023,382,102,484,36,520,890,58.43%,42.92%,1
屏東縣,屏東市,0024,578,141,719,41,760,1353,56.17%,42.72%,1
屏東縣,屏東市,0025,353,336,689,34,723,1386,52.16%,25.47%,1
屏東縣,屏東市,0026,581,140,721,37,758,1413,53.64%,41.12%,1
屏東縣,屏東市,0027,530,123,653,36,689,1272,54.17%,41.67%,1
屏東縣,屏東市,0028,539,123,662,29,691,1287,53.69%,41.88%,1
屏東縣,屏東市,0029,584,128,712,45,757,1311,57.74%,44.55%,1
屏東縣,屏東市,0030,503,164,667,24,691,1285,53.77%,39.14%,1
屏東縣,屏東市,0031,541,137,678,52,730,1297,56.28%,41.71%,1
屏東縣,屏東市,0032,555,126,681,33,714,1361,52.46%,40.78%,1
屏東縣,屏東市,0033,519,147,666,44,710,1381,51.41%,37.58%,1
屏東縣,屏東市,0034,527,158,685,51,736,1258,58.51%,41.89%,1
屏東縣,屏東市,0035,462,170,632,52,684,1259,54.33%,36.7%,1
屏東縣,屏東市,0036,432,108,540,41,581,1076,54%,40.15%,1
屏東縣,屏東市,0037,503,124,627,39,666,1162,57.31%,43.29%,1
屏東縣,屏東市,0038,556,152,708,35,743,1318,56.37%,42.19%,1
屏東縣,屏東市,0039,381,102,483,40,523,939,55.7%,40.58%,1
屏東縣,屏東市,0040,418,110,528,33,561,972,57.72%,43%,1
屏東縣,屏東市,0041,648,174,822,39,861,1535,56.09%,42.21%,1
屏東縣,屏東市,0042,515,132,647,41,688,1419,48.48%,36.29%,1
屏東縣,屏東市,0043,539,111,650,22,672,1398,48.07%,38.56%,1
屏東縣,屏東市,0044,541,144,685,57,742,1405,52.81%,38.51%,1
屏東縣,屏東市,0045,635,147,782,33,815,1486,54.85%,42.73%,1
屏東縣,屏東市,0046,409,127,536,56,592,1061,55.8%,38.55%,1
屏東縣,屏東市,0047,496,140,636,104,740,1540,48.05%,32.21%,1
屏東縣,屏東市,0048,380,113,493,18,511,1141,44.79%,33.3%,1
屏東縣,屏東市,0049,469,105,574,37,611,1247,49%,37.61%,1
屏東縣,屏東市,0050,562,130,692,40,732,1446,50.62%,38.87%,1
屏東縣,屏東市,0051,549,148,697,42,739,1303,56.72%,42.13%,1
屏東縣,屏東市,0052,522,119,641,44,685,1253,54.67%,41.66%,1
屏東縣,屏東市,0053,561,102,663,49,712,1315,54.14%,42.66%,1
屏東縣,屏東市,0054,512,174,686,41,727,1425,51.02%,35.93%,1
屏東縣,屏東市,0055,546,139,685,21,706,1423,49.61%,38.37%,1
屏東縣,屏東市,0056,577,145,722,53,775,1400,55.36%,41.21%,1
屏東縣,屏東市,0057,561,180,741,43,784,1359,57.69%,41.28%,1
屏東縣,屏東市,0058,576,103,679,36,715,1328,53.84%,43.37%,1
屏東縣,屏東市,0059,653,121,774,44,818,1539,53.15%,42.43%,1
屏東縣,屏東市,0060,108,24,132,3,135,391,34.53%,27.62%,1
屏東縣,屏東市,0061,75,29,104,12,116,200,58%,37.5%,1
屏東縣,屏東市,0062,114,27,141,25,166,328,50.61%,34.76%,1
屏東縣,屏東市,0063,103,15,118,3,121,231,52.38%,44.59%,1
屏東縣,屏東市,0064,366,84,450,49,499,945,52.8%,38.73%,1
屏東縣,屏東市,0065,381,115,496,54,550,1053,52.23%,36.18%,1
屏東縣,屏東市,0066,370,99,469,58,527,1043,50.53%,35.47%,1
屏東縣,屏東市,0067,388,101,489,69,558,1061,52.59%,36.57%,1
屏東縣,屏東市,0068,306,105,411,39,450,876,51.37%,34.93%,1
屏東縣,屏東市,0069,593,69,662,105,767,1468,52.25%,40.4%,1
屏東縣,屏東市,0070,510,139,649,67,716,1454,49.24%,35.08%,1
屏東縣,屏東市,0071,467,138,605,23,628,1205,52.12%,38.76%,1
屏東縣,屏東市,0072,460,133,593,35,628,1284,48.91%,35.83%,1
屏東縣,屏東市,0073,477,103,580,32,612,1219,50.21%,39.13%,1
屏東縣,屏東市,0074,617,172,789,78,867,1544,56.15%,39.96%,1
屏東縣,屏東市,0075,549,178,727,83,810,1485,54.55%,36.97%,1
屏東縣,屏東市,0076,554,151,705,64,769,1387,55.44%,39.94%,1
屏東縣,屏東市,0077,360,89,449,31,480,953,50.37%,37.78%,1
屏東縣,屏東市,0078,631,205,836,47,883,1603,55.08%,39.36%,1
屏東縣,屏東市,0079,193,57,250,34,284,535,53.08%,36.07%,1
屏東縣,屏東市,0080,431,105,536,39,575,1119,51.39%,38.52%,1
屏東縣,屏東市,0081,359,86,445,27,472,847,55.73%,42.38%,1
屏東縣,屏東市,0082,364,115,479,63,542,923,58.72%,39.44%,1
屏東縣,屏東市,0083,436,135,571,38,609,1227,49.63%,35.53%,1
屏東縣,屏東市,0084,386,125,511,54,565,1039,54.38%,37.15%,1
屏東縣,屏東市,0085,539,146,685,100,785,1485,52.86%,36.3%,1
屏東縣,屏東市,0086,328,85,413,57,470,867,54.21%,37.83%,1
屏東縣,屏東市,0087,378,111,489,31,520,918,56.64%,41.18%,1
屏東縣,屏東市,0088,233,70,303,40,343,663,51.73%,35.14%,1
屏東縣,屏東市,0089,412,111,523,19,542,1215,44.61%,33.91%,1
屏東縣,屏東市,0090,548,172,720,68,788,1628,48.4%,33.66%,1
屏東縣,屏東市,0091,522,108,630,45,675,1209,55.83%,43.18%,1
屏東縣,屏東市,0092,550,121,671,22,693,1110,62.43%,49.55%,1
屏東縣,屏東市,0093,218,85,303,19,322,684,47.08%,31.87%,1
屏東縣,屏東市,0094,431,105,536,30,566,1349,41.96%,31.95%,1
屏東縣,屏東市,0095,525,126,651,63,714,1457,49%,36.03%,1
屏東縣,屏東市,0096,581,170,751,47,798,1447,55.15%,40.15%,1
屏東縣,屏東市,0097,500,128,628,29,657,1354,48.52%,36.93%,1
屏東縣,屏東市,0098,630,190,820,63,883,1583,55.78%,39.8%,1
屏東縣,屏東市,0099,693,133,826,24,850,1707,49.79%,40.6%,1
屏東縣,屏東市,0100,639,116,755,27,782,1637,47.77%,39.03%,1
屏東縣,屏東市,0101,547,147,694,9,703,1459,48.18%,37.49%,1
屏東縣,屏東市,0102,750,147,897,47,944,1759,53.67%,42.64%,1
屏東縣,屏東市,0103,801,156,957,42,999,1950,51.23%,41.08%,1
屏東縣,屏東市,0104,713,151,864,50,914,1729,52.86%,41.24%,1
屏東縣,屏東市,0105,608,134,742,25,767,1592,48.18%,38.19%,1
屏東縣,屏東市,0106,558,122,680,41,721,1437,50.17%,38.83%,1
屏東縣,屏東市,0107,488,83,571,29,600,1204,49.83%,40.53%,1
屏東縣,屏東市,0108,580,120,700,35,735,1340,54.85%,43.28%,1
屏東縣,屏東市,0109,552,133,685,32,717,1322,54.24%,41.75%,1
屏東縣,屏東市,0110,559,113,672,39,711,1462,48.63%,38.24%,1
屏東縣,屏東市,0111,1269,246,1515,49,1564,3241,48.26%,39.15%,1
屏東縣,屏東市,0112,599,94,693,26,719,1477,48.68%,40.56%,1
屏東縣,屏東市,0113,301,61,362,26,388,821,47.26%,36.66%,1
屏東縣,屏東市,0114,355,77,432,17,449,1099,40.86%,32.3%,1
屏東縣,屏東市,0115,698,125,823,47,870,1688,51.54%,41.35%,1
屏東縣,屏東市,0116,442,93,535,46,581,1167,49.79%,37.87%,1
屏東縣,屏東市,0117,335,101,436,52,488,915,53.33%,36.61%,1
屏東縣,屏東市,0118,400,91,491,38,529,1683,31.43%,23.77%,1
屏東縣,屏東市,0119,594,123,717,16,733,1497,48.96%,39.68%,1
屏東縣,屏東市,0120,410,123,533,30,563,1129,49.87%,36.32%,1
屏東縣,屏東市,0121,523,101,624,41,665,1232,53.98%,42.45%,1
屏東縣,屏東市,0122,338,88,426,33,459,853,53.81%,39.62%,1
屏東縣,屏東市,0123,376,108,484,20,504,869,58%,43.27%,1
屏東縣,屏東市,0124,505,120,625,44,669,1169,57.23%,43.2%,1
屏東縣,屏東市,0125,457,98,555,30,585,1058,55.29%,43.19%,1
屏東縣,屏東市,0126,483,137,620,51,671,1344,49.93%,35.94%,1
屏東縣,屏東市,0127,516,150,666,24,690,1299,53.12%,39.72%,1
屏東縣,屏東市,0128,440,95,535,33,568,1204,47.18%,36.54%,1
屏東縣,屏東市,0129,435,108,543,40,583,1123,51.91%,38.74%,1
屏東縣,屏東市,0130,429,124,553,32,585,1318,44.39%,32.55%,1
屏東縣,屏東市,0131,374,86,460,54,514,865,59.42%,43.24%,1
屏東縣,屏東市,0132,359,85,444,27,471,1100,42.82%,32.64%,1
屏東縣,屏東市,0133,433,106,539,26,565,1215,46.5%,35.64%,1
屏東縣,屏東市,0134,542,143,685,42,727,1370,53.07%,39.56%,1
屏東縣,屏東市,0135,493,121,614,13,627,1240,50.56%,39.76%,1
屏東縣,屏東市,0136,486,131,617,49,666,1168,57.02%,41.61%,1
屏東縣,屏東市,0137,455,96,551,25,576,1079,53.38%,42.17%,1
屏東縣,屏東市,0138,561,123,684,53,737,1289,57.18%,43.52%,1
屏東縣,屏東市,0139,435,107,542,29,571,1115,51.21%,39.01%,1
屏東縣,屏東市,0140,592,200,792,50,842,1491,56.47%,39.7%,1
屏東縣,屏東市,0141,525,116,641,37,678,1411,48.05%,37.21%,1
屏東縣,屏東市,0142,679,182,861,37,898,1803,49.81%,37.66%,1
屏東縣,屏東市,0143,329,69,398,28,426,744,57.26%,44.22%,1
屏東縣,屏東市,0144,269,70,339,26,365,678,53.83%,39.68%,1
屏東縣,屏東市,0145,277,87,364,29,393,681,57.71%,40.68%,1
屏東縣,屏東市,0146,506,115,621,32,653,1535,42.54%,32.96%,1
屏東縣,屏東市,0147,381,104,485,59,544,954,57.02%,39.94%,1
屏東縣,屏東市,0148,441,127,568,43,611,1018,60.02%,43.32%,1
屏東縣,屏東市,0149,486,135,621,31,652,1154,56.5%,42.11%,1
屏東縣,潮州鎮,0150,198,70,268,37,305,504,60.52%,39.29%,1
屏東縣,潮州鎮,0151,600,150,750,50,800,1711,46.76%,35.07%,1
屏東縣,潮州鎮,0152,608,171,779,28,807,1634,49.39%,37.21%,1
屏東縣,潮州鎮,0153,503,112,615,28,643,1414,45.47%,35.57%,1
屏東縣,潮州鎮,0154,223,96,319,57,376,603,62.35%,36.98%,1
屏東縣,潮州鎮,0155,343,86,429,57,486,896,54.24%,38.28%,1
屏東縣,潮州鎮,0156,479,132,611,62,673,1285,52.37%,37.28%,1
屏東縣,潮州鎮,0157,672,144,816,65,881,1744,50.52%,38.53%,1
屏東縣,潮州鎮,0158,363,96,459,52,511,1071,47.71%,33.89%,1
屏東縣,潮州鎮,0159,516,128,644,63,707,1209,58.48%,42.68%,1
屏東縣,潮州鎮,0160,433,129,562,45,607,1159,52.37%,37.36%,1
屏東縣,潮州鎮,0161,496,118,614,60,674,1296,52.01%,38.27%,1
屏東縣,潮州鎮,0162,602,135,737,51,788,1466,53.75%,41.06%,1
屏東縣,潮州鎮,0163,440,143,583,63,646,1130,57.17%,38.94%,1
屏東縣,潮州鎮,0164,571,153,724,46,770,1439,53.51%,39.68%,1
屏東縣,潮州鎮,0165,386,85,471,51,522,897,58.19%,43.03%,1
屏東縣,潮州鎮,0166,518,119,637,48,685,1225,55.92%,42.29%,1
屏東縣,潮州鎮,0167,434,109,543,42,585,1158,50.52%,37.48%,1
屏東縣,潮州鎮,0168,136,47,183,34,217,481,45.11%,28.27%,1
屏東縣,潮州鎮,0169,383,107,490,57,547,972,56.28%,39.4%,1
屏東縣,潮州鎮,0170,517,163,680,47,727,1245,58.39%,41.53%,1
屏東縣,潮州鎮,0171,547,138,685,58,743,1415,52.51%,38.66%,1
屏東縣,潮州鎮,0172,413,108,521,13,534,1255,42.55%,32.91%,1
屏東縣,潮州鎮,0173,346,83,429,27,456,1058,43.1%,32.7%,1
屏東縣,潮州鎮,0174,444,129,573,37,610,1187,51.39%,37.41%,1
屏東縣,潮州鎮,0175,433,106,539,67,606,1083,55.96%,39.98%,1
屏東縣,潮州鎮,0176,559,148,707,39,746,1590,46.92%,35.16%,1
屏東縣,潮州鎮,0177,715,159,874,69,943,1543,61.11%,46.34%,1
屏東縣,潮州鎮,0178,595,161,756,51,807,1631,49.48%,36.48%,1
屏東縣,潮州鎮,0179,497,91,588,33,621,1159,53.58%,42.88%,1
屏東縣,潮州鎮,0180,462,122,584,34,618,1099,56.23%,42.04%,1
屏東縣,潮州鎮,0181,423,115,538,52,590,1200,49.17%,35.25%,1
屏東縣,潮州鎮,0182,519,120,639,65,704,1391,50.61%,37.31%,1
屏東縣,潮州鎮,0183,369,74,443,62,505,881,57.32%,41.88%,1
屏東縣,潮州鎮,0184,131,40,171,21,192,454,42.29%,28.85%,1
屏東縣,潮州鎮,0185,328,175,503,95,598,1658,36.07%,19.78%,1
屏東縣,潮州鎮,0186,274,70,344,37,381,822,46.35%,33.33%,1
屏東縣,潮州鎮,0187,283,91,374,14,388,948,40.93%,29.85%,1
屏東縣,潮州鎮,0188,352,97,449,29,478,1194,40.03%,29.48%,1
屏東縣,潮州鎮,0189,129,30,159,32,191,337,56.68%,38.28%,1
屏東縣,東港鎮,0190,410,114,524,63,587,981,59.84%,41.79%,1
屏東縣,東港鎮,0191,431,134,565,64,629,1070,58.79%,40.28%,1
屏東縣,東港鎮,0192,233,60,293,48,341,527,64.71%,44.21%,1
屏東縣,東港鎮,0193,149,48,197,40,237,395,60%,37.72%,1
屏東縣,東港鎮,0194,235,65,300,38,338,659,51.29%,35.66%,1
屏東縣,東港鎮,0195,202,44,246,31,277,513,54%,39.38%,1
屏東縣,東港鎮,0196,656,167,823,61,884,1732,51.04%,37.88%,1
屏東縣,東港鎮,0197,720,173,893,56,949,1779,53.34%,40.47%,1
屏東縣,東港鎮,0198,471,124,595,47,642,1270,50.55%,37.09%,1
屏東縣,東港鎮,0199,486,147,633,64,697,1327,52.52%,36.62%,1
屏東縣,東港鎮,0200,480,143,623,72,695,1242,55.96%,38.65%,1
屏東縣,東港鎮,0201,654,124,778,101,879,1607,54.7%,40.7%,1
屏東縣,東港鎮,0202,469,109,578,38,616,1305,47.2%,35.94%,1
屏東縣,東港鎮,0203,286,66,352,39,391,695,56.26%,41.15%,1
屏東縣,東港鎮,0204,437,125,562,98,660,1076,61.34%,40.61%,1
屏東縣,東港鎮,0205,190,60,250,39,289,567,50.97%,33.51%,1
屏東縣,東港鎮,0206,286,77,363,41,404,806,50.12%,35.48%,1
屏東縣,東港鎮,0207,464,142,606,77,683,1227,55.66%,37.82%,1
屏東縣,東港鎮,0208,197,65,262,59,321,599,53.59%,32.89%,1
屏東縣,東港鎮,0209,390,110,500,49,549,1354,40.55%,28.8%,1
屏東縣,東港鎮,0210,256,76,332,56,388,734,52.86%,34.88%,1
屏東縣,東港鎮,0211,405,111,516,119,635,1107,57.36%,36.59%,1
屏東縣,東港鎮,0212,406,97,503,87,590,1198,49.25%,33.89%,1
屏東縣,東港鎮,0213,544,146,690,131,821,1614,50.87%,33.71%,1
屏東縣,東港鎮,0214,289,81,370,50,420,826,50.85%,34.99%,1
屏東縣,東港鎮,0215,360,95,455,63,518,912,56.8%,39.47%,1
屏東縣,東港鎮,0216,130,46,176,48,224,432,51.85%,30.09%,1
屏東縣,東港鎮,0217,429,122,551,130,681,1204,56.56%,35.63%,1
屏東縣,東港鎮,0218,525,146,671,57,728,1304,55.83%,40.26%,1
屏東縣,東港鎮,0219,522,148,670,75,745,1317,56.57%,39.64%,1
屏東縣,東港鎮,0220,530,134,664,42,706,1387,50.9%,38.21%,1
屏東縣,東港鎮,0221,443,108,551,44,595,1310,45.42%,33.82%,1
屏東縣,東港鎮,0222,421,123,544,42,586,1228,47.72%,34.28%,1
屏東縣,東港鎮,0223,233,81,314,59,373,766,48.69%,30.42%,1
屏東縣,東港鎮,0224,305,102,407,66,473,823,57.47%,37.06%,1
屏東縣,東港鎮,0225,203,44,247,19,266,755,35.23%,26.89%,1
屏東縣,東港鎮,0226,425,134,559,60,619,1094,56.58%,38.85%,1
屏東縣,東港鎮,0227,277,64,341,28,369,753,49%,36.79%,1
屏東縣,恆春鎮,0228,324,90,414,26,440,902,48.78%,35.92%,1
屏東縣,恆春鎮,0229,411,97,508,45,553,969,57.07%,42.41%,1
屏東縣,恆春鎮,0230,476,101,577,48,625,1280,48.83%,37.19%,1
屏東縣,恆春鎮,0231,554,20,574,32,606,1133,53.49%,48.9%,1
屏東縣,恆春鎮,0232,504,98,602,13,615,1552,39.63%,32.47%,1
屏東縣,恆春鎮,0233,455,105,560,55,615,1485,41.41%,30.64%,1
屏東縣,恆春鎮,0234,348,100,448,33,481,896,53.68%,38.84%,1
屏東縣,恆春鎮,0235,169,51,220,25,245,531,46.14%,31.83%,1
屏東縣,恆春鎮,0236,160,41,201,8,209,478,43.72%,33.47%,1
屏東縣,恆春鎮,0237,348,106,454,35,489,1020,47.94%,34.12%,1
屏東縣,恆春鎮,0238,306,100,406,28,434,924,46.97%,33.12%,1
屏東縣,恆春鎮,0239,349,80,429,17,446,1079,41.33%,32.34%,1
屏東縣,恆春鎮,0240,209,45,254,22,276,775,35.61%,26.97%,1
屏東縣,恆春鎮,0241,314,69,383,50,433,813,53.26%,38.62%,1
屏東縣,恆春鎮,0242,386,88,474,45,519,1104,47.01%,34.96%,1
屏東縣,恆春鎮,0243,345,100,445,45,490,1110,44.14%,31.08%,1
屏東縣,恆春鎮,0244,183,53,236,61,297,692,42.92%,26.45%,1
屏東縣,恆春鎮,0245,190,39,229,10,239,708,33.76%,26.84%,1
屏東縣,恆春鎮,0246,530,134,664,36,700,1505,46.51%,35.22%,1
屏東縣,恆春鎮,0247,382,83,465,47,512,1111,46.08%,34.38%,1
屏東縣,恆春鎮,0248,551,121,672,36,708,1543,45.88%,35.71%,1
屏東縣,恆春鎮,0249,245,55,300,19,319,828,38.53%,29.59%,1
屏東縣,恆春鎮,0250,318,94,412,27,439,844,52.01%,37.68%,1
屏東縣,恆春鎮,0251,456,102,558,45,603,1253,48.12%,36.39%,1
屏東縣,恆春鎮,0252,396,83,479,34,513,1126,45.56%,35.17%,1
屏東縣,萬丹鄉,0253,443,128,571,60,631,1527,41.32%,29.01%,1
屏東縣,萬丹鄉,0254,385,113,498,65,563,1147,49.08%,33.57%,1
屏東縣,萬丹鄉,0255,289,109,398,47,445,949,46.89%,30.45%,1
屏東縣,萬丹鄉,0256,349,92,441,35,476,990,48.08%,35.25%,1
屏東縣,萬丹鄉,0257,317,86,403,14,417,1022,40.8%,31.02%,1
屏東縣,萬丹鄉,0258,248,61,309,58,367,545,67.34%,45.5%,1
屏東縣,萬丹鄉,0259,459,123,582,85,667,1159,57.55%,39.6%,1
屏東縣,萬丹鄉,0260,320,97,417,78,495,837,59.14%,38.23%,1
屏東縣,萬丹鄉,0261,141,43,184,14,198,392,50.51%,35.97%,1
屏東縣,萬丹鄉,0262,357,93,450,34,484,847,57.14%,42.15%,1
屏東縣,萬丹鄉,0263,442,84,526,54,580,1149,50.48%,38.47%,1
屏東縣,萬丹鄉,0264,433,120,553,53,606,1131,53.58%,38.28%,1
屏東縣,萬丹鄉,0265,441,119,560,48,608,1178,51.61%,37.44%,1
屏東縣,萬丹鄉,0266,294,92,386,39,425,711,59.77%,41.35%,1
屏東縣,萬丹鄉,0267,235,82,317,26,343,595,57.65%,39.5%,1
屏東縣,萬丹鄉,0268,597,148,745,56,801,1403,57.09%,42.55%,1
屏東縣,萬丹鄉,0269,416,89,505,28,533,1094,48.72%,38.03%,1
屏東縣,萬丹鄉,0270,470,126,596,35,631,1158,54.49%,40.59%,1
屏東縣,萬丹鄉,0271,403,142,545,54,599,963,62.2%,41.85%,1
屏東縣,萬丹鄉,0272,379,111,490,56,546,1062,51.41%,35.69%,1
屏東縣,萬丹鄉,0273,584,208,792,89,881,1684,52.32%,34.68%,1
屏東縣,萬丹鄉,0274,610,137,747,41,788,1702,46.3%,35.84%,1
屏東縣,萬丹鄉,0275,337,120,457,49,506,976,51.84%,34.53%,1
屏東縣,萬丹鄉,0276,365,126,491,65,556,1013,54.89%,36.03%,1
屏東縣,萬丹鄉,0277,231,116,347,35,382,847,45.1%,27.27%,1
屏東縣,萬丹鄉,0278,576,206,782,130,912,1570,58.09%,36.69%,1
屏東縣,萬丹鄉,0279,481,141,622,70,692,1411,49.04%,34.09%,1
屏東縣,萬丹鄉,0280,404,115,519,78,597,1046,57.07%,38.62%,1
屏東縣,萬丹鄉,0281,457,145,602,30,632,1385,45.63%,33%,1
屏東縣,萬丹鄉,0282,300,83,383,62,445,804,55.35%,37.31%,1
屏東縣,萬丹鄉,0283,462,150,612,83,695,1284,54.13%,35.98%,1
屏東縣,萬丹鄉,0284,513,137,650,50,700,1430,48.95%,35.87%,1
屏東縣,萬丹鄉,0285,415,119,534,64,598,960,62.29%,43.23%,1
屏東縣,萬丹鄉,0286,332,96,428,48,476,786,60.56%,42.24%,1
屏東縣,萬丹鄉,0287,421,150,571,79,650,1158,56.13%,36.36%,1
屏東縣,萬丹鄉,0288,507,133,640,67,707,1647,42.93%,30.78%,1
屏東縣,萬丹鄉,0289,542,152,694,80,774,1666,46.46%,32.53%,1
屏東縣,萬丹鄉,0290,430,119,549,73,622,1023,60.8%,42.03%,1
屏東縣,萬丹鄉,0291,507,144,651,65,716,1227,58.35%,41.32%,1
屏東縣,長治鄉,0292,390,115,505,63,568,1018,55.8%,38.31%,1
屏東縣,長治鄉,0293,635,160,795,84,879,1614,54.46%,39.34%,1
屏東縣,長治鄉,0294,787,164,951,101,1052,1848,56.93%,42.59%,1
屏東縣,長治鄉,0295,670,179,849,71,920,1707,53.9%,39.25%,1
屏東縣,長治鄉,0296,429,94,523,30,553,972,56.89%,44.14%,1
屏東縣,長治鄉,0297,388,125,513,53,566,989,57.23%,39.23%,1
屏東縣,長治鄉,0298,313,86,399,46,445,735,60.54%,42.59%,1
屏東縣,長治鄉,0299,629,197,826,68,894,1813,49.31%,34.69%,1
屏東縣,長治鄉,0300,470,127,597,52,649,1073,60.48%,43.8%,1
屏東縣,長治鄉,0301,605,200,805,100,905,1654,54.72%,36.58%,1
屏東縣,長治鄉,0302,460,147,607,72,679,1205,56.35%,38.17%,1
屏東縣,長治鄉,0303,302,85,387,44,431,758,56.86%,39.84%,1
屏東縣,長治鄉,0304,513,182,695,110,805,1492,53.95%,34.38%,1
屏東縣,長治鄉,0305,355,94,449,54,503,884,56.9%,40.16%,1
屏東縣,長治鄉,0306,451,114,565,55,620,1090,56.88%,41.38%,1
屏東縣,長治鄉,0307,446,137,583,101,684,1422,48.1%,31.36%,1
屏東縣,長治鄉,0308,304,101,405,56,461,845,54.56%,35.98%,1
屏東縣,長治鄉,0309,348,116,464,69,533,925,57.62%,37.62%,1
屏東縣,長治鄉,0310,423,95,518,96,614,1138,53.95%,37.17%,1
屏東縣,長治鄉,0311,432,153,585,108,693,1242,55.8%,34.78%,1
屏東縣,長治鄉,0312,324,101,425,21,446,1159,38.48%,27.96%,1
屏東縣,長治鄉,0313,295,72,367,35,402,673,59.73%,43.83%,1
屏東縣,麟洛鄉,0314,314,94,408,37,445,788,56.47%,39.85%,1
屏東縣,麟洛鄉,0315,602,158,760,24,784,1386,56.57%,43.43%,1
屏東縣,麟洛鄉,0316,433,103,536,43,579,957,60.5%,45.25%,1
屏東縣,麟洛鄉,0317,315,80,395,49,444,731,60.74%,43.09%,1
屏東縣,麟洛鄉,0318,349,97,446,58,504,806,62.53%,43.3%,1
屏東縣,麟洛鄉,0319,410,126,536,22,558,1207,46.23%,33.97%,1
屏東縣,麟洛鄉,0320,592,129,721,87,808,1340,60.3%,44.18%,1
屏東縣,麟洛鄉,0321,498,145,643,60,703,1221,57.58%,40.79%,1
屏東縣,麟洛鄉,0322,309,89,398,15,413,851,48.53%,36.31%,1
屏東縣,麟洛鄉,0323,255,56,311,13,324,683,47.44%,37.34%,1
屏東縣,九如鄉,0324,548,184,732,100,832,1491,55.8%,36.75%,1
屏東縣,九如鄉,0325,515,146,661,70,731,1375,53.16%,37.45%,1
屏東縣,九如鄉,0326,572,160,732,53,785,1678,46.78%,34.09%,1
屏東縣,九如鄉,0327,473,129,602,76,678,1166,58.15%,40.57%,1
屏東縣,九如鄉,0328,393,104,497,52,549,1276,43.03%,30.8%,1
屏東縣,九如鄉,0329,398,113,511,68,579,1033,56.05%,38.53%,1
屏東縣,九如鄉,0330,298,69,367,30,397,577,68.8%,51.65%,1
屏東縣,九如鄉,0331,262,74,336,62,398,649,61.33%,40.37%,1
屏東縣,九如鄉,0332,724,220,944,145,1089,1999,54.48%,36.22%,1
屏東縣,九如鄉,0333,657,177,834,86,920,1766,52.1%,37.2%,1
屏東縣,九如鄉,0334,652,65,717,108,825,1600,51.56%,40.75%,1
屏東縣,九如鄉,0335,450,133,583,97,680,1248,54.49%,36.06%,1
屏東縣,九如鄉,0336,595,255,850,188,1038,1792,57.92%,33.2%,1
屏東縣,九如鄉,0337,571,147,718,92,810,1482,54.66%,38.53%,1
屏東縣,里港鄉,0338,630,189,819,92,911,1552,58.7%,40.59%,1
屏東縣,里港鄉,0339,542,164,706,82,788,1480,53.24%,36.62%,1
屏東縣,里港鄉,0340,452,170,622,55,677,1534,44.13%,29.47%,1
屏東縣,里港鄉,0341,566,179,745,105,850,1578,53.87%,35.87%,1
屏東縣,里港鄉,0342,512,88,600,65,665,1127,59.01%,45.43%,1
屏東縣,里港鄉,0343,351,98,449,46,495,845,58.58%,41.54%,1
屏東縣,里港鄉,0344,461,143,604,65,669,1282,52.18%,35.96%,1
屏東縣,里港鄉,0345,391,118,509,57,566,981,57.7%,39.86%,1
屏東縣,里港鄉,0346,414,108,522,73,595,1031,57.71%,40.16%,1
屏東縣,里港鄉,0347,546,149,695,108,803,1423,56.43%,38.37%,1
屏東縣,里港鄉,0348,101,42,143,23,166,363,45.73%,27.82%,1
屏東縣,里港鄉,0349,441,143,584,113,697,1203,57.94%,36.66%,1
屏東縣,里港鄉,0350,449,114,563,73,636,1027,61.93%,43.72%,1
屏東縣,里港鄉,0351,430,158,588,59,647,1384,46.75%,31.07%,1
屏東縣,里港鄉,0352,524,160,684,80,764,1512,50.53%,34.66%,1
屏東縣,里港鄉,0353,240,45,285,23,308,522,59%,45.98%,1
屏東縣,里港鄉,0354,308,91,399,60,459,822,55.84%,37.47%,1
屏東縣,里港鄉,0355,337,102,439,88,527,1007,52.33%,33.47%,1
屏東縣,里港鄉,0356,335,130,465,72,537,956,56.17%,35.04%,1
屏東縣,里港鄉,0357,196,62,258,24,282,499,56.51%,39.28%,1
屏東縣,鹽埔鄉,0358,348,94,442,34,476,951,50.05%,36.59%,1
屏東縣,鹽埔鄉,0359,302,91,393,31,424,899,47.16%,33.59%,1
屏東縣,鹽埔鄉,0360,343,94,437,31,468,1116,41.94%,30.73%,1
屏東縣,鹽埔鄉,0361,448,118,566,54,620,1241,49.96%,36.1%,1
屏東縣,鹽埔鄉,0362,268,66,334,54,388,770,50.39%,34.81%,1
屏東縣,鹽埔鄉,0363,363,88,451,49,500,962,51.98%,37.73%,1
屏東縣,鹽埔鄉,0364,426,137,563,67,630,1041,60.52%,40.92%,1
屏東縣,鹽埔鄉,0365,493,142,635,72,707,1367,51.72%,36.06%,1
屏東縣,鹽埔鄉,0366,485,110,595,60,655,1465,44.71%,33.11%,1
屏東縣,鹽埔鄉,0367,286,79,365,54,419,894,46.87%,31.99%,1
屏東縣,鹽埔鄉,0368,326,65,391,6,397,958,41.44%,34.03%,1
屏東縣,鹽埔鄉,0369,327,77,404,86,490,924,53.03%,35.39%,1
屏東縣,鹽埔鄉,0370,511,133,644,40,684,1598,42.8%,31.98%,1
屏東縣,鹽埔鄉,0371,521,193,714,115,829,1550,53.48%,33.61%,1
屏東縣,鹽埔鄉,0372,416,99,515,85,600,1127,53.24%,36.91%,1
屏東縣,鹽埔鄉,0373,476,108,584,84,668,1150,58.09%,41.39%,1
屏東縣,鹽埔鄉,0374,470,131,601,71,672,1233,54.5%,38.12%,1
屏東縣,鹽埔鄉,0375,409,102,511,80,591,984,60.06%,41.57%,1
屏東縣,鹽埔鄉,0376,600,188,788,66,854,1619,52.75%,37.06%,1
屏東縣,鹽埔鄉,0377,218,53,271,34,305,553,55.15%,39.42%,1
屏東縣,高樹鄉,0378,337,129,466,79,545,883,61.72%,38.17%,1
屏東縣,高樹鄉,0379,316,114,430,25,455,1255,36.25%,25.18%,1
屏東縣,高樹鄉,0380,433,141,574,37,611,1278,47.81%,33.88%,1
屏東縣,高樹鄉,0381,220,70,290,24,314,738,42.55%,29.81%,1
屏東縣,高樹鄉,0382,165,69,234,14,248,585,42.39%,28.21%,1
屏東縣,高樹鄉,0383,348,107,455,136,591,1012,58.4%,34.39%,1
屏東縣,高樹鄉,0384,369,104,473,90,563,1148,49.04%,32.14%,1
屏東縣,高樹鄉,0385,186,70,256,34,290,591,49.07%,31.47%,1
屏東縣,高樹鄉,0386,229,73,302,49,351,786,44.66%,29.13%,1
屏東縣,高樹鄉,0387,183,60,243,19,262,649,40.37%,28.2%,1
屏東縣,高樹鄉,0388,331,95,426,74,500,1229,40.68%,26.93%,1
屏東縣,高樹鄉,0389,403,122,525,55,580,1446,40.11%,27.87%,1
屏東縣,高樹鄉,0390,248,78,326,18,344,899,38.26%,27.59%,1
屏東縣,高樹鄉,0391,318,104,422,49,471,922,51.08%,34.49%,1
屏東縣,高樹鄉,0392,391,121,512,88,600,1259,47.66%,31.06%,1
屏東縣,高樹鄉,0393,289,68,357,25,382,1056,36.17%,27.37%,1
屏東縣,高樹鄉,0394,414,123,537,68,605,1116,54.21%,37.1%,1
屏東縣,高樹鄉,0395,349,139,488,78,566,1020,55.49%,34.22%,1
屏東縣,高樹鄉,0396,380,108,488,84,572,1055,54.22%,36.02%,1
屏東縣,高樹鄉,0397,285,95,380,42,422,738,57.18%,38.62%,1
屏東縣,高樹鄉,0398,154,35,189,32,221,493,44.83%,31.24%,1
屏東縣,高樹鄉,0399,550,201,751,105,856,1539,55.62%,35.74%,1
屏東縣,萬巒鄉,0400,410,119,529,40,569,1239,45.92%,33.09%,1
屏東縣,萬巒鄉,0401,276,88,364,61,425,759,55.99%,36.36%,1
屏東縣,萬巒鄉,0402,372,93,465,88,553,932,59.33%,39.91%,1
屏東縣,萬巒鄉,0403,309,91,400,63,463,769,60.21%,40.18%,1
屏東縣,萬巒鄉,0404,331,98,429,76,505,920,54.89%,35.98%,1
屏東縣,萬巒鄉,0405,229,60,289,35,324,560,57.86%,40.89%,1
屏東縣,萬巒鄉,0406,381,96,477,21,498,1120,44.46%,34.02%,1
屏東縣,萬巒鄉,0407,337,112,449,31,480,1048,45.8%,32.16%,1
屏東縣,萬巒鄉,0408,354,219,573,40,613,1438,42.63%,24.62%,1
屏東縣,萬巒鄉,0409,253,99,352,63,415,834,49.76%,30.34%,1
屏東縣,萬巒鄉,0410,273,86,359,64,423,813,52.03%,33.58%,1
屏東縣,萬巒鄉,0411,317,71,388,43,431,1020,42.25%,31.08%,1
屏東縣,萬巒鄉,0412,379,124,503,72,575,1007,57.1%,37.64%,1
屏東縣,萬巒鄉,0413,481,147,628,101,729,1648,44.24%,29.19%,1
屏東縣,萬巒鄉,0414,485,166,651,65,716,1437,49.83%,33.75%,1
屏東縣,萬巒鄉,0415,355,118,473,22,495,1228,40.31%,28.91%,1
屏東縣,萬巒鄉,0416,253,55,308,51,359,597,60.13%,42.38%,1
屏東縣,萬巒鄉,0417,207,57,264,50,314,576,54.51%,35.94%,1
屏東縣,內埔鄉,0418,440,115,555,44,599,1305,45.9%,33.72%,1
屏東縣,內埔鄉,0419,422,103,525,44,569,1287,44.21%,32.79%,1
屏東縣,內埔鄉,0420,484,115,599,18,617,1387,44.48%,34.9%,1
屏東縣,內埔鄉,0421,507,150,657,53,710,1540,46.1%,32.92%,1
屏東縣,內埔鄉,0422,543,149,692,52,744,1605,46.36%,33.83%,1
屏東縣,內埔鄉,0423,472,118,590,59,649,1326,48.94%,35.6%,1
屏東縣,內埔鄉,0424,221,67,288,46,334,591,56.51%,37.39%,1
屏東縣,內埔鄉,0425,378,101,479,47,526,1123,46.84%,33.66%,1
屏東縣,內埔鄉,0426,401,89,490,19,509,1079,47.17%,37.16%,1
屏東縣,內埔鄉,0427,562,143,705,64,769,1485,51.78%,37.85%,1
屏東縣,內埔鄉,0428,534,119,653,44,697,1248,55.85%,42.79%,1
屏東縣,內埔鄉,0429,567,152,719,55,774,1569,49.33%,36.14%,1
屏東縣,內埔鄉,0430,512,143,655,59,714,1493,47.82%,34.29%,1
屏東縣,內埔鄉,0431,426,173,599,16,615,1420,43.31%,30%,1
屏東縣,內埔鄉,0432,479,131,610,85,695,1334,52.1%,35.91%,1
屏東縣,內埔鄉,0433,519,140,659,78,737,1519,48.52%,34.17%,1
屏東縣,內埔鄉,0434,298,76,374,49,423,784,53.95%,38.01%,1
屏東縣,內埔鄉,0435,350,86,436,65,501,888,56.42%,39.41%,1
屏東縣,內埔鄉,0436,193,51,244,12,256,747,34.27%,25.84%,1
屏東縣,內埔鄉,0437,328,101,429,26,455,1168,38.96%,28.08%,1
屏東縣,內埔鄉,0438,217,62,279,33,312,546,57.14%,39.74%,1
屏東縣,內埔鄉,0439,448,130,578,58,636,1278,49.77%,35.05%,1
屏東縣,內埔鄉,0440,410,122,532,47,579,1348,42.95%,30.42%,1
屏東縣,內埔鄉,0441,425,135,560,87,647,1550,41.74%,27.42%,1
屏東縣,內埔鄉,0442,376,121,497,76,573,947,60.51%,39.7%,1
屏東縣,內埔鄉,0443,372,110,482,82,564,1097,51.41%,33.91%,1
屏東縣,內埔鄉,0444,315,109,424,51,475,1128,42.11%,27.93%,1
屏東縣,內埔鄉,0445,298,82,380,24,404,1253,32.24%,23.78%,1
屏東縣,內埔鄉,0446,393,119,512,29,541,1525,35.48%,25.77%,1
屏東縣,內埔鄉,0447,445,102,547,89,636,1215,52.35%,36.63%,1
屏東縣,內埔鄉,0448,370,92,462,28,490,1216,40.3%,30.43%,1
屏東縣,內埔鄉,0449,450,100,550,36,586,1353,43.31%,33.26%,1
屏東縣,內埔鄉,0450,364,84,448,40,488,1026,47.56%,35.48%,1
屏東縣,內埔鄉,0451,285,64,349,29,378,862,43.85%,33.06%,1
屏東縣,內埔鄉,0452,234,83,317,32,349,921,37.89%,25.41%,1
屏東縣,內埔鄉,0453,312,67,379,24,403,854,47.19%,36.53%,1
屏東縣,內埔鄉,0454,385,95,480,37,517,1230,42.03%,31.3%,1
屏東縣,內埔鄉,0455,353,91,444,26,470,1204,39.04%,29.32%,1
屏東縣,內埔鄉,0456,393,95,488,45,533,1301,40.97%,30.21%,1
屏東縣,內埔鄉,0457,327,73,400,46,446,806,55.33%,40.57%,1
屏東縣,竹田鄉,0458,577,179,756,79,835,1503,55.56%,38.39%,1
屏東縣,竹田鄉,0459,383,124,507,44,551,899,61.29%,42.6%,1
屏東縣,竹田鄉,0460,332,78,410,40,450,716,62.85%,46.37%,1
屏東縣,竹田鄉,0461,257,85,342,40,382,581,65.75%,44.23%,1
屏東縣,竹田鄉,0462,487,154,641,102,743,1327,55.99%,36.7%,1
屏東縣,竹田鄉,0463,388,148,536,84,620,997,62.19%,38.92%,1
屏東縣,竹田鄉,0464,261,56,317,24,341,649,52.54%,40.22%,1
屏東縣,竹田鄉,0465,262,58,320,25,345,476,72.48%,55.04%,1
屏東縣,竹田鄉,0466,534,143,677,60,737,1259,58.54%,42.41%,1
屏東縣,竹田鄉,0467,455,120,575,66,641,1227,52.24%,37.08%,1
屏東縣,竹田鄉,0468,227,56,283,39,322,504,63.89%,45.04%,1
屏東縣,竹田鄉,0469,324,87,411,50,461,860,53.6%,37.67%,1
屏東縣,竹田鄉,0470,298,89,387,20,407,800,50.88%,37.25%,1
屏東縣,竹田鄉,0471,434,161,595,59,654,1134,57.67%,38.27%,1
屏東縣,竹田鄉,0472,458,138,596,66,662,1229,53.86%,37.27%,1
屏東縣,竹田鄉,0473,436,117,553,69,622,1192,52.18%,36.58%,1
屏東縣,新埤鄉,0474,564,166,730,44,774,1712,45.21%,32.94%,1
屏東縣,新埤鄉,0475,108,38,146,27,173,314,55.1%,34.39%,1
屏東縣,新埤鄉,0476,288,82,370,37,407,752,54.12%,38.3%,1
屏東縣,新埤鄉,0477,129,31,160,23,183,334,54.79%,38.62%,1
屏東縣,新埤鄉,0478,353,118,471,64,535,957,55.9%,36.89%,1
屏東縣,新埤鄉,0479,308,88,396,55,451,764,59.03%,40.31%,1
屏東縣,新埤鄉,0480,130,51,181,32,213,373,57.1%,34.85%,1
屏東縣,新埤鄉,0481,216,64,280,33,313,678,46.17%,31.86%,1
屏東縣,新埤鄉,0482,225,66,291,23,314,701,44.79%,32.1%,1
屏東縣,新埤鄉,0483,373,107,480,55,535,1323,40.44%,28.19%,1
屏東縣,新埤鄉,0484,219,51,270,39,309,541,57.12%,40.48%,1
屏東縣,新埤鄉,0485,183,47,230,33,263,584,45.03%,31.34%,1
屏東縣,枋寮鄉,0486,481,123,604,75,679,1213,55.98%,39.65%,1
屏東縣,枋寮鄉,0487,329,114,443,69,512,891,57.46%,36.92%,1
屏東縣,枋寮鄉,0488,308,92,400,96,496,970,51.13%,31.75%,1
屏東縣,枋寮鄉,0489,243,59,302,32,334,629,53.1%,38.63%,1
屏東縣,枋寮鄉,0490,340,94,434,35,469,840,55.83%,40.48%,1
屏東縣,枋寮鄉,0491,314,81,395,43,438,774,56.59%,40.57%,1
屏東縣,枋寮鄉,0492,471,158,629,82,711,1379,51.56%,34.16%,1
屏東縣,枋寮鄉,0493,602,137,739,68,807,1502,53.73%,40.08%,1
屏東縣,枋寮鄉,0494,432,142,574,80,654,1276,51.25%,33.86%,1
屏東縣,枋寮鄉,0495,347,101,448,67,515,964,53.42%,36%,1
屏東縣,枋寮鄉,0496,401,106,507,97,604,1005,60.1%,39.9%,1
屏東縣,枋寮鄉,0497,250,54,304,23,327,734,44.55%,34.06%,1
屏東縣,枋寮鄉,0498,270,76,346,62,408,725,56.28%,37.24%,1
屏東縣,枋寮鄉,0499,339,101,440,73,513,1046,49.04%,32.41%,1
屏東縣,枋寮鄉,0500,417,111,528,75,603,1067,56.51%,39.08%,1
屏東縣,枋寮鄉,0501,159,55,214,63,277,718,38.58%,22.14%,1
屏東縣,枋寮鄉,0502,304,73,377,49,426,903,47.18%,33.67%,1
屏東縣,枋寮鄉,0503,455,151,606,84,690,1387,49.75%,32.8%,1
屏東縣,枋寮鄉,0504,501,149,650,88,738,1367,53.99%,36.65%,1
屏東縣,枋寮鄉,0505,249,89,338,46,384,618,62.14%,40.29%,1
屏東縣,枋寮鄉,0506,287,62,349,35,384,959,40.04%,29.93%,1
屏東縣,枋寮鄉,0507,168,40,208,28,236,427,55.27%,39.34%,1
屏東縣,新園鄉,0508,332,94,426,46,472,820,57.56%,40.49%,1
屏東縣,新園鄉,0509,376,73,449,60,509,843,60.38%,44.6%,1
屏東縣,新園鄉,0510,479,108,587,56,643,1242,51.77%,38.57%,1
屏東縣,新園鄉,0511,555,127,682,58,740,1290,57.36%,43.02%,1
屏東縣,新園鄉,0512,401,111,512,53,565,1073,52.66%,37.37%,1
屏東縣,新園鄉,0513,420,142,562,97,659,1088,60.57%,38.6%,1
屏東縣,新園鄉,0514,294,82,376,44,420,845,49.7%,34.79%,1
屏東縣,新園鄉,0515,317,95,412,52,464,862,53.83%,36.77%,1
屏東縣,新園鄉,0516,389,126,515,73,588,1183,49.7%,32.88%,1
屏東縣,新園鄉,0517,388,129,517,94,611,1109,55.09%,34.99%,1
屏東縣,新園鄉,0518,366,102,468,14,482,1119,43.07%,32.71%,1
屏東縣,新園鄉,0519,395,133,528,37,565,1152,49.05%,34.29%,1
屏東縣,新園鄉,0520,396,115,511,58,569,1030,55.24%,38.45%,1
屏東縣,新園鄉,0521,391,109,500,88,588,1104,53.26%,35.42%,1
屏東縣,新園鄉,0522,389,115,504,0,504,1240,40.65%,31.37%,1
屏東縣,新園鄉,0523,299,96,395,26,421,1120,37.59%,26.7%,1
屏東縣,新園鄉,0524,425,126,551,73,624,1074,58.1%,39.57%,1
屏東縣,新園鄉,0525,275,76,351,46,397,849,46.76%,32.39%,1
屏東縣,新園鄉,0526,253,95,348,64,412,749,55.01%,33.78%,1
屏東縣,新園鄉,0527,481,152,633,83,716,1416,50.56%,33.97%,1
屏東縣,新園鄉,0528,317,95,412,71,483,895,53.97%,35.42%,1
屏東縣,新園鄉,0529,376,82,458,62,520,933,55.73%,40.3%,1
屏東縣,新園鄉,0530,354,102,456,52,508,972,52.26%,36.42%,1
屏東縣,新園鄉,0531,393,130,523,83,606,1454,41.68%,27.03%,1
屏東縣,新園鄉,0532,628,175,803,162,965,1653,58.38%,37.99%,1
屏東縣,新園鄉,0533,412,111,523,110,633,1270,49.84%,32.44%,1
屏東縣,新園鄉,0534,401,129,530,144,674,1123,60.02%,35.71%,1
屏東縣,新園鄉,0535,372,120,492,122,614,1198,51.25%,31.05%,1
屏東縣,崁頂鄉,0536,428,89,517,45,562,1190,47.23%,35.97%,1
屏東縣,崁頂鄉,0537,431,100,531,57,588,1044,56.32%,41.28%,1
屏東縣,崁頂鄉,0538,307,97,404,49,453,818,55.38%,37.53%,1
屏東縣,崁頂鄉,0539,432,138,570,53,623,1214,51.32%,35.58%,1
屏東縣,崁頂鄉,0540,443,120,563,31,594,1325,44.83%,33.43%,1
屏東縣,崁頂鄉,0541,512,120,632,67,699,1253,55.79%,40.86%,1
屏東縣,崁頂鄉,0542,388,90,478,50,528,1039,50.82%,37.34%,1
屏東縣,崁頂鄉,0543,261,77,338,49,387,813,47.6%,32.1%,1
屏東縣,崁頂鄉,0544,241,71,312,20,332,736,45.11%,32.74%,1
屏東縣,崁頂鄉,0545,368,118,486,40,526,934,56.32%,39.4%,1
屏東縣,崁頂鄉,0546,310,108,418,53,471,900,52.33%,34.44%,1
屏東縣,崁頂鄉,0547,375,103,478,49,527,1004,52.49%,37.35%,1
屏東縣,林邊鄉,0548,579,170,749,121,870,1458,59.67%,39.71%,1
屏東縣,林邊鄉,0549,359,110,469,51,520,891,58.36%,40.29%,1
屏東縣,林邊鄉,0550,309,65,374,42,416,695,59.86%,44.46%,1
屏東縣,林邊鄉,0551,392,139,531,73,604,1015,59.51%,38.62%,1
屏東縣,林邊鄉,0552,489,131,620,52,672,1171,57.39%,41.76%,1
屏東縣,林邊鄉,0553,373,98,471,54,525,1003,52.34%,37.19%,1
屏東縣,林邊鄉,0554,293,116,409,50,459,725,63.31%,40.41%,1
屏東縣,林邊鄉,0555,309,113,422,68,490,841,58.26%,36.74%,1
屏東縣,林邊鄉,0556,321,90,411,60,471,793,59.39%,40.48%,1
屏東縣,林邊鄉,0557,399,91,490,56,546,919,59.41%,43.42%,1
屏東縣,林邊鄉,0558,454,122,576,63,639,1283,49.81%,35.39%,1
屏東縣,林邊鄉,0559,250,76,326,45,371,783,47.38%,31.93%,1
屏東縣,林邊鄉,0560,327,84,411,54,465,1033,45.01%,31.66%,1
屏東縣,林邊鄉,0561,414,119,533,102,635,1186,53.54%,34.91%,1
屏東縣,林邊鄉,0562,263,90,353,67,420,773,54.33%,34.02%,1
屏東縣,林邊鄉,0563,366,107,473,33,506,1122,45.1%,32.62%,1
屏東縣,南州鄉,0564,322,82,404,45,449,872,51.49%,36.93%,1
屏東縣,南州鄉,0565,315,79,394,42,436,794,54.91%,39.67%,1
屏東縣,南州鄉,0566,393,107,500,56,556,962,57.8%,40.85%,1
屏東縣,南州鄉,0567,397,119,516,62,578,1033,55.95%,38.43%,1
屏東縣,南州鄉,0568,358,103,461,50,511,1007,50.74%,35.55%,1
屏東縣,南州鄉,0569,180,69,249,22,271,466,58.15%,38.63%,1
屏東縣,南州鄉,0570,299,66,365,42,407,708,57.49%,42.23%,1
屏東縣,南州鄉,0571,404,120,524,67,591,1044,56.61%,38.7%,1
屏東縣,南州鄉,0572,306,84,390,39,429,1071,40.06%,28.57%,1
屏東縣,南州鄉,0573,313,87,400,37,437,979,44.64%,31.97%,1
屏東縣,南州鄉,0574,192,50,242,31,273,543,50.28%,35.36%,1
屏東縣,佳冬鄉,0575,475,136,611,76,687,1472,46.67%,32.27%,1
屏東縣,佳冬鄉,0576,398,116,514,79,593,1360,43.6%,29.26%,1
屏東縣,佳冬鄉,0577,297,97,394,69,463,804,57.59%,36.94%,1
屏東縣,佳冬鄉,0578,302,103,405,81,486,925,52.54%,32.65%,1
屏東縣,佳冬鄉,0579,277,68,345,19,364,855,42.57%,32.4%,1
屏東縣,佳冬鄉,0580,341,82,423,57,480,981,48.93%,34.76%,1
屏東縣,佳冬鄉,0581,339,92,431,56,487,1007,48.36%,33.66%,1
屏東縣,佳冬鄉,0582,357,85,442,63,505,872,57.91%,40.94%,1
屏東縣,佳冬鄉,0583,384,111,495,76,571,1255,45.5%,30.6%,1
屏東縣,佳冬鄉,0584,369,80,449,96,545,995,54.77%,37.09%,1
屏東縣,佳冬鄉,0585,194,57,251,27,278,734,37.87%,26.43%,1
屏東縣,佳冬鄉,0586,350,92,442,36,478,1178,40.58%,29.71%,1
屏東縣,佳冬鄉,0587,333,107,440,60,500,1095,45.66%,30.41%,1
屏東縣,佳冬鄉,0588,402,130,532,116,648,1097,59.07%,36.65%,1
屏東縣,佳冬鄉,0589,452,141,593,62,655,1273,51.45%,35.51%,1
屏東縣,佳冬鄉,0590,430,147,577,77,654,1160,56.38%,37.07%,1
屏東縣,琉球鄉,0591,323,73,396,47,443,1111,39.87%,29.07%,1
屏東縣,琉球鄉,0592,297,72,369,55,424,972,43.62%,30.56%,1
屏東縣,琉球鄉,0593,464,103,567,82,649,1278,50.78%,36.31%,1
屏東縣,琉球鄉,0594,349,64,413,82,495,976,50.72%,35.76%,1
屏東縣,琉球鄉,0595,538,149,687,87,774,1658,46.68%,32.45%,1
屏東縣,琉球鄉,0596,312,69,381,58,439,1146,38.31%,27.23%,1
屏東縣,琉球鄉,0597,308,63,371,48,419,1079,38.83%,28.54%,1
屏東縣,琉球鄉,0598,398,69,467,29,496,1613,30.75%,24.67%,1
屏東縣,琉球鄉,0599,317,64,381,63,444,873,50.86%,36.31%,1
屏東縣,車城鄉,0600,208,60,268,41,309,737,41.93%,28.22%,1
屏東縣,車城鄉,0601,154,49,203,38,241,647,37.25%,23.8%,1
屏東縣,車城鄉,0602,159,36,195,21,216,491,43.99%,32.38%,1
屏東縣,車城鄉,0603,285,81,366,32,398,856,46.5%,33.29%,1
屏東縣,車城鄉,0604,159,55,214,10,224,554,40.43%,28.7%,1
屏東縣,車城鄉,0605,106,28,134,5,139,388,35.82%,27.32%,1
屏東縣,車城鄉,0606,251,79,330,34,364,922,39.48%,27.22%,1
屏東縣,車城鄉,0607,143,31,174,8,182,597,30.49%,23.95%,1
屏東縣,車城鄉,0608,134,35,169,9,178,623,28.57%,21.51%,1
屏東縣,車城鄉,0609,136,29,165,26,191,425,44.94%,32%,1
屏東縣,車城鄉,0610,165,29,194,21,215,428,50.23%,38.55%,1
屏東縣,車城鄉,0611,123,30,153,11,164,504,32.54%,24.4%,1
屏東縣,車城鄉,0612,144,38,182,23,205,423,48.46%,34.04%,1
屏東縣,滿州鄉,0613,534,140,674,49,723,1575,45.9%,33.9%,1
屏東縣,滿州鄉,0614,146,29,175,9,184,420,43.81%,34.76%,1
屏東縣,滿州鄉,0615,256,64,320,29,349,602,57.97%,42.52%,1
屏東縣,滿州鄉,0616,350,83,433,24,457,1302,35.1%,26.88%,1
屏東縣,滿州鄉,0617,429,114,543,60,603,1314,45.89%,32.65%,1
屏東縣,滿州鄉,0618,287,73,360,30,390,1308,29.82%,21.94%,1
屏東縣,滿州鄉,0619,95,26,121,14,135,367,36.78%,25.89%,1
屏東縣,滿州鄉,0620,114,27,141,25,166,318,52.2%,35.85%,1
屏東縣,枋山鄉,0621,267,69,336,31,367,604,60.76%,44.21%,1
屏東縣,枋山鄉,0622,178,48,226,33,259,428,60.51%,41.59%,1
屏東縣,枋山鄉,0623,396,115,511,67,578,928,62.28%,42.67%,1
屏東縣,枋山鄉,0624,339,96,435,21,456,972,46.91%,34.88%,1
屏東縣,枋山鄉,0625,304,91,395,61,456,1041,43.8%,29.2%,1
屏東縣,枋山鄉,0626,205,65,270,23,293,883,33.18%,23.22%,1
屏東縣,三地門鄉,0627,193,48,241,18,259,616,42.05%,31.33%,1
屏東縣,三地門鄉,0628,223,66,289,58,347,572,60.66%,38.99%,1
屏東縣,三地門鄉,0629,103,23,126,15,141,323,43.65%,31.89%,1
屏東縣,三地門鄉,0630,575,159,734,59,793,1448,54.77%,39.71%,1
屏東縣,三地門鄉,0631,166,40,206,7,213,726,29.34%,22.87%,1
屏東縣,三地門鄉,0632,199,61,260,27,287,554,51.81%,35.92%,1
屏東縣,三地門鄉,0633,125,40,165,15,180,346,52.02%,36.13%,1
屏東縣,三地門鄉,0634,118,37,155,1,156,458,34.06%,25.76%,1
屏東縣,三地門鄉,0635,280,66,346,11,357,692,51.59%,40.46%,1
屏東縣,三地門鄉,0636,313,66,379,68,447,638,70.06%,49.06%,1
屏東縣,霧臺鄉,0637,191,46,237,29,266,346,76.88%,55.2%,1
屏東縣,霧臺鄉,0638,262,61,323,14,337,677,49.78%,38.7%,1
屏東縣,霧臺鄉,0639,40,9,49,0,49,162,30.25%,24.69%,1
屏東縣,霧臺鄉,0640,71,15,86,4,90,189,47.62%,37.57%,1
屏東縣,霧臺鄉,0641,151,24,175,35,210,296,70.95%,51.01%,1
屏東縣,霧臺鄉,0642,194,62,256,11,267,483,55.28%,40.17%,1
屏東縣,霧臺鄉,0643,100,32,132,2,134,347,38.62%,28.82%,1
屏東縣,霧臺鄉,0644,142,52,194,14,208,450,46.22%,31.56%,1
屏東縣,瑪家鄉,0645,163,49,212,2,214,455,47.03%,35.82%,1
屏東縣,瑪家鄉,0646,357,140,497,45,542,821,66.02%,43.48%,1
屏東縣,瑪家鄉,0647,296,95,391,72,463,635,72.91%,46.61%,1
屏東縣,瑪家鄉,0648,388,94,482,33,515,695,74.1%,55.83%,1
屏東縣,瑪家鄉,0649,330,68,398,29,427,671,63.64%,49.18%,1
屏東縣,瑪家鄉,0650,323,91,414,12,426,1057,40.3%,30.56%,1
屏東縣,瑪家鄉,0651,381,84,465,18,483,900,53.67%,42.33%,1
屏東縣,瑪家鄉,0652,156,36,192,12,204,429,47.55%,36.36%,1
屏東縣,泰武鄉,0653,286,58,344,12,356,669,53.21%,42.75%,1
屏東縣,泰武鄉,0654,62,23,85,8,93,190,48.95%,32.63%,1
屏東縣,泰武鄉,0655,406,126,532,75,607,922,65.84%,44.03%,1
屏東縣,泰武鄉,0656,292,94,386,57,443,598,74.08%,48.83%,1
屏東縣,泰武鄉,0657,386,66,452,51,503,771,65.24%,50.06%,1
屏東縣,泰武鄉,0658,188,65,253,49,302,414,72.95%,45.41%,1
屏東縣,泰武鄉,0659,275,83,358,35,393,780,50.38%,35.26%,1
屏東縣,來義鄉,0660,417,73,490,101,591,917,64.45%,45.47%,1
屏東縣,來義鄉,0661,136,32,168,12,180,361,49.86%,37.67%,1
屏東縣,來義鄉,0662,59,13,72,2,74,216,34.26%,27.31%,1
屏東縣,來義鄉,0663,268,43,311,25,336,445,75.51%,60.22%,1
屏東縣,來義鄉,0664,131,23,154,28,182,280,65%,46.79%,1
屏東縣,來義鄉,0665,511,88,599,50,649,1097,59.16%,46.58%,1
屏東縣,來義鄉,0666,407,84,491,69,560,840,66.67%,48.45%,1
屏東縣,來義鄉,0667,311,88,399,23,422,889,47.47%,34.98%,1
屏東縣,來義鄉,0668,415,110,525,52,577,1212,47.61%,34.24%,1
屏東縣,春日鄉,0669,147,40,187,6,193,909,21.23%,16.17%,1
屏東縣,春日鄉,0670,126,56,182,18,200,663,30.17%,19%,1
屏東縣,春日鄉,0671,34,6,40,0,40,304,13.16%,11.18%,1
屏東縣,春日鄉,0672,262,58,320,19,339,928,36.53%,28.23%,1
屏東縣,春日鄉,0673,120,32,152,10,162,641,25.27%,18.72%,1
屏東縣,春日鄉,0674,78,23,101,3,104,478,21.76%,16.32%,1
屏東縣,獅子鄉,0675,291,42,333,21,354,751,47.14%,38.75%,1
屏東縣,獅子鄉,0676,267,59,326,28,354,776,45.62%,34.41%,1
屏東縣,獅子鄉,0677,222,33,255,16,271,711,38.12%,31.22%,1
屏東縣,獅子鄉,0678,108,44,152,30,182,243,74.9%,44.44%,1
屏東縣,獅子鄉,0679,132,35,167,11,178,325,54.77%,40.62%,1
屏東縣,獅子鄉,0680,102,24,126,5,131,476,27.52%,21.43%,1
屏東縣,獅子鄉,0681,185,37,222,11,233,602,38.7%,30.73%,1
屏東縣,獅子鄉,0682,102,13,115,7,122,346,35.26%,29.48%,1
屏東縣,牡丹鄉,0683,104,28,132,11,143,342,41.81%,30.41%,1
屏東縣,牡丹鄉,0684,518,93,611,52,663,1306,50.77%,39.66%,1
屏東縣,牡丹鄉,0685,135,26,161,6,167,693,24.1%,19.48%,1
屏東縣,牡丹鄉,0686,120,31,151,9,160,437,36.61%,27.46%,1
屏東縣,牡丹鄉,0687,149,36,185,9,194,392,49.49%,38.01%,1
屏東縣,牡丹鄉,0688,217,47,264,10,274,593,46.21%,36.59%,1
屏東縣,牡丹鄉,0689,105,19,124,7,131,551,23.77%,19.06%,1
宜蘭縣,宜蘭市,0001,389,105,494,22,516,982,52.55%,39.61%,1
宜蘭縣,宜蘭市,0002,511,131,642,56,698,1270,54.96%,40.24%,1
宜蘭縣,宜蘭市,0003,347,94,441,20,461,849,54.3%,40.87%,1
宜蘭縣,宜蘭市,0004,321,94,415,25,440,756,58.2%,42.46%,1
宜蘭縣,宜蘭市,0005,414,89,503,48,551,1107,49.77%,37.4%,1
宜蘭縣,宜蘭市,0006,359,90,449,46,495,893,55.43%,40.2%,1
宜蘭縣,宜蘭市,0007,376,99,475,32,507,912,55.59%,41.23%,1
宜蘭縣,宜蘭市,0008,549,144,693,58,751,1335,56.25%,41.12%,1
宜蘭縣,宜蘭市,0009,250,84,334,31,365,686,53.21%,36.44%,1
宜蘭縣,宜蘭市,0010,626,159,785,35,820,1366,60.03%,45.83%,1
宜蘭縣,宜蘭市,0011,596,154,750,28,778,1363,57.08%,43.73%,1
宜蘭縣,宜蘭市,0012,672,160,832,51,883,1540,57.34%,43.64%,1
宜蘭縣,宜蘭市,0013,568,140,708,19,727,1341,54.21%,42.36%,1
宜蘭縣,宜蘭市,0014,493,132,625,58,683,1209,56.49%,40.78%,1
宜蘭縣,宜蘭市,0015,353,101,454,53,507,900,56.33%,39.22%,1
宜蘭縣,宜蘭市,0016,375,101,476,38,514,980,52.45%,38.27%,1
宜蘭縣,宜蘭市,0017,478,137,615,26,641,1165,55.02%,41.03%,1
宜蘭縣,宜蘭市,0018,402,77,479,23,502,904,55.53%,44.47%,1
宜蘭縣,宜蘭市,0019,349,86,435,22,457,813,56.21%,42.93%,1
宜蘭縣,宜蘭市,0020,395,102,497,42,539,978,55.11%,40.39%,1
宜蘭縣,宜蘭市,0021,439,114,553,25,578,1282,45.09%,34.24%,1
宜蘭縣,宜蘭市,0022,188,72,260,11,271,465,58.28%,40.43%,1
宜蘭縣,宜蘭市,0023,277,80,357,34,391,669,58.45%,41.41%,1
宜蘭縣,宜蘭市,0024,407,89,496,31,527,923,57.1%,44.1%,1
宜蘭縣,宜蘭市,0025,404,87,491,41,532,1006,52.88%,40.16%,1
宜蘭縣,宜蘭市,0026,343,115,458,41,499,762,65.49%,45.01%,1
宜蘭縣,宜蘭市,0027,314,95,409,38,447,727,61.49%,43.19%,1
宜蘭縣,宜蘭市,0028,393,97,490,57,547,833,65.67%,47.18%,1
宜蘭縣,宜蘭市,0029,498,107,605,35,640,1143,55.99%,43.57%,1
宜蘭縣,宜蘭市,0030,409,99,508,24,532,979,54.34%,41.78%,1
宜蘭縣,宜蘭市,0031,480,128,608,52,660,1214,54.37%,39.54%,1
宜蘭縣,宜蘭市,0032,508,158,666,67,733,1283,57.13%,39.59%,1
宜蘭縣,宜蘭市,0033,407,105,512,35,547,946,57.82%,43.02%,1
宜蘭縣,宜蘭市,0034,456,96,552,33,585,1090,53.67%,41.83%,1
宜蘭縣,宜蘭市,0035,406,103,509,19,528,943,55.99%,43.05%,1
宜蘭縣,宜蘭市,0036,341,114,455,36,491,774,63.44%,44.06%,1
宜蘭縣,宜蘭市,0037,443,111,554,36,590,968,60.95%,45.76%,1
宜蘭縣,宜蘭市,0038,425,118,543,28,571,926,61.66%,45.9%,1
宜蘭縣,宜蘭市,0039,438,125,563,49,612,1019,60.06%,42.98%,1
宜蘭縣,宜蘭市,0040,452,110,562,49,611,1084,56.37%,41.7%,1
宜蘭縣,宜蘭市,0041,443,123,566,27,593,1095,54.16%,40.46%,1
宜蘭縣,宜蘭市,0042,471,123,594,28,622,1083,57.43%,43.49%,1
宜蘭縣,宜蘭市,0043,433,123,556,35,591,1108,53.34%,39.08%,1
宜蘭縣,宜蘭市,0044,367,107,474,20,494,848,58.25%,43.28%,1
宜蘭縣,宜蘭市,0045,453,118,571,33,604,1095,55.16%,41.37%,1
宜蘭縣,宜蘭市,0046,480,121,601,25,626,1110,56.4%,43.24%,1
宜蘭縣,宜蘭市,0047,478,123,601,41,642,1104,58.15%,43.3%,1
宜蘭縣,宜蘭市,0048,486,110,596,44,640,1134,56.44%,42.86%,1
宜蘭縣,宜蘭市,0049,498,118,616,43,659,1146,57.5%,43.46%,1
宜蘭縣,宜蘭市,0050,391,88,479,49,528,876,60.27%,44.63%,1
宜蘭縣,宜蘭市,0051,376,81,457,49,506,905,55.91%,41.55%,1
宜蘭縣,宜蘭市,0052,381,115,496,38,534,910,58.68%,41.87%,1
宜蘭縣,宜蘭市,0053,506,128,634,34,668,1434,46.58%,35.29%,1
宜蘭縣,宜蘭市,0054,454,122,576,61,637,1152,55.3%,39.41%,1
宜蘭縣,宜蘭市,0055,400,138,538,36,574,966,59.42%,41.41%,1
宜蘭縣,宜蘭市,0056,287,91,378,35,413,711,58.09%,40.37%,1
宜蘭縣,宜蘭市,0057,387,108,495,37,532,884,60.18%,43.78%,1
宜蘭縣,宜蘭市,0058,528,184,712,52,764,1326,57.62%,39.82%,1
宜蘭縣,宜蘭市,0059,338,100,438,27,465,909,51.16%,37.18%,1
宜蘭縣,宜蘭市,0060,364,91,455,35,490,894,54.81%,40.72%,1
宜蘭縣,宜蘭市,0061,486,118,604,31,635,1259,50.44%,38.6%,1
宜蘭縣,宜蘭市,0062,316,79,395,24,419,789,53.11%,40.05%,1
宜蘭縣,宜蘭市,0063,351,91,442,34,476,867,54.9%,40.48%,1
宜蘭縣,宜蘭市,0064,550,170,720,86,806,1454,55.43%,37.83%,1
宜蘭縣,宜蘭市,0065,530,123,653,38,691,1130,61.15%,46.9%,1
宜蘭縣,宜蘭市,0066,409,77,486,22,508,1087,46.73%,37.63%,1
宜蘭縣,宜蘭市,0067,409,113,522,58,580,938,61.83%,43.6%,1
宜蘭縣,宜蘭市,0068,509,149,658,61,719,1285,55.95%,39.61%,1
宜蘭縣,宜蘭市,0069,353,107,460,22,482,952,50.63%,37.08%,1
宜蘭縣,宜蘭市,0070,380,130,510,61,571,948,60.23%,40.08%,1
宜蘭縣,宜蘭市,0071,420,142,562,42,604,1160,52.07%,36.21%,1
宜蘭縣,宜蘭市,0072,438,111,549,65,614,1015,60.49%,43.15%,1
宜蘭縣,宜蘭市,0073,189,58,247,13,260,424,61.32%,44.58%,1
宜蘭縣,宜蘭市,0074,410,104,514,48,562,964,58.3%,42.53%,1
宜蘭縣,宜蘭市,0075,353,110,463,53,516,959,53.81%,36.81%,1
宜蘭縣,宜蘭市,0076,364,110,474,40,514,814,63.14%,44.72%,1
宜蘭縣,宜蘭市,0077,350,127,477,49,526,885,59.44%,39.55%,1
宜蘭縣,宜蘭市,0078,435,179,614,65,679,1162,58.43%,37.44%,1
宜蘭縣,羅東鎮,0079,295,82,377,30,407,689,59.07%,42.82%,1
宜蘭縣,羅東鎮,0080,292,78,370,29,399,718,55.57%,40.67%,1
宜蘭縣,羅東鎮,0081,570,188,758,62,820,1475,55.59%,38.64%,1
宜蘭縣,羅東鎮,0082,571,157,728,69,797,1466,54.37%,38.95%,1
宜蘭縣,羅東鎮,0083,448,117,565,37,602,1075,56%,41.67%,1
宜蘭縣,羅東鎮,0084,399,100,499,38,537,963,55.76%,41.43%,1
宜蘭縣,羅東鎮,0085,568,157,725,86,811,1511,53.67%,37.59%,1
宜蘭縣,羅東鎮,0086,471,126,597,29,626,1166,53.69%,40.39%,1
宜蘭縣,羅東鎮,0087,516,155,671,63,734,1273,57.66%,40.53%,1
宜蘭縣,羅東鎮,0088,692,178,870,44,914,1735,52.68%,39.88%,1
宜蘭縣,羅東鎮,0089,629,167,796,45,841,1487,56.56%,42.3%,1
宜蘭縣,羅東鎮,0090,367,102,469,33,502,837,59.98%,43.85%,1
宜蘭縣,羅東鎮,0091,551,172,723,62,785,1312,59.83%,42%,1
宜蘭縣,羅東鎮,0092,597,154,751,51,802,1502,53.4%,39.75%,1
宜蘭縣,羅東鎮,0093,449,113,562,21,583,1138,51.23%,39.46%,1
宜蘭縣,羅東鎮,0094,397,118,515,46,561,1010,55.54%,39.31%,1
宜蘭縣,羅東鎮,0095,553,145,698,91,789,1373,57.47%,40.28%,1
宜蘭縣,羅東鎮,0096,470,103,573,37,610,1089,56.01%,43.16%,1
宜蘭縣,羅東鎮,0097,551,117,668,39,707,1304,54.22%,42.25%,1
宜蘭縣,羅東鎮,0098,485,141,626,63,689,1288,53.49%,37.66%,1
宜蘭縣,羅東鎮,0099,451,133,584,58,642,1036,61.97%,43.53%,1
宜蘭縣,羅東鎮,0100,452,122,574,40,614,969,63.36%,46.65%,1
宜蘭縣,羅東鎮,0101,423,126,549,42,591,985,60%,42.94%,1
宜蘭縣,羅東鎮,0102,565,195,760,75,835,1420,58.8%,39.79%,1
宜蘭縣,羅東鎮,0103,629,138,767,53,820,1430,57.34%,43.99%,1
宜蘭縣,羅東鎮,0104,437,139,576,52,628,1075,58.42%,40.65%,1
宜蘭縣,羅東鎮,0105,376,107,483,38,521,879,59.27%,42.78%,1
宜蘭縣,羅東鎮,0106,356,91,447,22,469,850,55.18%,41.88%,1
宜蘭縣,羅東鎮,0107,493,135,628,33,661,1111,59.5%,44.37%,1
宜蘭縣,羅東鎮,0108,515,157,672,37,709,1139,62.25%,45.22%,1
宜蘭縣,羅東鎮,0109,504,154,658,35,693,1130,61.33%,44.6%,1
宜蘭縣,羅東鎮,0110,411,123,534,45,579,980,59.08%,41.94%,1
宜蘭縣,羅東鎮,0111,606,151,757,47,804,1431,56.18%,42.35%,1
宜蘭縣,羅東鎮,0112,482,119,601,31,632,1109,56.99%,43.46%,1
宜蘭縣,羅東鎮,0113,453,115,568,41,609,1083,56.23%,41.83%,1
宜蘭縣,羅東鎮,0114,585,168,753,58,811,1404,57.76%,41.67%,1
宜蘭縣,羅東鎮,0115,516,177,693,46,739,1288,57.38%,40.06%,1
宜蘭縣,羅東鎮,0116,368,130,498,48,546,1183,46.15%,31.11%,1
宜蘭縣,羅東鎮,0117,494,131,625,35,660,1105,59.73%,44.71%,1
宜蘭縣,羅東鎮,0118,423,138,561,41,602,987,60.99%,42.86%,1
宜蘭縣,羅東鎮,0119,335,98,433,39,472,773,61.06%,43.34%,1
宜蘭縣,羅東鎮,0120,651,166,817,46,863,1366,63.18%,47.66%,1
宜蘭縣,羅東鎮,0121,423,129,552,31,583,907,64.28%,46.64%,1
宜蘭縣,羅東鎮,0122,563,120,683,34,717,1158,61.92%,48.62%,1
宜蘭縣,羅東鎮,0123,397,128,525,40,565,977,57.83%,40.63%,1
宜蘭縣,羅東鎮,0124,373,110,483,46,529,972,54.42%,38.37%,1
宜蘭縣,羅東鎮,0125,420,125,545,31,576,977,58.96%,42.99%,1
宜蘭縣,羅東鎮,0126,594,169,763,60,823,1398,58.87%,42.49%,1
宜蘭縣,羅東鎮,0127,425,124,549,25,574,1022,56.16%,41.59%,1
宜蘭縣,羅東鎮,0128,500,136,636,55,691,1131,61.1%,44.21%,1
宜蘭縣,蘇澳鎮,0129,482,136,618,54,672,1194,56.28%,40.37%,1
宜蘭縣,蘇澳鎮,0130,431,125,556,35,591,1128,52.39%,38.21%,1
宜蘭縣,蘇澳鎮,0131,491,104,595,48,643,1042,61.71%,47.12%,1
宜蘭縣,蘇澳鎮,0132,422,123,545,39,584,997,58.58%,42.33%,1
宜蘭縣,蘇澳鎮,0133,540,145,685,52,737,1303,56.56%,41.44%,1
宜蘭縣,蘇澳鎮,0134,535,142,677,70,747,1260,59.29%,42.46%,1
宜蘭縣,蘇澳鎮,0135,472,107,579,59,638,1130,56.46%,41.77%,1
宜蘭縣,蘇澳鎮,0136,220,58,278,37,315,559,56.35%,39.36%,1
宜蘭縣,蘇澳鎮,0137,107,50,157,23,180,351,51.28%,30.48%,1
宜蘭縣,蘇澳鎮,0138,325,108,433,56,489,889,55.01%,36.56%,1
宜蘭縣,蘇澳鎮,0139,172,50,222,21,243,434,55.99%,39.63%,1
宜蘭縣,蘇澳鎮,0140,364,114,478,26,504,835,60.36%,43.59%,1
宜蘭縣,蘇澳鎮,0141,398,116,514,39,553,975,56.72%,40.82%,1
宜蘭縣,蘇澳鎮,0142,471,136,607,65,672,1135,59.21%,41.5%,1
宜蘭縣,蘇澳鎮,0143,368,116,484,27,511,788,64.85%,46.7%,1
宜蘭縣,蘇澳鎮,0144,164,54,218,32,250,469,53.3%,34.97%,1
宜蘭縣,蘇澳鎮,0145,310,89,399,32,431,811,53.14%,38.22%,1
宜蘭縣,蘇澳鎮,0146,356,84,440,19,459,867,52.94%,41.06%,1
宜蘭縣,蘇澳鎮,0147,469,126,595,46,641,1139,56.28%,41.18%,1
宜蘭縣,蘇澳鎮,0148,471,97,568,34,602,1146,52.53%,41.1%,1
宜蘭縣,蘇澳鎮,0149,486,108,594,58,652,1154,56.5%,42.11%,1
宜蘭縣,蘇澳鎮,0150,333,82,415,23,438,908,48.24%,36.67%,1
宜蘭縣,蘇澳鎮,0151,273,68,341,23,364,656,55.49%,41.62%,1
宜蘭縣,蘇澳鎮,0152,352,114,466,51,517,834,61.99%,42.21%,1
宜蘭縣,蘇澳鎮,0153,466,99,565,40,605,1025,59.02%,45.46%,1
宜蘭縣,蘇澳鎮,0154,176,72,248,16,264,455,58.02%,38.68%,1
宜蘭縣,蘇澳鎮,0155,219,67,286,27,313,535,58.5%,40.93%,1
宜蘭縣,蘇澳鎮,0156,250,64,314,25,339,536,63.25%,46.64%,1
宜蘭縣,蘇澳鎮,0157,198,56,254,19,273,451,60.53%,43.9%,1
宜蘭縣,蘇澳鎮,0158,231,64,295,35,330,593,55.65%,38.95%,1
宜蘭縣,蘇澳鎮,0159,175,46,221,26,247,441,56.01%,39.68%,1
宜蘭縣,蘇澳鎮,0160,391,109,500,50,550,954,57.65%,40.99%,1
宜蘭縣,蘇澳鎮,0161,374,81,455,63,518,952,54.41%,39.29%,1
宜蘭縣,蘇澳鎮,0162,390,128,518,70,588,1125,52.27%,34.67%,1
宜蘭縣,蘇澳鎮,0163,288,73,361,67,428,763,56.09%,37.75%,1
宜蘭縣,蘇澳鎮,0164,210,63,273,39,312,706,44.19%,29.75%,1
宜蘭縣,蘇澳鎮,0165,349,103,452,64,516,1068,48.31%,32.68%,1
宜蘭縣,蘇澳鎮,0166,246,90,336,52,388,666,58.26%,36.94%,1
宜蘭縣,蘇澳鎮,0167,189,65,254,71,325,574,56.62%,32.93%,1
宜蘭縣,蘇澳鎮,0168,97,27,124,11,135,351,38.46%,27.64%,1
宜蘭縣,蘇澳鎮,0169,279,83,362,43,405,717,56.49%,38.91%,1
宜蘭縣,蘇澳鎮,0170,122,16,138,14,152,373,40.75%,32.71%,1
宜蘭縣,蘇澳鎮,0171,57,20,77,12,89,223,39.91%,25.56%,1
宜蘭縣,頭城鎮,0172,68,27,95,9,104,292,35.62%,23.29%,1
宜蘭縣,頭城鎮,0173,251,75,326,42,368,688,53.49%,36.48%,1
宜蘭縣,頭城鎮,0174,283,79,362,34,396,688,57.56%,41.13%,1
宜蘭縣,頭城鎮,0175,281,111,392,51,443,879,50.4%,31.97%,1
宜蘭縣,頭城鎮,0176,141,41,182,22,204,335,60.9%,42.09%,1
宜蘭縣,頭城鎮,0177,254,101,355,38,393,624,62.98%,40.71%,1
宜蘭縣,頭城鎮,0178,226,76,302,41,343,732,46.86%,30.87%,1
宜蘭縣,頭城鎮,0179,286,85,371,48,419,892,46.97%,32.06%,1
宜蘭縣,頭城鎮,0180,217,67,284,29,313,690,45.36%,31.45%,1
宜蘭縣,頭城鎮,0181,339,71,410,42,452,842,53.68%,40.26%,1
宜蘭縣,頭城鎮,0182,300,76,376,34,410,736,55.71%,40.76%,1
宜蘭縣,頭城鎮,0183,296,67,363,31,394,788,50%,37.56%,1
宜蘭縣,頭城鎮,0184,206,58,264,22,286,560,51.07%,36.79%,1
宜蘭縣,頭城鎮,0185,308,83,391,32,423,712,59.41%,43.26%,1
宜蘭縣,頭城鎮,0186,226,57,283,38,321,502,63.94%,45.02%,1
宜蘭縣,頭城鎮,0187,264,63,327,30,357,569,62.74%,46.4%,1
宜蘭縣,頭城鎮,0188,255,63,318,43,361,633,57.03%,40.28%,1
宜蘭縣,頭城鎮,0189,350,104,454,74,528,1132,46.64%,30.92%,1
宜蘭縣,頭城鎮,0190,360,93,453,42,495,1035,47.83%,34.78%,1
宜蘭縣,頭城鎮,0191,371,100,471,32,503,847,59.39%,43.8%,1
宜蘭縣,頭城鎮,0192,484,131,615,44,659,1172,56.23%,41.3%,1
宜蘭縣,頭城鎮,0193,357,80,437,26,463,896,51.67%,39.84%,1
宜蘭縣,頭城鎮,0194,490,106,596,30,626,1075,58.23%,45.58%,1
宜蘭縣,頭城鎮,0195,369,115,484,62,546,931,58.65%,39.63%,1
宜蘭縣,頭城鎮,0196,398,106,504,58,562,1021,55.04%,38.98%,1
宜蘭縣,頭城鎮,0197,235,59,294,53,347,709,48.94%,33.15%,1
宜蘭縣,頭城鎮,0198,324,83,407,35,442,689,64.15%,47.02%,1
宜蘭縣,頭城鎮,0199,276,68,344,40,384,615,62.44%,44.88%,1
宜蘭縣,頭城鎮,0200,301,64,365,50,415,759,54.68%,39.66%,1
宜蘭縣,頭城鎮,0201,389,114,503,59,562,917,61.29%,42.42%,1
宜蘭縣,頭城鎮,0202,432,106,538,63,601,1045,57.51%,41.34%,1
宜蘭縣,頭城鎮,0203,463,119,582,55,637,1130,56.37%,40.97%,1
宜蘭縣,礁溪鄉,0204,390,102,492,37,529,1122,47.15%,34.76%,1
宜蘭縣,礁溪鄉,0205,186,51,237,29,266,505,52.67%,36.83%,1
宜蘭縣,礁溪鄉,0206,348,119,467,42,509,988,51.52%,35.22%,1
宜蘭縣,礁溪鄉,0207,378,91,469,43,512,971,52.73%,38.93%,1
宜蘭縣,礁溪鄉,0208,436,131,567,50,617,1246,49.52%,34.99%,1
宜蘭縣,礁溪鄉,0209,556,183,739,35,774,1655,46.77%,33.6%,1
宜蘭縣,礁溪鄉,0210,386,91,477,35,512,1132,45.23%,34.1%,1
宜蘭縣,礁溪鄉,0211,331,78,409,29,438,783,55.94%,42.27%,1
宜蘭縣,礁溪鄉,0212,347,112,459,39,498,928,53.66%,37.39%,1
宜蘭縣,礁溪鄉,0213,348,69,417,37,454,848,53.54%,41.04%,1
宜蘭縣,礁溪鄉,0214,297,89,386,31,417,663,62.9%,44.8%,1
宜蘭縣,礁溪鄉,0215,261,62,323,16,339,608,55.76%,42.93%,1
宜蘭縣,礁溪鄉,0216,338,90,428,36,464,833,55.7%,40.58%,1
宜蘭縣,礁溪鄉,0217,415,124,539,15,554,1233,44.93%,33.66%,1
宜蘭縣,礁溪鄉,0218,327,106,433,45,478,854,55.97%,38.29%,1
宜蘭縣,礁溪鄉,0219,214,65,279,21,300,575,52.17%,37.22%,1
宜蘭縣,礁溪鄉,0220,320,105,425,41,466,835,55.81%,38.32%,1
宜蘭縣,礁溪鄉,0221,536,159,695,48,743,1305,56.93%,41.07%,1
宜蘭縣,礁溪鄉,0222,318,103,421,39,460,830,55.42%,38.31%,1
宜蘭縣,礁溪鄉,0223,285,97,382,45,427,649,65.79%,43.91%,1
宜蘭縣,礁溪鄉,0224,314,84,398,45,443,923,48%,34.02%,1
宜蘭縣,礁溪鄉,0225,389,101,490,40,530,1177,45.03%,33.05%,1
宜蘭縣,礁溪鄉,0226,337,84,421,40,461,840,54.88%,40.12%,1
宜蘭縣,礁溪鄉,0227,423,123,546,28,574,1051,54.61%,40.25%,1
宜蘭縣,礁溪鄉,0228,469,140,609,46,655,1339,48.92%,35.03%,1
宜蘭縣,礁溪鄉,0229,533,121,654,48,702,1194,58.79%,44.64%,1
宜蘭縣,礁溪鄉,0230,517,175,692,80,772,1314,58.75%,39.35%,1
宜蘭縣,礁溪鄉,0231,413,147,560,27,587,1125,52.18%,36.71%,1
宜蘭縣,礁溪鄉,0232,530,125,655,65,720,1207,59.65%,43.91%,1
宜蘭縣,礁溪鄉,0233,386,104,490,58,548,979,55.98%,39.43%,1
宜蘭縣,礁溪鄉,0234,386,133,519,65,584,954,61.22%,40.46%,1
宜蘭縣,礁溪鄉,0235,148,64,212,10,222,418,53.11%,35.41%,1
宜蘭縣,壯圍鄉,0236,574,191,765,97,862,1435,60.07%,40%,1
宜蘭縣,壯圍鄉,0237,425,144,569,55,624,1049,59.49%,40.51%,1
宜蘭縣,壯圍鄉,0238,457,127,584,71,655,1068,61.33%,42.79%,1
宜蘭縣,壯圍鄉,0239,324,78,402,96,498,868,57.37%,37.33%,1
宜蘭縣,壯圍鄉,0240,362,107,469,40,509,967,52.64%,37.44%,1
宜蘭縣,壯圍鄉,0241,398,110,508,67,575,940,61.17%,42.34%,1
宜蘭縣,壯圍鄉,0242,338,85,423,31,454,975,46.56%,34.67%,1
宜蘭縣,壯圍鄉,0243,318,99,417,72,489,797,61.36%,39.9%,1
宜蘭縣,壯圍鄉,0244,337,72,409,56,465,808,57.55%,41.71%,1
宜蘭縣,壯圍鄉,0245,333,123,456,81,537,911,58.95%,36.55%,1
宜蘭縣,壯圍鄉,0246,230,50,280,36,316,612,51.63%,37.58%,1
宜蘭縣,壯圍鄉,0247,344,107,451,51,502,790,63.54%,43.54%,1
宜蘭縣,壯圍鄉,0248,341,127,468,56,524,878,59.68%,38.84%,1
宜蘭縣,壯圍鄉,0249,340,80,420,43,463,723,64.04%,47.03%,1
宜蘭縣,壯圍鄉,0250,243,85,328,29,357,737,48.44%,32.97%,1
宜蘭縣,壯圍鄉,0251,267,87,354,59,413,686,60.2%,38.92%,1
宜蘭縣,壯圍鄉,0252,358,68,426,12,438,895,48.94%,40%,1
宜蘭縣,壯圍鄉,0253,549,131,680,74,754,1237,60.95%,44.38%,1
宜蘭縣,壯圍鄉,0254,470,120,590,60,650,1134,57.32%,41.45%,1
宜蘭縣,壯圍鄉,0255,427,129,556,57,613,1107,55.37%,38.57%,1
宜蘭縣,壯圍鄉,0256,459,111,570,27,597,1057,56.48%,43.42%,1
宜蘭縣,壯圍鄉,0257,379,105,484,46,530,1051,50.43%,36.06%,1
宜蘭縣,壯圍鄉,0258,276,74,350,47,397,722,54.99%,38.23%,1
宜蘭縣,員山鄉,0259,540,150,690,25,715,1393,51.33%,38.77%,1
宜蘭縣,員山鄉,0260,338,94,432,27,459,895,51.28%,37.77%,1
宜蘭縣,員山鄉,0261,475,115,590,79,669,1231,54.35%,38.59%,1
宜蘭縣,員山鄉,0262,429,95,524,34,558,1098,50.82%,39.07%,1
宜蘭縣,員山鄉,0263,403,91,494,34,528,1031,51.21%,39.09%,1
宜蘭縣,員山鄉,0264,391,93,484,70,554,1030,53.79%,37.96%,1
宜蘭縣,員山鄉,0265,356,147,503,41,544,1168,46.58%,30.48%,1
宜蘭縣,員山鄉,0266,309,95,404,55,459,809,56.74%,38.2%,1
宜蘭縣,員山鄉,0267,324,71,395,52,447,778,57.46%,41.65%,1
宜蘭縣,員山鄉,0268,634,154,788,55,843,1465,57.54%,43.28%,1
宜蘭縣,員山鄉,0269,415,111,526,52,578,979,59.04%,42.39%,1
宜蘭縣,員山鄉,0270,359,73,432,46,478,860,55.58%,41.74%,1
宜蘭縣,員山鄉,0271,406,111,517,80,597,1205,49.54%,33.69%,1
宜蘭縣,員山鄉,0272,415,110,525,83,608,1082,56.19%,38.35%,1
宜蘭縣,員山鄉,0273,160,52,212,31,243,412,58.98%,38.83%,1
宜蘭縣,員山鄉,0274,126,40,166,19,185,403,45.91%,31.27%,1
宜蘭縣,員山鄉,0275,61,26,87,17,104,232,44.83%,26.29%,1
宜蘭縣,員山鄉,0276,396,60,456,48,504,944,53.39%,41.95%,1
宜蘭縣,員山鄉,0277,335,116,451,45,496,894,55.48%,37.47%,1
宜蘭縣,員山鄉,0278,519,154,673,79,752,1356,55.46%,38.27%,1
宜蘭縣,員山鄉,0279,299,106,405,48,453,780,58.08%,38.33%,1
宜蘭縣,員山鄉,0280,361,144,505,83,588,932,63.09%,38.73%,1
宜蘭縣,員山鄉,0281,187,78,265,35,300,583,51.46%,32.08%,1
宜蘭縣,員山鄉,0282,352,85,437,67,504,900,56%,39.11%,1
宜蘭縣,員山鄉,0283,278,88,366,37,403,747,53.95%,37.22%,1
宜蘭縣,員山鄉,0284,307,72,379,50,429,788,54.44%,38.96%,1
宜蘭縣,員山鄉,0285,304,109,413,50,463,884,52.38%,34.39%,1
宜蘭縣,員山鄉,0286,302,91,393,15,408,857,47.61%,35.24%,1
宜蘭縣,員山鄉,0287,355,104,459,26,485,1016,47.74%,34.94%,1
宜蘭縣,員山鄉,0288,207,58,265,40,305,690,44.2%,30%,1
宜蘭縣,員山鄉,0289,241,65,306,54,360,689,52.25%,34.98%,1
宜蘭縣,冬山鄉,0290,347,97,444,42,486,807,60.22%,43%,1
宜蘭縣,冬山鄉,0291,344,96,440,17,457,817,55.94%,42.11%,1
宜蘭縣,冬山鄉,0292,504,111,615,43,658,1156,56.92%,43.6%,1
宜蘭縣,冬山鄉,0293,348,88,436,36,472,892,52.91%,39.01%,1
宜蘭縣,冬山鄉,0294,382,115,497,32,529,897,58.97%,42.59%,1
宜蘭縣,冬山鄉,0295,606,170,776,51,827,1392,59.41%,43.53%,1
宜蘭縣,冬山鄉,0296,607,185,792,47,839,1471,57.04%,41.26%,1
宜蘭縣,冬山鄉,0297,472,130,602,31,633,1435,44.11%,32.89%,1
宜蘭縣,冬山鄉,0298,573,159,732,36,768,1519,50.56%,37.72%,1
宜蘭縣,冬山鄉,0299,628,159,787,30,817,1456,56.11%,43.13%,1
宜蘭縣,冬山鄉,0300,295,92,387,41,428,711,60.2%,41.49%,1
宜蘭縣,冬山鄉,0301,305,73,378,27,405,694,58.36%,43.95%,1
宜蘭縣,冬山鄉,0302,689,220,909,46,955,1526,62.58%,45.15%,1
宜蘭縣,冬山鄉,0303,348,101,449,32,481,884,54.41%,39.37%,1
宜蘭縣,冬山鄉,0304,533,118,651,63,714,1465,48.74%,36.38%,1
宜蘭縣,冬山鄉,0305,187,51,238,38,276,488,56.56%,38.32%,1
宜蘭縣,冬山鄉,0306,464,129,593,55,648,1218,53.2%,38.1%,1
宜蘭縣,冬山鄉,0307,479,135,614,42,656,1291,50.81%,37.1%,1
宜蘭縣,冬山鄉,0308,491,137,628,35,663,1324,50.08%,37.08%,1
宜蘭縣,冬山鄉,0309,428,106,534,38,572,1160,49.31%,36.9%,1
宜蘭縣,冬山鄉,0310,484,141,625,46,671,1246,53.85%,38.84%,1
宜蘭縣,冬山鄉,0311,650,191,841,34,875,1754,49.89%,37.06%,1
宜蘭縣,冬山鄉,0312,452,129,581,61,642,1217,52.75%,37.14%,1
宜蘭縣,冬山鄉,0313,535,139,674,46,720,1495,48.16%,35.79%,1
宜蘭縣,冬山鄉,0314,373,100,473,37,510,937,54.43%,39.81%,1
宜蘭縣,冬山鄉,0315,411,111,522,31,553,1101,50.23%,37.33%,1
宜蘭縣,冬山鄉,0316,396,124,520,60,580,1118,51.88%,35.42%,1
宜蘭縣,冬山鄉,0317,558,141,699,49,748,1301,57.49%,42.89%,1
宜蘭縣,冬山鄉,0318,487,116,603,25,628,1225,51.27%,39.76%,1
宜蘭縣,冬山鄉,0319,494,164,658,44,702,1206,58.21%,40.96%,1
宜蘭縣,冬山鄉,0320,449,151,600,33,633,1278,49.53%,35.13%,1
宜蘭縣,冬山鄉,0321,432,125,557,37,594,1151,51.61%,37.53%,1
宜蘭縣,冬山鄉,0322,408,91,499,42,541,1094,49.45%,37.29%,1
宜蘭縣,冬山鄉,0323,512,148,660,46,706,1247,56.62%,41.06%,1
宜蘭縣,冬山鄉,0324,455,130,585,42,627,1247,50.28%,36.49%,1
宜蘭縣,冬山鄉,0325,404,99,503,26,529,979,54.03%,41.27%,1
宜蘭縣,冬山鄉,0326,322,80,402,22,424,698,60.74%,46.13%,1
宜蘭縣,冬山鄉,0327,654,162,816,49,865,1726,50.12%,37.89%,1
宜蘭縣,冬山鄉,0328,246,72,318,16,334,782,42.71%,31.46%,1
宜蘭縣,五結鄉,0329,384,90,474,57,531,1076,49.35%,35.69%,1
宜蘭縣,五結鄉,0330,344,116,460,23,483,944,51.17%,36.44%,1
宜蘭縣,五結鄉,0331,351,79,430,20,450,836,53.83%,41.99%,1
宜蘭縣,五結鄉,0332,381,108,489,41,530,937,56.56%,40.66%,1
宜蘭縣,五結鄉,0333,481,137,618,34,652,1255,51.95%,38.33%,1
宜蘭縣,五結鄉,0334,454,164,618,67,685,1270,53.94%,35.75%,1
宜蘭縣,五結鄉,0335,297,72,369,24,393,801,49.06%,37.08%,1
宜蘭縣,五結鄉,0336,320,64,384,33,417,802,52%,39.9%,1
宜蘭縣,五結鄉,0337,493,124,617,33,650,1306,49.77%,37.75%,1
宜蘭縣,五結鄉,0338,450,130,580,46,626,1190,52.61%,37.82%,1
宜蘭縣,五結鄉,0339,515,126,641,25,666,1316,50.61%,39.13%,1
宜蘭縣,五結鄉,0340,400,89,489,30,519,965,53.78%,41.45%,1
宜蘭縣,五結鄉,0341,320,84,404,31,435,814,53.44%,39.31%,1
宜蘭縣,五結鄉,0342,459,131,590,50,640,1254,51.04%,36.6%,1
宜蘭縣,五結鄉,0343,444,108,552,52,604,1060,56.98%,41.89%,1
宜蘭縣,五結鄉,0344,534,153,687,36,723,1323,54.65%,40.36%,1
宜蘭縣,五結鄉,0345,468,130,598,43,641,1120,57.23%,41.79%,1
宜蘭縣,五結鄉,0346,370,81,451,24,475,893,53.19%,41.43%,1
宜蘭縣,五結鄉,0347,460,144,604,41,645,1220,52.87%,37.7%,1
宜蘭縣,五結鄉,0348,413,102,515,21,536,924,58.01%,44.7%,1
宜蘭縣,五結鄉,0349,414,105,519,42,561,933,60.13%,44.37%,1
宜蘭縣,五結鄉,0350,421,83,504,24,528,986,53.55%,42.7%,1
宜蘭縣,五結鄉,0351,286,85,371,37,408,748,54.55%,38.24%,1
宜蘭縣,五結鄉,0352,572,178,750,82,832,1550,53.68%,36.9%,1
宜蘭縣,五結鄉,0353,257,71,328,27,355,629,56.44%,40.86%,1
宜蘭縣,五結鄉,0354,329,79,408,33,441,806,54.71%,40.82%,1
宜蘭縣,五結鄉,0355,326,126,452,44,496,956,51.88%,34.1%,1
宜蘭縣,五結鄉,0356,404,119,523,40,563,1066,52.81%,37.9%,1
宜蘭縣,五結鄉,0357,544,141,685,64,749,1513,49.5%,35.96%,1
宜蘭縣,五結鄉,0358,583,200,783,42,825,1566,52.68%,37.23%,1
宜蘭縣,五結鄉,0359,349,94,443,55,498,894,55.7%,39.04%,1
宜蘭縣,五結鄉,0360,389,131,520,61,581,1235,47.04%,31.5%,1
宜蘭縣,五結鄉,0361,281,76,357,39,396,704,56.25%,39.91%,1
宜蘭縣,三星鄉,0362,79,21,100,14,114,215,53.02%,36.74%,1
宜蘭縣,三星鄉,0363,159,48,207,34,241,523,46.08%,30.4%,1
宜蘭縣,三星鄉,0364,236,97,333,57,390,745,52.35%,31.68%,1
宜蘭縣,三星鄉,0365,210,57,267,36,303,617,49.11%,34.04%,1
宜蘭縣,三星鄉,0366,162,63,225,38,263,497,52.92%,32.6%,1
宜蘭縣,三星鄉,0367,258,95,353,58,411,735,55.92%,35.1%,1
宜蘭縣,三星鄉,0368,227,52,279,45,324,583,55.57%,38.94%,1
宜蘭縣,三星鄉,0369,170,35,205,29,234,436,53.67%,38.99%,1
宜蘭縣,三星鄉,0370,464,114,578,60,638,1224,52.12%,37.91%,1
宜蘭縣,三星鄉,0371,400,105,505,39,544,1151,47.26%,34.75%,1
宜蘭縣,三星鄉,0372,350,88,438,38,476,870,54.71%,40.23%,1
宜蘭縣,三星鄉,0373,380,109,489,43,532,1284,41.43%,29.6%,1
宜蘭縣,三星鄉,0374,358,123,481,49,530,897,59.09%,39.91%,1
宜蘭縣,三星鄉,0375,588,136,724,49,773,1439,53.72%,40.86%,1
宜蘭縣,三星鄉,0376,530,153,683,53,736,1445,50.93%,36.68%,1
宜蘭縣,三星鄉,0377,530,163,693,37,730,1402,52.07%,37.8%,1
宜蘭縣,三星鄉,0378,427,164,591,49,640,1230,52.03%,34.72%,1
宜蘭縣,三星鄉,0379,303,77,380,52,432,774,55.81%,39.15%,1
宜蘭縣,三星鄉,0380,332,95,427,50,477,827,57.68%,40.15%,1
宜蘭縣,三星鄉,0381,273,87,360,31,391,736,53.13%,37.09%,1
宜蘭縣,三星鄉,0382,552,139,691,63,754,1421,53.06%,38.85%,1
宜蘭縣,大同鄉,0383,235,76,311,47,358,893,40.09%,26.32%,1
宜蘭縣,大同鄉,0384,332,82,414,45,459,632,72.63%,52.53%,1
宜蘭縣,大同鄉,0385,232,44,276,18,294,684,42.98%,33.92%,1
宜蘭縣,大同鄉,0386,123,26,149,26,175,264,66.29%,46.59%,1
宜蘭縣,大同鄉,0387,99,12,111,4,115,337,34.12%,29.38%,1
宜蘭縣,大同鄉,0388,107,25,132,7,139,404,34.41%,26.49%,1
宜蘭縣,大同鄉,0389,17,4,21,5,26,55,47.27%,30.91%,1
宜蘭縣,大同鄉,0390,86,46,132,21,153,199,76.88%,43.22%,1
宜蘭縣,大同鄉,0391,177,54,231,17,248,787,31.51%,22.49%,1
宜蘭縣,大同鄉,0392,236,74,310,50,360,680,52.94%,34.71%,1
宜蘭縣,南澳鄉,0393,176,40,216,9,225,444,50.68%,39.64%,1
宜蘭縣,南澳鄉,0394,484,86,570,23,593,1210,49.01%,40%,1
宜蘭縣,南澳鄉,0395,426,85,511,73,584,962,60.71%,44.28%,1
宜蘭縣,南澳鄉,0396,123,23,146,4,150,411,36.5%,29.93%,1
宜蘭縣,南澳鄉,0397,240,51,291,17,308,447,68.9%,53.69%,1
宜蘭縣,南澳鄉,0398,254,79,333,35,368,475,77.47%,53.47%,1
宜蘭縣,南澳鄉,0399,304,65,369,42,411,695,59.14%,43.74%,1
花蓮縣,花蓮市,0001,669,159,828,33,861,1522,56.57%,43.96%,1
花蓮縣,花蓮市,0002,511,114,625,26,651,1114,58.44%,45.87%,1
花蓮縣,花蓮市,0003,283,74,357,19,376,670,56.12%,42.24%,1
花蓮縣,花蓮市,0004,594,119,713,24,737,1397,52.76%,42.52%,1
花蓮縣,花蓮市,0005,179,41,220,18,238,470,50.64%,38.09%,1
花蓮縣,花蓮市,0006,347,59,406,25,431,838,51.43%,41.41%,1
花蓮縣,花蓮市,0007,250,39,289,11,300,721,41.61%,34.67%,1
花蓮縣,花蓮市,0008,409,85,494,34,528,918,57.52%,44.55%,1
花蓮縣,花蓮市,0009,625,148,773,35,808,1539,52.5%,40.61%,1
花蓮縣,花蓮市,0010,577,110,687,58,745,1403,53.1%,41.13%,1
花蓮縣,花蓮市,0011,441,99,540,24,564,1068,52.81%,41.29%,1
花蓮縣,花蓮市,0012,515,105,620,23,643,1167,55.1%,44.13%,1
花蓮縣,花蓮市,0013,578,119,697,51,748,1259,59.41%,45.91%,1
花蓮縣,花蓮市,0014,440,101,541,71,612,1071,57.14%,41.08%,1
花蓮縣,花蓮市,0015,393,98,491,36,527,925,56.97%,42.49%,1
花蓮縣,花蓮市,0016,530,137,667,43,710,1141,62.23%,46.45%,1
花蓮縣,花蓮市,0017,471,98,569,26,595,1163,51.16%,40.5%,1
花蓮縣,花蓮市,0018,590,111,701,39,740,1279,57.86%,46.13%,1
花蓮縣,花蓮市,0019,559,130,689,26,715,1512,47.29%,36.97%,1
花蓮縣,花蓮市,0020,251,62,313,20,333,615,54.15%,40.81%,1
花蓮縣,花蓮市,0021,246,90,336,12,348,606,57.43%,40.59%,1
花蓮縣,花蓮市,0022,218,46,264,14,278,559,49.73%,39%,1
花蓮縣,花蓮市,0023,189,40,229,17,246,442,55.66%,42.76%,1
花蓮縣,花蓮市,0024,438,94,532,29,561,1114,50.36%,39.32%,1
花蓮縣,花蓮市,0025,177,35,212,23,235,416,56.49%,42.55%,1
花蓮縣,花蓮市,0026,255,78,333,18,351,577,60.83%,44.19%,1
花蓮縣,花蓮市,0027,383,85,468,26,494,810,60.99%,47.28%,1
花蓮縣,花蓮市,0028,240,50,290,20,310,538,57.62%,44.61%,1
花蓮縣,花蓮市,0029,227,56,283,26,309,566,54.59%,40.11%,1
花蓮縣,花蓮市,0030,201,38,239,7,246,469,52.45%,42.86%,1
花蓮縣,花蓮市,0031,254,51,305,18,323,565,57.17%,44.96%,1
花蓮縣,花蓮市,0032,310,57,367,33,400,816,49.02%,37.99%,1
花蓮縣,花蓮市,0033,357,78,435,41,476,911,52.25%,39.19%,1
花蓮縣,花蓮市,0034,413,84,497,40,537,1029,52.19%,40.14%,1
花蓮縣,花蓮市,0035,480,97,577,38,615,1043,58.96%,46.02%,1
花蓮縣,花蓮市,0036,390,82,472,16,488,856,57.01%,45.56%,1
花蓮縣,花蓮市,0037,396,120,516,30,546,979,55.77%,40.45%,1
花蓮縣,花蓮市,0038,567,139,706,45,751,1331,56.42%,42.6%,1
花蓮縣,花蓮市,0039,546,116,662,30,692,1228,56.35%,44.46%,1
花蓮縣,花蓮市,0040,417,97,514,30,544,955,56.96%,43.66%,1
花蓮縣,花蓮市,0041,505,107,612,28,640,1268,50.47%,39.83%,1
花蓮縣,花蓮市,0042,489,127,616,29,645,1230,52.44%,39.76%,1
花蓮縣,花蓮市,0043,603,119,722,49,771,1369,56.32%,44.05%,1
花蓮縣,花蓮市,0044,502,107,609,29,638,1435,44.46%,34.98%,1
花蓮縣,花蓮市,0045,488,120,608,32,640,1164,54.98%,41.92%,1
花蓮縣,花蓮市,0046,566,124,690,45,735,1249,58.85%,45.32%,1
花蓮縣,花蓮市,0047,497,109,606,50,656,1184,55.41%,41.98%,1
花蓮縣,花蓮市,0048,608,134,742,40,782,1490,52.48%,40.81%,1
花蓮縣,花蓮市,0049,519,89,608,34,642,1022,62.82%,50.78%,1
花蓮縣,花蓮市,0050,476,125,601,36,637,1135,56.12%,41.94%,1
花蓮縣,花蓮市,0051,484,96,580,30,610,1084,56.27%,44.65%,1
花蓮縣,花蓮市,0052,376,91,467,32,499,1339,37.27%,28.08%,1
花蓮縣,花蓮市,0053,237,51,288,12,300,501,59.88%,47.31%,1
花蓮縣,花蓮市,0054,395,81,476,21,497,904,54.98%,43.69%,1
花蓮縣,花蓮市,0055,228,61,289,15,304,490,62.04%,46.53%,1
花蓮縣,花蓮市,0056,441,99,540,25,565,1192,47.4%,37%,1
花蓮縣,花蓮市,0057,335,80,415,20,435,869,50.06%,38.55%,1
花蓮縣,花蓮市,0058,547,90,637,37,674,1267,53.2%,43.17%,1
花蓮縣,花蓮市,0059,415,96,511,41,552,959,57.56%,43.27%,1
花蓮縣,花蓮市,0060,438,76,514,26,540,993,54.38%,44.11%,1
花蓮縣,花蓮市,0061,406,99,505,47,552,982,56.21%,41.34%,1
花蓮縣,花蓮市,0062,486,117,603,15,618,1311,47.14%,37.07%,1
花蓮縣,花蓮市,0063,553,144,697,50,747,1455,51.34%,38.01%,1
花蓮縣,花蓮市,0064,417,101,518,18,536,1151,46.57%,36.23%,1
花蓮縣,花蓮市,0065,473,116,589,21,610,1237,49.31%,38.24%,1
花蓮縣,花蓮市,0066,500,107,607,37,644,1339,48.1%,37.34%,1
花蓮縣,花蓮市,0067,327,64,391,23,414,715,57.9%,45.73%,1
花蓮縣,花蓮市,0068,421,98,519,34,553,1000,55.3%,42.1%,1
花蓮縣,花蓮市,0069,529,134,663,35,698,1410,49.5%,37.52%,1
花蓮縣,花蓮市,0070,551,120,671,13,684,1303,52.49%,42.29%,1
花蓮縣,花蓮市,0071,537,103,640,32,672,1256,53.5%,42.75%,1
花蓮縣,花蓮市,0072,477,117,594,42,636,1105,57.56%,43.17%,1
花蓮縣,花蓮市,0073,424,112,536,21,557,1089,51.15%,38.93%,1
花蓮縣,花蓮市,0074,403,91,494,18,512,1043,49.09%,38.64%,1
花蓮縣,花蓮市,0075,515,80,595,25,620,1080,57.41%,47.69%,1
花蓮縣,花蓮市,0076,443,79,522,27,549,971,56.54%,45.62%,1
花蓮縣,花蓮市,0077,472,104,576,34,610,1068,57.12%,44.19%,1
花蓮縣,花蓮市,0078,552,114,666,24,690,1379,50.04%,40.03%,1
花蓮縣,花蓮市,0079,539,133,672,45,717,1362,52.64%,39.57%,1
花蓮縣,花蓮市,0080,596,127,723,33,756,1323,57.14%,45.05%,1
花蓮縣,花蓮市,0081,488,142,630,44,674,1482,45.48%,32.93%,1
花蓮縣,鳳林鎮,0195,559,117,676,62,738,1192,61.91%,46.9%,1
花蓮縣,鳳林鎮,0196,247,58,305,20,325,639,50.86%,38.65%,1
花蓮縣,鳳林鎮,0197,290,68,358,42,400,601,66.56%,48.25%,1
花蓮縣,鳳林鎮,0198,558,122,680,46,726,1137,63.85%,49.08%,1
花蓮縣,鳳林鎮,0199,290,78,368,49,417,742,56.2%,39.08%,1
花蓮縣,鳳林鎮,0200,277,45,322,27,349,610,57.21%,45.41%,1
花蓮縣,鳳林鎮,0201,112,42,154,38,192,295,65.08%,37.97%,1
花蓮縣,鳳林鎮,0202,54,10,64,2,66,218,30.28%,24.77%,1
花蓮縣,鳳林鎮,0203,226,53,279,22,301,720,41.81%,31.39%,1
花蓮縣,鳳林鎮,0204,200,62,262,23,285,528,53.98%,37.88%,1
花蓮縣,鳳林鎮,0205,210,61,271,18,289,560,51.61%,37.5%,1
花蓮縣,鳳林鎮,0206,208,32,240,51,291,541,53.79%,38.45%,1
花蓮縣,鳳林鎮,0207,333,77,410,54,464,818,56.72%,40.71%,1
花蓮縣,鳳林鎮,0208,311,66,377,30,407,984,41.36%,31.61%,1
花蓮縣,鳳林鎮,0209,34,6,40,9,49,91,53.85%,37.36%,1
花蓮縣,玉里鎮,0254,423,90,513,35,548,1008,54.37%,41.96%,1
花蓮縣,玉里鎮,0255,439,83,522,34,556,939,59.21%,46.75%,1
花蓮縣,玉里鎮,0256,505,82,587,71,658,1256,52.39%,40.21%,1
花蓮縣,玉里鎮,0257,375,89,464,42,506,929,54.47%,40.37%,1
花蓮縣,玉里鎮,0258,414,88,502,33,535,979,54.65%,42.29%,1
花蓮縣,玉里鎮,0259,566,125,691,39,730,1244,58.68%,45.5%,1
花蓮縣,玉里鎮,0260,295,82,377,39,416,847,49.11%,34.83%,1
花蓮縣,玉里鎮,0261,262,71,333,47,380,772,49.22%,33.94%,1
花蓮縣,玉里鎮,0262,209,46,255,22,277,558,49.64%,37.46%,1
花蓮縣,玉里鎮,0263,194,47,241,20,261,800,32.63%,24.25%,1
花蓮縣,玉里鎮,0264,438,99,537,58,595,1286,46.27%,34.06%,1
花蓮縣,玉里鎮,0265,407,116,523,76,599,1246,48.07%,32.66%,1
花蓮縣,玉里鎮,0266,201,89,290,56,346,647,53.48%,31.07%,1
花蓮縣,玉里鎮,0267,171,31,202,16,218,990,22.02%,17.27%,1
花蓮縣,玉里鎮,0268,155,51,206,57,263,530,49.62%,29.25%,1
花蓮縣,玉里鎮,0269,232,84,316,41,357,979,36.47%,23.7%,1
花蓮縣,玉里鎮,0270,175,53,228,92,320,557,57.45%,31.42%,1
花蓮縣,玉里鎮,0271,116,26,142,15,157,434,36.18%,26.73%,1
花蓮縣,玉里鎮,0272,214,85,299,62,361,1065,33.9%,20.09%,1
花蓮縣,玉里鎮,0273,274,95,369,92,461,866,53.23%,31.64%,1
花蓮縣,玉里鎮,0274,209,68,277,38,315,769,40.96%,27.18%,1
花蓮縣,玉里鎮,0275,266,72,338,32,370,869,42.58%,30.61%,1
花蓮縣,玉里鎮,0276,322,80,402,44,446,1080,41.3%,29.81%,1
花蓮縣,新城鄉,0082,160,37,197,17,214,367,58.31%,43.6%,1
花蓮縣,新城鄉,0083,357,73,430,9,439,929,47.26%,38.43%,1
花蓮縣,新城鄉,0084,231,75,306,48,354,590,60%,39.15%,1
花蓮縣,新城鄉,0085,111,41,152,21,173,307,56.35%,36.16%,1
花蓮縣,新城鄉,0086,117,23,140,20,160,260,61.54%,45%,1
花蓮縣,新城鄉,0087,544,119,663,57,720,1283,56.12%,42.4%,1
花蓮縣,新城鄉,0088,357,64,421,19,440,885,49.72%,40.34%,1
花蓮縣,新城鄉,0089,331,81,412,26,438,770,56.88%,42.99%,1
花蓮縣,新城鄉,0090,558,125,683,58,741,1363,54.37%,40.94%,1
花蓮縣,新城鄉,0091,145,38,183,9,192,366,52.46%,39.62%,1
花蓮縣,新城鄉,0092,433,115,548,43,591,1163,50.82%,37.23%,1
花蓮縣,新城鄉,0093,639,154,793,45,838,1605,52.21%,39.81%,1
花蓮縣,新城鄉,0094,492,102,594,43,637,1194,53.35%,41.21%,1
花蓮縣,新城鄉,0095,429,80,509,43,552,979,56.38%,43.82%,1
花蓮縣,新城鄉,0096,648,140,788,33,821,1485,55.29%,43.64%,1
花蓮縣,新城鄉,0097,437,87,524,35,559,1070,52.24%,40.84%,1
花蓮縣,新城鄉,0098,497,111,608,26,634,1164,54.47%,42.7%,1
花蓮縣,新城鄉,0099,340,76,416,51,467,880,53.07%,38.64%,1
花蓮縣,新城鄉,0100,137,34,171,18,189,369,51.22%,37.13%,1
花蓮縣,吉安鄉,0115,420,100,520,34,554,1059,52.31%,39.66%,1
花蓮縣,吉安鄉,0116,436,80,516,29,545,983,55.44%,44.35%,1
花蓮縣,吉安鄉,0117,452,76,528,34,562,1031,54.51%,43.84%,1
花蓮縣,吉安鄉,0118,427,110,537,27,564,1105,51.04%,38.64%,1
花蓮縣,吉安鄉,0119,439,102,541,33,574,1107,51.85%,39.66%,1
花蓮縣,吉安鄉,0120,430,127,557,30,587,1179,49.79%,36.47%,1
花蓮縣,吉安鄉,0121,481,128,609,54,663,1453,45.63%,33.1%,1
花蓮縣,吉安鄉,0122,666,130,796,44,840,1432,58.66%,46.51%,1
花蓮縣,吉安鄉,0123,575,125,700,27,727,1320,55.08%,43.56%,1
花蓮縣,吉安鄉,0124,538,120,658,23,681,1356,50.22%,39.68%,1
花蓮縣,吉安鄉,0125,533,98,631,30,661,1295,51.04%,41.16%,1
花蓮縣,吉安鄉,0126,620,127,747,50,797,1467,54.33%,42.26%,1
花蓮縣,吉安鄉,0127,609,146,755,29,784,1515,51.75%,40.2%,1
花蓮縣,吉安鄉,0128,492,103,595,35,630,1063,59.27%,46.28%,1
花蓮縣,吉安鄉,0129,458,88,546,17,563,1284,43.85%,35.67%,1
花蓮縣,吉安鄉,0130,621,122,743,30,773,1380,56.01%,45%,1
花蓮縣,吉安鄉,0131,535,149,684,47,731,1297,56.36%,41.25%,1
花蓮縣,吉安鄉,0132,617,161,778,64,842,1662,50.66%,37.12%,1
花蓮縣,吉安鄉,0133,503,174,677,71,748,1563,47.86%,32.18%,1
花蓮縣,吉安鄉,0134,473,104,577,43,620,1288,48.14%,36.72%,1
花蓮縣,吉安鄉,0135,371,101,472,30,502,907,55.35%,40.9%,1
花蓮縣,吉安鄉,0136,360,91,451,22,473,917,51.58%,39.26%,1
花蓮縣,吉安鄉,0137,400,103,503,23,526,1021,51.52%,39.18%,1
花蓮縣,吉安鄉,0138,472,106,578,36,614,1033,59.44%,45.69%,1
花蓮縣,吉安鄉,0139,420,88,508,42,550,966,56.94%,43.48%,1
花蓮縣,吉安鄉,0140,484,90,574,50,624,1188,52.53%,40.74%,1
花蓮縣,吉安鄉,0141,624,114,738,25,763,1480,51.55%,42.16%,1
花蓮縣,吉安鄉,0142,536,107,643,32,675,1393,48.46%,38.48%,1
花蓮縣,吉安鄉,0143,465,97,562,30,592,1193,49.62%,38.98%,1
花蓮縣,吉安鄉,0144,539,122,661,32,693,1445,47.96%,37.3%,1
花蓮縣,吉安鄉,0145,513,133,646,67,713,1301,54.8%,39.43%,1
花蓮縣,吉安鄉,0146,519,126,645,48,693,1215,57.04%,42.72%,1
花蓮縣,吉安鄉,0147,473,105,578,31,609,1135,53.66%,41.67%,1
花蓮縣,吉安鄉,0148,567,102,669,26,695,1223,56.83%,46.36%,1
花蓮縣,吉安鄉,0149,543,115,658,40,698,1274,54.79%,42.62%,1
花蓮縣,吉安鄉,0150,456,98,554,37,591,1124,52.58%,40.57%,1
花蓮縣,吉安鄉,0151,521,107,628,24,652,1158,56.3%,44.99%,1
花蓮縣,吉安鄉,0152,509,111,620,25,645,1157,55.75%,43.99%,1
花蓮縣,吉安鄉,0153,550,112,662,24,686,1258,54.53%,43.72%,1
花蓮縣,吉安鄉,0154,515,124,639,28,667,1257,53.06%,40.97%,1
花蓮縣,吉安鄉,0155,518,110,628,21,649,1245,52.13%,41.61%,1
花蓮縣,吉安鄉,0156,512,127,639,7,646,1166,55.4%,43.91%,1
花蓮縣,吉安鄉,0157,539,122,661,48,709,1358,52.21%,39.69%,1
花蓮縣,吉安鄉,0158,508,90,598,32,630,1214,51.89%,41.85%,1
花蓮縣,吉安鄉,0159,449,109,558,51,609,1151,52.91%,39.01%,1
花蓮縣,吉安鄉,0160,484,130,614,27,641,1157,55.4%,41.83%,1
花蓮縣,吉安鄉,0161,513,109,622,34,656,1161,56.5%,44.19%,1
花蓮縣,吉安鄉,0162,567,133,700,36,736,1304,56.44%,43.48%,1
花蓮縣,吉安鄉,0163,536,137,673,44,717,1367,52.45%,39.21%,1
花蓮縣,吉安鄉,0164,490,135,625,40,665,1411,47.13%,34.73%,1
花蓮縣,吉安鄉,0165,536,96,632,28,660,1409,46.84%,38.04%,1
花蓮縣,吉安鄉,0166,399,97,496,37,533,1125,47.38%,35.47%,1
花蓮縣,吉安鄉,0167,478,126,604,66,670,1213,55.23%,39.41%,1
花蓮縣,吉安鄉,0168,478,114,592,32,624,1141,54.69%,41.89%,1
花蓮縣,吉安鄉,0169,436,78,514,16,530,1156,45.85%,37.72%,1
花蓮縣,吉安鄉,0170,442,79,521,44,565,1092,51.74%,40.48%,1
花蓮縣,吉安鄉,0171,328,105,433,31,464,1026,45.22%,31.97%,1
花蓮縣,吉安鄉,0172,337,68,405,13,418,804,51.99%,41.92%,1
花蓮縣,吉安鄉,0173,475,116,591,34,625,1132,55.21%,41.96%,1
花蓮縣,壽豐鄉,0174,365,102,467,36,503,1052,47.81%,34.7%,1
花蓮縣,壽豐鄉,0175,159,37,196,22,218,357,61.06%,44.54%,1
花蓮縣,壽豐鄉,0176,381,91,472,44,516,1022,50.49%,37.28%,1
花蓮縣,壽豐鄉,0177,391,115,506,41,547,875,62.51%,44.69%,1
花蓮縣,壽豐鄉,0178,291,93,384,39,423,691,61.22%,42.11%,1
花蓮縣,壽豐鄉,0179,235,67,302,21,323,708,45.62%,33.19%,1
花蓮縣,壽豐鄉,0180,331,99,430,43,473,894,52.91%,37.02%,1
花蓮縣,壽豐鄉,0181,304,75,379,31,410,746,54.96%,40.75%,1
花蓮縣,壽豐鄉,0182,344,91,435,37,472,881,53.58%,39.05%,1
花蓮縣,壽豐鄉,0183,338,57,395,36,431,695,62.01%,48.63%,1
花蓮縣,壽豐鄉,0184,319,120,439,72,511,816,62.62%,39.09%,1
花蓮縣,壽豐鄉,0185,277,70,347,48,395,773,51.1%,35.83%,1
花蓮縣,壽豐鄉,0186,404,122,526,54,580,1029,56.37%,39.26%,1
花蓮縣,壽豐鄉,0187,190,41,231,26,257,407,63.14%,46.68%,1
花蓮縣,壽豐鄉,0188,485,118,603,45,648,1139,56.89%,42.58%,1
花蓮縣,壽豐鄉,0189,400,140,540,34,574,996,57.63%,40.16%,1
花蓮縣,壽豐鄉,0190,136,40,176,11,187,414,45.17%,32.85%,1
花蓮縣,壽豐鄉,0191,116,35,151,6,157,270,58.15%,42.96%,1
花蓮縣,壽豐鄉,0192,363,83,446,40,486,836,58.13%,43.42%,1
花蓮縣,壽豐鄉,0193,217,68,285,21,306,507,60.36%,42.8%,1
花蓮縣,壽豐鄉,0194,216,60,276,39,315,739,42.63%,29.23%,1
花蓮縣,光復鄉,0210,522,132,654,65,719,1295,55.52%,40.31%,1
花蓮縣,光復鄉,0211,373,89,462,35,497,859,57.86%,43.42%,1
花蓮縣,光復鄉,0212,352,96,448,122,570,958,59.5%,36.74%,1
花蓮縣,光復鄉,0213,370,127,497,93,590,1011,58.36%,36.6%,1
花蓮縣,光復鄉,0214,439,103,542,61,603,1041,57.93%,42.17%,1
花蓮縣,光復鄉,0215,292,89,381,67,448,821,54.57%,35.57%,1
花蓮縣,光復鄉,0216,28,6,34,1,35,188,18.62%,14.89%,1
花蓮縣,光復鄉,0217,208,46,254,28,282,514,54.86%,40.47%,1
花蓮縣,光復鄉,0218,103,43,146,12,158,446,35.43%,23.09%,1
花蓮縣,光復鄉,0219,303,83,386,45,431,851,50.65%,35.61%,1
花蓮縣,光復鄉,0220,243,76,319,25,344,932,36.91%,26.07%,1
花蓮縣,光復鄉,0221,212,38,250,18,268,471,56.9%,45.01%,1
花蓮縣,光復鄉,0222,251,61,312,46,358,640,55.94%,39.22%,1
花蓮縣,光復鄉,0223,35,7,42,3,45,116,38.79%,30.17%,1
花蓮縣,光復鄉,0224,116,19,135,10,145,496,29.23%,23.39%,1
花蓮縣,光復鄉,0225,106,30,136,10,146,324,45.06%,32.72%,1
花蓮縣,光復鄉,0226,126,32,158,18,176,454,38.77%,27.75%,1
花蓮縣,豐濱鄉,0227,194,66,260,82,342,717,47.7%,27.06%,1
花蓮縣,豐濱鄉,0228,170,87,257,47,304,751,40.48%,22.64%,1
花蓮縣,豐濱鄉,0229,176,63,239,48,287,613,46.82%,28.71%,1
花蓮縣,豐濱鄉,0230,283,56,339,23,362,809,44.75%,34.98%,1
花蓮縣,豐濱鄉,0231,44,9,53,2,55,357,15.41%,12.32%,1
花蓮縣,豐濱鄉,0232,207,71,278,62,340,669,50.82%,30.94%,1
花蓮縣,豐濱鄉,0233,162,34,196,12,208,479,43.42%,33.82%,1
花蓮縣,瑞穗鄉,0241,357,73,430,39,469,813,57.69%,43.91%,1
花蓮縣,瑞穗鄉,0242,448,98,546,63,609,1091,55.82%,41.06%,1
花蓮縣,瑞穗鄉,0243,371,72,443,33,476,839,56.73%,44.22%,1
花蓮縣,瑞穗鄉,0244,405,101,506,51,557,975,57.13%,41.54%,1
花蓮縣,瑞穗鄉,0245,180,54,234,20,254,546,46.52%,32.97%,1
花蓮縣,瑞穗鄉,0246,413,98,511,59,570,1002,56.89%,41.22%,1
花蓮縣,瑞穗鄉,0247,177,61,238,38,276,593,46.54%,29.85%,1
花蓮縣,瑞穗鄉,0248,362,117,479,73,552,965,57.2%,37.51%,1
花蓮縣,瑞穗鄉,0249,316,108,424,52,476,863,55.16%,36.62%,1
花蓮縣,瑞穗鄉,0250,58,14,72,5,77,340,22.65%,17.06%,1
花蓮縣,瑞穗鄉,0251,250,72,322,32,354,764,46.34%,32.72%,1
花蓮縣,瑞穗鄉,0252,139,16,155,15,170,868,19.59%,16.01%,1
花蓮縣,瑞穗鄉,0253,140,26,166,13,179,620,28.87%,22.58%,1
花蓮縣,富里鄉,0277,144,36,180,18,198,467,42.4%,30.84%,1
花蓮縣,富里鄉,0278,286,72,358,49,407,1032,39.44%,27.71%,1
花蓮縣,富里鄉,0279,206,35,241,35,276,638,43.26%,32.29%,1
花蓮縣,富里鄉,0280,204,46,250,72,322,591,54.48%,34.52%,1
花蓮縣,富里鄉,0281,435,100,535,56,591,1087,54.37%,40.02%,1
花蓮縣,富里鄉,0282,159,45,204,20,224,431,51.97%,36.89%,1
花蓮縣,富里鄉,0283,323,65,388,46,434,893,48.6%,36.17%,1
花蓮縣,富里鄉,0284,100,30,130,19,149,361,41.27%,27.7%,1
花蓮縣,富里鄉,0285,386,107,493,47,540,1362,39.65%,28.34%,1
花蓮縣,富里鄉,0286,171,46,217,21,238,458,51.97%,37.34%,1
花蓮縣,富里鄉,0287,125,36,161,34,195,621,31.4%,20.13%,1
花蓮縣,富里鄉,0288,163,57,220,23,243,493,49.29%,33.06%,1
花蓮縣,富里鄉,0289,207,61,268,30,298,631,47.23%,32.81%,1
花蓮縣,秀林鄉,0101,322,88,410,30,440,867,50.75%,37.14%,1
花蓮縣,秀林鄉,0102,196,71,267,24,291,575,50.61%,34.09%,1
花蓮縣,秀林鄉,0103,353,113,466,50,516,1373,37.58%,25.71%,1
花蓮縣,秀林鄉,0104,520,112,632,72,704,1644,42.82%,31.63%,1
花蓮縣,秀林鄉,0105,69,11,80,9,89,162,54.94%,42.59%,1
花蓮縣,秀林鄉,0106,119,49,168,25,193,384,50.26%,30.99%,1
花蓮縣,秀林鄉,0107,445,90,535,39,574,1382,41.53%,32.2%,1
花蓮縣,秀林鄉,0108,383,99,482,26,508,1125,45.16%,34.04%,1
花蓮縣,秀林鄉,0109,216,58,274,11,285,627,45.45%,34.45%,1
花蓮縣,秀林鄉,0110,443,106,549,52,601,987,60.89%,44.88%,1
花蓮縣,秀林鄉,0111,485,124,609,90,699,1139,61.37%,42.58%,1
花蓮縣,秀林鄉,0112,471,94,565,8,573,1213,47.24%,38.83%,1
花蓮縣,秀林鄉,0113,285,73,358,28,386,754,51.19%,37.8%,1
花蓮縣,秀林鄉,0114,108,21,129,13,142,330,43.03%,32.73%,1
花蓮縣,萬榮鄉,0234,398,124,522,72,594,1072,55.41%,37.13%,1
花蓮縣,萬榮鄉,0235,163,42,205,13,218,560,38.93%,29.11%,1
花蓮縣,萬榮鄉,0236,337,91,428,30,458,773,59.25%,43.6%,1
花蓮縣,萬榮鄉,0237,179,60,239,12,251,661,37.97%,27.08%,1
花蓮縣,萬榮鄉,0238,161,43,204,19,223,442,50.45%,36.43%,1
花蓮縣,萬榮鄉,0239,200,81,281,66,347,675,51.41%,29.63%,1
花蓮縣,萬榮鄉,0240,434,184,618,119,737,1086,67.86%,39.96%,1
花蓮縣,卓溪鄉,0290,208,58,266,16,282,533,52.91%,39.02%,1
花蓮縣,卓溪鄉,0291,214,75,289,37,326,522,62.45%,41%,1
花蓮縣,卓溪鄉,0292,127,37,164,17,181,493,36.71%,25.76%,1
花蓮縣,卓溪鄉,0293,316,84,400,38,438,701,62.48%,45.08%,1
花蓮縣,卓溪鄉,0294,323,69,392,51,443,746,59.38%,43.3%,1
花蓮縣,卓溪鄉,0295,222,106,328,58,386,616,62.66%,36.04%,1
花蓮縣,卓溪鄉,0296,96,17,113,16,129,405,31.85%,23.7%,1
花蓮縣,卓溪鄉,0297,131,32,163,16,179,329,54.41%,39.82%,1
花蓮縣,卓溪鄉,0298,174,27,201,17,218,428,50.93%,40.65%,1
花蓮縣,卓溪鄉,0299,78,10,88,10,98,174,56.32%,44.83%,1
臺東縣,臺東市,0001,332,72,404,24,428,874,48.97%,37.99%,1
臺東縣,臺東市,0002,688,148,836,68,904,1469,61.54%,46.83%,1
臺東縣,臺東市,0003,523,142,665,30,695,1259,55.2%,41.54%,1
臺東縣,臺東市,0004,564,161,725,39,764,1399,54.61%,40.31%,1
臺東縣,臺東市,0005,665,130,795,45,840,1363,61.63%,48.79%,1
臺東縣,臺東市,0006,682,166,848,43,891,1651,53.97%,41.31%,1
臺東縣,臺東市,0007,693,179,872,53,925,1490,62.08%,46.51%,1
臺東縣,臺東市,0008,347,69,416,29,445,859,51.8%,40.4%,1
臺東縣,臺東市,0009,422,86,508,28,536,890,60.22%,47.42%,1
臺東縣,臺東市,0010,263,78,341,35,376,651,57.76%,40.4%,1
臺東縣,臺東市,0011,582,184,766,57,823,1650,49.88%,35.27%,1
臺東縣,臺東市,0012,318,99,417,33,450,724,62.15%,43.92%,1
臺東縣,臺東市,0013,286,67,353,28,381,632,60.28%,45.25%,1
臺東縣,臺東市,0014,346,79,425,37,462,771,59.92%,44.88%,1
臺東縣,臺東市,0015,297,83,380,27,407,798,51%,37.22%,1
臺東縣,臺東市,0016,488,145,633,87,720,1299,55.43%,37.57%,1
臺東縣,臺東市,0017,366,89,455,32,487,811,60.05%,45.13%,1
臺東縣,臺東市,0018,366,85,451,38,489,764,64.01%,47.91%,1
臺東縣,臺東市,0019,300,75,375,18,393,784,50.13%,38.27%,1
臺東縣,臺東市,0020,159,33,192,15,207,427,48.48%,37.24%,1
臺東縣,臺東市,0021,487,115,602,36,638,1292,49.38%,37.69%,1
臺東縣,臺東市,0022,671,143,814,21,835,1501,55.63%,44.7%,1
臺東縣,臺東市,0023,227,49,276,20,296,601,49.25%,37.77%,1
臺東縣,臺東市,0024,164,31,195,8,203,417,48.68%,39.33%,1
臺東縣,臺東市,0025,431,82,513,42,555,1001,55.44%,43.06%,1
臺東縣,臺東市,0026,725,181,906,45,951,1638,58.06%,44.26%,1
臺東縣,臺東市,0027,670,152,822,49,871,1576,55.27%,42.51%,1
臺東縣,臺東市,0028,704,133,837,59,896,1595,56.18%,44.14%,1
臺東縣,臺東市,0029,767,152,919,48,967,1734,55.77%,44.23%,1
臺東縣,臺東市,0030,646,145,791,52,843,1476,57.11%,43.77%,1
臺東縣,臺東市,0031,723,156,879,47,926,1545,59.94%,46.8%,1
臺東縣,臺東市,0032,611,129,740,47,787,1313,59.94%,46.53%,1
臺東縣,臺東市,0033,652,126,778,38,816,1338,60.99%,48.73%,1
臺東縣,臺東市,0034,572,104,676,30,706,1312,53.81%,43.6%,1
臺東縣,臺東市,0035,538,140,678,46,724,1265,57.23%,42.53%,1
臺東縣,臺東市,0036,464,150,614,63,677,1407,48.12%,32.98%,1
臺東縣,臺東市,0037,596,121,717,40,757,1552,48.78%,38.4%,1
臺東縣,臺東市,0038,610,129,739,72,811,1445,56.12%,42.21%,1
臺東縣,臺東市,0039,921,206,1127,62,1189,2098,56.67%,43.9%,1
臺東縣,臺東市,0040,567,137,704,79,783,1324,59.14%,42.82%,1
臺東縣,臺東市,0041,688,115,803,38,841,1598,52.63%,43.05%,1
臺東縣,臺東市,0042,623,122,745,29,774,1513,51.16%,41.18%,1
臺東縣,臺東市,0043,654,121,775,69,844,1679,50.27%,38.95%,1
臺東縣,臺東市,0044,518,155,673,65,738,1414,52.19%,36.63%,1
臺東縣,臺東市,0045,735,163,898,54,952,1798,52.95%,40.88%,1
臺東縣,臺東市,0046,579,156,735,63,798,1749,45.63%,33.1%,1
臺東縣,臺東市,0047,693,155,848,90,938,1709,54.89%,40.55%,1
臺東縣,臺東市,0048,648,123,771,53,824,1629,50.58%,39.78%,1
臺東縣,臺東市,0049,411,116,527,63,590,1116,52.87%,36.83%,1
臺東縣,臺東市,0050,413,99,512,28,540,1259,42.89%,32.8%,1
臺東縣,臺東市,0051,408,104,512,36,548,1232,44.48%,33.12%,1
臺東縣,臺東市,0052,501,162,663,108,771,1505,51.23%,33.29%,1
臺東縣,臺東市,0053,269,78,347,57,404,836,48.33%,32.18%,1
臺東縣,臺東市,0054,556,128,684,48,732,1294,56.57%,42.97%,1
臺東縣,臺東市,0055,526,140,666,55,721,1350,53.41%,38.96%,1
臺東縣,臺東市,0056,940,186,1126,70,1196,2162,55.32%,43.48%,1
臺東縣,臺東市,0057,758,170,928,35,963,1627,59.19%,46.59%,1
臺東縣,臺東市,0058,488,119,607,54,661,1140,57.98%,42.81%,1
臺東縣,臺東市,0059,537,116,653,45,698,1359,51.36%,39.51%,1
臺東縣,臺東市,0060,532,151,683,56,739,1329,55.61%,40.03%,1
臺東縣,臺東市,0061,381,97,478,37,515,990,52.02%,38.48%,1
臺東縣,臺東市,0062,420,107,527,58,585,1038,56.36%,40.46%,1
臺東縣,臺東市,0063,594,164,758,76,834,1597,52.22%,37.19%,1
臺東縣,臺東市,0064,533,132,665,80,745,1385,53.79%,38.48%,1
臺東縣,臺東市,0065,308,83,391,17,408,939,43.45%,32.8%,1
臺東縣,臺東市,0066,382,104,486,62,548,1258,43.56%,30.37%,1
臺東縣,臺東市,0067,478,147,625,11,636,1350,47.11%,35.41%,1
臺東縣,臺東市,0068,370,78,448,27,475,1058,44.9%,34.97%,1
臺東縣,臺東市,0069,258,78,336,30,366,895,40.89%,28.83%,1
臺東縣,成功鎮,0070,173,43,216,43,259,516,50.19%,33.53%,1
臺東縣,成功鎮,0071,366,154,520,64,584,960,60.83%,38.13%,1
臺東縣,成功鎮,0072,86,17,103,15,118,365,32.33%,23.56%,1
臺東縣,成功鎮,0073,218,69,287,58,345,747,46.18%,29.18%,1
臺東縣,成功鎮,0074,102,31,133,26,159,339,46.9%,30.09%,1
臺東縣,成功鎮,0075,340,82,422,29,451,995,45.33%,34.17%,1
臺東縣,成功鎮,0076,333,98,431,53,484,863,56.08%,38.59%,1
臺東縣,成功鎮,0077,386,76,462,45,507,931,54.46%,41.46%,1
臺東縣,成功鎮,0078,370,73,443,33,476,970,49.07%,38.14%,1
臺東縣,成功鎮,0079,489,98,587,104,691,1365,50.62%,35.82%,1
臺東縣,成功鎮,0080,525,118,643,78,721,1366,52.78%,38.43%,1
臺東縣,成功鎮,0081,153,48,201,62,263,516,50.97%,29.65%,1
臺東縣,成功鎮,0082,225,68,293,82,375,887,42.28%,25.37%,1
臺東縣,成功鎮,0083,127,46,173,44,217,488,44.47%,26.02%,1
臺東縣,成功鎮,0084,116,38,154,41,195,481,40.54%,24.12%,1
臺東縣,成功鎮,0085,58,15,73,2,75,373,20.11%,15.55%,1
臺東縣,成功鎮,0086,90,32,122,23,145,264,54.92%,34.09%,1
臺東縣,關山鎮,0087,415,96,511,25,536,909,58.97%,45.65%,1
臺東縣,關山鎮,0088,265,52,317,20,337,790,42.66%,33.54%,1
臺東縣,關山鎮,0089,379,85,464,36,500,828,60.39%,45.77%,1
臺東縣,關山鎮,0090,270,76,346,23,369,887,41.6%,30.44%,1
臺東縣,關山鎮,0091,495,96,591,26,617,1137,54.27%,43.54%,1
臺東縣,關山鎮,0092,252,66,318,32,350,732,47.81%,34.43%,1
臺東縣,關山鎮,0093,343,90,433,35,468,912,51.32%,37.61%,1
臺東縣,關山鎮,0094,233,46,279,20,299,779,38.38%,29.91%,1
臺東縣,關山鎮,0095,164,24,188,15,203,535,37.94%,30.65%,1
臺東縣,卑南鄉,0096,413,129,542,58,600,1041,57.64%,39.67%,1
臺東縣,卑南鄉,0097,440,87,527,40,567,1165,48.67%,37.77%,1
臺東縣,卑南鄉,0098,56,20,76,20,96,219,43.84%,25.57%,1
臺東縣,卑南鄉,0099,152,33,185,29,214,460,46.52%,33.04%,1
臺東縣,卑南鄉,0100,112,28,140,15,155,387,40.05%,28.94%,1
臺東縣,卑南鄉,0101,248,57,305,25,330,767,43.02%,32.33%,1
臺東縣,卑南鄉,0102,192,42,234,36,270,503,53.68%,38.17%,1
臺東縣,卑南鄉,0103,233,74,307,39,346,727,47.59%,32.05%,1
臺東縣,卑南鄉,0104,157,39,196,33,229,436,52.52%,36.01%,1
臺東縣,卑南鄉,0105,49,36,85,11,96,261,36.78%,18.77%,1
臺東縣,卑南鄉,0106,69,34,103,12,115,215,53.49%,32.09%,1
臺東縣,卑南鄉,0107,609,134,743,60,803,1442,55.69%,42.23%,1
臺東縣,卑南鄉,0108,208,42,250,12,262,527,49.72%,39.47%,1
臺東縣,卑南鄉,0109,397,124,521,58,579,1046,55.35%,37.95%,1
臺東縣,卑南鄉,0110,399,125,524,72,596,1110,53.69%,35.95%,1
臺東縣,卑南鄉,0111,462,110,572,56,628,1105,56.83%,41.81%,1
臺東縣,卑南鄉,0112,467,132,599,129,728,1167,62.38%,40.02%,1
臺東縣,卑南鄉,0113,305,113,418,52,470,968,48.55%,31.51%,1
臺東縣,卑南鄉,0114,42,13,55,2,57,159,35.85%,26.42%,1
臺東縣,卑南鄉,0115,163,37,200,19,219,488,44.88%,33.4%,1
臺東縣,卑南鄉,0116,150,36,186,18,204,347,58.79%,43.23%,1
臺東縣,卑南鄉,0117,170,33,203,23,226,436,51.83%,38.99%,1
臺東縣,鹿野鄉,0118,146,35,181,8,189,522,36.21%,27.97%,1
臺東縣,鹿野鄉,0119,213,69,282,25,307,574,53.48%,37.11%,1
臺東縣,鹿野鄉,0120,288,88,376,38,414,1055,39.24%,27.3%,1
臺東縣,鹿野鄉,0121,373,104,477,37,514,1104,46.56%,33.79%,1
臺東縣,鹿野鄉,0122,115,25,140,14,154,342,45.03%,33.63%,1
臺東縣,鹿野鄉,0123,283,92,375,44,419,895,46.82%,31.62%,1
臺東縣,鹿野鄉,0124,267,94,361,48,409,864,47.34%,30.9%,1
臺東縣,鹿野鄉,0125,174,69,243,45,288,675,42.67%,25.78%,1
臺東縣,鹿野鄉,0126,146,50,196,17,213,435,48.97%,33.56%,1
臺東縣,鹿野鄉,0127,109,48,157,23,180,470,38.3%,23.19%,1
臺東縣,池上鄉,0128,355,78,433,28,461,992,46.47%,35.79%,1
臺東縣,池上鄉,0129,385,78,463,47,510,929,54.9%,41.44%,1
臺東縣,池上鄉,0130,145,41,186,24,210,434,48.39%,33.41%,1
臺東縣,池上鄉,0131,203,70,273,33,306,703,43.53%,28.88%,1
臺東縣,池上鄉,0132,201,40,241,20,261,654,39.91%,30.73%,1
臺東縣,池上鄉,0133,86,27,113,15,128,324,39.51%,26.54%,1
臺東縣,池上鄉,0134,245,77,322,36,358,794,45.09%,30.86%,1
臺東縣,池上鄉,0135,314,60,374,40,414,856,48.36%,36.68%,1
臺東縣,池上鄉,0136,106,22,128,13,141,344,40.99%,30.81%,1
臺東縣,池上鄉,0137,128,24,152,19,171,311,54.98%,41.16%,1
臺東縣,池上鄉,0138,82,36,118,18,136,386,35.23%,21.24%,1
臺東縣,池上鄉,0139,103,32,135,18,153,435,35.17%,23.68%,1
臺東縣,東河鄉,0140,79,20,99,23,122,290,42.07%,27.24%,1
臺東縣,東河鄉,0141,241,57,298,38,336,620,54.19%,38.87%,1
臺東縣,東河鄉,0142,469,166,635,104,739,1196,61.79%,39.21%,1
臺東縣,東河鄉,0143,255,81,336,92,428,918,46.62%,27.78%,1
臺東縣,東河鄉,0144,174,39,213,44,257,555,46.31%,31.35%,1
臺東縣,東河鄉,0145,276,87,363,30,393,977,40.23%,28.25%,1
臺東縣,東河鄉,0146,219,60,279,13,292,1197,24.39%,18.3%,1
臺東縣,東河鄉,0147,143,37,180,29,209,867,24.11%,16.49%,1
臺東縣,東河鄉,0148,99,30,129,19,148,345,42.9%,28.7%,1
臺東縣,東河鄉,0149,109,39,148,20,168,408,41.18%,26.72%,1
臺東縣,東河鄉,0150,85,20,105,9,114,262,43.51%,32.44%,1
臺東縣,長濱鄉,0151,189,71,260,49,309,536,57.65%,35.26%,1
臺東縣,長濱鄉,0152,157,34,191,28,219,689,31.79%,22.79%,1
臺東縣,長濱鄉,0153,291,105,396,103,499,913,54.65%,31.87%,1
臺東縣,長濱鄉,0154,336,65,401,24,425,1268,33.52%,26.5%,1
臺東縣,長濱鄉,0155,194,83,277,58,335,725,46.21%,26.76%,1
臺東縣,長濱鄉,0156,100,27,127,6,133,532,25%,18.8%,1
臺東縣,長濱鄉,0157,165,53,218,61,279,660,42.27%,25%,1
臺東縣,長濱鄉,0158,53,8,61,4,65,336,19.35%,15.77%,1
臺東縣,長濱鄉,0159,43,7,50,14,64,195,32.82%,22.05%,1
臺東縣,長濱鄉,0160,10,1,11,2,13,25,52%,40%,1
臺東縣,長濱鄉,0161,148,42,190,60,250,605,41.32%,24.46%,1
臺東縣,太麻里鄉,0162,272,64,336,48,384,722,53.19%,37.67%,1
臺東縣,太麻里鄉,0163,209,59,268,21,289,575,50.26%,36.35%,1
臺東縣,太麻里鄉,0164,210,68,278,32,310,623,49.76%,33.71%,1
臺東縣,太麻里鄉,0165,187,56,243,51,294,622,47.27%,30.06%,1
臺東縣,太麻里鄉,0166,159,35,194,13,207,560,36.96%,28.39%,1
臺東縣,太麻里鄉,0167,336,89,425,100,525,957,54.86%,35.11%,1
臺東縣,太麻里鄉,0168,226,95,321,36,357,809,44.13%,27.94%,1
臺東縣,太麻里鄉,0169,290,81,371,43,414,673,61.52%,43.09%,1
臺東縣,太麻里鄉,0170,265,65,330,49,379,737,51.42%,35.96%,1
臺東縣,太麻里鄉,0171,151,55,206,32,238,424,56.13%,35.61%,1
臺東縣,太麻里鄉,0172,104,53,157,22,179,374,47.86%,27.81%,1
臺東縣,太麻里鄉,0173,202,55,257,20,277,829,33.41%,24.37%,1
臺東縣,太麻里鄉,0174,212,51,263,6,269,869,30.96%,24.4%,1
臺東縣,太麻里鄉,0175,47,13,60,4,64,223,28.7%,21.08%,1
臺東縣,太麻里鄉,0176,259,59,318,44,362,669,54.11%,38.71%,1
臺東縣,大武鄉,0177,209,57,266,66,332,568,58.45%,36.8%,1
臺東縣,大武鄉,0178,445,124,569,151,720,1474,48.85%,30.19%,1
臺東縣,大武鄉,0179,466,130,596,110,706,1327,53.2%,35.12%,1
臺東縣,大武鄉,0180,319,104,423,110,533,1134,47%,28.13%,1
臺東縣,大武鄉,0181,118,34,152,61,213,386,55.18%,30.57%,1
臺東縣,大武鄉,0182,101,36,137,30,167,377,44.3%,26.79%,1
臺東縣,綠島鄉,0183,470,99,569,30,599,1474,40.64%,31.89%,1
臺東縣,綠島鄉,0184,361,78,439,34,473,1082,43.72%,33.36%,1
臺東縣,綠島鄉,0185,282,76,358,23,381,813,46.86%,34.69%,1
臺東縣,綠島鄉,0186,70,23,93,3,96,210,45.71%,33.33%,1
臺東縣,海端鄉,0187,169,58,227,36,263,497,52.92%,34%,1
臺東縣,海端鄉,0188,222,73,295,35,330,569,58%,39.02%,1
臺東縣,海端鄉,0189,318,103,421,58,479,971,49.33%,32.75%,1
臺東縣,海端鄉,0190,270,83,353,40,393,728,53.98%,37.09%,1
臺東縣,海端鄉,0191,91,33,124,16,140,259,54.05%,35.14%,1
臺東縣,海端鄉,0192,81,33,114,12,126,254,49.61%,31.89%,1
臺東縣,延平鄉,0193,342,101,443,59,502,1014,49.51%,33.73%,1
臺東縣,延平鄉,0194,169,61,230,66,296,426,69.48%,39.67%,1
臺東縣,延平鄉,0195,148,35,183,24,207,315,65.71%,46.98%,1
臺東縣,延平鄉,0196,160,55,215,15,230,579,39.72%,27.63%,1
臺東縣,延平鄉,0197,189,59,248,26,274,596,45.97%,31.71%,1
臺東縣,金峰鄉,0198,355,118,473,62,535,1241,43.11%,28.61%,1
臺東縣,金峰鄉,0199,251,59,310,34,344,601,57.24%,41.76%,1
臺東縣,金峰鄉,0200,266,75,341,52,393,520,75.58%,51.15%,1
臺東縣,金峰鄉,0201,127,35,162,27,189,336,56.25%,37.8%,1
臺東縣,金峰鄉,0202,91,31,122,30,152,330,46.06%,27.58%,1
臺東縣,達仁鄉,0203,101,27,128,26,154,246,62.6%,41.06%,1
臺東縣,達仁鄉,0204,178,29,207,11,218,340,64.12%,52.35%,1
臺東縣,達仁鄉,0205,138,43,181,14,195,296,65.88%,46.62%,1
臺東縣,達仁鄉,0206,188,39,227,37,264,429,61.54%,43.82%,1
臺東縣,達仁鄉,0207,144,40,184,27,211,331,63.75%,43.5%,1
臺東縣,達仁鄉,0208,167,67,234,23,257,628,40.92%,26.59%,1
臺東縣,達仁鄉,0209,324,92,416,50,466,867,53.75%,37.37%,1
臺東縣,蘭嶼鄉,0210,252,87,339,29,368,943,39.02%,26.72%,1
臺東縣,蘭嶼鄉,0211,372,114,486,23,509,1238,41.11%,30.05%,1
臺東縣,蘭嶼鄉,0212,223,117,340,21,361,1240,29.11%,17.98%,1
臺東縣,蘭嶼鄉,0213,173,66,239,40,279,760,36.71%,22.76%,1
澎湖縣,馬公市,0001,161,50,211,13,224,481,46.57%,33.47%,1
澎湖縣,馬公市,0002,219,44,263,19,282,558,50.54%,39.25%,1
澎湖縣,馬公市,0003,175,43,218,45,263,533,49.34%,32.83%,1
澎湖縣,馬公市,0004,318,98,416,31,447,922,48.48%,34.49%,1
澎湖縣,馬公市,0005,392,107,499,37,536,1021,52.5%,38.39%,1
澎湖縣,馬公市,0006,289,81,370,32,402,793,50.69%,36.44%,1
澎湖縣,馬公市,0007,371,90,461,47,508,954,53.25%,38.89%,1
澎湖縣,馬公市,0008,328,132,460,30,490,1001,48.95%,32.77%,1
澎湖縣,馬公市,0009,393,97,490,38,528,1192,44.3%,32.97%,1
澎湖縣,馬公市,0010,502,113,615,41,656,1402,46.79%,35.81%,1
澎湖縣,馬公市,0011,563,102,665,27,692,1389,49.82%,40.53%,1
澎湖縣,馬公市,0012,523,127,650,38,688,1339,51.38%,39.06%,1
澎湖縣,馬公市,0013,422,115,537,44,581,1254,46.33%,33.65%,1
澎湖縣,馬公市,0014,439,109,548,51,599,1194,50.17%,36.77%,1
澎湖縣,馬公市,0015,484,136,620,52,672,1393,48.24%,34.75%,1
澎湖縣,馬公市,0016,570,136,706,41,747,1440,51.88%,39.58%,1
澎湖縣,馬公市,0017,423,111,534,56,590,1215,48.56%,34.81%,1
澎湖縣,馬公市,0018,493,87,580,51,631,1284,49.14%,38.4%,1
澎湖縣,馬公市,0019,562,138,700,51,751,1512,49.67%,37.17%,1
澎湖縣,馬公市,0020,413,94,507,64,571,1181,48.35%,34.97%,1
澎湖縣,馬公市,0021,506,117,623,44,667,1348,49.48%,37.54%,1
澎湖縣,馬公市,0022,557,127,684,29,713,1391,51.26%,40.04%,1
澎湖縣,馬公市,0023,687,221,908,30,938,2124,44.16%,32.34%,1
澎湖縣,馬公市,0024,555,118,673,66,739,1500,49.27%,37%,1
澎湖縣,馬公市,0025,622,118,740,35,775,1582,48.99%,39.32%,1
澎湖縣,馬公市,0026,615,146,761,35,796,1638,48.6%,37.55%,1
澎湖縣,馬公市,0027,614,145,759,47,806,1554,51.87%,39.51%,1
澎湖縣,馬公市,0028,290,59,349,26,375,980,38.27%,29.59%,1
澎湖縣,馬公市,0029,335,81,416,29,445,892,49.89%,37.56%,1
澎湖縣,馬公市,0030,263,44,307,14,321,778,41.26%,33.8%,1
澎湖縣,馬公市,0031,364,70,434,35,469,930,50.43%,39.14%,1
澎湖縣,馬公市,0032,676,137,813,42,855,1481,57.73%,45.64%,1
澎湖縣,馬公市,0033,496,79,575,16,591,1128,52.39%,43.97%,1
澎湖縣,馬公市,0034,159,34,193,23,216,415,52.05%,38.31%,1
澎湖縣,馬公市,0035,441,76,517,40,557,1120,49.73%,39.38%,1
澎湖縣,馬公市,0036,406,86,492,22,514,950,54.11%,42.74%,1
澎湖縣,馬公市,0037,210,45,255,25,280,627,44.66%,33.49%,1
澎湖縣,馬公市,0038,400,87,487,24,511,1055,48.44%,37.91%,1
澎湖縣,馬公市,0039,389,85,474,40,514,989,51.97%,39.33%,1
澎湖縣,馬公市,0040,237,60,297,32,329,591,55.67%,40.1%,1
澎湖縣,馬公市,0041,457,138,595,62,657,1387,47.37%,32.95%,1
澎湖縣,馬公市,0042,323,97,420,52,472,1079,43.74%,29.94%,1
澎湖縣,馬公市,0043,292,64,356,41,397,797,49.81%,36.64%,1
澎湖縣,馬公市,0044,301,56,357,22,379,903,41.97%,33.33%,1
澎湖縣,馬公市,0045,120,32,152,22,174,376,46.28%,31.91%,1
澎湖縣,馬公市,0046,137,37,174,20,194,371,52.29%,36.93%,1
澎湖縣,馬公市,0047,346,77,423,17,440,1173,37.51%,29.5%,1
澎湖縣,馬公市,0048,331,89,420,24,444,1389,31.97%,23.83%,1
澎湖縣,馬公市,0049,117,41,158,55,213,761,27.99%,15.37%,1
澎湖縣,馬公市,0050,122,32,154,22,176,288,61.11%,42.36%,1
澎湖縣,湖西鄉,0051,441,73,514,58,572,1120,51.07%,39.38%,1
澎湖縣,湖西鄉,0052,94,34,128,12,140,332,42.17%,28.31%,1
澎湖縣,湖西鄉,0053,66,18,84,4,88,242,36.36%,27.27%,1
澎湖縣,湖西鄉,0054,71,21,92,7,99,293,33.79%,24.23%,1
澎湖縣,湖西鄉,0055,181,45,226,48,274,666,41.14%,27.18%,1
澎湖縣,湖西鄉,0056,114,23,137,25,162,326,49.69%,34.97%,1
澎湖縣,湖西鄉,0057,211,38,249,16,265,732,36.2%,28.83%,1
澎湖縣,湖西鄉,0058,233,41,274,23,297,651,45.62%,35.79%,1
澎湖縣,湖西鄉,0059,241,53,294,13,307,744,41.26%,32.39%,1
澎湖縣,湖西鄉,0060,53,17,70,4,74,134,55.22%,39.55%,1
澎湖縣,湖西鄉,0061,204,36,240,18,258,794,32.49%,25.69%,1
澎湖縣,湖西鄉,0062,67,10,77,2,79,216,36.57%,31.02%,1
澎湖縣,湖西鄉,0063,145,41,186,7,193,664,29.07%,21.84%,1
澎湖縣,湖西鄉,0064,103,21,124,6,130,279,46.59%,36.92%,1
澎湖縣,湖西鄉,0065,119,19,138,7,145,296,48.99%,40.2%,1
澎湖縣,湖西鄉,0066,102,12,114,4,118,257,45.91%,39.69%,1
澎湖縣,湖西鄉,0067,20,6,26,1,27,89,30.34%,22.47%,1
澎湖縣,湖西鄉,0068,266,88,354,28,382,815,46.87%,32.64%,1
澎湖縣,湖西鄉,0069,303,55,358,20,378,975,38.77%,31.08%,1
澎湖縣,湖西鄉,0070,209,71,280,34,314,648,48.46%,32.25%,1
澎湖縣,湖西鄉,0071,257,71,328,27,355,893,39.75%,28.78%,1
澎湖縣,湖西鄉,0072,268,88,356,82,438,846,51.77%,31.68%,1
澎湖縣,湖西鄉,0073,188,49,237,13,250,729,34.29%,25.79%,1
澎湖縣,白沙鄉,0074,174,64,238,17,255,514,49.61%,33.85%,1
澎湖縣,白沙鄉,0075,254,51,305,22,327,657,49.77%,38.66%,1
澎湖縣,白沙鄉,0076,60,8,68,4,72,109,66.06%,55.05%,1
澎湖縣,白沙鄉,0077,51,9,60,5,65,156,41.67%,32.69%,1
澎湖縣,白沙鄉,0078,86,27,113,7,120,293,40.96%,29.35%,1
澎湖縣,白沙鄉,0079,53,14,67,1,68,231,29.44%,22.94%,1
澎湖縣,白沙鄉,0080,57,19,76,10,86,161,53.42%,35.4%,1
澎湖縣,白沙鄉,0081,568,158,726,56,782,1705,45.87%,33.31%,1
澎湖縣,白沙鄉,0082,89,22,111,10,121,285,42.46%,31.23%,1
澎湖縣,白沙鄉,0083,156,47,203,8,211,723,29.18%,21.58%,1
澎湖縣,白沙鄉,0084,201,54,255,30,285,774,36.82%,25.97%,1
澎湖縣,白沙鄉,0085,276,102,378,108,486,1429,34.01%,19.31%,1
澎湖縣,白沙鄉,0086,360,71,431,67,498,1084,45.94%,33.21%,1
澎湖縣,白沙鄉,0087,100,20,120,5,125,251,49.8%,39.84%,1
澎湖縣,白沙鄉,0088,50,22,72,16,88,253,34.78%,19.76%,1
澎湖縣,西嶼鄉,0089,32,8,40,1,41,283,14.49%,11.31%,1
澎湖縣,西嶼鄉,0090,86,16,102,19,121,424,28.54%,20.28%,1
澎湖縣,西嶼鄉,0091,178,50,228,56,284,826,34.38%,21.55%,1
澎湖縣,西嶼鄉,0092,73,21,94,9,103,282,36.52%,25.89%,1
澎湖縣,西嶼鄉,0093,163,42,205,47,252,661,38.12%,24.66%,1
澎湖縣,西嶼鄉,0094,14,8,22,5,27,141,19.15%,9.93%,1
澎湖縣,西嶼鄉,0095,142,24,166,8,174,635,27.4%,22.36%,1
澎湖縣,西嶼鄉,0096,46,15,61,5,66,216,30.56%,21.3%,1
澎湖縣,西嶼鄉,0097,83,23,106,23,129,572,22.55%,14.51%,1
澎湖縣,西嶼鄉,0098,322,80,402,94,496,1267,39.15%,25.41%,1
澎湖縣,西嶼鄉,0099,228,40,268,28,296,942,31.42%,24.2%,1
澎湖縣,西嶼鄉,0100,274,82,356,72,428,1133,37.78%,24.18%,1
澎湖縣,望安鄉,0101,248,50,298,29,327,734,44.55%,33.79%,1
澎湖縣,望安鄉,0102,144,22,166,24,190,454,41.85%,31.72%,1
澎湖縣,望安鄉,0103,62,19,81,11,92,300,30.67%,20.67%,1
澎湖縣,望安鄉,0104,164,36,200,37,237,471,50.32%,34.82%,1
澎湖縣,望安鄉,0105,158,25,183,19,202,672,30.06%,23.51%,1
澎湖縣,望安鄉,0106,182,71,253,45,298,742,40.16%,24.53%,1
澎湖縣,望安鄉,0107,77,16,93,15,108,264,40.91%,29.17%,1
澎湖縣,望安鄉,0108,130,32,162,7,169,476,35.5%,27.31%,1
澎湖縣,望安鄉,0109,25,11,36,4,40,208,19.23%,12.02%,1
澎湖縣,望安鄉,0110,66,20,86,5,91,307,29.64%,21.5%,1
澎湖縣,七美鄉,0111,48,14,62,5,67,248,27.02%,19.35%,1
澎湖縣,七美鄉,0112,143,29,172,32,204,581,35.11%,24.61%,1
澎湖縣,七美鄉,0113,142,51,193,30,223,641,34.79%,22.15%,1
澎湖縣,七美鄉,0114,85,26,111,2,113,382,29.58%,22.25%,1
澎湖縣,七美鄉,0115,55,11,66,6,72,351,20.51%,15.67%,1
澎湖縣,七美鄉,0116,239,49,288,27,315,1171,26.9%,20.41%,1
金門縣,金城鎮,0001,406,69,475,17,492,1396,35.24%,29.08%,1
金門縣,金城鎮,0002,552,105,657,34,691,1831,37.74%,30.15%,1
金門縣,金城鎮,0003,507,96,603,39,642,1750,36.69%,28.97%,1
金門縣,金城鎮,0004,581,99,680,37,717,1889,37.96%,30.76%,1
金門縣,金城鎮,0005,423,84,507,29,536,1675,32%,25.25%,1
金門縣,金城鎮,0006,638,107,745,35,780,1901,41.03%,33.56%,1
金門縣,金城鎮,0007,409,99,508,48,556,1610,34.53%,25.4%,1
金門縣,金城鎮,0008,487,89,576,26,602,1687,35.68%,28.87%,1
金門縣,金城鎮,0009,481,79,560,20,580,1594,36.39%,30.18%,1
金門縣,金城鎮,0010,520,65,585,13,598,1726,34.65%,30.13%,1
金門縣,金城鎮,0011,530,78,608,21,629,1733,36.3%,30.58%,1
金門縣,金城鎮,0012,504,90,594,28,622,1532,40.6%,32.9%,1
金門縣,金城鎮,0013,569,102,671,46,717,2079,34.49%,27.37%,1
金門縣,金城鎮,0014,541,75,616,34,650,2033,31.97%,26.61%,1
金門縣,金城鎮,0015,731,105,836,46,882,2517,35.04%,29.04%,1
金門縣,金城鎮,0016,594,100,694,32,726,2083,34.85%,28.52%,1
金門縣,金城鎮,0017,598,106,704,31,735,2140,34.35%,27.94%,1
金門縣,金城鎮,0018,583,94,677,31,708,2435,29.08%,23.94%,1
金門縣,金城鎮,0019,253,60,313,32,345,1353,25.5%,18.7%,1
金門縣,金城鎮,0020,422,57,479,18,497,1574,31.58%,26.81%,1
金門縣,金城鎮,0021,396,65,461,17,478,1277,37.43%,31.01%,1
金門縣,金沙鎮,0066,491,109,600,54,654,1909,34.26%,25.72%,1
金門縣,金沙鎮,0067,511,75,586,39,625,1524,41.01%,33.53%,1
金門縣,金沙鎮,0068,432,69,501,43,544,1673,32.52%,25.82%,1
金門縣,金沙鎮,0069,532,80,612,48,660,2003,32.95%,26.56%,1
金門縣,金沙鎮,0070,399,69,468,25,493,1212,40.68%,32.92%,1
金門縣,金沙鎮,0071,312,67,379,31,410,1126,36.41%,27.71%,1
金門縣,金沙鎮,0072,391,61,452,27,479,1540,31.1%,25.39%,1
金門縣,金沙鎮,0073,283,54,337,39,376,1216,30.92%,23.27%,1
金門縣,金沙鎮,0074,205,38,243,15,258,950,27.16%,21.58%,1
金門縣,金沙鎮,0075,595,72,667,34,701,1895,36.99%,31.4%,1
金門縣,金沙鎮,0076,360,76,436,27,463,1135,40.79%,31.72%,1
金門縣,金沙鎮,0077,349,55,404,31,435,1252,34.74%,27.88%,1
金門縣,金沙鎮,0078,401,43,444,18,462,1125,41.07%,35.64%,1
金門縣,金湖鎮,0049,415,92,507,33,540,1348,40.06%,30.79%,1
金門縣,金湖鎮,0050,364,69,433,53,486,1386,35.06%,26.26%,1
金門縣,金湖鎮,0051,497,70,567,37,604,1403,43.05%,35.42%,1
金門縣,金湖鎮,0052,553,92,645,28,673,1771,38%,31.23%,1
金門縣,金湖鎮,0053,418,101,519,39,558,1493,37.37%,28%,1
金門縣,金湖鎮,0054,444,57,501,34,535,1510,35.43%,29.4%,1
金門縣,金湖鎮,0055,509,65,574,38,612,1607,38.08%,31.67%,1
金門縣,金湖鎮,0056,540,85,625,45,670,2006,33.4%,26.92%,1
金門縣,金湖鎮,0057,516,102,618,23,641,1780,36.01%,28.99%,1
金門縣,金湖鎮,0058,533,81,614,21,635,1739,36.52%,30.65%,1
金門縣,金湖鎮,0059,386,67,453,25,478,1384,34.54%,27.89%,1
金門縣,金湖鎮,0060,428,71,499,29,528,1400,37.71%,30.57%,1
金門縣,金湖鎮,0061,468,95,563,22,585,1325,44.15%,35.32%,1
金門縣,金湖鎮,0062,327,56,383,29,412,1236,33.33%,26.46%,1
金門縣,金湖鎮,0063,366,71,437,35,472,1382,34.15%,26.48%,1
金門縣,金湖鎮,0064,459,81,540,20,560,1631,34.33%,28.14%,1
金門縣,金湖鎮,0065,392,69,461,34,495,1514,32.69%,25.89%,1
金門縣,金寧鄉,0022,417,78,495,46,541,1735,31.18%,24.03%,1
金門縣,金寧鄉,0023,374,81,455,29,484,1537,31.49%,24.33%,1
金門縣,金寧鄉,0024,454,98,552,39,591,1766,33.47%,25.71%,1
金門縣,金寧鄉,0025,311,56,367,8,375,1015,36.95%,30.64%,1
金門縣,金寧鄉,0026,486,80,566,48,614,1726,35.57%,28.16%,1
金門縣,金寧鄉,0027,417,82,499,34,533,1691,31.52%,24.66%,1
金門縣,金寧鄉,0028,637,191,828,37,865,2044,42.32%,31.16%,1
金門縣,金寧鄉,0029,653,77,730,34,764,1848,41.34%,35.34%,1
金門縣,金寧鄉,0030,527,77,604,0,604,1735,34.81%,30.37%,1
金門縣,金寧鄉,0031,510,86,596,31,627,1795,34.93%,28.41%,1
金門縣,金寧鄉,0032,467,73,540,42,582,1834,31.73%,25.46%,1
金門縣,金寧鄉,0033,419,67,486,24,510,1528,33.38%,27.42%,1
金門縣,金寧鄉,0034,483,62,545,23,568,1473,38.56%,32.79%,1
金門縣,金寧鄉,0035,490,72,562,38,600,1679,35.74%,29.18%,1
金門縣,金寧鄉,0036,707,196,903,28,931,1921,48.46%,36.8%,1
金門縣,金寧鄉,0037,389,62,451,16,467,1298,35.98%,29.97%,1
金門縣,金寧鄉,0038,410,69,479,26,505,1537,32.86%,26.68%,1
金門縣,烈嶼鄉,0039,630,62,692,30,722,1647,43.84%,38.25%,1
金門縣,烈嶼鄉,0040,511,72,583,34,617,1733,35.6%,29.49%,1
金門縣,烈嶼鄉,0041,500,71,571,33,604,1635,36.94%,30.58%,1
金門縣,烈嶼鄉,0042,355,61,416,24,440,1296,33.95%,27.39%,1
金門縣,烈嶼鄉,0043,284,49,333,22,355,1099,32.3%,25.84%,1
金門縣,烈嶼鄉,0044,409,65,474,22,496,1425,34.81%,28.7%,1
金門縣,烈嶼鄉,0045,425,73,498,27,525,1412,37.18%,30.1%,1
金門縣,烈嶼鄉,0046,432,53,485,20,505,1429,35.34%,30.23%,1
金門縣,烏坵鄉,0047,68,7,75,3,78,275,28.36%,24.73%,1
金門縣,烏坵鄉,0048,70,9,79,8,87,292,29.79%,23.97%,1
連江縣,南竿鄉,0001,859,115,974,39,1013,1967,51.5%,43.67%,1
連江縣,南竿鄉,0002,723,105,828,50,878,1837,47.8%,39.36%,1
連江縣,南竿鄉,0003,491,77,568,20,588,1114,52.78%,44.08%,1
連江縣,南竿鄉,0004,700,70,770,24,794,1543,51.46%,45.37%,1
連江縣,北竿鄉,0005,664,113,777,37,814,1515,53.73%,43.83%,1
連江縣,北竿鄉,0006,250,28,278,10,288,610,47.21%,40.98%,1
連江縣,莒光鄉,0007,279,38,317,18,335,698,47.99%,39.97%,1
連江縣,莒光鄉,0008,365,57,422,22,444,783,56.7%,46.62%,1
連江縣,東引鄉,0009,512,52,564,15,579,1138,50.88%,44.99%,1
基隆市,中正區,0001,180,50,230,16,246,466,52.79%,38.63%,1
基隆市,中正區,0002,390,113,503,19,522,1262,41.36%,30.9%,1
基隆市,中正區,0003,364,128,492,63,555,1171,47.4%,31.08%,1
基隆市,中正區,0004,847,178,1025,28,1053,2823,37.3%,30%,1
基隆市,中正區,0005,430,152,582,46,628,1474,42.61%,29.17%,1
基隆市,中正區,0006,390,101,491,59,550,1271,43.27%,30.68%,1
基隆市,中正區,0007,862,228,1090,70,1160,2707,42.85%,31.84%,1
基隆市,中正區,0008,570,141,711,39,750,1545,48.54%,36.89%,1
基隆市,中正區,0009,223,33,256,15,271,761,35.61%,29.3%,1
基隆市,中正區,0010,509,119,628,13,641,1352,47.41%,37.65%,1
基隆市,中正區,0011,523,103,626,13,639,1413,45.22%,37.01%,1
基隆市,中正區,0012,903,199,1102,41,1143,2665,42.89%,33.88%,1
基隆市,中正區,0013,400,123,523,67,590,1261,46.79%,31.72%,1
基隆市,中正區,0014,595,205,800,71,871,1753,49.69%,33.94%,1
基隆市,中正區,0015,308,96,404,38,442,984,44.92%,31.3%,1
基隆市,中正區,0016,395,82,477,28,505,1166,43.31%,33.88%,1
基隆市,中正區,0017,338,98,436,31,467,973,48%,34.74%,1
基隆市,中正區,0018,460,133,593,22,615,1694,36.3%,27.15%,1
基隆市,中正區,0019,465,137,602,30,632,1270,49.76%,36.61%,1
基隆市,中正區,0020,438,107,545,23,568,1090,52.11%,40.18%,1
基隆市,中正區,0021,339,90,429,18,447,870,51.38%,38.97%,1
基隆市,中正區,0022,426,107,533,38,571,1138,50.18%,37.43%,1
基隆市,中正區,0023,315,80,395,42,437,862,50.7%,36.54%,1
基隆市,中正區,0024,538,133,671,61,732,1341,54.59%,40.12%,1
基隆市,中正區,0025,340,84,424,46,470,859,54.71%,39.58%,1
基隆市,中正區,0026,510,127,637,25,662,1457,45.44%,35%,1
基隆市,中正區,0027,469,119,588,62,650,1594,40.78%,29.42%,1
基隆市,中正區,0028,299,88,387,40,427,802,53.24%,37.28%,1
基隆市,中正區,0029,442,127,569,48,617,1267,48.7%,34.89%,1
基隆市,中正區,0030,429,129,558,61,619,1175,52.68%,36.51%,1
基隆市,中正區,0031,504,122,626,51,677,1210,55.95%,41.65%,1
基隆市,中正區,0032,358,128,486,53,539,1037,51.98%,34.52%,1
基隆市,中正區,0033,462,120,582,52,634,1219,52.01%,37.9%,1
基隆市,中正區,0034,318,99,417,17,434,904,48.01%,35.18%,1
基隆市,中正區,0035,301,104,405,34,439,709,61.92%,42.45%,1
基隆市,七堵區,0219,504,157,661,60,721,1258,57.31%,40.06%,1
基隆市,七堵區,0220,501,143,644,41,685,1237,55.38%,40.5%,1
基隆市,七堵區,0221,511,116,627,17,644,1259,51.15%,40.59%,1
基隆市,七堵區,0222,390,119,509,46,555,1120,49.55%,34.82%,1
基隆市,七堵區,0223,469,116,585,54,639,1344,47.54%,34.9%,1
基隆市,七堵區,0224,451,125,576,41,617,1011,61.03%,44.61%,1
基隆市,七堵區,0225,332,108,440,20,460,925,49.73%,35.89%,1
基隆市,七堵區,0226,723,186,909,61,970,1735,55.91%,41.67%,1
基隆市,七堵區,0227,756,217,973,60,1033,1833,56.36%,41.24%,1
基隆市,七堵區,0228,356,106,462,26,488,938,52.03%,37.95%,1
基隆市,七堵區,0229,417,105,522,50,572,962,59.46%,43.35%,1
基隆市,七堵區,0230,511,104,615,39,654,1191,54.91%,42.91%,1
基隆市,七堵區,0231,412,103,515,48,563,999,56.36%,41.24%,1
基隆市,七堵區,0232,110,20,130,7,137,282,48.58%,39.01%,1
基隆市,七堵區,0233,462,127,589,53,642,1243,51.65%,37.17%,1
基隆市,七堵區,0234,402,115,517,42,559,1092,51.19%,36.81%,1
基隆市,七堵區,0235,481,148,629,40,669,1246,53.69%,38.6%,1
基隆市,七堵區,0236,637,186,823,41,864,1722,50.17%,36.99%,1
基隆市,七堵區,0237,517,128,645,38,683,1318,51.82%,39.23%,1
基隆市,七堵區,0238,348,89,437,18,455,975,46.67%,35.69%,1
基隆市,七堵區,0239,507,138,645,26,671,1285,52.22%,39.46%,1
基隆市,七堵區,0240,369,100,469,48,517,1077,48%,34.26%,1
基隆市,七堵區,0241,333,105,438,30,468,989,47.32%,33.67%,1
基隆市,七堵區,0242,430,124,554,38,592,1193,49.62%,36.04%,1
基隆市,七堵區,0243,454,164,618,45,663,1273,52.08%,35.66%,1
基隆市,七堵區,0244,692,187,879,67,946,1774,53.33%,39.01%,1
基隆市,七堵區,0245,647,185,832,59,891,1689,52.75%,38.31%,1
基隆市,七堵區,0246,506,125,631,61,692,1355,51.07%,37.34%,1
基隆市,七堵區,0247,547,162,709,54,763,1512,50.46%,36.18%,1
基隆市,七堵區,0248,513,157,670,25,695,1486,46.77%,34.52%,1
基隆市,七堵區,0249,656,149,805,31,836,1706,49%,38.45%,1
基隆市,七堵區,0250,557,141,698,53,751,1384,54.26%,40.25%,1
基隆市,七堵區,0251,443,140,583,42,625,1045,59.81%,42.39%,1
基隆市,七堵區,0252,540,154,694,37,731,1374,53.2%,39.3%,1
基隆市,七堵區,0253,163,46,209,9,218,428,50.93%,38.08%,1
基隆市,七堵區,0254,132,40,172,24,196,326,60.12%,40.49%,1
基隆市,七堵區,0255,193,38,231,16,247,351,70.37%,54.99%,1
基隆市,七堵區,0256,688,154,842,33,875,1871,46.77%,36.77%,1
基隆市,七堵區,0257,148,43,191,6,197,448,43.97%,33.04%,1
基隆市,暖暖區,0191,515,133,648,53,701,1431,48.99%,35.99%,1
基隆市,暖暖區,0192,152,42,194,6,200,456,43.86%,33.33%,1
基隆市,暖暖區,0193,246,78,324,28,352,637,55.26%,38.62%,1
基隆市,暖暖區,0194,307,88,395,25,420,735,57.14%,41.77%,1
基隆市,暖暖區,0195,386,93,479,27,506,1078,46.94%,35.81%,1
基隆市,暖暖區,0196,458,132,590,43,633,1238,51.13%,37%,1
基隆市,暖暖區,0197,505,133,638,41,679,1325,51.25%,38.11%,1
基隆市,暖暖區,0198,574,154,728,42,770,1475,52.2%,38.92%,1
基隆市,暖暖區,0199,393,102,495,33,528,1179,44.78%,33.33%,1
基隆市,暖暖區,0200,500,106,606,40,646,1110,58.2%,45.05%,1
基隆市,暖暖區,0201,502,119,621,27,648,1443,44.91%,34.79%,1
基隆市,暖暖區,0202,149,54,203,19,222,415,53.49%,35.9%,1
基隆市,暖暖區,0203,523,112,635,21,656,1378,47.61%,37.95%,1
基隆市,暖暖區,0204,603,179,782,26,808,1570,51.46%,38.41%,1
基隆市,暖暖區,0205,703,186,889,44,933,1603,58.2%,43.86%,1
基隆市,暖暖區,0206,535,142,677,41,718,1267,56.67%,42.23%,1
基隆市,暖暖區,0207,559,122,681,33,714,1359,52.54%,41.13%,1
基隆市,暖暖區,0208,446,94,540,19,559,970,57.63%,45.98%,1
基隆市,暖暖區,0209,426,67,493,22,515,1002,51.4%,42.51%,1
基隆市,暖暖區,0210,346,98,444,24,468,944,49.58%,36.65%,1
基隆市,暖暖區,0211,633,165,798,43,841,1500,56.07%,42.2%,1
基隆市,暖暖區,0212,455,94,549,28,577,1442,40.01%,31.55%,1
基隆市,暖暖區,0213,487,111,598,25,623,1165,53.48%,41.8%,1
基隆市,暖暖區,0214,622,160,782,21,803,1610,49.88%,38.63%,1
基隆市,暖暖區,0215,561,129,690,31,721,1328,54.29%,42.24%,1
基隆市,暖暖區,0216,463,103,566,20,586,1173,49.96%,39.47%,1
基隆市,暖暖區,0217,469,93,562,36,598,1019,58.68%,46.03%,1
基隆市,暖暖區,0218,572,121,693,24,717,1373,52.22%,41.66%,1
基隆市,仁愛區,0072,572,154,726,94,820,1782,46.02%,32.1%,1
基隆市,仁愛區,0073,435,116,551,46,597,1055,56.59%,41.23%,1
基隆市,仁愛區,0074,534,149,683,37,720,1558,46.21%,34.27%,1
基隆市,仁愛區,0075,675,168,843,41,884,1736,50.92%,38.88%,1
基隆市,仁愛區,0076,526,165,691,42,733,1243,58.97%,42.32%,1
基隆市,仁愛區,0077,457,128,585,41,626,1109,56.45%,41.21%,1
基隆市,仁愛區,0078,782,150,932,39,971,1684,57.66%,46.44%,1
基隆市,仁愛區,0079,353,104,457,41,498,919,54.19%,38.41%,1
基隆市,仁愛區,0080,353,117,470,20,490,991,49.45%,35.62%,1
基隆市,仁愛區,0081,346,95,441,18,459,876,52.4%,39.5%,1
基隆市,仁愛區,0082,443,115,558,46,604,1046,57.74%,42.35%,1
基隆市,仁愛區,0083,196,46,242,21,263,434,60.6%,45.16%,1
基隆市,仁愛區,0084,307,80,387,59,446,764,58.38%,40.18%,1
基隆市,仁愛區,0085,359,116,475,21,496,968,51.24%,37.09%,1
基隆市,仁愛區,0086,456,147,603,75,678,1326,51.13%,34.39%,1
基隆市,仁愛區,0087,404,103,507,34,541,1315,41.14%,30.72%,1
基隆市,仁愛區,0088,304,104,408,39,447,775,57.68%,39.23%,1
基隆市,仁愛區,0089,242,81,323,50,373,652,57.21%,37.12%,1
基隆市,仁愛區,0090,275,74,349,27,376,674,55.79%,40.8%,1
基隆市,仁愛區,0091,287,86,373,36,409,789,51.84%,36.38%,1
基隆市,仁愛區,0092,642,193,835,66,901,1715,52.54%,37.43%,1
基隆市,仁愛區,0093,306,105,411,41,452,849,53.24%,36.04%,1
基隆市,仁愛區,0094,362,82,444,25,469,875,53.6%,41.37%,1
基隆市,仁愛區,0095,312,80,392,41,433,851,50.88%,36.66%,1
基隆市,仁愛區,0096,325,75,400,26,426,735,57.96%,44.22%,1
基隆市,仁愛區,0097,360,109,469,65,534,1009,52.92%,35.68%,1
基隆市,仁愛區,0098,374,116,490,38,528,1082,48.8%,34.57%,1
基隆市,仁愛區,0099,465,128,593,69,662,1278,51.8%,36.38%,1
基隆市,仁愛區,0100,701,126,827,48,875,1519,57.6%,46.15%,1
基隆市,仁愛區,0101,432,118,550,44,594,1336,44.46%,32.34%,1
基隆市,仁愛區,0102,493,144,637,62,699,1178,59.34%,41.85%,1
基隆市,仁愛區,0103,247,92,339,43,382,708,53.95%,34.89%,1
基隆市,仁愛區,0104,247,81,328,26,354,567,62.43%,43.56%,1
基隆市,仁愛區,0105,246,106,352,58,410,751,54.59%,32.76%,1
基隆市,仁愛區,0106,244,80,324,29,353,589,59.93%,41.43%,1
基隆市,中山區,0107,303,73,376,21,397,796,49.87%,38.07%,1
基隆市,中山區,0108,478,115,593,44,637,1036,61.49%,46.14%,1
基隆市,中山區,0109,287,104,391,41,432,756,57.14%,37.96%,1
基隆市,中山區,0110,282,105,387,19,406,957,42.42%,29.47%,1
基隆市,中山區,0111,308,87,395,10,405,802,50.5%,38.4%,1
基隆市,中山區,0112,507,125,632,44,676,1263,53.52%,40.14%,1
基隆市,中山區,0113,342,77,419,23,442,778,56.81%,43.96%,1
基隆市,中山區,0114,443,134,577,81,658,1180,55.76%,37.54%,1
基隆市,中山區,0115,343,90,433,29,462,990,46.67%,34.65%,1
基隆市,中山區,0116,404,101,505,36,541,1332,40.62%,30.33%,1
基隆市,中山區,0117,292,78,370,22,392,848,46.23%,34.43%,1
基隆市,中山區,0118,329,85,414,13,427,922,46.31%,35.68%,1
基隆市,中山區,0119,193,67,260,11,271,459,59.04%,42.05%,1
基隆市,中山區,0120,196,56,252,27,279,574,48.61%,34.15%,1
基隆市,中山區,0121,336,81,417,37,454,877,51.77%,38.31%,1
基隆市,中山區,0122,496,175,671,38,709,1584,44.76%,31.31%,1
基隆市,中山區,0123,358,89,447,34,481,1319,36.47%,27.14%,1
基隆市,中山區,0124,715,214,929,57,986,1938,50.88%,36.89%,1
基隆市,中山區,0125,655,195,850,49,899,1877,47.9%,34.9%,1
基隆市,中山區,0126,854,214,1068,37,1105,2088,52.92%,40.9%,1
基隆市,中山區,0127,774,210,984,38,1022,1946,52.52%,39.77%,1
基隆市,中山區,0128,557,154,711,52,763,1353,56.39%,41.17%,1
基隆市,中山區,0129,496,131,627,45,672,1317,51.03%,37.66%,1
基隆市,中山區,0130,337,126,463,33,496,870,57.01%,38.74%,1
基隆市,中山區,0131,582,112,694,26,720,1322,54.46%,44.02%,1
基隆市,中山區,0132,438,129,567,20,587,1295,45.33%,33.82%,1
基隆市,中山區,0133,338,103,441,18,459,756,60.71%,44.71%,1
基隆市,中山區,0134,526,155,681,28,709,1602,44.26%,32.83%,1
基隆市,中山區,0135,552,151,703,42,745,1568,47.51%,35.2%,1
基隆市,中山區,0136,520,179,699,37,736,1404,52.42%,37.04%,1
基隆市,中山區,0137,655,169,824,26,850,1909,44.53%,34.31%,1
基隆市,中山區,0138,534,150,684,79,763,1642,46.47%,32.52%,1
基隆市,中山區,0139,331,80,411,19,430,932,46.14%,35.52%,1
基隆市,中山區,0140,365,105,470,43,513,849,60.42%,42.99%,1
基隆市,中山區,0141,274,105,379,49,428,715,59.86%,38.32%,1
基隆市,安樂區,0142,471,130,601,61,662,1361,48.64%,34.61%,1
基隆市,安樂區,0143,430,113,543,35,578,1213,47.65%,35.45%,1
基隆市,安樂區,0144,334,84,418,34,452,1026,44.05%,32.55%,1
基隆市,安樂區,0145,434,110,544,82,626,1038,60.31%,41.81%,1
基隆市,安樂區,0146,335,123,458,58,516,897,57.53%,37.35%,1
基隆市,安樂區,0147,535,148,683,57,740,1401,52.82%,38.19%,1
基隆市,安樂區,0148,156,48,204,9,213,641,33.23%,24.34%,1
基隆市,安樂區,0149,510,176,686,50,736,1472,50%,34.65%,1
基隆市,安樂區,0150,186,49,235,25,260,472,55.08%,39.41%,1
基隆市,安樂區,0151,352,111,463,28,491,841,58.38%,41.85%,1
基隆市,安樂區,0152,212,64,276,27,303,571,53.06%,37.13%,1
基隆市,安樂區,0153,659,182,841,40,881,1901,46.34%,34.67%,1
基隆市,安樂區,0154,476,177,653,42,695,1349,51.52%,35.29%,1
基隆市,安樂區,0155,453,128,581,41,622,1225,50.78%,36.98%,1
基隆市,安樂區,0156,547,155,702,40,742,1351,54.92%,40.49%,1
基隆市,安樂區,0157,701,170,871,41,912,1601,56.96%,43.79%,1
基隆市,安樂區,0158,1028,218,1246,43,1289,2513,51.29%,40.91%,1
基隆市,安樂區,0159,667,160,827,45,872,1613,54.06%,41.35%,1
基隆市,安樂區,0160,723,167,890,46,936,1731,54.07%,41.77%,1
基隆市,安樂區,0161,623,189,812,29,841,1424,59.06%,43.75%,1
基隆市,安樂區,0162,681,177,858,49,907,1806,50.22%,37.71%,1
基隆市,安樂區,0163,695,183,878,63,941,1679,56.05%,41.39%,1
基隆市,安樂區,0164,751,212,963,43,1006,1902,52.89%,39.48%,1
基隆市,安樂區,0165,795,195,990,38,1028,2040,50.39%,38.97%,1
基隆市,安樂區,0166,526,143,669,45,714,1313,54.38%,40.06%,1
基隆市,安樂區,0167,443,144,587,20,607,1243,48.83%,35.64%,1
基隆市,安樂區,0168,706,152,858,30,888,1759,50.48%,40.14%,1
基隆市,安樂區,0169,324,89,413,24,437,694,62.97%,46.69%,1
基隆市,安樂區,0170,412,112,524,25,549,866,63.39%,47.58%,1
基隆市,安樂區,0171,490,141,631,26,657,1557,42.2%,31.47%,1
基隆市,安樂區,0172,521,161,682,27,709,1411,50.25%,36.92%,1
基隆市,安樂區,0173,699,165,864,25,889,1568,56.7%,44.58%,1
基隆市,安樂區,0174,564,129,693,32,725,1400,51.79%,40.29%,1
基隆市,安樂區,0175,638,121,759,12,771,1531,50.36%,41.67%,1
基隆市,安樂區,0176,627,137,764,26,790,1673,47.22%,37.48%,1
基隆市,安樂區,0177,412,108,520,38,558,1054,52.94%,39.09%,1
基隆市,安樂區,0178,635,143,778,29,807,1923,41.97%,33.02%,1
基隆市,安樂區,0179,769,221,990,56,1046,1960,53.37%,39.23%,1
基隆市,安樂區,0180,741,178,919,61,980,1962,49.95%,37.77%,1
基隆市,安樂區,0181,818,222,1040,55,1095,2117,51.72%,38.64%,1
基隆市,安樂區,0182,692,153,845,26,871,1829,47.62%,37.83%,1
基隆市,安樂區,0183,595,112,707,29,736,1529,48.14%,38.91%,1
基隆市,安樂區,0184,733,176,909,36,945,1869,50.56%,39.22%,1
基隆市,安樂區,0185,519,85,604,15,619,1140,54.3%,45.53%,1
基隆市,安樂區,0186,725,71,796,51,847,1641,51.61%,44.18%,1
基隆市,安樂區,0187,482,142,624,36,660,1279,51.6%,37.69%,1
基隆市,安樂區,0188,556,118,674,22,696,1360,51.18%,40.88%,1
基隆市,安樂區,0189,571,146,717,43,760,1399,54.32%,40.81%,1
基隆市,安樂區,0190,501,106,607,29,636,1251,50.84%,40.05%,1
基隆市,信義區,0036,431,121,552,36,588,1096,53.65%,39.32%,1
基隆市,信義區,0037,560,143,703,34,737,1232,59.82%,45.45%,1
基隆市,信義區,0038,483,126,609,22,631,1184,53.29%,40.79%,1
基隆市,信義區,0039,492,108,600,63,663,1133,58.52%,43.42%,1
基隆市,信義區,0040,496,122,618,38,656,1188,55.22%,41.75%,1
基隆市,信義區,0041,307,84,391,30,421,725,58.07%,42.34%,1
基隆市,信義區,0042,522,156,678,42,720,1524,47.24%,34.25%,1
基隆市,信義區,0043,298,67,365,34,399,736,54.21%,40.49%,1
基隆市,信義區,0044,235,58,293,18,311,611,50.9%,38.46%,1
基隆市,信義區,0045,319,90,409,16,425,951,44.69%,33.54%,1
基隆市,信義區,0046,645,156,801,32,833,1616,51.55%,39.91%,1
基隆市,信義區,0047,640,143,783,32,815,1516,53.76%,42.22%,1
基隆市,信義區,0048,404,103,507,29,536,1049,51.1%,38.51%,1
基隆市,信義區,0049,416,108,524,28,552,1069,51.64%,38.91%,1
基隆市,信義區,0050,317,80,397,23,420,727,57.77%,43.6%,1
基隆市,信義區,0051,435,83,518,23,541,929,58.23%,46.82%,1
基隆市,信義區,0052,514,142,656,34,690,1118,61.72%,45.97%,1
基隆市,信義區,0053,573,138,711,40,751,1339,56.09%,42.79%,1
基隆市,信義區,0054,407,76,483,20,503,999,50.35%,40.74%,1
基隆市,信義區,0055,304,61,365,15,380,764,49.74%,39.79%,1
基隆市,信義區,0056,570,138,708,38,746,1555,47.97%,36.66%,1
基隆市,信義區,0057,778,158,936,30,966,2015,47.94%,38.61%,1
基隆市,信義區,0058,547,127,674,42,716,1268,56.47%,43.14%,1
基隆市,信義區,0059,625,163,788,39,827,1569,52.71%,39.83%,1
基隆市,信義區,0060,723,172,895,58,953,1985,48.01%,36.42%,1
基隆市,信義區,0061,651,126,777,24,801,1476,54.27%,44.11%,1
基隆市,信義區,0062,674,137,811,31,842,1493,56.4%,45.14%,1
基隆市,信義區,0063,600,125,725,26,751,1249,60.13%,48.04%,1
基隆市,信義區,0064,618,144,762,25,787,1559,50.48%,39.64%,1
基隆市,信義區,0065,450,92,542,14,556,1168,47.6%,38.53%,1
基隆市,信義區,0066,684,114,798,26,824,1602,51.44%,42.7%,1
基隆市,信義區,0067,519,123,642,37,679,1485,45.72%,34.95%,1
基隆市,信義區,0068,395,80,475,25,500,1009,49.55%,39.15%,1
基隆市,信義區,0069,679,138,817,47,864,2016,42.86%,33.68%,1
基隆市,信義區,0070,570,119,689,34,723,1764,40.99%,32.31%,1
基隆市,信義區,0071,529,129,658,37,695,1295,53.67%,40.85%,1
新竹市,東區,0001,377,101,478,15,493,1512,32.61%,24.93%,1
新竹市,東區,0002,441,117,558,25,583,953,61.18%,46.27%,1
新竹市,東區,0003,316,81,397,23,420,729,57.61%,43.35%,1
新竹市,東區,0004,244,84,328,24,352,566,62.19%,43.11%,1
新竹市,東區,0005,258,90,348,19,367,640,57.34%,40.31%,1
新竹市,東區,0006,109,43,152,19,171,305,56.07%,35.74%,1
新竹市,東區,0007,231,92,323,15,338,563,60.04%,41.03%,1
新竹市,東區,0008,307,85,392,13,405,741,54.66%,41.43%,1
新竹市,東區,0009,452,126,578,10,588,1041,56.48%,43.42%,1
新竹市,東區,0010,677,161,838,23,861,1615,53.31%,41.92%,1
新竹市,東區,0011,566,138,704,36,740,1287,57.5%,43.98%,1
新竹市,東區,0012,678,183,861,17,878,1554,56.5%,43.63%,1
新竹市,東區,0013,633,154,787,15,802,1388,57.78%,45.61%,1
新竹市,東區,0014,617,183,800,30,830,1419,58.49%,43.48%,1
新竹市,東區,0015,547,156,703,50,753,1355,55.57%,40.37%,1
新竹市,東區,0016,621,169,790,30,820,1490,55.03%,41.68%,1
新竹市,東區,0017,708,169,877,22,899,1615,55.67%,43.84%,1
新竹市,東區,0018,712,197,909,44,953,1672,57%,42.58%,1
新竹市,東區,0019,468,114,582,29,611,1062,57.53%,44.07%,1
新竹市,東區,0020,558,153,711,40,751,1315,57.11%,42.43%,1
新竹市,東區,0021,441,116,557,37,594,1000,59.4%,44.1%,1
新竹市,東區,0022,589,165,754,35,789,1337,59.01%,44.05%,1
新竹市,東區,0023,743,162,905,29,934,1747,53.46%,42.53%,1
新竹市,東區,0024,716,206,922,34,956,1600,59.75%,44.75%,1
新竹市,東區,0025,500,129,629,27,656,1158,56.65%,43.18%,1
新竹市,東區,0026,390,126,516,26,542,828,65.46%,47.1%,1
新竹市,東區,0027,649,180,829,41,870,1573,55.31%,41.26%,1
新竹市,東區,0028,678,170,848,40,888,1550,57.29%,43.74%,1
新竹市,東區,0029,523,174,697,24,721,1317,54.75%,39.71%,1
新竹市,東區,0030,436,168,604,39,643,1040,61.83%,41.92%,1
新竹市,東區,0031,416,108,524,17,541,935,57.86%,44.49%,1
新竹市,東區,0032,456,118,574,21,595,1074,55.4%,42.46%,1
新竹市,東區,0033,533,124,657,35,692,1133,61.08%,47.04%,1
新竹市,東區,0034,571,138,709,49,758,1262,60.06%,45.25%,1
新竹市,東區,0035,516,142,658,20,678,1199,56.55%,43.04%,1
新竹市,東區,0036,563,157,720,30,750,1226,61.17%,45.92%,1
新竹市,東區,0037,655,174,829,47,876,1377,63.62%,47.57%,1
新竹市,東區,0038,475,130,605,25,630,991,63.57%,47.93%,1
新竹市,東區,0039,520,169,689,72,761,1271,59.87%,40.91%,1
新竹市,東區,0040,516,110,626,25,651,1012,64.33%,50.99%,1
新竹市,東區,0041,418,116,534,54,588,1001,58.74%,41.76%,1
新竹市,東區,0042,619,188,807,47,854,1603,53.28%,38.62%,1
新竹市,東區,0043,468,173,641,41,682,1236,55.18%,37.86%,1
新竹市,東區,0044,560,143,703,36,739,1532,48.24%,36.55%,1
新竹市,東區,0045,540,137,677,39,716,1306,54.82%,41.35%,1
新竹市,東區,0046,456,115,571,59,630,1073,58.71%,42.5%,1
新竹市,東區,0047,384,118,502,13,515,952,54.1%,40.34%,1
新竹市,東區,0048,447,132,579,26,605,1298,46.61%,34.44%,1
新竹市,東區,0049,330,67,397,14,411,778,52.83%,42.42%,1
新竹市,東區,0050,500,172,672,34,706,1195,59.08%,41.84%,1
新竹市,東區,0051,620,193,813,54,867,1569,55.26%,39.52%,1
新竹市,東區,0052,737,182,919,39,958,1533,62.49%,48.08%,1
新竹市,東區,0053,633,134,767,45,812,1336,60.78%,47.38%,1
新竹市,東區,0054,663,110,773,38,811,1367,59.33%,48.5%,1
新竹市,東區,0055,621,134,755,31,786,1289,60.98%,48.18%,1
新竹市,東區,0056,392,112,504,23,527,960,54.9%,40.83%,1
新竹市,東區,0057,396,117,513,21,534,843,63.35%,46.98%,1
新竹市,東區,0058,416,113,529,40,569,948,60.02%,43.88%,1
新竹市,東區,0059,410,73,483,30,513,915,56.07%,44.81%,1
新竹市,東區,0060,845,153,998,33,1031,1801,57.25%,46.92%,1
新竹市,東區,0061,478,112,590,23,613,1079,56.81%,44.3%,1
新竹市,東區,0062,340,62,402,11,413,676,61.09%,50.3%,1
新竹市,東區,0063,508,129,637,37,674,1132,59.54%,44.88%,1
新竹市,東區,0064,94,42,136,12,148,251,58.96%,37.45%,1
新竹市,東區,0065,683,193,876,47,923,1620,56.98%,42.16%,1
新竹市,東區,0066,591,176,767,31,798,1479,53.96%,39.96%,1
新竹市,東區,0067,549,175,724,30,754,1402,53.78%,39.16%,1
新竹市,東區,0068,531,158,689,40,729,1280,56.95%,41.48%,1
新竹市,東區,0069,535,169,704,21,725,1228,59.04%,43.57%,1
新竹市,東區,0070,437,177,614,9,623,1157,53.85%,37.77%,1
新竹市,東區,0071,502,247,749,19,768,1354,56.72%,37.08%,1
新竹市,東區,0072,629,209,838,28,866,1334,64.92%,47.15%,1
新竹市,東區,0073,566,129,695,25,720,1234,58.35%,45.87%,1
新竹市,東區,0074,668,169,837,30,867,1398,62.02%,47.78%,1
新竹市,東區,0075,383,154,537,30,567,928,61.1%,41.27%,1
新竹市,東區,0076,675,147,822,23,845,1368,61.77%,49.34%,1
新竹市,東區,0077,467,130,597,20,617,1215,50.78%,38.44%,1
新竹市,東區,0078,389,112,501,31,532,1067,49.86%,36.46%,1
新竹市,東區,0079,464,177,641,15,656,1194,54.94%,38.86%,1
新竹市,東區,0080,482,140,622,18,640,1193,53.65%,40.4%,1
新竹市,東區,0081,581,165,746,59,805,1388,58%,41.86%,1
新竹市,東區,0082,550,155,705,28,733,1267,57.85%,43.41%,1
新竹市,東區,0083,583,122,705,25,730,1299,56.2%,44.88%,1
新竹市,東區,0084,560,148,708,32,740,1288,57.45%,43.48%,1
新竹市,東區,0085,537,188,725,19,744,1228,60.59%,43.73%,1
新竹市,東區,0086,516,161,677,11,688,1135,60.62%,45.46%,1
新竹市,東區,0087,567,194,761,23,784,1237,63.38%,45.84%,1
新竹市,東區,0088,473,99,572,34,606,1135,53.39%,41.67%,1
新竹市,東區,0089,464,103,567,18,585,1165,50.21%,39.83%,1
新竹市,東區,0090,474,124,598,18,616,1124,54.8%,42.17%,1
新竹市,東區,0091,539,130,669,43,712,1210,58.84%,44.55%,1
新竹市,東區,0092,537,140,677,34,711,1323,53.74%,40.59%,1
新竹市,東區,0093,506,104,610,20,630,1207,52.2%,41.92%,1
新竹市,東區,0094,448,144,592,28,620,1264,49.05%,35.44%,1
新竹市,東區,0095,546,136,682,23,705,1248,56.49%,43.75%,1
新竹市,東區,0096,665,158,823,35,858,1400,61.29%,47.5%,1
新竹市,東區,0097,645,200,845,21,866,1473,58.79%,43.79%,1
新竹市,東區,0098,587,147,734,37,771,1367,56.4%,42.94%,1
新竹市,東區,0099,547,132,679,18,697,1233,56.53%,44.36%,1
新竹市,東區,0100,199,56,255,14,269,507,53.06%,39.25%,1
新竹市,東區,0101,294,92,386,33,419,714,58.68%,41.18%,1
新竹市,東區,0102,338,124,462,51,513,875,58.63%,38.63%,1
新竹市,東區,0103,597,152,749,43,792,1396,56.73%,42.77%,1
新竹市,東區,0104,470,143,613,37,650,1232,52.76%,38.15%,1
新竹市,東區,0105,515,162,677,40,717,1323,54.2%,38.93%,1
新竹市,東區,0106,533,121,654,18,672,1516,44.33%,35.16%,1
新竹市,東區,0107,569,134,703,44,747,1453,51.41%,39.16%,1
新竹市,東區,0108,348,130,478,39,517,880,58.75%,39.55%,1
新竹市,東區,0109,448,85,533,27,560,1058,52.93%,42.34%,1
新竹市,東區,0110,426,141,567,30,597,1061,56.27%,40.15%,1
新竹市,東區,0111,273,95,368,33,401,710,56.48%,38.45%,1
新竹市,東區,0112,299,106,405,48,453,752,60.24%,39.76%,1
新竹市,東區,0113,226,56,282,18,300,475,63.16%,47.58%,1
新竹市,東區,0114,329,99,428,36,464,880,52.73%,37.39%,1
新竹市,東區,0115,413,118,531,33,564,989,57.03%,41.76%,1
新竹市,東區,0116,456,119,575,37,612,1059,57.79%,43.06%,1
新竹市,東區,0117,232,96,328,41,369,607,60.79%,38.22%,1
新竹市,東區,0118,341,104,445,29,474,815,58.16%,41.84%,1
新竹市,東區,0119,361,85,446,34,480,777,61.78%,46.46%,1
新竹市,東區,0120,516,129,645,30,675,1399,48.25%,36.88%,1
新竹市,東區,0121,492,147,639,37,676,1216,55.59%,40.46%,1
新竹市,東區,0122,404,115,519,35,554,1062,52.17%,38.04%,1
新竹市,東區,0123,453,121,574,23,597,1046,57.07%,43.31%,1
新竹市,東區,0124,546,119,665,16,681,1332,51.13%,40.99%,1
新竹市,東區,0125,560,170,730,46,776,1350,57.48%,41.48%,1
新竹市,東區,0126,553,154,707,17,724,1438,50.35%,38.46%,1
新竹市,東區,0127,520,156,676,42,718,1414,50.78%,36.78%,1
新竹市,東區,0128,644,164,808,27,835,1476,56.57%,43.63%,1
新竹市,東區,0129,604,171,775,41,816,1326,61.54%,45.55%,1
新竹市,東區,0130,442,120,562,13,575,927,62.03%,47.68%,1
新竹市,東區,0131,525,163,688,20,708,1273,55.62%,41.24%,1
新竹市,東區,0132,503,139,642,44,686,1315,52.17%,38.25%,1
新竹市,東區,0133,604,165,769,23,792,1413,56.05%,42.75%,1
新竹市,東區,0134,473,118,591,20,611,1064,57.42%,44.45%,1
新竹市,東區,0135,577,181,758,23,781,1244,62.78%,46.38%,1
新竹市,東區,0136,466,113,579,8,587,1160,50.6%,40.17%,1
新竹市,東區,0137,525,138,663,17,680,1398,48.64%,37.55%,1
新竹市,東區,0138,439,116,555,14,569,1384,41.11%,31.72%,1
新竹市,東區,0139,400,112,512,27,539,874,61.67%,45.77%,1
新竹市,北區,0140,166,59,225,10,235,477,49.27%,34.8%,1
新竹市,北區,0141,226,73,299,22,321,535,60%,42.24%,1
新竹市,北區,0142,269,123,392,52,444,746,59.52%,36.06%,1
新竹市,北區,0143,211,53,264,15,279,546,51.1%,38.64%,1
新竹市,北區,0144,328,85,413,29,442,711,62.17%,46.13%,1
新竹市,北區,0145,404,128,532,34,566,1143,49.52%,35.35%,1
新竹市,北區,0146,522,152,674,39,713,1370,52.04%,38.1%,1
新竹市,北區,0147,547,171,718,39,757,1390,54.46%,39.35%,1
新竹市,北區,0148,409,104,513,22,535,962,55.61%,42.52%,1
新竹市,北區,0149,508,143,651,14,665,1237,53.76%,41.07%,1
新竹市,北區,0150,591,155,746,42,788,1604,49.13%,36.85%,1
新竹市,北區,0151,274,75,349,12,361,758,47.63%,36.15%,1
新竹市,北區,0152,525,110,635,29,664,1320,50.3%,39.77%,1
新竹市,北區,0153,576,139,715,48,763,1519,50.23%,37.92%,1
新竹市,北區,0154,92,36,128,5,133,347,38.33%,26.51%,1
新竹市,北區,0155,549,129,678,37,715,1212,58.99%,45.3%,1
新竹市,北區,0156,565,158,723,45,768,1484,51.75%,38.07%,1
新竹市,北區,0157,542,180,722,50,772,1428,54.06%,37.96%,1
新竹市,北區,0158,472,130,602,24,626,1128,55.5%,41.84%,1
新竹市,北區,0159,263,69,332,15,347,638,54.39%,41.22%,1
新竹市,北區,0160,579,85,664,42,706,1222,57.77%,47.38%,1
新竹市,北區,0161,459,98,557,22,579,1076,53.81%,42.66%,1
新竹市,北區,0162,455,120,575,22,597,937,63.71%,48.56%,1
新竹市,北區,0163,562,140,702,45,747,1394,53.59%,40.32%,1
新竹市,北區,0164,575,159,734,34,768,1568,48.98%,36.67%,1
新竹市,北區,0165,501,145,646,59,705,1159,60.83%,43.23%,1
新竹市,北區,0166,87,15,102,3,105,252,41.67%,34.52%,1
新竹市,北區,0167,347,93,440,26,466,761,61.24%,45.6%,1
新竹市,北區,0168,323,113,436,32,468,788,59.39%,40.99%,1
新竹市,北區,0169,265,60,325,34,359,561,63.99%,47.24%,1
新竹市,北區,0170,587,153,740,84,824,1558,52.89%,37.68%,1
新竹市,北區,0171,503,144,647,27,674,1398,48.21%,35.98%,1
新竹市,北區,0172,397,103,500,33,533,957,55.69%,41.48%,1
新竹市,北區,0173,523,117,640,43,683,1195,57.15%,43.77%,1
新竹市,北區,0174,443,135,578,31,609,1236,49.27%,35.84%,1
新竹市,北區,0175,458,146,604,48,652,1255,51.95%,36.49%,1
新竹市,北區,0176,467,133,600,23,623,1114,55.92%,41.92%,1
新竹市,北區,0177,566,158,724,26,750,1396,53.72%,40.54%,1
新竹市,北區,0178,585,190,775,61,836,1456,57.42%,40.18%,1
新竹市,北區,0179,575,134,709,30,739,1374,53.78%,41.85%,1
新竹市,北區,0180,439,95,534,39,573,1070,53.55%,41.03%,1
新竹市,北區,0181,455,124,579,60,639,1142,55.95%,39.84%,1
新竹市,北區,0182,431,101,532,23,555,1103,50.32%,39.08%,1
新竹市,北區,0183,453,157,610,67,677,1190,56.89%,38.07%,1
新竹市,北區,0184,535,110,645,26,671,1089,61.62%,49.13%,1
新竹市,北區,0185,454,120,574,16,590,1272,46.38%,35.69%,1
新竹市,北區,0186,531,164,695,47,742,1306,56.81%,40.66%,1
新竹市,北區,0187,560,144,704,41,745,1328,56.1%,42.17%,1
新竹市,北區,0188,585,132,717,31,748,1457,51.34%,40.15%,1
新竹市,北區,0189,578,196,774,56,830,1492,55.63%,38.74%,1
新竹市,北區,0190,515,139,654,49,703,1160,60.6%,44.4%,1
新竹市,北區,0191,399,132,531,40,571,971,58.81%,41.09%,1
新竹市,北區,0192,324,90,414,22,436,1401,31.12%,23.13%,1
新竹市,北區,0193,566,164,730,34,764,1340,57.01%,42.24%,1
新竹市,北區,0194,602,140,742,53,795,1371,57.99%,43.91%,1
新竹市,北區,0195,516,144,660,17,677,1267,53.43%,40.73%,1
新竹市,北區,0196,500,137,637,27,664,1073,61.88%,46.6%,1
新竹市,北區,0197,487,156,643,34,677,1159,58.41%,42.02%,1
新竹市,北區,0198,533,140,673,16,689,1294,53.25%,41.19%,1
新竹市,北區,0199,593,163,756,41,797,1442,55.27%,41.12%,1
新竹市,北區,0200,540,168,708,19,727,1270,57.24%,42.52%,1
新竹市,北區,0201,520,166,686,36,722,1179,61.24%,44.11%,1
新竹市,北區,0202,449,114,563,33,596,949,62.8%,47.31%,1
新竹市,北區,0203,488,147,635,34,669,1163,57.52%,41.96%,1
新竹市,北區,0204,556,134,690,21,711,1334,53.3%,41.68%,1
新竹市,北區,0205,589,165,754,39,793,1415,56.04%,41.63%,1
新竹市,北區,0206,577,176,753,36,789,1305,60.46%,44.21%,1
新竹市,北區,0207,537,114,651,31,682,1200,56.83%,44.75%,1
新竹市,北區,0208,474,116,590,23,613,1106,55.42%,42.86%,1
新竹市,北區,0209,484,121,605,22,627,1044,60.06%,46.36%,1
新竹市,北區,0210,454,139,593,34,627,1061,59.1%,42.79%,1
新竹市,北區,0211,659,171,830,64,894,1518,58.89%,43.41%,1
新竹市,北區,0212,561,158,719,39,758,1220,62.13%,45.98%,1
新竹市,北區,0213,642,179,821,18,839,1475,56.88%,43.53%,1
新竹市,北區,0214,554,149,703,42,745,1373,54.26%,40.35%,1
新竹市,北區,0215,630,169,799,19,818,1450,56.41%,43.45%,1
新竹市,北區,0216,649,148,797,30,827,1423,58.12%,45.61%,1
新竹市,北區,0217,504,84,588,14,602,1059,56.85%,47.59%,1
新竹市,北區,0218,558,93,651,34,685,1130,60.62%,49.38%,1
新竹市,北區,0219,614,110,724,28,752,1208,62.25%,50.83%,1
新竹市,北區,0220,634,104,738,25,763,1226,62.23%,51.71%,1
新竹市,北區,0221,489,145,634,30,664,1175,56.51%,41.62%,1
新竹市,北區,0222,571,156,727,24,751,1371,54.78%,41.65%,1
新竹市,北區,0223,529,142,671,43,714,1306,54.67%,40.51%,1
新竹市,北區,0224,521,150,671,23,694,1340,51.79%,38.88%,1
新竹市,北區,0225,473,154,627,57,684,1111,61.57%,42.57%,1
新竹市,北區,0226,562,157,719,44,763,1197,63.74%,46.95%,1
新竹市,北區,0227,455,84,539,35,574,1008,56.94%,45.14%,1
新竹市,北區,0228,366,113,479,21,500,946,52.85%,38.69%,1
新竹市,北區,0229,306,85,391,31,422,705,59.86%,43.4%,1
新竹市,北區,0230,340,115,455,50,505,848,59.55%,40.09%,1
新竹市,北區,0231,537,122,659,26,685,1295,52.9%,41.47%,1
新竹市,北區,0232,578,119,697,42,739,1467,50.37%,39.4%,1
新竹市,北區,0233,574,136,710,37,747,1659,45.03%,34.6%,1
新竹市,北區,0234,490,141,631,43,674,1297,51.97%,37.78%,1
新竹市,北區,0235,549,171,720,69,789,1374,57.42%,39.96%,1
新竹市,北區,0236,626,151,777,66,843,1457,57.86%,42.96%,1
新竹市,北區,0237,512,94,606,26,632,1072,58.96%,47.76%,1
新竹市,北區,0238,541,134,675,50,725,1350,53.7%,40.07%,1
新竹市,北區,0239,447,123,570,32,602,971,62%,46.04%,1
新竹市,北區,0240,610,172,782,68,850,1450,58.62%,42.07%,1
新竹市,北區,0241,386,89,475,31,506,895,56.54%,43.13%,1
新竹市,北區,0242,599,125,724,32,756,1378,54.86%,43.47%,1
新竹市,北區,0243,583,186,769,70,839,1609,52.14%,36.23%,1
新竹市,北區,0244,247,64,311,35,346,594,58.25%,41.58%,1
新竹市,香山區,0245,578,143,721,56,777,1443,53.85%,40.06%,1
新竹市,香山區,0246,512,133,645,40,685,1241,55.2%,41.26%,1
新竹市,香山區,0247,536,85,621,22,643,1194,53.85%,44.89%,1
新竹市,香山區,0248,475,111,586,11,597,1081,55.23%,43.94%,1
新竹市,香山區,0249,364,72,436,21,457,807,56.63%,45.11%,1
新竹市,香山區,0250,722,183,905,49,954,1760,54.2%,41.02%,1
新竹市,香山區,0251,721,163,884,31,915,1635,55.96%,44.1%,1
新竹市,香山區,0252,644,173,817,37,854,1473,57.98%,43.72%,1
新竹市,香山區,0253,619,150,769,19,788,1408,55.97%,43.96%,1
新竹市,香山區,0254,483,114,597,19,616,1318,46.74%,36.65%,1
新竹市,香山區,0255,564,153,717,34,751,1337,56.17%,42.18%,1
新竹市,香山區,0256,856,170,1026,30,1056,1862,56.71%,45.97%,1
新竹市,香山區,0257,440,127,567,19,586,1067,54.92%,41.24%,1
新竹市,香山區,0258,397,104,501,28,529,863,61.3%,46%,1
新竹市,香山區,0259,518,164,682,54,736,1198,61.44%,43.24%,1
新竹市,香山區,0260,488,156,644,45,689,1138,60.54%,42.88%,1
新竹市,香山區,0261,476,119,595,52,647,957,67.61%,49.74%,1
新竹市,香山區,0262,586,141,727,70,797,1348,59.12%,43.47%,1
新竹市,香山區,0263,509,117,626,55,681,1023,66.57%,49.76%,1
新竹市,香山區,0264,416,103,519,23,542,970,55.88%,42.89%,1
新竹市,香山區,0265,546,157,703,45,748,1318,56.75%,41.43%,1
新竹市,香山區,0266,428,136,564,42,606,1088,55.7%,39.34%,1
新竹市,香山區,0267,339,68,407,22,429,903,47.51%,37.54%,1
新竹市,香山區,0268,405,148,553,34,587,1012,58%,40.02%,1
新竹市,香山區,0269,430,113,543,34,577,1014,56.9%,42.41%,1
新竹市,香山區,0270,534,142,676,24,700,1238,56.54%,43.13%,1
新竹市,香山區,0271,466,125,591,68,659,1182,55.75%,39.42%,1
新竹市,香山區,0272,626,155,781,68,849,1331,63.79%,47.03%,1
新竹市,香山區,0273,474,120,594,23,617,976,63.22%,48.57%,1
新竹市,香山區,0274,358,74,432,15,447,834,53.6%,42.93%,1
新竹市,香山區,0275,406,92,498,31,529,919,57.56%,44.18%,1
新竹市,香山區,0276,511,155,666,34,700,1188,58.92%,43.01%,1
新竹市,香山區,0277,480,104,584,41,625,1086,57.55%,44.2%,1
新竹市,香山區,0278,536,133,669,47,716,1144,62.59%,46.85%,1
新竹市,香山區,0279,516,108,624,33,657,1112,59.08%,46.4%,1
新竹市,香山區,0280,653,155,808,43,851,1476,57.66%,44.24%,1
新竹市,香山區,0281,550,140,690,27,717,1291,55.54%,42.6%,1
新竹市,香山區,0282,696,170,866,39,905,1464,61.82%,47.54%,1
新竹市,香山區,0283,607,135,742,81,823,1427,57.67%,42.54%,1
新竹市,香山區,0284,567,147,714,27,741,1336,55.46%,42.44%,1
新竹市,香山區,0285,387,137,524,35,559,1131,49.43%,34.22%,1
新竹市,香山區,0286,464,122,586,63,649,1070,60.65%,43.36%,1
新竹市,香山區,0287,448,111,559,58,617,1006,61.33%,44.53%,1
新竹市,香山區,0288,442,98,540,21,561,1223,45.87%,36.14%,1
新竹市,香山區,0289,472,109,581,25,606,1119,54.16%,42.18%,1
新竹市,香山區,0290,517,136,653,31,684,1400,48.86%,36.93%,1
新竹市,香山區,0291,579,142,721,30,751,1627,46.16%,35.59%,1
新竹市,香山區,0292,489,120,609,35,644,1289,49.96%,37.94%,1
新竹市,香山區,0293,538,134,672,43,715,1409,50.75%,38.18%,1
新竹市,香山區,0294,301,94,395,20,415,814,50.98%,36.98%,1
新竹市,香山區,0295,301,78,379,21,400,719,55.63%,41.86%,1
新竹市,香山區,0296,383,100,483,17,500,1065,46.95%,35.96%,1
新竹市,香山區,0297,331,68,399,29,428,776,55.15%,42.65%,1
新竹市,香山區,0298,382,98,480,33,513,890,57.64%,42.92%,1
新竹市,香山區,0299,339,89,428,19,447,896,49.89%,37.83%,1
嘉義市,東區,0001,419,121,540,31,571,1025,55.71%,40.88%,1
嘉義市,東區,0002,496,136,632,26,658,1276,51.57%,38.87%,1
嘉義市,東區,0003,348,104,452,43,495,974,50.82%,35.73%,1
嘉義市,東區,0004,522,149,671,47,718,1175,61.11%,44.43%,1
嘉義市,東區,0005,308,89,397,34,431,702,61.4%,43.87%,1
嘉義市,東區,0006,441,108,549,26,575,1092,52.66%,40.38%,1
嘉義市,東區,0007,339,97,436,14,450,1023,43.99%,33.14%,1
嘉義市,東區,0008,696,172,868,67,935,1816,51.49%,38.33%,1
嘉義市,東區,0009,782,214,996,64,1060,1936,54.75%,40.39%,1
嘉義市,東區,0010,704,200,904,26,930,1698,54.77%,41.46%,1
嘉義市,東區,0011,514,151,665,28,693,1221,56.76%,42.1%,1
嘉義市,東區,0012,433,138,571,26,597,1113,53.64%,38.9%,1
嘉義市,東區,0013,593,185,778,43,821,1452,56.54%,40.84%,1
嘉義市,東區,0014,716,90,806,42,848,1395,60.79%,51.33%,1
嘉義市,東區,0015,497,154,651,47,698,1453,48.04%,34.21%,1
嘉義市,東區,0016,432,102,534,19,553,1094,50.55%,39.49%,1
嘉義市,東區,0017,601,146,747,36,783,1420,55.14%,42.32%,1
嘉義市,東區,0018,637,222,859,48,907,1552,58.44%,41.04%,1
嘉義市,東區,0019,631,191,822,63,885,1558,56.8%,40.5%,1
嘉義市,東區,0020,438,140,578,37,615,1062,57.91%,41.24%,1
嘉義市,東區,0021,475,132,607,48,655,1199,54.63%,39.62%,1
嘉義市,東區,0022,523,123,646,27,673,1236,54.45%,42.31%,1
嘉義市,東區,0023,353,90,443,22,465,890,52.25%,39.66%,1
嘉義市,東區,0024,397,99,496,38,534,880,60.68%,45.11%,1
嘉義市,東區,0025,474,137,611,19,630,1189,52.99%,39.87%,1
嘉義市,東區,0026,271,92,363,13,376,669,56.2%,40.51%,1
嘉義市,東區,0027,594,143,737,44,781,1435,54.43%,41.39%,1
嘉義市,東區,0028,596,180,776,37,813,1349,60.27%,44.18%,1
嘉義市,東區,0029,545,186,731,29,760,1455,52.23%,37.46%,1
嘉義市,東區,0030,371,114,485,39,524,915,57.27%,40.55%,1
嘉義市,東區,0031,348,131,479,30,509,952,53.47%,36.55%,1
嘉義市,東區,0032,354,127,481,45,526,941,55.9%,37.62%,1
嘉義市,東區,0033,391,131,522,23,545,1080,50.46%,36.2%,1
嘉義市,東區,0034,395,118,513,24,537,1157,46.41%,34.14%,1
嘉義市,東區,0035,436,140,576,23,599,1053,56.89%,41.41%,1
嘉義市,東區,0036,322,106,428,25,453,967,46.85%,33.3%,1
嘉義市,東區,0037,374,137,511,33,544,1091,49.86%,34.28%,1
嘉義市,東區,0038,402,110,512,53,565,961,58.79%,41.83%,1
嘉義市,東區,0039,246,80,326,28,354,863,41.02%,28.51%,1
嘉義市,東區,0040,440,118,558,54,612,1023,59.82%,43.01%,1
嘉義市,東區,0041,417,147,564,80,644,1078,59.74%,38.68%,1
嘉義市,東區,0042,356,107,463,19,482,938,51.39%,37.95%,1
嘉義市,東區,0043,405,131,536,29,565,1049,53.86%,38.61%,1
嘉義市,東區,0044,483,146,629,75,704,1360,51.76%,35.51%,1
嘉義市,東區,0045,501,192,693,95,788,1615,48.79%,31.02%,1
嘉義市,東區,0046,452,167,619,53,672,1267,53.04%,35.67%,1
嘉義市,東區,0047,522,160,682,71,753,1579,47.69%,33.06%,1
嘉義市,東區,0048,679,188,867,74,941,1831,51.39%,37.08%,1
嘉義市,東區,0049,418,100,518,35,553,977,56.6%,42.78%,1
嘉義市,東區,0050,395,160,555,34,589,1169,50.38%,33.79%,1
嘉義市,東區,0051,506,146,652,85,737,1238,59.53%,40.87%,1
嘉義市,東區,0052,530,127,657,22,679,1266,53.63%,41.86%,1
嘉義市,東區,0053,505,113,618,42,660,1429,46.19%,35.34%,1
嘉義市,東區,0054,540,132,672,23,695,1288,53.96%,41.93%,1
嘉義市,東區,0055,384,120,504,34,538,980,54.9%,39.18%,1
嘉義市,東區,0056,344,98,442,22,464,922,50.33%,37.31%,1
嘉義市,東區,0057,479,129,608,54,662,1133,58.43%,42.28%,1
嘉義市,東區,0058,522,123,645,47,692,1235,56.03%,42.27%,1
嘉義市,東區,0059,612,152,764,21,785,1525,51.48%,40.13%,1
嘉義市,東區,0060,441,115,556,50,606,1170,51.79%,37.69%,1
嘉義市,東區,0061,507,165,672,65,737,1177,62.62%,43.08%,1
嘉義市,東區,0062,494,124,618,55,673,1207,55.76%,40.93%,1
嘉義市,東區,0063,528,145,673,50,723,1272,56.84%,41.51%,1
嘉義市,東區,0064,444,156,600,70,670,1188,56.4%,37.37%,1
嘉義市,東區,0065,423,124,547,29,576,1172,49.15%,36.09%,1
嘉義市,東區,0066,416,141,557,38,595,1020,58.33%,40.78%,1
嘉義市,東區,0067,554,150,704,55,759,1332,56.98%,41.59%,1
嘉義市,東區,0068,427,154,581,39,620,1011,61.33%,42.24%,1
嘉義市,東區,0069,624,176,800,76,876,1682,52.08%,37.1%,1
嘉義市,東區,0070,686,105,791,66,857,1567,54.69%,43.78%,1
嘉義市,東區,0071,510,106,616,21,637,1207,52.78%,42.25%,1
嘉義市,東區,0072,435,101,536,20,556,981,56.68%,44.34%,1
嘉義市,東區,0073,539,138,677,48,725,1395,51.97%,38.64%,1
嘉義市,東區,0074,465,164,629,14,643,1434,44.84%,32.43%,1
嘉義市,東區,0075,451,138,589,25,614,1404,43.73%,32.12%,1
嘉義市,東區,0076,593,142,735,43,778,1428,54.48%,41.53%,1
嘉義市,東區,0077,545,151,696,51,747,1823,40.98%,29.9%,1
嘉義市,東區,0078,547,170,717,39,756,1570,48.15%,34.84%,1
嘉義市,東區,0079,436,146,582,59,641,1282,50%,34.01%,1
嘉義市,東區,0080,718,152,870,58,928,1571,59.07%,45.7%,1
嘉義市,東區,0081,571,155,726,31,757,1533,49.38%,37.25%,1
嘉義市,西區,0082,334,99,433,18,451,885,50.96%,37.74%,1
嘉義市,西區,0083,433,113,546,57,603,1109,54.37%,39.04%,1
嘉義市,西區,0084,320,128,448,42,490,1020,48.04%,31.37%,1
嘉義市,西區,0085,437,96,533,44,577,925,62.38%,47.24%,1
嘉義市,西區,0086,486,190,676,34,710,1671,42.49%,29.08%,1
嘉義市,西區,0087,471,143,614,29,643,1215,52.92%,38.77%,1
嘉義市,西區,0088,379,120,499,22,521,1036,50.29%,36.58%,1
嘉義市,西區,0089,389,137,526,32,558,1129,49.42%,34.46%,1
嘉義市,西區,0090,397,142,539,28,567,1127,50.31%,35.23%,1
嘉義市,西區,0091,507,188,695,42,737,1415,52.08%,35.83%,1
嘉義市,西區,0092,501,152,653,26,679,1366,49.71%,36.68%,1
嘉義市,西區,0093,439,141,580,61,641,1053,60.87%,41.69%,1
嘉義市,西區,0094,435,95,530,24,554,1067,51.92%,40.77%,1
嘉義市,西區,0095,514,154,668,31,699,1575,44.38%,32.63%,1
嘉義市,西區,0096,706,215,921,47,968,1865,51.9%,37.86%,1
嘉義市,西區,0097,446,98,544,45,589,1196,49.25%,37.29%,1
嘉義市,西區,0098,449,118,567,24,591,1280,46.17%,35.08%,1
嘉義市,西區,0099,651,158,809,66,875,1629,53.71%,39.96%,1
嘉義市,西區,0100,558,170,728,75,803,1393,57.65%,40.06%,1
嘉義市,西區,0101,452,138,590,35,625,1077,58.03%,41.97%,1
嘉義市,西區,0102,604,157,761,36,797,1694,47.05%,35.66%,1
嘉義市,西區,0103,343,102,445,80,525,841,62.43%,40.78%,1
嘉義市,西區,0104,425,126,551,6,557,1183,47.08%,35.93%,1
嘉義市,西區,0105,451,115,566,31,597,1000,59.7%,45.1%,1
嘉義市,西區,0106,469,131,600,24,624,1095,56.99%,42.83%,1
嘉義市,西區,0107,534,157,691,35,726,1256,57.8%,42.52%,1
嘉義市,西區,0108,407,100,507,52,559,962,58.11%,42.31%,1
嘉義市,西區,0109,384,129,513,20,533,865,61.62%,44.39%,1
嘉義市,西區,0110,509,146,655,65,720,1396,51.58%,36.46%,1
嘉義市,西區,0111,733,173,906,68,974,1799,54.14%,40.74%,1
嘉義市,西區,0112,544,145,689,37,726,1505,48.24%,36.15%,1
嘉義市,西區,0113,657,162,819,65,884,1698,52.06%,38.69%,1
嘉義市,西區,0114,738,184,922,20,942,1854,50.81%,39.81%,1
嘉義市,西區,0115,522,129,651,14,665,1537,43.27%,33.96%,1
嘉義市,西區,0116,629,103,732,89,821,1604,51.18%,39.21%,1
嘉義市,西區,0117,431,102,533,61,594,944,62.92%,45.66%,1
嘉義市,西區,0118,657,187,844,83,927,1627,56.98%,40.38%,1
嘉義市,西區,0119,490,131,621,52,673,1144,58.83%,42.83%,1
嘉義市,西區,0120,536,154,690,50,740,1362,54.33%,39.35%,1
嘉義市,西區,0121,515,143,658,39,697,1279,54.5%,40.27%,1
嘉義市,西區,0122,681,194,875,70,945,1702,55.52%,40.01%,1
嘉義市,西區,0123,589,153,742,54,796,1358,58.62%,43.37%,1
嘉義市,西區,0124,601,164,765,66,831,1360,61.1%,44.19%,1
嘉義市,西區,0125,637,195,832,64,896,1589,56.39%,40.09%,1
嘉義市,西區,0126,576,140,716,43,759,1280,59.3%,45%,1
嘉義市,西區,0127,435,120,555,30,585,1220,47.95%,35.66%,1
嘉義市,西區,0128,513,123,636,28,664,1172,56.66%,43.77%,1
嘉義市,西區,0129,563,123,686,45,731,1320,55.38%,42.65%,1
嘉義市,西區,0130,576,138,714,35,749,1185,63.21%,48.61%,1
嘉義市,西區,0131,519,186,705,60,765,1278,59.86%,40.61%,1
嘉義市,西區,0132,464,128,592,28,620,1394,44.48%,33.29%,1
嘉義市,西區,0133,650,167,817,59,876,1540,56.88%,42.21%,1
嘉義市,西區,0134,638,157,795,73,868,1548,56.07%,41.21%,1
嘉義市,西區,0135,523,123,646,37,683,1295,52.74%,40.39%,1
嘉義市,西區,0136,594,155,749,48,797,1318,60.47%,45.07%,1
嘉義市,西區,0137,634,160,794,59,853,1545,55.21%,41.04%,1
嘉義市,西區,0138,271,58,329,24,353,736,47.96%,36.82%,1
嘉義市,西區,0139,440,122,562,19,581,1168,49.74%,37.67%,1
嘉義市,西區,0140,338,104,442,32,474,756,62.7%,44.71%,1
嘉義市,西區,0141,397,60,457,15,472,869,54.32%,45.68%,1
嘉義市,西區,0142,412,118,530,48,578,983,58.8%,41.91%,1
嘉義市,西區,0143,336,88,424,45,469,828,56.64%,40.58%,1
嘉義市,西區,0144,797,141,938,40,978,1775,55.1%,44.9%,1
嘉義市,西區,0145,607,115,722,41,763,1419,53.77%,42.78%,1
嘉義市,西區,0146,288,90,378,13,391,779,50.19%,36.97%,1
嘉義市,西區,0147,314,77,391,17,408,855,47.72%,36.73%,1
嘉義市,西區,0148,479,117,596,77,673,1146,58.73%,41.8%,1
嘉義市,西區,0149,440,144,584,32,616,1111,55.45%,39.6%,1
嘉義市,西區,0150,342,102,444,48,492,767,64.15%,44.59%,1
嘉義市,西區,0151,285,73,358,26,384,817,47%,34.88%,1
嘉義市,西區,0152,291,96,387,60,447,770,58.05%,37.79%,1
嘉義市,西區,0153,346,109,455,26,481,1135,42.38%,30.48%,1
嘉義市,西區,0154,282,87,369,86,455,835,54.49%,33.77%,1
嘉義市,西區,0155,406,108,514,43,557,1182,47.12%,34.35%,1
嘉義市,西區,0156,284,115,399,39,438,944,46.4%,30.08%,1
嘉義市,西區,0157,358,103,461,35,496,997,49.75%,35.91%,1
嘉義市,西區,0158,395,128,523,32,555,1074,51.68%,36.78%,1
嘉義市,西區,0159,450,149,599,24,623,1460,42.67%,30.82%,1
嘉義市,西區,0160,508,136,644,33,677,1352,50.07%,37.57%,1
嘉義市,西區,0161,572,180,752,51,803,1499,53.57%,38.16%,1
嘉義市,西區,0162,451,145,596,103,699,1262,55.39%,35.74%,1
嘉義市,西區,0163,483,150,633,30,663,1299,51.04%,37.18%,1
嘉義市,西區,0164,583,190,773,61,834,1734,48.1%,33.62%,1
嘉義市,西區,0165,622,129,751,34,785,1674,46.89%,37.16%,1
嘉義市,西區,0166,580,153,733,30,763,1540,49.55%,37.66%,1
嘉義市,西區,0167,447,122,569,27,596,1056,56.44%,42.33%,1
嘉義市,西區,0168,555,192,747,105,852,1467,58.08%,37.83%,1
嘉義市,西區,0169,520,157,677,67,744,1431,51.99%,36.34%,1
嘉義市,西區,0170,558,138,696,74,770,1234,62.4%,45.22%,1
嘉義市,西區,0171,475,133,608,33,641,1266,50.63%,37.52%,1
嘉義市,西區,0172,490,137,627,34,661,1211,54.58%,40.46%,1
嘉義市,西區,0173,469,141,610,25,635,1121,56.65%,41.84%,1
嘉義市,西區,0174,384,119,503,21,524,1155,45.37%,33.25%,1
嘉義市,西區,0175,587,208,795,124,919,1546,59.44%,37.97%,1
嘉義市,西區,0176,482,138,620,30,650,1322,49.17%,36.46%,1
嘉義市,西區,0177,619,177,796,89,885,1549,57.13%,39.96%,1
