縣市,鄉鎮市區,開票所,同意票,不同意票,有效票,無效票,投票數,投票權人數,投票率,投票權人數百分比,總數
臺北市,松山區,0527,521,354,875,60,935,1583,59.07%,32.91%,1
臺北市,松山區,0528,547,349,896,86,982,1691,58.07%,32.35%,1
臺北市,松山區,0529,452,287,739,55,794,1386,57.29%,32.61%,1
臺北市,松山區,0530,444,324,768,58,826,1362,60.65%,32.6%,1
臺北市,松山區,0531,462,328,790,53,843,1399,60.26%,33.02%,1
臺北市,松山區,0532,393,334,727,85,812,1324,61.33%,29.68%,1
臺北市,松山區,0533,429,325,754,77,831,1296,64.12%,33.1%,1
臺北市,松山區,0534,459,335,794,60,854,1386,61.62%,33.12%,1
臺北市,松山區,0535,507,385,892,89,981,1529,64.16%,33.16%,1
臺北市,松山區,0536,496,279,775,46,821,1416,57.98%,35.03%,1
臺北市,松山區,0537,513,324,837,68,905,1619,55.9%,31.69%,1
臺北市,松山區,0538,432,356,788,57,845,1386,60.97%,31.17%,1
臺北市,松山區,0539,507,329,836,50,886,1380,64.2%,36.74%,1
臺北市,松山區,0540,424,346,770,56,826,1357,60.87%,31.25%,1
臺北市,松山區,0541,464,303,767,53,820,1296,63.27%,35.8%,1
臺北市,松山區,0542,558,348,906,79,985,1632,60.36%,34.19%,1
臺北市,松山區,0543,442,332,774,52,826,1414,58.42%,31.26%,1
臺北市,松山區,0544,343,447,790,52,842,1404,59.97%,24.43%,1
臺北市,松山區,0545,460,320,780,73,853,1365,62.49%,33.7%,1
臺北市,松山區,0546,456,337,793,71,864,1431,60.38%,31.87%,1
臺北市,松山區,0547,474,367,841,64,905,1483,61.02%,31.96%,1
臺北市,松山區,0548,433,320,753,60,813,1293,62.88%,33.49%,1
臺北市,松山區,0549,486,271,757,58,815,1410,57.8%,34.47%,1
臺北市,松山區,0550,473,270,743,50,793,1307,60.67%,36.19%,1
臺北市,松山區,0551,399,341,740,54,794,1242,63.93%,32.13%,1
臺北市,松山區,0552,405,292,697,38,735,1192,61.66%,33.98%,1
臺北市,松山區,0553,416,321,737,64,801,1276,62.77%,32.6%,1
臺北市,松山區,0554,392,274,666,38,704,1201,58.62%,32.64%,1
臺北市,松山區,0555,448,304,752,39,791,1318,60.02%,33.99%,1
臺北市,松山區,0556,388,268,656,42,698,1157,60.33%,33.54%,1
臺北市,松山區,0557,371,266,637,28,665,1157,57.48%,32.07%,1
臺北市,松山區,0558,461,314,775,58,833,1357,61.39%,33.97%,1
臺北市,松山區,0559,372,231,603,45,648,1215,53.33%,30.62%,1
臺北市,松山區,0560,469,280,749,41,790,1345,58.74%,34.87%,1
臺北市,松山區,0561,378,294,672,77,749,1237,60.55%,30.56%,1
臺北市,松山區,0562,544,288,832,34,866,1393,62.17%,39.05%,1
臺北市,松山區,0563,455,352,807,56,863,1331,64.84%,34.18%,1
臺北市,松山區,0564,554,354,908,57,965,1550,62.26%,35.74%,1
臺北市,松山區,0565,493,209,702,41,743,1308,56.8%,37.69%,1
臺北市,松山區,0566,548,287,835,43,878,1490,58.93%,36.78%,1
臺北市,松山區,0567,540,314,854,39,893,1406,63.51%,38.41%,1
臺北市,松山區,0568,392,334,726,43,769,1191,64.57%,32.91%,1
臺北市,松山區,0569,365,247,612,53,665,1095,60.73%,33.33%,1
臺北市,松山區,0570,372,281,653,58,711,1198,59.35%,31.05%,1
臺北市,松山區,0571,413,274,687,60,747,1265,59.05%,32.65%,1
臺北市,松山區,0572,396,274,670,47,717,1225,58.53%,32.33%,1
臺北市,松山區,0573,570,416,986,69,1055,1698,62.13%,33.57%,1
臺北市,松山區,0574,634,347,981,59,1040,1819,57.17%,34.85%,1
臺北市,松山區,0575,577,404,981,79,1060,1754,60.43%,32.9%,1
臺北市,松山區,0576,412,388,800,50,850,1361,62.45%,30.27%,1
臺北市,松山區,0577,430,289,719,25,744,1189,62.57%,36.16%,1
臺北市,松山區,0578,390,301,691,56,747,1214,61.53%,32.13%,1
臺北市,松山區,0579,402,300,702,64,766,1284,59.66%,31.31%,1
臺北市,松山區,0580,439,313,752,53,805,1297,62.07%,33.85%,1
臺北市,松山區,0581,413,307,720,54,774,1330,58.2%,31.05%,1
臺北市,松山區,0582,487,313,800,95,895,1396,64.11%,34.89%,1
臺北市,松山區,0583,491,301,792,45,837,1480,56.55%,33.18%,1
臺北市,松山區,0584,496,319,815,48,863,1419,60.82%,34.95%,1
臺北市,松山區,0585,441,334,775,71,846,1390,60.86%,31.73%,1
臺北市,松山區,0586,481,379,860,57,917,1525,60.13%,31.54%,1
臺北市,松山區,0587,491,354,845,54,899,1633,55.05%,30.07%,1
臺北市,松山區,0588,481,358,839,58,897,2677,33.51%,17.97%,1
臺北市,松山區,0589,374,342,716,57,773,1281,60.34%,29.2%,1
臺北市,松山區,0590,354,301,655,69,724,1469,49.29%,24.1%,1
臺北市,松山區,0591,492,387,879,86,965,1700,56.76%,28.94%,1
臺北市,松山區,0592,423,348,771,53,824,1503,54.82%,28.14%,1
臺北市,松山區,0593,406,294,700,40,740,1309,56.53%,31.02%,1
臺北市,松山區,0594,447,302,749,87,836,1376,60.76%,32.49%,1
臺北市,松山區,0595,529,375,904,49,953,1654,57.62%,31.98%,1
臺北市,松山區,0596,452,380,832,76,908,1601,56.71%,28.23%,1
臺北市,松山區,0597,531,297,828,56,884,1496,59.09%,35.49%,1
臺北市,松山區,0598,548,379,927,85,1012,1598,63.33%,34.29%,1
臺北市,松山區,0599,609,383,992,62,1054,1751,60.19%,34.78%,1
臺北市,松山區,0600,658,267,925,48,973,1557,62.49%,42.26%,1
臺北市,松山區,0601,701,337,1038,51,1089,1686,64.59%,41.58%,1
臺北市,松山區,0602,702,278,980,71,1051,1707,61.57%,41.12%,1
臺北市,松山區,0603,755,383,1138,57,1195,1854,64.46%,40.72%,1
臺北市,松山區,0604,617,311,928,49,977,1740,56.15%,35.46%,1
臺北市,松山區,0605,482,319,801,85,886,1494,59.3%,32.26%,1
臺北市,松山區,0606,491,328,819,55,874,1453,60.15%,33.79%,1
臺北市,松山區,0607,493,339,832,40,872,1458,59.81%,33.81%,1
臺北市,松山區,0608,520,337,857,41,898,1536,58.46%,33.85%,1
臺北市,松山區,0609,497,343,840,45,885,1463,60.49%,33.97%,1
臺北市,松山區,0610,523,388,911,45,956,1790,53.41%,29.22%,1
臺北市,松山區,0611,536,415,951,66,1017,1679,60.57%,31.92%,1
臺北市,松山區,0612,484,378,862,82,944,1785,52.89%,27.11%,1
臺北市,松山區,0613,547,394,941,71,1012,1793,56.44%,30.51%,1
臺北市,松山區,0614,520,238,758,62,820,1381,59.38%,37.65%,1
臺北市,松山區,0615,418,298,716,59,775,1279,60.59%,32.68%,1
臺北市,松山區,0616,537,375,912,96,1008,1681,59.96%,31.95%,1
臺北市,松山區,0617,441,280,721,60,781,1232,63.39%,35.8%,1
臺北市,松山區,0618,476,356,832,56,888,1533,57.93%,31.05%,1
臺北市,松山區,0619,496,389,885,64,949,1540,61.62%,32.21%,1
臺北市,松山區,0620,511,394,905,61,966,1716,56.29%,29.78%,1
臺北市,松山區,0621,628,235,863,61,924,1664,55.53%,37.74%,1
臺北市,松山區,0622,430,316,746,33,779,1350,57.7%,31.85%,1
臺北市,松山區,0623,575,423,998,53,1051,1837,57.21%,31.3%,1
臺北市,松山區,0624,431,330,761,91,852,1558,54.69%,27.66%,1
臺北市,松山區,0625,466,338,804,68,872,1420,61.41%,32.82%,1
臺北市,松山區,0626,454,340,794,56,850,1474,57.67%,30.8%,1
臺北市,松山區,0627,499,341,840,74,914,1591,57.45%,31.36%,1
臺北市,松山區,0628,548,384,932,68,1000,1726,57.94%,31.75%,1
臺北市,松山區,0629,435,363,798,54,852,1452,58.68%,29.96%,1
臺北市,松山區,0630,422,351,773,54,827,1482,55.8%,28.48%,1
臺北市,松山區,0631,447,362,809,64,873,1460,59.79%,30.62%,1
臺北市,松山區,0632,430,316,746,63,809,1398,57.87%,30.76%,1
臺北市,松山區,0633,454,335,789,67,856,1423,60.15%,31.9%,1
臺北市,松山區,0634,390,301,691,42,733,1226,59.79%,31.81%,1
臺北市,松山區,0635,360,290,650,54,704,1158,60.79%,31.09%,1
臺北市,松山區,0636,451,318,769,54,823,1426,57.71%,31.63%,1
臺北市,松山區,0637,401,127,528,31,559,1177,47.49%,34.07%,1
臺北市,松山區,0638,449,302,751,52,803,1363,58.91%,32.94%,1
臺北市,松山區,0639,429,281,710,60,770,1240,62.1%,34.6%,1
臺北市,松山區,0640,433,362,795,66,861,1375,62.62%,31.49%,1
臺北市,松山區,0641,439,323,762,63,825,1377,59.91%,31.88%,1
臺北市,松山區,0642,371,269,640,43,683,1225,55.76%,30.29%,1
臺北市,松山區,0643,307,291,598,49,647,1017,63.62%,30.19%,1
臺北市,信義區,0644,498,275,773,34,807,2476,32.59%,20.11%,1
臺北市,信義區,0645,565,280,845,28,873,1381,63.22%,40.91%,1
臺北市,信義區,0646,497,272,769,52,821,1294,63.45%,38.41%,1
臺北市,信義區,0647,455,300,755,44,799,1351,59.14%,33.68%,1
臺北市,信義區,0648,449,268,717,52,769,1296,59.34%,34.65%,1
臺北市,信義區,0649,466,300,766,51,817,1302,62.75%,35.79%,1
臺北市,信義區,0650,304,209,513,72,585,1025,57.07%,29.66%,1
臺北市,信義區,0651,460,294,754,32,786,1421,55.31%,32.37%,1
臺北市,信義區,0652,496,310,806,50,856,1501,57.03%,33.04%,1
臺北市,信義區,0653,449,318,767,45,812,1575,51.56%,28.51%,1
臺北市,信義區,0654,506,343,849,31,880,1516,58.05%,33.38%,1
臺北市,信義區,0655,475,316,791,39,830,1382,60.06%,34.37%,1
臺北市,信義區,0656,360,246,606,53,659,1128,58.42%,31.91%,1
臺北市,信義區,0657,440,288,728,70,798,1397,57.12%,31.5%,1
臺北市,信義區,0658,375,295,670,66,736,1161,63.39%,32.3%,1
臺北市,信義區,0659,447,302,749,52,801,1368,58.55%,32.68%,1
臺北市,信義區,0660,350,247,597,33,630,1049,60.06%,33.37%,1
臺北市,信義區,0661,415,303,718,53,771,1308,58.94%,31.73%,1
臺北市,信義區,0662,370,296,666,61,727,1154,63%,32.06%,1
臺北市,信義區,0663,366,272,638,28,666,1078,61.78%,33.95%,1
臺北市,信義區,0664,459,298,757,56,813,1375,59.13%,33.38%,1
臺北市,信義區,0665,485,323,808,53,861,1448,59.46%,33.49%,1
臺北市,信義區,0666,445,279,724,31,755,1250,60.4%,35.6%,1
臺北市,信義區,0667,453,332,785,43,828,1381,59.96%,32.8%,1
臺北市,信義區,0668,403,293,696,57,753,1213,62.08%,33.22%,1
臺北市,信義區,0669,448,377,825,52,877,1373,63.87%,32.63%,1
臺北市,信義區,0670,406,294,700,51,751,1226,61.26%,33.12%,1
臺北市,信義區,0671,355,278,633,35,668,1117,59.8%,31.78%,1
臺北市,信義區,0672,380,269,649,53,702,1123,62.51%,33.84%,1
臺北市,信義區,0673,408,282,690,39,729,1200,60.75%,34%,1
臺北市,信義區,0674,387,289,676,37,713,1335,53.41%,28.99%,1
臺北市,信義區,0675,413,278,691,37,728,1332,54.65%,31.01%,1
臺北市,信義區,0676,535,363,898,83,981,1648,59.53%,32.46%,1
臺北市,信義區,0677,465,342,807,72,879,1542,57%,30.16%,1
臺北市,信義區,0678,377,283,660,78,738,1228,60.1%,30.7%,1
臺北市,信義區,0679,494,416,910,71,981,1731,56.67%,28.54%,1
臺北市,信義區,0680,447,344,791,44,835,1403,59.52%,31.86%,1
臺北市,信義區,0681,578,394,972,94,1066,1929,55.26%,29.96%,1
臺北市,信義區,0682,433,300,733,65,798,1300,61.38%,33.31%,1
臺北市,信義區,0683,462,298,760,38,798,1486,53.7%,31.09%,1
臺北市,信義區,0684,394,313,707,79,786,1532,51.31%,25.72%,1
臺北市,信義區,0685,461,349,810,58,868,1387,62.58%,33.24%,1
臺北市,信義區,0686,376,215,591,62,653,1195,54.64%,31.46%,1
臺北市,信義區,0687,330,212,542,61,603,1068,56.46%,30.9%,1
臺北市,信義區,0688,349,277,626,57,683,1273,53.65%,27.42%,1
臺北市,信義區,0689,425,322,747,86,833,1329,62.68%,31.98%,1
臺北市,信義區,0690,381,296,677,47,724,1311,55.23%,29.06%,1
臺北市,信義區,0691,362,274,636,67,703,1258,55.88%,28.78%,1
臺北市,信義區,0692,390,296,686,88,774,1277,60.61%,30.54%,1
臺北市,信義區,0693,435,311,746,67,813,1285,63.27%,33.85%,1
臺北市,信義區,0694,369,312,681,64,745,1161,64.17%,31.78%,1
臺北市,信義區,0695,405,292,697,55,752,1299,57.89%,31.18%,1
臺北市,信義區,0696,407,259,666,54,720,1243,57.92%,32.74%,1
臺北市,信義區,0697,389,259,648,44,692,1197,57.81%,32.5%,1
臺北市,信義區,0698,443,306,749,31,780,1224,63.73%,36.19%,1
臺北市,信義區,0699,330,250,580,54,634,1147,55.27%,28.77%,1
臺北市,信義區,0700,329,257,586,30,616,1045,58.95%,31.48%,1
臺北市,信義區,0701,395,253,648,56,704,1096,64.23%,36.04%,1
臺北市,信義區,0702,355,254,609,29,638,1115,57.22%,31.84%,1
臺北市,信義區,0703,339,231,570,73,643,1117,57.56%,30.35%,1
臺北市,信義區,0704,294,206,500,35,535,1019,52.5%,28.85%,1
臺北市,信義區,0705,441,283,724,72,796,1346,59.14%,32.76%,1
臺北市,信義區,0706,456,290,746,50,796,1405,56.65%,32.46%,1
臺北市,信義區,0707,464,271,735,58,793,1356,58.48%,34.22%,1
臺北市,信義區,0708,455,322,777,27,804,1250,64.32%,36.4%,1
臺北市,信義區,0709,421,287,708,60,768,1254,61.24%,33.57%,1
臺北市,信義區,0710,434,282,716,46,762,1317,57.86%,32.95%,1
臺北市,信義區,0711,460,290,750,55,805,1271,63.34%,36.19%,1
臺北市,信義區,0712,286,229,515,40,555,979,56.69%,29.21%,1
臺北市,信義區,0713,306,220,526,42,568,1025,55.41%,29.85%,1
臺北市,信義區,0714,427,278,705,49,754,1512,49.87%,28.24%,1
臺北市,信義區,0715,475,361,836,51,887,1483,59.81%,32.03%,1
臺北市,信義區,0716,458,325,783,51,834,1359,61.37%,33.7%,1
臺北市,信義區,0717,491,309,800,35,835,1387,60.2%,35.4%,1
臺北市,信義區,0718,416,343,759,36,795,1455,54.64%,28.59%,1
臺北市,信義區,0719,461,354,815,34,849,1461,58.11%,31.55%,1
臺北市,信義區,0720,513,347,860,58,918,1532,59.92%,33.49%,1
臺北市,信義區,0721,350,269,619,53,672,1043,64.43%,33.56%,1
臺北市,信義區,0722,282,220,502,54,556,875,63.54%,32.23%,1
臺北市,信義區,0723,282,203,485,42,527,927,56.85%,30.42%,1
臺北市,信義區,0724,352,254,606,80,686,1119,61.3%,31.46%,1
臺北市,信義區,0725,425,362,787,76,863,1463,58.99%,29.05%,1
臺北市,信義區,0726,424,337,761,58,819,1293,63.34%,32.79%,1
臺北市,信義區,0727,475,335,810,65,875,1553,56.34%,30.59%,1
臺北市,信義區,0728,425,317,742,43,785,1360,57.72%,31.25%,1
臺北市,信義區,0729,447,322,769,58,827,1392,59.41%,32.11%,1
臺北市,信義區,0730,436,322,758,32,790,1377,57.37%,31.66%,1
臺北市,信義區,0731,451,312,763,29,792,1377,57.52%,32.75%,1
臺北市,信義區,0732,360,284,644,40,684,1269,53.9%,28.37%,1
臺北市,信義區,0733,455,286,741,105,846,1407,60.13%,32.34%,1
臺北市,信義區,0734,358,279,637,48,685,1172,58.45%,30.55%,1
臺北市,信義區,0735,365,278,643,38,681,1182,57.61%,30.88%,1
臺北市,信義區,0736,417,277,694,64,758,1255,60.4%,33.23%,1
臺北市,信義區,0737,534,314,848,45,893,1689,52.87%,31.62%,1
臺北市,信義區,0738,518,319,837,36,873,1605,54.39%,32.27%,1
臺北市,信義區,0739,362,249,611,38,649,1143,56.78%,31.67%,1
臺北市,信義區,0740,442,276,718,59,777,1440,53.96%,30.69%,1
臺北市,信義區,0741,494,308,802,61,863,1495,57.73%,33.04%,1
臺北市,信義區,0742,522,339,861,52,913,1514,60.3%,34.48%,1
臺北市,信義區,0743,438,304,742,48,790,1449,54.52%,30.23%,1
臺北市,信義區,0744,461,326,787,69,856,1401,61.1%,32.91%,1
臺北市,信義區,0745,372,237,609,26,635,1181,53.77%,31.5%,1
臺北市,信義區,0746,512,302,814,50,864,1376,62.79%,37.21%,1
臺北市,信義區,0747,507,301,808,66,874,1422,61.46%,35.65%,1
臺北市,信義區,0748,446,256,702,35,737,1267,58.17%,35.2%,1
臺北市,信義區,0749,361,253,614,44,658,1220,53.93%,29.59%,1
臺北市,信義區,0750,467,291,758,45,803,1562,51.41%,29.9%,1
臺北市,信義區,0751,451,314,765,34,799,1455,54.91%,31%,1
臺北市,信義區,0752,519,306,825,60,885,1605,55.14%,32.34%,1
臺北市,信義區,0753,629,320,949,48,997,1626,61.32%,38.68%,1
臺北市,信義區,0754,582,300,882,55,937,1561,60.03%,37.28%,1
臺北市,信義區,0755,405,300,705,36,741,1547,47.9%,26.18%,1
臺北市,信義區,0756,443,288,731,38,769,1336,57.56%,33.16%,1
臺北市,信義區,0757,379,237,616,61,677,1314,51.52%,28.84%,1
臺北市,信義區,0758,407,255,662,46,708,1297,54.59%,31.38%,1
臺北市,信義區,0759,422,260,682,80,762,1366,55.78%,30.89%,1
臺北市,信義區,0760,386,349,735,106,841,1472,57.13%,26.22%,1
臺北市,信義區,0761,465,312,777,60,837,1450,57.72%,32.07%,1
臺北市,信義區,0762,418,270,688,87,775,1328,58.36%,31.48%,1
臺北市,信義區,0763,458,320,778,81,859,1399,61.4%,32.74%,1
臺北市,信義區,0764,452,298,750,97,847,1373,61.69%,32.92%,1
臺北市,信義區,0765,420,154,574,38,612,1099,55.69%,38.22%,1
臺北市,信義區,0766,371,282,653,59,712,1226,58.08%,30.26%,1
臺北市,信義區,0767,386,254,640,31,671,1267,52.96%,30.47%,1
臺北市,信義區,0768,457,363,820,90,910,1531,59.44%,29.85%,1
臺北市,信義區,0769,514,305,819,55,874,1438,60.78%,35.74%,1
臺北市,信義區,0770,540,334,874,44,918,1657,55.4%,32.59%,1
臺北市,信義區,0771,555,349,904,60,964,1621,59.47%,34.24%,1
臺北市,信義區,0772,524,354,878,22,900,1508,59.68%,34.75%,1
臺北市,信義區,0773,448,320,768,50,818,1334,61.32%,33.58%,1
臺北市,信義區,0774,323,223,546,56,602,1246,48.31%,25.92%,1
臺北市,信義區,0775,433,268,701,61,762,1196,63.71%,36.2%,1
臺北市,信義區,0776,404,279,683,41,724,1220,59.34%,33.11%,1
臺北市,信義區,0777,486,324,810,50,860,1538,55.92%,31.6%,1
臺北市,信義區,0778,540,324,864,76,940,1565,60.06%,34.5%,1
臺北市,信義區,0779,484,311,795,78,873,1621,53.86%,29.86%,1
臺北市,信義區,0780,459,316,775,65,840,1486,56.53%,30.89%,1
臺北市,信義區,0781,466,304,770,53,823,1507,54.61%,30.92%,1
臺北市,信義區,0782,509,325,834,65,899,1516,59.3%,33.58%,1
臺北市,信義區,0783,419,303,722,77,799,1287,62.08%,32.56%,1
臺北市,信義區,0784,309,187,496,65,561,1050,53.43%,29.43%,1
臺北市,信義區,0785,286,166,452,45,497,801,62.05%,35.71%,1
臺北市,大安區,1214,362,262,624,38,662,1184,55.91%,30.57%,1
臺北市,大安區,1215,376,241,617,39,656,1197,54.8%,31.41%,1
臺北市,大安區,1216,383,300,683,26,709,1221,58.07%,31.37%,1
臺北市,大安區,1217,496,214,710,36,746,1246,59.87%,39.81%,1
臺北市,大安區,1218,502,359,861,50,911,1478,61.64%,33.96%,1
臺北市,大安區,1219,376,297,673,76,749,1314,57%,28.61%,1
臺北市,大安區,1220,557,359,916,58,974,1594,61.1%,34.94%,1
臺北市,大安區,1221,466,352,818,41,859,1429,60.11%,32.61%,1
臺北市,大安區,1222,556,298,854,29,883,1452,60.81%,38.29%,1
臺北市,大安區,1223,490,368,858,35,893,1551,57.58%,31.59%,1
臺北市,大安區,1224,447,315,762,62,824,1335,61.72%,33.48%,1
臺北市,大安區,1225,359,264,623,34,657,1196,54.93%,30.02%,1
臺北市,大安區,1226,405,303,708,32,740,1339,55.27%,30.25%,1
臺北市,大安區,1227,450,331,781,39,820,1448,56.63%,31.08%,1
臺北市,大安區,1228,457,302,759,43,802,1373,58.41%,33.28%,1
臺北市,大安區,1229,468,330,798,48,846,1439,58.79%,32.52%,1
臺北市,大安區,1230,343,264,607,24,631,1174,53.75%,29.22%,1
臺北市,大安區,1231,314,256,570,34,604,1144,52.8%,27.45%,1
臺北市,大安區,1232,342,223,565,35,600,1119,53.62%,30.56%,1
臺北市,大安區,1233,278,187,465,32,497,1024,48.54%,27.15%,1
臺北市,大安區,1234,372,223,595,35,630,1032,61.05%,36.05%,1
臺北市,大安區,1235,519,242,761,37,798,1319,60.5%,39.35%,1
臺北市,大安區,1236,501,301,802,42,844,1369,61.65%,36.6%,1
臺北市,大安區,1237,398,355,753,49,802,1347,59.54%,29.55%,1
臺北市,大安區,1238,451,375,826,41,867,1655,52.39%,27.25%,1
臺北市,大安區,1239,447,316,763,50,813,1595,50.97%,28.03%,1
臺北市,大安區,1240,468,279,747,36,783,1429,54.79%,32.75%,1
臺北市,大安區,1241,365,285,650,37,687,1309,52.48%,27.88%,1
臺北市,大安區,1242,447,322,769,56,825,1508,54.71%,29.64%,1
臺北市,大安區,1243,370,314,684,49,733,1310,55.95%,28.24%,1
臺北市,大安區,1244,324,279,603,42,645,1233,52.31%,26.28%,1
臺北市,大安區,1245,363,270,633,63,696,1287,54.08%,28.21%,1
臺北市,大安區,1246,311,252,563,41,604,1147,52.66%,27.11%,1
臺北市,大安區,1247,340,292,632,47,679,1260,53.89%,26.98%,1
臺北市,大安區,1248,440,283,723,31,754,1377,54.76%,31.95%,1
臺北市,大安區,1249,366,275,641,76,717,1284,55.84%,28.5%,1
臺北市,大安區,1250,377,270,647,36,683,1314,51.98%,28.69%,1
臺北市,大安區,1251,350,278,628,48,676,1273,53.1%,27.49%,1
臺北市,大安區,1252,334,315,649,26,675,1146,58.9%,29.14%,1
臺北市,大安區,1253,412,301,713,45,758,1285,58.99%,32.06%,1
臺北市,大安區,1254,410,344,754,35,789,1297,60.83%,31.61%,1
臺北市,大安區,1255,374,260,634,51,685,1101,62.22%,33.97%,1
臺北市,大安區,1256,402,301,703,53,756,1310,57.71%,30.69%,1
臺北市,大安區,1257,449,327,776,68,844,1365,61.83%,32.89%,1
臺北市,大安區,1258,432,331,763,30,793,1372,57.8%,31.49%,1
臺北市,大安區,1259,410,274,684,47,731,1189,61.48%,34.48%,1
臺北市,大安區,1260,436,280,716,45,761,1256,60.59%,34.71%,1
臺北市,大安區,1261,379,278,657,40,697,1151,60.56%,32.93%,1
臺北市,大安區,1262,527,352,879,56,935,1501,62.29%,35.11%,1
臺北市,大安區,1263,524,352,876,46,922,1520,60.66%,34.47%,1
臺北市,大安區,1264,482,402,884,66,950,1529,62.13%,31.52%,1
臺北市,大安區,1265,518,372,890,76,966,1579,61.18%,32.81%,1
臺北市,大安區,1266,367,273,640,37,677,2619,25.85%,14.01%,1
臺北市,大安區,1267,425,285,710,31,741,1290,57.44%,32.95%,1
臺北市,大安區,1268,455,336,791,32,823,1307,62.97%,34.81%,1
臺北市,大安區,1269,526,337,863,31,894,1489,60.04%,35.33%,1
臺北市,大安區,1270,387,264,651,38,689,1097,62.81%,35.28%,1
臺北市,大安區,1271,448,296,744,39,783,1328,58.96%,33.73%,1
臺北市,大安區,1272,376,278,654,31,685,1189,57.61%,31.62%,1
臺北市,大安區,1273,413,291,704,32,736,1270,57.95%,32.52%,1
臺北市,大安區,1274,420,328,748,28,776,1349,57.52%,31.13%,1
臺北市,大安區,1275,411,276,687,42,729,1292,56.42%,31.81%,1
臺北市,大安區,1276,456,302,758,54,812,1314,61.8%,34.7%,1
臺北市,大安區,1277,377,304,681,50,731,1200,60.92%,31.42%,1
臺北市,大安區,1278,471,373,844,60,904,1558,58.02%,30.23%,1
臺北市,大安區,1279,483,345,828,59,887,1561,56.82%,30.94%,1
臺北市,大安區,1280,491,319,810,54,864,1446,59.75%,33.96%,1
臺北市,大安區,1281,511,341,852,38,890,1499,59.37%,34.09%,1
臺北市,大安區,1282,505,323,828,41,869,1467,59.24%,34.42%,1
臺北市,大安區,1283,504,311,815,39,854,1511,56.52%,33.36%,1
臺北市,大安區,1284,516,367,883,83,966,1600,60.38%,32.25%,1
臺北市,大安區,1285,520,367,887,42,929,1573,59.06%,33.06%,1
臺北市,大安區,1286,528,332,860,43,903,1467,61.55%,35.99%,1
臺北市,大安區,1287,468,295,763,40,803,1358,59.13%,34.46%,1
臺北市,大安區,1288,527,320,847,60,907,1568,57.84%,33.61%,1
臺北市,大安區,1289,464,321,785,56,841,1411,59.6%,32.88%,1
臺北市,大安區,1290,497,338,835,31,866,1554,55.73%,31.98%,1
臺北市,大安區,1291,489,282,771,49,820,1345,60.97%,36.36%,1
臺北市,大安區,1292,533,278,811,27,838,1435,58.4%,37.14%,1
臺北市,大安區,1293,577,313,890,40,930,1481,62.8%,38.96%,1
臺北市,大安區,1294,559,313,872,32,904,1451,62.3%,38.53%,1
臺北市,大安區,1295,498,361,859,68,927,1566,59.2%,31.8%,1
臺北市,大安區,1296,489,359,848,48,896,1525,58.75%,32.07%,1
臺北市,大安區,1297,421,296,717,47,764,1336,57.19%,31.51%,1
臺北市,大安區,1298,505,325,830,63,893,1483,60.22%,34.05%,1
臺北市,大安區,1299,396,291,687,33,720,1396,51.58%,28.37%,1
臺北市,大安區,1300,462,335,797,73,870,1406,61.88%,32.86%,1
臺北市,大安區,1301,482,337,819,50,869,1434,60.6%,33.61%,1
臺北市,大安區,1302,424,292,716,43,759,1288,58.93%,32.92%,1
臺北市,大安區,1303,476,310,786,50,836,1407,59.42%,33.83%,1
臺北市,大安區,1304,464,323,787,44,831,1514,54.89%,30.65%,1
臺北市,大安區,1305,403,291,694,66,760,1550,49.03%,26%,1
臺北市,大安區,1306,499,314,813,64,877,1490,58.86%,33.49%,1
臺北市,大安區,1307,379,297,676,39,715,1284,55.69%,29.52%,1
臺北市,大安區,1308,414,235,649,33,682,1129,60.41%,36.67%,1
臺北市,大安區,1309,398,284,682,33,715,1193,59.93%,33.36%,1
臺北市,大安區,1310,306,254,560,41,601,1057,56.86%,28.95%,1
臺北市,大安區,1311,404,323,727,60,787,1361,57.83%,29.68%,1
臺北市,大安區,1312,455,286,741,56,797,1412,56.44%,32.22%,1
臺北市,大安區,1313,371,257,628,56,684,1423,48.07%,26.07%,1
臺北市,大安區,1314,374,274,648,87,735,1257,58.47%,29.75%,1
臺北市,大安區,1315,386,251,637,63,700,1133,61.78%,34.07%,1
臺北市,大安區,1316,320,244,564,54,618,1077,57.38%,29.71%,1
臺北市,大安區,1317,413,313,726,55,781,1300,60.08%,31.77%,1
臺北市,大安區,1318,472,291,763,59,822,1319,62.32%,35.78%,1
臺北市,大安區,1319,402,297,699,80,779,1265,61.58%,31.78%,1
臺北市,大安區,1320,379,261,640,42,682,1265,53.91%,29.96%,1
臺北市,大安區,1321,386,226,612,49,661,1103,59.93%,35%,1
臺北市,大安區,1322,486,271,757,55,812,1341,60.55%,36.24%,1
臺北市,大安區,1323,512,261,773,50,823,1357,60.65%,37.73%,1
臺北市,大安區,1324,448,257,705,42,747,1260,59.29%,35.56%,1
臺北市,大安區,1325,450,268,718,43,761,1295,58.76%,34.75%,1
臺北市,大安區,1326,395,318,713,41,754,1399,53.9%,28.23%,1
臺北市,大安區,1327,384,236,620,42,662,1150,57.57%,33.39%,1
臺北市,大安區,1328,436,240,676,40,716,1351,53%,32.27%,1
臺北市,大安區,1329,417,309,726,71,797,1341,59.43%,31.1%,1
臺北市,大安區,1330,375,228,603,27,630,1129,55.8%,33.22%,1
臺北市,大安區,1331,480,239,719,42,761,1328,57.3%,36.14%,1
臺北市,大安區,1332,647,294,941,43,984,1557,63.2%,41.55%,1
臺北市,大安區,1333,553,301,854,56,910,1461,62.29%,37.85%,1
臺北市,大安區,1334,524,257,781,39,820,1589,51.6%,32.98%,1
臺北市,大安區,1335,536,251,787,46,833,1473,56.55%,36.39%,1
臺北市,大安區,1336,454,340,794,42,836,1479,56.52%,30.7%,1
臺北市,大安區,1337,289,197,486,34,520,833,62.42%,34.69%,1
臺北市,大安區,1338,279,235,514,54,568,999,56.86%,27.93%,1
臺北市,大安區,1339,305,386,691,56,747,1757,42.52%,17.36%,1
臺北市,大安區,1340,516,357,873,56,929,1573,59.06%,32.8%,1
臺北市,大安區,1341,570,371,941,42,983,1587,61.94%,35.92%,1
臺北市,大安區,1342,482,375,857,59,916,1496,61.23%,32.22%,1
臺北市,大安區,1343,481,340,821,37,858,1440,59.58%,33.4%,1
臺北市,大安區,1344,550,343,893,63,956,1578,60.58%,34.85%,1
臺北市,大安區,1345,383,305,688,34,722,1223,59.04%,31.32%,1
臺北市,大安區,1346,342,276,618,32,650,1119,58.09%,30.56%,1
臺北市,大安區,1347,416,308,724,35,759,1252,60.62%,33.23%,1
臺北市,大安區,1348,535,358,893,48,941,1576,59.71%,33.95%,1
臺北市,大安區,1349,461,325,786,33,819,1425,57.47%,32.35%,1
臺北市,大安區,1350,436,320,756,33,789,1450,54.41%,30.07%,1
臺北市,大安區,1351,461,311,772,54,826,1444,57.2%,31.93%,1
臺北市,大安區,1352,436,362,798,43,841,1337,62.9%,32.61%,1
臺北市,大安區,1353,436,301,737,44,781,1417,55.12%,30.77%,1
臺北市,大安區,1354,398,277,675,58,733,1250,58.64%,31.84%,1
臺北市,大安區,1355,395,235,630,60,690,1176,58.67%,33.59%,1
臺北市,大安區,1356,428,297,725,55,780,1257,62.05%,34.05%,1
臺北市,大安區,1357,400,230,630,58,688,1257,54.73%,31.82%,1
臺北市,大安區,1358,362,273,635,40,675,1148,58.8%,31.53%,1
臺北市,大安區,1359,442,331,773,61,834,1418,58.82%,31.17%,1
臺北市,大安區,1360,322,225,547,35,582,1028,56.61%,31.32%,1
臺北市,大安區,1361,486,338,824,44,868,1445,60.07%,33.63%,1
臺北市,大安區,1362,466,291,757,53,810,1361,59.52%,34.24%,1
臺北市,大安區,1363,484,292,776,55,831,1343,61.88%,36.04%,1
臺北市,大安區,1364,417,278,695,58,753,1267,59.43%,32.91%,1
臺北市,大安區,1365,400,307,707,48,755,1380,54.71%,28.99%,1
臺北市,大安區,1366,483,318,801,57,858,1524,56.3%,31.69%,1
臺北市,大安區,1367,501,309,810,61,871,1470,59.25%,34.08%,1
臺北市,大安區,1368,359,257,616,77,693,1318,52.58%,27.24%,1
臺北市,大安區,1369,412,297,709,70,779,1430,54.48%,28.81%,1
臺北市,大安區,1370,460,288,748,52,800,1386,57.72%,33.19%,1
臺北市,大安區,1371,437,283,720,43,763,1438,53.06%,30.39%,1
臺北市,大安區,1372,361,259,620,38,658,1270,51.81%,28.43%,1
臺北市,大安區,1373,416,313,729,52,781,1395,55.99%,29.82%,1
臺北市,大安區,1374,392,303,695,53,748,1292,57.89%,30.34%,1
臺北市,大安區,1375,389,297,686,47,733,1310,55.95%,29.69%,1
臺北市,大安區,1376,391,299,690,53,743,1319,56.33%,29.64%,1
臺北市,大安區,1377,403,348,751,41,792,1355,58.45%,29.74%,1
臺北市,大安區,1378,376,293,669,32,701,1312,53.43%,28.66%,1
臺北市,大安區,1379,451,284,735,27,762,1335,57.08%,33.78%,1
臺北市,大安區,1380,444,306,750,38,788,1489,52.92%,29.82%,1
臺北市,大安區,1381,424,293,717,44,761,1307,58.22%,32.44%,1
臺北市,大安區,1382,382,278,660,40,700,1328,52.71%,28.77%,1
臺北市,大安區,1383,402,262,664,7,671,1277,52.55%,31.48%,1
臺北市,大安區,1384,425,280,705,53,758,1314,57.69%,32.34%,1
臺北市,大安區,1385,433,285,718,53,771,1270,60.71%,34.09%,1
臺北市,大安區,1386,409,295,704,59,763,1308,58.33%,31.27%,1
臺北市,大安區,1387,388,274,662,27,689,1138,60.54%,34.09%,1
臺北市,大安區,1388,429,268,697,44,741,1333,55.59%,32.18%,1
臺北市,大安區,1389,397,251,648,45,693,1176,58.93%,33.76%,1
臺北市,大安區,1390,416,289,705,55,760,1311,57.97%,31.73%,1
臺北市,大安區,1391,397,290,687,37,724,1295,55.91%,30.66%,1
臺北市,大安區,1392,500,275,775,53,828,1421,58.27%,35.19%,1
臺北市,大安區,1393,448,300,748,42,790,1409,56.07%,31.8%,1
臺北市,大安區,1394,470,293,763,70,833,1434,58.09%,32.78%,1
臺北市,大安區,1395,391,297,688,96,784,1449,54.11%,26.98%,1
臺北市,大安區,1396,428,279,707,54,761,1284,59.27%,33.33%,1
臺北市,大安區,1397,406,267,673,45,718,1248,57.53%,32.53%,1
臺北市,大安區,1398,423,276,699,40,739,1119,66.04%,37.8%,1
臺北市,大安區,1399,305,190,495,39,534,883,60.48%,34.54%,1
臺北市,大安區,1400,204,111,315,46,361,630,57.3%,32.38%,1
臺北市,大安區,1401,260,192,452,35,487,814,59.83%,31.94%,1
臺北市,中山區,0786,463,355,818,57,875,1522,57.49%,30.42%,1
臺北市,中山區,0787,364,325,689,38,727,1332,54.58%,27.33%,1
臺北市,中山區,0788,429,346,775,62,837,1656,50.54%,25.91%,1
臺北市,中山區,0789,361,283,644,67,711,1367,52.01%,26.41%,1
臺北市,中山區,0790,485,337,822,62,884,1732,51.04%,28%,1
臺北市,中山區,0791,454,400,854,72,926,1634,56.67%,27.78%,1
臺北市,中山區,0792,465,368,833,71,904,1650,54.79%,28.18%,1
臺北市,中山區,0793,400,369,769,46,815,1392,58.55%,28.74%,1
臺北市,中山區,0794,356,326,682,47,729,1177,61.94%,30.25%,1
臺北市,中山區,0795,430,384,814,64,878,1477,59.44%,29.11%,1
臺北市,中山區,0796,296,217,513,68,581,1063,54.66%,27.85%,1
臺北市,中山區,0797,396,264,660,50,710,1296,54.78%,30.56%,1
臺北市,中山區,0798,387,283,670,44,714,1330,53.68%,29.1%,1
臺北市,中山區,0799,404,341,745,67,812,1483,54.75%,27.24%,1
臺北市,中山區,0800,439,323,762,64,826,1542,53.57%,28.47%,1
臺北市,中山區,0801,484,351,835,72,907,1710,53.04%,28.3%,1
臺北市,中山區,0802,243,274,517,45,562,1315,42.74%,18.48%,1
臺北市,中山區,0803,350,277,627,76,703,1245,56.47%,28.11%,1
臺北市,中山區,0804,376,260,636,53,689,1262,54.6%,29.79%,1
臺北市,中山區,0805,451,359,810,67,877,1518,57.77%,29.71%,1
臺北市,中山區,0806,456,341,797,81,878,1522,57.69%,29.96%,1
臺北市,中山區,0807,411,354,765,68,833,1580,52.72%,26.01%,1
臺北市,中山區,0808,459,345,804,58,862,1529,56.38%,30.02%,1
臺北市,中山區,0809,380,266,646,47,693,1221,56.76%,31.12%,1
臺北市,中山區,0810,389,297,686,39,725,1221,59.38%,31.86%,1
臺北市,中山區,0811,308,229,537,35,572,1139,50.22%,27.04%,1
臺北市,中山區,0812,380,324,704,100,804,1407,57.14%,27.01%,1
臺北市,中山區,0813,403,315,718,41,759,1321,57.46%,30.51%,1
臺北市,中山區,0814,434,308,742,49,791,1578,50.13%,27.5%,1
臺北市,中山區,0815,475,365,840,63,903,1739,51.93%,27.31%,1
臺北市,中山區,0816,454,350,804,51,855,1637,52.23%,27.73%,1
臺北市,中山區,0817,439,326,765,78,843,1541,54.7%,28.49%,1
臺北市,中山區,0818,374,284,658,61,719,1210,59.42%,30.91%,1
臺北市,中山區,0819,387,293,680,54,734,1331,55.15%,29.08%,1
臺北市,中山區,0820,314,266,580,69,649,1224,53.02%,25.65%,1
臺北市,中山區,0821,473,362,835,76,911,1585,57.48%,29.84%,1
臺北市,中山區,0822,472,390,862,88,950,1523,62.38%,30.99%,1
臺北市,中山區,0823,436,338,774,75,849,1368,62.06%,31.87%,1
臺北市,中山區,0824,664,313,977,62,1039,1805,57.56%,36.79%,1
臺北市,中山區,0825,516,243,759,53,812,1404,57.83%,36.75%,1
臺北市,中山區,0826,590,416,1006,51,1057,1708,61.89%,34.54%,1
臺北市,中山區,0827,504,354,858,62,920,1451,63.4%,34.73%,1
臺北市,中山區,0828,548,402,950,88,1038,1684,61.64%,32.54%,1
臺北市,中山區,0829,553,299,852,47,899,1585,56.72%,34.89%,1
臺北市,中山區,0830,416,334,750,88,838,1391,60.24%,29.91%,1
臺北市,中山區,0831,451,375,826,85,911,1375,66.25%,32.8%,1
臺北市,中山區,0832,489,369,858,38,896,1472,60.87%,33.22%,1
臺北市,中山區,0833,417,278,695,45,740,1327,55.76%,31.42%,1
臺北市,中山區,0834,478,307,785,34,819,1401,58.46%,34.12%,1
臺北市,中山區,0835,455,333,788,52,840,1423,59.03%,31.97%,1
臺北市,中山區,0836,505,366,871,53,924,1569,58.89%,32.19%,1
臺北市,中山區,0837,526,393,919,39,958,1651,58.03%,31.86%,1
臺北市,中山區,0838,481,392,873,42,915,1624,56.34%,29.62%,1
臺北市,中山區,0839,564,437,1001,59,1060,1713,61.88%,32.92%,1
臺北市,中山區,0840,546,381,927,61,988,1647,59.99%,33.15%,1
臺北市,中山區,0841,533,369,902,52,954,1762,54.14%,30.25%,1
臺北市,中山區,0842,502,315,817,47,864,1399,61.76%,35.88%,1
臺北市,中山區,0843,471,385,856,62,918,1489,61.65%,31.63%,1
臺北市,中山區,0844,474,264,738,48,786,1269,61.94%,37.35%,1
臺北市,中山區,0845,347,248,595,38,633,998,63.43%,34.77%,1
臺北市,中山區,0846,410,346,756,74,830,1472,56.39%,27.85%,1
臺北市,中山區,0847,430,320,750,71,821,1517,54.12%,28.35%,1
臺北市,中山區,0848,449,414,863,85,948,1704,55.63%,26.35%,1
臺北市,中山區,0849,444,431,875,73,948,1603,59.14%,27.7%,1
臺北市,中山區,0850,400,296,696,92,788,1432,55.03%,27.93%,1
臺北市,中山區,0851,439,385,824,72,896,1500,59.73%,29.27%,1
臺北市,中山區,0852,402,343,745,62,807,1332,60.59%,30.18%,1
臺北市,中山區,0853,494,347,841,61,902,1450,62.21%,34.07%,1
臺北市,中山區,0854,454,347,801,62,863,1434,60.18%,31.66%,1
臺北市,中山區,0855,440,297,737,52,789,1419,55.6%,31.01%,1
臺北市,中山區,0856,348,313,661,55,716,1292,55.42%,26.93%,1
臺北市,中山區,0857,420,340,760,77,837,1526,54.85%,27.52%,1
臺北市,中山區,0858,407,324,731,56,787,1582,49.75%,25.73%,1
臺北市,中山區,0859,399,357,756,71,827,1588,52.08%,25.13%,1
臺北市,中山區,0860,401,354,755,88,843,1463,57.62%,27.41%,1
臺北市,中山區,0861,405,313,718,75,793,1533,51.73%,26.42%,1
臺北市,中山區,0862,259,217,476,62,538,944,56.99%,27.44%,1
臺北市,中山區,0863,512,511,1023,72,1095,1745,62.75%,29.34%,1
臺北市,中山區,0864,447,350,797,55,852,1679,50.74%,26.62%,1
臺北市,中山區,0865,441,339,780,49,829,3419,24.25%,12.9%,1
臺北市,中山區,0866,443,314,757,78,835,1387,60.2%,31.94%,1
臺北市,中山區,0867,516,387,903,87,990,1672,59.21%,30.86%,1
臺北市,中山區,0868,387,300,687,81,768,1319,58.23%,29.34%,1
臺北市,中山區,0869,385,310,695,67,762,1364,55.87%,28.23%,1
臺北市,中山區,0870,400,344,744,70,814,1461,55.72%,27.38%,1
臺北市,中山區,0871,347,269,616,69,685,1173,58.4%,29.58%,1
臺北市,中山區,0872,343,241,584,53,637,1171,54.4%,29.29%,1
臺北市,中山區,0873,371,308,679,71,750,1310,57.25%,28.32%,1
臺北市,中山區,0874,453,316,769,56,825,1373,60.09%,32.99%,1
臺北市,中山區,0875,401,345,746,39,785,1290,60.85%,31.09%,1
臺北市,中山區,0876,445,303,748,78,826,1346,61.37%,33.06%,1
臺北市,中山區,0877,468,359,827,60,887,1468,60.42%,31.88%,1
臺北市,中山區,0878,372,291,663,40,703,1178,59.68%,31.58%,1
臺北市,中山區,0879,564,405,969,61,1030,1654,62.27%,34.1%,1
臺北市,中山區,0880,467,329,796,65,861,1464,58.81%,31.9%,1
臺北市,中山區,0881,426,338,764,39,803,1450,55.38%,29.38%,1
臺北市,中山區,0882,472,337,809,72,881,1534,57.43%,30.77%,1
臺北市,中山區,0883,503,398,901,52,953,1703,55.96%,29.54%,1
臺北市,中山區,0884,531,356,887,70,957,1610,59.44%,32.98%,1
臺北市,中山區,0885,486,364,850,78,928,1653,56.14%,29.4%,1
臺北市,中山區,0886,523,416,939,82,1021,1694,60.27%,30.87%,1
臺北市,中山區,0887,481,362,843,69,912,1623,56.19%,29.64%,1
臺北市,中山區,0888,465,418,883,62,945,1618,58.41%,28.74%,1
臺北市,中山區,0889,445,406,851,45,896,1583,56.6%,28.11%,1
臺北市,中山區,0890,454,442,896,69,965,1605,60.12%,28.29%,1
臺北市,中山區,0891,482,349,831,61,892,1398,63.81%,34.48%,1
臺北市,中山區,0892,527,387,914,70,984,1526,64.48%,34.53%,1
臺北市,中山區,0893,460,398,858,54,912,1555,58.65%,29.58%,1
臺北市,中山區,0894,497,348,845,47,892,1597,55.85%,31.12%,1
臺北市,中山區,0895,467,371,838,97,935,1587,58.92%,29.43%,1
臺北市,中山區,0896,513,375,888,74,962,1587,60.62%,32.33%,1
臺北市,中山區,0897,485,386,871,76,947,1546,61.25%,31.37%,1
臺北市,中山區,0898,410,277,687,66,753,1322,56.96%,31.01%,1
臺北市,中山區,0899,392,296,688,53,741,1267,58.48%,30.94%,1
臺北市,中山區,0900,359,294,653,34,687,1210,56.78%,29.67%,1
臺北市,中山區,0901,402,282,684,63,747,1295,57.68%,31.04%,1
臺北市,中山區,0902,482,333,815,94,909,1467,61.96%,32.86%,1
臺北市,中山區,0903,587,278,865,62,927,1491,62.17%,39.37%,1
臺北市,中山區,0904,599,306,905,78,983,1516,64.84%,39.51%,1
臺北市,中山區,0905,390,313,703,42,745,1384,53.83%,28.18%,1
臺北市,中山區,0906,374,298,672,52,724,1138,63.62%,32.86%,1
臺北市,中山區,0907,435,333,768,39,807,1513,53.34%,28.75%,1
臺北市,中山區,0908,521,329,850,76,926,1559,59.4%,33.42%,1
臺北市,中山區,0909,461,335,796,91,887,1429,62.07%,32.26%,1
臺北市,中山區,0910,409,321,730,39,769,1245,61.77%,32.85%,1
臺北市,中山區,0911,400,313,713,56,769,1214,63.34%,32.95%,1
臺北市,中山區,0912,429,346,775,55,830,1394,59.54%,30.77%,1
臺北市,中山區,0913,383,284,667,25,692,1336,51.8%,28.67%,1
臺北市,中山區,0914,375,276,651,52,703,1227,57.29%,30.56%,1
臺北市,中山區,0915,432,339,771,53,824,1382,59.62%,31.26%,1
臺北市,中山區,0916,457,315,772,55,827,1436,57.59%,31.82%,1
臺北市,中山區,0917,397,295,692,43,735,1405,52.31%,28.26%,1
臺北市,中山區,0918,430,267,697,38,735,1259,58.38%,34.15%,1
臺北市,中正區,1001,426,317,743,45,788,1308,60.24%,32.57%,1
臺北市,中正區,1002,371,296,667,72,739,1317,56.11%,28.17%,1
臺北市,中正區,1003,382,246,628,36,664,1069,62.11%,35.73%,1
臺北市,中正區,1004,372,209,581,49,630,1128,55.85%,32.98%,1
臺北市,中正區,1005,356,249,605,44,649,1053,61.63%,33.81%,1
臺北市,中正區,1006,343,245,588,32,620,1048,59.16%,32.73%,1
臺北市,中正區,1007,422,268,690,55,745,1297,57.44%,32.54%,1
臺北市,中正區,1008,411,261,672,37,709,1193,59.43%,34.45%,1
臺北市,中正區,1009,542,373,915,55,970,1500,64.67%,36.13%,1
臺北市,中正區,1010,430,272,702,43,745,1346,55.35%,31.95%,1
臺北市,中正區,1011,456,265,721,23,744,1283,57.99%,35.54%,1
臺北市,中正區,1012,455,327,782,46,828,1450,57.1%,31.38%,1
臺北市,中正區,1013,466,339,805,49,854,1433,59.6%,32.52%,1
臺北市,中正區,1014,456,349,805,57,862,1309,65.85%,34.84%,1
臺北市,中正區,1015,481,308,789,32,821,1386,59.24%,34.7%,1
臺北市,中正區,1016,395,283,678,55,733,1201,61.03%,32.89%,1
臺北市,中正區,1017,479,303,782,56,838,1336,62.72%,35.85%,1
臺北市,中正區,1018,459,319,778,48,826,1358,60.82%,33.8%,1
臺北市,中正區,1019,415,252,667,55,722,1177,61.34%,35.26%,1
臺北市,中正區,1020,444,306,750,38,788,1236,63.75%,35.92%,1
臺北市,中正區,1021,476,333,809,47,856,1478,57.92%,32.21%,1
臺北市,中正區,1022,526,323,849,38,887,1474,60.18%,35.69%,1
臺北市,中正區,1023,374,276,650,40,690,1172,58.87%,31.91%,1
臺北市,中正區,1024,428,301,729,43,772,1310,58.93%,32.67%,1
臺北市,中正區,1025,449,283,732,30,762,1263,60.33%,35.55%,1
臺北市,中正區,1026,379,278,657,47,704,1169,60.22%,32.42%,1
臺北市,中正區,1027,469,292,761,31,792,1391,56.94%,33.72%,1
臺北市,中正區,1028,386,263,649,39,688,1201,57.29%,32.14%,1
臺北市,中正區,1029,429,297,726,57,783,1324,59.14%,32.4%,1
臺北市,中正區,1030,364,253,617,66,683,1216,56.17%,29.93%,1
臺北市,中正區,1031,348,273,621,60,681,1183,57.57%,29.42%,1
臺北市,中正區,1032,456,354,810,82,892,1469,60.72%,31.04%,1
臺北市,中正區,1033,451,310,761,60,821,1411,58.19%,31.96%,1
臺北市,中正區,1034,445,309,754,92,846,1398,60.52%,31.83%,1
臺北市,中正區,1035,447,312,759,81,840,1479,56.8%,30.22%,1
臺北市,中正區,1036,501,328,829,73,902,1620,55.68%,30.93%,1
臺北市,中正區,1037,350,223,573,22,595,1041,57.16%,33.62%,1
臺北市,中正區,1038,315,246,561,23,584,1056,55.3%,29.83%,1
臺北市,中正區,1039,370,261,631,51,682,1063,64.16%,34.81%,1
臺北市,中正區,1040,395,283,678,68,746,1591,46.89%,24.83%,1
臺北市,中正區,1041,367,252,619,88,707,1502,47.07%,24.43%,1
臺北市,中正區,1042,391,247,638,77,715,1331,53.72%,29.38%,1
臺北市,中正區,1043,458,293,751,70,821,1441,56.97%,31.78%,1
臺北市,中正區,1044,415,321,736,57,793,1273,62.29%,32.6%,1
臺北市,中正區,1045,368,283,651,43,694,1133,61.25%,32.48%,1
臺北市,中正區,1046,364,287,651,38,689,1156,59.6%,31.49%,1
臺北市,中正區,1047,412,340,752,58,810,1377,58.82%,29.92%,1
臺北市,中正區,1048,379,339,718,62,780,1266,61.61%,29.94%,1
臺北市,中正區,1049,406,257,663,51,714,1111,64.27%,36.54%,1
臺北市,中正區,1050,365,262,627,40,667,1124,59.34%,32.47%,1
臺北市,中正區,1051,432,359,791,53,844,1373,61.47%,31.46%,1
臺北市,中正區,1052,501,281,782,55,837,1351,61.95%,37.08%,1
臺北市,中正區,1053,509,337,846,41,887,1495,59.33%,34.05%,1
臺北市,中正區,1054,479,374,853,68,921,1436,64.14%,33.36%,1
臺北市,中正區,1055,503,333,836,30,866,1516,57.12%,33.18%,1
臺北市,中正區,1056,459,297,756,47,803,1374,58.44%,33.41%,1
臺北市,中正區,1057,456,308,764,67,831,1522,54.6%,29.96%,1
臺北市,中正區,1058,480,278,758,43,801,1336,59.96%,35.93%,1
臺北市,中正區,1059,489,387,876,43,919,1551,59.25%,31.53%,1
臺北市,中正區,1060,528,379,907,52,959,1594,60.16%,33.12%,1
臺北市,中正區,1061,495,327,822,63,885,1503,58.88%,32.93%,1
臺北市,中正區,1062,501,325,826,41,867,1455,59.59%,34.43%,1
臺北市,中正區,1063,498,325,823,22,845,1439,58.72%,34.61%,1
臺北市,中正區,1064,507,312,819,49,868,1469,59.09%,34.51%,1
臺北市,中正區,1065,533,248,781,35,816,1430,57.06%,37.27%,1
臺北市,中正區,1066,555,288,843,50,893,1444,61.84%,38.43%,1
臺北市,中正區,1067,418,291,709,24,733,1254,58.45%,33.33%,1
臺北市,中正區,1068,308,215,523,52,575,932,61.7%,33.05%,1
臺北市,中正區,1069,339,245,584,61,645,1055,61.14%,32.13%,1
臺北市,中正區,1070,403,265,668,54,722,1226,58.89%,32.87%,1
臺北市,中正區,1071,409,271,680,52,732,1390,52.66%,29.42%,1
臺北市,中正區,1072,462,288,750,29,779,1336,58.31%,34.58%,1
臺北市,中正區,1073,386,336,722,54,776,1419,54.69%,27.2%,1
臺北市,中正區,1074,577,218,795,52,847,1361,62.23%,42.4%,1
臺北市,中正區,1075,518,346,864,54,918,2520,36.43%,20.56%,1
臺北市,中正區,1076,396,279,675,34,709,1224,57.92%,32.35%,1
臺北市,中正區,1077,334,319,653,6,659,1272,51.81%,26.26%,1
臺北市,中正區,1078,412,342,754,58,812,1400,58%,29.43%,1
臺北市,中正區,1079,420,279,699,38,737,1319,55.88%,31.84%,1
臺北市,中正區,1080,430,285,715,48,763,1232,61.93%,34.9%,1
臺北市,中正區,1081,448,306,754,48,802,1265,63.4%,35.42%,1
臺北市,中正區,1082,370,272,642,34,676,1055,64.08%,35.07%,1
臺北市,中正區,1083,318,226,544,24,568,954,59.54%,33.33%,1
臺北市,中正區,1084,306,231,537,43,580,1018,56.97%,30.06%,1
臺北市,中正區,1085,439,325,764,52,816,1431,57.02%,30.68%,1
臺北市,中正區,1086,379,246,625,49,674,1271,53.03%,29.82%,1
臺北市,中正區,1087,291,271,562,52,614,983,62.46%,29.6%,1
臺北市,中正區,1088,513,358,871,42,913,1594,57.28%,32.18%,1
臺北市,中正區,1089,552,345,897,52,949,1565,60.64%,35.27%,1
臺北市,中正區,1090,547,363,910,43,953,1650,57.76%,33.15%,1
臺北市,中正區,1091,505,343,848,39,887,1600,55.44%,31.56%,1
臺北市,中正區,1092,420,329,749,37,786,1391,56.51%,30.19%,1
臺北市,中正區,1093,572,388,960,53,1013,1769,57.26%,32.33%,1
臺北市,中正區,1094,470,349,819,65,884,1487,59.45%,31.61%,1
臺北市,中正區,1095,383,295,678,108,786,1291,60.88%,29.67%,1
臺北市,中正區,1096,455,294,749,35,784,1289,60.82%,35.3%,1
臺北市,大同區,0919,359,304,663,88,751,1261,59.56%,28.47%,1
臺北市,大同區,0920,424,341,765,71,836,1352,61.83%,31.36%,1
臺北市,大同區,0921,443,343,786,60,846,1462,57.87%,30.3%,1
臺北市,大同區,0922,461,337,798,79,877,1510,58.08%,30.53%,1
臺北市,大同區,0923,398,342,740,53,793,1496,53.01%,26.6%,1
臺北市,大同區,0924,364,322,686,64,750,1329,56.43%,27.39%,1
臺北市,大同區,0925,389,289,678,90,768,1307,58.76%,29.76%,1
臺北市,大同區,0926,305,255,560,70,630,1065,59.15%,28.64%,1
臺北市,大同區,0927,299,283,582,49,631,1085,58.16%,27.56%,1
臺北市,大同區,0928,289,294,583,79,662,1047,63.23%,27.6%,1
臺北市,大同區,0929,324,278,602,45,647,1215,53.25%,26.67%,1
臺北市,大同區,0930,307,332,639,47,686,1117,61.41%,27.48%,1
臺北市,大同區,0931,336,327,663,69,732,1186,61.72%,28.33%,1
臺北市,大同區,0932,324,333,657,72,729,1185,61.52%,27.34%,1
臺北市,大同區,0933,419,300,719,53,772,1359,56.81%,30.83%,1
臺北市,大同區,0934,369,317,686,34,720,1273,56.56%,28.99%,1
臺北市,大同區,0935,399,333,732,58,790,1291,61.19%,30.91%,1
臺北市,大同區,0936,385,279,664,52,716,1288,55.59%,29.89%,1
臺北市,大同區,0937,411,314,725,56,781,1245,62.73%,33.01%,1
臺北市,大同區,0938,419,301,720,72,792,1261,62.81%,33.23%,1
臺北市,大同區,0939,405,301,706,33,739,1348,54.82%,30.04%,1
臺北市,大同區,0940,448,431,879,111,990,1676,59.07%,26.73%,1
臺北市,大同區,0941,430,305,735,70,805,1311,61.4%,32.8%,1
臺北市,大同區,0942,412,300,712,91,803,1316,61.02%,31.31%,1
臺北市,大同區,0943,402,330,732,93,825,1409,58.55%,28.53%,1
臺北市,大同區,0944,433,361,794,75,869,1436,60.52%,30.15%,1
臺北市,大同區,0945,450,326,776,66,842,1408,59.8%,31.96%,1
臺北市,大同區,0946,387,303,690,46,736,1276,57.68%,30.33%,1
臺北市,大同區,0947,335,267,602,34,636,1110,57.3%,30.18%,1
臺北市,大同區,0948,391,326,717,50,767,1324,57.93%,29.53%,1
臺北市,大同區,0949,308,246,554,41,595,1016,58.56%,30.31%,1
臺北市,大同區,0950,339,253,592,48,640,1028,62.26%,32.98%,1
臺北市,大同區,0951,375,265,640,65,705,1158,60.88%,32.38%,1
臺北市,大同區,0952,364,269,633,63,696,1138,61.16%,31.99%,1
臺北市,大同區,0953,360,298,658,70,728,1214,59.97%,29.65%,1
臺北市,大同區,0954,330,264,594,34,628,1090,57.61%,30.28%,1
臺北市,大同區,0955,450,341,791,71,862,1305,66.05%,34.48%,1
臺北市,大同區,0956,330,256,586,38,624,1167,53.47%,28.28%,1
臺北市,大同區,0957,350,262,612,61,673,1148,58.62%,30.49%,1
臺北市,大同區,0958,380,308,688,65,753,1203,62.59%,31.59%,1
臺北市,大同區,0959,379,350,729,70,799,1441,55.45%,26.3%,1
臺北市,大同區,0960,405,344,749,70,819,1315,62.28%,30.8%,1
臺北市,大同區,0961,395,326,721,72,793,1393,56.93%,28.36%,1
臺北市,大同區,0962,400,305,705,60,765,1278,59.86%,31.3%,1
臺北市,大同區,0963,329,278,607,64,671,1246,53.85%,26.4%,1
臺北市,大同區,0964,317,265,582,81,663,1142,58.06%,27.76%,1
臺北市,大同區,0965,400,324,724,88,812,1336,60.78%,29.94%,1
臺北市,大同區,0966,405,372,777,61,838,1363,61.48%,29.71%,1
臺北市,大同區,0967,425,373,798,40,838,1476,56.78%,28.79%,1
臺北市,大同區,0968,402,362,764,71,835,1418,58.89%,28.35%,1
臺北市,大同區,0969,391,341,732,60,792,1460,54.25%,26.78%,1
臺北市,大同區,0970,276,259,535,73,608,1222,49.75%,22.59%,1
臺北市,大同區,0971,288,257,545,103,648,1246,52.01%,23.11%,1
臺北市,大同區,0972,404,296,700,84,784,1256,62.42%,32.17%,1
臺北市,大同區,0973,375,320,695,47,742,1289,57.56%,29.09%,1
臺北市,大同區,0974,376,307,683,36,719,1340,53.66%,28.06%,1
臺北市,大同區,0975,443,329,772,67,839,1555,53.95%,28.49%,1
臺北市,大同區,0976,432,299,731,102,833,2459,33.88%,17.57%,1
臺北市,大同區,0977,248,216,464,75,539,1108,48.65%,22.38%,1
臺北市,大同區,0978,227,174,401,71,472,867,54.44%,26.18%,1
臺北市,大同區,0979,395,349,744,73,817,1329,61.47%,29.72%,1
臺北市,大同區,0980,328,291,619,47,666,1162,57.31%,28.23%,1
臺北市,大同區,0981,375,326,701,86,787,1434,54.88%,26.15%,1
臺北市,大同區,0982,400,303,703,86,789,1351,58.4%,29.61%,1
臺北市,大同區,0983,493,247,740,67,807,1531,52.71%,32.2%,1
臺北市,大同區,0984,378,328,706,56,762,1507,50.56%,25.08%,1
臺北市,大同區,0985,417,351,768,75,843,1488,56.65%,28.02%,1
臺北市,大同區,0986,410,348,758,98,856,1384,61.85%,29.62%,1
臺北市,大同區,0987,456,310,766,83,849,1460,58.15%,31.23%,1
臺北市,大同區,0988,452,320,772,74,846,1371,61.71%,32.97%,1
臺北市,大同區,0989,429,331,760,32,792,1439,55.04%,29.81%,1
臺北市,大同區,0990,302,454,756,72,828,1376,60.17%,21.95%,1
臺北市,大同區,0991,379,305,684,94,778,1366,56.95%,27.75%,1
臺北市,大同區,0992,419,295,714,74,788,1218,64.7%,34.4%,1
臺北市,大同區,0993,393,271,664,68,732,1235,59.27%,31.82%,1
臺北市,大同區,0994,413,281,694,31,725,1364,53.15%,30.28%,1
臺北市,大同區,0995,500,334,834,77,911,1408,64.7%,35.51%,1
臺北市,大同區,0996,463,319,782,65,847,1450,58.41%,31.93%,1
臺北市,大同區,0997,479,336,815,80,895,1429,62.63%,33.52%,1
臺北市,大同區,0998,343,290,633,75,708,1170,60.51%,29.32%,1
臺北市,大同區,0999,319,326,645,91,736,1245,59.12%,25.62%,1
臺北市,大同區,1000,384,326,710,82,792,1215,65.19%,31.6%,1
臺北市,萬華區,1097,406,318,724,58,782,1305,59.92%,31.11%,1
臺北市,萬華區,1098,304,221,525,79,604,1183,51.06%,25.7%,1
臺北市,萬華區,1099,348,260,608,32,640,1176,54.42%,29.59%,1
臺北市,萬華區,1100,312,260,572,33,605,1169,51.75%,26.69%,1
臺北市,萬華區,1101,399,287,686,56,742,1457,50.93%,27.39%,1
臺北市,萬華區,1102,377,293,670,86,756,1563,48.37%,24.12%,1
臺北市,萬華區,1103,498,300,798,56,854,1771,48.22%,28.12%,1
臺北市,萬華區,1104,439,336,775,65,840,1615,52.01%,27.18%,1
臺北市,萬華區,1105,436,311,747,85,832,1478,56.29%,29.5%,1
臺北市,萬華區,1106,442,290,732,57,789,1462,53.97%,30.23%,1
臺北市,萬華區,1107,387,271,658,79,737,1507,48.91%,25.68%,1
臺北市,萬華區,1108,404,314,718,73,791,1347,58.72%,29.99%,1
臺北市,萬華區,1109,376,288,664,62,726,1367,53.11%,27.51%,1
臺北市,萬華區,1110,408,311,719,64,783,1277,61.32%,31.95%,1
臺北市,萬華區,1111,380,283,663,63,726,1395,52.04%,27.24%,1
臺北市,萬華區,1112,376,353,729,59,788,1450,54.34%,25.93%,1
臺北市,萬華區,1113,360,254,614,80,694,1340,51.79%,26.87%,1
臺北市,萬華區,1114,327,265,592,67,659,1242,53.06%,26.33%,1
臺北市,萬華區,1115,340,291,631,84,715,1286,55.6%,26.44%,1
臺北市,萬華區,1116,361,274,635,73,708,1324,53.47%,27.27%,1
臺北市,萬華區,1117,452,328,780,80,860,1619,53.12%,27.92%,1
臺北市,萬華區,1118,330,254,584,92,676,1352,50%,24.41%,1
臺北市,萬華區,1119,398,303,701,62,763,1440,52.99%,27.64%,1
臺北市,萬華區,1120,376,294,670,51,721,1194,60.39%,31.49%,1
臺北市,萬華區,1121,361,258,619,74,693,1083,63.99%,33.33%,1
臺北市,萬華區,1122,343,251,594,85,679,1237,54.89%,27.73%,1
臺北市,萬華區,1123,448,381,829,65,894,1625,55.02%,27.57%,1
臺北市,萬華區,1124,404,315,719,86,805,1324,60.8%,30.51%,1
臺北市,萬華區,1125,417,312,729,67,796,1352,58.88%,30.84%,1
臺北市,萬華區,1126,376,314,690,59,749,2630,28.48%,14.3%,1
臺北市,萬華區,1127,451,387,838,75,913,1504,60.7%,29.99%,1
臺北市,萬華區,1128,370,332,702,75,777,1425,54.53%,25.96%,1
臺北市,萬華區,1129,399,317,716,88,804,1591,50.53%,25.08%,1
臺北市,萬華區,1130,420,305,725,80,805,1474,54.61%,28.49%,1
臺北市,萬華區,1131,408,353,761,88,849,1612,52.67%,25.31%,1
臺北市,萬華區,1132,399,325,724,74,798,1447,55.15%,27.57%,1
臺北市,萬華區,1133,492,326,818,79,897,1491,60.16%,33%,1
臺北市,萬華區,1134,455,359,814,71,885,1500,59%,30.33%,1
臺北市,萬華區,1135,470,382,852,78,930,1582,58.79%,29.71%,1
臺北市,萬華區,1136,438,322,760,74,834,1623,51.39%,26.99%,1
臺北市,萬華區,1137,370,252,622,41,663,1228,53.99%,30.13%,1
臺北市,萬華區,1138,370,268,638,85,723,1268,57.02%,29.18%,1
臺北市,萬華區,1139,370,285,655,76,731,1207,60.56%,30.65%,1
臺北市,萬華區,1140,362,291,653,63,716,1188,60.27%,30.47%,1
臺北市,萬華區,1141,420,318,738,56,794,1474,53.87%,28.49%,1
臺北市,萬華區,1142,365,215,580,39,619,1304,47.47%,27.99%,1
臺北市,萬華區,1143,218,177,395,68,463,1082,42.79%,20.15%,1
臺北市,萬華區,1144,250,250,500,56,556,1052,52.85%,23.76%,1
臺北市,萬華區,1145,300,269,569,61,630,1135,55.51%,26.43%,1
臺北市,萬華區,1146,352,270,622,68,690,1225,56.33%,28.73%,1
臺北市,萬華區,1147,444,308,752,81,833,1583,52.62%,28.05%,1
臺北市,萬華區,1148,379,319,698,90,788,1403,56.17%,27.01%,1
臺北市,萬華區,1149,409,316,725,88,813,1406,57.82%,29.09%,1
臺北市,萬華區,1150,426,316,742,74,816,1401,58.24%,30.41%,1
臺北市,萬華區,1151,358,260,618,83,701,1188,59.01%,30.13%,1
臺北市,萬華區,1152,422,356,778,82,860,1597,53.85%,26.42%,1
臺北市,萬華區,1153,387,315,702,93,795,1290,61.63%,30%,1
臺北市,萬華區,1154,441,364,805,37,842,1746,48.22%,25.26%,1
臺北市,萬華區,1155,409,323,732,44,776,1595,48.65%,25.64%,1
臺北市,萬華區,1156,462,362,824,116,940,1701,55.26%,27.16%,1
臺北市,萬華區,1157,305,280,585,77,662,1339,49.44%,22.78%,1
臺北市,萬華區,1158,353,277,630,104,734,1484,49.46%,23.79%,1
臺北市,萬華區,1159,479,350,829,94,923,1604,57.54%,29.86%,1
臺北市,萬華區,1160,371,272,643,54,697,1197,58.23%,30.99%,1
臺北市,萬華區,1161,361,277,638,97,735,1347,54.57%,26.8%,1
臺北市,萬華區,1162,403,330,733,55,788,1223,64.43%,32.95%,1
臺北市,萬華區,1163,319,244,563,49,612,1036,59.07%,30.79%,1
臺北市,萬華區,1164,317,266,583,78,661,1035,63.86%,30.63%,1
臺北市,萬華區,1165,377,272,649,62,711,1141,62.31%,33.04%,1
臺北市,萬華區,1166,364,324,688,60,748,1271,58.85%,28.64%,1
臺北市,萬華區,1167,388,316,704,105,809,1328,60.92%,29.22%,1
臺北市,萬華區,1168,372,329,701,57,758,1286,58.94%,28.93%,1
臺北市,萬華區,1169,493,395,888,100,988,1679,58.84%,29.36%,1
臺北市,萬華區,1170,474,362,836,76,912,1619,56.33%,29.28%,1
臺北市,萬華區,1171,431,322,753,67,820,1625,50.46%,26.52%,1
臺北市,萬華區,1172,495,390,885,73,958,1623,59.03%,30.5%,1
臺北市,萬華區,1173,375,266,641,80,721,1280,56.33%,29.3%,1
臺北市,萬華區,1174,472,334,806,91,897,1608,55.78%,29.35%,1
臺北市,萬華區,1175,441,338,779,76,855,1453,58.84%,30.35%,1
臺北市,萬華區,1176,474,365,839,64,903,1472,61.35%,32.2%,1
臺北市,萬華區,1177,393,334,727,62,789,1373,57.47%,28.62%,1
臺北市,萬華區,1178,419,269,688,84,772,1394,55.38%,30.06%,1
臺北市,萬華區,1179,427,272,699,47,746,1427,52.28%,29.92%,1
臺北市,萬華區,1180,406,361,767,62,829,1342,61.77%,30.25%,1
臺北市,萬華區,1181,495,346,841,92,933,1569,59.46%,31.55%,1
臺北市,萬華區,1182,408,279,687,75,762,1514,50.33%,26.95%,1
臺北市,萬華區,1183,461,314,775,44,819,1720,47.62%,26.8%,1
臺北市,萬華區,1184,467,363,830,87,917,1461,62.77%,31.96%,1
臺北市,萬華區,1185,361,278,639,52,691,1264,54.67%,28.56%,1
臺北市,萬華區,1186,410,346,756,75,831,1334,62.29%,30.73%,1
臺北市,萬華區,1187,335,474,809,36,845,1446,58.44%,23.17%,1
臺北市,萬華區,1188,362,270,632,54,686,1307,52.49%,27.7%,1
臺北市,萬華區,1189,435,302,737,95,832,1420,58.59%,30.63%,1
臺北市,萬華區,1190,379,313,692,51,743,1427,52.07%,26.56%,1
臺北市,萬華區,1191,296,192,488,54,542,956,56.69%,30.96%,1
臺北市,萬華區,1192,417,311,728,65,793,1352,58.65%,30.84%,1
臺北市,萬華區,1193,434,279,713,68,781,1370,57.01%,31.68%,1
臺北市,萬華區,1194,449,237,686,49,735,1222,60.15%,36.74%,1
臺北市,萬華區,1195,470,254,724,52,776,1375,56.44%,34.18%,1
臺北市,萬華區,1196,507,298,805,53,858,1463,58.65%,34.65%,1
臺北市,萬華區,1197,424,311,735,60,795,1527,52.06%,27.77%,1
臺北市,萬華區,1198,480,259,739,69,808,1485,54.41%,32.32%,1
臺北市,萬華區,1199,636,285,921,58,979,1591,61.53%,39.97%,1
臺北市,萬華區,1200,572,293,865,42,907,1394,65.06%,41.03%,1
臺北市,萬華區,1201,524,317,841,37,878,1522,57.69%,34.43%,1
臺北市,萬華區,1202,631,329,960,42,1002,1661,60.33%,37.99%,1
臺北市,萬華區,1203,562,334,896,40,936,1561,59.96%,36%,1
臺北市,萬華區,1204,559,289,848,59,907,1406,64.51%,39.76%,1
臺北市,萬華區,1205,377,262,639,60,699,1498,46.66%,25.17%,1
臺北市,萬華區,1206,378,251,629,83,712,1478,48.17%,25.58%,1
臺北市,萬華區,1207,358,228,586,77,663,1170,56.67%,30.6%,1
臺北市,萬華區,1208,481,275,756,61,817,1376,59.38%,34.96%,1
臺北市,萬華區,1209,357,226,583,30,613,1093,56.08%,32.66%,1
臺北市,萬華區,1210,380,237,617,69,686,1084,63.28%,35.06%,1
臺北市,萬華區,1211,362,245,607,69,676,1119,60.41%,32.35%,1
臺北市,萬華區,1212,497,305,802,52,854,1381,61.84%,35.99%,1
臺北市,萬華區,1213,427,334,761,54,815,1396,58.38%,30.59%,1
臺北市,文山區,1402,469,335,804,62,866,1539,56.27%,30.47%,1
臺北市,文山區,1403,504,272,776,43,819,1548,52.91%,32.56%,1
臺北市,文山區,1404,489,347,836,73,909,1493,60.88%,32.75%,1
臺北市,文山區,1405,551,384,935,64,999,1648,60.62%,33.43%,1
臺北市,文山區,1406,519,314,833,65,898,1544,58.16%,33.61%,1
臺北市,文山區,1407,523,323,846,63,909,1557,58.38%,33.59%,1
臺北市,文山區,1408,491,313,804,47,851,1514,56.21%,32.43%,1
臺北市,文山區,1409,577,349,926,63,989,1540,64.22%,37.47%,1
臺北市,文山區,1410,503,354,857,54,911,1466,62.14%,34.31%,1
臺北市,文山區,1411,534,306,840,57,897,1444,62.12%,36.98%,1
臺北市,文山區,1412,466,337,803,84,887,1455,60.96%,32.03%,1
臺北市,文山區,1413,462,285,747,61,808,1440,56.11%,32.08%,1
臺北市,文山區,1414,483,315,798,69,867,1398,62.02%,34.55%,1
臺北市,文山區,1415,443,311,754,30,784,1412,55.52%,31.37%,1
臺北市,文山區,1416,451,314,765,63,828,1426,58.06%,31.63%,1
臺北市,文山區,1417,447,336,783,61,844,1437,58.73%,31.11%,1
臺北市,文山區,1418,413,327,740,73,813,1340,60.67%,30.82%,1
臺北市,文山區,1419,530,332,862,46,908,1568,57.91%,33.8%,1
臺北市,文山區,1420,462,294,756,47,803,1372,58.53%,33.67%,1
臺北市,文山區,1421,336,236,572,40,612,1046,58.51%,32.12%,1
臺北市,文山區,1422,445,277,722,50,772,1274,60.6%,34.93%,1
臺北市,文山區,1423,453,289,742,40,782,1324,59.06%,34.21%,1
臺北市,文山區,1424,573,364,937,76,1013,1722,58.83%,33.28%,1
臺北市,文山區,1425,632,345,977,67,1044,1737,60.1%,36.38%,1
臺北市,文山區,1426,523,310,833,28,861,1370,62.85%,38.18%,1
臺北市,文山區,1427,497,308,805,78,883,1495,59.06%,33.24%,1
臺北市,文山區,1428,447,283,730,71,801,1328,60.32%,33.66%,1
臺北市,文山區,1429,387,260,647,61,708,1138,62.21%,34.01%,1
臺北市,文山區,1430,559,296,855,37,892,1471,60.64%,38%,1
臺北市,文山區,1431,403,281,684,33,717,1144,62.67%,35.23%,1
臺北市,文山區,1432,437,267,704,57,761,1176,64.71%,37.16%,1
臺北市,文山區,1433,430,290,720,54,774,1212,63.86%,35.48%,1
臺北市,文山區,1434,420,297,717,49,766,1214,63.1%,34.6%,1
臺北市,文山區,1435,361,264,625,50,675,1170,57.69%,30.85%,1
臺北市,文山區,1436,434,311,745,59,804,1308,61.47%,33.18%,1
臺北市,文山區,1437,405,262,667,62,729,1190,61.26%,34.03%,1
臺北市,文山區,1438,385,249,634,58,692,1110,62.34%,34.68%,1
臺北市,文山區,1439,524,311,835,56,891,1512,58.93%,34.66%,1
臺北市,文山區,1440,551,253,804,61,865,1387,62.36%,39.73%,1
臺北市,文山區,1441,459,303,762,53,815,1355,60.15%,33.87%,1
臺北市,文山區,1442,442,312,754,76,830,1370,60.58%,32.26%,1
臺北市,文山區,1443,485,332,817,70,887,1484,59.77%,32.68%,1
臺北市,文山區,1444,576,392,968,86,1054,1786,59.01%,32.25%,1
臺北市,文山區,1445,443,265,708,62,770,1260,61.11%,35.16%,1
臺北市,文山區,1446,471,269,740,39,779,1194,65.24%,39.45%,1
臺北市,文山區,1447,472,331,803,69,872,1444,60.39%,32.69%,1
臺北市,文山區,1448,534,311,845,55,900,1495,60.2%,35.72%,1
臺北市,文山區,1449,560,264,824,68,892,1446,61.69%,38.73%,1
臺北市,文山區,1450,458,312,770,88,858,1450,59.17%,31.59%,1
臺北市,文山區,1451,539,311,850,60,910,1486,61.24%,36.27%,1
臺北市,文山區,1452,416,294,710,43,753,1259,59.81%,33.04%,1
臺北市,文山區,1453,478,293,771,36,807,1317,61.28%,36.29%,1
臺北市,文山區,1454,461,321,782,46,828,1321,62.68%,34.9%,1
臺北市,文山區,1455,511,303,814,53,867,1475,58.78%,34.64%,1
臺北市,文山區,1456,426,262,688,49,737,1271,57.99%,33.52%,1
臺北市,文山區,1457,542,376,918,53,971,1609,60.35%,33.69%,1
臺北市,文山區,1458,501,284,785,42,827,1501,55.1%,33.38%,1
臺北市,文山區,1459,314,187,501,48,549,997,55.07%,31.49%,1
臺北市,文山區,1460,396,241,637,49,686,1052,65.21%,37.64%,1
臺北市,文山區,1461,459,268,727,40,767,1247,61.51%,36.81%,1
臺北市,文山區,1462,405,257,662,62,724,1167,62.04%,34.7%,1
臺北市,文山區,1463,478,264,742,43,785,1280,61.33%,37.34%,1
臺北市,文山區,1464,404,276,680,37,717,1153,62.19%,35.04%,1
臺北市,文山區,1465,540,356,896,59,955,1557,61.34%,34.68%,1
臺北市,文山區,1466,521,284,805,71,876,1444,60.66%,36.08%,1
臺北市,文山區,1467,593,291,884,58,942,1459,64.56%,40.64%,1
臺北市,文山區,1468,514,307,821,49,870,1357,64.11%,37.88%,1
臺北市,文山區,1469,437,309,746,52,798,1194,66.83%,36.6%,1
臺北市,文山區,1470,408,285,693,63,756,1184,63.85%,34.46%,1
臺北市,文山區,1471,405,268,673,48,721,1119,64.43%,36.19%,1
臺北市,文山區,1472,458,322,780,74,854,1350,63.26%,33.93%,1
臺北市,文山區,1473,466,317,783,63,846,1502,56.32%,31.03%,1
臺北市,文山區,1474,524,307,831,74,905,1511,59.89%,34.68%,1
臺北市,文山區,1475,534,357,891,48,939,1481,63.4%,36.06%,1
臺北市,文山區,1476,553,327,880,58,938,1477,63.51%,37.44%,1
臺北市,文山區,1477,441,310,751,54,805,1294,62.21%,34.08%,1
臺北市,文山區,1478,408,270,678,32,710,1040,68.27%,39.23%,1
臺北市,文山區,1479,484,293,777,58,835,1323,63.11%,36.58%,1
臺北市,文山區,1480,393,267,660,57,717,1153,62.19%,34.08%,1
臺北市,文山區,1481,551,289,840,67,907,1525,59.48%,36.13%,1
臺北市,文山區,1482,441,280,721,59,780,1412,55.24%,31.23%,1
臺北市,文山區,1483,540,353,893,44,937,1473,63.61%,36.66%,1
臺北市,文山區,1484,517,336,853,47,900,1486,60.57%,34.79%,1
臺北市,文山區,1485,628,326,954,61,1015,1616,62.81%,38.86%,1
臺北市,文山區,1486,538,343,881,71,952,1489,63.94%,36.13%,1
臺北市,文山區,1487,493,286,779,68,847,1414,59.9%,34.87%,1
臺北市,文山區,1488,538,356,894,68,962,1494,64.39%,36.01%,1
臺北市,文山區,1489,531,357,888,72,960,1547,62.06%,34.32%,1
臺北市,文山區,1490,550,351,901,69,970,1587,61.12%,34.66%,1
臺北市,文山區,1491,605,322,927,45,972,1515,64.16%,39.93%,1
臺北市,文山區,1492,594,332,926,61,987,1573,62.75%,37.76%,1
臺北市,文山區,1493,572,343,915,48,963,1542,62.45%,37.09%,1
臺北市,文山區,1494,465,266,731,71,802,1465,54.74%,31.74%,1
臺北市,文山區,1495,177,126,303,42,345,699,49.36%,25.32%,1
臺北市,文山區,1496,377,260,637,70,707,1372,51.53%,27.48%,1
臺北市,文山區,1497,408,289,697,59,756,1448,52.21%,28.18%,1
臺北市,文山區,1498,499,373,872,49,921,1548,59.5%,32.24%,1
臺北市,文山區,1499,480,363,843,59,902,1501,60.09%,31.98%,1
臺北市,文山區,1500,583,310,893,55,948,1560,60.77%,37.37%,1
臺北市,文山區,1501,548,320,868,52,920,1567,58.71%,34.97%,1
臺北市,文山區,1502,530,332,862,58,920,1554,59.2%,34.11%,1
臺北市,文山區,1503,535,317,852,65,917,1544,59.39%,34.65%,1
臺北市,文山區,1504,614,260,874,51,925,1528,60.54%,40.18%,1
臺北市,文山區,1505,587,327,914,48,962,1543,62.35%,38.04%,1
臺北市,文山區,1506,544,345,889,72,961,2754,34.89%,19.75%,1
臺北市,文山區,1507,488,308,796,98,894,1709,52.31%,28.55%,1
臺北市,文山區,1508,445,346,791,81,872,1515,57.56%,29.37%,1
臺北市,文山區,1509,490,316,806,69,875,1571,55.7%,31.19%,1
臺北市,文山區,1510,505,333,838,75,913,1578,57.86%,32%,1
臺北市,文山區,1511,536,235,771,52,823,1454,56.6%,36.86%,1
臺北市,文山區,1512,505,291,796,63,859,1436,59.82%,35.17%,1
臺北市,文山區,1513,493,334,827,60,887,1402,63.27%,35.16%,1
臺北市,文山區,1514,381,257,638,53,691,1117,61.86%,34.11%,1
臺北市,文山區,1515,353,234,587,63,650,1094,59.41%,32.27%,1
臺北市,文山區,1516,426,206,632,57,689,1070,64.39%,39.81%,1
臺北市,文山區,1517,521,283,804,43,847,1319,64.22%,39.5%,1
臺北市,文山區,1518,459,283,742,52,794,1226,64.76%,37.44%,1
臺北市,文山區,1519,466,277,743,53,796,1385,57.47%,33.65%,1
臺北市,文山區,1520,499,298,797,62,859,1416,60.66%,35.24%,1
臺北市,文山區,1521,530,315,845,63,908,1412,64.31%,37.54%,1
臺北市,文山區,1522,471,342,813,71,884,1535,57.59%,30.68%,1
臺北市,文山區,1523,640,351,991,62,1053,1654,63.66%,38.69%,1
臺北市,文山區,1524,428,257,685,43,728,1156,62.98%,37.02%,1
臺北市,文山區,1525,447,239,686,46,732,1231,59.46%,36.31%,1
臺北市,文山區,1526,400,282,682,46,728,1218,59.77%,32.84%,1
臺北市,文山區,1527,456,268,724,36,760,1176,64.63%,38.78%,1
臺北市,文山區,1528,472,342,814,4,818,1392,58.76%,33.91%,1
臺北市,文山區,1529,410,292,702,87,789,1323,59.64%,30.99%,1
臺北市,文山區,1530,421,279,700,48,748,1297,57.67%,32.46%,1
臺北市,文山區,1531,460,290,750,63,813,1296,62.73%,35.49%,1
臺北市,文山區,1532,514,359,873,62,935,1613,57.97%,31.87%,1
臺北市,文山區,1533,577,367,944,91,1035,1697,60.99%,34%,1
臺北市,文山區,1534,496,375,871,75,946,1579,59.91%,31.41%,1
臺北市,文山區,1535,484,303,787,59,846,1320,64.09%,36.67%,1
臺北市,文山區,1536,476,304,780,49,829,1438,57.65%,33.1%,1
臺北市,文山區,1537,453,294,747,37,784,1465,53.52%,30.92%,1
臺北市,文山區,1538,531,390,921,72,993,1646,60.33%,32.26%,1
臺北市,文山區,1539,425,299,724,60,784,1286,60.96%,33.05%,1
臺北市,文山區,1540,431,272,703,46,749,1219,61.44%,35.36%,1
臺北市,文山區,1541,463,304,767,45,812,1292,62.85%,35.84%,1
臺北市,文山區,1542,481,310,791,64,855,1489,57.42%,32.3%,1
臺北市,文山區,1543,562,355,917,67,984,1611,61.08%,34.89%,1
臺北市,文山區,1544,423,227,650,65,715,1549,46.16%,27.31%,1
臺北市,文山區,1545,545,339,884,65,949,1678,56.56%,32.48%,1
臺北市,文山區,1546,529,354,883,72,955,1660,57.53%,31.87%,1
臺北市,文山區,1547,516,343,859,51,910,1816,50.11%,28.41%,1
臺北市,文山區,1548,267,260,527,42,569,985,57.77%,27.11%,1
臺北市,文山區,1549,507,269,776,32,808,1314,61.49%,38.58%,1
臺北市,文山區,1550,382,230,612,50,662,1018,65.03%,37.52%,1
臺北市,文山區,1551,560,331,891,52,943,1578,59.76%,35.49%,1
臺北市,文山區,1552,502,304,806,52,858,1457,58.89%,34.45%,1
臺北市,文山區,1553,485,275,760,49,809,1326,61.01%,36.58%,1
臺北市,文山區,1554,495,301,796,65,861,1393,61.81%,35.53%,1
臺北市,文山區,1555,411,322,733,56,789,1377,57.3%,29.85%,1
臺北市,文山區,1556,452,357,809,59,868,1448,59.94%,31.22%,1
臺北市,文山區,1557,529,338,867,54,921,1447,63.65%,36.56%,1
臺北市,文山區,1558,652,412,1064,68,1132,1739,65.09%,37.49%,1
臺北市,文山區,1559,511,322,833,48,881,1457,60.47%,35.07%,1
臺北市,文山區,1560,438,297,735,60,795,1288,61.72%,34.01%,1
臺北市,文山區,1561,360,286,646,67,713,1301,54.8%,27.67%,1
臺北市,文山區,1562,220,179,399,75,474,865,54.8%,25.43%,1
臺北市,文山區,1563,218,183,401,39,440,789,55.77%,27.63%,1
臺北市,南港區,0455,345,292,637,33,670,1280,52.34%,26.95%,1
臺北市,南港區,0456,407,303,710,38,748,1351,55.37%,30.13%,1
臺北市,南港區,0457,453,284,737,49,786,1345,58.44%,33.68%,1
臺北市,南港區,0458,395,310,705,48,753,1679,44.85%,23.53%,1
臺北市,南港區,0459,448,375,823,63,886,1680,52.74%,26.67%,1
臺北市,南港區,0460,427,340,767,75,842,1635,51.5%,26.12%,1
臺北市,南港區,0461,434,316,750,65,815,1459,55.86%,29.75%,1
臺北市,南港區,0462,601,353,954,37,991,1706,58.09%,35.23%,1
臺北市,南港區,0463,482,365,847,54,901,1674,53.82%,28.79%,1
臺北市,南港區,0464,487,311,798,36,834,1491,55.94%,32.66%,1
臺北市,南港區,0465,356,291,647,57,704,1086,64.83%,32.78%,1
臺北市,南港區,0466,412,297,709,73,782,1202,65.06%,34.28%,1
臺北市,南港區,0467,356,308,664,59,723,1198,60.35%,29.72%,1
臺北市,南港區,0468,418,298,716,34,750,1430,52.45%,29.23%,1
臺北市,南港區,0469,410,319,729,58,787,1275,61.73%,32.16%,1
臺北市,南港區,0470,456,353,809,63,872,1344,64.88%,33.93%,1
臺北市,南港區,0471,460,332,792,43,835,1391,60.03%,33.07%,1
臺北市,南港區,0472,470,314,784,40,824,1342,61.4%,35.02%,1
臺北市,南港區,0473,443,264,707,58,765,1389,55.08%,31.89%,1
臺北市,南港區,0474,457,360,817,46,863,1426,60.52%,32.05%,1
臺北市,南港區,0475,494,278,772,42,814,1359,59.9%,36.35%,1
臺北市,南港區,0476,399,320,719,73,792,1366,57.98%,29.21%,1
臺北市,南港區,0477,501,308,809,39,848,1441,58.85%,34.77%,1
臺北市,南港區,0478,430,335,765,73,838,1529,54.81%,28.12%,1
臺北市,南港區,0479,442,332,774,85,859,1618,53.09%,27.32%,1
臺北市,南港區,0480,393,287,680,85,765,1545,49.51%,25.44%,1
臺北市,南港區,0481,500,334,834,65,899,1569,57.3%,31.87%,1
臺北市,南港區,0482,466,350,816,50,866,1661,52.14%,28.06%,1
臺北市,南港區,0483,420,304,724,74,798,1518,52.57%,27.67%,1
臺北市,南港區,0484,501,383,884,69,953,1552,61.4%,32.28%,1
臺北市,南港區,0485,502,331,833,38,871,1658,52.53%,30.28%,1
臺北市,南港區,0486,485,372,857,75,932,1608,57.96%,30.16%,1
臺北市,南港區,0487,428,316,744,51,795,1475,53.9%,29.02%,1
臺北市,南港區,0488,593,397,990,60,1050,1722,60.98%,34.44%,1
臺北市,南港區,0489,501,362,863,33,896,1383,64.79%,36.23%,1
臺北市,南港區,0490,417,342,759,100,859,1397,61.49%,29.85%,1
臺北市,南港區,0491,465,310,775,40,815,1352,60.28%,34.39%,1
臺北市,南港區,0492,420,342,762,50,812,1344,60.42%,31.25%,1
臺北市,南港區,0493,388,313,701,39,740,1385,53.43%,28.01%,1
臺北市,南港區,0494,448,307,755,42,797,1399,56.97%,32.02%,1
臺北市,南港區,0495,393,305,698,40,738,1381,53.44%,28.46%,1
臺北市,南港區,0496,476,324,800,51,851,1548,54.97%,30.75%,1
臺北市,南港區,0497,348,278,626,37,663,1190,55.71%,29.24%,1
臺北市,南港區,0498,474,347,821,50,871,1490,58.46%,31.81%,1
臺北市,南港區,0499,354,274,628,42,670,1096,61.13%,32.3%,1
臺北市,南港區,0500,417,301,718,45,763,1238,61.63%,33.68%,1
臺北市,南港區,0501,426,319,745,39,784,1271,61.68%,33.52%,1
臺北市,南港區,0502,368,241,609,59,668,1146,58.29%,32.11%,1
臺北市,南港區,0503,376,285,661,48,709,1232,57.55%,30.52%,1
臺北市,南港區,0504,497,291,788,41,829,1649,50.27%,30.14%,1
臺北市,南港區,0505,571,359,930,60,990,1688,58.65%,33.83%,1
臺北市,南港區,0506,510,348,858,36,894,1503,59.48%,33.93%,1
臺北市,南港區,0507,459,369,828,39,867,1542,56.23%,29.77%,1
臺北市,南港區,0508,485,333,818,56,874,1463,59.74%,33.15%,1
臺北市,南港區,0509,391,286,677,85,762,1195,63.77%,32.72%,1
臺北市,南港區,0510,389,333,722,33,755,1254,60.21%,31.02%,1
臺北市,南港區,0511,458,292,750,50,800,1356,59%,33.78%,1
臺北市,南港區,0512,409,343,752,96,848,1363,62.22%,30.01%,1
臺北市,南港區,0513,477,294,771,65,836,1317,63.48%,36.22%,1
臺北市,南港區,0514,451,284,735,36,771,1331,57.93%,33.88%,1
臺北市,南港區,0515,501,354,855,85,940,1610,58.39%,31.12%,1
臺北市,南港區,0516,479,323,802,46,848,1542,54.99%,31.06%,1
臺北市,南港區,0517,507,345,852,84,936,1581,59.2%,32.07%,1
臺北市,南港區,0518,324,288,612,52,664,1225,54.2%,26.45%,1
臺北市,南港區,0519,472,302,774,62,836,1264,66.14%,37.34%,1
臺北市,南港區,0520,381,525,906,112,1018,1649,61.73%,23.1%,1
臺北市,南港區,0521,461,275,736,24,760,1267,59.98%,36.39%,1
臺北市,南港區,0522,425,280,705,66,771,1336,57.71%,31.81%,1
臺北市,南港區,0523,400,287,687,34,721,1162,62.05%,34.42%,1
臺北市,南港區,0524,363,228,591,25,616,1045,58.95%,34.74%,1
臺北市,南港區,0525,502,324,826,68,894,1351,66.17%,37.16%,1
臺北市,南港區,0526,440,296,736,41,777,1358,57.22%,32.4%,1
臺北市,內湖區,0305,466,333,799,50,849,1661,51.11%,28.06%,1
臺北市,內湖區,0306,459,350,809,83,892,1602,55.68%,28.65%,1
臺北市,內湖區,0307,515,411,926,99,1025,1655,61.93%,31.12%,1
臺北市,內湖區,0308,532,368,900,58,958,1582,60.56%,33.63%,1
臺北市,內湖區,0309,527,348,875,46,921,1688,54.56%,31.22%,1
臺北市,內湖區,0310,573,359,932,62,994,1737,57.23%,32.99%,1
臺北市,內湖區,0311,609,380,989,76,1065,1809,58.87%,33.67%,1
臺北市,內湖區,0312,454,273,727,57,784,1376,56.98%,32.99%,1
臺北市,內湖區,0313,592,328,920,140,1060,1747,60.68%,33.89%,1
臺北市,內湖區,0314,546,362,908,39,947,1389,68.18%,39.31%,1
臺北市,內湖區,0315,485,364,849,54,903,1454,62.1%,33.36%,1
臺北市,內湖區,0316,508,387,895,47,942,1468,64.17%,34.6%,1
臺北市,內湖區,0317,578,386,964,48,1012,1603,63.13%,36.06%,1
臺北市,內湖區,0318,575,381,956,37,993,1795,55.32%,32.03%,1
臺北市,內湖區,0319,597,414,1011,72,1083,1737,62.35%,34.37%,1
臺北市,內湖區,0320,589,376,965,83,1048,1744,60.09%,33.77%,1
臺北市,內湖區,0321,567,343,910,77,987,1661,59.42%,34.14%,1
臺北市,內湖區,0322,488,369,857,60,917,1577,58.15%,30.94%,1
臺北市,內湖區,0323,450,410,860,43,903,1494,60.44%,30.12%,1
臺北市,內湖區,0324,511,385,896,65,961,1626,59.1%,31.43%,1
臺北市,內湖區,0325,543,347,890,83,973,1641,59.29%,33.09%,1
臺北市,內湖區,0326,513,327,840,65,905,1554,58.24%,33.01%,1
臺北市,內湖區,0327,556,415,971,84,1055,1728,61.05%,32.18%,1
臺北市,內湖區,0328,574,351,925,64,989,1736,56.97%,33.06%,1
臺北市,內湖區,0329,542,343,885,52,937,1461,64.13%,37.1%,1
臺北市,內湖區,0330,594,248,842,45,887,1509,58.78%,39.36%,1
臺北市,內湖區,0331,442,293,735,51,786,1358,57.88%,32.55%,1
臺北市,內湖區,0332,558,366,924,63,987,1761,56.05%,31.69%,1
臺北市,內湖區,0333,558,358,916,39,955,1651,57.84%,33.8%,1
臺北市,內湖區,0334,601,403,1004,79,1083,1809,59.87%,33.22%,1
臺北市,內湖區,0335,607,361,968,70,1038,1773,58.54%,34.24%,1
臺北市,內湖區,0336,627,376,1003,50,1053,1890,55.71%,33.17%,1
臺北市,內湖區,0337,634,426,1060,75,1135,1760,64.49%,36.02%,1
臺北市,內湖區,0338,584,349,933,43,976,1645,59.33%,35.5%,1
臺北市,內湖區,0339,368,318,686,37,723,1324,54.61%,27.79%,1
臺北市,內湖區,0340,376,243,619,44,663,1072,61.85%,35.07%,1
臺北市,內湖區,0341,512,313,825,37,862,1509,57.12%,33.93%,1
臺北市,內湖區,0342,518,402,920,73,993,1715,57.9%,30.2%,1
臺北市,內湖區,0343,551,433,984,57,1041,1774,58.68%,31.06%,1
臺北市,內湖區,0344,651,410,1061,65,1126,1796,62.69%,36.25%,1
臺北市,內湖區,0345,570,387,957,52,1009,1784,56.56%,31.95%,1
臺北市,內湖區,0346,445,381,826,58,884,1417,62.39%,31.4%,1
臺北市,內湖區,0347,526,411,937,38,975,1699,57.39%,30.96%,1
臺北市,內湖區,0348,529,490,1019,62,1081,1719,62.89%,30.77%,1
臺北市,內湖區,0349,557,392,949,47,996,1715,58.08%,32.48%,1
臺北市,內湖區,0350,489,314,803,47,850,1634,52.02%,29.93%,1
臺北市,內湖區,0351,414,328,742,70,812,1435,56.59%,28.85%,1
臺北市,內湖區,0352,426,332,758,51,809,1440,56.18%,29.58%,1
臺北市,內湖區,0353,510,345,855,38,893,1446,61.76%,35.27%,1
臺北市,內湖區,0354,451,328,779,74,853,1657,51.48%,27.22%,1
臺北市,內湖區,0355,393,306,699,78,777,1261,61.62%,31.17%,1
臺北市,內湖區,0356,91,102,193,45,238,456,52.19%,19.96%,1
臺北市,內湖區,0357,568,329,897,45,942,1433,65.74%,39.64%,1
臺北市,內湖區,0358,472,375,847,46,893,1485,60.13%,31.78%,1
臺北市,內湖區,0359,488,372,860,57,917,1590,57.67%,30.69%,1
臺北市,內湖區,0360,415,303,718,68,786,1219,64.48%,34.04%,1
臺北市,內湖區,0361,538,354,892,78,970,1732,56%,31.06%,1
臺北市,內湖區,0362,568,401,969,37,1006,1727,58.25%,32.89%,1
臺北市,內湖區,0363,508,386,894,68,962,1637,58.77%,31.03%,1
臺北市,內湖區,0364,482,312,794,42,836,1453,57.54%,33.17%,1
臺北市,內湖區,0365,512,341,853,52,905,1617,55.97%,31.66%,1
臺北市,內湖區,0366,523,334,857,50,907,1604,56.55%,32.61%,1
臺北市,內湖區,0367,495,366,861,38,899,1406,63.94%,35.21%,1
臺北市,內湖區,0368,452,312,764,47,811,1353,59.94%,33.41%,1
臺北市,內湖區,0369,623,365,988,65,1053,1724,61.08%,36.14%,1
臺北市,內湖區,0370,485,300,785,52,837,1378,60.74%,35.2%,1
臺北市,內湖區,0371,491,322,813,45,858,1403,61.15%,35%,1
臺北市,內湖區,0372,500,327,827,48,875,1547,56.56%,32.32%,1
臺北市,內湖區,0373,579,375,954,68,1022,1718,59.49%,33.7%,1
臺北市,內湖區,0374,581,395,976,66,1042,1813,57.47%,32.05%,1
臺北市,內湖區,0375,614,425,1039,83,1122,1791,62.65%,34.28%,1
臺北市,內湖區,0376,641,430,1071,61,1132,1855,61.02%,34.56%,1
臺北市,內湖區,0377,599,368,967,40,1007,1731,58.17%,34.6%,1
臺北市,內湖區,0378,551,418,969,61,1030,1593,64.66%,34.59%,1
臺北市,內湖區,0379,590,365,955,58,1013,1869,54.2%,31.57%,1
臺北市,內湖區,0380,561,394,955,62,1017,1687,60.28%,33.25%,1
臺北市,內湖區,0381,538,327,865,39,904,1530,59.08%,35.16%,1
臺北市,內湖區,0382,461,278,739,63,802,1300,61.69%,35.46%,1
臺北市,內湖區,0383,471,319,790,56,846,1314,64.38%,35.84%,1
臺北市,內湖區,0384,383,309,692,46,738,1433,51.5%,26.73%,1
臺北市,內湖區,0385,437,315,752,42,794,1450,54.76%,30.14%,1
臺北市,內湖區,0386,528,325,853,69,922,1608,57.34%,32.84%,1
臺北市,內湖區,0387,429,346,775,63,838,1414,59.26%,30.34%,1
臺北市,內湖區,0388,493,319,812,57,869,1492,58.24%,33.04%,1
臺北市,內湖區,0389,416,350,766,39,805,1528,52.68%,27.23%,1
臺北市,內湖區,0390,540,390,930,56,986,1692,58.27%,31.91%,1
臺北市,內湖區,0391,464,397,861,60,921,1556,59.19%,29.82%,1
臺北市,內湖區,0392,477,361,838,55,893,1637,54.55%,29.14%,1
臺北市,內湖區,0393,533,387,920,43,963,1749,55.06%,30.47%,1
臺北市,內湖區,0394,365,267,632,48,680,1220,55.74%,29.92%,1
臺北市,內湖區,0395,503,343,846,80,926,1600,57.88%,31.44%,1
臺北市,內湖區,0396,469,320,789,65,854,1473,57.98%,31.84%,1
臺北市,內湖區,0397,469,320,789,70,859,1498,57.34%,31.31%,1
臺北市,內湖區,0398,504,339,843,52,895,1557,57.48%,32.37%,1
臺北市,內湖區,0399,518,339,857,46,903,1674,53.94%,30.94%,1
臺北市,內湖區,0400,565,414,979,65,1044,1728,60.42%,32.7%,1
臺北市,內湖區,0401,171,154,325,76,401,788,50.89%,21.7%,1
臺北市,內湖區,0402,443,330,773,87,860,1542,55.77%,28.73%,1
臺北市,內湖區,0403,417,355,772,65,837,1676,49.94%,24.88%,1
臺北市,內湖區,0404,358,307,665,42,707,1360,51.99%,26.32%,1
臺北市,內湖區,0405,462,291,753,37,790,1259,62.75%,36.7%,1
臺北市,內湖區,0406,428,265,693,23,716,1301,55.03%,32.9%,1
臺北市,內湖區,0407,323,272,595,47,642,1251,51.32%,25.82%,1
臺北市,內湖區,0408,484,294,778,76,854,1502,56.86%,32.22%,1
臺北市,內湖區,0409,518,334,852,47,899,1596,56.33%,32.46%,1
臺北市,內湖區,0410,518,391,909,36,945,1649,57.31%,31.41%,1
臺北市,內湖區,0411,559,342,901,78,979,1774,55.19%,31.51%,1
臺北市,內湖區,0412,544,339,883,51,934,1746,53.49%,31.16%,1
臺北市,內湖區,0413,474,302,776,34,810,1473,54.99%,32.18%,1
臺北市,內湖區,0414,533,366,899,76,975,2824,34.53%,18.87%,1
臺北市,內湖區,0415,490,407,897,60,957,1849,51.76%,26.5%,1
臺北市,內湖區,0416,477,297,774,79,853,1530,55.75%,31.18%,1
臺北市,內湖區,0417,485,402,887,60,947,1656,57.19%,29.29%,1
臺北市,內湖區,0418,465,343,808,49,857,1457,58.82%,31.91%,1
臺北市,內湖區,0419,578,382,960,59,1019,1695,60.12%,34.1%,1
臺北市,內湖區,0420,565,368,933,58,991,1663,59.59%,33.97%,1
臺北市,內湖區,0421,506,382,888,60,948,1654,57.32%,30.59%,1
臺北市,內湖區,0422,569,350,919,67,986,1642,60.05%,34.65%,1
臺北市,內湖區,0423,557,355,912,45,957,1685,56.8%,33.06%,1
臺北市,內湖區,0424,566,408,974,72,1046,1862,56.18%,30.4%,1
臺北市,內湖區,0425,648,435,1083,57,1140,1900,60%,34.11%,1
臺北市,內湖區,0426,677,398,1075,64,1139,1790,63.63%,37.82%,1
臺北市,內湖區,0427,423,313,736,76,812,1417,57.3%,29.85%,1
臺北市,內湖區,0428,520,385,905,66,971,1694,57.32%,30.7%,1
臺北市,內湖區,0429,500,400,900,88,988,1676,58.95%,29.83%,1
臺北市,內湖區,0430,528,366,894,33,927,1643,56.42%,32.14%,1
臺北市,內湖區,0431,548,332,880,57,937,1588,59.01%,34.51%,1
臺北市,內湖區,0432,539,364,903,60,963,1603,60.07%,33.62%,1
臺北市,內湖區,0433,545,333,878,78,956,1629,58.69%,33.46%,1
臺北市,內湖區,0434,597,365,962,53,1015,1646,61.66%,36.27%,1
臺北市,內湖區,0435,633,355,988,54,1042,1883,55.34%,33.62%,1
臺北市,內湖區,0436,475,305,780,46,826,1434,57.6%,33.12%,1
臺北市,內湖區,0437,452,309,761,50,811,1418,57.19%,31.88%,1
臺北市,內湖區,0438,456,291,747,72,819,1373,59.65%,33.21%,1
臺北市,內湖區,0439,453,296,749,68,817,1349,60.56%,33.58%,1
臺北市,內湖區,0440,521,353,874,58,932,1511,61.68%,34.48%,1
臺北市,內湖區,0441,545,355,900,72,972,1563,62.19%,34.87%,1
臺北市,內湖區,0442,497,356,853,59,912,1550,58.84%,32.06%,1
臺北市,內湖區,0443,330,277,607,52,659,1157,56.96%,28.52%,1
臺北市,內湖區,0444,544,430,974,60,1034,1768,58.48%,30.77%,1
臺北市,內湖區,0445,535,373,908,64,972,1664,58.41%,32.15%,1
臺北市,內湖區,0446,563,372,935,92,1027,1743,58.92%,32.3%,1
臺北市,內湖區,0447,493,359,852,26,878,1480,59.32%,33.31%,1
臺北市,內湖區,0448,527,401,928,63,991,1589,62.37%,33.17%,1
臺北市,內湖區,0449,443,316,759,34,793,1371,57.84%,32.31%,1
臺北市,內湖區,0450,585,344,929,55,984,1575,62.48%,37.14%,1
臺北市,內湖區,0451,470,307,777,26,803,1377,58.32%,34.13%,1
臺北市,內湖區,0452,566,353,919,71,990,1469,67.39%,38.53%,1
臺北市,內湖區,0453,561,359,920,32,952,1529,62.26%,36.69%,1
臺北市,內湖區,0454,537,388,925,73,998,1649,60.52%,32.57%,1
臺北市,士林區,0142,480,381,861,89,950,1695,56.05%,28.32%,1
臺北市,士林區,0143,498,404,902,112,1014,1720,58.95%,28.95%,1
臺北市,士林區,0144,385,264,649,95,744,1288,57.76%,29.89%,1
臺北市,士林區,0145,459,336,795,71,866,1546,56.02%,29.69%,1
臺北市,士林區,0146,222,157,379,34,413,652,63.34%,34.05%,1
臺北市,士林區,0147,253,186,439,45,484,870,55.63%,29.08%,1
臺北市,士林區,0148,347,308,655,56,711,1137,62.53%,30.52%,1
臺北市,士林區,0149,356,252,608,62,670,1050,63.81%,33.9%,1
臺北市,士林區,0150,324,250,574,68,642,1031,62.27%,31.43%,1
臺北市,士林區,0151,340,272,612,32,644,1075,59.91%,31.63%,1
臺北市,士林區,0152,265,205,470,52,522,2175,24%,12.18%,1
臺北市,士林區,0153,553,336,889,56,945,1775,53.24%,31.15%,1
臺北市,士林區,0154,578,339,917,67,984,1669,58.96%,34.63%,1
臺北市,士林區,0155,514,412,926,89,1015,1665,60.96%,30.87%,1
臺北市,士林區,0156,551,390,941,83,1024,1648,62.14%,33.43%,1
臺北市,士林區,0157,403,287,690,36,726,1246,58.27%,32.34%,1
臺北市,士林區,0158,368,377,745,71,816,1419,57.51%,25.93%,1
臺北市,士林區,0159,361,334,695,84,779,1327,58.7%,27.2%,1
臺北市,士林區,0160,450,411,861,78,939,1573,59.69%,28.61%,1
臺北市,士林區,0161,454,324,778,95,873,1470,59.39%,30.88%,1
臺北市,士林區,0162,536,411,947,51,998,1775,56.23%,30.2%,1
臺北市,士林區,0163,537,424,961,62,1023,1692,60.46%,31.74%,1
臺北市,士林區,0164,573,429,1002,67,1069,1842,58.03%,31.11%,1
臺北市,士林區,0165,370,280,650,63,713,1166,61.15%,31.73%,1
臺北市,士林區,0166,438,353,791,95,886,1687,52.52%,25.96%,1
臺北市,士林區,0167,506,354,860,72,932,1624,57.39%,31.16%,1
臺北市,士林區,0168,450,364,814,108,922,1477,62.42%,30.47%,1
臺北市,士林區,0169,380,311,691,71,762,1250,60.96%,30.4%,1
臺北市,士林區,0170,410,336,746,110,856,1434,59.69%,28.59%,1
臺北市,士林區,0171,445,321,766,51,817,1452,56.27%,30.65%,1
臺北市,士林區,0172,519,371,890,74,964,1533,62.88%,33.86%,1
臺北市,士林區,0173,483,352,835,93,928,1515,61.25%,31.88%,1
臺北市,士林區,0174,369,290,659,70,729,1203,60.6%,30.67%,1
臺北市,士林區,0175,463,377,840,88,928,1487,62.41%,31.14%,1
臺北市,士林區,0176,381,283,664,49,713,1252,56.95%,30.43%,1
臺北市,士林區,0177,480,332,812,61,873,1536,56.84%,31.25%,1
臺北市,士林區,0178,471,418,889,63,952,1556,61.18%,30.27%,1
臺北市,士林區,0179,463,354,817,76,893,1511,59.1%,30.64%,1
臺北市,士林區,0180,516,394,910,83,993,1572,63.17%,32.82%,1
臺北市,士林區,0181,471,364,835,84,919,1668,55.1%,28.24%,1
臺北市,士林區,0182,484,366,850,123,973,1685,57.74%,28.72%,1
臺北市,士林區,0183,490,336,826,79,905,1568,57.72%,31.25%,1
臺北市,士林區,0184,364,310,674,59,733,1327,55.24%,27.43%,1
臺北市,士林區,0185,388,285,673,74,747,1338,55.83%,29%,1
臺北市,士林區,0186,403,324,727,77,804,1515,53.07%,26.6%,1
臺北市,士林區,0187,430,360,790,76,866,1452,59.64%,29.61%,1
臺北市,士林區,0188,461,309,770,72,842,1448,58.15%,31.84%,1
臺北市,士林區,0189,482,345,827,72,899,1521,59.11%,31.69%,1
臺北市,士林區,0190,442,336,778,59,837,1461,57.29%,30.25%,1
臺北市,士林區,0191,401,345,746,87,833,1541,54.06%,26.02%,1
臺北市,士林區,0192,369,322,691,61,752,1611,46.68%,22.91%,1
臺北市,士林區,0193,432,391,823,78,901,1595,56.49%,27.08%,1
臺北市,士林區,0194,473,343,816,57,873,1685,51.81%,28.07%,1
臺北市,士林區,0195,517,378,895,85,980,1816,53.96%,28.47%,1
臺北市,士林區,0196,473,375,848,110,958,1687,56.79%,28.04%,1
臺北市,士林區,0197,469,369,838,93,931,1646,56.56%,28.49%,1
臺北市,士林區,0198,479,335,814,71,885,1643,53.86%,29.15%,1
臺北市,士林區,0199,494,424,918,61,979,1687,58.03%,29.28%,1
臺北市,士林區,0200,483,398,881,92,973,1655,58.79%,29.18%,1
臺北市,士林區,0201,490,384,874,44,918,1779,51.6%,27.54%,1
臺北市,士林區,0202,578,439,1017,67,1084,1855,58.44%,31.16%,1
臺北市,士林區,0203,400,312,712,74,786,1350,58.22%,29.63%,1
臺北市,士林區,0204,403,293,696,51,747,1455,51.34%,27.7%,1
臺北市,士林區,0205,357,296,653,68,721,1497,48.16%,23.85%,1
臺北市,士林區,0206,318,292,610,64,674,1398,48.21%,22.75%,1
臺北市,士林區,0207,544,398,942,83,1025,1747,58.67%,31.14%,1
臺北市,士林區,0208,409,298,707,113,820,1465,55.97%,27.92%,1
臺北市,士林區,0209,407,376,783,85,868,1530,56.73%,26.6%,1
臺北市,士林區,0210,474,408,882,91,973,1855,52.45%,25.55%,1
臺北市,士林區,0211,394,353,747,85,832,1444,57.62%,27.29%,1
臺北市,士林區,0212,400,350,750,80,830,1563,53.1%,25.59%,1
臺北市,士林區,0213,388,372,760,99,859,1482,57.96%,26.18%,1
臺北市,士林區,0214,397,348,745,120,865,1552,55.73%,25.58%,1
臺北市,士林區,0215,544,369,913,98,1011,1790,56.48%,30.39%,1
臺北市,士林區,0216,328,421,749,108,857,1628,52.64%,20.15%,1
臺北市,士林區,0217,361,290,651,96,747,1337,55.87%,27%,1
臺北市,士林區,0218,496,382,878,115,993,1750,56.74%,28.34%,1
臺北市,士林區,0219,438,337,775,115,890,1668,53.36%,26.26%,1
臺北市,士林區,0220,310,272,582,86,668,1403,47.61%,22.1%,1
臺北市,士林區,0221,320,314,634,67,701,1468,47.75%,21.8%,1
臺北市,士林區,0222,363,302,665,47,712,1471,48.4%,24.68%,1
臺北市,士林區,0223,444,327,771,105,876,1666,52.58%,26.65%,1
臺北市,士林區,0224,376,373,749,78,827,1587,52.11%,23.69%,1
臺北市,士林區,0225,490,375,865,88,953,1987,47.96%,24.66%,1
臺北市,士林區,0226,359,249,608,41,649,1271,51.06%,28.25%,1
臺北市,士林區,0227,597,354,951,88,1039,1728,60.13%,34.55%,1
臺北市,士林區,0228,511,378,889,91,980,1630,60.12%,31.35%,1
臺北市,士林區,0229,505,393,898,74,972,1619,60.04%,31.19%,1
臺北市,士林區,0230,479,316,795,49,844,1425,59.23%,33.61%,1
臺北市,士林區,0231,537,389,926,74,1000,1623,61.61%,33.09%,1
臺北市,士林區,0232,493,358,851,77,928,1564,59.34%,31.52%,1
臺北市,士林區,0233,598,237,835,51,886,1376,64.39%,43.46%,1
臺北市,士林區,0234,568,327,895,49,944,1517,62.23%,37.44%,1
臺北市,士林區,0235,484,372,856,65,921,1729,53.27%,27.99%,1
臺北市,士林區,0236,489,382,871,53,924,1511,61.15%,32.36%,1
臺北市,士林區,0237,583,420,1003,62,1065,1811,58.81%,32.19%,1
臺北市,士林區,0238,480,375,855,45,900,1533,58.71%,31.31%,1
臺北市,士林區,0239,590,421,1011,66,1077,1657,65%,35.61%,1
臺北市,士林區,0240,491,322,813,48,861,1499,57.44%,32.76%,1
臺北市,士林區,0241,435,294,729,81,810,1402,57.77%,31.03%,1
臺北市,士林區,0242,395,370,765,67,832,1273,65.36%,31.03%,1
臺北市,士林區,0243,418,300,718,47,765,1273,60.09%,32.84%,1
臺北市,士林區,0244,405,321,726,61,787,1316,59.8%,30.78%,1
臺北市,士林區,0245,485,409,894,64,958,1659,57.75%,29.23%,1
臺北市,士林區,0246,532,379,911,57,968,1749,55.35%,30.42%,1
臺北市,士林區,0247,471,333,804,82,886,1552,57.09%,30.35%,1
臺北市,士林區,0248,529,321,850,60,910,1529,59.52%,34.6%,1
臺北市,士林區,0249,570,30,600,55,655,1644,39.84%,34.67%,1
臺北市,士林區,0250,531,410,941,70,1011,1779,56.83%,29.85%,1
臺北市,士林區,0251,476,378,854,62,916,1597,57.36%,29.81%,1
臺北市,士林區,0252,440,325,765,80,845,1454,58.12%,30.26%,1
臺北市,士林區,0253,516,400,916,57,973,1582,61.5%,32.62%,1
臺北市,士林區,0254,476,355,831,71,902,1518,59.42%,31.36%,1
臺北市,士林區,0255,412,337,749,29,778,1501,51.83%,27.45%,1
臺北市,士林區,0256,475,320,795,63,858,1420,60.42%,33.45%,1
臺北市,士林區,0257,477,340,817,66,883,1494,59.1%,31.93%,1
臺北市,士林區,0258,500,393,893,71,964,1568,61.48%,31.89%,1
臺北市,士林區,0259,382,330,712,56,768,1208,63.58%,31.62%,1
臺北市,士林區,0260,552,394,946,86,1032,1826,56.52%,30.23%,1
臺北市,士林區,0261,496,381,877,62,939,1647,57.01%,30.12%,1
臺北市,士林區,0262,498,379,877,71,948,1654,57.32%,30.11%,1
臺北市,士林區,0263,511,360,871,60,931,1550,60.06%,32.97%,1
臺北市,士林區,0264,407,357,764,57,821,1298,63.25%,31.36%,1
臺北市,士林區,0265,383,330,713,88,801,1297,61.76%,29.53%,1
臺北市,士林區,0266,401,311,712,51,763,1352,56.43%,29.66%,1
臺北市,士林區,0267,479,333,812,67,879,1522,57.75%,31.47%,1
臺北市,士林區,0268,436,390,826,90,916,1602,57.18%,27.22%,1
臺北市,士林區,0269,415,343,758,74,832,1441,57.74%,28.8%,1
臺北市,士林區,0270,375,287,662,34,696,1325,52.53%,28.3%,1
臺北市,士林區,0271,498,342,840,60,900,1567,57.43%,31.78%,1
臺北市,士林區,0272,444,386,830,49,879,1518,57.91%,29.25%,1
臺北市,士林區,0273,532,353,885,61,946,1549,61.07%,34.34%,1
臺北市,士林區,0274,523,365,888,43,931,1652,56.36%,31.66%,1
臺北市,士林區,0275,589,395,984,72,1056,1766,59.8%,33.35%,1
臺北市,士林區,0276,490,360,850,53,903,1638,55.13%,29.91%,1
臺北市,士林區,0277,513,325,838,64,902,1491,60.5%,34.41%,1
臺北市,士林區,0278,483,357,840,47,887,1521,58.32%,31.76%,1
臺北市,士林區,0279,459,313,772,53,825,1351,61.07%,33.97%,1
臺北市,士林區,0280,536,351,887,35,922,1742,52.93%,30.77%,1
臺北市,士林區,0281,486,379,865,53,918,1585,57.92%,30.66%,1
臺北市,士林區,0282,499,337,836,57,893,1521,58.71%,32.81%,1
臺北市,士林區,0283,455,372,827,35,862,1543,55.87%,29.49%,1
臺北市,士林區,0284,477,313,790,41,831,1404,59.19%,33.97%,1
臺北市,士林區,0285,347,513,860,33,893,1541,57.95%,22.52%,1
臺北市,士林區,0286,464,346,810,68,878,1584,55.43%,29.29%,1
臺北市,士林區,0287,460,383,843,67,910,1519,59.91%,30.28%,1
臺北市,士林區,0288,435,303,738,36,774,1482,52.23%,29.35%,1
臺北市,士林區,0289,366,293,659,50,709,1243,57.04%,29.44%,1
臺北市,士林區,0290,332,265,597,71,668,1156,57.79%,28.72%,1
臺北市,士林區,0291,338,252,590,110,700,1262,55.47%,26.78%,1
臺北市,士林區,0292,274,201,475,58,533,889,59.96%,30.82%,1
臺北市,士林區,0293,245,225,470,66,536,858,62.47%,28.55%,1
臺北市,士林區,0294,219,238,457,82,539,945,57.04%,23.17%,1
臺北市,士林區,0295,279,192,471,63,534,960,55.63%,29.06%,1
臺北市,士林區,0296,250,189,439,56,495,876,56.51%,28.54%,1
臺北市,士林區,0297,169,146,315,47,362,556,65.11%,30.4%,1
臺北市,士林區,0298,397,194,591,79,670,919,72.91%,43.2%,1
臺北市,士林區,0299,440,350,790,109,899,1360,66.1%,32.35%,1
臺北市,士林區,0300,391,343,734,97,831,1355,61.33%,28.86%,1
臺北市,士林區,0301,416,278,694,50,744,1252,59.42%,33.23%,1
臺北市,士林區,0302,401,285,686,46,732,1182,61.93%,33.93%,1
臺北市,士林區,0303,401,269,670,23,693,1431,48.43%,28.02%,1
臺北市,士林區,0304,357,271,628,46,674,1240,54.35%,28.79%,1
臺北市,北投區,0001,447,298,745,59,804,1313,61.23%,34.04%,1
臺北市,北投區,0002,441,384,825,48,873,1403,62.22%,31.43%,1
臺北市,北投區,0003,335,276,611,64,675,1081,62.44%,30.99%,1
臺北市,北投區,0004,251,424,675,52,727,1209,60.13%,20.76%,1
臺北市,北投區,0005,377,340,717,60,777,1326,58.6%,28.43%,1
臺北市,北投區,0006,386,326,712,55,767,1263,60.73%,30.56%,1
臺北市,北投區,0007,509,375,884,73,957,1580,60.57%,32.22%,1
臺北市,北投區,0008,486,382,868,65,933,1577,59.16%,30.82%,1
臺北市,北投區,0009,506,311,817,72,889,1483,59.95%,34.12%,1
臺北市,北投區,0010,451,326,777,41,818,1461,55.99%,30.87%,1
臺北市,北投區,0011,416,342,758,80,838,1466,57.16%,28.38%,1
臺北市,北投區,0012,502,393,895,71,966,1620,59.63%,30.99%,1
臺北市,北投區,0013,463,307,770,42,812,1543,52.62%,30.01%,1
臺北市,北投區,0014,424,314,738,78,816,1513,53.93%,28.02%,1
臺北市,北投區,0015,497,325,822,56,878,1534,57.24%,32.4%,1
臺北市,北投區,0016,541,367,908,80,988,1650,59.88%,32.79%,1
臺北市,北投區,0017,490,340,830,50,880,1533,57.4%,31.96%,1
臺北市,北投區,0018,513,362,875,66,941,1702,55.29%,30.14%,1
臺北市,北投區,0019,541,378,919,62,981,1721,57%,31.44%,1
臺北市,北投區,0020,503,396,899,60,959,1575,60.89%,31.94%,1
臺北市,北投區,0021,481,345,826,74,900,1530,58.82%,31.44%,1
臺北市,北投區,0022,529,425,954,17,971,1728,56.19%,30.61%,1
臺北市,北投區,0023,514,393,907,70,977,1702,57.4%,30.2%,1
臺北市,北投區,0024,501,382,883,81,964,1696,56.84%,29.54%,1
臺北市,北投區,0025,467,281,748,46,794,1684,47.15%,27.73%,1
臺北市,北投區,0026,599,371,970,60,1030,1717,59.99%,34.89%,1
臺北市,北投區,0027,486,354,840,45,885,1605,55.14%,30.28%,1
臺北市,北投區,0028,539,380,919,71,990,1723,57.46%,31.28%,1
臺北市,北投區,0029,555,370,925,54,979,1597,61.3%,34.75%,1
臺北市,北投區,0030,563,368,931,42,973,1700,57.24%,33.12%,1
臺北市,北投區,0031,415,362,777,41,818,1544,52.98%,26.88%,1
臺北市,北投區,0032,453,358,811,66,877,1635,53.64%,27.71%,1
臺北市,北投區,0033,445,387,832,37,869,1495,58.13%,29.77%,1
臺北市,北投區,0034,510,389,899,42,941,1619,58.12%,31.5%,1
臺北市,北投區,0035,493,401,894,57,951,1683,56.51%,29.29%,1
臺北市,北投區,0036,480,325,805,85,890,1662,53.55%,28.88%,1
臺北市,北投區,0037,514,358,872,39,911,1850,49.24%,27.78%,1
臺北市,北投區,0038,455,368,823,33,856,1674,51.14%,27.18%,1
臺北市,北投區,0039,520,344,864,59,923,1511,61.09%,34.41%,1
臺北市,北投區,0040,385,346,731,32,763,1393,54.77%,27.64%,1
臺北市,北投區,0041,419,326,745,64,809,1279,63.25%,32.76%,1
臺北市,北投區,0042,377,212,589,48,637,1122,56.77%,33.6%,1
臺北市,北投區,0043,491,309,800,57,857,1238,69.22%,39.66%,1
臺北市,北投區,0044,480,369,849,73,922,1477,62.42%,32.5%,1
臺北市,北投區,0045,487,355,842,73,915,1495,61.2%,32.58%,1
臺北市,北投區,0046,511,353,864,59,923,1469,62.83%,34.79%,1
臺北市,北投區,0047,508,291,799,60,859,1462,58.76%,34.75%,1
臺北市,北投區,0048,464,307,771,82,853,1431,59.61%,32.42%,1
臺北市,北投區,0049,451,345,796,55,851,1486,57.27%,30.35%,1
臺北市,北投區,0050,459,351,810,72,882,1449,60.87%,31.68%,1
臺北市,北投區,0051,455,337,792,53,845,1456,58.04%,31.25%,1
臺北市,北投區,0052,402,304,706,40,746,1311,56.9%,30.66%,1
臺北市,北投區,0053,428,301,729,71,800,1356,59%,31.56%,1
臺北市,北投區,0054,442,314,756,40,796,1338,59.49%,33.03%,1
臺北市,北投區,0055,476,343,819,41,860,1525,56.39%,31.21%,1
臺北市,北投區,0056,458,363,821,63,884,1620,54.57%,28.27%,1
臺北市,北投區,0057,412,329,741,49,790,1499,52.7%,27.48%,1
臺北市,北投區,0058,550,302,852,48,900,1497,60.12%,36.74%,1
臺北市,北投區,0059,506,342,848,71,919,1624,56.59%,31.16%,1
臺北市,北投區,0060,400,323,723,116,839,1536,54.62%,26.04%,1
臺北市,北投區,0061,475,343,818,87,905,1469,61.61%,32.33%,1
臺北市,北投區,0062,480,360,840,52,892,1598,55.82%,30.04%,1
臺北市,北投區,0063,523,359,882,44,926,1690,54.79%,30.95%,1
臺北市,北投區,0064,447,350,797,111,908,1599,56.79%,27.95%,1
臺北市,北投區,0065,514,350,864,70,934,1634,57.16%,31.46%,1
臺北市,北投區,0066,451,367,818,63,881,1660,53.07%,27.17%,1
臺北市,北投區,0067,544,388,932,70,1002,1900,52.74%,28.63%,1
臺北市,北投區,0068,550,419,969,71,1040,1797,57.87%,30.61%,1
臺北市,北投區,0069,544,437,981,80,1061,1832,57.91%,29.69%,1
臺北市,北投區,0070,553,416,969,79,1048,1784,58.74%,31%,1
臺北市,北投區,0071,545,398,943,70,1013,1732,58.49%,31.47%,1
臺北市,北投區,0072,288,209,497,62,559,2035,27.47%,14.15%,1
臺北市,北投區,0073,453,336,789,72,861,1504,57.25%,30.12%,1
臺北市,北投區,0074,549,353,902,86,988,1683,58.7%,32.62%,1
臺北市,北投區,0075,471,350,821,85,906,1635,55.41%,28.81%,1
臺北市,北投區,0076,487,236,723,87,810,1613,50.22%,30.19%,1
臺北市,北投區,0077,465,285,750,42,792,1483,53.41%,31.36%,1
臺北市,北投區,0078,435,348,783,60,843,1500,56.2%,29%,1
臺北市,北投區,0079,456,334,790,79,869,1483,58.6%,30.75%,1
臺北市,北投區,0080,466,329,795,78,873,1544,56.54%,30.18%,1
臺北市,北投區,0081,385,305,690,80,770,1532,50.26%,25.13%,1
臺北市,北投區,0082,650,288,938,89,1027,1819,56.46%,35.73%,1
臺北市,北投區,0083,479,395,874,89,963,1863,51.69%,25.71%,1
臺北市,北投區,0084,492,391,883,32,915,1872,48.88%,26.28%,1
臺北市,北投區,0085,466,365,831,67,898,1627,55.19%,28.64%,1
臺北市,北投區,0086,488,356,844,49,893,1696,52.65%,28.77%,1
臺北市,北投區,0087,558,401,959,72,1031,1841,56%,30.31%,1
臺北市,北投區,0088,384,295,679,74,753,1324,56.87%,29%,1
臺北市,北投區,0089,448,316,764,52,816,1504,54.26%,29.79%,1
臺北市,北投區,0090,460,323,783,72,855,1511,56.59%,30.44%,1
臺北市,北投區,0091,496,407,903,52,955,1615,59.13%,30.71%,1
臺北市,北投區,0092,378,256,634,43,677,1270,53.31%,29.76%,1
臺北市,北投區,0093,374,310,684,46,730,1492,48.93%,25.07%,1
臺北市,北投區,0094,413,311,724,41,765,1429,53.53%,28.9%,1
臺北市,北投區,0095,477,304,781,32,813,1567,51.88%,30.44%,1
臺北市,北投區,0096,441,280,721,59,780,1388,56.2%,31.77%,1
臺北市,北投區,0097,416,290,706,31,737,1448,50.9%,28.73%,1
臺北市,北投區,0098,369,300,669,49,718,1356,52.95%,27.21%,1
臺北市,北投區,0099,403,271,674,61,735,1308,56.19%,30.81%,1
臺北市,北投區,0100,358,275,633,68,701,1165,60.17%,30.73%,1
臺北市,北投區,0101,460,301,761,102,863,1429,60.39%,32.19%,1
臺北市,北投區,0102,459,284,743,44,787,1472,53.46%,31.18%,1
臺北市,北投區,0103,510,374,884,66,950,1508,63%,33.82%,1
臺北市,北投區,0104,441,337,778,69,847,1480,57.23%,29.8%,1
臺北市,北投區,0105,315,257,572,58,630,1142,55.17%,27.58%,1
臺北市,北投區,0106,480,297,777,45,822,1554,52.9%,30.89%,1
臺北市,北投區,0107,524,383,907,92,999,1669,59.86%,31.4%,1
臺北市,北投區,0108,543,405,948,80,1028,1823,56.39%,29.79%,1
臺北市,北投區,0109,543,314,857,92,949,1739,54.57%,31.22%,1
臺北市,北投區,0110,540,333,873,78,951,1771,53.7%,30.49%,1
臺北市,北投區,0111,412,296,708,64,772,1468,52.59%,28.07%,1
臺北市,北投區,0112,466,282,748,59,807,1469,54.94%,31.72%,1
臺北市,北投區,0113,426,249,675,34,709,1094,64.81%,38.94%,1
臺北市,北投區,0114,429,231,660,46,706,1101,64.12%,38.96%,1
臺北市,北投區,0115,490,303,793,73,866,1422,60.9%,34.46%,1
臺北市,北投區,0116,429,275,704,74,778,1390,55.97%,30.86%,1
臺北市,北投區,0117,406,304,710,71,781,1307,59.76%,31.06%,1
臺北市,北投區,0118,394,305,699,73,772,1215,63.54%,32.43%,1
臺北市,北投區,0119,473,329,802,67,869,1642,52.92%,28.81%,1
臺北市,北投區,0120,454,329,783,48,831,1623,51.2%,27.97%,1
臺北市,北投區,0121,504,326,830,67,897,1621,55.34%,31.09%,1
臺北市,北投區,0122,401,313,714,26,740,1367,54.13%,29.33%,1
臺北市,北投區,0123,345,307,652,70,722,1309,55.16%,26.36%,1
臺北市,北投區,0124,423,309,732,44,776,1356,57.23%,31.19%,1
臺北市,北投區,0125,415,290,705,53,758,1365,55.53%,30.4%,1
臺北市,北投區,0126,448,365,813,54,867,1613,53.75%,27.77%,1
臺北市,北投區,0127,415,294,709,52,761,1590,47.86%,26.1%,1
臺北市,北投區,0128,505,376,881,88,969,1662,58.3%,30.39%,1
臺北市,北投區,0129,494,381,875,59,934,1622,57.58%,30.46%,1
臺北市,北投區,0130,502,439,941,45,986,1820,54.18%,27.58%,1
臺北市,北投區,0131,513,352,865,79,944,1615,58.45%,31.76%,1
臺北市,北投區,0132,391,287,678,75,753,1612,46.71%,24.26%,1
臺北市,北投區,0133,481,336,817,96,913,1652,55.27%,29.12%,1
臺北市,北投區,0134,494,376,870,47,917,1666,55.04%,29.65%,1
臺北市,北投區,0135,462,361,823,63,886,1641,53.99%,28.15%,1
臺北市,北投區,0136,156,129,285,34,319,528,60.42%,29.55%,1
臺北市,北投區,0137,366,334,700,84,784,1642,47.75%,22.29%,1
臺北市,北投區,0138,250,168,418,52,470,829,56.69%,30.16%,1
臺北市,北投區,0139,226,111,337,46,383,690,55.51%,32.75%,1
臺北市,北投區,0140,295,225,520,63,583,1067,54.64%,27.65%,1
臺北市,北投區,0141,233,176,409,98,507,892,56.84%,26.12%,1
新北市,板橋區,0894,373,299,672,98,770,1388,55.48%,26.87%,1
新北市,板橋區,0895,405,288,693,66,759,1294,58.66%,31.3%,1
新北市,板橋區,0896,200,166,366,37,403,667,60.42%,29.99%,1
新北市,板橋區,0897,235,183,418,57,475,898,52.9%,26.17%,1
新北市,板橋區,0898,283,186,469,37,506,829,61.04%,34.14%,1
新北市,板橋區,0899,249,165,414,48,462,739,62.52%,33.69%,1
新北市,板橋區,0900,341,220,561,70,631,1035,60.97%,32.95%,1
新北市,板橋區,0901,380,322,702,74,776,1713,45.3%,22.18%,1
新北市,板橋區,0902,186,120,306,27,333,658,50.61%,28.27%,1
新北市,板橋區,0903,372,259,631,107,738,1312,56.25%,28.35%,1
新北市,板橋區,0904,385,305,690,73,763,1492,51.14%,25.8%,1
新北市,板橋區,0905,338,293,631,86,717,1393,51.47%,24.26%,1
新北市,板橋區,0906,478,335,813,67,880,4742,18.56%,10.08%,1
新北市,板橋區,0907,415,299,714,48,762,1439,52.95%,28.84%,1
新北市,板橋區,0908,380,261,641,79,720,1187,60.66%,32.01%,1
新北市,板橋區,0909,326,236,562,51,613,1122,54.63%,29.06%,1
新北市,板橋區,0910,447,293,740,44,784,1363,57.52%,32.8%,1
新北市,板橋區,0911,299,282,581,68,649,1093,59.38%,27.36%,1
新北市,板橋區,0912,409,309,718,53,771,1331,57.93%,30.73%,1
新北市,板橋區,0913,312,260,572,67,639,1026,62.28%,30.41%,1
新北市,板橋區,0914,361,232,593,136,729,1244,58.6%,29.02%,1
新北市,板橋區,0915,332,263,595,95,690,1268,54.42%,26.18%,1
新北市,板橋區,0916,344,251,595,61,656,1313,49.96%,26.2%,1
新北市,板橋區,0917,420,254,674,58,732,1196,61.2%,35.12%,1
新北市,板橋區,0918,442,283,725,50,775,1137,68.16%,38.87%,1
新北市,板橋區,0919,445,307,752,53,805,1269,63.44%,35.07%,1
新北市,板橋區,0920,387,253,640,40,680,1117,60.88%,34.65%,1
新北市,板橋區,0921,353,255,608,56,664,1042,63.72%,33.88%,1
新北市,板橋區,0922,350,322,672,90,762,1257,60.62%,27.84%,1
新北市,板橋區,0923,369,263,632,91,723,1216,59.46%,30.35%,1
新北市,板橋區,0924,340,250,590,72,662,1126,58.79%,30.2%,1
新北市,板橋區,0925,477,298,775,67,842,1290,65.27%,36.98%,1
新北市,板橋區,0926,342,252,594,28,622,1215,51.19%,28.15%,1
新北市,板橋區,0927,343,206,549,34,583,1099,53.05%,31.21%,1
新北市,板橋區,0928,547,245,792,54,846,1329,63.66%,41.16%,1
新北市,板橋區,0929,391,176,567,41,608,996,61.04%,39.26%,1
新北市,板橋區,0930,346,223,569,54,623,1047,59.5%,33.05%,1
新北市,板橋區,0931,404,276,680,86,766,1272,60.22%,31.76%,1
新北市,板橋區,0932,417,273,690,63,753,1252,60.14%,33.31%,1
新北市,板橋區,0933,349,298,647,84,731,1238,59.05%,28.19%,1
新北市,板橋區,0934,451,337,788,86,874,1389,62.92%,32.47%,1
新北市,板橋區,0935,401,268,669,82,751,1194,62.9%,33.58%,1
新北市,板橋區,0936,309,205,514,68,582,1093,53.25%,28.27%,1
新北市,板橋區,0937,338,231,569,90,659,1148,57.4%,29.44%,1
新北市,板橋區,0938,409,280,689,62,751,1268,59.23%,32.26%,1
新北市,板橋區,0939,342,285,627,91,718,1230,58.37%,27.8%,1
新北市,板橋區,0940,295,217,512,70,582,1012,57.51%,29.15%,1
新北市,板橋區,0941,231,192,423,64,487,811,60.05%,28.48%,1
新北市,板橋區,0942,367,288,655,102,757,1197,63.24%,30.66%,1
新北市,板橋區,0943,346,226,572,49,621,1142,54.38%,30.3%,1
新北市,板橋區,0944,381,255,636,63,699,1222,57.2%,31.18%,1
新北市,板橋區,0945,278,170,448,56,504,796,63.32%,34.92%,1
新北市,板橋區,0946,333,223,556,90,646,997,64.79%,33.4%,1
新北市,板橋區,0947,260,273,533,43,576,1011,56.97%,25.72%,1
新北市,板橋區,0948,327,251,578,85,663,1157,57.3%,28.26%,1
新北市,板橋區,0949,316,243,559,76,635,1040,61.06%,30.38%,1
新北市,板橋區,0950,397,266,663,50,713,1173,60.78%,33.84%,1
新北市,板橋區,0951,375,252,627,34,661,1193,55.41%,31.43%,1
新北市,板橋區,0952,429,268,697,46,743,1255,59.2%,34.18%,1
新北市,板橋區,0953,421,285,706,54,760,1306,58.19%,32.24%,1
新北市,板橋區,0954,324,236,560,31,591,1050,56.29%,30.86%,1
新北市,板橋區,0955,264,234,498,48,546,942,57.96%,28.03%,1
新北市,板橋區,0956,390,257,647,71,718,1133,63.37%,34.42%,1
新北市,板橋區,0957,389,279,668,65,733,1251,58.59%,31.1%,1
新北市,板橋區,0958,417,290,707,60,767,1293,59.32%,32.25%,1
新北市,板橋區,0959,322,251,573,78,651,1208,53.89%,26.66%,1
新北市,板橋區,0960,342,279,621,78,699,1223,57.15%,27.96%,1
新北市,板橋區,0961,281,246,527,78,605,1061,57.02%,26.48%,1
新北市,板橋區,0962,465,328,793,72,865,1515,57.1%,30.69%,1
新北市,板橋區,0963,385,289,674,80,754,1225,61.55%,31.43%,1
新北市,板橋區,0964,426,253,679,36,715,1120,63.84%,38.04%,1
新北市,板橋區,0965,371,250,621,69,690,1091,63.24%,34.01%,1
新北市,板橋區,0966,530,266,796,54,850,1385,61.37%,38.27%,1
新北市,板橋區,0967,405,301,706,84,790,1283,61.57%,31.57%,1
新北市,板橋區,0968,343,275,618,108,726,1204,60.3%,28.49%,1
新北市,板橋區,0969,402,282,684,73,757,1191,63.56%,33.75%,1
新北市,板橋區,0970,334,264,598,89,687,1078,63.73%,30.98%,1
新北市,板橋區,0971,421,294,715,83,798,1351,59.07%,31.16%,1
新北市,板橋區,0972,406,283,689,87,776,1322,58.7%,30.71%,1
新北市,板橋區,0973,279,183,462,66,528,868,60.83%,32.14%,1
新北市,板橋區,0974,338,265,603,89,692,1029,67.25%,32.85%,1
新北市,板橋區,0975,517,364,881,59,940,1602,58.68%,32.27%,1
新北市,板橋區,0976,308,430,738,16,754,1362,55.36%,22.61%,1
新北市,板橋區,0977,512,359,871,96,967,1698,56.95%,30.15%,1
新北市,板橋區,0978,494,306,800,50,850,1495,56.86%,33.04%,1
新北市,板橋區,0979,406,346,752,93,845,1522,55.52%,26.68%,1
新北市,板橋區,0980,388,299,687,69,756,1279,59.11%,30.34%,1
新北市,板橋區,0981,384,274,658,76,734,1559,47.08%,24.63%,1
新北市,板橋區,0982,420,290,710,117,827,1537,53.81%,27.33%,1
新北市,板橋區,0983,406,295,701,94,795,1531,51.93%,26.52%,1
新北市,板橋區,0984,515,352,867,39,906,1720,52.67%,29.94%,1
新北市,板橋區,0985,341,220,561,54,615,1165,52.79%,29.27%,1
新北市,板橋區,0986,589,410,999,49,1048,1857,56.44%,31.72%,1
新北市,板橋區,0987,319,230,549,79,628,1078,58.26%,29.59%,1
新北市,板橋區,0988,322,266,588,30,618,1177,52.51%,27.36%,1
新北市,板橋區,0989,544,400,944,66,1010,1798,56.17%,30.26%,1
新北市,板橋區,0990,417,349,766,115,881,1455,60.55%,28.66%,1
新北市,板橋區,0991,370,299,669,96,765,1245,61.45%,29.72%,1
新北市,板橋區,0992,457,277,734,203,937,1704,54.99%,26.82%,1
新北市,板橋區,0993,528,202,730,44,774,1600,48.38%,33%,1
新北市,板橋區,0994,368,296,664,44,708,1409,50.25%,26.12%,1
新北市,板橋區,0995,354,312,666,75,741,1286,57.62%,27.53%,1
新北市,板橋區,0996,296,274,570,102,672,1359,49.45%,21.78%,1
新北市,板橋區,0997,332,237,569,55,624,1188,52.53%,27.95%,1
新北市,板橋區,0998,441,346,787,62,849,1627,52.18%,27.11%,1
新北市,板橋區,0999,429,299,728,53,781,1633,47.83%,26.27%,1
新北市,板橋區,1000,619,374,993,86,1079,1814,59.48%,34.12%,1
新北市,板橋區,1001,553,381,934,33,967,1810,53.43%,30.55%,1
新北市,板橋區,1002,346,214,560,100,660,1133,58.25%,30.54%,1
新北市,板橋區,1003,245,186,431,45,476,841,56.6%,29.13%,1
新北市,板橋區,1004,321,255,576,79,655,1050,62.38%,30.57%,1
新北市,板橋區,1005,286,257,543,98,641,1130,56.73%,25.31%,1
新北市,板橋區,1006,328,247,575,83,658,1056,62.31%,31.06%,1
新北市,板橋區,1007,301,231,532,47,579,1129,51.28%,26.66%,1
新北市,板橋區,1008,510,354,864,109,973,1713,56.8%,29.77%,1
新北市,板橋區,1009,500,343,843,110,953,1622,58.75%,30.83%,1
新北市,板橋區,1010,470,343,813,88,901,1427,63.14%,32.94%,1
新北市,板橋區,1011,514,351,865,40,905,1471,61.52%,34.94%,1
新北市,板橋區,1012,299,225,524,36,560,1076,52.04%,27.79%,1
新北市,板橋區,1013,270,183,453,27,480,979,49.03%,27.58%,1
新北市,板橋區,1014,378,272,650,37,687,1079,63.67%,35.03%,1
新北市,板橋區,1015,248,165,413,58,471,828,56.88%,29.95%,1
新北市,板橋區,1016,225,205,430,81,511,820,62.32%,27.44%,1
新北市,板橋區,1017,291,226,517,49,566,989,57.23%,29.42%,1
新北市,板橋區,1018,271,248,519,80,599,1023,58.55%,26.49%,1
新北市,板橋區,1019,271,245,516,48,564,1044,54.02%,25.96%,1
新北市,板橋區,1020,290,203,493,85,578,968,59.71%,29.96%,1
新北市,板橋區,1021,377,290,667,46,713,1222,58.35%,30.85%,1
新北市,板橋區,1022,389,309,698,62,760,1385,54.87%,28.09%,1
新北市,板橋區,1023,422,341,763,98,861,1585,54.32%,26.62%,1
新北市,板橋區,1024,519,388,907,103,1010,1840,54.89%,28.21%,1
新北市,板橋區,1025,524,477,1001,116,1117,1806,61.85%,29.01%,1
新北市,板橋區,1026,429,322,751,110,861,1506,57.17%,28.49%,1
新北市,板橋區,1027,387,329,716,110,826,1476,55.96%,26.22%,1
新北市,板橋區,1028,454,339,793,85,878,1500,58.53%,30.27%,1
新北市,板橋區,1029,309,258,567,124,691,1096,63.05%,28.19%,1
新北市,板橋區,1030,287,239,526,78,604,963,62.72%,29.8%,1
新北市,板橋區,1031,183,607,790,65,855,1601,53.4%,11.43%,1
新北市,板橋區,1032,506,329,835,95,930,1507,61.71%,33.58%,1
新北市,板橋區,1033,406,322,728,88,816,1315,62.05%,30.87%,1
新北市,板橋區,1034,347,253,600,39,639,1178,54.24%,29.46%,1
新北市,板橋區,1035,562,417,979,112,1091,1822,59.88%,30.85%,1
新北市,板橋區,1036,525,375,900,95,995,1605,61.99%,32.71%,1
新北市,板橋區,1037,528,348,876,22,898,1549,57.97%,34.09%,1
新北市,板橋區,1038,653,447,1100,57,1157,1948,59.39%,33.52%,1
新北市,板橋區,1039,608,386,994,45,1039,1935,53.7%,31.42%,1
新北市,板橋區,1040,291,233,524,57,581,1097,52.96%,26.53%,1
新北市,板橋區,1041,282,254,536,62,598,1095,54.61%,25.75%,1
新北市,板橋區,1042,493,307,800,120,920,1678,54.83%,29.38%,1
新北市,板橋區,1043,483,358,841,120,961,1750,54.91%,27.6%,1
新北市,板橋區,1044,310,269,579,88,667,1187,56.19%,26.12%,1
新北市,板橋區,1045,372,254,626,44,670,1154,58.06%,32.24%,1
新北市,板橋區,1046,395,274,669,39,708,1262,56.1%,31.3%,1
新北市,板橋區,1047,339,277,616,106,722,1271,56.81%,26.67%,1
新北市,板橋區,1048,384,298,682,123,805,1410,57.09%,27.23%,1
新北市,板橋區,1049,457,333,790,120,910,1745,52.15%,26.19%,1
新北市,板橋區,1050,514,387,901,156,1057,1867,56.61%,27.53%,1
新北市,板橋區,1051,526,416,942,107,1049,1753,59.84%,30.01%,1
新北市,板橋區,1052,384,267,651,71,722,1204,59.97%,31.89%,1
新北市,板橋區,1053,467,336,803,91,894,1614,55.39%,28.93%,1
新北市,板橋區,1054,391,289,680,63,743,1237,60.06%,31.61%,1
新北市,板橋區,1055,378,336,714,91,805,1361,59.15%,27.77%,1
新北市,板橋區,1056,343,304,647,46,693,1243,55.75%,27.59%,1
新北市,板橋區,1057,407,315,722,42,764,1515,50.43%,26.86%,1
新北市,板橋區,1058,501,318,819,88,907,1515,59.87%,33.07%,1
新北市,板橋區,1059,294,221,515,72,587,949,61.85%,30.98%,1
新北市,板橋區,1060,463,340,803,98,901,1629,55.31%,28.42%,1
新北市,板橋區,1061,360,295,655,66,721,1238,58.24%,29.08%,1
新北市,板橋區,1062,201,147,348,36,384,901,42.62%,22.31%,1
新北市,板橋區,1063,434,330,764,101,865,1475,58.64%,29.42%,1
新北市,板橋區,1064,420,323,743,90,833,1481,56.25%,28.36%,1
新北市,板橋區,1065,453,343,796,128,924,1800,51.33%,25.17%,1
新北市,板橋區,1066,489,335,824,80,904,1630,55.46%,30%,1
新北市,板橋區,1067,437,271,708,67,775,1298,59.71%,33.67%,1
新北市,板橋區,1068,273,197,470,53,523,874,59.84%,31.24%,1
新北市,板橋區,1069,281,225,506,21,527,992,53.13%,28.33%,1
新北市,板橋區,1070,374,247,621,26,647,1034,62.57%,36.17%,1
新北市,板橋區,1071,428,349,777,89,866,1451,59.68%,29.5%,1
新北市,板橋區,1072,354,279,633,57,690,1130,61.06%,31.33%,1
新北市,板橋區,1073,481,301,782,67,849,1440,58.96%,33.4%,1
新北市,板橋區,1074,427,371,798,110,908,1531,59.31%,27.89%,1
新北市,板橋區,1075,439,341,780,83,863,1349,63.97%,32.54%,1
新北市,板橋區,1076,423,326,749,70,819,1593,51.41%,26.55%,1
新北市,板橋區,1077,356,246,602,48,650,1174,55.37%,30.32%,1
新北市,板橋區,1078,342,299,641,61,702,1228,57.17%,27.85%,1
新北市,板橋區,1079,365,263,628,49,677,1187,57.03%,30.75%,1
新北市,板橋區,1080,272,204,476,60,536,870,61.61%,31.26%,1
新北市,板橋區,1081,711,425,1136,78,1214,2033,59.71%,34.97%,1
新北市,板橋區,1082,403,301,704,67,771,1418,54.37%,28.42%,1
新北市,板橋區,1083,301,253,554,68,622,1075,57.86%,28%,1
新北市,板橋區,1084,458,300,758,46,804,1515,53.07%,30.23%,1
新北市,板橋區,1085,392,280,672,60,732,1182,61.93%,33.16%,1
新北市,板橋區,1086,573,386,959,96,1055,1893,55.73%,30.27%,1
新北市,板橋區,1087,369,272,641,79,720,1302,55.3%,28.34%,1
新北市,板橋區,1088,380,263,643,78,721,1366,52.78%,27.82%,1
新北市,板橋區,1089,358,329,687,104,791,1318,60.02%,27.16%,1
新北市,板橋區,1090,320,285,605,60,665,1200,55.42%,26.67%,1
新北市,板橋區,1091,595,464,1059,79,1138,2028,56.11%,29.34%,1
新北市,板橋區,1092,512,383,895,129,1024,1746,58.65%,29.32%,1
新北市,板橋區,1093,579,352,931,42,973,1954,49.8%,29.63%,1
新北市,板橋區,1094,442,308,750,75,825,1474,55.97%,29.99%,1
新北市,板橋區,1095,390,317,707,79,786,1418,55.43%,27.5%,1
新北市,板橋區,1096,468,408,876,88,964,1563,61.68%,29.94%,1
新北市,板橋區,1097,485,383,868,115,983,1780,55.22%,27.25%,1
新北市,板橋區,1098,502,361,863,61,924,1707,54.13%,29.41%,1
新北市,板橋區,1099,203,110,313,14,327,906,36.09%,22.41%,1
新北市,板橋區,1100,296,224,520,73,593,1030,57.57%,28.74%,1
新北市,板橋區,1101,316,275,591,65,656,1115,58.83%,28.34%,1
新北市,板橋區,1102,593,340,933,46,979,1836,53.32%,32.3%,1
新北市,板橋區,1103,553,374,927,100,1027,1881,54.6%,29.4%,1
新北市,板橋區,1104,485,384,869,58,927,1688,54.92%,28.73%,1
新北市,板橋區,1105,563,416,979,59,1038,1760,58.98%,31.99%,1
新北市,板橋區,1106,325,262,587,67,654,1044,62.64%,31.13%,1
新北市,板橋區,1107,329,241,570,55,625,1043,59.92%,31.54%,1
新北市,板橋區,1108,365,242,607,80,687,1099,62.51%,33.21%,1
新北市,板橋區,1109,358,91,449,77,526,1260,41.75%,28.41%,1
新北市,板橋區,1110,347,248,595,67,662,1131,58.53%,30.68%,1
新北市,板橋區,1111,348,303,651,70,721,1225,58.86%,28.41%,1
新北市,板橋區,1112,570,272,842,66,908,1455,62.41%,39.18%,1
新北市,板橋區,1113,332,293,625,95,720,1267,56.83%,26.2%,1
新北市,板橋區,1114,257,253,510,70,580,972,59.67%,26.44%,1
新北市,板橋區,1115,301,241,542,52,594,994,59.76%,30.28%,1
新北市,板橋區,1116,330,277,607,36,643,1111,57.88%,29.7%,1
新北市,板橋區,1117,288,400,688,94,782,1177,66.44%,24.47%,1
新北市,板橋區,1118,476,300,776,82,858,1544,55.57%,30.83%,1
新北市,板橋區,1119,305,196,501,87,588,1021,57.59%,29.87%,1
新北市,板橋區,1120,291,220,511,81,592,1040,56.92%,27.98%,1
新北市,板橋區,1121,445,323,768,56,824,1504,54.79%,29.59%,1
新北市,板橋區,1122,425,275,700,44,744,1373,54.19%,30.95%,1
新北市,板橋區,1123,399,277,676,32,708,1210,58.51%,32.98%,1
新北市,板橋區,1124,618,259,877,86,963,1809,53.23%,34.16%,1
新北市,板橋區,1125,483,326,809,107,916,1551,59.06%,31.14%,1
新北市,板橋區,1126,468,301,769,55,824,1408,58.52%,33.24%,1
新北市,板橋區,1127,420,280,700,52,752,1285,58.52%,32.68%,1
新北市,板橋區,1128,352,282,634,53,687,1102,62.34%,31.94%,1
新北市,板橋區,1129,407,262,669,49,718,1399,51.32%,29.09%,1
新北市,板橋區,1130,536,322,858,96,954,1692,56.38%,31.68%,1
新北市,板橋區,1131,533,362,895,64,959,1625,59.02%,32.8%,1
新北市,板橋區,1132,533,367,900,94,994,1712,58.06%,31.13%,1
新北市,板橋區,1133,394,258,652,55,707,1246,56.74%,31.62%,1
新北市,板橋區,1134,461,314,775,43,818,1471,55.61%,31.34%,1
新北市,板橋區,1135,554,364,918,79,997,1761,56.62%,31.46%,1
新北市,板橋區,1136,464,319,783,75,858,1499,57.24%,30.95%,1
新北市,板橋區,1137,444,244,688,76,764,1528,50%,29.06%,1
新北市,板橋區,1138,503,316,819,78,897,1536,58.4%,32.75%,1
新北市,板橋區,1139,472,344,816,79,895,1550,57.74%,30.45%,1
新北市,板橋區,1140,621,439,1060,112,1172,2050,57.17%,30.29%,1
新北市,板橋區,1141,418,291,709,66,775,1300,59.62%,32.15%,1
新北市,板橋區,1142,493,327,820,61,881,1537,57.32%,32.08%,1
新北市,板橋區,1143,317,313,630,46,676,1341,50.41%,23.64%,1
新北市,板橋區,1144,486,332,818,85,903,1606,56.23%,30.26%,1
新北市,板橋區,1145,419,276,695,48,743,1433,51.85%,29.24%,1
新北市,板橋區,1146,475,316,791,61,852,1685,50.56%,28.19%,1
新北市,板橋區,1147,407,298,705,65,770,1248,61.7%,32.61%,1
新北市,板橋區,1148,369,185,554,53,607,1172,51.79%,31.48%,1
新北市,板橋區,1149,414,289,703,67,770,1640,46.95%,25.24%,1
新北市,板橋區,1150,476,252,728,52,780,1428,54.62%,33.33%,1
新北市,板橋區,1151,406,385,791,87,878,1527,57.5%,26.59%,1
新北市,板橋區,1152,431,304,735,54,789,1350,58.44%,31.93%,1
新北市,板橋區,1153,501,305,806,90,896,1582,56.64%,31.67%,1
新北市,板橋區,1154,329,212,541,60,601,919,65.4%,35.8%,1
新北市,板橋區,1155,277,206,483,30,513,930,55.16%,29.78%,1
新北市,板橋區,1156,326,236,562,43,605,974,62.11%,33.47%,1
新北市,板橋區,1157,582,360,942,61,1003,1732,57.91%,33.6%,1
新北市,板橋區,1158,410,322,732,78,810,1438,56.33%,28.51%,1
新北市,板橋區,1159,513,331,844,126,970,1777,54.59%,28.87%,1
新北市,板橋區,1160,466,334,800,77,877,1764,49.72%,26.42%,1
新北市,板橋區,1161,364,294,658,42,700,1289,54.31%,28.24%,1
新北市,板橋區,1162,331,248,579,97,676,1182,57.19%,28%,1
新北市,板橋區,1163,376,252,628,81,709,1174,60.39%,32.03%,1
新北市,板橋區,1164,538,387,925,86,1011,1870,54.06%,28.77%,1
新北市,板橋區,1165,599,396,995,83,1078,1842,58.52%,32.52%,1
新北市,板橋區,1166,338,227,565,73,638,1094,58.32%,30.9%,1
新北市,板橋區,1167,358,240,598,77,675,1228,54.97%,29.15%,1
新北市,板橋區,1168,328,250,578,62,640,998,64.13%,32.87%,1
新北市,板橋區,1169,284,234,518,52,570,862,66.13%,32.95%,1
新北市,板橋區,1170,439,357,796,64,860,1622,53.02%,27.07%,1
新北市,板橋區,1171,330,309,639,78,717,1205,59.5%,27.39%,1
新北市,板橋區,1172,482,363,845,61,906,1787,50.7%,26.97%,1
新北市,板橋區,1173,556,326,882,41,923,1610,57.33%,34.53%,1
新北市,板橋區,1174,749,483,1232,60,1292,2216,58.3%,33.8%,1
新北市,板橋區,1175,704,491,1195,73,1268,2294,55.27%,30.69%,1
新北市,板橋區,1176,593,401,994,114,1108,2090,53.01%,28.37%,1
新北市,板橋區,1177,386,250,636,43,679,1356,50.07%,28.47%,1
新北市,板橋區,1178,325,246,571,53,624,1067,58.48%,30.46%,1
新北市,板橋區,1179,269,312,581,82,663,1319,50.27%,20.39%,1
新北市,板橋區,1180,345,265,610,73,683,1316,51.9%,26.22%,1
新北市,板橋區,1181,331,234,565,81,646,1195,54.06%,27.7%,1
新北市,板橋區,1182,244,218,462,45,507,857,59.16%,28.47%,1
新北市,板橋區,1183,401,284,685,92,777,1417,54.83%,28.3%,1
新北市,板橋區,1184,428,376,804,106,910,1560,58.33%,27.44%,1
新北市,板橋區,1185,505,360,865,120,985,1747,56.38%,28.91%,1
新北市,板橋區,1186,434,243,677,73,750,1176,63.78%,36.9%,1
新北市,板橋區,1187,324,278,602,45,647,1101,58.76%,29.43%,1
新北市,板橋區,1188,454,337,791,43,834,1458,57.2%,31.14%,1
新北市,板橋區,1189,441,302,743,58,801,1630,49.14%,27.06%,1
新北市,板橋區,1190,417,298,715,142,857,1611,53.2%,25.88%,1
新北市,板橋區,1191,330,234,564,40,604,1139,53.03%,28.97%,1
新北市,板橋區,1192,341,210,551,59,610,1120,54.46%,30.45%,1
新北市,板橋區,1193,300,214,514,113,627,1022,61.35%,29.35%,1
新北市,板橋區,1194,305,230,535,106,641,1049,61.11%,29.08%,1
新北市,板橋區,1195,325,213,538,43,581,1007,57.7%,32.27%,1
新北市,板橋區,1196,450,287,737,44,781,1393,56.07%,32.3%,1
新北市,板橋區,1197,80,74,154,46,200,474,42.19%,16.88%,1
新北市,板橋區,1198,156,104,260,39,299,500,59.8%,31.2%,1
新北市,板橋區,1199,346,246,592,68,660,1177,56.07%,29.4%,1
新北市,板橋區,1200,312,286,598,50,648,1186,54.64%,26.31%,1
新北市,板橋區,1201,358,240,598,92,690,1139,60.58%,31.43%,1
新北市,板橋區,1202,501,367,868,98,966,1750,55.2%,28.63%,1
新北市,板橋區,1203,640,458,1098,65,1163,3451,33.7%,18.55%,1
新北市,板橋區,1204,435,316,751,110,861,1620,53.15%,26.85%,1
新北市,板橋區,1205,247,157,404,33,437,903,48.39%,27.35%,1
新北市,板橋區,1206,373,287,660,57,717,1232,58.2%,30.28%,1
新北市,板橋區,1207,238,197,435,36,471,975,48.31%,24.41%,1
新北市,板橋區,1208,333,265,598,52,650,1224,53.1%,27.21%,1
新北市,板橋區,1209,353,311,664,25,689,1291,53.37%,27.34%,1
新北市,板橋區,1210,493,347,840,57,897,1828,49.07%,26.97%,1
新北市,板橋區,1211,469,329,798,70,868,1725,50.32%,27.19%,1
新北市,板橋區,1212,286,197,483,38,521,1085,48.02%,26.36%,1
新北市,板橋區,1213,659,455,1114,59,1173,2357,49.77%,27.96%,1
新北市,板橋區,1214,444,337,781,49,830,1560,53.21%,28.46%,1
新北市,板橋區,1215,565,356,921,44,965,2201,43.84%,25.67%,1
新北市,板橋區,1216,469,320,789,70,859,1626,52.83%,28.84%,1
新北市,板橋區,1217,446,319,765,60,825,1786,46.19%,24.97%,1
新北市,板橋區,1218,486,548,1034,61,1095,1763,62.11%,27.57%,1
新北市,板橋區,1219,469,354,823,29,852,1744,48.85%,26.89%,1
新北市,板橋區,1220,454,317,771,84,855,1645,51.98%,27.6%,1
新北市,板橋區,1221,516,315,831,63,894,1861,48.04%,27.73%,1
新北市,板橋區,1222,423,307,730,47,777,1596,48.68%,26.5%,1
新北市,板橋區,1223,549,370,919,94,1013,1871,54.14%,29.34%,1
新北市,板橋區,1224,590,373,963,102,1065,1938,54.95%,30.44%,1
新北市,板橋區,1225,536,401,937,82,1019,1827,55.77%,29.34%,1
新北市,板橋區,1226,385,262,647,69,716,1359,52.69%,28.33%,1
新北市,板橋區,1227,530,283,813,73,886,1613,54.93%,32.86%,1
新北市,板橋區,1228,473,327,800,84,884,1566,56.45%,30.2%,1
新北市,板橋區,1229,513,364,877,73,950,1552,61.21%,33.05%,1
新北市,板橋區,1230,509,388,897,53,950,1885,50.4%,27%,1
新北市,板橋區,1231,488,378,866,128,994,1893,52.51%,25.78%,1
新北市,三重區,0659,414,300,714,96,810,1509,53.68%,27.44%,1
新北市,三重區,0660,492,338,830,89,919,1591,57.76%,30.92%,1
新北市,三重區,0661,505,365,870,88,958,1653,57.96%,30.55%,1
新北市,三重區,0662,418,325,743,102,845,1392,60.7%,30.03%,1
新北市,三重區,0663,474,303,777,102,879,1451,60.58%,32.67%,1
新北市,三重區,0664,380,284,664,102,766,1329,57.64%,28.59%,1
新北市,三重區,0665,457,313,770,62,832,1459,57.03%,31.32%,1
新北市,三重區,0666,309,230,539,81,620,1024,60.55%,30.18%,1
新北市,三重區,0667,283,286,569,72,641,1066,60.13%,26.55%,1
新北市,三重區,0668,277,214,491,75,566,856,66.12%,32.36%,1
新北市,三重區,0669,221,170,391,49,440,764,57.59%,28.93%,1
新北市,三重區,0670,242,205,447,63,510,821,62.12%,29.48%,1
新北市,三重區,0671,456,429,885,85,970,1887,51.4%,24.17%,1
新北市,三重區,0672,445,359,804,80,884,1646,53.71%,27.04%,1
新北市,三重區,0673,109,84,193,22,215,358,60.06%,30.45%,1
新北市,三重區,0674,313,228,541,83,624,1039,60.06%,30.13%,1
新北市,三重區,0675,338,279,617,60,677,1114,60.77%,30.34%,1
新北市,三重區,0676,572,300,872,57,929,1588,58.5%,36.02%,1
新北市,三重區,0677,484,357,841,70,911,1702,53.53%,28.44%,1
新北市,三重區,0678,397,313,710,82,792,1288,61.49%,30.82%,1
新北市,三重區,0679,541,373,914,72,986,1629,60.53%,33.21%,1
新北市,三重區,0680,537,413,950,100,1050,1861,56.42%,28.86%,1
新北市,三重區,0681,472,357,829,66,895,1727,51.82%,27.33%,1
新北市,三重區,0682,516,425,941,71,1012,1813,55.82%,28.46%,1
新北市,三重區,0683,486,321,807,91,898,1595,56.3%,30.47%,1
新北市,三重區,0684,446,343,789,90,879,1513,58.1%,29.48%,1
新北市,三重區,0685,420,331,751,73,824,4433,18.59%,9.47%,1
新北市,三重區,0686,368,317,685,65,750,1283,58.46%,28.68%,1
新北市,三重區,0687,464,338,802,72,874,1430,61.12%,32.45%,1
新北市,三重區,0688,416,355,771,43,814,1357,59.99%,30.66%,1
新北市,三重區,0689,303,214,517,56,573,963,59.5%,31.46%,1
新北市,三重區,0690,270,196,466,61,527,883,59.68%,30.58%,1
新北市,三重區,0691,418,320,738,115,853,1494,57.1%,27.98%,1
新北市,三重區,0692,516,328,844,96,940,1616,58.17%,31.93%,1
新北市,三重區,0693,391,275,666,97,763,1329,57.41%,29.42%,1
新北市,三重區,0694,389,335,724,82,806,1289,62.53%,30.18%,1
新北市,三重區,0695,372,328,700,108,808,1380,58.55%,26.96%,1
新北市,三重區,0696,525,363,888,61,949,1668,56.89%,31.47%,1
新北市,三重區,0697,406,279,685,91,776,1226,63.3%,33.12%,1
新北市,三重區,0698,435,344,779,56,835,1421,58.76%,30.61%,1
新北市,三重區,0699,426,309,735,72,807,1364,59.16%,31.23%,1
新北市,三重區,0700,393,280,673,63,736,1232,59.74%,31.9%,1
新北市,三重區,0701,366,326,692,77,769,1248,61.62%,29.33%,1
新北市,三重區,0702,402,266,668,82,750,1256,59.71%,32.01%,1
新北市,三重區,0703,467,385,852,81,933,1506,61.95%,31.01%,1
新北市,三重區,0704,530,376,906,88,994,1669,59.56%,31.76%,1
新北市,三重區,0705,389,266,655,108,763,1308,58.33%,29.74%,1
新北市,三重區,0706,448,303,751,76,827,1263,65.48%,35.47%,1
新北市,三重區,0707,377,364,741,97,838,1471,56.97%,25.63%,1
新北市,三重區,0708,399,350,749,124,873,1447,60.33%,27.57%,1
新北市,三重區,0709,424,320,744,86,830,1693,49.03%,25.04%,1
新北市,三重區,0710,579,463,1042,41,1083,2015,53.75%,28.73%,1
新北市,三重區,0711,493,369,862,100,962,1812,53.09%,27.21%,1
新北市,三重區,0712,442,313,755,51,806,1509,53.41%,29.29%,1
新北市,三重區,0713,444,293,737,80,817,1439,56.78%,30.85%,1
新北市,三重區,0714,429,316,745,68,813,1437,56.58%,29.85%,1
新北市,三重區,0715,479,432,911,7,918,1697,54.1%,28.23%,1
新北市,三重區,0716,552,318,870,59,929,1793,51.81%,30.79%,1
新北市,三重區,0717,501,389,890,73,963,1603,60.07%,31.25%,1
新北市,三重區,0718,329,260,589,44,633,1166,54.29%,28.22%,1
新北市,三重區,0719,341,257,598,67,665,1126,59.06%,30.28%,1
新北市,三重區,0720,333,234,567,84,651,1291,50.43%,25.79%,1
新北市,三重區,0721,476,332,808,91,899,1597,56.29%,29.81%,1
新北市,三重區,0722,342,231,573,90,663,1081,61.33%,31.64%,1
新北市,三重區,0723,279,212,491,94,585,911,64.22%,30.63%,1
新北市,三重區,0724,447,335,782,63,845,1719,49.16%,26%,1
新北市,三重區,0725,354,268,622,105,727,1289,56.4%,27.46%,1
新北市,三重區,0726,425,269,694,111,805,1318,61.08%,32.25%,1
新北市,三重區,0727,478,382,860,87,947,1822,51.98%,26.23%,1
新北市,三重區,0728,316,237,553,114,667,1185,56.29%,26.67%,1
新北市,三重區,0729,354,250,604,118,722,1369,52.74%,25.86%,1
新北市,三重區,0730,428,326,754,102,856,1507,56.8%,28.4%,1
新北市,三重區,0731,283,189,472,80,552,926,59.61%,30.56%,1
新北市,三重區,0732,241,194,435,37,472,950,49.68%,25.37%,1
新北市,三重區,0733,427,343,770,96,866,1678,51.61%,25.45%,1
新北市,三重區,0734,311,236,547,91,638,1117,57.12%,27.84%,1
新北市,三重區,0735,346,277,623,80,703,1318,53.34%,26.25%,1
新北市,三重區,0736,390,311,701,59,760,1388,54.76%,28.1%,1
新北市,三重區,0737,293,210,503,95,598,1026,58.28%,28.56%,1
新北市,三重區,0738,324,289,613,69,682,1096,62.23%,29.56%,1
新北市,三重區,0739,310,207,517,56,573,967,59.26%,32.06%,1
新北市,三重區,0740,513,398,911,84,995,1871,53.18%,27.42%,1
新北市,三重區,0741,494,331,825,110,935,1663,56.22%,29.71%,1
新北市,三重區,0742,353,260,613,35,648,1208,53.64%,29.22%,1
新北市,三重區,0743,360,294,654,78,732,1398,52.36%,25.75%,1
新北市,三重區,0744,321,209,530,49,579,1078,53.71%,29.78%,1
新北市,三重區,0745,278,228,506,94,600,1102,54.45%,25.23%,1
新北市,三重區,0746,385,286,671,98,769,1393,55.2%,27.64%,1
新北市,三重區,0747,363,293,656,83,739,1251,59.07%,29.02%,1
新北市,三重區,0748,418,281,699,87,786,1234,63.7%,33.87%,1
新北市,三重區,0749,449,417,866,94,960,1661,57.8%,27.03%,1
新北市,三重區,0750,491,315,806,103,909,1590,57.17%,30.88%,1
新北市,三重區,0751,342,281,623,79,702,1182,59.39%,28.93%,1
新北市,三重區,0752,380,346,726,92,818,1369,59.75%,27.76%,1
新北市,三重區,0753,377,308,685,75,760,1222,62.19%,30.85%,1
新北市,三重區,0754,352,279,631,110,741,1304,56.83%,26.99%,1
新北市,三重區,0755,306,192,498,68,566,1054,53.7%,29.03%,1
新北市,三重區,0756,450,365,815,103,918,1635,56.15%,27.52%,1
新北市,三重區,0757,489,341,830,103,933,1779,52.45%,27.49%,1
新北市,三重區,0758,508,310,818,118,936,1633,57.32%,31.11%,1
新北市,三重區,0759,337,237,574,65,639,1107,57.72%,30.44%,1
新北市,三重區,0760,327,243,570,70,640,1021,62.68%,32.03%,1
新北市,三重區,0761,396,321,717,138,855,1649,51.85%,24.01%,1
新北市,三重區,0762,256,203,459,41,500,874,57.21%,29.29%,1
新北市,三重區,0763,380,292,672,156,828,1402,59.06%,27.1%,1
新北市,三重區,0764,439,314,753,110,863,1713,50.38%,25.63%,1
新北市,三重區,0765,215,202,417,73,490,973,50.36%,22.1%,1
新北市,三重區,0766,39,224,263,73,336,1038,32.37%,3.76%,1
新北市,三重區,0767,414,323,737,204,941,1833,51.34%,22.59%,1
新北市,三重區,0768,228,185,413,48,461,817,56.43%,27.91%,1
新北市,三重區,0769,415,326,741,82,823,1387,59.34%,29.92%,1
新北市,三重區,0770,233,182,415,47,462,784,58.93%,29.72%,1
新北市,三重區,0771,294,226,520,52,572,1096,52.19%,26.82%,1
新北市,三重區,0772,326,260,586,110,696,1163,59.85%,28.03%,1
新北市,三重區,0773,576,328,904,76,980,1868,52.46%,30.84%,1
新北市,三重區,0774,294,220,514,99,613,1117,54.88%,26.32%,1
新北市,三重區,0775,239,189,428,62,490,934,52.46%,25.59%,1
新北市,三重區,0776,353,289,642,100,742,1412,52.55%,25%,1
新北市,三重區,0777,357,251,608,67,675,1062,63.56%,33.62%,1
新北市,三重區,0778,250,164,414,95,509,891,57.13%,28.06%,1
新北市,三重區,0779,315,235,550,94,644,936,68.8%,33.65%,1
新北市,三重區,0780,261,248,509,84,593,1085,54.65%,24.06%,1
新北市,三重區,0781,261,197,458,34,492,1065,46.2%,24.51%,1
新北市,三重區,0782,411,298,709,88,797,1398,57.01%,29.4%,1
新北市,三重區,0783,460,338,798,72,870,1550,56.13%,29.68%,1
新北市,三重區,0784,449,349,798,113,911,1674,54.42%,26.82%,1
新北市,三重區,0785,361,248,609,99,708,1215,58.27%,29.71%,1
新北市,三重區,0786,453,344,797,91,888,1606,55.29%,28.21%,1
新北市,三重區,0787,354,255,609,65,674,1182,57.02%,29.95%,1
新北市,三重區,0788,343,285,628,101,729,1238,58.89%,27.71%,1
新北市,三重區,0789,395,305,700,97,797,1342,59.39%,29.43%,1
新北市,三重區,0790,418,319,737,82,819,1408,58.17%,29.69%,1
新北市,三重區,0791,423,446,869,126,995,1770,56.21%,23.9%,1
新北市,三重區,0792,247,237,484,69,553,940,58.83%,26.28%,1
新北市,三重區,0793,255,218,473,44,517,975,53.03%,26.15%,1
新北市,三重區,0794,401,323,724,79,803,1507,53.28%,26.61%,1
新北市,三重區,0795,384,324,708,105,813,1419,57.29%,27.06%,1
新北市,三重區,0796,365,262,627,85,712,1257,56.64%,29.04%,1
新北市,三重區,0797,485,341,826,96,922,1619,56.95%,29.96%,1
新北市,三重區,0798,487,377,864,19,883,1745,50.6%,27.91%,1
新北市,三重區,0799,425,328,753,106,859,1519,56.55%,27.98%,1
新北市,三重區,0800,473,331,804,85,889,1682,52.85%,28.12%,1
新北市,三重區,0801,510,380,890,102,992,1697,58.46%,30.05%,1
新北市,三重區,0802,301,196,497,87,584,1073,54.43%,28.05%,1
新北市,三重區,0803,256,189,445,67,512,924,55.41%,27.71%,1
新北市,三重區,0804,391,312,703,68,771,1613,47.8%,24.24%,1
新北市,三重區,0805,276,193,469,83,552,1034,53.38%,26.69%,1
新北市,三重區,0806,314,248,562,83,645,1118,57.69%,28.09%,1
新北市,三重區,0807,342,286,628,89,717,1269,56.5%,26.95%,1
新北市,三重區,0808,270,196,466,90,556,990,56.16%,27.27%,1
新北市,三重區,0809,385,282,667,91,758,1336,56.74%,28.82%,1
新北市,三重區,0810,498,313,811,93,904,1601,56.46%,31.11%,1
新北市,三重區,0811,482,389,871,82,953,1581,60.28%,30.49%,1
新北市,三重區,0812,408,292,700,82,782,1345,58.14%,30.33%,1
新北市,三重區,0813,364,332,696,77,773,1226,63.05%,29.69%,1
新北市,三重區,0814,471,279,750,113,863,1650,52.3%,28.55%,1
新北市,三重區,0815,332,241,573,85,658,1140,57.72%,29.12%,1
新北市,三重區,0816,472,302,774,62,836,1639,51.01%,28.8%,1
新北市,三重區,0817,602,274,876,77,953,1699,56.09%,35.43%,1
新北市,三重區,0818,564,333,897,97,994,1501,66.22%,37.57%,1
新北市,三重區,0819,430,345,775,94,869,1538,56.5%,27.96%,1
新北市,三重區,0820,439,308,747,95,842,1540,54.68%,28.51%,1
新北市,三重區,0821,360,265,625,92,717,1276,56.19%,28.21%,1
新北市,三重區,0822,410,319,729,89,818,1539,53.15%,26.64%,1
新北市,三重區,0823,316,315,631,72,703,1170,60.09%,27.01%,1
新北市,三重區,0824,315,258,573,61,634,1120,56.61%,28.13%,1
新北市,三重區,0825,428,370,798,112,910,1789,50.87%,23.92%,1
新北市,三重區,0826,405,297,702,109,811,1520,53.36%,26.64%,1
新北市,三重區,0827,505,392,897,117,1014,1821,55.68%,27.73%,1
新北市,三重區,0828,399,300,699,91,790,1407,56.15%,28.36%,1
新北市,三重區,0829,412,343,755,78,833,1491,55.87%,27.63%,1
新北市,三重區,0830,428,310,738,90,828,1381,59.96%,30.99%,1
新北市,三重區,0831,341,279,620,88,708,1222,57.94%,27.91%,1
新北市,三重區,0832,551,391,942,67,1009,1938,52.06%,28.43%,1
新北市,三重區,0833,479,366,845,49,894,1639,54.55%,29.23%,1
新北市,三重區,0834,460,327,787,118,905,1614,56.07%,28.5%,1
新北市,三重區,0835,518,328,846,89,935,1709,54.71%,30.31%,1
新北市,三重區,0836,483,324,807,101,908,1753,51.8%,27.55%,1
新北市,三重區,0837,420,306,726,91,817,1398,58.44%,30.04%,1
新北市,三重區,0838,469,364,833,88,921,1706,53.99%,27.49%,1
新北市,三重區,0839,474,353,827,96,923,1614,57.19%,29.37%,1
新北市,三重區,0840,441,349,790,102,892,1591,56.07%,27.72%,1
新北市,三重區,0841,443,354,797,78,875,1627,53.78%,27.23%,1
新北市,三重區,0842,452,312,764,108,872,1505,57.94%,30.03%,1
新北市,三重區,0843,391,295,686,70,756,1331,56.8%,29.38%,1
新北市,三重區,0844,448,316,764,78,842,1678,50.18%,26.7%,1
新北市,三重區,0845,445,340,785,63,848,1498,56.61%,29.71%,1
新北市,三重區,0846,520,420,940,113,1053,1800,58.5%,28.89%,1
新北市,三重區,0847,469,305,774,69,843,1703,49.5%,27.54%,1
新北市,三重區,0848,536,380,916,68,984,1975,49.82%,27.14%,1
新北市,三重區,0849,521,391,912,77,989,1894,52.22%,27.51%,1
新北市,三重區,0850,432,312,744,79,823,1405,58.58%,30.75%,1
新北市,三重區,0851,386,306,692,51,743,1293,57.46%,29.85%,1
新北市,三重區,0852,367,267,634,80,714,1259,56.71%,29.15%,1
新北市,三重區,0853,363,245,608,100,708,1144,61.89%,31.73%,1
新北市,三重區,0854,385,294,679,87,766,1254,61.08%,30.7%,1
新北市,三重區,0855,375,280,655,88,743,1313,56.59%,28.56%,1
新北市,三重區,0856,423,354,777,96,873,1594,54.77%,26.54%,1
新北市,三重區,0857,489,398,887,90,977,1775,55.04%,27.55%,1
新北市,三重區,0858,395,322,717,133,850,1516,56.07%,26.06%,1
新北市,三重區,0859,408,290,698,126,824,1315,62.66%,31.03%,1
新北市,三重區,0860,238,195,433,87,520,843,61.68%,28.23%,1
新北市,三重區,0861,291,234,525,87,612,1160,52.76%,25.09%,1
新北市,三重區,0862,302,237,539,81,620,1052,58.94%,28.71%,1
新北市,三重區,0863,331,255,586,76,662,1054,62.81%,31.4%,1
新北市,三重區,0864,273,228,501,89,590,997,59.18%,27.38%,1
新北市,三重區,0865,239,203,442,59,501,936,53.53%,25.53%,1
新北市,三重區,0866,414,341,755,126,881,1658,53.14%,24.97%,1
新北市,三重區,0867,394,313,707,94,801,1496,53.54%,26.34%,1
新北市,三重區,0868,308,268,576,79,655,1064,61.56%,28.95%,1
新北市,三重區,0869,377,257,634,70,704,1152,61.11%,32.73%,1
新北市,三重區,0870,415,328,743,59,802,1532,52.35%,27.09%,1
新北市,三重區,0871,339,241,580,60,640,1338,47.83%,25.34%,1
新北市,三重區,0872,346,230,576,81,657,1303,50.42%,26.55%,1
新北市,三重區,0873,457,250,707,110,817,1369,59.68%,33.38%,1
新北市,三重區,0874,415,315,730,102,832,1491,55.8%,27.83%,1
新北市,三重區,0875,447,361,808,140,948,1821,52.06%,24.55%,1
新北市,三重區,0876,532,357,889,76,965,1906,50.63%,27.91%,1
新北市,三重區,0877,552,411,963,86,1049,1842,56.95%,29.97%,1
新北市,三重區,0878,240,165,405,69,474,878,53.99%,27.33%,1
新北市,三重區,0879,296,236,532,77,609,963,63.24%,30.74%,1
新北市,三重區,0880,353,259,612,52,664,1381,48.08%,25.56%,1
新北市,三重區,0881,415,307,722,117,839,1681,49.91%,24.69%,1
新北市,三重區,0882,414,335,749,51,800,1548,51.68%,26.74%,1
新北市,三重區,0883,459,350,809,85,894,1542,57.98%,29.77%,1
新北市,三重區,0884,452,319,771,95,866,1557,55.62%,29.03%,1
新北市,三重區,0885,519,306,825,76,901,1661,54.24%,31.25%,1
新北市,三重區,0886,603,431,1034,47,1081,2024,53.41%,29.79%,1
新北市,三重區,0887,383,314,697,98,795,1588,50.06%,24.12%,1
新北市,三重區,0888,486,319,805,137,942,1706,55.22%,28.49%,1
新北市,三重區,0889,392,309,701,82,783,1341,58.39%,29.23%,1
新北市,三重區,0890,295,191,486,60,546,1025,53.27%,28.78%,1
新北市,三重區,0891,403,279,682,86,768,1339,57.36%,30.1%,1
新北市,三重區,0892,467,343,810,152,962,1725,55.77%,27.07%,1
新北市,三重區,0893,516,361,877,119,996,1826,54.55%,28.26%,1
新北市,中和區,1232,463,311,774,75,849,1630,52.09%,28.4%,1
新北市,中和區,1233,518,399,917,76,993,1775,55.94%,29.18%,1
新北市,中和區,1234,533,333,866,59,925,1844,50.16%,28.9%,1
新北市,中和區,1235,374,235,609,38,647,1019,63.49%,36.7%,1
新北市,中和區,1236,402,238,640,58,698,1138,61.34%,35.33%,1
新北市,中和區,1237,563,303,866,58,924,1878,49.2%,29.98%,1
新北市,中和區,1238,701,349,1050,76,1126,1980,56.87%,35.4%,1
新北市,中和區,1239,555,372,927,104,1031,1844,55.91%,30.1%,1
新北市,中和區,1240,669,410,1079,61,1140,2085,54.68%,32.09%,1
新北市,中和區,1241,468,284,752,81,833,1498,55.61%,31.24%,1
新北市,中和區,1242,555,353,908,51,959,1761,54.46%,31.52%,1
新北市,中和區,1243,361,267,628,51,679,1254,54.15%,28.79%,1
新北市,中和區,1244,433,295,728,57,785,1343,58.45%,32.24%,1
新北市,中和區,1245,576,338,914,61,975,1789,54.5%,32.2%,1
新北市,中和區,1246,644,396,1040,53,1093,2000,54.65%,32.2%,1
新北市,中和區,1247,547,368,915,58,973,1953,49.82%,28.01%,1
新北市,中和區,1248,528,344,872,78,950,1712,55.49%,30.84%,1
新北市,中和區,1249,536,290,826,75,901,1582,56.95%,33.88%,1
新北市,中和區,1250,552,326,878,79,957,1742,54.94%,31.69%,1
新北市,中和區,1251,515,325,840,76,916,1493,61.35%,34.49%,1
新北市,中和區,1252,377,276,653,64,717,1352,53.03%,27.88%,1
新北市,中和區,1253,431,254,685,56,741,1244,59.57%,34.65%,1
新北市,中和區,1254,446,297,743,74,817,1394,58.61%,31.99%,1
新北市,中和區,1255,504,304,808,40,848,1917,44.24%,26.29%,1
新北市,中和區,1256,492,361,853,102,955,1830,52.19%,26.89%,1
新北市,中和區,1257,339,248,587,79,666,1124,59.25%,30.16%,1
新北市,中和區,1258,362,285,647,53,700,1412,49.58%,25.64%,1
新北市,中和區,1259,394,285,679,64,743,1356,54.79%,29.06%,1
新北市,中和區,1260,447,173,620,56,676,1425,47.44%,31.37%,1
新北市,中和區,1261,386,285,671,87,758,1259,60.21%,30.66%,1
新北市,中和區,1262,351,288,639,94,733,1256,58.36%,27.95%,1
新北市,中和區,1263,447,280,727,69,796,1423,55.94%,31.41%,1
新北市,中和區,1264,372,269,641,68,709,1221,58.07%,30.47%,1
新北市,中和區,1265,513,332,845,89,934,1858,50.27%,27.61%,1
新北市,中和區,1266,518,341,859,68,927,1804,51.39%,28.71%,1
新北市,中和區,1267,545,358,903,49,952,1669,57.04%,32.65%,1
新北市,中和區,1268,467,312,779,57,836,1485,56.3%,31.45%,1
新北市,中和區,1269,313,230,543,68,611,1005,60.8%,31.14%,1
新北市,中和區,1270,392,284,676,74,750,1175,63.83%,33.36%,1
新北市,中和區,1271,370,252,622,71,693,1171,59.18%,31.6%,1
新北市,中和區,1272,486,326,812,58,870,1746,49.83%,27.84%,1
新北市,中和區,1273,426,281,707,58,765,1555,49.2%,27.4%,1
新北市,中和區,1274,327,231,558,80,638,1112,57.37%,29.41%,1
新北市,中和區,1275,609,367,976,75,1051,1780,59.04%,34.21%,1
新北市,中和區,1276,609,373,982,68,1050,1918,54.74%,31.75%,1
新北市,中和區,1277,468,261,729,38,767,1689,45.41%,27.71%,1
新北市,中和區,1278,629,348,977,51,1028,1781,57.72%,35.32%,1
新北市,中和區,1279,433,303,736,65,801,1419,56.45%,30.51%,1
新北市,中和區,1280,404,264,668,57,725,1344,53.94%,30.06%,1
新北市,中和區,1281,673,380,1053,70,1123,1804,62.25%,37.31%,1
新北市,中和區,1282,496,383,879,80,959,1788,53.64%,27.74%,1
新北市,中和區,1283,554,384,938,65,1003,1793,55.94%,30.9%,1
新北市,中和區,1284,439,251,690,91,781,1352,57.77%,32.47%,1
新北市,中和區,1285,629,311,940,85,1025,1813,56.54%,34.69%,1
新北市,中和區,1286,481,279,760,54,814,1288,63.2%,37.34%,1
新北市,中和區,1287,357,259,616,51,667,1186,56.24%,30.1%,1
新北市,中和區,1288,326,263,589,12,601,1237,48.59%,26.35%,1
新北市,中和區,1289,444,268,712,60,772,1406,54.91%,31.58%,1
新北市,中和區,1290,440,274,714,94,808,1442,56.03%,30.51%,1
新北市,中和區,1291,317,271,588,60,648,1040,62.31%,30.48%,1
新北市,中和區,1292,403,292,695,90,785,1292,60.76%,31.19%,1
新北市,中和區,1293,558,347,905,78,983,1811,54.28%,30.81%,1
新北市,中和區,1294,563,339,902,123,1025,1789,57.29%,31.47%,1
新北市,中和區,1295,324,188,512,53,565,859,65.77%,37.72%,1
新北市,中和區,1296,372,203,575,50,625,972,64.3%,38.27%,1
新北市,中和區,1297,409,296,705,67,772,1346,57.36%,30.39%,1
新北市,中和區,1298,321,228,549,49,598,1034,57.83%,31.04%,1
新北市,中和區,1299,453,282,735,65,800,1387,57.68%,32.66%,1
新北市,中和區,1300,661,393,1054,116,1170,2067,56.6%,31.98%,1
新北市,中和區,1301,430,311,741,65,806,1670,48.26%,25.75%,1
新北市,中和區,1302,357,233,590,74,664,1166,56.95%,30.62%,1
新北市,中和區,1303,325,201,526,47,573,963,59.5%,33.75%,1
新北市,中和區,1304,292,221,513,50,563,1070,52.62%,27.29%,1
新北市,中和區,1305,362,263,625,71,696,1319,52.77%,27.45%,1
新北市,中和區,1306,510,290,800,82,882,1438,61.34%,35.47%,1
新北市,中和區,1307,590,282,872,48,920,1808,50.88%,32.63%,1
新北市,中和區,1308,385,207,592,31,623,1191,52.31%,32.33%,1
新北市,中和區,1309,494,335,829,78,907,1632,55.58%,30.27%,1
新北市,中和區,1310,504,330,834,57,891,1765,50.48%,28.56%,1
新北市,中和區,1311,450,216,666,38,704,1168,60.27%,38.53%,1
新北市,中和區,1312,400,220,620,29,649,1176,55.19%,34.01%,1
新北市,中和區,1313,612,307,919,65,984,1565,62.88%,39.11%,1
新北市,中和區,1314,445,308,753,59,812,1578,51.46%,28.2%,1
新北市,中和區,1315,613,421,1034,45,1079,2029,53.18%,30.21%,1
新北市,中和區,1316,271,206,477,45,522,905,57.68%,29.94%,1
新北市,中和區,1317,231,162,393,50,443,839,52.8%,27.53%,1
新北市,中和區,1318,244,157,401,36,437,762,57.35%,32.02%,1
新北市,中和區,1319,327,282,609,86,695,1420,48.94%,23.03%,1
新北市,中和區,1320,392,238,630,66,696,1272,54.72%,30.82%,1
新北市,中和區,1321,635,334,969,80,1049,1976,53.09%,32.14%,1
新北市,中和區,1322,628,290,918,54,972,1779,54.64%,35.3%,1
新北市,中和區,1323,376,259,635,73,708,1454,48.69%,25.86%,1
新北市,中和區,1324,414,244,658,56,714,1374,51.97%,30.13%,1
新北市,中和區,1325,401,239,640,54,694,1369,50.69%,29.29%,1
新北市,中和區,1326,451,312,763,70,833,1501,55.5%,30.05%,1
新北市,中和區,1327,317,208,525,75,600,920,65.22%,34.46%,1
新北市,中和區,1328,366,214,580,68,648,1050,61.71%,34.86%,1
新北市,中和區,1329,99,74,173,25,198,321,61.68%,30.84%,1
新北市,中和區,1330,435,276,711,83,794,1474,53.87%,29.51%,1
新北市,中和區,1331,460,275,735,103,838,1461,57.36%,31.49%,1
新北市,中和區,1332,508,290,798,61,859,1621,52.99%,31.34%,1
新北市,中和區,1333,369,333,702,83,785,1327,59.16%,27.81%,1
新北市,中和區,1334,238,167,405,46,451,775,58.19%,30.71%,1
新北市,中和區,1335,534,372,906,54,960,1916,50.1%,27.87%,1
新北市,中和區,1336,535,353,888,94,982,1901,51.66%,28.14%,1
新北市,中和區,1337,413,294,707,58,765,4411,17.34%,9.36%,1
新北市,中和區,1338,366,246,612,63,675,1212,55.69%,30.2%,1
新北市,中和區,1339,368,232,600,53,653,1126,57.99%,32.68%,1
新北市,中和區,1340,461,235,696,44,740,1507,49.1%,30.59%,1
新北市,中和區,1341,485,305,790,26,816,1519,53.72%,31.93%,1
新北市,中和區,1342,476,305,781,62,843,1467,57.46%,32.45%,1
新北市,中和區,1343,471,313,784,98,882,1453,60.7%,32.42%,1
新北市,中和區,1344,496,274,770,54,824,1364,60.41%,36.36%,1
新北市,中和區,1345,410,264,674,57,731,1302,56.14%,31.49%,1
新北市,中和區,1346,439,259,698,47,745,1627,45.79%,26.98%,1
新北市,中和區,1347,421,306,727,48,775,1503,51.56%,28.01%,1
新北市,中和區,1348,409,282,691,36,727,1392,52.23%,29.38%,1
新北市,中和區,1349,353,242,595,44,639,1067,59.89%,33.08%,1
新北市,中和區,1350,478,318,796,65,861,1623,53.05%,29.45%,1
新北市,中和區,1351,428,245,673,37,710,1208,58.77%,35.43%,1
新北市,中和區,1352,492,322,814,75,889,1991,44.65%,24.71%,1
新北市,中和區,1353,557,268,825,77,902,1932,46.69%,28.83%,1
新北市,中和區,1354,376,215,591,35,626,947,66.1%,39.7%,1
新北市,中和區,1355,519,344,863,96,959,1660,57.77%,31.27%,1
新北市,中和區,1356,446,275,721,65,786,1574,49.94%,28.34%,1
新北市,中和區,1357,620,388,1008,72,1080,2136,50.56%,29.03%,1
新北市,中和區,1358,440,257,697,84,781,1462,53.42%,30.1%,1
新北市,中和區,1359,425,288,713,101,814,1548,52.58%,27.45%,1
新北市,中和區,1360,260,160,420,37,457,692,66.04%,37.57%,1
新北市,中和區,1361,478,221,699,72,771,1221,63.14%,39.15%,1
新北市,中和區,1362,429,291,720,71,791,1331,59.43%,32.23%,1
新北市,中和區,1363,310,238,548,60,608,984,61.79%,31.5%,1
新北市,中和區,1364,567,324,891,54,945,1871,50.51%,30.3%,1
新北市,中和區,1365,375,238,613,71,684,1279,53.48%,29.32%,1
新北市,中和區,1366,522,343,865,60,925,1629,56.78%,32.04%,1
新北市,中和區,1367,464,328,792,50,842,1482,56.82%,31.31%,1
新北市,中和區,1368,544,390,934,68,1002,1715,58.43%,31.72%,1
新北市,中和區,1369,647,362,1009,77,1086,1952,55.64%,33.15%,1
新北市,中和區,1370,195,154,349,50,399,686,58.16%,28.43%,1
新北市,中和區,1371,396,313,709,52,761,1577,48.26%,25.11%,1
新北市,中和區,1372,367,262,629,52,681,1158,58.81%,31.69%,1
新北市,中和區,1373,348,365,713,35,748,1195,62.59%,29.12%,1
新北市,中和區,1374,370,253,623,52,675,1054,64.04%,35.1%,1
新北市,中和區,1375,211,152,363,30,393,612,64.22%,34.48%,1
新北市,中和區,1376,559,333,892,53,945,1668,56.65%,33.51%,1
新北市,中和區,1377,363,245,608,74,682,1071,63.68%,33.89%,1
新北市,中和區,1378,441,275,716,83,799,1169,68.35%,37.72%,1
新北市,中和區,1379,402,283,685,54,739,1370,53.94%,29.34%,1
新北市,中和區,1380,514,343,857,99,956,1574,60.74%,32.66%,1
新北市,中和區,1381,663,440,1103,53,1156,2614,44.22%,25.36%,1
新北市,中和區,1382,498,314,812,60,872,1477,59.04%,33.72%,1
新北市,中和區,1383,294,244,538,74,612,1041,58.79%,28.24%,1
新北市,中和區,1384,439,275,714,76,790,1538,51.37%,28.54%,1
新北市,中和區,1385,462,317,779,78,857,1599,53.6%,28.89%,1
新北市,中和區,1386,499,329,828,110,938,1586,59.14%,31.46%,1
新北市,中和區,1387,517,431,948,98,1046,1726,60.6%,29.95%,1
新北市,中和區,1388,583,442,1025,108,1133,1854,61.11%,31.45%,1
新北市,中和區,1389,478,336,814,83,897,1472,60.94%,32.47%,1
新北市,中和區,1390,484,307,791,79,870,1430,60.84%,33.85%,1
新北市,中和區,1391,508,313,821,69,890,1488,59.81%,34.14%,1
新北市,中和區,1392,392,238,630,53,683,1251,54.6%,31.33%,1
新北市,中和區,1393,483,313,796,67,863,1487,58.04%,32.48%,1
新北市,中和區,1394,393,256,649,96,745,1328,56.1%,29.59%,1
新北市,中和區,1395,378,261,639,61,700,1128,62.06%,33.51%,1
新北市,中和區,1396,376,239,615,44,659,1008,65.38%,37.3%,1
新北市,中和區,1397,561,413,974,48,1022,1786,57.22%,31.41%,1
新北市,中和區,1398,682,441,1123,68,1191,2219,53.67%,30.73%,1
新北市,中和區,1399,354,267,621,53,674,1322,50.98%,26.78%,1
新北市,中和區,1400,438,295,733,43,776,1495,51.91%,29.3%,1
新北市,中和區,1401,396,293,689,76,765,1414,54.1%,28.01%,1
新北市,中和區,1402,489,393,882,88,970,1681,57.7%,29.09%,1
新北市,中和區,1403,421,264,685,71,756,1361,55.55%,30.93%,1
新北市,中和區,1404,439,291,730,75,805,1442,55.83%,30.44%,1
新北市,中和區,1405,400,269,669,39,708,1383,51.19%,28.92%,1
新北市,中和區,1406,429,259,688,40,728,1264,57.59%,33.94%,1
新北市,中和區,1407,585,376,961,127,1088,1810,60.11%,32.32%,1
新北市,中和區,1408,532,338,870,91,961,1951,49.26%,27.27%,1
新北市,中和區,1409,468,260,728,60,788,1582,49.81%,29.58%,1
新北市,中和區,1410,631,417,1048,104,1152,1945,59.23%,32.44%,1
新北市,中和區,1411,459,290,749,58,807,1390,58.06%,33.02%,1
新北市,中和區,1412,371,261,632,29,661,1161,56.93%,31.96%,1
新北市,中和區,1413,506,213,719,58,777,1399,55.54%,36.17%,1
新北市,中和區,1414,305,244,549,33,582,1070,54.39%,28.5%,1
新北市,中和區,1415,330,269,599,28,627,1169,53.64%,28.23%,1
新北市,中和區,1416,436,255,691,76,767,1214,63.18%,35.91%,1
新北市,中和區,1417,452,306,758,69,827,1398,59.16%,32.33%,1
新北市,中和區,1418,308,248,556,52,608,1049,57.96%,29.36%,1
新北市,中和區,1419,439,316,755,61,816,1324,61.63%,33.16%,1
新北市,中和區,1420,467,292,759,60,819,1765,46.4%,26.46%,1
新北市,中和區,1421,424,355,779,101,880,1709,51.49%,24.81%,1
新北市,中和區,1422,357,252,609,87,696,1186,58.68%,30.1%,1
新北市,中和區,1423,439,255,694,80,774,1318,58.73%,33.31%,1
新北市,中和區,1424,488,289,777,79,856,1430,59.86%,34.13%,1
新北市,中和區,1425,401,250,651,77,728,1637,44.47%,24.5%,1
新北市,中和區,1426,373,261,634,76,710,1283,55.34%,29.07%,1
新北市,中和區,1427,356,322,678,69,747,1310,57.02%,27.18%,1
新北市,中和區,1428,421,281,702,65,767,1301,58.95%,32.36%,1
新北市,中和區,1429,493,368,861,99,960,1681,57.11%,29.33%,1
新北市,中和區,1430,427,296,723,68,791,1384,57.15%,30.85%,1
新北市,中和區,1431,339,265,604,80,684,1187,57.62%,28.56%,1
新北市,中和區,1432,445,315,760,3,763,1779,42.89%,25.01%,1
新北市,中和區,1433,560,343,903,68,971,1712,56.72%,32.71%,1
新北市,中和區,1434,448,281,729,71,800,1462,54.72%,30.64%,1
新北市,中和區,1435,592,326,918,51,969,1824,53.13%,32.46%,1
新北市,中和區,1436,524,173,697,80,777,1389,55.94%,37.72%,1
新北市,中和區,1437,489,293,782,65,847,1434,59.07%,34.1%,1
新北市,中和區,1438,330,630,960,80,1040,1953,53.25%,16.9%,1
新北市,中和區,1439,632,396,1028,98,1126,2002,56.24%,31.57%,1
新北市,中和區,1440,602,322,924,54,978,1858,52.64%,32.4%,1
新北市,中和區,1441,600,344,944,50,994,1801,55.19%,33.31%,1
新北市,中和區,1442,584,314,898,74,972,1691,57.48%,34.54%,1
新北市,中和區,1443,478,269,747,64,811,1363,59.5%,35.07%,1
新北市,中和區,1444,454,258,712,50,762,1220,62.46%,37.21%,1
新北市,中和區,1445,488,323,811,47,858,1365,62.86%,35.75%,1
新北市,中和區,1446,392,230,622,46,668,1178,56.71%,33.28%,1
新北市,中和區,1447,251,210,461,43,504,830,60.72%,30.24%,1
新北市,中和區,1448,321,244,565,75,640,1197,53.47%,26.82%,1
新北市,中和區,1449,451,281,732,68,800,1369,58.44%,32.94%,1
新北市,中和區,1450,448,277,725,73,798,1336,59.73%,33.53%,1
新北市,中和區,1451,486,302,788,70,858,1377,62.31%,35.29%,1
新北市,中和區,1452,493,314,807,78,885,1499,59.04%,32.89%,1
新北市,中和區,1453,592,332,924,54,978,1689,57.9%,35.05%,1
新北市,中和區,1454,403,326,729,66,795,1323,60.09%,30.46%,1
新北市,中和區,1455,369,234,603,69,672,1079,62.28%,34.2%,1
新北市,中和區,1456,482,357,839,72,911,1545,58.96%,31.2%,1
新北市,中和區,1457,398,261,659,73,732,1326,55.2%,30.02%,1
新北市,中和區,1458,500,246,746,39,785,1443,54.4%,34.65%,1
新北市,中和區,1459,591,312,903,47,950,1712,55.49%,34.52%,1
新北市,中和區,1460,641,319,960,84,1044,1916,54.49%,33.46%,1
新北市,中和區,1461,287,196,483,58,541,863,62.69%,33.26%,1
新北市,中和區,1462,441,284,725,12,737,1203,61.26%,36.66%,1
新北市,中和區,1463,505,264,769,34,803,1483,54.15%,34.05%,1
新北市,中和區,1464,507,273,780,62,842,1575,53.46%,32.19%,1
新北市,中和區,1465,413,250,663,63,726,1432,50.7%,28.84%,1
新北市,中和區,1466,433,294,727,79,806,1441,55.93%,30.05%,1
新北市,中和區,1467,425,249,674,72,746,1269,58.79%,33.49%,1
新北市,中和區,1468,515,249,764,44,808,1363,59.28%,37.78%,1
新北市,中和區,1469,376,210,586,43,629,1089,57.76%,34.53%,1
新北市,中和區,1470,311,260,571,36,607,1171,51.84%,26.56%,1
新北市,中和區,1471,379,220,599,46,645,1150,56.09%,32.96%,1
新北市,中和區,1472,439,224,663,35,698,1154,60.49%,38.04%,1
新北市,中和區,1473,387,231,618,47,665,1067,62.32%,36.27%,1
新北市,中和區,1474,491,271,762,65,827,1526,54.19%,32.18%,1
新北市,中和區,1475,508,283,791,56,847,1447,58.53%,35.11%,1
新北市,永和區,1476,497,333,830,87,917,1554,59.01%,31.98%,1
新北市,永和區,1477,366,210,576,27,603,1065,56.62%,34.37%,1
新北市,永和區,1478,302,188,490,55,545,854,63.82%,35.36%,1
新北市,永和區,1479,465,220,685,75,760,1253,60.65%,37.11%,1
新北市,永和區,1480,571,336,907,64,971,1733,56.03%,32.95%,1
新北市,永和區,1481,534,291,825,69,894,1581,56.55%,33.78%,1
新北市,永和區,1482,567,306,873,89,962,1735,55.45%,32.68%,1
新北市,永和區,1483,503,313,816,44,860,1563,55.02%,32.18%,1
新北市,永和區,1484,579,334,913,73,986,1650,59.76%,35.09%,1
新北市,永和區,1485,507,266,773,56,829,1454,57.02%,34.87%,1
新北市,永和區,1486,465,295,760,68,828,1568,52.81%,29.66%,1
新北市,永和區,1487,469,266,735,65,800,1444,55.4%,32.48%,1
新北市,永和區,1488,316,258,574,51,625,1140,54.82%,27.72%,1
新北市,永和區,1489,252,409,661,67,728,1188,61.28%,21.21%,1
新北市,永和區,1490,449,323,772,83,855,1516,56.4%,29.62%,1
新北市,永和區,1491,447,258,705,75,780,1397,55.83%,32%,1
新北市,永和區,1492,470,292,762,54,816,1438,56.75%,32.68%,1
新北市,永和區,1493,364,241,605,48,653,1084,60.24%,33.58%,1
新北市,永和區,1494,312,196,508,43,551,941,58.55%,33.16%,1
新北市,永和區,1495,542,269,811,61,872,1598,54.57%,33.92%,1
新北市,永和區,1496,485,305,790,37,827,2842,29.1%,17.07%,1
新北市,永和區,1497,430,298,728,62,790,1261,62.65%,34.1%,1
新北市,永和區,1498,532,343,875,51,926,1449,63.91%,36.71%,1
新北市,永和區,1499,521,315,836,56,892,1511,59.03%,34.48%,1
新北市,永和區,1500,546,322,868,52,920,1470,62.59%,37.14%,1
新北市,永和區,1501,629,221,850,58,908,1580,57.47%,39.81%,1
新北市,永和區,1502,510,325,835,68,903,1438,62.8%,35.47%,1
新北市,永和區,1503,482,295,777,39,816,1305,62.53%,36.93%,1
新北市,永和區,1504,376,239,615,29,644,1046,61.57%,35.95%,1
新北市,永和區,1505,509,355,864,24,888,1566,56.7%,32.5%,1
新北市,永和區,1506,466,343,809,60,869,1468,59.2%,31.74%,1
新北市,永和區,1507,494,312,806,55,861,1305,65.98%,37.85%,1
新北市,永和區,1508,385,275,660,51,711,1181,60.2%,32.6%,1
新北市,永和區,1509,557,305,862,72,934,1720,54.3%,32.38%,1
新北市,永和區,1510,359,284,643,39,682,1103,61.83%,32.55%,1
新北市,永和區,1511,509,313,822,148,970,1649,58.82%,30.87%,1
新北市,永和區,1512,395,310,705,49,754,1206,62.52%,32.75%,1
新北市,永和區,1513,551,314,865,47,912,1506,60.56%,36.59%,1
新北市,永和區,1514,511,274,785,72,857,1488,57.59%,34.34%,1
新北市,永和區,1515,449,261,710,87,797,1288,61.88%,34.86%,1
新北市,永和區,1516,455,236,691,53,744,1413,52.65%,32.2%,1
新北市,永和區,1517,468,245,713,60,773,1329,58.16%,35.21%,1
新北市,永和區,1518,556,292,848,52,900,1436,62.67%,38.72%,1
新北市,永和區,1519,339,269,608,59,667,1112,59.98%,30.49%,1
新北市,永和區,1520,418,274,692,53,745,1100,67.73%,38%,1
新北市,永和區,1521,559,331,890,63,953,1545,61.68%,36.18%,1
新北市,永和區,1522,516,267,783,29,812,1436,56.55%,35.93%,1
新北市,永和區,1523,630,371,1001,75,1076,1731,62.16%,36.4%,1
新北市,永和區,1524,593,406,999,82,1081,1762,61.35%,33.65%,1
新北市,永和區,1525,369,313,682,63,745,1320,56.44%,27.95%,1
新北市,永和區,1526,379,224,603,28,631,1297,48.65%,29.22%,1
新北市,永和區,1527,550,348,898,88,986,1798,54.84%,30.59%,1
新北市,永和區,1528,508,320,828,78,906,1491,60.76%,34.07%,1
新北市,永和區,1529,430,240,670,32,702,1223,57.4%,35.16%,1
新北市,永和區,1530,373,224,597,72,669,1108,60.38%,33.66%,1
新北市,永和區,1531,456,335,791,70,861,1408,61.15%,32.39%,1
新北市,永和區,1532,419,283,702,66,768,1265,60.71%,33.12%,1
新北市,永和區,1533,346,223,569,37,606,1115,54.35%,31.03%,1
新北市,永和區,1534,376,280,656,71,727,1133,64.17%,33.19%,1
新北市,永和區,1535,423,239,662,66,728,1217,59.82%,34.76%,1
新北市,永和區,1536,543,340,883,80,963,1713,56.22%,31.7%,1
新北市,永和區,1537,553,311,864,72,936,1721,54.39%,32.13%,1
新北市,永和區,1538,406,267,673,77,750,1327,56.52%,30.6%,1
新北市,永和區,1539,451,285,736,45,781,1257,62.13%,35.88%,1
新北市,永和區,1540,477,320,797,54,851,1348,63.13%,35.39%,1
新北市,永和區,1541,665,310,975,47,1022,1461,69.95%,45.52%,1
新北市,永和區,1542,448,296,744,72,816,1368,59.65%,32.75%,1
新北市,永和區,1543,267,246,513,104,617,1234,50%,21.64%,1
新北市,永和區,1544,443,262,705,63,768,1303,58.94%,34%,1
新北市,永和區,1545,510,270,780,44,824,1516,54.35%,33.64%,1
新北市,永和區,1546,492,299,791,78,869,1422,61.11%,34.6%,1
新北市,永和區,1547,361,221,582,38,620,991,62.56%,36.43%,1
新北市,永和區,1548,372,226,598,51,649,1016,63.88%,36.61%,1
新北市,永和區,1549,410,222,632,62,694,1146,60.56%,35.78%,1
新北市,永和區,1550,344,242,586,42,628,1043,60.21%,32.98%,1
新北市,永和區,1551,442,262,704,23,727,1210,60.08%,36.53%,1
新北市,永和區,1552,553,333,886,45,931,1630,57.12%,33.93%,1
新北市,永和區,1553,396,226,622,37,659,1092,60.35%,36.26%,1
新北市,永和區,1554,617,414,1031,75,1106,1872,59.08%,32.96%,1
新北市,永和區,1555,618,345,963,45,1008,1781,56.6%,34.7%,1
新北市,永和區,1556,355,239,594,54,648,1049,61.77%,33.84%,1
新北市,永和區,1557,471,286,757,49,806,1285,62.72%,36.65%,1
新北市,永和區,1558,426,267,693,54,747,1209,61.79%,35.24%,1
新北市,永和區,1559,374,298,672,39,711,1132,62.81%,33.04%,1
新北市,永和區,1560,453,314,767,54,821,1287,63.79%,35.2%,1
新北市,永和區,1561,350,262,612,60,672,1068,62.92%,32.77%,1
新北市,永和區,1562,390,263,653,59,712,1098,64.85%,35.52%,1
新北市,永和區,1563,443,260,703,60,763,1222,62.44%,36.25%,1
新北市,永和區,1564,388,240,628,80,708,1157,61.19%,33.54%,1
新北市,永和區,1565,402,290,692,73,765,1168,65.5%,34.42%,1
新北市,永和區,1566,393,283,676,75,751,1283,58.53%,30.63%,1
新北市,永和區,1567,454,303,757,47,804,1372,58.6%,33.09%,1
新北市,永和區,1568,658,387,1045,77,1122,1876,59.81%,35.07%,1
新北市,永和區,1569,546,367,913,89,1002,1576,63.58%,34.64%,1
新北市,永和區,1570,539,386,925,71,996,1661,59.96%,32.45%,1
新北市,永和區,1571,600,373,973,45,1018,1808,56.31%,33.19%,1
新北市,永和區,1572,621,372,993,73,1066,1898,56.16%,32.72%,1
新北市,永和區,1573,550,313,863,64,927,1508,61.47%,36.47%,1
新北市,永和區,1574,448,293,741,77,818,1341,61%,33.41%,1
新北市,永和區,1575,453,308,761,70,831,1422,58.44%,31.86%,1
新北市,永和區,1576,406,239,645,46,691,1177,58.71%,34.49%,1
新北市,永和區,1577,489,338,827,94,921,1557,59.15%,31.41%,1
新北市,永和區,1578,449,321,770,60,830,1491,55.67%,30.11%,1
新北市,永和區,1579,516,318,834,69,903,1586,56.94%,32.53%,1
新北市,永和區,1580,424,259,683,33,716,1313,54.53%,32.29%,1
新北市,永和區,1581,488,371,859,77,936,1636,57.21%,29.83%,1
新北市,永和區,1582,494,352,846,79,925,1598,57.88%,30.91%,1
新北市,永和區,1583,593,324,917,59,976,1609,60.66%,36.86%,1
新北市,永和區,1584,495,308,803,51,854,1375,62.11%,36%,1
新北市,永和區,1585,624,354,978,60,1038,1648,62.99%,37.86%,1
新北市,永和區,1586,332,255,587,59,646,1077,59.98%,30.83%,1
新北市,永和區,1587,394,258,652,56,708,1157,61.19%,34.05%,1
新北市,永和區,1588,506,308,814,40,854,1339,63.78%,37.79%,1
新北市,永和區,1589,479,285,764,35,799,1306,61.18%,36.68%,1
新北市,永和區,1590,476,273,749,37,786,1236,63.59%,38.51%,1
新北市,永和區,1591,428,243,671,35,706,1133,62.31%,37.78%,1
新北市,永和區,1592,533,296,829,36,865,1425,60.7%,37.4%,1
新北市,永和區,1593,612,399,1011,100,1111,1938,57.33%,31.58%,1
新北市,永和區,1594,553,352,905,58,963,1607,59.93%,34.41%,1
新北市,永和區,1595,298,180,478,48,526,853,61.66%,34.94%,1
新北市,永和區,1596,216,153,369,58,427,768,55.6%,28.13%,1
新北市,永和區,1597,232,156,388,40,428,893,47.93%,25.98%,1
新北市,永和區,1598,236,167,403,33,436,743,58.68%,31.76%,1
新北市,永和區,1599,390,278,668,51,719,1155,62.25%,33.77%,1
新北市,永和區,1600,439,280,719,66,785,1263,62.15%,34.76%,1
新北市,永和區,1601,441,251,692,41,733,1189,61.65%,37.09%,1
新北市,永和區,1602,410,288,698,47,745,1346,55.35%,30.46%,1
新北市,永和區,1603,458,256,714,61,775,1368,56.65%,33.48%,1
新北市,永和區,1604,354,221,575,43,618,1043,59.25%,33.94%,1
新北市,永和區,1605,557,406,963,68,1031,1709,60.33%,32.59%,1
新北市,永和區,1606,273,174,447,35,482,879,54.84%,31.06%,1
新北市,永和區,1607,262,237,499,43,542,904,59.96%,28.98%,1
新北市,永和區,1608,440,269,709,63,772,1221,63.23%,36.04%,1
新北市,永和區,1609,235,250,485,48,533,1018,52.36%,23.08%,1
新北市,永和區,1610,522,292,814,60,874,1551,56.35%,33.66%,1
新北市,永和區,1611,478,310,788,67,855,1428,59.87%,33.47%,1
新北市,永和區,1612,365,221,586,61,647,1044,61.97%,34.96%,1
新北市,永和區,1613,351,196,547,61,608,967,62.87%,36.3%,1
新北市,新莊區,0302,336,238,574,87,661,1123,58.86%,29.92%,1
新北市,新莊區,0303,383,310,693,83,776,1278,60.72%,29.97%,1
新北市,新莊區,0304,352,304,656,82,738,1163,63.46%,30.27%,1
新北市,新莊區,0305,386,299,685,72,757,1228,61.64%,31.43%,1
新北市,新莊區,0306,345,304,649,62,711,1211,58.71%,28.49%,1
新北市,新莊區,0307,318,308,626,75,701,1176,59.61%,27.04%,1
新北市,新莊區,0308,493,367,860,79,939,1536,61.13%,32.1%,1
新北市,新莊區,0309,478,382,860,70,930,1486,62.58%,32.17%,1
新北市,新莊區,0310,508,378,886,88,974,1513,64.38%,33.58%,1
新北市,新莊區,0311,431,339,770,120,890,1395,63.8%,30.9%,1
新北市,新莊區,0312,408,270,678,92,770,1353,56.91%,30.16%,1
新北市,新莊區,0313,471,330,801,76,877,1409,62.24%,33.43%,1
新北市,新莊區,0314,462,299,761,49,810,1478,54.8%,31.26%,1
新北市,新莊區,0315,278,215,493,82,575,921,62.43%,30.18%,1
新北市,新莊區,0316,336,215,551,60,611,971,62.92%,34.6%,1
新北市,新莊區,0317,492,368,860,102,962,1534,62.71%,32.07%,1
新北市,新莊區,0318,478,308,786,52,838,1516,55.28%,31.53%,1
新北市,新莊區,0319,198,162,360,52,412,697,59.11%,28.41%,1
新北市,新莊區,0320,415,254,669,45,714,1235,57.81%,33.6%,1
新北市,新莊區,0321,359,236,595,51,646,1138,56.77%,31.55%,1
新北市,新莊區,0322,288,226,514,38,552,1063,51.93%,27.09%,1
新北市,新莊區,0323,460,316,776,66,842,3399,24.77%,13.53%,1
新北市,新莊區,0324,509,347,856,80,936,1575,59.43%,32.32%,1
新北市,新莊區,0325,543,381,924,78,1002,1615,62.04%,33.62%,1
新北市,新莊區,0326,424,342,766,85,851,1612,52.79%,26.3%,1
新北市,新莊區,0327,450,297,747,91,838,1514,55.35%,29.72%,1
新北市,新莊區,0328,380,266,646,42,688,1382,49.78%,27.5%,1
新北市,新莊區,0329,429,324,753,72,825,1475,55.93%,29.08%,1
新北市,新莊區,0330,497,303,800,30,830,1462,56.77%,33.99%,1
新北市,新莊區,0331,415,310,725,59,784,1426,54.98%,29.1%,1
新北市,新莊區,0332,412,303,715,75,790,1421,55.59%,28.99%,1
新北市,新莊區,0333,485,304,789,35,824,1536,53.65%,31.58%,1
新北市,新莊區,0334,490,363,853,68,921,1587,58.03%,30.88%,1
新北市,新莊區,0335,197,186,383,18,401,749,53.54%,26.3%,1
新北市,新莊區,0336,424,281,705,63,768,1276,60.19%,33.23%,1
新北市,新莊區,0337,404,263,667,44,711,1303,54.57%,31.01%,1
新北市,新莊區,0338,391,301,692,77,769,1259,61.08%,31.06%,1
新北市,新莊區,0339,442,278,720,59,779,1291,60.34%,34.24%,1
新北市,新莊區,0340,505,312,817,28,845,1493,56.6%,33.82%,1
新北市,新莊區,0341,467,339,806,71,877,1507,58.2%,30.99%,1
新北市,新莊區,0342,471,301,772,35,807,1456,55.43%,32.35%,1
新北市,新莊區,0343,444,301,745,36,781,1396,55.95%,31.81%,1
新北市,新莊區,0344,360,254,614,74,688,1351,50.93%,26.65%,1
新北市,新莊區,0345,422,271,693,101,794,1403,56.59%,30.08%,1
新北市,新莊區,0346,445,301,746,88,834,1497,55.71%,29.73%,1
新北市,新莊區,0347,402,265,667,107,774,1272,60.85%,31.6%,1
新北市,新莊區,0348,355,212,567,60,627,1269,49.41%,27.97%,1
新北市,新莊區,0349,389,310,699,92,791,1335,59.25%,29.14%,1
新北市,新莊區,0350,462,275,737,53,790,1300,60.77%,35.54%,1
新北市,新莊區,0351,435,287,722,63,785,1286,61.04%,33.83%,1
新北市,新莊區,0352,437,312,749,73,822,1255,65.5%,34.82%,1
新北市,新莊區,0353,445,332,777,139,916,1558,58.79%,28.56%,1
新北市,新莊區,0354,452,324,776,85,861,1567,54.95%,28.84%,1
新北市,新莊區,0355,497,347,844,102,946,1603,59.01%,31%,1
新北市,新莊區,0356,456,362,818,47,865,1538,56.24%,29.65%,1
新北市,新莊區,0357,544,343,887,66,953,1671,57.03%,32.56%,1
新北市,新莊區,0358,474,358,832,53,885,1698,52.12%,27.92%,1
新北市,新莊區,0359,495,376,871,67,938,1545,60.71%,32.04%,1
新北市,新莊區,0360,518,388,906,135,1041,1696,61.38%,30.54%,1
新北市,新莊區,0361,452,321,773,111,884,1626,54.37%,27.8%,1
新北市,新莊區,0362,301,231,532,100,632,1170,54.02%,25.73%,1
新北市,新莊區,0363,358,243,601,119,720,1236,58.25%,28.96%,1
新北市,新莊區,0364,305,206,511,76,587,1071,54.81%,28.48%,1
新北市,新莊區,0365,331,251,582,69,651,1129,57.66%,29.32%,1
新北市,新莊區,0366,485,379,864,59,923,1586,58.2%,30.58%,1
新北市,新莊區,0367,430,305,735,93,828,1597,51.85%,26.93%,1
新北市,新莊區,0368,378,311,689,127,816,1573,51.88%,24.03%,1
新北市,新莊區,0369,344,238,582,59,641,1225,52.33%,28.08%,1
新北市,新莊區,0370,343,228,571,51,622,1217,51.11%,28.18%,1
新北市,新莊區,0371,457,331,788,97,885,1571,56.33%,29.09%,1
新北市,新莊區,0372,449,320,769,91,860,1594,53.95%,28.17%,1
新北市,新莊區,0373,445,335,780,83,863,1583,54.52%,28.11%,1
新北市,新莊區,0374,424,280,704,59,763,1245,61.29%,34.06%,1
新北市,新莊區,0375,345,250,595,66,661,1203,54.95%,28.68%,1
新北市,新莊區,0376,438,275,713,86,799,1265,63.16%,34.62%,1
新北市,新莊區,0377,417,258,675,78,753,1255,60%,33.23%,1
新北市,新莊區,0378,398,306,704,54,758,1287,58.9%,30.92%,1
新北市,新莊區,0379,346,321,667,68,735,1167,62.98%,29.65%,1
新北市,新莊區,0380,375,270,645,82,727,1299,55.97%,28.87%,1
新北市,新莊區,0381,331,314,645,56,701,1207,58.08%,27.42%,1
新北市,新莊區,0382,456,295,751,79,830,1415,58.66%,32.23%,1
新北市,新莊區,0383,408,285,693,93,786,1342,58.57%,30.4%,1
新北市,新莊區,0384,391,296,687,92,779,1341,58.09%,29.16%,1
新北市,新莊區,0385,385,238,623,95,718,1247,57.58%,30.87%,1
新北市,新莊區,0386,399,209,608,40,648,984,65.85%,40.55%,1
新北市,新莊區,0387,361,210,571,64,635,1043,60.88%,34.61%,1
新北市,新莊區,0388,429,273,702,52,754,1135,66.43%,37.8%,1
新北市,新莊區,0389,358,277,635,55,690,1185,58.23%,30.21%,1
新北市,新莊區,0390,405,315,720,54,774,1346,57.5%,30.09%,1
新北市,新莊區,0391,418,317,735,85,820,1372,59.77%,30.47%,1
新北市,新莊區,0392,419,317,736,98,834,1350,61.78%,31.04%,1
新北市,新莊區,0393,434,213,647,77,724,1307,55.39%,33.21%,1
新北市,新莊區,0394,397,273,670,107,777,1353,57.43%,29.34%,1
新北市,新莊區,0395,406,280,686,76,762,1287,59.21%,31.55%,1
新北市,新莊區,0396,388,277,665,46,711,1567,45.37%,24.76%,1
新北市,新莊區,0397,556,358,914,108,1022,1709,59.8%,32.53%,1
新北市,新莊區,0398,458,277,735,65,800,1616,49.5%,28.34%,1
新北市,新莊區,0399,418,329,747,80,827,1628,50.8%,25.68%,1
新北市,新莊區,0400,346,278,624,83,707,1148,61.59%,30.14%,1
新北市,新莊區,0401,340,285,625,14,639,1201,53.21%,28.31%,1
新北市,新莊區,0402,364,304,668,55,723,1135,63.7%,32.07%,1
新北市,新莊區,0403,476,354,830,94,924,1495,61.81%,31.84%,1
新北市,新莊區,0404,496,347,843,81,924,1486,62.18%,33.38%,1
新北市,新莊區,0405,482,364,846,69,915,1483,61.7%,32.5%,1
新北市,新莊區,0406,497,306,803,54,857,1553,55.18%,32%,1
新北市,新莊區,0407,584,367,951,54,1005,1625,61.85%,35.94%,1
新北市,新莊區,0408,528,356,884,43,927,1671,55.48%,31.6%,1
新北市,新莊區,0409,448,343,791,77,868,1389,62.49%,32.25%,1
新北市,新莊區,0410,395,288,683,64,747,1272,58.73%,31.05%,1
新北市,新莊區,0411,496,334,830,48,878,1409,62.31%,35.2%,1
新北市,新莊區,0412,441,324,765,56,821,1372,59.84%,32.14%,1
新北市,新莊區,0413,288,220,508,63,571,955,59.79%,30.16%,1
新北市,新莊區,0414,278,176,454,85,539,952,56.62%,29.2%,1
新北市,新莊區,0415,405,327,732,53,785,1412,55.59%,28.68%,1
新北市,新莊區,0416,417,323,740,84,824,1415,58.23%,29.47%,1
新北市,新莊區,0417,470,308,778,81,859,1421,60.45%,33.08%,1
新北市,新莊區,0418,424,316,740,71,811,1293,62.72%,32.79%,1
新北市,新莊區,0419,434,297,731,32,763,1475,51.73%,29.42%,1
新北市,新莊區,0420,465,266,731,87,818,1429,57.24%,32.54%,1
新北市,新莊區,0421,447,330,777,65,842,1481,56.85%,30.18%,1
新北市,新莊區,0422,516,287,803,89,892,1472,60.6%,35.05%,1
新北市,新莊區,0423,484,325,809,59,868,1474,58.89%,32.84%,1
新北市,新莊區,0424,487,324,811,37,848,1462,58%,33.31%,1
新北市,新莊區,0425,506,325,831,55,886,1484,59.7%,34.1%,1
新北市,新莊區,0426,484,307,791,53,844,1461,57.77%,33.13%,1
新北市,新莊區,0427,453,337,790,40,830,1444,57.48%,31.37%,1
新北市,新莊區,0428,483,316,799,46,845,1437,58.8%,33.61%,1
新北市,新莊區,0429,423,307,730,88,818,1641,49.85%,25.78%,1
新北市,新莊區,0430,441,332,773,84,857,1633,52.48%,27.01%,1
新北市,新莊區,0431,487,334,821,41,862,1531,56.3%,31.81%,1
新北市,新莊區,0432,485,350,835,72,907,1517,59.79%,31.97%,1
新北市,新莊區,0433,438,312,750,70,820,1487,55.14%,29.46%,1
新北市,新莊區,0434,504,311,815,69,884,1560,56.67%,32.31%,1
新北市,新莊區,0435,466,324,790,101,891,1584,56.25%,29.42%,1
新北市,新莊區,0436,481,331,812,55,867,1602,54.12%,30.02%,1
新北市,新莊區,0437,219,199,418,66,484,818,59.17%,26.77%,1
新北市,新莊區,0438,449,292,741,79,820,1633,50.21%,27.5%,1
新北市,新莊區,0439,434,362,796,90,886,1652,53.63%,26.27%,1
新北市,新莊區,0440,449,304,753,75,828,1498,55.27%,29.97%,1
新北市,新莊區,0441,351,311,662,55,717,1379,51.99%,25.45%,1
新北市,新莊區,0442,439,301,740,73,813,1381,58.87%,31.79%,1
新北市,新莊區,0443,482,322,804,106,910,1535,59.28%,31.4%,1
新北市,新莊區,0444,516,330,846,83,929,1492,62.27%,34.58%,1
新北市,新莊區,0445,503,312,815,96,911,1450,62.83%,34.69%,1
新北市,新莊區,0446,353,237,590,70,660,1107,59.62%,31.89%,1
新北市,新莊區,0447,336,256,592,66,658,1063,61.9%,31.61%,1
新北市,新莊區,0448,305,293,598,75,673,1143,58.88%,26.68%,1
新北市,新莊區,0449,374,264,638,118,756,1341,56.38%,27.89%,1
新北市,新莊區,0450,333,232,565,62,627,1063,58.98%,31.33%,1
新北市,新莊區,0451,312,276,588,72,660,1096,60.22%,28.47%,1
新北市,新莊區,0452,402,295,697,53,750,1309,57.3%,30.71%,1
新北市,新莊區,0453,345,300,645,71,716,1216,58.88%,28.37%,1
新北市,新莊區,0454,393,270,663,26,689,1278,53.91%,30.75%,1
新北市,新莊區,0455,477,298,775,99,874,1352,64.64%,35.28%,1
新北市,新莊區,0456,355,252,607,69,676,1298,52.08%,27.35%,1
新北市,新莊區,0457,303,233,536,73,609,1042,58.45%,29.08%,1
新北市,新莊區,0458,249,191,440,29,469,881,53.23%,28.26%,1
新北市,新莊區,0459,369,279,648,64,712,1109,64.2%,33.27%,1
新北市,新莊區,0460,389,263,652,65,717,1291,55.54%,30.13%,1
新北市,新莊區,0461,374,267,641,41,682,1293,52.75%,28.92%,1
新北市,新莊區,0462,424,289,713,77,790,1336,59.13%,31.74%,1
新北市,新莊區,0463,376,303,679,69,748,1384,54.05%,27.17%,1
新北市,新莊區,0464,353,221,574,34,608,1231,49.39%,28.68%,1
新北市,新莊區,0465,277,203,480,52,532,940,56.6%,29.47%,1
新北市,新莊區,0466,366,283,649,118,767,1369,56.03%,26.73%,1
新北市,新莊區,0467,357,320,677,95,772,1384,55.78%,25.79%,1
新北市,新莊區,0468,357,299,656,83,739,1272,58.1%,28.07%,1
新北市,新莊區,0469,348,240,588,46,634,1073,59.09%,32.43%,1
新北市,新莊區,0470,294,268,562,41,603,1058,56.99%,27.79%,1
新北市,新莊區,0471,491,321,812,28,840,1528,54.97%,32.13%,1
新北市,新莊區,0472,392,237,629,50,679,1244,54.58%,31.51%,1
新北市,新莊區,0473,400,262,662,67,729,1356,53.76%,29.5%,1
新北市,新莊區,0474,371,199,570,41,611,1164,52.49%,31.87%,1
新北市,新莊區,0475,441,307,748,92,840,1423,59.03%,30.99%,1
新北市,新莊區,0476,414,316,730,45,775,1250,62%,33.12%,1
新北市,新莊區,0477,392,250,642,39,681,1252,54.39%,31.31%,1
新北市,新莊區,0478,308,208,516,36,552,1022,54.01%,30.14%,1
新北市,新莊區,0479,287,222,509,55,564,959,58.81%,29.93%,1
新北市,新莊區,0480,520,383,903,58,961,1646,58.38%,31.59%,1
新北市,新莊區,0481,457,339,796,75,871,1551,56.16%,29.46%,1
新北市,新莊區,0482,486,342,828,79,907,1526,59.44%,31.85%,1
新北市,新莊區,0483,480,322,802,52,854,1518,56.26%,31.62%,1
新北市,新莊區,0484,516,327,843,57,900,1547,58.18%,33.35%,1
新北市,新莊區,0485,396,325,721,106,827,1505,54.95%,26.31%,1
新北市,新莊區,0486,410,302,712,111,823,1527,53.9%,26.85%,1
新北市,新莊區,0487,396,318,714,68,782,1482,52.77%,26.72%,1
新北市,新莊區,0488,432,292,724,97,821,1586,51.77%,27.24%,1
新北市,新莊區,0489,312,212,524,96,620,1065,58.22%,29.3%,1
新北市,新莊區,0490,351,257,608,62,670,1040,64.42%,33.75%,1
新北市,新莊區,0491,324,221,545,67,612,1090,56.15%,29.72%,1
新北市,新莊區,0492,328,217,545,78,623,1071,58.17%,30.63%,1
新北市,新莊區,0493,482,312,794,48,842,1704,49.41%,28.29%,1
新北市,新莊區,0494,451,335,786,58,844,1698,49.71%,26.56%,1
新北市,新莊區,0495,451,324,775,77,852,1362,62.56%,33.11%,1
新北市,新莊區,0496,409,320,729,61,790,1350,58.52%,30.3%,1
新北市,新莊區,0497,439,379,818,150,968,1689,57.31%,25.99%,1
新北市,新莊區,0498,439,351,790,145,935,1612,58%,27.23%,1
新北市,新莊區,0499,362,257,619,65,684,1130,60.53%,32.04%,1
新北市,新莊區,0500,348,272,620,75,695,1111,62.56%,31.32%,1
新北市,新莊區,0501,467,305,772,58,830,1539,53.93%,30.34%,1
新北市,新莊區,0502,457,374,831,52,883,1586,55.67%,28.81%,1
新北市,新莊區,0503,514,342,856,85,941,1631,57.69%,31.51%,1
新北市,新莊區,0504,450,333,783,75,858,1540,55.71%,29.22%,1
新北市,新莊區,0505,353,287,640,59,699,1388,50.36%,25.43%,1
新北市,新莊區,0506,364,240,604,110,714,1388,51.44%,26.22%,1
新北市,新莊區,0507,353,268,621,74,695,1387,50.11%,25.45%,1
新北市,新莊區,0508,342,235,577,57,634,1181,53.68%,28.96%,1
新北市,新莊區,0509,318,265,583,76,659,1135,58.06%,28.02%,1
新北市,新莊區,0510,334,274,608,65,673,1173,57.37%,28.47%,1
新北市,新莊區,0511,371,284,655,49,704,1215,57.94%,30.53%,1
新北市,新莊區,0512,469,331,800,62,862,1488,57.93%,31.52%,1
新北市,新莊區,0513,439,335,774,49,823,1444,56.99%,30.4%,1
新北市,新莊區,0514,460,323,783,54,837,1499,55.84%,30.69%,1
新北市,新莊區,0515,430,330,760,43,803,1449,55.42%,29.68%,1
新北市,新莊區,0516,470,357,827,95,922,1640,56.22%,28.66%,1
新北市,新莊區,0517,502,300,802,92,894,1648,54.25%,30.46%,1
新北市,新莊區,0518,372,278,650,72,722,1371,52.66%,27.13%,1
新北市,新莊區,0519,399,298,697,81,778,1400,55.57%,28.5%,1
新北市,新莊區,0520,430,299,729,91,820,1457,56.28%,29.51%,1
新北市,新莊區,0521,424,300,724,102,826,1502,54.99%,28.23%,1
新北市,新莊區,0522,394,300,694,91,785,1412,55.59%,27.9%,1
新北市,新莊區,0523,366,281,647,82,729,1318,55.31%,27.77%,1
新北市,新莊區,0524,453,308,761,70,831,1411,58.89%,32.1%,1
新北市,新莊區,0525,396,290,686,45,731,1262,57.92%,31.38%,1
新北市,新莊區,0526,449,246,695,41,736,1228,59.93%,36.56%,1
新北市,新莊區,0527,569,368,937,90,1027,1748,58.75%,32.55%,1
新北市,新莊區,0528,529,384,913,109,1022,1761,58.04%,30.04%,1
新北市,新莊區,0529,379,243,622,81,703,1326,53.02%,28.58%,1
新北市,新莊區,0530,350,245,595,80,675,1344,50.22%,26.04%,1
新北市,新莊區,0531,423,280,703,64,767,1355,56.61%,31.22%,1
新北市,新莊區,0532,391,265,656,103,759,1306,58.12%,29.94%,1
新北市,新莊區,0533,435,306,741,58,799,1349,59.23%,32.25%,1
新北市,新莊區,0534,391,270,661,46,707,1265,55.89%,30.91%,1
新北市,新莊區,0535,425,280,705,71,776,1282,60.53%,33.15%,1
新北市,新莊區,0536,393,287,680,61,741,1237,59.9%,31.77%,1
新北市,新莊區,0537,420,255,675,35,710,1301,54.57%,32.28%,1
新北市,新莊區,0538,393,261,654,72,726,1262,57.53%,31.14%,1
新北市,新莊區,0539,379,283,662,61,723,1270,56.93%,29.84%,1
新北市,新莊區,0540,371,281,652,78,730,1245,58.63%,29.8%,1
新北市,新莊區,0541,315,275,590,93,683,1220,55.98%,25.82%,1
新北市,新莊區,0542,364,252,616,49,665,1245,53.41%,29.24%,1
新北市,新莊區,0543,349,231,580,59,639,1212,52.72%,28.8%,1
新北市,新莊區,0544,350,258,608,77,685,1253,54.67%,27.93%,1
新北市,新莊區,0545,357,250,607,69,676,1272,53.14%,28.07%,1
新北市,新莊區,0546,430,257,687,37,724,1227,59.01%,35.04%,1
新北市,新莊區,0547,368,258,626,53,679,1126,60.3%,32.68%,1
新北市,新莊區,0548,376,286,662,61,723,1240,58.31%,30.32%,1
新北市,新莊區,0549,472,306,778,53,831,1460,56.92%,32.33%,1
新北市,新莊區,0550,316,229,545,57,602,1072,56.16%,29.48%,1
新北市,新莊區,0551,304,224,528,63,591,1127,52.44%,26.97%,1
新北市,新莊區,0552,411,302,713,52,765,1332,57.43%,30.86%,1
新北市,新莊區,0553,372,285,657,31,688,1341,51.3%,27.74%,1
新北市,新莊區,0554,252,205,457,29,486,1140,42.63%,22.11%,1
新北市,新店區,1987,508,331,839,52,891,1603,55.58%,31.69%,1
新北市,新店區,1988,561,441,1002,68,1070,1921,55.7%,29.2%,1
新北市,新店區,1989,336,226,562,25,587,1082,54.25%,31.05%,1
新北市,新店區,1990,391,273,664,53,717,1235,58.06%,31.66%,1
新北市,新店區,1991,540,344,884,39,923,1568,58.86%,34.44%,1
新北市,新店區,1992,230,167,397,57,454,771,58.88%,29.83%,1
新北市,新店區,1993,365,296,661,41,702,1256,55.89%,29.06%,1
新北市,新店區,1994,330,214,544,58,602,1008,59.72%,32.74%,1
新北市,新店區,1995,527,303,830,61,891,1515,58.81%,34.79%,1
新北市,新店區,1996,646,307,953,69,1022,1637,62.43%,39.46%,1
新北市,新店區,1997,485,351,836,65,901,1549,58.17%,31.31%,1
新北市,新店區,1998,785,403,1188,69,1257,2011,62.51%,39.04%,1
新北市,新店區,1999,521,302,823,83,906,1554,58.3%,33.53%,1
新北市,新店區,2000,456,435,891,99,990,1770,55.93%,25.76%,1
新北市,新店區,2001,455,276,731,56,787,1316,59.8%,34.57%,1
新北市,新店區,2002,380,196,576,68,644,1126,57.19%,33.75%,1
新北市,新店區,2003,428,303,731,65,796,1460,54.52%,29.32%,1
新北市,新店區,2004,562,303,865,78,943,1584,59.53%,35.48%,1
新北市,新店區,2005,475,293,768,66,834,1449,57.56%,32.78%,1
新北市,新店區,2006,576,321,897,60,957,1520,62.96%,37.89%,1
新北市,新店區,2007,704,324,1028,45,1073,1821,58.92%,38.66%,1
新北市,新店區,2008,676,384,1060,46,1106,1956,56.54%,34.56%,1
新北市,新店區,2009,572,346,918,62,980,1665,58.86%,34.35%,1
新北市,新店區,2010,590,317,907,58,965,1588,60.77%,37.15%,1
新北市,新店區,2011,518,304,822,31,853,1519,56.16%,34.1%,1
新北市,新店區,2012,430,274,704,44,748,1185,63.12%,36.29%,1
新北市,新店區,2013,424,248,672,27,699,1095,63.84%,38.72%,1
新北市,新店區,2014,409,231,640,52,692,1106,62.57%,36.98%,1
新北市,新店區,2015,216,166,382,27,409,2700,15.15%,8%,1
新北市,新店區,2016,348,216,564,33,597,995,60%,34.97%,1
新北市,新店區,2017,381,242,623,48,671,1168,57.45%,32.62%,1
新北市,新店區,2018,428,263,691,69,760,1123,67.68%,38.11%,1
新北市,新店區,2019,412,243,655,53,708,1085,65.25%,37.97%,1
新北市,新店區,2020,524,292,816,63,879,1412,62.25%,37.11%,1
新北市,新店區,2021,588,318,906,64,970,1659,58.47%,35.44%,1
新北市,新店區,2022,467,255,722,48,770,1198,64.27%,38.98%,1
新北市,新店區,2023,451,252,703,42,745,1376,54.14%,32.78%,1
新北市,新店區,2024,426,246,672,45,717,1300,55.15%,32.77%,1
新北市,新店區,2025,451,229,680,46,726,1238,58.64%,36.43%,1
新北市,新店區,2026,461,242,703,36,739,1388,53.24%,33.21%,1
新北市,新店區,2027,217,324,541,52,593,933,63.56%,23.26%,1
新北市,新店區,2028,337,198,535,49,584,908,64.32%,37.11%,1
新北市,新店區,2029,496,340,836,75,911,1582,57.59%,31.35%,1
新北市,新店區,2030,452,258,710,68,778,1247,62.39%,36.25%,1
新北市,新店區,2031,332,214,546,57,603,971,62.1%,34.19%,1
新北市,新店區,2032,426,216,642,66,708,1145,61.83%,37.21%,1
新北市,新店區,2033,493,280,773,65,838,1392,60.2%,35.42%,1
新北市,新店區,2034,527,325,852,64,916,1452,63.09%,36.29%,1
新北市,新店區,2035,506,275,781,56,837,1440,58.13%,35.14%,1
新北市,新店區,2036,586,347,933,91,1024,1786,57.33%,32.81%,1
新北市,新店區,2037,704,282,986,78,1064,1825,58.3%,38.58%,1
新北市,新店區,2038,519,332,851,40,891,1477,60.32%,35.14%,1
新北市,新店區,2039,617,352,969,63,1032,1750,58.97%,35.26%,1
新北市,新店區,2040,643,319,962,64,1026,1792,57.25%,35.88%,1
新北市,新店區,2041,722,333,1055,67,1122,1979,56.7%,36.48%,1
新北市,新店區,2042,303,167,470,31,501,826,60.65%,36.68%,1
新北市,新店區,2043,738,354,1092,58,1150,1924,59.77%,38.36%,1
新北市,新店區,2044,561,263,824,33,857,1383,61.97%,40.56%,1
新北市,新店區,2045,230,150,380,45,425,830,51.2%,27.71%,1
新北市,新店區,2046,675,347,1022,47,1069,1759,60.77%,38.37%,1
新北市,新店區,2047,723,387,1110,71,1181,1957,60.35%,36.94%,1
新北市,新店區,2048,559,305,864,38,902,1481,60.9%,37.74%,1
新北市,新店區,2049,529,301,830,85,915,1552,58.96%,34.09%,1
新北市,新店區,2050,503,264,767,79,846,1467,57.67%,34.29%,1
新北市,新店區,2051,485,262,747,55,802,1371,58.5%,35.38%,1
新北市,新店區,2052,325,229,554,44,598,991,60.34%,32.8%,1
新北市,新店區,2053,428,246,674,72,746,1231,60.6%,34.77%,1
新北市,新店區,2054,539,374,913,85,998,1701,58.67%,31.69%,1
新北市,新店區,2055,549,367,916,58,974,1707,57.06%,32.16%,1
新北市,新店區,2056,531,464,995,50,1045,1773,58.94%,29.95%,1
新北市,新店區,2057,598,365,963,47,1010,1866,54.13%,32.05%,1
新北市,新店區,2058,633,343,976,58,1034,1735,59.6%,36.48%,1
新北市,新店區,2059,625,366,991,57,1048,1632,64.22%,38.3%,1
新北市,新店區,2060,570,317,887,65,952,1591,59.84%,35.83%,1
新北市,新店區,2061,435,304,739,79,818,1495,54.72%,29.1%,1
新北市,新店區,2062,572,158,730,33,763,1511,50.5%,37.86%,1
新北市,新店區,2063,377,288,665,70,735,1260,58.33%,29.92%,1
新北市,新店區,2064,738,370,1108,51,1159,1948,59.5%,37.89%,1
新北市,新店區,2065,588,339,927,52,979,1582,61.88%,37.17%,1
新北市,新店區,2066,411,292,703,62,765,1315,58.17%,31.25%,1
新北市,新店區,2067,475,320,795,60,855,1562,54.74%,30.41%,1
新北市,新店區,2068,786,342,1128,47,1175,1982,59.28%,39.66%,1
新北市,新店區,2069,524,310,834,65,899,1518,59.22%,34.52%,1
新北市,新店區,2070,570,350,920,53,973,1735,56.08%,32.85%,1
新北市,新店區,2071,618,290,908,57,965,1716,56.24%,36.01%,1
新北市,新店區,2072,549,306,855,76,931,1580,58.92%,34.75%,1
新北市,新店區,2073,498,304,802,45,847,1358,62.37%,36.67%,1
新北市,新店區,2074,526,365,891,112,1003,1610,62.3%,32.67%,1
新北市,新店區,2075,447,273,720,52,772,1383,55.82%,32.32%,1
新北市,新店區,2076,531,337,868,42,910,1596,57.02%,33.27%,1
新北市,新店區,2077,437,247,684,46,730,1360,53.68%,32.13%,1
新北市,新店區,2078,391,175,566,30,596,1160,51.38%,33.71%,1
新北市,新店區,2079,534,234,768,46,814,1236,65.86%,43.2%,1
新北市,新店區,2080,518,240,758,41,799,1234,64.75%,41.98%,1
新北市,新店區,2081,481,350,831,91,922,1579,58.39%,30.46%,1
新北市,新店區,2082,415,236,651,60,711,1241,57.29%,33.44%,1
新北市,新店區,2083,401,284,685,28,713,1275,55.92%,31.45%,1
新北市,新店區,2084,341,240,581,65,646,1214,53.21%,28.09%,1
新北市,新店區,2085,406,290,696,97,793,1578,50.25%,25.73%,1
新北市,新店區,2086,470,276,746,50,796,1442,55.2%,32.59%,1
新北市,新店區,2087,430,266,696,84,780,1475,52.88%,29.15%,1
新北市,新店區,2088,649,317,966,60,1026,1580,64.94%,41.08%,1
新北市,新店區,2089,442,352,794,43,837,1585,52.81%,27.89%,1
新北市,新店區,2090,485,372,857,78,935,1586,58.95%,30.58%,1
新北市,新店區,2091,622,379,1001,73,1074,1931,55.62%,32.21%,1
新北市,新店區,2092,430,216,646,40,686,1239,55.37%,34.71%,1
新北市,新店區,2093,599,372,971,73,1044,1892,55.18%,31.66%,1
新北市,新店區,2094,442,293,735,62,797,1529,52.13%,28.91%,1
新北市,新店區,2095,469,261,730,61,791,1358,58.25%,34.54%,1
新北市,新店區,2096,560,366,926,50,976,1905,51.23%,29.4%,1
新北市,新店區,2097,532,346,878,123,1001,1885,53.1%,28.22%,1
新北市,新店區,2098,393,276,669,66,735,1345,54.65%,29.22%,1
新北市,新店區,2099,408,317,725,68,793,1387,57.17%,29.42%,1
新北市,新店區,2100,626,378,1004,77,1081,1960,55.15%,31.94%,1
新北市,新店區,2101,588,356,944,88,1032,1837,56.18%,32.01%,1
新北市,新店區,2102,565,308,873,73,946,1662,56.92%,34%,1
新北市,新店區,2103,586,335,921,73,994,1617,61.47%,36.24%,1
新北市,新店區,2104,587,336,923,52,975,1704,57.22%,34.45%,1
新北市,新店區,2105,559,341,900,87,987,1835,53.79%,30.46%,1
新北市,新店區,2106,610,375,985,101,1086,2009,54.06%,30.36%,1
新北市,新店區,2107,451,289,740,72,812,1450,56%,31.1%,1
新北市,新店區,2108,551,357,908,53,961,1726,55.68%,31.92%,1
新北市,新店區,2109,553,342,895,84,979,1797,54.48%,30.77%,1
新北市,新店區,2110,592,318,910,51,961,1739,55.26%,34.04%,1
新北市,新店區,2111,522,281,803,49,852,1523,55.94%,34.27%,1
新北市,新店區,2112,546,299,845,41,886,1642,53.96%,33.25%,1
新北市,新店區,2113,558,302,860,38,898,1644,54.62%,33.94%,1
新北市,新店區,2114,475,320,795,42,837,1662,50.36%,28.58%,1
新北市,新店區,2115,636,463,1099,84,1183,2067,57.23%,30.77%,1
新北市,新店區,2116,468,315,783,70,853,1870,45.61%,25.03%,1
新北市,新店區,2117,647,370,1017,61,1078,1982,54.39%,32.64%,1
新北市,新店區,2118,572,256,828,53,881,1546,56.99%,37%,1
新北市,新店區,2119,623,357,980,54,1034,1712,60.4%,36.39%,1
新北市,新店區,2120,544,293,837,46,883,1423,62.05%,38.23%,1
新北市,新店區,2121,611,324,935,79,1014,1666,60.86%,36.67%,1
新北市,新店區,2122,645,377,1022,75,1097,1769,62.01%,36.46%,1
新北市,新店區,2123,279,204,483,59,542,1079,50.23%,25.86%,1
新北市,新店區,2124,332,243,575,24,599,1140,52.54%,29.12%,1
新北市,新店區,2125,701,230,931,68,999,1825,54.74%,38.41%,1
新北市,新店區,2126,384,283,667,46,713,1178,60.53%,32.6%,1
新北市,新店區,2127,469,274,743,54,797,1463,54.48%,32.06%,1
新北市,新店區,2128,377,232,609,45,654,1152,56.77%,32.73%,1
新北市,新店區,2129,551,351,902,42,944,2008,47.01%,27.44%,1
新北市,新店區,2130,589,328,917,55,972,2120,45.85%,27.78%,1
新北市,新店區,2131,411,251,662,23,685,1153,59.41%,35.65%,1
新北市,新店區,2132,513,272,785,40,825,1573,52.45%,32.61%,1
新北市,新店區,2133,500,358,858,105,963,1992,48.34%,25.1%,1
新北市,新店區,2134,426,337,763,60,823,1668,49.34%,25.54%,1
新北市,新店區,2135,422,296,718,76,794,1617,49.1%,26.1%,1
新北市,新店區,2136,586,399,985,95,1080,2013,53.65%,29.11%,1
新北市,新店區,2137,616,373,989,50,1039,1791,58.01%,34.39%,1
新北市,新店區,2138,523,334,857,67,924,1624,56.9%,32.2%,1
新北市,新店區,2139,432,239,671,45,716,1178,60.78%,36.67%,1
新北市,新店區,2140,464,245,709,42,751,1277,58.81%,36.34%,1
新北市,新店區,2141,645,345,990,73,1063,1879,56.57%,34.33%,1
新北市,新店區,2142,222,136,358,33,391,939,41.64%,23.64%,1
新北市,新店區,2143,304,205,509,44,553,960,57.6%,31.67%,1
新北市,新店區,2144,510,324,834,42,876,1434,61.09%,35.56%,1
新北市,新店區,2145,499,383,882,77,959,1838,52.18%,27.15%,1
新北市,新店區,2146,469,281,750,62,812,1453,55.88%,32.28%,1
新北市,新店區,2147,432,321,753,79,832,1549,53.71%,27.89%,1
新北市,新店區,2148,612,401,1013,66,1079,1860,58.01%,32.9%,1
新北市,新店區,2149,526,317,843,52,895,1743,51.35%,30.18%,1
新北市,新店區,2150,441,254,695,40,735,1122,65.51%,39.3%,1
新北市,新店區,2151,478,284,762,52,814,1468,55.45%,32.56%,1
新北市,新店區,2152,545,362,907,65,972,1763,55.13%,30.91%,1
新北市,新店區,2153,394,262,656,60,716,1344,53.27%,29.32%,1
新北市,新店區,2154,194,147,341,62,403,753,53.52%,25.76%,1
新北市,新店區,2155,169,122,291,16,307,602,51%,28.07%,1
新北市,新店區,2156,611,473,1084,85,1169,2237,52.26%,27.31%,1
新北市,新店區,2157,304,248,552,42,594,1096,54.2%,27.74%,1
新北市,新店區,2158,286,196,482,54,536,1143,46.89%,25.02%,1
新北市,新店區,2159,420,308,728,97,825,1569,52.58%,26.77%,1
新北市,新店區,2160,453,253,706,94,800,1284,62.31%,35.28%,1
新北市,新店區,2161,64,54,118,15,133,439,30.3%,14.58%,1
新北市,新店區,2162,206,185,391,45,436,750,58.13%,27.47%,1
新北市,樹林區,1614,372,280,652,91,743,1408,52.77%,26.42%,1
新北市,樹林區,1615,348,285,633,46,679,1310,51.83%,26.56%,1
新北市,樹林區,1616,386,286,672,90,762,1534,49.67%,25.16%,1
新北市,樹林區,1617,334,263,597,75,672,1211,55.49%,27.58%,1
新北市,樹林區,1618,345,252,597,60,657,1125,58.4%,30.67%,1
新北市,樹林區,1619,379,251,630,55,685,1134,60.41%,33.42%,1
新北市,樹林區,1620,432,345,777,117,894,1897,47.13%,22.77%,1
新北市,樹林區,1621,476,349,825,87,912,1716,53.15%,27.74%,1
新北市,樹林區,1622,209,192,401,56,457,736,62.09%,28.4%,1
新北市,樹林區,1623,364,281,645,48,693,1137,60.95%,32.01%,1
新北市,樹林區,1624,420,317,737,63,800,1542,51.88%,27.24%,1
新北市,樹林區,1625,383,317,700,108,808,1470,54.97%,26.05%,1
新北市,樹林區,1626,390,265,655,39,694,1456,47.66%,26.79%,1
新北市,樹林區,1627,327,270,597,32,629,1124,55.96%,29.09%,1
新北市,樹林區,1628,339,267,606,54,660,1235,53.44%,27.45%,1
新北市,樹林區,1629,347,276,623,48,671,1212,55.36%,28.63%,1
新北市,樹林區,1630,315,242,557,48,605,1223,49.47%,25.76%,1
新北市,樹林區,1631,368,275,643,82,725,1335,54.31%,27.57%,1
新北市,樹林區,1632,339,271,610,54,664,1206,55.06%,28.11%,1
新北市,樹林區,1633,366,260,626,85,711,1927,36.9%,18.99%,1
新北市,樹林區,1634,253,210,463,60,523,914,57.22%,27.68%,1
新北市,樹林區,1635,456,311,767,73,840,1456,57.69%,31.32%,1
新北市,樹林區,1636,409,268,677,67,744,1409,52.8%,29.03%,1
新北市,樹林區,1637,478,334,812,87,899,1500,59.93%,31.87%,1
新北市,樹林區,1638,470,318,788,79,867,1545,56.12%,30.42%,1
新北市,樹林區,1639,415,312,727,49,776,1483,52.33%,27.98%,1
新北市,樹林區,1640,440,323,763,51,814,1524,53.41%,28.87%,1
新北市,樹林區,1641,479,279,758,42,800,1431,55.9%,33.47%,1
新北市,樹林區,1642,336,233,569,87,656,1181,55.55%,28.45%,1
新北市,樹林區,1643,332,237,569,83,652,1116,58.42%,29.75%,1
新北市,樹林區,1644,262,253,515,50,565,1077,52.46%,24.33%,1
新北市,樹林區,1645,288,220,508,29,537,1103,48.69%,26.11%,1
新北市,樹林區,1646,402,294,696,76,772,1385,55.74%,29.03%,1
新北市,樹林區,1647,349,263,612,59,671,1266,53%,27.57%,1
新北市,樹林區,1648,346,253,599,52,651,1195,54.48%,28.95%,1
新北市,樹林區,1649,345,255,600,78,678,1254,54.07%,27.51%,1
新北市,樹林區,1650,385,269,654,73,727,1263,57.56%,30.48%,1
新北市,樹林區,1651,469,338,807,94,901,1473,61.17%,31.84%,1
新北市,樹林區,1652,274,191,465,35,500,870,57.47%,31.49%,1
新北市,樹林區,1653,396,338,734,87,821,1338,61.36%,29.6%,1
新北市,樹林區,1654,300,188,488,51,539,1010,53.37%,29.7%,1
新北市,樹林區,1655,493,356,849,114,963,1658,58.08%,29.73%,1
新北市,樹林區,1656,486,404,890,78,968,1538,62.94%,31.6%,1
新北市,樹林區,1657,480,298,778,111,889,1405,63.27%,34.16%,1
新北市,樹林區,1658,494,321,815,73,888,1587,55.95%,31.13%,1
新北市,樹林區,1659,462,339,801,79,880,1566,56.19%,29.5%,1
新北市,樹林區,1660,274,209,483,32,515,997,51.65%,27.48%,1
新北市,樹林區,1661,349,258,607,68,675,1187,56.87%,29.4%,1
新北市,樹林區,1662,279,234,513,66,579,1061,54.57%,26.3%,1
新北市,樹林區,1663,564,323,887,66,953,1701,56.03%,33.16%,1
新北市,樹林區,1664,391,266,657,69,726,1278,56.81%,30.59%,1
新北市,樹林區,1665,470,315,785,80,865,1433,60.36%,32.8%,1
新北市,樹林區,1666,392,315,707,95,802,1306,61.41%,30.02%,1
新北市,樹林區,1667,363,326,689,84,773,1268,60.96%,28.63%,1
新北市,樹林區,1668,418,279,697,43,740,1281,57.77%,32.63%,1
新北市,樹林區,1669,380,285,665,55,720,1200,60%,31.67%,1
新北市,樹林區,1670,369,315,684,56,740,1491,49.63%,24.75%,1
新北市,樹林區,1671,306,223,529,32,561,1066,52.63%,28.71%,1
新北市,樹林區,1672,276,200,476,81,557,877,63.51%,31.47%,1
新北市,樹林區,1673,442,354,796,87,883,1616,54.64%,27.35%,1
新北市,樹林區,1674,408,251,659,89,748,1589,47.07%,25.68%,1
新北市,樹林區,1675,434,289,723,75,798,1367,58.38%,31.75%,1
新北市,樹林區,1676,347,264,611,77,688,1144,60.14%,30.33%,1
新北市,樹林區,1677,285,226,511,49,560,1059,52.88%,26.91%,1
新北市,樹林區,1678,330,265,595,82,677,1224,55.31%,26.96%,1
新北市,樹林區,1679,301,219,520,59,579,1141,50.74%,26.38%,1
新北市,樹林區,1680,349,208,557,36,593,1396,42.48%,25%,1
新北市,樹林區,1681,325,246,571,66,637,1157,55.06%,28.09%,1
新北市,樹林區,1682,373,301,674,101,775,1498,51.74%,24.9%,1
新北市,樹林區,1683,390,340,730,104,834,1514,55.09%,25.76%,1
新北市,樹林區,1684,419,294,713,67,780,1546,50.45%,27.1%,1
新北市,樹林區,1685,385,312,697,81,778,1392,55.89%,27.66%,1
新北市,樹林區,1686,490,313,803,73,876,1566,55.94%,31.29%,1
新北市,樹林區,1687,456,326,782,64,846,1566,54.02%,29.12%,1
新北市,樹林區,1688,437,311,748,77,825,1517,54.38%,28.81%,1
新北市,樹林區,1689,481,280,761,61,822,1481,55.5%,32.48%,1
新北市,樹林區,1690,376,252,628,49,677,1261,53.69%,29.82%,1
新北市,樹林區,1691,247,325,572,38,610,1163,52.45%,21.24%,1
新北市,樹林區,1692,511,383,894,98,992,1661,59.72%,30.76%,1
新北市,樹林區,1693,486,347,833,67,900,1585,56.78%,30.66%,1
新北市,樹林區,1694,334,223,557,59,616,1018,60.51%,32.81%,1
新北市,樹林區,1695,371,243,614,80,694,1247,55.65%,29.75%,1
新北市,樹林區,1696,401,259,660,93,753,1390,54.17%,28.85%,1
新北市,樹林區,1697,384,301,685,57,742,1293,57.39%,29.7%,1
新北市,樹林區,1698,347,301,648,41,689,1301,52.96%,26.67%,1
新北市,樹林區,1699,427,336,763,81,844,1606,52.55%,26.59%,1
新北市,樹林區,1700,329,290,619,90,709,1277,55.52%,25.76%,1
新北市,樹林區,1701,344,269,613,70,683,1219,56.03%,28.22%,1
新北市,樹林區,1702,376,304,680,59,739,1454,50.83%,25.86%,1
新北市,樹林區,1703,375,268,643,58,701,1314,53.35%,28.54%,1
新北市,樹林區,1704,346,260,606,33,639,1008,63.39%,34.33%,1
新北市,樹林區,1705,439,302,741,104,845,1574,53.68%,27.89%,1
新北市,樹林區,1706,419,298,717,56,773,1364,56.67%,30.72%,1
新北市,樹林區,1707,434,332,766,88,854,1677,50.92%,25.88%,1
新北市,樹林區,1708,399,276,675,53,728,1683,43.26%,23.71%,1
新北市,樹林區,1709,449,314,763,71,834,1452,57.44%,30.92%,1
新北市,樹林區,1710,555,328,883,38,921,1592,57.85%,34.86%,1
新北市,樹林區,1711,518,362,880,55,935,1619,57.75%,32%,1
新北市,樹林區,1712,616,348,964,45,1009,1642,61.45%,37.52%,1
新北市,樹林區,1713,428,300,728,37,765,1357,56.37%,31.54%,1
新北市,樹林區,1714,456,370,826,116,942,1638,57.51%,27.84%,1
新北市,樹林區,1715,458,347,805,66,871,1592,54.71%,28.77%,1
新北市,樹林區,1716,483,346,829,67,896,1521,58.91%,31.76%,1
新北市,樹林區,1717,578,364,942,69,1011,1707,59.23%,33.86%,1
新北市,樹林區,1718,533,377,910,105,1015,1741,58.3%,30.61%,1
新北市,樹林區,1719,483,348,831,88,919,1655,55.53%,29.18%,1
新北市,樹林區,1720,479,307,786,125,911,1775,51.32%,26.99%,1
新北市,樹林區,1721,583,329,912,74,986,1781,55.36%,32.73%,1
新北市,樹林區,1722,366,277,643,78,721,1565,46.07%,23.39%,1
新北市,樹林區,1723,258,203,461,44,505,936,53.95%,27.56%,1
新北市,樹林區,1724,296,230,526,34,560,1030,54.37%,28.74%,1
新北市,鶯歌區,1725,161,106,267,26,293,515,56.89%,31.26%,1
新北市,鶯歌區,1726,305,217,522,59,581,965,60.21%,31.61%,1
新北市,鶯歌區,1727,538,442,980,83,1063,1931,55.05%,27.86%,1
新北市,鶯歌區,1728,492,314,806,82,888,1797,49.42%,27.38%,1
新北市,鶯歌區,1729,326,217,543,54,597,1057,56.48%,30.84%,1
新北市,鶯歌區,1730,273,186,459,27,486,962,50.52%,28.38%,1
新北市,鶯歌區,1731,309,219,528,54,582,934,62.31%,33.08%,1
新北市,鶯歌區,1732,544,433,977,84,1061,1742,60.91%,31.23%,1
新北市,鶯歌區,1733,470,316,786,73,859,1634,52.57%,28.76%,1
新北市,鶯歌區,1734,458,281,739,82,821,1676,48.99%,27.33%,1
新北市,鶯歌區,1735,553,438,991,136,1127,2052,54.92%,26.95%,1
新北市,鶯歌區,1736,481,372,853,60,913,1977,46.18%,24.33%,1
新北市,鶯歌區,1737,582,402,984,47,1031,1957,52.68%,29.74%,1
新北市,鶯歌區,1738,195,153,348,40,388,850,45.65%,22.94%,1
新北市,鶯歌區,1739,504,342,846,70,916,1782,51.4%,28.28%,1
新北市,鶯歌區,1740,432,297,729,65,794,1496,53.07%,28.88%,1
新北市,鶯歌區,1741,560,378,938,63,1001,2071,48.33%,27.04%,1
新北市,鶯歌區,1742,391,300,691,98,789,1753,45.01%,22.3%,1
新北市,鶯歌區,1743,483,320,803,67,870,1737,50.09%,27.81%,1
新北市,鶯歌區,1744,491,262,753,86,839,1669,50.27%,29.42%,1
新北市,鶯歌區,1745,460,317,777,52,829,1842,45.01%,24.97%,1
新北市,鶯歌區,1746,386,280,666,70,736,1454,50.62%,26.55%,1
新北市,鶯歌區,1747,263,185,448,56,504,942,53.5%,27.92%,1
新北市,鶯歌區,1748,333,276,609,95,704,1317,53.45%,25.28%,1
新北市,鶯歌區,1749,228,170,398,34,432,949,45.52%,24.03%,1
新北市,鶯歌區,1750,493,283,776,65,841,1440,58.4%,34.24%,1
新北市,鶯歌區,1751,525,354,879,113,992,1809,54.84%,29.02%,1
新北市,鶯歌區,1752,552,352,904,82,986,1758,56.09%,31.4%,1
新北市,鶯歌區,1753,458,337,795,72,867,1589,54.56%,28.82%,1
新北市,鶯歌區,1754,318,249,567,65,632,1067,59.23%,29.8%,1
新北市,鶯歌區,1755,340,247,587,55,642,1092,58.79%,31.14%,1
新北市,鶯歌區,1756,526,364,890,65,955,1730,55.2%,30.4%,1
新北市,鶯歌區,1757,379,259,638,76,714,1281,55.74%,29.59%,1
新北市,鶯歌區,1758,407,294,701,66,767,1238,61.95%,32.88%,1
新北市,鶯歌區,1759,464,327,791,78,869,1568,55.42%,29.59%,1
新北市,鶯歌區,1760,373,239,612,73,685,1271,53.89%,29.35%,1
新北市,鶯歌區,1761,288,185,473,33,506,1183,42.77%,24.34%,1
新北市,鶯歌區,1762,278,169,447,39,486,1026,47.37%,27.1%,1
新北市,鶯歌區,1763,431,365,796,54,850,1721,49.39%,25.04%,1
新北市,鶯歌區,1764,348,289,637,52,689,1317,52.32%,26.42%,1
新北市,鶯歌區,1765,304,251,555,72,627,1046,59.94%,29.06%,1
新北市,鶯歌區,1766,335,279,614,75,689,1144,60.23%,29.28%,1
新北市,鶯歌區,1767,324,265,589,90,679,1336,50.82%,24.25%,1
新北市,鶯歌區,1768,335,246,581,108,689,1479,46.59%,22.65%,1
新北市,鶯歌區,1769,463,341,804,95,899,1736,51.79%,26.67%,1
新北市,鶯歌區,1770,424,309,733,70,803,1389,57.81%,30.53%,1
新北市,鶯歌區,1771,537,391,928,106,1034,1956,52.86%,27.45%,1
新北市,鶯歌區,1772,373,291,664,79,743,1371,54.19%,27.21%,1
新北市,鶯歌區,1773,405,279,684,47,731,1810,40.39%,22.38%,1
新北市,鶯歌區,1774,49,43,92,6,98,227,43.17%,21.59%,1
新北市,三峽區,1917,93,66,159,29,188,274,68.61%,33.94%,1
新北市,三峽區,1918,159,118,277,45,322,583,55.23%,27.27%,1
新北市,三峽區,1919,414,327,741,32,773,1765,43.8%,23.46%,1
新北市,三峽區,1920,484,345,829,79,908,1714,52.98%,28.24%,1
新北市,三峽區,1921,358,297,655,42,697,1355,51.44%,26.42%,1
新北市,三峽區,1922,399,283,682,67,749,1329,56.36%,30.02%,1
新北市,三峽區,1923,277,203,480,75,555,1059,52.41%,26.16%,1
新北市,三峽區,1924,372,328,700,82,782,1364,57.33%,27.27%,1
新北市,三峽區,1925,317,259,576,70,646,1098,58.83%,28.87%,1
新北市,三峽區,1926,386,267,653,58,711,1296,54.86%,29.78%,1
新北市,三峽區,1927,306,267,573,101,674,1240,54.35%,24.68%,1
新北市,三峽區,1928,448,309,757,54,811,1531,52.97%,29.26%,1
新北市,三峽區,1929,431,234,665,41,706,1444,48.89%,29.85%,1
新北市,三峽區,1930,358,285,643,89,732,1347,54.34%,26.58%,1
新北市,三峽區,1931,413,297,710,73,783,1455,53.81%,28.38%,1
新北市,三峽區,1932,408,265,673,42,715,1556,45.95%,26.22%,1
新北市,三峽區,1933,305,262,567,38,605,1390,43.53%,21.94%,1
新北市,三峽區,1934,431,315,746,71,817,1532,53.33%,28.13%,1
新北市,三峽區,1935,327,259,586,84,670,1377,48.66%,23.75%,1
新北市,三峽區,1936,595,232,827,70,897,1731,51.82%,34.37%,1
新北市,三峽區,1937,487,314,801,50,851,1705,49.91%,28.56%,1
新北市,三峽區,1938,509,314,823,49,872,1590,54.84%,32.01%,1
新北市,三峽區,1939,514,364,878,46,924,1650,56%,31.15%,1
新北市,三峽區,1940,422,329,751,38,789,1441,54.75%,29.29%,1
新北市,三峽區,1941,485,306,791,24,815,1404,58.05%,34.54%,1
新北市,三峽區,1942,455,274,729,43,772,1295,59.61%,35.14%,1
新北市,三峽區,1943,368,248,616,42,658,1348,48.81%,27.3%,1
新北市,三峽區,1944,487,344,831,34,865,1579,54.78%,30.84%,1
新北市,三峽區,1945,433,302,735,31,766,1435,53.38%,30.17%,1
新北市,三峽區,1946,607,321,928,41,969,1659,58.41%,36.59%,1
新北市,三峽區,1947,526,333,859,57,916,1512,60.58%,34.79%,1
新北市,三峽區,1948,523,296,819,53,872,1463,59.6%,35.75%,1
新北市,三峽區,1949,494,320,814,34,848,1465,57.88%,33.72%,1
新北市,三峽區,1950,502,303,805,31,836,1463,57.14%,34.31%,1
新北市,三峽區,1951,485,297,782,45,827,1443,57.31%,33.61%,1
新北市,三峽區,1952,462,295,757,67,824,1634,50.43%,28.27%,1
新北市,三峽區,1953,462,371,833,88,921,1716,53.67%,26.92%,1
新北市,三峽區,1954,471,327,798,70,868,1675,51.82%,28.12%,1
新北市,三峽區,1955,392,273,665,62,727,1649,44.09%,23.77%,1
新北市,三峽區,1956,399,305,704,82,786,1489,52.79%,26.8%,1
新北市,三峽區,1957,487,310,797,72,869,1771,49.07%,27.5%,1
新北市,三峽區,1958,521,331,852,67,919,1726,53.24%,30.19%,1
新北市,三峽區,1959,365,302,667,67,734,1363,53.85%,26.78%,1
新北市,三峽區,1960,466,309,775,74,849,1624,52.28%,28.69%,1
新北市,三峽區,1961,285,409,694,55,749,1352,55.4%,21.08%,1
新北市,三峽區,1962,335,260,595,22,617,1608,38.37%,20.83%,1
新北市,三峽區,1963,429,275,704,74,778,1458,53.36%,29.42%,1
新北市,三峽區,1964,411,325,736,52,788,1641,48.02%,25.05%,1
新北市,三峽區,1965,398,289,687,120,807,1530,52.75%,26.01%,1
新北市,三峽區,1966,316,244,560,72,632,1389,45.5%,22.75%,1
新北市,三峽區,1967,342,240,582,88,670,1315,50.95%,26.01%,1
新北市,三峽區,1968,338,179,517,52,569,934,60.92%,36.19%,1
新北市,三峽區,1969,320,232,552,54,606,1270,47.72%,25.2%,1
新北市,三峽區,1970,236,178,414,47,461,929,49.62%,25.4%,1
新北市,三峽區,1971,260,211,471,39,510,1035,49.28%,25.12%,1
新北市,三峽區,1972,97,100,197,26,223,502,44.42%,19.32%,1
新北市,三峽區,1973,188,153,341,67,408,836,48.8%,22.49%,1
新北市,三峽區,1974,160,97,257,70,327,669,48.88%,23.92%,1
新北市,三峽區,1975,207,145,352,78,430,733,58.66%,28.24%,1
新北市,三峽區,1976,533,335,868,70,938,1560,60.13%,34.17%,1
新北市,三峽區,1977,461,317,778,64,842,1638,51.4%,28.14%,1
新北市,三峽區,1978,351,259,610,65,675,1394,48.42%,25.18%,1
新北市,三峽區,1979,226,176,402,44,446,771,57.85%,29.31%,1
新北市,三峽區,1980,363,275,638,39,677,1367,49.52%,26.55%,1
新北市,三峽區,1981,316,249,565,80,645,1241,51.97%,25.46%,1
新北市,三峽區,1982,387,273,660,62,722,1520,47.5%,25.46%,1
新北市,三峽區,1983,294,202,496,58,554,873,63.46%,33.68%,1
新北市,三峽區,1984,131,120,251,123,374,768,48.7%,17.06%,1
新北市,三峽區,1985,266,205,471,42,513,1097,46.76%,24.25%,1
新北市,三峽區,1986,291,195,486,90,576,1322,43.57%,22.01%,1
新北市,淡水區,0029,139,106,245,43,288,544,52.94%,25.55%,1
新北市,淡水區,0030,305,197,502,80,582,1044,55.75%,29.21%,1
新北市,淡水區,0031,417,260,677,58,735,1462,50.27%,28.52%,1
新北市,淡水區,0032,416,291,707,93,800,1525,52.46%,27.28%,1
新北市,淡水區,0033,240,179,419,47,466,986,47.26%,24.34%,1
新北市,淡水區,0034,245,155,400,45,445,806,55.21%,30.4%,1
新北市,淡水區,0035,340,224,564,94,658,1173,56.1%,28.99%,1
新北市,淡水區,0036,338,219,557,68,625,1343,46.54%,25.17%,1
新北市,淡水區,0037,282,185,467,28,495,1153,42.93%,24.46%,1
新北市,淡水區,0038,188,181,369,55,424,874,48.51%,21.51%,1
新北市,淡水區,0039,258,238,496,92,588,1063,55.32%,24.27%,1
新北市,淡水區,0040,346,236,582,59,641,1309,48.97%,26.43%,1
新北市,淡水區,0041,347,279,626,67,693,1290,53.72%,26.9%,1
新北市,淡水區,0042,565,342,907,52,959,1675,57.25%,33.73%,1
新北市,淡水區,0043,493,331,824,60,884,1589,55.63%,31.03%,1
新北市,淡水區,0044,559,322,881,63,944,1624,58.13%,34.42%,1
新北市,淡水區,0045,372,249,621,44,665,1241,53.59%,29.98%,1
新北市,淡水區,0046,355,284,639,71,710,1317,53.91%,26.96%,1
新北市,淡水區,0047,395,260,655,41,696,1225,56.82%,32.24%,1
新北市,淡水區,0048,431,306,737,52,789,1426,55.33%,30.22%,1
新北市,淡水區,0049,542,357,899,40,939,1610,58.32%,33.66%,1
新北市,淡水區,0050,601,414,1015,68,1083,1982,54.64%,30.32%,1
新北市,淡水區,0051,493,335,828,64,892,1924,46.36%,25.62%,1
新北市,淡水區,0052,504,369,873,52,925,1822,50.77%,27.66%,1
新北市,淡水區,0053,338,292,630,92,722,1232,58.6%,27.44%,1
新北市,淡水區,0054,473,342,815,91,906,1588,57.05%,29.79%,1
新北市,淡水區,0055,506,337,843,59,902,1784,50.56%,28.36%,1
新北市,淡水區,0056,481,382,863,64,927,1762,52.61%,27.3%,1
新北市,淡水區,0057,466,302,768,51,819,1546,52.98%,30.14%,1
新北市,淡水區,0058,559,406,965,56,1021,1897,53.82%,29.47%,1
新北市,淡水區,0059,453,295,748,51,799,1489,53.66%,30.42%,1
新北市,淡水區,0060,502,311,813,62,875,1679,52.11%,29.9%,1
新北市,淡水區,0061,479,315,794,52,846,1693,49.97%,28.29%,1
新北市,淡水區,0062,507,326,833,29,862,1674,51.49%,30.29%,1
新北市,淡水區,0063,419,271,690,39,729,1330,54.81%,31.5%,1
新北市,淡水區,0064,449,291,740,28,768,1467,52.35%,30.61%,1
新北市,淡水區,0065,585,341,926,43,969,1837,52.75%,31.85%,1
新北市,淡水區,0066,378,248,626,27,653,1924,33.94%,19.65%,1
新北市,淡水區,0067,692,446,1138,39,1177,2340,50.3%,29.57%,1
新北市,淡水區,0068,387,301,688,99,787,1704,46.19%,22.71%,1
新北市,淡水區,0069,414,257,671,48,719,1363,52.75%,30.37%,1
新北市,淡水區,0070,844,520,1364,52,1416,3068,46.15%,27.51%,1
新北市,淡水區,0071,393,305,698,50,748,1528,48.95%,25.72%,1
新北市,淡水區,0072,429,304,733,80,813,1600,50.81%,26.81%,1
新北市,淡水區,0073,576,393,969,90,1059,1874,56.51%,30.74%,1
新北市,淡水區,0074,454,300,754,80,834,1567,53.22%,28.97%,1
新北市,淡水區,0075,410,258,668,32,700,1245,56.22%,32.93%,1
新北市,淡水區,0076,329,250,579,43,622,1211,51.36%,27.17%,1
新北市,淡水區,0077,631,417,1048,62,1110,1992,55.72%,31.68%,1
新北市,淡水區,0078,643,376,1019,52,1071,2028,52.81%,31.71%,1
新北市,淡水區,0079,426,275,701,79,780,1373,56.81%,31.03%,1
新北市,淡水區,0080,539,325,864,62,926,1732,53.46%,31.12%,1
新北市,淡水區,0081,401,298,699,58,757,1519,49.84%,26.4%,1
新北市,淡水區,0082,447,336,783,35,818,1727,47.37%,25.88%,1
新北市,淡水區,0083,364,279,643,70,713,1297,54.97%,28.06%,1
新北市,淡水區,0084,298,215,513,56,569,1066,53.38%,27.95%,1
新北市,淡水區,0085,419,287,706,65,771,1387,55.59%,30.21%,1
新北市,淡水區,0086,571,404,975,64,1039,1909,54.43%,29.91%,1
新北市,淡水區,0087,544,353,897,54,951,1770,53.73%,30.73%,1
新北市,淡水區,0088,567,383,950,80,1030,2049,50.27%,27.67%,1
新北市,淡水區,0089,477,357,834,71,905,1680,53.87%,28.39%,1
新北市,淡水區,0090,449,335,784,67,851,1433,59.39%,31.33%,1
新北市,淡水區,0091,388,298,686,46,732,1365,53.63%,28.42%,1
新北市,淡水區,0092,463,295,758,61,819,1452,56.4%,31.89%,1
新北市,淡水區,0093,561,350,911,59,970,1804,53.77%,31.1%,1
新北市,淡水區,0094,375,279,654,45,699,1322,52.87%,28.37%,1
新北市,淡水區,0095,601,399,1000,45,1045,2019,51.76%,29.77%,1
新北市,淡水區,0096,541,395,936,49,985,1696,58.08%,31.9%,1
新北市,淡水區,0097,497,338,835,47,882,1576,55.96%,31.54%,1
新北市,淡水區,0098,578,367,945,53,998,1781,56.04%,32.45%,1
新北市,淡水區,0099,555,361,916,59,975,1665,58.56%,33.33%,1
新北市,淡水區,0100,579,397,976,74,1050,2013,52.16%,28.76%,1
新北市,淡水區,0101,295,243,538,54,592,1108,53.43%,26.62%,1
新北市,淡水區,0102,386,261,647,65,712,1305,54.56%,29.58%,1
新北市,淡水區,0103,328,284,612,25,637,1199,53.13%,27.36%,1
新北市,淡水區,0104,615,392,1007,67,1074,2017,53.25%,30.49%,1
新北市,淡水區,0105,561,401,962,73,1035,2125,48.71%,26.4%,1
新北市,淡水區,0106,318,234,552,32,584,1289,45.31%,24.67%,1
新北市,淡水區,0107,427,288,715,69,784,1319,59.44%,32.37%,1
新北市,淡水區,0108,309,233,542,38,580,1051,55.19%,29.4%,1
新北市,淡水區,0109,368,300,668,53,721,1348,53.49%,27.3%,1
新北市,淡水區,0110,314,218,532,38,570,1106,51.54%,28.39%,1
新北市,淡水區,0111,206,171,377,43,420,717,58.58%,28.73%,1
新北市,淡水區,0112,377,297,674,50,724,1385,52.27%,27.22%,1
新北市,淡水區,0113,247,214,461,45,506,841,60.17%,29.37%,1
新北市,淡水區,0114,192,155,347,35,382,665,57.44%,28.87%,1
新北市,淡水區,0115,126,101,227,24,251,419,59.9%,30.07%,1
新北市,淡水區,0116,490,351,841,42,883,1599,55.22%,30.64%,1
新北市,淡水區,0117,469,348,817,64,881,1670,52.75%,28.08%,1
新北市,淡水區,0118,552,328,880,72,952,1683,56.57%,32.8%,1
新北市,淡水區,0119,430,294,724,71,795,1577,50.41%,27.27%,1
新北市,淡水區,0120,442,320,762,47,809,1618,50%,27.32%,1
新北市,淡水區,0121,576,375,951,72,1023,2214,46.21%,26.02%,1
新北市,淡水區,0122,515,348,863,88,951,1832,51.91%,28.11%,1
新北市,淡水區,0123,653,371,1024,85,1109,2123,52.24%,30.76%,1
新北市,淡水區,0124,808,457,1265,35,1300,2998,43.36%,26.95%,1
新北市,汐止區,2336,334,414,748,97,845,1595,52.98%,20.94%,1
新北市,汐止區,2337,361,276,637,70,707,1262,56.02%,28.61%,1
新北市,汐止區,2338,253,213,466,73,539,917,58.78%,27.59%,1
新北市,汐止區,2339,618,357,975,93,1068,1929,55.37%,32.04%,1
新北市,汐止區,2340,644,452,1096,84,1180,2227,52.99%,28.92%,1
新北市,汐止區,2341,323,266,589,60,649,1143,56.78%,28.26%,1
新北市,汐止區,2342,433,283,716,46,762,1367,55.74%,31.68%,1
新北市,汐止區,2343,89,61,150,25,175,322,54.35%,27.64%,1
新北市,汐止區,2344,429,335,764,5,769,1460,52.67%,29.38%,1
新北市,汐止區,2345,490,313,803,71,874,1719,50.84%,28.5%,1
新北市,汐止區,2346,465,314,779,69,848,1661,51.05%,28%,1
新北市,汐止區,2347,521,308,829,70,899,1590,56.54%,32.77%,1
新北市,汐止區,2348,464,338,802,71,873,1599,54.6%,29.02%,1
新北市,汐止區,2349,566,328,894,76,970,1749,55.46%,32.36%,1
新北市,汐止區,2350,183,144,327,29,356,1809,19.68%,10.12%,1
新北市,汐止區,2351,419,281,700,45,745,1601,46.53%,26.17%,1
新北市,汐止區,2352,410,256,666,74,740,1387,53.35%,29.56%,1
新北市,汐止區,2353,567,396,963,80,1043,1779,58.63%,31.87%,1
新北市,汐止區,2354,694,392,1086,68,1154,2074,55.64%,33.46%,1
新北市,汐止區,2355,634,401,1035,78,1113,2072,53.72%,30.6%,1
新北市,汐止區,2356,697,456,1153,83,1236,2120,58.3%,32.88%,1
新北市,汐止區,2357,590,391,981,69,1050,1952,53.79%,30.23%,1
新北市,汐止區,2358,481,306,787,91,878,1654,53.08%,29.08%,1
新北市,汐止區,2359,425,253,678,83,761,1444,52.7%,29.43%,1
新北市,汐止區,2360,537,383,920,42,962,1627,59.13%,33.01%,1
新北市,汐止區,2361,486,338,824,83,907,1751,51.8%,27.76%,1
新北市,汐止區,2362,612,402,1014,81,1095,2066,53%,29.62%,1
新北市,汐止區,2363,506,305,811,70,881,1941,45.39%,26.07%,1
新北市,汐止區,2364,606,338,944,71,1015,1906,53.25%,31.79%,1
新北市,汐止區,2365,355,274,629,89,718,1363,52.68%,26.05%,1
新北市,汐止區,2366,354,292,646,50,696,1368,50.88%,25.88%,1
新北市,汐止區,2367,302,251,553,62,615,1233,49.88%,24.49%,1
新北市,汐止區,2368,449,286,735,40,775,1554,49.87%,28.89%,1
新北市,汐止區,2369,426,361,787,66,853,1700,50.18%,25.06%,1
新北市,汐止區,2370,348,233,581,49,630,1124,56.05%,30.96%,1
新北市,汐止區,2371,597,413,1010,75,1085,1900,57.11%,31.42%,1
新北市,汐止區,2372,626,384,1010,87,1097,2050,53.51%,30.54%,1
新北市,汐止區,2373,382,226,608,59,667,1244,53.62%,30.71%,1
新北市,汐止區,2374,356,250,606,55,661,1320,50.08%,26.97%,1
新北市,汐止區,2375,445,322,767,65,832,1473,56.48%,30.21%,1
新北市,汐止區,2376,584,336,920,76,996,1802,55.27%,32.41%,1
新北市,汐止區,2377,412,278,690,51,741,1266,58.53%,32.54%,1
新北市,汐止區,2378,364,290,654,84,738,1481,49.83%,24.58%,1
新北市,汐止區,2379,412,284,696,77,773,1497,51.64%,27.52%,1
新北市,汐止區,2380,155,124,279,25,304,556,54.68%,27.88%,1
新北市,汐止區,2381,545,338,883,72,955,1913,49.92%,28.49%,1
新北市,汐止區,2382,580,384,964,54,1018,2027,50.22%,28.61%,1
新北市,汐止區,2383,546,351,897,49,946,1927,49.09%,28.33%,1
新北市,汐止區,2384,183,154,337,51,388,696,55.75%,26.29%,1
新北市,汐止區,2385,601,354,955,98,1053,2127,49.51%,28.26%,1
新北市,汐止區,2386,427,279,706,70,776,1642,47.26%,26%,1
新北市,汐止區,2387,514,386,900,98,998,1912,52.2%,26.88%,1
新北市,汐止區,2388,447,351,798,79,877,1893,46.33%,23.61%,1
新北市,汐止區,2389,372,255,627,87,714,1466,48.7%,25.38%,1
新北市,汐止區,2390,441,262,703,90,793,1538,51.56%,28.67%,1
新北市,汐止區,2391,472,261,733,53,786,1550,50.71%,30.45%,1
新北市,汐止區,2392,404,261,665,76,741,1456,50.89%,27.75%,1
新北市,汐止區,2393,291,227,518,56,574,947,60.61%,30.73%,1
新北市,汐止區,2394,277,211,488,29,517,923,56.01%,30.01%,1
新北市,汐止區,2395,477,349,826,203,1029,2043,50.37%,23.35%,1
新北市,汐止區,2396,511,366,877,82,959,2012,47.66%,25.4%,1
新北市,汐止區,2397,379,245,624,54,678,1471,46.09%,25.76%,1
新北市,汐止區,2398,431,311,742,76,818,1603,51.03%,26.89%,1
新北市,汐止區,2399,455,294,749,74,823,1530,53.79%,29.74%,1
新北市,汐止區,2400,491,318,809,46,855,1988,43.01%,24.7%,1
新北市,汐止區,2401,585,434,1019,70,1089,2198,49.55%,26.62%,1
新北市,汐止區,2402,473,325,798,71,869,1712,50.76%,27.63%,1
新北市,汐止區,2403,558,368,926,79,1005,1806,55.65%,30.9%,1
新北市,汐止區,2404,471,292,763,89,852,1576,54.06%,29.89%,1
新北市,汐止區,2405,442,293,735,50,785,1511,51.95%,29.25%,1
新北市,汐止區,2406,486,267,753,54,807,1691,47.72%,28.74%,1
新北市,汐止區,2407,479,321,800,69,869,1636,53.12%,29.28%,1
新北市,汐止區,2408,505,285,790,75,865,1676,51.61%,30.13%,1
新北市,汐止區,2409,370,240,610,46,656,1264,51.9%,29.27%,1
新北市,汐止區,2410,360,216,576,29,605,1165,51.93%,30.9%,1
新北市,汐止區,2411,487,329,816,77,893,1765,50.59%,27.59%,1
新北市,汐止區,2412,473,292,765,41,806,1815,44.41%,26.06%,1
新北市,汐止區,2413,469,319,788,95,883,1778,49.66%,26.38%,1
新北市,汐止區,2414,489,291,780,92,872,1580,55.19%,30.95%,1
新北市,汐止區,2415,421,330,751,56,807,1516,53.23%,27.77%,1
新北市,汐止區,2416,383,254,637,62,699,1425,49.05%,26.88%,1
新北市,汐止區,2417,423,293,716,51,767,1388,55.26%,30.48%,1
新北市,汐止區,2418,382,315,697,83,780,1436,54.32%,26.6%,1
新北市,汐止區,2419,479,303,782,58,840,1591,52.8%,30.11%,1
新北市,汐止區,2420,474,298,772,42,814,1639,49.66%,28.92%,1
新北市,汐止區,2421,386,266,652,35,687,1394,49.28%,27.69%,1
新北市,汐止區,2422,546,382,928,62,990,2035,48.65%,26.83%,1
新北市,汐止區,2423,543,358,901,71,972,1895,51.29%,28.65%,1
新北市,汐止區,2424,471,277,748,36,784,1374,57.06%,34.28%,1
新北市,汐止區,2425,327,256,583,36,619,1061,58.34%,30.82%,1
新北市,汐止區,2426,515,295,810,25,835,1312,63.64%,39.25%,1
新北市,汐止區,2427,508,286,794,64,858,1548,55.43%,32.82%,1
新北市,汐止區,2428,467,267,734,37,771,1350,57.11%,34.59%,1
新北市,汐止區,2429,427,334,761,50,811,1499,54.1%,28.49%,1
新北市,汐止區,2430,461,265,726,58,784,1366,57.39%,33.75%,1
新北市,汐止區,2431,399,294,693,72,765,1335,57.3%,29.89%,1
新北市,汐止區,2432,462,286,748,60,808,1324,61.03%,34.89%,1
新北市,汐止區,2433,424,281,705,76,781,1286,60.73%,32.97%,1
新北市,汐止區,2434,310,252,562,74,636,1155,55.06%,26.84%,1
新北市,汐止區,2435,610,373,983,47,1030,1682,61.24%,36.27%,1
新北市,汐止區,2436,526,325,851,69,920,1494,61.58%,35.21%,1
新北市,汐止區,2437,314,316,630,73,703,1166,60.29%,26.93%,1
新北市,汐止區,2438,622,432,1054,141,1195,2184,54.72%,28.48%,1
新北市,汐止區,2439,606,408,1014,96,1110,2031,54.65%,29.84%,1
新北市,汐止區,2440,535,351,886,76,962,1759,54.69%,30.42%,1
新北市,汐止區,2441,525,316,841,59,900,1577,57.07%,33.29%,1
新北市,汐止區,2442,441,252,693,33,726,1364,53.23%,32.33%,1
新北市,汐止區,2443,471,264,735,62,797,1401,56.89%,33.62%,1
新北市,汐止區,2444,377,270,647,46,693,1173,59.08%,32.14%,1
新北市,汐止區,2445,330,218,548,33,581,993,58.51%,33.23%,1
新北市,汐止區,2446,527,275,802,37,839,1587,52.87%,33.21%,1
新北市,瑞芳區,2220,215,159,374,47,421,725,58.07%,29.66%,1
新北市,瑞芳區,2221,310,222,532,75,607,1074,56.52%,28.86%,1
新北市,瑞芳區,2222,253,156,409,23,432,825,52.36%,30.67%,1
新北市,瑞芳區,2223,357,250,607,30,637,1242,51.29%,28.74%,1
新北市,瑞芳區,2224,173,113,286,39,325,598,54.35%,28.93%,1
新北市,瑞芳區,2225,250,164,414,52,466,872,53.44%,28.67%,1
新北市,瑞芳區,2226,187,135,322,48,370,760,48.68%,24.61%,1
新北市,瑞芳區,2227,349,210,559,65,624,1330,46.92%,26.24%,1
新北市,瑞芳區,2228,430,283,713,72,785,1683,46.64%,25.55%,1
新北市,瑞芳區,2229,257,192,449,65,514,980,52.45%,26.22%,1
新北市,瑞芳區,2230,256,187,443,60,503,946,53.17%,27.06%,1
新北市,瑞芳區,2231,345,211,556,50,606,1375,44.07%,25.09%,1
新北市,瑞芳區,2232,457,297,754,65,819,1671,49.01%,27.35%,1
新北市,瑞芳區,2233,222,167,389,37,426,978,43.56%,22.7%,1
新北市,瑞芳區,2234,155,119,274,40,314,645,48.68%,24.03%,1
新北市,瑞芳區,2235,283,203,486,73,559,1089,51.33%,25.99%,1
新北市,瑞芳區,2236,65,43,108,15,123,286,43.01%,22.73%,1
新北市,瑞芳區,2237,100,86,186,44,230,461,49.89%,21.69%,1
新北市,瑞芳區,2238,66,50,116,22,138,274,50.36%,24.09%,1
新北市,瑞芳區,2239,49,34,83,10,93,155,60%,31.61%,1
新北市,瑞芳區,2240,243,160,403,47,450,817,55.08%,29.74%,1
新北市,瑞芳區,2241,218,146,364,89,453,884,51.24%,24.66%,1
新北市,瑞芳區,2242,328,230,558,61,619,1333,46.44%,24.61%,1
新北市,瑞芳區,2243,138,82,220,14,234,607,38.55%,22.73%,1
新北市,瑞芳區,2244,289,200,489,53,542,1045,51.87%,27.66%,1
新北市,瑞芳區,2245,195,115,310,53,363,673,53.94%,28.97%,1
新北市,瑞芳區,2246,134,80,214,15,229,618,37.06%,21.68%,1
新北市,瑞芳區,2247,259,195,454,39,493,1063,46.38%,24.37%,1
新北市,瑞芳區,2248,247,164,411,55,466,860,54.19%,28.72%,1
新北市,瑞芳區,2249,68,53,121,5,126,432,29.17%,15.74%,1
新北市,瑞芳區,2250,95,65,160,12,172,445,38.65%,21.35%,1
新北市,瑞芳區,2251,68,55,123,11,134,318,42.14%,21.38%,1
新北市,瑞芳區,2252,31,34,65,12,77,159,48.43%,19.5%,1
新北市,瑞芳區,2253,78,49,127,18,145,337,43.03%,23.15%,1
新北市,瑞芳區,2254,58,29,87,11,98,180,54.44%,32.22%,1
新北市,瑞芳區,2255,46,21,67,14,81,187,43.32%,24.6%,1
新北市,瑞芳區,2256,105,65,170,22,192,369,52.03%,28.46%,1
新北市,瑞芳區,2257,81,77,158,28,186,335,55.52%,24.18%,1
新北市,瑞芳區,2258,112,69,181,19,200,470,42.55%,23.83%,1
新北市,瑞芳區,2259,64,45,109,7,116,297,39.06%,21.55%,1
新北市,瑞芳區,2260,89,69,158,8,166,267,62.17%,33.33%,1
新北市,瑞芳區,2261,130,90,220,11,231,876,26.37%,14.84%,1
新北市,瑞芳區,2262,244,172,416,32,448,1241,36.1%,19.66%,1
新北市,瑞芳區,2263,265,189,454,78,532,998,53.31%,26.55%,1
新北市,瑞芳區,2264,253,179,432,66,498,948,52.53%,26.69%,1
新北市,瑞芳區,2265,276,190,466,38,504,1308,38.53%,21.1%,1
新北市,土城區,1775,427,303,730,78,808,1505,53.69%,28.37%,1
新北市,土城區,1776,394,306,700,50,750,1242,60.39%,31.72%,1
新北市,土城區,1777,421,250,671,45,716,1206,59.37%,34.91%,1
新北市,土城區,1778,429,287,716,87,803,1474,54.48%,29.1%,1
新北市,土城區,1779,390,284,674,80,754,1489,50.64%,26.19%,1
新北市,土城區,1780,447,339,786,73,859,1675,51.28%,26.69%,1
新北市,土城區,1781,462,295,757,69,826,1499,55.1%,30.82%,1
新北市,土城區,1782,403,298,701,71,772,1495,51.64%,26.96%,1
新北市,土城區,1783,386,272,658,102,760,1411,53.86%,27.36%,1
新北市,土城區,1784,382,250,632,72,704,1378,51.09%,27.72%,1
新北市,土城區,1785,340,272,612,56,668,1256,53.18%,27.07%,1
新北市,土城區,1786,411,316,727,65,792,1379,57.43%,29.8%,1
新北市,土城區,1787,399,254,653,86,739,1424,51.9%,28.02%,1
新北市,土城區,1788,404,283,687,99,786,1455,54.02%,27.77%,1
新北市,土城區,1789,381,291,672,65,737,1419,51.94%,26.85%,1
新北市,土城區,1790,462,295,757,46,803,1357,59.17%,34.05%,1
新北市,土城區,1791,452,300,752,47,799,1501,53.23%,30.11%,1
新北市,土城區,1792,341,254,595,98,693,1206,57.46%,28.28%,1
新北市,土城區,1793,374,314,688,41,729,1255,58.09%,29.8%,1
新北市,土城區,1794,527,341,868,102,970,1869,51.9%,28.2%,1
新北市,土城區,1795,336,312,648,51,699,1292,54.1%,26.01%,1
新北市,土城區,1796,355,263,618,39,657,1324,49.62%,26.81%,1
新北市,土城區,1797,289,245,534,79,613,1155,53.07%,25.02%,1
新北市,土城區,1798,331,254,585,70,655,1183,55.37%,27.98%,1
新北市,土城區,1799,271,211,482,64,546,2518,21.68%,10.76%,1
新北市,土城區,1800,347,223,570,68,638,1218,52.38%,28.49%,1
新北市,土城區,1801,323,241,564,84,648,1133,57.19%,28.51%,1
新北市,土城區,1802,251,201,452,45,497,894,55.59%,28.08%,1
新北市,土城區,1803,311,174,485,65,550,931,59.08%,33.4%,1
新北市,土城區,1804,743,321,1064,90,1154,1820,63.41%,40.82%,1
新北市,土城區,1805,421,228,649,45,694,1320,52.58%,31.89%,1
新北市,土城區,1806,443,157,600,51,651,1241,52.46%,35.7%,1
新北市,土城區,1807,417,292,709,65,774,1414,54.74%,29.49%,1
新北市,土城區,1808,394,297,691,95,786,1378,57.04%,28.59%,1
新北市,土城區,1809,411,328,739,90,829,1421,58.34%,28.92%,1
新北市,土城區,1810,398,258,656,67,723,1340,53.96%,29.7%,1
新北市,土城區,1811,333,284,617,61,678,1144,59.27%,29.11%,1
新北市,土城區,1812,375,273,648,77,725,1268,57.18%,29.57%,1
新北市,土城區,1813,351,247,598,94,692,1196,57.86%,29.35%,1
新北市,土城區,1814,421,278,699,82,781,1308,59.71%,32.19%,1
新北市,土城區,1815,335,251,586,87,673,1175,57.28%,28.51%,1
新北市,土城區,1816,364,258,622,82,704,1230,57.24%,29.59%,1
新北市,土城區,1817,393,289,682,88,770,1342,57.38%,29.28%,1
新北市,土城區,1818,407,287,694,47,741,1268,58.44%,32.1%,1
新北市,土城區,1819,389,298,687,86,773,1227,63%,31.7%,1
新北市,土城區,1820,440,237,677,102,779,1356,57.45%,32.45%,1
新北市,土城區,1821,465,288,753,85,838,1496,56.02%,31.08%,1
新北市,土城區,1822,370,270,640,104,744,1309,56.84%,28.27%,1
新北市,土城區,1823,362,264,626,68,694,1175,59.06%,30.81%,1
新北市,土城區,1824,354,255,609,83,692,1237,55.94%,28.62%,1
新北市,土城區,1825,381,252,633,86,719,1256,57.25%,30.33%,1
新北市,土城區,1826,383,251,634,31,665,1228,54.15%,31.19%,1
新北市,土城區,1827,343,240,583,85,668,1182,56.51%,29.02%,1
新北市,土城區,1828,445,334,779,67,846,1558,54.3%,28.56%,1
新北市,土城區,1829,345,253,598,66,664,1160,57.24%,29.74%,1
新北市,土城區,1830,404,293,697,67,764,1357,56.3%,29.77%,1
新北市,土城區,1831,417,286,703,101,804,1464,54.92%,28.48%,1
新北市,土城區,1832,358,271,629,64,693,1335,51.91%,26.82%,1
新北市,土城區,1833,368,291,659,91,750,1346,55.72%,27.34%,1
新北市,土城區,1834,492,344,836,68,904,1435,63%,34.29%,1
新北市,土城區,1835,489,317,806,97,903,1639,55.09%,29.84%,1
新北市,土城區,1836,580,319,899,83,982,1728,56.83%,33.56%,1
新北市,土城區,1837,440,272,712,45,757,1665,45.47%,26.43%,1
新北市,土城區,1838,432,294,726,82,808,1333,60.62%,32.41%,1
新北市,土城區,1839,515,344,859,53,912,1567,58.2%,32.87%,1
新北市,土城區,1840,431,332,763,102,865,1576,54.89%,27.35%,1
新北市,土城區,1841,455,300,755,81,836,1458,57.34%,31.21%,1
新北市,土城區,1842,433,304,737,133,870,1517,57.35%,28.54%,1
新北市,土城區,1843,505,300,805,61,866,1489,58.16%,33.92%,1
新北市,土城區,1844,489,322,811,38,849,1463,58.03%,33.42%,1
新北市,土城區,1845,467,343,810,56,866,1584,54.67%,29.48%,1
新北市,土城區,1846,465,253,718,82,800,1464,54.64%,31.76%,1
新北市,土城區,1847,495,327,822,80,902,1598,56.45%,30.98%,1
新北市,土城區,1848,399,293,692,108,800,1500,53.33%,26.6%,1
新北市,土城區,1849,471,306,777,67,844,1542,54.73%,30.54%,1
新北市,土城區,1850,544,337,881,73,954,1619,58.93%,33.6%,1
新北市,土城區,1851,415,284,699,57,756,1521,49.7%,27.28%,1
新北市,土城區,1852,505,358,863,54,917,1691,54.23%,29.86%,1
新北市,土城區,1853,494,324,818,68,886,1657,53.47%,29.81%,1
新北市,土城區,1854,578,396,974,55,1029,1772,58.07%,32.62%,1
新北市,土城區,1855,467,287,754,31,785,1423,55.17%,32.82%,1
新北市,土城區,1856,420,337,757,57,814,1321,61.62%,31.79%,1
新北市,土城區,1857,472,326,798,76,874,1429,61.16%,33.03%,1
新北市,土城區,1858,436,255,691,83,774,1445,53.56%,30.17%,1
新北市,土城區,1859,517,296,813,70,883,1520,58.09%,34.01%,1
新北市,土城區,1860,411,234,645,37,682,1484,45.96%,27.7%,1
新北市,土城區,1861,404,282,686,40,726,1362,53.3%,29.66%,1
新北市,土城區,1862,366,262,628,57,685,1262,54.28%,29%,1
新北市,土城區,1863,390,317,707,70,777,1343,57.86%,29.04%,1
新北市,土城區,1864,340,252,592,63,655,1337,48.99%,25.43%,1
新北市,土城區,1865,305,216,521,66,587,1325,44.3%,23.02%,1
新北市,土城區,1866,356,288,644,66,710,1390,51.08%,25.61%,1
新北市,土城區,1867,452,302,754,79,833,1534,54.3%,29.47%,1
新北市,土城區,1868,420,265,685,103,788,1484,53.1%,28.3%,1
新北市,土城區,1869,411,265,676,117,793,1532,51.76%,26.83%,1
新北市,土城區,1870,481,282,763,82,845,1507,56.07%,31.92%,1
新北市,土城區,1871,493,311,804,69,873,1550,56.32%,31.81%,1
新北市,土城區,1872,459,323,782,70,852,1567,54.37%,29.29%,1
新北市,土城區,1873,402,300,702,76,778,1367,56.91%,29.41%,1
新北市,土城區,1874,358,267,625,68,693,1293,53.6%,27.69%,1
新北市,土城區,1875,415,291,706,83,789,1402,56.28%,29.6%,1
新北市,土城區,1876,421,275,696,67,763,1379,55.33%,30.53%,1
新北市,土城區,1877,445,266,711,60,771,1471,52.41%,30.25%,1
新北市,土城區,1878,427,268,695,62,757,1410,53.69%,30.28%,1
新北市,土城區,1879,458,314,772,59,831,1542,53.89%,29.7%,1
新北市,土城區,1880,343,267,610,73,683,1238,55.17%,27.71%,1
新北市,土城區,1881,333,232,565,115,680,1301,52.27%,25.6%,1
新北市,土城區,1882,505,298,803,41,844,1311,64.38%,38.52%,1
新北市,土城區,1883,414,253,667,68,735,1511,48.64%,27.4%,1
新北市,土城區,1884,419,320,739,75,814,1531,53.17%,27.37%,1
新北市,土城區,1885,478,297,775,78,853,1638,52.08%,29.18%,1
新北市,土城區,1886,441,288,729,63,792,1335,59.33%,33.03%,1
新北市,土城區,1887,463,277,740,64,804,1459,55.11%,31.73%,1
新北市,土城區,1888,442,301,743,59,802,1489,53.86%,29.68%,1
新北市,土城區,1889,560,351,911,60,971,1774,54.74%,31.57%,1
新北市,土城區,1890,546,374,920,60,980,1792,54.69%,30.47%,1
新北市,土城區,1891,562,348,910,77,987,1798,54.89%,31.26%,1
新北市,土城區,1892,355,262,617,85,702,1312,53.51%,27.06%,1
新北市,土城區,1893,383,219,602,76,678,1301,52.11%,29.44%,1
新北市,土城區,1894,336,261,597,68,665,1254,53.03%,26.79%,1
新北市,土城區,1895,338,258,596,47,643,1215,52.92%,27.82%,1
新北市,土城區,1896,443,279,722,62,784,1448,54.14%,30.59%,1
新北市,土城區,1897,369,263,632,83,715,1321,54.13%,27.93%,1
新北市,土城區,1898,292,225,517,80,597,1150,51.91%,25.39%,1
新北市,土城區,1899,337,285,622,78,700,1425,49.12%,23.65%,1
新北市,土城區,1900,379,355,734,80,814,1366,59.59%,27.75%,1
新北市,土城區,1901,382,293,675,60,735,1292,56.89%,29.57%,1
新北市,土城區,1902,367,276,643,77,720,1317,54.67%,27.87%,1
新北市,土城區,1903,404,274,678,75,753,1324,56.87%,30.51%,1
新北市,土城區,1904,328,238,566,73,639,1189,53.74%,27.59%,1
新北市,土城區,1905,351,317,668,43,711,1223,58.14%,28.7%,1
新北市,土城區,1906,440,309,749,80,829,1550,53.48%,28.39%,1
新北市,土城區,1907,458,349,807,104,911,1606,56.72%,28.52%,1
新北市,土城區,1908,433,329,762,66,828,1509,54.87%,28.69%,1
新北市,土城區,1909,469,273,742,82,824,1529,53.89%,30.67%,1
新北市,土城區,1910,427,239,666,106,772,1458,52.95%,29.29%,1
新北市,土城區,1911,403,305,708,132,840,1468,57.22%,27.45%,1
新北市,土城區,1912,433,305,738,67,805,1495,53.85%,28.96%,1
新北市,土城區,1913,363,281,644,96,740,1303,56.79%,27.86%,1
新北市,土城區,1914,397,298,695,74,769,1365,56.34%,29.08%,1
新北市,土城區,1915,452,284,736,85,821,1476,55.62%,30.62%,1
新北市,土城區,1916,520,270,790,51,841,1519,55.37%,34.23%,1
新北市,蘆洲區,0555,402,370,772,136,908,1600,56.75%,25.12%,1
新北市,蘆洲區,0556,482,298,780,81,861,1549,55.58%,31.12%,1
新北市,蘆洲區,0557,433,340,773,114,887,1516,58.51%,28.56%,1
新北市,蘆洲區,0558,407,260,667,107,774,1404,55.13%,28.99%,1
新北市,蘆洲區,0559,363,295,658,94,752,1381,54.45%,26.29%,1
新北市,蘆洲區,0560,461,315,776,63,839,1485,56.5%,31.04%,1
新北市,蘆洲區,0561,344,266,610,69,679,1779,38.17%,19.34%,1
新北市,蘆洲區,0562,478,402,880,78,958,1797,53.31%,26.6%,1
新北市,蘆洲區,0563,392,304,696,96,792,1364,58.06%,28.74%,1
新北市,蘆洲區,0564,504,325,829,86,915,1635,55.96%,30.83%,1
新北市,蘆洲區,0565,382,307,689,62,751,1567,47.93%,24.38%,1
新北市,蘆洲區,0566,428,306,734,66,800,1524,52.49%,28.08%,1
新北市,蘆洲區,0567,439,325,764,74,838,1612,51.99%,27.23%,1
新北市,蘆洲區,0568,451,379,830,54,884,1674,52.81%,26.94%,1
新北市,蘆洲區,0569,451,367,818,83,901,1838,49.02%,24.54%,1
新北市,蘆洲區,0570,441,322,763,57,820,1814,45.2%,24.31%,1
新北市,蘆洲區,0571,412,342,754,66,820,1473,55.67%,27.97%,1
新北市,蘆洲區,0572,437,299,736,60,796,1465,54.33%,29.83%,1
新北市,蘆洲區,0573,489,371,860,93,953,1652,57.69%,29.6%,1
新北市,蘆洲區,0574,451,232,683,119,802,1650,48.61%,27.33%,1
新北市,蘆洲區,0575,507,341,848,65,913,1656,55.13%,30.62%,1
新北市,蘆洲區,0576,411,330,741,82,823,1571,52.39%,26.16%,1
新北市,蘆洲區,0577,404,322,726,89,815,1523,53.51%,26.53%,1
新北市,蘆洲區,0578,414,331,745,53,798,1475,54.1%,28.07%,1
新北市,蘆洲區,0579,372,271,643,78,721,1367,52.74%,27.21%,1
新北市,蘆洲區,0580,442,337,779,79,858,1514,56.67%,29.19%,1
新北市,蘆洲區,0581,589,394,983,70,1053,1791,58.79%,32.89%,1
新北市,蘆洲區,0582,566,391,957,79,1036,1714,60.44%,33.02%,1
新北市,蘆洲區,0583,593,364,957,59,1016,1780,57.08%,33.31%,1
新北市,蘆洲區,0584,552,369,921,54,975,1713,56.92%,32.22%,1
新北市,蘆洲區,0585,556,393,949,59,1008,1720,58.6%,32.33%,1
新北市,蘆洲區,0586,532,379,911,57,968,1766,54.81%,30.12%,1
新北市,蘆洲區,0587,479,313,792,91,883,1623,54.41%,29.51%,1
新北市,蘆洲區,0588,541,334,875,74,949,1740,54.54%,31.09%,1
新北市,蘆洲區,0589,525,409,934,84,1018,1759,57.87%,29.85%,1
新北市,蘆洲區,0590,517,421,938,94,1032,1775,58.14%,29.13%,1
新北市,蘆洲區,0591,589,408,997,91,1088,1909,56.99%,30.85%,1
新北市,蘆洲區,0592,527,409,936,116,1052,1805,58.28%,29.2%,1
新北市,蘆洲區,0593,448,359,807,62,869,1642,52.92%,27.28%,1
新北市,蘆洲區,0594,506,334,840,82,922,1713,53.82%,29.54%,1
新北市,蘆洲區,0595,462,342,804,90,894,1746,51.2%,26.46%,1
新北市,蘆洲區,0596,468,338,806,73,879,1596,55.08%,29.32%,1
新北市,蘆洲區,0597,415,280,695,65,760,1434,53%,28.94%,1
新北市,蘆洲區,0598,411,320,731,71,802,1450,55.31%,28.34%,1
新北市,蘆洲區,0599,403,319,722,44,766,1543,49.64%,26.12%,1
新北市,蘆洲區,0600,436,310,746,67,813,1525,53.31%,28.59%,1
新北市,蘆洲區,0601,391,282,673,63,736,1419,51.87%,27.55%,1
新北市,蘆洲區,0602,388,284,672,68,740,1298,57.01%,29.89%,1
新北市,蘆洲區,0603,373,257,630,79,709,1304,54.37%,28.6%,1
新北市,蘆洲區,0604,514,360,874,91,965,1806,53.43%,28.46%,1
新北市,蘆洲區,0605,523,358,881,112,993,1910,51.99%,27.38%,1
新北市,蘆洲區,0606,448,335,783,84,867,1873,46.29%,23.92%,1
新北市,蘆洲區,0607,456,332,788,64,852,1785,47.73%,25.55%,1
新北市,蘆洲區,0608,434,351,785,89,874,1760,49.66%,24.66%,1
新北市,蘆洲區,0609,573,369,942,89,1031,1841,56%,31.12%,1
新北市,蘆洲區,0610,488,356,844,67,911,1855,49.11%,26.31%,1
新北市,蘆洲區,0611,343,297,640,90,730,1450,50.34%,23.66%,1
新北市,蘆洲區,0612,383,367,750,80,830,1585,52.37%,24.16%,1
新北市,蘆洲區,0613,359,271,630,154,784,1541,50.88%,23.3%,1
新北市,蘆洲區,0614,447,337,784,84,868,1626,53.38%,27.49%,1
新北市,蘆洲區,0615,328,293,621,80,701,1241,56.49%,26.43%,1
新北市,蘆洲區,0616,458,346,804,85,889,1634,54.41%,28.03%,1
新北市,蘆洲區,0617,464,305,769,98,867,1573,55.12%,29.5%,1
新北市,蘆洲區,0618,496,364,860,63,923,1619,57.01%,30.64%,1
新北市,蘆洲區,0619,536,379,915,112,1027,1878,54.69%,28.54%,1
新北市,蘆洲區,0620,502,352,854,110,964,1797,53.64%,27.94%,1
新北市,蘆洲區,0621,551,400,951,57,1008,1816,55.51%,30.34%,1
新北市,蘆洲區,0622,385,313,698,107,805,1344,59.9%,28.65%,1
新北市,蘆洲區,0623,431,392,823,96,919,1492,61.6%,28.89%,1
新北市,蘆洲區,0624,541,387,928,136,1064,1959,54.31%,27.62%,1
新北市,蘆洲區,0625,436,314,750,133,883,1611,54.81%,27.06%,1
新北市,蘆洲區,0626,429,387,816,100,916,1574,58.2%,27.26%,1
新北市,蘆洲區,0627,503,358,861,88,949,1653,57.41%,30.43%,1
新北市,蘆洲區,0628,586,388,974,90,1064,3085,34.49%,19%,1
新北市,蘆洲區,0629,470,382,852,115,967,1812,53.37%,25.94%,1
新北市,蘆洲區,0630,339,307,646,84,730,1332,54.8%,25.45%,1
新北市,蘆洲區,0631,416,284,700,102,802,1648,48.67%,25.24%,1
新北市,蘆洲區,0632,389,263,652,51,703,1355,51.88%,28.71%,1
新北市,蘆洲區,0633,412,300,712,51,763,1371,55.65%,30.05%,1
新北市,蘆洲區,0634,291,266,557,91,648,1111,58.33%,26.19%,1
新北市,蘆洲區,0635,312,276,588,114,702,1176,59.69%,26.53%,1
新北市,蘆洲區,0636,442,344,786,94,880,1602,54.93%,27.59%,1
新北市,蘆洲區,0637,329,296,625,69,694,1361,50.99%,24.17%,1
新北市,蘆洲區,0638,443,282,725,101,826,1530,53.99%,28.95%,1
新北市,蘆洲區,0639,250,186,436,91,527,925,56.97%,27.03%,1
新北市,蘆洲區,0640,524,389,913,86,999,1851,53.97%,28.31%,1
新北市,蘆洲區,0641,508,305,813,62,875,1791,48.86%,28.36%,1
新北市,蘆洲區,0642,500,343,843,82,925,1853,49.92%,26.98%,1
新北市,蘆洲區,0643,457,333,790,64,854,1758,48.58%,26%,1
新北市,蘆洲區,0644,522,357,879,89,968,1798,53.84%,29.03%,1
新北市,蘆洲區,0645,497,337,834,72,906,1645,55.08%,30.21%,1
新北市,蘆洲區,0646,409,300,709,76,785,1612,48.7%,25.37%,1
新北市,蘆洲區,0647,425,339,764,109,873,1784,48.93%,23.82%,1
新北市,蘆洲區,0648,420,295,715,78,793,1701,46.62%,24.69%,1
新北市,蘆洲區,0649,457,302,759,57,816,1581,51.61%,28.91%,1
新北市,蘆洲區,0650,441,325,766,76,842,1534,54.89%,28.75%,1
新北市,蘆洲區,0651,479,362,841,87,928,1620,57.28%,29.57%,1
新北市,蘆洲區,0652,468,346,814,74,888,1494,59.44%,31.33%,1
新北市,蘆洲區,0653,338,254,592,66,658,1183,55.62%,28.57%,1
新北市,蘆洲區,0654,263,243,506,64,570,985,57.87%,26.7%,1
新北市,蘆洲區,0655,459,319,778,89,867,1673,51.82%,27.44%,1
新北市,蘆洲區,0656,504,345,849,99,948,1688,56.16%,29.86%,1
新北市,蘆洲區,0657,356,269,625,65,690,1249,55.24%,28.5%,1
新北市,蘆洲區,0658,401,291,692,85,777,1476,52.64%,27.17%,1
新北市,五股區,0207,369,316,685,112,797,1456,54.74%,25.34%,1
新北市,五股區,0208,404,300,704,83,787,1482,53.1%,27.26%,1
新北市,五股區,0209,341,323,664,61,725,1287,56.33%,26.5%,1
新北市,五股區,0210,259,256,515,48,563,1106,50.9%,23.42%,1
新北市,五股區,0211,336,253,589,91,680,1283,53%,26.19%,1
新北市,五股區,0212,492,370,862,60,922,1833,50.3%,26.84%,1
新北市,五股區,0213,351,246,597,61,658,1141,57.67%,30.76%,1
新北市,五股區,0214,137,103,240,45,285,463,61.56%,29.59%,1
新北市,五股區,0215,526,340,866,88,954,1786,53.42%,29.45%,1
新北市,五股區,0216,419,360,779,68,847,1660,51.02%,25.24%,1
新北市,五股區,0217,400,333,733,110,843,1534,54.95%,26.08%,1
新北市,五股區,0218,357,276,633,95,728,1285,56.65%,27.78%,1
新北市,五股區,0219,475,338,813,150,963,1832,52.57%,25.93%,1
新北市,五股區,0220,406,332,738,65,803,1542,52.08%,26.33%,1
新北市,五股區,0221,406,377,783,80,863,1897,45.49%,21.4%,1
新北市,五股區,0222,474,336,810,142,952,1964,48.47%,24.13%,1
新北市,五股區,0223,447,335,782,103,885,1779,49.75%,25.13%,1
新北市,五股區,0224,505,348,853,42,895,1735,51.59%,29.11%,1
新北市,五股區,0225,618,445,1063,70,1133,2299,49.28%,26.88%,1
新北市,五股區,0226,429,339,768,78,846,1755,48.21%,24.44%,1
新北市,五股區,0227,456,374,830,91,921,1674,55.02%,27.24%,1
新北市,五股區,0228,444,358,802,116,918,1661,55.27%,26.73%,1
新北市,五股區,0229,306,244,550,53,603,1281,47.07%,23.89%,1
新北市,五股區,0230,422,320,742,101,843,1566,53.83%,26.95%,1
新北市,五股區,0231,405,252,657,48,705,1560,45.19%,25.96%,1
新北市,五股區,0232,475,332,807,59,866,1622,53.39%,29.28%,1
新北市,五股區,0233,518,377,895,60,955,1779,53.68%,29.12%,1
新北市,五股區,0234,382,302,684,88,772,1487,51.92%,25.69%,1
新北市,五股區,0235,472,329,801,61,862,1567,55.01%,30.12%,1
新北市,五股區,0236,257,216,473,48,521,1333,39.08%,19.28%,1
新北市,五股區,0237,392,279,671,87,758,1263,60.02%,31.04%,1
新北市,五股區,0238,373,400,773,95,868,1314,66.06%,28.39%,1
新北市,五股區,0239,413,294,707,58,765,1513,50.56%,27.3%,1
新北市,五股區,0240,457,306,763,66,829,1517,54.65%,30.13%,1
新北市,五股區,0241,446,340,786,89,875,1613,54.25%,27.65%,1
新北市,五股區,0242,469,313,782,91,873,1616,54.02%,29.02%,1
新北市,五股區,0243,417,366,783,83,866,1616,53.59%,25.8%,1
新北市,五股區,0244,485,338,823,97,920,1689,54.47%,28.72%,1
新北市,五股區,0245,513,436,949,38,987,1894,52.11%,27.09%,1
新北市,五股區,0246,408,266,674,84,758,1210,62.64%,33.72%,1
新北市,五股區,0247,455,308,763,81,844,1643,51.37%,27.69%,1
新北市,五股區,0248,421,286,707,41,748,1441,51.91%,29.22%,1
新北市,五股區,0249,399,288,687,67,754,1305,57.78%,30.57%,1
新北市,五股區,0250,365,266,631,90,721,1170,61.62%,31.2%,1
新北市,五股區,0251,512,259,771,80,851,1397,60.92%,36.65%,1
新北市,五股區,0252,464,257,721,72,793,1312,60.44%,35.37%,1
新北市,五股區,0253,358,175,533,37,570,1127,50.58%,31.77%,1
新北市,五股區,0254,365,185,550,51,601,1154,52.08%,31.63%,1
新北市,泰山區,0255,159,128,287,39,326,643,50.7%,24.73%,1
新北市,泰山區,0256,59,44,103,12,115,186,61.83%,31.72%,1
新北市,泰山區,0257,428,262,690,51,741,1457,50.86%,29.38%,1
新北市,泰山區,0258,495,312,807,83,890,1594,55.83%,31.05%,1
新北市,泰山區,0259,451,288,739,69,808,1598,50.56%,28.22%,1
新北市,泰山區,0260,450,255,705,53,758,1503,50.43%,29.94%,1
新北市,泰山區,0261,389,262,651,98,749,1436,52.16%,27.09%,1
新北市,泰山區,0262,402,290,692,73,765,1384,55.27%,29.05%,1
新北市,泰山區,0263,359,255,614,74,688,1231,55.89%,29.16%,1
新北市,泰山區,0264,358,262,620,45,665,1295,51.35%,27.64%,1
新北市,泰山區,0265,513,308,821,77,898,1563,57.45%,32.82%,1
新北市,泰山區,0266,533,314,847,80,927,1610,57.58%,33.11%,1
新北市,泰山區,0267,348,285,633,42,675,1253,53.87%,27.77%,1
新北市,泰山區,0268,348,259,607,58,665,1294,51.39%,26.89%,1
新北市,泰山區,0269,423,304,727,63,790,1354,58.35%,31.24%,1
新北市,泰山區,0270,405,241,646,44,690,1259,54.81%,32.17%,1
新北市,泰山區,0271,389,263,652,53,705,1252,56.31%,31.07%,1
新北市,泰山區,0272,312,213,525,47,572,1094,52.29%,28.52%,1
新北市,泰山區,0273,482,350,832,61,893,1590,56.16%,30.31%,1
新北市,泰山區,0274,468,352,820,88,908,1634,55.57%,28.64%,1
新北市,泰山區,0275,371,307,678,51,729,1536,47.46%,24.15%,1
新北市,泰山區,0276,450,368,818,68,886,1534,57.76%,29.34%,1
新北市,泰山區,0277,532,349,881,67,948,1545,61.36%,34.43%,1
新北市,泰山區,0278,435,284,719,64,783,1399,55.97%,31.09%,1
新北市,泰山區,0279,407,258,665,34,699,1315,53.16%,30.95%,1
新北市,泰山區,0280,396,268,664,70,734,1201,61.12%,32.97%,1
新北市,泰山區,0281,332,256,588,69,657,1182,55.58%,28.09%,1
新北市,泰山區,0282,419,341,760,111,871,1665,52.31%,25.17%,1
新北市,泰山區,0283,516,392,908,103,1011,1855,54.5%,27.82%,1
新北市,泰山區,0284,537,383,920,111,1031,1866,55.25%,28.78%,1
新北市,泰山區,0285,585,368,953,78,1031,1935,53.28%,30.23%,1
新北市,泰山區,0286,436,321,757,62,819,1589,51.54%,27.44%,1
新北市,泰山區,0287,350,203,553,55,608,1152,52.78%,30.38%,1
新北市,泰山區,0288,328,234,562,61,623,1114,55.92%,29.44%,1
新北市,泰山區,0289,348,228,576,72,648,1040,62.31%,33.46%,1
新北市,泰山區,0290,300,240,540,59,599,1003,59.72%,29.91%,1
新北市,泰山區,0291,305,246,551,33,584,975,59.9%,31.28%,1
新北市,泰山區,0292,428,296,724,60,784,1440,54.44%,29.72%,1
新北市,泰山區,0293,425,309,734,47,781,1480,52.77%,28.72%,1
新北市,泰山區,0294,352,279,631,49,680,1211,56.15%,29.07%,1
新北市,泰山區,0295,430,219,649,42,691,1237,55.86%,34.76%,1
新北市,泰山區,0296,315,207,522,57,579,1069,54.16%,29.47%,1
新北市,泰山區,0297,511,406,917,79,996,1680,59.29%,30.42%,1
新北市,泰山區,0298,474,395,869,62,931,1651,56.39%,28.71%,1
新北市,泰山區,0299,408,284,692,49,741,1420,52.18%,28.73%,1
新北市,泰山區,0300,414,294,708,59,767,1337,57.37%,30.96%,1
新北市,泰山區,0301,478,381,859,48,907,1591,57.01%,30.04%,1
新北市,林口區,0145,350,268,618,62,680,1268,53.63%,27.6%,1
新北市,林口區,0146,319,226,545,62,607,1171,51.84%,27.24%,1
新北市,林口區,0147,373,267,640,58,698,1218,57.31%,30.62%,1
新北市,林口區,0148,522,396,918,65,983,1788,54.98%,29.19%,1
新北市,林口區,0149,436,308,744,83,827,1625,50.89%,26.83%,1
新北市,林口區,0150,413,264,677,79,756,1448,52.21%,28.52%,1
新北市,林口區,0151,341,251,592,90,682,1328,51.36%,25.68%,1
新北市,林口區,0152,367,266,633,75,708,1523,46.49%,24.1%,1
新北市,林口區,0153,390,235,625,59,684,1245,54.94%,31.33%,1
新北市,林口區,0154,477,311,788,37,825,1329,62.08%,35.89%,1
新北市,林口區,0155,488,319,807,57,864,1465,58.98%,33.31%,1
新北市,林口區,0156,446,327,773,33,806,1369,58.88%,32.58%,1
新北市,林口區,0157,406,330,736,54,790,1346,58.69%,30.16%,1
新北市,林口區,0158,332,243,575,75,650,1181,55.04%,28.11%,1
新北市,林口區,0159,446,313,759,40,799,1291,61.89%,34.55%,1
新北市,林口區,0160,357,253,610,63,673,1213,55.48%,29.43%,1
新北市,林口區,0161,418,253,671,61,732,1256,58.28%,33.28%,1
新北市,林口區,0162,317,259,576,67,643,1185,54.26%,26.75%,1
新北市,林口區,0163,416,266,682,60,742,1361,54.52%,30.57%,1
新北市,林口區,0164,578,286,864,37,901,1756,51.31%,32.92%,1
新北市,林口區,0165,533,293,826,35,861,1676,51.37%,31.8%,1
新北市,林口區,0166,530,300,830,41,871,1540,56.56%,34.42%,1
新北市,林口區,0167,536,277,813,39,852,1569,54.3%,34.16%,1
新北市,林口區,0168,505,298,803,35,838,1514,55.35%,33.36%,1
新北市,林口區,0169,353,309,662,33,695,1193,58.26%,29.59%,1
新北市,林口區,0170,564,320,884,34,918,1610,57.02%,35.03%,1
新北市,林口區,0171,441,286,727,45,772,1338,57.7%,32.96%,1
新北市,林口區,0172,343,252,595,60,655,1141,57.41%,30.06%,1
新北市,林口區,0173,424,265,689,49,738,1307,56.47%,32.44%,1
新北市,林口區,0174,403,315,718,42,760,1327,57.27%,30.37%,1
新北市,林口區,0175,430,262,692,51,743,1285,57.82%,33.46%,1
新北市,林口區,0176,440,334,774,49,823,1481,55.57%,29.71%,1
新北市,林口區,0177,480,343,823,36,859,1510,56.89%,31.79%,1
新北市,林口區,0178,549,355,904,45,949,1785,53.17%,30.76%,1
新北市,林口區,0179,567,368,935,38,973,1792,54.3%,31.64%,1
新北市,林口區,0180,528,296,824,35,859,1517,56.62%,34.81%,1
新北市,林口區,0181,560,300,860,37,897,1564,57.35%,35.81%,1
新北市,林口區,0182,549,305,854,42,896,1560,57.44%,35.19%,1
新北市,林口區,0183,490,304,794,44,838,1544,54.27%,31.74%,1
新北市,林口區,0184,500,318,818,49,867,1593,54.43%,31.39%,1
新北市,林口區,0185,454,305,759,41,800,1431,55.9%,31.73%,1
新北市,林口區,0186,483,310,793,56,849,1571,54.04%,30.74%,1
新北市,林口區,0187,463,324,787,45,832,1439,57.82%,32.18%,1
新北市,林口區,0188,483,306,789,53,842,1451,58.03%,33.29%,1
新北市,林口區,0189,467,314,781,60,841,1391,60.46%,33.57%,1
新北市,林口區,0190,471,293,764,47,811,1461,55.51%,32.24%,1
新北市,林口區,0191,528,336,864,48,912,1691,53.93%,31.22%,1
新北市,林口區,0192,449,324,773,82,855,1524,56.1%,29.46%,1
新北市,林口區,0193,478,310,788,51,839,1343,62.47%,35.59%,1
新北市,林口區,0194,463,317,780,54,834,1398,59.66%,33.12%,1
新北市,林口區,0195,457,309,766,57,823,1380,59.64%,33.12%,1
新北市,林口區,0196,418,288,706,59,765,1367,55.96%,30.58%,1
新北市,林口區,0197,421,301,722,51,773,1350,57.26%,31.19%,1
新北市,林口區,0198,380,273,653,46,699,1194,58.54%,31.83%,1
新北市,林口區,0199,386,272,658,79,737,1344,54.84%,28.72%,1
新北市,林口區,0200,342,263,605,48,653,1154,56.59%,29.64%,1
新北市,林口區,0201,375,269,644,53,697,1119,62.29%,33.51%,1
新北市,林口區,0202,238,209,447,54,501,1026,48.83%,23.2%,1
新北市,林口區,0203,336,263,599,76,675,1210,55.79%,27.77%,1
新北市,林口區,0204,244,196,440,74,514,912,56.36%,26.75%,1
新北市,林口區,0205,239,190,429,50,479,824,58.13%,29%,1
新北市,林口區,0206,425,316,741,91,832,1411,58.97%,30.12%,1
新北市,深坑區,2163,321,219,540,49,589,1142,51.58%,28.11%,1
新北市,深坑區,2164,347,256,603,67,670,1139,58.82%,30.47%,1
新北市,深坑區,2165,262,234,496,77,573,1065,53.8%,24.6%,1
新北市,深坑區,2166,408,242,650,66,716,1400,51.14%,29.14%,1
新北市,深坑區,2167,374,246,620,57,677,1330,50.9%,28.12%,1
新北市,深坑區,2168,365,272,637,41,678,1380,49.13%,26.45%,1
新北市,深坑區,2169,390,246,636,35,671,1496,44.85%,26.07%,1
新北市,深坑區,2170,487,300,787,78,865,1508,57.36%,32.29%,1
新北市,深坑區,2171,468,371,839,87,926,1624,57.02%,28.82%,1
新北市,深坑區,2172,674,431,1105,73,1178,2165,54.41%,31.13%,1
新北市,深坑區,2173,564,376,940,105,1045,1790,58.38%,31.51%,1
新北市,深坑區,2174,204,151,355,33,388,782,49.62%,26.09%,1
新北市,深坑區,2175,409,236,645,30,675,1164,57.99%,35.14%,1
新北市,深坑區,2176,427,308,735,67,802,1344,59.67%,31.77%,1
新北市,深坑區,2177,238,188,426,28,454,739,61.43%,32.21%,1
新北市,深坑區,2178,178,123,301,38,339,556,60.97%,32.01%,1
新北市,石碇區,2179,109,93,202,39,241,391,61.64%,27.88%,1
新北市,石碇區,2180,220,130,350,51,401,789,50.82%,27.88%,1
新北市,石碇區,2181,134,113,247,29,276,662,41.69%,20.24%,1
新北市,石碇區,2182,81,63,144,17,161,310,51.94%,26.13%,1
新北市,石碇區,2183,83,50,133,16,149,280,53.21%,29.64%,1
新北市,石碇區,2184,19,14,33,5,38,93,40.86%,20.43%,1
新北市,石碇區,2185,152,107,259,46,305,683,44.66%,22.25%,1
新北市,石碇區,2186,110,79,189,14,203,323,62.85%,34.06%,1
新北市,石碇區,2187,135,116,251,12,263,726,36.23%,18.6%,1
新北市,石碇區,2188,146,125,271,44,315,591,53.3%,24.7%,1
新北市,石碇區,2189,71,83,154,36,190,282,67.38%,25.18%,1
新北市,石碇區,2190,184,115,299,21,320,788,40.61%,23.35%,1
新北市,石碇區,2191,236,241,477,77,554,943,58.75%,25.03%,1
新北市,坪林區,2192,373,215,588,58,646,1248,51.76%,29.89%,1
新北市,坪林區,2193,138,110,248,44,292,612,47.71%,22.55%,1
新北市,坪林區,2194,316,232,548,106,654,1141,57.32%,27.7%,1
新北市,坪林區,2195,90,67,157,7,164,417,39.33%,21.58%,1
新北市,坪林區,2196,162,119,281,51,332,595,55.8%,27.23%,1
新北市,坪林區,2197,77,51,128,24,152,248,61.29%,31.05%,1
新北市,坪林區,2198,92,51,143,22,165,338,48.82%,27.22%,1
新北市,坪林區,2199,107,71,178,25,203,478,42.47%,22.38%,1
新北市,坪林區,2200,80,56,136,17,153,390,39.23%,20.51%,1
新北市,坪林區,2201,100,58,158,36,194,424,45.75%,23.58%,1
新北市,三芝區,0011,83,51,134,13,147,312,47.12%,26.6%,1
新北市,三芝區,0012,403,244,647,38,685,1421,48.21%,28.36%,1
新北市,三芝區,0013,468,276,744,59,803,1557,51.57%,30.06%,1
新北市,三芝區,0014,465,380,845,85,930,1828,50.88%,25.44%,1
新北市,三芝區,0015,265,221,486,54,540,1060,50.94%,25%,1
新北市,三芝區,0016,189,120,309,49,358,819,43.71%,23.08%,1
新北市,三芝區,0017,403,273,676,42,718,1701,42.21%,23.69%,1
新北市,三芝區,0018,433,326,759,80,839,1740,48.22%,24.89%,1
新北市,三芝區,0019,334,285,619,60,679,1451,46.8%,23.02%,1
新北市,三芝區,0020,300,202,502,72,574,1248,45.99%,24.04%,1
新北市,三芝區,0021,171,130,301,22,323,629,51.35%,27.19%,1
新北市,三芝區,0022,123,85,208,24,232,504,46.03%,24.4%,1
新北市,三芝區,0023,151,138,289,22,311,698,44.56%,21.63%,1
新北市,三芝區,0024,528,352,880,74,954,2069,46.11%,25.52%,1
新北市,三芝區,0025,216,155,371,45,416,784,53.06%,27.55%,1
新北市,三芝區,0026,122,108,230,33,263,522,50.38%,23.37%,1
新北市,三芝區,0027,127,97,224,80,304,587,51.79%,21.64%,1
新北市,三芝區,0028,306,243,549,57,606,1189,50.97%,25.74%,1
新北市,石門區,0001,281,229,510,70,580,1121,51.74%,25.07%,1
新北市,石門區,0002,329,259,588,84,672,1389,48.38%,23.69%,1
新北市,石門區,0003,257,185,442,52,494,933,52.95%,27.55%,1
新北市,石門區,0004,328,212,540,79,619,1244,49.76%,26.37%,1
新北市,石門區,0005,231,146,377,108,485,883,54.93%,26.16%,1
新北市,石門區,0006,444,311,755,78,833,1564,53.26%,28.39%,1
新北市,石門區,0007,413,303,716,82,798,1500,53.2%,27.53%,1
新北市,石門區,0008,88,40,128,23,151,328,46.04%,26.83%,1
新北市,石門區,0009,197,176,373,31,404,651,62.06%,30.26%,1
新北市,石門區,0010,208,144,352,60,412,915,45.03%,22.73%,1
新北市,八里區,0125,393,269,662,80,742,1498,49.53%,26.23%,1
新北市,八里區,0126,497,349,846,56,902,1939,46.52%,25.63%,1
新北市,八里區,0127,402,322,724,84,808,1516,53.3%,26.52%,1
新北市,八里區,0128,512,342,854,83,937,1642,57.06%,31.18%,1
新北市,八里區,0129,473,368,841,96,937,1927,48.62%,24.55%,1
新北市,八里區,0130,372,249,621,69,690,1276,54.08%,29.15%,1
新北市,八里區,0131,430,291,721,69,790,1349,58.56%,31.88%,1
新北市,八里區,0132,421,295,716,73,789,1403,56.24%,30.01%,1
新北市,八里區,0133,471,336,807,83,890,1644,54.14%,28.65%,1
新北市,八里區,0134,539,380,919,68,987,1853,53.26%,29.09%,1
新北市,八里區,0135,568,382,950,90,1040,1793,58%,31.68%,1
新北市,八里區,0136,446,357,803,80,883,1644,53.71%,27.13%,1
新北市,八里區,0137,486,400,886,77,963,1846,52.17%,26.33%,1
新北市,八里區,0138,375,267,642,77,719,1346,53.42%,27.86%,1
新北市,八里區,0139,471,334,805,68,873,1621,53.86%,29.06%,1
新北市,八里區,0140,528,325,853,86,939,2110,44.5%,25.02%,1
新北市,八里區,0141,522,382,904,98,1002,1967,50.94%,26.54%,1
新北市,八里區,0142,478,338,816,82,898,1626,55.23%,29.4%,1
新北市,八里區,0143,447,305,752,81,833,1514,55.02%,29.52%,1
新北市,八里區,0144,449,271,720,114,834,1456,57.28%,30.84%,1
新北市,平溪區,2208,88,68,156,31,187,384,48.7%,22.92%,1
新北市,平溪區,2209,59,34,93,2,95,232,40.95%,25.43%,1
新北市,平溪區,2210,74,53,127,13,140,249,56.22%,29.72%,1
新北市,平溪區,2211,128,67,195,57,252,458,55.02%,27.95%,1
新北市,平溪區,2212,49,50,99,28,127,232,54.74%,21.12%,1
新北市,平溪區,2213,145,88,233,27,260,635,40.94%,22.83%,1
新北市,平溪區,2214,111,89,200,37,237,427,55.5%,26%,1
新北市,平溪區,2215,173,129,302,54,356,862,41.3%,20.07%,1
新北市,平溪區,2216,41,28,69,4,73,147,49.66%,27.89%,1
新北市,平溪區,2217,82,37,119,18,137,365,37.53%,22.47%,1
新北市,平溪區,2218,23,34,57,7,64,153,41.83%,15.03%,1
新北市,平溪區,2219,61,33,94,15,109,177,61.58%,34.46%,1
新北市,雙溪區,2266,116,70,186,30,216,455,47.47%,25.49%,1
新北市,雙溪區,2267,75,54,129,19,148,286,51.75%,26.22%,1
新北市,雙溪區,2268,152,94,246,31,277,496,55.85%,30.65%,1
新北市,雙溪區,2269,87,61,148,14,162,383,42.3%,22.72%,1
新北市,雙溪區,2270,207,120,327,50,377,887,42.5%,23.34%,1
新北市,雙溪區,2271,156,100,256,20,276,652,42.33%,23.93%,1
新北市,雙溪區,2272,100,56,156,15,171,333,51.35%,30.03%,1
新北市,雙溪區,2273,168,113,281,37,318,642,49.53%,26.17%,1
新北市,雙溪區,2274,72,50,122,13,135,282,47.87%,25.53%,1
新北市,雙溪區,2275,148,100,248,21,269,621,43.32%,23.83%,1
新北市,雙溪區,2276,98,61,159,10,169,422,40.05%,23.22%,1
新北市,雙溪區,2277,60,43,103,31,134,369,36.31%,16.26%,1
新北市,雙溪區,2278,30,25,55,10,65,120,54.17%,25%,1
新北市,雙溪區,2279,73,41,114,22,136,271,50.18%,26.94%,1
新北市,雙溪區,2280,98,85,183,30,213,362,58.84%,27.07%,1
新北市,雙溪區,2281,98,72,170,25,195,371,52.56%,26.42%,1
新北市,雙溪區,2282,329,212,541,72,613,1047,58.55%,31.42%,1
新北市,貢寮區,2283,217,183,400,52,452,876,51.6%,24.77%,1
新北市,貢寮區,2284,117,76,193,27,220,433,50.81%,27.02%,1
新北市,貢寮區,2285,127,73,200,11,211,516,40.89%,24.61%,1
新北市,貢寮區,2286,70,56,126,27,153,373,41.02%,18.77%,1
新北市,貢寮區,2287,56,61,117,38,155,313,49.52%,17.89%,1
新北市,貢寮區,2288,135,102,237,13,250,485,51.55%,27.84%,1
新北市,貢寮區,2289,91,110,201,13,214,415,51.57%,21.93%,1
新北市,貢寮區,2290,168,182,350,17,367,812,45.2%,20.69%,1
新北市,貢寮區,2291,160,211,371,47,418,861,48.55%,18.58%,1
新北市,貢寮區,2292,115,176,291,18,309,676,45.71%,17.01%,1
新北市,貢寮區,2293,183,251,434,31,465,1091,42.62%,16.77%,1
新北市,貢寮區,2294,174,189,363,47,410,955,42.93%,18.22%,1
新北市,貢寮區,2295,148,174,322,15,337,769,43.82%,19.25%,1
新北市,貢寮區,2296,238,209,447,29,476,962,49.48%,24.74%,1
新北市,貢寮區,2297,105,100,205,9,214,390,54.87%,26.92%,1
新北市,貢寮區,2298,75,83,158,8,166,349,47.56%,21.49%,1
新北市,貢寮區,2299,81,84,165,36,201,508,39.57%,15.94%,1
新北市,貢寮區,2300,87,64,151,16,167,495,33.74%,17.58%,1
新北市,金山區,2301,141,94,235,27,262,481,54.47%,29.31%,1
新北市,金山區,2302,192,151,343,36,379,715,53.01%,26.85%,1
新北市,金山區,2303,114,72,186,28,214,481,44.49%,23.7%,1
新北市,金山區,2304,441,307,748,81,829,1792,46.26%,24.61%,1
新北市,金山區,2305,448,373,821,92,913,1781,51.26%,25.15%,1
新北市,金山區,2306,565,435,1000,76,1076,2010,53.53%,28.11%,1
新北市,金山區,2307,427,289,716,67,783,1572,49.81%,27.16%,1
新北市,金山區,2308,436,375,811,101,912,1777,51.32%,24.54%,1
新北市,金山區,2309,427,292,719,55,774,1631,47.46%,26.18%,1
新北市,金山區,2310,224,174,398,36,434,828,52.42%,27.05%,1
新北市,金山區,2311,225,188,413,40,453,888,51.01%,25.34%,1
新北市,金山區,2312,311,234,545,64,609,1211,50.29%,25.68%,1
新北市,金山區,2313,109,106,215,25,240,416,57.69%,26.2%,1
新北市,金山區,2314,211,135,346,53,399,682,58.5%,30.94%,1
新北市,金山區,2315,149,141,290,59,349,644,54.19%,23.14%,1
新北市,金山區,2316,210,151,361,48,409,830,49.28%,25.3%,1
新北市,金山區,2317,44,43,87,12,99,188,52.66%,23.4%,1
新北市,金山區,2318,116,114,230,29,259,469,55.22%,24.73%,1
新北市,金山區,2319,110,72,182,31,213,582,36.6%,18.9%,1
新北市,萬里區,2320,378,244,622,74,696,1286,54.12%,29.39%,1
新北市,萬里區,2321,455,335,790,68,858,1576,54.44%,28.87%,1
新北市,萬里區,2322,368,257,625,65,690,1447,47.68%,25.43%,1
新北市,萬里區,2323,335,251,586,87,673,1466,45.91%,22.85%,1
新北市,萬里區,2324,309,211,520,75,595,1369,43.46%,22.57%,1
新北市,萬里區,2325,250,161,411,64,475,1215,39.09%,20.58%,1
新北市,萬里區,2326,363,236,599,95,694,1317,52.7%,27.56%,1
新北市,萬里區,2327,342,310,652,76,728,1676,43.44%,20.41%,1
新北市,萬里區,2328,383,273,656,84,740,1550,47.74%,24.71%,1
新北市,萬里區,2329,307,221,528,62,590,945,62.43%,32.49%,1
新北市,萬里區,2330,506,377,883,76,959,1760,54.49%,28.75%,1
新北市,萬里區,2331,164,97,261,27,288,570,50.53%,28.77%,1
新北市,萬里區,2332,233,175,408,44,452,952,47.48%,24.47%,1
新北市,萬里區,2333,186,131,317,79,396,674,58.75%,27.6%,1
新北市,萬里區,2334,97,91,188,23,211,405,52.1%,23.95%,1
新北市,萬里區,2335,265,208,473,77,550,1089,50.51%,24.33%,1
新北市,烏來區,2202,531,314,845,87,932,1568,59.44%,33.86%,1
新北市,烏來區,2203,340,217,557,31,588,1198,49.08%,28.38%,1
新北市,烏來區,2204,309,206,515,45,560,1169,47.9%,26.43%,1
新北市,烏來區,2205,77,38,115,4,119,228,52.19%,33.77%,1
新北市,烏來區,2206,135,88,223,47,270,486,55.56%,27.78%,1
新北市,烏來區,2207,148,95,243,30,273,615,44.39%,24.07%,1
桃園市,桃園區,0001,419,327,746,65,811,1593,50.91%,26.3%,1
桃園市,桃園區,0002,454,355,809,38,847,1934,43.8%,23.47%,1
桃園市,桃園區,0003,499,337,836,78,914,1661,55.03%,30.04%,1
桃園市,桃園區,0004,392,246,638,32,670,1448,46.27%,27.07%,1
桃園市,桃園區,0005,499,386,885,64,949,1974,48.07%,25.28%,1
桃園市,桃園區,0006,468,309,777,90,867,1882,46.07%,24.87%,1
桃園市,桃園區,0007,497,336,833,51,884,1800,49.11%,27.61%,1
桃園市,桃園區,0008,506,301,807,66,873,1598,54.63%,31.66%,1
桃園市,桃園區,0009,492,285,777,94,871,1626,53.57%,30.26%,1
桃園市,桃園區,0010,420,294,714,64,778,1590,48.93%,26.42%,1
桃園市,桃園區,0011,446,304,750,81,831,1637,50.76%,27.24%,1
桃園市,桃園區,0012,510,377,887,66,953,1943,49.05%,26.25%,1
桃園市,桃園區,0013,409,307,716,64,780,1482,52.63%,27.6%,1
桃園市,桃園區,0014,398,330,728,50,778,1423,54.67%,27.97%,1
桃園市,桃園區,0015,514,262,776,56,832,1509,55.14%,34.06%,1
桃園市,桃園區,0016,527,284,811,38,849,1567,54.18%,33.63%,1
桃園市,桃園區,0017,423,241,664,45,709,1305,54.33%,32.41%,1
桃園市,桃園區,0018,367,268,635,48,683,1416,48.23%,25.92%,1
桃園市,桃園區,0019,458,300,758,53,811,1439,56.36%,31.83%,1
桃園市,桃園區,0020,385,333,718,64,782,1399,55.9%,27.52%,1
桃園市,桃園區,0021,483,320,803,57,860,1540,55.84%,31.36%,1
桃園市,桃園區,0022,475,274,749,55,804,1638,49.08%,29%,1
桃園市,桃園區,0023,312,305,617,48,665,1228,54.15%,25.41%,1
桃園市,桃園區,0024,409,294,703,125,828,1649,50.21%,24.8%,1
桃園市,桃園區,0025,476,310,786,50,836,1601,52.22%,29.73%,1
桃園市,桃園區,0026,399,251,650,100,750,1477,50.78%,27.01%,1
桃園市,桃園區,0027,469,272,741,50,791,1503,52.63%,31.2%,1
桃園市,桃園區,0028,415,296,711,80,791,1375,57.53%,30.18%,1
桃園市,桃園區,0029,503,376,879,58,937,1743,53.76%,28.86%,1
桃園市,桃園區,0030,501,324,825,84,909,1862,48.82%,26.91%,1
桃園市,桃園區,0031,504,333,837,67,904,1728,52.31%,29.17%,1
桃園市,桃園區,0032,193,149,342,20,362,690,52.46%,27.97%,1
桃園市,桃園區,0033,250,226,476,39,515,852,60.45%,29.34%,1
桃園市,桃園區,0034,435,282,717,67,784,1353,57.95%,32.15%,1
桃園市,桃園區,0035,345,256,601,39,640,1698,37.69%,20.32%,1
桃園市,桃園區,0036,411,271,682,66,748,1452,51.52%,28.31%,1
桃園市,桃園區,0037,465,329,794,77,871,1681,51.81%,27.66%,1
桃園市,桃園區,0038,460,326,786,69,855,1669,51.23%,27.56%,1
桃園市,桃園區,0039,454,341,795,71,866,1530,56.6%,29.67%,1
桃園市,桃園區,0040,462,323,785,71,856,1582,54.11%,29.2%,1
桃園市,桃園區,0041,426,293,719,48,767,1587,48.33%,26.84%,1
桃園市,桃園區,0042,407,313,720,81,801,1451,55.2%,28.05%,1
桃園市,桃園區,0043,381,285,666,54,720,1582,45.51%,24.08%,1
桃園市,桃園區,0044,316,213,529,54,583,1028,56.71%,30.74%,1
桃園市,桃園區,0045,535,371,906,65,971,1934,50.21%,27.66%,1
桃園市,桃園區,0046,290,197,487,65,552,1016,54.33%,28.54%,1
桃園市,桃園區,0047,312,231,543,42,585,1079,54.22%,28.92%,1
桃園市,桃園區,0048,517,323,840,48,888,1837,48.34%,28.14%,1
桃園市,桃園區,0049,369,295,664,61,725,1390,52.16%,26.55%,1
桃園市,桃園區,0050,439,300,739,52,791,1489,53.12%,29.48%,1
桃園市,桃園區,0051,605,376,981,32,1013,1821,55.63%,33.22%,1
桃園市,桃園區,0052,427,281,708,29,737,1563,47.15%,27.32%,1
桃園市,桃園區,0053,519,350,869,47,916,1697,53.98%,30.58%,1
桃園市,桃園區,0054,549,338,887,53,940,1740,54.02%,31.55%,1
桃園市,桃園區,0055,494,300,794,60,854,1626,52.52%,30.38%,1
桃園市,桃園區,0056,395,245,640,37,677,1239,54.64%,31.88%,1
桃園市,桃園區,0057,603,316,919,27,946,1766,53.57%,34.14%,1
桃園市,桃園區,0058,443,318,761,69,830,1555,53.38%,28.49%,1
桃園市,桃園區,0059,555,355,910,56,966,1831,52.76%,30.31%,1
桃園市,桃園區,0060,334,278,612,53,665,1115,59.64%,29.96%,1
桃園市,桃園區,0061,440,362,802,60,862,1562,55.19%,28.17%,1
桃園市,桃園區,0062,516,332,848,48,896,1744,51.38%,29.59%,1
桃園市,桃園區,0063,480,327,807,55,862,1838,46.9%,26.12%,1
桃園市,桃園區,0064,544,381,925,94,1019,1889,53.94%,28.8%,1
桃園市,桃園區,0065,507,342,849,90,939,1985,47.3%,25.54%,1
桃園市,桃園區,0066,516,309,825,51,876,1524,57.48%,33.86%,1
桃園市,桃園區,0067,503,321,824,50,874,1425,61.33%,35.3%,1
桃園市,桃園區,0068,519,345,864,58,922,1606,57.41%,32.32%,1
桃園市,桃園區,0069,688,410,1098,43,1141,2056,55.5%,33.46%,1
桃園市,桃園區,0070,694,366,1060,54,1114,2010,55.42%,34.53%,1
桃園市,桃園區,0071,657,383,1040,67,1107,2245,49.31%,29.27%,1
桃園市,桃園區,0072,453,333,786,60,846,1590,53.21%,28.49%,1
桃園市,桃園區,0073,551,329,880,37,917,1536,59.7%,35.87%,1
桃園市,桃園區,0074,500,377,877,66,943,1949,48.38%,25.65%,1
桃園市,桃園區,0075,561,348,909,62,971,1965,49.41%,28.55%,1
桃園市,桃園區,0076,645,375,1020,65,1085,2414,44.95%,26.72%,1
桃園市,桃園區,0077,565,369,934,64,998,1942,51.39%,29.09%,1
桃園市,桃園區,0078,642,394,1036,73,1109,2156,51.44%,29.78%,1
桃園市,桃園區,0079,441,286,727,65,792,1404,56.41%,31.41%,1
桃園市,桃園區,0080,416,253,669,39,708,1194,59.3%,34.84%,1
桃園市,桃園區,0081,414,337,751,82,833,1449,57.49%,28.57%,1
桃園市,桃園區,0082,503,289,792,81,873,1803,48.42%,27.9%,1
桃園市,桃園區,0083,470,349,819,77,896,1692,52.96%,27.78%,1
桃園市,桃園區,0084,563,356,919,75,994,1913,51.96%,29.43%,1
桃園市,桃園區,0085,517,350,867,75,942,1815,51.9%,28.48%,1
桃園市,桃園區,0086,305,223,528,59,587,1173,50.04%,26%,1
桃園市,桃園區,0087,314,211,525,38,563,1162,48.45%,27.02%,1
桃園市,桃園區,0088,275,187,462,93,555,1194,46.48%,23.03%,1
桃園市,桃園區,0089,499,330,829,74,903,1695,53.27%,29.44%,1
桃園市,桃園區,0090,527,326,853,51,904,1797,50.31%,29.33%,1
桃園市,桃園區,0091,494,282,776,42,818,1592,51.38%,31.03%,1
桃園市,桃園區,0092,519,301,820,77,897,1780,50.39%,29.16%,1
桃園市,桃園區,0093,498,322,820,54,874,1904,45.9%,26.16%,1
桃園市,桃園區,0094,592,343,935,44,979,2021,48.44%,29.29%,1
桃園市,桃園區,0095,447,291,738,58,796,1545,51.52%,28.93%,1
桃園市,桃園區,0096,441,295,736,40,776,1617,47.99%,27.27%,1
桃園市,桃園區,0097,663,150,813,43,856,1683,50.86%,39.39%,1
桃園市,桃園區,0098,574,356,930,69,999,1834,54.47%,31.3%,1
桃園市,桃園區,0099,523,373,896,67,963,2055,46.86%,25.45%,1
桃園市,桃園區,0100,516,334,850,39,889,1828,48.63%,28.23%,1
桃園市,桃園區,0101,512,360,872,46,918,1873,49.01%,27.34%,1
桃園市,桃園區,0102,432,284,716,45,761,3687,20.64%,11.72%,1
桃園市,桃園區,0103,515,367,882,53,935,1850,50.54%,27.84%,1
桃園市,桃園區,0104,551,308,859,66,925,1827,50.63%,30.16%,1
桃園市,桃園區,0105,373,253,626,63,689,1149,59.97%,32.46%,1
桃園市,桃園區,0106,332,242,574,43,617,1061,58.15%,31.29%,1
桃園市,桃園區,0107,508,309,817,42,859,1831,46.91%,27.74%,1
桃園市,桃園區,0108,606,408,1014,68,1082,2168,49.91%,27.95%,1
桃園市,桃園區,0109,503,370,873,46,919,1874,49.04%,26.84%,1
桃園市,桃園區,0110,420,251,671,35,706,1524,46.33%,27.56%,1
桃園市,桃園區,0111,492,288,780,32,812,1528,53.14%,32.2%,1
桃園市,桃園區,0112,425,321,746,54,800,1489,53.73%,28.54%,1
桃園市,桃園區,0113,353,264,617,70,687,1308,52.52%,26.99%,1
桃園市,桃園區,0114,423,309,732,71,803,1583,50.73%,26.72%,1
桃園市,桃園區,0115,428,388,816,63,879,1618,54.33%,26.45%,1
桃園市,桃園區,0116,547,395,942,96,1038,2127,48.8%,25.72%,1
桃園市,桃園區,0117,636,306,942,41,983,2033,48.35%,31.28%,1
桃園市,桃園區,0118,632,368,1000,57,1057,2098,50.38%,30.12%,1
桃園市,桃園區,0119,641,417,1058,84,1142,2126,53.72%,30.15%,1
桃園市,桃園區,0120,565,328,893,53,946,1917,49.35%,29.47%,1
桃園市,桃園區,0121,547,378,925,51,976,1997,48.87%,27.39%,1
桃園市,桃園區,0122,571,363,934,53,987,1929,51.17%,29.6%,1
桃園市,桃園區,0123,503,320,823,34,857,1691,50.68%,29.75%,1
桃園市,桃園區,0124,473,347,820,39,859,1900,45.21%,24.89%,1
桃園市,桃園區,0125,508,341,849,87,936,1761,53.15%,28.85%,1
桃園市,桃園區,0126,565,342,907,46,953,1922,49.58%,29.4%,1
桃園市,桃園區,0127,520,162,682,94,776,1995,38.9%,26.07%,1
桃園市,桃園區,0128,304,228,532,51,583,1063,54.84%,28.6%,1
桃園市,桃園區,0129,430,239,669,63,732,1412,51.84%,30.45%,1
桃園市,桃園區,0130,433,356,789,45,834,1746,47.77%,24.8%,1
桃園市,桃園區,0131,420,329,749,63,812,1689,48.08%,24.87%,1
桃園市,桃園區,0132,388,235,623,39,662,1542,42.93%,25.16%,1
桃園市,桃園區,0133,389,272,661,63,724,1437,50.38%,27.07%,1
桃園市,桃園區,0134,448,326,774,59,833,1679,49.61%,26.68%,1
桃園市,桃園區,0135,464,338,802,76,878,1886,46.55%,24.6%,1
桃園市,桃園區,0136,472,323,795,92,887,1657,53.53%,28.49%,1
桃園市,桃園區,0137,393,307,700,30,730,1349,54.11%,29.13%,1
桃園市,桃園區,0138,551,338,889,53,942,1805,52.19%,30.53%,1
桃園市,桃園區,0139,410,456,866,64,930,1846,50.38%,22.21%,1
桃園市,桃園區,0140,540,192,732,50,782,1644,47.57%,32.85%,1
桃園市,桃園區,0141,446,297,743,62,805,1674,48.09%,26.64%,1
桃園市,桃園區,0142,491,333,824,59,883,1737,50.83%,28.27%,1
桃園市,桃園區,0143,472,297,769,68,837,1566,53.45%,30.14%,1
桃園市,桃園區,0144,454,303,757,52,809,1517,53.33%,29.93%,1
桃園市,桃園區,0145,434,267,701,48,749,1619,46.26%,26.81%,1
桃園市,桃園區,0146,494,353,847,57,904,1774,50.96%,27.85%,1
桃園市,桃園區,0147,511,314,825,46,871,1666,52.28%,30.67%,1
桃園市,桃園區,0148,447,320,767,31,798,1528,52.23%,29.25%,1
桃園市,桃園區,0149,461,341,802,64,866,1709,50.67%,26.97%,1
桃園市,桃園區,0150,502,336,838,25,863,1719,50.2%,29.2%,1
桃園市,桃園區,0151,399,257,656,70,726,1569,46.27%,25.43%,1
桃園市,桃園區,0152,436,255,691,51,742,1505,49.3%,28.97%,1
桃園市,桃園區,0153,391,311,702,57,759,1496,50.74%,26.14%,1
桃園市,桃園區,0154,469,268,737,68,805,1505,53.49%,31.16%,1
桃園市,桃園區,0155,537,328,865,57,922,1807,51.02%,29.72%,1
桃園市,桃園區,0156,530,364,894,55,949,1857,51.1%,28.54%,1
桃園市,桃園區,0157,483,330,813,80,893,1589,56.2%,30.4%,1
桃園市,桃園區,0158,580,413,993,56,1049,2088,50.24%,27.78%,1
桃園市,桃園區,0159,575,334,909,47,956,1893,50.5%,30.38%,1
桃園市,桃園區,0160,324,225,549,16,565,1303,43.36%,24.87%,1
桃園市,桃園區,0161,431,276,707,48,755,1416,53.32%,30.44%,1
桃園市,桃園區,0162,359,256,615,49,664,1351,49.15%,26.57%,1
桃園市,桃園區,0163,452,305,757,53,810,1659,48.82%,27.25%,1
桃園市,桃園區,0164,624,336,960,59,1019,2103,48.45%,29.67%,1
桃園市,桃園區,0165,578,322,900,57,957,1943,49.25%,29.75%,1
桃園市,桃園區,0166,589,340,929,49,978,1927,50.75%,30.57%,1
桃園市,桃園區,0167,501,312,813,64,877,1929,45.46%,25.97%,1
桃園市,桃園區,0168,702,462,1164,64,1228,2204,55.72%,31.85%,1
桃園市,桃園區,0169,547,337,884,47,931,2033,45.79%,26.91%,1
桃園市,桃園區,0170,499,304,803,39,842,1656,50.85%,30.13%,1
桃園市,桃園區,0171,428,373,801,55,856,1712,50%,25%,1
桃園市,桃園區,0172,469,340,809,65,874,1738,50.29%,26.99%,1
桃園市,桃園區,0173,496,317,813,36,849,1432,59.29%,34.64%,1
桃園市,桃園區,0174,299,302,601,47,648,1421,45.6%,21.04%,1
桃園市,桃園區,0175,391,280,671,28,699,1344,52.01%,29.09%,1
桃園市,桃園區,0176,520,336,856,48,904,1942,46.55%,26.78%,1
桃園市,桃園區,0177,591,360,951,50,1001,2001,50.02%,29.54%,1
桃園市,桃園區,0178,518,320,838,34,872,1941,44.93%,26.69%,1
桃園市,桃園區,0179,505,356,861,39,900,1702,52.88%,29.67%,1
桃園市,桃園區,0180,448,310,758,64,822,1589,51.73%,28.19%,1
桃園市,桃園區,0181,459,269,728,50,778,1544,50.39%,29.73%,1
桃園市,桃園區,0182,447,283,730,58,788,1860,42.37%,24.03%,1
桃園市,桃園區,0183,485,317,802,66,868,1726,50.29%,28.1%,1
桃園市,桃園區,0184,462,347,809,60,869,1798,48.33%,25.7%,1
桃園市,桃園區,0185,577,344,921,52,973,1925,50.55%,29.97%,1
桃園市,桃園區,0186,551,344,895,68,963,1945,49.51%,28.33%,1
桃園市,桃園區,0187,429,336,765,63,828,1764,46.94%,24.32%,1
桃園市,桃園區,0188,649,300,949,83,1032,1899,54.34%,34.18%,1
桃園市,桃園區,0189,404,287,691,30,721,1415,50.95%,28.55%,1
桃園市,桃園區,0190,501,203,704,50,754,1790,42.12%,27.99%,1
桃園市,桃園區,0191,465,306,771,37,808,1693,47.73%,27.47%,1
桃園市,桃園區,0192,513,353,866,59,925,1916,48.28%,26.77%,1
桃園市,桃園區,0193,397,234,631,40,671,1434,46.79%,27.68%,1
桃園市,桃園區,0194,436,360,796,51,847,1494,56.69%,29.18%,1
桃園市,桃園區,0195,369,283,652,69,721,1311,55%,28.15%,1
桃園市,桃園區,0196,421,308,729,44,773,1476,52.37%,28.52%,1
桃園市,桃園區,0197,433,332,765,63,828,1484,55.8%,29.18%,1
桃園市,桃園區,0198,427,285,712,52,764,1514,50.46%,28.2%,1
桃園市,桃園區,0199,396,274,670,85,755,1446,52.21%,27.39%,1
桃園市,桃園區,0200,419,297,716,28,744,1573,47.3%,26.64%,1
桃園市,桃園區,0201,428,255,683,40,723,1564,46.23%,27.37%,1
桃園市,桃園區,0202,309,218,527,46,573,1015,56.45%,30.44%,1
桃園市,桃園區,0203,227,219,446,40,486,955,50.89%,23.77%,1
桃園市,桃園區,0204,507,346,853,48,901,1796,50.17%,28.23%,1
桃園市,桃園區,0205,520,348,868,39,907,1878,48.3%,27.69%,1
桃園市,桃園區,0206,465,326,791,54,845,1729,48.87%,26.89%,1
桃園市,桃園區,0207,474,306,780,48,828,1843,44.93%,25.72%,1
桃園市,桃園區,0208,466,275,741,44,785,1817,43.2%,25.65%,1
桃園市,桃園區,0209,285,222,507,46,553,979,56.49%,29.11%,1
桃園市,桃園區,0210,431,266,697,28,725,1363,53.19%,31.62%,1
桃園市,桃園區,0211,477,263,740,28,768,1546,49.68%,30.85%,1
桃園市,桃園區,0212,376,244,620,37,657,1308,50.23%,28.75%,1
桃園市,桃園區,0213,611,386,997,72,1069,2164,49.4%,28.23%,1
桃園市,桃園區,0214,543,371,914,60,974,2020,48.22%,26.88%,1
桃園市,桃園區,0215,502,305,807,49,856,1924,44.49%,26.09%,1
桃園市,桃園區,0216,539,312,851,50,901,2088,43.15%,25.81%,1
桃園市,中壢區,0591,445,250,695,47,742,1401,52.96%,31.76%,1
桃園市,中壢區,0592,498,340,838,70,908,1798,50.5%,27.7%,1
桃園市,中壢區,0593,467,259,726,57,783,1642,47.69%,28.44%,1
桃園市,中壢區,0594,503,296,799,86,885,1670,52.99%,30.12%,1
桃園市,中壢區,0595,462,304,766,30,796,1456,54.67%,31.73%,1
桃園市,中壢區,0596,530,320,850,61,911,1531,59.5%,34.62%,1
桃園市,中壢區,0597,551,325,876,51,927,1623,57.12%,33.95%,1
桃園市,中壢區,0598,548,304,852,39,891,1953,45.62%,28.06%,1
桃園市,中壢區,0599,352,263,615,42,657,1155,56.88%,30.48%,1
桃園市,中壢區,0600,494,296,790,51,841,1800,46.72%,27.44%,1
桃園市,中壢區,0601,535,270,805,48,853,1757,48.55%,30.45%,1
桃園市,中壢區,0602,445,237,682,70,752,1281,58.7%,34.74%,1
桃園市,中壢區,0603,468,305,773,48,821,1462,56.16%,32.01%,1
桃園市,中壢區,0604,480,227,707,56,763,1560,48.91%,30.77%,1
桃園市,中壢區,0605,555,325,880,41,921,1602,57.49%,34.64%,1
桃園市,中壢區,0606,359,243,602,43,645,1006,64.12%,35.69%,1
桃園市,中壢區,0607,488,286,774,43,817,1474,55.43%,33.11%,1
桃園市,中壢區,0608,487,282,769,118,887,1627,54.52%,29.93%,1
桃園市,中壢區,0609,484,329,813,46,859,1519,56.55%,31.86%,1
桃園市,中壢區,0610,595,272,867,82,949,1526,62.19%,38.99%,1
桃園市,中壢區,0611,536,239,775,98,873,1618,53.96%,33.13%,1
桃園市,中壢區,0612,544,277,821,85,906,1554,58.3%,35.01%,1
桃園市,中壢區,0613,571,276,847,78,925,1706,54.22%,33.47%,1
桃園市,中壢區,0614,642,322,964,66,1030,1818,56.66%,35.31%,1
桃園市,中壢區,0615,588,340,928,56,984,1991,49.42%,29.53%,1
桃園市,中壢區,0616,568,231,799,48,847,1609,52.64%,35.3%,1
桃園市,中壢區,0617,403,213,616,21,637,1329,47.93%,30.32%,1
桃園市,中壢區,0618,440,234,674,117,791,1587,49.84%,27.73%,1
桃園市,中壢區,0619,598,346,944,42,986,1955,50.43%,30.59%,1
桃園市,中壢區,0620,470,331,801,82,883,1711,51.61%,27.47%,1
桃園市,中壢區,0621,500,303,803,68,871,1712,50.88%,29.21%,1
桃園市,中壢區,0622,506,276,782,50,832,1448,57.46%,34.94%,1
桃園市,中壢區,0623,462,297,759,60,819,1605,51.03%,28.79%,1
桃園市,中壢區,0624,464,270,734,21,755,1633,46.23%,28.41%,1
桃園市,中壢區,0625,556,389,945,74,1019,1795,56.77%,30.97%,1
桃園市,中壢區,0626,555,320,875,40,915,1689,54.17%,32.86%,1
桃園市,中壢區,0627,359,258,617,53,670,1201,55.79%,29.89%,1
桃園市,中壢區,0628,402,265,667,46,713,1353,52.7%,29.71%,1
桃園市,中壢區,0629,430,300,730,62,792,1587,49.91%,27.1%,1
桃園市,中壢區,0630,616,321,937,63,1000,1883,53.11%,32.71%,1
桃園市,中壢區,0631,428,281,709,38,747,1448,51.59%,29.56%,1
桃園市,中壢區,0632,570,329,899,49,948,1810,52.38%,31.49%,1
桃園市,中壢區,0633,568,330,898,84,982,1916,51.25%,29.65%,1
桃園市,中壢區,0634,398,228,626,48,674,1177,57.26%,33.81%,1
桃園市,中壢區,0635,475,299,774,62,836,1410,59.29%,33.69%,1
桃園市,中壢區,0636,403,271,674,42,716,1368,52.34%,29.46%,1
桃園市,中壢區,0637,508,283,791,61,852,1424,59.83%,35.67%,1
桃園市,中壢區,0638,485,335,820,56,876,1573,55.69%,30.83%,1
桃園市,中壢區,0639,391,228,619,21,640,1152,55.56%,33.94%,1
桃園市,中壢區,0640,371,250,621,28,649,1178,55.09%,31.49%,1
桃園市,中壢區,0641,615,359,974,78,1052,1966,53.51%,31.28%,1
桃園市,中壢區,0642,405,268,673,40,713,3474,20.52%,11.66%,1
桃園市,中壢區,0643,615,434,1049,78,1127,2099,53.69%,29.3%,1
桃園市,中壢區,0644,392,203,595,54,649,1178,55.09%,33.28%,1
桃園市,中壢區,0645,480,312,792,63,855,1397,61.2%,34.36%,1
桃園市,中壢區,0646,535,337,872,54,926,1669,55.48%,32.06%,1
桃園市,中壢區,0647,566,365,931,92,1023,2087,49.02%,27.12%,1
桃園市,中壢區,0648,541,376,917,63,980,1900,51.58%,28.47%,1
桃園市,中壢區,0649,400,276,676,36,712,1640,43.41%,24.39%,1
桃園市,中壢區,0650,363,192,555,40,595,994,59.86%,36.52%,1
桃園市,中壢區,0651,432,236,668,61,729,1131,64.46%,38.2%,1
桃園市,中壢區,0652,564,339,903,48,951,1625,58.52%,34.71%,1
桃園市,中壢區,0653,453,359,812,47,859,1384,62.07%,32.73%,1
桃園市,中壢區,0654,501,295,796,55,851,1588,53.59%,31.55%,1
桃園市,中壢區,0655,462,274,736,49,785,1445,54.33%,31.97%,1
桃園市,中壢區,0656,451,280,731,65,796,1743,45.67%,25.87%,1
桃園市,中壢區,0657,483,338,821,36,857,1812,47.3%,26.66%,1
桃園市,中壢區,0658,437,289,726,66,792,1546,51.23%,28.27%,1
桃園市,中壢區,0659,404,231,635,54,689,1290,53.41%,31.32%,1
桃園市,中壢區,0660,641,299,940,101,1041,2145,48.53%,29.88%,1
桃園市,中壢區,0661,405,267,672,47,719,1451,49.55%,27.91%,1
桃園市,中壢區,0662,477,261,738,43,781,1489,52.45%,32.03%,1
桃園市,中壢區,0663,268,161,429,31,460,827,55.62%,32.41%,1
桃園市,中壢區,0664,407,297,704,46,750,1442,52.01%,28.22%,1
桃園市,中壢區,0665,509,306,815,35,850,1842,46.15%,27.63%,1
桃園市,中壢區,0666,436,228,664,43,707,1520,46.51%,28.68%,1
桃園市,中壢區,0667,472,292,764,52,816,1764,46.26%,26.76%,1
桃園市,中壢區,0668,472,318,790,34,824,1488,55.38%,31.72%,1
桃園市,中壢區,0669,476,295,771,74,845,1593,53.04%,29.88%,1
桃園市,中壢區,0670,438,318,756,46,802,1505,53.29%,29.1%,1
桃園市,中壢區,0671,528,294,822,39,861,1661,51.84%,31.79%,1
桃園市,中壢區,0672,518,249,767,52,819,1492,54.89%,34.72%,1
桃園市,中壢區,0673,322,256,578,39,617,1249,49.4%,25.78%,1
桃園市,中壢區,0674,406,247,653,47,700,1257,55.69%,32.3%,1
桃園市,中壢區,0675,500,280,780,82,862,1659,51.96%,30.14%,1
桃園市,中壢區,0676,649,299,948,49,997,1815,54.93%,35.76%,1
桃園市,中壢區,0677,488,317,805,53,858,1702,50.41%,28.67%,1
桃園市,中壢區,0678,467,311,778,29,807,1541,52.37%,30.3%,1
桃園市,中壢區,0679,488,268,756,64,820,1659,49.43%,29.42%,1
桃園市,中壢區,0680,570,288,858,109,967,1874,51.6%,30.42%,1
桃園市,中壢區,0681,448,299,747,54,801,1603,49.97%,27.95%,1
桃園市,中壢區,0682,543,292,835,45,880,1735,50.72%,31.3%,1
桃園市,中壢區,0683,589,310,899,28,927,1815,51.07%,32.45%,1
桃園市,中壢區,0684,553,329,882,41,923,1873,49.28%,29.52%,1
桃園市,中壢區,0685,598,293,891,79,970,1739,55.78%,34.39%,1
桃園市,中壢區,0686,513,275,788,58,846,1709,49.5%,30.02%,1
桃園市,中壢區,0687,535,323,858,55,913,1655,55.17%,32.33%,1
桃園市,中壢區,0688,521,325,846,49,895,1664,53.79%,31.31%,1
桃園市,中壢區,0689,305,195,500,33,533,1087,49.03%,28.06%,1
桃園市,中壢區,0690,308,223,531,61,592,1065,55.59%,28.92%,1
桃園市,中壢區,0691,519,379,898,97,995,1844,53.96%,28.15%,1
桃園市,中壢區,0692,331,188,519,62,581,1220,47.62%,27.13%,1
桃園市,中壢區,0693,356,249,605,49,654,1219,53.65%,29.2%,1
桃園市,中壢區,0694,351,288,639,59,698,1260,55.4%,27.86%,1
桃園市,中壢區,0695,515,336,851,75,926,1594,58.09%,32.31%,1
桃園市,中壢區,0696,489,369,858,79,937,1733,54.07%,28.22%,1
桃園市,中壢區,0697,638,329,967,73,1040,1979,52.55%,32.24%,1
桃園市,中壢區,0698,473,334,807,43,850,1621,52.44%,29.18%,1
桃園市,中壢區,0699,429,299,728,52,780,1391,56.07%,30.84%,1
桃園市,中壢區,0700,495,312,807,38,845,1531,55.19%,32.33%,1
桃園市,中壢區,0701,520,348,868,60,928,1943,47.76%,26.76%,1
桃園市,中壢區,0702,428,245,673,40,713,1363,52.31%,31.4%,1
桃園市,中壢區,0703,555,365,920,63,983,2172,45.26%,25.55%,1
桃園市,中壢區,0704,550,280,830,49,879,1798,48.89%,30.59%,1
桃園市,中壢區,0705,486,305,791,32,823,1671,49.25%,29.08%,1
桃園市,中壢區,0706,553,346,899,75,974,1969,49.47%,28.09%,1
桃園市,中壢區,0707,557,368,925,65,990,1563,63.34%,35.64%,1
桃園市,中壢區,0708,552,363,915,59,974,1762,55.28%,31.33%,1
桃園市,中壢區,0709,496,267,763,53,816,1923,42.43%,25.79%,1
桃園市,中壢區,0710,502,308,810,88,898,1572,57.12%,31.93%,1
桃園市,中壢區,0711,564,393,957,60,1017,1850,54.97%,30.49%,1
桃園市,中壢區,0712,449,300,749,71,820,1583,51.8%,28.36%,1
桃園市,中壢區,0713,490,344,834,56,890,1735,51.3%,28.24%,1
桃園市,中壢區,0714,368,292,660,23,683,1292,52.86%,28.48%,1
桃園市,中壢區,0715,398,248,646,27,673,1265,53.2%,31.46%,1
桃園市,中壢區,0716,534,320,854,58,912,1798,50.72%,29.7%,1
桃園市,中壢區,0717,579,385,964,76,1040,1822,57.08%,31.78%,1
桃園市,中壢區,0718,492,322,814,35,849,1613,52.63%,30.5%,1
桃園市,中壢區,0719,419,293,712,45,757,1405,53.88%,29.82%,1
桃園市,中壢區,0720,516,380,896,81,977,1730,56.47%,29.83%,1
桃園市,中壢區,0721,484,321,805,45,850,1384,61.42%,34.97%,1
桃園市,中壢區,0722,373,234,607,23,630,1122,56.15%,33.24%,1
桃園市,中壢區,0723,308,240,548,58,606,992,61.09%,31.05%,1
桃園市,中壢區,0724,520,354,874,56,930,1820,51.1%,28.57%,1
桃園市,中壢區,0725,551,302,853,81,934,1847,50.57%,29.83%,1
桃園市,中壢區,0726,425,271,696,64,760,1302,58.37%,32.64%,1
桃園市,中壢區,0727,359,250,609,77,686,1203,57.02%,29.84%,1
桃園市,中壢區,0728,413,308,721,66,787,1226,64.19%,33.69%,1
桃園市,中壢區,0729,414,260,674,47,721,1234,58.43%,33.55%,1
桃園市,中壢區,0730,583,303,886,63,949,2023,46.91%,28.82%,1
桃園市,中壢區,0731,429,281,710,32,742,1555,47.72%,27.59%,1
桃園市,中壢區,0732,561,348,909,73,982,1951,50.33%,28.75%,1
桃園市,中壢區,0733,517,209,726,51,777,1383,56.18%,37.38%,1
桃園市,中壢區,0734,363,276,639,65,704,1164,60.48%,31.19%,1
桃園市,中壢區,0735,494,271,765,54,819,1482,55.26%,33.33%,1
桃園市,中壢區,0736,522,361,883,60,943,1770,53.28%,29.49%,1
桃園市,中壢區,0737,549,350,899,90,989,1703,58.07%,32.24%,1
桃園市,中壢區,0738,589,319,908,62,970,1841,52.69%,31.99%,1
桃園市,中壢區,0739,659,351,1010,51,1061,1941,54.66%,33.95%,1
桃園市,中壢區,0740,703,357,1060,52,1112,2029,54.81%,34.65%,1
桃園市,中壢區,0741,534,315,849,61,910,1636,55.62%,32.64%,1
桃園市,中壢區,0742,496,319,815,56,871,1528,57%,32.46%,1
桃園市,中壢區,0743,614,386,1000,101,1101,2289,48.1%,26.82%,1
桃園市,中壢區,0744,562,371,933,57,990,2020,49.01%,27.82%,1
桃園市,中壢區,0745,613,382,995,77,1072,2027,52.89%,30.24%,1
桃園市,中壢區,0746,486,308,794,41,835,1883,44.34%,25.81%,1
桃園市,中壢區,0747,612,345,957,71,1028,2080,49.42%,29.42%,1
桃園市,中壢區,0748,176,137,313,18,331,646,51.24%,27.24%,1
桃園市,中壢區,0749,642,408,1050,72,1122,1780,63.03%,36.07%,1
桃園市,中壢區,0750,461,282,743,35,778,1372,56.71%,33.6%,1
桃園市,中壢區,0751,527,373,900,55,955,1668,57.25%,31.59%,1
桃園市,中壢區,0752,567,375,942,51,993,1987,49.97%,28.54%,1
桃園市,中壢區,0753,443,334,777,33,810,1520,53.29%,29.14%,1
桃園市,中壢區,0754,238,189,427,41,468,852,54.93%,27.93%,1
桃園市,中壢區,0755,387,234,621,43,664,1209,54.92%,32.01%,1
桃園市,中壢區,0756,455,259,714,85,799,1481,53.95%,30.72%,1
桃園市,中壢區,0757,450,270,720,27,747,1564,47.76%,28.77%,1
桃園市,中壢區,0758,595,383,978,78,1056,1957,53.96%,30.4%,1
桃園市,中壢區,0759,376,291,667,75,742,1223,60.67%,30.74%,1
桃園市,中壢區,0760,342,278,620,57,677,1182,57.28%,28.93%,1
桃園市,中壢區,0761,303,267,570,53,623,1066,58.44%,28.42%,1
桃園市,中壢區,0762,525,375,900,64,964,1701,56.67%,30.86%,1
桃園市,中壢區,0763,285,171,456,46,502,943,53.23%,30.22%,1
桃園市,中壢區,0764,232,181,413,31,444,731,60.74%,31.74%,1
桃園市,中壢區,0765,234,178,412,80,492,851,57.81%,27.5%,1
桃園市,中壢區,0766,300,201,501,55,556,1011,55%,29.67%,1
桃園市,中壢區,0767,473,313,786,57,843,1532,55.03%,30.87%,1
桃園市,中壢區,0768,300,216,516,43,559,1028,54.38%,29.18%,1
桃園市,中壢區,0769,351,258,609,58,667,1157,57.65%,30.34%,1
桃園市,中壢區,0770,453,311,764,73,837,1591,52.61%,28.47%,1
桃園市,中壢區,0771,639,332,971,57,1028,2156,47.68%,29.64%,1
桃園市,中壢區,0772,390,267,657,39,696,1479,47.06%,26.37%,1
桃園市,中壢區,0773,584,305,889,45,934,1780,52.47%,32.81%,1
桃園市,中壢區,0774,485,343,828,65,893,1651,54.09%,29.38%,1
桃園市,中壢區,0775,615,335,950,56,1006,1870,53.8%,32.89%,1
桃園市,中壢區,0776,514,312,826,43,869,1913,45.43%,26.87%,1
桃園市,中壢區,0777,442,260,702,50,752,1609,46.74%,27.47%,1
桃園市,中壢區,0778,412,308,720,44,764,1539,49.64%,26.77%,1
桃園市,中壢區,0779,404,300,704,52,756,1426,53.02%,28.33%,1
桃園市,中壢區,0780,437,299,736,47,783,1618,48.39%,27.01%,1
桃園市,中壢區,0781,453,271,724,60,784,1441,54.41%,31.44%,1
桃園市,中壢區,0782,515,289,804,47,851,1528,55.69%,33.7%,1
桃園市,中壢區,0783,458,356,814,76,890,1683,52.88%,27.21%,1
桃園市,中壢區,0784,625,349,974,100,1074,1945,55.22%,32.13%,1
桃園市,中壢區,0785,420,316,736,68,804,1534,52.41%,27.38%,1
桃園市,中壢區,0786,535,301,836,81,917,1810,50.66%,29.56%,1
桃園市,中壢區,0787,312,189,501,61,562,1097,51.23%,28.44%,1
桃園市,中壢區,0788,544,356,900,39,939,1917,48.98%,28.38%,1
桃園市,中壢區,0789,541,342,883,69,952,1858,51.24%,29.12%,1
桃園市,中壢區,0790,298,536,834,39,873,1576,55.39%,18.91%,1
桃園市,中壢區,0791,450,303,753,64,817,1478,55.28%,30.45%,1
桃園市,中壢區,0792,478,314,792,50,842,1589,52.99%,30.08%,1
桃園市,中壢區,0793,598,390,988,126,1114,2037,54.69%,29.36%,1
桃園市,中壢區,0794,405,236,641,56,697,1158,60.19%,34.97%,1
桃園市,中壢區,0795,553,406,959,92,1051,1967,53.43%,28.11%,1
桃園市,中壢區,0796,508,330,838,86,924,1830,50.49%,27.76%,1
桃園市,中壢區,0797,480,378,858,56,914,1856,49.25%,25.86%,1
桃園市,中壢區,0798,541,418,959,67,1026,2068,49.61%,26.16%,1
桃園市,中壢區,0799,499,324,823,68,891,2152,41.4%,23.19%,1
桃園市,中壢區,0800,527,400,927,70,997,2158,46.2%,24.42%,1
桃園市,大溪區,0522,395,347,742,87,829,1477,56.13%,26.74%,1
桃園市,大溪區,0523,288,214,502,52,554,1006,55.07%,28.63%,1
桃園市,大溪區,0524,418,298,716,103,819,1553,52.74%,26.92%,1
桃園市,大溪區,0525,459,328,787,86,873,1597,54.66%,28.74%,1
桃園市,大溪區,0526,370,278,648,80,728,1358,53.61%,27.25%,1
桃園市,大溪區,0527,384,294,678,76,754,1585,47.57%,24.23%,1
桃園市,大溪區,0528,458,320,778,59,837,1612,51.92%,28.41%,1
桃園市,大溪區,0529,415,241,656,53,709,1555,45.59%,26.69%,1
桃園市,大溪區,0530,377,325,702,70,772,1282,60.22%,29.41%,1
桃園市,大溪區,0531,383,248,631,102,733,1392,52.66%,27.51%,1
桃園市,大溪區,0532,390,226,616,102,718,1422,50.49%,27.43%,1
桃園市,大溪區,0533,390,303,693,93,786,1448,54.28%,26.93%,1
桃園市,大溪區,0534,418,276,694,82,776,1269,61.15%,32.94%,1
桃園市,大溪區,0535,273,252,525,68,593,977,60.7%,27.94%,1
桃園市,大溪區,0536,382,315,697,61,758,1359,55.78%,28.11%,1
桃園市,大溪區,0537,345,251,596,93,689,1135,60.7%,30.4%,1
桃園市,大溪區,0538,154,120,274,79,353,660,53.48%,23.33%,1
桃園市,大溪區,0539,267,215,482,41,523,1056,49.53%,25.28%,1
桃園市,大溪區,0540,348,233,581,68,649,1263,51.39%,27.55%,1
桃園市,大溪區,0541,188,156,344,53,397,717,55.37%,26.22%,1
桃園市,大溪區,0542,294,228,522,26,548,1299,42.19%,22.63%,1
桃園市,大溪區,0543,304,167,471,71,542,976,55.53%,31.15%,1
桃園市,大溪區,0544,261,193,454,52,506,938,53.94%,27.83%,1
桃園市,大溪區,0545,196,179,375,40,415,832,49.88%,23.56%,1
桃園市,大溪區,0546,209,148,357,29,386,866,44.57%,24.13%,1
桃園市,大溪區,0547,156,144,300,35,335,694,48.27%,22.48%,1
桃園市,大溪區,0548,345,275,620,60,680,1410,48.23%,24.47%,1
桃園市,大溪區,0549,346,215,561,86,647,1303,49.65%,26.55%,1
桃園市,大溪區,0550,338,209,547,46,593,1125,52.71%,30.04%,1
桃園市,大溪區,0551,354,244,598,43,641,1170,54.79%,30.26%,1
桃園市,大溪區,0552,434,265,699,62,761,1308,58.18%,33.18%,1
桃園市,大溪區,0553,321,218,539,80,619,1094,56.58%,29.34%,1
桃園市,大溪區,0554,654,401,1055,93,1148,2153,53.32%,30.38%,1
桃園市,大溪區,0555,438,192,630,53,683,1173,58.23%,37.34%,1
桃園市,大溪區,0556,409,246,655,53,708,1369,51.72%,29.88%,1
桃園市,大溪區,0557,416,255,671,73,744,1446,51.45%,28.77%,1
桃園市,大溪區,0558,368,185,553,74,627,1406,44.59%,26.17%,1
桃園市,大溪區,0559,498,322,820,41,861,1592,54.08%,31.28%,1
桃園市,大溪區,0560,427,343,770,84,854,1497,57.05%,28.52%,1
桃園市,大溪區,0561,449,332,781,102,883,1559,56.64%,28.8%,1
桃園市,大溪區,0562,485,320,805,35,840,1684,49.88%,28.8%,1
桃園市,大溪區,0563,554,373,927,150,1077,1959,54.98%,28.28%,1
桃園市,大溪區,0564,420,274,694,79,773,1369,56.46%,30.68%,1
桃園市,大溪區,0565,422,300,722,71,793,1431,55.42%,29.49%,1
桃園市,大溪區,0566,343,264,607,45,652,1657,39.35%,20.7%,1
桃園市,大溪區,0567,344,214,558,38,596,1387,42.97%,24.8%,1
桃園市,大溪區,0568,311,204,515,53,568,1085,52.35%,28.66%,1
桃園市,大溪區,0569,431,302,733,61,794,1403,56.59%,30.72%,1
桃園市,大溪區,0570,397,287,684,100,784,1511,51.89%,26.27%,1
桃園市,大溪區,0571,400,316,716,81,797,1719,46.36%,23.27%,1
桃園市,大溪區,0572,384,286,670,121,791,1717,46.07%,22.36%,1
桃園市,大溪區,0573,319,204,523,124,647,1207,53.6%,26.43%,1
桃園市,大溪區,0574,356,239,595,78,673,1188,56.65%,29.97%,1
桃園市,大溪區,0575,403,266,669,38,707,1514,46.7%,26.62%,1
桃園市,大溪區,0576,484,278,762,94,856,1529,55.98%,31.65%,1
桃園市,大溪區,0577,423,270,693,49,742,1260,58.89%,33.57%,1
桃園市,大溪區,0578,266,183,449,24,473,831,56.92%,32.01%,1
桃園市,大溪區,0579,458,248,706,73,779,1407,55.37%,32.55%,1
桃園市,大溪區,0580,394,245,639,91,730,1494,48.86%,26.37%,1
桃園市,楊梅區,0926,400,245,645,66,711,1269,56.03%,31.52%,1
桃園市,楊梅區,0927,422,283,705,67,772,1246,61.96%,33.87%,1
桃園市,楊梅區,0928,491,268,759,62,821,1408,58.31%,34.87%,1
桃園市,楊梅區,0929,455,281,736,64,800,1434,55.79%,31.73%,1
桃園市,楊梅區,0930,463,256,719,60,779,1515,51.42%,30.56%,1
桃園市,楊梅區,0931,473,257,730,72,802,1657,48.4%,28.55%,1
桃園市,楊梅區,0932,397,201,598,56,654,1137,57.52%,34.92%,1
桃園市,楊梅區,0933,665,385,1050,48,1098,2211,49.66%,30.08%,1
桃園市,楊梅區,0934,602,358,960,37,997,2008,49.65%,29.98%,1
桃園市,楊梅區,0935,591,366,957,42,999,1911,52.28%,30.93%,1
桃園市,楊梅區,0936,433,304,737,75,812,1449,56.04%,29.88%,1
桃園市,楊梅區,0937,480,313,793,72,865,1877,46.08%,25.57%,1
桃園市,楊梅區,0938,542,360,902,53,955,1988,48.04%,27.26%,1
桃園市,楊梅區,0939,598,254,852,49,901,1931,46.66%,30.97%,1
桃園市,楊梅區,0940,563,321,884,68,952,1938,49.12%,29.05%,1
桃園市,楊梅區,0941,552,291,843,36,879,1677,52.42%,32.92%,1
桃園市,楊梅區,0942,536,357,893,36,929,1848,50.27%,29%,1
桃園市,楊梅區,0943,555,341,896,52,948,1882,50.37%,29.49%,1
桃園市,楊梅區,0944,331,242,573,30,603,1541,39.13%,21.48%,1
桃園市,楊梅區,0945,563,320,883,57,940,1938,48.5%,29.05%,1
桃園市,楊梅區,0946,422,254,676,23,699,1562,44.75%,27.02%,1
桃園市,楊梅區,0947,705,429,1134,50,1184,2125,55.72%,33.18%,1
桃園市,楊梅區,0948,493,332,825,64,889,1516,58.64%,32.52%,1
桃園市,楊梅區,0949,528,325,853,39,892,1807,49.36%,29.22%,1
桃園市,楊梅區,0950,582,350,932,65,997,2101,47.45%,27.7%,1
桃園市,楊梅區,0951,622,372,994,81,1075,2054,52.34%,30.28%,1
桃園市,楊梅區,0952,628,361,989,38,1027,2226,46.14%,28.21%,1
桃園市,楊梅區,0953,460,267,727,22,749,1405,53.31%,32.74%,1
桃園市,楊梅區,0954,515,311,826,47,873,1843,47.37%,27.94%,1
桃園市,楊梅區,0955,596,371,967,69,1036,2324,44.58%,25.65%,1
桃園市,楊梅區,0956,528,316,844,41,885,1713,51.66%,30.82%,1
桃園市,楊梅區,0957,560,304,864,71,935,1587,58.92%,35.29%,1
桃園市,楊梅區,0958,454,292,746,48,794,1416,56.07%,32.06%,1
桃園市,楊梅區,0959,512,310,822,47,869,1591,54.62%,32.18%,1
桃園市,楊梅區,0960,572,358,930,76,1006,1943,51.78%,29.44%,1
桃園市,楊梅區,0961,552,333,885,44,929,1762,52.72%,31.33%,1
桃園市,楊梅區,0962,322,205,527,46,573,1083,52.91%,29.73%,1
桃園市,楊梅區,0963,622,344,966,80,1046,2027,51.6%,30.69%,1
桃園市,楊梅區,0964,402,266,668,63,731,1274,57.38%,31.55%,1
桃園市,楊梅區,0965,464,243,707,77,784,1359,57.69%,34.14%,1
桃園市,楊梅區,0966,510,295,805,62,867,2444,35.47%,20.87%,1
桃園市,楊梅區,0967,612,331,943,30,973,2298,42.34%,26.63%,1
桃園市,楊梅區,0968,700,333,1033,57,1090,2222,49.05%,31.5%,1
桃園市,楊梅區,0969,449,318,767,83,850,1610,52.8%,27.89%,1
桃園市,楊梅區,0970,468,300,768,97,865,1627,53.17%,28.76%,1
桃園市,楊梅區,0971,511,302,813,59,872,1589,54.88%,32.16%,1
桃園市,楊梅區,0972,511,331,842,92,934,1758,53.13%,29.07%,1
桃園市,楊梅區,0973,400,295,695,78,773,1776,43.52%,22.52%,1
桃園市,楊梅區,0974,277,175,452,29,481,1000,48.1%,27.7%,1
桃園市,楊梅區,0975,617,328,945,100,1045,2290,45.63%,26.94%,1
桃園市,楊梅區,0976,426,314,740,84,824,1551,53.13%,27.47%,1
桃園市,楊梅區,0977,522,294,816,100,916,1861,49.22%,28.05%,1
桃園市,楊梅區,0978,279,188,467,69,536,1141,46.98%,24.45%,1
桃園市,楊梅區,0979,522,283,805,60,865,1785,48.46%,29.24%,1
桃園市,楊梅區,0980,418,287,705,93,798,1498,53.27%,27.9%,1
桃園市,楊梅區,0981,310,228,538,85,623,1187,52.49%,26.12%,1
桃園市,楊梅區,0982,378,269,647,62,709,1270,55.83%,29.76%,1
桃園市,楊梅區,0983,422,273,695,53,748,1424,52.53%,29.63%,1
桃園市,楊梅區,0984,458,85,543,30,573,1273,45.01%,35.98%,1
桃園市,楊梅區,0985,394,253,647,49,696,1534,45.37%,25.68%,1
桃園市,楊梅區,0986,415,303,718,88,806,1783,45.2%,23.28%,1
桃園市,楊梅區,0987,495,281,776,37,813,1709,47.57%,28.96%,1
桃園市,楊梅區,0988,453,337,790,93,883,1920,45.99%,23.59%,1
桃園市,楊梅區,0989,338,245,583,46,629,1194,52.68%,28.31%,1
桃園市,楊梅區,0990,455,265,720,27,747,1408,53.05%,32.32%,1
桃園市,楊梅區,0991,467,256,723,50,773,1737,44.5%,26.89%,1
桃園市,楊梅區,0992,588,305,893,47,940,1920,48.96%,30.63%,1
桃園市,楊梅區,0993,354,234,588,52,640,1234,51.86%,28.69%,1
桃園市,楊梅區,0994,448,294,742,87,829,1491,55.6%,30.05%,1
桃園市,楊梅區,0995,530,537,1067,59,1126,2020,55.74%,26.24%,1
桃園市,楊梅區,0996,504,306,810,41,851,1863,45.68%,27.05%,1
桃園市,楊梅區,0997,480,349,829,71,900,1692,53.19%,28.37%,1
桃園市,楊梅區,0998,508,305,813,39,852,1686,50.53%,30.13%,1
桃園市,楊梅區,0999,477,289,766,117,883,1626,54.31%,29.34%,1
桃園市,楊梅區,1000,523,282,805,42,847,1557,54.4%,33.59%,1
桃園市,楊梅區,1001,597,268,865,64,929,1603,57.95%,37.24%,1
桃園市,楊梅區,1002,477,300,777,152,929,1889,49.18%,25.25%,1
桃園市,楊梅區,1003,467,201,668,44,712,1448,49.17%,32.25%,1
桃園市,楊梅區,1004,462,238,700,64,764,1351,56.55%,34.2%,1
桃園市,楊梅區,1005,436,270,706,61,767,1313,58.42%,33.21%,1
桃園市,楊梅區,1006,476,340,816,60,876,1689,51.87%,28.18%,1
桃園市,楊梅區,1007,533,400,933,40,973,2063,47.16%,25.84%,1
桃園市,蘆竹區,0396,315,233,548,145,693,1358,51.03%,23.2%,1
桃園市,蘆竹區,0397,369,307,676,97,773,1538,50.26%,23.99%,1
桃園市,蘆竹區,0398,466,348,814,97,911,2118,43.01%,22%,1
桃園市,蘆竹區,0399,501,349,850,79,929,1673,55.53%,29.95%,1
桃園市,蘆竹區,0400,453,290,743,42,785,1500,52.33%,30.2%,1
桃園市,蘆竹區,0401,493,352,845,61,906,1699,53.33%,29.02%,1
桃園市,蘆竹區,0402,657,418,1075,70,1145,2250,50.89%,29.2%,1
桃園市,蘆竹區,0403,595,415,1010,39,1049,2354,44.56%,25.28%,1
桃園市,蘆竹區,0404,343,270,613,30,643,1446,44.47%,23.72%,1
桃園市,蘆竹區,0405,382,289,671,83,754,1623,46.46%,23.54%,1
桃園市,蘆竹區,0406,511,269,780,50,830,1747,47.51%,29.25%,1
桃園市,蘆竹區,0407,557,387,944,78,1022,1988,51.41%,28.02%,1
桃園市,蘆竹區,0408,394,297,691,63,754,1437,52.47%,27.42%,1
桃園市,蘆竹區,0409,410,344,754,88,842,1532,54.96%,26.76%,1
桃園市,蘆竹區,0410,404,252,656,41,697,1447,48.17%,27.92%,1
桃園市,蘆竹區,0411,627,386,1013,72,1085,2189,49.57%,28.64%,1
桃園市,蘆竹區,0412,691,405,1096,71,1167,2498,46.72%,27.66%,1
桃園市,蘆竹區,0413,371,296,667,40,707,1322,53.48%,28.06%,1
桃園市,蘆竹區,0414,424,331,755,95,850,1991,42.69%,21.3%,1
桃園市,蘆竹區,0415,529,352,881,107,988,2097,47.11%,25.23%,1
桃園市,蘆竹區,0416,447,329,776,73,849,1558,54.49%,28.69%,1
桃園市,蘆竹區,0417,556,366,922,69,991,1891,52.41%,29.4%,1
桃園市,蘆竹區,0418,434,284,718,55,773,1590,48.62%,27.3%,1
桃園市,蘆竹區,0419,587,408,995,77,1072,2404,44.59%,24.42%,1
桃園市,蘆竹區,0420,750,438,1188,57,1245,2522,49.37%,29.74%,1
桃園市,蘆竹區,0421,373,434,807,37,844,1633,51.68%,22.84%,1
桃園市,蘆竹區,0422,473,344,817,64,881,1715,51.37%,27.58%,1
桃園市,蘆竹區,0423,546,421,967,43,1010,2215,45.6%,24.65%,1
桃園市,蘆竹區,0424,536,393,929,55,984,2029,48.5%,26.42%,1
桃園市,蘆竹區,0425,462,331,793,49,842,1731,48.64%,26.69%,1
桃園市,蘆竹區,0426,542,336,878,46,924,1820,50.77%,29.78%,1
桃園市,蘆竹區,0427,493,321,814,64,878,1633,53.77%,30.19%,1
桃園市,蘆竹區,0428,423,267,690,36,726,1668,43.53%,25.36%,1
桃園市,蘆竹區,0429,464,304,768,41,809,1493,54.19%,31.08%,1
桃園市,蘆竹區,0430,536,365,901,66,967,1864,51.88%,28.76%,1
桃園市,蘆竹區,0431,419,341,760,39,799,1703,46.92%,24.6%,1
桃園市,蘆竹區,0432,482,367,849,63,912,1893,48.18%,25.46%,1
桃園市,蘆竹區,0433,571,400,971,86,1057,1922,54.99%,29.71%,1
桃園市,蘆竹區,0434,416,285,701,38,739,1393,53.05%,29.86%,1
桃園市,蘆竹區,0435,386,296,682,52,734,1338,54.86%,28.85%,1
桃園市,蘆竹區,0436,454,341,795,62,857,1688,50.77%,26.9%,1
桃園市,蘆竹區,0437,363,307,670,84,754,1462,51.57%,24.83%,1
桃園市,蘆竹區,0438,313,260,573,44,617,1232,50.08%,25.41%,1
桃園市,蘆竹區,0439,367,233,600,45,645,1356,47.57%,27.06%,1
桃園市,蘆竹區,0440,378,277,655,61,716,1181,60.63%,32.01%,1
桃園市,蘆竹區,0441,365,210,575,33,608,1199,50.71%,30.44%,1
桃園市,蘆竹區,0442,543,329,872,35,907,1710,53.04%,31.75%,1
桃園市,蘆竹區,0443,388,264,652,56,708,1423,49.75%,27.27%,1
桃園市,蘆竹區,0444,467,302,769,48,817,1522,53.68%,30.68%,1
桃園市,蘆竹區,0445,499,336,835,39,874,1639,53.33%,30.45%,1
桃園市,蘆竹區,0446,586,386,972,59,1031,2055,50.17%,28.52%,1
桃園市,蘆竹區,0447,713,427,1140,45,1185,2178,54.41%,32.74%,1
桃園市,蘆竹區,0448,565,309,874,42,916,1709,53.6%,33.06%,1
桃園市,蘆竹區,0449,545,320,865,53,918,1667,55.07%,32.69%,1
桃園市,蘆竹區,0450,522,361,883,54,937,1745,53.7%,29.91%,1
桃園市,蘆竹區,0451,702,300,1002,75,1077,1967,54.75%,35.69%,1
桃園市,蘆竹區,0452,598,359,957,34,991,1802,54.99%,33.19%,1
桃園市,蘆竹區,0453,733,524,1257,58,1315,2727,48.22%,26.88%,1
桃園市,蘆竹區,0454,484,342,826,47,873,1868,46.73%,25.91%,1
桃園市,蘆竹區,0455,405,310,715,64,779,1537,50.68%,26.35%,1
桃園市,蘆竹區,0456,458,337,795,46,841,1616,52.04%,28.34%,1
桃園市,蘆竹區,0457,473,329,802,53,855,1483,57.65%,31.89%,1
桃園市,蘆竹區,0458,459,323,782,64,846,1689,50.09%,27.18%,1
桃園市,蘆竹區,0459,306,202,508,54,562,1318,42.64%,23.22%,1
桃園市,蘆竹區,0460,361,282,643,118,761,1203,63.26%,30.01%,1
桃園市,蘆竹區,0461,449,313,762,42,804,1771,45.4%,25.35%,1
桃園市,蘆竹區,0462,396,342,738,119,857,1832,46.78%,21.62%,1
桃園市,蘆竹區,0463,420,341,761,129,890,1763,50.48%,23.82%,1
桃園市,蘆竹區,0464,297,263,560,30,590,1497,39.41%,19.84%,1
桃園市,蘆竹區,0465,498,325,823,161,984,1671,58.89%,29.8%,1
桃園市,蘆竹區,0466,273,171,444,90,534,929,57.48%,29.39%,1
桃園市,蘆竹區,0467,398,348,746,121,867,1559,55.61%,25.53%,1
桃園市,蘆竹區,0468,431,263,694,47,741,1497,49.5%,28.79%,1
桃園市,蘆竹區,0469,458,360,818,94,912,1441,63.29%,31.78%,1
桃園市,蘆竹區,0470,410,247,657,82,739,1465,50.44%,27.99%,1
桃園市,蘆竹區,0471,277,200,477,52,529,1029,51.41%,26.92%,1
桃園市,大園區,0472,370,264,634,71,705,1538,45.84%,24.06%,1
桃園市,大園區,0473,373,234,607,50,657,1616,40.66%,23.08%,1
桃園市,大園區,0474,412,329,741,70,811,1437,56.44%,28.67%,1
桃園市,大園區,0475,446,342,788,51,839,1554,53.99%,28.7%,1
桃園市,大園區,0476,350,235,585,56,641,1237,51.82%,28.29%,1
桃園市,大園區,0477,348,268,616,79,695,1347,51.6%,25.84%,1
桃園市,大園區,0478,330,250,580,38,618,1261,49.01%,26.17%,1
桃園市,大園區,0479,337,246,583,55,638,1256,50.8%,26.83%,1
桃園市,大園區,0480,353,229,582,43,625,1370,45.62%,25.77%,1
桃園市,大園區,0481,390,300,690,55,745,1610,46.27%,24.22%,1
桃園市,大園區,0482,399,265,664,51,715,1419,50.39%,28.12%,1
桃園市,大園區,0483,354,231,585,46,631,1588,39.74%,22.29%,1
桃園市,大園區,0484,466,278,744,66,810,1612,50.25%,28.91%,1
桃園市,大園區,0485,355,299,654,53,707,1440,49.1%,24.65%,1
桃園市,大園區,0486,334,251,585,63,648,1326,48.87%,25.19%,1
桃園市,大園區,0487,472,271,743,73,816,1455,56.08%,32.44%,1
桃園市,大園區,0488,459,308,767,71,838,1562,53.65%,29.39%,1
桃園市,大園區,0489,392,286,678,43,721,1284,56.15%,30.53%,1
桃園市,大園區,0490,391,269,660,33,693,1454,47.66%,26.89%,1
桃園市,大園區,0491,442,288,730,29,759,1490,50.94%,29.66%,1
桃園市,大園區,0492,392,277,669,54,723,1617,44.71%,24.24%,1
桃園市,大園區,0493,400,326,726,99,825,1594,51.76%,25.09%,1
桃園市,大園區,0494,441,330,771,67,838,1650,50.79%,26.73%,1
桃園市,大園區,0495,349,298,647,25,672,1467,45.81%,23.79%,1
桃園市,大園區,0496,401,303,704,42,746,1494,49.93%,26.84%,1
桃園市,大園區,0497,406,300,706,71,777,1538,50.52%,26.4%,1
桃園市,大園區,0498,347,292,639,34,673,1397,48.17%,24.84%,1
桃園市,大園區,0499,406,305,711,43,754,1637,46.06%,24.8%,1
桃園市,大園區,0500,399,235,634,65,699,1452,48.14%,27.48%,1
桃園市,大園區,0501,441,296,737,68,805,1414,56.93%,31.19%,1
桃園市,大園區,0502,461,314,775,62,837,1670,50.12%,27.6%,1
桃園市,大園區,0503,429,296,725,29,754,1701,44.33%,25.22%,1
桃園市,大園區,0504,428,264,692,48,740,1813,40.82%,23.61%,1
桃園市,大園區,0505,421,295,716,60,776,1687,46%,24.96%,1
桃園市,大園區,0506,479,324,803,20,823,1650,49.88%,29.03%,1
桃園市,大園區,0507,498,320,818,59,877,1556,56.36%,32.01%,1
桃園市,大園區,0508,459,314,773,53,826,1844,44.79%,24.89%,1
桃園市,大園區,0509,362,234,596,57,653,1336,48.88%,27.1%,1
桃園市,大園區,0510,435,292,727,60,787,1414,55.66%,30.76%,1
桃園市,大園區,0511,384,276,660,81,741,1238,59.85%,31.02%,1
桃園市,大園區,0512,390,300,690,54,744,1227,60.64%,31.78%,1
桃園市,大園區,0513,309,235,544,47,591,1199,49.29%,25.77%,1
桃園市,大園區,0514,343,238,581,28,609,1349,45.14%,25.43%,1
桃園市,大園區,0515,404,105,509,47,556,1120,49.64%,36.07%,1
桃園市,大園區,0516,305,206,511,39,550,1080,50.93%,28.24%,1
桃園市,大園區,0517,336,253,589,70,659,1341,49.14%,25.06%,1
桃園市,大園區,0518,359,282,641,69,710,1345,52.79%,26.69%,1
桃園市,大園區,0519,375,262,637,60,697,1565,44.54%,23.96%,1
桃園市,大園區,0520,367,253,620,37,657,1519,43.25%,24.16%,1
桃園市,大園區,0521,507,399,906,80,986,2130,46.29%,23.8%,1
桃園市,龜山區,0217,304,150,454,28,482,874,55.15%,34.78%,1
桃園市,龜山區,0218,656,333,989,84,1073,2014,53.28%,32.57%,1
桃園市,龜山區,0219,548,471,1019,27,1046,2145,48.76%,25.55%,1
桃園市,龜山區,0220,583,295,878,73,951,1744,54.53%,33.43%,1
桃園市,龜山區,0221,612,340,952,67,1019,1885,54.06%,32.47%,1
桃園市,龜山區,0222,419,258,677,76,753,1546,48.71%,27.1%,1
桃園市,龜山區,0223,435,315,750,81,831,1684,49.35%,25.83%,1
桃園市,龜山區,0224,358,247,605,66,671,1477,45.43%,24.24%,1
桃園市,龜山區,0225,534,272,806,52,858,1528,56.15%,34.95%,1
桃園市,龜山區,0226,159,113,272,19,291,1428,20.38%,11.13%,1
桃園市,龜山區,0227,461,301,762,78,840,1525,55.08%,30.23%,1
桃園市,龜山區,0228,313,237,550,57,607,1041,58.31%,30.07%,1
桃園市,龜山區,0229,335,314,649,45,694,1404,49.43%,23.86%,1
桃園市,龜山區,0230,445,289,734,80,814,1478,55.07%,30.11%,1
桃園市,龜山區,0231,621,411,1032,83,1115,2178,51.19%,28.51%,1
桃園市,龜山區,0232,475,340,815,80,895,1672,53.53%,28.41%,1
桃園市,龜山區,0233,356,271,627,52,679,1376,49.35%,25.87%,1
桃園市,龜山區,0234,402,278,680,68,748,1480,50.54%,27.16%,1
桃園市,龜山區,0235,378,259,637,48,685,1258,54.45%,30.05%,1
桃園市,龜山區,0236,410,280,690,42,732,1464,50%,28.01%,1
桃園市,龜山區,0237,485,361,846,94,940,1844,50.98%,26.3%,1
桃園市,龜山區,0238,339,244,583,26,609,1169,52.1%,29%,1
桃園市,龜山區,0239,420,275,695,52,747,1921,38.89%,21.86%,1
桃園市,龜山區,0240,459,305,764,30,794,1694,46.87%,27.1%,1
桃園市,龜山區,0241,520,398,918,75,993,1771,56.07%,29.36%,1
桃園市,龜山區,0242,425,289,714,71,785,1665,47.15%,25.53%,1
桃園市,龜山區,0243,361,297,658,80,738,1439,51.29%,25.09%,1
桃園市,龜山區,0244,420,281,701,90,791,1728,45.78%,24.31%,1
桃園市,龜山區,0245,519,331,850,63,913,1788,51.06%,29.03%,1
桃園市,龜山區,0246,378,267,645,51,696,1465,47.51%,25.8%,1
桃園市,龜山區,0247,349,289,638,51,689,1659,41.53%,21.04%,1
桃園市,龜山區,0248,402,270,672,58,730,1693,43.12%,23.74%,1
桃園市,龜山區,0249,392,262,654,35,689,1818,37.9%,21.56%,1
桃園市,龜山區,0250,452,350,802,77,879,1752,50.17%,25.8%,1
桃園市,龜山區,0251,488,368,856,38,894,1818,49.17%,26.84%,1
桃園市,龜山區,0252,375,324,699,34,733,1499,48.9%,25.02%,1
桃園市,龜山區,0253,484,408,892,65,957,1916,49.95%,25.26%,1
桃園市,龜山區,0254,469,368,837,62,899,1804,49.83%,26%,1
桃園市,龜山區,0255,533,425,958,44,1002,2127,47.11%,25.06%,1
桃園市,龜山區,0256,250,211,461,76,537,1005,53.43%,24.88%,1
桃園市,龜山區,0257,418,297,715,53,768,1449,53%,28.85%,1
桃園市,龜山區,0258,383,258,641,80,721,1498,48.13%,25.57%,1
桃園市,龜山區,0259,480,345,825,93,918,2149,42.72%,22.34%,1
桃園市,龜山區,0260,339,238,577,80,657,1771,37.1%,19.14%,1
桃園市,龜山區,0261,231,160,391,37,428,841,50.89%,27.47%,1
桃園市,龜山區,0262,557,400,957,89,1046,2284,45.8%,24.39%,1
桃園市,龜山區,0263,314,251,565,84,649,1228,52.85%,25.57%,1
桃園市,龜山區,0264,504,325,829,71,900,1979,45.48%,25.47%,1
桃園市,龜山區,0265,348,244,592,43,635,1378,46.08%,25.25%,1
桃園市,龜山區,0266,278,200,478,54,532,1061,50.14%,26.2%,1
桃園市,龜山區,0267,614,214,828,77,905,1917,47.21%,32.03%,1
桃園市,龜山區,0268,531,318,849,52,901,1540,58.51%,34.48%,1
桃園市,龜山區,0269,459,270,729,46,775,1433,54.08%,32.03%,1
桃園市,龜山區,0270,396,301,697,37,734,1455,50.45%,27.22%,1
桃園市,龜山區,0271,662,458,1120,98,1218,2280,53.42%,29.04%,1
桃園市,龜山區,0272,468,313,781,62,843,1668,50.54%,28.06%,1
桃園市,龜山區,0273,477,335,812,64,876,1885,46.47%,25.31%,1
桃園市,龜山區,0274,453,404,857,44,901,1849,48.73%,24.5%,1
桃園市,龜山區,0275,512,403,915,33,948,1704,55.63%,30.05%,1
桃園市,龜山區,0276,313,258,571,42,613,1156,53.03%,27.08%,1
桃園市,龜山區,0277,448,362,810,82,892,2114,42.19%,21.19%,1
桃園市,龜山區,0278,243,344,587,49,636,1943,32.73%,12.51%,1
桃園市,龜山區,0279,487,302,789,49,838,1800,46.56%,27.06%,1
桃園市,龜山區,0280,546,360,906,65,971,2020,48.07%,27.03%,1
桃園市,龜山區,0281,372,305,677,50,727,1319,55.12%,28.2%,1
桃園市,龜山區,0282,618,494,1112,65,1177,2229,52.8%,27.73%,1
桃園市,龜山區,0283,537,374,911,31,942,1992,47.29%,26.96%,1
桃園市,龜山區,0284,575,418,993,64,1057,2237,47.25%,25.7%,1
桃園市,龜山區,0285,580,402,982,47,1029,2133,48.24%,27.19%,1
桃園市,龜山區,0286,596,440,1036,71,1107,2187,50.62%,27.25%,1
桃園市,龜山區,0287,534,354,888,66,954,1959,48.7%,27.26%,1
桃園市,龜山區,0288,451,384,835,34,869,1910,45.5%,23.61%,1
桃園市,龜山區,0289,503,361,864,118,982,1840,53.37%,27.34%,1
桃園市,龜山區,0290,576,471,1047,83,1130,2266,49.87%,25.42%,1
桃園市,龜山區,0291,598,400,998,60,1058,2387,44.32%,25.05%,1
桃園市,龜山區,0292,472,290,762,34,796,1692,47.04%,27.9%,1
桃園市,龜山區,0293,265,174,439,25,464,904,51.33%,29.31%,1
桃園市,龜山區,0294,453,288,741,41,782,1469,53.23%,30.84%,1
桃園市,八德區,0295,417,319,736,86,822,1761,46.68%,23.68%,1
桃園市,八德區,0296,418,284,702,27,729,1804,40.41%,23.17%,1
桃園市,八德區,0297,266,213,479,33,512,1813,28.24%,14.67%,1
桃園市,八德區,0298,479,299,778,46,824,1784,46.19%,26.85%,1
桃園市,八德區,0299,541,346,887,55,942,2257,41.74%,23.97%,1
桃園市,八德區,0300,419,284,703,51,754,1857,40.6%,22.56%,1
桃園市,八德區,0301,578,371,949,58,1007,2261,44.54%,25.56%,1
桃園市,八德區,0302,585,329,914,74,988,1903,51.92%,30.74%,1
桃園市,八德區,0303,565,332,897,84,981,1955,50.18%,28.9%,1
桃園市,八德區,0304,393,303,696,29,725,1665,43.54%,23.6%,1
桃園市,八德區,0305,403,298,701,81,782,1431,54.65%,28.16%,1
桃園市,八德區,0306,350,250,600,48,648,1263,51.31%,27.71%,1
桃園市,八德區,0307,477,333,810,86,896,1583,56.6%,30.13%,1
桃園市,八德區,0308,364,273,637,47,684,1246,54.9%,29.21%,1
桃園市,八德區,0309,395,277,672,52,724,1356,53.39%,29.13%,1
桃園市,八德區,0310,501,310,811,93,904,1630,55.46%,30.74%,1
桃園市,八德區,0311,465,252,717,50,767,1586,48.36%,29.32%,1
桃園市,八德區,0312,460,320,780,86,866,1649,52.52%,27.9%,1
桃園市,八德區,0313,486,303,789,101,890,1910,46.6%,25.45%,1
桃園市,八德區,0314,465,333,798,101,899,1612,55.77%,28.85%,1
桃園市,八德區,0315,484,312,796,60,856,1640,52.2%,29.51%,1
桃園市,八德區,0316,351,258,609,70,679,1303,52.11%,26.94%,1
桃園市,八德區,0317,455,282,737,69,806,1413,57.04%,32.2%,1
桃園市,八德區,0318,461,333,794,75,869,1711,50.79%,26.94%,1
桃園市,八德區,0319,414,307,721,115,836,1562,53.52%,26.5%,1
桃園市,八德區,0320,510,291,801,79,880,1735,50.72%,29.39%,1
桃園市,八德區,0321,459,339,798,49,847,1658,51.09%,27.68%,1
桃園市,八德區,0322,343,212,555,65,620,1022,60.67%,33.56%,1
桃園市,八德區,0323,464,244,708,65,773,1673,46.2%,27.73%,1
桃園市,八德區,0324,500,296,796,42,838,1741,48.13%,28.72%,1
桃園市,八德區,0325,549,416,965,88,1053,2110,49.91%,26.02%,1
桃園市,八德區,0326,382,184,566,40,606,1145,52.93%,33.36%,1
桃園市,八德區,0327,372,179,551,45,596,1010,59.01%,36.83%,1
桃園市,八德區,0328,452,319,771,30,801,1848,43.34%,24.46%,1
桃園市,八德區,0329,377,286,663,60,723,1334,54.2%,28.26%,1
桃園市,八德區,0330,325,225,550,32,582,1349,43.14%,24.09%,1
桃園市,八德區,0331,423,293,716,52,768,1341,57.27%,31.54%,1
桃園市,八德區,0332,367,255,622,63,685,1178,58.15%,31.15%,1
桃園市,八德區,0333,424,277,701,48,749,1374,54.51%,30.86%,1
桃園市,八德區,0334,371,284,655,74,729,1462,49.86%,25.38%,1
桃園市,八德區,0335,449,297,746,105,851,1943,43.8%,23.11%,1
桃園市,八德區,0336,405,262,667,97,764,1928,39.63%,21.01%,1
桃園市,八德區,0337,368,254,622,50,672,1403,47.9%,26.23%,1
桃園市,八德區,0338,405,300,705,98,803,1672,48.03%,24.22%,1
桃園市,八德區,0339,499,357,856,45,901,1947,46.28%,25.63%,1
桃園市,八德區,0340,371,234,605,51,656,1200,54.67%,30.92%,1
桃園市,八德區,0341,457,343,800,91,891,1895,47.02%,24.12%,1
桃園市,八德區,0342,546,315,861,97,958,1988,48.19%,27.46%,1
桃園市,八德區,0343,563,364,927,115,1042,2006,51.94%,28.07%,1
桃園市,八德區,0344,502,379,881,9,890,2061,43.18%,24.36%,1
桃園市,八德區,0345,492,392,884,79,963,2108,45.68%,23.34%,1
桃園市,八德區,0346,491,323,814,76,890,1862,47.8%,26.37%,1
桃園市,八德區,0347,463,319,782,35,817,1681,48.6%,27.54%,1
桃園市,八德區,0348,340,268,608,81,689,1317,52.32%,25.82%,1
桃園市,八德區,0349,651,428,1079,86,1165,2093,55.66%,31.1%,1
桃園市,八德區,0350,453,330,783,68,851,1499,56.77%,30.22%,1
桃園市,八德區,0351,502,331,833,74,907,1782,50.9%,28.17%,1
桃園市,八德區,0352,537,311,848,54,902,1763,51.16%,30.46%,1
桃園市,八德區,0353,339,250,589,76,665,1226,54.24%,27.65%,1
桃園市,八德區,0354,406,271,677,44,721,1311,55%,30.97%,1
桃園市,八德區,0355,352,258,610,57,667,1170,57.01%,30.09%,1
桃園市,八德區,0356,414,260,674,44,718,1313,54.68%,31.53%,1
桃園市,八德區,0357,362,246,608,40,648,1186,54.64%,30.52%,1
桃園市,八德區,0358,355,284,639,82,721,1481,48.68%,23.97%,1
桃園市,八德區,0359,575,384,959,65,1024,1998,51.25%,28.78%,1
桃園市,八德區,0360,255,212,467,44,511,916,55.79%,27.84%,1
桃園市,八德區,0361,550,298,848,80,928,1943,47.76%,28.31%,1
桃園市,八德區,0362,571,364,935,56,991,2076,47.74%,27.5%,1
桃園市,八德區,0363,368,272,640,89,729,1363,53.48%,27%,1
桃園市,八德區,0364,413,293,706,81,787,1491,52.78%,27.7%,1
桃園市,八德區,0365,374,296,670,89,759,1474,51.49%,25.37%,1
桃園市,八德區,0366,106,52,158,17,175,718,24.37%,14.76%,1
桃園市,八德區,0367,378,289,667,65,732,1386,52.81%,27.27%,1
桃園市,八德區,0368,432,276,708,79,787,1487,52.93%,29.05%,1
桃園市,八德區,0369,468,234,702,106,808,1552,52.06%,30.15%,1
桃園市,八德區,0370,325,227,552,65,617,1255,49.16%,25.9%,1
桃園市,八德區,0371,447,356,803,82,885,1505,58.8%,29.7%,1
桃園市,八德區,0372,358,259,617,86,703,1436,48.96%,24.93%,1
桃園市,八德區,0373,465,331,796,83,879,1618,54.33%,28.74%,1
桃園市,八德區,0374,468,301,769,89,858,1685,50.92%,27.77%,1
桃園市,八德區,0375,490,289,779,67,846,1835,46.1%,26.7%,1
桃園市,八德區,0376,533,332,865,81,946,1881,50.29%,28.34%,1
桃園市,八德區,0377,441,350,791,46,837,1766,47.4%,24.97%,1
桃園市,八德區,0378,482,329,811,111,922,1817,50.74%,26.53%,1
桃園市,八德區,0379,693,388,1081,46,1127,2198,51.27%,31.53%,1
桃園市,八德區,0380,498,341,839,63,902,1732,52.08%,28.75%,1
桃園市,八德區,0381,691,367,1058,49,1107,2089,52.99%,33.08%,1
桃園市,八德區,0382,371,263,634,44,678,1257,53.94%,29.51%,1
桃園市,八德區,0383,333,256,589,65,654,1267,51.62%,26.28%,1
桃園市,八德區,0384,450,285,735,30,765,1427,53.61%,31.53%,1
桃園市,八德區,0385,558,335,893,78,971,1685,57.63%,33.12%,1
桃園市,八德區,0386,577,297,874,72,946,1748,54.12%,33.01%,1
桃園市,八德區,0387,729,355,1084,61,1145,1650,69.39%,44.18%,1
桃園市,八德區,0388,425,301,726,74,800,1478,54.13%,28.76%,1
桃園市,八德區,0389,484,315,799,69,868,1607,54.01%,30.12%,1
桃園市,八德區,0390,577,353,930,89,1019,1841,55.35%,31.34%,1
桃園市,八德區,0391,586,376,962,102,1064,2082,51.1%,28.15%,1
桃園市,八德區,0392,498,332,830,77,907,1959,46.3%,25.42%,1
桃園市,八德區,0393,627,425,1052,81,1133,2209,51.29%,28.38%,1
桃園市,八德區,0394,573,339,912,66,978,1864,52.47%,30.74%,1
桃園市,八德區,0395,536,352,888,72,960,2000,48%,26.8%,1
桃園市,龍潭區,1008,615,92,707,34,741,1482,50%,41.5%,1
桃園市,龍潭區,1009,427,273,700,72,772,1528,50.52%,27.95%,1
桃園市,龍潭區,1010,448,276,724,50,774,1503,51.5%,29.81%,1
桃園市,龍潭區,1011,446,285,731,63,794,1568,50.64%,28.44%,1
桃園市,龍潭區,1012,348,218,566,65,631,1216,51.89%,28.62%,1
桃園市,龍潭區,1013,533,316,849,100,949,2088,45.45%,25.53%,1
桃園市,龍潭區,1014,635,381,1016,88,1104,1987,55.56%,31.96%,1
桃園市,龍潭區,1015,569,297,866,47,913,1586,57.57%,35.88%,1
桃園市,龍潭區,1016,318,246,564,57,621,1221,50.86%,26.04%,1
桃園市,龍潭區,1017,354,232,586,58,644,1134,56.79%,31.22%,1
桃園市,龍潭區,1018,551,346,897,75,972,2081,46.71%,26.48%,1
桃園市,龍潭區,1019,524,304,828,61,889,1925,46.18%,27.22%,1
桃園市,龍潭區,1020,748,340,1088,58,1146,2095,54.7%,35.7%,1
桃園市,龍潭區,1021,758,337,1095,69,1164,2040,57.06%,37.16%,1
桃園市,龍潭區,1022,483,317,800,80,880,1790,49.16%,26.98%,1
桃園市,龍潭區,1023,519,369,888,129,1017,1872,54.33%,27.72%,1
桃園市,龍潭區,1024,509,351,860,118,978,1726,56.66%,29.49%,1
桃園市,龍潭區,1025,545,334,879,86,965,1792,53.85%,30.41%,1
桃園市,龍潭區,1026,270,416,686,57,743,1398,53.15%,19.31%,1
桃園市,龍潭區,1027,355,259,614,47,661,1345,49.14%,26.39%,1
桃園市,龍潭區,1028,386,328,714,52,766,1409,54.36%,27.4%,1
桃園市,龍潭區,1029,363,254,617,35,652,1362,47.87%,26.65%,1
桃園市,龍潭區,1030,518,357,875,59,934,1650,56.61%,31.39%,1
桃園市,龍潭區,1031,444,317,761,72,833,1597,52.16%,27.8%,1
桃園市,龍潭區,1032,413,283,696,42,738,1410,52.34%,29.29%,1
桃園市,龍潭區,1033,388,259,647,61,708,1275,55.53%,30.43%,1
桃園市,龍潭區,1034,585,435,1020,71,1091,1909,57.15%,30.64%,1
桃園市,龍潭區,1035,676,377,1053,45,1098,2024,54.25%,33.4%,1
桃園市,龍潭區,1036,640,385,1025,53,1078,2002,53.85%,31.97%,1
桃園市,龍潭區,1037,592,341,933,74,1007,1786,56.38%,33.15%,1
桃園市,龍潭區,1038,570,320,890,66,956,1756,54.44%,32.46%,1
桃園市,龍潭區,1039,592,364,956,48,1004,1830,54.86%,32.35%,1
桃園市,龍潭區,1040,605,344,949,47,996,1697,58.69%,35.65%,1
桃園市,龍潭區,1041,519,270,789,55,844,1519,55.56%,34.17%,1
桃園市,龍潭區,1042,567,258,825,61,886,1805,49.09%,31.41%,1
桃園市,龍潭區,1043,680,86,766,47,813,1792,45.37%,37.95%,1
桃園市,龍潭區,1044,494,315,809,68,877,1500,58.47%,32.93%,1
桃園市,龍潭區,1045,415,228,643,47,690,1427,48.35%,29.08%,1
桃園市,龍潭區,1046,381,225,606,46,652,1444,45.15%,26.39%,1
桃園市,龍潭區,1047,378,215,593,79,672,1321,50.87%,28.61%,1
桃園市,龍潭區,1048,412,264,676,51,727,1215,59.84%,33.91%,1
桃園市,龍潭區,1049,375,242,617,78,695,1297,53.59%,28.91%,1
桃園市,龍潭區,1050,416,241,657,25,682,1407,48.47%,29.57%,1
桃園市,龍潭區,1051,413,294,707,69,776,1564,49.62%,26.41%,1
桃園市,龍潭區,1052,366,262,628,72,700,1317,53.15%,27.79%,1
桃園市,龍潭區,1053,268,184,452,56,508,1023,49.66%,26.2%,1
桃園市,龍潭區,1054,539,314,853,69,922,1721,53.57%,31.32%,1
桃園市,龍潭區,1055,620,283,903,72,975,1764,55.27%,35.15%,1
桃園市,龍潭區,1056,438,285,723,84,807,1499,53.84%,29.22%,1
桃園市,龍潭區,1057,623,325,948,59,1007,2151,46.82%,28.96%,1
桃園市,龍潭區,1058,526,304,830,27,857,1524,56.23%,34.51%,1
桃園市,龍潭區,1059,581,263,844,29,873,1456,59.96%,39.9%,1
桃園市,龍潭區,1060,767,300,1067,52,1119,1847,60.58%,41.53%,1
桃園市,龍潭區,1061,747,355,1102,33,1135,1899,59.77%,39.34%,1
桃園市,龍潭區,1062,583,312,895,42,937,1725,54.32%,33.8%,1
桃園市,龍潭區,1063,612,338,950,64,1014,1665,60.9%,36.76%,1
桃園市,龍潭區,1064,492,271,763,55,818,1649,49.61%,29.84%,1
桃園市,龍潭區,1065,396,252,648,90,738,1539,47.95%,25.73%,1
桃園市,龍潭區,1066,515,300,815,68,883,1541,57.3%,33.42%,1
桃園市,龍潭區,1067,419,276,695,58,753,1375,54.76%,30.47%,1
桃園市,龍潭區,1068,446,294,740,46,786,1453,54.09%,30.7%,1
桃園市,龍潭區,1069,326,223,549,61,610,1074,56.8%,30.35%,1
桃園市,龍潭區,1070,474,265,739,28,767,1299,59.05%,36.49%,1
桃園市,龍潭區,1071,139,154,293,26,319,678,47.05%,20.5%,1
桃園市,平鎮區,0801,380,272,652,67,719,1487,48.35%,25.55%,1
桃園市,平鎮區,0802,450,261,711,65,776,1453,53.41%,30.97%,1
桃園市,平鎮區,0803,450,295,745,62,807,1491,54.12%,30.18%,1
桃園市,平鎮區,0804,366,270,636,69,705,1346,52.38%,27.19%,1
桃園市,平鎮區,0805,471,328,799,46,845,1660,50.9%,28.37%,1
桃園市,平鎮區,0806,501,331,832,57,889,1921,46.28%,26.08%,1
桃園市,平鎮區,0807,631,363,994,74,1068,1974,54.1%,31.97%,1
桃園市,平鎮區,0808,540,341,881,55,936,1867,50.13%,28.92%,1
桃園市,平鎮區,0809,554,313,867,53,920,1786,51.51%,31.02%,1
桃園市,平鎮區,0810,405,240,645,38,683,1634,41.8%,24.79%,1
桃園市,平鎮區,0811,337,218,555,30,585,1080,54.17%,31.2%,1
桃園市,平鎮區,0812,471,290,761,35,796,1514,52.58%,31.11%,1
桃園市,平鎮區,0813,519,280,799,85,884,1918,46.09%,27.06%,1
桃園市,平鎮區,0814,329,247,576,83,659,1182,55.75%,27.83%,1
桃園市,平鎮區,0815,469,285,754,49,803,1667,48.17%,28.13%,1
桃園市,平鎮區,0816,430,290,720,38,758,1640,46.22%,26.22%,1
桃園市,平鎮區,0817,515,286,801,24,825,1603,51.47%,32.13%,1
桃園市,平鎮區,0818,519,307,826,27,853,1556,54.82%,33.35%,1
桃園市,平鎮區,0819,499,275,774,62,836,1697,49.26%,29.4%,1
桃園市,平鎮區,0820,307,200,507,23,530,1130,46.9%,27.17%,1
桃園市,平鎮區,0821,349,247,596,40,636,1196,53.18%,29.18%,1
桃園市,平鎮區,0822,496,327,823,56,879,1685,52.17%,29.44%,1
桃園市,平鎮區,0823,472,331,803,60,863,1532,56.33%,30.81%,1
桃園市,平鎮區,0824,448,292,740,53,793,1564,50.7%,28.64%,1
桃園市,平鎮區,0825,449,273,722,48,770,1824,42.21%,24.62%,1
桃園市,平鎮區,0826,532,338,870,49,919,1912,48.06%,27.82%,1
桃園市,平鎮區,0827,265,197,462,101,563,1048,53.72%,25.29%,1
桃園市,平鎮區,0828,413,235,648,58,706,1259,56.08%,32.8%,1
桃園市,平鎮區,0829,332,190,522,28,550,1061,51.84%,31.29%,1
桃園市,平鎮區,0830,385,214,599,44,643,1072,59.98%,35.91%,1
桃園市,平鎮區,0831,511,333,844,67,911,1788,50.95%,28.58%,1
桃園市,平鎮區,0832,462,256,718,53,771,1510,51.06%,30.6%,1
桃園市,平鎮區,0833,398,270,668,68,736,1403,52.46%,28.37%,1
桃園市,平鎮區,0834,428,275,703,63,766,1407,54.44%,30.42%,1
桃園市,平鎮區,0835,561,379,940,78,1018,1901,53.55%,29.51%,1
桃園市,平鎮區,0836,538,324,862,46,908,1994,45.54%,26.98%,1
桃園市,平鎮區,0837,534,322,856,40,896,1730,51.79%,30.87%,1
桃園市,平鎮區,0838,576,364,940,69,1009,1905,52.97%,30.24%,1
桃園市,平鎮區,0839,561,350,911,33,944,1723,54.79%,32.56%,1
桃園市,平鎮區,0840,374,284,658,58,716,1307,54.78%,28.62%,1
桃園市,平鎮區,0841,427,263,690,54,744,1337,55.65%,31.94%,1
桃園市,平鎮區,0842,372,217,589,50,639,980,65.2%,37.96%,1
桃園市,平鎮區,0843,499,342,841,91,932,1818,51.27%,27.45%,1
桃園市,平鎮區,0844,454,301,755,48,803,1463,54.89%,31.03%,1
桃園市,平鎮區,0845,406,266,672,37,709,1213,58.45%,33.47%,1
桃園市,平鎮區,0846,345,238,583,48,631,1085,58.16%,31.8%,1
桃園市,平鎮區,0847,408,264,672,45,717,1458,49.18%,27.98%,1
桃園市,平鎮區,0848,417,283,700,76,776,1408,55.11%,29.62%,1
桃園市,平鎮區,0849,377,279,656,67,723,1396,51.79%,27.01%,1
桃園市,平鎮區,0850,389,245,634,37,671,1044,64.27%,37.26%,1
桃園市,平鎮區,0851,382,224,606,15,621,1124,55.25%,33.99%,1
桃園市,平鎮區,0852,466,316,782,32,814,1517,53.66%,30.72%,1
桃園市,平鎮區,0853,490,289,779,37,816,1571,51.94%,31.19%,1
桃園市,平鎮區,0854,572,345,917,45,962,1752,54.91%,32.65%,1
桃園市,平鎮區,0855,496,306,802,57,859,1434,59.9%,34.59%,1
桃園市,平鎮區,0856,580,345,925,56,981,1710,57.37%,33.92%,1
桃園市,平鎮區,0857,510,303,813,51,864,1555,55.56%,32.8%,1
桃園市,平鎮區,0858,582,342,924,48,972,2051,47.39%,28.38%,1
桃園市,平鎮區,0859,452,301,753,35,788,1477,53.35%,30.6%,1
桃園市,平鎮區,0860,444,320,764,42,806,1501,53.7%,29.58%,1
桃園市,平鎮區,0861,437,270,707,77,784,1405,55.8%,31.1%,1
桃園市,平鎮區,0862,522,292,814,69,883,1656,53.32%,31.52%,1
桃園市,平鎮區,0863,639,199,838,53,891,1921,46.38%,33.26%,1
桃園市,平鎮區,0864,470,307,777,44,821,1717,47.82%,27.37%,1
桃園市,平鎮區,0865,389,262,651,67,718,1319,54.44%,29.49%,1
桃園市,平鎮區,0866,501,305,806,70,876,1745,50.2%,28.71%,1
桃園市,平鎮區,0867,531,320,851,89,940,1721,54.62%,30.85%,1
桃園市,平鎮區,0868,372,243,615,44,659,1206,54.64%,30.85%,1
桃園市,平鎮區,0869,447,296,743,43,786,1202,65.39%,37.19%,1
桃園市,平鎮區,0870,409,250,659,47,706,1208,58.44%,33.86%,1
桃園市,平鎮區,0871,404,291,695,57,752,1267,59.35%,31.89%,1
桃園市,平鎮區,0872,333,242,575,36,611,1094,55.85%,30.44%,1
桃園市,平鎮區,0873,465,285,750,67,817,1394,58.61%,33.36%,1
桃園市,平鎮區,0874,453,239,692,27,719,1215,59.18%,37.28%,1
桃園市,平鎮區,0875,315,220,535,48,583,1010,57.72%,31.19%,1
桃園市,平鎮區,0876,392,266,658,35,693,1261,54.96%,31.09%,1
桃園市,平鎮區,0877,459,272,731,39,770,1314,58.6%,34.93%,1
桃園市,平鎮區,0878,212,170,382,41,423,722,58.59%,29.36%,1
桃園市,平鎮區,0879,260,190,450,31,481,839,57.33%,30.99%,1
桃園市,平鎮區,0880,393,311,704,42,746,1399,53.32%,28.09%,1
桃園市,平鎮區,0881,579,344,923,67,990,1968,50.3%,29.42%,1
桃園市,平鎮區,0882,529,317,846,51,897,1672,53.65%,31.64%,1
桃園市,平鎮區,0883,365,239,604,45,649,2213,29.33%,16.49%,1
桃園市,平鎮區,0884,318,243,561,27,588,949,61.96%,33.51%,1
桃園市,平鎮區,0885,579,326,905,64,969,1621,59.78%,35.72%,1
桃園市,平鎮區,0886,491,300,791,49,840,1643,51.13%,29.88%,1
桃園市,平鎮區,0887,611,351,962,52,1014,1844,54.99%,33.13%,1
桃園市,平鎮區,0888,525,316,841,62,903,1752,51.54%,29.97%,1
桃園市,平鎮區,0889,445,301,746,62,808,1577,51.24%,28.22%,1
桃園市,平鎮區,0890,458,344,802,42,844,1517,55.64%,30.19%,1
桃園市,平鎮區,0891,303,264,567,44,611,1039,58.81%,29.16%,1
桃園市,平鎮區,0892,454,269,723,54,777,1318,58.95%,34.45%,1
桃園市,平鎮區,0893,546,264,810,51,861,1636,52.63%,33.37%,1
桃園市,平鎮區,0894,413,277,690,51,741,1316,56.31%,31.38%,1
桃園市,平鎮區,0895,469,326,795,22,817,1474,55.43%,31.82%,1
桃園市,平鎮區,0896,393,245,638,68,706,1480,47.7%,26.55%,1
桃園市,平鎮區,0897,400,269,669,39,708,1330,53.23%,30.08%,1
桃園市,平鎮區,0898,403,240,643,41,684,1228,55.7%,32.82%,1
桃園市,平鎮區,0899,435,318,753,55,808,1377,58.68%,31.59%,1
桃園市,平鎮區,0900,429,255,684,41,725,1198,60.52%,35.81%,1
桃園市,平鎮區,0901,405,277,682,44,726,1231,58.98%,32.9%,1
桃園市,平鎮區,0902,404,232,636,76,712,1243,57.28%,32.5%,1
桃園市,平鎮區,0903,486,274,760,79,839,1590,52.77%,30.57%,1
桃園市,平鎮區,0904,418,260,678,58,736,1366,53.88%,30.6%,1
桃園市,平鎮區,0905,447,223,670,46,716,1332,53.75%,33.56%,1
桃園市,平鎮區,0906,333,194,527,34,561,1201,46.71%,27.73%,1
桃園市,平鎮區,0907,439,290,729,42,771,1668,46.22%,26.32%,1
桃園市,平鎮區,0908,387,249,636,70,706,1351,52.26%,28.65%,1
桃園市,平鎮區,0909,398,236,634,38,672,1460,46.03%,27.26%,1
桃園市,平鎮區,0910,539,343,882,52,934,1841,50.73%,29.28%,1
桃園市,平鎮區,0911,406,250,656,31,687,1475,46.58%,27.53%,1
桃園市,平鎮區,0912,300,215,515,44,559,1011,55.29%,29.67%,1
桃園市,平鎮區,0913,293,186,479,34,513,1052,48.76%,27.85%,1
桃園市,平鎮區,0914,423,221,644,66,710,1154,61.53%,36.66%,1
桃園市,平鎮區,0915,476,288,764,38,802,1645,48.75%,28.94%,1
桃園市,平鎮區,0916,380,255,635,139,774,1539,50.29%,24.69%,1
桃園市,平鎮區,0917,428,233,661,86,747,1385,53.94%,30.9%,1
桃園市,平鎮區,0918,429,265,694,46,740,1395,53.05%,30.75%,1
桃園市,平鎮區,0919,485,310,795,59,854,1711,49.91%,28.35%,1
桃園市,平鎮區,0920,491,288,779,55,834,1631,51.13%,30.1%,1
桃園市,平鎮區,0921,374,205,579,26,605,1110,54.5%,33.69%,1
桃園市,平鎮區,0922,671,315,986,55,1041,1931,53.91%,34.75%,1
桃園市,平鎮區,0923,344,242,586,33,619,1127,54.92%,30.52%,1
桃園市,平鎮區,0924,468,234,702,76,778,1414,55.02%,33.1%,1
桃園市,平鎮區,0925,523,270,793,52,845,1609,52.52%,32.5%,1
桃園市,新屋區,1072,447,281,728,41,769,1306,58.88%,34.23%,1
桃園市,新屋區,1073,482,334,816,50,866,1556,55.66%,30.98%,1
桃園市,新屋區,1074,615,398,1013,113,1126,1849,60.9%,33.26%,1
桃園市,新屋區,1075,692,426,1118,100,1218,2096,58.11%,33.02%,1
桃園市,新屋區,1076,326,418,744,55,799,1517,52.67%,21.49%,1
桃園市,新屋區,1077,642,441,1083,108,1191,2095,56.85%,30.64%,1
桃園市,新屋區,1078,506,296,802,57,859,1856,46.28%,27.26%,1
桃園市,新屋區,1079,601,386,987,92,1079,1986,54.33%,30.26%,1
桃園市,新屋區,1080,330,270,600,93,693,1425,48.63%,23.16%,1
桃園市,新屋區,1081,359,278,637,52,689,1385,49.75%,25.92%,1
桃園市,新屋區,1082,435,273,708,73,781,1271,61.45%,34.23%,1
桃園市,新屋區,1083,379,249,628,53,681,1271,53.58%,29.82%,1
桃園市,新屋區,1084,360,287,647,49,696,1234,56.4%,29.17%,1
桃園市,新屋區,1085,310,252,562,43,605,1085,55.76%,28.57%,1
桃園市,新屋區,1086,646,376,1022,76,1098,1992,55.12%,32.43%,1
桃園市,新屋區,1087,641,454,1095,101,1196,2032,58.86%,31.55%,1
桃園市,新屋區,1088,363,258,621,85,706,1291,54.69%,28.12%,1
桃園市,新屋區,1089,402,238,640,45,685,1401,48.89%,28.69%,1
桃園市,新屋區,1090,350,236,586,61,647,1106,58.5%,31.65%,1
桃園市,新屋區,1091,243,199,442,28,470,908,51.76%,26.76%,1
桃園市,新屋區,1092,226,136,362,46,408,663,61.54%,34.09%,1
桃園市,新屋區,1093,316,198,514,67,581,1088,53.4%,29.04%,1
桃園市,新屋區,1094,377,219,596,71,667,1050,63.52%,35.9%,1
桃園市,新屋區,1095,279,203,482,30,512,896,57.14%,31.14%,1
桃園市,新屋區,1096,437,280,717,104,821,1369,59.97%,31.92%,1
桃園市,新屋區,1097,251,191,442,46,488,995,49.05%,25.23%,1
桃園市,新屋區,1098,223,157,380,32,412,741,55.6%,30.09%,1
桃園市,新屋區,1099,292,224,516,66,582,943,61.72%,30.97%,1
桃園市,新屋區,1100,471,309,780,105,885,1714,51.63%,27.48%,1
桃園市,新屋區,1101,386,315,701,34,735,1340,54.85%,28.81%,1
桃園市,觀音區,1102,354,237,591,44,635,1371,46.32%,25.82%,1
桃園市,觀音區,1103,318,208,526,46,572,1362,42%,23.35%,1
桃園市,觀音區,1104,270,197,467,64,531,997,53.26%,27.08%,1
桃園市,觀音區,1105,368,257,625,33,658,1407,46.77%,26.15%,1
桃園市,觀音區,1106,493,329,822,49,871,1692,51.48%,29.14%,1
桃園市,觀音區,1107,397,217,614,32,646,1279,50.51%,31.04%,1
桃園市,觀音區,1108,234,153,387,22,409,791,51.71%,29.58%,1
桃園市,觀音區,1109,279,177,456,47,503,892,56.39%,31.28%,1
桃園市,觀音區,1110,312,183,495,36,531,886,59.93%,35.21%,1
桃園市,觀音區,1111,184,162,346,51,397,712,55.76%,25.84%,1
桃園市,觀音區,1112,390,287,677,136,813,1609,50.53%,24.24%,1
桃園市,觀音區,1113,381,255,636,70,706,1274,55.42%,29.91%,1
桃園市,觀音區,1114,333,206,539,40,579,1351,42.86%,24.65%,1
桃園市,觀音區,1115,391,262,653,75,728,1262,57.69%,30.98%,1
桃園市,觀音區,1116,377,242,619,87,706,1242,56.84%,30.35%,1
桃園市,觀音區,1117,415,291,706,69,775,1461,53.05%,28.41%,1
桃園市,觀音區,1118,438,313,751,69,820,1613,50.84%,27.15%,1
桃園市,觀音區,1119,449,286,735,64,799,1479,54.02%,30.36%,1
桃園市,觀音區,1120,365,304,669,72,741,1552,47.74%,23.52%,1
桃園市,觀音區,1121,389,308,697,56,753,1517,49.64%,25.64%,1
桃園市,觀音區,1122,466,306,772,74,846,1691,50.03%,27.56%,1
桃園市,觀音區,1123,360,246,606,24,630,1157,54.45%,31.11%,1
桃園市,觀音區,1124,407,280,687,55,742,1455,51%,27.97%,1
桃園市,觀音區,1125,317,226,543,66,609,1150,52.96%,27.57%,1
桃園市,觀音區,1126,325,240,565,63,628,1112,56.47%,29.23%,1
桃園市,觀音區,1127,374,214,588,23,611,1251,48.84%,29.9%,1
桃園市,觀音區,1128,400,260,660,123,783,1446,54.15%,27.66%,1
桃園市,觀音區,1129,360,287,647,143,790,1493,52.91%,24.11%,1
桃園市,觀音區,1130,333,259,592,113,705,1339,52.65%,24.87%,1
桃園市,觀音區,1131,333,282,615,41,656,1137,57.7%,29.29%,1
桃園市,觀音區,1132,280,208,488,39,527,1043,50.53%,26.85%,1
桃園市,觀音區,1133,245,166,411,49,460,993,46.32%,24.67%,1
桃園市,觀音區,1134,270,179,449,38,487,975,49.95%,27.69%,1
桃園市,觀音區,1135,490,326,816,61,877,2029,43.22%,24.15%,1
桃園市,觀音區,1136,540,337,877,66,943,1765,53.43%,30.59%,1
桃園市,觀音區,1137,524,317,841,64,905,1809,50.03%,28.97%,1
桃園市,觀音區,1138,488,370,858,44,902,1869,48.26%,26.11%,1
桃園市,觀音區,1139,465,279,744,62,806,1870,43.1%,24.87%,1
桃園市,觀音區,1140,377,259,636,50,686,1932,35.51%,19.51%,1
桃園市,觀音區,1141,188,162,350,17,367,899,40.82%,20.91%,1
桃園市,觀音區,1142,239,157,396,22,418,985,42.44%,24.26%,1
桃園市,復興區,0581,508,469,977,125,1102,1991,55.35%,25.51%,1
桃園市,復興區,0582,396,297,693,98,791,1392,56.82%,28.45%,1
桃園市,復興區,0583,185,84,269,24,293,564,51.95%,32.8%,1
桃園市,復興區,0584,188,140,328,27,355,716,49.58%,26.26%,1
桃園市,復興區,0585,322,221,543,83,626,1016,61.61%,31.69%,1
桃園市,復興區,0586,141,111,252,15,267,669,39.91%,21.08%,1
桃園市,復興區,0587,198,139,337,18,355,760,46.71%,26.05%,1
桃園市,復興區,0588,186,163,349,19,368,751,49%,24.77%,1
桃園市,復興區,0589,135,76,211,21,232,683,33.97%,19.77%,1
桃園市,復興區,0590,345,232,577,41,618,1224,50.49%,28.19%,1
臺中市,中區,1070,515,382,897,117,1014,1652,61.38%,31.17%,1
臺中市,中區,1071,392,352,744,104,848,1531,55.39%,25.6%,1
臺中市,中區,1072,419,307,726,71,797,1431,55.7%,29.28%,1
臺中市,中區,1073,330,235,565,52,617,1060,58.21%,31.13%,1
臺中市,中區,1074,302,186,488,63,551,982,56.11%,30.75%,1
臺中市,中區,1075,370,255,625,93,718,1191,60.29%,31.07%,1
臺中市,中區,1076,221,200,421,73,494,855,57.78%,25.85%,1
臺中市,中區,1077,291,199,490,44,534,1135,47.05%,25.64%,1
臺中市,中區,1078,228,160,388,18,406,705,57.59%,32.34%,1
臺中市,中區,1079,309,230,539,62,601,1009,59.56%,30.62%,1
臺中市,中區,1080,337,290,627,107,734,1304,56.29%,25.84%,1
臺中市,中區,1081,485,361,846,55,901,1841,48.94%,26.34%,1
臺中市,東區,1148,224,182,406,31,437,1138,38.4%,19.68%,1
臺中市,東區,1149,306,215,521,41,562,984,57.11%,31.1%,1
臺中市,東區,1150,267,195,462,60,522,877,59.52%,30.44%,1
臺中市,東區,1151,346,259,605,56,661,1070,61.78%,32.34%,1
臺中市,東區,1152,371,249,620,61,681,1106,61.57%,33.54%,1
臺中市,東區,1153,297,217,514,67,581,953,60.97%,31.16%,1
臺中市,東區,1154,385,275,660,49,709,1195,59.33%,32.22%,1
臺中市,東區,1155,370,277,647,60,707,1251,56.51%,29.58%,1
臺中市,東區,1156,347,282,629,51,680,1190,57.14%,29.16%,1
臺中市,東區,1157,409,314,723,68,791,1394,56.74%,29.34%,1
臺中市,東區,1158,457,363,820,70,890,1443,61.68%,31.67%,1
臺中市,東區,1159,217,178,395,47,442,762,58.01%,28.48%,1
臺中市,東區,1160,364,296,660,61,721,1140,63.25%,31.93%,1
臺中市,東區,1161,366,315,681,83,764,1211,63.09%,30.22%,1
臺中市,東區,1162,275,173,448,33,481,755,63.71%,36.42%,1
臺中市,東區,1163,454,289,743,97,840,1491,56.34%,30.45%,1
臺中市,東區,1164,267,217,484,59,543,1000,54.3%,26.7%,1
臺中市,東區,1165,372,226,598,81,679,1114,60.95%,33.39%,1
臺中市,東區,1166,341,242,583,47,630,1101,57.22%,30.97%,1
臺中市,東區,1167,367,294,661,89,750,1169,64.16%,31.39%,1
臺中市,東區,1168,405,304,709,95,804,1283,62.67%,31.57%,1
臺中市,東區,1169,406,273,679,59,738,1168,63.18%,34.76%,1
臺中市,東區,1170,400,304,704,50,754,1386,54.4%,28.86%,1
臺中市,東區,1171,509,350,859,69,928,1557,59.6%,32.69%,1
臺中市,東區,1172,414,329,743,71,814,1380,58.99%,30%,1
臺中市,東區,1173,527,375,902,79,981,1674,58.6%,31.48%,1
臺中市,東區,1174,642,300,942,57,999,1604,62.28%,40.02%,1
臺中市,東區,1175,579,420,999,90,1089,1815,60%,31.9%,1
臺中市,東區,1176,528,344,872,75,947,1700,55.71%,31.06%,1
臺中市,東區,1177,498,325,823,92,915,1592,57.47%,31.28%,1
臺中市,東區,1178,546,368,914,107,1021,1850,55.19%,29.51%,1
臺中市,東區,1179,442,250,692,59,751,1252,59.98%,35.3%,1
臺中市,東區,1180,429,299,728,66,794,1250,63.52%,34.32%,1
臺中市,東區,1181,418,264,682,68,750,1241,60.44%,33.68%,1
臺中市,東區,1182,390,252,642,69,711,1318,53.95%,29.59%,1
臺中市,東區,1183,389,250,639,96,735,1288,57.07%,30.2%,1
臺中市,東區,1184,499,299,798,103,901,1442,62.48%,34.6%,1
臺中市,東區,1185,406,239,645,71,716,1202,59.57%,33.78%,1
臺中市,東區,1186,505,271,776,80,856,1452,58.95%,34.78%,1
臺中市,東區,1187,471,295,766,58,824,1480,55.68%,31.82%,1
臺中市,東區,1188,643,284,927,86,1013,1736,58.35%,37.04%,1
臺中市,東區,1189,257,188,445,56,501,867,57.79%,29.64%,1
臺中市,東區,1190,554,268,822,67,889,1693,52.51%,32.72%,1
臺中市,東區,1191,488,355,843,98,941,1538,61.18%,31.73%,1
臺中市,東區,1192,444,420,864,129,993,1593,62.34%,27.87%,1
臺中市,東區,1193,445,315,760,51,811,1481,54.76%,30.05%,1
臺中市,東區,1194,458,333,791,77,868,1414,61.39%,32.39%,1
臺中市,東區,1195,361,293,654,62,716,1297,55.2%,27.83%,1
臺中市,東區,1196,384,360,744,86,830,1394,59.54%,27.55%,1
臺中市,南區,1197,301,217,518,54,572,937,61.05%,32.12%,1
臺中市,南區,1198,342,255,597,60,657,1001,65.63%,34.17%,1
臺中市,南區,1199,415,324,739,85,824,1249,65.97%,33.23%,1
臺中市,南區,1200,451,294,745,78,823,1202,68.47%,37.52%,1
臺中市,南區,1201,319,267,586,131,717,1130,63.45%,28.23%,1
臺中市,南區,1202,411,296,707,80,787,1239,63.52%,33.17%,1
臺中市,南區,1203,365,276,641,88,729,1238,58.89%,29.48%,1
臺中市,南區,1204,413,303,716,73,789,1272,62.03%,32.47%,1
臺中市,南區,1205,399,302,701,70,771,1273,60.57%,31.34%,1
臺中市,南區,1206,416,300,716,89,805,1317,61.12%,31.59%,1
臺中市,南區,1207,433,308,741,47,788,1160,67.93%,37.33%,1
臺中市,南區,1208,431,294,725,64,789,1205,65.48%,35.77%,1
臺中市,南區,1209,351,280,631,57,688,1111,61.93%,31.59%,1
臺中市,南區,1210,490,360,850,77,927,1407,65.88%,34.83%,1
臺中市,南區,1211,458,329,787,68,855,1419,60.25%,32.28%,1
臺中市,南區,1212,400,250,650,88,738,1157,63.79%,34.57%,1
臺中市,南區,1213,468,303,771,48,819,1415,57.88%,33.07%,1
臺中市,南區,1214,446,341,787,65,852,1289,66.1%,34.6%,1
臺中市,南區,1215,468,329,797,83,880,1454,60.52%,32.19%,1
臺中市,南區,1216,439,320,759,74,833,1491,55.87%,29.44%,1
臺中市,南區,1217,480,287,767,55,822,1394,58.97%,34.43%,1
臺中市,南區,1218,455,314,769,89,858,1430,60%,31.82%,1
臺中市,南區,1219,392,278,670,169,839,1342,62.52%,29.21%,1
臺中市,南區,1220,416,340,756,129,885,1304,67.87%,31.9%,1
臺中市,南區,1221,401,289,690,66,756,1190,63.53%,33.7%,1
臺中市,南區,1222,435,243,678,81,759,1273,59.62%,34.17%,1
臺中市,南區,1223,502,317,819,86,905,1387,65.25%,36.19%,1
臺中市,南區,1224,452,287,739,71,810,1356,59.73%,33.33%,1
臺中市,南區,1225,444,298,742,75,817,1304,62.65%,34.05%,1
臺中市,南區,1226,477,290,767,57,824,1256,65.61%,37.98%,1
臺中市,南區,1227,481,333,814,45,859,1364,62.98%,35.26%,1
臺中市,南區,1228,417,330,747,104,851,1361,62.53%,30.64%,1
臺中市,南區,1229,511,316,827,47,874,1407,62.12%,36.32%,1
臺中市,南區,1230,403,306,709,92,801,1308,61.24%,30.81%,1
臺中市,南區,1231,358,311,669,64,733,1250,58.64%,28.64%,1
臺中市,南區,1232,413,272,685,58,743,1284,57.87%,32.17%,1
臺中市,南區,1233,399,273,672,82,754,1175,64.17%,33.96%,1
臺中市,南區,1234,429,282,711,57,768,1158,66.32%,37.05%,1
臺中市,南區,1235,415,227,642,75,717,1168,61.39%,35.53%,1
臺中市,南區,1236,581,374,955,83,1038,1626,63.84%,35.73%,1
臺中市,南區,1237,506,318,824,51,875,2115,41.37%,23.92%,1
臺中市,南區,1238,586,359,945,63,1008,1805,55.84%,32.47%,1
臺中市,南區,1239,552,332,884,57,941,1695,55.52%,32.57%,1
臺中市,南區,1240,590,379,969,77,1046,1643,63.66%,35.91%,1
臺中市,南區,1241,485,355,840,44,884,1423,62.12%,34.08%,1
臺中市,南區,1242,498,345,843,76,919,1542,59.6%,32.3%,1
臺中市,南區,1243,521,339,860,58,918,1533,59.88%,33.99%,1
臺中市,南區,1244,557,346,903,91,994,1531,64.92%,36.38%,1
臺中市,南區,1245,402,293,695,62,757,1392,54.38%,28.88%,1
臺中市,南區,1246,516,340,856,59,915,1592,57.47%,32.41%,1
臺中市,南區,1247,475,354,829,67,896,1431,62.61%,33.19%,1
臺中市,南區,1248,532,368,900,86,986,1799,54.81%,29.57%,1
臺中市,南區,1249,616,381,997,86,1083,1708,63.41%,36.07%,1
臺中市,南區,1250,482,419,901,80,981,1700,57.71%,28.35%,1
臺中市,南區,1251,646,399,1045,57,1102,1751,62.94%,36.89%,1
臺中市,南區,1252,681,495,1176,91,1267,2109,60.08%,32.29%,1
臺中市,南區,1253,542,379,921,84,1005,1697,59.22%,31.94%,1
臺中市,南區,1254,486,327,813,56,869,1456,59.68%,33.38%,1
臺中市,南區,1255,603,453,1056,91,1147,1726,66.45%,34.94%,1
臺中市,南區,1256,640,361,1001,80,1081,1723,62.74%,37.14%,1
臺中市,南區,1257,550,339,889,84,973,1569,62.01%,35.05%,1
臺中市,南區,1258,377,312,689,105,794,1274,62.32%,29.59%,1
臺中市,南區,1259,519,346,865,57,922,1390,66.33%,37.34%,1
臺中市,南區,1260,477,320,797,52,849,1295,65.56%,36.83%,1
臺中市,南區,1261,419,301,720,79,799,1312,60.9%,31.94%,1
臺中市,南區,1262,522,323,845,57,902,1417,63.66%,36.84%,1
臺中市,南區,1263,489,329,818,37,855,1230,69.51%,39.76%,1
臺中市,南區,1264,418,278,696,94,790,1308,60.4%,31.96%,1
臺中市,南區,1265,471,333,804,73,877,1467,59.78%,32.11%,1
臺中市,南區,1266,408,371,779,80,859,1399,61.4%,29.16%,1
臺中市,南區,1267,370,280,650,83,733,1207,60.73%,30.65%,1
臺中市,南區,1268,421,293,714,60,774,1317,58.77%,31.97%,1
臺中市,南區,1269,499,363,862,52,914,1563,58.48%,31.93%,1
臺中市,南區,1270,453,277,730,39,769,1221,62.98%,37.1%,1
臺中市,西區,1082,267,200,467,47,514,1400,36.71%,19.07%,1
臺中市,西區,1083,302,226,528,27,555,861,64.46%,35.08%,1
臺中市,西區,1084,463,308,771,69,840,1416,59.32%,32.7%,1
臺中市,西區,1085,349,235,584,51,635,1020,62.25%,34.22%,1
臺中市,西區,1086,259,209,468,45,513,778,65.94%,33.29%,1
臺中市,西區,1087,445,291,736,69,805,1465,54.95%,30.38%,1
臺中市,西區,1088,319,242,561,30,591,1017,58.11%,31.37%,1
臺中市,西區,1089,271,216,487,39,526,868,60.6%,31.22%,1
臺中市,西區,1090,425,304,729,80,809,1251,64.67%,33.97%,1
臺中市,西區,1091,357,271,628,55,683,1044,65.42%,34.2%,1
臺中市,西區,1092,480,324,804,58,862,1487,57.97%,32.28%,1
臺中市,西區,1093,518,336,854,59,913,1573,58.04%,32.93%,1
臺中市,西區,1094,586,385,971,81,1052,1731,60.77%,33.85%,1
臺中市,西區,1095,389,285,674,53,727,1209,60.13%,32.18%,1
臺中市,西區,1096,509,330,839,56,895,1564,57.23%,32.54%,1
臺中市,西區,1097,409,273,682,50,732,1175,62.3%,34.81%,1
臺中市,西區,1098,469,321,790,63,853,1505,56.68%,31.16%,1
臺中市,西區,1099,512,294,806,46,852,1418,60.08%,36.11%,1
臺中市,西區,1100,390,265,655,10,665,1497,44.42%,26.05%,1
臺中市,西區,1101,397,300,697,58,755,1260,59.92%,31.51%,1
臺中市,西區,1102,464,317,781,70,851,1399,60.83%,33.17%,1
臺中市,西區,1103,473,289,762,72,834,1447,57.64%,32.69%,1
臺中市,西區,1104,530,373,903,83,986,1683,58.59%,31.49%,1
臺中市,西區,1105,528,342,870,80,950,1585,59.94%,33.31%,1
臺中市,西區,1106,526,342,868,68,936,1557,60.12%,33.78%,1
臺中市,西區,1107,495,326,821,88,909,1663,54.66%,29.77%,1
臺中市,西區,1108,598,426,1024,98,1122,1921,58.41%,31.13%,1
臺中市,西區,1109,521,451,972,58,1030,1952,52.77%,26.69%,1
臺中市,西區,1110,544,356,900,70,970,1708,56.79%,31.85%,1
臺中市,西區,1111,417,254,671,49,720,1131,63.66%,36.87%,1
臺中市,西區,1112,608,342,950,87,1037,1916,54.12%,31.73%,1
臺中市,西區,1113,399,325,724,54,778,1275,61.02%,31.29%,1
臺中市,西區,1114,543,352,895,70,965,1822,52.96%,29.8%,1
臺中市,西區,1115,446,308,754,55,809,1374,58.88%,32.46%,1
臺中市,西區,1116,330,242,572,77,649,1129,57.48%,29.23%,1
臺中市,西區,1117,359,256,615,58,673,1201,56.04%,29.89%,1
臺中市,西區,1118,478,385,863,73,936,1639,57.11%,29.16%,1
臺中市,西區,1119,564,431,995,95,1090,1863,58.51%,30.27%,1
臺中市,西區,1120,455,304,759,70,829,1287,64.41%,35.35%,1
臺中市,西區,1121,494,353,847,71,918,1504,61.04%,32.85%,1
臺中市,西區,1122,443,278,721,44,765,1308,58.49%,33.87%,1
臺中市,西區,1123,459,316,775,69,844,1433,58.9%,32.03%,1
臺中市,西區,1124,408,363,771,52,823,1450,56.76%,28.14%,1
臺中市,西區,1125,496,368,864,71,935,1465,63.82%,33.86%,1
臺中市,西區,1126,553,348,901,89,990,1818,54.46%,30.42%,1
臺中市,西區,1127,513,423,936,98,1034,1782,58.02%,28.79%,1
臺中市,西區,1128,415,361,776,95,871,1428,60.99%,29.06%,1
臺中市,西區,1129,374,292,666,62,728,1366,53.29%,27.38%,1
臺中市,西區,1130,471,330,801,52,853,1498,56.94%,31.44%,1
臺中市,西區,1131,446,309,755,59,814,1350,60.3%,33.04%,1
臺中市,西區,1132,447,311,758,54,812,1339,60.64%,33.38%,1
臺中市,西區,1133,582,335,917,51,968,1613,60.01%,36.08%,1
臺中市,西區,1134,471,301,772,79,851,1454,58.53%,32.39%,1
臺中市,西區,1135,531,359,890,73,963,1597,60.3%,33.25%,1
臺中市,西區,1136,457,336,793,99,892,1411,63.22%,32.39%,1
臺中市,西區,1137,431,371,802,87,889,1493,59.54%,28.87%,1
臺中市,西區,1138,553,339,892,92,984,1600,61.5%,34.56%,1
臺中市,西區,1139,524,351,875,79,954,1710,55.79%,30.64%,1
臺中市,西區,1140,389,252,641,39,680,1139,59.7%,34.15%,1
臺中市,西區,1141,362,277,639,42,681,1105,61.63%,32.76%,1
臺中市,西區,1142,495,298,793,73,866,1498,57.81%,33.04%,1
臺中市,西區,1143,543,364,907,66,973,1921,50.65%,28.27%,1
臺中市,西區,1144,401,309,710,81,791,1340,59.03%,29.93%,1
臺中市,西區,1145,531,341,872,60,932,1536,60.68%,34.57%,1
臺中市,西區,1146,394,314,708,95,803,1361,59%,28.95%,1
臺中市,西區,1147,515,321,836,59,895,1430,62.59%,36.01%,1
臺中市,北區,0983,430,287,717,51,768,1437,53.44%,29.92%,1
臺中市,北區,0984,479,321,800,111,911,1708,53.34%,28.04%,1
臺中市,北區,0985,290,202,492,57,549,1051,52.24%,27.59%,1
臺中市,北區,0986,307,219,526,58,584,996,58.63%,30.82%,1
臺中市,北區,0987,567,261,828,38,866,1504,57.58%,37.7%,1
臺中市,北區,0988,333,219,552,54,606,975,62.15%,34.15%,1
臺中市,北區,0989,287,187,474,49,523,886,59.03%,32.39%,1
臺中市,北區,0990,312,218,530,53,583,1276,45.69%,24.45%,1
臺中市,北區,0991,245,186,431,53,484,938,51.6%,26.12%,1
臺中市,北區,0992,394,272,666,105,771,1404,54.91%,28.06%,1
臺中市,北區,0993,335,203,538,25,563,996,56.53%,33.63%,1
臺中市,北區,0994,243,191,434,59,493,869,56.73%,27.96%,1
臺中市,北區,0995,235,152,387,42,429,704,60.94%,33.38%,1
臺中市,北區,0996,274,206,480,49,529,979,54.03%,27.99%,1
臺中市,北區,0997,229,151,380,29,409,773,52.91%,29.62%,1
臺中市,北區,0998,253,158,411,41,452,759,59.55%,33.33%,1
臺中市,北區,0999,511,237,748,91,839,1438,58.34%,35.54%,1
臺中市,北區,1000,361,223,584,44,628,1212,51.82%,29.79%,1
臺中市,北區,1001,569,360,929,49,978,1731,56.5%,32.87%,1
臺中市,北區,1002,405,326,731,57,788,1445,54.53%,28.03%,1
臺中市,北區,1003,568,374,942,87,1029,1855,55.47%,30.62%,1
臺中市,北區,1004,487,293,780,95,875,1728,50.64%,28.18%,1
臺中市,北區,1005,542,357,899,69,968,1878,51.54%,28.86%,1
臺中市,北區,1006,585,229,814,120,934,1793,52.09%,32.63%,1
臺中市,北區,1007,522,302,824,96,920,1555,59.16%,33.57%,1
臺中市,北區,1008,484,343,827,45,872,1761,49.52%,27.48%,1
臺中市,北區,1009,495,296,791,69,860,1579,54.46%,31.35%,1
臺中市,北區,1010,652,395,1047,133,1180,2192,53.83%,29.74%,1
臺中市,北區,1011,534,320,854,78,932,1560,59.74%,34.23%,1
臺中市,北區,1012,490,311,801,56,857,1476,58.06%,33.2%,1
臺中市,北區,1013,360,212,572,46,618,1006,61.43%,35.79%,1
臺中市,北區,1014,461,301,762,56,818,1403,58.3%,32.86%,1
臺中市,北區,1015,454,282,736,39,775,1446,53.6%,31.4%,1
臺中市,北區,1016,446,313,759,64,823,1460,56.37%,30.55%,1
臺中市,北區,1017,393,265,658,39,697,1233,56.53%,31.87%,1
臺中市,北區,1018,422,225,647,42,689,1027,67.09%,41.09%,1
臺中市,北區,1019,403,252,655,38,693,1207,57.42%,33.39%,1
臺中市,北區,1020,388,268,656,61,717,1167,61.44%,33.25%,1
臺中市,北區,1021,344,273,617,37,654,1150,56.87%,29.91%,1
臺中市,北區,1022,330,247,577,51,628,1061,59.19%,31.1%,1
臺中市,北區,1023,318,224,542,41,583,1005,58.01%,31.64%,1
臺中市,北區,1024,386,282,668,40,708,1250,56.64%,30.88%,1
臺中市,北區,1025,445,333,778,86,864,1448,59.67%,30.73%,1
臺中市,北區,1026,477,267,744,82,826,1379,59.9%,34.59%,1
臺中市,北區,1027,517,319,836,116,952,1652,57.63%,31.3%,1
臺中市,北區,1028,563,360,923,88,1011,1867,54.15%,30.16%,1
臺中市,北區,1029,314,220,534,23,557,2078,26.8%,15.11%,1
臺中市,北區,1030,537,328,865,82,947,1562,60.63%,34.38%,1
臺中市,北區,1031,469,306,775,50,825,1430,57.69%,32.8%,1
臺中市,北區,1032,657,420,1077,95,1172,2018,58.08%,32.56%,1
臺中市,北區,1033,536,307,843,42,885,1710,51.75%,31.35%,1
臺中市,北區,1034,434,311,745,48,793,1432,55.38%,30.31%,1
臺中市,北區,1035,402,239,641,64,705,1157,60.93%,34.75%,1
臺中市,北區,1036,425,248,673,32,705,1188,59.34%,35.77%,1
臺中市,北區,1037,449,281,730,71,801,1419,56.45%,31.64%,1
臺中市,北區,1038,534,298,832,58,890,1653,53.84%,32.3%,1
臺中市,北區,1039,381,266,647,84,731,1233,59.29%,30.9%,1
臺中市,北區,1040,389,283,672,38,710,1243,57.12%,31.3%,1
臺中市,北區,1041,374,245,619,20,639,1219,52.42%,30.68%,1
臺中市,北區,1042,395,306,701,58,759,1272,59.67%,31.05%,1
臺中市,北區,1043,414,284,698,49,747,1285,58.13%,32.22%,1
臺中市,北區,1044,555,417,972,65,1037,1780,58.26%,31.18%,1
臺中市,北區,1045,443,267,710,45,755,1461,51.68%,30.32%,1
臺中市,北區,1046,420,295,715,66,781,1310,59.62%,32.06%,1
臺中市,北區,1047,499,300,799,68,867,1669,51.95%,29.9%,1
臺中市,北區,1048,622,377,999,128,1127,1932,58.33%,32.19%,1
臺中市,北區,1049,480,396,876,58,934,1682,55.53%,28.54%,1
臺中市,北區,1050,554,416,970,40,1010,1891,53.41%,29.3%,1
臺中市,北區,1051,590,393,983,82,1065,1882,56.59%,31.35%,1
臺中市,北區,1052,369,255,624,28,652,1159,56.26%,31.84%,1
臺中市,北區,1053,484,319,803,70,873,1553,56.21%,31.17%,1
臺中市,北區,1054,505,340,845,41,886,1607,55.13%,31.43%,1
臺中市,北區,1055,548,389,937,59,996,1773,56.18%,30.91%,1
臺中市,北區,1056,480,324,804,76,880,1524,57.74%,31.5%,1
臺中市,北區,1057,518,377,895,110,1005,1613,62.31%,32.11%,1
臺中市,北區,1058,627,384,1011,81,1092,1877,58.18%,33.4%,1
臺中市,北區,1059,546,389,935,100,1035,1792,57.76%,30.47%,1
臺中市,北區,1060,467,300,767,64,831,1392,59.7%,33.55%,1
臺中市,北區,1061,416,263,679,56,735,1297,56.67%,32.07%,1
臺中市,北區,1062,485,386,871,78,949,1556,60.99%,31.17%,1
臺中市,北區,1063,442,331,773,54,827,1497,55.24%,29.53%,1
臺中市,北區,1064,462,328,790,79,869,1550,56.06%,29.81%,1
臺中市,北區,1065,444,286,730,96,826,1434,57.6%,30.96%,1
臺中市,北區,1066,614,348,962,75,1037,1793,57.84%,34.24%,1
臺中市,北區,1067,599,364,963,78,1041,1866,55.79%,32.1%,1
臺中市,北區,1068,429,308,737,65,802,1346,59.58%,31.87%,1
臺中市,北區,1069,388,265,653,74,727,1267,57.38%,30.62%,1
臺中市,西屯區,0625,539,379,918,105,1023,1638,62.45%,32.91%,1
臺中市,西屯區,0626,402,275,677,56,733,1335,54.91%,30.11%,1
臺中市,西屯區,0627,605,364,969,71,1040,1776,58.56%,34.07%,1
臺中市,西屯區,0628,445,279,724,50,774,1351,57.29%,32.94%,1
臺中市,西屯區,0629,466,298,764,53,817,1338,61.06%,34.83%,1
臺中市,西屯區,0630,562,289,851,67,918,1582,58.03%,35.52%,1
臺中市,西屯區,0631,568,271,839,66,905,1710,52.92%,33.22%,1
臺中市,西屯區,0632,482,297,779,73,852,1595,53.42%,30.22%,1
臺中市,西屯區,0633,547,287,834,101,935,1585,58.99%,34.51%,1
臺中市,西屯區,0634,508,343,851,113,964,1749,55.12%,29.05%,1
臺中市,西屯區,0635,639,350,989,103,1092,1877,58.18%,34.04%,1
臺中市,西屯區,0636,503,373,876,51,927,1697,54.63%,29.64%,1
臺中市,西屯區,0637,495,352,847,60,907,1480,61.28%,33.45%,1
臺中市,西屯區,0638,524,360,884,85,969,1483,65.34%,35.33%,1
臺中市,西屯區,0639,515,328,843,60,903,2484,36.35%,20.73%,1
臺中市,西屯區,0640,283,173,456,68,524,781,67.09%,36.24%,1
臺中市,西屯區,0641,539,297,836,59,895,1477,60.6%,36.49%,1
臺中市,西屯區,0642,550,391,941,60,1001,1784,56.11%,30.83%,1
臺中市,西屯區,0643,570,342,912,54,966,1686,57.3%,33.81%,1
臺中市,西屯區,0644,574,343,917,56,973,1692,57.51%,33.92%,1
臺中市,西屯區,0645,570,279,849,52,901,1659,54.31%,34.36%,1
臺中市,西屯區,0646,476,420,896,52,948,1648,57.52%,28.88%,1
臺中市,西屯區,0647,552,333,885,61,946,1536,61.59%,35.94%,1
臺中市,西屯區,0648,538,382,920,77,997,1666,59.84%,32.29%,1
臺中市,西屯區,0649,480,302,782,66,848,1428,59.38%,33.61%,1
臺中市,西屯區,0650,555,369,924,70,994,1810,54.92%,30.66%,1
臺中市,西屯區,0651,491,344,835,59,894,1574,56.8%,31.19%,1
臺中市,西屯區,0652,553,336,889,47,936,1650,56.73%,33.52%,1
臺中市,西屯區,0653,544,342,886,91,977,1681,58.12%,32.36%,1
臺中市,西屯區,0654,522,323,845,77,922,1656,55.68%,31.52%,1
臺中市,西屯區,0655,408,254,662,97,759,1243,61.06%,32.82%,1
臺中市,西屯區,0656,535,336,871,78,949,1471,64.51%,36.37%,1
臺中市,西屯區,0657,528,317,845,51,896,1431,62.61%,36.9%,1
臺中市,西屯區,0658,540,358,898,80,978,1714,57.06%,31.51%,1
臺中市,西屯區,0659,475,277,752,88,840,1424,58.99%,33.36%,1
臺中市,西屯區,0660,367,269,636,65,701,1176,59.61%,31.21%,1
臺中市,西屯區,0661,477,304,781,102,883,1456,60.65%,32.76%,1
臺中市,西屯區,0662,543,306,849,67,916,1451,63.13%,37.42%,1
臺中市,西屯區,0663,406,242,648,49,697,1063,65.57%,38.19%,1
臺中市,西屯區,0664,426,305,731,68,799,1357,58.88%,31.39%,1
臺中市,西屯區,0665,493,248,741,99,840,1355,61.99%,36.38%,1
臺中市,西屯區,0666,559,247,806,48,854,1384,61.71%,40.39%,1
臺中市,西屯區,0667,639,250,889,78,967,1613,59.95%,39.62%,1
臺中市,西屯區,0668,512,315,827,74,901,1562,57.68%,32.78%,1
臺中市,西屯區,0669,418,297,715,86,801,1219,65.71%,34.29%,1
臺中市,西屯區,0670,373,282,655,65,720,1235,58.3%,30.2%,1
臺中市,西屯區,0671,330,273,603,78,681,1131,60.21%,29.18%,1
臺中市,西屯區,0672,537,333,870,69,939,1494,62.85%,35.94%,1
臺中市,西屯區,0673,434,263,697,80,777,1325,58.64%,32.75%,1
臺中市,西屯區,0674,447,323,770,62,832,1386,60.03%,32.25%,1
臺中市,西屯區,0675,615,358,973,99,1072,1816,59.03%,33.87%,1
臺中市,西屯區,0676,538,336,874,61,935,1734,53.92%,31.03%,1
臺中市,西屯區,0677,577,384,961,91,1052,1777,59.2%,32.47%,1
臺中市,西屯區,0678,559,352,911,84,995,1818,54.73%,30.75%,1
臺中市,西屯區,0679,568,295,863,104,967,1699,56.92%,33.43%,1
臺中市,西屯區,0680,491,341,832,58,890,1715,51.9%,28.63%,1
臺中市,西屯區,0681,533,322,855,45,900,1654,54.41%,32.22%,1
臺中市,西屯區,0682,560,285,845,47,892,1636,54.52%,34.23%,1
臺中市,西屯區,0683,371,293,664,53,717,1298,55.24%,28.58%,1
臺中市,西屯區,0684,154,597,751,87,838,1391,60.24%,11.07%,1
臺中市,西屯區,0685,605,398,1003,88,1091,1853,58.88%,32.65%,1
臺中市,西屯區,0686,569,345,914,96,1010,1820,55.49%,31.26%,1
臺中市,西屯區,0687,577,395,972,81,1053,1809,58.21%,31.9%,1
臺中市,西屯區,0688,463,311,774,72,846,1352,62.57%,34.25%,1
臺中市,西屯區,0689,479,300,779,103,882,1521,57.99%,31.49%,1
臺中市,西屯區,0690,496,364,860,49,909,1486,61.17%,33.38%,1
臺中市,西屯區,0691,530,330,860,88,948,1674,56.63%,31.66%,1
臺中市,西屯區,0692,563,359,922,85,1007,1610,62.55%,34.97%,1
臺中市,西屯區,0693,570,354,924,67,991,1695,58.47%,33.63%,1
臺中市,西屯區,0694,587,285,872,77,949,1684,56.35%,34.86%,1
臺中市,西屯區,0695,395,298,693,48,741,1221,60.69%,32.35%,1
臺中市,西屯區,0696,460,317,777,77,854,1252,68.21%,36.74%,1
臺中市,西屯區,0697,417,312,729,84,813,1301,62.49%,32.05%,1
臺中市,西屯區,0698,401,216,617,53,670,1049,63.87%,38.23%,1
臺中市,西屯區,0699,408,197,605,70,675,1113,60.65%,36.66%,1
臺中市,西屯區,0700,482,284,766,91,857,1557,55.04%,30.96%,1
臺中市,西屯區,0701,512,312,824,88,912,1640,55.61%,31.22%,1
臺中市,西屯區,0702,471,353,824,112,936,1402,66.76%,33.59%,1
臺中市,西屯區,0703,496,312,808,99,907,1717,52.82%,28.89%,1
臺中市,西屯區,0704,442,341,783,100,883,1688,52.31%,26.18%,1
臺中市,西屯區,0705,321,250,571,147,718,1168,61.47%,27.48%,1
臺中市,西屯區,0706,519,345,864,79,943,1729,54.54%,30.02%,1
臺中市,西屯區,0707,609,361,970,92,1062,2007,52.91%,30.34%,1
臺中市,西屯區,0708,420,266,686,113,799,1296,61.65%,32.41%,1
臺中市,西屯區,0709,287,201,488,49,537,1068,50.28%,26.87%,1
臺中市,西屯區,0710,480,288,768,140,908,1707,53.19%,28.12%,1
臺中市,西屯區,0711,555,348,903,75,978,1636,59.78%,33.92%,1
臺中市,西屯區,0712,478,302,780,71,851,1761,48.32%,27.14%,1
臺中市,西屯區,0713,394,287,681,87,768,1314,58.45%,29.98%,1
臺中市,西屯區,0714,445,276,721,66,787,1233,63.83%,36.09%,1
臺中市,西屯區,0715,472,316,788,68,856,1549,55.26%,30.47%,1
臺中市,西屯區,0716,525,292,817,55,872,1639,53.2%,32.03%,1
臺中市,西屯區,0717,432,305,737,80,817,1486,54.98%,29.07%,1
臺中市,西屯區,0718,563,369,932,54,986,1806,54.6%,31.17%,1
臺中市,西屯區,0719,469,287,756,36,792,1451,54.58%,32.32%,1
臺中市,西屯區,0720,422,287,709,62,771,1302,59.22%,32.41%,1
臺中市,西屯區,0721,503,272,775,72,847,1353,62.6%,37.18%,1
臺中市,西屯區,0722,739,438,1177,84,1261,2162,58.33%,34.18%,1
臺中市,西屯區,0723,491,338,829,40,869,1520,57.17%,32.3%,1
臺中市,西屯區,0724,607,393,1000,58,1058,1935,54.68%,31.37%,1
臺中市,西屯區,0725,599,349,948,85,1033,1847,55.93%,32.43%,1
臺中市,西屯區,0726,591,373,964,45,1009,1738,58.06%,34%,1
臺中市,西屯區,0727,563,363,926,81,1007,1640,61.4%,34.33%,1
臺中市,西屯區,0728,656,386,1042,58,1100,1908,57.65%,34.38%,1
臺中市,西屯區,0729,475,284,759,56,815,1402,58.13%,33.88%,1
臺中市,西屯區,0730,458,288,746,67,813,1515,53.66%,30.23%,1
臺中市,西屯區,0731,420,266,686,56,742,1541,48.15%,27.26%,1
臺中市,西屯區,0732,473,298,771,64,835,1502,55.59%,31.49%,1
臺中市,西屯區,0733,472,338,810,120,930,1526,60.94%,30.93%,1
臺中市,西屯區,0734,454,322,776,98,874,1425,61.33%,31.86%,1
臺中市,西屯區,0735,454,308,762,57,819,1334,61.39%,34.03%,1
臺中市,西屯區,0736,537,383,920,75,995,1649,60.34%,32.57%,1
臺中市,西屯區,0737,479,300,779,70,849,1566,54.21%,30.59%,1
臺中市,西屯區,0738,553,377,930,65,995,1629,61.08%,33.95%,1
臺中市,西屯區,0739,579,329,908,57,965,1628,59.28%,35.57%,1
臺中市,西屯區,0740,527,301,828,61,889,1442,61.65%,36.55%,1
臺中市,西屯區,0741,351,254,605,67,672,1206,55.72%,29.1%,1
臺中市,西屯區,0742,341,255,596,91,687,1086,63.26%,31.4%,1
臺中市,西屯區,0743,358,249,607,73,680,1088,62.5%,32.9%,1
臺中市,西屯區,0744,395,235,630,47,677,1140,59.39%,34.65%,1
臺中市,南屯區,0745,460,267,727,79,806,1321,61.01%,34.82%,1
臺中市,南屯區,0746,419,341,760,83,843,1346,62.63%,31.13%,1
臺中市,南屯區,0747,463,329,792,70,862,1428,60.36%,32.42%,1
臺中市,南屯區,0748,487,288,775,53,828,1442,57.42%,33.77%,1
臺中市,南屯區,0749,513,356,869,40,909,1408,64.56%,36.43%,1
臺中市,南屯區,0750,486,328,814,47,861,1404,61.32%,34.62%,1
臺中市,南屯區,0751,489,319,808,54,862,1354,63.66%,36.12%,1
臺中市,南屯區,0752,466,300,766,70,836,1332,62.76%,34.98%,1
臺中市,南屯區,0753,499,361,860,65,925,1463,63.23%,34.11%,1
臺中市,南屯區,0754,467,310,777,80,857,1413,60.65%,33.05%,1
臺中市,南屯區,0755,455,296,751,33,784,1218,64.37%,37.36%,1
臺中市,南屯區,0756,386,299,685,58,743,1308,56.8%,29.51%,1
臺中市,南屯區,0757,504,374,878,82,960,1527,62.87%,33.01%,1
臺中市,南屯區,0758,460,291,751,59,810,1294,62.6%,35.55%,1
臺中市,南屯區,0759,448,289,737,76,813,1516,53.63%,29.55%,1
臺中市,南屯區,0760,490,318,808,147,955,1529,62.46%,32.05%,1
臺中市,南屯區,0761,453,329,782,78,860,1397,61.56%,32.43%,1
臺中市,南屯區,0762,357,380,737,54,791,1406,56.26%,25.39%,1
臺中市,南屯區,0763,435,307,742,85,827,1497,55.24%,29.06%,1
臺中市,南屯區,0764,419,298,717,101,818,1424,57.44%,29.42%,1
臺中市,南屯區,0765,401,244,645,84,729,1488,48.99%,26.95%,1
臺中市,南屯區,0766,210,143,353,54,407,608,66.94%,34.54%,1
臺中市,南屯區,0767,254,185,439,91,530,813,65.19%,31.24%,1
臺中市,南屯區,0768,373,273,646,87,733,1190,61.6%,31.34%,1
臺中市,南屯區,0769,360,266,626,41,667,1174,56.81%,30.66%,1
臺中市,南屯區,0770,415,273,688,14,702,1224,57.35%,33.91%,1
臺中市,南屯區,0771,409,245,654,66,720,1466,49.11%,27.9%,1
臺中市,南屯區,0772,314,120,434,39,473,1333,35.48%,23.56%,1
臺中市,南屯區,0773,279,171,450,72,522,814,64.13%,34.28%,1
臺中市,南屯區,0774,439,252,691,103,794,1436,55.29%,30.57%,1
臺中市,南屯區,0775,496,317,813,94,907,1515,59.87%,32.74%,1
臺中市,南屯區,0776,404,273,677,122,799,1545,51.72%,26.15%,1
臺中市,南屯區,0777,446,298,744,70,814,1383,58.86%,32.25%,1
臺中市,南屯區,0778,381,424,805,61,866,1433,60.43%,26.59%,1
臺中市,南屯區,0779,304,265,569,55,624,1134,55.03%,26.81%,1
臺中市,南屯區,0780,399,306,705,56,761,1216,62.58%,32.81%,1
臺中市,南屯區,0781,394,243,637,99,736,1271,57.91%,31%,1
臺中市,南屯區,0782,341,262,603,62,665,1203,55.28%,28.35%,1
臺中市,南屯區,0783,420,266,686,56,742,1268,58.52%,33.12%,1
臺中市,南屯區,0784,446,302,748,85,833,1390,59.93%,32.09%,1
臺中市,南屯區,0785,425,309,734,77,811,1397,58.05%,30.42%,1
臺中市,南屯區,0786,472,357,829,94,923,1607,57.44%,29.37%,1
臺中市,南屯區,0787,542,336,878,68,946,1582,59.8%,34.26%,1
臺中市,南屯區,0788,561,361,922,51,973,1611,60.4%,34.82%,1
臺中市,南屯區,0789,488,287,775,66,841,1322,63.62%,36.91%,1
臺中市,南屯區,0790,493,303,796,67,863,1321,65.33%,37.32%,1
臺中市,南屯區,0791,458,302,760,55,815,1360,59.93%,33.68%,1
臺中市,南屯區,0792,482,308,790,34,824,1361,60.54%,35.42%,1
臺中市,南屯區,0793,456,273,729,56,785,1257,62.45%,36.28%,1
臺中市,南屯區,0794,429,302,731,53,784,1207,64.95%,35.54%,1
臺中市,南屯區,0795,400,378,778,42,820,1282,63.96%,31.2%,1
臺中市,南屯區,0796,477,294,771,50,821,1248,65.79%,38.22%,1
臺中市,南屯區,0797,475,318,793,60,853,1304,65.41%,36.43%,1
臺中市,南屯區,0798,424,279,703,42,745,1214,61.37%,34.93%,1
臺中市,南屯區,0799,382,255,637,74,711,1102,64.52%,34.66%,1
臺中市,南屯區,0800,691,301,992,61,1053,1630,64.6%,42.39%,1
臺中市,南屯區,0801,494,291,785,47,832,1333,62.42%,37.06%,1
臺中市,南屯區,0802,448,316,764,56,820,1292,63.47%,34.67%,1
臺中市,南屯區,0803,443,275,718,70,788,1272,61.95%,34.83%,1
臺中市,南屯區,0804,489,287,776,49,825,1345,61.34%,36.36%,1
臺中市,南屯區,0805,338,229,567,125,692,981,70.54%,34.45%,1
臺中市,南屯區,0806,393,235,628,75,703,1097,64.08%,35.82%,1
臺中市,南屯區,0807,404,207,611,39,650,991,65.59%,40.77%,1
臺中市,南屯區,0808,416,249,665,50,715,1170,61.11%,35.56%,1
臺中市,南屯區,0809,413,291,704,48,752,1171,64.22%,35.27%,1
臺中市,南屯區,0810,442,289,731,83,814,1349,60.34%,32.77%,1
臺中市,南屯區,0811,504,324,828,46,874,1368,63.89%,36.84%,1
臺中市,南屯區,0812,469,293,762,57,819,1263,64.85%,37.13%,1
臺中市,南屯區,0813,558,341,899,73,972,1547,62.83%,36.07%,1
臺中市,南屯區,0814,564,337,901,96,997,1649,60.46%,34.2%,1
臺中市,南屯區,0815,563,299,862,63,925,1629,56.78%,34.56%,1
臺中市,南屯區,0816,454,317,771,85,856,1580,54.18%,28.73%,1
臺中市,南屯區,0817,534,351,885,61,946,1444,65.51%,36.98%,1
臺中市,南屯區,0818,479,298,777,47,824,1413,58.32%,33.9%,1
臺中市,南屯區,0819,446,291,737,72,809,1377,58.75%,32.39%,1
臺中市,南屯區,0820,528,351,879,48,927,1527,60.71%,34.58%,1
臺中市,南屯區,0821,491,288,779,63,842,1335,63.07%,36.78%,1
臺中市,南屯區,0822,562,421,983,52,1035,1544,67.03%,36.4%,1
臺中市,南屯區,0823,488,409,897,74,971,1482,65.52%,32.93%,1
臺中市,南屯區,0824,494,327,821,107,928,1488,62.37%,33.2%,1
臺中市,南屯區,0825,449,288,737,76,813,1538,52.86%,29.19%,1
臺中市,南屯區,0826,580,396,976,83,1059,1674,63.26%,34.65%,1
臺中市,南屯區,0827,501,291,792,71,863,1996,43.24%,25.1%,1
臺中市,南屯區,0828,527,297,824,100,924,1514,61.03%,34.81%,1
臺中市,南屯區,0829,437,263,700,90,790,1217,64.91%,35.91%,1
臺中市,南屯區,0830,438,306,744,62,806,1347,59.84%,32.52%,1
臺中市,南屯區,0831,406,229,635,57,692,1109,62.4%,36.61%,1
臺中市,南屯區,0832,503,343,846,52,898,1546,58.09%,32.54%,1
臺中市,南屯區,0833,501,337,838,68,906,1408,64.35%,35.58%,1
臺中市,南屯區,0834,314,227,541,48,589,1057,55.72%,29.71%,1
臺中市,南屯區,0835,375,257,632,62,694,1133,61.25%,33.1%,1
臺中市,南屯區,0836,439,269,708,66,774,1278,60.56%,34.35%,1
臺中市,南屯區,0837,399,291,690,66,756,1144,66.08%,34.88%,1
臺中市,南屯區,0838,373,271,644,60,704,1140,61.75%,32.72%,1
臺中市,南屯區,0839,421,265,686,52,738,1171,63.02%,35.95%,1
臺中市,南屯區,0840,468,316,784,52,836,1303,64.16%,35.92%,1
臺中市,南屯區,0841,419,309,728,59,787,1402,56.13%,29.89%,1
臺中市,南屯區,0842,521,326,847,74,921,1571,58.63%,33.16%,1
臺中市,南屯區,0843,394,294,688,48,736,1139,64.62%,34.59%,1
臺中市,南屯區,0844,412,314,726,56,782,1216,64.31%,33.88%,1
臺中市,南屯區,0845,439,254,693,48,741,1162,63.77%,37.78%,1
臺中市,北屯區,0846,617,353,970,93,1063,1670,63.65%,36.95%,1
臺中市,北屯區,0847,526,311,837,95,932,1706,54.63%,30.83%,1
臺中市,北屯區,0848,488,270,758,98,856,1507,56.8%,32.38%,1
臺中市,北屯區,0849,572,333,905,81,986,1652,59.69%,34.62%,1
臺中市,北屯區,0850,340,217,557,39,596,1107,53.84%,30.71%,1
臺中市,北屯區,0851,653,395,1048,110,1158,2151,53.84%,30.36%,1
臺中市,北屯區,0852,547,371,918,51,969,1612,60.11%,33.93%,1
臺中市,北屯區,0853,553,354,907,74,981,1743,56.28%,31.73%,1
臺中市,北屯區,0854,624,419,1043,73,1116,2099,53.17%,29.73%,1
臺中市,北屯區,0855,560,302,862,49,911,1595,57.12%,35.11%,1
臺中市,北屯區,0856,572,355,927,93,1020,1923,53.04%,29.75%,1
臺中市,北屯區,0857,497,326,823,79,902,1641,54.97%,30.29%,1
臺中市,北屯區,0858,422,270,692,52,744,1157,64.3%,36.47%,1
臺中市,北屯區,0859,396,209,605,60,665,1041,63.88%,38.04%,1
臺中市,北屯區,0860,474,304,778,69,847,1563,54.19%,30.33%,1
臺中市,北屯區,0861,447,296,743,96,839,1559,53.82%,28.67%,1
臺中市,北屯區,0862,422,254,676,34,710,1411,50.32%,29.91%,1
臺中市,北屯區,0863,597,390,987,57,1044,1761,59.28%,33.9%,1
臺中市,北屯區,0864,474,296,770,95,865,1361,63.56%,34.83%,1
臺中市,北屯區,0865,554,378,932,123,1055,1852,56.97%,29.91%,1
臺中市,北屯區,0866,636,412,1048,67,1115,1928,57.83%,32.99%,1
臺中市,北屯區,0867,535,369,904,58,962,1492,64.48%,35.86%,1
臺中市,北屯區,0868,633,351,984,117,1101,1998,55.11%,31.68%,1
臺中市,北屯區,0869,447,320,767,60,827,1272,65.02%,35.14%,1
臺中市,北屯區,0870,446,307,753,56,809,1317,61.43%,33.86%,1
臺中市,北屯區,0871,352,283,635,90,725,1327,54.63%,26.53%,1
臺中市,北屯區,0872,391,252,643,40,683,1280,53.36%,30.55%,1
臺中市,北屯區,0873,564,350,914,69,983,1865,52.71%,30.24%,1
臺中市,北屯區,0874,499,230,729,57,786,1230,63.9%,40.57%,1
臺中市,北屯區,0875,417,255,672,62,734,1356,54.13%,30.75%,1
臺中市,北屯區,0876,581,331,912,74,986,1732,56.93%,33.55%,1
臺中市,北屯區,0877,543,332,875,75,950,1586,59.9%,34.24%,1
臺中市,北屯區,0878,457,290,747,65,812,1441,56.35%,31.71%,1
臺中市,北屯區,0879,574,429,1003,106,1109,2045,54.23%,28.07%,1
臺中市,北屯區,0880,565,352,917,94,1011,1914,52.82%,29.52%,1
臺中市,北屯區,0881,528,391,919,61,980,1918,51.09%,27.53%,1
臺中市,北屯區,0882,644,387,1031,53,1084,2079,52.14%,30.98%,1
臺中市,北屯區,0883,635,426,1061,94,1155,2040,56.62%,31.13%,1
臺中市,北屯區,0884,615,343,958,51,1009,2027,49.78%,30.34%,1
臺中市,北屯區,0885,445,282,727,62,789,1402,56.28%,31.74%,1
臺中市,北屯區,0886,378,601,979,88,1067,1826,58.43%,20.7%,1
臺中市,北屯區,0887,633,390,1023,75,1098,2162,50.79%,29.28%,1
臺中市,北屯區,0888,633,425,1058,42,1100,2332,47.17%,27.14%,1
臺中市,北屯區,0889,324,194,518,63,581,985,58.98%,32.89%,1
臺中市,北屯區,0890,546,405,951,57,1008,2037,49.48%,26.8%,1
臺中市,北屯區,0891,328,250,578,56,634,1032,61.43%,31.78%,1
臺中市,北屯區,0892,373,207,580,48,628,1062,59.13%,35.12%,1
臺中市,北屯區,0893,275,187,462,62,524,909,57.65%,30.25%,1
臺中市,北屯區,0894,498,298,796,78,874,1445,60.48%,34.46%,1
臺中市,北屯區,0895,514,469,983,74,1057,1842,57.38%,27.9%,1
臺中市,北屯區,0896,408,245,653,64,717,1187,60.4%,34.37%,1
臺中市,北屯區,0897,479,291,770,72,842,1456,57.83%,32.9%,1
臺中市,北屯區,0898,654,335,989,83,1072,1866,57.45%,35.05%,1
臺中市,北屯區,0899,521,326,847,59,906,1667,54.35%,31.25%,1
臺中市,北屯區,0900,572,365,937,40,977,1683,58.05%,33.99%,1
臺中市,北屯區,0901,508,337,845,69,914,1642,55.66%,30.94%,1
臺中市,北屯區,0902,473,343,816,41,857,1475,58.1%,32.07%,1
臺中市,北屯區,0903,527,314,841,58,899,1644,54.68%,32.06%,1
臺中市,北屯區,0904,545,357,902,51,953,1603,59.45%,34%,1
臺中市,北屯區,0905,707,385,1092,69,1161,1949,59.57%,36.28%,1
臺中市,北屯區,0906,686,357,1043,87,1130,1790,63.13%,38.32%,1
臺中市,北屯區,0907,457,327,784,67,851,1440,59.1%,31.74%,1
臺中市,北屯區,0908,521,369,890,89,979,1601,61.15%,32.54%,1
臺中市,北屯區,0909,465,321,786,75,861,1527,56.39%,30.45%,1
臺中市,北屯區,0910,502,318,820,74,894,1675,53.37%,29.97%,1
臺中市,北屯區,0911,452,287,739,76,815,1579,51.61%,28.63%,1
臺中市,北屯區,0912,466,319,785,100,885,1524,58.07%,30.58%,1
臺中市,北屯區,0913,527,311,838,81,919,1677,54.8%,31.43%,1
臺中市,北屯區,0914,512,321,833,73,906,1599,56.66%,32.02%,1
臺中市,北屯區,0915,499,300,799,87,886,1458,60.77%,34.22%,1
臺中市,北屯區,0916,538,334,872,74,946,1571,60.22%,34.25%,1
臺中市,北屯區,0917,510,340,850,95,945,1579,59.85%,32.3%,1
臺中市,北屯區,0918,542,460,1002,90,1092,1849,59.06%,29.31%,1
臺中市,北屯區,0919,572,315,887,81,968,1682,57.55%,34.01%,1
臺中市,北屯區,0920,539,335,874,95,969,1760,55.06%,30.63%,1
臺中市,北屯區,0921,533,363,896,99,995,1699,58.56%,31.37%,1
臺中市,北屯區,0922,584,349,933,74,1007,1626,61.93%,35.92%,1
臺中市,北屯區,0923,506,342,848,11,859,1491,57.61%,33.94%,1
臺中市,北屯區,0924,496,354,850,63,913,1640,55.67%,30.24%,1
臺中市,北屯區,0925,640,387,1027,104,1131,2052,55.12%,31.19%,1
臺中市,北屯區,0926,597,406,1003,60,1063,1875,56.69%,31.84%,1
臺中市,北屯區,0927,496,322,818,55,873,1559,56%,31.82%,1
臺中市,北屯區,0928,450,323,773,110,883,1480,59.66%,30.41%,1
臺中市,北屯區,0929,465,308,773,64,837,1397,59.91%,33.29%,1
臺中市,北屯區,0930,597,410,1007,86,1093,1889,57.86%,31.6%,1
臺中市,北屯區,0931,532,346,878,100,978,1728,56.6%,30.79%,1
臺中市,北屯區,0932,462,328,790,104,894,1592,56.16%,29.02%,1
臺中市,北屯區,0933,510,303,813,105,918,1656,55.43%,30.8%,1
臺中市,北屯區,0934,445,300,745,91,836,1524,54.86%,29.2%,1
臺中市,北屯區,0935,464,353,817,62,879,1502,58.52%,30.89%,1
臺中市,北屯區,0936,497,440,937,49,986,1772,55.64%,28.05%,1
臺中市,北屯區,0937,500,310,810,64,874,1461,59.82%,34.22%,1
臺中市,北屯區,0938,561,296,857,46,903,1769,51.05%,31.71%,1
臺中市,北屯區,0939,647,413,1060,75,1135,1894,59.93%,34.16%,1
臺中市,北屯區,0940,612,376,988,81,1069,2033,52.58%,30.1%,1
臺中市,北屯區,0941,599,376,975,94,1069,1947,54.9%,30.77%,1
臺中市,北屯區,0942,712,483,1195,61,1256,2188,57.4%,32.54%,1
臺中市,北屯區,0943,659,245,904,102,1006,1661,60.57%,39.67%,1
臺中市,北屯區,0944,575,344,919,50,969,1667,58.13%,34.49%,1
臺中市,北屯區,0945,548,340,888,81,969,1728,56.08%,31.71%,1
臺中市,北屯區,0946,500,360,860,59,919,1688,54.44%,29.62%,1
臺中市,北屯區,0947,490,295,785,61,846,1475,57.36%,33.22%,1
臺中市,北屯區,0948,600,368,968,57,1025,1681,60.98%,35.69%,1
臺中市,北屯區,0949,737,400,1137,86,1223,2078,58.85%,35.47%,1
臺中市,北屯區,0950,695,283,978,84,1062,2059,51.58%,33.75%,1
臺中市,北屯區,0951,579,378,957,94,1051,1792,58.65%,32.31%,1
臺中市,北屯區,0952,595,385,980,70,1050,2974,35.31%,20.01%,1
臺中市,北屯區,0953,347,201,548,79,627,1072,58.49%,32.37%,1
臺中市,北屯區,0954,788,449,1237,85,1322,2099,62.98%,37.54%,1
臺中市,北屯區,0955,657,415,1072,90,1162,1823,63.74%,36.04%,1
臺中市,北屯區,0956,700,434,1134,100,1234,2022,61.03%,34.62%,1
臺中市,北屯區,0957,641,427,1068,62,1130,1992,56.73%,32.18%,1
臺中市,北屯區,0958,537,373,910,71,981,1585,61.89%,33.88%,1
臺中市,北屯區,0959,543,349,892,69,961,1565,61.41%,34.7%,1
臺中市,北屯區,0960,544,308,852,57,909,1780,51.07%,30.56%,1
臺中市,北屯區,0961,674,404,1078,77,1155,1874,61.63%,35.97%,1
臺中市,北屯區,0962,638,341,979,70,1049,1755,59.77%,36.35%,1
臺中市,北屯區,0963,590,339,929,75,1004,1497,67.07%,39.41%,1
臺中市,北屯區,0964,559,349,908,81,989,1567,63.11%,35.67%,1
臺中市,北屯區,0965,543,295,838,76,914,1624,56.28%,33.44%,1
臺中市,北屯區,0966,600,311,911,81,992,1614,61.46%,37.17%,1
臺中市,北屯區,0967,546,293,839,74,913,1595,57.24%,34.23%,1
臺中市,北屯區,0968,552,318,870,87,957,1782,53.7%,30.98%,1
臺中市,北屯區,0969,359,273,632,61,693,1357,51.07%,26.46%,1
臺中市,北屯區,0970,357,206,563,62,625,1071,58.36%,33.33%,1
臺中市,北屯區,0971,427,256,683,76,759,1372,55.32%,31.12%,1
臺中市,北屯區,0972,496,268,764,83,847,1415,59.86%,35.05%,1
臺中市,北屯區,0973,626,383,1009,101,1110,1789,62.05%,34.99%,1
臺中市,北屯區,0974,695,381,1076,118,1194,1907,62.61%,36.44%,1
臺中市,北屯區,0975,722,371,1093,93,1186,2008,59.06%,35.96%,1
臺中市,北屯區,0976,506,291,797,81,878,1541,56.98%,32.84%,1
臺中市,北屯區,0977,578,336,914,82,996,1669,59.68%,34.63%,1
臺中市,北屯區,0978,595,308,903,52,955,1685,56.68%,35.31%,1
臺中市,北屯區,0979,570,397,967,85,1052,1785,58.94%,31.93%,1
臺中市,北屯區,0980,515,363,878,102,980,1596,61.4%,32.27%,1
臺中市,北屯區,0981,618,335,953,91,1044,1731,60.31%,35.7%,1
臺中市,北屯區,0982,481,290,771,79,850,1496,56.82%,32.15%,1
臺中市,豐原區,0394,297,201,498,65,563,983,57.27%,30.21%,1
臺中市,豐原區,0395,426,313,739,43,782,1309,59.74%,32.54%,1
臺中市,豐原區,0396,338,279,617,72,689,1116,61.74%,30.29%,1
臺中市,豐原區,0397,304,250,554,56,610,945,64.55%,32.17%,1
臺中市,豐原區,0398,244,217,461,83,544,850,64%,28.71%,1
臺中市,豐原區,0399,267,179,446,44,490,760,64.47%,35.13%,1
臺中市,豐原區,0400,545,345,890,2,892,1617,55.16%,33.7%,1
臺中市,豐原區,0401,515,305,820,71,891,1677,53.13%,30.71%,1
臺中市,豐原區,0402,681,390,1071,56,1127,1771,63.64%,38.45%,1
臺中市,豐原區,0403,327,298,625,44,669,1145,58.43%,28.56%,1
臺中市,豐原區,0404,413,290,703,66,769,1362,56.46%,30.32%,1
臺中市,豐原區,0405,484,292,776,65,841,1389,60.55%,34.85%,1
臺中市,豐原區,0406,521,331,852,85,937,1530,61.24%,34.05%,1
臺中市,豐原區,0407,436,308,744,141,885,1471,60.16%,29.64%,1
臺中市,豐原區,0408,438,328,766,102,868,1410,61.56%,31.06%,1
臺中市,豐原區,0409,354,249,603,68,671,1162,57.75%,30.46%,1
臺中市,豐原區,0410,508,381,889,64,953,1656,57.55%,30.68%,1
臺中市,豐原區,0411,586,379,965,79,1044,1838,56.8%,31.88%,1
臺中市,豐原區,0412,507,344,851,105,956,1666,57.38%,30.43%,1
臺中市,豐原區,0413,605,380,985,108,1093,1821,60.02%,33.22%,1
臺中市,豐原區,0414,675,439,1114,96,1210,1821,66.45%,37.07%,1
臺中市,豐原區,0415,500,336,836,81,917,1647,55.68%,30.36%,1
臺中市,豐原區,0416,395,341,736,107,843,1256,67.12%,31.45%,1
臺中市,豐原區,0417,551,354,905,94,999,1552,64.37%,35.5%,1
臺中市,豐原區,0418,592,389,981,66,1047,1793,58.39%,33.02%,1
臺中市,豐原區,0419,269,219,488,50,538,759,70.88%,35.44%,1
臺中市,豐原區,0420,202,178,380,42,422,642,65.73%,31.46%,1
臺中市,豐原區,0421,484,380,864,44,908,1528,59.42%,31.68%,1
臺中市,豐原區,0422,628,425,1053,89,1142,1788,63.87%,35.12%,1
臺中市,豐原區,0423,566,398,964,110,1074,1663,64.58%,34.03%,1
臺中市,豐原區,0424,470,334,804,73,877,1260,69.6%,37.3%,1
臺中市,豐原區,0425,285,199,484,41,525,902,58.2%,31.6%,1
臺中市,豐原區,0426,412,281,693,40,733,1357,54.02%,30.36%,1
臺中市,豐原區,0427,577,325,902,60,962,1592,60.43%,36.24%,1
臺中市,豐原區,0428,626,382,1008,95,1103,1873,58.89%,33.42%,1
臺中市,豐原區,0429,601,375,976,100,1076,1867,57.63%,32.19%,1
臺中市,豐原區,0430,548,382,930,134,1064,1823,58.37%,30.06%,1
臺中市,豐原區,0431,577,363,940,89,1029,1962,52.45%,29.41%,1
臺中市,豐原區,0432,757,545,1302,116,1418,2313,61.31%,32.73%,1
臺中市,豐原區,0433,514,331,845,93,938,1510,62.12%,34.04%,1
臺中市,豐原區,0434,605,415,1020,78,1098,1824,60.2%,33.17%,1
臺中市,豐原區,0435,449,305,754,60,814,1363,59.72%,32.94%,1
臺中市,豐原區,0436,537,363,900,75,975,1535,63.52%,34.98%,1
臺中市,豐原區,0437,474,357,831,84,915,1457,62.8%,32.53%,1
臺中市,豐原區,0438,361,305,666,66,732,1184,61.82%,30.49%,1
臺中市,豐原區,0439,635,401,1036,83,1119,2299,48.67%,27.62%,1
臺中市,豐原區,0440,936,107,1043,111,1154,1940,59.48%,48.25%,1
臺中市,豐原區,0441,653,440,1093,64,1157,2067,55.97%,31.59%,1
臺中市,豐原區,0442,683,407,1090,71,1161,2038,56.97%,33.51%,1
臺中市,豐原區,0443,543,442,985,72,1057,1835,57.6%,29.59%,1
臺中市,豐原區,0444,622,421,1043,98,1141,1979,57.66%,31.43%,1
臺中市,豐原區,0445,647,379,1026,135,1161,2014,57.65%,32.13%,1
臺中市,豐原區,0446,739,474,1213,107,1320,2257,58.48%,32.74%,1
臺中市,豐原區,0447,484,316,800,87,887,1406,63.09%,34.42%,1
臺中市,豐原區,0448,467,341,808,56,864,1418,60.93%,32.93%,1
臺中市,豐原區,0449,625,405,1030,92,1122,1772,63.32%,35.27%,1
臺中市,豐原區,0450,422,293,715,54,769,1202,63.98%,35.11%,1
臺中市,豐原區,0451,501,352,853,46,899,1447,62.13%,34.62%,1
臺中市,豐原區,0452,571,398,969,117,1086,1758,61.77%,32.48%,1
臺中市,豐原區,0453,538,365,903,84,987,1546,63.84%,34.8%,1
臺中市,豐原區,0454,654,379,1033,94,1127,1815,62.09%,36.03%,1
臺中市,豐原區,0455,650,439,1089,82,1171,1932,60.61%,33.64%,1
臺中市,豐原區,0456,625,438,1063,73,1136,1770,64.18%,35.31%,1
臺中市,豐原區,0457,495,318,813,56,869,1560,55.71%,31.73%,1
臺中市,豐原區,0458,611,354,965,90,1055,1810,58.29%,33.76%,1
臺中市,豐原區,0459,574,382,956,89,1045,1653,63.22%,34.72%,1
臺中市,豐原區,0460,465,319,784,74,858,1444,59.42%,32.2%,1
臺中市,豐原區,0461,466,317,783,56,839,1318,63.66%,35.36%,1
臺中市,豐原區,0462,516,333,849,105,954,1566,60.92%,32.95%,1
臺中市,豐原區,0463,591,349,940,76,1016,1748,58.12%,33.81%,1
臺中市,豐原區,0464,493,352,845,112,957,1772,54.01%,27.82%,1
臺中市,豐原區,0465,536,370,906,116,1022,1721,59.38%,31.14%,1
臺中市,豐原區,0466,517,369,886,66,952,1578,60.33%,32.76%,1
臺中市,豐原區,0467,585,371,956,131,1087,1859,58.47%,31.47%,1
臺中市,豐原區,0468,457,346,803,70,873,1479,59.03%,30.9%,1
臺中市,豐原區,0469,627,408,1035,68,1103,1889,58.39%,33.19%,1
臺中市,豐原區,0470,600,352,952,81,1033,1803,57.29%,33.28%,1
臺中市,豐原區,0471,448,272,720,87,807,1421,56.79%,31.53%,1
臺中市,豐原區,0472,554,354,908,96,1004,1585,63.34%,34.95%,1
臺中市,豐原區,0473,647,359,1006,108,1114,1774,62.8%,36.47%,1
臺中市,豐原區,0474,669,483,1152,106,1258,2132,59.01%,31.38%,1
臺中市,豐原區,0475,466,352,818,90,908,1515,59.93%,30.76%,1
臺中市,豐原區,0476,382,279,661,51,712,1359,52.39%,28.11%,1
臺中市,豐原區,0477,322,242,564,38,602,948,63.5%,33.97%,1
臺中市,豐原區,0478,377,259,636,78,714,1134,62.96%,33.25%,1
臺中市,豐原區,0479,407,262,669,79,748,1114,67.15%,36.54%,1
臺中市,豐原區,0480,324,240,564,76,640,1050,60.95%,30.86%,1
臺中市,豐原區,0481,427,263,690,84,774,1182,65.48%,36.13%,1
臺中市,東勢區,1513,376,255,631,93,724,1299,55.74%,28.95%,1
臺中市,東勢區,1514,296,216,512,61,573,1007,56.9%,29.39%,1
臺中市,東勢區,1515,224,181,405,75,480,859,55.88%,26.08%,1
臺中市,東勢區,1516,347,208,555,94,649,991,65.49%,35.02%,1
臺中市,東勢區,1517,228,168,396,40,436,863,50.52%,26.42%,1
臺中市,東勢區,1518,471,328,799,124,923,1628,56.7%,28.93%,1
臺中市,東勢區,1519,359,262,621,86,707,1335,52.96%,26.89%,1
臺中市,東勢區,1520,264,347,611,87,698,1092,63.92%,24.18%,1
臺中市,東勢區,1521,343,259,602,71,673,1050,64.1%,32.67%,1
臺中市,東勢區,1522,467,273,740,88,828,1431,57.86%,32.63%,1
臺中市,東勢區,1523,455,288,743,79,822,1372,59.91%,33.16%,1
臺中市,東勢區,1524,473,308,781,59,840,1412,59.49%,33.5%,1
臺中市,東勢區,1525,264,161,425,92,517,878,58.88%,30.07%,1
臺中市,東勢區,1526,379,268,647,106,753,1475,51.05%,25.69%,1
臺中市,東勢區,1527,262,167,429,37,466,872,53.44%,30.05%,1
臺中市,東勢區,1528,269,190,459,110,569,1006,56.56%,26.74%,1
臺中市,東勢區,1529,379,255,634,45,679,1222,55.56%,31.01%,1
臺中市,東勢區,1530,430,302,732,76,808,1228,65.8%,35.02%,1
臺中市,東勢區,1531,359,217,576,38,614,1036,59.27%,34.65%,1
臺中市,東勢區,1532,314,232,546,57,603,977,61.72%,32.14%,1
臺中市,東勢區,1533,456,242,698,65,763,1395,54.7%,32.69%,1
臺中市,東勢區,1534,366,253,619,120,739,1169,63.22%,31.31%,1
臺中市,東勢區,1535,346,229,575,67,642,1027,62.51%,33.69%,1
臺中市,東勢區,1536,340,194,534,54,588,984,59.76%,34.55%,1
臺中市,東勢區,1537,346,190,536,52,588,866,67.9%,39.95%,1
臺中市,東勢區,1538,288,210,498,139,637,1031,61.78%,27.93%,1
臺中市,東勢區,1539,331,176,507,69,576,865,66.59%,38.27%,1
臺中市,東勢區,1540,502,276,778,80,858,1357,63.23%,36.99%,1
臺中市,東勢區,1541,236,178,414,37,451,736,61.28%,32.07%,1
臺中市,東勢區,1542,315,384,699,81,780,1314,59.36%,23.97%,1
臺中市,東勢區,1543,449,341,790,123,913,1677,54.44%,26.77%,1
臺中市,東勢區,1544,341,196,537,41,578,950,60.84%,35.89%,1
臺中市,東勢區,1545,345,221,566,63,629,1007,62.46%,34.26%,1
臺中市,東勢區,1546,319,259,578,46,624,1214,51.4%,26.28%,1
臺中市,東勢區,1547,281,189,470,50,520,907,57.33%,30.98%,1
臺中市,東勢區,1548,226,214,440,57,497,902,55.1%,25.06%,1
臺中市,東勢區,1549,192,113,305,14,319,720,44.31%,26.67%,1
臺中市,東勢區,1550,172,111,283,25,308,666,46.25%,25.83%,1
臺中市,東勢區,1551,404,235,639,102,741,1361,54.45%,29.68%,1
臺中市,大甲區,0001,290,439,729,88,817,1356,60.25%,21.39%,1
臺中市,大甲區,0002,360,240,600,65,665,1059,62.8%,33.99%,1
臺中市,大甲區,0003,227,174,401,43,444,694,63.98%,32.71%,1
臺中市,大甲區,0004,276,200,476,45,521,874,59.61%,31.58%,1
臺中市,大甲區,0005,211,184,395,34,429,763,56.23%,27.65%,1
臺中市,大甲區,0006,290,211,501,46,547,856,63.9%,33.88%,1
臺中市,大甲區,0007,391,280,671,68,739,1249,59.17%,31.31%,1
臺中市,大甲區,0008,369,93,462,41,503,922,54.56%,40.02%,1
臺中市,大甲區,0009,378,264,642,60,702,1189,59.04%,31.79%,1
臺中市,大甲區,0010,390,239,629,51,680,1065,63.85%,36.62%,1
臺中市,大甲區,0011,425,294,719,85,804,1252,64.22%,33.95%,1
臺中市,大甲區,0012,318,235,553,60,613,1057,57.99%,30.09%,1
臺中市,大甲區,0013,315,242,557,37,594,1031,57.61%,30.55%,1
臺中市,大甲區,0014,371,239,610,58,668,1060,63.02%,35%,1
臺中市,大甲區,0015,388,294,682,84,766,1311,58.43%,29.6%,1
臺中市,大甲區,0016,449,309,758,61,819,1424,57.51%,31.53%,1
臺中市,大甲區,0017,539,361,900,83,983,1670,58.86%,32.28%,1
臺中市,大甲區,0018,253,162,415,63,478,812,58.87%,31.16%,1
臺中市,大甲區,0019,296,193,489,29,518,863,60.02%,34.3%,1
臺中市,大甲區,0020,519,361,880,69,949,1598,59.39%,32.48%,1
臺中市,大甲區,0021,465,363,828,76,904,1588,56.93%,29.28%,1
臺中市,大甲區,0022,392,235,627,65,692,1197,57.81%,32.75%,1
臺中市,大甲區,0023,301,230,531,88,619,1106,55.97%,27.22%,1
臺中市,大甲區,0024,279,221,500,71,571,903,63.23%,30.9%,1
臺中市,大甲區,0025,290,200,490,53,543,869,62.49%,33.37%,1
臺中市,大甲區,0026,448,277,725,59,784,1350,58.07%,33.19%,1
臺中市,大甲區,0027,332,246,578,122,700,1144,61.19%,29.02%,1
臺中市,大甲區,0028,402,250,652,81,733,1208,60.68%,33.28%,1
臺中市,大甲區,0029,534,319,853,66,919,1567,58.65%,34.08%,1
臺中市,大甲區,0030,455,295,750,41,791,1246,63.48%,36.52%,1
臺中市,大甲區,0031,233,186,419,51,470,767,61.28%,30.38%,1
臺中市,大甲區,0032,259,179,438,42,480,790,60.76%,32.78%,1
臺中市,大甲區,0033,318,219,537,52,589,972,60.6%,32.72%,1
臺中市,大甲區,0034,397,300,697,59,756,1388,54.47%,28.6%,1
臺中市,大甲區,0035,387,275,662,54,716,1331,53.79%,29.08%,1
臺中市,大甲區,0036,416,255,671,60,731,1167,62.64%,35.65%,1
臺中市,大甲區,0037,679,371,1050,72,1122,1934,58.01%,35.11%,1
臺中市,大甲區,0038,384,212,596,62,658,1263,52.1%,30.4%,1
臺中市,大甲區,0039,411,295,706,88,794,1390,57.12%,29.57%,1
臺中市,大甲區,0040,309,203,512,59,571,1186,48.15%,26.05%,1
臺中市,大甲區,0041,417,299,716,58,774,1397,55.4%,29.85%,1
臺中市,大甲區,0042,295,182,477,29,506,1173,43.14%,25.15%,1
臺中市,大甲區,0043,411,272,683,90,773,1398,55.29%,29.4%,1
臺中市,大甲區,0044,325,237,562,79,641,1228,52.2%,26.47%,1
臺中市,大甲區,0045,348,271,619,63,682,1258,54.21%,27.66%,1
臺中市,大甲區,0046,407,314,721,67,788,1435,54.91%,28.36%,1
臺中市,大甲區,0047,430,331,761,81,842,1532,54.96%,28.07%,1
臺中市,大甲區,0048,218,114,332,46,378,652,57.98%,33.44%,1
臺中市,大甲區,0049,214,171,385,46,431,870,49.54%,24.6%,1
臺中市,大甲區,0050,235,181,416,45,461,891,51.74%,26.37%,1
臺中市,大甲區,0051,257,154,411,43,454,784,57.91%,32.78%,1
臺中市,大甲區,0052,369,261,630,119,749,1368,54.75%,26.97%,1
臺中市,大甲區,0053,356,148,504,96,600,1126,53.29%,31.62%,1
臺中市,大甲區,0054,398,222,620,116,736,1486,49.53%,26.78%,1
臺中市,清水區,0091,322,224,546,38,584,1076,54.28%,29.93%,1
臺中市,清水區,0092,345,211,556,68,624,953,65.48%,36.2%,1
臺中市,清水區,0093,286,216,502,71,573,914,62.69%,31.29%,1
臺中市,清水區,0094,404,255,659,76,735,1143,64.3%,35.35%,1
臺中市,清水區,0095,247,147,394,36,430,680,63.24%,36.32%,1
臺中市,清水區,0096,317,184,501,57,558,904,61.73%,35.07%,1
臺中市,清水區,0097,302,212,514,62,576,893,64.5%,33.82%,1
臺中市,清水區,0098,529,313,842,75,917,1577,58.15%,33.54%,1
臺中市,清水區,0099,230,141,371,35,406,690,58.84%,33.33%,1
臺中市,清水區,0100,122,99,221,25,246,403,61.04%,30.27%,1
臺中市,清水區,0101,449,294,743,103,846,1413,59.87%,31.78%,1
臺中市,清水區,0102,233,169,402,56,458,777,58.94%,29.99%,1
臺中市,清水區,0103,477,265,742,53,795,1313,60.55%,36.33%,1
臺中市,清水區,0104,537,285,822,72,894,1439,62.13%,37.32%,1
臺中市,清水區,0105,384,261,645,38,683,1265,53.99%,30.36%,1
臺中市,清水區,0106,490,276,766,43,809,1277,63.35%,38.37%,1
臺中市,清水區,0107,457,259,716,57,773,1276,60.58%,35.82%,1
臺中市,清水區,0108,484,332,816,52,868,1376,63.08%,35.17%,1
臺中市,清水區,0109,516,251,767,42,809,1291,62.66%,39.97%,1
臺中市,清水區,0110,519,300,819,97,916,1510,60.66%,34.37%,1
臺中市,清水區,0111,412,401,813,9,822,1524,53.94%,27.03%,1
臺中市,清水區,0112,422,291,713,69,782,1474,53.05%,28.63%,1
臺中市,清水區,0113,474,301,775,77,852,1507,56.54%,31.45%,1
臺中市,清水區,0114,460,308,768,96,864,1321,65.4%,34.82%,1
臺中市,清水區,0115,300,243,543,61,604,1157,52.2%,25.93%,1
臺中市,清水區,0116,427,264,691,61,752,1255,59.92%,34.02%,1
臺中市,清水區,0117,266,188,454,48,502,881,56.98%,30.19%,1
臺中市,清水區,0118,384,214,598,73,671,1083,61.96%,35.46%,1
臺中市,清水區,0119,346,174,520,50,570,951,59.94%,36.38%,1
臺中市,清水區,0120,420,280,700,83,783,1424,54.99%,29.49%,1
臺中市,清水區,0121,348,249,597,78,675,1233,54.74%,28.22%,1
臺中市,清水區,0122,310,246,556,75,631,1288,48.99%,24.07%,1
臺中市,清水區,0123,386,268,654,69,723,1200,60.25%,32.17%,1
臺中市,清水區,0124,626,287,913,54,967,1609,60.1%,38.91%,1
臺中市,清水區,0125,399,283,682,33,715,1136,62.94%,35.12%,1
臺中市,清水區,0126,447,196,643,84,727,1302,55.84%,34.33%,1
臺中市,清水區,0127,520,253,773,101,874,1373,63.66%,37.87%,1
臺中市,清水區,0128,337,227,564,92,656,1257,52.19%,26.81%,1
臺中市,清水區,0129,322,205,527,94,621,1184,52.45%,27.2%,1
臺中市,清水區,0130,429,231,660,89,749,1322,56.66%,32.45%,1
臺中市,清水區,0131,325,228,553,75,628,1193,52.64%,27.24%,1
臺中市,清水區,0132,256,185,441,108,549,927,59.22%,27.62%,1
臺中市,清水區,0133,341,247,588,80,668,1073,62.26%,31.78%,1
臺中市,清水區,0134,375,252,627,95,722,1163,62.08%,32.24%,1
臺中市,清水區,0135,276,161,437,40,477,855,55.79%,32.28%,1
臺中市,清水區,0136,238,173,411,91,502,902,55.65%,26.39%,1
臺中市,清水區,0137,451,278,729,87,816,1415,57.67%,31.87%,1
臺中市,清水區,0138,309,207,516,64,580,1066,54.41%,28.99%,1
臺中市,清水區,0139,425,267,692,86,778,1391,55.93%,30.55%,1
臺中市,清水區,0140,440,273,713,51,764,1449,52.73%,30.37%,1
臺中市,清水區,0141,469,299,768,63,831,1377,60.35%,34.06%,1
臺中市,清水區,0142,440,335,775,74,849,1423,59.66%,30.92%,1
臺中市,清水區,0143,534,337,871,71,942,1624,58%,32.88%,1
臺中市,清水區,0144,393,279,672,95,767,1358,56.48%,28.94%,1
臺中市,清水區,0145,455,305,760,92,852,1464,58.2%,31.08%,1
臺中市,清水區,0146,376,273,649,97,746,1211,61.6%,31.05%,1
臺中市,清水區,0147,429,285,714,61,775,1456,53.23%,29.46%,1
臺中市,清水區,0148,405,217,622,103,725,1162,62.39%,34.85%,1
臺中市,清水區,0149,545,241,786,88,874,1368,63.89%,39.84%,1
臺中市,沙鹿區,0186,423,243,666,71,737,1380,53.41%,30.65%,1
臺中市,沙鹿區,0187,274,186,460,59,519,852,60.92%,32.16%,1
臺中市,沙鹿區,0188,399,241,640,83,723,1176,61.48%,33.93%,1
臺中市,沙鹿區,0189,353,200,553,92,645,958,67.33%,36.85%,1
臺中市,沙鹿區,0190,176,135,311,26,337,488,69.06%,36.07%,1
臺中市,沙鹿區,0191,380,241,621,68,689,1177,58.54%,32.29%,1
臺中市,沙鹿區,0192,402,241,643,101,744,1285,57.9%,31.28%,1
臺中市,沙鹿區,0193,502,324,826,113,939,1736,54.09%,28.92%,1
臺中市,沙鹿區,0194,488,354,842,150,992,1628,60.93%,29.98%,1
臺中市,沙鹿區,0195,449,306,755,39,794,1469,54.05%,30.57%,1
臺中市,沙鹿區,0196,476,327,803,68,871,1423,61.21%,33.45%,1
臺中市,沙鹿區,0197,433,275,708,152,860,1444,59.56%,29.99%,1
臺中市,沙鹿區,0198,462,269,731,124,855,1469,58.2%,31.45%,1
臺中市,沙鹿區,0199,567,443,1010,95,1105,1902,58.1%,29.81%,1
臺中市,沙鹿區,0200,526,375,901,83,984,1675,58.75%,31.4%,1
臺中市,沙鹿區,0201,340,225,565,73,638,1098,58.11%,30.97%,1
臺中市,沙鹿區,0202,524,344,868,81,949,1539,61.66%,34.05%,1
臺中市,沙鹿區,0203,427,306,733,53,786,1329,59.14%,32.13%,1
臺中市,沙鹿區,0204,364,278,642,64,706,1255,56.25%,29%,1
臺中市,沙鹿區,0205,478,344,822,68,890,1507,59.06%,31.72%,1
臺中市,沙鹿區,0206,446,320,766,102,868,1463,59.33%,30.49%,1
臺中市,沙鹿區,0207,371,246,617,94,711,1279,55.59%,29.01%,1
臺中市,沙鹿區,0208,301,180,481,54,535,1024,52.25%,29.39%,1
臺中市,沙鹿區,0209,411,261,672,83,755,1388,54.39%,29.61%,1
臺中市,沙鹿區,0210,358,226,584,68,652,1074,60.71%,33.33%,1
臺中市,沙鹿區,0211,364,244,608,48,656,1072,61.19%,33.96%,1
臺中市,沙鹿區,0212,361,238,599,92,691,1107,62.42%,32.61%,1
臺中市,沙鹿區,0213,547,362,909,78,987,1947,50.69%,28.09%,1
臺中市,沙鹿區,0214,481,324,805,95,900,1682,53.51%,28.6%,1
臺中市,沙鹿區,0215,573,324,897,55,952,1633,58.3%,35.09%,1
臺中市,沙鹿區,0216,450,286,736,70,806,1533,52.58%,29.35%,1
臺中市,沙鹿區,0217,380,314,694,62,756,1605,47.1%,23.68%,1
臺中市,沙鹿區,0218,512,302,814,65,879,1694,51.89%,30.22%,1
臺中市,沙鹿區,0219,499,311,810,65,875,1628,53.75%,30.65%,1
臺中市,沙鹿區,0220,553,371,924,45,969,1665,58.2%,33.21%,1
臺中市,沙鹿區,0221,475,359,834,76,910,1651,55.12%,28.77%,1
臺中市,沙鹿區,0222,370,232,602,85,687,1108,62%,33.39%,1
臺中市,沙鹿區,0223,398,247,645,55,700,1142,61.3%,34.85%,1
臺中市,沙鹿區,0224,330,221,551,48,599,1039,57.65%,31.76%,1
臺中市,沙鹿區,0225,541,387,928,89,1017,1840,55.27%,29.4%,1
臺中市,沙鹿區,0226,553,413,966,72,1038,1872,55.45%,29.54%,1
臺中市,沙鹿區,0227,433,321,754,86,840,1558,53.92%,27.79%,1
臺中市,沙鹿區,0228,511,315,826,76,902,1739,51.87%,29.38%,1
臺中市,沙鹿區,0229,477,313,790,54,844,1672,50.48%,28.53%,1
臺中市,沙鹿區,0230,511,337,848,62,910,1634,55.69%,31.27%,1
臺中市,沙鹿區,0231,460,301,761,63,824,1616,50.99%,28.47%,1
臺中市,沙鹿區,0232,493,329,822,83,905,1593,56.81%,30.95%,1
臺中市,沙鹿區,0233,299,198,497,35,532,981,54.23%,30.48%,1
臺中市,沙鹿區,0234,594,342,936,93,1029,1740,59.14%,34.14%,1
臺中市,沙鹿區,0235,412,255,667,94,761,1247,61.03%,33.04%,1
臺中市,沙鹿區,0236,345,222,567,31,598,1047,57.12%,32.95%,1
臺中市,沙鹿區,0237,329,232,561,105,666,1119,59.52%,29.4%,1
臺中市,沙鹿區,0238,311,198,509,57,566,1025,55.22%,30.34%,1
臺中市,梧棲區,0150,451,323,774,97,871,1541,56.52%,29.27%,1
臺中市,梧棲區,0151,463,328,791,90,881,1581,55.72%,29.29%,1
臺中市,梧棲區,0152,342,214,556,81,637,1083,58.82%,31.58%,1
臺中市,梧棲區,0153,273,197,470,59,529,876,60.39%,31.16%,1
臺中市,梧棲區,0154,320,215,535,83,618,1043,59.25%,30.68%,1
臺中市,梧棲區,0155,424,299,723,60,783,1502,52.13%,28.23%,1
臺中市,梧棲區,0156,432,292,724,74,798,1384,57.66%,31.21%,1
臺中市,梧棲區,0157,166,140,306,44,350,517,67.7%,32.11%,1
臺中市,梧棲區,0158,412,258,670,79,749,1169,64.07%,35.24%,1
臺中市,梧棲區,0159,285,182,467,57,524,863,60.72%,33.02%,1
臺中市,梧棲區,0160,355,219,574,66,640,1277,50.12%,27.8%,1
臺中市,梧棲區,0161,503,359,862,76,938,1742,53.85%,28.87%,1
臺中市,梧棲區,0162,397,318,715,74,789,1342,58.79%,29.58%,1
臺中市,梧棲區,0163,517,387,904,113,1017,1767,57.56%,29.26%,1
臺中市,梧棲區,0164,424,277,701,88,789,1542,51.17%,27.5%,1
臺中市,梧棲區,0165,539,296,835,62,897,1636,54.83%,32.95%,1
臺中市,梧棲區,0166,528,335,863,83,946,1796,52.67%,29.4%,1
臺中市,梧棲區,0167,474,278,752,47,799,1450,55.1%,32.69%,1
臺中市,梧棲區,0168,423,278,701,152,853,1548,55.1%,27.33%,1
臺中市,梧棲區,0169,432,303,735,69,804,1366,58.86%,31.63%,1
臺中市,梧棲區,0170,352,218,570,48,618,955,64.71%,36.86%,1
臺中市,梧棲區,0171,383,260,643,74,717,1305,54.94%,29.35%,1
臺中市,梧棲區,0172,393,268,661,71,732,1239,59.08%,31.72%,1
臺中市,梧棲區,0173,338,228,566,101,667,1079,61.82%,31.33%,1
臺中市,梧棲區,0174,395,232,627,53,680,1220,55.74%,32.38%,1
臺中市,梧棲區,0175,524,322,846,86,932,1544,60.36%,33.94%,1
臺中市,梧棲區,0176,501,312,813,68,881,1460,60.34%,34.32%,1
臺中市,梧棲區,0177,422,280,702,84,786,1292,60.84%,32.66%,1
臺中市,梧棲區,0178,411,259,670,72,742,1300,57.08%,31.62%,1
臺中市,梧棲區,0179,456,293,749,86,835,1555,53.7%,29.32%,1
臺中市,梧棲區,0180,309,190,499,72,571,1031,55.38%,29.97%,1
臺中市,梧棲區,0181,414,268,682,88,770,1277,60.3%,32.42%,1
臺中市,梧棲區,0182,301,214,515,59,574,1037,55.35%,29.03%,1
臺中市,梧棲區,0183,384,240,624,82,706,1187,59.48%,32.35%,1
臺中市,梧棲區,0184,441,236,677,82,759,1399,54.25%,31.52%,1
臺中市,梧棲區,0185,339,233,572,65,637,1135,56.12%,29.87%,1
臺中市,后里區,0357,300,172,472,70,542,852,63.62%,35.21%,1
臺中市,后里區,0358,345,218,563,85,648,1135,57.09%,30.4%,1
臺中市,后里區,0359,280,220,500,80,580,1079,53.75%,25.95%,1
臺中市,后里區,0360,547,286,833,82,915,1539,59.45%,35.54%,1
臺中市,后里區,0361,524,320,844,84,928,1591,58.33%,32.94%,1
臺中市,后里區,0362,393,254,647,67,714,1376,51.89%,28.56%,1
臺中市,后里區,0363,426,262,688,37,725,1298,55.86%,32.82%,1
臺中市,后里區,0364,451,297,748,104,852,1428,59.66%,31.58%,1
臺中市,后里區,0365,434,274,708,74,782,1178,66.38%,36.84%,1
臺中市,后里區,0366,374,241,615,40,655,1095,59.82%,34.16%,1
臺中市,后里區,0367,314,187,501,38,539,963,55.97%,32.61%,1
臺中市,后里區,0368,342,245,587,67,654,1163,56.23%,29.41%,1
臺中市,后里區,0369,336,219,555,63,618,1018,60.71%,33.01%,1
臺中市,后里區,0370,295,198,493,61,554,854,64.87%,34.54%,1
臺中市,后里區,0371,456,280,736,77,813,1485,54.75%,30.71%,1
臺中市,后里區,0372,502,276,778,77,855,1355,63.1%,37.05%,1
臺中市,后里區,0373,246,159,405,60,465,840,55.36%,29.29%,1
臺中市,后里區,0374,352,257,609,73,682,1146,59.51%,30.72%,1
臺中市,后里區,0375,525,379,904,122,1026,1669,61.47%,31.46%,1
臺中市,后里區,0376,535,375,910,131,1041,1673,62.22%,31.98%,1
臺中市,后里區,0377,504,296,800,71,871,1493,58.34%,33.76%,1
臺中市,后里區,0378,339,212,551,98,649,1052,61.69%,32.22%,1
臺中市,后里區,0379,281,163,444,39,483,909,53.14%,30.91%,1
臺中市,后里區,0380,346,221,567,97,664,1091,60.86%,31.71%,1
臺中市,后里區,0381,410,264,674,152,826,1342,61.55%,30.55%,1
臺中市,后里區,0382,286,230,516,129,645,1138,56.68%,25.13%,1
臺中市,后里區,0383,327,197,524,66,590,977,60.39%,33.47%,1
臺中市,后里區,0384,413,268,681,65,746,1584,47.1%,26.07%,1
臺中市,后里區,0385,287,179,466,58,524,915,57.27%,31.37%,1
臺中市,后里區,0386,379,261,640,100,740,1225,60.41%,30.94%,1
臺中市,后里區,0387,474,299,773,82,855,1552,55.09%,30.54%,1
臺中市,后里區,0388,495,319,814,61,875,1600,54.69%,30.94%,1
臺中市,后里區,0389,285,195,480,56,536,942,56.9%,30.25%,1
臺中市,后里區,0390,277,207,484,44,528,943,55.99%,29.37%,1
臺中市,后里區,0391,291,202,493,66,559,1055,52.99%,27.58%,1
臺中市,后里區,0392,331,219,550,80,630,1067,59.04%,31.02%,1
臺中市,后里區,0393,354,261,615,96,711,1340,53.06%,26.42%,1
臺中市,神岡區,0482,558,351,909,93,1002,1684,59.5%,33.14%,1
臺中市,神岡區,0483,491,355,846,75,921,1559,59.08%,31.49%,1
臺中市,神岡區,0484,329,233,562,63,625,1095,57.08%,30.05%,1
臺中市,神岡區,0485,363,295,658,50,708,1044,67.82%,34.77%,1
臺中市,神岡區,0486,441,299,740,115,855,1310,65.27%,33.66%,1
臺中市,神岡區,0487,414,300,714,114,828,1294,63.99%,31.99%,1
臺中市,神岡區,0488,348,272,620,67,687,1143,60.1%,30.45%,1
臺中市,神岡區,0489,322,227,549,85,634,1022,62.04%,31.51%,1
臺中市,神岡區,0490,372,249,621,80,701,1269,55.24%,29.31%,1
臺中市,神岡區,0491,298,173,471,44,515,1085,47.47%,27.47%,1
臺中市,神岡區,0492,310,217,527,65,592,942,62.85%,32.91%,1
臺中市,神岡區,0493,330,247,577,71,648,1154,56.15%,28.6%,1
臺中市,神岡區,0494,389,296,685,86,771,1390,55.47%,27.99%,1
臺中市,神岡區,0495,418,326,744,123,867,1372,63.19%,30.47%,1
臺中市,神岡區,0496,391,265,656,42,698,1328,52.56%,29.44%,1
臺中市,神岡區,0497,313,230,543,32,575,1038,55.39%,30.15%,1
臺中市,神岡區,0498,432,299,731,71,802,1452,55.23%,29.75%,1
臺中市,神岡區,0499,519,359,878,82,960,1551,61.9%,33.46%,1
臺中市,神岡區,0500,456,315,771,90,861,1567,54.95%,29.1%,1
臺中市,神岡區,0501,450,352,802,43,845,1449,58.32%,31.06%,1
臺中市,神岡區,0502,334,269,603,42,645,1246,51.77%,26.81%,1
臺中市,神岡區,0503,454,301,755,95,850,1431,59.4%,31.73%,1
臺中市,神岡區,0504,363,281,644,91,735,1163,63.2%,31.21%,1
臺中市,神岡區,0505,464,344,808,101,909,1402,64.84%,33.1%,1
臺中市,神岡區,0506,408,275,683,71,754,1271,59.32%,32.1%,1
臺中市,神岡區,0507,385,256,641,90,731,1198,61.02%,32.14%,1
臺中市,神岡區,0508,410,279,689,101,790,1312,60.21%,31.25%,1
臺中市,神岡區,0509,454,332,786,117,903,1590,56.79%,28.55%,1
臺中市,神岡區,0510,397,284,681,47,728,1324,54.98%,29.98%,1
臺中市,神岡區,0511,426,266,692,76,768,1415,54.28%,30.11%,1
臺中市,神岡區,0512,493,347,840,100,940,1483,63.39%,33.24%,1
臺中市,神岡區,0513,366,298,664,71,735,1402,52.43%,26.11%,1
臺中市,神岡區,0514,399,236,635,76,711,1275,55.76%,31.29%,1
臺中市,神岡區,0515,380,270,650,61,711,1288,55.2%,29.5%,1
臺中市,神岡區,0516,308,216,524,89,613,1080,56.76%,28.52%,1
臺中市,神岡區,0517,392,294,686,53,739,1344,54.99%,29.17%,1
臺中市,神岡區,0518,317,285,602,65,667,1061,62.87%,29.88%,1
臺中市,神岡區,0519,400,286,686,57,743,1176,63.18%,34.01%,1
臺中市,神岡區,0520,400,285,685,95,780,1244,62.7%,32.15%,1
臺中市,神岡區,0521,423,331,754,98,852,1318,64.64%,32.09%,1
臺中市,神岡區,0522,409,313,722,16,738,1471,50.17%,27.8%,1
臺中市,神岡區,0523,453,327,780,97,877,1323,66.29%,34.24%,1
臺中市,潭子區,0570,408,305,713,82,795,1306,60.87%,31.24%,1
臺中市,潭子區,0571,361,272,633,56,689,1128,61.08%,32%,1
臺中市,潭子區,0572,358,295,653,74,727,1159,62.73%,30.89%,1
臺中市,潭子區,0573,542,355,897,107,1004,1630,61.6%,33.25%,1
臺中市,潭子區,0574,496,327,823,56,879,1532,57.38%,32.38%,1
臺中市,潭子區,0575,460,339,799,72,871,1677,51.94%,27.43%,1
臺中市,潭子區,0576,490,346,836,89,925,1744,53.04%,28.1%,1
臺中市,潭子區,0577,572,393,965,68,1033,1795,57.55%,31.87%,1
臺中市,潭子區,0578,377,235,612,62,674,1171,57.56%,32.19%,1
臺中市,潭子區,0579,476,282,758,57,815,1427,57.11%,33.36%,1
臺中市,潭子區,0580,573,341,914,67,981,1709,57.4%,33.53%,1
臺中市,潭子區,0581,559,334,893,75,968,1723,56.18%,32.44%,1
臺中市,潭子區,0582,552,360,912,73,985,1782,55.27%,30.98%,1
臺中市,潭子區,0583,439,274,713,55,768,1407,54.58%,31.2%,1
臺中市,潭子區,0584,587,377,964,58,1022,1771,57.71%,33.15%,1
臺中市,潭子區,0585,617,368,985,99,1084,1795,60.39%,34.37%,1
臺中市,潭子區,0586,555,369,924,89,1013,1612,62.84%,34.43%,1
臺中市,潭子區,0587,598,387,985,56,1041,1894,54.96%,31.57%,1
臺中市,潭子區,0588,555,333,888,72,960,1689,56.84%,32.86%,1
臺中市,潭子區,0589,437,280,717,92,809,1525,53.05%,28.66%,1
臺中市,潭子區,0590,484,358,842,67,909,1622,56.04%,29.84%,1
臺中市,潭子區,0591,385,261,646,77,723,1200,60.25%,32.08%,1
臺中市,潭子區,0592,408,274,682,35,717,1355,52.92%,30.11%,1
臺中市,潭子區,0593,546,365,911,64,975,1777,54.87%,30.73%,1
臺中市,潭子區,0594,634,402,1036,63,1099,1923,57.15%,32.97%,1
臺中市,潭子區,0595,508,314,822,89,911,1674,54.42%,30.35%,1
臺中市,潭子區,0596,488,344,832,80,912,1451,62.85%,33.63%,1
臺中市,潭子區,0597,468,322,790,75,865,1486,58.21%,31.49%,1
臺中市,潭子區,0598,496,356,852,60,912,1511,60.36%,32.83%,1
臺中市,潭子區,0599,594,320,914,80,994,1666,59.66%,35.65%,1
臺中市,潭子區,0600,578,353,931,53,984,1750,56.23%,33.03%,1
臺中市,潭子區,0601,447,299,746,64,810,1437,56.37%,31.11%,1
臺中市,潭子區,0602,598,305,903,70,973,1735,56.08%,34.47%,1
臺中市,潭子區,0603,520,318,838,72,910,1612,56.45%,32.26%,1
臺中市,潭子區,0604,415,249,664,41,705,1143,61.68%,36.31%,1
臺中市,潭子區,0605,659,413,1072,54,1126,2096,53.72%,31.44%,1
臺中市,潭子區,0606,612,240,852,89,941,1549,60.75%,39.51%,1
臺中市,潭子區,0607,495,363,858,40,898,1573,57.09%,31.47%,1
臺中市,潭子區,0608,518,281,799,48,847,1585,53.44%,32.68%,1
臺中市,潭子區,0609,518,314,832,52,884,1572,56.23%,32.95%,1
臺中市,潭子區,0610,619,342,961,77,1038,1738,59.72%,35.62%,1
臺中市,潭子區,0611,578,369,947,100,1047,1883,55.6%,30.7%,1
臺中市,潭子區,0612,419,310,729,68,797,1401,56.89%,29.91%,1
臺中市,潭子區,0613,459,289,748,86,834,1352,61.69%,33.95%,1
臺中市,潭子區,0614,698,418,1116,121,1237,2085,59.33%,33.48%,1
臺中市,潭子區,0615,683,425,1108,133,1241,2047,60.63%,33.37%,1
臺中市,潭子區,0616,498,346,844,46,890,1673,53.2%,29.77%,1
臺中市,潭子區,0617,581,409,990,66,1056,1874,56.35%,31%,1
臺中市,潭子區,0618,322,245,567,66,633,1051,60.23%,30.64%,1
臺中市,潭子區,0619,483,346,829,56,885,1674,52.87%,28.85%,1
臺中市,潭子區,0620,585,422,1007,74,1081,1831,59.04%,31.95%,1
臺中市,潭子區,0621,600,391,991,99,1090,2003,54.42%,29.96%,1
臺中市,潭子區,0622,476,283,759,74,833,1535,54.27%,31.01%,1
臺中市,潭子區,0623,631,379,1010,159,1169,2286,51.14%,27.6%,1
臺中市,潭子區,0624,554,360,914,84,998,1861,53.63%,29.77%,1
臺中市,大雅區,0524,656,420,1076,88,1164,2027,57.42%,32.36%,1
臺中市,大雅區,0525,545,379,924,79,1003,1967,50.99%,27.71%,1
臺中市,大雅區,0526,609,354,963,63,1026,1912,53.66%,31.85%,1
臺中市,大雅區,0527,529,336,865,74,939,1537,61.09%,34.42%,1
臺中市,大雅區,0528,465,331,796,83,879,1439,61.08%,32.31%,1
臺中市,大雅區,0529,427,310,737,99,836,1402,59.63%,30.46%,1
臺中市,大雅區,0530,626,406,1032,75,1107,2013,54.99%,31.1%,1
臺中市,大雅區,0531,615,405,1020,104,1124,1917,58.63%,32.08%,1
臺中市,大雅區,0532,620,416,1036,66,1102,2011,54.8%,30.83%,1
臺中市,大雅區,0533,649,366,1015,76,1091,1887,57.82%,34.39%,1
臺中市,大雅區,0534,475,348,823,78,901,1480,60.88%,32.09%,1
臺中市,大雅區,0535,593,367,960,84,1044,1816,57.49%,32.65%,1
臺中市,大雅區,0536,503,349,852,132,984,1898,51.84%,26.5%,1
臺中市,大雅區,0537,654,394,1048,100,1148,2008,57.17%,32.57%,1
臺中市,大雅區,0538,645,418,1063,86,1149,1976,58.15%,32.64%,1
臺中市,大雅區,0539,517,351,868,109,977,1673,58.4%,30.9%,1
臺中市,大雅區,0540,494,311,805,71,876,1409,62.17%,35.06%,1
臺中市,大雅區,0541,181,598,779,33,812,1382,58.76%,13.1%,1
臺中市,大雅區,0542,489,339,828,105,933,1635,57.06%,29.91%,1
臺中市,大雅區,0543,557,313,870,75,945,1565,60.38%,35.59%,1
臺中市,大雅區,0544,481,287,768,65,833,1528,54.52%,31.48%,1
臺中市,大雅區,0545,600,375,975,65,1040,1963,52.98%,30.57%,1
臺中市,大雅區,0546,595,392,987,83,1070,2073,51.62%,28.7%,1
臺中市,大雅區,0547,580,402,982,121,1103,1984,55.59%,29.23%,1
臺中市,大雅區,0548,530,345,875,66,941,1688,55.75%,31.4%,1
臺中市,大雅區,0549,416,321,737,67,804,1387,57.97%,29.99%,1
臺中市,大雅區,0550,544,340,884,149,1033,1701,60.73%,31.98%,1
臺中市,大雅區,0551,544,338,882,97,979,1721,56.89%,31.61%,1
臺中市,大雅區,0552,483,304,787,81,868,1879,46.19%,25.71%,1
臺中市,大雅區,0553,559,348,907,82,989,1568,63.07%,35.65%,1
臺中市,大雅區,0554,507,403,910,117,1027,1761,58.32%,28.79%,1
臺中市,大雅區,0555,565,359,924,146,1070,1752,61.07%,32.25%,1
臺中市,大雅區,0556,407,294,701,57,758,1264,59.97%,32.2%,1
臺中市,大雅區,0557,418,323,741,73,814,1302,62.52%,32.1%,1
臺中市,大雅區,0558,464,282,746,87,833,1449,57.49%,32.02%,1
臺中市,大雅區,0559,560,318,878,147,1025,1621,63.23%,34.55%,1
臺中市,大雅區,0560,486,322,808,116,924,1647,56.1%,29.51%,1
臺中市,大雅區,0561,446,296,742,49,791,1441,54.89%,30.95%,1
臺中市,大雅區,0562,477,270,747,50,797,1460,54.59%,32.67%,1
臺中市,大雅區,0563,602,440,1042,99,1141,1832,62.28%,32.86%,1
臺中市,大雅區,0564,467,310,777,95,872,1371,63.6%,34.06%,1
臺中市,大雅區,0565,403,275,678,14,692,1418,48.8%,28.42%,1
臺中市,大雅區,0566,503,315,818,69,887,1473,60.22%,34.15%,1
臺中市,大雅區,0567,414,300,714,78,792,1335,59.33%,31.01%,1
臺中市,大雅區,0568,617,254,871,108,979,1733,56.49%,35.6%,1
臺中市,大雅區,0569,599,234,833,129,962,1884,51.06%,31.79%,1
臺中市,新社區,1562,302,221,523,40,563,1011,55.69%,29.87%,1
臺中市,新社區,1563,390,251,641,52,693,1195,57.99%,32.64%,1
臺中市,新社區,1564,351,251,602,43,645,1053,61.25%,33.33%,1
臺中市,新社區,1565,209,148,357,47,404,961,42.04%,21.75%,1
臺中市,新社區,1566,256,191,447,31,478,919,52.01%,27.86%,1
臺中市,新社區,1567,461,276,737,99,836,1367,61.16%,33.72%,1
臺中市,新社區,1568,290,172,462,63,525,1010,51.98%,28.71%,1
臺中市,新社區,1569,268,220,488,80,568,1169,48.59%,22.93%,1
臺中市,新社區,1570,299,194,493,70,563,989,56.93%,30.23%,1
臺中市,新社區,1571,289,145,434,43,477,894,53.36%,32.33%,1
臺中市,新社區,1572,325,173,498,39,537,1033,51.98%,31.46%,1
臺中市,新社區,1573,244,158,402,37,439,1058,41.49%,23.06%,1
臺中市,新社區,1574,224,149,373,30,403,845,47.69%,26.51%,1
臺中市,新社區,1575,166,190,356,35,391,576,67.88%,28.82%,1
臺中市,新社區,1576,331,212,543,82,625,1229,50.85%,26.93%,1
臺中市,新社區,1577,202,145,347,53,400,890,44.94%,22.7%,1
臺中市,新社區,1578,205,146,351,53,404,781,51.73%,26.25%,1
臺中市,新社區,1579,387,234,621,58,679,1244,54.58%,31.11%,1
臺中市,新社區,1580,42,29,71,10,81,213,38.03%,19.72%,1
臺中市,新社區,1581,157,124,281,29,310,676,45.86%,23.22%,1
臺中市,新社區,1582,162,84,246,36,282,585,48.21%,27.69%,1
臺中市,新社區,1583,280,171,451,75,526,938,56.08%,29.85%,1
臺中市,新社區,1584,63,40,103,8,111,224,49.55%,28.13%,1
臺中市,石岡區,1552,412,244,656,72,728,1244,58.52%,33.12%,1
臺中市,石岡區,1553,470,310,780,80,860,1539,55.88%,30.54%,1
臺中市,石岡區,1554,383,275,658,52,710,1202,59.07%,31.86%,1
臺中市,石岡區,1555,341,251,592,105,697,1272,54.8%,26.81%,1
臺中市,石岡區,1556,207,123,330,60,390,652,59.82%,31.75%,1
臺中市,石岡區,1557,504,336,840,119,959,1457,65.82%,34.59%,1
臺中市,石岡區,1558,595,315,910,109,1019,1836,55.5%,32.41%,1
臺中市,石岡區,1559,307,214,521,62,583,1001,58.24%,30.67%,1
臺中市,石岡區,1560,486,337,823,65,888,1448,61.33%,33.56%,1
臺中市,石岡區,1561,408,269,677,86,763,1229,62.08%,33.2%,1
臺中市,外埔區,0071,310,221,531,71,602,1059,56.85%,29.27%,1
臺中市,外埔區,0072,327,231,558,33,591,1013,58.34%,32.28%,1
臺中市,外埔區,0073,386,260,646,71,717,1150,62.35%,33.57%,1
臺中市,外埔區,0074,681,405,1086,97,1183,1855,63.77%,36.71%,1
臺中市,外埔區,0075,457,286,743,54,797,1327,60.06%,34.44%,1
臺中市,外埔區,0076,503,298,801,77,878,1453,60.43%,34.62%,1
臺中市,外埔區,0077,515,289,804,122,926,1653,56.02%,31.16%,1
臺中市,外埔區,0078,478,332,810,66,876,1615,54.24%,29.6%,1
臺中市,外埔區,0079,392,325,717,63,780,1470,53.06%,26.67%,1
臺中市,外埔區,0080,481,350,831,94,925,1559,59.33%,30.85%,1
臺中市,外埔區,0081,551,382,933,136,1069,1902,56.2%,28.97%,1
臺中市,外埔區,0082,370,285,655,77,732,1138,64.32%,32.51%,1
臺中市,外埔區,0083,360,230,590,89,679,1065,63.76%,33.8%,1
臺中市,外埔區,0084,433,277,710,66,776,1243,62.43%,34.84%,1
臺中市,外埔區,0085,274,204,478,50,528,962,54.89%,28.48%,1
臺中市,外埔區,0086,340,244,584,73,657,1169,56.2%,29.08%,1
臺中市,外埔區,0087,450,255,705,79,784,1216,64.47%,37.01%,1
臺中市,外埔區,0088,502,200,702,75,777,1391,55.86%,36.09%,1
臺中市,外埔區,0089,488,304,792,118,910,1616,56.31%,30.2%,1
臺中市,外埔區,0090,311,204,515,51,566,1203,47.05%,25.85%,1
臺中市,大安區,0055,289,196,485,84,569,1068,53.28%,27.06%,1
臺中市,大安區,0056,319,209,528,85,613,1050,58.38%,30.38%,1
臺中市,大安區,0057,370,290,660,101,761,1246,61.08%,29.7%,1
臺中市,大安區,0058,406,293,699,82,781,1397,55.91%,29.06%,1
臺中市,大安區,0059,381,279,660,97,757,1227,61.7%,31.05%,1
臺中市,大安區,0060,364,228,592,100,692,1170,59.15%,31.11%,1
臺中市,大安區,0061,285,173,458,138,596,914,65.21%,31.18%,1
臺中市,大安區,0062,173,117,290,55,345,667,51.72%,25.94%,1
臺中市,大安區,0063,254,150,404,79,483,890,54.27%,28.54%,1
臺中市,大安區,0064,368,272,640,95,735,1289,57.02%,28.55%,1
臺中市,大安區,0065,109,94,203,39,242,455,53.19%,23.96%,1
臺中市,大安區,0066,321,200,521,62,583,1028,56.71%,31.23%,1
臺中市,大安區,0067,438,311,749,117,866,1446,59.89%,30.29%,1
臺中市,大安區,0068,248,159,407,41,448,688,65.12%,36.05%,1
臺中市,大安區,0069,338,222,560,89,649,1062,61.11%,31.83%,1
臺中市,大安區,0070,301,250,551,48,599,923,64.9%,32.61%,1
臺中市,烏日區,0317,523,303,826,105,931,1480,62.91%,35.34%,1
臺中市,烏日區,0318,592,415,1007,114,1121,1841,60.89%,32.16%,1
臺中市,烏日區,0319,547,364,911,92,1003,1751,57.28%,31.24%,1
臺中市,烏日區,0320,496,368,864,93,957,1547,61.86%,32.06%,1
臺中市,烏日區,0321,616,386,1002,63,1065,1836,58.01%,33.55%,1
臺中市,烏日區,0322,405,284,689,134,823,1239,66.42%,32.69%,1
臺中市,烏日區,0323,378,275,653,94,747,1295,57.68%,29.19%,1
臺中市,烏日區,0324,370,245,615,99,714,1263,56.53%,29.3%,1
臺中市,烏日區,0325,475,378,853,53,906,1622,55.86%,29.28%,1
臺中市,烏日區,0326,559,362,921,109,1030,1822,56.53%,30.68%,1
臺中市,烏日區,0327,593,402,995,97,1092,1966,55.54%,30.16%,1
臺中市,烏日區,0328,520,358,878,68,946,1615,58.58%,32.2%,1
臺中市,烏日區,0329,399,292,691,60,751,1232,60.96%,32.39%,1
臺中市,烏日區,0330,405,294,699,45,744,1347,55.23%,30.07%,1
臺中市,烏日區,0331,337,232,569,55,624,1165,53.56%,28.93%,1
臺中市,烏日區,0332,573,355,928,62,990,1664,59.5%,34.44%,1
臺中市,烏日區,0333,368,295,663,77,740,1230,60.16%,29.92%,1
臺中市,烏日區,0334,521,350,871,117,988,1574,62.77%,33.1%,1
臺中市,烏日區,0335,511,334,845,68,913,1452,62.88%,35.19%,1
臺中市,烏日區,0336,547,338,885,100,985,1879,52.42%,29.11%,1
臺中市,烏日區,0337,483,344,827,76,903,1601,56.4%,30.17%,1
臺中市,烏日區,0338,528,336,864,85,949,1546,61.38%,34.15%,1
臺中市,烏日區,0339,497,363,860,74,934,1866,50.05%,26.63%,1
臺中市,烏日區,0340,622,426,1048,99,1147,1938,59.18%,32.09%,1
臺中市,烏日區,0341,560,364,924,109,1033,1759,58.73%,31.84%,1
臺中市,烏日區,0342,651,383,1034,110,1144,2061,55.51%,31.59%,1
臺中市,烏日區,0343,582,342,924,81,1005,1691,59.43%,34.42%,1
臺中市,烏日區,0344,318,279,597,81,678,1039,65.26%,30.61%,1
臺中市,烏日區,0345,392,278,670,63,733,1221,60.03%,32.1%,1
臺中市,烏日區,0346,533,363,896,110,1006,1650,60.97%,32.3%,1
臺中市,烏日區,0347,307,207,514,63,577,937,61.58%,32.76%,1
臺中市,烏日區,0348,409,274,683,43,726,1220,59.51%,33.52%,1
臺中市,烏日區,0349,584,304,888,179,1067,2139,49.88%,27.3%,1
臺中市,烏日區,0350,455,323,778,105,883,1371,64.41%,33.19%,1
臺中市,烏日區,0351,421,260,681,73,754,1277,59.04%,32.97%,1
臺中市,烏日區,0352,519,322,841,108,949,1708,55.56%,30.39%,1
臺中市,烏日區,0353,628,413,1041,115,1156,2048,56.45%,30.66%,1
臺中市,烏日區,0354,495,345,840,69,909,1632,55.7%,30.33%,1
臺中市,烏日區,0355,418,304,722,84,806,1327,60.74%,31.5%,1
臺中市,烏日區,0356,221,188,409,89,498,854,58.31%,25.88%,1
臺中市,大肚區,0284,419,302,721,73,794,1415,56.11%,29.61%,1
臺中市,大肚區,0285,409,250,659,88,747,1392,53.66%,29.38%,1
臺中市,大肚區,0286,503,327,830,92,922,1520,60.66%,33.09%,1
臺中市,大肚區,0287,321,191,512,71,583,862,67.63%,37.24%,1
臺中市,大肚區,0288,440,257,697,81,778,1256,61.94%,35.03%,1
臺中市,大肚區,0289,426,233,659,88,747,1292,57.82%,32.97%,1
臺中市,大肚區,0290,312,225,537,76,613,1010,60.69%,30.89%,1
臺中市,大肚區,0291,467,344,811,108,919,1485,61.89%,31.45%,1
臺中市,大肚區,0292,415,244,659,100,759,1190,63.78%,34.87%,1
臺中市,大肚區,0293,389,257,646,99,745,1250,59.6%,31.12%,1
臺中市,大肚區,0294,420,279,699,82,781,1310,59.62%,32.06%,1
臺中市,大肚區,0295,491,166,657,79,736,1294,56.88%,37.94%,1
臺中市,大肚區,0296,576,404,980,103,1083,1734,62.46%,33.22%,1
臺中市,大肚區,0297,402,255,657,93,750,1316,56.99%,30.55%,1
臺中市,大肚區,0298,258,177,435,73,508,854,59.48%,30.21%,1
臺中市,大肚區,0299,463,288,751,62,813,1273,63.86%,36.37%,1
臺中市,大肚區,0300,299,201,500,43,543,851,63.81%,35.14%,1
臺中市,大肚區,0301,529,306,835,68,903,1629,55.43%,32.47%,1
臺中市,大肚區,0302,507,325,832,127,959,1709,56.11%,29.67%,1
臺中市,大肚區,0303,267,188,455,54,509,953,53.41%,28.02%,1
臺中市,大肚區,0304,422,332,754,61,815,1336,61%,31.59%,1
臺中市,大肚區,0305,609,415,1024,119,1143,2113,54.09%,28.82%,1
臺中市,大肚區,0306,527,332,859,161,1020,1730,58.96%,30.46%,1
臺中市,大肚區,0307,571,329,900,50,950,1692,56.15%,33.75%,1
臺中市,大肚區,0308,576,357,933,56,989,1747,56.61%,32.97%,1
臺中市,大肚區,0309,527,307,834,101,935,1672,55.92%,31.52%,1
臺中市,大肚區,0310,467,351,818,68,886,1675,52.9%,27.88%,1
臺中市,大肚區,0311,520,325,845,94,939,1673,56.13%,31.08%,1
臺中市,大肚區,0312,481,388,869,88,957,1636,58.5%,29.4%,1
臺中市,大肚區,0313,497,325,822,121,943,1753,53.79%,28.35%,1
臺中市,大肚區,0314,346,278,624,57,681,1343,50.71%,25.76%,1
臺中市,大肚區,0315,513,384,897,90,987,1822,54.17%,28.16%,1
臺中市,大肚區,0316,509,369,878,154,1032,1670,61.8%,30.48%,1
臺中市,龍井區,0239,595,347,942,115,1057,1758,60.13%,33.85%,1
臺中市,龍井區,0240,410,241,651,75,726,1275,56.94%,32.16%,1
臺中市,龍井區,0241,353,262,615,56,671,1379,48.66%,25.6%,1
臺中市,龍井區,0242,385,271,656,90,746,1403,53.17%,27.44%,1
臺中市,龍井區,0243,283,225,508,56,564,974,57.91%,29.06%,1
臺中市,龍井區,0244,303,171,474,64,538,901,59.71%,33.63%,1
臺中市,龍井區,0245,523,345,868,117,985,1779,55.37%,29.4%,1
臺中市,龍井區,0246,531,340,871,90,961,1609,59.73%,33%,1
臺中市,龍井區,0247,216,276,492,43,535,1038,51.54%,20.81%,1
臺中市,龍井區,0248,463,258,721,83,804,1328,60.54%,34.86%,1
臺中市,龍井區,0249,330,204,534,36,570,921,61.89%,35.83%,1
臺中市,龍井區,0250,460,288,748,97,845,1609,52.52%,28.59%,1
臺中市,龍井區,0251,308,232,540,34,574,1227,46.78%,25.1%,1
臺中市,龍井區,0252,378,255,633,92,725,1278,56.73%,29.58%,1
臺中市,龍井區,0253,205,171,376,39,415,914,45.4%,22.43%,1
臺中市,龍井區,0254,448,303,751,47,798,1678,47.56%,26.7%,1
臺中市,龍井區,0255,323,234,557,64,621,1233,50.36%,26.2%,1
臺中市,龍井區,0256,459,305,764,95,859,1520,56.51%,30.2%,1
臺中市,龍井區,0257,561,329,890,82,972,1905,51.02%,29.45%,1
臺中市,龍井區,0258,469,349,818,83,901,1520,59.28%,30.86%,1
臺中市,龍井區,0259,389,291,680,70,750,1385,54.15%,28.09%,1
臺中市,龍井區,0260,367,257,624,57,681,1212,56.19%,30.28%,1
臺中市,龍井區,0261,504,267,771,42,813,1432,56.77%,35.2%,1
臺中市,龍井區,0262,450,347,797,71,868,1663,52.19%,27.06%,1
臺中市,龍井區,0263,438,249,687,65,752,1422,52.88%,30.8%,1
臺中市,龍井區,0264,409,337,746,84,830,1616,51.36%,25.31%,1
臺中市,龍井區,0265,474,293,767,73,840,1422,59.07%,33.33%,1
臺中市,龍井區,0266,367,264,631,56,687,1165,58.97%,31.5%,1
臺中市,龍井區,0267,511,336,847,53,900,1624,55.42%,31.47%,1
臺中市,龍井區,0268,522,288,810,93,903,1613,55.98%,32.36%,1
臺中市,龍井區,0269,327,198,525,62,587,943,62.25%,34.68%,1
臺中市,龍井區,0270,437,303,740,111,851,1595,53.35%,27.4%,1
臺中市,龍井區,0271,491,297,788,100,888,1508,58.89%,32.56%,1
臺中市,龍井區,0272,430,278,708,81,789,1479,53.35%,29.07%,1
臺中市,龍井區,0273,471,316,787,88,875,1509,57.99%,31.21%,1
臺中市,龍井區,0274,510,334,844,98,942,1582,59.54%,32.24%,1
臺中市,龍井區,0275,657,230,887,86,973,1725,56.41%,38.09%,1
臺中市,龍井區,0276,523,326,849,78,927,1616,57.36%,32.36%,1
臺中市,龍井區,0277,532,377,909,64,973,1657,58.72%,32.11%,1
臺中市,龍井區,0278,590,358,948,83,1031,1774,58.12%,33.26%,1
臺中市,龍井區,0279,538,418,956,77,1033,1701,60.73%,31.63%,1
臺中市,龍井區,0280,335,267,602,58,660,1121,58.88%,29.88%,1
臺中市,龍井區,0281,324,233,557,64,621,987,62.92%,32.83%,1
臺中市,龍井區,0282,364,297,661,59,720,1206,59.7%,30.18%,1
臺中市,龍井區,0283,459,315,774,73,847,1378,61.47%,33.31%,1
臺中市,霧峰區,1470,408,266,674,70,744,1205,61.74%,33.86%,1
臺中市,霧峰區,1471,491,342,833,89,922,1620,56.91%,30.31%,1
臺中市,霧峰區,1472,537,308,845,111,956,1559,61.32%,34.45%,1
臺中市,霧峰區,1473,535,305,840,96,936,1660,56.39%,32.23%,1
臺中市,霧峰區,1474,551,340,891,89,980,1602,61.17%,34.39%,1
臺中市,霧峰區,1475,395,255,650,83,733,1325,55.32%,29.81%,1
臺中市,霧峰區,1476,485,311,796,95,891,1515,58.81%,32.01%,1
臺中市,霧峰區,1477,437,347,784,94,878,1561,56.25%,27.99%,1
臺中市,霧峰區,1478,480,332,812,98,910,1691,53.81%,28.39%,1
臺中市,霧峰區,1479,472,292,764,93,857,1486,57.67%,31.76%,1
臺中市,霧峰區,1480,300,226,526,86,612,975,62.77%,30.77%,1
臺中市,霧峰區,1481,493,283,776,77,853,1358,62.81%,36.3%,1
臺中市,霧峰區,1482,410,279,689,70,759,1141,66.52%,35.93%,1
臺中市,霧峰區,1483,271,204,475,87,562,855,65.73%,31.7%,1
臺中市,霧峰區,1484,379,249,628,91,719,1202,59.82%,31.53%,1
臺中市,霧峰區,1485,304,226,530,71,601,1078,55.75%,28.2%,1
臺中市,霧峰區,1486,471,298,769,95,864,1456,59.34%,32.35%,1
臺中市,霧峰區,1487,552,320,872,83,955,1573,60.71%,35.09%,1
臺中市,霧峰區,1488,561,289,850,91,941,1591,59.15%,35.26%,1
臺中市,霧峰區,1489,451,244,695,84,779,1214,64.17%,37.15%,1
臺中市,霧峰區,1490,369,271,640,85,725,1267,57.22%,29.12%,1
臺中市,霧峰區,1491,435,245,680,88,768,1277,60.14%,34.06%,1
臺中市,霧峰區,1492,415,311,726,52,778,1366,56.95%,30.38%,1
臺中市,霧峰區,1493,354,231,585,103,688,994,69.22%,35.61%,1
臺中市,霧峰區,1494,295,202,497,44,541,863,62.69%,34.18%,1
臺中市,霧峰區,1495,392,249,641,91,732,1274,57.46%,30.77%,1
臺中市,霧峰區,1496,336,243,579,103,682,1162,58.69%,28.92%,1
臺中市,霧峰區,1497,397,277,674,105,779,1252,62.22%,31.71%,1
臺中市,霧峰區,1498,420,263,683,107,790,1322,59.76%,31.77%,1
臺中市,霧峰區,1499,355,261,616,92,708,1116,63.44%,31.81%,1
臺中市,霧峰區,1500,353,275,628,113,741,1156,64.1%,30.54%,1
臺中市,霧峰區,1501,360,254,614,115,729,1147,63.56%,31.39%,1
臺中市,霧峰區,1502,331,216,547,81,628,928,67.67%,35.67%,1
臺中市,霧峰區,1503,412,237,649,79,728,1296,56.17%,31.79%,1
臺中市,霧峰區,1504,344,240,584,128,712,1314,54.19%,26.18%,1
臺中市,霧峰區,1505,418,272,690,111,801,1328,60.32%,31.48%,1
臺中市,霧峰區,1506,300,191,491,96,587,989,59.35%,30.33%,1
臺中市,霧峰區,1507,372,218,590,90,680,1088,62.5%,34.19%,1
臺中市,霧峰區,1508,493,272,765,91,856,1363,62.8%,36.17%,1
臺中市,霧峰區,1509,512,354,866,99,965,1573,61.35%,32.55%,1
臺中市,霧峰區,1510,303,250,553,93,646,1117,57.83%,27.13%,1
臺中市,霧峰區,1511,447,308,755,109,864,1342,64.38%,33.31%,1
臺中市,霧峰區,1512,348,226,574,110,684,1024,66.8%,33.98%,1
臺中市,太平區,1271,550,361,911,84,995,1821,54.64%,30.2%,1
臺中市,太平區,1272,455,304,759,78,837,1680,49.82%,27.08%,1
臺中市,太平區,1273,555,444,999,131,1130,1947,58.04%,28.51%,1
臺中市,太平區,1274,640,414,1054,99,1153,1910,60.37%,33.51%,1
臺中市,太平區,1275,538,402,940,82,1022,1894,53.96%,28.41%,1
臺中市,太平區,1276,671,401,1072,107,1179,1953,60.37%,34.36%,1
臺中市,太平區,1277,573,368,941,115,1056,1846,57.2%,31.04%,1
臺中市,太平區,1278,490,322,812,64,876,1493,58.67%,32.82%,1
臺中市,太平區,1279,490,314,804,94,898,1605,55.95%,30.53%,1
臺中市,太平區,1280,578,308,886,56,942,1619,58.18%,35.7%,1
臺中市,太平區,1281,648,337,985,107,1092,2011,54.3%,32.22%,1
臺中市,太平區,1282,604,410,1014,54,1068,2056,51.95%,29.38%,1
臺中市,太平區,1283,573,362,935,103,1038,1876,55.33%,30.54%,1
臺中市,太平區,1284,623,264,887,103,990,1815,54.55%,34.33%,1
臺中市,太平區,1285,380,267,647,63,710,1281,55.43%,29.66%,1
臺中市,太平區,1286,315,259,574,76,650,1004,64.74%,31.37%,1
臺中市,太平區,1287,598,422,1020,111,1131,1886,59.97%,31.71%,1
臺中市,太平區,1288,416,344,760,99,859,1431,60.03%,29.07%,1
臺中市,太平區,1289,550,394,944,113,1057,1930,54.77%,28.5%,1
臺中市,太平區,1290,587,420,1007,105,1112,2164,51.39%,27.13%,1
臺中市,太平區,1291,622,376,998,113,1111,2048,54.25%,30.37%,1
臺中市,太平區,1292,595,392,987,97,1084,2035,53.27%,29.24%,1
臺中市,太平區,1293,491,329,820,109,929,1685,55.13%,29.14%,1
臺中市,太平區,1294,533,415,948,128,1076,2185,49.24%,24.39%,1
臺中市,太平區,1295,326,255,581,39,620,1176,52.72%,27.72%,1
臺中市,太平區,1296,480,305,785,71,856,1597,53.6%,30.06%,1
臺中市,太平區,1297,394,265,659,82,741,1378,53.77%,28.59%,1
臺中市,太平區,1298,502,306,808,35,843,1546,54.53%,32.47%,1
臺中市,太平區,1299,529,339,868,87,955,1890,50.53%,27.99%,1
臺中市,太平區,1300,307,216,523,70,593,1053,56.32%,29.15%,1
臺中市,太平區,1301,521,330,851,105,956,1582,60.43%,32.93%,1
臺中市,太平區,1302,573,52,625,82,707,1699,41.61%,33.73%,1
臺中市,太平區,1303,417,312,729,84,813,1493,54.45%,27.93%,1
臺中市,太平區,1304,296,216,512,66,578,1063,54.37%,27.85%,1
臺中市,太平區,1305,405,201,606,70,676,1117,60.52%,36.26%,1
臺中市,太平區,1306,377,220,597,59,656,1084,60.52%,34.78%,1
臺中市,太平區,1307,524,327,851,54,905,1776,50.96%,29.5%,1
臺中市,太平區,1308,522,354,876,67,943,1729,54.54%,30.19%,1
臺中市,太平區,1309,449,286,735,80,815,1658,49.16%,27.08%,1
臺中市,太平區,1310,618,366,984,88,1072,2010,53.33%,30.75%,1
臺中市,太平區,1311,587,319,906,69,975,1752,55.65%,33.5%,1
臺中市,太平區,1312,572,330,902,95,997,1654,60.28%,34.58%,1
臺中市,太平區,1313,484,256,740,47,787,1951,40.34%,24.81%,1
臺中市,太平區,1314,758,492,1250,104,1354,2170,62.4%,34.93%,1
臺中市,太平區,1315,761,481,1242,88,1330,2231,59.61%,34.11%,1
臺中市,太平區,1316,541,311,852,70,922,1623,56.81%,33.33%,1
臺中市,太平區,1317,407,275,682,79,761,1548,49.16%,26.29%,1
臺中市,太平區,1318,452,262,714,80,794,1442,55.06%,31.35%,1
臺中市,太平區,1319,378,297,675,48,723,1501,48.17%,25.18%,1
臺中市,太平區,1320,560,364,924,52,976,2025,48.2%,27.65%,1
臺中市,太平區,1321,537,362,899,114,1013,1885,53.74%,28.49%,1
臺中市,太平區,1322,594,351,945,110,1055,2155,48.96%,27.56%,1
臺中市,太平區,1323,445,365,810,74,884,1775,49.8%,25.07%,1
臺中市,太平區,1324,518,307,825,90,915,2021,45.27%,25.63%,1
臺中市,太平區,1325,682,350,1032,179,1211,2075,58.36%,32.87%,1
臺中市,太平區,1326,509,319,828,68,896,1723,52%,29.54%,1
臺中市,太平區,1327,664,394,1058,83,1141,2049,55.69%,32.41%,1
臺中市,太平區,1328,446,295,741,41,782,1415,55.27%,31.52%,1
臺中市,太平區,1329,563,346,909,87,996,1778,56.02%,31.66%,1
臺中市,太平區,1330,501,332,833,75,908,1706,53.22%,29.37%,1
臺中市,太平區,1331,661,394,1055,79,1134,2090,54.26%,31.63%,1
臺中市,太平區,1332,586,396,982,84,1066,2093,50.93%,28%,1
臺中市,太平區,1333,440,291,731,69,800,1688,47.39%,26.07%,1
臺中市,太平區,1334,430,266,696,64,760,1488,51.08%,28.9%,1
臺中市,太平區,1335,520,384,904,75,979,1667,58.73%,31.19%,1
臺中市,太平區,1336,571,360,931,88,1019,1793,56.83%,31.85%,1
臺中市,太平區,1337,611,389,1000,84,1084,1903,56.96%,32.11%,1
臺中市,太平區,1338,537,376,913,110,1023,1834,55.78%,29.28%,1
臺中市,太平區,1339,495,266,761,60,821,1526,53.8%,32.44%,1
臺中市,太平區,1340,547,326,873,44,917,1483,61.83%,36.88%,1
臺中市,太平區,1341,548,355,903,56,959,1694,56.61%,32.35%,1
臺中市,太平區,1342,575,321,896,76,972,1952,49.8%,29.46%,1
臺中市,太平區,1343,578,439,1017,62,1079,1995,54.09%,28.97%,1
臺中市,太平區,1344,620,101,721,40,761,1311,58.05%,47.29%,1
臺中市,太平區,1345,540,415,955,61,1016,1537,66.1%,35.13%,1
臺中市,太平區,1346,532,364,896,76,972,1974,49.24%,26.95%,1
臺中市,太平區,1347,577,379,956,60,1016,1828,55.58%,31.56%,1
臺中市,太平區,1348,647,367,1014,63,1077,2191,49.16%,29.53%,1
臺中市,太平區,1349,504,329,833,129,962,1825,52.71%,27.62%,1
臺中市,太平區,1350,449,285,734,16,750,1559,48.11%,28.8%,1
臺中市,太平區,1351,359,242,601,88,689,1225,56.24%,29.31%,1
臺中市,太平區,1352,492,362,854,82,936,1678,55.78%,29.32%,1
臺中市,太平區,1353,383,279,662,141,803,1501,53.5%,25.52%,1
臺中市,太平區,1354,456,371,827,95,922,1450,63.59%,31.45%,1
臺中市,太平區,1355,587,395,982,119,1101,2126,51.79%,27.61%,1
臺中市,太平區,1356,220,162,382,67,449,699,64.23%,31.47%,1
臺中市,太平區,1357,359,291,650,35,685,1428,47.97%,25.14%,1
臺中市,太平區,1358,489,366,855,109,964,1666,57.86%,29.35%,1
臺中市,太平區,1359,367,262,629,72,701,1241,56.49%,29.57%,1
臺中市,太平區,1360,427,260,687,72,759,1266,59.95%,33.73%,1
臺中市,太平區,1361,371,234,605,62,667,1166,57.2%,31.82%,1
臺中市,太平區,1362,568,399,967,92,1059,1790,59.16%,31.73%,1
臺中市,太平區,1363,422,305,727,84,811,1754,46.24%,24.06%,1
臺中市,大里區,1364,497,289,786,76,862,1614,53.41%,30.79%,1
臺中市,大里區,1365,465,276,741,59,800,1599,50.03%,29.08%,1
臺中市,大里區,1366,488,283,771,104,875,1715,51.02%,28.45%,1
臺中市,大里區,1367,419,247,666,46,712,1264,56.33%,33.15%,1
臺中市,大里區,1368,429,257,686,61,747,1416,52.75%,30.3%,1
臺中市,大里區,1369,356,229,585,56,641,1188,53.96%,29.97%,1
臺中市,大里區,1370,344,276,620,104,724,1359,53.27%,25.31%,1
臺中市,大里區,1371,452,325,777,73,850,1457,58.34%,31.02%,1
臺中市,大里區,1372,469,303,772,59,831,1403,59.23%,33.43%,1
臺中市,大里區,1373,516,332,848,84,932,1697,54.92%,30.41%,1
臺中市,大里區,1374,530,433,963,133,1096,1811,60.52%,29.27%,1
臺中市,大里區,1375,539,352,891,93,984,1830,53.77%,29.45%,1
臺中市,大里區,1376,427,350,777,187,964,2228,43.27%,19.17%,1
臺中市,大里區,1377,632,380,1012,125,1137,1997,56.94%,31.65%,1
臺中市,大里區,1378,793,420,1213,82,1295,2033,63.7%,39.01%,1
臺中市,大里區,1379,551,414,965,94,1059,1835,57.71%,30.03%,1
臺中市,大里區,1380,423,257,680,43,723,1268,57.02%,33.36%,1
臺中市,大里區,1381,535,331,866,77,943,1645,57.33%,32.52%,1
臺中市,大里區,1382,543,311,854,64,918,1561,58.81%,34.79%,1
臺中市,大里區,1383,490,297,787,60,847,1301,65.1%,37.66%,1
臺中市,大里區,1384,464,301,765,105,870,1621,53.67%,28.62%,1
臺中市,大里區,1385,464,393,857,90,947,1797,52.7%,25.82%,1
臺中市,大里區,1386,364,241,605,47,652,1230,53.01%,29.59%,1
臺中市,大里區,1387,455,268,723,86,809,1488,54.37%,30.58%,1
臺中市,大里區,1388,416,270,686,103,789,1459,54.08%,28.51%,1
臺中市,大里區,1389,484,360,844,90,934,1647,56.71%,29.39%,1
臺中市,大里區,1390,344,265,609,85,694,1100,63.09%,31.27%,1
臺中市,大里區,1391,434,305,739,72,811,1410,57.52%,30.78%,1
臺中市,大里區,1392,538,323,861,98,959,1807,53.07%,29.77%,1
臺中市,大里區,1393,395,301,696,58,754,1331,56.65%,29.68%,1
臺中市,大里區,1394,559,345,904,64,968,1801,53.75%,31.04%,1
臺中市,大里區,1395,557,336,893,76,969,1909,50.76%,29.18%,1
臺中市,大里區,1396,438,309,747,115,862,1699,50.74%,25.78%,1
臺中市,大里區,1397,532,334,866,84,950,1627,58.39%,32.7%,1
臺中市,大里區,1398,597,352,949,92,1041,1912,54.45%,31.22%,1
臺中市,大里區,1399,489,348,837,108,945,1753,53.91%,27.9%,1
臺中市,大里區,1400,477,310,787,89,876,1602,54.68%,29.78%,1
臺中市,大里區,1401,344,220,564,96,660,1144,57.69%,30.07%,1
臺中市,大里區,1402,508,353,861,102,963,1655,58.19%,30.69%,1
臺中市,大里區,1403,447,281,728,77,805,1438,55.98%,31.08%,1
臺中市,大里區,1404,291,229,520,77,597,1000,59.7%,29.1%,1
臺中市,大里區,1405,535,329,864,95,959,1711,56.05%,31.27%,1
臺中市,大里區,1406,566,281,847,15,862,1698,50.77%,33.33%,1
臺中市,大里區,1407,561,367,928,135,1063,1914,55.54%,29.31%,1
臺中市,大里區,1408,470,284,754,70,824,1465,56.25%,32.08%,1
臺中市,大里區,1409,468,312,780,125,905,1581,57.24%,29.6%,1
臺中市,大里區,1410,473,310,783,115,898,1509,59.51%,31.35%,1
臺中市,大里區,1411,477,278,755,67,822,1570,52.36%,30.38%,1
臺中市,大里區,1412,446,304,750,82,832,1425,58.39%,31.3%,1
臺中市,大里區,1413,385,346,731,91,822,1384,59.39%,27.82%,1
臺中市,大里區,1414,325,220,545,40,585,1204,48.59%,26.99%,1
臺中市,大里區,1415,487,313,800,62,862,1761,48.95%,27.65%,1
臺中市,大里區,1416,390,273,663,44,707,1473,48%,26.48%,1
臺中市,大里區,1417,535,327,862,85,947,1675,56.54%,31.94%,1
臺中市,大里區,1418,577,320,897,94,991,1755,56.47%,32.88%,1
臺中市,大里區,1419,484,336,820,122,942,1593,59.13%,30.38%,1
臺中市,大里區,1420,524,380,904,93,997,1799,55.42%,29.13%,1
臺中市,大里區,1421,492,316,808,107,915,1606,56.97%,30.64%,1
臺中市,大里區,1422,555,378,933,65,998,1875,53.23%,29.6%,1
臺中市,大里區,1423,609,270,879,82,961,1670,57.54%,36.47%,1
臺中市,大里區,1424,545,372,917,101,1018,1898,53.64%,28.71%,1
臺中市,大里區,1425,500,310,810,66,876,1679,52.17%,29.78%,1
臺中市,大里區,1426,388,269,657,97,754,1373,54.92%,28.26%,1
臺中市,大里區,1427,412,242,654,99,753,1299,57.97%,31.72%,1
臺中市,大里區,1428,457,284,741,67,808,1430,56.5%,31.96%,1
臺中市,大里區,1429,678,392,1070,71,1141,1805,63.21%,37.56%,1
臺中市,大里區,1430,648,457,1105,59,1164,1806,64.45%,35.88%,1
臺中市,大里區,1431,784,329,1113,77,1190,1826,65.17%,42.94%,1
臺中市,大里區,1432,691,411,1102,75,1177,1805,65.21%,38.28%,1
臺中市,大里區,1433,628,439,1067,84,1151,1907,60.36%,32.93%,1
臺中市,大里區,1434,376,264,640,60,700,1103,63.46%,34.09%,1
臺中市,大里區,1435,431,261,692,59,751,1419,52.92%,30.37%,1
臺中市,大里區,1436,414,295,709,90,799,1434,55.72%,28.87%,1
臺中市,大里區,1437,554,274,828,71,899,1875,47.95%,29.55%,1
臺中市,大里區,1438,536,384,920,70,990,1862,53.17%,28.79%,1
臺中市,大里區,1439,536,393,929,61,990,1850,53.51%,28.97%,1
臺中市,大里區,1440,498,358,856,79,935,1622,57.64%,30.7%,1
臺中市,大里區,1441,558,355,913,93,1006,1638,61.42%,34.07%,1
臺中市,大里區,1442,555,369,924,96,1020,1633,62.46%,33.99%,1
臺中市,大里區,1443,542,341,883,73,956,1662,57.52%,32.61%,1
臺中市,大里區,1444,682,386,1068,67,1135,1917,59.21%,35.58%,1
臺中市,大里區,1445,445,359,804,89,893,1701,52.5%,26.16%,1
臺中市,大里區,1446,443,278,721,110,831,1549,53.65%,28.6%,1
臺中市,大里區,1447,473,382,855,79,934,1567,59.6%,30.19%,1
臺中市,大里區,1448,503,310,813,98,911,1614,56.44%,31.16%,1
臺中市,大里區,1449,554,365,919,131,1050,1811,57.98%,30.59%,1
臺中市,大里區,1450,408,283,691,65,756,1336,56.59%,30.54%,1
臺中市,大里區,1451,473,372,845,93,938,1759,53.33%,26.89%,1
臺中市,大里區,1452,502,336,838,101,939,1783,52.66%,28.15%,1
臺中市,大里區,1453,483,318,801,93,894,1736,51.5%,27.82%,1
臺中市,大里區,1454,615,361,976,72,1048,1874,55.92%,32.82%,1
臺中市,大里區,1455,520,412,932,148,1080,1889,57.17%,27.53%,1
臺中市,大里區,1456,577,395,972,72,1044,1947,53.62%,29.64%,1
臺中市,大里區,1457,640,407,1047,88,1135,1938,58.57%,33.02%,1
臺中市,大里區,1458,588,340,928,95,1023,1836,55.72%,32.03%,1
臺中市,大里區,1459,591,366,957,90,1047,1913,54.73%,30.89%,1
臺中市,大里區,1460,544,348,892,109,1001,1913,52.33%,28.44%,1
臺中市,大里區,1461,559,367,926,77,1003,1937,51.78%,28.86%,1
臺中市,大里區,1462,437,322,759,64,823,1508,54.58%,28.98%,1
臺中市,大里區,1463,429,313,742,40,782,1340,58.36%,32.01%,1
臺中市,大里區,1464,529,344,873,97,970,1656,58.57%,31.94%,1
臺中市,大里區,1465,393,267,660,73,733,1290,56.82%,30.47%,1
臺中市,大里區,1466,509,351,860,63,923,1655,55.77%,30.76%,1
臺中市,大里區,1467,359,226,585,37,622,1260,49.37%,28.49%,1
臺中市,大里區,1468,377,294,671,56,727,1247,58.3%,30.23%,1
臺中市,大里區,1469,391,310,701,161,862,1548,55.68%,25.26%,1
臺中市,和平區,1585,309,244,553,59,612,956,64.02%,32.32%,1
臺中市,和平區,1586,342,209,551,68,619,963,64.28%,35.51%,1
臺中市,和平區,1587,142,104,246,13,259,456,56.8%,31.14%,1
臺中市,和平區,1588,355,212,567,73,640,1011,63.3%,35.11%,1
臺中市,和平區,1589,222,129,351,27,378,636,59.43%,34.91%,1
臺中市,和平區,1590,85,55,140,9,149,270,55.19%,31.48%,1
臺中市,和平區,1591,226,95,321,36,357,460,77.61%,49.13%,1
臺中市,和平區,1592,137,87,224,18,242,321,75.39%,42.68%,1
臺中市,和平區,1593,253,188,441,54,495,783,63.22%,32.31%,1
臺中市,和平區,1594,125,65,190,10,200,336,59.52%,37.2%,1
臺中市,和平區,1595,162,135,297,16,313,451,69.4%,35.92%,1
臺中市,和平區,1596,96,81,177,16,193,366,52.73%,26.23%,1
臺中市,和平區,1597,198,113,311,14,325,771,42.15%,25.68%,1
臺中市,和平區,1598,172,102,274,43,317,574,55.23%,29.97%,1
臺中市,和平區,1599,73,63,136,32,168,274,61.31%,26.64%,1
臺中市,和平區,1600,35,45,80,7,87,157,55.41%,22.29%,1
臺中市,和平區,1601,185,134,319,34,353,713,49.51%,25.95%,1
臺南市,新營區,0116,426,290,716,78,794,1693,46.9%,25.16%,1
臺南市,新營區,0117,449,289,738,131,869,1561,55.67%,28.76%,1
臺南市,新營區,0118,436,300,736,67,803,1487,54%,29.32%,1
臺南市,新營區,0119,332,252,584,43,627,1232,50.89%,26.95%,1
臺南市,新營區,0120,296,213,509,30,539,1067,50.52%,27.74%,1
臺南市,新營區,0121,345,249,594,46,640,1419,45.1%,24.31%,1
臺南市,新營區,0122,483,253,736,43,779,1466,53.14%,32.95%,1
臺南市,新營區,0123,269,228,497,72,569,932,61.05%,28.86%,1
臺南市,新營區,0124,266,186,452,37,489,1099,44.49%,24.2%,1
臺南市,新營區,0125,183,129,312,40,352,757,46.5%,24.17%,1
臺南市,新營區,0126,239,223,462,35,497,888,55.97%,26.91%,1
臺南市,新營區,0127,295,218,513,32,545,1115,48.88%,26.46%,1
臺南市,新營區,0128,234,176,410,27,437,937,46.64%,24.97%,1
臺南市,新營區,0129,379,250,629,54,683,1387,49.24%,27.33%,1
臺南市,新營區,0130,494,195,689,67,756,1526,49.54%,32.37%,1
臺南市,新營區,0131,417,269,686,43,729,1301,56.03%,32.05%,1
臺南市,新營區,0132,496,304,800,65,865,1538,56.24%,32.25%,1
臺南市,新營區,0133,509,292,801,52,853,1584,53.85%,32.13%,1
臺南市,新營區,0134,550,313,863,37,900,1583,56.85%,34.74%,1
臺南市,新營區,0135,469,292,761,74,835,1530,54.58%,30.65%,1
臺南市,新營區,0136,349,279,628,65,693,1193,58.09%,29.25%,1
臺南市,新營區,0137,305,198,503,26,529,1439,36.76%,21.2%,1
臺南市,新營區,0138,439,309,748,64,812,1438,56.47%,30.53%,1
臺南市,新營區,0139,96,89,185,25,210,359,58.5%,26.74%,1
臺南市,新營區,0140,258,198,456,47,503,1233,40.79%,20.92%,1
臺南市,新營區,0141,300,165,465,31,496,1227,40.42%,24.45%,1
臺南市,新營區,0142,306,255,561,25,586,1320,44.39%,23.18%,1
臺南市,新營區,0143,479,264,743,40,783,1930,40.57%,24.82%,1
臺南市,新營區,0144,456,264,720,70,790,1501,52.63%,30.38%,1
臺南市,新營區,0145,394,270,664,53,717,1475,48.61%,26.71%,1
臺南市,新營區,0146,531,333,864,71,935,1753,53.34%,30.29%,1
臺南市,新營區,0147,455,328,783,59,842,1748,48.17%,26.03%,1
臺南市,新營區,0148,491,328,819,66,885,1741,50.83%,28.2%,1
臺南市,新營區,0149,372,276,648,32,680,1433,47.45%,25.96%,1
臺南市,新營區,0150,464,292,756,72,828,1595,51.91%,29.09%,1
臺南市,新營區,0151,223,169,392,15,407,959,42.44%,23.25%,1
臺南市,新營區,0152,627,305,932,105,1037,1865,55.6%,33.62%,1
臺南市,新營區,0153,385,298,683,98,781,1678,46.54%,22.94%,1
臺南市,新營區,0154,327,230,557,60,617,1373,44.94%,23.82%,1
臺南市,新營區,0155,272,210,482,45,527,1431,36.83%,19.01%,1
臺南市,新營區,0156,63,32,95,1,96,291,32.99%,21.65%,1
臺南市,新營區,0157,445,346,791,54,845,1749,48.31%,25.44%,1
臺南市,新營區,0158,497,278,775,49,824,1862,44.25%,26.69%,1
臺南市,新營區,0159,532,328,860,118,978,1821,53.71%,29.21%,1
臺南市,新營區,0160,459,317,776,70,846,1845,45.85%,24.88%,1
臺南市,新營區,0161,107,71,178,13,191,542,35.24%,19.74%,1
臺南市,新營區,0162,85,48,133,3,136,402,33.83%,21.14%,1
臺南市,新營區,0163,179,162,341,70,411,703,58.46%,25.46%,1
臺南市,新營區,0164,226,147,373,50,423,941,44.95%,24.02%,1
臺南市,鹽水區,0085,271,203,474,80,554,1037,53.42%,26.13%,1
臺南市,鹽水區,0086,121,110,231,26,257,480,53.54%,25.21%,1
臺南市,鹽水區,0087,200,136,336,43,379,636,59.59%,31.45%,1
臺南市,鹽水區,0088,72,64,136,16,152,321,47.35%,22.43%,1
臺南市,鹽水區,0089,162,92,254,40,294,497,59.15%,32.6%,1
臺南市,鹽水區,0090,222,178,400,25,425,759,55.99%,29.25%,1
臺南市,鹽水區,0091,88,50,138,25,163,341,47.8%,25.81%,1
臺南市,鹽水區,0092,121,118,239,32,271,507,53.45%,23.87%,1
臺南市,鹽水區,0093,171,164,335,28,363,863,42.06%,19.81%,1
臺南市,鹽水區,0094,321,263,584,42,626,1373,45.59%,23.38%,1
臺南市,鹽水區,0095,397,283,680,70,750,1507,49.77%,26.34%,1
臺南市,鹽水區,0096,368,275,643,83,726,1374,52.84%,26.78%,1
臺南市,鹽水區,0097,297,204,501,69,570,1244,45.82%,23.87%,1
臺南市,鹽水區,0098,284,188,472,63,535,1022,52.35%,27.79%,1
臺南市,鹽水區,0099,166,114,280,49,329,921,35.72%,18.02%,1
臺南市,鹽水區,0100,201,197,398,59,457,847,53.96%,23.73%,1
臺南市,鹽水區,0101,121,118,239,3,242,736,32.88%,16.44%,1
臺南市,鹽水區,0102,190,139,329,25,354,761,46.52%,24.97%,1
臺南市,鹽水區,0103,76,50,126,14,140,285,49.12%,26.67%,1
臺南市,鹽水區,0104,104,87,191,34,225,493,45.64%,21.1%,1
臺南市,鹽水區,0105,138,72,210,23,233,621,37.52%,22.22%,1
臺南市,鹽水區,0106,77,46,123,10,133,392,33.93%,19.64%,1
臺南市,鹽水區,0107,229,145,374,45,419,925,45.3%,24.76%,1
臺南市,鹽水區,0108,152,110,262,46,308,728,42.31%,20.88%,1
臺南市,鹽水區,0109,22,30,52,28,80,214,37.38%,10.28%,1
臺南市,鹽水區,0110,98,60,158,18,176,387,45.48%,25.32%,1
臺南市,鹽水區,0111,86,38,124,26,150,301,49.83%,28.57%,1
臺南市,鹽水區,0112,131,117,248,40,288,755,38.15%,17.35%,1
臺南市,鹽水區,0113,65,58,123,25,148,365,40.55%,17.81%,1
臺南市,鹽水區,0114,215,151,366,36,402,935,42.99%,22.99%,1
臺南市,鹽水區,0115,113,61,174,40,214,494,43.32%,22.87%,1
臺南市,白河區,0030,308,231,539,83,622,1176,52.89%,26.19%,1
臺南市,白河區,0031,152,97,249,21,270,546,49.45%,27.84%,1
臺南市,白河區,0032,245,183,428,35,463,859,53.9%,28.52%,1
臺南市,白河區,0033,264,189,453,59,512,946,54.12%,27.91%,1
臺南市,白河區,0034,278,213,491,58,549,1116,49.19%,24.91%,1
臺南市,白河區,0035,300,185,485,38,523,1397,37.44%,21.47%,1
臺南市,白河區,0036,159,103,262,23,285,756,37.7%,21.03%,1
臺南市,白河區,0037,216,150,366,58,424,871,48.68%,24.8%,1
臺南市,白河區,0038,228,168,396,48,444,897,49.5%,25.42%,1
臺南市,白河區,0039,118,104,222,40,262,784,33.42%,15.05%,1
臺南市,白河區,0040,122,87,209,26,235,572,41.08%,21.33%,1
臺南市,白河區,0041,74,53,127,9,136,457,29.76%,16.19%,1
臺南市,白河區,0042,98,74,172,24,196,600,32.67%,16.33%,1
臺南市,白河區,0043,65,38,103,5,108,375,28.8%,17.33%,1
臺南市,白河區,0044,61,50,111,15,126,508,24.8%,12.01%,1
臺南市,白河區,0045,81,86,167,12,179,631,28.37%,12.84%,1
臺南市,白河區,0046,57,40,97,16,113,391,28.9%,14.58%,1
臺南市,白河區,0047,119,102,221,21,242,799,30.29%,14.89%,1
臺南市,白河區,0048,74,60,134,23,157,506,31.03%,14.62%,1
臺南市,白河區,0049,179,113,292,44,336,832,40.38%,21.51%,1
臺南市,白河區,0050,274,212,486,42,528,1179,44.78%,23.24%,1
臺南市,白河區,0051,117,106,223,14,237,744,31.85%,15.73%,1
臺南市,白河區,0052,139,94,233,29,262,699,37.48%,19.89%,1
臺南市,白河區,0053,99,94,193,16,209,633,33.02%,15.64%,1
臺南市,白河區,0054,213,164,377,81,458,859,53.32%,24.8%,1
臺南市,白河區,0055,204,121,325,56,381,884,43.1%,23.08%,1
臺南市,白河區,0056,92,85,177,16,193,740,26.08%,12.43%,1
臺南市,白河區,0057,294,188,482,66,548,1334,41.08%,22.04%,1
臺南市,白河區,0058,164,108,272,81,353,723,48.82%,22.68%,1
臺南市,白河區,0059,172,124,296,80,376,682,55.13%,25.22%,1
臺南市,白河區,0060,221,155,376,63,439,855,51.35%,25.85%,1
臺南市,白河區,0061,107,71,178,36,214,543,39.41%,19.71%,1
臺南市,柳營區,0165,271,227,498,65,563,1166,48.28%,23.24%,1
臺南市,柳營區,0166,183,137,320,19,339,625,54.24%,29.28%,1
臺南市,柳營區,0167,164,114,278,31,309,738,41.87%,22.22%,1
臺南市,柳營區,0168,254,148,402,34,436,834,52.28%,30.46%,1
臺南市,柳營區,0169,262,196,458,43,501,1104,45.38%,23.73%,1
臺南市,柳營區,0170,235,167,402,27,429,1015,42.27%,23.15%,1
臺南市,柳營區,0171,490,310,800,139,939,1720,54.59%,28.49%,1
臺南市,柳營區,0172,345,231,576,81,657,1391,47.23%,24.8%,1
臺南市,柳營區,0173,95,79,174,10,184,425,43.29%,22.35%,1
臺南市,柳營區,0174,56,47,103,24,127,318,39.94%,17.61%,1
臺南市,柳營區,0175,197,132,329,49,378,753,50.2%,26.16%,1
臺南市,柳營區,0176,173,102,275,69,344,730,47.12%,23.7%,1
臺南市,柳營區,0177,172,133,305,48,353,725,48.69%,23.72%,1
臺南市,柳營區,0178,235,135,370,50,420,787,53.37%,29.86%,1
臺南市,柳營區,0179,75,64,139,31,170,297,57.24%,25.25%,1
臺南市,柳營區,0180,199,115,314,55,369,673,54.83%,29.57%,1
臺南市,柳營區,0181,187,119,306,64,370,640,57.81%,29.22%,1
臺南市,柳營區,0182,158,103,261,24,285,660,43.18%,23.94%,1
臺南市,柳營區,0183,274,187,461,56,517,1212,42.66%,22.61%,1
臺南市,柳營區,0184,55,31,86,3,89,202,44.06%,27.23%,1
臺南市,柳營區,0185,243,165,408,98,506,1049,48.24%,23.16%,1
臺南市,柳營區,0186,37,32,69,2,71,158,44.94%,23.42%,1
臺南市,柳營區,0187,224,153,377,87,464,921,50.38%,24.32%,1
臺南市,柳營區,0188,112,71,183,25,208,504,41.27%,22.22%,1
臺南市,柳營區,0189,38,21,59,6,65,157,41.4%,24.2%,1
臺南市,後壁區,0001,205,162,367,58,425,743,57.2%,27.59%,1
臺南市,後壁區,0002,208,180,388,45,433,898,48.22%,23.16%,1
臺南市,後壁區,0003,181,121,302,68,370,786,47.07%,23.03%,1
臺南市,後壁區,0004,108,100,208,64,272,534,50.94%,20.22%,1
臺南市,後壁區,0005,263,180,443,87,530,1034,51.26%,25.44%,1
臺南市,後壁區,0006,44,45,89,17,106,232,45.69%,18.97%,1
臺南市,後壁區,0007,102,85,187,47,234,479,48.85%,21.29%,1
臺南市,後壁區,0008,175,158,333,43,376,837,44.92%,20.91%,1
臺南市,後壁區,0009,209,175,384,45,429,1085,39.54%,19.26%,1
臺南市,後壁區,0010,220,153,373,22,395,1157,34.14%,19.01%,1
臺南市,後壁區,0011,186,119,305,80,385,755,50.99%,24.64%,1
臺南市,後壁區,0012,126,78,204,42,246,458,53.71%,27.51%,1
臺南市,後壁區,0013,87,59,146,26,172,371,46.36%,23.45%,1
臺南市,後壁區,0014,143,123,266,61,327,676,48.37%,21.15%,1
臺南市,後壁區,0015,94,58,152,40,192,428,44.86%,21.96%,1
臺南市,後壁區,0016,103,74,177,18,195,547,35.65%,18.83%,1
臺南市,後壁區,0017,97,86,183,49,232,455,50.99%,21.32%,1
臺南市,後壁區,0018,173,152,325,78,403,984,40.96%,17.58%,1
臺南市,後壁區,0019,108,78,186,37,223,483,46.17%,22.36%,1
臺南市,後壁區,0020,126,66,192,33,225,536,41.98%,23.51%,1
臺南市,後壁區,0021,177,113,290,16,306,958,31.94%,18.48%,1
臺南市,後壁區,0022,132,78,210,41,251,441,56.92%,29.93%,1
臺南市,後壁區,0023,153,134,287,70,357,677,52.73%,22.6%,1
臺南市,後壁區,0024,252,185,437,80,517,996,51.91%,25.3%,1
臺南市,後壁區,0025,282,231,513,34,547,1255,43.59%,22.47%,1
臺南市,後壁區,0026,164,107,271,20,291,678,42.92%,24.19%,1
臺南市,後壁區,0027,98,86,184,16,200,553,36.17%,17.72%,1
臺南市,後壁區,0028,119,79,198,20,218,616,35.39%,19.32%,1
臺南市,後壁區,0029,281,203,484,48,532,1189,44.74%,23.63%,1
臺南市,東山區,0062,316,222,538,82,620,1401,44.25%,22.56%,1
臺南市,東山區,0063,241,170,411,54,465,1185,39.24%,20.34%,1
臺南市,東山區,0064,239,206,445,84,529,1303,40.6%,18.34%,1
臺南市,東山區,0065,154,100,254,38,292,732,39.89%,21.04%,1
臺南市,東山區,0066,135,86,221,51,272,721,37.73%,18.72%,1
臺南市,東山區,0067,196,142,338,59,397,1104,35.96%,17.75%,1
臺南市,東山區,0068,188,129,317,42,359,943,38.07%,19.94%,1
臺南市,東山區,0069,81,53,134,3,137,653,20.98%,12.4%,1
臺南市,東山區,0070,127,86,213,77,290,596,48.66%,21.31%,1
臺南市,東山區,0071,189,132,321,75,396,878,45.1%,21.53%,1
臺南市,東山區,0072,122,134,256,64,320,771,41.5%,15.82%,1
臺南市,東山區,0073,105,80,185,25,210,483,43.48%,21.74%,1
臺南市,東山區,0074,171,99,270,47,317,640,49.53%,26.72%,1
臺南市,東山區,0075,47,43,90,7,97,425,22.82%,11.06%,1
臺南市,東山區,0076,81,47,128,17,145,394,36.8%,20.56%,1
臺南市,東山區,0077,85,68,153,36,189,373,50.67%,22.79%,1
臺南市,東山區,0078,200,150,350,52,402,1257,31.98%,15.91%,1
臺南市,東山區,0079,113,74,187,12,199,887,22.44%,12.74%,1
臺南市,東山區,0080,102,48,150,11,161,658,24.47%,15.5%,1
臺南市,東山區,0081,148,125,273,39,312,1101,28.34%,13.44%,1
臺南市,東山區,0082,145,97,242,19,261,1057,24.69%,13.72%,1
臺南市,東山區,0083,144,107,251,50,301,639,47.1%,22.54%,1
臺南市,東山區,0084,43,53,96,21,117,270,43.33%,15.93%,1
臺南市,麻豆區,0381,309,234,543,61,604,1205,50.12%,25.64%,1
臺南市,麻豆區,0382,178,152,330,37,367,660,55.61%,26.97%,1
臺南市,麻豆區,0383,136,121,257,32,289,523,55.26%,26%,1
臺南市,麻豆區,0384,501,226,727,52,779,1597,48.78%,31.37%,1
臺南市,麻豆區,0385,358,276,634,68,702,1262,55.63%,28.37%,1
臺南市,麻豆區,0386,386,306,692,57,749,1325,56.53%,29.13%,1
臺南市,麻豆區,0387,359,260,619,46,665,1384,48.05%,25.94%,1
臺南市,麻豆區,0388,304,231,535,30,565,1121,50.4%,27.12%,1
臺南市,麻豆區,0389,224,232,456,21,477,1021,46.72%,21.94%,1
臺南市,麻豆區,0390,126,312,438,27,465,954,48.74%,13.21%,1
臺南市,麻豆區,0391,343,265,608,40,648,1513,42.83%,22.67%,1
臺南市,麻豆區,0392,385,302,687,61,748,1726,43.34%,22.31%,1
臺南市,麻豆區,0393,497,325,822,84,906,1804,50.22%,27.55%,1
臺南市,麻豆區,0394,245,211,456,45,501,1106,45.3%,22.15%,1
臺南市,麻豆區,0395,393,313,706,50,756,1503,50.3%,26.15%,1
臺南市,麻豆區,0396,358,249,607,52,659,1302,50.61%,27.5%,1
臺南市,麻豆區,0397,170,121,291,14,305,645,47.29%,26.36%,1
臺南市,麻豆區,0398,224,173,397,41,438,777,56.37%,28.83%,1
臺南市,麻豆區,0399,378,286,664,55,719,1612,44.6%,23.45%,1
臺南市,麻豆區,0400,170,118,288,15,303,718,42.2%,23.68%,1
臺南市,麻豆區,0401,374,253,627,37,664,1656,40.1%,22.58%,1
臺南市,麻豆區,0402,317,250,567,98,665,1355,49.08%,23.39%,1
臺南市,麻豆區,0403,220,127,347,25,372,977,38.08%,22.52%,1
臺南市,麻豆區,0404,223,187,410,32,442,1012,43.68%,22.04%,1
臺南市,麻豆區,0405,165,153,318,21,339,626,54.15%,26.36%,1
臺南市,麻豆區,0406,72,57,129,6,135,467,28.91%,15.42%,1
臺南市,麻豆區,0407,290,227,517,31,548,1260,43.49%,23.02%,1
臺南市,麻豆區,0408,306,207,513,55,568,1111,51.13%,27.54%,1
臺南市,麻豆區,0409,145,114,259,35,294,550,53.45%,26.36%,1
臺南市,麻豆區,0410,179,177,356,54,410,798,51.38%,22.43%,1
臺南市,麻豆區,0411,250,167,417,87,504,852,59.15%,29.34%,1
臺南市,麻豆區,0412,190,121,311,14,325,830,39.16%,22.89%,1
臺南市,麻豆區,0413,195,166,361,18,379,941,40.28%,20.72%,1
臺南市,麻豆區,0414,294,231,525,56,581,1158,50.17%,25.39%,1
臺南市,麻豆區,0415,144,100,244,16,260,612,42.48%,23.53%,1
臺南市,下營區,0343,344,231,575,56,631,1558,40.5%,22.08%,1
臺南市,下營區,0344,225,164,389,40,429,1112,38.58%,20.23%,1
臺南市,下營區,0345,205,156,361,61,422,893,47.26%,22.96%,1
臺南市,下營區,0346,329,252,581,64,645,1623,39.74%,20.27%,1
臺南市,下營區,0347,389,274,663,97,760,1568,48.47%,24.81%,1
臺南市,下營區,0348,251,196,447,59,506,985,51.37%,25.48%,1
臺南市,下營區,0349,247,136,383,23,406,953,42.6%,25.92%,1
臺南市,下營區,0350,258,173,431,35,466,1031,45.2%,25.02%,1
臺南市,下營區,0351,311,201,512,86,598,1077,55.52%,28.88%,1
臺南市,下營區,0352,130,108,238,45,283,703,40.26%,18.49%,1
臺南市,下營區,0353,186,138,324,23,347,854,40.63%,21.78%,1
臺南市,下營區,0354,283,206,489,68,557,1164,47.85%,24.31%,1
臺南市,下營區,0355,248,182,430,28,458,1091,41.98%,22.73%,1
臺南市,下營區,0356,247,174,421,69,490,959,51.09%,25.76%,1
臺南市,下營區,0357,238,157,395,39,434,935,46.42%,25.45%,1
臺南市,下營區,0358,233,163,396,54,450,893,50.39%,26.09%,1
臺南市,下營區,0359,368,205,573,99,672,1293,51.97%,28.46%,1
臺南市,下營區,0360,302,221,523,103,626,1185,52.83%,25.49%,1
臺南市,下營區,0361,209,144,353,22,375,1070,35.05%,19.53%,1
臺南市,六甲區,0362,230,177,407,59,466,819,56.9%,28.08%,1
臺南市,六甲區,0363,166,137,303,18,321,645,49.77%,25.74%,1
臺南市,六甲區,0364,283,316,599,52,651,1444,45.08%,19.6%,1
臺南市,六甲區,0365,316,266,582,50,632,1554,40.67%,20.33%,1
臺南市,六甲區,0366,243,193,436,46,482,1171,41.16%,20.75%,1
臺南市,六甲區,0367,325,252,577,70,647,1351,47.89%,24.06%,1
臺南市,六甲區,0368,218,164,382,83,465,1010,46.04%,21.58%,1
臺南市,六甲區,0369,218,154,372,62,434,919,47.23%,23.72%,1
臺南市,六甲區,0370,328,249,577,76,653,1369,47.7%,23.96%,1
臺南市,六甲區,0371,266,170,436,69,505,976,51.74%,27.25%,1
臺南市,六甲區,0372,296,198,494,58,552,1015,54.38%,29.16%,1
臺南市,六甲區,0373,282,194,476,46,522,1176,44.39%,23.98%,1
臺南市,六甲區,0374,233,193,426,56,482,939,51.33%,24.81%,1
臺南市,六甲區,0375,174,143,317,56,373,712,52.39%,24.44%,1
臺南市,六甲區,0376,225,181,406,50,456,881,51.76%,25.54%,1
臺南市,六甲區,0377,347,269,616,71,687,1184,58.02%,29.31%,1
臺南市,六甲區,0378,178,148,326,35,361,599,60.27%,29.72%,1
臺南市,六甲區,0379,126,91,217,12,229,759,30.17%,16.6%,1
臺南市,六甲區,0380,120,96,216,28,244,621,39.29%,19.32%,1
臺南市,官田區,0416,242,198,440,22,462,1104,41.85%,21.92%,1
臺南市,官田區,0417,258,168,426,48,474,965,49.12%,26.74%,1
臺南市,官田區,0418,369,264,633,53,686,1402,48.93%,26.32%,1
臺南市,官田區,0419,465,379,844,61,905,1653,54.75%,28.13%,1
臺南市,官田區,0420,224,164,388,51,439,966,45.45%,23.19%,1
臺南市,官田區,0421,68,41,109,15,124,284,43.66%,23.94%,1
臺南市,官田區,0422,59,48,107,6,113,402,28.11%,14.68%,1
臺南市,官田區,0423,242,215,457,11,468,982,47.66%,24.64%,1
臺南市,官田區,0424,241,139,380,29,409,975,41.95%,24.72%,1
臺南市,官田區,0425,209,141,350,47,397,802,49.5%,26.06%,1
臺南市,官田區,0426,317,227,544,55,599,1118,53.58%,28.35%,1
臺南市,官田區,0427,375,290,665,33,698,1455,47.97%,25.77%,1
臺南市,官田區,0428,309,241,550,43,593,1208,49.09%,25.58%,1
臺南市,官田區,0429,311,209,520,71,591,1293,45.71%,24.05%,1
臺南市,官田區,0430,115,100,215,24,239,607,39.37%,18.95%,1
臺南市,官田區,0431,106,98,204,36,240,501,47.9%,21.16%,1
臺南市,官田區,0432,192,141,333,65,398,728,54.67%,26.37%,1
臺南市,官田區,0433,189,171,360,26,386,842,45.84%,22.45%,1
臺南市,官田區,0434,129,91,220,55,275,515,53.4%,25.05%,1
臺南市,官田區,0435,198,115,313,19,332,873,38.03%,22.68%,1
臺南市,大內區,0436,141,125,266,57,323,759,42.56%,18.58%,1
臺南市,大內區,0437,46,38,84,3,87,262,33.21%,17.56%,1
臺南市,大內區,0438,112,85,197,21,218,646,33.75%,17.34%,1
臺南市,大內區,0439,320,198,518,77,595,1473,40.39%,21.72%,1
臺南市,大內區,0440,270,156,426,67,493,915,53.88%,29.51%,1
臺南市,大內區,0441,217,171,388,43,431,779,55.33%,27.86%,1
臺南市,大內區,0442,180,158,338,51,389,637,61.07%,28.26%,1
臺南市,大內區,0443,212,166,378,41,419,993,42.2%,21.35%,1
臺南市,大內區,0444,217,134,351,57,408,766,53.26%,28.33%,1
臺南市,大內區,0445,242,132,374,40,414,841,49.23%,28.78%,1
臺南市,大內區,0446,153,91,244,41,285,583,48.89%,26.24%,1
臺南市,佳里區,0282,389,302,691,81,772,1391,55.5%,27.97%,1
臺南市,佳里區,0283,267,171,438,44,482,829,58.14%,32.21%,1
臺南市,佳里區,0284,325,214,539,80,619,1401,44.18%,23.2%,1
臺南市,佳里區,0285,352,233,585,22,607,1452,41.8%,24.24%,1
臺南市,佳里區,0286,399,273,672,66,738,1382,53.4%,28.87%,1
臺南市,佳里區,0287,438,264,702,71,773,1463,52.84%,29.94%,1
臺南市,佳里區,0288,328,238,566,57,623,1280,48.67%,25.63%,1
臺南市,佳里區,0289,428,271,699,104,803,1486,54.04%,28.8%,1
臺南市,佳里區,0290,411,280,691,67,758,1378,55.01%,29.83%,1
臺南市,佳里區,0291,455,276,731,74,805,1505,53.49%,30.23%,1
臺南市,佳里區,0292,524,340,864,106,970,1860,52.15%,28.17%,1
臺南市,佳里區,0293,304,193,497,136,633,1134,55.82%,26.81%,1
臺南市,佳里區,0294,426,266,692,64,756,1426,53.02%,29.87%,1
臺南市,佳里區,0295,515,346,861,76,937,1779,52.67%,28.95%,1
臺南市,佳里區,0296,599,356,955,82,1037,1906,54.41%,31.43%,1
臺南市,佳里區,0297,380,267,647,66,713,1425,50.04%,26.67%,1
臺南市,佳里區,0298,359,239,598,57,655,1255,52.19%,28.61%,1
臺南市,佳里區,0299,406,241,647,99,746,1524,48.95%,26.64%,1
臺南市,佳里區,0300,469,288,757,55,812,1631,49.79%,28.76%,1
臺南市,佳里區,0301,464,320,784,75,859,1546,55.56%,30.01%,1
臺南市,佳里區,0302,388,268,656,49,705,1187,59.39%,32.69%,1
臺南市,佳里區,0303,410,254,664,49,713,1381,51.63%,29.69%,1
臺南市,佳里區,0304,376,248,624,34,658,1364,48.24%,27.57%,1
臺南市,佳里區,0305,389,271,660,27,687,1314,52.28%,29.6%,1
臺南市,佳里區,0306,350,211,561,75,636,1164,54.64%,30.07%,1
臺南市,佳里區,0307,276,181,457,54,511,961,53.17%,28.72%,1
臺南市,佳里區,0308,308,215,523,67,590,1218,48.44%,25.29%,1
臺南市,佳里區,0309,260,180,440,45,485,919,52.77%,28.29%,1
臺南市,佳里區,0310,187,127,314,33,347,689,50.36%,27.14%,1
臺南市,佳里區,0311,78,77,155,14,169,383,44.13%,20.37%,1
臺南市,佳里區,0312,379,257,636,83,719,1507,47.71%,25.15%,1
臺南市,佳里區,0313,200,99,299,45,344,702,49%,28.49%,1
臺南市,佳里區,0314,288,154,442,52,494,907,54.47%,31.75%,1
臺南市,佳里區,0315,281,210,491,64,555,937,59.23%,29.99%,1
臺南市,佳里區,0316,225,210,435,111,546,1030,53.01%,21.84%,1
臺南市,佳里區,0317,258,190,448,61,509,981,51.89%,26.3%,1
臺南市,佳里區,0318,187,136,323,23,346,787,43.96%,23.76%,1
臺南市,佳里區,0319,366,307,673,92,765,1513,50.56%,24.19%,1
臺南市,佳里區,0320,155,114,269,20,289,714,40.48%,21.71%,1
臺南市,佳里區,0321,169,146,315,54,369,745,49.53%,22.68%,1
臺南市,佳里區,0322,206,182,388,33,421,951,44.27%,21.66%,1
臺南市,學甲區,0208,232,175,407,73,480,862,55.68%,26.91%,1
臺南市,學甲區,0209,186,135,321,11,332,611,54.34%,30.44%,1
臺南市,學甲區,0210,237,203,440,36,476,936,50.85%,25.32%,1
臺南市,學甲區,0211,251,205,456,46,502,1066,47.09%,23.55%,1
臺南市,學甲區,0212,236,201,437,41,478,869,55.01%,27.16%,1
臺南市,學甲區,0213,175,113,288,37,325,635,51.18%,27.56%,1
臺南市,學甲區,0214,217,134,351,25,376,822,45.74%,26.4%,1
臺南市,學甲區,0215,101,67,168,19,187,443,42.21%,22.8%,1
臺南市,學甲區,0216,373,267,640,45,685,1370,50%,27.23%,1
臺南市,學甲區,0217,339,203,542,62,604,1117,54.07%,30.35%,1
臺南市,學甲區,0218,358,228,586,94,680,1365,49.82%,26.23%,1
臺南市,學甲區,0219,380,241,621,92,713,1489,47.88%,25.52%,1
臺南市,學甲區,0220,114,96,210,46,256,627,40.83%,18.18%,1
臺南市,學甲區,0221,274,204,478,31,509,1052,48.38%,26.05%,1
臺南市,學甲區,0222,298,219,517,37,554,1183,46.83%,25.19%,1
臺南市,學甲區,0223,215,145,360,31,391,979,39.94%,21.96%,1
臺南市,學甲區,0224,244,233,477,81,558,1241,44.96%,19.66%,1
臺南市,學甲區,0225,171,128,299,27,326,843,38.67%,20.28%,1
臺南市,學甲區,0226,142,99,241,38,279,580,48.1%,24.48%,1
臺南市,學甲區,0227,179,97,276,19,295,832,35.46%,21.51%,1
臺南市,學甲區,0228,60,77,137,12,149,406,36.7%,14.78%,1
臺南市,學甲區,0229,234,149,383,42,425,818,51.96%,28.61%,1
臺南市,學甲區,0230,212,151,363,27,390,1052,37.07%,20.15%,1
臺南市,學甲區,0231,112,111,223,12,235,578,40.66%,19.38%,1
臺南市,學甲區,0232,75,65,140,28,168,430,39.07%,17.44%,1
臺南市,學甲區,0233,96,57,153,12,165,361,45.71%,26.59%,1
臺南市,西港區,0323,255,164,419,23,442,933,47.37%,27.33%,1
臺南市,西港區,0324,232,199,431,33,464,901,51.5%,25.75%,1
臺南市,西港區,0325,329,222,551,38,589,1314,44.82%,25.04%,1
臺南市,西港區,0326,334,272,606,88,694,1349,51.45%,24.76%,1
臺南市,西港區,0327,278,213,491,72,563,1014,55.52%,27.42%,1
臺南市,西港區,0328,389,265,654,61,715,1900,37.63%,20.47%,1
臺南市,西港區,0329,393,271,664,59,723,1663,43.48%,23.63%,1
臺南市,西港區,0330,140,136,276,21,297,738,40.24%,18.97%,1
臺南市,西港區,0331,353,225,578,66,644,1211,53.18%,29.15%,1
臺南市,西港區,0332,86,66,152,30,182,382,47.64%,22.51%,1
臺南市,西港區,0333,194,126,320,17,337,786,42.88%,24.68%,1
臺南市,西港區,0334,201,143,344,25,369,838,44.03%,23.99%,1
臺南市,西港區,0335,306,238,544,52,596,1449,41.13%,21.12%,1
臺南市,西港區,0336,284,233,517,49,566,1479,38.27%,19.2%,1
臺南市,西港區,0337,216,139,355,69,424,763,55.57%,28.31%,1
臺南市,西港區,0338,290,206,496,38,534,1297,41.17%,22.36%,1
臺南市,西港區,0339,334,226,560,44,604,1393,43.36%,23.98%,1
臺南市,西港區,0340,196,141,337,21,358,958,37.37%,20.46%,1
臺南市,西港區,0341,115,66,181,20,201,391,51.41%,29.41%,1
臺南市,西港區,0342,205,161,366,54,420,805,52.17%,25.47%,1
臺南市,七股區,0258,129,91,220,19,239,534,44.76%,24.16%,1
臺南市,七股區,0259,132,107,239,21,260,508,51.18%,25.98%,1
臺南市,七股區,0260,132,72,204,8,212,665,31.88%,19.85%,1
臺南市,七股區,0261,195,119,314,24,338,834,40.53%,23.38%,1
臺南市,七股區,0262,162,115,277,22,299,810,36.91%,20%,1
臺南市,七股區,0263,83,52,135,12,147,480,30.63%,17.29%,1
臺南市,七股區,0264,90,61,151,10,161,445,36.18%,20.22%,1
臺南市,七股區,0265,113,67,180,13,193,680,28.38%,16.62%,1
臺南市,七股區,0266,147,97,244,14,258,838,30.79%,17.54%,1
臺南市,七股區,0267,137,87,224,30,254,780,32.56%,17.56%,1
臺南市,七股區,0268,91,72,163,21,184,350,52.57%,26%,1
臺南市,七股區,0269,254,182,436,82,518,907,57.11%,28%,1
臺南市,七股區,0270,172,113,285,31,316,780,40.51%,22.05%,1
臺南市,七股區,0271,395,243,638,49,687,1658,41.44%,23.82%,1
臺南市,七股區,0272,228,125,353,36,389,913,42.61%,24.97%,1
臺南市,七股區,0273,299,211,510,81,591,1202,49.17%,24.88%,1
臺南市,七股區,0274,126,101,227,11,238,696,34.2%,18.1%,1
臺南市,七股區,0275,155,109,264,42,306,647,47.3%,23.96%,1
臺南市,七股區,0276,197,127,324,63,387,622,62.22%,31.67%,1
臺南市,七股區,0277,307,246,553,114,667,1175,56.77%,26.13%,1
臺南市,七股區,0278,136,141,277,25,302,698,43.27%,19.48%,1
臺南市,七股區,0279,268,165,433,75,508,983,51.68%,27.26%,1
臺南市,七股區,0280,252,179,431,55,486,1366,35.58%,18.45%,1
臺南市,七股區,0281,311,205,516,89,605,1379,43.87%,22.55%,1
臺南市,將軍區,0234,335,220,555,72,627,1110,56.49%,30.18%,1
臺南市,將軍區,0235,450,249,699,45,744,1418,52.47%,31.73%,1
臺南市,將軍區,0236,225,179,404,29,433,969,44.69%,23.22%,1
臺南市,將軍區,0237,136,120,256,49,305,519,58.77%,26.2%,1
臺南市,將軍區,0238,272,198,470,44,514,1106,46.47%,24.59%,1
臺南市,將軍區,0239,131,95,226,43,269,542,49.63%,24.17%,1
臺南市,將軍區,0240,57,48,105,12,117,315,37.14%,18.1%,1
臺南市,將軍區,0241,129,77,206,32,238,584,40.75%,22.09%,1
臺南市,將軍區,0242,91,70,161,14,175,398,43.97%,22.86%,1
臺南市,將軍區,0243,119,89,208,23,231,608,37.99%,19.57%,1
臺南市,將軍區,0244,116,82,198,20,218,442,49.32%,26.24%,1
臺南市,將軍區,0245,100,117,217,15,232,650,35.69%,15.38%,1
臺南市,將軍區,0246,98,75,173,14,187,573,32.64%,17.1%,1
臺南市,將軍區,0247,126,71,197,13,210,617,34.04%,20.42%,1
臺南市,將軍區,0248,143,97,240,24,264,573,46.07%,24.96%,1
臺南市,將軍區,0249,114,70,184,30,214,434,49.31%,26.27%,1
臺南市,將軍區,0250,164,124,288,21,309,849,36.4%,19.32%,1
臺南市,將軍區,0251,143,85,228,29,257,645,39.84%,22.17%,1
臺南市,將軍區,0252,118,93,211,16,227,690,32.9%,17.1%,1
臺南市,將軍區,0253,94,80,174,13,187,663,28.21%,14.18%,1
臺南市,將軍區,0254,233,166,399,40,439,1175,37.36%,19.83%,1
臺南市,將軍區,0255,150,94,244,34,278,837,33.21%,17.92%,1
臺南市,將軍區,0256,239,180,419,136,555,1061,52.31%,22.53%,1
臺南市,將軍區,0257,181,99,280,26,306,976,31.35%,18.55%,1
臺南市,北門區,0190,105,81,186,16,202,484,41.74%,21.69%,1
臺南市,北門區,0191,103,44,147,18,165,401,41.15%,25.69%,1
臺南市,北門區,0192,93,54,147,8,155,456,33.99%,20.39%,1
臺南市,北門區,0193,110,74,184,20,204,382,53.4%,28.8%,1
臺南市,北門區,0194,93,60,153,24,177,356,49.72%,26.12%,1
臺南市,北門區,0195,73,59,132,7,139,389,35.73%,18.77%,1
臺南市,北門區,0196,171,111,282,12,294,742,39.62%,23.05%,1
臺南市,北門區,0197,143,73,216,15,231,599,38.56%,23.87%,1
臺南市,北門區,0198,116,92,208,35,243,594,40.91%,19.53%,1
臺南市,北門區,0199,110,108,218,26,244,572,42.66%,19.23%,1
臺南市,北門區,0200,52,37,89,4,93,318,29.25%,16.35%,1
臺南市,北門區,0201,92,70,162,17,179,473,37.84%,19.45%,1
臺南市,北門區,0202,168,106,274,15,289,954,30.29%,17.61%,1
臺南市,北門區,0203,207,137,344,45,389,737,52.78%,28.09%,1
臺南市,北門區,0204,122,86,208,13,221,679,32.55%,17.97%,1
臺南市,北門區,0205,94,70,164,33,197,521,37.81%,18.04%,1
臺南市,北門區,0206,109,76,185,24,209,632,33.07%,17.25%,1
臺南市,北門區,0207,128,84,212,15,227,636,35.69%,20.13%,1
臺南市,新化區,0581,249,152,401,52,453,746,60.72%,33.38%,1
臺南市,新化區,0582,323,269,592,59,651,1102,59.07%,29.31%,1
臺南市,新化區,0583,102,91,193,22,215,370,58.11%,27.57%,1
臺南市,新化區,0584,266,216,482,85,567,947,59.87%,28.09%,1
臺南市,新化區,0585,217,326,543,69,612,1154,53.03%,18.8%,1
臺南市,新化區,0586,295,236,531,76,607,1082,56.1%,27.26%,1
臺南市,新化區,0587,303,237,540,71,611,1075,56.84%,28.19%,1
臺南市,新化區,0588,153,150,303,33,336,640,52.5%,23.91%,1
臺南市,新化區,0589,84,96,180,23,203,410,49.51%,20.49%,1
臺南市,新化區,0590,151,88,239,32,271,533,50.84%,28.33%,1
臺南市,新化區,0591,207,193,400,34,434,836,51.91%,24.76%,1
臺南市,新化區,0592,225,160,385,35,420,978,42.94%,23.01%,1
臺南市,新化區,0593,372,294,666,51,717,1348,53.19%,27.6%,1
臺南市,新化區,0594,281,211,492,41,533,1015,52.51%,27.68%,1
臺南市,新化區,0595,351,184,535,40,575,1228,46.82%,28.58%,1
臺南市,新化區,0596,214,183,397,53,450,789,57.03%,27.12%,1
臺南市,新化區,0597,244,225,469,35,504,1022,49.32%,23.87%,1
臺南市,新化區,0598,296,164,460,25,485,1021,47.5%,28.99%,1
臺南市,新化區,0599,372,263,635,72,707,1229,57.53%,30.27%,1
臺南市,新化區,0600,326,240,566,24,590,1153,51.17%,28.27%,1
臺南市,新化區,0601,212,155,367,33,400,1012,39.53%,20.95%,1
臺南市,新化區,0602,411,301,712,88,800,1458,54.87%,28.19%,1
臺南市,新化區,0603,509,332,841,73,914,1645,55.56%,30.94%,1
臺南市,新化區,0604,313,208,521,64,585,1016,57.58%,30.81%,1
臺南市,新化區,0605,147,115,262,15,277,559,49.55%,26.3%,1
臺南市,新化區,0606,356,270,626,51,677,1222,55.4%,29.13%,1
臺南市,新化區,0607,494,364,858,58,916,1562,58.64%,31.63%,1
臺南市,新化區,0608,240,177,417,34,451,994,45.37%,24.14%,1
臺南市,新化區,0609,251,211,462,97,559,1013,55.18%,24.78%,1
臺南市,新化區,0610,341,243,584,89,673,1197,56.22%,28.49%,1
臺南市,新化區,0611,262,193,455,54,509,1021,49.85%,25.66%,1
臺南市,新化區,0612,314,242,556,91,647,1428,45.31%,21.99%,1
臺南市,新化區,0613,114,62,176,39,215,456,47.15%,25%,1
臺南市,新化區,0614,295,224,519,59,578,1037,55.74%,28.45%,1
臺南市,新化區,0615,313,214,527,86,613,1097,55.88%,28.53%,1
臺南市,新化區,0616,243,190,433,65,498,902,55.21%,26.94%,1
臺南市,新化區,0617,217,181,398,113,511,999,51.15%,21.72%,1
臺南市,善化區,0492,254,218,472,35,507,1132,44.79%,22.44%,1
臺南市,善化區,0493,501,322,823,85,908,1845,49.21%,27.15%,1
臺南市,善化區,0494,526,390,916,137,1053,2090,50.38%,25.17%,1
臺南市,善化區,0495,476,307,783,89,872,1582,55.12%,30.09%,1
臺南市,善化區,0496,497,462,959,86,1045,1901,54.97%,26.14%,1
臺南市,善化區,0497,493,373,866,84,950,1818,52.26%,27.12%,1
臺南市,善化區,0498,448,319,767,91,858,1639,52.35%,27.33%,1
臺南市,善化區,0499,308,243,551,45,596,1061,56.17%,29.03%,1
臺南市,善化區,0500,511,356,867,121,988,1786,55.32%,28.61%,1
臺南市,善化區,0501,315,220,535,49,584,1147,50.92%,27.46%,1
臺南市,善化區,0502,367,334,701,88,789,1581,49.91%,23.21%,1
臺南市,善化區,0503,311,227,538,116,654,1240,52.74%,25.08%,1
臺南市,善化區,0504,358,258,616,48,664,1743,38.1%,20.54%,1
臺南市,善化區,0505,353,269,622,74,696,1246,55.86%,28.33%,1
臺南市,善化區,0506,264,171,435,31,466,961,48.49%,27.47%,1
臺南市,善化區,0507,244,170,414,17,431,938,45.95%,26.01%,1
臺南市,善化區,0508,175,153,328,26,354,722,49.03%,24.24%,1
臺南市,善化區,0509,253,167,420,34,454,1062,42.75%,23.82%,1
臺南市,善化區,0510,433,319,752,119,871,1715,50.79%,25.25%,1
臺南市,善化區,0511,256,205,461,81,542,1120,48.39%,22.86%,1
臺南市,善化區,0512,189,187,376,54,430,865,49.71%,21.85%,1
臺南市,善化區,0513,404,322,726,92,818,1574,51.97%,25.67%,1
臺南市,善化區,0514,368,253,621,70,691,1535,45.02%,23.97%,1
臺南市,善化區,0515,260,233,493,87,580,1106,52.44%,23.51%,1
臺南市,善化區,0516,334,279,613,45,658,1402,46.93%,23.82%,1
臺南市,善化區,0517,443,317,760,108,868,1458,59.53%,30.38%,1
臺南市,善化區,0518,331,270,601,39,640,1380,46.38%,23.99%,1
臺南市,善化區,0519,326,294,620,23,643,1232,52.19%,26.46%,1
臺南市,善化區,0520,309,244,553,24,577,1069,53.98%,28.91%,1
臺南市,新市區,0545,227,187,414,38,452,960,47.08%,23.65%,1
臺南市,新市區,0546,329,262,591,62,653,1118,58.41%,29.43%,1
臺南市,新市區,0547,228,155,383,30,413,850,48.59%,26.82%,1
臺南市,新市區,0548,337,252,589,72,661,1241,53.26%,27.16%,1
臺南市,新市區,0549,363,280,643,58,701,1297,54.05%,27.99%,1
臺南市,新市區,0550,297,192,489,52,541,962,56.24%,30.87%,1
臺南市,新市區,0551,343,269,612,87,699,1237,56.51%,27.73%,1
臺南市,新市區,0552,350,281,631,80,711,1326,53.62%,26.4%,1
臺南市,新市區,0553,329,274,603,89,692,1211,57.14%,27.17%,1
臺南市,新市區,0554,323,299,622,38,660,1305,50.57%,24.75%,1
臺南市,新市區,0555,203,106,309,65,374,688,54.36%,29.51%,1
臺南市,新市區,0556,259,198,457,58,515,911,56.53%,28.43%,1
臺南市,新市區,0557,374,288,662,64,726,1525,47.61%,24.52%,1
臺南市,新市區,0558,232,171,403,14,417,1091,38.22%,21.26%,1
臺南市,新市區,0559,310,216,526,40,566,1122,50.45%,27.63%,1
臺南市,新市區,0560,278,190,468,42,510,1049,48.62%,26.5%,1
臺南市,新市區,0561,372,253,625,37,662,1564,42.33%,23.79%,1
臺南市,新市區,0562,428,303,731,78,809,1515,53.4%,28.25%,1
臺南市,新市區,0563,453,204,657,31,688,1378,49.93%,32.87%,1
臺南市,新市區,0564,270,168,438,77,515,827,62.27%,32.65%,1
臺南市,新市區,0565,295,214,509,105,614,960,63.96%,30.73%,1
臺南市,新市區,0566,237,197,434,64,498,951,52.37%,24.92%,1
臺南市,新市區,0567,335,275,610,86,696,1264,55.06%,26.5%,1
臺南市,新市區,0568,306,253,559,48,607,1173,51.75%,26.09%,1
臺南市,新市區,0569,198,161,359,30,389,684,56.87%,28.95%,1
臺南市,新市區,0570,333,214,547,101,648,1055,61.42%,31.56%,1
臺南市,新市區,0571,353,287,640,49,689,1122,61.41%,31.46%,1
臺南市,安定區,0521,367,383,750,17,767,1251,61.31%,29.34%,1
臺南市,安定區,0522,239,181,420,63,483,899,53.73%,26.59%,1
臺南市,安定區,0523,301,215,516,89,605,1106,54.7%,27.22%,1
臺南市,安定區,0524,263,196,459,66,525,948,55.38%,27.74%,1
臺南市,安定區,0525,373,250,623,54,677,1442,46.95%,25.87%,1
臺南市,安定區,0526,293,263,556,101,657,1385,47.44%,21.16%,1
臺南市,安定區,0527,230,172,402,56,458,801,57.18%,28.71%,1
臺南市,安定區,0528,164,137,301,38,339,736,46.06%,22.28%,1
臺南市,安定區,0529,203,147,350,51,401,781,51.34%,25.99%,1
臺南市,安定區,0530,220,174,394,30,424,795,53.33%,27.67%,1
臺南市,安定區,0531,255,188,443,60,503,862,58.35%,29.58%,1
臺南市,安定區,0532,387,259,646,51,697,1487,46.87%,26.03%,1
臺南市,安定區,0533,349,274,623,59,682,1385,49.24%,25.2%,1
臺南市,安定區,0534,377,267,644,43,687,1518,45.26%,24.84%,1
臺南市,安定區,0535,343,220,563,73,636,1094,58.14%,31.35%,1
臺南市,安定區,0536,427,322,749,131,880,1590,55.35%,26.86%,1
臺南市,安定區,0537,226,153,379,44,423,754,56.1%,29.97%,1
臺南市,安定區,0538,209,136,345,57,402,716,56.15%,29.19%,1
臺南市,安定區,0539,440,293,733,80,813,1492,54.49%,29.49%,1
臺南市,安定區,0540,284,180,464,48,512,943,54.29%,30.12%,1
臺南市,安定區,0541,310,241,551,44,595,1157,51.43%,26.79%,1
臺南市,安定區,0542,348,298,646,121,767,1384,55.42%,25.14%,1
臺南市,安定區,0543,229,223,452,71,523,967,54.08%,23.68%,1
臺南市,安定區,0544,163,114,277,45,322,611,52.7%,26.68%,1
臺南市,山上區,0572,171,121,292,67,359,855,41.99%,20%,1
臺南市,山上區,0573,178,97,275,41,316,836,37.8%,21.29%,1
臺南市,山上區,0574,181,143,324,45,369,753,49%,24.04%,1
臺南市,山上區,0575,175,145,320,54,374,788,47.46%,22.21%,1
臺南市,山上區,0576,261,182,443,48,491,984,49.9%,26.52%,1
臺南市,山上區,0577,222,159,381,22,403,972,41.46%,22.84%,1
臺南市,山上區,0578,92,53,145,11,156,553,28.21%,16.64%,1
臺南市,山上區,0579,84,54,138,9,147,378,38.89%,22.22%,1
臺南市,山上區,0580,93,62,155,26,181,392,46.17%,23.72%,1
臺南市,玉井區,0466,339,214,553,32,585,1242,47.1%,27.29%,1
臺南市,玉井區,0467,329,216,545,45,590,1141,51.71%,28.83%,1
臺南市,玉井區,0468,179,123,302,28,330,698,47.28%,25.64%,1
臺南市,玉井區,0469,244,145,389,26,415,849,48.88%,28.74%,1
臺南市,玉井區,0470,269,171,440,69,509,949,53.64%,28.35%,1
臺南市,玉井區,0471,178,94,272,31,303,618,49.03%,28.8%,1
臺南市,玉井區,0472,143,82,225,9,234,594,39.39%,24.07%,1
臺南市,玉井區,0473,208,150,358,21,379,927,40.88%,22.44%,1
臺南市,玉井區,0474,129,97,226,46,272,512,53.13%,25.2%,1
臺南市,玉井區,0475,127,83,210,32,242,509,47.54%,24.95%,1
臺南市,玉井區,0476,133,100,233,29,262,496,52.82%,26.81%,1
臺南市,玉井區,0477,188,124,312,12,324,759,42.69%,24.77%,1
臺南市,玉井區,0478,134,95,229,17,246,669,36.77%,20.03%,1
臺南市,玉井區,0479,186,125,311,72,383,787,48.67%,23.63%,1
臺南市,玉井區,0480,146,89,235,50,285,620,45.97%,23.55%,1
臺南市,玉井區,0481,253,185,438,64,502,987,50.86%,25.63%,1
臺南市,楠西區,0447,246,164,410,68,478,978,48.88%,25.15%,1
臺南市,楠西區,0448,253,175,428,44,472,870,54.25%,29.08%,1
臺南市,楠西區,0449,198,134,332,9,341,1160,29.4%,17.07%,1
臺南市,楠西區,0450,149,114,263,22,285,699,40.77%,21.32%,1
臺南市,楠西區,0451,200,122,322,22,344,990,34.75%,20.2%,1
臺南市,楠西區,0452,216,151,367,36,403,928,43.43%,23.28%,1
臺南市,楠西區,0453,151,110,261,53,314,660,47.58%,22.88%,1
臺南市,楠西區,0454,298,208,506,77,583,1187,49.12%,25.11%,1
臺南市,楠西區,0455,280,168,448,36,484,1056,45.83%,26.52%,1
臺南市,南化區,0456,190,135,325,46,371,690,53.77%,27.54%,1
臺南市,南化區,0457,169,157,326,56,382,695,54.96%,24.32%,1
臺南市,南化區,0458,174,135,309,50,359,806,44.54%,21.59%,1
臺南市,南化區,0459,138,86,224,46,270,654,41.28%,21.1%,1
臺南市,南化區,0460,139,107,246,36,282,783,36.02%,17.75%,1
臺南市,南化區,0461,112,74,186,21,207,425,48.71%,26.35%,1
臺南市,南化區,0462,147,89,236,39,275,559,49.19%,26.3%,1
臺南市,南化區,0463,287,165,452,31,483,1189,40.62%,24.14%,1
臺南市,南化區,0464,270,222,492,39,531,1044,50.86%,25.86%,1
臺南市,南化區,0465,257,198,455,31,486,941,51.65%,27.31%,1
臺南市,左鎮區,0482,95,67,162,25,187,392,47.7%,24.23%,1
臺南市,左鎮區,0483,176,116,292,43,335,644,52.02%,27.33%,1
臺南市,左鎮區,0484,93,71,164,16,180,468,38.46%,19.87%,1
臺南市,左鎮區,0485,156,119,275,38,313,753,41.57%,20.72%,1
臺南市,左鎮區,0486,73,59,132,28,160,345,46.38%,21.16%,1
臺南市,左鎮區,0487,93,57,150,15,165,393,41.98%,23.66%,1
臺南市,左鎮區,0488,83,69,152,18,170,420,40.48%,19.76%,1
臺南市,左鎮區,0489,54,44,98,10,108,313,34.5%,17.25%,1
臺南市,左鎮區,0490,33,30,63,3,66,186,35.48%,17.74%,1
臺南市,左鎮區,0491,89,75,164,56,220,504,43.65%,17.66%,1
臺南市,仁德區,1188,355,295,650,72,722,1318,54.78%,26.93%,1
臺南市,仁德區,1189,396,304,700,70,770,1406,54.77%,28.17%,1
臺南市,仁德區,1190,393,283,676,90,766,1465,52.29%,26.83%,1
臺南市,仁德區,1191,329,309,638,78,716,1192,60.07%,27.6%,1
臺南市,仁德區,1192,402,350,752,77,829,1429,58.01%,28.13%,1
臺南市,仁德區,1193,335,280,615,107,722,1320,54.7%,25.38%,1
臺南市,仁德區,1194,454,274,728,97,825,1373,60.09%,33.07%,1
臺南市,仁德區,1195,392,304,696,65,761,1330,57.22%,29.47%,1
臺南市,仁德區,1196,513,353,866,56,922,1687,54.65%,30.41%,1
臺南市,仁德區,1197,361,326,687,67,754,1491,50.57%,24.21%,1
臺南市,仁德區,1198,287,199,486,54,540,1151,46.92%,24.93%,1
臺南市,仁德區,1199,414,280,694,34,728,1407,51.74%,29.42%,1
臺南市,仁德區,1200,461,301,762,65,827,1465,56.45%,31.47%,1
臺南市,仁德區,1201,413,286,699,51,750,1335,56.18%,30.94%,1
臺南市,仁德區,1202,399,312,711,75,786,1490,52.75%,26.78%,1
臺南市,仁德區,1203,463,308,771,81,852,1453,58.64%,31.87%,1
臺南市,仁德區,1204,266,182,448,33,481,990,48.59%,26.87%,1
臺南市,仁德區,1205,476,339,815,73,888,1573,56.45%,30.26%,1
臺南市,仁德區,1206,255,229,484,82,566,1031,54.9%,24.73%,1
臺南市,仁德區,1207,333,255,588,38,626,1194,52.43%,27.89%,1
臺南市,仁德區,1208,325,251,576,78,654,1268,51.58%,25.63%,1
臺南市,仁德區,1209,249,210,459,53,512,929,55.11%,26.8%,1
臺南市,仁德區,1210,306,199,505,15,520,1145,45.41%,26.72%,1
臺南市,仁德區,1211,374,273,647,64,711,1413,50.32%,26.47%,1
臺南市,仁德區,1212,396,284,680,108,788,1465,53.79%,27.03%,1
臺南市,仁德區,1213,366,363,729,69,798,1390,57.41%,26.33%,1
臺南市,仁德區,1214,363,313,676,90,766,1396,54.87%,26%,1
臺南市,仁德區,1215,561,374,935,62,997,1906,52.31%,29.43%,1
臺南市,仁德區,1216,454,266,720,52,772,1546,49.94%,29.37%,1
臺南市,仁德區,1217,359,277,636,47,683,1546,44.18%,23.22%,1
臺南市,仁德區,1218,424,252,676,69,745,1399,53.25%,30.31%,1
臺南市,仁德區,1219,473,344,817,110,927,1748,53.03%,27.06%,1
臺南市,仁德區,1220,313,271,584,59,643,1140,56.4%,27.46%,1
臺南市,仁德區,1221,343,241,584,32,616,1277,48.24%,26.86%,1
臺南市,仁德區,1222,349,240,589,52,641,1019,62.9%,34.25%,1
臺南市,仁德區,1223,349,275,624,48,672,1414,47.52%,24.68%,1
臺南市,仁德區,1224,328,243,571,40,611,1349,45.29%,24.31%,1
臺南市,仁德區,1225,406,282,688,38,726,1471,49.35%,27.6%,1
臺南市,仁德區,1226,362,268,630,32,662,1324,50%,27.34%,1
臺南市,仁德區,1227,346,214,560,72,632,1310,48.24%,26.41%,1
臺南市,仁德區,1228,163,120,283,28,311,554,56.14%,29.42%,1
臺南市,仁德區,1229,444,255,699,50,749,1395,53.69%,31.83%,1
臺南市,仁德區,1230,366,251,617,20,637,1264,50.4%,28.96%,1
臺南市,仁德區,1231,311,217,528,98,626,1180,53.05%,26.36%,1
臺南市,仁德區,1232,192,178,370,43,413,928,44.5%,20.69%,1
臺南市,仁德區,1233,225,174,399,32,431,965,44.66%,23.32%,1
臺南市,仁德區,1234,251,206,457,47,504,1119,45.04%,22.43%,1
臺南市,仁德區,1235,343,221,564,86,650,1206,53.9%,28.44%,1
臺南市,仁德區,1236,366,233,599,69,668,1466,45.57%,24.97%,1
臺南市,歸仁區,1237,414,308,722,80,802,1560,51.41%,26.54%,1
臺南市,歸仁區,1238,435,317,752,84,836,1383,60.45%,31.45%,1
臺南市,歸仁區,1239,413,317,730,48,778,1491,52.18%,27.7%,1
臺南市,歸仁區,1240,377,280,657,73,730,1482,49.26%,25.44%,1
臺南市,歸仁區,1241,361,274,635,40,675,1330,50.75%,27.14%,1
臺南市,歸仁區,1242,403,325,728,56,784,1399,56.04%,28.81%,1
臺南市,歸仁區,1243,378,267,645,45,690,1416,48.73%,26.69%,1
臺南市,歸仁區,1244,200,322,522,49,571,1336,42.74%,14.97%,1
臺南市,歸仁區,1245,294,220,514,71,585,1183,49.45%,24.85%,1
臺南市,歸仁區,1246,287,256,543,34,577,1237,46.65%,23.2%,1
臺南市,歸仁區,1247,315,250,565,72,637,1133,56.22%,27.8%,1
臺南市,歸仁區,1248,299,224,523,52,575,1149,50.04%,26.02%,1
臺南市,歸仁區,1249,293,246,539,13,552,1105,49.95%,26.52%,1
臺南市,歸仁區,1250,286,242,528,73,601,1099,54.69%,26.02%,1
臺南市,歸仁區,1251,300,238,538,91,629,1082,58.13%,27.73%,1
臺南市,歸仁區,1252,413,323,736,64,800,1519,52.67%,27.19%,1
臺南市,歸仁區,1253,453,304,757,82,839,1467,57.19%,30.88%,1
臺南市,歸仁區,1254,293,240,533,46,579,1090,53.12%,26.88%,1
臺南市,歸仁區,1255,308,212,520,35,555,1131,49.07%,27.23%,1
臺南市,歸仁區,1256,278,210,488,41,529,1080,48.98%,25.74%,1
臺南市,歸仁區,1257,262,198,460,34,494,1121,44.07%,23.37%,1
臺南市,歸仁區,1258,361,260,621,98,719,1336,53.82%,27.02%,1
臺南市,歸仁區,1259,290,237,527,87,614,1128,54.43%,25.71%,1
臺南市,歸仁區,1260,264,232,496,34,530,1055,50.24%,25.02%,1
臺南市,歸仁區,1261,298,239,537,49,586,1102,53.18%,27.04%,1
臺南市,歸仁區,1262,314,211,525,55,580,1068,54.31%,29.4%,1
臺南市,歸仁區,1263,300,224,524,69,593,1033,57.41%,29.04%,1
臺南市,歸仁區,1264,385,265,650,41,691,1772,39%,21.73%,1
臺南市,歸仁區,1265,408,272,680,88,768,1399,54.9%,29.16%,1
臺南市,歸仁區,1266,436,323,759,43,802,1544,51.94%,28.24%,1
臺南市,歸仁區,1267,155,118,273,14,287,684,41.96%,22.66%,1
臺南市,歸仁區,1268,242,197,439,51,490,839,58.4%,28.84%,1
臺南市,歸仁區,1269,294,234,528,63,591,1014,58.28%,28.99%,1
臺南市,歸仁區,1270,391,272,663,38,701,1906,36.78%,20.51%,1
臺南市,歸仁區,1271,353,281,634,76,710,1245,57.03%,28.35%,1
臺南市,歸仁區,1272,291,207,498,58,556,1048,53.05%,27.77%,1
臺南市,歸仁區,1273,321,228,549,30,579,1175,49.28%,27.32%,1
臺南市,歸仁區,1274,332,261,593,48,641,1411,45.43%,23.53%,1
臺南市,歸仁區,1275,472,326,798,53,851,1514,56.21%,31.18%,1
臺南市,歸仁區,1276,472,355,827,75,902,1678,53.75%,28.13%,1
臺南市,歸仁區,1277,258,213,471,35,506,949,53.32%,27.19%,1
臺南市,歸仁區,1278,303,225,528,71,599,1009,59.37%,30.03%,1
臺南市,歸仁區,1279,316,256,572,8,580,984,58.94%,32.11%,1
臺南市,歸仁區,1280,221,171,392,55,447,756,59.13%,29.23%,1
臺南市,歸仁區,1281,476,326,802,75,877,1478,59.34%,32.21%,1
臺南市,歸仁區,1282,579,205,784,80,864,1467,58.9%,39.47%,1
臺南市,關廟區,1283,357,108,465,34,499,982,50.81%,36.35%,1
臺南市,關廟區,1284,367,252,619,48,667,1156,57.7%,31.75%,1
臺南市,關廟區,1285,239,199,438,29,467,1006,46.42%,23.76%,1
臺南市,關廟區,1286,316,250,566,65,631,1043,60.5%,30.3%,1
臺南市,關廟區,1287,271,216,487,94,581,1012,57.41%,26.78%,1
臺南市,關廟區,1288,245,177,422,20,442,1013,43.63%,24.19%,1
臺南市,關廟區,1289,342,253,595,50,645,1294,49.85%,26.43%,1
臺南市,關廟區,1290,341,230,571,53,624,1264,49.37%,26.98%,1
臺南市,關廟區,1291,327,219,546,47,593,1166,50.86%,28.04%,1
臺南市,關廟區,1292,260,180,440,25,465,1018,45.68%,25.54%,1
臺南市,關廟區,1293,185,108,293,48,341,733,46.52%,25.24%,1
臺南市,關廟區,1294,333,240,573,36,609,1093,55.72%,30.47%,1
臺南市,關廟區,1295,333,206,539,28,567,1081,52.45%,30.8%,1
臺南市,關廟區,1296,292,232,524,52,576,978,58.9%,29.86%,1
臺南市,關廟區,1297,286,198,484,27,511,1116,45.79%,25.63%,1
臺南市,關廟區,1298,266,188,454,65,519,972,53.4%,27.37%,1
臺南市,關廟區,1299,280,217,497,106,603,1045,57.7%,26.79%,1
臺南市,關廟區,1300,251,165,416,44,460,872,52.75%,28.78%,1
臺南市,關廟區,1301,278,242,520,54,574,1007,57%,27.61%,1
臺南市,關廟區,1302,229,163,392,65,457,763,59.9%,30.01%,1
臺南市,關廟區,1303,168,130,298,36,334,630,53.02%,26.67%,1
臺南市,關廟區,1304,264,225,489,63,552,959,57.56%,27.53%,1
臺南市,關廟區,1305,302,215,517,52,569,1123,50.67%,26.89%,1
臺南市,關廟區,1306,229,160,389,69,458,804,56.97%,28.48%,1
臺南市,關廟區,1307,175,149,324,20,344,720,47.78%,24.31%,1
臺南市,關廟區,1308,212,128,340,26,366,843,43.42%,25.15%,1
臺南市,關廟區,1309,77,75,152,21,173,358,48.32%,21.51%,1
臺南市,關廟區,1310,221,137,358,68,426,797,53.45%,27.73%,1
臺南市,關廟區,1311,180,100,280,19,299,709,42.17%,25.39%,1
臺南市,關廟區,1312,204,174,378,26,404,904,44.69%,22.57%,1
臺南市,關廟區,1313,248,188,436,29,465,963,48.29%,25.75%,1
臺南市,關廟區,1314,125,111,236,6,242,489,49.49%,25.56%,1
臺南市,龍崎區,1315,269,189,458,65,523,1047,49.95%,25.69%,1
臺南市,龍崎區,1316,154,101,255,22,277,630,43.97%,24.44%,1
臺南市,龍崎區,1317,31,17,48,4,52,141,36.88%,21.99%,1
臺南市,龍崎區,1318,83,77,160,15,175,367,47.68%,22.62%,1
臺南市,龍崎區,1319,95,55,150,14,164,337,48.66%,28.19%,1
臺南市,龍崎區,1320,62,56,118,12,130,318,40.88%,19.5%,1
臺南市,龍崎區,1321,112,73,185,29,214,427,50.12%,26.23%,1
臺南市,龍崎區,1322,97,70,167,17,184,446,41.26%,21.75%,1
臺南市,永康區,0708,388,308,696,71,767,1398,54.86%,27.75%,1
臺南市,永康區,0709,329,241,570,64,634,1478,42.9%,22.26%,1
臺南市,永康區,0710,384,287,671,46,717,1442,49.72%,26.63%,1
臺南市,永康區,0711,362,253,615,50,665,1353,49.15%,26.76%,1
臺南市,永康區,0712,291,229,520,44,564,1160,48.62%,25.09%,1
臺南市,永康區,0713,317,237,554,53,607,1122,54.1%,28.25%,1
臺南市,永康區,0714,311,238,549,23,572,1165,49.1%,26.7%,1
臺南市,永康區,0715,341,269,610,46,656,1317,49.81%,25.89%,1
臺南市,永康區,0716,377,267,644,59,703,1376,51.09%,27.4%,1
臺南市,永康區,0717,410,277,687,41,728,1361,53.49%,30.12%,1
臺南市,永康區,0718,451,297,748,53,801,1374,58.3%,32.82%,1
臺南市,永康區,0719,410,340,750,76,826,1709,48.33%,23.99%,1
臺南市,永康區,0720,458,283,741,96,837,1717,48.75%,26.67%,1
臺南市,永康區,0721,470,303,773,67,840,1759,47.75%,26.72%,1
臺南市,永康區,0722,478,312,790,60,850,1636,51.96%,29.22%,1
臺南市,永康區,0723,483,189,672,87,759,1442,52.64%,33.5%,1
臺南市,永康區,0724,446,285,731,46,777,1545,50.29%,28.87%,1
臺南市,永康區,0725,463,255,718,72,790,1565,50.48%,29.58%,1
臺南市,永康區,0726,452,302,754,59,813,1684,48.28%,26.84%,1
臺南市,永康區,0727,426,260,686,36,722,1548,46.64%,27.52%,1
臺南市,永康區,0728,396,311,707,36,743,1389,53.49%,28.51%,1
臺南市,永康區,0729,391,267,658,65,723,1369,52.81%,28.56%,1
臺南市,永康區,0730,398,265,663,104,767,1415,54.2%,28.13%,1
臺南市,永康區,0731,349,230,579,24,603,1386,43.51%,25.18%,1
臺南市,永康區,0732,221,166,387,12,399,1747,22.84%,12.65%,1
臺南市,永康區,0733,420,274,694,70,764,1485,51.45%,28.28%,1
臺南市,永康區,0734,471,310,781,104,885,1747,50.66%,26.96%,1
臺南市,永康區,0735,432,276,708,42,750,1744,43%,24.77%,1
臺南市,永康區,0736,426,308,734,104,838,1797,46.63%,23.71%,1
臺南市,永康區,0737,514,372,886,86,972,1800,54%,28.56%,1
臺南市,永康區,0738,485,306,791,25,816,1720,47.44%,28.2%,1
臺南市,永康區,0739,501,362,863,53,916,1708,53.63%,29.33%,1
臺南市,永康區,0740,466,307,773,45,818,1519,53.85%,30.68%,1
臺南市,永康區,0741,425,310,735,103,838,1497,55.98%,28.39%,1
臺南市,永康區,0742,612,93,705,39,744,1509,49.3%,40.56%,1
臺南市,永康區,0743,473,341,814,81,895,1542,58.04%,30.67%,1
臺南市,永康區,0744,473,322,795,47,842,1536,54.82%,30.79%,1
臺南市,永康區,0745,422,335,757,68,825,1531,53.89%,27.56%,1
臺南市,永康區,0746,412,281,693,72,765,1327,57.65%,31.05%,1
臺南市,永康區,0747,423,289,712,36,748,1456,51.37%,29.05%,1
臺南市,永康區,0748,400,312,712,63,775,1396,55.52%,28.65%,1
臺南市,永康區,0749,437,350,787,58,845,1636,51.65%,26.71%,1
臺南市,永康區,0750,471,326,797,60,857,1592,53.83%,29.59%,1
臺南市,永康區,0751,504,418,922,37,959,2017,47.55%,24.99%,1
臺南市,永康區,0752,191,143,334,23,357,672,53.13%,28.42%,1
臺南市,永康區,0753,421,297,718,34,752,1611,46.68%,26.13%,1
臺南市,永康區,0754,421,310,731,58,789,1502,52.53%,28.03%,1
臺南市,永康區,0755,426,273,699,36,735,1660,44.28%,25.66%,1
臺南市,永康區,0756,371,269,640,42,682,1561,43.69%,23.77%,1
臺南市,永康區,0757,403,317,720,37,757,1590,47.61%,25.35%,1
臺南市,永康區,0758,226,208,434,27,461,924,49.89%,24.46%,1
臺南市,永康區,0759,300,188,488,48,536,938,57.14%,31.98%,1
臺南市,永康區,0760,289,202,491,53,544,957,56.84%,30.2%,1
臺南市,永康區,0761,144,91,235,42,277,496,55.85%,29.03%,1
臺南市,永康區,0762,469,360,829,76,905,1717,52.71%,27.32%,1
臺南市,永康區,0763,375,325,700,55,755,1615,46.75%,23.22%,1
臺南市,永康區,0764,401,311,712,44,756,1554,48.65%,25.8%,1
臺南市,永康區,0765,306,231,537,34,571,1196,47.74%,25.59%,1
臺南市,永康區,0766,345,265,610,51,661,1274,51.88%,27.08%,1
臺南市,永康區,0767,355,242,597,54,651,1215,53.58%,29.22%,1
臺南市,永康區,0768,422,291,713,29,742,1457,50.93%,28.96%,1
臺南市,永康區,0769,407,302,709,42,751,1451,51.76%,28.05%,1
臺南市,永康區,0770,334,289,623,61,684,1423,48.07%,23.47%,1
臺南市,永康區,0771,373,321,694,48,742,1394,53.23%,26.76%,1
臺南市,永康區,0772,247,211,458,58,516,890,57.98%,27.75%,1
臺南市,永康區,0773,303,257,560,52,612,1018,60.12%,29.76%,1
臺南市,永康區,0774,129,59,188,26,214,368,58.15%,35.05%,1
臺南市,永康區,0775,391,263,654,58,712,1208,58.94%,32.37%,1
臺南市,永康區,0776,279,259,538,30,568,1187,47.85%,23.5%,1
臺南市,永康區,0777,370,278,648,52,700,1381,50.69%,26.79%,1
臺南市,永康區,0778,381,268,649,80,729,1405,51.89%,27.12%,1
臺南市,永康區,0779,377,259,636,88,724,1445,50.1%,26.09%,1
臺南市,永康區,0780,468,297,765,76,841,1687,49.85%,27.74%,1
臺南市,永康區,0781,355,283,638,45,683,1535,44.5%,23.13%,1
臺南市,永康區,0782,471,303,774,62,836,1542,54.22%,30.54%,1
臺南市,永康區,0783,480,287,767,53,820,1618,50.68%,29.67%,1
臺南市,永康區,0784,434,273,707,35,742,1338,55.46%,32.44%,1
臺南市,永康區,0785,348,299,647,84,731,1285,56.89%,27.08%,1
臺南市,永康區,0786,349,253,602,31,633,1240,51.05%,28.15%,1
臺南市,永康區,0787,351,260,611,59,670,1343,49.89%,26.14%,1
臺南市,永康區,0788,373,325,698,65,763,1327,57.5%,28.11%,1
臺南市,永康區,0789,465,294,759,56,815,1565,52.08%,29.71%,1
臺南市,永康區,0790,439,270,709,114,823,1476,55.76%,29.74%,1
臺南市,永康區,0791,421,293,714,53,767,1476,51.96%,28.52%,1
臺南市,永康區,0792,436,338,774,60,834,1463,57.01%,29.8%,1
臺南市,永康區,0793,284,211,495,78,573,983,58.29%,28.89%,1
臺南市,永康區,0794,333,240,573,72,645,1116,57.8%,29.84%,1
臺南市,永康區,0795,293,216,509,81,590,1117,52.82%,26.23%,1
臺南市,永康區,0796,283,190,473,36,509,1069,47.61%,26.47%,1
臺南市,永康區,0797,386,259,645,53,698,1180,59.15%,32.71%,1
臺南市,永康區,0798,337,217,554,89,643,1176,54.68%,28.66%,1
臺南市,永康區,0799,310,261,571,37,608,1158,52.5%,26.77%,1
臺南市,永康區,0800,338,288,626,86,712,1208,58.94%,27.98%,1
臺南市,永康區,0801,390,314,704,100,804,1501,53.56%,25.98%,1
臺南市,永康區,0802,372,300,672,53,725,1298,55.86%,28.66%,1
臺南市,永康區,0803,438,294,732,44,776,1542,50.32%,28.4%,1
臺南市,永康區,0804,468,314,782,75,857,1537,55.76%,30.45%,1
臺南市,永康區,0805,433,306,739,83,822,1359,60.49%,31.86%,1
臺南市,永康區,0806,267,220,487,43,530,1139,46.53%,23.44%,1
臺南市,永康區,0807,284,231,515,57,572,1158,49.4%,24.53%,1
臺南市,永康區,0808,365,325,690,90,780,1538,50.72%,23.73%,1
臺南市,永康區,0809,292,232,524,28,552,1166,47.34%,25.04%,1
臺南市,永康區,0810,314,229,543,46,589,1228,47.96%,25.57%,1
臺南市,永康區,0811,340,275,615,63,678,1200,56.5%,28.33%,1
臺南市,永康區,0812,326,257,583,51,634,1131,56.06%,28.82%,1
臺南市,永康區,0813,305,246,551,35,586,1147,51.09%,26.59%,1
臺南市,永康區,0814,372,289,661,69,730,1442,50.62%,25.8%,1
臺南市,永康區,0815,370,234,604,45,649,1325,48.98%,27.92%,1
臺南市,永康區,0816,308,218,526,49,575,1260,45.63%,24.44%,1
臺南市,永康區,0817,317,417,734,66,800,1631,49.05%,19.44%,1
臺南市,永康區,0818,433,276,709,59,768,1549,49.58%,27.95%,1
臺南市,永康區,0819,461,311,772,42,814,1666,48.86%,27.67%,1
臺南市,永康區,0820,261,164,425,71,496,1012,49.01%,25.79%,1
臺南市,永康區,0821,242,152,394,26,420,976,43.03%,24.8%,1
臺南市,永康區,0822,153,108,261,20,281,531,52.92%,28.81%,1
臺南市,永康區,0823,244,174,418,57,475,859,55.3%,28.41%,1
臺南市,永康區,0824,239,189,428,38,466,937,49.73%,25.51%,1
臺南市,永康區,0825,363,264,627,72,699,1307,53.48%,27.77%,1
臺南市,永康區,0826,383,271,654,32,686,1482,46.29%,25.84%,1
臺南市,永康區,0827,321,263,584,41,625,1341,46.61%,23.94%,1
臺南市,永康區,0828,355,296,651,47,698,1376,50.73%,25.8%,1
臺南市,永康區,0829,379,258,637,55,692,1390,49.78%,27.27%,1
臺南市,永康區,0830,430,344,774,59,833,1534,54.3%,28.03%,1
臺南市,永康區,0831,449,298,747,59,806,1460,55.21%,30.75%,1
臺南市,永康區,0832,405,257,662,40,702,1383,50.76%,29.28%,1
臺南市,永康區,0833,393,235,628,47,675,1299,51.96%,30.25%,1
臺南市,永康區,0834,361,296,657,43,700,1264,55.38%,28.56%,1
臺南市,永康區,0835,422,300,722,49,771,1355,56.9%,31.14%,1
臺南市,永康區,0836,401,258,659,33,692,1414,48.94%,28.36%,1
臺南市,永康區,0837,343,255,598,30,628,1109,56.63%,30.93%,1
臺南市,永康區,0838,316,215,531,56,587,1151,51%,27.45%,1
臺南市,永康區,0839,355,234,589,71,660,1026,64.33%,34.6%,1
臺南市,永康區,0840,249,219,468,36,504,1071,47.06%,23.25%,1
臺南市,永康區,0841,456,322,778,91,869,1387,62.65%,32.88%,1
臺南市,永康區,0842,432,325,757,51,808,1377,58.68%,31.37%,1
臺南市,永康區,0843,509,311,820,63,883,1687,52.34%,30.17%,1
臺南市,永康區,0844,466,328,794,47,841,1700,49.47%,27.41%,1
臺南市,永康區,0845,430,323,753,48,801,1444,55.47%,29.78%,1
臺南市,永康區,0846,402,291,693,67,760,1485,51.18%,27.07%,1
臺南市,永康區,0847,450,309,759,56,815,1717,47.47%,26.21%,1
臺南市,永康區,0848,429,303,732,63,795,1701,46.74%,25.22%,1
臺南市,永康區,0849,363,274,637,40,677,1382,48.99%,26.27%,1
臺南市,東區,1095,572,398,970,75,1045,2681,38.98%,21.34%,1
臺南市,東區,1096,496,373,869,48,917,1811,50.64%,27.39%,1
臺南市,東區,1097,470,371,841,89,930,1491,62.37%,31.52%,1
臺南市,東區,1098,436,272,708,48,756,1378,54.86%,31.64%,1
臺南市,東區,1099,482,331,813,75,888,1552,57.22%,31.06%,1
臺南市,東區,1100,395,339,734,30,764,1326,57.62%,29.79%,1
臺南市,東區,1101,465,359,824,75,899,1594,56.4%,29.17%,1
臺南市,東區,1102,493,400,893,51,944,1639,57.6%,30.08%,1
臺南市,東區,1103,484,370,854,77,931,1724,54%,28.07%,1
臺南市,東區,1104,472,341,813,95,908,1629,55.74%,28.97%,1
臺南市,東區,1105,436,290,726,37,763,1399,54.54%,31.17%,1
臺南市,東區,1106,462,319,781,46,827,1534,53.91%,30.12%,1
臺南市,東區,1107,505,364,869,68,937,1656,56.58%,30.5%,1
臺南市,東區,1108,372,304,676,54,730,1322,55.22%,28.14%,1
臺南市,東區,1109,518,322,840,42,882,1620,54.44%,31.98%,1
臺南市,東區,1110,464,308,772,42,814,1331,61.16%,34.86%,1
臺南市,東區,1111,325,213,538,49,587,1039,56.5%,31.28%,1
臺南市,東區,1112,334,229,563,42,605,1257,48.13%,26.57%,1
臺南市,東區,1113,549,377,926,124,1050,2067,50.8%,26.56%,1
臺南市,東區,1114,693,408,1101,47,1148,2153,53.32%,32.19%,1
臺南市,東區,1115,715,442,1157,73,1230,2363,52.05%,30.26%,1
臺南市,東區,1116,405,325,730,58,788,1427,55.22%,28.38%,1
臺南市,東區,1117,467,335,802,56,858,1555,55.18%,30.03%,1
臺南市,東區,1118,530,354,884,69,953,2115,45.06%,25.06%,1
臺南市,東區,1119,622,442,1064,92,1156,2340,49.4%,26.58%,1
臺南市,東區,1120,716,515,1231,83,1314,2474,53.11%,28.94%,1
臺南市,東區,1121,678,485,1163,76,1239,2391,51.82%,28.36%,1
臺南市,東區,1122,484,369,853,77,930,1673,55.59%,28.93%,1
臺南市,東區,1123,451,331,782,48,830,1594,52.07%,28.29%,1
臺南市,東區,1124,498,346,844,77,921,1607,57.31%,30.99%,1
臺南市,東區,1125,713,441,1154,45,1199,2087,57.45%,34.16%,1
臺南市,東區,1126,757,548,1305,53,1358,2369,57.32%,31.95%,1
臺南市,東區,1127,459,331,790,121,911,1696,53.71%,27.06%,1
臺南市,東區,1128,432,382,814,45,859,1612,53.29%,26.8%,1
臺南市,東區,1129,420,390,810,75,885,1708,51.81%,24.59%,1
臺南市,東區,1130,450,347,797,59,856,1560,54.87%,28.85%,1
臺南市,東區,1131,536,392,928,61,989,1854,53.34%,28.91%,1
臺南市,東區,1132,582,458,1040,57,1097,2278,48.16%,25.55%,1
臺南市,東區,1133,587,418,1005,61,1066,2093,50.93%,28.05%,1
臺南市,東區,1134,696,509,1205,74,1279,2242,57.05%,31.04%,1
臺南市,東區,1135,372,247,619,73,692,1152,60.07%,32.29%,1
臺南市,東區,1136,441,328,769,28,797,1318,60.47%,33.46%,1
臺南市,東區,1137,676,463,1139,63,1202,2200,54.64%,30.73%,1
臺南市,東區,1138,653,434,1087,60,1147,1960,58.52%,33.32%,1
臺南市,東區,1139,413,332,745,50,795,1489,53.39%,27.74%,1
臺南市,東區,1140,398,313,711,83,794,1443,55.02%,27.58%,1
臺南市,東區,1141,468,394,862,44,906,1498,60.48%,31.24%,1
臺南市,東區,1142,496,367,863,28,891,1622,54.93%,30.58%,1
臺南市,東區,1143,537,376,913,53,966,1738,55.58%,30.9%,1
臺南市,東區,1144,393,322,715,81,796,1501,53.03%,26.18%,1
臺南市,東區,1145,442,333,775,57,832,1482,56.14%,29.82%,1
臺南市,東區,1146,488,358,846,46,892,1829,48.77%,26.68%,1
臺南市,東區,1147,546,357,903,59,962,1764,54.54%,30.95%,1
臺南市,東區,1148,440,322,762,57,819,1427,57.39%,30.83%,1
臺南市,東區,1149,390,319,709,60,769,1427,53.89%,27.33%,1
臺南市,東區,1150,469,256,725,56,781,1388,56.27%,33.79%,1
臺南市,東區,1151,368,283,651,36,687,1131,60.74%,32.54%,1
臺南市,東區,1152,278,218,496,43,539,1000,53.9%,27.8%,1
臺南市,東區,1153,304,212,516,38,554,996,55.62%,30.52%,1
臺南市,東區,1154,247,215,462,39,501,935,53.58%,26.42%,1
臺南市,東區,1155,249,230,479,66,545,947,57.55%,26.29%,1
臺南市,東區,1156,310,250,560,24,584,1090,53.58%,28.44%,1
臺南市,東區,1157,226,191,417,64,481,896,53.68%,25.22%,1
臺南市,東區,1158,462,340,802,30,832,1589,52.36%,29.07%,1
臺南市,東區,1159,426,362,788,52,840,1497,56.11%,28.46%,1
臺南市,東區,1160,354,304,658,66,724,1386,52.24%,25.54%,1
臺南市,東區,1161,309,260,569,24,593,1101,53.86%,28.07%,1
臺南市,東區,1162,380,327,707,66,773,1332,58.03%,28.53%,1
臺南市,東區,1163,366,249,615,56,671,1185,56.62%,30.89%,1
臺南市,東區,1164,388,292,680,62,742,1262,58.8%,30.74%,1
臺南市,東區,1165,442,239,681,92,773,1517,50.96%,29.14%,1
臺南市,東區,1166,343,282,625,86,711,1287,55.24%,26.65%,1
臺南市,東區,1167,483,362,845,76,921,1657,55.58%,29.15%,1
臺南市,東區,1168,623,477,1100,116,1216,2238,54.33%,27.84%,1
臺南市,東區,1169,614,476,1090,64,1154,2246,51.38%,27.34%,1
臺南市,東區,1170,574,489,1063,72,1135,2191,51.8%,26.2%,1
臺南市,東區,1171,565,415,980,92,1072,2063,51.96%,27.39%,1
臺南市,東區,1172,683,470,1153,96,1249,2177,57.37%,31.37%,1
臺南市,東區,1173,592,406,998,84,1082,1863,58.08%,31.78%,1
臺南市,東區,1174,691,447,1138,53,1191,2185,54.51%,31.62%,1
臺南市,東區,1175,429,314,743,72,815,1721,47.36%,24.93%,1
臺南市,東區,1176,413,324,737,126,863,1556,55.46%,26.54%,1
臺南市,東區,1177,504,371,875,48,923,1602,57.62%,31.46%,1
臺南市,東區,1178,407,312,719,82,801,1523,52.59%,26.72%,1
臺南市,東區,1179,409,274,683,59,742,1382,53.69%,29.59%,1
臺南市,東區,1180,417,320,737,52,789,1486,53.1%,28.06%,1
臺南市,東區,1181,428,367,795,77,872,1560,55.9%,27.44%,1
臺南市,東區,1182,416,342,758,75,833,1684,49.47%,24.7%,1
臺南市,東區,1183,494,379,873,44,917,1653,55.47%,29.89%,1
臺南市,東區,1184,453,358,811,33,844,1554,54.31%,29.15%,1
臺南市,東區,1185,420,335,755,40,795,1408,56.46%,29.83%,1
臺南市,東區,1186,640,497,1137,59,1196,2084,57.39%,30.71%,1
臺南市,東區,1187,545,419,964,69,1033,1896,54.48%,28.74%,1
臺南市,南區,1015,317,288,605,76,681,1221,55.77%,25.96%,1
臺南市,南區,1016,520,394,914,94,1008,2171,46.43%,23.95%,1
臺南市,南區,1017,315,287,602,66,668,1150,58.09%,27.39%,1
臺南市,南區,1018,340,228,568,58,626,1122,55.79%,30.3%,1
臺南市,南區,1019,387,243,630,70,700,1444,48.48%,26.8%,1
臺南市,南區,1020,466,312,778,89,867,1765,49.12%,26.4%,1
臺南市,南區,1021,385,296,681,61,742,1298,57.16%,29.66%,1
臺南市,南區,1022,448,286,734,68,802,1458,55.01%,30.73%,1
臺南市,南區,1023,549,338,887,43,930,1940,47.94%,28.3%,1
臺南市,南區,1024,426,364,790,73,863,1637,52.72%,26.02%,1
臺南市,南區,1025,213,160,373,23,396,871,45.46%,24.45%,1
臺南市,南區,1026,182,128,310,25,335,589,56.88%,30.9%,1
臺南市,南區,1027,242,237,479,45,524,801,65.42%,30.21%,1
臺南市,南區,1028,295,201,496,72,568,990,57.37%,29.8%,1
臺南市,南區,1029,403,275,678,63,741,1222,60.64%,32.98%,1
臺南市,南區,1030,301,215,516,83,599,997,60.08%,30.19%,1
臺南市,南區,1031,299,250,549,45,594,1204,49.34%,24.83%,1
臺南市,南區,1032,383,287,670,51,721,1570,45.92%,24.39%,1
臺南市,南區,1033,343,274,617,62,679,1222,55.56%,28.07%,1
臺南市,南區,1034,281,192,473,35,508,1076,47.21%,26.12%,1
臺南市,南區,1035,280,256,536,46,582,1127,51.64%,24.84%,1
臺南市,南區,1036,317,245,562,61,623,1135,54.89%,27.93%,1
臺南市,南區,1037,316,277,593,77,670,1263,53.05%,25.02%,1
臺南市,南區,1038,265,189,454,49,503,1014,49.61%,26.13%,1
臺南市,南區,1039,449,299,748,87,835,1491,56%,30.11%,1
臺南市,南區,1040,485,364,849,83,932,1815,51.35%,26.72%,1
臺南市,南區,1041,361,277,638,45,683,1398,48.86%,25.82%,1
臺南市,南區,1042,477,357,834,56,890,2107,42.24%,22.64%,1
臺南市,南區,1043,453,394,847,85,932,1587,58.73%,28.54%,1
臺南市,南區,1044,498,354,852,97,949,1626,58.36%,30.63%,1
臺南市,南區,1045,420,369,789,45,834,1761,47.36%,23.85%,1
臺南市,南區,1046,439,342,781,87,868,1630,53.25%,26.93%,1
臺南市,南區,1047,418,329,747,83,830,1542,53.83%,27.11%,1
臺南市,南區,1048,380,290,670,106,776,1464,53.01%,25.96%,1
臺南市,南區,1049,441,353,794,116,910,1727,52.69%,25.54%,1
臺南市,南區,1050,332,254,586,65,651,1085,60%,30.6%,1
臺南市,南區,1051,223,207,430,31,461,939,49.09%,23.75%,1
臺南市,南區,1052,301,275,576,102,678,1419,47.78%,21.21%,1
臺南市,南區,1053,331,260,591,78,669,1333,50.19%,24.83%,1
臺南市,南區,1054,363,295,658,73,731,1465,49.9%,24.78%,1
臺南市,南區,1055,314,207,521,40,561,1099,51.05%,28.57%,1
臺南市,南區,1056,303,191,494,42,536,1133,47.31%,26.74%,1
臺南市,南區,1057,335,259,594,118,712,1375,51.78%,24.36%,1
臺南市,南區,1058,404,336,740,47,787,1781,44.19%,22.68%,1
臺南市,南區,1059,474,339,813,60,873,1542,56.61%,30.74%,1
臺南市,南區,1060,359,279,638,75,713,1486,47.98%,24.16%,1
臺南市,南區,1061,446,360,806,103,909,1640,55.43%,27.2%,1
臺南市,南區,1062,395,307,702,63,765,1701,44.97%,23.22%,1
臺南市,南區,1063,381,280,661,99,760,1541,49.32%,24.72%,1
臺南市,南區,1064,498,391,889,132,1021,2027,50.37%,24.57%,1
臺南市,南區,1065,511,414,925,104,1029,1774,58%,28.8%,1
臺南市,南區,1066,417,320,737,95,832,1613,51.58%,25.85%,1
臺南市,南區,1067,428,344,772,42,814,1707,47.69%,25.07%,1
臺南市,南區,1068,294,230,524,31,555,1657,33.49%,17.74%,1
臺南市,南區,1069,271,248,519,62,581,1077,53.95%,25.16%,1
臺南市,南區,1070,332,233,565,64,629,1185,53.08%,28.02%,1
臺南市,南區,1071,344,258,602,60,662,1249,53%,27.54%,1
臺南市,南區,1072,467,351,818,42,860,1985,43.32%,23.53%,1
臺南市,南區,1073,440,368,808,100,908,2017,45.02%,21.81%,1
臺南市,南區,1074,384,352,736,93,829,1717,48.28%,22.36%,1
臺南市,南區,1075,259,200,459,54,513,929,55.22%,27.88%,1
臺南市,南區,1076,185,173,358,36,394,695,56.69%,26.62%,1
臺南市,南區,1077,226,176,402,38,440,997,44.13%,22.67%,1
臺南市,南區,1078,190,120,310,30,340,784,43.37%,24.23%,1
臺南市,南區,1079,321,229,550,106,656,1119,58.62%,28.69%,1
臺南市,南區,1080,228,171,399,40,439,1054,41.65%,21.63%,1
臺南市,南區,1081,299,214,513,127,640,1245,51.41%,24.02%,1
臺南市,南區,1082,479,376,855,77,932,2064,45.16%,23.21%,1
臺南市,南區,1083,427,330,757,44,801,2056,38.96%,20.77%,1
臺南市,南區,1084,293,248,541,44,585,1373,42.61%,21.34%,1
臺南市,南區,1085,201,159,360,54,414,1002,41.32%,20.06%,1
臺南市,南區,1086,215,158,373,63,436,760,57.37%,28.29%,1
臺南市,南區,1087,254,216,470,96,566,1031,54.9%,24.64%,1
臺南市,南區,1088,194,144,338,71,409,744,54.97%,26.08%,1
臺南市,南區,1089,314,240,554,89,643,1186,54.22%,26.48%,1
臺南市,南區,1090,340,305,645,99,744,1358,54.79%,25.04%,1
臺南市,南區,1091,195,158,353,41,394,897,43.92%,21.74%,1
臺南市,南區,1092,318,242,560,97,657,1265,51.94%,25.14%,1
臺南市,南區,1093,227,199,426,62,488,1093,44.65%,20.77%,1
臺南市,南區,1094,297,200,497,49,546,1016,53.74%,29.23%,1
臺南市,北區,0850,488,341,829,77,906,1793,50.53%,27.22%,1
臺南市,北區,0851,443,298,741,66,807,1708,47.25%,25.94%,1
臺南市,北區,0852,249,235,484,27,511,997,51.25%,24.97%,1
臺南市,北區,0853,338,267,605,46,651,1452,44.83%,23.28%,1
臺南市,北區,0854,357,278,635,34,669,1351,49.52%,26.42%,1
臺南市,北區,0855,434,321,755,73,828,1323,62.59%,32.8%,1
臺南市,北區,0856,313,237,550,40,590,1073,54.99%,29.17%,1
臺南市,北區,0857,319,271,590,42,632,1138,55.54%,28.03%,1
臺南市,北區,0858,314,257,571,52,623,1189,52.4%,26.41%,1
臺南市,北區,0859,406,294,700,48,748,1262,59.27%,32.17%,1
臺南市,北區,0860,352,223,575,30,605,1017,59.49%,34.61%,1
臺南市,北區,0861,257,163,420,27,447,847,52.77%,30.34%,1
臺南市,北區,0862,339,239,578,45,623,1076,57.9%,31.51%,1
臺南市,北區,0863,325,206,531,38,569,954,59.64%,34.07%,1
臺南市,北區,0864,355,252,607,81,688,1300,52.92%,27.31%,1
臺南市,北區,0865,442,227,669,60,729,1390,52.45%,31.8%,1
臺南市,北區,0866,373,315,688,52,740,1318,56.15%,28.3%,1
臺南市,北區,0867,275,210,485,18,503,974,51.64%,28.23%,1
臺南市,北區,0868,290,207,497,31,528,990,53.33%,29.29%,1
臺南市,北區,0869,317,276,593,19,612,1016,60.24%,31.2%,1
臺南市,北區,0870,304,241,545,44,589,1053,55.94%,28.87%,1
臺南市,北區,0871,363,307,670,86,756,1466,51.57%,24.76%,1
臺南市,北區,0872,448,307,755,94,849,1535,55.31%,29.19%,1
臺南市,北區,0873,397,320,717,77,794,1544,51.42%,25.71%,1
臺南市,北區,0874,512,378,890,87,977,1760,55.51%,29.09%,1
臺南市,北區,0875,312,271,583,45,628,1372,45.77%,22.74%,1
臺南市,北區,0876,320,219,539,48,587,1002,58.58%,31.94%,1
臺南市,北區,0877,353,276,629,50,679,1171,57.98%,30.15%,1
臺南市,北區,0878,371,205,576,36,612,1285,47.63%,28.87%,1
臺南市,北區,0879,303,197,500,45,545,1036,52.61%,29.25%,1
臺南市,北區,0880,412,265,677,71,748,1392,53.74%,29.6%,1
臺南市,北區,0881,313,247,560,74,634,1147,55.27%,27.29%,1
臺南市,北區,0882,354,253,607,56,663,1526,43.45%,23.2%,1
臺南市,北區,0883,415,322,737,50,787,1559,50.48%,26.62%,1
臺南市,北區,0884,247,189,436,78,514,892,57.62%,27.69%,1
臺南市,北區,0885,239,191,430,49,479,937,51.12%,25.51%,1
臺南市,北區,0886,400,326,726,105,831,1449,57.35%,27.61%,1
臺南市,北區,0887,312,222,534,49,583,1160,50.26%,26.9%,1
臺南市,北區,0888,273,232,505,89,594,1567,37.91%,17.42%,1
臺南市,北區,0889,364,281,645,67,712,1346,52.9%,27.04%,1
臺南市,北區,0890,375,285,660,19,679,1451,46.8%,25.84%,1
臺南市,北區,0891,399,308,707,44,751,1522,49.34%,26.22%,1
臺南市,北區,0892,331,258,589,46,635,1278,49.69%,25.9%,1
臺南市,北區,0893,273,247,520,72,592,1164,50.86%,23.45%,1
臺南市,北區,0894,269,208,477,27,504,1091,46.2%,24.66%,1
臺南市,北區,0895,251,204,455,35,490,993,49.35%,25.28%,1
臺南市,北區,0896,242,203,445,51,496,1119,44.33%,21.63%,1
臺南市,北區,0897,460,363,823,105,928,1685,55.07%,27.3%,1
臺南市,北區,0898,371,304,675,31,706,1368,51.61%,27.12%,1
臺南市,北區,0899,379,290,669,80,749,1389,53.92%,27.29%,1
臺南市,北區,0900,445,343,788,38,826,1469,56.23%,30.29%,1
臺南市,北區,0901,520,358,878,71,949,1655,57.34%,31.42%,1
臺南市,北區,0902,390,289,679,35,714,1261,56.62%,30.93%,1
臺南市,北區,0903,407,312,719,34,753,1490,50.54%,27.32%,1
臺南市,北區,0904,459,323,782,48,830,1436,57.8%,31.96%,1
臺南市,北區,0905,422,278,700,90,790,1340,58.96%,31.49%,1
臺南市,北區,0906,446,296,742,56,798,1464,54.51%,30.46%,1
臺南市,北區,0907,457,363,820,44,864,1513,57.11%,30.2%,1
臺南市,北區,0908,524,385,909,16,925,1709,54.13%,30.66%,1
臺南市,北區,0909,500,365,865,43,908,1517,59.85%,32.96%,1
臺南市,北區,0910,406,380,786,43,829,1598,51.88%,25.41%,1
臺南市,北區,0911,374,307,681,58,739,1399,52.82%,26.73%,1
臺南市,北區,0912,326,242,568,68,636,1214,52.39%,26.85%,1
臺南市,北區,0913,310,250,560,37,597,1064,56.11%,29.14%,1
臺南市,北區,0914,378,272,650,52,702,1148,61.15%,32.93%,1
臺南市,北區,0915,409,303,712,47,759,1391,54.57%,29.4%,1
臺南市,北區,0916,463,355,818,58,876,1584,55.3%,29.23%,1
臺南市,北區,0917,503,340,843,49,892,1595,55.92%,31.54%,1
臺南市,北區,0918,389,302,691,38,729,1397,52.18%,27.85%,1
臺南市,北區,0919,452,364,816,69,885,1662,53.25%,27.2%,1
臺南市,北區,0920,475,307,782,38,820,1634,50.18%,29.07%,1
臺南市,北區,0921,523,394,917,98,1015,1793,56.61%,29.17%,1
臺南市,北區,0922,540,394,934,69,1003,1872,53.58%,28.85%,1
臺南市,北區,0923,465,423,888,121,1009,1874,53.84%,24.81%,1
臺南市,北區,0924,477,330,807,91,898,1760,51.02%,27.1%,1
臺南市,北區,0925,490,314,804,89,893,1753,50.94%,27.95%,1
臺南市,北區,0926,341,279,620,36,656,1502,43.68%,22.7%,1
臺南市,北區,0927,403,321,724,60,784,1470,53.33%,27.41%,1
臺南市,北區,0928,332,274,606,97,703,1319,53.3%,25.17%,1
臺南市,北區,0929,639,336,975,63,1038,1876,55.33%,34.06%,1
臺南市,北區,0930,479,368,847,48,895,1720,52.03%,27.85%,1
臺南市,安南區,0618,688,573,1261,46,1307,2549,51.28%,26.99%,1
臺南市,安南區,0619,578,451,1029,127,1156,2321,49.81%,24.9%,1
臺南市,安南區,0620,619,486,1105,83,1188,2156,55.1%,28.71%,1
臺南市,安南區,0621,498,375,873,97,970,1662,58.36%,29.96%,1
臺南市,安南區,0622,426,318,744,134,878,1512,58.07%,28.17%,1
臺南市,安南區,0623,409,331,740,84,824,1625,50.71%,25.17%,1
臺南市,安南區,0624,516,377,893,63,956,2143,44.61%,24.08%,1
臺南市,安南區,0625,723,489,1212,114,1326,2457,53.97%,29.43%,1
臺南市,安南區,0626,625,450,1075,127,1202,2148,55.96%,29.1%,1
臺南市,安南區,0627,644,487,1131,98,1229,2364,51.99%,27.24%,1
臺南市,安南區,0628,455,346,801,71,872,1868,46.68%,24.36%,1
臺南市,安南區,0629,724,238,962,79,1041,1797,57.93%,40.29%,1
臺南市,安南區,0630,649,477,1126,91,1217,2268,53.66%,28.62%,1
臺南市,安南區,0631,539,389,928,95,1023,2291,44.65%,23.53%,1
臺南市,安南區,0632,597,445,1042,102,1144,2255,50.73%,26.47%,1
臺南市,安南區,0633,453,400,853,86,939,1940,48.4%,23.35%,1
臺南市,安南區,0634,529,461,990,64,1054,2013,52.36%,26.28%,1
臺南市,安南區,0635,556,397,953,87,1040,2024,51.38%,27.47%,1
臺南市,安南區,0636,473,407,880,106,986,1613,61.13%,29.32%,1
臺南市,安南區,0637,303,243,546,52,598,1178,50.76%,25.72%,1
臺南市,安南區,0638,548,480,1028,114,1142,2143,53.29%,25.57%,1
臺南市,安南區,0639,498,369,867,98,965,1721,56.07%,28.94%,1
臺南市,安南區,0640,547,371,918,86,1004,1773,56.63%,30.85%,1
臺南市,安南區,0641,411,297,708,30,738,1428,51.68%,28.78%,1
臺南市,安南區,0642,476,344,820,72,892,1626,54.86%,29.27%,1
臺南市,安南區,0643,378,293,671,64,735,1358,54.12%,27.84%,1
臺南市,安南區,0644,481,300,781,63,844,1447,58.33%,33.24%,1
臺南市,安南區,0645,402,278,680,92,772,1358,56.85%,29.6%,1
臺南市,安南區,0646,528,403,931,80,1011,2116,47.78%,24.95%,1
臺南市,安南區,0647,580,441,1021,63,1084,2321,46.7%,24.99%,1
臺南市,安南區,0648,864,101,965,60,1025,2117,48.42%,40.81%,1
臺南市,安南區,0649,476,396,872,83,955,1927,49.56%,24.7%,1
臺南市,安南區,0650,562,429,991,152,1143,2242,50.98%,25.07%,1
臺南市,安南區,0651,587,444,1031,68,1099,2334,47.09%,25.15%,1
臺南市,安南區,0652,526,373,899,91,990,1822,54.34%,28.87%,1
臺南市,安南區,0653,513,386,899,110,1009,1813,55.65%,28.3%,1
臺南市,安南區,0654,639,411,1050,122,1172,2188,53.56%,29.2%,1
臺南市,安南區,0655,609,440,1049,121,1170,2399,48.77%,25.39%,1
臺南市,安南區,0656,557,386,943,86,1029,2247,45.79%,24.79%,1
臺南市,安南區,0657,355,278,633,86,719,1165,61.72%,30.47%,1
臺南市,安南區,0658,391,310,701,71,772,1539,50.16%,25.41%,1
臺南市,安南區,0659,482,412,894,126,1020,1835,55.59%,26.27%,1
臺南市,安南區,0660,493,364,857,120,977,1797,54.37%,27.43%,1
臺南市,安南區,0661,558,393,951,129,1080,2223,48.58%,25.1%,1
臺南市,安南區,0662,282,268,550,73,623,977,63.77%,28.86%,1
臺南市,安南區,0663,382,325,707,51,758,1642,46.16%,23.26%,1
臺南市,安南區,0664,494,356,850,87,937,1697,55.22%,29.11%,1
臺南市,安南區,0665,472,358,830,85,915,1966,46.54%,24.01%,1
臺南市,安南區,0666,343,273,616,82,698,1319,52.92%,26%,1
臺南市,安南區,0667,480,362,842,90,932,1909,48.82%,25.14%,1
臺南市,安南區,0668,503,345,848,96,944,1763,53.55%,28.53%,1
臺南市,安南區,0669,260,193,453,62,515,965,53.37%,26.94%,1
臺南市,安南區,0670,352,249,601,99,700,1547,45.25%,22.75%,1
臺南市,安南區,0671,454,366,820,86,906,1784,50.78%,25.45%,1
臺南市,安南區,0672,514,423,937,84,1021,2145,47.6%,23.96%,1
臺南市,安南區,0673,727,496,1223,92,1315,2443,53.83%,29.76%,1
臺南市,安南區,0674,590,447,1037,72,1109,2565,43.24%,23%,1
臺南市,安南區,0675,660,522,1182,105,1287,2480,51.9%,26.61%,1
臺南市,安南區,0676,548,388,936,123,1059,2349,45.08%,23.33%,1
臺南市,安南區,0677,557,486,1043,112,1155,2168,53.27%,25.69%,1
臺南市,安南區,0678,438,325,763,65,828,1630,50.8%,26.87%,1
臺南市,安南區,0679,387,304,691,47,738,1675,44.06%,23.1%,1
臺南市,安南區,0680,488,391,879,131,1010,1627,62.08%,29.99%,1
臺南市,安南區,0681,387,336,723,70,793,1493,53.11%,25.92%,1
臺南市,安南區,0682,417,279,696,88,784,1397,56.12%,29.85%,1
臺南市,安南區,0683,378,292,670,65,735,1416,51.91%,26.69%,1
臺南市,安南區,0684,397,317,714,40,754,1460,51.64%,27.19%,1
臺南市,安南區,0685,520,386,906,64,970,2222,43.65%,23.4%,1
臺南市,安南區,0686,564,418,982,117,1099,2070,53.09%,27.25%,1
臺南市,安南區,0687,486,390,876,74,950,1739,54.63%,27.95%,1
臺南市,安南區,0688,483,348,831,105,936,1830,51.15%,26.39%,1
臺南市,安南區,0689,517,430,947,105,1052,1803,58.35%,28.67%,1
臺南市,安南區,0690,476,461,937,80,1017,1800,56.5%,26.44%,1
臺南市,安南區,0691,399,350,749,104,853,1815,47%,21.98%,1
臺南市,安南區,0692,453,349,802,61,863,1846,46.75%,24.54%,1
臺南市,安南區,0693,256,225,481,72,553,905,61.1%,28.29%,1
臺南市,安南區,0694,316,258,574,87,661,1073,61.6%,29.45%,1
臺南市,安南區,0695,475,338,813,97,910,1579,57.63%,30.08%,1
臺南市,安南區,0696,484,356,840,130,970,1876,51.71%,25.8%,1
臺南市,安南區,0697,292,247,539,64,603,1194,50.5%,24.46%,1
臺南市,安南區,0698,290,224,514,43,557,1475,37.76%,19.66%,1
臺南市,安南區,0699,270,347,617,34,651,1380,47.17%,19.57%,1
臺南市,安南區,0700,345,289,634,25,659,1462,45.08%,23.6%,1
臺南市,安南區,0701,315,200,515,88,603,1044,57.76%,30.17%,1
臺南市,安南區,0702,191,140,331,64,395,603,65.51%,31.67%,1
臺南市,安南區,0703,204,163,367,31,398,690,57.68%,29.57%,1
臺南市,安南區,0704,342,320,662,60,722,1447,49.9%,23.64%,1
臺南市,安南區,0705,309,226,535,62,597,910,65.6%,33.96%,1
臺南市,安南區,0706,443,338,781,112,893,1850,48.27%,23.95%,1
臺南市,安南區,0707,497,299,796,75,871,1501,58.03%,33.11%,1
臺南市,安平區,0983,478,382,860,94,954,1753,54.42%,27.27%,1
臺南市,安平區,0984,523,363,886,64,950,1859,51.1%,28.13%,1
臺南市,安平區,0985,432,321,753,52,805,1382,58.25%,31.26%,1
臺南市,安平區,0986,665,502,1167,93,1260,2547,49.47%,26.11%,1
臺南市,安平區,0987,618,539,1157,87,1244,2407,51.68%,25.68%,1
臺南市,安平區,0988,506,377,883,59,942,2070,45.51%,24.44%,1
臺南市,安平區,0989,685,338,1023,55,1078,2132,50.56%,32.13%,1
臺南市,安平區,0990,412,326,738,34,772,1450,53.24%,28.41%,1
臺南市,安平區,0991,424,331,755,35,790,1605,49.22%,26.42%,1
臺南市,安平區,0992,472,406,878,68,946,1755,53.9%,26.89%,1
臺南市,安平區,0993,425,328,753,60,813,1728,47.05%,24.59%,1
臺南市,安平區,0994,349,313,662,65,727,1754,41.45%,19.9%,1
臺南市,安平區,0995,449,348,797,75,872,1686,51.72%,26.63%,1
臺南市,安平區,0996,545,397,942,50,992,1843,53.83%,29.57%,1
臺南市,安平區,0997,466,355,821,50,871,1565,55.65%,29.78%,1
臺南市,安平區,0998,368,263,631,38,669,1288,51.94%,28.57%,1
臺南市,安平區,0999,441,315,756,30,786,1653,47.55%,26.68%,1
臺南市,安平區,1000,489,278,767,44,811,1697,47.79%,28.82%,1
臺南市,安平區,1001,532,408,940,69,1009,2154,46.84%,24.7%,1
臺南市,安平區,1002,537,425,962,65,1027,2107,48.74%,25.49%,1
臺南市,安平區,1003,490,350,840,86,926,1675,55.28%,29.25%,1
臺南市,安平區,1004,527,428,955,67,1022,1979,51.64%,26.63%,1
臺南市,安平區,1005,427,311,738,47,785,1602,49%,26.65%,1
臺南市,安平區,1006,463,273,736,65,801,1586,50.5%,29.19%,1
臺南市,安平區,1007,98,71,169,13,182,438,41.55%,22.37%,1
臺南市,安平區,1008,479,335,814,88,902,1780,50.67%,26.91%,1
臺南市,安平區,1009,383,332,715,54,769,1623,47.38%,23.6%,1
臺南市,安平區,1010,555,393,948,111,1059,2157,49.1%,25.73%,1
臺南市,安平區,1011,302,261,563,59,622,1286,48.37%,23.48%,1
臺南市,安平區,1012,391,306,697,90,787,1492,52.75%,26.21%,1
臺南市,安平區,1013,318,205,523,50,573,1325,43.25%,24%,1
臺南市,安平區,1014,497,375,872,119,991,2001,49.53%,24.84%,1
臺南市,中西區,0931,341,319,660,75,735,1332,55.18%,25.6%,1
臺南市,中西區,0932,342,283,625,86,711,1246,57.06%,27.45%,1
臺南市,中西區,0933,335,266,601,71,672,1276,52.66%,26.25%,1
臺南市,中西區,0934,453,374,827,65,892,1583,56.35%,28.62%,1
臺南市,中西區,0935,421,358,779,51,830,1464,56.69%,28.76%,1
臺南市,中西區,0936,326,276,602,32,634,1234,51.38%,26.42%,1
臺南市,中西區,0937,388,339,727,59,786,1368,57.46%,28.36%,1
臺南市,中西區,0938,321,245,566,44,610,1322,46.14%,24.28%,1
臺南市,中西區,0939,278,290,568,76,644,1216,52.96%,22.86%,1
臺南市,中西區,0940,334,296,630,45,675,1289,52.37%,25.91%,1
臺南市,中西區,0941,373,270,643,57,700,1237,56.59%,30.15%,1
臺南市,中西區,0942,268,232,500,45,545,1189,45.84%,22.54%,1
臺南市,中西區,0943,341,261,602,75,677,1201,56.37%,28.39%,1
臺南市,中西區,0944,324,247,571,66,637,1065,59.81%,30.42%,1
臺南市,中西區,0945,307,231,538,65,603,1055,57.16%,29.1%,1
臺南市,中西區,0946,347,299,646,65,711,1170,60.77%,29.66%,1
臺南市,中西區,0947,419,293,712,61,773,1280,60.39%,32.73%,1
臺南市,中西區,0948,361,277,638,52,690,1223,56.42%,29.52%,1
臺南市,中西區,0949,365,305,670,81,751,1292,58.13%,28.25%,1
臺南市,中西區,0950,296,266,562,21,583,993,58.71%,29.81%,1
臺南市,中西區,0951,408,352,760,77,837,1541,54.32%,26.48%,1
臺南市,中西區,0952,499,402,901,86,987,1652,59.75%,30.21%,1
臺南市,中西區,0953,371,285,656,34,690,1212,56.93%,30.61%,1
臺南市,中西區,0954,458,392,850,74,924,1621,57%,28.25%,1
臺南市,中西區,0955,449,410,859,56,915,1660,55.12%,27.05%,1
臺南市,中西區,0956,420,362,782,88,870,1595,54.55%,26.33%,1
臺南市,中西區,0957,394,315,709,58,767,1436,53.41%,27.44%,1
臺南市,中西區,0958,339,311,650,71,721,1265,57%,26.8%,1
臺南市,中西區,0959,254,218,472,53,525,856,61.33%,29.67%,1
臺南市,中西區,0960,299,266,565,53,618,1168,52.91%,25.6%,1
臺南市,中西區,0961,312,265,577,88,665,1134,58.64%,27.51%,1
臺南市,中西區,0962,307,245,552,68,620,995,62.31%,30.85%,1
臺南市,中西區,0963,436,330,766,43,809,1313,61.61%,33.21%,1
臺南市,中西區,0964,352,332,684,67,751,1265,59.37%,27.83%,1
臺南市,中西區,0965,303,292,595,56,651,1215,53.58%,24.94%,1
臺南市,中西區,0966,365,269,634,51,685,1248,54.89%,29.25%,1
臺南市,中西區,0967,199,139,338,43,381,687,55.46%,28.97%,1
臺南市,中西區,0968,310,231,541,93,634,1139,55.66%,27.22%,1
臺南市,中西區,0969,293,210,503,64,567,971,58.39%,30.18%,1
臺南市,中西區,0970,279,197,476,67,543,1254,43.3%,22.25%,1
臺南市,中西區,0971,252,240,492,50,542,979,55.36%,25.74%,1
臺南市,中西區,0972,452,361,813,76,889,1745,50.95%,25.9%,1
臺南市,中西區,0973,269,267,536,45,581,1074,54.1%,25.05%,1
臺南市,中西區,0974,364,299,663,55,718,1436,50%,25.35%,1
臺南市,中西區,0975,234,195,429,67,496,865,57.34%,27.05%,1
臺南市,中西區,0976,312,262,574,63,637,1164,54.73%,26.8%,1
臺南市,中西區,0977,298,262,560,50,610,1285,47.47%,23.19%,1
臺南市,中西區,0978,270,269,539,55,594,1078,55.1%,25.05%,1
臺南市,中西區,0979,383,296,679,69,748,1704,43.9%,22.48%,1
臺南市,中西區,0980,342,306,648,108,756,1296,58.33%,26.39%,1
臺南市,中西區,0981,315,251,566,56,622,1128,55.14%,27.93%,1
臺南市,中西區,0982,374,273,647,40,687,1245,55.18%,30.04%,1
高雄市,鹽埕區,0845,400,345,745,63,808,1304,61.96%,30.67%,1
高雄市,鹽埕區,0846,111,79,190,28,218,357,61.06%,31.09%,1
高雄市,鹽埕區,0847,177,175,352,35,387,651,59.45%,27.19%,1
高雄市,鹽埕區,0848,358,252,610,33,643,1322,48.64%,27.08%,1
高雄市,鹽埕區,0849,346,237,583,24,607,1056,57.48%,32.77%,1
高雄市,鹽埕區,0850,280,227,507,24,531,904,58.74%,30.97%,1
高雄市,鹽埕區,0851,335,245,580,37,617,1130,54.6%,29.65%,1
高雄市,鹽埕區,0852,292,199,491,21,512,840,60.95%,34.76%,1
高雄市,鹽埕區,0853,225,178,403,35,438,616,71.1%,36.53%,1
高雄市,鹽埕區,0854,407,279,686,41,727,1397,52.04%,29.13%,1
高雄市,鹽埕區,0855,221,203,424,19,443,766,57.83%,28.85%,1
高雄市,鹽埕區,0856,255,221,476,45,521,839,62.1%,30.39%,1
高雄市,鹽埕區,0857,291,185,476,19,495,805,61.49%,36.15%,1
高雄市,鹽埕區,0858,229,160,389,19,408,750,54.4%,30.53%,1
高雄市,鹽埕區,0859,271,244,515,36,551,986,55.88%,27.48%,1
高雄市,鹽埕區,0860,303,224,527,13,540,1068,50.56%,28.37%,1
高雄市,鹽埕區,0861,324,258,582,47,629,1060,59.34%,30.57%,1
高雄市,鹽埕區,0862,228,178,406,37,443,805,55.03%,28.32%,1
高雄市,鹽埕區,0863,307,201,508,23,531,1073,49.49%,28.61%,1
高雄市,鹽埕區,0864,253,179,432,38,470,921,51.03%,27.47%,1
高雄市,鹽埕區,0865,362,255,617,24,641,1171,54.74%,30.91%,1
高雄市,鹽埕區,0866,165,162,327,17,344,594,57.91%,27.78%,1
高雄市,鹽埕區,0867,186,142,328,24,352,592,59.46%,31.42%,1
高雄市,鹽埕區,0868,169,129,298,16,314,610,51.48%,27.7%,1
高雄市,鼓山區,0768,289,178,467,32,499,959,52.03%,30.14%,1
高雄市,鼓山區,0769,374,236,610,53,663,1000,66.3%,37.4%,1
高雄市,鼓山區,0770,289,196,485,22,507,910,55.71%,31.76%,1
高雄市,鼓山區,0771,402,248,650,61,711,1085,65.53%,37.05%,1
高雄市,鼓山區,0772,359,258,617,53,670,1484,45.15%,24.19%,1
高雄市,鼓山區,0773,490,298,788,38,826,1393,59.3%,35.18%,1
高雄市,鼓山區,0774,503,274,777,76,853,1270,67.17%,39.61%,1
高雄市,鼓山區,0775,303,243,546,43,589,1055,55.83%,28.72%,1
高雄市,鼓山區,0776,360,278,638,38,676,1172,57.68%,30.72%,1
高雄市,鼓山區,0777,407,275,682,56,738,1175,62.81%,34.64%,1
高雄市,鼓山區,0778,393,293,686,54,740,1274,58.08%,30.85%,1
高雄市,鼓山區,0779,276,220,496,63,559,1085,51.52%,25.44%,1
高雄市,鼓山區,0780,481,289,770,73,843,1470,57.35%,32.72%,1
高雄市,鼓山區,0781,346,244,590,51,641,974,65.81%,35.52%,1
高雄市,鼓山區,0782,414,283,697,99,796,1275,62.43%,32.47%,1
高雄市,鼓山區,0783,361,267,628,63,691,1206,57.3%,29.93%,1
高雄市,鼓山區,0784,423,253,676,39,715,1238,57.75%,34.17%,1
高雄市,鼓山區,0785,371,109,480,18,498,721,69.07%,51.46%,1
高雄市,鼓山區,0786,360,257,617,38,655,1220,53.69%,29.51%,1
高雄市,鼓山區,0787,524,363,887,51,938,1966,47.71%,26.65%,1
高雄市,鼓山區,0788,426,375,801,121,922,1722,53.54%,24.74%,1
高雄市,鼓山區,0789,522,329,851,42,893,1720,51.92%,30.35%,1
高雄市,鼓山區,0790,437,253,690,115,805,1287,62.55%,33.95%,1
高雄市,鼓山區,0791,338,243,581,49,630,1369,46.02%,24.69%,1
高雄市,鼓山區,0792,403,292,695,52,747,1222,61.13%,32.98%,1
高雄市,鼓山區,0793,540,359,899,62,961,1770,54.29%,30.51%,1
高雄市,鼓山區,0794,729,299,1028,53,1081,1860,58.12%,39.19%,1
高雄市,鼓山區,0795,590,406,996,60,1056,1857,56.87%,31.77%,1
高雄市,鼓山區,0796,606,418,1024,58,1082,1841,58.77%,32.92%,1
高雄市,鼓山區,0797,657,439,1096,74,1170,1830,63.93%,35.9%,1
高雄市,鼓山區,0798,598,414,1012,71,1083,1809,59.87%,33.06%,1
高雄市,鼓山區,0799,663,439,1102,52,1154,1894,60.93%,35.01%,1
高雄市,鼓山區,0800,630,482,1112,38,1150,1882,61.11%,33.48%,1
高雄市,鼓山區,0801,677,485,1162,53,1215,1894,64.15%,35.74%,1
高雄市,鼓山區,0802,607,354,961,54,1015,1745,58.17%,34.79%,1
高雄市,鼓山區,0803,614,401,1015,30,1045,1887,55.38%,32.54%,1
高雄市,鼓山區,0804,713,453,1166,69,1235,1891,65.31%,37.7%,1
高雄市,鼓山區,0805,647,455,1102,54,1156,1903,60.75%,34%,1
高雄市,鼓山區,0806,654,513,1167,52,1219,1998,61.01%,32.73%,1
高雄市,鼓山區,0807,714,415,1129,53,1182,1912,61.82%,37.34%,1
高雄市,鼓山區,0808,660,459,1119,85,1204,1923,62.61%,34.32%,1
高雄市,鼓山區,0809,800,467,1267,35,1302,1888,68.96%,42.37%,1
高雄市,鼓山區,0810,682,450,1132,24,1156,1873,61.72%,36.41%,1
高雄市,鼓山區,0811,760,495,1255,49,1304,1959,66.56%,38.8%,1
高雄市,鼓山區,0812,720,465,1185,58,1243,1897,65.52%,37.95%,1
高雄市,鼓山區,0813,873,318,1191,55,1246,2362,52.75%,36.96%,1
高雄市,鼓山區,0814,676,401,1077,85,1162,1850,62.81%,36.54%,1
高雄市,鼓山區,0815,664,489,1153,37,1190,1928,61.72%,34.44%,1
高雄市,鼓山區,0816,671,402,1073,33,1106,1937,57.1%,34.64%,1
高雄市,鼓山區,0817,749,456,1205,63,1268,2123,59.73%,35.28%,1
高雄市,鼓山區,0818,635,426,1061,45,1106,1861,59.43%,34.12%,1
高雄市,鼓山區,0819,660,401,1061,40,1101,1892,58.19%,34.88%,1
高雄市,鼓山區,0820,783,479,1262,63,1325,2147,61.71%,36.47%,1
高雄市,鼓山區,0821,686,440,1126,43,1169,1897,61.62%,36.16%,1
高雄市,鼓山區,0822,674,464,1138,50,1188,2041,58.21%,33.02%,1
高雄市,鼓山區,0823,454,275,729,59,788,1309,60.2%,34.68%,1
高雄市,鼓山區,0824,604,449,1053,67,1120,1867,59.99%,32.35%,1
高雄市,鼓山區,0825,472,277,749,38,787,1152,68.32%,40.97%,1
高雄市,鼓山區,0826,530,316,846,61,907,1404,64.6%,37.75%,1
高雄市,鼓山區,0827,263,188,451,28,479,1210,39.59%,21.74%,1
高雄市,鼓山區,0828,335,252,587,50,637,1135,56.12%,29.52%,1
高雄市,鼓山區,0829,345,233,578,87,665,1831,36.32%,18.84%,1
高雄市,鼓山區,0830,417,285,702,60,762,1288,59.16%,32.38%,1
高雄市,鼓山區,0831,451,154,605,52,657,1241,52.94%,36.34%,1
高雄市,鼓山區,0832,459,293,752,73,825,1342,61.48%,34.2%,1
高雄市,鼓山區,0833,438,306,744,129,873,1422,61.39%,30.8%,1
高雄市,鼓山區,0834,475,313,788,126,914,1453,62.9%,32.69%,1
高雄市,鼓山區,0835,194,150,344,55,399,616,64.77%,31.49%,1
高雄市,鼓山區,0836,237,180,417,84,501,834,60.07%,28.42%,1
高雄市,鼓山區,0837,268,233,501,75,576,969,59.44%,27.66%,1
高雄市,鼓山區,0838,277,217,494,89,583,978,59.61%,28.32%,1
高雄市,鼓山區,0839,229,201,430,61,491,760,64.61%,30.13%,1
高雄市,鼓山區,0840,358,317,675,80,755,1248,60.5%,28.69%,1
高雄市,鼓山區,0841,292,233,525,34,559,1143,48.91%,25.55%,1
高雄市,鼓山區,0842,329,268,597,84,681,1358,50.15%,24.23%,1
高雄市,鼓山區,0843,285,210,495,26,521,1036,50.29%,27.51%,1
高雄市,鼓山區,0844,180,111,291,13,304,580,52.41%,31.03%,1
高雄市,左營區,0534,502,301,803,78,881,2604,33.83%,19.28%,1
高雄市,左營區,0535,324,230,554,89,643,1037,62.01%,31.24%,1
高雄市,左營區,0536,176,128,304,55,359,542,66.24%,32.47%,1
高雄市,左營區,0537,183,145,328,59,387,635,60.94%,28.82%,1
高雄市,左營區,0538,121,104,225,21,246,518,47.49%,23.36%,1
高雄市,左營區,0539,223,154,377,71,448,813,55.1%,27.43%,1
高雄市,左營區,0540,344,99,443,92,535,889,60.18%,38.7%,1
高雄市,左營區,0541,218,178,396,75,471,731,64.43%,29.82%,1
高雄市,左營區,0542,433,311,744,60,804,1592,50.5%,27.2%,1
高雄市,左營區,0543,547,370,917,54,971,1709,56.82%,32.01%,1
高雄市,左營區,0544,556,292,848,81,929,1588,58.5%,35.01%,1
高雄市,左營區,0545,129,49,178,16,194,358,54.19%,36.03%,1
高雄市,左營區,0546,292,144,436,20,456,666,68.47%,43.84%,1
高雄市,左營區,0547,575,329,904,89,993,1748,56.81%,32.89%,1
高雄市,左營區,0548,462,242,704,63,767,1196,64.13%,38.63%,1
高雄市,左營區,0549,433,285,718,70,788,1240,63.55%,34.92%,1
高雄市,左營區,0550,621,206,827,46,873,1402,62.27%,44.29%,1
高雄市,左營區,0551,546,181,727,32,759,1173,64.71%,46.55%,1
高雄市,左營區,0552,257,170,427,30,457,641,71.29%,40.09%,1
高雄市,左營區,0553,245,234,479,56,535,951,56.26%,25.76%,1
高雄市,左營區,0554,221,153,374,52,426,732,58.2%,30.19%,1
高雄市,左營區,0555,85,73,158,22,180,339,53.1%,25.07%,1
高雄市,左營區,0556,152,126,278,16,294,519,56.65%,29.29%,1
高雄市,左營區,0557,135,145,280,62,342,514,66.54%,26.26%,1
高雄市,左營區,0558,232,159,391,69,460,720,63.89%,32.22%,1
高雄市,左營區,0559,115,101,216,53,269,411,65.45%,27.98%,1
高雄市,左營區,0560,188,148,336,59,395,603,65.51%,31.18%,1
高雄市,左營區,0561,282,200,482,74,556,904,61.5%,31.19%,1
高雄市,左營區,0562,385,240,625,47,672,1318,50.99%,29.21%,1
高雄市,左營區,0563,251,207,458,34,492,966,50.93%,25.98%,1
高雄市,左營區,0564,534,269,803,46,849,1440,58.96%,37.08%,1
高雄市,左營區,0565,745,305,1050,57,1107,1990,55.63%,37.44%,1
高雄市,左營區,0566,435,195,630,44,674,1090,61.83%,39.91%,1
高雄市,左營區,0567,498,214,712,84,796,1272,62.58%,39.15%,1
高雄市,左營區,0568,621,332,953,30,983,1558,63.09%,39.86%,1
高雄市,左營區,0569,555,368,923,44,967,1501,64.42%,36.98%,1
高雄市,左營區,0570,159,78,237,11,248,360,68.89%,44.17%,1
高雄市,左營區,0571,566,193,759,29,788,1335,59.03%,42.4%,1
高雄市,左營區,0572,531,241,772,22,794,1359,58.43%,39.07%,1
高雄市,左營區,0573,584,292,876,64,940,1487,63.21%,39.27%,1
高雄市,左營區,0574,567,306,873,63,936,1637,57.18%,34.64%,1
高雄市,左營區,0575,564,349,913,51,964,1553,62.07%,36.32%,1
高雄市,左營區,0576,575,363,938,69,1007,1564,64.39%,36.76%,1
高雄市,左營區,0577,676,430,1106,58,1164,1788,65.1%,37.81%,1
高雄市,左營區,0578,698,449,1147,96,1243,2028,61.29%,34.42%,1
高雄市,左營區,0579,665,471,1136,110,1246,2037,61.17%,32.65%,1
高雄市,左營區,0580,762,475,1237,65,1302,2101,61.97%,36.27%,1
高雄市,左營區,0581,728,448,1176,62,1238,2018,61.35%,36.08%,1
高雄市,左營區,0582,648,511,1159,81,1240,1925,64.42%,33.66%,1
高雄市,左營區,0583,660,446,1106,39,1145,1989,57.57%,33.18%,1
高雄市,左營區,0584,566,336,902,36,938,1780,52.7%,31.8%,1
高雄市,左營區,0585,620,418,1038,43,1081,1778,60.8%,34.87%,1
高雄市,左營區,0586,560,313,873,40,913,1496,61.03%,37.43%,1
高雄市,左營區,0587,540,372,912,53,965,1538,62.74%,35.11%,1
高雄市,左營區,0588,710,472,1182,74,1256,2058,61.03%,34.5%,1
高雄市,左營區,0589,668,487,1155,39,1194,1992,59.94%,33.53%,1
高雄市,左營區,0590,709,468,1177,93,1270,2058,61.71%,34.45%,1
高雄市,左營區,0591,718,490,1208,69,1277,2090,61.1%,34.35%,1
高雄市,左營區,0592,699,498,1197,41,1238,2157,57.39%,32.41%,1
高雄市,左營區,0593,786,499,1285,53,1338,2096,63.84%,37.5%,1
高雄市,左營區,0594,691,540,1231,97,1328,2101,63.21%,32.89%,1
高雄市,左營區,0595,523,369,892,102,994,1649,60.28%,31.72%,1
高雄市,左營區,0596,468,336,804,97,901,1516,59.43%,30.87%,1
高雄市,左營區,0597,591,389,980,90,1070,1678,63.77%,35.22%,1
高雄市,左營區,0598,662,393,1055,102,1157,1898,60.96%,34.88%,1
高雄市,左營區,0599,595,423,1018,65,1083,1837,58.95%,32.39%,1
高雄市,左營區,0600,624,404,1028,37,1065,1922,55.41%,32.47%,1
高雄市,左營區,0601,646,403,1049,72,1121,1785,62.8%,36.19%,1
高雄市,左營區,0602,628,407,1035,35,1070,1886,56.73%,33.3%,1
高雄市,左營區,0603,674,434,1108,61,1169,1895,61.69%,35.57%,1
高雄市,左營區,0604,706,377,1083,41,1124,1831,61.39%,38.56%,1
高雄市,左營區,0605,727,396,1123,61,1184,2050,57.76%,35.46%,1
高雄市,左營區,0606,887,539,1426,58,1484,2251,65.93%,39.4%,1
高雄市,左營區,0607,754,531,1285,45,1330,2126,62.56%,35.47%,1
高雄市,左營區,0608,626,393,1019,42,1061,1928,55.03%,32.47%,1
高雄市,左營區,0609,714,476,1190,64,1254,2166,57.89%,32.96%,1
高雄市,左營區,0610,694,444,1138,73,1211,2031,59.63%,34.17%,1
高雄市,左營區,0611,698,467,1165,64,1229,1987,61.85%,35.13%,1
高雄市,左營區,0612,785,495,1280,50,1330,2166,61.4%,36.24%,1
高雄市,左營區,0613,614,413,1027,117,1144,1856,61.64%,33.08%,1
高雄市,左營區,0614,817,541,1358,45,1403,2289,61.29%,35.69%,1
高雄市,左營區,0615,696,427,1123,53,1176,1973,59.6%,35.28%,1
高雄市,左營區,0616,677,361,1038,89,1127,1818,61.99%,37.24%,1
高雄市,左營區,0617,524,333,857,48,905,1565,57.83%,33.48%,1
高雄市,左營區,0618,652,349,1001,57,1058,1608,65.8%,40.55%,1
高雄市,左營區,0619,668,443,1111,68,1179,1812,65.07%,36.87%,1
高雄市,左營區,0620,613,338,951,36,987,1821,54.2%,33.66%,1
高雄市,左營區,0621,677,439,1116,79,1195,1907,62.66%,35.5%,1
高雄市,左營區,0622,633,383,1016,64,1080,1812,59.6%,34.93%,1
高雄市,左營區,0623,716,404,1120,38,1158,1833,63.18%,39.06%,1
高雄市,左營區,0624,680,402,1082,68,1150,1850,62.16%,36.76%,1
高雄市,左營區,0625,608,351,959,72,1031,1738,59.32%,34.98%,1
高雄市,左營區,0626,714,437,1151,62,1213,1864,65.08%,38.3%,1
高雄市,左營區,0627,684,444,1128,68,1196,1887,63.38%,36.25%,1
高雄市,左營區,0628,646,374,1020,31,1051,1870,56.2%,34.55%,1
高雄市,左營區,0629,746,361,1107,51,1158,1866,62.06%,39.98%,1
高雄市,左營區,0630,708,330,1038,27,1065,1862,57.2%,38.02%,1
高雄市,左營區,0631,619,430,1049,50,1099,1816,60.52%,34.09%,1
高雄市,左營區,0632,662,392,1054,52,1106,1833,60.34%,36.12%,1
高雄市,左營區,0633,584,402,986,67,1053,1676,62.83%,34.84%,1
高雄市,左營區,0634,638,437,1075,60,1135,1843,61.58%,34.62%,1
高雄市,左營區,0635,690,432,1122,40,1162,1872,62.07%,36.86%,1
高雄市,左營區,0636,730,468,1198,48,1246,2259,55.16%,32.32%,1
高雄市,楠梓區,0435,492,286,778,54,832,1309,63.56%,37.59%,1
高雄市,楠梓區,0436,473,328,801,41,842,1408,59.8%,33.59%,1
高雄市,楠梓區,0437,599,432,1031,65,1096,1851,59.21%,32.36%,1
高雄市,楠梓區,0438,527,391,918,64,982,1578,62.23%,33.4%,1
高雄市,楠梓區,0439,542,388,930,40,970,1715,56.56%,31.6%,1
高雄市,楠梓區,0440,419,437,856,28,884,1611,54.87%,26.01%,1
高雄市,楠梓區,0441,609,418,1027,78,1105,2024,54.59%,30.09%,1
高雄市,楠梓區,0442,582,392,974,47,1021,1890,54.02%,30.79%,1
高雄市,楠梓區,0443,529,312,841,30,871,1762,49.43%,30.02%,1
高雄市,楠梓區,0444,575,395,970,66,1036,1888,54.87%,30.46%,1
高雄市,楠梓區,0445,595,356,951,85,1036,1822,56.86%,32.66%,1
高雄市,楠梓區,0446,605,377,982,60,1042,1846,56.45%,32.77%,1
高雄市,楠梓區,0447,432,284,716,75,791,1268,62.38%,34.07%,1
高雄市,楠梓區,0448,452,299,751,58,809,1240,65.24%,36.45%,1
高雄市,楠梓區,0449,489,351,840,42,882,1432,61.59%,34.15%,1
高雄市,楠梓區,0450,471,354,825,64,889,1490,59.66%,31.61%,1
高雄市,楠梓區,0451,530,330,860,61,921,1464,62.91%,36.2%,1
高雄市,楠梓區,0452,426,316,742,77,819,1435,57.07%,29.69%,1
高雄市,楠梓區,0453,446,357,803,83,886,1602,55.31%,27.84%,1
高雄市,楠梓區,0454,455,321,776,64,840,1500,56%,30.33%,1
高雄市,楠梓區,0455,495,323,818,93,911,1591,57.26%,31.11%,1
高雄市,楠梓區,0456,346,263,609,51,660,1669,39.54%,20.73%,1
高雄市,楠梓區,0457,474,348,822,70,892,1469,60.72%,32.27%,1
高雄市,楠梓區,0458,470,322,792,95,887,1559,56.9%,30.15%,1
高雄市,楠梓區,0459,522,343,865,86,951,1638,58.06%,31.87%,1
高雄市,楠梓區,0460,639,430,1069,101,1170,1960,59.69%,32.6%,1
高雄市,楠梓區,0461,608,412,1020,127,1147,1912,59.99%,31.8%,1
高雄市,楠梓區,0462,535,341,876,66,942,1559,60.42%,34.32%,1
高雄市,楠梓區,0463,436,311,747,53,800,1423,56.22%,30.64%,1
高雄市,楠梓區,0464,589,360,949,46,995,1696,58.67%,34.73%,1
高雄市,楠梓區,0465,392,342,734,163,897,1493,60.08%,26.26%,1
高雄市,楠梓區,0466,442,366,808,116,924,1527,60.51%,28.95%,1
高雄市,楠梓區,0467,327,262,589,62,651,1020,63.82%,32.06%,1
高雄市,楠梓區,0468,372,255,627,91,718,1197,59.98%,31.08%,1
高雄市,楠梓區,0469,424,316,740,108,848,1528,55.5%,27.75%,1
高雄市,楠梓區,0470,498,400,898,107,1005,1918,52.4%,25.96%,1
高雄市,楠梓區,0471,432,301,733,109,842,1458,57.75%,29.63%,1
高雄市,楠梓區,0472,600,412,1012,111,1123,1790,62.74%,33.52%,1
高雄市,楠梓區,0473,624,425,1049,98,1147,1845,62.17%,33.82%,1
高雄市,楠梓區,0474,706,460,1166,74,1240,2037,60.87%,34.66%,1
高雄市,楠梓區,0475,633,404,1037,68,1105,1964,56.26%,32.23%,1
高雄市,楠梓區,0476,644,430,1074,46,1120,2006,55.83%,32.1%,1
高雄市,楠梓區,0477,622,425,1047,69,1116,1951,57.2%,31.88%,1
高雄市,楠梓區,0478,628,392,1020,82,1102,1951,56.48%,32.19%,1
高雄市,楠梓區,0479,709,418,1127,82,1209,2008,60.21%,35.31%,1
高雄市,楠梓區,0480,686,372,1058,90,1148,1923,59.7%,35.67%,1
高雄市,楠梓區,0481,697,375,1072,78,1150,1921,59.86%,36.28%,1
高雄市,楠梓區,0482,363,183,546,35,581,832,69.83%,43.63%,1
高雄市,楠梓區,0483,186,292,478,51,529,1156,45.76%,16.09%,1
高雄市,楠梓區,0484,378,267,645,66,711,1125,63.2%,33.6%,1
高雄市,楠梓區,0485,364,248,612,66,678,1060,63.96%,34.34%,1
高雄市,楠梓區,0486,533,317,850,69,919,1502,61.19%,35.49%,1
高雄市,楠梓區,0487,441,316,757,101,858,1404,61.11%,31.41%,1
高雄市,楠梓區,0488,472,283,755,70,825,1552,53.16%,30.41%,1
高雄市,楠梓區,0489,467,303,770,70,840,1460,57.53%,31.99%,1
高雄市,楠梓區,0490,415,248,663,60,723,1315,54.98%,31.56%,1
高雄市,楠梓區,0491,344,248,592,77,669,1062,62.99%,32.39%,1
高雄市,楠梓區,0492,359,236,595,70,665,1078,61.69%,33.3%,1
高雄市,楠梓區,0493,323,208,531,84,615,914,67.29%,35.34%,1
高雄市,楠梓區,0494,369,240,609,100,709,1064,66.64%,34.68%,1
高雄市,楠梓區,0495,583,365,948,94,1042,1705,61.11%,34.19%,1
高雄市,楠梓區,0496,586,390,976,69,1045,1728,60.47%,33.91%,1
高雄市,楠梓區,0497,692,387,1079,77,1156,1917,60.3%,36.1%,1
高雄市,楠梓區,0498,406,292,698,120,818,1439,56.85%,28.21%,1
高雄市,楠梓區,0499,440,300,740,74,814,1287,63.25%,34.19%,1
高雄市,楠梓區,0500,540,337,877,85,962,1504,63.96%,35.9%,1
高雄市,楠梓區,0501,548,297,845,69,914,1405,65.05%,39%,1
高雄市,楠梓區,0502,414,285,699,87,786,1287,61.07%,32.17%,1
高雄市,楠梓區,0503,445,297,742,68,810,1295,62.55%,34.36%,1
高雄市,楠梓區,0504,529,332,861,67,928,1483,62.58%,35.67%,1
高雄市,楠梓區,0505,643,385,1028,68,1096,1649,66.46%,38.99%,1
高雄市,楠梓區,0506,353,234,587,60,647,998,64.83%,35.37%,1
高雄市,楠梓區,0507,365,224,589,80,669,1025,65.27%,35.61%,1
高雄市,楠梓區,0508,654,391,1045,61,1106,1671,66.19%,39.14%,1
高雄市,楠梓區,0509,505,349,854,102,956,1453,65.79%,34.76%,1
高雄市,楠梓區,0510,567,343,910,98,1008,1673,60.25%,33.89%,1
高雄市,楠梓區,0511,582,307,889,70,959,1653,58.02%,35.21%,1
高雄市,楠梓區,0512,341,245,586,57,643,1034,62.19%,32.98%,1
高雄市,楠梓區,0513,433,279,712,65,777,1127,68.94%,38.42%,1
高雄市,楠梓區,0514,507,313,820,98,918,1575,58.29%,32.19%,1
高雄市,楠梓區,0515,514,372,886,74,960,1559,61.58%,32.97%,1
高雄市,楠梓區,0516,430,304,734,76,810,1378,58.78%,31.2%,1
高雄市,楠梓區,0517,556,404,960,88,1048,1714,61.14%,32.44%,1
高雄市,楠梓區,0518,762,198,960,88,1048,1721,60.89%,44.28%,1
高雄市,楠梓區,0519,573,334,907,82,989,1628,60.75%,35.2%,1
高雄市,楠梓區,0520,584,377,961,110,1071,1590,67.36%,36.73%,1
高雄市,楠梓區,0521,559,362,921,75,996,1628,61.18%,34.34%,1
高雄市,楠梓區,0522,631,441,1072,59,1131,1739,65.04%,36.29%,1
高雄市,楠梓區,0523,626,365,991,68,1059,1642,64.49%,38.12%,1
高雄市,楠梓區,0524,564,342,906,75,981,1766,55.55%,31.94%,1
高雄市,楠梓區,0525,508,268,776,82,858,1482,57.89%,34.28%,1
高雄市,楠梓區,0526,549,325,874,42,916,1749,52.37%,31.39%,1
高雄市,楠梓區,0527,541,367,908,62,970,1591,60.97%,34%,1
高雄市,楠梓區,0528,577,370,947,51,998,1545,64.6%,37.35%,1
高雄市,楠梓區,0529,639,385,1024,49,1073,1651,64.99%,38.7%,1
高雄市,楠梓區,0530,591,387,978,65,1043,1646,63.37%,35.91%,1
高雄市,楠梓區,0531,491,384,875,88,963,1496,64.37%,32.82%,1
高雄市,楠梓區,0532,435,271,706,96,802,1403,57.16%,31%,1
高雄市,楠梓區,0533,535,342,877,58,935,1624,57.57%,32.94%,1
高雄市,三民區,0887,578,418,996,95,1091,1893,57.63%,30.53%,1
高雄市,三民區,0888,586,378,964,117,1081,1982,54.54%,29.57%,1
高雄市,三民區,0889,520,359,879,93,972,1661,58.52%,31.31%,1
高雄市,三民區,0890,567,412,979,33,1012,1894,53.43%,29.94%,1
高雄市,三民區,0891,604,376,980,65,1045,1839,56.82%,32.84%,1
高雄市,三民區,0892,642,435,1077,74,1151,2014,57.15%,31.88%,1
高雄市,三民區,0893,573,424,997,124,1121,1897,59.09%,30.21%,1
高雄市,三民區,0894,582,416,998,55,1053,2016,52.23%,28.87%,1
高雄市,三民區,0895,564,426,990,67,1057,1924,54.94%,29.31%,1
高雄市,三民區,0896,577,379,956,77,1033,1749,59.06%,32.99%,1
高雄市,三民區,0897,674,419,1093,77,1170,1845,63.41%,36.53%,1
高雄市,三民區,0898,516,345,861,52,913,1724,52.96%,29.93%,1
高雄市,三民區,0899,628,398,1026,58,1084,1889,57.38%,33.25%,1
高雄市,三民區,0900,530,346,876,77,953,1622,58.75%,32.68%,1
高雄市,三民區,0901,574,456,1030,45,1075,1870,57.49%,30.7%,1
高雄市,三民區,0902,527,366,893,70,963,1523,63.23%,34.6%,1
高雄市,三民區,0903,564,407,971,71,1042,2006,51.94%,28.12%,1
高雄市,三民區,0904,747,488,1235,73,1308,2076,63.01%,35.98%,1
高雄市,三民區,0905,707,440,1147,36,1183,2073,57.07%,34.11%,1
高雄市,三民區,0906,689,447,1136,72,1208,2045,59.07%,33.69%,1
高雄市,三民區,0907,584,359,943,82,1025,2070,49.52%,28.21%,1
高雄市,三民區,0908,638,422,1060,80,1140,2035,56.02%,31.35%,1
高雄市,三民區,0909,767,480,1247,50,1297,2075,62.51%,36.96%,1
高雄市,三民區,0910,737,410,1147,61,1208,2053,58.84%,35.9%,1
高雄市,三民區,0911,739,473,1212,69,1281,2063,62.09%,35.82%,1
高雄市,三民區,0912,804,481,1285,64,1349,2143,62.95%,37.52%,1
高雄市,三民區,0913,549,445,994,93,1087,1746,62.26%,31.44%,1
高雄市,三民區,0914,500,342,842,37,879,1735,50.66%,28.82%,1
高雄市,三民區,0915,503,338,841,72,913,1655,55.17%,30.39%,1
高雄市,三民區,0916,555,323,878,71,949,1583,59.95%,35.06%,1
高雄市,三民區,0917,591,365,956,63,1019,1800,56.61%,32.83%,1
高雄市,三民區,0918,588,378,966,50,1016,1730,58.73%,33.99%,1
高雄市,三民區,0919,536,375,911,49,960,1715,55.98%,31.25%,1
高雄市,三民區,0920,536,406,942,65,1007,1691,59.55%,31.7%,1
高雄市,三民區,0921,649,390,1039,70,1109,1865,59.46%,34.8%,1
高雄市,三民區,0922,367,273,640,55,695,1073,64.77%,34.2%,1
高雄市,三民區,0923,306,258,564,73,637,917,69.47%,33.37%,1
高雄市,三民區,0924,538,386,924,62,986,1647,59.87%,32.67%,1
高雄市,三民區,0925,538,390,928,88,1016,1654,61.43%,32.53%,1
高雄市,三民區,0926,561,394,955,66,1021,1639,62.29%,34.23%,1
高雄市,三民區,0927,601,422,1023,81,1104,1833,60.23%,32.79%,1
高雄市,三民區,0928,508,335,843,47,890,1362,65.35%,37.3%,1
高雄市,三民區,0929,555,357,912,75,987,1557,63.39%,35.65%,1
高雄市,三民區,0930,528,34,562,33,595,1482,40.15%,35.63%,1
高雄市,三民區,0931,523,393,916,69,985,1563,63.02%,33.46%,1
高雄市,三民區,0932,508,362,870,50,920,1497,61.46%,33.93%,1
高雄市,三民區,0933,547,380,927,38,965,1523,63.36%,35.92%,1
高雄市,三民區,0934,483,327,810,56,866,1293,66.98%,37.35%,1
高雄市,三民區,0935,617,373,990,63,1053,1662,63.36%,37.12%,1
高雄市,三民區,0936,400,403,803,60,863,1441,59.89%,27.76%,1
高雄市,三民區,0937,461,372,833,56,889,1326,67.04%,34.77%,1
高雄市,三民區,0938,516,403,919,35,954,1476,64.63%,34.96%,1
高雄市,三民區,0939,595,378,973,35,1008,1968,51.22%,30.23%,1
高雄市,三民區,0940,443,346,789,54,843,1618,52.1%,27.38%,1
高雄市,三民區,0941,678,336,1014,70,1084,1873,57.88%,36.2%,1
高雄市,三民區,0942,447,370,817,79,896,1487,60.26%,30.06%,1
高雄市,三民區,0943,500,366,866,28,894,1640,54.51%,30.49%,1
高雄市,三民區,0944,586,413,999,35,1034,1889,54.74%,31.02%,1
高雄市,三民區,0945,710,304,1014,55,1069,1969,54.29%,36.06%,1
高雄市,三民區,0946,454,316,770,112,882,1466,60.16%,30.97%,1
高雄市,三民區,0947,561,405,966,74,1040,1697,61.28%,33.06%,1
高雄市,三民區,0948,547,386,933,81,1014,1663,60.97%,32.89%,1
高雄市,三民區,0949,504,390,894,70,964,1649,58.46%,30.56%,1
高雄市,三民區,0950,474,319,793,55,848,1486,57.07%,31.9%,1
高雄市,三民區,0951,484,306,790,31,821,1495,54.92%,32.37%,1
高雄市,三民區,0952,590,349,939,33,972,1548,62.79%,38.11%,1
高雄市,三民區,0953,468,336,804,43,847,1493,56.73%,31.35%,1
高雄市,三民區,0954,532,324,856,43,899,1445,62.21%,36.82%,1
高雄市,三民區,0955,564,266,830,47,877,1529,57.36%,36.89%,1
高雄市,三民區,0956,473,354,827,27,854,1506,56.71%,31.41%,1
高雄市,三民區,0957,569,355,924,51,975,1549,62.94%,36.73%,1
高雄市,三民區,0958,584,375,959,74,1033,1620,63.77%,36.05%,1
高雄市,三民區,0959,537,370,907,79,986,1550,63.61%,34.65%,1
高雄市,三民區,0960,507,372,879,61,940,1488,63.17%,34.07%,1
高雄市,三民區,0961,580,293,873,65,938,1335,70.26%,43.45%,1
高雄市,三民區,0962,457,288,745,70,815,1332,61.19%,34.31%,1
高雄市,三民區,0963,559,422,981,96,1077,1764,61.05%,31.69%,1
高雄市,三民區,0964,599,400,999,46,1045,1811,57.7%,33.08%,1
高雄市,三民區,0965,595,415,1010,69,1079,1693,63.73%,35.14%,1
高雄市,三民區,0966,562,436,998,100,1098,1684,65.2%,33.37%,1
高雄市,三民區,0967,486,303,789,65,854,1464,58.33%,33.2%,1
高雄市,三民區,0968,625,433,1058,56,1114,1719,64.81%,36.36%,1
高雄市,三民區,0969,558,403,961,52,1013,1749,57.92%,31.9%,1
高雄市,三民區,0970,629,358,987,53,1040,1908,54.51%,32.97%,1
高雄市,三民區,0971,543,350,893,74,967,1573,61.47%,34.52%,1
高雄市,三民區,0972,513,366,879,54,933,1628,57.31%,31.51%,1
高雄市,三民區,0973,386,268,654,65,719,1377,52.21%,28.03%,1
高雄市,三民區,0974,558,355,913,61,974,1530,63.66%,36.47%,1
高雄市,三民區,0975,333,281,614,64,678,1188,57.07%,28.03%,1
高雄市,三民區,0976,439,336,775,52,827,2791,29.63%,15.73%,1
高雄市,三民區,0977,587,436,1023,73,1096,1840,59.57%,31.9%,1
高雄市,三民區,0978,563,374,937,109,1046,1671,62.6%,33.69%,1
高雄市,三民區,0979,537,378,915,66,981,1624,60.41%,33.07%,1
高雄市,三民區,0980,608,385,993,67,1060,1555,68.17%,39.1%,1
高雄市,三民區,0981,561,365,926,57,983,1489,66.02%,37.68%,1
高雄市,三民區,0982,599,362,961,76,1037,1662,62.39%,36.04%,1
高雄市,三民區,0983,539,357,896,31,927,1639,56.56%,32.89%,1
高雄市,三民區,0984,540,456,996,99,1095,1872,58.49%,28.85%,1
高雄市,三民區,0985,653,422,1075,82,1157,1968,58.79%,33.18%,1
高雄市,三民區,0986,391,266,657,129,786,1471,53.43%,26.58%,1
高雄市,三民區,0987,460,332,792,84,876,1534,57.11%,29.99%,1
高雄市,三民區,0988,481,332,813,94,907,1659,54.67%,28.99%,1
高雄市,三民區,0989,517,350,867,48,915,1815,50.41%,28.48%,1
高雄市,三民區,0990,543,381,924,60,984,1808,54.42%,30.03%,1
高雄市,三民區,0991,373,236,609,47,656,1224,53.59%,30.47%,1
高雄市,三民區,0992,452,293,745,34,779,1406,55.41%,32.15%,1
高雄市,三民區,0993,287,211,498,36,534,945,56.51%,30.37%,1
高雄市,三民區,0994,314,244,558,45,603,944,63.88%,33.26%,1
高雄市,三民區,0995,510,379,889,92,981,1669,58.78%,30.56%,1
高雄市,三民區,0996,457,359,816,100,916,1473,62.19%,31.03%,1
高雄市,三民區,0997,546,342,888,69,957,1876,51.01%,29.1%,1
高雄市,三民區,0998,250,350,600,66,666,1682,39.6%,14.86%,1
高雄市,三民區,0999,543,374,917,53,970,1791,54.16%,30.32%,1
高雄市,三民區,1000,598,421,1019,75,1094,1808,60.51%,33.08%,1
高雄市,三民區,1001,582,341,923,76,999,1798,55.56%,32.37%,1
高雄市,三民區,1002,659,466,1125,80,1205,2030,59.36%,32.46%,1
高雄市,三民區,1003,711,418,1129,36,1165,2034,57.28%,34.96%,1
高雄市,三民區,1004,670,438,1108,48,1156,1998,57.86%,33.53%,1
高雄市,三民區,1005,579,381,960,57,1017,1914,53.13%,30.25%,1
高雄市,三民區,1006,609,416,1025,56,1081,1965,55.01%,30.99%,1
高雄市,三民區,1007,571,426,997,100,1097,1885,58.2%,30.29%,1
高雄市,三民區,1008,433,277,710,21,731,1220,59.92%,35.49%,1
高雄市,三民區,1009,318,231,549,85,634,1057,59.98%,30.09%,1
高雄市,三民區,1010,457,227,684,41,725,1434,50.56%,31.87%,1
高雄市,三民區,1011,373,226,599,53,652,1350,48.3%,27.63%,1
高雄市,三民區,1012,232,166,398,23,421,872,48.28%,26.61%,1
高雄市,三民區,1013,245,216,461,31,492,954,51.57%,25.68%,1
高雄市,三民區,1014,582,354,936,36,972,1689,57.55%,34.46%,1
高雄市,三民區,1015,454,285,739,40,779,1390,56.04%,32.66%,1
高雄市,三民區,1016,438,309,747,85,832,1336,62.28%,32.78%,1
高雄市,三民區,1017,508,376,884,72,956,1437,66.53%,35.35%,1
高雄市,三民區,1018,486,320,806,42,848,1452,58.4%,33.47%,1
高雄市,三民區,1019,494,349,843,99,942,1513,62.26%,32.65%,1
高雄市,三民區,1020,466,381,847,119,966,1467,65.85%,31.77%,1
高雄市,三民區,1021,468,388,856,84,940,1381,68.07%,33.89%,1
高雄市,三民區,1022,347,262,609,55,664,1117,59.44%,31.07%,1
高雄市,三民區,1023,439,370,809,41,850,1327,64.05%,33.08%,1
高雄市,三民區,1024,416,330,746,51,797,1304,61.12%,31.9%,1
高雄市,三民區,1025,401,343,744,47,791,1483,53.34%,27.04%,1
高雄市,三民區,1026,477,373,850,62,912,1473,61.91%,32.38%,1
高雄市,三民區,1027,310,240,550,54,604,980,61.63%,31.63%,1
高雄市,三民區,1028,362,437,799,74,873,1409,61.96%,25.69%,1
高雄市,三民區,1029,374,315,689,66,755,1230,61.38%,30.41%,1
高雄市,三民區,1030,334,287,621,65,686,1024,66.99%,32.62%,1
高雄市,三民區,1031,368,274,642,71,713,1130,63.1%,32.57%,1
高雄市,三民區,1032,541,391,932,50,982,1889,51.99%,28.64%,1
高雄市,三民區,1033,457,324,781,49,830,1427,58.16%,32.03%,1
高雄市,三民區,1034,241,206,447,32,479,791,60.56%,30.47%,1
高雄市,三民區,1035,365,299,664,98,762,1079,70.62%,33.83%,1
高雄市,三民區,1036,451,374,825,79,904,1492,60.59%,30.23%,1
高雄市,三民區,1037,326,260,586,72,658,1020,64.51%,31.96%,1
高雄市,三民區,1038,321,257,578,11,589,1001,58.84%,32.07%,1
高雄市,三民區,1039,508,361,869,55,924,1581,58.44%,32.13%,1
高雄市,三民區,1040,507,254,761,58,819,1471,55.68%,34.47%,1
高雄市,三民區,1041,343,314,657,32,689,1151,59.86%,29.8%,1
高雄市,三民區,1042,454,316,770,73,843,1334,63.19%,34.03%,1
高雄市,三民區,1043,432,285,717,56,773,1275,60.63%,33.88%,1
高雄市,三民區,1044,393,334,727,40,767,1688,45.44%,23.28%,1
高雄市,三民區,1045,385,294,679,39,718,1214,59.14%,31.71%,1
高雄市,三民區,1046,407,291,698,36,734,1149,63.88%,35.42%,1
高雄市,三民區,1047,517,390,907,107,1014,1667,60.83%,31.01%,1
高雄市,三民區,1048,506,380,886,50,936,1786,52.41%,28.33%,1
高雄市,三民區,1049,190,335,525,23,548,896,61.16%,21.21%,1
高雄市,三民區,1050,316,198,514,67,581,925,62.81%,34.16%,1
高雄市,三民區,1051,233,183,416,54,470,684,68.71%,34.06%,1
高雄市,三民區,1052,333,247,580,75,655,981,66.77%,33.94%,1
高雄市,三民區,1053,382,300,682,85,767,1383,55.46%,27.62%,1
高雄市,三民區,1054,422,323,745,62,807,1382,58.39%,30.54%,1
高雄市,三民區,1055,252,174,426,41,467,808,57.8%,31.19%,1
高雄市,三民區,1056,377,307,684,33,717,1197,59.9%,31.5%,1
高雄市,三民區,1057,410,300,710,65,775,1344,57.66%,30.51%,1
高雄市,三民區,1058,420,339,759,65,824,1344,61.31%,31.25%,1
高雄市,三民區,1059,458,321,779,32,811,1359,59.68%,33.7%,1
高雄市,三民區,1060,347,271,618,67,685,1073,63.84%,32.34%,1
高雄市,三民區,1061,344,270,614,61,675,1186,56.91%,29.01%,1
高雄市,三民區,1062,567,396,963,80,1043,1749,59.63%,32.42%,1
高雄市,三民區,1063,235,197,432,23,455,877,51.88%,26.8%,1
高雄市,三民區,1064,467,327,794,119,913,1402,65.12%,33.31%,1
高雄市,三民區,1065,260,208,468,26,494,769,64.24%,33.81%,1
高雄市,三民區,1066,422,265,687,66,753,1207,62.39%,34.96%,1
高雄市,三民區,1067,354,245,599,55,654,1270,51.5%,27.87%,1
高雄市,三民區,1068,402,257,659,64,723,1248,57.93%,32.21%,1
高雄市,三民區,1069,419,257,676,108,784,1263,62.07%,33.17%,1
高雄市,三民區,1070,348,256,604,38,642,1101,58.31%,31.61%,1
高雄市,三民區,1071,384,258,642,36,678,1116,60.75%,34.41%,1
高雄市,三民區,1072,379,276,655,40,695,1152,60.33%,32.9%,1
高雄市,三民區,1073,344,250,594,73,667,1057,63.1%,32.54%,1
高雄市,三民區,1074,289,190,479,55,534,971,54.99%,29.76%,1
高雄市,三民區,1075,305,253,558,35,593,1062,55.84%,28.72%,1
高雄市,新興區,1098,284,182,466,26,492,828,59.42%,34.3%,1
高雄市,新興區,1099,339,240,579,58,637,963,66.15%,35.2%,1
高雄市,新興區,1100,309,242,551,33,584,1075,54.33%,28.74%,1
高雄市,新興區,1101,505,329,834,38,872,1488,58.6%,33.94%,1
高雄市,新興區,1102,455,362,817,40,857,1438,59.6%,31.64%,1
高雄市,新興區,1103,348,264,612,38,650,1049,61.96%,33.17%,1
高雄市,新興區,1104,446,402,848,73,921,1378,66.84%,32.37%,1
高雄市,新興區,1105,236,161,397,41,438,666,65.77%,35.44%,1
高雄市,新興區,1106,308,241,549,30,579,981,59.02%,31.4%,1
高雄市,新興區,1107,294,274,568,41,609,933,65.27%,31.51%,1
高雄市,新興區,1108,306,242,548,28,576,987,58.36%,31%,1
高雄市,新興區,1109,355,224,579,42,621,988,62.85%,35.93%,1
高雄市,新興區,1110,255,188,443,42,485,735,65.99%,34.69%,1
高雄市,新興區,1111,422,336,758,33,791,1317,60.06%,32.04%,1
高雄市,新興區,1112,231,179,410,21,431,800,53.87%,28.88%,1
高雄市,新興區,1113,314,253,567,44,611,968,63.12%,32.44%,1
高雄市,新興區,1114,307,217,524,39,563,913,61.66%,33.63%,1
高雄市,新興區,1115,477,371,848,30,878,1389,63.21%,34.34%,1
高雄市,新興區,1116,435,336,771,56,827,1228,67.35%,35.42%,1
高雄市,新興區,1117,407,285,692,79,771,1211,63.67%,33.61%,1
高雄市,新興區,1118,380,246,626,26,652,1101,59.22%,34.51%,1
高雄市,新興區,1119,265,184,449,25,474,752,63.03%,35.24%,1
高雄市,新興區,1120,318,252,570,50,620,873,71.02%,36.43%,1
高雄市,新興區,1121,489,436,925,59,984,1609,61.16%,30.39%,1
高雄市,新興區,1122,574,456,1030,67,1097,1736,63.19%,33.06%,1
高雄市,新興區,1123,429,264,693,27,720,1258,57.23%,34.1%,1
高雄市,新興區,1124,362,269,631,59,690,1105,62.44%,32.76%,1
高雄市,新興區,1125,289,193,482,52,534,851,62.75%,33.96%,1
高雄市,新興區,1126,327,257,584,53,637,1011,63.01%,32.34%,1
高雄市,新興區,1127,285,260,545,76,621,888,69.93%,32.09%,1
高雄市,新興區,1128,295,253,548,29,577,1005,57.41%,29.35%,1
高雄市,新興區,1129,350,242,592,16,608,1375,44.22%,25.45%,1
高雄市,新興區,1130,449,343,792,65,857,1388,61.74%,32.35%,1
高雄市,新興區,1131,230,154,384,50,434,719,60.36%,31.99%,1
高雄市,新興區,1132,335,239,574,76,650,1077,60.35%,31.1%,1
高雄市,新興區,1133,221,196,417,18,435,875,49.71%,25.26%,1
高雄市,新興區,1134,274,211,485,25,510,936,54.49%,29.27%,1
高雄市,新興區,1135,289,215,504,57,561,944,59.43%,30.61%,1
高雄市,新興區,1136,232,185,417,33,450,833,54.02%,27.85%,1
高雄市,新興區,1137,222,182,404,19,423,708,59.75%,31.36%,1
高雄市,新興區,1138,250,154,404,22,426,741,57.49%,33.74%,1
高雄市,新興區,1139,315,288,603,37,640,1235,51.82%,25.51%,1
高雄市,前金區,1076,187,159,346,17,363,673,53.94%,27.79%,1
高雄市,前金區,1077,366,228,594,34,628,1022,61.45%,35.81%,1
高雄市,前金區,1078,401,284,685,44,729,1324,55.06%,30.29%,1
高雄市,前金區,1079,272,190,462,48,510,839,60.79%,32.42%,1
高雄市,前金區,1080,293,229,522,77,599,975,61.44%,30.05%,1
高雄市,前金區,1081,620,383,1003,65,1068,1806,59.14%,34.33%,1
高雄市,前金區,1082,587,416,1003,46,1049,1781,58.9%,32.96%,1
高雄市,前金區,1083,220,194,414,39,453,717,63.18%,30.68%,1
高雄市,前金區,1084,334,263,597,27,624,1097,56.88%,30.45%,1
高雄市,前金區,1085,542,360,902,41,943,1633,57.75%,33.19%,1
高雄市,前金區,1086,267,215,482,39,521,759,68.64%,35.18%,1
高雄市,前金區,1087,317,257,574,57,631,948,66.56%,33.44%,1
高雄市,前金區,1088,276,216,492,72,564,1009,55.9%,27.35%,1
高雄市,前金區,1089,293,236,529,46,575,945,60.85%,31.01%,1
高雄市,前金區,1090,278,175,453,24,477,772,61.79%,36.01%,1
高雄市,前金區,1091,249,207,456,34,490,757,64.73%,32.89%,1
高雄市,前金區,1092,381,242,623,39,662,1047,63.23%,36.39%,1
高雄市,前金區,1093,316,263,579,50,629,985,63.86%,32.08%,1
高雄市,前金區,1094,540,348,888,29,917,1674,54.78%,32.26%,1
高雄市,前金區,1095,326,262,588,43,631,1088,58%,29.96%,1
高雄市,前金區,1096,306,239,545,58,603,893,67.53%,34.27%,1
高雄市,前金區,1097,364,276,640,46,686,1184,57.94%,30.74%,1
高雄市,苓雅區,1140,240,189,429,29,458,718,63.79%,33.43%,1
高雄市,苓雅區,1141,471,335,806,53,859,1492,57.57%,31.57%,1
高雄市,苓雅區,1142,399,273,672,60,732,1210,60.5%,32.98%,1
高雄市,苓雅區,1143,442,340,782,32,814,1617,50.34%,27.33%,1
高雄市,苓雅區,1144,463,331,794,94,888,1428,62.18%,32.42%,1
高雄市,苓雅區,1145,495,196,691,53,744,1444,51.52%,34.28%,1
高雄市,苓雅區,1146,434,340,774,76,850,1452,58.54%,29.89%,1
高雄市,苓雅區,1147,185,135,320,39,359,554,64.8%,33.39%,1
高雄市,苓雅區,1148,296,217,513,23,536,950,56.42%,31.16%,1
高雄市,苓雅區,1149,278,226,504,25,529,978,54.09%,28.43%,1
高雄市,苓雅區,1150,500,300,800,62,862,1673,51.52%,29.89%,1
高雄市,苓雅區,1151,600,424,1024,64,1088,2045,53.2%,29.34%,1
高雄市,苓雅區,1152,331,191,522,67,589,939,62.73%,35.25%,1
高雄市,苓雅區,1153,357,301,658,43,701,1284,54.6%,27.8%,1
高雄市,苓雅區,1154,318,197,515,34,549,908,60.46%,35.02%,1
高雄市,苓雅區,1155,251,201,452,18,470,838,56.09%,29.95%,1
高雄市,苓雅區,1156,394,323,717,44,761,1267,60.06%,31.1%,1
高雄市,苓雅區,1157,354,239,593,62,655,994,65.9%,35.61%,1
高雄市,苓雅區,1158,206,192,398,19,417,774,53.88%,26.61%,1
高雄市,苓雅區,1159,373,269,642,32,674,1121,60.12%,33.27%,1
高雄市,苓雅區,1160,462,351,813,63,876,1474,59.43%,31.34%,1
高雄市,苓雅區,1161,512,350,862,77,939,1525,61.57%,33.57%,1
高雄市,苓雅區,1162,381,249,630,38,668,1147,58.24%,33.22%,1
高雄市,苓雅區,1163,258,262,520,44,564,1014,55.62%,25.44%,1
高雄市,苓雅區,1164,467,400,867,47,914,1496,61.1%,31.22%,1
高雄市,苓雅區,1165,603,275,878,69,947,1499,63.18%,40.23%,1
高雄市,苓雅區,1166,394,285,679,28,707,1138,62.13%,34.62%,1
高雄市,苓雅區,1167,309,232,541,43,584,839,69.61%,36.83%,1
高雄市,苓雅區,1168,387,307,694,45,739,2088,35.39%,18.53%,1
高雄市,苓雅區,1169,550,397,947,40,987,1648,59.89%,33.37%,1
高雄市,苓雅區,1170,534,357,891,67,958,1623,59.03%,32.9%,1
高雄市,苓雅區,1171,693,485,1178,61,1239,1932,64.13%,35.87%,1
高雄市,苓雅區,1172,448,298,746,27,773,1127,68.59%,39.75%,1
高雄市,苓雅區,1173,443,321,764,26,790,1156,68.34%,38.32%,1
高雄市,苓雅區,1174,481,391,872,41,913,1465,62.32%,32.83%,1
高雄市,苓雅區,1175,219,128,347,20,367,690,53.19%,31.74%,1
高雄市,苓雅區,1176,358,285,643,99,742,1283,57.83%,27.9%,1
高雄市,苓雅區,1177,459,341,800,81,881,1432,61.52%,32.05%,1
高雄市,苓雅區,1178,440,306,746,36,782,1313,59.56%,33.51%,1
高雄市,苓雅區,1179,442,364,806,35,841,1579,53.26%,27.99%,1
高雄市,苓雅區,1180,438,340,778,67,845,1385,61.01%,31.62%,1
高雄市,苓雅區,1181,508,336,844,67,911,1449,62.87%,35.06%,1
高雄市,苓雅區,1182,679,422,1101,63,1164,1834,63.47%,37.02%,1
高雄市,苓雅區,1183,498,348,846,61,907,1436,63.16%,34.68%,1
高雄市,苓雅區,1184,616,250,866,56,922,1431,64.43%,43.05%,1
高雄市,苓雅區,1185,460,320,780,29,809,1248,64.82%,36.86%,1
高雄市,苓雅區,1186,555,337,892,47,939,1470,63.88%,37.76%,1
高雄市,苓雅區,1187,585,358,943,82,1025,1540,66.56%,37.99%,1
高雄市,苓雅區,1188,475,368,843,29,872,1374,63.46%,34.57%,1
高雄市,苓雅區,1189,293,233,526,30,556,839,66.27%,34.92%,1
高雄市,苓雅區,1190,382,274,656,44,700,1022,68.49%,37.38%,1
高雄市,苓雅區,1191,411,253,664,15,679,1062,63.94%,38.7%,1
高雄市,苓雅區,1192,401,241,642,27,669,1078,62.06%,37.2%,1
高雄市,苓雅區,1193,386,288,674,41,715,1117,64.01%,34.56%,1
高雄市,苓雅區,1194,544,347,891,49,940,1516,62.01%,35.88%,1
高雄市,苓雅區,1195,409,362,771,120,891,1440,61.88%,28.4%,1
高雄市,苓雅區,1196,266,211,477,38,515,839,61.38%,31.7%,1
高雄市,苓雅區,1197,265,204,469,23,492,888,55.41%,29.84%,1
高雄市,苓雅區,1198,370,309,679,30,709,1101,64.4%,33.61%,1
高雄市,苓雅區,1199,358,297,655,62,717,1004,71.41%,35.66%,1
高雄市,苓雅區,1200,476,346,822,57,879,1427,61.6%,33.36%,1
高雄市,苓雅區,1201,405,267,672,30,702,1168,60.1%,34.67%,1
高雄市,苓雅區,1202,424,308,732,66,798,1184,67.4%,35.81%,1
高雄市,苓雅區,1203,347,249,596,39,635,974,65.2%,35.63%,1
高雄市,苓雅區,1204,265,174,439,17,456,849,53.71%,31.21%,1
高雄市,苓雅區,1205,607,434,1041,67,1108,1821,60.85%,33.33%,1
高雄市,苓雅區,1206,395,289,684,58,742,1306,56.81%,30.25%,1
高雄市,苓雅區,1207,413,302,715,27,742,1185,62.62%,34.85%,1
高雄市,苓雅區,1208,474,322,796,53,849,1415,60%,33.5%,1
高雄市,苓雅區,1209,348,258,606,36,642,962,66.74%,36.17%,1
高雄市,苓雅區,1210,300,232,532,59,591,964,61.31%,31.12%,1
高雄市,苓雅區,1211,552,347,899,34,933,1524,61.22%,36.22%,1
高雄市,苓雅區,1212,469,374,843,36,879,1455,60.41%,32.23%,1
高雄市,苓雅區,1213,358,275,633,48,681,1272,53.54%,28.14%,1
高雄市,苓雅區,1214,370,295,665,23,688,1256,54.78%,29.46%,1
高雄市,苓雅區,1215,376,263,639,31,670,1203,55.69%,31.26%,1
高雄市,苓雅區,1216,391,240,631,24,655,1062,61.68%,36.82%,1
高雄市,苓雅區,1217,282,221,503,59,562,850,66.12%,33.18%,1
高雄市,苓雅區,1218,340,269,609,81,690,1010,68.32%,33.66%,1
高雄市,苓雅區,1219,365,240,605,32,637,1118,56.98%,32.65%,1
高雄市,苓雅區,1220,318,222,540,55,595,937,63.5%,33.94%,1
高雄市,苓雅區,1221,405,319,724,31,755,1493,50.57%,27.13%,1
高雄市,苓雅區,1222,445,233,678,36,714,1183,60.36%,37.62%,1
高雄市,苓雅區,1223,383,245,628,39,667,1318,50.61%,29.06%,1
高雄市,苓雅區,1224,456,295,751,53,804,1362,59.03%,33.48%,1
高雄市,苓雅區,1225,326,273,599,75,674,1102,61.16%,29.58%,1
高雄市,苓雅區,1226,473,342,815,62,877,1481,59.22%,31.94%,1
高雄市,苓雅區,1227,297,230,527,53,580,878,66.06%,33.83%,1
高雄市,苓雅區,1228,268,182,450,27,477,908,52.53%,29.52%,1
高雄市,苓雅區,1229,395,233,628,61,689,1056,65.25%,37.41%,1
高雄市,苓雅區,1230,326,237,563,34,597,1091,54.72%,29.88%,1
高雄市,苓雅區,1231,335,260,595,26,621,976,63.63%,34.32%,1
高雄市,苓雅區,1232,370,293,663,47,710,1063,66.79%,34.81%,1
高雄市,苓雅區,1233,520,359,879,68,947,1484,63.81%,35.04%,1
高雄市,苓雅區,1234,398,350,748,42,790,1290,61.24%,30.85%,1
高雄市,苓雅區,1235,624,395,1019,63,1082,1740,62.18%,35.86%,1
高雄市,苓雅區,1236,511,382,893,66,959,1594,60.16%,32.06%,1
高雄市,苓雅區,1237,560,348,908,32,940,1648,57.04%,33.98%,1
高雄市,苓雅區,1238,475,270,745,59,804,1236,65.05%,38.43%,1
高雄市,苓雅區,1239,404,303,707,48,755,1211,62.35%,33.36%,1
高雄市,苓雅區,1240,414,297,711,30,741,1283,57.76%,32.27%,1
高雄市,苓雅區,1241,644,410,1054,85,1139,1804,63.14%,35.7%,1
高雄市,苓雅區,1242,609,392,1001,76,1077,1718,62.69%,35.45%,1
高雄市,苓雅區,1243,452,315,767,59,826,1297,63.69%,34.85%,1
高雄市,苓雅區,1244,466,349,815,81,896,1449,61.84%,32.16%,1
高雄市,苓雅區,1245,441,296,737,43,780,1307,59.68%,33.74%,1
高雄市,苓雅區,1246,411,282,693,61,754,1184,63.68%,34.71%,1
高雄市,苓雅區,1247,447,315,762,82,844,1250,67.52%,35.76%,1
高雄市,苓雅區,1248,267,424,691,36,727,1248,58.25%,21.39%,1
高雄市,苓雅區,1249,426,316,742,22,764,1283,59.55%,33.2%,1
高雄市,苓雅區,1250,370,280,650,30,680,1121,60.66%,33.01%,1
高雄市,苓雅區,1251,419,299,718,29,747,1258,59.38%,33.31%,1
高雄市,苓雅區,1252,452,334,786,40,826,1339,61.69%,33.76%,1
高雄市,苓雅區,1253,586,481,1067,58,1125,1986,56.65%,29.51%,1
高雄市,苓雅區,1254,347,217,564,33,597,1028,58.07%,33.75%,1
高雄市,苓雅區,1255,310,244,554,21,575,948,60.65%,32.7%,1
高雄市,前鎮區,1484,491,383,874,126,1000,1809,55.28%,27.14%,1
高雄市,前鎮區,1485,507,403,910,83,993,1835,54.11%,27.63%,1
高雄市,前鎮區,1486,439,318,757,78,835,1890,44.18%,23.23%,1
高雄市,前鎮區,1487,519,409,928,63,991,2013,49.23%,25.78%,1
高雄市,前鎮區,1488,506,363,869,81,950,1776,53.49%,28.49%,1
高雄市,前鎮區,1489,429,327,756,87,843,1705,49.44%,25.16%,1
高雄市,前鎮區,1490,203,140,343,79,422,672,62.8%,30.21%,1
高雄市,前鎮區,1491,461,303,764,85,849,1726,49.19%,26.71%,1
高雄市,前鎮區,1492,475,377,852,50,902,1597,56.48%,29.74%,1
高雄市,前鎮區,1493,540,370,910,96,1006,1690,59.53%,31.95%,1
高雄市,前鎮區,1494,363,250,613,77,690,1080,63.89%,33.61%,1
高雄市,前鎮區,1495,410,280,690,82,772,1159,66.61%,35.38%,1
高雄市,前鎮區,1496,396,242,638,81,719,1314,54.72%,30.14%,1
高雄市,前鎮區,1497,306,188,494,68,562,896,62.72%,34.15%,1
高雄市,前鎮區,1498,312,234,546,49,595,1002,59.38%,31.14%,1
高雄市,前鎮區,1499,573,373,946,121,1067,2765,38.59%,20.72%,1
高雄市,前鎮區,1500,186,129,315,63,378,600,63%,31%,1
高雄市,前鎮區,1501,266,217,483,45,528,1466,36.02%,18.14%,1
高雄市,前鎮區,1502,408,312,720,56,776,1449,53.55%,28.16%,1
高雄市,前鎮區,1503,299,184,483,65,548,991,55.3%,30.17%,1
高雄市,前鎮區,1504,412,260,672,86,758,1248,60.74%,33.01%,1
高雄市,前鎮區,1505,359,211,570,108,678,1066,63.6%,33.68%,1
高雄市,前鎮區,1506,185,115,300,39,339,706,48.02%,26.2%,1
高雄市,前鎮區,1507,189,151,340,33,373,713,52.31%,26.51%,1
高雄市,前鎮區,1508,370,281,651,47,698,1344,51.93%,27.53%,1
高雄市,前鎮區,1509,244,219,463,61,524,856,61.21%,28.5%,1
高雄市,前鎮區,1510,223,186,409,49,458,873,52.46%,25.54%,1
高雄市,前鎮區,1511,296,224,520,54,574,1114,51.53%,26.57%,1
高雄市,前鎮區,1512,260,240,500,14,514,1112,46.22%,23.38%,1
高雄市,前鎮區,1513,292,232,524,68,592,1044,56.7%,27.97%,1
高雄市,前鎮區,1514,258,220,478,40,518,940,55.11%,27.45%,1
高雄市,前鎮區,1515,353,270,623,83,706,1342,52.61%,26.3%,1
高雄市,前鎮區,1516,518,350,868,60,928,1402,66.19%,36.95%,1
高雄市,前鎮區,1517,453,314,767,44,811,1320,61.44%,34.32%,1
高雄市,前鎮區,1518,293,221,514,62,576,958,60.13%,30.58%,1
高雄市,前鎮區,1519,460,360,820,51,871,1276,68.26%,36.05%,1
高雄市,前鎮區,1520,495,322,817,98,915,1459,62.71%,33.93%,1
高雄市,前鎮區,1521,200,142,342,30,372,761,48.88%,26.28%,1
高雄市,前鎮區,1522,309,228,537,28,565,1093,51.69%,28.27%,1
高雄市,前鎮區,1523,638,273,911,55,966,1521,63.51%,41.95%,1
高雄市,前鎮區,1524,638,284,922,40,962,1557,61.79%,40.98%,1
高雄市,前鎮區,1525,580,368,948,35,983,1821,53.98%,31.85%,1
高雄市,前鎮區,1526,476,212,688,49,737,1066,69.14%,44.65%,1
高雄市,前鎮區,1527,438,218,656,24,680,1046,65.01%,41.87%,1
高雄市,前鎮區,1528,538,388,926,72,998,1709,58.4%,31.48%,1
高雄市,前鎮區,1529,573,394,967,97,1064,1723,61.75%,33.26%,1
高雄市,前鎮區,1530,438,297,735,51,786,1202,65.39%,36.44%,1
高雄市,前鎮區,1531,476,324,800,44,844,1279,65.99%,37.22%,1
高雄市,前鎮區,1532,596,336,932,48,980,1513,64.77%,39.39%,1
高雄市,前鎮區,1533,416,277,693,26,719,1260,57.06%,33.02%,1
高雄市,前鎮區,1534,418,246,664,91,755,1139,66.29%,36.7%,1
高雄市,前鎮區,1535,436,274,710,53,763,1140,66.93%,38.25%,1
高雄市,前鎮區,1536,477,353,830,97,927,1462,63.41%,32.63%,1
高雄市,前鎮區,1537,483,324,807,44,851,1359,62.62%,35.54%,1
高雄市,前鎮區,1538,535,442,977,83,1060,2037,52.04%,26.26%,1
高雄市,前鎮區,1539,458,285,743,30,773,1410,54.82%,32.48%,1
高雄市,前鎮區,1540,429,275,704,30,734,1307,56.16%,32.82%,1
高雄市,前鎮區,1541,459,339,798,87,885,1512,58.53%,30.36%,1
高雄市,前鎮區,1542,450,374,824,92,916,1491,61.44%,30.18%,1
高雄市,前鎮區,1543,519,332,851,98,949,1621,58.54%,32.02%,1
高雄市,前鎮區,1544,443,298,741,71,812,1522,53.35%,29.11%,1
高雄市,前鎮區,1545,507,373,880,70,950,1593,59.64%,31.83%,1
高雄市,前鎮區,1546,642,416,1058,95,1153,1885,61.17%,34.06%,1
高雄市,前鎮區,1547,626,450,1076,92,1168,1870,62.46%,33.48%,1
高雄市,前鎮區,1548,496,292,788,33,821,1388,59.15%,35.73%,1
高雄市,前鎮區,1549,462,286,748,68,816,1348,60.53%,34.27%,1
高雄市,前鎮區,1550,388,274,662,110,772,1341,57.57%,28.93%,1
高雄市,前鎮區,1551,460,365,825,52,877,1364,64.3%,33.72%,1
高雄市,前鎮區,1552,463,279,742,88,830,1367,60.72%,33.87%,1
高雄市,前鎮區,1553,409,289,698,85,783,1326,59.05%,30.84%,1
高雄市,前鎮區,1554,331,245,576,43,619,1059,58.45%,31.26%,1
高雄市,前鎮區,1555,379,272,651,24,675,1119,60.32%,33.87%,1
高雄市,前鎮區,1556,479,321,800,48,848,1565,54.19%,30.61%,1
高雄市,前鎮區,1557,488,343,831,69,900,1549,58.1%,31.5%,1
高雄市,前鎮區,1558,650,403,1053,49,1102,1691,65.17%,38.44%,1
高雄市,前鎮區,1559,667,398,1065,42,1107,1837,60.26%,36.31%,1
高雄市,前鎮區,1560,378,284,662,22,684,1092,62.64%,34.62%,1
高雄市,前鎮區,1561,387,259,646,60,706,1126,62.7%,34.37%,1
高雄市,前鎮區,1562,366,257,623,80,703,1215,57.86%,30.12%,1
高雄市,前鎮區,1563,465,344,809,46,855,1443,59.25%,32.22%,1
高雄市,前鎮區,1564,578,351,929,37,966,1448,66.71%,39.92%,1
高雄市,前鎮區,1565,555,385,940,73,1013,1648,61.47%,33.68%,1
高雄市,前鎮區,1566,469,352,821,86,907,1603,56.58%,29.26%,1
高雄市,前鎮區,1567,448,320,768,29,797,1596,49.94%,28.07%,1
高雄市,前鎮區,1568,422,263,685,41,726,1450,50.07%,29.1%,1
高雄市,前鎮區,1569,458,287,745,98,843,1510,55.83%,30.33%,1
高雄市,前鎮區,1570,536,405,941,96,1037,1647,62.96%,32.54%,1
高雄市,前鎮區,1571,430,275,705,69,774,1342,57.68%,32.04%,1
高雄市,前鎮區,1572,430,266,696,53,749,1384,54.12%,31.07%,1
高雄市,前鎮區,1573,424,319,743,80,823,1479,55.65%,28.67%,1
高雄市,前鎮區,1574,497,323,820,45,865,1546,55.95%,32.15%,1
高雄市,前鎮區,1575,562,345,907,61,968,1595,60.69%,35.24%,1
高雄市,前鎮區,1576,421,262,683,61,744,1201,61.95%,35.05%,1
高雄市,前鎮區,1577,315,236,551,33,584,1082,53.97%,29.11%,1
高雄市,前鎮區,1578,313,186,499,41,540,996,54.22%,31.43%,1
高雄市,前鎮區,1579,292,211,503,77,580,932,62.23%,31.33%,1
高雄市,前鎮區,1580,359,284,643,47,690,1146,60.21%,31.33%,1
高雄市,前鎮區,1581,395,225,620,37,657,1096,59.95%,36.04%,1
高雄市,前鎮區,1582,505,301,806,24,830,1332,62.31%,37.91%,1
高雄市,前鎮區,1583,384,247,631,53,684,1175,58.21%,32.68%,1
高雄市,前鎮區,1584,309,225,534,65,599,986,60.75%,31.34%,1
高雄市,前鎮區,1585,409,342,751,75,826,1316,62.77%,31.08%,1
高雄市,前鎮區,1586,438,310,748,76,824,1559,52.85%,28.09%,1
高雄市,前鎮區,1587,510,392,902,89,991,1622,61.1%,31.44%,1
高雄市,前鎮區,1588,391,290,681,39,720,1310,54.96%,29.85%,1
高雄市,前鎮區,1589,398,288,686,100,786,1299,60.51%,30.64%,1
高雄市,前鎮區,1590,429,292,721,73,794,1191,66.67%,36.02%,1
高雄市,前鎮區,1591,427,257,684,41,725,1375,52.73%,31.05%,1
高雄市,前鎮區,1592,435,298,733,40,773,1338,57.77%,32.51%,1
高雄市,前鎮區,1593,339,262,601,48,649,1175,55.23%,28.85%,1
高雄市,前鎮區,1594,415,299,714,35,749,1357,55.2%,30.58%,1
高雄市,前鎮區,1595,412,300,712,71,783,1187,65.96%,34.71%,1
高雄市,前鎮區,1596,365,253,618,52,670,1164,57.56%,31.36%,1
高雄市,前鎮區,1597,403,301,704,73,777,1219,63.74%,33.06%,1
高雄市,前鎮區,1598,464,293,757,21,778,1428,54.48%,32.49%,1
高雄市,前鎮區,1599,469,311,780,100,880,1495,58.86%,31.37%,1
高雄市,前鎮區,1600,535,338,873,41,914,1531,59.7%,34.94%,1
高雄市,前鎮區,1601,479,367,846,77,923,1509,61.17%,31.74%,1
高雄市,前鎮區,1602,479,353,832,78,910,1591,57.2%,30.11%,1
高雄市,旗津區,0869,325,283,608,125,733,1177,62.28%,27.61%,1
高雄市,旗津區,0870,281,203,484,61,545,1109,49.14%,25.34%,1
高雄市,旗津區,0871,404,300,704,31,735,1642,44.76%,24.6%,1
高雄市,旗津區,0872,302,239,541,115,656,1209,54.26%,24.98%,1
高雄市,旗津區,0873,256,209,465,65,530,1112,47.66%,23.02%,1
高雄市,旗津區,0874,417,328,745,107,852,1483,57.45%,28.12%,1
高雄市,旗津區,0875,368,249,617,41,658,1460,45.07%,25.21%,1
高雄市,旗津區,0876,458,341,799,173,972,1572,61.83%,29.13%,1
高雄市,旗津區,0877,368,230,598,37,635,1384,45.88%,26.59%,1
高雄市,旗津區,0878,333,252,585,50,635,1390,45.68%,23.96%,1
高雄市,旗津區,0879,307,234,541,69,610,1239,49.23%,24.78%,1
高雄市,旗津區,0880,486,416,902,148,1050,2045,51.34%,23.77%,1
高雄市,旗津區,0881,206,185,391,28,419,893,46.92%,23.07%,1
高雄市,旗津區,0882,551,290,841,132,973,1866,52.14%,29.53%,1
高雄市,旗津區,0883,391,319,710,51,761,1874,40.61%,20.86%,1
高雄市,旗津區,0884,203,189,392,66,458,893,51.29%,22.73%,1
高雄市,旗津區,0885,322,277,599,45,644,1215,53%,26.5%,1
高雄市,旗津區,0886,353,212,565,50,615,1297,47.42%,27.22%,1
高雄市,小港區,1603,392,276,668,41,709,1108,63.99%,35.38%,1
高雄市,小港區,1604,378,260,638,79,717,1171,61.23%,32.28%,1
高雄市,小港區,1605,585,364,949,29,978,1557,62.81%,37.57%,1
高雄市,小港區,1606,467,358,825,31,856,1668,51.32%,28%,1
高雄市,小港區,1607,431,255,686,40,726,1183,61.37%,36.43%,1
高雄市,小港區,1608,452,302,754,33,787,1372,57.36%,32.94%,1
高雄市,小港區,1609,591,377,968,80,1048,1737,60.33%,34.02%,1
高雄市,小港區,1610,449,365,814,88,902,1586,56.87%,28.31%,1
高雄市,小港區,1611,485,283,768,81,849,1558,54.49%,31.13%,1
高雄市,小港區,1612,494,294,788,69,857,1284,66.74%,38.47%,1
高雄市,小港區,1613,408,311,719,60,779,1249,62.37%,32.67%,1
高雄市,小港區,1614,644,381,1025,112,1137,2400,47.38%,26.83%,1
高雄市,小港區,1615,369,305,674,44,718,1181,60.8%,31.24%,1
高雄市,小港區,1616,365,218,583,36,619,1079,57.37%,33.83%,1
高雄市,小港區,1617,400,329,729,57,786,1335,58.88%,29.96%,1
高雄市,小港區,1618,408,286,694,74,768,1241,61.89%,32.88%,1
高雄市,小港區,1619,501,322,823,72,895,1513,59.15%,33.11%,1
高雄市,小港區,1620,454,299,753,79,832,1349,61.68%,33.65%,1
高雄市,小港區,1621,445,335,780,53,833,1483,56.17%,30.01%,1
高雄市,小港區,1622,480,323,803,39,842,1451,58.03%,33.08%,1
高雄市,小港區,1623,379,260,639,32,671,1241,54.07%,30.54%,1
高雄市,小港區,1624,443,326,769,77,846,1262,67.04%,35.1%,1
高雄市,小港區,1625,578,417,995,109,1104,1813,60.89%,31.88%,1
高雄市,小港區,1626,537,345,882,50,932,1877,49.65%,28.61%,1
高雄市,小港區,1627,444,314,758,27,785,1391,56.43%,31.92%,1
高雄市,小港區,1628,488,339,827,50,877,1453,60.36%,33.59%,1
高雄市,小港區,1629,406,430,836,47,883,1374,64.26%,29.55%,1
高雄市,小港區,1630,434,295,729,61,790,1348,58.61%,32.2%,1
高雄市,小港區,1631,500,271,771,64,835,1334,62.59%,37.48%,1
高雄市,小港區,1632,452,322,774,39,813,1433,56.73%,31.54%,1
高雄市,小港區,1633,420,285,705,31,736,1448,50.83%,29.01%,1
高雄市,小港區,1634,524,336,860,92,952,1488,63.98%,35.22%,1
高雄市,小港區,1635,424,288,712,77,789,1278,61.74%,33.18%,1
高雄市,小港區,1636,486,320,806,61,867,1306,66.39%,37.21%,1
高雄市,小港區,1637,516,362,878,95,973,1625,59.88%,31.75%,1
高雄市,小港區,1638,563,394,957,89,1046,1640,63.78%,34.33%,1
高雄市,小港區,1639,515,300,815,59,874,1506,58.03%,34.2%,1
高雄市,小港區,1640,468,269,737,62,799,1438,55.56%,32.55%,1
高雄市,小港區,1641,424,271,695,45,740,1105,66.97%,38.37%,1
高雄市,小港區,1642,395,223,618,28,646,1167,55.36%,33.85%,1
高雄市,小港區,1643,528,309,837,37,874,1420,61.55%,37.18%,1
高雄市,小港區,1644,548,299,847,60,907,1380,65.72%,39.71%,1
高雄市,小港區,1645,432,253,685,34,719,1239,58.03%,34.87%,1
高雄市,小港區,1646,702,188,890,80,970,1563,62.06%,44.91%,1
高雄市,小港區,1647,455,447,902,81,983,1644,59.79%,27.68%,1
高雄市,小港區,1648,602,396,998,87,1085,1895,57.26%,31.77%,1
高雄市,小港區,1649,549,343,892,109,1001,1748,57.27%,31.41%,1
高雄市,小港區,1650,490,398,888,86,974,1579,61.68%,31.03%,1
高雄市,小港區,1651,649,467,1116,53,1169,2135,54.75%,30.4%,1
高雄市,小港區,1652,559,369,928,85,1013,1728,58.62%,32.35%,1
高雄市,小港區,1653,582,406,988,73,1061,2022,52.47%,28.78%,1
高雄市,小港區,1654,359,232,591,37,628,1329,47.25%,27.01%,1
高雄市,小港區,1655,410,275,685,44,729,1320,55.23%,31.06%,1
高雄市,小港區,1656,375,309,684,91,775,1267,61.17%,29.6%,1
高雄市,小港區,1657,421,324,745,83,828,1298,63.79%,32.43%,1
高雄市,小港區,1658,426,318,744,50,794,1289,61.6%,33.05%,1
高雄市,小港區,1659,488,373,861,47,908,1534,59.19%,31.81%,1
高雄市,小港區,1660,501,327,828,63,891,1494,59.64%,33.53%,1
高雄市,小港區,1661,450,291,741,84,825,1377,59.91%,32.68%,1
高雄市,小港區,1662,495,285,780,82,862,1344,64.14%,36.83%,1
高雄市,小港區,1663,478,313,791,71,862,1508,57.16%,31.7%,1
高雄市,小港區,1664,375,342,717,35,752,1400,53.71%,26.79%,1
高雄市,小港區,1665,504,318,822,68,890,1457,61.08%,34.59%,1
高雄市,小港區,1666,458,282,740,37,777,1392,55.82%,32.9%,1
高雄市,小港區,1667,594,401,995,92,1087,1983,54.82%,29.95%,1
高雄市,小港區,1668,413,226,639,37,676,1204,56.15%,34.3%,1
高雄市,小港區,1669,509,292,801,58,859,1300,66.08%,39.15%,1
高雄市,小港區,1670,587,450,1037,115,1152,1857,62.04%,31.61%,1
高雄市,小港區,1671,336,537,873,39,912,1566,58.24%,21.46%,1
高雄市,小港區,1672,474,329,803,82,885,1343,65.9%,35.29%,1
高雄市,小港區,1673,422,300,722,89,811,1236,65.61%,34.14%,1
高雄市,小港區,1674,536,342,878,104,982,1564,62.79%,34.27%,1
高雄市,小港區,1675,453,327,780,42,822,1484,55.39%,30.53%,1
高雄市,小港區,1676,469,323,792,41,833,1477,56.4%,31.75%,1
高雄市,小港區,1677,511,363,874,45,919,1482,62.01%,34.48%,1
高雄市,小港區,1678,522,353,875,34,909,1708,53.22%,30.56%,1
高雄市,小港區,1679,579,419,998,75,1073,1867,57.47%,31.01%,1
高雄市,小港區,1680,470,338,808,32,840,1709,49.15%,27.5%,1
高雄市,小港區,1681,406,297,703,82,785,1425,55.09%,28.49%,1
高雄市,小港區,1682,439,313,752,57,809,1696,47.7%,25.88%,1
高雄市,小港區,1683,419,268,687,58,745,1522,48.95%,27.53%,1
高雄市,小港區,1684,499,286,785,119,904,1531,59.05%,32.59%,1
高雄市,小港區,1685,609,454,1063,165,1228,2215,55.44%,27.49%,1
高雄市,小港區,1686,411,342,753,53,806,1515,53.2%,27.13%,1
高雄市,小港區,1687,405,309,714,37,751,1535,48.93%,26.38%,1
高雄市,小港區,1688,390,266,656,39,695,1276,54.47%,30.56%,1
高雄市,小港區,1689,337,235,572,41,613,1217,50.37%,27.69%,1
高雄市,小港區,1690,483,292,775,76,851,1707,49.85%,28.3%,1
高雄市,小港區,1691,527,355,882,145,1027,1920,53.49%,27.45%,1
高雄市,鳳山區,1256,386,260,646,65,711,1080,65.83%,35.74%,1
高雄市,鳳山區,1257,285,187,472,43,515,819,62.88%,34.8%,1
高雄市,鳳山區,1258,267,204,471,61,532,851,62.51%,31.37%,1
高雄市,鳳山區,1259,377,258,635,43,678,1075,63.07%,35.07%,1
高雄市,鳳山區,1260,443,285,728,43,771,1223,63.04%,36.22%,1
高雄市,鳳山區,1261,396,306,702,48,750,1207,62.14%,32.81%,1
高雄市,鳳山區,1262,395,287,682,51,733,1339,54.74%,29.5%,1
高雄市,鳳山區,1263,355,218,573,42,615,1188,51.77%,29.88%,1
高雄市,鳳山區,1264,380,208,588,55,643,1055,60.95%,36.02%,1
高雄市,鳳山區,1265,365,200,565,73,638,1109,57.53%,32.91%,1
高雄市,鳳山區,1266,271,204,475,44,519,756,68.65%,35.85%,1
高雄市,鳳山區,1267,353,249,602,54,656,1182,55.5%,29.86%,1
高雄市,鳳山區,1268,469,338,807,73,880,1496,58.82%,31.35%,1
高雄市,鳳山區,1269,602,370,972,76,1048,2094,50.05%,28.75%,1
高雄市,鳳山區,1270,538,348,886,31,917,1672,54.84%,32.18%,1
高雄市,鳳山區,1271,566,352,918,38,956,1761,54.29%,32.14%,1
高雄市,鳳山區,1272,452,329,781,84,865,1450,59.66%,31.17%,1
高雄市,鳳山區,1273,443,271,714,45,759,1455,52.16%,30.45%,1
高雄市,鳳山區,1274,386,278,664,71,735,1234,59.56%,31.28%,1
高雄市,鳳山區,1275,588,413,1001,71,1072,1713,62.58%,34.33%,1
高雄市,鳳山區,1276,516,333,849,36,885,1698,52.12%,30.39%,1
高雄市,鳳山區,1277,403,304,707,66,773,1247,61.99%,32.32%,1
高雄市,鳳山區,1278,374,243,617,45,662,1087,60.9%,34.41%,1
高雄市,鳳山區,1279,415,268,683,32,715,1199,59.63%,34.61%,1
高雄市,鳳山區,1280,580,261,841,59,900,1559,57.73%,37.2%,1
高雄市,鳳山區,1281,414,281,695,47,742,1233,60.18%,33.58%,1
高雄市,鳳山區,1282,418,302,720,52,772,1277,60.45%,32.73%,1
高雄市,鳳山區,1283,531,281,812,24,836,1481,56.45%,35.85%,1
高雄市,鳳山區,1284,421,294,715,24,739,1154,64.04%,36.48%,1
高雄市,鳳山區,1285,422,344,766,37,803,1475,54.44%,28.61%,1
高雄市,鳳山區,1286,391,221,612,37,649,1247,52.04%,31.36%,1
高雄市,鳳山區,1287,458,320,778,70,848,1538,55.14%,29.78%,1
高雄市,鳳山區,1288,335,245,580,44,624,1097,56.88%,30.54%,1
高雄市,鳳山區,1289,364,246,610,41,651,1221,53.32%,29.81%,1
高雄市,鳳山區,1290,435,233,668,64,732,1075,68.09%,40.47%,1
高雄市,鳳山區,1291,637,375,1012,51,1063,1751,60.71%,36.38%,1
高雄市,鳳山區,1292,611,394,1005,47,1052,1758,59.84%,34.76%,1
高雄市,鳳山區,1293,604,341,945,91,1036,1749,59.23%,34.53%,1
高雄市,鳳山區,1294,587,354,941,33,974,1746,55.78%,33.62%,1
高雄市,鳳山區,1295,590,331,921,49,970,1712,56.66%,34.46%,1
高雄市,鳳山區,1296,413,310,723,28,751,1247,60.22%,33.12%,1
高雄市,鳳山區,1297,480,314,794,63,857,1409,60.82%,34.07%,1
高雄市,鳳山區,1298,451,308,759,52,811,1347,60.21%,33.48%,1
高雄市,鳳山區,1299,625,352,977,25,1002,1771,56.58%,35.29%,1
高雄市,鳳山區,1300,513,342,855,23,878,1537,57.12%,33.38%,1
高雄市,鳳山區,1301,571,344,915,36,951,1605,59.25%,35.58%,1
高雄市,鳳山區,1302,483,288,771,57,828,1375,60.22%,35.13%,1
高雄市,鳳山區,1303,514,304,818,57,875,1393,62.81%,36.9%,1
高雄市,鳳山區,1304,530,297,827,32,859,1584,54.23%,33.46%,1
高雄市,鳳山區,1305,171,169,340,22,362,618,58.58%,27.67%,1
高雄市,鳳山區,1306,156,94,250,11,261,423,61.7%,36.88%,1
高雄市,鳳山區,1307,415,288,703,63,766,1312,58.38%,31.63%,1
高雄市,鳳山區,1308,257,176,433,30,463,769,60.21%,33.42%,1
高雄市,鳳山區,1309,434,308,742,30,772,1213,63.64%,35.78%,1
高雄市,鳳山區,1310,410,278,688,44,732,1107,66.12%,37.04%,1
高雄市,鳳山區,1311,388,289,677,37,714,1188,60.1%,32.66%,1
高雄市,鳳山區,1312,475,222,697,38,735,1183,62.13%,40.15%,1
高雄市,鳳山區,1313,401,333,734,46,780,1264,61.71%,31.72%,1
高雄市,鳳山區,1314,279,202,481,43,524,882,59.41%,31.63%,1
高雄市,鳳山區,1315,391,256,647,62,709,1007,70.41%,38.83%,1
高雄市,鳳山區,1316,261,207,468,69,537,853,62.95%,30.6%,1
高雄市,鳳山區,1317,237,182,419,58,477,1660,28.73%,14.28%,1
高雄市,鳳山區,1318,391,263,654,42,696,1124,61.92%,34.79%,1
高雄市,鳳山區,1319,352,284,636,57,693,1112,62.32%,31.65%,1
高雄市,鳳山區,1320,373,240,613,52,665,1182,56.26%,31.56%,1
高雄市,鳳山區,1321,340,219,559,68,627,875,71.66%,38.86%,1
高雄市,鳳山區,1322,336,249,585,56,641,1040,61.63%,32.31%,1
高雄市,鳳山區,1323,401,266,667,33,700,1094,63.99%,36.65%,1
高雄市,鳳山區,1324,457,242,699,58,757,1217,62.2%,37.55%,1
高雄市,鳳山區,1325,374,252,626,41,667,974,68.48%,38.4%,1
高雄市,鳳山區,1326,349,204,553,49,602,987,60.99%,35.36%,1
高雄市,鳳山區,1327,488,264,752,33,785,1210,64.88%,40.33%,1
高雄市,鳳山區,1328,462,314,776,56,832,1391,59.81%,33.21%,1
高雄市,鳳山區,1329,339,262,601,25,626,1241,50.44%,27.32%,1
高雄市,鳳山區,1330,361,241,602,44,646,1000,64.6%,36.1%,1
高雄市,鳳山區,1331,398,233,631,40,671,1092,61.45%,36.45%,1
高雄市,鳳山區,1332,531,239,770,45,815,1308,62.31%,40.6%,1
高雄市,鳳山區,1333,373,217,590,59,649,1031,62.95%,36.18%,1
高雄市,鳳山區,1334,461,200,661,74,735,1159,63.42%,39.78%,1
高雄市,鳳山區,1335,375,241,616,63,679,1127,60.25%,33.27%,1
高雄市,鳳山區,1336,437,303,740,57,797,1109,71.87%,39.4%,1
高雄市,鳳山區,1337,709,422,1131,71,1202,1879,63.97%,37.73%,1
高雄市,鳳山區,1338,760,391,1151,53,1204,1803,66.78%,42.15%,1
高雄市,鳳山區,1339,676,338,1014,95,1109,2045,54.23%,33.06%,1
高雄市,鳳山區,1340,467,286,753,65,818,1432,57.12%,32.61%,1
高雄市,鳳山區,1341,313,201,514,24,538,1033,52.08%,30.3%,1
高雄市,鳳山區,1342,417,288,705,95,800,1253,63.85%,33.28%,1
高雄市,鳳山區,1343,397,280,677,37,714,1217,58.67%,32.62%,1
高雄市,鳳山區,1344,482,283,765,53,818,1267,64.56%,38.04%,1
高雄市,鳳山區,1345,410,251,661,44,705,1251,56.35%,32.77%,1
高雄市,鳳山區,1346,540,325,865,89,954,1563,61.04%,34.55%,1
高雄市,鳳山區,1347,700,300,1000,72,1072,1888,56.78%,37.08%,1
高雄市,鳳山區,1348,465,332,797,40,837,1368,61.18%,33.99%,1
高雄市,鳳山區,1349,500,313,813,49,862,1588,54.28%,31.49%,1
高雄市,鳳山區,1350,528,206,734,71,805,1255,64.14%,42.07%,1
高雄市,鳳山區,1351,422,282,704,64,768,1264,60.76%,33.39%,1
高雄市,鳳山區,1352,449,284,733,87,820,1291,63.52%,34.78%,1
高雄市,鳳山區,1353,431,232,663,41,704,1224,57.52%,35.21%,1
高雄市,鳳山區,1354,441,271,712,46,758,1296,58.49%,34.03%,1
高雄市,鳳山區,1355,316,188,504,52,556,826,67.31%,38.26%,1
高雄市,鳳山區,1356,457,241,698,53,751,1229,61.11%,37.18%,1
高雄市,鳳山區,1357,555,287,842,57,899,1467,61.28%,37.83%,1
高雄市,鳳山區,1358,414,274,688,57,745,1218,61.17%,33.99%,1
高雄市,鳳山區,1359,664,433,1097,80,1177,2173,54.16%,30.56%,1
高雄市,鳳山區,1360,768,467,1235,77,1312,2255,58.18%,34.06%,1
高雄市,鳳山區,1361,545,341,886,40,926,1556,59.51%,35.03%,1
高雄市,鳳山區,1362,466,321,787,58,845,1521,55.56%,30.64%,1
高雄市,鳳山區,1363,423,271,694,50,744,1407,52.88%,30.06%,1
高雄市,鳳山區,1364,551,326,877,61,938,1542,60.83%,35.73%,1
高雄市,鳳山區,1365,491,267,758,35,793,1502,52.8%,32.69%,1
高雄市,鳳山區,1366,495,274,769,66,835,1320,63.26%,37.5%,1
高雄市,鳳山區,1367,568,240,808,43,851,1507,56.47%,37.69%,1
高雄市,鳳山區,1368,551,228,779,49,828,1284,64.49%,42.91%,1
高雄市,鳳山區,1369,454,286,740,53,793,1441,55.03%,31.51%,1
高雄市,鳳山區,1370,522,305,827,92,919,1485,61.89%,35.15%,1
高雄市,鳳山區,1371,363,286,649,62,711,1205,59%,30.12%,1
高雄市,鳳山區,1372,373,296,669,35,704,1284,54.83%,29.05%,1
高雄市,鳳山區,1373,469,297,766,64,830,1326,62.59%,35.37%,1
高雄市,鳳山區,1374,366,256,622,32,654,1096,59.67%,33.39%,1
高雄市,鳳山區,1375,397,278,675,85,760,1182,64.3%,33.59%,1
高雄市,鳳山區,1376,260,375,635,61,696,1017,68.44%,25.57%,1
高雄市,鳳山區,1377,343,291,634,86,720,1198,60.1%,28.63%,1
高雄市,鳳山區,1378,370,259,629,44,673,1281,52.54%,28.88%,1
高雄市,鳳山區,1379,449,367,816,46,862,1358,63.48%,33.06%,1
高雄市,鳳山區,1380,467,293,760,53,813,1226,66.31%,38.09%,1
高雄市,鳳山區,1381,382,264,646,71,717,1098,65.3%,34.79%,1
高雄市,鳳山區,1382,399,283,682,39,721,1200,60.08%,33.25%,1
高雄市,鳳山區,1383,291,229,520,49,569,942,60.4%,30.89%,1
高雄市,鳳山區,1384,379,240,619,40,659,1206,54.64%,31.43%,1
高雄市,鳳山區,1385,408,300,708,39,747,1159,64.45%,35.2%,1
高雄市,鳳山區,1386,505,328,833,53,886,1401,63.24%,36.05%,1
高雄市,鳳山區,1387,487,320,807,30,837,1525,54.89%,31.93%,1
高雄市,鳳山區,1388,416,315,731,47,778,1345,57.84%,30.93%,1
高雄市,鳳山區,1389,402,313,715,32,747,1180,63.31%,34.07%,1
高雄市,鳳山區,1390,328,237,565,24,589,1106,53.25%,29.66%,1
高雄市,鳳山區,1391,512,325,837,79,916,1442,63.52%,35.51%,1
高雄市,鳳山區,1392,467,324,791,67,858,1376,62.35%,33.94%,1
高雄市,鳳山區,1393,407,298,705,36,741,1243,59.61%,32.74%,1
高雄市,鳳山區,1394,467,288,755,30,785,1361,57.68%,34.31%,1
高雄市,鳳山區,1395,481,336,817,71,888,1416,62.71%,33.97%,1
高雄市,鳳山區,1396,600,348,948,60,1008,1536,65.63%,39.06%,1
高雄市,鳳山區,1397,411,293,704,34,738,1388,53.17%,29.61%,1
高雄市,鳳山區,1398,409,279,688,89,777,1241,62.61%,32.96%,1
高雄市,鳳山區,1399,499,317,816,63,879,1394,63.06%,35.8%,1
高雄市,鳳山區,1400,454,295,749,28,777,1188,65.4%,38.22%,1
高雄市,鳳山區,1401,362,265,627,49,676,1112,60.79%,32.55%,1
高雄市,鳳山區,1402,413,322,735,54,789,1198,65.86%,34.47%,1
高雄市,鳳山區,1403,494,311,805,49,854,1475,57.9%,33.49%,1
高雄市,鳳山區,1404,367,239,606,49,655,1216,53.87%,30.18%,1
高雄市,鳳山區,1405,365,261,626,41,667,1318,50.61%,27.69%,1
高雄市,鳳山區,1406,463,339,802,32,834,1465,56.93%,31.6%,1
高雄市,鳳山區,1407,383,261,644,52,696,1314,52.97%,29.15%,1
高雄市,鳳山區,1408,474,291,765,50,815,1649,49.42%,28.74%,1
高雄市,鳳山區,1409,484,303,787,111,898,1601,56.09%,30.23%,1
高雄市,鳳山區,1410,392,227,619,32,651,1155,56.36%,33.94%,1
高雄市,鳳山區,1411,338,247,585,58,643,1050,61.24%,32.19%,1
高雄市,鳳山區,1412,431,275,706,24,730,1417,51.52%,30.42%,1
高雄市,鳳山區,1413,485,319,804,83,887,1525,58.16%,31.8%,1
高雄市,鳳山區,1414,523,331,854,68,922,1514,60.9%,34.54%,1
高雄市,鳳山區,1415,405,243,648,59,707,1190,59.41%,34.03%,1
高雄市,鳳山區,1416,429,264,693,33,726,1325,54.79%,32.38%,1
高雄市,鳳山區,1417,349,246,595,60,655,1049,62.44%,33.27%,1
高雄市,鳳山區,1418,359,214,573,37,610,1026,59.45%,34.99%,1
高雄市,鳳山區,1419,392,271,663,60,723,1152,62.76%,34.03%,1
高雄市,鳳山區,1420,365,260,625,29,654,1254,52.15%,29.11%,1
高雄市,鳳山區,1421,493,335,828,55,883,1688,52.31%,29.21%,1
高雄市,鳳山區,1422,576,314,890,80,970,1657,58.54%,34.76%,1
高雄市,鳳山區,1423,515,347,862,44,906,1729,52.4%,29.79%,1
高雄市,鳳山區,1424,578,354,932,59,991,1628,60.87%,35.5%,1
高雄市,鳳山區,1425,566,345,911,26,937,1891,49.55%,29.93%,1
高雄市,鳳山區,1426,580,358,938,53,991,1594,62.17%,36.39%,1
高雄市,鳳山區,1427,527,291,818,20,838,1342,62.44%,39.27%,1
高雄市,鳳山區,1428,577,316,893,55,948,1448,65.47%,39.85%,1
高雄市,鳳山區,1429,490,314,804,64,868,1405,61.78%,34.88%,1
高雄市,鳳山區,1430,353,278,631,81,712,1097,64.9%,32.18%,1
高雄市,鳳山區,1431,405,310,715,99,814,1248,65.22%,32.45%,1
高雄市,鳳山區,1432,407,278,685,77,762,1225,62.2%,33.22%,1
高雄市,鳳山區,1433,375,270,645,34,679,1214,55.93%,30.89%,1
高雄市,鳳山區,1434,702,458,1160,102,1262,2032,62.11%,34.55%,1
高雄市,鳳山區,1435,644,429,1073,81,1154,1927,59.89%,33.42%,1
高雄市,鳳山區,1436,958,270,1228,78,1306,2097,62.28%,45.68%,1
高雄市,鳳山區,1437,272,232,504,64,568,968,58.68%,28.1%,1
高雄市,鳳山區,1438,375,242,617,66,683,1200,56.92%,31.25%,1
高雄市,鳳山區,1439,347,254,601,72,673,1101,61.13%,31.52%,1
高雄市,鳳山區,1440,404,287,691,58,749,1369,54.71%,29.51%,1
高雄市,鳳山區,1441,481,332,813,77,890,1542,57.72%,31.19%,1
高雄市,鳳山區,1442,532,360,892,57,949,1536,61.78%,34.64%,1
高雄市,鳳山區,1443,420,277,697,43,740,1382,53.55%,30.39%,1
高雄市,鳳山區,1444,410,374,784,98,882,1452,60.74%,28.24%,1
高雄市,鳳山區,1445,353,227,580,53,633,1058,59.83%,33.36%,1
高雄市,鳳山區,1446,366,214,580,63,643,976,65.88%,37.5%,1
高雄市,鳳山區,1447,446,301,747,56,803,1545,51.97%,28.87%,1
高雄市,鳳山區,1448,341,274,615,59,674,1143,58.97%,29.83%,1
高雄市,鳳山區,1449,187,132,319,18,337,1301,25.9%,14.37%,1
高雄市,鳳山區,1450,334,227,561,43,604,1250,48.32%,26.72%,1
高雄市,鳳山區,1451,389,251,640,68,708,1208,58.61%,32.2%,1
高雄市,鳳山區,1452,402,256,658,86,744,1202,61.9%,33.44%,1
高雄市,鳳山區,1453,476,310,786,88,874,1499,58.31%,31.75%,1
高雄市,鳳山區,1454,471,311,782,71,853,1522,56.04%,30.95%,1
高雄市,鳳山區,1455,397,251,648,70,718,1125,63.82%,35.29%,1
高雄市,鳳山區,1456,429,304,733,41,774,1307,59.22%,32.82%,1
高雄市,鳳山區,1457,459,303,762,76,838,1405,59.64%,32.67%,1
高雄市,鳳山區,1458,424,249,673,80,753,1252,60.14%,33.87%,1
高雄市,鳳山區,1459,470,288,758,35,793,1291,61.43%,36.41%,1
高雄市,鳳山區,1460,315,204,519,75,594,938,63.33%,33.58%,1
高雄市,鳳山區,1461,603,395,998,52,1050,1783,58.89%,33.82%,1
高雄市,鳳山區,1462,367,265,632,42,674,1105,61%,33.21%,1
高雄市,鳳山區,1463,421,304,725,98,823,1392,59.12%,30.24%,1
高雄市,鳳山區,1464,457,327,784,47,831,1244,66.8%,36.74%,1
高雄市,鳳山區,1465,330,256,586,69,655,1154,56.76%,28.6%,1
高雄市,鳳山區,1466,380,251,631,65,696,1153,60.36%,32.96%,1
高雄市,鳳山區,1467,331,206,537,26,563,1148,49.04%,28.83%,1
高雄市,鳳山區,1468,416,273,689,137,826,1432,57.68%,29.05%,1
高雄市,鳳山區,1469,337,235,572,38,610,1429,42.69%,23.58%,1
高雄市,鳳山區,1470,474,312,786,35,821,1479,55.51%,32.05%,1
高雄市,鳳山區,1471,338,253,591,50,641,1026,62.48%,32.94%,1
高雄市,鳳山區,1472,301,267,568,106,674,993,67.88%,30.31%,1
高雄市,鳳山區,1473,325,214,539,82,621,947,65.58%,34.32%,1
高雄市,鳳山區,1474,336,211,547,61,608,1042,58.35%,32.25%,1
高雄市,鳳山區,1475,346,250,596,65,661,1098,60.2%,31.51%,1
高雄市,鳳山區,1476,354,273,627,32,659,1284,51.32%,27.57%,1
高雄市,鳳山區,1477,359,261,620,54,674,1242,54.27%,28.9%,1
高雄市,鳳山區,1478,359,245,604,83,687,1093,62.85%,32.85%,1
高雄市,鳳山區,1479,396,302,698,61,759,1353,56.1%,29.27%,1
高雄市,鳳山區,1480,410,273,683,23,706,1353,52.18%,30.3%,1
高雄市,鳳山區,1481,439,302,741,66,807,1309,61.65%,33.54%,1
高雄市,鳳山區,1482,530,360,890,63,953,1627,58.57%,32.58%,1
高雄市,鳳山區,1483,435,315,750,95,845,1372,61.59%,31.71%,1
高雄市,林園區,1773,391,279,670,93,763,1262,60.46%,30.98%,1
高雄市,林園區,1774,459,287,746,80,826,1562,52.88%,29.39%,1
高雄市,林園區,1775,343,222,565,33,598,1078,55.47%,31.82%,1
高雄市,林園區,1776,351,220,571,58,629,979,64.25%,35.85%,1
高雄市,林園區,1777,343,277,620,58,678,1195,56.74%,28.7%,1
高雄市,林園區,1778,383,291,674,81,755,1380,54.71%,27.75%,1
高雄市,林園區,1779,372,270,642,90,732,1280,57.19%,29.06%,1
高雄市,林園區,1780,388,215,603,50,653,1269,51.46%,30.58%,1
高雄市,林園區,1781,379,260,639,29,668,1568,42.6%,24.17%,1
高雄市,林園區,1782,443,233,676,59,735,1226,59.95%,36.13%,1
高雄市,林園區,1783,486,263,749,64,813,1480,54.93%,32.84%,1
高雄市,林園區,1784,497,290,787,77,864,1459,59.22%,34.06%,1
高雄市,林園區,1785,452,306,758,67,825,1593,51.79%,28.37%,1
高雄市,林園區,1786,279,190,469,72,541,895,60.45%,31.17%,1
高雄市,林園區,1787,307,227,534,44,578,1110,52.07%,27.66%,1
高雄市,林園區,1788,386,268,654,80,734,1348,54.45%,28.64%,1
高雄市,林園區,1789,286,204,490,56,546,912,59.87%,31.36%,1
高雄市,林園區,1790,390,244,634,70,704,1085,64.88%,35.94%,1
高雄市,林園區,1791,284,194,478,40,518,955,54.24%,29.74%,1
高雄市,林園區,1792,280,194,474,70,544,879,61.89%,31.85%,1
高雄市,林園區,1793,361,211,572,75,647,1103,58.66%,32.73%,1
高雄市,林園區,1794,376,225,601,82,683,1054,64.8%,35.67%,1
高雄市,林園區,1795,356,232,588,20,608,1292,47.06%,27.55%,1
高雄市,林園區,1796,440,288,728,40,768,1683,45.63%,26.14%,1
高雄市,林園區,1797,195,116,311,39,350,607,57.66%,32.13%,1
高雄市,林園區,1798,297,205,502,90,592,1012,58.5%,29.35%,1
高雄市,林園區,1799,341,209,550,70,620,1046,59.27%,32.6%,1
高雄市,林園區,1800,253,146,399,29,428,914,46.83%,27.68%,1
高雄市,林園區,1801,431,308,739,84,823,1405,58.58%,30.68%,1
高雄市,林園區,1802,444,261,705,87,792,1299,60.97%,34.18%,1
高雄市,林園區,1803,354,239,593,46,639,1170,54.62%,30.26%,1
高雄市,林園區,1804,322,239,561,41,602,1299,46.34%,24.79%,1
高雄市,林園區,1805,317,219,536,50,586,1031,56.84%,30.75%,1
高雄市,林園區,1806,243,164,407,31,438,849,51.59%,28.62%,1
高雄市,林園區,1807,207,179,386,74,460,838,54.89%,24.7%,1
高雄市,林園區,1808,313,166,479,44,523,938,55.76%,33.37%,1
高雄市,林園區,1809,291,184,475,48,523,1051,49.76%,27.69%,1
高雄市,林園區,1810,228,187,415,63,478,786,60.81%,29.01%,1
高雄市,林園區,1811,274,206,480,71,551,894,61.63%,30.65%,1
高雄市,林園區,1812,171,81,252,25,277,749,36.98%,22.83%,1
高雄市,林園區,1813,502,323,825,50,875,1485,58.92%,33.8%,1
高雄市,林園區,1814,470,299,769,125,894,1478,60.49%,31.8%,1
高雄市,林園區,1815,482,304,786,72,858,1345,63.79%,35.84%,1
高雄市,林園區,1816,309,214,523,51,574,1038,55.3%,29.77%,1
高雄市,林園區,1817,403,259,662,33,695,1203,57.77%,33.5%,1
高雄市,林園區,1818,342,262,604,39,643,1138,56.5%,30.05%,1
高雄市,林園區,1819,284,187,471,27,498,1025,48.59%,27.71%,1
高雄市,林園區,1820,423,276,699,90,789,1341,58.84%,31.54%,1
高雄市,林園區,1821,405,111,516,42,558,1218,45.81%,33.25%,1
高雄市,林園區,1822,284,176,460,32,492,1147,42.89%,24.76%,1
高雄市,林園區,1823,281,194,475,35,510,1176,43.37%,23.89%,1
高雄市,大寮區,1692,196,136,332,34,366,727,50.34%,26.96%,1
高雄市,大寮區,1693,163,156,319,20,339,718,47.21%,22.7%,1
高雄市,大寮區,1694,369,233,602,63,665,1340,49.63%,27.54%,1
高雄市,大寮區,1695,410,264,674,65,739,1575,46.92%,26.03%,1
高雄市,大寮區,1696,128,107,235,27,262,444,59.01%,28.83%,1
高雄市,大寮區,1697,604,390,994,63,1057,2374,44.52%,25.44%,1
高雄市,大寮區,1698,423,224,647,82,729,1291,56.47%,32.77%,1
高雄市,大寮區,1699,417,300,717,95,812,1400,58%,29.79%,1
高雄市,大寮區,1700,413,289,702,35,737,1390,53.02%,29.71%,1
高雄市,大寮區,1701,419,279,698,82,780,1401,55.67%,29.91%,1
高雄市,大寮區,1702,363,216,579,38,617,1199,51.46%,30.28%,1
高雄市,大寮區,1703,304,246,550,37,587,1210,48.51%,25.12%,1
高雄市,大寮區,1704,363,253,616,49,665,1195,55.65%,30.38%,1
高雄市,大寮區,1705,319,247,566,34,600,1166,51.46%,27.36%,1
高雄市,大寮區,1706,392,307,699,46,745,1353,55.06%,28.97%,1
高雄市,大寮區,1707,332,242,574,82,656,1052,62.36%,31.56%,1
高雄市,大寮區,1708,289,142,431,31,462,1024,45.12%,28.22%,1
高雄市,大寮區,1709,359,272,631,31,662,1189,55.68%,30.19%,1
高雄市,大寮區,1710,514,299,813,103,916,1512,60.58%,33.99%,1
高雄市,大寮區,1711,446,346,792,88,880,1633,53.89%,27.31%,1
高雄市,大寮區,1712,366,283,649,81,730,1214,60.13%,30.15%,1
高雄市,大寮區,1713,445,270,715,91,806,1258,64.07%,35.37%,1
高雄市,大寮區,1714,417,304,721,32,753,1323,56.92%,31.52%,1
高雄市,大寮區,1715,447,261,708,50,758,1253,60.49%,35.67%,1
高雄市,大寮區,1716,342,297,639,84,723,1035,69.86%,33.04%,1
高雄市,大寮區,1717,330,242,572,40,612,1106,55.33%,29.84%,1
高雄市,大寮區,1718,374,262,636,51,687,1195,57.49%,31.3%,1
高雄市,大寮區,1719,231,345,576,22,598,1051,56.9%,21.98%,1
高雄市,大寮區,1720,450,312,762,91,853,1425,59.86%,31.58%,1
高雄市,大寮區,1721,510,333,843,71,914,1635,55.9%,31.19%,1
高雄市,大寮區,1722,478,267,745,65,810,1359,59.6%,35.17%,1
高雄市,大寮區,1723,439,295,734,72,806,1361,59.22%,32.26%,1
高雄市,大寮區,1724,524,338,862,59,921,1629,56.54%,32.17%,1
高雄市,大寮區,1725,455,382,837,49,886,1518,58.37%,29.97%,1
高雄市,大寮區,1726,482,338,820,77,897,1620,55.37%,29.75%,1
高雄市,大寮區,1727,498,338,836,26,862,1648,52.31%,30.22%,1
高雄市,大寮區,1728,480,265,745,55,800,1385,57.76%,34.66%,1
高雄市,大寮區,1729,435,294,729,40,769,1435,53.59%,30.31%,1
高雄市,大寮區,1730,320,226,546,22,568,1046,54.3%,30.59%,1
高雄市,大寮區,1731,221,157,378,43,421,789,53.36%,28.01%,1
高雄市,大寮區,1732,255,194,449,43,492,909,54.13%,28.05%,1
高雄市,大寮區,1733,232,165,397,36,433,733,59.07%,31.65%,1
高雄市,大寮區,1734,409,418,827,18,845,1553,54.41%,26.34%,1
高雄市,大寮區,1735,269,207,476,27,503,922,54.56%,29.18%,1
高雄市,大寮區,1736,287,222,509,83,592,1012,58.5%,28.36%,1
高雄市,大寮區,1737,177,295,472,70,542,968,55.99%,18.29%,1
高雄市,大寮區,1738,320,199,519,34,553,1021,54.16%,31.34%,1
高雄市,大寮區,1739,412,269,681,80,761,1554,48.97%,26.51%,1
高雄市,大寮區,1740,384,234,618,69,687,1120,61.34%,34.29%,1
高雄市,大寮區,1741,441,266,707,60,767,1225,62.61%,36%,1
高雄市,大寮區,1742,279,203,482,31,513,1320,38.86%,21.14%,1
高雄市,大寮區,1743,430,269,699,46,745,1317,56.57%,32.65%,1
高雄市,大寮區,1744,342,233,575,26,601,1119,53.71%,30.56%,1
高雄市,大寮區,1745,392,271,663,60,723,1190,60.76%,32.94%,1
高雄市,大寮區,1746,405,285,690,61,751,1229,61.11%,32.95%,1
高雄市,大寮區,1747,417,289,706,48,754,1178,64.01%,35.4%,1
高雄市,大寮區,1748,245,520,765,27,792,1272,62.26%,19.26%,1
高雄市,大寮區,1749,433,313,746,32,778,1413,55.06%,30.64%,1
高雄市,大寮區,1750,406,277,683,56,739,1185,62.36%,34.26%,1
高雄市,大寮區,1751,189,107,296,10,306,553,55.33%,34.18%,1
高雄市,大寮區,1752,315,232,547,81,628,1121,56.02%,28.1%,1
高雄市,大寮區,1753,420,242,662,34,696,1227,56.72%,34.23%,1
高雄市,大寮區,1754,388,248,636,82,718,1058,67.86%,36.67%,1
高雄市,大寮區,1755,392,259,651,46,697,1209,57.65%,32.42%,1
高雄市,大寮區,1756,392,227,619,18,637,1100,57.91%,35.64%,1
高雄市,大寮區,1757,323,235,558,33,591,1122,52.67%,28.79%,1
高雄市,大寮區,1758,316,241,557,87,644,983,65.51%,32.15%,1
高雄市,大寮區,1759,341,234,575,35,610,1192,51.17%,28.61%,1
高雄市,大寮區,1760,185,173,358,28,386,719,53.69%,25.73%,1
高雄市,大寮區,1761,273,182,455,28,483,829,58.26%,32.93%,1
高雄市,大寮區,1762,266,197,463,70,533,771,69.13%,34.5%,1
高雄市,大寮區,1763,318,275,593,83,676,1075,62.88%,29.58%,1
高雄市,大寮區,1764,408,292,700,90,790,1280,61.72%,31.88%,1
高雄市,大寮區,1765,309,269,578,118,696,1179,59.03%,26.21%,1
高雄市,大寮區,1766,357,241,598,45,643,1210,53.14%,29.5%,1
高雄市,大寮區,1767,74,31,105,11,116,189,61.38%,39.15%,1
高雄市,大寮區,1768,422,262,684,67,751,1228,61.16%,34.36%,1
高雄市,大寮區,1769,413,211,624,49,673,1170,57.52%,35.3%,1
高雄市,大寮區,1770,518,290,808,66,874,1416,61.72%,36.58%,1
高雄市,大寮區,1771,547,304,851,58,909,1482,61.34%,36.91%,1
高雄市,大寮區,1772,480,263,743,76,819,1478,55.41%,32.48%,1
高雄市,大樹區,0736,425,303,728,36,764,1386,55.12%,30.66%,1
高雄市,大樹區,0737,474,325,799,45,844,1315,64.18%,36.05%,1
高雄市,大樹區,0738,755,486,1241,81,1322,2461,53.72%,30.68%,1
高雄市,大樹區,0739,380,261,641,46,687,1274,53.92%,29.83%,1
高雄市,大樹區,0740,423,218,641,74,715,1265,56.52%,33.44%,1
高雄市,大樹區,0741,463,282,745,85,830,1504,55.19%,30.78%,1
高雄市,大樹區,0742,276,207,483,35,518,1049,49.38%,26.31%,1
高雄市,大樹區,0743,487,318,805,40,845,1573,53.72%,30.96%,1
高雄市,大樹區,0744,294,209,503,41,544,1121,48.53%,26.23%,1
高雄市,大樹區,0745,410,189,599,58,657,1207,54.43%,33.97%,1
高雄市,大樹區,0746,350,215,565,26,591,1134,52.12%,30.86%,1
高雄市,大樹區,0747,366,257,623,42,665,1124,59.16%,32.56%,1
高雄市,大樹區,0748,378,240,618,102,720,1259,57.19%,30.02%,1
高雄市,大樹區,0749,395,225,620,76,696,1105,62.99%,35.75%,1
高雄市,大樹區,0750,340,241,581,70,651,1128,57.71%,30.14%,1
高雄市,大樹區,0751,311,194,505,89,594,1079,55.05%,28.82%,1
高雄市,大樹區,0752,86,374,460,54,514,1025,50.15%,8.39%,1
高雄市,大樹區,0753,279,188,467,61,528,950,55.58%,29.37%,1
高雄市,大樹區,0754,413,279,692,115,807,1433,56.32%,28.82%,1
高雄市,大樹區,0755,214,129,343,35,378,794,47.61%,26.95%,1
高雄市,大樹區,0756,165,116,281,23,304,781,38.92%,21.13%,1
高雄市,大樹區,0757,342,259,601,32,633,1318,48.03%,25.95%,1
高雄市,大樹區,0758,223,122,345,61,406,736,55.16%,30.3%,1
高雄市,大樹區,0759,268,176,444,41,485,1047,46.32%,25.6%,1
高雄市,大樹區,0760,385,273,658,93,751,1271,59.09%,30.29%,1
高雄市,大樹區,0761,305,231,536,38,574,1186,48.4%,25.72%,1
高雄市,大樹區,0762,307,208,515,66,581,1007,57.7%,30.49%,1
高雄市,大樹區,0763,281,169,450,67,517,859,60.19%,32.71%,1
高雄市,大樹區,0764,197,116,313,26,339,735,46.12%,26.8%,1
高雄市,大樹區,0765,314,235,549,91,640,1046,61.19%,30.02%,1
高雄市,大樹區,0766,451,155,606,45,651,880,73.98%,51.25%,1
高雄市,大樹區,0767,203,132,335,27,362,720,50.28%,28.19%,1
高雄市,大社區,0637,276,181,457,78,535,950,56.32%,29.05%,1
高雄市,大社區,0638,342,281,623,43,666,1306,51%,26.19%,1
高雄市,大社區,0639,491,294,785,48,833,1856,44.88%,26.45%,1
高雄市,大社區,0640,301,264,565,67,632,986,64.1%,30.53%,1
高雄市,大社區,0641,294,210,504,69,573,1116,51.34%,26.34%,1
高雄市,大社區,0642,394,318,712,94,806,1253,64.33%,31.44%,1
高雄市,大社區,0643,533,346,879,56,935,1613,57.97%,33.04%,1
高雄市,大社區,0644,400,317,717,61,778,1455,53.47%,27.49%,1
高雄市,大社區,0645,505,419,924,60,984,1674,58.78%,30.17%,1
高雄市,大社區,0646,312,225,537,70,607,1004,60.46%,31.08%,1
高雄市,大社區,0647,271,193,464,40,504,879,57.34%,30.83%,1
高雄市,大社區,0648,224,161,385,23,408,778,52.44%,28.79%,1
高雄市,大社區,0649,356,255,611,67,678,1110,61.08%,32.07%,1
高雄市,大社區,0650,423,332,755,52,807,1432,56.35%,29.54%,1
高雄市,大社區,0651,493,319,812,54,866,1466,59.07%,33.63%,1
高雄市,大社區,0652,427,388,815,89,904,1383,65.37%,30.87%,1
高雄市,大社區,0653,558,357,915,73,988,1645,60.06%,33.92%,1
高雄市,大社區,0654,428,289,717,66,783,1555,50.35%,27.52%,1
高雄市,大社區,0655,544,393,937,81,1018,1750,58.17%,31.09%,1
高雄市,大社區,0656,322,256,578,74,652,1111,58.69%,28.98%,1
高雄市,大社區,0657,345,280,625,70,695,1133,61.34%,30.45%,1
高雄市,大社區,0658,301,204,505,41,546,912,59.87%,33%,1
高雄市,大社區,0659,194,131,325,21,346,745,46.44%,26.04%,1
高雄市,大社區,0660,280,227,507,37,544,934,58.24%,29.98%,1
高雄市,仁武區,0661,629,439,1068,51,1119,1777,62.97%,35.4%,1
高雄市,仁武區,0662,836,471,1307,80,1387,2273,61.02%,36.78%,1
高雄市,仁武區,0663,526,305,831,82,913,1384,65.97%,38.01%,1
高雄市,仁武區,0664,392,235,627,62,689,1170,58.89%,33.5%,1
高雄市,仁武區,0665,418,323,741,73,814,1216,66.94%,34.38%,1
高雄市,仁武區,0666,528,331,859,36,895,1598,56.01%,33.04%,1
高雄市,仁武區,0667,808,489,1297,50,1347,2143,62.86%,37.7%,1
高雄市,仁武區,0668,393,283,676,75,751,1300,57.77%,30.23%,1
高雄市,仁武區,0669,405,318,723,94,817,1338,61.06%,30.27%,1
高雄市,仁武區,0670,363,258,621,31,652,1217,53.57%,29.83%,1
高雄市,仁武區,0671,306,225,531,87,618,1202,51.41%,25.46%,1
高雄市,仁武區,0672,415,259,674,50,724,1404,51.57%,29.56%,1
高雄市,仁武區,0673,261,166,427,55,482,830,58.07%,31.45%,1
高雄市,仁武區,0674,442,289,731,52,783,1802,43.45%,24.53%,1
高雄市,仁武區,0675,557,339,896,83,979,1877,52.16%,29.68%,1
高雄市,仁武區,0676,456,333,789,45,834,1738,47.99%,26.24%,1
高雄市,仁武區,0677,460,333,793,67,860,1549,55.52%,29.7%,1
高雄市,仁武區,0678,498,360,858,68,926,1579,58.64%,31.54%,1
高雄市,仁武區,0679,434,280,714,43,757,1406,53.84%,30.87%,1
高雄市,仁武區,0680,508,291,799,34,833,1461,57.02%,34.77%,1
高雄市,仁武區,0681,445,311,756,65,821,1311,62.62%,33.94%,1
高雄市,仁武區,0682,427,297,724,39,763,1373,55.57%,31.1%,1
高雄市,仁武區,0683,255,228,483,22,505,1035,48.79%,24.64%,1
高雄市,仁武區,0684,337,262,599,45,644,1181,54.53%,28.54%,1
高雄市,仁武區,0685,513,340,853,55,908,1670,54.37%,30.72%,1
高雄市,仁武區,0686,481,340,821,40,861,1576,54.63%,30.52%,1
高雄市,仁武區,0687,538,364,902,82,984,1576,62.44%,34.14%,1
高雄市,仁武區,0688,688,422,1110,53,1163,1915,60.73%,35.93%,1
高雄市,仁武區,0689,537,378,915,40,955,1758,54.32%,30.55%,1
高雄市,仁武區,0690,692,436,1128,63,1191,1892,62.95%,36.58%,1
高雄市,仁武區,0691,697,451,1148,78,1226,2025,60.54%,34.42%,1
高雄市,仁武區,0692,742,440,1182,66,1248,2014,61.97%,36.84%,1
高雄市,仁武區,0693,552,380,932,64,996,1473,67.62%,37.47%,1
高雄市,仁武區,0694,292,204,496,33,529,979,54.03%,29.83%,1
高雄市,仁武區,0695,307,203,510,37,547,944,57.94%,32.52%,1
高雄市,仁武區,0696,364,237,601,117,718,1153,62.27%,31.57%,1
高雄市,仁武區,0697,403,265,668,51,719,1328,54.14%,30.35%,1
高雄市,仁武區,0698,743,179,922,76,998,1657,60.23%,44.84%,1
高雄市,仁武區,0699,440,311,751,72,823,1545,53.27%,28.48%,1
高雄市,仁武區,0700,460,348,808,62,870,1417,61.4%,32.46%,1
高雄市,仁武區,0701,611,356,967,59,1026,1602,64.04%,38.14%,1
高雄市,仁武區,0702,643,446,1089,79,1168,1823,64.07%,35.27%,1
高雄市,仁武區,0703,616,384,1000,40,1040,1914,54.34%,32.18%,1
高雄市,仁武區,0704,686,400,1086,57,1143,1992,57.38%,34.44%,1
高雄市,仁武區,0705,589,436,1025,43,1068,2045,52.22%,28.8%,1
高雄市,仁武區,0706,707,443,1150,55,1205,1982,60.8%,35.67%,1
高雄市,仁武區,0707,641,465,1106,66,1172,2167,54.08%,29.58%,1
高雄市,鳥松區,0708,543,374,917,71,988,1678,58.88%,32.36%,1
高雄市,鳥松區,0709,510,316,826,87,913,1682,54.28%,30.32%,1
高雄市,鳥松區,0710,392,309,701,55,756,1225,61.71%,32%,1
高雄市,鳥松區,0711,400,267,667,67,734,1322,55.52%,30.26%,1
高雄市,鳥松區,0712,198,485,683,54,737,1215,60.66%,16.3%,1
高雄市,鳥松區,0713,497,422,919,62,981,1779,55.14%,27.94%,1
高雄市,鳥松區,0714,349,360,709,27,736,1129,65.19%,30.91%,1
高雄市,鳥松區,0715,414,345,759,66,825,1374,60.04%,30.13%,1
高雄市,鳥松區,0716,329,261,590,45,635,1089,58.31%,30.21%,1
高雄市,鳥松區,0717,745,544,1289,77,1366,2219,61.56%,33.57%,1
高雄市,鳥松區,0718,544,364,908,44,952,1634,58.26%,33.29%,1
高雄市,鳥松區,0719,543,365,908,79,987,1553,63.55%,34.96%,1
高雄市,鳥松區,0720,563,386,949,60,1009,1572,64.19%,35.81%,1
高雄市,鳥松區,0721,597,417,1014,47,1061,1688,62.86%,35.37%,1
高雄市,鳥松區,0722,566,391,957,54,1011,1626,62.18%,34.81%,1
高雄市,鳥松區,0723,609,464,1073,62,1135,1744,65.08%,34.92%,1
高雄市,鳥松區,0724,375,264,639,53,692,1230,56.26%,30.49%,1
高雄市,鳥松區,0725,496,180,676,98,774,1201,64.45%,41.3%,1
高雄市,鳥松區,0726,396,280,676,46,722,1117,64.64%,35.45%,1
高雄市,鳥松區,0727,383,242,625,90,715,1255,56.97%,30.52%,1
高雄市,鳥松區,0728,399,308,707,48,755,1432,52.72%,27.86%,1
高雄市,鳥松區,0729,411,257,668,40,708,1370,51.68%,30%,1
高雄市,鳥松區,0730,434,319,753,99,852,1364,62.46%,31.82%,1
高雄市,鳥松區,0731,343,252,595,59,654,1041,62.82%,32.95%,1
高雄市,鳥松區,0732,276,182,458,45,503,702,71.65%,39.32%,1
高雄市,鳥松區,0733,402,278,680,54,734,1212,60.56%,33.17%,1
高雄市,鳥松區,0734,410,283,693,64,757,1289,58.73%,31.81%,1
高雄市,鳥松區,0735,501,391,892,35,927,1449,63.98%,34.58%,1
高雄市,岡山區,0261,533,300,833,50,883,1345,65.65%,39.63%,1
高雄市,岡山區,0262,237,214,451,24,475,1045,45.45%,22.68%,1
高雄市,岡山區,0263,354,241,595,44,639,1051,60.8%,33.68%,1
高雄市,岡山區,0264,301,218,519,23,542,917,59.11%,32.82%,1
高雄市,岡山區,0265,337,229,566,41,607,934,64.99%,36.08%,1
高雄市,岡山區,0266,412,231,643,49,692,1097,63.08%,37.56%,1
高雄市,岡山區,0267,473,284,757,48,805,1208,66.64%,39.16%,1
高雄市,岡山區,0268,405,292,697,71,768,1159,66.26%,34.94%,1
高雄市,岡山區,0269,336,230,566,56,622,1018,61.1%,33.01%,1
高雄市,岡山區,0270,371,265,636,43,679,1316,51.6%,28.19%,1
高雄市,岡山區,0271,453,282,735,39,774,1345,57.55%,33.68%,1
高雄市,岡山區,0272,469,289,758,51,809,1295,62.47%,36.22%,1
高雄市,岡山區,0273,491,297,788,54,842,1425,59.09%,34.46%,1
高雄市,岡山區,0274,436,256,692,34,726,1328,54.67%,32.83%,1
高雄市,岡山區,0275,475,308,783,29,812,1382,58.76%,34.37%,1
高雄市,岡山區,0276,578,236,814,26,840,1381,60.83%,41.85%,1
高雄市,岡山區,0277,423,271,694,76,770,1282,60.06%,33%,1
高雄市,岡山區,0278,422,250,672,28,700,1240,56.45%,34.03%,1
高雄市,岡山區,0279,470,265,735,59,794,1327,59.83%,35.42%,1
高雄市,岡山區,0280,562,340,902,56,958,1736,55.18%,32.37%,1
高雄市,岡山區,0281,513,373,886,66,952,1566,60.79%,32.76%,1
高雄市,岡山區,0282,501,286,787,93,880,1779,49.47%,28.16%,1
高雄市,岡山區,0283,529,330,859,98,957,1593,60.08%,33.21%,1
高雄市,岡山區,0284,513,301,814,108,922,1480,62.3%,34.66%,1
高雄市,岡山區,0285,481,287,768,63,831,1364,60.92%,35.26%,1
高雄市,岡山區,0286,489,321,810,54,864,1410,61.28%,34.68%,1
高雄市,岡山區,0287,418,305,723,66,789,1148,68.73%,36.41%,1
高雄市,岡山區,0288,188,160,348,57,405,625,64.8%,30.08%,1
高雄市,岡山區,0289,326,229,555,46,601,969,62.02%,33.64%,1
高雄市,岡山區,0290,300,216,516,16,532,861,61.79%,34.84%,1
高雄市,岡山區,0291,246,160,406,30,436,823,52.98%,29.89%,1
高雄市,岡山區,0292,300,233,533,62,595,889,66.93%,33.75%,1
高雄市,岡山區,0293,427,292,719,55,774,1283,60.33%,33.28%,1
高雄市,岡山區,0294,520,272,792,47,839,1512,55.49%,34.39%,1
高雄市,岡山區,0295,348,261,609,64,673,983,68.46%,35.4%,1
高雄市,岡山區,0296,455,246,701,54,755,1262,59.83%,36.05%,1
高雄市,岡山區,0297,406,201,607,72,679,1096,61.95%,37.04%,1
高雄市,岡山區,0298,368,237,605,44,649,1066,60.88%,34.52%,1
高雄市,岡山區,0299,400,218,618,47,665,1188,55.98%,33.67%,1
高雄市,岡山區,0300,485,306,791,53,844,1360,62.06%,35.66%,1
高雄市,岡山區,0301,490,301,791,48,839,1363,61.56%,35.95%,1
高雄市,岡山區,0302,503,314,817,62,879,1352,65.01%,37.2%,1
高雄市,岡山區,0303,493,305,798,71,869,1460,59.52%,33.77%,1
高雄市,岡山區,0304,419,306,725,58,783,1272,61.56%,32.94%,1
高雄市,岡山區,0305,422,218,640,58,698,1080,64.63%,39.07%,1
高雄市,岡山區,0306,453,242,695,86,781,1255,62.23%,36.1%,1
高雄市,岡山區,0307,347,228,575,55,630,938,67.16%,36.99%,1
高雄市,岡山區,0308,446,288,734,58,792,1237,64.03%,36.05%,1
高雄市,岡山區,0309,400,300,700,39,739,1413,52.3%,28.31%,1
高雄市,岡山區,0310,259,177,436,16,452,765,59.08%,33.86%,1
高雄市,岡山區,0311,388,243,631,43,674,1043,64.62%,37.2%,1
高雄市,岡山區,0312,253,142,395,44,439,844,52.01%,29.98%,1
高雄市,岡山區,0313,414,259,673,55,728,993,73.31%,41.69%,1
高雄市,岡山區,0314,340,251,591,80,671,1038,64.64%,32.76%,1
高雄市,岡山區,0315,334,243,577,84,661,1070,61.78%,31.21%,1
高雄市,岡山區,0316,324,283,607,82,689,1023,67.35%,31.67%,1
高雄市,岡山區,0317,453,284,737,37,774,1349,57.38%,33.58%,1
高雄市,岡山區,0318,456,273,729,49,778,1452,53.58%,31.4%,1
高雄市,岡山區,0319,117,70,187,19,206,301,68.44%,38.87%,1
高雄市,岡山區,0320,234,185,419,93,512,756,67.72%,30.95%,1
高雄市,岡山區,0321,179,168,347,19,366,733,49.93%,24.42%,1
高雄市,岡山區,0322,315,199,514,80,594,854,69.56%,36.89%,1
高雄市,岡山區,0323,222,146,368,24,392,866,45.27%,25.64%,1
高雄市,岡山區,0324,312,196,508,60,568,978,58.08%,31.9%,1
高雄市,岡山區,0325,437,331,768,52,820,1336,61.38%,32.71%,1
高雄市,岡山區,0326,570,175,745,19,764,1218,62.73%,46.8%,1
高雄市,岡山區,0327,149,98,247,14,261,341,76.54%,43.7%,1
高雄市,岡山區,0328,530,149,679,37,716,955,74.97%,55.5%,1
高雄市,岡山區,0329,504,131,635,17,652,940,69.36%,53.62%,1
高雄市,岡山區,0330,343,192,535,43,578,851,67.92%,40.31%,1
高雄市,岡山區,0331,360,157,517,18,535,762,70.21%,47.24%,1
高雄市,岡山區,0332,125,100,225,16,241,318,75.79%,39.31%,1
高雄市,橋頭區,0404,358,245,603,73,676,1005,67.26%,35.62%,1
高雄市,橋頭區,0405,333,296,629,54,683,1073,63.65%,31.03%,1
高雄市,橋頭區,0406,347,281,628,34,662,1129,58.64%,30.74%,1
高雄市,橋頭區,0407,416,287,703,80,783,1244,62.94%,33.44%,1
高雄市,橋頭區,0408,316,275,591,39,630,1091,57.75%,28.96%,1
高雄市,橋頭區,0409,461,342,803,65,868,1329,65.31%,34.69%,1
高雄市,橋頭區,0410,373,287,660,54,714,1140,62.63%,32.72%,1
高雄市,橋頭區,0411,386,292,678,77,755,1220,61.89%,31.64%,1
高雄市,橋頭區,0412,397,258,655,58,713,1047,68.1%,37.92%,1
高雄市,橋頭區,0413,389,287,676,111,787,1315,59.85%,29.58%,1
高雄市,橋頭區,0414,209,153,362,33,395,691,57.16%,30.25%,1
高雄市,橋頭區,0415,246,171,417,59,476,720,66.11%,34.17%,1
高雄市,橋頭區,0416,331,280,611,137,748,1192,62.75%,27.77%,1
高雄市,橋頭區,0417,421,324,745,98,843,1318,63.96%,31.94%,1
高雄市,橋頭區,0418,264,167,431,59,490,761,64.39%,34.69%,1
高雄市,橋頭區,0419,291,230,521,30,551,973,56.63%,29.91%,1
高雄市,橋頭區,0420,206,124,330,34,364,587,62.01%,35.09%,1
高雄市,橋頭區,0421,280,193,473,54,527,812,64.9%,34.48%,1
高雄市,橋頭區,0422,98,108,206,11,217,343,63.27%,28.57%,1
高雄市,橋頭區,0423,437,340,777,41,818,1266,64.61%,34.52%,1
高雄市,橋頭區,0424,378,257,635,101,736,1128,65.25%,33.51%,1
高雄市,橋頭區,0425,272,226,498,65,563,884,63.69%,30.77%,1
高雄市,橋頭區,0426,351,246,597,95,692,1187,58.3%,29.57%,1
高雄市,橋頭區,0427,420,258,678,99,777,1259,61.72%,33.36%,1
高雄市,橋頭區,0428,399,273,672,82,754,1361,55.4%,29.32%,1
高雄市,橋頭區,0429,174,156,330,33,363,671,54.1%,25.93%,1
高雄市,橋頭區,0430,426,283,709,69,778,1215,64.03%,35.06%,1
高雄市,橋頭區,0431,424,310,734,84,818,1255,65.18%,33.78%,1
高雄市,橋頭區,0432,415,285,700,83,783,1219,64.23%,34.04%,1
高雄市,橋頭區,0433,413,308,721,39,760,1372,55.39%,30.1%,1
高雄市,橋頭區,0434,165,137,302,8,310,758,40.9%,21.77%,1
高雄市,燕巢區,0333,378,192,570,94,664,1152,57.64%,32.81%,1
高雄市,燕巢區,0334,348,270,618,31,649,1120,57.95%,31.07%,1
高雄市,燕巢區,0335,354,220,574,68,642,974,65.91%,36.34%,1
高雄市,燕巢區,0336,304,222,526,25,551,1019,54.07%,29.83%,1
高雄市,燕巢區,0337,314,215,529,78,607,1058,57.37%,29.68%,1
高雄市,燕巢區,0338,240,168,408,40,448,1017,44.05%,23.6%,1
高雄市,燕巢區,0339,15,22,37,4,41,259,15.83%,5.79%,1
高雄市,燕巢區,0340,319,223,542,68,610,926,65.87%,34.45%,1
高雄市,燕巢區,0341,175,105,280,32,312,624,50%,28.04%,1
高雄市,燕巢區,0342,386,255,641,76,717,1102,65.06%,35.03%,1
高雄市,燕巢區,0343,312,207,519,64,583,1072,54.38%,29.1%,1
高雄市,燕巢區,0344,411,296,707,74,781,1361,57.38%,30.2%,1
高雄市,燕巢區,0345,155,96,251,36,287,472,60.81%,32.84%,1
高雄市,燕巢區,0346,354,229,583,56,639,1197,53.38%,29.57%,1
高雄市,燕巢區,0347,389,246,635,86,721,1134,63.58%,34.3%,1
高雄市,燕巢區,0348,327,248,575,46,621,1148,54.09%,28.48%,1
高雄市,燕巢區,0349,354,219,573,84,657,1207,54.43%,29.33%,1
高雄市,燕巢區,0350,529,301,830,60,890,1402,63.48%,37.73%,1
高雄市,燕巢區,0351,289,238,527,81,608,1000,60.8%,28.9%,1
高雄市,燕巢區,0352,363,246,609,67,676,1110,60.9%,32.7%,1
高雄市,燕巢區,0353,413,264,677,65,742,1291,57.47%,31.99%,1
高雄市,燕巢區,0354,214,189,403,81,484,797,60.73%,26.85%,1
高雄市,燕巢區,0355,309,192,501,67,568,1098,51.73%,28.14%,1
高雄市,燕巢區,0356,403,271,674,77,751,1393,53.91%,28.93%,1
高雄市,燕巢區,0357,374,79,453,25,478,1079,44.3%,34.66%,1
高雄市,田寮區,0237,91,54,145,8,153,369,41.46%,24.66%,1
高雄市,田寮區,0238,164,94,258,19,277,656,42.23%,25%,1
高雄市,田寮區,0239,64,50,114,10,124,406,30.54%,15.76%,1
高雄市,田寮區,0240,97,75,172,21,193,380,50.79%,25.53%,1
高雄市,田寮區,0241,112,69,181,14,195,379,51.45%,29.55%,1
高雄市,田寮區,0242,185,114,299,56,355,625,56.8%,29.6%,1
高雄市,田寮區,0243,241,180,421,26,447,946,47.25%,25.48%,1
高雄市,田寮區,0244,206,130,336,43,379,794,47.73%,25.94%,1
高雄市,田寮區,0245,96,52,148,21,169,382,44.24%,25.13%,1
高雄市,田寮區,0246,87,57,144,55,199,513,38.79%,16.96%,1
高雄市,田寮區,0247,159,117,276,18,294,601,48.92%,26.46%,1
高雄市,田寮區,0248,188,109,297,63,360,620,58.06%,30.32%,1
高雄市,阿蓮區,0216,301,267,568,40,608,1299,46.81%,23.17%,1
高雄市,阿蓮區,0217,296,256,552,36,588,1107,53.12%,26.74%,1
高雄市,阿蓮區,0218,228,180,408,38,446,898,49.67%,25.39%,1
高雄市,阿蓮區,0219,349,262,611,79,690,1259,54.81%,27.72%,1
高雄市,阿蓮區,0220,420,346,766,58,824,1579,52.18%,26.6%,1
高雄市,阿蓮區,0221,179,130,309,13,322,564,57.09%,31.74%,1
高雄市,阿蓮區,0222,269,177,446,50,496,768,64.58%,35.03%,1
高雄市,阿蓮區,0223,304,284,588,51,639,1092,58.52%,27.84%,1
高雄市,阿蓮區,0224,309,252,561,67,628,1099,57.14%,28.12%,1
高雄市,阿蓮區,0225,376,221,597,37,634,1134,55.91%,33.16%,1
高雄市,阿蓮區,0226,519,229,748,34,782,1561,50.1%,33.25%,1
高雄市,阿蓮區,0227,429,352,781,120,901,1533,58.77%,27.98%,1
高雄市,阿蓮區,0228,300,223,523,37,560,1116,50.18%,26.88%,1
高雄市,阿蓮區,0229,287,224,511,50,561,1054,53.23%,27.23%,1
高雄市,阿蓮區,0230,372,247,619,63,682,1260,54.13%,29.52%,1
高雄市,阿蓮區,0231,409,309,718,78,796,1504,52.93%,27.19%,1
高雄市,阿蓮區,0232,197,185,382,24,406,848,47.88%,23.23%,1
高雄市,阿蓮區,0233,228,170,398,27,425,823,51.64%,27.7%,1
高雄市,阿蓮區,0234,295,225,520,39,559,1021,54.75%,28.89%,1
高雄市,阿蓮區,0235,469,320,789,60,849,1715,49.5%,27.35%,1
高雄市,阿蓮區,0236,354,266,620,65,685,1300,52.69%,27.23%,1
高雄市,路竹區,0175,300,194,494,32,526,1026,51.27%,29.24%,1
高雄市,路竹區,0176,328,226,554,74,628,1069,58.75%,30.68%,1
高雄市,路竹區,0177,352,262,614,77,691,1127,61.31%,31.23%,1
高雄市,路竹區,0178,357,240,597,75,672,1179,57%,30.28%,1
高雄市,路竹區,0179,351,247,598,104,702,1237,56.75%,28.38%,1
高雄市,路竹區,0180,356,234,590,66,656,1096,59.85%,32.48%,1
高雄市,路竹區,0181,423,294,717,82,799,1272,62.81%,33.25%,1
高雄市,路竹區,0182,386,243,629,70,699,1182,59.14%,32.66%,1
高雄市,路竹區,0183,374,223,597,55,652,1127,57.85%,33.19%,1
高雄市,路竹區,0184,303,214,517,56,573,956,59.94%,31.69%,1
高雄市,路竹區,0185,354,238,592,72,664,1132,58.66%,31.27%,1
高雄市,路竹區,0186,332,229,561,95,656,1025,64%,32.39%,1
高雄市,路竹區,0187,262,247,509,35,544,1007,54.02%,26.02%,1
高雄市,路竹區,0188,388,236,624,70,694,1301,53.34%,29.82%,1
高雄市,路竹區,0189,265,205,470,39,509,885,57.51%,29.94%,1
高雄市,路竹區,0190,207,168,375,20,395,837,47.19%,24.73%,1
高雄市,路竹區,0191,290,210,500,65,565,930,60.75%,31.18%,1
高雄市,路竹區,0192,196,156,352,52,404,781,51.73%,25.1%,1
高雄市,路竹區,0193,297,238,535,74,609,1023,59.53%,29.03%,1
高雄市,路竹區,0194,562,399,961,83,1044,1763,59.22%,31.88%,1
高雄市,路竹區,0195,477,383,860,57,917,1637,56.02%,29.14%,1
高雄市,路竹區,0196,295,236,531,63,594,1070,55.51%,27.57%,1
高雄市,路竹區,0197,384,272,656,61,717,1177,60.92%,32.63%,1
高雄市,路竹區,0198,293,239,532,60,592,1007,58.79%,29.1%,1
高雄市,路竹區,0199,302,240,542,48,590,1026,57.5%,29.43%,1
高雄市,路竹區,0200,326,210,536,60,596,1017,58.6%,32.06%,1
高雄市,路竹區,0201,410,280,690,52,742,1264,58.7%,32.44%,1
高雄市,路竹區,0202,342,244,586,74,660,1089,60.61%,31.4%,1
高雄市,路竹區,0203,304,158,462,38,500,851,58.75%,35.72%,1
高雄市,路竹區,0204,307,233,540,91,631,1011,62.41%,30.37%,1
高雄市,路竹區,0205,339,231,570,33,603,937,64.35%,36.18%,1
高雄市,路竹區,0206,213,147,360,19,379,820,46.22%,25.98%,1
高雄市,路竹區,0207,275,259,534,35,569,910,62.53%,30.22%,1
高雄市,路竹區,0208,249,187,436,58,494,867,56.98%,28.72%,1
高雄市,路竹區,0209,280,225,505,32,537,937,57.31%,29.88%,1
高雄市,路竹區,0210,279,212,491,27,518,900,57.56%,31%,1
高雄市,路竹區,0211,309,198,507,48,555,900,61.67%,34.33%,1
高雄市,路竹區,0212,308,201,509,44,553,918,60.24%,33.55%,1
高雄市,路竹區,0213,282,236,518,40,558,870,64.14%,32.41%,1
高雄市,路竹區,0214,403,260,663,57,720,1150,62.61%,35.04%,1
高雄市,路竹區,0215,567,344,911,72,983,1537,63.96%,36.89%,1
高雄市,湖內區,0151,327,204,531,29,560,1112,50.36%,29.41%,1
高雄市,湖內區,0152,285,207,492,91,583,1017,57.33%,28.02%,1
高雄市,湖內區,0153,204,174,378,33,411,796,51.63%,25.63%,1
高雄市,湖內區,0154,355,256,611,38,649,1079,60.15%,32.9%,1
高雄市,湖內區,0155,325,255,580,34,614,1115,55.07%,29.15%,1
高雄市,湖內區,0156,375,266,641,45,686,1311,52.33%,28.6%,1
高雄市,湖內區,0157,385,255,640,48,688,1319,52.16%,29.19%,1
高雄市,湖內區,0158,406,306,712,77,789,1244,63.42%,32.64%,1
高雄市,湖內區,0159,426,284,710,57,767,1227,62.51%,34.72%,1
高雄市,湖內區,0160,404,241,645,67,712,1163,61.22%,34.74%,1
高雄市,湖內區,0161,321,229,550,41,591,981,60.24%,32.72%,1
高雄市,湖內區,0162,243,141,384,20,404,780,51.79%,31.15%,1
高雄市,湖內區,0163,250,168,418,56,474,832,56.97%,30.05%,1
高雄市,湖內區,0164,355,244,599,41,640,1017,62.93%,34.91%,1
高雄市,湖內區,0165,338,227,565,37,602,1051,57.28%,32.16%,1
高雄市,湖內區,0166,265,192,457,39,496,941,52.71%,28.16%,1
高雄市,湖內區,0167,229,189,418,62,480,863,55.62%,26.54%,1
高雄市,湖內區,0168,340,244,584,47,631,1160,54.4%,29.31%,1
高雄市,湖內區,0169,255,180,435,27,462,1090,42.39%,23.39%,1
高雄市,湖內區,0170,318,262,580,66,646,1122,57.58%,28.34%,1
高雄市,湖內區,0171,286,187,473,35,508,1123,45.24%,25.47%,1
高雄市,湖內區,0172,170,155,325,35,360,684,52.63%,24.85%,1
高雄市,湖內區,0173,335,239,574,39,613,1249,49.08%,26.82%,1
高雄市,湖內區,0174,382,270,652,65,717,1453,49.35%,26.29%,1
高雄市,茄萣區,0130,237,183,420,22,442,976,45.29%,24.28%,1
高雄市,茄萣區,0131,255,163,418,67,485,887,54.68%,28.75%,1
高雄市,茄萣區,0132,457,343,800,49,849,1710,49.65%,26.73%,1
高雄市,茄萣區,0133,267,242,509,53,562,1280,43.91%,20.86%,1
高雄市,茄萣區,0134,413,272,685,42,727,1314,55.33%,31.43%,1
高雄市,茄萣區,0135,370,279,649,37,686,1157,59.29%,31.98%,1
高雄市,茄萣區,0136,497,366,863,121,984,1785,55.13%,27.84%,1
高雄市,茄萣區,0137,213,178,391,98,489,838,58.35%,25.42%,1
高雄市,茄萣區,0138,400,314,714,83,797,1249,63.81%,32.03%,1
高雄市,茄萣區,0139,300,213,513,97,610,1116,54.66%,26.88%,1
高雄市,茄萣區,0140,228,194,422,56,478,978,48.88%,23.31%,1
高雄市,茄萣區,0141,290,171,461,40,501,1125,44.53%,25.78%,1
高雄市,茄萣區,0142,298,260,558,65,623,1139,54.7%,26.16%,1
高雄市,茄萣區,0143,365,278,643,111,754,1363,55.32%,26.78%,1
高雄市,茄萣區,0144,457,362,819,114,933,1598,58.39%,28.6%,1
高雄市,茄萣區,0145,295,224,519,74,593,1111,53.38%,26.55%,1
高雄市,茄萣區,0146,219,159,378,45,423,925,45.73%,23.68%,1
高雄市,茄萣區,0147,315,225,540,75,615,1148,53.57%,27.44%,1
高雄市,茄萣區,0148,200,424,624,46,670,1353,49.52%,14.78%,1
高雄市,茄萣區,0149,373,272,645,76,721,1331,54.17%,28.02%,1
高雄市,茄萣區,0150,476,331,807,83,890,1829,48.66%,26.03%,1
高雄市,永安區,0249,282,167,449,53,502,756,66.4%,37.3%,1
高雄市,永安區,0250,264,180,444,72,516,818,63.08%,32.27%,1
高雄市,永安區,0251,321,229,550,46,596,866,68.82%,37.07%,1
高雄市,永安區,0252,337,199,536,79,615,951,64.67%,35.44%,1
高雄市,永安區,0253,335,225,560,65,625,992,63%,33.77%,1
高雄市,永安區,0254,165,121,286,24,310,682,45.45%,24.19%,1
高雄市,永安區,0255,199,154,353,28,381,665,57.29%,29.92%,1
高雄市,永安區,0256,122,63,185,19,204,371,54.99%,32.88%,1
高雄市,永安區,0257,391,272,663,68,731,1114,65.62%,35.1%,1
高雄市,永安區,0258,503,327,830,49,879,1418,61.99%,35.47%,1
高雄市,永安區,0259,524,340,864,98,962,1477,65.13%,35.48%,1
高雄市,永安區,0260,660,430,1090,98,1188,1891,62.82%,34.9%,1
高雄市,彌陀區,0358,380,301,681,70,751,1246,60.27%,30.5%,1
高雄市,彌陀區,0359,271,211,482,65,547,885,61.81%,30.62%,1
高雄市,彌陀區,0360,364,210,574,73,647,955,67.75%,38.12%,1
高雄市,彌陀區,0361,156,113,269,46,315,534,58.99%,29.21%,1
高雄市,彌陀區,0362,232,176,408,40,448,738,60.7%,31.44%,1
高雄市,彌陀區,0363,317,200,517,58,575,855,67.25%,37.08%,1
高雄市,彌陀區,0364,285,207,492,65,557,877,63.51%,32.5%,1
高雄市,彌陀區,0365,279,160,439,67,506,781,64.79%,35.72%,1
高雄市,彌陀區,0366,249,190,439,34,473,808,58.54%,30.82%,1
高雄市,彌陀區,0367,239,177,416,41,457,904,50.55%,26.44%,1
高雄市,彌陀區,0368,279,168,447,54,501,825,60.73%,33.82%,1
高雄市,彌陀區,0369,200,252,452,65,517,941,54.94%,21.25%,1
高雄市,彌陀區,0370,296,225,521,44,565,1013,55.77%,29.22%,1
高雄市,彌陀區,0371,353,220,573,72,645,1024,62.99%,34.47%,1
高雄市,彌陀區,0372,261,156,417,28,445,861,51.68%,30.31%,1
高雄市,彌陀區,0373,369,272,641,88,729,1163,62.68%,31.73%,1
高雄市,彌陀區,0374,439,252,691,98,789,1216,64.88%,36.1%,1
高雄市,彌陀區,0375,324,214,538,86,624,861,72.47%,37.63%,1
高雄市,梓官區,0376,350,247,597,76,673,1061,63.43%,32.99%,1
高雄市,梓官區,0377,337,228,565,70,635,1063,59.74%,31.7%,1
高雄市,梓官區,0378,254,258,512,41,553,969,57.07%,26.21%,1
高雄市,梓官區,0379,291,224,515,30,545,1078,50.56%,26.99%,1
高雄市,梓官區,0380,244,219,463,57,520,838,62.05%,29.12%,1
高雄市,梓官區,0381,191,149,340,47,387,611,63.34%,31.26%,1
高雄市,梓官區,0382,248,158,406,41,447,782,57.16%,31.71%,1
高雄市,梓官區,0383,515,330,845,101,946,1451,65.2%,35.49%,1
高雄市,梓官區,0384,343,243,586,30,616,1144,53.85%,29.98%,1
高雄市,梓官區,0385,271,187,458,27,485,975,49.74%,27.79%,1
高雄市,梓官區,0386,398,288,686,56,742,1317,56.34%,30.22%,1
高雄市,梓官區,0387,378,280,658,93,751,1218,61.66%,31.03%,1
高雄市,梓官區,0388,348,226,574,50,624,1073,58.15%,32.43%,1
高雄市,梓官區,0389,300,214,514,50,564,1112,50.72%,26.98%,1
高雄市,梓官區,0390,196,154,350,51,401,715,56.08%,27.41%,1
高雄市,梓官區,0391,360,266,626,68,694,1311,52.94%,27.46%,1
高雄市,梓官區,0392,272,205,477,46,523,939,55.7%,28.97%,1
高雄市,梓官區,0393,289,199,488,28,516,824,62.62%,35.07%,1
高雄市,梓官區,0394,359,227,586,109,695,1052,66.06%,34.13%,1
高雄市,梓官區,0395,322,222,544,103,647,1020,63.43%,31.57%,1
高雄市,梓官區,0396,368,243,611,39,650,1260,51.59%,29.21%,1
高雄市,梓官區,0397,504,305,809,49,858,1595,53.79%,31.6%,1
高雄市,梓官區,0398,282,174,456,42,498,829,60.07%,34.02%,1
高雄市,梓官區,0399,482,295,777,28,805,1532,52.55%,31.46%,1
高雄市,梓官區,0400,368,319,687,78,765,1195,64.02%,30.79%,1
高雄市,梓官區,0401,388,232,620,87,707,1143,61.85%,33.95%,1
高雄市,梓官區,0402,367,297,664,72,736,1186,62.06%,30.94%,1
高雄市,梓官區,0403,515,254,769,56,825,1732,47.63%,29.73%,1
高雄市,旗山區,0060,358,226,584,51,635,1060,59.91%,33.77%,1
高雄市,旗山區,0061,305,214,519,71,590,1125,52.44%,27.11%,1
高雄市,旗山區,0062,387,223,610,41,651,1100,59.18%,35.18%,1
高雄市,旗山區,0063,417,276,693,28,721,1238,58.24%,33.68%,1
高雄市,旗山區,0064,315,191,506,25,531,933,56.91%,33.76%,1
高雄市,旗山區,0065,190,144,334,18,352,727,48.42%,26.13%,1
高雄市,旗山區,0066,345,201,546,51,597,1071,55.74%,32.21%,1
高雄市,旗山區,0067,218,136,354,32,386,744,51.88%,29.3%,1
高雄市,旗山區,0068,277,204,481,37,518,1100,47.09%,25.18%,1
高雄市,旗山區,0069,103,67,170,23,193,369,52.3%,27.91%,1
高雄市,旗山區,0070,217,149,366,20,386,888,43.47%,24.44%,1
高雄市,旗山區,0071,113,82,195,9,204,510,40%,22.16%,1
高雄市,旗山區,0072,322,235,557,91,648,1042,62.19%,30.9%,1
高雄市,旗山區,0073,235,143,378,53,431,791,54.49%,29.71%,1
高雄市,旗山區,0074,308,182,490,79,569,939,60.6%,32.8%,1
高雄市,旗山區,0075,311,246,557,45,602,1218,49.43%,25.53%,1
高雄市,旗山區,0076,54,24,78,19,97,178,54.49%,30.34%,1
高雄市,旗山區,0077,317,213,530,59,589,946,62.26%,33.51%,1
高雄市,旗山區,0078,295,216,511,46,557,1025,54.34%,28.78%,1
高雄市,旗山區,0079,354,198,552,148,700,1040,67.31%,34.04%,1
高雄市,旗山區,0080,304,217,521,56,577,900,64.11%,33.78%,1
高雄市,旗山區,0081,199,112,311,24,335,663,50.53%,30.02%,1
高雄市,旗山區,0082,285,186,471,63,534,954,55.97%,29.87%,1
高雄市,旗山區,0083,309,222,531,32,563,1060,53.11%,29.15%,1
高雄市,旗山區,0084,360,240,600,64,664,1110,59.82%,32.43%,1
高雄市,旗山區,0085,345,218,563,68,631,1062,59.42%,32.49%,1
高雄市,旗山區,0086,369,223,592,48,640,1151,55.6%,32.06%,1
高雄市,旗山區,0087,69,71,140,25,165,266,62.03%,25.94%,1
高雄市,旗山區,0088,204,139,343,43,386,633,60.98%,32.23%,1
高雄市,旗山區,0089,365,221,586,44,630,1307,48.2%,27.93%,1
高雄市,旗山區,0090,188,161,349,73,422,754,55.97%,24.93%,1
高雄市,旗山區,0091,362,284,646,103,749,1296,57.79%,27.93%,1
高雄市,旗山區,0092,215,147,362,16,378,839,45.05%,25.63%,1
高雄市,旗山區,0093,427,264,691,59,750,1329,56.43%,32.13%,1
高雄市,旗山區,0094,211,127,338,34,372,628,59.24%,33.6%,1
高雄市,美濃區,0095,326,271,597,94,691,1175,58.81%,27.74%,1
高雄市,美濃區,0096,390,259,649,43,692,1438,48.12%,27.12%,1
高雄市,美濃區,0097,255,197,452,53,505,989,51.06%,25.78%,1
高雄市,美濃區,0098,430,316,746,80,826,1427,57.88%,30.13%,1
高雄市,美濃區,0099,403,270,673,64,737,1309,56.3%,30.79%,1
高雄市,美濃區,0100,389,316,705,64,769,1263,60.89%,30.8%,1
高雄市,美濃區,0101,312,203,515,82,597,997,59.88%,31.29%,1
高雄市,美濃區,0102,334,217,551,62,613,1064,57.61%,31.39%,1
高雄市,美濃區,0103,444,285,729,88,817,1498,54.54%,29.64%,1
高雄市,美濃區,0104,330,236,566,90,656,1119,58.62%,29.49%,1
高雄市,美濃區,0105,322,216,538,60,598,1031,58%,31.23%,1
高雄市,美濃區,0106,411,273,684,83,767,1437,53.38%,28.6%,1
高雄市,美濃區,0107,342,205,547,62,609,1071,56.86%,31.93%,1
高雄市,美濃區,0108,208,140,348,38,386,687,56.19%,30.28%,1
高雄市,美濃區,0109,175,121,296,22,318,775,41.03%,22.58%,1
高雄市,美濃區,0110,355,265,620,79,699,1353,51.66%,26.24%,1
高雄市,美濃區,0111,313,234,547,45,592,1191,49.71%,26.28%,1
高雄市,美濃區,0112,245,142,387,47,434,906,47.9%,27.04%,1
高雄市,美濃區,0113,386,248,634,60,694,1178,58.91%,32.77%,1
高雄市,美濃區,0114,353,207,560,33,593,1252,47.36%,28.19%,1
高雄市,美濃區,0115,476,315,791,70,861,1549,55.58%,30.73%,1
高雄市,美濃區,0116,311,193,504,50,554,1088,50.92%,28.58%,1
高雄市,美濃區,0117,363,224,587,48,635,1116,56.9%,32.53%,1
高雄市,美濃區,0118,305,182,487,41,528,977,54.04%,31.22%,1
高雄市,美濃區,0119,259,178,437,74,511,816,62.62%,31.74%,1
高雄市,美濃區,0120,266,133,399,32,431,955,45.13%,27.85%,1
高雄市,美濃區,0121,295,187,482,68,550,943,58.32%,31.28%,1
高雄市,美濃區,0122,397,254,651,56,707,1371,51.57%,28.96%,1
高雄市,美濃區,0123,263,190,453,62,515,919,56.04%,28.62%,1
高雄市,美濃區,0124,304,206,510,53,563,915,61.53%,33.22%,1
高雄市,美濃區,0125,214,171,385,71,456,828,55.07%,25.85%,1
高雄市,美濃區,0126,134,113,247,72,319,674,47.33%,19.88%,1
高雄市,六龜區,0020,196,143,339,35,374,760,49.21%,25.79%,1
高雄市,六龜區,0021,159,101,260,49,309,666,46.4%,23.87%,1
高雄市,六龜區,0022,212,129,341,58,399,704,56.68%,30.11%,1
高雄市,六龜區,0023,257,193,450,60,510,1003,50.85%,25.62%,1
高雄市,六龜區,0024,333,208,541,114,655,1382,47.4%,24.1%,1
高雄市,六龜區,0025,207,133,340,74,414,986,41.99%,20.99%,1
高雄市,六龜區,0026,284,189,473,52,525,1046,50.19%,27.15%,1
高雄市,六龜區,0027,181,137,318,62,380,812,46.8%,22.29%,1
高雄市,六龜區,0028,338,251,589,72,661,1431,46.19%,23.62%,1
高雄市,六龜區,0029,254,151,405,71,476,912,52.19%,27.85%,1
高雄市,六龜區,0030,321,203,524,51,575,1472,39.06%,21.81%,1
高雄市,六龜區,0031,63,52,115,29,144,327,44.04%,19.27%,1
高雄市,甲仙區,0013,97,61,158,9,167,472,35.38%,20.55%,1
高雄市,甲仙區,0014,284,191,475,77,552,882,62.59%,32.2%,1
高雄市,甲仙區,0015,177,127,304,48,352,668,52.69%,26.5%,1
高雄市,甲仙區,0016,381,276,657,137,794,1581,50.22%,24.1%,1
高雄市,甲仙區,0017,121,80,201,12,213,673,31.65%,17.98%,1
高雄市,甲仙區,0018,141,101,242,42,284,607,46.79%,23.23%,1
高雄市,甲仙區,0019,128,98,226,25,251,534,47%,23.97%,1
高雄市,杉林區,0032,161,98,259,55,314,640,49.06%,25.16%,1
高雄市,杉林區,0033,146,128,274,28,302,696,43.39%,20.98%,1
高雄市,杉林區,0034,223,175,398,59,457,1284,35.59%,17.37%,1
高雄市,杉林區,0035,221,178,399,39,438,1027,42.65%,21.52%,1
高雄市,杉林區,0036,126,65,191,35,226,482,46.89%,26.14%,1
高雄市,杉林區,0037,444,343,787,115,902,1627,55.44%,27.29%,1
高雄市,杉林區,0038,435,242,677,46,723,1630,44.36%,26.69%,1
高雄市,杉林區,0039,198,123,321,29,350,973,35.97%,20.35%,1
高雄市,杉林區,0040,201,159,360,31,391,987,39.61%,20.36%,1
高雄市,杉林區,0041,355,225,580,84,664,1261,52.66%,28.15%,1
高雄市,內門區,0042,211,163,374,65,439,969,45.3%,21.78%,1
高雄市,內門區,0043,130,94,224,23,247,652,37.88%,19.94%,1
高雄市,內門區,0044,262,168,430,82,512,961,53.28%,27.26%,1
高雄市,內門區,0045,96,66,162,8,170,426,39.91%,22.54%,1
高雄市,內門區,0046,97,68,165,17,182,398,45.73%,24.37%,1
高雄市,內門區,0047,131,68,199,19,218,508,42.91%,25.79%,1
高雄市,內門區,0048,312,196,508,66,574,980,58.57%,31.84%,1
高雄市,內門區,0049,269,208,477,60,537,1225,43.84%,21.96%,1
高雄市,內門區,0050,465,322,787,159,946,1722,54.94%,27%,1
高雄市,內門區,0051,130,110,240,35,275,560,49.11%,23.21%,1
高雄市,內門區,0052,180,116,296,22,318,801,39.7%,22.47%,1
高雄市,內門區,0053,103,92,195,21,216,423,51.06%,24.35%,1
高雄市,內門區,0054,115,89,204,32,236,497,47.48%,23.14%,1
高雄市,內門區,0055,173,109,282,33,315,677,46.53%,25.55%,1
高雄市,內門區,0056,110,72,182,15,197,593,33.22%,18.55%,1
高雄市,內門區,0057,111,82,193,54,247,597,41.37%,18.59%,1
高雄市,內門區,0058,86,43,129,14,143,343,41.69%,25.07%,1
高雄市,內門區,0059,190,124,314,53,367,670,54.78%,28.36%,1
高雄市,茂林區,0127,195,128,323,33,356,507,70.22%,38.46%,1
高雄市,茂林區,0128,159,77,236,25,261,382,68.32%,41.62%,1
高雄市,茂林區,0129,283,147,430,22,452,726,62.26%,38.98%,1
高雄市,桃源區,0001,48,34,82,1,83,264,31.44%,18.18%,1
高雄市,桃源區,0002,96,58,154,17,171,233,73.39%,41.2%,1
高雄市,桃源區,0003,101,67,168,8,176,279,63.08%,36.2%,1
高雄市,桃源區,0004,52,55,107,6,113,223,50.67%,23.32%,1
高雄市,桃源區,0005,196,112,308,17,325,783,41.51%,25.03%,1
高雄市,桃源區,0006,144,89,233,12,245,632,38.77%,22.78%,1
高雄市,桃源區,0007,246,129,375,40,415,612,67.81%,40.2%,1
高雄市,桃源區,0008,141,88,229,21,250,472,52.97%,29.87%,1
高雄市,那瑪夏區,0009,176,120,296,47,343,741,46.29%,23.75%,1
高雄市,那瑪夏區,0010,211,125,336,81,417,585,71.28%,36.07%,1
高雄市,那瑪夏區,0011,270,133,403,63,466,609,76.52%,44.33%,1
高雄市,那瑪夏區,0012,88,69,157,10,167,489,34.15%,18%,1
新竹縣,竹北市,0001,512,311,823,30,853,1319,64.67%,38.82%,1
新竹縣,竹北市,0002,467,312,779,24,803,1321,60.79%,35.35%,1
新竹縣,竹北市,0003,448,307,755,48,803,1272,63.13%,35.22%,1
新竹縣,竹北市,0004,503,302,805,44,849,1467,57.87%,34.29%,1
新竹縣,竹北市,0005,412,273,685,16,701,1226,57.18%,33.61%,1
新竹縣,竹北市,0006,446,341,787,15,802,1412,56.8%,31.59%,1
新竹縣,竹北市,0007,519,342,861,18,879,1400,62.79%,37.07%,1
新竹縣,竹北市,0008,476,369,845,35,880,1415,62.19%,33.64%,1
新竹縣,竹北市,0009,457,302,759,36,795,1361,58.41%,33.58%,1
新竹縣,竹北市,0010,484,327,811,26,837,1515,55.25%,31.95%,1
新竹縣,竹北市,0011,365,512,877,17,894,1495,59.8%,24.41%,1
新竹縣,竹北市,0012,501,318,819,20,839,1417,59.21%,35.36%,1
新竹縣,竹北市,0013,461,391,852,37,889,1548,57.43%,29.78%,1
新竹縣,竹北市,0014,446,328,774,31,805,1434,56.14%,31.1%,1
新竹縣,竹北市,0015,486,283,769,43,812,1385,58.63%,35.09%,1
新竹縣,竹北市,0016,439,322,761,36,797,1247,63.91%,35.2%,1
新竹縣,竹北市,0017,431,340,771,28,799,1373,58.19%,31.39%,1
新竹縣,竹北市,0018,498,331,829,30,859,1345,63.87%,37.03%,1
新竹縣,竹北市,0019,391,244,635,37,672,1165,57.68%,33.56%,1
新竹縣,竹北市,0020,399,292,691,57,748,1164,64.26%,34.28%,1
新竹縣,竹北市,0021,422,292,714,41,755,1212,62.29%,34.82%,1
新竹縣,竹北市,0022,455,274,729,33,762,1507,50.56%,30.19%,1
新竹縣,竹北市,0023,504,266,770,48,818,1576,51.9%,31.98%,1
新竹縣,竹北市,0024,463,325,788,39,827,1464,56.49%,31.63%,1
新竹縣,竹北市,0025,441,336,777,41,818,1428,57.28%,30.88%,1
新竹縣,竹北市,0026,576,123,699,29,728,1442,50.49%,39.94%,1
新竹縣,竹北市,0027,463,308,771,70,841,1415,59.43%,32.72%,1
新竹縣,竹北市,0028,486,336,822,28,850,1666,51.02%,29.17%,1
新竹縣,竹北市,0029,521,371,892,50,942,1751,53.8%,29.75%,1
新竹縣,竹北市,0030,403,307,710,25,735,1196,61.45%,33.7%,1
新竹縣,竹北市,0031,415,300,715,29,744,1235,60.24%,33.6%,1
新竹縣,竹北市,0032,363,301,664,21,685,1204,56.89%,30.15%,1
新竹縣,竹北市,0033,444,320,764,36,800,1308,61.16%,33.94%,1
新竹縣,竹北市,0034,403,286,689,18,707,1233,57.34%,32.68%,1
新竹縣,竹北市,0035,391,260,651,21,672,1129,59.52%,34.63%,1
新竹縣,竹北市,0036,391,242,633,29,662,1069,61.93%,36.58%,1
新竹縣,竹北市,0037,381,283,664,48,712,1114,63.91%,34.2%,1
新竹縣,竹北市,0038,400,242,642,37,679,1103,61.56%,36.26%,1
新竹縣,竹北市,0039,370,265,635,35,670,1029,65.11%,35.96%,1
新竹縣,竹北市,0040,427,268,695,36,731,1133,64.52%,37.69%,1
新竹縣,竹北市,0041,429,310,739,22,761,1301,58.49%,32.97%,1
新竹縣,竹北市,0042,601,402,1003,50,1053,1798,58.57%,33.43%,1
新竹縣,竹北市,0043,503,301,804,48,852,1427,59.71%,35.25%,1
新竹縣,竹北市,0044,555,310,865,45,910,1462,62.24%,37.96%,1
新竹縣,竹北市,0045,507,303,810,37,847,1342,63.11%,37.78%,1
新竹縣,竹北市,0046,575,300,875,32,907,1480,61.28%,38.85%,1
新竹縣,竹北市,0047,524,379,903,29,932,1645,56.66%,31.85%,1
新竹縣,竹北市,0048,466,301,767,30,797,1256,63.46%,37.1%,1
新竹縣,竹北市,0049,377,306,683,40,723,1181,61.22%,31.92%,1
新竹縣,竹北市,0050,500,308,808,53,861,1329,64.79%,37.62%,1
新竹縣,竹北市,0051,456,299,755,31,786,1228,64.01%,37.13%,1
新竹縣,竹北市,0052,492,334,826,50,876,1552,56.44%,31.7%,1
新竹縣,竹北市,0053,538,324,862,31,893,1480,60.34%,36.35%,1
新竹縣,竹北市,0054,436,325,761,43,804,1487,54.07%,29.32%,1
新竹縣,竹北市,0055,451,296,747,57,804,1470,54.69%,30.68%,1
新竹縣,竹北市,0056,460,277,737,49,786,1477,53.22%,31.14%,1
新竹縣,竹北市,0057,572,352,924,60,984,1611,61.08%,35.51%,1
新竹縣,竹北市,0058,525,309,834,77,911,1555,58.59%,33.76%,1
新竹縣,竹北市,0059,435,315,750,49,799,1468,54.43%,29.63%,1
新竹縣,竹北市,0060,528,314,842,58,900,1509,59.64%,34.99%,1
新竹縣,竹北市,0061,479,355,834,57,891,1602,55.62%,29.9%,1
新竹縣,竹北市,0062,501,302,803,61,864,1448,59.67%,34.6%,1
新竹縣,竹北市,0063,466,250,716,80,796,1318,60.39%,35.36%,1
新竹縣,竹北市,0064,546,384,930,71,1001,1634,61.26%,33.41%,1
新竹縣,竹北市,0065,401,303,704,68,772,1345,57.4%,29.81%,1
新竹縣,竹北市,0066,349,242,591,35,626,958,65.34%,36.43%,1
新竹縣,竹北市,0067,410,242,652,51,703,1112,63.22%,36.87%,1
新竹縣,竹北市,0068,357,246,603,66,669,1134,58.99%,31.48%,1
新竹縣,竹北市,0069,490,322,812,43,855,1483,57.65%,33.04%,1
新竹縣,竹北市,0070,429,264,693,55,748,1332,56.16%,32.21%,1
新竹縣,竹北市,0071,430,292,722,45,767,1482,51.75%,29.01%,1
新竹縣,竹北市,0072,338,255,593,28,621,1449,42.86%,23.33%,1
新竹縣,竹北市,0073,413,270,683,33,716,1319,54.28%,31.31%,1
新竹縣,竹北市,0074,393,285,678,51,729,1332,54.73%,29.5%,1
新竹縣,竹北市,0075,433,285,718,34,752,1412,53.26%,30.67%,1
新竹縣,竹北市,0076,453,370,823,57,880,1640,53.66%,27.62%,1
新竹縣,竹北市,0077,426,282,708,44,752,1323,56.84%,32.2%,1
新竹縣,竹北市,0078,466,330,796,59,855,1428,59.87%,32.63%,1
新竹縣,竹北市,0079,496,335,831,62,893,1533,58.25%,32.35%,1
新竹縣,竹北市,0080,384,290,674,32,706,1346,52.45%,28.53%,1
新竹縣,竹北市,0081,385,223,608,61,669,1219,54.88%,31.58%,1
新竹縣,竹北市,0082,489,341,830,67,897,1466,61.19%,33.36%,1
新竹縣,竹北市,0083,335,257,592,40,632,1147,55.1%,29.21%,1
新竹縣,竹北市,0084,505,200,705,46,751,1529,49.12%,33.03%,1
新竹縣,竹北市,0085,518,306,824,54,878,1522,57.69%,34.03%,1
新竹縣,竹北市,0086,429,337,766,66,832,1383,60.16%,31.02%,1
新竹縣,竹北市,0087,499,344,843,59,902,1569,57.49%,31.8%,1
新竹縣,竹北市,0088,486,265,751,38,789,1506,52.39%,32.27%,1
新竹縣,竹北市,0089,280,191,471,36,507,877,57.81%,31.93%,1
新竹縣,竹北市,0090,361,219,580,48,628,1074,58.47%,33.61%,1
新竹縣,竹北市,0091,388,256,644,61,705,1089,64.74%,35.63%,1
新竹縣,竹北市,0092,428,298,726,67,793,1336,59.36%,32.04%,1
新竹縣,竹北市,0093,319,223,542,64,606,1058,57.28%,30.15%,1
新竹縣,竹北市,0094,328,239,567,59,626,937,66.81%,35.01%,1
新竹縣,竹北市,0095,368,254,622,70,692,1206,57.38%,30.51%,1
新竹縣,竹北市,0096,349,272,621,67,688,1205,57.1%,28.96%,1
新竹縣,竹北市,0097,559,383,942,86,1028,1718,59.84%,32.54%,1
新竹縣,竹北市,0098,265,202,467,59,526,917,57.36%,28.9%,1
新竹縣,竹北市,0099,228,142,370,37,407,668,60.93%,34.13%,1
新竹縣,竹北市,0100,235,174,409,49,458,824,55.58%,28.52%,1
新竹縣,竹北市,0101,237,153,390,75,465,782,59.46%,30.31%,1
新竹縣,竹北市,0102,317,205,522,79,601,977,61.51%,32.45%,1
新竹縣,竹北市,0103,229,200,429,28,457,937,48.77%,24.44%,1
新竹縣,竹東鎮,0104,82,55,137,17,154,309,49.84%,26.54%,1
新竹縣,竹東鎮,0105,94,81,175,38,213,416,51.2%,22.6%,1
新竹縣,竹東鎮,0106,116,65,181,12,193,386,50%,30.05%,1
新竹縣,竹東鎮,0107,378,61,439,33,472,950,49.68%,39.79%,1
新竹縣,竹東鎮,0108,405,242,647,21,668,1275,52.39%,31.76%,1
新竹縣,竹東鎮,0109,391,223,614,43,657,1213,54.16%,32.23%,1
新竹縣,竹東鎮,0110,503,316,819,48,867,1548,56.01%,32.49%,1
新竹縣,竹東鎮,0111,369,202,571,51,622,1246,49.92%,29.61%,1
新竹縣,竹東鎮,0112,306,205,511,64,575,1252,45.93%,24.44%,1
新竹縣,竹東鎮,0113,403,252,655,64,719,1359,52.91%,29.65%,1
新竹縣,竹東鎮,0114,333,278,611,58,669,1255,53.31%,26.53%,1
新竹縣,竹東鎮,0115,414,272,686,63,749,1304,57.44%,31.75%,1
新竹縣,竹東鎮,0116,414,253,667,61,728,1292,56.35%,32.04%,1
新竹縣,竹東鎮,0117,326,210,536,21,557,1111,50.14%,29.34%,1
新竹縣,竹東鎮,0118,285,188,473,52,525,880,59.66%,32.39%,1
新竹縣,竹東鎮,0119,197,166,363,30,393,670,58.66%,29.4%,1
新竹縣,竹東鎮,0120,441,243,684,43,727,1244,58.44%,35.45%,1
新竹縣,竹東鎮,0121,346,199,545,63,608,1126,54%,30.73%,1
新竹縣,竹東鎮,0122,341,196,537,51,588,1073,54.8%,31.78%,1
新竹縣,竹東鎮,0123,384,267,651,44,695,1215,57.2%,31.6%,1
新竹縣,竹東鎮,0124,386,242,628,35,663,1155,57.4%,33.42%,1
新竹縣,竹東鎮,0125,247,186,433,49,482,852,56.57%,28.99%,1
新竹縣,竹東鎮,0126,272,221,493,33,526,875,60.11%,31.09%,1
新竹縣,竹東鎮,0127,389,213,602,48,650,1070,60.75%,36.36%,1
新竹縣,竹東鎮,0128,210,136,346,33,379,704,53.84%,29.83%,1
新竹縣,竹東鎮,0129,213,137,350,32,382,951,40.17%,22.4%,1
新竹縣,竹東鎮,0130,312,230,542,21,563,984,57.22%,31.71%,1
新竹縣,竹東鎮,0131,255,197,452,25,477,1113,42.86%,22.91%,1
新竹縣,竹東鎮,0132,179,140,319,38,357,595,60%,30.08%,1
新竹縣,竹東鎮,0133,245,173,418,51,469,762,61.55%,32.15%,1
新竹縣,竹東鎮,0134,233,164,397,24,421,763,55.18%,30.54%,1
新竹縣,竹東鎮,0135,229,174,403,20,423,813,52.03%,28.17%,1
新竹縣,竹東鎮,0136,347,240,587,36,623,1310,47.56%,26.49%,1
新竹縣,竹東鎮,0137,396,239,635,70,705,1434,49.16%,27.62%,1
新竹縣,竹東鎮,0138,355,239,594,42,636,1131,56.23%,31.39%,1
新竹縣,竹東鎮,0139,305,191,496,32,528,967,54.6%,31.54%,1
新竹縣,竹東鎮,0140,334,229,563,50,613,1196,51.25%,27.93%,1
新竹縣,竹東鎮,0141,367,234,601,55,656,1154,56.85%,31.8%,1
新竹縣,竹東鎮,0142,204,190,394,43,437,715,61.12%,28.53%,1
新竹縣,竹東鎮,0143,227,144,371,18,389,685,56.79%,33.14%,1
新竹縣,竹東鎮,0144,421,240,661,59,720,1352,53.25%,31.14%,1
新竹縣,竹東鎮,0145,455,292,747,59,806,1407,57.29%,32.34%,1
新竹縣,竹東鎮,0146,441,249,690,43,733,1362,53.82%,32.38%,1
新竹縣,竹東鎮,0147,432,274,706,49,755,1330,56.77%,32.48%,1
新竹縣,竹東鎮,0148,431,275,706,79,785,1441,54.48%,29.91%,1
新竹縣,竹東鎮,0149,360,241,601,29,630,1248,50.48%,28.85%,1
新竹縣,竹東鎮,0150,317,211,528,38,566,1263,44.81%,25.1%,1
新竹縣,竹東鎮,0151,326,225,551,43,594,1232,48.21%,26.46%,1
新竹縣,竹東鎮,0152,287,218,505,38,543,1143,47.51%,25.11%,1
新竹縣,竹東鎮,0153,516,282,798,39,837,1529,54.74%,33.75%,1
新竹縣,竹東鎮,0154,338,230,568,59,627,1140,55%,29.65%,1
新竹縣,竹東鎮,0155,186,149,335,31,366,570,64.21%,32.63%,1
新竹縣,竹東鎮,0156,387,230,617,38,655,1345,48.7%,28.77%,1
新竹縣,竹東鎮,0157,399,243,642,94,736,1381,53.29%,28.89%,1
新竹縣,竹東鎮,0158,412,293,705,60,765,1379,55.47%,29.88%,1
新竹縣,竹東鎮,0159,340,207,547,56,603,1033,58.37%,32.91%,1
新竹縣,竹東鎮,0160,344,202,546,37,583,1066,54.69%,32.27%,1
新竹縣,竹東鎮,0161,283,217,500,56,556,938,59.28%,30.17%,1
新竹縣,竹東鎮,0162,323,210,533,54,587,952,61.66%,33.93%,1
新竹縣,竹東鎮,0163,528,305,833,52,885,1468,60.29%,35.97%,1
新竹縣,竹東鎮,0164,496,431,927,45,972,1915,50.76%,25.9%,1
新竹縣,竹東鎮,0165,331,250,581,55,636,1220,52.13%,27.13%,1
新竹縣,竹東鎮,0166,302,208,510,22,532,1166,45.63%,25.9%,1
新竹縣,竹東鎮,0167,433,238,671,44,715,1492,47.92%,29.02%,1
新竹縣,竹東鎮,0168,377,242,619,40,659,1245,52.93%,30.28%,1
新竹縣,竹東鎮,0169,341,221,562,63,625,1083,57.71%,31.49%,1
新竹縣,竹東鎮,0170,339,230,569,40,609,1102,55.26%,30.76%,1
新竹縣,竹東鎮,0171,346,206,552,32,584,1068,54.68%,32.4%,1
新竹縣,竹東鎮,0172,363,237,600,25,625,1097,56.97%,33.09%,1
新竹縣,竹東鎮,0173,292,152,444,37,481,962,50%,30.35%,1
新竹縣,竹東鎮,0174,281,205,486,32,518,909,56.99%,30.91%,1
新竹縣,竹東鎮,0175,163,105,268,34,302,603,50.08%,27.03%,1
新竹縣,新埔鎮,0176,354,204,558,32,590,983,60.02%,36.01%,1
新竹縣,新埔鎮,0177,204,137,341,28,369,597,61.81%,34.17%,1
新竹縣,新埔鎮,0178,360,202,562,31,593,1070,55.42%,33.64%,1
新竹縣,新埔鎮,0179,390,95,485,39,524,935,56.04%,41.71%,1
新竹縣,新埔鎮,0180,233,164,397,37,434,753,57.64%,30.94%,1
新竹縣,新埔鎮,0181,325,202,527,25,552,838,65.87%,38.78%,1
新竹縣,新埔鎮,0182,320,159,479,45,524,924,56.71%,34.63%,1
新竹縣,新埔鎮,0183,273,153,426,26,452,905,49.94%,30.17%,1
新竹縣,新埔鎮,0184,312,195,507,30,537,948,56.65%,32.91%,1
新竹縣,新埔鎮,0185,331,214,545,48,593,1017,58.31%,32.55%,1
新竹縣,新埔鎮,0186,419,256,675,43,718,1176,61.05%,35.63%,1
新竹縣,新埔鎮,0187,387,241,628,70,698,1122,62.21%,34.49%,1
新竹縣,新埔鎮,0188,239,194,433,18,451,1022,44.13%,23.39%,1
新竹縣,新埔鎮,0189,409,255,664,49,713,1429,49.9%,28.62%,1
新竹縣,新埔鎮,0190,165,101,266,38,304,451,67.41%,36.59%,1
新竹縣,新埔鎮,0191,199,179,378,33,411,724,56.77%,27.49%,1
新竹縣,新埔鎮,0192,205,146,351,43,394,617,63.86%,33.23%,1
新竹縣,新埔鎮,0193,382,238,620,59,679,1144,59.35%,33.39%,1
新竹縣,新埔鎮,0194,374,239,613,46,659,1139,57.86%,32.84%,1
新竹縣,新埔鎮,0195,289,171,460,22,482,861,55.98%,33.57%,1
新竹縣,新埔鎮,0196,300,216,516,40,556,1093,50.87%,27.45%,1
新竹縣,新埔鎮,0197,277,192,469,36,505,978,51.64%,28.32%,1
新竹縣,新埔鎮,0198,293,195,488,30,518,1040,49.81%,28.17%,1
新竹縣,新埔鎮,0199,353,217,570,50,620,1160,53.45%,30.43%,1
新竹縣,新埔鎮,0200,320,223,543,35,578,950,60.84%,33.68%,1
新竹縣,新埔鎮,0201,288,168,456,42,498,882,56.46%,32.65%,1
新竹縣,新埔鎮,0202,416,262,678,61,739,1281,57.69%,32.47%,1
新竹縣,新埔鎮,0203,366,221,587,65,652,1212,53.8%,30.2%,1
新竹縣,新埔鎮,0204,282,150,432,52,484,1013,47.78%,27.84%,1
新竹縣,新埔鎮,0205,215,146,361,41,402,630,63.81%,34.13%,1
新竹縣,關西鎮,0206,169,104,273,34,307,480,63.96%,35.21%,1
新竹縣,關西鎮,0207,286,197,483,59,542,903,60.02%,31.67%,1
新竹縣,關西鎮,0208,321,225,546,48,594,1020,58.24%,31.47%,1
新竹縣,關西鎮,0209,186,168,354,27,381,705,54.04%,26.38%,1
新竹縣,關西鎮,0210,300,238,538,46,584,1056,55.3%,28.41%,1
新竹縣,關西鎮,0211,366,273,639,59,698,1275,54.75%,28.71%,1
新竹縣,關西鎮,0212,392,296,688,66,754,1287,58.59%,30.46%,1
新竹縣,關西鎮,0213,258,168,426,40,466,771,60.44%,33.46%,1
新竹縣,關西鎮,0214,305,218,523,45,568,1046,54.3%,29.16%,1
新竹縣,關西鎮,0215,290,249,539,63,602,1030,58.45%,28.16%,1
新竹縣,關西鎮,0216,398,242,640,48,688,1208,56.95%,32.95%,1
新竹縣,關西鎮,0217,289,208,497,29,526,1095,48.04%,26.39%,1
新竹縣,關西鎮,0218,342,253,595,117,712,1350,52.74%,25.33%,1
新竹縣,關西鎮,0219,289,212,501,35,536,846,63.36%,34.16%,1
新竹縣,關西鎮,0220,405,264,669,73,742,1362,54.48%,29.74%,1
新竹縣,關西鎮,0221,241,167,408,39,447,903,49.5%,26.69%,1
新竹縣,關西鎮,0222,139,104,243,25,268,551,48.64%,25.23%,1
新竹縣,關西鎮,0223,101,71,172,20,192,461,41.65%,21.91%,1
新竹縣,關西鎮,0224,179,109,288,31,319,572,55.77%,31.29%,1
新竹縣,關西鎮,0225,252,221,473,34,507,943,53.76%,26.72%,1
新竹縣,關西鎮,0226,231,190,421,48,469,808,58.04%,28.59%,1
新竹縣,關西鎮,0227,342,200,542,41,583,923,63.16%,37.05%,1
新竹縣,關西鎮,0228,297,202,499,40,539,903,59.69%,32.89%,1
新竹縣,關西鎮,0229,334,192,526,51,577,977,59.06%,34.19%,1
新竹縣,關西鎮,0230,270,191,461,44,505,824,61.29%,32.77%,1
新竹縣,關西鎮,0231,191,126,317,25,342,559,61.18%,34.17%,1
新竹縣,關西鎮,0232,284,214,498,36,534,854,62.53%,33.26%,1
新竹縣,湖口鄉,0233,369,282,651,58,709,1393,50.9%,26.49%,1
新竹縣,湖口鄉,0234,466,345,811,57,868,1505,57.67%,30.96%,1
新竹縣,湖口鄉,0235,388,310,698,54,752,1188,63.3%,32.66%,1
新竹縣,湖口鄉,0236,387,280,667,54,721,1267,56.91%,30.54%,1
新竹縣,湖口鄉,0237,519,359,878,57,935,1668,56.06%,31.12%,1
新竹縣,湖口鄉,0238,579,336,915,83,998,1719,58.06%,33.68%,1
新竹縣,湖口鄉,0239,405,246,651,69,720,1162,61.96%,34.85%,1
新竹縣,湖口鄉,0240,531,345,876,52,928,1833,50.63%,28.97%,1
新竹縣,湖口鄉,0241,459,311,770,60,830,1444,57.48%,31.79%,1
新竹縣,湖口鄉,0242,478,284,762,76,838,1347,62.21%,35.49%,1
新竹縣,湖口鄉,0243,397,266,663,28,691,1202,57.49%,33.03%,1
新竹縣,湖口鄉,0244,262,208,470,47,517,851,60.75%,30.79%,1
新竹縣,湖口鄉,0245,418,294,712,56,768,1272,60.38%,32.86%,1
新竹縣,湖口鄉,0246,389,275,664,58,722,1275,56.63%,30.51%,1
新竹縣,湖口鄉,0247,533,366,899,65,964,1560,61.79%,34.17%,1
新竹縣,湖口鄉,0248,402,232,634,100,734,1147,63.99%,35.05%,1
新竹縣,湖口鄉,0249,563,345,908,65,973,1729,56.28%,32.56%,1
新竹縣,湖口鄉,0250,420,269,689,65,754,1402,53.78%,29.96%,1
新竹縣,湖口鄉,0251,401,248,649,57,706,1183,59.68%,33.9%,1
新竹縣,湖口鄉,0252,412,321,733,53,786,1282,61.31%,32.14%,1
新竹縣,湖口鄉,0253,441,321,762,42,804,1335,60.22%,33.03%,1
新竹縣,湖口鄉,0254,540,338,878,52,930,1493,62.29%,36.17%,1
新竹縣,湖口鄉,0255,577,393,970,29,999,1877,53.22%,30.74%,1
新竹縣,湖口鄉,0256,369,256,625,48,673,1082,62.2%,34.1%,1
新竹縣,湖口鄉,0257,361,273,634,52,686,1115,61.52%,32.38%,1
新竹縣,湖口鄉,0258,338,210,548,56,604,1193,50.63%,28.33%,1
新竹縣,湖口鄉,0259,581,376,957,51,1008,1947,51.77%,29.84%,1
新竹縣,湖口鄉,0260,371,248,619,62,681,1125,60.53%,32.98%,1
新竹縣,湖口鄉,0261,336,237,573,49,622,1050,59.24%,32%,1
新竹縣,湖口鄉,0262,588,361,949,52,1001,1733,57.76%,33.93%,1
新竹縣,湖口鄉,0263,434,277,711,48,759,1284,59.11%,33.8%,1
新竹縣,湖口鄉,0264,373,225,598,34,632,1062,59.51%,35.12%,1
新竹縣,湖口鄉,0265,512,290,802,77,879,1547,56.82%,33.1%,1
新竹縣,湖口鄉,0266,430,274,704,37,741,1494,49.6%,28.78%,1
新竹縣,湖口鄉,0267,461,286,747,39,786,1634,48.1%,28.21%,1
新竹縣,湖口鄉,0268,392,250,642,29,671,1444,46.47%,27.15%,1
新竹縣,湖口鄉,0269,377,274,651,43,694,1324,52.42%,28.47%,1
新竹縣,湖口鄉,0270,341,216,557,44,601,1058,56.81%,32.23%,1
新竹縣,湖口鄉,0271,288,196,484,23,507,1220,41.56%,23.61%,1
新竹縣,湖口鄉,0272,430,271,701,47,748,1333,56.11%,32.26%,1
新竹縣,湖口鄉,0273,396,304,700,66,766,1461,52.43%,27.1%,1
新竹縣,湖口鄉,0274,434,278,712,37,749,1429,52.41%,30.37%,1
新竹縣,湖口鄉,0275,400,279,679,29,708,1506,47.01%,26.56%,1
新竹縣,湖口鄉,0276,392,234,626,44,670,1103,60.74%,35.54%,1
新竹縣,湖口鄉,0277,402,303,705,36,741,1495,49.57%,26.89%,1
新竹縣,湖口鄉,0278,240,143,383,51,434,752,57.71%,31.91%,1
新竹縣,湖口鄉,0279,309,194,503,43,546,986,55.38%,31.34%,1
新竹縣,新豐鄉,0280,298,211,509,69,578,1080,53.52%,27.59%,1
新竹縣,新豐鄉,0281,246,187,433,37,470,887,52.99%,27.73%,1
新竹縣,新豐鄉,0282,286,212,498,39,537,954,56.29%,29.98%,1
新竹縣,新豐鄉,0283,279,227,506,50,556,1003,55.43%,27.82%,1
新竹縣,新豐鄉,0284,350,207,557,47,604,1106,54.61%,31.65%,1
新竹縣,新豐鄉,0285,359,256,615,45,660,1123,58.77%,31.97%,1
新竹縣,新豐鄉,0286,263,209,472,54,526,891,59.03%,29.52%,1
新竹縣,新豐鄉,0287,233,166,399,41,440,874,50.34%,26.66%,1
新竹縣,新豐鄉,0288,235,190,425,33,458,824,55.58%,28.52%,1
新竹縣,新豐鄉,0289,287,174,461,29,490,975,50.26%,29.44%,1
新竹縣,新豐鄉,0290,275,151,426,57,483,847,57.02%,32.47%,1
新竹縣,新豐鄉,0291,412,342,754,77,831,1477,56.26%,27.89%,1
新竹縣,新豐鄉,0292,345,253,598,65,663,1266,52.37%,27.25%,1
新竹縣,新豐鄉,0293,290,184,474,82,556,1029,54.03%,28.18%,1
新竹縣,新豐鄉,0294,286,229,515,62,577,1063,54.28%,26.9%,1
新竹縣,新豐鄉,0295,328,218,546,34,580,1055,54.98%,31.09%,1
新竹縣,新豐鄉,0296,474,299,773,37,810,1445,56.06%,32.8%,1
新竹縣,新豐鄉,0297,500,315,815,51,866,1413,61.29%,35.39%,1
新竹縣,新豐鄉,0298,326,265,591,33,624,971,64.26%,33.57%,1
新竹縣,新豐鄉,0299,378,273,651,29,680,1135,59.91%,33.3%,1
新竹縣,新豐鄉,0300,385,256,641,46,687,1269,54.14%,30.34%,1
新竹縣,新豐鄉,0301,399,260,659,49,708,1257,56.32%,31.74%,1
新竹縣,新豐鄉,0302,550,349,899,58,957,1662,57.58%,33.09%,1
新竹縣,新豐鄉,0303,448,291,739,31,770,1486,51.82%,30.15%,1
新竹縣,新豐鄉,0304,368,226,594,74,668,1067,62.61%,34.49%,1
新竹縣,新豐鄉,0305,450,270,720,69,789,1302,60.6%,34.56%,1
新竹縣,新豐鄉,0306,424,286,710,77,787,1410,55.82%,30.07%,1
新竹縣,新豐鄉,0307,381,248,629,66,695,1267,54.85%,30.07%,1
新竹縣,新豐鄉,0308,347,229,576,52,628,1258,49.92%,27.58%,1
新竹縣,新豐鄉,0309,336,225,561,34,595,1217,48.89%,27.61%,1
新竹縣,新豐鄉,0310,478,281,759,41,800,1456,54.95%,32.83%,1
新竹縣,新豐鄉,0311,389,243,632,48,680,1157,58.77%,33.62%,1
新竹縣,新豐鄉,0312,325,218,543,34,577,1089,52.98%,29.84%,1
新竹縣,新豐鄉,0313,381,252,633,21,654,1160,56.38%,32.84%,1
新竹縣,新豐鄉,0314,359,224,583,26,609,976,62.4%,36.78%,1
新竹縣,新豐鄉,0315,476,307,783,33,816,1443,56.55%,32.99%,1
新竹縣,新豐鄉,0316,377,227,604,32,636,1247,51%,30.23%,1
新竹縣,新豐鄉,0317,487,279,766,26,792,1411,56.13%,34.51%,1
新竹縣,新豐鄉,0318,262,416,678,58,736,1238,59.45%,21.16%,1
新竹縣,芎林鄉,0319,111,112,223,20,243,417,58.27%,26.62%,1
新竹縣,芎林鄉,0320,184,157,341,34,375,534,70.22%,34.46%,1
新竹縣,芎林鄉,0321,278,224,502,63,565,963,58.67%,28.87%,1
新竹縣,芎林鄉,0322,144,102,246,26,272,418,65.07%,34.45%,1
新竹縣,芎林鄉,0323,348,305,653,69,722,1312,55.03%,26.52%,1
新竹縣,芎林鄉,0324,336,285,621,57,678,1354,50.07%,24.82%,1
新竹縣,芎林鄉,0325,252,169,421,50,471,785,60%,32.1%,1
新竹縣,芎林鄉,0326,240,163,403,86,489,797,61.36%,30.11%,1
新竹縣,芎林鄉,0327,195,155,350,29,379,623,60.83%,31.3%,1
新竹縣,芎林鄉,0328,217,176,393,46,439,759,57.84%,28.59%,1
新竹縣,芎林鄉,0329,345,241,586,61,647,1272,50.86%,27.12%,1
新竹縣,芎林鄉,0330,370,255,625,47,672,1129,59.52%,32.77%,1
新竹縣,芎林鄉,0331,231,173,404,40,444,713,62.27%,32.4%,1
新竹縣,芎林鄉,0332,273,204,477,47,524,839,62.46%,32.54%,1
新竹縣,芎林鄉,0333,418,283,701,38,739,1123,65.81%,37.22%,1
新竹縣,芎林鄉,0334,365,192,557,26,583,981,59.43%,37.21%,1
新竹縣,芎林鄉,0335,369,230,599,62,661,1078,61.32%,34.23%,1
新竹縣,芎林鄉,0336,349,203,552,43,595,1094,54.39%,31.9%,1
新竹縣,芎林鄉,0337,343,248,591,60,651,1102,59.07%,31.13%,1
新竹縣,橫山鄉,0338,398,287,685,69,754,1231,61.25%,32.33%,1
新竹縣,橫山鄉,0339,308,258,566,61,627,1041,60.23%,29.59%,1
新竹縣,橫山鄉,0340,380,259,639,48,687,1132,60.69%,33.57%,1
新竹縣,橫山鄉,0341,294,174,468,41,509,859,59.25%,34.23%,1
新竹縣,橫山鄉,0342,60,40,100,17,117,204,57.35%,29.41%,1
新竹縣,橫山鄉,0343,52,37,89,11,100,222,45.05%,23.42%,1
新竹縣,橫山鄉,0344,103,67,170,47,217,338,64.2%,30.47%,1
新竹縣,橫山鄉,0345,272,182,454,38,492,916,53.71%,29.69%,1
新竹縣,橫山鄉,0346,135,89,224,15,239,573,41.71%,23.56%,1
新竹縣,橫山鄉,0347,92,83,175,14,189,275,68.73%,33.45%,1
新竹縣,橫山鄉,0348,125,76,201,25,226,463,48.81%,27%,1
新竹縣,橫山鄉,0349,238,149,387,54,441,690,63.91%,34.49%,1
新竹縣,橫山鄉,0350,78,57,135,13,148,288,51.39%,27.08%,1
新竹縣,橫山鄉,0351,243,145,388,53,441,685,64.38%,35.47%,1
新竹縣,橫山鄉,0352,316,174,490,46,536,868,61.75%,36.41%,1
新竹縣,橫山鄉,0353,519,367,886,81,967,1561,61.95%,33.25%,1
新竹縣,北埔鄉,0354,346,209,555,19,574,1158,49.57%,29.88%,1
新竹縣,北埔鄉,0355,367,297,664,73,737,1238,59.53%,29.64%,1
新竹縣,北埔鄉,0356,164,148,312,27,339,580,58.45%,28.28%,1
新竹縣,北埔鄉,0357,323,185,508,35,543,931,58.32%,34.69%,1
新竹縣,北埔鄉,0358,516,330,846,84,930,1653,56.26%,31.22%,1
新竹縣,北埔鄉,0359,277,161,438,47,485,845,57.4%,32.78%,1
新竹縣,北埔鄉,0360,111,83,194,17,211,384,54.95%,28.91%,1
新竹縣,北埔鄉,0361,235,160,395,26,421,763,55.18%,30.8%,1
新竹縣,北埔鄉,0362,83,81,164,20,184,333,55.26%,24.92%,1
新竹縣,北埔鄉,0363,91,52,143,8,151,295,51.19%,30.85%,1
新竹縣,寶山鄉,0364,341,237,578,84,662,1158,57.17%,29.45%,1
新竹縣,寶山鄉,0365,475,299,774,50,824,1437,57.34%,33.05%,1
新竹縣,寶山鄉,0366,471,295,766,72,838,1470,57.01%,32.04%,1
新竹縣,寶山鄉,0367,368,291,659,50,709,1170,60.6%,31.45%,1
新竹縣,寶山鄉,0368,652,383,1035,63,1098,1900,57.79%,34.32%,1
新竹縣,寶山鄉,0369,316,198,514,26,540,1056,51.14%,29.92%,1
新竹縣,寶山鄉,0370,412,283,695,66,761,1205,63.15%,34.19%,1
新竹縣,寶山鄉,0371,249,145,394,46,440,766,57.44%,32.51%,1
新竹縣,寶山鄉,0372,293,175,468,51,519,846,61.35%,34.63%,1
新竹縣,寶山鄉,0373,266,179,445,46,491,804,61.07%,33.08%,1
新竹縣,寶山鄉,0374,212,132,344,18,362,607,59.64%,34.93%,1
新竹縣,寶山鄉,0375,189,146,335,20,355,554,64.08%,34.12%,1
新竹縣,峨眉鄉,0376,290,215,505,69,574,879,65.3%,32.99%,1
新竹縣,峨眉鄉,0377,213,161,374,57,431,683,63.1%,31.19%,1
新竹縣,峨眉鄉,0378,185,147,332,34,366,604,60.6%,30.63%,1
新竹縣,峨眉鄉,0379,99,76,175,23,198,339,58.41%,29.2%,1
新竹縣,峨眉鄉,0380,52,58,110,6,116,276,42.03%,18.84%,1
新竹縣,峨眉鄉,0381,443,294,737,119,856,1406,60.88%,31.51%,1
新竹縣,峨眉鄉,0382,176,68,244,47,291,462,62.99%,38.1%,1
新竹縣,峨眉鄉,0383,121,83,204,23,227,419,54.18%,28.88%,1
新竹縣,尖石鄉,0384,96,76,172,15,187,474,39.45%,20.25%,1
新竹縣,尖石鄉,0385,113,48,161,9,170,357,47.62%,31.65%,1
新竹縣,尖石鄉,0386,50,43,93,17,110,225,48.89%,22.22%,1
新竹縣,尖石鄉,0387,104,51,155,12,167,374,44.65%,27.81%,1
新竹縣,尖石鄉,0388,191,108,299,15,314,773,40.62%,24.71%,1
新竹縣,尖石鄉,0389,121,91,212,17,229,490,46.73%,24.69%,1
新竹縣,尖石鄉,0390,104,71,175,6,181,531,34.09%,19.59%,1
新竹縣,尖石鄉,0391,158,129,287,11,298,660,45.15%,23.94%,1
新竹縣,尖石鄉,0392,173,165,338,63,401,613,65.42%,28.22%,1
新竹縣,尖石鄉,0393,131,123,254,3,257,593,43.34%,22.09%,1
新竹縣,尖石鄉,0394,121,120,241,31,272,575,47.3%,21.04%,1
新竹縣,尖石鄉,0395,43,33,76,8,84,126,66.67%,34.13%,1
新竹縣,尖石鄉,0396,97,70,167,7,174,499,34.87%,19.44%,1
新竹縣,尖石鄉,0397,124,82,206,20,226,785,28.79%,15.8%,1
新竹縣,尖石鄉,0398,71,69,140,24,164,289,56.75%,24.57%,1
新竹縣,五峰鄉,0399,215,121,336,30,366,672,54.46%,31.99%,1
新竹縣,五峰鄉,0400,166,117,283,24,307,713,43.06%,23.28%,1
新竹縣,五峰鄉,0401,131,61,192,8,200,594,33.67%,22.05%,1
新竹縣,五峰鄉,0402,196,127,323,57,380,896,42.41%,21.88%,1
新竹縣,五峰鄉,0403,164,109,273,13,286,727,39.34%,22.56%,1
新竹縣,五峰鄉,0404,74,66,140,9,149,395,37.72%,18.73%,1
苗栗縣,苗栗市,0001,368,225,593,33,626,1087,57.59%,33.85%,1
苗栗縣,苗栗市,0002,350,190,540,31,571,1018,56.09%,34.38%,1
苗栗縣,苗栗市,0003,375,232,607,30,637,1156,55.1%,32.44%,1
苗栗縣,苗栗市,0004,401,178,579,37,616,1118,55.1%,35.87%,1
苗栗縣,苗栗市,0005,376,216,592,45,637,1084,58.76%,34.69%,1
苗栗縣,苗栗市,0006,416,251,667,50,717,1203,59.6%,34.58%,1
苗栗縣,苗栗市,0007,479,237,716,59,775,1306,59.34%,36.68%,1
苗栗縣,苗栗市,0008,412,235,647,68,715,1193,59.93%,34.53%,1
苗栗縣,苗栗市,0009,402,225,627,35,662,1115,59.37%,36.05%,1
苗栗縣,苗栗市,0010,418,221,639,48,687,1119,61.39%,37.35%,1
苗栗縣,苗栗市,0011,397,246,643,54,697,1132,61.57%,35.07%,1
苗栗縣,苗栗市,0012,428,263,691,49,740,1289,57.41%,33.2%,1
苗栗縣,苗栗市,0013,447,262,709,53,762,1264,60.28%,35.36%,1
苗栗縣,苗栗市,0014,285,175,460,37,497,870,57.13%,32.76%,1
苗栗縣,苗栗市,0015,338,131,469,46,515,1008,51.09%,33.53%,1
苗栗縣,苗栗市,0016,342,195,537,32,569,1078,52.78%,31.73%,1
苗栗縣,苗栗市,0017,380,225,605,42,647,1077,60.07%,35.28%,1
苗栗縣,苗栗市,0018,292,187,479,34,513,880,58.3%,33.18%,1
苗栗縣,苗栗市,0019,265,189,454,49,503,894,56.26%,29.64%,1
苗栗縣,苗栗市,0020,173,109,282,22,304,522,58.24%,33.14%,1
苗栗縣,苗栗市,0021,486,317,803,69,872,1376,63.37%,35.32%,1
苗栗縣,苗栗市,0022,454,250,704,47,751,1391,53.99%,32.64%,1
苗栗縣,苗栗市,0023,368,224,592,57,649,1081,60.04%,34.04%,1
苗栗縣,苗栗市,0024,413,243,656,54,710,1272,55.82%,32.47%,1
苗栗縣,苗栗市,0025,377,265,642,73,715,1112,64.3%,33.9%,1
苗栗縣,苗栗市,0026,328,193,521,23,544,813,66.91%,40.34%,1
苗栗縣,苗栗市,0027,248,163,411,26,437,767,56.98%,32.33%,1
苗栗縣,苗栗市,0028,329,202,531,36,567,1010,56.14%,32.57%,1
苗栗縣,苗栗市,0029,432,203,635,31,666,1182,56.35%,36.55%,1
苗栗縣,苗栗市,0030,324,208,532,22,554,965,57.41%,33.58%,1
苗栗縣,苗栗市,0031,220,132,352,12,364,607,59.97%,36.24%,1
苗栗縣,苗栗市,0032,365,217,582,30,612,990,61.82%,36.87%,1
苗栗縣,苗栗市,0033,356,212,568,108,676,1230,54.96%,28.94%,1
苗栗縣,苗栗市,0034,465,282,747,48,795,1372,57.94%,33.89%,1
苗栗縣,苗栗市,0035,429,224,653,59,712,1213,58.7%,35.37%,1
苗栗縣,苗栗市,0036,459,217,676,48,724,1272,56.92%,36.08%,1
苗栗縣,苗栗市,0037,458,252,710,38,748,1221,61.26%,37.51%,1
苗栗縣,苗栗市,0038,357,233,590,53,643,1104,58.24%,32.34%,1
苗栗縣,苗栗市,0039,391,202,593,15,608,1171,51.92%,33.39%,1
苗栗縣,苗栗市,0040,461,268,729,58,787,1392,56.54%,33.12%,1
苗栗縣,苗栗市,0041,438,299,737,60,797,1356,58.78%,32.3%,1
苗栗縣,苗栗市,0042,445,296,741,67,808,1387,58.26%,32.08%,1
苗栗縣,苗栗市,0043,393,245,638,38,676,1206,56.05%,32.59%,1
苗栗縣,苗栗市,0044,359,237,596,42,638,1004,63.55%,35.76%,1
苗栗縣,苗栗市,0045,391,245,636,37,673,1202,55.99%,32.53%,1
苗栗縣,苗栗市,0046,370,237,607,36,643,1052,61.12%,35.17%,1
苗栗縣,苗栗市,0047,320,189,509,29,538,873,61.63%,36.66%,1
苗栗縣,苗栗市,0048,389,214,603,49,652,975,66.87%,39.9%,1
苗栗縣,苗栗市,0049,405,188,593,50,643,1003,64.11%,40.38%,1
苗栗縣,苗栗市,0050,331,221,552,29,581,1000,58.1%,33.1%,1
苗栗縣,苗栗市,0051,366,186,552,39,591,1047,56.45%,34.96%,1
苗栗縣,苗栗市,0052,354,239,593,38,631,1025,61.56%,34.54%,1
苗栗縣,苗栗市,0053,341,235,576,34,610,1130,53.98%,30.18%,1
苗栗縣,苗栗市,0054,400,222,622,32,654,1146,57.07%,34.9%,1
苗栗縣,苗栗市,0055,497,284,781,60,841,1432,58.73%,34.71%,1
苗栗縣,苗栗市,0056,436,222,658,46,704,1492,47.18%,29.22%,1
苗栗縣,苗栗市,0057,389,262,651,39,690,1125,61.33%,34.58%,1
苗栗縣,苗栗市,0058,410,238,648,48,696,1241,56.08%,33.04%,1
苗栗縣,苗栗市,0059,449,280,729,36,765,1278,59.86%,35.13%,1
苗栗縣,苗栗市,0060,442,248,690,32,722,1293,55.84%,34.18%,1
苗栗縣,苗栗市,0061,417,245,662,45,707,1342,52.68%,31.07%,1
苗栗縣,苗栗市,0062,252,179,431,46,477,857,55.66%,29.4%,1
苗栗縣,苗栗市,0063,362,237,599,47,646,1180,54.75%,30.68%,1
苗栗縣,苗栗市,0064,360,236,596,40,636,1072,59.33%,33.58%,1
苗栗縣,苗栗市,0065,307,153,460,26,486,912,53.29%,33.66%,1
苗栗縣,苗栗市,0066,249,136,385,41,426,796,53.52%,31.28%,1
苗栗縣,苗栗市,0067,234,171,405,27,432,869,49.71%,26.93%,1
苗栗縣,苑裡鎮,0183,260,202,462,61,523,873,59.91%,29.78%,1
苗栗縣,苑裡鎮,0184,433,296,729,60,789,1346,58.62%,32.17%,1
苗栗縣,苑裡鎮,0185,328,241,569,61,630,951,66.25%,34.49%,1
苗栗縣,苑裡鎮,0186,166,136,302,21,323,615,52.52%,26.99%,1
苗栗縣,苑裡鎮,0187,266,203,469,80,549,878,62.53%,30.3%,1
苗栗縣,苑裡鎮,0188,243,175,418,55,473,767,61.67%,31.68%,1
苗栗縣,苑裡鎮,0189,218,171,389,48,437,776,56.31%,28.09%,1
苗栗縣,苑裡鎮,0190,341,212,553,82,635,1231,51.58%,27.7%,1
苗栗縣,苑裡鎮,0191,364,254,618,61,679,1145,59.3%,31.79%,1
苗栗縣,苑裡鎮,0192,255,171,426,50,476,850,56%,30%,1
苗栗縣,苑裡鎮,0193,309,196,505,77,582,1052,55.32%,29.37%,1
苗栗縣,苑裡鎮,0194,326,259,585,54,639,1114,57.36%,29.26%,1
苗栗縣,苑裡鎮,0195,354,244,598,72,670,1136,58.98%,31.16%,1
苗栗縣,苑裡鎮,0196,382,251,633,38,671,1194,56.2%,31.99%,1
苗栗縣,苑裡鎮,0197,499,329,828,74,902,1579,57.12%,31.6%,1
苗栗縣,苑裡鎮,0198,378,266,644,69,713,1149,62.05%,32.9%,1
苗栗縣,苑裡鎮,0199,300,262,562,81,643,1057,60.83%,28.38%,1
苗栗縣,苑裡鎮,0200,333,193,526,22,548,1101,49.77%,30.25%,1
苗栗縣,苑裡鎮,0201,191,189,380,47,427,912,46.82%,20.94%,1
苗栗縣,苑裡鎮,0202,177,143,320,44,364,652,55.83%,27.15%,1
苗栗縣,苑裡鎮,0203,423,270,693,88,781,1348,57.94%,31.38%,1
苗栗縣,苑裡鎮,0204,168,144,312,31,343,733,46.79%,22.92%,1
苗栗縣,苑裡鎮,0205,188,122,310,22,332,662,50.15%,28.4%,1
苗栗縣,苑裡鎮,0206,265,197,462,54,516,893,57.78%,29.68%,1
苗栗縣,苑裡鎮,0207,310,184,494,51,545,910,59.89%,34.07%,1
苗栗縣,苑裡鎮,0208,343,298,641,58,699,1270,55.04%,27.01%,1
苗栗縣,苑裡鎮,0209,158,101,259,33,292,545,53.58%,28.99%,1
苗栗縣,苑裡鎮,0210,258,159,417,85,502,792,63.38%,32.58%,1
苗栗縣,苑裡鎮,0211,215,165,380,38,418,726,57.58%,29.61%,1
苗栗縣,苑裡鎮,0212,200,115,315,29,344,827,41.6%,24.18%,1
苗栗縣,苑裡鎮,0213,229,178,407,56,463,782,59.21%,29.28%,1
苗栗縣,苑裡鎮,0214,223,174,397,38,435,788,55.2%,28.3%,1
苗栗縣,苑裡鎮,0215,215,211,426,36,462,846,54.61%,25.41%,1
苗栗縣,苑裡鎮,0216,254,187,441,64,505,828,60.99%,30.68%,1
苗栗縣,苑裡鎮,0217,292,185,477,73,550,943,58.32%,30.97%,1
苗栗縣,苑裡鎮,0218,361,235,596,36,632,1082,58.41%,33.36%,1
苗栗縣,苑裡鎮,0219,373,306,679,69,748,1234,60.62%,30.23%,1
苗栗縣,苑裡鎮,0220,389,321,710,73,783,1434,54.6%,27.13%,1
苗栗縣,苑裡鎮,0221,317,203,520,51,571,987,57.85%,32.12%,1
苗栗縣,苑裡鎮,0222,279,225,504,59,563,882,63.83%,31.63%,1
苗栗縣,通霄鎮,0149,325,273,598,62,660,1142,57.79%,28.46%,1
苗栗縣,通霄鎮,0150,278,238,516,60,576,884,65.16%,31.45%,1
苗栗縣,通霄鎮,0151,297,214,511,90,601,1068,56.27%,27.81%,1
苗栗縣,通霄鎮,0152,296,234,530,49,579,1009,57.38%,29.34%,1
苗栗縣,通霄鎮,0153,285,213,498,63,561,859,65.31%,33.18%,1
苗栗縣,通霄鎮,0154,372,182,554,54,608,1040,58.46%,35.77%,1
苗栗縣,通霄鎮,0155,244,157,401,23,424,1008,42.06%,24.21%,1
苗栗縣,通霄鎮,0156,180,153,333,75,408,686,59.48%,26.24%,1
苗栗縣,通霄鎮,0157,228,220,448,61,509,761,66.89%,29.96%,1
苗栗縣,通霄鎮,0158,225,134,359,43,402,790,50.89%,28.48%,1
苗栗縣,通霄鎮,0159,268,194,462,72,534,966,55.28%,27.74%,1
苗栗縣,通霄鎮,0160,255,162,417,86,503,972,51.75%,26.23%,1
苗栗縣,通霄鎮,0161,225,156,381,52,433,771,56.16%,29.18%,1
苗栗縣,通霄鎮,0162,176,139,315,26,341,758,44.99%,23.22%,1
苗栗縣,通霄鎮,0163,330,198,528,54,582,1078,53.99%,30.61%,1
苗栗縣,通霄鎮,0164,99,71,170,29,199,459,43.36%,21.57%,1
苗栗縣,通霄鎮,0165,240,163,403,46,449,894,50.22%,26.85%,1
苗栗縣,通霄鎮,0166,87,63,150,9,159,402,39.55%,21.64%,1
苗栗縣,通霄鎮,0167,238,145,383,50,433,802,53.99%,29.68%,1
苗栗縣,通霄鎮,0168,178,136,314,33,347,684,50.73%,26.02%,1
苗栗縣,通霄鎮,0169,236,157,393,50,443,943,46.98%,25.03%,1
苗栗縣,通霄鎮,0170,225,187,412,67,479,790,60.63%,28.48%,1
苗栗縣,通霄鎮,0171,156,112,268,18,286,673,42.5%,23.18%,1
苗栗縣,通霄鎮,0172,357,214,571,80,651,1232,52.84%,28.98%,1
苗栗縣,通霄鎮,0173,410,262,672,83,755,1286,58.71%,31.88%,1
苗栗縣,通霄鎮,0174,175,156,331,54,385,649,59.32%,26.96%,1
苗栗縣,通霄鎮,0175,200,141,341,45,386,769,50.2%,26.01%,1
苗栗縣,通霄鎮,0176,313,228,541,90,631,1148,54.97%,27.26%,1
苗栗縣,通霄鎮,0177,264,209,473,102,575,1138,50.53%,23.2%,1
苗栗縣,通霄鎮,0178,296,189,485,70,555,1121,49.51%,26.4%,1
苗栗縣,通霄鎮,0179,229,165,394,31,425,769,55.27%,29.78%,1
苗栗縣,通霄鎮,0180,142,137,279,19,298,616,48.38%,23.05%,1
苗栗縣,通霄鎮,0181,236,148,384,52,436,799,54.57%,29.54%,1
苗栗縣,通霄鎮,0182,195,140,335,38,373,743,50.2%,26.24%,1
苗栗縣,竹南鎮,0270,327,284,611,41,652,1086,60.04%,30.11%,1
苗栗縣,竹南鎮,0271,272,186,458,30,488,826,59.08%,32.93%,1
苗栗縣,竹南鎮,0272,318,183,501,56,557,1051,53%,30.26%,1
苗栗縣,竹南鎮,0273,433,251,684,50,734,1235,59.43%,35.06%,1
苗栗縣,竹南鎮,0274,337,198,535,80,615,1016,60.53%,33.17%,1
苗栗縣,竹南鎮,0275,444,281,725,75,800,1472,54.35%,30.16%,1
苗栗縣,竹南鎮,0276,356,242,598,40,638,1301,49.04%,27.36%,1
苗栗縣,竹南鎮,0277,455,284,739,43,782,1544,50.65%,29.47%,1
苗栗縣,竹南鎮,0278,455,335,790,41,831,1512,54.96%,30.09%,1
苗栗縣,竹南鎮,0279,403,310,713,62,775,1463,52.97%,27.55%,1
苗栗縣,竹南鎮,0280,302,230,532,38,570,1073,53.12%,28.15%,1
苗栗縣,竹南鎮,0281,460,332,792,46,838,1453,57.67%,31.66%,1
苗栗縣,竹南鎮,0282,431,283,714,39,753,1245,60.48%,34.62%,1
苗栗縣,竹南鎮,0283,498,355,853,36,889,1487,59.78%,33.49%,1
苗栗縣,竹南鎮,0284,322,226,548,49,597,1018,58.64%,31.63%,1
苗栗縣,竹南鎮,0285,336,275,611,45,656,1105,59.37%,30.41%,1
苗栗縣,竹南鎮,0286,358,284,642,59,701,1322,53.03%,27.08%,1
苗栗縣,竹南鎮,0287,394,235,629,32,661,1140,57.98%,34.56%,1
苗栗縣,竹南鎮,0288,368,231,599,55,654,1067,61.29%,34.49%,1
苗栗縣,竹南鎮,0289,375,301,676,42,718,1136,63.2%,33.01%,1
苗栗縣,竹南鎮,0290,372,218,590,63,653,1253,52.11%,29.69%,1
苗栗縣,竹南鎮,0291,240,198,438,76,514,963,53.37%,24.92%,1
苗栗縣,竹南鎮,0292,296,203,499,57,556,1021,54.46%,28.99%,1
苗栗縣,竹南鎮,0293,409,235,644,48,692,1154,59.97%,35.44%,1
苗栗縣,竹南鎮,0294,305,242,547,48,595,1042,57.1%,29.27%,1
苗栗縣,竹南鎮,0295,428,272,700,46,746,1293,57.7%,33.1%,1
苗栗縣,竹南鎮,0296,273,176,449,36,485,816,59.44%,33.46%,1
苗栗縣,竹南鎮,0297,307,196,503,60,563,989,56.93%,31.04%,1
苗栗縣,竹南鎮,0298,394,226,620,58,678,1122,60.43%,35.12%,1
苗栗縣,竹南鎮,0299,271,205,476,49,525,1111,47.25%,24.39%,1
苗栗縣,竹南鎮,0300,330,233,563,52,615,1036,59.36%,31.85%,1
苗栗縣,竹南鎮,0301,305,224,529,30,559,1112,50.27%,27.43%,1
苗栗縣,竹南鎮,0302,409,258,667,38,705,1348,52.3%,30.34%,1
苗栗縣,竹南鎮,0303,347,264,611,40,651,1114,58.44%,31.15%,1
苗栗縣,竹南鎮,0304,365,251,616,58,674,1119,60.23%,32.62%,1
苗栗縣,竹南鎮,0305,275,190,465,34,499,878,56.83%,31.32%,1
苗栗縣,竹南鎮,0306,343,258,601,54,655,1059,61.85%,32.39%,1
苗栗縣,竹南鎮,0307,282,190,472,49,521,869,59.95%,32.45%,1
苗栗縣,竹南鎮,0308,240,169,409,38,447,800,55.88%,30%,1
苗栗縣,竹南鎮,0309,399,268,667,44,711,1165,61.03%,34.25%,1
苗栗縣,竹南鎮,0310,242,178,420,41,461,791,58.28%,30.59%,1
苗栗縣,竹南鎮,0311,205,140,345,27,372,677,54.95%,30.28%,1
苗栗縣,竹南鎮,0312,275,182,457,60,517,797,64.87%,34.5%,1
苗栗縣,竹南鎮,0313,369,230,599,44,643,1191,53.99%,30.98%,1
苗栗縣,竹南鎮,0314,303,210,513,23,536,1027,52.19%,29.5%,1
苗栗縣,竹南鎮,0315,411,321,732,62,794,1341,59.21%,30.65%,1
苗栗縣,竹南鎮,0316,397,246,643,61,704,1378,51.09%,28.81%,1
苗栗縣,竹南鎮,0317,388,255,643,38,681,1216,56%,31.91%,1
苗栗縣,竹南鎮,0318,480,301,781,47,828,1570,52.74%,30.57%,1
苗栗縣,竹南鎮,0319,156,132,288,44,332,538,61.71%,29%,1
苗栗縣,竹南鎮,0320,299,216,515,30,545,1166,46.74%,25.64%,1
苗栗縣,竹南鎮,0321,545,190,735,43,778,1488,52.28%,36.63%,1
苗栗縣,竹南鎮,0322,418,265,683,38,721,1449,49.76%,28.85%,1
苗栗縣,竹南鎮,0323,339,248,587,75,662,1182,56.01%,28.68%,1
苗栗縣,竹南鎮,0324,317,274,591,77,668,1175,56.85%,26.98%,1
苗栗縣,竹南鎮,0325,289,233,522,37,559,983,56.87%,29.4%,1
苗栗縣,竹南鎮,0326,177,110,287,21,308,492,62.6%,35.98%,1
苗栗縣,竹南鎮,0327,327,240,567,55,622,1074,57.91%,30.45%,1
苗栗縣,竹南鎮,0328,230,198,428,45,473,852,55.52%,27%,1
苗栗縣,竹南鎮,0329,360,284,644,44,688,1297,53.05%,27.76%,1
苗栗縣,竹南鎮,0330,311,189,500,58,558,1028,54.28%,30.25%,1
苗栗縣,頭份市,0331,245,185,430,68,498,915,54.43%,26.78%,1
苗栗縣,頭份市,0332,390,270,660,76,736,1292,56.97%,30.19%,1
苗栗縣,頭份市,0333,288,228,516,36,552,928,59.48%,31.03%,1
苗栗縣,頭份市,0334,249,152,401,12,413,835,49.46%,29.82%,1
苗栗縣,頭份市,0335,339,213,552,35,587,1070,54.86%,31.68%,1
苗栗縣,頭份市,0336,238,172,410,30,440,879,50.06%,27.08%,1
苗栗縣,頭份市,0337,284,216,500,38,538,1039,51.78%,27.33%,1
苗栗縣,頭份市,0338,341,252,593,66,659,1129,58.37%,30.2%,1
苗栗縣,頭份市,0339,287,217,504,69,573,1041,55.04%,27.57%,1
苗栗縣,頭份市,0340,447,260,707,80,787,1546,50.91%,28.91%,1
苗栗縣,頭份市,0341,318,221,539,45,584,935,62.46%,34.01%,1
苗栗縣,頭份市,0342,299,283,582,35,617,1180,52.29%,25.34%,1
苗栗縣,頭份市,0343,441,300,741,27,768,1499,51.23%,29.42%,1
苗栗縣,頭份市,0344,230,154,384,20,404,747,54.08%,30.79%,1
苗栗縣,頭份市,0345,446,269,715,43,758,1406,53.91%,31.72%,1
苗栗縣,頭份市,0346,349,258,607,67,674,1193,56.5%,29.25%,1
苗栗縣,頭份市,0347,280,220,500,52,552,948,58.23%,29.54%,1
苗栗縣,頭份市,0348,274,170,444,23,467,869,53.74%,31.53%,1
苗栗縣,頭份市,0349,351,252,603,59,662,1142,57.97%,30.74%,1
苗栗縣,頭份市,0350,385,286,671,29,700,1286,54.43%,29.94%,1
苗栗縣,頭份市,0351,307,185,492,44,536,903,59.36%,34%,1
苗栗縣,頭份市,0352,430,248,678,58,736,1186,62.06%,36.26%,1
苗栗縣,頭份市,0353,380,190,570,29,599,1016,58.96%,37.4%,1
苗栗縣,頭份市,0354,258,258,516,43,559,985,56.75%,26.19%,1
苗栗縣,頭份市,0355,322,205,527,38,565,1037,54.48%,31.05%,1
苗栗縣,頭份市,0356,262,178,440,24,464,947,49%,27.67%,1
苗栗縣,頭份市,0357,300,183,483,36,519,890,58.31%,33.71%,1
苗栗縣,頭份市,0358,210,159,369,39,408,646,63.16%,32.51%,1
苗栗縣,頭份市,0359,303,236,539,43,582,975,59.69%,31.08%,1
苗栗縣,頭份市,0360,193,181,374,19,393,1015,38.72%,19.01%,1
苗栗縣,頭份市,0361,506,285,791,76,867,1399,61.97%,36.17%,1
苗栗縣,頭份市,0362,355,270,625,64,689,1143,60.28%,31.06%,1
苗栗縣,頭份市,0363,374,234,608,64,672,1030,65.24%,36.31%,1
苗栗縣,頭份市,0364,420,303,723,51,774,1338,57.85%,31.39%,1
苗栗縣,頭份市,0365,456,282,738,40,778,1450,53.66%,31.45%,1
苗栗縣,頭份市,0366,356,227,583,26,609,1042,58.45%,34.17%,1
苗栗縣,頭份市,0367,457,300,757,39,796,1326,60.03%,34.46%,1
苗栗縣,頭份市,0368,485,280,765,38,803,1270,63.23%,38.19%,1
苗栗縣,頭份市,0369,386,280,666,49,715,1288,55.51%,29.97%,1
苗栗縣,頭份市,0370,447,229,676,43,719,1243,57.84%,35.96%,1
苗栗縣,頭份市,0371,444,275,719,37,756,1280,59.06%,34.69%,1
苗栗縣,頭份市,0372,477,360,837,76,913,1618,56.43%,29.48%,1
苗栗縣,頭份市,0373,523,356,879,63,942,1759,53.55%,29.73%,1
苗栗縣,頭份市,0374,443,247,690,62,752,1264,59.49%,35.05%,1
苗栗縣,頭份市,0375,432,285,717,48,765,1326,57.69%,32.58%,1
苗栗縣,頭份市,0376,539,306,845,42,887,1551,57.19%,34.75%,1
苗栗縣,頭份市,0377,458,309,767,47,814,1574,51.72%,29.1%,1
苗栗縣,頭份市,0378,337,292,629,72,701,1262,55.55%,26.7%,1
苗栗縣,頭份市,0379,408,232,640,46,686,1171,58.58%,34.84%,1
苗栗縣,頭份市,0380,387,253,640,55,695,1074,64.71%,36.03%,1
苗栗縣,頭份市,0381,381,259,640,49,689,1141,60.39%,33.39%,1
苗栗縣,頭份市,0382,377,306,683,48,731,1259,58.06%,29.94%,1
苗栗縣,頭份市,0383,358,235,593,62,655,1186,55.23%,30.19%,1
苗栗縣,頭份市,0384,335,202,537,46,583,1121,52.01%,29.88%,1
苗栗縣,頭份市,0385,264,185,449,36,485,847,57.26%,31.17%,1
苗栗縣,頭份市,0386,345,218,563,36,599,993,60.32%,34.74%,1
苗栗縣,頭份市,0387,309,223,532,40,572,1055,54.22%,29.29%,1
苗栗縣,頭份市,0388,463,292,755,75,830,1655,50.15%,27.98%,1
苗栗縣,頭份市,0389,561,321,882,107,989,1799,54.97%,31.18%,1
苗栗縣,頭份市,0390,352,255,607,56,663,1141,58.11%,30.85%,1
苗栗縣,頭份市,0391,441,283,724,59,783,1431,54.72%,30.82%,1
苗栗縣,頭份市,0392,369,259,628,25,653,1412,46.25%,26.13%,1
苗栗縣,頭份市,0393,286,222,508,56,564,1074,52.51%,26.63%,1
苗栗縣,頭份市,0394,432,256,688,54,742,1245,59.6%,34.7%,1
苗栗縣,頭份市,0395,438,290,728,74,802,1344,59.67%,32.59%,1
苗栗縣,頭份市,0396,435,308,743,98,841,1363,61.7%,31.91%,1
苗栗縣,頭份市,0397,299,205,504,59,563,898,62.69%,33.3%,1
苗栗縣,頭份市,0398,376,243,619,93,712,1182,60.24%,31.81%,1
苗栗縣,頭份市,0399,442,280,722,53,775,1413,54.85%,31.28%,1
苗栗縣,頭份市,0400,328,232,560,57,617,991,62.26%,33.1%,1
苗栗縣,頭份市,0401,376,255,631,65,696,1180,58.98%,31.86%,1
苗栗縣,後龍鎮,0223,182,126,308,36,344,590,58.31%,30.85%,1
苗栗縣,後龍鎮,0224,263,233,496,61,557,883,63.08%,29.78%,1
苗栗縣,後龍鎮,0225,254,177,431,62,493,793,62.17%,32.03%,1
苗栗縣,後龍鎮,0226,218,181,399,42,441,732,60.25%,29.78%,1
苗栗縣,後龍鎮,0227,189,135,324,36,360,592,60.81%,31.93%,1
苗栗縣,後龍鎮,0228,345,257,602,61,663,1113,59.57%,31%,1
苗栗縣,後龍鎮,0229,346,267,613,64,677,1195,56.65%,28.95%,1
苗栗縣,後龍鎮,0230,345,223,568,50,618,997,61.99%,34.6%,1
苗栗縣,後龍鎮,0231,239,178,417,25,442,913,48.41%,26.18%,1
苗栗縣,後龍鎮,0232,184,118,302,33,335,641,52.26%,28.71%,1
苗栗縣,後龍鎮,0233,236,159,395,49,444,848,52.36%,27.83%,1
苗栗縣,後龍鎮,0234,357,250,607,93,700,1264,55.38%,28.24%,1
苗栗縣,後龍鎮,0235,243,187,430,58,488,965,50.57%,25.18%,1
苗栗縣,後龍鎮,0236,478,291,769,83,852,1216,70.07%,39.31%,1
苗栗縣,後龍鎮,0237,288,196,484,49,533,977,54.55%,29.48%,1
苗栗縣,後龍鎮,0238,246,177,423,53,476,943,50.48%,26.09%,1
苗栗縣,後龍鎮,0239,238,203,441,80,521,910,57.25%,26.15%,1
苗栗縣,後龍鎮,0240,234,187,421,52,473,851,55.58%,27.5%,1
苗栗縣,後龍鎮,0241,229,196,425,25,450,725,62.07%,31.59%,1
苗栗縣,後龍鎮,0242,195,145,340,50,390,650,60%,30%,1
苗栗縣,後龍鎮,0243,188,138,326,47,373,706,52.83%,26.63%,1
苗栗縣,後龍鎮,0244,225,163,388,48,436,748,58.29%,30.08%,1
苗栗縣,後龍鎮,0245,199,133,332,42,374,801,46.69%,24.84%,1
苗栗縣,後龍鎮,0246,333,239,572,53,625,1107,56.46%,30.08%,1
苗栗縣,後龍鎮,0247,311,248,559,90,649,1197,54.22%,25.98%,1
苗栗縣,後龍鎮,0248,283,191,474,54,528,1036,50.97%,27.32%,1
苗栗縣,後龍鎮,0249,215,166,381,38,419,913,45.89%,23.55%,1
苗栗縣,後龍鎮,0250,228,155,383,57,440,719,61.2%,31.71%,1
苗栗縣,後龍鎮,0251,296,202,498,99,597,1037,57.57%,28.54%,1
苗栗縣,後龍鎮,0252,165,121,286,21,307,601,51.08%,27.45%,1
苗栗縣,後龍鎮,0253,295,226,521,54,575,1269,45.31%,23.25%,1
苗栗縣,後龍鎮,0254,195,137,332,28,360,735,48.98%,26.53%,1
苗栗縣,後龍鎮,0255,66,65,131,13,144,422,34.12%,15.64%,1
苗栗縣,後龍鎮,0256,187,134,321,31,352,625,56.32%,29.92%,1
苗栗縣,後龍鎮,0257,293,223,516,63,579,1234,46.92%,23.74%,1
苗栗縣,卓蘭鎮,0442,343,204,547,39,586,961,60.98%,35.69%,1
苗栗縣,卓蘭鎮,0443,286,214,500,73,573,1017,56.34%,28.12%,1
苗栗縣,卓蘭鎮,0444,402,238,640,63,703,1095,64.2%,36.71%,1
苗栗縣,卓蘭鎮,0445,262,148,410,41,451,745,60.54%,35.17%,1
苗栗縣,卓蘭鎮,0446,245,132,377,54,431,783,55.04%,31.29%,1
苗栗縣,卓蘭鎮,0447,235,105,340,19,359,745,48.19%,31.54%,1
苗栗縣,卓蘭鎮,0448,276,182,458,40,498,999,49.85%,27.63%,1
苗栗縣,卓蘭鎮,0449,220,150,370,48,418,671,62.3%,32.79%,1
苗栗縣,卓蘭鎮,0450,231,187,418,65,483,734,65.8%,31.47%,1
苗栗縣,卓蘭鎮,0451,290,195,485,52,537,865,62.08%,33.53%,1
苗栗縣,卓蘭鎮,0452,265,188,453,69,522,828,63.04%,32%,1
苗栗縣,卓蘭鎮,0453,125,82,207,37,244,386,63.21%,32.38%,1
苗栗縣,卓蘭鎮,0454,246,152,398,46,444,688,64.53%,35.76%,1
苗栗縣,卓蘭鎮,0455,276,171,447,47,494,792,62.37%,34.85%,1
苗栗縣,卓蘭鎮,0456,243,142,385,45,430,729,58.98%,33.33%,1
苗栗縣,卓蘭鎮,0457,279,199,478,39,517,1093,47.3%,25.53%,1
苗栗縣,卓蘭鎮,0458,209,119,328,17,345,615,56.1%,33.98%,1
苗栗縣,卓蘭鎮,0459,28,16,44,1,45,86,52.33%,32.56%,1
苗栗縣,卓蘭鎮,0460,315,180,495,21,516,940,54.89%,33.51%,1
苗栗縣,大湖鄉,0420,211,161,372,34,406,744,54.57%,28.36%,1
苗栗縣,大湖鄉,0421,275,181,456,32,488,881,55.39%,31.21%,1
苗栗縣,大湖鄉,0422,177,120,297,42,339,596,56.88%,29.7%,1
苗栗縣,大湖鄉,0423,349,237,586,66,652,1260,51.75%,27.7%,1
苗栗縣,大湖鄉,0424,253,152,405,48,453,867,52.25%,29.18%,1
苗栗縣,大湖鄉,0425,296,192,488,23,511,923,55.36%,32.07%,1
苗栗縣,大湖鄉,0426,352,275,627,110,737,1395,52.83%,25.23%,1
苗栗縣,大湖鄉,0427,111,70,181,22,203,561,36.19%,19.79%,1
苗栗縣,大湖鄉,0428,231,117,348,22,370,638,57.99%,36.21%,1
苗栗縣,大湖鄉,0429,210,143,353,46,399,754,52.92%,27.85%,1
苗栗縣,大湖鄉,0430,133,100,233,18,251,501,50.1%,26.55%,1
苗栗縣,大湖鄉,0431,210,128,338,21,359,652,55.06%,32.21%,1
苗栗縣,大湖鄉,0432,213,169,382,31,413,843,48.99%,25.27%,1
苗栗縣,大湖鄉,0433,289,188,477,102,579,1020,56.76%,28.33%,1
苗栗縣,大湖鄉,0434,341,187,528,51,579,1018,56.88%,33.5%,1
苗栗縣,公館鄉,0068,272,201,473,49,522,789,66.16%,34.47%,1
苗栗縣,公館鄉,0069,295,196,491,33,524,792,66.16%,37.25%,1
苗栗縣,公館鄉,0070,388,231,619,101,720,1117,64.46%,34.74%,1
苗栗縣,公館鄉,0071,421,290,711,74,785,1255,62.55%,33.55%,1
苗栗縣,公館鄉,0072,366,255,621,63,684,1141,59.95%,32.08%,1
苗栗縣,公館鄉,0073,385,237,622,65,687,1172,58.62%,32.85%,1
苗栗縣,公館鄉,0074,391,247,638,57,695,1100,63.18%,35.55%,1
苗栗縣,公館鄉,0075,393,208,601,52,653,1232,53%,31.9%,1
苗栗縣,公館鄉,0076,330,175,505,67,572,1081,52.91%,30.53%,1
苗栗縣,公館鄉,0077,468,245,713,62,775,1250,62%,37.44%,1
苗栗縣,公館鄉,0078,343,239,582,50,632,1081,58.46%,31.73%,1
苗栗縣,公館鄉,0079,280,195,475,80,555,964,57.57%,29.05%,1
苗栗縣,公館鄉,0080,340,205,545,86,631,1038,60.79%,32.76%,1
苗栗縣,公館鄉,0081,121,81,202,26,228,360,63.33%,33.61%,1
苗栗縣,公館鄉,0082,259,191,450,48,498,865,57.57%,29.94%,1
苗栗縣,公館鄉,0083,333,254,587,65,652,1166,55.92%,28.56%,1
苗栗縣,公館鄉,0084,232,168,400,30,430,719,59.81%,32.27%,1
苗栗縣,公館鄉,0085,230,159,389,46,435,788,55.2%,29.19%,1
苗栗縣,公館鄉,0086,108,57,165,37,202,303,66.67%,35.64%,1
苗栗縣,公館鄉,0087,454,276,730,65,795,1322,60.14%,34.34%,1
苗栗縣,公館鄉,0088,304,179,483,52,535,933,57.34%,32.58%,1
苗栗縣,公館鄉,0089,410,290,700,92,792,1455,54.43%,28.18%,1
苗栗縣,公館鄉,0090,543,348,891,111,1002,1615,62.04%,33.62%,1
苗栗縣,公館鄉,0091,438,267,705,99,804,1451,55.41%,30.19%,1
苗栗縣,公館鄉,0092,496,308,804,78,882,1462,60.33%,33.93%,1
苗栗縣,公館鄉,0093,396,265,661,76,737,1317,55.96%,30.07%,1
苗栗縣,公館鄉,0094,78,39,117,14,131,221,59.28%,35.29%,1
苗栗縣,公館鄉,0095,95,65,160,15,175,329,53.19%,28.88%,1
苗栗縣,銅鑼鄉,0108,324,177,501,48,549,887,61.89%,36.53%,1
苗栗縣,銅鑼鄉,0109,356,221,577,54,631,1052,59.98%,33.84%,1
苗栗縣,銅鑼鄉,0110,456,317,773,54,827,1347,61.4%,33.85%,1
苗栗縣,銅鑼鄉,0111,377,242,619,53,672,1177,57.09%,32.03%,1
苗栗縣,銅鑼鄉,0112,368,276,644,41,685,1268,54.02%,29.02%,1
苗栗縣,銅鑼鄉,0113,334,221,555,28,583,1185,49.2%,28.19%,1
苗栗縣,銅鑼鄉,0114,373,177,550,47,597,1029,58.02%,36.25%,1
苗栗縣,銅鑼鄉,0115,304,181,485,36,521,905,57.57%,33.59%,1
苗栗縣,銅鑼鄉,0116,252,168,420,46,466,750,62.13%,33.6%,1
苗栗縣,銅鑼鄉,0117,312,202,514,39,553,1080,51.2%,28.89%,1
苗栗縣,銅鑼鄉,0118,345,202,547,54,601,1108,54.24%,31.14%,1
苗栗縣,銅鑼鄉,0119,266,153,419,38,457,862,53.02%,30.86%,1
苗栗縣,銅鑼鄉,0120,345,259,604,43,647,1216,53.21%,28.37%,1
苗栗縣,銅鑼鄉,0121,166,107,273,30,303,588,51.53%,28.23%,1
苗栗縣,銅鑼鄉,0122,126,81,207,27,234,429,54.55%,29.37%,1
苗栗縣,銅鑼鄉,0123,171,116,287,30,317,541,58.6%,31.61%,1
苗栗縣,南庄鄉,0411,326,238,564,75,639,1155,55.32%,28.23%,1
苗栗縣,南庄鄉,0412,201,137,338,28,366,650,56.31%,30.92%,1
苗栗縣,南庄鄉,0413,360,264,624,75,699,1353,51.66%,26.61%,1
苗栗縣,南庄鄉,0414,189,124,313,44,357,813,43.91%,23.25%,1
苗栗縣,南庄鄉,0415,193,131,324,39,363,837,43.37%,23.06%,1
苗栗縣,南庄鄉,0416,341,186,527,47,574,1093,52.52%,31.2%,1
苗栗縣,南庄鄉,0417,281,232,513,60,573,1048,54.68%,26.81%,1
苗栗縣,南庄鄉,0418,233,178,411,36,447,872,51.26%,26.72%,1
苗栗縣,南庄鄉,0419,163,124,287,16,303,963,31.46%,16.93%,1
苗栗縣,頭屋鄉,0096,495,329,824,69,893,1335,66.89%,37.08%,1
苗栗縣,頭屋鄉,0097,438,281,719,108,827,1168,70.8%,37.5%,1
苗栗縣,頭屋鄉,0098,280,200,480,40,520,792,65.66%,35.35%,1
苗栗縣,頭屋鄉,0099,378,226,604,54,658,918,71.68%,41.18%,1
苗栗縣,頭屋鄉,0100,272,152,424,40,464,725,64%,37.52%,1
苗栗縣,頭屋鄉,0101,329,183,512,43,555,899,61.74%,36.6%,1
苗栗縣,頭屋鄉,0102,98,69,167,14,181,369,49.05%,26.56%,1
苗栗縣,頭屋鄉,0103,267,200,467,37,504,844,59.72%,31.64%,1
苗栗縣,頭屋鄉,0104,352,221,573,31,604,1007,59.98%,34.96%,1
苗栗縣,頭屋鄉,0105,305,163,468,33,501,794,63.1%,38.41%,1
苗栗縣,頭屋鄉,0106,84,54,138,18,156,211,73.93%,39.81%,1
苗栗縣,頭屋鄉,0107,132,82,214,24,238,328,72.56%,40.24%,1
苗栗縣,三義鄉,0124,271,192,463,58,521,853,61.08%,31.77%,1
苗栗縣,三義鄉,0125,351,230,581,34,615,983,62.56%,35.71%,1
苗栗縣,三義鄉,0126,354,235,589,59,648,1080,60%,32.78%,1
苗栗縣,三義鄉,0127,380,240,620,31,651,1216,53.54%,31.25%,1
苗栗縣,三義鄉,0128,322,236,558,45,603,1017,59.29%,31.66%,1
苗栗縣,三義鄉,0129,290,318,608,24,632,1180,53.56%,24.58%,1
苗栗縣,三義鄉,0130,374,280,654,30,684,1198,57.1%,31.22%,1
苗栗縣,三義鄉,0131,135,86,221,21,242,417,58.03%,32.37%,1
苗栗縣,三義鄉,0132,294,190,484,32,516,991,52.07%,29.67%,1
苗栗縣,三義鄉,0133,256,210,466,22,488,834,58.51%,30.7%,1
苗栗縣,三義鄉,0134,193,143,336,30,366,622,58.84%,31.03%,1
苗栗縣,三義鄉,0135,234,185,419,41,460,749,61.42%,31.24%,1
苗栗縣,三義鄉,0136,276,151,427,33,460,692,66.47%,39.88%,1
苗栗縣,三義鄉,0137,299,199,498,37,535,759,70.49%,39.39%,1
苗栗縣,三義鄉,0138,160,132,292,44,336,629,53.42%,25.44%,1
苗栗縣,三義鄉,0139,207,144,351,37,388,669,58%,30.94%,1
苗栗縣,西湖鄉,0140,172,128,300,26,326,601,54.24%,28.62%,1
苗栗縣,西湖鄉,0141,197,118,315,26,341,566,60.25%,34.81%,1
苗栗縣,西湖鄉,0142,249,188,437,55,492,843,58.36%,29.54%,1
苗栗縣,西湖鄉,0143,197,121,318,24,342,648,52.78%,30.4%,1
苗栗縣,西湖鄉,0144,262,155,417,55,472,936,50.43%,27.99%,1
苗栗縣,西湖鄉,0145,142,92,234,13,247,461,53.58%,30.8%,1
苗栗縣,西湖鄉,0146,153,121,274,20,294,515,57.09%,29.71%,1
苗栗縣,西湖鄉,0147,309,236,545,70,615,1141,53.9%,27.08%,1
苗栗縣,西湖鄉,0148,208,146,354,40,394,671,58.72%,31%,1
苗栗縣,造橋鄉,0258,392,288,680,85,765,1171,65.33%,33.48%,1
苗栗縣,造橋鄉,0259,290,190,480,49,529,889,59.51%,32.62%,1
苗栗縣,造橋鄉,0260,149,66,215,22,237,479,49.48%,31.11%,1
苗栗縣,造橋鄉,0261,347,205,552,50,602,1024,58.79%,33.89%,1
苗栗縣,造橋鄉,0262,310,270,580,77,657,1214,54.12%,25.54%,1
苗栗縣,造橋鄉,0263,297,232,529,31,560,1071,52.29%,27.73%,1
苗栗縣,造橋鄉,0264,328,208,536,72,608,1157,52.55%,28.35%,1
苗栗縣,造橋鄉,0265,151,111,262,37,299,512,58.4%,29.49%,1
苗栗縣,造橋鄉,0266,184,100,284,26,310,491,63.14%,37.47%,1
苗栗縣,造橋鄉,0267,396,291,687,78,765,1272,60.14%,31.13%,1
苗栗縣,造橋鄉,0268,244,155,399,52,451,785,57.45%,31.08%,1
苗栗縣,造橋鄉,0269,298,243,541,97,638,962,66.32%,30.98%,1
苗栗縣,三灣鄉,0402,346,215,561,35,596,996,59.84%,34.74%,1
苗栗縣,三灣鄉,0403,380,242,622,66,688,1205,57.1%,31.54%,1
苗栗縣,三灣鄉,0404,199,132,331,55,386,635,60.79%,31.34%,1
苗栗縣,三灣鄉,0405,253,172,425,69,494,862,57.31%,29.35%,1
苗栗縣,三灣鄉,0406,55,50,105,13,118,238,49.58%,23.11%,1
苗栗縣,三灣鄉,0407,131,125,256,36,292,541,53.97%,24.21%,1
苗栗縣,三灣鄉,0408,159,104,263,35,298,578,51.56%,27.51%,1
苗栗縣,三灣鄉,0409,128,101,229,50,279,405,68.89%,31.6%,1
苗栗縣,三灣鄉,0410,117,83,200,22,222,392,56.63%,29.85%,1
苗栗縣,獅潭鄉,0435,77,40,117,12,129,328,39.33%,23.48%,1
苗栗縣,獅潭鄉,0436,128,81,209,39,248,565,43.89%,22.65%,1
苗栗縣,獅潭鄉,0437,285,179,464,59,523,911,57.41%,31.28%,1
苗栗縣,獅潭鄉,0438,159,84,243,25,268,568,47.18%,27.99%,1
苗栗縣,獅潭鄉,0439,190,124,314,27,341,580,58.79%,32.76%,1
苗栗縣,獅潭鄉,0440,103,58,161,9,170,333,51.05%,30.93%,1
苗栗縣,獅潭鄉,0441,209,118,327,21,348,683,50.95%,30.6%,1
苗栗縣,泰安鄉,0461,70,62,132,16,148,325,45.54%,21.54%,1
苗栗縣,泰安鄉,0462,154,96,250,34,284,484,58.68%,31.82%,1
苗栗縣,泰安鄉,0463,252,186,438,48,486,666,72.97%,37.84%,1
苗栗縣,泰安鄉,0464,207,128,335,54,389,574,67.77%,36.06%,1
苗栗縣,泰安鄉,0465,102,57,159,12,171,333,51.35%,30.63%,1
苗栗縣,泰安鄉,0466,192,129,321,15,336,495,67.88%,38.79%,1
苗栗縣,泰安鄉,0467,202,148,350,40,390,544,71.69%,37.13%,1
苗栗縣,泰安鄉,0468,123,92,215,25,240,500,48%,24.6%,1
苗栗縣,泰安鄉,0469,257,172,429,50,479,670,71.49%,38.36%,1
苗栗縣,泰安鄉,0470,188,249,437,6,443,589,75.21%,31.92%,1
彰化縣,彰化市,0001,293,190,483,47,530,871,60.85%,33.64%,1
彰化縣,彰化市,0002,187,133,320,43,363,751,48.34%,24.9%,1
彰化縣,彰化市,0003,334,225,559,51,610,923,66.09%,36.19%,1
彰化縣,彰化市,0004,258,173,431,53,484,779,62.13%,33.12%,1
彰化縣,彰化市,0005,240,194,434,45,479,779,61.49%,30.81%,1
彰化縣,彰化市,0006,221,174,395,31,426,720,59.17%,30.69%,1
彰化縣,彰化市,0007,248,156,404,43,447,749,59.68%,33.11%,1
彰化縣,彰化市,0008,282,170,452,51,503,767,65.58%,36.77%,1
彰化縣,彰化市,0009,338,247,585,67,652,1047,62.27%,32.28%,1
彰化縣,彰化市,0010,300,234,534,53,587,1027,57.16%,29.21%,1
彰化縣,彰化市,0011,363,280,643,74,717,1249,57.41%,29.06%,1
彰化縣,彰化市,0012,357,260,617,58,675,1136,59.42%,31.43%,1
彰化縣,彰化市,0013,384,256,640,85,725,1169,62.02%,32.85%,1
彰化縣,彰化市,0014,263,190,453,31,484,766,63.19%,34.33%,1
彰化縣,彰化市,0015,224,129,353,24,377,643,58.63%,34.84%,1
彰化縣,彰化市,0016,432,241,673,72,745,1251,59.55%,34.53%,1
彰化縣,彰化市,0017,265,204,469,40,509,1301,39.12%,20.37%,1
彰化縣,彰化市,0018,464,255,719,50,769,1280,60.08%,36.25%,1
彰化縣,彰化市,0019,398,269,667,60,727,1179,61.66%,33.76%,1
彰化縣,彰化市,0020,405,241,646,43,689,1168,58.99%,34.67%,1
彰化縣,彰化市,0021,399,264,663,51,714,1218,58.62%,32.76%,1
彰化縣,彰化市,0022,494,328,822,65,887,1351,65.66%,36.57%,1
彰化縣,彰化市,0023,408,287,695,42,737,1204,61.21%,33.89%,1
彰化縣,彰化市,0024,418,264,682,27,709,1189,59.63%,35.16%,1
彰化縣,彰化市,0025,376,254,630,68,698,1207,57.83%,31.15%,1
彰化縣,彰化市,0026,379,256,635,61,696,1161,59.95%,32.64%,1
彰化縣,彰化市,0027,312,300,612,45,657,1166,56.35%,26.76%,1
彰化縣,彰化市,0028,485,301,786,60,846,1362,62.11%,35.61%,1
彰化縣,彰化市,0029,403,323,726,45,771,1236,62.38%,32.61%,1
彰化縣,彰化市,0030,337,254,591,54,645,1065,60.56%,31.64%,1
彰化縣,彰化市,0031,392,272,664,62,726,1199,60.55%,32.69%,1
彰化縣,彰化市,0032,408,293,701,39,740,1233,60.02%,33.09%,1
彰化縣,彰化市,0033,411,276,687,34,721,1245,57.91%,33.01%,1
彰化縣,彰化市,0034,380,291,671,50,721,1153,62.53%,32.96%,1
彰化縣,彰化市,0035,312,234,546,47,593,1045,56.75%,29.86%,1
彰化縣,彰化市,0036,351,261,612,23,635,1097,57.89%,32%,1
彰化縣,彰化市,0037,391,252,643,49,692,1190,58.15%,32.86%,1
彰化縣,彰化市,0038,392,258,650,44,694,1106,62.75%,35.44%,1
彰化縣,彰化市,0039,371,244,615,47,662,1097,60.35%,33.82%,1
彰化縣,彰化市,0040,342,238,580,63,643,1048,61.35%,32.63%,1
彰化縣,彰化市,0041,342,228,570,47,617,980,62.96%,34.9%,1
彰化縣,彰化市,0042,245,172,417,29,446,707,63.08%,34.65%,1
彰化縣,彰化市,0043,247,191,438,56,494,809,61.06%,30.53%,1
彰化縣,彰化市,0044,312,266,578,58,636,1008,63.1%,30.95%,1
彰化縣,彰化市,0045,267,180,447,66,513,901,56.94%,29.63%,1
彰化縣,彰化市,0046,302,200,502,48,550,951,57.83%,31.76%,1
彰化縣,彰化市,0047,357,249,606,43,649,1076,60.32%,33.18%,1
彰化縣,彰化市,0048,200,314,514,46,560,1022,54.79%,19.57%,1
彰化縣,彰化市,0049,293,193,486,54,540,894,60.4%,32.77%,1
彰化縣,彰化市,0050,328,238,566,52,618,1016,60.83%,32.28%,1
彰化縣,彰化市,0051,245,173,418,83,501,771,64.98%,31.78%,1
彰化縣,彰化市,0052,256,220,476,55,531,868,61.18%,29.49%,1
彰化縣,彰化市,0053,330,265,595,92,687,1135,60.53%,29.07%,1
彰化縣,彰化市,0054,268,223,491,74,565,910,62.09%,29.45%,1
彰化縣,彰化市,0055,287,279,566,49,615,1004,61.25%,28.59%,1
彰化縣,彰化市,0056,354,267,621,53,674,1077,62.58%,32.87%,1
彰化縣,彰化市,0057,465,296,761,67,828,1258,65.82%,36.96%,1
彰化縣,彰化市,0058,346,249,595,57,652,1025,63.61%,33.76%,1
彰化縣,彰化市,0059,399,271,670,71,741,1177,62.96%,33.9%,1
彰化縣,彰化市,0060,411,235,646,74,720,1262,57.05%,32.57%,1
彰化縣,彰化市,0061,417,243,660,96,756,1209,62.53%,34.49%,1
彰化縣,彰化市,0062,364,236,600,57,657,1041,63.11%,34.97%,1
彰化縣,彰化市,0063,354,261,615,57,672,1075,62.51%,32.93%,1
彰化縣,彰化市,0064,325,211,536,56,592,1029,57.53%,31.58%,1
彰化縣,彰化市,0065,344,279,623,77,700,1203,58.19%,28.6%,1
彰化縣,彰化市,0066,289,236,525,63,588,1014,57.99%,28.5%,1
彰化縣,彰化市,0067,360,238,598,49,647,1069,60.52%,33.68%,1
彰化縣,彰化市,0068,262,197,459,36,495,969,51.08%,27.04%,1
彰化縣,彰化市,0069,322,219,541,51,592,1105,53.57%,29.14%,1
彰化縣,彰化市,0070,344,234,578,51,629,981,64.12%,35.07%,1
彰化縣,彰化市,0071,340,273,613,78,691,1095,63.11%,31.05%,1
彰化縣,彰化市,0072,356,275,631,42,673,1087,61.91%,32.75%,1
彰化縣,彰化市,0073,374,214,588,51,639,1050,60.86%,35.62%,1
彰化縣,彰化市,0074,430,279,709,63,772,1252,61.66%,34.35%,1
彰化縣,彰化市,0075,329,241,570,50,620,1113,55.71%,29.56%,1
彰化縣,彰化市,0076,341,248,589,42,631,1009,62.54%,33.8%,1
彰化縣,彰化市,0077,318,210,528,48,576,999,57.66%,31.83%,1
彰化縣,彰化市,0078,306,250,556,31,587,997,58.88%,30.69%,1
彰化縣,彰化市,0079,431,264,695,48,743,1145,64.89%,37.64%,1
彰化縣,彰化市,0080,398,289,687,33,720,1227,58.68%,32.44%,1
彰化縣,彰化市,0081,393,307,700,54,754,1208,62.42%,32.53%,1
彰化縣,彰化市,0082,502,370,872,58,930,1598,58.2%,31.41%,1
彰化縣,彰化市,0083,303,198,501,48,549,890,61.69%,34.04%,1
彰化縣,彰化市,0084,405,254,659,43,702,1104,63.59%,36.68%,1
彰化縣,彰化市,0085,363,234,597,35,632,1097,57.61%,33.09%,1
彰化縣,彰化市,0086,260,157,417,54,471,799,58.95%,32.54%,1
彰化縣,彰化市,0087,333,215,548,72,620,1000,62%,33.3%,1
彰化縣,彰化市,0088,336,237,573,96,669,1153,58.02%,29.14%,1
彰化縣,彰化市,0089,284,246,530,76,606,977,62.03%,29.07%,1
彰化縣,彰化市,0090,343,280,623,74,697,1201,58.03%,28.56%,1
彰化縣,彰化市,0091,317,275,592,70,662,1057,62.63%,29.99%,1
彰化縣,彰化市,0092,368,278,646,84,730,1238,58.97%,29.73%,1
彰化縣,彰化市,0093,395,297,692,55,747,1210,61.74%,32.64%,1
彰化縣,彰化市,0094,325,248,573,62,635,1026,61.89%,31.68%,1
彰化縣,彰化市,0095,427,214,641,57,698,1061,65.79%,40.25%,1
彰化縣,彰化市,0096,387,266,653,72,725,1213,59.77%,31.9%,1
彰化縣,彰化市,0097,411,309,720,53,773,1264,61.16%,32.52%,1
彰化縣,彰化市,0098,208,206,414,53,467,691,67.58%,30.1%,1
彰化縣,彰化市,0099,302,215,517,61,578,893,64.73%,33.82%,1
彰化縣,彰化市,0100,220,186,406,50,456,733,62.21%,30.01%,1
彰化縣,彰化市,0101,213,192,405,43,448,692,64.74%,30.78%,1
彰化縣,彰化市,0102,214,172,386,48,434,728,59.62%,29.4%,1
彰化縣,彰化市,0103,272,199,471,30,501,773,64.81%,35.19%,1
彰化縣,彰化市,0104,280,186,466,29,495,975,50.77%,28.72%,1
彰化縣,彰化市,0105,302,215,517,43,560,908,61.67%,33.26%,1
彰化縣,彰化市,0106,354,292,646,13,659,1156,57.01%,30.62%,1
彰化縣,彰化市,0107,392,306,698,58,756,1235,61.21%,31.74%,1
彰化縣,彰化市,0108,426,296,722,54,776,1376,56.4%,30.96%,1
彰化縣,彰化市,0109,420,323,743,46,789,1389,56.8%,30.24%,1
彰化縣,彰化市,0110,272,230,502,58,560,846,66.19%,32.15%,1
彰化縣,彰化市,0111,300,209,509,46,555,859,64.61%,34.92%,1
彰化縣,彰化市,0112,278,180,458,26,484,781,61.97%,35.6%,1
彰化縣,彰化市,0113,293,189,482,38,520,875,59.43%,33.49%,1
彰化縣,彰化市,0114,260,176,436,50,486,816,59.56%,31.86%,1
彰化縣,彰化市,0115,207,186,393,41,434,687,63.17%,30.13%,1
彰化縣,彰化市,0116,247,167,414,57,471,727,64.79%,33.98%,1
彰化縣,彰化市,0117,217,182,399,30,429,662,64.8%,32.78%,1
彰化縣,彰化市,0118,239,141,380,27,407,633,64.3%,37.76%,1
彰化縣,彰化市,0119,311,231,542,46,588,906,64.9%,34.33%,1
彰化縣,彰化市,0120,267,165,432,58,490,853,57.44%,31.3%,1
彰化縣,彰化市,0121,347,241,588,58,646,1027,62.9%,33.79%,1
彰化縣,彰化市,0122,325,256,581,53,634,993,63.85%,32.73%,1
彰化縣,彰化市,0123,242,220,462,58,520,848,61.32%,28.54%,1
彰化縣,彰化市,0124,372,289,661,45,706,1118,63.15%,33.27%,1
彰化縣,彰化市,0125,426,282,708,59,767,1263,60.73%,33.73%,1
彰化縣,彰化市,0126,432,298,730,70,800,1268,63.09%,34.07%,1
彰化縣,彰化市,0127,439,275,714,59,773,1258,61.45%,34.9%,1
彰化縣,彰化市,0128,418,282,700,43,743,1212,61.3%,34.49%,1
彰化縣,彰化市,0129,305,187,492,81,573,924,62.01%,33.01%,1
彰化縣,彰化市,0130,338,227,565,33,598,939,63.68%,36%,1
彰化縣,彰化市,0131,323,257,580,63,643,953,67.47%,33.89%,1
彰化縣,彰化市,0132,367,234,601,48,649,981,66.16%,37.41%,1
彰化縣,彰化市,0133,415,292,707,84,791,1249,63.33%,33.23%,1
彰化縣,彰化市,0134,261,193,454,62,516,817,63.16%,31.95%,1
彰化縣,彰化市,0135,302,187,489,41,530,872,60.78%,34.63%,1
彰化縣,彰化市,0136,226,147,373,31,404,689,58.64%,32.8%,1
彰化縣,彰化市,0137,439,252,691,40,731,1156,63.24%,37.98%,1
彰化縣,彰化市,0138,435,263,698,42,740,1291,57.32%,33.69%,1
彰化縣,彰化市,0139,374,250,624,39,663,1139,58.21%,32.84%,1
彰化縣,彰化市,0140,365,271,636,62,698,1125,62.04%,32.44%,1
彰化縣,彰化市,0141,405,275,680,41,721,1258,57.31%,32.19%,1
彰化縣,彰化市,0142,379,238,617,49,666,1123,59.31%,33.75%,1
彰化縣,彰化市,0143,367,263,630,70,700,1175,59.57%,31.23%,1
彰化縣,彰化市,0144,286,245,531,40,571,862,66.24%,33.18%,1
彰化縣,彰化市,0145,282,211,493,36,529,872,60.67%,32.34%,1
彰化縣,彰化市,0146,311,240,551,26,577,897,64.33%,34.67%,1
彰化縣,彰化市,0147,297,228,525,33,558,1003,55.63%,29.61%,1
彰化縣,彰化市,0148,278,213,491,25,516,915,56.39%,30.38%,1
彰化縣,彰化市,0149,369,242,611,57,668,1158,57.69%,31.87%,1
彰化縣,彰化市,0150,355,283,638,46,684,1084,63.1%,32.75%,1
彰化縣,彰化市,0151,408,305,713,70,783,1372,57.07%,29.74%,1
彰化縣,彰化市,0152,359,272,631,54,685,1113,61.55%,32.26%,1
彰化縣,彰化市,0153,280,185,465,43,508,800,63.5%,35%,1
彰化縣,彰化市,0154,255,228,483,56,539,885,60.9%,28.81%,1
彰化縣,彰化市,0155,353,230,583,32,615,1000,61.5%,35.3%,1
彰化縣,彰化市,0156,336,248,584,47,631,1159,54.44%,28.99%,1
彰化縣,彰化市,0157,353,247,600,44,644,1123,57.35%,31.43%,1
彰化縣,彰化市,0158,328,195,523,78,601,907,66.26%,36.16%,1
彰化縣,彰化市,0159,316,164,480,83,563,989,56.93%,31.95%,1
彰化縣,彰化市,0160,326,244,570,66,636,1012,62.85%,32.21%,1
彰化縣,彰化市,0161,283,213,496,48,544,1033,52.66%,27.4%,1
彰化縣,彰化市,0162,427,200,627,54,681,1116,61.02%,38.26%,1
彰化縣,彰化市,0163,408,274,682,31,713,1154,61.79%,35.36%,1
彰化縣,彰化市,0164,357,227,584,49,633,1064,59.49%,33.55%,1
彰化縣,彰化市,0165,252,189,441,60,501,770,65.06%,32.73%,1
彰化縣,彰化市,0166,287,223,510,47,557,889,62.65%,32.28%,1
彰化縣,彰化市,0167,257,181,438,62,500,786,63.61%,32.7%,1
彰化縣,彰化市,0168,317,237,554,61,615,1120,54.91%,28.3%,1
彰化縣,彰化市,0169,337,323,660,28,688,1269,54.22%,26.56%,1
彰化縣,彰化市,0170,384,261,645,63,708,1159,61.09%,33.13%,1
彰化縣,彰化市,0171,352,305,657,69,726,1184,61.32%,29.73%,1
彰化縣,彰化市,0172,332,253,585,51,636,1089,58.4%,30.49%,1
彰化縣,彰化市,0173,323,251,574,59,633,968,65.39%,33.37%,1
彰化縣,彰化市,0174,316,198,514,32,546,930,58.71%,33.98%,1
彰化縣,彰化市,0175,336,216,552,45,597,973,61.36%,34.53%,1
彰化縣,彰化市,0176,355,213,568,45,613,1184,51.77%,29.98%,1
彰化縣,彰化市,0177,313,222,535,77,612,1002,61.08%,31.24%,1
彰化縣,彰化市,0178,393,224,617,27,644,1148,56.1%,34.23%,1
彰化縣,彰化市,0179,382,210,592,54,646,1112,58.09%,34.35%,1
彰化縣,彰化市,0180,348,215,563,59,622,907,68.58%,38.37%,1
彰化縣,彰化市,0181,380,230,610,69,679,1112,61.06%,34.17%,1
彰化縣,彰化市,0182,228,149,377,45,422,823,51.28%,27.7%,1
彰化縣,彰化市,0183,393,276,669,90,759,1276,59.48%,30.8%,1
彰化縣,彰化市,0184,337,263,600,60,660,1161,56.85%,29.03%,1
彰化縣,鹿港鎮,0243,304,287,591,77,668,1140,58.6%,26.67%,1
彰化縣,鹿港鎮,0244,158,107,265,39,304,511,59.49%,30.92%,1
彰化縣,鹿港鎮,0245,227,155,382,22,404,857,47.14%,26.49%,1
彰化縣,鹿港鎮,0246,300,238,538,73,611,946,64.59%,31.71%,1
彰化縣,鹿港鎮,0247,288,227,515,49,564,945,59.68%,30.48%,1
彰化縣,鹿港鎮,0248,355,237,592,64,656,1097,59.8%,32.36%,1
彰化縣,鹿港鎮,0249,415,280,695,44,739,1479,49.97%,28.06%,1
彰化縣,鹿港鎮,0250,432,338,770,85,855,1425,60%,30.32%,1
彰化縣,鹿港鎮,0251,287,200,487,71,558,880,63.41%,32.61%,1
彰化縣,鹿港鎮,0252,350,227,577,83,660,1183,55.79%,29.59%,1
彰化縣,鹿港鎮,0253,316,240,556,76,632,1047,60.36%,30.18%,1
彰化縣,鹿港鎮,0254,321,233,554,32,586,1097,53.42%,29.26%,1
彰化縣,鹿港鎮,0255,325,204,529,64,593,1030,57.57%,31.55%,1
彰化縣,鹿港鎮,0256,389,234,623,48,671,1161,57.8%,33.51%,1
彰化縣,鹿港鎮,0257,148,129,277,63,340,540,62.96%,27.41%,1
彰化縣,鹿港鎮,0258,332,247,579,65,644,1135,56.74%,29.25%,1
彰化縣,鹿港鎮,0259,351,242,593,79,672,1155,58.18%,30.39%,1
彰化縣,鹿港鎮,0260,391,251,642,56,698,1127,61.93%,34.69%,1
彰化縣,鹿港鎮,0261,336,229,565,58,623,1045,59.62%,32.15%,1
彰化縣,鹿港鎮,0262,334,253,587,80,667,1127,59.18%,29.64%,1
彰化縣,鹿港鎮,0263,400,286,686,67,753,1178,63.92%,33.96%,1
彰化縣,鹿港鎮,0264,83,71,154,15,169,284,59.51%,29.23%,1
彰化縣,鹿港鎮,0265,170,134,304,41,345,584,59.08%,29.11%,1
彰化縣,鹿港鎮,0266,226,158,384,50,434,659,65.86%,34.29%,1
彰化縣,鹿港鎮,0267,273,194,467,30,497,915,54.32%,29.84%,1
彰化縣,鹿港鎮,0268,316,282,598,79,677,1079,62.74%,29.29%,1
彰化縣,鹿港鎮,0269,422,230,652,78,730,1129,64.66%,37.38%,1
彰化縣,鹿港鎮,0270,396,237,633,72,705,1273,55.38%,31.11%,1
彰化縣,鹿港鎮,0271,203,121,324,53,377,706,53.4%,28.75%,1
彰化縣,鹿港鎮,0272,342,174,516,114,630,1137,55.41%,30.08%,1
彰化縣,鹿港鎮,0273,320,274,594,67,661,1195,55.31%,26.78%,1
彰化縣,鹿港鎮,0274,352,230,582,80,662,1225,54.04%,28.73%,1
彰化縣,鹿港鎮,0275,345,217,562,68,630,957,65.83%,36.05%,1
彰化縣,鹿港鎮,0276,210,124,334,70,404,758,53.3%,27.7%,1
彰化縣,鹿港鎮,0277,213,158,371,60,431,723,59.61%,29.46%,1
彰化縣,鹿港鎮,0278,297,195,492,48,540,984,54.88%,30.18%,1
彰化縣,鹿港鎮,0279,357,223,580,66,646,1018,63.46%,35.07%,1
彰化縣,鹿港鎮,0280,371,210,581,64,645,1165,55.36%,31.85%,1
彰化縣,鹿港鎮,0281,228,259,487,64,551,1161,47.46%,19.64%,1
彰化縣,鹿港鎮,0282,305,186,491,66,557,1020,54.61%,29.9%,1
彰化縣,鹿港鎮,0283,325,229,554,72,626,1068,58.61%,30.43%,1
彰化縣,鹿港鎮,0284,335,211,546,62,608,1024,59.38%,32.71%,1
彰化縣,鹿港鎮,0285,295,215,510,88,598,974,61.4%,30.29%,1
彰化縣,鹿港鎮,0286,430,295,725,94,819,1505,54.42%,28.57%,1
彰化縣,鹿港鎮,0287,291,248,539,65,604,1092,55.31%,26.65%,1
彰化縣,鹿港鎮,0288,396,267,663,79,742,1223,60.67%,32.38%,1
彰化縣,鹿港鎮,0289,438,252,690,51,741,1572,47.14%,27.86%,1
彰化縣,鹿港鎮,0290,358,196,554,64,618,1003,61.62%,35.69%,1
彰化縣,鹿港鎮,0291,304,204,508,48,556,933,59.59%,32.58%,1
彰化縣,鹿港鎮,0292,347,249,596,67,663,1093,60.66%,31.75%,1
彰化縣,鹿港鎮,0293,284,192,476,34,510,907,56.23%,31.31%,1
彰化縣,鹿港鎮,0294,333,274,607,67,674,1219,55.29%,27.32%,1
彰化縣,鹿港鎮,0295,469,320,789,99,888,1397,63.56%,33.57%,1
彰化縣,鹿港鎮,0296,396,263,659,49,708,1229,57.61%,32.22%,1
彰化縣,鹿港鎮,0297,443,296,739,52,791,1444,54.78%,30.68%,1
彰化縣,鹿港鎮,0298,398,256,654,77,731,1227,59.58%,32.44%,1
彰化縣,鹿港鎮,0299,365,274,639,74,713,1187,60.07%,30.75%,1
彰化縣,鹿港鎮,0300,390,256,646,47,693,1296,53.47%,30.09%,1
彰化縣,鹿港鎮,0301,390,294,684,69,753,1451,51.9%,26.88%,1
彰化縣,鹿港鎮,0302,368,299,667,69,736,1299,56.66%,28.33%,1
彰化縣,鹿港鎮,0303,462,275,737,65,802,1298,61.79%,35.59%,1
彰化縣,鹿港鎮,0304,468,290,758,82,840,1458,57.61%,32.1%,1
彰化縣,鹿港鎮,0305,343,271,614,57,671,1138,58.96%,30.14%,1
彰化縣,鹿港鎮,0306,362,255,617,67,684,1170,58.46%,30.94%,1
彰化縣,鹿港鎮,0307,399,278,677,65,742,1221,60.77%,32.68%,1
彰化縣,和美鎮,0373,391,270,661,78,739,1341,55.11%,29.16%,1
彰化縣,和美鎮,0374,418,286,704,65,769,1480,51.96%,28.24%,1
彰化縣,和美鎮,0375,476,330,806,51,857,1529,56.05%,31.13%,1
彰化縣,和美鎮,0376,477,336,813,36,849,1711,49.62%,27.88%,1
彰化縣,和美鎮,0377,326,247,573,42,615,1057,58.18%,30.84%,1
彰化縣,和美鎮,0378,345,219,564,50,614,1032,59.5%,33.43%,1
彰化縣,和美鎮,0379,302,251,553,58,611,1015,60.2%,29.75%,1
彰化縣,和美鎮,0380,414,257,671,63,734,1209,60.71%,34.24%,1
彰化縣,和美鎮,0381,130,102,232,19,251,430,58.37%,30.23%,1
彰化縣,和美鎮,0382,249,195,444,23,467,856,54.56%,29.09%,1
彰化縣,和美鎮,0383,341,203,544,37,581,966,60.14%,35.3%,1
彰化縣,和美鎮,0384,325,223,548,34,582,1059,54.96%,30.69%,1
彰化縣,和美鎮,0385,334,249,583,55,638,1117,57.12%,29.9%,1
彰化縣,和美鎮,0386,306,231,537,55,592,1066,55.53%,28.71%,1
彰化縣,和美鎮,0387,399,226,625,51,676,1252,53.99%,31.87%,1
彰化縣,和美鎮,0388,454,285,739,68,807,1528,52.81%,29.71%,1
彰化縣,和美鎮,0389,263,188,451,46,497,826,60.17%,31.84%,1
彰化縣,和美鎮,0390,268,173,441,39,480,854,56.21%,31.38%,1
彰化縣,和美鎮,0391,388,280,668,69,737,1387,53.14%,27.97%,1
彰化縣,和美鎮,0392,279,172,451,26,477,765,62.35%,36.47%,1
彰化縣,和美鎮,0393,426,253,679,71,750,1438,52.16%,29.62%,1
彰化縣,和美鎮,0394,446,307,753,77,830,1396,59.46%,31.95%,1
彰化縣,和美鎮,0395,211,140,351,28,379,658,57.6%,32.07%,1
彰化縣,和美鎮,0396,290,197,487,29,516,809,63.78%,35.85%,1
彰化縣,和美鎮,0397,254,200,454,29,483,932,51.82%,27.25%,1
彰化縣,和美鎮,0398,280,169,449,37,486,888,54.73%,31.53%,1
彰化縣,和美鎮,0399,398,249,647,51,698,1144,61.01%,34.79%,1
彰化縣,和美鎮,0400,347,218,565,50,615,1077,57.1%,32.22%,1
彰化縣,和美鎮,0401,359,278,637,76,713,1349,52.85%,26.61%,1
彰化縣,和美鎮,0402,402,268,670,49,719,1155,62.25%,34.81%,1
彰化縣,和美鎮,0403,409,230,639,55,694,1253,55.39%,32.64%,1
彰化縣,和美鎮,0404,383,249,632,53,685,1252,54.71%,30.59%,1
彰化縣,和美鎮,0405,469,283,752,35,787,1474,53.39%,31.82%,1
彰化縣,和美鎮,0406,379,268,647,45,692,1396,49.57%,27.15%,1
彰化縣,和美鎮,0407,429,245,674,50,724,1348,53.71%,31.82%,1
彰化縣,和美鎮,0408,325,255,580,39,619,999,61.96%,32.53%,1
彰化縣,和美鎮,0409,296,209,505,44,549,911,60.26%,32.49%,1
彰化縣,和美鎮,0410,312,237,549,37,586,1005,58.31%,31.04%,1
彰化縣,和美鎮,0411,308,199,507,54,561,967,58.01%,31.85%,1
彰化縣,和美鎮,0412,320,377,697,68,765,1308,58.49%,24.46%,1
彰化縣,和美鎮,0413,425,270,695,53,748,1324,56.5%,32.1%,1
彰化縣,和美鎮,0414,305,280,585,72,657,1102,59.62%,27.68%,1
彰化縣,和美鎮,0415,324,236,560,60,620,1124,55.16%,28.83%,1
彰化縣,和美鎮,0416,362,265,627,77,704,1211,58.13%,29.89%,1
彰化縣,和美鎮,0417,305,222,527,61,588,884,66.52%,34.5%,1
彰化縣,和美鎮,0418,320,256,576,75,651,1119,58.18%,28.6%,1
彰化縣,和美鎮,0419,394,277,671,69,740,1300,56.92%,30.31%,1
彰化縣,和美鎮,0420,310,233,543,61,604,1104,54.71%,28.08%,1
彰化縣,和美鎮,0421,421,259,680,60,740,1213,61.01%,34.71%,1
彰化縣,和美鎮,0422,308,211,519,56,575,1127,51.02%,27.33%,1
彰化縣,和美鎮,0423,277,186,463,61,524,919,57.02%,30.14%,1
彰化縣,和美鎮,0424,323,213,536,57,593,987,60.08%,32.73%,1
彰化縣,和美鎮,0425,334,209,543,48,591,958,61.69%,34.86%,1
彰化縣,和美鎮,0426,479,255,734,55,789,1362,57.93%,35.17%,1
彰化縣,和美鎮,0427,481,276,757,44,801,1461,54.83%,32.92%,1
彰化縣,和美鎮,0428,450,315,765,39,804,1405,57.22%,32.03%,1
彰化縣,和美鎮,0429,284,186,470,50,520,860,60.47%,33.02%,1
彰化縣,和美鎮,0430,283,174,457,22,479,875,54.74%,32.34%,1
彰化縣,和美鎮,0431,269,185,454,49,503,871,57.75%,30.88%,1
彰化縣,和美鎮,0432,281,209,490,62,552,883,62.51%,31.82%,1
彰化縣,和美鎮,0433,363,254,617,60,677,1224,55.31%,29.66%,1
彰化縣,和美鎮,0434,317,224,541,56,597,1075,55.53%,29.49%,1
彰化縣,和美鎮,0435,287,210,497,47,544,956,56.9%,30.02%,1
彰化縣,和美鎮,0436,309,218,527,54,581,1037,56.03%,29.8%,1
彰化縣,和美鎮,0437,317,211,528,32,560,1011,55.39%,31.36%,1
彰化縣,和美鎮,0438,284,221,505,68,573,1023,56.01%,27.76%,1
彰化縣,和美鎮,0439,222,131,353,39,392,719,54.52%,30.88%,1
彰化縣,和美鎮,0440,248,201,449,66,515,913,56.41%,27.16%,1
彰化縣,線西鄉,0469,363,207,570,39,609,1071,56.86%,33.89%,1
彰化縣,線西鄉,0470,406,243,649,45,694,1166,59.52%,34.82%,1
彰化縣,線西鄉,0471,426,252,678,76,754,1269,59.42%,33.57%,1
彰化縣,線西鄉,0472,366,230,596,58,654,1138,57.47%,32.16%,1
彰化縣,線西鄉,0473,368,270,638,81,719,1128,63.74%,32.62%,1
彰化縣,線西鄉,0474,410,266,676,96,772,1275,60.55%,32.16%,1
彰化縣,線西鄉,0475,410,245,655,53,708,1187,59.65%,34.54%,1
彰化縣,線西鄉,0476,317,232,549,58,607,991,61.25%,31.99%,1
彰化縣,線西鄉,0477,286,204,490,73,563,938,60.02%,30.49%,1
彰化縣,線西鄉,0478,370,232,602,78,680,1276,53.29%,29%,1
彰化縣,線西鄉,0479,401,293,694,63,757,1285,58.91%,31.21%,1
彰化縣,線西鄉,0480,524,275,799,79,878,1341,65.47%,39.08%,1
彰化縣,伸港鄉,0441,421,109,530,65,595,1182,50.34%,35.62%,1
彰化縣,伸港鄉,0442,480,182,662,57,719,1166,61.66%,41.17%,1
彰化縣,伸港鄉,0443,300,205,505,58,563,966,58.28%,31.06%,1
彰化縣,伸港鄉,0444,261,179,440,48,488,873,55.9%,29.9%,1
彰化縣,伸港鄉,0445,261,167,428,62,490,812,60.34%,32.14%,1
彰化縣,伸港鄉,0446,258,185,443,49,492,875,56.23%,29.49%,1
彰化縣,伸港鄉,0447,281,168,449,57,506,904,55.97%,31.08%,1
彰化縣,伸港鄉,0448,304,205,509,51,560,1008,55.56%,30.16%,1
彰化縣,伸港鄉,0449,393,236,629,56,685,1154,59.36%,34.06%,1
彰化縣,伸港鄉,0450,393,298,691,93,784,1486,52.76%,26.45%,1
彰化縣,伸港鄉,0451,353,202,555,55,610,1095,55.71%,32.24%,1
彰化縣,伸港鄉,0452,295,227,522,33,555,1087,51.06%,27.14%,1
彰化縣,伸港鄉,0453,338,233,571,75,646,1085,59.54%,31.15%,1
彰化縣,伸港鄉,0454,320,176,496,47,543,908,59.8%,35.24%,1
彰化縣,伸港鄉,0455,461,262,723,49,772,1264,61.08%,36.47%,1
彰化縣,伸港鄉,0456,243,162,405,66,471,854,55.15%,28.45%,1
彰化縣,伸港鄉,0457,201,176,377,50,427,846,50.47%,23.76%,1
彰化縣,伸港鄉,0458,285,213,498,112,610,1143,53.37%,24.93%,1
彰化縣,伸港鄉,0459,432,274,706,54,760,1357,56.01%,31.83%,1
彰化縣,伸港鄉,0460,389,284,673,77,750,1349,55.6%,28.84%,1
彰化縣,伸港鄉,0461,360,251,611,68,679,1154,58.84%,31.2%,1
彰化縣,伸港鄉,0462,347,276,623,53,676,1279,52.85%,27.13%,1
彰化縣,伸港鄉,0463,419,291,710,66,776,1317,58.92%,31.81%,1
彰化縣,伸港鄉,0464,326,227,553,55,608,990,61.41%,32.93%,1
彰化縣,伸港鄉,0465,298,177,475,29,504,852,59.15%,34.98%,1
彰化縣,伸港鄉,0466,378,254,632,45,677,1178,57.47%,32.09%,1
彰化縣,伸港鄉,0467,291,248,539,97,636,1088,58.46%,26.75%,1
彰化縣,伸港鄉,0468,361,229,590,59,649,1135,57.18%,31.81%,1
彰化縣,福興鄉,0308,358,289,647,89,736,1363,54%,26.27%,1
彰化縣,福興鄉,0309,250,190,440,29,469,821,57.13%,30.45%,1
彰化縣,福興鄉,0310,363,221,584,73,657,1256,52.31%,28.9%,1
彰化縣,福興鄉,0311,308,227,535,105,640,1166,54.89%,26.42%,1
彰化縣,福興鄉,0312,414,284,698,69,767,1464,52.39%,28.28%,1
彰化縣,福興鄉,0313,356,247,603,59,662,1251,52.92%,28.46%,1
彰化縣,福興鄉,0314,423,290,713,62,775,1465,52.9%,28.87%,1
彰化縣,福興鄉,0315,247,170,417,55,472,960,49.17%,25.73%,1
彰化縣,福興鄉,0316,386,245,631,82,713,1323,53.89%,29.18%,1
彰化縣,福興鄉,0317,389,297,686,70,756,1365,55.38%,28.5%,1
彰化縣,福興鄉,0318,336,262,598,56,654,1458,44.86%,23.05%,1
彰化縣,福興鄉,0319,419,272,691,95,786,1492,52.68%,28.08%,1
彰化縣,福興鄉,0320,257,141,398,30,428,888,48.2%,28.94%,1
彰化縣,福興鄉,0321,335,228,563,66,629,1054,59.68%,31.78%,1
彰化縣,福興鄉,0322,263,207,470,51,521,1043,49.95%,25.22%,1
彰化縣,福興鄉,0323,378,280,658,81,739,1340,55.15%,28.21%,1
彰化縣,福興鄉,0324,296,201,497,57,554,1085,51.06%,27.28%,1
彰化縣,福興鄉,0325,359,293,652,53,705,1392,50.65%,25.79%,1
彰化縣,福興鄉,0326,398,280,678,95,773,1316,58.74%,30.24%,1
彰化縣,福興鄉,0327,486,201,687,70,757,1255,60.32%,38.73%,1
彰化縣,福興鄉,0328,388,231,619,56,675,1101,61.31%,35.24%,1
彰化縣,福興鄉,0329,365,199,564,90,654,1167,56.04%,31.28%,1
彰化縣,福興鄉,0330,366,259,625,105,730,1393,52.4%,26.27%,1
彰化縣,福興鄉,0331,364,247,611,83,694,1216,57.07%,29.93%,1
彰化縣,福興鄉,0332,294,190,484,50,534,1063,50.24%,27.66%,1
彰化縣,福興鄉,0333,357,260,617,86,703,1306,53.83%,27.34%,1
彰化縣,福興鄉,0334,324,207,531,69,600,1287,46.62%,25.17%,1
彰化縣,福興鄉,0335,305,192,497,62,559,994,56.24%,30.68%,1
彰化縣,福興鄉,0336,384,249,633,107,740,1311,56.45%,29.29%,1
彰化縣,福興鄉,0337,330,184,514,39,553,926,59.72%,35.64%,1
彰化縣,福興鄉,0338,270,189,459,54,513,995,51.56%,27.14%,1
彰化縣,福興鄉,0339,345,213,558,113,671,1079,62.19%,31.97%,1
彰化縣,福興鄉,0340,288,214,502,103,605,1150,52.61%,25.04%,1
彰化縣,秀水鄉,0341,328,213,541,128,669,1066,62.76%,30.77%,1
彰化縣,秀水鄉,0342,200,145,345,52,397,620,64.03%,32.26%,1
彰化縣,秀水鄉,0343,210,209,419,22,441,876,50.34%,23.97%,1
彰化縣,秀水鄉,0344,395,292,687,51,738,1196,61.71%,33.03%,1
彰化縣,秀水鄉,0345,412,323,735,54,789,1369,57.63%,30.09%,1
彰化縣,秀水鄉,0346,411,273,684,72,756,1273,59.39%,32.29%,1
彰化縣,秀水鄉,0347,424,301,725,82,807,1433,56.32%,29.59%,1
彰化縣,秀水鄉,0348,307,230,537,35,572,967,59.15%,31.75%,1
彰化縣,秀水鄉,0349,311,212,523,24,547,921,59.39%,33.77%,1
彰化縣,秀水鄉,0350,241,148,389,44,433,689,62.84%,34.98%,1
彰化縣,秀水鄉,0351,229,144,373,48,421,688,61.19%,33.28%,1
彰化縣,秀水鄉,0352,419,291,710,72,782,1252,62.46%,33.47%,1
彰化縣,秀水鄉,0353,382,256,638,55,693,1281,54.1%,29.82%,1
彰化縣,秀水鄉,0354,223,162,385,31,416,754,55.17%,29.58%,1
彰化縣,秀水鄉,0355,315,221,536,51,587,1024,57.32%,30.76%,1
彰化縣,秀水鄉,0356,435,294,729,46,775,1433,54.08%,30.36%,1
彰化縣,秀水鄉,0357,467,331,798,75,873,1366,63.91%,34.19%,1
彰化縣,秀水鄉,0358,274,215,489,57,546,895,61.01%,30.61%,1
彰化縣,秀水鄉,0359,390,281,671,82,753,1386,54.33%,28.14%,1
彰化縣,秀水鄉,0360,271,191,462,82,544,896,60.71%,30.25%,1
彰化縣,秀水鄉,0361,285,188,473,55,528,804,65.67%,35.45%,1
彰化縣,秀水鄉,0362,285,188,473,45,518,827,62.64%,34.46%,1
彰化縣,秀水鄉,0363,330,206,536,57,593,996,59.54%,33.13%,1
彰化縣,秀水鄉,0364,326,229,555,62,617,931,66.27%,35.02%,1
彰化縣,秀水鄉,0365,209,156,365,41,406,715,56.78%,29.23%,1
彰化縣,秀水鄉,0366,423,279,702,69,771,1229,62.73%,34.42%,1
彰化縣,秀水鄉,0367,223,206,429,35,464,890,52.13%,25.06%,1
彰化縣,秀水鄉,0368,265,196,461,50,511,811,63.01%,32.68%,1
彰化縣,秀水鄉,0369,249,183,432,55,487,786,61.96%,31.68%,1
彰化縣,秀水鄉,0370,288,197,485,57,542,931,58.22%,30.93%,1
彰化縣,秀水鄉,0371,418,264,682,86,768,1265,60.71%,33.04%,1
彰化縣,秀水鄉,0372,241,173,414,48,462,824,56.07%,29.25%,1
彰化縣,花壇鄉,0185,268,204,472,68,540,901,59.93%,29.74%,1
彰化縣,花壇鄉,0186,352,230,582,50,632,1042,60.65%,33.78%,1
彰化縣,花壇鄉,0187,360,300,660,29,689,1314,52.44%,27.4%,1
彰化縣,花壇鄉,0188,229,206,435,55,490,808,60.64%,28.34%,1
彰化縣,花壇鄉,0189,312,222,534,53,587,1019,57.61%,30.62%,1
彰化縣,花壇鄉,0190,344,256,600,103,703,1144,61.45%,30.07%,1
彰化縣,花壇鄉,0191,351,234,585,139,724,1240,58.39%,28.31%,1
彰化縣,花壇鄉,0192,448,335,783,93,876,1425,61.47%,31.44%,1
彰化縣,花壇鄉,0193,360,255,615,78,693,1095,63.29%,32.88%,1
彰化縣,花壇鄉,0194,290,200,490,56,546,910,60%,31.87%,1
彰化縣,花壇鄉,0195,295,225,520,54,574,982,58.45%,30.04%,1
彰化縣,花壇鄉,0196,311,234,545,19,564,1070,52.71%,29.07%,1
彰化縣,花壇鄉,0197,209,142,351,24,375,700,53.57%,29.86%,1
彰化縣,花壇鄉,0198,243,202,445,58,503,764,65.84%,31.81%,1
彰化縣,花壇鄉,0199,331,212,543,60,603,953,63.27%,34.73%,1
彰化縣,花壇鄉,0200,290,226,516,40,556,974,57.08%,29.77%,1
彰化縣,花壇鄉,0201,337,243,580,68,648,1111,58.33%,30.33%,1
彰化縣,花壇鄉,0202,374,209,583,89,672,1101,61.04%,33.97%,1
彰化縣,花壇鄉,0203,345,206,551,62,613,1110,55.23%,31.08%,1
彰化縣,花壇鄉,0204,385,281,666,67,733,1262,58.08%,30.51%,1
彰化縣,花壇鄉,0205,334,274,608,41,649,1103,58.84%,30.28%,1
彰化縣,花壇鄉,0206,348,275,623,71,694,1347,51.52%,25.84%,1
彰化縣,花壇鄉,0207,333,246,579,60,639,1169,54.66%,28.49%,1
彰化縣,花壇鄉,0208,466,236,702,62,764,1274,59.97%,36.58%,1
彰化縣,花壇鄉,0209,474,273,747,54,801,1280,62.58%,37.03%,1
彰化縣,花壇鄉,0210,394,276,670,52,722,1244,58.04%,31.67%,1
彰化縣,花壇鄉,0211,335,279,614,68,682,1159,58.84%,28.9%,1
彰化縣,花壇鄉,0212,362,243,605,46,651,1042,62.48%,34.74%,1
彰化縣,花壇鄉,0213,301,241,542,66,608,1111,54.73%,27.09%,1
彰化縣,花壇鄉,0214,306,204,510,58,568,893,63.61%,34.27%,1
彰化縣,花壇鄉,0215,284,214,498,65,563,953,59.08%,29.8%,1
彰化縣,花壇鄉,0216,283,183,466,41,507,987,51.37%,28.67%,1
彰化縣,花壇鄉,0217,314,228,542,58,600,925,64.86%,33.95%,1
彰化縣,花壇鄉,0218,293,184,477,52,529,951,55.63%,30.81%,1
彰化縣,花壇鄉,0219,319,188,507,38,545,955,57.07%,33.4%,1
彰化縣,花壇鄉,0220,280,186,466,21,487,895,54.41%,31.28%,1
彰化縣,花壇鄉,0221,226,151,377,34,411,711,57.81%,31.79%,1
彰化縣,芬園鄉,0222,308,175,483,56,539,958,56.26%,32.15%,1
彰化縣,芬園鄉,0223,245,155,400,56,456,794,57.43%,30.86%,1
彰化縣,芬園鄉,0224,389,273,662,88,750,1415,53%,27.49%,1
彰化縣,芬園鄉,0225,306,224,530,38,568,927,61.27%,33.01%,1
彰化縣,芬園鄉,0226,266,156,422,52,474,831,57.04%,32.01%,1
彰化縣,芬園鄉,0227,188,113,301,23,324,570,56.84%,32.98%,1
彰化縣,芬園鄉,0228,351,225,576,63,639,1227,52.08%,28.61%,1
彰化縣,芬園鄉,0229,381,221,602,81,683,1238,55.17%,30.78%,1
彰化縣,芬園鄉,0230,414,290,704,82,786,1362,57.71%,30.4%,1
彰化縣,芬園鄉,0231,292,208,500,84,584,989,59.05%,29.52%,1
彰化縣,芬園鄉,0232,364,245,609,57,666,1054,63.19%,34.54%,1
彰化縣,芬園鄉,0233,232,133,365,33,398,607,65.57%,38.22%,1
彰化縣,芬園鄉,0234,308,179,487,49,536,882,60.77%,34.92%,1
彰化縣,芬園鄉,0235,329,180,509,53,562,1143,49.17%,28.78%,1
彰化縣,芬園鄉,0236,178,95,273,27,300,661,45.39%,26.93%,1
彰化縣,芬園鄉,0237,241,158,399,6,405,838,48.33%,28.76%,1
彰化縣,芬園鄉,0238,241,176,417,30,447,847,52.77%,28.45%,1
彰化縣,芬園鄉,0239,304,223,527,65,592,987,59.98%,30.8%,1
彰化縣,芬園鄉,0240,336,226,562,74,636,1217,52.26%,27.61%,1
彰化縣,芬園鄉,0241,219,167,386,78,464,865,53.64%,25.32%,1
彰化縣,芬園鄉,0242,261,202,463,52,515,996,51.71%,26.2%,1
彰化縣,員林市,0481,337,193,530,36,566,1087,52.07%,31%,1
彰化縣,員林市,0482,391,265,656,43,699,1353,51.66%,28.9%,1
彰化縣,員林市,0483,381,254,635,63,698,1313,53.16%,29.02%,1
彰化縣,員林市,0484,359,221,580,26,606,1328,45.63%,27.03%,1
彰化縣,員林市,0485,251,307,558,39,597,1055,56.59%,23.79%,1
彰化縣,員林市,0486,287,181,468,55,523,959,54.54%,29.93%,1
彰化縣,員林市,0487,232,169,401,50,451,772,58.42%,30.05%,1
彰化縣,員林市,0488,283,177,460,51,511,831,61.49%,34.06%,1
彰化縣,員林市,0489,197,169,366,27,393,854,46.02%,23.07%,1
彰化縣,員林市,0490,266,211,477,55,532,1190,44.71%,22.35%,1
彰化縣,員林市,0491,219,143,362,35,397,726,54.68%,30.17%,1
彰化縣,員林市,0492,328,231,559,71,630,1124,56.05%,29.18%,1
彰化縣,員林市,0493,219,169,388,65,453,860,52.67%,25.47%,1
彰化縣,員林市,0494,389,224,613,70,683,1122,60.87%,34.67%,1
彰化縣,員林市,0495,371,213,584,57,641,1075,59.63%,34.51%,1
彰化縣,員林市,0496,257,217,474,76,550,993,55.39%,25.88%,1
彰化縣,員林市,0497,269,217,486,41,527,967,54.5%,27.82%,1
彰化縣,員林市,0498,283,228,511,67,578,1008,57.34%,28.08%,1
彰化縣,員林市,0499,223,171,394,61,455,804,56.59%,27.74%,1
彰化縣,員林市,0500,249,192,441,41,482,867,55.59%,28.72%,1
彰化縣,員林市,0501,250,165,415,47,462,885,52.2%,28.25%,1
彰化縣,員林市,0502,274,173,447,21,468,1097,42.66%,24.98%,1
彰化縣,員林市,0503,399,238,637,36,673,1255,53.63%,31.79%,1
彰化縣,員林市,0504,320,245,565,50,615,1063,57.86%,30.1%,1
彰化縣,員林市,0505,400,101,501,18,519,925,56.11%,43.24%,1
彰化縣,員林市,0506,270,233,503,56,559,947,59.03%,28.51%,1
彰化縣,員林市,0507,319,199,518,32,550,916,60.04%,34.83%,1
彰化縣,員林市,0508,267,170,437,43,480,862,55.68%,30.97%,1
彰化縣,員林市,0509,320,207,527,29,556,987,56.33%,32.42%,1
彰化縣,員林市,0510,338,206,544,50,594,1085,54.75%,31.15%,1
彰化縣,員林市,0511,360,242,602,37,639,1110,57.57%,32.43%,1
彰化縣,員林市,0512,321,213,534,33,567,1095,51.78%,29.32%,1
彰化縣,員林市,0513,447,288,735,47,782,1278,61.19%,34.98%,1
彰化縣,員林市,0514,387,227,614,39,653,1109,58.88%,34.9%,1
彰化縣,員林市,0515,312,229,541,70,611,1055,57.91%,29.57%,1
彰化縣,員林市,0516,260,210,470,39,509,876,58.11%,29.68%,1
彰化縣,員林市,0517,298,220,518,50,568,1115,50.94%,26.73%,1
彰化縣,員林市,0518,402,229,631,58,689,1186,58.09%,33.9%,1
彰化縣,員林市,0519,365,184,549,51,600,995,60.3%,36.68%,1
彰化縣,員林市,0520,309,191,500,24,524,999,52.45%,30.93%,1
彰化縣,員林市,0521,366,246,612,44,656,1201,54.62%,30.47%,1
彰化縣,員林市,0522,397,297,694,42,736,1342,54.84%,29.58%,1
彰化縣,員林市,0523,307,234,541,42,583,1086,53.68%,28.27%,1
彰化縣,員林市,0524,264,146,410,46,456,854,53.4%,30.91%,1
彰化縣,員林市,0525,334,214,548,42,590,1064,55.45%,31.39%,1
彰化縣,員林市,0526,296,206,502,15,517,879,58.82%,33.67%,1
彰化縣,員林市,0527,322,198,520,41,561,827,67.84%,38.94%,1
彰化縣,員林市,0528,266,168,434,28,462,867,53.29%,30.68%,1
彰化縣,員林市,0529,371,271,642,37,679,1201,56.54%,30.89%,1
彰化縣,員林市,0530,372,228,600,43,643,1106,58.14%,33.63%,1
彰化縣,員林市,0531,250,202,452,52,504,845,59.64%,29.59%,1
彰化縣,員林市,0532,296,187,483,42,525,894,58.72%,33.11%,1
彰化縣,員林市,0533,299,158,457,45,502,849,59.13%,35.22%,1
彰化縣,員林市,0534,246,173,419,50,469,747,62.78%,32.93%,1
彰化縣,員林市,0535,331,181,512,37,549,884,62.1%,37.44%,1
彰化縣,員林市,0536,262,182,444,36,480,900,53.33%,29.11%,1
彰化縣,員林市,0537,321,188,509,35,544,1040,52.31%,30.87%,1
彰化縣,員林市,0538,264,162,426,30,456,831,54.87%,31.77%,1
彰化縣,員林市,0539,224,126,350,39,389,591,65.82%,37.9%,1
彰化縣,員林市,0540,407,277,684,38,722,1330,54.29%,30.6%,1
彰化縣,員林市,0541,434,253,687,41,728,1295,56.22%,33.51%,1
彰化縣,員林市,0542,369,257,626,90,716,1283,55.81%,28.76%,1
彰化縣,員林市,0543,326,203,529,41,570,943,60.45%,34.57%,1
彰化縣,員林市,0544,446,353,799,73,872,1388,62.82%,32.13%,1
彰化縣,員林市,0545,385,247,632,48,680,1176,57.82%,32.74%,1
彰化縣,員林市,0546,245,154,399,21,420,867,48.44%,28.26%,1
彰化縣,員林市,0547,321,223,544,70,614,1121,54.77%,28.64%,1
彰化縣,員林市,0548,390,200,590,45,635,1190,53.36%,32.77%,1
彰化縣,員林市,0549,314,202,516,49,565,945,59.79%,33.23%,1
彰化縣,員林市,0550,310,196,506,42,548,906,60.49%,34.22%,1
彰化縣,員林市,0551,292,256,548,49,597,978,61.04%,29.86%,1
彰化縣,員林市,0552,308,192,500,60,560,949,59.01%,32.46%,1
彰化縣,員林市,0553,318,223,541,33,574,949,60.48%,33.51%,1
彰化縣,員林市,0554,331,178,509,51,560,1006,55.67%,32.9%,1
彰化縣,員林市,0555,364,113,477,51,528,889,59.39%,40.94%,1
彰化縣,員林市,0556,325,213,538,24,562,923,60.89%,35.21%,1
彰化縣,員林市,0557,403,282,685,63,748,1209,61.87%,33.33%,1
彰化縣,員林市,0558,341,263,604,47,651,1075,60.56%,31.72%,1
彰化縣,員林市,0559,492,292,784,39,823,1342,61.33%,36.66%,1
彰化縣,員林市,0560,367,277,644,44,688,1039,66.22%,35.32%,1
彰化縣,員林市,0561,324,193,517,114,631,1131,55.79%,28.65%,1
彰化縣,員林市,0562,416,257,673,31,704,1356,51.92%,30.68%,1
彰化縣,員林市,0563,441,269,710,59,769,1370,56.13%,32.19%,1
彰化縣,員林市,0564,344,240,584,53,637,1090,58.44%,31.56%,1
彰化縣,員林市,0565,307,197,504,31,535,821,65.16%,37.39%,1
彰化縣,員林市,0566,290,217,507,34,541,910,59.45%,31.87%,1
彰化縣,員林市,0567,386,243,629,54,683,1203,56.77%,32.09%,1
彰化縣,員林市,0568,446,294,740,40,780,1378,56.6%,32.37%,1
彰化縣,員林市,0569,443,285,728,35,763,1352,56.43%,32.77%,1
彰化縣,員林市,0570,384,236,620,33,653,1060,61.6%,36.23%,1
彰化縣,員林市,0571,374,285,659,67,726,1317,55.13%,28.4%,1
彰化縣,員林市,0572,339,214,553,56,609,1120,54.38%,30.27%,1
彰化縣,員林市,0573,310,185,495,60,555,1025,54.15%,30.24%,1
彰化縣,員林市,0574,347,228,575,55,630,1097,57.43%,31.63%,1
彰化縣,員林市,0575,264,209,473,51,524,859,61%,30.73%,1
彰化縣,員林市,0576,256,167,423,42,465,837,55.56%,30.59%,1
彰化縣,員林市,0577,356,267,623,60,683,1090,62.66%,32.66%,1
彰化縣,員林市,0578,309,223,532,80,612,1073,57.04%,28.8%,1
彰化縣,溪湖鎮,0640,365,244,609,67,676,1221,55.36%,29.89%,1
彰化縣,溪湖鎮,0641,225,141,366,43,409,638,64.11%,35.27%,1
彰化縣,溪湖鎮,0642,250,177,427,58,485,817,59.36%,30.6%,1
彰化縣,溪湖鎮,0643,364,185,549,47,596,968,61.57%,37.6%,1
彰化縣,溪湖鎮,0644,171,100,271,24,295,448,65.85%,38.17%,1
彰化縣,溪湖鎮,0645,294,237,531,54,585,1123,52.09%,26.18%,1
彰化縣,溪湖鎮,0646,351,251,602,56,658,1166,56.43%,30.1%,1
彰化縣,溪湖鎮,0647,345,252,597,44,641,1151,55.69%,29.97%,1
彰化縣,溪湖鎮,0648,431,246,677,46,723,1249,57.89%,34.51%,1
彰化縣,溪湖鎮,0649,370,252,622,56,678,1146,59.16%,32.29%,1
彰化縣,溪湖鎮,0650,424,236,660,53,713,1199,59.47%,35.36%,1
彰化縣,溪湖鎮,0651,287,175,462,59,521,895,58.21%,32.07%,1
彰化縣,溪湖鎮,0652,309,219,528,32,560,964,58.09%,32.05%,1
彰化縣,溪湖鎮,0653,253,209,462,35,497,851,58.4%,29.73%,1
彰化縣,溪湖鎮,0654,338,220,558,51,609,1072,56.81%,31.53%,1
彰化縣,溪湖鎮,0655,376,234,610,58,668,1113,60.02%,33.78%,1
彰化縣,溪湖鎮,0656,392,213,605,48,653,1090,59.91%,35.96%,1
彰化縣,溪湖鎮,0657,416,258,674,49,723,1193,60.6%,34.87%,1
彰化縣,溪湖鎮,0658,348,182,530,61,591,952,62.08%,36.55%,1
彰化縣,溪湖鎮,0659,362,244,606,64,670,1172,57.17%,30.89%,1
彰化縣,溪湖鎮,0660,442,106,548,44,592,1027,57.64%,43.04%,1
彰化縣,溪湖鎮,0661,430,266,696,50,746,1188,62.79%,36.2%,1
彰化縣,溪湖鎮,0662,397,279,676,67,743,1403,52.96%,28.3%,1
彰化縣,溪湖鎮,0663,375,249,624,90,714,1397,51.11%,26.84%,1
彰化縣,溪湖鎮,0664,510,332,842,72,914,1636,55.87%,31.17%,1
彰化縣,溪湖鎮,0665,429,251,680,94,774,1298,59.63%,33.05%,1
彰化縣,溪湖鎮,0666,395,240,635,64,699,1214,57.58%,32.54%,1
彰化縣,溪湖鎮,0667,411,298,709,67,776,1297,59.83%,31.69%,1
彰化縣,溪湖鎮,0668,347,200,547,58,605,968,62.5%,35.85%,1
彰化縣,溪湖鎮,0669,258,193,451,57,508,839,60.55%,30.75%,1
彰化縣,溪湖鎮,0670,277,204,481,70,551,907,60.75%,30.54%,1
彰化縣,溪湖鎮,0671,258,151,409,40,449,898,50%,28.73%,1
彰化縣,溪湖鎮,0672,242,155,397,52,449,650,69.08%,37.23%,1
彰化縣,溪湖鎮,0673,384,254,638,100,738,1279,57.7%,30.02%,1
彰化縣,溪湖鎮,0674,240,165,405,62,467,730,63.97%,32.88%,1
彰化縣,溪湖鎮,0675,471,272,743,75,818,1407,58.14%,33.48%,1
彰化縣,溪湖鎮,0676,338,237,575,63,638,1273,50.12%,26.55%,1
彰化縣,溪湖鎮,0677,300,199,499,38,537,988,54.35%,30.36%,1
彰化縣,溪湖鎮,0678,242,182,424,57,481,754,63.79%,32.1%,1
彰化縣,溪湖鎮,0679,279,181,460,65,525,1052,49.9%,26.52%,1
彰化縣,溪湖鎮,0680,337,232,569,48,617,1149,53.7%,29.33%,1
彰化縣,溪湖鎮,0681,291,449,740,124,864,1365,63.3%,21.32%,1
彰化縣,田中鎮,0742,241,151,392,84,476,854,55.74%,28.22%,1
彰化縣,田中鎮,0743,269,166,435,55,490,963,50.88%,27.93%,1
彰化縣,田中鎮,0744,21,17,38,7,45,175,25.71%,12%,1
彰化縣,田中鎮,0745,198,159,357,37,394,739,53.32%,26.79%,1
彰化縣,田中鎮,0746,246,155,401,42,443,826,53.63%,29.78%,1
彰化縣,田中鎮,0747,177,217,394,55,449,741,60.59%,23.89%,1
彰化縣,田中鎮,0748,128,77,205,13,218,506,43.08%,25.3%,1
彰化縣,田中鎮,0749,273,186,459,62,521,1001,52.05%,27.27%,1
彰化縣,田中鎮,0750,392,250,642,94,736,1281,57.46%,30.6%,1
彰化縣,田中鎮,0751,316,223,539,68,607,1035,58.65%,30.53%,1
彰化縣,田中鎮,0752,402,304,706,72,778,1327,58.63%,30.29%,1
彰化縣,田中鎮,0753,269,200,469,51,520,844,61.61%,31.87%,1
彰化縣,田中鎮,0754,285,190,475,43,518,913,56.74%,31.22%,1
彰化縣,田中鎮,0755,226,139,365,40,405,613,66.07%,36.87%,1
彰化縣,田中鎮,0756,430,289,719,98,817,1382,59.12%,31.11%,1
彰化縣,田中鎮,0757,373,245,618,53,671,1034,64.89%,36.07%,1
彰化縣,田中鎮,0758,341,232,573,44,617,935,65.99%,36.47%,1
彰化縣,田中鎮,0759,404,280,684,67,751,1301,57.72%,31.05%,1
彰化縣,田中鎮,0760,376,242,618,49,667,1100,60.64%,34.18%,1
彰化縣,田中鎮,0761,336,243,579,68,647,1071,60.41%,31.37%,1
彰化縣,田中鎮,0762,401,242,643,78,721,1163,61.99%,34.48%,1
彰化縣,田中鎮,0763,272,208,480,53,533,809,65.88%,33.62%,1
彰化縣,田中鎮,0764,362,274,636,66,702,1155,60.78%,31.34%,1
彰化縣,田中鎮,0765,384,258,642,90,732,1270,57.64%,30.24%,1
彰化縣,田中鎮,0766,248,199,447,41,488,870,56.09%,28.51%,1
彰化縣,田中鎮,0767,196,147,343,79,422,736,57.34%,26.63%,1
彰化縣,田中鎮,0768,351,286,637,57,694,1335,51.99%,26.29%,1
彰化縣,田中鎮,0769,243,206,449,47,496,876,56.62%,27.74%,1
彰化縣,田中鎮,0770,245,197,442,51,493,898,54.9%,27.28%,1
彰化縣,田中鎮,0771,417,286,703,41,744,1298,57.32%,32.13%,1
彰化縣,田中鎮,0772,409,302,711,98,809,1451,55.75%,28.19%,1
彰化縣,田中鎮,0773,463,293,756,81,837,1475,56.75%,31.39%,1
彰化縣,田中鎮,0774,198,145,343,61,404,766,52.74%,25.85%,1
彰化縣,田中鎮,0775,242,160,402,37,439,810,54.2%,29.88%,1
彰化縣,田中鎮,0776,279,215,494,76,570,953,59.81%,29.28%,1
彰化縣,田中鎮,0777,288,197,485,70,555,885,62.71%,32.54%,1
彰化縣,大村鄉,0579,484,341,825,78,903,1426,63.32%,33.94%,1
彰化縣,大村鄉,0580,595,393,988,85,1073,1726,62.17%,34.47%,1
彰化縣,大村鄉,0581,224,214,438,67,505,797,63.36%,28.11%,1
彰化縣,大村鄉,0582,242,155,397,34,431,745,57.85%,32.48%,1
彰化縣,大村鄉,0583,394,228,622,67,689,1125,61.24%,35.02%,1
彰化縣,大村鄉,0584,440,313,753,114,867,1486,58.34%,29.61%,1
彰化縣,大村鄉,0585,455,285,740,93,833,1426,58.42%,31.91%,1
彰化縣,大村鄉,0586,291,185,476,48,524,824,63.59%,35.32%,1
彰化縣,大村鄉,0587,324,225,549,54,603,1177,51.23%,27.53%,1
彰化縣,大村鄉,0588,487,306,793,88,881,1478,59.61%,32.95%,1
彰化縣,大村鄉,0589,216,168,384,27,411,779,52.76%,27.73%,1
彰化縣,大村鄉,0590,285,165,450,56,506,812,62.32%,35.1%,1
彰化縣,大村鄉,0591,372,222,594,50,644,1161,55.47%,32.04%,1
彰化縣,大村鄉,0592,377,247,624,56,680,1238,54.93%,30.45%,1
彰化縣,大村鄉,0593,391,263,654,73,727,1259,57.74%,31.06%,1
彰化縣,大村鄉,0594,458,304,762,57,819,1412,58%,32.44%,1
彰化縣,大村鄉,0595,460,298,758,35,793,1401,56.6%,32.83%,1
彰化縣,大村鄉,0596,467,287,754,89,843,1395,60.43%,33.48%,1
彰化縣,大村鄉,0597,324,208,532,69,601,996,60.34%,32.53%,1
彰化縣,大村鄉,0598,333,232,565,47,612,1047,58.45%,31.81%,1
彰化縣,大村鄉,0599,329,200,529,54,583,985,59.19%,33.4%,1
彰化縣,大村鄉,0600,358,244,602,56,658,1054,62.43%,33.97%,1
彰化縣,大村鄉,0601,402,252,654,61,715,1200,59.58%,33.5%,1
彰化縣,大村鄉,0602,319,221,540,78,618,1003,61.62%,31.8%,1
彰化縣,大村鄉,0603,289,227,516,58,574,1046,54.88%,27.63%,1
彰化縣,大村鄉,0604,381,263,644,61,705,1189,59.29%,32.04%,1
彰化縣,大村鄉,0605,383,254,637,64,701,1305,53.72%,29.35%,1
彰化縣,埔鹽鄉,0682,435,115,550,44,594,958,62%,45.41%,1
彰化縣,埔鹽鄉,0683,237,205,442,53,495,754,65.65%,31.43%,1
彰化縣,埔鹽鄉,0684,267,197,464,37,501,757,66.18%,35.27%,1
彰化縣,埔鹽鄉,0685,264,198,462,43,505,806,62.66%,32.75%,1
彰化縣,埔鹽鄉,0686,449,254,703,39,742,1280,57.97%,35.08%,1
彰化縣,埔鹽鄉,0687,313,191,504,45,549,928,59.16%,33.73%,1
彰化縣,埔鹽鄉,0688,302,225,527,74,601,895,67.15%,33.74%,1
彰化縣,埔鹽鄉,0689,270,201,471,55,526,815,64.54%,33.13%,1
彰化縣,埔鹽鄉,0690,308,193,501,59,560,957,58.52%,32.18%,1
彰化縣,埔鹽鄉,0691,425,235,660,126,786,1338,58.74%,31.76%,1
彰化縣,埔鹽鄉,0692,322,237,559,74,633,1106,57.23%,29.11%,1
彰化縣,埔鹽鄉,0693,259,162,421,54,475,690,68.84%,37.54%,1
彰化縣,埔鹽鄉,0694,402,266,668,38,706,1230,57.4%,32.68%,1
彰化縣,埔鹽鄉,0695,253,189,442,42,484,847,57.14%,29.87%,1
彰化縣,埔鹽鄉,0696,307,218,525,37,562,897,62.65%,34.23%,1
彰化縣,埔鹽鄉,0697,259,212,471,58,529,882,59.98%,29.37%,1
彰化縣,埔鹽鄉,0698,434,223,657,60,717,1180,60.76%,36.78%,1
彰化縣,埔鹽鄉,0699,366,237,603,103,706,1215,58.11%,30.12%,1
彰化縣,埔鹽鄉,0700,170,80,250,31,281,422,66.59%,40.28%,1
彰化縣,埔鹽鄉,0701,355,206,561,62,623,1106,56.33%,32.1%,1
彰化縣,埔鹽鄉,0702,284,213,497,68,565,874,64.65%,32.49%,1
彰化縣,埔鹽鄉,0703,451,287,738,120,858,1445,59.38%,31.21%,1
彰化縣,埔鹽鄉,0704,296,172,468,77,545,875,62.29%,33.83%,1
彰化縣,埔鹽鄉,0705,256,144,400,47,447,837,53.41%,30.59%,1
彰化縣,埔鹽鄉,0706,220,131,351,61,412,685,60.15%,32.12%,1
彰化縣,埔鹽鄉,0707,244,160,404,60,464,733,63.3%,33.29%,1
彰化縣,埔鹽鄉,0708,252,154,406,90,496,798,62.16%,31.58%,1
彰化縣,埔鹽鄉,0709,457,256,713,80,793,1381,57.42%,33.09%,1
彰化縣,埔鹽鄉,0710,388,261,649,55,704,1335,52.73%,29.06%,1
彰化縣,埔心鄉,0711,381,235,616,93,709,1139,62.25%,33.45%,1
彰化縣,埔心鄉,0712,370,280,650,65,715,1217,58.75%,30.4%,1
彰化縣,埔心鄉,0713,428,301,729,45,774,1248,62.02%,34.29%,1
彰化縣,埔心鄉,0714,404,323,727,77,804,1248,64.42%,32.37%,1
彰化縣,埔心鄉,0715,338,179,517,50,567,916,61.9%,36.9%,1
彰化縣,埔心鄉,0716,214,167,381,29,410,625,65.6%,34.24%,1
彰化縣,埔心鄉,0717,401,247,648,46,694,1271,54.6%,31.55%,1
彰化縣,埔心鄉,0718,213,130,343,35,378,608,62.17%,35.03%,1
彰化縣,埔心鄉,0719,382,268,650,82,732,1132,64.66%,33.75%,1
彰化縣,埔心鄉,0720,363,209,572,66,638,1027,62.12%,35.35%,1
彰化縣,埔心鄉,0721,340,192,532,56,588,926,63.5%,36.72%,1
彰化縣,埔心鄉,0722,252,162,414,68,482,778,61.95%,32.39%,1
彰化縣,埔心鄉,0723,250,143,393,33,426,660,64.55%,37.88%,1
彰化縣,埔心鄉,0724,475,276,751,67,818,1330,61.5%,35.71%,1
彰化縣,埔心鄉,0725,313,239,552,29,581,991,58.63%,31.58%,1
彰化縣,埔心鄉,0726,332,237,569,46,615,985,62.44%,33.71%,1
彰化縣,埔心鄉,0727,327,221,548,47,595,1034,57.54%,31.62%,1
彰化縣,埔心鄉,0728,213,131,344,55,399,612,65.2%,34.8%,1
彰化縣,埔心鄉,0729,448,269,717,70,787,1236,63.67%,36.25%,1
彰化縣,埔心鄉,0730,257,176,433,58,491,775,63.35%,33.16%,1
彰化縣,埔心鄉,0731,268,185,453,45,498,738,67.48%,36.31%,1
彰化縣,埔心鄉,0732,316,275,591,45,636,1036,61.39%,30.5%,1
彰化縣,埔心鄉,0733,283,195,478,80,558,975,57.23%,29.03%,1
彰化縣,埔心鄉,0734,269,181,450,53,503,885,56.84%,30.4%,1
彰化縣,埔心鄉,0735,311,203,514,77,591,939,62.94%,33.12%,1
彰化縣,埔心鄉,0736,239,122,361,43,404,689,58.64%,34.69%,1
彰化縣,埔心鄉,0737,223,134,357,35,392,659,59.48%,33.84%,1
彰化縣,埔心鄉,0738,273,182,455,46,501,910,55.05%,30%,1
彰化縣,埔心鄉,0739,466,332,798,93,891,1352,65.9%,34.47%,1
彰化縣,埔心鄉,0740,237,161,398,41,439,759,57.84%,31.23%,1
彰化縣,埔心鄉,0741,323,188,511,57,568,942,60.3%,34.29%,1
彰化縣,永靖鄉,0606,348,232,580,95,675,1255,53.78%,27.73%,1
彰化縣,永靖鄉,0607,278,192,470,72,542,889,60.97%,31.27%,1
彰化縣,永靖鄉,0608,299,225,524,54,578,1026,56.34%,29.14%,1
彰化縣,永靖鄉,0609,240,158,398,53,451,724,62.29%,33.15%,1
彰化縣,永靖鄉,0610,302,200,502,51,553,924,59.85%,32.68%,1
彰化縣,永靖鄉,0611,179,180,359,61,420,659,63.73%,27.16%,1
彰化縣,永靖鄉,0612,230,165,395,40,435,734,59.26%,31.34%,1
彰化縣,永靖鄉,0613,191,136,327,25,352,758,46.44%,25.2%,1
彰化縣,永靖鄉,0614,313,197,510,44,554,848,65.33%,36.91%,1
彰化縣,永靖鄉,0615,381,289,670,93,763,1404,54.34%,27.14%,1
彰化縣,永靖鄉,0616,309,204,513,37,550,792,69.44%,39.02%,1
彰化縣,永靖鄉,0617,225,177,402,44,446,695,64.17%,32.37%,1
彰化縣,永靖鄉,0618,299,161,460,49,509,821,62%,36.42%,1
彰化縣,永靖鄉,0619,382,209,591,81,672,1064,63.16%,35.9%,1
彰化縣,永靖鄉,0620,261,173,434,52,486,840,57.86%,31.07%,1
彰化縣,永靖鄉,0621,350,279,629,40,669,1079,62%,32.44%,1
彰化縣,永靖鄉,0622,346,251,597,57,654,1048,62.4%,33.02%,1
彰化縣,永靖鄉,0623,322,222,544,67,611,960,63.65%,33.54%,1
彰化縣,永靖鄉,0624,260,186,446,36,482,798,60.4%,32.58%,1
彰化縣,永靖鄉,0625,238,210,448,80,528,796,66.33%,29.9%,1
彰化縣,永靖鄉,0626,198,132,330,51,381,662,57.55%,29.91%,1
彰化縣,永靖鄉,0627,324,228,552,54,606,1040,58.27%,31.15%,1
彰化縣,永靖鄉,0628,305,226,531,54,585,1025,57.07%,29.76%,1
彰化縣,永靖鄉,0629,498,297,795,81,876,1357,64.55%,36.7%,1
彰化縣,永靖鄉,0630,431,266,697,79,776,1236,62.78%,34.87%,1
彰化縣,永靖鄉,0631,272,198,470,24,494,871,56.72%,31.23%,1
彰化縣,永靖鄉,0632,227,118,345,42,387,706,54.82%,32.15%,1
彰化縣,永靖鄉,0633,252,196,448,46,494,770,64.16%,32.73%,1
彰化縣,永靖鄉,0634,244,147,391,48,439,669,65.62%,36.47%,1
彰化縣,永靖鄉,0635,240,199,439,58,497,862,57.66%,27.84%,1
彰化縣,永靖鄉,0636,258,169,427,50,477,847,56.32%,30.46%,1
彰化縣,永靖鄉,0637,243,131,374,56,430,668,64.37%,36.38%,1
彰化縣,永靖鄉,0638,306,197,503,45,548,1073,51.07%,28.52%,1
彰化縣,永靖鄉,0639,337,256,593,63,656,1339,48.99%,25.17%,1
彰化縣,社頭鄉,0778,217,205,422,43,465,791,58.79%,27.43%,1
彰化縣,社頭鄉,0779,303,209,512,47,559,984,56.81%,30.79%,1
彰化縣,社頭鄉,0780,292,192,484,30,514,990,51.92%,29.49%,1
彰化縣,社頭鄉,0781,342,230,572,58,630,1016,62.01%,33.66%,1
彰化縣,社頭鄉,0782,555,55,610,49,659,1091,60.4%,50.87%,1
彰化縣,社頭鄉,0783,392,271,663,80,743,1236,60.11%,31.72%,1
彰化縣,社頭鄉,0784,372,251,623,35,658,1203,54.7%,30.92%,1
彰化縣,社頭鄉,0785,243,151,394,33,427,753,56.71%,32.27%,1
彰化縣,社頭鄉,0786,211,138,349,37,386,725,53.24%,29.1%,1
彰化縣,社頭鄉,0787,309,242,551,72,623,1023,60.9%,30.21%,1
彰化縣,社頭鄉,0788,188,146,334,46,380,562,67.62%,33.45%,1
彰化縣,社頭鄉,0789,310,224,534,49,583,1049,55.58%,29.55%,1
彰化縣,社頭鄉,0790,308,204,512,46,558,933,59.81%,33.01%,1
彰化縣,社頭鄉,0791,304,235,539,67,606,990,61.21%,30.71%,1
彰化縣,社頭鄉,0792,309,208,517,50,567,1076,52.7%,28.72%,1
彰化縣,社頭鄉,0793,245,177,422,30,452,742,60.92%,33.02%,1
彰化縣,社頭鄉,0794,205,136,341,30,371,672,55.21%,30.51%,1
彰化縣,社頭鄉,0795,346,224,570,54,624,1235,50.53%,28.02%,1
彰化縣,社頭鄉,0796,233,186,419,36,455,750,60.67%,31.07%,1
彰化縣,社頭鄉,0797,252,188,440,47,487,895,54.41%,28.16%,1
彰化縣,社頭鄉,0798,205,118,323,23,346,688,50.29%,29.8%,1
彰化縣,社頭鄉,0799,287,151,438,42,480,870,55.17%,32.99%,1
彰化縣,社頭鄉,0800,374,265,639,41,680,1140,59.65%,32.81%,1
彰化縣,社頭鄉,0801,296,226,522,60,582,985,59.09%,30.05%,1
彰化縣,社頭鄉,0802,473,244,717,70,787,1266,62.16%,37.36%,1
彰化縣,社頭鄉,0803,291,214,505,49,554,937,59.12%,31.06%,1
彰化縣,社頭鄉,0804,386,251,637,55,692,1219,56.77%,31.67%,1
彰化縣,社頭鄉,0805,353,238,591,78,669,1165,57.42%,30.3%,1
彰化縣,社頭鄉,0806,329,201,530,60,590,986,59.84%,33.37%,1
彰化縣,社頭鄉,0807,345,82,427,31,458,724,63.26%,47.65%,1
彰化縣,社頭鄉,0808,317,226,543,47,590,1015,58.13%,31.23%,1
彰化縣,社頭鄉,0809,291,230,521,51,572,1116,51.25%,26.08%,1
彰化縣,社頭鄉,0810,290,231,521,56,577,1061,54.38%,27.33%,1
彰化縣,社頭鄉,0811,314,213,527,71,598,992,60.28%,31.65%,1
彰化縣,社頭鄉,0812,342,205,547,35,582,1092,53.3%,31.32%,1
彰化縣,社頭鄉,0813,273,184,457,48,505,828,60.99%,32.97%,1
彰化縣,社頭鄉,0814,210,155,365,59,424,787,53.88%,26.68%,1
彰化縣,社頭鄉,0815,197,126,323,25,348,719,48.4%,27.4%,1
彰化縣,二水鄉,0816,307,219,526,82,608,1028,59.14%,29.86%,1
彰化縣,二水鄉,0817,225,154,379,54,433,689,62.84%,32.66%,1
彰化縣,二水鄉,0818,232,164,396,76,472,871,54.19%,26.64%,1
彰化縣,二水鄉,0819,281,182,463,99,562,953,58.97%,29.49%,1
彰化縣,二水鄉,0820,161,123,284,55,339,624,54.33%,25.8%,1
彰化縣,二水鄉,0821,207,162,369,57,426,645,66.05%,32.09%,1
彰化縣,二水鄉,0822,270,253,523,62,585,986,59.33%,27.38%,1
彰化縣,二水鄉,0823,321,229,550,72,622,943,65.96%,34.04%,1
彰化縣,二水鄉,0824,139,120,259,10,269,455,59.12%,30.55%,1
彰化縣,二水鄉,0825,283,227,510,46,556,831,66.91%,34.06%,1
彰化縣,二水鄉,0826,280,184,464,44,508,831,61.13%,33.69%,1
彰化縣,二水鄉,0827,310,223,533,27,560,1013,55.28%,30.6%,1
彰化縣,二水鄉,0828,235,192,427,79,506,796,63.57%,29.52%,1
彰化縣,二水鄉,0829,235,152,387,64,451,781,57.75%,30.09%,1
彰化縣,二水鄉,0830,171,149,320,29,349,692,50.43%,24.71%,1
彰化縣,二水鄉,0831,198,142,340,30,370,635,58.27%,31.18%,1
彰化縣,二水鄉,0832,200,78,278,49,327,566,57.77%,35.34%,1
彰化縣,北斗鎮,0833,262,183,445,74,519,925,56.11%,28.32%,1
彰化縣,北斗鎮,0834,266,204,470,59,529,869,60.87%,30.61%,1
彰化縣,北斗鎮,0835,285,211,496,52,548,855,64.09%,33.33%,1
彰化縣,北斗鎮,0836,382,235,617,57,674,1065,63.29%,35.87%,1
彰化縣,北斗鎮,0837,230,195,425,81,506,828,61.11%,27.78%,1
彰化縣,北斗鎮,0838,348,255,603,71,674,1124,59.96%,30.96%,1
彰化縣,北斗鎮,0839,379,245,624,57,681,1096,62.14%,34.58%,1
彰化縣,北斗鎮,0840,380,248,628,82,710,1213,58.53%,31.33%,1
彰化縣,北斗鎮,0841,329,244,573,72,645,1164,55.41%,28.26%,1
彰化縣,北斗鎮,0842,214,155,369,41,410,730,56.16%,29.32%,1
彰化縣,北斗鎮,0843,291,162,453,39,492,878,56.04%,33.14%,1
彰化縣,北斗鎮,0844,269,194,463,46,509,833,61.1%,32.29%,1
彰化縣,北斗鎮,0845,290,227,517,50,567,957,59.25%,30.3%,1
彰化縣,北斗鎮,0846,250,151,401,38,439,783,56.07%,31.93%,1
彰化縣,北斗鎮,0847,144,131,275,40,315,573,54.97%,25.13%,1
彰化縣,北斗鎮,0848,188,149,337,45,382,672,56.85%,27.98%,1
彰化縣,北斗鎮,0849,190,147,337,42,379,695,54.53%,27.34%,1
彰化縣,北斗鎮,0850,210,145,355,46,401,747,53.68%,28.11%,1
彰化縣,北斗鎮,0851,237,149,386,27,413,643,64.23%,36.86%,1
彰化縣,北斗鎮,0852,215,133,348,42,390,662,58.91%,32.48%,1
彰化縣,北斗鎮,0853,378,230,608,83,691,1085,63.69%,34.84%,1
彰化縣,北斗鎮,0854,360,226,586,80,666,1121,59.41%,32.11%,1
彰化縣,北斗鎮,0855,272,195,467,42,509,830,61.33%,32.77%,1
彰化縣,北斗鎮,0856,310,184,494,52,546,975,56%,31.79%,1
彰化縣,北斗鎮,0857,412,211,623,43,666,1212,54.95%,33.99%,1
彰化縣,北斗鎮,0858,426,270,696,84,780,1302,59.91%,32.72%,1
彰化縣,北斗鎮,0859,291,195,486,50,536,1077,49.77%,27.02%,1
彰化縣,北斗鎮,0860,275,162,437,67,504,917,54.96%,29.99%,1
彰化縣,北斗鎮,0861,262,158,420,43,463,825,56.12%,31.76%,1
彰化縣,北斗鎮,0862,277,221,498,56,554,937,59.12%,29.56%,1
彰化縣,二林鎮,0942,152,130,282,35,317,731,43.37%,20.79%,1
彰化縣,二林鎮,0943,334,195,529,59,588,1025,57.37%,32.59%,1
彰化縣,二林鎮,0944,241,184,425,27,452,784,57.65%,30.74%,1
彰化縣,二林鎮,0945,288,186,474,44,518,892,58.07%,32.29%,1
彰化縣,二林鎮,0946,340,293,633,83,716,1256,57.01%,27.07%,1
彰化縣,二林鎮,0947,315,202,517,53,570,1043,54.65%,30.2%,1
彰化縣,二林鎮,0948,356,242,598,48,646,1076,60.04%,33.09%,1
彰化縣,二林鎮,0949,342,228,570,71,641,1082,59.24%,31.61%,1
彰化縣,二林鎮,0950,406,281,687,76,763,1427,53.47%,28.45%,1
彰化縣,二林鎮,0951,253,201,454,84,538,1030,52.23%,24.56%,1
彰化縣,二林鎮,0952,275,198,473,67,540,1033,52.27%,26.62%,1
彰化縣,二林鎮,0953,290,201,491,58,549,977,56.19%,29.68%,1
彰化縣,二林鎮,0954,183,139,322,28,350,683,51.24%,26.79%,1
彰化縣,二林鎮,0955,246,163,409,97,506,975,51.9%,25.23%,1
彰化縣,二林鎮,0956,305,202,507,94,601,1336,44.99%,22.83%,1
彰化縣,二林鎮,0957,243,163,406,77,483,1019,47.4%,23.85%,1
彰化縣,二林鎮,0958,228,150,378,62,440,1003,43.87%,22.73%,1
彰化縣,二林鎮,0959,357,211,568,84,652,1151,56.65%,31.02%,1
彰化縣,二林鎮,0960,469,320,789,120,909,1598,56.88%,29.35%,1
彰化縣,二林鎮,0961,446,284,730,69,799,1488,53.7%,29.97%,1
彰化縣,二林鎮,0962,582,356,938,68,1006,1771,56.8%,32.86%,1
彰化縣,二林鎮,0963,323,206,529,55,584,1360,42.94%,23.75%,1
彰化縣,二林鎮,0964,401,282,683,81,764,1613,47.37%,24.86%,1
彰化縣,二林鎮,0965,326,214,540,93,633,1228,51.55%,26.55%,1
彰化縣,二林鎮,0966,252,151,403,33,436,771,56.55%,32.68%,1
彰化縣,二林鎮,0967,268,197,465,42,507,858,59.09%,31.24%,1
彰化縣,二林鎮,0968,180,102,282,2,284,661,42.97%,27.23%,1
彰化縣,二林鎮,0969,336,185,521,107,628,1268,49.53%,26.5%,1
彰化縣,二林鎮,0970,293,186,479,40,519,1081,48.01%,27.1%,1
彰化縣,二林鎮,0971,318,215,533,60,593,1213,48.89%,26.22%,1
彰化縣,二林鎮,0972,416,247,663,80,743,1328,55.95%,31.33%,1
彰化縣,二林鎮,0973,272,177,449,85,534,1118,47.76%,24.33%,1
彰化縣,二林鎮,0974,258,206,464,67,531,1157,45.89%,22.3%,1
彰化縣,二林鎮,0975,249,184,433,44,477,972,49.07%,25.62%,1
彰化縣,二林鎮,0976,284,155,439,45,484,902,53.66%,31.49%,1
彰化縣,二林鎮,0977,397,323,720,73,793,1273,62.29%,31.19%,1
彰化縣,二林鎮,0978,220,291,511,45,556,1087,51.15%,20.24%,1
彰化縣,二林鎮,0979,288,204,492,85,577,987,58.46%,29.18%,1
彰化縣,二林鎮,0980,148,133,281,29,310,719,43.12%,20.58%,1
彰化縣,田尾鄉,0863,337,265,602,64,666,1284,51.87%,26.25%,1
彰化縣,田尾鄉,0864,365,279,644,83,727,1187,61.25%,30.75%,1
彰化縣,田尾鄉,0865,322,234,556,56,612,1033,59.24%,31.17%,1
彰化縣,田尾鄉,0866,253,138,391,37,428,696,61.49%,36.35%,1
彰化縣,田尾鄉,0867,316,183,499,42,541,872,62.04%,36.24%,1
彰化縣,田尾鄉,0868,207,123,330,32,362,680,53.24%,30.44%,1
彰化縣,田尾鄉,0869,324,184,508,47,555,875,63.43%,37.03%,1
彰化縣,田尾鄉,0870,369,293,662,53,715,1337,53.48%,27.6%,1
彰化縣,田尾鄉,0871,505,269,774,70,844,1376,61.34%,36.7%,1
彰化縣,田尾鄉,0872,448,236,684,53,737,1186,62.14%,37.77%,1
彰化縣,田尾鄉,0873,332,208,540,66,606,874,69.34%,37.99%,1
彰化縣,田尾鄉,0874,177,134,311,45,356,647,55.02%,27.36%,1
彰化縣,田尾鄉,0875,296,217,513,57,570,959,59.44%,30.87%,1
彰化縣,田尾鄉,0876,75,49,124,19,143,263,54.37%,28.52%,1
彰化縣,田尾鄉,0877,182,112,294,40,334,618,54.05%,29.45%,1
彰化縣,田尾鄉,0878,330,220,550,30,580,938,61.83%,35.18%,1
彰化縣,田尾鄉,0879,332,172,504,57,561,880,63.75%,37.73%,1
彰化縣,田尾鄉,0880,224,151,375,53,428,804,53.23%,27.86%,1
彰化縣,田尾鄉,0881,186,116,302,26,328,592,55.41%,31.42%,1
彰化縣,田尾鄉,0882,356,237,593,93,686,1079,63.58%,32.99%,1
彰化縣,田尾鄉,0883,408,298,706,76,782,1336,58.53%,30.54%,1
彰化縣,田尾鄉,0884,372,218,590,57,647,1198,54.01%,31.05%,1
彰化縣,田尾鄉,0885,169,119,288,66,354,621,57%,27.21%,1
彰化縣,田尾鄉,0886,228,143,371,41,412,760,54.21%,30%,1
彰化縣,田尾鄉,0887,366,257,623,80,703,1084,64.85%,33.76%,1
彰化縣,埤頭鄉,0888,295,212,507,73,580,1178,49.24%,25.04%,1
彰化縣,埤頭鄉,0889,379,248,627,65,692,1290,53.64%,29.38%,1
彰化縣,埤頭鄉,0890,291,163,454,69,523,973,53.75%,29.91%,1
彰化縣,埤頭鄉,0891,206,172,378,41,419,783,53.51%,26.31%,1
彰化縣,埤頭鄉,0892,224,140,364,54,418,733,57.03%,30.56%,1
彰化縣,埤頭鄉,0893,279,158,437,84,521,899,57.95%,31.03%,1
彰化縣,埤頭鄉,0894,272,199,471,73,544,965,56.37%,28.19%,1
彰化縣,埤頭鄉,0895,399,237,636,67,703,1356,51.84%,29.42%,1
彰化縣,埤頭鄉,0896,370,230,600,89,689,1265,54.47%,29.25%,1
彰化縣,埤頭鄉,0897,288,178,466,70,536,877,61.12%,32.84%,1
彰化縣,埤頭鄉,0898,213,121,334,48,382,705,54.18%,30.21%,1
彰化縣,埤頭鄉,0899,360,217,577,61,638,1062,60.08%,33.9%,1
彰化縣,埤頭鄉,0900,446,223,669,72,741,1300,57%,34.31%,1
彰化縣,埤頭鄉,0901,304,161,465,75,540,923,58.5%,32.94%,1
彰化縣,埤頭鄉,0902,324,177,501,44,545,1085,50.23%,29.86%,1
彰化縣,埤頭鄉,0903,366,205,571,83,654,1103,59.29%,33.18%,1
彰化縣,埤頭鄉,0904,195,139,334,41,375,735,51.02%,26.53%,1
彰化縣,埤頭鄉,0905,178,101,279,37,316,574,55.05%,31.01%,1
彰化縣,埤頭鄉,0906,221,112,333,52,385,767,50.2%,28.81%,1
彰化縣,埤頭鄉,0907,223,139,362,45,407,737,55.22%,30.26%,1
彰化縣,埤頭鄉,0908,217,245,462,76,538,1058,50.85%,20.51%,1
彰化縣,埤頭鄉,0909,200,161,361,63,424,826,51.33%,24.21%,1
彰化縣,埤頭鄉,0910,288,163,451,101,552,1082,51.02%,26.62%,1
彰化縣,埤頭鄉,0911,229,163,392,55,447,737,60.65%,31.07%,1
彰化縣,埤頭鄉,0912,213,132,345,32,377,711,53.02%,29.96%,1
彰化縣,埤頭鄉,0913,283,230,513,83,596,1043,57.14%,27.13%,1
彰化縣,埤頭鄉,0914,241,167,408,30,438,910,48.13%,26.48%,1
彰化縣,芳苑鄉,0998,167,105,272,60,332,940,35.32%,17.77%,1
彰化縣,芳苑鄉,0999,70,53,123,30,153,403,37.97%,17.37%,1
彰化縣,芳苑鄉,1000,194,136,330,43,373,756,49.34%,25.66%,1
彰化縣,芳苑鄉,1001,88,60,148,30,178,548,32.48%,16.06%,1
彰化縣,芳苑鄉,1002,293,156,449,66,515,997,51.65%,29.39%,1
彰化縣,芳苑鄉,1003,282,216,498,88,586,1300,45.08%,21.69%,1
彰化縣,芳苑鄉,1004,217,174,391,51,442,859,51.46%,25.26%,1
彰化縣,芳苑鄉,1005,205,116,321,25,346,734,47.14%,27.93%,1
彰化縣,芳苑鄉,1006,185,87,272,32,304,636,47.8%,29.09%,1
彰化縣,芳苑鄉,1007,173,130,303,72,375,808,46.41%,21.41%,1
彰化縣,芳苑鄉,1008,144,98,242,53,295,668,44.16%,21.56%,1
彰化縣,芳苑鄉,1009,212,125,337,40,377,744,50.67%,28.49%,1
彰化縣,芳苑鄉,1010,234,146,380,106,486,1026,47.37%,22.81%,1
彰化縣,芳苑鄉,1011,131,79,210,10,220,586,37.54%,22.35%,1
彰化縣,芳苑鄉,1012,168,119,287,27,314,593,52.95%,28.33%,1
彰化縣,芳苑鄉,1013,237,221,458,126,584,1071,54.53%,22.13%,1
彰化縣,芳苑鄉,1014,272,191,463,96,559,1060,52.74%,25.66%,1
彰化縣,芳苑鄉,1015,173,115,288,31,319,708,45.06%,24.44%,1
彰化縣,芳苑鄉,1016,162,112,274,74,348,735,47.35%,22.04%,1
彰化縣,芳苑鄉,1017,163,107,270,61,331,571,57.97%,28.55%,1
彰化縣,芳苑鄉,1018,180,88,268,41,309,729,42.39%,24.69%,1
彰化縣,芳苑鄉,1019,169,101,270,76,346,674,51.34%,25.07%,1
彰化縣,芳苑鄉,1020,218,153,371,60,431,846,50.95%,25.77%,1
彰化縣,芳苑鄉,1021,266,148,414,52,466,806,57.82%,33%,1
彰化縣,芳苑鄉,1022,87,64,151,16,167,470,35.53%,18.51%,1
彰化縣,芳苑鄉,1023,352,206,558,63,621,1124,55.25%,31.32%,1
彰化縣,芳苑鄉,1024,82,43,125,27,152,317,47.95%,25.87%,1
彰化縣,芳苑鄉,1025,242,184,426,71,497,1158,42.92%,20.9%,1
彰化縣,芳苑鄉,1026,250,157,407,29,436,967,45.09%,25.85%,1
彰化縣,芳苑鄉,1027,187,155,342,55,397,762,52.1%,24.54%,1
彰化縣,芳苑鄉,1028,268,162,430,47,477,1086,43.92%,24.68%,1
彰化縣,芳苑鄉,1029,203,135,338,30,368,747,49.26%,27.18%,1
彰化縣,芳苑鄉,1030,162,78,240,26,266,653,40.74%,24.81%,1
彰化縣,芳苑鄉,1031,257,190,447,67,514,872,58.94%,29.47%,1
彰化縣,芳苑鄉,1032,397,278,675,70,745,1235,60.32%,32.15%,1
彰化縣,芳苑鄉,1033,307,210,517,74,591,1102,53.63%,27.86%,1
彰化縣,大城鄉,0981,232,135,367,31,398,1288,30.9%,18.01%,1
彰化縣,大城鄉,0982,214,128,342,84,426,1104,38.59%,19.38%,1
彰化縣,大城鄉,0983,290,162,452,85,537,964,55.71%,30.08%,1
彰化縣,大城鄉,0984,341,202,543,67,610,1312,46.49%,25.99%,1
彰化縣,大城鄉,0985,173,118,291,75,366,853,42.91%,20.28%,1
彰化縣,大城鄉,0986,105,54,159,24,183,518,35.33%,20.27%,1
彰化縣,大城鄉,0987,113,97,210,39,249,574,43.38%,19.69%,1
彰化縣,大城鄉,0988,122,109,231,37,268,702,38.18%,17.38%,1
彰化縣,大城鄉,0989,57,41,98,18,116,376,30.85%,15.16%,1
彰化縣,大城鄉,0990,111,78,189,25,214,693,30.88%,16.02%,1
彰化縣,大城鄉,0991,202,128,330,52,382,877,43.56%,23.03%,1
彰化縣,大城鄉,0992,99,76,175,13,188,655,28.7%,15.11%,1
彰化縣,大城鄉,0993,218,146,364,45,409,1103,37.08%,19.76%,1
彰化縣,大城鄉,0994,224,136,360,50,410,1192,34.4%,18.79%,1
彰化縣,大城鄉,0995,188,132,320,41,361,917,39.37%,20.5%,1
彰化縣,大城鄉,0996,126,66,192,32,224,686,32.65%,18.37%,1
彰化縣,大城鄉,0997,161,91,252,30,282,899,31.37%,17.91%,1
彰化縣,竹塘鄉,1034,367,227,594,75,669,1168,57.28%,31.42%,1
彰化縣,竹塘鄉,1035,296,212,508,38,546,965,56.58%,30.67%,1
彰化縣,竹塘鄉,1036,312,221,533,62,595,960,61.98%,32.5%,1
彰化縣,竹塘鄉,1037,232,185,417,66,483,743,65.01%,31.22%,1
彰化縣,竹塘鄉,1038,174,121,295,44,339,751,45.14%,23.17%,1
彰化縣,竹塘鄉,1039,190,132,322,52,374,792,47.22%,23.99%,1
彰化縣,竹塘鄉,1040,171,113,284,22,306,733,41.75%,23.33%,1
彰化縣,竹塘鄉,1041,188,110,298,49,347,657,52.82%,28.61%,1
彰化縣,竹塘鄉,1042,307,170,477,55,532,1063,50.05%,28.88%,1
彰化縣,竹塘鄉,1043,338,206,544,91,635,1114,57%,30.34%,1
彰化縣,竹塘鄉,1044,154,119,273,67,340,506,67.19%,30.43%,1
彰化縣,竹塘鄉,1045,206,161,367,53,420,823,51.03%,25.03%,1
彰化縣,竹塘鄉,1046,184,101,285,51,336,654,51.38%,28.13%,1
彰化縣,竹塘鄉,1047,134,82,216,32,248,577,42.98%,23.22%,1
彰化縣,竹塘鄉,1048,219,127,346,62,408,772,52.85%,28.37%,1
彰化縣,竹塘鄉,1049,125,73,198,51,249,543,45.86%,23.02%,1
彰化縣,溪州鄉,0915,223,158,381,51,432,778,55.53%,28.66%,1
彰化縣,溪州鄉,0916,256,210,466,36,502,1061,47.31%,24.13%,1
彰化縣,溪州鄉,0917,157,128,285,36,321,701,45.79%,22.4%,1
彰化縣,溪州鄉,0918,263,210,473,59,532,879,60.52%,29.92%,1
彰化縣,溪州鄉,0919,208,172,380,49,429,654,65.6%,31.8%,1
彰化縣,溪州鄉,0920,259,194,453,42,495,878,56.38%,29.5%,1
彰化縣,溪州鄉,0921,297,226,523,57,580,942,61.57%,31.53%,1
彰化縣,溪州鄉,0922,266,172,438,41,479,871,54.99%,30.54%,1
彰化縣,溪州鄉,0923,280,201,481,41,522,1047,49.86%,26.74%,1
彰化縣,溪州鄉,0924,243,204,447,54,501,858,58.39%,28.32%,1
彰化縣,溪州鄉,0925,332,232,564,87,651,1409,46.2%,23.56%,1
彰化縣,溪州鄉,0926,214,131,345,35,380,792,47.98%,27.02%,1
彰化縣,溪州鄉,0927,167,152,319,66,385,714,53.92%,23.39%,1
彰化縣,溪州鄉,0928,274,192,466,73,539,1109,48.6%,24.71%,1
彰化縣,溪州鄉,0929,222,160,382,47,429,962,44.59%,23.08%,1
彰化縣,溪州鄉,0930,299,165,464,66,530,1157,45.81%,25.84%,1
彰化縣,溪州鄉,0931,265,164,429,61,490,952,51.47%,27.84%,1
彰化縣,溪州鄉,0932,240,179,419,60,479,887,54%,27.06%,1
彰化縣,溪州鄉,0933,192,134,326,54,380,866,43.88%,22.17%,1
彰化縣,溪州鄉,0934,241,178,419,63,482,1010,47.72%,23.86%,1
彰化縣,溪州鄉,0935,205,193,398,27,425,853,49.82%,24.03%,1
彰化縣,溪州鄉,0936,225,145,370,63,433,843,51.36%,26.69%,1
彰化縣,溪州鄉,0937,138,91,229,17,246,711,34.6%,19.41%,1
彰化縣,溪州鄉,0938,218,168,386,81,467,851,54.88%,25.62%,1
彰化縣,溪州鄉,0939,203,175,378,37,415,883,47%,22.99%,1
彰化縣,溪州鄉,0940,322,196,518,62,580,1247,46.51%,25.82%,1
彰化縣,溪州鄉,0941,432,322,754,87,841,1490,56.44%,28.99%,1
南投縣,南投市,0001,316,208,524,28,552,927,59.55%,34.09%,1
南投縣,南投市,0002,241,179,420,34,454,667,68.07%,36.13%,1
南投縣,南投市,0003,271,182,453,41,494,773,63.91%,35.06%,1
南投縣,南投市,0004,282,193,475,41,516,818,63.08%,34.47%,1
南投縣,南投市,0005,194,134,328,28,356,525,67.81%,36.95%,1
南投縣,南投市,0006,206,137,343,41,384,575,66.78%,35.83%,1
南投縣,南投市,0007,150,83,233,21,254,368,69.02%,40.76%,1
南投縣,南投市,0008,366,217,583,55,638,956,66.74%,38.28%,1
南投縣,南投市,0009,396,230,626,28,654,1245,52.53%,31.81%,1
南投縣,南投市,0010,512,304,816,40,856,1484,57.68%,34.5%,1
南投縣,南投市,0011,477,246,723,57,780,1191,65.49%,40.05%,1
南投縣,南投市,0012,547,314,861,59,920,1506,61.09%,36.32%,1
南投縣,南投市,0013,375,256,631,44,675,1070,63.08%,35.05%,1
南投縣,南投市,0014,266,126,392,30,422,670,62.99%,39.7%,1
南投縣,南投市,0015,424,218,642,53,695,1050,66.19%,40.38%,1
南投縣,南投市,0016,349,210,559,50,609,1122,54.28%,31.11%,1
南投縣,南投市,0017,313,200,513,43,556,984,56.5%,31.81%,1
南投縣,南投市,0018,429,221,650,32,682,1062,64.22%,40.4%,1
南投縣,南投市,0019,363,215,578,71,649,1053,61.63%,34.47%,1
南投縣,南投市,0020,394,262,656,46,702,1104,63.59%,35.69%,1
南投縣,南投市,0021,388,255,643,48,691,1192,57.97%,32.55%,1
南投縣,南投市,0022,310,206,516,37,553,960,57.6%,32.29%,1
南投縣,南投市,0023,315,202,517,40,557,906,61.48%,34.77%,1
南投縣,南投市,0024,328,212,540,53,593,957,61.96%,34.27%,1
南投縣,南投市,0025,347,240,587,65,652,997,65.4%,34.8%,1
南投縣,南投市,0026,365,213,578,49,627,1008,62.2%,36.21%,1
南投縣,南投市,0027,388,262,650,37,687,1164,59.02%,33.33%,1
南投縣,南投市,0028,193,118,311,41,352,587,59.97%,32.88%,1
南投縣,南投市,0029,227,137,364,41,405,734,55.18%,30.93%,1
南投縣,南投市,0030,234,143,377,47,424,724,58.56%,32.32%,1
南投縣,南投市,0031,396,169,565,38,603,1003,60.12%,39.48%,1
南投縣,南投市,0032,459,278,737,51,788,1356,58.11%,33.85%,1
南投縣,南投市,0033,446,244,690,60,750,1373,54.62%,32.48%,1
南投縣,南投市,0034,496,279,775,42,817,1452,56.27%,34.16%,1
南投縣,南投市,0035,118,68,186,13,199,362,54.97%,32.6%,1
南投縣,南投市,0036,124,84,208,28,236,389,60.67%,31.88%,1
南投縣,南投市,0037,469,297,766,64,830,1276,65.05%,36.76%,1
南投縣,南投市,0038,379,275,654,60,714,1089,65.56%,34.8%,1
南投縣,南投市,0039,341,204,545,48,593,921,64.39%,37.02%,1
南投縣,南投市,0040,383,208,591,32,623,892,69.84%,42.94%,1
南投縣,南投市,0041,450,209,659,37,696,1050,66.29%,42.86%,1
南投縣,南投市,0042,429,227,656,33,689,1078,63.91%,39.8%,1
南投縣,南投市,0043,449,195,644,24,668,1078,61.97%,41.65%,1
南投縣,南投市,0044,386,208,594,29,623,861,72.36%,44.83%,1
南投縣,南投市,0045,381,261,642,86,728,1221,59.62%,31.2%,1
南投縣,南投市,0046,397,227,624,34,658,1105,59.55%,35.93%,1
南投縣,南投市,0047,455,273,728,27,755,1230,61.38%,36.99%,1
南投縣,南投市,0048,400,230,630,45,675,1092,61.81%,36.63%,1
南投縣,南投市,0049,542,261,803,20,823,1286,64%,42.15%,1
南投縣,南投市,0050,252,154,406,48,454,655,69.31%,38.47%,1
南投縣,南投市,0051,269,167,436,33,469,719,65.23%,37.41%,1
南投縣,南投市,0052,248,136,384,33,417,720,57.92%,34.44%,1
南投縣,南投市,0053,201,122,323,21,344,509,67.58%,39.49%,1
南投縣,南投市,0054,178,83,261,19,280,492,56.91%,36.18%,1
南投縣,南投市,0055,266,91,357,25,382,616,62.01%,43.18%,1
南投縣,南投市,0056,420,182,602,40,642,1010,63.56%,41.58%,1
南投縣,南投市,0057,350,132,482,24,506,848,59.67%,41.27%,1
南投縣,南投市,0058,524,291,815,76,891,1387,64.24%,37.78%,1
南投縣,南投市,0059,485,273,758,47,805,1245,64.66%,38.96%,1
南投縣,南投市,0060,404,260,664,34,698,1199,58.22%,33.69%,1
南投縣,南投市,0061,451,284,735,51,786,1288,61.02%,35.02%,1
南投縣,南投市,0062,331,231,562,59,621,1040,59.71%,31.83%,1
南投縣,南投市,0063,372,234,606,57,663,1070,61.96%,34.77%,1
南投縣,南投市,0064,490,275,765,51,816,1299,62.82%,37.72%,1
南投縣,南投市,0065,361,411,772,47,819,1122,72.99%,32.17%,1
南投縣,南投市,0066,490,293,783,60,843,1414,59.62%,34.65%,1
南投縣,南投市,0067,367,245,612,51,663,1121,59.14%,32.74%,1
南投縣,南投市,0068,467,310,777,40,817,1434,56.97%,32.57%,1
南投縣,南投市,0069,466,249,715,58,773,1393,55.49%,33.45%,1
南投縣,南投市,0070,371,200,571,28,599,1059,56.56%,35.03%,1
南投縣,南投市,0071,397,262,659,43,702,1218,57.64%,32.59%,1
南投縣,南投市,0072,405,242,647,25,672,1293,51.97%,31.32%,1
南投縣,南投市,0073,364,266,630,43,673,1337,50.34%,27.23%,1
南投縣,南投市,0074,308,216,524,32,556,876,63.47%,35.16%,1
南投縣,南投市,0075,322,209,531,32,563,971,57.98%,33.16%,1
南投縣,南投市,0076,325,235,560,33,593,1012,58.6%,32.11%,1
南投縣,南投市,0077,314,179,493,46,539,973,55.4%,32.27%,1
南投縣,南投市,0078,363,210,573,52,625,1002,62.38%,36.23%,1
南投縣,南投市,0079,323,232,555,56,611,1024,59.67%,31.54%,1
南投縣,南投市,0080,288,199,487,105,592,1122,52.76%,25.67%,1
南投縣,南投市,0081,214,133,347,50,397,790,50.25%,27.09%,1
南投縣,南投市,0082,156,104,260,22,282,647,43.59%,24.11%,1
南投縣,南投市,0083,300,170,470,67,537,950,56.53%,31.58%,1
南投縣,南投市,0084,287,185,472,33,505,980,51.53%,29.29%,1
南投縣,埔里鎮,0085,273,182,455,47,502,828,60.63%,32.97%,1
南投縣,埔里鎮,0086,275,162,437,54,491,786,62.47%,34.99%,1
南投縣,埔里鎮,0087,351,207,558,51,609,1062,57.34%,33.05%,1
南投縣,埔里鎮,0088,421,239,660,89,749,1201,62.36%,35.05%,1
南投縣,埔里鎮,0089,448,283,731,37,768,1415,54.28%,31.66%,1
南投縣,埔里鎮,0090,429,242,671,38,709,1282,55.3%,33.46%,1
南投縣,埔里鎮,0091,270,172,442,57,499,859,58.09%,31.43%,1
南投縣,埔里鎮,0092,405,247,652,93,745,1288,57.84%,31.44%,1
南投縣,埔里鎮,0093,430,289,719,41,760,1330,57.14%,32.33%,1
南投縣,埔里鎮,0094,435,270,705,62,767,1416,54.17%,30.72%,1
南投縣,埔里鎮,0095,353,242,595,54,649,1283,50.58%,27.51%,1
南投縣,埔里鎮,0096,339,261,600,101,701,1151,60.9%,29.45%,1
南投縣,埔里鎮,0097,339,256,595,39,634,1193,53.14%,28.42%,1
南投縣,埔里鎮,0098,482,266,748,86,834,1471,56.7%,32.77%,1
南投縣,埔里鎮,0099,238,189,427,106,533,1044,51.05%,22.8%,1
南投縣,埔里鎮,0100,346,242,588,78,666,1122,59.36%,30.84%,1
南投縣,埔里鎮,0101,417,246,663,63,726,1129,64.3%,36.94%,1
南投縣,埔里鎮,0102,283,175,458,27,485,901,53.83%,31.41%,1
南投縣,埔里鎮,0103,306,188,494,47,541,997,54.26%,30.69%,1
南投縣,埔里鎮,0104,294,236,530,45,575,1209,47.56%,24.32%,1
南投縣,埔里鎮,0105,304,219,523,30,553,838,65.99%,36.28%,1
南投縣,埔里鎮,0106,339,210,549,63,612,1226,49.92%,27.65%,1
南投縣,埔里鎮,0107,414,284,698,87,785,1263,62.15%,32.78%,1
南投縣,埔里鎮,0108,390,216,606,33,639,1045,61.15%,37.32%,1
南投縣,埔里鎮,0109,400,220,620,60,680,1120,60.71%,35.71%,1
南投縣,埔里鎮,0110,387,253,640,51,691,1062,65.07%,36.44%,1
南投縣,埔里鎮,0111,352,196,548,41,589,1022,57.63%,34.44%,1
南投縣,埔里鎮,0112,370,195,565,34,599,1051,56.99%,35.2%,1
南投縣,埔里鎮,0113,350,233,583,41,624,1106,56.42%,31.65%,1
南投縣,埔里鎮,0114,364,204,568,33,601,1098,54.74%,33.15%,1
南投縣,埔里鎮,0115,366,217,583,53,636,1067,59.61%,34.3%,1
南投縣,埔里鎮,0116,161,216,377,52,429,725,59.17%,22.21%,1
南投縣,埔里鎮,0117,343,162,505,33,538,905,59.45%,37.9%,1
南投縣,埔里鎮,0118,363,212,575,69,644,1179,54.62%,30.79%,1
南投縣,埔里鎮,0119,262,187,449,44,493,944,52.22%,27.75%,1
南投縣,埔里鎮,0120,142,91,233,36,269,465,57.85%,30.54%,1
南投縣,埔里鎮,0121,362,220,582,58,640,1133,56.49%,31.95%,1
南投縣,埔里鎮,0122,330,194,524,55,579,1100,52.64%,30%,1
南投縣,埔里鎮,0123,385,233,618,58,676,1155,58.53%,33.33%,1
南投縣,埔里鎮,0124,358,247,605,67,672,1254,53.59%,28.55%,1
南投縣,埔里鎮,0125,404,221,625,74,699,1296,53.94%,31.17%,1
南投縣,埔里鎮,0126,371,247,618,46,664,1023,64.91%,36.27%,1
南投縣,埔里鎮,0127,284,163,447,20,467,964,48.44%,29.46%,1
南投縣,埔里鎮,0128,323,199,522,48,570,986,57.81%,32.76%,1
南投縣,埔里鎮,0129,367,210,577,40,617,1016,60.73%,36.12%,1
南投縣,埔里鎮,0130,290,192,482,54,536,898,59.69%,32.29%,1
南投縣,埔里鎮,0131,343,211,554,44,598,980,61.02%,35%,1
南投縣,埔里鎮,0132,337,199,536,31,567,933,60.77%,36.12%,1
南投縣,埔里鎮,0133,387,208,595,59,654,929,70.4%,41.66%,1
南投縣,埔里鎮,0134,285,202,487,102,589,1032,57.07%,27.62%,1
南投縣,埔里鎮,0135,104,41,145,5,150,315,47.62%,33.02%,1
南投縣,埔里鎮,0136,370,268,638,84,722,1363,52.97%,27.15%,1
南投縣,埔里鎮,0137,242,161,403,36,439,725,60.55%,33.38%,1
南投縣,埔里鎮,0138,212,184,396,32,428,705,60.71%,30.07%,1
南投縣,埔里鎮,0139,285,171,456,33,489,751,65.11%,37.95%,1
南投縣,埔里鎮,0140,317,172,489,45,534,932,57.3%,34.01%,1
南投縣,埔里鎮,0141,306,224,530,39,569,956,59.52%,32.01%,1
南投縣,埔里鎮,0142,125,66,191,17,208,376,55.32%,33.24%,1
南投縣,埔里鎮,0143,205,167,372,36,408,682,59.82%,30.06%,1
南投縣,埔里鎮,0144,485,100,585,59,644,990,65.05%,48.99%,1
南投縣,埔里鎮,0145,318,238,556,116,672,1324,50.76%,24.02%,1
南投縣,埔里鎮,0146,66,63,129,17,146,298,48.99%,22.15%,1
南投縣,埔里鎮,0147,390,186,576,81,657,1170,56.15%,33.33%,1
南投縣,埔里鎮,0148,217,114,331,22,353,604,58.44%,35.93%,1
南投縣,埔里鎮,0149,298,209,507,47,554,999,55.46%,29.83%,1
南投縣,埔里鎮,0150,267,145,412,38,450,923,48.75%,28.93%,1
南投縣,埔里鎮,0151,314,185,499,39,538,887,60.65%,35.4%,1
南投縣,埔里鎮,0152,297,191,488,31,519,981,52.91%,30.28%,1
南投縣,草屯鎮,0153,407,169,576,35,611,998,61.22%,40.78%,1
南投縣,草屯鎮,0154,363,229,592,36,628,1127,55.72%,32.21%,1
南投縣,草屯鎮,0155,439,276,715,29,744,1401,53.1%,31.33%,1
南投縣,草屯鎮,0156,343,237,580,34,614,1110,55.32%,30.9%,1
南投縣,草屯鎮,0157,457,264,721,51,772,1285,60.08%,35.56%,1
南投縣,草屯鎮,0158,320,175,495,38,533,936,56.94%,34.19%,1
南投縣,草屯鎮,0159,354,261,615,53,668,1141,58.55%,31.03%,1
南投縣,草屯鎮,0160,264,152,416,29,445,705,63.12%,37.45%,1
南投縣,草屯鎮,0161,374,279,653,31,684,1121,61.02%,33.36%,1
南投縣,草屯鎮,0162,347,204,551,31,582,877,66.36%,39.57%,1
南投縣,草屯鎮,0163,484,276,760,64,824,1401,58.82%,34.55%,1
南投縣,草屯鎮,0164,396,248,644,53,697,1267,55.01%,31.25%,1
南投縣,草屯鎮,0165,429,208,637,84,721,1214,59.39%,35.34%,1
南投縣,草屯鎮,0166,419,278,697,49,746,1259,59.25%,33.28%,1
南投縣,草屯鎮,0167,515,309,824,47,871,1442,60.4%,35.71%,1
南投縣,草屯鎮,0168,406,313,719,42,761,1273,59.78%,31.89%,1
南投縣,草屯鎮,0169,408,197,605,47,652,1145,56.94%,35.63%,1
南投縣,草屯鎮,0170,454,223,677,38,715,1279,55.9%,35.5%,1
南投縣,草屯鎮,0171,383,220,603,43,646,1158,55.79%,33.07%,1
南投縣,草屯鎮,0172,530,288,818,64,882,1335,66.07%,39.7%,1
南投縣,草屯鎮,0173,402,312,714,50,764,1178,64.86%,34.13%,1
南投縣,草屯鎮,0174,458,277,735,47,782,1327,58.93%,34.51%,1
南投縣,草屯鎮,0175,374,198,572,26,598,1000,59.8%,37.4%,1
南投縣,草屯鎮,0176,480,203,683,36,719,1257,57.2%,38.19%,1
南投縣,草屯鎮,0177,319,193,512,36,548,883,62.06%,36.13%,1
南投縣,草屯鎮,0178,341,241,582,37,619,1121,55.22%,30.42%,1
南投縣,草屯鎮,0179,367,214,581,41,622,1043,59.64%,35.19%,1
南投縣,草屯鎮,0180,357,219,576,30,606,979,61.9%,36.47%,1
南投縣,草屯鎮,0181,296,202,498,28,526,1048,50.19%,28.24%,1
南投縣,草屯鎮,0182,312,227,539,41,580,1009,57.48%,30.92%,1
南投縣,草屯鎮,0183,368,203,571,34,605,1138,53.16%,32.34%,1
南投縣,草屯鎮,0184,372,252,624,40,664,1197,55.47%,31.08%,1
南投縣,草屯鎮,0185,469,300,769,40,809,1364,59.31%,34.38%,1
南投縣,草屯鎮,0186,390,212,602,48,650,1059,61.38%,36.83%,1
南投縣,草屯鎮,0187,369,240,609,50,659,1108,59.48%,33.3%,1
南投縣,草屯鎮,0188,308,154,462,43,505,879,57.45%,35.04%,1
南投縣,草屯鎮,0189,315,186,501,62,563,957,58.83%,32.92%,1
南投縣,草屯鎮,0190,391,231,622,39,661,1395,47.38%,28.03%,1
南投縣,草屯鎮,0191,405,238,643,41,684,1101,62.13%,36.78%,1
南投縣,草屯鎮,0192,402,260,662,41,703,1297,54.2%,30.99%,1
南投縣,草屯鎮,0193,206,162,368,31,399,877,45.5%,23.49%,1
南投縣,草屯鎮,0194,374,229,603,79,682,1376,49.56%,27.18%,1
南投縣,草屯鎮,0195,359,244,603,58,661,1008,65.58%,35.62%,1
南投縣,草屯鎮,0196,374,235,609,56,665,1080,61.57%,34.63%,1
南投縣,草屯鎮,0197,329,190,519,41,560,1017,55.06%,32.35%,1
南投縣,草屯鎮,0198,341,232,573,40,613,961,63.79%,35.48%,1
南投縣,草屯鎮,0199,406,252,658,51,709,1160,61.12%,35%,1
南投縣,草屯鎮,0200,371,234,605,43,648,1121,57.81%,33.1%,1
南投縣,草屯鎮,0201,396,270,666,45,711,1243,57.2%,31.86%,1
南投縣,草屯鎮,0202,321,195,516,39,555,932,59.55%,34.44%,1
南投縣,草屯鎮,0203,497,285,782,76,858,1323,64.85%,37.57%,1
南投縣,草屯鎮,0204,448,287,735,51,786,1518,51.78%,29.51%,1
南投縣,草屯鎮,0205,318,203,521,52,573,923,62.08%,34.45%,1
南投縣,草屯鎮,0206,286,194,480,51,531,970,54.74%,29.48%,1
南投縣,草屯鎮,0207,332,205,537,36,573,1026,55.85%,32.36%,1
南投縣,草屯鎮,0208,440,311,751,73,824,1466,56.21%,30.01%,1
南投縣,草屯鎮,0209,392,243,635,42,677,1180,57.37%,33.22%,1
南投縣,草屯鎮,0210,350,222,572,42,614,1006,61.03%,34.79%,1
南投縣,草屯鎮,0211,291,177,468,39,507,1000,50.7%,29.1%,1
南投縣,草屯鎮,0212,293,351,644,42,686,1128,60.82%,25.98%,1
南投縣,草屯鎮,0213,206,122,328,13,341,623,54.74%,33.07%,1
南投縣,草屯鎮,0214,195,162,357,63,420,707,59.41%,27.58%,1
南投縣,草屯鎮,0215,214,133,347,40,387,719,53.82%,29.76%,1
南投縣,草屯鎮,0216,147,85,232,27,259,527,49.15%,27.89%,1
南投縣,草屯鎮,0217,382,258,640,65,705,1183,59.59%,32.29%,1
南投縣,草屯鎮,0218,322,172,494,40,534,869,61.45%,37.05%,1
南投縣,草屯鎮,0219,315,230,545,16,561,1132,49.56%,27.83%,1
南投縣,草屯鎮,0220,292,223,515,54,569,949,59.96%,30.77%,1
南投縣,草屯鎮,0221,333,217,550,40,590,965,61.14%,34.51%,1
南投縣,草屯鎮,0222,335,204,539,34,573,1068,53.65%,31.37%,1
南投縣,草屯鎮,0223,354,216,570,58,628,1024,61.33%,34.57%,1
南投縣,草屯鎮,0224,205,116,321,31,352,642,54.83%,31.93%,1
南投縣,草屯鎮,0225,305,195,500,41,541,1017,53.2%,29.99%,1
南投縣,草屯鎮,0226,384,203,587,38,625,1092,57.23%,35.16%,1
南投縣,草屯鎮,0227,378,208,586,68,654,1170,55.9%,32.31%,1
南投縣,草屯鎮,0228,371,237,608,62,670,1106,60.58%,33.54%,1
南投縣,竹山鎮,0229,421,222,643,62,705,1170,60.26%,35.98%,1
南投縣,竹山鎮,0230,290,178,468,62,530,850,62.35%,34.12%,1
南投縣,竹山鎮,0231,189,120,309,33,342,621,55.07%,30.43%,1
南投縣,竹山鎮,0232,292,177,469,36,505,905,55.8%,32.27%,1
南投縣,竹山鎮,0233,320,178,498,59,557,1099,50.68%,29.12%,1
南投縣,竹山鎮,0234,359,222,581,56,637,1214,52.47%,29.57%,1
南投縣,竹山鎮,0235,451,258,709,69,778,1287,60.45%,35.04%,1
南投縣,竹山鎮,0236,398,215,613,62,675,1191,56.68%,33.42%,1
南投縣,竹山鎮,0237,335,223,558,77,635,1118,56.8%,29.96%,1
南投縣,竹山鎮,0238,397,287,684,44,728,1278,56.96%,31.06%,1
南投縣,竹山鎮,0239,359,249,608,64,672,1153,58.28%,31.14%,1
南投縣,竹山鎮,0240,366,221,587,76,663,1243,53.34%,29.44%,1
南投縣,竹山鎮,0241,448,228,676,57,733,1308,56.04%,34.25%,1
南投縣,竹山鎮,0242,418,243,661,51,712,1358,52.43%,30.78%,1
南投縣,竹山鎮,0243,319,203,522,54,576,1044,55.17%,30.56%,1
南投縣,竹山鎮,0244,181,110,291,30,321,511,62.82%,35.42%,1
南投縣,竹山鎮,0245,215,136,351,15,366,682,53.67%,31.52%,1
南投縣,竹山鎮,0246,282,169,451,27,478,989,48.33%,28.51%,1
南投縣,竹山鎮,0247,437,263,700,53,753,1378,54.64%,31.71%,1
南投縣,竹山鎮,0248,60,43,103,8,111,217,51.15%,27.65%,1
南投縣,竹山鎮,0249,149,103,252,36,288,479,60.13%,31.11%,1
南投縣,竹山鎮,0250,114,67,181,17,198,430,46.05%,26.51%,1
南投縣,竹山鎮,0251,453,292,745,65,810,1437,56.37%,31.52%,1
南投縣,竹山鎮,0252,443,281,724,50,774,1286,60.19%,34.45%,1
南投縣,竹山鎮,0253,391,201,592,63,655,1080,60.65%,36.2%,1
南投縣,竹山鎮,0254,350,196,546,49,595,1070,55.61%,32.71%,1
南投縣,竹山鎮,0255,417,270,687,58,745,1295,57.53%,32.2%,1
南投縣,竹山鎮,0256,356,186,542,50,592,1047,56.54%,34%,1
南投縣,竹山鎮,0257,405,257,662,59,721,1300,55.46%,31.15%,1
南投縣,竹山鎮,0258,247,144,391,36,427,908,47.03%,27.2%,1
南投縣,竹山鎮,0259,209,156,365,55,420,821,51.16%,25.46%,1
南投縣,竹山鎮,0260,427,273,700,65,765,1320,57.95%,32.35%,1
南投縣,竹山鎮,0261,281,178,459,30,489,967,50.57%,29.06%,1
南投縣,竹山鎮,0262,145,106,251,44,295,595,49.58%,24.37%,1
南投縣,竹山鎮,0263,239,163,402,74,476,859,55.41%,27.82%,1
南投縣,竹山鎮,0264,359,219,578,67,645,1196,53.93%,30.02%,1
南投縣,竹山鎮,0265,218,108,326,43,369,649,56.86%,33.59%,1
南投縣,竹山鎮,0266,383,292,675,74,749,1341,55.85%,28.56%,1
南投縣,竹山鎮,0267,344,198,542,80,622,1222,50.9%,28.15%,1
南投縣,竹山鎮,0268,203,117,320,28,348,602,57.81%,33.72%,1
南投縣,竹山鎮,0269,192,124,316,29,345,617,55.92%,31.12%,1
南投縣,竹山鎮,0270,269,174,443,51,494,793,62.3%,33.92%,1
南投縣,竹山鎮,0271,298,185,483,19,502,922,54.45%,32.32%,1
南投縣,竹山鎮,0272,115,61,176,18,194,366,53.01%,31.42%,1
南投縣,竹山鎮,0273,151,61,212,16,228,509,44.79%,29.67%,1
南投縣,竹山鎮,0274,59,34,93,13,106,193,54.92%,30.57%,1
南投縣,竹山鎮,0275,148,82,230,21,251,406,61.82%,36.45%,1
南投縣,竹山鎮,0276,130,93,223,29,252,495,50.91%,26.26%,1
南投縣,竹山鎮,0277,64,33,97,11,108,307,35.18%,20.85%,1
南投縣,竹山鎮,0278,115,75,190,44,234,440,53.18%,26.14%,1
南投縣,竹山鎮,0279,178,89,267,46,313,577,54.25%,30.85%,1
南投縣,竹山鎮,0280,95,84,179,33,212,486,43.62%,19.55%,1
南投縣,竹山鎮,0281,82,50,132,16,148,403,36.72%,20.35%,1
南投縣,集集鎮,0282,356,242,598,50,648,1070,60.56%,33.27%,1
南投縣,集集鎮,0283,349,172,521,38,559,918,60.89%,38.02%,1
南投縣,集集鎮,0284,203,114,317,34,351,581,60.41%,34.94%,1
南投縣,集集鎮,0285,422,231,653,61,714,1194,59.8%,35.34%,1
南投縣,集集鎮,0286,119,73,192,28,220,488,45.08%,24.39%,1
南投縣,集集鎮,0287,175,96,271,43,314,504,62.3%,34.72%,1
南投縣,集集鎮,0288,247,184,431,132,563,910,61.87%,27.14%,1
南投縣,集集鎮,0289,277,162,439,43,482,773,62.35%,35.83%,1
南投縣,集集鎮,0290,217,150,367,36,403,709,56.84%,30.61%,1
南投縣,集集鎮,0291,340,164,504,30,534,960,55.63%,35.42%,1
南投縣,集集鎮,0292,146,110,256,21,277,503,55.07%,29.03%,1
南投縣,集集鎮,0293,109,73,182,29,211,419,50.36%,26.01%,1
南投縣,集集鎮,0294,131,104,235,30,265,582,45.53%,22.51%,1
南投縣,名間鄉,0295,409,265,674,56,730,1050,69.52%,38.95%,1
南投縣,名間鄉,0296,315,173,488,66,554,920,60.22%,34.24%,1
南投縣,名間鄉,0297,259,182,441,35,476,727,65.47%,35.63%,1
南投縣,名間鄉,0298,322,196,518,35,553,861,64.23%,37.4%,1
南投縣,名間鄉,0299,300,175,475,45,520,897,57.97%,33.44%,1
南投縣,名間鄉,0300,359,227,586,61,647,1055,61.33%,34.03%,1
南投縣,名間鄉,0301,382,247,629,65,694,1184,58.61%,32.26%,1
南投縣,名間鄉,0302,234,166,400,46,446,783,56.96%,29.89%,1
南投縣,名間鄉,0303,272,158,430,59,489,781,62.61%,34.83%,1
南投縣,名間鄉,0304,325,168,493,49,542,977,55.48%,33.27%,1
南投縣,名間鄉,0305,323,182,505,62,567,1015,55.86%,31.82%,1
南投縣,名間鄉,0306,323,190,513,41,554,914,60.61%,35.34%,1
南投縣,名間鄉,0307,318,229,547,29,576,1028,56.03%,30.93%,1
南投縣,名間鄉,0308,350,219,569,49,618,1018,60.71%,34.38%,1
南投縣,名間鄉,0309,429,261,690,62,752,1274,59.03%,33.67%,1
南投縣,名間鄉,0310,251,155,406,48,454,755,60.13%,33.25%,1
南投縣,名間鄉,0311,335,196,531,61,592,895,66.15%,37.43%,1
南投縣,名間鄉,0312,329,163,492,30,522,892,58.52%,36.88%,1
南投縣,名間鄉,0313,285,216,501,51,552,951,58.04%,29.97%,1
南投縣,名間鄉,0314,403,248,651,72,723,1261,57.34%,31.96%,1
南投縣,名間鄉,0315,230,155,385,57,442,768,57.55%,29.95%,1
南投縣,名間鄉,0316,352,164,516,62,578,962,60.08%,36.59%,1
南投縣,名間鄉,0317,290,171,461,73,534,867,61.59%,33.45%,1
南投縣,名間鄉,0318,290,206,496,68,564,930,60.65%,31.18%,1
南投縣,名間鄉,0319,184,143,327,61,388,641,60.53%,28.71%,1
南投縣,名間鄉,0320,141,108,249,32,281,530,53.02%,26.6%,1
南投縣,名間鄉,0321,311,183,494,62,556,931,59.72%,33.4%,1
南投縣,名間鄉,0322,359,242,601,71,672,1127,59.63%,31.85%,1
南投縣,名間鄉,0323,145,101,246,48,294,443,66.37%,32.73%,1
南投縣,名間鄉,0324,303,179,482,50,532,870,61.15%,34.83%,1
南投縣,名間鄉,0325,196,132,328,62,390,621,62.8%,31.56%,1
南投縣,名間鄉,0326,347,226,573,51,624,1179,52.93%,29.43%,1
南投縣,名間鄉,0327,324,179,503,59,562,881,63.79%,36.78%,1
南投縣,名間鄉,0328,314,212,526,70,596,876,68.04%,35.84%,1
南投縣,名間鄉,0329,274,142,416,59,475,783,60.66%,34.99%,1
南投縣,名間鄉,0330,239,130,369,50,419,778,53.86%,30.72%,1
南投縣,名間鄉,0331,286,199,485,56,541,983,55.04%,29.09%,1
南投縣,鹿谷鄉,0332,250,154,404,80,484,934,51.82%,26.77%,1
南投縣,鹿谷鄉,0333,311,177,488,49,537,940,57.13%,33.09%,1
南投縣,鹿谷鄉,0334,243,170,413,43,456,852,53.52%,28.52%,1
南投縣,鹿谷鄉,0335,104,67,171,36,207,451,45.9%,23.06%,1
南投縣,鹿谷鄉,0336,299,152,451,36,487,810,60.12%,36.91%,1
南投縣,鹿谷鄉,0337,407,238,645,68,713,1142,62.43%,35.64%,1
南投縣,鹿谷鄉,0338,216,133,349,20,369,766,48.17%,28.2%,1
南投縣,鹿谷鄉,0339,281,178,459,58,517,884,58.48%,31.79%,1
南投縣,鹿谷鄉,0340,240,177,417,44,461,811,56.84%,29.59%,1
南投縣,鹿谷鄉,0341,149,102,251,26,277,581,47.68%,25.65%,1
南投縣,鹿谷鄉,0342,162,103,265,29,294,578,50.87%,28.03%,1
南投縣,鹿谷鄉,0343,170,80,250,29,279,467,59.74%,36.4%,1
南投縣,鹿谷鄉,0344,197,119,316,30,346,622,55.63%,31.67%,1
南投縣,鹿谷鄉,0345,224,123,347,36,383,740,51.76%,30.27%,1
南投縣,鹿谷鄉,0346,216,161,377,56,433,767,56.45%,28.16%,1
南投縣,鹿谷鄉,0347,298,173,471,58,529,909,58.2%,32.78%,1
南投縣,鹿谷鄉,0348,225,118,343,28,371,713,52.03%,31.56%,1
南投縣,鹿谷鄉,0349,203,104,307,28,335,717,46.72%,28.31%,1
南投縣,鹿谷鄉,0350,222,133,355,51,406,794,51.13%,27.96%,1
南投縣,鹿谷鄉,0351,190,118,308,27,335,726,46.14%,26.17%,1
南投縣,鹿谷鄉,0352,186,92,278,39,317,737,43.01%,25.24%,1
南投縣,中寮鄉,0353,261,180,441,67,508,822,61.8%,31.75%,1
南投縣,中寮鄉,0354,82,58,140,15,155,253,61.26%,32.41%,1
南投縣,中寮鄉,0355,51,34,85,10,95,221,42.99%,23.08%,1
南投縣,中寮鄉,0356,89,66,155,2,157,353,44.48%,25.21%,1
南投縣,中寮鄉,0357,124,85,209,28,237,427,55.5%,29.04%,1
南投縣,中寮鄉,0358,127,75,202,25,227,406,55.91%,31.28%,1
南投縣,中寮鄉,0359,81,56,137,24,161,307,52.44%,26.38%,1
南投縣,中寮鄉,0360,216,130,346,54,400,661,60.51%,32.68%,1
南投縣,中寮鄉,0361,108,68,176,17,193,290,66.55%,37.24%,1
南投縣,中寮鄉,0362,314,217,531,46,577,973,59.3%,32.27%,1
南投縣,中寮鄉,0363,252,172,424,33,457,754,60.61%,33.42%,1
南投縣,中寮鄉,0364,184,144,328,40,368,662,55.59%,27.79%,1
南投縣,中寮鄉,0365,144,71,215,14,229,490,46.73%,29.39%,1
南投縣,中寮鄉,0366,96,58,154,21,175,335,52.24%,28.66%,1
南投縣,中寮鄉,0367,360,166,526,49,575,990,58.08%,36.36%,1
南投縣,中寮鄉,0368,162,109,271,21,292,461,63.34%,35.14%,1
南投縣,中寮鄉,0369,200,154,354,28,382,614,62.21%,32.57%,1
南投縣,中寮鄉,0370,275,165,440,72,512,895,57.21%,30.73%,1
南投縣,中寮鄉,0371,124,97,221,44,265,465,56.99%,26.67%,1
南投縣,中寮鄉,0372,202,131,333,70,403,682,59.09%,29.62%,1
南投縣,中寮鄉,0373,150,112,262,41,303,490,61.84%,30.61%,1
南投縣,中寮鄉,0374,198,138,336,59,395,643,61.43%,30.79%,1
南投縣,中寮鄉,0375,158,94,252,32,284,459,61.87%,34.42%,1
南投縣,中寮鄉,0376,133,101,234,31,265,528,50.19%,25.19%,1
南投縣,魚池鄉,0377,287,180,467,62,529,922,57.38%,31.13%,1
南投縣,魚池鄉,0378,353,234,587,63,650,1098,59.2%,32.15%,1
南投縣,魚池鄉,0379,231,116,347,39,386,720,53.61%,32.08%,1
南投縣,魚池鄉,0380,288,178,466,41,507,860,58.95%,33.49%,1
南投縣,魚池鄉,0381,136,84,220,41,261,514,50.78%,26.46%,1
南投縣,魚池鄉,0382,171,95,266,17,283,574,49.3%,29.79%,1
南投縣,魚池鄉,0383,405,203,608,67,675,1249,54.04%,32.43%,1
南投縣,魚池鄉,0384,101,70,171,21,192,293,65.53%,34.47%,1
南投縣,魚池鄉,0385,133,119,252,27,279,513,54.39%,25.93%,1
南投縣,魚池鄉,0386,54,41,95,7,102,186,54.84%,29.03%,1
南投縣,魚池鄉,0387,248,158,406,32,438,841,52.08%,29.49%,1
南投縣,魚池鄉,0388,84,63,147,23,170,270,62.96%,31.11%,1
南投縣,魚池鄉,0389,85,48,133,20,153,275,55.64%,30.91%,1
南投縣,魚池鄉,0390,72,44,116,13,129,282,45.74%,25.53%,1
南投縣,魚池鄉,0391,112,65,177,11,188,392,47.96%,28.57%,1
南投縣,魚池鄉,0392,162,107,269,34,303,556,54.5%,29.14%,1
南投縣,魚池鄉,0393,55,30,85,11,96,176,54.55%,31.25%,1
南投縣,魚池鄉,0394,130,108,238,35,273,578,47.23%,22.49%,1
南投縣,魚池鄉,0395,108,94,202,22,224,439,51.03%,24.6%,1
南投縣,魚池鄉,0396,296,163,459,37,496,844,58.77%,35.07%,1
南投縣,魚池鄉,0397,241,182,423,43,466,868,53.69%,27.76%,1
南投縣,魚池鄉,0398,122,48,170,20,190,405,46.91%,30.12%,1
南投縣,魚池鄉,0399,160,114,274,31,305,537,56.8%,29.8%,1
南投縣,魚池鄉,0400,104,60,164,18,182,335,54.33%,31.04%,1
南投縣,魚池鄉,0401,54,32,86,18,104,231,45.02%,23.38%,1
南投縣,國姓鄉,0402,338,197,535,66,601,964,62.34%,35.06%,1
南投縣,國姓鄉,0403,249,136,385,29,414,736,56.25%,33.83%,1
南投縣,國姓鄉,0404,256,152,408,66,474,801,59.18%,31.96%,1
南投縣,國姓鄉,0405,329,175,504,30,534,964,55.39%,34.13%,1
南投縣,國姓鄉,0406,218,131,349,36,385,686,56.12%,31.78%,1
南投縣,國姓鄉,0407,196,125,321,41,362,661,54.77%,29.65%,1
南投縣,國姓鄉,0408,215,122,337,45,382,730,52.33%,29.45%,1
南投縣,國姓鄉,0409,190,189,379,55,434,774,56.07%,24.55%,1
南投縣,國姓鄉,0410,233,172,405,19,424,706,60.06%,33%,1
南投縣,國姓鄉,0411,303,219,522,55,577,1012,57.02%,29.94%,1
南投縣,國姓鄉,0412,229,128,357,36,393,868,45.28%,26.38%,1
南投縣,國姓鄉,0413,343,175,518,42,560,918,61%,37.36%,1
南投縣,國姓鄉,0414,282,195,477,59,536,937,57.2%,30.1%,1
南投縣,國姓鄉,0415,232,158,390,60,450,815,55.21%,28.47%,1
南投縣,國姓鄉,0416,382,252,634,49,683,1134,60.23%,33.69%,1
南投縣,國姓鄉,0417,206,132,338,33,371,714,51.96%,28.85%,1
南投縣,國姓鄉,0418,347,214,561,60,621,1095,56.71%,31.69%,1
南投縣,國姓鄉,0419,127,87,214,23,237,448,52.9%,28.35%,1
南投縣,國姓鄉,0420,321,196,517,55,572,1064,53.76%,30.17%,1
南投縣,國姓鄉,0421,168,103,271,29,300,570,52.63%,29.47%,1
南投縣,水里鄉,0422,243,143,386,37,423,757,55.88%,32.1%,1
南投縣,水里鄉,0423,171,102,273,41,314,554,56.68%,30.87%,1
南投縣,水里鄉,0424,308,224,532,46,578,999,57.86%,30.83%,1
南投縣,水里鄉,0425,184,104,288,35,323,616,52.44%,29.87%,1
南投縣,水里鄉,0426,293,184,477,38,515,875,58.86%,33.49%,1
南投縣,水里鄉,0427,141,128,269,14,283,480,58.96%,29.38%,1
南投縣,水里鄉,0428,156,69,225,22,247,450,54.89%,34.67%,1
南投縣,水里鄉,0429,205,109,314,41,355,643,55.21%,31.88%,1
南投縣,水里鄉,0430,345,214,559,31,590,1004,58.76%,34.36%,1
南投縣,水里鄉,0431,228,132,360,41,401,741,54.12%,30.77%,1
南投縣,水里鄉,0432,298,149,447,24,471,802,58.73%,37.16%,1
南投縣,水里鄉,0433,359,226,585,57,642,998,64.33%,35.97%,1
南投縣,水里鄉,0434,244,135,379,60,439,800,54.88%,30.5%,1
南投縣,水里鄉,0435,196,141,337,28,365,589,61.97%,33.28%,1
南投縣,水里鄉,0436,224,157,381,87,468,887,52.76%,25.25%,1
南投縣,水里鄉,0437,372,207,579,52,631,1217,51.85%,30.57%,1
南投縣,水里鄉,0438,52,23,75,2,77,205,37.56%,25.37%,1
南投縣,水里鄉,0439,118,66,184,25,209,330,63.33%,35.76%,1
南投縣,水里鄉,0440,309,214,523,42,565,1100,51.36%,28.09%,1
南投縣,水里鄉,0441,45,37,82,10,92,275,33.45%,16.36%,1
南投縣,水里鄉,0442,75,46,121,10,131,318,41.19%,23.58%,1
南投縣,水里鄉,0443,240,147,387,62,449,818,54.89%,29.34%,1
南投縣,信義鄉,0444,336,220,556,124,680,1201,56.62%,27.98%,1
南投縣,信義鄉,0445,95,54,149,17,166,329,50.46%,28.88%,1
南投縣,信義鄉,0446,131,98,229,37,266,516,51.55%,25.39%,1
南投縣,信義鄉,0447,113,54,167,26,193,424,45.52%,26.65%,1
南投縣,信義鄉,0448,90,55,145,8,153,321,47.66%,28.04%,1
南投縣,信義鄉,0449,221,132,353,31,384,648,59.26%,34.1%,1
南投縣,信義鄉,0450,221,105,326,100,426,584,72.95%,37.84%,1
南投縣,信義鄉,0451,203,119,322,21,343,1376,24.93%,14.75%,1
南投縣,信義鄉,0452,256,149,405,30,435,979,44.43%,26.15%,1
南投縣,信義鄉,0453,181,121,302,90,392,530,73.96%,34.15%,1
南投縣,信義鄉,0454,262,176,438,49,487,961,50.68%,27.26%,1
南投縣,信義鄉,0455,143,92,235,20,255,464,54.96%,30.82%,1
南投縣,信義鄉,0456,158,106,264,38,302,517,58.41%,30.56%,1
南投縣,信義鄉,0457,50,34,84,3,87,149,58.39%,33.56%,1
南投縣,信義鄉,0458,346,239,585,175,760,1020,74.51%,33.92%,1
南投縣,信義鄉,0459,325,150,475,161,636,929,68.46%,34.98%,1
南投縣,信義鄉,0460,71,39,110,15,125,274,45.62%,25.91%,1
南投縣,信義鄉,0461,392,155,547,83,630,900,70%,43.56%,1
南投縣,信義鄉,0462,256,130,386,65,451,617,73.1%,41.49%,1
南投縣,信義鄉,0463,204,100,304,43,347,560,61.96%,36.43%,1
南投縣,仁愛鄉,0464,327,174,501,30,531,973,54.57%,33.61%,1
南投縣,仁愛鄉,0465,81,50,131,19,150,296,50.68%,27.36%,1
南投縣,仁愛鄉,0466,237,143,380,25,405,900,45%,26.33%,1
南投縣,仁愛鄉,0467,159,111,270,28,298,460,64.78%,34.57%,1
南投縣,仁愛鄉,0468,101,74,175,8,183,305,60%,33.11%,1
南投縣,仁愛鄉,0469,11,7,18,2,20,58,34.48%,18.97%,1
南投縣,仁愛鄉,0470,245,119,364,14,378,952,39.71%,25.74%,1
南投縣,仁愛鄉,0471,159,74,233,6,239,679,35.2%,23.42%,1
南投縣,仁愛鄉,0472,185,120,305,64,369,623,59.23%,29.7%,1
南投縣,仁愛鄉,0473,100,64,164,6,170,597,28.48%,16.75%,1
南投縣,仁愛鄉,0474,120,94,214,34,248,384,64.58%,31.25%,1
南投縣,仁愛鄉,0475,33,23,56,6,62,121,51.24%,27.27%,1
南投縣,仁愛鄉,0476,94,37,131,3,134,264,50.76%,35.61%,1
南投縣,仁愛鄉,0477,229,121,350,27,377,509,74.07%,44.99%,1
南投縣,仁愛鄉,0478,95,83,178,29,207,338,61.24%,28.11%,1
南投縣,仁愛鄉,0479,49,26,75,0,75,169,44.38%,28.99%,1
南投縣,仁愛鄉,0480,176,85,261,32,293,613,47.8%,28.71%,1
南投縣,仁愛鄉,0481,98,74,172,18,190,404,47.03%,24.26%,1
南投縣,仁愛鄉,0482,34,34,68,9,77,134,57.46%,25.37%,1
南投縣,仁愛鄉,0483,199,134,333,59,392,630,62.22%,31.59%,1
南投縣,仁愛鄉,0484,183,106,289,11,300,763,39.32%,23.98%,1
南投縣,仁愛鄉,0485,332,195,527,39,566,889,63.67%,37.35%,1
南投縣,仁愛鄉,0486,255,129,384,54,438,672,65.18%,37.95%,1
南投縣,仁愛鄉,0487,149,91,240,32,272,447,60.85%,33.33%,1
南投縣,仁愛鄉,0488,215,72,287,17,304,409,74.33%,52.57%,1
雲林縣,斗六市,0411,182,141,323,16,339,644,52.64%,28.26%,1
雲林縣,斗六市,0412,190,117,307,42,349,617,56.56%,30.79%,1
雲林縣,斗六市,0413,278,187,465,37,502,764,65.71%,36.39%,1
雲林縣,斗六市,0414,270,180,450,38,488,784,62.24%,34.44%,1
雲林縣,斗六市,0415,213,177,390,42,432,760,56.84%,28.03%,1
雲林縣,斗六市,0416,629,421,1050,88,1138,1881,60.5%,33.44%,1
雲林縣,斗六市,0417,553,371,924,70,994,1829,54.35%,30.24%,1
雲林縣,斗六市,0418,433,299,732,51,783,1255,62.39%,34.5%,1
雲林縣,斗六市,0419,434,236,670,33,703,1090,64.5%,39.82%,1
雲林縣,斗六市,0420,383,239,622,51,673,1103,61.02%,34.72%,1
雲林縣,斗六市,0421,434,231,665,40,705,1176,59.95%,36.9%,1
雲林縣,斗六市,0422,483,332,815,39,854,1529,55.85%,31.59%,1
雲林縣,斗六市,0423,452,274,726,56,782,1335,58.58%,33.86%,1
雲林縣,斗六市,0424,589,380,969,70,1039,1770,58.7%,33.28%,1
雲林縣,斗六市,0425,400,299,699,51,750,1308,57.34%,30.58%,1
雲林縣,斗六市,0426,671,412,1083,91,1174,2171,54.08%,30.91%,1
雲林縣,斗六市,0427,404,268,672,58,730,1193,61.19%,33.86%,1
雲林縣,斗六市,0428,583,332,915,66,981,1572,62.4%,37.09%,1
雲林縣,斗六市,0429,326,203,529,31,560,1009,55.5%,32.31%,1
雲林縣,斗六市,0430,437,245,682,63,745,1195,62.34%,36.57%,1
雲林縣,斗六市,0431,507,281,788,81,869,1415,61.41%,35.83%,1
雲林縣,斗六市,0432,352,276,628,49,677,1101,61.49%,31.97%,1
雲林縣,斗六市,0433,488,338,826,58,884,1648,53.64%,29.61%,1
雲林縣,斗六市,0434,477,283,760,41,801,1588,50.44%,30.04%,1
雲林縣,斗六市,0435,475,302,777,44,821,1392,58.98%,34.12%,1
雲林縣,斗六市,0436,475,298,773,54,827,1422,58.16%,33.4%,1
雲林縣,斗六市,0437,352,180,532,47,579,1187,48.78%,29.65%,1
雲林縣,斗六市,0438,322,213,535,54,589,1142,51.58%,28.2%,1
雲林縣,斗六市,0439,504,324,828,46,874,1421,61.51%,35.47%,1
雲林縣,斗六市,0440,400,283,683,35,718,1261,56.94%,31.72%,1
雲林縣,斗六市,0441,443,300,743,42,785,1506,52.12%,29.42%,1
雲林縣,斗六市,0442,415,306,721,40,761,1214,62.69%,34.18%,1
雲林縣,斗六市,0443,484,315,799,72,871,1362,63.95%,35.54%,1
雲林縣,斗六市,0444,346,216,562,35,597,1097,54.42%,31.54%,1
雲林縣,斗六市,0445,415,258,673,48,721,1262,57.13%,32.88%,1
雲林縣,斗六市,0446,380,219,599,36,635,1154,55.03%,32.93%,1
雲林縣,斗六市,0447,306,172,478,33,511,847,60.33%,36.13%,1
雲林縣,斗六市,0448,480,246,726,47,773,1439,53.72%,33.36%,1
雲林縣,斗六市,0449,590,401,991,74,1065,1747,60.96%,33.77%,1
雲林縣,斗六市,0450,485,275,760,52,812,1418,57.26%,34.2%,1
雲林縣,斗六市,0451,362,217,579,54,633,1112,56.92%,32.55%,1
雲林縣,斗六市,0452,424,263,687,61,748,1302,57.45%,32.57%,1
雲林縣,斗六市,0453,217,183,400,25,425,669,63.53%,32.44%,1
雲林縣,斗六市,0454,248,141,389,47,436,752,57.98%,32.98%,1
雲林縣,斗六市,0455,433,278,711,54,765,1450,52.76%,29.86%,1
雲林縣,斗六市,0456,168,107,275,46,321,555,57.84%,30.27%,1
雲林縣,斗六市,0457,438,261,699,69,768,1470,52.24%,29.8%,1
雲林縣,斗六市,0458,313,204,517,36,553,927,59.65%,33.76%,1
雲林縣,斗六市,0459,654,379,1033,72,1105,1893,58.37%,34.55%,1
雲林縣,斗六市,0460,493,386,879,107,986,1708,57.73%,28.86%,1
雲林縣,斗六市,0461,506,245,751,82,833,1773,46.98%,28.54%,1
雲林縣,斗六市,0462,500,295,795,49,844,1412,59.77%,35.41%,1
雲林縣,斗六市,0463,501,302,803,33,836,1354,61.74%,37%,1
雲林縣,斗六市,0464,395,264,659,40,699,1267,55.17%,31.18%,1
雲林縣,斗六市,0465,387,258,645,38,683,1273,53.65%,30.4%,1
雲林縣,斗六市,0466,522,285,807,97,904,1748,51.72%,29.86%,1
雲林縣,斗六市,0467,395,253,648,79,727,1238,58.72%,31.91%,1
雲林縣,斗六市,0468,493,310,803,88,891,1648,54.07%,29.92%,1
雲林縣,斗六市,0469,524,324,848,69,917,1520,60.33%,34.47%,1
雲林縣,斗六市,0470,317,202,519,40,559,1087,51.43%,29.16%,1
雲林縣,斗六市,0471,632,364,996,87,1083,1904,56.88%,33.19%,1
雲林縣,斗六市,0472,229,156,385,39,424,702,60.4%,32.62%,1
雲林縣,斗六市,0473,314,269,583,64,647,1111,58.24%,28.26%,1
雲林縣,斗六市,0474,290,207,497,46,543,1123,48.35%,25.82%,1
雲林縣,斗六市,0475,339,202,541,50,591,1146,51.57%,29.58%,1
雲林縣,斗六市,0476,555,342,897,45,942,1786,52.74%,31.08%,1
雲林縣,斗六市,0477,280,237,517,69,586,1023,57.28%,27.37%,1
雲林縣,斗六市,0478,611,427,1038,109,1147,2072,55.36%,29.49%,1
雲林縣,斗六市,0479,326,230,556,30,586,1128,51.95%,28.9%,1
雲林縣,斗南鎮,0498,338,276,614,60,674,1166,57.8%,28.99%,1
雲林縣,斗南鎮,0499,366,280,646,42,688,1135,60.62%,32.25%,1
雲林縣,斗南鎮,0500,323,238,561,44,605,975,62.05%,33.13%,1
雲林縣,斗南鎮,0501,507,298,805,58,863,1459,59.15%,34.75%,1
雲林縣,斗南鎮,0502,441,295,736,58,794,1351,58.77%,32.64%,1
雲林縣,斗南鎮,0503,458,217,675,66,741,1321,56.09%,34.67%,1
雲林縣,斗南鎮,0504,263,185,448,51,499,907,55.02%,29%,1
雲林縣,斗南鎮,0505,528,334,862,68,930,1473,63.14%,35.85%,1
雲林縣,斗南鎮,0506,392,336,728,75,803,1277,62.88%,30.7%,1
雲林縣,斗南鎮,0507,351,291,642,113,755,1333,56.64%,26.33%,1
雲林縣,斗南鎮,0508,219,151,370,40,410,777,52.77%,28.19%,1
雲林縣,斗南鎮,0509,226,197,423,53,476,877,54.28%,25.77%,1
雲林縣,斗南鎮,0510,267,161,428,65,493,899,54.84%,29.7%,1
雲林縣,斗南鎮,0511,151,113,264,50,314,688,45.64%,21.95%,1
雲林縣,斗南鎮,0512,307,302,609,41,650,1147,56.67%,26.77%,1
雲林縣,斗南鎮,0513,506,328,834,111,945,1709,55.3%,29.61%,1
雲林縣,斗南鎮,0514,335,242,577,56,633,1042,60.75%,32.15%,1
雲林縣,斗南鎮,0515,453,327,780,99,879,1631,53.89%,27.77%,1
雲林縣,斗南鎮,0516,367,547,914,100,1014,1702,59.58%,21.56%,1
雲林縣,斗南鎮,0517,498,349,847,68,915,1564,58.5%,31.84%,1
雲林縣,斗南鎮,0518,241,144,385,16,401,910,44.07%,26.48%,1
雲林縣,斗南鎮,0519,436,287,723,59,782,1276,61.29%,34.17%,1
雲林縣,斗南鎮,0520,228,137,365,24,389,897,43.37%,25.42%,1
雲林縣,斗南鎮,0521,231,150,381,44,425,803,52.93%,28.77%,1
雲林縣,斗南鎮,0522,276,171,447,57,504,866,58.2%,31.87%,1
雲林縣,斗南鎮,0523,261,167,428,76,504,852,59.15%,30.63%,1
雲林縣,斗南鎮,0524,178,148,326,55,381,671,56.78%,26.53%,1
雲林縣,斗南鎮,0525,289,190,479,37,516,981,52.6%,29.46%,1
雲林縣,斗南鎮,0526,279,207,486,35,521,1129,46.15%,24.71%,1
雲林縣,斗南鎮,0527,496,314,810,122,932,1586,58.76%,31.27%,1
雲林縣,斗南鎮,0528,429,237,666,92,758,1243,60.98%,34.51%,1
雲林縣,斗南鎮,0529,251,185,436,36,472,984,47.97%,25.51%,1
雲林縣,斗南鎮,0530,431,307,738,97,835,1507,55.41%,28.6%,1
雲林縣,虎尾鎮,0109,411,260,671,73,744,1347,55.23%,30.51%,1
雲林縣,虎尾鎮,0110,410,284,694,47,741,1258,58.9%,32.59%,1
雲林縣,虎尾鎮,0111,234,176,410,25,435,785,55.41%,29.81%,1
雲林縣,虎尾鎮,0112,219,170,389,49,438,890,49.21%,24.61%,1
雲林縣,虎尾鎮,0113,442,310,752,58,810,1413,57.32%,31.28%,1
雲林縣,虎尾鎮,0114,499,300,799,67,866,1431,60.52%,34.87%,1
雲林縣,虎尾鎮,0115,348,234,582,76,658,1224,53.76%,28.43%,1
雲林縣,虎尾鎮,0116,381,212,593,51,644,1325,48.6%,28.75%,1
雲林縣,虎尾鎮,0117,286,211,497,73,570,941,60.57%,30.39%,1
雲林縣,虎尾鎮,0118,517,304,821,40,861,1613,53.38%,32.05%,1
雲林縣,虎尾鎮,0119,450,331,781,57,838,1641,51.07%,27.42%,1
雲林縣,虎尾鎮,0120,410,252,662,53,715,1200,59.58%,34.17%,1
雲林縣,虎尾鎮,0121,403,273,676,86,762,1294,58.89%,31.14%,1
雲林縣,虎尾鎮,0122,388,271,659,58,717,1273,56.32%,30.48%,1
雲林縣,虎尾鎮,0123,512,311,823,44,867,1438,60.29%,35.61%,1
雲林縣,虎尾鎮,0124,466,278,744,42,786,1361,57.75%,34.24%,1
雲林縣,虎尾鎮,0125,481,332,813,54,867,1444,60.04%,33.31%,1
雲林縣,虎尾鎮,0126,542,339,881,49,930,1490,62.42%,36.38%,1
雲林縣,虎尾鎮,0127,476,305,781,50,831,1307,63.58%,36.42%,1
雲林縣,虎尾鎮,0128,266,186,452,34,486,967,50.26%,27.51%,1
雲林縣,虎尾鎮,0129,538,365,903,47,950,1865,50.94%,28.85%,1
雲林縣,虎尾鎮,0130,611,354,965,65,1030,1880,54.79%,32.5%,1
雲林縣,虎尾鎮,0131,292,232,524,46,570,1099,51.87%,26.57%,1
雲林縣,虎尾鎮,0132,272,214,486,21,507,901,56.27%,30.19%,1
雲林縣,虎尾鎮,0133,335,208,543,35,578,1120,51.61%,29.91%,1
雲林縣,虎尾鎮,0134,131,101,232,12,244,545,44.77%,24.04%,1
雲林縣,虎尾鎮,0135,383,291,674,79,753,1420,53.03%,26.97%,1
雲林縣,虎尾鎮,0136,327,241,568,42,610,1248,48.88%,26.2%,1
雲林縣,虎尾鎮,0137,241,145,386,32,418,799,52.32%,30.16%,1
雲林縣,虎尾鎮,0138,228,155,383,62,445,836,53.23%,27.27%,1
雲林縣,虎尾鎮,0139,214,204,418,55,473,924,51.19%,23.16%,1
雲林縣,虎尾鎮,0140,390,257,647,55,702,1648,42.6%,23.67%,1
雲林縣,虎尾鎮,0141,391,278,669,113,782,1616,48.39%,24.2%,1
雲林縣,虎尾鎮,0142,412,264,676,82,758,1546,49.03%,26.65%,1
雲林縣,虎尾鎮,0143,373,216,589,41,630,1283,49.1%,29.07%,1
雲林縣,虎尾鎮,0144,293,192,485,42,527,1078,48.89%,27.18%,1
雲林縣,虎尾鎮,0145,327,230,557,52,609,1313,46.38%,24.9%,1
雲林縣,虎尾鎮,0146,310,250,560,48,608,1284,47.35%,24.14%,1
雲林縣,虎尾鎮,0147,380,247,627,101,728,1356,53.69%,28.02%,1
雲林縣,虎尾鎮,0148,442,285,727,78,805,1504,53.52%,29.39%,1
雲林縣,虎尾鎮,0149,308,195,503,43,546,1224,44.61%,25.16%,1
雲林縣,虎尾鎮,0150,379,244,623,85,708,1509,46.92%,25.12%,1
雲林縣,虎尾鎮,0151,145,156,301,66,367,855,42.92%,16.96%,1
雲林縣,虎尾鎮,0152,377,238,615,104,719,1549,46.42%,24.34%,1
雲林縣,虎尾鎮,0153,220,136,356,37,393,851,46.18%,25.85%,1
雲林縣,虎尾鎮,0154,349,209,558,79,637,1272,50.08%,27.44%,1
雲林縣,西螺鎮,0340,432,282,714,83,797,1590,50.13%,27.17%,1
雲林縣,西螺鎮,0341,517,317,834,114,948,1741,54.45%,29.7%,1
雲林縣,西螺鎮,0342,388,233,621,71,692,1080,64.07%,35.93%,1
雲林縣,西螺鎮,0343,347,230,577,76,653,1040,62.79%,33.37%,1
雲林縣,西螺鎮,0344,400,281,681,67,748,1346,55.57%,29.72%,1
雲林縣,西螺鎮,0345,535,287,822,63,885,1625,54.46%,32.92%,1
雲林縣,西螺鎮,0346,123,80,203,24,227,354,64.12%,34.75%,1
雲林縣,西螺鎮,0347,155,120,275,43,318,580,54.83%,26.72%,1
雲林縣,西螺鎮,0348,193,133,326,47,373,591,63.11%,32.66%,1
雲林縣,西螺鎮,0349,313,236,549,72,621,1050,59.14%,29.81%,1
雲林縣,西螺鎮,0350,368,267,635,76,711,1147,61.99%,32.08%,1
雲林縣,西螺鎮,0351,437,314,751,110,861,1602,53.75%,27.28%,1
雲林縣,西螺鎮,0352,445,238,683,82,765,1452,52.69%,30.65%,1
雲林縣,西螺鎮,0353,426,336,762,117,879,1578,55.7%,27%,1
雲林縣,西螺鎮,0354,363,260,623,40,663,1305,50.8%,27.82%,1
雲林縣,西螺鎮,0355,323,214,537,66,603,1327,45.44%,24.34%,1
雲林縣,西螺鎮,0356,436,258,694,92,786,1516,51.85%,28.76%,1
雲林縣,西螺鎮,0357,184,119,303,37,340,828,41.06%,22.22%,1
雲林縣,西螺鎮,0358,168,103,271,25,296,788,37.56%,21.32%,1
雲林縣,西螺鎮,0359,205,151,356,86,442,863,51.22%,23.75%,1
雲林縣,西螺鎮,0360,218,183,401,119,520,984,52.85%,22.15%,1
雲林縣,西螺鎮,0361,357,287,644,66,710,1514,46.9%,23.58%,1
雲林縣,西螺鎮,0362,211,170,381,82,463,870,53.22%,24.25%,1
雲林縣,西螺鎮,0363,271,179,450,67,517,971,53.24%,27.91%,1
雲林縣,西螺鎮,0364,309,213,522,63,585,1304,44.86%,23.7%,1
雲林縣,西螺鎮,0365,193,106,299,51,350,726,48.21%,26.58%,1
雲林縣,西螺鎮,0366,211,180,391,59,450,823,54.68%,25.64%,1
雲林縣,西螺鎮,0367,198,122,320,28,348,886,39.28%,22.35%,1
雲林縣,西螺鎮,0368,363,224,587,99,686,1373,49.96%,26.44%,1
雲林縣,西螺鎮,0369,282,177,459,78,537,983,54.63%,28.69%,1
雲林縣,西螺鎮,0370,280,203,483,61,544,1014,53.65%,27.61%,1
雲林縣,西螺鎮,0371,226,163,389,83,472,939,50.27%,24.07%,1
雲林縣,西螺鎮,0372,232,154,386,45,431,866,49.77%,26.79%,1
雲林縣,西螺鎮,0373,383,248,631,93,724,1486,48.72%,25.77%,1
雲林縣,土庫鎮,0080,282,164,446,68,514,809,63.54%,34.86%,1
雲林縣,土庫鎮,0081,247,222,469,70,539,896,60.16%,27.57%,1
雲林縣,土庫鎮,0082,204,139,343,55,398,687,57.93%,29.69%,1
雲林縣,土庫鎮,0083,278,150,428,43,471,702,67.09%,39.6%,1
雲林縣,土庫鎮,0084,366,215,581,57,638,1032,61.82%,35.47%,1
雲林縣,土庫鎮,0085,186,129,315,56,371,697,53.23%,26.69%,1
雲林縣,土庫鎮,0086,100,85,185,39,224,427,52.46%,23.42%,1
雲林縣,土庫鎮,0087,462,295,757,86,843,1451,58.1%,31.84%,1
雲林縣,土庫鎮,0088,404,281,685,38,723,1283,56.35%,31.49%,1
雲林縣,土庫鎮,0089,150,109,259,20,279,634,44.01%,23.66%,1
雲林縣,土庫鎮,0090,231,156,387,41,428,796,53.77%,29.02%,1
雲林縣,土庫鎮,0091,150,129,279,54,333,745,44.7%,20.13%,1
雲林縣,土庫鎮,0092,143,109,252,38,290,576,50.35%,24.83%,1
雲林縣,土庫鎮,0093,168,124,292,64,356,743,47.91%,22.61%,1
雲林縣,土庫鎮,0094,117,102,219,19,238,534,44.57%,21.91%,1
雲林縣,土庫鎮,0095,268,184,452,92,544,1199,45.37%,22.35%,1
雲林縣,土庫鎮,0096,251,212,463,77,540,1077,50.14%,23.31%,1
雲林縣,土庫鎮,0097,178,112,290,46,336,819,41.03%,21.73%,1
雲林縣,土庫鎮,0098,178,141,319,51,370,684,54.09%,26.02%,1
雲林縣,土庫鎮,0099,240,153,393,67,460,843,54.57%,28.47%,1
雲林縣,土庫鎮,0100,239,161,400,87,487,916,53.17%,26.09%,1
雲林縣,土庫鎮,0101,232,183,415,58,473,948,49.89%,24.47%,1
雲林縣,土庫鎮,0102,275,153,428,36,464,914,50.77%,30.09%,1
雲林縣,土庫鎮,0103,234,149,383,83,466,860,54.19%,27.21%,1
雲林縣,土庫鎮,0104,254,153,407,64,471,929,50.7%,27.34%,1
雲林縣,土庫鎮,0105,214,141,355,63,418,875,47.77%,24.46%,1
雲林縣,土庫鎮,0106,204,109,313,52,365,896,40.74%,22.77%,1
雲林縣,土庫鎮,0107,165,107,272,70,342,757,45.18%,21.8%,1
雲林縣,土庫鎮,0108,162,121,283,45,328,683,48.02%,23.72%,1
雲林縣,北港鎮,0256,215,119,334,90,424,724,58.56%,29.7%,1
雲林縣,北港鎮,0257,192,156,348,81,429,688,62.35%,27.91%,1
雲林縣,北港鎮,0258,131,86,217,48,265,452,58.63%,28.98%,1
雲林縣,北港鎮,0259,238,183,421,86,507,866,58.55%,27.48%,1
雲林縣,北港鎮,0260,90,63,153,25,178,336,52.98%,26.79%,1
雲林縣,北港鎮,0261,123,59,182,35,217,395,54.94%,31.14%,1
雲林縣,北港鎮,0262,131,78,209,29,238,376,63.3%,34.84%,1
雲林縣,北港鎮,0263,284,211,495,54,549,950,57.79%,29.89%,1
雲林縣,北港鎮,0264,153,118,271,51,322,512,62.89%,29.88%,1
雲林縣,北港鎮,0265,99,57,156,42,198,324,61.11%,30.56%,1
雲林縣,北港鎮,0266,152,108,260,39,299,546,54.76%,27.84%,1
雲林縣,北港鎮,0267,140,94,234,25,259,433,59.82%,32.33%,1
雲林縣,北港鎮,0268,214,141,355,76,431,751,57.39%,28.5%,1
雲林縣,北港鎮,0269,154,87,241,32,273,442,61.76%,34.84%,1
雲林縣,北港鎮,0270,351,227,578,88,666,1151,57.86%,30.5%,1
雲林縣,北港鎮,0271,375,272,647,66,713,1224,58.25%,30.64%,1
雲林縣,北港鎮,0272,329,265,594,70,664,1211,54.83%,27.17%,1
雲林縣,北港鎮,0273,398,250,648,99,747,1326,56.33%,30.02%,1
雲林縣,北港鎮,0274,244,174,418,61,479,744,64.38%,32.8%,1
雲林縣,北港鎮,0275,323,243,566,61,627,977,64.18%,33.06%,1
雲林縣,北港鎮,0276,256,200,456,74,530,960,55.21%,26.67%,1
雲林縣,北港鎮,0277,98,61,159,15,174,494,35.22%,19.84%,1
雲林縣,北港鎮,0278,446,266,712,76,788,1364,57.77%,32.7%,1
雲林縣,北港鎮,0279,399,171,570,84,654,1123,58.24%,35.53%,1
雲林縣,北港鎮,0280,482,275,757,65,822,1451,56.65%,33.22%,1
雲林縣,北港鎮,0281,380,240,620,77,697,1162,59.98%,32.7%,1
雲林縣,北港鎮,0282,311,204,515,68,583,1130,51.59%,27.52%,1
雲林縣,北港鎮,0283,312,205,517,60,577,1149,50.22%,27.15%,1
雲林縣,北港鎮,0284,106,86,192,48,240,533,45.03%,19.89%,1
雲林縣,北港鎮,0285,125,108,233,143,376,433,86.84%,28.87%,1
雲林縣,北港鎮,0286,114,46,160,19,179,377,47.48%,30.24%,1
雲林縣,北港鎮,0287,191,126,317,34,351,809,43.39%,23.61%,1
雲林縣,北港鎮,0288,324,215,539,100,639,1397,45.74%,23.19%,1
雲林縣,北港鎮,0289,262,174,436,96,532,1145,46.46%,22.88%,1
雲林縣,北港鎮,0290,134,104,238,73,311,828,37.56%,16.18%,1
雲林縣,北港鎮,0291,124,73,197,25,222,557,39.86%,22.26%,1
雲林縣,北港鎮,0292,266,176,442,56,498,1060,46.98%,25.09%,1
雲林縣,北港鎮,0293,160,81,241,37,278,577,48.18%,27.73%,1
雲林縣,北港鎮,0294,196,143,339,72,411,931,44.15%,21.05%,1
雲林縣,北港鎮,0295,311,182,493,53,546,1018,53.63%,30.55%,1
雲林縣,北港鎮,0296,307,212,519,38,557,1032,53.97%,29.75%,1
雲林縣,古坑鄉,0531,346,215,561,61,622,1126,55.24%,30.73%,1
雲林縣,古坑鄉,0532,281,179,460,64,524,994,52.72%,28.27%,1
雲林縣,古坑鄉,0533,399,269,668,94,762,1517,50.23%,26.3%,1
雲林縣,古坑鄉,0534,402,230,632,65,697,1302,53.53%,30.88%,1
雲林縣,古坑鄉,0535,482,322,804,69,873,1772,49.27%,27.2%,1
雲林縣,古坑鄉,0536,345,195,540,104,644,1122,57.4%,30.75%,1
雲林縣,古坑鄉,0537,57,31,88,8,96,304,31.58%,18.75%,1
雲林縣,古坑鄉,0538,327,246,573,107,680,1169,58.17%,27.97%,1
雲林縣,古坑鄉,0539,312,227,539,111,650,1255,51.79%,24.86%,1
雲林縣,古坑鄉,0540,357,229,586,66,652,1078,60.48%,33.12%,1
雲林縣,古坑鄉,0541,248,145,393,45,438,943,46.45%,26.3%,1
雲林縣,古坑鄉,0542,342,244,586,83,669,1300,51.46%,26.31%,1
雲林縣,古坑鄉,0543,251,178,429,54,483,964,50.1%,26.04%,1
雲林縣,古坑鄉,0544,334,234,568,55,623,1144,54.46%,29.2%,1
雲林縣,古坑鄉,0545,433,271,704,84,788,1482,53.17%,29.22%,1
雲林縣,古坑鄉,0546,220,120,340,46,386,688,56.1%,31.98%,1
雲林縣,古坑鄉,0547,257,164,421,66,487,998,48.8%,25.75%,1
雲林縣,古坑鄉,0548,360,227,587,63,650,1140,57.02%,31.58%,1
雲林縣,古坑鄉,0549,320,199,519,70,589,1102,53.45%,29.04%,1
雲林縣,古坑鄉,0550,267,186,453,44,497,956,51.99%,27.93%,1
雲林縣,古坑鄉,0551,189,140,329,38,367,695,52.81%,27.19%,1
雲林縣,古坑鄉,0552,472,114,586,9,595,1233,48.26%,38.28%,1
雲林縣,古坑鄉,0553,49,42,91,11,102,285,35.79%,17.19%,1
雲林縣,古坑鄉,0554,160,103,263,15,278,734,37.87%,21.8%,1
雲林縣,古坑鄉,0555,296,265,561,73,634,1150,55.13%,25.74%,1
雲林縣,古坑鄉,0556,110,94,204,26,230,453,50.77%,24.28%,1
雲林縣,古坑鄉,0557,131,105,236,41,277,571,48.51%,22.94%,1
雲林縣,大埤鄉,0480,212,140,352,49,401,750,53.47%,28.27%,1
雲林縣,大埤鄉,0481,200,124,324,32,356,719,49.51%,27.82%,1
雲林縣,大埤鄉,0482,179,104,283,29,312,603,51.74%,29.68%,1
雲林縣,大埤鄉,0483,236,213,449,76,525,1106,47.47%,21.34%,1
雲林縣,大埤鄉,0484,438,297,735,47,782,1495,52.31%,29.3%,1
雲林縣,大埤鄉,0485,188,132,320,38,358,600,59.67%,31.33%,1
雲林縣,大埤鄉,0486,312,218,530,67,597,1004,59.46%,31.08%,1
雲林縣,大埤鄉,0487,199,139,338,35,373,948,39.35%,20.99%,1
雲林縣,大埤鄉,0488,464,266,730,101,831,1539,54%,30.15%,1
雲林縣,大埤鄉,0489,371,237,608,81,689,1430,48.18%,25.94%,1
雲林縣,大埤鄉,0490,109,89,198,37,235,465,50.54%,23.44%,1
雲林縣,大埤鄉,0491,324,253,577,64,641,1307,49.04%,24.79%,1
雲林縣,大埤鄉,0492,107,104,211,30,241,474,50.84%,22.57%,1
雲林縣,大埤鄉,0493,354,262,616,106,722,1220,59.18%,29.02%,1
雲林縣,大埤鄉,0494,192,125,317,30,347,733,47.34%,26.19%,1
雲林縣,大埤鄉,0495,194,132,326,46,372,681,54.63%,28.49%,1
雲林縣,大埤鄉,0496,151,107,258,42,300,712,42.13%,21.21%,1
雲林縣,大埤鄉,0497,181,113,294,54,348,723,48.13%,25.03%,1
雲林縣,莿桐鄉,0374,418,332,750,101,851,1507,56.47%,27.74%,1
雲林縣,莿桐鄉,0375,405,250,655,50,705,1300,54.23%,31.15%,1
雲林縣,莿桐鄉,0376,392,249,641,106,747,1272,58.73%,30.82%,1
雲林縣,莿桐鄉,0377,191,173,364,94,458,861,53.19%,22.18%,1
雲林縣,莿桐鄉,0378,384,259,643,90,733,1565,46.84%,24.54%,1
雲林縣,莿桐鄉,0379,162,101,263,26,289,577,50.09%,28.08%,1
雲林縣,莿桐鄉,0380,144,110,254,46,300,636,47.17%,22.64%,1
雲林縣,莿桐鄉,0381,284,182,466,104,570,1110,51.35%,25.59%,1
雲林縣,莿桐鄉,0382,305,204,509,78,587,973,60.33%,31.35%,1
雲林縣,莿桐鄉,0383,275,188,463,85,548,985,55.63%,27.92%,1
雲林縣,莿桐鄉,0384,515,370,885,125,1010,1707,59.17%,30.17%,1
雲林縣,莿桐鄉,0385,332,279,611,107,718,1284,55.92%,25.86%,1
雲林縣,莿桐鄉,0386,378,285,663,74,737,1293,57%,29.23%,1
雲林縣,莿桐鄉,0387,270,166,436,74,510,900,56.67%,30%,1
雲林縣,莿桐鄉,0388,318,205,523,97,620,1040,59.62%,30.58%,1
雲林縣,莿桐鄉,0389,316,228,544,44,588,1165,50.47%,27.12%,1
雲林縣,莿桐鄉,0390,255,167,422,71,493,871,56.6%,29.28%,1
雲林縣,莿桐鄉,0391,285,178,463,72,535,885,60.45%,32.2%,1
雲林縣,莿桐鄉,0392,365,276,641,84,725,1489,48.69%,24.51%,1
雲林縣,莿桐鄉,0393,470,219,689,106,795,1347,59.02%,34.89%,1
雲林縣,莿桐鄉,0394,349,235,584,82,666,1150,57.91%,30.35%,1
雲林縣,莿桐鄉,0395,205,129,334,55,389,653,59.57%,31.39%,1
雲林縣,林內鄉,0396,333,242,575,81,656,1036,63.32%,32.14%,1
雲林縣,林內鄉,0397,452,311,763,73,836,1490,56.11%,30.34%,1
雲林縣,林內鄉,0398,436,272,708,96,804,1491,53.92%,29.24%,1
雲林縣,林內鄉,0399,181,106,287,68,355,671,52.91%,26.97%,1
雲林縣,林內鄉,0400,419,307,726,136,862,1436,60.03%,29.18%,1
雲林縣,林內鄉,0401,247,129,376,67,443,751,58.99%,32.89%,1
雲林縣,林內鄉,0402,149,109,258,34,292,535,54.58%,27.85%,1
雲林縣,林內鄉,0403,187,139,326,55,381,811,46.98%,23.06%,1
雲林縣,林內鄉,0404,388,250,638,129,767,1339,57.28%,28.98%,1
雲林縣,林內鄉,0405,359,233,592,79,671,1286,52.18%,27.92%,1
雲林縣,林內鄉,0406,187,132,319,39,358,646,55.42%,28.95%,1
雲林縣,林內鄉,0407,310,246,556,91,647,1158,55.87%,26.77%,1
雲林縣,林內鄉,0408,324,204,528,91,619,1090,56.79%,29.72%,1
雲林縣,林內鄉,0409,290,208,498,82,580,950,61.05%,30.53%,1
雲林縣,林內鄉,0410,220,176,396,51,447,861,51.92%,25.55%,1
雲林縣,二崙鄉,0317,324,275,599,52,651,1463,44.5%,22.15%,1
雲林縣,二崙鄉,0318,416,286,702,75,777,1738,44.71%,23.94%,1
雲林縣,二崙鄉,0319,150,100,250,54,304,625,48.64%,24%,1
雲林縣,二崙鄉,0320,265,166,431,75,506,1018,49.71%,26.03%,1
雲林縣,二崙鄉,0321,85,77,162,3,165,448,36.83%,18.97%,1
雲林縣,二崙鄉,0322,203,142,345,57,402,1048,38.36%,19.37%,1
雲林縣,二崙鄉,0323,315,231,546,86,632,1161,54.44%,27.13%,1
雲林縣,二崙鄉,0324,260,196,456,52,508,991,51.26%,26.24%,1
雲林縣,二崙鄉,0325,215,202,417,81,498,849,58.66%,25.32%,1
雲林縣,二崙鄉,0326,240,159,399,51,450,890,50.56%,26.97%,1
雲林縣,二崙鄉,0327,375,212,587,114,701,1427,49.12%,26.28%,1
雲林縣,二崙鄉,0328,232,148,380,39,419,891,47.03%,26.04%,1
雲林縣,二崙鄉,0329,166,109,275,41,316,757,41.74%,21.93%,1
雲林縣,二崙鄉,0330,357,242,599,132,731,1497,48.83%,23.85%,1
雲林縣,二崙鄉,0331,269,202,471,81,552,1171,47.14%,22.97%,1
雲林縣,二崙鄉,0332,197,131,328,75,403,686,58.75%,28.72%,1
雲林縣,二崙鄉,0333,185,113,298,88,386,864,44.68%,21.41%,1
雲林縣,二崙鄉,0334,324,192,516,99,615,1073,57.32%,30.2%,1
雲林縣,二崙鄉,0335,148,91,239,37,276,696,39.66%,21.26%,1
雲林縣,二崙鄉,0336,237,154,391,81,472,1271,37.14%,18.65%,1
雲林縣,二崙鄉,0337,205,137,342,63,405,912,44.41%,22.48%,1
雲林縣,二崙鄉,0338,190,146,336,47,383,861,44.48%,22.07%,1
雲林縣,二崙鄉,0339,219,164,383,67,450,1030,43.69%,21.26%,1
雲林縣,崙背鄉,0297,338,228,566,87,653,1176,55.53%,28.74%,1
雲林縣,崙背鄉,0298,381,246,627,73,700,1439,48.64%,26.48%,1
雲林縣,崙背鄉,0299,335,212,547,60,607,1027,59.1%,32.62%,1
雲林縣,崙背鄉,0300,392,247,639,55,694,1259,55.12%,31.14%,1
雲林縣,崙背鄉,0301,269,202,471,49,520,1058,49.15%,25.43%,1
雲林縣,崙背鄉,0302,243,163,406,40,446,998,44.69%,24.35%,1
雲林縣,崙背鄉,0303,260,164,424,30,454,968,46.9%,26.86%,1
雲林縣,崙背鄉,0304,296,204,500,56,556,1055,52.7%,28.06%,1
雲林縣,崙背鄉,0305,298,215,513,107,620,1315,47.15%,22.66%,1
雲林縣,崙背鄉,0306,155,135,290,37,327,1027,31.84%,15.09%,1
雲林縣,崙背鄉,0307,281,192,473,114,587,997,58.88%,28.18%,1
雲林縣,崙背鄉,0308,239,137,376,46,422,807,52.29%,29.62%,1
雲林縣,崙背鄉,0309,132,131,263,22,285,698,40.83%,18.91%,1
雲林縣,崙背鄉,0310,157,152,309,63,372,804,46.27%,19.53%,1
雲林縣,崙背鄉,0311,227,144,371,33,404,867,46.6%,26.18%,1
雲林縣,崙背鄉,0312,198,113,311,35,346,886,39.05%,22.35%,1
雲林縣,崙背鄉,0313,336,175,511,104,615,1476,41.67%,22.76%,1
雲林縣,崙背鄉,0314,190,134,324,48,372,1159,32.1%,16.39%,1
雲林縣,崙背鄉,0315,283,297,580,92,672,1220,55.08%,23.2%,1
雲林縣,崙背鄉,0316,206,151,357,54,411,814,50.49%,25.31%,1
雲林縣,麥寮鄉,0001,317,239,556,86,642,1497,42.89%,21.18%,1
雲林縣,麥寮鄉,0002,445,345,790,83,873,1738,50.23%,25.6%,1
雲林縣,麥寮鄉,0003,502,396,898,59,957,1921,49.82%,26.13%,1
雲林縣,麥寮鄉,0004,463,310,773,83,856,1832,46.72%,25.27%,1
雲林縣,麥寮鄉,0005,314,216,530,77,607,1340,45.3%,23.43%,1
雲林縣,麥寮鄉,0006,283,191,474,79,553,1138,48.59%,24.87%,1
雲林縣,麥寮鄉,0007,415,254,669,84,753,1551,48.55%,26.76%,1
雲林縣,麥寮鄉,0008,117,141,258,53,311,715,43.5%,16.36%,1
雲林縣,麥寮鄉,0009,250,199,449,45,494,1194,41.37%,20.94%,1
雲林縣,麥寮鄉,0010,270,177,447,41,488,1023,47.7%,26.39%,1
雲林縣,麥寮鄉,0011,315,217,532,60,592,1558,38%,20.22%,1
雲林縣,麥寮鄉,0012,238,189,427,47,474,1187,39.93%,20.05%,1
雲林縣,麥寮鄉,0013,231,144,375,45,420,983,42.73%,23.5%,1
雲林縣,麥寮鄉,0014,383,199,582,59,641,1363,47.03%,28.1%,1
雲林縣,麥寮鄉,0015,408,248,656,97,753,1596,47.18%,25.56%,1
雲林縣,麥寮鄉,0016,416,317,733,130,863,1469,58.75%,28.32%,1
雲林縣,麥寮鄉,0017,231,128,359,63,422,964,43.78%,23.96%,1
雲林縣,麥寮鄉,0018,216,156,372,60,432,1038,41.62%,20.81%,1
雲林縣,麥寮鄉,0019,339,203,542,78,620,1230,50.41%,27.56%,1
雲林縣,麥寮鄉,0020,349,223,572,66,638,1329,48.01%,26.26%,1
雲林縣,麥寮鄉,0021,299,193,492,112,604,1129,53.5%,26.48%,1
雲林縣,麥寮鄉,0022,347,221,568,128,696,1241,56.08%,27.96%,1
雲林縣,麥寮鄉,0023,433,257,690,111,801,1471,54.45%,29.44%,1
雲林縣,麥寮鄉,0024,289,234,523,102,625,1107,56.46%,26.11%,1
雲林縣,麥寮鄉,0025,473,332,805,97,902,1636,55.13%,28.91%,1
雲林縣,麥寮鄉,0026,488,270,758,78,836,1755,47.64%,27.81%,1
雲林縣,麥寮鄉,0027,367,177,544,56,600,1158,51.81%,31.69%,1
雲林縣,麥寮鄉,0028,285,177,462,51,513,956,53.66%,29.81%,1
雲林縣,東勢鄉,0051,286,183,469,74,543,1207,44.99%,23.7%,1
雲林縣,東勢鄉,0052,168,113,281,45,326,540,60.37%,31.11%,1
雲林縣,東勢鄉,0053,203,128,331,41,372,896,41.52%,22.66%,1
雲林縣,東勢鄉,0054,198,135,333,60,393,728,53.98%,27.2%,1
雲林縣,東勢鄉,0055,448,310,758,111,869,1533,56.69%,29.22%,1
雲林縣,東勢鄉,0056,362,245,607,108,715,1203,59.43%,30.09%,1
雲林縣,東勢鄉,0057,177,138,315,76,391,817,47.86%,21.66%,1
雲林縣,東勢鄉,0058,196,97,293,31,324,546,59.34%,35.9%,1
雲林縣,東勢鄉,0059,207,150,357,81,438,853,51.35%,24.27%,1
雲林縣,東勢鄉,0060,155,147,302,63,365,856,42.64%,18.11%,1
雲林縣,東勢鄉,0061,222,162,384,61,445,923,48.21%,24.05%,1
雲林縣,東勢鄉,0062,264,175,439,53,492,1022,48.14%,25.83%,1
雲林縣,東勢鄉,0063,135,74,209,32,241,634,38.01%,21.29%,1
雲林縣,東勢鄉,0064,94,49,143,23,166,394,42.13%,23.86%,1
雲林縣,東勢鄉,0065,210,144,354,62,416,1087,38.27%,19.32%,1
雲林縣,褒忠鄉,0066,256,177,433,83,516,923,55.9%,27.74%,1
雲林縣,褒忠鄉,0067,320,218,538,47,585,993,58.91%,32.23%,1
雲林縣,褒忠鄉,0068,210,139,349,40,389,748,52.01%,28.07%,1
雲林縣,褒忠鄉,0069,186,139,325,24,349,702,49.72%,26.5%,1
雲林縣,褒忠鄉,0070,218,123,341,30,371,752,49.34%,28.99%,1
雲林縣,褒忠鄉,0071,219,154,373,32,405,756,53.57%,28.97%,1
雲林縣,褒忠鄉,0072,154,79,233,21,254,490,51.84%,31.43%,1
雲林縣,褒忠鄉,0073,243,147,390,50,440,1034,42.55%,23.5%,1
雲林縣,褒忠鄉,0074,111,91,202,29,231,470,49.15%,23.62%,1
雲林縣,褒忠鄉,0075,189,147,336,42,378,737,51.29%,25.64%,1
雲林縣,褒忠鄉,0076,245,143,388,48,436,878,49.66%,27.9%,1
雲林縣,褒忠鄉,0077,215,124,339,51,390,778,50.13%,27.63%,1
雲林縣,褒忠鄉,0078,301,234,535,60,595,1224,48.61%,24.59%,1
雲林縣,褒忠鄉,0079,190,151,341,77,418,896,46.65%,21.21%,1
雲林縣,臺西鄉,0029,363,223,586,91,677,1238,54.68%,29.32%,1
雲林縣,臺西鄉,0030,276,174,450,63,513,1091,47.02%,25.3%,1
雲林縣,臺西鄉,0031,320,182,502,78,580,1098,52.82%,29.14%,1
雲林縣,臺西鄉,0032,239,153,392,47,439,1048,41.89%,22.81%,1
雲林縣,臺西鄉,0033,241,168,409,83,492,1025,48%,23.51%,1
雲林縣,臺西鄉,0034,235,141,376,54,430,850,50.59%,27.65%,1
雲林縣,臺西鄉,0035,341,214,555,86,641,1460,43.9%,23.36%,1
雲林縣,臺西鄉,0036,193,140,333,102,435,1180,36.86%,16.36%,1
雲林縣,臺西鄉,0037,127,75,202,34,236,710,33.24%,17.89%,1
雲林縣,臺西鄉,0038,123,84,207,16,223,620,35.97%,19.84%,1
雲林縣,臺西鄉,0039,104,71,175,38,213,449,47.44%,23.16%,1
雲林縣,臺西鄉,0040,119,92,211,67,278,687,40.47%,17.32%,1
雲林縣,臺西鄉,0041,290,188,478,83,561,1247,44.99%,23.26%,1
雲林縣,臺西鄉,0042,119,65,184,23,207,583,35.51%,20.41%,1
雲林縣,臺西鄉,0043,293,157,450,75,525,1042,50.38%,28.12%,1
雲林縣,臺西鄉,0044,126,64,190,30,220,472,46.61%,26.69%,1
雲林縣,臺西鄉,0045,346,159,505,42,547,1409,38.82%,24.56%,1
雲林縣,臺西鄉,0046,271,185,456,103,559,1061,52.69%,25.54%,1
雲林縣,臺西鄉,0047,211,148,359,44,403,993,40.58%,21.25%,1
雲林縣,臺西鄉,0048,248,153,401,91,492,1013,48.57%,24.48%,1
雲林縣,臺西鄉,0049,346,209,555,55,610,1233,49.47%,28.06%,1
雲林縣,臺西鄉,0050,139,96,235,29,264,616,42.86%,22.56%,1
雲林縣,元長鄉,0180,216,177,393,54,447,915,48.85%,23.61%,1
雲林縣,元長鄉,0181,321,202,523,49,572,1284,44.55%,25%,1
雲林縣,元長鄉,0182,273,196,469,55,524,1150,45.57%,23.74%,1
雲林縣,元長鄉,0183,165,97,262,61,323,744,43.41%,22.18%,1
雲林縣,元長鄉,0184,189,137,326,62,388,790,49.11%,23.92%,1
雲林縣,元長鄉,0185,216,242,458,98,556,1356,41%,15.93%,1
雲林縣,元長鄉,0186,189,110,299,57,356,739,48.17%,25.58%,1
雲林縣,元長鄉,0187,188,138,326,50,376,965,38.96%,19.48%,1
雲林縣,元長鄉,0188,211,164,375,89,464,1080,42.96%,19.54%,1
雲林縣,元長鄉,0189,182,144,326,53,379,948,39.98%,19.2%,1
雲林縣,元長鄉,0190,113,85,198,46,244,762,32.02%,14.83%,1
雲林縣,元長鄉,0191,139,104,243,25,268,582,46.05%,23.88%,1
雲林縣,元長鄉,0192,171,125,296,21,317,865,36.65%,19.77%,1
雲林縣,元長鄉,0193,42,25,67,9,76,362,20.99%,11.6%,1
雲林縣,元長鄉,0194,239,141,380,49,429,1162,36.92%,20.57%,1
雲林縣,元長鄉,0195,325,232,557,63,620,1527,40.6%,21.28%,1
雲林縣,元長鄉,0196,242,156,398,89,487,1006,48.41%,24.06%,1
雲林縣,元長鄉,0197,206,111,317,31,348,855,40.7%,24.09%,1
雲林縣,元長鄉,0198,276,189,465,93,558,1181,47.25%,23.37%,1
雲林縣,元長鄉,0199,183,126,309,50,359,864,41.55%,21.18%,1
雲林縣,元長鄉,0200,125,96,221,44,265,667,39.73%,18.74%,1
雲林縣,元長鄉,0201,183,117,300,43,343,878,39.07%,20.84%,1
雲林縣,元長鄉,0202,104,61,165,9,174,610,28.52%,17.05%,1
雲林縣,元長鄉,0203,172,135,307,88,395,837,47.19%,20.55%,1
雲林縣,元長鄉,0204,199,113,312,46,358,701,51.07%,28.39%,1
雲林縣,四湖鄉,0155,243,161,404,77,481,1082,44.45%,22.46%,1
雲林縣,四湖鄉,0156,196,120,316,52,368,676,54.44%,28.99%,1
雲林縣,四湖鄉,0157,223,184,407,34,441,862,51.16%,25.87%,1
雲林縣,四湖鄉,0158,94,45,139,26,165,477,34.59%,19.71%,1
雲林縣,四湖鄉,0159,221,236,457,47,504,952,52.94%,23.21%,1
雲林縣,四湖鄉,0160,138,86,224,24,248,650,38.15%,21.23%,1
雲林縣,四湖鄉,0161,231,152,383,30,413,969,42.62%,23.84%,1
雲林縣,四湖鄉,0162,174,140,314,58,372,925,40.22%,18.81%,1
雲林縣,四湖鄉,0163,233,125,358,34,392,914,42.89%,25.49%,1
雲林縣,四湖鄉,0164,114,65,179,61,240,759,31.62%,15.02%,1
雲林縣,四湖鄉,0165,228,159,387,63,450,1219,36.92%,18.7%,1
雲林縣,四湖鄉,0166,160,104,264,57,321,937,34.26%,17.08%,1
雲林縣,四湖鄉,0167,129,75,204,17,221,773,28.59%,16.69%,1
雲林縣,四湖鄉,0168,113,66,179,46,225,555,40.54%,20.36%,1
雲林縣,四湖鄉,0169,154,97,251,45,296,876,33.79%,17.58%,1
雲林縣,四湖鄉,0170,75,41,116,23,139,360,38.61%,20.83%,1
雲林縣,四湖鄉,0171,146,77,223,43,266,885,30.06%,16.5%,1
雲林縣,四湖鄉,0172,150,92,242,44,286,833,34.33%,18.01%,1
雲林縣,四湖鄉,0173,145,125,270,51,321,785,40.89%,18.47%,1
雲林縣,四湖鄉,0174,165,113,278,57,335,705,47.52%,23.4%,1
雲林縣,四湖鄉,0175,154,97,251,41,292,927,31.5%,16.61%,1
雲林縣,四湖鄉,0176,168,116,284,93,377,1058,35.63%,15.88%,1
雲林縣,四湖鄉,0177,181,156,337,67,404,1071,37.72%,16.9%,1
雲林縣,四湖鄉,0178,142,105,247,27,274,1022,26.81%,13.89%,1
雲林縣,四湖鄉,0179,131,104,235,43,278,711,39.1%,18.42%,1
雲林縣,口湖鄉,0205,300,215,515,73,588,1134,51.85%,26.46%,1
雲林縣,口湖鄉,0206,322,222,544,122,666,1225,54.37%,26.29%,1
雲林縣,口湖鄉,0207,139,83,222,51,273,647,42.19%,21.48%,1
雲林縣,口湖鄉,0208,198,113,311,28,339,709,47.81%,27.93%,1
雲林縣,口湖鄉,0209,190,148,338,88,426,900,47.33%,21.11%,1
雲林縣,口湖鄉,0210,245,168,413,83,496,1011,49.06%,24.23%,1
雲林縣,口湖鄉,0211,300,176,476,45,521,1437,36.26%,20.88%,1
雲林縣,口湖鄉,0212,132,110,242,13,255,848,30.07%,15.57%,1
雲林縣,口湖鄉,0213,244,166,410,51,461,1193,38.64%,20.45%,1
雲林縣,口湖鄉,0214,149,91,240,48,288,759,37.94%,19.63%,1
雲林縣,口湖鄉,0215,204,112,316,51,367,815,45.03%,25.03%,1
雲林縣,口湖鄉,0216,362,248,610,103,713,1460,48.84%,24.79%,1
雲林縣,口湖鄉,0217,86,69,155,13,168,556,30.22%,15.47%,1
雲林縣,口湖鄉,0218,486,117,603,87,690,1532,45.04%,31.72%,1
雲林縣,口湖鄉,0219,193,157,350,22,372,847,43.92%,22.79%,1
雲林縣,口湖鄉,0220,97,54,151,31,182,374,48.66%,25.94%,1
雲林縣,口湖鄉,0221,346,285,631,198,829,1508,54.97%,22.94%,1
雲林縣,口湖鄉,0222,268,167,435,89,524,951,55.1%,28.18%,1
雲林縣,口湖鄉,0223,251,179,430,100,530,910,58.24%,27.58%,1
雲林縣,口湖鄉,0224,274,178,452,54,506,879,57.57%,31.17%,1
雲林縣,口湖鄉,0225,289,164,453,137,590,1213,48.64%,23.83%,1
雲林縣,口湖鄉,0226,258,137,395,64,459,952,48.21%,27.1%,1
雲林縣,口湖鄉,0227,190,133,323,65,388,720,53.89%,26.39%,1
雲林縣,口湖鄉,0228,194,148,342,38,380,1006,37.77%,19.28%,1
雲林縣,口湖鄉,0229,111,88,199,14,213,607,35.09%,18.29%,1
雲林縣,水林鄉,0230,308,207,515,92,607,1355,44.8%,22.73%,1
雲林縣,水林鄉,0231,204,167,371,31,402,887,45.32%,23%,1
雲林縣,水林鄉,0232,340,242,582,78,660,1234,53.48%,27.55%,1
雲林縣,水林鄉,0233,183,155,338,19,357,763,46.79%,23.98%,1
雲林縣,水林鄉,0234,143,101,244,58,302,721,41.89%,19.83%,1
雲林縣,水林鄉,0235,126,84,210,16,226,647,34.93%,19.47%,1
雲林縣,水林鄉,0236,218,144,362,69,431,989,43.58%,22.04%,1
雲林縣,水林鄉,0237,174,99,273,35,308,837,36.8%,20.79%,1
雲林縣,水林鄉,0238,240,111,351,28,379,1081,35.06%,22.2%,1
雲林縣,水林鄉,0239,155,122,277,38,315,704,44.74%,22.02%,1
雲林縣,水林鄉,0240,253,146,399,92,491,1006,48.81%,25.15%,1
雲林縣,水林鄉,0241,136,107,243,18,261,651,40.09%,20.89%,1
雲林縣,水林鄉,0242,135,80,215,24,239,607,39.37%,22.24%,1
雲林縣,水林鄉,0243,210,141,351,79,430,1033,41.63%,20.33%,1
雲林縣,水林鄉,0244,118,66,184,15,199,631,31.54%,18.7%,1
雲林縣,水林鄉,0245,212,113,325,80,405,961,42.14%,22.06%,1
雲林縣,水林鄉,0246,200,130,330,92,422,951,44.37%,21.03%,1
雲林縣,水林鄉,0247,190,130,320,44,364,838,43.44%,22.67%,1
雲林縣,水林鄉,0248,236,160,396,104,500,1055,47.39%,22.37%,1
雲林縣,水林鄉,0249,89,52,141,31,172,512,33.59%,17.38%,1
雲林縣,水林鄉,0250,128,87,215,21,236,671,35.17%,19.08%,1
雲林縣,水林鄉,0251,90,81,171,40,211,693,30.45%,12.99%,1
雲林縣,水林鄉,0252,109,77,186,53,239,689,34.69%,15.82%,1
雲林縣,水林鄉,0253,233,172,405,88,493,1022,48.24%,22.8%,1
雲林縣,水林鄉,0254,259,167,426,51,477,1191,40.05%,21.75%,1
雲林縣,水林鄉,0255,219,144,363,50,413,779,53.02%,28.11%,1
嘉義縣,太保市,0001,335,259,594,85,679,1210,56.12%,27.69%,1
嘉義縣,太保市,0002,319,213,532,44,576,1076,53.53%,29.65%,1
嘉義縣,太保市,0003,138,66,204,30,234,488,47.95%,28.28%,1
嘉義縣,太保市,0004,334,304,638,78,716,1475,48.54%,22.64%,1
嘉義縣,太保市,0005,192,129,321,37,358,790,45.32%,24.3%,1
嘉義縣,太保市,0006,232,156,388,53,441,883,49.94%,26.27%,1
嘉義縣,太保市,0007,197,131,328,56,384,758,50.66%,25.99%,1
嘉義縣,太保市,0008,102,49,151,7,158,389,40.62%,26.22%,1
嘉義縣,太保市,0009,245,208,453,59,512,1101,46.5%,22.25%,1
嘉義縣,太保市,0010,237,163,400,20,420,853,49.24%,27.78%,1
嘉義縣,太保市,0011,44,33,77,15,92,224,41.07%,19.64%,1
嘉義縣,太保市,0012,167,88,255,64,319,662,48.19%,25.23%,1
嘉義縣,太保市,0013,592,320,912,49,961,1630,58.96%,36.32%,1
嘉義縣,太保市,0014,217,175,392,32,424,913,46.44%,23.77%,1
嘉義縣,太保市,0015,246,167,413,20,433,779,55.58%,31.58%,1
嘉義縣,太保市,0016,335,258,593,112,705,1278,55.16%,26.21%,1
嘉義縣,太保市,0017,218,138,356,34,390,819,47.62%,26.62%,1
嘉義縣,太保市,0018,441,296,737,43,780,1573,49.59%,28.04%,1
嘉義縣,太保市,0019,123,105,228,32,260,481,54.05%,25.57%,1
嘉義縣,太保市,0020,87,49,136,6,142,245,57.96%,35.51%,1
嘉義縣,太保市,0021,84,68,152,19,171,317,53.94%,26.5%,1
嘉義縣,太保市,0022,63,46,109,7,116,258,44.96%,24.42%,1
嘉義縣,太保市,0023,177,95,272,61,333,611,54.5%,28.97%,1
嘉義縣,太保市,0024,446,331,777,64,841,1526,55.11%,29.23%,1
嘉義縣,太保市,0025,358,262,620,36,656,1196,54.85%,29.93%,1
嘉義縣,太保市,0026,403,325,728,111,839,1536,54.62%,26.24%,1
嘉義縣,太保市,0027,428,315,743,79,822,1481,55.5%,28.9%,1
嘉義縣,太保市,0028,457,276,733,58,791,1450,54.55%,31.52%,1
嘉義縣,太保市,0029,214,151,365,26,391,840,46.55%,25.48%,1
嘉義縣,太保市,0030,290,190,480,29,509,989,51.47%,29.32%,1
嘉義縣,太保市,0031,436,320,756,110,866,1529,56.64%,28.52%,1
嘉義縣,太保市,0032,458,306,764,84,848,1511,56.12%,30.31%,1
嘉義縣,太保市,0033,163,114,277,50,327,697,46.92%,23.39%,1
嘉義縣,朴子市,0233,359,229,588,54,642,1183,54.27%,30.35%,1
嘉義縣,朴子市,0234,216,154,370,44,414,755,54.83%,28.61%,1
嘉義縣,朴子市,0235,374,258,632,42,674,1253,53.79%,29.85%,1
嘉義縣,朴子市,0236,256,326,582,65,647,1078,60.02%,23.75%,1
嘉義縣,朴子市,0237,318,280,598,87,685,1117,61.32%,28.47%,1
嘉義縣,朴子市,0238,125,85,210,20,230,387,59.43%,32.3%,1
嘉義縣,朴子市,0239,172,143,315,44,359,633,56.71%,27.17%,1
嘉義縣,朴子市,0240,190,137,327,38,365,650,56.15%,29.23%,1
嘉義縣,朴子市,0241,272,180,452,66,518,825,62.79%,32.97%,1
嘉義縣,朴子市,0242,249,146,395,52,447,810,55.19%,30.74%,1
嘉義縣,朴子市,0243,318,179,497,53,550,940,58.51%,33.83%,1
嘉義縣,朴子市,0244,233,183,416,62,478,905,52.82%,25.75%,1
嘉義縣,朴子市,0245,387,321,708,59,767,1605,47.79%,24.11%,1
嘉義縣,朴子市,0246,469,314,783,65,848,1479,57.34%,31.71%,1
嘉義縣,朴子市,0247,377,258,635,65,700,1218,57.47%,30.95%,1
嘉義縣,朴子市,0248,463,319,782,75,857,1496,57.29%,30.95%,1
嘉義縣,朴子市,0249,177,132,309,49,358,667,53.67%,26.54%,1
嘉義縣,朴子市,0250,118,98,216,31,247,627,39.39%,18.82%,1
嘉義縣,朴子市,0251,206,130,336,61,397,791,50.19%,26.04%,1
嘉義縣,朴子市,0252,286,180,466,107,573,1034,55.42%,27.66%,1
嘉義縣,朴子市,0253,448,317,765,35,800,1710,46.78%,26.2%,1
嘉義縣,朴子市,0254,420,292,712,61,773,1671,46.26%,25.13%,1
嘉義縣,朴子市,0255,338,225,563,56,619,1547,40.01%,21.85%,1
嘉義縣,朴子市,0256,304,265,569,77,646,1602,40.32%,18.98%,1
嘉義縣,朴子市,0257,435,264,699,40,739,1302,56.76%,33.41%,1
嘉義縣,朴子市,0258,198,122,320,57,377,740,50.95%,26.76%,1
嘉義縣,朴子市,0259,343,203,546,72,618,1054,58.63%,32.54%,1
嘉義縣,朴子市,0260,185,140,325,21,346,907,38.15%,20.4%,1
嘉義縣,朴子市,0261,158,118,276,32,308,720,42.78%,21.94%,1
嘉義縣,朴子市,0262,69,46,115,31,146,251,58.17%,27.49%,1
嘉義縣,朴子市,0263,163,122,285,49,334,767,43.55%,21.25%,1
嘉義縣,朴子市,0264,198,148,346,43,389,702,55.41%,28.21%,1
嘉義縣,朴子市,0265,247,174,421,64,485,1038,46.72%,23.8%,1
嘉義縣,朴子市,0266,218,146,364,30,394,1228,32.08%,17.75%,1
嘉義縣,朴子市,0267,118,83,201,56,257,499,51.5%,23.65%,1
嘉義縣,布袋鎮,0325,165,96,261,37,298,614,48.53%,26.87%,1
嘉義縣,布袋鎮,0326,92,58,150,18,168,372,45.16%,24.73%,1
嘉義縣,布袋鎮,0327,244,160,404,101,505,914,55.25%,26.7%,1
嘉義縣,布袋鎮,0328,320,209,529,105,634,1198,52.92%,26.71%,1
嘉義縣,布袋鎮,0329,277,170,447,78,525,1113,47.17%,24.89%,1
嘉義縣,布袋鎮,0330,292,176,468,67,535,992,53.93%,29.44%,1
嘉義縣,布袋鎮,0331,196,123,319,15,334,689,48.48%,28.45%,1
嘉義縣,布袋鎮,0332,215,166,381,82,463,882,52.49%,24.38%,1
嘉義縣,布袋鎮,0333,203,129,332,47,379,731,51.85%,27.77%,1
嘉義縣,布袋鎮,0334,252,124,376,41,417,779,53.53%,32.35%,1
嘉義縣,布袋鎮,0335,182,120,302,39,341,762,44.75%,23.88%,1
嘉義縣,布袋鎮,0336,289,170,459,66,525,1184,44.34%,24.41%,1
嘉義縣,布袋鎮,0337,286,199,485,76,561,1423,39.42%,20.1%,1
嘉義縣,布袋鎮,0338,302,169,471,63,534,1351,39.53%,22.35%,1
嘉義縣,布袋鎮,0339,57,41,98,7,105,275,38.18%,20.73%,1
嘉義縣,布袋鎮,0340,48,46,94,16,110,243,45.27%,19.75%,1
嘉義縣,布袋鎮,0341,151,122,273,90,363,661,54.92%,22.84%,1
嘉義縣,布袋鎮,0342,301,178,479,55,534,1145,46.64%,26.29%,1
嘉義縣,布袋鎮,0343,217,172,389,34,423,936,45.19%,23.18%,1
嘉義縣,布袋鎮,0344,227,179,406,48,454,958,47.39%,23.7%,1
嘉義縣,布袋鎮,0345,65,51,116,17,133,298,44.63%,21.81%,1
嘉義縣,布袋鎮,0346,136,72,208,36,244,428,57.01%,31.78%,1
嘉義縣,布袋鎮,0347,33,16,49,3,52,121,42.98%,27.27%,1
嘉義縣,布袋鎮,0348,27,19,46,4,50,174,28.74%,15.52%,1
嘉義縣,布袋鎮,0349,229,158,387,64,451,953,47.32%,24.03%,1
嘉義縣,布袋鎮,0350,374,243,617,75,692,1292,53.56%,28.95%,1
嘉義縣,布袋鎮,0351,435,97,532,69,601,1127,53.33%,38.6%,1
嘉義縣,布袋鎮,0352,330,203,533,52,585,1244,47.03%,26.53%,1
嘉義縣,布袋鎮,0353,257,193,450,28,478,1106,43.22%,23.24%,1
嘉義縣,大林鎮,0169,119,112,231,33,264,483,54.66%,24.64%,1
嘉義縣,大林鎮,0170,530,413,943,77,1020,1823,55.95%,29.07%,1
嘉義縣,大林鎮,0171,271,214,485,25,510,955,53.4%,28.38%,1
嘉義縣,大林鎮,0172,372,299,671,51,722,1436,50.28%,25.91%,1
嘉義縣,大林鎮,0173,372,305,677,75,752,1390,54.1%,26.76%,1
嘉義縣,大林鎮,0174,454,317,771,78,849,1512,56.15%,30.03%,1
嘉義縣,大林鎮,0175,459,335,794,70,864,1536,56.25%,29.88%,1
嘉義縣,大林鎮,0176,297,192,489,56,545,1165,46.78%,25.49%,1
嘉義縣,大林鎮,0177,557,375,932,78,1010,1730,58.38%,32.2%,1
嘉義縣,大林鎮,0178,113,113,226,19,245,602,40.7%,18.77%,1
嘉義縣,大林鎮,0179,154,138,292,65,357,716,49.86%,21.51%,1
嘉義縣,大林鎮,0180,102,100,202,11,213,625,34.08%,16.32%,1
嘉義縣,大林鎮,0181,38,29,67,2,69,193,35.75%,19.69%,1
嘉義縣,大林鎮,0182,389,281,670,77,747,1642,45.49%,23.69%,1
嘉義縣,大林鎮,0183,387,291,678,82,760,1465,51.88%,26.42%,1
嘉義縣,大林鎮,0184,211,160,371,40,411,928,44.29%,22.74%,1
嘉義縣,大林鎮,0185,84,50,134,25,159,361,44.04%,23.27%,1
嘉義縣,大林鎮,0186,200,135,335,20,355,814,43.61%,24.57%,1
嘉義縣,大林鎮,0187,398,286,684,44,728,1579,46.11%,25.21%,1
嘉義縣,大林鎮,0188,558,376,934,106,1040,2041,50.96%,27.34%,1
嘉義縣,大林鎮,0189,248,172,420,55,475,931,51.02%,26.64%,1
嘉義縣,大林鎮,0190,185,114,299,46,345,675,51.11%,27.41%,1
嘉義縣,大林鎮,0191,168,116,284,33,317,655,48.4%,25.65%,1
嘉義縣,大林鎮,0192,217,141,358,52,410,833,49.22%,26.05%,1
嘉義縣,大林鎮,0193,240,205,445,55,500,832,60.1%,28.85%,1
嘉義縣,民雄鄉,0093,360,308,668,66,734,1267,57.93%,28.41%,1
嘉義縣,民雄鄉,0094,284,198,482,42,524,1030,50.87%,27.57%,1
嘉義縣,民雄鄉,0095,472,351,823,119,942,1590,59.25%,29.69%,1
嘉義縣,民雄鄉,0096,463,318,781,52,833,1673,49.79%,27.67%,1
嘉義縣,民雄鄉,0097,484,407,891,87,978,1718,56.93%,28.17%,1
嘉義縣,民雄鄉,0098,325,215,540,74,614,1040,59.04%,31.25%,1
嘉義縣,民雄鄉,0099,307,219,526,71,597,1100,54.27%,27.91%,1
嘉義縣,民雄鄉,0100,406,305,711,89,800,1559,51.31%,26.04%,1
嘉義縣,民雄鄉,0101,497,355,852,86,938,1862,50.38%,26.69%,1
嘉義縣,民雄鄉,0102,409,312,721,88,809,1435,56.38%,28.5%,1
嘉義縣,民雄鄉,0103,409,129,538,379,917,1751,52.37%,23.36%,1
嘉義縣,民雄鄉,0104,268,191,459,67,526,933,56.38%,28.72%,1
嘉義縣,民雄鄉,0105,225,237,462,55,517,827,62.52%,27.21%,1
嘉義縣,民雄鄉,0106,190,145,335,59,394,843,46.74%,22.54%,1
嘉義縣,民雄鄉,0107,482,358,840,97,937,1774,52.82%,27.17%,1
嘉義縣,民雄鄉,0108,86,70,156,26,182,385,47.27%,22.34%,1
嘉義縣,民雄鄉,0109,400,297,697,46,743,1306,56.89%,30.63%,1
嘉義縣,民雄鄉,0110,151,113,264,56,320,535,59.81%,28.22%,1
嘉義縣,民雄鄉,0111,305,221,526,90,616,1055,58.39%,28.91%,1
嘉義縣,民雄鄉,0112,424,316,740,58,798,1476,54.07%,28.73%,1
嘉義縣,民雄鄉,0113,443,278,721,74,795,1583,50.22%,27.98%,1
嘉義縣,民雄鄉,0114,191,117,308,36,344,758,45.38%,25.2%,1
嘉義縣,民雄鄉,0115,358,262,620,54,674,1354,49.78%,26.44%,1
嘉義縣,民雄鄉,0116,305,261,566,117,683,1202,56.82%,25.37%,1
嘉義縣,民雄鄉,0117,335,254,589,57,646,1175,54.98%,28.51%,1
嘉義縣,民雄鄉,0118,386,287,673,56,729,1423,51.23%,27.13%,1
嘉義縣,民雄鄉,0119,492,293,785,62,847,1612,52.54%,30.52%,1
嘉義縣,民雄鄉,0120,521,357,878,47,925,1695,54.57%,30.74%,1
嘉義縣,民雄鄉,0121,400,299,699,54,753,1665,45.23%,24.02%,1
嘉義縣,民雄鄉,0122,260,163,423,68,491,1019,48.18%,25.52%,1
嘉義縣,民雄鄉,0123,351,274,625,80,705,1352,52.14%,25.96%,1
嘉義縣,民雄鄉,0124,472,334,806,87,893,1620,55.12%,29.14%,1
嘉義縣,民雄鄉,0125,254,165,419,53,472,943,50.05%,26.94%,1
嘉義縣,民雄鄉,0126,391,331,722,75,797,1720,46.34%,22.73%,1
嘉義縣,民雄鄉,0127,478,371,849,109,958,1875,51.09%,25.49%,1
嘉義縣,民雄鄉,0128,398,260,658,73,731,1305,56.02%,30.5%,1
嘉義縣,民雄鄉,0129,365,293,658,80,738,1441,51.21%,25.33%,1
嘉義縣,民雄鄉,0130,384,289,673,83,756,1413,53.5%,27.18%,1
嘉義縣,民雄鄉,0131,425,300,725,93,818,1560,52.44%,27.24%,1
嘉義縣,民雄鄉,0132,558,426,984,129,1113,2004,55.54%,27.84%,1
嘉義縣,民雄鄉,0133,440,278,718,80,798,1354,58.94%,32.5%,1
嘉義縣,民雄鄉,0134,298,245,543,55,598,1076,55.58%,27.7%,1
嘉義縣,民雄鄉,0135,408,348,756,157,913,1629,56.05%,25.05%,1
嘉義縣,民雄鄉,0136,499,409,908,94,1002,1977,50.68%,25.24%,1
嘉義縣,民雄鄉,0137,299,280,579,103,682,1295,52.66%,23.09%,1
嘉義縣,溪口鄉,0194,365,270,635,115,750,1318,56.9%,27.69%,1
嘉義縣,溪口鄉,0195,215,130,345,48,393,677,58.05%,31.76%,1
嘉義縣,溪口鄉,0196,98,80,178,20,198,417,47.48%,23.5%,1
嘉義縣,溪口鄉,0197,72,60,132,14,146,273,53.48%,26.37%,1
嘉義縣,溪口鄉,0198,277,177,454,73,527,908,58.04%,30.51%,1
嘉義縣,溪口鄉,0199,90,59,149,13,162,386,41.97%,23.32%,1
嘉義縣,溪口鄉,0200,277,235,512,65,577,1039,55.53%,26.66%,1
嘉義縣,溪口鄉,0201,161,122,283,48,331,708,46.75%,22.74%,1
嘉義縣,溪口鄉,0202,216,165,381,18,399,909,43.89%,23.76%,1
嘉義縣,溪口鄉,0203,146,233,379,52,431,786,54.83%,18.58%,1
嘉義縣,溪口鄉,0204,196,138,334,50,384,807,47.58%,24.29%,1
嘉義縣,溪口鄉,0205,261,152,413,27,440,1168,37.67%,22.35%,1
嘉義縣,溪口鄉,0206,275,230,505,81,586,1052,55.7%,26.14%,1
嘉義縣,溪口鄉,0207,129,102,231,54,285,565,50.44%,22.83%,1
嘉義縣,溪口鄉,0208,121,53,174,31,205,388,52.84%,31.19%,1
嘉義縣,溪口鄉,0209,155,104,259,26,285,701,40.66%,22.11%,1
嘉義縣,溪口鄉,0210,206,154,360,50,410,1003,40.88%,20.54%,1
嘉義縣,新港鄉,0138,313,212,525,43,568,1087,52.25%,28.79%,1
嘉義縣,新港鄉,0139,403,253,656,78,734,1116,65.77%,36.11%,1
嘉義縣,新港鄉,0140,201,152,353,58,411,740,55.54%,27.16%,1
嘉義縣,新港鄉,0141,185,174,359,79,438,827,52.96%,22.37%,1
嘉義縣,新港鄉,0142,225,151,376,55,431,704,61.22%,31.96%,1
嘉義縣,新港鄉,0143,226,186,412,60,472,768,61.46%,29.43%,1
嘉義縣,新港鄉,0144,222,183,405,50,455,761,59.79%,29.17%,1
嘉義縣,新港鄉,0145,211,149,360,71,431,850,50.71%,24.82%,1
嘉義縣,新港鄉,0146,345,266,611,89,700,1327,52.75%,26%,1
嘉義縣,新港鄉,0147,208,151,359,60,419,756,55.42%,27.51%,1
嘉義縣,新港鄉,0148,233,135,368,94,462,816,56.62%,28.55%,1
嘉義縣,新港鄉,0149,162,97,259,47,306,667,45.88%,24.29%,1
嘉義縣,新港鄉,0150,249,171,420,63,483,942,51.27%,26.43%,1
嘉義縣,新港鄉,0151,210,151,361,77,438,918,47.71%,22.88%,1
嘉義縣,新港鄉,0152,133,70,203,17,220,554,39.71%,24.01%,1
嘉義縣,新港鄉,0153,233,149,382,59,441,929,47.47%,25.08%,1
嘉義縣,新港鄉,0154,85,70,155,49,204,487,41.89%,17.45%,1
嘉義縣,新港鄉,0155,133,83,216,53,269,487,55.24%,27.31%,1
嘉義縣,新港鄉,0156,174,167,341,58,399,836,47.73%,20.81%,1
嘉義縣,新港鄉,0157,202,180,382,82,464,845,54.91%,23.91%,1
嘉義縣,新港鄉,0158,235,151,386,67,453,834,54.32%,28.18%,1
嘉義縣,新港鄉,0159,219,149,368,57,425,753,56.44%,29.08%,1
嘉義縣,新港鄉,0160,322,298,620,82,702,1328,52.86%,24.25%,1
嘉義縣,新港鄉,0161,282,212,494,62,556,969,57.38%,29.1%,1
嘉義縣,新港鄉,0162,309,218,527,90,617,1043,59.16%,29.63%,1
嘉義縣,新港鄉,0163,453,305,758,83,841,1400,60.07%,32.36%,1
嘉義縣,新港鄉,0164,183,118,301,39,340,1017,33.43%,17.99%,1
嘉義縣,新港鄉,0165,281,173,454,60,514,1132,45.41%,24.82%,1
嘉義縣,新港鄉,0166,273,181,454,84,538,1037,51.88%,26.33%,1
嘉義縣,新港鄉,0167,146,123,269,62,331,563,58.79%,25.93%,1
嘉義縣,新港鄉,0168,230,157,387,22,409,849,48.17%,27.09%,1
嘉義縣,六腳鄉,0268,268,173,441,46,487,1165,41.8%,23%,1
嘉義縣,六腳鄉,0269,158,84,242,26,268,825,32.48%,19.15%,1
嘉義縣,六腳鄉,0270,189,136,325,37,362,850,42.59%,22.24%,1
嘉義縣,六腳鄉,0271,52,55,107,24,131,222,59.01%,23.42%,1
嘉義縣,六腳鄉,0272,242,275,517,73,590,1216,48.52%,19.9%,1
嘉義縣,六腳鄉,0273,235,149,384,58,442,1200,36.83%,19.58%,1
嘉義縣,六腳鄉,0274,227,128,355,54,409,877,46.64%,25.88%,1
嘉義縣,六腳鄉,0275,138,88,226,48,274,644,42.55%,21.43%,1
嘉義縣,六腳鄉,0276,111,72,183,26,209,594,35.19%,18.69%,1
嘉義縣,六腳鄉,0277,26,14,40,1,41,167,24.55%,15.57%,1
嘉義縣,六腳鄉,0278,27,40,67,2,69,204,33.82%,13.24%,1
嘉義縣,六腳鄉,0279,32,50,82,7,89,234,38.03%,13.68%,1
嘉義縣,六腳鄉,0280,76,39,115,11,126,361,34.9%,21.05%,1
嘉義縣,六腳鄉,0281,155,104,259,69,328,592,55.41%,26.18%,1
嘉義縣,六腳鄉,0282,153,106,259,49,308,619,49.76%,24.72%,1
嘉義縣,六腳鄉,0283,141,79,220,53,273,714,38.24%,19.75%,1
嘉義縣,六腳鄉,0284,248,179,427,65,492,1051,46.81%,23.6%,1
嘉義縣,六腳鄉,0285,236,167,403,79,482,934,51.61%,25.27%,1
嘉義縣,六腳鄉,0286,273,173,446,66,512,1044,49.04%,26.15%,1
嘉義縣,六腳鄉,0287,318,227,545,38,583,1476,39.5%,21.54%,1
嘉義縣,六腳鄉,0288,115,73,188,26,214,618,34.63%,18.61%,1
嘉義縣,六腳鄉,0289,80,35,115,47,162,478,33.89%,16.74%,1
嘉義縣,六腳鄉,0290,105,82,187,45,232,642,36.14%,16.36%,1
嘉義縣,六腳鄉,0291,138,103,241,19,260,883,29.45%,15.63%,1
嘉義縣,六腳鄉,0292,131,66,197,8,205,739,27.74%,17.73%,1
嘉義縣,六腳鄉,0293,102,80,182,33,215,554,38.81%,18.41%,1
嘉義縣,六腳鄉,0294,97,83,180,23,203,649,31.28%,14.95%,1
嘉義縣,六腳鄉,0295,145,64,209,23,232,689,33.67%,21.04%,1
嘉義縣,六腳鄉,0296,81,67,148,24,172,455,37.8%,17.8%,1
嘉義縣,六腳鄉,0297,12,19,31,6,37,125,29.6%,9.6%,1
嘉義縣,東石鄉,0298,398,294,692,119,811,1915,42.35%,20.78%,1
嘉義縣,東石鄉,0299,185,122,307,63,370,938,39.45%,19.72%,1
嘉義縣,東石鄉,0300,184,161,345,36,381,1366,27.89%,13.47%,1
嘉義縣,東石鄉,0301,347,216,563,6,569,1676,33.95%,20.7%,1
嘉義縣,東石鄉,0302,224,144,368,97,465,1151,40.4%,19.46%,1
嘉義縣,東石鄉,0303,142,93,235,86,321,716,44.83%,19.83%,1
嘉義縣,東石鄉,0304,61,49,110,13,123,387,31.78%,15.76%,1
嘉義縣,東石鄉,0305,141,77,218,15,233,864,26.97%,16.32%,1
嘉義縣,東石鄉,0306,143,113,256,24,280,910,30.77%,15.71%,1
嘉義縣,東石鄉,0307,140,80,220,18,238,760,31.32%,18.42%,1
嘉義縣,東石鄉,0308,44,27,71,15,86,166,51.81%,26.51%,1
嘉義縣,東石鄉,0309,32,28,60,17,77,212,36.32%,15.09%,1
嘉義縣,東石鄉,0310,176,106,282,50,332,993,33.43%,17.72%,1
嘉義縣,東石鄉,0311,72,27,99,13,112,306,36.6%,23.53%,1
嘉義縣,東石鄉,0312,189,123,312,99,411,1046,39.29%,18.07%,1
嘉義縣,東石鄉,0313,40,25,65,25,90,235,38.3%,17.02%,1
嘉義縣,東石鄉,0314,267,184,451,104,555,1226,45.27%,21.78%,1
嘉義縣,東石鄉,0315,172,126,298,66,364,843,43.18%,20.4%,1
嘉義縣,東石鄉,0316,149,97,246,38,284,693,40.98%,21.5%,1
嘉義縣,東石鄉,0317,198,147,345,67,412,839,49.11%,23.6%,1
嘉義縣,東石鄉,0318,86,43,129,18,147,363,40.5%,23.69%,1
嘉義縣,東石鄉,0319,71,27,98,11,109,321,33.96%,22.12%,1
嘉義縣,東石鄉,0320,337,194,531,66,597,1083,55.12%,31.12%,1
嘉義縣,東石鄉,0321,209,138,347,65,412,901,45.73%,23.2%,1
嘉義縣,東石鄉,0322,196,129,325,40,365,1216,30.02%,16.12%,1
嘉義縣,東石鄉,0323,117,86,203,46,249,418,59.57%,27.99%,1
嘉義縣,東石鄉,0324,82,58,140,15,155,371,41.78%,22.1%,1
嘉義縣,義竹鄉,0354,120,80,200,28,228,482,47.3%,24.9%,1
嘉義縣,義竹鄉,0355,66,42,108,22,130,223,58.3%,29.6%,1
嘉義縣,義竹鄉,0356,452,272,724,94,818,1529,53.5%,29.56%,1
嘉義縣,義竹鄉,0357,368,213,581,73,654,1175,55.66%,31.32%,1
嘉義縣,義竹鄉,0358,284,201,485,59,544,886,61.4%,32.05%,1
嘉義縣,義竹鄉,0359,173,116,289,46,335,743,45.09%,23.28%,1
嘉義縣,義竹鄉,0360,362,221,583,92,675,1236,54.61%,29.29%,1
嘉義縣,義竹鄉,0361,105,64,169,25,194,377,51.46%,27.85%,1
嘉義縣,義竹鄉,0362,80,52,132,21,153,338,45.27%,23.67%,1
嘉義縣,義竹鄉,0363,38,17,55,4,59,102,57.84%,37.25%,1
嘉義縣,義竹鄉,0364,181,118,299,35,334,763,43.77%,23.72%,1
嘉義縣,義竹鄉,0365,118,85,203,36,239,429,55.71%,27.51%,1
嘉義縣,義竹鄉,0366,110,73,183,24,207,427,48.48%,25.76%,1
嘉義縣,義竹鄉,0367,159,125,284,46,330,607,54.37%,26.19%,1
嘉義縣,義竹鄉,0368,364,253,617,51,668,1486,44.95%,24.5%,1
嘉義縣,義竹鄉,0369,245,139,384,92,476,835,57.01%,29.34%,1
嘉義縣,義竹鄉,0370,171,106,277,77,354,816,43.38%,20.96%,1
嘉義縣,義竹鄉,0371,194,119,313,68,381,833,45.74%,23.29%,1
嘉義縣,義竹鄉,0372,93,87,180,31,211,433,48.73%,21.48%,1
嘉義縣,義竹鄉,0373,151,80,231,8,239,558,42.83%,27.06%,1
嘉義縣,義竹鄉,0374,149,112,261,52,313,602,51.99%,24.75%,1
嘉義縣,義竹鄉,0375,33,17,50,2,52,140,37.14%,23.57%,1
嘉義縣,義竹鄉,0376,97,51,148,30,178,393,45.29%,24.68%,1
嘉義縣,義竹鄉,0377,153,111,264,23,287,585,49.06%,26.15%,1
嘉義縣,義竹鄉,0378,96,58,154,12,166,526,31.56%,18.25%,1
嘉義縣,義竹鄉,0379,29,33,62,9,71,123,57.72%,23.58%,1
嘉義縣,鹿草鄉,0034,110,83,193,48,241,522,46.17%,21.07%,1
嘉義縣,鹿草鄉,0035,163,93,256,43,299,563,53.11%,28.95%,1
嘉義縣,鹿草鄉,0036,327,216,543,94,637,1304,48.85%,25.08%,1
嘉義縣,鹿草鄉,0037,355,236,591,72,663,1312,50.53%,27.06%,1
嘉義縣,鹿草鄉,0038,79,46,125,4,129,320,40.31%,24.69%,1
嘉義縣,鹿草鄉,0039,61,44,105,5,110,418,26.32%,14.59%,1
嘉義縣,鹿草鄉,0040,235,137,372,71,443,1025,43.22%,22.93%,1
嘉義縣,鹿草鄉,0041,95,69,164,22,186,451,41.24%,21.06%,1
嘉義縣,鹿草鄉,0042,206,134,340,102,442,830,53.25%,24.82%,1
嘉義縣,鹿草鄉,0043,219,185,404,86,490,1050,46.67%,20.86%,1
嘉義縣,鹿草鄉,0044,183,147,330,70,400,972,41.15%,18.83%,1
嘉義縣,鹿草鄉,0045,245,145,390,54,444,962,46.15%,25.47%,1
嘉義縣,鹿草鄉,0046,166,131,297,55,352,678,51.92%,24.48%,1
嘉義縣,鹿草鄉,0047,58,57,115,22,137,262,52.29%,22.14%,1
嘉義縣,鹿草鄉,0048,174,155,329,62,391,906,43.16%,19.21%,1
嘉義縣,鹿草鄉,0049,54,40,94,13,107,306,34.97%,17.65%,1
嘉義縣,鹿草鄉,0050,287,182,469,83,552,1062,51.98%,27.02%,1
嘉義縣,鹿草鄉,0051,96,76,172,29,201,373,53.89%,25.74%,1
嘉義縣,鹿草鄉,0052,90,54,144,31,175,324,54.01%,27.78%,1
嘉義縣,鹿草鄉,0053,79,50,129,18,147,297,49.49%,26.6%,1
嘉義縣,水上鄉,0054,257,197,454,44,498,1024,48.63%,25.1%,1
嘉義縣,水上鄉,0055,292,249,541,72,613,1015,60.39%,28.77%,1
嘉義縣,水上鄉,0056,501,339,840,103,943,1932,48.81%,25.93%,1
嘉義縣,水上鄉,0057,476,153,629,51,680,1170,58.12%,40.68%,1
嘉義縣,水上鄉,0058,393,296,689,76,765,1305,58.62%,30.11%,1
嘉義縣,水上鄉,0059,327,218,545,74,619,1242,49.84%,26.33%,1
嘉義縣,水上鄉,0060,79,59,138,25,163,324,50.31%,24.38%,1
嘉義縣,水上鄉,0061,165,134,299,27,326,622,52.41%,26.53%,1
嘉義縣,水上鄉,0062,320,201,521,96,617,1216,50.74%,26.32%,1
嘉義縣,水上鄉,0063,315,207,522,36,558,1020,54.71%,30.88%,1
嘉義縣,水上鄉,0064,237,202,439,42,481,771,62.39%,30.74%,1
嘉義縣,水上鄉,0065,155,96,251,25,276,441,62.59%,35.15%,1
嘉義縣,水上鄉,0066,207,153,360,48,408,626,65.18%,33.07%,1
嘉義縣,水上鄉,0067,186,116,302,35,337,570,59.12%,32.63%,1
嘉義縣,水上鄉,0068,94,73,167,25,192,368,52.17%,25.54%,1
嘉義縣,水上鄉,0069,257,181,438,99,537,1037,51.78%,24.78%,1
嘉義縣,水上鄉,0070,286,214,500,73,573,1065,53.8%,26.85%,1
嘉義縣,水上鄉,0071,244,177,421,86,507,802,63.22%,30.42%,1
嘉義縣,水上鄉,0072,542,336,878,45,923,1948,47.38%,27.82%,1
嘉義縣,水上鄉,0073,279,173,452,73,525,1028,51.07%,27.14%,1
嘉義縣,水上鄉,0074,213,125,338,33,371,641,57.88%,33.23%,1
嘉義縣,水上鄉,0075,121,97,218,10,228,408,55.88%,29.66%,1
嘉義縣,水上鄉,0076,236,163,399,59,458,794,57.68%,29.72%,1
嘉義縣,水上鄉,0077,137,104,241,30,271,569,47.63%,24.08%,1
嘉義縣,水上鄉,0078,241,166,407,45,452,806,56.08%,29.9%,1
嘉義縣,水上鄉,0079,305,186,491,63,554,960,57.71%,31.77%,1
嘉義縣,水上鄉,0080,577,433,1010,99,1109,2035,54.5%,28.35%,1
嘉義縣,水上鄉,0081,511,386,897,119,1016,1987,51.13%,25.72%,1
嘉義縣,水上鄉,0082,341,222,563,43,606,1154,52.51%,29.55%,1
嘉義縣,水上鄉,0083,604,411,1015,92,1107,2208,50.14%,27.36%,1
嘉義縣,水上鄉,0084,526,323,849,89,938,2102,44.62%,25.02%,1
嘉義縣,水上鄉,0085,357,226,583,70,653,1309,49.89%,27.27%,1
嘉義縣,水上鄉,0086,441,349,790,117,907,1671,54.28%,26.39%,1
嘉義縣,水上鄉,0087,238,154,392,47,439,822,53.41%,28.95%,1
嘉義縣,水上鄉,0088,408,353,761,86,847,1772,47.8%,23.02%,1
嘉義縣,水上鄉,0089,514,386,900,103,1003,1919,52.27%,26.78%,1
嘉義縣,水上鄉,0090,216,142,358,20,378,912,41.45%,23.68%,1
嘉義縣,水上鄉,0091,273,165,438,36,474,992,47.78%,27.52%,1
嘉義縣,水上鄉,0092,284,218,502,61,563,1270,44.33%,22.36%,1
嘉義縣,中埔鄉,0380,222,157,379,24,403,1046,38.53%,21.22%,1
嘉義縣,中埔鄉,0381,408,330,738,102,840,1788,46.98%,22.82%,1
嘉義縣,中埔鄉,0382,405,313,718,63,781,1730,45.14%,23.41%,1
嘉義縣,中埔鄉,0383,407,288,695,76,771,1581,48.77%,25.74%,1
嘉義縣,中埔鄉,0384,354,254,608,67,675,1594,42.35%,22.21%,1
嘉義縣,中埔鄉,0385,456,381,837,62,899,1801,49.92%,25.32%,1
嘉義縣,中埔鄉,0386,492,325,817,85,902,1862,48.44%,26.42%,1
嘉義縣,中埔鄉,0387,434,315,749,35,784,1803,43.48%,24.07%,1
嘉義縣,中埔鄉,0388,442,252,694,74,768,1481,51.86%,29.84%,1
嘉義縣,中埔鄉,0389,375,279,654,64,718,1366,52.56%,27.45%,1
嘉義縣,中埔鄉,0390,345,285,630,81,711,1599,44.47%,21.58%,1
嘉義縣,中埔鄉,0391,331,213,544,46,590,1196,49.33%,27.68%,1
嘉義縣,中埔鄉,0392,401,315,716,105,821,1809,45.38%,22.17%,1
嘉義縣,中埔鄉,0393,255,172,427,26,453,953,47.53%,26.76%,1
嘉義縣,中埔鄉,0394,352,243,595,75,670,1441,46.5%,24.43%,1
嘉義縣,中埔鄉,0395,453,327,780,87,867,1882,46.07%,24.07%,1
嘉義縣,中埔鄉,0396,275,206,481,36,517,1470,35.17%,18.71%,1
嘉義縣,中埔鄉,0397,393,266,659,94,753,1699,44.32%,23.13%,1
嘉義縣,中埔鄉,0398,97,59,156,17,173,422,41%,22.99%,1
嘉義縣,中埔鄉,0399,270,168,438,74,512,1030,49.71%,26.21%,1
嘉義縣,中埔鄉,0400,206,149,355,52,407,879,46.3%,23.44%,1
嘉義縣,中埔鄉,0401,161,145,306,25,331,828,39.98%,19.44%,1
嘉義縣,中埔鄉,0402,265,164,429,68,497,881,56.41%,30.08%,1
嘉義縣,中埔鄉,0403,72,53,125,23,148,296,50%,24.32%,1
嘉義縣,中埔鄉,0404,185,190,375,104,479,979,48.93%,18.9%,1
嘉義縣,中埔鄉,0405,272,208,480,48,528,1268,41.64%,21.45%,1
嘉義縣,中埔鄉,0406,113,74,187,8,195,670,29.1%,16.87%,1
嘉義縣,中埔鄉,0407,211,147,358,73,431,754,57.16%,27.98%,1
嘉義縣,中埔鄉,0408,175,125,300,51,351,648,54.17%,27.01%,1
嘉義縣,中埔鄉,0409,152,118,270,24,294,741,39.68%,20.51%,1
嘉義縣,中埔鄉,0410,124,80,204,5,209,518,40.35%,23.94%,1
嘉義縣,中埔鄉,0411,120,81,201,40,241,482,50%,24.9%,1
嘉義縣,中埔鄉,0412,73,58,131,12,143,348,41.09%,20.98%,1
嘉義縣,中埔鄉,0413,80,57,137,10,147,294,50%,27.21%,1
嘉義縣,竹崎鄉,0414,347,269,616,39,655,1312,49.92%,26.45%,1
嘉義縣,竹崎鄉,0415,360,244,604,31,635,1210,52.48%,29.75%,1
嘉義縣,竹崎鄉,0416,302,197,499,53,552,991,55.7%,30.47%,1
嘉義縣,竹崎鄉,0417,326,234,560,48,608,1207,50.37%,27.01%,1
嘉義縣,竹崎鄉,0418,150,134,284,21,305,752,40.56%,19.95%,1
嘉義縣,竹崎鄉,0419,228,185,413,71,484,833,58.1%,27.37%,1
嘉義縣,竹崎鄉,0420,186,411,597,93,690,1220,56.56%,15.25%,1
嘉義縣,竹崎鄉,0421,194,126,320,22,342,616,55.52%,31.49%,1
嘉義縣,竹崎鄉,0422,271,195,466,62,528,1031,51.21%,26.29%,1
嘉義縣,竹崎鄉,0423,357,235,592,76,668,1292,51.7%,27.63%,1
嘉義縣,竹崎鄉,0424,595,415,1010,85,1095,1995,54.89%,29.82%,1
嘉義縣,竹崎鄉,0425,503,351,854,38,892,1996,44.69%,25.2%,1
嘉義縣,竹崎鄉,0426,383,282,665,93,758,1449,52.31%,26.43%,1
嘉義縣,竹崎鄉,0427,409,236,645,45,690,1420,48.59%,28.8%,1
嘉義縣,竹崎鄉,0428,427,354,781,65,846,1590,53.21%,26.86%,1
嘉義縣,竹崎鄉,0429,204,148,352,38,390,771,50.58%,26.46%,1
嘉義縣,竹崎鄉,0430,220,208,428,51,479,1014,47.24%,21.7%,1
嘉義縣,竹崎鄉,0431,60,37,97,11,108,327,33.03%,18.35%,1
嘉義縣,竹崎鄉,0432,202,127,329,31,360,687,52.4%,29.4%,1
嘉義縣,竹崎鄉,0433,152,112,264,30,294,641,45.87%,23.71%,1
嘉義縣,竹崎鄉,0434,117,99,216,11,227,474,47.89%,24.68%,1
嘉義縣,竹崎鄉,0435,97,69,166,22,188,383,49.09%,25.33%,1
嘉義縣,竹崎鄉,0436,181,143,324,51,375,619,60.58%,29.24%,1
嘉義縣,竹崎鄉,0437,51,37,88,11,99,214,46.26%,23.83%,1
嘉義縣,竹崎鄉,0438,414,287,701,115,816,1568,52.04%,26.4%,1
嘉義縣,竹崎鄉,0439,136,109,245,51,296,658,44.98%,20.67%,1
嘉義縣,竹崎鄉,0440,108,111,219,36,255,434,58.76%,24.88%,1
嘉義縣,竹崎鄉,0441,263,168,431,64,495,917,53.98%,28.68%,1
嘉義縣,竹崎鄉,0442,231,175,406,65,471,981,48.01%,23.55%,1
嘉義縣,竹崎鄉,0443,168,140,308,28,336,789,42.59%,21.29%,1
嘉義縣,竹崎鄉,0444,15,12,27,2,29,108,26.85%,13.89%,1
嘉義縣,竹崎鄉,0445,29,22,51,3,54,235,22.98%,12.34%,1
嘉義縣,竹崎鄉,0446,85,46,131,7,138,331,41.69%,25.68%,1
嘉義縣,竹崎鄉,0447,140,118,258,17,275,450,61.11%,31.11%,1
嘉義縣,竹崎鄉,0448,114,49,163,10,173,462,37.45%,24.68%,1
嘉義縣,竹崎鄉,0449,63,27,90,16,106,251,42.23%,25.1%,1
嘉義縣,梅山鄉,0211,277,212,489,33,522,1041,50.14%,26.61%,1
嘉義縣,梅山鄉,0212,352,274,626,117,743,1245,59.68%,28.27%,1
嘉義縣,梅山鄉,0213,298,203,501,61,562,917,61.29%,32.5%,1
嘉義縣,梅山鄉,0214,330,243,573,56,629,1189,52.9%,27.75%,1
嘉義縣,梅山鄉,0215,419,273,692,89,781,1388,56.27%,30.19%,1
嘉義縣,梅山鄉,0216,502,372,874,79,953,1827,52.16%,27.48%,1
嘉義縣,梅山鄉,0217,168,123,291,54,345,545,63.3%,30.83%,1
嘉義縣,梅山鄉,0218,87,60,147,36,183,407,44.96%,21.38%,1
嘉義縣,梅山鄉,0219,159,134,293,44,337,636,52.99%,25%,1
嘉義縣,梅山鄉,0220,159,116,275,55,330,576,57.29%,27.6%,1
嘉義縣,梅山鄉,0221,483,334,817,95,912,1674,54.48%,28.85%,1
嘉義縣,梅山鄉,0222,200,146,346,18,364,858,42.42%,23.31%,1
嘉義縣,梅山鄉,0223,154,136,290,41,331,526,62.93%,29.28%,1
嘉義縣,梅山鄉,0224,79,69,148,33,181,372,48.66%,21.24%,1
嘉義縣,梅山鄉,0225,131,90,221,32,253,506,50%,25.89%,1
嘉義縣,梅山鄉,0226,156,95,251,50,301,433,69.52%,36.03%,1
嘉義縣,梅山鄉,0227,92,55,147,19,166,404,41.09%,22.77%,1
嘉義縣,梅山鄉,0228,74,54,128,18,146,293,49.83%,25.26%,1
嘉義縣,梅山鄉,0229,232,128,360,89,449,712,63.06%,32.58%,1
嘉義縣,梅山鄉,0230,191,141,332,41,373,602,61.96%,31.73%,1
嘉義縣,梅山鄉,0231,129,94,223,26,249,515,48.35%,25.05%,1
嘉義縣,梅山鄉,0232,85,61,146,18,164,417,39.33%,20.38%,1
嘉義縣,番路鄉,0450,354,271,625,82,707,1174,60.22%,30.15%,1
嘉義縣,番路鄉,0451,141,104,245,16,261,449,58.13%,31.4%,1
嘉義縣,番路鄉,0452,256,136,392,51,443,753,58.83%,34%,1
嘉義縣,番路鄉,0453,145,83,228,32,260,551,47.19%,26.32%,1
嘉義縣,番路鄉,0454,534,365,899,104,1003,1791,56%,29.82%,1
嘉義縣,番路鄉,0455,232,239,471,67,538,849,63.37%,27.33%,1
嘉義縣,番路鄉,0456,158,279,437,55,492,866,56.81%,18.24%,1
嘉義縣,番路鄉,0457,257,145,402,37,439,800,54.88%,32.13%,1
嘉義縣,番路鄉,0458,124,99,223,28,251,444,56.53%,27.93%,1
嘉義縣,番路鄉,0459,136,94,230,19,249,635,39.21%,21.42%,1
嘉義縣,番路鄉,0460,77,50,127,16,143,319,44.83%,24.14%,1
嘉義縣,番路鄉,0461,231,104,335,40,375,642,58.41%,35.98%,1
嘉義縣,番路鄉,0462,127,67,194,34,228,509,44.79%,24.95%,1
嘉義縣,番路鄉,0463,26,65,91,1,92,162,56.79%,16.05%,1
嘉義縣,番路鄉,0464,51,53,104,12,116,212,54.72%,24.06%,1
嘉義縣,大埔鄉,0465,437,282,719,84,803,1468,54.7%,29.77%,1
嘉義縣,大埔鄉,0466,68,31,99,9,108,320,33.75%,21.25%,1
嘉義縣,大埔鄉,0467,94,66,160,8,168,304,55.26%,30.92%,1
嘉義縣,大埔鄉,0468,46,45,91,2,93,184,50.54%,25%,1
嘉義縣,大埔鄉,0469,67,74,141,14,155,234,66.24%,28.63%,1
嘉義縣,大埔鄉,0470,134,94,228,9,237,495,47.88%,27.07%,1
嘉義縣,大埔鄉,0471,59,44,103,4,107,199,53.77%,29.65%,1
嘉義縣,大埔鄉,0472,54,37,91,14,105,226,46.46%,23.89%,1
嘉義縣,大埔鄉,0473,206,116,322,27,349,569,61.34%,36.2%,1
嘉義縣,阿里山鄉,0474,95,71,166,8,174,371,46.9%,25.61%,1
嘉義縣,阿里山鄉,0475,53,25,78,6,84,197,42.64%,26.9%,1
嘉義縣,阿里山鄉,0476,37,31,68,2,70,152,46.05%,24.34%,1
嘉義縣,阿里山鄉,0477,36,33,69,8,77,231,33.33%,15.58%,1
嘉義縣,阿里山鄉,0478,17,4,21,0,21,72,29.17%,23.61%,1
嘉義縣,阿里山鄉,0479,69,48,117,1,118,311,37.94%,22.19%,1
嘉義縣,阿里山鄉,0480,92,60,152,11,163,306,53.27%,30.07%,1
嘉義縣,阿里山鄉,0481,234,171,405,9,414,970,42.68%,24.12%,1
嘉義縣,阿里山鄉,0482,248,173,421,33,454,827,54.9%,29.99%,1
嘉義縣,阿里山鄉,0483,59,49,108,2,110,238,46.22%,24.79%,1
嘉義縣,阿里山鄉,0484,60,47,107,11,118,479,24.63%,12.53%,1
嘉義縣,阿里山鄉,0485,53,40,93,6,99,291,34.02%,18.21%,1
嘉義縣,阿里山鄉,0486,84,57,141,16,157,246,63.82%,34.15%,1
屏東縣,屏東市,0001,69,53,122,6,128,237,54.01%,29.11%,1
屏東縣,屏東市,0002,74,68,142,23,165,294,56.12%,25.17%,1
屏東縣,屏東市,0003,157,128,285,20,305,582,52.41%,26.98%,1
屏東縣,屏東市,0004,211,158,369,28,397,713,55.68%,29.59%,1
屏東縣,屏東市,0005,167,123,290,25,315,572,55.07%,29.2%,1
屏東縣,屏東市,0006,148,116,264,15,279,455,61.32%,32.53%,1
屏東縣,屏東市,0007,78,67,145,0,145,249,58.23%,31.33%,1
屏東縣,屏東市,0008,322,220,542,41,583,1315,44.33%,24.49%,1
屏東縣,屏東市,0009,330,258,588,54,642,1373,46.76%,24.03%,1
屏東縣,屏東市,0010,223,168,391,49,440,713,61.71%,31.28%,1
屏東縣,屏東市,0011,200,122,322,46,368,573,64.22%,34.9%,1
屏東縣,屏東市,0012,90,86,176,22,198,297,66.67%,30.3%,1
屏東縣,屏東市,0013,173,85,258,23,281,409,68.7%,42.3%,1
屏東縣,屏東市,0014,81,64,145,15,160,286,55.94%,28.32%,1
屏東縣,屏東市,0015,118,99,217,14,231,421,54.87%,28.03%,1
屏東縣,屏東市,0016,187,126,313,18,331,569,58.17%,32.86%,1
屏東縣,屏東市,0017,122,113,235,15,250,459,54.47%,26.58%,1
屏東縣,屏東市,0018,205,191,396,29,425,672,63.24%,30.51%,1
屏東縣,屏東市,0019,189,181,370,54,424,668,63.47%,28.29%,1
屏東縣,屏東市,0020,115,105,220,13,233,411,56.69%,27.98%,1
屏東縣,屏東市,0021,219,177,396,46,442,768,57.55%,28.52%,1
屏東縣,屏東市,0022,245,161,406,31,437,786,55.6%,31.17%,1
屏東縣,屏東市,0023,287,187,474,47,521,890,58.54%,32.25%,1
屏東縣,屏東市,0024,437,276,713,48,761,1353,56.25%,32.3%,1
屏東縣,屏東市,0025,403,293,696,39,735,1386,53.03%,29.08%,1
屏東縣,屏東市,0026,442,278,720,41,761,1413,53.86%,31.28%,1
屏東縣,屏東市,0027,371,280,651,39,690,1272,54.25%,29.17%,1
屏東縣,屏東市,0028,411,259,670,32,702,1287,54.55%,31.93%,1
屏東縣,屏東市,0029,432,276,708,46,754,1311,57.51%,32.95%,1
屏東縣,屏東市,0030,372,293,665,33,698,1285,54.32%,28.95%,1
屏東縣,屏東市,0031,412,281,693,53,746,1297,57.52%,31.77%,1
屏東縣,屏東市,0032,423,267,690,34,724,1361,53.2%,31.08%,1
屏東縣,屏東市,0033,361,299,660,52,712,1381,51.56%,26.14%,1
屏東縣,屏東市,0034,393,284,677,64,741,1258,58.9%,31.24%,1
屏東縣,屏東市,0035,381,275,656,57,713,1259,56.63%,30.26%,1
屏東縣,屏東市,0036,312,233,545,40,585,1076,54.37%,29%,1
屏東縣,屏東市,0037,376,249,625,42,667,1162,57.4%,32.36%,1
屏東縣,屏東市,0038,401,311,712,43,755,1318,57.28%,30.42%,1
屏東縣,屏東市,0039,291,191,482,43,525,939,55.91%,30.99%,1
屏東縣,屏東市,0040,331,197,528,33,561,972,57.72%,34.05%,1
屏東縣,屏東市,0041,508,308,816,45,861,1535,56.09%,33.09%,1
屏東縣,屏東市,0042,386,256,642,48,690,1419,48.63%,27.2%,1
屏東縣,屏東市,0043,371,270,641,32,673,1398,48.14%,26.54%,1
屏東縣,屏東市,0044,426,249,675,71,746,1405,53.1%,30.32%,1
屏東縣,屏東市,0045,464,311,775,37,812,1486,54.64%,31.22%,1
屏東縣,屏東市,0046,301,235,536,57,593,1061,55.89%,28.37%,1
屏東縣,屏東市,0047,416,227,643,103,746,1540,48.44%,27.01%,1
屏東縣,屏東市,0048,284,219,503,25,528,1141,46.28%,24.89%,1
屏東縣,屏東市,0049,329,240,569,43,612,1247,49.08%,26.38%,1
屏東縣,屏東市,0050,404,285,689,44,733,1446,50.69%,27.94%,1
屏東縣,屏東市,0051,409,285,694,50,744,1303,57.1%,31.39%,1
屏東縣,屏東市,0052,321,323,644,44,688,1253,54.91%,25.62%,1
屏東縣,屏東市,0053,413,259,672,43,715,1315,54.37%,31.41%,1
屏東縣,屏東市,0054,382,290,672,55,727,1425,51.02%,26.81%,1
屏東縣,屏東市,0055,384,293,677,39,716,1423,50.32%,26.99%,1
屏東縣,屏東市,0056,453,282,735,45,780,1400,55.71%,32.36%,1
屏東縣,屏東市,0057,396,345,741,47,788,1359,57.98%,29.14%,1
屏東縣,屏東市,0058,446,217,663,52,715,1328,53.84%,33.58%,1
屏東縣,屏東市,0059,479,286,765,41,806,1539,52.37%,31.12%,1
屏東縣,屏東市,0060,74,53,127,7,134,391,34.27%,18.93%,1
屏東縣,屏東市,0061,57,48,105,12,117,200,58.5%,28.5%,1
屏東縣,屏東市,0062,88,49,137,28,165,328,50.3%,26.83%,1
屏東縣,屏東市,0063,70,47,117,4,121,231,52.38%,30.3%,1
屏東縣,屏東市,0064,278,184,462,56,518,945,54.81%,29.42%,1
屏東縣,屏東市,0065,287,210,497,56,553,1053,52.52%,27.26%,1
屏東縣,屏東市,0066,269,199,468,61,529,1043,50.72%,25.79%,1
屏東縣,屏東市,0067,287,193,480,79,559,1061,52.69%,27.05%,1
屏東縣,屏東市,0068,237,174,411,41,452,876,51.6%,27.05%,1
屏東縣,屏東市,0069,440,267,707,102,809,1468,55.11%,29.97%,1
屏東縣,屏東市,0070,385,249,634,79,713,1454,49.04%,26.48%,1
屏東縣,屏東市,0071,350,242,592,39,631,1205,52.37%,29.05%,1
屏東縣,屏東市,0072,340,295,635,0,635,1284,49.45%,26.48%,1
屏東縣,屏東市,0073,340,241,581,37,618,1219,50.7%,27.89%,1
屏東縣,屏東市,0074,450,333,783,89,872,1544,56.48%,29.15%,1
屏東縣,屏東市,0075,414,290,704,104,808,1485,54.41%,27.88%,1
屏東縣,屏東市,0076,426,274,700,69,769,1387,55.44%,30.71%,1
屏東縣,屏東市,0077,268,183,451,28,479,953,50.26%,28.12%,1
屏東縣,屏東市,0078,431,394,825,49,874,1603,54.52%,26.89%,1
屏東縣,屏東市,0079,153,98,251,36,287,535,53.64%,28.6%,1
屏東縣,屏東市,0080,345,197,542,46,588,1119,52.55%,30.83%,1
屏東縣,屏東市,0081,278,154,432,39,471,847,55.61%,32.82%,1
屏東縣,屏東市,0082,273,200,473,73,546,923,59.15%,29.58%,1
屏東縣,屏東市,0083,323,246,569,46,615,1227,50.12%,26.32%,1
屏東縣,屏東市,0084,301,210,511,57,568,1039,54.67%,28.97%,1
屏東縣,屏東市,0085,371,319,690,104,794,1485,53.47%,24.98%,1
屏東縣,屏東市,0086,251,175,426,62,488,867,56.29%,28.95%,1
屏東縣,屏東市,0087,288,191,479,43,522,918,56.86%,31.37%,1
屏東縣,屏東市,0088,175,116,291,52,343,663,51.73%,26.4%,1
屏東縣,屏東市,0089,311,206,517,30,547,1215,45.02%,25.6%,1
屏東縣,屏東市,0090,412,300,712,96,808,1628,49.63%,25.31%,1
屏東縣,屏東市,0091,369,252,621,51,672,1209,55.58%,30.52%,1
屏東縣,屏東市,0092,414,262,676,24,700,1110,63.06%,37.3%,1
屏東縣,屏東市,0093,159,140,299,22,321,684,46.93%,23.25%,1
屏東縣,屏東市,0094,330,216,546,37,583,1349,43.22%,24.46%,1
屏東縣,屏東市,0095,402,249,651,63,714,1457,49%,27.59%,1
屏東縣,屏東市,0096,440,352,792,47,839,1447,57.98%,30.41%,1
屏東縣,屏東市,0097,382,256,638,31,669,1354,49.41%,28.21%,1
屏東縣,屏東市,0098,484,324,808,76,884,1583,55.84%,30.57%,1
屏東縣,屏東市,0099,558,287,845,24,869,1707,50.91%,32.69%,1
屏東縣,屏東市,0100,436,303,739,44,783,1637,47.83%,26.63%,1
屏東縣,屏東市,0101,422,265,687,45,732,1459,50.17%,28.92%,1
屏東縣,屏東市,0102,567,324,891,43,934,1759,53.1%,32.23%,1
屏東縣,屏東市,0103,635,317,952,51,1003,1950,51.44%,32.56%,1
屏東縣,屏東市,0104,543,317,860,63,923,1729,53.38%,31.41%,1
屏東縣,屏東市,0105,462,283,745,43,788,1592,49.5%,29.02%,1
屏東縣,屏東市,0106,425,254,679,41,720,1437,50.1%,29.58%,1
屏東縣,屏東市,0107,355,214,569,33,602,1204,50%,29.49%,1
屏東縣,屏東市,0108,441,252,693,39,732,1340,54.63%,32.91%,1
屏東縣,屏東市,0109,391,284,675,42,717,1322,54.24%,29.58%,1
屏東縣,屏東市,0110,439,256,695,33,728,1462,49.79%,30.03%,1
屏東縣,屏東市,0111,988,539,1527,64,1591,3241,49.09%,30.48%,1
屏東縣,屏東市,0112,471,225,696,23,719,1477,48.68%,31.89%,1
屏東縣,屏東市,0113,213,150,363,34,397,821,48.36%,25.94%,1
屏東縣,屏東市,0114,254,187,441,27,468,1099,42.58%,23.11%,1
屏東縣,屏東市,0115,536,274,810,58,868,1688,51.42%,31.75%,1
屏東縣,屏東市,0116,299,234,533,48,581,1167,49.79%,25.62%,1
屏東縣,屏東市,0117,247,190,437,52,489,915,53.44%,26.99%,1
屏東縣,屏東市,0118,281,199,480,43,523,1683,31.08%,16.7%,1
屏東縣,屏東市,0119,447,279,726,20,746,1497,49.83%,29.86%,1
屏東縣,屏東市,0120,281,258,539,31,570,1129,50.49%,24.89%,1
屏東縣,屏東市,0121,394,235,629,38,667,1232,54.14%,31.98%,1
屏東縣,屏東市,0122,255,180,435,29,464,853,54.4%,29.89%,1
屏東縣,屏東市,0123,288,193,481,24,505,869,58.11%,33.14%,1
屏東縣,屏東市,0124,379,241,620,49,669,1169,57.23%,32.42%,1
屏東縣,屏東市,0125,334,217,551,37,588,1058,55.58%,31.57%,1
屏東縣,屏東市,0126,382,246,628,44,672,1344,50%,28.42%,1
屏東縣,屏東市,0127,459,259,718,29,747,1299,57.51%,35.33%,1
屏東縣,屏東市,0128,313,219,532,47,579,1204,48.09%,26%,1
屏東縣,屏東市,0129,326,225,551,38,589,1123,52.45%,29.03%,1
屏東縣,屏東市,0130,328,211,539,45,584,1318,44.31%,24.89%,1
屏東縣,屏東市,0131,278,182,460,57,517,865,59.77%,32.14%,1
屏東縣,屏東市,0132,257,186,443,32,475,1100,43.18%,23.36%,1
屏東縣,屏東市,0133,351,208,559,16,575,1215,47.33%,28.89%,1
屏東縣,屏東市,0134,401,286,687,39,726,1370,52.99%,29.27%,1
屏東縣,屏東市,0135,365,245,610,19,629,1240,50.73%,29.44%,1
屏東縣,屏東市,0136,391,232,623,44,667,1168,57.11%,33.48%,1
屏東縣,屏東市,0137,331,222,553,30,583,1079,54.03%,30.68%,1
屏東縣,屏東市,0138,413,265,678,61,739,1289,57.33%,32.04%,1
屏東縣,屏東市,0139,324,216,540,44,584,1115,52.38%,29.06%,1
屏東縣,屏東市,0140,572,216,788,52,840,1491,56.34%,38.36%,1
屏東縣,屏東市,0141,400,224,624,55,679,1411,48.12%,28.35%,1
屏東縣,屏東市,0142,547,316,863,33,896,1803,49.69%,30.34%,1
屏東縣,屏東市,0143,234,158,392,34,426,744,57.26%,31.45%,1
屏東縣,屏東市,0144,198,140,338,29,367,678,54.13%,29.2%,1
屏東縣,屏東市,0145,206,166,372,28,400,681,58.74%,30.25%,1
屏東縣,屏東市,0146,346,272,618,45,663,1535,43.19%,22.54%,1
屏東縣,屏東市,0147,280,187,467,72,539,954,56.5%,29.35%,1
屏東縣,屏東市,0148,320,239,559,56,615,1018,60.41%,31.43%,1
屏東縣,屏東市,0149,349,265,614,37,651,1154,56.41%,30.24%,1
屏東縣,潮州鎮,0150,153,114,267,38,305,504,60.52%,30.36%,1
屏東縣,潮州鎮,0151,448,304,752,57,809,1711,47.28%,26.18%,1
屏東縣,潮州鎮,0152,503,310,813,34,847,1634,51.84%,30.78%,1
屏東縣,潮州鎮,0153,365,253,618,39,657,1414,46.46%,25.81%,1
屏東縣,潮州鎮,0154,180,146,326,50,376,603,62.35%,29.85%,1
屏東縣,潮州鎮,0155,254,161,415,73,488,896,54.46%,28.35%,1
屏東縣,潮州鎮,0156,354,259,613,63,676,1285,52.61%,27.55%,1
屏東縣,潮州鎮,0157,477,326,803,66,869,1744,49.83%,27.35%,1
屏東縣,潮州鎮,0158,326,241,567,48,615,1071,57.42%,30.44%,1
屏東縣,潮州鎮,0159,375,267,642,63,705,1209,58.31%,31.02%,1
屏東縣,潮州鎮,0160,327,229,556,55,611,1159,52.72%,28.21%,1
屏東縣,潮州鎮,0161,348,253,601,58,659,1296,50.85%,26.85%,1
屏東縣,潮州鎮,0162,446,289,735,53,788,1466,53.75%,30.42%,1
屏東縣,潮州鎮,0163,292,292,584,62,646,1130,57.17%,25.84%,1
屏東縣,潮州鎮,0164,436,275,711,58,769,1439,53.44%,30.3%,1
屏東縣,潮州鎮,0165,266,218,484,47,531,897,59.2%,29.65%,1
屏東縣,潮州鎮,0166,444,200,644,50,694,1225,56.65%,36.24%,1
屏東縣,潮州鎮,0167,328,202,530,55,585,1158,50.52%,28.32%,1
屏東縣,潮州鎮,0168,100,75,175,42,217,481,45.11%,20.79%,1
屏東縣,潮州鎮,0169,260,242,502,47,549,972,56.48%,26.75%,1
屏東縣,潮州鎮,0170,363,319,682,2,684,1245,54.94%,29.16%,1
屏東縣,潮州鎮,0171,412,273,685,65,750,1415,53%,29.12%,1
屏東縣,潮州鎮,0172,290,244,534,25,559,1255,44.54%,23.11%,1
屏東縣,潮州鎮,0173,243,139,382,30,412,1058,38.94%,22.97%,1
屏東縣,潮州鎮,0174,328,245,573,40,613,1187,51.64%,27.63%,1
屏東縣,潮州鎮,0175,308,228,536,75,611,1083,56.42%,28.44%,1
屏東縣,潮州鎮,0176,392,314,706,47,753,1590,47.36%,24.65%,1
屏東縣,潮州鎮,0177,467,296,763,77,840,1543,54.44%,30.27%,1
屏東縣,潮州鎮,0178,452,293,745,67,812,1631,49.79%,27.71%,1
屏東縣,潮州鎮,0179,394,226,620,41,661,1159,57.03%,33.99%,1
屏東縣,潮州鎮,0180,338,240,578,36,614,1099,55.87%,30.76%,1
屏東縣,潮州鎮,0181,331,213,544,51,595,1200,49.58%,27.58%,1
屏東縣,潮州鎮,0182,388,245,633,71,704,1391,50.61%,27.89%,1
屏東縣,潮州鎮,0183,254,183,437,65,502,881,56.98%,28.83%,1
屏東縣,潮州鎮,0184,106,67,173,25,198,454,43.61%,23.35%,1
屏東縣,潮州鎮,0185,422,357,779,101,880,1658,53.08%,25.45%,1
屏東縣,潮州鎮,0186,212,136,348,42,390,822,47.45%,25.79%,1
屏東縣,潮州鎮,0187,229,157,386,18,404,948,42.62%,24.16%,1
屏東縣,潮州鎮,0188,250,195,445,36,481,1194,40.28%,20.94%,1
屏東縣,潮州鎮,0189,84,64,148,43,191,337,56.68%,24.93%,1
屏東縣,東港鎮,0190,294,233,527,69,596,981,60.75%,29.97%,1
屏東縣,東港鎮,0191,313,258,571,62,633,1070,59.16%,29.25%,1
屏東縣,東港鎮,0192,177,112,289,54,343,527,65.09%,33.59%,1
屏東縣,東港鎮,0193,109,99,208,31,239,395,60.51%,27.59%,1
屏東縣,東港鎮,0194,151,139,290,48,338,659,51.29%,22.91%,1
屏東縣,東港鎮,0195,140,107,247,31,278,513,54.19%,27.29%,1
屏東縣,東港鎮,0196,488,318,806,80,886,1732,51.15%,28.18%,1
屏東縣,東港鎮,0197,484,400,884,64,948,1779,53.29%,27.21%,1
屏東縣,東港鎮,0198,360,228,588,58,646,1270,50.87%,28.35%,1
屏東縣,東港鎮,0199,348,269,617,79,696,1327,52.45%,26.22%,1
屏東縣,東港鎮,0200,319,297,616,78,694,1242,55.88%,25.68%,1
屏東縣,東港鎮,0201,441,334,775,108,883,1607,54.95%,27.44%,1
屏東縣,東港鎮,0202,336,239,575,53,628,1305,48.12%,25.75%,1
屏東縣,東港鎮,0203,199,149,348,45,393,695,56.55%,28.63%,1
屏東縣,東港鎮,0204,318,225,543,117,660,1076,61.34%,29.55%,1
屏東縣,東港鎮,0205,136,116,252,41,293,567,51.68%,23.99%,1
屏東縣,東港鎮,0206,220,150,370,47,417,806,51.74%,27.3%,1
屏東縣,東港鎮,0207,336,259,595,88,683,1227,55.66%,27.38%,1
屏東縣,東港鎮,0208,151,118,269,55,324,599,54.09%,25.21%,1
屏東縣,東港鎮,0209,301,192,493,59,552,1354,40.77%,22.23%,1
屏東縣,東港鎮,0210,187,140,327,62,389,734,53%,25.48%,1
屏東縣,東港鎮,0211,281,211,492,143,635,1107,57.36%,25.38%,1
屏東縣,東港鎮,0212,300,188,488,103,591,1198,49.33%,25.04%,1
屏東縣,東港鎮,0213,407,276,683,135,818,1614,50.68%,25.22%,1
屏東縣,東港鎮,0214,195,175,370,53,423,826,51.21%,23.61%,1
屏東縣,東港鎮,0215,185,250,435,80,515,912,56.47%,20.29%,1
屏東縣,東港鎮,0216,85,96,181,42,223,432,51.62%,19.68%,1
屏東縣,東港鎮,0217,346,219,565,119,684,1204,56.81%,28.74%,1
屏東縣,東港鎮,0218,370,271,641,83,724,1304,55.52%,28.37%,1
屏東縣,東港鎮,0219,404,282,686,82,768,1317,58.31%,30.68%,1
屏東縣,東港鎮,0220,382,273,655,49,704,1387,50.76%,27.54%,1
屏東縣,東港鎮,0221,312,242,554,40,594,1310,45.34%,23.82%,1
屏東縣,東港鎮,0222,318,217,535,62,597,1228,48.62%,25.9%,1
屏東縣,東港鎮,0223,181,138,319,55,374,766,48.83%,23.63%,1
屏東縣,東港鎮,0224,226,175,401,73,474,823,57.59%,27.46%,1
屏東縣,東港鎮,0225,158,87,245,28,273,755,36.16%,20.93%,1
屏東縣,東港鎮,0226,292,217,509,112,621,1094,56.76%,26.69%,1
屏東縣,東港鎮,0227,218,122,340,31,371,753,49.27%,28.95%,1
屏東縣,恆春鎮,0228,196,205,401,37,438,902,48.56%,21.73%,1
屏東縣,恆春鎮,0229,273,244,517,37,554,969,57.17%,28.17%,1
屏東縣,恆春鎮,0230,334,249,583,46,629,1280,49.14%,26.09%,1
屏東縣,恆春鎮,0231,340,232,572,35,607,1133,53.57%,30.01%,1
屏東縣,恆春鎮,0232,374,231,605,22,627,1552,40.4%,24.1%,1
屏東縣,恆春鎮,0233,306,252,558,61,619,1485,41.68%,20.61%,1
屏東縣,恆春鎮,0234,244,201,445,35,480,896,53.57%,27.23%,1
屏東縣,恆春鎮,0235,132,86,218,29,247,531,46.52%,24.86%,1
屏東縣,恆春鎮,0236,116,84,200,13,213,478,44.56%,24.27%,1
屏東縣,恆春鎮,0237,267,183,450,39,489,1020,47.94%,26.18%,1
屏東縣,恆春鎮,0238,220,196,416,24,440,924,47.62%,23.81%,1
屏東縣,恆春鎮,0239,254,174,428,21,449,1079,41.61%,23.54%,1
屏東縣,恆春鎮,0240,150,109,259,29,288,775,37.16%,19.35%,1
屏東縣,恆春鎮,0241,239,138,377,59,436,813,53.63%,29.4%,1
屏東縣,恆春鎮,0242,276,192,468,53,521,1104,47.19%,25%,1
屏東縣,恆春鎮,0243,240,193,433,59,492,1110,44.32%,21.62%,1
屏東縣,恆春鎮,0244,127,99,226,71,297,692,42.92%,18.35%,1
屏東縣,恆春鎮,0245,132,99,231,10,241,708,34.04%,18.64%,1
屏東縣,恆春鎮,0246,377,290,667,40,707,1505,46.98%,25.05%,1
屏東縣,恆春鎮,0247,279,197,476,41,517,1111,46.53%,25.11%,1
屏東縣,恆春鎮,0248,367,283,650,53,703,1543,45.56%,23.78%,1
屏東縣,恆春鎮,0249,180,126,306,22,328,828,39.61%,21.74%,1
屏東縣,恆春鎮,0250,227,181,408,33,441,844,52.25%,26.9%,1
屏東縣,恆春鎮,0251,311,249,560,48,608,1253,48.52%,24.82%,1
屏東縣,恆春鎮,0252,265,205,470,43,513,1126,45.56%,23.53%,1
屏東縣,萬丹鄉,0253,351,249,600,52,652,1527,42.7%,22.99%,1
屏東縣,萬丹鄉,0254,300,202,502,67,569,1147,49.61%,26.16%,1
屏東縣,萬丹鄉,0255,207,191,398,52,450,949,47.42%,21.81%,1
屏東縣,萬丹鄉,0256,261,181,442,36,478,990,48.28%,26.36%,1
屏東縣,萬丹鄉,0257,224,186,410,24,434,1022,42.47%,21.92%,1
屏東縣,萬丹鄉,0258,175,125,300,67,367,545,67.34%,32.11%,1
屏東縣,萬丹鄉,0259,357,212,569,110,679,1159,58.58%,30.8%,1
屏東縣,萬丹鄉,0260,238,172,410,84,494,837,59.02%,28.43%,1
屏東縣,萬丹鄉,0261,120,58,178,18,196,392,50%,30.61%,1
屏東縣,萬丹鄉,0262,247,193,440,46,486,847,57.38%,29.16%,1
屏東縣,萬丹鄉,0263,307,218,525,56,581,1149,50.57%,26.72%,1
屏東縣,萬丹鄉,0264,317,234,551,54,605,1131,53.49%,28.03%,1
屏東縣,萬丹鄉,0265,329,223,552,57,609,1178,51.7%,27.93%,1
屏東縣,萬丹鄉,0266,196,194,390,36,426,711,59.92%,27.57%,1
屏東縣,萬丹鄉,0267,203,128,331,27,358,595,60.17%,34.12%,1
屏東縣,萬丹鄉,0268,255,487,742,63,805,1403,57.38%,18.18%,1
屏東縣,萬丹鄉,0269,291,214,505,35,540,1094,49.36%,26.6%,1
屏東縣,萬丹鄉,0270,318,265,583,58,641,1158,55.35%,27.46%,1
屏東縣,萬丹鄉,0271,290,225,515,83,598,963,62.1%,30.11%,1
屏東縣,萬丹鄉,0272,272,235,507,58,565,1062,53.2%,25.61%,1
屏東縣,萬丹鄉,0273,453,335,788,99,887,1684,52.67%,26.9%,1
屏東縣,萬丹鄉,0274,466,290,756,44,800,1702,47%,27.38%,1
屏東縣,萬丹鄉,0275,251,218,469,56,525,976,53.79%,25.72%,1
屏東縣,萬丹鄉,0276,289,199,488,67,555,1013,54.79%,28.53%,1
屏東縣,萬丹鄉,0277,151,192,343,39,382,847,45.1%,17.83%,1
屏東縣,萬丹鄉,0278,469,298,767,145,912,1570,58.09%,29.87%,1
屏東縣,萬丹鄉,0279,363,236,599,93,692,1411,49.04%,25.73%,1
屏東縣,萬丹鄉,0280,303,210,513,90,603,1046,57.65%,28.97%,1
屏東縣,萬丹鄉,0281,346,257,603,48,651,1385,47%,24.98%,1
屏東縣,萬丹鄉,0282,221,160,381,65,446,804,55.47%,27.49%,1
屏東縣,萬丹鄉,0283,343,250,593,103,696,1284,54.21%,26.71%,1
屏東縣,萬丹鄉,0284,378,258,636,65,701,1430,49.02%,26.43%,1
屏東縣,萬丹鄉,0285,319,195,514,82,596,960,62.08%,33.23%,1
屏東縣,萬丹鄉,0286,237,181,418,57,475,786,60.43%,30.15%,1
屏東縣,萬丹鄉,0287,297,265,562,87,649,1158,56.04%,25.65%,1
屏東縣,萬丹鄉,0288,358,265,623,80,703,1647,42.68%,21.74%,1
屏東縣,萬丹鄉,0289,413,266,679,94,773,1666,46.4%,24.79%,1
屏東縣,萬丹鄉,0290,322,213,535,89,624,1023,61%,31.48%,1
屏東縣,萬丹鄉,0291,381,256,637,77,714,1227,58.19%,31.05%,1
屏東縣,長治鄉,0292,291,204,495,71,566,1018,55.6%,28.59%,1
屏東縣,長治鄉,0293,465,325,790,86,876,1614,54.28%,28.81%,1
屏東縣,長治鄉,0294,559,385,944,100,1044,1848,56.49%,30.25%,1
屏東縣,長治鄉,0295,622,224,846,74,920,1707,53.9%,36.44%,1
屏東縣,長治鄉,0296,319,195,514,34,548,972,56.38%,32.82%,1
屏東縣,長治鄉,0297,187,312,499,64,563,989,56.93%,18.91%,1
屏東縣,長治鄉,0298,212,170,382,62,444,735,60.41%,28.84%,1
屏東縣,長治鄉,0299,472,351,823,70,893,1813,49.26%,26.03%,1
屏東縣,長治鄉,0300,348,248,596,55,651,1073,60.67%,32.43%,1
屏東縣,長治鄉,0301,528,268,796,83,879,1654,53.14%,31.92%,1
屏東縣,長治鄉,0302,335,268,603,72,675,1205,56.02%,27.8%,1
屏東縣,長治鄉,0303,226,158,384,48,432,758,56.99%,29.82%,1
屏東縣,長治鄉,0304,413,296,709,99,808,1492,54.16%,27.68%,1
屏東縣,長治鄉,0305,262,177,439,65,504,884,57.01%,29.64%,1
屏東縣,長治鄉,0306,292,244,536,75,611,1090,56.06%,26.79%,1
屏東縣,長治鄉,0307,356,215,571,114,685,1422,48.17%,25.04%,1
屏東縣,長治鄉,0308,233,163,396,67,463,845,54.79%,27.57%,1
屏東縣,長治鄉,0309,239,169,408,123,531,925,57.41%,25.84%,1
屏東縣,長治鄉,0310,304,206,510,106,616,1138,54.13%,26.71%,1
屏東縣,長治鄉,0311,307,272,579,119,698,1242,56.2%,24.72%,1
屏東縣,長治鄉,0312,259,187,446,25,471,1159,40.64%,22.35%,1
屏東縣,長治鄉,0313,215,148,363,39,402,673,59.73%,31.95%,1
屏東縣,麟洛鄉,0314,217,177,394,51,445,788,56.47%,27.54%,1
屏東縣,麟洛鄉,0315,454,313,767,33,800,1386,57.72%,32.76%,1
屏東縣,麟洛鄉,0316,304,222,526,58,584,957,61.02%,31.77%,1
屏東縣,麟洛鄉,0317,219,181,400,46,446,731,61.01%,29.96%,1
屏東縣,麟洛鄉,0318,253,194,447,57,504,806,62.53%,31.39%,1
屏東縣,麟洛鄉,0319,302,246,548,23,571,1207,47.31%,25.02%,1
屏東縣,麟洛鄉,0320,409,327,736,80,816,1340,60.9%,30.52%,1
屏東縣,麟洛鄉,0321,367,275,642,66,708,1221,57.99%,30.06%,1
屏東縣,麟洛鄉,0322,237,168,405,22,427,851,50.18%,27.85%,1
屏東縣,麟洛鄉,0323,173,136,309,14,323,683,47.29%,25.33%,1
屏東縣,九如鄉,0324,342,400,742,100,842,1491,56.47%,22.94%,1
屏東縣,九如鄉,0325,380,276,656,81,737,1375,53.6%,27.64%,1
屏東縣,九如鄉,0326,427,303,730,69,799,1678,47.62%,25.45%,1
屏東縣,九如鄉,0327,333,257,590,89,679,1166,58.23%,28.56%,1
屏東縣,九如鄉,0328,296,211,507,46,553,1276,43.34%,23.2%,1
屏東縣,九如鄉,0329,273,236,509,74,583,1033,56.44%,26.43%,1
屏東縣,九如鄉,0330,212,141,353,44,397,577,68.8%,36.74%,1
屏東縣,九如鄉,0331,190,139,329,74,403,649,62.1%,29.28%,1
屏東縣,九如鄉,0332,553,367,920,172,1092,1999,54.63%,27.66%,1
屏東縣,九如鄉,0333,480,328,808,107,915,1766,51.81%,27.18%,1
屏東縣,九如鄉,0334,401,319,720,108,828,1600,51.75%,25.06%,1
屏東縣,九如鄉,0335,328,263,591,90,681,1248,54.57%,26.28%,1
屏東縣,九如鄉,0336,448,402,850,188,1038,1792,57.92%,25%,1
屏東縣,九如鄉,0337,433,261,694,123,817,1482,55.13%,29.22%,1
屏東縣,里港鄉,0338,492,334,826,90,916,1552,59.02%,31.7%,1
屏東縣,里港鄉,0339,404,287,691,97,788,1480,53.24%,27.3%,1
屏東縣,里港鄉,0340,324,300,624,61,685,1534,44.65%,21.12%,1
屏東縣,里港鄉,0341,413,308,721,131,852,1578,53.99%,26.17%,1
屏東縣,里港鄉,0342,300,295,595,72,667,1127,59.18%,26.62%,1
屏東縣,里港鄉,0343,249,192,441,57,498,845,58.93%,29.47%,1
屏東縣,里港鄉,0344,360,257,617,68,685,1282,53.43%,28.08%,1
屏東縣,里港鄉,0345,281,209,490,79,569,981,58%,28.64%,1
屏東縣,里港鄉,0346,295,226,521,78,599,1031,58.1%,28.61%,1
屏東縣,里港鄉,0347,390,279,669,125,794,1423,55.8%,27.41%,1
屏東縣,里港鄉,0348,73,64,137,29,166,363,45.73%,20.11%,1
屏東縣,里港鄉,0349,312,313,625,75,700,1203,58.19%,25.94%,1
屏東縣,里港鄉,0350,294,260,554,83,637,1027,62.03%,28.63%,1
屏東縣,里港鄉,0351,340,246,586,76,662,1384,47.83%,24.57%,1
屏東縣,里港鄉,0352,406,282,688,96,784,1512,51.85%,26.85%,1
屏東縣,里港鄉,0353,175,111,286,22,308,522,59%,33.52%,1
屏東縣,里港鄉,0354,210,178,388,71,459,822,55.84%,25.55%,1
屏東縣,里港鄉,0355,234,198,432,96,528,1007,52.43%,23.24%,1
屏東縣,里港鄉,0356,244,216,460,77,537,956,56.17%,25.52%,1
屏東縣,里港鄉,0357,149,101,250,32,282,499,56.51%,29.86%,1
屏東縣,鹽埔鄉,0358,266,175,441,42,483,951,50.79%,27.97%,1
屏東縣,鹽埔鄉,0359,229,157,386,36,422,899,46.94%,25.47%,1
屏東縣,鹽埔鄉,0360,264,190,454,35,489,1116,43.82%,23.66%,1
屏東縣,鹽埔鄉,0361,332,240,572,50,622,1241,50.12%,26.75%,1
屏東縣,鹽埔鄉,0362,210,128,338,50,388,770,50.39%,27.27%,1
屏東縣,鹽埔鄉,0363,301,155,456,47,503,962,52.29%,31.29%,1
屏東縣,鹽埔鄉,0364,323,246,569,62,631,1041,60.61%,31.03%,1
屏東縣,鹽埔鄉,0365,408,267,675,35,710,1367,51.94%,29.85%,1
屏東縣,鹽埔鄉,0366,368,220,588,73,661,1465,45.12%,25.12%,1
屏東縣,鹽埔鄉,0367,218,147,365,53,418,894,46.76%,24.38%,1
屏東縣,鹽埔鄉,0368,234,157,391,3,394,958,41.13%,24.43%,1
屏東縣,鹽埔鄉,0369,224,107,331,107,438,924,47.4%,24.24%,1
屏東縣,鹽埔鄉,0370,359,280,639,50,689,1598,43.12%,22.47%,1
屏東縣,鹽埔鄉,0371,377,324,701,128,829,1550,53.48%,24.32%,1
屏東縣,鹽埔鄉,0372,299,213,512,90,602,1127,53.42%,26.53%,1
屏東縣,鹽埔鄉,0373,352,226,578,91,669,1150,58.17%,30.61%,1
屏東縣,鹽埔鄉,0374,351,253,604,69,673,1233,54.58%,28.47%,1
屏東縣,鹽埔鄉,0375,309,184,493,99,592,984,60.16%,31.4%,1
屏東縣,鹽埔鄉,0376,457,325,782,76,858,1619,53%,28.23%,1
屏東縣,鹽埔鄉,0377,165,108,273,35,308,553,55.7%,29.84%,1
屏東縣,高樹鄉,0378,229,223,452,92,544,883,61.61%,25.93%,1
屏東縣,高樹鄉,0379,255,178,433,36,469,1255,37.37%,20.32%,1
屏東縣,高樹鄉,0380,432,174,606,39,645,1278,50.47%,33.8%,1
屏東縣,高樹鄉,0381,169,124,293,31,324,738,43.9%,22.9%,1
屏東縣,高樹鄉,0382,123,110,233,16,249,585,42.56%,21.03%,1
屏東縣,高樹鄉,0383,250,235,485,108,593,1012,58.6%,24.7%,1
屏東縣,高樹鄉,0384,293,181,474,93,567,1148,49.39%,25.52%,1
屏東縣,高樹鄉,0385,151,109,260,35,295,591,49.92%,25.55%,1
屏東縣,高樹鄉,0386,159,141,300,53,353,786,44.91%,20.23%,1
屏東縣,高樹鄉,0387,151,99,250,31,281,649,43.3%,23.27%,1
屏東縣,高樹鄉,0388,258,172,430,75,505,1229,41.09%,20.99%,1
屏東縣,高樹鄉,0389,296,239,535,64,599,1446,41.42%,20.47%,1
屏東縣,高樹鄉,0390,188,141,329,20,349,899,38.82%,20.91%,1
屏東縣,高樹鄉,0391,243,166,409,63,472,922,51.19%,26.36%,1
屏東縣,高樹鄉,0392,304,198,502,85,587,1259,46.62%,24.15%,1
屏東縣,高樹鄉,0393,205,160,365,32,397,1056,37.59%,19.41%,1
屏東縣,高樹鄉,0394,317,222,539,75,614,1116,55.02%,28.41%,1
屏東縣,高樹鄉,0395,289,198,487,82,569,1020,55.78%,28.33%,1
屏東縣,高樹鄉,0396,276,203,479,93,572,1055,54.22%,26.16%,1
屏東縣,高樹鄉,0397,217,163,380,55,435,738,58.94%,29.4%,1
屏東縣,高樹鄉,0398,117,78,195,32,227,493,46.04%,23.73%,1
屏東縣,高樹鄉,0399,421,329,750,120,870,1539,56.53%,27.36%,1
屏東縣,萬巒鄉,0400,297,236,533,45,578,1239,46.65%,23.97%,1
屏東縣,萬巒鄉,0401,188,181,369,62,431,759,56.79%,24.77%,1
屏東縣,萬巒鄉,0402,258,191,449,106,555,932,59.55%,27.68%,1
屏東縣,萬巒鄉,0403,208,189,397,68,465,769,60.47%,27.05%,1
屏東縣,萬巒鄉,0404,222,192,414,87,501,920,54.46%,24.13%,1
屏東縣,萬巒鄉,0405,144,126,270,52,322,560,57.5%,25.71%,1
屏東縣,萬巒鄉,0406,289,174,463,36,499,1120,44.55%,25.8%,1
屏東縣,萬巒鄉,0407,297,157,454,40,494,1048,47.14%,28.34%,1
屏東縣,萬巒鄉,0408,331,234,565,58,623,1438,43.32%,23.02%,1
屏東縣,萬巒鄉,0409,205,141,346,69,415,834,49.76%,24.58%,1
屏東縣,萬巒鄉,0410,193,153,346,77,423,813,52.03%,23.74%,1
屏東縣,萬巒鄉,0411,237,148,385,47,432,1020,42.35%,23.24%,1
屏東縣,萬巒鄉,0412,289,209,498,80,578,1007,57.4%,28.7%,1
屏東縣,萬巒鄉,0413,352,278,630,99,729,1648,44.24%,21.36%,1
屏東縣,萬巒鄉,0414,346,283,629,86,715,1437,49.76%,24.08%,1
屏東縣,萬巒鄉,0415,277,195,472,33,505,1228,41.12%,22.56%,1
屏東縣,萬巒鄉,0416,214,84,298,62,360,597,60.3%,35.85%,1
屏東縣,萬巒鄉,0417,130,129,259,54,313,576,54.34%,22.57%,1
屏東縣,內埔鄉,0418,311,242,553,43,596,1305,45.67%,23.83%,1
屏東縣,內埔鄉,0419,327,218,545,42,587,1287,45.61%,25.41%,1
屏東縣,內埔鄉,0420,342,262,604,19,623,1387,44.92%,24.66%,1
屏東縣,內埔鄉,0421,379,273,652,67,719,1540,46.69%,24.61%,1
屏東縣,內埔鄉,0422,384,304,688,62,750,1605,46.73%,23.93%,1
屏東縣,內埔鄉,0423,349,228,577,78,655,1326,49.4%,26.32%,1
屏東縣,內埔鄉,0424,147,125,272,63,335,591,56.68%,24.87%,1
屏東縣,內埔鄉,0425,296,171,467,64,531,1123,47.28%,26.36%,1
屏東縣,內埔鄉,0426,302,189,491,23,514,1079,47.64%,27.99%,1
屏東縣,內埔鄉,0427,396,295,691,76,767,1485,51.65%,26.67%,1
屏東縣,內埔鄉,0428,407,246,653,45,698,1248,55.93%,32.61%,1
屏東縣,內埔鄉,0429,229,301,530,64,594,1569,37.86%,14.6%,1
屏東縣,內埔鄉,0430,377,269,646,67,713,1493,47.76%,25.25%,1
屏東縣,內埔鄉,0431,347,246,593,22,615,1420,43.31%,24.44%,1
屏東縣,內埔鄉,0432,352,265,617,78,695,1334,52.1%,26.39%,1
屏東縣,內埔鄉,0433,400,255,655,81,736,1519,48.45%,26.33%,1
屏東縣,內埔鄉,0434,221,150,371,50,421,784,53.7%,28.19%,1
屏東縣,內埔鄉,0435,249,178,427,73,500,888,56.31%,28.04%,1
屏東縣,內埔鄉,0436,149,100,249,16,265,747,35.48%,19.95%,1
屏東縣,內埔鄉,0437,253,183,436,27,463,1168,39.64%,21.66%,1
屏東縣,內埔鄉,0438,145,124,269,42,311,546,56.96%,26.56%,1
屏東縣,內埔鄉,0439,332,249,581,56,637,1278,49.84%,25.98%,1
屏東縣,內埔鄉,0440,289,225,514,67,581,1348,43.1%,21.44%,1
屏東縣,內埔鄉,0441,329,234,563,84,647,1550,41.74%,21.23%,1
屏東縣,內埔鄉,0442,284,215,499,78,577,947,60.93%,29.99%,1
屏東縣,內埔鄉,0443,290,189,479,83,562,1097,51.23%,26.44%,1
屏東縣,內埔鄉,0444,229,178,407,65,472,1128,41.84%,20.3%,1
屏東縣,內埔鄉,0445,196,177,373,35,408,1253,32.56%,15.64%,1
屏東縣,內埔鄉,0446,272,267,539,31,570,1525,37.38%,17.84%,1
屏東縣,內埔鄉,0447,316,239,555,78,633,1215,52.1%,26.01%,1
屏東縣,內埔鄉,0448,260,201,461,34,495,1216,40.71%,21.38%,1
屏東縣,內埔鄉,0449,353,204,557,32,589,1353,43.53%,26.09%,1
屏東縣,內埔鄉,0450,257,194,451,41,492,1026,47.95%,25.05%,1
屏東縣,內埔鄉,0451,209,135,344,41,385,862,44.66%,24.25%,1
屏東縣,內埔鄉,0452,172,139,311,40,351,921,38.11%,18.68%,1
屏東縣,內埔鄉,0453,199,176,375,29,404,854,47.31%,23.3%,1
屏東縣,內埔鄉,0454,277,197,474,52,526,1230,42.76%,22.52%,1
屏東縣,內埔鄉,0455,253,192,445,36,481,1204,39.95%,21.01%,1
屏東縣,內埔鄉,0456,291,203,494,49,543,1301,41.74%,22.37%,1
屏東縣,內埔鄉,0457,236,162,398,52,450,806,55.83%,29.28%,1
屏東縣,竹田鄉,0458,429,327,756,82,838,1503,55.76%,28.54%,1
屏東縣,竹田鄉,0459,283,212,495,56,551,899,61.29%,31.48%,1
屏東縣,竹田鄉,0460,229,171,400,51,451,716,62.99%,31.98%,1
屏東縣,竹田鄉,0461,163,178,341,42,383,581,65.92%,28.06%,1
屏東縣,竹田鄉,0462,382,247,629,111,740,1327,55.76%,28.79%,1
屏東縣,竹田鄉,0463,250,269,519,102,621,997,62.29%,25.08%,1
屏東縣,竹田鄉,0464,183,134,317,32,349,649,53.78%,28.2%,1
屏東縣,竹田鄉,0465,195,120,315,32,347,476,72.9%,40.97%,1
屏東縣,竹田鄉,0466,379,285,664,73,737,1259,58.54%,30.1%,1
屏東縣,竹田鄉,0467,364,210,574,69,643,1227,52.4%,29.67%,1
屏東縣,竹田鄉,0468,163,114,277,47,324,504,64.29%,32.34%,1
屏東縣,竹田鄉,0469,233,174,407,55,462,860,53.72%,27.09%,1
屏東縣,竹田鄉,0470,223,155,378,32,410,800,51.25%,27.88%,1
屏東縣,竹田鄉,0471,312,262,574,79,653,1134,57.58%,27.51%,1
屏東縣,竹田鄉,0472,349,247,596,67,663,1229,53.95%,28.4%,1
屏東縣,竹田鄉,0473,329,214,543,81,624,1192,52.35%,27.6%,1
屏東縣,新埤鄉,0474,411,328,739,55,794,1712,46.38%,24.01%,1
屏東縣,新埤鄉,0475,74,57,131,43,174,314,55.41%,23.57%,1
屏東縣,新埤鄉,0476,194,165,359,47,406,752,53.99%,25.8%,1
屏東縣,新埤鄉,0477,90,64,154,30,184,334,55.09%,26.95%,1
屏東縣,新埤鄉,0478,261,203,464,67,531,957,55.49%,27.27%,1
屏東縣,新埤鄉,0479,215,172,387,64,451,764,59.03%,28.14%,1
屏東縣,新埤鄉,0480,98,77,175,38,213,373,57.1%,26.27%,1
屏東縣,新埤鄉,0481,161,118,279,39,318,678,46.9%,23.75%,1
屏東縣,新埤鄉,0482,168,111,279,34,313,701,44.65%,23.97%,1
屏東縣,新埤鄉,0483,273,193,466,69,535,1323,40.44%,20.63%,1
屏東縣,新埤鄉,0484,154,109,263,48,311,541,57.49%,28.47%,1
屏東縣,新埤鄉,0485,154,73,227,36,263,584,45.03%,26.37%,1
屏東縣,枋寮鄉,0486,349,251,600,80,680,1213,56.06%,28.77%,1
屏東縣,枋寮鄉,0487,224,211,435,77,512,891,57.46%,25.14%,1
屏東縣,枋寮鄉,0488,229,166,395,100,495,970,51.03%,23.61%,1
屏東縣,枋寮鄉,0489,193,104,297,39,336,629,53.42%,30.68%,1
屏東縣,枋寮鄉,0490,256,163,419,60,479,840,57.02%,30.48%,1
屏東縣,枋寮鄉,0491,228,169,397,49,446,774,57.62%,29.46%,1
屏東縣,枋寮鄉,0492,376,251,627,86,713,1379,51.7%,27.27%,1
屏東縣,枋寮鄉,0493,462,295,757,70,827,1502,55.06%,30.76%,1
屏東縣,枋寮鄉,0494,319,236,555,94,649,1276,50.86%,25%,1
屏東縣,枋寮鄉,0495,251,171,422,90,512,964,53.11%,26.04%,1
屏東縣,枋寮鄉,0496,318,191,509,98,607,1005,60.4%,31.64%,1
屏東縣,枋寮鄉,0497,201,103,304,31,335,734,45.64%,27.38%,1
屏東縣,枋寮鄉,0498,196,149,345,63,408,725,56.28%,27.03%,1
屏東縣,枋寮鄉,0499,272,175,447,71,518,1046,49.52%,26%,1
屏東縣,枋寮鄉,0500,313,224,537,72,609,1067,57.08%,29.33%,1
屏東縣,枋寮鄉,0501,133,80,213,65,278,718,38.72%,18.52%,1
屏東縣,枋寮鄉,0502,196,170,366,58,424,903,46.95%,21.71%,1
屏東縣,枋寮鄉,0503,353,249,602,94,696,1387,50.18%,25.45%,1
屏東縣,枋寮鄉,0504,368,276,644,96,740,1367,54.13%,26.92%,1
屏東縣,枋寮鄉,0505,178,149,327,59,386,618,62.46%,28.8%,1
屏東縣,枋寮鄉,0506,204,141,345,45,390,959,40.67%,21.27%,1
屏東縣,枋寮鄉,0507,128,73,201,35,236,427,55.27%,29.98%,1
屏東縣,新園鄉,0508,215,193,408,64,472,820,57.56%,26.22%,1
屏東縣,新園鄉,0509,282,154,436,72,508,843,60.26%,33.45%,1
屏東縣,新園鄉,0510,328,247,575,68,643,1242,51.77%,26.41%,1
屏東縣,新園鄉,0511,416,254,670,70,740,1290,57.36%,32.25%,1
屏東縣,新園鄉,0512,310,199,509,59,568,1073,52.94%,28.89%,1
屏東縣,新園鄉,0513,294,235,529,116,645,1088,59.28%,27.02%,1
屏東縣,新園鄉,0514,225,146,371,50,421,845,49.82%,26.63%,1
屏東縣,新園鄉,0515,221,190,411,54,465,862,53.94%,25.64%,1
屏東縣,新園鄉,0516,285,219,504,84,588,1183,49.7%,24.09%,1
屏東縣,新園鄉,0517,305,206,511,100,611,1109,55.09%,27.5%,1
屏東縣,新園鄉,0518,279,199,478,17,495,1119,44.24%,24.93%,1
屏東縣,新園鄉,0519,302,223,525,40,565,1152,49.05%,26.22%,1
屏東縣,新園鄉,0520,327,182,509,65,574,1030,55.73%,31.75%,1
屏東縣,新園鄉,0521,312,187,499,87,586,1104,53.08%,28.26%,1
屏東縣,新園鄉,0522,295,225,520,0,520,1240,41.94%,23.79%,1
屏東縣,新園鄉,0523,223,176,399,32,431,1120,38.48%,19.91%,1
屏東縣,新園鄉,0524,317,233,550,74,624,1074,58.1%,29.52%,1
屏東縣,新園鄉,0525,195,159,354,42,396,849,46.64%,22.97%,1
屏東縣,新園鄉,0526,182,161,343,69,412,749,55.01%,24.3%,1
屏東縣,新園鄉,0527,370,262,632,85,717,1416,50.64%,26.13%,1
屏東縣,新園鄉,0528,233,170,403,75,478,895,53.41%,26.03%,1
屏東縣,新園鄉,0529,281,167,448,72,520,933,55.73%,30.12%,1
屏東縣,新園鄉,0530,272,181,453,61,514,972,52.88%,27.98%,1
屏東縣,新園鄉,0531,304,223,527,87,614,1454,42.23%,20.91%,1
屏東縣,新園鄉,0532,473,324,797,168,965,1653,58.38%,28.61%,1
屏東縣,新園鄉,0533,302,210,512,121,633,1270,49.84%,23.78%,1
屏東縣,新園鄉,0534,311,231,542,150,692,1123,61.62%,27.69%,1
屏東縣,新園鄉,0535,293,193,486,127,613,1198,51.17%,24.46%,1
屏東縣,崁頂鄉,0536,310,206,516,62,578,1190,48.57%,26.05%,1
屏東縣,崁頂鄉,0537,303,232,535,58,593,1044,56.8%,29.02%,1
屏東縣,崁頂鄉,0538,224,182,406,46,452,818,55.26%,27.38%,1
屏東縣,崁頂鄉,0539,348,228,576,53,629,1214,51.81%,28.67%,1
屏東縣,崁頂鄉,0540,331,237,568,42,610,1325,46.04%,24.98%,1
屏東縣,崁頂鄉,0541,387,256,643,64,707,1253,56.42%,30.89%,1
屏東縣,崁頂鄉,0542,295,172,467,59,526,1039,50.63%,28.39%,1
屏東縣,崁頂鄉,0543,179,156,335,53,388,813,47.72%,22.02%,1
屏東縣,崁頂鄉,0544,177,129,306,36,342,736,46.47%,24.05%,1
屏東縣,崁頂鄉,0545,288,189,477,46,523,934,56%,30.84%,1
屏東縣,崁頂鄉,0546,219,178,397,75,472,900,52.44%,24.33%,1
屏東縣,崁頂鄉,0547,296,183,479,48,527,1004,52.49%,29.48%,1
屏東縣,林邊鄉,0548,425,305,730,128,858,1458,58.85%,29.15%,1
屏東縣,林邊鄉,0549,249,204,453,63,516,891,57.91%,27.95%,1
屏東縣,林邊鄉,0550,237,139,376,43,419,695,60.29%,34.1%,1
屏東縣,林邊鄉,0551,287,250,537,70,607,1015,59.8%,28.28%,1
屏東縣,林邊鄉,0552,385,233,618,54,672,1171,57.39%,32.88%,1
屏東縣,林邊鄉,0553,262,217,479,48,527,1003,52.54%,26.12%,1
屏東縣,林邊鄉,0554,212,202,414,48,462,725,63.72%,29.24%,1
屏東縣,林邊鄉,0555,227,190,417,78,495,841,58.86%,26.99%,1
屏東縣,林邊鄉,0556,242,171,413,60,473,793,59.65%,30.52%,1
屏東縣,林邊鄉,0557,278,204,482,65,547,919,59.52%,30.25%,1
屏東縣,林邊鄉,0558,344,239,583,65,648,1283,50.51%,26.81%,1
屏東縣,林邊鄉,0559,191,143,334,40,374,783,47.77%,24.39%,1
屏東縣,林邊鄉,0560,261,142,403,58,461,1033,44.63%,25.27%,1
屏東縣,林邊鄉,0561,299,232,531,108,639,1186,53.88%,25.21%,1
屏東縣,林邊鄉,0562,199,152,351,72,423,773,54.72%,25.74%,1
屏東縣,林邊鄉,0563,269,201,470,44,514,1122,45.81%,23.98%,1
屏東縣,南州鄉,0564,221,133,354,79,433,872,49.66%,25.34%,1
屏東縣,南州鄉,0565,214,164,378,59,437,794,55.04%,26.95%,1
屏東縣,南州鄉,0566,288,208,496,60,556,962,57.8%,29.94%,1
屏東縣,南州鄉,0567,278,220,498,77,575,1033,55.66%,26.91%,1
屏東縣,南州鄉,0568,256,210,466,52,518,1007,51.44%,25.42%,1
屏東縣,南州鄉,0569,140,102,242,31,273,466,58.58%,30.04%,1
屏東縣,南州鄉,0570,216,156,372,45,417,708,58.9%,30.51%,1
屏東縣,南州鄉,0571,265,244,509,82,591,1044,56.61%,25.38%,1
屏東縣,南州鄉,0572,230,167,397,40,437,1071,40.8%,21.48%,1
屏東縣,南州鄉,0573,240,186,426,31,457,979,46.68%,24.51%,1
屏東縣,南州鄉,0574,155,81,236,39,275,543,50.64%,28.55%,1
屏東縣,佳冬鄉,0575,364,253,617,70,687,1472,46.67%,24.73%,1
屏東縣,佳冬鄉,0576,285,233,518,88,606,1360,44.56%,20.96%,1
屏東縣,佳冬鄉,0577,228,147,375,87,462,804,57.46%,28.36%,1
屏東縣,佳冬鄉,0578,218,182,400,84,484,925,52.32%,23.57%,1
屏東縣,佳冬鄉,0579,198,149,347,16,363,855,42.46%,23.16%,1
屏東縣,佳冬鄉,0580,263,154,417,41,458,981,46.69%,26.81%,1
屏東縣,佳冬鄉,0581,276,158,434,62,496,1007,49.26%,27.41%,1
屏東縣,佳冬鄉,0582,204,143,347,62,409,872,46.9%,23.39%,1
屏東縣,佳冬鄉,0583,306,182,488,80,568,1255,45.26%,24.38%,1
屏東縣,佳冬鄉,0584,277,180,457,89,546,995,54.87%,27.84%,1
屏東縣,佳冬鄉,0585,136,116,252,29,281,734,38.28%,18.53%,1
屏東縣,佳冬鄉,0586,250,216,466,34,500,1178,42.44%,21.22%,1
屏東縣,佳冬鄉,0587,245,182,427,28,455,1095,41.55%,22.37%,1
屏東縣,佳冬鄉,0588,280,222,502,141,643,1097,58.61%,25.52%,1
屏東縣,佳冬鄉,0589,326,244,570,81,651,1273,51.14%,25.61%,1
屏東縣,佳冬鄉,0590,338,244,582,71,653,1160,56.29%,29.14%,1
屏東縣,琉球鄉,0591,239,156,395,51,446,1111,40.14%,21.51%,1
屏東縣,琉球鄉,0592,240,136,376,55,431,972,44.34%,24.69%,1
屏東縣,琉球鄉,0593,363,199,562,88,650,1278,50.86%,28.4%,1
屏東縣,琉球鄉,0594,242,160,402,93,495,976,50.72%,24.8%,1
屏東縣,琉球鄉,0595,429,269,698,90,788,1658,47.53%,25.87%,1
屏東縣,琉球鄉,0596,226,154,380,61,441,1146,38.48%,19.72%,1
屏東縣,琉球鄉,0597,232,130,362,55,417,1079,38.65%,21.5%,1
屏東縣,琉球鄉,0598,300,160,460,51,511,1613,31.68%,18.6%,1
屏東縣,琉球鄉,0599,236,157,393,58,451,873,51.66%,27.03%,1
屏東縣,車城鄉,0600,154,111,265,44,309,737,41.93%,20.9%,1
屏東縣,車城鄉,0601,113,87,200,41,241,647,37.25%,17.47%,1
屏東縣,車城鄉,0602,106,97,203,22,225,491,45.82%,21.59%,1
屏東縣,車城鄉,0603,194,163,357,39,396,856,46.26%,22.66%,1
屏東縣,車城鄉,0604,119,98,217,10,227,554,40.97%,21.48%,1
屏東縣,車城鄉,0605,83,51,134,6,140,388,36.08%,21.39%,1
屏東縣,車城鄉,0606,186,133,319,50,369,922,40.02%,20.17%,1
屏東縣,車城鄉,0607,96,75,171,11,182,597,30.49%,16.08%,1
屏東縣,車城鄉,0608,87,88,175,10,185,623,29.7%,13.96%,1
屏東縣,車城鄉,0609,97,69,166,25,191,425,44.94%,22.82%,1
屏東縣,車城鄉,0610,122,72,194,22,216,428,50.47%,28.5%,1
屏東縣,車城鄉,0611,97,63,160,11,171,504,33.93%,19.25%,1
屏東縣,車城鄉,0612,108,79,187,24,211,423,49.88%,25.53%,1
屏東縣,滿州鄉,0613,389,291,680,54,734,1575,46.6%,24.7%,1
屏東縣,滿州鄉,0614,102,74,176,11,187,420,44.52%,24.29%,1
屏東縣,滿州鄉,0615,171,147,318,31,349,602,57.97%,28.41%,1
屏東縣,滿州鄉,0616,261,178,439,26,465,1302,35.71%,20.05%,1
屏東縣,滿州鄉,0617,326,217,543,64,607,1314,46.19%,24.81%,1
屏東縣,滿州鄉,0618,210,149,359,34,393,1308,30.05%,16.06%,1
屏東縣,滿州鄉,0619,59,57,116,16,132,367,35.97%,16.08%,1
屏東縣,滿州鄉,0620,93,52,145,21,166,318,52.2%,29.25%,1
屏東縣,枋山鄉,0621,197,135,332,34,366,604,60.6%,32.62%,1
屏東縣,枋山鄉,0622,130,91,221,37,258,428,60.28%,30.37%,1
屏東縣,枋山鄉,0623,319,173,492,90,582,928,62.72%,34.38%,1
屏東縣,枋山鄉,0624,266,174,440,25,465,972,47.84%,27.37%,1
屏東縣,枋山鄉,0625,217,172,389,71,460,1041,44.19%,20.85%,1
屏東縣,枋山鄉,0626,154,124,278,25,303,883,34.31%,17.44%,1
屏東縣,三地門鄉,0627,135,107,242,31,273,616,44.32%,21.92%,1
屏東縣,三地門鄉,0628,137,117,254,91,345,572,60.31%,23.95%,1
屏東縣,三地門鄉,0629,76,44,120,27,147,323,45.51%,23.53%,1
屏東縣,三地門鄉,0630,446,292,738,66,804,1448,55.52%,30.8%,1
屏東縣,三地門鄉,0631,131,77,208,8,216,726,29.75%,18.04%,1
屏東縣,三地門鄉,0632,142,117,259,28,287,554,51.81%,25.63%,1
屏東縣,三地門鄉,0633,94,74,168,16,184,346,53.18%,27.17%,1
屏東縣,三地門鄉,0634,79,74,153,3,156,458,34.06%,17.25%,1
屏東縣,三地門鄉,0635,219,115,334,27,361,692,52.17%,31.65%,1
屏東縣,三地門鄉,0636,253,138,391,73,464,638,72.73%,39.66%,1
屏東縣,霧臺鄉,0637,133,104,237,30,267,346,77.17%,38.44%,1
屏東縣,霧臺鄉,0638,193,135,328,19,347,677,51.26%,28.51%,1
屏東縣,霧臺鄉,0639,38,12,50,0,50,162,30.86%,23.46%,1
屏東縣,霧臺鄉,0640,55,35,90,6,96,189,50.79%,29.1%,1
屏東縣,霧臺鄉,0641,98,76,174,36,210,296,70.95%,33.11%,1
屏東縣,霧臺鄉,0642,141,121,262,14,276,483,57.14%,29.19%,1
屏東縣,霧臺鄉,0643,71,69,140,2,142,347,40.92%,20.46%,1
屏東縣,霧臺鄉,0644,94,74,168,27,195,450,43.33%,20.89%,1
屏東縣,瑪家鄉,0645,122,88,210,4,214,455,47.03%,26.81%,1
屏東縣,瑪家鄉,0646,268,216,484,52,536,821,65.29%,32.64%,1
屏東縣,瑪家鄉,0647,233,147,380,81,461,635,72.6%,36.69%,1
屏東縣,瑪家鄉,0648,333,143,476,40,516,695,74.24%,47.91%,1
屏東縣,瑪家鄉,0649,256,140,396,36,432,671,64.38%,38.15%,1
屏東縣,瑪家鄉,0650,248,163,411,20,431,1057,40.78%,23.46%,1
屏東縣,瑪家鄉,0651,290,162,452,32,484,900,53.78%,32.22%,1
屏東縣,瑪家鄉,0652,123,75,198,11,209,429,48.72%,28.67%,1
屏東縣,泰武鄉,0653,192,140,332,23,355,669,53.06%,28.7%,1
屏東縣,泰武鄉,0654,52,28,80,15,95,190,50%,27.37%,1
屏東縣,泰武鄉,0655,300,225,525,82,607,922,65.84%,32.54%,1
屏東縣,泰武鄉,0656,229,141,370,75,445,598,74.41%,38.29%,1
屏東縣,泰武鄉,0657,311,133,444,59,503,771,65.24%,40.34%,1
屏東縣,泰武鄉,0658,136,113,249,53,302,414,72.95%,32.85%,1
屏東縣,泰武鄉,0659,190,163,353,43,396,780,50.77%,24.36%,1
屏東縣,來義鄉,0660,341,142,483,118,601,917,65.54%,37.19%,1
屏東縣,來義鄉,0661,105,61,166,19,185,361,51.25%,29.09%,1
屏東縣,來義鄉,0662,40,35,75,3,78,216,36.11%,18.52%,1
屏東縣,來義鄉,0663,214,93,307,29,336,445,75.51%,48.09%,1
屏東縣,來義鄉,0664,89,62,151,31,182,280,65%,31.79%,1
屏東縣,來義鄉,0665,430,160,590,59,649,1097,59.16%,39.2%,1
屏東縣,來義鄉,0666,345,140,485,74,559,840,66.55%,41.07%,1
屏東縣,來義鄉,0667,243,151,394,27,421,889,47.36%,27.33%,1
屏東縣,來義鄉,0668,317,193,510,65,575,1212,47.44%,26.16%,1
屏東縣,春日鄉,0669,100,84,184,6,190,909,20.9%,11%,1
屏東縣,春日鄉,0670,89,82,171,26,197,663,29.71%,13.42%,1
屏東縣,春日鄉,0671,28,10,38,2,40,304,13.16%,9.21%,1
屏東縣,春日鄉,0672,178,123,301,31,332,928,35.78%,19.18%,1
屏東縣,春日鄉,0673,83,78,161,11,172,641,26.83%,12.95%,1
屏東縣,春日鄉,0674,68,32,100,5,105,478,21.97%,14.23%,1
屏東縣,獅子鄉,0675,219,123,342,20,362,751,48.2%,29.16%,1
屏東縣,獅子鄉,0676,202,121,323,39,362,776,46.65%,26.03%,1
屏東縣,獅子鄉,0677,170,90,260,16,276,711,38.82%,23.91%,1
屏東縣,獅子鄉,0678,62,85,147,36,183,243,75.31%,25.51%,1
屏東縣,獅子鄉,0679,85,79,164,13,177,325,54.46%,26.15%,1
屏東縣,獅子鄉,0680,79,51,130,7,137,476,28.78%,16.6%,1
屏東縣,獅子鄉,0681,141,82,223,13,236,602,39.2%,23.42%,1
屏東縣,獅子鄉,0682,69,45,114,10,124,346,35.84%,19.94%,1
屏東縣,牡丹鄉,0683,60,75,135,8,143,342,41.81%,17.54%,1
屏東縣,牡丹鄉,0684,381,226,607,56,663,1306,50.77%,29.17%,1
屏東縣,牡丹鄉,0685,94,60,154,10,164,693,23.67%,13.56%,1
屏東縣,牡丹鄉,0686,76,69,145,19,164,437,37.53%,17.39%,1
屏東縣,牡丹鄉,0687,110,76,186,8,194,392,49.49%,28.06%,1
屏東縣,牡丹鄉,0688,150,122,272,9,281,593,47.39%,25.3%,1
屏東縣,牡丹鄉,0689,86,39,125,7,132,551,23.96%,15.61%,1
宜蘭縣,宜蘭市,0001,282,205,487,36,523,982,53.26%,28.72%,1
宜蘭縣,宜蘭市,0002,400,221,621,80,701,1270,55.2%,31.5%,1
宜蘭縣,宜蘭市,0003,261,178,439,26,465,849,54.77%,30.74%,1
宜蘭縣,宜蘭市,0004,247,168,415,25,440,756,58.2%,32.67%,1
宜蘭縣,宜蘭市,0005,320,186,506,51,557,1107,50.32%,28.91%,1
宜蘭縣,宜蘭市,0006,263,171,434,60,494,893,55.32%,29.45%,1
宜蘭縣,宜蘭市,0007,273,194,467,42,509,912,55.81%,29.93%,1
宜蘭縣,宜蘭市,0008,429,250,679,73,752,1335,56.33%,32.13%,1
宜蘭縣,宜蘭市,0009,184,139,323,45,368,686,53.64%,26.82%,1
宜蘭縣,宜蘭市,0010,471,315,786,74,860,1366,62.96%,34.48%,1
宜蘭縣,宜蘭市,0011,422,306,728,47,775,1363,56.86%,30.96%,1
宜蘭縣,宜蘭市,0012,498,315,813,72,885,1540,57.47%,32.34%,1
宜蘭縣,宜蘭市,0013,428,261,689,40,729,1341,54.36%,31.92%,1
宜蘭縣,宜蘭市,0014,389,234,623,64,687,1209,56.82%,32.18%,1
宜蘭縣,宜蘭市,0015,258,177,435,75,510,900,56.67%,28.67%,1
宜蘭縣,宜蘭市,0016,272,184,456,54,510,980,52.04%,27.76%,1
宜蘭縣,宜蘭市,0017,350,247,597,48,645,1165,55.36%,30.04%,1
宜蘭縣,宜蘭市,0018,301,173,474,33,507,904,56.08%,33.3%,1
宜蘭縣,宜蘭市,0019,108,315,423,37,460,813,56.58%,13.28%,1
宜蘭縣,宜蘭市,0020,300,191,491,51,542,978,55.42%,30.67%,1
宜蘭縣,宜蘭市,0021,320,215,535,47,582,1282,45.4%,24.96%,1
宜蘭縣,宜蘭市,0022,152,102,254,19,273,465,58.71%,32.69%,1
宜蘭縣,宜蘭市,0023,190,124,314,79,393,669,58.74%,28.4%,1
宜蘭縣,宜蘭市,0024,310,169,479,49,528,923,57.2%,33.59%,1
宜蘭縣,宜蘭市,0025,288,182,470,62,532,1006,52.88%,28.63%,1
宜蘭縣,宜蘭市,0026,239,197,436,63,499,762,65.49%,31.36%,1
宜蘭縣,宜蘭市,0027,236,177,413,47,460,727,63.27%,32.46%,1
宜蘭縣,宜蘭市,0028,258,204,462,85,547,833,65.67%,30.97%,1
宜蘭縣,宜蘭市,0029,422,187,609,41,650,1143,56.87%,36.92%,1
宜蘭縣,宜蘭市,0030,308,196,504,32,536,979,54.75%,31.46%,1
宜蘭縣,宜蘭市,0031,366,231,597,77,674,1214,55.52%,30.15%,1
宜蘭縣,宜蘭市,0032,382,249,631,102,733,1283,57.13%,29.77%,1
宜蘭縣,宜蘭市,0033,307,187,494,56,550,946,58.14%,32.45%,1
宜蘭縣,宜蘭市,0034,335,185,520,66,586,1090,53.76%,30.73%,1
宜蘭縣,宜蘭市,0035,303,200,503,36,539,943,57.16%,32.13%,1
宜蘭縣,宜蘭市,0036,230,220,450,43,493,774,63.7%,29.72%,1
宜蘭縣,宜蘭市,0037,331,216,547,44,591,968,61.05%,34.19%,1
宜蘭縣,宜蘭市,0038,312,211,523,47,570,926,61.56%,33.69%,1
宜蘭縣,宜蘭市,0039,301,235,536,76,612,1019,60.06%,29.54%,1
宜蘭縣,宜蘭市,0040,340,208,548,64,612,1084,56.46%,31.37%,1
宜蘭縣,宜蘭市,0041,327,235,562,33,595,1095,54.34%,29.86%,1
宜蘭縣,宜蘭市,0042,370,215,585,39,624,1083,57.62%,34.16%,1
宜蘭縣,宜蘭市,0043,292,240,532,63,595,1108,53.7%,26.35%,1
宜蘭縣,宜蘭市,0044,281,178,459,34,493,848,58.14%,33.14%,1
宜蘭縣,宜蘭市,0045,335,218,553,54,607,1095,55.43%,30.59%,1
宜蘭縣,宜蘭市,0046,339,234,573,54,627,1110,56.49%,30.54%,1
宜蘭縣,宜蘭市,0047,352,228,580,63,643,1104,58.24%,31.88%,1
宜蘭縣,宜蘭市,0048,362,219,581,63,644,1134,56.79%,31.92%,1
宜蘭縣,宜蘭市,0049,361,240,601,59,660,1146,57.59%,31.5%,1
宜蘭縣,宜蘭市,0050,275,187,462,65,527,876,60.16%,31.39%,1
宜蘭縣,宜蘭市,0051,258,178,436,70,506,905,55.91%,28.51%,1
宜蘭縣,宜蘭市,0052,297,168,465,69,534,910,58.68%,32.64%,1
宜蘭縣,宜蘭市,0053,390,221,611,63,674,1434,47%,27.2%,1
宜蘭縣,宜蘭市,0054,396,151,547,90,637,1152,55.3%,34.38%,1
宜蘭縣,宜蘭市,0055,294,226,520,59,579,966,59.94%,30.43%,1
宜蘭縣,宜蘭市,0056,206,157,363,52,415,711,58.37%,28.97%,1
宜蘭縣,宜蘭市,0057,280,196,476,60,536,884,60.63%,31.67%,1
宜蘭縣,宜蘭市,0058,380,304,684,81,765,1326,57.69%,28.66%,1
宜蘭縣,宜蘭市,0059,247,186,433,35,468,909,51.49%,27.17%,1
宜蘭縣,宜蘭市,0060,248,182,430,60,490,894,54.81%,27.74%,1
宜蘭縣,宜蘭市,0061,344,229,573,64,637,1259,50.6%,27.32%,1
宜蘭縣,宜蘭市,0062,227,148,375,41,416,789,52.72%,28.77%,1
宜蘭縣,宜蘭市,0063,199,235,434,41,475,867,54.79%,22.95%,1
宜蘭縣,宜蘭市,0064,418,283,701,104,805,1454,55.36%,28.75%,1
宜蘭縣,宜蘭市,0065,407,240,647,45,692,1130,61.24%,36.02%,1
宜蘭縣,宜蘭市,0066,297,163,460,40,500,1087,46%,27.32%,1
宜蘭縣,宜蘭市,0067,326,187,513,67,580,938,61.83%,34.75%,1
宜蘭縣,宜蘭市,0068,403,252,655,62,717,1285,55.8%,31.36%,1
宜蘭縣,宜蘭市,0069,264,185,449,42,491,952,51.58%,27.73%,1
宜蘭縣,宜蘭市,0070,296,223,519,52,571,948,60.23%,31.22%,1
宜蘭縣,宜蘭市,0071,305,227,532,76,608,1160,52.41%,26.29%,1
宜蘭縣,宜蘭市,0072,288,235,523,80,603,1015,59.41%,28.37%,1
宜蘭縣,宜蘭市,0073,147,91,238,26,264,424,62.26%,34.67%,1
宜蘭縣,宜蘭市,0074,281,201,482,82,564,964,58.51%,29.15%,1
宜蘭縣,宜蘭市,0075,255,189,444,72,516,959,53.81%,26.59%,1
宜蘭縣,宜蘭市,0076,264,190,454,56,510,814,62.65%,32.43%,1
宜蘭縣,宜蘭市,0077,236,220,456,70,526,885,59.44%,26.67%,1
宜蘭縣,宜蘭市,0078,303,278,581,93,674,1162,58%,26.08%,1
宜蘭縣,羅東鎮,0079,202,157,359,47,406,689,58.93%,29.32%,1
宜蘭縣,羅東鎮,0080,215,142,357,40,397,718,55.29%,29.94%,1
宜蘭縣,羅東鎮,0081,432,301,733,87,820,1475,55.59%,29.29%,1
宜蘭縣,羅東鎮,0082,417,285,702,95,797,1466,54.37%,28.44%,1
宜蘭縣,羅東鎮,0083,314,232,546,57,603,1075,56.09%,29.21%,1
宜蘭縣,羅東鎮,0084,262,211,473,64,537,963,55.76%,27.21%,1
宜蘭縣,羅東鎮,0085,406,308,714,99,813,1511,53.81%,26.87%,1
宜蘭縣,羅東鎮,0086,298,290,588,46,634,1166,54.37%,25.56%,1
宜蘭縣,羅東鎮,0087,400,247,647,87,734,1273,57.66%,31.42%,1
宜蘭縣,羅東鎮,0088,502,352,854,58,912,1735,52.56%,28.93%,1
宜蘭縣,羅東鎮,0089,454,288,742,100,842,1487,56.62%,30.53%,1
宜蘭縣,羅東鎮,0090,257,196,453,52,505,837,60.33%,30.7%,1
宜蘭縣,羅東鎮,0091,374,340,714,74,788,1312,60.06%,28.51%,1
宜蘭縣,羅東鎮,0092,413,288,701,100,801,1502,53.33%,27.5%,1
宜蘭縣,羅東鎮,0093,326,224,550,41,591,1138,51.93%,28.65%,1
宜蘭縣,羅東鎮,0094,303,200,503,60,563,1010,55.74%,30%,1
宜蘭縣,羅東鎮,0095,370,296,666,125,791,1373,57.61%,26.95%,1
宜蘭縣,羅東鎮,0096,318,228,546,59,605,1089,55.56%,29.2%,1
宜蘭縣,羅東鎮,0097,363,277,640,72,712,1304,54.6%,27.84%,1
宜蘭縣,羅東鎮,0098,339,258,597,97,694,1288,53.88%,26.32%,1
宜蘭縣,羅東鎮,0099,337,239,576,65,641,1036,61.87%,32.53%,1
宜蘭縣,羅東鎮,0100,334,201,535,79,614,969,63.36%,34.47%,1
宜蘭縣,羅東鎮,0101,309,222,531,63,594,985,60.3%,31.37%,1
宜蘭縣,羅東鎮,0102,423,316,739,101,840,1420,59.15%,29.79%,1
宜蘭縣,羅東鎮,0103,453,307,760,61,821,1430,57.41%,31.68%,1
宜蘭縣,羅東鎮,0104,343,216,559,74,633,1075,58.88%,31.91%,1
宜蘭縣,羅東鎮,0105,274,192,466,57,523,879,59.5%,31.17%,1
宜蘭縣,羅東鎮,0106,245,186,431,41,472,850,55.53%,28.82%,1
宜蘭縣,羅東鎮,0107,369,235,604,58,662,1111,59.59%,33.21%,1
宜蘭縣,羅東鎮,0108,413,237,650,60,710,1139,62.34%,36.26%,1
宜蘭縣,羅東鎮,0109,360,263,623,71,694,1130,61.42%,31.86%,1
宜蘭縣,羅東鎮,0110,300,230,530,51,581,980,59.29%,30.61%,1
宜蘭縣,羅東鎮,0111,455,272,727,78,805,1431,56.25%,31.8%,1
宜蘭縣,羅東鎮,0112,353,225,578,55,633,1109,57.08%,31.83%,1
宜蘭縣,羅東鎮,0113,335,220,555,54,609,1083,56.23%,30.93%,1
宜蘭縣,羅東鎮,0114,410,329,739,76,815,1404,58.05%,29.2%,1
宜蘭縣,羅東鎮,0115,406,264,670,72,742,1288,57.61%,31.52%,1
宜蘭縣,羅東鎮,0116,278,215,493,54,547,1183,46.24%,23.5%,1
宜蘭縣,羅東鎮,0117,343,265,608,53,661,1105,59.82%,31.04%,1
宜蘭縣,羅東鎮,0118,318,231,549,55,604,987,61.2%,32.22%,1
宜蘭縣,羅東鎮,0119,243,175,418,52,470,773,60.8%,31.44%,1
宜蘭縣,羅東鎮,0120,483,322,805,63,868,1366,63.54%,35.36%,1
宜蘭縣,羅東鎮,0121,357,192,549,35,584,907,64.39%,39.36%,1
宜蘭縣,羅東鎮,0122,385,273,658,60,718,1158,62%,33.25%,1
宜蘭縣,羅東鎮,0123,268,203,471,97,568,977,58.14%,27.43%,1
宜蘭縣,羅東鎮,0124,263,205,468,62,530,972,54.53%,27.06%,1
宜蘭縣,羅東鎮,0125,318,209,527,52,579,977,59.26%,32.55%,1
宜蘭縣,羅東鎮,0126,439,304,743,76,819,1398,58.58%,31.4%,1
宜蘭縣,羅東鎮,0127,315,216,531,44,575,1022,56.26%,30.82%,1
宜蘭縣,羅東鎮,0128,365,251,616,69,685,1131,60.57%,32.27%,1
宜蘭縣,蘇澳鎮,0129,329,267,596,80,676,1194,56.62%,27.55%,1
宜蘭縣,蘇澳鎮,0130,313,218,531,55,586,1128,51.95%,27.75%,1
宜蘭縣,蘇澳鎮,0131,361,212,573,69,642,1042,61.61%,34.64%,1
宜蘭縣,蘇澳鎮,0132,318,215,533,53,586,997,58.78%,31.9%,1
宜蘭縣,蘇澳鎮,0133,419,244,663,73,736,1303,56.49%,32.16%,1
宜蘭縣,蘇澳鎮,0134,411,241,652,94,746,1260,59.21%,32.62%,1
宜蘭縣,蘇澳鎮,0135,337,190,527,136,663,1130,58.67%,29.82%,1
宜蘭縣,蘇澳鎮,0136,151,117,268,47,315,559,56.35%,27.01%,1
宜蘭縣,蘇澳鎮,0137,98,55,153,34,187,351,53.28%,27.92%,1
宜蘭縣,蘇澳鎮,0138,258,167,425,65,490,889,55.12%,29.02%,1
宜蘭縣,蘇澳鎮,0139,107,91,198,44,242,434,55.76%,24.65%,1
宜蘭縣,蘇澳鎮,0140,248,205,453,37,490,835,58.68%,29.7%,1
宜蘭縣,蘇澳鎮,0141,284,206,490,66,556,975,57.03%,29.13%,1
宜蘭縣,蘇澳鎮,0142,339,230,569,110,679,1135,59.82%,29.87%,1
宜蘭縣,蘇澳鎮,0143,255,200,455,57,512,788,64.97%,32.36%,1
宜蘭縣,蘇澳鎮,0144,121,90,211,39,250,469,53.3%,25.8%,1
宜蘭縣,蘇澳鎮,0145,230,147,377,54,431,811,53.14%,28.36%,1
宜蘭縣,蘇澳鎮,0146,252,179,431,37,468,867,53.98%,29.07%,1
宜蘭縣,蘇澳鎮,0147,375,202,577,64,641,1139,56.28%,32.92%,1
宜蘭縣,蘇澳鎮,0148,339,195,534,70,604,1146,52.71%,29.58%,1
宜蘭縣,蘇澳鎮,0149,338,222,560,91,651,1154,56.41%,29.29%,1
宜蘭縣,蘇澳鎮,0150,243,183,426,33,459,908,50.55%,26.76%,1
宜蘭縣,蘇澳鎮,0151,212,124,336,29,365,656,55.64%,32.32%,1
宜蘭縣,蘇澳鎮,0152,254,182,436,74,510,834,61.15%,30.46%,1
宜蘭縣,蘇澳鎮,0153,347,215,562,51,613,1025,59.8%,33.85%,1
宜蘭縣,蘇澳鎮,0154,134,112,246,21,267,455,58.68%,29.45%,1
宜蘭縣,蘇澳鎮,0155,155,118,273,40,313,535,58.5%,28.97%,1
宜蘭縣,蘇澳鎮,0156,165,135,300,40,340,536,63.43%,30.78%,1
宜蘭縣,蘇澳鎮,0157,149,107,256,19,275,451,60.98%,33.04%,1
宜蘭縣,蘇澳鎮,0158,178,104,282,50,332,593,55.99%,30.02%,1
宜蘭縣,蘇澳鎮,0159,140,79,219,30,249,441,56.46%,31.75%,1
宜蘭縣,蘇澳鎮,0160,288,184,472,75,547,954,57.34%,30.19%,1
宜蘭縣,蘇澳鎮,0161,257,166,423,96,519,952,54.52%,27%,1
宜蘭縣,蘇澳鎮,0162,291,197,488,102,590,1125,52.44%,25.87%,1
宜蘭縣,蘇澳鎮,0163,217,122,339,94,433,763,56.75%,28.44%,1
宜蘭縣,蘇澳鎮,0164,154,91,245,68,313,706,44.33%,21.81%,1
宜蘭縣,蘇澳鎮,0165,246,188,434,82,516,1068,48.31%,23.03%,1
宜蘭縣,蘇澳鎮,0166,191,122,313,75,388,666,58.26%,28.68%,1
宜蘭縣,蘇澳鎮,0167,132,97,229,99,328,574,57.14%,23%,1
宜蘭縣,蘇澳鎮,0168,53,65,118,16,134,351,38.18%,15.1%,1
宜蘭縣,蘇澳鎮,0169,229,120,349,55,404,717,56.35%,31.94%,1
宜蘭縣,蘇澳鎮,0170,84,45,129,24,153,373,41.02%,22.52%,1
宜蘭縣,蘇澳鎮,0171,48,16,64,13,77,223,34.53%,21.52%,1
宜蘭縣,頭城鎮,0172,58,33,91,17,108,292,36.99%,19.86%,1
宜蘭縣,頭城鎮,0173,183,118,301,69,370,688,53.78%,26.6%,1
宜蘭縣,頭城鎮,0174,202,144,346,50,396,688,57.56%,29.36%,1
宜蘭縣,頭城鎮,0175,211,165,376,74,450,879,51.19%,24%,1
宜蘭縣,頭城鎮,0176,95,77,172,32,204,335,60.9%,28.36%,1
宜蘭縣,頭城鎮,0177,146,176,322,71,393,624,62.98%,23.4%,1
宜蘭縣,頭城鎮,0178,168,115,283,61,344,732,46.99%,22.95%,1
宜蘭縣,頭城鎮,0179,206,140,346,73,419,892,46.97%,23.09%,1
宜蘭縣,頭城鎮,0180,159,118,277,35,312,690,45.22%,23.04%,1
宜蘭縣,頭城鎮,0181,233,161,394,58,452,842,53.68%,27.67%,1
宜蘭縣,頭城鎮,0182,211,148,359,51,410,736,55.71%,28.67%,1
宜蘭縣,頭城鎮,0183,209,141,350,43,393,788,49.87%,26.52%,1
宜蘭縣,頭城鎮,0184,132,110,242,46,288,560,51.43%,23.57%,1
宜蘭縣,頭城鎮,0185,231,136,367,57,424,712,59.55%,32.44%,1
宜蘭縣,頭城鎮,0186,163,123,286,35,321,502,63.94%,32.47%,1
宜蘭縣,頭城鎮,0187,185,138,323,36,359,569,63.09%,32.51%,1
宜蘭縣,頭城鎮,0188,179,140,319,42,361,633,57.03%,28.28%,1
宜蘭縣,頭城鎮,0189,256,197,453,80,533,1132,47.08%,22.61%,1
宜蘭縣,頭城鎮,0190,249,172,421,74,495,1035,47.83%,24.06%,1
宜蘭縣,頭城鎮,0191,246,200,446,58,504,847,59.5%,29.04%,1
宜蘭縣,頭城鎮,0192,345,248,593,71,664,1172,56.66%,29.44%,1
宜蘭縣,頭城鎮,0193,255,174,429,40,469,896,52.34%,28.46%,1
宜蘭縣,頭城鎮,0194,331,245,576,46,622,1075,57.86%,30.79%,1
宜蘭縣,頭城鎮,0195,255,219,474,75,549,931,58.97%,27.39%,1
宜蘭縣,頭城鎮,0196,319,172,491,71,562,1021,55.04%,31.24%,1
宜蘭縣,頭城鎮,0197,177,114,291,59,350,709,49.37%,24.96%,1
宜蘭縣,頭城鎮,0198,231,167,398,44,442,689,64.15%,33.53%,1
宜蘭縣,頭城鎮,0199,209,121,330,55,385,615,62.6%,33.98%,1
宜蘭縣,頭城鎮,0200,234,122,356,59,415,759,54.68%,30.83%,1
宜蘭縣,頭城鎮,0201,276,211,487,73,560,917,61.07%,30.1%,1
宜蘭縣,頭城鎮,0202,304,211,515,84,599,1045,57.32%,29.09%,1
宜蘭縣,頭城鎮,0203,295,255,550,90,640,1130,56.64%,26.11%,1
宜蘭縣,礁溪鄉,0204,298,179,477,55,532,1122,47.42%,26.56%,1
宜蘭縣,礁溪鄉,0205,130,96,226,41,267,505,52.87%,25.74%,1
宜蘭縣,礁溪鄉,0206,258,192,450,61,511,988,51.72%,26.11%,1
宜蘭縣,礁溪鄉,0207,351,118,469,46,515,971,53.04%,36.15%,1
宜蘭縣,礁溪鄉,0208,324,228,552,68,620,1246,49.76%,26%,1
宜蘭縣,礁溪鄉,0209,410,312,722,55,777,1655,46.95%,24.77%,1
宜蘭縣,礁溪鄉,0210,287,203,490,28,518,1132,45.76%,25.35%,1
宜蘭縣,礁溪鄉,0211,237,165,402,37,439,783,56.07%,30.27%,1
宜蘭縣,礁溪鄉,0212,247,199,446,52,498,928,53.66%,26.62%,1
宜蘭縣,礁溪鄉,0213,247,160,407,49,456,848,53.77%,29.13%,1
宜蘭縣,礁溪鄉,0214,229,135,364,53,417,663,62.9%,34.54%,1
宜蘭縣,礁溪鄉,0215,199,117,316,25,341,608,56.09%,32.73%,1
宜蘭縣,礁溪鄉,0216,256,161,417,48,465,833,55.82%,30.73%,1
宜蘭縣,礁溪鄉,0217,297,225,522,41,563,1233,45.66%,24.09%,1
宜蘭縣,礁溪鄉,0218,261,164,425,54,479,854,56.09%,30.56%,1
宜蘭縣,礁溪鄉,0219,156,109,265,38,303,575,52.7%,27.13%,1
宜蘭縣,礁溪鄉,0220,234,174,408,60,468,835,56.05%,28.02%,1
宜蘭縣,礁溪鄉,0221,403,257,660,86,746,1305,57.16%,30.88%,1
宜蘭縣,礁溪鄉,0222,219,164,383,77,460,830,55.42%,26.39%,1
宜蘭縣,礁溪鄉,0223,216,150,366,61,427,649,65.79%,33.28%,1
宜蘭縣,礁溪鄉,0224,217,176,393,68,461,923,49.95%,23.51%,1
宜蘭縣,礁溪鄉,0225,306,169,475,59,534,1177,45.37%,26%,1
宜蘭縣,礁溪鄉,0226,264,147,411,51,462,840,55%,31.43%,1
宜蘭縣,礁溪鄉,0227,293,224,517,59,576,1051,54.8%,27.88%,1
宜蘭縣,礁溪鄉,0228,369,222,591,73,664,1339,49.59%,27.56%,1
宜蘭縣,礁溪鄉,0229,384,234,618,84,702,1194,58.79%,32.16%,1
宜蘭縣,礁溪鄉,0230,351,304,655,119,774,1314,58.9%,26.71%,1
宜蘭縣,礁溪鄉,0231,313,245,558,42,600,1125,53.33%,27.82%,1
宜蘭縣,礁溪鄉,0232,375,252,627,95,722,1207,59.82%,31.07%,1
宜蘭縣,礁溪鄉,0233,262,209,471,77,548,979,55.98%,26.76%,1
宜蘭縣,礁溪鄉,0234,295,213,508,77,585,954,61.32%,30.92%,1
宜蘭縣,礁溪鄉,0235,118,98,216,8,224,418,53.59%,28.23%,1
宜蘭縣,壯圍鄉,0236,438,299,737,125,862,1435,60.07%,30.52%,1
宜蘭縣,壯圍鄉,0237,312,235,547,77,624,1049,59.49%,29.74%,1
宜蘭縣,壯圍鄉,0238,299,252,551,104,655,1068,61.33%,28%,1
宜蘭縣,壯圍鄉,0239,223,172,395,103,498,868,57.37%,25.69%,1
宜蘭縣,壯圍鄉,0240,273,182,455,55,510,967,52.74%,28.23%,1
宜蘭縣,壯圍鄉,0241,278,214,492,84,576,940,61.28%,29.57%,1
宜蘭縣,壯圍鄉,0242,255,134,389,62,451,975,46.26%,26.15%,1
宜蘭縣,壯圍鄉,0243,224,178,402,86,488,797,61.23%,28.11%,1
宜蘭縣,壯圍鄉,0244,237,133,370,97,467,808,57.8%,29.33%,1
宜蘭縣,壯圍鄉,0245,247,187,434,106,540,911,59.28%,27.11%,1
宜蘭縣,壯圍鄉,0246,175,101,276,40,316,612,51.63%,28.59%,1
宜蘭縣,壯圍鄉,0247,241,183,424,81,505,790,63.92%,30.51%,1
宜蘭縣,壯圍鄉,0248,270,176,446,78,524,878,59.68%,30.75%,1
宜蘭縣,壯圍鄉,0249,242,167,409,63,472,723,65.28%,33.47%,1
宜蘭縣,壯圍鄉,0250,179,141,320,46,366,737,49.66%,24.29%,1
宜蘭縣,壯圍鄉,0251,203,140,343,70,413,686,60.2%,29.59%,1
宜蘭縣,壯圍鄉,0252,269,171,440,6,446,895,49.83%,30.06%,1
宜蘭縣,壯圍鄉,0253,386,280,666,89,755,1237,61.03%,31.2%,1
宜蘭縣,壯圍鄉,0254,362,202,564,86,650,1134,57.32%,31.92%,1
宜蘭縣,壯圍鄉,0255,316,209,525,85,610,1107,55.1%,28.55%,1
宜蘭縣,壯圍鄉,0256,310,228,538,70,608,1057,57.52%,29.33%,1
宜蘭縣,壯圍鄉,0257,286,203,489,46,535,1051,50.9%,27.21%,1
宜蘭縣,壯圍鄉,0258,209,129,338,61,399,722,55.26%,28.95%,1
宜蘭縣,員山鄉,0259,406,244,650,54,704,1393,50.54%,29.15%,1
宜蘭縣,員山鄉,0260,237,188,425,40,465,895,51.96%,26.48%,1
宜蘭縣,員山鄉,0261,332,229,561,102,663,1231,53.86%,26.97%,1
宜蘭縣,員山鄉,0262,313,198,511,48,559,1098,50.91%,28.51%,1
宜蘭縣,員山鄉,0263,282,191,473,62,535,1031,51.89%,27.35%,1
宜蘭縣,員山鄉,0264,167,303,470,85,555,1030,53.88%,16.21%,1
宜蘭縣,員山鄉,0265,233,258,491,59,550,1168,47.09%,19.95%,1
宜蘭縣,員山鄉,0266,220,161,381,78,459,809,56.74%,27.19%,1
宜蘭縣,員山鄉,0267,218,163,381,70,451,778,57.97%,28.02%,1
宜蘭縣,員山鄉,0268,459,283,742,102,844,1465,57.61%,31.33%,1
宜蘭縣,員山鄉,0269,300,202,502,76,578,979,59.04%,30.64%,1
宜蘭縣,員山鄉,0270,245,167,412,66,478,860,55.58%,28.49%,1
宜蘭縣,員山鄉,0271,287,214,501,101,602,1205,49.96%,23.82%,1
宜蘭縣,員山鄉,0272,309,190,499,117,616,1082,56.93%,28.56%,1
宜蘭縣,員山鄉,0273,111,93,204,39,243,412,58.98%,26.94%,1
宜蘭縣,員山鄉,0274,89,72,161,26,187,403,46.4%,22.08%,1
宜蘭縣,員山鄉,0275,54,36,90,14,104,232,44.83%,23.28%,1
宜蘭縣,員山鄉,0276,265,189,454,50,504,944,53.39%,28.07%,1
宜蘭縣,員山鄉,0277,248,176,424,74,498,894,55.7%,27.74%,1
宜蘭縣,員山鄉,0278,378,276,654,101,755,1356,55.68%,27.88%,1
宜蘭縣,員山鄉,0279,214,182,396,58,454,780,58.21%,27.44%,1
宜蘭縣,員山鄉,0280,262,238,500,93,593,932,63.63%,28.11%,1
宜蘭縣,員山鄉,0281,125,123,248,52,300,583,51.46%,21.44%,1
宜蘭縣,員山鄉,0282,245,181,426,78,504,900,56%,27.22%,1
宜蘭縣,員山鄉,0283,205,141,346,55,401,747,53.68%,27.44%,1
宜蘭縣,員山鄉,0284,217,143,360,70,430,788,54.57%,27.54%,1
宜蘭縣,員山鄉,0285,229,149,378,82,460,884,52.04%,25.9%,1
宜蘭縣,員山鄉,0286,233,138,371,41,412,857,48.07%,27.19%,1
宜蘭縣,員山鄉,0287,238,203,441,52,493,1016,48.52%,23.43%,1
宜蘭縣,員山鄉,0288,155,100,255,51,306,690,44.35%,22.46%,1
宜蘭縣,員山鄉,0289,166,118,284,78,362,689,52.54%,24.09%,1
宜蘭縣,冬山鄉,0290,245,179,424,63,487,807,60.35%,30.36%,1
宜蘭縣,冬山鄉,0291,264,174,438,27,465,817,56.92%,32.31%,1
宜蘭縣,冬山鄉,0292,347,237,584,74,658,1156,56.92%,30.02%,1
宜蘭縣,冬山鄉,0293,249,166,415,58,473,892,53.03%,27.91%,1
宜蘭縣,冬山鄉,0294,274,192,466,58,524,897,58.42%,30.55%,1
宜蘭縣,冬山鄉,0295,465,289,754,85,839,1392,60.27%,33.41%,1
宜蘭縣,冬山鄉,0296,448,320,768,68,836,1471,56.83%,30.46%,1
宜蘭縣,冬山鄉,0297,333,246,579,61,640,1435,44.6%,23.21%,1
宜蘭縣,冬山鄉,0298,427,296,723,49,772,1519,50.82%,28.11%,1
宜蘭縣,冬山鄉,0299,440,326,766,50,816,1456,56.04%,30.22%,1
宜蘭縣,冬山鄉,0300,233,143,376,56,432,711,60.76%,32.77%,1
宜蘭縣,冬山鄉,0301,221,145,366,41,407,694,58.65%,31.84%,1
宜蘭縣,冬山鄉,0302,541,342,883,73,956,1526,62.65%,35.45%,1
宜蘭縣,冬山鄉,0303,261,186,447,34,481,884,54.41%,29.52%,1
宜蘭縣,冬山鄉,0304,382,241,623,90,713,1465,48.67%,26.08%,1
宜蘭縣,冬山鄉,0305,149,102,251,26,277,488,56.76%,30.53%,1
宜蘭縣,冬山鄉,0306,351,214,565,83,648,1218,53.2%,28.82%,1
宜蘭縣,冬山鄉,0307,350,238,588,69,657,1291,50.89%,27.11%,1
宜蘭縣,冬山鄉,0308,359,252,611,54,665,1324,50.23%,27.11%,1
宜蘭縣,冬山鄉,0309,337,196,533,41,574,1160,49.48%,29.05%,1
宜蘭縣,冬山鄉,0310,366,220,586,82,668,1246,53.61%,29.37%,1
宜蘭縣,冬山鄉,0311,447,367,814,66,880,1754,50.17%,25.48%,1
宜蘭縣,冬山鄉,0312,337,256,593,51,644,1217,52.92%,27.69%,1
宜蘭縣,冬山鄉,0313,413,249,662,60,722,1495,48.29%,27.63%,1
宜蘭縣,冬山鄉,0314,280,184,464,46,510,937,54.43%,29.88%,1
宜蘭縣,冬山鄉,0315,309,209,518,41,559,1101,50.77%,28.07%,1
宜蘭縣,冬山鄉,0316,287,221,508,74,582,1118,52.06%,25.67%,1
宜蘭縣,冬山鄉,0317,409,297,706,51,757,1301,58.19%,31.44%,1
宜蘭縣,冬山鄉,0318,340,258,598,42,640,1225,52.24%,27.76%,1
宜蘭縣,冬山鄉,0319,382,261,643,66,709,1206,58.79%,31.67%,1
宜蘭縣,冬山鄉,0320,336,247,583,51,634,1278,49.61%,26.29%,1
宜蘭縣,冬山鄉,0321,313,217,530,65,595,1151,51.69%,27.19%,1
宜蘭縣,冬山鄉,0322,295,170,465,76,541,1094,49.45%,26.97%,1
宜蘭縣,冬山鄉,0323,363,281,644,65,709,1247,56.86%,29.11%,1
宜蘭縣,冬山鄉,0324,337,222,559,68,627,1247,50.28%,27.02%,1
宜蘭縣,冬山鄉,0325,285,215,500,31,531,979,54.24%,29.11%,1
宜蘭縣,冬山鄉,0326,237,158,395,30,425,698,60.89%,33.95%,1
宜蘭縣,冬山鄉,0327,669,161,830,47,877,1726,50.81%,38.76%,1
宜蘭縣,冬山鄉,0328,163,144,307,26,333,782,42.58%,20.84%,1
宜蘭縣,五結鄉,0329,283,197,480,71,551,1076,51.21%,26.3%,1
宜蘭縣,五結鄉,0330,234,218,452,36,488,944,51.69%,24.79%,1
宜蘭縣,五結鄉,0331,266,153,419,41,460,836,55.02%,31.82%,1
宜蘭縣,五結鄉,0332,271,200,471,61,532,937,56.78%,28.92%,1
宜蘭縣,五結鄉,0333,314,293,607,47,654,1255,52.11%,25.02%,1
宜蘭縣,五結鄉,0334,300,288,588,98,686,1270,54.02%,23.62%,1
宜蘭縣,五結鄉,0335,211,154,365,29,394,801,49.19%,26.34%,1
宜蘭縣,五結鄉,0336,223,148,371,47,418,802,52.12%,27.81%,1
宜蘭縣,五結鄉,0337,360,228,588,61,649,1306,49.69%,27.57%,1
宜蘭縣,五結鄉,0338,347,216,563,65,628,1190,52.77%,29.16%,1
宜蘭縣,五結鄉,0339,376,269,645,34,679,1316,51.6%,28.57%,1
宜蘭縣,五結鄉,0340,294,191,485,38,523,965,54.2%,30.47%,1
宜蘭縣,五結鄉,0341,233,151,384,51,435,814,53.44%,28.62%,1
宜蘭縣,五結鄉,0342,341,242,583,55,638,1254,50.88%,27.19%,1
宜蘭縣,五結鄉,0343,312,218,530,73,603,1060,56.89%,29.43%,1
宜蘭縣,五結鄉,0344,431,238,669,61,730,1323,55.18%,32.58%,1
宜蘭縣,五結鄉,0345,360,211,571,68,639,1120,57.05%,32.14%,1
宜蘭縣,五結鄉,0346,286,154,440,36,476,893,53.3%,32.03%,1
宜蘭縣,五結鄉,0347,320,275,595,54,649,1220,53.2%,26.23%,1
宜蘭縣,五結鄉,0348,304,197,501,37,538,924,58.23%,32.9%,1
宜蘭縣,五結鄉,0349,307,193,500,61,561,933,60.13%,32.9%,1
宜蘭縣,五結鄉,0350,285,194,479,49,528,986,53.55%,28.9%,1
宜蘭縣,五結鄉,0351,210,139,349,59,408,748,54.55%,28.07%,1
宜蘭縣,五結鄉,0352,428,300,728,108,836,1550,53.94%,27.61%,1
宜蘭縣,五結鄉,0353,200,111,311,45,356,629,56.6%,31.8%,1
宜蘭縣,五結鄉,0354,231,137,368,71,439,806,54.47%,28.66%,1
宜蘭縣,五結鄉,0355,228,209,437,60,497,956,51.99%,23.85%,1
宜蘭縣,五結鄉,0356,300,217,517,52,569,1066,53.38%,28.14%,1
宜蘭縣,五結鄉,0357,395,270,665,85,750,1513,49.57%,26.11%,1
宜蘭縣,五結鄉,0358,445,293,738,86,824,1566,52.62%,28.42%,1
宜蘭縣,五結鄉,0359,239,171,410,87,497,894,55.59%,26.73%,1
宜蘭縣,五結鄉,0360,267,215,482,100,582,1235,47.13%,21.62%,1
宜蘭縣,五結鄉,0361,214,119,333,65,398,704,56.53%,30.4%,1
宜蘭縣,三星鄉,0362,52,43,95,19,114,215,53.02%,24.19%,1
宜蘭縣,三星鄉,0363,120,81,201,40,241,523,46.08%,22.94%,1
宜蘭縣,三星鄉,0364,172,172,344,46,390,745,52.35%,23.09%,1
宜蘭縣,三星鄉,0365,127,140,267,45,312,617,50.57%,20.58%,1
宜蘭縣,三星鄉,0366,108,110,218,48,266,497,53.52%,21.73%,1
宜蘭縣,三星鄉,0367,192,166,358,53,411,735,55.92%,26.12%,1
宜蘭縣,三星鄉,0368,154,109,263,61,324,583,55.57%,26.42%,1
宜蘭縣,三星鄉,0369,112,86,198,37,235,436,53.9%,25.69%,1
宜蘭縣,三星鄉,0370,338,219,557,87,644,1224,52.61%,27.61%,1
宜蘭縣,三星鄉,0371,269,215,484,66,550,1151,47.78%,23.37%,1
宜蘭縣,三星鄉,0372,269,180,449,30,479,870,55.06%,30.92%,1
宜蘭縣,三星鄉,0373,278,187,465,69,534,1284,41.59%,21.65%,1
宜蘭縣,三星鄉,0374,275,196,471,59,530,897,59.09%,30.66%,1
宜蘭縣,三星鄉,0375,430,270,700,80,780,1439,54.2%,29.88%,1
宜蘭縣,三星鄉,0376,389,264,653,83,736,1445,50.93%,26.92%,1
宜蘭縣,三星鄉,0377,385,272,657,65,722,1402,51.5%,27.46%,1
宜蘭縣,三星鄉,0378,318,253,571,73,644,1230,52.36%,25.85%,1
宜蘭縣,三星鄉,0379,240,131,371,61,432,774,55.81%,31.01%,1
宜蘭縣,三星鄉,0380,274,159,433,47,480,827,58.04%,33.13%,1
宜蘭縣,三星鄉,0381,226,129,355,36,391,736,53.13%,30.71%,1
宜蘭縣,三星鄉,0382,363,275,638,110,748,1421,52.64%,25.55%,1
宜蘭縣,大同鄉,0383,183,119,302,68,370,893,41.43%,20.49%,1
宜蘭縣,大同鄉,0384,221,151,372,88,460,632,72.78%,34.97%,1
宜蘭縣,大同鄉,0385,179,109,288,28,316,684,46.2%,26.17%,1
宜蘭縣,大同鄉,0386,89,55,144,31,175,264,66.29%,33.71%,1
宜蘭縣,大同鄉,0387,73,36,109,9,118,337,35.01%,21.66%,1
宜蘭縣,大同鄉,0388,85,58,143,9,152,404,37.62%,21.04%,1
宜蘭縣,大同鄉,0389,10,10,20,6,26,55,47.27%,18.18%,1
宜蘭縣,大同鄉,0390,60,62,122,31,153,199,76.88%,30.15%,1
宜蘭縣,大同鄉,0391,129,99,228,27,255,787,32.4%,16.39%,1
宜蘭縣,大同鄉,0392,193,108,301,65,366,680,53.82%,28.38%,1
宜蘭縣,南澳鄉,0393,142,67,209,17,226,444,50.9%,31.98%,1
宜蘭縣,南澳鄉,0394,386,174,560,43,603,1210,49.83%,31.9%,1
宜蘭縣,南澳鄉,0395,316,186,502,100,602,962,62.58%,32.85%,1
宜蘭縣,南澳鄉,0396,92,43,135,16,151,411,36.74%,22.38%,1
宜蘭縣,南澳鄉,0397,145,132,277,29,306,447,68.46%,32.44%,1
宜蘭縣,南澳鄉,0398,176,127,303,65,368,475,77.47%,37.05%,1
宜蘭縣,南澳鄉,0399,234,118,352,59,411,695,59.14%,33.67%,1
花蓮縣,花蓮市,0001,525,303,828,39,867,1522,56.96%,34.49%,1
花蓮縣,花蓮市,0002,375,229,604,49,653,1114,58.62%,33.66%,1
花蓮縣,花蓮市,0003,212,128,340,35,375,670,55.97%,31.64%,1
花蓮縣,花蓮市,0004,446,264,710,32,742,1397,53.11%,31.93%,1
花蓮縣,花蓮市,0005,119,87,206,34,240,470,51.06%,25.32%,1
花蓮縣,花蓮市,0006,261,139,400,32,432,838,51.55%,31.15%,1
花蓮縣,花蓮市,0007,174,102,276,25,301,721,41.75%,24.13%,1
花蓮縣,花蓮市,0008,290,196,486,46,532,918,57.95%,31.59%,1
花蓮縣,花蓮市,0009,458,285,743,67,810,1539,52.63%,29.76%,1
花蓮縣,花蓮市,0010,454,235,689,57,746,1403,53.17%,32.36%,1
花蓮縣,花蓮市,0011,303,212,515,49,564,1068,52.81%,28.37%,1
花蓮縣,花蓮市,0012,388,229,617,28,645,1167,55.27%,33.25%,1
花蓮縣,花蓮市,0013,427,250,677,74,751,1259,59.65%,33.92%,1
花蓮縣,花蓮市,0014,310,197,507,86,593,1071,55.37%,28.94%,1
花蓮縣,花蓮市,0015,284,201,485,42,527,925,56.97%,30.7%,1
花蓮縣,花蓮市,0016,410,222,632,79,711,1141,62.31%,35.93%,1
花蓮縣,花蓮市,0017,362,210,572,30,602,1163,51.76%,31.13%,1
花蓮縣,花蓮市,0018,460,231,691,51,742,1279,58.01%,35.97%,1
花蓮縣,花蓮市,0019,440,248,688,36,724,1512,47.88%,29.1%,1
花蓮縣,花蓮市,0020,181,121,302,31,333,615,54.15%,29.43%,1
花蓮縣,花蓮市,0021,170,147,317,33,350,606,57.76%,28.05%,1
花蓮縣,花蓮市,0022,175,78,253,21,274,559,49.02%,31.31%,1
花蓮縣,花蓮市,0023,154,79,233,15,248,442,56.11%,34.84%,1
花蓮縣,花蓮市,0024,318,213,531,37,568,1114,50.99%,28.55%,1
花蓮縣,花蓮市,0025,140,83,223,13,236,416,56.73%,33.65%,1
花蓮縣,花蓮市,0026,214,115,329,24,353,577,61.18%,37.09%,1
花蓮縣,花蓮市,0027,265,201,466,28,494,810,60.99%,32.72%,1
花蓮縣,花蓮市,0028,175,111,286,23,309,538,57.43%,32.53%,1
花蓮縣,花蓮市,0029,176,101,277,32,309,566,54.59%,31.1%,1
花蓮縣,花蓮市,0030,159,81,240,10,250,469,53.3%,33.9%,1
花蓮縣,花蓮市,0031,175,126,301,20,321,565,56.81%,30.97%,1
花蓮縣,花蓮市,0032,249,119,368,34,402,816,49.26%,30.51%,1
花蓮縣,花蓮市,0033,250,171,421,57,478,911,52.47%,27.44%,1
花蓮縣,花蓮市,0034,296,183,479,59,538,1029,52.28%,28.77%,1
花蓮縣,花蓮市,0035,334,229,563,53,616,1043,59.06%,32.02%,1
花蓮縣,花蓮市,0036,290,177,467,28,495,856,57.83%,33.88%,1
花蓮縣,花蓮市,0037,301,198,499,41,540,979,55.16%,30.75%,1
花蓮縣,花蓮市,0038,431,256,687,63,750,1331,56.35%,32.38%,1
花蓮縣,花蓮市,0039,401,244,645,48,693,1228,56.43%,32.65%,1
花蓮縣,花蓮市,0040,306,199,505,39,544,955,56.96%,32.04%,1
花蓮縣,花蓮市,0041,361,228,589,51,640,1268,50.47%,28.47%,1
花蓮縣,花蓮市,0042,381,216,597,48,645,1230,52.44%,30.98%,1
花蓮縣,花蓮市,0043,461,252,713,61,774,1369,56.54%,33.67%,1
花蓮縣,花蓮市,0044,385,225,610,38,648,1435,45.16%,26.83%,1
花蓮縣,花蓮市,0045,354,240,594,48,642,1164,55.15%,30.41%,1
花蓮縣,花蓮市,0046,448,236,684,50,734,1249,58.77%,35.87%,1
花蓮縣,花蓮市,0047,375,227,602,59,661,1184,55.83%,31.67%,1
花蓮縣,花蓮市,0048,475,260,735,39,774,1490,51.95%,31.88%,1
花蓮縣,花蓮市,0049,359,225,584,57,641,1022,62.72%,35.13%,1
花蓮縣,花蓮市,0050,313,233,546,92,638,1135,56.21%,27.58%,1
花蓮縣,花蓮市,0051,379,184,563,47,610,1084,56.27%,34.96%,1
花蓮縣,花蓮市,0052,282,180,462,39,501,1339,37.42%,21.06%,1
花蓮縣,花蓮市,0053,175,106,281,19,300,501,59.88%,34.93%,1
花蓮縣,花蓮市,0054,295,181,476,21,497,904,54.98%,32.63%,1
花蓮縣,花蓮市,0055,167,112,279,25,304,490,62.04%,34.08%,1
花蓮縣,花蓮市,0056,311,216,527,38,565,1192,47.4%,26.09%,1
花蓮縣,花蓮市,0057,249,159,408,30,438,869,50.4%,28.65%,1
花蓮縣,花蓮市,0058,396,223,619,53,672,1267,53.04%,31.25%,1
花蓮縣,花蓮市,0059,336,163,499,55,554,959,57.77%,35.04%,1
花蓮縣,花蓮市,0060,325,168,493,48,541,993,54.48%,32.73%,1
花蓮縣,花蓮市,0061,295,196,491,61,552,982,56.21%,30.04%,1
花蓮縣,花蓮市,0062,361,245,606,26,632,1311,48.21%,27.54%,1
花蓮縣,花蓮市,0063,410,288,698,51,749,1455,51.48%,28.18%,1
花蓮縣,花蓮市,0064,305,201,506,30,536,1151,46.57%,26.5%,1
花蓮縣,花蓮市,0065,347,227,574,35,609,1237,49.23%,28.05%,1
花蓮縣,花蓮市,0066,372,224,596,49,645,1339,48.17%,27.78%,1
花蓮縣,花蓮市,0067,242,148,390,25,415,715,58.04%,33.85%,1
花蓮縣,花蓮市,0068,311,199,510,49,559,1000,55.9%,31.1%,1
花蓮縣,花蓮市,0069,369,265,634,64,698,1410,49.5%,26.17%,1
花蓮縣,花蓮市,0070,409,254,663,27,690,1303,52.95%,31.39%,1
花蓮縣,花蓮市,0071,388,251,639,32,671,1256,53.42%,30.89%,1
花蓮縣,花蓮市,0072,364,208,572,64,636,1105,57.56%,32.94%,1
花蓮縣,花蓮市,0073,318,207,525,33,558,1089,51.24%,29.2%,1
花蓮縣,花蓮市,0074,287,199,486,30,516,1043,49.47%,27.52%,1
花蓮縣,花蓮市,0075,376,200,576,39,615,1080,56.94%,34.81%,1
花蓮縣,花蓮市,0076,323,178,501,48,549,971,56.54%,33.26%,1
花蓮縣,花蓮市,0077,346,241,587,24,611,1068,57.21%,32.4%,1
花蓮縣,花蓮市,0078,412,228,640,55,695,1379,50.4%,29.88%,1
花蓮縣,花蓮市,0079,397,260,657,61,718,1362,52.72%,29.15%,1
花蓮縣,花蓮市,0080,462,250,712,47,759,1323,57.37%,34.92%,1
花蓮縣,花蓮市,0081,386,246,632,41,673,1482,45.41%,26.05%,1
花蓮縣,鳳林鎮,0195,413,231,644,81,725,1192,60.82%,34.65%,1
花蓮縣,鳳林鎮,0196,178,115,293,31,324,639,50.7%,27.86%,1
花蓮縣,鳳林鎮,0197,212,137,349,51,400,601,66.56%,35.27%,1
花蓮縣,鳳林鎮,0198,434,234,668,58,726,1137,63.85%,38.17%,1
花蓮縣,鳳林鎮,0199,201,158,359,58,417,742,56.2%,27.09%,1
花蓮縣,鳳林鎮,0200,192,121,313,37,350,610,57.38%,31.48%,1
花蓮縣,鳳林鎮,0201,76,69,145,47,192,295,65.08%,25.76%,1
花蓮縣,鳳林鎮,0202,35,30,65,2,67,218,30.73%,16.06%,1
花蓮縣,鳳林鎮,0203,163,109,272,26,298,720,41.39%,22.64%,1
花蓮縣,鳳林鎮,0204,139,98,237,50,287,528,54.36%,26.33%,1
花蓮縣,鳳林鎮,0205,144,110,254,37,291,560,51.96%,25.71%,1
花蓮縣,鳳林鎮,0206,146,89,235,57,292,541,53.97%,26.99%,1
花蓮縣,鳳林鎮,0207,262,131,393,71,464,818,56.72%,32.03%,1
花蓮縣,鳳林鎮,0208,225,143,368,48,416,984,42.28%,22.87%,1
花蓮縣,鳳林鎮,0209,24,15,39,10,49,91,53.85%,26.37%,1
花蓮縣,玉里鎮,0254,315,177,492,54,546,1008,54.17%,31.25%,1
花蓮縣,玉里鎮,0255,282,221,503,55,558,939,59.42%,30.03%,1
花蓮縣,玉里鎮,0256,385,193,578,80,658,1256,52.39%,30.65%,1
花蓮縣,玉里鎮,0257,261,179,440,66,506,929,54.47%,28.09%,1
花蓮縣,玉里鎮,0258,289,200,489,49,538,979,54.95%,29.52%,1
花蓮縣,玉里鎮,0259,439,239,678,52,730,1244,58.68%,35.29%,1
花蓮縣,玉里鎮,0260,217,139,356,60,416,847,49.11%,25.62%,1
花蓮縣,玉里鎮,0261,180,143,323,57,380,772,49.22%,23.32%,1
花蓮縣,玉里鎮,0262,149,103,252,26,278,558,49.82%,26.7%,1
花蓮縣,玉里鎮,0263,139,91,230,30,260,800,32.5%,17.37%,1
花蓮縣,玉里鎮,0264,336,180,516,78,594,1286,46.19%,26.13%,1
花蓮縣,玉里鎮,0265,227,280,507,94,601,1246,48.23%,18.22%,1
花蓮縣,玉里鎮,0266,140,137,277,68,345,647,53.32%,21.64%,1
花蓮縣,玉里鎮,0267,135,72,207,17,224,990,22.63%,13.64%,1
花蓮縣,玉里鎮,0268,122,80,202,60,262,530,49.43%,23.02%,1
花蓮縣,玉里鎮,0269,168,140,308,54,362,979,36.98%,17.16%,1
花蓮縣,玉里鎮,0270,140,83,223,97,320,557,57.45%,25.13%,1
花蓮縣,玉里鎮,0271,89,48,137,24,161,434,37.1%,20.51%,1
花蓮縣,玉里鎮,0272,177,97,274,95,369,1065,34.65%,16.62%,1
花蓮縣,玉里鎮,0273,183,157,340,119,459,866,53%,21.13%,1
花蓮縣,玉里鎮,0274,154,103,257,61,318,769,41.35%,20.03%,1
花蓮縣,玉里鎮,0275,189,135,324,46,370,869,42.58%,21.75%,1
花蓮縣,玉里鎮,0276,337,54,391,56,447,1080,41.39%,31.2%,1
花蓮縣,新城鄉,0082,118,81,199,16,215,367,58.58%,32.15%,1
花蓮縣,新城鄉,0083,260,165,425,21,446,929,48.01%,27.99%,1
花蓮縣,新城鄉,0084,165,115,280,74,354,590,60%,27.97%,1
花蓮縣,新城鄉,0085,88,59,147,26,173,307,56.35%,28.66%,1
花蓮縣,新城鄉,0086,83,50,133,28,161,260,61.92%,31.92%,1
花蓮縣,新城鄉,0087,418,227,645,75,720,1283,56.12%,32.58%,1
花蓮縣,新城鄉,0088,255,153,408,39,447,885,50.51%,28.81%,1
花蓮縣,新城鄉,0089,230,165,395,44,439,770,57.01%,29.87%,1
花蓮縣,新城鄉,0090,430,237,667,74,741,1363,54.37%,31.55%,1
花蓮縣,新城鄉,0091,102,71,173,19,192,366,52.46%,27.87%,1
花蓮縣,新城鄉,0092,343,188,531,60,591,1163,50.82%,29.49%,1
花蓮縣,新城鄉,0093,474,303,777,66,843,1605,52.52%,29.53%,1
花蓮縣,新城鄉,0094,329,251,580,63,643,1194,53.85%,27.55%,1
花蓮縣,新城鄉,0095,333,179,512,40,552,979,56.38%,34.01%,1
花蓮縣,新城鄉,0096,485,280,765,56,821,1485,55.29%,32.66%,1
花蓮縣,新城鄉,0097,317,208,525,35,560,1070,52.34%,29.63%,1
花蓮縣,新城鄉,0098,359,231,590,45,635,1164,54.55%,30.84%,1
花蓮縣,新城鄉,0099,249,158,407,60,467,880,53.07%,28.3%,1
花蓮縣,新城鄉,0100,101,70,171,18,189,369,51.22%,27.37%,1
花蓮縣,吉安鄉,0115,319,187,506,52,558,1059,52.69%,30.12%,1
花蓮縣,吉安鄉,0116,300,188,488,59,547,983,55.65%,30.52%,1
花蓮縣,吉安鄉,0117,327,192,519,44,563,1031,54.61%,31.72%,1
花蓮縣,吉安鄉,0118,293,223,516,46,562,1105,50.86%,26.52%,1
花蓮縣,吉安鄉,0119,326,215,541,33,574,1107,51.85%,29.45%,1
花蓮縣,吉安鄉,0120,312,219,531,57,588,1179,49.87%,26.46%,1
花蓮縣,吉安鄉,0121,355,231,586,79,665,1453,45.77%,24.43%,1
花蓮縣,吉安鄉,0122,485,301,786,56,842,1432,58.8%,33.87%,1
花蓮縣,吉安鄉,0123,440,244,684,45,729,1320,55.23%,33.33%,1
花蓮縣,吉安鄉,0124,414,224,638,51,689,1356,50.81%,30.53%,1
花蓮縣,吉安鄉,0125,400,215,615,52,667,1295,51.51%,30.89%,1
花蓮縣,吉安鄉,0126,436,285,721,76,797,1467,54.33%,29.72%,1
花蓮縣,吉安鄉,0127,480,280,760,32,792,1515,52.28%,31.68%,1
花蓮縣,吉安鄉,0128,380,189,569,65,634,1063,59.64%,35.75%,1
花蓮縣,吉安鄉,0129,348,201,549,16,565,1284,44%,27.1%,1
花蓮縣,吉安鄉,0130,478,249,727,46,773,1380,56.01%,34.64%,1
花蓮縣,吉安鄉,0131,406,263,669,63,732,1297,56.44%,31.3%,1
花蓮縣,吉安鄉,0132,462,298,760,101,861,1662,51.81%,27.8%,1
花蓮縣,吉安鄉,0133,359,282,641,109,750,1563,47.98%,22.97%,1
花蓮縣,吉安鄉,0134,351,205,556,67,623,1288,48.37%,27.25%,1
花蓮縣,吉安鄉,0135,254,196,450,56,506,907,55.79%,28%,1
花蓮縣,吉安鄉,0136,239,192,431,43,474,917,51.69%,26.06%,1
花蓮縣,吉安鄉,0137,296,194,490,37,527,1021,51.62%,28.99%,1
花蓮縣,吉安鄉,0138,376,185,561,53,614,1033,59.44%,36.4%,1
花蓮縣,吉安鄉,0139,303,181,484,66,550,966,56.94%,31.37%,1
花蓮縣,吉安鄉,0140,249,303,552,71,623,1188,52.44%,20.96%,1
花蓮縣,吉安鄉,0141,437,287,724,40,764,1480,51.62%,29.53%,1
花蓮縣,吉安鄉,0142,378,238,616,56,672,1393,48.24%,27.14%,1
花蓮縣,吉安鄉,0143,345,206,551,44,595,1193,49.87%,28.92%,1
花蓮縣,吉安鄉,0144,422,230,652,45,697,1445,48.24%,29.2%,1
花蓮縣,吉安鄉,0145,360,247,607,107,714,1301,54.88%,27.67%,1
花蓮縣,吉安鄉,0146,389,247,636,56,692,1215,56.95%,32.02%,1
花蓮縣,吉安鄉,0147,341,220,561,49,610,1135,53.74%,30.04%,1
花蓮縣,吉安鄉,0148,416,247,663,32,695,1223,56.83%,34.01%,1
花蓮縣,吉安鄉,0149,403,246,649,52,701,1274,55.02%,31.63%,1
花蓮縣,吉安鄉,0150,345,197,542,53,595,1124,52.94%,30.69%,1
花蓮縣,吉安鄉,0151,394,220,614,38,652,1158,56.3%,34.02%,1
花蓮縣,吉安鄉,0152,364,246,610,35,645,1157,55.75%,31.46%,1
花蓮縣,吉安鄉,0153,381,257,638,49,687,1258,54.61%,30.29%,1
花蓮縣,吉安鄉,0154,384,264,648,23,671,1257,53.38%,30.55%,1
花蓮縣,吉安鄉,0155,404,209,613,34,647,1245,51.97%,32.45%,1
花蓮縣,吉安鄉,0156,413,218,631,17,648,1166,55.57%,35.42%,1
花蓮縣,吉安鄉,0157,403,223,626,82,708,1358,52.14%,29.68%,1
花蓮縣,吉安鄉,0158,367,218,585,44,629,1214,51.81%,30.23%,1
花蓮縣,吉安鄉,0159,339,209,548,70,618,1151,53.69%,29.45%,1
花蓮縣,吉安鄉,0160,358,232,590,47,637,1157,55.06%,30.94%,1
花蓮縣,吉安鄉,0161,402,208,610,46,656,1161,56.5%,34.63%,1
花蓮縣,吉安鄉,0162,411,262,673,63,736,1304,56.44%,31.52%,1
花蓮縣,吉安鄉,0163,418,237,655,63,718,1367,52.52%,30.58%,1
花蓮縣,吉安鄉,0164,397,207,604,60,664,1411,47.06%,28.14%,1
花蓮縣,吉安鄉,0165,392,202,594,73,667,1409,47.34%,27.82%,1
花蓮縣,吉安鄉,0166,312,180,492,45,537,1125,47.73%,27.73%,1
花蓮縣,吉安鄉,0167,340,247,587,85,672,1213,55.4%,28.03%,1
花蓮縣,吉安鄉,0168,348,221,569,55,624,1141,54.69%,30.5%,1
花蓮縣,吉安鄉,0169,292,193,485,41,526,1156,45.5%,25.26%,1
花蓮縣,吉安鄉,0170,319,181,500,62,562,1092,51.47%,29.21%,1
花蓮縣,吉安鄉,0171,249,167,416,50,466,1026,45.42%,24.27%,1
花蓮縣,吉安鄉,0172,242,153,395,30,425,804,52.86%,30.1%,1
花蓮縣,吉安鄉,0173,375,200,575,51,626,1132,55.3%,33.13%,1
花蓮縣,壽豐鄉,0174,249,204,453,50,503,1052,47.81%,23.67%,1
花蓮縣,壽豐鄉,0175,113,67,180,38,218,357,61.06%,31.65%,1
花蓮縣,壽豐鄉,0176,280,168,448,71,519,1022,50.78%,27.4%,1
花蓮縣,壽豐鄉,0177,274,216,490,58,548,875,62.63%,31.31%,1
花蓮縣,壽豐鄉,0178,203,170,373,50,423,691,61.22%,29.38%,1
花蓮縣,壽豐鄉,0179,146,153,299,30,329,708,46.47%,20.62%,1
花蓮縣,壽豐鄉,0180,218,182,400,73,473,894,52.91%,24.38%,1
花蓮縣,壽豐鄉,0181,210,154,364,43,407,746,54.56%,28.15%,1
花蓮縣,壽豐鄉,0182,241,182,423,47,470,881,53.35%,27.36%,1
花蓮縣,壽豐鄉,0183,249,150,399,36,435,695,62.59%,35.83%,1
花蓮縣,壽豐鄉,0184,222,193,415,97,512,816,62.75%,27.21%,1
花蓮縣,壽豐鄉,0185,218,129,347,49,396,773,51.23%,28.2%,1
花蓮縣,壽豐鄉,0186,292,223,515,70,585,1029,56.85%,28.38%,1
花蓮縣,壽豐鄉,0187,131,95,226,32,258,407,63.39%,32.19%,1
花蓮縣,壽豐鄉,0188,344,233,577,69,646,1139,56.72%,30.2%,1
花蓮縣,壽豐鄉,0189,291,235,526,48,574,996,57.63%,29.22%,1
花蓮縣,壽豐鄉,0190,102,72,174,13,187,414,45.17%,24.64%,1
花蓮縣,壽豐鄉,0191,87,58,145,12,157,270,58.15%,32.22%,1
花蓮縣,壽豐鄉,0192,274,151,425,63,488,836,58.37%,32.78%,1
花蓮縣,壽豐鄉,0193,165,118,283,26,309,507,60.95%,32.54%,1
花蓮縣,壽豐鄉,0194,156,98,254,62,316,739,42.76%,21.11%,1
花蓮縣,光復鄉,0210,355,259,614,111,725,1295,55.98%,27.41%,1
花蓮縣,光復鄉,0211,284,164,448,53,501,859,58.32%,33.06%,1
花蓮縣,光復鄉,0212,272,184,456,113,569,958,59.39%,28.39%,1
花蓮縣,光復鄉,0213,280,190,470,111,581,1011,57.47%,27.7%,1
花蓮縣,光復鄉,0214,335,190,525,78,603,1041,57.93%,32.18%,1
花蓮縣,光復鄉,0215,211,128,339,109,448,821,54.57%,25.7%,1
花蓮縣,光復鄉,0216,26,9,35,0,35,188,18.62%,13.83%,1
花蓮縣,光復鄉,0217,154,84,238,44,282,514,54.86%,29.96%,1
花蓮縣,光復鄉,0218,86,63,149,15,164,446,36.77%,19.28%,1
花蓮縣,光復鄉,0219,231,137,368,60,428,851,50.29%,27.14%,1
花蓮縣,光復鄉,0220,162,137,299,36,335,932,35.94%,17.38%,1
花蓮縣,光復鄉,0221,154,83,237,30,267,471,56.69%,32.7%,1
花蓮縣,光復鄉,0222,169,130,299,58,357,640,55.78%,26.41%,1
花蓮縣,光復鄉,0223,26,15,41,4,45,116,38.79%,22.41%,1
花蓮縣,光復鄉,0224,86,50,136,11,147,496,29.64%,17.34%,1
花蓮縣,光復鄉,0225,89,44,133,13,146,324,45.06%,27.47%,1
花蓮縣,光復鄉,0226,103,44,147,29,176,454,38.77%,22.69%,1
花蓮縣,豐濱鄉,0227,141,104,245,91,336,717,46.86%,19.67%,1
花蓮縣,豐濱鄉,0228,127,109,236,70,306,751,40.75%,16.91%,1
花蓮縣,豐濱鄉,0229,135,101,236,53,289,613,47.15%,22.02%,1
花蓮縣,豐濱鄉,0230,236,134,370,32,402,809,49.69%,29.17%,1
花蓮縣,豐濱鄉,0231,34,16,50,1,51,357,14.29%,9.52%,1
花蓮縣,豐濱鄉,0232,149,111,260,80,340,669,50.82%,22.27%,1
花蓮縣,豐濱鄉,0233,118,82,200,10,210,479,43.84%,24.63%,1
花蓮縣,瑞穗鄉,0241,274,142,416,55,471,813,57.93%,33.7%,1
花蓮縣,瑞穗鄉,0242,340,183,523,85,608,1091,55.73%,31.16%,1
花蓮縣,瑞穗鄉,0243,259,155,414,63,477,839,56.85%,30.87%,1
花蓮縣,瑞穗鄉,0244,296,180,476,84,560,975,57.44%,30.36%,1
花蓮縣,瑞穗鄉,0245,136,83,219,36,255,546,46.7%,24.91%,1
花蓮縣,瑞穗鄉,0246,290,190,480,86,566,1002,56.49%,28.94%,1
花蓮縣,瑞穗鄉,0247,132,100,232,44,276,593,46.54%,22.26%,1
花蓮縣,瑞穗鄉,0248,275,192,467,87,554,965,57.41%,28.5%,1
花蓮縣,瑞穗鄉,0249,230,169,399,76,475,863,55.04%,26.65%,1
花蓮縣,瑞穗鄉,0250,46,29,75,4,79,340,23.24%,13.53%,1
花蓮縣,瑞穗鄉,0251,186,123,309,44,353,764,46.2%,24.35%,1
花蓮縣,瑞穗鄉,0252,100,58,158,10,168,868,19.35%,11.52%,1
花蓮縣,瑞穗鄉,0253,92,68,160,28,188,620,30.32%,14.84%,1
花蓮縣,富里鄉,0277,112,62,174,21,195,467,41.76%,23.98%,1
花蓮縣,富里鄉,0278,206,140,346,64,410,1032,39.73%,19.96%,1
花蓮縣,富里鄉,0279,133,104,237,43,280,638,43.89%,20.85%,1
花蓮縣,富里鄉,0280,144,97,241,80,321,591,54.31%,24.37%,1
花蓮縣,富里鄉,0281,305,204,509,84,593,1087,54.55%,28.06%,1
花蓮縣,富里鄉,0282,111,86,197,27,224,431,51.97%,25.75%,1
花蓮縣,富里鄉,0283,248,146,394,40,434,893,48.6%,27.77%,1
花蓮縣,富里鄉,0284,67,51,118,31,149,361,41.27%,18.56%,1
花蓮縣,富里鄉,0285,291,204,495,48,543,1362,39.87%,21.37%,1
花蓮縣,富里鄉,0286,129,73,202,36,238,458,51.97%,28.17%,1
花蓮縣,富里鄉,0287,99,57,156,42,198,621,31.88%,15.94%,1
花蓮縣,富里鄉,0288,129,88,217,26,243,493,49.29%,26.17%,1
花蓮縣,富里鄉,0289,159,90,249,53,302,631,47.86%,25.2%,1
花蓮縣,秀林鄉,0101,265,153,418,31,449,867,51.79%,30.57%,1
花蓮縣,秀林鄉,0102,166,105,271,27,298,575,51.83%,28.87%,1
花蓮縣,秀林鄉,0103,286,187,473,49,522,1373,38.02%,20.83%,1
花蓮縣,秀林鄉,0104,404,222,626,83,709,1644,43.13%,24.57%,1
花蓮縣,秀林鄉,0105,49,34,83,6,89,162,54.94%,30.25%,1
花蓮縣,秀林鄉,0106,90,73,163,27,190,384,49.48%,23.44%,1
花蓮縣,秀林鄉,0107,341,204,545,44,589,1382,42.62%,24.67%,1
花蓮縣,秀林鄉,0108,271,192,463,50,513,1125,45.6%,24.09%,1
花蓮縣,秀林鄉,0109,177,90,267,23,290,627,46.25%,28.23%,1
花蓮縣,秀林鄉,0110,337,206,543,55,598,987,60.59%,34.14%,1
花蓮縣,秀林鄉,0111,373,217,590,109,699,1139,61.37%,32.75%,1
花蓮縣,秀林鄉,0112,401,170,571,8,579,1213,47.73%,33.06%,1
花蓮縣,秀林鄉,0113,178,139,317,30,347,754,46.02%,23.61%,1
花蓮縣,秀林鄉,0114,85,44,129,15,144,330,43.64%,25.76%,1
花蓮縣,萬榮鄉,0234,289,203,492,102,594,1072,55.41%,26.96%,1
花蓮縣,萬榮鄉,0235,141,92,233,13,246,560,43.93%,25.18%,1
花蓮縣,萬榮鄉,0236,255,166,421,42,463,773,59.9%,32.99%,1
花蓮縣,萬榮鄉,0237,161,80,241,15,256,661,38.73%,24.36%,1
花蓮縣,萬榮鄉,0238,121,82,203,21,224,442,50.68%,27.38%,1
花蓮縣,萬榮鄉,0239,155,116,271,76,347,675,51.41%,22.96%,1
花蓮縣,萬榮鄉,0240,316,274,590,148,738,1086,67.96%,29.1%,1
花蓮縣,卓溪鄉,0290,135,121,256,26,282,533,52.91%,25.33%,1
花蓮縣,卓溪鄉,0291,172,96,268,59,327,522,62.64%,32.95%,1
花蓮縣,卓溪鄉,0292,110,65,175,20,195,493,39.55%,22.31%,1
花蓮縣,卓溪鄉,0293,226,152,378,61,439,701,62.62%,32.24%,1
花蓮縣,卓溪鄉,0294,210,173,383,60,443,746,59.38%,28.15%,1
花蓮縣,卓溪鄉,0295,165,146,311,75,386,616,62.66%,26.79%,1
花蓮縣,卓溪鄉,0296,67,40,107,25,132,405,32.59%,16.54%,1
花蓮縣,卓溪鄉,0297,98,52,150,29,179,329,54.41%,29.79%,1
花蓮縣,卓溪鄉,0298,138,56,194,21,215,428,50.23%,32.24%,1
花蓮縣,卓溪鄉,0299,59,26,85,13,98,174,56.32%,33.91%,1
臺東縣,臺東市,0001,237,158,395,37,432,874,49.43%,27.12%,1
臺東縣,臺東市,0002,517,328,845,60,905,1469,61.61%,35.19%,1
臺東縣,臺東市,0003,414,244,658,39,697,1259,55.36%,32.88%,1
臺東縣,臺東市,0004,441,292,733,40,773,1399,55.25%,31.52%,1
臺東縣,臺東市,0005,502,293,795,46,841,1363,61.7%,36.83%,1
臺東縣,臺東市,0006,525,326,851,45,896,1651,54.27%,31.8%,1
臺東縣,臺東市,0007,555,326,881,48,929,1490,62.35%,37.25%,1
臺東縣,臺東市,0008,252,160,412,38,450,859,52.39%,29.34%,1
臺東縣,臺東市,0009,279,220,499,36,535,890,60.11%,31.35%,1
臺東縣,臺東市,0010,188,142,330,46,376,651,57.76%,28.88%,1
臺東縣,臺東市,0011,459,306,765,66,831,1650,50.36%,27.82%,1
臺東縣,臺東市,0012,243,178,421,29,450,724,62.15%,33.56%,1
臺東縣,臺東市,0013,206,145,351,30,381,632,60.28%,32.59%,1
臺東縣,臺東市,0014,251,168,419,44,463,771,60.05%,32.56%,1
臺東縣,臺東市,0015,234,145,379,28,407,798,51%,29.32%,1
臺東縣,臺東市,0016,360,264,624,96,720,1299,55.43%,27.71%,1
臺東縣,臺東市,0017,256,216,472,25,497,811,61.28%,31.57%,1
臺東縣,臺東市,0018,265,186,451,40,491,764,64.27%,34.69%,1
臺東縣,臺東市,0019,219,166,385,17,402,784,51.28%,27.93%,1
臺東縣,臺東市,0020,110,89,199,13,212,427,49.65%,25.76%,1
臺東縣,臺東市,0021,372,244,616,34,650,1292,50.31%,28.79%,1
臺東縣,臺東市,0022,513,306,819,24,843,1501,56.16%,34.18%,1
臺東縣,臺東市,0023,161,126,287,15,302,601,50.25%,26.79%,1
臺東縣,臺東市,0024,119,72,191,12,203,417,48.68%,28.54%,1
臺東縣,臺東市,0025,329,180,509,50,559,1001,55.84%,32.87%,1
臺東縣,臺東市,0026,583,318,901,49,950,1638,58%,35.59%,1
臺東縣,臺東市,0027,527,287,814,57,871,1576,55.27%,33.44%,1
臺東縣,臺東市,0028,519,319,838,66,904,1595,56.68%,32.54%,1
臺東縣,臺東市,0029,621,290,911,57,968,1734,55.82%,35.81%,1
臺東縣,臺東市,0030,491,298,789,56,845,1476,57.25%,33.27%,1
臺東縣,臺東市,0031,561,319,880,48,928,1545,60.06%,36.31%,1
臺東縣,臺東市,0032,455,291,746,46,792,1313,60.32%,34.65%,1
臺東縣,臺東市,0033,491,279,770,46,816,1338,60.99%,36.7%,1
臺東縣,臺東市,0034,424,258,682,35,717,1312,54.65%,32.32%,1
臺東縣,臺東市,0035,412,269,681,54,735,1265,58.1%,32.57%,1
臺東縣,臺東市,0036,348,259,607,69,676,1407,48.05%,24.73%,1
臺東縣,臺東市,0037,438,268,706,51,757,1552,48.78%,28.22%,1
臺東縣,臺東市,0038,477,268,745,80,825,1445,57.09%,33.01%,1
臺東縣,臺東市,0039,697,423,1120,73,1193,2098,56.86%,33.22%,1
臺東縣,臺東市,0040,434,264,698,89,787,1324,59.44%,32.78%,1
臺東縣,臺東市,0041,524,285,809,37,846,1598,52.94%,32.79%,1
臺東縣,臺東市,0042,453,300,753,33,786,1513,51.95%,29.94%,1
臺東縣,臺東市,0043,546,307,853,49,902,1679,53.72%,32.52%,1
臺東縣,臺東市,0044,393,286,679,63,742,1414,52.48%,27.79%,1
臺東縣,臺東市,0045,547,301,848,72,920,1798,51.17%,30.42%,1
臺東縣,臺東市,0046,442,273,715,86,801,1749,45.8%,25.27%,1
臺東縣,臺東市,0047,516,305,821,106,927,1709,54.24%,30.19%,1
臺東縣,臺東市,0048,515,260,775,64,839,1629,51.5%,31.61%,1
臺東縣,臺東市,0049,318,203,521,69,590,1116,52.87%,28.49%,1
臺東縣,臺東市,0050,321,205,526,31,557,1259,44.24%,25.5%,1
臺東縣,臺東市,0051,301,215,516,39,555,1232,45.05%,24.43%,1
臺東縣,臺東市,0052,360,295,655,120,775,1505,51.5%,23.92%,1
臺東縣,臺東市,0053,201,142,343,61,404,836,48.33%,24.04%,1
臺東縣,臺東市,0054,440,251,691,46,737,1294,56.96%,34%,1
臺東縣,臺東市,0055,425,231,656,66,722,1350,53.48%,31.48%,1
臺東縣,臺東市,0056,709,406,1115,82,1197,2162,55.37%,32.79%,1
臺東縣,臺東市,0057,572,342,914,54,968,1627,59.5%,35.16%,1
臺東縣,臺東市,0058,403,215,618,49,667,1140,58.51%,35.35%,1
臺東縣,臺東市,0059,438,230,668,42,710,1359,52.24%,32.23%,1
臺東縣,臺東市,0060,425,253,678,61,739,1329,55.61%,31.98%,1
臺東縣,臺東市,0061,278,193,471,42,513,990,51.82%,28.08%,1
臺東縣,臺東市,0062,342,195,537,52,589,1038,56.74%,32.95%,1
臺東縣,臺東市,0063,397,347,744,86,830,1597,51.97%,24.86%,1
臺東縣,臺東市,0064,387,277,664,81,745,1385,53.79%,27.94%,1
臺東縣,臺東市,0065,228,169,397,19,416,939,44.3%,24.28%,1
臺東縣,臺東市,0066,315,189,504,52,556,1258,44.2%,25.04%,1
臺東縣,臺東市,0067,370,248,618,11,629,1350,46.59%,27.41%,1
臺東縣,臺東市,0068,249,187,436,43,479,1058,45.27%,23.53%,1
臺東縣,臺東市,0069,195,147,342,35,377,895,42.12%,21.79%,1
臺東縣,成功鎮,0070,133,81,214,48,262,516,50.78%,25.78%,1
臺東縣,成功鎮,0071,269,246,515,69,584,960,60.83%,28.02%,1
臺東縣,成功鎮,0072,72,37,109,15,124,365,33.97%,19.73%,1
臺東縣,成功鎮,0073,166,112,278,67,345,747,46.18%,22.22%,1
臺東縣,成功鎮,0074,82,51,133,27,160,339,47.2%,24.19%,1
臺東縣,成功鎮,0075,267,160,427,27,454,995,45.63%,26.83%,1
臺東縣,成功鎮,0076,276,150,426,57,483,863,55.97%,31.98%,1
臺東縣,成功鎮,0077,279,171,450,57,507,931,54.46%,29.97%,1
臺東縣,成功鎮,0078,300,163,463,33,496,970,51.13%,30.93%,1
臺東縣,成功鎮,0079,342,243,585,108,693,1365,50.77%,25.05%,1
臺東縣,成功鎮,0080,425,200,625,94,719,1366,52.64%,31.11%,1
臺東縣,成功鎮,0081,120,79,199,63,262,516,50.78%,23.26%,1
臺東縣,成功鎮,0082,191,107,298,76,374,887,42.16%,21.53%,1
臺東縣,成功鎮,0083,97,71,168,49,217,488,44.47%,19.88%,1
臺東縣,成功鎮,0084,98,58,156,39,195,481,40.54%,20.37%,1
臺東縣,成功鎮,0085,41,29,70,0,70,373,18.77%,10.99%,1
臺東縣,成功鎮,0086,74,43,117,26,143,264,54.17%,28.03%,1
臺東縣,關山鎮,0087,301,202,503,35,538,909,59.19%,33.11%,1
臺東縣,關山鎮,0088,189,124,313,25,338,790,42.78%,23.92%,1
臺東縣,關山鎮,0089,271,186,457,44,501,828,60.51%,32.73%,1
臺東縣,關山鎮,0090,204,147,351,22,373,887,42.05%,23%,1
臺東縣,關山鎮,0091,398,189,587,34,621,1137,54.62%,35%,1
臺東縣,關山鎮,0092,183,132,315,35,350,732,47.81%,25%,1
臺東縣,關山鎮,0093,248,179,427,46,473,912,51.86%,27.19%,1
臺東縣,關山鎮,0094,172,111,283,20,303,779,38.9%,22.08%,1
臺東縣,關山鎮,0095,140,45,185,18,203,535,37.94%,26.17%,1
臺東縣,卑南鄉,0096,305,234,539,62,601,1041,57.73%,29.3%,1
臺東縣,卑南鄉,0097,343,187,530,39,569,1165,48.84%,29.44%,1
臺東縣,卑南鄉,0098,35,40,75,22,97,219,44.29%,15.98%,1
臺東縣,卑南鄉,0099,112,70,182,34,216,460,46.96%,24.35%,1
臺東縣,卑南鄉,0100,78,61,139,16,155,387,40.05%,20.16%,1
臺東縣,卑南鄉,0101,166,126,292,37,329,767,42.89%,21.64%,1
臺東縣,卑南鄉,0102,159,69,228,42,270,503,53.68%,31.61%,1
臺東縣,卑南鄉,0103,173,125,298,48,346,727,47.59%,23.8%,1
臺東縣,卑南鄉,0104,122,70,192,36,228,436,52.29%,27.98%,1
臺東縣,卑南鄉,0105,43,42,85,11,96,261,36.78%,16.48%,1
臺東縣,卑南鄉,0106,65,39,104,12,116,215,53.95%,30.23%,1
臺東縣,卑南鄉,0107,467,280,747,58,805,1442,55.83%,32.39%,1
臺東縣,卑南鄉,0108,150,97,247,17,264,527,50.09%,28.46%,1
臺東縣,卑南鄉,0109,300,224,524,56,580,1046,55.45%,28.68%,1
臺東縣,卑南鄉,0110,286,246,532,70,602,1110,54.23%,25.77%,1
臺東縣,卑南鄉,0111,335,231,566,63,629,1105,56.92%,30.32%,1
臺東縣,卑南鄉,0112,334,241,575,150,725,1167,62.13%,28.62%,1
臺東縣,卑南鄉,0113,224,182,406,67,473,968,48.86%,23.14%,1
臺東縣,卑南鄉,0114,29,23,52,3,55,159,34.59%,18.24%,1
臺東縣,卑南鄉,0115,127,66,193,27,220,488,45.08%,26.02%,1
臺東縣,卑南鄉,0116,89,88,177,25,202,347,58.21%,25.65%,1
臺東縣,卑南鄉,0117,123,78,201,26,227,436,52.06%,28.21%,1
臺東縣,鹿野鄉,0118,115,66,181,10,191,522,36.59%,22.03%,1
臺東縣,鹿野鄉,0119,164,111,275,31,306,574,53.31%,28.57%,1
臺東縣,鹿野鄉,0120,239,145,384,35,419,1055,39.72%,22.65%,1
臺東縣,鹿野鄉,0121,278,192,470,43,513,1104,46.47%,25.18%,1
臺東縣,鹿野鄉,0122,91,42,133,22,155,342,45.32%,26.61%,1
臺東縣,鹿野鄉,0123,224,154,378,42,420,895,46.93%,25.03%,1
臺東縣,鹿野鄉,0124,200,144,344,66,410,864,47.45%,23.15%,1
臺東縣,鹿野鄉,0125,121,122,243,45,288,675,42.67%,17.93%,1
臺東縣,鹿野鄉,0126,111,87,198,16,214,435,49.2%,25.52%,1
臺東縣,鹿野鄉,0127,86,66,152,29,181,470,38.51%,18.3%,1
臺東縣,池上鄉,0128,264,165,429,39,468,992,47.18%,26.61%,1
臺東縣,池上鄉,0129,263,182,445,65,510,929,54.9%,28.31%,1
臺東縣,池上鄉,0130,99,87,186,25,211,434,48.62%,22.81%,1
臺東縣,池上鄉,0131,157,113,270,37,307,703,43.67%,22.33%,1
臺東縣,池上鄉,0132,146,91,237,24,261,654,39.91%,22.32%,1
臺東縣,池上鄉,0133,50,59,109,20,129,324,39.81%,15.43%,1
臺東縣,池上鄉,0134,186,125,311,48,359,794,45.21%,23.43%,1
臺東縣,池上鄉,0135,208,151,359,52,411,856,48.01%,24.3%,1
臺東縣,池上鄉,0136,87,40,127,14,141,344,40.99%,25.29%,1
臺東縣,池上鄉,0137,98,48,146,25,171,311,54.98%,31.51%,1
臺東縣,池上鄉,0138,72,52,124,12,136,386,35.23%,18.65%,1
臺東縣,池上鄉,0139,76,56,132,19,151,435,34.71%,17.47%,1
臺東縣,東河鄉,0140,58,40,98,24,122,290,42.07%,20%,1
臺東縣,東河鄉,0141,187,105,292,44,336,620,54.19%,30.16%,1
臺東縣,東河鄉,0142,364,274,638,100,738,1196,61.71%,30.43%,1
臺東縣,東河鄉,0143,208,141,349,86,435,918,47.39%,22.66%,1
臺東縣,東河鄉,0144,119,93,212,45,257,555,46.31%,21.44%,1
臺東縣,東河鄉,0145,216,146,362,35,397,977,40.63%,22.11%,1
臺東縣,東河鄉,0146,169,132,301,21,322,1197,26.9%,14.12%,1
臺東縣,東河鄉,0147,100,73,173,36,209,867,24.11%,11.53%,1
臺東縣,東河鄉,0148,72,57,129,19,148,345,42.9%,20.87%,1
臺東縣,東河鄉,0149,78,71,149,21,170,408,41.67%,19.12%,1
臺東縣,東河鄉,0150,58,45,103,11,114,262,43.51%,22.14%,1
臺東縣,長濱鄉,0151,121,133,254,55,309,536,57.65%,22.57%,1
臺東縣,長濱鄉,0152,108,79,187,35,222,689,32.22%,15.67%,1
臺東縣,長濱鄉,0153,234,141,375,115,490,913,53.67%,25.63%,1
臺東縣,長濱鄉,0154,252,139,391,36,427,1268,33.68%,19.87%,1
臺東縣,長濱鄉,0155,153,101,254,81,335,725,46.21%,21.1%,1
臺東縣,長濱鄉,0156,64,55,119,15,134,532,25.19%,12.03%,1
臺東縣,長濱鄉,0157,123,88,211,68,279,660,42.27%,18.64%,1
臺東縣,長濱鄉,0158,44,23,67,3,70,336,20.83%,13.1%,1
臺東縣,長濱鄉,0159,28,20,48,16,64,195,32.82%,14.36%,1
臺東縣,長濱鄉,0160,8,2,10,3,13,25,52%,32%,1
臺東縣,長濱鄉,0161,134,59,193,62,255,605,42.15%,22.15%,1
臺東縣,太麻里鄉,0162,191,143,334,50,384,722,53.19%,26.45%,1
臺東縣,太麻里鄉,0163,174,86,260,35,295,575,51.3%,30.26%,1
臺東縣,太麻里鄉,0164,165,109,274,40,314,623,50.4%,26.48%,1
臺東縣,太麻里鄉,0165,138,108,246,50,296,622,47.59%,22.19%,1
臺東縣,太麻里鄉,0166,124,67,191,13,204,560,36.43%,22.14%,1
臺東縣,太麻里鄉,0167,252,164,416,109,525,957,54.86%,26.33%,1
臺東縣,太麻里鄉,0168,160,154,314,52,366,809,45.24%,19.78%,1
臺東縣,太麻里鄉,0169,219,145,364,49,413,673,61.37%,32.54%,1
臺東縣,太麻里鄉,0170,185,137,322,57,379,737,51.42%,25.1%,1
臺東縣,太麻里鄉,0171,114,86,200,40,240,424,56.6%,26.89%,1
臺東縣,太麻里鄉,0172,81,76,157,22,179,374,47.86%,21.66%,1
臺東縣,太麻里鄉,0173,163,92,255,26,281,829,33.9%,19.66%,1
臺東縣,太麻里鄉,0174,160,112,272,9,281,869,32.34%,18.41%,1
臺東縣,太麻里鄉,0175,35,24,59,6,65,223,29.15%,15.7%,1
臺東縣,太麻里鄉,0176,198,109,307,56,363,669,54.26%,29.6%,1
臺東縣,大武鄉,0177,152,108,260,73,333,568,58.63%,26.76%,1
臺東縣,大武鄉,0178,319,254,573,151,724,1474,49.12%,21.64%,1
臺東縣,大武鄉,0179,335,256,591,115,706,1327,53.2%,25.24%,1
臺東縣,大武鄉,0180,251,163,414,120,534,1134,47.09%,22.13%,1
臺東縣,大武鄉,0181,78,68,146,67,213,386,55.18%,20.21%,1
臺東縣,大武鄉,0182,81,53,134,33,167,377,44.3%,21.49%,1
臺東縣,綠島鄉,0183,355,211,566,38,604,1474,40.98%,24.08%,1
臺東縣,綠島鄉,0184,283,152,435,37,472,1082,43.62%,26.16%,1
臺東縣,綠島鄉,0185,219,141,360,21,381,813,46.86%,26.94%,1
臺東縣,綠島鄉,0186,45,49,94,2,96,210,45.71%,21.43%,1
臺東縣,海端鄉,0187,124,105,229,34,263,497,52.92%,24.95%,1
臺東縣,海端鄉,0188,175,120,295,35,330,569,58%,30.76%,1
臺東縣,海端鄉,0189,237,188,425,56,481,971,49.54%,24.41%,1
臺東縣,海端鄉,0190,184,169,353,40,393,728,53.98%,25.27%,1
臺東縣,海端鄉,0191,71,54,125,15,140,259,54.05%,27.41%,1
臺東縣,海端鄉,0192,64,49,113,14,127,254,50%,25.2%,1
臺東縣,延平鄉,0193,243,216,459,55,514,1014,50.69%,23.96%,1
臺東縣,延平鄉,0194,123,113,236,60,296,426,69.48%,28.87%,1
臺東縣,延平鄉,0195,108,74,182,27,209,315,66.35%,34.29%,1
臺東縣,延平鄉,0196,126,84,210,23,233,579,40.24%,21.76%,1
臺東縣,延平鄉,0197,136,111,247,28,275,596,46.14%,22.82%,1
臺東縣,金峰鄉,0198,294,194,488,73,561,1241,45.21%,23.69%,1
臺東縣,金峰鄉,0199,186,127,313,37,350,601,58.24%,30.95%,1
臺東縣,金峰鄉,0200,205,130,335,57,392,520,75.38%,39.42%,1
臺東縣,金峰鄉,0201,99,57,156,32,188,336,55.95%,29.46%,1
臺東縣,金峰鄉,0202,63,55,118,36,154,330,46.67%,19.09%,1
臺東縣,達仁鄉,0203,69,59,128,26,154,246,62.6%,28.05%,1
臺東縣,達仁鄉,0204,54,141,195,23,218,340,64.12%,15.88%,1
臺東縣,達仁鄉,0205,95,83,178,18,196,296,66.22%,32.09%,1
臺東縣,達仁鄉,0206,126,102,228,41,269,429,62.7%,29.37%,1
臺東縣,達仁鄉,0207,94,94,188,27,215,331,64.95%,28.4%,1
臺東縣,達仁鄉,0208,130,107,237,21,258,628,41.08%,20.7%,1
臺東縣,達仁鄉,0209,184,219,403,64,467,867,53.86%,21.22%,1
臺東縣,蘭嶼鄉,0210,154,197,351,30,381,943,40.4%,16.33%,1
臺東縣,蘭嶼鄉,0211,211,274,485,44,529,1238,42.73%,17.04%,1
臺東縣,蘭嶼鄉,0212,148,219,367,25,392,1240,31.61%,11.94%,1
臺東縣,蘭嶼鄉,0213,121,127,248,31,279,760,36.71%,15.92%,1
澎湖縣,馬公市,0001,123,79,202,21,223,481,46.36%,25.57%,1
澎湖縣,馬公市,0002,176,91,267,18,285,558,51.08%,31.54%,1
澎湖縣,馬公市,0003,135,85,220,43,263,533,49.34%,25.33%,1
澎湖縣,馬公市,0004,242,172,414,39,453,922,49.13%,26.25%,1
澎湖縣,馬公市,0005,290,204,494,47,541,1021,52.99%,28.4%,1
澎湖縣,馬公市,0006,233,129,362,42,404,793,50.95%,29.38%,1
澎湖縣,馬公市,0007,279,180,459,51,510,954,53.46%,29.25%,1
澎湖縣,馬公市,0008,274,183,457,44,501,1001,50.05%,27.37%,1
澎湖縣,馬公市,0009,316,163,479,52,531,1192,44.55%,26.51%,1
澎湖縣,馬公市,0010,378,214,592,68,660,1402,47.08%,26.96%,1
澎湖縣,馬公市,0011,423,224,647,50,697,1389,50.18%,30.45%,1
澎湖縣,馬公市,0012,403,223,626,65,691,1339,51.61%,30.1%,1
澎湖縣,馬公市,0013,350,188,538,54,592,1254,47.21%,27.91%,1
澎湖縣,馬公市,0014,341,202,543,58,601,1194,50.34%,28.56%,1
澎湖縣,馬公市,0015,365,246,611,61,672,1393,48.24%,26.2%,1
澎湖縣,馬公市,0016,446,256,702,49,751,1440,52.15%,30.97%,1
澎湖縣,馬公市,0017,311,212,523,67,590,1215,48.56%,25.6%,1
澎湖縣,馬公市,0018,358,192,550,83,633,1284,49.3%,27.88%,1
澎湖縣,馬公市,0019,428,243,671,75,746,1512,49.34%,28.31%,1
澎湖縣,馬公市,0020,311,167,478,92,570,1181,48.26%,26.33%,1
澎湖縣,馬公市,0021,412,211,623,47,670,1348,49.7%,30.56%,1
澎湖縣,馬公市,0022,414,253,667,52,719,1391,51.69%,29.76%,1
澎湖縣,馬公市,0023,493,386,879,58,937,2124,44.11%,23.21%,1
澎湖縣,馬公市,0024,440,221,661,79,740,1500,49.33%,29.33%,1
澎湖縣,馬公市,0025,474,248,722,56,778,1582,49.18%,29.96%,1
澎湖縣,馬公市,0026,474,263,737,57,794,1638,48.47%,28.94%,1
澎湖縣,馬公市,0027,456,297,753,57,810,1554,52.12%,29.34%,1
澎湖縣,馬公市,0028,219,134,353,26,379,980,38.67%,22.35%,1
澎湖縣,馬公市,0029,270,130,400,47,447,892,50.11%,30.27%,1
澎湖縣,馬公市,0030,193,111,304,17,321,778,41.26%,24.81%,1
澎湖縣,馬公市,0031,292,146,438,34,472,930,50.75%,31.4%,1
澎湖縣,馬公市,0032,515,275,790,66,856,1481,57.8%,34.77%,1
澎湖縣,馬公市,0033,382,184,566,26,592,1128,52.48%,33.87%,1
澎湖縣,馬公市,0034,115,72,187,31,218,415,52.53%,27.71%,1
澎湖縣,馬公市,0035,328,168,496,60,556,1120,49.64%,29.29%,1
澎湖縣,馬公市,0036,340,143,483,32,515,950,54.21%,35.79%,1
澎湖縣,馬公市,0037,161,84,245,36,281,627,44.82%,25.68%,1
澎湖縣,馬公市,0038,319,164,483,37,520,1055,49.29%,30.24%,1
澎湖縣,馬公市,0039,300,170,470,48,518,989,52.38%,30.33%,1
澎湖縣,馬公市,0040,181,103,284,45,329,591,55.67%,30.63%,1
澎湖縣,馬公市,0041,350,217,567,91,658,1387,47.44%,25.23%,1
澎湖縣,馬公市,0042,244,162,406,62,468,1079,43.37%,22.61%,1
澎湖縣,馬公市,0043,227,109,336,61,397,797,49.81%,28.48%,1
澎湖縣,馬公市,0044,239,113,352,31,383,903,42.41%,26.47%,1
澎湖縣,馬公市,0045,89,56,145,29,174,376,46.28%,23.67%,1
澎湖縣,馬公市,0046,105,67,172,23,195,371,52.56%,28.3%,1
澎湖縣,馬公市,0047,224,194,418,26,444,1173,37.85%,19.1%,1
澎湖縣,馬公市,0048,252,161,413,45,458,1389,32.97%,18.14%,1
澎湖縣,馬公市,0049,89,62,151,62,213,761,27.99%,11.7%,1
澎湖縣,馬公市,0050,91,62,153,23,176,288,61.11%,31.6%,1
澎湖縣,湖西鄉,0051,330,165,495,80,575,1120,51.34%,29.46%,1
澎湖縣,湖西鄉,0052,80,51,131,11,142,332,42.77%,24.1%,1
澎湖縣,湖西鄉,0053,48,36,84,5,89,242,36.78%,19.83%,1
澎湖縣,湖西鄉,0054,65,27,92,8,100,293,34.13%,22.18%,1
澎湖縣,湖西鄉,0055,136,86,222,51,273,666,40.99%,20.42%,1
澎湖縣,湖西鄉,0056,91,51,142,20,162,326,49.69%,27.91%,1
澎湖縣,湖西鄉,0057,142,102,244,28,272,732,37.16%,19.4%,1
澎湖縣,湖西鄉,0058,182,85,267,30,297,651,45.62%,27.96%,1
澎湖縣,湖西鄉,0059,204,86,290,22,312,744,41.94%,27.42%,1
澎湖縣,湖西鄉,0060,43,26,69,5,74,134,55.22%,32.09%,1
澎湖縣,湖西鄉,0061,147,88,235,26,261,794,32.87%,18.51%,1
澎湖縣,湖西鄉,0062,54,22,76,2,78,216,36.11%,25%,1
澎湖縣,湖西鄉,0063,120,57,177,18,195,664,29.37%,18.07%,1
澎湖縣,湖西鄉,0064,80,39,119,11,130,279,46.59%,28.67%,1
澎湖縣,湖西鄉,0065,95,44,139,9,148,296,50%,32.09%,1
澎湖縣,湖西鄉,0066,78,27,105,15,120,257,46.69%,30.35%,1
澎湖縣,湖西鄉,0067,18,6,24,3,27,89,30.34%,20.22%,1
澎湖縣,湖西鄉,0068,201,149,350,37,387,815,47.48%,24.66%,1
澎湖縣,湖西鄉,0069,229,120,349,31,380,975,38.97%,23.49%,1
澎湖縣,湖西鄉,0070,179,106,285,30,315,648,48.61%,27.62%,1
澎湖縣,湖西鄉,0071,204,123,327,32,359,893,40.2%,22.84%,1
澎湖縣,湖西鄉,0072,215,132,347,91,438,846,51.77%,25.41%,1
澎湖縣,湖西鄉,0073,137,99,236,20,256,729,35.12%,18.79%,1
澎湖縣,白沙鄉,0074,130,102,232,24,256,514,49.81%,25.29%,1
澎湖縣,白沙鄉,0075,193,123,316,18,334,657,50.84%,29.38%,1
澎湖縣,白沙鄉,0076,40,27,67,6,73,109,66.97%,36.7%,1
澎湖縣,白沙鄉,0077,47,12,59,6,65,156,41.67%,30.13%,1
澎湖縣,白沙鄉,0078,69,40,109,10,119,293,40.61%,23.55%,1
澎湖縣,白沙鄉,0079,42,24,66,4,70,231,30.3%,18.18%,1
澎湖縣,白沙鄉,0080,49,27,76,10,86,161,53.42%,30.43%,1
澎湖縣,白沙鄉,0081,476,246,722,63,785,1705,46.04%,27.92%,1
澎湖縣,白沙鄉,0082,71,39,110,11,121,285,42.46%,24.91%,1
澎湖縣,白沙鄉,0083,117,79,196,19,215,723,29.74%,16.18%,1
澎湖縣,白沙鄉,0084,149,98,247,38,285,774,36.82%,19.25%,1
澎湖縣,白沙鄉,0085,219,157,376,118,494,1429,34.57%,15.33%,1
澎湖縣,白沙鄉,0086,297,124,421,77,498,1084,45.94%,27.4%,1
澎湖縣,白沙鄉,0087,68,48,116,9,125,251,49.8%,27.09%,1
澎湖縣,白沙鄉,0088,36,34,70,19,89,253,35.18%,14.23%,1
澎湖縣,西嶼鄉,0089,22,19,41,3,44,283,15.55%,7.77%,1
澎湖縣,西嶼鄉,0090,70,37,107,15,122,424,28.77%,16.51%,1
澎湖縣,西嶼鄉,0091,137,88,225,60,285,826,34.5%,16.59%,1
澎湖縣,西嶼鄉,0092,55,34,89,14,103,282,36.52%,19.5%,1
澎湖縣,西嶼鄉,0093,112,80,192,62,254,661,38.43%,16.94%,1
澎湖縣,西嶼鄉,0094,11,14,25,3,28,141,19.86%,7.8%,1
澎湖縣,西嶼鄉,0095,108,54,162,13,175,635,27.56%,17.01%,1
澎湖縣,西嶼鄉,0096,39,23,62,6,68,216,31.48%,18.06%,1
澎湖縣,西嶼鄉,0097,60,43,103,30,133,572,23.25%,10.49%,1
澎湖縣,西嶼鄉,0098,267,139,406,97,503,1267,39.7%,21.07%,1
澎湖縣,西嶼鄉,0099,188,85,273,26,299,942,31.74%,19.96%,1
澎湖縣,西嶼鄉,0100,197,152,349,81,430,1133,37.95%,17.39%,1
澎湖縣,望安鄉,0101,175,103,278,51,329,734,44.82%,23.84%,1
澎湖縣,望安鄉,0102,105,53,158,32,190,454,41.85%,23.13%,1
澎湖縣,望安鄉,0103,54,27,81,16,97,300,32.33%,18%,1
澎湖縣,望安鄉,0104,128,68,196,43,239,471,50.74%,27.18%,1
澎湖縣,望安鄉,0105,123,58,181,27,208,672,30.95%,18.3%,1
澎湖縣,望安鄉,0106,141,105,246,51,297,742,40.03%,19%,1
澎湖縣,望安鄉,0107,49,41,90,18,108,264,40.91%,18.56%,1
澎湖縣,望安鄉,0108,101,64,165,8,173,476,36.34%,21.22%,1
澎湖縣,望安鄉,0109,20,20,40,4,44,208,21.15%,9.62%,1
澎湖縣,望安鄉,0110,49,34,83,9,92,307,29.97%,15.96%,1
澎湖縣,七美鄉,0111,41,21,62,4,66,248,26.61%,16.53%,1
澎湖縣,七美鄉,0112,93,78,171,33,204,581,35.11%,16.01%,1
澎湖縣,七美鄉,0113,108,78,186,39,225,641,35.1%,16.85%,1
澎湖縣,七美鄉,0114,63,44,107,9,116,382,30.37%,16.49%,1
澎湖縣,七美鄉,0115,47,18,65,7,72,351,20.51%,13.39%,1
澎湖縣,七美鄉,0116,183,101,284,32,316,1171,26.99%,15.63%,1
金門縣,金城鎮,0001,310,141,451,41,492,1396,35.24%,22.21%,1
金門縣,金城鎮,0002,409,248,657,35,692,1831,37.79%,22.34%,1
金門縣,金城鎮,0003,373,203,576,67,643,1750,36.74%,21.31%,1
金門縣,金城鎮,0004,381,244,625,93,718,1889,38.01%,20.17%,1
金門縣,金城鎮,0005,336,157,493,43,536,1675,32%,20.06%,1
金門縣,金城鎮,0006,473,241,714,66,780,1901,41.03%,24.88%,1
金門縣,金城鎮,0007,303,171,474,82,556,1610,34.53%,18.82%,1
金門縣,金城鎮,0008,364,196,560,41,601,1687,35.63%,21.58%,1
金門縣,金城鎮,0009,364,193,557,23,580,1594,36.39%,22.84%,1
金門縣,金城鎮,0010,361,219,580,23,603,1726,34.94%,20.92%,1
金門縣,金城鎮,0011,406,184,590,39,629,1733,36.3%,23.43%,1
金門縣,金城鎮,0012,361,222,583,41,624,1532,40.73%,23.56%,1
金門縣,金城鎮,0013,403,247,650,69,719,2079,34.58%,19.38%,1
金門縣,金城鎮,0014,515,88,603,49,652,2033,32.07%,25.33%,1
金門縣,金城鎮,0015,563,257,820,63,883,2517,35.08%,22.37%,1
金門縣,金城鎮,0016,464,210,674,54,728,2083,34.95%,22.28%,1
金門縣,金城鎮,0017,474,174,648,55,703,2140,32.85%,22.15%,1
金門縣,金城鎮,0018,391,220,611,94,705,2435,28.95%,16.06%,1
金門縣,金城鎮,0019,199,101,300,46,346,1353,25.57%,14.71%,1
金門縣,金城鎮,0020,343,123,466,28,494,1574,31.39%,21.79%,1
金門縣,金城鎮,0021,264,135,399,79,478,1277,37.43%,20.67%,1
金門縣,金沙鎮,0066,390,212,602,55,657,1909,34.42%,20.43%,1
金門縣,金沙鎮,0067,395,166,561,64,625,1524,41.01%,25.92%,1
金門縣,金沙鎮,0068,328,148,476,67,543,1673,32.46%,19.61%,1
金門縣,金沙鎮,0069,402,207,609,49,658,2003,32.85%,20.07%,1
金門縣,金沙鎮,0070,282,168,450,43,493,1212,40.68%,23.27%,1
金門縣,金沙鎮,0071,248,131,379,31,410,1126,36.41%,22.02%,1
金門縣,金沙鎮,0072,300,135,435,44,479,1540,31.1%,19.48%,1
金門縣,金沙鎮,0073,210,126,336,40,376,1216,30.92%,17.27%,1
金門縣,金沙鎮,0074,156,80,236,22,258,950,27.16%,16.42%,1
金門縣,金沙鎮,0075,453,196,649,52,701,1895,36.99%,23.91%,1
金門縣,金沙鎮,0076,278,145,423,40,463,1135,40.79%,24.49%,1
金門縣,金沙鎮,0077,264,119,383,52,435,1252,34.74%,21.09%,1
金門縣,金沙鎮,0078,293,139,432,32,464,1125,41.24%,26.04%,1
金門縣,金湖鎮,0049,320,173,493,47,540,1348,40.06%,23.74%,1
金門縣,金湖鎮,0050,284,173,457,28,485,1386,34.99%,20.49%,1
金門縣,金湖鎮,0051,368,178,546,59,605,1403,43.12%,26.23%,1
金門縣,金湖鎮,0052,445,176,621,51,672,1771,37.94%,25.13%,1
金門縣,金湖鎮,0053,327,164,491,64,555,1493,37.17%,21.9%,1
金門縣,金湖鎮,0054,293,155,448,88,536,1510,35.5%,19.4%,1
金門縣,金湖鎮,0055,389,165,554,59,613,1607,38.15%,24.21%,1
金門縣,金湖鎮,0056,407,170,577,90,667,2006,33.25%,20.29%,1
金門縣,金湖鎮,0057,388,204,592,49,641,1780,36.01%,21.8%,1
金門縣,金湖鎮,0058,412,192,604,31,635,1739,36.52%,23.69%,1
金門縣,金湖鎮,0059,291,144,435,43,478,1384,34.54%,21.03%,1
金門縣,金湖鎮,0060,308,158,466,62,528,1400,37.71%,22%,1
金門縣,金湖鎮,0061,367,189,556,31,587,1325,44.3%,27.7%,1
金門縣,金湖鎮,0062,259,109,368,45,413,1236,33.41%,20.95%,1
金門縣,金湖鎮,0063,262,158,420,54,474,1382,34.3%,18.96%,1
金門縣,金湖鎮,0064,348,170,518,42,560,1631,34.33%,21.34%,1
金門縣,金湖鎮,0065,294,141,435,59,494,1514,32.63%,19.42%,1
金門縣,金寧鄉,0022,314,152,466,75,541,1735,31.18%,18.1%,1
金門縣,金寧鄉,0023,288,152,440,45,485,1537,31.55%,18.74%,1
金門縣,金寧鄉,0024,316,206,522,70,592,1766,33.52%,17.89%,1
金門縣,金寧鄉,0025,232,119,351,24,375,1015,36.95%,22.86%,1
金門縣,金寧鄉,0026,369,182,551,61,612,1726,35.46%,21.38%,1
金門縣,金寧鄉,0027,334,180,514,21,535,1691,31.64%,19.75%,1
金門縣,金寧鄉,0028,414,407,821,44,865,2044,42.32%,20.25%,1
金門縣,金寧鄉,0029,505,215,720,44,764,1848,41.34%,27.33%,1
金門縣,金寧鄉,0030,393,184,577,27,604,1735,34.81%,22.65%,1
金門縣,金寧鄉,0031,371,190,561,66,627,1795,34.93%,20.67%,1
金門縣,金寧鄉,0032,347,168,515,66,581,1834,31.68%,18.92%,1
金門縣,金寧鄉,0033,310,170,480,35,515,1528,33.7%,20.29%,1
金門縣,金寧鄉,0034,366,173,539,29,568,1473,38.56%,24.85%,1
金門縣,金寧鄉,0035,379,180,559,42,601,1679,35.8%,22.57%,1
金門縣,金寧鄉,0036,577,315,892,39,931,1921,48.46%,30.04%,1
金門縣,金寧鄉,0037,301,139,440,27,467,1298,35.98%,23.19%,1
金門縣,金寧鄉,0038,316,144,460,45,505,1537,32.86%,20.56%,1
金門縣,烈嶼鄉,0039,513,169,682,40,722,1647,43.84%,31.15%,1
金門縣,烈嶼鄉,0040,396,175,571,46,617,1733,35.6%,22.85%,1
金門縣,烈嶼鄉,0041,398,163,561,44,605,1635,37%,24.34%,1
金門縣,烈嶼鄉,0042,278,134,412,29,441,1296,34.03%,21.45%,1
金門縣,烈嶼鄉,0043,229,101,330,25,355,1099,32.3%,20.84%,1
金門縣,烈嶼鄉,0044,299,153,452,31,483,1425,33.89%,20.98%,1
金門縣,烈嶼鄉,0045,332,169,501,24,525,1412,37.18%,23.51%,1
金門縣,烈嶼鄉,0046,361,107,468,37,505,1429,35.34%,25.26%,1
金門縣,烏坵鄉,0047,47,27,74,4,78,275,28.36%,17.09%,1
金門縣,烏坵鄉,0048,48,35,83,4,87,292,29.79%,16.44%,1
連江縣,南竿鄉,0001,658,310,968,46,1014,1967,51.55%,33.45%,1
連江縣,南竿鄉,0002,580,250,830,50,880,1837,47.9%,31.57%,1
連江縣,南竿鄉,0003,375,179,554,34,588,1114,52.78%,33.66%,1
連江縣,南竿鄉,0004,588,164,752,43,795,1543,51.52%,38.11%,1
連江縣,北竿鄉,0005,522,240,762,55,817,1515,53.93%,34.46%,1
連江縣,北竿鄉,0006,185,96,281,12,293,610,48.03%,30.33%,1
連江縣,莒光鄉,0007,224,94,318,20,338,698,48.42%,32.09%,1
連江縣,莒光鄉,0008,278,130,408,37,445,783,56.83%,35.5%,1
連江縣,東引鄉,0009,354,200,554,26,580,1138,50.97%,31.11%,1
基隆市,中正區,0001,108,114,222,23,245,466,52.58%,23.18%,1
基隆市,中正區,0002,278,212,490,39,529,1262,41.92%,22.03%,1
基隆市,中正區,0003,259,229,488,66,554,1171,47.31%,22.12%,1
基隆市,中正區,0004,621,410,1031,30,1061,2823,37.58%,22%,1
基隆市,中正區,0005,321,251,572,69,641,1474,43.49%,21.78%,1
基隆市,中正區,0006,301,176,477,76,553,1271,43.51%,23.68%,1
基隆市,中正區,0007,623,436,1059,102,1161,2707,42.89%,23.01%,1
基隆市,中正區,0008,381,241,622,126,748,1545,48.41%,24.66%,1
基隆市,中正區,0009,159,98,257,23,280,761,36.79%,20.89%,1
基隆市,中正區,0010,361,259,620,25,645,1352,47.71%,26.7%,1
基隆市,中正區,0011,405,218,623,25,648,1413,45.86%,28.66%,1
基隆市,中正區,0012,654,431,1085,63,1148,2665,43.08%,24.54%,1
基隆市,中正區,0013,292,227,519,68,587,1261,46.55%,23.16%,1
基隆市,中正區,0014,461,317,778,97,875,1753,49.91%,26.3%,1
基隆市,中正區,0015,199,187,386,55,441,984,44.82%,20.22%,1
基隆市,中正區,0016,282,195,477,42,519,1166,44.51%,24.19%,1
基隆市,中正區,0017,261,171,432,38,470,973,48.3%,26.82%,1
基隆市,中正區,0018,358,229,587,34,621,1694,36.66%,21.13%,1
基隆市,中正區,0019,355,242,597,40,637,1270,50.16%,27.95%,1
基隆市,中正區,0020,295,217,512,55,567,1090,52.02%,27.06%,1
基隆市,中正區,0021,264,153,417,33,450,870,51.72%,30.34%,1
基隆市,中正區,0022,298,229,527,45,572,1138,50.26%,26.19%,1
基隆市,中正區,0023,223,150,373,50,423,862,49.07%,25.87%,1
基隆市,中正區,0024,406,250,656,77,733,1341,54.66%,30.28%,1
基隆市,中正區,0025,248,183,431,42,473,859,55.06%,28.87%,1
基隆市,中正區,0026,374,268,642,32,674,1457,46.26%,25.67%,1
基隆市,中正區,0027,343,243,586,70,656,1594,41.15%,21.52%,1
基隆市,中正區,0028,210,169,379,48,427,802,53.24%,26.18%,1
基隆市,中正區,0029,342,234,576,42,618,1267,48.78%,26.99%,1
基隆市,中正區,0030,293,264,557,70,627,1175,53.36%,24.94%,1
基隆市,中正區,0031,359,261,620,53,673,1210,55.62%,29.67%,1
基隆市,中正區,0032,267,200,467,72,539,1037,51.98%,25.75%,1
基隆市,中正區,0033,346,222,568,67,635,1219,52.09%,28.38%,1
基隆市,中正區,0034,251,161,412,26,438,904,48.45%,27.77%,1
基隆市,中正區,0035,215,188,403,39,442,709,62.34%,30.32%,1
基隆市,七堵區,0219,354,282,636,76,712,1258,56.6%,28.14%,1
基隆市,七堵區,0220,366,262,628,49,677,1237,54.73%,29.59%,1
基隆市,七堵區,0221,355,255,610,34,644,1259,51.15%,28.2%,1
基隆市,七堵區,0222,245,253,498,57,555,1120,49.55%,21.88%,1
基隆市,七堵區,0223,344,229,573,67,640,1344,47.62%,25.6%,1
基隆市,七堵區,0224,319,243,562,58,620,1011,61.33%,31.55%,1
基隆市,七堵區,0225,244,192,436,29,465,925,50.27%,26.38%,1
基隆市,七堵區,0226,536,376,912,73,985,1735,56.77%,30.89%,1
基隆市,七堵區,0227,547,411,958,74,1032,1833,56.3%,29.84%,1
基隆市,七堵區,0228,281,203,484,23,507,938,54.05%,29.96%,1
基隆市,七堵區,0229,296,215,511,63,574,962,59.67%,30.77%,1
基隆市,七堵區,0230,371,257,628,48,676,1191,56.76%,31.15%,1
基隆市,七堵區,0231,302,209,511,57,568,999,56.86%,30.23%,1
基隆市,七堵區,0232,81,47,128,9,137,282,48.58%,28.72%,1
基隆市,七堵區,0233,349,234,583,58,641,1243,51.57%,28.08%,1
基隆市,七堵區,0234,296,219,515,50,565,1092,51.74%,27.11%,1
基隆市,七堵區,0235,330,286,616,52,668,1246,53.61%,26.48%,1
基隆市,七堵區,0236,659,135,794,69,863,1722,50.12%,38.27%,1
基隆市,七堵區,0237,358,297,655,39,694,1318,52.66%,27.16%,1
基隆市,七堵區,0238,273,163,436,24,460,975,47.18%,28%,1
基隆市,七堵區,0239,360,271,631,40,671,1285,52.22%,28.02%,1
基隆市,七堵區,0240,235,226,461,58,519,1077,48.19%,21.82%,1
基隆市,七堵區,0241,264,168,432,43,475,989,48.03%,26.69%,1
基隆市,七堵區,0242,319,241,560,38,598,1193,50.13%,26.74%,1
基隆市,七堵區,0243,483,122,605,53,658,1273,51.69%,37.94%,1
基隆市,七堵區,0244,501,347,848,96,944,1774,53.21%,28.24%,1
基隆市,七堵區,0245,461,348,809,80,889,1689,52.63%,27.29%,1
基隆市,七堵區,0246,365,256,621,73,694,1355,51.22%,26.94%,1
基隆市,七堵區,0247,379,317,696,68,764,1512,50.53%,25.07%,1
基隆市,七堵區,0248,385,283,668,37,705,1486,47.44%,25.91%,1
基隆市,七堵區,0249,477,340,817,29,846,1706,49.59%,27.96%,1
基隆市,七堵區,0250,406,284,690,64,754,1384,54.48%,29.34%,1
基隆市,七堵區,0251,321,246,567,60,627,1045,60%,30.72%,1
基隆市,七堵區,0252,384,302,686,46,732,1374,53.28%,27.95%,1
基隆市,七堵區,0253,115,94,209,10,219,428,51.17%,26.87%,1
基隆市,七堵區,0254,98,71,169,28,197,326,60.43%,30.06%,1
基隆市,七堵區,0255,135,92,227,20,247,351,70.37%,38.46%,1
基隆市,七堵區,0256,499,330,829,43,872,1871,46.61%,26.67%,1
基隆市,七堵區,0257,110,78,188,12,200,448,44.64%,24.55%,1
基隆市,暖暖區,0191,379,274,653,47,700,1431,48.92%,26.48%,1
基隆市,暖暖區,0192,108,86,194,8,202,456,44.3%,23.68%,1
基隆市,暖暖區,0193,204,126,330,23,353,637,55.42%,32.03%,1
基隆市,暖暖區,0194,226,173,399,28,427,735,58.1%,30.75%,1
基隆市,暖暖區,0195,291,185,476,34,510,1078,47.31%,26.99%,1
基隆市,暖暖區,0196,343,196,539,53,592,1238,47.82%,27.71%,1
基隆市,暖暖區,0197,350,283,633,44,677,1325,51.09%,26.42%,1
基隆市,暖暖區,0198,432,287,719,57,776,1475,52.61%,29.29%,1
基隆市,暖暖區,0199,283,222,505,31,536,1179,45.46%,24%,1
基隆市,暖暖區,0200,358,237,595,51,646,1110,58.2%,32.25%,1
基隆市,暖暖區,0201,390,234,624,39,663,1443,45.95%,27.03%,1
基隆市,暖暖區,0202,108,82,190,33,223,415,53.73%,26.02%,1
基隆市,暖暖區,0203,399,248,647,18,665,1378,48.26%,28.96%,1
基隆市,暖暖區,0204,435,342,777,42,819,1570,52.17%,27.71%,1
基隆市,暖暖區,0205,605,266,871,60,931,1603,58.08%,37.74%,1
基隆市,暖暖區,0206,396,266,662,58,720,1267,56.83%,31.25%,1
基隆市,暖暖區,0207,407,257,664,51,715,1359,52.61%,29.95%,1
基隆市,暖暖區,0208,329,203,532,32,564,970,58.14%,33.92%,1
基隆市,暖暖區,0209,299,201,500,23,523,1002,52.2%,29.84%,1
基隆市,暖暖區,0210,240,194,434,40,474,944,50.21%,25.42%,1
基隆市,暖暖區,0211,439,355,794,49,843,1500,56.2%,29.27%,1
基隆市,暖暖區,0212,357,202,559,26,585,1442,40.57%,24.76%,1
基隆市,暖暖區,0213,370,238,608,23,631,1165,54.16%,31.76%,1
基隆市,暖暖區,0214,452,319,771,39,810,1610,50.31%,28.07%,1
基隆市,暖暖區,0215,396,294,690,36,726,1328,54.67%,29.82%,1
基隆市,暖暖區,0216,349,222,571,29,600,1173,51.15%,29.75%,1
基隆市,暖暖區,0217,331,228,559,39,598,1019,58.68%,32.48%,1
基隆市,暖暖區,0218,436,257,693,23,716,1373,52.15%,31.76%,1
基隆市,仁愛區,0072,410,294,704,106,810,1782,45.45%,23.01%,1
基隆市,仁愛區,0073,309,232,541,59,600,1055,56.87%,29.29%,1
基隆市,仁愛區,0074,377,308,685,41,726,1558,46.6%,24.2%,1
基隆市,仁愛區,0075,508,326,834,60,894,1736,51.5%,29.26%,1
基隆市,仁愛區,0076,393,281,674,59,733,1243,58.97%,31.62%,1
基隆市,仁愛區,0077,310,271,581,42,623,1109,56.18%,27.95%,1
基隆市,仁愛區,0078,576,323,899,57,956,1684,56.77%,34.2%,1
基隆市,仁愛區,0079,265,193,458,43,501,919,54.52%,28.84%,1
基隆市,仁愛區,0080,272,208,480,19,499,991,50.35%,27.45%,1
基隆市,仁愛區,0081,264,185,449,21,470,876,53.65%,30.14%,1
基隆市,仁愛區,0082,321,236,557,49,606,1046,57.93%,30.69%,1
基隆市,仁愛區,0083,143,95,238,25,263,434,60.6%,32.95%,1
基隆市,仁愛區,0084,212,174,386,71,457,764,59.82%,27.75%,1
基隆市,仁愛區,0085,265,195,460,35,495,968,51.14%,27.38%,1
基隆市,仁愛區,0086,344,272,616,61,677,1326,51.06%,25.94%,1
基隆市,仁愛區,0087,284,209,493,58,551,1315,41.9%,21.6%,1
基隆市,仁愛區,0088,246,150,396,51,447,775,57.68%,31.74%,1
基隆市,仁愛區,0089,173,153,326,53,379,652,58.13%,26.53%,1
基隆市,仁愛區,0090,215,121,336,42,378,674,56.08%,31.9%,1
基隆市,仁愛區,0091,198,160,358,52,410,789,51.96%,25.1%,1
基隆市,仁愛區,0092,490,322,812,87,899,1715,52.42%,28.57%,1
基隆市,仁愛區,0093,218,183,401,54,455,849,53.59%,25.68%,1
基隆市,仁愛區,0094,273,171,444,29,473,875,54.06%,31.2%,1
基隆市,仁愛區,0095,234,156,390,45,435,851,51.12%,27.5%,1
基隆市,仁愛區,0096,216,166,382,45,427,735,58.1%,29.39%,1
基隆市,仁愛區,0097,267,190,457,77,534,1009,52.92%,26.46%,1
基隆市,仁愛區,0098,246,220,466,64,530,1082,48.98%,22.74%,1
基隆市,仁愛區,0099,328,252,580,85,665,1278,52.03%,25.67%,1
基隆市,仁愛區,0100,510,293,803,64,867,1519,57.08%,33.57%,1
基隆市,仁愛區,0101,309,234,543,56,599,1336,44.84%,23.13%,1
基隆市,仁愛區,0102,359,280,639,69,708,1178,60.1%,30.48%,1
基隆市,仁愛區,0103,191,137,328,54,382,708,53.95%,26.98%,1
基隆市,仁愛區,0104,167,157,324,34,358,567,63.14%,29.45%,1
基隆市,仁愛區,0105,195,172,367,49,416,751,55.39%,25.97%,1
基隆市,仁愛區,0106,189,134,323,31,354,589,60.1%,32.09%,1
基隆市,中山區,0107,229,137,366,33,399,796,50.13%,28.77%,1
基隆市,中山區,0108,360,209,569,69,638,1036,61.58%,34.75%,1
基隆市,中山區,0109,205,180,385,47,432,756,57.14%,27.12%,1
基隆市,中山區,0110,210,180,390,31,421,957,43.99%,21.94%,1
基隆市,中山區,0111,231,170,401,13,414,802,51.62%,28.8%,1
基隆市,中山區,0112,369,242,611,64,675,1263,53.44%,29.22%,1
基隆市,中山區,0113,244,181,425,27,452,778,58.1%,31.36%,1
基隆市,中山區,0114,338,216,554,113,667,1180,56.53%,28.64%,1
基隆市,中山區,0115,271,164,435,31,466,990,47.07%,27.37%,1
基隆市,中山區,0116,284,227,511,36,547,1332,41.07%,21.32%,1
基隆市,中山區,0117,199,162,361,34,395,848,46.58%,23.47%,1
基隆市,中山區,0118,242,167,409,18,427,922,46.31%,26.25%,1
基隆市,中山區,0119,136,113,249,23,272,459,59.26%,29.63%,1
基隆市,中山區,0120,152,96,248,32,280,574,48.78%,26.48%,1
基隆市,中山區,0121,246,150,396,58,454,877,51.77%,28.05%,1
基隆市,中山區,0122,385,277,662,46,708,1584,44.7%,24.31%,1
基隆市,中山區,0123,256,199,455,38,493,1319,37.38%,19.41%,1
基隆市,中山區,0124,527,366,893,89,982,1938,50.67%,27.19%,1
基隆市,中山區,0125,494,341,835,63,898,1877,47.84%,26.32%,1
基隆市,中山區,0126,666,409,1075,39,1114,2088,53.35%,31.9%,1
基隆市,中山區,0127,627,360,987,42,1029,1946,52.88%,32.22%,1
基隆市,中山區,0128,410,305,715,49,764,1353,56.47%,30.3%,1
基隆市,中山區,0129,361,252,613,16,629,1317,47.76%,27.41%,1
基隆市,中山區,0130,258,207,465,31,496,870,57.01%,29.66%,1
基隆市,中山區,0131,418,274,692,27,719,1322,54.39%,31.62%,1
基隆市,中山區,0132,328,231,559,32,591,1295,45.64%,25.33%,1
基隆市,中山區,0133,238,187,425,35,460,756,60.85%,31.48%,1
基隆市,中山區,0134,387,282,669,42,711,1602,44.38%,24.16%,1
基隆市,中山區,0135,399,309,708,40,748,1568,47.7%,25.45%,1
基隆市,中山區,0136,396,296,692,46,738,1404,52.56%,28.21%,1
基隆市,中山區,0137,514,330,844,32,876,1909,45.89%,26.93%,1
基隆市,中山區,0138,404,272,676,84,760,1642,46.29%,24.6%,1
基隆市,中山區,0139,238,161,399,31,430,932,46.14%,25.54%,1
基隆市,中山區,0140,271,188,459,52,511,849,60.19%,31.92%,1
基隆市,中山區,0141,202,175,377,50,427,715,59.72%,28.25%,1
基隆市,安樂區,0142,358,233,591,61,652,1361,47.91%,26.3%,1
基隆市,安樂區,0143,311,221,532,47,579,1213,47.73%,25.64%,1
基隆市,安樂區,0144,259,168,427,34,461,1026,44.93%,25.24%,1
基隆市,安樂區,0145,296,244,540,86,626,1038,60.31%,28.52%,1
基隆市,安樂區,0146,265,188,453,65,518,897,57.75%,29.54%,1
基隆市,安樂區,0147,389,278,667,75,742,1401,52.96%,27.77%,1
基隆市,安樂區,0148,127,91,218,9,227,641,35.41%,19.81%,1
基隆市,安樂區,0149,379,284,663,55,718,1472,48.78%,25.75%,1
基隆市,安樂區,0150,133,98,231,30,261,472,55.3%,28.18%,1
基隆市,安樂區,0151,246,213,459,36,495,841,58.86%,29.25%,1
基隆市,安樂區,0152,148,117,265,38,303,571,53.06%,25.92%,1
基隆市,安樂區,0153,466,368,834,57,891,1901,46.87%,24.51%,1
基隆市,安樂區,0154,346,292,638,57,695,1349,51.52%,25.65%,1
基隆市,安樂區,0155,339,244,583,42,625,1225,51.02%,27.67%,1
基隆市,安樂區,0156,413,280,693,53,746,1351,55.22%,30.57%,1
基隆市,安樂區,0157,536,319,855,53,908,1601,56.71%,33.48%,1
基隆市,安樂區,0158,730,510,1240,52,1292,2513,51.41%,29.05%,1
基隆市,安樂區,0159,506,316,822,50,872,1613,54.06%,31.37%,1
基隆市,安樂區,0160,550,334,884,57,941,1731,54.36%,31.77%,1
基隆市,安樂區,0161,472,338,810,35,845,1424,59.34%,33.15%,1
基隆市,安樂區,0162,504,347,851,68,919,1806,50.89%,27.91%,1
基隆市,安樂區,0163,526,347,873,74,947,1679,56.4%,31.33%,1
基隆市,安樂區,0164,576,352,928,57,985,1902,51.79%,30.28%,1
基隆市,安樂區,0165,658,337,995,48,1043,2040,51.13%,32.25%,1
基隆市,安樂區,0166,374,287,661,50,711,1313,54.15%,28.48%,1
基隆市,安樂區,0167,332,257,589,33,622,1243,50.04%,26.71%,1
基隆市,安樂區,0168,570,300,870,26,896,1759,50.94%,32.4%,1
基隆市,安樂區,0169,244,173,417,21,438,694,63.11%,35.16%,1
基隆市,安樂區,0170,310,214,524,27,551,866,63.63%,35.8%,1
基隆市,安樂區,0171,385,246,631,33,664,1557,42.65%,24.73%,1
基隆市,安樂區,0172,427,265,692,26,718,1411,50.89%,30.26%,1
基隆市,安樂區,0173,532,325,857,33,890,1568,56.76%,33.93%,1
基隆市,安樂區,0174,428,262,690,42,732,1400,52.29%,30.57%,1
基隆市,安樂區,0175,501,264,765,16,781,1531,51.01%,32.72%,1
基隆市,安樂區,0176,470,289,759,36,795,1673,47.52%,28.09%,1
基隆市,安樂區,0177,299,206,505,54,559,1054,53.04%,28.37%,1
基隆市,安樂區,0178,490,279,769,45,814,1923,42.33%,25.48%,1
基隆市,安樂區,0179,741,276,1017,32,1049,1960,53.52%,37.81%,1
基隆市,安樂區,0180,565,337,902,65,967,1962,49.29%,28.8%,1
基隆市,安樂區,0181,601,430,1031,62,1093,2117,51.63%,28.39%,1
基隆市,安樂區,0182,512,336,848,41,889,1829,48.61%,27.99%,1
基隆市,安樂區,0183,424,278,702,39,741,1529,48.46%,27.73%,1
基隆市,安樂區,0184,558,345,903,48,951,1869,50.88%,29.86%,1
基隆市,安樂區,0185,390,217,607,17,624,1140,54.74%,34.21%,1
基隆市,安樂區,0186,447,338,785,51,836,1641,50.94%,27.24%,1
基隆市,安樂區,0187,334,271,605,57,662,1279,51.76%,26.11%,1
基隆市,安樂區,0188,406,255,661,38,699,1360,51.4%,29.85%,1
基隆市,安樂區,0189,397,331,728,35,763,1399,54.54%,28.38%,1
基隆市,安樂區,0190,365,239,604,35,639,1251,51.08%,29.18%,1
基隆市,信義區,0036,340,126,466,56,522,1096,47.63%,31.02%,1
基隆市,信義區,0037,392,284,676,53,729,1232,59.17%,31.82%,1
基隆市,信義區,0038,374,240,614,25,639,1184,53.97%,31.59%,1
基隆市,信義區,0039,378,222,600,65,665,1133,58.69%,33.36%,1
基隆市,信義區,0040,362,251,613,43,656,1188,55.22%,30.47%,1
基隆市,信義區,0041,227,156,383,38,421,725,58.07%,31.31%,1
基隆市,信義區,0042,393,278,671,52,723,1524,47.44%,25.79%,1
基隆市,信義區,0043,218,154,372,35,407,736,55.3%,29.62%,1
基隆市,信義區,0044,158,127,285,27,312,611,51.06%,25.86%,1
基隆市,信義區,0045,232,169,401,29,430,951,45.22%,24.4%,1
基隆市,信義區,0046,500,296,796,44,840,1616,51.98%,30.94%,1
基隆市,信義區,0047,526,239,765,49,814,1516,53.69%,34.7%,1
基隆市,信義區,0048,284,218,502,36,538,1049,51.29%,27.07%,1
基隆市,信義區,0049,308,216,524,30,554,1069,51.82%,28.81%,1
基隆市,信義區,0050,213,175,388,32,420,727,57.77%,29.3%,1
基隆市,信義區,0051,310,210,520,26,546,929,58.77%,33.37%,1
基隆市,信義區,0052,381,276,657,34,691,1118,61.81%,34.08%,1
基隆市,信義區,0053,433,275,708,43,751,1339,56.09%,32.34%,1
基隆市,信義區,0054,281,189,470,39,509,999,50.95%,28.13%,1
基隆市,信義區,0055,224,147,371,18,389,764,50.92%,29.32%,1
基隆市,信義區,0056,420,280,700,45,745,1555,47.91%,27.01%,1
基隆市,信義區,0057,574,350,924,37,961,2015,47.69%,28.49%,1
基隆市,信義區,0058,410,250,660,56,716,1268,56.47%,32.33%,1
基隆市,信義區,0059,489,285,774,58,832,1569,53.03%,31.17%,1
基隆市,信義區,0060,526,356,882,71,953,1985,48.01%,26.5%,1
基隆市,信義區,0061,492,280,772,36,808,1476,54.74%,33.33%,1
基隆市,信義區,0062,504,296,800,34,834,1493,55.86%,33.76%,1
基隆市,信義區,0063,436,279,715,35,750,1249,60.05%,34.91%,1
基隆市,信義區,0064,465,277,742,41,783,1559,50.22%,29.83%,1
基隆市,信義區,0065,331,209,540,23,563,1168,48.2%,28.34%,1
基隆市,信義區,0066,489,294,783,42,825,1602,51.5%,30.52%,1
基隆市,信義區,0067,292,340,632,43,675,1485,45.45%,19.66%,1
基隆市,信義區,0068,300,173,473,32,505,1009,50.05%,29.73%,1
基隆市,信義區,0069,507,301,808,53,861,2016,42.71%,25.15%,1
基隆市,信義區,0070,427,266,693,47,740,1764,41.95%,24.21%,1
基隆市,信義區,0071,380,260,640,59,699,1295,53.98%,29.34%,1
新竹市,東區,0001,257,204,461,30,491,1512,32.47%,17%,1
新竹市,東區,0002,360,193,553,33,586,953,61.49%,37.78%,1
新竹市,東區,0003,236,151,387,36,423,729,58.02%,32.37%,1
新竹市,東區,0004,173,154,327,26,353,566,62.37%,30.57%,1
新竹市,東區,0005,188,141,329,40,369,640,57.66%,29.38%,1
新竹市,東區,0006,94,58,152,21,173,305,56.72%,30.82%,1
新竹市,東區,0007,175,135,310,32,342,563,60.75%,31.08%,1
新竹市,東區,0008,220,164,384,23,407,741,54.93%,29.69%,1
新竹市,東區,0009,328,239,567,29,596,1041,57.25%,31.51%,1
新竹市,東區,0010,503,325,828,39,867,1615,53.68%,31.15%,1
新竹市,東區,0011,430,259,689,51,740,1287,57.5%,33.41%,1
新竹市,東區,0012,500,334,834,48,882,1554,56.76%,32.18%,1
新竹市,東區,0013,483,300,783,28,811,1388,58.43%,34.8%,1
新竹市,東區,0014,589,186,775,60,835,1419,58.84%,41.51%,1
新竹市,東區,0015,398,303,701,58,759,1355,56.01%,29.37%,1
新竹市,東區,0016,480,299,779,51,830,1490,55.7%,32.21%,1
新竹市,東區,0017,536,319,855,43,898,1615,55.6%,33.19%,1
新竹市,東區,0018,525,357,882,75,957,1672,57.24%,31.4%,1
新竹市,東區,0019,349,226,575,40,615,1062,57.91%,32.86%,1
新竹市,東區,0020,423,271,694,58,752,1315,57.19%,32.17%,1
新竹市,東區,0021,319,191,510,86,596,1000,59.6%,31.9%,1
新竹市,東區,0022,413,319,732,59,791,1337,59.16%,30.89%,1
新竹市,東區,0023,570,324,894,46,940,1747,53.81%,32.63%,1
新竹市,東區,0024,544,369,913,44,957,1600,59.81%,34%,1
新竹市,東區,0025,368,240,608,47,655,1158,56.56%,31.78%,1
新竹市,東區,0026,291,211,502,40,542,828,65.46%,35.14%,1
新竹市,東區,0027,481,340,821,49,870,1573,55.31%,30.58%,1
新竹市,東區,0028,515,321,836,54,890,1550,57.42%,33.23%,1
新竹市,東區,0029,390,299,689,37,726,1317,55.13%,29.61%,1
新竹市,東區,0030,322,263,585,61,646,1040,62.12%,30.96%,1
新竹市,東區,0031,338,177,515,41,556,935,59.47%,36.15%,1
新竹市,東區,0032,361,220,581,31,612,1074,56.98%,33.61%,1
新竹市,東區,0033,411,246,657,44,701,1133,61.87%,36.28%,1
新竹市,東區,0034,443,276,719,38,757,1262,59.98%,35.1%,1
新竹市,東區,0035,422,232,654,33,687,1199,57.3%,35.2%,1
新竹市,東區,0036,433,278,711,42,753,1226,61.42%,35.32%,1
新竹市,東區,0037,516,314,830,56,886,1377,64.34%,37.47%,1
新竹市,東區,0038,356,255,611,26,637,991,64.28%,35.92%,1
新竹市,東區,0039,396,295,691,73,764,1271,60.11%,31.16%,1
新竹市,東區,0040,394,232,626,26,652,1012,64.43%,38.93%,1
新竹市,東區,0041,331,193,524,69,593,1001,59.24%,33.07%,1
新竹市,東區,0042,484,298,782,72,854,1603,53.28%,30.19%,1
新竹市,東區,0043,362,292,654,28,682,1236,55.18%,29.29%,1
新竹市,東區,0044,407,273,680,58,738,1532,48.17%,26.57%,1
新竹市,東區,0045,390,277,667,56,723,1306,55.36%,29.86%,1
新竹市,東區,0046,334,237,571,60,631,1073,58.81%,31.13%,1
新竹市,東區,0047,293,205,498,22,520,952,54.62%,30.78%,1
新竹市,東區,0048,322,234,556,62,618,1298,47.61%,24.81%,1
新竹市,東區,0049,240,142,382,33,415,778,53.34%,30.85%,1
新竹市,東區,0050,394,265,659,51,710,1195,59.41%,32.97%,1
新竹市,東區,0051,482,317,799,69,868,1569,55.32%,30.72%,1
新竹市,東區,0052,582,347,929,34,963,1533,62.82%,37.96%,1
新竹市,東區,0053,513,248,761,55,816,1336,61.08%,38.4%,1
新竹市,東區,0054,515,249,764,49,813,1367,59.47%,37.67%,1
新竹市,東區,0055,504,241,745,43,788,1289,61.13%,39.1%,1
新竹市,東區,0056,301,199,500,31,531,960,55.31%,31.35%,1
新竹市,東區,0057,312,189,501,38,539,843,63.94%,37.01%,1
新竹市,東區,0058,326,210,536,51,587,948,61.92%,34.39%,1
新竹市,東區,0059,296,184,480,38,518,915,56.61%,32.35%,1
新竹市,東區,0060,674,317,991,49,1040,1801,57.75%,37.42%,1
新竹市,東區,0061,357,224,581,37,618,1079,57.28%,33.09%,1
新竹市,東區,0062,270,134,404,13,417,676,61.69%,39.94%,1
新竹市,東區,0063,400,219,619,57,676,1132,59.72%,35.34%,1
新竹市,東區,0064,93,49,142,10,152,251,60.56%,37.05%,1
新竹市,東區,0065,585,304,889,49,938,1620,57.9%,36.11%,1
新竹市,東區,0066,449,306,755,45,800,1479,54.09%,30.36%,1
新竹市,東區,0067,434,291,725,32,757,1402,53.99%,30.96%,1
新竹市,東區,0068,380,272,652,70,722,1280,56.41%,29.69%,1
新竹市,東區,0069,403,296,699,29,728,1228,59.28%,32.82%,1
新竹市,東區,0070,352,258,610,13,623,1157,53.85%,30.42%,1
新竹市,東區,0071,451,281,732,40,772,1354,57.02%,33.31%,1
新竹市,東區,0072,534,297,831,24,855,1334,64.09%,40.03%,1
新竹市,東區,0073,418,275,693,38,731,1234,59.24%,33.87%,1
新竹市,東區,0074,530,302,832,44,876,1398,62.66%,37.91%,1
新竹市,東區,0075,312,235,547,29,576,928,62.07%,33.62%,1
新竹市,東區,0076,515,293,808,37,845,1368,61.77%,37.65%,1
新竹市,東區,0077,353,149,502,28,530,1215,43.62%,29.05%,1
新竹市,東區,0078,280,221,501,37,538,1067,50.42%,26.24%,1
新竹市,東區,0079,358,278,636,27,663,1194,55.53%,29.98%,1
新竹市,東區,0080,357,250,607,31,638,1193,53.48%,29.92%,1
新竹市,東區,0081,414,305,719,85,804,1388,57.93%,29.83%,1
新竹市,東區,0082,419,273,692,48,740,1267,58.41%,33.07%,1
新竹市,東區,0083,431,293,724,26,750,1299,57.74%,33.18%,1
新竹市,東區,0084,422,267,689,54,743,1288,57.69%,32.76%,1
新竹市,東區,0085,428,287,715,32,747,1228,60.83%,34.85%,1
新竹市,東區,0086,392,276,668,33,701,1135,61.76%,34.54%,1
新竹市,東區,0087,459,294,753,35,788,1237,63.7%,37.11%,1
新竹市,東區,0088,323,229,552,55,607,1135,53.48%,28.46%,1
新竹市,東區,0089,344,208,552,41,593,1165,50.9%,29.53%,1
新竹市,東區,0090,337,235,572,46,618,1124,54.98%,29.98%,1
新竹市,東區,0091,391,286,677,34,711,1210,58.76%,32.31%,1
新竹市,東區,0092,398,272,670,48,718,1323,54.27%,30.08%,1
新竹市,東區,0093,384,226,610,24,634,1207,52.53%,31.81%,1
新竹市,東區,0094,372,216,588,43,631,1264,49.92%,29.43%,1
新竹市,東區,0095,410,244,654,26,680,1248,54.49%,32.85%,1
新竹市,東區,0096,530,292,822,37,859,1400,61.36%,37.86%,1
新竹市,東區,0097,520,315,835,39,874,1473,59.33%,35.3%,1
新竹市,東區,0098,443,285,728,49,777,1367,56.84%,32.41%,1
新竹市,東區,0099,419,279,698,19,717,1233,58.15%,33.98%,1
新竹市,東區,0100,135,113,248,19,267,507,52.66%,26.63%,1
新竹市,東區,0101,217,155,372,49,421,714,58.96%,30.39%,1
新竹市,東區,0102,252,194,446,66,512,875,58.51%,28.8%,1
新竹市,東區,0103,442,288,730,63,793,1396,56.81%,31.66%,1
新竹市,東區,0104,347,262,609,54,663,1232,53.81%,28.17%,1
新竹市,東區,0105,400,279,679,44,723,1323,54.65%,30.23%,1
新竹市,東區,0106,225,443,668,40,708,1516,46.7%,14.84%,1
新竹市,東區,0107,421,281,702,46,748,1453,51.48%,28.97%,1
新竹市,東區,0108,265,203,468,49,517,880,58.75%,30.11%,1
新竹市,東區,0109,313,228,541,24,565,1058,53.4%,29.58%,1
新竹市,東區,0110,301,257,558,38,596,1061,56.17%,28.37%,1
新竹市,東區,0111,192,172,364,39,403,710,56.76%,27.04%,1
新竹市,東區,0112,228,174,402,51,453,752,60.24%,30.32%,1
新竹市,東區,0113,154,124,278,23,301,475,63.37%,32.42%,1
新竹市,東區,0114,234,205,439,30,469,880,53.3%,26.59%,1
新竹市,東區,0115,287,248,535,43,578,989,58.44%,29.02%,1
新竹市,東區,0116,338,223,561,51,612,1059,57.79%,31.92%,1
新竹市,東區,0117,174,156,330,40,370,607,60.96%,28.67%,1
新竹市,東區,0118,244,194,438,38,476,815,58.4%,29.94%,1
新竹市,東區,0119,249,155,404,77,481,777,61.9%,32.05%,1
新竹市,東區,0120,394,234,628,51,679,1399,48.53%,28.16%,1
新竹市,東區,0121,371,266,637,44,681,1216,56%,30.51%,1
新竹市,東區,0122,299,215,514,43,557,1062,52.45%,28.15%,1
新竹市,東區,0123,350,219,569,36,605,1046,57.84%,33.46%,1
新竹市,東區,0124,421,240,661,29,690,1332,51.8%,31.61%,1
新竹市,東區,0125,407,308,715,63,778,1350,57.63%,30.15%,1
新竹市,東區,0126,430,270,700,35,735,1438,51.11%,29.9%,1
新竹市,東區,0127,384,301,685,43,728,1414,51.49%,27.16%,1
新竹市,東區,0128,460,343,803,37,840,1476,56.91%,31.17%,1
新竹市,東區,0129,451,304,755,63,818,1326,61.69%,34.01%,1
新竹市,東區,0130,315,237,552,32,584,927,63%,33.98%,1
新竹市,東區,0131,386,296,682,32,714,1273,56.09%,30.32%,1
新竹市,東區,0132,394,267,661,34,695,1315,52.85%,29.96%,1
新竹市,東區,0133,477,282,759,38,797,1413,56.4%,33.76%,1
新竹市,東區,0134,335,228,563,39,602,1064,56.58%,31.48%,1
新竹市,東區,0135,455,302,757,32,789,1244,63.42%,36.58%,1
新竹市,東區,0136,348,229,577,6,583,1160,50.26%,30%,1
新竹市,東區,0137,405,246,651,37,688,1398,49.21%,28.97%,1
新竹市,東區,0138,332,208,540,27,567,1384,40.97%,23.99%,1
新竹市,東區,0139,337,186,523,44,567,874,64.87%,38.56%,1
新竹市,北區,0140,111,112,223,19,242,477,50.73%,23.27%,1
新竹市,北區,0141,173,121,294,29,323,535,60.37%,32.34%,1
新竹市,北區,0142,207,173,380,64,444,746,59.52%,27.75%,1
新竹市,北區,0143,149,114,263,25,288,546,52.75%,27.29%,1
新竹市,北區,0144,212,179,391,52,443,711,62.31%,29.82%,1
新竹市,北區,0145,306,234,540,42,582,1143,50.92%,26.77%,1
新竹市,北區,0146,405,272,677,47,724,1370,52.85%,29.56%,1
新竹市,北區,0147,392,317,709,51,760,1390,54.68%,28.2%,1
新竹市,北區,0148,311,200,511,31,542,962,56.34%,32.33%,1
新竹市,北區,0149,359,283,642,25,667,1237,53.92%,29.02%,1
新竹市,北區,0150,405,302,707,87,794,1604,49.5%,25.25%,1
新竹市,北區,0151,190,159,349,20,369,758,48.68%,25.07%,1
新竹市,北區,0152,384,246,630,39,669,1320,50.68%,29.09%,1
新竹市,北區,0153,435,255,690,80,770,1519,50.69%,28.64%,1
新竹市,北區,0154,73,52,125,7,132,347,38.04%,21.04%,1
新竹市,北區,0155,375,294,669,42,711,1212,58.66%,30.94%,1
新竹市,北區,0156,416,302,718,57,775,1484,52.22%,28.03%,1
新竹市,北區,0157,401,300,701,76,777,1428,54.41%,28.08%,1
新竹市,北區,0158,348,242,590,43,633,1128,56.12%,30.85%,1
新竹市,北區,0159,185,140,325,27,352,638,55.17%,29%,1
新竹市,北區,0160,418,234,652,55,707,1222,57.86%,34.21%,1
新竹市,北區,0161,309,224,533,42,575,1076,53.44%,28.72%,1
新竹市,北區,0162,346,228,574,25,599,937,63.93%,36.93%,1
新竹市,北區,0163,404,288,692,62,754,1394,54.09%,28.98%,1
新竹市,北區,0164,414,302,716,64,780,1568,49.74%,26.4%,1
新竹市,北區,0165,371,301,672,34,706,1159,60.91%,32.01%,1
新竹市,北區,0166,50,52,102,3,105,252,41.67%,19.84%,1
新竹市,北區,0167,272,184,456,20,476,761,62.55%,35.74%,1
新竹市,北區,0168,245,185,430,39,469,788,59.52%,31.09%,1
新竹市,北區,0169,181,132,313,42,355,561,63.28%,32.26%,1
新竹市,北區,0170,444,294,738,88,826,1558,53.02%,28.5%,1
新竹市,北區,0171,372,273,645,38,683,1398,48.86%,26.61%,1
新竹市,北區,0172,299,189,488,46,534,957,55.8%,31.24%,1
新竹市,北區,0173,396,236,632,61,693,1195,57.99%,33.14%,1
新竹市,北區,0174,333,232,565,48,613,1236,49.6%,26.94%,1
新竹市,北區,0175,339,252,591,69,660,1255,52.59%,27.01%,1
新竹市,北區,0176,374,213,587,41,628,1114,56.37%,33.57%,1
新竹市,北區,0177,435,293,728,16,744,1396,53.3%,31.16%,1
新竹市,北區,0178,455,335,790,51,841,1456,57.76%,31.25%,1
新竹市,北區,0179,435,281,716,32,748,1374,54.44%,31.66%,1
新竹市,北區,0180,301,224,525,51,576,1070,53.83%,28.13%,1
新竹市,北區,0181,346,225,571,70,641,1142,56.13%,30.3%,1
新竹市,北區,0182,351,197,548,18,566,1103,51.31%,31.82%,1
新竹市,北區,0183,361,238,599,80,679,1190,57.06%,30.34%,1
新竹市,北區,0184,403,239,642,34,676,1089,62.08%,37.01%,1
新竹市,北區,0185,328,238,566,30,596,1272,46.86%,25.79%,1
新竹市,北區,0186,396,290,686,59,745,1306,57.04%,30.32%,1
新竹市,北區,0187,410,251,661,60,721,1328,54.29%,30.87%,1
新竹市,北區,0188,439,281,720,41,761,1457,52.23%,30.13%,1
新竹市,北區,0189,481,296,777,55,832,1492,55.76%,32.24%,1
新竹市,北區,0190,415,239,654,45,699,1160,60.26%,35.78%,1
新竹市,北區,0191,253,220,473,99,572,971,58.91%,26.06%,1
新竹市,北區,0192,264,156,420,26,446,1401,31.83%,18.84%,1
新竹市,北區,0193,429,291,720,47,767,1340,57.24%,32.01%,1
新竹市,北區,0194,453,316,769,38,807,1371,58.86%,33.04%,1
新竹市,北區,0195,361,289,650,40,690,1267,54.46%,28.49%,1
新竹市,北區,0196,358,256,614,56,670,1073,62.44%,33.36%,1
新竹市,北區,0197,383,255,638,40,678,1159,58.5%,33.05%,1
新竹市,北區,0198,409,268,677,28,705,1294,54.48%,31.61%,1
新竹市,北區,0199,444,306,750,55,805,1442,55.83%,30.79%,1
新竹市,北區,0200,425,271,696,33,729,1270,57.4%,33.46%,1
新竹市,北區,0201,414,275,689,53,742,1179,62.93%,35.11%,1
新竹市,北區,0202,334,214,548,52,600,949,63.22%,35.19%,1
新竹市,北區,0203,365,255,620,43,663,1163,57.01%,31.38%,1
新竹市,北區,0204,421,277,698,34,732,1334,54.87%,31.56%,1
新竹市,北區,0205,429,313,742,51,793,1415,56.04%,30.32%,1
新竹市,北區,0206,433,322,755,36,791,1305,60.61%,33.18%,1
新竹市,北區,0207,402,240,642,40,682,1200,56.83%,33.5%,1
新竹市,北區,0208,334,264,598,26,624,1106,56.42%,30.2%,1
新竹市,北區,0209,364,225,589,35,624,1044,59.77%,34.87%,1
新竹市,北區,0210,335,244,579,50,629,1061,59.28%,31.57%,1
新竹市,北區,0211,353,497,850,53,903,1518,59.49%,23.25%,1
新竹市,北區,0212,385,319,704,54,758,1220,62.13%,31.56%,1
新竹市,北區,0213,492,339,831,23,854,1475,57.9%,33.36%,1
新竹市,北區,0214,413,275,688,61,749,1373,54.55%,30.08%,1
新竹市,北區,0215,492,288,780,46,826,1450,56.97%,33.93%,1
新竹市,北區,0216,515,266,781,48,829,1423,58.26%,36.19%,1
新竹市,北區,0217,340,239,579,23,602,1059,56.85%,32.11%,1
新竹市,北區,0218,419,206,625,60,685,1130,60.62%,37.08%,1
新竹市,北區,0219,465,245,710,39,749,1208,62%,38.49%,1
新竹市,北區,0220,490,216,706,56,762,1226,62.15%,39.97%,1
新竹市,北區,0221,367,258,625,40,665,1175,56.6%,31.23%,1
新竹市,北區,0222,475,265,740,32,772,1371,56.31%,34.65%,1
新竹市,北區,0223,411,243,654,58,712,1306,54.52%,31.47%,1
新竹市,北區,0224,397,275,672,31,703,1340,52.46%,29.63%,1
新竹市,北區,0225,346,264,610,75,685,1111,61.66%,31.14%,1
新竹市,北區,0226,412,295,707,55,762,1197,63.66%,34.42%,1
新竹市,北區,0227,324,207,531,45,576,1008,57.14%,32.14%,1
新竹市,北區,0228,278,205,483,28,511,946,54.02%,29.39%,1
新竹市,北區,0229,220,164,384,38,422,705,59.86%,31.21%,1
新竹市,北區,0230,216,194,410,95,505,848,59.55%,25.47%,1
新竹市,北區,0231,397,247,644,44,688,1295,53.13%,30.66%,1
新竹市,北區,0232,362,335,697,49,746,1467,50.85%,24.68%,1
新竹市,北區,0233,430,268,698,54,752,1659,45.33%,25.92%,1
新竹市,北區,0234,363,256,619,60,679,1297,52.35%,27.99%,1
新竹市,北區,0235,424,290,714,75,789,1374,57.42%,30.86%,1
新竹市,北區,0236,457,309,766,75,841,1457,57.72%,31.37%,1
新竹市,北區,0237,328,252,580,53,633,1072,59.05%,30.6%,1
新竹市,北區,0238,387,271,658,70,728,1350,53.93%,28.67%,1
新竹市,北區,0239,334,228,562,43,605,971,62.31%,34.4%,1
新竹市,北區,0240,432,350,782,68,850,1450,58.62%,29.79%,1
新竹市,北區,0241,279,191,470,39,509,895,56.87%,31.17%,1
新竹市,北區,0242,442,274,716,38,754,1378,54.72%,32.08%,1
新竹市,北區,0243,428,329,757,83,840,1609,52.21%,26.6%,1
新竹市,北區,0244,180,122,302,43,345,594,58.08%,30.3%,1
新竹市,香山區,0245,432,279,711,68,779,1443,53.98%,29.94%,1
新竹市,香山區,0246,361,278,639,46,685,1241,55.2%,29.09%,1
新竹市,香山區,0247,379,239,618,31,649,1194,54.36%,31.74%,1
新竹市,香山區,0248,330,254,584,15,599,1081,55.41%,30.53%,1
新竹市,香山區,0249,248,180,428,34,462,807,57.25%,30.73%,1
新竹市,香山區,0250,587,312,899,59,958,1760,54.43%,33.35%,1
新竹市,香山區,0251,530,323,853,60,913,1635,55.84%,32.42%,1
新竹市,香山區,0252,453,333,786,64,850,1473,57.71%,30.75%,1
新竹市,香山區,0253,454,302,756,36,792,1408,56.25%,32.24%,1
新竹市,香山區,0254,381,213,594,28,622,1318,47.19%,28.91%,1
新竹市,香山區,0255,389,312,701,51,752,1337,56.25%,29.09%,1
新竹市,香山區,0256,557,335,892,49,941,1862,50.54%,29.91%,1
新竹市,香山區,0257,307,265,572,21,593,1067,55.58%,28.77%,1
新竹市,香山區,0258,288,201,489,39,528,863,61.18%,33.37%,1
新竹市,香山區,0259,403,272,675,61,736,1198,61.44%,33.64%,1
新竹市,香山區,0260,373,251,624,67,691,1138,60.72%,32.78%,1
新竹市,香山區,0261,320,233,553,69,622,957,64.99%,33.44%,1
新竹市,香山區,0262,427,253,680,91,771,1348,57.2%,31.68%,1
新竹市,香山區,0263,367,240,607,73,680,1023,66.47%,35.87%,1
新竹市,香山區,0264,307,204,511,35,546,970,56.29%,31.65%,1
新竹市,香山區,0265,410,279,689,66,755,1318,57.28%,31.11%,1
新竹市,香山區,0266,327,229,556,53,609,1088,55.97%,30.06%,1
新竹市,香山區,0267,239,160,399,30,429,903,47.51%,26.47%,1
新竹市,香山區,0268,284,253,537,50,587,1012,58%,28.06%,1
新竹市,香山區,0269,294,229,523,51,574,1014,56.61%,28.99%,1
新竹市,香山區,0270,385,287,672,31,703,1238,56.79%,31.1%,1
新竹市,香山區,0271,380,203,583,72,655,1182,55.41%,32.15%,1
新竹市,香山區,0272,482,269,751,99,850,1331,63.86%,36.21%,1
新竹市,香山區,0273,350,246,596,33,629,976,64.45%,35.86%,1
新竹市,香山區,0274,257,161,418,35,453,834,54.32%,30.82%,1
新竹市,香山區,0275,305,183,488,42,530,919,57.67%,33.19%,1
新竹市,香山區,0276,396,259,655,48,703,1188,59.18%,33.33%,1
新竹市,香山區,0277,322,244,566,61,627,1086,57.73%,29.65%,1
新竹市,香山區,0278,415,249,664,52,716,1144,62.59%,36.28%,1
新竹市,香山區,0279,374,108,482,64,546,1112,49.1%,33.63%,1
新竹市,香山區,0280,476,312,788,65,853,1476,57.79%,32.25%,1
新竹市,香山區,0281,408,256,664,52,716,1291,55.46%,31.6%,1
新竹市,香山區,0282,501,335,836,67,903,1464,61.68%,34.22%,1
新竹市,香山區,0283,474,280,754,89,843,1427,59.07%,33.22%,1
新竹市,香山區,0284,403,291,694,53,747,1336,55.91%,30.16%,1
新竹市,香山區,0285,275,233,508,48,556,1131,49.16%,24.31%,1
新竹市,香山區,0286,365,198,563,87,650,1070,60.75%,34.11%,1
新竹市,香山區,0287,312,235,547,72,619,1006,61.53%,31.01%,1
新竹市,香山區,0288,320,203,523,46,569,1223,46.52%,26.17%,1
新竹市,香山區,0289,340,238,578,34,612,1119,54.69%,30.38%,1
新竹市,香山區,0290,364,276,640,46,686,1400,49%,26%,1
新竹市,香山區,0291,445,266,711,50,761,1627,46.77%,27.35%,1
新竹市,香山區,0292,369,217,586,59,645,1289,50.04%,28.63%,1
新竹市,香山區,0293,397,249,646,69,715,1409,50.75%,28.18%,1
新竹市,香山區,0294,213,174,387,45,432,814,53.07%,26.17%,1
新竹市,香山區,0295,210,141,351,49,400,719,55.63%,29.21%,1
新竹市,香山區,0296,299,180,479,26,505,1065,47.42%,28.08%,1
新竹市,香山區,0297,226,147,373,60,433,776,55.8%,29.12%,1
新竹市,香山區,0298,271,190,461,51,512,890,57.53%,30.45%,1
新竹市,香山區,0299,251,161,412,30,442,896,49.33%,28.01%,1
嘉義市,東區,0001,310,235,545,37,582,1025,56.78%,30.24%,1
嘉義市,東區,0002,393,266,659,19,678,1276,53.13%,30.8%,1
嘉義市,東區,0003,252,193,445,51,496,974,50.92%,25.87%,1
嘉義市,東區,0004,416,250,666,53,719,1175,61.19%,35.4%,1
嘉義市,東區,0005,221,183,404,32,436,702,62.11%,31.48%,1
嘉義市,東區,0006,342,211,553,31,584,1092,53.48%,31.32%,1
嘉義市,東區,0007,245,189,434,31,465,1023,45.45%,23.95%,1
嘉義市,東區,0008,501,354,855,81,936,1816,51.54%,27.59%,1
嘉義市,東區,0009,597,395,992,73,1065,1936,55.01%,30.84%,1
嘉義市,東區,0010,541,366,907,38,945,1698,55.65%,31.86%,1
嘉義市,東區,0011,381,292,673,42,715,1221,58.56%,31.2%,1
嘉義市,東區,0012,328,251,579,33,612,1113,54.99%,29.47%,1
嘉義市,東區,0013,437,328,765,63,828,1452,57.02%,30.1%,1
嘉義市,東區,0014,455,353,808,46,854,1395,61.22%,32.62%,1
嘉義市,東區,0015,451,216,667,51,718,1453,49.42%,31.04%,1
嘉義市,東區,0016,335,200,535,37,572,1094,52.29%,30.62%,1
嘉義市,東區,0017,464,286,750,47,797,1420,56.13%,32.68%,1
嘉義市,東區,0018,475,361,836,73,909,1552,58.57%,30.61%,1
嘉義市,東區,0019,474,348,822,64,886,1558,56.87%,30.42%,1
嘉義市,東區,0020,319,250,569,51,620,1062,58.38%,30.04%,1
嘉義市,東區,0021,356,236,592,63,655,1199,54.63%,29.69%,1
嘉義市,東區,0022,392,250,642,35,677,1236,54.77%,31.72%,1
嘉義市,東區,0023,250,197,447,25,472,890,53.03%,28.09%,1
嘉義市,東區,0024,288,193,481,54,535,880,60.8%,32.73%,1
嘉義市,東區,0025,346,271,617,18,635,1189,53.41%,29.1%,1
嘉義市,東區,0026,205,165,370,23,393,669,58.74%,30.64%,1
嘉義市,東區,0027,451,286,737,50,787,1435,54.84%,31.43%,1
嘉義市,東區,0028,458,318,776,45,821,1349,60.86%,33.95%,1
嘉義市,東區,0029,413,316,729,37,766,1455,52.65%,28.38%,1
嘉義市,東區,0030,292,201,493,36,529,915,57.81%,31.91%,1
嘉義市,東區,0031,247,243,490,31,521,952,54.73%,25.95%,1
嘉義市,東區,0032,260,221,481,49,530,941,56.32%,27.63%,1
嘉義市,東區,0033,288,231,519,41,560,1080,51.85%,26.67%,1
嘉義市,東區,0034,297,229,526,34,560,1157,48.4%,25.67%,1
嘉義市,東區,0035,311,270,581,28,609,1053,57.83%,29.53%,1
嘉義市,東區,0036,261,183,444,31,475,967,49.12%,26.99%,1
嘉義市,東區,0037,291,216,507,46,553,1091,50.69%,26.67%,1
嘉義市,東區,0038,285,222,507,64,571,961,59.42%,29.66%,1
嘉義市,東區,0039,186,137,323,31,354,863,41.02%,21.55%,1
嘉義市,東區,0040,314,241,555,61,616,1023,60.22%,30.69%,1
嘉義市,東區,0041,311,250,561,86,647,1078,60.02%,28.85%,1
嘉義市,東區,0042,250,219,469,28,497,938,52.99%,26.65%,1
嘉義市,東區,0043,307,226,533,39,572,1049,54.53%,29.27%,1
嘉義市,東區,0044,359,267,626,78,704,1360,51.76%,26.4%,1
嘉義市,東區,0045,378,300,678,100,778,1615,48.17%,23.41%,1
嘉義市,東區,0046,329,287,616,57,673,1267,53.12%,25.97%,1
嘉義市,東區,0047,393,275,668,83,751,1579,47.56%,24.89%,1
嘉義市,東區,0048,512,325,837,107,944,1831,51.56%,27.96%,1
嘉義市,東區,0049,319,207,526,34,560,977,57.32%,32.65%,1
嘉義市,東區,0050,301,261,562,42,604,1169,51.67%,25.75%,1
嘉義市,東區,0051,362,287,649,86,735,1238,59.37%,29.24%,1
嘉義市,東區,0052,360,296,656,32,688,1266,54.34%,28.44%,1
嘉義市,東區,0053,365,257,622,55,677,1429,47.38%,25.54%,1
嘉義市,東區,0054,377,294,671,35,706,1288,54.81%,29.27%,1
嘉義市,東區,0055,296,198,494,48,542,980,55.31%,30.2%,1
嘉義市,東區,0056,269,178,447,28,475,922,51.52%,29.18%,1
嘉義市,東區,0057,344,260,604,55,659,1133,58.16%,30.36%,1
嘉義市,東區,0058,398,239,637,64,701,1235,56.76%,32.23%,1
嘉義市,東區,0059,466,293,759,36,795,1525,52.13%,30.56%,1
嘉義市,東區,0060,326,221,547,58,605,1170,51.71%,27.86%,1
嘉義市,東區,0061,396,277,673,69,742,1177,63.04%,33.64%,1
嘉義市,東區,0062,376,245,621,63,684,1207,56.67%,31.15%,1
嘉義市,東區,0063,380,300,680,51,731,1272,57.47%,29.87%,1
嘉義市,東區,0064,318,239,557,117,674,1188,56.73%,26.77%,1
嘉義市,東區,0065,331,213,544,36,580,1172,49.49%,28.24%,1
嘉義市,東區,0066,339,207,546,52,598,1020,58.63%,33.24%,1
嘉義市,東區,0067,402,301,703,64,767,1332,57.58%,30.18%,1
嘉義市,東區,0068,310,260,570,54,624,1011,61.72%,30.66%,1
嘉義市,東區,0069,480,325,805,71,876,1682,52.08%,28.54%,1
嘉義市,東區,0070,465,312,777,79,856,1567,54.63%,29.67%,1
嘉義市,東區,0071,366,251,617,30,647,1207,53.6%,30.32%,1
嘉義市,東區,0072,312,223,535,34,569,981,58%,31.8%,1
嘉義市,東區,0073,393,286,679,59,738,1395,52.9%,28.17%,1
嘉義市,東區,0074,376,261,637,26,663,1434,46.23%,26.22%,1
嘉義市,東區,0075,342,245,587,35,622,1404,44.3%,24.36%,1
嘉義市,東區,0076,438,294,732,55,787,1428,55.11%,30.67%,1
嘉義市,東區,0077,427,297,724,35,759,1823,41.63%,23.42%,1
嘉義市,東區,0078,398,317,715,49,764,1570,48.66%,25.35%,1
嘉義市,東區,0079,318,249,567,80,647,1282,50.47%,24.8%,1
嘉義市,東區,0080,550,313,863,62,925,1571,58.88%,35.01%,1
嘉義市,東區,0081,421,306,727,43,770,1533,50.23%,27.46%,1
嘉義市,西區,0082,257,185,442,20,462,885,52.2%,29.04%,1
嘉義市,西區,0083,313,228,541,62,603,1109,54.37%,28.22%,1
嘉義市,西區,0084,217,220,437,64,501,1020,49.12%,21.27%,1
嘉義市,西區,0085,300,222,522,58,580,925,62.7%,32.43%,1
嘉義市,西區,0086,353,325,678,52,730,1671,43.69%,21.13%,1
嘉義市,西區,0087,362,251,613,35,648,1215,53.33%,29.79%,1
嘉義市,西區,0088,282,226,508,28,536,1036,51.74%,27.22%,1
嘉義市,西區,0089,300,233,533,28,561,1129,49.69%,26.57%,1
嘉義市,西區,0090,309,242,551,34,585,1127,51.91%,27.42%,1
嘉義市,西區,0091,390,297,687,59,746,1415,52.72%,27.56%,1
嘉義市,西區,0092,406,248,654,29,683,1366,50%,29.72%,1
嘉義市,西區,0093,324,255,579,63,642,1053,60.97%,30.77%,1
嘉義市,西區,0094,328,210,538,30,568,1067,53.23%,30.74%,1
嘉義市,西區,0095,411,269,680,40,720,1575,45.71%,26.1%,1
嘉義市,西區,0096,532,379,911,59,970,1865,52.01%,28.53%,1
嘉義市,西區,0097,332,212,544,47,591,1196,49.41%,27.76%,1
嘉義市,西區,0098,352,266,618,37,655,1280,51.17%,27.5%,1
嘉義市,西區,0099,513,291,804,72,876,1629,53.78%,31.49%,1
嘉義市,西區,0100,438,278,716,93,809,1393,58.08%,31.44%,1
嘉義市,西區,0101,328,256,584,53,637,1077,59.15%,30.45%,1
嘉義市,西區,0102,474,289,763,38,801,1694,47.28%,27.98%,1
嘉義市,西區,0103,227,209,436,89,525,841,62.43%,26.99%,1
嘉義市,西區,0104,311,248,559,5,564,1183,47.68%,26.29%,1
嘉義市,西區,0105,350,222,572,36,608,1000,60.8%,35%,1
嘉義市,西區,0106,342,259,601,30,631,1095,57.63%,31.23%,1
嘉義市,西區,0107,379,308,687,48,735,1256,58.52%,30.18%,1
嘉義市,西區,0108,295,210,505,55,560,962,58.21%,30.67%,1
嘉義市,西區,0109,291,229,520,22,542,865,62.66%,33.64%,1
嘉義市,西區,0110,412,275,687,64,751,1396,53.8%,29.51%,1
嘉義市,西區,0111,541,358,899,76,975,1799,54.2%,30.07%,1
嘉義市,西區,0112,417,276,693,37,730,1505,48.5%,27.71%,1
嘉義市,西區,0113,497,327,824,67,891,1698,52.47%,29.27%,1
嘉義市,西區,0114,560,363,923,39,962,1854,51.89%,30.2%,1
嘉義市,西區,0115,384,269,653,20,673,1537,43.79%,24.98%,1
嘉義市,西區,0116,419,317,736,93,829,1604,51.68%,26.12%,1
嘉義市,西區,0117,307,206,513,83,596,944,63.14%,32.52%,1
嘉義市,西區,0118,472,374,846,85,931,1627,57.22%,29.01%,1
嘉義市,西區,0119,359,260,619,58,677,1144,59.18%,31.38%,1
嘉義市,西區,0120,399,274,673,67,740,1362,54.33%,29.3%,1
嘉義市,西區,0121,392,294,686,44,730,1279,57.08%,30.65%,1
嘉義市,西區,0122,500,337,837,109,946,1702,55.58%,29.38%,1
嘉義市,西區,0123,403,336,739,62,801,1358,58.98%,29.68%,1
嘉義市,西區,0124,400,311,711,119,830,1360,61.03%,29.41%,1
嘉義市,西區,0125,536,313,849,61,910,1589,57.27%,33.73%,1
嘉義市,西區,0126,408,303,711,50,761,1280,59.45%,31.88%,1
嘉義市,西區,0127,316,243,559,32,591,1220,48.44%,25.9%,1
嘉義市,西區,0128,385,255,640,31,671,1172,57.25%,32.85%,1
嘉義市,西區,0129,398,268,666,66,732,1320,55.45%,30.15%,1
嘉義市,西區,0130,451,266,717,38,755,1185,63.71%,38.06%,1
嘉義市,西區,0131,407,315,722,53,775,1278,60.64%,31.85%,1
嘉義市,西區,0132,370,220,590,30,620,1394,44.48%,26.54%,1
嘉義市,西區,0133,488,320,808,63,871,1540,56.56%,31.69%,1
嘉義市,西區,0134,488,300,788,85,873,1548,56.4%,31.52%,1
嘉義市,西區,0135,367,288,655,37,692,1295,53.44%,28.34%,1
嘉義市,西區,0136,429,290,719,82,801,1318,60.77%,32.55%,1
嘉義市,西區,0137,456,330,786,66,852,1545,55.15%,29.51%,1
嘉義市,西區,0138,177,147,324,29,353,736,47.96%,24.05%,1
嘉義市,西區,0139,306,238,544,39,583,1168,49.91%,26.2%,1
嘉義市,西區,0140,245,185,430,43,473,756,62.57%,32.41%,1
嘉義市,西區,0141,292,163,455,23,478,869,55.01%,33.6%,1
嘉義市,西區,0142,303,221,524,56,580,983,59%,30.82%,1
嘉義市,西區,0143,254,158,412,61,473,828,57.13%,30.68%,1
嘉義市,西區,0144,590,333,923,56,979,1775,55.15%,33.24%,1
嘉義市,西區,0145,448,269,717,48,765,1419,53.91%,31.57%,1
嘉義市,西區,0146,199,171,370,20,390,779,50.06%,25.55%,1
嘉義市,西區,0147,211,190,401,17,418,855,48.89%,24.68%,1
嘉義市,西區,0148,348,236,584,89,673,1146,58.73%,30.37%,1
嘉義市,西區,0149,353,238,591,34,625,1111,56.26%,31.77%,1
嘉義市,西區,0150,235,201,436,57,493,767,64.28%,30.64%,1
嘉義市,西區,0151,220,134,354,33,387,817,47.37%,26.93%,1
嘉義市,西區,0152,202,188,390,57,447,770,58.05%,26.23%,1
嘉義市,西區,0153,265,212,477,19,496,1135,43.7%,23.35%,1
嘉義市,西區,0154,204,165,369,86,455,835,54.49%,24.43%,1
嘉義市,西區,0155,292,221,513,50,563,1182,47.63%,24.7%,1
嘉義市,西區,0156,210,183,393,47,440,944,46.61%,22.25%,1
嘉義市,西區,0157,272,194,466,43,509,997,51.05%,27.28%,1
嘉義市,西區,0158,299,233,532,33,565,1074,52.61%,27.84%,1
嘉義市,西區,0159,355,255,610,31,641,1460,43.9%,24.32%,1
嘉義市,西區,0160,420,230,650,36,686,1352,50.74%,31.07%,1
嘉義市,西區,0161,431,343,774,53,827,1499,55.17%,28.75%,1
嘉義市,西區,0162,393,241,634,68,702,1262,55.63%,31.14%,1
嘉義市,西區,0163,364,272,636,40,676,1299,52.04%,28.02%,1
嘉義市,西區,0164,466,330,796,71,867,1734,50%,26.87%,1
嘉義市,西區,0165,448,320,768,36,804,1674,48.03%,26.76%,1
嘉義市,西區,0166,432,310,742,47,789,1540,51.23%,28.05%,1
嘉義市,西區,0167,320,263,583,40,623,1056,59%,30.3%,1
嘉義市,西區,0168,437,292,729,127,856,1467,58.35%,29.79%,1
嘉義市,西區,0169,386,283,669,76,745,1431,52.06%,26.97%,1
嘉義市,西區,0170,425,258,683,90,773,1234,62.64%,34.44%,1
嘉義市,西區,0171,361,266,627,27,654,1266,51.66%,28.52%,1
嘉義市,西區,0172,332,294,626,38,664,1211,54.83%,27.42%,1
嘉義市,西區,0173,359,247,606,29,635,1121,56.65%,32.02%,1
嘉義市,西區,0174,315,210,525,28,553,1155,47.88%,27.27%,1
嘉義市,西區,0175,438,377,815,90,905,1546,58.54%,28.33%,1
嘉義市,西區,0176,411,218,629,28,657,1322,49.7%,31.09%,1
嘉義市,西區,0177,536,317,853,96,949,1549,61.27%,34.6%,1
