縣市,鄉鎮市區,開票所,同意票,不同意票,有效票,無效票,投票數,投票權人數,投票率,投票權人數百分比,總數
臺北市,松山區,0527,663,198,861,57,918,1583,57.99%,41.88%,1
臺北市,松山區,0528,668,227,895,78,973,1691,57.54%,39.5%,1
臺北市,松山區,0529,683,57,740,53,793,1386,57.22%,49.28%,1
臺北市,松山區,0530,560,200,760,63,823,1362,60.43%,41.12%,1
臺北市,松山區,0531,588,195,783,59,842,1399,60.19%,42.03%,1
臺北市,松山區,0532,542,202,744,59,803,1324,60.65%,40.94%,1
臺北市,松山區,0533,542,226,768,63,831,1296,64.12%,41.82%,1
臺北市,松山區,0534,580,215,795,59,854,1386,61.62%,41.85%,1
臺北市,松山區,0535,636,251,887,84,971,1529,63.51%,41.6%,1
臺北市,松山區,0536,609,157,766,50,816,1416,57.63%,43.01%,1
臺北市,松山區,0537,641,197,838,64,902,1619,55.71%,39.59%,1
臺北市,松山區,0538,561,213,774,64,838,1386,60.46%,40.48%,1
臺北市,松山區,0539,622,205,827,58,885,1380,64.13%,45.07%,1
臺北市,松山區,0540,576,187,763,53,816,1357,60.13%,42.45%,1
臺北市,松山區,0541,571,192,763,51,814,1296,62.81%,44.06%,1
臺北市,松山區,0542,721,177,898,85,983,1632,60.23%,44.18%,1
臺北市,松山區,0543,563,206,769,52,821,1414,58.06%,39.82%,1
臺北市,松山區,0544,595,209,804,53,857,1404,61.04%,42.38%,1
臺北市,松山區,0545,585,181,766,83,849,1365,62.2%,42.86%,1
臺北市,松山區,0546,600,187,787,73,860,1431,60.1%,41.93%,1
臺北市,松山區,0547,629,215,844,58,902,1483,60.82%,42.41%,1
臺北市,松山區,0548,592,167,759,50,809,1293,62.57%,45.78%,1
臺北市,松山區,0549,597,158,755,50,805,1410,57.09%,42.34%,1
臺北市,松山區,0550,582,161,743,53,796,1307,60.9%,44.53%,1
臺北市,松山區,0551,545,184,729,60,789,1242,63.53%,43.88%,1
臺北市,松山區,0552,525,172,697,35,732,1192,61.41%,44.04%,1
臺北市,松山區,0553,556,185,741,59,800,1276,62.7%,43.57%,1
臺北市,松山區,0554,491,178,669,35,704,1201,58.62%,40.88%,1
臺北市,松山區,0555,570,179,749,44,793,1318,60.17%,43.25%,1
臺北市,松山區,0556,505,177,682,41,723,1157,62.49%,43.65%,1
臺北市,松山區,0557,445,196,641,15,656,1157,56.7%,38.46%,1
臺北市,松山區,0558,578,188,766,64,830,1357,61.16%,42.59%,1
臺北市,松山區,0559,438,150,588,40,628,1215,51.69%,36.05%,1
臺北市,松山區,0560,546,188,734,47,781,1345,58.07%,40.59%,1
臺北市,松山區,0561,509,189,698,50,748,1237,60.47%,41.15%,1
臺北市,松山區,0562,592,145,737,37,774,1393,55.56%,42.5%,1
臺北市,松山區,0563,565,230,795,60,855,1331,64.24%,42.45%,1
臺北市,松山區,0564,676,228,904,60,964,1550,62.19%,43.61%,1
臺北市,松山區,0565,602,107,709,30,739,1308,56.5%,46.02%,1
臺北市,松山區,0566,699,131,830,44,874,1490,58.66%,46.91%,1
臺北市,松山區,0567,673,178,851,43,894,1406,63.58%,47.87%,1
臺北市,松山區,0568,521,205,726,44,770,1191,64.65%,43.74%,1
臺北市,松山區,0569,430,188,618,36,654,1095,59.73%,39.27%,1
臺北市,松山區,0570,481,174,655,50,705,1198,58.85%,40.15%,1
臺北市,松山區,0571,522,159,681,59,740,1265,58.5%,41.26%,1
臺北市,松山區,0572,496,182,678,52,730,1225,59.59%,40.49%,1
臺北市,松山區,0573,738,250,988,61,1049,1698,61.78%,43.46%,1
臺北市,松山區,0574,773,219,992,59,1051,1819,57.78%,42.5%,1
臺北市,松山區,0575,710,275,985,70,1055,1754,60.15%,40.48%,1
臺北市,松山區,0576,557,239,796,45,841,1361,61.79%,40.93%,1
臺北市,松山區,0577,539,164,703,28,731,1189,61.48%,45.33%,1
臺北市,松山區,0578,494,199,693,53,746,1214,61.45%,40.69%,1
臺北市,松山區,0579,518,183,701,56,757,1284,58.96%,40.34%,1
臺北市,松山區,0580,551,188,739,61,800,1297,61.68%,42.48%,1
臺北市,松山區,0581,504,220,724,40,764,1330,57.44%,37.89%,1
臺北市,松山區,0582,632,167,799,61,860,1396,61.6%,45.27%,1
臺北市,松山區,0583,619,164,783,37,820,1480,55.41%,41.82%,1
臺北市,松山區,0584,644,181,825,38,863,1419,60.82%,45.38%,1
臺北市,松山區,0585,574,197,771,70,841,1390,60.5%,41.29%,1
臺北市,松山區,0586,641,222,863,49,912,1525,59.8%,42.03%,1
臺北市,松山區,0587,635,220,855,45,900,1633,55.11%,38.89%,1
臺北市,松山區,0588,602,235,837,58,895,2677,33.43%,22.49%,1
臺北市,松山區,0589,507,198,705,68,773,1281,60.34%,39.58%,1
臺北市,松山區,0590,460,195,655,57,712,1469,48.47%,31.31%,1
臺北市,松山區,0591,637,242,879,82,961,1700,56.53%,37.47%,1
臺北市,松山區,0592,589,193,782,34,816,1503,54.29%,39.19%,1
臺北市,松山區,0593,507,193,700,54,754,1309,57.6%,38.73%,1
臺北市,松山區,0594,581,181,762,70,832,1376,60.47%,42.22%,1
臺北市,松山區,0595,638,249,887,57,944,1654,57.07%,38.57%,1
臺北市,松山區,0596,578,235,813,84,897,1601,56.03%,36.1%,1
臺北市,松山區,0597,691,142,833,41,874,1496,58.42%,46.19%,1
臺北市,松山區,0598,717,212,929,85,1014,1598,63.45%,44.87%,1
臺北市,松山區,0599,770,221,991,64,1055,1751,60.25%,43.97%,1
臺北市,松山區,0600,740,173,913,53,966,1557,62.04%,47.53%,1
臺北市,松山區,0601,872,187,1059,55,1114,1686,66.07%,51.72%,1
臺北市,松山區,0602,872,122,994,59,1053,1707,61.69%,51.08%,1
臺北市,松山區,0603,923,209,1132,59,1191,1854,64.24%,49.78%,1
臺北市,松山區,0604,704,221,925,51,976,1740,56.09%,40.46%,1
臺北市,松山區,0605,590,214,804,83,887,1494,59.37%,39.49%,1
臺北市,松山區,0606,636,187,823,50,873,1453,60.08%,43.77%,1
臺北市,松山區,0607,604,212,816,56,872,1458,59.81%,41.43%,1
臺北市,松山區,0608,646,197,843,57,900,1536,58.59%,42.06%,1
臺北市,松山區,0609,625,212,837,45,882,1463,60.29%,42.72%,1
臺北市,松山區,0610,669,239,908,44,952,1790,53.18%,37.37%,1
臺北市,松山區,0611,662,277,939,59,998,1679,59.44%,39.43%,1
臺北市,松山區,0612,646,212,858,80,938,1785,52.55%,36.19%,1
臺北市,松山區,0613,678,264,942,76,1018,1793,56.78%,37.81%,1
臺北市,松山區,0614,597,157,754,67,821,1381,59.45%,43.23%,1
臺北市,松山區,0615,548,171,719,53,772,1279,60.36%,42.85%,1
臺北市,松山區,0616,700,238,938,75,1013,1681,60.26%,41.64%,1
臺北市,松山區,0617,538,182,720,54,774,1232,62.82%,43.67%,1
臺北市,松山區,0618,808,11,819,63,882,1533,57.53%,52.71%,1
臺北市,松山區,0619,632,255,887,58,945,1540,61.36%,41.04%,1
臺北市,松山區,0620,645,256,901,51,952,1716,55.48%,37.59%,1
臺北市,松山區,0621,606,260,866,55,921,1664,55.35%,36.42%,1
臺北市,松山區,0622,553,185,738,40,778,1350,57.63%,40.96%,1
臺北市,松山區,0623,748,235,983,58,1041,1837,56.67%,40.72%,1
臺北市,松山區,0624,562,205,767,86,853,1558,54.75%,36.07%,1
臺北市,松山區,0625,604,213,817,61,878,1420,61.83%,42.54%,1
臺北市,松山區,0626,594,195,789,58,847,1474,57.46%,40.3%,1
臺北市,松山區,0627,597,247,844,65,909,1591,57.13%,37.52%,1
臺北市,松山區,0628,701,231,932,67,999,1726,57.88%,40.61%,1
臺北市,松山區,0629,575,222,797,49,846,1452,58.26%,39.6%,1
臺北市,松山區,0630,565,218,783,43,826,1482,55.74%,38.12%,1
臺北市,松山區,0631,584,226,810,56,866,1460,59.32%,40%,1
臺北市,松山區,0632,542,207,749,59,808,1398,57.8%,38.77%,1
臺北市,松山區,0633,607,196,803,60,863,1423,60.65%,42.66%,1
臺北市,松山區,0634,545,159,704,30,734,1226,59.87%,44.45%,1
臺北市,松山區,0635,507,147,654,48,702,1158,60.62%,43.78%,1
臺北市,松山區,0636,574,197,771,52,823,1426,57.71%,40.25%,1
臺北市,松山區,0637,539,126,665,25,690,1177,58.62%,45.79%,1
臺北市,松山區,0638,533,206,739,55,794,1363,58.25%,39.1%,1
臺北市,松山區,0639,538,171,709,61,770,1240,62.1%,43.39%,1
臺北市,松山區,0640,575,213,788,64,852,1375,61.96%,41.82%,1
臺北市,松山區,0641,575,198,773,51,824,1377,59.84%,41.76%,1
臺北市,松山區,0642,480,159,639,35,674,1225,55.02%,39.18%,1
臺北市,松山區,0643,430,187,617,41,658,1017,64.7%,42.28%,1
臺北市,信義區,0644,605,155,760,32,792,2476,31.99%,24.43%,1
臺北市,信義區,0645,695,148,843,31,874,1381,63.29%,50.33%,1
臺北市,信義區,0646,611,155,766,54,820,1294,63.37%,47.22%,1
臺北市,信義區,0647,572,176,748,11,759,1351,56.18%,42.34%,1
臺北市,信義區,0648,564,159,723,41,764,1296,58.95%,43.52%,1
臺北市,信義區,0649,564,169,733,60,793,1302,60.91%,43.32%,1
臺北市,信義區,0650,403,110,513,69,582,1025,56.78%,39.32%,1
臺北市,信義區,0651,550,188,738,46,784,1421,55.17%,38.71%,1
臺北市,信義區,0652,622,170,792,54,846,1501,56.36%,41.44%,1
臺北市,信義區,0653,573,185,758,44,802,1575,50.92%,36.38%,1
臺北市,信義區,0654,661,177,838,35,873,1516,57.59%,43.6%,1
臺北市,信義區,0655,574,202,776,33,809,1382,58.54%,41.53%,1
臺北市,信義區,0656,464,140,604,52,656,1128,58.16%,41.13%,1
臺北市,信義區,0657,561,162,723,70,793,1397,56.76%,40.16%,1
臺北市,信義區,0658,500,176,676,51,727,1161,62.62%,43.07%,1
臺北市,信義區,0659,574,176,750,49,799,1368,58.41%,41.96%,1
臺北市,信義區,0660,445,140,585,33,618,1049,58.91%,42.42%,1
臺北市,信義區,0661,601,152,753,54,807,1308,61.7%,45.95%,1
臺北市,信義區,0662,508,162,670,54,724,1154,62.74%,44.02%,1
臺北市,信義區,0663,473,165,638,23,661,1078,61.32%,43.88%,1
臺北市,信義區,0664,590,167,757,50,807,1375,58.69%,42.91%,1
臺北市,信義區,0665,641,172,813,45,858,1448,59.25%,44.27%,1
臺北市,信義區,0666,532,182,714,29,743,1250,59.44%,42.56%,1
臺北市,信義區,0667,584,201,785,43,828,1381,59.96%,42.29%,1
臺北市,信義區,0668,523,168,691,62,753,1213,62.08%,43.12%,1
臺北市,信義區,0669,627,214,841,57,898,1373,65.4%,45.67%,1
臺北市,信義區,0670,523,180,703,44,747,1226,60.93%,42.66%,1
臺北市,信義區,0671,466,167,633,26,659,1117,59%,41.72%,1
臺北市,信義區,0672,489,151,640,55,695,1123,61.89%,43.54%,1
臺北市,信義區,0673,520,156,676,51,727,1200,60.58%,43.33%,1
臺北市,信義區,0674,515,163,678,32,710,1335,53.18%,38.58%,1
臺北市,信義區,0675,532,159,691,38,729,1332,54.73%,39.94%,1
臺北市,信義區,0676,662,231,893,82,975,1648,59.16%,40.17%,1
臺北市,信義區,0677,509,301,810,73,883,1542,57.26%,33.01%,1
臺北市,信義區,0678,507,164,671,59,730,1228,59.45%,41.29%,1
臺北市,信義區,0679,671,258,929,71,1000,1731,57.77%,38.76%,1
臺北市,信義區,0680,598,185,783,49,832,1403,59.3%,42.62%,1
臺北市,信義區,0681,744,232,976,95,1071,1929,55.52%,38.57%,1
臺北市,信義區,0682,563,185,748,54,802,1300,61.69%,43.31%,1
臺北市,信義區,0683,556,185,741,39,780,1486,52.49%,37.42%,1
臺北市,信義區,0684,532,170,702,73,775,1532,50.59%,34.73%,1
臺北市,信義區,0685,595,209,804,62,866,1387,62.44%,42.9%,1
臺北市,信義區,0686,452,160,612,46,658,1195,55.06%,37.82%,1
臺北市,信義區,0687,420,127,547,40,587,1068,54.96%,39.33%,1
臺北市,信義區,0688,448,164,612,57,669,1273,52.55%,35.19%,1
臺北市,信義區,0689,607,161,768,72,840,1329,63.21%,45.67%,1
臺北市,信義區,0690,498,162,660,48,708,1311,54%,37.99%,1
臺北市,信義區,0691,470,173,643,58,701,1258,55.72%,37.36%,1
臺北市,信義區,0692,516,185,701,73,774,1277,60.61%,40.41%,1
臺北市,信義區,0693,570,179,749,64,813,1285,63.27%,44.36%,1
臺北市,信義區,0694,501,181,682,60,742,1161,63.91%,43.15%,1
臺北市,信義區,0695,484,199,683,48,731,1299,56.27%,37.26%,1
臺北市,信義區,0696,511,156,667,51,718,1243,57.76%,41.11%,1
臺北市,信義區,0697,491,161,652,41,693,1197,57.89%,41.02%,1
臺北市,信義區,0698,547,182,729,37,766,1224,62.58%,44.69%,1
臺北市,信義區,0699,456,126,582,45,627,1147,54.66%,39.76%,1
臺北市,信義區,0700,377,144,521,29,550,1045,52.63%,36.08%,1
臺北市,信義區,0701,489,145,634,35,669,1096,61.04%,44.62%,1
臺北市,信義區,0702,455,144,599,21,620,1115,55.61%,40.81%,1
臺北市,信義區,0703,426,161,587,55,642,1117,57.48%,38.14%,1
臺北市,信義區,0704,379,122,501,31,532,1019,52.21%,37.19%,1
臺北市,信義區,0705,587,149,736,59,795,1346,59.06%,43.61%,1
臺北市,信義區,0706,587,145,732,54,786,1405,55.94%,41.78%,1
臺北市,信義區,0707,586,158,744,49,793,1356,58.48%,43.22%,1
臺北市,信義區,0708,562,191,753,43,796,1250,63.68%,44.96%,1
臺北市,信義區,0709,553,167,720,47,767,1254,61.16%,44.1%,1
臺北市,信義區,0710,559,159,718,33,751,1317,57.02%,42.44%,1
臺北市,信義區,0711,556,187,743,58,801,1271,63.02%,43.75%,1
臺北市,信義區,0712,379,138,517,37,554,979,56.59%,38.71%,1
臺北市,信義區,0713,391,135,526,48,574,1025,56%,38.15%,1
臺北市,信義區,0714,560,151,711,41,752,1512,49.74%,37.04%,1
臺北市,信義區,0715,648,206,854,36,890,1483,60.01%,43.7%,1
臺北市,信義區,0716,605,174,779,48,827,1359,60.85%,44.52%,1
臺北市,信義區,0717,577,212,789,28,817,1387,58.9%,41.6%,1
臺北市,信義區,0718,551,194,745,39,784,1455,53.88%,37.87%,1
臺北市,信義區,0719,565,231,796,39,835,1461,57.15%,38.67%,1
臺北市,信義區,0720,661,178,839,54,893,1532,58.29%,43.15%,1
臺北市,信義區,0721,456,158,614,55,669,1043,64.14%,43.72%,1
臺北市,信義區,0722,353,147,500,53,553,875,63.2%,40.34%,1
臺北市,信義區,0723,368,126,494,27,521,927,56.2%,39.7%,1
臺北市,信義區,0724,436,174,610,72,682,1119,60.95%,38.96%,1
臺北市,信義區,0725,568,226,794,61,855,1463,58.44%,38.82%,1
臺北市,信義區,0726,552,204,756,63,819,1293,63.34%,42.69%,1
臺北市,信義區,0727,623,198,821,59,880,1553,56.66%,40.12%,1
臺北市,信義區,0728,537,199,736,44,780,1360,57.35%,39.49%,1
臺北市,信義區,0729,574,181,755,80,835,1392,59.99%,41.24%,1
臺北市,信義區,0730,545,194,739,31,770,1377,55.92%,39.58%,1
臺北市,信義區,0731,587,176,763,17,780,1377,56.64%,42.63%,1
臺北市,信義區,0732,448,215,663,39,702,1269,55.32%,35.3%,1
臺北市,信義區,0733,586,177,763,82,845,1407,60.06%,41.65%,1
臺北市,信義區,0734,491,153,644,40,684,1172,58.36%,41.89%,1
臺北市,信義區,0735,501,146,647,27,674,1182,57.02%,42.39%,1
臺北市,信義區,0736,518,166,684,62,746,1255,59.44%,41.27%,1
臺北市,信義區,0737,644,172,816,53,869,1689,51.45%,38.13%,1
臺北市,信義區,0738,644,187,831,37,868,1605,54.08%,40.12%,1
臺北市,信義區,0739,478,133,611,40,651,1143,56.96%,41.82%,1
臺北市,信義區,0740,560,172,732,45,777,1440,53.96%,38.89%,1
臺北市,信義區,0741,630,177,807,53,860,1495,57.53%,42.14%,1
臺北市,信義區,0742,625,201,826,61,887,1514,58.59%,41.28%,1
臺北市,信義區,0743,589,152,741,50,791,1449,54.59%,40.65%,1
臺北市,信義區,0744,608,189,797,52,849,1401,60.6%,43.4%,1
臺北市,信義區,0745,478,124,602,28,630,1181,53.34%,40.47%,1
臺北市,信義區,0746,632,180,812,35,847,1376,61.56%,45.93%,1
臺北市,信義區,0747,645,173,818,53,871,1422,61.25%,45.36%,1
臺北市,信義區,0748,552,142,694,28,722,1267,56.99%,43.57%,1
臺北市,信義區,0749,462,161,623,32,655,1220,53.69%,37.87%,1
臺北市,信義區,0750,592,178,770,31,801,1562,51.28%,37.9%,1
臺北市,信義區,0751,591,169,760,37,797,1455,54.78%,40.62%,1
臺北市,信義區,0752,652,175,827,52,879,1605,54.77%,40.62%,1
臺北市,信義區,0753,787,173,960,29,989,1626,60.82%,48.4%,1
臺北市,信義區,0754,647,202,849,84,933,1561,59.77%,41.45%,1
臺北市,信義區,0755,537,172,709,34,743,1547,48.03%,34.71%,1
臺北市,信義區,0756,566,164,730,30,760,1336,56.89%,42.37%,1
臺北市,信義區,0757,504,125,629,50,679,1314,51.67%,38.36%,1
臺北市,信義區,0758,511,141,652,49,701,1297,54.05%,39.4%,1
臺北市,信義區,0759,527,169,696,65,761,1366,55.71%,38.58%,1
臺北市,信義區,0760,576,203,779,62,841,1472,57.13%,39.13%,1
臺北市,信義區,0761,614,171,785,50,835,1450,57.59%,42.34%,1
臺北市,信義區,0762,529,186,715,57,772,1328,58.13%,39.83%,1
臺北市,信義區,0763,591,196,787,69,856,1399,61.19%,42.24%,1
臺北市,信義區,0764,573,190,763,76,839,1373,61.11%,41.73%,1
臺北市,信義區,0765,449,125,574,33,607,1099,55.23%,40.86%,1
臺北市,信義區,0766,488,167,655,52,707,1226,57.67%,39.8%,1
臺北市,信義區,0767,506,134,640,33,673,1267,53.12%,39.94%,1
臺北市,信義區,0768,643,200,843,74,917,1531,59.9%,42%,1
臺北市,信義區,0769,636,184,820,54,874,1438,60.78%,44.23%,1
臺北市,信義區,0770,667,191,858,31,889,1657,53.65%,40.25%,1
臺北市,信義區,0771,702,210,912,52,964,1621,59.47%,43.31%,1
臺北市,信義區,0772,628,209,837,34,871,1508,57.76%,41.64%,1
臺北市,信義區,0773,578,194,772,39,811,1334,60.79%,43.33%,1
臺北市,信義區,0774,412,131,543,51,594,1246,47.67%,33.07%,1
臺北市,信義區,0775,541,176,717,45,762,1196,63.71%,45.23%,1
臺北市,信義區,0776,524,159,683,32,715,1220,58.61%,42.95%,1
臺北市,信義區,0777,624,188,812,34,846,1538,55.01%,40.57%,1
臺北市,信義區,0778,687,182,869,74,943,1565,60.26%,43.9%,1
臺北市,信義區,0779,630,174,804,85,889,1621,54.84%,38.86%,1
臺北市,信義區,0780,597,171,768,69,837,1486,56.33%,40.17%,1
臺北市,信義區,0781,596,172,768,36,804,1507,53.35%,39.55%,1
臺北市,信義區,0782,650,177,827,72,899,1516,59.3%,42.88%,1
臺北市,信義區,0783,561,171,732,72,804,1287,62.47%,43.59%,1
臺北市,信義區,0784,380,119,499,58,557,1050,53.05%,36.19%,1
臺北市,信義區,0785,351,105,456,40,496,801,61.92%,43.82%,1
臺北市,大安區,1214,453,159,612,31,643,1184,54.31%,38.26%,1
臺北市,大安區,1215,465,144,609,44,653,1197,54.55%,38.85%,1
臺北市,大安區,1216,497,176,673,27,700,1221,57.33%,40.7%,1
臺北市,大安區,1217,580,139,719,23,742,1246,59.55%,46.55%,1
臺北市,大安區,1218,614,243,857,42,899,1478,60.83%,41.54%,1
臺北市,大安區,1219,493,193,686,65,751,1314,57.15%,37.52%,1
臺北市,大安區,1220,665,235,900,63,963,1594,60.41%,41.72%,1
臺北市,大安區,1221,598,225,823,30,853,1429,59.69%,41.85%,1
臺北市,大安區,1222,642,201,843,29,872,1452,60.06%,44.21%,1
臺北市,大安區,1223,603,247,850,36,886,1551,57.12%,38.88%,1
臺北市,大安區,1224,561,190,751,55,806,1335,60.37%,42.02%,1
臺北市,大安區,1225,455,157,612,30,642,1196,53.68%,38.04%,1
臺北市,大安區,1226,489,205,694,39,733,1339,54.74%,36.52%,1
臺北市,大安區,1227,534,226,760,45,805,1448,55.59%,36.88%,1
臺北市,大安區,1228,581,167,748,51,799,1373,58.19%,42.32%,1
臺北市,大安區,1229,561,204,765,71,836,1439,58.1%,38.99%,1
臺北市,大安區,1230,450,156,606,17,623,1174,53.07%,38.33%,1
臺北市,大安區,1231,413,156,569,31,600,1144,52.45%,36.1%,1
臺北市,大安區,1232,442,124,566,34,600,1119,53.62%,39.5%,1
臺北市,大安區,1233,357,108,465,34,499,1024,48.73%,34.86%,1
臺北市,大安區,1234,488,112,600,27,627,1032,60.76%,47.29%,1
臺北市,大安區,1235,659,94,753,41,794,1319,60.2%,49.96%,1
臺北市,大安區,1236,615,180,795,47,842,1369,61.5%,44.92%,1
臺北市,大安區,1237,518,221,739,56,795,1347,59.02%,38.46%,1
臺北市,大安區,1238,568,244,812,51,863,1655,52.15%,34.32%,1
臺北市,大安區,1239,575,185,760,41,801,1595,50.22%,36.05%,1
臺北市,大安區,1240,525,228,753,42,795,1429,55.63%,36.74%,1
臺北市,大安區,1241,478,172,650,26,676,1309,51.64%,36.52%,1
臺北市,大安區,1242,554,209,763,47,810,1508,53.71%,36.74%,1
臺北市,大安區,1243,462,213,675,44,719,1310,54.89%,35.27%,1
臺北市,大安區,1244,424,172,596,38,634,1233,51.42%,34.39%,1
臺北市,大安區,1245,466,163,629,58,687,1287,53.38%,36.21%,1
臺北市,大安區,1246,399,159,558,38,596,1147,51.96%,34.79%,1
臺北市,大安區,1247,465,177,642,33,675,1260,53.57%,36.9%,1
臺北市,大安區,1248,549,173,722,45,767,1377,55.7%,39.87%,1
臺北市,大安區,1249,488,158,646,68,714,1284,55.61%,38.01%,1
臺北市,大安區,1250,493,154,647,36,683,1314,51.98%,37.52%,1
臺北市,大安區,1251,456,189,645,32,677,1273,53.18%,35.82%,1
臺北市,大安區,1252,453,184,637,29,666,1146,58.12%,39.53%,1
臺北市,大安區,1253,517,204,721,30,751,1285,58.44%,40.23%,1
臺北市,大安區,1254,542,207,749,33,782,1297,60.29%,41.79%,1
臺北市,大安區,1255,486,153,639,34,673,1101,61.13%,44.14%,1
臺北市,大安區,1256,497,196,693,62,755,1310,57.63%,37.94%,1
臺北市,大安區,1257,540,226,766,65,831,1365,60.88%,39.56%,1
臺北市,大安區,1258,561,187,748,32,780,1372,56.85%,40.89%,1
臺北市,大安區,1259,501,194,695,34,729,1189,61.31%,42.14%,1
臺北市,大安區,1260,498,201,699,47,746,1256,59.39%,39.65%,1
臺北市,大安區,1261,487,166,653,37,690,1151,59.95%,42.31%,1
臺北市,大安區,1262,481,196,677,45,722,1501,48.1%,32.05%,1
臺北市,大安區,1263,657,203,860,40,900,1520,59.21%,43.22%,1
臺北市,大安區,1264,645,252,897,52,949,1529,62.07%,42.18%,1
臺北市,大安區,1265,671,233,904,54,958,1579,60.67%,42.5%,1
臺北市,大安區,1266,470,159,629,48,677,2619,25.85%,17.95%,1
臺北市,大安區,1267,555,153,708,28,736,1290,57.05%,43.02%,1
臺北市,大安區,1268,541,227,768,39,807,1307,61.74%,41.39%,1
臺北市,大安區,1269,631,191,822,36,858,1489,57.62%,42.38%,1
臺北市,大安區,1270,496,149,645,40,685,1097,62.44%,45.21%,1
臺北市,大安區,1271,542,182,724,48,772,1328,58.13%,40.81%,1
臺北市,大安區,1272,469,181,650,26,676,1189,56.85%,39.44%,1
臺北市,大安區,1273,508,202,710,26,736,1270,57.95%,40%,1
臺北市,大安區,1274,528,207,735,21,756,1349,56.04%,39.14%,1
臺北市,大安區,1275,515,170,685,35,720,1292,55.73%,39.86%,1
臺北市,大安區,1276,564,197,761,43,804,1314,61.19%,42.92%,1
臺北市,大安區,1277,483,195,678,52,730,1200,60.83%,40.25%,1
臺北市,大安區,1278,610,244,854,50,904,1558,58.02%,39.15%,1
臺北市,大安區,1279,617,228,845,47,892,1561,57.14%,39.53%,1
臺北市,大安區,1280,617,186,803,59,862,1446,59.61%,42.67%,1
臺北市,大安區,1281,635,203,838,43,881,1499,58.77%,42.36%,1
臺北市,大安區,1282,640,186,826,30,856,1467,58.35%,43.63%,1
臺北市,大安區,1283,568,120,688,52,740,1511,48.97%,37.59%,1
臺北市,大安區,1284,674,223,897,61,958,1600,59.88%,42.13%,1
臺北市,大安區,1285,619,258,877,53,930,1573,59.12%,39.35%,1
臺北市,大安區,1286,636,208,844,51,895,1467,61.01%,43.35%,1
臺北市,大安區,1287,584,160,744,61,805,1358,59.28%,43%,1
臺北市,大安區,1288,620,209,829,71,900,1568,57.4%,39.54%,1
臺北市,大安區,1289,575,216,791,47,838,1411,59.39%,40.75%,1
臺北市,大安區,1290,666,198,864,30,894,1554,57.53%,42.86%,1
臺北市,大安區,1291,604,175,779,43,822,1345,61.12%,44.91%,1
臺北市,大安區,1292,652,149,801,27,828,1435,57.7%,45.44%,1
臺北市,大安區,1293,708,185,893,30,923,1481,62.32%,47.81%,1
臺北市,大安區,1294,734,157,891,40,931,1451,64.16%,50.59%,1
臺北市,大安區,1295,628,227,855,66,921,1566,58.81%,40.1%,1
臺北市,大安區,1296,624,226,850,39,889,1525,58.3%,40.92%,1
臺北市,大安區,1297,517,167,684,52,736,1336,55.09%,38.7%,1
臺北市,大安區,1298,606,222,828,65,893,1483,60.22%,40.86%,1
臺北市,大安區,1299,514,154,668,40,708,1396,50.72%,36.82%,1
臺北市,大安區,1300,605,204,809,62,871,1406,61.95%,43.03%,1
臺北市,大安區,1301,600,212,812,40,852,1434,59.41%,41.84%,1
臺北市,大安區,1302,521,190,711,37,748,1288,58.07%,40.45%,1
臺北市,大安區,1303,584,204,788,42,830,1407,58.99%,41.51%,1
臺北市,大安區,1304,563,203,766,43,809,1514,53.43%,37.19%,1
臺北市,大安區,1305,552,159,711,59,770,1550,49.68%,35.61%,1
臺北市,大安區,1306,624,192,816,54,870,1490,58.39%,41.88%,1
臺北市,大安區,1307,503,168,671,35,706,1284,54.98%,39.17%,1
臺北市,大安區,1308,503,134,637,39,676,1129,59.88%,44.55%,1
臺北市,大安區,1309,500,176,676,27,703,1193,58.93%,41.91%,1
臺北市,大安區,1310,413,151,564,36,600,1057,56.76%,39.07%,1
臺北市,大安區,1311,532,196,728,53,781,1361,57.38%,39.09%,1
臺北市,大安區,1312,557,169,726,68,794,1412,56.23%,39.45%,1
臺北市,大安區,1313,461,174,635,50,685,1423,48.14%,32.4%,1
臺北市,大安區,1314,475,176,651,85,736,1257,58.55%,37.79%,1
臺北市,大安區,1315,470,180,650,53,703,1133,62.05%,41.48%,1
臺北市,大安區,1316,405,158,563,38,601,1077,55.8%,37.6%,1
臺北市,大安區,1317,538,197,735,51,786,1300,60.46%,41.38%,1
臺北市,大安區,1318,600,151,751,70,821,1319,62.24%,45.49%,1
臺北市,大安區,1319,535,146,681,75,756,1265,59.76%,42.29%,1
臺北市,大安區,1320,486,158,644,39,683,1265,53.99%,38.42%,1
臺北市,大安區,1321,480,138,618,35,653,1103,59.2%,43.52%,1
臺北市,大安區,1322,604,139,743,42,785,1341,58.54%,45.04%,1
臺北市,大安區,1323,618,155,773,50,823,1357,60.65%,45.54%,1
臺北市,大安區,1324,526,179,705,42,747,1260,59.29%,41.75%,1
臺北市,大安區,1325,556,170,726,40,766,1295,59.15%,42.93%,1
臺北市,大安區,1326,542,155,697,40,737,1399,52.68%,38.74%,1
臺北市,大安區,1327,461,163,624,37,661,1150,57.48%,40.09%,1
臺北市,大安區,1328,532,145,677,36,713,1351,52.78%,39.38%,1
臺北市,大安區,1329,552,196,748,49,797,1341,59.43%,41.16%,1
臺北市,大安區,1330,466,141,607,23,630,1129,55.8%,41.28%,1
臺北市,大安區,1331,584,144,728,25,753,1328,56.7%,43.98%,1
臺北市,大安區,1332,788,140,928,48,976,1557,62.68%,50.61%,1
臺北市,大安區,1333,687,188,875,50,925,1461,63.31%,47.02%,1
臺北市,大安區,1334,615,165,780,33,813,1589,51.16%,38.7%,1
臺北市,大安區,1335,640,149,789,40,829,1473,56.28%,43.45%,1
臺北市,大安區,1336,499,299,798,39,837,1479,56.59%,33.74%,1
臺北市,大安區,1337,370,117,487,33,520,833,62.42%,44.42%,1
臺北市,大安區,1338,412,123,535,30,565,999,56.56%,41.24%,1
臺北市,大安區,1339,819,187,1006,44,1050,1757,59.76%,46.61%,1
臺北市,大安區,1340,679,197,876,40,916,1573,58.23%,43.17%,1
臺北市,大安區,1341,697,230,927,53,980,1587,61.75%,43.92%,1
臺北市,大安區,1342,597,255,852,62,914,1496,61.1%,39.91%,1
臺北市,大安區,1343,596,201,797,48,845,1440,58.68%,41.39%,1
臺北市,大安區,1344,655,240,895,56,951,1578,60.27%,41.51%,1
臺北市,大安區,1345,486,193,679,32,711,1223,58.14%,39.74%,1
臺北市,大安區,1346,445,169,614,21,635,1119,56.75%,39.77%,1
臺北市,大安區,1347,554,169,723,25,748,1252,59.74%,44.25%,1
臺北市,大安區,1348,649,230,879,45,924,1576,58.63%,41.18%,1
臺北市,大安區,1349,568,187,755,47,802,1425,56.28%,39.86%,1
臺北市,大安區,1350,537,206,743,33,776,1450,53.52%,37.03%,1
臺北市,大安區,1351,558,207,765,42,807,1444,55.89%,38.64%,1
臺北市,大安區,1352,580,204,784,44,828,1337,61.93%,43.38%,1
臺北市,大安區,1353,539,181,720,35,755,1417,53.28%,38.04%,1
臺北市,大安區,1354,317,259,576,54,630,1250,50.4%,25.36%,1
臺北市,大安區,1355,474,149,623,61,684,1176,58.16%,40.31%,1
臺北市,大安區,1356,552,180,732,52,784,1257,62.37%,43.91%,1
臺北市,大安區,1357,525,171,696,53,749,1257,59.59%,41.77%,1
臺北市,大安區,1358,472,154,626,32,658,1148,57.32%,41.11%,1
臺北市,大安區,1359,559,200,759,61,820,1418,57.83%,39.42%,1
臺北市,大安區,1360,418,132,550,25,575,1028,55.93%,40.66%,1
臺北市,大安區,1361,506,210,716,54,770,1445,53.29%,35.02%,1
臺北市,大安區,1362,582,171,753,55,808,1361,59.37%,42.76%,1
臺北市,大安區,1363,573,194,767,53,820,1343,61.06%,42.67%,1
臺北市,大安區,1364,516,174,690,62,752,1267,59.35%,40.73%,1
臺北市,大安區,1365,547,170,717,35,752,1380,54.49%,39.64%,1
臺北市,大安區,1366,607,183,790,61,851,1524,55.84%,39.83%,1
臺北市,大安區,1367,633,183,816,42,858,1470,58.37%,43.06%,1
臺北市,大安區,1368,507,124,631,61,692,1318,52.5%,38.47%,1
臺北市,大安區,1369,566,181,747,47,794,1430,55.52%,39.58%,1
臺北市,大安區,1370,561,180,741,56,797,1386,57.5%,40.48%,1
臺北市,大安區,1371,539,187,726,32,758,1438,52.71%,37.48%,1
臺北市,大安區,1372,465,160,625,29,654,1270,51.5%,36.61%,1
臺北市,大安區,1373,537,173,710,67,777,1395,55.7%,38.49%,1
臺北市,大安區,1374,518,169,687,49,736,1292,56.97%,40.09%,1
臺北市,大安區,1375,522,165,687,42,729,1310,55.65%,39.85%,1
臺北市,大安區,1376,513,182,695,40,735,1319,55.72%,38.89%,1
臺北市,大安區,1377,636,119,755,30,785,1355,57.93%,46.94%,1
臺北市,大安區,1378,512,146,658,28,686,1312,52.29%,39.02%,1
臺北市,大安區,1379,559,157,716,29,745,1335,55.81%,41.87%,1
臺北市,大安區,1380,550,188,738,42,780,1489,52.38%,36.94%,1
臺北市,大安區,1381,551,166,717,28,745,1307,57%,42.16%,1
臺北市,大安區,1382,493,187,680,20,700,1328,52.71%,37.12%,1
臺北市,大安區,1383,484,166,650,10,660,1277,51.68%,37.9%,1
臺北市,大安區,1384,537,165,702,44,746,1314,56.77%,40.87%,1
臺北市,大安區,1385,516,195,711,55,766,1270,60.31%,40.63%,1
臺北市,大安區,1386,510,187,697,59,756,1308,57.8%,38.99%,1
臺北市,大安區,1387,445,155,600,33,633,1138,55.62%,39.1%,1
臺北市,大安區,1388,559,147,706,31,737,1333,55.29%,41.94%,1
臺北市,大安區,1389,484,155,639,45,684,1176,58.16%,41.16%,1
臺北市,大安區,1390,514,189,703,53,756,1311,57.67%,39.21%,1
臺北市,大安區,1391,500,179,679,32,711,1295,54.9%,38.61%,1
臺北市,大安區,1392,587,178,765,59,824,1421,57.99%,41.31%,1
臺北市,大安區,1393,556,177,733,49,782,1409,55.5%,39.46%,1
臺北市,大安區,1394,607,201,808,39,847,1434,59.07%,42.33%,1
臺北市,大安區,1395,528,199,727,55,782,1449,53.97%,36.44%,1
臺北市,大安區,1396,520,183,703,55,758,1284,59.03%,40.5%,1
臺北市,大安區,1397,485,154,639,33,672,1248,53.85%,38.86%,1
臺北市,大安區,1398,505,180,685,33,718,1119,64.16%,45.13%,1
臺北市,大安區,1399,388,108,496,36,532,883,60.25%,43.94%,1
臺北市,大安區,1400,244,75,319,40,359,630,56.98%,38.73%,1
臺北市,大安區,1401,3,123,126,33,159,814,19.53%,0.37%,1
臺北市,中山區,0786,633,188,821,49,870,1522,57.16%,41.59%,1
臺北市,中山區,0787,486,213,699,34,733,1332,55.03%,36.49%,1
臺北市,中山區,0788,583,198,781,55,836,1656,50.48%,35.21%,1
臺北市,中山區,0789,456,195,651,58,709,1367,51.87%,33.36%,1
臺北市,中山區,0790,509,321,830,53,883,1732,50.98%,29.39%,1
臺北市,中山區,0791,656,218,874,64,938,1634,57.41%,40.15%,1
臺北市,中山區,0792,589,236,825,65,890,1650,53.94%,35.7%,1
臺北市,中山區,0793,521,243,764,49,813,1392,58.41%,37.43%,1
臺北市,中山區,0794,465,221,686,39,725,1177,61.6%,39.51%,1
臺北市,中山區,0795,573,221,794,67,861,1477,58.29%,38.79%,1
臺北市,中山區,0796,375,146,521,60,581,1063,54.66%,35.28%,1
臺北市,中山區,0797,481,158,639,48,687,1296,53.01%,37.11%,1
臺北市,中山區,0798,487,189,676,40,716,1330,53.83%,36.62%,1
臺北市,中山區,0799,518,214,732,68,800,1483,53.94%,34.93%,1
臺北市,中山區,0800,603,184,787,46,833,1542,54.02%,39.11%,1
臺北市,中山區,0801,621,209,830,60,890,1710,52.05%,36.32%,1
臺北市,中山區,0802,476,154,630,37,667,1315,50.72%,36.2%,1
臺北市,中山區,0803,465,164,629,73,702,1245,56.39%,37.35%,1
臺北市,中山區,0804,491,142,633,48,681,1262,53.96%,38.91%,1
臺北市,中山區,0805,567,242,809,62,871,1518,57.38%,37.35%,1
臺北市,中山區,0806,572,226,798,79,877,1522,57.62%,37.58%,1
臺北市,中山區,0807,513,237,750,77,827,1580,52.34%,32.47%,1
臺北市,中山區,0808,602,205,807,48,855,1529,55.92%,39.37%,1
臺北市,中山區,0809,475,161,636,49,685,1221,56.1%,38.9%,1
臺北市,中山區,0810,488,183,671,53,724,1221,59.3%,39.97%,1
臺北市,中山區,0811,431,112,543,32,575,1139,50.48%,37.84%,1
臺北市,中山區,0812,494,218,712,85,797,1407,56.65%,35.11%,1
臺北市,中山區,0813,507,203,710,44,754,1321,57.08%,38.38%,1
臺北市,中山區,0814,576,164,740,48,788,1578,49.94%,36.5%,1
臺北市,中山區,0815,638,176,814,61,875,1739,50.32%,36.69%,1
臺北市,中山區,0816,589,220,809,49,858,1637,52.41%,35.98%,1
臺北市,中山區,0817,553,207,760,81,841,1541,54.57%,35.89%,1
臺北市,中山區,0818,488,174,662,57,719,1210,59.42%,40.33%,1
臺北市,中山區,0819,495,177,672,50,722,1331,54.24%,37.19%,1
臺北市,中山區,0820,421,153,574,70,644,1224,52.61%,34.4%,1
臺北市,中山區,0821,634,205,839,66,905,1585,57.1%,40%,1
臺北市,中山區,0822,615,239,854,93,947,1523,62.18%,40.38%,1
臺北市,中山區,0823,581,195,776,69,845,1368,61.77%,42.47%,1
臺北市,中山區,0824,802,175,977,58,1035,1805,57.34%,44.43%,1
臺北市,中山區,0825,656,116,772,56,828,1404,58.97%,46.72%,1
臺北市,中山區,0826,716,297,1013,55,1068,1708,62.53%,41.92%,1
臺北市,中山區,0827,635,208,843,69,912,1451,62.85%,43.76%,1
臺北市,中山區,0828,712,231,943,88,1031,1684,61.22%,42.28%,1
臺北市,中山區,0829,682,161,843,42,885,1585,55.84%,43.03%,1
臺北市,中山區,0830,559,197,756,81,837,1391,60.17%,40.19%,1
臺北市,中山區,0831,601,225,826,86,912,1375,66.33%,43.71%,1
臺北市,中山區,0832,628,230,858,26,884,1472,60.05%,42.66%,1
臺北市,中山區,0833,521,173,694,43,737,1327,55.54%,39.26%,1
臺北市,中山區,0834,622,164,786,35,821,1401,58.6%,44.4%,1
臺北市,中山區,0835,589,200,789,47,836,1423,58.75%,41.39%,1
臺北市,中山區,0836,633,237,870,50,920,1569,58.64%,40.34%,1
臺北市,中山區,0837,677,236,913,33,946,1651,57.3%,41.01%,1
臺北市,中山區,0838,666,200,866,31,897,1624,55.23%,41.01%,1
臺北市,中山區,0839,730,264,994,58,1052,1713,61.41%,42.62%,1
臺北市,中山區,0840,713,223,936,49,985,1647,59.81%,43.29%,1
臺北市,中山區,0841,664,236,900,54,954,1762,54.14%,37.68%,1
臺北市,中山區,0842,629,182,811,48,859,1399,61.4%,44.96%,1
臺北市,中山區,0843,663,214,877,46,923,1489,61.99%,44.53%,1
臺北市,中山區,0844,582,157,739,39,778,1269,61.31%,45.86%,1
臺北市,中山區,0845,456,126,582,49,631,998,63.23%,45.69%,1
臺北市,中山區,0846,471,186,657,68,725,1472,49.25%,32%,1
臺北市,中山區,0847,523,224,747,56,803,1517,52.93%,34.48%,1
臺北市,中山區,0848,722,225,947,80,1027,1704,60.27%,42.37%,1
臺北市,中山區,0849,560,289,849,77,926,1603,57.77%,34.93%,1
臺北市,中山區,0850,500,198,698,91,789,1432,55.1%,34.92%,1
臺北市,中山區,0851,597,228,825,73,898,1500,59.87%,39.8%,1
臺北市,中山區,0852,539,247,786,10,796,1332,59.76%,40.47%,1
臺北市,中山區,0853,571,242,813,63,876,1450,60.41%,39.38%,1
臺北市,中山區,0854,584,219,803,57,860,1434,59.97%,40.73%,1
臺北市,中山區,0855,516,200,716,48,764,1419,53.84%,36.36%,1
臺北市,中山區,0856,464,202,666,47,713,1292,55.19%,35.91%,1
臺北市,中山區,0857,537,229,766,67,833,1526,54.59%,35.19%,1
臺北市,中山區,0858,530,187,717,63,780,1582,49.3%,33.5%,1
臺北市,中山區,0859,533,217,750,73,823,1588,51.83%,33.56%,1
臺北市,中山區,0860,529,229,758,80,838,1463,57.28%,36.16%,1
臺北市,中山區,0861,514,213,727,61,788,1533,51.4%,33.53%,1
臺北市,中山區,0862,332,153,485,61,546,944,57.84%,35.17%,1
臺北市,中山區,0863,704,305,1009,80,1089,1745,62.41%,40.34%,1
臺北市,中山區,0864,579,205,784,57,841,1679,50.09%,34.48%,1
臺北市,中山區,0865,558,196,754,60,814,3419,23.81%,16.32%,1
臺北市,中山區,0866,552,198,750,80,830,1387,59.84%,39.8%,1
臺北市,中山區,0867,660,235,895,84,979,1672,58.55%,39.47%,1
臺北市,中山區,0868,514,186,700,69,769,1319,58.3%,38.97%,1
臺北市,中山區,0869,497,207,704,66,770,1364,56.45%,36.44%,1
臺北市,中山區,0870,527,223,750,61,811,1461,55.51%,36.07%,1
臺北市,中山區,0871,446,191,637,56,693,1173,59.08%,38.02%,1
臺北市,中山區,0872,424,141,565,63,628,1171,53.63%,36.21%,1
臺北市,中山區,0873,502,189,691,51,742,1310,56.64%,38.32%,1
臺北市,中山區,0874,603,168,771,54,825,1373,60.09%,43.92%,1
臺北市,中山區,0875,537,190,727,40,767,1290,59.46%,41.63%,1
臺北市,中山區,0876,562,188,750,68,818,1346,60.77%,41.75%,1
臺北市,中山區,0877,590,229,819,70,889,1468,60.56%,40.19%,1
臺北市,中山區,0878,494,170,664,33,697,1178,59.17%,41.94%,1
臺北市,中山區,0879,683,241,924,55,979,1654,59.19%,41.29%,1
臺北市,中山區,0880,608,186,794,65,859,1464,58.67%,41.53%,1
臺北市,中山區,0881,534,220,754,40,794,1450,54.76%,36.83%,1
臺北市,中山區,0882,579,222,801,71,872,1534,56.84%,37.74%,1
臺北市,中山區,0883,648,228,876,53,929,1703,54.55%,38.05%,1
臺北市,中山區,0884,636,220,856,88,944,1610,58.63%,39.5%,1
臺北市,中山區,0885,659,200,859,85,944,1653,57.11%,39.87%,1
臺北市,中山區,0886,669,271,940,68,1008,1694,59.5%,39.49%,1
臺北市,中山區,0887,594,254,848,69,917,1623,56.5%,36.6%,1
臺北市,中山區,0888,607,273,880,65,945,1618,58.41%,37.52%,1
臺北市,中山區,0889,607,229,836,53,889,1583,56.16%,38.34%,1
臺北市,中山區,0890,585,289,874,77,951,1605,59.25%,36.45%,1
臺北市,中山區,0891,577,254,831,57,888,1398,63.52%,41.27%,1
臺北市,中山區,0892,668,244,912,68,980,1526,64.22%,43.77%,1
臺北市,中山區,0893,586,257,843,65,908,1555,58.39%,37.68%,1
臺北市,中山區,0894,617,212,829,52,881,1597,55.17%,38.63%,1
臺北市,中山區,0895,598,237,835,95,930,1587,58.6%,37.68%,1
臺北市,中山區,0896,693,188,881,76,957,1587,60.3%,43.67%,1
臺北市,中山區,0897,621,239,860,83,943,1546,61%,40.17%,1
臺北市,中山區,0898,520,167,687,64,751,1322,56.81%,39.33%,1
臺北市,中山區,0899,512,175,687,52,739,1267,58.33%,40.41%,1
臺北市,中山區,0900,520,143,663,20,683,1210,56.45%,42.98%,1
臺北市,中山區,0901,525,160,685,63,748,1295,57.76%,40.54%,1
臺北市,中山區,0902,672,209,881,65,946,1467,64.49%,45.81%,1
臺北市,中山區,0903,686,148,834,48,882,1491,59.15%,46.01%,1
臺北市,中山區,0904,778,149,927,62,989,1516,65.24%,51.32%,1
臺北市,中山區,0905,502,188,690,51,741,1384,53.54%,36.27%,1
臺北市,中山區,0906,513,165,678,47,725,1138,63.71%,45.08%,1
臺北市,中山區,0907,549,212,761,36,797,1513,52.68%,36.29%,1
臺北市,中山區,0908,650,198,848,75,923,1559,59.2%,41.69%,1
臺北市,中山區,0909,597,198,795,87,882,1429,61.72%,41.78%,1
臺北市,中山區,0910,502,207,709,56,765,1245,61.45%,40.32%,1
臺北市,中山區,0911,513,176,689,58,747,1214,61.53%,42.26%,1
臺北市,中山區,0912,532,234,766,55,821,1394,58.9%,38.16%,1
臺北市,中山區,0913,494,169,663,24,687,1336,51.42%,36.98%,1
臺北市,中山區,0914,498,151,649,49,698,1227,56.89%,40.59%,1
臺北市,中山區,0915,561,210,771,44,815,1382,58.97%,40.59%,1
臺北市,中山區,0916,577,190,767,57,824,1436,57.38%,40.18%,1
臺北市,中山區,0917,514,180,694,40,734,1405,52.24%,36.58%,1
臺北市,中山區,0918,541,142,683,43,726,1259,57.66%,42.97%,1
臺北市,中正區,1001,541,197,738,44,782,1308,59.79%,41.36%,1
臺北市,中正區,1002,467,193,660,81,741,1317,56.26%,35.46%,1
臺北市,中正區,1003,510,116,626,35,661,1069,61.83%,47.71%,1
臺北市,中正區,1004,476,110,586,46,632,1128,56.03%,42.2%,1
臺北市,中正區,1005,440,149,589,52,641,1053,60.87%,41.79%,1
臺北市,中正區,1006,442,133,575,24,599,1048,57.16%,42.18%,1
臺北市,中正區,1007,547,128,675,59,734,1297,56.59%,42.17%,1
臺北市,中正區,1008,515,167,682,30,712,1193,59.68%,43.17%,1
臺北市,中正區,1009,692,225,917,53,970,1500,64.67%,46.13%,1
臺北市,中正區,1010,530,176,706,40,746,1346,55.42%,39.38%,1
臺北市,中正區,1011,538,174,712,24,736,1283,57.37%,41.93%,1
臺北市,中正區,1012,582,184,766,57,823,1450,56.76%,40.14%,1
臺北市,中正區,1013,604,192,796,58,854,1433,59.6%,42.15%,1
臺北市,中正區,1014,580,225,805,56,861,1309,65.78%,44.31%,1
臺北市,中正區,1015,580,198,778,27,805,1386,58.08%,41.85%,1
臺北市,中正區,1016,519,163,682,47,729,1201,60.7%,43.21%,1
臺北市,中正區,1017,582,184,766,61,827,1336,61.9%,43.56%,1
臺北市,中正區,1018,577,197,774,52,826,1358,60.82%,42.49%,1
臺北市,中正區,1019,503,156,659,55,714,1177,60.66%,42.74%,1
臺北市,中正區,1020,578,171,749,38,787,1236,63.67%,46.76%,1
臺北市,中正區,1021,598,205,803,54,857,1478,57.98%,40.46%,1
臺北市,中正區,1022,637,193,830,28,858,1474,58.21%,43.22%,1
臺北市,中正區,1023,493,150,643,47,690,1172,58.87%,42.06%,1
臺北市,中正區,1024,526,198,724,49,773,1310,59.01%,40.15%,1
臺北市,中正區,1025,558,152,710,52,762,1263,60.33%,44.18%,1
臺北市,中正區,1026,480,176,656,45,701,1169,59.97%,41.06%,1
臺北市,中正區,1027,623,135,758,33,791,1391,56.87%,44.79%,1
臺北市,中正區,1028,480,167,647,39,686,1201,57.12%,39.97%,1
臺北市,中正區,1029,545,189,734,52,786,1324,59.37%,41.16%,1
臺北市,中正區,1030,473,143,616,65,681,1216,56%,38.9%,1
臺北市,中正區,1031,459,174,633,47,680,1183,57.48%,38.8%,1
臺北市,中正區,1032,585,226,811,76,887,1469,60.38%,39.82%,1
臺北市,中正區,1033,577,187,764,63,827,1411,58.61%,40.89%,1
臺北市,中正區,1034,573,186,759,86,845,1398,60.44%,40.99%,1
臺北市,中正區,1035,593,172,765,74,839,1479,56.73%,40.09%,1
臺北市,中正區,1036,654,169,823,87,910,1620,56.17%,40.37%,1
臺北市,中正區,1037,419,149,568,19,587,1041,56.39%,40.25%,1
臺北市,中正區,1038,399,161,560,20,580,1056,54.92%,37.78%,1
臺北市,中正區,1039,465,169,634,42,676,1063,63.59%,43.74%,1
臺北市,中正區,1040,501,173,674,69,743,1591,46.7%,31.49%,1
臺北市,中正區,1041,484,144,628,84,712,1502,47.4%,32.22%,1
臺北市,中正區,1042,502,140,642,69,711,1331,53.42%,37.72%,1
臺北市,中正區,1043,563,184,747,71,818,1441,56.77%,39.07%,1
臺北市,中正區,1044,555,180,735,56,791,1273,62.14%,43.6%,1
臺北市,中正區,1045,468,171,639,54,693,1133,61.17%,41.31%,1
臺北市,中正區,1046,496,152,648,45,693,1156,59.95%,42.91%,1
臺北市,中正區,1047,530,199,729,69,798,1377,57.95%,38.49%,1
臺北市,中正區,1048,531,174,705,72,777,1266,61.37%,41.94%,1
臺北市,中正區,1049,519,142,661,48,709,1111,63.82%,46.71%,1
臺北市,中正區,1050,488,134,622,32,654,1124,58.19%,43.42%,1
臺北市,中正區,1051,59,200,259,56,315,1373,22.94%,4.3%,1
臺北市,中正區,1052,598,186,784,48,832,1351,61.58%,44.26%,1
臺北市,中正區,1053,620,214,834,38,872,1495,58.33%,41.47%,1
臺北市,中正區,1054,635,209,844,68,912,1436,63.51%,44.22%,1
臺北市,中正區,1055,637,193,830,33,863,1516,56.93%,42.02%,1
臺北市,中正區,1056,575,179,754,42,796,1374,57.93%,41.85%,1
臺北市,中正區,1057,594,192,786,48,834,1522,54.8%,39.03%,1
臺北市,中正區,1058,551,184,735,47,782,1336,58.53%,41.24%,1
臺北市,中正區,1059,633,220,853,52,905,1551,58.35%,40.81%,1
臺北市,中正區,1060,659,226,885,68,953,1594,59.79%,41.34%,1
臺北市,中正區,1061,586,214,800,78,878,1503,58.42%,38.99%,1
臺北市,中正區,1062,633,184,817,42,859,1455,59.04%,43.51%,1
臺北市,中正區,1063,637,182,819,23,842,1439,58.51%,44.27%,1
臺北市,中正區,1064,612,200,812,51,863,1469,58.75%,41.66%,1
臺北市,中正區,1065,665,156,821,37,858,1430,60%,46.5%,1
臺北市,中正區,1066,641,190,831,60,891,1444,61.7%,44.39%,1
臺北市,中正區,1067,551,142,693,29,722,1254,57.58%,43.94%,1
臺北市,中正區,1068,403,127,530,47,577,932,61.91%,43.24%,1
臺北市,中正區,1069,420,172,592,51,643,1055,60.95%,39.81%,1
臺北市,中正區,1070,519,159,678,43,721,1226,58.81%,42.33%,1
臺北市,中正區,1071,507,171,678,54,732,1390,52.66%,36.47%,1
臺北市,中正區,1072,565,166,731,43,774,1336,57.93%,42.29%,1
臺北市,中正區,1073,509,182,691,61,752,1419,53%,35.87%,1
臺北市,中正區,1074,567,227,794,51,845,1361,62.09%,41.66%,1
臺北市,中正區,1075,652,204,856,54,910,2520,36.11%,25.87%,1
臺北市,中正區,1076,519,162,681,19,700,1224,57.19%,42.4%,1
臺北市,中正區,1077,471,181,652,5,657,1272,51.65%,37.03%,1
臺北市,中正區,1078,505,255,760,51,811,1400,57.93%,36.07%,1
臺北市,中正區,1079,484,192,676,38,714,1319,54.13%,36.69%,1
臺北市,中正區,1080,529,176,705,53,758,1232,61.53%,42.94%,1
臺北市,中正區,1081,571,181,752,46,798,1265,63.08%,45.14%,1
臺北市,中正區,1082,491,154,645,27,672,1055,63.7%,46.54%,1
臺北市,中正區,1083,402,137,539,27,566,954,59.33%,42.14%,1
臺北市,中正區,1084,432,141,573,37,610,1018,59.92%,42.44%,1
臺北市,中正區,1085,564,197,761,43,804,1431,56.18%,39.41%,1
臺北市,中正區,1086,463,159,622,46,668,1271,52.56%,36.43%,1
臺北市,中正區,1087,386,181,567,47,614,983,62.46%,39.27%,1
臺北市,中正區,1088,613,240,853,48,901,1594,56.52%,38.46%,1
臺北市,中正區,1089,704,193,897,58,955,1565,61.02%,44.98%,1
臺北市,中正區,1090,666,231,897,47,944,1650,57.21%,40.36%,1
臺北市,中正區,1091,597,232,829,45,874,1600,54.63%,37.31%,1
臺北市,中正區,1092,542,209,751,23,774,1391,55.64%,38.96%,1
臺北市,中正區,1093,700,249,949,53,1002,1769,56.64%,39.57%,1
臺北市,中正區,1094,572,258,830,58,888,1487,59.72%,38.47%,1
臺北市,中正區,1095,540,208,748,32,780,1291,60.42%,41.83%,1
臺北市,中正區,1096,536,204,740,35,775,1289,60.12%,41.58%,1
臺北市,大同區,0919,455,203,658,87,745,1261,59.08%,36.08%,1
臺北市,大同區,0920,520,245,765,68,833,1352,61.61%,38.46%,1
臺北市,大同區,0921,548,225,773,63,836,1462,57.18%,37.48%,1
臺北市,大同區,0922,595,201,796,71,867,1510,57.42%,39.4%,1
臺北市,大同區,0923,503,234,737,37,774,1496,51.74%,33.62%,1
臺北市,大同區,0924,480,200,680,87,767,1329,57.71%,36.12%,1
臺北市,大同區,0925,487,194,681,86,767,1307,58.68%,37.26%,1
臺北市,大同區,0926,410,155,565,63,628,1065,58.97%,38.5%,1
臺北市,大同區,0927,406,160,566,48,614,1085,56.59%,37.42%,1
臺北市,大同區,0928,401,189,590,66,656,1047,62.66%,38.3%,1
臺北市,大同區,0929,414,174,588,44,632,1215,52.02%,34.07%,1
臺北市,大同區,0930,427,219,646,40,686,1117,61.41%,38.23%,1
臺北市,大同區,0931,483,187,670,58,728,1186,61.38%,40.73%,1
臺北市,大同區,0932,447,212,659,64,723,1185,61.01%,37.72%,1
臺北市,大同區,0933,517,195,712,48,760,1359,55.92%,38.04%,1
臺北市,大同區,0934,510,173,683,34,717,1273,56.32%,40.06%,1
臺北市,大同區,0935,521,202,723,56,779,1291,60.34%,40.36%,1
臺北市,大同區,0936,485,168,653,51,704,1288,54.66%,37.66%,1
臺北市,大同區,0937,505,210,715,55,770,1245,61.85%,40.56%,1
臺北市,大同區,0938,531,195,726,65,791,1261,62.73%,42.11%,1
臺北市,大同區,0939,503,197,700,35,735,1348,54.53%,37.31%,1
臺北市,大同區,0940,623,255,878,102,980,1676,58.47%,37.17%,1
臺北市,大同區,0941,542,194,736,67,803,1311,61.25%,41.34%,1
臺北市,大同區,0942,498,210,708,87,795,1316,60.41%,37.84%,1
臺北市,大同區,0943,520,222,742,74,816,1409,57.91%,36.91%,1
臺北市,大同區,0944,565,229,794,70,864,1436,60.17%,39.35%,1
臺北市,大同區,0945,531,238,769,64,833,1408,59.16%,37.71%,1
臺北市,大同區,0946,479,207,686,46,732,1276,57.37%,37.54%,1
臺北市,大同區,0947,460,146,606,18,624,1110,56.22%,41.44%,1
臺北市,大同區,0948,526,197,723,35,758,1324,57.25%,39.73%,1
臺北市,大同區,0949,382,154,536,48,584,1016,57.48%,37.6%,1
臺北市,大同區,0950,430,160,590,47,637,1028,61.96%,41.83%,1
臺北市,大同區,0951,466,173,639,60,699,1158,60.36%,40.24%,1
臺北市,大同區,0952,470,164,634,57,691,1138,60.72%,41.3%,1
臺北市,大同區,0953,484,170,654,72,726,1214,59.8%,39.87%,1
臺北市,大同區,0954,418,167,585,26,611,1090,56.06%,38.35%,1
臺北市,大同區,0955,561,199,760,67,827,1305,63.37%,42.99%,1
臺北市,大同區,0956,428,156,584,34,618,1167,52.96%,36.68%,1
臺北市,大同區,0957,441,178,619,54,673,1148,58.62%,38.41%,1
臺北市,大同區,0958,504,180,684,53,737,1203,61.26%,41.9%,1
臺北市,大同區,0959,512,222,734,54,788,1441,54.68%,35.53%,1
臺北市,大同區,0960,525,228,753,68,821,1315,62.43%,39.92%,1
臺北市,大同區,0961,521,189,710,82,792,1393,56.86%,37.4%,1
臺北市,大同區,0962,505,199,704,62,766,1278,59.94%,39.51%,1
臺北市,大同區,0963,431,177,608,56,664,1246,53.29%,34.59%,1
臺北市,大同區,0964,411,173,584,75,659,1142,57.71%,35.99%,1
臺北市,大同區,0965,531,219,750,68,818,1336,61.23%,39.75%,1
臺北市,大同區,0966,549,220,769,65,834,1363,61.19%,40.28%,1
臺北市,大同區,0967,561,214,775,48,823,1476,55.76%,38.01%,1
臺北市,大同區,0968,525,245,770,66,836,1418,58.96%,37.02%,1
臺北市,大同區,0969,538,204,742,41,783,1460,53.63%,36.85%,1
臺北市,大同區,0970,374,171,545,61,606,1222,49.59%,30.61%,1
臺北市,大同區,0971,377,165,542,104,646,1246,51.85%,30.26%,1
臺北市,大同區,0972,482,218,700,80,780,1256,62.1%,38.38%,1
臺北市,大同區,0973,505,194,699,37,736,1289,57.1%,39.18%,1
臺北市,大同區,0974,479,200,679,24,703,1340,52.46%,35.75%,1
臺北市,大同區,0975,544,226,770,67,837,1555,53.83%,34.98%,1
臺北市,大同區,0976,550,184,734,85,819,2459,33.31%,22.37%,1
臺北市,大同區,0977,326,139,465,65,530,1108,47.83%,29.42%,1
臺北市,大同區,0978,304,118,422,66,488,867,56.29%,35.06%,1
臺北市,大同區,0979,546,217,763,57,820,1329,61.7%,41.08%,1
臺北市,大同區,0980,411,204,615,39,654,1162,56.28%,35.37%,1
臺北市,大同區,0981,522,183,705,80,785,1434,54.74%,36.4%,1
臺北市,大同區,0982,532,192,724,65,789,1351,58.4%,39.38%,1
臺北市,大同區,0983,515,222,737,54,791,1531,51.67%,33.64%,1
臺北市,大同區,0984,490,211,701,35,736,1507,48.84%,32.51%,1
臺北市,大同區,0985,530,231,761,69,830,1488,55.78%,35.62%,1
臺北市,大同區,0986,537,221,758,93,851,1384,61.49%,38.8%,1
臺北市,大同區,0987,575,194,769,78,847,1460,58.01%,39.38%,1
臺北市,大同區,0988,555,212,767,68,835,1371,60.9%,40.48%,1
臺北市,大同區,0989,540,208,748,34,782,1439,54.34%,37.53%,1
臺北市,大同區,0990,524,226,750,82,832,1376,60.47%,38.08%,1
臺北市,大同區,0991,490,194,684,93,777,1366,56.88%,35.87%,1
臺北市,大同區,0992,510,215,725,62,787,1218,64.61%,41.87%,1
臺北市,大同區,0993,512,154,666,62,728,1235,58.95%,41.46%,1
臺北市,大同區,0994,516,169,685,31,716,1364,52.49%,37.83%,1
臺北市,大同區,0995,569,332,901,93,994,1408,70.6%,40.41%,1
臺北市,大同區,0996,567,206,773,70,843,1450,58.14%,39.1%,1
臺北市,大同區,0997,597,216,813,76,889,1429,62.21%,41.78%,1
臺北市,大同區,0998,450,188,638,78,716,1170,61.2%,38.46%,1
臺北市,大同區,0999,441,214,655,77,732,1245,58.8%,35.42%,1
臺北市,大同區,1000,496,207,703,87,790,1215,65.02%,40.82%,1
臺北市,萬華區,1097,520,199,719,60,779,1305,59.69%,39.85%,1
臺北市,萬華區,1098,386,149,535,68,603,1183,50.97%,32.63%,1
臺北市,萬華區,1099,436,161,597,35,632,1176,53.74%,37.07%,1
臺北市,萬華區,1100,396,162,558,34,592,1169,50.64%,33.88%,1
臺北市,萬華區,1101,505,175,680,56,736,1457,50.51%,34.66%,1
臺北市,萬華區,1102,476,192,668,86,754,1563,48.24%,30.45%,1
臺北市,萬華區,1103,588,194,782,42,824,1771,46.53%,33.2%,1
臺北市,萬華區,1104,558,219,777,57,834,1615,51.64%,34.55%,1
臺北市,萬華區,1105,539,198,737,87,824,1478,55.75%,36.47%,1
臺北市,萬華區,1106,532,191,723,48,771,1462,52.74%,36.39%,1
臺北市,萬華區,1107,497,159,656,79,735,1507,48.77%,32.98%,1
臺北市,萬華區,1108,528,207,735,61,796,1347,59.09%,39.2%,1
臺北市,萬華區,1109,489,186,675,55,730,1367,53.4%,35.77%,1
臺北市,萬華區,1110,512,214,726,56,782,1277,61.24%,40.09%,1
臺北市,萬華區,1111,492,254,746,56,802,1395,57.49%,35.27%,1
臺北市,萬華區,1112,494,212,706,70,776,1450,53.52%,34.07%,1
臺北市,萬華區,1113,468,161,629,63,692,1340,51.64%,34.93%,1
臺北市,萬華區,1114,423,183,606,61,667,1242,53.7%,34.06%,1
臺北市,萬華區,1115,425,199,624,87,711,1286,55.29%,33.05%,1
臺北市,萬華區,1116,482,159,641,59,700,1324,52.87%,36.4%,1
臺北市,萬華區,1117,539,235,774,86,860,1619,53.12%,33.29%,1
臺北市,萬華區,1118,423,164,587,82,669,1352,49.48%,31.29%,1
臺北市,萬華區,1119,612,94,706,50,756,1440,52.5%,42.5%,1
臺北市,萬華區,1120,458,203,661,58,719,1194,60.22%,38.36%,1
臺北市,萬華區,1121,471,154,625,67,692,1083,63.9%,43.49%,1
臺北市,萬華區,1122,411,177,588,85,673,1237,54.41%,33.23%,1
臺北市,萬華區,1123,531,232,763,79,842,1625,51.82%,32.68%,1
臺北市,萬華區,1124,531,197,728,74,802,1324,60.57%,40.11%,1
臺北市,萬華區,1125,537,179,716,77,793,1352,58.65%,39.72%,1
臺北市,萬華區,1126,464,209,673,66,739,2630,28.1%,17.64%,1
臺北市,萬華區,1127,576,261,837,71,908,1504,60.37%,38.3%,1
臺北市,萬華區,1128,513,197,710,64,774,1425,54.32%,36%,1
臺北市,萬華區,1129,522,209,731,77,808,1591,50.79%,32.81%,1
臺北市,萬華區,1130,552,164,716,87,803,1474,54.48%,37.45%,1
臺北市,萬華區,1131,559,189,748,97,845,1612,52.42%,34.68%,1
臺北市,萬華區,1132,550,184,734,67,801,1447,55.36%,38.01%,1
臺北市,萬華區,1133,619,186,805,60,865,1491,58.01%,41.52%,1
臺北市,萬華區,1134,624,208,832,58,890,1500,59.33%,41.6%,1
臺北市,萬華區,1135,615,269,884,66,950,1582,60.05%,38.87%,1
臺北市,萬華區,1136,578,97,675,68,743,1623,45.78%,35.61%,1
臺北市,萬華區,1137,461,165,626,32,658,1228,53.58%,37.54%,1
臺北市,萬華區,1138,482,168,650,71,721,1268,56.86%,38.01%,1
臺北市,萬華區,1139,492,146,638,72,710,1207,58.82%,40.76%,1
臺北市,萬華區,1140,492,178,670,45,715,1188,60.19%,41.41%,1
臺北市,萬華區,1141,529,200,729,66,795,1474,53.93%,35.89%,1
臺北市,萬華區,1142,453,114,567,28,595,1304,45.63%,34.74%,1
臺北市,萬華區,1143,296,108,404,53,457,1082,42.24%,27.36%,1
臺北市,萬華區,1144,343,151,494,52,546,1052,51.9%,32.6%,1
臺北市,萬華區,1145,400,170,570,64,634,1135,55.86%,35.24%,1
臺北市,萬華區,1146,415,210,625,68,693,1225,56.57%,33.88%,1
臺北市,萬華區,1147,580,183,763,71,834,1583,52.68%,36.64%,1
臺北市,萬華區,1148,515,194,709,71,780,1403,55.6%,36.71%,1
臺北市,萬華區,1149,533,195,728,77,805,1406,57.25%,37.91%,1
臺北市,萬華區,1150,553,198,751,63,814,1401,58.1%,39.47%,1
臺北市,萬華區,1151,475,168,643,67,710,1188,59.76%,39.98%,1
臺北市,萬華區,1152,553,204,757,87,844,1597,52.85%,34.63%,1
臺北市,萬華區,1153,516,194,710,83,793,1290,61.47%,40%,1
臺北市,萬華區,1154,557,235,792,38,830,1746,47.54%,31.9%,1
臺北市,萬華區,1155,505,199,704,52,756,1595,47.4%,31.66%,1
臺北市,萬華區,1156,579,233,812,119,931,1701,54.73%,34.04%,1
臺北市,萬華區,1157,404,173,577,88,665,1339,49.66%,30.17%,1
臺北市,萬華區,1158,475,161,636,98,734,1484,49.46%,32.01%,1
臺北市,萬華區,1159,612,210,822,91,913,1604,56.92%,38.15%,1
臺北市,萬華區,1160,466,174,640,50,690,1197,57.64%,38.93%,1
臺北市,萬華區,1161,478,171,649,84,733,1347,54.42%,35.49%,1
臺北市,萬華區,1162,537,188,725,54,779,1223,63.7%,43.91%,1
臺北市,萬華區,1163,426,133,559,42,601,1036,58.01%,41.12%,1
臺北市,萬華區,1164,412,183,595,68,663,1035,64.06%,39.81%,1
臺北市,萬華區,1165,510,187,697,10,707,1141,61.96%,44.7%,1
臺北市,萬華區,1166,537,156,693,45,738,1271,58.06%,42.25%,1
臺北市,萬華區,1167,508,200,708,98,806,1328,60.69%,38.25%,1
臺北市,萬華區,1168,519,193,712,44,756,1286,58.79%,40.36%,1
臺北市,萬華區,1169,664,228,892,96,988,1679,58.84%,39.55%,1
臺北市,萬華區,1170,614,221,835,79,914,1619,56.45%,37.92%,1
臺北市,萬華區,1171,542,196,738,74,812,1625,49.97%,33.35%,1
臺北市,萬華區,1172,662,226,888,73,961,1623,59.21%,40.79%,1
臺北市,萬華區,1173,480,155,635,82,717,1280,56.02%,37.5%,1
臺北市,萬華區,1174,626,193,819,79,898,1608,55.85%,38.93%,1
臺北市,萬華區,1175,560,220,780,68,848,1453,58.36%,38.54%,1
臺北市,萬華區,1176,614,219,833,65,898,1472,61.01%,41.71%,1
臺北市,萬華區,1177,522,224,746,45,791,1373,57.61%,38.02%,1
臺北市,萬華區,1178,529,161,690,81,771,1394,55.31%,37.95%,1
臺北市,萬華區,1179,503,179,682,46,728,1427,51.02%,35.25%,1
臺北市,萬華區,1180,531,226,757,67,824,1342,61.4%,39.57%,1
臺北市,萬華區,1181,650,202,852,82,934,1569,59.53%,41.43%,1
臺北市,萬華區,1182,512,188,700,63,763,1514,50.4%,33.82%,1
臺北市,萬華區,1183,580,190,770,41,811,1720,47.15%,33.72%,1
臺北市,萬華區,1184,620,200,820,79,899,1461,61.53%,42.44%,1
臺北市,萬華區,1185,466,169,635,43,678,1264,53.64%,36.87%,1
臺北市,萬華區,1186,574,201,775,66,841,1334,63.04%,43.03%,1
臺北市,萬華區,1187,563,207,770,50,820,1446,56.71%,38.93%,1
臺北市,萬華區,1188,476,152,628,53,681,1307,52.1%,36.42%,1
臺北市,萬華區,1189,560,175,735,94,829,1420,58.38%,39.44%,1
臺北市,萬華區,1190,491,198,689,41,730,1427,51.16%,34.41%,1
臺北市,萬華區,1191,373,122,495,48,543,956,56.8%,39.02%,1
臺北市,萬華區,1192,554,163,717,74,791,1352,58.51%,40.98%,1
臺北市,萬華區,1193,588,130,718,54,772,1370,56.35%,42.92%,1
臺北市,萬華區,1194,586,96,682,52,734,1222,60.07%,47.95%,1
臺北市,萬華區,1195,613,106,719,50,769,1375,55.93%,44.58%,1
臺北市,萬華區,1196,643,151,794,62,856,1463,58.51%,43.95%,1
臺北市,萬華區,1197,577,156,733,46,779,1527,51.02%,37.79%,1
臺北市,萬華區,1198,600,147,747,57,804,1485,54.14%,40.4%,1
臺北市,萬華區,1199,788,145,933,48,981,1591,61.66%,49.53%,1
臺北市,萬華區,1200,714,157,871,32,903,1394,64.78%,51.22%,1
臺北市,萬華區,1201,659,172,831,38,869,1522,57.1%,43.3%,1
臺北市,萬華區,1202,817,147,964,40,1004,1661,60.45%,49.19%,1
臺北市,萬華區,1203,723,180,903,33,936,1561,59.96%,46.32%,1
臺北市,萬華區,1204,660,183,843,53,896,1406,63.73%,46.94%,1
臺北市,萬華區,1205,473,171,644,49,693,1498,46.26%,31.58%,1
臺北市,萬華區,1206,461,160,621,78,699,1478,47.29%,31.19%,1
臺北市,萬華區,1207,429,188,617,69,686,1170,58.63%,36.67%,1
臺北市,萬華區,1208,634,126,760,57,817,1376,59.38%,46.08%,1
臺北市,萬華區,1209,468,121,589,25,614,1093,56.18%,42.82%,1
臺北市,萬華區,1210,490,127,617,64,681,1084,62.82%,45.2%,1
臺北市,萬華區,1211,489,136,625,51,676,1119,60.41%,43.7%,1
臺北市,萬華區,1212,630,179,809,47,856,1381,61.98%,45.62%,1
臺北市,萬華區,1213,589,176,765,53,818,1396,58.6%,42.19%,1
臺北市,文山區,1402,584,239,823,40,863,1539,56.08%,37.95%,1
臺北市,文山區,1403,604,171,775,40,815,1548,52.65%,39.02%,1
臺北市,文山區,1404,619,208,827,77,904,1493,60.55%,41.46%,1
臺北市,文山區,1405,702,224,926,66,992,1648,60.19%,42.6%,1
臺北市,文山區,1406,652,188,840,57,897,1544,58.1%,42.23%,1
臺北市,文山區,1407,663,178,841,68,909,1557,58.38%,42.58%,1
臺北市,文山區,1408,642,160,802,52,854,1514,56.41%,42.4%,1
臺北市,文山區,1409,730,192,922,64,986,1540,64.03%,47.4%,1
臺北市,文山區,1410,677,184,861,44,905,1466,61.73%,46.18%,1
臺北市,文山區,1411,656,196,852,46,898,1444,62.19%,45.43%,1
臺北市,文山區,1412,615,199,814,72,886,1455,60.89%,42.27%,1
臺北市,文山區,1413,578,170,748,62,810,1440,56.25%,40.14%,1
臺北市,文山區,1414,605,189,794,66,860,1398,61.52%,43.28%,1
臺北市,文山區,1415,582,148,730,31,761,1412,53.9%,41.22%,1
臺北市,文山區,1416,587,185,772,54,826,1426,57.92%,41.16%,1
臺北市,文山區,1417,603,198,801,49,850,1437,59.15%,41.96%,1
臺北市,文山區,1418,587,167,754,55,809,1340,60.37%,43.81%,1
臺北市,文山區,1419,646,205,851,37,888,1568,56.63%,41.2%,1
臺北市,文山區,1420,597,153,750,32,782,1372,57%,43.51%,1
臺北市,文山區,1421,451,109,560,38,598,1046,57.17%,43.12%,1
臺北市,文山區,1422,547,168,715,48,763,1274,59.89%,42.94%,1
臺北市,文山區,1423,566,173,739,42,781,1324,58.99%,42.75%,1
臺北市,文山區,1424,703,223,926,63,989,1722,57.43%,40.82%,1
臺北市,文山區,1425,758,196,954,74,1028,1737,59.18%,43.64%,1
臺北市,文山區,1426,657,166,823,28,851,1370,62.12%,47.96%,1
臺北市,文山區,1427,611,202,813,67,880,1495,58.86%,40.87%,1
臺北市,文山區,1428,581,167,748,54,802,1328,60.39%,43.75%,1
臺北市,文山區,1429,488,151,639,58,697,1138,61.25%,42.88%,1
臺北市,文山區,1430,664,169,833,41,874,1471,59.42%,45.14%,1
臺北市,文山區,1431,510,163,673,40,713,1144,62.33%,44.58%,1
臺北市,文山區,1432,530,170,700,60,760,1176,64.63%,45.07%,1
臺北市,文山區,1433,523,84,607,51,658,1212,54.29%,43.15%,1
臺北市,文山區,1434,539,166,705,44,749,1214,61.7%,44.4%,1
臺北市,文山區,1435,463,163,626,47,673,1170,57.52%,39.57%,1
臺北市,文山區,1436,532,210,742,55,797,1308,60.93%,40.67%,1
臺北市,文山區,1437,507,160,667,58,725,1190,60.92%,42.61%,1
臺北市,文山區,1438,491,122,613,49,662,1110,59.64%,44.23%,1
臺北市,文山區,1439,655,173,828,59,887,1512,58.66%,43.32%,1
臺北市,文山區,1440,672,123,795,65,860,1387,62%,48.45%,1
臺北市,文山區,1441,580,175,755,56,811,1355,59.85%,42.8%,1
臺北市,文山區,1442,542,209,751,73,824,1370,60.15%,39.56%,1
臺北市,文山區,1443,645,178,823,64,887,1484,59.77%,43.46%,1
臺北市,文山區,1444,756,214,970,77,1047,1786,58.62%,42.33%,1
臺北市,文山區,1445,567,139,706,60,766,1260,60.79%,45%,1
臺北市,文山區,1446,577,171,748,28,776,1194,64.99%,48.32%,1
臺北市,文山區,1447,617,203,820,53,873,1444,60.46%,42.73%,1
臺北市,文山區,1448,681,152,833,63,896,1495,59.93%,45.55%,1
臺北市,文山區,1449,666,159,825,63,888,1446,61.41%,46.06%,1
臺北市,文山區,1450,619,162,781,76,857,1450,59.1%,42.69%,1
臺北市,文山區,1451,658,179,837,54,891,1486,59.96%,44.28%,1
臺北市,文山區,1452,582,135,717,44,761,1259,60.44%,46.23%,1
臺北市,文山區,1453,613,159,772,26,798,1317,60.59%,46.55%,1
臺北市,文山區,1454,602,177,779,44,823,1321,62.3%,45.57%,1
臺北市,文山區,1455,632,178,810,52,862,1475,58.44%,42.85%,1
臺北市,文山區,1456,522,164,686,48,734,1271,57.75%,41.07%,1
臺北市,文山區,1457,694,226,920,48,968,1609,60.16%,43.13%,1
臺北市,文山區,1458,631,161,792,39,831,1501,55.36%,42.04%,1
臺北市,文山區,1459,387,123,510,41,551,997,55.27%,38.82%,1
臺北市,文山區,1460,500,137,637,44,681,1052,64.73%,47.53%,1
臺北市,文山區,1461,574,151,725,41,766,1247,61.43%,46.03%,1
臺北市,文山區,1462,478,187,665,53,718,1167,61.53%,40.96%,1
臺北市,文山區,1463,562,169,731,39,770,1280,60.16%,43.91%,1
臺北市,文山區,1464,538,132,670,37,707,1153,61.32%,46.66%,1
臺北市,文山區,1465,718,177,895,52,947,1557,60.82%,46.11%,1
臺北市,文山區,1466,631,161,792,64,856,1444,59.28%,43.7%,1
臺北市,文山區,1467,722,172,894,42,936,1459,64.15%,49.49%,1
臺北市,文山區,1468,632,175,807,50,857,1357,63.15%,46.57%,1
臺北市,文山區,1469,581,161,742,50,792,1194,66.33%,48.66%,1
臺北市,文山區,1470,541,159,700,61,761,1184,64.27%,45.69%,1
臺北市,文山區,1471,506,163,669,48,717,1119,64.08%,45.22%,1
臺北市,文山區,1472,634,163,797,60,857,1350,63.48%,46.96%,1
臺北市,文山區,1473,623,164,787,58,845,1502,56.26%,41.48%,1
臺北市,文山區,1474,669,100,769,240,1009,1511,66.78%,44.28%,1
臺北市,文山區,1475,686,201,887,45,932,1481,62.93%,46.32%,1
臺北市,文山區,1476,727,163,890,49,939,1477,63.57%,49.22%,1
臺北市,文山區,1477,590,152,742,57,799,1294,61.75%,45.6%,1
臺北市,文山區,1478,523,144,667,40,707,1040,67.98%,50.29%,1
臺北市,文山區,1479,619,161,780,55,835,1323,63.11%,46.79%,1
臺北市,文山區,1480,495,157,652,59,711,1153,61.67%,42.93%,1
臺北市,文山區,1481,656,173,829,65,894,1525,58.62%,43.02%,1
臺北市,文山區,1482,575,157,732,57,789,1412,55.88%,40.72%,1
臺北市,文山區,1483,656,209,865,62,927,1473,62.93%,44.53%,1
臺北市,文山區,1484,659,197,856,37,893,1486,60.09%,44.35%,1
臺北市,文山區,1485,785,169,954,59,1013,1616,62.69%,48.58%,1
臺北市,文山區,1486,685,193,878,66,944,1489,63.4%,46%,1
臺北市,文山區,1487,622,160,782,57,839,1414,59.34%,43.99%,1
臺北市,文山區,1488,703,206,909,52,961,1494,64.32%,47.05%,1
臺北市,文山區,1489,721,187,908,56,964,1547,62.31%,46.61%,1
臺北市,文山區,1490,671,230,901,66,967,1587,60.93%,42.28%,1
臺北市,文山區,1491,734,192,926,43,969,1515,63.96%,48.45%,1
臺北市,文山區,1492,716,206,922,63,985,1573,62.62%,45.52%,1
臺北市,文山區,1493,708,210,918,43,961,1542,62.32%,45.91%,1
臺北市,文山區,1494,567,157,724,81,805,1465,54.95%,38.7%,1
臺北市,文山區,1495,216,88,304,40,344,699,49.21%,30.9%,1
臺北市,文山區,1496,500,148,648,62,710,1372,51.75%,36.44%,1
臺北市,文山區,1497,535,153,688,57,745,1448,51.45%,36.95%,1
臺北市,文山區,1498,653,200,853,61,914,1548,59.04%,42.18%,1
臺北市,文山區,1499,649,191,840,48,888,1501,59.16%,43.24%,1
臺北市,文山區,1500,713,188,901,40,941,1560,60.32%,45.71%,1
臺北市,文山區,1501,683,190,873,52,925,1567,59.03%,43.59%,1
臺北市,文山區,1502,666,197,863,54,917,1554,59.01%,42.86%,1
臺北市,文山區,1503,665,189,854,62,916,1544,59.33%,43.07%,1
臺北市,文山區,1504,698,175,873,50,923,1528,60.41%,45.68%,1
臺北市,文山區,1505,741,178,919,40,959,1543,62.15%,48.02%,1
臺北市,文山區,1506,670,230,900,60,960,2754,34.86%,24.33%,1
臺北市,文山區,1507,635,83,718,76,794,1709,46.46%,37.16%,1
臺北市,文山區,1508,577,212,789,80,869,1515,57.36%,38.09%,1
臺北市,文山區,1509,622,169,791,71,862,1571,54.87%,39.59%,1
臺北市,文山區,1510,651,177,828,74,902,1578,57.16%,41.25%,1
臺北市,文山區,1511,573,179,752,68,820,1454,56.4%,39.41%,1
臺北市,文山區,1512,614,169,783,67,850,1436,59.19%,42.76%,1
臺北市,文山區,1513,660,173,833,61,894,1402,63.77%,47.08%,1
臺北市,文山區,1514,515,146,661,41,702,1117,62.85%,46.11%,1
臺北市,文山區,1515,452,138,590,62,652,1094,59.6%,41.32%,1
臺北市,文山區,1516,492,142,634,53,687,1070,64.21%,45.98%,1
臺北市,文山區,1517,638,165,803,39,842,1319,63.84%,48.37%,1
臺北市,文山區,1518,578,153,731,56,787,1226,64.19%,47.15%,1
臺北市,文山區,1519,592,153,745,45,790,1385,57.04%,42.74%,1
臺北市,文山區,1520,599,192,791,63,854,1416,60.31%,42.3%,1
臺北市,文山區,1521,660,177,837,63,900,1412,63.74%,46.74%,1
臺北市,文山區,1522,659,162,821,62,883,1535,57.52%,42.93%,1
臺北市,文山區,1523,780,209,989,59,1048,1654,63.36%,47.16%,1
臺北市,文山區,1524,543,148,691,40,731,1156,63.24%,46.97%,1
臺北市,文山區,1525,577,149,726,48,774,1231,62.88%,46.87%,1
臺北市,文山區,1526,519,141,660,47,707,1218,58.05%,42.61%,1
臺北市,文山區,1527,555,157,712,44,756,1176,64.29%,47.19%,1
臺北市,文山區,1528,599,213,812,49,861,1392,61.85%,43.03%,1
臺北市,文山區,1529,514,175,689,95,784,1323,59.26%,38.85%,1
臺北市,文山區,1530,532,167,699,46,745,1297,57.44%,41.02%,1
臺北市,文山區,1531,582,159,741,74,815,1296,62.89%,44.91%,1
臺北市,文山區,1532,655,217,872,65,937,1613,58.09%,40.61%,1
臺北市,文山區,1533,731,237,968,60,1028,1697,60.58%,43.08%,1
臺北市,文山區,1534,665,187,852,72,924,1579,58.52%,42.12%,1
臺北市,文山區,1535,605,170,775,62,837,1320,63.41%,45.83%,1
臺北市,文山區,1536,617,166,783,38,821,1438,57.09%,42.91%,1
臺北市,文山區,1537,598,155,753,32,785,1465,53.58%,40.82%,1
臺北市,文山區,1538,667,237,904,85,989,1646,60.09%,40.52%,1
臺北市,文山區,1539,548,177,725,53,778,1286,60.5%,42.61%,1
臺北市,文山區,1540,542,168,710,39,749,1219,61.44%,44.46%,1
臺北市,文山區,1541,597,154,751,52,803,1292,62.15%,46.21%,1
臺北市,文山區,1542,610,172,782,66,848,1489,56.95%,40.97%,1
臺北市,文山區,1543,699,211,910,69,979,1611,60.77%,43.39%,1
臺北市,文山區,1544,573,180,753,54,807,1549,52.1%,36.99%,1
臺北市,文山區,1545,677,194,871,69,940,1678,56.02%,40.35%,1
臺北市,文山區,1546,660,220,880,63,943,1660,56.81%,39.76%,1
臺北市,文山區,1547,665,187,852,47,899,1816,49.5%,36.62%,1
臺北市,文山區,1548,389,144,533,32,565,985,57.36%,39.49%,1
臺北市,文山區,1549,637,131,768,37,805,1314,61.26%,48.48%,1
臺北市,文山區,1550,474,138,612,50,662,1018,65.03%,46.56%,1
臺北市,文山區,1551,678,204,882,53,935,1578,59.25%,42.97%,1
臺北市,文山區,1552,626,187,813,38,851,1457,58.41%,42.96%,1
臺北市,文山區,1553,597,164,761,59,820,1326,61.84%,45.02%,1
臺北市,文山區,1554,624,172,796,57,853,1393,61.23%,44.8%,1
臺北市,文山區,1555,555,168,723,63,786,1377,57.08%,40.31%,1
臺北市,文山區,1556,625,200,825,45,870,1448,60.08%,43.16%,1
臺北市,文山區,1557,667,190,857,57,914,1447,63.17%,46.1%,1
臺北市,文山區,1558,809,252,1061,69,1130,1739,64.98%,46.52%,1
臺北市,文山區,1559,668,155,823,46,869,1457,59.64%,45.85%,1
臺北市,文山區,1560,585,167,752,46,798,1288,61.96%,45.42%,1
臺北市,文山區,1561,475,161,636,78,714,1301,54.88%,36.51%,1
臺北市,文山區,1562,293,122,415,59,474,865,54.8%,33.87%,1
臺北市,文山區,1563,294,109,403,40,443,789,56.15%,37.26%,1
臺北市,南港區,0455,467,151,618,31,649,1280,50.7%,36.48%,1
臺北市,南港區,0456,551,175,726,28,754,1351,55.81%,40.78%,1
臺北市,南港區,0457,566,167,733,43,776,1345,57.7%,42.08%,1
臺北市,南港區,0458,496,206,702,45,747,1679,44.49%,29.54%,1
臺北市,南港區,0459,566,238,804,62,866,1680,51.55%,33.69%,1
臺北市,南港區,0460,594,191,785,49,834,1635,51.01%,36.33%,1
臺北市,南港區,0461,578,175,753,51,804,1459,55.11%,39.62%,1
臺北市,南港區,0462,704,223,927,37,964,1706,56.51%,41.27%,1
臺北市,南港區,0463,662,180,842,105,947,1674,56.57%,39.55%,1
臺北市,南港區,0464,545,260,805,28,833,1491,55.87%,36.55%,1
臺北市,南港區,0465,501,156,657,40,697,1086,64.18%,46.13%,1
臺北市,南港區,0466,525,175,700,74,774,1202,64.39%,43.68%,1
臺北市,南港區,0467,488,167,655,89,744,1198,62.1%,40.73%,1
臺北市,南港區,0468,524,176,700,31,731,1430,51.12%,36.64%,1
臺北市,南港區,0469,491,230,721,60,781,1275,61.25%,38.51%,1
臺北市,南港區,0470,603,207,810,59,869,1344,64.66%,44.87%,1
臺北市,南港區,0471,570,198,768,50,818,1391,58.81%,40.98%,1
臺北市,南港區,0472,626,159,785,36,821,1342,61.18%,46.65%,1
臺北市,南港區,0473,540,169,709,47,756,1389,54.43%,38.88%,1
臺北市,南港區,0474,615,191,806,48,854,1426,59.89%,43.13%,1
臺北市,南港區,0475,655,134,789,31,820,1359,60.34%,48.2%,1
臺北市,南港區,0476,553,181,734,61,795,1366,58.2%,40.48%,1
臺北市,南港區,0477,635,166,801,30,831,1441,57.67%,44.07%,1
臺北市,南港區,0478,577,189,766,66,832,1529,54.41%,37.74%,1
臺北市,南港區,0479,617,184,801,53,854,1618,52.78%,38.13%,1
臺北市,南港區,0480,509,165,674,86,760,1545,49.19%,32.94%,1
臺北市,南港區,0481,644,197,841,57,898,1569,57.23%,41.05%,1
臺北市,南港區,0482,600,175,775,50,825,1661,49.67%,36.12%,1
臺北市,南港區,0483,548,180,728,66,794,1518,52.31%,36.1%,1
臺北市,南港區,0484,670,209,879,59,938,1552,60.44%,43.17%,1
臺北市,南港區,0485,654,175,829,25,854,1658,51.51%,39.45%,1
臺北市,南港區,0486,630,233,863,61,924,1608,57.46%,39.18%,1
臺北市,南港區,0487,578,169,747,42,789,1475,53.49%,39.19%,1
臺北市,南港區,0488,767,247,1014,52,1066,1722,61.9%,44.54%,1
臺北市,南港區,0489,634,210,844,41,885,1383,63.99%,45.84%,1
臺北市,南港區,0490,606,171,777,45,822,1397,58.84%,43.38%,1
臺北市,南港區,0491,575,176,751,55,806,1352,59.62%,42.53%,1
臺北市,南港區,0492,569,183,752,55,807,1344,60.04%,42.34%,1
臺北市,南港區,0493,505,184,689,33,722,1385,52.13%,36.46%,1
臺北市,南港區,0494,552,182,734,60,794,1399,56.75%,39.46%,1
臺北市,南港區,0495,523,164,687,44,731,1381,52.93%,37.87%,1
臺北市,南港區,0496,601,202,803,56,859,1548,55.49%,38.82%,1
臺北市,南港區,0497,485,140,625,30,655,1190,55.04%,40.76%,1
臺北市,南港區,0498,611,225,836,39,875,1490,58.72%,41.01%,1
臺北市,南港區,0499,497,142,639,25,664,1096,60.58%,45.35%,1
臺北市,南港區,0500,574,159,733,32,765,1238,61.79%,46.37%,1
臺北市,南港區,0501,558,178,736,35,771,1271,60.66%,43.9%,1
臺北市,南港區,0502,456,158,614,56,670,1146,58.46%,39.79%,1
臺北市,南港區,0503,459,186,645,49,694,1232,56.33%,37.26%,1
臺北市,南港區,0504,632,155,787,39,826,1649,50.09%,38.33%,1
臺北市,南港區,0505,730,202,932,58,990,1688,58.65%,43.25%,1
臺北市,南港區,0506,664,197,861,33,894,1503,59.48%,44.18%,1
臺北市,南港區,0507,608,208,816,37,853,1542,55.32%,39.43%,1
臺北市,南港區,0508,612,192,804,48,852,1463,58.24%,41.83%,1
臺北市,南港區,0509,502,174,676,78,754,1195,63.1%,42.01%,1
臺北市,南港區,0510,502,212,714,20,734,1254,58.53%,40.03%,1
臺北市,南港區,0511,587,151,738,47,785,1356,57.89%,43.29%,1
臺北市,南港區,0512,563,194,757,78,835,1363,61.26%,41.31%,1
臺北市,南港區,0513,593,188,781,51,832,1317,63.17%,45.03%,1
臺北市,南港區,0514,558,170,728,37,765,1331,57.48%,41.92%,1
臺北市,南港區,0515,631,220,851,80,931,1610,57.83%,39.19%,1
臺北市,南港區,0516,593,203,796,40,836,1542,54.22%,38.46%,1
臺北市,南港區,0517,643,203,846,85,931,1581,58.89%,40.67%,1
臺北市,南港區,0518,554,161,715,49,764,1225,62.37%,45.22%,1
臺北市,南港區,0519,558,185,743,57,800,1264,63.29%,44.15%,1
臺北市,南港區,0520,713,212,925,85,1010,1649,61.25%,43.24%,1
臺北市,南港區,0521,566,162,728,23,751,1267,59.27%,44.67%,1
臺北市,南港區,0522,569,154,723,43,766,1336,57.34%,42.59%,1
臺北市,南港區,0523,525,150,675,27,702,1162,60.41%,45.18%,1
臺北市,南港區,0524,462,120,582,24,606,1045,57.99%,44.21%,1
臺北市,南港區,0525,669,156,825,65,890,1351,65.88%,49.52%,1
臺北市,南港區,0526,608,116,724,33,757,1358,55.74%,44.77%,1
臺北市,內湖區,0305,620,191,811,35,846,1661,50.93%,37.33%,1
臺北市,內湖區,0306,589,226,815,79,894,1602,55.81%,36.77%,1
臺北市,內湖區,0307,676,224,900,105,1005,1655,60.73%,40.85%,1
臺北市,內湖區,0308,678,224,902,46,948,1582,59.92%,42.86%,1
臺北市,內湖區,0309,688,188,876,42,918,1688,54.38%,40.76%,1
臺北市,內湖區,0310,691,244,935,54,989,1737,56.94%,39.78%,1
臺北市,內湖區,0311,796,207,1003,75,1078,1809,59.59%,44%,1
臺北市,內湖區,0312,543,186,729,57,786,1376,57.12%,39.46%,1
臺北市,內湖區,0313,750,207,957,103,1060,1747,60.68%,42.93%,1
臺北市,內湖區,0314,601,206,807,33,840,1389,60.48%,43.27%,1
臺北市,內湖區,0315,669,185,854,52,906,1454,62.31%,46.01%,1
臺北市,內湖區,0316,634,242,876,52,928,1468,63.22%,43.19%,1
臺北市,內湖區,0317,734,220,954,50,1004,1603,62.63%,45.79%,1
臺北市,內湖區,0318,706,239,945,39,984,1795,54.82%,39.33%,1
臺北市,內湖區,0319,774,244,1018,67,1085,1737,62.46%,44.56%,1
臺北市,內湖區,0320,723,243,966,77,1043,1744,59.81%,41.46%,1
臺北市,內湖區,0321,705,208,913,69,982,1661,59.12%,42.44%,1
臺北市,內湖區,0322,634,233,867,52,919,1577,58.28%,40.2%,1
臺北市,內湖區,0323,650,217,867,28,895,1494,59.91%,43.51%,1
臺北市,內湖區,0324,691,196,887,72,959,1626,58.98%,42.5%,1
臺北市,內湖區,0325,679,203,882,82,964,1641,58.74%,41.38%,1
臺北市,內湖區,0326,662,186,848,53,901,1554,57.98%,42.6%,1
臺北市,內湖區,0327,724,257,981,60,1041,1728,60.24%,41.9%,1
臺北市,內湖區,0328,697,218,915,67,982,1736,56.57%,40.15%,1
臺北市,內湖區,0329,682,203,885,51,936,1461,64.07%,46.68%,1
臺北市,內湖區,0330,621,203,824,45,869,1509,57.59%,41.15%,1
臺北市,內湖區,0331,527,201,728,35,763,1358,56.19%,38.81%,1
臺北市,內湖區,0332,76,207,283,54,337,1761,19.14%,4.32%,1
臺北市,內湖區,0333,701,108,809,28,837,1651,50.7%,42.46%,1
臺北市,內湖區,0334,755,228,983,80,1063,1809,58.76%,41.74%,1
臺北市,內湖區,0335,763,206,969,62,1031,1773,58.15%,43.03%,1
臺北市,內湖區,0336,769,218,987,45,1032,1890,54.6%,40.69%,1
臺北市,內湖區,0337,810,255,1065,67,1132,1760,64.32%,46.02%,1
臺北市,內湖區,0338,738,201,939,38,977,1645,59.39%,44.86%,1
臺北市,內湖區,0339,606,178,784,29,813,1324,61.4%,45.77%,1
臺北市,內湖區,0340,507,124,631,34,665,1072,62.03%,47.29%,1
臺北市,內湖區,0341,606,187,793,40,833,1509,55.2%,40.16%,1
臺北市,內湖區,0342,719,243,962,33,995,1715,58.02%,41.92%,1
臺北市,內湖區,0343,729,243,972,64,1036,1774,58.4%,41.09%,1
臺北市,內湖區,0344,806,259,1065,72,1137,1796,63.31%,44.88%,1
臺北市,內湖區,0345,713,231,944,51,995,1784,55.77%,39.97%,1
臺北市,內湖區,0346,604,211,815,65,880,1417,62.1%,42.63%,1
臺北市,內湖區,0347,690,241,931,42,973,1699,57.27%,40.61%,1
臺北市,內湖區,0348,773,250,1023,56,1079,1719,62.77%,44.97%,1
臺北市,內湖區,0349,717,224,941,30,971,1715,56.62%,41.81%,1
臺北市,內湖區,0350,620,172,792,36,828,1634,50.67%,37.94%,1
臺北市,內湖區,0351,553,187,740,74,814,1435,56.72%,38.54%,1
臺北市,內湖區,0352,597,167,764,32,796,1440,55.28%,41.46%,1
臺北市,內湖區,0353,679,173,852,35,887,1446,61.34%,46.96%,1
臺北市,內湖區,0354,635,189,824,69,893,1657,53.89%,38.32%,1
臺北市,內湖區,0355,539,164,703,73,776,1261,61.54%,42.74%,1
臺北市,內湖區,0356,138,65,203,33,236,456,51.75%,30.26%,1
臺北市,內湖區,0357,689,207,896,43,939,1433,65.53%,48.08%,1
臺北市,內湖區,0358,608,236,844,43,887,1485,59.73%,40.94%,1
臺北市,內湖區,0359,651,221,872,41,913,1590,57.42%,40.94%,1
臺北市,內湖區,0360,567,158,725,58,783,1219,64.23%,46.51%,1
臺北市,內湖區,0361,659,229,888,75,963,1732,55.6%,38.05%,1
臺北市,內湖區,0362,792,173,965,38,1003,1727,58.08%,45.86%,1
臺北市,內湖區,0363,675,221,896,64,960,1637,58.64%,41.23%,1
臺北市,內湖區,0364,601,180,781,49,830,1453,57.12%,41.36%,1
臺北市,內湖區,0365,679,179,858,40,898,1617,55.53%,41.99%,1
臺北市,內湖區,0366,674,194,868,32,900,1604,56.11%,42.02%,1
臺北市,內湖區,0367,646,198,844,41,885,1406,62.94%,45.95%,1
臺北市,內湖區,0368,562,199,761,47,808,1353,59.72%,41.54%,1
臺北市,內湖區,0369,767,218,985,60,1045,1724,60.61%,44.49%,1
臺北市,內湖區,0370,596,180,776,50,826,1378,59.94%,43.25%,1
臺北市,內湖區,0371,632,182,814,40,854,1403,60.87%,45.05%,1
臺北市,內湖區,0372,647,172,819,43,862,1547,55.72%,41.82%,1
臺北市,內湖區,0373,711,269,980,49,1029,1718,59.9%,41.39%,1
臺北市,內湖區,0374,738,239,977,59,1036,1813,57.14%,40.71%,1
臺北市,內湖區,0375,792,253,1045,67,1112,1791,62.09%,44.22%,1
臺北市,內湖區,0376,793,265,1058,57,1115,1855,60.11%,42.75%,1
臺北市,內湖區,0377,778,197,975,31,1006,1731,58.12%,44.95%,1
臺北市,內湖區,0378,731,222,953,67,1020,1593,64.03%,45.89%,1
臺北市,內湖區,0379,745,191,936,60,996,1869,53.29%,39.86%,1
臺北市,內湖區,0380,741,211,952,62,1014,1687,60.11%,43.92%,1
臺北市,內湖區,0381,656,197,853,37,890,1530,58.17%,42.88%,1
臺北市,內湖區,0382,575,165,740,59,799,1300,61.46%,44.23%,1
臺北市,內湖區,0383,650,139,789,53,842,1314,64.08%,49.47%,1
臺北市,內湖區,0384,504,179,683,41,724,1433,50.52%,35.17%,1
臺北市,內湖區,0385,601,147,748,43,791,1450,54.55%,41.45%,1
臺北市,內湖區,0386,644,210,854,60,914,1608,56.84%,40.05%,1
臺北市,內湖區,0387,591,190,781,53,834,1414,58.98%,41.8%,1
臺北市,內湖區,0388,639,185,824,43,867,1492,58.11%,42.83%,1
臺北市,內湖區,0389,595,178,773,33,806,1528,52.75%,38.94%,1
臺北市,內湖區,0390,696,220,916,63,979,1692,57.86%,41.13%,1
臺北市,內湖區,0391,629,214,843,54,897,1556,57.65%,40.42%,1
臺北市,內湖區,0392,656,211,867,27,894,1637,54.61%,40.07%,1
臺北市,內湖區,0393,676,215,891,50,941,1749,53.8%,38.65%,1
臺北市,內湖區,0394,485,153,638,36,674,1220,55.25%,39.75%,1
臺北市,內湖區,0395,635,207,842,79,921,1600,57.56%,39.69%,1
臺北市,內湖區,0396,610,188,798,51,849,1473,57.64%,41.41%,1
臺北市,內湖區,0397,585,209,794,68,862,1498,57.54%,39.05%,1
臺北市,內湖區,0398,663,181,844,47,891,1557,57.23%,42.58%,1
臺北市,內湖區,0399,651,198,849,53,902,1674,53.88%,38.89%,1
臺北市,內湖區,0400,736,237,973,61,1034,1728,59.84%,42.59%,1
臺北市,內湖區,0401,251,116,367,51,418,788,53.05%,31.85%,1
臺北市,內湖區,0402,530,252,782,81,863,1542,55.97%,34.37%,1
臺北市,內湖區,0403,603,191,794,57,851,1676,50.78%,35.98%,1
臺北市,內湖區,0404,474,188,662,33,695,1360,51.1%,34.85%,1
臺北市,內湖區,0405,594,160,754,35,789,1259,62.67%,47.18%,1
臺北市,內湖區,0406,559,134,693,19,712,1301,54.73%,42.97%,1
臺北市,內湖區,0407,429,167,596,43,639,1251,51.08%,34.29%,1
臺北市,內湖區,0408,602,177,779,74,853,1502,56.79%,40.08%,1
臺北市,內湖區,0409,669,171,840,49,889,1596,55.7%,41.92%,1
臺北市,內湖區,0410,684,222,906,24,930,1649,56.4%,41.48%,1
臺北市,內湖區,0411,723,188,911,65,976,1774,55.02%,40.76%,1
臺北市,內湖區,0412,677,194,871,49,920,1746,52.69%,38.77%,1
臺北市,內湖區,0413,606,167,773,24,797,1473,54.11%,41.14%,1
臺北市,內湖區,0414,686,207,893,76,969,2824,34.31%,24.29%,1
臺北市,內湖區,0415,640,265,905,48,953,1849,51.54%,34.61%,1
臺北市,內湖區,0416,603,180,783,67,850,1530,55.56%,39.41%,1
臺北市,內湖區,0417,634,231,865,66,931,1656,56.22%,38.29%,1
臺北市,內湖區,0418,587,217,804,46,850,1457,58.34%,40.29%,1
臺北市,內湖區,0419,729,217,946,67,1013,1695,59.76%,43.01%,1
臺北市,內湖區,0420,720,215,935,49,984,1663,59.17%,43.3%,1
臺北市,內湖區,0421,677,203,880,65,945,1654,57.13%,40.93%,1
臺北市,內湖區,0422,714,208,922,64,986,1642,60.05%,43.48%,1
臺北市,內湖區,0423,688,218,906,48,954,1685,56.62%,40.83%,1
臺北市,內湖區,0424,733,245,978,67,1045,1862,56.12%,39.37%,1
臺北市,內湖區,0425,823,252,1075,58,1133,1900,59.63%,43.32%,1
臺北市,內湖區,0426,850,247,1097,66,1163,1790,64.97%,47.49%,1
臺北市,內湖區,0427,588,162,750,63,813,1417,57.37%,41.5%,1
臺北市,內湖區,0428,700,213,913,54,967,1694,57.08%,41.32%,1
臺北市,內湖區,0429,663,181,844,66,910,1676,54.3%,39.56%,1
臺北市,內湖區,0430,666,215,881,31,912,1643,55.51%,40.54%,1
臺北市,內湖區,0431,674,208,882,53,935,1588,58.88%,42.44%,1
臺北市,內湖區,0432,704,190,894,62,956,1603,59.64%,43.92%,1
臺北市,內湖區,0433,707,190,897,52,949,1629,58.26%,43.4%,1
臺北市,內湖區,0434,750,205,955,59,1014,1646,61.6%,45.57%,1
臺北市,內湖區,0435,786,204,990,52,1042,1883,55.34%,41.74%,1
臺北市,內湖區,0436,578,182,760,56,816,1434,56.9%,40.31%,1
臺北市,內湖區,0437,603,154,757,38,795,1418,56.06%,42.52%,1
臺北市,內湖區,0438,586,162,748,72,820,1373,59.72%,42.68%,1
臺北市,內湖區,0439,572,174,746,71,817,1349,60.56%,42.4%,1
臺北市,內湖區,0440,632,227,859,60,919,1511,60.82%,41.83%,1
臺北市,內湖區,0441,694,191,885,78,963,1563,61.61%,44.4%,1
臺北市,內湖區,0442,650,200,850,55,905,1550,58.39%,41.94%,1
臺北市,內湖區,0443,460,150,610,60,670,1157,57.91%,39.76%,1
臺北市,內湖區,0444,719,249,968,52,1020,1768,57.69%,40.67%,1
臺北市,內湖區,0445,687,215,902,63,965,1664,57.99%,41.29%,1
臺北市,內湖區,0446,762,234,996,76,1072,1743,61.5%,43.72%,1
臺北市,內湖區,0447,644,193,837,27,864,1480,58.38%,43.51%,1
臺北市,內湖區,0448,680,235,915,70,985,1589,61.99%,42.79%,1
臺北市,內湖區,0449,580,178,758,35,793,1371,57.84%,42.3%,1
臺北市,內湖區,0450,723,205,928,52,980,1575,62.22%,45.9%,1
臺北市,內湖區,0451,615,167,782,17,799,1377,58.02%,44.66%,1
臺北市,內湖區,0452,703,213,916,61,977,1469,66.51%,47.86%,1
臺北市,內湖區,0453,675,230,905,33,938,1529,61.35%,44.15%,1
臺北市,內湖區,0454,730,211,941,58,999,1649,60.58%,44.27%,1
臺北市,士林區,0142,498,262,760,88,848,1695,50.03%,29.38%,1
臺北市,士林區,0143,668,237,905,104,1009,1720,58.66%,38.84%,1
臺北市,士林區,0144,494,171,665,78,743,1288,57.69%,38.35%,1
臺北市,士林區,0145,567,219,786,77,863,1546,55.82%,36.68%,1
臺北市,士林區,0146,295,83,378,34,412,652,63.19%,45.25%,1
臺北市,士林區,0147,322,114,436,45,481,870,55.29%,37.01%,1
臺北市,士林區,0148,424,223,647,59,706,1137,62.09%,37.29%,1
臺北市,士林區,0149,435,160,595,68,663,1050,63.14%,41.43%,1
臺北市,士林區,0150,429,151,580,62,642,1031,62.27%,41.61%,1
臺北市,士林區,0151,439,165,604,34,638,1075,59.35%,40.84%,1
臺北市,士林區,0152,346,115,461,59,520,2175,23.91%,15.91%,1
臺北市,士林區,0153,659,218,877,76,953,1775,53.69%,37.13%,1
臺北市,士林區,0154,710,212,922,56,978,1669,58.6%,42.54%,1
臺北市,士林區,0155,660,275,935,75,1010,1665,60.66%,39.64%,1
臺北市,士林區,0156,659,270,929,87,1016,1648,61.65%,39.99%,1
臺北市,士林區,0157,498,177,675,32,707,1246,56.74%,39.97%,1
臺北市,士林區,0158,503,226,729,89,818,1419,57.65%,35.45%,1
臺北市,士林區,0159,493,192,685,87,772,1327,58.18%,37.15%,1
臺北市,士林區,0160,612,283,895,76,971,1573,61.73%,38.91%,1
臺北市,士林區,0161,593,192,785,86,871,1470,59.25%,40.34%,1
臺北市,士林區,0162,672,222,894,34,928,1775,52.28%,37.86%,1
臺北市,士林區,0163,689,228,917,71,988,1692,58.39%,40.72%,1
臺北市,士林區,0164,750,256,1006,63,1069,1842,58.03%,40.72%,1
臺北市,士林區,0165,483,171,654,58,712,1166,61.06%,41.42%,1
臺北市,士林區,0166,594,205,799,82,881,1687,52.22%,35.21%,1
臺北市,士林區,0167,623,236,859,75,934,1624,57.51%,38.36%,1
臺北市,士林區,0168,583,226,809,113,922,1477,62.42%,39.47%,1
臺北市,士林區,0169,498,203,701,58,759,1250,60.72%,39.84%,1
臺北市,士林區,0170,561,203,764,92,856,1434,59.69%,39.12%,1
臺北市,士林區,0171,553,231,784,82,866,1452,59.64%,38.09%,1
臺北市,士林區,0172,622,260,882,81,963,1533,62.82%,40.57%,1
臺北市,士林區,0173,634,210,844,84,928,1515,61.25%,41.85%,1
臺北市,士林區,0174,474,198,672,59,731,1203,60.76%,39.4%,1
臺北市,士林區,0175,628,217,845,83,928,1487,62.41%,42.23%,1
臺北市,士林區,0176,490,183,673,38,711,1252,56.79%,39.14%,1
臺北市,士林區,0177,574,218,792,64,856,1536,55.73%,37.37%,1
臺北市,士林區,0178,619,243,862,74,936,1556,60.15%,39.78%,1
臺北市,士林區,0179,603,220,823,56,879,1511,58.17%,39.91%,1
臺北市,士林區,0180,627,255,882,84,966,1572,61.45%,39.89%,1
臺北市,士林區,0181,672,203,875,89,964,1668,57.79%,40.29%,1
臺北市,士林區,0182,624,213,837,113,950,1685,56.38%,37.03%,1
臺北市,士林區,0183,617,217,834,67,901,1568,57.46%,39.35%,1
臺北市,士林區,0184,512,164,676,53,729,1327,54.94%,38.58%,1
臺北市,士林區,0185,460,185,645,72,717,1338,53.59%,34.38%,1
臺北市,士林區,0186,529,197,726,68,794,1515,52.41%,34.92%,1
臺北市,士林區,0187,589,202,791,77,868,1452,59.78%,40.56%,1
臺北市,士林區,0188,590,186,776,65,841,1448,58.08%,40.75%,1
臺北市,士林區,0189,605,218,823,63,886,1521,58.25%,39.78%,1
臺北市,士林區,0190,527,242,769,48,817,1461,55.92%,36.07%,1
臺北市,士林區,0191,516,235,751,80,831,1541,53.93%,33.48%,1
臺北市,士林區,0192,517,175,692,62,754,1611,46.8%,32.09%,1
臺北市,士林區,0193,589,227,816,82,898,1595,56.3%,36.93%,1
臺北市,士林區,0194,610,201,811,56,867,1685,51.45%,36.2%,1
臺北市,士林區,0195,668,233,901,82,983,1816,54.13%,36.78%,1
臺北市,士林區,0196,619,245,864,102,966,1687,57.26%,36.69%,1
臺北市,士林區,0197,623,217,840,94,934,1646,56.74%,37.85%,1
臺北市,士林區,0198,621,191,812,68,880,1643,53.56%,37.8%,1
臺北市,士林區,0199,710,187,897,67,964,1687,57.14%,42.09%,1
臺北市,士林區,0200,629,250,879,92,971,1655,58.67%,38.01%,1
臺北市,士林區,0201,640,235,875,41,916,1779,51.49%,35.98%,1
臺北市,士林區,0202,713,282,995,74,1069,1855,57.63%,38.44%,1
臺北市,士林區,0203,527,185,712,69,781,1350,57.85%,39.04%,1
臺北市,士林區,0204,527,168,695,42,737,1455,50.65%,36.22%,1
臺北市,士林區,0205,444,200,644,73,717,1497,47.9%,29.66%,1
臺北市,士林區,0206,417,167,584,71,655,1398,46.85%,29.83%,1
臺北市,士林區,0207,654,291,945,83,1028,1747,58.84%,37.44%,1
臺北市,士林區,0208,551,182,733,95,828,1465,56.52%,37.61%,1
臺北市,士林區,0209,553,229,782,79,861,1530,56.27%,36.14%,1
臺北市,士林區,0210,616,253,869,97,966,1855,52.08%,33.21%,1
臺北市,士林區,0211,522,220,742,79,821,1444,56.86%,36.15%,1
臺北市,士林區,0212,554,192,746,86,832,1563,53.23%,35.44%,1
臺北市,士林區,0213,538,212,750,94,844,1482,56.95%,36.3%,1
臺北市,士林區,0214,524,223,747,109,856,1552,55.15%,33.76%,1
臺北市,士林區,0215,678,241,919,92,1011,1790,56.48%,37.88%,1
臺北市,士林區,0216,566,194,760,94,854,1628,52.46%,34.77%,1
臺北市,士林區,0217,445,215,660,78,738,1337,55.2%,33.28%,1
臺北市,士林區,0218,675,229,904,93,997,1750,56.97%,38.57%,1
臺北市,士林區,0219,564,214,778,118,896,1668,53.72%,33.81%,1
臺北市,士林區,0220,396,180,576,91,667,1403,47.54%,28.23%,1
臺北市,士林區,0221,420,221,641,62,703,1468,47.89%,28.61%,1
臺北市,士林區,0222,465,186,651,45,696,1471,47.31%,31.61%,1
臺北市,士林區,0223,574,192,766,103,869,1666,52.16%,34.45%,1
臺北市,士林區,0224,525,233,758,65,823,1587,51.86%,33.08%,1
臺北市,士林區,0225,629,235,864,89,953,1987,47.96%,31.66%,1
臺北市,士林區,0226,455,143,598,25,623,1271,49.02%,35.8%,1
臺北市,士林區,0227,735,219,954,81,1035,1728,59.9%,42.53%,1
臺北市,士林區,0228,688,217,905,73,978,1630,60%,42.21%,1
臺北市,士林區,0229,651,250,901,65,966,1619,59.67%,40.21%,1
臺北市,士林區,0230,593,191,784,59,843,1425,59.16%,41.61%,1
臺北市,士林區,0231,672,247,919,76,995,1623,61.31%,41.4%,1
臺北市,士林區,0232,620,248,868,61,929,1564,59.4%,39.64%,1
臺北市,士林區,0233,617,214,831,63,894,1376,64.97%,44.84%,1
臺北市,士林區,0234,722,175,897,43,940,1517,61.96%,47.59%,1
臺北市,士林區,0235,631,235,866,56,922,1729,53.33%,36.5%,1
臺北市,士林區,0236,656,217,873,53,926,1511,61.28%,43.41%,1
臺北市,士林區,0237,767,237,1004,64,1068,1811,58.97%,42.35%,1
臺北市,士林區,0238,593,242,835,53,888,1533,57.93%,38.68%,1
臺北市,士林區,0239,764,247,1011,63,1074,1657,64.82%,46.11%,1
臺北市,士林區,0240,629,175,804,52,856,1499,57.1%,41.96%,1
臺北市,士林區,0241,595,146,741,69,810,1402,57.77%,42.44%,1
臺北市,士林區,0242,546,214,760,71,831,1273,65.28%,42.89%,1
臺北市,士林區,0243,513,190,703,54,757,1273,59.47%,40.3%,1
臺北市,士林區,0244,514,211,725,57,782,1316,59.42%,39.06%,1
臺北市,士林區,0245,649,237,886,71,957,1659,57.69%,39.12%,1
臺北市,士林區,0246,679,227,906,48,954,1749,54.55%,38.82%,1
臺北市,士林區,0247,574,234,808,74,882,1552,56.83%,36.98%,1
臺北市,士林區,0248,664,176,840,66,906,1529,59.25%,43.43%,1
臺北市,士林區,0249,715,153,868,50,918,1644,55.84%,43.49%,1
臺北市,士林區,0250,699,237,936,69,1005,1779,56.49%,39.29%,1
臺北市,士林區,0251,637,217,854,53,907,1597,56.79%,39.89%,1
臺北市,士林區,0252,564,203,767,64,831,1454,57.15%,38.79%,1
臺北市,士林區,0253,649,255,904,62,966,1582,61.06%,41.02%,1
臺北市,士林區,0254,654,193,847,56,903,1518,59.49%,43.08%,1
臺北市,士林區,0255,542,200,742,30,772,1501,51.43%,36.11%,1
臺北市,士林區,0256,599,203,802,54,856,1420,60.28%,42.18%,1
臺北市,士林區,0257,584,210,794,76,870,1494,58.23%,39.09%,1
臺北市,士林區,0258,641,242,883,70,953,1568,60.78%,40.88%,1
臺北市,士林區,0259,497,217,714,51,765,1208,63.33%,41.14%,1
臺北市,士林區,0260,692,268,960,68,1028,1826,56.3%,37.9%,1
臺北市,士林區,0261,619,245,864,74,938,1647,56.95%,37.58%,1
臺北市,士林區,0262,633,229,862,72,934,1654,56.47%,38.27%,1
臺北市,士林區,0263,647,211,858,65,923,1550,59.55%,41.74%,1
臺北市,士林區,0264,548,106,654,60,714,1298,55.01%,42.22%,1
臺北市,士林區,0265,536,186,722,60,782,1297,60.29%,41.33%,1
臺北市,士林區,0266,525,192,717,53,770,1352,56.95%,38.83%,1
臺北市,士林區,0267,595,222,817,58,875,1522,57.49%,39.09%,1
臺北市,士林區,0268,561,248,809,103,912,1602,56.93%,35.02%,1
臺北市,士林區,0269,539,226,765,70,835,1441,57.95%,37.4%,1
臺北市,士林區,0270,484,189,673,30,703,1325,53.06%,36.53%,1
臺北市,士林區,0271,627,221,848,55,903,1567,57.63%,40.01%,1
臺北市,士林區,0272,593,213,806,33,839,1518,55.27%,39.06%,1
臺北市,士林區,0273,647,238,885,59,944,1549,60.94%,41.77%,1
臺北市,士林區,0274,651,234,885,36,921,1652,55.75%,39.41%,1
臺北市,士林區,0275,735,247,982,73,1055,1766,59.74%,41.62%,1
臺北市,士林區,0276,612,239,851,37,888,1638,54.21%,37.36%,1
臺北市,士林區,0277,652,203,855,60,915,1491,61.37%,43.73%,1
臺北市,士林區,0278,623,211,834,38,872,1521,57.33%,40.96%,1
臺北市,士林區,0279,611,160,771,60,831,1351,61.51%,45.23%,1
臺北市,士林區,0280,612,238,850,36,886,1742,50.86%,35.13%,1
臺北市,士林區,0281,634,256,890,62,952,1585,60.06%,40%,1
臺北市,士林區,0282,638,196,834,58,892,1521,58.65%,41.95%,1
臺北市,士林區,0283,610,205,815,46,861,1543,55.8%,39.53%,1
臺北市,士林區,0284,595,186,781,51,832,1404,59.26%,42.38%,1
臺北市,士林區,0285,617,221,838,54,892,1541,57.88%,40.04%,1
臺北市,士林區,0286,630,186,816,68,884,1584,55.81%,39.77%,1
臺北市,士林區,0287,612,230,842,66,908,1519,59.78%,40.29%,1
臺北市,士林區,0288,546,183,729,40,769,1482,51.89%,36.84%,1
臺北市,士林區,0289,481,163,644,67,711,1243,57.2%,38.7%,1
臺北市,士林區,0290,433,176,609,57,666,1156,57.61%,37.46%,1
臺北市,士林區,0291,407,173,580,85,665,1262,52.69%,32.25%,1
臺北市,士林區,0292,337,146,483,50,533,889,59.96%,37.91%,1
臺北市,士林區,0293,308,155,463,0,463,858,53.96%,35.9%,1
臺北市,士林區,0294,298,167,465,69,534,945,56.51%,31.53%,1
臺北市,士林區,0295,356,115,471,60,531,960,55.31%,37.08%,1
臺北市,士林區,0296,342,95,437,58,495,876,56.51%,39.04%,1
臺北市,士林區,0297,217,108,325,38,363,556,65.29%,39.03%,1
臺北市,士林區,0298,368,125,493,82,575,919,62.57%,40.04%,1
臺北市,士林區,0299,549,243,792,108,900,1360,66.18%,40.37%,1
臺北市,士林區,0300,521,201,722,102,824,1355,60.81%,38.45%,1
臺北市,士林區,0301,550,140,690,53,743,1252,59.35%,43.93%,1
臺北市,士林區,0302,553,126,679,60,739,1182,62.52%,46.79%,1
臺北市,士林區,0303,494,149,643,27,670,1431,46.82%,34.52%,1
臺北市,士林區,0304,449,169,618,43,661,1240,53.31%,36.21%,1
臺北市,北投區,0001,540,193,733,65,798,1313,60.78%,41.13%,1
臺北市,北投區,0002,568,248,816,48,864,1403,61.58%,40.48%,1
臺北市,北投區,0003,431,175,606,59,665,1081,61.52%,39.87%,1
臺北市,北投區,0004,487,181,668,58,726,1209,60.05%,40.28%,1
臺北市,北投區,0005,524,197,721,50,771,1326,58.14%,39.52%,1
臺北市,北投區,0006,495,203,698,64,762,1263,60.33%,39.19%,1
臺北市,北投區,0007,643,237,880,64,944,1580,59.75%,40.7%,1
臺北市,北投區,0008,642,234,876,49,925,1577,58.66%,40.71%,1
臺北市,北投區,0009,699,104,803,75,878,1483,59.2%,47.13%,1
臺北市,北投區,0010,586,180,766,45,811,1461,55.51%,40.11%,1
臺北市,北投區,0011,549,198,747,84,831,1466,56.68%,37.45%,1
臺北市,北投區,0012,650,218,868,70,938,1620,57.9%,40.12%,1
臺北市,北投區,0013,570,201,771,39,810,1543,52.5%,36.94%,1
臺北市,北投區,0014,530,210,740,79,819,1513,54.13%,35.03%,1
臺北市,北投區,0015,618,194,812,53,865,1534,56.39%,40.29%,1
臺北市,北投區,0016,690,212,902,80,982,1650,59.52%,41.82%,1
臺北市,北投區,0017,619,201,820,48,868,1533,56.62%,40.38%,1
臺北市,北投區,0018,645,225,870,62,932,1702,54.76%,37.9%,1
臺北市,北投區,0019,678,236,914,55,969,1721,56.3%,39.4%,1
臺北市,北投區,0020,608,274,882,70,952,1575,60.44%,38.6%,1
臺北市,北投區,0021,601,214,815,76,891,1530,58.24%,39.28%,1
臺北市,北投區,0022,645,213,858,87,945,1728,54.69%,37.33%,1
臺北市,北投區,0023,660,225,885,86,971,1702,57.05%,38.78%,1
臺北市,北投區,0024,620,248,868,81,949,1696,55.96%,36.56%,1
臺北市,北投區,0025,563,187,750,45,795,1684,47.21%,33.43%,1
臺北市,北投區,0026,704,246,950,75,1025,1717,59.7%,41%,1
臺北市,北投區,0027,643,223,866,52,918,1605,57.2%,40.06%,1
臺北市,北投區,0028,706,217,923,64,987,1723,57.28%,40.98%,1
臺北市,北投區,0029,683,229,912,66,978,1597,61.24%,42.77%,1
臺北市,北投區,0030,653,251,904,59,963,1700,56.65%,38.41%,1
臺北市,北投區,0031,599,164,763,41,804,1544,52.07%,38.8%,1
臺北市,北投區,0032,584,228,812,61,873,1635,53.39%,35.72%,1
臺北市,北投區,0033,624,195,819,37,856,1495,57.26%,41.74%,1
臺北市,北投區,0034,656,248,904,36,940,1619,58.06%,40.52%,1
臺北市,北投區,0035,632,267,899,54,953,1683,56.63%,37.55%,1
臺北市,北投區,0036,624,203,827,59,886,1662,53.31%,37.55%,1
臺北市,北投區,0037,638,218,856,48,904,1850,48.86%,34.49%,1
臺北市,北投區,0038,611,207,818,25,843,1674,50.36%,36.5%,1
臺北市,北投區,0039,682,179,861,56,917,1511,60.69%,45.14%,1
臺北市,北投區,0040,551,179,730,26,756,1393,54.27%,39.55%,1
臺北市,北投區,0041,569,183,752,58,810,1279,63.33%,44.49%,1
臺北市,北投區,0042,464,120,584,38,622,1122,55.44%,41.35%,1
臺北市,北投區,0043,615,173,788,65,853,1238,68.9%,49.68%,1
臺北市,北投區,0044,645,199,844,68,912,1477,61.75%,43.67%,1
臺北市,北投區,0045,637,196,833,78,911,1495,60.94%,42.61%,1
臺北市,北投區,0046,653,205,858,61,919,1469,62.56%,44.45%,1
臺北市,北投區,0047,617,182,799,63,862,1462,58.96%,42.2%,1
臺北市,北投區,0048,600,177,777,73,850,1431,59.4%,41.93%,1
臺北市,北投區,0049,580,217,797,43,840,1486,56.53%,39.03%,1
臺北市,北投區,0050,592,226,818,62,880,1449,60.73%,40.86%,1
臺北市,北投區,0051,572,211,783,47,830,1456,57.01%,39.29%,1
臺北市,北投區,0052,506,178,684,42,726,1311,55.38%,38.6%,1
臺北市,北投區,0053,531,187,718,67,785,1356,57.89%,39.16%,1
臺北市,北投區,0054,546,174,720,42,762,1338,56.95%,40.81%,1
臺北市,北投區,0055,608,207,815,33,848,1525,55.61%,39.87%,1
臺北市,北投區,0056,615,200,815,50,865,1620,53.4%,37.96%,1
臺北市,北投區,0057,568,173,741,33,774,1499,51.63%,37.89%,1
臺北市,北投區,0058,663,164,827,50,877,1497,58.58%,44.29%,1
臺北市,北投區,0059,625,222,847,69,916,1624,56.4%,38.49%,1
臺北市,北投區,0060,565,178,743,94,837,1536,54.49%,36.78%,1
臺北市,北投區,0061,596,219,815,86,901,1469,61.33%,40.57%,1
臺北市,北投區,0062,612,213,825,63,888,1598,55.57%,38.3%,1
臺北市,北投區,0063,651,218,869,41,910,1690,53.85%,38.52%,1
臺北市,北投區,0064,597,213,810,107,917,1599,57.35%,37.34%,1
臺北市,北投區,0065,626,209,835,79,914,1634,55.94%,38.31%,1
臺北市,北投區,0066,568,231,799,78,877,1660,52.83%,34.22%,1
臺北市,北投區,0067,682,241,923,71,994,1900,52.32%,35.89%,1
臺北市,北投區,0068,712,258,970,58,1028,1797,57.21%,39.62%,1
臺北市,北投區,0069,708,260,968,87,1055,1832,57.59%,38.65%,1
臺北市,北投區,0070,714,257,971,75,1046,1784,58.63%,40.02%,1
臺北市,北投區,0071,690,243,933,57,990,1732,57.16%,39.84%,1
臺北市,北投區,0072,372,121,493,61,554,2035,27.22%,18.28%,1
臺北市,北投區,0073,580,212,792,73,865,1504,57.51%,38.56%,1
臺北市,北投區,0074,693,215,908,94,1002,1683,59.54%,41.18%,1
臺北市,北投區,0075,580,230,810,95,905,1635,55.35%,35.47%,1
臺北市,北投區,0076,614,205,819,85,904,1613,56.04%,38.07%,1
臺北市,北投區,0077,602,161,763,39,802,1483,54.08%,40.59%,1
臺北市,北投區,0078,555,231,786,57,843,1500,56.2%,37%,1
臺北市,北投區,0079,583,201,784,83,867,1483,58.46%,39.31%,1
臺北市,北投區,0080,562,233,795,75,870,1544,56.35%,36.4%,1
臺北市,北投區,0081,512,171,683,78,761,1532,49.67%,33.42%,1
臺北市,北投區,0082,688,250,938,79,1017,1819,55.91%,37.82%,1
臺北市,北投區,0083,612,262,874,84,958,1863,51.42%,32.85%,1
臺北市,北投區,0084,611,251,862,39,901,1872,48.13%,32.64%,1
臺北市,北投區,0085,605,223,828,65,893,1627,54.89%,37.19%,1
臺北市,北投區,0086,635,198,833,44,877,1696,51.71%,37.44%,1
臺北市,北投區,0087,678,260,938,65,1003,1841,54.48%,36.83%,1
臺北市,北投區,0088,514,166,680,70,750,1324,56.65%,38.82%,1
臺北市,北投區,0089,570,182,752,51,803,1504,53.39%,37.9%,1
臺北市,北投區,0090,595,193,788,56,844,1511,55.86%,39.38%,1
臺北市,北投區,0091,643,251,894,53,947,1615,58.64%,39.81%,1
臺北市,北投區,0092,500,127,627,48,675,1270,53.15%,39.37%,1
臺北市,北投區,0093,525,168,693,40,733,1492,49.13%,35.19%,1
臺北市,北投區,0094,521,197,718,45,763,1429,53.39%,36.46%,1
臺北市,北投區,0095,594,174,768,27,795,1567,50.73%,37.91%,1
臺北市,北投區,0096,527,197,724,51,775,1388,55.84%,37.97%,1
臺北市,北投區,0097,520,179,699,27,726,1448,50.14%,35.91%,1
臺北市,北投區,0098,479,180,659,61,720,1356,53.1%,35.32%,1
臺北市,北投區,0099,511,164,675,57,732,1308,55.96%,39.07%,1
臺北市,北投區,0100,484,163,647,56,703,1165,60.34%,41.55%,1
臺北市,北投區,0101,587,192,779,73,852,1429,59.62%,41.08%,1
臺北市,北投區,0102,596,151,747,33,780,1472,52.99%,40.49%,1
臺北市,北投區,0103,642,223,865,73,938,1508,62.2%,42.57%,1
臺北市,北投區,0104,553,226,779,71,850,1480,57.43%,37.36%,1
臺北市,北投區,0105,408,164,572,49,621,1142,54.38%,35.73%,1
臺北市,北投區,0106,604,171,775,45,820,1554,52.77%,38.87%,1
臺北市,北投區,0107,684,215,899,92,991,1669,59.38%,40.98%,1
臺北市,北投區,0108,744,198,942,80,1022,1823,56.06%,40.81%,1
臺北市,北投區,0109,684,187,871,86,957,1739,55.03%,39.33%,1
臺北市,北投區,0110,648,224,872,72,944,1771,53.3%,36.59%,1
臺北市,北投區,0111,590,159,749,46,795,1468,54.16%,40.19%,1
臺北市,北投區,0112,565,191,756,49,805,1469,54.8%,38.46%,1
臺北市,北投區,0113,550,114,664,45,709,1094,64.81%,50.27%,1
臺北市,北投區,0114,540,117,657,49,706,1101,64.12%,49.05%,1
臺北市,北投區,0115,634,166,800,69,869,1422,61.11%,44.59%,1
臺北市,北投區,0116,578,132,710,64,774,1390,55.68%,41.58%,1
臺北市,北投區,0117,532,172,704,73,777,1307,59.45%,40.7%,1
臺北市,北投區,0118,488,192,680,89,769,1215,63.29%,40.16%,1
臺北市,北投區,0119,610,182,792,47,839,1642,51.1%,37.15%,1
臺北市,北投區,0120,620,169,789,37,826,1623,50.89%,38.2%,1
臺北市,北投區,0121,649,183,832,73,905,1621,55.83%,40.04%,1
臺北市,北投區,0122,520,190,710,25,735,1367,53.77%,38.04%,1
臺北市,北投區,0123,431,215,646,64,710,1309,54.24%,32.93%,1
臺北市,北投區,0124,568,168,736,34,770,1356,56.78%,41.89%,1
臺北市,北投區,0125,539,160,699,50,749,1365,54.87%,39.49%,1
臺北市,北投區,0126,588,219,807,50,857,1613,53.13%,36.45%,1
臺北市,北投區,0127,541,176,717,43,760,1590,47.8%,34.03%,1
臺北市,北投區,0128,650,232,882,82,964,1662,58%,39.11%,1
臺北市,北投區,0129,626,242,868,67,935,1622,57.64%,38.59%,1
臺北市,北投區,0130,641,289,930,40,970,1820,53.3%,35.22%,1
臺北市,北投區,0131,672,194,866,77,943,1615,58.39%,41.61%,1
臺北市,北投區,0132,489,182,671,78,749,1612,46.46%,30.33%,1
臺北市,北投區,0133,608,221,829,74,903,1652,54.66%,36.8%,1
臺北市,北投區,0134,677,200,877,35,912,1666,54.74%,40.64%,1
臺北市,北投區,0135,602,223,825,55,880,1641,53.63%,36.68%,1
臺北市,北投區,0136,205,74,279,40,319,528,60.42%,38.83%,1
臺北市,北投區,0137,507,194,701,83,784,1642,47.75%,30.88%,1
臺北市,北投區,0138,326,105,431,38,469,829,56.57%,39.32%,1
臺北市,北投區,0139,273,69,342,40,382,690,55.36%,39.57%,1
臺北市,北投區,0140,400,133,533,52,585,1067,54.83%,37.49%,1
臺北市,北投區,0141,341,104,445,62,507,892,56.84%,38.23%,1
新北市,板橋區,0894,549,187,736,79,815,1388,58.72%,39.55%,1
新北市,板橋區,0895,514,196,710,49,759,1294,58.66%,39.72%,1
新北市,板橋區,0896,272,96,368,28,396,667,59.37%,40.78%,1
新北市,板橋區,0897,319,105,424,50,474,898,52.78%,35.52%,1
新北市,板橋區,0898,357,100,457,47,504,829,60.8%,43.06%,1
新北市,板橋區,0899,334,91,425,41,466,739,63.06%,45.2%,1
新北市,板橋區,0900,434,143,577,56,633,1035,61.16%,41.93%,1
新北市,板橋區,0901,544,178,722,39,761,1713,44.42%,31.76%,1
新北市,板橋區,0902,228,82,310,16,326,658,49.54%,34.65%,1
新北市,板橋區,0903,466,167,633,101,734,1312,55.95%,35.52%,1
新北市,板橋區,0904,528,167,695,64,759,1492,50.87%,35.39%,1
新北市,板橋區,0905,477,156,633,77,710,1393,50.97%,34.24%,1
新北市,板橋區,0906,584,227,811,66,877,4742,18.49%,12.32%,1
新北市,板橋區,0907,535,175,710,46,756,1439,52.54%,37.18%,1
新北市,板橋區,0908,471,160,631,87,718,1187,60.49%,39.68%,1
新北市,板橋區,0909,441,120,561,46,607,1122,54.1%,39.3%,1
新北市,板橋區,0910,552,165,717,62,779,1363,57.15%,40.5%,1
新北市,板橋區,0911,434,165,599,49,648,1093,59.29%,39.71%,1
新北市,板橋區,0912,547,188,735,49,784,1331,58.9%,41.1%,1
新北市,板橋區,0913,429,147,576,65,641,1026,62.48%,41.81%,1
新北市,板橋區,0914,500,134,634,92,726,1244,58.36%,40.19%,1
新北市,板橋區,0915,438,156,594,93,687,1268,54.18%,34.54%,1
新北市,板橋區,0916,449,148,597,47,644,1313,49.05%,34.2%,1
新北市,板橋區,0917,488,188,676,53,729,1196,60.95%,40.8%,1
新北市,板橋區,0918,540,176,716,61,777,1137,68.34%,47.49%,1
新北市,板橋區,0919,549,196,745,60,805,1269,63.44%,43.26%,1
新北市,板橋區,0920,491,154,645,33,678,1117,60.7%,43.96%,1
新北市,板橋區,0921,463,140,603,58,661,1042,63.44%,44.43%,1
新北市,板橋區,0922,483,190,673,86,759,1257,60.38%,38.42%,1
新北市,板橋區,0923,476,167,643,79,722,1216,59.38%,39.14%,1
新北市,板橋區,0924,437,153,590,62,652,1126,57.9%,38.81%,1
新北市,板橋區,0925,574,193,767,73,840,1290,65.12%,44.5%,1
新北市,板橋區,0926,449,134,583,14,597,1215,49.14%,36.95%,1
新北市,板橋區,0927,401,137,538,26,564,1099,51.32%,36.49%,1
新北市,板橋區,0928,665,129,794,49,843,1329,63.43%,50.04%,1
新北市,板橋區,0929,481,85,566,40,606,996,60.84%,48.29%,1
新北市,板橋區,0930,454,119,573,46,619,1047,59.12%,43.36%,1
新北市,板橋區,0931,598,183,781,84,865,1272,68%,47.01%,1
新北市,板橋區,0932,556,144,700,64,764,1252,61.02%,44.41%,1
新北市,板橋區,0933,479,179,658,73,731,1238,59.05%,38.69%,1
新北市,板橋區,0934,583,210,793,85,878,1389,63.21%,41.97%,1
新北市,板橋區,0935,491,190,681,71,752,1194,62.98%,41.12%,1
新北市,板橋區,0936,402,112,514,68,582,1093,53.25%,36.78%,1
新北市,板橋區,0937,427,143,570,87,657,1148,57.23%,37.2%,1
新北市,板橋區,0938,496,153,649,57,706,1268,55.68%,39.12%,1
新北市,板橋區,0939,467,180,647,71,718,1230,58.37%,37.97%,1
新北市,板橋區,0940,389,134,523,53,576,1012,56.92%,38.44%,1
新北市,板橋區,0941,322,114,436,50,486,811,59.93%,39.7%,1
新北市,板橋區,0942,495,173,668,83,751,1197,62.74%,41.35%,1
新北市,板橋區,0943,443,124,567,43,610,1142,53.42%,38.79%,1
新北市,板橋區,0944,469,157,626,66,692,1222,56.63%,38.38%,1
新北市,板橋區,0945,352,96,448,53,501,796,62.94%,44.22%,1
新北市,板橋區,0946,446,123,569,78,647,997,64.89%,44.73%,1
新北市,板橋區,0947,365,179,544,40,584,1011,57.76%,36.1%,1
新北市,板橋區,0948,430,167,597,70,667,1157,57.65%,37.17%,1
新北市,板橋區,0949,418,144,562,67,629,1040,60.48%,40.19%,1
新北市,板橋區,0950,522,142,664,47,711,1173,60.61%,44.5%,1
新北市,板橋區,0951,462,142,604,35,639,1193,53.56%,38.73%,1
新北市,板橋區,0952,524,158,682,45,727,1255,57.93%,41.75%,1
新北市,板橋區,0953,515,185,700,57,757,1306,57.96%,39.43%,1
新北市,板橋區,0954,418,136,554,24,578,1050,55.05%,39.81%,1
新北市,板橋區,0955,368,137,505,37,542,942,57.54%,39.07%,1
新北市,板橋區,0956,488,159,647,65,712,1133,62.84%,43.07%,1
新北市,板橋區,0957,505,165,670,56,726,1251,58.03%,40.37%,1
新北市,板橋區,0958,522,177,699,45,744,1293,57.54%,40.37%,1
新北市,板橋區,0959,427,157,584,71,655,1208,54.22%,35.35%,1
新北市,板橋區,0960,465,150,615,75,690,1223,56.42%,38.02%,1
新北市,板橋區,0961,392,152,544,60,604,1061,56.93%,36.95%,1
新北市,板橋區,0962,603,194,797,56,853,1515,56.3%,39.8%,1
新北市,板橋區,0963,513,165,678,76,754,1225,61.55%,41.88%,1
新北市,板橋區,0964,556,119,675,33,708,1120,63.21%,49.64%,1
新北市,板橋區,0965,495,140,635,52,687,1091,62.97%,45.37%,1
新北市,板橋區,0966,648,132,780,43,823,1385,59.42%,46.79%,1
新北市,板橋區,0967,499,189,688,79,767,1283,59.78%,38.89%,1
新北市,板橋區,0968,450,153,603,102,705,1204,58.55%,37.38%,1
新北市,板橋區,0969,548,146,694,61,755,1191,63.39%,46.01%,1
新北市,板橋區,0970,455,163,618,68,686,1078,63.64%,42.21%,1
新北市,板橋區,0971,506,204,710,86,796,1351,58.92%,37.45%,1
新北市,板橋區,0972,534,165,699,77,776,1322,58.7%,40.39%,1
新北市,板橋區,0973,336,124,460,65,525,868,60.48%,38.71%,1
新北市,板橋區,0974,416,191,607,80,687,1029,66.76%,40.43%,1
新北市,板橋區,0975,679,216,895,50,945,1602,58.99%,42.38%,1
新北市,板橋區,0976,538,204,742,73,815,1362,59.84%,39.5%,1
新北市,板橋區,0977,641,214,855,106,961,1698,56.6%,37.75%,1
新北市,板橋區,0978,637,163,800,48,848,1495,56.72%,42.61%,1
新北市,板橋區,0979,498,242,740,94,834,1522,54.8%,32.72%,1
新北市,板橋區,0980,527,154,681,73,754,1279,58.95%,41.2%,1
新北市,板橋區,0981,478,182,660,66,726,1559,46.57%,30.66%,1
新北市,板橋區,0982,539,173,712,114,826,1537,53.74%,35.07%,1
新北市,板橋區,0983,496,204,700,88,788,1531,51.47%,32.4%,1
新北市,板橋區,0984,645,219,864,36,900,1720,52.33%,37.5%,1
新北市,板橋區,0985,424,128,552,47,599,1165,51.42%,36.39%,1
新北市,板橋區,0986,760,238,998,63,1061,1857,57.14%,40.93%,1
新北市,板橋區,0987,391,146,537,83,620,1078,57.51%,36.27%,1
新北市,板橋區,0988,422,155,577,31,608,1177,51.66%,35.85%,1
新北市,板橋區,0989,689,259,948,62,1010,1798,56.17%,38.32%,1
新北市,板橋區,0990,580,186,766,119,885,1455,60.82%,39.86%,1
新北市,板橋區,0991,482,197,679,83,762,1245,61.2%,38.71%,1
新北市,板橋區,0992,578,249,827,105,932,1704,54.69%,33.92%,1
新北市,板橋區,0993,682,196,878,39,917,1600,57.31%,42.63%,1
新北市,板橋區,0994,487,179,666,43,709,1409,50.32%,34.56%,1
新北市,板橋區,0995,492,173,665,71,736,1286,57.23%,38.26%,1
新北市,板橋區,0996,381,159,540,129,669,1359,49.23%,28.04%,1
新北市,板橋區,0997,402,167,569,61,630,1188,53.03%,33.84%,1
新北市,板橋區,0998,572,194,766,68,834,1627,51.26%,35.16%,1
新北市,板橋區,0999,539,170,709,40,749,1633,45.87%,33.01%,1
新北市,板橋區,1000,744,251,995,91,1086,1814,59.87%,41.01%,1
新北市,板橋區,1001,721,201,922,84,1006,1810,55.58%,39.83%,1
新北市,板橋區,1002,425,142,567,92,659,1133,58.16%,37.51%,1
新北市,板橋區,1003,311,117,428,48,476,841,56.6%,36.98%,1
新北市,板橋區,1004,455,128,583,70,653,1050,62.19%,43.33%,1
新北市,板橋區,1005,378,135,513,88,601,1130,53.19%,33.45%,1
新北市,板橋區,1006,413,164,577,81,658,1056,62.31%,39.11%,1
新北市,板橋區,1007,290,245,535,38,573,1129,50.75%,25.69%,1
新北市,板橋區,1008,664,210,874,97,971,1713,56.68%,38.76%,1
新北市,板橋區,1009,640,221,861,86,947,1622,58.38%,39.46%,1
新北市,板橋區,1010,638,192,830,62,892,1427,62.51%,44.71%,1
新北市,板橋區,1011,658,196,854,37,891,1471,60.57%,44.73%,1
新北市,板橋區,1012,385,148,533,24,557,1076,51.77%,35.78%,1
新北市,板橋區,1013,337,106,443,12,455,979,46.48%,34.42%,1
新北市,板橋區,1014,496,132,628,40,668,1079,61.91%,45.97%,1
新北市,板橋區,1015,291,111,402,71,473,828,57.13%,35.14%,1
新北市,板橋區,1016,295,136,431,84,515,820,62.8%,35.98%,1
新北市,板橋區,1017,368,148,516,47,563,989,56.93%,37.21%,1
新北市,板橋區,1018,359,154,513,85,598,1023,58.46%,35.09%,1
新北市,板橋區,1019,360,150,510,43,553,1044,52.97%,34.48%,1
新北市,板橋區,1020,368,135,503,68,571,968,58.99%,38.02%,1
新北市,板橋區,1021,488,166,654,38,692,1222,56.63%,39.93%,1
新北市,板橋區,1022,521,173,694,54,748,1385,54.01%,37.62%,1
新北市,板橋區,1023,570,209,779,84,863,1585,54.45%,35.96%,1
新北市,板橋區,1024,674,237,911,92,1003,1840,54.51%,36.63%,1
新北市,板橋區,1025,705,293,998,118,1116,1806,61.79%,39.04%,1
新北市,板橋區,1026,558,204,762,95,857,1506,56.91%,37.05%,1
新北市,板橋區,1027,526,202,728,98,826,1476,55.96%,35.64%,1
新北市,板橋區,1028,595,193,788,84,872,1500,58.13%,39.67%,1
新北市,板橋區,1029,462,156,618,78,696,1096,63.5%,42.15%,1
新北市,板橋區,1030,367,152,519,84,603,963,62.62%,38.11%,1
新北市,板橋區,1031,592,186,778,61,839,1601,52.4%,36.98%,1
新北市,板橋區,1032,641,204,845,86,931,1507,61.78%,42.53%,1
新北市,板橋區,1033,504,215,719,95,814,1315,61.9%,38.33%,1
新北市,板橋區,1034,419,174,593,43,636,1178,53.99%,35.57%,1
新北市,板橋區,1035,764,232,996,93,1089,1822,59.77%,41.93%,1
新北市,板橋區,1036,661,244,905,90,995,1605,61.99%,41.18%,1
新北市,板橋區,1037,658,214,872,25,897,1549,57.91%,42.48%,1
新北市,板橋區,1038,835,245,1080,64,1144,1948,58.73%,42.86%,1
新北市,板橋區,1039,744,242,986,39,1025,1935,52.97%,38.45%,1
新北市,板橋區,1040,394,130,524,51,575,1097,52.42%,35.92%,1
新北市,板橋區,1041,390,159,549,59,608,1095,55.53%,35.62%,1
新北市,板橋區,1042,567,238,805,110,915,1678,54.53%,33.79%,1
新北市,板橋區,1043,623,219,842,123,965,1750,55.14%,35.6%,1
新北市,板橋區,1044,427,167,594,71,665,1187,56.02%,35.97%,1
新北市,板橋區,1045,456,161,617,36,653,1154,56.59%,39.51%,1
新北市,板橋區,1046,488,183,671,37,708,1262,56.1%,38.67%,1
新北市,板橋區,1047,485,143,628,92,720,1271,56.65%,38.16%,1
新北市,板橋區,1048,512,183,695,110,805,1410,57.09%,36.31%,1
新北市,板橋區,1049,615,181,796,110,906,1745,51.92%,35.24%,1
新北市,板橋區,1050,660,252,912,145,1057,1867,56.61%,35.35%,1
新北市,板橋區,1051,698,241,939,106,1045,1753,59.61%,39.82%,1
新北市,板橋區,1052,483,166,649,17,666,1204,55.32%,40.12%,1
新北市,板橋區,1053,608,196,804,84,888,1614,55.02%,37.67%,1
新北市,板橋區,1054,501,178,679,59,738,1237,59.66%,40.5%,1
新北市,板橋區,1055,528,199,727,88,815,1361,59.88%,38.8%,1
新北市,板橋區,1056,459,173,632,49,681,1243,54.79%,36.93%,1
新北市,板橋區,1057,519,186,705,49,754,1515,49.77%,34.26%,1
新北市,板橋區,1058,600,213,813,95,908,1515,59.93%,39.6%,1
新北市,板橋區,1059,375,124,499,80,579,949,61.01%,39.52%,1
新北市,板橋區,1060,596,219,815,84,899,1629,55.19%,36.59%,1
新北市,板橋區,1061,480,173,653,60,713,1238,57.59%,38.77%,1
新北市,板橋區,1062,272,74,346,35,381,901,42.29%,30.19%,1
新北市,板橋區,1063,573,179,752,109,861,1475,58.37%,38.85%,1
新北市,板橋區,1064,522,205,727,98,825,1481,55.71%,35.25%,1
新北市,板橋區,1065,631,191,822,100,922,1800,51.22%,35.06%,1
新北市,板橋區,1066,604,213,817,81,898,1630,55.09%,37.06%,1
新北市,板橋區,1067,546,163,709,57,766,1298,59.01%,42.06%,1
新北市,板橋區,1068,342,127,469,52,521,874,59.61%,39.13%,1
新北市,板橋區,1069,362,130,492,25,517,992,52.12%,36.49%,1
新北市,板橋區,1070,459,154,613,20,633,1034,61.22%,44.39%,1
新北市,板橋區,1071,528,227,755,95,850,1451,58.58%,36.39%,1
新北市,板橋區,1072,471,154,625,54,679,1130,60.09%,41.68%,1
新北市,板橋區,1073,603,183,786,63,849,1440,58.96%,41.88%,1
新北市,板橋區,1074,578,225,803,105,908,1531,59.31%,37.75%,1
新北市,板橋區,1075,580,198,778,85,863,1349,63.97%,42.99%,1
新北市,板橋區,1076,519,187,706,54,760,1593,47.71%,32.58%,1
新北市,板橋區,1077,463,137,600,42,642,1174,54.68%,39.44%,1
新北市,板橋區,1078,472,163,635,61,696,1228,56.68%,38.44%,1
新北市,板橋區,1079,442,181,623,45,668,1187,56.28%,37.24%,1
新北市,板橋區,1080,339,128,467,69,536,870,61.61%,38.97%,1
新北市,板橋區,1081,905,241,1146,57,1203,2033,59.17%,44.52%,1
新北市,板橋區,1082,505,196,701,69,770,1418,54.3%,35.61%,1
新北市,板橋區,1083,397,161,558,63,621,1075,57.77%,36.93%,1
新北市,板橋區,1084,557,169,726,49,775,1515,51.16%,36.77%,1
新北市,板橋區,1085,501,184,685,51,736,1182,62.27%,42.39%,1
新北市,板橋區,1086,687,251,938,108,1046,1893,55.26%,36.29%,1
新北市,板橋區,1087,470,181,651,69,720,1302,55.3%,36.1%,1
新北市,板橋區,1088,481,177,658,54,712,1366,52.12%,35.21%,1
新北市,板橋區,1089,549,184,733,91,824,1318,62.52%,41.65%,1
新北市,板橋區,1090,465,157,622,49,671,1200,55.92%,38.75%,1
新北市,板橋區,1091,788,279,1067,69,1136,2028,56.02%,38.86%,1
新北市,板橋區,1092,657,249,906,118,1024,1746,58.65%,37.63%,1
新北市,板橋區,1093,711,215,926,43,969,1954,49.59%,36.39%,1
新北市,板橋區,1094,562,186,748,75,823,1474,55.83%,38.13%,1
新北市,板橋區,1095,541,178,719,65,784,1418,55.29%,38.15%,1
新北市,板橋區,1096,627,242,869,92,961,1563,61.48%,40.12%,1
新北市,板橋區,1097,640,226,866,117,983,1780,55.22%,35.96%,1
新北市,板橋區,1098,649,220,869,58,927,1707,54.31%,38.02%,1
新北市,板橋區,1099,247,53,300,13,313,906,34.55%,27.26%,1
新北市,板橋區,1100,373,107,480,76,556,1030,53.98%,36.21%,1
新北市,板橋區,1101,436,152,588,59,647,1115,58.03%,39.1%,1
新北市,板橋區,1102,693,219,912,40,952,1836,51.85%,37.75%,1
新北市,板橋區,1103,719,208,927,102,1029,1881,54.7%,38.22%,1
新北市,板橋區,1104,663,210,873,43,916,1688,54.27%,39.28%,1
新北市,板橋區,1105,758,229,987,49,1036,1760,58.86%,43.07%,1
新北市,板橋區,1106,437,189,626,57,683,1044,65.42%,41.86%,1
新北市,板橋區,1107,428,157,585,53,638,1043,61.17%,41.04%,1
新北市,板橋區,1108,458,160,618,67,685,1099,62.33%,41.67%,1
新北市,板橋區,1109,438,237,675,56,731,1260,58.02%,34.76%,1
新北市,板橋區,1110,444,160,604,53,657,1131,58.09%,39.26%,1
新北市,板橋區,1111,485,168,653,66,719,1225,58.69%,39.59%,1
新北市,板橋區,1112,645,194,839,63,902,1455,61.99%,44.33%,1
新北市,板橋區,1113,467,198,665,48,713,1267,56.27%,36.86%,1
新北市,板橋區,1114,338,169,507,75,582,972,59.88%,34.77%,1
新北市,板橋區,1115,393,144,537,48,585,994,58.85%,39.54%,1
新北市,板橋區,1116,445,151,596,32,628,1111,56.53%,40.05%,1
新北市,板橋區,1117,479,227,706,72,778,1177,66.1%,40.7%,1
新北市,板橋區,1118,608,170,778,83,861,1544,55.76%,39.38%,1
新北市,板橋區,1119,388,114,502,92,594,1021,58.18%,38%,1
新北市,板橋區,1120,387,129,516,74,590,1040,56.73%,37.21%,1
新北市,板橋區,1121,577,201,778,38,816,1504,54.26%,38.36%,1
新北市,板橋區,1122,537,156,693,50,743,1373,54.12%,39.11%,1
新北市,板橋區,1123,495,171,666,30,696,1210,57.52%,40.91%,1
新北市,板橋區,1124,679,195,874,86,960,1809,53.07%,37.53%,1
新北市,板橋區,1125,631,181,812,98,910,1551,58.67%,40.68%,1
新北市,板橋區,1126,591,170,761,41,802,1408,56.96%,41.97%,1
新北市,板橋區,1127,546,150,696,42,738,1285,57.43%,42.49%,1
新北市,板橋區,1128,465,170,635,47,682,1102,61.89%,42.2%,1
新北市,板橋區,1129,503,164,667,39,706,1399,50.46%,35.95%,1
新北市,板橋區,1130,669,183,852,103,955,1692,56.44%,39.54%,1
新北市,板橋區,1131,677,234,911,43,954,1625,58.71%,41.66%,1
新北市,板橋區,1132,674,211,885,96,981,1712,57.3%,39.37%,1
新北市,板橋區,1133,478,172,650,47,697,1246,55.94%,38.36%,1
新北市,板橋區,1134,581,192,773,49,822,1471,55.88%,39.5%,1
新北市,板橋區,1135,711,196,907,85,992,1761,56.33%,40.37%,1
新北市,板橋區,1136,569,207,776,87,863,1499,57.57%,37.96%,1
新北市,板橋區,1137,529,195,724,75,799,1528,52.29%,34.62%,1
新北市,板橋區,1138,600,197,797,81,878,1536,57.16%,39.06%,1
新北市,板橋區,1139,623,202,825,65,890,1550,57.42%,40.19%,1
新北市,板橋區,1140,838,286,1124,104,1228,2050,59.9%,40.88%,1
新北市,板橋區,1141,544,159,703,68,771,1300,59.31%,41.85%,1
新北市,板橋區,1142,636,185,821,63,884,1537,57.51%,41.38%,1
新北市,板橋區,1143,480,146,626,29,655,1341,48.84%,35.79%,1
新北市,板橋區,1144,664,198,862,38,900,1606,56.04%,41.34%,1
新北市,板橋區,1145,525,149,674,53,727,1433,50.73%,36.64%,1
新北市,板橋區,1146,591,185,776,55,831,1685,49.32%,35.07%,1
新北市,板橋區,1147,499,189,688,77,765,1248,61.3%,39.98%,1
新北市,板橋區,1148,485,112,597,58,655,1172,55.89%,41.38%,1
新北市,板橋區,1149,535,172,707,29,736,1640,44.88%,32.62%,1
新北市,板橋區,1150,557,160,717,41,758,1428,53.08%,39.01%,1
新北市,板橋區,1151,589,203,792,85,877,1527,57.43%,38.57%,1
新北市,板橋區,1152,572,175,747,43,790,1350,58.52%,42.37%,1
新北市,板橋區,1153,651,168,819,78,897,1582,56.7%,41.15%,1
新北市,板橋區,1154,420,115,535,58,593,919,64.53%,45.7%,1
新北市,板橋區,1155,375,102,477,34,511,930,54.95%,40.32%,1
新北市,板橋區,1156,442,123,565,30,595,974,61.09%,45.38%,1
新北市,板橋區,1157,769,179,948,57,1005,1732,58.03%,44.4%,1
新北市,板橋區,1158,566,172,738,65,803,1438,55.84%,39.36%,1
新北市,板橋區,1159,614,231,845,115,960,1777,54.02%,34.55%,1
新北市,板橋區,1160,607,194,801,73,874,1764,49.55%,34.41%,1
新北市,板橋區,1161,515,155,670,21,691,1289,53.61%,39.95%,1
新北市,板橋區,1162,487,131,618,51,669,1182,56.6%,41.2%,1
新北市,板橋區,1163,461,172,633,71,704,1174,59.97%,39.27%,1
新北市,板橋區,1164,663,236,899,109,1008,1870,53.9%,35.45%,1
新北市,板橋區,1165,743,256,999,74,1073,1842,58.25%,40.34%,1
新北市,板橋區,1166,450,118,568,66,634,1094,57.95%,41.13%,1
新北市,板橋區,1167,445,156,601,73,674,1228,54.89%,36.24%,1
新北市,板橋區,1168,428,163,591,58,649,998,65.03%,42.89%,1
新北市,板橋區,1169,375,143,518,48,566,862,65.66%,43.5%,1
新北市,板橋區,1170,570,203,773,75,848,1622,52.28%,35.14%,1
新北市,板橋區,1171,492,168,660,75,735,1205,61%,40.83%,1
新北市,板橋區,1172,611,219,830,60,890,1787,49.8%,34.19%,1
新北市,板橋區,1173,688,184,872,48,920,1610,57.14%,42.73%,1
新北市,板橋區,1174,936,283,1219,62,1281,2216,57.81%,42.24%,1
新北市,板橋區,1175,919,284,1203,63,1266,2294,55.19%,40.06%,1
新北市,板橋區,1176,751,188,939,100,1039,2090,49.71%,35.93%,1
新北市,板橋區,1177,495,130,625,44,669,1356,49.34%,36.5%,1
新北市,板橋區,1178,443,139,582,45,627,1067,58.76%,41.52%,1
新北市,板橋區,1179,507,181,688,67,755,1319,57.24%,38.44%,1
新北市,板橋區,1180,443,163,606,65,671,1316,50.99%,33.66%,1
新北市,板橋區,1181,437,128,565,81,646,1195,54.06%,36.57%,1
新北市,板橋區,1182,342,98,440,32,472,857,55.08%,39.91%,1
新北市,板橋區,1183,487,185,672,97,769,1417,54.27%,34.37%,1
新北市,板橋區,1184,588,220,808,96,904,1560,57.95%,37.69%,1
新北市,板橋區,1185,672,214,886,103,989,1747,56.61%,38.47%,1
新北市,板橋區,1186,513,186,699,65,764,1176,64.97%,43.62%,1
新北市,板橋區,1187,461,146,607,35,642,1101,58.31%,41.87%,1
新北市,板橋區,1188,590,204,794,34,828,1458,56.79%,40.47%,1
新北市,板橋區,1189,565,177,742,56,798,1630,48.96%,34.66%,1
新北市,板橋區,1190,548,216,764,113,877,1611,54.44%,34.02%,1
新北市,板橋區,1191,411,133,544,43,587,1139,51.54%,36.08%,1
新北市,板橋區,1192,429,125,554,47,601,1120,53.66%,38.3%,1
新北市,板橋區,1193,400,155,555,98,653,1022,63.89%,39.14%,1
新北市,板橋區,1194,395,151,546,91,637,1049,60.72%,37.65%,1
新北市,板橋區,1195,429,124,553,33,586,1007,58.19%,42.6%,1
新北市,板橋區,1196,585,157,742,37,779,1393,55.92%,42%,1
新北市,板橋區,1197,125,44,169,32,201,474,42.41%,26.37%,1
新北市,板橋區,1198,189,72,261,36,297,500,59.4%,37.8%,1
新北市,板橋區,1199,443,148,591,51,642,1177,54.55%,37.64%,1
新北市,板橋區,1200,440,146,586,45,631,1186,53.2%,37.1%,1
新北市,板橋區,1201,460,163,623,77,700,1139,61.46%,40.39%,1
新北市,板橋區,1202,665,211,876,75,951,1750,54.34%,38%,1
新北市,板橋區,1203,873,246,1119,49,1168,3451,33.85%,25.3%,1
新北市,板橋區,1204,565,193,758,97,855,1620,52.78%,34.88%,1
新北市,板橋區,1205,306,91,397,35,432,903,47.84%,33.89%,1
新北市,板橋區,1206,479,174,653,65,718,1232,58.28%,38.88%,1
新北市,板橋區,1207,337,105,442,26,468,975,48%,34.56%,1
新北市,板橋區,1208,447,155,602,43,645,1224,52.7%,36.52%,1
新北市,板橋區,1209,515,149,664,43,707,1291,54.76%,39.89%,1
新北市,板橋區,1210,620,202,822,59,881,1828,48.19%,33.92%,1
新北市,板橋區,1211,608,188,796,59,855,1725,49.57%,35.25%,1
新北市,板橋區,1212,384,114,498,28,526,1085,48.48%,35.39%,1
新北市,板橋區,1213,837,284,1121,95,1216,2357,51.59%,35.51%,1
新北市,板橋區,1214,596,183,779,45,824,1560,52.82%,38.21%,1
新北市,板橋區,1215,717,189,906,40,946,2201,42.98%,32.58%,1
新北市,板橋區,1216,618,200,818,60,878,1626,54%,38.01%,1
新北市,板橋區,1217,593,173,766,59,825,1786,46.19%,33.2%,1
新北市,板橋區,1218,655,191,846,76,922,1763,52.3%,37.15%,1
新北市,板橋區,1219,608,189,797,38,835,1744,47.88%,34.86%,1
新北市,板橋區,1220,605,184,789,59,848,1645,51.55%,36.78%,1
新北市,板橋區,1221,684,163,847,51,898,1861,48.25%,36.75%,1
新北市,板橋區,1222,561,168,729,46,775,1596,48.56%,35.15%,1
新北市,板橋區,1223,668,237,905,83,988,1871,52.81%,35.7%,1
新北市,板橋區,1224,763,217,980,82,1062,1938,54.8%,39.37%,1
新北市,板橋區,1225,737,222,959,53,1012,1827,55.39%,40.34%,1
新北市,板橋區,1226,421,234,655,46,701,1359,51.58%,30.98%,1
新北市,板橋區,1227,671,135,806,76,882,1613,54.68%,41.6%,1
新北市,板橋區,1228,580,213,793,89,882,1566,56.32%,37.04%,1
新北市,板橋區,1229,659,207,866,56,922,1552,59.41%,42.46%,1
新北市,板橋區,1230,671,241,912,50,962,1885,51.03%,35.6%,1
新北市,板橋區,1231,680,237,917,68,985,1893,52.03%,35.92%,1
新北市,三重區,0659,568,159,727,80,807,1509,53.48%,37.64%,1
新北市,三重區,0660,623,219,842,76,918,1591,57.7%,39.16%,1
新北市,三重區,0661,619,244,863,86,949,1653,57.41%,37.45%,1
新北市,三重區,0662,533,212,745,84,829,1392,59.55%,38.29%,1
新北市,三重區,0663,598,177,775,103,878,1451,60.51%,41.21%,1
新北市,三重區,0664,473,188,661,103,764,1329,57.49%,35.59%,1
新北市,三重區,0665,591,184,775,57,832,1459,57.03%,40.51%,1
新北市,三重區,0666,396,154,550,68,618,1024,60.35%,38.67%,1
新北市,三重區,0667,411,173,584,66,650,1066,60.98%,38.56%,1
新北市,三重區,0668,377,124,501,64,565,856,66%,44.04%,1
新北市,三重區,0669,276,122,398,41,439,764,57.46%,36.13%,1
新北市,三重區,0670,314,132,446,60,506,821,61.63%,38.25%,1
新北市,三重區,0671,643,263,906,80,986,1887,52.25%,34.08%,1
新北市,三重區,0672,569,235,804,69,873,1646,53.04%,34.57%,1
新北市,三重區,0673,138,52,190,20,210,358,58.66%,38.55%,1
新北市,三重區,0674,415,143,558,66,624,1039,60.06%,39.94%,1
新北市,三重區,0675,445,183,628,49,677,1114,60.77%,39.95%,1
新北市,三重區,0676,846,28,874,54,928,1588,58.44%,53.27%,1
新北市,三重區,0677,633,215,848,59,907,1702,53.29%,37.19%,1
新北市,三重區,0678,516,210,726,65,791,1288,61.41%,40.06%,1
新北市,三重區,0679,654,254,908,78,986,1629,60.53%,40.15%,1
新北市,三重區,0680,740,218,958,85,1043,1861,56.05%,39.76%,1
新北市,三重區,0681,608,206,814,68,882,1727,51.07%,35.21%,1
新北市,三重區,0682,703,242,945,59,1004,1813,55.38%,38.78%,1
新北市,三重區,0683,626,196,822,81,903,1595,56.61%,39.25%,1
新北市,三重區,0684,598,199,797,75,872,1513,57.63%,39.52%,1
新北市,三重區,0685,512,237,749,72,821,4433,18.52%,11.55%,1
新北市,三重區,0686,514,179,693,50,743,1283,57.91%,40.06%,1
新北市,三重區,0687,612,193,805,67,872,1430,60.98%,42.8%,1
新北市,三重區,0688,580,163,743,49,792,1357,58.36%,42.74%,1
新北市,三重區,0689,381,142,523,45,568,963,58.98%,39.56%,1
新北市,三重區,0690,327,127,454,62,516,883,58.44%,37.03%,1
新北市,三重區,0691,551,189,740,106,846,1494,56.63%,36.88%,1
新北市,三重區,0692,617,231,848,98,946,1616,58.54%,38.18%,1
新北市,三重區,0693,510,161,671,88,759,1329,57.11%,38.37%,1
新北市,三重區,0694,525,212,737,67,804,1289,62.37%,40.73%,1
新北市,三重區,0695,511,192,703,99,802,1380,58.12%,37.03%,1
新北市,三重區,0696,671,205,876,64,940,1668,56.35%,40.23%,1
新北市,三重區,0697,504,184,688,88,776,1226,63.3%,41.11%,1
新北市,三重區,0698,558,204,762,70,832,1421,58.55%,39.27%,1
新北市,三重區,0699,542,189,731,69,800,1364,58.65%,39.74%,1
新北市,三重區,0700,500,178,678,55,733,1232,59.5%,40.58%,1
新北市,三重區,0701,524,186,710,68,778,1248,62.34%,41.99%,1
新北市,三重區,0702,480,110,590,81,671,1256,53.42%,38.22%,1
新北市,三重區,0703,613,241,854,78,932,1506,61.89%,40.7%,1
新北市,三重區,0704,669,238,907,88,995,1669,59.62%,40.08%,1
新北市,三重區,0705,500,161,661,105,766,1308,58.56%,38.23%,1
新北市,三重區,0706,582,176,758,71,829,1263,65.64%,46.08%,1
新北市,三重區,0707,550,194,744,97,841,1471,57.17%,37.39%,1
新北市,三重區,0708,518,227,745,132,877,1447,60.61%,35.8%,1
新北市,三重區,0709,550,203,753,79,832,1693,49.14%,32.49%,1
新北市,三重區,0710,749,272,1021,59,1080,2015,53.6%,37.17%,1
新北市,三重區,0711,635,208,843,103,946,1812,52.21%,35.04%,1
新北市,三重區,0712,531,171,702,52,754,1509,49.97%,35.19%,1
新北市,三重區,0713,590,185,775,61,836,1439,58.1%,41%,1
新北市,三重區,0714,556,189,745,76,821,1437,57.13%,38.69%,1
新北市,三重區,0715,616,234,850,71,921,1697,54.27%,36.3%,1
新北市,三重區,0716,658,201,859,54,913,1793,50.92%,36.7%,1
新北市,三重區,0717,666,226,892,66,958,1603,59.76%,41.55%,1
新北市,三重區,0718,430,161,591,43,634,1166,54.37%,36.88%,1
新北市,三重區,0719,467,152,619,45,664,1126,58.97%,41.47%,1
新北市,三重區,0720,432,147,579,68,647,1291,50.12%,33.46%,1
新北市,三重區,0721,589,204,793,104,897,1597,56.17%,36.88%,1
新北市,三重區,0722,435,147,582,81,663,1081,61.33%,40.24%,1
新北市,三重區,0723,374,139,513,73,586,911,64.32%,41.05%,1
新北市,三重區,0724,572,208,780,57,837,1719,48.69%,33.28%,1
新北市,三重區,0725,475,163,638,86,724,1289,56.17%,36.85%,1
新北市,三重區,0726,511,187,698,107,805,1318,61.08%,38.77%,1
新北市,三重區,0727,641,220,861,84,945,1822,51.87%,35.18%,1
新北市,三重區,0728,432,154,586,106,692,1185,58.4%,36.46%,1
新北市,三重區,0729,463,152,615,107,722,1369,52.74%,33.82%,1
新北市,三重區,0730,569,210,779,82,861,1507,57.13%,37.76%,1
新北市,三重區,0731,343,134,477,75,552,926,59.61%,37.04%,1
新北市,三重區,0732,319,113,432,28,460,950,48.42%,33.58%,1
新北市,三重區,0733,568,223,791,89,880,1678,52.44%,33.85%,1
新北市,三重區,0734,393,150,543,95,638,1117,57.12%,35.18%,1
新北市,三重區,0735,477,156,633,67,700,1318,53.11%,36.19%,1
新北市,三重區,0736,486,213,699,48,747,1388,53.82%,35.01%,1
新北市,三重區,0737,382,131,513,85,598,1026,58.28%,37.23%,1
新北市,三重區,0738,460,160,620,63,683,1096,62.32%,41.97%,1
新北市,三重區,0739,380,145,525,46,571,967,59.05%,39.3%,1
新北市,三重區,0740,629,269,898,80,978,1871,52.27%,33.62%,1
新北市,三重區,0741,615,211,826,107,933,1663,56.1%,36.98%,1
新北市,三重區,0742,458,136,594,33,627,1208,51.9%,37.91%,1
新北市,三重區,0743,471,191,662,66,728,1398,52.07%,33.69%,1
新北市,三重區,0744,394,139,533,37,570,1078,52.88%,36.55%,1
新北市,三重區,0745,390,133,523,83,606,1102,54.99%,35.39%,1
新北市,三重區,0746,484,186,670,97,767,1393,55.06%,34.75%,1
新北市,三重區,0747,506,153,659,80,739,1251,59.07%,40.45%,1
新北市,三重區,0748,523,183,706,79,785,1234,63.61%,42.38%,1
新北市,三重區,0749,619,247,866,93,959,1661,57.74%,37.27%,1
新北市,三重區,0750,622,190,812,95,907,1590,57.04%,39.12%,1
新北市,三重區,0751,460,163,623,77,700,1182,59.22%,38.92%,1
新北市,三重區,0752,500,239,739,79,818,1369,59.75%,36.52%,1
新北市,三重區,0753,494,196,690,68,758,1222,62.03%,40.43%,1
新北市,三重區,0754,447,184,631,113,744,1304,57.06%,34.28%,1
新北市,三重區,0755,383,119,502,62,564,1054,53.51%,36.34%,1
新北市,三重區,0756,582,223,805,107,912,1635,55.78%,35.6%,1
新北市,三重區,0757,628,219,847,87,934,1779,52.5%,35.3%,1
新北市,三重區,0758,610,217,827,107,934,1633,57.2%,37.35%,1
新北市,三重區,0759,443,138,581,59,640,1107,57.81%,40.02%,1
新北市,三重區,0760,421,159,580,52,632,1021,61.9%,41.23%,1
新北市,三重區,0761,523,204,727,131,858,1649,52.03%,31.72%,1
新北市,三重區,0762,321,133,454,44,498,874,56.98%,36.73%,1
新北市,三重區,0763,525,189,714,110,824,1402,58.77%,37.45%,1
新北市,三重區,0764,545,209,754,109,863,1713,50.38%,31.82%,1
新北市,三重區,0765,313,108,421,69,490,973,50.36%,32.17%,1
新北市,三重區,0766,407,138,545,67,612,1038,58.96%,39.21%,1
新北市,三重區,0767,596,210,806,134,940,1833,51.28%,32.52%,1
新北市,三重區,0768,295,125,420,41,461,817,56.43%,36.11%,1
新北市,三重區,0769,547,199,746,78,824,1387,59.41%,39.44%,1
新北市,三重區,0770,320,107,427,44,471,784,60.08%,40.82%,1
新北市,三重區,0771,357,150,507,36,543,1096,49.54%,32.57%,1
新北市,三重區,0772,470,137,607,83,690,1163,59.33%,40.41%,1
新北市,三重區,0773,710,198,908,71,979,1868,52.41%,38.01%,1
新北市,三重區,0774,371,151,522,93,615,1117,55.06%,33.21%,1
新北市,三重區,0775,318,118,436,58,494,934,52.89%,34.05%,1
新北市,三重區,0776,471,190,661,80,741,1412,52.48%,33.36%,1
新北市,三重區,0777,473,150,623,58,681,1062,64.12%,44.54%,1
新北市,三重區,0778,338,89,427,86,513,891,57.58%,37.93%,1
新北市,三重區,0779,426,127,553,91,644,936,68.8%,45.51%,1
新北市,三重區,0780,381,136,517,81,598,1085,55.12%,35.12%,1
新北市,三重區,0781,331,153,484,24,508,1065,47.7%,31.08%,1
新北市,三重區,0782,557,176,733,68,801,1398,57.3%,39.84%,1
新北市,三重區,0783,616,203,819,63,882,1550,56.9%,39.74%,1
新北市,三重區,0784,601,205,806,102,908,1674,54.24%,35.9%,1
新北市,三重區,0785,469,151,620,86,706,1215,58.11%,38.6%,1
新北市,三重區,0786,572,223,795,85,880,1606,54.79%,35.62%,1
新北市,三重區,0787,480,122,602,60,662,1182,56.01%,40.61%,1
新北市,三重區,0788,461,167,628,100,728,1238,58.8%,37.24%,1
新北市,三重區,0789,538,184,722,74,796,1342,59.31%,40.09%,1
新北市,三重區,0790,543,215,758,62,820,1408,58.24%,38.57%,1
新北市,三重區,0791,665,195,860,120,980,1770,55.37%,37.57%,1
新北市,三重區,0792,355,133,488,62,550,940,58.51%,37.77%,1
新北市,三重區,0793,344,135,479,29,508,975,52.1%,35.28%,1
新北市,三重區,0794,548,184,732,66,798,1507,52.95%,36.36%,1
新北市,三重區,0795,513,208,721,92,813,1419,57.29%,36.15%,1
新北市,三重區,0796,497,149,646,67,713,1257,56.72%,39.54%,1
新北市,三重區,0797,585,231,816,99,915,1619,56.52%,36.13%,1
新北市,三重區,0798,652,209,861,95,956,1745,54.79%,37.36%,1
新北市,三重區,0799,578,202,780,78,858,1519,56.48%,38.05%,1
新北市,三重區,0800,604,204,808,81,889,1682,52.85%,35.91%,1
新北市,三重區,0801,671,244,915,78,993,1697,58.52%,39.54%,1
新北市,三重區,0802,371,116,487,86,573,1073,53.4%,34.58%,1
新北市,三重區,0803,325,122,447,62,509,924,55.09%,35.17%,1
新北市,三重區,0804,516,176,692,64,756,1613,46.87%,31.99%,1
新北市,三重區,0805,380,108,488,62,550,1034,53.19%,36.75%,1
新北市,三重區,0806,413,161,574,79,653,1118,58.41%,36.94%,1
新北市,三重區,0807,454,164,618,96,714,1269,56.26%,35.78%,1
新北市,三重區,0808,343,138,481,69,550,990,55.56%,34.65%,1
新北市,三重區,0809,494,167,661,96,757,1336,56.66%,36.98%,1
新北市,三重區,0810,650,198,848,78,926,1601,57.84%,40.6%,1
新北市,三重區,0811,575,245,820,102,922,1581,58.32%,36.37%,1
新北市,三重區,0812,478,213,691,73,764,1345,56.8%,35.54%,1
新北市,三重區,0813,494,192,686,66,752,1226,61.34%,40.29%,1
新北市,三重區,0814,590,169,759,107,866,1650,52.48%,35.76%,1
新北市,三重區,0815,437,143,580,76,656,1140,57.54%,38.33%,1
新北市,三重區,0816,599,196,795,47,842,1639,51.37%,36.55%,1
新北市,三重區,0817,647,217,864,85,949,1699,55.86%,38.08%,1
新北市,三重區,0818,681,208,889,105,994,1501,66.22%,45.37%,1
新北市,三重區,0819,586,207,793,75,868,1538,56.44%,38.1%,1
新北市,三重區,0820,567,181,748,94,842,1540,54.68%,36.82%,1
新北市,三重區,0821,488,158,646,71,717,1276,56.19%,38.24%,1
新北市,三重區,0822,520,224,744,81,825,1539,53.61%,33.79%,1
新北市,三重區,0823,474,169,643,60,703,1170,60.09%,40.51%,1
新北市,三重區,0824,389,189,578,60,638,1120,56.96%,34.73%,1
新北市,三重區,0825,662,242,904,105,1009,1789,56.4%,37%,1
新北市,三重區,0826,522,198,720,90,810,1520,53.29%,34.34%,1
新北市,三重區,0827,660,256,916,98,1014,1821,55.68%,36.24%,1
新北市,三重區,0828,528,172,700,92,792,1407,56.29%,37.53%,1
新北市,三重區,0829,563,198,761,74,835,1491,56%,37.76%,1
新北市,三重區,0830,545,196,741,78,819,1381,59.3%,39.46%,1
新北市,三重區,0831,427,185,612,94,706,1222,57.77%,34.94%,1
新北市,三重區,0832,707,238,945,72,1017,1938,52.48%,36.48%,1
新北市,三重區,0833,613,198,811,49,860,1639,52.47%,37.4%,1
新北市,三重區,0834,601,206,807,99,906,1614,56.13%,37.24%,1
新北市,三重區,0835,624,221,845,92,937,1709,54.83%,36.51%,1
新北市,三重區,0836,625,180,805,100,905,1753,51.63%,35.65%,1
新北市,三重區,0837,506,231,737,81,818,1398,58.51%,36.19%,1
新北市,三重區,0838,595,237,832,93,925,1706,54.22%,34.88%,1
新北市,三重區,0839,620,228,848,76,924,1614,57.25%,38.41%,1
新北市,三重區,0840,585,214,799,58,857,1591,53.87%,36.77%,1
新北市,三重區,0841,613,192,805,60,865,1627,53.17%,37.68%,1
新北市,三重區,0842,556,209,765,105,870,1505,57.81%,36.94%,1
新北市,三重區,0843,544,147,691,64,755,1331,56.72%,40.87%,1
新北市,三重區,0844,573,176,749,63,812,1678,48.39%,34.15%,1
新北市,三重區,0845,564,216,780,65,845,1498,56.41%,37.65%,1
新北市,三重區,0846,689,277,966,88,1054,1800,58.56%,38.28%,1
新北市,三重區,0847,582,191,773,60,833,1703,48.91%,34.17%,1
新北市,三重區,0848,696,222,918,65,983,1975,49.77%,35.24%,1
新北市,三重區,0849,652,242,894,81,975,1894,51.48%,34.42%,1
新北市,三重區,0850,564,196,760,64,824,1405,58.65%,40.14%,1
新北市,三重區,0851,514,177,691,53,744,1293,57.54%,39.75%,1
新北市,三重區,0852,479,182,661,63,724,1259,57.51%,38.05%,1
新北市,三重區,0853,450,166,616,92,708,1144,61.89%,39.34%,1
新北市,三重區,0854,487,182,669,99,768,1254,61.24%,38.84%,1
新北市,三重區,0855,508,169,677,76,753,1313,57.35%,38.69%,1
新北市,三重區,0856,566,201,767,106,873,1594,54.77%,35.51%,1
新北市,三重區,0857,675,215,890,86,976,1775,54.99%,38.03%,1
新北市,三重區,0858,532,193,725,123,848,1516,55.94%,35.09%,1
新北市,三重區,0859,519,197,716,104,820,1315,62.36%,39.47%,1
新北市,三重區,0860,309,134,443,76,519,843,61.57%,36.65%,1
新北市,三重區,0861,396,141,537,76,613,1160,52.84%,34.14%,1
新北市,三重區,0862,381,171,552,67,619,1052,58.84%,36.22%,1
新北市,三重區,0863,434,162,596,67,663,1054,62.9%,41.18%,1
新北市,三重區,0864,363,147,510,79,589,997,59.08%,36.41%,1
新北市,三重區,0865,325,126,451,48,499,936,53.31%,34.72%,1
新北市,三重區,0866,592,207,799,107,906,1658,54.64%,35.71%,1
新北市,三重區,0867,517,193,710,101,811,1496,54.21%,34.56%,1
新北市,三重區,0868,440,145,585,72,657,1064,61.75%,41.35%,1
新北市,三重區,0869,482,160,642,62,704,1152,61.11%,41.84%,1
新北市,三重區,0870,550,175,725,57,782,1532,51.04%,35.9%,1
新北市,三重區,0871,470,114,584,55,639,1338,47.76%,35.13%,1
新北市,三重區,0872,486,187,673,61,734,1303,56.33%,37.3%,1
新北市,三重區,0873,547,169,716,100,816,1369,59.61%,39.96%,1
新北市,三重區,0874,576,158,734,104,838,1491,56.2%,38.63%,1
新北市,三重區,0875,604,220,824,124,948,1821,52.06%,33.17%,1
新北市,三重區,0876,657,214,871,83,954,1906,50.05%,34.47%,1
新北市,三重區,0877,702,261,963,76,1039,1842,56.41%,38.11%,1
新北市,三重區,0878,309,108,417,55,472,878,53.76%,35.19%,1
新北市,三重區,0879,386,155,541,68,609,963,63.24%,40.08%,1
新北市,三重區,0880,456,161,617,33,650,1381,47.07%,33.02%,1
新北市,三重區,0881,562,180,742,89,831,1681,49.43%,33.43%,1
新北市,三重區,0882,544,199,743,50,793,1548,51.23%,35.14%,1
新北市,三重區,0883,614,195,809,85,894,1542,57.98%,39.82%,1
新北市,三重區,0884,581,190,771,82,853,1557,54.78%,37.32%,1
新北市,三重區,0885,655,184,839,59,898,1661,54.06%,39.43%,1
新北市,三重區,0886,801,220,1021,44,1065,2024,52.62%,39.58%,1
新北市,三重區,0887,512,194,706,87,793,1588,49.94%,32.24%,1
新北市,三重區,0888,588,223,811,127,938,1706,54.98%,34.47%,1
新北市,三重區,0889,519,197,716,67,783,1341,58.39%,38.7%,1
新北市,三重區,0890,351,132,483,49,532,1025,51.9%,34.24%,1
新北市,三重區,0891,514,163,677,84,761,1339,56.83%,38.39%,1
新北市,三重區,0892,602,233,835,126,961,1725,55.71%,34.9%,1
新北市,三重區,0893,698,213,911,85,996,1826,54.55%,38.23%,1
新北市,中和區,1232,592,198,790,54,844,1630,51.78%,36.32%,1
新北市,中和區,1233,702,231,933,57,990,1775,55.77%,39.55%,1
新北市,中和區,1234,691,184,875,44,919,1844,49.84%,37.47%,1
新北市,中和區,1235,476,134,610,32,642,1019,63%,46.71%,1
新北市,中和區,1236,539,113,652,39,691,1138,60.72%,47.36%,1
新北市,中和區,1237,723,184,907,45,952,1878,50.69%,38.5%,1
新北市,中和區,1238,886,187,1073,54,1127,1980,56.92%,44.75%,1
新北市,中和區,1239,715,230,945,82,1027,1844,55.69%,38.77%,1
新北市,中和區,1240,858,222,1080,53,1133,2085,54.34%,41.15%,1
新北市,中和區,1241,599,170,769,64,833,1498,55.61%,39.99%,1
新北市,中和區,1242,687,219,906,42,948,1761,53.83%,39.01%,1
新北市,中和區,1243,474,155,629,37,666,1254,53.11%,37.8%,1
新北市,中和區,1244,596,141,737,46,783,1343,58.3%,44.38%,1
新北市,中和區,1245,738,196,934,35,969,1789,54.16%,41.25%,1
新北市,中和區,1246,831,213,1044,46,1090,2000,54.5%,41.55%,1
新北市,中和區,1247,674,228,902,51,953,1953,48.8%,34.51%,1
新北市,中和區,1248,645,225,870,73,943,1712,55.08%,37.68%,1
新北市,中和區,1249,684,158,842,57,899,1582,56.83%,43.24%,1
新北市,中和區,1250,695,203,898,67,965,1742,55.4%,39.9%,1
新北市,中和區,1251,664,192,856,60,916,1493,61.35%,44.47%,1
新北市,中和區,1252,497,151,648,53,701,1352,51.85%,36.76%,1
新北市,中和區,1253,565,124,689,44,733,1244,58.92%,45.42%,1
新北市,中和區,1254,581,183,764,67,831,1394,59.61%,41.68%,1
新北市,中和區,1255,606,199,805,35,840,1917,43.82%,31.61%,1
新北市,中和區,1256,647,212,859,96,955,1830,52.19%,35.36%,1
新北市,中和區,1257,449,151,600,60,660,1124,58.72%,39.95%,1
新北市,中和區,1258,488,155,643,48,691,1412,48.94%,34.56%,1
新北市,中和區,1259,515,161,676,60,736,1356,54.28%,37.98%,1
新北市,中和區,1260,549,149,698,50,748,1425,52.49%,38.53%,1
新北市,中和區,1261,529,151,680,80,760,1259,60.37%,42.02%,1
新北市,中和區,1262,497,159,656,70,726,1256,57.8%,39.57%,1
新北市,中和區,1263,578,162,740,54,794,1423,55.8%,40.62%,1
新北市,中和區,1264,513,142,655,60,715,1221,58.56%,42.01%,1
新北市,中和區,1265,642,216,858,77,935,1858,50.32%,34.55%,1
新北市,中和區,1266,673,194,867,61,928,1804,51.44%,37.31%,1
新北市,中和區,1267,650,231,881,47,928,1669,55.6%,38.95%,1
新北市,中和區,1268,607,173,780,56,836,1485,56.3%,40.88%,1
新北市,中和區,1269,420,126,546,60,606,1005,60.3%,41.79%,1
新北市,中和區,1270,536,155,691,63,754,1175,64.17%,45.62%,1
新北市,中和區,1271,500,133,633,57,690,1171,58.92%,42.7%,1
新北市,中和區,1272,646,178,824,32,856,1746,49.03%,37%,1
新北市,中和區,1273,564,166,730,46,776,1555,49.9%,36.27%,1
新北市,中和區,1274,451,123,574,56,630,1112,56.65%,40.56%,1
新北市,中和區,1275,781,212,993,56,1049,1780,58.93%,43.88%,1
新北市,中和區,1276,781,212,993,47,1040,1918,54.22%,40.72%,1
新北市,中和區,1277,575,151,726,42,768,1689,45.47%,34.04%,1
新北市,中和區,1278,769,189,958,39,997,1781,55.98%,43.18%,1
新北市,中和區,1279,555,180,735,56,791,1419,55.74%,39.11%,1
新北市,中和區,1280,515,165,680,42,722,1344,53.72%,38.32%,1
新北市,中和區,1281,826,242,1068,64,1132,1804,62.75%,45.79%,1
新北市,中和區,1282,639,237,876,81,957,1788,53.52%,35.74%,1
新北市,中和區,1283,700,207,907,73,980,1793,54.66%,39.04%,1
新北市,中和區,1284,560,151,711,71,782,1352,57.84%,41.42%,1
新北市,中和區,1285,795,168,963,62,1025,1813,56.54%,43.85%,1
新北市,中和區,1286,616,156,772,45,817,1288,63.43%,47.83%,1
新北市,中和區,1287,466,141,607,47,654,1186,55.14%,39.29%,1
新北市,中和區,1288,432,166,598,13,611,1237,49.39%,34.92%,1
新北市,中和區,1289,571,145,716,48,764,1406,54.34%,40.61%,1
新北市,中和區,1290,573,159,732,69,801,1442,55.55%,39.74%,1
新北市,中和區,1291,434,145,579,55,634,1040,60.96%,41.73%,1
新北市,中和區,1292,544,181,725,60,785,1292,60.76%,42.11%,1
新北市,中和區,1293,706,205,911,70,981,1811,54.17%,38.98%,1
新北市,中和區,1294,685,214,899,118,1017,1789,56.85%,38.29%,1
新北市,中和區,1295,400,77,477,43,520,859,60.54%,46.57%,1
新北市,中和區,1296,492,96,588,36,624,972,64.2%,50.62%,1
新北市,中和區,1297,531,163,694,71,765,1346,56.84%,39.45%,1
新北市,中和區,1298,423,132,555,48,603,1034,58.32%,40.91%,1
新北市,中和區,1299,584,154,738,56,794,1387,57.25%,42.11%,1
新北市,中和區,1300,836,231,1067,102,1169,2067,56.56%,40.45%,1
新北市,中和區,1301,552,185,737,68,805,1670,48.2%,33.05%,1
新北市,中和區,1302,454,137,591,67,658,1166,56.43%,38.94%,1
新北市,中和區,1303,406,124,530,45,575,963,59.71%,42.16%,1
新北市,中和區,1304,417,103,520,47,567,1070,52.99%,38.97%,1
新北市,中和區,1305,533,151,684,61,745,1319,56.48%,40.41%,1
新北市,中和區,1306,646,100,746,158,904,1438,62.87%,44.92%,1
新北市,中和區,1307,715,164,879,34,913,1808,50.5%,39.55%,1
新北市,中和區,1308,482,99,581,24,605,1191,50.8%,40.47%,1
新北市,中和區,1309,652,188,840,70,910,1632,55.76%,39.95%,1
新北市,中和區,1310,696,164,860,48,908,1765,51.44%,39.43%,1
新北市,中和區,1311,560,96,656,44,700,1168,59.93%,47.95%,1
新北市,中和區,1312,504,103,607,30,637,1176,54.17%,42.86%,1
新北市,中和區,1313,776,145,921,61,982,1565,62.75%,49.58%,1
新北市,中和區,1314,609,152,761,48,809,1578,51.27%,38.59%,1
新北市,中和區,1315,848,188,1036,38,1074,2029,52.93%,41.79%,1
新北市,中和區,1316,364,116,480,42,522,905,57.68%,40.22%,1
新北市,中和區,1317,313,83,396,46,442,839,52.68%,37.31%,1
新北市,中和區,1318,308,90,398,38,436,762,57.22%,40.42%,1
新北市,中和區,1319,573,152,725,76,801,1420,56.41%,40.35%,1
新北市,中和區,1320,492,139,631,64,695,1272,54.64%,38.68%,1
新北市,中和區,1321,776,190,966,70,1036,1976,52.43%,39.27%,1
新北市,中和區,1322,741,165,906,54,960,1779,53.96%,41.65%,1
新北市,中和區,1323,521,130,651,64,715,1454,49.17%,35.83%,1
新北市,中和區,1324,532,135,667,34,701,1374,51.02%,38.72%,1
新北市,中和區,1325,544,98,642,53,695,1369,50.77%,39.74%,1
新北市,中和區,1326,592,153,745,69,814,1501,54.23%,39.44%,1
新北市,中和區,1327,409,121,530,68,598,920,65%,44.46%,1
新北市,中和區,1328,449,134,583,65,648,1050,61.71%,42.76%,1
新北市,中和區,1329,138,39,177,21,198,321,61.68%,42.99%,1
新北市,中和區,1330,574,138,712,71,783,1474,53.12%,38.94%,1
新北市,中和區,1331,617,144,761,76,837,1461,57.29%,42.23%,1
新北市,中和區,1332,623,176,799,59,858,1621,52.93%,38.43%,1
新北市,中和區,1333,547,204,751,68,819,1327,61.72%,41.22%,1
新北市,中和區,1334,296,104,400,46,446,775,57.55%,38.19%,1
新北市,中和區,1335,705,210,915,48,963,1916,50.26%,36.8%,1
新北市,中和區,1336,719,186,905,83,988,1901,51.97%,37.82%,1
新北市,中和區,1337,542,169,711,39,750,4411,17%,12.29%,1
新北市,中和區,1338,495,144,639,25,664,1212,54.79%,40.84%,1
新北市,中和區,1339,467,140,607,44,651,1126,57.82%,41.47%,1
新北市,中和區,1340,591,151,742,33,775,1507,51.43%,39.22%,1
新北市,中和區,1341,645,150,795,24,819,1519,53.92%,42.46%,1
新北市,中和區,1342,617,184,801,45,846,1467,57.67%,42.06%,1
新北市,中和區,1343,632,166,798,84,882,1453,60.7%,43.5%,1
新北市,中和區,1344,613,153,766,64,830,1364,60.85%,44.94%,1
新北市,中和區,1345,560,112,672,57,729,1302,55.99%,43.01%,1
新北市,中和區,1346,562,131,693,50,743,1627,45.67%,34.54%,1
新北市,中和區,1347,332,177,509,45,554,1503,36.86%,22.09%,1
新北市,中和區,1348,531,149,680,34,714,1392,51.29%,38.15%,1
新北市,中和區,1349,472,120,592,42,634,1067,59.42%,44.24%,1
新北市,中和區,1350,622,184,806,55,861,1623,53.05%,38.32%,1
新北市,中和區,1351,530,140,670,37,707,1208,58.53%,43.87%,1
新北市,中和區,1352,645,184,829,55,884,1991,44.4%,32.4%,1
新北市,中和區,1353,700,141,841,59,900,1932,46.58%,36.23%,1
新北市,中和區,1354,467,111,578,45,623,947,65.79%,49.31%,1
新北市,中和區,1355,688,194,882,71,953,1660,57.41%,41.45%,1
新北市,中和區,1356,579,143,722,62,784,1574,49.81%,36.79%,1
新北市,中和區,1357,807,211,1018,73,1091,2136,51.08%,37.78%,1
新北市,中和區,1358,531,167,698,83,781,1462,53.42%,36.32%,1
新北市,中和區,1359,598,137,735,79,814,1548,52.58%,38.63%,1
新北市,中和區,1360,352,83,435,22,457,692,66.04%,50.87%,1
新北市,中和區,1361,583,119,702,63,765,1221,62.65%,47.75%,1
新北市,中和區,1362,543,183,726,64,790,1331,59.35%,40.8%,1
新北市,中和區,1363,446,108,554,50,604,984,61.38%,45.33%,1
新北市,中和區,1364,695,184,879,70,949,1871,50.72%,37.15%,1
新北市,中和區,1365,491,133,624,51,675,1279,52.78%,38.39%,1
新北市,中和區,1366,666,211,877,53,930,1629,57.09%,40.88%,1
新北市,中和區,1367,637,163,800,38,838,1482,56.55%,42.98%,1
新北市,中和區,1368,733,199,932,66,998,1715,58.19%,42.74%,1
新北市,中和區,1369,812,209,1021,74,1095,1952,56.1%,41.6%,1
新北市,中和區,1370,286,84,370,38,408,686,59.48%,41.69%,1
新北市,中和區,1371,521,191,712,36,748,1577,47.43%,33.04%,1
新北市,中和區,1372,502,130,632,38,670,1158,57.86%,43.35%,1
新北市,中和區,1373,572,142,714,20,734,1195,61.42%,47.87%,1
新北市,中和區,1374,498,137,635,37,672,1054,63.76%,47.25%,1
新北市,中和區,1375,280,85,365,26,391,612,63.89%,45.75%,1
新北市,中和區,1376,717,179,896,40,936,1668,56.12%,42.99%,1
新北市,中和區,1377,458,152,610,75,685,1071,63.96%,42.76%,1
新北市,中和區,1378,538,194,732,65,797,1169,68.18%,46.02%,1
新北市,中和區,1379,535,160,695,45,740,1370,54.01%,39.05%,1
新北市,中和區,1380,668,186,854,92,946,1574,60.1%,42.44%,1
新北市,中和區,1381,900,218,1118,37,1155,2614,44.19%,34.43%,1
新北市,中和區,1382,615,202,817,46,863,1477,58.43%,41.64%,1
新北市,中和區,1383,395,143,538,73,611,1041,58.69%,37.94%,1
新北市,中和區,1384,683,144,827,62,889,1538,57.8%,44.41%,1
新北市,中和區,1385,574,204,778,60,838,1599,52.41%,35.9%,1
新北市,中和區,1386,671,211,882,86,968,1586,61.03%,42.31%,1
新北市,中和區,1387,698,255,953,96,1049,1726,60.78%,40.44%,1
新北市,中和區,1388,805,244,1049,86,1135,1854,61.22%,43.42%,1
新北市,中和區,1389,631,209,840,64,904,1472,61.41%,42.87%,1
新北市,中和區,1390,607,189,796,71,867,1430,60.63%,42.45%,1
新北市,中和區,1391,656,182,838,55,893,1488,60.01%,44.09%,1
新北市,中和區,1392,482,151,633,42,675,1251,53.96%,38.53%,1
新北市,中和區,1393,611,194,805,59,864,1487,58.1%,41.09%,1
新北市,中和區,1394,476,166,642,100,742,1328,55.87%,35.84%,1
新北市,中和區,1395,511,130,641,55,696,1128,61.7%,45.3%,1
新北市,中和區,1396,491,128,619,40,659,1008,65.38%,48.71%,1
新北市,中和區,1397,734,243,977,41,1018,1786,57%,41.1%,1
新北市,中和區,1398,875,243,1118,71,1189,2219,53.58%,39.43%,1
新北市,中和區,1399,466,165,631,44,675,1322,51.06%,35.25%,1
新北市,中和區,1400,502,155,657,25,682,1495,45.62%,33.58%,1
新北市,中和區,1401,529,175,704,60,764,1414,54.03%,37.41%,1
新北市,中和區,1402,680,203,883,78,961,1681,57.17%,40.45%,1
新北市,中和區,1403,536,156,692,60,752,1361,55.25%,39.38%,1
新北市,中和區,1404,586,156,742,58,800,1442,55.48%,40.64%,1
新北市,中和區,1405,501,175,676,30,706,1383,51.05%,36.23%,1
新北市,中和區,1406,553,136,689,39,728,1264,57.59%,43.75%,1
新北市,中和區,1407,707,242,949,118,1067,1810,58.95%,39.06%,1
新北市,中和區,1408,670,223,893,52,945,1951,48.44%,34.34%,1
新北市,中和區,1409,598,121,719,52,771,1582,48.74%,37.8%,1
新北市,中和區,1410,825,225,1050,102,1152,1945,59.23%,42.42%,1
新北市,中和區,1411,605,134,739,59,798,1390,57.41%,43.53%,1
新北市,中和區,1412,475,154,629,21,650,1161,55.99%,40.91%,1
新北市,中和區,1413,674,91,765,36,801,1399,57.26%,48.18%,1
新北市,中和區,1414,399,146,545,33,578,1070,54.02%,37.29%,1
新北市,中和區,1415,460,130,590,29,619,1169,52.95%,39.35%,1
新北市,中和區,1416,567,129,696,69,765,1214,63.01%,46.71%,1
新北市,中和區,1417,607,152,759,65,824,1398,58.94%,43.42%,1
新北市,中和區,1418,439,126,565,38,603,1049,57.48%,41.85%,1
新北市,中和區,1419,470,287,757,47,804,1324,60.73%,35.5%,1
新北市,中和區,1420,611,166,777,37,814,1765,46.12%,34.62%,1
新北市,中和區,1421,627,187,814,61,875,1709,51.2%,36.69%,1
新北市,中和區,1422,480,142,622,73,695,1186,58.6%,40.47%,1
新北市,中和區,1423,553,165,718,54,772,1318,58.57%,41.96%,1
新北市,中和區,1424,595,194,789,50,839,1430,58.67%,41.61%,1
新北市,中和區,1425,514,153,667,61,728,1637,44.47%,31.4%,1
新北市,中和區,1426,487,170,657,61,718,1283,55.96%,37.96%,1
新北市,中和區,1427,492,188,680,57,737,1310,56.26%,37.56%,1
新北市,中和區,1428,556,155,711,58,769,1301,59.11%,42.74%,1
新北市,中和區,1429,672,221,893,71,964,1681,57.35%,39.98%,1
新北市,中和區,1430,556,172,728,48,776,1384,56.07%,40.17%,1
新北市,中和區,1431,469,152,621,65,686,1187,57.79%,39.51%,1
新北市,中和區,1432,589,182,771,8,779,1779,43.79%,33.11%,1
新北市,中和區,1433,742,171,913,57,970,1712,56.66%,43.34%,1
新北市,中和區,1434,570,178,748,44,792,1462,54.17%,38.99%,1
新北市,中和區,1435,734,186,920,49,969,1824,53.13%,40.24%,1
新北市,中和區,1436,530,182,712,66,778,1389,56.01%,38.16%,1
新北市,中和區,1437,628,162,790,49,839,1434,58.51%,43.79%,1
新北市,中和區,1438,795,171,966,70,1036,1953,53.05%,40.71%,1
新北市,中和區,1439,779,248,1027,83,1110,2002,55.44%,38.91%,1
新北市,中和區,1440,764,152,916,44,960,1858,51.67%,41.12%,1
新北市,中和區,1441,737,173,910,38,948,1801,52.64%,40.92%,1
新北市,中和區,1442,722,178,900,73,973,1691,57.54%,42.7%,1
新北市,中和區,1443,597,154,751,52,803,1363,58.91%,43.8%,1
新北市,中和區,1444,579,131,710,39,749,1220,61.39%,47.46%,1
新北市,中和區,1445,649,153,802,35,837,1365,61.32%,47.55%,1
新北市,中和區,1446,606,28,634,32,666,1178,56.54%,51.44%,1
新北市,中和區,1447,359,109,468,36,504,830,60.72%,43.25%,1
新北市,中和區,1448,454,133,587,56,643,1197,53.72%,37.93%,1
新北市,中和區,1449,571,177,748,52,800,1369,58.44%,41.71%,1
新北市,中和區,1450,574,167,741,52,793,1336,59.36%,42.96%,1
新北市,中和區,1451,651,150,801,58,859,1377,62.38%,47.28%,1
新北市,中和區,1452,634,184,818,63,881,1499,58.77%,42.29%,1
新北市,中和區,1453,732,181,913,54,967,1689,57.25%,43.34%,1
新北市,中和區,1454,561,170,731,61,792,1323,59.86%,42.4%,1
新北市,中和區,1455,483,138,621,54,675,1079,62.56%,44.76%,1
新北市,中和區,1456,634,203,837,68,905,1545,58.58%,41.04%,1
新北市,中和區,1457,506,162,668,65,733,1326,55.28%,38.16%,1
新北市,中和區,1458,580,156,736,41,777,1443,53.85%,40.19%,1
新北市,中和區,1459,735,161,896,36,932,1712,54.44%,42.93%,1
新北市,中和區,1460,785,192,977,66,1043,1916,54.44%,40.97%,1
新北市,中和區,1461,383,119,502,39,541,863,62.69%,44.38%,1
新北市,中和區,1462,582,144,726,11,737,1203,61.26%,48.38%,1
新北市,中和區,1463,632,150,782,19,801,1483,54.01%,42.62%,1
新北市,中和區,1464,663,140,803,36,839,1575,53.27%,42.1%,1
新北市,中和區,1465,530,133,663,61,724,1432,50.56%,37.01%,1
新北市,中和區,1466,595,150,745,63,808,1441,56.07%,41.29%,1
新北市,中和區,1467,549,152,701,55,756,1269,59.57%,43.26%,1
新北市,中和區,1468,630,144,774,34,808,1363,59.28%,46.22%,1
新北市,中和區,1469,496,89,585,38,623,1089,57.21%,45.55%,1
新北市,中和區,1470,434,146,580,28,608,1171,51.92%,37.06%,1
新北市,中和區,1471,489,108,597,46,643,1150,55.91%,42.52%,1
新北市,中和區,1472,562,122,684,29,713,1154,61.79%,48.7%,1
新北市,中和區,1473,506,114,620,41,661,1067,61.95%,47.42%,1
新北市,中和區,1474,617,163,780,44,824,1526,54%,40.43%,1
新北市,中和區,1475,629,159,788,54,842,1447,58.19%,43.47%,1
新北市,永和區,1476,632,203,835,83,918,1554,59.07%,40.67%,1
新北市,永和區,1477,466,108,574,22,596,1065,55.96%,43.76%,1
新北市,永和區,1478,395,99,494,50,544,854,63.7%,46.25%,1
新北市,永和區,1479,547,148,695,66,761,1253,60.73%,43.66%,1
新北市,永和區,1480,716,197,913,44,957,1733,55.22%,41.32%,1
新北市,永和區,1481,646,188,834,59,893,1581,56.48%,40.86%,1
新北市,永和區,1482,705,179,884,60,944,1735,54.41%,40.63%,1
新北市,永和區,1483,663,141,804,28,832,1563,53.23%,42.42%,1
新北市,永和區,1484,708,209,917,62,979,1650,59.33%,42.91%,1
新北市,永和區,1485,655,123,778,47,825,1454,56.74%,45.05%,1
新北市,永和區,1486,582,172,754,62,816,1568,52.04%,37.12%,1
新北市,永和區,1487,556,158,714,53,767,1444,53.12%,38.5%,1
新北市,永和區,1488,425,153,578,45,623,1140,54.65%,37.28%,1
新北市,永和區,1489,532,151,683,54,737,1188,62.04%,44.78%,1
新北市,永和區,1490,601,190,791,61,852,1516,56.2%,39.64%,1
新北市,永和區,1491,580,135,715,65,780,1397,55.83%,41.52%,1
新北市,永和區,1492,606,135,741,50,791,1438,55.01%,42.14%,1
新北市,永和區,1493,477,124,601,49,650,1084,59.96%,44%,1
新北市,永和區,1494,397,116,513,31,544,941,57.81%,42.19%,1
新北市,永和區,1495,676,141,817,49,866,1598,54.19%,42.3%,1
新北市,永和區,1496,591,194,785,38,823,2842,28.96%,20.8%,1
新北市,永和區,1497,551,180,731,57,788,1261,62.49%,43.7%,1
新北市,永和區,1498,677,194,871,55,926,1449,63.91%,46.72%,1
新北市,永和區,1499,657,183,840,50,890,1511,58.9%,43.48%,1
新北市,永和區,1500,682,168,850,64,914,1470,62.18%,46.39%,1
新北市,永和區,1501,701,177,878,43,921,1580,58.29%,44.37%,1
新北市,永和區,1502,679,169,848,59,907,1438,63.07%,47.22%,1
新北市,永和區,1503,628,143,771,36,807,1305,61.84%,48.12%,1
新北市,永和區,1504,492,117,609,27,636,1046,60.8%,47.04%,1
新北市,永和區,1505,675,181,856,27,883,1566,56.39%,43.1%,1
新北市,永和區,1506,611,203,814,43,857,1468,58.38%,41.62%,1
新北市,永和區,1507,623,182,805,48,853,1305,65.36%,47.74%,1
新北市,永和區,1508,521,143,664,41,705,1181,59.7%,44.12%,1
新北市,永和區,1509,684,184,868,66,934,1720,54.3%,39.77%,1
新北市,永和區,1510,483,166,649,34,683,1103,61.92%,43.79%,1
新北市,永和區,1511,697,173,870,100,970,1649,58.82%,42.27%,1
新北市,永和區,1512,527,178,705,41,746,1206,61.86%,43.7%,1
新北市,永和區,1513,653,195,848,55,903,1506,59.96%,43.36%,1
新北市,永和區,1514,609,182,791,65,856,1488,57.53%,40.93%,1
新北市,永和區,1515,570,160,730,66,796,1288,61.8%,44.25%,1
新北市,永和區,1516,545,138,683,45,728,1413,51.52%,38.57%,1
新北市,永和區,1517,567,143,710,62,772,1329,58.09%,42.66%,1
新北市,永和區,1518,673,171,844,44,888,1436,61.84%,46.87%,1
新北市,永和區,1519,468,144,612,53,665,1112,59.8%,42.09%,1
新北市,永和區,1520,564,129,693,49,742,1100,67.45%,51.27%,1
新北市,永和區,1521,719,184,903,57,960,1545,62.14%,46.54%,1
新北市,永和區,1522,622,157,779,24,803,1436,55.92%,43.31%,1
新北市,永和區,1523,797,197,994,83,1077,1731,62.22%,46.04%,1
新北市,永和區,1524,774,234,1008,86,1094,1762,62.09%,43.93%,1
新北市,永和區,1525,531,167,698,46,744,1320,56.36%,40.23%,1
新北市,永和區,1526,453,147,600,18,618,1297,47.65%,34.93%,1
新北市,永和區,1527,714,206,920,83,1003,1798,55.78%,39.71%,1
新北市,永和區,1528,619,206,825,77,902,1491,60.5%,41.52%,1
新北市,永和區,1529,561,115,676,24,700,1223,57.24%,45.87%,1
新北市,永和區,1530,464,143,607,60,667,1108,60.2%,41.88%,1
新北市,永和區,1531,606,185,791,69,860,1408,61.08%,43.04%,1
新北市,永和區,1532,548,170,718,54,772,1265,61.03%,43.32%,1
新北市,永和區,1533,460,120,580,26,606,1115,54.35%,41.26%,1
新北市,永和區,1534,506,151,657,70,727,1133,64.17%,44.66%,1
新北市,永和區,1535,512,152,664,64,728,1217,59.82%,42.07%,1
新北市,永和區,1536,658,227,885,66,951,1713,55.52%,38.41%,1
新北市,永和區,1537,700,178,878,61,939,1721,54.56%,40.67%,1
新北市,永和區,1538,510,168,678,72,750,1327,56.52%,38.43%,1
新北市,永和區,1539,588,148,736,40,776,1257,61.73%,46.78%,1
新北市,永和區,1540,650,144,794,57,851,1348,63.13%,48.22%,1
新北市,永和區,1541,709,166,875,50,925,1461,63.31%,48.53%,1
新北市,永和區,1542,597,149,746,68,814,1368,59.5%,43.64%,1
新北市,永和區,1543,513,130,643,73,716,1234,58.02%,41.57%,1
新北市,永和區,1544,559,140,699,63,762,1303,58.48%,42.9%,1
新北市,永和區,1545,645,145,790,26,816,1516,53.83%,42.55%,1
新北市,永和區,1546,622,168,790,77,867,1422,60.97%,43.74%,1
新北市,永和區,1547,454,128,582,34,616,991,62.16%,45.81%,1
新北市,永和區,1548,478,120,598,43,641,1016,63.09%,47.05%,1
新北市,永和區,1549,498,134,632,60,692,1146,60.38%,43.46%,1
新北市,永和區,1550,474,116,590,29,619,1043,59.35%,45.45%,1
新北市,永和區,1551,563,129,692,26,718,1210,59.34%,46.53%,1
新北市,永和區,1552,708,175,883,40,923,1630,56.63%,43.44%,1
新北市,永和區,1553,510,121,631,27,658,1092,60.26%,46.7%,1
新北市,永和區,1554,798,235,1033,57,1090,1872,58.23%,42.63%,1
新北市,永和區,1555,817,132,949,41,990,1781,55.59%,45.87%,1
新北市,永和區,1556,445,154,599,45,644,1049,61.39%,42.42%,1
新北市,永和區,1557,582,82,664,38,702,1285,54.63%,45.29%,1
新北市,永和區,1558,541,158,699,37,736,1209,60.88%,44.75%,1
新北市,永和區,1559,515,161,676,31,707,1132,62.46%,45.49%,1
新北市,永和區,1560,569,184,753,56,809,1287,62.86%,44.21%,1
新北市,永和區,1561,469,144,613,58,671,1068,62.83%,43.91%,1
新北市,永和區,1562,487,151,638,60,698,1098,63.57%,44.35%,1
新北市,永和區,1563,559,145,704,54,758,1222,62.03%,45.74%,1
新北市,永和區,1564,503,137,640,69,709,1157,61.28%,43.47%,1
新北市,永和區,1565,546,169,715,53,768,1168,65.75%,46.75%,1
新北市,永和區,1566,511,166,677,71,748,1283,58.3%,39.83%,1
新北市,永和區,1567,573,174,747,53,800,1372,58.31%,41.76%,1
新北市,永和區,1568,851,171,1022,56,1078,1876,57.46%,45.36%,1
新北市,永和區,1569,717,202,919,80,999,1576,63.39%,45.49%,1
新北市,永和區,1570,720,218,938,58,996,1661,59.96%,43.35%,1
新北市,永和區,1571,766,209,975,35,1010,1808,55.86%,42.37%,1
新北市,永和區,1572,801,227,1028,51,1079,1898,56.85%,42.2%,1
新北市,永和區,1573,657,204,861,63,924,1508,61.27%,43.57%,1
新北市,永和區,1574,589,162,751,69,820,1341,61.15%,43.92%,1
新北市,永和區,1575,603,177,780,53,833,1422,58.58%,42.41%,1
新北市,永和區,1576,530,123,653,32,685,1177,58.2%,45.03%,1
新北市,永和區,1577,644,199,843,76,919,1557,59.02%,41.36%,1
新北市,永和區,1578,581,200,781,47,828,1491,55.53%,38.97%,1
新北市,永和區,1579,651,193,844,56,900,1586,56.75%,41.05%,1
新北市,永和區,1580,528,150,678,21,699,1313,53.24%,40.21%,1
新北市,永和區,1581,660,195,855,78,933,1636,57.03%,40.34%,1
新北市,永和區,1582,652,198,850,66,916,1598,57.32%,40.8%,1
新北市,永和區,1583,723,192,915,57,972,1609,60.41%,44.93%,1
新北市,永和區,1584,609,195,804,47,851,1375,61.89%,44.29%,1
新北市,永和區,1585,783,189,972,65,1037,1648,62.92%,47.51%,1
新北市,永和區,1586,464,142,606,42,648,1077,60.17%,43.08%,1
新北市,永和區,1587,504,161,665,38,703,1157,60.76%,43.56%,1
新北市,永和區,1588,628,182,810,43,853,1339,63.7%,46.9%,1
新北市,永和區,1589,620,158,778,18,796,1306,60.95%,47.47%,1
新北市,永和區,1590,611,145,756,27,783,1236,63.35%,49.43%,1
新北市,永和區,1591,534,133,667,36,703,1133,62.05%,47.13%,1
新北市,永和區,1592,675,139,814,50,864,1425,60.63%,47.37%,1
新北市,永和區,1593,794,228,1022,92,1114,1938,57.48%,40.97%,1
新北市,永和區,1594,680,207,887,69,956,1607,59.49%,42.31%,1
新北市,永和區,1595,391,94,485,40,525,853,61.55%,45.84%,1
新北市,永和區,1596,303,74,377,49,426,768,55.47%,39.45%,1
新北市,永和區,1597,302,69,371,29,400,893,44.79%,33.82%,1
新北市,永和區,1598,327,72,399,37,436,743,58.68%,44.01%,1
新北市,永和區,1599,466,146,612,50,662,1155,57.32%,40.35%,1
新北市,永和區,1600,585,143,728,51,779,1263,61.68%,46.32%,1
新北市,永和區,1601,566,124,690,38,728,1189,61.23%,47.6%,1
新北市,永和區,1602,539,151,690,44,734,1346,54.53%,40.04%,1
新北市,永和區,1603,564,157,721,52,773,1368,56.51%,41.23%,1
新北市,永和區,1604,453,136,589,27,616,1043,59.06%,43.43%,1
新北市,永和區,1605,722,240,962,56,1018,1709,59.57%,42.25%,1
新北市,永和區,1606,367,91,458,21,479,879,54.49%,41.75%,1
新北市,永和區,1607,371,128,499,43,542,904,59.96%,41.04%,1
新北市,永和區,1608,558,154,712,58,770,1221,63.06%,45.7%,1
新北市,永和區,1609,437,140,577,56,633,1018,62.18%,42.93%,1
新北市,永和區,1610,654,166,820,41,861,1551,55.51%,42.17%,1
新北市,永和區,1611,628,174,802,59,861,1428,60.29%,43.98%,1
新北市,永和區,1612,458,123,581,63,644,1044,61.69%,43.87%,1
新北市,永和區,1613,433,112,545,57,602,967,62.25%,44.78%,1
新北市,新莊區,0302,411,168,579,81,660,1123,58.77%,36.6%,1
新北市,新莊區,0303,506,195,701,78,779,1278,60.95%,39.59%,1
新北市,新莊區,0304,512,158,670,68,738,1163,63.46%,44.02%,1
新北市,新莊區,0305,488,209,697,57,754,1228,61.4%,39.74%,1
新北市,新莊區,0306,454,188,642,65,707,1211,58.38%,37.49%,1
新北市,新莊區,0307,439,200,639,61,700,1176,59.52%,37.33%,1
新北市,新莊區,0308,646,225,871,56,927,1536,60.35%,42.06%,1
新北市,新莊區,0309,812,85,897,73,970,1486,65.28%,54.64%,1
新北市,新莊區,0310,662,237,899,73,972,1513,64.24%,43.75%,1
新北市,新莊區,0311,568,233,801,88,889,1395,63.73%,40.72%,1
新北市,新莊區,0312,512,167,679,89,768,1353,56.76%,37.84%,1
新北市,新莊區,0313,588,209,797,76,873,1409,61.96%,41.73%,1
新北市,新莊區,0314,601,161,762,35,797,1478,53.92%,40.66%,1
新北市,新莊區,0315,366,147,513,62,575,921,62.43%,39.74%,1
新北市,新莊區,0316,399,163,562,48,610,971,62.82%,41.09%,1
新北市,新莊區,0317,678,211,889,75,964,1534,62.84%,44.2%,1
新北市,新莊區,0318,586,191,777,55,832,1516,54.88%,38.65%,1
新北市,新莊區,0319,271,94,365,45,410,697,58.82%,38.88%,1
新北市,新莊區,0320,532,127,659,40,699,1235,56.6%,43.08%,1
新北市,新莊區,0321,438,157,595,51,646,1138,56.77%,38.49%,1
新北市,新莊區,0322,379,138,517,31,548,1063,51.55%,35.65%,1
新北市,新莊區,0323,556,218,774,67,841,3399,24.74%,16.36%,1
新北市,新莊區,0324,643,213,856,78,934,1575,59.3%,40.83%,1
新北市,新莊區,0325,690,244,934,82,1016,1615,62.91%,42.72%,1
新北市,新莊區,0326,548,224,772,80,852,1612,52.85%,34%,1
新北市,新莊區,0327,527,213,740,84,824,1514,54.43%,34.81%,1
新北市,新莊區,0328,474,169,643,36,679,1382,49.13%,34.3%,1
新北市,新莊區,0329,610,189,799,60,859,1475,58.24%,41.36%,1
新北市,新莊區,0330,609,182,791,31,822,1462,56.22%,41.66%,1
新北市,新莊區,0331,597,145,742,46,788,1426,55.26%,41.87%,1
新北市,新莊區,0332,521,201,722,68,790,1421,55.59%,36.66%,1
新北市,新莊區,0333,609,184,793,63,856,1536,55.73%,39.65%,1
新北市,新莊區,0334,671,189,860,60,920,1587,57.97%,42.28%,1
新北市,新莊區,0335,281,90,371,21,392,749,52.34%,37.52%,1
新北市,新莊區,0336,574,150,724,55,779,1276,61.05%,44.98%,1
新北市,新莊區,0337,505,164,669,39,708,1303,54.34%,38.76%,1
新北市,新莊區,0338,520,167,687,76,763,1259,60.6%,41.3%,1
新北市,新莊區,0339,560,156,716,59,775,1291,60.03%,43.38%,1
新北市,新莊區,0340,637,175,812,36,848,1493,56.8%,42.67%,1
新北市,新莊區,0341,614,200,814,62,876,1507,58.13%,40.74%,1
新北市,新莊區,0342,592,163,755,24,779,1456,53.5%,40.66%,1
新北市,新莊區,0343,579,168,747,32,779,1396,55.8%,41.48%,1
新北市,新莊區,0344,456,162,618,62,680,1351,50.33%,33.75%,1
新北市,新莊區,0345,574,172,746,66,812,1403,57.88%,40.91%,1
新北市,新莊區,0346,561,198,759,73,832,1497,55.58%,37.47%,1
新北市,新莊區,0347,507,174,681,91,772,1272,60.69%,39.86%,1
新北市,新莊區,0348,442,132,574,46,620,1269,48.86%,34.83%,1
新北市,新莊區,0349,519,191,710,78,788,1335,59.03%,38.88%,1
新北市,新莊區,0350,569,176,745,49,794,1300,61.08%,43.77%,1
新北市,新莊區,0351,575,153,728,51,779,1286,60.58%,44.71%,1
新北市,新莊區,0352,586,180,766,59,825,1255,65.74%,46.69%,1
新北市,新莊區,0353,635,205,840,99,939,1558,60.27%,40.76%,1
新北市,新莊區,0354,503,171,674,84,758,1567,48.37%,32.1%,1
新北市,新莊區,0355,625,228,853,85,938,1603,58.52%,38.99%,1
新北市,新莊區,0356,607,203,810,43,853,1538,55.46%,39.47%,1
新北市,新莊區,0357,626,228,854,57,911,1671,54.52%,37.46%,1
新北市,新莊區,0358,603,217,820,54,874,1698,51.47%,35.51%,1
新北市,新莊區,0359,672,207,879,58,937,1545,60.65%,43.5%,1
新北市,新莊區,0360,676,215,891,135,1026,1696,60.5%,39.86%,1
新北市,新莊區,0361,603,194,797,103,900,1626,55.35%,37.08%,1
新北市,新莊區,0362,151,394,545,87,632,1170,54.02%,12.91%,1
新北市,新莊區,0363,454,151,605,114,719,1236,58.17%,36.73%,1
新北市,新莊區,0364,389,130,519,75,594,1071,55.46%,36.32%,1
新北市,新莊區,0365,407,182,589,57,646,1129,57.22%,36.05%,1
新北市,新莊區,0366,624,234,858,58,916,1586,57.76%,39.34%,1
新北市,新莊區,0367,556,200,756,73,829,1597,51.91%,34.82%,1
新北市,新莊區,0368,498,192,690,123,813,1573,51.68%,31.66%,1
新北市,新莊區,0369,435,143,578,55,633,1225,51.67%,35.51%,1
新北市,新莊區,0370,437,139,576,39,615,1217,50.53%,35.91%,1
新北市,新莊區,0371,578,202,780,89,869,1571,55.32%,36.79%,1
新北市,新莊區,0372,596,189,785,77,862,1594,54.08%,37.39%,1
新北市,新莊區,0373,584,207,791,69,860,1583,54.33%,36.89%,1
新北市,新莊區,0374,532,155,687,65,752,1245,60.4%,42.73%,1
新北市,新莊區,0375,452,169,621,53,674,1203,56.03%,37.57%,1
新北市,新莊區,0376,559,169,728,66,794,1265,62.77%,44.19%,1
新北市,新莊區,0377,510,165,675,75,750,1255,59.76%,40.64%,1
新北市,新莊區,0378,519,180,699,52,751,1287,58.35%,40.33%,1
新北市,新莊區,0379,444,204,648,82,730,1167,62.55%,38.05%,1
新北市,新莊區,0380,476,164,640,79,719,1299,55.35%,36.64%,1
新北市,新莊區,0381,486,153,639,59,698,1207,57.83%,40.27%,1
新北市,新莊區,0382,583,179,762,64,826,1415,58.37%,41.2%,1
新北市,新莊區,0383,503,197,700,81,781,1342,58.2%,37.48%,1
新北市,新莊區,0384,500,186,686,94,780,1341,58.17%,37.29%,1
新北市,新莊區,0385,471,166,637,80,717,1247,57.5%,37.77%,1
新北市,新莊區,0386,512,92,604,34,638,984,64.84%,52.03%,1
新北市,新莊區,0387,452,134,586,55,641,1043,61.46%,43.34%,1
新北市,新莊區,0388,526,186,712,47,759,1135,66.87%,46.34%,1
新北市,新莊區,0389,476,152,628,57,685,1185,57.81%,40.17%,1
新北市,新莊區,0390,549,170,719,55,774,1346,57.5%,40.79%,1
新北市,新莊區,0391,524,210,734,84,818,1372,59.62%,38.19%,1
新北市,新莊區,0392,565,178,743,83,826,1350,61.19%,41.85%,1
新北市,新莊區,0393,481,162,643,89,732,1307,56.01%,36.8%,1
新北市,新莊區,0394,498,176,674,101,775,1353,57.28%,36.81%,1
新北市,新莊區,0395,504,185,689,89,778,1287,60.45%,39.16%,1
新北市,新莊區,0396,508,149,657,36,693,1567,44.22%,32.42%,1
新北市,新莊區,0397,715,207,922,97,1019,1709,59.63%,41.84%,1
新北市,新莊區,0398,585,158,743,44,787,1616,48.7%,36.2%,1
新北市,新莊區,0399,547,184,731,80,811,1628,49.82%,33.6%,1
新北市,新莊區,0400,459,164,623,80,703,1148,61.24%,39.98%,1
新北市,新莊區,0401,458,172,630,10,640,1201,53.29%,38.13%,1
新北市,新莊區,0402,484,179,663,63,726,1135,63.96%,42.64%,1
新北市,新莊區,0403,643,226,869,70,939,1495,62.81%,43.01%,1
新北市,新莊區,0404,582,210,792,81,873,1486,58.75%,39.17%,1
新北市,新莊區,0405,672,179,851,54,905,1483,61.02%,45.31%,1
新北市,新莊區,0406,634,160,794,57,851,1553,54.8%,40.82%,1
新北市,新莊區,0407,752,211,963,43,1006,1625,61.91%,46.28%,1
新北市,新莊區,0408,696,192,888,35,923,1671,55.24%,41.65%,1
新北市,新莊區,0409,613,81,694,74,768,1389,55.29%,44.13%,1
新北市,新莊區,0410,522,159,681,46,727,1272,57.15%,41.04%,1
新北市,新莊區,0411,648,174,822,53,875,1409,62.1%,45.99%,1
新北市,新莊區,0412,535,225,760,56,816,1372,59.48%,38.99%,1
新北市,新莊區,0413,358,133,491,67,558,955,58.43%,37.49%,1
新北市,新莊區,0414,335,122,457,81,538,952,56.51%,35.19%,1
新北市,新莊區,0415,541,202,743,44,787,1412,55.74%,38.31%,1
新北市,新莊區,0416,536,213,749,73,822,1415,58.09%,37.88%,1
新北市,新莊區,0417,581,192,773,80,853,1421,60.03%,40.89%,1
新北市,新莊區,0418,555,191,746,63,809,1293,62.57%,42.92%,1
新北市,新莊區,0419,526,185,711,25,736,1475,49.9%,35.66%,1
新北市,新莊區,0420,567,168,735,81,816,1429,57.1%,39.68%,1
新北市,新莊區,0421,593,186,779,64,843,1481,56.92%,40.04%,1
新北市,新莊區,0422,524,175,699,93,792,1472,53.8%,35.6%,1
新北市,新莊區,0423,620,190,810,49,859,1474,58.28%,42.06%,1
新北市,新莊區,0424,677,185,862,27,889,1462,60.81%,46.31%,1
新北市,新莊區,0425,637,204,841,42,883,1484,59.5%,42.92%,1
新北市,新莊區,0426,607,174,781,55,836,1461,57.22%,41.55%,1
新北市,新莊區,0427,603,193,796,36,832,1444,57.62%,41.76%,1
新北市,新莊區,0428,622,190,812,30,842,1437,58.59%,43.28%,1
新北市,新莊區,0429,601,187,788,45,833,1641,50.76%,36.62%,1
新北市,新莊區,0430,596,201,797,42,839,1633,51.38%,36.5%,1
新北市,新莊區,0431,631,201,832,26,858,1531,56.04%,41.21%,1
新北市,新莊區,0432,646,198,844,61,905,1517,59.66%,42.58%,1
新北市,新莊區,0433,585,187,772,50,822,1487,55.28%,39.34%,1
新北市,新莊區,0434,647,182,829,56,885,1560,56.73%,41.47%,1
新北市,新莊區,0435,591,218,809,80,889,1584,56.12%,37.31%,1
新北市,新莊區,0436,633,189,822,41,863,1602,53.87%,39.51%,1
新北市,新莊區,0437,298,118,416,66,482,818,58.92%,36.43%,1
新北市,新莊區,0438,526,178,704,72,776,1633,47.52%,32.21%,1
新北市,新莊區,0439,592,211,803,78,881,1652,53.33%,35.84%,1
新北市,新莊區,0440,178,571,749,79,828,1498,55.27%,11.88%,1
新北市,新莊區,0441,514,180,694,48,742,1379,53.81%,37.27%,1
新北市,新莊區,0442,572,171,743,58,801,1381,58%,41.42%,1
新北市,新莊區,0443,623,190,813,84,897,1535,58.44%,40.59%,1
新北市,新莊區,0444,662,212,874,71,945,1492,63.34%,44.37%,1
新北市,新莊區,0445,639,179,818,93,911,1450,62.83%,44.07%,1
新北市,新莊區,0446,457,135,592,64,656,1107,59.26%,41.28%,1
新北市,新莊區,0447,464,152,616,64,680,1063,63.97%,43.65%,1
新北市,新莊區,0448,433,170,603,64,667,1143,58.36%,37.88%,1
新北市,新莊區,0449,492,157,649,120,769,1341,57.35%,36.69%,1
新北市,新莊區,0450,442,138,580,46,626,1063,58.89%,41.58%,1
新北市,新莊區,0451,430,166,596,60,656,1096,59.85%,39.23%,1
新北市,新莊區,0452,526,170,696,52,748,1309,57.14%,40.18%,1
新北市,新莊區,0453,475,191,666,59,725,1216,59.62%,39.06%,1
新北市,新莊區,0454,468,157,625,61,686,1278,53.68%,36.62%,1
新北市,新莊區,0455,492,205,697,78,775,1352,57.32%,36.39%,1
新北市,新莊區,0456,445,171,616,61,677,1298,52.16%,34.28%,1
新北市,新莊區,0457,402,152,554,55,609,1042,58.45%,38.58%,1
新北市,新莊區,0458,330,109,439,27,466,881,52.89%,37.46%,1
新北市,新莊區,0459,473,188,661,54,715,1109,64.47%,42.65%,1
新北市,新莊區,0460,492,166,658,58,716,1291,55.46%,38.11%,1
新北市,新莊區,0461,507,139,646,34,680,1293,52.59%,39.21%,1
新北市,新莊區,0462,519,197,716,71,787,1336,58.91%,38.85%,1
新北市,新莊區,0463,536,151,687,54,741,1384,53.54%,38.73%,1
新北市,新莊區,0464,476,109,585,24,609,1231,49.47%,38.67%,1
新北市,新莊區,0465,385,111,496,35,531,940,56.49%,40.96%,1
新北市,新莊區,0466,486,177,663,102,765,1369,55.88%,35.5%,1
新北市,新莊區,0467,506,188,694,77,771,1384,55.71%,36.56%,1
新北市,新莊區,0468,491,164,655,83,738,1272,58.02%,38.6%,1
新北市,新莊區,0469,467,117,584,51,635,1073,59.18%,43.52%,1
新北市,新莊區,0470,424,136,560,38,598,1058,56.52%,40.08%,1
新北市,新莊區,0471,630,172,802,25,827,1528,54.12%,41.23%,1
新北市,新莊區,0472,504,118,622,57,679,1244,54.58%,40.51%,1
新北市,新莊區,0473,518,147,665,60,725,1356,53.47%,38.2%,1
新北市,新莊區,0474,470,105,575,36,611,1164,52.49%,40.38%,1
新北市,新莊區,0475,592,166,758,82,840,1423,59.03%,41.6%,1
新北市,新莊區,0476,553,178,731,43,774,1250,61.92%,44.24%,1
新北市,新莊區,0477,485,162,647,38,685,1252,54.71%,38.74%,1
新北市,新莊區,0478,396,122,518,34,552,1022,54.01%,38.75%,1
新北市,新莊區,0479,375,145,520,44,564,959,58.81%,39.1%,1
新北市,新莊區,0480,669,225,894,56,950,1646,57.72%,40.64%,1
新北市,新莊區,0481,580,192,772,74,846,1551,54.55%,37.4%,1
新北市,新莊區,0482,622,217,839,66,905,1526,59.31%,40.76%,1
新北市,新莊區,0483,616,186,802,50,852,1518,56.13%,40.58%,1
新北市,新莊區,0484,663,186,849,54,903,1547,58.37%,42.86%,1
新北市,新莊區,0485,540,191,731,94,825,1505,54.82%,35.88%,1
新北市,新莊區,0486,532,202,734,88,822,1527,53.83%,34.84%,1
新北市,新莊區,0487,530,186,716,64,780,1482,52.63%,35.76%,1
新北市,新莊區,0488,566,168,734,86,820,1586,51.7%,35.69%,1
新北市,新莊區,0489,392,138,530,91,621,1065,58.31%,36.81%,1
新北市,新莊區,0490,485,135,620,54,674,1040,64.81%,46.63%,1
新北市,新莊區,0491,403,143,546,63,609,1090,55.87%,36.97%,1
新北市,新莊區,0492,414,137,551,69,620,1071,57.89%,38.66%,1
新北市,新莊區,0493,595,208,803,35,838,1704,49.18%,34.92%,1
新北市,新莊區,0494,612,179,791,48,839,1698,49.41%,36.04%,1
新北市,新莊區,0495,590,193,783,61,844,1362,61.97%,43.32%,1
新北市,新莊區,0496,559,179,738,41,779,1350,57.7%,41.41%,1
新北市,新莊區,0497,658,218,876,85,961,1689,56.9%,38.96%,1
新北市,新莊區,0498,649,186,835,100,935,1612,58%,40.26%,1
新北市,新莊區,0499,474,145,619,61,680,1130,60.18%,41.95%,1
新北市,新莊區,0500,462,156,618,74,692,1111,62.29%,41.58%,1
新北市,新莊區,0501,581,200,781,47,828,1539,53.8%,37.75%,1
新北市,新莊區,0502,604,233,837,47,884,1586,55.74%,38.08%,1
新北市,新莊區,0503,647,210,857,78,935,1631,57.33%,39.67%,1
新北市,新莊區,0504,598,197,795,60,855,1540,55.52%,38.83%,1
新北市,新莊區,0505,448,186,634,64,698,1388,50.29%,32.28%,1
新北市,新莊區,0506,467,158,625,90,715,1388,51.51%,33.65%,1
新北市,新莊區,0507,459,160,619,73,692,1387,49.89%,33.09%,1
新北市,新莊區,0508,431,148,579,51,630,1181,53.34%,36.49%,1
新北市,新莊區,0509,416,175,591,70,661,1135,58.24%,36.65%,1
新北市,新莊區,0510,447,199,646,60,706,1173,60.19%,38.11%,1
新北市,新莊區,0511,511,148,659,47,706,1215,58.11%,42.06%,1
新北市,新莊區,0512,706,97,803,56,859,1488,57.73%,47.45%,1
新北市,新莊區,0513,575,190,765,57,822,1444,56.93%,39.82%,1
新北市,新莊區,0514,514,266,780,49,829,1499,55.3%,34.29%,1
新北市,新莊區,0515,552,213,765,28,793,1449,54.73%,38.1%,1
新北市,新莊區,0516,660,184,844,82,926,1640,56.46%,40.24%,1
新北市,新莊區,0517,608,206,814,89,903,1648,54.79%,36.89%,1
新北市,新莊區,0518,494,169,663,59,722,1371,52.66%,36.03%,1
新北市,新莊區,0519,499,196,695,74,769,1400,54.93%,35.64%,1
新北市,新莊區,0520,561,168,729,86,815,1457,55.94%,38.5%,1
新北市,新莊區,0521,551,181,732,93,825,1502,54.93%,36.68%,1
新北市,新莊區,0522,526,181,707,78,785,1412,55.59%,37.25%,1
新北市,新莊區,0523,485,164,649,81,730,1318,55.39%,36.8%,1
新北市,新莊區,0524,593,170,763,66,829,1411,58.75%,42.03%,1
新北市,新莊區,0525,545,150,695,34,729,1262,57.77%,43.19%,1
新北市,新莊區,0526,550,138,688,53,741,1228,60.34%,44.79%,1
新北市,新莊區,0527,723,223,946,73,1019,1748,58.3%,41.36%,1
新北市,新莊區,0528,728,212,940,82,1022,1761,58.04%,41.34%,1
新北市,新莊區,0529,472,157,629,75,704,1326,53.09%,35.6%,1
新北市,新莊區,0530,439,162,601,69,670,1344,49.85%,32.66%,1
新北市,新莊區,0531,558,156,714,54,768,1355,56.68%,41.18%,1
新北市,新莊區,0532,512,172,684,76,760,1306,58.19%,39.2%,1
新北市,新莊區,0533,574,187,761,46,807,1349,59.82%,42.55%,1
新北市,新莊區,0534,510,158,668,39,707,1265,55.89%,40.32%,1
新北市,新莊區,0535,542,167,709,67,776,1282,60.53%,42.28%,1
新北市,新莊區,0536,542,144,686,59,745,1237,60.23%,43.82%,1
新北市,新莊區,0537,539,134,673,31,704,1301,54.11%,41.43%,1
新北市,新莊區,0538,515,141,656,67,723,1262,57.29%,40.81%,1
新北市,新莊區,0539,504,168,672,52,724,1270,57.01%,39.69%,1
新北市,新莊區,0540,476,187,663,70,733,1245,58.88%,38.23%,1
新北市,新莊區,0541,436,173,609,78,687,1220,56.31%,35.74%,1
新北市,新莊區,0542,480,142,622,36,658,1245,52.85%,38.55%,1
新北市,新莊區,0543,442,146,588,53,641,1212,52.89%,36.47%,1
新北市,新莊區,0544,451,147,598,85,683,1253,54.51%,35.99%,1
新北市,新莊區,0545,461,148,609,66,675,1272,53.07%,36.24%,1
新北市,新莊區,0546,545,140,685,37,722,1227,58.84%,44.42%,1
新北市,新莊區,0547,483,143,626,48,674,1126,59.86%,42.9%,1
新北市,新莊區,0548,506,173,679,41,720,1240,58.06%,40.81%,1
新北市,新莊區,0549,586,178,764,62,826,1460,56.58%,40.14%,1
新北市,新莊區,0550,403,152,555,44,599,1072,55.88%,37.59%,1
新北市,新莊區,0551,410,123,533,52,585,1127,51.91%,36.38%,1
新北市,新莊區,0552,573,159,732,41,773,1332,58.03%,43.02%,1
新北市,新莊區,0553,527,138,665,23,688,1341,51.3%,39.3%,1
新北市,新莊區,0554,347,119,466,26,492,1140,43.16%,30.44%,1
新北市,新店區,1987,637,175,812,61,873,1603,54.46%,39.74%,1
新北市,新店區,1988,802,222,1024,50,1074,1921,55.91%,41.75%,1
新北市,新店區,1989,418,137,555,24,579,1082,53.51%,38.63%,1
新北市,新店區,1990,501,162,663,51,714,1235,57.81%,40.57%,1
新北市,新店區,1991,714,158,872,38,910,1568,58.04%,45.54%,1
新北市,新店區,1992,304,111,415,39,454,771,58.88%,39.43%,1
新北市,新店區,1993,487,163,650,44,694,1256,55.25%,38.77%,1
新北市,新店區,1994,436,112,548,53,601,1008,59.62%,43.25%,1
新北市,新店區,1995,697,133,830,50,880,1515,58.09%,46.01%,1
新北市,新店區,1996,772,186,958,56,1014,1637,61.94%,47.16%,1
新北市,新店區,1997,646,200,846,56,902,1549,58.23%,41.7%,1
新北市,新店區,1998,981,208,1189,62,1251,2011,62.21%,48.78%,1
新北市,新店區,1999,633,170,803,97,900,1554,57.92%,40.73%,1
新北市,新店區,2000,735,183,918,68,986,1770,55.71%,41.53%,1
新北市,新店區,2001,577,150,727,54,781,1316,59.35%,43.84%,1
新北市,新店區,2002,458,122,580,60,640,1126,56.84%,40.67%,1
新北市,新店區,2003,582,155,737,58,795,1460,54.45%,39.86%,1
新北市,新店區,2004,672,193,865,63,928,1584,58.59%,42.42%,1
新北市,新店區,2005,602,179,781,46,827,1449,57.07%,41.55%,1
新北市,新店區,2006,725,174,899,53,952,1520,62.63%,47.7%,1
新北市,新店區,2007,851,179,1030,41,1071,1821,58.81%,46.73%,1
新北市,新店區,2008,800,249,1049,45,1094,1956,55.93%,40.9%,1
新北市,新店區,2009,705,217,922,56,978,1665,58.74%,42.34%,1
新北市,新店區,2010,742,169,911,53,964,1588,60.71%,46.73%,1
新北市,新店區,2011,654,169,823,23,846,1519,55.69%,43.05%,1
新北市,新店區,2012,538,169,707,37,744,1185,62.78%,45.4%,1
新北市,新店區,2013,540,129,669,24,693,1095,63.29%,49.32%,1
新北市,新店區,2014,500,126,626,62,688,1106,62.21%,45.21%,1
新北市,新店區,2015,293,91,384,22,406,2700,15.04%,10.85%,1
新北市,新店區,2016,444,116,560,27,587,995,58.99%,44.62%,1
新北市,新店區,2017,498,128,626,45,671,1168,57.45%,42.64%,1
新北市,新店區,2018,575,122,697,62,759,1123,67.59%,51.2%,1
新北市,新店區,2019,515,141,656,46,702,1085,64.7%,47.47%,1
新北市,新店區,2020,656,166,822,58,880,1412,62.32%,46.46%,1
新北市,新店區,2021,720,177,897,61,958,1659,57.75%,43.4%,1
新北市,新店區,2022,608,112,720,51,771,1198,64.36%,50.75%,1
新北市,新店區,2023,564,145,709,35,744,1376,54.07%,40.99%,1
新北市,新店區,2024,549,122,671,39,710,1300,54.62%,42.23%,1
新北市,新店區,2025,536,141,677,49,726,1238,58.64%,43.3%,1
新北市,新店區,2026,659,134,793,31,824,1388,59.37%,47.48%,1
新北市,新店區,2027,410,128,538,47,585,933,62.7%,43.94%,1
新北市,新店區,2028,434,109,543,38,581,908,63.99%,47.8%,1
新北市,新店區,2029,669,181,850,61,911,1582,57.59%,42.29%,1
新北市,新店區,2030,590,137,727,49,776,1247,62.23%,47.31%,1
新北市,新店區,2031,436,101,537,66,603,971,62.1%,44.9%,1
新北市,新店區,2032,529,121,650,51,701,1145,61.22%,46.2%,1
新北市,新店區,2033,640,141,781,55,836,1392,60.06%,45.98%,1
新北市,新店區,2034,689,171,860,57,917,1452,63.15%,47.45%,1
新北市,新店區,2035,607,174,781,53,834,1440,57.92%,42.15%,1
新北市,新店區,2036,729,201,930,88,1018,1786,57%,40.82%,1
新北市,新店區,2037,800,196,996,59,1055,1825,57.81%,43.84%,1
新北市,新店區,2038,687,164,851,33,884,1477,59.85%,46.51%,1
新北市,新店區,2039,869,102,971,59,1030,1750,58.86%,49.66%,1
新北市,新店區,2040,803,161,964,62,1026,1792,57.25%,44.81%,1
新北市,新店區,2041,883,164,1047,70,1117,1979,56.44%,44.62%,1
新北市,新店區,2042,398,79,477,24,501,826,60.65%,48.18%,1
新北市,新店區,2043,922,173,1095,46,1141,1924,59.3%,47.92%,1
新北市,新店區,2044,682,141,823,21,844,1383,61.03%,49.31%,1
新北市,新店區,2045,307,79,386,39,425,830,51.2%,36.99%,1
新北市,新店區,2046,841,179,1020,43,1063,1759,60.43%,47.81%,1
新北市,新店區,2047,941,184,1125,55,1180,1957,60.3%,48.08%,1
新北市,新店區,2048,704,157,861,37,898,1481,60.63%,47.54%,1
新北市,新店區,2049,675,173,848,71,919,1552,59.21%,43.49%,1
新北市,新店區,2050,614,152,766,76,842,1467,57.4%,41.85%,1
新北市,新店區,2051,601,146,747,50,797,1371,58.13%,43.84%,1
新北市,新店區,2052,443,111,554,44,598,991,60.34%,44.7%,1
新北市,新店區,2053,555,124,679,65,744,1231,60.44%,45.09%,1
新北市,新店區,2054,733,199,932,64,996,1701,58.55%,43.09%,1
新北市,新店區,2055,703,123,826,53,879,1707,51.49%,41.18%,1
新北市,新店區,2056,767,181,948,40,988,1773,55.72%,43.26%,1
新北市,新店區,2057,743,193,936,57,993,1866,53.22%,39.82%,1
新北市,新店區,2058,768,211,979,51,1030,1735,59.37%,44.27%,1
新北市,新店區,2059,763,215,978,57,1035,1632,63.42%,46.75%,1
新北市,新店區,2060,731,157,888,60,948,1591,59.59%,45.95%,1
新北市,新店區,2061,585,159,744,72,816,1495,54.58%,39.13%,1
新北市,新店區,2062,597,125,722,28,750,1511,49.64%,39.51%,1
新北市,新店區,2063,527,150,677,58,735,1260,58.33%,41.83%,1
新北市,新店區,2064,922,201,1123,43,1166,1948,59.86%,47.33%,1
新北市,新店區,2065,728,191,919,58,977,1582,61.76%,46.02%,1
新北市,新店區,2066,545,172,717,49,766,1315,58.25%,41.44%,1
新北市,新店區,2067,622,168,790,55,845,1562,54.1%,39.82%,1
新北市,新店區,2068,953,174,1127,35,1162,1982,58.63%,48.08%,1
新北市,新店區,2069,655,186,841,58,899,1518,59.22%,43.15%,1
新北市,新店區,2070,763,171,934,33,967,1735,55.73%,43.98%,1
新北市,新店區,2071,746,153,899,59,958,1716,55.83%,43.47%,1
新北市,新店區,2072,685,178,863,61,924,1580,58.48%,43.35%,1
新北市,新店區,2073,623,170,793,50,843,1358,62.08%,45.88%,1
新北市,新店區,2074,696,216,912,90,1002,1610,62.24%,43.23%,1
新北市,新店區,2075,551,179,730,43,773,1383,55.89%,39.84%,1
新北市,新店區,2076,690,173,863,39,902,1596,56.52%,43.23%,1
新北市,新店區,2077,567,111,678,46,724,1360,53.24%,41.69%,1
新北市,新店區,2078,493,79,572,21,593,1160,51.12%,42.5%,1
新北市,新店區,2079,670,101,771,41,812,1236,65.7%,54.21%,1
新北市,新店區,2080,641,124,765,29,794,1234,64.34%,51.94%,1
新北市,新店區,2081,668,182,850,67,917,1579,58.07%,42.31%,1
新北市,新店區,2082,553,113,666,43,709,1241,57.13%,44.56%,1
新北市,新店區,2083,512,157,669,34,703,1275,55.14%,40.16%,1
新北市,新店區,2084,479,114,593,53,646,1214,53.21%,39.46%,1
新北市,新店區,2085,545,171,716,72,788,1578,49.94%,34.54%,1
新北市,新店區,2086,582,165,747,48,795,1442,55.13%,40.36%,1
新北市,新店區,2087,540,169,709,80,789,1475,53.49%,36.61%,1
新北市,新店區,2088,689,183,872,54,926,1580,58.61%,43.61%,1
新北市,新店區,2089,621,170,791,44,835,1585,52.68%,39.18%,1
新北市,新店區,2090,621,191,812,76,888,1586,55.99%,39.16%,1
新北市,新店區,2091,797,202,999,74,1073,1931,55.57%,41.27%,1
新北市,新店區,2092,531,114,645,40,685,1239,55.29%,42.86%,1
新北市,新店區,2093,798,187,985,59,1044,1892,55.18%,42.18%,1
新北市,新店區,2094,567,165,732,60,792,1529,51.8%,37.08%,1
新北市,新店區,2095,620,109,729,59,788,1358,58.03%,45.66%,1
新北市,新店區,2096,710,214,924,46,970,1905,50.92%,37.27%,1
新北市,新店區,2097,766,164,930,59,989,1885,52.47%,40.64%,1
新北市,新店區,2098,522,142,664,69,733,1345,54.5%,38.81%,1
新北市,新店區,2099,565,165,730,64,794,1387,57.25%,40.74%,1
新北市,新店區,2100,800,202,1002,74,1076,1960,54.9%,40.82%,1
新北市,新店區,2101,758,191,949,78,1027,1837,55.91%,41.26%,1
新北市,新店區,2102,701,189,890,54,944,1662,56.8%,42.18%,1
新北市,新店區,2103,757,176,933,62,995,1617,61.53%,46.82%,1
新北市,新店區,2104,710,199,909,45,954,1704,55.99%,41.67%,1
新北市,新店區,2105,703,207,910,77,987,1835,53.79%,38.31%,1
新北市,新店區,2106,782,218,1000,84,1084,2009,53.96%,38.92%,1
新北市,新店區,2107,578,173,751,61,812,1450,56%,39.86%,1
新北市,新店區,2108,729,171,900,60,960,1726,55.62%,42.24%,1
新北市,新店區,2109,724,179,903,69,972,1797,54.09%,40.29%,1
新北市,新店區,2110,734,177,911,45,956,1739,54.97%,42.21%,1
新北市,新店區,2111,657,155,812,34,846,1523,55.55%,43.14%,1
新北市,新店區,2112,711,130,841,34,875,1642,53.29%,43.3%,1
新北市,新店區,2113,723,158,881,25,906,1644,55.11%,43.98%,1
新北市,新店區,2114,609,176,785,44,829,1662,49.88%,36.64%,1
新北市,新店區,2115,875,242,1117,62,1179,2067,57.04%,42.33%,1
新北市,新店區,2116,606,182,788,48,836,1870,44.71%,32.41%,1
新北市,新店區,2117,823,181,1004,64,1068,1982,53.88%,41.52%,1
新北市,新店區,2118,679,141,820,38,858,1546,55.5%,43.92%,1
新北市,新店區,2119,799,194,993,41,1034,1712,60.4%,46.67%,1
新北市,新店區,2120,692,162,854,30,884,1423,62.12%,48.63%,1
新北市,新店區,2121,749,192,941,67,1008,1666,60.5%,44.96%,1
新北市,新店區,2122,843,176,1019,57,1076,1769,60.83%,47.65%,1
新北市,新店區,2123,361,141,502,40,542,1079,50.23%,33.46%,1
新北市,新店區,2124,428,134,562,26,588,1140,51.58%,37.54%,1
新北市,新店區,2125,723,212,935,66,1001,1825,54.85%,39.62%,1
新北市,新店區,2126,514,160,674,38,712,1178,60.44%,43.63%,1
新北市,新店區,2127,591,155,746,48,794,1463,54.27%,40.4%,1
新北市,新店區,2128,496,118,614,41,655,1152,56.86%,43.06%,1
新北市,新店區,2129,734,161,895,41,936,2008,46.61%,36.55%,1
新北市,新店區,2130,787,143,930,43,973,2120,45.9%,37.12%,1
新北市,新店區,2131,553,106,659,16,675,1153,58.54%,47.96%,1
新北市,新店區,2132,644,145,789,43,832,1573,52.89%,40.94%,1
新北市,新店區,2133,666,212,878,86,964,1992,48.39%,33.43%,1
新北市,新店區,2134,576,189,765,58,823,1668,49.34%,34.53%,1
新北市,新店區,2135,469,266,735,58,793,1617,49.04%,29%,1
新北市,新店區,2136,786,196,982,97,1079,2013,53.6%,39.05%,1
新北市,新店區,2137,785,184,969,59,1028,1791,57.4%,43.83%,1
新北市,新店區,2138,694,174,868,50,918,1624,56.53%,42.73%,1
新北市,新店區,2139,568,117,685,28,713,1178,60.53%,48.22%,1
新北市,新店區,2140,596,118,714,33,747,1277,58.5%,46.67%,1
新北市,新店區,2141,819,177,996,67,1063,1879,56.57%,43.59%,1
新北市,新店區,2142,291,117,408,27,435,939,46.33%,30.99%,1
新北市,新店區,2143,398,114,512,37,549,960,57.19%,41.46%,1
新北市,新店區,2144,657,184,841,31,872,1434,60.81%,45.82%,1
新北市,新店區,2145,773,112,885,66,951,1838,51.74%,42.06%,1
新北市,新店區,2146,600,166,766,51,817,1453,56.23%,41.29%,1
新北市,新店區,2147,602,164,766,63,829,1549,53.52%,38.86%,1
新北市,新店區,2148,807,212,1019,53,1072,1860,57.63%,43.39%,1
新北市,新店區,2149,658,158,816,44,860,1743,49.34%,37.75%,1
新北市,新店區,2150,568,123,691,44,735,1122,65.51%,50.62%,1
新北市,新店區,2151,628,143,771,40,811,1468,55.25%,42.78%,1
新北市,新店區,2152,755,172,927,45,972,1763,55.13%,42.82%,1
新北市,新店區,2153,507,159,666,49,715,1344,53.2%,37.72%,1
新北市,新店區,2154,267,85,352,53,405,753,53.78%,35.46%,1
新北市,新店區,2155,206,84,290,10,300,602,49.83%,34.22%,1
新北市,新店區,2156,817,274,1091,73,1164,2237,52.03%,36.52%,1
新北市,新店區,2157,416,136,552,34,586,1096,53.47%,37.96%,1
新北市,新店區,2158,363,116,479,58,537,1143,46.98%,31.76%,1
新北市,新店區,2159,521,208,729,84,813,1569,51.82%,33.21%,1
新北市,新店區,2160,465,161,626,70,696,1284,54.21%,36.21%,1
新北市,新店區,2161,84,37,121,15,136,439,30.98%,19.13%,1
新北市,新店區,2162,271,121,392,42,434,750,57.87%,36.13%,1
新北市,樹林區,1614,494,167,661,80,741,1408,52.63%,35.09%,1
新北市,樹林區,1615,468,164,632,38,670,1310,51.15%,35.73%,1
新北市,樹林區,1616,507,173,680,75,755,1534,49.22%,33.05%,1
新北市,樹林區,1617,453,150,603,68,671,1211,55.41%,37.41%,1
新北市,樹林區,1618,435,160,595,57,652,1125,57.96%,38.67%,1
新北市,樹林區,1619,481,168,649,45,694,1134,61.2%,42.42%,1
新北市,樹林區,1620,589,200,789,100,889,1897,46.86%,31.05%,1
新北市,樹林區,1621,625,212,837,77,914,1716,53.26%,36.42%,1
新北市,樹林區,1622,285,114,399,58,457,736,62.09%,38.72%,1
新北市,樹林區,1623,484,170,654,35,689,1137,60.6%,42.57%,1
新北市,樹林區,1624,535,199,734,63,797,1542,51.69%,34.7%,1
新北市,樹林區,1625,598,192,790,69,859,1470,58.44%,40.68%,1
新北市,樹林區,1626,485,164,649,31,680,1456,46.7%,33.31%,1
新北市,樹林區,1627,437,146,583,30,613,1124,54.54%,38.88%,1
新北市,樹林區,1628,482,143,625,34,659,1235,53.36%,39.03%,1
新北市,樹林區,1629,458,175,633,37,670,1212,55.28%,37.79%,1
新北市,樹林區,1630,430,133,563,35,598,1223,48.9%,35.16%,1
新北市,樹林區,1631,479,155,634,83,717,1335,53.71%,35.88%,1
新北市,樹林區,1632,459,155,614,48,662,1206,54.89%,38.06%,1
新北市,樹林區,1633,462,161,623,92,715,1927,37.1%,23.98%,1
新北市,樹林區,1634,343,128,471,48,519,914,56.78%,37.53%,1
新北市,樹林區,1635,561,200,761,74,835,1456,57.35%,38.53%,1
新北市,樹林區,1636,525,158,683,53,736,1409,52.24%,37.26%,1
新北市,樹林區,1637,581,239,820,78,898,1500,59.87%,38.73%,1
新北市,樹林區,1638,621,171,792,72,864,1545,55.92%,40.19%,1
新北市,樹林區,1639,539,189,728,45,773,1483,52.12%,36.35%,1
新北市,樹林區,1640,570,184,754,40,794,1524,52.1%,37.4%,1
新北市,樹林區,1641,572,181,753,42,795,1431,55.56%,39.97%,1
新北市,樹林區,1642,437,149,586,70,656,1181,55.55%,37%,1
新北市,樹林區,1643,415,160,575,77,652,1116,58.42%,37.19%,1
新北市,樹林區,1644,364,156,520,45,565,1077,52.46%,33.8%,1
新北市,樹林區,1645,386,123,509,22,531,1103,48.14%,35%,1
新北市,樹林區,1646,520,177,697,70,767,1385,55.38%,37.55%,1
新北市,樹林區,1647,459,151,610,54,664,1266,52.45%,36.26%,1
新北市,樹林區,1648,436,157,593,57,650,1195,54.39%,36.49%,1
新北市,樹林區,1649,463,157,620,56,676,1254,53.91%,36.92%,1
新北市,樹林區,1650,502,171,673,51,724,1263,57.32%,39.75%,1
新北市,樹林區,1651,570,236,806,88,894,1473,60.69%,38.7%,1
新北市,樹林區,1652,358,106,464,33,497,870,57.13%,41.15%,1
新北市,樹林區,1653,547,195,742,78,820,1338,61.29%,40.88%,1
新北市,樹林區,1654,381,113,494,39,533,1010,52.77%,37.72%,1
新北市,樹林區,1655,662,218,880,75,955,1658,57.6%,39.93%,1
新北市,樹林區,1656,656,251,907,65,972,1538,63.2%,42.65%,1
新北市,樹林區,1657,633,161,794,91,885,1405,62.99%,45.05%,1
新北市,樹林區,1658,592,227,819,69,888,1587,55.95%,37.3%,1
新北市,樹林區,1659,604,207,811,60,871,1566,55.62%,38.57%,1
新北市,樹林區,1660,364,114,478,27,505,997,50.65%,36.51%,1
新北市,樹林區,1661,439,173,612,61,673,1187,56.7%,36.98%,1
新北市,樹林區,1662,388,129,517,62,579,1061,54.57%,36.57%,1
新北市,樹林區,1663,706,185,891,61,952,1701,55.97%,41.5%,1
新北市,樹林區,1664,524,138,662,61,723,1278,56.57%,41%,1
新北市,樹林區,1665,598,186,784,73,857,1433,59.8%,41.73%,1
新北市,樹林區,1666,558,163,721,77,798,1306,61.1%,42.73%,1
新北市,樹林區,1667,518,183,701,72,773,1268,60.96%,40.85%,1
新北市,樹林區,1668,501,192,693,43,736,1281,57.46%,39.11%,1
新北市,樹林區,1669,379,283,662,54,716,1200,59.67%,31.58%,1
新北市,樹林區,1670,543,191,734,37,771,1491,51.71%,36.42%,1
新北市,樹林區,1671,410,112,522,28,550,1066,51.59%,38.46%,1
新北市,樹林區,1672,372,111,483,74,557,877,63.51%,42.42%,1
新北市,樹林區,1673,609,198,807,68,875,1616,54.15%,37.69%,1
新北市,樹林區,1674,508,164,672,66,738,1589,46.44%,31.97%,1
新北市,樹林區,1675,563,165,728,67,795,1367,58.16%,41.19%,1
新北市,樹林區,1676,471,163,634,47,681,1144,59.53%,41.17%,1
新北市,樹林區,1677,402,119,521,30,551,1059,52.03%,37.96%,1
新北市,樹林區,1678,445,172,617,60,677,1224,55.31%,36.36%,1
新北市,樹林區,1679,388,133,521,51,572,1141,50.13%,34.01%,1
新北市,樹林區,1680,460,99,559,32,591,1396,42.34%,32.95%,1
新北市,樹林區,1681,421,168,589,45,634,1157,54.8%,36.39%,1
新北市,樹林區,1682,492,192,684,89,773,1498,51.6%,32.84%,1
新北市,樹林區,1683,569,181,750,82,832,1514,54.95%,37.58%,1
新北市,樹林區,1684,556,168,724,57,781,1546,50.52%,35.96%,1
新北市,樹林區,1685,521,192,713,61,774,1392,55.6%,37.43%,1
新北市,樹林區,1686,660,155,815,61,876,1566,55.94%,42.15%,1
新北市,樹林區,1687,618,187,805,36,841,1566,53.7%,39.46%,1
新北市,樹林區,1688,584,175,759,66,825,1517,54.38%,38.5%,1
新北市,樹林區,1689,584,183,767,46,813,1481,54.9%,39.43%,1
新北市,樹林區,1690,446,141,587,47,634,1261,50.28%,35.37%,1
新北市,樹林區,1691,452,120,572,34,606,1163,52.11%,38.87%,1
新北市,樹林區,1692,688,223,911,84,995,1661,59.9%,41.42%,1
新北市,樹林區,1693,616,219,835,65,900,1585,56.78%,38.86%,1
新北市,樹林區,1694,428,138,566,49,615,1018,60.41%,42.04%,1
新北市,樹林區,1695,488,136,624,74,698,1247,55.97%,39.13%,1
新北市,樹林區,1696,561,116,677,76,753,1390,54.17%,40.36%,1
新北市,樹林區,1697,532,159,691,50,741,1293,57.31%,41.14%,1
新北市,樹林區,1698,463,162,625,43,668,1301,51.35%,35.59%,1
新北市,樹林區,1699,551,222,773,73,846,1606,52.68%,34.31%,1
新北市,樹林區,1700,467,168,635,81,716,1277,56.07%,36.57%,1
新北市,樹林區,1701,460,159,619,71,690,1219,56.6%,37.74%,1
新北市,樹林區,1702,537,153,690,42,732,1454,50.34%,36.93%,1
新北市,樹林區,1703,508,145,653,46,699,1314,53.2%,38.66%,1
新北市,樹林區,1704,470,142,612,28,640,1008,63.49%,46.63%,1
新北市,樹林區,1705,591,169,760,87,847,1574,53.81%,37.55%,1
新北市,樹林區,1706,551,171,722,43,765,1364,56.09%,40.4%,1
新北市,樹林區,1707,560,210,770,80,850,1677,50.69%,33.39%,1
新北市,樹林區,1708,519,160,679,42,721,1683,42.84%,30.84%,1
新北市,樹林區,1709,593,184,777,59,836,1452,57.58%,40.84%,1
新北市,樹林區,1710,711,175,886,38,924,1592,58.04%,44.66%,1
新北市,樹林區,1711,707,179,886,45,931,1619,57.5%,43.67%,1
新北市,樹林區,1712,774,188,962,42,1004,1642,61.14%,47.14%,1
新北市,樹林區,1713,563,159,722,31,753,1357,55.49%,41.49%,1
新北市,樹林區,1714,595,250,845,87,932,1638,56.9%,36.32%,1
新北市,樹林區,1715,615,210,825,52,877,1592,55.09%,38.63%,1
新北市,樹林區,1716,658,172,830,56,886,1521,58.25%,43.26%,1
新北市,樹林區,1717,753,215,968,60,1028,1707,60.22%,44.11%,1
新北市,樹林區,1718,745,202,947,68,1015,1741,58.3%,42.79%,1
新北市,樹林區,1719,697,168,865,44,909,1655,54.92%,42.11%,1
新北市,樹林區,1720,638,200,838,79,917,1775,51.66%,35.94%,1
新北市,樹林區,1721,722,182,904,67,971,1781,54.52%,40.54%,1
新北市,樹林區,1722,496,169,665,47,712,1565,45.5%,31.69%,1
新北市,樹林區,1723,326,131,457,45,502,936,53.63%,34.83%,1
新北市,樹林區,1724,375,156,531,23,554,1030,53.79%,36.41%,1
新北市,鶯歌區,1725,194,83,277,17,294,515,57.09%,37.67%,1
新北市,鶯歌區,1726,390,142,532,47,579,965,60%,40.41%,1
新北市,鶯歌區,1727,746,220,966,94,1060,1931,54.89%,38.63%,1
新北市,鶯歌區,1728,628,197,825,60,885,1797,49.25%,34.95%,1
新北市,鶯歌區,1729,414,127,541,49,590,1057,55.82%,39.17%,1
新北市,鶯歌區,1730,338,123,461,17,478,962,49.69%,35.14%,1
新北市,鶯歌區,1731,403,137,540,42,582,934,62.31%,43.15%,1
新北市,鶯歌區,1732,712,262,974,81,1055,1742,60.56%,40.87%,1
新北市,鶯歌區,1733,587,207,794,66,860,1634,52.63%,35.92%,1
新北市,鶯歌區,1734,588,186,774,46,820,1676,48.93%,35.08%,1
新北市,鶯歌區,1735,745,276,1021,100,1121,2052,54.63%,36.31%,1
新北市,鶯歌區,1736,656,203,859,43,902,1977,45.62%,33.18%,1
新北市,鶯歌區,1737,750,246,996,25,1021,1957,52.17%,38.32%,1
新北市,鶯歌區,1738,260,92,352,27,379,850,44.59%,30.59%,1
新北市,鶯歌區,1739,655,206,861,56,917,1782,51.46%,36.76%,1
新北市,鶯歌區,1740,582,153,735,56,791,1496,52.87%,38.9%,1
新北市,鶯歌區,1741,682,251,933,53,986,2071,47.61%,32.93%,1
新北市,鶯歌區,1742,530,224,754,58,812,1753,46.32%,30.23%,1
新北市,鶯歌區,1743,646,172,818,51,869,1737,50.03%,37.19%,1
新北市,鶯歌區,1744,618,151,769,67,836,1669,50.09%,37.03%,1
新北市,鶯歌區,1745,581,193,774,48,822,1842,44.63%,31.54%,1
新北市,鶯歌區,1746,495,185,680,54,734,1454,50.48%,34.04%,1
新北市,鶯歌區,1747,343,116,459,41,500,942,53.08%,36.41%,1
新北市,鶯歌區,1748,460,178,638,68,706,1317,53.61%,34.93%,1
新北市,鶯歌區,1749,307,93,400,21,421,949,44.36%,32.35%,1
新北市,鶯歌區,1750,589,196,785,58,843,1440,58.54%,40.9%,1
新北市,鶯歌區,1751,610,308,918,74,992,1809,54.84%,33.72%,1
新北市,鶯歌區,1752,703,215,918,69,987,1758,56.14%,39.99%,1
新北市,鶯歌區,1753,607,194,801,61,862,1589,54.25%,38.2%,1
新北市,鶯歌區,1754,438,157,595,37,632,1067,59.23%,41.05%,1
新北市,鶯歌區,1755,444,155,599,43,642,1092,58.79%,40.66%,1
新北市,鶯歌區,1756,676,215,891,57,948,1730,54.8%,39.08%,1
新北市,鶯歌區,1757,515,137,652,61,713,1281,55.66%,40.2%,1
新北市,鶯歌區,1758,540,160,700,54,754,1238,60.9%,43.62%,1
新北市,鶯歌區,1759,611,182,793,76,869,1568,55.42%,38.97%,1
新北市,鶯歌區,1760,482,146,628,56,684,1271,53.82%,37.92%,1
新北市,鶯歌區,1761,355,109,464,27,491,1183,41.5%,30.01%,1
新北市,鶯歌區,1762,374,83,457,25,482,1026,46.98%,36.45%,1
新北市,鶯歌區,1763,612,182,794,43,837,1721,48.63%,35.56%,1
新北市,鶯歌區,1764,453,162,615,71,686,1317,52.09%,34.4%,1
新北市,鶯歌區,1765,399,165,564,62,626,1046,59.85%,38.15%,1
新北市,鶯歌區,1766,454,179,633,53,686,1144,59.97%,39.69%,1
新北市,鶯歌區,1767,438,166,604,69,673,1336,50.37%,32.78%,1
新北市,鶯歌區,1768,478,151,629,44,673,1479,45.5%,32.32%,1
新北市,鶯歌區,1769,624,211,835,55,890,1736,51.27%,35.94%,1
新北市,鶯歌區,1770,586,179,765,68,833,1389,59.97%,42.19%,1
新北市,鶯歌區,1771,717,22,739,86,825,1956,42.18%,36.66%,1
新北市,鶯歌區,1772,464,220,684,53,737,1371,53.76%,33.84%,1
新北市,鶯歌區,1773,533,154,687,43,730,1810,40.33%,29.45%,1
新北市,鶯歌區,1774,74,18,92,6,98,227,43.17%,32.6%,1
新北市,三峽區,1917,124,37,161,25,186,274,67.88%,45.26%,1
新北市,三峽區,1918,211,69,280,42,322,583,55.23%,36.19%,1
新北市,三峽區,1919,546,193,739,31,770,1765,43.63%,30.93%,1
新北市,三峽區,1920,613,230,843,61,904,1714,52.74%,35.76%,1
新北市,三峽區,1921,514,128,642,33,675,1355,49.82%,37.93%,1
新北市,三峽區,1922,554,147,701,44,745,1329,56.06%,41.69%,1
新北市,三峽區,1923,367,126,493,58,551,1059,52.03%,34.66%,1
新北市,三峽區,1924,534,187,721,60,781,1364,57.26%,39.15%,1
新北市,三峽區,1925,433,156,589,57,646,1098,58.83%,39.44%,1
新北市,三峽區,1926,496,152,648,62,710,1296,54.78%,38.27%,1
新北市,三峽區,1927,421,178,599,65,664,1240,53.55%,33.95%,1
新北市,三峽區,1928,581,177,758,50,808,1531,52.78%,37.95%,1
新北市,三峽區,1929,533,120,653,44,697,1444,48.27%,36.91%,1
新北市,三峽區,1930,477,177,654,80,734,1347,54.49%,35.41%,1
新北市,三峽區,1931,559,156,715,65,780,1455,53.61%,38.42%,1
新北市,三峽區,1932,505,162,667,41,708,1556,45.5%,32.46%,1
新北市,三峽區,1933,414,131,545,47,592,1390,42.59%,29.78%,1
新北市,三峽區,1934,592,173,765,55,820,1532,53.52%,38.64%,1
新北市,三峽區,1935,462,135,597,71,668,1377,48.51%,33.55%,1
新北市,三峽區,1936,652,184,836,57,893,1731,51.59%,37.67%,1
新北市,三峽區,1937,620,194,814,35,849,1705,49.79%,36.36%,1
新北市,三峽區,1938,670,169,839,35,874,1590,54.97%,42.14%,1
新北市,三峽區,1939,692,199,891,32,923,1650,55.94%,41.94%,1
新北市,三峽區,1940,580,170,750,36,786,1441,54.55%,40.25%,1
新北市,三峽區,1941,632,154,786,26,812,1404,57.83%,45.01%,1
新北市,三峽區,1942,597,139,736,33,769,1295,59.38%,46.1%,1
新北市,三峽區,1943,464,155,619,32,651,1348,48.29%,34.42%,1
新北市,三峽區,1944,641,180,821,32,853,1579,54.02%,40.6%,1
新北市,三峽區,1945,585,152,737,26,763,1435,53.17%,40.77%,1
新北市,三峽區,1946,749,189,938,32,970,1659,58.47%,45.15%,1
新北市,三峽區,1947,697,170,867,48,915,1512,60.52%,46.1%,1
新北市,三峽區,1948,634,163,797,49,846,1463,57.83%,43.34%,1
新北市,三峽區,1949,663,143,806,29,835,1465,57%,45.26%,1
新北市,三峽區,1950,649,162,811,28,839,1463,57.35%,44.36%,1
新北市,三峽區,1951,632,147,779,44,823,1443,57.03%,43.8%,1
新北市,三峽區,1952,591,171,762,60,822,1634,50.31%,36.17%,1
新北市,三峽區,1953,638,219,857,65,922,1716,53.73%,37.18%,1
新北市,三峽區,1954,614,188,802,69,871,1675,52%,36.66%,1
新北市,三峽區,1955,506,161,667,55,722,1649,43.78%,30.69%,1
新北市,三峽區,1956,528,178,706,80,786,1489,52.79%,35.46%,1
新北市,三峽區,1957,624,180,804,57,861,1771,48.62%,35.23%,1
新北市,三峽區,1958,693,173,866,70,936,1726,54.23%,40.15%,1
新北市,三峽區,1959,483,166,649,77,726,1363,53.26%,35.44%,1
新北市,三峽區,1960,639,160,799,40,839,1624,51.66%,39.35%,1
新北市,三峽區,1961,523,180,703,56,759,1352,56.14%,38.68%,1
新北市,三峽區,1962,433,147,580,28,608,1608,37.81%,26.93%,1
新北市,三峽區,1963,529,185,714,61,775,1458,53.16%,36.28%,1
新北市,三峽區,1964,557,172,729,50,779,1641,47.47%,33.94%,1
新北市,三峽區,1965,527,175,702,108,810,1530,52.94%,34.44%,1
新北市,三峽區,1966,425,136,561,70,631,1389,45.43%,30.6%,1
新北市,三峽區,1967,441,133,574,88,662,1315,50.34%,33.54%,1
新北市,三峽區,1968,422,97,519,50,569,934,60.92%,45.18%,1
新北市,三峽區,1969,417,136,553,38,591,1270,46.54%,32.83%,1
新北市,三峽區,1970,292,116,408,50,458,929,49.3%,31.43%,1
新北市,三峽區,1971,363,122,485,17,502,1035,48.5%,35.07%,1
新北市,三峽區,1972,161,42,203,19,222,502,44.22%,32.07%,1
新北市,三峽區,1973,272,76,348,59,407,836,48.68%,32.54%,1
新北市,三峽區,1974,195,73,268,59,327,669,48.88%,29.15%,1
新北市,三峽區,1975,271,87,358,72,430,733,58.66%,36.97%,1
新北市,三峽區,1976,676,198,874,63,937,1560,60.06%,43.33%,1
新北市,三峽區,1977,620,173,793,50,843,1638,51.47%,37.85%,1
新北市,三峽區,1978,458,144,602,56,658,1394,47.2%,32.86%,1
新北市,三峽區,1979,295,103,398,46,444,771,57.59%,38.26%,1
新北市,三峽區,1980,467,162,629,36,665,1367,48.65%,34.16%,1
新北市,三峽區,1981,453,119,572,72,644,1241,51.89%,36.5%,1
新北市,三峽區,1982,530,145,675,36,711,1520,46.78%,34.87%,1
新北市,三峽區,1983,375,130,505,51,556,873,63.69%,42.96%,1
新北市,三峽區,1984,215,93,308,66,374,768,48.7%,27.99%,1
新北市,三峽區,1985,351,124,475,33,508,1097,46.31%,32%,1
新北市,三峽區,1986,359,132,491,76,567,1322,42.89%,27.16%,1
新北市,淡水區,0029,169,80,249,39,288,544,52.94%,31.07%,1
新北市,淡水區,0030,397,119,516,63,579,1044,55.46%,38.03%,1
新北市,淡水區,0031,523,162,685,40,725,1462,49.59%,35.77%,1
新北市,淡水區,0032,539,192,731,64,795,1525,52.13%,35.34%,1
新北市,淡水區,0033,334,96,430,46,476,986,48.28%,33.87%,1
新北市,淡水區,0034,310,98,408,37,445,806,55.21%,38.46%,1
新北市,淡水區,0035,426,143,569,88,657,1173,56.01%,36.32%,1
新北市,淡水區,0036,448,125,573,51,624,1343,46.46%,33.36%,1
新北市,淡水區,0037,339,114,453,33,486,1153,42.15%,29.4%,1
新北市,淡水區,0038,241,124,365,47,412,874,47.14%,27.57%,1
新北市,淡水區,0039,348,152,500,88,588,1063,55.32%,32.74%,1
新北市,淡水區,0040,439,138,577,41,618,1309,47.21%,33.54%,1
新北市,淡水區,0041,475,162,637,55,692,1290,53.64%,36.82%,1
新北市,淡水區,0042,712,185,897,39,936,1675,55.88%,42.51%,1
新北市,淡水區,0043,642,175,817,57,874,1589,55%,40.4%,1
新北市,淡水區,0044,680,190,870,53,923,1624,56.83%,41.87%,1
新北市,淡水區,0045,465,142,607,48,655,1241,52.78%,37.47%,1
新北市,淡水區,0046,480,163,643,64,707,1317,53.68%,36.45%,1
新北市,淡水區,0047,496,154,650,38,688,1225,56.16%,40.49%,1
新北市,淡水區,0048,593,157,750,40,790,1426,55.4%,41.58%,1
新北市,淡水區,0049,675,207,882,54,936,1610,58.14%,41.93%,1
新北市,淡水區,0050,780,235,1015,50,1065,1982,53.73%,39.35%,1
新北市,淡水區,0051,627,210,837,58,895,1924,46.52%,32.59%,1
新北市,淡水區,0052,658,204,862,59,921,1822,50.55%,36.11%,1
新北市,淡水區,0053,493,164,657,78,735,1232,59.66%,40.02%,1
新北市,淡水區,0054,646,190,836,69,905,1588,56.99%,40.68%,1
新北市,淡水區,0055,692,150,842,54,896,1784,50.22%,38.79%,1
新北市,淡水區,0056,611,234,845,79,924,1762,52.44%,34.68%,1
新北市,淡水區,0057,595,171,766,51,817,1546,52.85%,38.49%,1
新北市,淡水區,0058,733,228,961,53,1014,1897,53.45%,38.64%,1
新北市,淡水區,0059,587,164,751,45,796,1489,53.46%,39.42%,1
新北市,淡水區,0060,610,195,805,55,860,1679,51.22%,36.33%,1
新北市,淡水區,0061,619,184,803,41,844,1693,49.85%,36.56%,1
新北市,淡水區,0062,585,178,763,25,788,1674,47.07%,34.95%,1
新北市,淡水區,0063,548,148,696,25,721,1330,54.21%,41.2%,1
新北市,淡水區,0064,596,141,737,27,764,1467,52.08%,40.63%,1
新北市,淡水區,0065,747,176,923,52,975,1837,53.08%,40.66%,1
新北市,淡水區,0066,508,125,633,18,651,1924,33.84%,26.4%,1
新北市,淡水區,0067,901,243,1144,34,1178,2340,50.34%,38.5%,1
新北市,淡水區,0068,571,159,730,53,783,1704,45.95%,33.51%,1
新北市,淡水區,0069,530,141,671,47,718,1363,52.68%,38.88%,1
新北市,淡水區,0070,1072,276,1348,51,1399,3068,45.6%,34.94%,1
新北市,淡水區,0071,565,139,704,41,745,1528,48.76%,36.98%,1
新北市,淡水區,0072,556,183,739,62,801,1600,50.06%,34.75%,1
新北市,淡水區,0073,750,221,971,74,1045,1874,55.76%,40.02%,1
新北市,淡水區,0074,587,166,753,80,833,1567,53.16%,37.46%,1
新北市,淡水區,0075,490,170,660,38,698,1245,56.06%,39.36%,1
新北市,淡水區,0076,441,159,600,32,632,1211,52.19%,36.42%,1
新北市,淡水區,0077,814,233,1047,51,1098,1992,55.12%,40.86%,1
新北市,淡水區,0078,801,215,1016,40,1056,2028,52.07%,39.5%,1
新北市,淡水區,0079,528,171,699,81,780,1373,56.81%,38.46%,1
新北市,淡水區,0080,701,174,875,41,916,1732,52.89%,40.47%,1
新北市,淡水區,0081,533,178,711,52,763,1519,50.23%,35.09%,1
新北市,淡水區,0082,621,167,788,28,816,1727,47.25%,35.96%,1
新北市,淡水區,0083,401,268,669,38,707,1297,54.51%,30.92%,1
新北市,淡水區,0084,397,120,517,52,569,1066,53.38%,37.24%,1
新北市,淡水區,0085,550,159,709,57,766,1387,55.23%,39.65%,1
新北市,淡水區,0086,723,250,973,62,1035,1909,54.22%,37.87%,1
新北市,淡水區,0087,678,207,885,63,948,1770,53.56%,38.31%,1
新北市,淡水區,0088,747,209,956,70,1026,2049,50.07%,36.46%,1
新北市,淡水區,0089,669,202,871,37,908,1680,54.05%,39.82%,1
新北市,淡水區,0090,571,204,775,69,844,1433,58.9%,39.85%,1
新北市,淡水區,0091,518,158,676,42,718,1365,52.6%,37.95%,1
新北市,淡水區,0092,570,176,746,65,811,1452,55.85%,39.26%,1
新北市,淡水區,0093,737,162,899,63,962,1804,53.33%,40.85%,1
新北市,淡水區,0094,497,152,649,47,696,1322,52.65%,37.59%,1
新北市,淡水區,0095,784,207,991,37,1028,2019,50.92%,38.83%,1
新北市,淡水區,0096,737,207,944,45,989,1696,58.31%,43.46%,1
新北市,淡水區,0097,622,212,834,42,876,1576,55.58%,39.47%,1
新北市,淡水區,0098,832,125,957,48,1005,1781,56.43%,46.72%,1
新北市,淡水區,0099,688,222,910,61,971,1665,58.32%,41.32%,1
新北市,淡水區,0100,762,242,1004,72,1076,2013,53.45%,37.85%,1
新北市,淡水區,0101,396,155,551,43,594,1108,53.61%,35.74%,1
新北市,淡水區,0102,504,149,653,68,721,1305,55.25%,38.62%,1
新北市,淡水區,0103,441,168,609,24,633,1199,52.79%,36.78%,1
新北市,淡水區,0104,777,213,990,71,1061,2017,52.6%,38.52%,1
新北市,淡水區,0105,704,246,950,79,1029,2125,48.42%,33.13%,1
新北市,淡水區,0106,402,146,548,37,585,1289,45.38%,31.19%,1
新北市,淡水區,0107,571,159,730,52,782,1319,59.29%,43.29%,1
新北市,淡水區,0108,406,125,531,33,564,1051,53.66%,38.63%,1
新北市,淡水區,0109,524,147,671,42,713,1348,52.89%,38.87%,1
新北市,淡水區,0110,400,115,515,47,562,1106,50.81%,36.17%,1
新北市,淡水區,0111,274,110,384,34,418,717,58.3%,38.21%,1
新北市,淡水區,0112,494,180,674,41,715,1385,51.62%,35.67%,1
新北市,淡水區,0113,332,125,457,46,503,841,59.81%,39.48%,1
新北市,淡水區,0114,263,81,344,34,378,665,56.84%,39.55%,1
新北市,淡水區,0115,176,52,228,23,251,419,59.9%,42%,1
新北市,淡水區,0116,653,192,845,35,880,1599,55.03%,40.84%,1
新北市,淡水區,0117,628,194,822,55,877,1670,52.51%,37.6%,1
新北市,淡水區,0118,760,131,891,65,956,1683,56.8%,45.16%,1
新北市,淡水區,0119,558,171,729,64,793,1577,50.29%,35.38%,1
新北市,淡水區,0120,588,166,754,55,809,1618,50%,36.34%,1
新北市,淡水區,0121,749,223,972,46,1018,2214,45.98%,33.83%,1
新北市,淡水區,0122,674,213,887,66,953,1832,52.02%,36.79%,1
新北市,淡水區,0123,807,228,1035,71,1106,2123,52.1%,38.01%,1
新北市,淡水區,0124,1050,199,1249,32,1281,2998,42.73%,35.02%,1
新北市,汐止區,2336,598,170,768,87,855,1595,53.61%,37.49%,1
新北市,汐止區,2337,515,138,653,53,706,1262,55.94%,40.81%,1
新北市,汐止區,2338,352,119,471,70,541,917,59%,38.39%,1
新北市,汐止區,2339,774,226,1000,66,1066,1929,55.26%,40.12%,1
新北市,汐止區,2340,844,257,1101,77,1178,2227,52.9%,37.9%,1
新北市,汐止區,2341,409,174,583,62,645,1143,56.43%,35.78%,1
新北市,汐止區,2342,554,155,709,43,752,1367,55.01%,40.53%,1
新北市,汐止區,2343,110,42,152,21,173,322,53.73%,34.16%,1
新北市,汐止區,2344,576,200,776,4,780,1460,53.42%,39.45%,1
新北市,汐止區,2345,593,211,804,71,875,1719,50.9%,34.5%,1
新北市,汐止區,2346,589,173,762,65,827,1661,49.79%,35.46%,1
新北市,汐止區,2347,644,183,827,73,900,1590,56.6%,40.5%,1
新北市,汐止區,2348,645,171,816,55,871,1599,54.47%,40.34%,1
新北市,汐止區,2349,718,185,903,66,969,1749,55.4%,41.05%,1
新北市,汐止區,2350,225,101,326,30,356,1809,19.68%,12.44%,1
新北市,汐止區,2351,524,172,696,34,730,1601,45.6%,32.73%,1
新北市,汐止區,2352,527,140,667,71,738,1387,53.21%,38%,1
新北市,汐止區,2353,679,321,1000,94,1094,1779,61.5%,38.17%,1
新北市,汐止區,2354,851,228,1079,77,1156,2074,55.74%,41.03%,1
新北市,汐止區,2355,824,232,1056,54,1110,2072,53.57%,39.77%,1
新北市,汐止區,2356,884,280,1164,65,1229,2120,57.97%,41.7%,1
新北市,汐止區,2357,674,231,905,45,950,1952,48.67%,34.53%,1
新北市,汐止區,2358,610,190,800,78,878,1654,53.08%,36.88%,1
新北市,汐止區,2359,527,162,689,68,757,1444,52.42%,36.5%,1
新北市,汐止區,2360,700,210,910,51,961,1627,59.07%,43.02%,1
新北市,汐止區,2361,639,206,845,64,909,1751,51.91%,36.49%,1
新北市,汐止區,2362,824,210,1034,49,1083,2066,52.42%,39.88%,1
新北市,汐止區,2363,651,160,811,58,869,1941,44.77%,33.54%,1
新北市,汐止區,2364,666,194,860,51,911,1906,47.8%,34.94%,1
新北市,汐止區,2365,468,179,647,71,718,1363,52.68%,34.34%,1
新北市,汐止區,2366,459,176,635,58,693,1368,50.66%,33.55%,1
新北市,汐止區,2367,407,153,560,51,611,1233,49.55%,33.01%,1
新北市,汐止區,2368,579,152,731,32,763,1554,49.1%,37.26%,1
新北市,汐止區,2369,616,187,803,40,843,1700,49.59%,36.24%,1
新北市,汐止區,2370,475,123,598,30,628,1124,55.87%,42.26%,1
新北市,汐止區,2371,773,225,998,85,1083,1900,57%,40.68%,1
新北市,汐止區,2372,826,201,1027,65,1092,2050,53.27%,40.29%,1
新北市,汐止區,2373,459,145,604,59,663,1244,53.3%,36.9%,1
新北市,汐止區,2374,471,147,618,43,661,1320,50.08%,35.68%,1
新北市,汐止區,2375,594,179,773,52,825,1473,56.01%,40.33%,1
新北市,汐止區,2376,730,192,922,70,992,1802,55.05%,40.51%,1
新北市,汐止區,2377,580,114,694,44,738,1266,58.29%,45.81%,1
新北市,汐止區,2378,505,169,674,65,739,1481,49.9%,34.1%,1
新北市,汐止區,2379,533,169,702,70,772,1497,51.57%,35.6%,1
新北市,汐止區,2380,224,60,284,19,303,556,54.5%,40.29%,1
新北市,汐止區,2381,698,195,893,63,956,1913,49.97%,36.49%,1
新北市,汐止區,2382,769,189,958,55,1013,2027,49.98%,37.94%,1
新北市,汐止區,2383,718,188,906,38,944,1927,48.99%,37.26%,1
新北市,汐止區,2384,245,98,343,46,389,696,55.89%,35.2%,1
新北市,汐止區,2385,764,213,977,73,1050,2127,49.37%,35.92%,1
新北市,汐止區,2386,548,161,709,56,765,1642,46.59%,33.37%,1
新北市,汐止區,2387,671,234,905,91,996,1912,52.09%,35.09%,1
新北市,汐止區,2388,634,191,825,51,876,1893,46.28%,33.49%,1
新北市,汐止區,2389,481,154,635,76,711,1466,48.5%,32.81%,1
新北市,汐止區,2390,552,155,707,83,790,1538,51.37%,35.89%,1
新北市,汐止區,2391,568,162,730,52,782,1550,50.45%,36.65%,1
新北市,汐止區,2392,509,151,660,72,732,1456,50.27%,34.96%,1
新北市,汐止區,2393,403,111,514,58,572,947,60.4%,42.56%,1
新北市,汐止區,2394,360,123,483,27,510,923,55.25%,39%,1
新北市,汐止區,2395,673,225,898,128,1026,2043,50.22%,32.94%,1
新北市,汐止區,2396,630,247,877,81,958,2012,47.61%,31.31%,1
新北市,汐止區,2397,500,125,625,40,665,1471,45.21%,33.99%,1
新北市,汐止區,2398,582,169,751,63,814,1603,50.78%,36.31%,1
新北市,汐止區,2399,586,179,765,59,824,1530,53.86%,38.3%,1
新北市,汐止區,2400,604,206,810,43,853,1988,42.91%,30.38%,1
新北市,汐止區,2401,802,232,1034,55,1089,2198,49.55%,36.49%,1
新北市,汐止區,2402,628,177,805,61,866,1712,50.58%,36.68%,1
新北市,汐止區,2403,730,201,931,74,1005,1806,55.65%,40.42%,1
新北市,汐止區,2404,597,171,768,77,845,1576,53.62%,37.88%,1
新北市,汐止區,2405,581,161,742,34,776,1511,51.36%,38.45%,1
新北市,汐止區,2406,591,171,762,38,800,1691,47.31%,34.95%,1
新北市,汐止區,2407,641,174,815,51,866,1636,52.93%,39.18%,1
新北市,汐止區,2408,626,172,798,63,861,1676,51.37%,37.35%,1
新北市,汐止區,2409,479,125,604,50,654,1264,51.74%,37.9%,1
新北市,汐止區,2410,435,125,560,39,599,1165,51.42%,37.34%,1
新北市,汐止區,2411,631,198,829,59,888,1765,50.31%,35.75%,1
新北市,汐止區,2412,571,175,746,43,789,1815,43.47%,31.46%,1
新北市,汐止區,2413,603,205,808,71,879,1778,49.44%,33.91%,1
新北市,汐止區,2414,619,171,790,82,872,1580,55.19%,39.18%,1
新北市,汐止區,2415,569,183,752,54,806,1516,53.17%,37.53%,1
新北市,汐止區,2416,496,154,650,60,710,1425,49.82%,34.81%,1
新北市,汐止區,2417,557,157,714,44,758,1388,54.61%,40.13%,1
新北市,汐止區,2418,530,182,712,64,776,1436,54.04%,36.91%,1
新北市,汐止區,2419,611,184,795,44,839,1591,52.73%,38.4%,1
新北市,汐止區,2420,607,163,770,41,811,1639,49.48%,37.03%,1
新北市,汐止區,2421,516,142,658,26,684,1394,49.07%,37.02%,1
新北市,汐止區,2422,701,227,928,58,986,2035,48.45%,34.45%,1
新北市,汐止區,2423,688,198,886,69,955,1895,50.4%,36.31%,1
新北市,汐止區,2424,622,130,752,22,774,1374,56.33%,45.27%,1
新北市,汐止區,2425,484,116,600,26,626,1061,59%,45.62%,1
新北市,汐止區,2426,651,147,798,30,828,1312,63.11%,49.62%,1
新北市,汐止區,2427,635,173,808,45,853,1548,55.1%,41.02%,1
新北市,汐止區,2428,587,153,740,33,773,1350,57.26%,43.48%,1
新北市,汐止區,2429,599,176,775,39,814,1499,54.3%,39.96%,1
新北市,汐止區,2430,556,158,714,72,786,1366,57.54%,40.7%,1
新北市,汐止區,2431,542,153,695,70,765,1335,57.3%,40.6%,1
新北市,汐止區,2432,597,149,746,61,807,1324,60.95%,45.09%,1
新北市,汐止區,2433,534,161,695,86,781,1286,60.73%,41.52%,1
新北市,汐止區,2434,439,147,586,50,636,1155,55.06%,38.01%,1
新北市,汐止區,2435,767,219,986,49,1035,1682,61.53%,45.6%,1
新北市,汐止區,2436,693,174,867,64,931,1494,62.32%,46.39%,1
新北市,汐止區,2437,443,186,629,68,697,1166,59.78%,37.99%,1
新北市,汐止區,2438,816,263,1079,124,1203,2184,55.08%,37.36%,1
新北市,汐止區,2439,780,229,1009,95,1104,2031,54.36%,38.4%,1
新北市,汐止區,2440,688,203,891,81,972,1759,55.26%,39.11%,1
新北市,汐止區,2441,637,194,831,61,892,1577,56.56%,40.39%,1
新北市,汐止區,2442,534,159,693,18,711,1364,52.13%,39.15%,1
新北市,汐止區,2443,582,161,743,42,785,1401,56.03%,41.54%,1
新北市,汐止區,2444,482,159,641,52,693,1173,59.08%,41.09%,1
新北市,汐止區,2445,456,98,554,26,580,993,58.41%,45.92%,1
新北市,汐止區,2446,634,162,796,36,832,1587,52.43%,39.95%,1
新北市,瑞芳區,2220,302,82,384,35,419,725,57.79%,41.66%,1
新北市,瑞芳區,2221,431,120,551,53,604,1074,56.24%,40.13%,1
新北市,瑞芳區,2222,322,79,401,20,421,825,51.03%,39.03%,1
新北市,瑞芳區,2223,479,139,618,38,656,1242,52.82%,38.57%,1
新北市,瑞芳區,2224,241,56,297,31,328,598,54.85%,40.3%,1
新北市,瑞芳區,2225,337,89,426,42,468,872,53.67%,38.65%,1
新北市,瑞芳區,2226,254,73,327,39,366,760,48.16%,33.42%,1
新北市,瑞芳區,2227,463,119,582,37,619,1330,46.54%,34.81%,1
新北市,瑞芳區,2228,535,176,711,73,784,1683,46.58%,31.79%,1
新北市,瑞芳區,2229,368,107,475,45,520,980,53.06%,37.55%,1
新北市,瑞芳區,2230,344,110,454,47,501,946,52.96%,36.36%,1
新北市,瑞芳區,2231,465,105,570,28,598,1375,43.49%,33.82%,1
新北市,瑞芳區,2232,623,158,781,40,821,1671,49.13%,37.28%,1
新北市,瑞芳區,2233,307,84,391,28,419,978,42.84%,31.39%,1
新北市,瑞芳區,2234,205,81,286,29,315,645,48.84%,31.78%,1
新北市,瑞芳區,2235,372,131,503,59,562,1089,51.61%,34.16%,1
新北市,瑞芳區,2236,84,22,106,15,121,286,42.31%,29.37%,1
新北市,瑞芳區,2237,147,52,199,31,230,461,49.89%,31.89%,1
新北市,瑞芳區,2238,91,24,115,22,137,274,50%,33.21%,1
新北市,瑞芳區,2239,60,22,82,11,93,155,60%,38.71%,1
新北市,瑞芳區,2240,316,94,410,40,450,817,55.08%,38.68%,1
新北市,瑞芳區,2241,326,89,415,55,470,884,53.17%,36.88%,1
新北市,瑞芳區,2242,442,142,584,49,633,1333,47.49%,33.16%,1
新北市,瑞芳區,2243,189,35,224,7,231,607,38.06%,31.14%,1
新北市,瑞芳區,2244,395,109,504,36,540,1045,51.67%,37.8%,1
新北市,瑞芳區,2245,265,54,319,45,364,673,54.09%,39.38%,1
新北市,瑞芳區,2246,173,49,222,12,234,618,37.86%,27.99%,1
新北市,瑞芳區,2247,379,92,471,25,496,1063,46.66%,35.65%,1
新北市,瑞芳區,2248,321,97,418,47,465,860,54.07%,37.33%,1
新北市,瑞芳區,2249,102,23,125,6,131,432,30.32%,23.61%,1
新北市,瑞芳區,2250,130,32,162,8,170,445,38.2%,29.21%,1
新北市,瑞芳區,2251,106,19,125,9,134,318,42.14%,33.33%,1
新北市,瑞芳區,2252,53,14,67,10,77,159,48.43%,33.33%,1
新北市,瑞芳區,2253,101,27,128,17,145,337,43.03%,29.97%,1
新北市,瑞芳區,2254,67,20,87,11,98,180,54.44%,37.22%,1
新北市,瑞芳區,2255,56,10,66,15,81,187,43.32%,29.95%,1
新北市,瑞芳區,2256,128,39,167,24,191,369,51.76%,34.69%,1
新北市,瑞芳區,2257,115,47,162,24,186,335,55.52%,34.33%,1
新北市,瑞芳區,2258,131,51,182,18,200,470,42.55%,27.87%,1
新北市,瑞芳區,2259,80,29,109,7,116,297,39.06%,26.94%,1
新北市,瑞芳區,2260,133,28,161,3,164,267,61.42%,49.81%,1
新北市,瑞芳區,2261,161,49,210,11,221,876,25.23%,18.38%,1
新北市,瑞芳區,2262,299,132,431,31,462,1241,37.23%,24.09%,1
新北市,瑞芳區,2263,310,158,468,62,530,998,53.11%,31.06%,1
新北市,瑞芳區,2264,295,155,450,50,500,948,52.74%,31.12%,1
新北市,瑞芳區,2265,335,162,497,24,521,1308,39.83%,25.61%,1
新北市,土城區,1775,542,189,731,72,803,1505,53.36%,36.01%,1
新北市,土城區,1776,573,131,704,40,744,1242,59.9%,46.14%,1
新北市,土城區,1777,523,155,678,35,713,1206,59.12%,43.37%,1
新北市,土城區,1778,529,190,719,88,807,1474,54.75%,35.89%,1
新北市,土城區,1779,509,183,692,61,753,1489,50.57%,34.18%,1
新北市,土城區,1780,597,193,790,67,857,1675,51.16%,35.64%,1
新北市,土城區,1781,578,176,754,66,820,1499,54.7%,38.56%,1
新北市,土城區,1782,569,150,719,53,772,1495,51.64%,38.06%,1
新北市,土城區,1783,500,176,676,84,760,1411,53.86%,35.44%,1
新北市,土城區,1784,493,149,642,60,702,1378,50.94%,35.78%,1
新北市,土城區,1785,457,156,613,54,667,1256,53.11%,36.39%,1
新北市,土城區,1786,547,170,717,69,786,1379,57%,39.67%,1
新北市,土城區,1787,494,176,670,67,737,1424,51.76%,34.69%,1
新北市,土城區,1788,539,189,728,57,785,1455,53.95%,37.04%,1
新北市,土城區,1789,495,194,689,47,736,1419,51.87%,34.88%,1
新北市,土城區,1790,594,167,761,41,802,1357,59.1%,43.77%,1
新北市,土城區,1791,581,168,749,50,799,1501,53.23%,38.71%,1
新北市,土城區,1792,452,159,611,82,693,1206,57.46%,37.48%,1
新北市,土城區,1793,498,181,679,50,729,1255,58.09%,39.68%,1
新北市,土城區,1794,677,209,886,83,969,1869,51.85%,36.22%,1
新北市,土城區,1795,484,168,652,42,694,1292,53.72%,37.46%,1
新北市,土城區,1796,521,140,661,33,694,1324,52.42%,39.35%,1
新北市,土城區,1797,502,46,548,65,613,1155,53.07%,43.46%,1
新北市,土城區,1798,443,145,588,63,651,1183,55.03%,37.45%,1
新北市,土城區,1799,361,124,485,52,537,2518,21.33%,14.34%,1
新北市,土城區,1800,467,146,613,48,661,1218,54.27%,38.34%,1
新北市,土城區,1801,468,112,580,69,649,1133,57.28%,41.31%,1
新北市,土城區,1802,329,121,450,41,491,894,54.92%,36.8%,1
新北市,土城區,1803,363,127,490,57,547,931,58.75%,38.99%,1
新北市,土城區,1804,915,163,1078,71,1149,1820,63.13%,50.27%,1
新北市,土城區,1805,505,148,653,34,687,1320,52.05%,38.26%,1
新北市,土城區,1806,454,150,604,47,651,1241,52.46%,36.58%,1
新北市,土城區,1807,541,171,712,60,772,1414,54.6%,38.26%,1
新北市,土城區,1808,566,165,731,52,783,1378,56.82%,41.07%,1
新北市,土城區,1809,584,182,766,60,826,1421,58.13%,41.1%,1
新北市,土城區,1810,534,143,677,43,720,1340,53.73%,39.85%,1
新北市,土城區,1811,477,147,624,54,678,1144,59.27%,41.7%,1
新北市,土城區,1812,496,164,660,63,723,1268,57.02%,39.12%,1
新北市,土城區,1813,458,146,604,83,687,1196,57.44%,38.29%,1
新北市,土城區,1814,551,173,724,54,778,1308,59.48%,42.13%,1
新北市,土城區,1815,490,140,630,41,671,1175,57.11%,41.7%,1
新北市,土城區,1816,475,169,644,60,704,1230,57.24%,38.62%,1
新北市,土城區,1817,502,179,681,87,768,1342,57.23%,37.41%,1
新北市,土城區,1818,510,181,691,53,744,1268,58.68%,40.22%,1
新北市,土城區,1819,522,177,699,75,774,1227,63.08%,42.54%,1
新北市,土城區,1820,501,187,688,91,779,1356,57.45%,36.95%,1
新北市,土城區,1821,587,175,762,71,833,1496,55.68%,39.24%,1
新北市,土城區,1822,500,163,663,82,745,1309,56.91%,38.2%,1
新北市,土城區,1823,444,176,620,73,693,1175,58.98%,37.79%,1
新北市,土城區,1824,458,156,614,78,692,1237,55.94%,37.03%,1
新北市,土城區,1825,494,156,650,68,718,1256,57.17%,39.33%,1
新北市,土城區,1826,494,134,628,37,665,1228,54.15%,40.23%,1
新北市,土城區,1827,439,146,585,80,665,1182,56.26%,37.14%,1
新北市,土城區,1828,600,177,777,57,834,1558,53.53%,38.51%,1
新北市,土城區,1829,458,141,599,63,662,1160,57.07%,39.48%,1
新北市,土城區,1830,501,188,689,72,761,1357,56.08%,36.92%,1
新北市,土城區,1831,490,183,673,116,789,1464,53.89%,33.47%,1
新北市,土城區,1832,464,157,621,73,694,1335,51.99%,34.76%,1
新北市,土城區,1833,487,167,654,89,743,1346,55.2%,36.18%,1
新北市,土城區,1834,591,217,808,57,865,1435,60.28%,41.18%,1
新北市,土城區,1835,582,202,784,68,852,1639,51.98%,35.51%,1
新北市,土城區,1836,683,222,905,74,979,1728,56.66%,39.53%,1
新北市,土城區,1837,559,158,717,40,757,1665,45.47%,33.57%,1
新北市,土城區,1838,546,186,732,76,808,1333,60.62%,40.96%,1
新北市,土城區,1839,649,204,853,53,906,1567,57.82%,41.42%,1
新北市,土城區,1840,590,192,782,84,866,1576,54.95%,37.44%,1
新北市,土城區,1841,585,172,757,69,826,1458,56.65%,40.12%,1
新北市,土城區,1842,594,196,790,80,870,1517,57.35%,39.16%,1
新北市,土城區,1843,630,174,804,43,847,1489,56.88%,42.31%,1
新北市,土城區,1844,611,183,794,45,839,1463,57.35%,41.76%,1
新北市,土城區,1845,641,180,821,31,852,1584,53.79%,40.47%,1
新北市,土城區,1846,580,164,744,53,797,1464,54.44%,39.62%,1
新北市,土城區,1847,639,195,834,68,902,1598,56.45%,39.99%,1
新北市,土城區,1848,545,166,711,88,799,1500,53.27%,36.33%,1
新北市,土城區,1849,620,171,791,48,839,1542,54.41%,40.21%,1
新北市,土城區,1850,678,205,883,85,968,1619,59.79%,41.88%,1
新北市,土城區,1851,539,168,707,40,747,1521,49.11%,35.44%,1
新北市,土城區,1852,647,212,859,43,902,1691,53.34%,38.26%,1
新北市,土城區,1853,638,184,822,57,879,1657,53.05%,38.5%,1
新北市,土城區,1854,751,227,978,48,1026,1772,57.9%,42.38%,1
新北市,土城區,1855,583,175,758,20,778,1423,54.67%,40.97%,1
新北市,土城區,1856,575,200,775,52,827,1321,62.6%,43.53%,1
新北市,土城區,1857,591,215,806,59,865,1429,60.53%,41.36%,1
新北市,土城區,1858,529,186,715,59,774,1445,53.56%,36.61%,1
新北市,土城區,1859,638,184,822,58,880,1520,57.89%,41.97%,1
新北市,土城區,1860,518,125,643,29,672,1484,45.28%,34.91%,1
新北市,土城區,1861,519,166,685,40,725,1362,53.23%,38.11%,1
新北市,土城區,1862,485,149,634,40,674,1262,53.41%,38.43%,1
新北市,土城區,1863,547,175,722,47,769,1343,57.26%,40.73%,1
新北市,土城區,1864,394,209,603,52,655,1337,48.99%,29.47%,1
新北市,土城區,1865,397,139,536,56,592,1325,44.68%,29.96%,1
新北市,土城區,1866,485,170,655,52,707,1390,50.86%,34.89%,1
新北市,土城區,1867,587,164,751,79,830,1534,54.11%,38.27%,1
新北市,土城區,1868,535,167,702,86,788,1484,53.1%,36.05%,1
新北市,土城區,1869,559,153,712,86,798,1532,52.09%,36.49%,1
新北市,土城區,1870,605,156,761,83,844,1507,56.01%,40.15%,1
新北市,土城區,1871,632,173,805,64,869,1550,56.06%,40.77%,1
新北市,土城區,1872,632,173,805,53,858,1567,54.75%,40.33%,1
新北市,土城區,1873,569,159,728,51,779,1367,56.99%,41.62%,1
新北市,土城區,1874,498,135,633,62,695,1293,53.75%,38.52%,1
新北市,土城區,1875,530,185,715,73,788,1402,56.21%,37.8%,1
新北市,土城區,1876,531,161,692,62,754,1379,54.68%,38.51%,1
新北市,土城區,1877,550,156,706,49,755,1471,51.33%,37.39%,1
新北市,土城區,1878,549,149,698,49,747,1410,52.98%,38.94%,1
新北市,土城區,1879,575,197,772,64,836,1542,54.22%,37.29%,1
新北市,土城區,1880,462,164,626,57,683,1238,55.17%,37.32%,1
新北市,土城區,1881,492,129,621,55,676,1301,51.96%,37.82%,1
新北市,土城區,1882,623,172,795,45,840,1311,64.07%,47.52%,1
新北市,土城區,1883,537,157,694,37,731,1511,48.38%,35.54%,1
新北市,土城區,1884,541,195,736,76,812,1531,53.04%,35.34%,1
新北市,土城區,1885,598,193,791,69,860,1638,52.5%,36.51%,1
新北市,土城區,1886,538,198,736,52,788,1335,59.03%,40.3%,1
新北市,土城區,1887,586,165,751,53,804,1459,55.11%,40.16%,1
新北市,土城區,1888,578,198,776,33,809,1489,54.33%,38.82%,1
新北市,土城區,1889,726,181,907,31,938,1774,52.87%,40.92%,1
新北市,土城區,1890,727,198,925,52,977,1792,54.52%,40.57%,1
新北市,土城區,1891,741,182,923,68,991,1798,55.12%,41.21%,1
新北市,土城區,1892,485,149,634,68,702,1312,53.51%,36.97%,1
新北市,土城區,1893,476,145,621,57,678,1301,52.11%,36.59%,1
新北市,土城區,1894,442,167,609,54,663,1254,52.87%,35.25%,1
新北市,土城區,1895,431,141,572,47,619,1215,50.95%,35.47%,1
新北市,土城區,1896,545,162,707,66,773,1448,53.38%,37.64%,1
新北市,土城區,1897,474,166,640,69,709,1321,53.67%,35.88%,1
新北市,土城區,1898,376,144,520,82,602,1150,52.35%,32.7%,1
新北市,土城區,1899,452,187,639,59,698,1425,48.98%,31.72%,1
新北市,土城區,1900,534,205,739,75,814,1366,59.59%,39.09%,1
新北市,土城區,1901,520,155,675,55,730,1292,56.5%,40.25%,1
新北市,土城區,1902,495,147,642,71,713,1317,54.14%,37.59%,1
新北市,土城區,1903,543,154,697,60,757,1324,57.18%,41.01%,1
新北市,土城區,1904,460,143,603,57,660,1189,55.51%,38.69%,1
新北市,土城區,1905,467,162,629,79,708,1223,57.89%,38.18%,1
新北市,土城區,1906,594,177,771,57,828,1550,53.42%,38.32%,1
新北市,土城區,1907,636,189,825,85,910,1606,56.66%,39.6%,1
新北市,土城區,1908,587,190,777,52,829,1509,54.94%,38.9%,1
新北市,土城區,1909,579,176,755,69,824,1529,53.89%,37.87%,1
新北市,土城區,1910,506,167,673,93,766,1458,52.54%,34.71%,1
新北市,土城區,1911,548,197,745,86,831,1468,56.61%,37.33%,1
新北市,土城區,1912,555,193,748,53,801,1495,53.58%,37.12%,1
新北市,土城區,1913,487,182,669,71,740,1303,56.79%,37.38%,1
新北市,土城區,1914,517,188,705,61,766,1365,56.12%,37.88%,1
新北市,土城區,1915,563,166,729,91,820,1476,55.56%,38.14%,1
新北市,土城區,1916,646,127,773,39,812,1519,53.46%,42.53%,1
新北市,蘆洲區,0555,572,229,801,110,911,1600,56.94%,35.75%,1
新北市,蘆洲區,0556,561,217,778,79,857,1549,55.33%,36.22%,1
新北市,蘆洲區,0557,587,201,788,101,889,1516,58.64%,38.72%,1
新北市,蘆洲區,0558,524,155,679,95,774,1404,55.13%,37.32%,1
新北市,蘆洲區,0559,473,179,652,99,751,1381,54.38%,34.25%,1
新北市,蘆洲區,0560,627,159,786,52,838,1485,56.43%,42.22%,1
新北市,蘆洲區,0561,489,154,643,50,693,1779,38.95%,27.49%,1
新北市,蘆洲區,0562,652,239,891,68,959,1797,53.37%,36.28%,1
新北市,蘆洲區,0563,526,183,709,79,788,1364,57.77%,38.56%,1
新北市,蘆洲區,0564,642,194,836,79,915,1635,55.96%,39.27%,1
新北市,蘆洲區,0565,498,178,676,56,732,1567,46.71%,31.78%,1
新北市,蘆洲區,0566,563,188,751,57,808,1524,53.02%,36.94%,1
新北市,蘆洲區,0567,551,195,746,81,827,1612,51.3%,34.18%,1
新北市,蘆洲區,0568,613,186,799,73,872,1674,52.09%,36.62%,1
新北市,蘆洲區,0569,649,213,862,78,940,1838,51.14%,35.31%,1
新北市,蘆洲區,0570,562,198,760,55,815,1814,44.93%,30.98%,1
新北市,蘆洲區,0571,519,236,755,55,810,1473,54.99%,35.23%,1
新北市,蘆洲區,0572,565,158,723,70,793,1465,54.13%,38.57%,1
新北市,蘆洲區,0573,622,229,851,98,949,1652,57.45%,37.65%,1
新北市,蘆洲區,0574,597,201,798,104,902,1650,54.67%,36.18%,1
新北市,蘆洲區,0575,677,188,865,57,922,1656,55.68%,40.88%,1
新北市,蘆洲區,0576,524,227,751,68,819,1571,52.13%,33.35%,1
新北市,蘆洲區,0577,523,210,733,86,819,1523,53.78%,34.34%,1
新北市,蘆洲區,0578,584,173,757,55,812,1475,55.05%,39.59%,1
新北市,蘆洲區,0579,497,147,644,79,723,1367,52.89%,36.36%,1
新北市,蘆洲區,0580,598,187,785,69,854,1514,56.41%,39.5%,1
新北市,蘆洲區,0581,709,277,986,62,1048,1791,58.51%,39.59%,1
新北市,蘆洲區,0582,775,194,969,68,1037,1714,60.5%,45.22%,1
新北市,蘆洲區,0583,741,222,963,44,1007,1780,56.57%,41.63%,1
新北市,蘆洲區,0584,713,204,917,55,972,1713,56.74%,41.62%,1
新北市,蘆洲區,0585,719,217,936,53,989,1720,57.5%,41.8%,1
新北市,蘆洲區,0586,714,202,916,56,972,1766,55.04%,40.43%,1
新北市,蘆洲區,0587,627,177,804,79,883,1623,54.41%,38.63%,1
新北市,蘆洲區,0588,670,221,891,58,949,1740,54.54%,38.51%,1
新北市,蘆洲區,0589,717,221,938,77,1015,1759,57.7%,40.76%,1
新北市,蘆洲區,0590,686,253,939,85,1024,1775,57.69%,38.65%,1
新北市,蘆洲區,0591,750,260,1010,79,1089,1909,57.05%,39.29%,1
新北市,蘆洲區,0592,694,256,950,100,1050,1805,58.17%,38.45%,1
新北市,蘆洲區,0593,596,212,808,59,867,1642,52.8%,36.3%,1
新北市,蘆洲區,0594,633,212,845,64,909,1713,53.06%,36.95%,1
新北市,蘆洲區,0595,592,224,816,79,895,1746,51.26%,33.91%,1
新北市,蘆洲區,0596,596,210,806,70,876,1596,54.89%,37.34%,1
新北市,蘆洲區,0597,521,170,691,64,755,1434,52.65%,36.33%,1
新北市,蘆洲區,0598,519,200,719,75,794,1450,54.76%,35.79%,1
新北市,蘆洲區,0599,529,196,725,30,755,1543,48.93%,34.28%,1
新北市,蘆洲區,0600,593,169,762,57,819,1525,53.7%,38.89%,1
新北市,蘆洲區,0601,491,164,655,78,733,1419,51.66%,34.6%,1
新北市,蘆洲區,0602,509,173,682,58,740,1298,57.01%,39.21%,1
新北市,蘆洲區,0603,466,165,631,76,707,1304,54.22%,35.74%,1
新北市,蘆洲區,0604,646,235,881,80,961,1806,53.21%,35.77%,1
新北市,蘆洲區,0605,672,241,913,81,994,1910,52.04%,35.18%,1
新北市,蘆洲區,0606,597,184,781,80,861,1873,45.97%,31.87%,1
新北市,蘆洲區,0607,586,198,784,58,842,1785,47.17%,32.83%,1
新北市,蘆洲區,0608,570,224,794,73,867,1760,49.26%,32.39%,1
新北市,蘆洲區,0609,732,207,939,81,1020,1841,55.4%,39.76%,1
新北市,蘆洲區,0610,669,185,854,47,901,1855,48.57%,36.06%,1
新北市,蘆洲區,0611,480,165,645,85,730,1450,50.34%,33.1%,1
新北市,蘆洲區,0612,554,188,742,83,825,1585,52.05%,34.95%,1
新北市,蘆洲區,0613,492,180,672,110,782,1541,50.75%,31.93%,1
新北市,蘆洲區,0614,578,206,784,82,866,1626,53.26%,35.55%,1
新北市,蘆洲區,0615,474,167,641,73,714,1241,57.53%,38.2%,1
新北市,蘆洲區,0616,590,217,807,76,883,1634,54.04%,36.11%,1
新北市,蘆洲區,0617,607,179,786,81,867,1573,55.12%,38.59%,1
新北市,蘆洲區,0618,609,237,846,64,910,1619,56.21%,37.62%,1
新北市,蘆洲區,0619,687,220,907,108,1015,1878,54.05%,36.58%,1
新北市,蘆洲區,0620,642,231,873,97,970,1797,53.98%,35.73%,1
新北市,蘆洲區,0621,715,250,965,46,1011,1816,55.67%,39.37%,1
新北市,蘆洲區,0622,520,187,707,92,799,1344,59.45%,38.69%,1
新北市,蘆洲區,0623,545,242,787,74,861,1492,57.71%,36.53%,1
新北市,蘆洲區,0624,674,240,914,135,1049,1959,53.55%,34.41%,1
新北市,蘆洲區,0625,558,215,773,110,883,1611,54.81%,34.64%,1
新北市,蘆洲區,0626,698,131,829,88,917,1574,58.26%,44.35%,1
新北市,蘆洲區,0627,627,205,832,85,917,1653,55.47%,37.93%,1
新北市,蘆洲區,0628,735,240,975,81,1056,3085,34.23%,23.82%,1
新北市,蘆洲區,0629,632,253,885,83,968,1812,53.42%,34.88%,1
新北市,蘆洲區,0630,478,183,661,70,731,1332,54.88%,35.89%,1
新北市,蘆洲區,0631,510,196,706,98,804,1648,48.79%,30.95%,1
新北市,蘆洲區,0632,486,165,651,37,688,1355,50.77%,35.87%,1
新北市,蘆洲區,0633,470,183,653,48,701,1371,51.13%,34.28%,1
新北市,蘆洲區,0634,385,175,560,76,636,1111,57.25%,34.65%,1
新北市,蘆洲區,0635,432,176,608,88,696,1176,59.18%,36.73%,1
新北市,蘆洲區,0636,592,218,810,73,883,1602,55.12%,36.95%,1
新北市,蘆洲區,0637,449,188,637,57,694,1361,50.99%,32.99%,1
新北市,蘆洲區,0638,568,185,753,27,780,1530,50.98%,37.12%,1
新北市,蘆洲區,0639,331,113,444,83,527,925,56.97%,35.78%,1
新北市,蘆洲區,0640,681,233,914,96,1010,1851,54.57%,36.79%,1
新北市,蘆洲區,0641,608,197,805,69,874,1791,48.8%,33.95%,1
新北市,蘆洲區,0642,616,219,835,83,918,1853,49.54%,33.24%,1
新北市,蘆洲區,0643,573,209,782,52,834,1758,47.44%,32.59%,1
新北市,蘆洲區,0644,659,219,878,90,968,1798,53.84%,36.65%,1
新北市,蘆洲區,0645,637,196,833,60,893,1645,54.29%,38.72%,1
新北市,蘆洲區,0646,539,178,717,73,790,1612,49.01%,33.44%,1
新北市,蘆洲區,0647,582,177,759,95,854,1784,47.87%,32.62%,1
新北市,蘆洲區,0648,526,187,713,75,788,1701,46.33%,30.92%,1
新北市,蘆洲區,0649,580,184,764,46,810,1581,51.23%,36.69%,1
新北市,蘆洲區,0650,565,217,782,58,840,1534,54.76%,36.83%,1
新北市,蘆洲區,0651,605,233,838,88,926,1620,57.16%,37.35%,1
新北市,蘆洲區,0652,601,198,799,87,886,1494,59.3%,40.23%,1
新北市,蘆洲區,0653,463,141,604,53,657,1183,55.54%,39.14%,1
新北市,蘆洲區,0654,322,187,509,56,565,985,57.36%,32.69%,1
新北市,蘆洲區,0655,562,212,774,92,866,1673,51.76%,33.59%,1
新北市,蘆洲區,0656,617,210,827,115,942,1688,55.81%,36.55%,1
新北市,蘆洲區,0657,575,153,728,55,783,1249,62.69%,46.04%,1
新北市,蘆洲區,0658,524,171,695,81,776,1476,52.57%,35.5%,1
新北市,五股區,0207,479,205,684,109,793,1456,54.46%,32.9%,1
新北市,五股區,0208,515,182,697,87,784,1482,52.9%,34.75%,1
新北市,五股區,0209,460,197,657,65,722,1287,56.1%,35.74%,1
新北市,五股區,0210,320,193,513,39,552,1106,49.91%,28.93%,1
新北市,五股區,0211,421,162,583,93,676,1283,52.69%,32.81%,1
新北市,五股區,0212,615,239,854,64,918,1833,50.08%,33.55%,1
新北市,五股區,0213,463,132,595,60,655,1141,57.41%,40.58%,1
新北市,五股區,0214,177,69,246,37,283,463,61.12%,38.23%,1
新北市,五股區,0215,677,201,878,68,946,1786,52.97%,37.91%,1
新北市,五股區,0216,556,246,802,43,845,1660,50.9%,33.49%,1
新北市,五股區,0217,549,203,752,93,845,1534,55.08%,35.79%,1
新北市,五股區,0218,471,153,624,101,725,1285,56.42%,36.65%,1
新北市,五股區,0219,607,224,831,134,965,1832,52.67%,33.13%,1
新北市,五股區,0220,562,188,750,45,795,1542,51.56%,36.45%,1
新北市,五股區,0221,585,207,792,60,852,1897,44.91%,30.84%,1
新北市,五股區,0222,618,215,833,124,957,1964,48.73%,31.47%,1
新北市,五股區,0223,582,214,796,89,885,1779,49.75%,32.72%,1
新北市,五股區,0224,597,199,796,98,894,1735,51.53%,34.41%,1
新北市,五股區,0225,822,243,1065,57,1122,2299,48.8%,35.75%,1
新北市,五股區,0226,581,195,776,68,844,1755,48.09%,33.11%,1
新北市,五股區,0227,645,203,848,78,926,1674,55.32%,38.53%,1
新北市,五股區,0228,596,226,822,94,916,1661,55.15%,35.88%,1
新北市,五股區,0229,385,166,551,47,598,1281,46.68%,30.05%,1
新北市,五股區,0230,564,189,753,90,843,1566,53.83%,36.02%,1
新北市,五股區,0231,497,158,655,40,695,1560,44.55%,31.86%,1
新北市,五股區,0232,602,198,800,51,851,1622,52.47%,37.11%,1
新北市,五股區,0233,700,198,898,50,948,1779,53.29%,39.35%,1
新北市,五股區,0234,512,172,684,86,770,1487,51.78%,34.43%,1
新北市,五股區,0235,620,182,802,56,858,1567,54.75%,39.57%,1
新北市,五股區,0236,347,127,474,42,516,1333,38.71%,26.03%,1
新北市,五股區,0237,501,200,701,66,767,1263,60.73%,39.67%,1
新北市,五股區,0238,497,179,676,82,758,1314,57.69%,37.82%,1
新北市,五股區,0239,544,165,709,41,750,1513,49.57%,35.96%,1
新北市,五股區,0240,603,171,774,46,820,1517,54.05%,39.75%,1
新北市,五股區,0241,570,221,791,80,871,1613,54%,35.34%,1
新北市,五股區,0242,605,182,787,82,869,1616,53.77%,37.44%,1
新北市,五股區,0243,579,205,784,81,865,1616,53.53%,35.83%,1
新北市,五股區,0244,625,212,837,79,916,1689,54.23%,37%,1
新北市,五股區,0245,709,198,907,38,945,1894,49.89%,37.43%,1
新北市,五股區,0246,513,177,690,72,762,1210,62.98%,42.4%,1
新北市,五股區,0247,586,190,776,70,846,1643,51.49%,35.67%,1
新北市,五股區,0248,549,153,702,33,735,1441,51.01%,38.1%,1
新北市,五股區,0249,548,143,691,61,752,1305,57.62%,41.99%,1
新北市,五股區,0250,492,166,658,62,720,1170,61.54%,42.05%,1
新北市,五股區,0251,646,144,790,61,851,1397,60.92%,46.24%,1
新北市,五股區,0252,595,115,710,70,780,1312,59.45%,45.35%,1
新北市,五股區,0253,460,81,541,32,573,1127,50.84%,40.82%,1
新北市,五股區,0254,487,70,557,44,601,1154,52.08%,42.2%,1
新北市,泰山區,0255,213,78,291,33,324,643,50.39%,33.13%,1
新北市,泰山區,0256,89,19,108,6,114,186,61.29%,47.85%,1
新北市,泰山區,0257,502,173,675,52,727,1457,49.9%,34.45%,1
新北市,泰山區,0258,626,189,815,73,888,1594,55.71%,39.27%,1
新北市,泰山區,0259,598,142,740,64,804,1598,50.31%,37.42%,1
新北市,泰山區,0260,550,150,700,47,747,1503,49.7%,36.59%,1
新北市,泰山區,0261,522,150,672,77,749,1436,52.16%,36.35%,1
新北市,泰山區,0262,518,185,703,59,762,1384,55.06%,37.43%,1
新北市,泰山區,0263,478,151,629,59,688,1231,55.89%,38.83%,1
新北市,泰山區,0264,456,162,618,36,654,1295,50.5%,35.21%,1
新北市,泰山區,0265,643,181,824,73,897,1563,57.39%,41.14%,1
新北市,泰山區,0266,679,178,857,68,925,1610,57.45%,42.17%,1
新北市,泰山區,0267,478,156,634,40,674,1253,53.79%,38.15%,1
新北市,泰山區,0268,464,148,612,52,664,1294,51.31%,35.86%,1
新北市,泰山區,0269,545,196,741,47,788,1354,58.2%,40.25%,1
新北市,泰山區,0270,497,134,631,44,675,1259,53.61%,39.48%,1
新北市,泰山區,0271,504,159,663,32,695,1252,55.51%,40.26%,1
新北市,泰山區,0272,405,123,528,30,558,1094,51.01%,37.02%,1
新北市,泰山區,0273,598,217,815,75,890,1590,55.97%,37.61%,1
新北市,泰山區,0274,579,236,815,92,907,1634,55.51%,35.43%,1
新北市,泰山區,0275,495,182,677,52,729,1536,47.46%,32.23%,1
新北市,泰山區,0276,627,201,828,57,885,1534,57.69%,40.87%,1
新北市,泰山區,0277,715,173,888,60,948,1545,61.36%,46.28%,1
新北市,泰山區,0278,592,133,725,57,782,1399,55.9%,42.32%,1
新北市,泰山區,0279,508,155,663,33,696,1315,52.93%,38.63%,1
新北市,泰山區,0280,612,61,673,61,734,1201,61.12%,50.96%,1
新北市,泰山區,0281,440,146,586,70,656,1182,55.5%,37.23%,1
新北市,泰山區,0282,615,184,799,72,871,1665,52.31%,36.94%,1
新北市,泰山區,0283,698,227,925,84,1009,1855,54.39%,37.63%,1
新北市,泰山區,0284,701,219,920,107,1027,1866,55.04%,37.57%,1
新北市,泰山區,0285,768,200,968,62,1030,1935,53.23%,39.69%,1
新北市,泰山區,0286,589,174,763,53,816,1589,51.35%,37.07%,1
新北市,泰山區,0287,437,116,553,43,596,1152,51.74%,37.93%,1
新北市,泰山區,0288,417,152,569,58,627,1114,56.28%,37.43%,1
新北市,泰山區,0289,461,129,590,57,647,1040,62.21%,44.33%,1
新北市,泰山區,0290,446,109,555,46,601,1003,59.92%,44.47%,1
新北市,泰山區,0291,397,142,539,28,567,975,58.15%,40.72%,1
新北市,泰山區,0292,544,195,739,46,785,1440,54.51%,37.78%,1
新北市,泰山區,0293,555,176,731,27,758,1480,51.22%,37.5%,1
新北市,泰山區,0294,473,154,627,44,671,1211,55.41%,39.06%,1
新北市,泰山區,0295,473,157,630,36,666,1237,53.84%,38.24%,1
新北市,泰山區,0296,414,111,525,51,576,1069,53.88%,38.73%,1
新北市,泰山區,0297,718,203,921,75,996,1680,59.29%,42.74%,1
新北市,泰山區,0298,642,213,855,52,907,1651,54.94%,38.89%,1
新北市,泰山區,0299,524,161,685,38,723,1420,50.92%,36.9%,1
新北市,泰山區,0300,541,169,710,45,755,1337,56.47%,40.46%,1
新北市,泰山區,0301,634,221,855,49,904,1591,56.82%,39.85%,1
新北市,林口區,0145,420,174,594,84,678,1268,53.47%,33.12%,1
新北市,林口區,0146,391,163,554,53,607,1171,51.84%,33.39%,1
新北市,林口區,0147,470,167,637,62,699,1218,57.39%,38.59%,1
新北市,林口區,0148,671,191,862,56,918,1788,51.34%,37.53%,1
新北市,林口區,0149,562,180,742,84,826,1625,50.83%,34.58%,1
新北市,林口區,0150,516,165,681,72,753,1448,52%,35.64%,1
新北市,林口區,0151,461,140,601,84,685,1328,51.58%,34.71%,1
新北市,林口區,0152,496,137,633,73,706,1523,46.36%,32.57%,1
新北市,林口區,0153,506,126,632,51,683,1245,54.86%,40.64%,1
新北市,林口區,0154,636,143,779,47,826,1329,62.15%,47.86%,1
新北市,林口區,0155,633,181,814,42,856,1465,58.43%,43.21%,1
新北市,林口區,0156,583,188,771,34,805,1369,58.8%,42.59%,1
新北市,林口區,0157,509,220,729,57,786,1346,58.4%,37.82%,1
新北市,林口區,0158,404,174,578,71,649,1181,54.95%,34.21%,1
新北市,林口區,0159,559,206,765,31,796,1291,61.66%,43.3%,1
新北市,林口區,0160,458,169,627,47,674,1213,55.56%,37.76%,1
新北市,林口區,0161,528,157,685,48,733,1256,58.36%,42.04%,1
新北市,林口區,0162,406,183,589,55,644,1185,54.35%,34.26%,1
新北市,林口區,0163,509,177,686,51,737,1361,54.15%,37.4%,1
新北市,林口區,0164,737,127,864,32,896,1756,51.03%,41.97%,1
新北市,林口區,0165,662,167,829,33,862,1676,51.43%,39.5%,1
新北市,林口區,0166,675,170,845,24,869,1540,56.43%,43.83%,1
新北市,林口區,0167,658,146,804,49,853,1569,54.37%,41.94%,1
新北市,林口區,0168,641,162,803,34,837,1514,55.28%,42.34%,1
新北市,林口區,0169,538,126,664,29,693,1193,58.09%,45.1%,1
新北市,林口區,0170,702,181,883,34,917,1610,56.96%,43.6%,1
新北市,林口區,0171,582,155,737,37,774,1338,57.85%,43.5%,1
新北市,林口區,0172,467,149,616,37,653,1141,57.23%,40.93%,1
新北市,林口區,0173,529,157,686,52,738,1307,56.47%,40.47%,1
新北市,林口區,0174,571,157,728,33,761,1327,57.35%,43.03%,1
新北市,林口區,0175,551,155,706,36,742,1285,57.74%,42.88%,1
新北市,林口區,0176,588,196,784,48,832,1481,56.18%,39.7%,1
新北市,林口區,0177,638,182,820,32,852,1510,56.42%,42.25%,1
新北市,林口區,0178,719,199,918,48,966,1785,54.12%,40.28%,1
新北市,林口區,0179,710,229,939,33,972,1792,54.24%,39.62%,1
新北市,林口區,0180,652,169,821,38,859,1517,56.62%,42.98%,1
新北市,林口區,0181,691,174,865,35,900,1564,57.54%,44.18%,1
新北市,林口區,0182,701,151,852,43,895,1560,57.37%,44.94%,1
新北市,林口區,0183,635,166,801,38,839,1544,54.34%,41.13%,1
新北市,林口區,0184,665,154,819,38,857,1593,53.8%,41.75%,1
新北市,林口區,0185,605,166,771,31,802,1431,56.04%,42.28%,1
新北市,林口區,0186,607,189,796,48,844,1571,53.72%,38.64%,1
新北市,林口區,0187,614,178,792,42,834,1439,57.96%,42.67%,1
新北市,林口區,0188,608,186,794,48,842,1451,58.03%,41.9%,1
新北市,林口區,0189,596,190,786,53,839,1391,60.32%,42.85%,1
新北市,林口區,0190,611,168,779,33,812,1461,55.58%,41.82%,1
新北市,林口區,0191,682,195,877,33,910,1691,53.81%,40.33%,1
新北市,林口區,0192,597,195,792,55,847,1524,55.58%,39.17%,1
新北市,林口區,0193,630,165,795,43,838,1343,62.4%,46.91%,1
新北市,林口區,0194,635,163,798,40,838,1398,59.94%,45.42%,1
新北市,林口區,0195,590,171,761,56,817,1380,59.2%,42.75%,1
新北市,林口區,0196,533,171,704,62,766,1367,56.04%,38.99%,1
新北市,林口區,0197,523,221,744,31,775,1350,57.41%,38.74%,1
新北市,林口區,0198,498,155,653,45,698,1194,58.46%,41.71%,1
新北市,林口區,0199,498,170,668,68,736,1344,54.76%,37.05%,1
新北市,林口區,0200,465,145,610,43,653,1154,56.59%,40.29%,1
新北市,林口區,0201,502,145,647,46,693,1119,61.93%,44.86%,1
新北市,林口區,0202,309,132,441,60,501,1026,48.83%,30.12%,1
新北市,林口區,0203,420,195,615,58,673,1210,55.62%,34.71%,1
新北市,林口區,0204,327,121,448,65,513,912,56.25%,35.86%,1
新北市,林口區,0205,302,135,437,43,480,824,58.25%,36.65%,1
新北市,林口區,0206,543,194,737,95,832,1411,58.97%,38.48%,1
新北市,深坑區,2163,418,134,552,37,589,1142,51.58%,36.6%,1
新北市,深坑區,2164,456,159,615,53,668,1139,58.65%,40.04%,1
新北市,深坑區,2165,366,145,511,60,571,1065,53.62%,34.37%,1
新北市,深坑區,2166,511,148,659,57,716,1400,51.14%,36.5%,1
新北市,深坑區,2167,482,135,617,57,674,1330,50.68%,36.24%,1
新北市,深坑區,2168,490,149,639,46,685,1380,49.64%,35.51%,1
新北市,深坑區,2169,497,137,634,28,662,1496,44.25%,33.22%,1
新北市,深坑區,2170,618,173,791,71,862,1508,57.16%,40.98%,1
新北市,深坑區,2171,647,208,855,69,924,1624,56.9%,39.84%,1
新北市,深坑區,2172,853,245,1098,64,1162,2165,53.67%,39.4%,1
新北市,深坑區,2173,743,235,978,73,1051,1790,58.72%,41.51%,1
新北市,深坑區,2174,274,84,358,21,379,782,48.47%,35.04%,1
新北市,深坑區,2175,508,131,639,30,669,1164,57.47%,43.64%,1
新北市,深坑區,2176,565,167,732,63,795,1344,59.15%,42.04%,1
新北市,深坑區,2177,324,100,424,31,455,739,61.57%,43.84%,1
新北市,深坑區,2178,240,66,306,33,339,556,60.97%,43.17%,1
新北市,石碇區,2179,160,58,218,22,240,391,61.38%,40.92%,1
新北市,石碇區,2180,276,75,351,47,398,789,50.44%,34.98%,1
新北市,石碇區,2181,187,63,250,26,276,662,41.69%,28.25%,1
新北市,石碇區,2182,101,39,140,15,155,310,50%,32.58%,1
新北市,石碇區,2183,101,34,135,13,148,280,52.86%,36.07%,1
新北市,石碇區,2184,22,11,33,5,38,93,40.86%,23.66%,1
新北市,石碇區,2185,187,74,261,47,308,683,45.1%,27.38%,1
新北市,石碇區,2186,152,41,193,9,202,323,62.54%,47.06%,1
新北市,石碇區,2187,177,69,246,9,255,726,35.12%,24.38%,1
新北市,石碇區,2188,193,88,281,34,315,591,53.3%,32.66%,1
新北市,石碇區,2189,114,51,165,24,189,282,67.02%,40.43%,1
新北市,石碇區,2190,232,65,297,16,313,788,39.72%,29.44%,1
新北市,石碇區,2191,330,161,491,62,553,943,58.64%,34.99%,1
新北市,坪林區,2192,443,138,581,55,636,1248,50.96%,35.5%,1
新北市,坪林區,2193,198,50,248,43,291,612,47.55%,32.35%,1
新北市,坪林區,2194,412,134,546,104,650,1141,56.97%,36.11%,1
新北市,坪林區,2195,106,48,154,7,161,417,38.61%,25.42%,1
新北市,坪林區,2196,209,71,280,51,331,595,55.63%,35.13%,1
新北市,坪林區,2197,104,26,130,22,152,248,61.29%,41.94%,1
新北市,坪林區,2198,110,37,147,15,162,338,47.93%,32.54%,1
新北市,坪林區,2199,149,37,186,21,207,478,43.31%,31.17%,1
新北市,坪林區,2200,102,34,136,11,147,390,37.69%,26.15%,1
新北市,坪林區,2201,124,43,167,27,194,424,45.75%,29.25%,1
新北市,三芝區,0011,106,30,136,12,148,312,47.44%,33.97%,1
新北市,三芝區,0012,521,123,644,40,684,1421,48.14%,36.66%,1
新北市,三芝區,0013,574,168,742,59,801,1557,51.45%,36.87%,1
新北市,三芝區,0014,687,188,875,73,948,1828,51.86%,37.58%,1
新北市,三芝區,0015,370,120,490,50,540,1060,50.94%,34.91%,1
新北市,三芝區,0016,232,90,322,34,356,819,43.47%,28.33%,1
新北市,三芝區,0017,519,156,675,42,717,1701,42.15%,30.51%,1
新北市,三芝區,0018,580,179,759,78,837,1740,48.1%,33.33%,1
新北市,三芝區,0019,451,160,611,52,663,1451,45.69%,31.08%,1
新北市,三芝區,0020,391,125,516,59,575,1248,46.07%,31.33%,1
新北市,三芝區,0021,231,70,301,20,321,629,51.03%,36.72%,1
新北市,三芝區,0022,165,50,215,18,233,504,46.23%,32.74%,1
新北市,三芝區,0023,218,73,291,15,306,698,43.84%,31.23%,1
新北市,三芝區,0024,708,182,890,65,955,2069,46.16%,34.22%,1
新北市,三芝區,0025,287,89,376,38,414,784,52.81%,36.61%,1
新北市,三芝區,0026,160,74,234,29,263,522,50.38%,30.65%,1
新北市,三芝區,0027,176,74,250,53,303,587,51.62%,29.98%,1
新北市,三芝區,0028,366,184,550,51,601,1189,50.55%,30.78%,1
新北市,石門區,0001,376,151,527,52,579,1121,51.65%,33.54%,1
新北市,石門區,0002,440,152,592,78,670,1389,48.24%,31.68%,1
新北市,石門區,0003,330,101,431,61,492,933,52.73%,35.37%,1
新北市,石門區,0004,433,116,549,69,618,1244,49.68%,34.81%,1
新北市,石門區,0005,324,90,414,71,485,883,54.93%,36.69%,1
新北市,石門區,0006,588,167,755,70,825,1564,52.75%,37.6%,1
新北市,石門區,0007,523,207,730,65,795,1500,53%,34.87%,1
新北市,石門區,0008,110,28,138,13,151,328,46.04%,33.54%,1
新北市,石門區,0009,281,81,362,41,403,651,61.9%,43.16%,1
新北市,石門區,0010,291,77,368,43,411,915,44.92%,31.8%,1
新北市,八里區,0125,511,161,672,70,742,1498,49.53%,34.11%,1
新北市,八里區,0126,651,188,839,47,886,1939,45.69%,33.57%,1
新北市,八里區,0127,551,175,726,80,806,1516,53.17%,36.35%,1
新北市,八里區,0128,640,218,858,71,929,1642,56.58%,38.98%,1
新北市,八里區,0129,630,202,832,106,938,1927,48.68%,32.69%,1
新北市,八里區,0130,497,136,633,57,690,1276,54.08%,38.95%,1
新北市,八里區,0131,552,178,730,55,785,1349,58.19%,40.92%,1
新北市,八里區,0132,535,176,711,74,785,1403,55.95%,38.13%,1
新北市,八里區,0133,616,207,823,64,887,1644,53.95%,37.47%,1
新北市,八里區,0134,715,200,915,66,981,1853,52.94%,38.59%,1
新北市,八里區,0135,742,195,937,102,1039,1793,57.95%,41.38%,1
新北市,八里區,0136,598,222,820,63,883,1644,53.71%,36.37%,1
新北市,八里區,0137,682,206,888,76,964,1846,52.22%,36.94%,1
新北市,八里區,0138,484,165,649,70,719,1346,53.42%,35.96%,1
新北市,八里區,0139,603,199,802,69,871,1621,53.73%,37.2%,1
新北市,八里區,0140,656,200,856,86,942,2110,44.64%,31.09%,1
新北市,八里區,0141,674,234,908,92,1000,1967,50.84%,34.27%,1
新北市,八里區,0142,626,204,830,64,894,1626,54.98%,38.5%,1
新北市,八里區,0143,554,201,755,77,832,1514,54.95%,36.59%,1
新北市,八里區,0144,464,274,738,96,834,1456,57.28%,31.87%,1
新北市,平溪區,2208,121,44,165,22,187,384,48.7%,31.51%,1
新北市,平溪區,2209,74,20,94,1,95,232,40.95%,31.9%,1
新北市,平溪區,2210,84,38,122,18,140,249,56.22%,33.73%,1
新北市,平溪區,2211,159,57,216,37,253,458,55.24%,34.72%,1
新北市,平溪區,2212,78,32,110,19,129,232,55.6%,33.62%,1
新北市,平溪區,2213,182,59,241,16,257,635,40.47%,28.66%,1
新北市,平溪區,2214,148,46,194,42,236,427,55.27%,34.66%,1
新北市,平溪區,2215,233,67,300,43,343,862,39.79%,27.03%,1
新北市,平溪區,2216,52,17,69,4,73,147,49.66%,35.37%,1
新北市,平溪區,2217,96,24,120,15,135,365,36.99%,26.3%,1
新北市,平溪區,2218,41,19,60,8,68,153,44.44%,26.8%,1
新北市,平溪區,2219,65,24,89,20,109,177,61.58%,36.72%,1
新北市,雙溪區,2266,158,36,194,21,215,455,47.25%,34.73%,1
新北市,雙溪區,2267,99,35,134,14,148,286,51.75%,34.62%,1
新北市,雙溪區,2268,191,57,248,27,275,496,55.44%,38.51%,1
新北市,雙溪區,2269,116,31,147,13,160,383,41.78%,30.29%,1
新北市,雙溪區,2270,254,78,332,45,377,887,42.5%,28.64%,1
新北市,雙溪區,2271,189,53,242,34,276,652,42.33%,28.99%,1
新北市,雙溪區,2272,119,31,150,17,167,333,50.15%,35.74%,1
新北市,雙溪區,2273,216,75,291,29,320,642,49.84%,33.64%,1
新北市,雙溪區,2274,83,37,120,14,134,282,47.52%,29.43%,1
新北市,雙溪區,2275,176,61,237,32,269,621,43.32%,28.34%,1
新北市,雙溪區,2276,119,36,155,11,166,422,39.34%,28.2%,1
新北市,雙溪區,2277,70,35,105,29,134,369,36.31%,18.97%,1
新北市,雙溪區,2278,48,7,55,10,65,120,54.17%,40%,1
新北市,雙溪區,2279,92,24,116,18,134,271,49.45%,33.95%,1
新北市,雙溪區,2280,142,43,185,27,212,362,58.56%,39.23%,1
新北市,雙溪區,2281,118,41,159,34,193,371,52.02%,31.81%,1
新北市,雙溪區,2282,409,134,543,65,608,1047,58.07%,39.06%,1
新北市,貢寮區,2283,307,84,391,44,435,876,49.66%,35.05%,1
新北市,貢寮區,2284,142,49,191,27,218,433,50.35%,32.79%,1
新北市,貢寮區,2285,142,38,180,16,196,516,37.98%,27.52%,1
新北市,貢寮區,2286,91,34,125,26,151,373,40.48%,24.4%,1
新北市,貢寮區,2287,89,32,121,28,149,313,47.6%,28.43%,1
新北市,貢寮區,2288,173,48,221,14,235,485,48.45%,35.67%,1
新北市,貢寮區,2289,122,54,176,34,210,415,50.6%,29.4%,1
新北市,貢寮區,2290,224,83,307,17,324,812,39.9%,27.59%,1
新北市,貢寮區,2291,259,106,365,47,412,861,47.85%,30.08%,1
新北市,貢寮區,2292,151,79,230,31,261,676,38.61%,22.34%,1
新北市,貢寮區,2293,254,108,362,25,387,1091,35.47%,23.28%,1
新北市,貢寮區,2294,239,95,334,52,386,955,40.42%,25.03%,1
新北市,貢寮區,2295,206,64,270,10,280,769,36.41%,26.79%,1
新北市,貢寮區,2296,294,132,426,38,464,962,48.23%,30.56%,1
新北市,貢寮區,2297,133,47,180,11,191,390,48.97%,34.1%,1
新北市,貢寮區,2298,110,36,146,1,147,349,42.12%,31.52%,1
新北市,貢寮區,2299,124,42,166,31,197,508,38.78%,24.41%,1
新北市,貢寮區,2300,111,36,147,14,161,495,32.53%,22.42%,1
新北市,金山區,2301,184,43,227,35,262,481,54.47%,38.25%,1
新北市,金山區,2302,245,99,344,35,379,715,53.01%,34.27%,1
新北市,金山區,2303,137,47,184,30,214,481,44.49%,28.48%,1
新北市,金山區,2304,581,167,748,78,826,1792,46.09%,32.42%,1
新北市,金山區,2305,621,203,824,85,909,1781,51.04%,34.87%,1
新北市,金山區,2306,753,236,989,81,1070,2010,53.23%,37.46%,1
新北市,金山區,2307,522,183,705,60,765,1572,48.66%,33.21%,1
新北市,金山區,2308,634,188,822,85,907,1777,51.04%,35.68%,1
新北市,金山區,2309,551,154,705,69,774,1631,47.46%,33.78%,1
新北市,金山區,2310,313,83,396,36,432,828,52.17%,37.8%,1
新北市,金山區,2311,303,118,421,29,450,888,50.68%,34.12%,1
新北市,金山區,2312,397,125,522,85,607,1211,50.12%,32.78%,1
新北市,金山區,2313,170,51,221,18,239,416,57.45%,40.87%,1
新北市,金山區,2314,260,91,351,47,398,682,58.36%,38.12%,1
新北市,金山區,2315,227,64,291,57,348,644,54.04%,35.25%,1
新北市,金山區,2316,281,90,371,38,409,830,49.28%,33.86%,1
新北市,金山區,2317,59,28,87,12,99,188,52.66%,31.38%,1
新北市,金山區,2318,163,67,230,29,259,469,55.22%,34.75%,1
新北市,金山區,2319,134,45,179,34,213,582,36.6%,23.02%,1
新北市,萬里區,2320,504,147,651,43,694,1286,53.97%,39.19%,1
新北市,萬里區,2321,601,194,795,65,860,1576,54.57%,38.13%,1
新北市,萬里區,2322,496,141,637,52,689,1447,47.62%,34.28%,1
新北市,萬里區,2323,465,129,594,75,669,1466,45.63%,31.72%,1
新北市,萬里區,2324,400,128,528,58,586,1369,42.8%,29.22%,1
新北市,萬里區,2325,315,101,416,59,475,1215,39.09%,25.93%,1
新北市,萬里區,2326,484,143,627,59,686,1317,52.09%,36.75%,1
新北市,萬里區,2327,510,134,644,73,717,1676,42.78%,30.43%,1
新北市,萬里區,2328,515,143,658,81,739,1550,47.68%,33.23%,1
新北市,萬里區,2329,391,134,525,55,580,945,61.38%,41.38%,1
新北市,萬里區,2330,659,214,873,82,955,1760,54.26%,37.44%,1
新北市,萬里區,2331,204,58,262,24,286,570,50.18%,35.79%,1
新北市,萬里區,2332,275,127,402,41,443,952,46.53%,28.89%,1
新北市,萬里區,2333,247,85,332,63,395,674,58.61%,36.65%,1
新北市,萬里區,2334,144,45,189,19,208,405,51.36%,35.56%,1
新北市,萬里區,2335,369,116,485,65,550,1089,50.51%,33.88%,1
新北市,烏來區,2202,676,191,867,66,933,1568,59.5%,43.11%,1
新北市,烏來區,2203,434,125,559,21,580,1198,48.41%,36.23%,1
新北市,烏來區,2204,411,105,516,30,546,1169,46.71%,35.16%,1
新北市,烏來區,2205,87,22,109,4,113,228,49.56%,38.16%,1
新北市,烏來區,2206,174,51,225,38,263,486,54.12%,35.8%,1
新北市,烏來區,2207,200,48,248,24,272,615,44.23%,32.52%,1
桃園市,桃園區,0001,563,180,743,61,804,1593,50.47%,35.34%,1
桃園市,桃園區,0002,599,197,796,40,836,1934,43.23%,30.97%,1
桃園市,桃園區,0003,644,191,835,73,908,1661,54.67%,38.77%,1
桃園市,桃園區,0004,504,121,625,33,658,1448,45.44%,34.81%,1
桃園市,桃園區,0005,678,211,889,53,942,1974,47.72%,34.35%,1
桃園市,桃園區,0006,582,194,776,86,862,1882,45.8%,30.92%,1
桃園市,桃園區,0007,605,211,816,61,877,1800,48.72%,33.61%,1
桃園市,桃園區,0008,630,184,814,58,872,1598,54.57%,39.42%,1
桃園市,桃園區,0009,497,181,678,92,770,1626,47.36%,30.57%,1
桃園市,桃園區,0010,540,169,709,54,763,1590,47.99%,33.96%,1
桃園市,桃園區,0011,552,210,762,69,831,1637,50.76%,33.72%,1
桃園市,桃園區,0012,636,235,871,72,943,1943,48.53%,32.73%,1
桃園市,桃園區,0013,547,183,730,43,773,1482,52.16%,36.91%,1
桃園市,桃園區,0014,552,168,720,55,775,1423,54.46%,38.79%,1
桃園市,桃園區,0015,580,177,757,53,810,1509,53.68%,38.44%,1
桃園市,桃園區,0016,640,161,801,49,850,1567,54.24%,40.84%,1
桃園市,桃園區,0017,512,147,659,51,710,1305,54.41%,39.23%,1
桃園市,桃園區,0018,496,137,633,48,681,1416,48.09%,35.03%,1
桃園市,桃園區,0019,570,201,771,38,809,1439,56.22%,39.61%,1
桃園市,桃園區,0020,508,212,720,63,783,1399,55.97%,36.31%,1
桃園市,桃園區,0021,610,191,801,58,859,1540,55.78%,39.61%,1
桃園市,桃園區,0022,593,160,753,48,801,1638,48.9%,36.2%,1
桃園市,桃園區,0023,485,131,616,46,662,1228,53.91%,39.5%,1
桃園市,桃園區,0024,576,178,754,75,829,1649,50.27%,34.93%,1
桃園市,桃園區,0025,606,174,780,52,832,1601,51.97%,37.85%,1
桃園市,桃園區,0026,500,151,651,87,738,1477,49.97%,33.85%,1
桃園市,桃園區,0027,578,165,743,37,780,1503,51.9%,38.46%,1
桃園市,桃園區,0028,516,190,706,82,788,1375,57.31%,37.53%,1
桃園市,桃園區,0029,644,238,882,55,937,1743,53.76%,36.95%,1
桃園市,桃園區,0030,628,207,835,74,909,1862,48.82%,33.73%,1
桃園市,桃園區,0031,625,215,840,64,904,1728,52.31%,36.17%,1
桃園市,桃園區,0032,251,93,344,17,361,690,52.32%,36.38%,1
桃園市,桃園區,0033,343,132,475,41,516,852,60.56%,40.26%,1
桃園市,桃園區,0034,524,192,716,68,784,1353,57.95%,38.73%,1
桃園市,桃園區,0035,494,100,594,37,631,1698,37.16%,29.09%,1
桃園市,桃園區,0036,489,188,677,66,743,1452,51.17%,33.68%,1
桃園市,桃園區,0037,586,218,804,69,873,1681,51.93%,34.86%,1
桃園市,桃園區,0038,564,215,779,75,854,1669,51.17%,33.79%,1
桃園市,桃園區,0039,574,208,782,58,840,1530,54.9%,37.52%,1
桃園市,桃園區,0040,587,205,792,62,854,1582,53.98%,37.1%,1
桃園市,桃園區,0041,539,181,720,44,764,1587,48.14%,33.96%,1
桃園市,桃園區,0042,540,187,727,71,798,1451,55%,37.22%,1
桃園市,桃園區,0043,486,185,671,48,719,1582,45.45%,30.72%,1
桃園市,桃園區,0044,371,161,532,45,577,1028,56.13%,36.09%,1
桃園市,桃園區,0045,691,194,885,79,964,1934,49.84%,35.73%,1
桃園市,桃園區,0046,388,109,497,56,553,1016,54.43%,38.19%,1
桃園市,桃園區,0047,396,150,546,32,578,1079,53.57%,36.7%,1
桃園市,桃園區,0048,630,215,845,42,887,1837,48.29%,34.3%,1
桃園市,桃園區,0049,488,196,684,68,752,1390,54.1%,35.11%,1
桃園市,桃園區,0050,596,154,750,41,791,1489,53.12%,40.03%,1
桃園市,桃園區,0051,720,246,966,35,1001,1821,54.97%,39.54%,1
桃園市,桃園區,0052,532,172,704,24,728,1563,46.58%,34.04%,1
桃園市,桃園區,0053,662,210,872,38,910,1697,53.62%,39.01%,1
桃園市,桃園區,0054,705,181,886,52,938,1740,53.91%,40.52%,1
桃園市,桃園區,0055,621,172,793,55,848,1626,52.15%,38.19%,1
桃園市,桃園區,0056,521,135,656,19,675,1239,54.48%,42.05%,1
桃園市,桃園區,0057,766,178,944,50,994,1766,56.29%,43.37%,1
桃園市,桃園區,0058,561,209,770,62,832,1555,53.5%,36.08%,1
桃園市,桃園區,0059,696,209,905,53,958,1831,52.32%,38.01%,1
桃園市,桃園區,0060,480,138,618,47,665,1115,59.64%,43.05%,1
桃園市,桃園區,0061,568,234,802,57,859,1562,54.99%,36.36%,1
桃園市,桃園區,0062,663,194,857,38,895,1744,51.32%,38.02%,1
桃園市,桃園區,0063,614,201,815,43,858,1838,46.68%,33.41%,1
桃園市,桃園區,0064,705,232,937,87,1024,1889,54.21%,37.32%,1
桃園市,桃園區,0065,681,194,875,62,937,1985,47.2%,34.31%,1
桃園市,桃園區,0066,646,179,825,49,874,1524,57.35%,42.39%,1
桃園市,桃園區,0067,655,170,825,51,876,1425,61.47%,45.96%,1
桃園市,桃園區,0068,682,184,866,50,916,1606,57.04%,42.47%,1
桃園市,桃園區,0069,891,209,1100,33,1133,2056,55.11%,43.34%,1
桃園市,桃園區,0070,851,210,1061,47,1108,2010,55.12%,42.34%,1
桃園市,桃園區,0071,827,217,1044,61,1105,2245,49.22%,36.84%,1
桃園市,桃園區,0072,612,184,796,38,834,1590,52.45%,38.49%,1
桃園市,桃園區,0073,693,192,885,30,915,1536,59.57%,45.12%,1
桃園市,桃園區,0074,644,234,878,63,941,1949,48.28%,33.04%,1
桃園市,桃園區,0075,718,199,917,58,975,1965,49.62%,36.54%,1
桃園市,桃園區,0076,814,198,1012,69,1081,2414,44.78%,33.72%,1
桃園市,桃園區,0077,704,226,930,63,993,1942,51.13%,36.25%,1
桃園市,桃園區,0078,806,231,1037,66,1103,2156,51.16%,37.38%,1
桃園市,桃園區,0079,512,211,723,65,788,1404,56.13%,36.47%,1
桃園市,桃園區,0080,520,150,670,29,699,1194,58.54%,43.55%,1
桃園市,桃園區,0081,537,208,745,82,827,1449,57.07%,37.06%,1
桃園市,桃園區,0082,595,195,790,80,870,1803,48.25%,33%,1
桃園市,桃園區,0083,614,218,832,66,898,1692,53.07%,36.29%,1
桃園市,桃園區,0084,702,230,932,57,989,1913,51.7%,36.7%,1
桃園市,桃園區,0085,664,222,886,66,952,1815,52.45%,36.58%,1
桃園市,桃園區,0086,396,143,539,48,587,1173,50.04%,33.76%,1
桃園市,桃園區,0087,434,95,529,25,554,1162,47.68%,37.35%,1
桃園市,桃園區,0088,373,112,485,68,553,1194,46.31%,31.24%,1
桃園市,桃園區,0089,624,214,838,63,901,1695,53.16%,36.81%,1
桃園市,桃園區,0090,640,206,846,58,904,1797,50.31%,35.61%,1
桃園市,桃園區,0091,622,160,782,34,816,1592,51.26%,39.07%,1
桃園市,桃園區,0092,660,162,822,77,899,1780,50.51%,37.08%,1
桃園市,桃園區,0093,651,173,824,42,866,1904,45.48%,34.19%,1
桃園市,桃園區,0094,763,186,949,29,978,2021,48.39%,37.75%,1
桃園市,桃園區,0095,586,158,744,49,793,1545,51.33%,37.93%,1
桃園市,桃園區,0096,597,150,747,34,781,1617,48.3%,36.92%,1
桃園市,桃園區,0097,647,162,809,41,850,1683,50.51%,38.44%,1
桃園市,桃園區,0098,725,200,925,73,998,1834,54.42%,39.53%,1
桃園市,桃園區,0099,694,204,898,58,956,2055,46.52%,33.77%,1
桃園市,桃園區,0100,677,164,841,29,870,1828,47.59%,37.04%,1
桃園市,桃園區,0101,680,192,872,45,917,1873,48.96%,36.31%,1
桃園市,桃園區,0102,574,146,720,40,760,3687,20.61%,15.57%,1
桃園市,桃園區,0103,686,209,895,40,935,1850,50.54%,37.08%,1
桃園市,桃園區,0104,692,167,859,50,909,1827,49.75%,37.88%,1
桃園市,桃園區,0105,497,149,646,44,690,1149,60.05%,43.26%,1
桃園市,桃園區,0106,425,148,573,41,614,1061,57.87%,40.06%,1
桃園市,桃園區,0107,614,190,804,43,847,1831,46.26%,33.53%,1
桃園市,桃園區,0108,746,95,841,70,911,2168,42.02%,34.41%,1
桃園市,桃園區,0109,683,199,882,32,914,1874,48.77%,36.45%,1
桃園市,桃園區,0110,510,161,671,28,699,1524,45.87%,33.46%,1
桃園市,桃園區,0111,590,178,768,40,808,1528,52.88%,38.61%,1
桃園市,桃園區,0112,588,176,764,44,808,1489,54.26%,39.49%,1
桃園市,桃園區,0113,450,157,607,73,680,1308,51.99%,34.4%,1
桃園市,桃園區,0114,559,188,747,58,805,1583,50.85%,35.31%,1
桃園市,桃園區,0115,583,232,815,67,882,1618,54.51%,36.03%,1
桃園市,桃園區,0116,745,238,983,80,1063,2127,49.98%,35.03%,1
桃園市,桃園區,0117,724,205,929,27,956,2033,47.02%,35.61%,1
桃園市,桃園區,0118,788,215,1003,49,1052,2098,50.14%,37.56%,1
桃園市,桃園區,0119,813,244,1057,87,1144,2126,53.81%,38.24%,1
桃園市,桃園區,0120,814,86,900,50,950,1917,49.56%,42.46%,1
桃園市,桃園區,0121,728,193,921,55,976,1997,48.87%,36.45%,1
桃園市,桃園區,0122,765,192,957,53,1010,1929,52.36%,39.66%,1
桃園市,桃園區,0123,619,195,814,43,857,1691,50.68%,36.61%,1
桃園市,桃園區,0124,720,195,915,43,958,1900,50.42%,37.89%,1
桃園市,桃園區,0125,662,196,858,76,934,1761,53.04%,37.59%,1
桃園市,桃園區,0126,684,212,896,43,939,1922,48.86%,35.59%,1
桃園市,桃園區,0127,715,184,899,58,957,1995,47.97%,35.84%,1
桃園市,桃園區,0128,399,128,527,48,575,1063,54.09%,37.54%,1
桃園市,桃園區,0129,541,129,670,63,733,1412,51.91%,38.31%,1
桃園市,桃園區,0130,703,198,901,29,930,1746,53.26%,40.26%,1
桃園市,桃園區,0131,566,185,751,60,811,1689,48.02%,33.51%,1
桃園市,桃園區,0132,457,160,617,42,659,1542,42.74%,29.64%,1
桃園市,桃園區,0133,511,164,675,46,721,1437,50.17%,35.56%,1
桃園市,桃園區,0134,578,192,770,52,822,1679,48.96%,34.43%,1
桃園市,桃園區,0135,614,189,803,70,873,1886,46.29%,32.56%,1
桃園市,桃園區,0136,634,188,822,67,889,1657,53.65%,38.26%,1
桃園市,桃園區,0137,513,162,675,47,722,1349,53.52%,38.03%,1
桃園市,桃園區,0138,696,199,895,44,939,1805,52.02%,38.56%,1
桃園市,桃園區,0139,648,211,859,67,926,1846,50.16%,35.1%,1
桃園市,桃園區,0140,552,170,722,50,772,1644,46.96%,33.58%,1
桃園市,桃園區,0141,562,175,737,63,800,1674,47.79%,33.57%,1
桃園市,桃園區,0142,631,204,835,49,884,1737,50.89%,36.33%,1
桃園市,桃園區,0143,571,200,771,59,830,1566,53%,36.46%,1
桃園市,桃園區,0144,608,161,769,40,809,1517,53.33%,40.08%,1
桃園市,桃園區,0145,534,169,703,37,740,1619,45.71%,32.98%,1
桃園市,桃園區,0146,653,199,852,52,904,1774,50.96%,36.81%,1
桃園市,桃園區,0147,663,163,826,37,863,1666,51.8%,39.8%,1
桃園市,桃園區,0148,588,179,767,26,793,1528,51.9%,38.48%,1
桃園市,桃園區,0149,590,218,808,58,866,1709,50.67%,34.52%,1
桃園市,桃園區,0150,558,267,825,33,858,1719,49.91%,32.46%,1
桃園市,桃園區,0151,508,162,670,53,723,1569,46.08%,32.38%,1
桃園市,桃園區,0152,542,156,698,45,743,1505,49.37%,36.01%,1
桃園市,桃園區,0153,523,174,697,58,755,1496,50.47%,34.96%,1
桃園市,桃園區,0154,593,155,748,54,802,1505,53.29%,39.4%,1
桃園市,桃園區,0155,680,180,860,49,909,1807,50.3%,37.63%,1
桃園市,桃園區,0156,714,193,907,41,948,1857,51.05%,38.45%,1
桃園市,桃園區,0157,628,195,823,70,893,1589,56.2%,39.52%,1
桃園市,桃園區,0158,753,243,996,45,1041,2088,49.86%,36.06%,1
桃園市,桃園區,0159,708,195,903,44,947,1893,50.03%,37.4%,1
桃園市,桃園區,0160,423,128,551,40,591,1303,45.36%,32.46%,1
桃園市,桃園區,0161,536,173,709,46,755,1416,53.32%,37.85%,1
桃園市,桃園區,0162,481,139,620,41,661,1351,48.93%,35.6%,1
桃園市,桃園區,0163,589,172,761,43,804,1659,48.46%,35.5%,1
桃園市,桃園區,0164,773,188,961,55,1016,2103,48.31%,36.76%,1
桃園市,桃園區,0165,763,153,916,43,959,1943,49.36%,39.27%,1
桃園市,桃園區,0166,701,210,911,64,975,1927,50.6%,36.38%,1
桃園市,桃園區,0167,633,172,805,54,859,1929,44.53%,32.81%,1
桃園市,桃園區,0168,944,241,1185,50,1235,2204,56.03%,42.83%,1
桃園市,桃園區,0169,651,236,887,43,930,2033,45.75%,32.02%,1
桃園市,桃園區,0170,662,157,819,23,842,1656,50.85%,39.98%,1
桃園市,桃園區,0171,588,198,786,58,844,1712,49.3%,34.35%,1
桃園市,桃園區,0172,627,190,817,56,873,1738,50.23%,36.08%,1
桃園市,桃園區,0173,667,161,828,29,857,1432,59.85%,46.58%,1
桃園市,桃園區,0174,612,153,765,50,815,1421,57.35%,43.07%,1
桃園市,桃園區,0175,504,161,665,27,692,1344,51.49%,37.5%,1
桃園市,桃園區,0176,663,194,857,44,901,1942,46.4%,34.14%,1
桃園市,桃園區,0177,738,202,940,61,1001,2001,50.02%,36.88%,1
桃園市,桃園區,0178,668,164,832,33,865,1941,44.56%,34.42%,1
桃園市,桃園區,0179,636,207,843,47,890,1702,52.29%,37.37%,1
桃園市,桃園區,0180,596,180,776,45,821,1589,51.67%,37.51%,1
桃園市,桃園區,0181,592,153,745,37,782,1544,50.65%,38.34%,1
桃園市,桃園區,0182,557,173,730,46,776,1860,41.72%,29.95%,1
桃園市,桃園區,0183,623,176,799,68,867,1726,50.23%,36.1%,1
桃園市,桃園區,0184,606,214,820,47,867,1798,48.22%,33.7%,1
桃園市,桃園區,0185,689,234,923,34,957,1925,49.71%,35.79%,1
桃園市,桃園區,0186,653,247,900,47,947,1945,48.69%,33.57%,1
桃園市,桃園區,0187,463,302,765,59,824,1764,46.71%,26.25%,1
桃園市,桃園區,0188,750,205,955,78,1033,1899,54.4%,39.49%,1
桃園市,桃園區,0189,540,155,695,20,715,1415,50.53%,38.16%,1
桃園市,桃園區,0190,635,172,807,44,851,1790,47.54%,35.47%,1
桃園市,桃園區,0191,578,184,762,34,796,1693,47.02%,34.14%,1
桃園市,桃園區,0192,639,121,760,54,814,1916,42.48%,33.35%,1
桃園市,桃園區,0193,473,154,627,33,660,1434,46.03%,32.98%,1
桃園市,桃園區,0194,586,197,783,47,830,1494,55.56%,39.22%,1
桃園市,桃園區,0195,475,173,648,70,718,1311,54.77%,36.23%,1
桃園市,桃園區,0196,519,194,713,52,765,1476,51.83%,35.16%,1
桃園市,桃園區,0197,562,209,771,55,826,1484,55.66%,37.87%,1
桃園市,桃園區,0198,543,175,718,50,768,1514,50.73%,35.87%,1
桃園市,桃園區,0199,534,151,685,70,755,1446,52.21%,36.93%,1
桃園市,桃園區,0200,533,175,708,23,731,1573,46.47%,33.88%,1
桃園市,桃園區,0201,523,152,675,47,722,1564,46.16%,33.44%,1
桃園市,桃園區,0202,391,130,521,50,571,1015,56.26%,38.52%,1
桃園市,桃園區,0203,320,121,441,36,477,955,49.95%,33.51%,1
桃園市,桃園區,0204,670,172,842,51,893,1796,49.72%,37.31%,1
桃園市,桃園區,0205,700,177,877,29,906,1878,48.24%,37.27%,1
桃園市,桃園區,0206,613,194,807,38,845,1729,48.87%,35.45%,1
桃園市,桃園區,0207,625,160,785,29,814,1843,44.17%,33.91%,1
桃園市,桃園區,0208,600,142,742,38,780,1817,42.93%,33.02%,1
桃園市,桃園區,0209,371,140,511,42,553,979,56.49%,37.9%,1
桃園市,桃園區,0210,536,174,710,40,750,1363,55.03%,39.33%,1
桃園市,桃園區,0211,588,157,745,21,766,1546,49.55%,38.03%,1
桃園市,桃園區,0212,487,137,624,33,657,1308,50.23%,37.23%,1
桃園市,桃園區,0213,770,237,1007,62,1069,2164,49.4%,35.58%,1
桃園市,桃園區,0214,684,230,914,59,973,2020,48.17%,33.86%,1
桃園市,桃園區,0215,646,157,803,50,853,1924,44.33%,33.58%,1
桃園市,桃園區,0216,688,161,849,52,901,2088,43.15%,32.95%,1
桃園市,中壢區,0591,568,118,686,54,740,1401,52.82%,40.54%,1
桃園市,中壢區,0592,651,193,844,55,899,1798,50%,36.21%,1
桃園市,中壢區,0593,560,157,717,55,772,1642,47.02%,34.1%,1
桃園市,中壢區,0594,645,189,834,53,887,1670,53.11%,38.62%,1
桃園市,中壢區,0595,598,171,769,22,791,1456,54.33%,41.07%,1
桃園市,中壢區,0596,698,164,862,45,907,1531,59.24%,45.59%,1
桃園市,中壢區,0597,682,200,882,50,932,1623,57.42%,42.02%,1
桃園市,中壢區,0598,690,149,839,48,887,1953,45.42%,35.33%,1
桃園市,中壢區,0599,486,142,628,29,657,1155,56.88%,42.08%,1
桃園市,中壢區,0600,637,156,793,49,842,1800,46.78%,35.39%,1
桃園市,中壢區,0601,676,138,814,37,851,1757,48.43%,38.47%,1
桃園市,中壢區,0602,573,128,701,51,752,1281,58.7%,44.73%,1
桃園市,中壢區,0603,634,159,793,33,826,1462,56.5%,43.37%,1
桃園市,中壢區,0604,569,149,718,56,774,1560,49.62%,36.47%,1
桃園市,中壢區,0605,711,172,883,42,925,1602,57.74%,44.38%,1
桃園市,中壢區,0606,493,120,613,32,645,1006,64.12%,49.01%,1
桃園市,中壢區,0607,723,157,880,34,914,1474,62.01%,49.05%,1
桃園市,中壢區,0608,640,154,794,89,883,1627,54.27%,39.34%,1
桃園市,中壢區,0609,632,178,810,49,859,1519,56.55%,41.61%,1
桃園市,中壢區,0610,602,162,764,79,843,1526,55.24%,39.45%,1
桃園市,中壢區,0611,660,138,798,75,873,1618,53.96%,40.79%,1
桃園市,中壢區,0612,684,148,832,71,903,1554,58.11%,44.02%,1
桃園市,中壢區,0613,714,127,841,77,918,1706,53.81%,41.85%,1
桃園市,中壢區,0614,828,168,996,47,1043,1818,57.37%,45.54%,1
桃園市,中壢區,0615,758,165,923,50,973,1991,48.87%,38.07%,1
桃園市,中壢區,0616,661,140,801,27,828,1609,51.46%,41.08%,1
桃園市,中壢區,0617,522,86,608,23,631,1329,47.48%,39.28%,1
桃園市,中壢區,0618,573,131,704,84,788,1587,49.65%,36.11%,1
桃園市,中壢區,0619,771,164,935,39,974,1955,49.82%,39.44%,1
桃園市,中壢區,0620,621,218,839,46,885,1711,51.72%,36.29%,1
桃園市,中壢區,0621,658,159,817,56,873,1712,50.99%,38.43%,1
桃園市,中壢區,0622,626,151,777,54,831,1448,57.39%,43.23%,1
桃園市,中壢區,0623,607,164,771,51,822,1605,51.21%,37.82%,1
桃園市,中壢區,0624,587,145,732,17,749,1633,45.87%,35.95%,1
桃園市,中壢區,0625,775,185,960,57,1017,1795,56.66%,43.18%,1
桃園市,中壢區,0626,711,170,881,33,914,1689,54.11%,42.1%,1
桃園市,中壢區,0627,486,140,626,44,670,1201,55.79%,40.47%,1
桃園市,中壢區,0628,526,149,675,35,710,1353,52.48%,38.88%,1
桃園市,中壢區,0629,617,144,761,33,794,1587,50.03%,38.88%,1
桃園市,中壢區,0630,757,103,860,53,913,1883,48.49%,40.2%,1
桃園市,中壢區,0631,547,167,714,32,746,1448,51.52%,37.78%,1
桃園市,中壢區,0632,740,176,916,33,949,1810,52.43%,40.88%,1
桃園市,中壢區,0633,721,178,899,81,980,1916,51.15%,37.63%,1
桃園市,中壢區,0634,519,128,647,24,671,1177,57.01%,44.1%,1
桃園市,中壢區,0635,595,187,782,50,832,1410,59.01%,42.2%,1
桃園市,中壢區,0636,498,145,643,16,659,1368,48.17%,36.4%,1
桃園市,中壢區,0637,606,186,792,56,848,1424,59.55%,42.56%,1
桃園市,中壢區,0638,640,199,839,38,877,1573,55.75%,40.69%,1
桃園市,中壢區,0639,472,146,618,24,642,1152,55.73%,40.97%,1
桃園市,中壢區,0640,466,143,609,24,633,1178,53.74%,39.56%,1
桃園市,中壢區,0641,755,223,978,75,1053,1966,53.56%,38.4%,1
桃園市,中壢區,0642,525,148,673,33,706,3474,20.32%,15.11%,1
桃園市,中壢區,0643,841,213,1054,63,1117,2099,53.22%,40.07%,1
桃園市,中壢區,0644,484,125,609,41,650,1178,55.18%,41.09%,1
桃園市,中壢區,0645,620,175,795,61,856,1397,61.27%,44.38%,1
桃園市,中壢區,0646,670,199,869,50,919,1669,55.06%,40.14%,1
桃園市,中壢區,0647,757,186,943,61,1004,2087,48.11%,36.27%,1
桃園市,中壢區,0648,827,87,914,56,970,1900,51.05%,43.53%,1
桃園市,中壢區,0649,523,153,676,31,707,1640,43.11%,31.89%,1
桃園市,中壢區,0650,479,89,568,27,595,994,59.86%,48.19%,1
桃園市,中壢區,0651,560,114,674,55,729,1131,64.46%,49.51%,1
桃園市,中壢區,0652,721,183,904,50,954,1625,58.71%,44.37%,1
桃園市,中壢區,0653,618,193,811,46,857,1384,61.92%,44.65%,1
桃園市,中壢區,0654,616,179,795,48,843,1588,53.09%,38.79%,1
桃園市,中壢區,0655,618,130,748,37,785,1445,54.33%,42.77%,1
桃園市,中壢區,0656,614,142,756,58,814,1743,46.7%,35.23%,1
桃園市,中壢區,0657,678,138,816,44,860,1812,47.46%,37.42%,1
桃園市,中壢區,0658,580,146,726,63,789,1546,51.03%,37.52%,1
桃園市,中壢區,0659,511,128,639,48,687,1290,53.26%,39.61%,1
桃園市,中壢區,0660,775,173,948,94,1042,2145,48.58%,36.13%,1
桃園市,中壢區,0661,519,145,664,50,714,1451,49.21%,35.77%,1
桃園市,中壢區,0662,609,131,740,37,777,1489,52.18%,40.9%,1
桃園市,中壢區,0663,352,79,431,26,457,827,55.26%,42.56%,1
桃園市,中壢區,0664,592,112,704,36,740,1442,51.32%,41.05%,1
桃園市,中壢區,0665,668,178,846,22,868,1842,47.12%,36.26%,1
桃園市,中壢區,0666,559,120,679,26,705,1520,46.38%,36.78%,1
桃園市,中壢區,0667,625,151,776,45,821,1764,46.54%,35.43%,1
桃園市,中壢區,0668,659,137,796,28,824,1488,55.38%,44.29%,1
桃園市,中壢區,0669,625,168,793,53,846,1593,53.11%,39.23%,1
桃園市,中壢區,0670,604,158,762,41,803,1505,53.36%,40.13%,1
桃園市,中壢區,0671,625,179,804,37,841,1661,50.63%,37.63%,1
桃園市,中壢區,0672,530,252,782,34,816,1492,54.69%,35.52%,1
桃園市,中壢區,0673,441,146,587,30,617,1249,49.4%,35.31%,1
桃園市,中壢區,0674,541,126,667,31,698,1257,55.53%,43.04%,1
桃園市,中壢區,0675,628,157,785,78,863,1659,52.02%,37.85%,1
桃園市,中壢區,0676,783,177,960,50,1010,1815,55.65%,43.14%,1
桃園市,中壢區,0677,653,155,808,49,857,1702,50.35%,38.37%,1
桃園市,中壢區,0678,620,162,782,21,803,1541,52.11%,40.23%,1
桃園市,中壢區,0679,550,236,786,40,826,1659,49.79%,33.15%,1
桃園市,中壢區,0680,731,130,861,118,979,1874,52.24%,39.01%,1
桃園市,中壢區,0681,636,117,753,50,803,1603,50.09%,39.68%,1
桃園市,中壢區,0682,660,172,832,49,881,1735,50.78%,38.04%,1
桃園市,中壢區,0683,717,170,887,22,909,1815,50.08%,39.5%,1
桃園市,中壢區,0684,821,174,995,37,1032,1873,55.1%,43.83%,1
桃園市,中壢區,0685,774,138,912,56,968,1739,55.66%,44.51%,1
桃園市,中壢區,0686,658,140,798,41,839,1709,49.09%,38.5%,1
桃園市,中壢區,0687,678,192,870,43,913,1655,55.17%,40.97%,1
桃園市,中壢區,0688,713,120,833,44,877,1664,52.7%,42.85%,1
桃園市,中壢區,0689,395,102,497,17,514,1087,47.29%,36.34%,1
桃園市,中壢區,0690,416,121,537,61,598,1065,56.15%,39.06%,1
桃園市,中壢區,0691,705,209,914,78,992,1844,53.8%,38.23%,1
桃園市,中壢區,0692,426,102,528,48,576,1220,47.21%,34.92%,1
桃園市,中壢區,0693,471,143,614,39,653,1219,53.57%,38.64%,1
桃園市,中壢區,0694,471,172,643,51,694,1260,55.08%,37.38%,1
桃園市,中壢區,0695,663,187,850,77,927,1594,58.16%,41.59%,1
桃園市,中壢區,0696,649,209,858,76,934,1733,53.89%,37.45%,1
桃園市,中壢區,0697,806,175,981,58,1039,1979,52.5%,40.73%,1
桃園市,中壢區,0698,628,180,808,29,837,1621,51.63%,38.74%,1
桃園市,中壢區,0699,557,175,732,43,775,1391,55.72%,40.04%,1
桃園市,中壢區,0700,648,155,803,36,839,1531,54.8%,42.33%,1
桃園市,中壢區,0701,702,176,878,48,926,1943,47.66%,36.13%,1
桃園市,中壢區,0702,548,134,682,32,714,1363,52.38%,40.21%,1
桃園市,中壢區,0703,744,181,925,61,986,2172,45.4%,34.25%,1
桃園市,中壢區,0704,698,132,830,49,879,1798,48.89%,38.82%,1
桃園市,中壢區,0705,643,153,796,28,824,1671,49.31%,38.48%,1
桃園市,中壢區,0706,749,183,932,43,975,1969,49.52%,38.04%,1
桃園市,中壢區,0707,751,170,921,61,982,1563,62.83%,48.05%,1
桃園市,中壢區,0708,742,182,924,49,973,1762,55.22%,42.11%,1
桃園市,中壢區,0709,632,130,762,50,812,1923,42.23%,32.87%,1
桃園市,中壢區,0710,654,173,827,67,894,1572,56.87%,41.6%,1
桃園市,中壢區,0711,776,192,968,46,1014,1850,54.81%,41.95%,1
桃園市,中壢區,0712,605,151,756,61,817,1583,51.61%,38.22%,1
桃園市,中壢區,0713,627,197,824,60,884,1735,50.95%,36.14%,1
桃園市,中壢區,0714,481,160,641,30,671,1292,51.93%,37.23%,1
桃園市,中壢區,0715,516,117,633,26,659,1265,52.09%,40.79%,1
桃園市,中壢區,0716,670,206,876,43,919,1798,51.11%,37.26%,1
桃園市,中壢區,0717,769,209,978,62,1040,1822,57.08%,42.21%,1
桃園市,中壢區,0718,646,178,824,26,850,1613,52.7%,40.05%,1
桃園市,中壢區,0719,553,165,718,40,758,1405,53.95%,39.36%,1
桃園市,中壢區,0720,665,229,894,80,974,1730,56.3%,38.44%,1
桃園市,中壢區,0721,640,172,812,38,850,1384,61.42%,46.24%,1
桃園市,中壢區,0722,475,132,607,20,627,1122,55.88%,42.34%,1
桃園市,中壢區,0723,418,188,606,0,606,992,61.09%,42.14%,1
桃園市,中壢區,0724,654,218,872,49,921,1820,50.6%,35.93%,1
桃園市,中壢區,0725,689,193,882,58,940,1847,50.89%,37.3%,1
桃園市,中壢區,0726,572,141,713,53,766,1302,58.83%,43.93%,1
桃園市,中壢區,0727,490,150,640,45,685,1203,56.94%,40.73%,1
桃園市,中壢區,0728,570,161,731,50,781,1226,63.7%,46.49%,1
桃園市,中壢區,0729,521,141,662,46,708,1234,57.37%,42.22%,1
桃園市,中壢區,0730,747,159,906,50,956,2023,47.26%,36.93%,1
桃園市,中壢區,0731,564,149,713,20,733,1555,47.14%,36.27%,1
桃園市,中壢區,0732,693,211,904,69,973,1951,49.87%,35.52%,1
桃園市,中壢區,0733,569,144,713,55,768,1383,55.53%,41.14%,1
桃園市,中壢區,0734,513,142,655,49,704,1164,60.48%,44.07%,1
桃園市,中壢區,0735,630,142,772,36,808,1482,54.52%,42.51%,1
桃園市,中壢區,0736,686,210,896,49,945,1770,53.39%,38.76%,1
桃園市,中壢區,0737,703,214,917,73,990,1703,58.13%,41.28%,1
桃園市,中壢區,0738,725,182,907,63,970,1841,52.69%,39.38%,1
桃園市,中壢區,0739,808,197,1005,45,1050,1941,54.1%,41.63%,1
桃園市,中壢區,0740,847,212,1059,57,1116,2029,55%,41.74%,1
桃園市,中壢區,0741,685,173,858,39,897,1636,54.83%,41.87%,1
桃園市,中壢區,0742,672,166,838,32,870,1528,56.94%,43.98%,1
桃園市,中壢區,0743,759,240,999,91,1090,2289,47.62%,33.16%,1
桃園市,中壢區,0744,695,235,930,59,989,2020,48.96%,34.41%,1
桃園市,中壢區,0745,788,206,994,59,1053,2027,51.95%,38.88%,1
桃園市,中壢區,0746,638,158,796,35,831,1883,44.13%,33.88%,1
桃園市,中壢區,0747,807,166,973,52,1025,2080,49.28%,38.8%,1
桃園市,中壢區,0748,234,75,309,20,329,646,50.93%,36.22%,1
桃園市,中壢區,0749,1014,32,1046,67,1113,1780,62.53%,56.97%,1
桃園市,中壢區,0750,601,150,751,25,776,1372,56.56%,43.8%,1
桃園市,中壢區,0751,676,228,904,49,953,1668,57.13%,40.53%,1
桃園市,中壢區,0752,763,186,949,43,992,1987,49.92%,38.4%,1
桃園市,中壢區,0753,587,191,778,30,808,1520,53.16%,38.62%,1
桃園市,中壢區,0754,313,111,424,41,465,852,54.58%,36.74%,1
桃園市,中壢區,0755,494,123,617,45,662,1209,54.76%,40.86%,1
桃園市,中壢區,0756,532,176,708,85,793,1481,53.54%,35.92%,1
桃園市,中壢區,0757,582,134,716,22,738,1564,47.19%,37.21%,1
桃園市,中壢區,0758,760,234,994,65,1059,1957,54.11%,38.83%,1
桃園市,中壢區,0759,498,177,675,64,739,1223,60.43%,40.72%,1
桃園市,中壢區,0760,468,146,614,54,668,1182,56.51%,39.59%,1
桃園市,中壢區,0761,418,166,584,45,629,1066,59.01%,39.21%,1
桃園市,中壢區,0762,698,202,900,62,962,1701,56.55%,41.03%,1
桃園市,中壢區,0763,355,97,452,45,497,943,52.7%,37.65%,1
桃園市,中壢區,0764,313,101,414,28,442,731,60.47%,42.82%,1
桃園市,中壢區,0765,329,112,441,47,488,851,57.34%,38.66%,1
桃園市,中壢區,0766,377,137,514,39,553,1011,54.7%,37.29%,1
桃園市,中壢區,0767,584,193,777,51,828,1532,54.05%,38.12%,1
桃園市,中壢區,0768,404,114,518,42,560,1028,54.47%,39.3%,1
桃園市,中壢區,0769,451,151,602,47,649,1157,56.09%,38.98%,1
桃園市,中壢區,0770,591,206,797,54,851,1591,53.49%,37.15%,1
桃園市,中壢區,0771,747,210,957,65,1022,2156,47.4%,34.65%,1
桃園市,中壢區,0772,487,158,645,33,678,1479,45.84%,32.93%,1
桃園市,中壢區,0773,705,181,886,40,926,1780,52.02%,39.61%,1
桃園市,中壢區,0774,637,186,823,67,890,1651,53.91%,38.58%,1
桃園市,中壢區,0775,828,136,964,42,1006,1870,53.8%,44.28%,1
桃園市,中壢區,0776,669,174,843,26,869,1913,45.43%,34.97%,1
桃園市,中壢區,0777,541,150,691,36,727,1609,45.18%,33.62%,1
桃園市,中壢區,0778,550,178,728,32,760,1539,49.38%,35.74%,1
桃園市,中壢區,0779,540,171,711,42,753,1426,52.81%,37.87%,1
桃園市,中壢區,0780,540,193,733,37,770,1618,47.59%,33.37%,1
桃園市,中壢區,0781,553,178,731,51,782,1441,54.27%,38.38%,1
桃園市,中壢區,0782,625,176,801,42,843,1528,55.17%,40.9%,1
桃園市,中壢區,0783,622,194,816,65,881,1683,52.35%,36.96%,1
桃園市,中壢區,0784,750,230,980,94,1074,1945,55.22%,38.56%,1
桃園市,中壢區,0785,545,194,739,68,807,1534,52.61%,35.53%,1
桃園市,中壢區,0786,534,288,822,86,908,1810,50.17%,29.5%,1
桃園市,中壢區,0787,362,136,498,64,562,1097,51.23%,33%,1
桃園市,中壢區,0788,690,204,894,36,930,1917,48.51%,35.99%,1
桃園市,中壢區,0789,673,222,895,57,952,1858,51.24%,36.22%,1
桃園市,中壢區,0790,624,177,801,40,841,1576,53.36%,39.59%,1
桃園市,中壢區,0791,687,97,784,40,824,1478,55.75%,46.48%,1
桃園市,中壢區,0792,599,203,802,38,840,1589,52.86%,37.7%,1
桃園市,中壢區,0793,754,256,1010,102,1112,2037,54.59%,37.02%,1
桃園市,中壢區,0794,483,157,640,52,692,1158,59.76%,41.71%,1
桃園市,中壢區,0795,728,259,987,78,1065,1967,54.14%,37.01%,1
桃園市,中壢區,0796,656,202,858,77,935,1830,51.09%,35.85%,1
桃園市,中壢區,0797,605,235,840,62,902,1856,48.6%,32.6%,1
桃園市,中壢區,0798,710,230,940,80,1020,2068,49.32%,34.33%,1
桃園市,中壢區,0799,637,209,846,47,893,2152,41.5%,29.6%,1
桃園市,中壢區,0800,694,223,917,59,976,2158,45.23%,32.16%,1
桃園市,大溪區,0522,535,218,753,74,827,1477,55.99%,36.22%,1
桃園市,大溪區,0523,359,139,498,45,543,1006,53.98%,35.69%,1
桃園市,大溪區,0524,538,183,721,92,813,1553,52.35%,34.64%,1
桃園市,大溪區,0525,570,210,780,84,864,1597,54.1%,35.69%,1
桃園市,大溪區,0526,502,150,652,70,722,1358,53.17%,36.97%,1
桃園市,大溪區,0527,519,181,700,50,750,1585,47.32%,32.74%,1
桃園市,大溪區,0528,588,192,780,55,835,1612,51.8%,36.48%,1
桃園市,大溪區,0529,520,143,663,40,703,1555,45.21%,33.44%,1
桃園市,大溪區,0530,529,183,712,60,772,1282,60.22%,41.26%,1
桃園市,大溪區,0531,522,137,659,71,730,1392,52.44%,37.5%,1
桃園市,大溪區,0532,481,178,659,58,717,1422,50.42%,33.83%,1
桃園市,大溪區,0533,537,174,711,77,788,1448,54.42%,37.09%,1
桃園市,大溪區,0534,508,197,705,70,775,1269,61.07%,40.03%,1
桃園市,大溪區,0535,345,164,509,82,591,977,60.49%,35.31%,1
桃園市,大溪區,0536,512,192,704,48,752,1359,55.33%,37.67%,1
桃園市,大溪區,0537,425,182,607,75,682,1135,60.09%,37.44%,1
桃園市,大溪區,0538,211,102,313,39,352,660,53.33%,31.97%,1
桃園市,大溪區,0539,354,128,482,39,521,1056,49.34%,33.52%,1
桃園市,大溪區,0540,458,133,591,60,651,1263,51.54%,36.26%,1
桃園市,大溪區,0541,246,97,343,53,396,717,55.23%,34.31%,1
桃園市,大溪區,0542,363,145,508,21,529,1299,40.72%,27.94%,1
桃園市,大溪區,0543,365,113,478,60,538,976,55.12%,37.4%,1
桃園市,大溪區,0544,345,102,447,59,506,938,53.94%,36.78%,1
桃園市,大溪區,0545,289,82,371,34,405,832,48.68%,34.74%,1
桃園市,大溪區,0546,285,77,362,24,386,866,44.57%,32.91%,1
桃園市,大溪區,0547,202,95,297,34,331,694,47.69%,29.11%,1
桃園市,大溪區,0548,420,191,611,48,659,1410,46.74%,29.79%,1
桃園市,大溪區,0549,445,132,577,68,645,1303,49.5%,34.15%,1
桃園市,大溪區,0550,421,122,543,46,589,1125,52.36%,37.42%,1
桃園市,大溪區,0551,461,132,593,43,636,1170,54.36%,39.4%,1
桃園市,大溪區,0552,530,173,703,59,762,1308,58.26%,40.52%,1
桃園市,大溪區,0553,393,154,547,67,614,1094,56.12%,35.92%,1
桃園市,大溪區,0554,844,230,1074,71,1145,2153,53.18%,39.2%,1
桃園市,大溪區,0555,551,77,628,49,677,1173,57.72%,46.97%,1
桃園市,大溪區,0556,534,137,671,29,700,1369,51.13%,39.01%,1
桃園市,大溪區,0557,558,118,676,67,743,1446,51.38%,38.59%,1
桃園市,大溪區,0558,477,86,563,61,624,1406,44.38%,33.93%,1
桃園市,大溪區,0559,672,148,820,38,858,1592,53.89%,42.21%,1
桃園市,大溪區,0560,574,196,770,83,853,1497,56.98%,38.34%,1
桃園市,大溪區,0561,587,212,799,82,881,1559,56.51%,37.65%,1
桃園市,大溪區,0562,614,179,793,30,823,1684,48.87%,36.46%,1
桃園市,大溪區,0563,915,97,1012,62,1074,1959,54.82%,46.71%,1
桃園市,大溪區,0564,544,160,704,70,774,1369,56.54%,39.74%,1
桃園市,大溪區,0565,555,170,725,70,795,1431,55.56%,38.78%,1
桃園市,大溪區,0566,470,139,609,32,641,1657,38.68%,28.36%,1
桃園市,大溪區,0567,413,147,560,33,593,1387,42.75%,29.78%,1
桃園市,大溪區,0568,429,95,524,44,568,1085,52.35%,39.54%,1
桃園市,大溪區,0569,577,164,741,54,795,1403,56.66%,41.13%,1
桃園市,大溪區,0570,526,165,691,93,784,1511,51.89%,34.81%,1
桃園市,大溪區,0571,513,193,706,91,797,1719,46.36%,29.84%,1
桃園市,大溪區,0572,508,187,695,101,796,1717,46.36%,29.59%,1
桃園市,大溪區,0573,435,139,574,74,648,1207,53.69%,36.04%,1
桃園市,大溪區,0574,489,97,586,86,672,1188,56.57%,41.16%,1
桃園市,大溪區,0575,497,168,665,35,700,1514,46.24%,32.83%,1
桃園市,大溪區,0576,633,150,783,72,855,1529,55.92%,41.4%,1
桃園市,大溪區,0577,557,133,690,51,741,1260,58.81%,44.21%,1
桃園市,大溪區,0578,340,108,448,22,470,831,56.56%,40.91%,1
桃園市,大溪區,0579,554,168,722,64,786,1407,55.86%,39.37%,1
桃園市,大溪區,0580,494,151,645,75,720,1494,48.19%,33.07%,1
桃園市,楊梅區,0926,506,145,651,56,707,1269,55.71%,39.87%,1
桃園市,楊梅區,0927,577,137,714,55,769,1246,61.72%,46.31%,1
桃園市,楊梅區,0928,637,145,782,40,822,1408,58.38%,45.24%,1
桃園市,楊梅區,0929,570,161,731,62,793,1434,55.3%,39.75%,1
桃園市,楊梅區,0930,594,108,702,62,764,1515,50.43%,39.21%,1
桃園市,楊梅區,0931,585,157,742,55,797,1657,48.1%,35.3%,1
桃園市,楊梅區,0932,505,115,620,33,653,1137,57.43%,44.42%,1
桃園市,楊梅區,0933,871,189,1060,38,1098,2211,49.66%,39.39%,1
桃園市,楊梅區,0934,752,206,958,32,990,2008,49.3%,37.45%,1
桃園市,楊梅區,0935,762,206,968,33,1001,1911,52.38%,39.87%,1
桃園市,楊梅區,0936,570,178,748,64,812,1449,56.04%,39.34%,1
桃園市,楊梅區,0937,628,170,798,68,866,1877,46.14%,33.46%,1
桃園市,楊梅區,0938,688,205,893,61,954,1988,47.99%,34.61%,1
桃園市,楊梅區,0939,752,197,949,35,984,1931,50.96%,38.94%,1
桃園市,楊梅區,0940,746,161,907,47,954,1938,49.23%,38.49%,1
桃園市,楊梅區,0941,728,128,856,30,886,1677,52.83%,43.41%,1
桃園市,楊梅區,0942,686,203,889,32,921,1848,49.84%,37.12%,1
桃園市,楊梅區,0943,716,194,910,36,946,1882,50.27%,38.04%,1
桃園市,楊梅區,0944,472,110,582,18,600,1541,38.94%,30.63%,1
桃園市,楊梅區,0945,714,173,887,51,938,1938,48.4%,36.84%,1
桃園市,楊梅區,0946,525,142,667,20,687,1562,43.98%,33.61%,1
桃園市,楊梅區,0947,778,331,1109,67,1176,2125,55.34%,36.61%,1
桃園市,楊梅區,0948,653,184,837,48,885,1516,58.38%,43.07%,1
桃園市,楊梅區,0949,677,174,851,38,889,1807,49.2%,37.47%,1
桃園市,楊梅區,0950,728,214,942,49,991,2101,47.17%,34.65%,1
桃園市,楊梅區,0951,802,211,1013,64,1077,2054,52.43%,39.05%,1
桃園市,楊梅區,0952,816,172,988,36,1024,2226,46%,36.66%,1
桃園市,楊梅區,0953,573,152,725,23,748,1405,53.24%,40.78%,1
桃園市,楊梅區,0954,640,186,826,41,867,1843,47.04%,34.73%,1
桃園市,楊梅區,0955,794,204,998,62,1060,2324,45.61%,34.17%,1
桃園市,楊梅區,0956,673,170,843,33,876,1713,51.14%,39.29%,1
桃園市,楊梅區,0957,712,163,875,61,936,1587,58.98%,44.86%,1
桃園市,楊梅區,0958,610,169,779,0,779,1416,55.01%,43.08%,1
桃園市,楊梅區,0959,681,157,838,33,871,1591,54.75%,42.8%,1
桃園市,楊梅區,0960,798,182,980,57,1037,1943,53.37%,41.07%,1
桃園市,楊梅區,0961,682,280,962,43,1005,1762,57.04%,38.71%,1
桃園市,楊梅區,0962,443,91,534,38,572,1083,52.82%,40.9%,1
桃園市,楊梅區,0963,788,199,987,61,1048,2027,51.7%,38.88%,1
桃園市,楊梅區,0964,524,140,664,64,728,1274,57.14%,41.13%,1
桃園市,楊梅區,0965,592,136,728,53,781,1359,57.47%,43.56%,1
桃園市,楊梅區,0966,634,176,810,54,864,2444,35.35%,25.94%,1
桃園市,楊梅區,0967,754,187,941,40,981,2298,42.69%,32.81%,1
桃園市,楊梅區,0968,831,208,1039,48,1087,2222,48.92%,37.4%,1
桃園市,楊梅區,0969,602,175,777,71,848,1610,52.67%,37.39%,1
桃園市,楊梅區,0970,606,169,775,91,866,1627,53.23%,37.25%,1
桃園市,楊梅區,0971,647,157,804,57,861,1589,54.19%,40.72%,1
桃園市,楊梅區,0972,663,194,857,76,933,1758,53.07%,37.71%,1
桃園市,楊梅區,0973,522,184,706,65,771,1776,43.41%,29.39%,1
桃園市,楊梅區,0974,353,93,446,25,471,1000,47.1%,35.3%,1
桃園市,楊梅區,0975,787,175,962,81,1043,2290,45.55%,34.37%,1
桃園市,楊梅區,0976,570,186,756,61,817,1551,52.68%,36.75%,1
桃園市,楊梅區,0977,671,171,842,75,917,1861,49.27%,36.06%,1
桃園市,楊梅區,0978,370,116,486,52,538,1141,47.15%,32.43%,1
桃園市,楊梅區,0979,640,163,803,53,856,1785,47.96%,35.85%,1
桃園市,楊梅區,0980,569,160,729,70,799,1498,53.34%,37.98%,1
桃園市,楊梅區,0981,422,149,571,51,622,1187,52.4%,35.55%,1
桃園市,楊梅區,0982,505,144,649,60,709,1270,55.83%,39.76%,1
桃園市,楊梅區,0983,545,143,688,47,735,1424,51.62%,38.27%,1
桃園市,楊梅區,0984,604,48,652,20,672,1273,52.79%,47.45%,1
桃園市,楊梅區,0985,484,167,651,38,689,1534,44.92%,31.55%,1
桃園市,楊梅區,0986,552,182,734,80,814,1783,45.65%,30.96%,1
桃園市,楊梅區,0987,638,146,784,25,809,1709,47.34%,37.33%,1
桃園市,楊梅區,0988,659,162,821,63,884,1920,46.04%,34.32%,1
桃園市,楊梅區,0989,465,127,592,33,625,1194,52.35%,38.94%,1
桃園市,楊梅區,0990,554,170,724,19,743,1408,52.77%,39.35%,1
桃園市,楊梅區,0991,595,144,739,37,776,1737,44.67%,34.25%,1
桃園市,楊梅區,0992,747,160,907,31,938,1920,48.85%,38.91%,1
桃園市,楊梅區,0993,479,145,624,34,658,1234,53.32%,38.82%,1
桃園市,楊梅區,0994,590,172,762,67,829,1491,55.6%,39.57%,1
桃園市,楊梅區,0995,697,195,892,49,941,2020,46.58%,34.5%,1
桃園市,楊梅區,0996,642,159,801,34,835,1863,44.82%,34.46%,1
桃園市,楊梅區,0997,644,183,827,63,890,1692,52.6%,38.06%,1
桃園市,楊梅區,0998,691,144,835,35,870,1686,51.6%,40.98%,1
桃園市,楊梅區,0999,637,184,821,73,894,1626,54.98%,39.18%,1
桃園市,楊梅區,1000,658,158,816,22,838,1557,53.82%,42.26%,1
桃園市,楊梅區,1001,678,192,870,64,934,1603,58.27%,42.3%,1
桃園市,楊梅區,1002,648,190,838,87,925,1889,48.97%,34.3%,1
桃園市,楊梅區,1003,620,140,760,30,790,1448,54.56%,42.82%,1
桃園市,楊梅區,1004,554,162,716,55,771,1351,57.07%,41.01%,1
桃園市,楊梅區,1005,571,132,703,60,763,1313,58.11%,43.49%,1
桃園市,楊梅區,1006,629,200,829,45,874,1689,51.75%,37.24%,1
桃園市,楊梅區,1007,710,195,905,33,938,2063,45.47%,34.42%,1
桃園市,蘆竹區,0396,428,184,612,89,701,1358,51.62%,31.52%,1
桃園市,蘆竹區,0397,465,205,670,100,770,1538,50.07%,30.23%,1
桃園市,蘆竹區,0398,617,205,822,73,895,2118,42.26%,29.13%,1
桃園市,蘆竹區,0399,639,209,848,77,925,1673,55.29%,38.19%,1
桃園市,蘆竹區,0400,569,183,752,30,782,1500,52.13%,37.93%,1
桃園市,蘆竹區,0401,645,199,844,61,905,1699,53.27%,37.96%,1
桃園市,蘆竹區,0402,828,242,1070,72,1142,2250,50.76%,36.8%,1
桃園市,蘆竹區,0403,778,228,1006,29,1035,2354,43.97%,33.05%,1
桃園市,蘆竹區,0404,478,140,618,28,646,1446,44.67%,33.06%,1
桃園市,蘆竹區,0405,515,164,679,72,751,1623,46.27%,31.73%,1
桃園市,蘆竹區,0406,615,161,776,40,816,1747,46.71%,35.2%,1
桃園市,蘆竹區,0407,683,261,944,77,1021,1988,51.36%,34.36%,1
桃園市,蘆竹區,0408,525,173,698,56,754,1437,52.47%,36.53%,1
桃園市,蘆竹區,0409,596,188,784,72,856,1532,55.87%,38.9%,1
桃園市,蘆竹區,0410,522,128,650,40,690,1447,47.68%,36.07%,1
桃園市,蘆竹區,0411,757,266,1023,66,1089,2189,49.75%,34.58%,1
桃園市,蘆竹區,0412,851,237,1088,76,1164,2498,46.6%,34.07%,1
桃園市,蘆竹區,0413,454,199,653,35,688,1322,52.04%,34.34%,1
桃園市,蘆竹區,0414,551,200,751,91,842,1991,42.29%,27.67%,1
桃園市,蘆竹區,0415,657,237,894,84,978,2097,46.64%,31.33%,1
桃園市,蘆竹區,0416,619,179,798,45,843,1558,54.11%,39.73%,1
桃園市,蘆竹區,0417,735,202,937,53,990,1891,52.35%,38.87%,1
桃園市,蘆竹區,0418,564,156,720,52,772,1590,48.55%,35.47%,1
桃園市,蘆竹區,0419,762,250,1012,59,1071,2404,44.55%,31.7%,1
桃園市,蘆竹區,0420,936,263,1199,51,1250,2522,49.56%,37.11%,1
桃園市,蘆竹區,0421,623,186,809,32,841,1633,51.5%,38.15%,1
桃園市,蘆竹區,0422,632,188,820,58,878,1715,51.2%,36.85%,1
桃園市,蘆竹區,0423,697,244,941,36,977,2215,44.11%,31.47%,1
桃園市,蘆竹區,0424,708,216,924,51,975,2029,48.05%,34.89%,1
桃園市,蘆竹區,0425,612,175,787,46,833,1731,48.12%,35.36%,1
桃園市,蘆竹區,0426,708,174,882,44,926,1820,50.88%,38.9%,1
桃園市,蘆竹區,0427,634,177,811,64,875,1633,53.58%,38.82%,1
桃園市,蘆竹區,0428,498,178,676,33,709,1668,42.51%,29.86%,1
桃園市,蘆竹區,0429,599,172,771,40,811,1493,54.32%,40.12%,1
桃園市,蘆竹區,0430,650,233,883,79,962,1864,51.61%,34.87%,1
桃園市,蘆竹區,0431,576,173,749,33,782,1703,45.92%,33.82%,1
桃園市,蘆竹區,0432,656,210,866,43,909,1893,48.02%,34.65%,1
桃園市,蘆竹區,0433,730,252,982,76,1058,1922,55.05%,37.98%,1
桃園市,蘆竹區,0434,535,169,704,33,737,1393,52.91%,38.41%,1
桃園市,蘆竹區,0435,511,170,681,53,734,1338,54.86%,38.19%,1
桃園市,蘆竹區,0436,620,194,814,43,857,1688,50.77%,36.73%,1
桃園市,蘆竹區,0437,486,195,681,71,752,1462,51.44%,33.24%,1
桃園市,蘆竹區,0438,423,159,582,30,612,1232,49.68%,34.33%,1
桃園市,蘆竹區,0439,481,129,610,36,646,1356,47.64%,35.47%,1
桃園市,蘆竹區,0440,517,133,650,62,712,1181,60.29%,43.78%,1
桃園市,蘆竹區,0441,458,121,579,28,607,1199,50.63%,38.2%,1
桃園市,蘆竹區,0442,685,172,857,52,909,1710,53.16%,40.06%,1
桃園市,蘆竹區,0443,508,158,666,38,704,1423,49.47%,35.7%,1
桃園市,蘆竹區,0444,582,182,764,49,813,1522,53.42%,38.24%,1
桃園市,蘆竹區,0445,644,182,826,44,870,1639,53.08%,39.29%,1
桃園市,蘆竹區,0446,746,220,966,53,1019,2055,49.59%,36.3%,1
桃園市,蘆竹區,0447,810,233,1043,43,1086,2178,49.86%,37.19%,1
桃園市,蘆竹區,0448,680,195,875,37,912,1709,53.36%,39.79%,1
桃園市,蘆竹區,0449,674,185,859,55,914,1667,54.83%,40.43%,1
桃園市,蘆竹區,0450,708,175,883,47,930,1745,53.3%,40.57%,1
桃園市,蘆竹區,0451,788,240,1028,55,1083,1967,55.06%,40.06%,1
桃園市,蘆竹區,0452,740,206,946,39,985,1802,54.66%,41.07%,1
桃園市,蘆竹區,0453,992,265,1257,54,1311,2727,48.07%,36.38%,1
桃園市,蘆竹區,0454,633,188,821,40,861,1868,46.09%,33.89%,1
桃園市,蘆竹區,0455,562,171,733,45,778,1537,50.62%,36.56%,1
桃園市,蘆竹區,0456,591,198,789,53,842,1616,52.1%,36.57%,1
桃園市,蘆竹區,0457,591,197,788,66,854,1483,57.59%,39.85%,1
桃園市,蘆竹區,0458,621,171,792,50,842,1689,49.85%,36.77%,1
桃園市,蘆竹區,0459,385,124,509,56,565,1318,42.87%,29.21%,1
桃園市,蘆竹區,0460,582,75,657,102,759,1203,63.09%,48.38%,1
桃園市,蘆竹區,0461,574,200,774,29,803,1771,45.34%,32.41%,1
桃園市,蘆竹區,0462,518,243,761,101,862,1832,47.05%,28.28%,1
桃園市,蘆竹區,0463,566,215,781,108,889,1763,50.43%,32.1%,1
桃園市,蘆竹區,0464,381,192,573,23,596,1497,39.81%,25.45%,1
桃園市,蘆竹區,0465,610,242,852,133,985,1671,58.95%,36.51%,1
桃園市,蘆竹區,0466,321,134,455,78,533,929,57.37%,34.55%,1
桃園市,蘆竹區,0467,511,238,749,122,871,1559,55.87%,32.78%,1
桃園市,蘆竹區,0468,552,153,705,34,739,1497,49.37%,36.87%,1
桃園市,蘆竹區,0469,608,219,827,85,912,1441,63.29%,42.19%,1
桃園市,蘆竹區,0470,499,176,675,62,737,1465,50.31%,34.06%,1
桃園市,蘆竹區,0471,345,146,491,42,533,1029,51.8%,33.53%,1
桃園市,大園區,0472,487,167,654,50,704,1538,45.77%,31.66%,1
桃園市,大園區,0473,444,151,595,36,631,1616,39.05%,27.48%,1
桃園市,大園區,0474,556,196,752,60,812,1437,56.51%,38.69%,1
桃園市,大園區,0475,597,190,787,50,837,1554,53.86%,38.42%,1
桃園市,大園區,0476,436,157,593,47,640,1237,51.74%,35.25%,1
桃園市,大園區,0477,478,148,626,67,693,1347,51.45%,35.49%,1
桃園市,大園區,0478,434,146,580,31,611,1261,48.45%,34.42%,1
桃園市,大園區,0479,444,135,579,57,636,1256,50.64%,35.35%,1
桃園市,大園區,0480,449,127,576,38,614,1370,44.82%,32.77%,1
桃園市,大園區,0481,517,179,696,51,747,1610,46.4%,32.11%,1
桃園市,大園區,0482,469,180,649,61,710,1419,50.04%,33.05%,1
桃園市,大園區,0483,456,136,592,27,619,1588,38.98%,28.72%,1
桃園市,大園區,0484,572,185,757,49,806,1612,50%,35.48%,1
桃園市,大園區,0485,501,161,662,48,710,1440,49.31%,34.79%,1
桃園市,大園區,0486,440,163,603,43,646,1326,48.72%,33.18%,1
桃園市,大園區,0487,579,171,750,66,816,1455,56.08%,39.79%,1
桃園市,大園區,0488,574,191,765,70,835,1562,53.46%,36.75%,1
桃園市,大園區,0489,523,154,677,36,713,1284,55.53%,40.73%,1
桃園市,大園區,0490,514,144,658,29,687,1454,47.25%,35.35%,1
桃園市,大園區,0491,561,162,723,36,759,1490,50.94%,37.65%,1
桃園市,大園區,0492,483,183,666,43,709,1617,43.85%,29.87%,1
桃園市,大園區,0493,519,208,727,95,822,1594,51.57%,32.56%,1
桃園市,大園區,0494,582,183,765,68,833,1650,50.48%,35.27%,1
桃園市,大園區,0495,478,201,679,26,705,1467,48.06%,32.58%,1
桃園市,大園區,0496,527,166,693,43,736,1494,49.26%,35.27%,1
桃園市,大園區,0497,544,161,705,66,771,1538,50.13%,35.37%,1
桃園市,大園區,0498,486,153,639,30,669,1397,47.89%,34.79%,1
桃園市,大園區,0499,556,173,729,27,756,1637,46.18%,33.96%,1
桃園市,大園區,0500,493,146,639,60,699,1452,48.14%,33.95%,1
桃園市,大園區,0501,578,154,732,61,793,1414,56.08%,40.88%,1
桃園市,大園區,0502,571,190,761,44,805,1670,48.2%,34.19%,1
桃園市,大園區,0503,599,155,754,62,816,1701,47.97%,35.21%,1
桃園市,大園區,0504,520,168,688,41,729,1813,40.21%,28.68%,1
桃園市,大園區,0505,531,177,708,56,764,1687,45.29%,31.48%,1
桃園市,大園區,0506,608,191,799,18,817,1650,49.52%,36.85%,1
桃園市,大園區,0507,631,192,823,54,877,1556,56.36%,40.55%,1
桃園市,大園區,0508,597,181,778,40,818,1844,44.36%,32.38%,1
桃園市,大園區,0509,461,125,586,67,653,1336,48.88%,34.51%,1
桃園市,大園區,0510,510,208,718,68,786,1414,55.59%,36.07%,1
桃園市,大園區,0511,509,167,676,57,733,1238,59.21%,41.11%,1
桃園市,大園區,0512,511,170,681,57,738,1227,60.15%,41.65%,1
桃園市,大園區,0513,406,148,554,27,581,1199,48.46%,33.86%,1
桃園市,大園區,0514,424,141,565,32,597,1349,44.26%,31.43%,1
桃園市,大園區,0515,375,137,512,39,551,1120,49.2%,33.48%,1
桃園市,大園區,0516,396,112,508,36,544,1080,50.37%,36.67%,1
桃園市,大園區,0517,459,145,604,54,658,1341,49.07%,34.23%,1
桃園市,大園區,0518,501,176,677,39,716,1345,53.23%,37.25%,1
桃園市,大園區,0519,496,147,643,57,700,1565,44.73%,31.69%,1
桃園市,大園區,0520,468,157,625,31,656,1519,43.19%,30.81%,1
桃園市,大園區,0521,718,198,916,71,987,2130,46.34%,33.71%,1
桃園市,龜山區,0217,398,56,454,25,479,874,54.81%,45.54%,1
桃園市,龜山區,0218,821,177,998,83,1081,2014,53.67%,40.76%,1
桃園市,龜山區,0219,760,235,995,38,1033,2145,48.16%,35.43%,1
桃園市,龜山區,0220,771,109,880,65,945,1744,54.19%,44.21%,1
桃園市,龜山區,0221,795,158,953,63,1016,1885,53.9%,42.18%,1
桃園市,龜山區,0222,355,340,695,59,754,1546,48.77%,22.96%,1
桃園市,龜山區,0223,577,190,767,72,839,1684,49.82%,34.26%,1
桃園市,龜山區,0224,448,169,617,39,656,1477,44.41%,30.33%,1
桃園市,龜山區,0225,660,139,799,55,854,1528,55.89%,43.19%,1
桃園市,龜山區,0226,207,68,275,16,291,1428,20.38%,14.5%,1
桃園市,龜山區,0227,570,196,766,66,832,1525,54.56%,37.38%,1
桃園市,龜山區,0228,412,135,547,60,607,1041,58.31%,39.58%,1
桃園市,龜山區,0229,473,176,649,34,683,1404,48.65%,33.69%,1
桃園市,龜山區,0230,554,189,743,69,812,1478,54.94%,37.48%,1
桃園市,龜山區,0231,794,250,1044,65,1109,2178,50.92%,36.46%,1
桃園市,龜山區,0232,595,215,810,87,897,1672,53.65%,35.59%,1
桃園市,龜山區,0233,487,141,628,44,672,1376,48.84%,35.39%,1
桃園市,龜山區,0234,499,192,691,57,748,1480,50.54%,33.72%,1
桃園市,龜山區,0235,482,153,635,49,684,1258,54.37%,38.31%,1
桃園市,龜山區,0236,559,161,720,32,752,1464,51.37%,38.18%,1
桃園市,龜山區,0237,638,193,831,102,933,1844,50.6%,34.6%,1
桃園市,龜山區,0238,443,134,577,27,604,1169,51.67%,37.9%,1
桃園市,龜山區,0239,536,166,702,32,734,1921,38.21%,27.9%,1
桃園市,龜山區,0240,576,183,759,32,791,1694,46.69%,34%,1
桃園市,龜山區,0241,703,212,915,66,981,1771,55.39%,39.7%,1
桃園市,龜山區,0242,551,170,721,65,786,1665,47.21%,33.09%,1
桃園市,龜山區,0243,466,179,645,75,720,1439,50.03%,32.38%,1
桃園市,龜山區,0244,534,180,714,70,784,1728,45.37%,30.9%,1
桃園市,龜山區,0245,668,184,852,55,907,1788,50.73%,37.36%,1
桃園市,龜山區,0246,486,152,638,60,698,1465,47.65%,33.17%,1
桃園市,龜山區,0247,493,148,641,46,687,1659,41.41%,29.72%,1
桃園市,龜山區,0248,539,147,686,39,725,1693,42.82%,31.84%,1
桃園市,龜山區,0249,501,147,648,20,668,1818,36.74%,27.56%,1
桃園市,龜山區,0250,568,234,802,79,881,1752,50.29%,32.42%,1
桃園市,龜山區,0251,605,240,845,43,888,1818,48.84%,33.28%,1
桃園市,龜山區,0252,555,175,730,26,756,1499,50.43%,37.02%,1
桃園市,龜山區,0253,664,220,884,61,945,1916,49.32%,34.66%,1
桃園市,龜山區,0254,619,214,833,57,890,1804,49.33%,34.31%,1
桃園市,龜山區,0255,699,243,942,46,988,2127,46.45%,32.86%,1
桃園市,龜山區,0256,326,145,471,64,535,1005,53.23%,32.44%,1
桃園市,龜山區,0257,575,148,723,36,759,1449,52.38%,39.68%,1
桃園市,龜山區,0258,484,173,657,62,719,1498,48%,32.31%,1
桃園市,龜山區,0259,669,225,894,63,957,2149,44.53%,31.13%,1
桃園市,龜山區,0260,485,128,613,42,655,1771,36.98%,27.39%,1
桃園市,龜山區,0261,294,103,397,32,429,841,51.01%,34.96%,1
桃園市,龜山區,0262,723,257,980,66,1046,2284,45.8%,31.65%,1
桃園市,龜山區,0263,412,166,578,72,650,1228,52.93%,33.55%,1
桃園市,龜山區,0264,638,187,825,52,877,1979,44.32%,32.24%,1
桃園市,龜山區,0265,457,129,586,38,624,1378,45.28%,33.16%,1
桃園市,龜山區,0266,361,129,490,42,532,1061,50.14%,34.02%,1
桃園市,龜山區,0267,651,192,843,56,899,1917,46.9%,33.96%,1
桃園市,龜山區,0268,687,170,857,46,903,1540,58.64%,44.61%,1
桃園市,龜山區,0269,589,151,740,34,774,1433,54.01%,41.1%,1
桃園市,龜山區,0270,505,177,682,39,721,1455,49.55%,34.71%,1
桃園市,龜山區,0271,867,278,1145,70,1215,2280,53.29%,38.03%,1
桃園市,龜山區,0272,594,199,793,48,841,1668,50.42%,35.61%,1
桃園市,龜山區,0273,624,221,845,47,892,1885,47.32%,33.1%,1
桃園市,龜山區,0274,628,239,867,37,904,1849,48.89%,33.96%,1
桃園市,龜山區,0275,643,264,907,35,942,1704,55.28%,37.73%,1
桃園市,龜山區,0276,416,152,568,47,615,1156,53.2%,35.99%,1
桃園市,龜山區,0277,635,181,816,69,885,2114,41.86%,30.04%,1
桃園市,龜山區,0278,592,193,785,35,820,1943,42.2%,30.47%,1
桃園市,龜山區,0279,597,198,795,39,834,1800,46.33%,33.17%,1
桃園市,龜山區,0280,673,241,914,57,971,2020,48.07%,33.32%,1
桃園市,龜山區,0281,554,135,689,43,732,1319,55.5%,42%,1
桃園市,龜山區,0282,852,267,1119,48,1167,2229,52.36%,38.22%,1
桃園市,龜山區,0283,702,238,940,26,966,1992,48.49%,35.24%,1
桃園市,龜山區,0284,749,236,985,71,1056,2237,47.21%,33.48%,1
桃園市,龜山區,0285,775,209,984,44,1028,2133,48.2%,36.33%,1
桃園市,龜山區,0286,788,256,1044,62,1106,2187,50.57%,36.03%,1
桃園市,龜山區,0287,689,208,897,59,956,1959,48.8%,35.17%,1
桃園市,龜山區,0288,597,228,825,41,866,1910,45.34%,31.26%,1
桃園市,龜山區,0289,626,252,878,100,978,1840,53.15%,34.02%,1
桃園市,龜山區,0290,815,257,1072,55,1127,2266,49.74%,35.97%,1
桃園市,龜山區,0291,826,203,1029,31,1060,2387,44.41%,34.6%,1
桃園市,龜山區,0292,570,177,747,35,782,1692,46.22%,33.69%,1
桃園市,龜山區,0293,334,104,438,21,459,904,50.77%,36.95%,1
桃園市,龜山區,0294,600,156,756,26,782,1469,53.23%,40.84%,1
桃園市,八德區,0295,583,164,747,89,836,1761,47.47%,33.11%,1
桃園市,八德區,0296,520,173,693,24,717,1804,39.75%,28.82%,1
桃園市,八德區,0297,364,120,484,37,521,1813,28.74%,20.08%,1
桃園市,八德區,0298,614,153,767,42,809,1784,45.35%,34.42%,1
桃園市,八德區,0299,718,166,884,59,943,2257,41.78%,31.81%,1
桃園市,八德區,0300,549,163,712,34,746,1857,40.17%,29.56%,1
桃園市,八德區,0301,742,205,947,53,1000,2261,44.23%,32.82%,1
桃園市,八德區,0302,716,183,899,76,975,1903,51.23%,37.62%,1
桃園市,八德區,0303,721,190,911,71,982,1955,50.23%,36.88%,1
桃園市,八德區,0304,534,157,691,14,705,1665,42.34%,32.07%,1
桃園市,八德區,0305,538,171,709,72,781,1431,54.58%,37.6%,1
桃園市,八德區,0306,490,152,642,41,683,1263,54.08%,38.8%,1
桃園市,八德區,0307,614,190,804,80,884,1583,55.84%,38.79%,1
桃園市,八德區,0308,490,147,637,47,684,1246,54.9%,39.33%,1
桃園市,八德區,0309,532,152,684,40,724,1356,53.39%,39.23%,1
桃園市,八德區,0310,639,172,811,83,894,1630,54.85%,39.2%,1
桃園市,八德區,0311,556,141,697,38,735,1586,46.34%,35.06%,1
桃園市,八德區,0312,599,191,790,75,865,1649,52.46%,36.33%,1
桃園市,八德區,0313,612,181,793,99,892,1910,46.7%,32.04%,1
桃園市,八德區,0314,624,183,807,85,892,1612,55.33%,38.71%,1
桃園市,八德區,0315,671,137,808,48,856,1640,52.2%,40.91%,1
桃園市,八德區,0316,445,165,610,54,664,1303,50.96%,34.15%,1
桃園市,八德區,0317,600,149,749,53,802,1413,56.76%,42.46%,1
桃園市,八德區,0318,583,219,802,63,865,1711,50.56%,34.07%,1
桃園市,八德區,0319,608,148,756,82,838,1562,53.65%,38.92%,1
桃園市,八德區,0320,657,166,823,59,882,1735,50.84%,37.87%,1
桃園市,八德區,0321,631,172,803,41,844,1658,50.9%,38.06%,1
桃園市,八德區,0322,423,138,561,49,610,1022,59.69%,41.39%,1
桃園市,八德區,0323,545,172,717,55,772,1673,46.14%,32.58%,1
桃園市,八德區,0324,623,167,790,41,831,1741,47.73%,35.78%,1
桃園市,八德區,0325,774,213,987,80,1067,2110,50.57%,36.68%,1
桃園市,八德區,0326,486,91,577,30,607,1145,53.01%,42.45%,1
桃園市,八德區,0327,463,86,549,38,587,1010,58.12%,45.84%,1
桃園市,八德區,0328,587,178,765,26,791,1848,42.8%,31.76%,1
桃園市,八德區,0329,516,154,670,50,720,1334,53.97%,38.68%,1
桃園市,八德區,0330,426,119,545,34,579,1349,42.92%,31.58%,1
桃園市,八德區,0331,552,162,714,46,760,1341,56.67%,41.16%,1
桃園市,八德區,0332,476,141,617,61,678,1178,57.56%,40.41%,1
桃園市,八德區,0333,529,162,691,46,737,1374,53.64%,38.5%,1
桃園市,八德區,0334,468,192,660,76,736,1462,50.34%,32.01%,1
桃園市,八德區,0335,598,177,775,65,840,1943,43.23%,30.78%,1
桃園市,八德區,0336,493,275,768,94,862,1928,44.71%,25.57%,1
桃園市,八德區,0337,447,150,597,37,634,1403,45.19%,31.86%,1
桃園市,八德區,0338,544,185,729,70,799,1672,47.79%,32.54%,1
桃園市,八德區,0339,630,210,840,44,884,1947,45.4%,32.36%,1
桃園市,八德區,0340,460,153,613,47,660,1200,55%,38.33%,1
桃園市,八德區,0341,603,205,808,85,893,1895,47.12%,31.82%,1
桃園市,八德區,0342,651,197,848,67,915,1988,46.03%,32.75%,1
桃園市,八德區,0343,729,231,960,83,1043,2006,51.99%,36.34%,1
桃園市,八德區,0344,667,222,889,13,902,2061,43.77%,32.36%,1
桃園市,八德區,0345,647,245,892,74,966,2108,45.83%,30.69%,1
桃園市,八德區,0346,728,101,829,60,889,1862,47.74%,39.1%,1
桃園市,八德區,0347,620,174,794,29,823,1681,48.96%,36.88%,1
桃園市,八德區,0348,486,160,646,65,711,1317,53.99%,36.9%,1
桃園市,八德區,0349,842,243,1085,77,1162,2093,55.52%,40.23%,1
桃園市,八德區,0350,570,209,779,70,849,1499,56.64%,38.03%,1
桃園市,八德區,0351,643,196,839,65,904,1782,50.73%,36.08%,1
桃園市,八德區,0352,697,168,865,34,899,1763,50.99%,39.53%,1
桃園市,八德區,0353,456,152,608,59,667,1226,54.4%,37.19%,1
桃園市,八德區,0354,527,153,680,40,720,1311,54.92%,40.2%,1
桃園市,八德區,0355,477,141,618,46,664,1170,56.75%,40.77%,1
桃園市,八德區,0356,545,127,672,39,711,1313,54.15%,41.51%,1
桃園市,八德區,0357,492,122,614,32,646,1186,54.47%,41.48%,1
桃園市,八德區,0358,512,159,671,50,721,1481,48.68%,34.57%,1
桃園市,八德區,0359,749,207,956,69,1025,1998,51.3%,37.49%,1
桃園市,八德區,0360,368,110,478,31,509,916,55.57%,40.17%,1
桃園市,八德區,0361,706,168,874,54,928,1943,47.76%,36.34%,1
桃園市,八德區,0362,785,160,945,44,989,2076,47.64%,37.81%,1
桃園市,八德區,0363,502,155,657,69,726,1363,53.26%,36.83%,1
桃園市,八德區,0364,535,186,721,60,781,1491,52.38%,35.88%,1
桃園市,八德區,0365,507,172,679,75,754,1474,51.15%,34.4%,1
桃園市,八德區,0366,131,22,153,22,175,718,24.37%,18.25%,1
桃園市,八德區,0367,506,168,674,56,730,1386,52.67%,36.51%,1
桃園市,八德區,0368,557,142,699,72,771,1487,51.85%,37.46%,1
桃園市,八德區,0369,623,109,732,80,812,1552,52.32%,40.14%,1
桃園市,八德區,0370,471,88,559,55,614,1255,48.92%,37.53%,1
桃園市,八德區,0371,618,150,768,70,838,1505,55.68%,41.06%,1
桃園市,八德區,0372,464,163,627,74,701,1436,48.82%,32.31%,1
桃園市,八德區,0373,579,223,802,74,876,1618,54.14%,35.78%,1
桃園市,八德區,0374,616,166,782,66,848,1685,50.33%,36.56%,1
桃園市,八德區,0375,641,143,784,63,847,1835,46.16%,34.93%,1
桃園市,八德區,0376,692,180,872,76,948,1881,50.4%,36.79%,1
桃園市,八德區,0377,607,174,781,54,835,1766,47.28%,34.37%,1
桃園市,八德區,0378,655,172,827,93,920,1817,50.63%,36.05%,1
桃園市,八德區,0379,885,189,1074,45,1119,2198,50.91%,40.26%,1
桃園市,八德區,0380,651,182,833,69,902,1732,52.08%,37.59%,1
桃園市,八德區,0381,821,213,1034,36,1070,2089,51.22%,39.3%,1
桃園市,八德區,0382,488,151,639,35,674,1257,53.62%,38.82%,1
桃園市,八德區,0383,441,146,587,69,656,1267,51.78%,34.81%,1
桃園市,八德區,0384,613,127,740,23,763,1427,53.47%,42.96%,1
桃園市,八德區,0385,709,204,913,59,972,1685,57.69%,42.08%,1
桃園市,八德區,0386,684,204,888,56,944,1748,54%,39.13%,1
桃園市,八德區,0387,870,189,1059,66,1125,1650,68.18%,52.73%,1
桃園市,八德區,0388,558,190,748,53,801,1478,54.19%,37.75%,1
桃園市,八德區,0389,624,167,791,68,859,1607,53.45%,38.83%,1
桃園市,八德區,0390,727,209,936,82,1018,1841,55.3%,39.49%,1
桃園市,八德區,0391,753,218,971,79,1050,2082,50.43%,36.17%,1
桃園市,八德區,0392,646,188,834,64,898,1959,45.84%,32.98%,1
桃園市,八德區,0393,823,247,1070,60,1130,2209,51.15%,37.26%,1
桃園市,八德區,0394,759,158,917,56,973,1864,52.2%,40.72%,1
桃園市,八德區,0395,687,215,902,67,969,2000,48.45%,34.35%,1
桃園市,龍潭區,1008,568,139,707,28,735,1482,49.6%,38.33%,1
桃園市,龍潭區,1009,565,155,720,51,771,1528,50.46%,36.98%,1
桃園市,龍潭區,1010,578,147,725,48,773,1503,51.43%,38.46%,1
桃園市,龍潭區,1011,570,170,740,54,794,1568,50.64%,36.35%,1
桃園市,龍潭區,1012,449,113,562,67,629,1216,51.73%,36.92%,1
桃園市,龍潭區,1013,670,197,867,82,949,2088,45.45%,32.09%,1
桃園市,龍潭區,1014,828,205,1033,79,1112,1987,55.96%,41.67%,1
桃園市,龍潭區,1015,702,161,863,50,913,1586,57.57%,44.26%,1
桃園市,龍潭區,1016,407,165,572,46,618,1221,50.61%,33.33%,1
桃園市,龍潭區,1017,449,136,585,54,639,1134,56.35%,39.59%,1
桃園市,龍潭區,1018,716,203,919,62,981,2081,47.14%,34.41%,1
桃園市,龍潭區,1019,547,283,830,43,873,1925,45.35%,28.42%,1
桃園市,龍潭區,1020,928,154,1082,37,1119,2095,53.41%,44.3%,1
桃園市,龍潭區,1021,951,150,1101,59,1160,2040,56.86%,46.62%,1
桃園市,龍潭區,1022,630,192,822,59,881,1790,49.22%,35.2%,1
桃園市,龍潭區,1023,697,225,922,96,1018,1872,54.38%,37.23%,1
桃園市,龍潭區,1024,692,206,898,77,975,1726,56.49%,40.09%,1
桃園市,龍潭區,1025,709,205,914,60,974,1792,54.35%,39.56%,1
桃園市,龍潭區,1026,548,145,693,38,731,1398,52.29%,39.2%,1
桃園市,龍潭區,1027,489,129,618,44,662,1345,49.22%,36.36%,1
桃園市,龍潭區,1028,585,134,719,51,770,1409,54.65%,41.52%,1
桃園市,龍潭區,1029,470,136,606,28,634,1362,46.55%,34.51%,1
桃園市,龍潭區,1030,668,213,881,55,936,1650,56.73%,40.48%,1
桃園市,龍潭區,1031,623,165,788,44,832,1597,52.1%,39.01%,1
桃園市,龍潭區,1032,546,154,700,36,736,1410,52.2%,38.72%,1
桃園市,龍潭區,1033,511,145,656,54,710,1275,55.69%,40.08%,1
桃園市,龍潭區,1034,771,250,1021,66,1087,1909,56.94%,40.39%,1
桃園市,龍潭區,1035,851,205,1056,33,1089,2024,53.8%,42.05%,1
桃園市,龍潭區,1036,812,205,1017,59,1076,2002,53.75%,40.56%,1
桃園市,龍潭區,1037,751,205,956,52,1008,1786,56.44%,42.05%,1
桃園市,龍潭區,1038,707,143,850,44,894,1756,50.91%,40.26%,1
桃園市,龍潭區,1039,781,181,962,37,999,1830,54.59%,42.68%,1
桃園市,龍潭區,1040,791,173,964,32,996,1697,58.69%,46.61%,1
桃園市,龍潭區,1041,659,127,786,38,824,1519,54.25%,43.38%,1
桃園市,龍潭區,1042,674,163,837,50,887,1805,49.14%,37.34%,1
桃園市,龍潭區,1043,633,137,770,42,812,1792,45.31%,35.32%,1
桃園市,龍潭區,1044,657,153,810,65,875,1500,58.33%,43.8%,1
桃園市,龍潭區,1045,522,138,660,31,691,1427,48.42%,36.58%,1
桃園市,龍潭區,1046,480,130,610,45,655,1444,45.36%,33.24%,1
桃園市,龍潭區,1047,505,121,626,45,671,1321,50.79%,38.23%,1
桃園市,龍潭區,1048,542,148,690,40,730,1215,60.08%,44.61%,1
桃園市,龍潭區,1049,491,139,630,64,694,1297,53.51%,37.86%,1
桃園市,龍潭區,1050,545,122,667,17,684,1407,48.61%,38.73%,1
桃園市,龍潭區,1051,563,160,723,49,772,1564,49.36%,36%,1
桃園市,龍潭區,1052,498,145,643,58,701,1317,53.23%,37.81%,1
桃園市,龍潭區,1053,383,78,461,47,508,1023,49.66%,37.44%,1
桃園市,龍潭區,1054,670,188,858,62,920,1721,53.46%,38.93%,1
桃園市,龍潭區,1055,754,152,906,69,975,1764,55.27%,42.74%,1
桃園市,龍潭區,1056,467,264,731,71,802,1499,53.5%,31.15%,1
桃園市,龍潭區,1057,766,180,946,52,998,2151,46.4%,35.61%,1
桃園市,龍潭區,1058,691,124,815,31,846,1524,55.51%,45.34%,1
桃園市,龍潭區,1059,679,154,833,29,862,1456,59.2%,46.63%,1
桃園市,龍潭區,1060,905,156,1061,48,1109,1847,60.04%,49%,1
桃園市,龍潭區,1061,923,173,1096,32,1128,1899,59.4%,48.6%,1
桃園市,龍潭區,1062,730,161,891,38,929,1725,53.86%,42.32%,1
桃園市,龍潭區,1063,786,169,955,56,1011,1665,60.72%,47.21%,1
桃園市,龍潭區,1064,625,146,771,42,813,1649,49.3%,37.9%,1
桃園市,龍潭區,1065,556,138,694,44,738,1539,47.95%,36.13%,1
桃園市,龍潭區,1066,551,176,727,60,787,1541,51.07%,35.76%,1
桃園市,龍潭區,1067,545,150,695,55,750,1375,54.55%,39.64%,1
桃園市,龍潭區,1068,587,163,750,33,783,1453,53.89%,40.4%,1
桃園市,龍潭區,1069,443,125,568,49,617,1074,57.45%,41.25%,1
桃園市,龍潭區,1070,607,131,738,16,754,1299,58.04%,46.73%,1
桃園市,龍潭區,1071,188,99,287,30,317,678,46.76%,27.73%,1
桃園市,平鎮區,0801,505,165,670,57,727,1487,48.89%,33.96%,1
桃園市,平鎮區,0802,555,142,697,57,754,1453,51.89%,38.2%,1
桃園市,平鎮區,0803,580,179,759,50,809,1491,54.26%,38.9%,1
桃園市,平鎮區,0804,478,165,643,57,700,1346,52.01%,35.51%,1
桃園市,平鎮區,0805,594,174,768,47,815,1660,49.1%,35.78%,1
桃園市,平鎮區,0806,679,164,843,47,890,1921,46.33%,35.35%,1
桃園市,平鎮區,0807,823,188,1011,59,1070,1974,54.2%,41.69%,1
桃園市,平鎮區,0808,709,184,893,42,935,1867,50.08%,37.98%,1
桃園市,平鎮區,0809,704,173,877,46,923,1786,51.68%,39.42%,1
桃園市,平鎮區,0810,522,131,653,34,687,1634,42.04%,31.95%,1
桃園市,平鎮區,0811,449,111,560,24,584,1080,54.07%,41.57%,1
桃園市,平鎮區,0812,600,164,764,28,792,1514,52.31%,39.63%,1
桃園市,平鎮區,0813,665,151,816,69,885,1918,46.14%,34.67%,1
桃園市,平鎮區,0814,425,155,580,73,653,1182,55.25%,35.96%,1
桃園市,平鎮區,0815,592,169,761,43,804,1667,48.23%,35.51%,1
桃園市,平鎮區,0816,559,157,716,41,757,1640,46.16%,34.09%,1
桃園市,平鎮區,0817,623,160,783,31,814,1603,50.78%,38.86%,1
桃園市,平鎮區,0818,669,163,832,16,848,1556,54.5%,42.99%,1
桃園市,平鎮區,0819,628,159,787,42,829,1697,48.85%,37.01%,1
桃園市,平鎮區,0820,411,95,506,19,525,1130,46.46%,36.37%,1
桃園市,平鎮區,0821,462,119,581,44,625,1196,52.26%,38.63%,1
桃園市,平鎮區,0822,667,164,831,38,869,1685,51.57%,39.58%,1
桃園市,平鎮區,0823,611,195,806,58,864,1532,56.4%,39.88%,1
桃園市,平鎮區,0824,607,160,767,34,801,1564,51.21%,38.81%,1
桃園市,平鎮區,0825,602,127,729,30,759,1824,41.61%,33%,1
桃園市,平鎮區,0826,693,179,872,32,904,1912,47.28%,36.24%,1
桃園市,平鎮區,0827,403,112,515,46,561,1048,53.53%,38.45%,1
桃園市,平鎮區,0828,524,126,650,58,708,1259,56.24%,41.62%,1
桃園市,平鎮區,0829,337,182,519,22,541,1061,50.99%,31.76%,1
桃園市,平鎮區,0830,484,119,603,31,634,1072,59.14%,45.15%,1
桃園市,平鎮區,0831,644,191,835,62,897,1788,50.17%,36.02%,1
桃園市,平鎮區,0832,629,127,756,35,791,1510,52.38%,41.66%,1
桃園市,平鎮區,0833,542,143,685,53,738,1403,52.6%,38.63%,1
桃園市,平鎮區,0834,544,154,698,69,767,1407,54.51%,38.66%,1
桃園市,平鎮區,0835,719,237,956,60,1016,1901,53.45%,37.82%,1
桃園市,平鎮區,0836,702,182,884,32,916,1994,45.94%,35.21%,1
桃園市,平鎮區,0837,663,177,840,56,896,1730,51.79%,38.32%,1
桃園市,平鎮區,0838,764,189,953,51,1004,1905,52.7%,40.1%,1
桃園市,平鎮區,0839,712,186,898,37,935,1723,54.27%,41.32%,1
桃園市,平鎮區,0840,514,140,654,56,710,1307,54.32%,39.33%,1
桃園市,平鎮區,0841,530,158,688,46,734,1337,54.9%,39.64%,1
桃園市,平鎮區,0842,460,129,589,46,635,980,64.8%,46.94%,1
桃園市,平鎮區,0843,645,228,873,57,930,1818,51.16%,35.48%,1
桃園市,平鎮區,0844,571,182,753,50,803,1463,54.89%,39.03%,1
桃園市,平鎮區,0845,507,162,669,32,701,1213,57.79%,41.8%,1
桃園市,平鎮區,0846,437,135,572,43,615,1085,56.68%,40.28%,1
桃園市,平鎮區,0847,536,148,684,33,717,1458,49.18%,36.76%,1
桃園市,平鎮區,0848,550,165,715,56,771,1408,54.76%,39.06%,1
桃園市,平鎮區,0849,492,169,661,57,718,1396,51.43%,35.24%,1
桃園市,平鎮區,0850,482,155,637,33,670,1044,64.18%,46.17%,1
桃園市,平鎮區,0851,483,115,598,14,612,1124,54.45%,42.97%,1
桃園市,平鎮區,0852,653,107,760,28,788,1517,51.94%,43.05%,1
桃園市,平鎮區,0853,626,156,782,29,811,1571,51.62%,39.85%,1
桃園市,平鎮區,0854,744,188,932,36,968,1752,55.25%,42.47%,1
桃園市,平鎮區,0855,634,189,823,31,854,1434,59.55%,44.21%,1
桃園市,平鎮區,0856,731,201,932,48,980,1710,57.31%,42.75%,1
桃園市,平鎮區,0857,644,177,821,43,864,1555,55.56%,41.41%,1
桃園市,平鎮區,0858,906,19,925,35,960,2051,46.81%,44.17%,1
桃園市,平鎮區,0859,566,185,751,37,788,1477,53.35%,38.32%,1
桃園市,平鎮區,0860,583,168,751,28,779,1501,51.9%,38.84%,1
桃園市,平鎮區,0861,556,154,710,65,775,1405,55.16%,39.57%,1
桃園市,平鎮區,0862,620,205,825,58,883,1656,53.32%,37.44%,1
桃園市,平鎮區,0863,672,181,853,38,891,1921,46.38%,34.98%,1
桃園市,平鎮區,0864,641,141,782,31,813,1717,47.35%,37.33%,1
桃園市,平鎮區,0865,503,163,666,45,711,1319,53.9%,38.13%,1
桃園市,平鎮區,0866,614,233,847,62,909,1745,52.09%,35.19%,1
桃園市,平鎮區,0867,668,194,862,78,940,1721,54.62%,38.81%,1
桃園市,平鎮區,0868,494,124,618,38,656,1206,54.39%,40.96%,1
桃園市,平鎮區,0869,585,148,733,44,777,1202,64.64%,48.67%,1
桃園市,平鎮區,0870,527,128,655,50,705,1208,58.36%,43.63%,1
桃園市,平鎮區,0871,537,160,697,49,746,1267,58.88%,42.38%,1
桃園市,平鎮區,0872,473,107,580,27,607,1094,55.48%,43.24%,1
桃園市,平鎮區,0873,580,176,756,62,818,1394,58.68%,41.61%,1
桃園市,平鎮區,0874,563,135,698,14,712,1215,58.6%,46.34%,1
桃園市,平鎮區,0875,528,6,534,47,581,1010,57.52%,52.28%,1
桃園市,平鎮區,0876,508,159,667,30,697,1261,55.27%,40.29%,1
桃園市,平鎮區,0877,581,152,733,28,761,1314,57.91%,44.22%,1
桃園市,平鎮區,0878,294,89,383,38,421,722,58.31%,40.72%,1
桃園市,平鎮區,0879,281,131,412,35,447,839,53.28%,33.49%,1
桃園市,平鎮區,0880,536,172,708,36,744,1399,53.18%,38.31%,1
桃園市,平鎮區,0881,713,217,930,57,987,1968,50.15%,36.23%,1
桃園市,平鎮區,0882,651,201,852,41,893,1672,53.41%,38.94%,1
桃園市,平鎮區,0883,494,124,618,34,652,2213,29.46%,22.32%,1
桃園市,平鎮區,0884,433,118,551,33,584,949,61.54%,45.63%,1
桃園市,平鎮區,0885,713,194,907,54,961,1621,59.28%,43.99%,1
桃園市,平鎮區,0886,629,168,797,41,838,1643,51%,38.28%,1
桃園市,平鎮區,0887,773,188,961,48,1009,1844,54.72%,41.92%,1
桃園市,平鎮區,0888,715,188,903,48,951,1752,54.28%,40.81%,1
桃園市,平鎮區,0889,547,170,717,64,781,1577,49.52%,34.69%,1
桃園市,平鎮區,0890,640,171,811,35,846,1517,55.77%,42.19%,1
桃園市,平鎮區,0891,430,145,575,32,607,1039,58.42%,41.39%,1
桃園市,平鎮區,0892,566,159,725,51,776,1318,58.88%,42.94%,1
桃園市,平鎮區,0893,656,157,813,47,860,1636,52.57%,40.1%,1
桃園市,平鎮區,0894,574,101,675,95,770,1316,58.51%,43.62%,1
桃園市,平鎮區,0895,616,168,784,29,813,1474,55.16%,41.79%,1
桃園市,平鎮區,0896,513,130,643,61,704,1480,47.57%,34.66%,1
桃園市,平鎮區,0897,555,125,680,27,707,1330,53.16%,41.73%,1
桃園市,平鎮區,0898,510,139,649,31,680,1228,55.37%,41.53%,1
桃園市,平鎮區,0899,575,177,752,47,799,1377,58.02%,41.76%,1
桃園市,平鎮區,0900,555,137,692,30,722,1198,60.27%,46.33%,1
桃園市,平鎮區,0901,537,171,708,37,745,1231,60.52%,43.62%,1
桃園市,平鎮區,0902,490,161,651,62,713,1243,57.36%,39.42%,1
桃園市,平鎮區,0903,646,146,792,47,839,1590,52.77%,40.63%,1
桃園市,平鎮區,0904,530,148,678,54,732,1366,53.59%,38.8%,1
桃園市,平鎮區,0905,545,123,668,49,717,1332,53.83%,40.92%,1
桃園市,平鎮區,0906,440,104,544,25,569,1201,47.38%,36.64%,1
桃園市,平鎮區,0907,567,163,730,46,776,1668,46.52%,33.99%,1
桃園市,平鎮區,0908,512,126,638,67,705,1351,52.18%,37.9%,1
桃園市,平鎮區,0909,512,114,626,34,660,1460,45.21%,35.07%,1
桃園市,平鎮區,0910,700,180,880,42,922,1841,50.08%,38.02%,1
桃園市,平鎮區,0911,557,104,661,21,682,1475,46.24%,37.76%,1
桃園市,平鎮區,0912,415,112,527,32,559,1011,55.29%,41.05%,1
桃園市,平鎮區,0913,364,110,474,33,507,1052,48.19%,34.6%,1
桃園市,平鎮區,0914,511,141,652,55,707,1154,61.27%,44.28%,1
桃園市,平鎮區,0915,607,155,762,35,797,1645,48.45%,36.9%,1
桃園市,平鎮區,0916,538,148,686,61,747,1539,48.54%,34.96%,1
桃園市,平鎮區,0917,536,128,664,83,747,1385,53.94%,38.7%,1
桃園市,平鎮區,0918,567,134,701,38,739,1395,52.97%,40.65%,1
桃園市,平鎮區,0919,666,144,810,40,850,1711,49.68%,38.92%,1
桃園市,平鎮區,0920,639,139,778,55,833,1631,51.07%,39.18%,1
桃園市,平鎮區,0921,483,100,583,21,604,1110,54.41%,43.51%,1
桃園市,平鎮區,0922,832,163,995,52,1047,1931,54.22%,43.09%,1
桃園市,平鎮區,0923,459,114,573,44,617,1127,54.75%,40.73%,1
桃園市,平鎮區,0924,581,117,698,71,769,1414,54.38%,41.09%,1
桃園市,平鎮區,0925,678,119,797,43,840,1609,52.21%,42.14%,1
桃園市,新屋區,1072,581,146,727,29,756,1306,57.89%,44.49%,1
桃園市,新屋區,1073,606,211,817,46,863,1556,55.46%,38.95%,1
桃園市,新屋區,1074,811,230,1041,76,1117,1849,60.41%,43.86%,1
桃園市,新屋區,1075,862,279,1141,74,1215,2096,57.97%,41.13%,1
桃園市,新屋區,1076,545,199,744,52,796,1517,52.47%,35.93%,1
桃園市,新屋區,1077,881,247,1128,72,1200,2095,57.28%,42.05%,1
桃園市,新屋區,1078,622,188,810,48,858,1856,46.23%,33.51%,1
桃園市,新屋區,1079,782,242,1024,71,1095,1986,55.14%,39.38%,1
桃園市,新屋區,1080,475,157,632,52,684,1425,48%,33.33%,1
桃園市,新屋區,1081,487,149,636,37,673,1385,48.59%,35.16%,1
桃園市,新屋區,1082,537,193,730,51,781,1271,61.45%,42.25%,1
桃園市,新屋區,1083,486,158,644,37,681,1271,53.58%,38.24%,1
桃園市,新屋區,1084,467,182,649,54,703,1234,56.97%,37.84%,1
桃園市,新屋區,1085,406,144,550,55,605,1085,55.76%,37.42%,1
桃園市,新屋區,1086,812,224,1036,42,1078,1992,54.12%,40.76%,1
桃園市,新屋區,1087,836,276,1112,80,1192,2032,58.66%,41.14%,1
桃園市,新屋區,1088,482,153,635,70,705,1291,54.61%,37.34%,1
桃園市,新屋區,1089,487,153,640,43,683,1401,48.75%,34.76%,1
桃園市,新屋區,1090,446,148,594,53,647,1106,58.5%,40.33%,1
桃園市,新屋區,1091,323,114,437,18,455,908,50.11%,35.57%,1
桃園市,新屋區,1092,267,102,369,39,408,663,61.54%,40.27%,1
桃園市,新屋區,1093,393,130,523,54,577,1088,53.03%,36.12%,1
桃園市,新屋區,1094,460,155,615,54,669,1050,63.71%,43.81%,1
桃園市,新屋區,1095,373,102,475,30,505,896,56.36%,41.63%,1
桃園市,新屋區,1096,578,150,728,90,818,1369,59.75%,42.22%,1
桃園市,新屋區,1097,311,134,445,38,483,995,48.54%,31.26%,1
桃園市,新屋區,1098,292,85,377,25,402,741,54.25%,39.41%,1
桃園市,新屋區,1099,368,149,517,65,582,943,61.72%,39.02%,1
桃園市,新屋區,1100,584,195,779,99,878,1714,51.23%,34.07%,1
桃園市,新屋區,1101,535,147,682,19,701,1340,52.31%,39.93%,1
桃園市,觀音區,1102,452,129,581,38,619,1371,45.15%,32.97%,1
桃園市,觀音區,1103,406,117,523,33,556,1362,40.82%,29.81%,1
桃園市,觀音區,1104,334,128,462,74,536,997,53.76%,33.5%,1
桃園市,觀音區,1105,484,121,605,34,639,1407,45.42%,34.4%,1
桃園市,觀音區,1106,637,194,831,38,869,1692,51.36%,37.65%,1
桃園市,觀音區,1107,484,133,617,25,642,1279,50.2%,37.84%,1
桃園市,觀音區,1108,303,86,389,19,408,791,51.58%,38.31%,1
桃園市,觀音區,1109,352,110,462,41,503,892,56.39%,39.46%,1
桃園市,觀音區,1110,398,109,507,25,532,886,60.05%,44.92%,1
桃園市,觀音區,1111,273,82,355,40,395,712,55.48%,38.34%,1
桃園市,觀音區,1112,507,196,703,110,813,1609,50.53%,31.51%,1
桃園市,觀音區,1113,489,159,648,57,705,1274,55.34%,38.38%,1
桃園市,觀音區,1114,431,121,552,25,577,1351,42.71%,31.9%,1
桃園市,觀音區,1115,522,151,673,55,728,1262,57.69%,41.36%,1
桃園市,觀音區,1116,474,160,634,76,710,1242,57.17%,38.16%,1
桃園市,觀音區,1117,525,170,695,71,766,1461,52.43%,35.93%,1
桃園市,觀音區,1118,583,179,762,54,816,1613,50.59%,36.14%,1
桃園市,觀音區,1119,550,185,735,59,794,1479,53.68%,37.19%,1
桃園市,觀音區,1120,494,189,683,55,738,1552,47.55%,31.83%,1
桃園市,觀音區,1121,494,221,715,34,749,1517,49.37%,32.56%,1
桃園市,觀音區,1122,561,204,765,71,836,1691,49.44%,33.18%,1
桃園市,觀音區,1123,471,137,608,23,631,1157,54.54%,40.71%,1
桃園市,觀音區,1124,516,169,685,55,740,1455,50.86%,35.46%,1
桃園市,觀音區,1125,460,113,573,36,609,1150,52.96%,40%,1
桃園市,觀音區,1126,444,143,587,39,626,1112,56.29%,39.93%,1
桃園市,觀音區,1127,560,25,585,21,606,1251,48.44%,44.76%,1
桃園市,觀音區,1128,541,145,686,97,783,1446,54.15%,37.41%,1
桃園市,觀音區,1129,502,187,689,96,785,1493,52.58%,33.62%,1
桃園市,觀音區,1130,487,151,638,64,702,1339,52.43%,36.37%,1
桃園市,觀音區,1131,481,139,620,35,655,1137,57.61%,42.3%,1
桃園市,觀音區,1132,372,104,476,48,524,1043,50.24%,35.67%,1
桃園市,觀音區,1133,312,105,417,42,459,993,46.22%,31.42%,1
桃園市,觀音區,1134,311,142,453,28,481,975,49.33%,31.9%,1
桃園市,觀音區,1135,624,195,819,43,862,2029,42.48%,30.75%,1
桃園市,觀音區,1136,678,221,899,41,940,1765,53.26%,38.41%,1
桃園市,觀音區,1137,668,197,865,51,916,1809,50.64%,36.93%,1
桃園市,觀音區,1138,650,203,853,42,895,1869,47.89%,34.78%,1
桃園市,觀音區,1139,595,153,748,61,809,1870,43.26%,31.82%,1
桃園市,觀音區,1140,480,159,639,46,685,1932,35.46%,24.84%,1
桃園市,觀音區,1141,261,87,348,14,362,899,40.27%,29.03%,1
桃園市,觀音區,1142,311,79,390,19,409,985,41.52%,31.57%,1
桃園市,復興區,0581,752,233,985,106,1091,1991,54.8%,37.77%,1
桃園市,復興區,0582,553,146,699,84,783,1392,56.25%,39.73%,1
桃園市,復興區,0583,221,56,277,16,293,564,51.95%,39.18%,1
桃園市,復興區,0584,255,63,318,23,341,716,47.63%,35.61%,1
桃園市,復興區,0585,445,119,564,62,626,1016,61.61%,43.8%,1
桃園市,復興區,0586,191,55,246,17,263,669,39.31%,28.55%,1
桃園市,復興區,0587,264,63,327,25,352,760,46.32%,34.74%,1
桃園市,復興區,0588,269,70,339,18,357,751,47.54%,35.82%,1
桃園市,復興區,0589,179,43,222,10,232,683,33.97%,26.21%,1
桃園市,復興區,0590,431,120,551,41,592,1224,48.37%,35.21%,1
臺中市,中區,1070,669,250,919,93,1012,1652,61.26%,40.5%,1
臺中市,中區,1071,569,227,796,56,852,1531,55.65%,37.17%,1
臺中市,中區,1072,537,201,738,54,792,1431,55.35%,37.53%,1
臺中市,中區,1073,429,126,555,59,614,1060,57.92%,40.47%,1
臺中市,中區,1074,389,101,490,55,545,982,55.5%,39.61%,1
臺中市,中區,1075,455,166,621,65,686,1191,57.6%,38.2%,1
臺中市,中區,1076,336,121,457,38,495,855,57.89%,39.3%,1
臺中市,中區,1077,380,105,485,47,532,1135,46.87%,33.48%,1
臺中市,中區,1078,304,73,377,23,400,705,56.74%,43.12%,1
臺中市,中區,1079,429,139,568,35,603,1009,59.76%,42.52%,1
臺中市,中區,1080,465,164,629,89,718,1304,55.06%,35.66%,1
臺中市,中區,1081,742,96,838,42,880,1841,47.8%,40.3%,1
臺中市,東區,1148,291,108,399,31,430,1138,37.79%,25.57%,1
臺中市,東區,1149,412,117,529,29,558,984,56.71%,41.87%,1
臺中市,東區,1150,362,115,477,43,520,877,59.29%,41.28%,1
臺中市,東區,1151,464,165,629,55,684,1070,63.93%,43.36%,1
臺中市,東區,1152,443,170,613,66,679,1106,61.39%,40.05%,1
臺中市,東區,1153,390,116,506,71,577,953,60.55%,40.92%,1
臺中市,東區,1154,507,155,662,29,691,1195,57.82%,42.43%,1
臺中市,東區,1155,515,145,660,44,704,1251,56.27%,41.17%,1
臺中市,東區,1156,414,193,607,59,666,1190,55.97%,34.79%,1
臺中市,東區,1157,577,160,737,49,786,1394,56.38%,41.39%,1
臺中市,東區,1158,582,231,813,61,874,1443,60.57%,40.33%,1
臺中市,東區,1159,290,111,401,35,436,762,57.22%,38.06%,1
臺中市,東區,1160,504,168,672,51,723,1140,63.42%,44.21%,1
臺中市,東區,1161,475,194,669,77,746,1211,61.6%,39.22%,1
臺中市,東區,1162,364,88,452,28,480,755,63.58%,48.21%,1
臺中市,東區,1163,570,189,759,79,838,1491,56.2%,38.23%,1
臺中市,東區,1164,365,132,497,33,530,1000,53%,36.5%,1
臺中市,東區,1165,438,174,612,64,676,1114,60.68%,39.32%,1
臺中市,東區,1166,437,135,572,48,620,1101,56.31%,39.69%,1
臺中市,東區,1167,486,185,671,82,753,1169,64.41%,41.57%,1
臺中市,東區,1168,542,178,720,82,802,1283,62.51%,42.24%,1
臺中市,東區,1169,517,173,690,45,735,1168,62.93%,44.26%,1
臺中市,東區,1170,524,184,708,40,748,1386,53.97%,37.81%,1
臺中市,東區,1171,643,210,853,64,917,1557,58.9%,41.3%,1
臺中市,東區,1172,534,204,738,77,815,1380,59.06%,38.7%,1
臺中市,東區,1173,658,241,899,65,964,1674,57.59%,39.31%,1
臺中市,東區,1174,716,226,942,53,995,1604,62.03%,44.64%,1
臺中市,東區,1175,792,238,1030,60,1090,1815,60.06%,43.64%,1
臺中市,東區,1176,670,202,872,65,937,1700,55.12%,39.41%,1
臺中市,東區,1177,652,202,854,53,907,1592,56.97%,40.95%,1
臺中市,東區,1178,708,200,908,10,918,1850,49.62%,38.27%,1
臺中市,東區,1179,580,130,710,40,750,1252,59.9%,46.33%,1
臺中市,東區,1180,557,184,741,48,789,1250,63.12%,44.56%,1
臺中市,東區,1181,551,153,704,55,759,1241,61.16%,44.4%,1
臺中市,東區,1182,494,158,652,55,707,1318,53.64%,37.48%,1
臺中市,東區,1183,516,152,668,65,733,1288,56.91%,40.06%,1
臺中市,東區,1184,635,169,804,88,892,1442,61.86%,44.04%,1
臺中市,東區,1185,508,143,651,63,714,1202,59.4%,42.26%,1
臺中市,東區,1186,669,128,797,60,857,1452,59.02%,46.07%,1
臺中市,東區,1187,608,176,784,44,828,1480,55.95%,41.08%,1
臺中市,東區,1188,800,132,932,51,983,1736,56.62%,46.08%,1
臺中市,東區,1189,331,112,443,52,495,867,57.09%,38.18%,1
臺中市,東區,1190,674,142,816,65,881,1693,52.04%,39.81%,1
臺中市,東區,1191,669,188,857,78,935,1538,60.79%,43.5%,1
臺中市,東區,1192,624,266,890,110,1000,1593,62.77%,39.17%,1
臺中市,東區,1193,604,170,774,36,810,1481,54.69%,40.78%,1
臺中市,東區,1194,634,171,805,50,855,1414,60.47%,44.84%,1
臺中市,東區,1195,497,166,663,44,707,1297,54.51%,38.32%,1
臺中市,東區,1196,545,207,752,80,832,1394,59.68%,39.1%,1
臺中市,南區,1197,386,142,528,44,572,937,61.05%,41.2%,1
臺中市,南區,1198,449,151,600,56,656,1001,65.53%,44.86%,1
臺中市,南區,1199,570,186,756,66,822,1249,65.81%,45.64%,1
臺中市,南區,1200,562,201,763,55,818,1202,68.05%,46.76%,1
臺中市,南區,1201,467,162,629,85,714,1130,63.19%,41.33%,1
臺中市,南區,1202,538,172,710,73,783,1239,63.2%,43.42%,1
臺中市,南區,1203,491,167,658,69,727,1238,58.72%,39.66%,1
臺中市,南區,1204,516,204,720,67,787,1272,61.87%,40.57%,1
臺中市,南區,1205,519,185,704,61,765,1273,60.09%,40.77%,1
臺中市,南區,1206,521,202,723,82,805,1317,61.12%,39.56%,1
臺中市,南區,1207,575,166,741,47,788,1160,67.93%,49.57%,1
臺中市,南區,1208,539,177,716,70,786,1205,65.23%,44.73%,1
臺中市,南區,1209,475,159,634,50,684,1111,61.57%,42.75%,1
臺中市,南區,1210,659,199,858,65,923,1407,65.6%,46.84%,1
臺中市,南區,1211,617,181,798,55,853,1419,60.11%,43.48%,1
臺中市,南區,1212,503,162,665,71,736,1157,63.61%,43.47%,1
臺中市,南區,1213,576,177,753,45,798,1415,56.4%,40.71%,1
臺中市,南區,1214,578,192,770,77,847,1289,65.71%,44.84%,1
臺中市,南區,1215,612,191,803,67,870,1454,59.83%,42.09%,1
臺中市,南區,1216,641,152,793,69,862,1491,57.81%,42.99%,1
臺中市,南區,1217,627,160,787,38,825,1394,59.18%,44.98%,1
臺中市,南區,1218,603,200,803,51,854,1430,59.72%,42.17%,1
臺中市,南區,1219,564,180,744,93,837,1342,62.37%,42.03%,1
臺中市,南區,1220,587,192,779,103,882,1304,67.64%,45.02%,1
臺中市,南區,1221,548,152,700,45,745,1190,62.61%,46.05%,1
臺中市,南區,1222,568,114,682,71,753,1273,59.15%,44.62%,1
臺中市,南區,1223,650,177,827,77,904,1387,65.18%,46.86%,1
臺中市,南區,1224,562,193,755,59,814,1356,60.03%,41.45%,1
臺中市,南區,1225,579,167,746,69,815,1304,62.5%,44.4%,1
臺中市,南區,1226,579,178,757,29,786,1256,62.58%,46.1%,1
臺中市,南區,1227,629,201,830,38,868,1364,63.64%,46.11%,1
臺中市,南區,1228,558,206,764,82,846,1361,62.16%,41%,1
臺中市,南區,1229,652,178,830,39,869,1407,61.76%,46.34%,1
臺中市,南區,1230,549,187,736,63,799,1308,61.09%,41.97%,1
臺中市,南區,1231,545,142,687,47,734,1250,58.72%,43.6%,1
臺中市,南區,1232,518,175,693,47,740,1284,57.63%,40.34%,1
臺中市,南區,1233,509,171,680,74,754,1175,64.17%,43.32%,1
臺中市,南區,1234,523,194,717,52,769,1158,66.41%,45.16%,1
臺中市,南區,1235,502,162,664,53,717,1168,61.39%,42.98%,1
臺中市,南區,1236,767,210,977,58,1035,1626,63.65%,47.17%,1
臺中市,南區,1237,619,212,831,46,877,2115,41.47%,29.27%,1
臺中市,南區,1238,769,177,946,53,999,1805,55.35%,42.6%,1
臺中市,南區,1239,709,183,892,53,945,1695,55.75%,41.83%,1
臺中市,南區,1240,765,219,984,58,1042,1643,63.42%,46.56%,1
臺中市,南區,1241,622,212,834,47,881,1423,61.91%,43.71%,1
臺中市,南區,1242,681,188,869,44,913,1542,59.21%,44.16%,1
臺中市,南區,1243,800,78,878,39,917,1533,59.82%,52.19%,1
臺中市,南區,1244,708,203,911,78,989,1531,64.6%,46.24%,1
臺中市,南區,1245,536,171,707,37,744,1392,53.45%,38.51%,1
臺中市,南區,1246,671,182,853,50,903,1592,56.72%,42.15%,1
臺中市,南區,1247,647,190,837,56,893,1431,62.4%,45.21%,1
臺中市,南區,1248,703,216,919,59,978,1799,54.36%,39.08%,1
臺中市,南區,1249,821,202,1023,62,1085,1708,63.52%,48.07%,1
臺中市,南區,1250,708,207,915,65,980,1700,57.65%,41.65%,1
臺中市,南區,1251,822,201,1023,52,1075,1751,61.39%,46.94%,1
臺中市,南區,1252,927,255,1182,69,1251,2109,59.32%,43.95%,1
臺中市,南區,1253,715,224,939,63,1002,1697,59.05%,42.13%,1
臺中市,南區,1254,635,172,807,57,864,1456,59.34%,43.61%,1
臺中市,南區,1255,831,257,1088,58,1146,1726,66.4%,48.15%,1
臺中市,南區,1256,779,219,998,84,1082,1723,62.8%,45.21%,1
臺中市,南區,1257,702,203,905,66,971,1569,61.89%,44.74%,1
臺中市,南區,1258,576,165,741,46,787,1274,61.77%,45.21%,1
臺中市,南區,1259,675,196,871,48,919,1390,66.12%,48.56%,1
臺中市,南區,1260,560,214,774,45,819,1295,63.24%,43.24%,1
臺中市,南區,1261,582,155,737,68,805,1312,61.36%,44.36%,1
臺中市,南區,1262,692,164,856,45,901,1417,63.59%,48.84%,1
臺中市,南區,1263,646,161,807,46,853,1230,69.35%,52.52%,1
臺中市,南區,1264,557,166,723,58,781,1308,59.71%,42.58%,1
臺中市,南區,1265,595,199,794,81,875,1467,59.65%,40.56%,1
臺中市,南區,1266,638,147,785,72,857,1399,61.26%,45.6%,1
臺中市,南區,1267,503,161,664,68,732,1207,60.65%,41.67%,1
臺中市,南區,1268,571,150,721,52,773,1317,58.69%,43.36%,1
臺中市,南區,1269,652,216,868,47,915,1563,58.54%,41.71%,1
臺中市,南區,1270,600,140,740,32,772,1221,63.23%,49.14%,1
臺中市,西區,1082,387,83,470,41,511,1400,36.5%,27.64%,1
臺中市,西區,1083,393,132,525,19,544,861,63.18%,45.64%,1
臺中市,西區,1084,623,173,796,43,839,1416,59.25%,44%,1
臺中市,西區,1085,432,159,591,46,637,1020,62.45%,42.35%,1
臺中市,西區,1086,368,115,483,30,513,778,65.94%,47.3%,1
臺中市,西區,1087,596,163,759,41,800,1465,54.61%,40.68%,1
臺中市,西區,1088,427,135,562,25,587,1017,57.72%,41.99%,1
臺中市,西區,1089,388,113,501,37,538,868,61.98%,44.7%,1
臺中市,西區,1090,567,87,654,50,704,1251,56.27%,45.32%,1
臺中市,西區,1091,468,163,631,53,684,1044,65.52%,44.83%,1
臺中市,西區,1092,611,197,808,40,848,1487,57.03%,41.09%,1
臺中市,西區,1093,635,200,835,71,906,1573,57.6%,40.37%,1
臺中市,西區,1094,748,227,975,77,1052,1731,60.77%,43.21%,1
臺中市,西區,1095,512,174,686,35,721,1209,59.64%,42.35%,1
臺中市,西區,1096,655,183,838,50,888,1564,56.78%,41.88%,1
臺中市,西區,1097,530,153,683,45,728,1175,61.96%,45.11%,1
臺中市,西區,1098,604,201,805,33,838,1505,55.68%,40.13%,1
臺中市,西區,1099,604,195,799,49,848,1418,59.8%,42.6%,1
臺中市,西區,1100,507,148,655,17,672,1497,44.89%,33.87%,1
臺中市,西區,1101,485,216,701,55,756,1260,60%,38.49%,1
臺中市,西區,1102,589,192,781,67,848,1399,60.61%,42.1%,1
臺中市,西區,1103,593,182,775,52,827,1447,57.15%,40.98%,1
臺中市,西區,1104,700,215,915,67,982,1683,58.35%,41.59%,1
臺中市,西區,1105,697,193,890,63,953,1585,60.13%,43.97%,1
臺中市,西區,1106,695,188,883,48,931,1557,59.79%,44.64%,1
臺中市,西區,1107,663,172,835,69,904,1663,54.36%,39.87%,1
臺中市,西區,1108,776,277,1053,67,1120,1921,58.3%,40.4%,1
臺中市,西區,1109,712,247,959,57,1016,1952,52.05%,36.48%,1
臺中市,西區,1110,663,228,891,54,945,1708,55.33%,38.82%,1
臺中市,西區,1111,532,150,682,32,714,1131,63.13%,47.04%,1
臺中市,西區,1112,787,193,980,65,1045,1916,54.54%,41.08%,1
臺中市,西區,1113,561,183,744,28,772,1275,60.55%,44%,1
臺中市,西區,1114,704,182,886,76,962,1822,52.8%,38.64%,1
臺中市,西區,1115,585,178,763,45,808,1374,58.81%,42.58%,1
臺中市,西區,1116,439,140,579,76,655,1129,58.02%,38.88%,1
臺中市,西區,1117,432,190,622,42,664,1201,55.29%,35.97%,1
臺中市,西區,1118,653,198,851,72,923,1639,56.31%,39.84%,1
臺中市,西區,1119,749,257,1006,83,1089,1863,58.45%,40.2%,1
臺中市,西區,1120,601,157,758,62,820,1287,63.71%,46.7%,1
臺中市,西區,1121,651,210,861,53,914,1504,60.77%,43.28%,1
臺中市,西區,1122,522,181,703,58,761,1308,58.18%,39.91%,1
臺中市,西區,1123,602,171,773,68,841,1433,58.69%,42.01%,1
臺中市,西區,1124,585,193,778,37,815,1450,56.21%,40.34%,1
臺中市,西區,1125,685,193,878,50,928,1465,63.34%,46.76%,1
臺中市,西區,1126,669,256,925,74,999,1818,54.95%,36.8%,1
臺中市,西區,1127,694,280,974,63,1037,1782,58.19%,38.95%,1
臺中市,西區,1128,578,221,799,55,854,1428,59.8%,40.48%,1
臺中市,西區,1129,514,158,672,52,724,1366,53%,37.63%,1
臺中市,西區,1130,611,180,791,58,849,1498,56.68%,40.79%,1
臺中市,西區,1131,593,160,753,56,809,1350,59.93%,43.93%,1
臺中市,西區,1132,600,170,770,35,805,1339,60.12%,44.81%,1
臺中市,西區,1133,716,197,913,50,963,1613,59.7%,44.39%,1
臺中市,西區,1134,605,180,785,62,847,1454,58.25%,41.61%,1
臺中市,西區,1135,660,240,900,53,953,1597,59.67%,41.33%,1
臺中市,西區,1136,667,174,841,52,893,1411,63.29%,47.27%,1
臺中市,西區,1137,623,190,813,73,886,1493,59.34%,41.73%,1
臺中市,西區,1138,716,202,918,59,977,1600,61.06%,44.75%,1
臺中市,西區,1139,682,220,902,64,966,1710,56.49%,39.88%,1
臺中市,西區,1140,491,145,636,41,677,1139,59.44%,43.11%,1
臺中市,西區,1141,482,136,618,56,674,1105,61%,43.62%,1
臺中市,西區,1142,616,192,808,57,865,1498,57.74%,41.12%,1
臺中市,西區,1143,678,226,904,40,944,1921,49.14%,35.29%,1
臺中市,西區,1144,523,186,709,68,777,1340,57.99%,39.03%,1
臺中市,西區,1145,669,222,891,43,934,1536,60.81%,43.55%,1
臺中市,西區,1146,519,198,717,81,798,1361,58.63%,38.13%,1
臺中市,西區,1147,677,171,848,41,889,1430,62.17%,47.34%,1
臺中市,北區,0983,537,176,713,43,756,1437,52.61%,37.37%,1
臺中市,北區,0984,507,317,824,85,909,1708,53.22%,29.68%,1
臺中市,北區,0985,399,103,502,39,541,1051,51.47%,37.96%,1
臺中市,北區,0986,407,132,539,35,574,996,57.63%,40.86%,1
臺中市,北區,0987,707,127,834,30,864,1504,57.45%,47.01%,1
臺中市,北區,0988,405,143,548,59,607,975,62.26%,41.54%,1
臺中市,北區,0989,381,100,481,41,522,886,58.92%,43%,1
臺中市,北區,0990,381,138,519,50,569,1276,44.59%,29.86%,1
臺中市,北區,0991,339,105,444,39,483,938,51.49%,36.14%,1
臺中市,北區,0992,520,163,683,87,770,1404,54.84%,37.04%,1
臺中市,北區,0993,409,125,534,20,554,996,55.62%,41.06%,1
臺中市,北區,0994,318,121,439,54,493,869,56.73%,36.59%,1
臺中市,北區,0995,330,81,411,20,431,704,61.22%,46.88%,1
臺中市,北區,0996,380,106,486,35,521,979,53.22%,38.82%,1
臺中市,北區,0997,319,65,384,19,403,773,52.13%,41.27%,1
臺中市,北區,0998,336,79,415,37,452,759,59.55%,44.27%,1
臺中市,北區,0999,700,113,813,50,863,1438,60.01%,48.68%,1
臺中市,北區,1000,505,95,600,21,621,1212,51.24%,41.67%,1
臺中市,北區,1001,707,226,933,40,973,1731,56.21%,40.84%,1
臺中市,北區,1002,655,189,844,40,884,1445,61.18%,45.33%,1
臺中市,北區,1003,743,223,966,56,1022,1855,55.09%,40.05%,1
臺中市,北區,1004,653,149,802,69,871,1728,50.41%,37.79%,1
臺中市,北區,1005,721,188,909,62,971,1878,51.7%,38.39%,1
臺中市,北區,1006,653,194,847,84,931,1793,51.92%,36.42%,1
臺中市,北區,1007,650,167,817,82,899,1555,57.81%,41.8%,1
臺中市,北區,1008,648,164,812,44,856,1761,48.61%,36.8%,1
臺中市,北區,1009,665,154,819,41,860,1579,54.46%,42.12%,1
臺中市,北區,1010,849,221,1070,96,1166,2192,53.19%,38.73%,1
臺中市,北區,1011,684,187,871,58,929,1560,59.55%,43.85%,1
臺中市,北區,1012,623,166,789,62,851,1476,57.66%,42.21%,1
臺中市,北區,1013,470,120,590,28,618,1006,61.43%,46.72%,1
臺中市,北區,1014,590,170,760,50,810,1403,57.73%,42.05%,1
臺中市,北區,1015,585,158,743,32,775,1446,53.6%,40.46%,1
臺中市,北區,1016,582,178,760,57,817,1460,55.96%,39.86%,1
臺中市,北區,1017,526,138,664,25,689,1233,55.88%,42.66%,1
臺中市,北區,1018,487,144,631,37,668,1027,65.04%,47.42%,1
臺中市,北區,1019,511,159,670,21,691,1207,57.25%,42.34%,1
臺中市,北區,1020,514,150,664,47,711,1167,60.93%,44.04%,1
臺中市,北區,1021,465,147,612,29,641,1150,55.74%,40.43%,1
臺中市,北區,1022,419,158,577,49,626,1061,59%,39.49%,1
臺中市,北區,1023,416,127,543,46,589,1005,58.61%,41.39%,1
臺中市,北區,1024,515,153,668,28,696,1250,55.68%,41.2%,1
臺中市,北區,1025,614,167,781,73,854,1448,58.98%,42.4%,1
臺中市,北區,1026,605,159,764,64,828,1379,60.04%,43.87%,1
臺中市,北區,1027,687,202,889,68,957,1652,57.93%,41.59%,1
臺中市,北區,1028,746,223,969,45,1014,1867,54.31%,39.96%,1
臺中市,北區,1029,407,109,516,27,543,2078,26.13%,19.59%,1
臺中市,北區,1030,695,190,885,58,943,1562,60.37%,44.49%,1
臺中市,北區,1031,613,154,767,37,804,1430,56.22%,42.87%,1
臺中市,北區,1032,830,270,1100,54,1154,2018,57.19%,41.13%,1
臺中市,北區,1033,645,165,810,43,853,1710,49.88%,37.72%,1
臺中市,北區,1034,596,155,751,38,789,1432,55.1%,41.62%,1
臺中市,北區,1035,507,147,654,37,691,1157,59.72%,43.82%,1
臺中市,北區,1036,518,130,648,35,683,1188,57.49%,43.6%,1
臺中市,北區,1037,595,157,752,52,804,1419,56.66%,41.93%,1
臺中市,北區,1038,673,175,848,23,871,1653,52.69%,40.71%,1
臺中市,北區,1039,518,161,679,53,732,1233,59.37%,42.01%,1
臺中市,北區,1040,514,163,677,34,711,1243,57.2%,41.35%,1
臺中市,北區,1041,499,108,607,25,632,1219,51.85%,40.94%,1
臺中市,北區,1042,504,184,688,65,753,1272,59.2%,39.62%,1
臺中市,北區,1043,553,162,715,27,742,1285,57.74%,43.04%,1
臺中市,北區,1044,746,239,985,43,1028,1780,57.75%,41.91%,1
臺中市,北區,1045,559,152,711,31,742,1461,50.79%,38.26%,1
臺中市,北區,1046,568,170,738,41,779,1310,59.47%,43.36%,1
臺中市,北區,1047,666,182,848,41,889,1669,53.27%,39.9%,1
臺中市,北區,1048,860,206,1066,52,1118,1932,57.87%,44.51%,1
臺中市,北區,1049,679,206,885,41,926,1682,55.05%,40.37%,1
臺中市,北區,1050,713,239,952,36,988,1891,52.25%,37.7%,1
臺中市,北區,1051,740,236,976,84,1060,1882,56.32%,39.32%,1
臺中市,北區,1052,485,135,620,31,651,1159,56.17%,41.85%,1
臺中市,北區,1053,639,175,814,49,863,1553,55.57%,41.15%,1
臺中市,北區,1054,617,199,816,63,879,1607,54.7%,38.39%,1
臺中市,北區,1055,687,232,919,68,987,1773,55.67%,38.75%,1
臺中市,北區,1056,594,213,807,73,880,1524,57.74%,38.98%,1
臺中市,北區,1057,708,227,935,68,1003,1613,62.18%,43.89%,1
臺中市,北區,1058,831,210,1041,54,1095,1877,58.34%,44.27%,1
臺中市,北區,1059,716,239,955,64,1019,1792,56.86%,39.96%,1
臺中市,北區,1060,592,173,765,58,823,1392,59.12%,42.53%,1
臺中市,北區,1061,517,162,679,43,722,1297,55.67%,39.86%,1
臺中市,北區,1062,657,228,885,49,934,1556,60.03%,42.22%,1
臺中市,北區,1063,587,200,787,39,826,1497,55.18%,39.21%,1
臺中市,北區,1064,635,74,709,48,757,1550,48.84%,40.97%,1
臺中市,北區,1065,672,175,847,42,889,1434,61.99%,46.86%,1
臺中市,北區,1066,752,208,960,68,1028,1793,57.33%,41.94%,1
臺中市,北區,1067,775,222,997,47,1044,1866,55.95%,41.53%,1
臺中市,北區,1068,547,175,722,76,798,1346,59.29%,40.64%,1
臺中市,北區,1069,526,142,668,65,733,1267,57.85%,41.52%,1
臺中市,西屯區,0625,725,224,949,68,1017,1638,62.09%,44.26%,1
臺中市,西屯區,0626,512,170,682,48,730,1335,54.68%,38.35%,1
臺中市,西屯區,0627,787,202,989,50,1039,1776,58.5%,44.31%,1
臺中市,西屯區,0628,568,166,734,35,769,1351,56.92%,42.04%,1
臺中市,西屯區,0629,572,183,755,59,814,1338,60.84%,42.75%,1
臺中市,西屯區,0630,687,190,877,45,922,1582,58.28%,43.43%,1
臺中市,西屯區,0631,686,168,854,41,895,1710,52.34%,40.12%,1
臺中市,西屯區,0632,590,193,783,63,846,1595,53.04%,36.99%,1
臺中市,西屯區,0633,727,151,878,61,939,1585,59.24%,45.87%,1
臺中市,西屯區,0634,657,241,898,68,966,1749,55.23%,37.56%,1
臺中市,西屯區,0635,821,200,1021,63,1084,1877,57.75%,43.74%,1
臺中市,西屯區,0636,661,220,881,44,925,1697,54.51%,38.95%,1
臺中市,西屯區,0637,659,192,851,52,903,1480,61.01%,44.53%,1
臺中市,西屯區,0638,685,224,909,60,969,1483,65.34%,46.19%,1
臺中市,西屯區,0639,638,202,840,54,894,2484,35.99%,25.68%,1
臺中市,西屯區,0640,357,117,474,47,521,781,66.71%,45.71%,1
臺中市,西屯區,0641,645,180,825,66,891,1477,60.32%,43.67%,1
臺中市,西屯區,0642,759,199,958,37,995,1784,55.77%,42.54%,1
臺中市,西屯區,0643,768,172,940,29,969,1686,57.47%,45.55%,1
臺中市,西屯區,0644,720,202,922,44,966,1692,57.09%,42.55%,1
臺中市,西屯區,0645,723,138,861,32,893,1659,53.83%,43.58%,1
臺中市,西屯區,0646,721,175,896,78,974,1648,59.1%,43.75%,1
臺中市,西屯區,0647,695,204,899,40,939,1536,61.13%,45.25%,1
臺中市,西屯區,0648,727,211,938,61,999,1666,59.96%,43.64%,1
臺中市,西屯區,0649,631,160,791,56,847,1428,59.31%,44.19%,1
臺中市,西屯區,0650,749,183,932,59,991,1810,54.75%,41.38%,1
臺中市,西屯區,0651,683,175,858,35,893,1574,56.73%,43.39%,1
臺中市,西屯區,0652,713,186,899,30,929,1650,56.3%,43.21%,1
臺中市,西屯區,0653,681,213,894,78,972,1681,57.82%,40.51%,1
臺中市,西屯區,0654,656,204,860,65,925,1656,55.86%,39.61%,1
臺中市,西屯區,0655,565,123,688,72,760,1243,61.14%,45.45%,1
臺中市,西屯區,0656,669,192,861,71,932,1471,63.36%,45.48%,1
臺中市,西屯區,0657,695,157,852,41,893,1431,62.4%,48.57%,1
臺中市,西屯區,0658,719,208,927,50,977,1714,57%,41.95%,1
臺中市,西屯區,0659,629,158,787,56,843,1424,59.2%,44.17%,1
臺中市,西屯區,0660,513,139,652,45,697,1176,59.27%,43.62%,1
臺中市,西屯區,0661,640,175,815,67,882,1456,60.58%,43.96%,1
臺中市,西屯區,0662,699,157,856,51,907,1451,62.51%,48.17%,1
臺中市,西屯區,0663,537,115,652,40,692,1063,65.1%,50.52%,1
臺中市,西屯區,0664,595,172,767,57,824,1357,60.72%,43.85%,1
臺中市,西屯區,0665,679,106,785,54,839,1355,61.92%,50.11%,1
臺中市,西屯區,0666,708,120,828,27,855,1384,61.78%,51.16%,1
臺中市,西屯區,0667,706,196,902,62,964,1613,59.76%,43.77%,1
臺中市,西屯區,0668,637,200,837,65,902,1562,57.75%,40.78%,1
臺中市,西屯區,0669,543,177,720,71,791,1219,64.89%,44.54%,1
臺中市,西屯區,0670,494,178,672,44,716,1235,57.98%,40%,1
臺中市,西屯區,0671,468,158,626,53,679,1131,60.04%,41.38%,1
臺中市,西屯區,0672,683,186,869,56,925,1494,61.91%,45.72%,1
臺中市,西屯區,0673,579,162,741,20,761,1325,57.43%,43.7%,1
臺中市,西屯區,0674,596,197,793,37,830,1386,59.88%,43%,1
臺中市,西屯區,0675,766,230,996,75,1071,1816,58.98%,42.18%,1
臺中市,西屯區,0676,699,181,880,49,929,1734,53.58%,40.31%,1
臺中市,西屯區,0677,782,216,998,71,1069,1777,60.16%,44.01%,1
臺中市,西屯區,0678,724,188,912,75,987,1818,54.29%,39.82%,1
臺中市,西屯區,0679,691,194,885,80,965,1699,56.8%,40.67%,1
臺中市,西屯區,0680,646,188,834,48,882,1715,51.43%,37.67%,1
臺中市,西屯區,0681,658,176,834,53,887,1654,53.63%,39.78%,1
臺中市,西屯區,0682,675,185,860,25,885,1636,54.1%,41.26%,1
臺中市,西屯區,0683,515,164,679,33,712,1298,54.85%,39.68%,1
臺中市,西屯區,0684,587,199,786,49,835,1391,60.03%,42.2%,1
臺中市,西屯區,0685,796,229,1025,67,1092,1853,58.93%,42.96%,1
臺中市,西屯區,0686,747,194,941,64,1005,1820,55.22%,41.04%,1
臺中市,西屯區,0687,748,234,982,59,1041,1809,57.55%,41.35%,1
臺中市,西屯區,0688,617,164,781,64,845,1352,62.5%,45.64%,1
臺中市,西屯區,0689,662,188,850,32,882,1521,57.99%,43.52%,1
臺中市,西屯區,0690,643,204,847,56,903,1486,60.77%,43.27%,1
臺中市,西屯區,0691,694,233,927,56,983,1674,58.72%,41.46%,1
臺中市,西屯區,0692,712,226,938,69,1007,1610,62.55%,44.22%,1
臺中市,西屯區,0693,745,195,940,44,984,1695,58.05%,43.95%,1
臺中市,西屯區,0694,698,187,885,59,944,1684,56.06%,41.45%,1
臺中市,西屯區,0695,511,193,704,30,734,1221,60.11%,41.85%,1
臺中市,西屯區,0696,600,198,798,62,860,1252,68.69%,47.92%,1
臺中市,西屯區,0697,565,183,748,63,811,1301,62.34%,43.43%,1
臺中市,西屯區,0698,532,87,619,41,660,1049,62.92%,50.71%,1
臺中市,西屯區,0699,547,74,621,54,675,1113,60.65%,49.15%,1
臺中市,西屯區,0700,663,140,803,56,859,1557,55.17%,42.58%,1
臺中市,西屯區,0701,645,203,848,55,903,1640,55.06%,39.33%,1
臺中市,西屯區,0702,655,199,854,81,935,1402,66.69%,46.72%,1
臺中市,西屯區,0703,669,163,832,78,910,1717,53%,38.96%,1
臺中市,西屯區,0704,687,193,880,75,955,1688,56.58%,40.7%,1
臺中市,西屯區,0705,472,154,626,95,721,1168,61.73%,40.41%,1
臺中市,西屯區,0706,697,192,889,52,941,1729,54.42%,40.31%,1
臺中市,西屯區,0707,809,197,1006,58,1064,2007,53.01%,40.31%,1
臺中市,西屯區,0708,549,147,696,99,795,1296,61.34%,42.36%,1
臺中市,西屯區,0709,400,100,500,30,530,1068,49.63%,37.45%,1
臺中市,西屯區,0710,655,151,806,103,909,1707,53.25%,38.37%,1
臺中市,西屯區,0711,729,182,911,57,968,1636,59.17%,44.56%,1
臺中市,西屯區,0712,620,73,693,48,741,1761,42.08%,35.21%,1
臺中市,西屯區,0713,558,158,716,49,765,1314,58.22%,42.47%,1
臺中市,西屯區,0714,577,168,745,42,787,1233,63.83%,46.8%,1
臺中市,西屯區,0715,625,166,791,52,843,1549,54.42%,40.35%,1
臺中市,西屯區,0716,674,163,837,35,872,1639,53.2%,41.12%,1
臺中市,西屯區,0717,599,154,753,60,813,1486,54.71%,40.31%,1
臺中市,西屯區,0718,736,213,949,31,980,1806,54.26%,40.75%,1
臺中市,西屯區,0719,604,156,760,29,789,1451,54.38%,41.63%,1
臺中市,西屯區,0720,615,120,735,35,770,1302,59.14%,47.24%,1
臺中市,西屯區,0721,599,192,791,52,843,1353,62.31%,44.27%,1
臺中市,西屯區,0722,976,251,1227,73,1300,2162,60.13%,45.14%,1
臺中市,西屯區,0723,622,188,810,58,868,1520,57.11%,40.92%,1
臺中市,西屯區,0724,825,187,1012,35,1047,1935,54.11%,42.64%,1
臺中市,西屯區,0725,760,226,986,61,1047,1847,56.69%,41.15%,1
臺中市,西屯區,0726,766,202,968,39,1007,1738,57.94%,44.07%,1
臺中市,西屯區,0727,757,199,956,49,1005,1640,61.28%,46.16%,1
臺中市,西屯區,0728,805,248,1053,43,1096,1908,57.44%,42.19%,1
臺中市,西屯區,0729,625,152,777,41,818,1402,58.35%,44.58%,1
臺中市,西屯區,0730,601,165,766,38,804,1515,53.07%,39.67%,1
臺中市,西屯區,0731,534,146,680,42,722,1541,46.85%,34.65%,1
臺中市,西屯區,0732,622,166,788,44,832,1502,55.39%,41.41%,1
臺中市,西屯區,0733,624,226,850,58,908,1526,59.5%,40.89%,1
臺中市,西屯區,0734,601,193,794,70,864,1425,60.63%,42.18%,1
臺中市,西屯區,0735,586,198,784,82,866,1334,64.92%,43.93%,1
臺中市,西屯區,0736,745,207,952,40,992,1649,60.16%,45.18%,1
臺中市,西屯區,0737,634,187,821,31,852,1566,54.41%,40.49%,1
臺中市,西屯區,0738,753,188,941,50,991,1629,60.83%,46.22%,1
臺中市,西屯區,0739,691,230,921,42,963,1628,59.15%,42.44%,1
臺中市,西屯區,0740,689,163,852,37,889,1442,61.65%,47.78%,1
臺中市,西屯區,0741,470,142,612,57,669,1206,55.47%,38.97%,1
臺中市,西屯區,0742,461,172,633,50,683,1086,62.89%,42.45%,1
臺中市,西屯區,0743,496,150,646,39,685,1088,62.96%,45.59%,1
臺中市,西屯區,0744,489,156,645,35,680,1140,59.65%,42.89%,1
臺中市,南屯區,0745,547,185,732,75,807,1321,61.09%,41.41%,1
臺中市,南屯區,0746,553,216,769,66,835,1346,62.04%,41.08%,1
臺中市,南屯區,0747,590,193,783,72,855,1428,59.87%,41.32%,1
臺中市,南屯區,0748,625,163,788,40,828,1442,57.42%,43.34%,1
臺中市,南屯區,0749,700,175,875,32,907,1408,64.42%,49.72%,1
臺中市,南屯區,0750,682,148,830,29,859,1404,61.18%,48.58%,1
臺中市,南屯區,0751,631,170,801,61,862,1354,63.66%,46.6%,1
臺中市,南屯區,0752,581,181,762,72,834,1332,62.61%,43.62%,1
臺中市,南屯區,0753,674,201,875,49,924,1463,63.16%,46.07%,1
臺中市,南屯區,0754,695,82,777,65,842,1413,59.59%,49.19%,1
臺中市,南屯區,0755,549,180,729,40,769,1218,63.14%,45.07%,1
臺中市,南屯區,0756,558,161,719,36,755,1308,57.72%,42.66%,1
臺中市,南屯區,0757,697,215,912,50,962,1527,63%,45.65%,1
臺中市,南屯區,0758,588,176,764,42,806,1294,62.29%,45.44%,1
臺中市,南屯區,0759,593,168,761,54,815,1516,53.76%,39.12%,1
臺中市,南屯區,0760,650,188,838,98,936,1529,61.22%,42.51%,1
臺中市,南屯區,0761,611,183,794,64,858,1397,61.42%,43.74%,1
臺中市,南屯區,0762,581,160,741,47,788,1406,56.05%,41.32%,1
臺中市,南屯區,0763,596,166,762,54,816,1497,54.51%,39.81%,1
臺中市,南屯區,0764,572,164,736,81,817,1424,57.37%,40.17%,1
臺中市,南屯區,0765,505,173,678,47,725,1488,48.72%,33.94%,1
臺中市,南屯區,0766,275,86,361,47,408,608,67.11%,45.23%,1
臺中市,南屯區,0767,330,127,457,71,528,813,64.94%,40.59%,1
臺中市,南屯區,0768,507,155,662,69,731,1190,61.43%,42.61%,1
臺中市,南屯區,0769,494,128,622,43,665,1174,56.64%,42.08%,1
臺中市,南屯區,0770,536,152,688,24,712,1224,58.17%,43.79%,1
臺中市,南屯區,0771,528,129,657,45,702,1466,47.89%,36.02%,1
臺中市,南屯區,0772,440,105,545,29,574,1333,43.06%,33.01%,1
臺中市,南屯區,0773,352,100,452,67,519,814,63.76%,43.24%,1
臺中市,南屯區,0774,544,178,722,62,784,1436,54.6%,37.88%,1
臺中市,南屯區,0775,649,190,839,61,900,1515,59.41%,42.84%,1
臺中市,南屯區,0776,600,143,743,52,795,1545,51.46%,38.83%,1
臺中市,南屯區,0777,603,158,761,53,814,1383,58.86%,43.6%,1
臺中市,南屯區,0778,643,166,809,38,847,1433,59.11%,44.87%,1
臺中市,南屯區,0779,436,141,577,48,625,1134,55.11%,38.45%,1
臺中市,南屯區,0780,593,122,715,47,762,1216,62.66%,48.77%,1
臺中市,南屯區,0781,495,158,653,82,735,1271,57.83%,38.95%,1
臺中市,南屯區,0782,486,141,627,38,665,1203,55.28%,40.4%,1
臺中市,南屯區,0783,543,161,704,38,742,1268,58.52%,42.82%,1
臺中市,南屯區,0784,577,192,769,62,831,1390,59.78%,41.51%,1
臺中市,南屯區,0785,587,173,760,50,810,1397,57.98%,42.02%,1
臺中市,南屯區,0786,633,214,847,79,926,1607,57.62%,39.39%,1
臺中市,南屯區,0787,702,194,896,49,945,1582,59.73%,44.37%,1
臺中市,南屯區,0788,720,191,911,55,966,1611,59.96%,44.69%,1
臺中市,南屯區,0789,588,201,789,52,841,1322,63.62%,44.48%,1
臺中市,南屯區,0790,622,177,799,54,853,1321,64.57%,47.09%,1
臺中市,南屯區,0791,612,148,760,51,811,1360,59.63%,45%,1
臺中市,南屯區,0792,630,160,790,24,814,1361,59.81%,46.29%,1
臺中市,南屯區,0793,566,184,750,36,786,1257,62.53%,45.03%,1
臺中市,南屯區,0794,606,145,751,31,782,1207,64.79%,50.21%,1
臺中市,南屯區,0795,623,159,782,32,814,1282,63.49%,48.6%,1
臺中市,南屯區,0796,611,169,780,38,818,1248,65.54%,48.96%,1
臺中市,南屯區,0797,623,182,805,47,852,1304,65.34%,47.78%,1
臺中市,南屯區,0798,552,147,699,44,743,1214,61.2%,45.47%,1
臺中市,南屯區,0799,505,140,645,56,701,1102,63.61%,45.83%,1
臺中市,南屯區,0800,816,189,1005,48,1053,1630,64.6%,50.06%,1
臺中市,南屯區,0801,641,150,791,41,832,1333,62.42%,48.09%,1
臺中市,南屯區,0802,608,163,771,43,814,1292,63%,47.06%,1
臺中市,南屯區,0803,589,156,745,43,788,1272,61.95%,46.31%,1
臺中市,南屯區,0804,627,136,763,46,809,1345,60.15%,46.62%,1
臺中市,南屯區,0805,500,142,642,46,688,981,70.13%,50.97%,1
臺中市,南屯區,0806,506,136,642,59,701,1097,63.9%,46.13%,1
臺中市,南屯區,0807,480,124,604,42,646,991,65.19%,48.44%,1
臺中市,南屯區,0808,538,142,680,30,710,1170,60.68%,45.98%,1
臺中市,南屯區,0809,552,147,699,48,747,1171,63.79%,47.14%,1
臺中市,南屯區,0810,557,179,736,74,810,1349,60.04%,41.29%,1
臺中市,南屯區,0811,644,191,835,39,874,1368,63.89%,47.08%,1
臺中市,南屯區,0812,606,162,768,48,816,1263,64.61%,47.98%,1
臺中市,南屯區,0813,699,219,918,44,962,1547,62.18%,45.18%,1
臺中市,南屯區,0814,716,211,927,63,990,1649,60.04%,43.42%,1
臺中市,南屯區,0815,660,200,860,52,912,1629,55.99%,40.52%,1
臺中市,南屯區,0816,606,195,801,59,860,1580,54.43%,38.35%,1
臺中市,南屯區,0817,709,196,905,41,946,1444,65.51%,49.1%,1
臺中市,南屯區,0818,644,146,790,27,817,1413,57.82%,45.58%,1
臺中市,南屯區,0819,613,148,761,45,806,1377,58.53%,44.52%,1
臺中市,南屯區,0820,654,225,879,54,933,1527,61.1%,42.83%,1
臺中市,南屯區,0821,606,180,786,47,833,1335,62.4%,45.39%,1
臺中市,南屯區,0822,776,215,991,46,1037,1544,67.16%,50.26%,1
臺中市,南屯區,0823,687,226,913,55,968,1482,65.32%,46.36%,1
臺中市,南屯區,0824,532,217,749,78,827,1488,55.58%,35.75%,1
臺中市,南屯區,0825,597,167,764,46,810,1538,52.67%,38.82%,1
臺中市,南屯區,0826,761,210,971,86,1057,1674,63.14%,45.46%,1
臺中市,南屯區,0827,609,197,806,58,864,1996,43.29%,30.51%,1
臺中市,南屯區,0828,683,172,855,67,922,1514,60.9%,45.11%,1
臺中市,南屯區,0829,576,142,718,65,783,1217,64.34%,47.33%,1
臺中市,南屯區,0830,569,172,741,61,802,1347,59.54%,42.24%,1
臺中市,南屯區,0831,489,137,626,46,672,1109,60.6%,44.09%,1
臺中市,南屯區,0832,675,172,847,50,897,1546,58.02%,43.66%,1
臺中市,南屯區,0833,657,194,851,54,905,1408,64.28%,46.66%,1
臺中市,南屯區,0834,424,138,562,20,582,1057,55.06%,40.11%,1
臺中市,南屯區,0835,473,158,631,62,693,1133,61.17%,41.75%,1
臺中市,南屯區,0836,565,160,725,33,758,1278,59.31%,44.21%,1
臺中市,南屯區,0837,543,157,700,54,754,1144,65.91%,47.47%,1
臺中市,南屯區,0838,495,159,654,42,696,1140,61.05%,43.42%,1
臺中市,南屯區,0839,531,164,695,44,739,1171,63.11%,45.35%,1
臺中市,南屯區,0840,600,179,779,58,837,1303,64.24%,46.05%,1
臺中市,南屯區,0841,570,154,724,53,777,1402,55.42%,40.66%,1
臺中市,南屯區,0842,676,182,858,55,913,1571,58.12%,43.03%,1
臺中市,南屯區,0843,515,166,681,51,732,1139,64.27%,45.22%,1
臺中市,南屯區,0844,562,162,724,56,780,1216,64.14%,46.22%,1
臺中市,南屯區,0845,549,139,688,50,738,1162,63.51%,47.25%,1
臺中市,北屯區,0846,830,147,977,64,1041,1670,62.34%,49.7%,1
臺中市,北屯區,0847,674,189,863,65,928,1706,54.4%,39.51%,1
臺中市,北屯區,0848,621,154,775,87,862,1507,57.2%,41.21%,1
臺中市,北屯區,0849,722,199,921,61,982,1652,59.44%,43.7%,1
臺中市,北屯區,0850,442,129,571,19,590,1107,53.3%,39.93%,1
臺中市,北屯區,0851,844,228,1072,84,1156,2151,53.74%,39.24%,1
臺中市,北屯區,0852,705,219,924,29,953,1612,59.12%,43.73%,1
臺中市,北屯區,0853,727,200,927,52,979,1743,56.17%,41.71%,1
臺中市,北屯區,0854,810,228,1038,54,1092,2099,52.02%,38.59%,1
臺中市,北屯區,0855,673,186,859,37,896,1595,56.18%,42.19%,1
臺中市,北屯區,0856,746,194,940,71,1011,1923,52.57%,38.79%,1
臺中市,北屯區,0857,658,175,833,67,900,1641,54.84%,40.1%,1
臺中市,北屯區,0858,557,138,695,35,730,1157,63.09%,48.14%,1
臺中市,北屯區,0859,503,117,620,44,664,1041,63.78%,48.32%,1
臺中市,北屯區,0860,690,103,793,52,845,1563,54.06%,44.15%,1
臺中市,北屯區,0861,602,172,774,66,840,1559,53.88%,38.61%,1
臺中市,北屯區,0862,552,118,670,25,695,1411,49.26%,39.12%,1
臺中市,北屯區,0863,782,206,988,43,1031,1761,58.55%,44.41%,1
臺中市,北屯區,0864,628,170,798,57,855,1361,62.82%,46.14%,1
臺中市,北屯區,0865,757,216,973,76,1049,1852,56.64%,40.87%,1
臺中市,北屯區,0866,831,224,1055,53,1108,1928,57.47%,43.1%,1
臺中市,北屯區,0867,725,186,911,41,952,1492,63.81%,48.59%,1
臺中市,北屯區,0868,823,210,1033,65,1098,1998,54.95%,41.19%,1
臺中市,北屯區,0869,600,180,780,45,825,1272,64.86%,47.17%,1
臺中市,北屯區,0870,575,162,737,39,776,1317,58.92%,43.66%,1
臺中市,北屯區,0871,476,164,640,100,740,1327,55.76%,35.87%,1
臺中市,北屯區,0872,491,150,641,32,673,1280,52.58%,38.36%,1
臺中市,北屯區,0873,746,165,911,64,975,1865,52.28%,40%,1
臺中市,北屯區,0874,564,159,723,64,787,1230,63.98%,45.85%,1
臺中市,北屯區,0875,524,147,671,56,727,1356,53.61%,38.64%,1
臺中市,北屯區,0876,747,180,927,61,988,1732,57.04%,43.13%,1
臺中市,北屯區,0877,717,168,885,48,933,1586,58.83%,45.21%,1
臺中市,北屯區,0878,613,158,771,46,817,1441,56.7%,42.54%,1
臺中市,北屯區,0879,802,231,1033,78,1111,2045,54.33%,39.22%,1
臺中市,北屯區,0880,612,313,925,78,1003,1914,52.4%,31.97%,1
臺中市,北屯區,0881,834,198,1032,57,1089,1918,56.78%,43.48%,1
臺中市,北屯區,0882,868,179,1047,37,1084,2079,52.14%,41.75%,1
臺中市,北屯區,0883,859,232,1091,67,1158,2040,56.76%,42.11%,1
臺中市,北屯區,0884,683,276,959,50,1009,2027,49.78%,33.7%,1
臺中市,北屯區,0885,580,153,733,56,789,1402,56.28%,41.37%,1
臺中市,北屯區,0886,801,197,998,64,1062,1826,58.16%,43.87%,1
臺中市,北屯區,0887,857,186,1043,37,1080,2162,49.95%,39.64%,1
臺中市,北屯區,0888,872,211,1083,32,1115,2332,47.81%,37.39%,1
臺中市,北屯區,0889,421,107,528,52,580,985,58.88%,42.74%,1
臺中市,北屯區,0890,707,246,953,42,995,2037,48.85%,34.71%,1
臺中市,北屯區,0891,454,134,588,46,634,1032,61.43%,43.99%,1
臺中市,北屯區,0892,476,110,586,35,621,1062,58.47%,44.82%,1
臺中市,北屯區,0893,380,92,472,54,526,909,57.87%,41.8%,1
臺中市,北屯區,0894,643,171,814,60,874,1445,60.48%,44.5%,1
臺中市,北屯區,0895,716,210,926,42,968,1842,52.55%,38.87%,1
臺中市,北屯區,0896,532,144,676,39,715,1187,60.24%,44.82%,1
臺中市,北屯區,0897,639,156,795,44,839,1456,57.62%,43.89%,1
臺中市,北屯區,0898,775,212,987,73,1060,1866,56.81%,41.53%,1
臺中市,北屯區,0899,683,170,853,52,905,1667,54.29%,40.97%,1
臺中市,北屯區,0900,751,178,929,30,959,1683,56.98%,44.62%,1
臺中市,北屯區,0901,658,215,873,42,915,1642,55.72%,40.07%,1
臺中市,北屯區,0902,651,165,816,25,841,1475,57.02%,44.14%,1
臺中市,北屯區,0903,702,148,850,29,879,1644,53.47%,42.7%,1
臺中市,北屯區,0904,755,158,913,34,947,1603,59.08%,47.1%,1
臺中市,北屯區,0905,857,229,1086,68,1154,1949,59.21%,43.97%,1
臺中市,北屯區,0906,850,210,1060,54,1114,1790,62.23%,47.49%,1
臺中市,北屯區,0907,621,175,796,49,845,1440,58.68%,43.13%,1
臺中市,北屯區,0908,686,224,910,60,970,1601,60.59%,42.85%,1
臺中市,北屯區,0909,592,205,797,58,855,1527,55.99%,38.77%,1
臺中市,北屯區,0910,654,174,828,60,888,1675,53.01%,39.04%,1
臺中市,北屯區,0911,492,149,641,41,682,1579,43.19%,31.16%,1
臺中市,北屯區,0912,620,166,786,95,881,1524,57.81%,40.68%,1
臺中市,北屯區,0913,675,174,849,67,916,1677,54.62%,40.25%,1
臺中市,北屯區,0914,650,185,835,68,903,1599,56.47%,40.65%,1
臺中市,北屯區,0915,631,181,812,73,885,1458,60.7%,43.28%,1
臺中市,北屯區,0916,781,173,954,69,1023,1571,65.12%,49.71%,1
臺中市,北屯區,0917,656,209,865,71,936,1579,59.28%,41.55%,1
臺中市,北屯區,0918,779,242,1021,66,1087,1849,58.79%,42.13%,1
臺中市,北屯區,0919,736,185,921,44,965,1682,57.37%,43.76%,1
臺中市,北屯區,0920,740,177,917,46,963,1760,54.72%,42.05%,1
臺中市,北屯區,0921,735,185,920,71,991,1699,58.33%,43.26%,1
臺中市,北屯區,0922,748,195,943,61,1004,1626,61.75%,46%,1
臺中市,北屯區,0923,647,223,870,15,885,1491,59.36%,43.39%,1
臺中市,北屯區,0924,650,205,855,34,889,1640,54.21%,39.63%,1
臺中市,北屯區,0925,813,232,1045,69,1114,2052,54.29%,39.62%,1
臺中市,北屯區,0926,798,214,1012,58,1070,1875,57.07%,42.56%,1
臺中市,北屯區,0927,669,161,830,29,859,1559,55.1%,42.91%,1
臺中市,北屯區,0928,631,176,807,75,882,1480,59.59%,42.64%,1
臺中市,北屯區,0929,585,176,761,72,833,1397,59.63%,41.88%,1
臺中市,北屯區,0930,830,210,1040,57,1097,1889,58.07%,43.94%,1
臺中市,北屯區,0931,697,199,896,100,996,1728,57.64%,40.34%,1
臺中市,北屯區,0932,629,185,814,74,888,1592,55.78%,39.51%,1
臺中市,北屯區,0933,646,189,835,80,915,1656,55.25%,39.01%,1
臺中市,北屯區,0934,589,165,754,74,828,1524,54.33%,38.65%,1
臺中市,北屯區,0935,638,197,835,47,882,1502,58.72%,42.48%,1
臺中市,北屯區,0936,757,188,945,42,987,1772,55.7%,42.72%,1
臺中市,北屯區,0937,675,152,827,52,879,1461,60.16%,46.2%,1
臺中市,北屯區,0938,689,168,857,32,889,1769,50.25%,38.95%,1
臺中市,北屯區,0939,791,260,1051,78,1129,1894,59.61%,41.76%,1
臺中市,北屯區,0940,774,224,998,67,1065,2033,52.39%,38.07%,1
臺中市,北屯區,0941,799,210,1009,58,1067,1947,54.8%,41.04%,1
臺中市,北屯區,0942,879,311,1190,68,1258,2188,57.5%,40.17%,1
臺中市,北屯區,0943,731,203,934,64,998,1661,60.08%,44.01%,1
臺中市,北屯區,0944,729,199,928,44,972,1667,58.31%,43.73%,1
臺中市,北屯區,0945,704,194,898,58,956,1728,55.32%,40.74%,1
臺中市,北屯區,0946,683,187,870,44,914,1688,54.15%,40.46%,1
臺中市,北屯區,0947,644,169,813,30,843,1475,57.15%,43.66%,1
臺中市,北屯區,0948,755,220,975,44,1019,1681,60.62%,44.91%,1
臺中市,北屯區,0949,892,261,1153,62,1215,2078,58.47%,42.93%,1
臺中市,北屯區,0950,869,229,1098,63,1161,2059,56.39%,42.2%,1
臺中市,北屯區,0951,771,222,993,47,1040,1792,58.04%,43.02%,1
臺中市,北屯區,0952,788,221,1009,39,1048,2974,35.24%,26.5%,1
臺中市,北屯區,0953,432,143,575,55,630,1072,58.77%,40.3%,1
臺中市,北屯區,0954,1076,234,1310,64,1374,2099,65.46%,51.26%,1
臺中市,北屯區,0955,835,283,1118,50,1168,1823,64.07%,45.8%,1
臺中市,北屯區,0956,907,252,1159,75,1234,2022,61.03%,44.86%,1
臺中市,北屯區,0957,850,219,1069,43,1112,1992,55.82%,42.67%,1
臺中市,北屯區,0958,712,193,905,56,961,1585,60.63%,44.92%,1
臺中市,北屯區,0959,701,198,899,60,959,1565,61.28%,44.79%,1
臺中市,北屯區,0960,648,190,838,57,895,1780,50.28%,36.4%,1
臺中市,北屯區,0961,885,211,1096,58,1154,1874,61.58%,47.23%,1
臺中市,北屯區,0962,839,163,1002,46,1048,1755,59.72%,47.81%,1
臺中市,北屯區,0963,747,209,956,46,1002,1497,66.93%,49.9%,1
臺中市,北屯區,0964,755,181,936,57,993,1567,63.37%,48.18%,1
臺中市,北屯區,0965,701,154,855,54,909,1624,55.97%,43.17%,1
臺中市,北屯區,0966,739,185,924,62,986,1614,61.09%,45.79%,1
臺中市,北屯區,0967,707,165,872,38,910,1595,57.05%,44.33%,1
臺中市,北屯區,0968,706,167,873,77,950,1782,53.31%,39.62%,1
臺中市,北屯區,0969,517,139,656,35,691,1357,50.92%,38.1%,1
臺中市,北屯區,0970,445,110,555,67,622,1071,58.08%,41.55%,1
臺中市,北屯區,0971,554,145,699,62,761,1372,55.47%,40.38%,1
臺中市,北屯區,0972,635,150,785,61,846,1415,59.79%,44.88%,1
臺中市,北屯區,0973,812,219,1031,74,1105,1789,61.77%,45.39%,1
臺中市,北屯區,0974,896,224,1120,77,1197,1907,62.77%,46.98%,1
臺中市,北屯區,0975,895,221,1116,71,1187,2008,59.11%,44.57%,1
臺中市,北屯區,0976,651,169,820,57,877,1541,56.91%,42.25%,1
臺中市,北屯區,0977,734,204,938,59,997,1669,59.74%,43.98%,1
臺中市,北屯區,0978,734,184,918,31,949,1685,56.32%,43.56%,1
臺中市,北屯區,0979,736,215,951,82,1033,1785,57.87%,41.23%,1
臺中市,北屯區,0980,725,187,912,67,979,1596,61.34%,45.43%,1
臺中市,北屯區,0981,759,226,985,63,1048,1731,60.54%,43.85%,1
臺中市,北屯區,0982,592,182,774,75,849,1496,56.75%,39.57%,1
臺中市,豐原區,0394,372,130,502,56,558,983,56.77%,37.84%,1
臺中市,豐原區,0395,538,186,724,56,780,1309,59.59%,41.1%,1
臺中市,豐原區,0396,460,174,634,57,691,1116,61.92%,41.22%,1
臺中市,豐原區,0397,433,124,557,52,609,945,64.44%,45.82%,1
臺中市,豐原區,0398,339,145,484,73,557,850,65.53%,39.88%,1
臺中市,豐原區,0399,341,99,440,45,485,760,63.82%,44.87%,1
臺中市,豐原區,0400,663,218,881,10,891,1617,55.1%,41%,1
臺中市,豐原區,0401,678,140,818,70,888,1677,52.95%,40.43%,1
臺中市,豐原區,0402,834,233,1067,50,1117,1771,63.07%,47.09%,1
臺中市,豐原區,0403,436,177,613,60,673,1145,58.78%,38.08%,1
臺中市,豐原區,0404,662,48,710,59,769,1362,56.46%,48.6%,1
臺中市,豐原區,0405,625,160,785,51,836,1389,60.19%,45%,1
臺中市,豐原區,0406,663,211,874,65,939,1530,61.37%,43.33%,1
臺中市,豐原區,0407,581,198,779,104,883,1471,60.03%,39.5%,1
臺中市,豐原區,0408,573,197,770,90,860,1410,60.99%,40.64%,1
臺中市,豐原區,0409,463,152,615,57,672,1162,57.83%,39.85%,1
臺中市,豐原區,0410,671,222,893,47,940,1656,56.76%,40.52%,1
臺中市,豐原區,0411,762,226,988,56,1044,1838,56.8%,41.46%,1
臺中市,豐原區,0412,651,208,859,81,940,1666,56.42%,39.08%,1
臺中市,豐原區,0413,766,238,1004,96,1100,1821,60.41%,42.06%,1
臺中市,豐原區,0414,888,244,1132,80,1212,1821,66.56%,48.76%,1
臺中市,豐原區,0415,646,209,855,48,903,1647,54.83%,39.22%,1
臺中市,豐原區,0416,569,181,750,88,838,1256,66.72%,45.3%,1
臺中市,豐原區,0417,722,208,930,66,996,1552,64.18%,46.52%,1
臺中市,豐原區,0418,758,225,983,57,1040,1793,58%,42.28%,1
臺中市,豐原區,0419,354,118,472,55,527,759,69.43%,46.64%,1
臺中市,豐原區,0420,262,112,374,46,420,642,65.42%,40.81%,1
臺中市,豐原區,0421,640,217,857,39,896,1528,58.64%,41.88%,1
臺中市,豐原區,0422,815,228,1043,90,1133,1788,63.37%,45.58%,1
臺中市,豐原區,0423,783,215,998,87,1085,1663,65.24%,47.08%,1
臺中市,豐原區,0424,608,187,795,75,870,1260,69.05%,48.25%,1
臺中市,豐原區,0425,391,95,486,37,523,902,57.98%,43.35%,1
臺中市,豐原區,0426,541,130,671,38,709,1357,52.25%,39.87%,1
臺中市,豐原區,0427,708,198,906,60,966,1592,60.68%,44.47%,1
臺中市,豐原區,0428,815,189,1004,95,1099,1873,58.68%,43.51%,1
臺中市,豐原區,0429,785,206,991,67,1058,1867,56.67%,42.05%,1
臺中市,豐原區,0430,749,216,965,95,1060,1823,58.15%,41.09%,1
臺中市,豐原區,0431,759,204,963,78,1041,1962,53.06%,38.69%,1
臺中市,豐原區,0432,996,331,1327,89,1416,2313,61.22%,43.06%,1
臺中市,豐原區,0433,675,181,856,79,935,1510,61.92%,44.7%,1
臺中市,豐原區,0434,746,283,1029,69,1098,1824,60.2%,40.9%,1
臺中市,豐原區,0435,576,174,750,59,809,1363,59.35%,42.26%,1
臺中市,豐原區,0436,695,206,901,69,970,1535,63.19%,45.28%,1
臺中市,豐原區,0437,605,243,848,60,908,1457,62.32%,41.52%,1
臺中市,豐原區,0438,518,161,679,49,728,1184,61.49%,43.75%,1
臺中市,豐原區,0439,790,223,1013,96,1109,2299,48.24%,34.36%,1
臺中市,豐原區,0440,833,220,1053,100,1153,1940,59.43%,42.94%,1
臺中市,豐原區,0441,813,265,1078,68,1146,2067,55.44%,39.33%,1
臺中市,豐原區,0442,851,215,1066,89,1155,2038,56.67%,41.76%,1
臺中市,豐原區,0443,738,541,1279,66,1345,1835,73.3%,40.22%,1
臺中市,豐原區,0444,776,269,1045,95,1140,1979,57.6%,39.21%,1
臺中市,豐原區,0445,818,205,1023,118,1141,2014,56.65%,40.62%,1
臺中市,豐原區,0446,910,284,1194,121,1315,2257,58.26%,40.32%,1
臺中市,豐原區,0447,614,192,806,78,884,1406,62.87%,43.67%,1
臺中市,豐原區,0448,619,170,789,62,851,1418,60.01%,43.65%,1
臺中市,豐原區,0449,871,192,1063,61,1124,1772,63.43%,49.15%,1
臺中市,豐原區,0450,541,167,708,53,761,1202,63.31%,45.01%,1
臺中市,豐原區,0451,653,199,852,36,888,1447,61.37%,45.13%,1
臺中市,豐原區,0452,732,239,971,106,1077,1758,61.26%,41.64%,1
臺中市,豐原區,0453,705,211,916,72,988,1546,63.91%,45.6%,1
臺中市,豐原區,0454,871,182,1053,69,1122,1815,61.82%,47.99%,1
臺中市,豐原區,0455,840,265,1105,60,1165,1932,60.3%,43.48%,1
臺中市,豐原區,0456,832,235,1067,64,1131,1770,63.9%,47.01%,1
臺中市,豐原區,0457,654,167,821,53,874,1560,56.03%,41.92%,1
臺中市,豐原區,0458,765,220,985,63,1048,1810,57.9%,42.27%,1
臺中市,豐原區,0459,735,226,961,65,1026,1653,62.07%,44.46%,1
臺中市,豐原區,0460,620,173,793,66,859,1444,59.49%,42.94%,1
臺中市,豐原區,0461,605,174,779,59,838,1318,63.58%,45.9%,1
臺中市,豐原區,0462,647,218,865,95,960,1566,61.3%,41.32%,1
臺中市,豐原區,0463,736,207,943,71,1014,1748,58.01%,42.11%,1
臺中市,豐原區,0464,675,191,866,96,962,1772,54.29%,38.09%,1
臺中市,豐原區,0465,690,219,909,95,1004,1721,58.34%,40.09%,1
臺中市,豐原區,0466,688,198,886,65,951,1578,60.27%,43.6%,1
臺中市,豐原區,0467,710,272,982,103,1085,1859,58.36%,38.19%,1
臺中市,豐原區,0468,601,207,808,65,873,1479,59.03%,40.64%,1
臺中市,豐原區,0469,817,216,1033,64,1097,1889,58.07%,43.25%,1
臺中市,豐原區,0470,788,196,984,48,1032,1803,57.24%,43.7%,1
臺中市,豐原區,0471,533,197,730,82,812,1421,57.14%,37.51%,1
臺中市,豐原區,0472,676,238,914,87,1001,1585,63.15%,42.65%,1
臺中市,豐原區,0473,920,122,1042,77,1119,1774,63.08%,51.86%,1
臺中市,豐原區,0474,920,254,1174,84,1258,2132,59.01%,43.15%,1
臺中市,豐原區,0475,616,198,814,87,901,1515,59.47%,40.66%,1
臺中市,豐原區,0476,528,150,678,32,710,1359,52.24%,38.85%,1
臺中市,豐原區,0477,409,139,548,49,597,948,62.97%,43.14%,1
臺中市,豐原區,0478,462,187,649,62,711,1134,62.7%,40.74%,1
臺中市,豐原區,0479,521,165,686,62,748,1114,67.15%,46.77%,1
臺中市,豐原區,0480,412,171,583,54,637,1050,60.67%,39.24%,1
臺中市,豐原區,0481,545,159,704,70,774,1182,65.48%,46.11%,1
臺中市,東勢區,1513,503,147,650,67,717,1299,55.2%,38.72%,1
臺中市,東勢區,1514,373,126,499,57,556,1007,55.21%,37.04%,1
臺中市,東勢區,1515,322,87,409,71,480,859,55.88%,37.49%,1
臺中市,東勢區,1516,419,140,559,87,646,991,65.19%,42.28%,1
臺中市,東勢區,1517,286,100,386,38,424,863,49.13%,33.14%,1
臺中市,東勢區,1518,614,188,802,125,927,1628,56.94%,37.71%,1
臺中市,東勢區,1519,472,151,623,74,697,1335,52.21%,35.36%,1
臺中市,東勢區,1520,499,145,644,54,698,1092,63.92%,45.7%,1
臺中市,東勢區,1521,456,151,607,62,669,1050,63.71%,43.43%,1
臺中市,東勢區,1522,613,141,754,66,820,1431,57.3%,42.84%,1
臺中市,東勢區,1523,600,161,761,64,825,1372,60.13%,43.73%,1
臺中市,東勢區,1524,626,158,784,49,833,1412,58.99%,44.33%,1
臺中市,東勢區,1525,359,93,452,64,516,878,58.77%,40.89%,1
臺中市,東勢區,1526,528,160,688,80,768,1475,52.07%,35.8%,1
臺中市,東勢區,1527,354,80,434,31,465,872,53.33%,40.6%,1
臺中市,東勢區,1528,381,119,500,66,566,1006,56.26%,37.87%,1
臺中市,東勢區,1529,493,152,645,31,676,1222,55.32%,40.34%,1
臺中市,東勢區,1530,569,162,731,74,805,1228,65.55%,46.34%,1
臺中市,東勢區,1531,363,117,480,32,512,1036,49.42%,35.04%,1
臺中市,東勢區,1532,434,112,546,46,592,977,60.59%,44.42%,1
臺中市,東勢區,1533,581,127,708,37,745,1395,53.41%,41.65%,1
臺中市,東勢區,1534,504,145,649,90,739,1169,63.22%,43.11%,1
臺中市,東勢區,1535,445,130,575,67,642,1027,62.51%,43.33%,1
臺中市,東勢區,1536,426,108,534,46,580,984,58.94%,43.29%,1
臺中市,東勢區,1537,417,101,518,44,562,866,64.9%,48.15%,1
臺中市,東勢區,1538,437,114,551,87,638,1031,61.88%,42.39%,1
臺中市,東勢區,1539,422,85,507,68,575,865,66.47%,48.79%,1
臺中市,東勢區,1540,638,150,788,74,862,1357,63.52%,47.02%,1
臺中市,東勢區,1541,337,77,414,35,449,736,61.01%,45.79%,1
臺中市,東勢區,1542,552,155,707,62,769,1314,58.52%,42.01%,1
臺中市,東勢區,1543,601,198,799,108,907,1677,54.08%,35.84%,1
臺中市,東勢區,1544,408,124,532,35,567,950,59.68%,42.95%,1
臺中市,東勢區,1545,458,114,572,53,625,1007,62.07%,45.48%,1
臺中市,東勢區,1546,384,172,556,64,620,1214,51.07%,31.63%,1
臺中市,東勢區,1547,370,100,470,50,520,907,57.33%,40.79%,1
臺中市,東勢區,1548,352,99,451,48,499,902,55.32%,39.02%,1
臺中市,東勢區,1549,235,65,300,19,319,720,44.31%,32.64%,1
臺中市,東勢區,1550,214,78,292,13,305,666,45.8%,32.13%,1
臺中市,東勢區,1551,516,146,662,78,740,1361,54.37%,37.91%,1
臺中市,大甲區,0001,541,177,718,88,806,1356,59.44%,39.9%,1
臺中市,大甲區,0002,479,124,603,58,661,1059,62.42%,45.23%,1
臺中市,大甲區,0003,302,99,401,37,438,694,63.11%,43.52%,1
臺中市,大甲區,0004,346,141,487,31,518,874,59.27%,39.59%,1
臺中市,大甲區,0005,297,98,395,34,429,763,56.23%,38.93%,1
臺中市,大甲區,0006,379,121,500,47,547,856,63.9%,44.28%,1
臺中市,大甲區,0007,555,130,685,58,743,1249,59.49%,44.44%,1
臺中市,大甲區,0008,346,115,461,35,496,922,53.8%,37.53%,1
臺中市,大甲區,0009,488,154,642,47,689,1189,57.95%,41.04%,1
臺中市,大甲區,0010,501,115,616,67,683,1065,64.13%,47.04%,1
臺中市,大甲區,0011,550,155,705,99,804,1252,64.22%,43.93%,1
臺中市,大甲區,0012,419,126,545,58,603,1057,57.05%,39.64%,1
臺中市,大甲區,0013,413,144,557,35,592,1031,57.42%,40.06%,1
臺中市,大甲區,0014,453,150,603,66,669,1060,63.11%,42.74%,1
臺中市,大甲區,0015,533,165,698,67,765,1311,58.35%,40.66%,1
臺中市,大甲區,0016,627,138,765,55,820,1424,57.58%,44.03%,1
臺中市,大甲區,0017,691,209,900,82,982,1670,58.8%,41.38%,1
臺中市,大甲區,0018,340,86,426,48,474,812,58.37%,41.87%,1
臺中市,大甲區,0019,369,106,475,31,506,863,58.63%,42.76%,1
臺中市,大甲區,0020,680,204,884,64,948,1598,59.32%,42.55%,1
臺中市,大甲區,0021,672,179,851,55,906,1588,57.05%,42.32%,1
臺中市,大甲區,0022,462,164,626,69,695,1197,58.06%,38.6%,1
臺中市,大甲區,0023,388,128,516,101,617,1106,55.79%,35.08%,1
臺中市,大甲區,0024,385,118,503,70,573,903,63.46%,42.64%,1
臺中市,大甲區,0025,370,124,494,47,541,869,62.26%,42.58%,1
臺中市,大甲區,0026,553,184,737,44,781,1350,57.85%,40.96%,1
臺中市,大甲區,0027,428,149,577,102,679,1144,59.35%,37.41%,1
臺中市,大甲區,0028,533,149,682,59,741,1208,61.34%,44.12%,1
臺中市,大甲區,0029,646,215,861,46,907,1567,57.88%,41.23%,1
臺中市,大甲區,0030,574,172,746,45,791,1246,63.48%,46.07%,1
臺中市,大甲區,0031,314,106,420,47,467,767,60.89%,40.94%,1
臺中市,大甲區,0032,329,104,433,47,480,790,60.76%,41.65%,1
臺中市,大甲區,0033,446,91,537,42,579,972,59.57%,45.88%,1
臺中市,大甲區,0034,551,148,699,64,763,1388,54.97%,39.7%,1
臺中市,大甲區,0035,508,166,674,37,711,1331,53.42%,38.17%,1
臺中市,大甲區,0036,512,160,672,53,725,1167,62.13%,43.87%,1
臺中市,大甲區,0037,843,201,1044,62,1106,1934,57.19%,43.59%,1
臺中市,大甲區,0038,470,132,602,58,660,1263,52.26%,37.21%,1
臺中市,大甲區,0039,656,74,730,61,791,1390,56.91%,47.19%,1
臺中市,大甲區,0040,396,121,517,40,557,1186,46.96%,33.39%,1
臺中市,大甲區,0041,565,167,732,39,771,1397,55.19%,40.44%,1
臺中市,大甲區,0042,360,112,472,24,496,1173,42.28%,30.69%,1
臺中市,大甲區,0043,531,156,687,82,769,1398,55.01%,37.98%,1
臺中市,大甲區,0044,431,147,578,61,639,1228,52.04%,35.1%,1
臺中市,大甲區,0045,484,138,622,58,680,1258,54.05%,38.47%,1
臺中市,大甲區,0046,469,271,740,51,791,1435,55.12%,32.68%,1
臺中市,大甲區,0047,579,203,782,61,843,1532,55.03%,37.79%,1
臺中市,大甲區,0048,258,75,333,43,376,652,57.67%,39.57%,1
臺中市,大甲區,0049,283,96,379,43,422,870,48.51%,32.53%,1
臺中市,大甲區,0050,329,100,429,31,460,891,51.63%,36.92%,1
臺中市,大甲區,0051,326,92,418,33,451,784,57.53%,41.58%,1
臺中市,大甲區,0052,488,166,654,95,749,1368,54.75%,35.67%,1
臺中市,大甲區,0053,426,117,543,58,601,1126,53.37%,37.83%,1
臺中市,大甲區,0054,510,138,648,83,731,1486,49.19%,34.32%,1
臺中市,清水區,0091,422,131,553,26,579,1076,53.81%,39.22%,1
臺中市,清水區,0092,433,137,570,56,626,953,65.69%,45.44%,1
臺中市,清水區,0093,373,138,511,56,567,914,62.04%,40.81%,1
臺中市,清水區,0094,523,154,677,54,731,1143,63.95%,45.76%,1
臺中市,清水區,0095,295,96,391,34,425,680,62.5%,43.38%,1
臺中市,清水區,0096,394,117,511,53,564,904,62.39%,43.58%,1
臺中市,清水區,0097,391,128,519,54,573,893,64.17%,43.78%,1
臺中市,清水區,0098,621,232,853,63,916,1577,58.08%,39.38%,1
臺中市,清水區,0099,280,87,367,36,403,690,58.41%,40.58%,1
臺中市,清水區,0100,161,63,224,22,246,403,61.04%,39.95%,1
臺中市,清水區,0101,603,174,777,66,843,1413,59.66%,42.68%,1
臺中市,清水區,0102,308,94,402,56,458,777,58.94%,39.64%,1
臺中市,清水區,0103,571,177,748,45,793,1313,60.4%,43.49%,1
臺中市,清水區,0104,629,197,826,64,890,1439,61.85%,43.71%,1
臺中市,清水區,0105,490,162,652,29,681,1265,53.83%,38.74%,1
臺中市,清水區,0106,599,164,763,32,795,1277,62.26%,46.91%,1
臺中市,清水區,0107,572,143,715,53,768,1276,60.19%,44.83%,1
臺中市,清水區,0108,642,184,826,39,865,1376,62.86%,46.66%,1
臺中市,清水區,0109,601,161,762,38,800,1291,61.97%,46.55%,1
臺中市,清水區,0110,651,192,843,75,918,1510,60.79%,43.11%,1
臺中市,清水區,0111,649,177,826,80,906,1524,59.45%,42.59%,1
臺中市,清水區,0112,574,160,734,49,783,1474,53.12%,38.94%,1
臺中市,清水區,0113,615,188,803,55,858,1507,56.93%,40.81%,1
臺中市,清水區,0114,590,182,772,89,861,1321,65.18%,44.66%,1
臺中市,清水區,0115,424,144,568,35,603,1157,52.12%,36.65%,1
臺中市,清水區,0116,563,150,713,43,756,1255,60.24%,44.86%,1
臺中市,清水區,0117,354,105,459,39,498,881,56.53%,40.18%,1
臺中市,清水區,0118,493,115,608,61,669,1083,61.77%,45.52%,1
臺中市,清水區,0119,437,112,549,29,578,951,60.78%,45.95%,1
臺中市,清水區,0120,571,140,711,71,782,1424,54.92%,40.1%,1
臺中市,清水區,0121,443,170,613,62,675,1233,54.74%,35.93%,1
臺中市,清水區,0122,423,184,607,22,629,1288,48.84%,32.84%,1
臺中市,清水區,0123,517,144,661,62,723,1200,60.25%,43.08%,1
臺中市,清水區,0124,782,132,914,45,959,1609,59.6%,48.6%,1
臺中市,清水區,0125,510,162,672,37,709,1136,62.41%,44.89%,1
臺中市,清水區,0126,531,116,647,78,725,1302,55.68%,40.78%,1
臺中市,清水區,0127,553,135,688,88,776,1373,56.52%,40.28%,1
臺中市,清水區,0128,443,137,580,76,656,1257,52.19%,35.24%,1
臺中市,清水區,0129,423,126,549,62,611,1184,51.6%,35.73%,1
臺中市,清水區,0130,534,135,669,73,742,1322,56.13%,40.39%,1
臺中市,清水區,0131,435,151,586,45,631,1193,52.89%,36.46%,1
臺中市,清水區,0132,353,125,478,74,552,927,59.55%,38.08%,1
臺中市,清水區,0133,464,141,605,64,669,1073,62.35%,43.24%,1
臺中市,清水區,0134,476,156,632,87,719,1163,61.82%,40.93%,1
臺中市,清水區,0135,323,92,415,62,477,855,55.79%,37.78%,1
臺中市,清水區,0136,307,118,425,75,500,902,55.43%,34.04%,1
臺中市,清水區,0137,579,167,746,70,816,1415,57.67%,40.92%,1
臺中市,清水區,0138,402,138,540,38,578,1066,54.22%,37.71%,1
臺中市,清水區,0139,535,176,711,68,779,1391,56%,38.46%,1
臺中市,清水區,0140,547,181,728,37,765,1449,52.8%,37.75%,1
臺中市,清水區,0141,571,189,760,67,827,1377,60.06%,41.47%,1
臺中市,清水區,0142,593,180,773,65,838,1423,58.89%,41.67%,1
臺中市,清水區,0143,663,218,881,56,937,1624,57.7%,40.83%,1
臺中市,清水區,0144,515,158,673,81,754,1358,55.52%,37.92%,1
臺中市,清水區,0145,600,149,749,99,848,1464,57.92%,40.98%,1
臺中市,清水區,0146,515,157,672,72,744,1211,61.44%,42.53%,1
臺中市,清水區,0147,584,145,729,36,765,1456,52.54%,40.11%,1
臺中市,清水區,0148,514,130,644,81,725,1162,62.39%,44.23%,1
臺中市,清水區,0149,640,144,784,89,873,1368,63.82%,46.78%,1
臺中市,沙鹿區,0186,544,132,676,60,736,1380,53.33%,39.42%,1
臺中市,沙鹿區,0187,358,115,473,47,520,852,61.03%,42.02%,1
臺中市,沙鹿區,0188,525,164,689,38,727,1176,61.82%,44.64%,1
臺中市,沙鹿區,0189,406,158,564,81,645,958,67.33%,42.38%,1
臺中市,沙鹿區,0190,236,71,307,30,337,488,69.06%,48.36%,1
臺中市,沙鹿區,0191,467,177,644,44,688,1177,58.45%,39.68%,1
臺中市,沙鹿區,0192,492,174,666,68,734,1285,57.12%,38.29%,1
臺中市,沙鹿區,0193,607,235,842,99,941,1736,54.21%,34.97%,1
臺中市,沙鹿區,0194,687,224,911,84,995,1628,61.12%,42.2%,1
臺中市,沙鹿區,0195,574,176,750,37,787,1469,53.57%,39.07%,1
臺中市,沙鹿區,0196,633,197,830,42,872,1423,61.28%,44.48%,1
臺中市,沙鹿區,0197,588,189,777,85,862,1444,59.7%,40.72%,1
臺中市,沙鹿區,0198,586,186,772,89,861,1469,58.61%,39.89%,1
臺中市,沙鹿區,0199,748,252,1000,97,1097,1902,57.68%,39.33%,1
臺中市,沙鹿區,0200,707,216,923,64,987,1675,58.93%,42.21%,1
臺中市,沙鹿區,0201,431,143,574,61,635,1098,57.83%,39.25%,1
臺中市,沙鹿區,0202,628,229,857,75,932,1539,60.56%,40.81%,1
臺中市,沙鹿區,0203,569,178,747,40,787,1329,59.22%,42.81%,1
臺中市,沙鹿區,0204,458,177,635,54,689,1255,54.9%,36.49%,1
臺中市,沙鹿區,0205,622,205,827,60,887,1507,58.86%,41.27%,1
臺中市,沙鹿區,0206,598,173,771,95,866,1463,59.19%,40.87%,1
臺中市,沙鹿區,0207,476,151,627,80,707,1279,55.28%,37.22%,1
臺中市,沙鹿區,0208,399,91,490,43,533,1024,52.05%,38.96%,1
臺中市,沙鹿區,0209,528,142,670,82,752,1388,54.18%,38.04%,1
臺中市,沙鹿區,0210,452,146,598,50,648,1074,60.34%,42.09%,1
臺中市,沙鹿區,0211,468,142,610,42,652,1072,60.82%,43.66%,1
臺中市,沙鹿區,0212,493,130,623,68,691,1107,62.42%,44.53%,1
臺中市,沙鹿區,0213,715,209,924,64,988,1947,50.74%,36.72%,1
臺中市,沙鹿區,0214,650,179,829,71,900,1682,53.51%,38.64%,1
臺中市,沙鹿區,0215,792,154,946,3,949,1633,58.11%,48.5%,1
臺中市,沙鹿區,0216,569,169,738,58,796,1533,51.92%,37.12%,1
臺中市,沙鹿區,0217,546,158,704,50,754,1605,46.98%,34.02%,1
臺中市,沙鹿區,0218,671,164,835,40,875,1694,51.65%,39.61%,1
臺中市,沙鹿區,0219,623,193,816,57,873,1628,53.62%,38.27%,1
臺中市,沙鹿區,0220,725,209,934,30,964,1665,57.9%,43.54%,1
臺中市,沙鹿區,0221,659,190,849,58,907,1651,54.94%,39.92%,1
臺中市,沙鹿區,0222,500,155,655,37,692,1108,62.45%,45.13%,1
臺中市,沙鹿區,0223,498,150,648,52,700,1142,61.3%,43.61%,1
臺中市,沙鹿區,0224,450,115,565,33,598,1039,57.56%,43.31%,1
臺中市,沙鹿區,0225,715,229,944,69,1013,1840,55.05%,38.86%,1
臺中市,沙鹿區,0226,763,221,984,52,1036,1872,55.34%,40.76%,1
臺中市,沙鹿區,0227,603,166,769,71,840,1558,53.92%,38.7%,1
臺中市,沙鹿區,0228,665,177,842,56,898,1739,51.64%,38.24%,1
臺中市,沙鹿區,0229,599,190,789,44,833,1672,49.82%,35.83%,1
臺中市,沙鹿區,0230,676,190,866,43,909,1634,55.63%,41.37%,1
臺中市,沙鹿區,0231,611,162,773,52,825,1616,51.05%,37.81%,1
臺中市,沙鹿區,0232,647,199,846,57,903,1593,56.69%,40.62%,1
臺中市,沙鹿區,0233,412,88,500,27,527,981,53.72%,42%,1
臺中市,沙鹿區,0234,749,215,964,62,1026,1740,58.97%,43.05%,1
臺中市,沙鹿區,0235,531,167,698,65,763,1247,61.19%,42.58%,1
臺中市,沙鹿區,0236,481,98,579,17,596,1047,56.92%,45.94%,1
臺中市,沙鹿區,0237,458,131,589,74,663,1119,59.25%,40.93%,1
臺中市,沙鹿區,0238,390,134,524,25,549,1025,53.56%,38.05%,1
臺中市,梧棲區,0150,600,201,801,67,868,1541,56.33%,38.94%,1
臺中市,梧棲區,0151,617,197,814,65,879,1581,55.6%,39.03%,1
臺中市,梧棲區,0152,423,156,579,57,636,1083,58.73%,39.06%,1
臺中市,梧棲區,0153,383,112,495,33,528,876,60.27%,43.72%,1
臺中市,梧棲區,0154,406,148,554,63,617,1043,59.16%,38.93%,1
臺中市,梧棲區,0155,563,177,740,45,785,1502,52.26%,37.48%,1
臺中市,梧棲區,0156,595,158,753,43,796,1384,57.51%,42.99%,1
臺中市,梧棲區,0157,221,96,317,38,355,517,68.67%,42.75%,1
臺中市,梧棲區,0158,537,143,680,65,745,1169,63.73%,45.94%,1
臺中市,梧棲區,0159,343,144,487,37,524,863,60.72%,39.75%,1
臺中市,梧棲區,0160,468,125,593,48,641,1277,50.2%,36.65%,1
臺中市,梧棲區,0161,632,245,877,61,938,1742,53.85%,36.28%,1
臺中市,梧棲區,0162,499,225,724,63,787,1342,58.64%,37.18%,1
臺中市,梧棲區,0163,687,244,931,90,1021,1767,57.78%,38.88%,1
臺中市,梧棲區,0164,540,182,722,70,792,1542,51.36%,35.02%,1
臺中市,梧棲區,0165,616,217,833,64,897,1636,54.83%,37.65%,1
臺中市,梧棲區,0166,643,213,856,82,938,1796,52.23%,35.8%,1
臺中市,梧棲區,0167,573,156,729,68,797,1450,54.97%,39.52%,1
臺中市,梧棲區,0168,555,170,725,124,849,1548,54.84%,35.85%,1
臺中市,梧棲區,0169,567,184,751,51,802,1366,58.71%,41.51%,1
臺中市,梧棲區,0170,467,110,577,32,609,955,63.77%,48.9%,1
臺中市,梧棲區,0171,502,154,656,60,716,1305,54.87%,38.47%,1
臺中市,梧棲區,0172,515,169,684,45,729,1239,58.84%,41.57%,1
臺中市,梧棲區,0173,483,112,595,72,667,1079,61.82%,44.76%,1
臺中市,梧棲區,0174,539,91,630,49,679,1220,55.66%,44.18%,1
臺中市,梧棲區,0175,656,195,851,77,928,1544,60.1%,42.49%,1
臺中市,梧棲區,0176,613,204,817,61,878,1460,60.14%,41.99%,1
臺中市,梧棲區,0177,566,157,723,61,784,1292,60.68%,43.81%,1
臺中市,梧棲區,0178,529,148,677,62,739,1300,56.85%,40.69%,1
臺中市,梧棲區,0179,558,205,763,72,835,1555,53.7%,35.88%,1
臺中市,梧棲區,0180,414,112,526,47,573,1031,55.58%,40.16%,1
臺中市,梧棲區,0181,548,148,696,70,766,1277,59.98%,42.91%,1
臺中市,梧棲區,0182,387,137,524,49,573,1037,55.26%,37.32%,1
臺中市,梧棲區,0183,479,157,636,70,706,1187,59.48%,40.35%,1
臺中市,梧棲區,0184,541,155,696,55,751,1399,53.68%,38.67%,1
臺中市,梧棲區,0185,461,132,593,47,640,1135,56.39%,40.62%,1
臺中市,后里區,0357,402,93,495,48,543,852,63.73%,47.18%,1
臺中市,后里區,0358,449,128,577,71,648,1135,57.09%,39.56%,1
臺中市,后里區,0359,396,125,521,52,573,1079,53.1%,36.7%,1
臺中市,后里區,0360,683,153,836,77,913,1539,59.32%,44.38%,1
臺中市,后里區,0361,687,157,844,81,925,1591,58.14%,43.18%,1
臺中市,后里區,0362,509,148,657,44,701,1376,50.94%,36.99%,1
臺中市,后里區,0363,522,165,687,24,711,1298,54.78%,40.22%,1
臺中市,后里區,0364,587,172,759,91,850,1428,59.52%,41.11%,1
臺中市,后里區,0365,557,162,719,63,782,1178,66.38%,47.28%,1
臺中市,后里區,0366,480,124,604,53,657,1095,60%,43.84%,1
臺中市,后里區,0367,393,111,504,25,529,963,54.93%,40.81%,1
臺中市,后里區,0368,466,139,605,53,658,1163,56.58%,40.07%,1
臺中市,后里區,0369,463,115,578,37,615,1018,60.41%,45.48%,1
臺中市,后里區,0370,407,97,504,59,563,854,65.93%,47.66%,1
臺中市,后里區,0371,590,153,743,70,813,1485,54.75%,39.73%,1
臺中市,后里區,0372,668,139,807,48,855,1355,63.1%,49.3%,1
臺中市,后里區,0373,313,92,405,62,467,840,55.6%,37.26%,1
臺中市,后里區,0374,473,152,625,60,685,1146,59.77%,41.27%,1
臺中市,后里區,0375,747,188,935,87,1022,1669,61.23%,44.76%,1
臺中市,后里區,0376,742,188,930,110,1040,1673,62.16%,44.35%,1
臺中市,后里區,0377,653,168,821,50,871,1493,58.34%,43.74%,1
臺中市,后里區,0378,451,134,585,67,652,1052,61.98%,42.87%,1
臺中市,后里區,0379,341,109,450,28,478,909,52.59%,37.51%,1
臺中市,后里區,0380,452,139,591,83,674,1091,61.78%,41.43%,1
臺中市,后里區,0381,589,156,745,82,827,1342,61.62%,43.89%,1
臺中市,后里區,0382,413,159,572,65,637,1138,55.98%,36.29%,1
臺中市,后里區,0383,431,105,536,52,588,977,60.18%,44.11%,1
臺中市,后里區,0384,549,151,700,46,746,1584,47.1%,34.66%,1
臺中市,后里區,0385,370,111,481,39,520,915,56.83%,40.44%,1
臺中市,后里區,0386,516,143,659,77,736,1225,60.08%,42.12%,1
臺中市,后里區,0387,654,149,803,47,850,1552,54.77%,42.14%,1
臺中市,后里區,0388,657,182,839,29,868,1600,54.25%,41.06%,1
臺中市,后里區,0389,396,100,496,40,536,942,56.9%,42.04%,1
臺中市,后里區,0390,358,140,498,26,524,943,55.57%,37.96%,1
臺中市,后里區,0391,403,107,510,51,561,1055,53.18%,38.2%,1
臺中市,后里區,0392,432,137,569,61,630,1067,59.04%,40.49%,1
臺中市,后里區,0393,480,166,646,66,712,1340,53.13%,35.82%,1
臺中市,神岡區,0482,762,176,938,62,1000,1684,59.38%,45.25%,1
臺中市,神岡區,0483,673,180,853,69,922,1559,59.14%,43.17%,1
臺中市,神岡區,0484,444,132,576,42,618,1095,56.44%,40.55%,1
臺中市,神岡區,0485,487,164,651,57,708,1044,67.82%,46.65%,1
臺中市,神岡區,0486,584,187,771,82,853,1310,65.11%,44.58%,1
臺中市,神岡區,0487,539,180,719,109,828,1294,63.99%,41.65%,1
臺中市,神岡區,0488,491,142,633,53,686,1143,60.02%,42.96%,1
臺中市,神岡區,0489,446,130,576,58,634,1022,62.04%,43.64%,1
臺中市,神岡區,0490,490,148,638,54,692,1269,54.53%,38.61%,1
臺中市,神岡區,0491,391,86,477,32,509,1085,46.91%,36.04%,1
臺中市,神岡區,0492,377,152,529,66,595,942,63.16%,40.02%,1
臺中市,神岡區,0493,453,141,594,41,635,1154,55.03%,39.25%,1
臺中市,神岡區,0494,548,168,716,54,770,1390,55.4%,39.42%,1
臺中市,神岡區,0495,578,200,778,90,868,1372,63.27%,42.13%,1
臺中市,神岡區,0496,482,153,635,42,677,1328,50.98%,36.3%,1
臺中市,神岡區,0497,399,134,533,31,564,1038,54.34%,38.44%,1
臺中市,神岡區,0498,614,157,771,51,822,1452,56.61%,42.29%,1
臺中市,神岡區,0499,703,184,887,67,954,1551,61.51%,45.33%,1
臺中市,神岡區,0500,624,158,782,79,861,1567,54.95%,39.82%,1
臺中市,神岡區,0501,616,179,795,46,841,1449,58.04%,42.51%,1
臺中市,神岡區,0502,469,147,616,26,642,1246,51.52%,37.64%,1
臺中市,神岡區,0503,616,178,794,60,854,1431,59.68%,43.05%,1
臺中市,神岡區,0504,501,153,654,81,735,1163,63.2%,43.08%,1
臺中市,神岡區,0505,634,206,840,61,901,1402,64.27%,45.22%,1
臺中市,神岡區,0506,543,155,698,52,750,1271,59.01%,42.72%,1
臺中市,神岡區,0507,510,160,670,56,726,1198,60.6%,42.57%,1
臺中市,神岡區,0508,564,160,724,77,801,1312,61.05%,42.99%,1
臺中市,神岡區,0509,638,186,824,77,901,1590,56.67%,40.13%,1
臺中市,神岡區,0510,510,163,673,48,721,1324,54.46%,38.52%,1
臺中市,神岡區,0511,535,170,705,51,756,1415,53.43%,37.81%,1
臺中市,神岡區,0512,674,208,882,58,940,1483,63.39%,45.45%,1
臺中市,神岡區,0513,505,174,679,48,727,1402,51.85%,36.02%,1
臺中市,神岡區,0514,524,139,663,48,711,1275,55.76%,41.1%,1
臺中市,神岡區,0515,464,170,634,73,707,1288,54.89%,36.02%,1
臺中市,神岡區,0516,420,132,552,64,616,1080,57.04%,38.89%,1
臺中市,神岡區,0517,511,175,686,31,717,1344,53.35%,38.02%,1
臺中市,神岡區,0518,458,141,599,67,666,1061,62.77%,43.17%,1
臺中市,神岡區,0519,533,157,690,51,741,1176,63.01%,45.32%,1
臺中市,神岡區,0520,529,177,706,71,777,1244,62.46%,42.52%,1
臺中市,神岡區,0521,605,180,785,65,850,1318,64.49%,45.9%,1
臺中市,神岡區,0522,578,168,746,53,799,1471,54.32%,39.29%,1
臺中市,神岡區,0523,585,204,789,87,876,1323,66.21%,44.22%,1
臺中市,潭子區,0570,561,164,725,58,783,1306,59.95%,42.96%,1
臺中市,潭子區,0571,464,166,630,57,687,1128,60.9%,41.13%,1
臺中市,潭子區,0572,517,166,683,62,745,1159,64.28%,44.61%,1
臺中市,潭子區,0573,728,190,918,82,1000,1630,61.35%,44.66%,1
臺中市,潭子區,0574,666,172,838,40,878,1532,57.31%,43.47%,1
臺中市,潭子區,0575,639,184,823,43,866,1677,51.64%,38.1%,1
臺中市,潭子區,0576,660,190,850,70,920,1744,52.75%,37.84%,1
臺中市,潭子區,0577,739,237,976,57,1033,1795,57.55%,41.17%,1
臺中市,潭子區,0578,494,134,628,45,673,1171,57.47%,42.19%,1
臺中市,潭子區,0579,621,154,775,41,816,1427,57.18%,43.52%,1
臺中市,潭子區,0580,693,208,901,64,965,1709,56.47%,40.55%,1
臺中市,潭子區,0581,751,186,937,42,979,1723,56.82%,43.59%,1
臺中市,潭子區,0582,734,194,928,56,984,1782,55.22%,41.19%,1
臺中市,潭子區,0583,575,150,725,42,767,1407,54.51%,40.87%,1
臺中市,潭子區,0584,767,190,957,42,999,1771,56.41%,43.31%,1
臺中市,潭子區,0585,784,207,991,93,1084,1795,60.39%,43.68%,1
臺中市,潭子區,0586,758,192,950,61,1011,1612,62.72%,47.02%,1
臺中市,潭子區,0587,783,201,984,50,1034,1894,54.59%,41.34%,1
臺中市,潭子區,0588,688,203,891,59,950,1689,56.25%,40.73%,1
臺中市,潭子區,0589,593,158,751,53,804,1525,52.72%,38.89%,1
臺中市,潭子區,0590,653,200,853,54,907,1622,55.92%,40.26%,1
臺中市,潭子區,0591,495,146,641,78,719,1200,59.92%,41.25%,1
臺中市,潭子區,0592,552,142,694,25,719,1355,53.06%,40.74%,1
臺中市,潭子區,0593,724,199,923,38,961,1777,54.08%,40.74%,1
臺中市,潭子區,0594,836,205,1041,33,1074,1923,55.85%,43.47%,1
臺中市,潭子區,0595,671,172,843,78,921,1674,55.02%,40.08%,1
臺中市,潭子區,0596,675,178,853,60,913,1451,62.92%,46.52%,1
臺中市,潭子區,0597,628,201,829,73,902,1486,60.7%,42.26%,1
臺中市,潭子區,0598,655,192,847,70,917,1511,60.69%,43.35%,1
臺中市,潭子區,0599,749,184,933,60,993,1666,59.6%,44.96%,1
臺中市,潭子區,0600,720,186,906,76,982,1750,56.11%,41.14%,1
臺中市,潭子區,0601,609,146,755,55,810,1437,56.37%,42.38%,1
臺中市,潭子區,0602,729,198,927,49,976,1735,56.25%,42.02%,1
臺中市,潭子區,0603,635,211,846,66,912,1612,56.58%,39.39%,1
臺中市,潭子區,0604,531,146,677,28,705,1143,61.68%,46.46%,1
臺中市,潭子區,0605,853,210,1063,60,1123,2096,53.58%,40.7%,1
臺中市,潭子區,0606,653,215,868,67,935,1549,60.36%,42.16%,1
臺中市,潭子區,0607,650,205,855,35,890,1573,56.58%,41.32%,1
臺中市,潭子區,0608,635,154,789,48,837,1585,52.81%,40.06%,1
臺中市,潭子區,0609,658,166,824,55,879,1572,55.92%,41.86%,1
臺中市,潭子區,0610,779,197,976,53,1029,1738,59.21%,44.82%,1
臺中市,潭子區,0611,747,220,967,83,1050,1883,55.76%,39.67%,1
臺中市,潭子區,0612,582,174,756,43,799,1401,57.03%,41.54%,1
臺中市,潭子區,0613,579,192,771,61,832,1352,61.54%,42.83%,1
臺中市,潭子區,0614,913,217,1130,98,1228,2085,58.9%,43.79%,1
臺中市,潭子區,0615,895,245,1140,101,1241,2047,60.63%,43.72%,1
臺中市,潭子區,0616,629,213,842,37,879,1673,52.54%,37.6%,1
臺中市,潭子區,0617,773,236,1009,107,1116,1874,59.55%,41.25%,1
臺中市,潭子區,0618,418,155,573,57,630,1051,59.94%,39.77%,1
臺中市,潭子區,0619,634,201,835,52,887,1674,52.99%,37.87%,1
臺中市,潭子區,0620,761,232,993,84,1077,1831,58.82%,41.56%,1
臺中市,潭子區,0621,762,233,995,86,1081,2003,53.97%,38.04%,1
臺中市,潭子區,0622,605,175,780,51,831,1535,54.14%,39.41%,1
臺中市,潭子區,0623,836,212,1048,118,1166,2286,51.01%,36.57%,1
臺中市,潭子區,0624,719,203,922,75,997,1861,53.57%,38.64%,1
臺中市,大雅區,0524,864,224,1088,74,1162,2027,57.33%,42.62%,1
臺中市,大雅區,0525,733,207,940,40,980,1967,49.82%,37.26%,1
臺中市,大雅區,0526,781,184,965,57,1022,1912,53.45%,40.85%,1
臺中市,大雅區,0527,695,192,887,51,938,1537,61.03%,45.22%,1
臺中市,大雅區,0528,612,202,814,60,874,1439,60.74%,42.53%,1
臺中市,大雅區,0529,591,195,786,51,837,1402,59.7%,42.15%,1
臺中市,大雅區,0530,840,236,1076,46,1122,2013,55.74%,41.73%,1
臺中市,大雅區,0531,796,255,1051,80,1131,1917,59%,41.52%,1
臺中市,大雅區,0532,789,249,1038,49,1087,2011,54.05%,39.23%,1
臺中市,大雅區,0533,809,212,1021,57,1078,1887,57.13%,42.87%,1
臺中市,大雅區,0534,646,204,850,58,908,1480,61.35%,43.65%,1
臺中市,大雅區,0535,751,211,962,68,1030,1816,56.72%,41.35%,1
臺中市,大雅區,0536,697,198,895,85,980,1898,51.63%,36.72%,1
臺中市,大雅區,0537,860,215,1075,75,1150,2008,57.27%,42.83%,1
臺中市,大雅區,0538,1060,15,1075,69,1144,1976,57.89%,53.64%,1
臺中市,大雅區,0539,725,200,925,51,976,1673,58.34%,43.34%,1
臺中市,大雅區,0540,634,194,828,41,869,1409,61.67%,45%,1
臺中市,大雅區,0541,583,184,767,38,805,1382,58.25%,42.19%,1
臺中市,大雅區,0542,674,175,849,81,930,1635,56.88%,41.22%,1
臺中市,大雅區,0543,666,201,867,55,922,1565,58.91%,42.56%,1
臺中市,大雅區,0544,599,179,778,60,838,1528,54.84%,39.2%,1
臺中市,大雅區,0545,774,202,976,52,1028,1963,52.37%,39.43%,1
臺中市,大雅區,0546,780,222,1002,58,1060,2073,51.13%,37.63%,1
臺中市,大雅區,0547,805,233,1038,63,1101,1984,55.49%,40.57%,1
臺中市,大雅區,0548,679,194,873,73,946,1688,56.04%,40.23%,1
臺中市,大雅區,0549,603,169,772,50,822,1387,59.26%,43.48%,1
臺中市,大雅區,0550,733,205,938,94,1032,1701,60.67%,43.09%,1
臺中市,大雅區,0551,699,204,903,72,975,1721,56.65%,40.62%,1
臺中市,大雅區,0552,654,149,803,55,858,1879,45.66%,34.81%,1
臺中市,大雅區,0553,699,225,924,62,986,1568,62.88%,44.58%,1
臺中市,大雅區,0554,685,256,941,69,1010,1761,57.35%,38.9%,1
臺中市,大雅區,0555,755,224,979,91,1070,1752,61.07%,43.09%,1
臺中市,大雅區,0556,571,148,719,36,755,1264,59.73%,45.17%,1
臺中市,大雅區,0557,603,150,753,59,812,1302,62.37%,46.31%,1
臺中市,大雅區,0558,610,162,772,61,833,1449,57.49%,42.1%,1
臺中市,大雅區,0559,702,199,901,95,996,1621,61.44%,43.31%,1
臺中市,大雅區,0560,661,163,824,101,925,1647,56.16%,40.13%,1
臺中市,大雅區,0561,582,157,739,42,781,1441,54.2%,40.39%,1
臺中市,大雅區,0562,612,140,752,37,789,1460,54.04%,41.92%,1
臺中市,大雅區,0563,799,245,1044,82,1126,1832,61.46%,43.61%,1
臺中市,大雅區,0564,621,176,797,73,870,1371,63.46%,45.3%,1
臺中市,大雅區,0565,512,161,673,9,682,1418,48.1%,36.11%,1
臺中市,大雅區,0566,637,181,818,47,865,1473,58.72%,43.25%,1
臺中市,大雅區,0567,538,182,720,72,792,1335,59.33%,40.3%,1
臺中市,大雅區,0568,762,157,919,71,990,1733,57.13%,43.97%,1
臺中市,大雅區,0569,696,145,841,120,961,1884,51.01%,36.94%,1
臺中市,新社區,1562,390,126,516,34,550,1011,54.4%,38.58%,1
臺中市,新社區,1563,483,153,636,43,679,1195,56.82%,40.42%,1
臺中市,新社區,1564,460,122,582,45,627,1053,59.54%,43.68%,1
臺中市,新社區,1565,289,79,368,28,396,961,41.21%,30.07%,1
臺中市,新社區,1566,348,101,449,22,471,919,51.25%,37.87%,1
臺中市,新社區,1567,602,159,761,72,833,1367,60.94%,44.04%,1
臺中市,新社區,1568,352,118,470,38,508,1010,50.3%,34.85%,1
臺中市,新社區,1569,385,103,488,71,559,1169,47.82%,32.93%,1
臺中市,新社區,1570,377,118,495,69,564,989,57.03%,38.12%,1
臺中市,新社區,1571,344,88,432,31,463,894,51.79%,38.48%,1
臺中市,新社區,1572,392,96,488,22,510,1033,49.37%,37.95%,1
臺中市,新社區,1573,322,75,397,37,434,1058,41.02%,30.43%,1
臺中市,新社區,1574,273,89,362,26,388,845,45.92%,32.31%,1
臺中市,新社區,1575,276,73,349,34,383,576,66.49%,47.92%,1
臺中市,新社區,1576,429,120,549,74,623,1229,50.69%,34.91%,1
臺中市,新社區,1577,281,82,363,38,401,890,45.06%,31.57%,1
臺中市,新社區,1578,277,74,351,41,392,781,50.19%,35.47%,1
臺中市,新社區,1579,491,114,605,74,679,1244,54.58%,39.47%,1
臺中市,新社區,1580,52,11,63,15,78,213,36.62%,24.41%,1
臺中市,新社區,1581,212,56,268,41,309,676,45.71%,31.36%,1
臺中市,新社區,1582,200,44,244,35,279,585,47.69%,34.19%,1
臺中市,新社區,1583,390,85,475,51,526,938,56.08%,41.58%,1
臺中市,新社區,1584,80,15,95,15,110,224,49.11%,35.71%,1
臺中市,石岡區,1552,521,151,672,54,726,1244,58.36%,41.88%,1
臺中市,石岡區,1553,612,185,797,67,864,1539,56.14%,39.77%,1
臺中市,石岡區,1554,485,163,648,62,710,1202,59.07%,40.35%,1
臺中市,石岡區,1555,478,141,619,78,697,1272,54.8%,37.58%,1
臺中市,石岡區,1556,274,70,344,47,391,652,59.97%,42.02%,1
臺中市,石岡區,1557,668,193,861,98,959,1457,65.82%,45.85%,1
臺中市,石岡區,1558,721,218,939,97,1036,1836,56.43%,39.27%,1
臺中市,石岡區,1559,425,99,524,55,579,1001,57.84%,42.46%,1
臺中市,石岡區,1560,627,187,814,70,884,1448,61.05%,43.3%,1
臺中市,石岡區,1561,548,148,696,67,763,1229,62.08%,44.59%,1
臺中市,外埔區,0071,416,118,534,66,600,1059,56.66%,39.28%,1
臺中市,外埔區,0072,440,120,560,28,588,1013,58.05%,43.44%,1
臺中市,外埔區,0073,528,116,644,68,712,1150,61.91%,45.91%,1
臺中市,外埔區,0074,904,202,1106,72,1178,1855,63.5%,48.73%,1
臺中市,外埔區,0075,587,166,753,41,794,1327,59.83%,44.24%,1
臺中市,外埔區,0076,652,170,822,54,876,1453,60.29%,44.87%,1
臺中市,外埔區,0077,686,155,841,85,926,1653,56.02%,41.5%,1
臺中市,外埔區,0078,637,180,817,56,873,1615,54.06%,39.44%,1
臺中市,外埔區,0079,555,171,726,47,773,1470,52.59%,37.76%,1
臺中市,外埔區,0080,633,203,836,78,914,1559,58.63%,40.6%,1
臺中市,外埔區,0081,739,222,961,109,1070,1902,56.26%,38.85%,1
臺中市,外埔區,0082,515,154,669,62,731,1138,64.24%,45.25%,1
臺中市,外埔區,0083,465,132,597,82,679,1065,63.76%,43.66%,1
臺中市,外埔區,0084,567,158,725,52,777,1243,62.51%,45.62%,1
臺中市,外埔區,0085,375,105,480,49,529,962,54.99%,38.98%,1
臺中市,外埔區,0086,472,120,592,61,653,1169,55.86%,40.38%,1
臺中市,外埔區,0087,558,157,715,65,780,1216,64.14%,45.89%,1
臺中市,外埔區,0088,562,141,703,68,771,1391,55.43%,40.4%,1
臺中市,外埔區,0089,602,205,807,99,906,1616,56.06%,37.25%,1
臺中市,外埔區,0090,397,104,501,52,553,1203,45.97%,33%,1
臺中市,大安區,0055,399,101,500,70,570,1068,53.37%,37.36%,1
臺中市,大安區,0056,428,110,538,75,613,1050,58.38%,40.76%,1
臺中市,大安區,0057,502,170,672,80,752,1246,60.35%,40.29%,1
臺中市,大安區,0058,539,173,712,66,778,1397,55.69%,38.58%,1
臺中市,大安區,0059,511,177,688,71,759,1227,61.86%,41.65%,1
臺中市,大安區,0060,481,130,611,77,688,1170,58.8%,41.11%,1
臺中市,大安區,0061,428,108,536,59,595,914,65.1%,46.83%,1
臺中市,大安區,0062,241,57,298,47,345,667,51.72%,36.13%,1
臺中市,大安區,0063,347,79,426,60,486,890,54.61%,38.99%,1
臺中市,大安區,0064,502,145,647,83,730,1289,56.63%,38.94%,1
臺中市,大安區,0065,155,51,206,35,241,455,52.97%,34.07%,1
臺中市,大安區,0066,425,120,545,42,587,1028,57.1%,41.34%,1
臺中市,大安區,0067,603,167,770,90,860,1446,59.47%,41.7%,1
臺中市,大安區,0068,340,69,409,37,446,688,64.83%,49.42%,1
臺中市,大安區,0069,456,124,580,70,650,1062,61.21%,42.94%,1
臺中市,大安區,0070,406,140,546,48,594,923,64.36%,43.99%,1
臺中市,烏日區,0317,637,229,866,65,931,1480,62.91%,43.04%,1
臺中市,烏日區,0318,772,224,996,93,1089,1841,59.15%,41.93%,1
臺中市,烏日區,0319,681,227,908,81,989,1751,56.48%,38.89%,1
臺中市,烏日區,0320,672,201,873,94,967,1547,62.51%,43.44%,1
臺中市,烏日區,0321,793,205,998,50,1048,1836,57.08%,43.19%,1
臺中市,烏日區,0322,539,194,733,85,818,1239,66.02%,43.5%,1
臺中市,烏日區,0323,520,148,668,73,741,1295,57.22%,40.15%,1
臺中市,烏日區,0324,507,155,662,52,714,1263,56.53%,40.14%,1
臺中市,烏日區,0325,678,187,865,40,905,1622,55.8%,41.8%,1
臺中市,烏日區,0326,742,191,933,99,1032,1822,56.64%,40.72%,1
臺中市,烏日區,0327,819,207,1026,69,1095,1966,55.7%,41.66%,1
臺中市,烏日區,0328,706,179,885,62,947,1615,58.64%,43.72%,1
臺中市,烏日區,0329,556,147,703,42,745,1232,60.47%,45.13%,1
臺中市,烏日區,0330,557,120,677,37,714,1347,53.01%,41.35%,1
臺中市,烏日區,0331,477,100,577,40,617,1165,52.96%,40.94%,1
臺中市,烏日區,0332,742,196,938,44,982,1664,59.01%,44.59%,1
臺中市,烏日區,0333,560,159,719,62,781,1230,63.5%,45.53%,1
臺中市,烏日區,0334,680,223,903,94,997,1574,63.34%,43.2%,1
臺中市,烏日區,0335,655,208,863,54,917,1452,63.15%,45.11%,1
臺中市,烏日區,0336,729,174,903,71,974,1879,51.84%,38.8%,1
臺中市,烏日區,0337,639,205,844,48,892,1601,55.72%,39.91%,1
臺中市,烏日區,0338,654,231,885,68,953,1546,61.64%,42.3%,1
臺中市,烏日區,0339,565,309,874,40,914,1866,48.98%,30.28%,1
臺中市,烏日區,0340,793,288,1081,86,1167,1938,60.22%,40.92%,1
臺中市,烏日區,0341,738,219,957,75,1032,1759,58.67%,41.96%,1
臺中市,烏日區,0342,843,240,1083,78,1161,2061,56.33%,40.9%,1
臺中市,烏日區,0343,749,192,941,59,1000,1691,59.14%,44.29%,1
臺中市,烏日區,0344,460,181,641,43,684,1039,65.83%,44.27%,1
臺中市,烏日區,0345,506,178,684,39,723,1221,59.21%,41.44%,1
臺中市,烏日區,0346,657,219,876,101,977,1650,59.21%,39.82%,1
臺中市,烏日區,0347,511,29,540,42,582,937,62.11%,54.54%,1
臺中市,烏日區,0348,546,136,682,51,733,1220,60.08%,44.75%,1
臺中市,烏日區,0349,763,53,816,132,948,2139,44.32%,35.67%,1
臺中市,烏日區,0350,620,174,794,87,881,1371,64.26%,45.22%,1
臺中市,烏日區,0351,535,153,688,61,749,1277,58.65%,41.9%,1
臺中市,烏日區,0352,647,221,868,75,943,1708,55.21%,37.88%,1
臺中市,烏日區,0353,841,216,1057,89,1146,2048,55.96%,41.06%,1
臺中市,烏日區,0354,617,201,818,88,906,1632,55.51%,37.81%,1
臺中市,烏日區,0355,535,192,727,78,805,1327,60.66%,40.32%,1
臺中市,烏日區,0356,318,106,424,71,495,854,57.96%,37.24%,1
臺中市,大肚區,0284,583,164,747,41,788,1415,55.69%,41.2%,1
臺中市,大肚區,0285,530,153,683,63,746,1392,53.59%,38.07%,1
臺中市,大肚區,0286,670,185,855,66,921,1520,60.59%,44.08%,1
臺中市,大肚區,0287,403,124,527,56,583,862,67.63%,46.75%,1
臺中市,大肚區,0288,555,165,720,57,777,1256,61.86%,44.19%,1
臺中市,大肚區,0289,537,141,678,69,747,1292,57.82%,41.56%,1
臺中市,大肚區,0290,441,129,570,45,615,1010,60.89%,43.66%,1
臺中市,大肚區,0291,635,187,822,96,918,1485,61.82%,42.76%,1
臺中市,大肚區,0292,552,132,684,71,755,1190,63.45%,46.39%,1
臺中市,大肚區,0293,535,143,678,65,743,1250,59.44%,42.8%,1
臺中市,大肚區,0294,569,153,722,55,777,1310,59.31%,43.44%,1
臺中市,大肚區,0295,531,149,680,56,736,1294,56.88%,41.04%,1
臺中市,大肚區,0296,757,251,1008,65,1073,1734,61.88%,43.66%,1
臺中市,大肚區,0297,512,153,665,81,746,1316,56.69%,38.91%,1
臺中市,大肚區,0298,353,112,465,44,509,854,59.6%,41.33%,1
臺中市,大肚區,0299,679,64,743,50,793,1273,62.29%,53.34%,1
臺中市,大肚區,0300,396,113,509,25,534,851,62.75%,46.53%,1
臺中市,大肚區,0301,693,162,855,48,903,1629,55.43%,42.54%,1
臺中市,大肚區,0302,674,179,853,109,962,1709,56.29%,39.44%,1
臺中市,大肚區,0303,362,94,456,53,509,953,53.41%,37.99%,1
臺中市,大肚區,0304,574,177,751,62,813,1336,60.85%,42.96%,1
臺中市,大肚區,0305,781,270,1051,91,1142,2113,54.05%,36.96%,1
臺中市,大肚區,0306,708,199,907,110,1017,1730,58.79%,40.92%,1
臺中市,大肚區,0307,710,199,909,34,943,1692,55.73%,41.96%,1
臺中市,大肚區,0308,742,189,931,53,984,1747,56.33%,42.47%,1
臺中市,大肚區,0309,721,164,885,73,958,1672,57.3%,43.12%,1
臺中市,大肚區,0310,627,199,826,57,883,1675,52.72%,37.43%,1
臺中市,大肚區,0311,673,192,865,72,937,1673,56.01%,40.23%,1
臺中市,大肚區,0312,683,224,907,56,963,1636,58.86%,41.75%,1
臺中市,大肚區,0313,620,221,841,103,944,1753,53.85%,35.37%,1
臺中市,大肚區,0314,485,152,637,41,678,1343,50.48%,36.11%,1
臺中市,大肚區,0315,739,188,927,65,992,1822,54.45%,40.56%,1
臺中市,大肚區,0316,747,175,922,107,1029,1670,61.62%,44.73%,1
臺中市,龍井區,0239,735,228,963,83,1046,1758,59.5%,41.81%,1
臺中市,龍井區,0240,525,154,679,49,728,1275,57.1%,41.18%,1
臺中市,龍井區,0241,590,49,639,29,668,1379,48.44%,42.78%,1
臺中市,龍井區,0242,517,160,677,65,742,1403,52.89%,36.85%,1
臺中市,龍井區,0243,380,135,515,47,562,974,57.7%,39.01%,1
臺中市,龍井區,0244,374,107,481,53,534,901,59.27%,41.51%,1
臺中市,龍井區,0245,595,219,814,80,894,1779,50.25%,33.45%,1
臺中市,龍井區,0246,682,203,885,71,956,1609,59.42%,42.39%,1
臺中市,龍井區,0247,373,130,503,29,532,1038,51.25%,35.93%,1
臺中市,龍井區,0248,589,151,740,66,806,1328,60.69%,44.35%,1
臺中市,龍井區,0249,387,141,528,34,562,921,61.02%,42.02%,1
臺中市,龍井區,0250,593,184,777,67,844,1609,52.45%,36.86%,1
臺中市,龍井區,0251,402,151,553,24,577,1227,47.03%,32.76%,1
臺中市,龍井區,0252,487,165,652,71,723,1278,56.57%,38.11%,1
臺中市,龍井區,0253,265,116,381,24,405,914,44.31%,28.99%,1
臺中市,龍井區,0254,587,158,745,48,793,1678,47.26%,34.98%,1
臺中市,龍井區,0255,414,161,575,40,615,1233,49.88%,33.58%,1
臺中市,龍井區,0256,580,191,771,84,855,1520,56.25%,38.16%,1
臺中市,龍井區,0257,697,227,924,44,968,1905,50.81%,36.59%,1
臺中市,龍井區,0258,585,247,832,65,897,1520,59.01%,38.49%,1
臺中市,龍井區,0259,512,151,663,85,748,1385,54.01%,36.97%,1
臺中市,龍井區,0260,470,154,624,54,678,1212,55.94%,38.78%,1
臺中市,龍井區,0261,593,179,772,37,809,1432,56.49%,41.41%,1
臺中市,龍井區,0262,623,204,827,49,876,1663,52.68%,37.46%,1
臺中市,龍井區,0263,535,169,704,44,748,1422,52.6%,37.62%,1
臺中市,龍井區,0264,530,211,741,72,813,1616,50.31%,32.8%,1
臺中市,龍井區,0265,595,163,758,67,825,1422,58.02%,41.84%,1
臺中市,龍井區,0266,519,137,656,32,688,1165,59.06%,44.55%,1
臺中市,龍井區,0267,664,211,875,32,907,1624,55.85%,40.89%,1
臺中市,龍井區,0268,665,186,851,54,905,1613,56.11%,41.23%,1
臺中市,龍井區,0269,400,137,537,49,586,943,62.14%,42.42%,1
臺中市,龍井區,0270,578,174,752,99,851,1595,53.35%,36.24%,1
臺中市,龍井區,0271,656,161,817,71,888,1508,58.89%,43.5%,1
臺中市,龍井區,0272,540,190,730,51,781,1479,52.81%,36.51%,1
臺中市,龍井區,0273,612,198,810,61,871,1509,57.72%,40.56%,1
臺中市,龍井區,0274,681,189,870,78,948,1582,59.92%,43.05%,1
臺中市,龍井區,0275,727,188,915,48,963,1725,55.83%,42.14%,1
臺中市,龍井區,0276,717,145,862,47,909,1616,56.25%,44.37%,1
臺中市,龍井區,0277,706,216,922,49,971,1657,58.6%,42.61%,1
臺中市,龍井區,0278,760,210,970,61,1031,1774,58.12%,42.84%,1
臺中市,龍井區,0279,737,221,958,73,1031,1701,60.61%,43.33%,1
臺中市,龍井區,0280,490,124,614,48,662,1121,59.05%,43.71%,1
臺中市,龍井區,0281,429,144,573,46,619,987,62.72%,43.47%,1
臺中市,龍井區,0282,463,186,649,60,709,1206,58.79%,38.39%,1
臺中市,龍井區,0283,611,199,810,36,846,1378,61.39%,44.34%,1
臺中市,霧峰區,1470,541,150,691,50,741,1205,61.49%,44.9%,1
臺中市,霧峰區,1471,651,209,860,63,923,1620,56.98%,40.19%,1
臺中市,霧峰區,1472,691,191,882,71,953,1559,61.13%,44.32%,1
臺中市,霧峰區,1473,686,192,878,73,951,1660,57.29%,41.33%,1
臺中市,霧峰區,1474,716,189,905,69,974,1602,60.8%,44.69%,1
臺中市,霧峰區,1475,527,145,672,54,726,1325,54.79%,39.77%,1
臺中市,霧峰區,1476,654,161,815,60,875,1515,57.76%,43.17%,1
臺中市,霧峰區,1477,596,202,798,82,880,1561,56.37%,38.18%,1
臺中市,霧峰區,1478,633,212,845,64,909,1691,53.76%,37.43%,1
臺中市,霧峰區,1479,606,184,790,69,859,1486,57.81%,40.78%,1
臺中市,霧峰區,1480,385,157,542,70,612,975,62.77%,39.49%,1
臺中市,霧峰區,1481,632,139,771,61,832,1358,61.27%,46.54%,1
臺中市,霧峰區,1482,559,146,705,54,759,1141,66.52%,48.99%,1
臺中市,霧峰區,1483,374,114,488,90,578,855,67.6%,43.74%,1
臺中市,霧峰區,1484,508,129,637,82,719,1202,59.82%,42.26%,1
臺中市,霧峰區,1485,427,121,548,54,602,1078,55.84%,39.61%,1
臺中市,霧峰區,1486,613,192,805,89,894,1456,61.4%,42.1%,1
臺中市,霧峰區,1487,700,183,883,66,949,1573,60.33%,44.5%,1
臺中市,霧峰區,1488,707,163,870,68,938,1591,58.96%,44.44%,1
臺中市,霧峰區,1489,567,142,709,70,779,1214,64.17%,46.71%,1
臺中市,霧峰區,1490,507,150,657,66,723,1267,57.06%,40.02%,1
臺中市,霧峰區,1491,563,110,673,86,759,1277,59.44%,44.09%,1
臺中市,霧峰區,1492,546,172,718,60,778,1366,56.95%,39.97%,1
臺中市,霧峰區,1493,466,153,619,69,688,994,69.22%,46.88%,1
臺中市,霧峰區,1494,381,118,499,46,545,863,63.15%,44.15%,1
臺中市,霧峰區,1495,518,155,673,57,730,1274,57.3%,40.66%,1
臺中市,霧峰區,1496,452,152,604,76,680,1162,58.52%,38.9%,1
臺中市,霧峰區,1497,538,148,686,89,775,1252,61.9%,42.97%,1
臺中市,霧峰區,1498,522,188,710,80,790,1322,59.76%,39.49%,1
臺中市,霧峰區,1499,477,157,634,72,706,1116,63.26%,42.74%,1
臺中市,霧峰區,1500,473,180,653,81,734,1156,63.49%,40.92%,1
臺中市,霧峰區,1501,542,120,662,60,722,1147,62.95%,47.25%,1
臺中市,霧峰區,1502,458,110,568,60,628,928,67.67%,49.35%,1
臺中市,霧峰區,1503,513,162,675,54,729,1296,56.25%,39.58%,1
臺中市,霧峰區,1504,558,75,633,85,718,1314,54.64%,42.47%,1
臺中市,霧峰區,1505,562,165,727,81,808,1328,60.84%,42.32%,1
臺中市,霧峰區,1506,379,131,510,72,582,989,58.85%,38.32%,1
臺中市,霧峰區,1507,480,120,600,83,683,1088,62.78%,44.12%,1
臺中市,霧峰區,1508,634,140,774,82,856,1363,62.8%,46.52%,1
臺中市,霧峰區,1509,682,200,882,82,964,1573,61.28%,43.36%,1
臺中市,霧峰區,1510,440,128,568,80,648,1117,58.01%,39.39%,1
臺中市,霧峰區,1511,592,182,774,86,860,1342,64.08%,44.11%,1
臺中市,霧峰區,1512,446,135,581,101,682,1024,66.6%,43.55%,1
臺中市,太平區,1271,678,217,895,99,994,1821,54.59%,37.23%,1
臺中市,太平區,1272,598,188,786,52,838,1680,49.88%,35.6%,1
臺中市,太平區,1273,784,235,1019,111,1130,1947,58.04%,40.27%,1
臺中市,太平區,1274,764,264,1028,120,1148,1910,60.1%,40%,1
臺中市,太平區,1275,704,244,948,61,1009,1894,53.27%,37.17%,1
臺中市,太平區,1276,777,227,1004,73,1077,1953,55.15%,39.78%,1
臺中市,太平區,1277,769,208,977,83,1060,1846,57.42%,41.66%,1
臺中市,太平區,1278,648,181,829,48,877,1493,58.74%,43.4%,1
臺中市,太平區,1279,649,184,833,65,898,1605,55.95%,40.44%,1
臺中市,太平區,1280,718,189,907,46,953,1619,58.86%,44.35%,1
臺中市,太平區,1281,746,252,998,90,1088,2011,54.1%,37.1%,1
臺中市,太平區,1282,793,218,1011,40,1051,2056,51.12%,38.57%,1
臺中市,太平區,1283,740,208,948,84,1032,1876,55.01%,39.45%,1
臺中市,太平區,1284,703,198,901,85,986,1815,54.33%,38.73%,1
臺中市,太平區,1285,486,162,648,59,707,1281,55.19%,37.94%,1
臺中市,太平區,1286,449,158,607,51,658,1004,65.54%,44.72%,1
臺中市,太平區,1287,771,266,1037,86,1123,1886,59.54%,40.88%,1
臺中市,太平區,1288,571,198,769,91,860,1431,60.1%,39.9%,1
臺中市,太平區,1289,748,222,970,80,1050,1930,54.4%,38.76%,1
臺中市,太平區,1290,790,228,1018,104,1122,2164,51.85%,36.51%,1
臺中市,太平區,1291,803,208,1011,96,1107,2048,54.05%,39.21%,1
臺中市,太平區,1292,808,215,1023,71,1094,2035,53.76%,39.71%,1
臺中市,太平區,1293,628,194,822,110,932,1685,55.31%,37.27%,1
臺中市,太平區,1294,757,237,994,88,1082,2185,49.52%,34.65%,1
臺中市,太平區,1295,458,127,585,31,616,1176,52.38%,38.95%,1
臺中市,太平區,1296,607,188,795,55,850,1597,53.22%,38.01%,1
臺中市,太平區,1297,521,190,711,77,788,1378,57.18%,37.81%,1
臺中市,太平區,1298,575,186,761,76,837,1546,54.14%,37.19%,1
臺中市,太平區,1299,665,201,866,95,961,1890,50.85%,35.19%,1
臺中市,太平區,1300,426,105,531,64,595,1053,56.51%,40.46%,1
臺中市,太平區,1301,702,159,861,88,949,1582,59.99%,44.37%,1
臺中市,太平區,1302,734,190,924,72,996,1699,58.62%,43.2%,1
臺中市,太平區,1303,569,157,726,79,805,1493,53.92%,38.11%,1
臺中市,太平區,1304,393,136,529,48,577,1063,54.28%,36.97%,1
臺中市,太平區,1305,500,126,626,55,681,1117,60.97%,44.76%,1
臺中市,太平區,1306,487,105,592,56,648,1084,59.78%,44.93%,1
臺中市,太平區,1307,657,184,841,53,894,1776,50.34%,36.99%,1
臺中市,太平區,1308,694,185,879,5,884,1729,51.13%,40.14%,1
臺中市,太平區,1309,594,149,743,62,805,1658,48.55%,35.83%,1
臺中市,太平區,1310,825,165,990,75,1065,2010,52.99%,41.04%,1
臺中市,太平區,1311,709,156,865,65,930,1752,53.08%,40.47%,1
臺中市,太平區,1312,737,181,918,77,995,1654,60.16%,44.56%,1
臺中市,太平區,1313,591,131,722,45,767,1951,39.31%,30.29%,1
臺中市,太平區,1314,960,281,1241,101,1342,2170,61.84%,44.24%,1
臺中市,太平區,1315,976,275,1251,67,1318,2231,59.08%,43.75%,1
臺中市,太平區,1316,695,170,865,48,913,1623,56.25%,42.82%,1
臺中市,太平區,1317,541,162,703,60,763,1548,49.29%,34.95%,1
臺中市,太平區,1318,539,168,707,84,791,1442,54.85%,37.38%,1
臺中市,太平區,1319,512,170,682,39,721,1501,48.03%,34.11%,1
臺中市,太平區,1320,733,195,928,40,968,2025,47.8%,36.2%,1
臺中市,太平區,1321,729,207,936,71,1007,1885,53.42%,38.67%,1
臺中市,太平區,1322,743,225,968,84,1052,2155,48.82%,34.48%,1
臺中市,太平區,1323,604,205,809,62,871,1775,49.07%,34.03%,1
臺中市,太平區,1324,657,170,827,94,921,2021,45.57%,32.51%,1
臺中市,太平區,1325,900,230,1130,85,1215,2075,58.55%,43.37%,1
臺中市,太平區,1326,628,201,829,68,897,1723,52.06%,36.45%,1
臺中市,太平區,1327,855,210,1065,79,1144,2049,55.83%,41.73%,1
臺中市,太平區,1328,600,145,745,35,780,1415,55.12%,42.4%,1
臺中市,太平區,1329,739,190,929,57,986,1778,55.46%,41.56%,1
臺中市,太平區,1330,642,195,837,62,899,1706,52.7%,37.63%,1
臺中市,太平區,1331,844,214,1058,65,1123,2090,53.73%,40.38%,1
臺中市,太平區,1332,792,185,977,71,1048,2093,50.07%,37.84%,1
臺中市,太平區,1333,596,146,742,49,791,1688,46.86%,35.31%,1
臺中市,太平區,1334,586,113,699,51,750,1488,50.4%,39.38%,1
臺中市,太平區,1335,685,240,925,71,996,1667,59.75%,41.09%,1
臺中市,太平區,1336,718,209,927,92,1019,1793,56.83%,40.04%,1
臺中市,太平區,1337,838,186,1024,46,1070,1903,56.23%,44.04%,1
臺中市,太平區,1338,737,210,947,76,1023,1834,55.78%,40.19%,1
臺中市,太平區,1339,618,139,757,51,808,1526,52.95%,40.5%,1
臺中市,太平區,1340,708,170,878,38,916,1483,61.77%,47.74%,1
臺中市,太平區,1341,736,177,913,41,954,1694,56.32%,43.45%,1
臺中市,太平區,1342,723,197,920,50,970,1952,49.69%,37.04%,1
臺中市,太平區,1343,809,209,1018,54,1072,1995,53.73%,40.55%,1
臺中市,太平區,1344,576,145,721,38,759,1311,57.89%,43.94%,1
臺中市,太平區,1345,776,182,958,58,1016,1537,66.1%,50.49%,1
臺中市,太平區,1346,721,195,916,62,978,1974,49.54%,36.52%,1
臺中市,太平區,1347,768,201,969,53,1022,1828,55.91%,42.01%,1
臺中市,太平區,1348,807,210,1017,50,1067,2191,48.7%,36.83%,1
臺中市,太平區,1349,666,200,866,107,973,1825,53.32%,36.49%,1
臺中市,太平區,1350,562,160,722,15,737,1559,47.27%,36.05%,1
臺中市,太平區,1351,464,144,608,79,687,1225,56.08%,37.88%,1
臺中市,太平區,1352,670,191,861,71,932,1678,55.54%,39.93%,1
臺中市,太平區,1353,524,175,699,101,800,1501,53.3%,34.91%,1
臺中市,太平區,1354,623,220,843,78,921,1450,63.52%,42.97%,1
臺中市,太平區,1355,796,207,1003,82,1085,2126,51.03%,37.44%,1
臺中市,太平區,1356,300,95,395,55,450,699,64.38%,42.92%,1
臺中市,太平區,1357,458,161,619,41,660,1428,46.22%,32.07%,1
臺中市,太平區,1358,664,195,859,98,957,1666,57.44%,39.86%,1
臺中市,太平區,1359,524,125,649,41,690,1241,55.6%,42.22%,1
臺中市,太平區,1360,549,146,695,66,761,1266,60.11%,43.36%,1
臺中市,太平區,1361,483,138,621,50,671,1166,57.55%,41.42%,1
臺中市,太平區,1362,635,208,843,86,929,1790,51.9%,35.47%,1
臺中市,太平區,1363,595,151,746,65,811,1754,46.24%,33.92%,1
臺中市,大里區,1364,626,174,800,52,852,1614,52.79%,38.79%,1
臺中市,大里區,1365,596,163,759,39,798,1599,49.91%,37.27%,1
臺中市,大里區,1366,625,194,819,53,872,1715,50.85%,36.44%,1
臺中市,大里區,1367,534,140,674,32,706,1264,55.85%,42.25%,1
臺中市,大里區,1368,555,141,696,44,740,1416,52.26%,39.19%,1
臺中市,大里區,1369,483,124,607,40,647,1188,54.46%,40.66%,1
臺中市,大里區,1370,491,163,654,66,720,1359,52.98%,36.13%,1
臺中市,大里區,1371,597,181,778,62,840,1457,57.65%,40.97%,1
臺中市,大里區,1372,593,171,764,64,828,1403,59.02%,42.27%,1
臺中市,大里區,1373,660,196,856,62,918,1697,54.1%,38.89%,1
臺中市,大里區,1374,746,239,985,99,1084,1811,59.86%,41.19%,1
臺中市,大里區,1375,705,208,913,68,981,1830,53.61%,38.52%,1
臺中市,大里區,1376,670,200,870,98,968,2228,43.45%,30.07%,1
臺中市,大里區,1377,836,219,1055,94,1149,1997,57.54%,41.86%,1
臺中市,大里區,1378,986,246,1232,60,1292,2033,63.55%,48.5%,1
臺中市,大里區,1379,728,267,995,53,1048,1835,57.11%,39.67%,1
臺中市,大里區,1380,531,149,680,37,717,1268,56.55%,41.88%,1
臺中市,大里區,1381,704,190,894,62,956,1645,58.12%,42.8%,1
臺中市,大里區,1382,692,173,865,48,913,1561,58.49%,44.33%,1
臺中市,大里區,1383,637,168,805,38,843,1301,64.8%,48.96%,1
臺中市,大里區,1384,633,172,805,73,878,1621,54.16%,39.05%,1
臺中市,大里區,1385,653,234,887,83,970,1797,53.98%,36.34%,1
臺中市,大里區,1386,488,125,613,28,641,1230,52.11%,39.67%,1
臺中市,大里區,1387,586,157,743,61,804,1488,54.03%,39.38%,1
臺中市,大里區,1388,531,181,712,82,794,1459,54.42%,36.39%,1
臺中市,大里區,1389,668,193,861,73,934,1647,56.71%,40.56%,1
臺中市,大里區,1390,443,157,600,70,670,1100,60.91%,40.27%,1
臺中市,大里區,1391,575,172,747,58,805,1410,57.09%,40.78%,1
臺中市,大里區,1392,676,203,879,78,957,1807,52.96%,37.41%,1
臺中市,大里區,1393,523,184,707,54,761,1331,57.18%,39.29%,1
臺中市,大里區,1394,713,199,912,57,969,1801,53.8%,39.59%,1
臺中市,大里區,1395,736,183,919,46,965,1909,50.55%,38.55%,1
臺中市,大里區,1396,598,173,771,89,860,1699,50.62%,35.2%,1
臺中市,大里區,1397,697,190,887,58,945,1627,58.08%,42.84%,1
臺中市,大里區,1398,780,186,966,70,1036,1912,54.18%,40.79%,1
臺中市,大里區,1399,677,182,859,78,937,1753,53.45%,38.62%,1
臺中市,大里區,1400,649,168,817,58,875,1602,54.62%,40.51%,1
臺中市,大里區,1401,460,130,590,68,658,1144,57.52%,40.21%,1
臺中市,大里區,1402,648,240,888,76,964,1655,58.25%,39.15%,1
臺中市,大里區,1403,578,183,761,45,806,1438,56.05%,40.19%,1
臺中市,大里區,1404,410,125,535,58,593,1000,59.3%,41%,1
臺中市,大里區,1405,705,174,879,80,959,1711,56.05%,41.2%,1
臺中市,大里區,1406,694,154,848,12,860,1698,50.65%,40.87%,1
臺中市,大里區,1407,712,262,974,94,1068,1914,55.8%,37.2%,1
臺中市,大里區,1408,615,182,797,31,828,1465,56.52%,41.98%,1
臺中市,大里區,1409,638,185,823,85,908,1581,57.43%,40.35%,1
臺中市,大里區,1410,632,183,815,79,894,1509,59.24%,41.88%,1
臺中市,大里區,1411,631,149,780,36,816,1570,51.97%,40.19%,1
臺中市,大里區,1412,579,192,771,50,821,1425,57.61%,40.63%,1
臺中市,大里區,1413,553,192,745,76,821,1384,59.32%,39.96%,1
臺中市,大里區,1414,382,150,532,48,580,1204,48.17%,31.73%,1
臺中市,大里區,1415,624,180,804,39,843,1761,47.87%,35.43%,1
臺中市,大里區,1416,525,139,664,37,701,1473,47.59%,35.64%,1
臺中市,大里區,1417,704,186,890,62,952,1675,56.84%,42.03%,1
臺中市,大里區,1418,758,160,918,70,988,1755,56.3%,43.19%,1
臺中市,大里區,1419,632,210,842,95,937,1593,58.82%,39.67%,1
臺中市,大里區,1420,724,201,925,75,1000,1799,55.59%,40.24%,1
臺中市,大里區,1421,647,183,830,86,916,1606,57.04%,40.29%,1
臺中市,大里區,1422,705,222,927,46,973,1875,51.89%,37.6%,1
臺中市,大里區,1423,674,214,888,66,954,1670,57.13%,40.36%,1
臺中市,大里區,1424,717,226,943,64,1007,1898,53.06%,37.78%,1
臺中市,大里區,1425,651,173,824,42,866,1679,51.58%,38.77%,1
臺中市,大里區,1426,522,157,679,71,750,1373,54.62%,38.02%,1
臺中市,大里區,1427,533,146,679,72,751,1299,57.81%,41.03%,1
臺中市,大里區,1428,595,158,753,54,807,1430,56.43%,41.61%,1
臺中市,大里區,1429,845,243,1088,50,1138,1805,63.05%,46.81%,1
臺中市,大里區,1430,881,244,1125,31,1156,1806,64.01%,48.78%,1
臺中市,大里區,1431,911,227,1138,56,1194,1826,65.39%,49.89%,1
臺中市,大里區,1432,912,219,1131,45,1176,1805,65.15%,50.53%,1
臺中市,大里區,1433,878,207,1085,64,1149,1907,60.25%,46.04%,1
臺中市,大里區,1434,541,141,682,57,739,1103,67%,49.05%,1
臺中市,大里區,1435,590,138,728,68,796,1419,56.1%,41.58%,1
臺中市,大里區,1436,552,163,715,77,792,1434,55.23%,38.49%,1
臺中市,大里區,1437,644,185,829,51,880,1875,46.93%,34.35%,1
臺中市,大里區,1438,713,240,953,54,1007,1862,54.08%,38.29%,1
臺中市,大里區,1439,750,186,936,42,978,1850,52.86%,40.54%,1
臺中市,大里區,1440,650,206,856,77,933,1622,57.52%,40.07%,1
臺中市,大里區,1441,736,205,941,71,1012,1638,61.78%,44.93%,1
臺中市,大里區,1442,688,243,931,89,1020,1633,62.46%,42.13%,1
臺中市,大里區,1443,688,205,893,42,935,1662,56.26%,41.4%,1
臺中市,大里區,1444,892,198,1090,45,1135,1917,59.21%,46.53%,1
臺中市,大里區,1445,611,200,811,85,896,1701,52.67%,35.92%,1
臺中市,大里區,1446,604,152,756,76,832,1549,53.71%,38.99%,1
臺中市,大里區,1447,666,197,863,76,939,1567,59.92%,42.5%,1
臺中市,大里區,1448,673,170,843,81,924,1614,57.25%,41.7%,1
臺中市,大里區,1449,719,216,935,101,1036,1811,57.21%,39.7%,1
臺中市,大里區,1450,160,535,695,53,748,1336,55.99%,11.98%,1
臺中市,大里區,1451,678,196,874,61,935,1759,53.16%,38.54%,1
臺中市,大里區,1452,647,202,849,90,939,1783,52.66%,36.29%,1
臺中市,大里區,1453,601,198,799,84,883,1736,50.86%,34.62%,1
臺中市,大里區,1454,780,204,984,66,1050,1874,56.03%,41.62%,1
臺中市,大里區,1455,775,221,996,71,1067,1889,56.48%,41.03%,1
臺中市,大里區,1456,744,227,971,65,1036,1947,53.21%,38.21%,1
臺中市,大里區,1457,847,217,1064,65,1129,1938,58.26%,43.7%,1
臺中市,大里區,1458,741,218,959,82,1041,1836,56.7%,40.36%,1
臺中市,大里區,1459,758,202,960,87,1047,1913,54.73%,39.62%,1
臺中市,大里區,1460,723,203,926,95,1021,1913,53.37%,37.79%,1
臺中市,大里區,1461,761,176,937,64,1001,1937,51.68%,39.29%,1
臺中市,大里區,1462,606,167,773,43,816,1508,54.11%,40.19%,1
臺中市,大里區,1463,582,162,744,33,777,1340,57.99%,43.43%,1
臺中市,大里區,1464,711,187,898,72,970,1656,58.57%,42.93%,1
臺中市,大里區,1465,521,153,674,45,719,1290,55.74%,40.39%,1
臺中市,大里區,1466,691,183,874,45,919,1655,55.53%,41.75%,1
臺中市,大里區,1467,439,141,580,28,608,1260,48.25%,34.84%,1
臺中市,大里區,1468,543,154,697,44,741,1247,59.42%,43.54%,1
臺中市,大里區,1469,594,195,789,76,865,1548,55.88%,38.37%,1
臺中市,和平區,1585,435,137,572,39,611,956,63.91%,45.5%,1
臺中市,和平區,1586,443,125,568,56,624,963,64.8%,46%,1
臺中市,和平區,1587,181,53,234,23,257,456,56.36%,39.69%,1
臺中市,和平區,1588,471,104,575,63,638,1011,63.11%,46.59%,1
臺中市,和平區,1589,283,64,347,26,373,636,58.65%,44.5%,1
臺中市,和平區,1590,97,21,118,9,127,270,47.04%,35.93%,1
臺中市,和平區,1591,282,36,318,39,357,460,77.61%,61.3%,1
臺中市,和平區,1592,181,42,223,19,242,321,75.39%,56.39%,1
臺中市,和平區,1593,367,98,465,30,495,783,63.22%,46.87%,1
臺中市,和平區,1594,150,33,183,17,200,336,59.52%,44.64%,1
臺中市,和平區,1595,238,56,294,14,308,451,68.29%,52.77%,1
臺中市,和平區,1596,140,31,171,16,187,366,51.09%,38.25%,1
臺中市,和平區,1597,265,55,320,13,333,771,43.19%,34.37%,1
臺中市,和平區,1598,228,55,283,35,318,574,55.4%,39.72%,1
臺中市,和平區,1599,117,33,150,19,169,274,61.68%,42.7%,1
臺中市,和平區,1600,63,10,73,12,85,157,54.14%,40.13%,1
臺中市,和平區,1601,267,54,321,20,341,713,47.83%,37.45%,1
臺南市,新營區,0116,556,156,712,76,788,1693,46.54%,32.84%,1
臺南市,新營區,0117,628,166,794,74,868,1561,55.61%,40.23%,1
臺南市,新營區,0118,552,189,741,61,802,1487,53.93%,37.12%,1
臺南市,新營區,0119,438,144,582,31,613,1232,49.76%,35.55%,1
臺南市,新營區,0120,379,124,503,28,531,1067,49.77%,35.52%,1
臺南市,新營區,0121,416,164,580,40,620,1419,43.69%,29.32%,1
臺南市,新營區,0122,577,155,732,29,761,1466,51.91%,39.36%,1
臺南市,新營區,0123,369,138,507,58,565,932,60.62%,39.59%,1
臺南市,新營區,0124,337,115,452,28,480,1099,43.68%,30.66%,1
臺南市,新營區,0125,246,72,318,28,346,757,45.71%,32.5%,1
臺南市,新營區,0126,346,109,455,44,499,888,56.19%,38.96%,1
臺南市,新營區,0127,373,149,522,20,542,1115,48.61%,33.45%,1
臺南市,新營區,0128,312,91,403,22,425,937,45.36%,33.3%,1
臺南市,新營區,0129,471,171,642,35,677,1387,48.81%,33.96%,1
臺南市,新營區,0130,550,145,695,56,751,1526,49.21%,36.04%,1
臺南市,新營區,0131,518,161,679,43,722,1301,55.5%,39.82%,1
臺南市,新營區,0132,655,157,812,54,866,1538,56.31%,42.59%,1
臺南市,新營區,0133,623,178,801,48,849,1584,53.6%,39.33%,1
臺南市,新營區,0134,693,162,855,41,896,1583,56.6%,43.78%,1
臺南市,新營區,0135,602,181,783,42,825,1530,53.92%,39.35%,1
臺南市,新營區,0136,460,170,630,49,679,1193,56.92%,38.56%,1
臺南市,新營區,0137,389,104,493,16,509,1439,35.37%,27.03%,1
臺南市,新營區,0138,585,165,750,53,803,1438,55.84%,40.68%,1
臺南市,新營區,0139,126,58,184,25,209,359,58.22%,35.1%,1
臺南市,新營區,0140,330,126,456,33,489,1233,39.66%,26.76%,1
臺南市,新營區,0141,374,91,465,25,490,1227,39.93%,30.48%,1
臺南市,新營區,0142,422,110,532,31,563,1320,42.65%,31.97%,1
臺南市,新營區,0143,555,175,730,30,760,1930,39.38%,28.76%,1
臺南市,新營區,0144,569,163,732,55,787,1501,52.43%,37.91%,1
臺南市,新營區,0145,546,122,668,46,714,1475,48.41%,37.02%,1
臺南市,新營區,0146,664,205,869,60,929,1753,52.99%,37.88%,1
臺南市,新營區,0147,613,182,795,48,843,1748,48.23%,35.07%,1
臺南市,新營區,0148,643,179,822,55,877,1741,50.37%,36.93%,1
臺南市,新營區,0149,488,155,643,27,670,1433,46.76%,34.05%,1
臺南市,新營區,0150,567,192,759,68,827,1595,51.85%,35.55%,1
臺南市,新營區,0151,298,78,376,21,397,959,41.4%,31.07%,1
臺南市,新營區,0152,620,189,809,76,885,1865,47.45%,33.24%,1
臺南市,新營區,0153,521,168,689,88,777,1678,46.31%,31.05%,1
臺南市,新營區,0154,421,136,557,56,613,1373,44.65%,30.66%,1
臺南市,新營區,0155,328,154,482,31,513,1431,35.85%,22.92%,1
臺南市,新營區,0156,63,26,89,4,93,291,31.96%,21.65%,1
臺南市,新營區,0157,568,224,792,48,840,1749,48.03%,32.48%,1
臺南市,新營區,0158,595,177,772,49,821,1862,44.09%,31.95%,1
臺南市,新營區,0159,700,193,893,85,978,1821,53.71%,38.44%,1
臺南市,新營區,0160,589,193,782,62,844,1845,45.75%,31.92%,1
臺南市,新營區,0161,128,48,176,12,188,542,34.69%,23.62%,1
臺南市,新營區,0162,91,38,129,5,134,402,33.33%,22.64%,1
臺南市,新營區,0163,240,93,333,77,410,703,58.32%,34.14%,1
臺南市,新營區,0164,264,110,374,43,417,941,44.31%,28.06%,1
臺南市,鹽水區,0085,360,124,484,66,550,1037,53.04%,34.72%,1
臺南市,鹽水區,0086,171,64,235,22,257,480,53.54%,35.63%,1
臺南市,鹽水區,0087,249,92,341,36,377,636,59.28%,39.15%,1
臺南市,鹽水區,0088,100,36,136,12,148,321,46.11%,31.15%,1
臺南市,鹽水區,0089,193,65,258,36,294,497,59.15%,38.83%,1
臺南市,鹽水區,0090,311,85,396,19,415,759,54.68%,40.97%,1
臺南市,鹽水區,0091,119,25,144,18,162,341,47.51%,34.9%,1
臺南市,鹽水區,0092,179,68,247,23,270,507,53.25%,35.31%,1
臺南市,鹽水區,0093,233,95,328,27,355,863,41.14%,27%,1
臺南市,鹽水區,0094,449,136,585,26,611,1373,44.5%,32.7%,1
臺南市,鹽水區,0095,524,150,674,75,749,1507,49.7%,34.77%,1
臺南市,鹽水區,0096,472,181,653,72,725,1374,52.77%,34.35%,1
臺南市,鹽水區,0097,378,127,505,58,563,1244,45.26%,30.39%,1
臺南市,鹽水區,0098,341,135,476,59,535,1022,52.35%,33.37%,1
臺南市,鹽水區,0099,190,81,271,49,320,921,34.74%,20.63%,1
臺南市,鹽水區,0100,275,133,408,49,457,847,53.96%,32.47%,1
臺南市,鹽水區,0101,153,56,209,6,215,736,29.21%,20.79%,1
臺南市,鹽水區,0102,222,96,318,16,334,761,43.89%,29.17%,1
臺南市,鹽水區,0103,93,33,126,11,137,285,48.07%,32.63%,1
臺南市,鹽水區,0104,124,63,187,39,226,493,45.84%,25.15%,1
臺南市,鹽水區,0105,144,54,198,23,221,621,35.59%,23.19%,1
臺南市,鹽水區,0106,84,26,110,14,124,392,31.63%,21.43%,1
臺南市,鹽水區,0107,276,95,371,34,405,925,43.78%,29.84%,1
臺南市,鹽水區,0108,201,73,274,35,309,728,42.45%,27.61%,1
臺南市,鹽水區,0109,43,17,60,20,80,214,37.38%,20.09%,1
臺南市,鹽水區,0110,128,33,161,13,174,387,44.96%,33.07%,1
臺南市,鹽水區,0111,90,40,130,19,149,301,49.5%,29.9%,1
臺南市,鹽水區,0112,176,74,250,35,285,755,37.75%,23.31%,1
臺南市,鹽水區,0113,82,42,124,20,144,365,39.45%,22.47%,1
臺南市,鹽水區,0114,257,96,353,36,389,935,41.6%,27.49%,1
臺南市,鹽水區,0115,126,54,180,33,213,494,43.12%,25.51%,1
臺南市,白河區,0030,386,152,538,85,623,1176,52.98%,32.82%,1
臺南市,白河區,0031,186,61,247,19,266,546,48.72%,34.07%,1
臺南市,白河區,0032,304,114,418,42,460,859,53.55%,35.39%,1
臺南市,白河區,0033,347,120,467,39,506,946,53.49%,36.68%,1
臺南市,白河區,0034,358,140,498,43,541,1116,48.48%,32.08%,1
臺南市,白河區,0035,346,118,464,33,497,1397,35.58%,24.77%,1
臺南市,白河區,0036,190,68,258,20,278,756,36.77%,25.13%,1
臺南市,白河區,0037,291,79,370,51,421,871,48.34%,33.41%,1
臺南市,白河區,0038,298,101,399,40,439,897,48.94%,33.22%,1
臺南市,白河區,0039,158,59,217,41,258,784,32.91%,20.15%,1
臺南市,白河區,0040,146,62,208,23,231,572,40.38%,25.52%,1
臺南市,白河區,0041,97,29,126,8,134,457,29.32%,21.23%,1
臺南市,白河區,0042,129,46,175,21,196,600,32.67%,21.5%,1
臺南市,白河區,0043,74,23,97,9,106,375,28.27%,19.73%,1
臺南市,白河區,0044,84,28,112,10,122,508,24.02%,16.54%,1
臺南市,白河區,0045,122,44,166,11,177,631,28.05%,19.33%,1
臺南市,白河區,0046,73,22,95,14,109,391,27.88%,18.67%,1
臺南市,白河區,0047,155,63,218,21,239,799,29.91%,19.4%,1
臺南市,白河區,0048,103,26,129,24,153,506,30.24%,20.36%,1
臺南市,白河區,0049,217,84,301,26,327,832,39.3%,26.08%,1
臺南市,白河區,0050,343,137,480,39,519,1179,44.02%,29.09%,1
臺南市,白河區,0051,154,61,215,17,232,744,31.18%,20.7%,1
臺南市,白河區,0052,170,58,228,22,250,699,35.77%,24.32%,1
臺南市,白河區,0053,137,61,198,12,210,633,33.18%,21.64%,1
臺南市,白河區,0054,268,119,387,71,458,859,53.32%,31.2%,1
臺南市,白河區,0055,241,78,319,60,379,884,42.87%,27.26%,1
臺南市,白河區,0056,104,45,149,10,159,740,21.49%,14.05%,1
臺南市,白河區,0057,377,111,488,57,545,1334,40.85%,28.26%,1
臺南市,白河區,0058,206,79,285,67,352,723,48.69%,28.49%,1
臺南市,白河區,0059,210,91,301,72,373,682,54.69%,30.79%,1
臺南市,白河區,0060,282,110,392,46,438,855,51.23%,32.98%,1
臺南市,白河區,0061,129,54,183,28,211,543,38.86%,23.76%,1
臺南市,柳營區,0165,373,124,497,64,561,1166,48.11%,31.99%,1
臺南市,柳營區,0166,214,98,312,18,330,625,52.8%,34.24%,1
臺南市,柳營區,0167,217,59,276,30,306,738,41.46%,29.4%,1
臺南市,柳營區,0168,317,95,412,19,431,834,51.68%,38.01%,1
臺南市,柳營區,0169,324,129,453,42,495,1104,44.84%,29.35%,1
臺南市,柳營區,0170,301,95,396,20,416,1015,40.99%,29.66%,1
臺南市,柳營區,0171,615,182,797,137,934,1720,54.3%,35.76%,1
臺南市,柳營區,0172,425,151,576,79,655,1391,47.09%,30.55%,1
臺南市,柳營區,0173,133,35,168,10,178,425,41.88%,31.29%,1
臺南市,柳營區,0174,76,24,100,24,124,318,38.99%,23.9%,1
臺南市,柳營區,0175,247,85,332,42,374,753,49.67%,32.8%,1
臺南市,柳營區,0176,237,63,300,44,344,730,47.12%,32.47%,1
臺南市,柳營區,0177,234,73,307,41,348,725,48%,32.28%,1
臺南市,柳營區,0178,283,104,387,37,424,787,53.88%,35.96%,1
臺南市,柳營區,0179,96,39,135,34,169,297,56.9%,32.32%,1
臺南市,柳營區,0180,247,76,323,45,368,673,54.68%,36.7%,1
臺南市,柳營區,0181,226,70,296,63,359,640,56.09%,35.31%,1
臺南市,柳營區,0182,187,64,251,29,280,660,42.42%,28.33%,1
臺南市,柳營區,0183,362,106,468,42,510,1212,42.08%,29.87%,1
臺南市,柳營區,0184,65,20,85,5,90,202,44.55%,32.18%,1
臺南市,柳營區,0185,333,86,419,85,504,1049,48.05%,31.74%,1
臺南市,柳營區,0186,51,17,68,3,71,158,44.94%,32.28%,1
臺南市,柳營區,0187,288,101,389,75,464,921,50.38%,31.27%,1
臺南市,柳營區,0188,151,35,186,21,207,504,41.07%,29.96%,1
臺南市,柳營區,0189,46,13,59,6,65,157,41.4%,29.3%,1
臺南市,後壁區,0001,256,98,354,72,426,743,57.34%,34.45%,1
臺南市,後壁區,0002,303,89,392,30,422,898,46.99%,33.74%,1
臺南市,後壁區,0003,218,85,303,60,363,786,46.18%,27.74%,1
臺南市,後壁區,0004,147,67,214,58,272,534,50.94%,27.53%,1
臺南市,後壁區,0005,329,122,451,78,529,1034,51.16%,31.82%,1
臺南市,後壁區,0006,49,34,83,23,106,232,45.69%,21.12%,1
臺南市,後壁區,0007,135,53,188,45,233,479,48.64%,28.18%,1
臺南市,後壁區,0008,251,83,334,33,367,837,43.85%,29.99%,1
臺南市,後壁區,0009,266,105,371,39,410,1085,37.79%,24.52%,1
臺南市,後壁區,0010,276,81,357,26,383,1157,33.1%,23.85%,1
臺南市,後壁區,0011,244,74,318,66,384,755,50.86%,32.32%,1
臺南市,後壁區,0012,161,49,210,36,246,458,53.71%,35.15%,1
臺南市,後壁區,0013,111,31,142,30,172,371,46.36%,29.92%,1
臺南市,後壁區,0014,187,78,265,59,324,676,47.93%,27.66%,1
臺南市,後壁區,0015,129,29,158,32,190,428,44.39%,30.14%,1
臺南市,後壁區,0016,133,49,182,12,194,547,35.47%,24.31%,1
臺南市,後壁區,0017,112,59,171,60,231,455,50.77%,24.62%,1
臺南市,後壁區,0018,237,85,322,78,400,984,40.65%,24.09%,1
臺南市,後壁區,0019,131,46,177,33,210,483,43.48%,27.12%,1
臺南市,後壁區,0020,152,38,190,33,223,536,41.6%,28.36%,1
臺南市,後壁區,0021,219,68,287,15,302,958,31.52%,22.86%,1
臺南市,後壁區,0022,167,50,217,36,253,441,57.37%,37.87%,1
臺南市,後壁區,0023,210,72,282,75,357,677,52.73%,31.02%,1
臺南市,後壁區,0024,332,98,430,88,518,996,52.01%,33.33%,1
臺南市,後壁區,0025,357,133,490,31,521,1255,41.51%,28.45%,1
臺南市,後壁區,0026,208,60,268,16,284,678,41.89%,30.68%,1
臺南市,後壁區,0027,142,46,188,8,196,553,35.44%,25.68%,1
臺南市,後壁區,0028,141,46,187,18,205,616,33.28%,22.89%,1
臺南市,後壁區,0029,358,127,485,41,526,1189,44.24%,30.11%,1
臺南市,東山區,0062,403,141,544,70,614,1401,43.83%,28.77%,1
臺南市,東山區,0063,325,92,417,43,460,1185,38.82%,27.43%,1
臺南市,東山區,0064,328,128,456,69,525,1303,40.29%,25.17%,1
臺南市,東山區,0065,194,59,253,40,293,732,40.03%,26.5%,1
臺南市,東山區,0066,167,61,228,43,271,721,37.59%,23.16%,1
臺南市,東山區,0067,233,107,340,54,394,1104,35.69%,21.11%,1
臺南市,東山區,0068,254,66,320,43,363,943,38.49%,26.94%,1
臺南市,東山區,0069,108,23,131,3,134,653,20.52%,16.54%,1
臺南市,東山區,0070,155,53,208,82,290,596,48.66%,26.01%,1
臺南市,東山區,0071,229,96,325,66,391,878,44.53%,26.08%,1
臺南市,東山區,0072,171,86,257,62,319,771,41.37%,22.18%,1
臺南市,東山區,0073,133,47,180,29,209,483,43.27%,27.54%,1
臺南市,東山區,0074,204,63,267,52,319,640,49.84%,31.88%,1
臺南市,東山區,0075,63,29,92,3,95,425,22.35%,14.82%,1
臺南市,東山區,0076,93,31,124,20,144,394,36.55%,23.6%,1
臺南市,東山區,0077,115,36,151,34,185,373,49.6%,30.83%,1
臺南市,東山區,0078,262,79,341,47,388,1257,30.87%,20.84%,1
臺南市,東山區,0079,134,53,187,7,194,887,21.87%,15.11%,1
臺南市,東山區,0080,115,30,145,14,159,658,24.16%,17.48%,1
臺南市,東山區,0081,198,74,272,34,306,1101,27.79%,17.98%,1
臺南市,東山區,0082,169,70,239,18,257,1057,24.31%,15.99%,1
臺南市,東山區,0083,193,55,248,54,302,639,47.26%,30.2%,1
臺南市,東山區,0084,66,34,100,17,117,270,43.33%,24.44%,1
臺南市,麻豆區,0381,389,153,542,53,595,1205,49.38%,32.28%,1
臺南市,麻豆區,0382,225,103,328,39,367,660,55.61%,34.09%,1
臺南市,麻豆區,0383,169,87,256,15,271,523,51.82%,32.31%,1
臺南市,麻豆區,0384,615,112,727,46,773,1597,48.4%,38.51%,1
臺南市,麻豆區,0385,473,169,642,59,701,1262,55.55%,37.48%,1
臺南市,麻豆區,0386,511,183,694,46,740,1325,55.85%,38.57%,1
臺南市,麻豆區,0387,458,163,621,32,653,1384,47.18%,33.09%,1
臺南市,麻豆區,0388,377,155,532,23,555,1121,49.51%,33.63%,1
臺南市,麻豆區,0389,304,137,441,25,466,1021,45.64%,29.77%,1
臺南市,麻豆區,0390,308,117,425,37,462,954,48.43%,32.29%,1
臺南市,麻豆區,0391,419,178,597,29,626,1513,41.37%,27.69%,1
臺南市,麻豆區,0392,495,183,678,56,734,1726,42.53%,28.68%,1
臺南市,麻豆區,0393,625,194,819,74,893,1804,49.5%,34.65%,1
臺南市,麻豆區,0394,319,138,457,38,495,1106,44.76%,28.84%,1
臺南市,麻豆區,0395,501,185,686,41,727,1503,48.37%,33.33%,1
臺南市,麻豆區,0396,452,151,603,57,660,1302,50.69%,34.72%,1
臺南市,麻豆區,0397,209,72,281,18,299,645,46.36%,32.4%,1
臺南市,麻豆區,0398,293,110,403,34,437,777,56.24%,37.71%,1
臺南市,麻豆區,0399,488,182,670,45,715,1612,44.35%,30.27%,1
臺南市,麻豆區,0400,197,83,280,17,297,718,41.36%,27.44%,1
臺南市,麻豆區,0401,456,168,624,28,652,1656,39.37%,27.54%,1
臺南市,麻豆區,0402,416,159,575,82,657,1355,48.49%,30.7%,1
臺南市,麻豆區,0403,255,76,331,32,363,977,37.15%,26.1%,1
臺南市,麻豆區,0404,292,114,406,29,435,1012,42.98%,28.85%,1
臺南市,麻豆區,0405,220,76,296,28,324,626,51.76%,35.14%,1
臺南市,麻豆區,0406,94,32,126,5,131,467,28.05%,20.13%,1
臺南市,麻豆區,0407,374,138,512,29,541,1260,42.94%,29.68%,1
臺南市,麻豆區,0408,367,142,509,46,555,1111,49.95%,33.03%,1
臺南市,麻豆區,0409,194,59,253,31,284,550,51.64%,35.27%,1
臺南市,麻豆區,0410,242,109,351,52,403,798,50.5%,30.33%,1
臺南市,麻豆區,0411,316,110,426,81,507,852,59.51%,37.09%,1
臺南市,麻豆區,0412,223,75,298,13,311,830,37.47%,26.87%,1
臺南市,麻豆區,0413,262,97,359,15,374,941,39.74%,27.84%,1
臺南市,麻豆區,0414,383,134,517,43,560,1158,48.36%,33.07%,1
臺南市,麻豆區,0415,180,69,249,11,260,612,42.48%,29.41%,1
臺南市,下營區,0343,415,145,560,55,615,1558,39.47%,26.64%,1
臺南市,下營區,0344,283,103,386,33,419,1112,37.68%,25.45%,1
臺南市,下營區,0345,277,79,356,66,422,893,47.26%,31.02%,1
臺南市,下營區,0346,417,154,571,64,635,1623,39.13%,25.69%,1
臺南市,下營區,0347,504,154,658,103,761,1568,48.53%,32.14%,1
臺南市,下營區,0348,332,112,444,60,504,985,51.17%,33.71%,1
臺南市,下營區,0349,294,79,373,21,394,953,41.34%,30.85%,1
臺南市,下營區,0350,328,100,428,30,458,1031,44.42%,31.81%,1
臺南市,下營區,0351,390,129,519,77,596,1077,55.34%,36.21%,1
臺南市,下營區,0352,166,70,236,44,280,703,39.83%,23.61%,1
臺南市,下營區,0353,238,78,316,23,339,854,39.7%,27.87%,1
臺南市,下營區,0354,375,121,496,59,555,1164,47.68%,32.22%,1
臺南市,下營區,0355,309,109,418,35,453,1091,41.52%,28.32%,1
臺南市,下營區,0356,328,98,426,63,489,959,50.99%,34.2%,1
臺南市,下營區,0357,300,92,392,35,427,935,45.67%,32.09%,1
臺南市,下營區,0358,295,101,396,51,447,893,50.06%,33.03%,1
臺南市,下營區,0359,441,138,579,93,672,1293,51.97%,34.11%,1
臺南市,下營區,0360,376,139,515,110,625,1185,52.74%,31.73%,1
臺南市,下營區,0361,256,81,337,22,359,1070,33.55%,23.93%,1
臺南市,六甲區,0362,292,109,401,62,463,819,56.53%,35.65%,1
臺南市,六甲區,0363,213,83,296,19,315,645,48.84%,33.02%,1
臺南市,六甲區,0364,429,159,588,53,641,1444,44.39%,29.71%,1
臺南市,六甲區,0365,413,164,577,53,630,1554,40.54%,26.58%,1
臺南市,六甲區,0366,329,102,431,46,477,1171,40.73%,28.1%,1
臺南市,六甲區,0367,402,166,568,77,645,1351,47.74%,29.76%,1
臺南市,六甲區,0368,277,107,384,81,465,1010,46.04%,27.43%,1
臺南市,六甲區,0369,265,104,369,63,432,919,47.01%,28.84%,1
臺南市,六甲區,0370,426,147,573,77,650,1369,47.48%,31.12%,1
臺南市,六甲區,0371,333,90,423,77,500,976,51.23%,34.12%,1
臺南市,六甲區,0372,346,140,486,59,545,1015,53.69%,34.09%,1
臺南市,六甲區,0373,344,127,471,40,511,1176,43.45%,29.25%,1
臺南市,六甲區,0374,296,126,422,58,480,939,51.12%,31.52%,1
臺南市,六甲區,0375,221,92,313,56,369,712,51.83%,31.04%,1
臺南市,六甲區,0376,302,103,405,52,457,881,51.87%,34.28%,1
臺南市,六甲區,0377,452,166,618,68,686,1184,57.94%,38.18%,1
臺南市,六甲區,0378,229,97,326,36,362,599,60.43%,38.23%,1
臺南市,六甲區,0379,155,52,207,9,216,759,28.46%,20.42%,1
臺南市,六甲區,0380,137,75,212,32,244,621,39.29%,22.06%,1
臺南市,官田區,0416,347,102,449,17,466,1104,42.21%,31.43%,1
臺南市,官田區,0417,287,131,418,56,474,965,49.12%,29.74%,1
臺南市,官田區,0418,477,150,627,49,676,1402,48.22%,34.02%,1
臺南市,官田區,0419,546,241,787,117,904,1653,54.69%,33.03%,1
臺南市,官田區,0420,258,114,372,64,436,966,45.13%,26.71%,1
臺南市,官田區,0421,72,36,108,14,122,284,42.96%,25.35%,1
臺南市,官田區,0422,79,23,102,7,109,402,27.11%,19.65%,1
臺南市,官田區,0423,313,133,446,18,464,982,47.25%,31.87%,1
臺南市,官田區,0424,264,97,361,43,404,975,41.44%,27.08%,1
臺南市,官田區,0425,245,106,351,46,397,802,49.5%,30.55%,1
臺南市,官田區,0426,405,129,534,60,594,1118,53.13%,36.23%,1
臺南市,官田區,0427,472,175,647,39,686,1455,47.15%,32.44%,1
臺南市,官田區,0428,400,149,549,38,587,1208,48.59%,33.11%,1
臺南市,官田區,0429,366,144,510,66,576,1293,44.55%,28.31%,1
臺南市,官田區,0430,151,56,207,26,233,607,38.39%,24.88%,1
臺南市,官田區,0431,148,55,203,36,239,501,47.7%,29.54%,1
臺南市,官田區,0432,237,97,334,61,395,728,54.26%,32.55%,1
臺南市,官田區,0433,235,121,356,20,376,842,44.66%,27.91%,1
臺南市,官田區,0434,160,71,231,44,275,515,53.4%,31.07%,1
臺南市,官田區,0435,227,77,304,22,326,873,37.34%,26%,1
臺南市,大內區,0436,188,79,267,55,322,759,42.42%,24.77%,1
臺南市,大內區,0437,59,22,81,3,84,262,32.06%,22.52%,1
臺南市,大內區,0438,148,41,189,18,207,646,32.04%,22.91%,1
臺南市,大內區,0439,393,113,506,76,582,1473,39.51%,26.68%,1
臺南市,大內區,0440,331,84,415,76,491,915,53.66%,36.17%,1
臺南市,大內區,0441,275,101,376,52,428,779,54.94%,35.3%,1
臺南市,大內區,0442,238,86,324,64,388,637,60.91%,37.36%,1
臺南市,大內區,0443,279,94,373,40,413,993,41.59%,28.1%,1
臺南市,大內區,0444,283,88,371,38,409,766,53.39%,36.95%,1
臺南市,大內區,0445,284,77,361,48,409,841,48.63%,33.77%,1
臺南市,大內區,0446,186,50,236,47,283,583,48.54%,31.9%,1
臺南市,佳里區,0282,500,194,694,76,770,1391,55.36%,35.95%,1
臺南市,佳里區,0283,331,111,442,37,479,829,57.78%,39.93%,1
臺南市,佳里區,0284,417,156,573,33,606,1401,43.25%,29.76%,1
臺南市,佳里區,0285,448,124,572,24,596,1452,41.05%,30.85%,1
臺南市,佳里區,0286,496,164,660,71,731,1382,52.89%,35.89%,1
臺南市,佳里區,0287,521,164,685,80,765,1463,52.29%,35.61%,1
臺南市,佳里區,0288,429,139,568,39,607,1280,47.42%,33.52%,1
臺南市,佳里區,0289,542,174,716,86,802,1486,53.97%,36.47%,1
臺南市,佳里區,0290,525,160,685,69,754,1378,54.72%,38.1%,1
臺南市,佳里區,0291,544,185,729,69,798,1505,53.02%,36.15%,1
臺南市,佳里區,0292,676,195,871,96,967,1860,51.99%,36.34%,1
臺南市,佳里區,0293,417,126,543,90,633,1134,55.82%,36.77%,1
臺南市,佳里區,0294,532,159,691,60,751,1426,52.66%,37.31%,1
臺南市,佳里區,0295,679,179,858,71,929,1779,52.22%,38.17%,1
臺南市,佳里區,0296,779,203,982,63,1045,1906,54.83%,40.87%,1
臺南市,佳里區,0297,480,165,645,60,705,1425,49.47%,33.68%,1
臺南市,佳里區,0298,446,152,598,55,653,1255,52.03%,35.54%,1
臺南市,佳里區,0299,502,161,663,83,746,1524,48.95%,32.94%,1
臺南市,佳里區,0300,595,169,764,49,813,1631,49.85%,36.48%,1
臺南市,佳里區,0301,603,209,812,49,861,1546,55.69%,39%,1
臺南市,佳里區,0302,493,160,653,47,700,1187,58.97%,41.53%,1
臺南市,佳里區,0303,495,163,658,48,706,1381,51.12%,35.84%,1
臺南市,佳里區,0304,497,132,629,22,651,1364,47.73%,36.44%,1
臺南市,佳里區,0305,491,149,640,36,676,1314,51.45%,37.37%,1
臺南市,佳里區,0306,421,145,566,69,635,1164,54.55%,36.17%,1
臺南市,佳里區,0307,336,116,452,60,512,961,53.28%,34.96%,1
臺南市,佳里區,0308,394,135,529,56,585,1218,48.03%,32.35%,1
臺南市,佳里區,0309,320,118,438,28,466,919,50.71%,34.82%,1
臺南市,佳里區,0310,246,74,320,29,349,689,50.65%,35.7%,1
臺南市,佳里區,0311,104,50,154,13,167,383,43.6%,27.15%,1
臺南市,佳里區,0312,511,143,654,64,718,1507,47.64%,33.91%,1
臺南市,佳里區,0313,220,73,293,51,344,702,49%,31.34%,1
臺南市,佳里區,0314,331,103,434,49,483,907,53.25%,36.49%,1
臺南市,佳里區,0315,356,138,494,58,552,937,58.91%,37.99%,1
臺南市,佳里區,0316,325,122,447,96,543,1030,52.72%,31.55%,1
臺南市,佳里區,0317,326,124,450,53,503,981,51.27%,33.23%,1
臺南市,佳里區,0318,246,79,325,25,350,787,44.47%,31.26%,1
臺南市,佳里區,0319,519,156,675,84,759,1513,50.17%,34.3%,1
臺南市,佳里區,0320,196,69,265,22,287,714,40.2%,27.45%,1
臺南市,佳里區,0321,224,92,316,50,366,745,49.13%,30.07%,1
臺南市,佳里區,0322,285,103,388,29,417,951,43.85%,29.97%,1
臺南市,學甲區,0208,282,137,419,61,480,862,55.68%,32.71%,1
臺南市,學甲區,0209,220,99,319,12,331,611,54.17%,36.01%,1
臺南市,學甲區,0210,321,121,442,30,472,936,50.43%,34.29%,1
臺南市,學甲區,0211,311,149,460,40,500,1066,46.9%,29.17%,1
臺南市,學甲區,0212,318,127,445,33,478,869,55.01%,36.59%,1
臺南市,學甲區,0213,224,63,287,37,324,635,51.02%,35.28%,1
臺南市,學甲區,0214,273,70,343,23,366,822,44.53%,33.21%,1
臺南市,學甲區,0215,125,41,166,19,185,443,41.76%,28.22%,1
臺南市,學甲區,0216,498,149,647,37,684,1370,49.93%,36.35%,1
臺南市,學甲區,0217,414,128,542,60,602,1117,53.89%,37.06%,1
臺南市,學甲區,0218,444,148,592,86,678,1365,49.67%,32.53%,1
臺南市,學甲區,0219,472,159,631,80,711,1489,47.75%,31.7%,1
臺南市,學甲區,0220,145,64,209,43,252,627,40.19%,23.13%,1
臺南市,學甲區,0221,345,135,480,23,503,1052,47.81%,32.79%,1
臺南市,學甲區,0222,398,117,515,29,544,1183,45.98%,33.64%,1
臺南市,學甲區,0223,274,81,355,36,391,979,39.94%,27.99%,1
臺南市,學甲區,0224,339,145,484,69,553,1241,44.56%,27.32%,1
臺南市,學甲區,0225,225,62,287,28,315,843,37.37%,26.69%,1
臺南市,學甲區,0226,176,60,236,43,279,580,48.1%,30.34%,1
臺南市,學甲區,0227,199,67,266,24,290,832,34.86%,23.92%,1
臺南市,學甲區,0228,84,50,134,10,144,406,35.47%,20.69%,1
臺南市,學甲區,0229,286,105,391,33,424,818,51.83%,34.96%,1
臺南市,學甲區,0230,261,98,359,19,378,1052,35.93%,24.81%,1
臺南市,學甲區,0231,145,66,211,16,227,578,39.27%,25.09%,1
臺南市,學甲區,0232,103,43,146,21,167,430,38.84%,23.95%,1
臺南市,學甲區,0233,125,24,149,14,163,361,45.15%,34.63%,1
臺南市,西港區,0323,331,97,428,13,441,933,47.27%,35.48%,1
臺南市,西港區,0324,301,133,434,23,457,901,50.72%,33.41%,1
臺南市,西港區,0325,415,138,553,31,584,1314,44.44%,31.58%,1
臺南市,西港區,0326,465,149,614,78,692,1349,51.3%,34.47%,1
臺南市,西港區,0327,360,142,502,56,558,1014,55.03%,35.5%,1
臺南市,西港區,0328,494,178,672,29,701,1900,36.89%,26%,1
臺南市,西港區,0329,499,159,658,61,719,1663,43.24%,30.01%,1
臺南市,西港區,0330,199,81,280,13,293,738,39.7%,26.96%,1
臺南市,西港區,0331,452,130,582,64,646,1211,53.34%,37.32%,1
臺南市,西港區,0332,112,40,152,27,179,382,46.86%,29.32%,1
臺南市,西港區,0333,227,81,308,15,323,786,41.09%,28.88%,1
臺南市,西港區,0334,267,80,347,14,361,838,43.08%,31.86%,1
臺南市,西港區,0335,378,140,518,47,565,1449,38.99%,26.09%,1
臺南市,西港區,0336,388,131,519,32,551,1479,37.25%,26.23%,1
臺南市,西港區,0337,263,80,343,76,419,763,54.91%,34.47%,1
臺南市,西港區,0338,380,113,493,27,520,1297,40.09%,29.3%,1
臺南市,西港區,0339,517,43,560,38,598,1393,42.93%,37.11%,1
臺南市,西港區,0340,235,97,332,19,351,958,36.64%,24.53%,1
臺南市,西港區,0341,142,37,179,21,200,391,51.15%,36.32%,1
臺南市,西港區,0342,291,73,364,55,419,805,52.05%,36.15%,1
臺南市,七股區,0258,153,54,207,16,223,534,41.76%,28.65%,1
臺南市,七股區,0259,171,61,232,20,252,508,49.61%,33.66%,1
臺南市,七股區,0260,150,40,190,10,200,665,30.08%,22.56%,1
臺南市,七股區,0261,245,58,303,30,333,834,39.93%,29.38%,1
臺南市,七股區,0262,202,75,277,16,293,810,36.17%,24.94%,1
臺南市,七股區,0263,98,38,136,14,150,480,31.25%,20.42%,1
臺南市,七股區,0264,110,34,144,9,153,445,34.38%,24.72%,1
臺南市,七股區,0265,117,45,162,16,178,680,26.18%,17.21%,1
臺南市,七股區,0266,169,65,234,11,245,838,29.24%,20.17%,1
臺南市,七股區,0267,168,54,222,25,247,780,31.67%,21.54%,1
臺南市,七股區,0268,118,45,163,19,182,350,52%,33.71%,1
臺南市,七股區,0269,325,114,439,98,537,907,59.21%,35.83%,1
臺南市,七股區,0270,226,63,289,22,311,780,39.87%,28.97%,1
臺南市,七股區,0271,493,135,628,43,671,1658,40.47%,29.73%,1
臺南市,七股區,0272,267,75,342,35,377,913,41.29%,29.24%,1
臺南市,七股區,0273,390,129,519,70,589,1202,49%,32.45%,1
臺南市,七股區,0274,185,40,225,12,237,696,34.05%,26.58%,1
臺南市,七股區,0275,190,73,263,39,302,647,46.68%,29.37%,1
臺南市,七股區,0276,242,76,318,67,385,622,61.9%,38.91%,1
臺南市,七股區,0277,437,128,565,100,665,1175,56.6%,37.19%,1
臺南市,七股區,0278,198,76,274,25,299,698,42.84%,28.37%,1
臺南市,七股區,0279,315,114,429,81,510,983,51.88%,32.04%,1
臺南市,七股區,0280,322,123,445,36,481,1366,35.21%,23.57%,1
臺南市,七股區,0281,384,132,516,85,601,1379,43.58%,27.85%,1
臺南市,將軍區,0234,413,143,556,68,624,1110,56.22%,37.21%,1
臺南市,將軍區,0235,469,121,590,27,617,1418,43.51%,33.07%,1
臺南市,將軍區,0236,287,103,390,31,421,969,43.45%,29.62%,1
臺南市,將軍區,0237,192,61,253,46,299,519,57.61%,36.99%,1
臺南市,將軍區,0238,354,101,455,23,478,1106,43.22%,32.01%,1
臺南市,將軍區,0239,159,68,227,40,267,542,49.26%,29.34%,1
臺南市,將軍區,0240,75,28,103,13,116,315,36.83%,23.81%,1
臺南市,將軍區,0241,158,45,203,31,234,584,40.07%,27.05%,1
臺南市,將軍區,0242,127,37,164,8,172,398,43.22%,31.91%,1
臺南市,將軍區,0243,153,51,204,17,221,608,36.35%,25.16%,1
臺南市,將軍區,0244,143,50,193,22,215,442,48.64%,32.35%,1
臺南市,將軍區,0245,146,56,202,13,215,650,33.08%,22.46%,1
臺南市,將軍區,0246,129,35,164,18,182,573,31.76%,22.51%,1
臺南市,將軍區,0247,148,46,194,10,204,617,33.06%,23.99%,1
臺南市,將軍區,0248,188,49,237,32,269,573,46.95%,32.81%,1
臺南市,將軍區,0249,129,52,181,31,212,434,48.85%,29.72%,1
臺南市,將軍區,0250,205,82,287,15,302,849,35.57%,24.15%,1
臺南市,將軍區,0251,166,54,220,33,253,645,39.22%,25.74%,1
臺南市,將軍區,0252,158,55,213,30,243,690,35.22%,22.9%,1
臺南市,將軍區,0253,129,43,172,10,182,663,27.45%,19.46%,1
臺南市,將軍區,0254,262,103,365,32,397,1175,33.79%,22.3%,1
臺南市,將軍區,0255,184,58,242,31,273,837,32.62%,21.98%,1
臺南市,將軍區,0256,311,106,417,138,555,1061,52.31%,29.31%,1
臺南市,將軍區,0257,211,66,277,24,301,976,30.84%,21.62%,1
臺南市,北門區,0190,131,54,185,12,197,484,40.7%,27.07%,1
臺南市,北門區,0191,120,25,145,18,163,401,40.65%,29.93%,1
臺南市,北門區,0192,118,27,145,7,152,456,33.33%,25.88%,1
臺南市,北門區,0193,141,37,178,21,199,382,52.09%,36.91%,1
臺南市,北門區,0194,102,42,144,32,176,356,49.44%,28.65%,1
臺南市,北門區,0195,91,39,130,6,136,389,34.96%,23.39%,1
臺南市,北門區,0196,217,59,276,11,287,742,38.68%,29.25%,1
臺南市,北門區,0197,166,46,212,16,228,599,38.06%,27.71%,1
臺南市,北門區,0198,159,58,217,26,243,594,40.91%,26.77%,1
臺南市,北門區,0199,161,53,214,30,244,572,42.66%,28.15%,1
臺南市,北門區,0200,62,21,83,9,92,318,28.93%,19.5%,1
臺南市,北門區,0201,109,49,158,16,174,473,36.79%,23.04%,1
臺南市,北門區,0202,200,63,263,15,278,954,29.14%,20.96%,1
臺南市,北門區,0203,277,70,347,40,387,737,52.51%,37.58%,1
臺南市,北門區,0204,154,48,202,14,216,679,31.81%,22.68%,1
臺南市,北門區,0205,113,47,160,37,197,521,37.81%,21.69%,1
臺南市,北門區,0206,144,45,189,18,207,632,32.75%,22.78%,1
臺南市,北門區,0207,148,46,194,15,209,636,32.86%,23.27%,1
臺南市,新化區,0581,327,76,403,49,452,746,60.59%,43.83%,1
臺南市,新化區,0582,438,50,488,161,649,1102,58.89%,39.75%,1
臺南市,新化區,0583,148,44,192,22,214,370,57.84%,40%,1
臺南市,新化區,0584,366,124,490,77,567,947,59.87%,38.65%,1
臺南市,新化區,0585,414,129,543,66,609,1154,52.77%,35.88%,1
臺南市,新化區,0586,401,132,533,74,607,1082,56.1%,37.06%,1
臺南市,新化區,0587,425,118,543,68,611,1075,56.84%,39.53%,1
臺南市,新化區,0588,233,76,309,28,337,640,52.66%,36.41%,1
臺南市,新化區,0589,129,48,177,23,200,410,48.78%,31.46%,1
臺南市,新化區,0590,188,52,240,30,270,533,50.66%,35.27%,1
臺南市,新化區,0591,288,112,400,29,429,836,51.32%,34.45%,1
臺南市,新化區,0592,290,95,385,33,418,978,42.74%,29.65%,1
臺南市,新化區,0593,473,185,658,53,711,1348,52.74%,35.09%,1
臺南市,新化區,0594,363,117,480,53,533,1015,52.51%,35.76%,1
臺南市,新化區,0595,405,116,521,34,555,1228,45.2%,32.98%,1
臺南市,新化區,0596,290,109,399,52,451,789,57.16%,36.76%,1
臺南市,新化區,0597,333,139,472,30,502,1022,49.12%,32.58%,1
臺南市,新化區,0598,340,115,455,23,478,1021,46.82%,33.3%,1
臺南市,新化區,0599,480,159,639,67,706,1229,57.45%,39.06%,1
臺南市,新化區,0600,412,133,545,29,574,1153,49.78%,35.73%,1
臺南市,新化區,0601,271,101,372,28,400,1012,39.53%,26.78%,1
臺南市,新化區,0602,538,175,713,80,793,1458,54.39%,36.9%,1
臺南市,新化區,0603,623,211,834,73,907,1645,55.14%,37.87%,1
臺南市,新化區,0604,383,138,521,63,584,1016,57.48%,37.7%,1
臺南市,新化區,0605,191,62,253,13,266,559,47.58%,34.17%,1
臺南市,新化區,0606,488,151,639,37,676,1222,55.32%,39.93%,1
臺南市,新化區,0607,635,214,849,66,915,1562,58.58%,40.65%,1
臺南市,新化區,0608,296,114,410,38,448,994,45.07%,29.78%,1
臺南市,新化區,0609,364,106,470,99,569,1013,56.17%,35.93%,1
臺南市,新化區,0610,432,157,589,82,671,1197,56.06%,36.09%,1
臺南市,新化區,0611,323,126,449,58,507,1021,49.66%,31.64%,1
臺南市,新化區,0612,431,135,566,80,646,1428,45.24%,30.18%,1
臺南市,新化區,0613,131,51,182,33,215,456,47.15%,28.73%,1
臺南市,新化區,0614,389,129,518,58,576,1037,55.54%,37.51%,1
臺南市,新化區,0615,397,123,520,92,612,1097,55.79%,36.19%,1
臺南市,新化區,0616,320,119,439,58,497,902,55.1%,35.48%,1
臺南市,新化區,0617,303,108,411,99,510,999,51.05%,30.33%,1
臺南市,善化區,0492,332,127,459,33,492,1132,43.46%,29.33%,1
臺南市,善化區,0493,617,209,826,75,901,1845,48.83%,33.44%,1
臺南市,善化區,0494,697,243,940,108,1048,2090,50.14%,33.35%,1
臺南市,善化區,0495,607,173,780,91,871,1582,55.06%,38.37%,1
臺南市,善化區,0496,693,262,955,88,1043,1901,54.87%,36.45%,1
臺南市,善化區,0497,633,246,879,63,942,1818,51.82%,34.82%,1
臺南市,善化區,0498,588,191,779,79,858,1639,52.35%,35.88%,1
臺南市,善化區,0499,403,150,553,41,594,1061,55.98%,37.98%,1
臺南市,善化區,0500,652,219,871,110,981,1786,54.93%,36.51%,1
臺南市,善化區,0501,409,130,539,40,579,1147,50.48%,35.66%,1
臺南市,善化區,0502,503,205,708,80,788,1581,49.84%,31.82%,1
臺南市,善化區,0503,364,174,538,115,653,1240,52.66%,29.35%,1
臺南市,善化區,0504,453,148,601,35,636,1743,36.49%,25.99%,1
臺南市,善化區,0505,446,183,629,66,695,1246,55.78%,35.79%,1
臺南市,善化區,0506,298,131,429,29,458,961,47.66%,31.01%,1
臺南市,善化區,0507,300,107,407,15,422,938,44.99%,31.98%,1
臺南市,善化區,0508,242,93,335,18,353,722,48.89%,33.52%,1
臺南市,善化區,0509,320,105,425,24,449,1062,42.28%,30.13%,1
臺南市,善化區,0510,596,175,771,95,866,1715,50.5%,34.75%,1
臺南市,善化區,0511,368,114,482,54,536,1120,47.86%,32.86%,1
臺南市,善化區,0512,254,120,374,55,429,865,49.6%,29.36%,1
臺南市,善化區,0513,525,214,739,77,816,1574,51.84%,33.35%,1
臺南市,善化區,0514,446,182,628,63,691,1535,45.02%,29.06%,1
臺南市,善化區,0515,353,154,507,71,578,1106,52.26%,31.92%,1
臺南市,善化區,0516,432,163,595,53,648,1402,46.22%,30.81%,1
臺南市,善化區,0517,554,221,775,93,868,1458,59.53%,38%,1
臺南市,善化區,0518,428,155,583,52,635,1380,46.01%,31.01%,1
臺南市,善化區,0519,468,157,625,17,642,1232,52.11%,37.99%,1
臺南市,善化區,0520,410,150,560,14,574,1069,53.7%,38.35%,1
臺南市,新市區,0545,308,106,414,36,450,960,46.88%,32.08%,1
臺南市,新市區,0546,434,163,597,53,650,1118,58.14%,38.82%,1
臺南市,新市區,0547,283,99,382,32,414,850,48.71%,33.29%,1
臺南市,新市區,0548,463,126,589,72,661,1241,53.26%,37.31%,1
臺南市,新市區,0549,482,171,653,47,700,1297,53.97%,37.16%,1
臺南市,新市區,0550,395,95,490,50,540,962,56.13%,41.06%,1
臺南市,新市區,0551,463,172,635,62,697,1237,56.35%,37.43%,1
臺南市,新市區,0552,470,189,659,52,711,1326,53.62%,35.44%,1
臺南市,新市區,0553,472,155,627,68,695,1211,57.39%,38.98%,1
臺南市,新市區,0554,430,178,608,47,655,1305,50.19%,32.95%,1
臺南市,新市區,0555,237,74,311,65,376,688,54.65%,34.45%,1
臺南市,新市區,0556,328,146,474,38,512,911,56.2%,36%,1
臺南市,新市區,0557,474,190,664,53,717,1525,47.02%,31.08%,1
臺南市,新市區,0558,321,89,410,5,415,1091,38.04%,29.42%,1
臺南市,新市區,0559,406,126,532,31,563,1122,50.18%,36.19%,1
臺南市,新市區,0560,340,126,466,34,500,1049,47.66%,32.41%,1
臺南市,新市區,0561,451,174,625,25,650,1564,41.56%,28.84%,1
臺南市,新市區,0562,563,183,746,62,808,1515,53.33%,37.16%,1
臺南市,新市區,0563,453,180,633,34,667,1378,48.4%,32.87%,1
臺南市,新市區,0564,326,128,454,60,514,827,62.15%,39.42%,1
臺南市,新市區,0565,390,127,517,92,609,960,63.44%,40.63%,1
臺南市,新市區,0566,325,106,431,68,499,951,52.47%,34.17%,1
臺南市,新市區,0567,442,177,619,77,696,1264,55.06%,34.97%,1
臺南市,新市區,0568,416,140,556,38,594,1173,50.64%,35.46%,1
臺南市,新市區,0569,243,114,357,26,383,684,55.99%,35.53%,1
臺南市,新市區,0570,421,148,569,78,647,1055,61.33%,39.91%,1
臺南市,新市區,0571,457,175,632,52,684,1122,60.96%,40.73%,1
臺南市,安定區,0521,486,187,673,94,767,1251,61.31%,38.85%,1
臺南市,安定區,0522,322,105,427,44,471,899,52.39%,35.82%,1
臺南市,安定區,0523,383,132,515,87,602,1106,54.43%,34.63%,1
臺南市,安定區,0524,340,125,465,60,525,948,55.38%,35.86%,1
臺南市,安定區,0525,462,166,628,38,666,1442,46.19%,32.04%,1
臺南市,安定區,0526,417,172,589,53,642,1385,46.35%,30.11%,1
臺南市,安定區,0527,311,93,404,54,458,801,57.18%,38.83%,1
臺南市,安定區,0528,210,85,295,38,333,736,45.24%,28.53%,1
臺南市,安定區,0529,275,87,362,39,401,781,51.34%,35.21%,1
臺南市,安定區,0530,281,111,392,22,414,795,52.08%,35.35%,1
臺南市,安定區,0531,340,106,446,58,504,862,58.47%,39.44%,1
臺南市,安定區,0532,495,162,657,38,695,1487,46.74%,33.29%,1
臺南市,安定區,0533,484,152,636,36,672,1385,48.52%,34.95%,1
臺南市,安定區,0534,443,189,632,40,672,1518,44.27%,29.18%,1
臺南市,安定區,0535,441,134,575,61,636,1094,58.14%,40.31%,1
臺南市,安定區,0536,554,215,769,116,885,1590,55.66%,34.84%,1
臺南市,安定區,0537,272,105,377,41,418,754,55.44%,36.07%,1
臺南市,安定區,0538,258,90,348,52,400,716,55.87%,36.03%,1
臺南市,安定區,0539,548,195,743,66,809,1492,54.22%,36.73%,1
臺南市,安定區,0540,329,126,455,57,512,943,54.29%,34.89%,1
臺南市,安定區,0541,412,132,544,32,576,1157,49.78%,35.61%,1
臺南市,安定區,0542,466,168,634,133,767,1384,55.42%,33.67%,1
臺南市,安定區,0543,330,125,455,65,520,967,53.77%,34.13%,1
臺南市,安定區,0544,223,65,288,35,323,611,52.86%,36.5%,1
臺南市,山上區,0572,210,78,288,70,358,855,41.87%,24.56%,1
臺南市,山上區,0573,201,68,269,47,316,836,37.8%,24.04%,1
臺南市,山上區,0574,235,84,319,46,365,753,48.47%,31.21%,1
臺南市,山上區,0575,246,84,330,41,371,788,47.08%,31.22%,1
臺南市,山上區,0576,335,109,444,45,489,984,49.7%,34.04%,1
臺南市,山上區,0577,268,102,370,12,382,972,39.3%,27.57%,1
臺南市,山上區,0578,122,31,153,6,159,553,28.75%,22.06%,1
臺南市,山上區,0579,102,32,134,7,141,378,37.3%,26.98%,1
臺南市,山上區,0580,105,47,152,28,180,392,45.92%,26.79%,1
臺南市,玉井區,0466,432,116,548,27,575,1242,46.3%,34.78%,1
臺南市,玉井區,0467,434,100,534,54,588,1141,51.53%,38.04%,1
臺南市,玉井區,0468,212,80,292,30,322,698,46.13%,30.37%,1
臺南市,玉井區,0469,280,97,377,27,404,849,47.59%,32.98%,1
臺南市,玉井區,0470,361,92,453,54,507,949,53.42%,38.04%,1
臺南市,玉井區,0471,214,61,275,26,301,618,48.71%,34.63%,1
臺南市,玉井區,0472,168,50,218,11,229,594,38.55%,28.28%,1
臺南市,玉井區,0473,282,76,358,16,374,927,40.35%,30.42%,1
臺南市,玉井區,0474,167,55,222,49,271,512,52.93%,32.62%,1
臺南市,玉井區,0475,161,52,213,29,242,509,47.54%,31.63%,1
臺南市,玉井區,0476,172,58,230,30,260,496,52.42%,34.68%,1
臺南市,玉井區,0477,222,81,303,15,318,759,41.9%,29.25%,1
臺南市,玉井區,0478,176,50,226,12,238,669,35.58%,26.31%,1
臺南市,玉井區,0479,239,71,310,71,381,787,48.41%,30.37%,1
臺南市,玉井區,0480,166,71,237,45,282,620,45.48%,26.77%,1
臺南市,玉井區,0481,355,94,449,53,502,987,50.86%,35.97%,1
臺南市,楠西區,0447,308,103,411,65,476,978,48.67%,31.49%,1
臺南市,楠西區,0448,320,109,429,44,473,870,54.37%,36.78%,1
臺南市,楠西區,0449,244,79,323,15,338,1160,29.14%,21.03%,1
臺南市,楠西區,0450,187,63,250,32,282,699,40.34%,26.75%,1
臺南市,楠西區,0451,251,63,314,20,334,990,33.74%,25.35%,1
臺南市,楠西區,0452,282,72,354,39,393,928,42.35%,30.39%,1
臺南市,楠西區,0453,223,41,264,48,312,660,47.27%,33.79%,1
臺南市,楠西區,0454,377,115,492,82,574,1187,48.36%,31.76%,1
臺南市,楠西區,0455,342,100,442,35,477,1056,45.17%,32.39%,1
臺南市,南化區,0456,238,80,318,49,367,690,53.19%,34.49%,1
臺南市,南化區,0457,240,84,324,57,381,695,54.82%,34.53%,1
臺南市,南化區,0458,236,83,319,37,356,806,44.17%,29.28%,1
臺南市,南化區,0459,177,48,225,44,269,654,41.13%,27.06%,1
臺南市,南化區,0460,187,56,243,39,282,783,36.02%,23.88%,1
臺南市,南化區,0461,132,51,183,22,205,425,48.24%,31.06%,1
臺南市,南化區,0462,185,53,238,36,274,559,49.02%,33.09%,1
臺南市,南化區,0463,330,106,436,31,467,1189,39.28%,27.75%,1
臺南市,南化區,0464,371,118,489,34,523,1044,50.1%,35.54%,1
臺南市,南化區,0465,356,104,460,28,488,941,51.86%,37.83%,1
臺南市,左鎮區,0482,119,38,157,32,189,392,48.21%,30.36%,1
臺南市,左鎮區,0483,226,54,280,55,335,644,52.02%,35.09%,1
臺南市,左鎮區,0484,131,36,167,16,183,468,39.1%,27.99%,1
臺南市,左鎮區,0485,187,81,268,44,312,753,41.43%,24.83%,1
臺南市,左鎮區,0486,97,33,130,27,157,345,45.51%,28.12%,1
臺南市,左鎮區,0487,114,32,146,18,164,393,41.73%,29.01%,1
臺南市,左鎮區,0488,118,40,158,17,175,420,41.67%,28.1%,1
臺南市,左鎮區,0489,74,27,101,13,114,313,36.42%,23.64%,1
臺南市,左鎮區,0490,43,18,61,3,64,186,34.41%,23.12%,1
臺南市,左鎮區,0491,110,53,163,55,218,504,43.25%,21.83%,1
臺南市,仁德區,1188,464,166,630,89,719,1318,54.55%,35.2%,1
臺南市,仁德區,1189,534,153,687,82,769,1406,54.69%,37.98%,1
臺南市,仁德區,1190,495,165,660,104,764,1465,52.15%,33.79%,1
臺南市,仁德區,1191,455,179,634,82,716,1192,60.07%,38.17%,1
臺南市,仁德區,1192,561,188,749,73,822,1429,57.52%,39.26%,1
臺南市,仁德區,1193,420,165,585,138,723,1320,54.77%,31.82%,1
臺南市,仁德區,1194,564,147,711,112,823,1373,59.94%,41.08%,1
臺南市,仁德區,1195,505,177,682,76,758,1330,56.99%,37.97%,1
臺南市,仁德區,1196,677,203,880,36,916,1687,54.3%,40.13%,1
臺南市,仁德區,1197,500,186,686,68,754,1491,50.57%,33.53%,1
臺南市,仁德區,1198,364,129,493,45,538,1151,46.74%,31.62%,1
臺南市,仁德區,1199,556,125,681,34,715,1407,50.82%,39.52%,1
臺南市,仁德區,1200,594,166,760,66,826,1465,56.38%,40.55%,1
臺南市,仁德區,1201,507,184,691,57,748,1335,56.03%,37.98%,1
臺南市,仁德區,1202,535,177,712,69,781,1490,52.42%,35.91%,1
臺南市,仁德區,1203,583,202,785,67,852,1453,58.64%,40.12%,1
臺南市,仁德區,1204,329,122,451,31,482,990,48.69%,33.23%,1
臺南市,仁德區,1205,598,210,808,75,883,1573,56.13%,38.02%,1
臺南市,仁德區,1206,371,123,494,70,564,1031,54.7%,35.98%,1
臺南市,仁德區,1207,407,172,579,40,619,1194,51.84%,34.09%,1
臺南市,仁德區,1208,455,137,592,57,649,1268,51.18%,35.88%,1
臺南市,仁德區,1209,311,150,461,47,508,929,54.68%,33.48%,1
臺南市,仁德區,1210,379,106,485,23,508,1145,44.37%,33.1%,1
臺南市,仁德區,1211,463,173,636,69,705,1413,49.89%,32.77%,1
臺南市,仁德區,1212,491,184,675,109,784,1465,53.52%,33.52%,1
臺南市,仁德區,1213,538,197,735,60,795,1390,57.19%,38.71%,1
臺南市,仁德區,1214,492,190,682,79,761,1396,54.51%,35.24%,1
臺南市,仁德區,1215,687,237,924,68,992,1906,52.05%,36.04%,1
臺南市,仁德區,1216,555,172,727,45,772,1546,49.94%,35.9%,1
臺南市,仁德區,1217,462,165,627,41,668,1546,43.21%,29.88%,1
臺南市,仁德區,1218,530,149,679,62,741,1399,52.97%,37.88%,1
臺南市,仁德區,1219,617,190,807,114,921,1748,52.69%,35.3%,1
臺南市,仁德區,1220,458,138,596,44,640,1140,56.14%,40.18%,1
臺南市,仁德區,1221,431,136,567,31,598,1277,46.83%,33.75%,1
臺南市,仁德區,1222,446,138,584,57,641,1019,62.9%,43.77%,1
臺南市,仁德區,1223,450,151,601,49,650,1414,45.97%,31.82%,1
臺南市,仁德區,1224,425,142,567,36,603,1349,44.7%,31.5%,1
臺南市,仁德區,1225,494,167,661,41,702,1471,47.72%,33.58%,1
臺南市,仁德區,1226,476,142,618,28,646,1324,48.79%,35.95%,1
臺南市,仁德區,1227,470,104,574,54,628,1310,47.94%,35.88%,1
臺南市,仁德區,1228,207,76,283,28,311,554,56.14%,37.36%,1
臺南市,仁德區,1229,590,105,695,53,748,1395,53.62%,42.29%,1
臺南市,仁德區,1230,486,107,593,22,615,1264,48.66%,38.45%,1
臺南市,仁德區,1231,391,122,513,101,614,1180,52.03%,33.14%,1
臺南市,仁德區,1232,270,92,362,44,406,928,43.75%,29.09%,1
臺南市,仁德區,1233,286,100,386,31,417,965,43.21%,29.64%,1
臺南市,仁德區,1234,352,114,466,35,501,1119,44.77%,31.46%,1
臺南市,仁德區,1235,430,128,558,88,646,1206,53.57%,35.66%,1
臺南市,仁德區,1236,424,154,578,63,641,1466,43.72%,28.92%,1
臺南市,歸仁區,1237,539,176,715,79,794,1560,50.9%,34.55%,1
臺南市,歸仁區,1238,537,222,759,75,834,1383,60.3%,38.83%,1
臺南市,歸仁區,1239,528,191,719,48,767,1491,51.44%,35.41%,1
臺南市,歸仁區,1240,458,187,645,78,723,1482,48.79%,30.9%,1
臺南市,歸仁區,1241,472,166,638,36,674,1330,50.68%,35.49%,1
臺南市,歸仁區,1242,538,192,730,52,782,1399,55.9%,38.46%,1
臺南市,歸仁區,1243,479,163,642,33,675,1416,47.67%,33.83%,1
臺南市,歸仁區,1244,368,147,515,44,559,1336,41.84%,27.54%,1
臺南市,歸仁區,1245,371,135,506,79,585,1183,49.45%,31.36%,1
臺南市,歸仁區,1246,395,137,532,28,560,1237,45.27%,31.93%,1
臺南市,歸仁區,1247,414,146,560,74,634,1133,55.96%,36.54%,1
臺南市,歸仁區,1248,393,132,525,45,570,1149,49.61%,34.2%,1
臺南市,歸仁區,1249,397,151,548,8,556,1105,50.32%,35.93%,1
臺南市,歸仁區,1250,388,150,538,62,600,1099,54.6%,35.3%,1
臺南市,歸仁區,1251,403,151,554,75,629,1082,58.13%,37.25%,1
臺南市,歸仁區,1252,550,184,734,54,788,1519,51.88%,36.21%,1
臺南市,歸仁區,1253,565,194,759,78,837,1467,57.06%,38.51%,1
臺南市,歸仁區,1254,372,148,520,50,570,1090,52.29%,34.13%,1
臺南市,歸仁區,1255,393,115,508,39,547,1131,48.36%,34.75%,1
臺南市,歸仁區,1256,370,103,473,36,509,1080,47.13%,34.26%,1
臺南市,歸仁區,1257,355,106,461,26,487,1121,43.44%,31.67%,1
臺南市,歸仁區,1258,461,165,626,94,720,1336,53.89%,34.51%,1
臺南市,歸仁區,1259,385,156,541,73,614,1128,54.43%,34.13%,1
臺南市,歸仁區,1260,361,135,496,31,527,1055,49.95%,34.22%,1
臺南市,歸仁區,1261,407,131,538,39,577,1102,52.36%,36.93%,1
臺南市,歸仁區,1262,405,125,530,49,579,1068,54.21%,37.92%,1
臺南市,歸仁區,1263,367,151,518,74,592,1033,57.31%,35.53%,1
臺南市,歸仁區,1264,490,145,635,34,669,1772,37.75%,27.65%,1
臺南市,歸仁區,1265,498,188,686,77,763,1399,54.54%,35.6%,1
臺南市,歸仁區,1266,551,183,734,31,765,1544,49.55%,35.69%,1
臺南市,歸仁區,1267,185,92,277,11,288,684,42.11%,27.05%,1
臺南市,歸仁區,1268,313,129,442,45,487,839,58.05%,37.31%,1
臺南市,歸仁區,1269,373,144,517,66,583,1014,57.5%,36.79%,1
臺南市,歸仁區,1270,487,167,654,38,692,1906,36.31%,25.55%,1
臺南市,歸仁區,1271,467,164,631,79,710,1245,57.03%,37.51%,1
臺南市,歸仁區,1272,377,137,514,42,556,1048,53.05%,35.97%,1
臺南市,歸仁區,1273,402,135,537,27,564,1175,48%,34.21%,1
臺南市,歸仁區,1274,441,156,597,39,636,1411,45.07%,31.25%,1
臺南市,歸仁區,1275,600,196,796,56,852,1514,56.27%,39.63%,1
臺南市,歸仁區,1276,625,201,826,75,901,1678,53.69%,37.25%,1
臺南市,歸仁區,1277,364,106,470,37,507,949,53.42%,38.36%,1
臺南市,歸仁區,1278,376,149,525,69,594,1009,58.87%,37.26%,1
臺南市,歸仁區,1279,407,163,570,4,574,984,58.33%,41.36%,1
臺南市,歸仁區,1280,292,105,397,47,444,756,58.73%,38.62%,1
臺南市,歸仁區,1281,603,198,801,71,872,1478,59%,40.8%,1
臺南市,歸仁區,1282,597,196,793,81,874,1467,59.58%,40.7%,1
臺南市,關廟區,1283,319,131,450,34,484,982,49.29%,32.48%,1
臺南市,關廟區,1284,452,157,609,53,662,1156,57.27%,39.1%,1
臺南市,關廟區,1285,316,112,428,34,462,1006,45.92%,31.41%,1
臺南市,關廟區,1286,382,182,564,66,630,1043,60.4%,36.63%,1
臺南市,關廟區,1287,362,127,489,92,581,1012,57.41%,35.77%,1
臺南市,關廟區,1288,303,106,409,25,434,1013,42.84%,29.91%,1
臺南市,關廟區,1289,459,141,600,42,642,1294,49.61%,35.47%,1
臺南市,關廟區,1290,421,151,572,43,615,1264,48.66%,33.31%,1
臺南市,關廟區,1291,387,160,547,44,591,1166,50.69%,33.19%,1
臺南市,關廟區,1292,347,113,460,1,461,1018,45.28%,34.09%,1
臺南市,關廟區,1293,219,76,295,46,341,733,46.52%,29.88%,1
臺南市,關廟區,1294,426,142,568,37,605,1093,55.35%,38.98%,1
臺南市,關廟區,1295,436,99,535,31,566,1081,52.36%,40.33%,1
臺南市,關廟區,1296,381,139,520,49,569,978,58.18%,38.96%,1
臺南市,關廟區,1297,342,128,470,30,500,1116,44.8%,30.65%,1
臺南市,關廟區,1298,347,113,460,58,518,972,53.29%,35.7%,1
臺南市,關廟區,1299,351,153,504,97,601,1045,57.51%,33.59%,1
臺南市,關廟區,1300,319,106,425,33,458,872,52.52%,36.58%,1
臺南市,關廟區,1301,381,137,518,50,568,1007,56.41%,37.84%,1
臺南市,關廟區,1302,271,123,394,61,455,763,59.63%,35.52%,1
臺南市,關廟區,1303,222,72,294,40,334,630,53.02%,35.24%,1
臺南市,關廟區,1304,346,142,488,63,551,959,57.46%,36.08%,1
臺南市,關廟區,1305,405,116,521,37,558,1123,49.69%,36.06%,1
臺南市,關廟區,1306,283,106,389,67,456,804,56.72%,35.2%,1
臺南市,關廟區,1307,237,83,320,17,337,720,46.81%,32.92%,1
臺南市,關廟區,1308,267,62,329,20,349,843,41.4%,31.67%,1
臺南市,關廟區,1309,113,42,155,12,167,358,46.65%,31.56%,1
臺南市,關廟區,1310,276,87,363,62,425,797,53.32%,34.63%,1
臺南市,關廟區,1311,215,67,282,14,296,709,41.75%,30.32%,1
臺南市,關廟區,1312,290,91,381,22,403,904,44.58%,32.08%,1
臺南市,關廟區,1313,326,108,434,29,463,963,48.08%,33.85%,1
臺南市,關廟區,1314,169,65,234,6,240,489,49.08%,34.56%,1
臺南市,龍崎區,1315,336,124,460,71,531,1047,50.72%,32.09%,1
臺南市,龍崎區,1316,184,61,245,26,271,630,43.02%,29.21%,1
臺南市,龍崎區,1317,37,9,46,3,49,141,34.75%,26.24%,1
臺南市,龍崎區,1318,111,47,158,16,174,367,47.41%,30.25%,1
臺南市,龍崎區,1319,119,29,148,12,160,337,47.48%,35.31%,1
臺南市,龍崎區,1320,88,30,118,7,125,318,39.31%,27.67%,1
臺南市,龍崎區,1321,155,30,185,28,213,427,49.88%,36.3%,1
臺南市,龍崎區,1322,107,47,154,21,175,446,39.24%,23.99%,1
臺南市,永康區,0708,504,186,690,72,762,1398,54.51%,36.05%,1
臺南市,永康區,0709,420,157,577,48,625,1478,42.29%,28.42%,1
臺南市,永康區,0710,512,153,665,48,713,1442,49.45%,35.51%,1
臺南市,永康區,0711,474,144,618,48,666,1353,49.22%,35.03%,1
臺南市,永康區,0712,390,139,529,32,561,1160,48.36%,33.62%,1
臺南市,永康區,0713,438,118,556,39,595,1122,53.03%,39.04%,1
臺南市,永康區,0714,394,144,538,21,559,1165,47.98%,33.82%,1
臺南市,永康區,0715,456,150,606,49,655,1317,49.73%,34.62%,1
臺南市,永康區,0716,509,138,647,58,705,1376,51.24%,36.99%,1
臺南市,永康區,0717,517,167,684,43,727,1361,53.42%,37.99%,1
臺南市,永康區,0718,547,199,746,48,794,1374,57.79%,39.81%,1
臺南市,永康區,0719,527,232,759,71,830,1709,48.57%,30.84%,1
臺南市,永康區,0720,582,184,766,71,837,1717,48.75%,33.9%,1
臺南市,永康區,0721,563,221,784,54,838,1759,47.64%,32.01%,1
臺南市,永康區,0722,609,187,796,61,857,1636,52.38%,37.22%,1
臺南市,永康區,0723,533,152,685,78,763,1442,52.91%,36.96%,1
臺南市,永康區,0724,567,162,729,50,779,1545,50.42%,36.7%,1
臺南市,永康區,0725,589,147,736,51,787,1565,50.29%,37.64%,1
臺南市,永康區,0726,570,195,765,47,812,1684,48.22%,33.85%,1
臺南市,永康區,0727,510,167,677,28,705,1548,45.54%,32.95%,1
臺南市,永康區,0728,525,188,713,38,751,1389,54.07%,37.8%,1
臺南市,永康區,0729,508,143,651,66,717,1369,52.37%,37.11%,1
臺南市,永康區,0730,512,157,669,96,765,1415,54.06%,36.18%,1
臺南市,永康區,0731,435,131,566,21,587,1386,42.35%,31.39%,1
臺南市,永康區,0732,295,84,379,9,388,1747,22.21%,16.89%,1
臺南市,永康區,0733,521,164,685,73,758,1485,51.04%,35.08%,1
臺南市,永康區,0734,602,189,791,95,886,1747,50.72%,34.46%,1
臺南市,永康區,0735,512,189,701,44,745,1744,42.72%,29.36%,1
臺南市,永康區,0736,582,181,763,60,823,1797,45.8%,32.39%,1
臺南市,永康區,0737,685,206,891,74,965,1800,53.61%,38.06%,1
臺南市,永康區,0738,609,167,776,30,806,1720,46.86%,35.41%,1
臺南市,永康區,0739,645,213,858,51,909,1708,53.22%,37.76%,1
臺南市,永康區,0740,594,164,758,48,806,1519,53.06%,39.1%,1
臺南市,永康區,0741,547,189,736,103,839,1497,56.05%,36.54%,1
臺南市,永康區,0742,534,149,683,36,719,1509,47.65%,35.39%,1
臺南市,永康區,0743,623,192,815,90,905,1542,58.69%,40.4%,1
臺南市,永康區,0744,625,182,807,31,838,1536,54.56%,40.69%,1
臺南市,永康區,0745,555,205,760,63,823,1531,53.76%,36.25%,1
臺南市,永康區,0746,509,187,696,62,758,1327,57.12%,38.36%,1
臺南市,永康區,0747,540,175,715,23,738,1456,50.69%,37.09%,1
臺南市,永康區,0748,532,190,722,52,774,1396,55.44%,38.11%,1
臺南市,永康區,0749,551,223,774,66,840,1636,51.34%,33.68%,1
臺南市,永康區,0750,577,217,794,56,850,1592,53.39%,36.24%,1
臺南市,永康區,0751,703,221,924,33,957,2017,47.45%,34.85%,1
臺南市,永康區,0752,249,82,331,21,352,672,52.38%,37.05%,1
臺南市,永康區,0753,535,178,713,32,745,1611,46.24%,33.21%,1
臺南市,永康區,0754,568,173,741,54,795,1502,52.93%,37.82%,1
臺南市,永康區,0755,527,164,691,35,726,1660,43.73%,31.75%,1
臺南市,永康區,0756,484,158,642,38,680,1561,43.56%,31.01%,1
臺南市,永康區,0757,497,202,699,37,736,1590,46.29%,31.26%,1
臺南市,永康區,0758,333,109,442,17,459,924,49.68%,36.04%,1
臺南市,永康區,0759,391,115,506,26,532,938,56.72%,41.68%,1
臺南市,永康區,0760,395,98,493,45,538,957,56.22%,41.27%,1
臺南市,永康區,0761,166,68,234,42,276,496,55.65%,33.47%,1
臺南市,永康區,0762,611,217,828,76,904,1717,52.65%,35.59%,1
臺南市,永康區,0763,518,180,698,44,742,1615,45.94%,32.07%,1
臺南市,永康區,0764,494,187,681,31,712,1554,45.82%,31.79%,1
臺南市,永康區,0765,386,135,521,35,556,1196,46.49%,32.27%,1
臺南市,永康區,0766,461,154,615,43,658,1274,51.65%,36.19%,1
臺南市,永康區,0767,467,146,613,41,654,1215,53.83%,38.44%,1
臺南市,永康區,0768,518,179,697,29,726,1457,49.83%,35.55%,1
臺南市,永康區,0769,545,171,716,22,738,1451,50.86%,37.56%,1
臺南市,永康區,0770,453,181,634,49,683,1423,48%,31.83%,1
臺南市,永康區,0771,517,186,703,40,743,1394,53.3%,37.09%,1
臺南市,永康區,0772,350,111,461,54,515,890,57.87%,39.33%,1
臺南市,永康區,0773,392,155,547,64,611,1018,60.02%,38.51%,1
臺南市,永康區,0774,144,44,188,26,214,368,58.15%,39.13%,1
臺南市,永康區,0775,458,199,657,56,713,1208,59.02%,37.91%,1
臺南市,永康區,0776,357,162,519,37,556,1187,46.84%,30.08%,1
臺南市,永康區,0777,479,184,663,36,699,1381,50.62%,34.69%,1
臺南市,永康區,0778,497,154,651,79,730,1405,51.96%,35.37%,1
臺南市,永康區,0779,467,175,642,80,722,1445,49.97%,32.32%,1
臺南市,永康區,0780,599,183,782,67,849,1687,50.33%,35.51%,1
臺南市,永康區,0781,472,166,638,41,679,1535,44.23%,30.75%,1
臺南市,永康區,0782,612,163,775,60,835,1542,54.15%,39.69%,1
臺南市,永康區,0783,597,168,765,40,805,1618,49.75%,36.9%,1
臺南市,永康區,0784,550,155,705,36,741,1338,55.38%,41.11%,1
臺南市,永康區,0785,475,182,657,79,736,1285,57.28%,36.96%,1
臺南市,永康區,0786,437,144,581,32,613,1240,49.44%,35.24%,1
臺南市,永康區,0787,433,172,605,64,669,1343,49.81%,32.24%,1
臺南市,永康區,0788,526,180,706,55,761,1327,57.35%,39.64%,1
臺南市,永康區,0789,563,189,752,60,812,1565,51.88%,35.97%,1
臺南市,永康區,0790,611,110,721,100,821,1476,55.62%,41.4%,1
臺南市,永康區,0791,529,175,704,49,753,1476,51.02%,35.84%,1
臺南市,永康區,0792,570,201,771,60,831,1463,56.8%,38.96%,1
臺南市,永康區,0793,357,129,486,89,575,983,58.49%,36.32%,1
臺南市,永康區,0794,422,154,576,71,647,1116,57.97%,37.81%,1
臺南市,永康區,0795,369,133,502,85,587,1117,52.55%,33.03%,1
臺南市,永康區,0796,325,139,464,36,500,1069,46.77%,30.4%,1
臺南市,永康區,0797,510,144,654,43,697,1180,59.07%,43.22%,1
臺南市,永康區,0798,418,131,549,95,644,1176,54.76%,35.54%,1
臺南市,永康區,0799,383,170,553,55,608,1158,52.5%,33.07%,1
臺南市,永康區,0800,444,170,614,93,707,1208,58.53%,36.75%,1
臺南市,永康區,0801,515,197,712,89,801,1501,53.36%,34.31%,1
臺南市,永康區,0802,490,168,658,38,696,1298,53.62%,37.75%,1
臺南市,永康區,0803,593,137,730,33,763,1542,49.48%,38.46%,1
臺南市,永康區,0804,611,178,789,68,857,1537,55.76%,39.75%,1
臺南市,永康區,0805,557,182,739,79,818,1359,60.19%,40.99%,1
臺南市,永康區,0806,343,128,471,46,517,1139,45.39%,30.11%,1
臺南市,永康區,0807,378,142,520,53,573,1158,49.48%,32.64%,1
臺南市,永康區,0808,479,211,690,86,776,1538,50.46%,31.14%,1
臺南市,永康區,0809,401,119,520,22,542,1166,46.48%,34.39%,1
臺南市,永康區,0810,434,112,546,24,570,1228,46.42%,35.34%,1
臺南市,永康區,0811,340,281,621,67,688,1200,57.33%,28.33%,1
臺南市,永康區,0812,411,176,587,46,633,1131,55.97%,36.34%,1
臺南市,永康區,0813,402,142,544,34,578,1147,50.39%,35.05%,1
臺南市,永康區,0814,502,163,665,62,727,1442,50.42%,34.81%,1
臺南市,永康區,0815,460,135,595,35,630,1325,47.55%,34.72%,1
臺南市,永康區,0816,404,114,518,46,564,1260,44.76%,32.06%,1
臺南市,永康區,0817,549,189,738,61,799,1631,48.99%,33.66%,1
臺南市,永康區,0818,551,164,715,53,768,1549,49.58%,35.57%,1
臺南市,永康區,0819,568,189,757,46,803,1666,48.2%,34.09%,1
臺南市,永康區,0820,359,88,447,49,496,1012,49.01%,35.47%,1
臺南市,永康區,0821,316,82,398,24,422,976,43.24%,32.38%,1
臺南市,永康區,0822,206,53,259,24,283,531,53.3%,38.79%,1
臺南市,永康區,0823,343,79,422,51,473,859,55.06%,39.93%,1
臺南市,永康區,0824,330,91,421,40,461,937,49.2%,35.22%,1
臺南市,永康區,0825,497,144,641,55,696,1307,53.25%,38.03%,1
臺南市,永康區,0826,514,123,637,35,672,1482,45.34%,34.68%,1
臺南市,永康區,0827,437,139,576,42,618,1341,46.09%,32.59%,1
臺南市,永康區,0828,505,138,643,52,695,1376,50.51%,36.7%,1
臺南市,永康區,0829,464,170,634,57,691,1390,49.71%,33.38%,1
臺南市,永康區,0830,557,226,783,47,830,1534,54.11%,36.31%,1
臺南市,永康區,0831,582,173,755,47,802,1460,54.93%,39.86%,1
臺南市,永康區,0832,497,153,650,30,680,1383,49.17%,35.94%,1
臺南市,永康區,0833,465,149,614,44,658,1299,50.65%,35.8%,1
臺南市,永康區,0834,495,163,658,37,695,1264,54.98%,39.16%,1
臺南市,永康區,0835,557,158,715,49,764,1355,56.38%,41.11%,1
臺南市,永康區,0836,502,135,637,34,671,1414,47.45%,35.5%,1
臺南市,永康區,0837,456,140,596,30,626,1109,56.45%,41.12%,1
臺南市,永康區,0838,427,110,537,51,588,1151,51.09%,37.1%,1
臺南市,永康區,0839,597,9,606,54,660,1026,64.33%,58.19%,1
臺南市,永康區,0840,346,124,470,30,500,1071,46.69%,32.31%,1
臺南市,永康區,0841,588,198,786,78,864,1387,62.29%,42.39%,1
臺南市,永康區,0842,548,205,753,50,803,1377,58.32%,39.8%,1
臺南市,永康區,0843,607,214,821,74,895,1687,53.05%,35.98%,1
臺南市,永康區,0844,593,202,795,48,843,1700,49.59%,34.88%,1
臺南市,永康區,0845,558,197,755,47,802,1444,55.54%,38.64%,1
臺南市,永康區,0846,554,154,708,50,758,1485,51.04%,37.31%,1
臺南市,永康區,0847,571,184,755,47,802,1717,46.71%,33.26%,1
臺南市,永康區,0848,560,174,734,60,794,1701,46.68%,32.92%,1
臺南市,永康區,0849,481,147,628,40,668,1382,48.34%,34.8%,1
臺南市,東區,1095,715,257,972,70,1042,2681,38.87%,26.67%,1
臺南市,東區,1096,604,249,853,37,890,1811,49.14%,33.35%,1
臺南市,東區,1097,606,231,837,94,931,1491,62.44%,40.64%,1
臺南市,東區,1098,519,182,701,53,754,1378,54.72%,37.66%,1
臺南市,東區,1099,594,104,698,73,771,1552,49.68%,38.27%,1
臺南市,東區,1100,509,216,725,32,757,1326,57.09%,38.39%,1
臺南市,東區,1101,602,223,825,76,901,1594,56.52%,37.77%,1
臺南市,東區,1102,628,249,877,62,939,1639,57.29%,38.32%,1
臺南市,東區,1103,627,232,859,65,924,1724,53.6%,36.37%,1
臺南市,東區,1104,602,222,824,83,907,1629,55.68%,36.96%,1
臺南市,東區,1105,542,162,704,45,749,1399,53.54%,38.74%,1
臺南市,東區,1106,602,171,773,43,816,1534,53.19%,39.24%,1
臺南市,東區,1107,633,227,860,73,933,1656,56.34%,38.22%,1
臺南市,東區,1108,507,149,656,72,728,1322,55.07%,38.35%,1
臺南市,東區,1109,633,199,832,42,874,1620,53.95%,39.07%,1
臺南市,東區,1110,597,165,762,45,807,1331,60.63%,44.85%,1
臺南市,東區,1111,386,137,523,61,584,1039,56.21%,37.15%,1
臺南市,東區,1112,409,137,546,44,590,1257,46.94%,32.54%,1
臺南市,東區,1113,696,219,915,131,1046,2067,50.6%,33.67%,1
臺南市,東區,1114,875,201,1076,45,1121,2153,52.07%,40.64%,1
臺南市,東區,1115,888,271,1159,64,1223,2363,51.76%,37.58%,1
臺南市,東區,1116,547,175,722,59,781,1427,54.73%,38.33%,1
臺南市,東區,1117,590,208,798,50,848,1555,54.53%,37.94%,1
臺南市,東區,1118,680,194,874,76,950,2115,44.92%,32.15%,1
臺南市,東區,1119,818,256,1074,90,1164,2340,49.74%,34.96%,1
臺南市,東區,1120,912,320,1232,83,1315,2474,53.15%,36.86%,1
臺南市,東區,1121,878,275,1153,83,1236,2391,51.69%,36.72%,1
臺南市,東區,1122,622,248,870,60,930,1673,55.59%,37.18%,1
臺南市,東區,1123,560,215,775,45,820,1594,51.44%,35.13%,1
臺南市,東區,1124,656,190,846,72,918,1607,57.13%,40.82%,1
臺南市,東區,1125,884,259,1143,48,1191,2087,57.07%,42.36%,1
臺南市,東區,1126,968,328,1296,50,1346,2369,56.82%,40.86%,1
臺南市,東區,1127,574,210,784,120,904,1696,53.3%,33.84%,1
臺南市,東區,1128,559,234,793,50,843,1612,52.3%,34.68%,1
臺南市,東區,1129,594,215,809,71,880,1708,51.52%,34.78%,1
臺南市,東區,1130,593,200,793,59,852,1560,54.62%,38.01%,1
臺南市,東區,1131,675,239,914,69,983,1854,53.02%,36.41%,1
臺南市,東區,1132,727,304,1031,49,1080,2278,47.41%,31.91%,1
臺南市,東區,1133,737,253,990,59,1049,2093,50.12%,35.21%,1
臺南市,東區,1134,914,294,1208,67,1275,2242,56.87%,40.77%,1
臺南市,東區,1135,467,156,623,56,679,1152,58.94%,40.54%,1
臺南市,東區,1136,601,173,774,22,796,1318,60.39%,45.6%,1
臺南市,東區,1137,842,284,1126,57,1183,2200,53.77%,38.27%,1
臺南市,東區,1138,820,269,1089,51,1140,1960,58.16%,41.84%,1
臺南市,東區,1139,529,201,730,49,779,1489,52.32%,35.53%,1
臺南市,東區,1140,503,211,714,81,795,1443,55.09%,34.86%,1
臺南市,東區,1141,609,241,850,56,906,1498,60.48%,40.65%,1
臺南市,東區,1142,615,234,849,26,875,1622,53.95%,37.92%,1
臺南市,東區,1143,678,225,903,57,960,1738,55.24%,39.01%,1
臺南市,東區,1144,520,201,721,71,792,1501,52.76%,34.64%,1
臺南市,東區,1145,536,221,757,68,825,1482,55.67%,36.17%,1
臺南市,東區,1146,612,226,838,47,885,1829,48.39%,33.46%,1
臺南市,東區,1147,645,246,891,70,961,1764,54.48%,36.56%,1
臺南市,東區,1148,603,174,777,44,821,1427,57.53%,42.26%,1
臺南市,東區,1149,504,191,695,77,772,1427,54.1%,35.32%,1
臺南市,東區,1150,565,159,724,57,781,1388,56.27%,40.71%,1
臺南市,東區,1151,437,205,642,40,682,1131,60.3%,38.64%,1
臺南市,東區,1152,354,120,474,60,534,1000,53.4%,35.4%,1
臺南市,東區,1153,383,117,500,53,553,996,55.52%,38.45%,1
臺南市,東區,1154,319,123,442,56,498,935,53.26%,34.12%,1
臺南市,東區,1155,307,155,462,83,545,947,57.55%,32.42%,1
臺南市,東區,1156,394,166,560,19,579,1090,53.12%,36.15%,1
臺南市,東區,1157,297,125,422,55,477,896,53.24%,33.15%,1
臺南市,東區,1158,562,224,786,32,818,1589,51.48%,35.37%,1
臺南市,東區,1159,583,196,779,61,840,1497,56.11%,38.94%,1
臺南市,東區,1160,463,198,661,60,721,1386,52.02%,33.41%,1
臺南市,東區,1161,393,161,554,21,575,1101,52.23%,35.69%,1
臺南市,東區,1162,488,217,705,64,769,1332,57.73%,36.64%,1
臺南市,東區,1163,463,143,606,61,667,1185,56.29%,39.07%,1
臺南市,東區,1164,526,147,673,60,733,1262,58.08%,41.68%,1
臺南市,東區,1165,517,187,704,53,757,1517,49.9%,34.08%,1
臺南市,東區,1166,459,162,621,88,709,1287,55.09%,35.66%,1
臺南市,東區,1167,626,222,848,67,915,1657,55.22%,37.78%,1
臺南市,東區,1168,811,283,1094,118,1212,2238,54.16%,36.24%,1
臺南市,東區,1169,787,302,1089,56,1145,2246,50.98%,35.04%,1
臺南市,東區,1170,786,266,1052,68,1120,2191,51.12%,35.87%,1
臺南市,東區,1171,746,257,1003,72,1075,2063,52.11%,36.16%,1
臺南市,東區,1172,866,298,1164,87,1251,2177,57.46%,39.78%,1
臺南市,東區,1173,757,216,973,104,1077,1863,57.81%,40.63%,1
臺南市,東區,1174,880,250,1130,58,1188,2185,54.37%,40.27%,1
臺南市,東區,1175,563,192,755,57,812,1721,47.18%,32.71%,1
臺南市,東區,1176,547,201,748,113,861,1556,55.33%,35.15%,1
臺南市,東區,1177,665,198,863,57,920,1602,57.43%,41.51%,1
臺南市,東區,1178,543,165,708,87,795,1523,52.2%,35.65%,1
臺南市,東區,1179,432,188,620,65,685,1382,49.57%,31.26%,1
臺南市,東區,1180,527,211,738,47,785,1486,52.83%,35.46%,1
臺南市,東區,1181,536,248,784,85,869,1560,55.71%,34.36%,1
臺南市,東區,1182,531,228,759,81,840,1684,49.88%,31.53%,1
臺南市,東區,1183,605,251,856,53,909,1653,54.99%,36.6%,1
臺南市,東區,1184,565,239,804,31,835,1554,53.73%,36.36%,1
臺南市,東區,1185,549,199,748,36,784,1408,55.68%,38.99%,1
臺南市,東區,1186,812,313,1125,58,1183,2084,56.77%,38.96%,1
臺南市,東區,1187,709,235,944,85,1029,1896,54.27%,37.39%,1
臺南市,南區,1015,451,172,623,48,671,1221,54.95%,36.94%,1
臺南市,南區,1016,688,217,905,99,1004,2171,46.25%,31.69%,1
臺南市,南區,1017,478,141,619,45,664,1150,57.74%,41.57%,1
臺南市,南區,1018,448,127,575,35,610,1122,54.37%,39.93%,1
臺南市,南區,1019,467,167,634,53,687,1444,47.58%,32.34%,1
臺南市,南區,1020,586,205,791,68,859,1765,48.67%,33.2%,1
臺南市,南區,1021,482,188,670,65,735,1298,56.63%,37.13%,1
臺南市,南區,1022,609,144,753,44,797,1458,54.66%,41.77%,1
臺南市,南區,1023,732,146,878,41,919,1940,47.37%,37.73%,1
臺南市,南區,1024,577,205,782,80,862,1637,52.66%,35.25%,1
臺南市,南區,1025,286,96,382,11,393,871,45.12%,32.84%,1
臺南市,南區,1026,226,86,312,22,334,589,56.71%,38.37%,1
臺南市,南區,1027,343,134,477,46,523,801,65.29%,42.82%,1
臺南市,南區,1028,384,120,504,64,568,990,57.37%,38.79%,1
臺南市,南區,1029,513,172,685,51,736,1222,60.23%,41.98%,1
臺南市,南區,1030,357,153,510,89,599,997,60.08%,35.81%,1
臺南市,南區,1031,374,174,548,39,587,1204,48.75%,31.06%,1
臺南市,南區,1032,470,188,658,43,701,1570,44.65%,29.94%,1
臺南市,南區,1033,421,180,601,68,669,1222,54.75%,34.45%,1
臺南市,南區,1034,344,115,459,33,492,1076,45.72%,31.97%,1
臺南市,南區,1035,337,188,525,36,561,1127,49.78%,29.9%,1
臺南市,南區,1036,399,149,548,71,619,1135,54.54%,35.15%,1
臺南市,南區,1037,436,157,593,76,669,1263,52.97%,34.52%,1
臺南市,南區,1038,340,109,449,39,488,1014,48.13%,33.53%,1
臺南市,南區,1039,542,209,751,81,832,1491,55.8%,36.35%,1
臺南市,南區,1040,640,214,854,56,910,1815,50.14%,35.26%,1
臺南市,南區,1041,473,170,643,28,671,1398,48%,33.83%,1
臺南市,南區,1042,611,224,835,57,892,2107,42.34%,29%,1
臺南市,南區,1043,635,227,862,71,933,1587,58.79%,40.01%,1
臺南市,南區,1044,525,254,779,90,869,1626,53.44%,32.29%,1
臺南市,南區,1045,542,226,768,45,813,1761,46.17%,30.78%,1
臺南市,南區,1046,546,225,771,95,866,1630,53.13%,33.5%,1
臺南市,南區,1047,552,205,757,71,828,1542,53.7%,35.8%,1
臺南市,南區,1048,483,181,664,106,770,1464,52.6%,32.99%,1
臺南市,南區,1049,545,242,787,118,905,1727,52.4%,31.56%,1
臺南市,南區,1050,403,173,576,68,644,1085,59.35%,37.14%,1
臺南市,南區,1051,315,114,429,22,451,939,48.03%,33.55%,1
臺南市,南區,1052,425,156,581,92,673,1419,47.43%,29.95%,1
臺南市,南區,1053,451,144,595,71,666,1333,49.96%,33.83%,1
臺南市,南區,1054,482,178,660,66,726,1465,49.56%,32.9%,1
臺南市,南區,1055,382,131,513,35,548,1099,49.86%,34.76%,1
臺南市,南區,1056,392,113,505,32,537,1133,47.4%,34.6%,1
臺南市,南區,1057,419,178,597,112,709,1375,51.56%,30.47%,1
臺南市,南區,1058,518,204,722,49,771,1781,43.29%,29.08%,1
臺南市,南區,1059,603,199,802,71,873,1542,56.61%,39.11%,1
臺南市,南區,1060,483,180,663,46,709,1486,47.71%,32.5%,1
臺南市,南區,1061,573,225,798,108,906,1640,55.24%,34.94%,1
臺南市,南區,1062,493,212,705,60,765,1701,44.97%,28.98%,1
臺南市,南區,1063,466,167,633,112,745,1541,48.35%,30.24%,1
臺南市,南區,1064,687,206,893,127,1020,2027,50.32%,33.89%,1
臺南市,南區,1065,675,249,924,108,1032,1774,58.17%,38.05%,1
臺南市,南區,1066,517,230,747,83,830,1613,51.46%,32.05%,1
臺南市,南區,1067,550,215,765,31,796,1707,46.63%,32.22%,1
臺南市,南區,1068,346,157,503,29,532,1657,32.11%,20.88%,1
臺南市,南區,1069,377,142,519,56,575,1077,53.39%,35%,1
臺南市,南區,1070,451,127,578,47,625,1185,52.74%,38.06%,1
臺南市,南區,1071,425,172,597,59,656,1249,52.52%,34.03%,1
臺南市,南區,1072,605,189,794,43,837,1985,42.17%,30.48%,1
臺南市,南區,1073,560,252,812,93,905,2017,44.87%,27.76%,1
臺南市,南區,1074,525,217,742,98,840,1717,48.92%,30.58%,1
臺南市,南區,1075,344,111,455,51,506,929,54.47%,37.03%,1
臺南市,南區,1076,249,109,358,36,394,695,56.69%,35.83%,1
臺南市,南區,1077,300,90,390,33,423,997,42.43%,30.09%,1
臺南市,南區,1078,251,56,307,23,330,784,42.09%,32.02%,1
臺南市,南區,1079,428,139,567,80,647,1119,57.82%,38.25%,1
臺南市,南區,1080,264,123,387,37,424,1054,40.23%,25.05%,1
臺南市,南區,1081,372,154,526,113,639,1245,51.33%,29.88%,1
臺南市,南區,1082,597,229,826,92,918,2064,44.48%,28.92%,1
臺南市,南區,1083,546,189,735,33,768,2056,37.35%,26.56%,1
臺南市,南區,1084,389,145,534,37,571,1373,41.59%,28.33%,1
臺南市,南區,1085,249,122,371,37,408,1002,40.72%,24.85%,1
臺南市,南區,1086,247,124,371,68,439,760,57.76%,32.5%,1
臺南市,南區,1087,335,141,476,84,560,1031,54.32%,32.49%,1
臺南市,南區,1088,253,91,344,64,408,744,54.84%,34.01%,1
臺南市,南區,1089,414,140,554,86,640,1186,53.96%,34.91%,1
臺南市,南區,1090,456,194,650,91,741,1358,54.57%,33.58%,1
臺南市,南區,1091,240,107,347,43,390,897,43.48%,26.76%,1
臺南市,南區,1092,435,149,584,74,658,1265,52.02%,34.39%,1
臺南市,南區,1093,294,135,429,53,482,1093,44.1%,26.9%,1
臺南市,南區,1094,386,110,496,37,533,1016,52.46%,37.99%,1
臺南市,北區,0850,622,196,818,91,909,1793,50.7%,34.69%,1
臺南市,北區,0851,531,188,719,61,780,1708,45.67%,31.09%,1
臺南市,北區,0852,369,116,485,25,510,997,51.15%,37.01%,1
臺南市,北區,0853,447,161,608,42,650,1452,44.77%,30.79%,1
臺南市,北區,0854,461,175,636,25,661,1351,48.93%,34.12%,1
臺南市,北區,0855,551,204,755,69,824,1323,62.28%,41.65%,1
臺南市,北區,0856,396,151,547,35,582,1073,54.24%,36.91%,1
臺南市,北區,0857,428,150,578,36,614,1138,53.95%,37.61%,1
臺南市,北區,0858,421,145,566,48,614,1189,51.64%,35.41%,1
臺南市,北區,0859,524,169,693,48,741,1262,58.72%,41.52%,1
臺南市,北區,0860,433,131,564,31,595,1017,58.51%,42.58%,1
臺南市,北區,0861,306,95,401,28,429,847,50.65%,36.13%,1
臺南市,北區,0862,455,118,573,50,623,1076,57.9%,42.29%,1
臺南市,北區,0863,370,160,530,37,567,954,59.43%,38.78%,1
臺南市,北區,0864,476,133,609,76,685,1300,52.69%,36.62%,1
臺南市,北區,0865,535,134,669,58,727,1390,52.3%,38.49%,1
臺南市,北區,0866,524,164,688,52,740,1318,56.15%,39.76%,1
臺南市,北區,0867,357,118,475,19,494,974,50.72%,36.65%,1
臺南市,北區,0868,361,126,487,27,514,990,51.92%,36.46%,1
臺南市,北區,0869,395,175,570,29,599,1016,58.96%,38.88%,1
臺南市,北區,0870,369,167,536,51,587,1053,55.75%,35.04%,1
臺南市,北區,0871,456,200,656,94,750,1466,51.16%,31.11%,1
臺南市,北區,0872,560,202,762,83,845,1535,55.05%,36.48%,1
臺南市,北區,0873,508,208,716,82,798,1544,51.68%,32.9%,1
臺南市,北區,0874,698,205,903,72,975,1760,55.4%,39.66%,1
臺南市,北區,0875,402,171,573,48,621,1372,45.26%,29.3%,1
臺南市,北區,0876,406,129,535,51,586,1002,58.48%,40.52%,1
臺南市,北區,0877,458,168,626,52,678,1171,57.9%,39.11%,1
臺南市,北區,0878,474,106,580,30,610,1285,47.47%,36.89%,1
臺南市,北區,0879,394,100,494,45,539,1036,52.03%,38.03%,1
臺南市,北區,0880,546,150,696,50,746,1392,53.59%,39.22%,1
臺南市,北區,0881,420,155,575,59,634,1147,55.27%,36.62%,1
臺南市,北區,0882,451,156,607,52,659,1526,43.18%,29.55%,1
臺南市,北區,0883,534,196,730,46,776,1559,49.78%,34.25%,1
臺南市,北區,0884,296,137,433,78,511,892,57.29%,33.18%,1
臺南市,北區,0885,319,115,434,44,478,937,51.01%,34.04%,1
臺南市,北區,0886,507,208,715,112,827,1449,57.07%,34.99%,1
臺南市,北區,0887,394,142,536,34,570,1160,49.14%,33.97%,1
臺南市,北區,0888,368,143,511,81,592,1567,37.78%,23.48%,1
臺南市,北區,0889,430,207,637,70,707,1346,52.53%,31.95%,1
臺南市,北區,0890,488,154,642,18,660,1451,45.49%,33.63%,1
臺南市,北區,0891,497,186,683,49,732,1522,48.09%,32.65%,1
臺南市,北區,0892,437,158,595,39,634,1278,49.61%,34.19%,1
臺南市,北區,0893,279,146,425,72,497,1164,42.7%,23.97%,1
臺南市,北區,0894,341,136,477,25,502,1091,46.01%,31.26%,1
臺南市,北區,0895,325,128,453,35,488,993,49.14%,32.73%,1
臺南市,北區,0896,327,114,441,42,483,1119,43.16%,29.22%,1
臺南市,北區,0897,597,239,836,86,922,1685,54.72%,35.43%,1
臺南市,北區,0898,491,187,678,24,702,1368,51.32%,35.89%,1
臺南市,北區,0899,496,180,676,66,742,1389,53.42%,35.71%,1
臺南市,北區,0900,579,198,777,31,808,1469,55%,39.41%,1
臺南市,北區,0901,666,205,871,77,948,1655,57.28%,40.24%,1
臺南市,北區,0902,500,172,672,39,711,1261,56.38%,39.65%,1
臺南市,北區,0903,542,166,708,32,740,1490,49.66%,36.38%,1
臺南市,北區,0904,640,180,820,6,826,1436,57.52%,44.57%,1
臺南市,北區,0905,525,177,702,84,786,1340,58.66%,39.18%,1
臺南市,北區,0906,551,199,750,42,792,1464,54.1%,37.64%,1
臺南市,北區,0907,613,216,829,29,858,1513,56.71%,40.52%,1
臺南市,北區,0908,665,226,891,35,926,1709,54.18%,38.91%,1
臺南市,北區,0909,638,220,858,50,908,1517,59.85%,42.06%,1
臺南市,北區,0910,575,224,799,28,827,1598,51.75%,35.98%,1
臺南市,北區,0911,493,184,677,59,736,1399,52.61%,35.24%,1
臺南市,北區,0912,412,160,572,60,632,1214,52.06%,33.94%,1
臺南市,北區,0913,417,148,565,31,596,1064,56.02%,39.19%,1
臺南市,北區,0914,459,182,641,59,700,1148,60.98%,39.98%,1
臺南市,北區,0915,505,196,701,50,751,1391,53.99%,36.3%,1
臺南市,北區,0916,622,188,810,56,866,1584,54.67%,39.27%,1
臺南市,北區,0917,642,200,842,47,889,1595,55.74%,40.25%,1
臺南市,北區,0918,513,173,686,42,728,1397,52.11%,36.72%,1
臺南市,北區,0919,600,219,819,65,884,1662,53.19%,36.1%,1
臺南市,北區,0920,566,203,769,35,804,1634,49.2%,34.64%,1
臺南市,北區,0921,677,235,912,102,1014,1793,56.55%,37.76%,1
臺南市,北區,0922,572,274,846,53,899,1872,48.02%,30.56%,1
臺南市,北區,0923,634,254,888,119,1007,1874,53.74%,33.83%,1
臺南市,北區,0924,625,204,829,73,902,1760,51.25%,35.51%,1
臺南市,北區,0925,624,194,818,71,889,1753,50.71%,35.6%,1
臺南市,北區,0926,452,146,598,35,633,1502,42.14%,30.09%,1
臺南市,北區,0927,535,188,723,57,780,1470,53.06%,36.39%,1
臺南市,北區,0928,418,189,607,97,704,1319,53.37%,31.69%,1
臺南市,北區,0929,715,243,958,74,1032,1876,55.01%,38.11%,1
臺南市,北區,0930,597,234,831,48,879,1720,51.1%,34.71%,1
臺南市,安南區,0618,950,295,1245,55,1300,2549,51%,37.27%,1
臺南市,安南區,0619,763,284,1047,90,1137,2321,48.99%,32.87%,1
臺南市,安南區,0620,835,268,1103,85,1188,2156,55.1%,38.73%,1
臺南市,安南區,0621,634,227,861,108,969,1662,58.3%,38.15%,1
臺南市,安南區,0622,576,179,755,119,874,1512,57.8%,38.1%,1
臺南市,安南區,0623,543,184,727,94,821,1625,50.52%,33.42%,1
臺南市,安南區,0624,644,239,883,62,945,2143,44.1%,30.05%,1
臺南市,安南區,0625,955,266,1221,105,1326,2457,53.97%,38.87%,1
臺南市,安南區,0626,771,294,1065,132,1197,2148,55.73%,35.89%,1
臺南市,安南區,0627,833,290,1123,103,1226,2364,51.86%,35.24%,1
臺南市,安南區,0628,604,206,810,51,861,1868,46.09%,32.33%,1
臺南市,安南區,0629,714,254,968,88,1056,1797,58.76%,39.73%,1
臺南市,安南區,0630,856,270,1126,82,1208,2268,53.26%,37.74%,1
臺南市,安南區,0631,683,234,917,89,1006,2291,43.91%,29.81%,1
臺南市,安南區,0632,781,270,1051,94,1145,2255,50.78%,34.63%,1
臺南市,安南區,0633,614,224,838,95,933,1940,48.09%,31.65%,1
臺南市,安南區,0634,746,248,994,44,1038,2013,51.56%,37.06%,1
臺南市,安南區,0635,718,215,933,104,1037,2024,51.24%,35.47%,1
臺南市,安南區,0636,634,237,871,107,978,1613,60.63%,39.31%,1
臺南市,安南區,0637,408,132,540,50,590,1178,50.08%,34.63%,1
臺南市,安南區,0638,740,272,1012,102,1114,2143,51.98%,34.53%,1
臺南市,安南區,0639,594,261,855,109,964,1721,56.01%,34.51%,1
臺南市,安南區,0640,680,247,927,79,1006,1773,56.74%,38.35%,1
臺南市,安南區,0641,515,179,694,33,727,1428,50.91%,36.06%,1
臺南市,安南區,0642,593,219,812,80,892,1626,54.86%,36.47%,1
臺南市,安南區,0643,469,190,659,74,733,1358,53.98%,34.54%,1
臺南市,安南區,0644,604,178,782,59,841,1447,58.12%,41.74%,1
臺南市,安南區,0645,497,172,669,102,771,1358,56.77%,36.6%,1
臺南市,安南區,0646,678,252,930,71,1001,2116,47.31%,32.04%,1
臺南市,安南區,0647,749,260,1009,55,1064,2321,45.84%,32.27%,1
臺南市,安南區,0648,725,221,946,62,1008,2117,47.61%,34.25%,1
臺南市,安南區,0649,614,249,863,88,951,1927,49.35%,31.86%,1
臺南市,安南區,0650,699,288,987,158,1145,2242,51.07%,31.18%,1
臺南市,安南區,0651,770,271,1041,52,1093,2334,46.83%,32.99%,1
臺南市,安南區,0652,673,233,906,84,990,1822,54.34%,36.94%,1
臺南市,安南區,0653,630,249,879,124,1003,1813,55.32%,34.75%,1
臺南市,安南區,0654,781,249,1030,136,1166,2188,53.29%,35.69%,1
臺南市,安南區,0655,801,267,1068,100,1168,2399,48.69%,33.39%,1
臺南市,安南區,0656,693,248,941,88,1029,2247,45.79%,30.84%,1
臺南市,安南區,0657,466,169,635,85,720,1165,61.8%,40%,1
臺南市,安南區,0658,519,173,692,72,764,1539,49.64%,33.72%,1
臺南市,安南區,0659,254,628,882,142,1024,1835,55.8%,13.84%,1
臺南市,安南區,0660,594,261,855,113,968,1797,53.87%,33.06%,1
臺南市,安南區,0661,711,242,953,117,1070,2223,48.13%,31.98%,1
臺南市,安南區,0662,390,154,544,76,620,977,63.46%,39.92%,1
臺南市,安南區,0663,517,188,705,46,751,1642,45.74%,31.49%,1
臺南市,安南區,0664,639,209,848,89,937,1697,55.22%,37.65%,1
臺南市,安南區,0665,644,188,832,74,906,1966,46.08%,32.76%,1
臺南市,安南區,0666,442,176,618,79,697,1319,52.84%,33.51%,1
臺南市,安南區,0667,609,230,839,91,930,1909,48.72%,31.9%,1
臺南市,安南區,0668,634,226,860,82,942,1763,53.43%,35.96%,1
臺南市,安南區,0669,351,103,454,61,515,965,53.37%,36.37%,1
臺南市,安南區,0670,441,160,601,94,695,1547,44.93%,28.51%,1
臺南市,安南區,0671,578,227,805,93,898,1784,50.34%,32.4%,1
臺南市,安南區,0672,719,227,946,76,1022,2145,47.65%,33.52%,1
臺南市,安南區,0673,922,282,1204,92,1296,2443,53.05%,37.74%,1
臺南市,安南區,0674,771,285,1056,65,1121,2565,43.7%,30.06%,1
臺南市,安南區,0675,853,326,1179,106,1285,2480,51.81%,34.4%,1
臺南市,安南區,0676,692,239,931,121,1052,2349,44.79%,29.46%,1
臺南市,安南區,0677,761,285,1046,105,1151,2168,53.09%,35.1%,1
臺南市,安南區,0678,599,177,776,49,825,1630,50.61%,36.75%,1
臺南市,安南區,0679,486,178,664,60,724,1675,43.22%,29.01%,1
臺南市,安南區,0680,660,222,882,127,1009,1627,62.02%,40.57%,1
臺南市,安南區,0681,511,196,707,75,782,1493,52.38%,34.23%,1
臺南市,安南區,0682,495,197,692,92,784,1397,56.12%,35.43%,1
臺南市,安南區,0683,396,271,667,87,754,1416,53.25%,27.97%,1
臺南市,安南區,0684,523,190,713,32,745,1460,51.03%,35.82%,1
臺南市,安南區,0685,713,188,901,58,959,2222,43.16%,32.09%,1
臺南市,安南區,0686,729,245,974,122,1096,2070,52.95%,35.22%,1
臺南市,安南區,0687,643,217,860,86,946,1739,54.4%,36.98%,1
臺南市,安南區,0688,606,207,813,118,931,1830,50.87%,33.11%,1
臺南市,安南區,0689,728,236,964,90,1054,1803,58.46%,40.38%,1
臺南市,安南區,0690,684,249,933,80,1013,1800,56.28%,38%,1
臺南市,安南區,0691,541,220,761,89,850,1815,46.83%,29.81%,1
臺南市,安南區,0692,582,217,799,56,855,1846,46.32%,31.53%,1
臺南市,安南區,0693,340,148,488,64,552,905,60.99%,37.57%,1
臺南市,安南區,0694,419,152,571,92,663,1073,61.79%,39.05%,1
臺南市,安南區,0695,638,181,819,86,905,1579,57.31%,40.41%,1
臺南市,安南區,0696,613,226,839,127,966,1876,51.49%,32.68%,1
臺南市,安南區,0697,390,146,536,62,598,1194,50.08%,32.66%,1
臺南市,安南區,0698,384,124,508,35,543,1475,36.81%,26.03%,1
臺南市,安南區,0699,468,145,613,29,642,1380,46.52%,33.91%,1
臺南市,安南區,0700,434,169,603,34,637,1462,43.57%,29.69%,1
臺南市,安南區,0701,397,127,524,71,595,1044,56.99%,38.03%,1
臺南市,安南區,0702,237,100,337,58,395,603,65.51%,39.3%,1
臺南市,安南區,0703,265,101,366,32,398,690,57.68%,38.41%,1
臺南市,安南區,0704,469,182,651,65,716,1447,49.48%,32.41%,1
臺南市,安南區,0705,426,124,550,47,597,910,65.6%,46.81%,1
臺南市,安南區,0706,589,191,780,102,882,1850,47.68%,31.84%,1
臺南市,安南區,0707,625,175,800,72,872,1501,58.09%,41.64%,1
臺南市,安平區,0983,638,238,876,89,965,1753,55.05%,36.39%,1
臺南市,安平區,0984,680,204,884,63,947,1859,50.94%,36.58%,1
臺南市,安平區,0985,475,181,656,53,709,1382,51.3%,34.37%,1
臺南市,安平區,0986,861,310,1171,89,1260,2547,49.47%,33.8%,1
臺南市,安平區,0987,880,313,1193,59,1252,2407,52.01%,36.56%,1
臺南市,安平區,0988,644,221,865,59,924,2070,44.64%,31.11%,1
臺南市,安平區,0989,744,275,1019,41,1060,2132,49.72%,34.9%,1
臺南市,安平區,0990,553,182,735,23,758,1450,52.28%,38.14%,1
臺南市,安平區,0991,554,185,739,29,768,1605,47.85%,34.52%,1
臺南市,安平區,0992,620,243,863,75,938,1755,53.45%,35.33%,1
臺南市,安平區,0993,557,202,759,54,813,1728,47.05%,32.23%,1
臺南市,安平區,0994,496,190,686,33,719,1754,40.99%,28.28%,1
臺南市,安平區,0995,619,192,811,61,872,1686,51.72%,36.71%,1
臺南市,安平區,0996,705,231,936,55,991,1843,53.77%,38.25%,1
臺南市,安平區,0997,612,202,814,51,865,1565,55.27%,39.11%,1
臺南市,安平區,0998,484,152,636,37,673,1288,52.25%,37.58%,1
臺南市,安平區,0999,541,205,746,23,769,1653,46.52%,32.73%,1
臺南市,安平區,1000,602,166,768,32,800,1697,47.14%,35.47%,1
臺南市,安平區,1001,745,206,951,56,1007,2154,46.75%,34.59%,1
臺南市,安平區,1002,739,231,970,52,1022,2107,48.5%,35.07%,1
臺南市,安平區,1003,644,200,844,77,921,1675,54.99%,38.45%,1
臺南市,安平區,1004,674,267,941,69,1010,1979,51.04%,34.06%,1
臺南市,安平區,1005,549,206,755,36,791,1602,49.38%,34.27%,1
臺南市,安平區,1006,571,179,750,53,803,1586,50.63%,36%,1
臺南市,安平區,1007,132,35,167,12,179,438,40.87%,30.14%,1
臺南市,安平區,1008,575,230,805,93,898,1780,50.45%,32.3%,1
臺南市,安平區,1009,494,218,712,45,757,1623,46.64%,30.44%,1
臺南市,安平區,1010,703,248,951,108,1059,2157,49.1%,32.59%,1
臺南市,安平區,1011,390,157,547,56,603,1286,46.89%,30.33%,1
臺南市,安平區,1012,478,212,690,92,782,1492,52.41%,32.04%,1
臺南市,安平區,1013,388,133,521,44,565,1325,42.64%,29.28%,1
臺南市,安平區,1014,714,189,903,84,987,2001,49.33%,35.68%,1
臺南市,中西區,0931,464,205,669,65,734,1332,55.11%,34.83%,1
臺南市,中西區,0932,438,190,628,84,712,1246,57.14%,35.15%,1
臺南市,中西區,0933,408,181,589,78,667,1276,52.27%,31.97%,1
臺南市,中西區,0934,593,225,818,64,882,1583,55.72%,37.46%,1
臺南市,中西區,0935,559,215,774,59,833,1464,56.9%,38.18%,1
臺南市,中西區,0936,402,198,600,28,628,1234,50.89%,32.58%,1
臺南市,中西區,0937,507,221,728,55,783,1368,57.24%,37.06%,1
臺南市,中西區,0938,400,154,554,42,596,1322,45.08%,30.26%,1
臺南市,中西區,0939,385,183,568,72,640,1216,52.63%,31.66%,1
臺南市,中西區,0940,412,196,608,48,656,1289,50.89%,31.96%,1
臺南市,中西區,0941,447,185,632,59,691,1237,55.86%,36.14%,1
臺南市,中西區,0942,342,168,510,39,549,1189,46.17%,28.76%,1
臺南市,中西區,0943,422,179,601,72,673,1201,56.04%,35.14%,1
臺南市,中西區,0944,428,145,573,63,636,1065,59.72%,40.19%,1
臺南市,中西區,0945,404,136,540,57,597,1055,56.59%,38.29%,1
臺南市,中西區,0946,476,191,667,45,712,1170,60.85%,40.68%,1
臺南市,中西區,0947,528,173,701,58,759,1280,59.3%,41.25%,1
臺南市,中西區,0948,448,194,642,46,688,1223,56.26%,36.63%,1
臺南市,中西區,0949,493,181,674,75,749,1292,57.97%,38.16%,1
臺南市,中西區,0950,399,150,549,22,571,993,57.5%,40.18%,1
臺南市,中西區,0951,554,208,762,63,825,1541,53.54%,35.95%,1
臺南市,中西區,0952,663,238,901,85,986,1652,59.69%,40.13%,1
臺南市,中西區,0953,480,170,650,37,687,1212,56.68%,39.6%,1
臺南市,中西區,0954,603,235,838,83,921,1621,56.82%,37.2%,1
臺南市,中西區,0955,594,258,852,57,909,1660,54.76%,35.78%,1
臺南市,中西區,0956,563,225,788,75,863,1595,54.11%,35.3%,1
臺南市,中西區,0957,488,205,693,69,762,1436,53.06%,33.98%,1
臺南市,中西區,0958,461,191,652,71,723,1265,57.15%,36.44%,1
臺南市,中西區,0959,339,132,471,54,525,856,61.33%,39.6%,1
臺南市,中西區,0960,382,176,558,56,614,1168,52.57%,32.71%,1
臺南市,中西區,0961,435,168,603,55,658,1134,58.02%,38.36%,1
臺南市,中西區,0962,402,156,558,65,623,995,62.61%,40.4%,1
臺南市,中西區,0963,584,166,750,55,805,1313,61.31%,44.48%,1
臺南市,中西區,0964,494,198,692,56,748,1265,59.13%,39.05%,1
臺南市,中西區,0965,422,173,595,56,651,1215,53.58%,34.73%,1
臺南市,中西區,0966,466,152,618,65,683,1248,54.73%,37.34%,1
臺南市,中西區,0967,211,120,331,46,377,687,54.88%,30.71%,1
臺南市,中西區,0968,387,157,544,90,634,1139,55.66%,33.98%,1
臺南市,中西區,0969,387,124,511,55,566,971,58.29%,39.86%,1
臺南市,中西區,0970,344,135,479,64,543,1254,43.3%,27.43%,1
臺南市,中西區,0971,340,138,478,52,530,979,54.14%,34.73%,1
臺南市,中西區,0972,596,217,813,73,886,1745,50.77%,34.15%,1
臺南市,中西區,0973,365,171,536,43,579,1074,53.91%,33.99%,1
臺南市,中西區,0974,460,200,660,48,708,1436,49.3%,32.03%,1
臺南市,中西區,0975,288,143,431,58,489,865,56.53%,33.29%,1
臺南市,中西區,0976,413,164,577,58,635,1164,54.55%,35.48%,1
臺南市,中西區,0977,386,172,558,39,597,1285,46.46%,30.04%,1
臺南市,中西區,0978,376,159,535,56,591,1078,54.82%,34.88%,1
臺南市,中西區,0979,470,188,658,63,721,1704,42.31%,27.58%,1
臺南市,中西區,0980,471,196,667,87,754,1296,58.18%,36.34%,1
臺南市,中西區,0981,429,140,569,51,620,1128,54.96%,38.03%,1
臺南市,中西區,0982,447,187,634,42,676,1245,54.3%,35.9%,1
高雄市,鹽埕區,0845,530,212,742,62,804,1304,61.66%,40.64%,1
高雄市,鹽埕區,0846,141,51,192,25,217,357,60.78%,39.5%,1
高雄市,鹽埕區,0847,240,105,345,28,373,651,57.3%,36.87%,1
高雄市,鹽埕區,0848,444,163,607,32,639,1322,48.34%,33.59%,1
高雄市,鹽埕區,0849,422,141,563,27,590,1056,55.87%,39.96%,1
高雄市,鹽埕區,0850,348,151,499,19,518,904,57.3%,38.5%,1
高雄市,鹽埕區,0851,423,147,570,32,602,1130,53.27%,37.43%,1
高雄市,鹽埕區,0852,370,102,472,23,495,840,58.93%,44.05%,1
高雄市,鹽埕區,0853,277,125,402,33,435,616,70.62%,44.97%,1
高雄市,鹽埕區,0854,471,198,669,43,712,1397,50.97%,33.72%,1
高雄市,鹽埕區,0855,283,126,409,18,427,766,55.74%,36.95%,1
高雄市,鹽埕區,0856,343,132,475,43,518,839,61.74%,40.88%,1
高雄市,鹽埕區,0857,337,126,463,18,481,805,59.75%,41.86%,1
高雄市,鹽埕區,0858,275,100,375,23,398,750,53.07%,36.67%,1
高雄市,鹽埕區,0859,353,142,495,38,533,986,54.06%,35.8%,1
高雄市,鹽埕區,0860,361,120,481,13,494,1068,46.25%,33.8%,1
高雄市,鹽埕區,0861,397,174,571,59,630,1060,59.43%,37.45%,1
高雄市,鹽埕區,0862,289,113,402,38,440,805,54.66%,35.9%,1
高雄市,鹽埕區,0863,359,135,494,18,512,1073,47.72%,33.46%,1
高雄市,鹽埕區,0864,299,132,431,34,465,921,50.49%,32.46%,1
高雄市,鹽埕區,0865,436,163,599,23,622,1171,53.12%,37.23%,1
高雄市,鹽埕區,0866,205,111,316,22,338,594,56.9%,34.51%,1
高雄市,鹽埕區,0867,241,85,326,19,345,592,58.28%,40.71%,1
高雄市,鹽埕區,0868,187,107,294,15,309,610,50.66%,30.66%,1
高雄市,鼓山區,0768,361,104,465,25,490,959,51.09%,37.64%,1
高雄市,鼓山區,0769,472,130,602,54,656,1000,65.6%,47.2%,1
高雄市,鼓山區,0770,392,98,490,13,503,910,55.27%,43.08%,1
高雄市,鼓山區,0771,538,118,656,55,711,1085,65.53%,49.59%,1
高雄市,鼓山區,0772,490,163,653,51,704,1484,47.44%,33.02%,1
高雄市,鼓山區,0773,621,159,780,31,811,1393,58.22%,44.58%,1
高雄市,鼓山區,0774,610,169,779,71,850,1270,66.93%,48.03%,1
高雄市,鼓山區,0775,402,132,534,47,581,1055,55.07%,38.1%,1
高雄市,鼓山區,0776,450,165,615,35,650,1172,55.46%,38.4%,1
高雄市,鼓山區,0777,495,189,684,51,735,1175,62.55%,42.13%,1
高雄市,鼓山區,0778,499,194,693,47,740,1274,58.08%,39.17%,1
高雄市,鼓山區,0779,381,123,504,52,556,1085,51.24%,35.12%,1
高雄市,鼓山區,0780,579,179,758,69,827,1470,56.26%,39.39%,1
高雄市,鼓山區,0781,417,167,584,51,635,974,65.2%,42.81%,1
高雄市,鼓山區,0782,523,185,708,87,795,1275,62.35%,41.02%,1
高雄市,鼓山區,0783,445,172,617,67,684,1206,56.72%,36.9%,1
高雄市,鼓山區,0784,508,167,675,31,706,1238,57.03%,41.03%,1
高雄市,鼓山區,0785,436,41,477,19,496,721,68.79%,60.47%,1
高雄市,鼓山區,0786,460,148,608,35,643,1220,52.7%,37.7%,1
高雄市,鼓山區,0787,645,220,865,46,911,1966,46.34%,32.81%,1
高雄市,鼓山區,0788,580,245,825,78,903,1722,52.44%,33.68%,1
高雄市,鼓山區,0789,633,204,837,29,866,1720,50.35%,36.8%,1
高雄市,鼓山區,0790,518,174,692,109,801,1287,62.24%,40.25%,1
高雄市,鼓山區,0791,434,152,586,44,630,1369,46.02%,31.7%,1
高雄市,鼓山區,0792,539,166,705,37,742,1222,60.72%,44.11%,1
高雄市,鼓山區,0793,692,185,877,58,935,1770,52.82%,39.1%,1
高雄市,鼓山區,0794,771,203,974,48,1022,1860,54.95%,41.45%,1
高雄市,鼓山區,0795,749,241,990,58,1048,1857,56.44%,40.33%,1
高雄市,鼓山區,0796,766,253,1019,54,1073,1841,58.28%,41.61%,1
高雄市,鼓山區,0797,799,250,1049,71,1120,1830,61.2%,43.66%,1
高雄市,鼓山區,0798,766,237,1003,69,1072,1809,59.26%,42.34%,1
高雄市,鼓山區,0799,854,231,1085,51,1136,1894,59.98%,45.09%,1
高雄市,鼓山區,0800,835,284,1119,25,1144,1882,60.79%,44.37%,1
高雄市,鼓山區,0801,824,319,1143,62,1205,1894,63.62%,43.51%,1
高雄市,鼓山區,0802,760,207,967,45,1012,1745,57.99%,43.55%,1
高雄市,鼓山區,0803,825,185,1010,26,1036,1887,54.9%,43.72%,1
高雄市,鼓山區,0804,867,294,1161,61,1222,1891,64.62%,45.85%,1
高雄市,鼓山區,0805,839,262,1101,60,1161,1903,61.01%,44.09%,1
高雄市,鼓山區,0806,833,330,1163,49,1212,1998,60.66%,41.69%,1
高雄市,鼓山區,0807,850,260,1110,67,1177,1912,61.56%,44.46%,1
高雄市,鼓山區,0808,864,260,1124,75,1199,1923,62.35%,44.93%,1
高雄市,鼓山區,0809,859,271,1130,38,1168,1888,61.86%,45.5%,1
高雄市,鼓山區,0810,873,255,1128,19,1147,1873,61.24%,46.61%,1
高雄市,鼓山區,0811,951,314,1265,48,1313,1959,67.02%,48.55%,1
高雄市,鼓山區,0812,917,260,1177,59,1236,1897,65.16%,48.34%,1
高雄市,鼓山區,0813,1076,300,1376,47,1423,2362,60.25%,45.55%,1
高雄市,鼓山區,0814,841,232,1073,77,1150,1850,62.16%,45.46%,1
高雄市,鼓山區,0815,1072,67,1139,35,1174,1928,60.89%,55.6%,1
高雄市,鼓山區,0816,842,213,1055,37,1092,1937,56.38%,43.47%,1
高雄市,鼓山區,0817,918,262,1180,75,1255,2123,59.11%,43.24%,1
高雄市,鼓山區,0818,785,274,1059,39,1098,1861,59%,42.18%,1
高雄市,鼓山區,0819,823,225,1048,38,1086,1892,57.4%,43.5%,1
高雄市,鼓山區,0820,931,315,1246,56,1302,2147,60.64%,43.36%,1
高雄市,鼓山區,0821,880,233,1113,46,1159,1897,61.1%,46.39%,1
高雄市,鼓山區,0822,833,295,1128,30,1158,2041,56.74%,40.81%,1
高雄市,鼓山區,0823,567,152,719,55,774,1309,59.13%,43.32%,1
高雄市,鼓山區,0824,796,278,1074,64,1138,1867,60.95%,42.64%,1
高雄市,鼓山區,0825,580,156,736,45,781,1152,67.8%,50.35%,1
高雄市,鼓山區,0826,657,185,842,59,901,1404,64.17%,46.79%,1
高雄市,鼓山區,0827,322,97,419,27,446,1210,36.86%,26.61%,1
高雄市,鼓山區,0828,399,178,577,51,628,1135,55.33%,35.15%,1
高雄市,鼓山區,0829,430,148,578,84,662,1831,36.16%,23.48%,1
高雄市,鼓山區,0830,526,154,680,76,756,1288,58.7%,40.84%,1
高雄市,鼓山區,0831,476,139,615,40,655,1241,52.78%,38.36%,1
高雄市,鼓山區,0832,568,172,740,83,823,1342,61.33%,42.32%,1
高雄市,鼓山區,0833,555,208,763,105,868,1422,61.04%,39.03%,1
高雄市,鼓山區,0834,617,196,813,104,917,1453,63.11%,42.46%,1
高雄市,鼓山區,0835,246,103,349,49,398,616,64.61%,39.94%,1
高雄市,鼓山區,0836,292,128,420,81,501,834,60.07%,35.01%,1
高雄市,鼓山區,0837,349,144,493,60,553,969,57.07%,36.02%,1
高雄市,鼓山區,0838,335,147,482,88,570,978,58.28%,34.25%,1
高雄市,鼓山區,0839,282,130,412,74,486,760,63.95%,37.11%,1
高雄市,鼓山區,0840,491,177,668,71,739,1248,59.21%,39.34%,1
高雄市,鼓山區,0841,369,165,534,23,557,1143,48.73%,32.28%,1
高雄市,鼓山區,0842,439,153,592,80,672,1358,49.48%,32.33%,1
高雄市,鼓山區,0843,386,104,490,19,509,1036,49.13%,37.26%,1
高雄市,鼓山區,0844,196,89,285,15,300,580,51.72%,33.79%,1
高雄市,左營區,0534,509,289,798,75,873,2604,33.53%,19.55%,1
高雄市,左營區,0535,397,154,551,93,644,1037,62.1%,38.28%,1
高雄市,左營區,0536,231,67,298,53,351,542,64.76%,42.62%,1
高雄市,左營區,0537,224,102,326,59,385,635,60.63%,35.28%,1
高雄市,左營區,0538,165,56,221,20,241,518,46.53%,31.85%,1
高雄市,左營區,0539,250,116,366,73,439,813,54%,30.75%,1
高雄市,左營區,0540,295,149,444,91,535,889,60.18%,33.18%,1
高雄市,左營區,0541,276,111,387,84,471,731,64.43%,37.76%,1
高雄市,左營區,0542,539,201,740,57,797,1592,50.06%,33.86%,1
高雄市,左營區,0543,680,223,903,58,961,1709,56.23%,39.79%,1
高雄市,左營區,0544,700,156,856,67,923,1588,58.12%,44.08%,1
高雄市,左營區,0545,166,19,185,10,195,358,54.47%,46.37%,1
高雄市,左營區,0546,389,50,439,17,456,666,68.47%,58.41%,1
高雄市,左營區,0547,727,182,909,74,983,1748,56.24%,41.59%,1
高雄市,左營區,0548,550,141,691,76,767,1196,64.13%,45.99%,1
高雄市,左營區,0549,547,165,712,70,782,1240,63.06%,44.11%,1
高雄市,左營區,0550,720,103,823,48,871,1402,62.13%,51.36%,1
高雄市,左營區,0551,635,79,714,33,747,1173,63.68%,54.13%,1
高雄市,左營區,0552,366,68,434,25,459,641,71.61%,57.1%,1
高雄市,左營區,0553,317,147,464,53,517,951,54.36%,33.33%,1
高雄市,左營區,0554,258,110,368,50,418,732,57.1%,35.25%,1
高雄市,左營區,0555,108,53,161,16,177,339,52.21%,31.86%,1
高雄市,左營區,0556,200,69,269,20,289,519,55.68%,38.54%,1
高雄市,左營區,0557,187,93,280,62,342,514,66.54%,36.38%,1
高雄市,左營區,0558,295,94,389,68,457,720,63.47%,40.97%,1
高雄市,左營區,0559,148,64,212,57,269,411,65.45%,36.01%,1
高雄市,左營區,0560,238,112,350,45,395,603,65.51%,39.47%,1
高雄市,左營區,0561,340,139,479,87,566,904,62.61%,37.61%,1
高雄市,左營區,0562,478,120,598,56,654,1318,49.62%,36.27%,1
高雄市,左營區,0563,338,116,454,34,488,966,50.52%,34.99%,1
高雄市,左營區,0564,673,128,801,45,846,1440,58.75%,46.74%,1
高雄市,左營區,0565,901,158,1059,58,1117,1990,56.13%,45.28%,1
高雄市,左營區,0566,554,75,629,42,671,1090,61.56%,50.83%,1
高雄市,左營區,0567,625,100,725,68,793,1272,62.34%,49.14%,1
高雄市,左營區,0568,756,183,939,31,970,1558,62.26%,48.52%,1
高雄市,左營區,0569,718,205,923,40,963,1501,64.16%,47.83%,1
高雄市,左營區,0570,197,38,235,12,247,360,68.61%,54.72%,1
高雄市,左營區,0571,672,80,752,36,788,1335,59.03%,50.34%,1
高雄市,左營區,0572,644,119,763,25,788,1359,57.98%,47.39%,1
高雄市,左營區,0573,712,151,863,64,927,1487,62.34%,47.88%,1
高雄市,左營區,0574,703,161,864,63,927,1637,56.63%,42.94%,1
高雄市,左營區,0575,754,182,936,50,986,1553,63.49%,48.55%,1
高雄市,左營區,0576,689,227,916,79,995,1564,63.62%,44.05%,1
高雄市,左營區,0577,847,240,1087,72,1159,1788,64.82%,47.37%,1
高雄市,左營區,0578,886,266,1152,89,1241,2028,61.19%,43.69%,1
高雄市,左營區,0579,844,280,1124,101,1225,2037,60.14%,41.43%,1
高雄市,左營區,0580,962,266,1228,64,1292,2101,61.49%,45.79%,1
高雄市,左營區,0581,921,239,1160,68,1228,2018,60.85%,45.64%,1
高雄市,左營區,0582,815,330,1145,93,1238,1925,64.31%,42.34%,1
高雄市,左營區,0583,800,300,1100,42,1142,1989,57.42%,40.22%,1
高雄市,左營區,0584,666,218,884,40,924,1780,51.91%,37.42%,1
高雄市,左營區,0585,770,270,1040,40,1080,1778,60.74%,43.31%,1
高雄市,左營區,0586,689,192,881,33,914,1496,61.1%,46.06%,1
高雄市,左營區,0587,677,240,917,55,972,1538,63.2%,44.02%,1
高雄市,左營區,0588,893,286,1179,73,1252,2058,60.84%,43.39%,1
高雄市,左營區,0589,843,285,1128,40,1168,1992,58.63%,42.32%,1
高雄市,左營區,0590,885,298,1183,81,1264,2058,61.42%,43%,1
高雄市,左營區,0591,917,288,1205,60,1265,2090,60.53%,43.88%,1
高雄市,左營區,0592,875,311,1186,81,1267,2157,58.74%,40.57%,1
高雄市,左營區,0593,939,304,1243,58,1301,2096,62.07%,44.8%,1
高雄市,左營區,0594,924,331,1255,83,1338,2101,63.68%,43.98%,1
高雄市,左營區,0595,689,218,907,85,992,1649,60.16%,41.78%,1
高雄市,左營區,0596,528,265,793,102,895,1516,59.04%,34.83%,1
高雄市,左營區,0597,727,236,963,97,1060,1678,63.17%,43.33%,1
高雄市,左營區,0598,793,287,1080,98,1178,1898,62.07%,41.78%,1
高雄市,左營區,0599,747,239,986,61,1047,1837,57%,40.66%,1
高雄市,左營區,0600,767,232,999,42,1041,1922,54.16%,39.91%,1
高雄市,左營區,0601,801,241,1042,61,1103,1785,61.79%,44.87%,1
高雄市,左營區,0602,817,207,1024,32,1056,1886,55.99%,43.32%,1
高雄市,左營區,0603,870,238,1108,50,1158,1895,61.11%,45.91%,1
高雄市,左營區,0604,849,222,1071,40,1111,1831,60.68%,46.37%,1
高雄市,左營區,0605,855,267,1122,47,1169,2050,57.02%,41.71%,1
高雄市,左營區,0606,1085,320,1405,64,1469,2251,65.26%,48.2%,1
高雄市,左營區,0607,983,291,1274,45,1319,2126,62.04%,46.24%,1
高雄市,左營區,0608,782,235,1017,32,1049,1928,54.41%,40.56%,1
高雄市,左營區,0609,872,297,1169,68,1237,2166,57.11%,40.26%,1
高雄市,左營區,0610,918,240,1158,63,1221,2031,60.12%,45.2%,1
高雄市,左營區,0611,910,255,1165,60,1225,1987,61.65%,45.8%,1
高雄市,左營區,0612,989,283,1272,42,1314,2166,60.66%,45.66%,1
高雄市,左營區,0613,804,256,1060,77,1137,1856,61.26%,43.32%,1
高雄市,左營區,0614,1011,325,1336,60,1396,2289,60.99%,44.17%,1
高雄市,左營區,0615,881,245,1126,49,1175,1973,59.55%,44.65%,1
高雄市,左營區,0616,802,232,1034,93,1127,1818,61.99%,44.11%,1
高雄市,左營區,0617,666,192,858,31,889,1565,56.81%,42.56%,1
高雄市,左營區,0618,811,192,1003,45,1048,1608,65.17%,50.44%,1
高雄市,左營區,0619,864,240,1104,71,1175,1812,64.85%,47.68%,1
高雄市,左營區,0620,768,195,963,25,988,1821,54.26%,42.17%,1
高雄市,左營區,0621,840,268,1108,72,1180,1907,61.88%,44.05%,1
高雄市,左營區,0622,829,167,996,53,1049,1812,57.89%,45.75%,1
高雄市,左營區,0623,876,227,1103,50,1153,1833,62.9%,47.79%,1
高雄市,左營區,0624,818,264,1082,72,1154,1850,62.38%,44.22%,1
高雄市,左營區,0625,737,210,947,79,1026,1738,59.03%,42.41%,1
高雄市,左營區,0626,888,247,1135,62,1197,1864,64.22%,47.64%,1
高雄市,左營區,0627,873,254,1127,63,1190,1887,63.06%,46.26%,1
高雄市,左營區,0628,810,203,1013,31,1044,1870,55.83%,43.32%,1
高雄市,左營區,0629,849,201,1050,32,1082,1866,57.98%,45.5%,1
高雄市,左營區,0630,798,238,1036,22,1058,1862,56.82%,42.86%,1
高雄市,左營區,0631,834,222,1056,39,1095,1816,60.3%,45.93%,1
高雄市,左營區,0632,791,224,1015,47,1062,1833,57.94%,43.15%,1
高雄市,左營區,0633,742,240,982,72,1054,1676,62.89%,44.27%,1
高雄市,左營區,0634,839,228,1067,66,1133,1843,61.48%,45.52%,1
高雄市,左營區,0635,884,227,1111,43,1154,1872,61.65%,47.22%,1
高雄市,左營區,0636,1013,266,1279,59,1338,2259,59.23%,44.84%,1
高雄市,楠梓區,0435,681,86,767,52,819,1309,62.57%,52.02%,1
高雄市,楠梓區,0436,598,194,792,29,821,1408,58.31%,42.47%,1
高雄市,楠梓區,0437,772,266,1038,58,1096,1851,59.21%,41.71%,1
高雄市,楠梓區,0438,655,248,903,75,978,1578,61.98%,41.51%,1
高雄市,楠梓區,0439,714,210,924,42,966,1715,56.33%,41.63%,1
高雄市,楠梓區,0440,651,206,857,30,887,1611,55.06%,40.41%,1
高雄市,楠梓區,0441,824,213,1037,72,1109,2024,54.79%,40.71%,1
高雄市,楠梓區,0442,749,214,963,39,1002,1890,53.02%,39.63%,1
高雄市,楠梓區,0443,658,193,851,25,876,1762,49.72%,37.34%,1
高雄市,楠梓區,0444,743,219,962,75,1037,1888,54.93%,39.35%,1
高雄市,楠梓區,0445,719,227,946,84,1030,1822,56.53%,39.46%,1
高雄市,楠梓區,0446,743,228,971,67,1038,1846,56.23%,40.25%,1
高雄市,楠梓區,0447,573,174,747,73,820,1268,64.67%,45.19%,1
高雄市,楠梓區,0448,580,169,749,56,805,1240,64.92%,46.77%,1
高雄市,楠梓區,0449,611,236,847,35,882,1432,61.59%,42.67%,1
高雄市,楠梓區,0450,641,178,819,62,881,1490,59.13%,43.02%,1
高雄市,楠梓區,0451,664,188,852,56,908,1464,62.02%,45.36%,1
高雄市,楠梓區,0452,523,210,733,84,817,1435,56.93%,36.45%,1
高雄市,楠梓區,0453,629,187,816,83,899,1602,56.12%,39.26%,1
高雄市,楠梓區,0454,580,205,785,62,847,1500,56.47%,38.67%,1
高雄市,楠梓區,0455,606,216,822,106,928,1591,58.33%,38.09%,1
高雄市,楠梓區,0456,410,185,595,63,658,1669,39.42%,24.57%,1
高雄市,楠梓區,0457,623,207,830,68,898,1469,61.13%,42.41%,1
高雄市,楠梓區,0458,593,196,789,97,886,1559,56.83%,38.04%,1
高雄市,楠梓區,0459,612,226,838,94,932,1638,56.9%,37.36%,1
高雄市,楠梓區,0460,802,270,1072,88,1160,1960,59.18%,40.92%,1
高雄市,楠梓區,0461,731,264,995,151,1146,1912,59.94%,38.23%,1
高雄市,楠梓區,0462,649,182,831,65,896,1559,57.47%,41.63%,1
高雄市,楠梓區,0463,595,154,749,53,802,1423,56.36%,41.81%,1
高雄市,楠梓區,0464,742,202,944,46,990,1696,58.37%,43.75%,1
高雄市,楠梓區,0465,504,215,719,156,875,1493,58.61%,33.76%,1
高雄市,楠梓區,0466,577,249,826,107,933,1527,61.1%,37.79%,1
高雄市,楠梓區,0467,395,180,575,79,654,1020,64.12%,38.73%,1
高雄市,楠梓區,0468,435,190,625,86,711,1197,59.4%,36.34%,1
高雄市,楠梓區,0469,494,246,740,99,839,1528,54.91%,32.33%,1
高雄市,楠梓區,0470,608,263,871,118,989,1918,51.56%,31.7%,1
高雄市,楠梓區,0471,418,200,618,113,731,1458,50.14%,28.67%,1
高雄市,楠梓區,0472,742,269,1011,112,1123,1790,62.74%,41.45%,1
高雄市,楠梓區,0473,818,241,1059,87,1146,1845,62.11%,44.34%,1
高雄市,楠梓區,0474,871,261,1132,85,1217,2037,59.74%,42.76%,1
高雄市,楠梓區,0475,825,218,1043,65,1108,1964,56.42%,42.01%,1
高雄市,楠梓區,0476,831,227,1058,50,1108,2006,55.23%,41.43%,1
高雄市,楠梓區,0477,790,256,1046,63,1109,1951,56.84%,40.49%,1
高雄市,楠梓區,0478,823,200,1023,68,1091,1951,55.92%,42.18%,1
高雄市,楠梓區,0479,894,223,1117,86,1203,2008,59.91%,44.52%,1
高雄市,楠梓區,0480,825,235,1060,102,1162,1923,60.43%,42.9%,1
高雄市,楠梓區,0481,874,206,1080,66,1146,1921,59.66%,45.5%,1
高雄市,楠梓區,0482,382,139,521,35,556,832,66.83%,45.91%,1
高雄市,楠梓區,0483,435,193,628,61,689,1156,59.6%,37.63%,1
高雄市,楠梓區,0484,438,200,638,63,701,1125,62.31%,38.93%,1
高雄市,楠梓區,0485,430,181,611,64,675,1060,63.68%,40.57%,1
高雄市,楠梓區,0486,663,211,874,68,942,1502,62.72%,44.14%,1
高雄市,楠梓區,0487,545,215,760,98,858,1404,61.11%,38.82%,1
高雄市,楠梓區,0488,578,163,741,84,825,1552,53.16%,37.24%,1
高雄市,楠梓區,0489,576,187,763,79,842,1460,57.67%,39.45%,1
高雄市,楠梓區,0490,513,136,649,73,722,1315,54.9%,39.01%,1
高雄市,楠梓區,0491,450,145,595,74,669,1062,62.99%,42.37%,1
高雄市,楠梓區,0492,469,119,588,72,660,1078,61.22%,43.51%,1
高雄市,楠梓區,0493,384,132,516,94,610,914,66.74%,42.01%,1
高雄市,楠梓區,0494,458,146,604,104,708,1064,66.54%,43.05%,1
高雄市,楠梓區,0495,709,234,943,96,1039,1705,60.94%,41.58%,1
高雄市,楠梓區,0496,784,191,975,69,1044,1728,60.42%,45.37%,1
高雄市,楠梓區,0497,869,203,1072,81,1153,1917,60.15%,45.33%,1
高雄市,楠梓區,0498,536,171,707,108,815,1439,56.64%,37.25%,1
高雄市,楠梓區,0499,564,162,726,87,813,1287,63.17%,43.82%,1
高雄市,楠梓區,0500,675,195,870,88,958,1504,63.7%,44.88%,1
高雄市,楠梓區,0501,689,166,855,76,931,1405,66.26%,49.04%,1
高雄市,楠梓區,0502,509,188,697,88,785,1287,60.99%,39.55%,1
高雄市,楠梓區,0503,577,167,744,58,802,1295,61.93%,44.56%,1
高雄市,楠梓區,0504,646,212,858,69,927,1483,62.51%,43.56%,1
高雄市,楠梓區,0505,790,227,1017,74,1091,1649,66.16%,47.91%,1
高雄市,楠梓區,0506,438,132,570,79,649,998,65.03%,43.89%,1
高雄市,楠梓區,0507,459,140,599,71,670,1025,65.37%,44.78%,1
高雄市,楠梓區,0508,778,231,1009,87,1096,1671,65.59%,46.56%,1
高雄市,楠梓區,0509,625,229,854,102,956,1453,65.79%,43.01%,1
高雄市,楠梓區,0510,656,228,884,101,985,1673,58.88%,39.21%,1
高雄市,楠梓區,0511,716,168,884,63,947,1653,57.29%,43.32%,1
高雄市,楠梓區,0512,448,133,581,60,641,1034,61.99%,43.33%,1
高雄市,楠梓區,0513,544,165,709,68,777,1127,68.94%,48.27%,1
高雄市,楠梓區,0514,625,190,815,99,914,1575,58.03%,39.68%,1
高雄市,楠梓區,0515,665,210,875,74,949,1559,60.87%,42.66%,1
高雄市,楠梓區,0516,558,171,729,62,791,1378,57.4%,40.49%,1
高雄市,楠梓區,0517,708,236,944,87,1031,1714,60.15%,41.31%,1
高雄市,楠梓區,0518,724,219,943,87,1030,1721,59.85%,42.07%,1
高雄市,楠梓區,0519,698,203,901,77,978,1628,60.07%,42.87%,1
高雄市,楠梓區,0520,765,212,977,90,1067,1590,67.11%,48.11%,1
高雄市,楠梓區,0521,722,196,918,77,995,1628,61.12%,44.35%,1
高雄市,楠梓區,0522,822,254,1076,50,1126,1739,64.75%,47.27%,1
高雄市,楠梓區,0523,794,195,989,75,1064,1642,64.8%,48.36%,1
高雄市,楠梓區,0524,695,203,898,88,986,1766,55.83%,39.35%,1
高雄市,楠梓區,0525,628,145,773,85,858,1482,57.89%,42.38%,1
高雄市,楠梓區,0526,715,160,875,40,915,1749,52.32%,40.88%,1
高雄市,楠梓區,0527,690,217,907,57,964,1591,60.59%,43.37%,1
高雄市,楠梓區,0528,758,189,947,45,992,1545,64.21%,49.06%,1
高雄市,楠梓區,0529,803,222,1025,45,1070,1651,64.81%,48.64%,1
高雄市,楠梓區,0530,769,217,986,67,1053,1646,63.97%,46.72%,1
高雄市,楠梓區,0531,637,124,761,97,858,1496,57.35%,42.58%,1
高雄市,楠梓區,0532,517,181,698,103,801,1403,57.09%,36.85%,1
高雄市,楠梓區,0533,668,208,876,66,942,1624,58%,41.13%,1
高雄市,三民區,0887,730,262,992,99,1091,1893,57.63%,38.56%,1
高雄市,三民區,0888,721,231,952,109,1061,1982,53.53%,36.38%,1
高雄市,三民區,0889,673,208,881,89,970,1661,58.4%,40.52%,1
高雄市,三民區,0890,749,219,968,32,1000,1894,52.8%,39.55%,1
高雄市,三民區,0891,730,240,970,70,1040,1839,56.55%,39.7%,1
高雄市,三民區,0892,798,279,1077,78,1155,2014,57.35%,39.62%,1
高雄市,三民區,0893,732,252,984,133,1117,1897,58.88%,38.59%,1
高雄市,三民區,0894,691,279,970,63,1033,2016,51.24%,34.28%,1
高雄市,三民區,0895,733,249,982,62,1044,1924,54.26%,38.1%,1
高雄市,三民區,0896,707,240,947,84,1031,1749,58.95%,40.42%,1
高雄市,三民區,0897,840,253,1093,77,1170,1845,63.41%,45.53%,1
高雄市,三民區,0898,649,197,846,53,899,1724,52.15%,37.65%,1
高雄市,三民區,0899,771,245,1016,55,1071,1889,56.7%,40.82%,1
高雄市,三民區,0900,637,230,867,82,949,1622,58.51%,39.27%,1
高雄市,三民區,0901,743,267,1010,46,1056,1870,56.47%,39.73%,1
高雄市,三民區,0902,641,238,879,78,957,1523,62.84%,42.09%,1
高雄市,三民區,0903,703,246,949,70,1019,2006,50.8%,35.04%,1
高雄市,三民區,0904,936,282,1218,85,1303,2076,62.76%,45.09%,1
高雄市,三民區,0905,887,244,1131,38,1169,2073,56.39%,42.79%,1
高雄市,三民區,0906,881,238,1119,81,1200,2045,58.68%,43.08%,1
高雄市,三民區,0907,710,245,955,86,1041,2070,50.29%,34.3%,1
高雄市,三民區,0908,743,291,1034,80,1114,2035,54.74%,36.51%,1
高雄市,三民區,0909,920,298,1218,63,1281,2075,61.73%,44.34%,1
高雄市,三民區,0910,926,232,1158,24,1182,2053,57.57%,45.1%,1
高雄市,三民區,0911,946,272,1218,79,1297,2063,62.87%,45.86%,1
高雄市,三民區,0912,995,268,1263,75,1338,2143,62.44%,46.43%,1
高雄市,三民區,0913,726,271,997,95,1092,1746,62.54%,41.58%,1
高雄市,三民區,0914,617,218,835,31,866,1735,49.91%,35.56%,1
高雄市,三民區,0915,624,214,838,79,917,1655,55.41%,37.7%,1
高雄市,三民區,0916,661,214,875,70,945,1583,59.7%,41.76%,1
高雄市,三民區,0917,740,218,958,55,1013,1800,56.28%,41.11%,1
高雄市,三民區,0918,743,222,965,49,1014,1730,58.61%,42.95%,1
高雄市,三民區,0919,681,230,911,41,952,1715,55.51%,39.71%,1
高雄市,三民區,0920,662,277,939,66,1005,1691,59.43%,39.15%,1
高雄市,三民區,0921,795,241,1036,66,1102,1865,59.09%,42.63%,1
高雄市,三民區,0922,481,170,651,42,693,1073,64.59%,44.83%,1
高雄市,三民區,0923,408,159,567,65,632,917,68.92%,44.49%,1
高雄市,三民區,0924,623,281,904,73,977,1647,59.32%,37.83%,1
高雄市,三民區,0925,682,231,913,90,1003,1654,60.64%,41.23%,1
高雄市,三民區,0926,651,248,899,57,956,1639,58.33%,39.72%,1
高雄市,三民區,0927,808,228,1036,69,1105,1833,60.28%,44.08%,1
高雄市,三民區,0928,636,204,840,38,878,1362,64.46%,46.7%,1
高雄市,三民區,0929,700,223,923,69,992,1557,63.71%,44.96%,1
高雄市,三民區,0930,645,222,867,25,892,1482,60.19%,43.52%,1
高雄市,三民區,0931,672,248,920,47,967,1563,61.87%,42.99%,1
高雄市,三民區,0932,622,229,851,45,896,1497,59.85%,41.55%,1
高雄市,三民區,0933,689,220,909,42,951,1523,62.44%,45.24%,1
高雄市,三民區,0934,581,218,799,63,862,1293,66.67%,44.93%,1
高雄市,三民區,0935,756,231,987,58,1045,1662,62.88%,45.49%,1
高雄市,三民區,0936,603,193,796,63,859,1441,59.61%,41.85%,1
高雄市,三民區,0937,618,216,834,58,892,1326,67.27%,46.61%,1
高雄市,三民區,0938,647,253,900,43,943,1476,63.89%,43.83%,1
高雄市,三民區,0939,720,226,946,41,987,1968,50.15%,36.59%,1
高雄市,三民區,0940,582,207,789,35,824,1618,50.93%,35.97%,1
高雄市,三民區,0941,771,237,1008,69,1077,1873,57.5%,41.16%,1
高雄市,三民區,0942,608,220,828,72,900,1487,60.52%,40.89%,1
高雄市,三民區,0943,603,241,844,34,878,1640,53.54%,36.77%,1
高雄市,三民區,0944,740,215,955,40,995,1889,52.67%,39.17%,1
高雄市,三民區,0945,777,218,995,45,1040,1969,52.82%,39.46%,1
高雄市,三民區,0946,571,201,772,103,875,1466,59.69%,38.95%,1
高雄市,三民區,0947,741,245,986,60,1046,1697,61.64%,43.67%,1
高雄市,三民區,0948,698,225,923,83,1006,1663,60.49%,41.97%,1
高雄市,三民區,0949,679,226,905,52,957,1649,58.04%,41.18%,1
高雄市,三民區,0950,574,200,774,49,823,1486,55.38%,38.63%,1
高雄市,三民區,0951,568,197,765,33,798,1495,53.38%,37.99%,1
高雄市,三民區,0952,748,224,972,26,998,1548,64.47%,48.32%,1
高雄市,三民區,0953,582,212,794,40,834,1493,55.86%,38.98%,1
高雄市,三民區,0954,647,198,845,40,885,1445,61.25%,44.78%,1
高雄市,三民區,0955,668,55,723,46,769,1529,50.29%,43.69%,1
高雄市,三民區,0956,616,180,796,37,833,1506,55.31%,40.9%,1
高雄市,三民區,0957,700,206,906,67,973,1549,62.81%,45.19%,1
高雄市,三民區,0958,715,237,952,78,1030,1620,63.58%,44.14%,1
高雄市,三民區,0959,676,239,915,64,979,1550,63.16%,43.61%,1
高雄市,三民區,0960,657,224,881,57,938,1488,63.04%,44.15%,1
高雄市,三民區,0961,582,180,762,62,824,1335,61.72%,43.6%,1
高雄市,三民區,0962,577,176,753,63,816,1332,61.26%,43.32%,1
高雄市,三民區,0963,702,269,971,106,1077,1764,61.05%,39.8%,1
高雄市,三民區,0964,742,247,989,49,1038,1811,57.32%,40.97%,1
高雄市,三民區,0965,733,250,983,88,1071,1693,63.26%,43.3%,1
高雄市,三民區,0966,710,284,994,89,1083,1684,64.31%,42.16%,1
高雄市,三民區,0967,599,176,775,65,840,1464,57.38%,40.92%,1
高雄市,三民區,0968,780,284,1064,43,1107,1719,64.4%,45.38%,1
高雄市,三民區,0969,725,240,965,33,998,1749,57.06%,41.45%,1
高雄市,三民區,0970,766,219,985,48,1033,1908,54.14%,40.15%,1
高雄市,三民區,0971,700,202,902,62,964,1573,61.28%,44.5%,1
高雄市,三民區,0972,643,218,861,54,915,1628,56.2%,39.5%,1
高雄市,三民區,0973,476,170,646,61,707,1377,51.34%,34.57%,1
高雄市,三民區,0974,695,209,904,60,964,1530,63.01%,45.42%,1
高雄市,三民區,0975,465,140,605,64,669,1188,56.31%,39.14%,1
高雄市,三民區,0976,568,213,781,40,821,2791,29.42%,20.35%,1
高雄市,三民區,0977,772,248,1020,75,1095,1840,59.51%,41.96%,1
高雄市,三民區,0978,704,226,930,113,1043,1671,62.42%,42.13%,1
高雄市,三民區,0979,674,232,906,74,980,1624,60.34%,41.5%,1
高雄市,三民區,0980,747,243,990,68,1058,1555,68.04%,48.04%,1
高雄市,三民區,0981,679,241,920,61,981,1489,65.88%,45.6%,1
高雄市,三民區,0982,744,222,966,71,1037,1662,62.39%,44.77%,1
高雄市,三民區,0983,675,202,877,32,909,1639,55.46%,41.18%,1
高雄市,三民區,0984,718,277,995,95,1090,1872,58.23%,38.35%,1
高雄市,三民區,0985,831,247,1078,74,1152,1968,58.54%,42.23%,1
高雄市,三民區,0986,518,147,665,121,786,1471,53.43%,35.21%,1
高雄市,三民區,0987,596,199,795,79,874,1534,56.98%,38.85%,1
高雄市,三民區,0988,623,177,800,105,905,1659,54.55%,37.55%,1
高雄市,三民區,0989,648,195,843,54,897,1815,49.42%,35.7%,1
高雄市,三民區,0990,676,216,892,62,954,1808,52.77%,37.39%,1
高雄市,三民區,0991,426,167,593,48,641,1224,52.37%,34.8%,1
高雄市,三民區,0992,548,187,735,37,772,1406,54.91%,38.98%,1
高雄市,三民區,0993,347,143,490,30,520,945,55.03%,36.72%,1
高雄市,三民區,0994,393,151,544,49,593,944,62.82%,41.63%,1
高雄市,三民區,0995,621,261,882,86,968,1669,58%,37.21%,1
高雄市,三民區,0996,552,254,806,107,913,1473,61.98%,37.47%,1
高雄市,三民區,0997,658,225,883,74,957,1876,51.01%,35.07%,1
高雄市,三民區,0998,430,158,588,67,655,1682,38.94%,25.56%,1
高雄市,三民區,0999,652,263,915,49,964,1791,53.82%,36.4%,1
高雄市,三民區,1000,737,281,1018,73,1091,1808,60.34%,40.76%,1
高雄市,三民區,1001,684,229,913,74,987,1798,54.89%,38.04%,1
高雄市,三民區,1002,835,290,1125,72,1197,2030,58.97%,41.13%,1
高雄市,三民區,1003,860,256,1116,28,1144,2034,56.24%,42.28%,1
高雄市,三民區,1004,840,250,1090,47,1137,1998,56.91%,42.04%,1
高雄市,三民區,1005,731,211,942,39,981,1914,51.25%,38.19%,1
高雄市,三民區,1006,767,233,1000,58,1058,1965,53.84%,39.03%,1
高雄市,三民區,1007,805,186,991,104,1095,1885,58.09%,42.71%,1
高雄市,三民區,1008,516,177,693,22,715,1220,58.61%,42.3%,1
高雄市,三民區,1009,382,163,545,86,631,1057,59.7%,36.14%,1
高雄市,三民區,1010,456,160,616,33,649,1434,45.26%,31.8%,1
高雄市,三民區,1011,453,131,584,54,638,1350,47.26%,33.56%,1
高雄市,三民區,1012,277,98,375,25,400,872,45.87%,31.77%,1
高雄市,三民區,1013,347,123,470,25,495,954,51.89%,36.37%,1
高雄市,三民區,1014,567,308,875,32,907,1689,53.7%,33.57%,1
高雄市,三民區,1015,524,213,737,28,765,1390,55.04%,37.7%,1
高雄市,三民區,1016,512,231,743,62,805,1336,60.25%,38.32%,1
高雄市,三民區,1017,643,241,884,63,947,1437,65.9%,44.75%,1
高雄市,三民區,1018,584,210,794,43,837,1452,57.64%,40.22%,1
高雄市,三民區,1019,607,238,845,90,935,1513,61.8%,40.12%,1
高雄市,三民區,1020,608,247,855,107,962,1467,65.58%,41.45%,1
高雄市,三民區,1021,584,257,841,95,936,1381,67.78%,42.29%,1
高雄市,三民區,1022,457,141,598,58,656,1117,58.73%,40.91%,1
高雄市,三民區,1023,547,217,764,45,809,1327,60.96%,41.22%,1
高雄市,三民區,1024,521,208,729,48,777,1304,59.59%,39.95%,1
高雄市,三民區,1025,499,224,723,42,765,1483,51.58%,33.65%,1
高雄市,三民區,1026,610,233,843,59,902,1473,61.24%,41.41%,1
高雄市,三民區,1027,396,149,545,41,586,980,59.8%,40.41%,1
高雄市,三民區,1028,583,211,794,76,870,1409,61.75%,41.38%,1
高雄市,三民區,1029,477,215,692,58,750,1230,60.98%,38.78%,1
高雄市,三民區,1030,433,177,610,73,683,1024,66.7%,42.29%,1
高雄市,三民區,1031,456,189,645,67,712,1130,63.01%,40.35%,1
高雄市,三民區,1032,658,256,914,45,959,1889,50.77%,34.83%,1
高雄市,三民區,1033,551,227,778,41,819,1427,57.39%,38.61%,1
高雄市,三民區,1034,318,128,446,23,469,791,59.29%,40.2%,1
高雄市,三民區,1035,474,185,659,95,754,1079,69.88%,43.93%,1
高雄市,三民區,1036,550,252,802,92,894,1492,59.92%,36.86%,1
高雄市,三民區,1037,421,168,589,66,655,1020,64.22%,41.27%,1
高雄市,三民區,1038,399,160,559,17,576,1001,57.54%,39.86%,1
高雄市,三民區,1039,629,219,848,61,909,1581,57.5%,39.78%,1
高雄市,三民區,1040,565,213,778,50,828,1471,56.29%,38.41%,1
高雄市,三民區,1041,451,168,619,35,654,1151,56.82%,39.18%,1
高雄市,三民區,1042,542,225,767,79,846,1334,63.42%,40.63%,1
高雄市,三民區,1043,537,183,720,51,771,1275,60.47%,42.12%,1
高雄市,三民區,1044,485,224,709,52,761,1688,45.08%,28.73%,1
高雄市,三民區,1045,455,195,650,42,692,1214,57%,37.48%,1
高雄市,三民區,1046,507,184,691,32,723,1149,62.92%,44.13%,1
高雄市,三民區,1047,636,260,896,110,1006,1667,60.35%,38.15%,1
高雄市,三民區,1048,620,247,867,42,909,1786,50.9%,34.71%,1
高雄市,三民區,1049,363,144,507,30,537,896,59.93%,40.51%,1
高雄市,三民區,1050,391,125,516,63,579,925,62.59%,42.27%,1
高雄市,三民區,1051,298,114,412,60,472,684,69.01%,43.57%,1
高雄市,三民區,1052,593,1,594,66,660,981,67.28%,60.45%,1
高雄市,三民區,1053,472,189,661,96,757,1383,54.74%,34.13%,1
高雄市,三民區,1054,526,198,724,67,791,1382,57.24%,38.06%,1
高雄市,三民區,1055,306,103,409,40,449,808,55.57%,37.87%,1
高雄市,三民區,1056,489,188,677,32,709,1197,59.23%,40.85%,1
高雄市,三民區,1057,529,165,694,65,759,1344,56.47%,39.36%,1
高雄市,三民區,1058,515,231,746,67,813,1344,60.49%,38.32%,1
高雄市,三民區,1059,577,178,755,24,779,1359,57.32%,42.46%,1
高雄市,三民區,1060,448,172,620,62,682,1073,63.56%,41.75%,1
高雄市,三民區,1061,454,155,609,61,670,1186,56.49%,38.28%,1
高雄市,三民區,1062,692,246,938,93,1031,1749,58.95%,39.57%,1
高雄市,三民區,1063,312,114,426,21,447,877,50.97%,35.58%,1
高雄市,三民區,1064,563,233,796,114,910,1402,64.91%,40.16%,1
高雄市,三民區,1065,331,127,458,28,486,769,63.2%,43.04%,1
高雄市,三民區,1066,501,172,673,73,746,1207,61.81%,41.51%,1
高雄市,三民區,1067,449,157,606,51,657,1270,51.73%,35.35%,1
高雄市,三民區,1068,494,169,663,62,725,1248,58.09%,39.58%,1
高雄市,三民區,1069,530,160,690,94,784,1263,62.07%,41.96%,1
高雄市,三民區,1070,434,166,600,43,643,1101,58.4%,39.42%,1
高雄市,三民區,1071,475,145,620,30,650,1116,58.24%,42.56%,1
高雄市,三民區,1072,465,160,625,40,665,1152,57.73%,40.36%,1
高雄市,三民區,1073,429,147,576,86,662,1057,62.63%,40.59%,1
高雄市,三民區,1074,329,133,462,56,518,971,53.35%,33.88%,1
高雄市,三民區,1075,403,141,544,28,572,1062,53.86%,37.95%,1
高雄市,新興區,1098,336,120,456,36,492,828,59.42%,40.58%,1
高雄市,新興區,1099,414,152,566,68,634,963,65.84%,42.99%,1
高雄市,新興區,1100,397,145,542,37,579,1075,53.86%,36.93%,1
高雄市,新興區,1101,621,208,829,32,861,1488,57.86%,41.73%,1
高雄市,新興區,1102,601,201,802,43,845,1438,58.76%,41.79%,1
高雄市,新興區,1103,446,164,610,31,641,1049,61.11%,42.52%,1
高雄市,新興區,1104,556,264,820,93,913,1378,66.26%,40.35%,1
高雄市,新興區,1105,300,96,396,40,436,666,65.47%,45.05%,1
高雄市,新興區,1106,368,204,572,32,604,981,61.57%,37.51%,1
高雄市,新興區,1107,404,166,570,39,609,933,65.27%,43.3%,1
高雄市,新興區,1108,410,124,534,29,563,987,57.04%,41.54%,1
高雄市,新興區,1109,435,132,567,46,613,988,62.04%,44.03%,1
高雄市,新興區,1110,325,112,437,45,482,735,65.58%,44.22%,1
高雄市,新興區,1111,513,226,739,41,780,1317,59.23%,38.95%,1
高雄市,新興區,1112,296,86,382,23,405,800,50.63%,37%,1
高雄市,新興區,1113,389,165,554,43,597,968,61.67%,40.19%,1
高雄市,新興區,1114,396,131,527,29,556,913,60.9%,43.37%,1
高雄市,新興區,1115,564,247,811,37,848,1389,61.05%,40.6%,1
高雄市,新興區,1116,557,217,774,52,826,1228,67.26%,45.36%,1
高雄市,新興區,1117,498,179,677,90,767,1211,63.34%,41.12%,1
高雄市,新興區,1118,475,149,624,19,643,1101,58.4%,43.14%,1
高雄市,新興區,1119,338,112,450,22,472,752,62.77%,44.95%,1
高雄市,新興區,1120,412,155,567,53,620,873,71.02%,47.19%,1
高雄市,新興區,1121,647,279,926,45,971,1609,60.35%,40.21%,1
高雄市,新興區,1122,750,277,1027,61,1088,1736,62.67%,43.2%,1
高雄市,新興區,1123,512,160,672,27,699,1258,55.56%,40.7%,1
高雄市,新興區,1124,463,167,630,59,689,1105,62.35%,41.9%,1
高雄市,新興區,1125,303,139,442,63,505,851,59.34%,35.61%,1
高雄市,新興區,1126,411,173,584,50,634,1011,62.71%,40.65%,1
高雄市,新興區,1127,376,160,536,81,617,888,69.48%,42.34%,1
高雄市,新興區,1128,397,133,530,34,564,1005,56.12%,39.5%,1
高雄市,新興區,1129,420,156,576,21,597,1375,43.42%,30.55%,1
高雄市,新興區,1130,558,214,772,81,853,1388,61.46%,40.2%,1
高雄市,新興區,1131,269,102,371,57,428,719,59.53%,37.41%,1
高雄市,新興區,1132,391,170,561,86,647,1077,60.07%,36.3%,1
高雄市,新興區,1133,295,113,408,18,426,875,48.69%,33.71%,1
高雄市,新興區,1134,357,121,478,24,502,936,53.63%,38.14%,1
高雄市,新興區,1135,358,130,488,65,553,944,58.58%,37.92%,1
高雄市,新興區,1136,289,119,408,34,442,833,53.06%,34.69%,1
高雄市,新興區,1137,284,108,392,16,408,708,57.63%,40.11%,1
高雄市,新興區,1138,319,83,402,20,422,741,56.95%,43.05%,1
高雄市,新興區,1139,408,186,594,37,631,1235,51.09%,33.04%,1
高雄市,前金區,1076,238,101,339,15,354,673,52.6%,35.36%,1
高雄市,前金區,1077,472,123,595,27,622,1022,60.86%,46.18%,1
高雄市,前金區,1078,505,161,666,46,712,1324,53.78%,38.14%,1
高雄市,前金區,1079,327,126,453,55,508,839,60.55%,38.97%,1
高雄市,前金區,1080,369,152,521,74,595,975,61.03%,37.85%,1
高雄市,前金區,1081,772,213,985,75,1060,1806,58.69%,42.75%,1
高雄市,前金區,1082,738,242,980,43,1023,1781,57.44%,41.44%,1
高雄市,前金區,1083,295,121,416,34,450,717,62.76%,41.14%,1
高雄市,前金區,1084,430,158,588,24,612,1097,55.79%,39.2%,1
高雄市,前金區,1085,637,240,877,38,915,1633,56.03%,39.01%,1
高雄市,前金區,1086,355,125,480,34,514,759,67.72%,46.77%,1
高雄市,前金區,1087,404,170,574,59,633,948,66.77%,42.62%,1
高雄市,前金區,1088,340,140,480,81,561,1009,55.6%,33.7%,1
高雄市,前金區,1089,388,133,521,46,567,945,60%,41.06%,1
高雄市,前金區,1090,334,112,446,21,467,772,60.49%,43.26%,1
高雄市,前金區,1091,321,136,457,32,489,757,64.6%,42.4%,1
高雄市,前金區,1092,459,153,612,37,649,1047,61.99%,43.84%,1
高雄市,前金區,1093,415,158,573,52,625,985,63.45%,42.13%,1
高雄市,前金區,1094,650,224,874,30,904,1674,54%,38.83%,1
高雄市,前金區,1095,425,159,584,34,618,1088,56.8%,39.06%,1
高雄市,前金區,1096,395,146,541,59,600,893,67.19%,44.23%,1
高雄市,前金區,1097,445,171,616,37,653,1184,55.15%,37.58%,1
高雄市,苓雅區,1140,301,119,420,27,447,718,62.26%,41.92%,1
高雄市,苓雅區,1141,647,158,805,46,851,1492,57.04%,43.36%,1
高雄市,苓雅區,1142,514,165,679,50,729,1210,60.25%,42.48%,1
高雄市,苓雅區,1143,568,190,758,38,796,1617,49.23%,35.13%,1
高雄市,苓雅區,1144,602,189,791,86,877,1428,61.41%,42.16%,1
高雄市,苓雅區,1145,483,194,677,53,730,1444,50.55%,33.45%,1
高雄市,苓雅區,1146,585,201,786,75,861,1452,59.3%,40.29%,1
高雄市,苓雅區,1147,232,81,313,42,355,554,64.08%,41.88%,1
高雄市,苓雅區,1148,355,147,502,20,522,950,54.95%,37.37%,1
高雄市,苓雅區,1149,336,155,491,23,514,978,52.56%,34.36%,1
高雄市,苓雅區,1150,609,191,800,41,841,1673,50.27%,36.4%,1
高雄市,苓雅區,1151,725,270,995,74,1069,2045,52.27%,35.45%,1
高雄市,苓雅區,1152,381,138,519,72,591,939,62.94%,40.58%,1
高雄市,苓雅區,1153,487,165,652,42,694,1284,54.05%,37.93%,1
高雄市,苓雅區,1154,388,123,511,31,542,908,59.69%,42.73%,1
高雄市,苓雅區,1155,333,106,439,18,457,838,54.53%,39.74%,1
高雄市,苓雅區,1156,519,191,710,39,749,1267,59.12%,40.96%,1
高雄市,苓雅區,1157,420,168,588,58,646,994,64.99%,42.25%,1
高雄市,苓雅區,1158,245,139,384,23,407,774,52.58%,31.65%,1
高雄市,苓雅區,1159,461,163,624,33,657,1121,58.61%,41.12%,1
高雄市,苓雅區,1160,572,226,798,63,861,1474,58.41%,38.81%,1
高雄市,苓雅區,1161,631,229,860,73,933,1525,61.18%,41.38%,1
高雄市,苓雅區,1162,460,154,614,36,650,1147,56.67%,40.1%,1
高雄市,苓雅區,1163,436,166,602,38,640,1014,63.12%,43%,1
高雄市,苓雅區,1164,584,260,844,62,906,1496,60.56%,39.04%,1
高雄市,苓雅區,1165,627,239,866,74,940,1499,62.71%,41.83%,1
高雄市,苓雅區,1166,509,160,669,25,694,1138,60.98%,44.73%,1
高雄市,苓雅區,1167,396,145,541,37,578,839,68.89%,47.2%,1
高雄市,苓雅區,1168,511,160,671,50,721,2088,34.53%,24.47%,1
高雄市,苓雅區,1169,694,259,953,11,964,1648,58.5%,42.11%,1
高雄市,苓雅區,1170,654,223,877,71,948,1623,58.41%,40.3%,1
高雄市,苓雅區,1171,898,286,1184,67,1251,1932,64.75%,46.48%,1
高雄市,苓雅區,1172,552,181,733,26,759,1127,67.35%,48.98%,1
高雄市,苓雅區,1173,565,178,743,25,768,1156,66.44%,48.88%,1
高雄市,苓雅區,1174,623,238,861,37,898,1465,61.3%,42.53%,1
高雄市,苓雅區,1175,245,89,334,26,360,690,52.17%,35.51%,1
高雄市,苓雅區,1176,456,176,632,103,735,1283,57.29%,35.54%,1
高雄市,苓雅區,1177,563,217,780,82,862,1432,60.2%,39.32%,1
高雄市,苓雅區,1178,543,194,737,48,785,1313,59.79%,41.36%,1
高雄市,苓雅區,1179,570,230,800,31,831,1579,52.63%,36.1%,1
高雄市,苓雅區,1180,533,228,761,73,834,1385,60.22%,38.48%,1
高雄市,苓雅區,1181,650,179,829,71,900,1449,62.11%,44.86%,1
高雄市,苓雅區,1182,818,273,1091,52,1143,1834,62.32%,44.6%,1
高雄市,苓雅區,1183,602,284,886,11,897,1436,62.47%,41.92%,1
高雄市,苓雅區,1184,628,228,856,60,916,1431,64.01%,43.89%,1
高雄市,苓雅區,1185,567,200,767,24,791,1248,63.38%,45.43%,1
高雄市,苓雅區,1186,666,218,884,48,932,1470,63.4%,45.31%,1
高雄市,苓雅區,1187,713,213,926,89,1015,1540,65.91%,46.3%,1
高雄市,苓雅區,1188,613,208,821,35,856,1374,62.3%,44.61%,1
高雄市,苓雅區,1189,398,129,527,25,552,839,65.79%,47.44%,1
高雄市,苓雅區,1190,485,162,647,42,689,1022,67.42%,47.46%,1
高雄市,苓雅區,1191,501,149,650,18,668,1062,62.9%,47.18%,1
高雄市,苓雅區,1192,471,153,624,25,649,1078,60.2%,43.69%,1
高雄市,苓雅區,1193,491,187,678,30,708,1117,63.38%,43.96%,1
高雄市,苓雅區,1194,634,242,876,60,936,1516,61.74%,41.82%,1
高雄市,苓雅區,1195,460,314,774,114,888,1440,61.67%,31.94%,1
高雄市,苓雅區,1196,340,130,470,42,512,839,61.03%,40.52%,1
高雄市,苓雅區,1197,354,110,464,25,489,888,55.07%,39.86%,1
高雄市,苓雅區,1198,467,189,656,36,692,1101,62.85%,42.42%,1
高雄市,苓雅區,1199,466,180,646,66,712,1004,70.92%,46.41%,1
高雄市,苓雅區,1200,596,207,803,67,870,1427,60.97%,41.77%,1
高雄市,苓雅區,1201,482,163,645,41,686,1168,58.73%,41.27%,1
高雄市,苓雅區,1202,535,197,732,63,795,1184,67.15%,45.19%,1
高雄市,苓雅區,1203,419,163,582,35,617,974,63.35%,43.02%,1
高雄市,苓雅區,1204,329,97,426,19,445,849,52.41%,38.75%,1
高雄市,苓雅區,1205,777,263,1040,59,1099,1821,60.35%,42.67%,1
高雄市,苓雅區,1206,582,191,773,58,831,1306,63.63%,44.56%,1
高雄市,苓雅區,1207,509,178,687,31,718,1185,60.59%,42.95%,1
高雄市,苓雅區,1208,566,230,796,48,844,1415,59.65%,40%,1
高雄市,苓雅區,1209,437,153,590,41,631,962,65.59%,45.43%,1
高雄市,苓雅區,1210,378,153,531,59,590,964,61.2%,39.21%,1
高雄市,苓雅區,1211,654,209,863,38,901,1524,59.12%,42.91%,1
高雄市,苓雅區,1212,615,216,831,40,871,1455,59.86%,42.27%,1
高雄市,苓雅區,1213,450,175,625,45,670,1272,52.67%,35.38%,1
高雄市,苓雅區,1214,467,169,636,34,670,1256,53.34%,37.18%,1
高雄市,苓雅區,1215,470,158,628,37,665,1203,55.28%,39.07%,1
高雄市,苓雅區,1216,488,131,619,20,639,1062,60.17%,45.95%,1
高雄市,苓雅區,1217,364,130,494,69,563,850,66.24%,42.82%,1
高雄市,苓雅區,1218,408,178,586,95,681,1010,67.43%,40.4%,1
高雄市,苓雅區,1219,445,153,598,33,631,1118,56.44%,39.8%,1
高雄市,苓雅區,1220,393,148,541,54,595,937,63.5%,41.94%,1
高雄市,苓雅區,1221,547,155,702,33,735,1493,49.23%,36.64%,1
高雄市,苓雅區,1222,516,157,673,37,710,1183,60.02%,43.62%,1
高雄市,苓雅區,1223,465,161,626,34,660,1318,50.08%,35.28%,1
高雄市,苓雅區,1224,534,205,739,55,794,1362,58.3%,39.21%,1
高雄市,苓雅區,1225,397,184,581,84,665,1102,60.34%,36.03%,1
高雄市,苓雅區,1226,611,193,804,69,873,1481,58.95%,41.26%,1
高雄市,苓雅區,1227,401,122,523,59,582,878,66.29%,45.67%,1
高雄市,苓雅區,1228,311,126,437,25,462,908,50.88%,34.25%,1
高雄市,苓雅區,1229,500,138,638,51,689,1056,65.25%,47.35%,1
高雄市,苓雅區,1230,403,144,547,43,590,1091,54.08%,36.94%,1
高雄市,苓雅區,1231,410,160,570,35,605,976,61.99%,42.01%,1
高雄市,苓雅區,1232,482,180,662,45,707,1063,66.51%,45.34%,1
高雄市,苓雅區,1233,640,218,858,78,936,1484,63.07%,43.13%,1
高雄市,苓雅區,1234,484,255,739,40,779,1290,60.39%,37.52%,1
高雄市,苓雅區,1235,736,262,998,59,1057,1740,60.75%,42.3%,1
高雄市,苓雅區,1236,672,209,881,66,947,1594,59.41%,42.16%,1
高雄市,苓雅區,1237,702,197,899,23,922,1648,55.95%,42.6%,1
高雄市,苓雅區,1238,557,179,736,65,801,1236,64.81%,45.06%,1
高雄市,苓雅區,1239,492,196,688,55,743,1211,61.35%,40.63%,1
高雄市,苓雅區,1240,503,199,702,31,733,1283,57.13%,39.2%,1
高雄市,苓雅區,1241,774,277,1051,86,1137,1804,63.03%,42.9%,1
高雄市,苓雅區,1242,748,249,997,72,1069,1718,62.22%,43.54%,1
高雄市,苓雅區,1243,553,196,749,66,815,1297,62.84%,42.64%,1
高雄市,苓雅區,1244,594,206,800,91,891,1449,61.49%,40.99%,1
高雄市,苓雅區,1245,544,202,746,31,777,1307,59.45%,41.62%,1
高雄市,苓雅區,1246,528,162,690,61,751,1184,63.43%,44.59%,1
高雄市,苓雅區,1247,547,217,764,82,846,1250,67.68%,43.76%,1
高雄市,苓雅區,1248,481,193,674,38,712,1248,57.05%,38.54%,1
高雄市,苓雅區,1249,540,185,725,29,754,1283,58.77%,42.09%,1
高雄市,苓雅區,1250,483,145,628,34,662,1121,59.05%,43.09%,1
高雄市,苓雅區,1251,522,184,706,31,737,1258,58.59%,41.49%,1
高雄市,苓雅區,1252,593,151,744,27,771,1339,57.58%,44.29%,1
高雄市,苓雅區,1253,759,278,1037,71,1108,1986,55.79%,38.22%,1
高雄市,苓雅區,1254,417,141,558,39,597,1028,58.07%,40.56%,1
高雄市,苓雅區,1255,417,134,551,17,568,948,59.92%,43.99%,1
高雄市,前鎮區,1484,626,232,858,143,1001,1809,55.33%,34.6%,1
高雄市,前鎮區,1485,652,253,905,94,999,1835,54.44%,35.53%,1
高雄市,前鎮區,1486,576,166,742,86,828,1890,43.81%,30.48%,1
高雄市,前鎮區,1487,662,239,901,71,972,2013,48.29%,32.89%,1
高雄市,前鎮區,1488,638,227,865,84,949,1776,53.43%,35.92%,1
高雄市,前鎮區,1489,531,197,728,100,828,1705,48.56%,31.14%,1
高雄市,前鎮區,1490,249,92,341,81,422,672,62.8%,37.05%,1
高雄市,前鎮區,1491,553,190,743,105,848,1726,49.13%,32.04%,1
高雄市,前鎮區,1492,607,224,831,48,879,1597,55.04%,38.01%,1
高雄市,前鎮區,1493,651,260,911,90,1001,1690,59.23%,38.52%,1
高雄市,前鎮區,1494,468,142,610,76,686,1080,63.52%,43.33%,1
高雄市,前鎮區,1495,498,183,681,84,765,1159,66.01%,42.97%,1
高雄市,前鎮區,1496,477,157,634,79,713,1314,54.26%,36.3%,1
高雄市,前鎮區,1497,387,103,490,68,558,896,62.28%,43.19%,1
高雄市,前鎮區,1498,392,151,543,50,593,1002,59.18%,39.12%,1
高雄市,前鎮區,1499,678,279,957,110,1067,2765,38.59%,24.52%,1
高雄市,前鎮區,1500,235,70,305,71,376,600,62.67%,39.17%,1
高雄市,前鎮區,1501,349,122,471,50,521,1466,35.54%,23.81%,1
高雄市,前鎮區,1502,527,176,703,57,760,1449,52.45%,36.37%,1
高雄市,前鎮區,1503,362,121,483,62,545,991,54.99%,36.53%,1
高雄市,前鎮區,1504,505,160,665,88,753,1248,60.34%,40.46%,1
高雄市,前鎮區,1505,432,140,572,108,680,1066,63.79%,40.53%,1
高雄市,前鎮區,1506,253,42,295,37,332,706,47.03%,35.84%,1
高雄市,前鎮區,1507,231,94,325,43,368,713,51.61%,32.4%,1
高雄市,前鎮區,1508,436,192,628,51,679,1344,50.52%,32.44%,1
高雄市,前鎮區,1509,343,115,458,59,517,856,60.4%,40.07%,1
高雄市,前鎮區,1510,269,128,397,45,442,873,50.63%,30.81%,1
高雄市,前鎮區,1511,379,135,514,53,567,1114,50.9%,34.02%,1
高雄市,前鎮區,1512,355,130,485,19,504,1112,45.32%,31.92%,1
高雄市,前鎮區,1513,390,132,522,63,585,1044,56.03%,37.36%,1
高雄市,前鎮區,1514,322,142,464,50,514,940,54.68%,34.26%,1
高雄市,前鎮區,1515,482,137,619,83,702,1342,52.31%,35.92%,1
高雄市,前鎮區,1516,624,224,848,68,916,1402,65.34%,44.51%,1
高雄市,前鎮區,1517,578,185,763,34,797,1320,60.38%,43.79%,1
高雄市,前鎮區,1518,361,147,508,64,572,958,59.71%,37.68%,1
高雄市,前鎮區,1519,630,188,818,49,867,1276,67.95%,49.37%,1
高雄市,前鎮區,1520,644,168,812,98,910,1459,62.37%,44.14%,1
高雄市,前鎮區,1521,226,108,334,27,361,761,47.44%,29.7%,1
高雄市,前鎮區,1522,380,152,532,29,561,1093,51.33%,34.77%,1
高雄市,前鎮區,1523,776,134,910,51,961,1521,63.18%,51.02%,1
高雄市,前鎮區,1524,761,155,916,43,959,1557,61.59%,48.88%,1
高雄市,前鎮區,1525,736,176,912,36,948,1821,52.06%,40.42%,1
高雄市,前鎮區,1526,584,107,691,46,737,1066,69.14%,54.78%,1
高雄市,前鎮區,1527,565,99,664,17,681,1046,65.11%,54.02%,1
高雄市,前鎮區,1528,647,279,926,65,991,1709,57.99%,37.86%,1
高雄市,前鎮區,1529,733,243,976,90,1066,1723,61.87%,42.54%,1
高雄市,前鎮區,1530,531,202,733,54,787,1202,65.47%,44.18%,1
高雄市,前鎮區,1531,559,225,784,53,837,1279,65.44%,43.71%,1
高雄市,前鎮區,1532,730,193,923,59,982,1513,64.9%,48.25%,1
高雄市,前鎮區,1533,538,146,684,25,709,1260,56.27%,42.7%,1
高雄市,前鎮區,1534,496,167,663,85,748,1139,65.67%,43.55%,1
高雄市,前鎮區,1535,528,178,706,54,760,1140,66.67%,46.32%,1
高雄市,前鎮區,1536,594,229,823,92,915,1462,62.59%,40.63%,1
高雄市,前鎮區,1537,603,196,799,44,843,1359,62.03%,44.37%,1
高雄市,前鎮區,1538,662,292,954,100,1054,2037,51.74%,32.5%,1
高雄市,前鎮區,1539,562,167,729,32,761,1410,53.97%,39.86%,1
高雄市,前鎮區,1540,491,209,700,28,728,1307,55.7%,37.57%,1
高雄市,前鎮區,1541,556,230,786,96,882,1512,58.33%,36.77%,1
高雄市,前鎮區,1542,582,246,828,88,916,1491,61.44%,39.03%,1
高雄市,前鎮區,1543,643,211,854,96,950,1621,58.61%,39.67%,1
高雄市,前鎮區,1544,550,182,732,75,807,1522,53.02%,36.14%,1
高雄市,前鎮區,1545,631,244,875,72,947,1593,59.45%,39.61%,1
高雄市,前鎮區,1546,769,260,1029,97,1126,1885,59.73%,40.8%,1
高雄市,前鎮區,1547,787,278,1065,100,1165,1870,62.3%,42.09%,1
高雄市,前鎮區,1548,560,212,772,35,807,1388,58.14%,40.35%,1
高雄市,前鎮區,1549,566,165,731,80,811,1348,60.16%,41.99%,1
高雄市,前鎮區,1550,495,159,654,120,774,1341,57.72%,36.91%,1
高雄市,前鎮區,1551,594,219,813,46,859,1364,62.98%,43.55%,1
高雄市,前鎮區,1552,548,200,748,81,829,1367,60.64%,40.09%,1
高雄市,前鎮區,1553,485,207,692,88,780,1326,58.82%,36.58%,1
高雄市,前鎮區,1554,422,120,542,49,591,1059,55.81%,39.85%,1
高雄市,前鎮區,1555,497,142,639,25,664,1119,59.34%,44.41%,1
高雄市,前鎮區,1556,561,220,781,39,820,1565,52.4%,35.85%,1
高雄市,前鎮區,1557,600,234,834,71,905,1549,58.42%,38.73%,1
高雄市,前鎮區,1558,816,224,1040,54,1094,1691,64.7%,48.26%,1
高雄市,前鎮區,1559,884,174,1058,41,1099,1837,59.83%,48.12%,1
高雄市,前鎮區,1560,484,157,641,29,670,1092,61.36%,44.32%,1
高雄市,前鎮區,1561,485,157,642,64,706,1126,62.7%,43.07%,1
高雄市,前鎮區,1562,450,172,622,84,706,1215,58.11%,37.04%,1
高雄市,前鎮區,1563,599,213,812,41,853,1443,59.11%,41.51%,1
高雄市,前鎮區,1564,690,231,921,38,959,1448,66.23%,47.65%,1
高雄市,前鎮區,1565,700,208,908,92,1000,1648,60.68%,42.48%,1
高雄市,前鎮區,1566,566,202,768,102,870,1603,54.27%,35.31%,1
高雄市,前鎮區,1567,584,169,753,26,779,1596,48.81%,36.59%,1
高雄市,前鎮區,1568,527,133,660,48,708,1450,48.83%,36.34%,1
高雄市,前鎮區,1569,564,182,746,92,838,1510,55.5%,37.35%,1
高雄市,前鎮區,1570,687,243,930,104,1034,1647,62.78%,41.71%,1
高雄市,前鎮區,1571,536,160,696,76,772,1342,57.53%,39.94%,1
高雄市,前鎮區,1572,537,140,677,57,734,1384,53.03%,38.8%,1
高雄市,前鎮區,1573,571,155,726,88,814,1479,55.04%,38.61%,1
高雄市,前鎮區,1574,630,200,830,45,875,1546,56.6%,40.75%,1
高雄市,前鎮區,1575,683,221,904,74,978,1595,61.32%,42.82%,1
高雄市,前鎮區,1576,513,158,671,74,745,1201,62.03%,42.71%,1
高雄市,前鎮區,1577,408,141,549,25,574,1082,53.05%,37.71%,1
高雄市,前鎮區,1578,369,119,488,50,538,996,54.02%,37.05%,1
高雄市,前鎮區,1579,349,138,487,89,576,932,61.8%,37.45%,1
高雄市,前鎮區,1580,450,189,639,57,696,1146,60.73%,39.27%,1
高雄市,前鎮區,1581,464,148,612,35,647,1096,59.03%,42.34%,1
高雄市,前鎮區,1582,628,165,793,20,813,1332,61.04%,47.15%,1
高雄市,前鎮區,1583,469,159,628,42,670,1175,57.02%,39.91%,1
高雄市,前鎮區,1584,401,128,529,70,599,986,60.75%,40.67%,1
高雄市,前鎮區,1585,558,184,742,81,823,1316,62.54%,42.4%,1
高雄市,前鎮區,1586,546,188,734,78,812,1559,52.08%,35.02%,1
高雄市,前鎮區,1587,682,217,899,88,987,1622,60.85%,42.05%,1
高雄市,前鎮區,1588,497,176,673,40,713,1310,54.43%,37.94%,1
高雄市,前鎮區,1589,483,209,692,109,801,1299,61.66%,37.18%,1
高雄市,前鎮區,1590,545,182,727,74,801,1191,67.25%,45.76%,1
高雄市,前鎮區,1591,528,142,670,30,700,1375,50.91%,38.4%,1
高雄市,前鎮區,1592,540,190,730,29,759,1338,56.73%,40.36%,1
高雄市,前鎮區,1593,441,162,603,29,632,1175,53.79%,37.53%,1
高雄市,前鎮區,1594,528,178,706,33,739,1357,54.46%,38.91%,1
高雄市,前鎮區,1595,487,211,698,69,767,1187,64.62%,41.03%,1
高雄市,前鎮區,1596,438,171,609,49,658,1164,56.53%,37.63%,1
高雄市,前鎮區,1597,513,180,693,70,763,1219,62.59%,42.08%,1
高雄市,前鎮區,1598,512,206,718,30,748,1428,52.38%,35.85%,1
高雄市,前鎮區,1599,548,218,766,114,880,1495,58.86%,36.66%,1
高雄市,前鎮區,1600,706,161,867,36,903,1531,58.98%,46.11%,1
高雄市,前鎮區,1601,516,276,792,105,897,1509,59.44%,34.19%,1
高雄市,前鎮區,1602,610,210,820,78,898,1591,56.44%,38.34%,1
高雄市,旗津區,0869,508,101,609,123,732,1177,62.19%,43.16%,1
高雄市,旗津區,0870,349,120,469,55,524,1109,47.25%,31.47%,1
高雄市,旗津區,0871,486,191,677,26,703,1642,42.81%,29.6%,1
高雄市,旗津區,0872,420,141,561,103,664,1209,54.92%,34.74%,1
高雄市,旗津區,0873,345,115,460,62,522,1112,46.94%,31.03%,1
高雄市,旗津區,0874,546,207,753,100,853,1483,57.52%,36.82%,1
高雄市,旗津區,0875,468,107,575,37,612,1460,41.92%,32.05%,1
高雄市,旗津區,0876,558,243,801,175,976,1572,62.09%,35.5%,1
高雄市,旗津區,0877,452,132,584,36,620,1384,44.8%,32.66%,1
高雄市,旗津區,0878,425,164,589,44,633,1390,45.54%,30.58%,1
高雄市,旗津區,0879,386,146,532,69,601,1239,48.51%,31.15%,1
高雄市,旗津區,0880,637,282,919,139,1058,2045,51.74%,31.15%,1
高雄市,旗津區,0881,283,108,391,23,414,893,46.36%,31.69%,1
高雄市,旗津區,0882,548,253,801,161,962,1866,51.55%,29.37%,1
高雄市,旗津區,0883,458,217,675,43,718,1874,38.31%,24.44%,1
高雄市,旗津區,0884,279,105,384,71,455,893,50.95%,31.24%,1
高雄市,旗津區,0885,399,179,578,48,626,1215,51.52%,32.84%,1
高雄市,旗津區,0886,433,119,552,48,600,1297,46.26%,33.38%,1
高雄市,小港區,1603,477,168,645,46,691,1108,62.36%,43.05%,1
高雄市,小港區,1604,498,165,663,70,733,1171,62.6%,42.53%,1
高雄市,小港區,1605,671,266,937,25,962,1557,61.79%,43.1%,1
高雄市,小港區,1606,651,182,833,26,859,1668,51.5%,39.03%,1
高雄市,小港區,1607,546,139,685,33,718,1183,60.69%,46.15%,1
高雄市,小港區,1608,560,172,732,31,763,1372,55.61%,40.82%,1
高雄市,小港區,1609,713,270,983,64,1047,1737,60.28%,41.05%,1
高雄市,小港區,1610,601,248,849,104,953,1586,60.09%,37.89%,1
高雄市,小港區,1611,574,177,751,80,831,1558,53.34%,36.84%,1
高雄市,小港區,1612,583,216,799,78,877,1284,68.3%,45.4%,1
高雄市,小港區,1613,544,164,708,69,777,1249,62.21%,43.55%,1
高雄市,小港區,1614,732,272,1004,121,1125,2400,46.88%,30.5%,1
高雄市,小港區,1615,470,189,659,50,709,1181,60.03%,39.8%,1
高雄市,小港區,1616,424,147,571,35,606,1079,56.16%,39.3%,1
高雄市,小港區,1617,547,195,742,44,786,1335,58.88%,40.97%,1
高雄市,小港區,1618,548,152,700,66,766,1241,61.72%,44.16%,1
高雄市,小港區,1619,581,221,802,67,869,1513,57.44%,38.4%,1
高雄市,小港區,1620,590,171,761,70,831,1349,61.6%,43.74%,1
高雄市,小港區,1621,562,208,770,53,823,1483,55.5%,37.9%,1
高雄市,小港區,1622,614,189,803,31,834,1451,57.48%,42.32%,1
高雄市,小港區,1623,479,150,629,27,656,1241,52.86%,38.6%,1
高雄市,小港區,1624,544,217,761,81,842,1262,66.72%,43.11%,1
高雄市,小港區,1625,752,245,997,104,1101,1813,60.73%,41.48%,1
高雄市,小港區,1626,654,211,865,41,906,1877,48.27%,34.84%,1
高雄市,小港區,1627,567,177,744,32,776,1391,55.79%,40.76%,1
高雄市,小港區,1628,622,200,822,34,856,1453,58.91%,42.81%,1
高雄市,小港區,1629,551,215,766,48,814,1374,59.24%,40.1%,1
高雄市,小港區,1630,538,187,725,65,790,1348,58.61%,39.91%,1
高雄市,小港區,1631,599,171,770,65,835,1334,62.59%,44.9%,1
高雄市,小港區,1632,547,212,759,36,795,1433,55.48%,38.17%,1
高雄市,小港區,1633,515,189,704,21,725,1448,50.07%,35.57%,1
高雄市,小港區,1634,836,43,879,80,959,1488,64.45%,56.18%,1
高雄市,小港區,1635,549,169,718,64,782,1278,61.19%,42.96%,1
高雄市,小港區,1636,616,209,825,58,883,1306,67.61%,47.17%,1
高雄市,小港區,1637,672,211,883,92,975,1625,60%,41.35%,1
高雄市,小港區,1638,697,245,942,100,1042,1640,63.54%,42.5%,1
高雄市,小港區,1639,617,192,809,64,873,1506,57.97%,40.97%,1
高雄市,小港區,1640,555,173,728,66,794,1438,55.22%,38.6%,1
高雄市,小港區,1641,560,151,711,42,753,1105,68.14%,50.68%,1
高雄市,小港區,1642,490,135,625,20,645,1167,55.27%,41.99%,1
高雄市,小港區,1643,640,173,813,34,847,1420,59.65%,45.07%,1
高雄市,小港區,1644,639,197,836,65,901,1380,65.29%,46.3%,1
高雄市,小港區,1645,550,120,670,33,703,1239,56.74%,44.39%,1
高雄市,小港區,1646,713,188,901,59,960,1563,61.42%,45.62%,1
高雄市,小港區,1647,689,202,891,85,976,1644,59.37%,41.91%,1
高雄市,小港區,1648,875,126,1001,83,1084,1895,57.2%,46.17%,1
高雄市,小港區,1649,674,218,892,99,991,1748,56.69%,38.56%,1
高雄市,小港區,1650,613,262,875,100,975,1579,61.75%,38.82%,1
高雄市,小港區,1651,801,264,1065,53,1118,2135,52.37%,37.52%,1
高雄市,小港區,1652,689,236,925,81,1006,1728,58.22%,39.87%,1
高雄市,小港區,1653,753,247,1000,54,1054,2022,52.13%,37.24%,1
高雄市,小港區,1654,464,131,595,22,617,1329,46.43%,34.91%,1
高雄市,小港區,1655,510,176,686,43,729,1320,55.23%,38.64%,1
高雄市,小港區,1656,497,190,687,88,775,1267,61.17%,39.23%,1
高雄市,小港區,1657,554,185,739,85,824,1298,63.48%,42.68%,1
高雄市,小港區,1658,566,179,745,36,781,1289,60.59%,43.91%,1
高雄市,小港區,1659,635,218,853,48,901,1534,58.74%,41.4%,1
高雄市,小港區,1660,622,209,831,48,879,1494,58.84%,41.63%,1
高雄市,小港區,1661,556,184,740,82,822,1377,59.69%,40.38%,1
高雄市,小港區,1662,622,158,780,80,860,1344,63.99%,46.28%,1
高雄市,小港區,1663,637,200,837,67,904,1508,59.95%,42.24%,1
高雄市,小港區,1664,403,313,716,35,751,1400,53.64%,28.79%,1
高雄市,小港區,1665,642,192,834,63,897,1457,61.56%,44.06%,1
高雄市,小港區,1666,560,178,738,36,774,1392,55.6%,40.23%,1
高雄市,小港區,1667,770,241,1011,74,1085,1983,54.72%,38.83%,1
高雄市,小港區,1668,503,117,620,33,653,1204,54.24%,41.78%,1
高雄市,小港區,1669,500,212,712,52,764,1300,58.77%,38.46%,1
高雄市,小港區,1670,762,300,1062,95,1157,1857,62.3%,41.03%,1
高雄市,小港區,1671,654,187,841,40,881,1566,56.26%,41.76%,1
高雄市,小港區,1672,601,193,794,84,878,1343,65.38%,44.75%,1
高雄市,小港區,1673,588,187,775,91,866,1236,70.06%,47.57%,1
高雄市,小港區,1674,674,213,887,96,983,1564,62.85%,43.09%,1
高雄市,小港區,1675,589,212,801,17,818,1484,55.12%,39.69%,1
高雄市,小港區,1676,584,203,787,41,828,1477,56.06%,39.54%,1
高雄市,小港區,1677,658,215,873,41,914,1482,61.67%,44.4%,1
高雄市,小港區,1678,642,215,857,39,896,1708,52.46%,37.59%,1
高雄市,小港區,1679,698,298,996,73,1069,1867,57.26%,37.39%,1
高雄市,小港區,1680,615,191,806,24,830,1709,48.57%,35.99%,1
高雄市,小港區,1681,523,187,710,71,781,1425,54.81%,36.7%,1
高雄市,小港區,1682,568,176,744,57,801,1696,47.23%,33.49%,1
高雄市,小港區,1683,603,67,670,48,718,1522,47.17%,39.62%,1
高雄市,小港區,1684,615,192,807,97,904,1531,59.05%,40.17%,1
高雄市,小港區,1685,703,349,1052,147,1199,2215,54.13%,31.74%,1
高雄市,小港區,1686,558,196,754,38,792,1515,52.28%,36.83%,1
高雄市,小港區,1687,488,203,691,38,729,1535,47.49%,31.79%,1
高雄市,小港區,1688,479,177,656,35,691,1276,54.15%,37.54%,1
高雄市,小港區,1689,406,144,550,39,589,1217,48.4%,33.36%,1
高雄市,小港區,1690,562,193,755,88,843,1707,49.38%,32.92%,1
高雄市,小港區,1691,638,262,900,125,1025,1920,53.39%,33.23%,1
高雄市,鳳山區,1256,491,156,647,59,706,1080,65.37%,45.46%,1
高雄市,鳳山區,1257,365,112,477,37,514,819,62.76%,44.57%,1
高雄市,鳳山區,1258,352,107,459,73,532,851,62.51%,41.36%,1
高雄市,鳳山區,1259,463,166,629,41,670,1075,62.33%,43.07%,1
高雄市,鳳山區,1260,556,166,722,35,757,1223,61.9%,45.46%,1
高雄市,鳳山區,1261,520,184,704,41,745,1207,61.72%,43.08%,1
高雄市,鳳山區,1262,495,198,693,41,734,1339,54.82%,36.97%,1
高雄市,鳳山區,1263,451,118,569,42,611,1188,51.43%,37.96%,1
高雄市,鳳山區,1264,457,126,583,58,641,1055,60.76%,43.32%,1
高雄市,鳳山區,1265,447,114,561,75,636,1109,57.35%,40.31%,1
高雄市,鳳山區,1266,367,105,472,43,515,756,68.12%,48.54%,1
高雄市,鳳山區,1267,476,132,608,38,646,1182,54.65%,40.27%,1
高雄市,鳳山區,1268,623,187,810,89,899,1496,60.09%,41.64%,1
高雄市,鳳山區,1269,767,210,977,66,1043,2094,49.81%,36.63%,1
高雄市,鳳山區,1270,676,208,884,30,914,1672,54.67%,40.43%,1
高雄市,鳳山區,1271,731,193,924,29,953,1761,54.12%,41.51%,1
高雄市,鳳山區,1272,596,192,788,72,860,1450,59.31%,41.1%,1
高雄市,鳳山區,1273,540,165,705,44,749,1455,51.48%,37.11%,1
高雄市,鳳山區,1274,523,140,663,69,732,1234,59.32%,42.38%,1
高雄市,鳳山區,1275,748,230,978,109,1087,1713,63.46%,43.67%,1
高雄市,鳳山區,1276,667,173,840,34,874,1698,51.47%,39.28%,1
高雄市,鳳山區,1277,513,185,698,74,772,1247,61.91%,41.14%,1
高雄市,鳳山區,1278,456,153,609,49,658,1087,60.53%,41.95%,1
高雄市,鳳山區,1279,533,146,679,28,707,1199,58.97%,44.45%,1
高雄市,鳳山區,1280,728,114,842,57,899,1559,57.67%,46.7%,1
高雄市,鳳山區,1281,544,142,686,43,729,1233,59.12%,44.12%,1
高雄市,鳳山區,1282,522,176,698,54,752,1277,58.89%,40.88%,1
高雄市,鳳山區,1283,655,138,793,18,811,1481,54.76%,44.23%,1
高雄市,鳳山區,1284,551,167,718,16,734,1154,63.6%,47.75%,1
高雄市,鳳山區,1285,535,231,766,26,792,1475,53.69%,36.27%,1
高雄市,鳳山區,1286,483,129,612,83,695,1247,55.73%,38.73%,1
高雄市,鳳山區,1287,576,186,762,83,845,1538,54.94%,37.45%,1
高雄市,鳳山區,1288,427,150,577,34,611,1097,55.7%,38.92%,1
高雄市,鳳山區,1289,433,161,594,28,622,1221,50.94%,35.46%,1
高雄市,鳳山區,1290,512,158,670,61,731,1075,68%,47.63%,1
高雄市,鳳山區,1291,782,227,1009,50,1059,1751,60.48%,44.66%,1
高雄市,鳳山區,1292,771,227,998,45,1043,1758,59.33%,43.86%,1
高雄市,鳳山區,1293,722,228,950,85,1035,1749,59.18%,41.28%,1
高雄市,鳳山區,1294,747,182,929,26,955,1746,54.7%,42.78%,1
高雄市,鳳山區,1295,716,190,906,54,960,1712,56.07%,41.82%,1
高雄市,鳳山區,1296,536,174,710,32,742,1247,59.5%,42.98%,1
高雄市,鳳山區,1297,695,101,796,57,853,1409,60.54%,49.33%,1
高雄市,鳳山區,1298,574,183,757,61,818,1347,60.73%,42.61%,1
高雄市,鳳山區,1299,734,222,956,27,983,1771,55.51%,41.45%,1
高雄市,鳳山區,1300,645,202,847,20,867,1537,56.41%,41.96%,1
高雄市,鳳山區,1301,731,218,949,34,983,1605,61.25%,45.55%,1
高雄市,鳳山區,1302,605,171,776,51,827,1375,60.15%,44%,1
高雄市,鳳山區,1303,623,182,805,66,871,1393,62.53%,44.72%,1
高雄市,鳳山區,1304,645,185,830,24,854,1584,53.91%,40.72%,1
高雄市,鳳山區,1305,208,122,330,24,354,618,57.28%,33.66%,1
高雄市,鳳山區,1306,186,52,238,12,250,423,59.1%,43.97%,1
高雄市,鳳山區,1307,516,176,692,69,761,1312,58%,39.33%,1
高雄市,鳳山區,1308,317,106,423,36,459,769,59.69%,41.22%,1
高雄市,鳳山區,1309,570,160,730,31,761,1213,62.74%,46.99%,1
高雄市,鳳山區,1310,529,149,678,39,717,1107,64.77%,47.79%,1
高雄市,鳳山區,1311,495,174,669,36,705,1188,59.34%,41.67%,1
高雄市,鳳山區,1312,516,171,687,44,731,1183,61.79%,43.62%,1
高雄市,鳳山區,1313,520,204,724,56,780,1264,61.71%,41.14%,1
高雄市,鳳山區,1314,354,127,481,35,516,882,58.5%,40.14%,1
高雄市,鳳山區,1315,476,170,646,57,703,1007,69.81%,47.27%,1
高雄市,鳳山區,1316,344,106,450,85,535,853,62.72%,40.33%,1
高雄市,鳳山區,1317,302,117,419,57,476,1660,28.67%,18.19%,1
高雄市,鳳山區,1318,491,163,654,37,691,1124,61.48%,43.68%,1
高雄市,鳳山區,1319,444,176,620,72,692,1112,62.23%,39.93%,1
高雄市,鳳山區,1320,465,138,603,50,653,1182,55.25%,39.34%,1
高雄市,鳳山區,1321,440,136,576,49,625,875,71.43%,50.29%,1
高雄市,鳳山區,1322,407,180,587,50,637,1040,61.25%,39.13%,1
高雄市,鳳山區,1323,488,172,660,34,694,1094,63.44%,44.61%,1
高雄市,鳳山區,1324,501,194,695,66,761,1217,62.53%,41.17%,1
高雄市,鳳山區,1325,462,163,625,41,666,974,68.38%,47.43%,1
高雄市,鳳山區,1326,443,115,558,44,602,987,60.99%,44.88%,1
高雄市,鳳山區,1327,588,163,751,24,775,1210,64.05%,48.6%,1
高雄市,鳳山區,1328,574,188,762,64,826,1391,59.38%,41.27%,1
高雄市,鳳山區,1329,427,164,591,26,617,1241,49.72%,34.41%,1
高雄市,鳳山區,1330,477,119,596,49,645,1000,64.5%,47.7%,1
高雄市,鳳山區,1331,488,130,618,46,664,1092,60.81%,44.69%,1
高雄市,鳳山區,1332,576,174,750,54,804,1308,61.47%,44.04%,1
高雄市,鳳山區,1333,454,125,579,66,645,1031,62.56%,44.03%,1
高雄市,鳳山區,1334,497,169,666,74,740,1159,63.85%,42.88%,1
高雄市,鳳山區,1335,465,143,608,64,672,1127,59.63%,41.26%,1
高雄市,鳳山區,1336,537,205,742,52,794,1109,71.6%,48.42%,1
高雄市,鳳山區,1337,851,263,1114,74,1188,1879,63.23%,45.29%,1
高雄市,鳳山區,1338,890,251,1141,52,1193,1803,66.17%,49.36%,1
高雄市,鳳山區,1339,824,183,1007,98,1105,2045,54.03%,40.29%,1
高雄市,鳳山區,1340,608,167,775,43,818,1432,57.12%,42.46%,1
高雄市,鳳山區,1341,409,102,511,23,534,1033,51.69%,39.59%,1
高雄市,鳳山區,1342,515,185,700,95,795,1253,63.45%,41.1%,1
高雄市,鳳山區,1343,503,168,671,32,703,1217,57.76%,41.33%,1
高雄市,鳳山區,1344,607,155,762,52,814,1267,64.25%,47.91%,1
高雄市,鳳山區,1345,484,151,635,52,687,1251,54.92%,38.69%,1
高雄市,鳳山區,1346,667,193,860,87,947,1563,60.59%,42.67%,1
高雄市,鳳山區,1347,884,213,1097,68,1165,1888,61.71%,46.82%,1
高雄市,鳳山區,1348,588,188,776,60,836,1368,61.11%,42.98%,1
高雄市,鳳山區,1349,627,179,806,49,855,1588,53.84%,39.48%,1
高雄市,鳳山區,1350,644,104,748,54,802,1255,63.9%,51.31%,1
高雄市,鳳山區,1351,538,166,704,74,778,1264,61.55%,42.56%,1
高雄市,鳳山區,1352,637,66,703,86,789,1291,61.12%,49.34%,1
高雄市,鳳山區,1353,528,118,646,48,694,1224,56.7%,43.14%,1
高雄市,鳳山區,1354,579,188,767,37,804,1296,62.04%,44.68%,1
高雄市,鳳山區,1355,393,108,501,55,556,826,67.31%,47.58%,1
高雄市,鳳山區,1356,569,128,697,54,751,1229,61.11%,46.3%,1
高雄市,鳳山區,1357,702,142,844,55,899,1467,61.28%,47.85%,1
高雄市,鳳山區,1358,536,142,678,64,742,1218,60.92%,44.01%,1
高雄市,鳳山區,1359,878,256,1134,91,1225,2173,56.37%,40.4%,1
高雄市,鳳山區,1360,1069,164,1233,75,1308,2255,58%,47.41%,1
高雄市,鳳山區,1361,688,190,878,45,923,1556,59.32%,44.22%,1
高雄市,鳳山區,1362,600,190,790,69,859,1521,56.48%,39.45%,1
高雄市,鳳山區,1363,537,150,687,49,736,1407,52.31%,38.17%,1
高雄市,鳳山區,1364,687,181,868,68,936,1542,60.7%,44.55%,1
高雄市,鳳山區,1365,616,150,766,22,788,1502,52.46%,41.01%,1
高雄市,鳳山區,1366,616,142,758,68,826,1320,62.58%,46.67%,1
高雄市,鳳山區,1367,699,90,789,43,832,1507,55.21%,46.38%,1
高雄市,鳳山區,1368,676,107,783,36,819,1284,63.79%,52.65%,1
高雄市,鳳山區,1369,585,160,745,45,790,1441,54.82%,40.6%,1
高雄市,鳳山區,1370,671,155,826,88,914,1485,61.55%,45.19%,1
高雄市,鳳山區,1371,449,176,625,73,698,1205,57.93%,37.26%,1
高雄市,鳳山區,1372,503,164,667,28,695,1284,54.13%,39.17%,1
高雄市,鳳山區,1373,543,205,748,68,816,1326,61.54%,40.95%,1
高雄市,鳳山區,1374,446,160,606,31,637,1096,58.12%,40.69%,1
高雄市,鳳山區,1375,487,186,673,83,756,1182,63.96%,41.2%,1
高雄市,鳳山區,1376,470,164,634,58,692,1017,68.04%,46.21%,1
高雄市,鳳山區,1377,452,176,628,89,717,1198,59.85%,37.73%,1
高雄市,鳳山區,1378,447,169,616,37,653,1281,50.98%,34.89%,1
高雄市,鳳山區,1379,600,209,809,45,854,1358,62.89%,44.18%,1
高雄市,鳳山區,1380,664,94,758,49,807,1226,65.82%,54.16%,1
高雄市,鳳山區,1381,495,144,639,72,711,1098,64.75%,45.08%,1
高雄市,鳳山區,1382,504,175,679,41,720,1200,60%,42%,1
高雄市,鳳山區,1383,384,120,504,45,549,942,58.28%,40.76%,1
高雄市,鳳山區,1384,491,138,629,27,656,1206,54.39%,40.71%,1
高雄市,鳳山區,1385,529,175,704,41,745,1159,64.28%,45.64%,1
高雄市,鳳山區,1386,618,192,810,68,878,1401,62.67%,44.11%,1
高雄市,鳳山區,1387,606,174,780,31,811,1525,53.18%,39.74%,1
高雄市,鳳山區,1388,528,196,724,41,765,1345,56.88%,39.26%,1
高雄市,鳳山區,1389,502,183,685,47,732,1180,62.03%,42.54%,1
高雄市,鳳山區,1390,399,149,548,32,580,1106,52.44%,36.08%,1
高雄市,鳳山區,1391,632,210,842,73,915,1442,63.45%,43.83%,1
高雄市,鳳山區,1392,608,187,795,59,854,1376,62.06%,44.19%,1
高雄市,鳳山區,1393,535,159,694,30,724,1243,58.25%,43.04%,1
高雄市,鳳山區,1394,596,150,746,22,768,1361,56.43%,43.79%,1
高雄市,鳳山區,1395,593,221,814,67,881,1416,62.22%,41.88%,1
高雄市,鳳山區,1396,706,235,941,77,1018,1536,66.28%,45.96%,1
高雄市,鳳山區,1397,527,172,699,30,729,1388,52.52%,37.97%,1
高雄市,鳳山區,1398,501,194,695,80,775,1241,62.45%,40.37%,1
高雄市,鳳山區,1399,601,216,817,58,875,1394,62.77%,43.11%,1
高雄市,鳳山區,1400,567,176,743,30,773,1188,65.07%,47.73%,1
高雄市,鳳山區,1401,459,156,615,44,659,1112,59.26%,41.28%,1
高雄市,鳳山區,1402,537,91,628,51,679,1198,56.68%,44.82%,1
高雄市,鳳山區,1403,564,245,809,50,859,1475,58.24%,38.24%,1
高雄市,鳳山區,1404,449,147,596,41,637,1216,52.38%,36.92%,1
高雄市,鳳山區,1405,435,171,606,42,648,1318,49.17%,33%,1
高雄市,鳳山區,1406,590,196,786,82,868,1465,59.25%,40.27%,1
高雄市,鳳山區,1407,468,167,635,41,676,1314,51.45%,35.62%,1
高雄市,鳳山區,1408,598,185,783,27,810,1649,49.12%,36.26%,1
高雄市,鳳山區,1409,602,180,782,98,880,1601,54.97%,37.6%,1
高雄市,鳳山區,1410,452,153,605,26,631,1155,54.63%,39.13%,1
高雄市,鳳山區,1411,423,150,573,66,639,1050,60.86%,40.29%,1
高雄市,鳳山區,1412,538,150,688,22,710,1417,50.11%,37.97%,1
高雄市,鳳山區,1413,616,200,816,66,882,1525,57.84%,40.39%,1
高雄市,鳳山區,1414,659,204,863,63,926,1514,61.16%,43.53%,1
高雄市,鳳山區,1415,520,132,652,47,699,1190,58.74%,43.7%,1
高雄市,鳳山區,1416,530,149,679,26,705,1325,53.21%,40%,1
高雄市,鳳山區,1417,462,130,592,62,654,1049,62.35%,44.04%,1
高雄市,鳳山區,1418,543,19,562,35,597,1026,58.19%,52.92%,1
高雄市,鳳山區,1419,488,171,659,61,720,1152,62.5%,42.36%,1
高雄市,鳳山區,1420,482,138,620,22,642,1254,51.2%,38.44%,1
高雄市,鳳山區,1421,636,207,843,33,876,1688,51.9%,37.68%,1
高雄市,鳳山區,1422,743,152,895,72,967,1657,58.36%,44.84%,1
高雄市,鳳山區,1423,656,208,864,43,907,1729,52.46%,37.94%,1
高雄市,鳳山區,1424,711,206,917,63,980,1628,60.2%,43.67%,1
高雄市,鳳山區,1425,694,202,896,24,920,1891,48.65%,36.7%,1
高雄市,鳳山區,1426,746,200,946,102,1048,1594,65.75%,46.8%,1
高雄市,鳳山區,1427,645,169,814,22,836,1342,62.3%,48.06%,1
高雄市,鳳山區,1428,689,213,902,45,947,1448,65.4%,47.58%,1
高雄市,鳳山區,1429,601,190,791,77,868,1405,61.78%,42.78%,1
高雄市,鳳山區,1430,456,171,627,86,713,1097,65%,41.57%,1
高雄市,鳳山區,1431,509,211,720,97,817,1248,65.46%,40.79%,1
高雄市,鳳山區,1432,481,199,680,81,761,1225,62.12%,39.27%,1
高雄市,鳳山區,1433,461,170,631,36,667,1214,54.94%,37.97%,1
高雄市,鳳山區,1434,890,275,1165,100,1265,2032,62.25%,43.8%,1
高雄市,鳳山區,1435,802,241,1043,85,1128,1927,58.54%,41.62%,1
高雄市,鳳山區,1436,946,272,1218,86,1304,2097,62.18%,45.11%,1
高雄市,鳳山區,1437,353,157,510,56,566,968,58.47%,36.47%,1
高雄市,鳳山區,1438,548,59,607,70,677,1200,56.42%,45.67%,1
高雄市,鳳山區,1439,420,164,584,86,670,1101,60.85%,38.15%,1
高雄市,鳳山區,1440,602,86,688,48,736,1369,53.76%,43.97%,1
高雄市,鳳山區,1441,630,198,828,74,902,1542,58.5%,40.86%,1
高雄市,鳳山區,1442,632,219,851,65,916,1536,59.64%,41.15%,1
高雄市,鳳山區,1443,488,190,678,39,717,1382,51.88%,35.31%,1
高雄市,鳳山區,1444,570,206,776,102,878,1452,60.47%,39.26%,1
高雄市,鳳山區,1445,437,133,570,64,634,1058,59.92%,41.3%,1
高雄市,鳳山區,1446,434,145,579,58,637,976,65.27%,44.47%,1
高雄市,鳳山區,1447,571,170,741,53,794,1545,51.39%,36.96%,1
高雄市,鳳山區,1448,444,173,617,56,673,1143,58.88%,38.85%,1
高雄市,鳳山區,1449,246,75,321,18,339,1301,26.06%,18.91%,1
高雄市,鳳山區,1450,409,137,546,38,584,1250,46.72%,32.72%,1
高雄市,鳳山區,1451,505,141,646,61,707,1208,58.53%,41.8%,1
高雄市,鳳山區,1452,491,150,641,98,739,1202,61.48%,40.85%,1
高雄市,鳳山區,1453,592,174,766,94,860,1499,57.37%,39.49%,1
高雄市,鳳山區,1454,600,197,797,55,852,1522,55.98%,39.42%,1
高雄市,鳳山區,1455,489,162,651,67,718,1125,63.82%,43.47%,1
高雄市,鳳山區,1456,552,173,725,37,762,1307,58.3%,42.23%,1
高雄市,鳳山區,1457,548,205,753,75,828,1405,58.93%,39%,1
高雄市,鳳山區,1458,506,177,683,75,758,1252,60.54%,40.42%,1
高雄市,鳳山區,1459,585,166,751,37,788,1291,61.04%,45.31%,1
高雄市,鳳山區,1460,387,137,524,70,594,938,63.33%,41.26%,1
高雄市,鳳山區,1461,732,252,984,52,1036,1783,58.1%,41.05%,1
高雄市,鳳山區,1462,484,141,625,42,667,1105,60.36%,43.8%,1
高雄市,鳳山區,1463,528,186,714,92,806,1392,57.9%,37.93%,1
高雄市,鳳山區,1464,570,202,772,57,829,1244,66.64%,45.82%,1
高雄市,鳳山區,1465,434,154,588,57,645,1154,55.89%,37.61%,1
高雄市,鳳山區,1466,470,167,637,58,695,1153,60.28%,40.76%,1
高雄市,鳳山區,1467,394,139,533,22,555,1148,48.34%,34.32%,1
高雄市,鳳山區,1468,528,177,705,121,826,1432,57.68%,36.87%,1
高雄市,鳳山區,1469,392,162,554,28,582,1429,40.73%,27.43%,1
高雄市,鳳山區,1470,590,188,778,29,807,1479,54.56%,39.89%,1
高雄市,鳳山區,1471,425,155,580,57,637,1026,62.09%,41.42%,1
高雄市,鳳山區,1472,397,181,578,99,677,993,68.18%,39.98%,1
高雄市,鳳山區,1473,415,131,546,71,617,947,65.15%,43.82%,1
高雄市,鳳山區,1474,411,124,535,65,600,1042,57.58%,39.44%,1
高雄市,鳳山區,1475,443,154,597,67,664,1098,60.47%,40.35%,1
高雄市,鳳山區,1476,464,160,624,26,650,1284,50.62%,36.14%,1
高雄市,鳳山區,1477,453,156,609,49,658,1242,52.98%,36.47%,1
高雄市,鳳山區,1478,456,147,603,89,692,1093,63.31%,41.72%,1
高雄市,鳳山區,1479,497,204,701,50,751,1353,55.51%,36.73%,1
高雄市,鳳山區,1480,509,159,668,28,696,1353,51.44%,37.62%,1
高雄市,鳳山區,1481,552,172,724,76,800,1309,61.12%,42.17%,1
高雄市,鳳山區,1482,658,216,874,66,940,1627,57.78%,40.44%,1
高雄市,鳳山區,1483,556,178,734,100,834,1372,60.79%,40.52%,1
高雄市,林園區,1773,427,243,670,88,758,1262,60.06%,33.84%,1
高雄市,林園區,1774,549,192,741,79,820,1562,52.5%,35.15%,1
高雄市,林園區,1775,428,129,557,36,593,1078,55.01%,39.7%,1
高雄市,林園區,1776,402,162,564,64,628,979,64.15%,41.06%,1
高雄市,林園區,1777,463,145,608,65,673,1195,56.32%,38.74%,1
高雄市,林園區,1778,508,175,683,70,753,1380,54.57%,36.81%,1
高雄市,林園區,1779,482,158,640,84,724,1280,56.56%,37.66%,1
高雄市,林園區,1780,454,156,610,29,639,1269,50.35%,35.78%,1
高雄市,林園區,1781,470,164,634,28,662,1568,42.22%,29.97%,1
高雄市,林園區,1782,505,158,663,62,725,1226,59.14%,41.19%,1
高雄市,林園區,1783,583,159,742,64,806,1480,54.46%,39.39%,1
高雄市,林園區,1784,614,178,792,63,855,1459,58.6%,42.08%,1
高雄市,林園區,1785,592,163,755,57,812,1593,50.97%,37.16%,1
高雄市,林園區,1786,330,114,444,89,533,895,59.55%,36.87%,1
高雄市,林園區,1787,394,149,543,40,583,1110,52.52%,35.5%,1
高雄市,林園區,1788,478,171,649,72,721,1348,53.49%,35.46%,1
高雄市,林園區,1789,356,130,486,63,549,912,60.2%,39.04%,1
高雄市,林園區,1790,467,160,627,74,701,1085,64.61%,43.04%,1
高雄市,林園區,1791,363,107,470,30,500,955,52.36%,38.01%,1
高雄市,林園區,1792,373,118,491,53,544,879,61.89%,42.43%,1
高雄市,林園區,1793,437,129,566,73,639,1103,57.93%,39.62%,1
高雄市,林園區,1794,459,140,599,84,683,1054,64.8%,43.55%,1
高雄市,林園區,1795,417,149,566,24,590,1292,45.67%,32.28%,1
高雄市,林園區,1796,554,165,719,28,747,1683,44.39%,32.92%,1
高雄市,林園區,1797,246,61,307,38,345,607,56.84%,40.53%,1
高雄市,林園區,1798,391,124,515,77,592,1012,58.5%,38.64%,1
高雄市,林園區,1799,432,134,566,50,616,1046,58.89%,41.3%,1
高雄市,林園區,1800,311,87,398,17,415,914,45.4%,34.03%,1
高雄市,林園區,1801,567,189,756,78,834,1405,59.36%,40.36%,1
高雄市,林園區,1802,533,189,722,20,742,1299,57.12%,41.03%,1
高雄市,林園區,1803,39,184,223,39,262,1170,22.39%,3.33%,1
高雄市,林園區,1804,398,155,553,40,593,1299,45.65%,30.64%,1
高雄市,林園區,1805,403,144,547,39,586,1031,56.84%,39.09%,1
高雄市,林園區,1806,153,108,261,24,285,849,33.57%,18.02%,1
高雄市,林園區,1807,260,125,385,69,454,838,54.18%,31.03%,1
高雄市,林園區,1808,381,110,491,30,521,938,55.54%,40.62%,1
高雄市,林園區,1809,411,94,505,41,546,1051,51.95%,39.11%,1
高雄市,林園區,1810,314,110,424,54,478,786,60.81%,39.95%,1
高雄市,林園區,1811,367,110,477,79,556,894,62.19%,41.05%,1
高雄市,林園區,1812,199,57,256,21,277,749,36.98%,26.57%,1
高雄市,林園區,1813,630,195,825,40,865,1485,58.25%,42.42%,1
高雄市,林園區,1814,557,218,775,100,875,1478,59.2%,37.69%,1
高雄市,林園區,1815,587,188,775,76,851,1345,63.27%,43.64%,1
高雄市,林園區,1816,362,152,514,60,574,1038,55.3%,34.87%,1
高雄市,林園區,1817,486,172,658,36,694,1203,57.69%,40.4%,1
高雄市,林園區,1818,444,58,502,22,524,1138,46.05%,39.02%,1
高雄市,林園區,1819,368,108,476,23,499,1025,48.68%,35.9%,1
高雄市,林園區,1820,545,158,703,85,788,1341,58.76%,40.64%,1
高雄市,林園區,1821,389,131,520,24,544,1218,44.66%,31.94%,1
高雄市,林園區,1822,340,107,447,25,472,1147,41.15%,29.64%,1
高雄市,林園區,1823,344,127,471,21,492,1176,41.84%,29.25%,1
高雄市,大寮區,1692,234,81,315,35,350,727,48.14%,32.19%,1
高雄市,大寮區,1693,230,86,316,17,333,718,46.38%,32.03%,1
高雄市,大寮區,1694,476,143,619,45,664,1340,49.55%,35.52%,1
高雄市,大寮區,1695,415,275,690,49,739,1575,46.92%,26.35%,1
高雄市,大寮區,1696,172,58,230,32,262,444,59.01%,38.74%,1
高雄市,大寮區,1697,798,208,1006,50,1056,2374,44.48%,33.61%,1
高雄市,大寮區,1698,500,141,641,82,723,1291,56%,38.73%,1
高雄市,大寮區,1699,535,194,729,80,809,1400,57.79%,38.21%,1
高雄市,大寮區,1700,534,168,702,34,736,1390,52.95%,38.42%,1
高雄市,大寮區,1701,491,208,699,82,781,1401,55.75%,35.05%,1
高雄市,大寮區,1702,436,144,580,31,611,1199,50.96%,36.36%,1
高雄市,大寮區,1703,404,146,550,25,575,1210,47.52%,33.39%,1
高雄市,大寮區,1704,458,156,614,51,665,1195,55.65%,38.33%,1
高雄市,大寮區,1705,416,137,553,28,581,1166,49.83%,35.68%,1
高雄市,大寮區,1706,530,168,698,42,740,1353,54.69%,39.17%,1
高雄市,大寮區,1707,423,139,562,80,642,1052,61.03%,40.21%,1
高雄市,大寮區,1708,308,116,424,31,455,1024,44.43%,30.08%,1
高雄市,大寮區,1709,450,174,624,33,657,1189,55.26%,37.85%,1
高雄市,大寮區,1710,629,198,827,92,919,1512,60.78%,41.6%,1
高雄市,大寮區,1711,591,200,791,82,873,1633,53.46%,36.19%,1
高雄市,大寮區,1712,495,166,661,55,716,1214,58.98%,40.77%,1
高雄市,大寮區,1713,528,189,717,85,802,1258,63.75%,41.97%,1
高雄市,大寮區,1714,495,221,716,32,748,1323,56.54%,37.41%,1
高雄市,大寮區,1715,565,141,706,50,756,1253,60.34%,45.09%,1
高雄市,大寮區,1716,461,122,583,71,654,1035,63.19%,44.54%,1
高雄市,大寮區,1717,432,140,572,31,603,1106,54.52%,39.06%,1
高雄市,大寮區,1718,481,158,639,45,684,1195,57.24%,40.25%,1
高雄市,大寮區,1719,430,135,565,26,591,1051,56.23%,40.91%,1
高雄市,大寮區,1720,584,180,764,87,851,1425,59.72%,40.98%,1
高雄市,大寮區,1721,633,217,850,60,910,1635,55.66%,38.72%,1
高雄市,大寮區,1722,552,185,737,68,805,1359,59.23%,40.62%,1
高雄市,大寮區,1723,587,156,743,62,805,1361,59.15%,43.13%,1
高雄市,大寮區,1724,674,197,871,43,914,1629,56.11%,41.38%,1
高雄市,大寮區,1725,644,174,818,61,879,1518,57.91%,42.42%,1
高雄市,大寮區,1726,624,193,817,73,890,1620,54.94%,38.52%,1
高雄市,大寮區,1727,645,189,834,30,864,1648,52.43%,39.14%,1
高雄市,大寮區,1728,567,155,722,50,772,1385,55.74%,40.94%,1
高雄市,大寮區,1729,555,164,719,32,751,1435,52.33%,38.68%,1
高雄市,大寮區,1730,412,121,533,29,562,1046,53.73%,39.39%,1
高雄市,大寮區,1731,263,117,380,37,417,789,52.85%,33.33%,1
高雄市,大寮區,1732,341,117,458,35,493,909,54.24%,37.51%,1
高雄市,大寮區,1733,270,117,387,46,433,733,59.07%,36.83%,1
高雄市,大寮區,1734,532,222,754,84,838,1553,53.96%,34.26%,1
高雄市,大寮區,1735,432,39,471,28,499,922,54.12%,46.85%,1
高雄市,大寮區,1736,373,136,509,77,586,1012,57.91%,36.86%,1
高雄市,大寮區,1737,333,128,461,71,532,968,54.96%,34.4%,1
高雄市,大寮區,1738,376,122,498,44,542,1021,53.09%,36.83%,1
高雄市,大寮區,1739,509,154,663,85,748,1554,48.13%,32.75%,1
高雄市,大寮區,1740,452,166,618,68,686,1120,61.25%,40.36%,1
高雄市,大寮區,1741,561,146,707,60,767,1225,62.61%,45.8%,1
高雄市,大寮區,1742,383,103,486,25,511,1320,38.71%,29.02%,1
高雄市,大寮區,1743,528,163,691,51,742,1317,56.34%,40.09%,1
高雄市,大寮區,1744,441,131,572,25,597,1119,53.35%,39.41%,1
高雄市,大寮區,1745,510,157,667,55,722,1190,60.67%,42.86%,1
高雄市,大寮區,1746,534,164,698,57,755,1229,61.43%,43.45%,1
高雄市,大寮區,1747,549,148,697,56,753,1178,63.92%,46.6%,1
高雄市,大寮區,1748,575,183,758,35,793,1272,62.34%,45.2%,1
高雄市,大寮區,1749,573,164,737,31,768,1413,54.35%,40.55%,1
高雄市,大寮區,1750,527,153,680,59,739,1185,62.36%,44.47%,1
高雄市,大寮區,1751,242,53,295,6,301,553,54.43%,43.76%,1
高雄市,大寮區,1752,402,149,551,78,629,1121,56.11%,35.86%,1
高雄市,大寮區,1753,481,174,655,29,684,1227,55.75%,39.2%,1
高雄市,大寮區,1754,485,158,643,74,717,1058,67.77%,45.84%,1
高雄市,大寮區,1755,492,167,659,36,695,1209,57.49%,40.69%,1
高雄市,大寮區,1756,474,135,609,20,629,1100,57.18%,43.09%,1
高雄市,大寮區,1757,430,129,559,30,589,1122,52.5%,38.32%,1
高雄市,大寮區,1758,407,157,564,81,645,983,65.62%,41.4%,1
高雄市,大寮區,1759,430,142,572,31,603,1192,50.59%,36.07%,1
高雄市,大寮區,1760,258,97,355,32,387,719,53.82%,35.88%,1
高雄市,大寮區,1761,350,98,448,40,488,829,58.87%,42.22%,1
高雄市,大寮區,1762,339,115,454,79,533,771,69.13%,43.97%,1
高雄市,大寮區,1763,406,183,589,90,679,1075,63.16%,37.77%,1
高雄市,大寮區,1764,519,176,695,92,787,1280,61.48%,40.55%,1
高雄市,大寮區,1765,445,157,602,89,691,1179,58.61%,37.74%,1
高雄市,大寮區,1766,441,158,599,29,628,1210,51.9%,36.45%,1
高雄市,大寮區,1767,94,15,109,7,116,189,61.38%,49.74%,1
高雄市,大寮區,1768,525,155,680,71,751,1228,61.16%,42.75%,1
高雄市,大寮區,1769,511,119,630,42,672,1170,57.44%,43.68%,1
高雄市,大寮區,1770,663,153,816,57,873,1416,61.65%,46.82%,1
高雄市,大寮區,1771,690,173,863,2,865,1482,58.37%,46.56%,1
高雄市,大寮區,1772,612,140,752,67,819,1478,55.41%,41.41%,1
高雄市,大樹區,0736,537,176,713,29,742,1386,53.54%,38.74%,1
高雄市,大樹區,0737,605,194,799,36,835,1315,63.5%,46.01%,1
高雄市,大樹區,0738,946,288,1234,82,1316,2461,53.47%,38.44%,1
高雄市,大樹區,0739,487,143,630,37,667,1274,52.35%,38.23%,1
高雄市,大樹區,0740,502,140,642,71,713,1265,56.36%,39.68%,1
高雄市,大樹區,0741,577,168,745,78,823,1504,54.72%,38.36%,1
高雄市,大樹區,0742,357,128,485,29,514,1049,49%,34.03%,1
高雄市,大樹區,0743,596,192,788,54,842,1573,53.53%,37.89%,1
高雄市,大樹區,0744,384,101,485,41,526,1121,46.92%,34.26%,1
高雄市,大樹區,0745,490,153,643,58,701,1207,58.08%,40.6%,1
高雄市,大樹區,0746,417,145,562,28,590,1134,52.03%,36.77%,1
高雄市,大樹區,0747,430,183,613,40,653,1124,58.1%,38.26%,1
高雄市,大樹區,0748,453,160,613,104,717,1259,56.95%,35.98%,1
高雄市,大樹區,0749,479,145,624,67,691,1105,62.53%,43.35%,1
高雄市,大樹區,0750,429,154,583,64,647,1128,57.36%,38.03%,1
高雄市,大樹區,0751,367,137,504,89,593,1079,54.96%,34.01%,1
高雄市,大樹區,0752,355,110,465,39,504,1025,49.17%,34.63%,1
高雄市,大樹區,0753,347,120,467,61,528,950,55.58%,36.53%,1
高雄市,大樹區,0754,484,220,704,107,811,1433,56.59%,33.78%,1
高雄市,大樹區,0755,258,92,350,24,374,794,47.1%,32.49%,1
高雄市,大樹區,0756,201,72,273,17,290,781,37.13%,25.74%,1
高雄市,大樹區,0757,419,162,581,30,611,1318,46.36%,31.79%,1
高雄市,大樹區,0758,267,88,355,49,404,736,54.89%,36.28%,1
高雄市,大樹區,0759,324,126,450,28,478,1047,45.65%,30.95%,1
高雄市,大樹區,0760,483,172,655,84,739,1271,58.14%,38%,1
高雄市,大樹區,0761,371,143,514,39,553,1186,46.63%,31.28%,1
高雄市,大樹區,0762,391,132,523,53,576,1007,57.2%,38.83%,1
高雄市,大樹區,0763,348,108,456,57,513,859,59.72%,40.51%,1
高雄市,大樹區,0764,253,58,311,22,333,735,45.31%,34.42%,1
高雄市,大樹區,0765,415,146,561,77,638,1046,60.99%,39.67%,1
高雄市,大樹區,0766,540,63,603,48,651,880,73.98%,61.36%,1
高雄市,大樹區,0767,263,76,339,20,359,720,49.86%,36.53%,1
高雄市,大社區,0637,336,130,466,76,542,950,57.05%,35.37%,1
高雄市,大社區,0638,456,162,618,45,663,1306,50.77%,34.92%,1
高雄市,大社區,0639,620,161,781,40,821,1856,44.23%,33.41%,1
高雄市,大社區,0640,408,154,562,69,631,986,64%,41.38%,1
高雄市,大社區,0641,372,138,510,63,573,1116,51.34%,33.33%,1
高雄市,大社區,0642,520,201,721,85,806,1253,64.33%,41.5%,1
高雄市,大社區,0643,643,221,864,63,927,1613,57.47%,39.86%,1
高雄市,大社區,0644,521,193,714,56,770,1455,52.92%,35.81%,1
高雄市,大社區,0645,641,273,914,61,975,1674,58.24%,38.29%,1
高雄市,大社區,0646,420,120,540,67,607,1004,60.46%,41.83%,1
高雄市,大社區,0647,329,132,461,40,501,879,57%,37.43%,1
高雄市,大社區,0648,261,124,385,22,407,778,52.31%,33.55%,1
高雄市,大社區,0649,437,174,611,64,675,1110,60.81%,39.37%,1
高雄市,大社區,0650,535,209,744,64,808,1432,56.42%,37.36%,1
高雄市,大社區,0651,596,194,790,49,839,1466,57.23%,40.65%,1
高雄市,大社區,0652,572,243,815,95,910,1383,65.8%,41.36%,1
高雄市,大社區,0653,681,217,898,87,985,1645,59.88%,41.4%,1
高雄市,大社區,0654,530,195,725,58,783,1555,50.35%,34.08%,1
高雄市,大社區,0655,660,266,926,88,1014,1750,57.94%,37.71%,1
高雄市,大社區,0656,425,161,586,65,651,1111,58.6%,38.25%,1
高雄市,大社區,0657,462,154,616,78,694,1133,61.25%,40.78%,1
高雄市,大社區,0658,374,116,490,46,536,912,58.77%,41.01%,1
高雄市,大社區,0659,234,82,316,16,332,745,44.56%,31.41%,1
高雄市,大社區,0660,374,130,504,35,539,934,57.71%,40.04%,1
高雄市,仁武區,0661,803,247,1050,55,1105,1777,62.18%,45.19%,1
高雄市,仁武區,0662,993,320,1313,76,1389,2273,61.11%,43.69%,1
高雄市,仁武區,0663,622,208,830,81,911,1384,65.82%,44.94%,1
高雄市,仁武區,0664,467,157,624,64,688,1170,58.8%,39.91%,1
高雄市,仁武區,0665,540,203,743,73,816,1216,67.11%,44.41%,1
高雄市,仁武區,0666,662,203,865,22,887,1598,55.51%,41.43%,1
高雄市,仁武區,0667,1008,272,1280,47,1327,2143,61.92%,47.04%,1
高雄市,仁武區,0668,498,174,672,73,745,1300,57.31%,38.31%,1
高雄市,仁武區,0669,548,186,734,77,811,1338,60.61%,40.96%,1
高雄市,仁武區,0670,450,163,613,23,636,1217,52.26%,36.98%,1
高雄市,仁武區,0671,403,135,538,78,616,1202,51.25%,33.53%,1
高雄市,仁武區,0672,500,169,669,47,716,1404,51%,35.61%,1
高雄市,仁武區,0673,314,109,423,57,480,830,57.83%,37.83%,1
高雄市,仁武區,0674,556,172,728,42,770,1802,42.73%,30.85%,1
高雄市,仁武區,0675,703,203,906,82,988,1877,52.64%,37.45%,1
高雄市,仁武區,0676,581,196,777,48,825,1738,47.47%,33.43%,1
高雄市,仁武區,0677,581,198,779,64,843,1549,54.42%,37.51%,1
高雄市,仁武區,0678,637,251,888,59,947,1579,59.97%,40.34%,1
高雄市,仁武區,0679,542,158,700,43,743,1406,52.84%,38.55%,1
高雄市,仁武區,0680,653,137,790,32,822,1461,56.26%,44.7%,1
高雄市,仁武區,0681,550,209,759,61,820,1311,62.55%,41.95%,1
高雄市,仁武區,0682,531,168,699,37,736,1373,53.61%,38.67%,1
高雄市,仁武區,0683,312,152,464,21,485,1035,46.86%,30.14%,1
高雄市,仁武區,0684,405,185,590,40,630,1181,53.34%,34.29%,1
高雄市,仁武區,0685,643,200,843,51,894,1670,53.53%,38.5%,1
高雄市,仁武區,0686,599,227,826,26,852,1576,54.06%,38.01%,1
高雄市,仁武區,0687,709,198,907,69,976,1576,61.93%,44.99%,1
高雄市,仁武區,0688,859,259,1118,47,1165,1915,60.84%,44.86%,1
高雄市,仁武區,0689,720,191,911,32,943,1758,53.64%,40.96%,1
高雄市,仁武區,0690,888,233,1121,72,1193,1892,63.05%,46.93%,1
高雄市,仁武區,0691,871,267,1138,84,1222,2025,60.35%,43.01%,1
高雄市,仁武區,0692,927,237,1164,74,1238,2014,61.47%,46.03%,1
高雄市,仁武區,0693,685,232,917,58,975,1473,66.19%,46.5%,1
高雄市,仁武區,0694,346,119,465,49,514,979,52.5%,35.34%,1
高雄市,仁武區,0695,384,115,499,28,527,944,55.83%,40.68%,1
高雄市,仁武區,0696,468,146,614,86,700,1153,60.71%,40.59%,1
高雄市,仁武區,0697,510,148,658,43,701,1328,52.79%,38.4%,1
高雄市,仁武區,0698,672,246,918,80,998,1657,60.23%,40.56%,1
高雄市,仁武區,0699,636,107,743,74,817,1545,52.88%,41.17%,1
高雄市,仁武區,0700,597,217,814,61,875,1417,61.75%,42.13%,1
高雄市,仁武區,0701,752,217,969,55,1024,1602,63.92%,46.94%,1
高雄市,仁武區,0702,823,258,1081,87,1168,1823,64.07%,45.15%,1
高雄市,仁武區,0703,777,254,1031,38,1069,1914,55.85%,40.6%,1
高雄市,仁武區,0704,914,150,1064,57,1121,1992,56.28%,45.88%,1
高雄市,仁武區,0705,774,254,1028,45,1073,2045,52.47%,37.85%,1
高雄市,仁武區,0706,895,246,1141,63,1204,1982,60.75%,45.16%,1
高雄市,仁武區,0707,828,272,1100,63,1163,2167,53.67%,38.21%,1
高雄市,鳥松區,0708,666,252,918,64,982,1678,58.52%,39.69%,1
高雄市,鳥松區,0709,638,201,839,75,914,1682,54.34%,37.93%,1
高雄市,鳥松區,0710,510,181,691,53,744,1225,60.73%,41.63%,1
高雄市,鳥松區,0711,503,162,665,68,733,1322,55.45%,38.05%,1
高雄市,鳥松區,0712,509,170,679,56,735,1215,60.49%,41.89%,1
高雄市,鳥松區,0713,665,242,907,51,958,1779,53.85%,37.38%,1
高雄市,鳥松區,0714,486,215,701,28,729,1129,64.57%,43.05%,1
高雄市,鳥松區,0715,590,197,787,68,855,1374,62.23%,42.94%,1
高雄市,鳥松區,0716,399,190,589,35,624,1089,57.3%,36.64%,1
高雄市,鳥松區,0717,940,348,1288,69,1357,2219,61.15%,42.36%,1
高雄市,鳥松區,0718,652,240,892,32,924,1634,56.55%,39.9%,1
高雄市,鳥松區,0719,702,216,918,68,986,1553,63.49%,45.2%,1
高雄市,鳥松區,0720,692,246,938,55,993,1572,63.17%,44.02%,1
高雄市,鳥松區,0721,723,292,1015,44,1059,1688,62.74%,42.83%,1
高雄市,鳥松區,0722,678,283,961,39,1000,1626,61.5%,41.7%,1
高雄市,鳥松區,0723,773,276,1049,70,1119,1744,64.16%,44.32%,1
高雄市,鳥松區,0724,466,162,628,58,686,1230,55.77%,37.89%,1
高雄市,鳥松區,0725,508,166,674,94,768,1201,63.95%,42.3%,1
高雄市,鳥松區,0726,498,167,665,51,716,1117,64.1%,44.58%,1
高雄市,鳥松區,0727,479,164,643,71,714,1255,56.89%,38.17%,1
高雄市,鳥松區,0728,535,154,689,46,735,1432,51.33%,37.36%,1
高雄市,鳥松區,0729,500,166,666,37,703,1370,51.31%,36.5%,1
高雄市,鳥松區,0730,618,159,777,71,848,1364,62.17%,45.31%,1
高雄市,鳥松區,0731,418,168,586,65,651,1041,62.54%,40.15%,1
高雄市,鳥松區,0732,361,107,468,40,508,702,72.36%,51.42%,1
高雄市,鳥松區,0733,470,189,659,69,728,1212,60.07%,38.78%,1
高雄市,鳥松區,0734,548,145,693,64,757,1289,58.73%,42.51%,1
高雄市,鳥松區,0735,658,222,880,47,927,1449,63.98%,45.41%,1
高雄市,岡山區,0261,632,190,822,53,875,1345,65.06%,46.99%,1
高雄市,岡山區,0262,312,128,440,24,464,1045,44.4%,29.86%,1
高雄市,岡山區,0263,461,127,588,50,638,1051,60.7%,43.86%,1
高雄市,岡山區,0264,399,122,521,19,540,917,58.89%,43.51%,1
高雄市,岡山區,0265,426,137,563,39,602,934,64.45%,45.61%,1
高雄市,岡山區,0266,483,150,633,55,688,1097,62.72%,44.03%,1
高雄市,岡山區,0267,584,175,759,43,802,1208,66.39%,48.34%,1
高雄市,岡山區,0268,498,188,686,80,766,1159,66.09%,42.97%,1
高雄市,岡山區,0269,411,155,566,58,624,1018,61.3%,40.37%,1
高雄市,岡山區,0270,450,157,607,42,649,1316,49.32%,34.19%,1
高雄市,岡山區,0271,551,72,623,36,659,1345,49%,40.97%,1
高雄市,岡山區,0272,557,193,750,53,803,1295,62.01%,43.01%,1
高雄市,岡山區,0273,599,179,778,63,841,1425,59.02%,42.04%,1
高雄市,岡山區,0274,530,139,669,37,706,1328,53.16%,39.91%,1
高雄市,岡山區,0275,602,171,773,24,797,1382,57.67%,43.56%,1
高雄市,岡山區,0276,656,152,808,22,830,1381,60.1%,47.5%,1
高雄市,岡山區,0277,531,159,690,79,769,1282,59.98%,41.42%,1
高雄市,岡山區,0278,507,163,670,18,688,1240,55.48%,40.89%,1
高雄市,岡山區,0279,587,143,730,64,794,1327,59.83%,44.24%,1
高雄市,岡山區,0280,708,192,900,66,966,1736,55.65%,40.78%,1
高雄市,岡山區,0281,665,208,873,73,946,1566,60.41%,42.46%,1
高雄市,岡山區,0282,545,167,712,46,758,1779,42.61%,30.64%,1
高雄市,岡山區,0283,687,196,883,73,956,1593,60.01%,43.13%,1
高雄市,岡山區,0284,645,202,847,70,917,1480,61.96%,43.58%,1
高雄市,岡山區,0285,608,163,771,37,808,1364,59.24%,44.57%,1
高雄市,岡山區,0286,617,189,806,56,862,1410,61.13%,43.76%,1
高雄市,岡山區,0287,539,183,722,64,786,1148,68.47%,46.95%,1
高雄市,岡山區,0288,251,101,352,52,404,625,64.64%,40.16%,1
高雄市,岡山區,0289,444,112,556,41,597,969,61.61%,45.82%,1
高雄市,岡山區,0290,388,117,505,22,527,861,61.21%,45.06%,1
高雄市,岡山區,0291,307,98,405,26,431,823,52.37%,37.3%,1
高雄市,岡山區,0292,391,135,526,67,593,889,66.7%,43.98%,1
高雄市,岡山區,0293,550,167,717,53,770,1283,60.02%,42.87%,1
高雄市,岡山區,0294,600,174,774,48,822,1512,54.37%,39.68%,1
高雄市,岡山區,0295,437,177,614,58,672,983,68.36%,44.46%,1
高雄市,岡山區,0296,540,164,704,46,750,1262,59.43%,42.79%,1
高雄市,岡山區,0297,450,163,613,65,678,1096,61.86%,41.06%,1
高雄市,岡山區,0298,456,134,590,56,646,1066,60.6%,42.78%,1
高雄市,岡山區,0299,496,126,622,40,662,1188,55.72%,41.75%,1
高雄市,岡山區,0300,587,183,770,66,836,1360,61.47%,43.16%,1
高雄市,岡山區,0301,596,186,782,44,826,1363,60.6%,43.73%,1
高雄市,岡山區,0302,640,180,820,57,877,1352,64.87%,47.34%,1
高雄市,岡山區,0303,628,171,799,70,869,1460,59.52%,43.01%,1
高雄市,岡山區,0304,574,154,728,53,781,1272,61.4%,45.13%,1
高雄市,岡山區,0305,510,136,646,51,697,1080,64.54%,47.22%,1
高雄市,岡山區,0306,523,179,702,76,778,1255,61.99%,41.67%,1
高雄市,岡山區,0307,434,143,577,52,629,938,67.06%,46.27%,1
高雄市,岡山區,0308,563,170,733,56,789,1237,63.78%,45.51%,1
高雄市,岡山區,0309,487,177,664,35,699,1413,49.47%,34.47%,1
高雄市,岡山區,0310,309,113,422,13,435,765,56.86%,40.39%,1
高雄市,岡山區,0311,483,153,636,41,677,1043,64.91%,46.31%,1
高雄市,岡山區,0312,310,84,394,35,429,844,50.83%,36.73%,1
高雄市,岡山區,0313,514,172,686,42,728,993,73.31%,51.76%,1
高雄市,岡山區,0314,462,141,603,67,670,1038,64.55%,44.51%,1
高雄市,岡山區,0315,402,171,573,78,651,1070,60.84%,37.57%,1
高雄市,岡山區,0316,435,167,602,81,683,1023,66.76%,42.52%,1
高雄市,岡山區,0317,527,202,729,34,763,1349,56.56%,39.07%,1
高雄市,岡山區,0318,545,160,705,49,754,1452,51.93%,37.53%,1
高雄市,岡山區,0319,46,138,184,19,203,301,67.44%,15.28%,1
高雄市,岡山區,0320,311,115,426,85,511,756,67.59%,41.14%,1
高雄市,岡山區,0321,244,89,333,15,348,733,47.48%,33.29%,1
高雄市,岡山區,0322,380,134,514,78,592,854,69.32%,44.5%,1
高雄市,岡山區,0323,271,78,349,22,371,866,42.84%,31.29%,1
高雄市,岡山區,0324,382,117,499,60,559,978,57.16%,39.06%,1
高雄市,岡山區,0325,716,103,819,0,819,1336,61.3%,53.59%,1
高雄市,岡山區,0326,665,79,744,18,762,1218,62.56%,54.6%,1
高雄市,岡山區,0327,179,62,241,18,259,341,75.95%,52.49%,1
高雄市,岡山區,0328,623,61,684,30,714,955,74.76%,65.24%,1
高雄市,岡山區,0329,574,59,633,15,648,940,68.94%,61.06%,1
高雄市,岡山區,0330,413,115,528,48,576,851,67.69%,48.53%,1
高雄市,岡山區,0331,435,79,514,21,535,762,70.21%,57.09%,1
高雄市,岡山區,0332,153,71,224,16,240,318,75.47%,48.11%,1
高雄市,橋頭區,0404,443,144,587,80,667,1005,66.37%,44.08%,1
高雄市,橋頭區,0405,447,177,624,54,678,1073,63.19%,41.66%,1
高雄市,橋頭區,0406,443,163,606,41,647,1129,57.31%,39.24%,1
高雄市,橋頭區,0407,523,173,696,85,781,1244,62.78%,42.04%,1
高雄市,橋頭區,0408,428,148,576,41,617,1091,56.55%,39.23%,1
高雄市,橋頭區,0409,593,205,798,60,858,1329,64.56%,44.62%,1
高雄市,橋頭區,0410,471,187,658,47,705,1140,61.84%,41.32%,1
高雄市,橋頭區,0411,574,98,672,82,754,1220,61.8%,47.05%,1
高雄市,橋頭區,0412,456,186,642,67,709,1047,67.72%,43.55%,1
高雄市,橋頭區,0413,478,200,678,107,785,1315,59.7%,36.35%,1
高雄市,橋頭區,0414,247,100,347,38,385,691,55.72%,35.75%,1
高雄市,橋頭區,0415,308,106,414,60,474,720,65.83%,42.78%,1
高雄市,橋頭區,0416,487,179,666,80,746,1192,62.58%,40.86%,1
高雄市,橋頭區,0417,537,221,758,80,838,1318,63.58%,40.74%,1
高雄市,橋頭區,0418,333,105,438,53,491,761,64.52%,43.76%,1
高雄市,橋頭區,0419,392,131,523,28,551,973,56.63%,40.29%,1
高雄市,橋頭區,0420,252,75,327,34,361,587,61.5%,42.93%,1
高雄市,橋頭區,0421,361,119,480,47,527,812,64.9%,44.46%,1
高雄市,橋頭區,0422,136,67,203,11,214,343,62.39%,39.65%,1
高雄市,橋頭區,0423,618,156,774,37,811,1266,64.06%,48.82%,1
高雄市,橋頭區,0424,471,168,639,98,737,1128,65.34%,41.76%,1
高雄市,橋頭區,0425,380,115,495,68,563,884,63.69%,42.99%,1
高雄市,橋頭區,0426,480,127,607,83,690,1187,58.13%,40.44%,1
高雄市,橋頭區,0427,523,159,682,89,771,1259,61.24%,41.54%,1
高雄市,橋頭區,0428,495,176,671,80,751,1361,55.18%,36.37%,1
高雄市,橋頭區,0429,232,84,316,37,353,671,52.61%,34.58%,1
高雄市,橋頭區,0430,520,192,712,67,779,1215,64.12%,42.8%,1
高雄市,橋頭區,0431,466,207,673,108,781,1255,62.23%,37.13%,1
高雄市,橋頭區,0432,536,184,720,67,787,1219,64.56%,43.97%,1
高雄市,橋頭區,0433,549,165,714,37,751,1372,54.74%,40.01%,1
高雄市,橋頭區,0434,208,80,288,11,299,758,39.45%,27.44%,1
高雄市,燕巢區,0333,431,132,563,93,656,1152,56.94%,37.41%,1
高雄市,燕巢區,0334,460,146,606,27,633,1120,56.52%,41.07%,1
高雄市,燕巢區,0335,431,152,583,58,641,974,65.81%,44.25%,1
高雄市,燕巢區,0336,372,146,518,16,534,1019,52.4%,36.51%,1
高雄市,燕巢區,0337,389,135,524,73,597,1058,56.43%,36.77%,1
高雄市,燕巢區,0338,297,92,389,40,429,1017,42.18%,29.2%,1
高雄市,燕巢區,0339,33,4,37,4,41,259,15.83%,12.74%,1
高雄市,燕巢區,0340,426,127,553,64,617,926,66.63%,46%,1
高雄市,燕巢區,0341,213,76,289,18,307,624,49.2%,34.13%,1
高雄市,燕巢區,0342,485,163,648,69,717,1102,65.06%,44.01%,1
高雄市,燕巢區,0343,391,130,521,56,577,1072,53.82%,36.47%,1
高雄市,燕巢區,0344,517,192,709,65,774,1361,56.87%,37.99%,1
高雄市,燕巢區,0345,203,49,252,35,287,472,60.81%,43.01%,1
高雄市,燕巢區,0346,445,131,576,60,636,1197,53.13%,37.18%,1
高雄市,燕巢區,0347,496,151,647,91,738,1134,65.08%,43.74%,1
高雄市,燕巢區,0348,405,149,554,50,604,1148,52.61%,35.28%,1
高雄市,燕巢區,0349,456,121,577,75,652,1207,54.02%,37.78%,1
高雄市,燕巢區,0350,636,193,829,46,875,1402,62.41%,45.36%,1
高雄市,燕巢區,0351,381,153,534,73,607,1000,60.7%,38.1%,1
高雄市,燕巢區,0352,459,150,609,71,680,1110,61.26%,41.35%,1
高雄市,燕巢區,0353,507,160,667,76,743,1291,57.55%,39.27%,1
高雄市,燕巢區,0354,284,124,408,78,486,797,60.98%,35.63%,1
高雄市,燕巢區,0355,364,137,501,64,565,1098,51.46%,33.15%,1
高雄市,燕巢區,0356,519,162,681,70,751,1393,53.91%,37.26%,1
高雄市,燕巢區,0357,337,90,427,27,454,1079,42.08%,31.23%,1
高雄市,田寮區,0237,99,37,136,6,142,369,38.48%,26.83%,1
高雄市,田寮區,0238,189,56,245,25,270,656,41.16%,28.81%,1
高雄市,田寮區,0239,73,31,104,11,115,406,28.33%,17.98%,1
高雄市,田寮區,0240,118,42,160,27,187,380,49.21%,31.05%,1
高雄市,田寮區,0241,129,48,177,15,192,379,50.66%,34.04%,1
高雄市,田寮區,0242,208,85,293,58,351,625,56.16%,33.28%,1
高雄市,田寮區,0243,322,91,413,20,433,946,45.77%,34.04%,1
高雄市,田寮區,0244,232,88,320,54,374,794,47.1%,29.22%,1
高雄市,田寮區,0245,101,40,141,27,168,382,43.98%,26.44%,1
高雄市,田寮區,0246,99,58,157,42,199,513,38.79%,19.3%,1
高雄市,田寮區,0247,183,84,267,23,290,601,48.25%,30.45%,1
高雄市,田寮區,0248,216,85,301,58,359,620,57.9%,34.84%,1
高雄市,阿蓮區,0216,375,175,550,45,595,1299,45.8%,28.87%,1
高雄市,阿蓮區,0217,405,140,545,31,576,1107,52.03%,36.59%,1
高雄市,阿蓮區,0218,290,111,401,31,432,898,48.11%,32.29%,1
高雄市,阿蓮區,0219,436,153,589,85,674,1259,53.53%,34.63%,1
高雄市,阿蓮區,0220,573,184,757,50,807,1579,51.11%,36.29%,1
高雄市,阿蓮區,0221,230,76,306,9,315,564,55.85%,40.78%,1
高雄市,阿蓮區,0222,326,119,445,51,496,768,64.58%,42.45%,1
高雄市,阿蓮區,0223,436,145,581,55,636,1092,58.24%,39.93%,1
高雄市,阿蓮區,0224,405,156,561,63,624,1099,56.78%,36.85%,1
高雄市,阿蓮區,0225,467,126,593,26,619,1134,54.59%,41.18%,1
高雄市,阿蓮區,0226,547,194,741,27,768,1561,49.2%,35.04%,1
高雄市,阿蓮區,0227,583,223,806,92,898,1533,58.58%,38.03%,1
高雄市,阿蓮區,0228,381,137,518,33,551,1116,49.37%,34.14%,1
高雄市,阿蓮區,0229,367,139,506,43,549,1054,52.09%,34.82%,1
高雄市,阿蓮區,0230,479,146,625,58,683,1260,54.21%,38.02%,1
高雄市,阿蓮區,0231,546,172,718,74,792,1504,52.66%,36.3%,1
高雄市,阿蓮區,0232,271,103,374,20,394,848,46.46%,31.96%,1
高雄市,阿蓮區,0233,320,80,400,24,424,823,51.52%,38.88%,1
高雄市,阿蓮區,0234,412,118,530,25,555,1021,54.36%,40.35%,1
高雄市,阿蓮區,0235,587,197,784,47,831,1715,48.45%,34.23%,1
高雄市,阿蓮區,0236,460,167,627,55,682,1300,52.46%,35.38%,1
高雄市,路竹區,0175,373,121,494,29,523,1026,50.97%,36.35%,1
高雄市,路竹區,0176,397,155,552,74,626,1069,58.56%,37.14%,1
高雄市,路竹區,0177,460,154,614,75,689,1127,61.14%,40.82%,1
高雄市,路竹區,0178,440,146,586,78,664,1179,56.32%,37.32%,1
高雄市,路竹區,0179,454,153,607,95,702,1237,56.75%,36.7%,1
高雄市,路竹區,0180,535,56,591,65,656,1096,59.85%,48.81%,1
高雄市,路竹區,0181,556,161,717,80,797,1272,62.66%,43.71%,1
高雄市,路竹區,0182,470,159,629,64,693,1182,58.63%,39.76%,1
高雄市,路竹區,0183,460,143,603,49,652,1127,57.85%,40.82%,1
高雄市,路竹區,0184,386,127,513,58,571,956,59.73%,40.38%,1
高雄市,路竹區,0185,431,172,603,59,662,1132,58.48%,38.07%,1
高雄市,路竹區,0186,424,140,564,91,655,1025,63.9%,41.37%,1
高雄市,路竹區,0187,369,123,492,32,524,1007,52.04%,36.64%,1
高雄市,路竹區,0188,469,156,625,71,696,1301,53.5%,36.05%,1
高雄市,路竹區,0189,364,107,471,34,505,885,57.06%,41.13%,1
高雄市,路竹區,0190,258,111,369,22,391,837,46.71%,30.82%,1
高雄市,路竹區,0191,369,130,499,66,565,930,60.75%,39.68%,1
高雄市,路竹區,0192,246,107,353,49,402,781,51.47%,31.5%,1
高雄市,路竹區,0193,380,161,541,66,607,1023,59.34%,37.15%,1
高雄市,路竹區,0194,745,204,949,84,1033,1763,58.59%,42.26%,1
高雄市,路竹區,0195,616,223,839,65,904,1637,55.22%,37.63%,1
高雄市,路竹區,0196,390,148,538,49,587,1070,54.86%,36.45%,1
高雄市,路竹區,0197,461,170,631,77,708,1177,60.15%,39.17%,1
高雄市,路竹區,0198,402,141,543,49,592,1007,58.79%,39.92%,1
高雄市,路竹區,0199,513,31,544,42,586,1026,57.12%,50%,1
高雄市,路竹區,0200,410,130,540,60,600,1017,59%,40.31%,1
高雄市,路竹區,0201,493,172,665,68,733,1264,57.99%,39%,1
高雄市,路竹區,0202,464,143,607,52,659,1089,60.51%,42.61%,1
高雄市,路竹區,0203,331,117,448,43,491,851,57.7%,38.9%,1
高雄市,路竹區,0204,410,149,559,65,624,1011,61.72%,40.55%,1
高雄市,路竹區,0205,421,146,567,36,603,937,64.35%,44.93%,1
高雄市,路竹區,0206,254,110,364,14,378,820,46.1%,30.98%,1
高雄市,路竹區,0207,405,142,547,32,579,910,63.63%,44.51%,1
高雄市,路竹區,0208,330,115,445,48,493,867,56.86%,38.06%,1
高雄市,路竹區,0209,356,128,484,45,529,937,56.46%,37.99%,1
高雄市,路竹區,0210,370,115,485,26,511,900,56.78%,41.11%,1
高雄市,路竹區,0211,370,125,495,57,552,900,61.33%,41.11%,1
高雄市,路竹區,0212,393,113,506,40,546,918,59.48%,42.81%,1
高雄市,路竹區,0213,371,145,516,41,557,870,64.02%,42.64%,1
高雄市,路竹區,0214,494,176,670,51,721,1150,62.7%,42.96%,1
高雄市,路竹區,0215,723,184,907,73,980,1537,63.76%,47.04%,1
高雄市,湖內區,0151,380,132,512,35,547,1112,49.19%,34.17%,1
高雄市,湖內區,0152,351,135,486,92,578,1017,56.83%,34.51%,1
高雄市,湖內區,0153,256,110,366,28,394,796,49.5%,32.16%,1
高雄市,湖內區,0154,454,159,613,34,647,1079,59.96%,42.08%,1
高雄市,湖內區,0155,423,155,578,36,614,1115,55.07%,37.94%,1
高雄市,湖內區,0156,482,156,638,40,678,1311,51.72%,36.77%,1
高雄市,湖內區,0157,464,169,633,40,673,1319,51.02%,35.18%,1
高雄市,湖內區,0158,547,159,706,78,784,1244,63.02%,43.97%,1
高雄市,湖內區,0159,552,155,707,58,765,1227,62.35%,44.99%,1
高雄市,湖內區,0160,491,155,646,69,715,1163,61.48%,42.22%,1
高雄市,湖內區,0161,399,151,550,39,589,981,60.04%,40.67%,1
高雄市,湖內區,0162,282,94,376,19,395,780,50.64%,36.15%,1
高雄市,湖內區,0163,304,113,417,57,474,832,56.97%,36.54%,1
高雄市,湖內區,0164,451,147,598,38,636,1017,62.54%,44.35%,1
高雄市,湖內區,0165,423,137,560,31,591,1051,56.23%,40.25%,1
高雄市,湖內區,0166,330,121,451,35,486,941,51.65%,35.07%,1
高雄市,湖內區,0167,314,109,423,54,477,863,55.27%,36.38%,1
高雄市,湖內區,0168,411,157,568,62,630,1160,54.31%,35.43%,1
高雄市,湖內區,0169,312,114,426,25,451,1090,41.38%,28.62%,1
高雄市,湖內區,0170,411,174,585,57,642,1122,57.22%,36.63%,1
高雄市,湖內區,0171,353,117,470,31,501,1123,44.61%,31.43%,1
高雄市,湖內區,0172,225,102,327,32,359,684,52.49%,32.89%,1
高雄市,湖內區,0173,440,137,577,27,604,1249,48.36%,35.23%,1
高雄市,湖內區,0174,508,153,661,57,718,1453,49.42%,34.96%,1
高雄市,茄萣區,0130,285,119,404,22,426,976,43.65%,29.2%,1
高雄市,茄萣區,0131,275,140,415,69,484,887,54.57%,31%,1
高雄市,茄萣區,0132,621,178,799,39,838,1710,49.01%,36.32%,1
高雄市,茄萣區,0133,379,142,521,39,560,1280,43.75%,29.61%,1
高雄市,茄萣區,0134,508,170,678,33,711,1314,54.11%,38.66%,1
高雄市,茄萣區,0135,482,163,645,29,674,1157,58.25%,41.66%,1
高雄市,茄萣區,0136,631,232,863,121,984,1785,55.13%,35.35%,1
高雄市,茄萣區,0137,266,120,386,100,486,838,58%,31.74%,1
高雄市,茄萣區,0138,510,183,693,96,789,1249,63.17%,40.83%,1
高雄市,茄萣區,0139,371,139,510,101,611,1116,54.75%,33.24%,1
高雄市,茄萣區,0140,305,111,416,56,472,978,48.26%,31.19%,1
高雄市,茄萣區,0141,330,114,444,46,490,1125,43.56%,29.33%,1
高雄市,茄萣區,0142,375,168,543,78,621,1139,54.52%,32.92%,1
高雄市,茄萣區,0143,459,183,642,19,661,1363,48.5%,33.68%,1
高雄市,茄萣區,0144,581,238,819,108,927,1598,58.01%,36.36%,1
高雄市,茄萣區,0145,383,150,533,66,599,1111,53.92%,34.47%,1
高雄市,茄萣區,0146,266,100,366,48,414,925,44.76%,28.76%,1
高雄市,茄萣區,0147,406,136,542,69,611,1148,53.22%,35.37%,1
高雄市,茄萣區,0148,453,161,614,44,658,1353,48.63%,33.48%,1
高雄市,茄萣區,0149,458,195,653,68,721,1331,54.17%,34.41%,1
高雄市,茄萣區,0150,589,226,815,70,885,1829,48.39%,32.2%,1
高雄市,永安區,0249,335,111,446,52,498,756,65.87%,44.31%,1
高雄市,永安區,0250,308,124,432,80,512,818,62.59%,37.65%,1
高雄市,永安區,0251,408,138,546,49,595,866,68.71%,47.11%,1
高雄市,永安區,0252,377,164,541,71,612,951,64.35%,39.64%,1
高雄市,永安區,0253,402,152,554,69,623,992,62.8%,40.52%,1
高雄市,永安區,0254,201,83,284,23,307,682,45.01%,29.47%,1
高雄市,永安區,0255,259,99,358,21,379,665,56.99%,38.95%,1
高雄市,永安區,0256,132,59,191,13,204,371,54.99%,35.58%,1
高雄市,永安區,0257,460,188,648,80,728,1114,65.35%,41.29%,1
高雄市,永安區,0258,617,211,828,46,874,1418,61.64%,43.51%,1
高雄市,永安區,0259,637,227,864,88,952,1477,64.45%,43.13%,1
高雄市,永安區,0260,818,270,1088,99,1187,1891,62.77%,43.26%,1
高雄市,彌陀區,0358,478,189,667,81,748,1246,60.03%,38.36%,1
高雄市,彌陀區,0359,358,135,493,55,548,885,61.92%,40.45%,1
高雄市,彌陀區,0360,415,159,574,73,647,955,67.75%,43.46%,1
高雄市,彌陀區,0361,189,78,267,48,315,534,58.99%,35.39%,1
高雄市,彌陀區,0362,313,100,413,32,445,738,60.3%,42.41%,1
高雄市,彌陀區,0363,420,105,525,50,575,855,67.25%,49.12%,1
高雄市,彌陀區,0364,370,126,496,61,557,877,63.51%,42.19%,1
高雄市,彌陀區,0365,326,111,437,65,502,781,64.28%,41.74%,1
高雄市,彌陀區,0366,316,114,430,38,468,808,57.92%,39.11%,1
高雄市,彌陀區,0367,301,111,412,42,454,904,50.22%,33.3%,1
高雄市,彌陀區,0368,322,123,445,54,499,825,60.48%,39.03%,1
高雄市,彌陀區,0369,320,115,435,81,516,941,54.84%,34.01%,1
高雄市,彌陀區,0370,390,136,526,40,566,1013,55.87%,38.5%,1
高雄市,彌陀區,0371,419,154,573,69,642,1024,62.7%,40.92%,1
高雄市,彌陀區,0372,320,93,413,22,435,861,50.52%,37.17%,1
高雄市,彌陀區,0373,495,133,628,96,724,1163,62.25%,42.56%,1
高雄市,彌陀區,0374,530,160,690,99,789,1216,64.88%,43.59%,1
高雄市,彌陀區,0375,390,138,528,94,622,861,72.24%,45.3%,1
高雄市,梓官區,0376,455,164,619,77,696,1061,65.6%,42.88%,1
高雄市,梓官區,0377,413,140,553,82,635,1063,59.74%,38.85%,1
高雄市,梓官區,0378,366,144,510,34,544,969,56.14%,37.77%,1
高雄市,梓官區,0379,347,158,505,31,536,1078,49.72%,32.19%,1
高雄市,梓官區,0380,321,132,453,67,520,838,62.05%,38.31%,1
高雄市,梓官區,0381,230,119,349,31,380,611,62.19%,37.64%,1
高雄市,梓官區,0382,305,102,407,31,438,782,56.01%,39%,1
高雄市,梓官區,0383,644,203,847,95,942,1451,64.92%,44.38%,1
高雄市,梓官區,0384,418,161,579,26,605,1144,52.88%,36.54%,1
高雄市,梓官區,0385,331,123,454,17,471,975,48.31%,33.95%,1
高雄市,梓官區,0386,512,166,678,57,735,1317,55.81%,38.88%,1
高雄市,梓官區,0387,496,174,670,83,753,1218,61.82%,40.72%,1
高雄市,梓官區,0388,433,141,574,43,617,1073,57.5%,40.35%,1
高雄市,梓官區,0389,374,134,508,47,555,1112,49.91%,33.63%,1
高雄市,梓官區,0390,257,97,354,45,399,715,55.8%,35.94%,1
高雄市,梓官區,0391,465,168,633,57,690,1311,52.63%,35.47%,1
高雄市,梓官區,0392,340,128,468,40,508,939,54.1%,36.21%,1
高雄市,梓官區,0393,369,111,480,34,514,824,62.38%,44.78%,1
高雄市,梓官區,0394,423,163,586,109,695,1052,66.06%,40.21%,1
高雄市,梓官區,0395,414,126,540,106,646,1020,63.33%,40.59%,1
高雄市,梓官區,0396,444,159,603,42,645,1260,51.19%,35.24%,1
高雄市,梓官區,0397,603,196,799,50,849,1595,53.23%,37.81%,1
高雄市,梓官區,0398,349,107,456,38,494,829,59.59%,42.1%,1
高雄市,梓官區,0399,577,176,753,35,788,1532,51.44%,37.66%,1
高雄市,梓官區,0400,490,185,675,85,760,1195,63.6%,41%,1
高雄市,梓官區,0401,467,152,619,86,705,1143,61.68%,40.86%,1
高雄市,梓官區,0402,498,168,666,69,735,1186,61.97%,41.99%,1
高雄市,梓官區,0403,614,138,752,47,799,1732,46.13%,35.45%,1
高雄市,旗山區,0060,463,117,580,53,633,1060,59.72%,43.68%,1
高雄市,旗山區,0061,411,128,539,52,591,1125,52.53%,36.53%,1
高雄市,旗山區,0062,499,114,613,32,645,1100,58.64%,45.36%,1
高雄市,旗山區,0063,513,165,678,32,710,1238,57.35%,41.44%,1
高雄市,旗山區,0064,390,105,495,26,521,933,55.84%,41.8%,1
高雄市,旗山區,0065,233,86,319,23,342,727,47.04%,32.05%,1
高雄市,旗山區,0066,409,127,536,59,595,1071,55.56%,38.19%,1
高雄市,旗山區,0067,265,89,354,28,382,744,51.34%,35.62%,1
高雄市,旗山區,0068,362,120,482,31,513,1100,46.64%,32.91%,1
高雄市,旗山區,0069,143,33,176,17,193,369,52.3%,38.75%,1
高雄市,旗山區,0070,254,99,353,20,373,888,42%,28.6%,1
高雄市,旗山區,0071,140,50,190,12,202,510,39.61%,27.45%,1
高雄市,旗山區,0072,401,160,561,87,648,1042,62.19%,38.48%,1
高雄市,旗山區,0073,281,98,379,54,433,791,54.74%,35.52%,1
高雄市,旗山區,0074,363,124,487,83,570,939,60.7%,38.66%,1
高雄市,旗山區,0075,420,143,563,34,597,1218,49.01%,34.48%,1
高雄市,旗山區,0076,53,19,72,23,95,178,53.37%,29.78%,1
高雄市,旗山區,0077,408,120,528,58,586,946,61.95%,43.13%,1
高雄市,旗山區,0078,351,146,497,40,537,1025,52.39%,34.24%,1
高雄市,旗山區,0079,435,114,549,77,626,1040,60.19%,41.83%,1
高雄市,旗山區,0080,380,139,519,54,573,900,63.67%,42.22%,1
高雄市,旗山區,0081,239,63,302,28,330,663,49.77%,36.05%,1
高雄市,旗山區,0082,374,93,467,63,530,954,55.56%,39.2%,1
高雄市,旗山區,0083,374,126,500,37,537,1060,50.66%,35.28%,1
高雄市,旗山區,0084,460,138,598,64,662,1110,59.64%,41.44%,1
高雄市,旗山區,0085,419,153,572,57,629,1062,59.23%,39.45%,1
高雄市,旗山區,0086,457,119,576,42,618,1151,53.69%,39.7%,1
高雄市,旗山區,0087,111,29,140,24,164,266,61.65%,41.73%,1
高雄市,旗山區,0088,242,103,345,39,384,633,60.66%,38.23%,1
高雄市,旗山區,0089,425,161,586,38,624,1307,47.74%,32.52%,1
高雄市,旗山區,0090,240,119,359,66,425,754,56.37%,31.83%,1
高雄市,旗山區,0091,458,168,626,111,737,1296,56.87%,35.34%,1
高雄市,旗山區,0092,253,89,342,23,365,839,43.5%,30.15%,1
高雄市,旗山區,0093,508,176,684,60,744,1329,55.98%,38.22%,1
高雄市,旗山區,0094,259,78,337,33,370,628,58.92%,41.24%,1
高雄市,美濃區,0095,449,146,595,91,686,1175,58.38%,38.21%,1
高雄市,美濃區,0096,483,163,646,37,683,1438,47.5%,33.59%,1
高雄市,美濃區,0097,355,101,456,50,506,989,51.16%,35.89%,1
高雄市,美濃區,0098,575,69,644,78,722,1427,50.6%,40.29%,1
高雄市,美濃區,0099,528,141,669,66,735,1309,56.15%,40.34%,1
高雄市,美濃區,0100,522,158,680,81,761,1263,60.25%,41.33%,1
高雄市,美濃區,0101,431,101,532,67,599,997,60.08%,43.23%,1
高雄市,美濃區,0102,429,129,558,56,614,1064,57.71%,40.32%,1
高雄市,美濃區,0103,597,141,738,79,817,1498,54.54%,39.85%,1
高雄市,美濃區,0104,461,122,583,74,657,1119,58.71%,41.2%,1
高雄市,美濃區,0105,444,115,559,82,641,1031,62.17%,43.06%,1
高雄市,美濃區,0106,520,165,685,78,763,1437,53.1%,36.19%,1
高雄市,美濃區,0107,417,131,548,60,608,1071,56.77%,38.94%,1
高雄市,美濃區,0108,279,67,346,41,387,687,56.33%,40.61%,1
高雄市,美濃區,0109,223,72,295,18,313,775,40.39%,28.77%,1
高雄市,美濃區,0110,469,157,626,68,694,1353,51.29%,34.66%,1
高雄市,美濃區,0111,424,116,540,43,583,1191,48.95%,35.6%,1
高雄市,美濃區,0112,306,91,397,30,427,906,47.13%,33.77%,1
高雄市,美濃區,0113,520,118,638,52,690,1178,58.57%,44.14%,1
高雄市,美濃區,0114,432,118,550,34,584,1252,46.65%,34.5%,1
高雄市,美濃區,0115,623,183,806,59,865,1549,55.84%,40.22%,1
高雄市,美濃區,0116,383,111,494,55,549,1088,50.46%,35.2%,1
高雄市,美濃區,0117,451,135,586,49,635,1116,56.9%,40.41%,1
高雄市,美濃區,0118,365,131,496,32,528,977,54.04%,37.36%,1
高雄市,美濃區,0119,329,113,442,68,510,816,62.5%,40.32%,1
高雄市,美濃區,0120,327,63,390,30,420,955,43.98%,34.24%,1
高雄市,美濃區,0121,373,107,480,67,547,943,58.01%,39.55%,1
高雄市,美濃區,0122,493,123,616,53,669,1371,48.8%,35.96%,1
高雄市,美濃區,0123,314,118,432,74,506,919,55.06%,34.17%,1
高雄市,美濃區,0124,371,129,500,62,562,915,61.42%,40.55%,1
高雄市,美濃區,0125,278,110,388,67,455,828,54.95%,33.57%,1
高雄市,美濃區,0126,184,73,257,60,317,674,47.03%,27.3%,1
高雄市,六龜區,0020,238,92,330,42,372,760,48.95%,31.32%,1
高雄市,六龜區,0021,196,75,271,36,307,666,46.1%,29.43%,1
高雄市,六龜區,0022,275,72,347,52,399,704,56.68%,39.06%,1
高雄市,六龜區,0023,323,115,438,71,509,1003,50.75%,32.2%,1
高雄市,六龜區,0024,422,117,539,114,653,1382,47.25%,30.54%,1
高雄市,六龜區,0025,245,94,339,78,417,986,42.29%,24.85%,1
高雄市,六龜區,0026,340,118,458,54,512,1046,48.95%,32.5%,1
高雄市,六龜區,0027,217,100,317,65,382,812,47.04%,26.72%,1
高雄市,六龜區,0028,551,35,586,77,663,1431,46.33%,38.5%,1
高雄市,六龜區,0029,318,85,403,74,477,912,52.3%,34.87%,1
高雄市,六龜區,0030,375,139,514,49,563,1472,38.25%,25.48%,1
高雄市,六龜區,0031,83,35,118,25,143,327,43.73%,25.38%,1
高雄市,甲仙區,0013,120,30,150,11,161,472,34.11%,25.42%,1
高雄市,甲仙區,0014,388,105,493,61,554,882,62.81%,43.99%,1
高雄市,甲仙區,0015,246,67,313,41,354,668,52.99%,36.83%,1
高雄市,甲仙區,0016,503,167,670,124,794,1581,50.22%,31.82%,1
高雄市,甲仙區,0017,151,52,203,11,214,673,31.8%,22.44%,1
高雄市,甲仙區,0018,194,47,241,37,278,607,45.8%,31.96%,1
高雄市,甲仙區,0019,184,47,231,11,242,534,45.32%,34.46%,1
高雄市,杉林區,0032,193,70,263,52,315,640,49.22%,30.16%,1
高雄市,杉林區,0033,205,61,266,28,294,696,42.24%,29.45%,1
高雄市,杉林區,0034,282,119,401,47,448,1284,34.89%,21.96%,1
高雄市,杉林區,0035,284,105,389,48,437,1027,42.55%,27.65%,1
高雄市,杉林區,0036,150,45,195,31,226,482,46.89%,31.12%,1
高雄市,杉林區,0037,581,193,774,127,901,1627,55.38%,35.71%,1
高雄市,杉林區,0038,543,133,676,35,711,1630,43.62%,33.31%,1
高雄市,杉林區,0039,237,83,320,25,345,973,35.46%,24.36%,1
高雄市,杉林區,0040,275,84,359,26,385,987,39.01%,27.86%,1
高雄市,杉林區,0041,428,146,574,89,663,1261,52.58%,33.94%,1
高雄市,內門區,0042,296,79,375,61,436,969,44.99%,30.55%,1
高雄市,內門區,0043,175,54,229,12,241,652,36.96%,26.84%,1
高雄市,內門區,0044,301,115,416,93,509,961,52.97%,31.32%,1
高雄市,內門區,0045,124,32,156,7,163,426,38.26%,29.11%,1
高雄市,內門區,0046,128,36,164,16,180,398,45.23%,32.16%,1
高雄市,內門區,0047,159,48,207,12,219,508,43.11%,31.3%,1
高雄市,內門區,0048,488,14,502,70,572,980,58.37%,49.8%,1
高雄市,內門區,0049,356,128,484,49,533,1225,43.51%,29.06%,1
高雄市,內門區,0050,583,221,804,142,946,1722,54.94%,33.86%,1
高雄市,內門區,0051,174,72,246,29,275,560,49.11%,31.07%,1
高雄市,內門區,0052,207,86,293,18,311,801,38.83%,25.84%,1
高雄市,內門區,0053,147,50,197,18,215,423,50.83%,34.75%,1
高雄市,內門區,0054,141,59,200,36,236,497,47.48%,28.37%,1
高雄市,內門區,0055,199,83,282,34,316,677,46.68%,29.39%,1
高雄市,內門區,0056,128,49,177,16,193,593,32.55%,21.59%,1
高雄市,內門區,0057,130,61,191,56,247,597,41.37%,21.78%,1
高雄市,內門區,0058,93,34,127,12,139,343,40.52%,27.11%,1
高雄市,內門區,0059,216,86,302,51,353,670,52.69%,32.24%,1
高雄市,茂林區,0127,252,67,319,37,356,507,70.22%,49.7%,1
高雄市,茂林區,0128,193,45,238,23,261,382,68.32%,50.52%,1
高雄市,茂林區,0129,339,71,410,31,441,726,60.74%,46.69%,1
高雄市,桃源區,0001,58,18,76,0,76,264,28.79%,21.97%,1
高雄市,桃源區,0002,119,35,154,17,171,233,73.39%,51.07%,1
高雄市,桃源區,0003,140,26,166,8,174,279,62.37%,50.18%,1
高雄市,桃源區,0004,71,35,106,3,109,223,48.88%,31.84%,1
高雄市,桃源區,0005,233,63,296,16,312,783,39.85%,29.76%,1
高雄市,桃源區,0006,187,42,229,9,238,632,37.66%,29.59%,1
高雄市,桃源區,0007,302,78,380,35,415,612,67.81%,49.35%,1
高雄市,桃源區,0008,174,51,225,24,249,472,52.75%,36.86%,1
高雄市,那瑪夏區,0009,225,71,296,29,325,741,43.86%,30.36%,1
高雄市,那瑪夏區,0010,262,95,357,64,421,585,71.97%,44.79%,1
高雄市,那瑪夏區,0011,334,70,404,60,464,609,76.19%,54.84%,1
高雄市,那瑪夏區,0012,116,39,155,7,162,489,33.13%,23.72%,1
新竹縣,竹北市,0001,643,178,821,33,854,1319,64.75%,48.75%,1
新竹縣,竹北市,0002,575,189,764,37,801,1321,60.64%,43.53%,1
新竹縣,竹北市,0003,593,163,756,47,803,1272,63.13%,46.62%,1
新竹縣,竹北市,0004,657,150,807,34,841,1467,57.33%,44.79%,1
新竹縣,竹北市,0005,488,179,667,24,691,1226,56.36%,39.8%,1
新竹縣,竹北市,0006,598,180,778,18,796,1412,56.37%,42.35%,1
新竹縣,竹北市,0007,674,189,863,12,875,1400,62.5%,48.14%,1
新竹縣,竹北市,0008,645,203,848,29,877,1415,61.98%,45.58%,1
新竹縣,竹北市,0009,589,169,758,31,789,1361,57.97%,43.28%,1
新竹縣,竹北市,0010,617,187,804,20,824,1515,54.39%,40.73%,1
新竹縣,竹北市,0011,654,200,854,32,886,1495,59.26%,43.75%,1
新竹縣,竹北市,0012,589,211,800,38,838,1417,59.14%,41.57%,1
新竹縣,竹北市,0013,618,222,840,42,882,1548,56.98%,39.92%,1
新竹縣,竹北市,0014,544,200,744,32,776,1434,54.11%,37.94%,1
新竹縣,竹北市,0015,625,151,776,37,813,1385,58.7%,45.13%,1
新竹縣,竹北市,0016,602,145,747,45,792,1247,63.51%,48.28%,1
新竹縣,竹北市,0017,572,196,768,29,797,1373,58.05%,41.66%,1
新竹縣,竹北市,0018,624,204,828,29,857,1345,63.72%,46.39%,1
新竹縣,竹北市,0019,520,109,629,40,669,1165,57.42%,44.64%,1
新竹縣,竹北市,0020,547,158,705,40,745,1164,64%,46.99%,1
新竹縣,竹北市,0021,544,170,714,40,754,1212,62.21%,44.88%,1
新竹縣,竹北市,0022,578,149,727,32,759,1507,50.36%,38.35%,1
新竹縣,竹北市,0023,648,123,771,44,815,1576,51.71%,41.12%,1
新竹縣,竹北市,0024,633,165,798,30,828,1464,56.56%,43.24%,1
新竹縣,竹北市,0025,604,180,784,28,812,1428,56.86%,42.3%,1
新竹縣,竹北市,0026,533,177,710,21,731,1442,50.69%,36.96%,1
新竹縣,竹北市,0027,615,160,775,67,842,1415,59.51%,43.46%,1
新竹縣,竹北市,0028,641,181,822,26,848,1666,50.9%,38.48%,1
新竹縣,竹北市,0029,669,216,885,52,937,1751,53.51%,38.21%,1
新竹縣,竹北市,0030,548,153,701,32,733,1196,61.29%,45.82%,1
新竹縣,竹北市,0031,560,156,716,26,742,1235,60.08%,45.34%,1
新竹縣,竹北市,0032,516,143,659,24,683,1204,56.73%,42.86%,1
新竹縣,竹北市,0033,616,151,767,26,793,1308,60.63%,47.09%,1
新竹縣,竹北市,0034,527,158,685,19,704,1233,57.1%,42.74%,1
新竹縣,竹北市,0035,515,139,654,18,672,1129,59.52%,45.62%,1
新竹縣,竹北市,0036,516,116,632,29,661,1069,61.83%,48.27%,1
新竹縣,竹北市,0037,545,123,668,43,711,1114,63.82%,48.92%,1
新竹縣,竹北市,0038,491,148,639,27,666,1103,60.38%,44.51%,1
新竹縣,竹北市,0039,507,128,635,35,670,1029,65.11%,49.27%,1
新竹縣,竹北市,0040,545,144,689,36,725,1133,63.99%,48.1%,1
新竹縣,竹北市,0041,570,155,725,31,756,1301,58.11%,43.81%,1
新竹縣,竹北市,0042,789,210,999,49,1048,1798,58.29%,43.88%,1
新竹縣,竹北市,0043,620,188,808,40,848,1427,59.43%,43.45%,1
新竹縣,竹北市,0044,701,165,866,40,906,1462,61.97%,47.95%,1
新竹縣,竹北市,0045,631,173,804,36,840,1342,62.59%,47.02%,1
新竹縣,竹北市,0046,705,164,869,30,899,1480,60.74%,47.64%,1
新竹縣,竹北市,0047,724,173,897,31,928,1645,56.41%,44.01%,1
新竹縣,竹北市,0048,612,162,774,29,803,1256,63.93%,48.73%,1
新竹縣,竹北市,0049,523,163,686,35,721,1181,61.05%,44.28%,1
新竹縣,竹北市,0050,656,159,815,40,855,1329,64.33%,49.36%,1
新竹縣,竹北市,0051,606,147,753,25,778,1228,63.36%,49.35%,1
新竹縣,竹北市,0052,638,203,841,35,876,1552,56.44%,41.11%,1
新竹縣,竹北市,0053,670,190,860,33,893,1480,60.34%,45.27%,1
新竹縣,竹北市,0054,582,187,769,32,801,1487,53.87%,39.14%,1
新竹縣,竹北市,0055,574,193,767,41,808,1470,54.97%,39.05%,1
新竹縣,竹北市,0056,586,162,748,37,785,1477,53.15%,39.68%,1
新竹縣,竹北市,0057,708,196,904,63,967,1611,60.02%,43.95%,1
新竹縣,竹北市,0058,662,171,833,74,907,1555,58.33%,42.57%,1
新竹縣,竹北市,0059,598,158,756,45,801,1468,54.56%,40.74%,1
新竹縣,竹北市,0060,650,187,837,58,895,1509,59.31%,43.07%,1
新竹縣,竹北市,0061,653,186,839,45,884,1602,55.18%,40.76%,1
新竹縣,竹北市,0062,639,168,807,59,866,1448,59.81%,44.13%,1
新竹縣,竹北市,0063,577,150,727,69,796,1318,60.39%,43.78%,1
新竹縣,竹北市,0064,764,181,945,55,1000,1634,61.2%,46.76%,1
新竹縣,竹北市,0065,539,171,710,63,773,1345,57.47%,40.07%,1
新竹縣,竹北市,0066,461,108,569,38,607,958,63.36%,48.12%,1
新竹縣,竹北市,0067,524,138,662,40,702,1112,63.13%,47.12%,1
新竹縣,竹北市,0068,452,149,601,68,669,1134,58.99%,39.86%,1
新竹縣,竹北市,0069,654,162,816,38,854,1483,57.59%,44.1%,1
新竹縣,竹北市,0070,562,147,709,42,751,1332,56.38%,42.19%,1
新竹縣,竹北市,0071,571,150,721,41,762,1482,51.42%,38.53%,1
新竹縣,竹北市,0072,453,138,591,26,617,1449,42.58%,31.26%,1
新竹縣,竹北市,0073,560,128,688,31,719,1319,54.51%,42.46%,1
新竹縣,竹北市,0074,538,145,683,42,725,1332,54.43%,40.39%,1
新竹縣,竹北市,0075,543,168,711,39,750,1412,53.12%,38.46%,1
新竹縣,竹北市,0076,660,163,823,55,878,1640,53.54%,40.24%,1
新竹縣,竹北市,0077,563,155,718,37,755,1323,57.07%,42.55%,1
新竹縣,竹北市,0078,721,76,797,57,854,1428,59.8%,50.49%,1
新竹縣,竹北市,0079,664,172,836,57,893,1533,58.25%,43.31%,1
新竹縣,竹北市,0080,524,144,668,28,696,1346,51.71%,38.93%,1
新竹縣,竹北市,0081,495,126,621,48,669,1219,54.88%,40.61%,1
新竹縣,竹北市,0082,647,172,819,73,892,1466,60.85%,44.13%,1
新竹縣,竹北市,0083,458,132,590,39,629,1147,54.84%,39.93%,1
新竹縣,竹北市,0084,557,157,714,39,753,1529,49.25%,36.43%,1
新竹縣,竹北市,0085,654,167,821,57,878,1522,57.69%,42.97%,1
新竹縣,竹北市,0086,625,161,786,44,830,1383,60.01%,45.19%,1
新竹縣,竹北市,0087,642,211,853,42,895,1569,57.04%,40.92%,1
新竹縣,竹北市,0088,604,154,758,24,782,1506,51.93%,40.11%,1
新竹縣,竹北市,0089,364,106,470,36,506,877,57.7%,41.51%,1
新竹縣,竹北市,0090,465,117,582,44,626,1074,58.29%,43.3%,1
新竹縣,竹北市,0091,513,148,661,42,703,1089,64.55%,47.11%,1
新竹縣,竹北市,0092,570,162,732,61,793,1336,59.36%,42.66%,1
新竹縣,竹北市,0093,412,119,531,72,603,1058,56.99%,38.94%,1
新竹縣,竹北市,0094,445,123,568,57,625,937,66.7%,47.49%,1
新竹縣,竹北市,0095,500,149,649,40,689,1206,57.13%,41.46%,1
新竹縣,竹北市,0096,478,154,632,49,681,1205,56.51%,39.67%,1
新竹縣,竹北市,0097,733,225,958,70,1028,1718,59.84%,42.67%,1
新竹縣,竹北市,0098,350,124,474,50,524,917,57.14%,38.17%,1
新竹縣,竹北市,0099,273,95,368,34,402,668,60.18%,40.87%,1
新竹縣,竹北市,0100,312,100,412,42,454,824,55.1%,37.86%,1
新竹縣,竹北市,0101,316,74,390,74,464,782,59.34%,40.41%,1
新竹縣,竹北市,0102,404,118,522,71,593,977,60.7%,41.35%,1
新竹縣,竹北市,0103,318,104,422,22,444,937,47.39%,33.94%,1
新竹縣,竹東鎮,0104,112,29,141,11,152,309,49.19%,36.25%,1
新竹縣,竹東鎮,0105,134,54,188,27,215,416,51.68%,32.21%,1
新竹縣,竹東鎮,0106,143,39,182,10,192,386,49.74%,37.05%,1
新竹縣,竹東鎮,0107,356,90,446,22,468,950,49.26%,37.47%,1
新竹縣,竹東鎮,0108,531,110,641,17,658,1275,51.61%,41.65%,1
新竹縣,竹東鎮,0109,481,137,618,39,657,1213,54.16%,39.65%,1
新竹縣,竹東鎮,0110,659,152,811,51,862,1548,55.68%,42.57%,1
新竹縣,竹東鎮,0111,481,101,582,36,618,1246,49.6%,38.6%,1
新竹縣,竹東鎮,0112,426,105,531,44,575,1252,45.93%,34.03%,1
新竹縣,竹東鎮,0113,531,129,660,58,718,1359,52.83%,39.07%,1
新竹縣,竹東鎮,0114,485,141,626,44,670,1255,53.39%,38.65%,1
新竹縣,竹東鎮,0115,584,130,714,35,749,1304,57.44%,44.79%,1
新竹縣,竹東鎮,0116,544,138,682,46,728,1292,56.35%,42.11%,1
新竹縣,竹東鎮,0117,441,102,543,11,554,1111,49.86%,39.69%,1
新竹縣,竹東鎮,0118,392,86,478,43,521,880,59.2%,44.55%,1
新竹縣,竹東鎮,0119,289,81,370,22,392,670,58.51%,43.13%,1
新竹縣,竹東鎮,0120,553,130,683,42,725,1244,58.28%,44.45%,1
新竹縣,竹東鎮,0121,447,108,555,52,607,1126,53.91%,39.7%,1
新竹縣,竹東鎮,0122,442,107,549,40,589,1073,54.89%,41.19%,1
新竹縣,竹東鎮,0123,494,155,649,45,694,1215,57.12%,40.66%,1
新竹縣,竹東鎮,0124,533,110,643,17,660,1155,57.14%,46.15%,1
新竹縣,竹東鎮,0125,335,106,441,43,484,852,56.81%,39.32%,1
新竹縣,竹東鎮,0126,368,116,484,42,526,875,60.11%,42.06%,1
新竹縣,竹東鎮,0127,473,137,610,44,654,1070,61.12%,44.21%,1
新竹縣,竹東鎮,0128,272,81,353,25,378,704,53.69%,38.64%,1
新竹縣,竹東鎮,0129,280,71,351,31,382,951,40.17%,29.44%,1
新竹縣,竹東鎮,0130,419,115,534,23,557,984,56.61%,42.58%,1
新竹縣,竹東鎮,0131,364,90,454,19,473,1113,42.5%,32.7%,1
新竹縣,竹東鎮,0132,247,83,330,26,356,595,59.83%,41.51%,1
新竹縣,竹東鎮,0133,317,102,419,47,466,762,61.15%,41.6%,1
新竹縣,竹東鎮,0134,313,83,396,25,421,763,55.18%,41.02%,1
新竹縣,竹東鎮,0135,294,104,398,22,420,813,51.66%,36.16%,1
新竹縣,竹東鎮,0136,461,124,585,32,617,1310,47.1%,35.19%,1
新竹縣,竹東鎮,0137,520,136,656,48,704,1434,49.09%,36.26%,1
新竹縣,竹東鎮,0138,477,140,617,33,650,1131,57.47%,42.18%,1
新竹縣,竹東鎮,0139,401,106,507,21,528,967,54.6%,41.47%,1
新竹縣,竹東鎮,0140,436,134,570,42,612,1196,51.17%,36.45%,1
新竹縣,竹東鎮,0141,486,127,613,41,654,1154,56.67%,42.11%,1
新竹縣,竹東鎮,0142,301,99,400,39,439,715,61.4%,42.1%,1
新竹縣,竹東鎮,0143,296,75,371,13,384,685,56.06%,43.21%,1
新竹縣,竹東鎮,0144,535,133,668,50,718,1352,53.11%,39.57%,1
新竹縣,竹東鎮,0145,598,143,741,64,805,1407,57.21%,42.5%,1
新竹縣,竹東鎮,0146,563,134,697,32,729,1362,53.52%,41.34%,1
新竹縣,竹東鎮,0147,565,138,703,47,750,1330,56.39%,42.48%,1
新竹縣,竹東鎮,0148,556,164,720,61,781,1441,54.2%,38.58%,1
新竹縣,竹東鎮,0149,477,130,607,18,625,1248,50.08%,38.22%,1
新竹縣,竹東鎮,0150,407,127,534,31,565,1263,44.73%,32.22%,1
新竹縣,竹東鎮,0151,447,115,562,28,590,1232,47.89%,36.28%,1
新竹縣,竹東鎮,0152,411,104,515,26,541,1143,47.33%,35.96%,1
新竹縣,竹東鎮,0153,641,152,793,36,829,1529,54.22%,41.92%,1
新竹縣,竹東鎮,0154,465,119,584,42,626,1140,54.91%,40.79%,1
新竹縣,竹東鎮,0155,257,80,337,27,364,570,63.86%,45.09%,1
新竹縣,竹東鎮,0156,491,129,620,36,656,1345,48.77%,36.51%,1
新竹縣,竹東鎮,0157,521,145,666,66,732,1381,53.01%,37.73%,1
新竹縣,竹東鎮,0158,537,157,694,62,756,1379,54.82%,38.94%,1
新竹縣,竹東鎮,0159,436,111,547,53,600,1033,58.08%,42.21%,1
新竹縣,竹東鎮,0160,444,99,543,38,581,1066,54.5%,41.65%,1
新竹縣,竹東鎮,0161,395,112,507,47,554,938,59.06%,42.11%,1
新竹縣,竹東鎮,0162,430,109,539,47,586,952,61.55%,45.17%,1
新竹縣,竹東鎮,0163,682,162,844,41,885,1468,60.29%,46.46%,1
新竹縣,竹東鎮,0164,708,225,933,40,973,1915,50.81%,36.97%,1
新竹縣,竹東鎮,0165,479,112,591,40,631,1220,51.72%,39.26%,1
新竹縣,竹東鎮,0166,406,104,510,21,531,1166,45.54%,34.82%,1
新竹縣,竹東鎮,0167,537,145,682,30,712,1492,47.72%,35.99%,1
新竹縣,竹東鎮,0168,438,172,610,42,652,1245,52.37%,35.18%,1
新竹縣,竹東鎮,0169,445,139,584,37,621,1083,57.34%,41.09%,1
新竹縣,竹東鎮,0170,437,131,568,35,603,1102,54.72%,39.66%,1
新竹縣,竹東鎮,0171,454,106,560,19,579,1068,54.21%,42.51%,1
新竹縣,竹東鎮,0172,450,145,595,30,625,1097,56.97%,41.02%,1
新竹縣,竹東鎮,0173,366,93,459,19,478,962,49.69%,38.05%,1
新竹縣,竹東鎮,0174,366,126,492,26,518,909,56.99%,40.26%,1
新竹縣,竹東鎮,0175,213,57,270,32,302,603,50.08%,35.32%,1
新竹縣,新埔鎮,0176,444,101,545,41,586,983,59.61%,45.17%,1
新竹縣,新埔鎮,0177,233,97,330,39,369,597,61.81%,39.03%,1
新竹縣,新埔鎮,0178,454,111,565,25,590,1070,55.14%,42.43%,1
新竹縣,新埔鎮,0179,389,97,486,38,524,935,56.04%,41.6%,1
新竹縣,新埔鎮,0180,298,96,394,38,432,753,57.37%,39.58%,1
新竹縣,新埔鎮,0181,412,114,526,26,552,838,65.87%,49.16%,1
新竹縣,新埔鎮,0182,392,87,479,33,512,924,55.41%,42.42%,1
新竹縣,新埔鎮,0183,335,82,417,31,448,905,49.5%,37.02%,1
新竹縣,新埔鎮,0184,401,107,508,28,536,948,56.54%,42.3%,1
新竹縣,新埔鎮,0185,433,110,543,46,589,1017,57.92%,42.58%,1
新竹縣,新埔鎮,0186,533,137,670,44,714,1176,60.71%,45.32%,1
新竹縣,新埔鎮,0187,478,160,638,60,698,1122,62.21%,42.6%,1
新竹縣,新埔鎮,0188,341,92,433,22,455,1022,44.52%,33.37%,1
新竹縣,新埔鎮,0189,518,151,669,49,718,1429,50.24%,36.25%,1
新竹縣,新埔鎮,0190,204,59,263,42,305,451,67.63%,45.23%,1
新竹縣,新埔鎮,0191,279,100,379,31,410,724,56.63%,38.54%,1
新竹縣,新埔鎮,0192,262,87,349,43,392,617,63.53%,42.46%,1
新竹縣,新埔鎮,0193,490,128,618,60,678,1144,59.27%,42.83%,1
新竹縣,新埔鎮,0194,472,140,612,44,656,1139,57.59%,41.44%,1
新竹縣,新埔鎮,0195,366,89,455,22,477,861,55.4%,42.51%,1
新竹縣,新埔鎮,0196,414,99,513,45,558,1093,51.05%,37.88%,1
新竹縣,新埔鎮,0197,367,101,468,37,505,978,51.64%,37.53%,1
新竹縣,新埔鎮,0198,377,100,477,31,508,1040,48.85%,36.25%,1
新竹縣,新埔鎮,0199,445,131,576,44,620,1160,53.45%,38.36%,1
新竹縣,新埔鎮,0200,439,110,549,26,575,950,60.53%,46.21%,1
新竹縣,新埔鎮,0201,380,86,466,31,497,882,56.35%,43.08%,1
新竹縣,新埔鎮,0202,526,148,674,65,739,1281,57.69%,41.06%,1
新竹縣,新埔鎮,0203,469,128,597,54,651,1212,53.71%,38.7%,1
新竹縣,新埔鎮,0204,354,87,441,42,483,1013,47.68%,34.95%,1
新竹縣,新埔鎮,0205,281,88,369,33,402,630,63.81%,44.6%,1
新竹縣,關西鎮,0206,231,47,278,29,307,480,63.96%,48.13%,1
新竹縣,關西鎮,0207,388,111,499,42,541,903,59.91%,42.97%,1
新竹縣,關西鎮,0208,442,112,554,40,594,1020,58.24%,43.33%,1
新竹縣,關西鎮,0209,273,84,357,20,377,705,53.48%,38.72%,1
新竹縣,關西鎮,0210,420,125,545,33,578,1056,54.73%,39.77%,1
新竹縣,關西鎮,0211,506,143,649,47,696,1275,54.59%,39.69%,1
新竹縣,關西鎮,0212,574,127,701,53,754,1287,58.59%,44.6%,1
新竹縣,關西鎮,0213,333,104,437,29,466,771,60.44%,43.19%,1
新竹縣,關西鎮,0214,417,109,526,43,569,1046,54.4%,39.87%,1
新竹縣,關西鎮,0215,427,127,554,48,602,1030,58.45%,41.46%,1
新竹縣,關西鎮,0216,534,109,643,45,688,1208,56.95%,44.21%,1
新竹縣,關西鎮,0217,418,91,509,21,530,1095,48.4%,38.17%,1
新竹縣,關西鎮,0218,500,156,656,55,711,1350,52.67%,37.04%,1
新竹縣,關西鎮,0219,409,101,510,27,537,846,63.48%,48.35%,1
新竹縣,關西鎮,0220,529,145,674,69,743,1362,54.55%,38.84%,1
新竹縣,關西鎮,0221,326,88,414,28,442,903,48.95%,36.1%,1
新竹縣,關西鎮,0222,193,54,247,22,269,551,48.82%,35.03%,1
新竹縣,關西鎮,0223,137,35,172,19,191,461,41.43%,29.72%,1
新竹縣,關西鎮,0224,233,56,289,30,319,572,55.77%,40.73%,1
新竹縣,關西鎮,0225,358,120,478,29,507,943,53.76%,37.96%,1
新竹縣,關西鎮,0226,316,105,421,47,468,808,57.92%,39.11%,1
新竹縣,關西鎮,0227,449,111,560,23,583,923,63.16%,48.65%,1
新竹縣,關西鎮,0228,395,102,497,38,535,903,59.25%,43.74%,1
新竹縣,關西鎮,0229,420,112,532,43,575,977,58.85%,42.99%,1
新竹縣,關西鎮,0230,352,112,464,38,502,824,60.92%,42.72%,1
新竹縣,關西鎮,0231,260,65,325,17,342,559,61.18%,46.51%,1
新竹縣,關西鎮,0232,400,103,503,31,534,854,62.53%,46.84%,1
新竹縣,湖口鄉,0233,488,171,659,44,703,1393,50.47%,35.03%,1
新竹縣,湖口鄉,0234,625,204,829,48,877,1505,58.27%,41.53%,1
新竹縣,湖口鄉,0235,545,168,713,43,756,1188,63.64%,45.88%,1
新竹縣,湖口鄉,0236,512,167,679,50,729,1267,57.54%,40.41%,1
新竹縣,湖口鄉,0237,709,184,893,40,933,1668,55.94%,42.51%,1
新竹縣,湖口鄉,0238,728,201,929,68,997,1719,58%,42.35%,1
新竹縣,湖口鄉,0239,538,136,674,49,723,1162,62.22%,46.3%,1
新竹縣,湖口鄉,0240,692,184,876,51,927,1833,50.57%,37.75%,1
新竹縣,湖口鄉,0241,684,89,773,54,827,1444,57.27%,47.37%,1
新竹縣,湖口鄉,0242,607,155,762,70,832,1347,61.77%,45.06%,1
新竹縣,湖口鄉,0243,539,128,667,19,686,1202,57.07%,44.84%,1
新竹縣,湖口鄉,0244,368,98,466,44,510,851,59.93%,43.24%,1
新竹縣,湖口鄉,0245,552,165,717,61,778,1272,61.16%,43.4%,1
新竹縣,湖口鄉,0246,513,161,674,49,723,1275,56.71%,40.24%,1
新竹縣,湖口鄉,0247,705,198,903,56,959,1560,61.47%,45.19%,1
新竹縣,湖口鄉,0248,505,134,639,92,731,1147,63.73%,44.03%,1
新竹縣,湖口鄉,0249,747,172,919,58,977,1729,56.51%,43.2%,1
新竹縣,湖口鄉,0250,552,154,706,46,752,1402,53.64%,39.37%,1
新竹縣,湖口鄉,0251,511,135,646,61,707,1183,59.76%,43.2%,1
新竹縣,湖口鄉,0252,591,148,739,42,781,1282,60.92%,46.1%,1
新竹縣,湖口鄉,0253,588,173,761,47,808,1335,60.52%,44.04%,1
新竹縣,湖口鄉,0254,691,188,879,48,927,1493,62.09%,46.28%,1
新竹縣,湖口鄉,0255,803,160,963,25,988,1877,52.64%,42.78%,1
新竹縣,湖口鄉,0256,505,130,635,36,671,1082,62.01%,46.67%,1
新竹縣,湖口鄉,0257,461,159,620,66,686,1115,61.52%,41.35%,1
新竹縣,湖口鄉,0258,422,132,554,43,597,1193,50.04%,35.37%,1
新竹縣,湖口鄉,0259,757,195,952,52,1004,1947,51.57%,38.88%,1
新竹縣,湖口鄉,0260,468,156,624,49,673,1125,59.82%,41.6%,1
新竹縣,湖口鄉,0261,421,139,560,48,608,1050,57.9%,40.1%,1
新竹縣,湖口鄉,0262,738,206,944,52,996,1733,57.47%,42.59%,1
新竹縣,湖口鄉,0263,564,149,713,44,757,1284,58.96%,43.93%,1
新竹縣,湖口鄉,0264,486,114,600,31,631,1062,59.42%,45.76%,1
新竹縣,湖口鄉,0265,669,152,821,56,877,1547,56.69%,43.24%,1
新竹縣,湖口鄉,0266,552,142,694,47,741,1494,49.6%,36.95%,1
新竹縣,湖口鄉,0267,603,147,750,31,781,1634,47.8%,36.9%,1
新竹縣,湖口鄉,0268,531,114,645,21,666,1444,46.12%,36.77%,1
新竹縣,湖口鄉,0269,523,145,668,27,695,1324,52.49%,39.5%,1
新竹縣,湖口鄉,0270,453,109,562,39,601,1058,56.81%,42.82%,1
新竹縣,湖口鄉,0271,380,106,486,22,508,1220,41.64%,31.15%,1
新竹縣,湖口鄉,0272,556,153,709,39,748,1333,56.11%,41.71%,1
新竹縣,湖口鄉,0273,567,142,709,57,766,1461,52.43%,38.81%,1
新竹縣,湖口鄉,0274,554,162,716,28,744,1429,52.06%,38.77%,1
新竹縣,湖口鄉,0275,539,138,677,25,702,1506,46.61%,35.79%,1
新竹縣,湖口鄉,0276,510,114,624,41,665,1103,60.29%,46.24%,1
新竹縣,湖口鄉,0277,528,173,701,40,741,1495,49.57%,35.32%,1
新竹縣,湖口鄉,0278,310,85,395,38,433,752,57.58%,41.22%,1
新竹縣,湖口鄉,0279,414,104,518,27,545,986,55.27%,41.99%,1
新竹縣,新豐鄉,0280,400,115,515,62,577,1080,53.43%,37.04%,1
新竹縣,新豐鄉,0281,334,102,436,34,470,887,52.99%,37.66%,1
新竹縣,新豐鄉,0282,381,119,500,34,534,954,55.97%,39.94%,1
新竹縣,新豐鄉,0283,388,123,511,38,549,1003,54.74%,38.68%,1
新竹縣,新豐鄉,0284,441,116,557,47,604,1106,54.61%,39.87%,1
新竹縣,新豐鄉,0285,475,147,622,39,661,1123,58.86%,42.3%,1
新竹縣,新豐鄉,0286,359,117,476,50,526,891,59.03%,40.29%,1
新竹縣,新豐鄉,0287,316,95,411,29,440,874,50.34%,36.16%,1
新竹縣,新豐鄉,0288,327,94,421,35,456,824,55.34%,39.68%,1
新竹縣,新豐鄉,0289,363,94,457,32,489,975,50.15%,37.23%,1
新竹縣,新豐鄉,0290,308,106,414,58,472,847,55.73%,36.36%,1
新竹縣,新豐鄉,0291,564,174,738,93,831,1477,56.26%,38.19%,1
新竹縣,新豐鄉,0292,441,168,609,56,665,1266,52.53%,34.83%,1
新竹縣,新豐鄉,0293,366,121,487,72,559,1029,54.32%,35.57%,1
新竹縣,新豐鄉,0294,369,146,515,53,568,1063,53.43%,34.71%,1
新竹縣,新豐鄉,0295,445,101,546,30,576,1055,54.6%,42.18%,1
新竹縣,新豐鄉,0296,645,122,767,38,805,1445,55.71%,44.64%,1
新竹縣,新豐鄉,0297,673,148,821,43,864,1413,61.15%,47.63%,1
新竹縣,新豐鄉,0298,452,126,578,40,618,971,63.65%,46.55%,1
新竹縣,新豐鄉,0299,520,132,652,26,678,1135,59.74%,45.81%,1
新竹縣,新豐鄉,0300,482,145,627,53,680,1269,53.59%,37.98%,1
新竹縣,新豐鄉,0301,519,152,671,41,712,1257,56.64%,41.29%,1
新竹縣,新豐鄉,0302,739,178,917,47,964,1662,58%,44.46%,1
新竹縣,新豐鄉,0303,552,187,739,29,768,1486,51.68%,37.15%,1
新竹縣,新豐鄉,0304,458,143,601,66,667,1067,62.51%,42.92%,1
新竹縣,新豐鄉,0305,580,145,725,59,784,1302,60.22%,44.55%,1
新竹縣,新豐鄉,0306,554,159,713,77,790,1410,56.03%,39.29%,1
新竹縣,新豐鄉,0307,485,159,644,51,695,1267,54.85%,38.28%,1
新竹縣,新豐鄉,0308,461,120,581,50,631,1258,50.16%,36.65%,1
新竹縣,新豐鄉,0309,445,124,569,23,592,1217,48.64%,36.57%,1
新竹縣,新豐鄉,0310,592,166,758,43,801,1456,55.01%,40.66%,1
新竹縣,新豐鄉,0311,506,137,643,36,679,1157,58.69%,43.73%,1
新竹縣,新豐鄉,0312,419,121,540,32,572,1089,52.53%,38.48%,1
新竹縣,新豐鄉,0313,511,117,628,20,648,1160,55.86%,44.05%,1
新竹縣,新豐鄉,0314,481,111,592,17,609,976,62.4%,49.28%,1
新竹縣,新豐鄉,0315,596,170,766,40,806,1443,55.86%,41.3%,1
新竹縣,新豐鄉,0316,464,136,600,23,623,1247,49.96%,37.21%,1
新竹縣,新豐鄉,0317,606,153,759,28,787,1411,55.78%,42.95%,1
新竹縣,新豐鄉,0318,550,139,689,47,736,1238,59.45%,44.43%,1
新竹縣,芎林鄉,0319,163,63,226,17,243,417,58.27%,39.09%,1
新竹縣,芎林鄉,0320,257,83,340,29,369,534,69.1%,48.13%,1
新竹縣,芎林鄉,0321,413,108,521,43,564,963,58.57%,42.89%,1
新竹縣,芎林鄉,0322,189,54,243,28,271,418,64.83%,45.22%,1
新竹縣,芎林鄉,0323,531,132,663,57,720,1312,54.88%,40.47%,1
新竹縣,芎林鄉,0324,493,138,631,44,675,1354,49.85%,36.41%,1
新竹縣,芎林鄉,0325,325,101,426,44,470,785,59.87%,41.4%,1
新竹縣,芎林鄉,0326,364,79,443,46,489,797,61.36%,45.67%,1
新竹縣,芎林鄉,0327,272,80,352,22,374,623,60.03%,43.66%,1
新竹縣,芎林鄉,0328,298,100,398,37,435,759,57.31%,39.26%,1
新竹縣,芎林鄉,0329,479,121,600,45,645,1272,50.71%,37.66%,1
新竹縣,芎林鄉,0330,506,129,635,37,672,1129,59.52%,44.82%,1
新竹縣,芎林鄉,0331,309,106,415,30,445,713,62.41%,43.34%,1
新竹縣,芎林鄉,0332,360,110,470,51,521,839,62.1%,42.91%,1
新竹縣,芎林鄉,0333,544,150,694,39,733,1123,65.27%,48.44%,1
新竹縣,芎林鄉,0334,443,115,558,20,578,981,58.92%,45.16%,1
新竹縣,芎林鄉,0335,455,153,608,49,657,1078,60.95%,42.21%,1
新竹縣,芎林鄉,0336,444,128,572,25,597,1094,54.57%,40.59%,1
新竹縣,芎林鄉,0337,463,134,597,58,655,1102,59.44%,42.01%,1
新竹縣,橫山鄉,0338,554,142,696,53,749,1231,60.84%,45%,1
新竹縣,橫山鄉,0339,430,129,559,67,626,1041,60.13%,41.31%,1
新竹縣,橫山鄉,0340,496,146,642,44,686,1132,60.6%,43.82%,1
新竹縣,橫山鄉,0341,367,97,464,41,505,859,58.79%,42.72%,1
新竹縣,橫山鄉,0342,78,23,101,16,117,204,57.35%,38.24%,1
新竹縣,橫山鄉,0343,63,27,90,10,100,222,45.05%,28.38%,1
新竹縣,橫山鄉,0344,140,43,183,34,217,338,64.2%,41.42%,1
新竹縣,橫山鄉,0345,369,84,453,39,492,916,53.71%,40.28%,1
新竹縣,橫山鄉,0346,184,41,225,13,238,573,41.54%,32.11%,1
新竹縣,橫山鄉,0347,132,48,180,9,189,275,68.73%,48%,1
新竹縣,橫山鄉,0348,160,44,204,22,226,463,48.81%,34.56%,1
新竹縣,橫山鄉,0349,324,75,399,41,440,690,63.77%,46.96%,1
新竹縣,橫山鄉,0350,97,32,129,12,141,288,48.96%,33.68%,1
新竹縣,橫山鄉,0351,321,90,411,31,442,685,64.53%,46.86%,1
新竹縣,橫山鄉,0352,399,98,497,40,537,868,61.87%,45.97%,1
新竹縣,橫山鄉,0353,702,202,904,64,968,1561,62.01%,44.97%,1
新竹縣,北埔鄉,0354,406,131,537,22,559,1158,48.27%,35.06%,1
新竹縣,北埔鄉,0355,484,187,671,61,732,1238,59.13%,39.1%,1
新竹縣,北埔鄉,0356,237,75,312,25,337,580,58.1%,40.86%,1
新竹縣,北埔鄉,0357,408,99,507,32,539,931,57.89%,43.82%,1
新竹縣,北埔鄉,0358,685,170,855,74,929,1653,56.2%,41.44%,1
新竹縣,北埔鄉,0359,356,96,452,32,484,845,57.28%,42.13%,1
新竹縣,北埔鄉,0360,156,40,196,12,208,384,54.17%,40.63%,1
新竹縣,北埔鄉,0361,334,74,408,12,420,763,55.05%,43.77%,1
新竹縣,北埔鄉,0362,126,39,165,20,185,333,55.56%,37.84%,1
新竹縣,北埔鄉,0363,118,20,138,7,145,295,49.15%,40%,1
新竹縣,寶山鄉,0364,470,128,598,62,660,1158,56.99%,40.59%,1
新竹縣,寶山鄉,0365,605,175,780,42,822,1437,57.2%,42.1%,1
新竹縣,寶山鄉,0366,584,199,783,51,834,1470,56.73%,39.73%,1
新竹縣,寶山鄉,0367,508,148,656,46,702,1170,60%,43.42%,1
新竹縣,寶山鄉,0368,797,243,1040,55,1095,1900,57.63%,41.95%,1
新竹縣,寶山鄉,0369,425,88,513,24,537,1056,50.85%,40.25%,1
新竹縣,寶山鄉,0370,534,159,693,63,756,1205,62.74%,44.32%,1
新竹縣,寶山鄉,0371,323,81,404,37,441,766,57.57%,42.17%,1
新竹縣,寶山鄉,0372,395,80,475,42,517,846,61.11%,46.69%,1
新竹縣,寶山鄉,0373,357,97,454,34,488,804,60.7%,44.4%,1
新竹縣,寶山鄉,0374,276,63,339,21,360,607,59.31%,45.47%,1
新竹縣,寶山鄉,0375,246,92,338,14,352,554,63.54%,44.4%,1
新竹縣,峨眉鄉,0376,414,101,515,55,570,879,64.85%,47.1%,1
新竹縣,峨眉鄉,0377,286,88,374,56,430,683,62.96%,41.87%,1
新竹縣,峨眉鄉,0378,251,83,334,31,365,604,60.43%,41.56%,1
新竹縣,峨眉鄉,0379,143,37,180,18,198,339,58.41%,42.18%,1
新竹縣,峨眉鄉,0380,72,34,106,8,114,276,41.3%,26.09%,1
新竹縣,峨眉鄉,0381,607,167,774,83,857,1406,60.95%,43.17%,1
新竹縣,峨眉鄉,0382,209,48,257,32,289,462,62.55%,45.24%,1
新竹縣,峨眉鄉,0383,152,54,206,19,225,419,53.7%,36.28%,1
新竹縣,尖石鄉,0384,132,44,176,9,185,474,39.03%,27.85%,1
新竹縣,尖石鄉,0385,134,25,159,9,168,357,47.06%,37.54%,1
新竹縣,尖石鄉,0386,75,19,94,16,110,225,48.89%,33.33%,1
新竹縣,尖石鄉,0387,132,31,163,6,169,374,45.19%,35.29%,1
新竹縣,尖石鄉,0388,252,45,297,8,305,773,39.46%,32.6%,1
新竹縣,尖石鄉,0389,155,42,197,15,212,490,43.27%,31.63%,1
新竹縣,尖石鄉,0390,140,36,176,6,182,531,34.27%,26.37%,1
新竹縣,尖石鄉,0391,206,46,252,6,258,660,39.09%,31.21%,1
新竹縣,尖石鄉,0392,241,100,341,59,400,613,65.25%,39.31%,1
新竹縣,尖石鄉,0393,187,65,252,2,254,593,42.83%,31.53%,1
新竹縣,尖石鄉,0394,183,56,239,18,257,575,44.7%,31.83%,1
新竹縣,尖石鄉,0395,65,12,77,7,84,126,66.67%,51.59%,1
新竹縣,尖石鄉,0396,131,27,158,6,164,499,32.87%,26.25%,1
新竹縣,尖石鄉,0397,143,59,202,16,218,785,27.77%,18.22%,1
新竹縣,尖石鄉,0398,96,48,144,19,163,289,56.4%,33.22%,1
新竹縣,五峰鄉,0399,250,78,328,29,357,672,53.13%,37.2%,1
新竹縣,五峰鄉,0400,219,71,290,12,302,713,42.36%,30.72%,1
新竹縣,五峰鄉,0401,151,39,190,7,197,594,33.16%,25.42%,1
新竹縣,五峰鄉,0402,274,68,342,26,368,896,41.07%,30.58%,1
新竹縣,五峰鄉,0403,216,61,277,4,281,727,38.65%,29.71%,1
新竹縣,五峰鄉,0404,107,30,137,9,146,395,36.96%,27.09%,1
苗栗縣,苗栗市,0001,484,104,588,36,624,1087,57.41%,44.53%,1
苗栗縣,苗栗市,0002,436,93,529,42,571,1018,56.09%,42.83%,1
苗栗縣,苗栗市,0003,482,148,630,21,651,1156,56.31%,41.7%,1
苗栗縣,苗栗市,0004,479,98,577,32,609,1118,54.47%,42.84%,1
苗栗縣,苗栗市,0005,468,115,583,46,629,1084,58.03%,43.17%,1
苗栗縣,苗栗市,0006,545,137,682,38,720,1203,59.85%,45.3%,1
苗栗縣,苗栗市,0007,600,124,724,53,777,1306,59.49%,45.94%,1
苗栗縣,苗栗市,0008,527,141,668,52,720,1193,60.35%,44.17%,1
苗栗縣,苗栗市,0009,513,110,623,36,659,1115,59.1%,46.01%,1
苗栗縣,苗栗市,0010,519,121,640,47,687,1119,61.39%,46.38%,1
苗栗縣,苗栗市,0011,509,137,646,50,696,1132,61.48%,44.96%,1
苗栗縣,苗栗市,0012,572,134,706,33,739,1289,57.33%,44.38%,1
苗栗縣,苗栗市,0013,577,139,716,41,757,1264,59.89%,45.65%,1
苗栗縣,苗栗市,0014,369,97,466,26,492,870,56.55%,42.41%,1
苗栗縣,苗栗市,0015,396,75,471,41,512,1008,50.79%,39.29%,1
苗栗縣,苗栗市,0016,419,119,538,31,569,1078,52.78%,38.87%,1
苗栗縣,苗栗市,0017,495,123,618,26,644,1077,59.8%,45.96%,1
苗栗縣,苗栗市,0018,374,91,465,41,506,880,57.5%,42.5%,1
苗栗縣,苗栗市,0019,365,91,456,46,502,894,56.15%,40.83%,1
苗栗縣,苗栗市,0020,224,49,273,29,302,522,57.85%,42.91%,1
苗栗縣,苗栗市,0021,615,184,799,70,869,1376,63.15%,44.69%,1
苗栗縣,苗栗市,0022,596,126,722,27,749,1391,53.85%,42.85%,1
苗栗縣,苗栗市,0023,458,131,589,57,646,1081,59.76%,42.37%,1
苗栗縣,苗栗市,0024,530,131,661,48,709,1272,55.74%,41.67%,1
苗栗縣,苗栗市,0025,499,168,667,47,714,1112,64.21%,44.87%,1
苗栗縣,苗栗市,0026,413,106,519,25,544,813,66.91%,50.8%,1
苗栗縣,苗栗市,0027,314,90,404,33,437,767,56.98%,40.94%,1
苗栗縣,苗栗市,0028,420,115,535,29,564,1010,55.84%,41.58%,1
苗栗縣,苗栗市,0029,519,113,632,35,667,1182,56.43%,43.91%,1
苗栗縣,苗栗市,0030,426,103,529,25,554,965,57.41%,44.15%,1
苗栗縣,苗栗市,0031,286,62,348,16,364,607,59.97%,47.12%,1
苗栗縣,苗栗市,0032,452,125,577,35,612,990,61.82%,45.66%,1
苗栗縣,苗栗市,0033,486,112,598,71,669,1230,54.39%,39.51%,1
苗栗縣,苗栗市,0034,601,153,754,41,795,1372,57.94%,43.8%,1
苗栗縣,苗栗市,0035,546,117,663,47,710,1213,58.53%,45.01%,1
苗栗縣,苗栗市,0036,560,119,679,45,724,1272,56.92%,44.03%,1
苗栗縣,苗栗市,0037,558,139,697,51,748,1221,61.26%,45.7%,1
苗栗縣,苗栗市,0038,474,133,607,37,644,1104,58.33%,42.93%,1
苗栗縣,苗栗市,0039,465,128,593,12,605,1171,51.67%,39.71%,1
苗栗縣,苗栗市,0040,581,152,733,50,783,1392,56.25%,41.74%,1
苗栗縣,苗栗市,0041,569,186,755,40,795,1356,58.63%,41.96%,1
苗栗縣,苗栗市,0042,575,164,739,64,803,1387,57.89%,41.46%,1
苗栗縣,苗栗市,0043,510,127,637,37,674,1206,55.89%,42.29%,1
苗栗縣,苗栗市,0044,469,129,598,38,636,1004,63.35%,46.71%,1
苗栗縣,苗栗市,0045,495,145,640,33,673,1202,55.99%,41.18%,1
苗栗縣,苗栗市,0046,494,117,611,31,642,1052,61.03%,46.96%,1
苗栗縣,苗栗市,0047,420,93,513,26,539,873,61.74%,48.11%,1
苗栗縣,苗栗市,0048,510,117,627,26,653,975,66.97%,52.31%,1
苗栗縣,苗栗市,0049,483,126,609,34,643,1003,64.11%,48.16%,1
苗栗縣,苗栗市,0050,444,118,562,17,579,1000,57.9%,44.4%,1
苗栗縣,苗栗市,0051,463,98,561,29,590,1047,56.35%,44.22%,1
苗栗縣,苗栗市,0052,497,91,588,38,626,1025,61.07%,48.49%,1
苗栗縣,苗栗市,0053,464,109,573,36,609,1130,53.89%,41.06%,1
苗栗縣,苗栗市,0054,508,112,620,34,654,1146,57.07%,44.33%,1
苗栗縣,苗栗市,0055,629,149,778,57,835,1432,58.31%,43.92%,1
苗栗縣,苗栗市,0056,530,128,658,35,693,1492,46.45%,35.52%,1
苗栗縣,苗栗市,0057,519,133,652,39,691,1125,61.42%,46.13%,1
苗栗縣,苗栗市,0058,522,140,662,33,695,1241,56%,42.06%,1
苗栗縣,苗栗市,0059,582,145,727,38,765,1278,59.86%,45.54%,1
苗栗縣,苗栗市,0060,579,112,691,23,714,1293,55.22%,44.78%,1
苗栗縣,苗栗市,0061,547,127,674,35,709,1342,52.83%,40.76%,1
苗栗縣,苗栗市,0062,336,105,441,37,478,857,55.78%,39.21%,1
苗栗縣,苗栗市,0063,492,112,604,43,647,1180,54.83%,41.69%,1
苗栗縣,苗栗市,0064,477,128,605,31,636,1072,59.33%,44.5%,1
苗栗縣,苗栗市,0065,386,71,457,25,482,912,52.85%,42.32%,1
苗栗縣,苗栗市,0066,312,85,397,29,426,796,53.52%,39.2%,1
苗栗縣,苗栗市,0067,322,81,403,27,430,869,49.48%,37.05%,1
苗栗縣,苑裡鎮,0183,331,139,470,53,523,873,59.91%,37.92%,1
苗栗縣,苑裡鎮,0184,551,178,729,44,773,1346,57.43%,40.94%,1
苗栗縣,苑裡鎮,0185,424,138,562,68,630,951,66.25%,44.58%,1
苗栗縣,苑裡鎮,0186,219,83,302,18,320,615,52.03%,35.61%,1
苗栗縣,苑裡鎮,0187,358,117,475,73,548,878,62.41%,40.77%,1
苗栗縣,苑裡鎮,0188,330,106,436,32,468,767,61.02%,43.02%,1
苗栗縣,苑裡鎮,0189,287,106,393,40,433,776,55.8%,36.98%,1
苗栗縣,苑裡鎮,0190,424,136,560,74,634,1231,51.5%,34.44%,1
苗栗縣,苑裡鎮,0191,467,153,620,52,672,1145,58.69%,40.79%,1
苗栗縣,苑裡鎮,0192,312,113,425,40,465,850,54.71%,36.71%,1
苗栗縣,苑裡鎮,0193,373,152,525,54,579,1052,55.04%,35.46%,1
苗栗縣,苑裡鎮,0194,438,157,595,44,639,1114,57.36%,39.32%,1
苗栗縣,苑裡鎮,0195,435,174,609,61,670,1136,58.98%,38.29%,1
苗栗縣,苑裡鎮,0196,459,161,620,44,664,1194,55.61%,38.44%,1
苗栗縣,苑裡鎮,0197,645,193,838,62,900,1579,57%,40.85%,1
苗栗縣,苑裡鎮,0198,481,159,640,68,708,1149,61.62%,41.86%,1
苗栗縣,苑裡鎮,0199,414,157,571,69,640,1057,60.55%,39.17%,1
苗栗縣,苑裡鎮,0200,388,133,521,19,540,1101,49.05%,35.24%,1
苗栗縣,苑裡鎮,0201,265,110,375,46,421,912,46.16%,29.06%,1
苗栗縣,苑裡鎮,0202,228,86,314,50,364,652,55.83%,34.97%,1
苗栗縣,苑裡鎮,0203,529,163,692,80,772,1348,57.27%,39.24%,1
苗栗縣,苑裡鎮,0204,217,98,315,26,341,733,46.52%,29.6%,1
苗栗縣,苑裡鎮,0205,251,64,315,13,328,662,49.55%,37.92%,1
苗栗縣,苑裡鎮,0206,356,109,465,51,516,893,57.78%,39.87%,1
苗栗縣,苑裡鎮,0207,377,121,498,47,545,910,59.89%,41.43%,1
苗栗縣,苑裡鎮,0208,465,167,632,61,693,1270,54.57%,36.61%,1
苗栗縣,苑裡鎮,0209,210,52,262,30,292,545,53.58%,38.53%,1
苗栗縣,苑裡鎮,0210,342,93,435,67,502,792,63.38%,43.18%,1
苗栗縣,苑裡鎮,0211,272,109,381,36,417,726,57.44%,37.47%,1
苗栗縣,苑裡鎮,0212,256,67,323,21,344,827,41.6%,30.96%,1
苗栗縣,苑裡鎮,0213,308,101,409,55,464,782,59.34%,39.39%,1
苗栗縣,苑裡鎮,0214,207,199,406,28,434,788,55.08%,26.27%,1
苗栗縣,苑裡鎮,0215,320,101,421,39,460,846,54.37%,37.83%,1
苗栗縣,苑裡鎮,0216,329,120,449,55,504,828,60.87%,39.73%,1
苗栗縣,苑裡鎮,0217,392,112,504,46,550,943,58.32%,41.57%,1
苗栗縣,苑裡鎮,0218,469,131,600,32,632,1082,58.41%,43.35%,1
苗栗縣,苑裡鎮,0219,511,176,687,62,749,1234,60.7%,41.41%,1
苗栗縣,苑裡鎮,0220,550,171,721,62,783,1434,54.6%,38.35%,1
苗栗縣,苑裡鎮,0221,393,130,523,45,568,987,57.55%,39.82%,1
苗栗縣,苑裡鎮,0222,349,168,517,45,562,882,63.72%,39.57%,1
苗栗縣,通霄鎮,0149,427,153,580,71,651,1142,57.01%,37.39%,1
苗栗縣,通霄鎮,0150,352,156,508,65,573,884,64.82%,39.82%,1
苗栗縣,通霄鎮,0151,389,133,522,69,591,1068,55.34%,36.42%,1
苗栗縣,通霄鎮,0152,380,136,516,48,564,1009,55.9%,37.66%,1
苗栗縣,通霄鎮,0153,367,141,508,53,561,859,65.31%,42.72%,1
苗栗縣,通霄鎮,0154,503,52,555,47,602,1040,57.88%,48.37%,1
苗栗縣,通霄鎮,0155,314,91,405,14,419,1008,41.57%,31.15%,1
苗栗縣,通霄鎮,0156,260,91,351,57,408,686,59.48%,37.9%,1
苗栗縣,通霄鎮,0157,321,128,449,54,503,761,66.1%,42.18%,1
苗栗縣,通霄鎮,0158,275,96,371,26,397,790,50.25%,34.81%,1
苗栗縣,通霄鎮,0159,337,135,472,58,530,966,54.87%,34.89%,1
苗栗縣,通霄鎮,0160,319,112,431,72,503,972,51.75%,32.82%,1
苗栗縣,通霄鎮,0161,288,96,384,48,432,771,56.03%,37.35%,1
苗栗縣,通霄鎮,0162,213,88,301,28,329,758,43.4%,28.1%,1
苗栗縣,通霄鎮,0163,377,153,530,52,582,1078,53.99%,34.97%,1
苗栗縣,通霄鎮,0164,124,52,176,23,199,459,43.36%,27.02%,1
苗栗縣,通霄鎮,0165,313,91,404,45,449,894,50.22%,35.01%,1
苗栗縣,通霄鎮,0166,108,41,149,10,159,402,39.55%,26.87%,1
苗栗縣,通霄鎮,0167,287,116,403,30,433,802,53.99%,35.79%,1
苗栗縣,通霄鎮,0168,215,103,318,28,346,684,50.58%,31.43%,1
苗栗縣,通霄鎮,0169,311,84,395,44,439,943,46.55%,32.98%,1
苗栗縣,通霄鎮,0170,95,321,416,61,477,790,60.38%,12.03%,1
苗栗縣,通霄鎮,0171,199,63,262,15,277,673,41.16%,29.57%,1
苗栗縣,通霄鎮,0172,446,143,589,60,649,1232,52.68%,36.2%,1
苗栗縣,通霄鎮,0173,505,176,681,74,755,1286,58.71%,39.27%,1
苗栗縣,通霄鎮,0174,248,91,339,47,386,649,59.48%,38.21%,1
苗栗縣,通霄鎮,0175,270,88,358,28,386,769,50.2%,35.11%,1
苗栗縣,通霄鎮,0176,398,160,558,72,630,1148,54.88%,34.67%,1
苗栗縣,通霄鎮,0177,366,136,502,73,575,1138,50.53%,32.16%,1
苗栗縣,通霄鎮,0178,367,127,494,49,543,1121,48.44%,32.74%,1
苗栗縣,通霄鎮,0179,296,109,405,22,427,769,55.53%,38.49%,1
苗栗縣,通霄鎮,0180,188,97,285,12,297,616,48.21%,30.52%,1
苗栗縣,通霄鎮,0181,314,87,401,37,438,799,54.82%,39.3%,1
苗栗縣,通霄鎮,0182,272,68,340,33,373,743,50.2%,36.61%,1
苗栗縣,竹南鎮,0270,450,162,612,37,649,1086,59.76%,41.44%,1
苗栗縣,竹南鎮,0271,360,90,450,36,486,826,58.84%,43.58%,1
苗栗縣,竹南鎮,0272,378,114,492,59,551,1051,52.43%,35.97%,1
苗栗縣,竹南鎮,0273,561,128,689,42,731,1235,59.19%,45.43%,1
苗栗縣,竹南鎮,0274,411,128,539,75,614,1016,60.43%,40.45%,1
苗栗縣,竹南鎮,0275,546,189,735,62,797,1472,54.14%,37.09%,1
苗栗縣,竹南鎮,0276,443,152,595,40,635,1301,48.81%,34.05%,1
苗栗縣,竹南鎮,0277,567,173,740,41,781,1544,50.58%,36.72%,1
苗栗縣,竹南鎮,0278,700,94,794,36,830,1512,54.89%,46.3%,1
苗栗縣,竹南鎮,0279,540,176,716,59,775,1463,52.97%,36.91%,1
苗栗縣,竹南鎮,0280,409,123,532,35,567,1073,52.84%,38.12%,1
苗栗縣,竹南鎮,0281,625,175,800,35,835,1453,57.47%,43.01%,1
苗栗縣,竹南鎮,0282,573,140,713,39,752,1245,60.4%,46.02%,1
苗栗縣,竹南鎮,0283,685,161,846,42,888,1487,59.72%,46.07%,1
苗栗縣,竹南鎮,0284,518,39,557,40,597,1018,58.64%,50.88%,1
苗栗縣,竹南鎮,0285,475,150,625,31,656,1105,59.37%,42.99%,1
苗栗縣,竹南鎮,0286,485,171,656,44,700,1322,52.95%,36.69%,1
苗栗縣,竹南鎮,0287,507,131,638,24,662,1140,58.07%,44.47%,1
苗栗縣,竹南鎮,0288,487,133,620,35,655,1067,61.39%,45.64%,1
苗栗縣,竹南鎮,0289,510,160,670,47,717,1136,63.12%,44.89%,1
苗栗縣,竹南鎮,0290,489,118,607,46,653,1253,52.11%,39.03%,1
苗栗縣,竹南鎮,0291,353,102,455,57,512,963,53.17%,36.66%,1
苗栗縣,竹南鎮,0292,379,130,509,47,556,1021,54.46%,37.12%,1
苗栗縣,竹南鎮,0293,501,144,645,47,692,1154,59.97%,43.41%,1
苗栗縣,竹南鎮,0294,433,127,560,32,592,1042,56.81%,41.55%,1
苗栗縣,竹南鎮,0295,559,143,702,41,743,1293,57.46%,43.23%,1
苗栗縣,竹南鎮,0296,364,98,462,18,480,816,58.82%,44.61%,1
苗栗縣,竹南鎮,0297,407,106,513,49,562,989,56.83%,41.15%,1
苗栗縣,竹南鎮,0298,525,116,641,36,677,1122,60.34%,46.79%,1
苗栗縣,竹南鎮,0299,382,100,482,41,523,1111,47.07%,34.38%,1
苗栗縣,竹南鎮,0300,453,100,553,62,615,1036,59.36%,43.73%,1
苗栗縣,竹南鎮,0301,413,116,529,30,559,1112,50.27%,37.14%,1
苗栗縣,竹南鎮,0302,645,29,674,26,700,1348,51.93%,47.85%,1
苗栗縣,竹南鎮,0303,470,151,621,23,644,1114,57.81%,42.19%,1
苗栗縣,竹南鎮,0304,477,143,620,51,671,1119,59.96%,42.63%,1
苗栗縣,竹南鎮,0305,364,99,463,35,498,878,56.72%,41.46%,1
苗栗縣,竹南鎮,0306,461,137,598,53,651,1059,61.47%,43.53%,1
苗栗縣,竹南鎮,0307,348,128,476,40,516,869,59.38%,40.05%,1
苗栗縣,竹南鎮,0308,311,101,412,30,442,800,55.25%,38.88%,1
苗栗縣,竹南鎮,0309,522,150,672,40,712,1165,61.12%,44.81%,1
苗栗縣,竹南鎮,0310,330,98,428,36,464,791,58.66%,41.72%,1
苗栗縣,竹南鎮,0311,242,105,347,24,371,677,54.8%,35.75%,1
苗栗縣,竹南鎮,0312,377,87,464,53,517,797,64.87%,47.3%,1
苗栗縣,竹南鎮,0313,480,129,609,42,651,1191,54.66%,40.3%,1
苗栗縣,竹南鎮,0314,387,123,510,22,532,1027,51.8%,37.68%,1
苗栗縣,竹南鎮,0315,588,155,743,48,791,1341,58.99%,43.85%,1
苗栗縣,竹南鎮,0316,502,144,646,57,703,1378,51.02%,36.43%,1
苗栗縣,竹南鎮,0317,505,145,650,32,682,1216,56.09%,41.53%,1
苗栗縣,竹南鎮,0318,628,157,785,37,822,1570,52.36%,40%,1
苗栗縣,竹南鎮,0319,226,70,296,35,331,538,61.52%,42.01%,1
苗栗縣,竹南鎮,0320,408,115,523,21,544,1166,46.66%,34.99%,1
苗栗縣,竹南鎮,0321,558,183,741,34,775,1488,52.08%,37.5%,1
苗栗縣,竹南鎮,0322,543,150,693,26,719,1449,49.62%,37.47%,1
苗栗縣,竹南鎮,0323,434,158,592,69,661,1182,55.92%,36.72%,1
苗栗縣,竹南鎮,0324,445,160,605,65,670,1175,57.02%,37.87%,1
苗栗縣,竹南鎮,0325,400,113,513,42,555,983,56.46%,40.69%,1
苗栗縣,竹南鎮,0326,230,55,285,24,309,492,62.8%,46.75%,1
苗栗縣,竹南鎮,0327,438,143,581,41,622,1074,57.91%,40.78%,1
苗栗縣,竹南鎮,0328,297,123,420,48,468,852,54.93%,34.86%,1
苗栗縣,竹南鎮,0329,519,137,656,31,687,1297,52.97%,40.02%,1
苗栗縣,竹南鎮,0330,388,123,511,47,558,1028,54.28%,37.74%,1
苗栗縣,頭份市,0331,346,96,442,55,497,915,54.32%,37.81%,1
苗栗縣,頭份市,0332,529,150,679,56,735,1292,56.89%,40.94%,1
苗栗縣,頭份市,0333,397,125,522,30,552,928,59.48%,42.78%,1
苗栗縣,頭份市,0334,318,70,388,14,402,835,48.14%,38.08%,1
苗栗縣,頭份市,0335,430,121,551,36,587,1070,54.86%,40.19%,1
苗栗縣,頭份市,0336,322,95,417,12,429,879,48.81%,36.63%,1
苗栗縣,頭份市,0337,380,114,494,44,538,1039,51.78%,36.57%,1
苗栗縣,頭份市,0338,477,120,597,61,658,1129,58.28%,42.25%,1
苗栗縣,頭份市,0339,421,113,534,38,572,1041,54.95%,40.44%,1
苗栗縣,頭份市,0340,565,150,715,72,787,1546,50.91%,36.55%,1
苗栗縣,頭份市,0341,429,118,547,38,585,935,62.57%,45.88%,1
苗栗縣,頭份市,0342,422,152,574,43,617,1180,52.29%,35.76%,1
苗栗縣,頭份市,0343,577,139,716,40,756,1499,50.43%,38.49%,1
苗栗縣,頭份市,0344,316,69,385,19,404,747,54.08%,42.3%,1
苗栗縣,頭份市,0345,563,150,713,35,748,1406,53.2%,40.04%,1
苗栗縣,頭份市,0346,495,122,617,57,674,1193,56.5%,41.49%,1
苗栗縣,頭份市,0347,384,134,518,34,552,948,58.23%,40.51%,1
苗栗縣,頭份市,0348,346,92,438,26,464,869,53.39%,39.82%,1
苗栗縣,頭份市,0349,485,131,616,49,665,1142,58.23%,42.47%,1
苗栗縣,頭份市,0350,520,150,670,28,698,1286,54.28%,40.44%,1
苗栗縣,頭份市,0351,399,102,501,33,534,903,59.14%,44.19%,1
苗栗縣,頭份市,0352,567,127,694,41,735,1186,61.97%,47.81%,1
苗栗縣,頭份市,0353,469,93,562,26,588,1016,57.87%,46.16%,1
苗栗縣,頭份市,0354,414,110,524,35,559,985,56.75%,42.03%,1
苗栗縣,頭份市,0355,441,108,549,27,576,1037,55.54%,42.53%,1
苗栗縣,頭份市,0356,340,88,428,36,464,947,49%,35.9%,1
苗栗縣,頭份市,0357,401,80,481,37,518,890,58.2%,45.06%,1
苗栗縣,頭份市,0358,270,96,366,40,406,646,62.85%,41.8%,1
苗栗縣,頭份市,0359,390,137,527,49,576,975,59.08%,40%,1
苗栗縣,頭份市,0360,284,87,371,21,392,1015,38.62%,27.98%,1
苗栗縣,頭份市,0361,627,172,799,59,858,1399,61.33%,44.82%,1
苗栗縣,頭份市,0362,507,130,637,50,687,1143,60.1%,44.36%,1
苗栗縣,頭份市,0363,456,140,596,73,669,1030,64.95%,44.27%,1
苗栗縣,頭份市,0364,569,162,731,40,771,1338,57.62%,42.53%,1
苗栗縣,頭份市,0365,599,137,736,36,772,1450,53.24%,41.31%,1
苗栗縣,頭份市,0366,487,95,582,23,605,1042,58.06%,46.74%,1
苗栗縣,頭份市,0367,596,157,753,44,797,1326,60.11%,44.95%,1
苗栗縣,頭份市,0368,614,154,768,32,800,1270,62.99%,48.35%,1
苗栗縣,頭份市,0369,518,155,673,41,714,1288,55.43%,40.22%,1
苗栗縣,頭份市,0370,537,139,676,36,712,1243,57.28%,43.2%,1
苗栗縣,頭份市,0371,573,141,714,36,750,1280,58.59%,44.77%,1
苗栗縣,頭份市,0372,648,180,828,74,902,1618,55.75%,40.05%,1
苗栗縣,頭份市,0373,711,174,885,47,932,1759,52.98%,40.42%,1
苗栗縣,頭份市,0374,581,128,709,40,749,1264,59.26%,45.97%,1
苗栗縣,頭份市,0375,604,129,733,32,765,1326,57.69%,45.55%,1
苗栗縣,頭份市,0376,697,149,846,39,885,1551,57.06%,44.94%,1
苗栗縣,頭份市,0377,629,139,768,44,812,1574,51.59%,39.96%,1
苗栗縣,頭份市,0378,540,159,699,40,739,1262,58.56%,42.79%,1
苗栗縣,頭份市,0379,523,120,643,43,686,1171,58.58%,44.66%,1
苗栗縣,頭份市,0380,518,137,655,41,696,1074,64.8%,48.23%,1
苗栗縣,頭份市,0381,521,135,656,32,688,1141,60.3%,45.66%,1
苗栗縣,頭份市,0382,519,167,686,45,731,1259,58.06%,41.22%,1
苗栗縣,頭份市,0383,485,136,621,34,655,1186,55.23%,40.89%,1
苗栗縣,頭份市,0384,440,112,552,31,583,1121,52.01%,39.25%,1
苗栗縣,頭份市,0385,355,100,455,31,486,847,57.38%,41.91%,1
苗栗縣,頭份市,0386,446,124,570,28,598,993,60.22%,44.91%,1
苗栗縣,頭份市,0387,417,115,532,36,568,1055,53.84%,39.53%,1
苗栗縣,頭份市,0388,634,138,772,54,826,1655,49.91%,38.31%,1
苗栗縣,頭份市,0389,758,165,923,66,989,1799,54.97%,42.13%,1
苗栗縣,頭份市,0390,500,126,626,36,662,1141,58.02%,43.82%,1
苗栗縣,頭份市,0391,566,163,729,52,781,1431,54.58%,39.55%,1
苗栗縣,頭份市,0392,491,128,619,32,651,1412,46.1%,34.77%,1
苗栗縣,頭份市,0393,416,109,525,39,564,1074,52.51%,38.73%,1
苗栗縣,頭份市,0394,570,131,701,42,743,1245,59.68%,45.78%,1
苗栗縣,頭份市,0395,554,190,744,55,799,1344,59.45%,41.22%,1
苗栗縣,頭份市,0396,614,168,782,61,843,1363,61.85%,45.05%,1
苗栗縣,頭份市,0397,414,104,518,45,563,898,62.69%,46.1%,1
苗栗縣,頭份市,0398,507,141,648,62,710,1182,60.07%,42.89%,1
苗栗縣,頭份市,0399,569,167,736,37,773,1413,54.71%,40.27%,1
苗栗縣,頭份市,0400,453,133,586,30,616,991,62.16%,45.71%,1
苗栗縣,頭份市,0401,495,155,650,43,693,1180,58.73%,41.95%,1
苗栗縣,後龍鎮,0223,228,76,304,36,340,590,57.63%,38.64%,1
苗栗縣,後龍鎮,0224,371,131,502,56,558,883,63.19%,42.02%,1
苗栗縣,後龍鎮,0225,336,103,439,54,493,793,62.17%,42.37%,1
苗栗縣,後龍鎮,0226,273,133,406,33,439,732,59.97%,37.3%,1
苗栗縣,後龍鎮,0227,224,93,317,41,358,592,60.47%,37.84%,1
苗栗縣,後龍鎮,0228,456,157,613,50,663,1113,59.57%,40.97%,1
苗栗縣,後龍鎮,0229,474,151,625,52,677,1195,56.65%,39.67%,1
苗栗縣,後龍鎮,0230,434,138,572,48,620,997,62.19%,43.53%,1
苗栗縣,後龍鎮,0231,301,108,409,26,435,913,47.65%,32.97%,1
苗栗縣,後龍鎮,0232,213,85,298,37,335,641,52.26%,33.23%,1
苗栗縣,後龍鎮,0233,300,107,407,30,437,848,51.53%,35.38%,1
苗栗縣,後龍鎮,0234,451,158,609,94,703,1264,55.62%,35.68%,1
苗栗縣,後龍鎮,0235,339,108,447,42,489,965,50.67%,35.13%,1
苗栗縣,後龍鎮,0236,620,163,783,68,851,1216,69.98%,50.99%,1
苗栗縣,後龍鎮,0237,396,101,497,36,533,977,54.55%,40.53%,1
苗栗縣,後龍鎮,0238,305,115,420,55,475,943,50.37%,32.34%,1
苗栗縣,後龍鎮,0239,328,127,455,66,521,910,57.25%,36.04%,1
苗栗縣,後龍鎮,0240,340,89,429,45,474,851,55.7%,39.95%,1
苗栗縣,後龍鎮,0241,301,120,421,27,448,725,61.79%,41.52%,1
苗栗縣,後龍鎮,0242,261,85,346,43,389,650,59.85%,40.15%,1
苗栗縣,後龍鎮,0243,231,90,321,45,366,706,51.84%,32.72%,1
苗栗縣,後龍鎮,0244,259,122,381,50,431,748,57.62%,34.63%,1
苗栗縣,後龍鎮,0245,231,98,329,45,374,801,46.69%,28.84%,1
苗栗縣,後龍鎮,0246,433,146,579,46,625,1107,56.46%,39.11%,1
苗栗縣,後龍鎮,0247,458,131,589,61,650,1197,54.3%,38.26%,1
苗栗縣,後龍鎮,0248,370,109,479,48,527,1036,50.87%,35.71%,1
苗栗縣,後龍鎮,0249,260,105,365,45,410,913,44.91%,28.48%,1
苗栗縣,後龍鎮,0250,287,98,385,55,440,719,61.2%,39.92%,1
苗栗縣,後龍鎮,0251,380,117,497,102,599,1037,57.76%,36.64%,1
苗栗縣,後龍鎮,0252,218,67,285,21,306,601,50.92%,36.27%,1
苗栗縣,後龍鎮,0253,495,124,619,48,667,1269,52.56%,39.01%,1
苗栗縣,後龍鎮,0254,240,86,326,30,356,735,48.44%,32.65%,1
苗栗縣,後龍鎮,0255,92,41,133,11,144,422,34.12%,21.8%,1
苗栗縣,後龍鎮,0256,253,77,330,25,355,625,56.8%,40.48%,1
苗栗縣,後龍鎮,0257,388,129,517,57,574,1234,46.52%,31.44%,1
苗栗縣,卓蘭鎮,0442,436,115,551,34,585,961,60.87%,45.37%,1
苗栗縣,卓蘭鎮,0443,393,120,513,59,572,1017,56.24%,38.64%,1
苗栗縣,卓蘭鎮,0444,471,169,640,64,704,1095,64.29%,43.01%,1
苗栗縣,卓蘭鎮,0445,319,96,415,32,447,745,60%,42.82%,1
苗栗縣,卓蘭鎮,0446,299,93,392,38,430,783,54.92%,38.19%,1
苗栗縣,卓蘭鎮,0447,250,86,336,19,355,745,47.65%,33.56%,1
苗栗縣,卓蘭鎮,0448,356,108,464,23,487,999,48.75%,35.64%,1
苗栗縣,卓蘭鎮,0449,312,69,381,37,418,671,62.3%,46.5%,1
苗栗縣,卓蘭鎮,0450,335,90,425,54,479,734,65.26%,45.64%,1
苗栗縣,卓蘭鎮,0451,369,119,488,46,534,865,61.73%,42.66%,1
苗栗縣,卓蘭鎮,0452,378,101,479,42,521,828,62.92%,45.65%,1
苗栗縣,卓蘭鎮,0453,171,44,215,29,244,386,63.21%,44.3%,1
苗栗縣,卓蘭鎮,0454,319,88,407,37,444,688,64.53%,46.37%,1
苗栗縣,卓蘭鎮,0455,319,129,448,46,494,792,62.37%,40.28%,1
苗栗縣,卓蘭鎮,0456,308,93,401,29,430,729,58.98%,42.25%,1
苗栗縣,卓蘭鎮,0457,364,118,482,30,512,1093,46.84%,33.3%,1
苗栗縣,卓蘭鎮,0458,277,58,335,11,346,615,56.26%,45.04%,1
苗栗縣,卓蘭鎮,0459,39,3,42,1,43,86,50%,45.35%,1
苗栗縣,卓蘭鎮,0460,389,100,489,19,508,940,54.04%,41.38%,1
苗栗縣,大湖鄉,0420,284,95,379,24,403,744,54.17%,38.17%,1
苗栗縣,大湖鄉,0421,370,85,455,31,486,881,55.16%,42%,1
苗栗縣,大湖鄉,0422,240,55,295,44,339,596,56.88%,40.27%,1
苗栗縣,大湖鄉,0423,449,136,585,65,650,1260,51.59%,35.63%,1
苗栗縣,大湖鄉,0424,348,78,426,29,455,867,52.48%,40.14%,1
苗栗縣,大湖鄉,0425,379,88,467,43,510,923,55.25%,41.06%,1
苗栗縣,大湖鄉,0426,500,170,670,67,737,1395,52.83%,35.84%,1
苗栗縣,大湖鄉,0427,131,52,183,20,203,561,36.19%,23.35%,1
苗栗縣,大湖鄉,0428,266,76,342,28,370,638,57.99%,41.69%,1
苗栗縣,大湖鄉,0429,284,71,355,44,399,754,52.92%,37.67%,1
苗栗縣,大湖鄉,0430,171,63,234,14,248,501,49.5%,34.13%,1
苗栗縣,大湖鄉,0431,247,79,326,32,358,652,54.91%,37.88%,1
苗栗縣,大湖鄉,0432,299,86,385,23,408,843,48.4%,35.47%,1
苗栗縣,大湖鄉,0433,419,109,528,69,597,1020,58.53%,41.08%,1
苗栗縣,大湖鄉,0434,442,104,546,33,579,1018,56.88%,43.42%,1
苗栗縣,公館鄉,0068,349,110,459,62,521,789,66.03%,44.23%,1
苗栗縣,公館鄉,0069,395,97,492,30,522,792,65.91%,49.87%,1
苗栗縣,公館鄉,0070,468,169,637,71,708,1117,63.38%,41.9%,1
苗栗縣,公館鄉,0071,557,166,723,62,785,1255,62.55%,44.38%,1
苗栗縣,公館鄉,0072,510,137,647,36,683,1141,59.86%,44.7%,1
苗栗縣,公館鄉,0073,510,135,645,42,687,1172,58.62%,43.52%,1
苗栗縣,公館鄉,0074,499,151,650,45,695,1100,63.18%,45.36%,1
苗栗縣,公館鄉,0075,480,124,604,48,652,1232,52.92%,38.96%,1
苗栗縣,公館鄉,0076,406,107,513,56,569,1081,52.64%,37.56%,1
苗栗縣,公館鄉,0077,610,119,729,46,775,1250,62%,48.8%,1
苗栗縣,公館鄉,0078,450,131,581,50,631,1081,58.37%,41.63%,1
苗栗縣,公館鄉,0079,384,106,490,63,553,964,57.37%,39.83%,1
苗栗縣,公館鄉,0080,460,120,580,57,637,1038,61.37%,44.32%,1
苗栗縣,公館鄉,0081,152,48,200,27,227,360,63.06%,42.22%,1
苗栗縣,公館鄉,0082,336,113,449,49,498,865,57.57%,38.84%,1
苗栗縣,公館鄉,0083,475,134,609,43,652,1166,55.92%,40.74%,1
苗栗縣,公館鄉,0084,323,81,404,25,429,719,59.67%,44.92%,1
苗栗縣,公館鄉,0085,303,94,397,38,435,788,55.2%,38.45%,1
苗栗縣,公館鄉,0086,138,37,175,27,202,303,66.67%,45.54%,1
苗栗縣,公館鄉,0087,565,166,731,56,787,1322,59.53%,42.74%,1
苗栗縣,公館鄉,0088,363,109,472,62,534,933,57.23%,38.91%,1
苗栗縣,公館鄉,0089,573,142,715,77,792,1455,54.43%,39.38%,1
苗栗縣,公館鄉,0090,708,207,915,84,999,1615,61.86%,43.84%,1
苗栗縣,公館鄉,0091,565,169,734,72,806,1451,55.55%,38.94%,1
苗栗縣,公館鄉,0092,651,174,825,57,882,1462,60.33%,44.53%,1
苗栗縣,公館鄉,0093,504,172,676,61,737,1317,55.96%,38.27%,1
苗栗縣,公館鄉,0094,112,15,127,4,131,221,59.28%,50.68%,1
苗栗縣,公館鄉,0095,133,31,164,11,175,329,53.19%,40.43%,1
苗栗縣,銅鑼鄉,0108,414,95,509,39,548,887,61.78%,46.67%,1
苗栗縣,銅鑼鄉,0109,465,118,583,47,630,1052,59.89%,44.2%,1
苗栗縣,銅鑼鄉,0110,635,164,799,27,826,1347,61.32%,47.14%,1
苗栗縣,銅鑼鄉,0111,500,130,630,41,671,1177,57.01%,42.48%,1
苗栗縣,銅鑼鄉,0112,504,145,649,34,683,1268,53.86%,39.75%,1
苗栗縣,銅鑼鄉,0113,428,113,541,36,577,1185,48.69%,36.12%,1
苗栗縣,銅鑼鄉,0114,477,87,564,39,603,1029,58.6%,46.36%,1
苗栗縣,銅鑼鄉,0115,421,74,495,26,521,905,57.57%,46.52%,1
苗栗縣,銅鑼鄉,0116,331,92,423,43,466,750,62.13%,44.13%,1
苗栗縣,銅鑼鄉,0117,398,115,513,41,554,1080,51.3%,36.85%,1
苗栗縣,銅鑼鄉,0118,440,103,543,56,599,1108,54.06%,39.71%,1
苗栗縣,銅鑼鄉,0119,344,73,417,40,457,862,53.02%,39.91%,1
苗栗縣,銅鑼鄉,0120,488,127,615,32,647,1216,53.21%,40.13%,1
苗栗縣,銅鑼鄉,0121,212,62,274,29,303,588,51.53%,36.05%,1
苗栗縣,銅鑼鄉,0122,154,48,202,32,234,429,54.55%,35.9%,1
苗栗縣,銅鑼鄉,0123,233,62,295,22,317,541,58.6%,43.07%,1
苗栗縣,南庄鄉,0411,447,123,570,69,639,1155,55.32%,38.7%,1
苗栗縣,南庄鄉,0412,242,79,321,44,365,650,56.15%,37.23%,1
苗栗縣,南庄鄉,0413,486,153,639,61,700,1353,51.74%,35.92%,1
苗栗縣,南庄鄉,0414,249,64,313,42,355,813,43.67%,30.63%,1
苗栗縣,南庄鄉,0415,253,73,326,31,357,837,42.65%,30.23%,1
苗栗縣,南庄鄉,0416,430,110,540,33,573,1093,52.42%,39.34%,1
苗栗縣,南庄鄉,0417,380,135,515,55,570,1048,54.39%,36.26%,1
苗栗縣,南庄鄉,0418,308,98,406,40,446,872,51.15%,35.32%,1
苗栗縣,南庄鄉,0419,238,50,288,11,299,963,31.05%,24.71%,1
苗栗縣,頭屋鄉,0096,652,186,838,55,893,1335,66.89%,48.84%,1
苗栗縣,頭屋鄉,0097,619,149,768,59,827,1168,70.8%,53%,1
苗栗縣,頭屋鄉,0098,375,110,485,31,516,792,65.15%,47.35%,1
苗栗縣,頭屋鄉,0099,499,113,612,46,658,918,71.68%,54.36%,1
苗栗縣,頭屋鄉,0100,343,84,427,35,462,725,63.72%,47.31%,1
苗栗縣,頭屋鄉,0101,429,100,529,25,554,899,61.62%,47.72%,1
苗栗縣,頭屋鄉,0102,128,38,166,15,181,369,49.05%,34.69%,1
苗栗縣,頭屋鄉,0103,373,106,479,25,504,844,59.72%,44.19%,1
苗栗縣,頭屋鄉,0104,459,105,564,32,596,1007,59.19%,45.58%,1
苗栗縣,頭屋鄉,0105,373,91,464,37,501,794,63.1%,46.98%,1
苗栗縣,頭屋鄉,0106,116,29,145,12,157,211,74.41%,54.98%,1
苗栗縣,頭屋鄉,0107,167,50,217,20,237,328,72.26%,50.91%,1
苗栗縣,三義鄉,0124,374,99,473,49,522,853,61.2%,43.85%,1
苗栗縣,三義鄉,0125,472,114,586,26,612,983,62.26%,48.02%,1
苗栗縣,三義鄉,0126,480,124,604,43,647,1080,59.91%,44.44%,1
苗栗縣,三義鄉,0127,527,103,630,18,648,1216,53.29%,43.34%,1
苗栗縣,三義鄉,0128,465,102,567,36,603,1017,59.29%,45.72%,1
苗栗縣,三義鄉,0129,508,105,613,19,632,1180,53.56%,43.05%,1
苗栗縣,三義鄉,0130,544,118,662,22,684,1198,57.1%,45.41%,1
苗栗縣,三義鄉,0131,175,44,219,22,241,417,57.79%,41.97%,1
苗栗縣,三義鄉,0132,382,106,488,27,515,991,51.97%,38.55%,1
苗栗縣,三義鄉,0133,368,106,474,14,488,834,58.51%,44.12%,1
苗栗縣,三義鄉,0134,269,66,335,31,366,622,58.84%,43.25%,1
苗栗縣,三義鄉,0135,315,105,420,39,459,749,61.28%,42.06%,1
苗栗縣,三義鄉,0136,355,81,436,24,460,692,66.47%,51.3%,1
苗栗縣,三義鄉,0137,398,99,497,37,534,759,70.36%,52.44%,1
苗栗縣,三義鄉,0138,241,67,308,27,335,629,53.26%,38.31%,1
苗栗縣,三義鄉,0139,250,99,349,37,386,669,57.7%,37.37%,1
苗栗縣,西湖鄉,0140,235,65,300,24,324,601,53.91%,39.1%,1
苗栗縣,西湖鄉,0141,258,60,318,23,341,566,60.25%,45.58%,1
苗栗縣,西湖鄉,0142,360,91,451,40,491,843,58.24%,42.7%,1
苗栗縣,西湖鄉,0143,257,71,328,15,343,648,52.93%,39.66%,1
苗栗縣,西湖鄉,0144,339,96,435,39,474,936,50.64%,36.22%,1
苗栗縣,西湖鄉,0145,187,46,233,14,247,461,53.58%,40.56%,1
苗栗縣,西湖鄉,0146,218,59,277,18,295,515,57.28%,42.33%,1
苗栗縣,西湖鄉,0147,432,116,548,67,615,1141,53.9%,37.86%,1
苗栗縣,西湖鄉,0148,300,57,357,38,395,671,58.87%,44.71%,1
苗栗縣,造橋鄉,0258,568,130,698,66,764,1171,65.24%,48.51%,1
苗栗縣,造橋鄉,0259,394,93,487,39,526,889,59.17%,44.32%,1
苗栗縣,造橋鄉,0260,184,34,218,17,235,479,49.06%,38.41%,1
苗栗縣,造橋鄉,0261,439,119,558,44,602,1024,58.79%,42.87%,1
苗栗縣,造橋鄉,0262,452,137,589,68,657,1214,54.12%,37.23%,1
苗栗縣,造橋鄉,0263,395,122,517,45,562,1071,52.47%,36.88%,1
苗栗縣,造橋鄉,0264,421,122,543,64,607,1157,52.46%,36.39%,1
苗栗縣,造橋鄉,0265,209,54,263,34,297,512,58.01%,40.82%,1
苗栗縣,造橋鄉,0266,224,61,285,25,310,491,63.14%,45.62%,1
苗栗縣,造橋鄉,0267,549,162,711,55,766,1272,60.22%,43.16%,1
苗栗縣,造橋鄉,0268,314,97,411,41,452,785,57.58%,40%,1
苗栗縣,造橋鄉,0269,389,148,537,89,626,962,65.07%,40.44%,1
苗栗縣,三灣鄉,0402,448,108,556,38,594,996,59.64%,44.98%,1
苗栗縣,三灣鄉,0403,475,145,620,70,690,1205,57.26%,39.42%,1
苗栗縣,三灣鄉,0404,261,90,351,36,387,635,60.94%,41.1%,1
苗栗縣,三灣鄉,0405,330,118,448,45,493,862,57.19%,38.28%,1
苗栗縣,三灣鄉,0406,87,19,106,12,118,238,49.58%,36.55%,1
苗栗縣,三灣鄉,0407,203,61,264,29,293,541,54.16%,37.52%,1
苗栗縣,三灣鄉,0408,200,65,265,33,298,578,51.56%,34.6%,1
苗栗縣,三灣鄉,0409,178,65,243,35,278,405,68.64%,43.95%,1
苗栗縣,三灣鄉,0410,153,45,198,24,222,392,56.63%,39.03%,1
苗栗縣,獅潭鄉,0435,102,17,119,8,127,328,38.72%,31.1%,1
苗栗縣,獅潭鄉,0436,157,53,210,38,248,565,43.89%,27.79%,1
苗栗縣,獅潭鄉,0437,357,99,456,68,524,911,57.52%,39.19%,1
苗栗縣,獅潭鄉,0438,186,62,248,19,267,568,47.01%,32.75%,1
苗栗縣,獅潭鄉,0439,249,59,308,33,341,580,58.79%,42.93%,1
苗栗縣,獅潭鄉,0440,136,24,160,6,166,333,49.85%,40.84%,1
苗栗縣,獅潭鄉,0441,257,56,313,32,345,683,50.51%,37.63%,1
苗栗縣,泰安鄉,0461,106,26,132,14,146,325,44.92%,32.62%,1
苗栗縣,泰安鄉,0462,195,73,268,17,285,484,58.88%,40.29%,1
苗栗縣,泰安鄉,0463,341,99,440,46,486,666,72.97%,51.2%,1
苗栗縣,泰安鄉,0464,268,78,346,43,389,574,67.77%,46.69%,1
苗栗縣,泰安鄉,0465,136,24,160,11,171,333,51.35%,40.84%,1
苗栗縣,泰安鄉,0466,265,58,323,12,335,495,67.68%,53.54%,1
苗栗縣,泰安鄉,0467,275,83,358,36,394,544,72.43%,50.55%,1
苗栗縣,泰安鄉,0468,159,57,216,20,236,500,47.2%,31.8%,1
苗栗縣,泰安鄉,0469,320,109,429,50,479,670,71.49%,47.76%,1
苗栗縣,泰安鄉,0470,360,81,441,5,446,589,75.72%,61.12%,1
彰化縣,彰化市,0001,362,123,485,36,521,871,59.82%,41.56%,1
彰化縣,彰化市,0002,252,70,322,40,362,751,48.2%,33.56%,1
彰化縣,彰化市,0003,334,230,564,44,608,923,65.87%,36.19%,1
彰化縣,彰化市,0004,312,115,427,54,481,779,61.75%,40.05%,1
彰化縣,彰化市,0005,324,111,435,45,480,779,61.62%,41.59%,1
彰化縣,彰化市,0006,272,117,389,30,419,720,58.19%,37.78%,1
彰化縣,彰化市,0007,298,112,410,37,447,749,59.68%,39.79%,1
彰化縣,彰化市,0008,359,94,453,50,503,767,65.58%,46.81%,1
彰化縣,彰化市,0009,438,152,590,62,652,1047,62.27%,41.83%,1
彰化縣,彰化市,0010,402,135,537,47,584,1027,56.86%,39.14%,1
彰化縣,彰化市,0011,488,148,636,74,710,1249,56.85%,39.07%,1
彰化縣,彰化市,0012,465,163,628,48,676,1136,59.51%,40.93%,1
彰化縣,彰化市,0013,515,150,665,59,724,1169,61.93%,44.05%,1
彰化縣,彰化市,0014,343,112,455,27,482,766,62.92%,44.78%,1
彰化縣,彰化市,0015,280,71,351,26,377,643,58.63%,43.55%,1
彰化縣,彰化市,0016,567,118,685,68,753,1251,60.19%,45.32%,1
彰化縣,彰化市,0017,340,125,465,40,505,1301,38.82%,26.13%,1
彰化縣,彰化市,0018,567,157,724,43,767,1280,59.92%,44.3%,1
彰化縣,彰化市,0019,510,168,678,46,724,1179,61.41%,43.26%,1
彰化縣,彰化市,0020,505,142,647,41,688,1168,58.9%,43.24%,1
彰化縣,彰化市,0021,522,149,671,55,726,1218,59.61%,42.86%,1
彰化縣,彰化市,0022,651,180,831,45,876,1351,64.84%,48.19%,1
彰化縣,彰化市,0023,519,202,721,34,755,1204,62.71%,43.11%,1
彰化縣,彰化市,0024,526,161,687,25,712,1189,59.88%,44.24%,1
彰化縣,彰化市,0025,502,150,652,58,710,1207,58.82%,41.59%,1
彰化縣,彰化市,0026,609,34,643,54,697,1161,60.03%,52.45%,1
彰化縣,彰化市,0027,432,176,608,44,652,1166,55.92%,37.05%,1
彰化縣,彰化市,0028,608,171,779,55,834,1362,61.23%,44.64%,1
彰化縣,彰化市,0029,524,202,726,44,770,1236,62.3%,42.39%,1
彰化縣,彰化市,0030,452,143,595,49,644,1065,60.47%,42.44%,1
彰化縣,彰化市,0031,498,160,658,63,721,1199,60.13%,41.53%,1
彰化縣,彰化市,0032,532,169,701,47,748,1233,60.67%,43.15%,1
彰化縣,彰化市,0033,536,146,682,39,721,1245,57.91%,43.05%,1
彰化縣,彰化市,0034,506,180,686,35,721,1153,62.53%,43.89%,1
彰化縣,彰化市,0035,421,128,549,44,593,1045,56.75%,40.29%,1
彰化縣,彰化市,0036,448,162,610,21,631,1097,57.52%,40.84%,1
彰化縣,彰化市,0037,475,156,631,61,692,1190,58.15%,39.92%,1
彰化縣,彰化市,0038,483,174,657,36,693,1106,62.66%,43.67%,1
彰化縣,彰化市,0039,481,139,620,42,662,1097,60.35%,43.85%,1
彰化縣,彰化市,0040,437,154,591,49,640,1048,61.07%,41.7%,1
彰化縣,彰化市,0041,432,139,571,44,615,980,62.76%,44.08%,1
彰化縣,彰化市,0042,310,113,423,25,448,707,63.37%,43.85%,1
彰化縣,彰化市,0043,336,110,446,43,489,809,60.44%,41.53%,1
彰化縣,彰化市,0044,420,155,575,56,631,1008,62.6%,41.67%,1
彰化縣,彰化市,0045,334,119,453,60,513,901,56.94%,37.07%,1
彰化縣,彰化市,0046,398,110,508,40,548,951,57.62%,41.85%,1
彰化縣,彰化市,0047,468,139,607,41,648,1076,60.22%,43.49%,1
彰化縣,彰化市,0048,378,145,523,40,563,1022,55.09%,36.99%,1
彰化縣,彰化市,0049,364,115,479,53,532,894,59.51%,40.72%,1
彰化縣,彰化市,0050,430,150,580,47,627,1016,61.71%,42.32%,1
彰化縣,彰化市,0051,311,140,451,44,495,771,64.2%,40.34%,1
彰化縣,彰化市,0052,353,133,486,48,534,868,61.52%,40.67%,1
彰化縣,彰化市,0053,450,154,604,85,689,1135,60.7%,39.65%,1
彰化縣,彰化市,0054,348,143,491,67,558,910,61.32%,38.24%,1
彰化縣,彰化市,0055,408,157,565,42,607,1004,60.46%,40.64%,1
彰化縣,彰化市,0056,479,139,618,52,670,1077,62.21%,44.48%,1
彰化縣,彰化市,0057,606,162,768,59,827,1258,65.74%,48.17%,1
彰化縣,彰化市,0058,486,121,607,44,651,1025,63.51%,47.41%,1
彰化縣,彰化市,0059,534,147,681,61,742,1177,63.04%,45.37%,1
彰化縣,彰化市,0060,516,138,654,62,716,1262,56.74%,40.89%,1
彰化縣,彰化市,0061,543,153,696,62,758,1209,62.7%,44.91%,1
彰化縣,彰化市,0062,465,153,618,42,660,1041,63.4%,44.67%,1
彰化縣,彰化市,0063,490,147,637,36,673,1075,62.6%,45.58%,1
彰化縣,彰化市,0064,428,97,525,65,590,1029,57.34%,41.59%,1
彰化縣,彰化市,0065,467,147,614,84,698,1203,58.02%,38.82%,1
彰化縣,彰化市,0066,418,122,540,45,585,1014,57.69%,41.22%,1
彰化縣,彰化市,0067,470,130,600,40,640,1069,59.87%,43.97%,1
彰化縣,彰化市,0068,350,117,467,30,497,969,51.29%,36.12%,1
彰化縣,彰化市,0069,423,129,552,40,592,1105,53.57%,38.28%,1
彰化縣,彰化市,0070,433,147,580,47,627,981,63.91%,44.14%,1
彰化縣,彰化市,0071,454,172,626,68,694,1095,63.38%,41.46%,1
彰化縣,彰化市,0072,488,154,642,27,669,1087,61.55%,44.89%,1
彰化縣,彰化市,0073,445,143,588,44,632,1050,60.19%,42.38%,1
彰化縣,彰化市,0074,539,182,721,53,774,1252,61.82%,43.05%,1
彰化縣,彰化市,0075,439,148,587,34,621,1113,55.8%,39.44%,1
彰化縣,彰化市,0076,467,134,601,32,633,1009,62.74%,46.28%,1
彰化縣,彰化市,0077,402,134,536,43,579,999,57.96%,40.24%,1
彰化縣,彰化市,0078,424,135,559,26,585,997,58.68%,42.53%,1
彰化縣,彰化市,0079,549,149,698,44,742,1145,64.8%,47.95%,1
彰化縣,彰化市,0080,504,186,690,26,716,1227,58.35%,41.08%,1
彰化縣,彰化市,0081,547,172,719,35,754,1208,62.42%,45.28%,1
彰化縣,彰化市,0082,699,186,885,42,927,1598,58.01%,43.74%,1
彰化縣,彰化市,0083,390,111,501,48,549,890,61.69%,43.82%,1
彰化縣,彰化市,0084,508,150,658,41,699,1104,63.32%,46.01%,1
彰化縣,彰化市,0085,472,132,604,26,630,1097,57.43%,43.03%,1
彰化縣,彰化市,0086,323,91,414,50,464,799,58.07%,40.43%,1
彰化縣,彰化市,0087,451,129,580,43,623,1000,62.3%,45.1%,1
彰化縣,彰化市,0088,455,140,595,81,676,1153,58.63%,39.46%,1
彰化縣,彰化市,0089,423,124,547,56,603,977,61.72%,43.3%,1
彰化縣,彰化市,0090,480,156,636,61,697,1201,58.03%,39.97%,1
彰化縣,彰化市,0091,425,186,611,50,661,1057,62.54%,40.21%,1
彰化縣,彰化市,0092,482,170,652,77,729,1238,58.89%,38.93%,1
彰化縣,彰化市,0093,542,163,705,43,748,1210,61.82%,44.79%,1
彰化縣,彰化市,0094,458,135,593,44,637,1026,62.09%,44.64%,1
彰化縣,彰化市,0095,509,140,649,47,696,1061,65.6%,47.97%,1
彰化縣,彰化市,0096,512,153,665,58,723,1213,59.6%,42.21%,1
彰化縣,彰化市,0097,568,158,726,43,769,1264,60.84%,44.94%,1
彰化縣,彰化市,0098,288,127,415,50,465,691,67.29%,41.68%,1
彰化縣,彰化市,0099,387,140,527,49,576,893,64.5%,43.34%,1
彰化縣,彰化市,0100,297,118,415,41,456,733,62.21%,40.52%,1
彰化縣,彰化市,0101,269,125,394,45,439,692,63.44%,38.87%,1
彰化縣,彰化市,0102,315,82,397,37,434,728,59.62%,43.27%,1
彰化縣,彰化市,0103,358,105,463,37,500,773,64.68%,46.31%,1
彰化縣,彰化市,0104,349,118,467,22,489,975,50.15%,35.79%,1
彰化縣,彰化市,0105,362,147,509,44,553,908,60.9%,39.87%,1
彰化縣,彰化市,0106,483,178,661,4,665,1156,57.53%,41.78%,1
彰化縣,彰化市,0107,518,176,694,64,758,1235,61.38%,41.94%,1
彰化縣,彰化市,0108,543,178,721,60,781,1376,56.76%,39.46%,1
彰化縣,彰化市,0109,572,167,739,50,789,1389,56.8%,41.18%,1
彰化縣,彰化市,0110,300,210,510,50,560,846,66.19%,35.46%,1
彰化縣,彰化市,0111,384,129,513,41,554,859,64.49%,44.7%,1
彰化縣,彰化市,0112,323,126,449,35,484,781,61.97%,41.36%,1
彰化縣,彰化市,0113,355,129,484,36,520,875,59.43%,40.57%,1
彰化縣,彰化市,0114,322,130,452,32,484,816,59.31%,39.46%,1
彰化縣,彰化市,0115,300,99,399,39,438,687,63.76%,43.67%,1
彰化縣,彰化市,0116,321,108,429,44,473,727,65.06%,44.15%,1
彰化縣,彰化市,0117,283,109,392,32,424,662,64.05%,42.75%,1
彰化縣,彰化市,0118,291,91,382,23,405,633,63.98%,45.97%,1
彰化縣,彰化市,0119,419,130,549,38,587,906,64.79%,46.25%,1
彰化縣,彰化市,0120,337,109,446,41,487,853,57.09%,39.51%,1
彰化縣,彰化市,0121,456,148,604,41,645,1027,62.8%,44.4%,1
彰化縣,彰化市,0122,446,146,592,44,636,993,64.05%,44.91%,1
彰化縣,彰化市,0123,342,127,469,53,522,848,61.56%,40.33%,1
彰化縣,彰化市,0124,518,149,667,32,699,1118,62.52%,46.33%,1
彰化縣,彰化市,0125,604,67,671,81,752,1263,59.54%,47.82%,1
彰化縣,彰化市,0126,596,151,747,48,795,1268,62.7%,47%,1
彰化縣,彰化市,0127,551,160,711,60,771,1258,61.29%,43.8%,1
彰化縣,彰化市,0128,547,161,708,40,748,1212,61.72%,45.13%,1
彰化縣,彰化市,0129,399,114,513,60,573,924,62.01%,43.18%,1
彰化縣,彰化市,0130,439,124,563,33,596,939,63.47%,46.75%,1
彰化縣,彰化市,0131,429,149,578,62,640,953,67.16%,45.02%,1
彰化縣,彰化市,0132,473,133,606,44,650,981,66.26%,48.22%,1
彰化縣,彰化市,0133,565,146,711,77,788,1249,63.09%,45.24%,1
彰化縣,彰化市,0134,329,117,446,64,510,817,62.42%,40.27%,1
彰化縣,彰化市,0135,370,107,477,55,532,872,61.01%,42.43%,1
彰化縣,彰化市,0136,281,91,372,32,404,689,58.64%,40.78%,1
彰化縣,彰化市,0137,552,131,683,43,726,1156,62.8%,47.75%,1
彰化縣,彰化市,0138,549,157,706,34,740,1291,57.32%,42.53%,1
彰化縣,彰化市,0139,491,128,619,40,659,1139,57.86%,43.11%,1
彰化縣,彰化市,0140,516,137,653,52,705,1125,62.67%,45.87%,1
彰化縣,彰化市,0141,535,139,674,52,726,1258,57.71%,42.53%,1
彰化縣,彰化市,0142,495,122,617,47,664,1123,59.13%,44.08%,1
彰化縣,彰化市,0143,500,148,648,51,699,1175,59.49%,42.55%,1
彰化縣,彰化市,0144,379,156,535,35,570,862,66.13%,43.97%,1
彰化縣,彰化市,0145,358,124,482,46,528,872,60.55%,41.06%,1
彰化縣,彰化市,0146,424,130,554,20,574,897,63.99%,47.27%,1
彰化縣,彰化市,0147,410,119,529,29,558,1003,55.63%,40.88%,1
彰化縣,彰化市,0148,366,114,480,26,506,915,55.3%,40%,1
彰化縣,彰化市,0149,472,150,622,46,668,1158,57.69%,40.76%,1
彰化縣,彰化市,0150,501,141,642,42,684,1084,63.1%,46.22%,1
彰化縣,彰化市,0151,632,76,708,68,776,1372,56.56%,46.06%,1
彰化縣,彰化市,0152,485,145,630,53,683,1113,61.37%,43.58%,1
彰化縣,彰化市,0153,366,100,466,41,507,800,63.38%,45.75%,1
彰化縣,彰化市,0154,345,130,475,54,529,885,59.77%,38.98%,1
彰化縣,彰化市,0155,459,120,579,26,605,1000,60.5%,45.9%,1
彰化縣,彰化市,0156,430,149,579,45,624,1159,53.84%,37.1%,1
彰化縣,彰化市,0157,482,121,603,36,639,1123,56.9%,42.92%,1
彰化縣,彰化市,0158,401,137,538,65,603,907,66.48%,44.21%,1
彰化縣,彰化市,0159,376,109,485,77,562,989,56.83%,38.02%,1
彰化縣,彰化市,0160,429,143,572,66,638,1012,63.04%,42.39%,1
彰化縣,彰化市,0161,394,124,518,31,549,1033,53.15%,38.14%,1
彰化縣,彰化市,0162,503,136,639,43,682,1116,61.11%,45.07%,1
彰化縣,彰化市,0163,539,142,681,31,712,1154,61.7%,46.71%,1
彰化縣,彰化市,0164,491,112,603,39,642,1064,60.34%,46.15%,1
彰化縣,彰化市,0165,331,119,450,52,502,770,65.19%,42.99%,1
彰化縣,彰化市,0166,379,142,521,36,557,889,62.65%,42.63%,1
彰化縣,彰化市,0167,337,106,443,57,500,786,63.61%,42.88%,1
彰化縣,彰化市,0168,404,158,562,57,619,1120,55.27%,36.07%,1
彰化縣,彰化市,0169,494,141,635,38,673,1269,53.03%,38.93%,1
彰化縣,彰化市,0170,495,157,652,54,706,1159,60.91%,42.71%,1
彰化縣,彰化市,0171,499,168,667,60,727,1184,61.4%,42.15%,1
彰化縣,彰化市,0172,449,144,593,42,635,1089,58.31%,41.23%,1
彰化縣,彰化市,0173,416,135,551,53,604,968,62.4%,42.98%,1
彰化縣,彰化市,0174,413,95,508,36,544,930,58.49%,44.41%,1
彰化縣,彰化市,0175,424,121,545,44,589,973,60.53%,43.58%,1
彰化縣,彰化市,0176,437,135,572,36,608,1184,51.35%,36.91%,1
彰化縣,彰化市,0177,423,132,555,58,613,1002,61.18%,42.22%,1
彰化縣,彰化市,0178,496,115,611,27,638,1148,55.57%,43.21%,1
彰化縣,彰化市,0179,466,135,601,45,646,1112,58.09%,41.91%,1
彰化縣,彰化市,0180,445,122,567,53,620,907,68.36%,49.06%,1
彰化縣,彰化市,0181,488,119,607,71,678,1112,60.97%,43.88%,1
彰化縣,彰化市,0182,301,81,382,42,424,823,51.52%,36.57%,1
彰化縣,彰化市,0183,543,131,674,70,744,1276,58.31%,42.55%,1
彰化縣,彰化市,0184,461,143,604,58,662,1161,57.02%,39.71%,1
彰化縣,鹿港鎮,0243,470,179,649,60,709,1140,62.19%,41.23%,1
彰化縣,鹿港鎮,0244,198,73,271,33,304,511,59.49%,38.75%,1
彰化縣,鹿港鎮,0245,285,83,368,30,398,857,46.44%,33.26%,1
彰化縣,鹿港鎮,0246,407,138,545,59,604,946,63.85%,43.02%,1
彰化縣,鹿港鎮,0247,392,121,513,48,561,945,59.37%,41.48%,1
彰化縣,鹿港鎮,0248,455,126,581,60,641,1097,58.43%,41.48%,1
彰化縣,鹿港鎮,0249,535,134,669,41,710,1479,48.01%,36.17%,1
彰化縣,鹿港鎮,0250,567,207,774,83,857,1425,60.14%,39.79%,1
彰化縣,鹿港鎮,0251,352,119,471,86,557,880,63.3%,40%,1
彰化縣,鹿港鎮,0252,437,144,581,77,658,1183,55.62%,36.94%,1
彰化縣,鹿港鎮,0253,426,131,557,80,637,1047,60.84%,40.69%,1
彰化縣,鹿港鎮,0254,403,133,536,30,566,1097,51.6%,36.74%,1
彰化縣,鹿港鎮,0255,402,124,526,67,593,1030,57.57%,39.03%,1
彰化縣,鹿港鎮,0256,478,134,612,54,666,1161,57.36%,41.17%,1
彰化縣,鹿港鎮,0257,210,74,284,56,340,540,62.96%,38.89%,1
彰化縣,鹿港鎮,0258,438,153,591,53,644,1135,56.74%,38.59%,1
彰化縣,鹿港鎮,0259,446,153,599,67,666,1155,57.66%,38.61%,1
彰化縣,鹿港鎮,0260,498,150,648,48,696,1127,61.76%,44.19%,1
彰化縣,鹿港鎮,0261,426,138,564,60,624,1045,59.71%,40.77%,1
彰化縣,鹿港鎮,0262,426,159,585,81,666,1127,59.09%,37.8%,1
彰化縣,鹿港鎮,0263,524,160,684,75,759,1178,64.43%,44.48%,1
彰化縣,鹿港鎮,0264,115,38,153,16,169,284,59.51%,40.49%,1
彰化縣,鹿港鎮,0265,222,85,307,38,345,584,59.08%,38.01%,1
彰化縣,鹿港鎮,0266,299,93,392,41,433,659,65.71%,45.37%,1
彰化縣,鹿港鎮,0267,347,114,461,23,484,915,52.9%,37.92%,1
彰化縣,鹿港鎮,0268,457,153,610,66,676,1079,62.65%,42.35%,1
彰化縣,鹿港鎮,0269,501,150,651,79,730,1129,64.66%,44.38%,1
彰化縣,鹿港鎮,0270,499,142,641,62,703,1273,55.22%,39.2%,1
彰化縣,鹿港鎮,0271,273,65,338,36,374,706,52.97%,38.67%,1
彰化縣,鹿港鎮,0272,431,107,538,92,630,1137,55.41%,37.91%,1
彰化縣,鹿港鎮,0273,478,130,608,54,662,1195,55.4%,40%,1
彰化縣,鹿港鎮,0274,486,119,605,57,662,1225,54.04%,39.67%,1
彰化縣,鹿港鎮,0275,427,135,562,68,630,957,65.83%,44.62%,1
彰化縣,鹿港鎮,0276,256,74,330,70,400,758,52.77%,33.77%,1
彰化縣,鹿港鎮,0277,293,80,373,57,430,723,59.47%,40.53%,1
彰化縣,鹿港鎮,0278,403,94,497,39,536,984,54.47%,40.96%,1
彰化縣,鹿港鎮,0279,471,113,584,60,644,1018,63.26%,46.27%,1
彰化縣,鹿港鎮,0280,458,131,589,56,645,1165,55.36%,39.31%,1
彰化縣,鹿港鎮,0281,432,128,560,54,614,1161,52.89%,37.21%,1
彰化縣,鹿港鎮,0282,405,102,507,46,553,1020,54.22%,39.71%,1
彰化縣,鹿港鎮,0283,404,138,542,73,615,1068,57.58%,37.83%,1
彰化縣,鹿港鎮,0284,437,124,561,41,602,1024,58.79%,42.68%,1
彰化縣,鹿港鎮,0285,390,121,511,88,599,974,61.5%,40.04%,1
彰化縣,鹿港鎮,0286,555,168,723,91,814,1505,54.09%,36.88%,1
彰化縣,鹿港鎮,0287,425,130,555,46,601,1092,55.04%,38.92%,1
彰化縣,鹿港鎮,0288,518,148,666,76,742,1223,60.67%,42.35%,1
彰化縣,鹿港鎮,0289,559,131,690,48,738,1572,46.95%,35.56%,1
彰化縣,鹿港鎮,0290,448,113,561,57,618,1003,61.62%,44.67%,1
彰化縣,鹿港鎮,0291,414,104,518,37,555,933,59.49%,44.37%,1
彰化縣,鹿港鎮,0292,469,132,601,62,663,1093,60.66%,42.91%,1
彰化縣,鹿港鎮,0293,364,114,478,27,505,907,55.68%,40.13%,1
彰化縣,鹿港鎮,0294,459,165,624,47,671,1219,55.05%,37.65%,1
彰化縣,鹿港鎮,0295,643,159,802,83,885,1397,63.35%,46.03%,1
彰化縣,鹿港鎮,0296,516,138,654,41,695,1229,56.55%,41.99%,1
彰化縣,鹿港鎮,0297,592,145,737,44,781,1444,54.09%,41%,1
彰化縣,鹿港鎮,0298,491,172,663,73,736,1227,59.98%,40.02%,1
彰化縣,鹿港鎮,0299,477,177,654,67,721,1187,60.74%,40.19%,1
彰化縣,鹿港鎮,0300,527,128,655,27,682,1296,52.62%,40.66%,1
彰化縣,鹿港鎮,0301,497,180,677,81,758,1451,52.24%,34.25%,1
彰化縣,鹿港鎮,0302,481,179,660,77,737,1299,56.74%,37.03%,1
彰化縣,鹿港鎮,0303,600,158,758,45,803,1298,61.86%,46.22%,1
彰化縣,鹿港鎮,0304,601,178,779,63,842,1458,57.75%,41.22%,1
彰化縣,鹿港鎮,0305,462,151,613,57,670,1138,58.88%,40.6%,1
彰化縣,鹿港鎮,0306,476,141,617,65,682,1170,58.29%,40.68%,1
彰化縣,鹿港鎮,0307,526,151,677,64,741,1221,60.69%,43.08%,1
彰化縣,和美鎮,0373,491,182,673,62,735,1341,54.81%,36.61%,1
彰化縣,和美鎮,0374,557,145,702,67,769,1480,51.96%,37.64%,1
彰化縣,和美鎮,0375,636,178,814,45,859,1529,56.18%,41.6%,1
彰化縣,和美鎮,0376,660,150,810,29,839,1711,49.04%,38.57%,1
彰化縣,和美鎮,0377,433,141,574,40,614,1057,58.09%,40.96%,1
彰化縣,和美鎮,0378,439,135,574,41,615,1032,59.59%,42.54%,1
彰化縣,和美鎮,0379,426,123,549,70,619,1015,60.99%,41.97%,1
彰化縣,和美鎮,0380,505,179,684,47,731,1209,60.46%,41.77%,1
彰化縣,和美鎮,0381,165,66,231,20,251,430,58.37%,38.37%,1
彰化縣,和美鎮,0382,332,113,445,19,464,856,54.21%,38.79%,1
彰化縣,和美鎮,0383,444,97,541,26,567,966,58.7%,45.96%,1
彰化縣,和美鎮,0384,407,147,554,24,578,1059,54.58%,38.43%,1
彰化縣,和美鎮,0385,436,159,595,43,638,1117,57.12%,39.03%,1
彰化縣,和美鎮,0386,416,137,553,41,594,1066,55.72%,39.02%,1
彰化縣,和美鎮,0387,462,162,624,46,670,1252,53.51%,36.9%,1
彰化縣,和美鎮,0388,588,164,752,53,805,1528,52.68%,38.48%,1
彰化縣,和美鎮,0389,347,113,460,36,496,826,60.05%,42.01%,1
彰化縣,和美鎮,0390,357,94,451,30,481,854,56.32%,41.8%,1
彰化縣,和美鎮,0391,559,118,677,63,740,1387,53.35%,40.3%,1
彰化縣,和美鎮,0392,334,111,445,32,477,765,62.35%,43.66%,1
彰化縣,和美鎮,0393,564,130,694,56,750,1438,52.16%,39.22%,1
彰化縣,和美鎮,0394,607,154,761,69,830,1396,59.46%,43.48%,1
彰化縣,和美鎮,0395,273,78,351,28,379,658,57.6%,41.49%,1
彰化縣,和美鎮,0396,383,98,481,34,515,809,63.66%,47.34%,1
彰化縣,和美鎮,0397,353,112,465,16,481,932,51.61%,37.88%,1
彰化縣,和美鎮,0398,360,93,453,34,487,888,54.84%,40.54%,1
彰化縣,和美鎮,0399,483,168,651,49,700,1144,61.19%,42.22%,1
彰化縣,和美鎮,0400,456,105,561,48,609,1077,56.55%,42.34%,1
彰化縣,和美鎮,0401,502,146,648,61,709,1349,52.56%,37.21%,1
彰化縣,和美鎮,0402,509,160,669,51,720,1155,62.34%,44.07%,1
彰化縣,和美鎮,0403,525,137,662,34,696,1253,55.55%,41.9%,1
彰化縣,和美鎮,0404,514,122,636,47,683,1252,54.55%,41.05%,1
彰化縣,和美鎮,0405,584,165,749,30,779,1474,52.85%,39.62%,1
彰化縣,和美鎮,0406,516,129,645,39,684,1396,49%,36.96%,1
彰化縣,和美鎮,0407,554,125,679,47,726,1348,53.86%,41.1%,1
彰化縣,和美鎮,0408,458,122,580,40,620,999,62.06%,45.85%,1
彰化縣,和美鎮,0409,367,132,499,52,551,911,60.48%,40.29%,1
彰化縣,和美鎮,0410,395,161,556,33,589,1005,58.61%,39.3%,1
彰化縣,和美鎮,0411,395,122,517,44,561,967,58.01%,40.85%,1
彰化縣,和美鎮,0412,536,174,710,51,761,1308,58.18%,40.98%,1
彰化縣,和美鎮,0413,539,160,699,47,746,1324,56.34%,40.71%,1
彰化縣,和美鎮,0414,419,173,592,64,656,1102,59.53%,38.02%,1
彰化縣,和美鎮,0415,425,141,566,52,618,1124,54.98%,37.81%,1
彰化縣,和美鎮,0416,444,199,643,59,702,1211,57.97%,36.66%,1
彰化縣,和美鎮,0417,403,148,551,42,593,884,67.08%,45.59%,1
彰化縣,和美鎮,0418,421,156,577,74,651,1119,58.18%,37.62%,1
彰化縣,和美鎮,0419,517,158,675,62,737,1300,56.69%,39.77%,1
彰化縣,和美鎮,0420,434,126,560,47,607,1104,54.98%,39.31%,1
彰化縣,和美鎮,0421,628,73,701,37,738,1213,60.84%,51.77%,1
彰化縣,和美鎮,0422,398,131,529,48,577,1127,51.2%,35.31%,1
彰化縣,和美鎮,0423,358,107,465,57,522,919,56.8%,38.96%,1
彰化縣,和美鎮,0424,418,128,546,49,595,987,60.28%,42.35%,1
彰化縣,和美鎮,0425,406,137,543,48,591,958,61.69%,42.38%,1
彰化縣,和美鎮,0426,574,168,742,47,789,1362,57.93%,42.14%,1
彰化縣,和美鎮,0427,611,152,763,30,793,1461,54.28%,41.82%,1
彰化縣,和美鎮,0428,601,172,773,34,807,1405,57.44%,42.78%,1
彰化縣,和美鎮,0429,370,106,476,45,521,860,60.58%,43.02%,1
彰化縣,和美鎮,0430,366,84,450,20,470,875,53.71%,41.83%,1
彰化縣,和美鎮,0431,349,109,458,44,502,871,57.63%,40.07%,1
彰化縣,和美鎮,0432,386,119,505,45,550,883,62.29%,43.71%,1
彰化縣,和美鎮,0433,439,176,615,58,673,1224,54.98%,35.87%,1
彰化縣,和美鎮,0434,420,134,554,43,597,1075,55.53%,39.07%,1
彰化縣,和美鎮,0435,375,125,500,41,541,956,56.59%,39.23%,1
彰化縣,和美鎮,0436,396,124,520,57,577,1037,55.64%,38.19%,1
彰化縣,和美鎮,0437,420,110,530,25,555,1011,54.9%,41.54%,1
彰化縣,和美鎮,0438,376,138,514,57,571,1023,55.82%,36.75%,1
彰化縣,和美鎮,0439,281,83,364,27,391,719,54.38%,39.08%,1
彰化縣,和美鎮,0440,346,126,472,45,517,913,56.63%,37.9%,1
彰化縣,線西鄉,0469,456,117,573,34,607,1071,56.68%,42.58%,1
彰化縣,線西鄉,0470,520,129,649,43,692,1166,59.35%,44.6%,1
彰化縣,線西鄉,0471,504,173,677,75,752,1269,59.26%,39.72%,1
彰化縣,線西鄉,0472,457,136,593,60,653,1138,57.38%,40.16%,1
彰化縣,線西鄉,0473,499,145,644,75,719,1128,63.74%,44.24%,1
彰化縣,線西鄉,0474,524,159,683,83,766,1275,60.08%,41.1%,1
彰化縣,線西鄉,0475,500,149,649,58,707,1187,59.56%,42.12%,1
彰化縣,線西鄉,0476,415,132,547,57,604,991,60.95%,41.88%,1
彰化縣,線西鄉,0477,375,128,503,58,561,938,59.81%,39.98%,1
彰化縣,線西鄉,0478,479,137,616,63,679,1276,53.21%,37.54%,1
彰化縣,線西鄉,0479,551,142,693,63,756,1285,58.83%,42.88%,1
彰化縣,線西鄉,0480,627,176,803,77,880,1341,65.62%,46.76%,1
彰化縣,伸港鄉,0441,461,89,550,44,594,1182,50.25%,39%,1
彰化縣,伸港鄉,0442,555,115,670,47,717,1166,61.49%,47.6%,1
彰化縣,伸港鄉,0443,401,106,507,51,558,966,57.76%,41.51%,1
彰化縣,伸港鄉,0444,349,96,445,42,487,873,55.78%,39.98%,1
彰化縣,伸港鄉,0445,336,103,439,50,489,812,60.22%,41.38%,1
彰化縣,伸港鄉,0446,365,90,455,37,492,875,56.23%,41.71%,1
彰化縣,伸港鄉,0447,349,106,455,48,503,904,55.64%,38.61%,1
彰化縣,伸港鄉,0448,404,113,517,43,560,1008,55.56%,40.08%,1
彰化縣,伸港鄉,0449,480,140,620,63,683,1154,59.19%,41.59%,1
彰化縣,伸港鄉,0450,546,161,707,77,784,1486,52.76%,36.74%,1
彰化縣,伸港鄉,0451,438,118,556,52,608,1095,55.53%,40%,1
彰化縣,伸港鄉,0452,399,130,529,28,557,1087,51.24%,36.71%,1
彰化縣,伸港鄉,0453,450,138,588,58,646,1085,59.54%,41.47%,1
彰化縣,伸港鄉,0454,398,100,498,45,543,908,59.8%,43.83%,1
彰化縣,伸港鄉,0455,586,129,715,44,759,1264,60.05%,46.36%,1
彰化縣,伸港鄉,0456,319,94,413,57,470,854,55.04%,37.35%,1
彰化縣,伸港鄉,0457,304,89,393,33,426,846,50.35%,35.93%,1
彰化縣,伸港鄉,0458,388,117,505,104,609,1143,53.28%,33.95%,1
彰化縣,伸港鄉,0459,557,155,712,38,750,1357,55.27%,41.05%,1
彰化縣,伸港鄉,0460,503,180,683,62,745,1349,55.23%,37.29%,1
彰化縣,伸港鄉,0461,478,143,621,55,676,1154,58.58%,41.42%,1
彰化縣,伸港鄉,0462,498,153,651,44,695,1279,54.34%,38.94%,1
彰化縣,伸港鄉,0463,657,53,710,64,774,1317,58.77%,49.89%,1
彰化縣,伸港鄉,0464,419,137,556,48,604,990,61.01%,42.32%,1
彰化縣,伸港鄉,0465,381,90,471,32,503,852,59.04%,44.72%,1
彰化縣,伸港鄉,0466,502,142,644,31,675,1178,57.3%,42.61%,1
彰化縣,伸港鄉,0467,418,108,526,74,600,1088,55.15%,38.42%,1
彰化縣,伸港鄉,0468,444,139,583,63,646,1135,56.92%,39.12%,1
彰化縣,福興鄉,0308,472,197,669,74,743,1363,54.51%,34.63%,1
彰化縣,福興鄉,0309,338,100,438,35,473,821,57.61%,41.17%,1
彰化縣,福興鄉,0310,463,128,591,66,657,1256,52.31%,36.86%,1
彰化縣,福興鄉,0311,396,132,528,107,635,1166,54.46%,33.96%,1
彰化縣,福興鄉,0312,545,162,707,59,766,1464,52.32%,37.23%,1
彰化縣,福興鄉,0313,459,142,601,58,659,1251,52.68%,36.69%,1
彰化縣,福興鄉,0314,550,155,705,69,774,1465,52.83%,37.54%,1
彰化縣,福興鄉,0315,333,102,435,34,469,960,48.85%,34.69%,1
彰化縣,福興鄉,0316,457,168,625,89,714,1323,53.97%,34.54%,1
彰化縣,福興鄉,0317,599,86,685,68,753,1365,55.16%,43.88%,1
彰化縣,福興鄉,0318,459,147,606,40,646,1458,44.31%,31.48%,1
彰化縣,福興鄉,0319,602,85,687,101,788,1492,52.82%,40.35%,1
彰化縣,福興鄉,0320,299,93,392,32,424,888,47.75%,33.67%,1
彰化縣,福興鄉,0321,436,131,567,62,629,1054,59.68%,41.37%,1
彰化縣,福興鄉,0322,363,108,471,50,521,1043,49.95%,34.8%,1
彰化縣,福興鄉,0323,485,176,661,78,739,1340,55.15%,36.19%,1
彰化縣,福興鄉,0324,387,119,506,44,550,1085,50.69%,35.67%,1
彰化縣,福興鄉,0325,498,150,648,52,700,1392,50.29%,35.78%,1
彰化縣,福興鄉,0326,557,126,683,91,774,1316,58.81%,42.33%,1
彰化縣,福興鄉,0327,514,180,694,63,757,1255,60.32%,40.96%,1
彰化縣,福興鄉,0328,485,136,621,51,672,1101,61.04%,44.05%,1
彰化縣,福興鄉,0329,471,100,571,85,656,1167,56.21%,40.36%,1
彰化縣,福興鄉,0330,487,159,646,83,729,1393,52.33%,34.96%,1
彰化縣,福興鄉,0331,485,143,628,64,692,1216,56.91%,39.88%,1
彰化縣,福興鄉,0332,365,114,479,52,531,1063,49.95%,34.34%,1
彰化縣,福興鄉,0333,484,149,633,74,707,1306,54.13%,37.06%,1
彰化縣,福興鄉,0334,387,141,528,62,590,1287,45.84%,30.07%,1
彰化縣,福興鄉,0335,385,123,508,50,558,994,56.14%,38.73%,1
彰化縣,福興鄉,0336,516,148,664,77,741,1311,56.52%,39.36%,1
彰化縣,福興鄉,0337,379,124,503,46,549,926,59.29%,40.93%,1
彰化縣,福興鄉,0338,342,126,468,51,519,995,52.16%,34.37%,1
彰化縣,福興鄉,0339,443,138,581,88,669,1079,62%,41.06%,1
彰化縣,福興鄉,0340,394,119,513,92,605,1150,52.61%,34.26%,1
彰化縣,秀水鄉,0341,446,140,586,81,667,1066,62.57%,41.84%,1
彰化縣,秀水鄉,0342,259,93,352,45,397,620,64.03%,41.77%,1
彰化縣,秀水鄉,0343,322,103,425,16,441,876,50.34%,36.76%,1
彰化縣,秀水鄉,0344,494,188,682,55,737,1196,61.62%,41.3%,1
彰化縣,秀水鄉,0345,557,178,735,55,790,1369,57.71%,40.69%,1
彰化縣,秀水鄉,0346,520,171,691,65,756,1273,59.39%,40.85%,1
彰化縣,秀水鄉,0347,572,172,744,62,806,1433,56.25%,39.92%,1
彰化縣,秀水鄉,0348,409,137,546,24,570,967,58.95%,42.3%,1
彰化縣,秀水鄉,0349,404,109,513,21,534,921,57.98%,43.87%,1
彰化縣,秀水鄉,0350,315,81,396,37,433,689,62.84%,45.72%,1
彰化縣,秀水鄉,0351,281,97,378,43,421,688,61.19%,40.84%,1
彰化縣,秀水鄉,0352,553,177,730,51,781,1252,62.38%,44.17%,1
彰化縣,秀水鄉,0353,502,144,646,37,683,1281,53.32%,39.19%,1
彰化縣,秀水鄉,0354,302,85,387,30,417,754,55.31%,40.05%,1
彰化縣,秀水鄉,0355,403,127,530,52,582,1024,56.84%,39.36%,1
彰化縣,秀水鄉,0356,597,138,735,28,763,1433,53.24%,41.66%,1
彰化縣,秀水鄉,0357,611,209,820,54,874,1366,63.98%,44.73%,1
彰化縣,秀水鄉,0358,357,129,486,58,544,895,60.78%,39.89%,1
彰化縣,秀水鄉,0359,522,152,674,80,754,1386,54.4%,37.66%,1
彰化縣,秀水鄉,0360,350,127,477,67,544,896,60.71%,39.06%,1
彰化縣,秀水鄉,0361,368,121,489,40,529,804,65.8%,45.77%,1
彰化縣,秀水鄉,0362,380,104,484,33,517,827,62.52%,45.95%,1
彰化縣,秀水鄉,0363,436,109,545,48,593,996,59.54%,43.78%,1
彰化縣,秀水鄉,0364,442,121,563,54,617,931,66.27%,47.48%,1
彰化縣,秀水鄉,0365,281,88,369,35,404,715,56.5%,39.3%,1
彰化縣,秀水鄉,0366,545,172,717,50,767,1229,62.41%,44.34%,1
彰化縣,秀水鄉,0367,328,97,425,34,459,890,51.57%,36.85%,1
彰化縣,秀水鄉,0368,350,105,455,54,509,811,62.76%,43.16%,1
彰化縣,秀水鄉,0369,332,115,447,39,486,786,61.83%,42.24%,1
彰化縣,秀水鄉,0370,304,199,503,39,542,931,58.22%,32.65%,1
彰化縣,秀水鄉,0371,523,160,683,85,768,1265,60.71%,41.34%,1
彰化縣,秀水鄉,0372,346,73,419,44,463,824,56.19%,41.99%,1
彰化縣,花壇鄉,0185,371,120,491,50,541,901,60.04%,41.18%,1
彰化縣,花壇鄉,0186,335,131,466,48,514,1042,49.33%,32.15%,1
彰化縣,花壇鄉,0187,514,142,656,28,684,1314,52.05%,39.12%,1
彰化縣,花壇鄉,0188,315,113,428,59,487,808,60.27%,38.99%,1
彰化縣,花壇鄉,0189,400,134,534,53,587,1019,57.61%,39.25%,1
彰化縣,花壇鄉,0190,454,155,609,91,700,1144,61.19%,39.69%,1
彰化縣,花壇鄉,0191,486,116,602,125,727,1240,58.63%,39.19%,1
彰化縣,花壇鄉,0192,615,164,779,100,879,1425,61.68%,43.16%,1
彰化縣,花壇鄉,0193,479,163,642,84,726,1095,66.3%,43.74%,1
彰化縣,花壇鄉,0194,380,122,502,43,545,910,59.89%,41.76%,1
彰化縣,花壇鄉,0195,416,127,543,36,579,982,58.96%,42.36%,1
彰化縣,花壇鄉,0196,390,154,544,23,567,1070,52.99%,36.45%,1
彰化縣,花壇鄉,0197,277,71,348,22,370,700,52.86%,39.57%,1
彰化縣,花壇鄉,0198,349,100,449,51,500,764,65.45%,45.68%,1
彰化縣,花壇鄉,0199,127,421,548,55,603,953,63.27%,13.33%,1
彰化縣,花壇鄉,0200,403,118,521,34,555,974,56.98%,41.38%,1
彰化縣,花壇鄉,0201,438,143,581,66,647,1111,58.24%,39.42%,1
彰化縣,花壇鄉,0202,483,112,595,73,668,1101,60.67%,43.87%,1
彰化縣,花壇鄉,0203,425,122,547,59,606,1110,54.59%,38.29%,1
彰化縣,花壇鄉,0204,518,147,665,60,725,1262,57.45%,41.05%,1
彰化縣,花壇鄉,0205,450,170,620,29,649,1103,58.84%,40.8%,1
彰化縣,花壇鄉,0206,470,151,621,76,697,1347,51.74%,34.89%,1
彰化縣,花壇鄉,0207,443,120,563,71,634,1169,54.23%,37.9%,1
彰化縣,花壇鄉,0208,542,158,700,64,764,1274,59.97%,42.54%,1
彰化縣,花壇鄉,0209,582,149,731,60,791,1280,61.8%,45.47%,1
彰化縣,花壇鄉,0210,533,142,675,46,721,1244,57.96%,42.85%,1
彰化縣,花壇鄉,0211,451,159,610,70,680,1159,58.67%,38.91%,1
彰化縣,花壇鄉,0212,493,114,607,46,653,1042,62.67%,47.31%,1
彰化縣,花壇鄉,0213,436,134,570,50,620,1111,55.81%,39.24%,1
彰化縣,花壇鄉,0214,395,120,515,52,567,893,63.49%,44.23%,1
彰化縣,花壇鄉,0215,372,131,503,62,565,953,59.29%,39.03%,1
彰化縣,花壇鄉,0216,377,59,436,35,471,987,47.72%,38.2%,1
彰化縣,花壇鄉,0217,405,135,540,58,598,925,64.65%,43.78%,1
彰化縣,花壇鄉,0218,389,106,495,29,524,951,55.1%,40.9%,1
彰化縣,花壇鄉,0219,397,116,513,31,544,955,56.96%,41.57%,1
彰化縣,花壇鄉,0220,354,103,457,29,486,895,54.3%,39.55%,1
彰化縣,花壇鄉,0221,294,84,378,30,408,711,57.38%,41.35%,1
彰化縣,芬園鄉,0222,396,93,489,45,534,958,55.74%,41.34%,1
彰化縣,芬園鄉,0223,304,94,398,56,454,794,57.18%,38.29%,1
彰化縣,芬園鄉,0224,493,155,648,98,746,1415,52.72%,34.84%,1
彰化縣,芬園鄉,0225,401,130,531,45,576,927,62.14%,43.26%,1
彰化縣,芬園鄉,0226,345,83,428,46,474,831,57.04%,41.52%,1
彰化縣,芬園鄉,0227,239,61,300,19,319,570,55.96%,41.93%,1
彰化縣,芬園鄉,0228,449,127,576,57,633,1227,51.59%,36.59%,1
彰化縣,芬園鄉,0229,482,125,607,75,682,1238,55.09%,38.93%,1
彰化縣,芬園鄉,0230,515,190,705,80,785,1362,57.64%,37.81%,1
彰化縣,芬園鄉,0231,399,116,515,66,581,989,58.75%,40.34%,1
彰化縣,芬園鄉,0232,474,124,598,67,665,1054,63.09%,44.97%,1
彰化縣,芬園鄉,0233,292,75,367,30,397,607,65.4%,48.11%,1
彰化縣,芬園鄉,0234,385,102,487,49,536,882,60.77%,43.65%,1
彰化縣,芬園鄉,0235,399,110,509,52,561,1143,49.08%,34.91%,1
彰化縣,芬園鄉,0236,222,53,275,25,300,661,45.39%,33.59%,1
彰化縣,芬園鄉,0237,294,101,395,6,401,838,47.85%,35.08%,1
彰化縣,芬園鄉,0238,290,113,403,39,442,847,52.18%,34.24%,1
彰化縣,芬園鄉,0239,401,116,517,75,592,987,59.98%,40.63%,1
彰化縣,芬園鄉,0240,397,145,542,83,625,1217,51.36%,32.62%,1
彰化縣,芬園鄉,0241,260,94,354,83,437,865,50.52%,30.06%,1
彰化縣,芬園鄉,0242,355,109,464,51,515,996,51.71%,35.64%,1
彰化縣,員林市,0481,443,91,534,25,559,1087,51.43%,40.75%,1
彰化縣,員林市,0482,501,163,664,36,700,1353,51.74%,37.03%,1
彰化縣,員林市,0483,495,142,637,57,694,1313,52.86%,37.7%,1
彰化縣,員林市,0484,443,129,572,27,599,1328,45.11%,33.36%,1
彰化縣,員林市,0485,411,152,563,34,597,1055,56.59%,38.96%,1
彰化縣,員林市,0486,385,92,477,44,521,959,54.33%,40.15%,1
彰化縣,員林市,0487,315,93,408,43,451,772,58.42%,40.8%,1
彰化縣,員林市,0488,359,107,466,44,510,831,61.37%,43.2%,1
彰化縣,員林市,0489,253,76,329,15,344,854,40.28%,29.63%,1
彰化縣,員林市,0490,378,117,495,38,533,1190,44.79%,31.76%,1
彰化縣,員林市,0491,306,73,379,20,399,726,54.96%,42.15%,1
彰化縣,員林市,0492,429,136,565,65,630,1124,56.05%,38.17%,1
彰化縣,員林市,0493,293,92,385,62,447,860,51.98%,34.07%,1
彰化縣,員林市,0494,480,138,618,58,676,1122,60.25%,42.78%,1
彰化縣,員林市,0495,440,148,588,50,638,1075,59.35%,40.93%,1
彰化縣,員林市,0496,357,125,482,69,551,993,55.49%,35.95%,1
彰化縣,員林市,0497,362,112,474,31,505,967,52.22%,37.44%,1
彰化縣,員林市,0498,371,143,514,63,577,1008,57.24%,36.81%,1
彰化縣,員林市,0499,298,107,405,49,454,804,56.47%,37.06%,1
彰化縣,員林市,0500,340,112,452,32,484,867,55.82%,39.22%,1
彰化縣,員林市,0501,345,92,437,30,467,885,52.77%,38.98%,1
彰化縣,員林市,0502,367,85,452,18,470,1097,42.84%,33.45%,1
彰化縣,員林市,0503,493,136,629,33,662,1255,52.75%,39.28%,1
彰化縣,員林市,0504,427,145,572,48,620,1063,58.33%,40.17%,1
彰化縣,員林市,0505,308,176,484,33,517,925,55.89%,33.3%,1
彰化縣,員林市,0506,370,138,508,49,557,947,58.82%,39.07%,1
彰化縣,員林市,0507,385,129,514,31,545,916,59.5%,42.03%,1
彰化縣,員林市,0508,349,95,444,34,478,862,55.45%,40.49%,1
彰化縣,員林市,0509,411,123,534,24,558,987,56.53%,41.64%,1
彰化縣,員林市,0510,422,128,550,47,597,1085,55.02%,38.89%,1
彰化縣,員林市,0511,473,136,609,29,638,1110,57.48%,42.61%,1
彰化縣,員林市,0512,408,127,535,24,559,1095,51.05%,37.26%,1
彰化縣,員林市,0513,613,130,743,38,781,1278,61.11%,47.97%,1
彰化縣,員林市,0514,494,115,609,44,653,1109,58.88%,44.54%,1
彰化縣,員林市,0515,404,137,541,61,602,1055,57.06%,38.29%,1
彰化縣,員林市,0516,380,122,502,32,534,876,60.96%,43.38%,1
彰化縣,員林市,0517,379,133,512,44,556,1115,49.87%,33.99%,1
彰化縣,員林市,0518,513,128,641,48,689,1186,58.09%,43.25%,1
彰化縣,員林市,0519,449,107,556,44,600,995,60.3%,45.13%,1
彰化縣,員林市,0520,397,108,505,12,517,999,51.75%,39.74%,1
彰化縣,員林市,0521,472,145,617,41,658,1201,54.79%,39.3%,1
彰化縣,員林市,0522,555,140,695,35,730,1342,54.4%,41.36%,1
彰化縣,員林市,0523,405,139,544,32,576,1086,53.04%,37.29%,1
彰化縣,員林市,0524,326,98,424,33,457,854,53.51%,38.17%,1
彰化縣,員林市,0525,435,120,555,36,591,1064,55.55%,40.88%,1
彰化縣,員林市,0526,385,114,499,19,518,879,58.93%,43.8%,1
彰化縣,員林市,0527,427,103,530,31,561,827,67.84%,51.63%,1
彰化縣,員林市,0528,352,88,440,18,458,867,52.83%,40.6%,1
彰化縣,員林市,0529,497,142,639,39,678,1201,56.45%,41.38%,1
彰化縣,員林市,0530,475,126,601,42,643,1106,58.14%,42.95%,1
彰化縣,員林市,0531,331,125,456,48,504,845,59.64%,39.17%,1
彰化縣,員林市,0532,373,116,489,36,525,894,58.72%,41.72%,1
彰化縣,員林市,0533,352,111,463,42,505,849,59.48%,41.46%,1
彰化縣,員林市,0534,315,105,420,50,470,747,62.92%,42.17%,1
彰化縣,員林市,0535,405,114,519,29,548,884,61.99%,45.81%,1
彰化縣,員林市,0536,341,101,442,36,478,900,53.11%,37.89%,1
彰化縣,員林市,0537,386,128,514,30,544,1040,52.31%,37.12%,1
彰化縣,員林市,0538,307,125,432,22,454,831,54.63%,36.94%,1
彰化縣,員林市,0539,256,86,342,40,382,591,64.64%,43.32%,1
彰化縣,員林市,0540,500,174,674,49,723,1330,54.36%,37.59%,1
彰化縣,員林市,0541,567,126,693,37,730,1295,56.37%,43.78%,1
彰化縣,員林市,0542,506,143,649,66,715,1283,55.73%,39.44%,1
彰化縣,員林市,0543,404,125,529,38,567,943,60.13%,42.84%,1
彰化縣,員林市,0544,597,185,782,59,841,1388,60.59%,43.01%,1
彰化縣,員林市,0545,534,108,642,35,677,1176,57.57%,45.41%,1
彰化縣,員林市,0546,315,87,402,13,415,867,47.87%,36.33%,1
彰化縣,員林市,0547,424,139,563,49,612,1121,54.59%,37.82%,1
彰化縣,員林市,0548,455,134,589,39,628,1190,52.77%,38.24%,1
彰化縣,員林市,0549,410,120,530,35,565,945,59.79%,43.39%,1
彰化縣,員林市,0550,400,109,509,36,545,906,60.15%,44.15%,1
彰化縣,員林市,0551,393,154,547,48,595,978,60.84%,40.18%,1
彰化縣,員林市,0552,416,94,510,45,555,949,58.48%,43.84%,1
彰化縣,員林市,0553,412,109,521,29,550,949,57.96%,43.41%,1
彰化縣,員林市,0554,418,109,527,35,562,1006,55.86%,41.55%,1
彰化縣,員林市,0555,361,123,484,44,528,889,59.39%,40.61%,1
彰化縣,員林市,0556,418,123,541,28,569,923,61.65%,45.29%,1
彰化縣,員林市,0557,538,163,701,39,740,1209,61.21%,44.5%,1
彰化縣,員林市,0558,471,138,609,41,650,1075,60.47%,43.81%,1
彰化縣,員林市,0559,620,160,780,44,824,1342,61.4%,46.2%,1
彰化縣,員林市,0560,486,160,646,42,688,1039,66.22%,46.78%,1
彰化縣,員林市,0561,425,128,553,77,630,1131,55.7%,37.58%,1
彰化縣,員林市,0562,497,168,665,35,700,1356,51.62%,36.65%,1
彰化縣,員林市,0563,556,147,703,64,767,1370,55.99%,40.58%,1
彰化縣,員林市,0564,446,143,589,46,635,1090,58.26%,40.92%,1
彰化縣,員林市,0565,391,108,499,31,530,821,64.56%,47.62%,1
彰化縣,員林市,0566,388,117,505,36,541,910,59.45%,42.64%,1
彰化縣,員林市,0567,484,147,631,50,681,1203,56.61%,40.23%,1
彰化縣,員林市,0568,553,166,719,55,774,1378,56.17%,40.13%,1
彰化縣,員林市,0569,563,174,737,34,771,1352,57.03%,41.64%,1
彰化縣,員林市,0570,462,165,627,23,650,1060,61.32%,43.58%,1
彰化縣,員林市,0571,529,136,665,54,719,1317,54.59%,40.17%,1
彰化縣,員林市,0572,425,138,563,44,607,1120,54.2%,37.95%,1
彰化縣,員林市,0573,403,109,512,42,554,1025,54.05%,39.32%,1
彰化縣,員林市,0574,434,143,577,53,630,1097,57.43%,39.56%,1
彰化縣,員林市,0575,350,134,484,44,528,859,61.47%,40.75%,1
彰化縣,員林市,0576,306,113,419,46,465,837,55.56%,36.56%,1
彰化縣,員林市,0577,478,150,628,55,683,1090,62.66%,43.85%,1
彰化縣,員林市,0578,410,131,541,68,609,1073,56.76%,38.21%,1
彰化縣,溪湖鎮,0640,477,146,623,54,677,1221,55.45%,39.07%,1
彰化縣,溪湖鎮,0641,286,87,373,36,409,638,64.11%,44.83%,1
彰化縣,溪湖鎮,0642,347,91,438,47,485,817,59.36%,42.47%,1
彰化縣,溪湖鎮,0643,435,103,538,46,584,968,60.33%,44.94%,1
彰化縣,溪湖鎮,0644,221,57,278,17,295,448,65.85%,49.33%,1
彰化縣,溪湖鎮,0645,412,121,533,34,567,1123,50.49%,36.69%,1
彰化縣,溪湖鎮,0646,458,140,598,58,656,1166,56.26%,39.28%,1
彰化縣,溪湖鎮,0647,462,141,603,39,642,1151,55.78%,40.14%,1
彰化縣,溪湖鎮,0648,522,159,681,42,723,1249,57.89%,41.79%,1
彰化縣,溪湖鎮,0649,473,149,622,57,679,1146,59.25%,41.27%,1
彰化縣,溪湖鎮,0650,505,120,625,64,689,1199,57.46%,42.12%,1
彰化縣,溪湖鎮,0651,364,108,472,49,521,895,58.21%,40.67%,1
彰化縣,溪湖鎮,0652,432,113,545,21,566,964,58.71%,44.81%,1
彰化縣,溪湖鎮,0653,350,115,465,31,496,851,58.28%,41.13%,1
彰化縣,溪湖鎮,0654,443,126,569,40,609,1072,56.81%,41.32%,1
彰化縣,溪湖鎮,0655,477,134,611,57,668,1113,60.02%,42.86%,1
彰化縣,溪湖鎮,0656,481,132,613,41,654,1090,60%,44.13%,1
彰化縣,溪湖鎮,0657,554,120,674,42,716,1193,60.02%,46.44%,1
彰化縣,溪湖鎮,0658,431,100,531,60,591,952,62.08%,45.27%,1
彰化縣,溪湖鎮,0659,467,146,613,61,674,1172,57.51%,39.85%,1
彰化縣,溪湖鎮,0660,474,109,583,9,592,1027,57.64%,46.15%,1
彰化縣,溪湖鎮,0661,596,96,692,54,746,1188,62.79%,50.17%,1
彰化縣,溪湖鎮,0662,512,175,687,63,750,1403,53.46%,36.49%,1
彰化縣,溪湖鎮,0663,486,150,636,80,716,1397,51.25%,34.79%,1
彰化縣,溪湖鎮,0664,643,202,845,63,908,1636,55.5%,39.3%,1
彰化縣,溪湖鎮,0665,542,141,683,85,768,1298,59.17%,41.76%,1
彰化縣,溪湖鎮,0666,520,119,639,59,698,1214,57.5%,42.83%,1
彰化縣,溪湖鎮,0667,589,132,721,55,776,1297,59.83%,45.41%,1
彰化縣,溪湖鎮,0668,452,98,550,55,605,968,62.5%,46.69%,1
彰化縣,溪湖鎮,0669,343,124,467,37,504,839,60.07%,40.88%,1
彰化縣,溪湖鎮,0670,385,121,506,45,551,907,60.75%,42.45%,1
彰化縣,溪湖鎮,0671,332,90,422,20,442,898,49.22%,36.97%,1
彰化縣,溪湖鎮,0672,330,87,417,32,449,650,69.08%,50.77%,1
彰化縣,溪湖鎮,0673,519,134,653,84,737,1279,57.62%,40.58%,1
彰化縣,溪湖鎮,0674,307,98,405,54,459,730,62.88%,42.05%,1
彰化縣,溪湖鎮,0675,690,45,735,75,810,1407,57.57%,49.04%,1
彰化縣,溪湖鎮,0676,422,157,579,62,641,1273,50.35%,33.15%,1
彰化縣,溪湖鎮,0677,406,104,510,32,542,988,54.86%,41.09%,1
彰化縣,溪湖鎮,0678,335,94,429,52,481,754,63.79%,44.43%,1
彰化縣,溪湖鎮,0679,337,134,471,54,525,1052,49.9%,32.03%,1
彰化縣,溪湖鎮,0680,435,136,571,45,616,1149,53.61%,37.86%,1
彰化縣,溪湖鎮,0681,564,201,765,98,863,1365,63.22%,41.32%,1
彰化縣,田中鎮,0742,296,93,389,87,476,854,55.74%,34.66%,1
彰化縣,田中鎮,0743,342,96,438,51,489,963,50.78%,35.51%,1
彰化縣,田中鎮,0744,24,14,38,7,45,175,25.71%,13.71%,1
彰化縣,田中鎮,0745,276,82,358,36,394,739,53.32%,37.35%,1
彰化縣,田中鎮,0746,305,95,400,39,439,826,53.15%,36.92%,1
彰化縣,田中鎮,0747,286,106,392,55,447,741,60.32%,38.6%,1
彰化縣,田中鎮,0748,165,40,205,12,217,506,42.89%,32.61%,1
彰化縣,田中鎮,0749,367,110,477,45,522,1001,52.15%,36.66%,1
彰化縣,田中鎮,0750,509,151,660,83,743,1281,58%,39.73%,1
彰化縣,田中鎮,0751,412,125,537,57,594,1035,57.39%,39.81%,1
彰化縣,田中鎮,0752,557,167,724,54,778,1327,58.63%,41.97%,1
彰化縣,田中鎮,0753,374,102,476,43,519,844,61.49%,44.31%,1
彰化縣,田中鎮,0754,360,108,468,53,521,913,57.06%,39.43%,1
彰化縣,田中鎮,0755,277,82,359,44,403,613,65.74%,45.19%,1
彰化縣,田中鎮,0756,564,181,745,75,820,1382,59.33%,40.81%,1
彰化縣,田中鎮,0757,505,126,631,46,677,1034,65.47%,48.84%,1
彰化縣,田中鎮,0758,453,123,576,41,617,935,65.99%,48.45%,1
彰化縣,田中鎮,0759,523,173,696,52,748,1301,57.49%,40.2%,1
彰化縣,田中鎮,0760,472,152,624,40,664,1100,60.36%,42.91%,1
彰化縣,田中鎮,0761,438,149,587,53,640,1071,59.76%,40.9%,1
彰化縣,田中鎮,0762,485,167,652,64,716,1163,61.56%,41.7%,1
彰化縣,田中鎮,0763,373,109,482,42,524,809,64.77%,46.11%,1
彰化縣,田中鎮,0764,490,149,639,58,697,1155,60.35%,42.42%,1
彰化縣,田中鎮,0765,478,164,642,86,728,1270,57.32%,37.64%,1
彰化縣,田中鎮,0766,346,103,449,40,489,870,56.21%,39.77%,1
彰化縣,田中鎮,0767,276,93,369,53,422,736,57.34%,37.5%,1
彰化縣,田中鎮,0768,482,154,636,57,693,1335,51.91%,36.1%,1
彰化縣,田中鎮,0769,332,118,450,41,491,876,56.05%,37.9%,1
彰化縣,田中鎮,0770,301,136,437,57,494,898,55.01%,33.52%,1
彰化縣,田中鎮,0771,560,162,722,28,750,1298,57.78%,43.14%,1
彰化縣,田中鎮,0772,525,201,726,81,807,1451,55.62%,36.18%,1
彰化縣,田中鎮,0773,606,163,769,65,834,1475,56.54%,41.08%,1
彰化縣,田中鎮,0774,263,86,349,51,400,766,52.22%,34.33%,1
彰化縣,田中鎮,0775,328,79,407,29,436,810,53.83%,40.49%,1
彰化縣,田中鎮,0776,363,134,497,68,565,953,59.29%,38.09%,1
彰化縣,田中鎮,0777,367,129,496,62,558,885,63.05%,41.47%,1
彰化縣,大村鄉,0579,655,177,832,70,902,1426,63.25%,45.93%,1
彰化縣,大村鄉,0580,793,200,993,83,1076,1726,62.34%,45.94%,1
彰化縣,大村鄉,0581,334,110,444,61,505,797,63.36%,41.91%,1
彰化縣,大村鄉,0582,300,92,392,21,413,745,55.44%,40.27%,1
彰化縣,大村鄉,0583,493,132,625,63,688,1125,61.16%,43.82%,1
彰化縣,大村鄉,0584,569,196,765,97,862,1486,58.01%,38.29%,1
彰化縣,大村鄉,0585,590,169,759,74,833,1426,58.42%,41.37%,1
彰化縣,大村鄉,0586,360,120,480,44,524,824,63.59%,43.69%,1
彰化縣,大村鄉,0587,440,118,558,43,601,1177,51.06%,37.38%,1
彰化縣,大村鄉,0588,635,174,809,72,881,1478,59.61%,42.96%,1
彰化縣,大村鄉,0589,295,92,387,19,406,779,52.12%,37.87%,1
彰化縣,大村鄉,0590,357,98,455,55,510,812,62.81%,43.97%,1
彰化縣,大村鄉,0591,465,131,596,39,635,1161,54.69%,40.05%,1
彰化縣,大村鄉,0592,486,133,619,34,653,1238,52.75%,39.26%,1
彰化縣,大村鄉,0593,515,154,669,58,727,1259,57.74%,40.91%,1
彰化縣,大村鄉,0594,606,158,764,56,820,1412,58.07%,42.92%,1
彰化縣,大村鄉,0595,582,177,759,30,789,1401,56.32%,41.54%,1
彰化縣,大村鄉,0596,592,167,759,79,838,1395,60.07%,42.44%,1
彰化縣,大村鄉,0597,390,149,539,62,601,996,60.34%,39.16%,1
彰化縣,大村鄉,0598,430,129,559,52,611,1047,58.36%,41.07%,1
彰化縣,大村鄉,0599,425,119,544,40,584,985,59.29%,43.15%,1
彰化縣,大村鄉,0600,470,140,610,48,658,1054,62.43%,44.59%,1
彰化縣,大村鄉,0601,515,147,662,50,712,1200,59.33%,42.92%,1
彰化縣,大村鄉,0602,437,110,547,71,618,1003,61.62%,43.57%,1
彰化縣,大村鄉,0603,403,129,532,40,572,1046,54.68%,38.53%,1
彰化縣,大村鄉,0604,519,138,657,55,712,1189,59.88%,43.65%,1
彰化縣,大村鄉,0605,496,148,644,61,705,1305,54.02%,38.01%,1
彰化縣,埔鹽鄉,0682,429,118,547,46,593,958,61.9%,44.78%,1
彰化縣,埔鹽鄉,0683,355,105,460,35,495,754,65.65%,47.08%,1
彰化縣,埔鹽鄉,0684,362,106,468,33,501,757,66.18%,47.82%,1
彰化縣,埔鹽鄉,0685,370,101,471,33,504,806,62.53%,45.91%,1
彰化縣,埔鹽鄉,0686,600,114,714,51,765,1280,59.77%,46.88%,1
彰化縣,埔鹽鄉,0687,409,97,506,46,552,928,59.48%,44.07%,1
彰化縣,埔鹽鄉,0688,387,142,529,60,589,895,65.81%,43.24%,1
彰化縣,埔鹽鄉,0689,362,110,472,53,525,815,64.42%,44.42%,1
彰化縣,埔鹽鄉,0690,406,112,518,41,559,957,58.41%,42.42%,1
彰化縣,埔鹽鄉,0691,555,124,679,107,786,1338,58.74%,41.48%,1
彰化縣,埔鹽鄉,0692,454,120,574,60,634,1106,57.32%,41.05%,1
彰化縣,埔鹽鄉,0693,325,99,424,45,469,690,67.97%,47.1%,1
彰化縣,埔鹽鄉,0694,519,136,655,50,705,1230,57.32%,42.2%,1
彰化縣,埔鹽鄉,0695,359,95,454,32,486,847,57.38%,42.38%,1
彰化縣,埔鹽鄉,0696,413,121,534,28,562,897,62.65%,46.04%,1
彰化縣,埔鹽鄉,0697,362,118,480,49,529,882,59.98%,41.04%,1
彰化縣,埔鹽鄉,0698,532,139,671,45,716,1180,60.68%,45.08%,1
彰化縣,埔鹽鄉,0699,465,155,620,85,705,1215,58.02%,38.27%,1
彰化縣,埔鹽鄉,0700,227,27,254,27,281,422,66.59%,53.79%,1
彰化縣,埔鹽鄉,0701,482,83,565,53,618,1106,55.88%,43.58%,1
彰化縣,埔鹽鄉,0702,383,120,503,62,565,874,64.65%,43.82%,1
彰化縣,埔鹽鄉,0703,585,173,758,99,857,1445,59.31%,40.48%,1
彰化縣,埔鹽鄉,0704,375,111,486,62,548,875,62.63%,42.86%,1
彰化縣,埔鹽鄉,0705,309,82,391,55,446,837,53.29%,36.92%,1
彰化縣,埔鹽鄉,0706,307,77,384,28,412,685,60.15%,44.82%,1
彰化縣,埔鹽鄉,0707,326,89,415,49,464,733,63.3%,44.47%,1
彰化縣,埔鹽鄉,0708,106,313,419,76,495,798,62.03%,13.28%,1
彰化縣,埔鹽鄉,0709,574,157,731,65,796,1381,57.64%,41.56%,1
彰化縣,埔鹽鄉,0710,512,142,654,52,706,1335,52.88%,38.35%,1
彰化縣,埔心鄉,0711,484,137,621,88,709,1139,62.25%,42.49%,1
彰化縣,埔心鄉,0712,470,167,637,77,714,1217,58.67%,38.62%,1
彰化縣,埔心鄉,0713,542,215,757,55,812,1248,65.06%,43.43%,1
彰化縣,埔心鄉,0714,521,191,712,80,792,1248,63.46%,41.75%,1
彰化縣,埔心鄉,0715,377,139,516,49,565,916,61.68%,41.16%,1
彰化縣,埔心鄉,0716,290,88,378,33,411,625,65.76%,46.4%,1
彰化縣,埔心鄉,0717,489,160,649,83,732,1271,57.59%,38.47%,1
彰化縣,埔心鄉,0718,270,76,346,30,376,608,61.84%,44.41%,1
彰化縣,埔心鄉,0719,503,148,651,42,693,1132,61.22%,44.43%,1
彰化縣,埔心鄉,0720,433,143,576,64,640,1027,62.32%,42.16%,1
彰化縣,埔心鄉,0721,401,131,532,53,585,926,63.17%,43.3%,1
彰化縣,埔心鄉,0722,307,112,419,63,482,778,61.95%,39.46%,1
彰化縣,埔心鄉,0723,304,84,388,38,426,660,64.55%,46.06%,1
彰化縣,埔心鄉,0724,585,167,752,68,820,1330,61.65%,43.98%,1
彰化縣,埔心鄉,0725,404,147,551,29,580,991,58.53%,40.77%,1
彰化縣,埔心鄉,0726,418,129,547,43,590,985,59.9%,42.44%,1
彰化縣,埔心鄉,0727,416,142,558,38,596,1034,57.64%,40.23%,1
彰化縣,埔心鄉,0728,260,90,350,46,396,612,64.71%,42.48%,1
彰化縣,埔心鄉,0729,567,155,722,67,789,1236,63.83%,45.87%,1
彰化縣,埔心鄉,0730,331,108,439,52,491,775,63.35%,42.71%,1
彰化縣,埔心鄉,0731,317,127,444,47,491,738,66.53%,42.95%,1
彰化縣,埔心鄉,0732,420,163,583,47,630,1036,60.81%,40.54%,1
彰化縣,埔心鄉,0733,355,125,480,78,558,975,57.23%,36.41%,1
彰化縣,埔心鄉,0734,362,114,476,45,521,885,58.87%,40.9%,1
彰化縣,埔心鄉,0735,393,132,525,64,589,939,62.73%,41.85%,1
彰化縣,埔心鄉,0736,295,78,373,38,411,689,59.65%,42.82%,1
彰化縣,埔心鄉,0737,272,82,354,33,387,659,58.73%,41.27%,1
彰化縣,埔心鄉,0738,348,102,450,43,493,910,54.18%,38.24%,1
彰化縣,埔心鄉,0739,595,217,812,81,893,1352,66.05%,44.01%,1
彰化縣,埔心鄉,0740,301,93,394,44,438,759,57.71%,39.66%,1
彰化縣,埔心鄉,0741,427,91,518,49,567,942,60.19%,45.33%,1
彰化縣,永靖鄉,0606,460,128,588,76,664,1255,52.91%,36.65%,1
彰化縣,永靖鄉,0607,367,113,480,62,542,889,60.97%,41.28%,1
彰化縣,永靖鄉,0608,407,129,536,41,577,1026,56.24%,39.67%,1
彰化縣,永靖鄉,0609,315,87,402,46,448,724,61.88%,43.51%,1
彰化縣,永靖鄉,0610,373,134,507,43,550,924,59.52%,40.37%,1
彰化縣,永靖鄉,0611,280,97,377,43,420,659,63.73%,42.49%,1
彰化縣,永靖鄉,0612,313,87,400,32,432,734,58.86%,42.64%,1
彰化縣,永靖鄉,0613,243,82,325,29,354,758,46.7%,32.06%,1
彰化縣,永靖鄉,0614,388,15,403,49,452,848,53.3%,45.75%,1
彰化縣,永靖鄉,0615,506,166,672,88,760,1404,54.13%,36.04%,1
彰化縣,永靖鄉,0616,381,115,496,53,549,792,69.32%,48.11%,1
彰化縣,永靖鄉,0617,293,99,392,51,443,695,63.74%,42.16%,1
彰化縣,永靖鄉,0618,387,80,467,42,509,821,62%,47.14%,1
彰化縣,永靖鄉,0619,464,127,591,76,667,1064,62.69%,43.61%,1
彰化縣,永靖鄉,0620,321,116,437,43,480,840,57.14%,38.21%,1
彰化縣,永靖鄉,0621,462,161,623,43,666,1079,61.72%,42.82%,1
彰化縣,永靖鄉,0622,471,138,609,45,654,1048,62.4%,44.94%,1
彰化縣,永靖鄉,0623,445,126,571,45,616,960,64.17%,46.35%,1
彰化縣,永靖鄉,0624,344,109,453,28,481,798,60.28%,43.11%,1
彰化縣,永靖鄉,0625,355,126,481,46,527,796,66.21%,44.6%,1
彰化縣,永靖鄉,0626,257,84,341,39,380,662,57.4%,38.82%,1
彰化縣,永靖鄉,0627,412,139,551,57,608,1040,58.46%,39.62%,1
彰化縣,永靖鄉,0628,397,131,528,56,584,1025,56.98%,38.73%,1
彰化縣,永靖鄉,0629,628,186,814,65,879,1357,64.78%,46.28%,1
彰化縣,永靖鄉,0630,544,133,677,69,746,1236,60.36%,44.01%,1
彰化縣,永靖鄉,0631,364,110,474,50,524,871,60.16%,41.79%,1
彰化縣,永靖鄉,0632,265,76,341,44,385,706,54.53%,37.54%,1
彰化縣,永靖鄉,0633,364,99,463,40,503,770,65.32%,47.27%,1
彰化縣,永靖鄉,0634,314,90,404,35,439,669,65.62%,46.94%,1
彰化縣,永靖鄉,0635,336,105,441,52,493,862,57.19%,38.98%,1
彰化縣,永靖鄉,0636,329,94,423,49,472,847,55.73%,38.84%,1
彰化縣,永靖鄉,0637,300,78,378,51,429,668,64.22%,44.91%,1
彰化縣,永靖鄉,0638,377,122,499,38,537,1073,50.05%,35.14%,1
彰化縣,永靖鄉,0639,427,163,590,64,654,1339,48.84%,31.89%,1
彰化縣,社頭鄉,0778,289,133,422,41,463,791,58.53%,36.54%,1
彰化縣,社頭鄉,0779,393,127,520,43,563,984,57.22%,39.94%,1
彰化縣,社頭鄉,0780,361,129,490,19,509,990,51.41%,36.46%,1
彰化縣,社頭鄉,0781,438,130,568,59,627,1016,61.71%,43.11%,1
彰化縣,社頭鄉,0782,446,164,610,49,659,1091,60.4%,40.88%,1
彰化縣,社頭鄉,0783,502,169,671,73,744,1236,60.19%,40.61%,1
彰化縣,社頭鄉,0784,484,130,614,34,648,1203,53.87%,40.23%,1
彰化縣,社頭鄉,0785,306,90,396,32,428,753,56.84%,40.64%,1
彰化縣,社頭鄉,0786,259,90,349,37,386,725,53.24%,35.72%,1
彰化縣,社頭鄉,0787,425,126,551,72,623,1023,60.9%,41.54%,1
彰化縣,社頭鄉,0788,238,98,336,41,377,562,67.08%,42.35%,1
彰化縣,社頭鄉,0789,414,128,542,36,578,1049,55.1%,39.47%,1
彰化縣,社頭鄉,0790,412,109,521,38,559,933,59.91%,44.16%,1
彰化縣,社頭鄉,0791,408,144,552,53,605,990,61.11%,41.21%,1
彰化縣,社頭鄉,0792,397,127,524,37,561,1076,52.14%,36.9%,1
彰化縣,社頭鄉,0793,317,109,426,21,447,742,60.24%,42.72%,1
彰化縣,社頭鄉,0794,277,63,340,21,361,672,53.72%,41.22%,1
彰化縣,社頭鄉,0795,459,117,576,49,625,1235,50.61%,37.17%,1
彰化縣,社頭鄉,0796,286,126,412,39,451,750,60.13%,38.13%,1
彰化縣,社頭鄉,0797,338,108,446,39,485,895,54.19%,37.77%,1
彰化縣,社頭鄉,0798,285,73,358,25,383,688,55.67%,41.42%,1
彰化縣,社頭鄉,0799,364,76,440,36,476,870,54.71%,41.84%,1
彰化縣,社頭鄉,0800,515,135,650,29,679,1140,59.56%,45.18%,1
彰化縣,社頭鄉,0801,497,44,541,42,583,985,59.19%,50.46%,1
彰化縣,社頭鄉,0802,589,128,717,70,787,1266,62.16%,46.52%,1
彰化縣,社頭鄉,0803,389,118,507,45,552,937,58.91%,41.52%,1
彰化縣,社頭鄉,0804,524,122,646,45,691,1219,56.69%,42.99%,1
彰化縣,社頭鄉,0805,438,150,588,81,669,1165,57.42%,37.6%,1
彰化縣,社頭鄉,0806,398,126,524,61,585,986,59.33%,40.37%,1
彰化縣,社頭鄉,0807,330,97,427,31,458,724,63.26%,45.58%,1
彰化縣,社頭鄉,0808,442,99,541,49,590,1015,58.13%,43.55%,1
彰化縣,社頭鄉,0809,406,134,540,32,572,1116,51.25%,36.38%,1
彰化縣,社頭鄉,0810,368,152,520,55,575,1061,54.19%,34.68%,1
彰化縣,社頭鄉,0811,422,131,553,42,595,992,59.98%,42.54%,1
彰化縣,社頭鄉,0812,407,128,535,31,566,1092,51.83%,37.27%,1
彰化縣,社頭鄉,0813,335,120,455,51,506,828,61.11%,40.46%,1
彰化縣,社頭鄉,0814,267,98,365,59,424,787,53.88%,33.93%,1
彰化縣,社頭鄉,0815,251,67,318,26,344,719,47.84%,34.91%,1
彰化縣,二水鄉,0816,388,146,534,72,606,1028,58.95%,37.74%,1
彰化縣,二水鄉,0817,292,84,376,57,433,689,62.84%,42.38%,1
彰化縣,二水鄉,0818,314,101,415,56,471,871,54.08%,36.05%,1
彰化縣,二水鄉,0819,387,107,494,67,561,953,58.87%,40.61%,1
彰化縣,二水鄉,0820,209,76,285,55,340,624,54.49%,33.49%,1
彰化縣,二水鄉,0821,290,82,372,55,427,645,66.2%,44.96%,1
彰化縣,二水鄉,0822,473,128,601,47,648,986,65.72%,47.97%,1
彰化縣,二水鄉,0823,389,154,543,79,622,943,65.96%,41.25%,1
彰化縣,二水鄉,0824,192,65,257,6,263,455,57.8%,42.2%,1
彰化縣,二水鄉,0825,385,131,516,38,554,831,66.67%,46.33%,1
彰化縣,二水鄉,0826,353,103,456,43,499,831,60.05%,42.48%,1
彰化縣,二水鄉,0827,380,142,522,30,552,1013,54.49%,37.51%,1
彰化縣,二水鄉,0828,299,127,426,79,505,796,63.44%,37.56%,1
彰化縣,二水鄉,0829,306,94,400,54,454,781,58.13%,39.18%,1
彰化縣,二水鄉,0830,242,84,326,22,348,692,50.29%,34.97%,1
彰化縣,二水鄉,0831,256,72,328,42,370,635,58.27%,40.31%,1
彰化縣,二水鄉,0832,201,88,289,38,327,566,57.77%,35.51%,1
彰化縣,北斗鎮,0833,324,111,435,80,515,925,55.68%,35.03%,1
彰化縣,北斗鎮,0834,344,125,469,56,525,869,60.41%,39.59%,1
彰化縣,北斗鎮,0835,381,128,509,48,557,855,65.15%,44.56%,1
彰化縣,北斗鎮,0836,463,150,613,57,670,1065,62.91%,43.47%,1
彰化縣,北斗鎮,0837,329,104,433,68,501,828,60.51%,39.73%,1
彰化縣,北斗鎮,0838,479,134,613,56,669,1124,59.52%,42.62%,1
彰化縣,北斗鎮,0839,469,141,610,58,668,1096,60.95%,42.79%,1
彰化縣,北斗鎮,0840,506,154,660,52,712,1213,58.7%,41.71%,1
彰化縣,北斗鎮,0841,449,126,575,70,645,1164,55.41%,38.57%,1
彰化縣,北斗鎮,0842,276,97,373,29,402,730,55.07%,37.81%,1
彰化縣,北斗鎮,0843,362,92,454,38,492,878,56.04%,41.23%,1
彰化縣,北斗鎮,0844,369,105,474,37,511,833,61.34%,44.3%,1
彰化縣,北斗鎮,0845,411,112,523,45,568,957,59.35%,42.95%,1
彰化縣,北斗鎮,0846,311,98,409,35,444,783,56.7%,39.72%,1
彰化縣,北斗鎮,0847,205,72,277,37,314,573,54.8%,35.78%,1
彰化縣,北斗鎮,0848,246,92,338,46,384,672,57.14%,36.61%,1
彰化縣,北斗鎮,0849,248,85,333,45,378,695,54.39%,35.68%,1
彰化縣,北斗鎮,0850,266,94,360,41,401,747,53.68%,35.61%,1
彰化縣,北斗鎮,0851,297,80,377,32,409,643,63.61%,46.19%,1
彰化縣,北斗鎮,0852,273,69,342,51,393,662,59.37%,41.24%,1
彰化縣,北斗鎮,0853,483,138,621,67,688,1085,63.41%,44.52%,1
彰化縣,北斗鎮,0854,472,138,610,58,668,1121,59.59%,42.11%,1
彰化縣,北斗鎮,0855,370,92,462,46,508,830,61.2%,44.58%,1
彰化縣,北斗鎮,0856,385,115,500,46,546,975,56%,39.49%,1
彰化縣,北斗鎮,0857,488,133,621,39,660,1212,54.46%,40.26%,1
彰化縣,北斗鎮,0858,544,153,697,83,780,1302,59.91%,41.78%,1
彰化縣,北斗鎮,0859,390,96,486,39,525,1077,48.75%,36.21%,1
彰化縣,北斗鎮,0860,361,82,443,63,506,917,55.18%,39.37%,1
彰化縣,北斗鎮,0861,314,92,406,42,448,825,54.3%,38.06%,1
彰化縣,北斗鎮,0862,394,104,498,56,554,937,59.12%,42.05%,1
彰化縣,二林鎮,0942,215,68,283,30,313,731,42.82%,29.41%,1
彰化縣,二林鎮,0943,416,117,533,54,587,1025,57.27%,40.59%,1
彰化縣,二林鎮,0944,324,104,428,24,452,784,57.65%,41.33%,1
彰化縣,二林鎮,0945,352,123,475,41,516,892,57.85%,39.46%,1
彰化縣,二林鎮,0946,494,147,641,74,715,1256,56.93%,39.33%,1
彰化縣,二林鎮,0947,404,100,504,55,559,1043,53.6%,38.73%,1
彰化縣,二林鎮,0948,467,138,605,43,648,1076,60.22%,43.4%,1
彰化縣,二林鎮,0949,453,120,573,65,638,1082,58.96%,41.87%,1
彰化縣,二林鎮,0950,522,167,689,67,756,1427,52.98%,36.58%,1
彰化縣,二林鎮,0951,336,127,463,70,533,1030,51.75%,32.62%,1
彰化縣,二林鎮,0952,363,114,477,68,545,1033,52.76%,35.14%,1
彰化縣,二林鎮,0953,405,113,518,50,568,977,58.14%,41.45%,1
彰化縣,二林鎮,0954,251,66,317,31,348,683,50.95%,36.75%,1
彰化縣,二林鎮,0955,329,193,522,85,607,975,62.26%,33.74%,1
彰化縣,二林鎮,0956,416,106,522,86,608,1336,45.51%,31.14%,1
彰化縣,二林鎮,0957,311,107,418,65,483,1019,47.4%,30.52%,1
彰化縣,二林鎮,0958,303,96,399,61,460,1003,45.86%,30.21%,1
彰化縣,二林鎮,0959,478,98,576,75,651,1151,56.56%,41.53%,1
彰化縣,二林鎮,0960,610,180,790,120,910,1598,56.95%,38.17%,1
彰化縣,二林鎮,0961,592,143,735,61,796,1488,53.49%,39.78%,1
彰化縣,二林鎮,0962,729,306,1035,69,1104,1771,62.34%,41.16%,1
彰化縣,二林鎮,0963,401,128,529,58,587,1360,43.16%,29.49%,1
彰化縣,二林鎮,0964,535,151,686,70,756,1613,46.87%,33.17%,1
彰化縣,二林鎮,0965,433,110,543,90,633,1228,51.55%,35.26%,1
彰化縣,二林鎮,0966,341,68,409,30,439,771,56.94%,44.23%,1
彰化縣,二林鎮,0967,355,106,461,37,498,858,58.04%,41.38%,1
彰化縣,二林鎮,0968,229,62,291,0,291,661,44.02%,34.64%,1
彰化縣,二林鎮,0969,408,133,541,88,629,1268,49.61%,32.18%,1
彰化縣,二林鎮,0970,362,109,471,39,510,1081,47.18%,33.49%,1
彰化縣,二林鎮,0971,414,124,538,45,583,1213,48.06%,34.13%,1
彰化縣,二林鎮,0972,527,143,670,72,742,1328,55.87%,39.68%,1
彰化縣,二林鎮,0973,357,95,452,82,534,1118,47.76%,31.93%,1
彰化縣,二林鎮,0974,469,115,584,48,632,1157,54.62%,40.54%,1
彰化縣,二林鎮,0975,323,105,428,46,474,972,48.77%,33.23%,1
彰化縣,二林鎮,0976,338,97,435,48,483,902,53.55%,37.47%,1
彰化縣,二林鎮,0977,524,165,689,93,782,1273,61.43%,41.16%,1
彰化縣,二林鎮,0978,379,118,497,48,545,1087,50.14%,34.87%,1
彰化縣,二林鎮,0979,375,124,499,79,578,987,58.56%,37.99%,1
彰化縣,二林鎮,0980,183,81,264,29,293,719,40.75%,25.45%,1
彰化縣,田尾鄉,0863,456,151,607,46,653,1284,50.86%,35.51%,1
彰化縣,田尾鄉,0864,505,154,659,66,725,1187,61.08%,42.54%,1
彰化縣,田尾鄉,0865,562,101,663,46,709,1033,68.64%,54.4%,1
彰化縣,田尾鄉,0866,309,78,387,39,426,696,61.21%,44.4%,1
彰化縣,田尾鄉,0867,413,84,497,37,534,872,61.24%,47.36%,1
彰化縣,田尾鄉,0868,266,69,335,26,361,680,53.09%,39.12%,1
彰化縣,田尾鄉,0869,365,140,505,49,554,875,63.31%,41.71%,1
彰化縣,田尾鄉,0870,485,152,637,67,704,1337,52.66%,36.28%,1
彰化縣,田尾鄉,0871,634,160,794,50,844,1376,61.34%,46.08%,1
彰化縣,田尾鄉,0872,558,129,687,49,736,1186,62.06%,47.05%,1
彰化縣,田尾鄉,0873,461,96,557,50,607,874,69.45%,52.75%,1
彰化縣,田尾鄉,0874,234,88,322,34,356,647,55.02%,36.17%,1
彰化縣,田尾鄉,0875,407,119,526,42,568,959,59.23%,42.44%,1
彰化縣,田尾鄉,0876,93,35,128,13,141,263,53.61%,35.36%,1
彰化縣,田尾鄉,0877,237,63,300,34,334,618,54.05%,38.35%,1
彰化縣,田尾鄉,0878,407,141,548,28,576,938,61.41%,43.39%,1
彰化縣,田尾鄉,0879,430,87,517,46,563,880,63.98%,48.86%,1
彰化縣,田尾鄉,0880,293,100,393,41,434,804,53.98%,36.44%,1
彰化縣,田尾鄉,0881,224,69,293,34,327,592,55.24%,37.84%,1
彰化縣,田尾鄉,0882,466,132,598,85,683,1079,63.3%,43.19%,1
彰化縣,田尾鄉,0883,541,174,715,59,774,1336,57.93%,40.49%,1
彰化縣,田尾鄉,0884,452,139,591,60,651,1198,54.34%,37.73%,1
彰化縣,田尾鄉,0885,230,83,313,41,354,621,57%,37.04%,1
彰化縣,田尾鄉,0886,294,84,378,32,410,760,53.95%,38.68%,1
彰化縣,田尾鄉,0887,465,163,628,73,701,1084,64.67%,42.9%,1
彰化縣,埤頭鄉,0888,387,132,519,62,581,1178,49.32%,32.85%,1
彰化縣,埤頭鄉,0889,584,54,638,50,688,1290,53.33%,45.27%,1
彰化縣,埤頭鄉,0890,378,90,468,57,525,973,53.96%,38.85%,1
彰化縣,埤頭鄉,0891,275,102,377,38,415,783,53%,35.12%,1
彰化縣,埤頭鄉,0892,275,93,368,50,418,733,57.03%,37.52%,1
彰化縣,埤頭鄉,0893,351,97,448,77,525,899,58.4%,39.04%,1
彰化縣,埤頭鄉,0894,378,116,494,51,545,965,56.48%,39.17%,1
彰化縣,埤頭鄉,0895,525,123,648,68,716,1356,52.8%,38.72%,1
彰化縣,埤頭鄉,0896,478,133,611,76,687,1265,54.31%,37.79%,1
彰化縣,埤頭鄉,0897,373,106,479,49,528,877,60.21%,42.53%,1
彰化縣,埤頭鄉,0898,259,74,333,49,382,705,54.18%,36.74%,1
彰化縣,埤頭鄉,0899,473,113,586,49,635,1062,59.79%,44.54%,1
彰化縣,埤頭鄉,0900,511,167,678,52,730,1300,56.15%,39.31%,1
彰化縣,埤頭鄉,0901,365,102,467,69,536,923,58.07%,39.54%,1
彰化縣,埤頭鄉,0902,392,104,496,41,537,1085,49.49%,36.13%,1
彰化縣,埤頭鄉,0903,465,128,593,60,653,1103,59.2%,42.16%,1
彰化縣,埤頭鄉,0904,249,90,339,35,374,735,50.88%,33.88%,1
彰化縣,埤頭鄉,0905,207,63,270,46,316,574,55.05%,36.06%,1
彰化縣,埤頭鄉,0906,281,62,343,41,384,767,50.07%,36.64%,1
彰化縣,埤頭鄉,0907,255,98,353,54,407,737,55.22%,34.6%,1
彰化縣,埤頭鄉,0908,295,136,431,59,490,1058,46.31%,27.88%,1
彰化縣,埤頭鄉,0909,255,95,350,73,423,826,51.21%,30.87%,1
彰化縣,埤頭鄉,0910,357,100,457,88,545,1082,50.37%,32.99%,1
彰化縣,埤頭鄉,0911,307,84,391,55,446,737,60.52%,41.66%,1
彰化縣,埤頭鄉,0912,270,79,349,28,377,711,53.02%,37.97%,1
彰化縣,埤頭鄉,0913,366,145,511,79,590,1043,56.57%,35.09%,1
彰化縣,埤頭鄉,0914,314,91,405,30,435,910,47.8%,34.51%,1
彰化縣,芳苑鄉,0998,208,64,272,58,330,940,35.11%,22.13%,1
彰化縣,芳苑鄉,0999,92,29,121,31,152,403,37.72%,22.83%,1
彰化縣,芳苑鄉,1000,239,84,323,41,364,756,48.15%,31.61%,1
彰化縣,芳苑鄉,1001,108,40,148,30,178,548,32.48%,19.71%,1
彰化縣,芳苑鄉,1002,358,91,449,68,517,997,51.86%,35.91%,1
彰化縣,芳苑鄉,1003,381,140,521,70,591,1300,45.46%,29.31%,1
彰化縣,芳苑鄉,1004,303,99,402,40,442,859,51.46%,35.27%,1
彰化縣,芳苑鄉,1005,251,74,325,24,349,734,47.55%,34.2%,1
彰化縣,芳苑鄉,1006,230,51,281,23,304,636,47.8%,36.16%,1
彰化縣,芳苑鄉,1007,231,74,305,70,375,808,46.41%,28.59%,1
彰化縣,芳苑鄉,1008,192,58,250,45,295,668,44.16%,28.74%,1
彰化縣,芳苑鄉,1009,267,77,344,34,378,744,50.81%,35.89%,1
彰化縣,芳苑鄉,1010,300,88,388,98,486,1026,47.37%,29.24%,1
彰化縣,芳苑鄉,1011,156,46,202,13,215,586,36.69%,26.62%,1
彰化縣,芳苑鄉,1012,208,77,285,28,313,593,52.78%,35.08%,1
彰化縣,芳苑鄉,1013,338,120,458,115,573,1071,53.5%,31.56%,1
彰化縣,芳苑鄉,1014,357,106,463,98,561,1060,52.92%,33.68%,1
彰化縣,芳苑鄉,1015,224,67,291,24,315,708,44.49%,31.64%,1
彰化縣,芳苑鄉,1016,213,73,286,62,348,735,47.35%,28.98%,1
彰化縣,芳苑鄉,1017,202,67,269,63,332,571,58.14%,35.38%,1
彰化縣,芳苑鄉,1018,223,49,272,36,308,729,42.25%,30.59%,1
彰化縣,芳苑鄉,1019,214,59,273,74,347,674,51.48%,31.75%,1
彰化縣,芳苑鄉,1020,287,94,381,47,428,846,50.59%,33.92%,1
彰化縣,芳苑鄉,1021,310,86,396,57,453,806,56.2%,38.46%,1
彰化縣,芳苑鄉,1022,122,31,153,13,166,470,35.32%,25.96%,1
彰化縣,芳苑鄉,1023,431,102,533,74,607,1124,54%,38.35%,1
彰化縣,芳苑鄉,1024,104,22,126,26,152,317,47.95%,32.81%,1
彰化縣,芳苑鄉,1025,317,107,424,70,494,1158,42.66%,27.37%,1
彰化縣,芳苑鄉,1026,308,90,398,30,428,967,44.26%,31.85%,1
彰化縣,芳苑鄉,1027,281,69,350,48,398,762,52.23%,36.88%,1
彰化縣,芳苑鄉,1028,335,85,420,57,477,1086,43.92%,30.85%,1
彰化縣,芳苑鄉,1029,275,68,343,25,368,747,49.26%,36.81%,1
彰化縣,芳苑鄉,1030,203,35,238,28,266,653,40.74%,31.09%,1
彰化縣,芳苑鄉,1031,347,103,450,63,513,872,58.83%,39.79%,1
彰化縣,芳苑鄉,1032,531,156,687,58,745,1235,60.32%,43%,1
彰化縣,芳苑鄉,1033,383,132,515,77,592,1102,53.72%,34.75%,1
彰化縣,大城鄉,0981,280,86,366,31,397,1288,30.82%,21.74%,1
彰化縣,大城鄉,0982,263,81,344,81,425,1104,38.5%,23.82%,1
彰化縣,大城鄉,0983,366,104,470,67,537,964,55.71%,37.97%,1
彰化縣,大城鄉,0984,416,117,533,74,607,1312,46.27%,31.71%,1
彰化縣,大城鄉,0985,230,74,304,62,366,853,42.91%,26.96%,1
彰化縣,大城鄉,0986,135,25,160,21,181,518,34.94%,26.06%,1
彰化縣,大城鄉,0987,172,48,220,29,249,574,43.38%,29.97%,1
彰化縣,大城鄉,0988,178,51,229,39,268,702,38.18%,25.36%,1
彰化縣,大城鄉,0989,82,21,103,15,118,376,31.38%,21.81%,1
彰化縣,大城鄉,0990,155,34,189,25,214,693,30.88%,22.37%,1
彰化縣,大城鄉,0991,252,84,336,49,385,877,43.9%,28.73%,1
彰化縣,大城鄉,0992,121,48,169,15,184,655,28.09%,18.47%,1
彰化縣,大城鄉,0993,296,71,367,38,405,1103,36.72%,26.84%,1
彰化縣,大城鄉,0994,282,93,375,31,406,1192,34.06%,23.66%,1
彰化縣,大城鄉,0995,246,83,329,32,361,917,39.37%,26.83%,1
彰化縣,大城鄉,0996,153,38,191,33,224,686,32.65%,22.3%,1
彰化縣,大城鄉,0997,193,59,252,20,272,899,30.26%,21.47%,1
彰化縣,竹塘鄉,1034,453,134,587,78,665,1168,56.93%,38.78%,1
彰化縣,竹塘鄉,1035,352,140,492,46,538,965,55.75%,36.48%,1
彰化縣,竹塘鄉,1036,407,130,537,60,597,960,62.19%,42.4%,1
彰化縣,竹塘鄉,1037,319,97,416,67,483,743,65.01%,42.93%,1
彰化縣,竹塘鄉,1038,225,70,295,42,337,751,44.87%,29.96%,1
彰化縣,竹塘鄉,1039,240,90,330,49,379,792,47.85%,30.3%,1
彰化縣,竹塘鄉,1040,231,62,293,17,310,733,42.29%,31.51%,1
彰化縣,竹塘鄉,1041,224,77,301,47,348,657,52.97%,34.09%,1
彰化縣,竹塘鄉,1042,378,106,484,44,528,1063,49.67%,35.56%,1
彰化縣,竹塘鄉,1043,423,122,545,86,631,1114,56.64%,37.97%,1
彰化縣,竹塘鄉,1044,207,81,288,54,342,506,67.59%,40.91%,1
彰化縣,竹塘鄉,1045,267,102,369,51,420,823,51.03%,32.44%,1
彰化縣,竹塘鄉,1046,222,80,302,42,344,654,52.6%,33.94%,1
彰化縣,竹塘鄉,1047,162,53,215,29,244,577,42.29%,28.08%,1
彰化縣,竹塘鄉,1048,257,91,348,59,407,772,52.72%,33.29%,1
彰化縣,竹塘鄉,1049,149,54,203,46,249,543,45.86%,27.44%,1
彰化縣,溪州鄉,0915,303,81,384,46,430,778,55.27%,38.95%,1
彰化縣,溪州鄉,0916,345,119,464,28,492,1061,46.37%,32.52%,1
彰化縣,溪州鄉,0917,210,80,290,33,323,701,46.08%,29.96%,1
彰化縣,溪州鄉,0918,357,122,479,51,530,879,60.3%,40.61%,1
彰化縣,溪州鄉,0919,275,106,381,47,428,654,65.44%,42.05%,1
彰化縣,溪州鄉,0920,341,97,438,50,488,878,55.58%,38.84%,1
彰化縣,溪州鄉,0921,404,122,526,50,576,942,61.15%,42.89%,1
彰化縣,溪州鄉,0922,341,92,433,37,470,871,53.96%,39.15%,1
彰化縣,溪州鄉,0923,379,108,487,31,518,1047,49.47%,36.2%,1
彰化縣,溪州鄉,0924,347,101,448,48,496,858,57.81%,40.44%,1
彰化縣,溪州鄉,0925,437,137,574,65,639,1409,45.35%,31.01%,1
彰化縣,溪州鄉,0926,248,92,340,38,378,792,47.73%,31.31%,1
彰化縣,溪州鄉,0927,230,90,320,66,386,714,54.06%,32.21%,1
彰化縣,溪州鄉,0928,354,120,474,65,539,1109,48.6%,31.92%,1
彰化縣,溪州鄉,0929,369,6,375,52,427,962,44.39%,38.36%,1
彰化縣,溪州鄉,0930,367,97,464,63,527,1157,45.55%,31.72%,1
彰化縣,溪州鄉,0931,344,95,439,51,490,952,51.47%,36.13%,1
彰化縣,溪州鄉,0932,317,117,434,43,477,887,53.78%,35.74%,1
彰化縣,溪州鄉,0933,259,75,334,46,380,866,43.88%,29.91%,1
彰化縣,溪州鄉,0934,307,110,417,63,480,1010,47.52%,30.4%,1
彰化縣,溪州鄉,0935,298,100,398,24,422,853,49.47%,34.94%,1
彰化縣,溪州鄉,0936,286,80,366,70,436,843,51.72%,33.93%,1
彰化縣,溪州鄉,0937,179,52,231,11,242,711,34.04%,25.18%,1
彰化縣,溪州鄉,0938,308,87,395,72,467,851,54.88%,36.19%,1
彰化縣,溪州鄉,0939,264,110,374,34,408,883,46.21%,29.9%,1
彰化縣,溪州鄉,0940,400,109,509,63,572,1247,45.87%,32.08%,1
彰化縣,溪州鄉,0941,555,180,735,91,826,1490,55.44%,37.25%,1
南投縣,南投市,0001,405,118,523,25,548,927,59.12%,43.69%,1
南投縣,南投市,0002,342,78,420,34,454,667,68.07%,51.27%,1
南投縣,南投市,0003,363,85,448,29,477,773,61.71%,46.96%,1
南投縣,南投市,0004,356,116,472,40,512,818,62.59%,43.52%,1
南投縣,南投市,0005,249,81,330,26,356,525,67.81%,47.43%,1
南投縣,南投市,0006,271,79,350,31,381,575,66.26%,47.13%,1
南投縣,南投市,0007,182,57,239,14,253,368,68.75%,49.46%,1
南投縣,南投市,0008,444,141,585,48,633,956,66.21%,46.44%,1
南投縣,南投市,0009,502,127,629,24,653,1245,52.45%,40.32%,1
南投縣,南投市,0010,682,37,719,31,750,1484,50.54%,45.96%,1
南投縣,南投市,0011,596,143,739,37,776,1191,65.16%,50.04%,1
南投縣,南投市,0012,667,193,860,55,915,1506,60.76%,44.29%,1
南投縣,南投市,0013,484,151,635,42,677,1070,63.27%,45.23%,1
南投縣,南投市,0014,313,80,393,25,418,670,62.39%,46.72%,1
南投縣,南投市,0015,496,148,644,49,693,1050,66%,47.24%,1
南投縣,南投市,0016,429,128,557,52,609,1122,54.28%,38.24%,1
南投縣,南投市,0017,390,133,523,35,558,984,56.71%,39.63%,1
南投縣,南投市,0018,542,109,651,25,676,1062,63.65%,51.04%,1
南投縣,南投市,0019,460,125,585,61,646,1053,61.35%,43.68%,1
南投縣,南投市,0020,485,173,658,44,702,1104,63.59%,43.93%,1
南投縣,南投市,0021,505,133,638,53,691,1192,57.97%,42.37%,1
南投縣,南投市,0022,392,108,500,47,547,960,56.98%,40.83%,1
南投縣,南投市,0023,407,109,516,42,558,906,61.59%,44.92%,1
南投縣,南投市,0024,423,120,543,47,590,957,61.65%,44.2%,1
南投縣,南投市,0025,447,151,598,53,651,997,65.3%,44.83%,1
南投縣,南投市,0026,466,122,588,39,627,1008,62.2%,46.23%,1
南投縣,南投市,0027,496,155,651,33,684,1164,58.76%,42.61%,1
南投縣,南投市,0028,254,70,324,30,354,587,60.31%,43.27%,1
南投縣,南投市,0029,261,103,364,37,401,734,54.63%,35.56%,1
南投縣,南投市,0030,301,83,384,40,424,724,58.56%,41.57%,1
南投縣,南投市,0031,456,104,560,36,596,1003,59.42%,45.46%,1
南投縣,南投市,0032,605,133,738,49,787,1356,58.04%,44.62%,1
南投縣,南投市,0033,564,129,693,51,744,1373,54.19%,41.08%,1
南投縣,南投市,0034,609,158,767,38,805,1452,55.44%,41.94%,1
南投縣,南投市,0035,153,26,179,17,196,362,54.14%,42.27%,1
南投縣,南投市,0036,162,43,205,29,234,389,60.15%,41.65%,1
南投縣,南投市,0037,597,169,766,65,831,1276,65.13%,46.79%,1
南投縣,南投市,0038,510,141,651,56,707,1089,64.92%,46.83%,1
南投縣,南投市,0039,438,108,546,47,593,921,64.39%,47.56%,1
南投縣,南投市,0040,490,100,590,35,625,892,70.07%,54.93%,1
南投縣,南投市,0041,543,109,652,35,687,1050,65.43%,51.71%,1
南投縣,南投市,0042,538,115,653,26,679,1078,62.99%,49.91%,1
南投縣,南投市,0043,522,101,623,44,667,1078,61.87%,48.42%,1
南投縣,南投市,0044,484,118,602,21,623,861,72.36%,56.21%,1
南投縣,南投市,0045,625,25,650,78,728,1221,59.62%,51.19%,1
南投縣,南投市,0046,487,134,621,29,650,1105,58.82%,44.07%,1
南投縣,南投市,0047,577,149,726,28,754,1230,61.3%,46.91%,1
南投縣,南投市,0048,530,103,633,42,675,1092,61.81%,48.53%,1
南投縣,南投市,0049,679,126,805,18,823,1286,64%,52.8%,1
南投縣,南投市,0050,342,77,419,28,447,655,68.24%,52.21%,1
南投縣,南投市,0051,347,99,446,33,479,719,66.62%,48.26%,1
南投縣,南投市,0052,313,74,387,30,417,720,57.92%,43.47%,1
南投縣,南投市,0053,260,65,325,17,342,509,67.19%,51.08%,1
南投縣,南投市,0054,228,35,263,16,279,492,56.71%,46.34%,1
南投縣,南投市,0055,310,46,356,21,377,616,61.2%,50.32%,1
南投縣,南投市,0056,525,82,607,31,638,1010,63.17%,51.98%,1
南投縣,南投市,0057,418,64,482,26,508,848,59.91%,49.29%,1
南投縣,南投市,0058,626,186,812,74,886,1387,63.88%,45.13%,1
南投縣,南投市,0059,608,156,764,39,803,1245,64.5%,48.84%,1
南投縣,南投市,0060,543,117,660,31,691,1199,57.63%,45.29%,1
南投縣,南投市,0061,567,163,730,47,777,1288,60.33%,44.02%,1
南投縣,南投市,0062,446,126,572,52,624,1040,60%,42.88%,1
南投縣,南投市,0063,489,119,608,56,664,1070,62.06%,45.7%,1
南投縣,南投市,0064,648,134,782,36,818,1299,62.97%,49.88%,1
南投縣,南投市,0065,533,145,678,31,709,1122,63.19%,47.5%,1
南投縣,南投市,0066,625,156,781,44,825,1414,58.35%,44.2%,1
南投縣,南投市,0067,489,125,614,50,664,1121,59.23%,43.62%,1
南投縣,南投市,0068,596,181,777,36,813,1434,56.69%,41.56%,1
南投縣,南投市,0069,583,149,732,41,773,1393,55.49%,41.85%,1
南投縣,南投市,0070,434,125,559,31,590,1059,55.71%,40.98%,1
南投縣,南投市,0071,527,145,672,37,709,1218,58.21%,43.27%,1
南投縣,南投市,0072,524,122,646,19,665,1293,51.43%,40.53%,1
南投縣,南投市,0073,508,125,633,45,678,1337,50.71%,38%,1
南投縣,南投市,0074,391,129,520,34,554,876,63.24%,44.63%,1
南投縣,南投市,0075,419,115,534,30,564,971,58.08%,43.15%,1
南投縣,南投市,0076,412,141,553,40,593,1012,58.6%,40.71%,1
南投縣,南投市,0077,399,92,491,43,534,973,54.88%,41.01%,1
南投縣,南投市,0078,444,136,580,44,624,1002,62.28%,44.31%,1
南投縣,南投市,0079,433,133,566,40,606,1024,59.18%,42.29%,1
南投縣,南投市,0080,357,131,488,106,594,1122,52.94%,31.82%,1
南投縣,南投市,0081,277,85,362,35,397,790,50.25%,35.06%,1
南投縣,南投市,0082,195,51,246,28,274,647,42.35%,30.14%,1
南投縣,南投市,0083,392,90,482,51,533,950,56.11%,41.26%,1
南投縣,南投市,0084,386,86,472,33,505,980,51.53%,39.39%,1
南投縣,埔里鎮,0085,365,80,445,54,499,828,60.27%,44.08%,1
南投縣,埔里鎮,0086,358,85,443,42,485,786,61.7%,45.55%,1
南投縣,埔里鎮,0087,451,105,556,39,595,1062,56.03%,42.47%,1
南投縣,埔里鎮,0088,566,131,697,49,746,1201,62.11%,47.13%,1
南投縣,埔里鎮,0089,597,127,724,34,758,1415,53.57%,42.19%,1
南投縣,埔里鎮,0090,555,122,677,37,714,1282,55.69%,43.29%,1
南投縣,埔里鎮,0091,375,75,450,47,497,859,57.86%,43.66%,1
南投縣,埔里鎮,0092,538,135,673,83,756,1288,58.7%,41.77%,1
南投縣,埔里鎮,0093,590,144,734,24,758,1330,56.99%,44.36%,1
南投縣,埔里鎮,0094,578,140,718,52,770,1416,54.38%,40.82%,1
南投縣,埔里鎮,0095,488,117,605,45,650,1283,50.66%,38.04%,1
南投縣,埔里鎮,0096,485,138,623,80,703,1151,61.08%,42.14%,1
南投縣,埔里鎮,0097,483,116,599,35,634,1193,53.14%,40.49%,1
南投縣,埔里鎮,0098,614,146,760,83,843,1471,57.31%,41.74%,1
南投縣,埔里鎮,0099,362,95,457,75,532,1044,50.96%,34.67%,1
南投縣,埔里鎮,0100,498,105,603,61,664,1122,59.18%,44.39%,1
南投縣,埔里鎮,0101,563,115,678,50,728,1129,64.48%,49.87%,1
南投縣,埔里鎮,0102,374,93,467,17,484,901,53.72%,41.51%,1
南投縣,埔里鎮,0103,394,96,490,54,544,997,54.56%,39.52%,1
南投縣,埔里鎮,0104,513,121,634,43,677,1209,56%,42.43%,1
南投縣,埔里鎮,0105,423,92,515,37,552,838,65.87%,50.48%,1
南投縣,埔里鎮,0106,454,107,561,53,614,1226,50.08%,37.03%,1
南投縣,埔里鎮,0107,578,148,726,59,785,1263,62.15%,45.76%,1
南投縣,埔里鎮,0108,505,101,606,33,639,1045,61.15%,48.33%,1
南投縣,埔里鎮,0109,544,108,652,41,693,1120,61.88%,48.57%,1
南投縣,埔里鎮,0110,517,127,644,47,691,1062,65.07%,48.68%,1
南投縣,埔里鎮,0111,443,100,543,37,580,1022,56.75%,43.35%,1
南投縣,埔里鎮,0112,442,125,567,31,598,1051,56.9%,42.06%,1
南投縣,埔里鎮,0113,458,116,574,42,616,1106,55.7%,41.41%,1
南投縣,埔里鎮,0114,461,106,567,28,595,1098,54.19%,41.99%,1
南投縣,埔里鎮,0115,505,92,597,35,632,1067,59.23%,47.33%,1
南投縣,埔里鎮,0116,285,88,373,53,426,725,58.76%,39.31%,1
南投縣,埔里鎮,0117,429,75,504,28,532,905,58.78%,47.4%,1
南投縣,埔里鎮,0118,476,103,579,63,642,1179,54.45%,40.37%,1
南投縣,埔里鎮,0119,367,89,456,35,491,944,52.01%,38.88%,1
南投縣,埔里鎮,0120,190,53,243,26,269,465,57.85%,40.86%,1
南投縣,埔里鎮,0121,480,124,604,45,649,1133,57.28%,42.37%,1
南投縣,埔里鎮,0122,443,94,537,39,576,1100,52.36%,40.27%,1
南投縣,埔里鎮,0123,508,108,616,56,672,1155,58.18%,43.98%,1
南投縣,埔里鎮,0124,485,129,614,55,669,1254,53.35%,38.68%,1
南投縣,埔里鎮,0125,519,114,633,65,698,1296,53.86%,40.05%,1
南投縣,埔里鎮,0126,470,153,623,40,663,1023,64.81%,45.94%,1
南投縣,埔里鎮,0127,383,69,452,20,472,964,48.96%,39.73%,1
南投縣,埔里鎮,0128,431,104,535,34,569,986,57.71%,43.71%,1
南投縣,埔里鎮,0129,486,101,587,29,616,1016,60.63%,47.83%,1
南投縣,埔里鎮,0130,365,115,480,50,530,898,59.02%,40.65%,1
南投縣,埔里鎮,0131,447,108,555,41,596,980,60.82%,45.61%,1
南投縣,埔里鎮,0132,411,116,527,34,561,933,60.13%,44.05%,1
南投縣,埔里鎮,0133,465,141,606,43,649,929,69.86%,50.05%,1
南投縣,埔里鎮,0134,415,113,528,60,588,1032,56.98%,40.21%,1
南投縣,埔里鎮,0135,115,24,139,10,149,315,47.3%,36.51%,1
南投縣,埔里鎮,0136,499,139,638,71,709,1363,52.02%,36.61%,1
南投縣,埔里鎮,0137,324,76,400,38,438,725,60.41%,44.69%,1
南投縣,埔里鎮,0138,293,114,407,21,428,705,60.71%,41.56%,1
南投縣,埔里鎮,0139,361,92,453,35,488,751,64.98%,48.07%,1
南投縣,埔里鎮,0140,404,87,491,43,534,932,57.3%,43.35%,1
南投縣,埔里鎮,0141,415,114,529,40,569,956,59.52%,43.41%,1
南投縣,埔里鎮,0142,154,45,199,12,211,376,56.12%,40.96%,1
南投縣,埔里鎮,0143,288,80,368,39,407,682,59.68%,42.23%,1
南投縣,埔里鎮,0144,545,48,593,52,645,990,65.15%,55.05%,1
南投縣,埔里鎮,0145,468,127,595,64,659,1324,49.77%,35.35%,1
南投縣,埔里鎮,0146,100,32,132,14,146,298,48.99%,33.56%,1
南投縣,埔里鎮,0147,501,97,598,63,661,1170,56.5%,42.82%,1
南投縣,埔里鎮,0148,262,68,330,23,353,604,58.44%,43.38%,1
南投縣,埔里鎮,0149,387,124,511,42,553,999,55.36%,38.74%,1
南投縣,埔里鎮,0150,341,88,429,25,454,923,49.19%,36.94%,1
南投縣,埔里鎮,0151,400,107,507,30,537,887,60.54%,45.1%,1
南投縣,埔里鎮,0152,390,95,485,28,513,981,52.29%,39.76%,1
南投縣,草屯鎮,0153,455,129,584,23,607,998,60.82%,45.59%,1
南投縣,草屯鎮,0154,484,109,593,30,623,1127,55.28%,42.95%,1
南投縣,草屯鎮,0155,599,104,703,28,731,1401,52.18%,42.76%,1
南投縣,草屯鎮,0156,410,166,576,37,613,1110,55.23%,36.94%,1
南投縣,草屯鎮,0157,576,138,714,57,771,1285,60%,44.82%,1
南投縣,草屯鎮,0158,382,118,500,33,533,936,56.94%,40.81%,1
南投縣,草屯鎮,0159,456,145,601,57,658,1141,57.67%,39.96%,1
南投縣,草屯鎮,0160,328,90,418,27,445,705,63.12%,46.52%,1
南投縣,草屯鎮,0161,490,146,636,27,663,1121,59.14%,43.71%,1
南投縣,草屯鎮,0162,419,130,549,34,583,877,66.48%,47.78%,1
南投縣,草屯鎮,0163,589,162,751,52,803,1401,57.32%,42.04%,1
南投縣,草屯鎮,0164,507,133,640,56,696,1267,54.93%,40.02%,1
南投縣,草屯鎮,0165,550,103,653,68,721,1214,59.39%,45.3%,1
南投縣,草屯鎮,0166,519,160,679,66,745,1259,59.17%,41.22%,1
南投縣,草屯鎮,0167,665,158,823,45,868,1442,60.19%,46.12%,1
南投縣,草屯鎮,0168,554,149,703,55,758,1273,59.54%,43.52%,1
南投縣,草屯鎮,0169,490,120,610,41,651,1145,56.86%,42.79%,1
南投縣,草屯鎮,0170,547,129,676,29,705,1279,55.12%,42.77%,1
南投縣,草屯鎮,0171,602,17,619,26,645,1158,55.7%,51.99%,1
南投縣,草屯鎮,0172,809,118,927,53,980,1335,73.41%,60.6%,1
南投縣,草屯鎮,0173,616,141,757,35,792,1178,67.23%,52.29%,1
南投縣,草屯鎮,0174,605,134,739,43,782,1327,58.93%,45.59%,1
南投縣,草屯鎮,0175,424,129,553,34,587,1000,58.7%,42.4%,1
南投縣,草屯鎮,0176,585,89,674,35,709,1257,56.4%,46.54%,1
南投縣,草屯鎮,0177,423,110,533,28,561,883,63.53%,47.9%,1
南投縣,草屯鎮,0178,478,115,593,28,621,1121,55.4%,42.64%,1
南投縣,草屯鎮,0179,478,112,590,32,622,1043,59.64%,45.83%,1
南投縣,草屯鎮,0180,463,113,576,23,599,979,61.18%,47.29%,1
南投縣,草屯鎮,0181,385,109,494,28,522,1048,49.81%,36.74%,1
南投縣,草屯鎮,0182,415,121,536,36,572,1009,56.69%,41.13%,1
南投縣,草屯鎮,0183,478,103,581,24,605,1138,53.16%,42%,1
南投縣,草屯鎮,0184,458,173,631,33,664,1197,55.47%,38.26%,1
南投縣,草屯鎮,0185,637,131,768,38,806,1364,59.09%,46.7%,1
南投縣,草屯鎮,0186,476,121,597,45,642,1059,60.62%,44.95%,1
南投縣,草屯鎮,0187,502,100,602,48,650,1108,58.66%,45.31%,1
南投縣,草屯鎮,0188,367,92,459,43,502,879,57.11%,41.75%,1
南投縣,草屯鎮,0189,414,102,516,48,564,957,58.93%,43.26%,1
南投縣,草屯鎮,0190,495,139,634,27,661,1395,47.38%,35.48%,1
南投縣,草屯鎮,0191,498,142,640,42,682,1101,61.94%,45.23%,1
南投縣,草屯鎮,0192,514,140,654,41,695,1297,53.59%,39.63%,1
南投縣,草屯鎮,0193,274,91,365,25,390,877,44.47%,31.24%,1
南投縣,草屯鎮,0194,486,131,617,61,678,1376,49.27%,35.32%,1
南投縣,草屯鎮,0195,488,113,601,50,651,1008,64.58%,48.41%,1
南投縣,草屯鎮,0196,493,122,615,51,666,1080,61.67%,45.65%,1
南投縣,草屯鎮,0197,398,118,516,49,565,1017,55.56%,39.13%,1
南投縣,草屯鎮,0198,427,138,565,48,613,961,63.79%,44.43%,1
南投縣,草屯鎮,0199,522,125,647,62,709,1160,61.12%,45%,1
南投縣,草屯鎮,0200,495,117,612,31,643,1121,57.36%,44.16%,1
南投縣,草屯鎮,0201,517,149,666,35,701,1243,56.4%,41.59%,1
南投縣,草屯鎮,0202,391,128,519,29,548,932,58.8%,41.95%,1
南投縣,草屯鎮,0203,637,159,796,61,857,1323,64.78%,48.15%,1
南投縣,草屯鎮,0204,574,158,732,38,770,1518,50.72%,37.81%,1
南投縣,草屯鎮,0205,385,136,521,47,568,923,61.54%,41.71%,1
南投縣,草屯鎮,0206,366,128,494,36,530,970,54.64%,37.73%,1
南投縣,草屯鎮,0207,401,131,532,34,566,1026,55.17%,39.08%,1
南投縣,草屯鎮,0208,574,179,753,72,825,1466,56.28%,39.15%,1
南投縣,草屯鎮,0209,510,127,637,37,674,1180,57.12%,43.22%,1
南投縣,草屯鎮,0210,455,130,585,26,611,1006,60.74%,45.23%,1
南投縣,草屯鎮,0211,377,89,466,40,506,1000,50.6%,37.7%,1
南投縣,草屯鎮,0212,516,140,656,31,687,1128,60.9%,45.74%,1
南投縣,草屯鎮,0213,247,76,323,13,336,623,53.93%,39.65%,1
南投縣,草屯鎮,0214,259,106,365,53,418,707,59.12%,36.63%,1
南投縣,草屯鎮,0215,279,77,356,31,387,719,53.82%,38.8%,1
南投縣,草屯鎮,0216,191,41,232,26,258,527,48.96%,36.24%,1
南投縣,草屯鎮,0217,528,131,659,49,708,1183,59.85%,44.63%,1
南投縣,草屯鎮,0218,390,108,498,33,531,869,61.1%,44.88%,1
南投縣,草屯鎮,0219,423,116,539,14,553,1132,48.85%,37.37%,1
南投縣,草屯鎮,0220,389,129,518,50,568,949,59.85%,40.99%,1
南投縣,草屯鎮,0221,440,111,551,34,585,965,60.62%,45.6%,1
南投縣,草屯鎮,0222,404,128,532,33,565,1068,52.9%,37.83%,1
南投縣,草屯鎮,0223,451,130,581,43,624,1024,60.94%,44.04%,1
南投縣,草屯鎮,0224,264,60,324,28,352,642,54.83%,41.12%,1
南投縣,草屯鎮,0225,389,100,489,49,538,1017,52.9%,38.25%,1
南投縣,草屯鎮,0226,484,96,580,43,623,1092,57.05%,44.32%,1
南投縣,草屯鎮,0227,456,136,592,66,658,1170,56.24%,38.97%,1
南投縣,草屯鎮,0228,475,132,607,59,666,1106,60.22%,42.95%,1
南投縣,竹山鎮,0229,514,138,652,52,704,1170,60.17%,43.93%,1
南投縣,竹山鎮,0230,367,120,487,45,532,850,62.59%,43.18%,1
南投縣,竹山鎮,0231,244,66,310,32,342,621,55.07%,39.29%,1
南投縣,竹山鎮,0232,387,84,471,35,506,905,55.91%,42.76%,1
南投縣,竹山鎮,0233,411,96,507,49,556,1099,50.59%,37.4%,1
南投縣,竹山鎮,0234,451,114,565,72,637,1214,52.47%,37.15%,1
南投縣,竹山鎮,0235,563,147,710,66,776,1287,60.3%,43.75%,1
南投縣,竹山鎮,0236,493,123,616,62,678,1191,56.93%,41.39%,1
南投縣,竹山鎮,0237,431,124,555,82,637,1118,56.98%,38.55%,1
南投縣,竹山鎮,0238,585,131,716,38,754,1278,59%,45.77%,1
南投縣,竹山鎮,0239,476,139,615,53,668,1153,57.94%,41.28%,1
南投縣,竹山鎮,0240,93,479,572,70,642,1243,51.65%,7.48%,1
南投縣,竹山鎮,0241,551,126,677,55,732,1308,55.96%,42.13%,1
南投縣,竹山鎮,0242,511,156,667,51,718,1358,52.87%,37.63%,1
南投縣,竹山鎮,0243,423,94,517,55,572,1044,54.79%,40.52%,1
南投縣,竹山鎮,0244,241,50,291,30,321,511,62.82%,47.16%,1
南投縣,竹山鎮,0245,289,61,350,10,360,682,52.79%,42.38%,1
南投縣,竹山鎮,0246,340,118,458,24,482,989,48.74%,34.38%,1
南投縣,竹山鎮,0247,561,135,696,45,741,1378,53.77%,40.71%,1
南投縣,竹山鎮,0248,73,31,104,7,111,217,51.15%,33.64%,1
南投縣,竹山鎮,0249,213,49,262,26,288,479,60.13%,44.47%,1
南投縣,竹山鎮,0250,133,48,181,17,198,430,46.05%,30.93%,1
南投縣,竹山鎮,0251,575,160,735,73,808,1437,56.23%,40.01%,1
南投縣,竹山鎮,0252,556,167,723,48,771,1286,59.95%,43.23%,1
南投縣,竹山鎮,0253,491,120,611,47,658,1080,60.93%,45.46%,1
南投縣,竹山鎮,0254,425,127,552,42,594,1070,55.51%,39.72%,1
南投縣,竹山鎮,0255,541,129,670,58,728,1295,56.22%,41.78%,1
南投縣,竹山鎮,0256,442,113,555,35,590,1047,56.35%,42.22%,1
南投縣,竹山鎮,0257,536,131,667,57,724,1300,55.69%,41.23%,1
南投縣,竹山鎮,0258,304,96,400,28,428,908,47.14%,33.48%,1
南投縣,竹山鎮,0259,280,86,366,54,420,821,51.16%,34.1%,1
南投縣,竹山鎮,0260,550,159,709,56,765,1320,57.95%,41.67%,1
南投縣,竹山鎮,0261,353,99,452,31,483,967,49.95%,36.5%,1
南投縣,竹山鎮,0262,211,55,266,24,290,595,48.74%,35.46%,1
南投縣,竹山鎮,0263,318,89,407,67,474,859,55.18%,37.02%,1
南投縣,竹山鎮,0264,460,120,580,65,645,1196,53.93%,38.46%,1
南投縣,竹山鎮,0265,274,61,335,34,369,649,56.86%,42.22%,1
南投縣,竹山鎮,0266,531,153,684,59,743,1341,55.41%,39.6%,1
南投縣,竹山鎮,0267,420,117,537,76,613,1222,50.16%,34.37%,1
南投縣,竹山鎮,0268,242,78,320,27,347,602,57.64%,40.2%,1
南投縣,竹山鎮,0269,250,61,311,35,346,617,56.08%,40.52%,1
南投縣,竹山鎮,0270,322,109,431,58,489,793,61.66%,40.61%,1
南投縣,竹山鎮,0271,389,86,475,19,494,922,53.58%,42.19%,1
南投縣,竹山鎮,0272,142,31,173,21,194,366,53.01%,38.8%,1
南投縣,竹山鎮,0273,187,27,214,10,224,509,44.01%,36.74%,1
南投縣,竹山鎮,0274,78,15,93,11,104,193,53.89%,40.41%,1
南投縣,竹山鎮,0275,181,45,226,25,251,406,61.82%,44.58%,1
南投縣,竹山鎮,0276,168,54,222,30,252,495,50.91%,33.94%,1
南投縣,竹山鎮,0277,75,19,94,12,106,307,34.53%,24.43%,1
南投縣,竹山鎮,0278,175,22,197,37,234,440,53.18%,39.77%,1
南投縣,竹山鎮,0279,221,43,264,49,313,577,54.25%,38.3%,1
南投縣,竹山鎮,0280,112,62,174,40,214,486,44.03%,23.05%,1
南投縣,竹山鎮,0281,104,26,130,18,148,403,36.72%,25.81%,1
南投縣,集集鎮,0282,493,105,598,50,648,1070,60.56%,46.07%,1
南投縣,集集鎮,0283,423,110,533,28,561,918,61.11%,46.08%,1
南投縣,集集鎮,0284,245,70,315,33,348,581,59.9%,42.17%,1
南投縣,集集鎮,0285,542,123,665,48,713,1194,59.72%,45.39%,1
南投縣,集集鎮,0286,147,52,199,22,221,488,45.29%,30.12%,1
南投縣,集集鎮,0287,226,47,273,40,313,504,62.1%,44.84%,1
南投縣,集集鎮,0288,350,121,471,92,563,910,61.87%,38.46%,1
南投縣,集集鎮,0289,354,70,424,61,485,773,62.74%,45.8%,1
南投縣,集集鎮,0290,280,91,371,31,402,709,56.7%,39.49%,1
南投縣,集集鎮,0291,395,102,497,35,532,960,55.42%,41.15%,1
南投縣,集集鎮,0292,198,55,253,22,275,503,54.67%,39.36%,1
南投縣,集集鎮,0293,153,33,186,25,211,419,50.36%,36.52%,1
南投縣,集集鎮,0294,204,44,248,15,263,582,45.19%,35.05%,1
南投縣,名間鄉,0295,519,150,669,61,730,1050,69.52%,49.43%,1
南投縣,名間鄉,0296,402,98,500,54,554,920,60.22%,43.7%,1
南投縣,名間鄉,0297,333,99,432,42,474,727,65.2%,45.8%,1
南投縣,名間鄉,0298,423,104,527,26,553,861,64.23%,49.13%,1
南投縣,名間鄉,0299,385,92,477,43,520,897,57.97%,42.92%,1
南投縣,名間鄉,0300,466,128,594,57,651,1055,61.71%,44.17%,1
南投縣,名間鄉,0301,517,113,630,66,696,1184,58.78%,43.67%,1
南投縣,名間鄉,0302,303,98,401,45,446,783,56.96%,38.7%,1
南投縣,名間鄉,0303,343,97,440,45,485,781,62.1%,43.92%,1
南投縣,名間鄉,0304,403,89,492,41,533,977,54.55%,41.25%,1
南投縣,名間鄉,0305,411,96,507,58,565,1015,55.67%,40.49%,1
南投縣,名間鄉,0306,405,104,509,41,550,914,60.18%,44.31%,1
南投縣,名間鄉,0307,431,109,540,20,560,1028,54.47%,41.93%,1
南投縣,名間鄉,0308,465,110,575,42,617,1018,60.61%,45.68%,1
南投縣,名間鄉,0309,541,137,678,73,751,1274,58.95%,42.46%,1
南投縣,名間鄉,0310,309,95,404,50,454,755,60.13%,40.93%,1
南投縣,名間鄉,0311,423,114,537,55,592,895,66.15%,47.26%,1
南投縣,名間鄉,0312,432,63,495,28,523,892,58.63%,48.43%,1
南投縣,名間鄉,0313,375,118,493,58,551,951,57.94%,39.43%,1
南投縣,名間鄉,0314,510,147,657,68,725,1261,57.49%,40.44%,1
南投縣,名間鄉,0315,299,103,402,41,443,768,57.68%,38.93%,1
南投縣,名間鄉,0316,374,145,519,60,579,962,60.19%,38.88%,1
南投縣,名間鄉,0317,360,106,466,67,533,867,61.48%,41.52%,1
南投縣,名間鄉,0318,383,113,496,69,565,930,60.75%,41.18%,1
南投縣,名間鄉,0319,244,77,321,67,388,641,60.53%,38.07%,1
南投縣,名間鄉,0320,191,60,251,30,281,530,53.02%,36.04%,1
南投縣,名間鄉,0321,366,113,479,76,555,931,59.61%,39.31%,1
南投縣,名間鄉,0322,485,131,616,58,674,1127,59.8%,43.03%,1
南投縣,名間鄉,0323,201,53,254,40,294,443,66.37%,45.37%,1
南投縣,名間鄉,0324,369,108,477,55,532,870,61.15%,42.41%,1
南投縣,名間鄉,0325,256,76,332,58,390,621,62.8%,41.22%,1
南投縣,名間鄉,0326,417,138,555,45,600,1179,50.89%,35.37%,1
南投縣,名間鄉,0327,426,84,510,49,559,881,63.45%,48.35%,1
南投縣,名間鄉,0328,438,96,534,62,596,876,68.04%,50%,1
南投縣,名間鄉,0329,326,89,415,59,474,783,60.54%,41.63%,1
南投縣,名間鄉,0330,308,62,370,49,419,778,53.86%,39.59%,1
南投縣,名間鄉,0331,385,105,490,53,543,983,55.24%,39.17%,1
南投縣,鹿谷鄉,0332,372,65,437,47,484,934,51.82%,39.83%,1
南投縣,鹿谷鄉,0333,385,104,489,48,537,940,57.13%,40.96%,1
南投縣,鹿谷鄉,0334,327,96,423,32,455,852,53.4%,38.38%,1
南投縣,鹿谷鄉,0335,138,39,177,24,201,451,44.57%,30.6%,1
南投縣,鹿谷鄉,0336,370,85,455,34,489,810,60.37%,45.68%,1
南投縣,鹿谷鄉,0337,526,125,651,61,712,1142,62.35%,46.06%,1
南投縣,鹿谷鄉,0338,283,56,339,21,360,766,47%,36.95%,1
南投縣,鹿谷鄉,0339,372,92,464,53,517,884,58.48%,42.08%,1
南投縣,鹿谷鄉,0340,318,104,422,36,458,811,56.47%,39.21%,1
南投縣,鹿谷鄉,0341,185,60,245,31,276,581,47.5%,31.84%,1
南投縣,鹿谷鄉,0342,201,70,271,23,294,578,50.87%,34.78%,1
南投縣,鹿谷鄉,0343,216,41,257,22,279,467,59.74%,46.25%,1
南投縣,鹿谷鄉,0344,261,53,314,32,346,622,55.63%,41.96%,1
南投縣,鹿谷鄉,0345,284,67,351,30,381,740,51.49%,38.38%,1
南投縣,鹿谷鄉,0346,297,91,388,45,433,767,56.45%,38.72%,1
南投縣,鹿谷鄉,0347,387,98,485,42,527,909,57.98%,42.57%,1
南投縣,鹿谷鄉,0348,283,58,341,28,369,713,51.75%,39.69%,1
南投縣,鹿谷鄉,0349,249,57,306,30,336,717,46.86%,34.73%,1
南投縣,鹿谷鄉,0350,272,89,361,39,400,794,50.38%,34.26%,1
南投縣,鹿谷鄉,0351,236,73,309,28,337,726,46.42%,32.51%,1
南投縣,鹿谷鄉,0352,229,51,280,31,311,737,42.2%,31.07%,1
南投縣,中寮鄉,0353,336,110,446,60,506,822,61.56%,40.88%,1
南投縣,中寮鄉,0354,108,33,141,14,155,253,61.26%,42.69%,1
南投縣,中寮鄉,0355,67,16,83,11,94,221,42.53%,30.32%,1
南投縣,中寮鄉,0356,113,37,150,6,156,353,44.19%,32.01%,1
南投縣,中寮鄉,0357,163,44,207,29,236,427,55.27%,38.17%,1
南投縣,中寮鄉,0358,164,45,209,18,227,406,55.91%,40.39%,1
南投縣,中寮鄉,0359,101,39,140,20,160,307,52.12%,32.9%,1
南投縣,中寮鄉,0360,290,75,365,36,401,661,60.67%,43.87%,1
南投縣,中寮鄉,0361,137,36,173,20,193,290,66.55%,47.24%,1
南投縣,中寮鄉,0362,400,129,529,41,570,973,58.58%,41.11%,1
南投縣,中寮鄉,0363,328,92,420,32,452,754,59.95%,43.5%,1
南投縣,中寮鄉,0364,267,75,342,26,368,662,55.59%,40.33%,1
南投縣,中寮鄉,0365,172,44,216,11,227,490,46.33%,35.1%,1
南投縣,中寮鄉,0366,120,39,159,16,175,335,52.24%,35.82%,1
南投縣,中寮鄉,0367,434,97,531,44,575,990,58.08%,43.84%,1
南投縣,中寮鄉,0368,202,67,269,20,289,461,62.69%,43.82%,1
南投縣,中寮鄉,0369,262,87,349,32,381,614,62.05%,42.67%,1
南投縣,中寮鄉,0370,336,112,448,67,515,895,57.54%,37.54%,1
南投縣,中寮鄉,0371,172,53,225,40,265,465,56.99%,36.99%,1
南投縣,中寮鄉,0372,267,78,345,57,402,682,58.94%,39.15%,1
南投縣,中寮鄉,0373,208,50,258,45,303,490,61.84%,42.45%,1
南投縣,中寮鄉,0374,260,79,339,56,395,643,61.43%,40.44%,1
南投縣,中寮鄉,0375,210,54,264,20,284,459,61.87%,45.75%,1
南投縣,中寮鄉,0376,182,58,240,25,265,528,50.19%,34.47%,1
南投縣,魚池鄉,0377,382,109,491,41,532,922,57.7%,41.43%,1
南投縣,魚池鄉,0378,465,124,589,54,643,1098,58.56%,42.35%,1
南投縣,魚池鄉,0379,275,73,348,36,384,720,53.33%,38.19%,1
南投縣,魚池鄉,0380,369,95,464,44,508,860,59.07%,42.91%,1
南投縣,魚池鄉,0381,170,51,221,40,261,514,50.78%,33.07%,1
南投縣,魚池鄉,0382,215,60,275,10,285,574,49.65%,37.46%,1
南投縣,魚池鄉,0383,469,147,616,56,672,1249,53.8%,37.55%,1
南投縣,魚池鄉,0384,142,35,177,15,192,293,65.53%,48.46%,1
南投縣,魚池鄉,0385,183,68,251,27,278,513,54.19%,35.67%,1
南投縣,魚池鄉,0386,69,25,94,8,102,186,54.84%,37.1%,1
南投縣,魚池鄉,0387,308,93,401,29,430,841,51.13%,36.62%,1
南投縣,魚池鄉,0388,115,33,148,21,169,270,62.59%,42.59%,1
南投縣,魚池鄉,0389,102,31,133,19,152,275,55.27%,37.09%,1
南投縣,魚池鄉,0390,89,26,115,14,129,282,45.74%,31.56%,1
南投縣,魚池鄉,0391,133,36,169,15,184,392,46.94%,33.93%,1
南投縣,魚池鄉,0392,215,62,277,27,304,556,54.68%,38.67%,1
南投縣,魚池鄉,0393,71,15,86,10,96,176,54.55%,40.34%,1
南投縣,魚池鄉,0394,202,47,249,24,273,578,47.23%,34.95%,1
南投縣,魚池鄉,0395,147,57,204,19,223,439,50.8%,33.49%,1
南投縣,魚池鄉,0396,392,73,465,32,497,844,58.89%,46.45%,1
南投縣,魚池鄉,0397,340,88,428,38,466,868,53.69%,39.17%,1
南投縣,魚池鄉,0398,144,28,172,18,190,405,46.91%,35.56%,1
南投縣,魚池鄉,0399,216,68,284,21,305,537,56.8%,40.22%,1
南投縣,魚池鄉,0400,131,29,160,24,184,335,54.93%,39.1%,1
南投縣,魚池鄉,0401,74,15,89,15,104,231,45.02%,32.03%,1
南投縣,國姓鄉,0402,433,95,528,73,601,964,62.34%,44.92%,1
南投縣,國姓鄉,0403,308,84,392,23,415,736,56.39%,41.85%,1
南投縣,國姓鄉,0404,347,68,415,54,469,801,58.55%,43.32%,1
南投縣,國姓鄉,0405,411,89,500,27,527,964,54.67%,42.63%,1
南投縣,國姓鄉,0406,286,69,355,29,384,686,55.98%,41.69%,1
南投縣,國姓鄉,0407,277,52,329,33,362,661,54.77%,41.91%,1
南投縣,國姓鄉,0408,281,51,332,50,382,730,52.33%,38.49%,1
南投縣,國姓鄉,0409,272,101,373,61,434,774,56.07%,35.14%,1
南投縣,國姓鄉,0410,315,93,408,15,423,706,59.92%,44.62%,1
南投縣,國姓鄉,0411,405,134,539,43,582,1012,57.51%,40.02%,1
南投縣,國姓鄉,0412,274,89,363,29,392,868,45.16%,31.57%,1
南投縣,國姓鄉,0413,462,74,536,26,562,918,61.22%,50.33%,1
南投縣,國姓鄉,0414,380,102,482,52,534,937,56.99%,40.55%,1
南投縣,國姓鄉,0415,311,93,404,55,459,815,56.32%,38.16%,1
南投縣,國姓鄉,0416,352,278,630,50,680,1134,59.96%,31.04%,1
南投縣,國姓鄉,0417,257,77,334,25,359,714,50.28%,35.99%,1
南投縣,國姓鄉,0418,438,119,557,57,614,1095,56.07%,40%,1
南投縣,國姓鄉,0419,162,49,211,26,237,448,52.9%,36.16%,1
南投縣,國姓鄉,0420,424,99,523,48,571,1064,53.67%,39.85%,1
南投縣,國姓鄉,0421,226,45,271,26,297,570,52.11%,39.65%,1
南投縣,水里鄉,0422,310,79,389,34,423,757,55.88%,40.95%,1
南投縣,水里鄉,0423,222,58,280,34,314,554,56.68%,40.07%,1
南投縣,水里鄉,0424,389,141,530,47,577,999,57.76%,38.94%,1
南投縣,水里鄉,0425,235,59,294,20,314,616,50.97%,38.15%,1
南投縣,水里鄉,0426,389,89,478,32,510,875,58.29%,44.46%,1
南投縣,水里鄉,0427,214,58,272,10,282,480,58.75%,44.58%,1
南投縣,水里鄉,0428,183,39,222,24,246,450,54.67%,40.67%,1
南投縣,水里鄉,0429,250,65,315,39,354,643,55.05%,38.88%,1
南投縣,水里鄉,0430,435,122,557,29,586,1004,58.37%,43.33%,1
南投縣,水里鄉,0431,304,67,371,25,396,741,53.44%,41.03%,1
南投縣,水里鄉,0432,324,124,448,22,470,802,58.6%,40.4%,1
南投縣,水里鄉,0433,453,139,592,48,640,998,64.13%,45.39%,1
南投縣,水里鄉,0434,288,91,379,60,439,800,54.88%,36%,1
南投縣,水里鄉,0435,249,91,340,24,364,589,61.8%,42.28%,1
南投縣,水里鄉,0436,316,101,417,48,465,887,52.42%,35.63%,1
南投縣,水里鄉,0437,463,115,578,54,632,1217,51.93%,38.04%,1
南投縣,水里鄉,0438,55,11,66,7,73,205,35.61%,26.83%,1
南投縣,水里鄉,0439,161,27,188,21,209,330,63.33%,48.79%,1
南投縣,水里鄉,0440,420,109,529,32,561,1100,51%,38.18%,1
南投縣,水里鄉,0441,68,18,86,5,91,275,33.09%,24.73%,1
南投縣,水里鄉,0442,98,25,123,5,128,318,40.25%,30.82%,1
南投縣,水里鄉,0443,289,100,389,54,443,818,54.16%,35.33%,1
南投縣,信義鄉,0444,457,117,574,107,681,1201,56.7%,38.05%,1
南投縣,信義鄉,0445,116,29,145,20,165,329,50.15%,35.26%,1
南投縣,信義鄉,0446,173,67,240,24,264,516,51.16%,33.53%,1
南投縣,信義鄉,0447,136,33,169,22,191,424,45.05%,32.08%,1
南投縣,信義鄉,0448,121,23,144,7,151,321,47.04%,37.69%,1
南投縣,信義鄉,0449,281,65,346,33,379,648,58.49%,43.36%,1
南投縣,信義鄉,0450,261,67,328,96,424,584,72.6%,44.69%,1
南投縣,信義鄉,0451,277,54,331,15,346,1376,25.15%,20.13%,1
南投縣,信義鄉,0452,306,81,387,32,419,979,42.8%,31.26%,1
南投縣,信義鄉,0453,225,83,308,82,390,530,73.58%,42.45%,1
南投縣,信義鄉,0454,342,94,436,47,483,961,50.26%,35.59%,1
南投縣,信義鄉,0455,198,38,236,19,255,464,54.96%,42.67%,1
南投縣,信義鄉,0456,209,60,269,34,303,517,58.61%,40.43%,1
南投縣,信義鄉,0457,62,17,79,8,87,149,58.39%,41.61%,1
南投縣,信義鄉,0458,458,143,601,159,760,1020,74.51%,44.9%,1
南投縣,信義鄉,0459,367,98,465,172,637,929,68.57%,39.5%,1
南投縣,信義鄉,0460,81,27,108,15,123,274,44.89%,29.56%,1
南投縣,信義鄉,0461,469,93,562,69,631,900,70.11%,52.11%,1
南投縣,信義鄉,0462,297,94,391,60,451,617,73.1%,48.14%,1
南投縣,信義鄉,0463,242,70,312,34,346,560,61.79%,43.21%,1
南投縣,仁愛鄉,0464,400,92,492,29,521,973,53.55%,41.11%,1
南投縣,仁愛鄉,0465,111,29,140,10,150,296,50.68%,37.5%,1
南投縣,仁愛鄉,0466,325,61,386,15,401,900,44.56%,36.11%,1
南投縣,仁愛鄉,0467,223,55,278,20,298,460,64.78%,48.48%,1
南投縣,仁愛鄉,0468,135,36,171,12,183,305,60%,44.26%,1
南投縣,仁愛鄉,0469,15,2,17,3,20,58,34.48%,25.86%,1
南投縣,仁愛鄉,0470,288,63,351,15,366,952,38.45%,30.25%,1
南投縣,仁愛鄉,0471,195,35,230,6,236,679,34.76%,28.72%,1
南投縣,仁愛鄉,0472,251,62,313,56,369,623,59.23%,40.29%,1
南投縣,仁愛鄉,0473,123,34,157,5,162,597,27.14%,20.6%,1
南投縣,仁愛鄉,0474,188,34,222,25,247,384,64.32%,48.96%,1
南投縣,仁愛鄉,0475,47,10,57,5,62,121,51.24%,38.84%,1
南投縣,仁愛鄉,0476,109,15,124,6,130,264,49.24%,41.29%,1
南投縣,仁愛鄉,0477,271,71,342,39,381,509,74.85%,53.24%,1
南投縣,仁愛鄉,0478,122,53,175,32,207,338,61.24%,36.09%,1
南投縣,仁愛鄉,0479,71,12,83,9,92,169,54.44%,42.01%,1
南投縣,仁愛鄉,0480,219,47,266,27,293,613,47.8%,35.73%,1
南投縣,仁愛鄉,0481,133,41,174,16,190,404,47.03%,32.92%,1
南投縣,仁愛鄉,0482,59,14,73,4,77,134,57.46%,44.03%,1
南投縣,仁愛鄉,0483,232,96,328,62,390,630,61.9%,36.83%,1
南投縣,仁愛鄉,0484,221,59,280,15,295,763,38.66%,28.96%,1
南投縣,仁愛鄉,0485,458,66,524,40,564,889,63.44%,51.52%,1
南投縣,仁愛鄉,0486,306,83,389,49,438,672,65.18%,45.54%,1
南投縣,仁愛鄉,0487,200,49,249,23,272,447,60.85%,44.74%,1
南投縣,仁愛鄉,0488,251,39,290,12,302,409,73.84%,61.37%,1
雲林縣,斗六市,0411,240,81,321,14,335,644,52.02%,37.27%,1
雲林縣,斗六市,0412,226,85,311,30,341,617,55.27%,36.63%,1
雲林縣,斗六市,0413,362,106,468,35,503,764,65.84%,47.38%,1
雲林縣,斗六市,0414,319,134,453,34,487,784,62.12%,40.69%,1
雲林縣,斗六市,0415,284,126,410,29,439,760,57.76%,37.37%,1
雲林縣,斗六市,0416,817,240,1057,78,1135,1881,60.34%,43.43%,1
雲林縣,斗六市,0417,695,235,930,67,997,1829,54.51%,38%,1
雲林縣,斗六市,0418,565,166,731,40,771,1255,61.43%,45.02%,1
雲林縣,斗六市,0419,563,105,668,35,703,1090,64.5%,51.65%,1
雲林縣,斗六市,0420,502,125,627,46,673,1103,61.02%,45.51%,1
雲林縣,斗六市,0421,530,127,657,47,704,1176,59.86%,45.07%,1
雲林縣,斗六市,0422,640,180,820,28,848,1529,55.46%,41.86%,1
雲林縣,斗六市,0423,613,139,752,43,795,1335,59.55%,45.92%,1
雲林縣,斗六市,0424,747,222,969,70,1039,1770,58.7%,42.2%,1
雲林縣,斗六市,0425,523,187,710,34,744,1308,56.88%,39.98%,1
雲林縣,斗六市,0426,825,261,1086,87,1173,2171,54.03%,38%,1
雲林縣,斗六市,0427,513,146,659,44,703,1193,58.93%,43%,1
雲林縣,斗六市,0428,708,204,912,66,978,1572,62.21%,45.04%,1
雲林縣,斗六市,0429,415,105,520,34,554,1009,54.91%,41.13%,1
雲林縣,斗六市,0430,553,145,698,44,742,1195,62.09%,46.28%,1
雲林縣,斗六市,0431,489,300,789,72,861,1415,60.85%,34.56%,1
雲林縣,斗六市,0432,470,163,633,32,665,1101,60.4%,42.69%,1
雲林縣,斗六市,0433,642,193,835,34,869,1648,52.73%,38.96%,1
雲林縣,斗六市,0434,614,150,764,37,801,1588,50.44%,38.66%,1
雲林縣,斗六市,0435,625,156,781,38,819,1392,58.84%,44.9%,1
雲林縣,斗六市,0436,634,159,793,38,831,1422,58.44%,44.59%,1
雲林縣,斗六市,0437,422,105,527,33,560,1187,47.18%,35.55%,1
雲林縣,斗六市,0438,430,150,580,37,617,1142,54.03%,37.65%,1
雲林縣,斗六市,0439,651,177,828,47,875,1421,61.58%,45.81%,1
雲林縣,斗六市,0440,523,165,688,29,717,1261,56.86%,41.48%,1
雲林縣,斗六市,0441,554,194,748,38,786,1506,52.19%,36.79%,1
雲林縣,斗六市,0442,529,143,672,37,709,1214,58.4%,43.57%,1
雲林縣,斗六市,0443,708,194,902,66,968,1362,71.07%,51.98%,1
雲林縣,斗六市,0444,447,122,569,24,593,1097,54.06%,40.75%,1
雲林縣,斗六市,0445,538,145,683,36,719,1262,56.97%,42.63%,1
雲林縣,斗六市,0446,476,121,597,36,633,1154,54.85%,41.25%,1
雲林縣,斗六市,0447,362,99,461,44,505,847,59.62%,42.74%,1
雲林縣,斗六市,0448,621,172,793,32,825,1439,57.33%,43.15%,1
雲林縣,斗六市,0449,766,223,989,73,1062,1747,60.79%,43.85%,1
雲林縣,斗六市,0450,604,162,766,48,814,1418,57.4%,42.6%,1
雲林縣,斗六市,0451,453,132,585,45,630,1112,56.65%,40.74%,1
雲林縣,斗六市,0452,568,135,703,50,753,1302,57.83%,43.63%,1
雲林縣,斗六市,0453,298,101,399,27,426,669,63.68%,44.54%,1
雲林縣,斗六市,0454,316,73,389,37,426,752,56.65%,42.02%,1
雲林縣,斗六市,0455,582,159,741,28,769,1450,53.03%,40.14%,1
雲林縣,斗六市,0456,212,65,277,42,319,555,57.48%,38.2%,1
雲林縣,斗六市,0457,571,147,718,47,765,1470,52.04%,38.84%,1
雲林縣,斗六市,0458,417,125,542,24,566,927,61.06%,44.98%,1
雲林縣,斗六市,0459,835,212,1047,58,1105,1893,58.37%,44.11%,1
雲林縣,斗六市,0460,645,228,873,109,982,1708,57.49%,37.76%,1
雲林縣,斗六市,0461,637,184,821,51,872,1773,49.18%,35.93%,1
雲林縣,斗六市,0462,616,170,786,51,837,1412,59.28%,43.63%,1
雲林縣,斗六市,0463,701,94,795,36,831,1354,61.37%,51.77%,1
雲林縣,斗六市,0464,502,156,658,35,693,1267,54.7%,39.62%,1
雲林縣,斗六市,0465,485,164,649,31,680,1273,53.42%,38.1%,1
雲林縣,斗六市,0466,652,167,819,90,909,1748,52%,37.3%,1
雲林縣,斗六市,0467,503,154,657,70,727,1238,58.72%,40.63%,1
雲林縣,斗六市,0468,635,181,816,96,912,1648,55.34%,38.53%,1
雲林縣,斗六市,0469,632,219,851,65,916,1520,60.26%,41.58%,1
雲林縣,斗六市,0470,407,114,521,38,559,1087,51.43%,37.44%,1
雲林縣,斗六市,0471,792,219,1011,77,1088,1904,57.14%,41.6%,1
雲林縣,斗六市,0472,305,80,385,39,424,702,60.4%,43.45%,1
雲林縣,斗六市,0473,443,157,600,46,646,1111,58.15%,39.87%,1
雲林縣,斗六市,0474,374,127,501,33,534,1123,47.55%,33.3%,1
雲林縣,斗六市,0475,434,115,549,32,581,1146,50.7%,37.87%,1
雲林縣,斗六市,0476,677,209,886,47,933,1786,52.24%,37.91%,1
雲林縣,斗六市,0477,383,152,535,51,586,1023,57.28%,37.44%,1
雲林縣,斗六市,0478,788,261,1049,94,1143,2072,55.16%,38.03%,1
雲林縣,斗六市,0479,405,142,547,27,574,1128,50.89%,35.9%,1
雲林縣,斗南鎮,0498,508,134,642,45,687,1166,58.92%,43.57%,1
雲林縣,斗南鎮,0499,494,151,645,38,683,1135,60.18%,43.52%,1
雲林縣,斗南鎮,0500,447,117,564,38,602,975,61.74%,45.85%,1
雲林縣,斗南鎮,0501,629,177,806,49,855,1459,58.6%,43.11%,1
雲林縣,斗南鎮,0502,559,180,739,53,792,1351,58.62%,41.38%,1
雲林縣,斗南鎮,0503,527,148,675,58,733,1321,55.49%,39.89%,1
雲林縣,斗南鎮,0504,342,104,446,51,497,907,54.8%,37.71%,1
雲林縣,斗南鎮,0505,651,189,840,83,923,1473,62.66%,44.2%,1
雲林縣,斗南鎮,0506,523,212,735,67,802,1277,62.8%,40.96%,1
雲林縣,斗南鎮,0507,475,161,636,98,734,1333,55.06%,35.63%,1
雲林縣,斗南鎮,0508,296,72,368,41,409,777,52.64%,38.1%,1
雲林縣,斗南鎮,0509,327,112,439,40,479,877,54.62%,37.29%,1
雲林縣,斗南鎮,0510,338,105,443,50,493,899,54.84%,37.6%,1
雲林縣,斗南鎮,0511,197,75,272,41,313,688,45.49%,28.63%,1
雲林縣,斗南鎮,0512,397,112,509,29,538,1147,46.9%,34.61%,1
雲林縣,斗南鎮,0513,619,235,854,91,945,1709,55.3%,36.22%,1
雲林縣,斗南鎮,0514,445,143,588,45,633,1042,60.75%,42.71%,1
雲林縣,斗南鎮,0515,591,214,805,70,875,1631,53.65%,36.24%,1
雲林縣,斗南鎮,0516,716,217,933,94,1027,1702,60.34%,42.07%,1
雲林縣,斗南鎮,0517,625,218,843,69,912,1564,58.31%,39.96%,1
雲林縣,斗南鎮,0518,304,81,385,34,419,910,46.04%,33.41%,1
雲林縣,斗南鎮,0519,549,171,720,50,770,1276,60.34%,43.03%,1
雲林縣,斗南鎮,0520,300,68,368,23,391,897,43.59%,33.44%,1
雲林縣,斗南鎮,0521,305,79,384,44,428,803,53.3%,37.98%,1
雲林縣,斗南鎮,0522,355,102,457,46,503,866,58.08%,40.99%,1
雲林縣,斗南鎮,0523,319,123,442,60,502,852,58.92%,37.44%,1
雲林縣,斗南鎮,0524,243,84,327,52,379,671,56.48%,36.21%,1
雲林縣,斗南鎮,0525,357,121,478,29,507,981,51.68%,36.39%,1
雲林縣,斗南鎮,0526,362,131,493,35,528,1129,46.77%,32.06%,1
雲林縣,斗南鎮,0527,647,184,831,106,937,1586,59.08%,40.79%,1
雲林縣,斗南鎮,0528,530,155,685,72,757,1243,60.9%,42.64%,1
雲林縣,斗南鎮,0529,338,108,446,25,471,984,47.87%,34.35%,1
雲林縣,斗南鎮,0530,554,180,734,77,811,1507,53.82%,36.76%,1
雲林縣,虎尾鎮,0109,549,140,689,55,744,1347,55.23%,40.76%,1
雲林縣,虎尾鎮,0110,513,178,691,48,739,1258,58.74%,40.78%,1
雲林縣,虎尾鎮,0111,288,108,396,30,426,785,54.27%,36.69%,1
雲林縣,虎尾鎮,0112,295,97,392,46,438,890,49.21%,33.15%,1
雲林縣,虎尾鎮,0113,571,186,757,53,810,1413,57.32%,40.41%,1
雲林縣,虎尾鎮,0114,634,181,815,56,871,1431,60.87%,44.3%,1
雲林縣,虎尾鎮,0115,439,152,591,66,657,1224,53.68%,35.87%,1
雲林縣,虎尾鎮,0116,532,70,602,42,644,1325,48.6%,40.15%,1
雲林縣,虎尾鎮,0117,372,125,497,71,568,941,60.36%,39.53%,1
雲林縣,虎尾鎮,0118,686,142,828,27,855,1613,53.01%,42.53%,1
雲林縣,虎尾鎮,0119,579,198,777,44,821,1641,50.03%,35.28%,1
雲林縣,虎尾鎮,0120,539,126,665,46,711,1200,59.25%,44.92%,1
雲林縣,虎尾鎮,0121,489,186,675,78,753,1294,58.19%,37.79%,1
雲林縣,虎尾鎮,0122,516,154,670,43,713,1273,56.01%,40.53%,1
雲林縣,虎尾鎮,0123,640,173,813,41,854,1438,59.39%,44.51%,1
雲林縣,虎尾鎮,0124,591,148,739,39,778,1361,57.16%,43.42%,1
雲林縣,虎尾鎮,0125,628,197,825,45,870,1444,60.25%,43.49%,1
雲林縣,虎尾鎮,0126,667,216,883,45,928,1490,62.28%,44.77%,1
雲林縣,虎尾鎮,0127,605,186,791,44,835,1307,63.89%,46.29%,1
雲林縣,虎尾鎮,0128,345,117,462,22,484,967,50.05%,35.68%,1
雲林縣,虎尾鎮,0129,713,199,912,41,953,1865,51.1%,38.23%,1
雲林縣,虎尾鎮,0130,724,243,967,51,1018,1880,54.15%,38.51%,1
雲林縣,虎尾鎮,0131,381,138,519,48,567,1099,51.59%,34.67%,1
雲林縣,虎尾鎮,0132,356,113,469,19,488,901,54.16%,39.51%,1
雲林縣,虎尾鎮,0133,427,114,541,30,571,1120,50.98%,38.13%,1
雲林縣,虎尾鎮,0134,185,46,231,11,242,545,44.4%,33.94%,1
雲林縣,虎尾鎮,0135,512,170,682,67,749,1420,52.75%,36.06%,1
雲林縣,虎尾鎮,0136,424,133,557,6,563,1248,45.11%,33.97%,1
雲林縣,虎尾鎮,0137,292,97,389,28,417,799,52.19%,36.55%,1
雲林縣,虎尾鎮,0138,275,106,381,64,445,836,53.23%,32.89%,1
雲林縣,虎尾鎮,0139,296,94,390,56,446,924,48.27%,32.03%,1
雲林縣,虎尾鎮,0140,486,171,657,38,695,1648,42.17%,29.49%,1
雲林縣,虎尾鎮,0141,466,195,661,111,772,1616,47.77%,28.84%,1
雲林縣,虎尾鎮,0142,520,199,719,58,777,1546,50.26%,33.64%,1
雲林縣,虎尾鎮,0143,459,126,585,42,627,1283,48.87%,35.78%,1
雲林縣,虎尾鎮,0144,360,121,481,36,517,1078,47.96%,33.4%,1
雲林縣,虎尾鎮,0145,418,133,551,48,599,1313,45.62%,31.84%,1
雲林縣,虎尾鎮,0146,410,141,551,44,595,1284,46.34%,31.93%,1
雲林縣,虎尾鎮,0147,477,156,633,95,728,1356,53.69%,35.18%,1
雲林縣,虎尾鎮,0148,567,145,712,97,809,1504,53.79%,37.7%,1
雲林縣,虎尾鎮,0149,391,112,503,39,542,1224,44.28%,31.94%,1
雲林縣,虎尾鎮,0150,509,139,648,59,707,1509,46.85%,33.73%,1
雲林縣,虎尾鎮,0151,189,109,298,65,363,855,42.46%,22.11%,1
雲林縣,虎尾鎮,0152,460,170,630,88,718,1549,46.35%,29.7%,1
雲林縣,虎尾鎮,0153,273,84,357,30,387,851,45.48%,32.08%,1
雲林縣,虎尾鎮,0154,450,107,557,76,633,1272,49.76%,35.38%,1
雲林縣,西螺鎮,0340,547,185,732,68,800,1590,50.31%,34.4%,1
雲林縣,西螺鎮,0341,691,189,880,101,981,1741,56.35%,39.69%,1
雲林縣,西螺鎮,0342,502,127,629,68,697,1080,64.54%,46.48%,1
雲林縣,西螺鎮,0343,447,136,583,65,648,1040,62.31%,42.98%,1
雲林縣,西螺鎮,0344,541,162,703,39,742,1346,55.13%,40.19%,1
雲林縣,西螺鎮,0345,621,201,822,57,879,1625,54.09%,38.22%,1
雲林縣,西螺鎮,0346,156,35,191,27,218,354,61.58%,44.07%,1
雲林縣,西螺鎮,0347,196,78,274,45,319,580,55%,33.79%,1
雲林縣,西螺鎮,0348,243,93,336,37,373,591,63.11%,41.12%,1
雲林縣,西螺鎮,0349,413,139,552,67,619,1050,58.95%,39.33%,1
雲林縣,西螺鎮,0350,460,180,640,66,706,1147,61.55%,40.1%,1
雲林縣,西螺鎮,0351,584,196,780,81,861,1602,53.75%,36.45%,1
雲林縣,西螺鎮,0352,520,171,691,60,751,1452,51.72%,35.81%,1
雲林縣,西螺鎮,0353,575,204,779,107,886,1578,56.15%,36.44%,1
雲林縣,西螺鎮,0354,492,125,617,32,649,1305,49.73%,37.7%,1
雲林縣,西螺鎮,0355,430,124,554,46,600,1327,45.21%,32.4%,1
雲林縣,西螺鎮,0356,523,188,711,70,781,1516,51.52%,34.5%,1
雲林縣,西螺鎮,0357,227,75,302,26,328,828,39.61%,27.42%,1
雲林縣,西螺鎮,0358,190,64,254,26,280,788,35.53%,24.11%,1
雲林縣,西螺鎮,0359,261,112,373,76,449,863,52.03%,30.24%,1
雲林縣,西螺鎮,0360,294,131,425,93,518,984,52.64%,29.88%,1
雲林縣,西螺鎮,0361,470,176,646,164,810,1514,53.5%,31.04%,1
雲林縣,西螺鎮,0362,269,123,392,71,463,870,53.22%,30.92%,1
雲林縣,西螺鎮,0363,350,105,455,61,516,971,53.14%,36.05%,1
雲林縣,西螺鎮,0364,385,144,529,54,583,1304,44.71%,29.52%,1
雲林縣,西螺鎮,0365,247,62,309,36,345,726,47.52%,34.02%,1
雲林縣,西螺鎮,0366,308,89,397,52,449,823,54.56%,37.42%,1
雲林縣,西螺鎮,0367,250,74,324,21,345,886,38.94%,28.22%,1
雲林縣,西螺鎮,0368,432,150,582,102,684,1373,49.82%,31.46%,1
雲林縣,西螺鎮,0369,345,121,466,68,534,983,54.32%,35.1%,1
雲林縣,西螺鎮,0370,382,109,491,54,545,1014,53.75%,37.67%,1
雲林縣,西螺鎮,0371,276,110,386,87,473,939,50.37%,29.39%,1
雲林縣,西螺鎮,0372,274,103,377,47,424,866,48.96%,31.64%,1
雲林縣,西螺鎮,0373,451,166,617,112,729,1486,49.06%,30.35%,1
雲林縣,土庫鎮,0080,336,119,455,58,513,809,63.41%,41.53%,1
雲林縣,土庫鎮,0081,347,131,478,58,536,896,59.82%,38.73%,1
雲林縣,土庫鎮,0082,252,96,348,48,396,687,57.64%,36.68%,1
雲林縣,土庫鎮,0083,337,99,436,34,470,702,66.95%,48.01%,1
雲林縣,土庫鎮,0084,466,127,593,42,635,1032,61.53%,45.16%,1
雲林縣,土庫鎮,0085,222,77,299,70,369,697,52.94%,31.85%,1
雲林縣,土庫鎮,0086,146,46,192,32,224,427,52.46%,34.19%,1
雲林縣,土庫鎮,0087,580,189,769,71,840,1451,57.89%,39.97%,1
雲林縣,土庫鎮,0088,517,166,683,36,719,1283,56.04%,40.3%,1
雲林縣,土庫鎮,0089,192,73,265,14,279,634,44.01%,30.28%,1
雲林縣,土庫鎮,0090,275,101,376,45,421,796,52.89%,34.55%,1
雲林縣,土庫鎮,0091,200,85,285,48,333,745,44.7%,26.85%,1
雲林縣,土庫鎮,0092,190,78,268,20,288,576,50%,32.99%,1
雲林縣,土庫鎮,0093,227,70,297,59,356,743,47.91%,30.55%,1
雲林縣,土庫鎮,0094,166,56,222,15,237,534,44.38%,31.09%,1
雲林縣,土庫鎮,0095,330,133,463,83,546,1199,45.54%,27.52%,1
雲林縣,土庫鎮,0096,335,130,465,74,539,1077,50.05%,31.1%,1
雲林縣,土庫鎮,0097,232,67,299,34,333,819,40.66%,28.33%,1
雲林縣,土庫鎮,0098,239,83,322,44,366,684,53.51%,34.94%,1
雲林縣,土庫鎮,0099,300,95,395,61,456,843,54.09%,35.59%,1
雲林縣,土庫鎮,0100,305,99,404,82,486,916,53.06%,33.3%,1
雲林縣,土庫鎮,0101,291,111,402,63,465,948,49.05%,30.7%,1
雲林縣,土庫鎮,0102,316,95,411,40,451,914,49.34%,34.57%,1
雲林縣,土庫鎮,0103,312,75,387,76,463,860,53.84%,36.28%,1
雲林縣,土庫鎮,0104,296,112,408,63,471,929,50.7%,31.86%,1
雲林縣,土庫鎮,0105,259,89,348,69,417,875,47.66%,29.6%,1
雲林縣,土庫鎮,0106,249,65,314,46,360,896,40.18%,27.79%,1
雲林縣,土庫鎮,0107,214,69,283,58,341,757,45.05%,28.27%,1
雲林縣,土庫鎮,0108,198,81,279,47,326,683,47.73%,28.99%,1
雲林縣,北港鎮,0256,257,95,352,75,427,724,58.98%,35.5%,1
雲林縣,北港鎮,0257,274,91,365,68,433,688,62.94%,39.83%,1
雲林縣,北港鎮,0258,164,53,217,48,265,452,58.63%,36.28%,1
雲林縣,北港鎮,0259,323,108,431,78,509,866,58.78%,37.3%,1
雲林縣,北港鎮,0260,104,47,151,26,177,336,52.68%,30.95%,1
雲林縣,北港鎮,0261,147,34,181,34,215,395,54.43%,37.22%,1
雲林縣,北港鎮,0262,160,44,204,33,237,376,63.03%,42.55%,1
雲林縣,北港鎮,0263,361,126,487,58,545,950,57.37%,38%,1
雲林縣,北港鎮,0264,197,72,269,50,319,512,62.3%,38.48%,1
雲林縣,北港鎮,0265,130,35,165,33,198,324,61.11%,40.12%,1
雲林縣,北港鎮,0266,188,74,262,36,298,546,54.58%,34.43%,1
雲林縣,北港鎮,0267,171,57,228,30,258,433,59.58%,39.49%,1
雲林縣,北港鎮,0268,263,102,365,66,431,751,57.39%,35.02%,1
雲林縣,北港鎮,0269,189,49,238,35,273,442,61.76%,42.76%,1
雲林縣,北港鎮,0270,442,152,594,72,666,1151,57.86%,38.4%,1
雲林縣,北港鎮,0271,480,163,643,56,699,1224,57.11%,39.22%,1
雲林縣,北港鎮,0272,444,139,583,63,646,1211,53.34%,36.66%,1
雲林縣,北港鎮,0273,499,166,665,91,756,1326,57.01%,37.63%,1
雲林縣,北港鎮,0274,331,100,431,47,478,744,64.25%,44.49%,1
雲林縣,北港鎮,0275,453,114,567,60,627,977,64.18%,46.37%,1
雲林縣,北港鎮,0276,340,119,459,66,525,960,54.69%,35.42%,1
雲林縣,北港鎮,0277,115,47,162,9,171,494,34.62%,23.28%,1
雲林縣,北港鎮,0278,565,162,727,59,786,1364,57.62%,41.42%,1
雲林縣,北港鎮,0279,454,127,581,71,652,1123,58.06%,40.43%,1
雲林縣,北港鎮,0280,567,186,753,66,819,1451,56.44%,39.08%,1
雲林縣,北港鎮,0281,457,145,602,90,692,1162,59.55%,39.33%,1
雲林縣,北港鎮,0282,374,162,536,50,586,1130,51.86%,33.1%,1
雲林縣,北港鎮,0283,398,119,517,51,568,1149,49.43%,34.64%,1
雲林縣,北港鎮,0284,148,53,201,39,240,533,45.03%,27.77%,1
雲林縣,北港鎮,0285,177,69,246,25,271,433,62.59%,40.88%,1
雲林縣,北港鎮,0286,135,25,160,18,178,377,47.21%,35.81%,1
雲林縣,北港鎮,0287,241,83,324,24,348,809,43.02%,29.79%,1
雲林縣,北港鎮,0288,426,128,554,88,642,1397,45.96%,30.49%,1
雲林縣,北港鎮,0289,320,111,431,100,531,1145,46.38%,27.95%,1
雲林縣,北港鎮,0290,173,66,239,75,314,828,37.92%,20.89%,1
雲林縣,北港鎮,0291,148,47,195,24,219,557,39.32%,26.57%,1
雲林縣,北港鎮,0292,300,147,447,52,499,1060,47.08%,28.3%,1
雲林縣,北港鎮,0293,174,70,244,34,278,577,48.18%,30.16%,1
雲林縣,北港鎮,0294,249,85,334,72,406,931,43.61%,26.75%,1
雲林縣,北港鎮,0295,375,119,494,45,539,1018,52.95%,36.84%,1
雲林縣,北港鎮,0296,384,135,519,29,548,1032,53.1%,37.21%,1
雲林縣,古坑鄉,0531,407,134,541,76,617,1126,54.8%,36.15%,1
雲林縣,古坑鄉,0532,359,101,460,62,522,994,52.52%,36.12%,1
雲林縣,古坑鄉,0533,498,196,694,59,753,1517,49.64%,32.83%,1
雲林縣,古坑鄉,0534,479,156,635,57,692,1302,53.15%,36.79%,1
雲林縣,古坑鄉,0535,652,159,811,56,867,1772,48.93%,36.79%,1
雲林縣,古坑鄉,0536,442,120,562,84,646,1122,57.58%,39.39%,1
雲林縣,古坑鄉,0537,64,24,88,5,93,304,30.59%,21.05%,1
雲林縣,古坑鄉,0538,472,123,595,84,679,1169,58.08%,40.38%,1
雲林縣,古坑鄉,0539,407,148,555,100,655,1255,52.19%,32.43%,1
雲林縣,古坑鄉,0540,455,141,596,56,652,1078,60.48%,42.21%,1
雲林縣,古坑鄉,0541,330,84,414,26,440,943,46.66%,34.99%,1
雲林縣,古坑鄉,0542,460,129,589,79,668,1300,51.38%,35.38%,1
雲林縣,古坑鄉,0543,323,99,422,59,481,964,49.9%,33.51%,1
雲林縣,古坑鄉,0544,439,120,559,58,617,1144,53.93%,38.37%,1
雲林縣,古坑鄉,0545,563,145,708,78,786,1482,53.04%,37.99%,1
雲林縣,古坑鄉,0546,277,69,346,39,385,688,55.96%,40.26%,1
雲林縣,古坑鄉,0547,341,103,444,45,489,998,49%,34.17%,1
雲林縣,古坑鄉,0548,463,130,593,58,651,1140,57.11%,40.61%,1
雲林縣,古坑鄉,0549,404,129,533,56,589,1102,53.45%,36.66%,1
雲林縣,古坑鄉,0550,345,121,466,31,497,956,51.99%,36.09%,1
雲林縣,古坑鄉,0551,236,94,330,31,361,695,51.94%,33.96%,1
雲林縣,古坑鄉,0552,420,119,539,29,568,1233,46.07%,34.06%,1
雲林縣,古坑鄉,0553,65,33,98,9,107,285,37.54%,22.81%,1
雲林縣,古坑鄉,0554,198,51,249,16,265,734,36.1%,26.98%,1
雲林縣,古坑鄉,0555,390,163,553,80,633,1150,55.04%,33.91%,1
雲林縣,古坑鄉,0556,149,56,205,25,230,453,50.77%,32.89%,1
雲林縣,古坑鄉,0557,192,54,246,31,277,571,48.51%,33.63%,1
雲林縣,大埤鄉,0480,279,80,359,41,400,750,53.33%,37.2%,1
雲林縣,大埤鄉,0481,249,76,325,27,352,719,48.96%,34.63%,1
雲林縣,大埤鄉,0482,232,52,284,28,312,603,51.74%,38.47%,1
雲林縣,大埤鄉,0483,316,139,455,64,519,1106,46.93%,28.57%,1
雲林縣,大埤鄉,0484,504,190,694,78,772,1495,51.64%,33.71%,1
雲林縣,大埤鄉,0485,231,93,324,32,356,600,59.33%,38.5%,1
雲林縣,大埤鄉,0486,392,141,533,56,589,1004,58.67%,39.04%,1
雲林縣,大埤鄉,0487,242,97,339,23,362,948,38.19%,25.53%,1
雲林縣,大埤鄉,0488,680,74,754,77,831,1539,54%,44.18%,1
雲林縣,大埤鄉,0489,485,145,630,73,703,1430,49.16%,33.92%,1
雲林縣,大埤鄉,0490,148,50,198,35,233,465,50.11%,31.83%,1
雲林縣,大埤鄉,0491,439,154,593,54,647,1307,49.5%,33.59%,1
雲林縣,大埤鄉,0492,156,56,212,28,240,474,50.63%,32.91%,1
雲林縣,大埤鄉,0493,449,176,625,99,724,1220,59.34%,36.8%,1
雲林縣,大埤鄉,0494,248,75,323,22,345,733,47.07%,33.83%,1
雲林縣,大埤鄉,0495,248,85,333,35,368,681,54.04%,36.42%,1
雲林縣,大埤鄉,0496,200,63,263,33,296,712,41.57%,28.09%,1
雲林縣,大埤鄉,0497,216,89,305,43,348,723,48.13%,29.88%,1
雲林縣,莿桐鄉,0374,546,197,743,103,846,1507,56.14%,36.23%,1
雲林縣,莿桐鄉,0375,516,132,648,48,696,1300,53.54%,39.69%,1
雲林縣,莿桐鄉,0376,477,150,627,90,717,1272,56.37%,37.5%,1
雲林縣,莿桐鄉,0377,276,112,388,71,459,861,53.31%,32.06%,1
雲林縣,莿桐鄉,0378,477,171,648,77,725,1565,46.33%,30.48%,1
雲林縣,莿桐鄉,0379,192,66,258,19,277,577,48.01%,33.28%,1
雲林縣,莿桐鄉,0380,164,87,251,48,299,636,47.01%,25.79%,1
雲林縣,莿桐鄉,0381,359,135,494,79,573,1110,51.62%,32.34%,1
雲林縣,莿桐鄉,0382,380,143,523,72,595,973,61.15%,39.05%,1
雲林縣,莿桐鄉,0383,351,127,478,76,554,985,56.24%,35.63%,1
雲林縣,莿桐鄉,0384,659,237,896,116,1012,1707,59.29%,38.61%,1
雲林縣,莿桐鄉,0385,470,160,630,88,718,1284,55.92%,36.6%,1
雲林縣,莿桐鄉,0386,444,183,627,79,706,1293,54.6%,34.34%,1
雲林縣,莿桐鄉,0387,334,114,448,62,510,900,56.67%,37.11%,1
雲林縣,莿桐鄉,0388,374,126,500,119,619,1040,59.52%,35.96%,1
雲林縣,莿桐鄉,0389,427,115,542,42,584,1165,50.13%,36.65%,1
雲林縣,莿桐鄉,0390,318,111,429,64,493,871,56.6%,36.51%,1
雲林縣,莿桐鄉,0391,365,112,477,58,535,885,60.45%,41.24%,1
雲林縣,莿桐鄉,0392,491,155,646,78,724,1489,48.62%,32.98%,1
雲林縣,莿桐鄉,0393,426,136,562,104,666,1347,49.44%,31.63%,1
雲林縣,莿桐鄉,0394,429,165,594,73,667,1150,58%,37.3%,1
雲林縣,莿桐鄉,0395,260,78,338,48,386,653,59.11%,39.82%,1
雲林縣,林內鄉,0396,440,138,578,77,655,1036,63.22%,42.47%,1
雲林縣,林內鄉,0397,572,175,747,89,836,1490,56.11%,38.39%,1
雲林縣,林內鄉,0398,543,165,708,87,795,1491,53.32%,36.42%,1
雲林縣,林內鄉,0399,237,50,287,66,353,671,52.61%,35.32%,1
雲林縣,林內鄉,0400,562,189,751,114,865,1436,60.24%,39.14%,1
雲林縣,林內鄉,0401,303,80,383,59,442,751,58.85%,40.35%,1
雲林縣,林內鄉,0402,197,71,268,25,293,535,54.77%,36.82%,1
雲林縣,林內鄉,0403,258,79,337,48,385,811,47.47%,31.81%,1
雲林縣,林內鄉,0404,490,172,662,103,765,1339,57.13%,36.59%,1
雲林縣,林內鄉,0405,482,120,602,91,693,1286,53.89%,37.48%,1
雲林縣,林內鄉,0406,239,78,317,38,355,646,54.95%,37%,1
雲林縣,林內鄉,0407,411,153,564,85,649,1158,56.04%,35.49%,1
雲林縣,林內鄉,0408,434,116,550,66,616,1090,56.51%,39.82%,1
雲林縣,林內鄉,0409,381,122,503,78,581,950,61.16%,40.11%,1
雲林縣,林內鄉,0410,303,97,400,46,446,861,51.8%,35.19%,1
雲林縣,二崙鄉,0317,446,161,607,40,647,1463,44.22%,30.49%,1
雲林縣,二崙鄉,0318,545,150,695,74,769,1738,44.25%,31.36%,1
雲林縣,二崙鄉,0319,180,58,238,59,297,625,47.52%,28.8%,1
雲林縣,二崙鄉,0320,329,93,422,74,496,1018,48.72%,32.32%,1
雲林縣,二崙鄉,0321,120,26,146,9,155,448,34.6%,26.79%,1
雲林縣,二崙鄉,0322,257,92,349,47,396,1048,37.79%,24.52%,1
雲林縣,二崙鄉,0323,396,150,546,83,629,1161,54.18%,34.11%,1
雲林縣,二崙鄉,0324,323,130,453,52,505,991,50.96%,32.59%,1
雲林縣,二崙鄉,0325,306,119,425,74,499,849,58.78%,36.04%,1
雲林縣,二崙鄉,0326,306,95,401,49,450,890,50.56%,34.38%,1
雲林縣,二崙鄉,0327,455,146,601,101,702,1427,49.19%,31.89%,1
雲林縣,二崙鄉,0328,282,98,380,37,417,891,46.8%,31.65%,1
雲林縣,二崙鄉,0329,213,76,289,26,315,757,41.61%,28.14%,1
雲林縣,二崙鄉,0330,446,163,609,117,726,1497,48.5%,29.79%,1
雲林縣,二崙鄉,0331,334,135,469,74,543,1171,46.37%,28.52%,1
雲林縣,二崙鄉,0332,245,98,343,57,400,686,58.31%,35.71%,1
雲林縣,二崙鄉,0333,209,79,288,98,386,864,44.68%,24.19%,1
雲林縣,二崙鄉,0334,390,141,531,84,615,1073,57.32%,36.35%,1
雲林縣,二崙鄉,0335,187,58,245,30,275,696,39.51%,26.87%,1
雲林縣,二崙鄉,0336,300,107,407,63,470,1271,36.98%,23.6%,1
雲林縣,二崙鄉,0337,252,101,353,53,406,912,44.52%,27.63%,1
雲林縣,二崙鄉,0338,222,110,332,43,375,861,43.55%,25.78%,1
雲林縣,二崙鄉,0339,271,111,382,66,448,1030,43.5%,26.31%,1
雲林縣,崙背鄉,0297,423,145,568,86,654,1176,55.61%,35.97%,1
雲林縣,崙背鄉,0298,476,166,642,50,692,1439,48.09%,33.08%,1
雲林縣,崙背鄉,0299,431,117,548,66,614,1027,59.79%,41.97%,1
雲林縣,崙背鄉,0300,487,147,634,56,690,1259,54.81%,38.68%,1
雲林縣,崙背鄉,0301,356,131,487,32,519,1058,49.05%,33.65%,1
雲林縣,崙背鄉,0302,317,94,411,34,445,998,44.59%,31.76%,1
雲林縣,崙背鄉,0303,314,107,421,28,449,968,46.38%,32.44%,1
雲林縣,崙背鄉,0304,362,138,500,53,553,1055,52.42%,34.31%,1
雲林縣,崙背鄉,0305,389,148,537,87,624,1315,47.45%,29.58%,1
雲林縣,崙背鄉,0306,203,84,287,35,322,1027,31.35%,19.77%,1
雲林縣,崙背鄉,0307,368,123,491,96,587,997,58.88%,36.91%,1
雲林縣,崙背鄉,0308,298,86,384,36,420,807,52.04%,36.93%,1
雲林縣,崙背鄉,0309,179,80,259,24,283,698,40.54%,25.64%,1
雲林縣,崙背鄉,0310,208,104,312,55,367,804,45.65%,25.87%,1
雲林縣,崙背鄉,0311,274,95,369,34,403,867,46.48%,31.6%,1
雲林縣,崙背鄉,0312,236,75,311,28,339,886,38.26%,26.64%,1
雲林縣,崙背鄉,0313,381,134,515,96,611,1476,41.4%,25.81%,1
雲林縣,崙背鄉,0314,243,80,323,49,372,1159,32.1%,20.97%,1
雲林縣,崙背鄉,0315,409,164,573,101,674,1220,55.25%,33.52%,1
雲林縣,崙背鄉,0316,271,100,371,37,408,814,50.12%,33.29%,1
雲林縣,麥寮鄉,0001,407,154,561,72,633,1497,42.28%,27.19%,1
雲林縣,麥寮鄉,0002,579,230,809,63,872,1738,50.17%,33.31%,1
雲林縣,麥寮鄉,0003,634,225,859,98,957,1921,49.82%,33%,1
雲林縣,麥寮鄉,0004,582,190,772,72,844,1832,46.07%,31.77%,1
雲林縣,麥寮鄉,0005,410,123,533,73,606,1340,45.22%,30.6%,1
雲林縣,麥寮鄉,0006,343,133,476,75,551,1138,48.42%,30.14%,1
雲林縣,麥寮鄉,0007,489,187,676,71,747,1551,48.16%,31.53%,1
雲林縣,麥寮鄉,0008,190,74,264,47,311,715,43.5%,26.57%,1
雲林縣,麥寮鄉,0009,313,124,437,54,491,1194,41.12%,26.21%,1
雲林縣,麥寮鄉,0010,316,104,420,68,488,1023,47.7%,30.89%,1
雲林縣,麥寮鄉,0011,400,144,544,44,588,1558,37.74%,25.67%,1
雲林縣,麥寮鄉,0012,308,127,435,37,472,1187,39.76%,25.95%,1
雲林縣,麥寮鄉,0013,281,108,389,31,420,983,42.73%,28.59%,1
雲林縣,麥寮鄉,0014,432,151,583,85,668,1363,49.01%,31.69%,1
雲林縣,麥寮鄉,0015,487,181,668,93,761,1596,47.68%,30.51%,1
雲林縣,麥寮鄉,0016,576,163,739,123,862,1469,58.68%,39.21%,1
雲林縣,麥寮鄉,0017,261,96,357,62,419,964,43.46%,27.07%,1
雲林縣,麥寮鄉,0018,276,102,378,52,430,1038,41.43%,26.59%,1
雲林縣,麥寮鄉,0019,431,114,545,75,620,1230,50.41%,35.04%,1
雲林縣,麥寮鄉,0020,438,146,584,57,641,1329,48.23%,32.96%,1
雲林縣,麥寮鄉,0021,364,148,512,88,600,1129,53.14%,32.24%,1
雲林縣,麥寮鄉,0022,444,149,593,100,693,1241,55.84%,35.78%,1
雲林縣,麥寮鄉,0023,541,160,701,102,803,1471,54.59%,36.78%,1
雲林縣,麥寮鄉,0024,384,165,549,81,630,1107,56.91%,34.69%,1
雲林縣,麥寮鄉,0025,554,252,806,95,901,1636,55.07%,33.86%,1
雲林縣,麥寮鄉,0026,590,168,758,64,822,1755,46.84%,33.62%,1
雲林縣,麥寮鄉,0027,435,117,552,45,597,1158,51.55%,37.56%,1
雲林縣,麥寮鄉,0028,358,117,475,40,515,956,53.87%,37.45%,1
雲林縣,東勢鄉,0051,347,122,469,66,535,1207,44.32%,28.75%,1
雲林縣,東勢鄉,0052,224,73,297,29,326,540,60.37%,41.48%,1
雲林縣,東勢鄉,0053,248,91,339,33,372,896,41.52%,27.68%,1
雲林縣,東勢鄉,0054,248,86,334,59,393,728,53.98%,34.07%,1
雲林縣,東勢鄉,0055,581,191,772,96,868,1533,56.62%,37.9%,1
雲林縣,東勢鄉,0056,456,154,610,103,713,1203,59.27%,37.91%,1
雲林縣,東勢鄉,0057,226,92,318,67,385,817,47.12%,27.66%,1
雲林縣,東勢鄉,0058,245,49,294,31,325,546,59.52%,44.87%,1
雲林縣,東勢鄉,0059,252,106,358,80,438,853,51.35%,29.54%,1
雲林縣,東勢鄉,0060,199,89,288,71,359,856,41.94%,23.25%,1
雲林縣,東勢鄉,0061,289,100,389,56,445,923,48.21%,31.31%,1
雲林縣,東勢鄉,0062,325,107,432,55,487,1022,47.65%,31.8%,1
雲林縣,東勢鄉,0063,176,38,214,27,241,634,38.01%,27.76%,1
雲林縣,東勢鄉,0064,101,33,134,27,161,394,40.86%,25.63%,1
雲林縣,東勢鄉,0065,273,88,361,43,404,1087,37.17%,25.11%,1
雲林縣,褒忠鄉,0066,333,107,440,69,509,923,55.15%,36.08%,1
雲林縣,褒忠鄉,0067,415,121,536,48,584,993,58.81%,41.79%,1
雲林縣,褒忠鄉,0068,278,84,362,29,391,748,52.27%,37.17%,1
雲林縣,褒忠鄉,0069,242,80,322,21,343,702,48.86%,34.47%,1
雲林縣,褒忠鄉,0070,271,64,335,20,355,752,47.21%,36.04%,1
雲林縣,褒忠鄉,0071,290,84,374,27,401,756,53.04%,38.36%,1
雲林縣,褒忠鄉,0072,174,60,234,17,251,490,51.22%,35.51%,1
雲林縣,褒忠鄉,0073,287,104,391,35,426,1034,41.2%,27.76%,1
雲林縣,褒忠鄉,0074,139,66,205,26,231,470,49.15%,29.57%,1
雲林縣,褒忠鄉,0075,252,92,344,33,377,737,51.15%,34.19%,1
雲林縣,褒忠鄉,0076,314,92,406,32,438,878,49.89%,35.76%,1
雲林縣,褒忠鄉,0077,255,83,338,52,390,778,50.13%,32.78%,1
雲林縣,褒忠鄉,0078,383,141,524,58,582,1224,47.55%,31.29%,1
雲林縣,褒忠鄉,0079,229,114,343,74,417,896,46.54%,25.56%,1
雲林縣,臺西鄉,0029,500,108,608,69,677,1238,54.68%,40.39%,1
雲林縣,臺西鄉,0030,350,111,461,54,515,1091,47.2%,32.08%,1
雲林縣,臺西鄉,0031,385,123,508,70,578,1098,52.64%,35.06%,1
雲林縣,臺西鄉,0032,285,103,388,49,437,1048,41.7%,27.19%,1
雲林縣,臺西鄉,0033,326,94,420,71,491,1025,47.9%,31.8%,1
雲林縣,臺西鄉,0034,285,89,374,57,431,850,50.71%,33.53%,1
雲林縣,臺西鄉,0035,402,145,547,94,641,1460,43.9%,27.53%,1
雲林縣,臺西鄉,0036,250,95,345,92,437,1180,37.03%,21.19%,1
雲林縣,臺西鄉,0037,162,38,200,35,235,710,33.1%,22.82%,1
雲林縣,臺西鄉,0038,143,52,195,16,211,620,34.03%,23.06%,1
雲林縣,臺西鄉,0039,132,50,182,31,213,449,47.44%,29.4%,1
雲林縣,臺西鄉,0040,161,56,217,59,276,687,40.17%,23.44%,1
雲林縣,臺西鄉,0041,366,116,482,75,557,1247,44.67%,29.35%,1
雲林縣,臺西鄉,0042,147,37,184,22,206,583,35.33%,25.21%,1
雲林縣,臺西鄉,0043,355,107,462,64,526,1042,50.48%,34.07%,1
雲林縣,臺西鄉,0044,140,52,192,27,219,472,46.4%,29.66%,1
雲林縣,臺西鄉,0045,397,105,502,35,537,1409,38.11%,28.18%,1
雲林縣,臺西鄉,0046,337,119,456,104,560,1061,52.78%,31.76%,1
雲林縣,臺西鄉,0047,267,89,356,43,399,993,40.18%,26.89%,1
雲林縣,臺西鄉,0048,295,111,406,86,492,1013,48.57%,29.12%,1
雲林縣,臺西鄉,0049,403,130,533,50,583,1233,47.28%,32.68%,1
雲林縣,臺西鄉,0050,184,52,236,28,264,616,42.86%,29.87%,1
雲林縣,元長鄉,0180,308,90,398,45,443,915,48.42%,33.66%,1
雲林縣,元長鄉,0181,385,140,525,40,565,1284,44%,29.98%,1
雲林縣,元長鄉,0182,330,128,458,50,508,1150,44.17%,28.7%,1
雲林縣,元長鄉,0183,195,73,268,52,320,744,43.01%,26.21%,1
雲林縣,元長鄉,0184,257,74,331,59,390,790,49.37%,32.53%,1
雲林縣,元長鄉,0185,350,121,471,85,556,1356,41%,25.81%,1
雲林縣,元長鄉,0186,193,98,291,66,357,739,48.31%,26.12%,1
雲林縣,元長鄉,0187,227,97,324,44,368,965,38.13%,23.52%,1
雲林縣,元長鄉,0188,276,111,387,77,464,1080,42.96%,25.56%,1
雲林縣,元長鄉,0189,237,82,319,54,373,948,39.35%,25%,1
雲林縣,元長鄉,0190,151,61,212,33,245,762,32.15%,19.82%,1
雲林縣,元長鄉,0191,175,56,231,32,263,582,45.19%,30.07%,1
雲林縣,元長鄉,0192,225,63,288,17,305,865,35.26%,26.01%,1
雲林縣,元長鄉,0193,63,7,70,7,77,362,21.27%,17.4%,1
雲林縣,元長鄉,0194,284,105,389,36,425,1162,36.57%,24.44%,1
雲林縣,元長鄉,0195,438,134,572,50,622,1527,40.73%,28.68%,1
雲林縣,元長鄉,0196,289,127,416,71,487,1006,48.41%,28.73%,1
雲林縣,元長鄉,0197,241,82,323,22,345,855,40.35%,28.19%,1
雲林縣,元長鄉,0198,362,111,473,84,557,1181,47.16%,30.65%,1
雲林縣,元長鄉,0199,234,74,308,47,355,864,41.09%,27.08%,1
雲林縣,元長鄉,0200,155,68,223,41,264,667,39.58%,23.24%,1
雲林縣,元長鄉,0201,213,84,297,45,342,878,38.95%,24.26%,1
雲林縣,元長鄉,0202,120,38,158,11,169,610,27.7%,19.67%,1
雲林縣,元長鄉,0203,235,91,326,73,399,837,47.67%,28.08%,1
雲林縣,元長鄉,0204,231,79,310,44,354,701,50.5%,32.95%,1
雲林縣,四湖鄉,0155,301,108,409,68,477,1082,44.09%,27.82%,1
雲林縣,四湖鄉,0156,237,76,313,50,363,676,53.7%,35.06%,1
雲林縣,四湖鄉,0157,291,87,378,25,403,862,46.75%,33.76%,1
雲林縣,四湖鄉,0158,105,34,139,22,161,477,33.75%,22.01%,1
雲林縣,四湖鄉,0159,361,106,467,34,501,952,52.63%,37.92%,1
雲林縣,四湖鄉,0160,167,50,217,19,236,650,36.31%,25.69%,1
雲林縣,四湖鄉,0161,284,98,382,22,404,969,41.69%,29.31%,1
雲林縣,四湖鄉,0162,221,99,320,52,372,925,40.22%,23.89%,1
雲林縣,四湖鄉,0163,282,67,349,30,379,914,41.47%,30.85%,1
雲林縣,四湖鄉,0164,137,54,191,50,241,759,31.75%,18.05%,1
雲林縣,四湖鄉,0165,277,111,388,57,445,1219,36.51%,22.72%,1
雲林縣,四湖鄉,0166,201,67,268,51,319,937,34.04%,21.45%,1
雲林縣,四湖鄉,0167,154,48,202,16,218,773,28.2%,19.92%,1
雲林縣,四湖鄉,0168,128,52,180,45,225,555,40.54%,23.06%,1
雲林縣,四湖鄉,0169,193,73,266,31,297,876,33.9%,22.03%,1
雲林縣,四湖鄉,0170,87,27,114,25,139,360,38.61%,24.17%,1
雲林縣,四湖鄉,0171,160,48,208,54,262,885,29.6%,18.08%,1
雲林縣,四湖鄉,0172,195,53,248,38,286,833,34.33%,23.41%,1
雲林縣,四湖鄉,0173,206,73,279,45,324,785,41.27%,26.24%,1
雲林縣,四湖鄉,0174,215,71,286,49,335,705,47.52%,30.5%,1
雲林縣,四湖鄉,0175,198,55,253,28,281,927,30.31%,21.36%,1
雲林縣,四湖鄉,0176,226,69,295,81,376,1058,35.54%,21.36%,1
雲林縣,四湖鄉,0177,251,96,347,58,405,1071,37.82%,23.44%,1
雲林縣,四湖鄉,0178,186,59,245,21,266,1022,26.03%,18.2%,1
雲林縣,四湖鄉,0179,170,67,237,40,277,711,38.96%,23.91%,1
雲林縣,口湖鄉,0205,361,144,505,70,575,1134,50.71%,31.83%,1
雲林縣,口湖鄉,0206,418,130,548,116,664,1225,54.2%,34.12%,1
雲林縣,口湖鄉,0207,176,50,226,45,271,647,41.89%,27.2%,1
雲林縣,口湖鄉,0208,234,74,308,28,336,709,47.39%,33%,1
雲林縣,口湖鄉,0209,264,80,344,81,425,900,47.22%,29.33%,1
雲林縣,口湖鄉,0210,307,108,415,81,496,1011,49.06%,30.37%,1
雲林縣,口湖鄉,0211,381,107,488,34,522,1437,36.33%,26.51%,1
雲林縣,口湖鄉,0212,174,63,237,8,245,848,28.89%,20.52%,1
雲林縣,口湖鄉,0213,304,108,412,39,451,1193,37.8%,25.48%,1
雲林縣,口湖鄉,0214,168,63,231,57,288,759,37.94%,22.13%,1
雲林縣,口湖鄉,0215,223,85,308,59,367,815,45.03%,27.36%,1
雲林縣,口湖鄉,0216,460,160,620,96,716,1460,49.04%,31.51%,1
雲林縣,口湖鄉,0217,104,47,151,13,164,556,29.5%,18.71%,1
雲林縣,口湖鄉,0218,480,126,606,85,691,1532,45.1%,31.33%,1
雲林縣,口湖鄉,0219,246,96,342,18,360,847,42.5%,29.04%,1
雲林縣,口湖鄉,0220,122,31,153,29,182,374,48.66%,32.62%,1
雲林縣,口湖鄉,0221,482,159,641,189,830,1508,55.04%,31.96%,1
雲林縣,口湖鄉,0222,348,95,443,76,519,951,54.57%,36.59%,1
雲林縣,口湖鄉,0223,300,122,422,95,517,910,56.81%,32.97%,1
雲林縣,口湖鄉,0224,351,111,462,50,512,879,58.25%,39.93%,1
雲林縣,口湖鄉,0225,346,99,445,140,585,1213,48.23%,28.52%,1
雲林縣,口湖鄉,0226,319,79,398,59,457,952,48%,33.51%,1
雲林縣,口湖鄉,0227,234,92,326,63,389,720,54.03%,32.5%,1
雲林縣,口湖鄉,0228,237,93,330,36,366,1006,36.38%,23.56%,1
雲林縣,口湖鄉,0229,153,45,198,11,209,607,34.43%,25.21%,1
雲林縣,水林鄉,0230,407,129,536,69,605,1355,44.65%,30.04%,1
雲林縣,水林鄉,0231,274,100,374,28,402,887,45.32%,30.89%,1
雲林縣,水林鄉,0232,456,138,594,66,660,1234,53.48%,36.95%,1
雲林縣,水林鄉,0233,248,77,325,21,346,763,45.35%,32.5%,1
雲林縣,水林鄉,0234,136,126,262,41,303,721,42.02%,18.86%,1
雲林縣,水林鄉,0235,168,41,209,13,222,647,34.31%,25.97%,1
雲林縣,水林鄉,0236,274,89,363,65,428,989,43.28%,27.7%,1
雲林縣,水林鄉,0237,193,81,274,29,303,837,36.2%,23.06%,1
雲林縣,水林鄉,0238,270,75,345,23,368,1081,34.04%,24.98%,1
雲林縣,水林鄉,0239,196,74,270,46,316,704,44.89%,27.84%,1
雲林縣,水林鄉,0240,287,109,396,94,490,1006,48.71%,28.53%,1
雲林縣,水林鄉,0241,188,57,245,13,258,651,39.63%,28.88%,1
雲林縣,水林鄉,0242,157,57,214,23,237,607,39.04%,25.86%,1
雲林縣,水林鄉,0243,253,103,356,73,429,1033,41.53%,24.49%,1
雲林縣,水林鄉,0244,141,42,183,14,197,631,31.22%,22.35%,1
雲林縣,水林鄉,0245,250,90,340,65,405,961,42.14%,26.01%,1
雲林縣,水林鄉,0246,242,92,334,84,418,951,43.95%,25.45%,1
雲林縣,水林鄉,0247,221,98,319,40,359,838,42.84%,26.37%,1
雲林縣,水林鄉,0248,319,84,403,97,500,1055,47.39%,30.24%,1
雲林縣,水林鄉,0249,102,30,132,35,167,512,32.62%,19.92%,1
雲林縣,水林鄉,0250,155,54,209,20,229,671,34.13%,23.1%,1
雲林縣,水林鄉,0251,119,49,168,45,213,693,30.74%,17.17%,1
雲林縣,水林鄉,0252,136,58,194,45,239,689,34.69%,19.74%,1
雲林縣,水林鄉,0253,314,102,416,78,494,1022,48.34%,30.72%,1
雲林縣,水林鄉,0254,323,101,424,45,469,1191,39.38%,27.12%,1
雲林縣,水林鄉,0255,281,81,362,42,404,779,51.86%,36.07%,1
嘉義縣,太保市,0001,463,130,593,84,677,1210,55.95%,38.26%,1
嘉義縣,太保市,0002,410,124,534,45,579,1076,53.81%,38.1%,1
嘉義縣,太保市,0003,152,53,205,29,234,488,47.95%,31.15%,1
嘉義縣,太保市,0004,450,191,641,73,714,1475,48.41%,30.51%,1
嘉義縣,太保市,0005,238,83,321,38,359,790,45.44%,30.13%,1
嘉義縣,太保市,0006,311,92,403,47,450,883,50.96%,35.22%,1
嘉義縣,太保市,0007,267,67,334,57,391,758,51.58%,35.22%,1
嘉義縣,太保市,0008,111,34,145,6,151,389,38.82%,28.53%,1
嘉義縣,太保市,0009,313,134,447,64,511,1101,46.41%,28.43%,1
嘉義縣,太保市,0010,305,90,395,15,410,853,48.07%,35.76%,1
嘉義縣,太保市,0011,54,25,79,13,92,224,41.07%,24.11%,1
嘉義縣,太保市,0012,198,61,259,59,318,662,48.04%,29.91%,1
嘉義縣,太保市,0013,736,187,923,39,962,1630,59.02%,45.15%,1
嘉義縣,太保市,0014,287,102,389,31,420,913,46%,31.43%,1
嘉義縣,太保市,0015,320,90,410,23,433,779,55.58%,41.08%,1
嘉義縣,太保市,0016,415,175,590,113,703,1278,55.01%,32.47%,1
嘉義縣,太保市,0017,252,95,347,37,384,819,46.89%,30.77%,1
嘉義縣,太保市,0018,538,187,725,41,766,1573,48.7%,34.2%,1
嘉義縣,太保市,0019,177,55,232,27,259,481,53.85%,36.8%,1
嘉義縣,太保市,0020,104,31,135,6,141,245,57.55%,42.45%,1
嘉義縣,太保市,0021,116,31,147,22,169,317,53.31%,36.59%,1
嘉義縣,太保市,0022,85,25,110,10,120,258,46.51%,32.95%,1
嘉義縣,太保市,0023,200,73,273,60,333,611,54.5%,32.73%,1
嘉義縣,太保市,0024,543,217,760,68,828,1526,54.26%,35.58%,1
嘉義縣,太保市,0025,424,186,610,33,643,1196,53.76%,35.45%,1
嘉義縣,太保市,0026,536,197,733,104,837,1536,54.49%,34.9%,1
嘉義縣,太保市,0027,524,211,735,90,825,1481,55.71%,35.38%,1
嘉義縣,太保市,0028,546,183,729,62,791,1450,54.55%,37.66%,1
嘉義縣,太保市,0029,267,95,362,25,387,840,46.07%,31.79%,1
嘉義縣,太保市,0030,331,135,466,34,500,989,50.56%,33.47%,1
嘉義縣,太保市,0031,566,177,743,103,846,1529,55.33%,37.02%,1
嘉義縣,太保市,0032,524,225,749,96,845,1511,55.92%,34.68%,1
嘉義縣,太保市,0033,199,75,274,47,321,697,46.05%,28.55%,1
嘉義縣,朴子市,0233,457,133,590,54,644,1183,54.44%,38.63%,1
嘉義縣,朴子市,0234,256,101,357,55,412,755,54.57%,33.91%,1
嘉義縣,朴子市,0235,473,149,622,44,666,1253,53.15%,37.75%,1
嘉義縣,朴子市,0236,424,149,573,77,650,1078,60.3%,39.33%,1
嘉義縣,朴子市,0237,484,110,594,91,685,1117,61.32%,43.33%,1
嘉義縣,朴子市,0238,149,55,204,26,230,387,59.43%,38.5%,1
嘉義縣,朴子市,0239,243,68,311,48,359,633,56.71%,38.39%,1
嘉義縣,朴子市,0240,280,40,320,40,360,650,55.38%,43.08%,1
嘉義縣,朴子市,0241,358,101,459,57,516,825,62.55%,43.39%,1
嘉義縣,朴子市,0242,298,83,381,63,444,810,54.81%,36.79%,1
嘉義縣,朴子市,0243,369,102,471,76,547,940,58.19%,39.26%,1
嘉義縣,朴子市,0244,301,113,414,66,480,905,53.04%,33.26%,1
嘉義縣,朴子市,0245,504,191,695,67,762,1605,47.48%,31.4%,1
嘉義縣,朴子市,0246,599,174,773,69,842,1479,56.93%,40.5%,1
嘉義縣,朴子市,0247,448,169,617,82,699,1218,57.39%,36.78%,1
嘉義縣,朴子市,0248,601,178,779,77,856,1496,57.22%,40.17%,1
嘉義縣,朴子市,0249,215,90,305,45,350,667,52.47%,32.23%,1
嘉義縣,朴子市,0250,152,59,211,33,244,627,38.92%,24.24%,1
嘉義縣,朴子市,0251,260,79,339,57,396,791,50.06%,32.87%,1
嘉義縣,朴子市,0252,345,116,461,112,573,1034,55.42%,33.37%,1
嘉義縣,朴子市,0253,574,188,762,35,797,1710,46.61%,33.57%,1
嘉義縣,朴子市,0254,548,151,699,54,753,1671,45.06%,32.79%,1
嘉義縣,朴子市,0255,422,133,555,57,612,1547,39.56%,27.28%,1
嘉義縣,朴子市,0256,400,156,556,85,641,1602,40.01%,24.97%,1
嘉義縣,朴子市,0257,544,151,695,40,735,1302,56.45%,41.78%,1
嘉義縣,朴子市,0258,245,70,315,61,376,740,50.81%,33.11%,1
嘉義縣,朴子市,0259,408,129,537,82,619,1054,58.73%,38.71%,1
嘉義縣,朴子市,0260,241,82,323,23,346,907,38.15%,26.57%,1
嘉義縣,朴子市,0261,186,72,258,46,304,720,42.22%,25.83%,1
嘉義縣,朴子市,0262,84,32,116,30,146,251,58.17%,33.47%,1
嘉義縣,朴子市,0263,199,73,272,62,334,767,43.55%,25.95%,1
嘉義縣,朴子市,0264,227,99,326,63,389,702,55.41%,32.34%,1
嘉義縣,朴子市,0265,304,110,414,71,485,1038,46.72%,29.29%,1
嘉義縣,朴子市,0266,272,76,348,40,388,1228,31.6%,22.15%,1
嘉義縣,朴子市,0267,139,53,192,65,257,499,51.5%,27.86%,1
嘉義縣,布袋鎮,0325,203,50,253,39,292,614,47.56%,33.06%,1
嘉義縣,布袋鎮,0326,113,37,150,16,166,372,44.62%,30.38%,1
嘉義縣,布袋鎮,0327,311,95,406,99,505,914,55.25%,34.03%,1
嘉義縣,布袋鎮,0328,408,120,528,103,631,1198,52.67%,34.06%,1
嘉義縣,布袋鎮,0329,342,94,436,86,522,1113,46.9%,30.73%,1
嘉義縣,布袋鎮,0330,341,104,445,91,536,992,54.03%,34.38%,1
嘉義縣,布袋鎮,0331,239,69,308,16,324,689,47.02%,34.69%,1
嘉義縣,布袋鎮,0332,285,88,373,78,451,882,51.13%,32.31%,1
嘉義縣,布袋鎮,0333,265,69,334,45,379,731,51.85%,36.25%,1
嘉義縣,布袋鎮,0334,293,74,367,51,418,779,53.66%,37.61%,1
嘉義縣,布袋鎮,0335,229,66,295,45,340,762,44.62%,30.05%,1
嘉義縣,布袋鎮,0336,350,104,454,66,520,1184,43.92%,29.56%,1
嘉義縣,布袋鎮,0337,365,120,485,73,558,1423,39.21%,25.65%,1
嘉義縣,布袋鎮,0338,337,123,460,79,539,1351,39.9%,24.94%,1
嘉義縣,布袋鎮,0339,69,31,100,6,106,275,38.55%,25.09%,1
嘉義縣,布袋鎮,0340,61,28,89,20,109,243,44.86%,25.1%,1
嘉義縣,布袋鎮,0341,201,63,264,99,363,661,54.92%,30.41%,1
嘉義縣,布袋鎮,0342,352,105,457,75,532,1145,46.46%,30.74%,1
嘉義縣,布袋鎮,0343,269,103,372,42,414,936,44.23%,28.74%,1
嘉義縣,布袋鎮,0344,300,101,401,52,453,958,47.29%,31.32%,1
嘉義縣,布袋鎮,0345,93,25,118,16,134,298,44.97%,31.21%,1
嘉義縣,布袋鎮,0346,44,162,206,37,243,428,56.78%,10.28%,1
嘉義縣,布袋鎮,0347,31,13,44,6,50,121,41.32%,25.62%,1
嘉義縣,布袋鎮,0348,34,10,44,5,49,174,28.16%,19.54%,1
嘉義縣,布袋鎮,0349,294,94,388,63,451,953,47.32%,30.85%,1
嘉義縣,布袋鎮,0350,447,161,608,79,687,1292,53.17%,34.6%,1
嘉義縣,布袋鎮,0351,395,133,528,72,600,1127,53.24%,35.05%,1
嘉義縣,布袋鎮,0352,410,127,537,38,575,1244,46.22%,32.96%,1
嘉義縣,布袋鎮,0353,304,121,425,28,453,1106,40.96%,27.49%,1
嘉義縣,大林鎮,0169,158,63,221,43,264,483,54.66%,32.71%,1
嘉義縣,大林鎮,0170,704,218,922,89,1011,1823,55.46%,38.62%,1
嘉義縣,大林鎮,0171,342,135,477,35,512,955,53.61%,35.81%,1
嘉義縣,大林鎮,0172,508,158,666,49,715,1436,49.79%,35.38%,1
嘉義縣,大林鎮,0173,476,172,648,71,719,1390,51.73%,34.24%,1
嘉義縣,大林鎮,0174,558,188,746,97,843,1512,55.75%,36.9%,1
嘉義縣,大林鎮,0175,582,208,790,68,858,1536,55.86%,37.89%,1
嘉義縣,大林鎮,0176,387,111,498,49,547,1165,46.95%,33.22%,1
嘉義縣,大林鎮,0177,694,233,927,82,1009,1730,58.32%,40.12%,1
嘉義縣,大林鎮,0178,169,49,218,20,238,602,39.53%,28.07%,1
嘉義縣,大林鎮,0179,200,76,276,81,357,716,49.86%,27.93%,1
嘉義縣,大林鎮,0180,143,42,185,17,202,625,32.32%,22.88%,1
嘉義縣,大林鎮,0181,49,18,67,1,68,193,35.23%,25.39%,1
嘉義縣,大林鎮,0182,489,178,667,84,751,1642,45.74%,29.78%,1
嘉義縣,大林鎮,0183,505,168,673,83,756,1465,51.6%,34.47%,1
嘉義縣,大林鎮,0184,266,84,350,60,410,928,44.18%,28.66%,1
嘉義縣,大林鎮,0185,98,31,129,30,159,361,44.04%,27.15%,1
嘉義縣,大林鎮,0186,239,66,305,34,339,814,41.65%,29.36%,1
嘉義縣,大林鎮,0187,497,175,672,45,717,1579,45.41%,31.48%,1
嘉義縣,大林鎮,0188,706,223,929,117,1046,2041,51.25%,34.59%,1
嘉義縣,大林鎮,0189,289,118,407,67,474,931,50.91%,31.04%,1
嘉義縣,大林鎮,0190,234,64,298,45,343,675,50.81%,34.67%,1
嘉義縣,大林鎮,0191,216,63,279,32,311,655,47.48%,32.98%,1
嘉義縣,大林鎮,0192,289,62,351,52,403,833,48.38%,34.69%,1
嘉義縣,大林鎮,0193,313,129,442,57,499,832,59.98%,37.62%,1
嘉義縣,民雄鄉,0093,514,154,668,62,730,1267,57.62%,40.57%,1
嘉義縣,民雄鄉,0094,366,117,483,42,525,1030,50.97%,35.53%,1
嘉義縣,民雄鄉,0095,620,273,893,46,939,1590,59.06%,38.99%,1
嘉義縣,民雄鄉,0096,599,170,769,46,815,1673,48.71%,35.8%,1
嘉義縣,民雄鄉,0097,636,241,877,91,968,1718,56.34%,37.02%,1
嘉義縣,民雄鄉,0098,440,116,556,58,614,1040,59.04%,42.31%,1
嘉義縣,民雄鄉,0099,389,136,525,68,593,1100,53.91%,35.36%,1
嘉義縣,民雄鄉,0100,510,195,705,90,795,1559,50.99%,32.71%,1
嘉義縣,民雄鄉,0101,597,244,841,96,937,1862,50.32%,32.06%,1
嘉義縣,民雄鄉,0102,538,196,734,74,808,1435,56.31%,37.49%,1
嘉義縣,民雄鄉,0103,509,226,735,171,906,1751,51.74%,29.07%,1
嘉義縣,民雄鄉,0104,340,112,452,68,520,933,55.73%,36.44%,1
嘉義縣,民雄鄉,0105,311,143,454,62,516,827,62.39%,37.61%,1
嘉義縣,民雄鄉,0106,226,101,327,64,391,843,46.38%,26.81%,1
嘉義縣,民雄鄉,0107,635,212,847,90,937,1774,52.82%,35.79%,1
嘉義縣,民雄鄉,0108,110,49,159,23,182,385,47.27%,28.57%,1
嘉義縣,民雄鄉,0109,519,177,696,49,745,1306,57.04%,39.74%,1
嘉義縣,民雄鄉,0110,193,79,272,48,320,535,59.81%,36.07%,1
嘉義縣,民雄鄉,0111,387,142,529,83,612,1055,58.01%,36.68%,1
嘉義縣,民雄鄉,0112,545,182,727,67,794,1476,53.79%,36.92%,1
嘉義縣,民雄鄉,0113,547,181,728,66,794,1583,50.16%,34.55%,1
嘉義縣,民雄鄉,0114,223,79,302,39,341,758,44.99%,29.42%,1
嘉義縣,民雄鄉,0115,456,156,612,62,674,1354,49.78%,33.68%,1
嘉義縣,民雄鄉,0116,436,152,588,96,684,1202,56.91%,36.27%,1
嘉義縣,民雄鄉,0117,440,146,586,60,646,1175,54.98%,37.45%,1
嘉義縣,民雄鄉,0118,506,151,657,65,722,1423,50.74%,35.56%,1
嘉義縣,民雄鄉,0119,609,179,788,59,847,1612,52.54%,37.78%,1
嘉義縣,民雄鄉,0120,651,230,881,41,922,1695,54.4%,38.41%,1
嘉義縣,民雄鄉,0121,518,174,692,62,754,1665,45.29%,31.11%,1
嘉義縣,民雄鄉,0122,334,93,427,62,489,1019,47.99%,32.78%,1
嘉義縣,民雄鄉,0123,467,167,634,72,706,1352,52.22%,34.54%,1
嘉義縣,民雄鄉,0124,578,215,793,96,889,1620,54.88%,35.68%,1
嘉義縣,民雄鄉,0125,320,107,427,46,473,943,50.16%,33.93%,1
嘉義縣,民雄鄉,0126,511,210,721,72,793,1720,46.1%,29.71%,1
嘉義縣,民雄鄉,0127,608,231,839,114,953,1875,50.83%,32.43%,1
嘉義縣,民雄鄉,0128,495,174,669,64,733,1305,56.17%,37.93%,1
嘉義縣,民雄鄉,0129,500,156,656,82,738,1441,51.21%,34.7%,1
嘉義縣,民雄鄉,0130,499,173,672,79,751,1413,53.15%,35.31%,1
嘉義縣,民雄鄉,0131,541,192,733,99,832,1560,53.33%,34.68%,1
嘉義縣,民雄鄉,0132,702,281,983,132,1115,2004,55.64%,35.03%,1
嘉義縣,民雄鄉,0133,563,157,720,75,795,1354,58.71%,41.58%,1
嘉義縣,民雄鄉,0134,419,134,553,45,598,1076,55.58%,38.94%,1
嘉義縣,民雄鄉,0135,560,209,769,139,908,1629,55.74%,34.38%,1
嘉義縣,民雄鄉,0136,673,227,900,90,990,1977,50.08%,34.04%,1
嘉義縣,民雄鄉,0137,398,187,585,98,683,1295,52.74%,30.73%,1
嘉義縣,溪口鄉,0194,484,149,633,115,748,1318,56.75%,36.72%,1
嘉義縣,溪口鄉,0195,248,88,336,54,390,677,57.61%,36.63%,1
嘉義縣,溪口鄉,0196,138,42,180,19,199,417,47.72%,33.09%,1
嘉義縣,溪口鄉,0197,91,38,129,19,148,273,54.21%,33.33%,1
嘉義縣,溪口鄉,0198,333,132,465,63,528,908,58.15%,36.67%,1
嘉義縣,溪口鄉,0199,112,33,145,16,161,386,41.71%,29.02%,1
嘉義縣,溪口鄉,0200,354,143,497,80,577,1039,55.53%,34.07%,1
嘉義縣,溪口鄉,0201,201,69,270,58,328,708,46.33%,28.39%,1
嘉義縣,溪口鄉,0202,267,100,367,23,390,909,42.9%,29.37%,1
嘉義縣,溪口鄉,0203,276,87,363,66,429,786,54.58%,35.11%,1
嘉義縣,溪口鄉,0204,241,83,324,58,382,807,47.34%,29.86%,1
嘉義縣,溪口鄉,0205,301,93,394,29,423,1168,36.22%,25.77%,1
嘉義縣,溪口鄉,0206,343,142,485,100,585,1052,55.61%,32.6%,1
嘉義縣,溪口鄉,0207,157,65,222,63,285,565,50.44%,27.79%,1
嘉義縣,溪口鄉,0208,139,37,176,28,204,388,52.58%,35.82%,1
嘉義縣,溪口鄉,0209,185,59,244,37,281,701,40.09%,26.39%,1
嘉義縣,溪口鄉,0210,255,95,350,47,397,1003,39.58%,25.42%,1
嘉義縣,新港鄉,0138,398,119,517,40,557,1087,51.24%,36.61%,1
嘉義縣,新港鄉,0139,511,154,665,70,735,1116,65.86%,45.79%,1
嘉義縣,新港鄉,0140,272,79,351,57,408,740,55.14%,36.76%,1
嘉義縣,新港鄉,0141,266,92,358,79,437,827,52.84%,32.16%,1
嘉義縣,新港鄉,0142,273,96,369,62,431,704,61.22%,38.78%,1
嘉義縣,新港鄉,0143,283,126,409,64,473,768,61.59%,36.85%,1
嘉義縣,新港鄉,0144,292,117,409,46,455,761,59.79%,38.37%,1
嘉義縣,新港鄉,0145,268,89,357,72,429,850,50.47%,31.53%,1
嘉義縣,新港鄉,0146,451,150,601,94,695,1327,52.37%,33.99%,1
嘉義縣,新港鄉,0147,265,84,349,68,417,756,55.16%,35.05%,1
嘉義縣,新港鄉,0148,275,88,363,98,461,816,56.5%,33.7%,1
嘉義縣,新港鄉,0149,188,78,266,36,302,667,45.28%,28.19%,1
嘉義縣,新港鄉,0150,304,118,422,58,480,942,50.96%,32.27%,1
嘉義縣,新港鄉,0151,256,105,361,77,438,918,47.71%,27.89%,1
嘉義縣,新港鄉,0152,168,44,212,11,223,554,40.25%,30.32%,1
嘉義縣,新港鄉,0153,281,93,374,61,435,929,46.82%,30.25%,1
嘉義縣,新港鄉,0154,122,38,160,44,204,487,41.89%,25.05%,1
嘉義縣,新港鄉,0155,160,61,221,49,270,487,55.44%,32.85%,1
嘉義縣,新港鄉,0156,210,123,333,61,394,836,47.13%,25.12%,1
嘉義縣,新港鄉,0157,262,124,386,78,464,845,54.91%,31.01%,1
嘉義縣,新港鄉,0158,303,91,394,58,452,834,54.2%,36.33%,1
嘉義縣,新港鄉,0159,278,88,366,59,425,753,56.44%,36.92%,1
嘉義縣,新港鄉,0160,425,195,620,81,701,1328,52.79%,32%,1
嘉義縣,新港鄉,0161,371,116,487,65,552,969,56.97%,38.29%,1
嘉義縣,新港鄉,0162,394,134,528,88,616,1043,59.06%,37.78%,1
嘉義縣,新港鄉,0163,569,184,753,88,841,1400,60.07%,40.64%,1
嘉義縣,新港鄉,0164,231,75,306,33,339,1017,33.33%,22.71%,1
嘉義縣,新港鄉,0165,320,123,443,66,509,1132,44.96%,28.27%,1
嘉義縣,新港鄉,0166,332,124,456,81,537,1037,51.78%,32.02%,1
嘉義縣,新港鄉,0167,201,71,272,59,331,563,58.79%,35.7%,1
嘉義縣,新港鄉,0168,260,115,375,32,407,849,47.94%,30.62%,1
嘉義縣,六腳鄉,0268,321,118,439,40,479,1165,41.12%,27.55%,1
嘉義縣,六腳鄉,0269,186,58,244,20,264,825,32%,22.55%,1
嘉義縣,六腳鄉,0270,244,83,327,33,360,850,42.35%,28.71%,1
嘉義縣,六腳鄉,0271,80,31,111,21,132,222,59.46%,36.04%,1
嘉義縣,六腳鄉,0272,385,134,519,66,585,1216,48.11%,31.66%,1
嘉義縣,六腳鄉,0273,303,80,383,52,435,1200,36.25%,25.25%,1
嘉義縣,六腳鄉,0274,269,85,354,55,409,877,46.64%,30.67%,1
嘉義縣,六腳鄉,0275,170,51,221,52,273,644,42.39%,26.4%,1
嘉義縣,六腳鄉,0276,134,50,184,19,203,594,34.18%,22.56%,1
嘉義縣,六腳鄉,0277,30,7,37,2,39,167,23.35%,17.96%,1
嘉義縣,六腳鄉,0278,39,27,66,1,67,204,32.84%,19.12%,1
嘉義縣,六腳鄉,0279,58,23,81,8,89,234,38.03%,24.79%,1
嘉義縣,六腳鄉,0280,82,30,112,9,121,361,33.52%,22.71%,1
嘉義縣,六腳鄉,0281,199,73,272,53,325,592,54.9%,33.61%,1
嘉義縣,六腳鄉,0282,182,80,262,48,310,619,50.08%,29.4%,1
嘉義縣,六腳鄉,0283,163,55,218,51,269,714,37.68%,22.83%,1
嘉義縣,六腳鄉,0284,329,94,423,60,483,1051,45.96%,31.3%,1
嘉義縣,六腳鄉,0285,301,109,410,72,482,934,51.61%,32.23%,1
嘉義縣,六腳鄉,0286,346,101,447,64,511,1044,48.95%,33.14%,1
嘉義縣,六腳鄉,0287,410,129,539,42,581,1476,39.36%,27.78%,1
嘉義縣,六腳鄉,0288,145,46,191,24,215,618,34.79%,23.46%,1
嘉義縣,六腳鄉,0289,84,26,110,52,162,478,33.89%,17.57%,1
嘉義縣,六腳鄉,0290,133,55,188,44,232,642,36.14%,20.72%,1
嘉義縣,六腳鄉,0291,176,69,245,15,260,883,29.45%,19.93%,1
嘉義縣,六腳鄉,0292,157,47,204,7,211,739,28.55%,21.24%,1
嘉義縣,六腳鄉,0293,131,51,182,33,215,554,38.81%,23.65%,1
嘉義縣,六腳鄉,0294,132,45,177,24,201,649,30.97%,20.34%,1
嘉義縣,六腳鄉,0295,158,48,206,24,230,689,33.38%,22.93%,1
嘉義縣,六腳鄉,0296,102,45,147,24,171,455,37.58%,22.42%,1
嘉義縣,六腳鄉,0297,24,9,33,4,37,125,29.6%,19.2%,1
嘉義縣,東石鄉,0298,494,195,689,111,800,1915,41.78%,25.8%,1
嘉義縣,東石鄉,0299,213,85,298,69,367,938,39.13%,22.71%,1
嘉義縣,東石鄉,0300,238,105,343,31,374,1366,27.38%,17.42%,1
嘉義縣,東石鄉,0301,413,144,557,5,562,1676,33.53%,24.64%,1
嘉義縣,東石鄉,0302,278,92,370,95,465,1151,40.4%,24.15%,1
嘉義縣,東石鄉,0303,172,66,238,82,320,716,44.69%,24.02%,1
嘉義縣,東石鄉,0304,88,28,116,8,124,387,32.04%,22.74%,1
嘉義縣,東石鄉,0305,173,46,219,12,231,864,26.74%,20.02%,1
嘉義縣,東石鄉,0306,181,64,245,21,266,910,29.23%,19.89%,1
嘉義縣,東石鄉,0307,174,48,222,16,238,760,31.32%,22.89%,1
嘉義縣,東石鄉,0308,48,22,70,15,85,166,51.2%,28.92%,1
嘉義縣,東石鄉,0309,47,14,61,16,77,212,36.32%,22.17%,1
嘉義縣,東石鄉,0310,218,60,278,44,322,993,32.43%,21.95%,1
嘉義縣,東石鄉,0311,72,25,97,14,111,306,36.27%,23.53%,1
嘉義縣,東石鄉,0312,217,84,301,110,411,1046,39.29%,20.75%,1
嘉義縣,東石鄉,0313,48,13,61,29,90,235,38.3%,20.43%,1
嘉義縣,東石鄉,0314,341,107,448,104,552,1226,45.02%,27.81%,1
嘉義縣,東石鄉,0315,211,85,296,66,362,843,42.94%,25.03%,1
嘉義縣,東石鄉,0316,190,57,247,34,281,693,40.55%,27.42%,1
嘉義縣,東石鄉,0317,264,83,347,65,412,839,49.11%,31.47%,1
嘉義縣,東石鄉,0318,108,21,129,16,145,363,39.94%,29.75%,1
嘉義縣,東石鄉,0319,77,21,98,10,108,321,33.64%,23.99%,1
嘉義縣,東石鄉,0320,347,141,488,108,596,1083,55.03%,32.04%,1
嘉義縣,東石鄉,0321,253,102,355,55,410,901,45.5%,28.08%,1
嘉義縣,東石鄉,0322,262,67,329,36,365,1216,30.02%,21.55%,1
嘉義縣,東石鄉,0323,137,65,202,47,249,418,59.57%,32.78%,1
嘉義縣,東石鄉,0324,117,24,141,14,155,371,41.78%,31.54%,1
嘉義縣,義竹鄉,0354,154,45,199,31,230,482,47.72%,31.95%,1
嘉義縣,義竹鄉,0355,83,27,110,20,130,223,58.3%,37.22%,1
嘉義縣,義竹鄉,0356,538,184,722,87,809,1529,52.91%,35.19%,1
嘉義縣,義竹鄉,0357,443,131,574,77,651,1175,55.4%,37.7%,1
嘉義縣,義竹鄉,0358,348,134,482,61,543,886,61.29%,39.28%,1
嘉義縣,義竹鄉,0359,207,83,290,44,334,743,44.95%,27.86%,1
嘉義縣,義竹鄉,0360,419,155,574,100,674,1236,54.53%,33.9%,1
嘉義縣,義竹鄉,0361,134,34,168,26,194,377,51.46%,35.54%,1
嘉義縣,義竹鄉,0362,100,29,129,23,152,338,44.97%,29.59%,1
嘉義縣,義竹鄉,0363,45,10,55,4,59,102,57.84%,44.12%,1
嘉義縣,義竹鄉,0364,240,64,304,23,327,763,42.86%,31.45%,1
嘉義縣,義竹鄉,0365,152,58,210,29,239,429,55.71%,35.43%,1
嘉義縣,義竹鄉,0366,144,38,182,24,206,427,48.24%,33.72%,1
嘉義縣,義竹鄉,0367,205,74,279,50,329,607,54.2%,33.77%,1
嘉義縣,義竹鄉,0368,458,141,599,60,659,1486,44.35%,30.82%,1
嘉義縣,義竹鄉,0369,299,105,404,72,476,835,57.01%,35.81%,1
嘉義縣,義竹鄉,0370,218,66,284,69,353,816,43.26%,26.72%,1
嘉義縣,義竹鄉,0371,229,86,315,66,381,833,45.74%,27.49%,1
嘉義縣,義竹鄉,0372,145,50,195,16,211,433,48.73%,33.49%,1
嘉義縣,義竹鄉,0373,187,44,231,7,238,558,42.65%,33.51%,1
嘉義縣,義竹鄉,0374,189,72,261,49,310,602,51.5%,31.4%,1
嘉義縣,義竹鄉,0375,36,13,49,2,51,140,36.43%,25.71%,1
嘉義縣,義竹鄉,0376,110,39,149,26,175,393,44.53%,27.99%,1
嘉義縣,義竹鄉,0377,194,62,256,28,284,585,48.55%,33.16%,1
嘉義縣,義竹鄉,0378,119,32,151,8,159,526,30.23%,22.62%,1
嘉義縣,義竹鄉,0379,35,20,55,12,67,123,54.47%,28.46%,1
嘉義縣,鹿草鄉,0034,132,56,188,52,240,522,45.98%,25.29%,1
嘉義縣,鹿草鄉,0035,182,70,252,47,299,563,53.11%,32.33%,1
嘉義縣,鹿草鄉,0036,405,138,543,95,638,1304,48.93%,31.06%,1
嘉義縣,鹿草鄉,0037,424,159,583,74,657,1312,50.08%,32.32%,1
嘉義縣,鹿草鄉,0038,94,29,123,5,128,320,40%,29.38%,1
嘉義縣,鹿草鄉,0039,89,16,105,5,110,418,26.32%,21.29%,1
嘉義縣,鹿草鄉,0040,279,85,364,73,437,1025,42.63%,27.22%,1
嘉義縣,鹿草鄉,0041,113,49,162,23,185,451,41.02%,25.06%,1
嘉義縣,鹿草鄉,0042,258,75,333,110,443,830,53.37%,31.08%,1
嘉義縣,鹿草鄉,0043,290,114,404,85,489,1050,46.57%,27.62%,1
嘉義縣,鹿草鄉,0044,256,69,325,74,399,972,41.05%,26.34%,1
嘉義縣,鹿草鄉,0045,283,87,370,70,440,962,45.74%,29.42%,1
嘉義縣,鹿草鄉,0046,205,80,285,57,342,678,50.44%,30.24%,1
嘉義縣,鹿草鄉,0047,77,25,102,35,137,262,52.29%,29.39%,1
嘉義縣,鹿草鄉,0048,252,77,329,61,390,906,43.05%,27.81%,1
嘉義縣,鹿草鄉,0049,71,20,91,14,105,306,34.31%,23.2%,1
嘉義縣,鹿草鄉,0050,353,101,454,80,534,1062,50.28%,33.24%,1
嘉義縣,鹿草鄉,0051,119,46,165,30,195,373,52.28%,31.9%,1
嘉義縣,鹿草鄉,0052,114,32,146,29,175,324,54.01%,35.19%,1
嘉義縣,鹿草鄉,0053,102,21,123,23,146,297,49.16%,34.34%,1
嘉義縣,水上鄉,0054,349,129,478,24,502,1024,49.02%,34.08%,1
嘉義縣,水上鄉,0055,397,150,547,65,612,1015,60.3%,39.11%,1
嘉義縣,水上鄉,0056,646,215,861,79,940,1932,48.65%,33.44%,1
嘉義縣,水上鄉,0057,462,160,622,55,677,1170,57.86%,39.49%,1
嘉義縣,水上鄉,0058,497,179,676,89,765,1305,58.62%,38.08%,1
嘉義縣,水上鄉,0059,412,138,550,64,614,1242,49.44%,33.17%,1
嘉義縣,水上鄉,0060,98,46,144,17,161,324,49.69%,30.25%,1
嘉義縣,水上鄉,0061,225,78,303,21,324,622,52.09%,36.17%,1
嘉義縣,水上鄉,0062,423,121,544,92,636,1216,52.3%,34.79%,1
嘉義縣,水上鄉,0063,400,124,524,34,558,1020,54.71%,39.22%,1
嘉義縣,水上鄉,0064,322,119,441,39,480,771,62.26%,41.76%,1
嘉義縣,水上鄉,0065,186,63,249,27,276,441,62.59%,42.18%,1
嘉義縣,水上鄉,0066,268,89,357,49,406,626,64.86%,42.81%,1
嘉義縣,水上鄉,0067,231,74,305,32,337,570,59.12%,40.53%,1
嘉義縣,水上鄉,0068,117,50,167,25,192,368,52.17%,31.79%,1
嘉義縣,水上鄉,0069,303,129,432,103,535,1037,51.59%,29.22%,1
嘉義縣,水上鄉,0070,368,134,502,72,574,1065,53.9%,34.55%,1
嘉義縣,水上鄉,0071,309,118,427,80,507,802,63.22%,38.53%,1
嘉義縣,水上鄉,0072,639,225,864,48,912,1948,46.82%,32.8%,1
嘉義縣,水上鄉,0073,334,124,458,65,523,1028,50.88%,32.49%,1
嘉義縣,水上鄉,0074,262,82,344,27,371,641,57.88%,40.87%,1
嘉義縣,水上鄉,0075,167,44,211,13,224,408,54.9%,40.93%,1
嘉義縣,水上鄉,0076,300,112,412,45,457,794,57.56%,37.78%,1
嘉義縣,水上鄉,0077,162,68,230,39,269,569,47.28%,28.47%,1
嘉義縣,水上鄉,0078,312,96,408,43,451,806,55.96%,38.71%,1
嘉義縣,水上鄉,0079,382,127,509,43,552,960,57.5%,39.79%,1
嘉義縣,水上鄉,0080,704,295,999,111,1110,2035,54.55%,34.59%,1
嘉義縣,水上鄉,0081,663,237,900,113,1013,1987,50.98%,33.37%,1
嘉義縣,水上鄉,0082,441,123,564,36,600,1154,51.99%,38.21%,1
嘉義縣,水上鄉,0083,770,265,1035,83,1118,2208,50.63%,34.87%,1
嘉義縣,水上鄉,0084,625,231,856,76,932,2102,44.34%,29.73%,1
嘉義縣,水上鄉,0085,426,152,578,77,655,1309,50.04%,32.54%,1
嘉義縣,水上鄉,0086,585,235,820,87,907,1671,54.28%,35.01%,1
嘉義縣,水上鄉,0087,297,93,390,50,440,822,53.53%,36.13%,1
嘉義縣,水上鄉,0088,578,206,784,55,839,1772,47.35%,32.62%,1
嘉義縣,水上鄉,0089,635,255,890,100,990,1919,51.59%,33.09%,1
嘉義縣,水上鄉,0090,249,94,343,26,369,912,40.46%,27.3%,1
嘉義縣,水上鄉,0091,323,116,439,31,470,992,47.38%,32.56%,1
嘉義縣,水上鄉,0092,382,111,493,70,563,1270,44.33%,30.08%,1
嘉義縣,中埔鄉,0380,294,94,388,16,404,1046,38.62%,28.11%,1
嘉義縣,中埔鄉,0381,540,199,739,98,837,1788,46.81%,30.2%,1
嘉義縣,中埔鄉,0382,495,209,704,61,765,1730,44.22%,28.61%,1
嘉義縣,中埔鄉,0383,530,179,709,63,772,1581,48.83%,33.52%,1
嘉義縣,中埔鄉,0384,486,150,636,45,681,1594,42.72%,30.49%,1
嘉義縣,中埔鄉,0385,619,207,826,55,881,1801,48.92%,34.37%,1
嘉義縣,中埔鄉,0386,639,191,830,81,911,1862,48.93%,34.32%,1
嘉義縣,中埔鄉,0387,548,183,731,39,770,1803,42.71%,30.39%,1
嘉義縣,中埔鄉,0388,541,162,703,65,768,1481,51.86%,36.53%,1
嘉義縣,中埔鄉,0389,502,143,645,75,720,1366,52.71%,36.75%,1
嘉義縣,中埔鄉,0390,441,182,623,87,710,1599,44.4%,27.58%,1
嘉義縣,中埔鄉,0391,388,142,530,50,580,1196,48.49%,32.44%,1
嘉義縣,中埔鄉,0392,528,192,720,99,819,1809,45.27%,29.19%,1
嘉義縣,中埔鄉,0393,302,115,417,34,451,953,47.32%,31.69%,1
嘉義縣,中埔鄉,0394,434,160,594,73,667,1441,46.29%,30.12%,1
嘉義縣,中埔鄉,0395,597,198,795,70,865,1882,45.96%,31.72%,1
嘉義縣,中埔鄉,0396,355,117,472,28,500,1470,34.01%,24.15%,1
嘉義縣,中埔鄉,0397,514,141,655,95,750,1699,44.14%,30.25%,1
嘉義縣,中埔鄉,0398,125,30,155,18,173,422,41%,29.62%,1
嘉義縣,中埔鄉,0399,327,118,445,69,514,1030,49.9%,31.75%,1
嘉義縣,中埔鄉,0400,245,97,342,49,391,879,44.48%,27.87%,1
嘉義縣,中埔鄉,0401,228,76,304,14,318,828,38.41%,27.54%,1
嘉義縣,中埔鄉,0402,344,95,439,60,499,881,56.64%,39.05%,1
嘉義縣,中埔鄉,0403,92,39,131,17,148,296,50%,31.08%,1
嘉義縣,中埔鄉,0404,275,103,378,101,479,979,48.93%,28.09%,1
嘉義縣,中埔鄉,0405,356,124,480,42,522,1268,41.17%,28.08%,1
嘉義縣,中埔鄉,0406,132,42,174,14,188,670,28.06%,19.7%,1
嘉義縣,中埔鄉,0407,271,96,367,64,431,754,57.16%,35.94%,1
嘉義縣,中埔鄉,0408,238,73,311,44,355,648,54.78%,36.73%,1
嘉義縣,中埔鄉,0409,202,60,262,29,291,741,39.27%,27.26%,1
嘉義縣,中埔鄉,0410,160,42,202,6,208,518,40.15%,30.89%,1
嘉義縣,中埔鄉,0411,141,64,205,36,241,482,50%,29.25%,1
嘉義縣,中埔鄉,0412,98,37,135,8,143,348,41.09%,28.16%,1
嘉義縣,中埔鄉,0413,105,30,135,14,149,294,50.68%,35.71%,1
嘉義縣,竹崎鄉,0414,455,148,603,38,641,1312,48.86%,34.68%,1
嘉義縣,竹崎鄉,0415,470,133,603,19,622,1210,51.4%,38.84%,1
嘉義縣,竹崎鄉,0416,389,114,503,50,553,991,55.8%,39.25%,1
嘉義縣,竹崎鄉,0417,421,126,547,48,595,1207,49.3%,34.88%,1
嘉義縣,竹崎鄉,0418,200,86,286,16,302,752,40.16%,26.6%,1
嘉義縣,竹崎鄉,0419,310,116,426,56,482,833,57.86%,37.21%,1
嘉義縣,竹崎鄉,0420,405,195,600,89,689,1220,56.48%,33.2%,1
嘉義縣,竹崎鄉,0421,248,71,319,18,337,616,54.71%,40.26%,1
嘉義縣,竹崎鄉,0422,348,115,463,65,528,1031,51.21%,33.75%,1
嘉義縣,竹崎鄉,0423,446,137,583,84,667,1292,51.63%,34.52%,1
嘉義縣,竹崎鄉,0424,781,237,1018,76,1094,1995,54.84%,39.15%,1
嘉義縣,竹崎鄉,0425,664,182,846,29,875,1996,43.84%,33.27%,1
嘉義縣,竹崎鄉,0426,520,159,679,77,756,1449,52.17%,35.89%,1
嘉義縣,竹崎鄉,0427,518,146,664,28,692,1420,48.73%,36.48%,1
嘉義縣,竹崎鄉,0428,559,211,770,63,833,1590,52.39%,35.16%,1
嘉義縣,竹崎鄉,0429,269,85,354,32,386,771,50.06%,34.89%,1
嘉義縣,竹崎鄉,0430,296,129,425,56,481,1014,47.44%,29.19%,1
嘉義縣,竹崎鄉,0431,72,25,97,10,107,327,32.72%,22.02%,1
嘉義縣,竹崎鄉,0432,250,75,325,31,356,687,51.82%,36.39%,1
嘉義縣,竹崎鄉,0433,193,71,264,27,291,641,45.4%,30.11%,1
嘉義縣,竹崎鄉,0434,167,44,211,13,224,474,47.26%,35.23%,1
嘉義縣,竹崎鄉,0435,134,26,160,27,187,383,48.83%,34.99%,1
嘉義縣,竹崎鄉,0436,243,73,316,57,373,619,60.26%,39.26%,1
嘉義縣,竹崎鄉,0437,70,22,92,6,98,214,45.79%,32.71%,1
嘉義縣,竹崎鄉,0438,515,189,704,112,816,1568,52.04%,32.84%,1
嘉義縣,竹崎鄉,0439,190,54,244,45,289,658,43.92%,28.88%,1
嘉義縣,竹崎鄉,0440,163,53,216,37,253,434,58.29%,37.56%,1
嘉義縣,竹崎鄉,0441,343,84,427,63,490,917,53.44%,37.4%,1
嘉義縣,竹崎鄉,0442,310,120,430,53,483,981,49.24%,31.6%,1
嘉義縣,竹崎鄉,0443,208,83,291,22,313,789,39.67%,26.36%,1
嘉義縣,竹崎鄉,0444,23,3,26,2,28,108,25.93%,21.3%,1
嘉義縣,竹崎鄉,0445,36,10,46,4,50,235,21.28%,15.32%,1
嘉義縣,竹崎鄉,0446,97,32,129,6,135,331,40.79%,29.31%,1
嘉義縣,竹崎鄉,0447,180,74,254,19,273,450,60.67%,40%,1
嘉義縣,竹崎鄉,0448,135,31,166,6,172,462,37.23%,29.22%,1
嘉義縣,竹崎鄉,0449,72,15,87,17,104,251,41.43%,28.69%,1
嘉義縣,梅山鄉,0211,338,130,468,44,512,1041,49.18%,32.47%,1
嘉義縣,梅山鄉,0212,463,175,638,96,734,1245,58.96%,37.19%,1
嘉義縣,梅山鄉,0213,380,129,509,54,563,917,61.4%,41.44%,1
嘉義縣,梅山鄉,0214,432,130,562,63,625,1189,52.57%,36.33%,1
嘉義縣,梅山鄉,0215,541,160,701,81,782,1388,56.34%,38.98%,1
嘉義縣,梅山鄉,0216,663,213,876,71,947,1827,51.83%,36.29%,1
嘉義縣,梅山鄉,0217,231,62,293,44,337,545,61.83%,42.39%,1
嘉義縣,梅山鄉,0218,112,38,150,33,183,407,44.96%,27.52%,1
嘉義縣,梅山鄉,0219,215,81,296,39,335,636,52.67%,33.81%,1
嘉義縣,梅山鄉,0220,202,71,273,57,330,576,57.29%,35.07%,1
嘉義縣,梅山鄉,0221,608,222,830,82,912,1674,54.48%,36.32%,1
嘉義縣,梅山鄉,0222,253,83,336,21,357,858,41.61%,29.49%,1
嘉義縣,梅山鄉,0223,202,91,293,37,330,526,62.74%,38.4%,1
嘉義縣,梅山鄉,0224,101,40,141,39,180,372,48.39%,27.15%,1
嘉義縣,梅山鄉,0225,175,52,227,27,254,506,50.2%,34.58%,1
嘉義縣,梅山鄉,0226,213,36,249,54,303,433,69.98%,49.19%,1
嘉義縣,梅山鄉,0227,109,34,143,17,160,404,39.6%,26.98%,1
嘉義縣,梅山鄉,0228,88,36,124,21,145,293,49.49%,30.03%,1
嘉義縣,梅山鄉,0229,292,82,374,73,447,712,62.78%,41.01%,1
嘉義縣,梅山鄉,0230,259,74,333,40,373,602,61.96%,43.02%,1
嘉義縣,梅山鄉,0231,171,50,221,29,250,515,48.54%,33.2%,1
嘉義縣,梅山鄉,0232,121,30,151,13,164,417,39.33%,29.02%,1
嘉義縣,番路鄉,0450,490,137,627,78,705,1174,60.05%,41.74%,1
嘉義縣,番路鄉,0451,196,48,244,13,257,449,57.24%,43.65%,1
嘉義縣,番路鄉,0452,317,83,400,42,442,753,58.7%,42.1%,1
嘉義縣,番路鄉,0453,170,53,223,35,258,551,46.82%,30.85%,1
嘉義縣,番路鄉,0454,710,198,908,93,1001,1791,55.89%,39.64%,1
嘉義縣,番路鄉,0455,326,141,467,71,538,849,63.37%,38.4%,1
嘉義縣,番路鄉,0456,332,109,441,48,489,866,56.47%,38.34%,1
嘉義縣,番路鄉,0457,335,67,402,37,439,800,54.88%,41.88%,1
嘉義縣,番路鄉,0458,155,59,214,36,250,444,56.31%,34.91%,1
嘉義縣,番路鄉,0459,170,54,224,20,244,635,38.43%,26.77%,1
嘉義縣,番路鄉,0460,96,29,125,18,143,319,44.83%,30.09%,1
嘉義縣,番路鄉,0461,290,51,341,34,375,642,58.41%,45.17%,1
嘉義縣,番路鄉,0462,160,35,195,33,228,509,44.79%,31.43%,1
嘉義縣,番路鄉,0463,61,16,77,0,77,162,47.53%,37.65%,1
嘉義縣,番路鄉,0464,80,22,102,11,113,212,53.3%,37.74%,1
嘉義縣,大埔鄉,0465,545,167,712,89,801,1468,54.56%,37.13%,1
嘉義縣,大埔鄉,0466,89,13,102,9,111,320,34.69%,27.81%,1
嘉義縣,大埔鄉,0467,118,41,159,9,168,304,55.26%,38.82%,1
嘉義縣,大埔鄉,0468,65,23,88,5,93,184,50.54%,35.33%,1
嘉義縣,大埔鄉,0469,108,33,141,13,154,234,65.81%,46.15%,1
嘉義縣,大埔鄉,0470,179,44,223,12,235,495,47.47%,36.16%,1
嘉義縣,大埔鄉,0471,70,30,100,2,102,199,51.26%,35.18%,1
嘉義縣,大埔鄉,0472,58,29,87,14,101,226,44.69%,25.66%,1
嘉義縣,大埔鄉,0473,256,68,324,24,348,569,61.16%,44.99%,1
嘉義縣,阿里山鄉,0474,127,33,160,9,169,371,45.55%,34.23%,1
嘉義縣,阿里山鄉,0475,60,13,73,11,84,197,42.64%,30.46%,1
嘉義縣,阿里山鄉,0476,54,13,67,1,68,152,44.74%,35.53%,1
嘉義縣,阿里山鄉,0477,55,14,69,5,74,231,32.03%,23.81%,1
嘉義縣,阿里山鄉,0478,12,5,17,4,21,72,29.17%,16.67%,1
嘉義縣,阿里山鄉,0479,97,14,111,3,114,311,36.66%,31.19%,1
嘉義縣,阿里山鄉,0480,121,26,147,17,164,306,53.59%,39.54%,1
嘉義縣,阿里山鄉,0481,321,78,399,12,411,970,42.37%,33.09%,1
嘉義縣,阿里山鄉,0482,340,83,423,31,454,827,54.9%,41.11%,1
嘉義縣,阿里山鄉,0483,91,21,112,2,114,238,47.9%,38.24%,1
嘉義縣,阿里山鄉,0484,87,21,108,9,117,479,24.43%,18.16%,1
嘉義縣,阿里山鄉,0485,67,20,87,7,94,291,32.3%,23.02%,1
嘉義縣,阿里山鄉,0486,107,28,135,22,157,246,63.82%,43.5%,1
屏東縣,屏東市,0001,81,39,120,8,128,237,54.01%,34.18%,1
屏東縣,屏東市,0002,91,43,134,31,165,294,56.12%,30.95%,1
屏東縣,屏東市,0003,185,88,273,24,297,582,51.03%,31.79%,1
屏東縣,屏東市,0004,277,96,373,24,397,713,55.68%,38.85%,1
屏東縣,屏東市,0005,194,84,278,37,315,572,55.07%,33.92%,1
屏東縣,屏東市,0006,195,66,261,19,280,455,61.54%,42.86%,1
屏東縣,屏東市,0007,108,32,140,0,140,249,56.22%,43.37%,1
屏東縣,屏東市,0008,406,134,540,36,576,1315,43.8%,30.87%,1
屏東縣,屏東市,0009,404,170,574,47,621,1373,45.23%,29.42%,1
屏東縣,屏東市,0010,282,102,384,52,436,713,61.15%,39.55%,1
屏東縣,屏東市,0011,233,79,312,52,364,573,63.53%,40.66%,1
屏東縣,屏東市,0012,121,56,177,22,199,297,67%,40.74%,1
屏東縣,屏東市,0013,178,85,263,18,281,409,68.7%,43.52%,1
屏東縣,屏東市,0014,98,45,143,17,160,286,55.94%,34.27%,1
屏東縣,屏東市,0015,148,55,203,23,226,421,53.68%,35.15%,1
屏東縣,屏東市,0016,214,95,309,13,322,569,56.59%,37.61%,1
屏東縣,屏東市,0017,152,77,229,18,247,459,53.81%,33.12%,1
屏東縣,屏東市,0018,275,113,388,26,414,672,61.61%,40.92%,1
屏東縣,屏東市,0019,246,123,369,53,422,668,63.17%,36.83%,1
屏東縣,屏東市,0020,159,59,218,18,236,411,57.42%,38.69%,1
屏東縣,屏東市,0021,283,118,401,38,439,768,57.16%,36.85%,1
屏東縣,屏東市,0022,309,93,402,31,433,786,55.09%,39.31%,1
屏東縣,屏東市,0023,354,124,478,42,520,890,58.43%,39.78%,1
屏東縣,屏東市,0024,558,155,713,47,760,1353,56.17%,41.24%,1
屏東縣,屏東市,0025,531,158,689,36,725,1386,52.31%,38.31%,1
屏東縣,屏東市,0026,597,128,725,37,762,1413,53.93%,42.25%,1
屏東縣,屏東市,0027,454,191,645,43,688,1272,54.09%,35.69%,1
屏東縣,屏東市,0028,533,128,661,31,692,1287,53.77%,41.41%,1
屏東縣,屏東市,0029,540,167,707,50,757,1311,57.74%,41.19%,1
屏東縣,屏東市,0030,490,179,669,24,693,1285,53.93%,38.13%,1
屏東縣,屏東市,0031,519,138,657,62,719,1297,55.44%,40.02%,1
屏東縣,屏東市,0032,530,155,685,32,717,1361,52.68%,38.94%,1
屏東縣,屏東市,0033,504,153,657,49,706,1381,51.12%,36.5%,1
屏東縣,屏東市,0034,501,187,688,55,743,1258,59.06%,39.83%,1
屏東縣,屏東市,0035,468,175,643,65,708,1259,56.24%,37.17%,1
屏東縣,屏東市,0036,430,103,533,47,580,1076,53.9%,39.96%,1
屏東縣,屏東市,0037,482,138,620,44,664,1162,57.14%,41.48%,1
屏東縣,屏東市,0038,554,163,717,31,748,1318,56.75%,42.03%,1
屏東縣,屏東市,0039,354,125,479,46,525,939,55.91%,37.7%,1
屏東縣,屏東市,0040,419,107,526,35,561,972,57.72%,43.11%,1
屏東縣,屏東市,0041,625,194,819,44,863,1535,56.22%,40.72%,1
屏東縣,屏東市,0042,477,151,628,44,672,1419,47.36%,33.62%,1
屏東縣,屏東市,0043,513,118,631,37,668,1398,47.78%,36.7%,1
屏東縣,屏東市,0044,525,145,670,63,733,1405,52.17%,37.37%,1
屏東縣,屏東市,0045,596,177,773,42,815,1486,54.85%,40.11%,1
屏東縣,屏東市,0046,391,133,524,67,591,1061,55.7%,36.85%,1
屏東縣,屏東市,0047,465,166,631,109,740,1540,48.05%,30.19%,1
屏東縣,屏東市,0048,350,135,485,22,507,1141,44.43%,30.67%,1
屏東縣,屏東市,0049,442,130,572,40,612,1247,49.08%,35.45%,1
屏東縣,屏東市,0050,541,148,689,43,732,1446,50.62%,37.41%,1
屏東縣,屏東市,0051,517,179,696,47,743,1303,57.02%,39.68%,1
屏東縣,屏東市,0052,495,133,628,54,682,1253,54.43%,39.51%,1
屏東縣,屏東市,0053,556,100,656,56,712,1315,54.14%,42.28%,1
屏東縣,屏東市,0054,499,181,680,48,728,1425,51.09%,35.02%,1
屏東縣,屏東市,0055,507,174,681,24,705,1423,49.54%,35.63%,1
屏東縣,屏東市,0056,547,176,723,52,775,1400,55.36%,39.07%,1
屏東縣,屏東市,0057,525,208,733,50,783,1359,57.62%,38.63%,1
屏東縣,屏東市,0058,581,96,677,38,715,1328,53.84%,43.75%,1
屏東縣,屏東市,0059,627,147,774,41,815,1539,52.96%,40.74%,1
屏東縣,屏東市,0060,105,25,130,5,135,391,34.53%,26.85%,1
屏東縣,屏東市,0061,71,31,102,14,116,200,58%,35.5%,1
屏東縣,屏東市,0062,100,35,135,31,166,328,50.61%,30.49%,1
屏東縣,屏東市,0063,97,19,116,5,121,231,52.38%,41.99%,1
屏東縣,屏東市,0064,332,129,461,61,522,945,55.24%,35.13%,1
屏東縣,屏東市,0065,375,109,484,61,545,1053,51.76%,35.61%,1
屏東縣,屏東市,0066,348,111,459,65,524,1043,50.24%,33.37%,1
屏東縣,屏東市,0067,374,131,505,50,555,1061,52.31%,35.25%,1
屏東縣,屏東市,0068,278,130,408,42,450,876,51.37%,31.74%,1
屏東縣,屏東市,0069,483,175,658,109,767,1468,52.25%,32.9%,1
屏東縣,屏東市,0070,468,172,640,74,714,1454,49.11%,32.19%,1
屏東縣,屏東市,0071,438,149,587,36,623,1205,51.7%,36.35%,1
屏東縣,屏東市,0072,443,152,595,36,631,1284,49.14%,34.5%,1
屏東縣,屏東市,0073,459,118,577,37,614,1219,50.37%,37.65%,1
屏東縣,屏東市,0074,573,195,768,90,858,1544,55.57%,37.11%,1
屏東縣,屏東市,0075,531,180,711,96,807,1485,54.34%,35.76%,1
屏東縣,屏東市,0076,538,161,699,69,768,1387,55.37%,38.79%,1
屏東縣,屏東市,0077,338,107,445,35,480,953,50.37%,35.47%,1
屏東縣,屏東市,0078,607,214,821,57,878,1603,54.77%,37.87%,1
屏東縣,屏東市,0079,182,68,250,35,285,535,53.27%,34.02%,1
屏東縣,屏東市,0080,417,115,532,43,575,1119,51.39%,37.27%,1
屏東縣,屏東市,0081,341,87,428,43,471,847,55.61%,40.26%,1
屏東縣,屏東市,0082,334,135,469,73,542,923,58.72%,36.19%,1
屏東縣,屏東市,0083,402,161,563,46,609,1227,49.63%,32.76%,1
屏東縣,屏東市,0084,387,116,503,61,564,1039,54.28%,37.25%,1
屏東縣,屏東市,0085,501,174,675,110,785,1485,52.86%,33.74%,1
屏東縣,屏東市,0086,116,95,211,62,273,867,31.49%,13.38%,1
屏東縣,屏東市,0087,355,130,485,37,522,918,56.86%,38.67%,1
屏東縣,屏東市,0088,217,77,294,49,343,663,51.73%,32.73%,1
屏東縣,屏東市,0089,385,131,516,26,542,1215,44.61%,31.69%,1
屏東縣,屏東市,0090,524,179,703,87,790,1628,48.53%,32.19%,1
屏東縣,屏東市,0091,503,121,624,46,670,1209,55.42%,41.6%,1
屏東縣,屏東市,0092,537,134,671,22,693,1110,62.43%,48.38%,1
屏東縣,屏東市,0093,219,85,304,19,323,684,47.22%,32.02%,1
屏東縣,屏東市,0094,417,113,530,32,562,1349,41.66%,30.91%,1
屏東縣,屏東市,0095,493,149,642,68,710,1457,48.73%,33.84%,1
屏東縣,屏東市,0096,557,189,746,51,797,1447,55.08%,38.49%,1
屏東縣,屏東市,0097,468,154,622,37,659,1354,48.67%,34.56%,1
屏東縣,屏東市,0098,609,197,806,76,882,1583,55.72%,38.47%,1
屏東縣,屏東市,0099,673,158,831,24,855,1707,50.09%,39.43%,1
屏東縣,屏東市,0100,598,151,749,31,780,1637,47.65%,36.53%,1
屏東縣,屏東市,0101,522,176,698,10,708,1459,48.53%,35.78%,1
屏東縣,屏東市,0102,723,173,896,48,944,1759,53.67%,41.1%,1
屏東縣,屏東市,0103,772,180,952,48,1000,1950,51.28%,39.59%,1
屏東縣,屏東市,0104,683,176,859,58,917,1729,53.04%,39.5%,1
屏東縣,屏東市,0105,619,132,751,34,785,1592,49.31%,38.88%,1
屏東縣,屏東市,0106,543,122,665,54,719,1437,50.03%,37.79%,1
屏東縣,屏東市,0107,471,97,568,34,602,1204,50%,39.12%,1
屏東縣,屏東市,0108,553,130,683,49,732,1340,54.63%,41.27%,1
屏東縣,屏東市,0109,522,151,673,44,717,1322,54.24%,39.49%,1
屏東縣,屏東市,0110,513,151,664,34,698,1462,47.74%,35.09%,1
屏東縣,屏東市,0111,1247,271,1518,54,1572,3241,48.5%,38.48%,1
屏東縣,屏東市,0112,563,124,687,31,718,1477,48.61%,38.12%,1
屏東縣,屏東市,0113,294,62,356,32,388,821,47.26%,35.81%,1
屏東縣,屏東市,0114,349,73,422,27,449,1099,40.86%,31.76%,1
屏東縣,屏東市,0115,682,135,817,53,870,1688,51.54%,40.4%,1
屏東縣,屏東市,0116,410,124,534,48,582,1167,49.87%,35.13%,1
屏東縣,屏東市,0117,327,105,432,56,488,915,53.33%,35.74%,1
屏東縣,屏東市,0118,380,103,483,44,527,1683,31.31%,22.58%,1
屏東縣,屏東市,0119,683,26,709,23,732,1497,48.9%,45.62%,1
屏東縣,屏東市,0120,385,143,528,34,562,1129,49.78%,34.1%,1
屏東縣,屏東市,0121,498,116,614,51,665,1232,53.98%,40.42%,1
屏東縣,屏東市,0122,319,107,426,33,459,853,53.81%,37.4%,1
屏東縣,屏東市,0123,363,115,478,25,503,869,57.88%,41.77%,1
屏東縣,屏東市,0124,484,138,622,47,669,1169,57.23%,41.4%,1
屏東縣,屏東市,0125,427,121,548,37,585,1058,55.29%,40.36%,1
屏東縣,屏東市,0126,480,132,612,56,668,1344,49.7%,35.71%,1
屏東縣,屏東市,0127,502,158,660,30,690,1299,53.12%,38.65%,1
屏東縣,屏東市,0128,400,115,515,50,565,1204,46.93%,33.22%,1
屏東縣,屏東市,0129,421,119,540,43,583,1123,51.91%,37.49%,1
屏東縣,屏東市,0130,402,134,536,45,581,1318,44.08%,30.5%,1
屏東縣,屏東市,0131,352,103,455,59,514,865,59.42%,40.69%,1
屏東縣,屏東市,0132,337,98,435,35,470,1100,42.73%,30.64%,1
屏東縣,屏東市,0133,427,113,540,24,564,1215,46.42%,35.14%,1
屏東縣,屏東市,0134,544,134,678,47,725,1370,52.92%,39.71%,1
屏東縣,屏東市,0135,460,141,601,21,622,1240,50.16%,37.1%,1
屏東縣,屏東市,0136,454,150,604,58,662,1168,56.68%,38.87%,1
屏東縣,屏東市,0137,438,108,546,30,576,1079,53.38%,40.59%,1
屏東縣,屏東市,0138,535,139,674,63,737,1289,57.18%,41.51%,1
屏東縣,屏東市,0139,415,128,543,35,578,1115,51.84%,37.22%,1
屏東縣,屏東市,0140,566,211,777,58,835,1491,56%,37.96%,1
屏東縣,屏東市,0141,494,139,633,44,677,1411,47.98%,35.01%,1
屏東縣,屏東市,0142,655,195,850,40,890,1803,49.36%,36.33%,1
屏東縣,屏東市,0143,312,83,395,31,426,744,57.26%,41.94%,1
屏東縣,屏東市,0144,247,89,336,29,365,678,53.83%,36.43%,1
屏東縣,屏東市,0145,267,93,360,34,394,681,57.86%,39.21%,1
屏東縣,屏東市,0146,464,148,612,37,649,1535,42.28%,30.23%,1
屏東縣,屏東市,0147,355,123,478,62,540,954,56.6%,37.21%,1
屏東縣,屏東市,0148,433,131,564,51,615,1018,60.41%,42.53%,1
屏東縣,屏東市,0149,455,156,611,38,649,1154,56.24%,39.43%,1
屏東縣,潮州鎮,0150,189,67,256,49,305,504,60.52%,37.5%,1
屏東縣,潮州鎮,0151,574,167,741,63,804,1711,46.99%,33.55%,1
屏東縣,潮州鎮,0152,586,187,773,35,808,1634,49.45%,35.86%,1
屏東縣,潮州鎮,0153,483,117,600,41,641,1414,45.33%,34.16%,1
屏東縣,潮州鎮,0154,212,102,314,62,376,603,62.35%,35.16%,1
屏東縣,潮州鎮,0155,315,100,415,72,487,896,54.35%,35.16%,1
屏東縣,潮州鎮,0156,443,152,595,73,668,1285,51.98%,34.47%,1
屏東縣,潮州鎮,0157,629,172,801,70,871,1744,49.94%,36.07%,1
屏東縣,潮州鎮,0158,442,119,561,53,614,1071,57.33%,41.27%,1
屏東縣,潮州鎮,0159,485,149,634,72,706,1209,58.4%,40.12%,1
屏東縣,潮州鎮,0160,433,116,549,55,604,1159,52.11%,37.36%,1
屏東縣,潮州鎮,0161,454,141,595,55,650,1296,50.15%,35.03%,1
屏東縣,潮州鎮,0162,573,157,730,57,787,1466,53.68%,39.09%,1
屏東縣,潮州鎮,0163,420,161,581,64,645,1130,57.08%,37.17%,1
屏東縣,潮州鎮,0164,551,164,715,58,773,1439,53.72%,38.29%,1
屏東縣,潮州鎮,0165,358,106,464,58,522,897,58.19%,39.91%,1
屏東縣,潮州鎮,0166,499,134,633,53,686,1225,56%,40.73%,1
屏東縣,潮州鎮,0167,413,119,532,53,585,1158,50.52%,35.66%,1
屏東縣,潮州鎮,0168,131,49,180,37,217,481,45.11%,27.23%,1
屏東縣,潮州鎮,0169,399,136,535,10,545,972,56.07%,41.05%,1
屏東縣,潮州鎮,0170,485,179,664,60,724,1245,58.15%,38.96%,1
屏東縣,潮州鎮,0171,514,160,674,68,742,1415,52.44%,36.33%,1
屏東縣,潮州鎮,0172,385,126,511,19,530,1255,42.23%,30.68%,1
屏東縣,潮州鎮,0173,285,84,369,39,408,1058,38.56%,26.94%,1
屏東縣,潮州鎮,0174,424,137,561,51,612,1187,51.56%,35.72%,1
屏東縣,潮州鎮,0175,420,103,523,73,596,1083,55.03%,38.78%,1
屏東縣,潮州鎮,0176,515,178,693,52,745,1590,46.86%,32.39%,1
屏東縣,潮州鎮,0177,594,178,772,79,851,1543,55.15%,38.5%,1
屏東縣,潮州鎮,0178,568,183,751,56,807,1631,49.48%,34.83%,1
屏東縣,潮州鎮,0179,477,109,586,35,621,1159,53.58%,41.16%,1
屏東縣,潮州鎮,0180,425,148,573,46,619,1099,56.32%,38.67%,1
屏東縣,潮州鎮,0181,411,123,534,55,589,1200,49.08%,34.25%,1
屏東縣,潮州鎮,0182,487,139,626,78,704,1391,50.61%,35.01%,1
屏東縣,潮州鎮,0183,348,100,448,61,509,881,57.78%,39.5%,1
屏東縣,潮州鎮,0184,120,48,168,25,193,454,42.51%,26.43%,1
屏東縣,潮州鎮,0185,581,192,773,100,873,1658,52.65%,35.04%,1
屏東縣,潮州鎮,0186,251,92,343,39,382,822,46.47%,30.54%,1
屏東縣,潮州鎮,0187,261,102,363,25,388,948,40.93%,27.53%,1
屏東縣,潮州鎮,0188,321,118,439,37,476,1194,39.87%,26.88%,1
屏東縣,潮州鎮,0189,119,37,156,35,191,337,56.68%,35.31%,1
屏東縣,東港鎮,0190,369,148,517,69,586,981,59.73%,37.61%,1
屏東縣,東港鎮,0191,403,158,561,70,631,1070,58.97%,37.66%,1
屏東縣,東港鎮,0192,216,76,292,49,341,527,64.71%,40.99%,1
屏東縣,東港鎮,0193,134,58,192,44,236,395,59.75%,33.92%,1
屏東縣,東港鎮,0194,208,83,291,47,338,659,51.29%,31.56%,1
屏東縣,東港鎮,0195,178,64,242,34,276,513,53.8%,34.7%,1
屏東縣,東港鎮,0196,614,202,816,64,880,1732,50.81%,35.45%,1
屏東縣,東港鎮,0197,692,193,885,64,949,1779,53.34%,38.9%,1
屏東縣,東港鎮,0198,435,150,585,59,644,1270,50.71%,34.25%,1
屏東縣,東港鎮,0199,458,158,616,78,694,1327,52.3%,34.51%,1
屏東縣,東港鎮,0200,460,154,614,80,694,1242,55.88%,37.04%,1
屏東縣,東港鎮,0201,577,189,766,113,879,1607,54.7%,35.91%,1
屏東縣,東港鎮,0202,433,138,571,45,616,1305,47.2%,33.18%,1
屏東縣,東港鎮,0203,254,91,345,46,391,695,56.26%,36.55%,1
屏東縣,東港鎮,0204,468,79,547,113,660,1076,61.34%,43.49%,1
屏東縣,東港鎮,0205,173,76,249,39,288,567,50.79%,30.51%,1
屏東縣,東港鎮,0206,268,82,350,48,398,806,49.38%,33.25%,1
屏東縣,東港鎮,0207,441,157,598,85,683,1227,55.66%,35.94%,1
屏東縣,東港鎮,0208,179,79,258,66,324,599,54.09%,29.88%,1
屏東縣,東港鎮,0209,363,134,497,52,549,1354,40.55%,26.81%,1
屏東縣,東港鎮,0210,240,83,323,65,388,734,52.86%,32.7%,1
屏東縣,東港鎮,0211,381,120,501,134,635,1107,57.36%,34.42%,1
屏東縣,東港鎮,0212,371,113,484,106,590,1198,49.25%,30.97%,1
屏東縣,東港鎮,0213,500,169,669,197,866,1614,53.66%,30.98%,1
屏東縣,東港鎮,0214,250,117,367,52,419,826,50.73%,30.27%,1
屏東縣,東港鎮,0215,337,104,441,75,516,912,56.58%,36.95%,1
屏東縣,東港鎮,0216,119,53,172,51,223,432,51.62%,27.55%,1
屏東縣,東港鎮,0217,419,131,550,130,680,1204,56.48%,34.8%,1
屏東縣,東港鎮,0218,471,168,639,79,718,1304,55.06%,36.12%,1
屏東縣,東港鎮,0219,504,158,662,83,745,1317,56.57%,38.27%,1
屏東縣,東港鎮,0220,493,166,659,48,707,1387,50.97%,35.54%,1
屏東縣,東港鎮,0221,426,126,552,43,595,1310,45.42%,32.52%,1
屏東縣,東港鎮,0222,383,136,519,63,582,1228,47.39%,31.19%,1
屏東縣,東港鎮,0223,210,98,308,65,373,766,48.69%,27.42%,1
屏東縣,東港鎮,0224,287,114,401,71,472,823,57.35%,34.87%,1
屏東縣,東港鎮,0225,200,44,244,22,266,755,35.23%,26.49%,1
屏東縣,東港鎮,0226,383,147,530,91,621,1094,56.76%,35.01%,1
屏東縣,東港鎮,0227,275,63,338,31,369,753,49%,36.52%,1
屏東縣,恆春鎮,0228,313,92,405,30,435,902,48.23%,34.7%,1
屏東縣,恆春鎮,0229,387,120,507,46,553,969,57.07%,39.94%,1
屏東縣,恆春鎮,0230,458,117,575,50,625,1280,48.83%,35.78%,1
屏東縣,恆春鎮,0231,431,131,562,43,605,1133,53.4%,38.04%,1
屏東縣,恆春鎮,0232,492,112,604,14,618,1552,39.82%,31.7%,1
屏東縣,恆春鎮,0233,443,114,557,63,620,1485,41.75%,29.83%,1
屏東縣,恆春鎮,0234,339,104,443,38,481,896,53.68%,37.83%,1
屏東縣,恆春鎮,0235,161,54,215,30,245,531,46.14%,30.32%,1
屏東縣,恆春鎮,0236,142,58,200,9,209,478,43.72%,29.71%,1
屏東縣,恆春鎮,0237,332,112,444,45,489,1020,47.94%,32.55%,1
屏東縣,恆春鎮,0238,293,113,406,27,433,924,46.86%,31.71%,1
屏東縣,恆春鎮,0239,324,101,425,25,450,1079,41.71%,30.03%,1
屏東縣,恆春鎮,0240,198,54,252,25,277,775,35.74%,25.55%,1
屏東縣,恆春鎮,0241,311,75,386,51,437,813,53.75%,38.25%,1
屏東縣,恆春鎮,0242,367,103,470,50,520,1104,47.1%,33.24%,1
屏東縣,恆春鎮,0243,311,126,437,60,497,1110,44.77%,28.02%,1
屏東縣,恆春鎮,0244,163,67,230,67,297,692,42.92%,23.55%,1
屏東縣,恆春鎮,0245,185,41,226,10,236,708,33.33%,26.13%,1
屏東縣,恆春鎮,0246,502,154,656,44,700,1505,46.51%,33.36%,1
屏東縣,恆春鎮,0247,353,99,452,61,513,1111,46.17%,31.77%,1
屏東縣,恆春鎮,0248,512,144,656,48,704,1543,45.63%,33.18%,1
屏東縣,恆春鎮,0249,220,79,299,19,318,828,38.41%,26.57%,1
屏東縣,恆春鎮,0250,307,102,409,30,439,844,52.01%,36.37%,1
屏東縣,恆春鎮,0251,422,129,551,52,603,1253,48.12%,33.68%,1
屏東縣,恆春鎮,0252,379,89,468,45,513,1126,45.56%,33.66%,1
屏東縣,萬丹鄉,0253,425,148,573,71,644,1527,42.17%,27.83%,1
屏東縣,萬丹鄉,0254,374,110,484,79,563,1147,49.08%,32.61%,1
屏東縣,萬丹鄉,0255,286,112,398,47,445,949,46.89%,30.14%,1
屏東縣,萬丹鄉,0256,329,111,440,36,476,990,48.08%,33.23%,1
屏東縣,萬丹鄉,0257,305,95,400,17,417,1022,40.8%,29.84%,1
屏東縣,萬丹鄉,0258,231,72,303,64,367,545,67.34%,42.39%,1
屏東縣,萬丹鄉,0259,425,154,579,101,680,1159,58.67%,36.67%,1
屏東縣,萬丹鄉,0260,292,123,415,81,496,837,59.26%,34.89%,1
屏東縣,萬丹鄉,0261,138,42,180,16,196,392,50%,35.2%,1
屏東縣,萬丹鄉,0262,327,112,439,45,484,847,57.14%,38.61%,1
屏東縣,萬丹鄉,0263,400,118,518,62,580,1149,50.48%,34.81%,1
屏東縣,萬丹鄉,0264,420,129,549,57,606,1131,53.58%,37.14%,1
屏東縣,萬丹鄉,0265,399,154,553,54,607,1178,51.53%,33.87%,1
屏東縣,萬丹鄉,0266,331,54,385,39,424,711,59.63%,46.55%,1
屏東縣,萬丹鄉,0267,219,88,307,36,343,595,57.65%,36.81%,1
屏東縣,萬丹鄉,0268,561,176,737,65,802,1403,57.16%,39.99%,1
屏東縣,萬丹鄉,0269,398,98,496,37,533,1094,48.72%,36.38%,1
屏東縣,萬丹鄉,0270,436,145,581,50,631,1158,54.49%,37.65%,1
屏東縣,萬丹鄉,0271,380,148,528,66,594,963,61.68%,39.46%,1
屏東縣,萬丹鄉,0272,359,135,494,54,548,1062,51.6%,33.8%,1
屏東縣,萬丹鄉,0273,563,212,775,91,866,1684,51.43%,33.43%,1
屏東縣,萬丹鄉,0274,559,183,742,49,791,1702,46.47%,32.84%,1
屏東縣,萬丹鄉,0275,316,128,444,63,507,976,51.95%,32.38%,1
屏東縣,萬丹鄉,0276,340,142,482,75,557,1013,54.99%,33.56%,1
屏東縣,萬丹鄉,0277,232,115,347,35,382,847,45.1%,27.39%,1
屏東縣,萬丹鄉,0278,432,326,758,154,912,1570,58.09%,27.52%,1
屏東縣,萬丹鄉,0279,404,225,629,61,690,1411,48.9%,28.63%,1
屏東縣,萬丹鄉,0280,379,123,502,98,600,1046,57.36%,36.23%,1
屏東縣,萬丹鄉,0281,432,144,576,53,629,1385,45.42%,31.19%,1
屏東縣,萬丹鄉,0282,265,108,373,72,445,804,55.35%,32.96%,1
屏東縣,萬丹鄉,0283,444,157,601,94,695,1284,54.13%,34.58%,1
屏東縣,萬丹鄉,0284,478,162,640,59,699,1430,48.88%,33.43%,1
屏東縣,萬丹鄉,0285,388,137,525,72,597,960,62.19%,40.42%,1
屏東縣,萬丹鄉,0286,306,106,412,64,476,786,60.56%,38.93%,1
屏東縣,萬丹鄉,0287,485,81,566,84,650,1158,56.13%,41.88%,1
屏東縣,萬丹鄉,0288,460,171,631,71,702,1647,42.62%,27.93%,1
屏東縣,萬丹鄉,0289,533,153,686,86,772,1666,46.34%,31.99%,1
屏東縣,萬丹鄉,0290,396,145,541,81,622,1023,60.8%,38.71%,1
屏東縣,萬丹鄉,0291,473,169,642,72,714,1227,58.19%,38.55%,1
屏東縣,長治鄉,0292,356,134,490,75,565,1018,55.5%,34.97%,1
屏東縣,長治鄉,0293,598,195,793,85,878,1614,54.4%,37.05%,1
屏東縣,長治鄉,0294,753,195,948,106,1054,1848,57.03%,40.75%,1
屏東縣,長治鄉,0295,631,201,832,81,913,1707,53.49%,36.97%,1
屏東縣,長治鄉,0296,399,121,520,30,550,972,56.58%,41.05%,1
屏東縣,長治鄉,0297,365,136,501,66,567,989,57.33%,36.91%,1
屏東縣,長治鄉,0298,287,103,390,55,445,735,60.54%,39.05%,1
屏東縣,長治鄉,0299,589,226,815,79,894,1813,49.31%,32.49%,1
屏東縣,長治鄉,0300,467,130,597,51,648,1073,60.39%,43.52%,1
屏東縣,長治鄉,0301,597,200,797,81,878,1654,53.08%,36.09%,1
屏東縣,長治鄉,0302,435,165,600,77,677,1205,56.18%,36.1%,1
屏東縣,長治鄉,0303,291,89,380,51,431,758,56.86%,38.39%,1
屏東縣,長治鄉,0304,483,206,689,112,801,1492,53.69%,32.37%,1
屏東縣,長治鄉,0305,342,94,436,62,498,884,56.33%,38.69%,1
屏東縣,長治鄉,0306,421,124,545,70,615,1090,56.42%,38.62%,1
屏東縣,長治鄉,0307,433,140,573,110,683,1422,48.03%,30.45%,1
屏東縣,長治鄉,0308,282,112,394,68,462,845,54.67%,33.37%,1
屏東縣,長治鄉,0309,304,126,430,110,540,925,58.38%,32.86%,1
屏東縣,長治鄉,0310,387,114,501,113,614,1138,53.95%,34.01%,1
屏東縣,長治鄉,0311,399,178,577,117,694,1242,55.88%,32.13%,1
屏東縣,長治鄉,0312,333,104,437,29,466,1159,40.21%,28.73%,1
屏東縣,長治鄉,0313,281,81,362,39,401,673,59.58%,41.75%,1
屏東縣,麟洛鄉,0314,298,101,399,46,445,788,56.47%,37.82%,1
屏東縣,麟洛鄉,0315,589,177,766,27,793,1386,57.22%,42.5%,1
屏東縣,麟洛鄉,0316,411,127,538,42,580,957,60.61%,42.95%,1
屏東縣,麟洛鄉,0317,288,102,390,54,444,731,60.74%,39.4%,1
屏東縣,麟洛鄉,0318,327,114,441,63,504,806,62.53%,40.57%,1
屏東縣,麟洛鄉,0319,383,142,525,27,552,1207,45.73%,31.73%,1
屏東縣,麟洛鄉,0320,548,176,724,85,809,1340,60.37%,40.9%,1
屏東縣,麟洛鄉,0321,455,176,631,73,704,1221,57.66%,37.26%,1
屏東縣,麟洛鄉,0322,305,104,409,16,425,851,49.94%,35.84%,1
屏東縣,麟洛鄉,0323,234,70,304,18,322,683,47.14%,34.26%,1
屏東縣,九如鄉,0324,528,204,732,105,837,1491,56.14%,35.41%,1
屏東縣,九如鄉,0325,467,183,650,81,731,1375,53.16%,33.96%,1
屏東縣,九如鄉,0326,558,173,731,57,788,1678,46.96%,33.25%,1
屏東縣,九如鄉,0327,434,156,590,89,679,1166,58.23%,37.22%,1
屏東縣,九如鄉,0328,352,144,496,56,552,1276,43.26%,27.59%,1
屏東縣,九如鄉,0329,379,127,506,72,578,1033,55.95%,36.69%,1
屏東縣,九如鄉,0330,273,89,362,35,397,577,68.8%,47.31%,1
屏東縣,九如鄉,0331,255,75,330,70,400,649,61.63%,39.29%,1
屏東縣,九如鄉,0332,682,250,932,156,1088,1999,54.43%,34.12%,1
屏東縣,九如鄉,0333,628,204,832,88,920,1766,52.1%,35.56%,1
屏東縣,九如鄉,0334,505,197,702,125,827,1600,51.69%,31.56%,1
屏東縣,九如鄉,0335,425,162,587,93,680,1248,54.49%,34.05%,1
屏東縣,九如鄉,0336,570,262,832,208,1040,1792,58.04%,31.81%,1
屏東縣,九如鄉,0337,545,143,688,122,810,1482,54.66%,36.77%,1
屏東縣,里港鄉,0338,618,201,819,97,916,1552,59.02%,39.82%,1
屏東縣,里港鄉,0339,501,190,691,97,788,1480,53.24%,33.85%,1
屏東縣,里港鄉,0340,428,187,615,62,677,1534,44.13%,27.9%,1
屏東縣,里港鄉,0341,537,183,720,130,850,1578,53.87%,34.03%,1
屏東縣,里港鄉,0342,429,168,597,69,666,1127,59.09%,38.07%,1
屏東縣,里港鄉,0343,328,108,436,60,496,845,58.7%,38.82%,1
屏東縣,里港鄉,0344,439,155,594,75,669,1282,52.18%,34.24%,1
屏東縣,里港鄉,0345,372,128,500,68,568,981,57.9%,37.92%,1
屏東縣,里港鄉,0346,381,128,509,86,595,1031,57.71%,36.95%,1
屏東縣,里港鄉,0347,488,196,684,114,798,1423,56.08%,34.29%,1
屏東縣,里港鄉,0348,95,38,133,33,166,363,45.73%,26.17%,1
屏東縣,里港鄉,0349,408,156,564,133,697,1203,57.94%,33.92%,1
屏東縣,里港鄉,0350,381,164,545,87,632,1027,61.54%,37.1%,1
屏東縣,里港鄉,0351,431,154,585,66,651,1384,47.04%,31.14%,1
屏東縣,里港鄉,0352,531,169,700,94,794,1512,52.51%,35.12%,1
屏東縣,里港鄉,0353,244,45,289,19,308,522,59%,46.74%,1
屏東縣,里港鄉,0354,283,106,389,70,459,822,55.84%,34.43%,1
屏東縣,里港鄉,0355,305,123,428,99,527,1007,52.33%,30.29%,1
屏東縣,里港鄉,0356,316,135,451,86,537,956,56.17%,33.05%,1
屏東縣,里港鄉,0357,186,65,251,31,282,499,56.51%,37.27%,1
屏東縣,鹽埔鄉,0358,334,102,436,40,476,951,50.05%,35.12%,1
屏東縣,鹽埔鄉,0359,288,99,387,35,422,899,46.94%,32.04%,1
屏東縣,鹽埔鄉,0360,327,102,429,36,465,1116,41.67%,29.3%,1
屏東縣,鹽埔鄉,0361,424,140,564,57,621,1241,50.04%,34.17%,1
屏東縣,鹽埔鄉,0362,239,86,325,62,387,770,50.26%,31.04%,1
屏東縣,鹽埔鄉,0363,351,95,446,56,502,962,52.18%,36.49%,1
屏東縣,鹽埔鄉,0364,402,151,553,74,627,1041,60.23%,38.62%,1
屏東縣,鹽埔鄉,0365,456,163,619,87,706,1367,51.65%,33.36%,1
屏東縣,鹽埔鄉,0366,459,127,586,67,653,1465,44.57%,31.33%,1
屏東縣,鹽埔鄉,0367,268,100,368,54,422,894,47.2%,29.98%,1
屏東縣,鹽埔鄉,0368,308,80,388,6,394,958,41.13%,32.15%,1
屏東縣,鹽埔鄉,0369,309,94,403,91,494,924,53.46%,33.44%,1
屏東縣,鹽埔鄉,0370,487,144,631,48,679,1598,42.49%,30.48%,1
屏東縣,鹽埔鄉,0371,483,213,696,133,829,1550,53.48%,31.16%,1
屏東縣,鹽埔鄉,0372,403,117,520,81,601,1127,53.33%,35.76%,1
屏東縣,鹽埔鄉,0373,440,132,572,96,668,1150,58.09%,38.26%,1
屏東縣,鹽埔鄉,0374,432,166,598,75,673,1233,54.58%,35.04%,1
屏東縣,鹽埔鄉,0375,385,114,499,92,591,984,60.06%,39.13%,1
屏東縣,鹽埔鄉,0376,564,224,788,65,853,1619,52.69%,34.84%,1
屏東縣,鹽埔鄉,0377,201,65,266,39,305,553,55.15%,36.35%,1
屏東縣,高樹鄉,0378,314,140,454,91,545,883,61.72%,35.56%,1
屏東縣,高樹鄉,0379,296,132,428,27,455,1255,36.25%,23.59%,1
屏東縣,高樹鄉,0380,417,141,558,26,584,1278,45.7%,32.63%,1
屏東縣,高樹鄉,0381,207,80,287,27,314,738,42.55%,28.05%,1
屏東縣,高樹鄉,0382,154,79,233,14,247,585,42.22%,26.32%,1
屏東縣,高樹鄉,0383,323,137,460,135,595,1012,58.79%,31.92%,1
屏東縣,高樹鄉,0384,347,125,472,90,562,1148,48.95%,30.23%,1
屏東縣,高樹鄉,0385,172,83,255,35,290,591,49.07%,29.1%,1
屏東縣,高樹鄉,0386,218,89,307,47,354,786,45.04%,27.74%,1
屏東縣,高樹鄉,0387,172,68,240,22,262,649,40.37%,26.5%,1
屏東縣,高樹鄉,0388,297,119,416,82,498,1229,40.52%,24.17%,1
屏東縣,高樹鄉,0389,385,131,516,65,581,1446,40.18%,26.63%,1
屏東縣,高樹鄉,0390,219,104,323,19,342,899,38.04%,24.36%,1
屏東縣,高樹鄉,0391,303,113,416,55,471,922,51.08%,32.86%,1
屏東縣,高樹鄉,0392,374,132,506,83,589,1259,46.78%,29.71%,1
屏東縣,高樹鄉,0393,262,85,347,34,381,1056,36.08%,24.81%,1
屏東縣,高樹鄉,0394,394,139,533,72,605,1116,54.21%,35.3%,1
屏東縣,高樹鄉,0395,325,143,468,91,559,1020,54.8%,31.86%,1
屏東縣,高樹鄉,0396,348,129,477,96,573,1055,54.31%,32.99%,1
屏東縣,高樹鄉,0397,276,92,368,52,420,738,56.91%,37.4%,1
屏東縣,高樹鄉,0398,146,45,191,29,220,493,44.62%,29.61%,1
屏東縣,高樹鄉,0399,533,207,740,116,856,1539,55.62%,34.63%,1
屏東縣,萬巒鄉,0400,375,165,540,40,580,1239,46.81%,30.27%,1
屏東縣,萬巒鄉,0401,258,105,363,61,424,759,55.86%,33.99%,1
屏東縣,萬巒鄉,0402,346,110,456,96,552,932,59.23%,37.12%,1
屏東縣,萬巒鄉,0403,283,111,394,69,463,769,60.21%,36.8%,1
屏東縣,萬巒鄉,0404,326,96,422,83,505,920,54.89%,35.43%,1
屏東縣,萬巒鄉,0405,209,76,285,37,322,560,57.5%,37.32%,1
屏東縣,萬巒鄉,0406,365,107,472,24,496,1120,44.29%,32.59%,1
屏東縣,萬巒鄉,0407,328,112,440,41,481,1048,45.9%,31.3%,1
屏東縣,萬巒鄉,0408,422,141,563,52,615,1438,42.77%,29.35%,1
屏東縣,萬巒鄉,0409,242,106,348,67,415,834,49.76%,29.02%,1
屏東縣,萬巒鄉,0410,258,94,352,71,423,813,52.03%,31.73%,1
屏東縣,萬巒鄉,0411,296,81,377,81,458,1020,44.9%,29.02%,1
屏東縣,萬巒鄉,0412,342,153,495,77,572,1007,56.8%,33.96%,1
屏東縣,萬巒鄉,0413,417,205,622,107,729,1648,44.24%,25.3%,1
屏東縣,萬巒鄉,0414,470,173,643,73,716,1437,49.83%,32.71%,1
屏東縣,萬巒鄉,0415,340,133,473,25,498,1228,40.55%,27.69%,1
屏東縣,萬巒鄉,0416,241,60,301,58,359,597,60.13%,40.37%,1
屏東縣,萬巒鄉,0417,179,77,256,58,314,576,54.51%,31.08%,1
屏東縣,內埔鄉,0418,412,140,552,47,599,1305,45.9%,31.57%,1
屏東縣,內埔鄉,0419,405,117,522,47,569,1287,44.21%,31.47%,1
屏東縣,內埔鄉,0420,466,130,596,24,620,1387,44.7%,33.6%,1
屏東縣,內埔鄉,0421,477,166,643,67,710,1540,46.1%,30.97%,1
屏東縣,內埔鄉,0422,511,189,700,61,761,1605,47.41%,31.84%,1
屏東縣,內埔鄉,0423,432,145,577,71,648,1326,48.87%,32.58%,1
屏東縣,內埔鄉,0424,201,80,281,53,334,591,56.51%,34.01%,1
屏東縣,內埔鄉,0425,367,108,475,52,527,1123,46.93%,32.68%,1
屏東縣,內埔鄉,0426,381,101,482,25,507,1079,46.99%,35.31%,1
屏東縣,內埔鄉,0427,534,166,700,68,768,1485,51.72%,35.96%,1
屏東縣,內埔鄉,0428,501,141,642,54,696,1248,55.77%,40.14%,1
屏東縣,內埔鄉,0429,568,145,713,56,769,1569,49.01%,36.2%,1
屏東縣,內埔鄉,0430,472,163,635,77,712,1493,47.69%,31.61%,1
屏東縣,內埔鄉,0431,456,140,596,18,614,1420,43.24%,32.11%,1
屏東縣,內埔鄉,0432,454,149,603,89,692,1334,51.87%,34.03%,1
屏東縣,內埔鄉,0433,498,155,653,84,737,1519,48.52%,32.78%,1
屏東縣,內埔鄉,0434,276,91,367,53,420,784,53.57%,35.2%,1
屏東縣,內埔鄉,0435,332,101,433,69,502,888,56.53%,37.39%,1
屏東縣,內埔鄉,0436,170,63,233,21,254,747,34%,22.76%,1
屏東縣,內埔鄉,0437,320,104,424,30,454,1168,38.87%,27.4%,1
屏東縣,內埔鄉,0438,188,83,271,41,312,546,57.14%,34.43%,1
屏東縣,內埔鄉,0439,415,57,472,69,541,1278,42.33%,32.47%,1
屏東縣,內埔鄉,0440,278,227,505,76,581,1348,43.1%,20.62%,1
屏東縣,內埔鄉,0441,423,136,559,84,643,1550,41.48%,27.29%,1
屏東縣,內埔鄉,0442,356,132,488,85,573,947,60.51%,37.59%,1
屏東縣,內埔鄉,0443,349,122,471,89,560,1097,51.05%,31.81%,1
屏東縣,內埔鄉,0444,303,111,414,61,475,1128,42.11%,26.86%,1
屏東縣,內埔鄉,0445,267,106,373,31,404,1253,32.24%,21.31%,1
屏東縣,內埔鄉,0446,365,141,506,36,542,1525,35.54%,23.93%,1
屏東縣,內埔鄉,0447,419,118,537,95,632,1215,52.02%,34.49%,1
屏東縣,內埔鄉,0448,353,109,462,26,488,1216,40.13%,29.03%,1
屏東縣,內埔鄉,0449,440,111,551,35,586,1353,43.31%,32.52%,1
屏東縣,內埔鄉,0450,351,93,444,44,488,1026,47.56%,34.21%,1
屏東縣,內埔鄉,0451,259,87,346,32,378,862,43.85%,30.05%,1
屏東縣,內埔鄉,0452,218,96,314,38,352,921,38.22%,23.67%,1
屏東縣,內埔鄉,0453,295,80,375,27,402,854,47.07%,34.54%,1
屏東縣,內埔鄉,0454,369,113,482,41,523,1230,42.52%,30%,1
屏東縣,內埔鄉,0455,337,100,437,32,469,1204,38.95%,27.99%,1
屏東縣,內埔鄉,0456,358,124,482,50,532,1301,40.89%,27.52%,1
屏東縣,內埔鄉,0457,314,76,390,53,443,806,54.96%,38.96%,1
屏東縣,竹田鄉,0458,547,192,739,96,835,1503,55.56%,36.39%,1
屏東縣,竹田鄉,0459,386,125,511,50,561,899,62.4%,42.94%,1
屏東縣,竹田鄉,0460,305,94,399,51,450,716,62.85%,42.6%,1
屏東縣,竹田鄉,0461,238,95,333,49,382,581,65.75%,40.96%,1
屏東縣,竹田鄉,0462,477,161,638,102,740,1327,55.76%,35.95%,1
屏東縣,竹田鄉,0463,360,175,535,85,620,997,62.19%,36.11%,1
屏東縣,竹田鄉,0464,236,72,308,33,341,649,52.54%,36.36%,1
屏東縣,竹田鄉,0465,246,73,319,27,346,476,72.69%,51.68%,1
屏東縣,竹田鄉,0466,503,167,670,69,739,1259,58.7%,39.95%,1
屏東縣,竹田鄉,0467,427,142,569,72,641,1227,52.24%,34.8%,1
屏東縣,竹田鄉,0468,194,89,283,39,322,504,63.89%,38.49%,1
屏東縣,竹田鄉,0469,321,88,409,52,461,860,53.6%,37.33%,1
屏東縣,竹田鄉,0470,280,104,384,23,407,800,50.88%,35%,1
屏東縣,竹田鄉,0471,419,165,584,69,653,1134,57.58%,36.95%,1
屏東縣,竹田鄉,0472,421,170,591,72,663,1229,53.95%,34.26%,1
屏東縣,竹田鄉,0473,417,134,551,73,624,1192,52.35%,34.98%,1
屏東縣,新埤鄉,0474,524,200,724,49,773,1712,45.15%,30.61%,1
屏東縣,新埤鄉,0475,102,37,139,34,173,314,55.1%,32.48%,1
屏東縣,新埤鄉,0476,259,103,362,44,406,752,53.99%,34.44%,1
屏東縣,新埤鄉,0477,121,35,156,27,183,334,54.79%,36.23%,1
屏東縣,新埤鄉,0478,353,66,419,68,487,957,50.89%,36.89%,1
屏東縣,新埤鄉,0479,280,102,382,71,453,764,59.29%,36.65%,1
屏東縣,新埤鄉,0480,119,60,179,34,213,373,57.1%,31.9%,1
屏東縣,新埤鄉,0481,200,80,280,34,314,678,46.31%,29.5%,1
屏東縣,新埤鄉,0482,208,71,279,32,311,701,44.37%,29.67%,1
屏東縣,新埤鄉,0483,337,121,458,77,535,1323,40.44%,25.47%,1
屏東縣,新埤鄉,0484,195,71,266,43,309,541,57.12%,36.04%,1
屏東縣,新埤鄉,0485,182,44,226,35,261,584,44.69%,31.16%,1
屏東縣,枋寮鄉,0486,449,138,587,84,671,1213,55.32%,37.02%,1
屏東縣,枋寮鄉,0487,319,121,440,72,512,891,57.46%,35.8%,1
屏東縣,枋寮鄉,0488,299,102,401,94,495,970,51.03%,30.82%,1
屏東縣,枋寮鄉,0489,237,60,297,37,334,629,53.1%,37.68%,1
屏東縣,枋寮鄉,0490,322,105,427,47,474,840,56.43%,38.33%,1
屏東縣,枋寮鄉,0491,306,88,394,43,437,774,56.46%,39.53%,1
屏東縣,枋寮鄉,0492,447,171,618,88,706,1379,51.2%,32.41%,1
屏東縣,枋寮鄉,0493,578,160,738,70,808,1502,53.79%,38.48%,1
屏東縣,枋寮鄉,0494,419,137,556,98,654,1276,51.25%,32.84%,1
屏東縣,枋寮鄉,0495,327,115,442,74,516,964,53.53%,33.92%,1
屏東縣,枋寮鄉,0496,385,123,508,96,604,1005,60.1%,38.31%,1
屏東縣,枋寮鄉,0497,238,65,303,25,328,734,44.69%,32.43%,1
屏東縣,枋寮鄉,0498,262,80,342,66,408,725,56.28%,36.14%,1
屏東縣,枋寮鄉,0499,310,125,435,76,511,1046,48.85%,29.64%,1
屏東縣,枋寮鄉,0500,406,126,532,82,614,1067,57.54%,38.05%,1
屏東縣,枋寮鄉,0501,145,63,208,69,277,718,38.58%,20.19%,1
屏東縣,枋寮鄉,0502,278,93,371,53,424,903,46.95%,30.79%,1
屏東縣,枋寮鄉,0503,431,169,600,89,689,1387,49.68%,31.07%,1
屏東縣,枋寮鄉,0504,474,180,654,86,740,1367,54.13%,34.67%,1
屏東縣,枋寮鄉,0505,236,98,334,51,385,618,62.3%,38.19%,1
屏東縣,枋寮鄉,0506,265,85,350,40,390,959,40.67%,27.63%,1
屏東縣,枋寮鄉,0507,159,47,206,29,235,427,55.04%,37.24%,1
屏東縣,新園鄉,0508,294,124,418,54,472,820,57.56%,35.85%,1
屏東縣,新園鄉,0509,353,92,445,60,505,843,59.91%,41.87%,1
屏東縣,新園鄉,0510,443,134,577,66,643,1242,51.77%,35.67%,1
屏東縣,新園鄉,0511,519,157,676,64,740,1290,57.36%,40.23%,1
屏東縣,新園鄉,0512,383,127,510,52,562,1073,52.38%,35.69%,1
屏東縣,新園鄉,0513,375,149,524,104,628,1088,57.72%,34.47%,1
屏東縣,新園鄉,0514,288,85,373,48,421,845,49.82%,34.08%,1
屏東縣,新園鄉,0515,297,113,410,14,424,862,49.19%,34.45%,1
屏東縣,新園鄉,0516,361,155,516,82,598,1183,50.55%,30.52%,1
屏東縣,新園鄉,0517,421,94,515,95,610,1109,55%,37.96%,1
屏東縣,新園鄉,0518,357,106,463,17,480,1119,42.9%,31.9%,1
屏東縣,新園鄉,0519,378,140,518,47,565,1152,49.05%,32.81%,1
屏東縣,新園鄉,0520,377,130,507,61,568,1030,55.15%,36.6%,1
屏東縣,新園鄉,0521,364,115,479,110,589,1104,53.35%,32.97%,1
屏東縣,新園鄉,0522,361,130,491,0,491,1240,39.6%,29.11%,1
屏東縣,新園鄉,0523,268,122,390,31,421,1120,37.59%,23.93%,1
屏東縣,新園鄉,0524,397,145,542,82,624,1074,58.1%,36.96%,1
屏東縣,新園鄉,0525,258,87,345,52,397,849,46.76%,30.39%,1
屏東縣,新園鄉,0526,227,118,345,67,412,749,55.01%,30.31%,1
屏東縣,新園鄉,0527,449,174,623,92,715,1416,50.49%,31.71%,1
屏東縣,新園鄉,0528,303,103,406,74,480,895,53.63%,33.85%,1
屏東縣,新園鄉,0529,336,113,449,71,520,933,55.73%,36.01%,1
屏東縣,新園鄉,0530,336,115,451,60,511,972,52.57%,34.57%,1
屏東縣,新園鄉,0531,372,135,507,95,602,1454,41.4%,25.58%,1
屏東縣,新園鄉,0532,588,208,796,169,965,1653,58.38%,35.57%,1
屏東縣,新園鄉,0533,394,120,514,122,636,1270,50.08%,31.02%,1
屏東縣,新園鄉,0534,419,150,569,157,726,1123,64.65%,37.31%,1
屏東縣,新園鄉,0535,351,136,487,126,613,1198,51.17%,29.3%,1
屏東縣,崁頂鄉,0536,418,101,519,47,566,1190,47.56%,35.13%,1
屏東縣,崁頂鄉,0537,387,123,510,69,579,1044,55.46%,37.07%,1
屏東縣,崁頂鄉,0538,286,113,399,52,451,818,55.13%,34.96%,1
屏東縣,崁頂鄉,0539,423,139,562,61,623,1214,51.32%,34.84%,1
屏東縣,崁頂鄉,0540,425,129,554,43,597,1325,45.06%,32.08%,1
屏東縣,崁頂鄉,0541,495,134,629,69,698,1253,55.71%,39.51%,1
屏東縣,崁頂鄉,0542,358,114,472,56,528,1039,50.82%,34.46%,1
屏東縣,崁頂鄉,0543,242,88,330,54,384,813,47.23%,29.77%,1
屏東縣,崁頂鄉,0544,229,71,300,30,330,736,44.84%,31.11%,1
屏東縣,崁頂鄉,0545,329,145,474,48,522,934,55.89%,35.22%,1
屏東縣,崁頂鄉,0546,279,129,408,63,471,900,52.33%,31%,1
屏東縣,崁頂鄉,0547,356,114,470,57,527,1004,52.49%,35.46%,1
屏東縣,林邊鄉,0548,561,189,750,122,872,1458,59.81%,38.48%,1
屏東縣,林邊鄉,0549,336,110,446,59,505,891,56.68%,37.71%,1
屏東縣,林邊鄉,0550,293,75,368,48,416,695,59.86%,42.16%,1
屏東縣,林邊鄉,0551,375,148,523,80,603,1015,59.41%,36.95%,1
屏東縣,林邊鄉,0552,470,142,612,60,672,1171,57.39%,40.14%,1
屏東縣,林邊鄉,0553,354,109,463,60,523,1003,52.14%,35.29%,1
屏東縣,林邊鄉,0554,287,124,411,48,459,725,63.31%,39.59%,1
屏東縣,林邊鄉,0555,282,123,405,85,490,841,58.26%,33.53%,1
屏東縣,林邊鄉,0556,304,102,406,65,471,793,59.39%,38.34%,1
屏東縣,林邊鄉,0557,378,103,481,64,545,919,59.3%,41.13%,1
屏東縣,林邊鄉,0558,424,143,567,73,640,1283,49.88%,33.05%,1
屏東縣,林邊鄉,0559,214,101,315,55,370,783,47.25%,27.33%,1
屏東縣,林邊鄉,0560,305,76,381,63,444,1033,42.98%,29.53%,1
屏東縣,林邊鄉,0561,387,139,526,109,635,1186,53.54%,32.63%,1
屏東縣,林邊鄉,0562,241,101,342,78,420,773,54.33%,31.18%,1
屏東縣,林邊鄉,0563,342,123,465,39,504,1122,44.92%,30.48%,1
屏東縣,南州鄉,0564,306,76,382,54,436,872,50%,35.09%,1
屏東縣,南州鄉,0565,288,93,381,54,435,794,54.79%,36.27%,1
屏東縣,南州鄉,0566,361,134,495,61,556,962,57.8%,37.53%,1
屏東縣,南州鄉,0567,369,128,497,72,569,1033,55.08%,35.72%,1
屏東縣,南州鄉,0568,329,128,457,59,516,1007,51.24%,32.67%,1
屏東縣,南州鄉,0569,177,70,247,25,272,466,58.37%,37.98%,1
屏東縣,南州鄉,0570,291,80,371,43,414,708,58.47%,41.1%,1
屏東縣,南州鄉,0571,383,135,518,73,591,1044,56.61%,36.69%,1
屏東縣,南州鄉,0572,300,86,386,42,428,1071,39.96%,28.01%,1
屏東縣,南州鄉,0573,294,113,407,35,442,979,45.15%,30.03%,1
屏東縣,南州鄉,0574,181,55,236,37,273,543,50.28%,33.33%,1
屏東縣,佳冬鄉,0575,460,151,611,76,687,1472,46.67%,31.25%,1
屏東縣,佳冬鄉,0576,383,122,505,86,591,1360,43.46%,28.16%,1
屏東縣,佳冬鄉,0577,274,114,388,74,462,804,57.46%,34.08%,1
屏東縣,佳冬鄉,0578,294,112,406,80,486,925,52.54%,31.78%,1
屏東縣,佳冬鄉,0579,242,97,339,24,363,855,42.46%,28.3%,1
屏東縣,佳冬鄉,0580,320,99,419,41,460,981,46.89%,32.62%,1
屏東縣,佳冬鄉,0581,321,105,426,69,495,1007,49.16%,31.88%,1
屏東縣,佳冬鄉,0582,234,102,336,62,398,872,45.64%,26.83%,1
屏東縣,佳冬鄉,0583,389,107,496,72,568,1255,45.26%,31%,1
屏東縣,佳冬鄉,0584,353,87,440,105,545,995,54.77%,35.48%,1
屏東縣,佳冬鄉,0585,181,70,251,25,276,734,37.6%,24.66%,1
屏東縣,佳冬鄉,0586,337,114,451,43,494,1178,41.94%,28.61%,1
屏東縣,佳冬鄉,0587,317,115,432,63,495,1095,45.21%,28.95%,1
屏東縣,佳冬鄉,0588,371,140,511,128,639,1097,58.25%,33.82%,1
屏東縣,佳冬鄉,0589,427,152,579,78,657,1273,51.61%,33.54%,1
屏東縣,佳冬鄉,0590,414,167,581,75,656,1160,56.55%,35.69%,1
屏東縣,琉球鄉,0591,303,83,386,53,439,1111,39.51%,27.27%,1
屏東縣,琉球鄉,0592,293,76,369,60,429,972,44.14%,30.14%,1
屏東縣,琉球鄉,0593,447,114,561,88,649,1278,50.78%,34.98%,1
屏東縣,琉球鄉,0594,326,78,404,91,495,976,50.72%,33.4%,1
屏東縣,琉球鄉,0595,526,167,693,93,786,1658,47.41%,31.72%,1
屏東縣,琉球鄉,0596,299,80,379,57,436,1146,38.05%,26.09%,1
屏東縣,琉球鄉,0597,90,75,165,53,218,1079,20.2%,8.34%,1
屏東縣,琉球鄉,0598,379,81,460,35,495,1613,30.69%,23.5%,1
屏東縣,琉球鄉,0599,299,73,372,72,444,873,50.86%,34.25%,1
屏東縣,車城鄉,0600,193,67,260,49,309,737,41.93%,26.19%,1
屏東縣,車城鄉,0601,151,55,206,35,241,647,37.25%,23.34%,1
屏東縣,車城鄉,0602,156,40,196,20,216,491,43.99%,31.77%,1
屏東縣,車城鄉,0603,279,85,364,33,397,856,46.38%,32.59%,1
屏東縣,車城鄉,0604,151,61,212,11,223,554,40.25%,27.26%,1
屏東縣,車城鄉,0605,101,32,133,6,139,388,35.82%,26.03%,1
屏東縣,車城鄉,0606,218,97,315,50,365,922,39.59%,23.64%,1
屏東縣,車城鄉,0607,132,37,169,9,178,597,29.82%,22.11%,1
屏東縣,車城鄉,0608,117,51,168,11,179,623,28.73%,18.78%,1
屏東縣,車城鄉,0609,126,40,166,25,191,425,44.94%,29.65%,1
屏東縣,車城鄉,0610,155,41,196,20,216,428,50.47%,36.21%,1
屏東縣,車城鄉,0611,115,35,150,14,164,504,32.54%,22.82%,1
屏東縣,車城鄉,0612,129,53,182,23,205,423,48.46%,30.5%,1
屏東縣,滿州鄉,0613,520,153,673,51,724,1575,45.97%,33.02%,1
屏東縣,滿州鄉,0614,131,40,171,13,184,420,43.81%,31.19%,1
屏東縣,滿州鄉,0615,226,90,316,33,349,602,57.97%,37.54%,1
屏東縣,滿州鄉,0616,331,102,433,23,456,1302,35.02%,25.42%,1
屏東縣,滿州鄉,0617,440,140,580,57,637,1314,48.48%,33.49%,1
屏東縣,滿州鄉,0618,282,72,354,36,390,1308,29.82%,21.56%,1
屏東縣,滿州鄉,0619,84,36,120,15,135,367,36.78%,22.89%,1
屏東縣,滿州鄉,0620,109,30,139,27,166,318,52.2%,34.28%,1
屏東縣,枋山鄉,0621,258,73,331,34,365,604,60.43%,42.72%,1
屏東縣,枋山鄉,0622,173,50,223,35,258,428,60.28%,40.42%,1
屏東縣,枋山鄉,0623,389,113,502,75,577,928,62.18%,41.92%,1
屏東縣,枋山鄉,0624,323,112,435,24,459,972,47.22%,33.23%,1
屏東縣,枋山鄉,0625,286,100,386,67,453,1041,43.52%,27.47%,1
屏東縣,枋山鄉,0626,187,82,269,21,290,883,32.84%,21.18%,1
屏東縣,三地門鄉,0627,186,49,235,22,257,616,41.72%,30.19%,1
屏東縣,三地門鄉,0628,199,69,268,76,344,572,60.14%,34.79%,1
屏東縣,三地門鄉,0629,101,26,127,14,141,323,43.65%,31.27%,1
屏東縣,三地門鄉,0630,564,161,725,68,793,1448,54.77%,38.95%,1
屏東縣,三地門鄉,0631,164,44,208,6,214,726,29.48%,22.59%,1
屏東縣,三地門鄉,0632,193,60,253,31,284,554,51.26%,34.84%,1
屏東縣,三地門鄉,0633,114,50,164,16,180,346,52.02%,32.95%,1
屏東縣,三地門鄉,0634,111,44,155,1,156,458,34.06%,24.24%,1
屏東縣,三地門鄉,0635,264,77,341,16,357,692,51.59%,38.15%,1
屏東縣,三地門鄉,0636,312,64,376,70,446,638,69.91%,48.9%,1
屏東縣,霧臺鄉,0637,183,53,236,30,266,346,76.88%,52.89%,1
屏東縣,霧臺鄉,0638,257,69,326,12,338,677,49.93%,37.96%,1
屏東縣,霧臺鄉,0639,40,9,49,1,50,162,30.86%,24.69%,1
屏東縣,霧臺鄉,0640,71,15,86,4,90,189,47.62%,37.57%,1
屏東縣,霧臺鄉,0641,145,27,172,38,210,296,70.95%,48.99%,1
屏東縣,霧臺鄉,0642,174,79,253,12,265,483,54.87%,36.02%,1
屏東縣,霧臺鄉,0643,93,37,130,3,133,347,38.33%,26.8%,1
屏東縣,霧臺鄉,0644,143,51,194,12,206,450,45.78%,31.78%,1
屏東縣,瑪家鄉,0645,168,44,212,5,217,455,47.69%,36.92%,1
屏東縣,瑪家鄉,0646,345,144,489,54,543,821,66.14%,42.02%,1
屏東縣,瑪家鄉,0647,291,95,386,74,460,635,72.44%,45.83%,1
屏東縣,瑪家鄉,0648,376,102,478,39,517,695,74.39%,54.1%,1
屏東縣,瑪家鄉,0649,330,62,392,32,424,671,63.19%,49.18%,1
屏東縣,瑪家鄉,0650,303,102,405,22,427,1057,40.4%,28.67%,1
屏東縣,瑪家鄉,0651,372,96,468,19,487,900,54.11%,41.33%,1
屏東縣,瑪家鄉,0652,161,36,197,7,204,429,47.55%,37.53%,1
屏東縣,泰武鄉,0653,273,65,338,19,357,669,53.36%,40.81%,1
屏東縣,泰武鄉,0654,62,24,86,7,93,190,48.95%,32.63%,1
屏東縣,泰武鄉,0655,386,143,529,78,607,922,65.84%,41.87%,1
屏東縣,泰武鄉,0656,283,92,375,67,442,598,73.91%,47.32%,1
屏東縣,泰武鄉,0657,356,86,442,61,503,771,65.24%,46.17%,1
屏東縣,泰武鄉,0658,183,67,250,52,302,414,72.95%,44.2%,1
屏東縣,泰武鄉,0659,248,103,351,41,392,780,50.26%,31.79%,1
屏東縣,來義鄉,0660,404,77,481,108,589,917,64.23%,44.06%,1
屏東縣,來義鄉,0661,131,36,167,13,180,361,49.86%,36.29%,1
屏東縣,來義鄉,0662,63,11,74,0,74,216,34.26%,29.17%,1
屏東縣,來義鄉,0663,271,39,310,26,336,445,75.51%,60.9%,1
屏東縣,來義鄉,0664,126,28,154,28,182,280,65%,45%,1
屏東縣,來義鄉,0665,500,99,599,50,649,1097,59.16%,45.58%,1
屏東縣,來義鄉,0666,393,96,489,70,559,840,66.55%,46.79%,1
屏東縣,來義鄉,0667,302,98,400,21,421,889,47.36%,33.97%,1
屏東縣,來義鄉,0668,386,158,544,33,577,1212,47.61%,31.85%,1
屏東縣,春日鄉,0669,140,45,185,7,192,909,21.12%,15.4%,1
屏東縣,春日鄉,0670,118,61,179,20,199,663,30.02%,17.8%,1
屏東縣,春日鄉,0671,33,7,40,0,40,304,13.16%,10.86%,1
屏東縣,春日鄉,0672,251,63,314,22,336,928,36.21%,27.05%,1
屏東縣,春日鄉,0673,118,35,153,9,162,641,25.27%,18.41%,1
屏東縣,春日鄉,0674,79,22,101,3,104,478,21.76%,16.53%,1
屏東縣,獅子鄉,0675,293,45,338,17,355,751,47.27%,39.01%,1
屏東縣,獅子鄉,0676,268,52,320,33,353,776,45.49%,34.54%,1
屏東縣,獅子鄉,0677,216,41,257,14,271,711,38.12%,30.38%,1
屏東縣,獅子鄉,0678,106,48,154,27,181,243,74.49%,43.62%,1
屏東縣,獅子鄉,0679,128,37,165,13,178,325,54.77%,39.38%,1
屏東縣,獅子鄉,0680,99,25,124,6,130,476,27.31%,20.8%,1
屏東縣,獅子鄉,0681,182,42,224,10,234,602,38.87%,30.23%,1
屏東縣,獅子鄉,0682,90,24,114,7,121,346,34.97%,26.01%,1
屏東縣,牡丹鄉,0683,104,26,130,12,142,342,41.52%,30.41%,1
屏東縣,牡丹鄉,0684,498,110,608,55,663,1306,50.77%,38.13%,1
屏東縣,牡丹鄉,0685,138,22,160,6,166,693,23.95%,19.91%,1
屏東縣,牡丹鄉,0686,109,39,148,12,160,437,36.61%,24.94%,1
屏東縣,牡丹鄉,0687,140,44,184,10,194,392,49.49%,35.71%,1
屏東縣,牡丹鄉,0688,208,56,264,11,275,593,46.37%,35.08%,1
屏東縣,牡丹鄉,0689,108,17,125,6,131,551,23.77%,19.6%,1
宜蘭縣,宜蘭市,0001,384,107,491,24,515,982,52.44%,39.1%,1
宜蘭縣,宜蘭市,0002,510,127,637,61,698,1270,54.96%,40.16%,1
宜蘭縣,宜蘭市,0003,344,91,435,26,461,849,54.3%,40.52%,1
宜蘭縣,宜蘭市,0004,322,93,415,25,440,756,58.2%,42.59%,1
宜蘭縣,宜蘭市,0005,428,74,502,57,559,1107,50.5%,38.66%,1
宜蘭縣,宜蘭市,0006,354,93,447,49,496,893,55.54%,39.64%,1
宜蘭縣,宜蘭市,0007,375,90,465,39,504,912,55.26%,41.12%,1
宜蘭縣,宜蘭市,0008,529,148,677,72,749,1335,56.1%,39.63%,1
宜蘭縣,宜蘭市,0009,247,82,329,36,365,686,53.21%,36.01%,1
宜蘭縣,宜蘭市,0010,619,153,772,41,813,1366,59.52%,45.31%,1
宜蘭縣,宜蘭市,0011,592,150,742,35,777,1363,57.01%,43.43%,1
宜蘭縣,宜蘭市,0012,685,144,829,54,883,1540,57.34%,44.48%,1
宜蘭縣,宜蘭市,0013,582,121,703,26,729,1341,54.36%,43.4%,1
宜蘭縣,宜蘭市,0014,483,135,618,64,682,1209,56.41%,39.95%,1
宜蘭縣,宜蘭市,0015,353,99,452,55,507,900,56.33%,39.22%,1
宜蘭縣,宜蘭市,0016,368,100,468,46,514,980,52.45%,37.55%,1
宜蘭縣,宜蘭市,0017,465,142,607,35,642,1165,55.11%,39.91%,1
宜蘭縣,宜蘭市,0018,398,78,476,25,501,904,55.42%,44.03%,1
宜蘭縣,宜蘭市,0019,336,90,426,31,457,813,56.21%,41.33%,1
宜蘭縣,宜蘭市,0020,381,114,495,45,540,978,55.21%,38.96%,1
宜蘭縣,宜蘭市,0021,434,116,550,32,582,1282,45.4%,33.85%,1
宜蘭縣,宜蘭市,0022,189,66,255,14,269,465,57.85%,40.65%,1
宜蘭縣,宜蘭市,0023,264,82,346,45,391,669,58.45%,39.46%,1
宜蘭縣,宜蘭市,0024,406,82,488,40,528,923,57.2%,43.99%,1
宜蘭縣,宜蘭市,0025,385,103,488,44,532,1006,52.88%,38.27%,1
宜蘭縣,宜蘭市,0026,335,111,446,50,496,762,65.09%,43.96%,1
宜蘭縣,宜蘭市,0027,290,110,400,48,448,727,61.62%,39.89%,1
宜蘭縣,宜蘭市,0028,365,110,475,69,544,833,65.31%,43.82%,1
宜蘭縣,宜蘭市,0029,485,130,615,30,645,1143,56.43%,42.43%,1
宜蘭縣,宜蘭市,0030,408,100,508,24,532,979,54.34%,41.68%,1
宜蘭縣,宜蘭市,0031,478,123,601,60,661,1214,54.45%,39.37%,1
宜蘭縣,宜蘭市,0032,459,185,644,97,741,1283,57.76%,35.78%,1
宜蘭縣,宜蘭市,0033,409,101,510,38,548,946,57.93%,43.23%,1
宜蘭縣,宜蘭市,0034,460,85,545,40,585,1090,53.67%,42.2%,1
宜蘭縣,宜蘭市,0035,410,94,504,29,533,943,56.52%,43.48%,1
宜蘭縣,宜蘭市,0036,345,109,454,39,493,774,63.7%,44.57%,1
宜蘭縣,宜蘭市,0037,436,108,544,46,590,968,60.95%,45.04%,1
宜蘭縣,宜蘭市,0038,425,117,542,30,572,926,61.77%,45.9%,1
宜蘭縣,宜蘭市,0039,437,120,557,55,612,1019,60.06%,42.89%,1
宜蘭縣,宜蘭市,0040,443,111,554,58,612,1084,56.46%,40.87%,1
宜蘭縣,宜蘭市,0041,439,119,558,35,593,1095,54.16%,40.09%,1
宜蘭縣,宜蘭市,0042,472,117,589,31,620,1083,57.25%,43.58%,1
宜蘭縣,宜蘭市,0043,448,108,556,35,591,1108,53.34%,40.43%,1
宜蘭縣,宜蘭市,0044,366,103,469,25,494,848,58.25%,43.16%,1
宜蘭縣,宜蘭市,0045,460,113,573,31,604,1095,55.16%,42.01%,1
宜蘭縣,宜蘭市,0046,483,114,597,29,626,1110,56.4%,43.51%,1
宜蘭縣,宜蘭市,0047,478,109,587,56,643,1104,58.24%,43.3%,1
宜蘭縣,宜蘭市,0048,479,116,595,46,641,1134,56.53%,42.24%,1
宜蘭縣,宜蘭市,0049,484,133,617,43,660,1146,57.59%,42.23%,1
宜蘭縣,宜蘭市,0050,370,105,475,53,528,876,60.27%,42.24%,1
宜蘭縣,宜蘭市,0051,359,85,444,62,506,905,55.91%,39.67%,1
宜蘭縣,宜蘭市,0052,388,96,484,50,534,910,58.68%,42.64%,1
宜蘭縣,宜蘭市,0053,506,122,628,51,679,1434,47.35%,35.29%,1
宜蘭縣,宜蘭市,0054,432,129,561,76,637,1152,55.3%,37.5%,1
宜蘭縣,宜蘭市,0055,396,133,529,48,577,966,59.73%,40.99%,1
宜蘭縣,宜蘭市,0056,283,87,370,44,414,711,58.23%,39.8%,1
宜蘭縣,宜蘭市,0057,375,111,486,48,534,884,60.41%,42.42%,1
宜蘭縣,宜蘭市,0058,534,165,699,65,764,1326,57.62%,40.27%,1
宜蘭縣,宜蘭市,0059,327,104,431,33,464,909,51.05%,35.97%,1
宜蘭縣,宜蘭市,0060,342,97,439,50,489,894,54.7%,38.26%,1
宜蘭縣,宜蘭市,0061,462,133,595,40,635,1259,50.44%,36.7%,1
宜蘭縣,宜蘭市,0062,306,77,383,36,419,789,53.11%,38.78%,1
宜蘭縣,宜蘭市,0063,342,96,438,38,476,867,54.9%,39.45%,1
宜蘭縣,宜蘭市,0064,536,182,718,88,806,1454,55.43%,36.86%,1
宜蘭縣,宜蘭市,0065,528,123,651,41,692,1130,61.24%,46.73%,1
宜蘭縣,宜蘭市,0066,405,71,476,30,506,1087,46.55%,37.26%,1
宜蘭縣,宜蘭市,0067,412,110,522,56,578,938,61.62%,43.92%,1
宜蘭縣,宜蘭市,0068,503,142,645,71,716,1285,55.72%,39.14%,1
宜蘭縣,宜蘭市,0069,342,109,451,28,479,952,50.32%,35.92%,1
宜蘭縣,宜蘭市,0070,363,141,504,67,571,948,60.23%,38.29%,1
宜蘭縣,宜蘭市,0071,425,122,547,62,609,1160,52.5%,36.64%,1
宜蘭縣,宜蘭市,0072,417,116,533,70,603,1015,59.41%,41.08%,1
宜蘭縣,宜蘭市,0073,196,49,245,16,261,424,61.56%,46.23%,1
宜蘭縣,宜蘭市,0074,394,110,504,59,563,964,58.4%,40.87%,1
宜蘭縣,宜蘭市,0075,344,113,457,58,515,959,53.7%,35.87%,1
宜蘭縣,宜蘭市,0076,369,106,475,45,520,814,63.88%,45.33%,1
宜蘭縣,宜蘭市,0077,329,138,467,59,526,885,59.44%,37.18%,1
宜蘭縣,宜蘭市,0078,451,149,600,77,677,1162,58.26%,38.81%,1
宜蘭縣,羅東鎮,0079,288,82,370,37,407,689,59.07%,41.8%,1
宜蘭縣,羅東鎮,0080,281,88,369,29,398,718,55.43%,39.14%,1
宜蘭縣,羅東鎮,0081,541,192,733,85,818,1475,55.46%,36.68%,1
宜蘭縣,羅東鎮,0082,539,177,716,81,797,1466,54.37%,36.77%,1
宜蘭縣,羅東鎮,0083,434,123,557,46,603,1075,56.09%,40.37%,1
宜蘭縣,羅東鎮,0084,378,116,494,42,536,963,55.66%,39.25%,1
宜蘭縣,羅東鎮,0085,553,153,706,105,811,1511,53.67%,36.6%,1
宜蘭縣,羅東鎮,0086,453,132,585,42,627,1166,53.77%,38.85%,1
宜蘭縣,羅東鎮,0087,496,173,669,68,737,1273,57.89%,38.96%,1
宜蘭縣,羅東鎮,0088,690,171,861,53,914,1735,52.68%,39.77%,1
宜蘭縣,羅東鎮,0089,612,166,778,62,840,1487,56.49%,41.16%,1
宜蘭縣,羅東鎮,0090,354,106,460,42,502,837,59.98%,42.29%,1
宜蘭縣,羅東鎮,0091,540,171,711,73,784,1312,59.76%,41.16%,1
宜蘭縣,羅東鎮,0092,580,148,728,69,797,1502,53.06%,38.62%,1
宜蘭縣,羅東鎮,0093,428,121,549,31,580,1138,50.97%,37.61%,1
宜蘭縣,羅東鎮,0094,381,122,503,57,560,1010,55.45%,37.72%,1
宜蘭縣,羅東鎮,0095,506,184,690,99,789,1373,57.47%,36.85%,1
宜蘭縣,羅東鎮,0096,425,131,556,51,607,1089,55.74%,39.03%,1
宜蘭縣,羅東鎮,0097,519,132,651,57,708,1304,54.29%,39.8%,1
宜蘭縣,羅東鎮,0098,469,147,616,73,689,1288,53.49%,36.41%,1
宜蘭縣,羅東鎮,0099,443,130,573,68,641,1036,61.87%,42.76%,1
宜蘭縣,羅東鎮,0100,444,118,562,52,614,969,63.36%,45.82%,1
宜蘭縣,羅東鎮,0101,409,126,535,56,591,985,60%,41.52%,1
宜蘭縣,羅東鎮,0102,546,189,735,96,831,1420,58.52%,38.45%,1
宜蘭縣,羅東鎮,0103,613,151,764,57,821,1430,57.41%,42.87%,1
宜蘭縣,羅東鎮,0104,438,128,566,65,631,1075,58.7%,40.74%,1
宜蘭縣,羅東鎮,0105,378,98,476,45,521,879,59.27%,43%,1
宜蘭縣,羅東鎮,0106,336,99,435,34,469,850,55.18%,39.53%,1
宜蘭縣,羅東鎮,0107,470,144,614,48,662,1111,59.59%,42.3%,1
宜蘭縣,羅東鎮,0108,518,132,650,59,709,1139,62.25%,45.48%,1
宜蘭縣,羅東鎮,0109,500,156,656,36,692,1130,61.24%,44.25%,1
宜蘭縣,羅東鎮,0110,401,126,527,52,579,980,59.08%,40.92%,1
宜蘭縣,羅東鎮,0111,585,160,745,59,804,1431,56.18%,40.88%,1
宜蘭縣,羅東鎮,0112,470,112,582,49,631,1109,56.9%,42.38%,1
宜蘭縣,羅東鎮,0113,444,115,559,50,609,1083,56.23%,41%,1
宜蘭縣,羅東鎮,0114,590,152,742,69,811,1404,57.76%,42.02%,1
宜蘭縣,羅東鎮,0115,518,163,681,59,740,1288,57.45%,40.22%,1
宜蘭縣,羅東鎮,0116,367,126,493,53,546,1183,46.15%,31.02%,1
宜蘭縣,羅東鎮,0117,471,137,608,53,661,1105,59.82%,42.62%,1
宜蘭縣,羅東鎮,0118,393,157,550,51,601,987,60.89%,39.82%,1
宜蘭縣,羅東鎮,0119,306,115,421,51,472,773,61.06%,39.59%,1
宜蘭縣,羅東鎮,0120,647,167,814,49,863,1366,63.18%,47.36%,1
宜蘭縣,羅東鎮,0121,421,125,546,37,583,907,64.28%,46.42%,1
宜蘭縣,羅東鎮,0122,537,130,667,50,717,1158,61.92%,46.37%,1
宜蘭縣,羅東鎮,0123,383,123,506,55,561,977,57.42%,39.2%,1
宜蘭縣,羅東鎮,0124,358,116,474,55,529,972,54.42%,36.83%,1
宜蘭縣,羅東鎮,0125,409,125,534,42,576,977,58.96%,41.86%,1
宜蘭縣,羅東鎮,0126,591,162,753,70,823,1398,58.87%,42.27%,1
宜蘭縣,羅東鎮,0127,416,128,544,32,576,1022,56.36%,40.7%,1
宜蘭縣,羅東鎮,0128,492,139,631,60,691,1131,61.1%,43.5%,1
宜蘭縣,蘇澳鎮,0129,459,147,606,64,670,1194,56.11%,38.44%,1
宜蘭縣,蘇澳鎮,0130,413,130,543,42,585,1128,51.86%,36.61%,1
宜蘭縣,蘇澳鎮,0131,471,117,588,52,640,1042,61.42%,45.2%,1
宜蘭縣,蘇澳鎮,0132,416,117,533,51,584,997,58.58%,41.73%,1
宜蘭縣,蘇澳鎮,0133,506,160,666,65,731,1303,56.1%,38.83%,1
宜蘭縣,蘇澳鎮,0134,525,148,673,74,747,1260,59.29%,41.67%,1
宜蘭縣,蘇澳鎮,0135,449,120,569,73,642,1130,56.81%,39.73%,1
宜蘭縣,蘇澳鎮,0136,207,65,272,43,315,559,56.35%,37.03%,1
宜蘭縣,蘇澳鎮,0137,110,44,154,26,180,351,51.28%,31.34%,1
宜蘭縣,蘇澳鎮,0138,312,111,423,65,488,889,54.89%,35.1%,1
宜蘭縣,蘇澳鎮,0139,154,59,213,28,241,434,55.53%,35.48%,1
宜蘭縣,蘇澳鎮,0140,351,195,546,39,585,835,70.06%,42.04%,1
宜蘭縣,蘇澳鎮,0141,389,113,502,49,551,975,56.51%,39.9%,1
宜蘭縣,蘇澳鎮,0142,451,149,600,72,672,1135,59.21%,39.74%,1
宜蘭縣,蘇澳鎮,0143,358,122,480,31,511,788,64.85%,45.43%,1
宜蘭縣,蘇澳鎮,0144,162,56,218,32,250,469,53.3%,34.54%,1
宜蘭縣,蘇澳鎮,0145,301,88,389,41,430,811,53.02%,37.11%,1
宜蘭縣,蘇澳鎮,0146,345,88,433,26,459,867,52.94%,39.79%,1
宜蘭縣,蘇澳鎮,0147,460,133,593,49,642,1139,56.37%,40.39%,1
宜蘭縣,蘇澳鎮,0148,452,104,556,44,600,1146,52.36%,39.44%,1
宜蘭縣,蘇澳鎮,0149,469,115,584,68,652,1154,56.5%,40.64%,1
宜蘭縣,蘇澳鎮,0150,312,106,418,24,442,908,48.68%,34.36%,1
宜蘭縣,蘇澳鎮,0151,255,77,332,32,364,656,55.49%,38.87%,1
宜蘭縣,蘇澳鎮,0152,351,103,454,60,514,834,61.63%,42.09%,1
宜蘭縣,蘇澳鎮,0153,415,146,561,44,605,1025,59.02%,40.49%,1
宜蘭縣,蘇澳鎮,0154,165,78,243,21,264,455,58.02%,36.26%,1
宜蘭縣,蘇澳鎮,0155,217,66,283,30,313,535,58.5%,40.56%,1
宜蘭縣,蘇澳鎮,0156,244,61,305,32,337,536,62.87%,45.52%,1
宜蘭縣,蘇澳鎮,0157,188,64,252,22,274,451,60.75%,41.69%,1
宜蘭縣,蘇澳鎮,0158,216,78,294,36,330,593,55.65%,36.42%,1
宜蘭縣,蘇澳鎮,0159,175,39,214,33,247,441,56.01%,39.68%,1
宜蘭縣,蘇澳鎮,0160,376,114,490,59,549,954,57.55%,39.41%,1
宜蘭縣,蘇澳鎮,0161,355,91,446,72,518,952,54.41%,37.29%,1
宜蘭縣,蘇澳鎮,0162,364,142,506,82,588,1125,52.27%,32.36%,1
宜蘭縣,蘇澳鎮,0163,274,78,352,75,427,763,55.96%,35.91%,1
宜蘭縣,蘇澳鎮,0164,204,61,265,50,315,706,44.62%,28.9%,1
宜蘭縣,蘇澳鎮,0165,324,111,435,80,515,1068,48.22%,30.34%,1
宜蘭縣,蘇澳鎮,0166,234,85,319,69,388,666,58.26%,35.14%,1
宜蘭縣,蘇澳鎮,0167,181,67,248,76,324,574,56.45%,31.53%,1
宜蘭縣,蘇澳鎮,0168,91,31,122,13,135,351,38.46%,25.93%,1
宜蘭縣,蘇澳鎮,0169,309,41,350,55,405,717,56.49%,43.1%,1
宜蘭縣,蘇澳鎮,0170,118,21,139,16,155,373,41.55%,31.64%,1
宜蘭縣,蘇澳鎮,0171,54,24,78,14,92,223,41.26%,24.22%,1
宜蘭縣,頭城鎮,0172,57,32,89,15,104,292,35.62%,19.52%,1
宜蘭縣,頭城鎮,0173,249,67,316,52,368,688,53.49%,36.19%,1
宜蘭縣,頭城鎮,0174,260,88,348,48,396,688,57.56%,37.79%,1
宜蘭縣,頭城鎮,0175,269,115,384,59,443,879,50.4%,30.6%,1
宜蘭縣,頭城鎮,0176,131,40,171,33,204,335,60.9%,39.1%,1
宜蘭縣,頭城鎮,0177,252,101,353,40,393,624,62.98%,40.38%,1
宜蘭縣,頭城鎮,0178,225,73,298,45,343,732,46.86%,30.74%,1
宜蘭縣,頭城鎮,0179,282,87,369,48,417,892,46.75%,31.61%,1
宜蘭縣,頭城鎮,0180,218,66,284,29,313,690,45.36%,31.59%,1
宜蘭縣,頭城鎮,0181,322,83,405,47,452,842,53.68%,38.24%,1
宜蘭縣,頭城鎮,0182,283,90,373,37,410,736,55.71%,38.45%,1
宜蘭縣,頭城鎮,0183,276,79,355,39,394,788,50%,35.03%,1
宜蘭縣,頭城鎮,0184,188,66,254,32,286,560,51.07%,33.57%,1
宜蘭縣,頭城鎮,0185,286,97,383,40,423,712,59.41%,40.17%,1
宜蘭縣,頭城鎮,0186,222,61,283,38,321,502,63.94%,44.22%,1
宜蘭縣,頭城鎮,0187,257,66,323,35,358,569,62.92%,45.17%,1
宜蘭縣,頭城鎮,0188,252,69,321,40,361,633,57.03%,39.81%,1
宜蘭縣,頭城鎮,0189,345,105,450,78,528,1132,46.64%,30.48%,1
宜蘭縣,頭城鎮,0190,347,97,444,51,495,1035,47.83%,33.53%,1
宜蘭縣,頭城鎮,0191,333,122,455,48,503,847,59.39%,39.32%,1
宜蘭縣,頭城鎮,0192,474,133,607,52,659,1172,56.23%,40.44%,1
宜蘭縣,頭城鎮,0193,344,85,429,36,465,896,51.9%,38.39%,1
宜蘭縣,頭城鎮,0194,476,118,594,30,624,1075,58.05%,44.28%,1
宜蘭縣,頭城鎮,0195,348,125,473,70,543,931,58.32%,37.38%,1
宜蘭縣,頭城鎮,0196,399,97,496,66,562,1021,55.04%,39.08%,1
宜蘭縣,頭城鎮,0197,219,70,289,58,347,709,48.94%,30.89%,1
宜蘭縣,頭城鎮,0198,305,87,392,50,442,689,64.15%,44.27%,1
宜蘭縣,頭城鎮,0199,271,61,332,50,382,615,62.11%,44.07%,1
宜蘭縣,頭城鎮,0200,282,76,358,57,415,759,54.68%,37.15%,1
宜蘭縣,頭城鎮,0201,381,113,494,69,563,917,61.4%,41.55%,1
宜蘭縣,頭城鎮,0202,398,126,524,74,598,1045,57.22%,38.09%,1
宜蘭縣,頭城鎮,0203,439,128,567,69,636,1130,56.28%,38.85%,1
宜蘭縣,礁溪鄉,0204,382,99,481,50,531,1122,47.33%,34.05%,1
宜蘭縣,礁溪鄉,0205,186,51,237,29,266,505,52.67%,36.83%,1
宜蘭縣,礁溪鄉,0206,347,115,462,47,509,988,51.52%,35.12%,1
宜蘭縣,礁溪鄉,0207,377,96,473,40,513,971,52.83%,38.83%,1
宜蘭縣,礁溪鄉,0208,427,138,565,52,617,1246,49.52%,34.27%,1
宜蘭縣,礁溪鄉,0209,558,173,731,48,779,1655,47.07%,33.72%,1
宜蘭縣,礁溪鄉,0210,376,99,475,37,512,1132,45.23%,33.22%,1
宜蘭縣,礁溪鄉,0211,323,79,402,34,436,783,55.68%,41.25%,1
宜蘭縣,礁溪鄉,0212,342,116,458,40,498,928,53.66%,36.85%,1
宜蘭縣,礁溪鄉,0213,321,78,399,54,453,848,53.42%,37.85%,1
宜蘭縣,礁溪鄉,0214,290,87,377,41,418,663,63.05%,43.74%,1
宜蘭縣,礁溪鄉,0215,254,60,314,19,333,608,54.77%,41.78%,1
宜蘭縣,礁溪鄉,0216,328,92,420,44,464,833,55.7%,39.38%,1
宜蘭縣,礁溪鄉,0217,399,130,529,25,554,1233,44.93%,32.36%,1
宜蘭縣,礁溪鄉,0218,331,99,430,49,479,854,56.09%,38.76%,1
宜蘭縣,礁溪鄉,0219,204,72,276,24,300,575,52.17%,35.48%,1
宜蘭縣,礁溪鄉,0220,303,114,417,49,466,835,55.81%,36.29%,1
宜蘭縣,礁溪鄉,0221,518,156,674,69,743,1305,56.93%,39.69%,1
宜蘭縣,礁溪鄉,0222,315,96,411,48,459,830,55.3%,37.95%,1
宜蘭縣,礁溪鄉,0223,274,98,372,55,427,649,65.79%,42.22%,1
宜蘭縣,礁溪鄉,0224,306,88,394,48,442,923,47.89%,33.15%,1
宜蘭縣,礁溪鄉,0225,378,103,481,49,530,1177,45.03%,32.12%,1
宜蘭縣,礁溪鄉,0226,317,96,413,47,460,840,54.76%,37.74%,1
宜蘭縣,礁溪鄉,0227,408,127,535,39,574,1051,54.61%,38.82%,1
宜蘭縣,礁溪鄉,0228,466,132,598,57,655,1339,48.92%,34.8%,1
宜蘭縣,礁溪鄉,0229,501,127,628,73,701,1194,58.71%,41.96%,1
宜蘭縣,礁溪鄉,0230,497,183,680,94,774,1314,58.9%,37.82%,1
宜蘭縣,礁溪鄉,0231,424,147,571,27,598,1125,53.16%,37.69%,1
宜蘭縣,礁溪鄉,0232,505,140,645,74,719,1207,59.57%,41.84%,1
宜蘭縣,礁溪鄉,0233,361,125,486,62,548,979,55.98%,36.87%,1
宜蘭縣,礁溪鄉,0234,388,129,517,68,585,954,61.32%,40.67%,1
宜蘭縣,礁溪鄉,0235,146,65,211,11,222,418,53.11%,34.93%,1
宜蘭縣,壯圍鄉,0236,570,177,747,116,863,1435,60.14%,39.72%,1
宜蘭縣,壯圍鄉,0237,412,149,561,63,624,1049,59.49%,39.28%,1
宜蘭縣,壯圍鄉,0238,433,144,577,79,656,1068,61.42%,40.54%,1
宜蘭縣,壯圍鄉,0239,301,104,405,93,498,868,57.37%,34.68%,1
宜蘭縣,壯圍鄉,0240,354,108,462,45,507,967,52.43%,36.61%,1
宜蘭縣,壯圍鄉,0241,377,120,497,78,575,940,61.17%,40.11%,1
宜蘭縣,壯圍鄉,0242,324,87,411,38,449,975,46.05%,33.23%,1
宜蘭縣,壯圍鄉,0243,301,110,411,76,487,797,61.1%,37.77%,1
宜蘭縣,壯圍鄉,0244,308,85,393,72,465,808,57.55%,38.12%,1
宜蘭縣,壯圍鄉,0245,303,141,444,93,537,911,58.95%,33.26%,1
宜蘭縣,壯圍鄉,0246,201,58,259,41,300,612,49.02%,32.84%,1
宜蘭縣,壯圍鄉,0247,327,119,446,54,500,790,63.29%,41.39%,1
宜蘭縣,壯圍鄉,0248,335,131,466,57,523,878,59.57%,38.15%,1
宜蘭縣,壯圍鄉,0249,320,91,411,52,463,723,64.04%,44.26%,1
宜蘭縣,壯圍鄉,0250,230,83,313,44,357,737,48.44%,31.21%,1
宜蘭縣,壯圍鄉,0251,249,96,345,68,413,686,60.2%,36.3%,1
宜蘭縣,壯圍鄉,0252,345,79,424,14,438,895,48.94%,38.55%,1
宜蘭縣,壯圍鄉,0253,535,138,673,80,753,1237,60.87%,43.25%,1
宜蘭縣,壯圍鄉,0254,453,119,572,78,650,1134,57.32%,39.95%,1
宜蘭縣,壯圍鄉,0255,403,133,536,76,612,1107,55.28%,36.4%,1
宜蘭縣,壯圍鄉,0256,434,124,558,38,596,1057,56.39%,41.06%,1
宜蘭縣,壯圍鄉,0257,382,106,488,42,530,1051,50.43%,36.35%,1
宜蘭縣,壯圍鄉,0258,252,89,341,56,397,722,54.99%,34.9%,1
宜蘭縣,員山鄉,0259,542,133,675,29,704,1393,50.54%,38.91%,1
宜蘭縣,員山鄉,0260,344,89,433,27,460,895,51.4%,38.44%,1
宜蘭縣,員山鄉,0261,496,99,595,74,669,1231,54.35%,40.29%,1
宜蘭縣,員山鄉,0262,419,97,516,40,556,1098,50.64%,38.16%,1
宜蘭縣,員山鄉,0263,392,86,478,50,528,1031,51.21%,38.02%,1
宜蘭縣,員山鄉,0264,365,110,475,79,554,1030,53.79%,35.44%,1
宜蘭縣,員山鄉,0265,379,114,493,52,545,1168,46.66%,32.45%,1
宜蘭縣,員山鄉,0266,288,95,383,74,457,809,56.49%,35.6%,1
宜蘭縣,員山鄉,0267,298,91,389,58,447,778,57.46%,38.3%,1
宜蘭縣,員山鄉,0268,626,139,765,80,845,1465,57.68%,42.73%,1
宜蘭縣,員山鄉,0269,395,131,526,52,578,979,59.04%,40.35%,1
宜蘭縣,員山鄉,0270,343,89,432,48,480,860,55.81%,39.88%,1
宜蘭縣,員山鄉,0271,387,114,501,96,597,1205,49.54%,32.12%,1
宜蘭縣,員山鄉,0272,409,111,520,92,612,1082,56.56%,37.8%,1
宜蘭縣,員山鄉,0273,152,54,206,37,243,412,58.98%,36.89%,1
宜蘭縣,員山鄉,0274,115,50,165,20,185,403,45.91%,28.54%,1
宜蘭縣,員山鄉,0275,60,29,89,15,104,232,44.83%,25.86%,1
宜蘭縣,員山鄉,0276,330,107,437,68,505,944,53.5%,34.96%,1
宜蘭縣,員山鄉,0277,326,104,430,63,493,894,55.15%,36.47%,1
宜蘭縣,員山鄉,0278,506,155,661,91,752,1356,55.46%,37.32%,1
宜蘭縣,員山鄉,0279,301,102,403,50,453,780,58.08%,38.59%,1
宜蘭縣,員山鄉,0280,339,157,496,94,590,932,63.3%,36.37%,1
宜蘭縣,員山鄉,0281,180,78,258,43,301,583,51.63%,30.87%,1
宜蘭縣,員山鄉,0282,333,92,425,77,502,900,55.78%,37%,1
宜蘭縣,員山鄉,0283,258,91,349,53,402,747,53.82%,34.54%,1
宜蘭縣,員山鄉,0284,299,74,373,58,431,788,54.7%,37.94%,1
宜蘭縣,員山鄉,0285,283,116,399,65,464,884,52.49%,32.01%,1
宜蘭縣,員山鄉,0286,293,95,388,22,410,857,47.84%,34.19%,1
宜蘭縣,員山鄉,0287,341,108,449,34,483,1016,47.54%,33.56%,1
宜蘭縣,員山鄉,0288,196,64,260,45,305,690,44.2%,28.41%,1
宜蘭縣,員山鄉,0289,224,84,308,54,362,689,52.54%,32.51%,1
宜蘭縣,冬山鄉,0290,329,104,433,54,487,807,60.35%,40.77%,1
宜蘭縣,冬山鄉,0291,339,99,438,19,457,817,55.94%,41.49%,1
宜蘭縣,冬山鄉,0292,480,114,594,64,658,1156,56.92%,41.52%,1
宜蘭縣,冬山鄉,0293,317,105,422,50,472,892,52.91%,35.54%,1
宜蘭縣,冬山鄉,0294,360,125,485,44,529,897,58.97%,40.13%,1
宜蘭縣,冬山鄉,0295,583,181,764,62,826,1392,59.34%,41.88%,1
宜蘭縣,冬山鄉,0296,623,163,786,51,837,1471,56.9%,42.35%,1
宜蘭縣,冬山鄉,0297,454,135,589,44,633,1435,44.11%,31.64%,1
宜蘭縣,冬山鄉,0298,560,165,725,43,768,1519,50.56%,36.87%,1
宜蘭縣,冬山鄉,0299,634,152,786,29,815,1456,55.98%,43.54%,1
宜蘭縣,冬山鄉,0300,280,95,375,53,428,711,60.2%,39.38%,1
宜蘭縣,冬山鄉,0301,295,72,367,37,404,694,58.21%,42.51%,1
宜蘭縣,冬山鄉,0302,678,207,885,67,952,1526,62.39%,44.43%,1
宜蘭縣,冬山鄉,0303,435,4,439,34,473,884,53.51%,49.21%,1
宜蘭縣,冬山鄉,0304,504,43,547,68,615,1465,41.98%,34.4%,1
宜蘭縣,冬山鄉,0305,184,52,236,40,276,488,56.56%,37.7%,1
宜蘭縣,冬山鄉,0306,467,126,593,53,646,1218,53.04%,38.34%,1
宜蘭縣,冬山鄉,0307,470,134,604,52,656,1291,50.81%,36.41%,1
宜蘭縣,冬山鄉,0308,490,135,625,37,662,1324,50%,37.01%,1
宜蘭縣,冬山鄉,0309,407,115,522,50,572,1160,49.31%,35.09%,1
宜蘭縣,冬山鄉,0310,479,121,600,58,658,1246,52.81%,38.44%,1
宜蘭縣,冬山鄉,0311,649,187,836,38,874,1754,49.83%,37%,1
宜蘭縣,冬山鄉,0312,451,131,582,60,642,1217,52.75%,37.06%,1
宜蘭縣,冬山鄉,0313,532,135,667,51,718,1495,48.03%,35.59%,1
宜蘭縣,冬山鄉,0314,356,113,469,41,510,937,54.43%,37.99%,1
宜蘭縣,冬山鄉,0315,384,125,509,39,548,1101,49.77%,34.88%,1
宜蘭縣,冬山鄉,0316,394,120,514,67,581,1118,51.97%,35.24%,1
宜蘭縣,冬山鄉,0317,558,148,706,46,752,1301,57.8%,42.89%,1
宜蘭縣,冬山鄉,0318,469,128,597,28,625,1225,51.02%,38.29%,1
宜蘭縣,冬山鄉,0319,487,163,650,50,700,1206,58.04%,40.38%,1
宜蘭縣,冬山鄉,0320,439,145,584,38,622,1278,48.67%,34.35%,1
宜蘭縣,冬山鄉,0321,418,125,543,51,594,1151,51.61%,36.32%,1
宜蘭縣,冬山鄉,0322,384,98,482,58,540,1094,49.36%,35.1%,1
宜蘭縣,冬山鄉,0323,499,157,656,50,706,1247,56.62%,40.02%,1
宜蘭縣,冬山鄉,0324,434,138,572,55,627,1247,50.28%,34.8%,1
宜蘭縣,冬山鄉,0325,389,107,496,33,529,979,54.03%,39.73%,1
宜蘭縣,冬山鄉,0326,314,86,400,24,424,698,60.74%,44.99%,1
宜蘭縣,冬山鄉,0327,637,175,812,51,863,1726,50%,36.91%,1
宜蘭縣,冬山鄉,0328,245,73,318,15,333,782,42.58%,31.33%,1
宜蘭縣,五結鄉,0329,372,118,490,60,550,1076,51.12%,34.57%,1
宜蘭縣,五結鄉,0330,340,111,451,31,482,944,51.06%,36.02%,1
宜蘭縣,五結鄉,0331,349,76,425,25,450,836,53.83%,41.75%,1
宜蘭縣,五結鄉,0332,364,116,480,50,530,937,56.56%,38.85%,1
宜蘭縣,五結鄉,0333,468,143,611,41,652,1255,51.95%,37.29%,1
宜蘭縣,五結鄉,0334,446,163,609,76,685,1270,53.94%,35.12%,1
宜蘭縣,五結鄉,0335,282,81,363,31,394,801,49.19%,35.21%,1
宜蘭縣,五結鄉,0336,300,74,374,43,417,802,52%,37.41%,1
宜蘭縣,五結鄉,0337,476,121,597,49,646,1306,49.46%,36.45%,1
宜蘭縣,五結鄉,0338,455,116,571,55,626,1190,52.61%,38.24%,1
宜蘭縣,五結鄉,0339,547,99,646,25,671,1316,50.99%,41.57%,1
宜蘭縣,五結鄉,0340,386,106,492,26,518,965,53.68%,40%,1
宜蘭縣,五結鄉,0341,317,79,396,39,435,814,53.44%,38.94%,1
宜蘭縣,五結鄉,0342,460,129,589,52,641,1254,51.12%,36.68%,1
宜蘭縣,五結鄉,0343,418,117,535,69,604,1060,56.98%,39.43%,1
宜蘭縣,五結鄉,0344,540,150,690,37,727,1323,54.95%,40.82%,1
宜蘭縣,五結鄉,0345,448,142,590,46,636,1120,56.79%,40%,1
宜蘭縣,五結鄉,0346,361,82,443,29,472,893,52.86%,40.43%,1
宜蘭縣,五結鄉,0347,444,150,594,49,643,1220,52.7%,36.39%,1
宜蘭縣,五結鄉,0348,412,96,508,28,536,924,58.01%,44.59%,1
宜蘭縣,五結鄉,0349,399,112,511,50,561,933,60.13%,42.77%,1
宜蘭縣,五結鄉,0350,407,86,493,35,528,986,53.55%,41.28%,1
宜蘭縣,五結鄉,0351,290,78,368,40,408,748,54.55%,38.77%,1
宜蘭縣,五結鄉,0352,581,165,746,86,832,1550,53.68%,37.48%,1
宜蘭縣,五結鄉,0353,249,75,324,30,354,629,56.28%,39.59%,1
宜蘭縣,五結鄉,0354,322,80,402,37,439,806,54.47%,39.95%,1
宜蘭縣,五結鄉,0355,309,139,448,49,497,956,51.99%,32.32%,1
宜蘭縣,五結鄉,0356,406,109,515,50,565,1066,53%,38.09%,1
宜蘭縣,五結鄉,0357,517,145,662,86,748,1513,49.44%,34.17%,1
宜蘭縣,五結鄉,0358,580,186,766,56,822,1566,52.49%,37.04%,1
宜蘭縣,五結鄉,0359,327,102,429,66,495,894,55.37%,36.58%,1
宜蘭縣,五結鄉,0360,364,137,501,79,580,1235,46.96%,29.47%,1
宜蘭縣,五結鄉,0361,259,85,344,52,396,704,56.25%,36.79%,1
宜蘭縣,三星鄉,0362,70,28,98,16,114,215,53.02%,32.56%,1
宜蘭縣,三星鄉,0363,154,53,207,34,241,523,46.08%,29.45%,1
宜蘭縣,三星鄉,0364,231,112,343,47,390,745,52.35%,31.01%,1
宜蘭縣,三星鄉,0365,189,74,263,41,304,617,49.27%,30.63%,1
宜蘭縣,三星鄉,0366,151,69,220,43,263,497,52.92%,30.38%,1
宜蘭縣,三星鄉,0367,254,100,354,57,411,735,55.92%,34.56%,1
宜蘭縣,三星鄉,0368,209,59,268,56,324,583,55.57%,35.85%,1
宜蘭縣,三星鄉,0369,162,41,203,31,234,436,53.67%,37.16%,1
宜蘭縣,三星鄉,0370,449,122,571,65,636,1224,51.96%,36.68%,1
宜蘭縣,三星鄉,0371,384,112,496,48,544,1151,47.26%,33.36%,1
宜蘭縣,三星鄉,0372,344,91,435,42,477,870,54.83%,39.54%,1
宜蘭縣,三星鄉,0373,378,105,483,50,533,1284,41.51%,29.44%,1
宜蘭縣,三星鄉,0374,365,113,478,52,530,897,59.09%,40.69%,1
宜蘭縣,三星鄉,0375,559,153,712,61,773,1439,53.72%,38.85%,1
宜蘭縣,三星鄉,0376,516,159,675,60,735,1445,50.87%,35.71%,1
宜蘭縣,三星鄉,0377,540,155,695,34,729,1402,52%,38.52%,1
宜蘭縣,三星鄉,0378,428,157,585,55,640,1230,52.03%,34.8%,1
宜蘭縣,三星鄉,0379,276,97,373,59,432,774,55.81%,35.66%,1
宜蘭縣,三星鄉,0380,330,97,427,50,477,827,57.68%,39.9%,1
宜蘭縣,三星鄉,0381,261,88,349,40,389,736,52.85%,35.46%,1
宜蘭縣,三星鄉,0382,474,134,608,88,696,1421,48.98%,33.36%,1
宜蘭縣,大同鄉,0383,229,80,309,49,358,893,40.09%,25.64%,1
宜蘭縣,大同鄉,0384,333,73,406,52,458,632,72.47%,52.69%,1
宜蘭縣,大同鄉,0385,221,54,275,19,294,684,42.98%,32.31%,1
宜蘭縣,大同鄉,0386,112,31,143,31,174,264,65.91%,42.42%,1
宜蘭縣,大同鄉,0387,97,12,109,5,114,337,33.83%,28.78%,1
宜蘭縣,大同鄉,0388,99,31,130,10,140,404,34.65%,24.5%,1
宜蘭縣,大同鄉,0389,14,7,21,5,26,55,47.27%,25.45%,1
宜蘭縣,大同鄉,0390,75,52,127,26,153,199,76.88%,37.69%,1
宜蘭縣,大同鄉,0391,184,47,231,17,248,787,31.51%,23.38%,1
宜蘭縣,大同鄉,0392,217,84,301,59,360,680,52.94%,31.91%,1
宜蘭縣,南澳鄉,0393,178,34,212,12,224,444,50.45%,40.09%,1
宜蘭縣,南澳鄉,0394,488,78,566,25,591,1210,48.84%,40.33%,1
宜蘭縣,南澳鄉,0395,418,83,501,82,583,962,60.6%,43.45%,1
宜蘭縣,南澳鄉,0396,114,30,144,7,151,411,36.74%,27.74%,1
宜蘭縣,南澳鄉,0397,237,50,287,21,308,447,68.9%,53.02%,1
宜蘭縣,南澳鄉,0398,248,77,325,43,368,475,77.47%,52.21%,1
宜蘭縣,南澳鄉,0399,304,70,374,37,411,695,59.14%,43.74%,1
花蓮縣,花蓮市,0001,660,165,825,35,860,1522,56.5%,43.36%,1
花蓮縣,花蓮市,0002,493,122,615,36,651,1114,58.44%,44.25%,1
花蓮縣,花蓮市,0003,272,78,350,26,376,670,56.12%,40.6%,1
花蓮縣,花蓮市,0004,575,142,717,21,738,1397,52.83%,41.16%,1
花蓮縣,花蓮市,0005,165,46,211,27,238,470,50.64%,35.11%,1
花蓮縣,花蓮市,0006,332,59,391,41,432,838,51.55%,39.62%,1
花蓮縣,花蓮市,0007,242,42,284,16,300,721,41.61%,33.56%,1
花蓮縣,花蓮市,0008,372,113,485,42,527,918,57.41%,40.52%,1
花蓮縣,花蓮市,0009,614,152,766,44,810,1539,52.63%,39.9%,1
花蓮縣,花蓮市,0010,557,124,681,64,745,1403,53.1%,39.7%,1
花蓮縣,花蓮市,0011,427,107,534,30,564,1068,52.81%,39.98%,1
花蓮縣,花蓮市,0012,501,109,610,31,641,1167,54.93%,42.93%,1
花蓮縣,花蓮市,0013,559,130,689,62,751,1259,59.65%,44.4%,1
花蓮縣,花蓮市,0014,382,135,517,66,583,1071,54.44%,35.67%,1
花蓮縣,花蓮市,0015,374,113,487,40,527,925,56.97%,40.43%,1
花蓮縣,花蓮市,0016,521,129,650,60,710,1141,62.23%,45.66%,1
花蓮縣,花蓮市,0017,451,117,568,29,597,1163,51.33%,38.78%,1
花蓮縣,花蓮市,0018,556,144,700,40,740,1279,57.86%,43.47%,1
花蓮縣,花蓮市,0019,540,142,682,33,715,1512,47.29%,35.71%,1
花蓮縣,花蓮市,0020,245,63,308,25,333,615,54.15%,39.84%,1
花蓮縣,花蓮市,0021,238,86,324,23,347,606,57.26%,39.27%,1
花蓮縣,花蓮市,0022,212,47,259,14,273,559,48.84%,37.92%,1
花蓮縣,花蓮市,0023,191,33,224,20,244,442,55.2%,43.21%,1
花蓮縣,花蓮市,0024,428,103,531,31,562,1114,50.45%,38.42%,1
花蓮縣,花蓮市,0025,169,44,213,21,234,416,56.25%,40.63%,1
花蓮縣,花蓮市,0026,242,73,315,34,349,577,60.49%,41.94%,1
花蓮縣,花蓮市,0027,367,100,467,26,493,810,60.86%,45.31%,1
花蓮縣,花蓮市,0028,224,56,280,29,309,538,57.43%,41.64%,1
花蓮縣,花蓮市,0029,212,67,279,30,309,566,54.59%,37.46%,1
花蓮縣,花蓮市,0030,180,49,229,15,244,469,52.03%,38.38%,1
花蓮縣,花蓮市,0031,252,53,305,18,323,565,57.17%,44.6%,1
花蓮縣,花蓮市,0032,301,64,365,36,401,816,49.14%,36.89%,1
花蓮縣,花蓮市,0033,343,87,430,49,479,911,52.58%,37.65%,1
花蓮縣,花蓮市,0034,391,96,487,50,537,1029,52.19%,38%,1
花蓮縣,花蓮市,0035,447,115,562,50,612,1043,58.68%,42.86%,1
花蓮縣,花蓮市,0036,366,92,458,29,487,856,56.89%,42.76%,1
花蓮縣,花蓮市,0037,394,109,503,35,538,979,54.95%,40.25%,1
花蓮縣,花蓮市,0038,549,152,701,48,749,1331,56.27%,41.25%,1
花蓮縣,花蓮市,0039,427,231,658,35,693,1228,56.43%,34.77%,1
花蓮縣,花蓮市,0040,406,98,504,40,544,955,56.96%,42.51%,1
花蓮縣,花蓮市,0041,499,108,607,33,640,1268,50.47%,39.35%,1
花蓮縣,花蓮市,0042,478,134,612,35,647,1230,52.6%,38.86%,1
花蓮縣,花蓮市,0043,596,118,714,58,772,1369,56.39%,43.54%,1
花蓮縣,花蓮市,0044,477,130,607,33,640,1435,44.6%,33.24%,1
花蓮縣,花蓮市,0045,482,115,597,43,640,1164,54.98%,41.41%,1
花蓮縣,花蓮市,0046,552,127,679,55,734,1249,58.77%,44.2%,1
花蓮縣,花蓮市,0047,477,125,602,55,657,1184,55.49%,40.29%,1
花蓮縣,花蓮市,0048,594,140,734,48,782,1490,52.48%,39.87%,1
花蓮縣,花蓮市,0049,493,110,603,37,640,1022,62.62%,48.24%,1
花蓮縣,花蓮市,0050,469,116,585,47,632,1135,55.68%,41.32%,1
花蓮縣,花蓮市,0051,476,96,572,37,609,1084,56.18%,43.91%,1
花蓮縣,花蓮市,0052,359,103,462,37,499,1339,37.27%,26.81%,1
花蓮縣,花蓮市,0053,225,57,282,18,300,501,59.88%,44.91%,1
花蓮縣,花蓮市,0054,372,99,471,26,497,904,54.98%,41.15%,1
花蓮縣,花蓮市,0055,214,69,283,19,302,490,61.63%,43.67%,1
花蓮縣,花蓮市,0056,442,94,536,28,564,1192,47.32%,37.08%,1
花蓮縣,花蓮市,0057,320,89,409,26,435,869,50.06%,36.82%,1
花蓮縣,花蓮市,0058,530,108,638,39,677,1267,53.43%,41.83%,1
花蓮縣,花蓮市,0059,400,102,502,50,552,959,57.56%,41.71%,1
花蓮縣,花蓮市,0060,426,85,511,28,539,993,54.28%,42.9%,1
花蓮縣,花蓮市,0061,389,105,494,58,552,982,56.21%,39.61%,1
花蓮縣,花蓮市,0062,478,124,602,18,620,1311,47.29%,36.46%,1
花蓮縣,花蓮市,0063,534,159,693,55,748,1455,51.41%,36.7%,1
花蓮縣,花蓮市,0064,395,104,499,37,536,1151,46.57%,34.32%,1
花蓮縣,花蓮市,0065,460,113,573,37,610,1237,49.31%,37.19%,1
花蓮縣,花蓮市,0066,491,110,601,43,644,1339,48.1%,36.67%,1
花蓮縣,花蓮市,0067,309,79,388,26,414,715,57.9%,43.22%,1
花蓮縣,花蓮市,0068,414,99,513,40,553,1000,55.3%,41.4%,1
花蓮縣,花蓮市,0069,505,138,643,55,698,1410,49.5%,35.82%,1
花蓮縣,花蓮市,0070,537,122,659,20,679,1303,52.11%,41.21%,1
花蓮縣,花蓮市,0071,496,143,639,33,672,1256,53.5%,39.49%,1
花蓮縣,花蓮市,0072,468,123,591,45,636,1105,57.56%,42.35%,1
花蓮縣,花蓮市,0073,402,125,527,30,557,1089,51.15%,36.91%,1
花蓮縣,花蓮市,0074,397,86,483,24,507,1043,48.61%,38.06%,1
花蓮縣,花蓮市,0075,491,92,583,33,616,1080,57.04%,45.46%,1
花蓮縣,花蓮市,0076,439,80,519,30,549,971,56.54%,45.21%,1
花蓮縣,花蓮市,0077,439,132,571,39,610,1068,57.12%,41.1%,1
花蓮縣,花蓮市,0078,528,133,661,31,692,1379,50.18%,38.29%,1
花蓮縣,花蓮市,0079,522,137,659,58,717,1362,52.64%,38.33%,1
花蓮縣,花蓮市,0080,583,135,718,40,758,1323,57.29%,44.07%,1
花蓮縣,花蓮市,0081,493,139,632,43,675,1482,45.55%,33.27%,1
花蓮縣,鳳林鎮,0195,560,108,668,70,738,1192,61.91%,46.98%,1
花蓮縣,鳳林鎮,0196,230,62,292,31,323,639,50.55%,35.99%,1
花蓮縣,鳳林鎮,0197,284,69,353,47,400,601,66.56%,47.25%,1
花蓮縣,鳳林鎮,0198,552,117,669,56,725,1137,63.76%,48.55%,1
花蓮縣,鳳林鎮,0199,281,82,363,54,417,742,56.2%,37.87%,1
花蓮縣,鳳林鎮,0200,265,50,315,34,349,610,57.21%,43.44%,1
花蓮縣,鳳林鎮,0201,104,49,153,39,192,295,65.08%,35.25%,1
花蓮縣,鳳林鎮,0202,53,10,63,3,66,218,30.28%,24.31%,1
花蓮縣,鳳林鎮,0203,221,54,275,22,297,720,41.25%,30.69%,1
花蓮縣,鳳林鎮,0204,201,58,259,27,286,528,54.17%,38.07%,1
花蓮縣,鳳林鎮,0205,198,71,269,19,288,560,51.43%,35.36%,1
花蓮縣,鳳林鎮,0206,201,36,237,54,291,541,53.79%,37.15%,1
花蓮縣,鳳林鎮,0207,321,81,402,62,464,818,56.72%,39.24%,1
花蓮縣,鳳林鎮,0208,281,77,358,47,405,984,41.16%,28.56%,1
花蓮縣,鳳林鎮,0209,31,10,41,8,49,91,53.85%,34.07%,1
花蓮縣,玉里鎮,0254,397,99,496,47,543,1008,53.87%,39.38%,1
花蓮縣,玉里鎮,0255,417,96,513,43,556,939,59.21%,44.41%,1
花蓮縣,玉里鎮,0256,502,93,595,61,656,1256,52.23%,39.97%,1
花蓮縣,玉里鎮,0257,362,91,453,52,505,929,54.36%,38.97%,1
花蓮縣,玉里鎮,0258,390,96,486,45,531,979,54.24%,39.84%,1
花蓮縣,玉里鎮,0259,551,136,687,43,730,1244,58.68%,44.29%,1
花蓮縣,玉里鎮,0260,292,83,375,41,416,847,49.11%,34.47%,1
花蓮縣,玉里鎮,0261,244,81,325,55,380,772,49.22%,31.61%,1
花蓮縣,玉里鎮,0262,200,54,254,23,277,558,49.64%,35.84%,1
花蓮縣,玉里鎮,0263,176,56,232,28,260,800,32.5%,22%,1
花蓮縣,玉里鎮,0264,412,113,525,70,595,1286,46.27%,32.04%,1
花蓮縣,玉里鎮,0265,397,117,514,85,599,1246,48.07%,31.86%,1
花蓮縣,玉里鎮,0266,183,90,273,72,345,647,53.32%,28.28%,1
花蓮縣,玉里鎮,0267,164,41,205,17,222,990,22.42%,16.57%,1
花蓮縣,玉里鎮,0268,148,62,210,53,263,530,49.62%,27.92%,1
花蓮縣,玉里鎮,0269,213,90,303,56,359,979,36.67%,21.76%,1
花蓮縣,玉里鎮,0270,174,49,223,97,320,557,57.45%,31.24%,1
花蓮縣,玉里鎮,0271,112,24,136,21,157,434,36.18%,25.81%,1
花蓮縣,玉里鎮,0272,207,74,281,80,361,1065,33.9%,19.44%,1
花蓮縣,玉里鎮,0273,246,110,356,105,461,866,53.23%,28.41%,1
花蓮縣,玉里鎮,0274,198,75,273,42,315,769,40.96%,25.75%,1
花蓮縣,玉里鎮,0275,248,80,328,42,370,869,42.58%,28.54%,1
花蓮縣,玉里鎮,0276,286,106,392,54,446,1080,41.3%,26.48%,1
花蓮縣,新城鄉,0082,157,42,199,17,216,367,58.86%,42.78%,1
花蓮縣,新城鄉,0083,343,82,425,11,436,929,46.93%,36.92%,1
花蓮縣,新城鄉,0084,218,91,309,45,354,590,60%,36.95%,1
花蓮縣,新城鄉,0085,99,49,148,25,173,307,56.35%,32.25%,1
花蓮縣,新城鄉,0086,108,30,138,22,160,260,61.54%,41.54%,1
花蓮縣,新城鄉,0087,527,150,677,58,735,1283,57.29%,41.08%,1
花蓮縣,新城鄉,0088,343,77,420,23,443,885,50.06%,38.76%,1
花蓮縣,新城鄉,0089,312,91,403,35,438,770,56.88%,40.52%,1
花蓮縣,新城鄉,0090,526,146,672,67,739,1363,54.22%,38.59%,1
花蓮縣,新城鄉,0091,144,36,180,12,192,366,52.46%,39.34%,1
花蓮縣,新城鄉,0092,422,120,542,48,590,1163,50.73%,36.29%,1
花蓮縣,新城鄉,0093,607,184,791,46,837,1605,52.15%,37.82%,1
花蓮縣,新城鄉,0094,476,115,591,46,637,1194,53.35%,39.87%,1
花蓮縣,新城鄉,0095,423,80,503,49,552,979,56.38%,43.21%,1
花蓮縣,新城鄉,0096,605,166,771,49,820,1485,55.22%,40.74%,1
花蓮縣,新城鄉,0097,418,102,520,38,558,1070,52.15%,39.07%,1
花蓮縣,新城鄉,0098,491,110,601,32,633,1164,54.38%,42.18%,1
花蓮縣,新城鄉,0099,321,86,407,59,466,880,52.95%,36.48%,1
花蓮縣,新城鄉,0100,128,41,169,17,186,369,50.41%,34.69%,1
花蓮縣,吉安鄉,0115,407,109,516,37,553,1059,52.22%,38.43%,1
花蓮縣,吉安鄉,0116,418,93,511,34,545,983,55.44%,42.52%,1
花蓮縣,吉安鄉,0117,434,92,526,33,559,1031,54.22%,42.1%,1
花蓮縣,吉安鄉,0118,408,114,522,41,563,1105,50.95%,36.92%,1
花蓮縣,吉安鄉,0119,420,115,535,39,574,1107,51.85%,37.94%,1
花蓮縣,吉安鄉,0120,412,127,539,48,587,1179,49.79%,34.94%,1
花蓮縣,吉安鄉,0121,464,142,606,59,665,1453,45.77%,31.93%,1
花蓮縣,吉安鄉,0122,639,154,793,48,841,1432,58.73%,44.62%,1
花蓮縣,吉安鄉,0123,560,132,692,36,728,1320,55.15%,42.42%,1
花蓮縣,吉安鄉,0124,525,130,655,28,683,1356,50.37%,38.72%,1
花蓮縣,吉安鄉,0125,513,108,621,40,661,1295,51.04%,39.61%,1
花蓮縣,吉安鄉,0126,597,144,741,56,797,1467,54.33%,40.7%,1
花蓮縣,吉安鄉,0127,591,158,749,35,784,1515,51.75%,39.01%,1
花蓮縣,吉安鄉,0128,459,119,578,49,627,1063,58.98%,43.18%,1
花蓮縣,吉安鄉,0129,430,105,535,26,561,1284,43.69%,33.49%,1
花蓮縣,吉安鄉,0130,587,142,729,44,773,1380,56.01%,42.54%,1
花蓮縣,吉安鄉,0131,527,148,675,56,731,1297,56.36%,40.63%,1
花蓮縣,吉安鄉,0132,609,159,768,83,851,1662,51.2%,36.64%,1
花蓮縣,吉安鄉,0133,476,178,654,94,748,1563,47.86%,30.45%,1
花蓮縣,吉安鄉,0134,455,116,571,50,621,1288,48.21%,35.33%,1
花蓮縣,吉安鄉,0135,364,102,466,38,504,907,55.57%,40.13%,1
花蓮縣,吉安鄉,0136,354,85,439,35,474,917,51.69%,38.6%,1
花蓮縣,吉安鄉,0137,386,110,496,30,526,1021,51.52%,37.81%,1
花蓮縣,吉安鄉,0138,459,116,575,39,614,1033,59.44%,44.43%,1
花蓮縣,吉安鄉,0139,398,99,497,53,550,966,56.94%,41.2%,1
花蓮縣,吉安鄉,0140,465,96,561,61,622,1188,52.36%,39.14%,1
花蓮縣,吉安鄉,0141,608,122,730,30,760,1480,51.35%,41.08%,1
花蓮縣,吉安鄉,0142,521,113,634,39,673,1393,48.31%,37.4%,1
花蓮縣,吉安鄉,0143,456,106,562,32,594,1193,49.79%,38.22%,1
花蓮縣,吉安鄉,0144,529,124,653,41,694,1445,48.03%,36.61%,1
花蓮縣,吉安鄉,0145,492,143,635,86,721,1301,55.42%,37.82%,1
花蓮縣,吉安鄉,0146,500,138,638,54,692,1215,56.95%,41.15%,1
花蓮縣,吉安鄉,0147,455,117,572,37,609,1135,53.66%,40.09%,1
花蓮縣,吉安鄉,0148,550,108,658,34,692,1223,56.58%,44.97%,1
花蓮縣,吉安鄉,0149,533,119,652,45,697,1274,54.71%,41.84%,1
花蓮縣,吉安鄉,0150,437,118,555,37,592,1124,52.67%,38.88%,1
花蓮縣,吉安鄉,0151,492,124,616,35,651,1158,56.22%,42.49%,1
花蓮縣,吉安鄉,0152,500,119,619,26,645,1157,55.75%,43.22%,1
花蓮縣,吉安鄉,0153,530,120,650,36,686,1258,54.53%,42.13%,1
花蓮縣,吉安鄉,0154,497,141,638,30,668,1257,53.14%,39.54%,1
花蓮縣,吉安鄉,0155,486,125,611,32,643,1245,51.65%,39.04%,1
花蓮縣,吉安鄉,0156,485,148,633,14,647,1166,55.49%,41.6%,1
花蓮縣,吉安鄉,0157,528,131,659,51,710,1358,52.28%,38.88%,1
花蓮縣,吉安鄉,0158,496,100,596,34,630,1214,51.89%,40.86%,1
花蓮縣,吉安鄉,0159,458,103,561,55,616,1151,53.52%,39.79%,1
花蓮縣,吉安鄉,0160,465,137,602,32,634,1157,54.8%,40.19%,1
花蓮縣,吉安鄉,0161,500,112,612,40,652,1161,56.16%,43.07%,1
花蓮縣,吉安鄉,0162,543,144,687,49,736,1304,56.44%,41.64%,1
花蓮縣,吉安鄉,0163,527,134,661,53,714,1367,52.23%,38.55%,1
花蓮縣,吉安鄉,0164,479,144,623,42,665,1411,47.13%,33.95%,1
花蓮縣,吉安鄉,0165,515,107,622,40,662,1409,46.98%,36.55%,1
花蓮縣,吉安鄉,0166,392,95,487,43,530,1125,47.11%,34.84%,1
花蓮縣,吉安鄉,0167,459,135,594,79,673,1213,55.48%,37.84%,1
花蓮縣,吉安鄉,0168,456,135,591,33,624,1141,54.69%,39.96%,1
花蓮縣,吉安鄉,0169,414,91,505,23,528,1156,45.67%,35.81%,1
花蓮縣,吉安鄉,0170,427,85,512,50,562,1092,51.47%,39.1%,1
花蓮縣,吉安鄉,0171,311,116,427,37,464,1026,45.22%,30.31%,1
花蓮縣,吉安鄉,0172,328,73,401,16,417,804,51.87%,40.8%,1
花蓮縣,吉安鄉,0173,483,104,587,38,625,1132,55.21%,42.67%,1
花蓮縣,壽豐鄉,0174,353,109,462,39,501,1052,47.62%,33.56%,1
花蓮縣,壽豐鄉,0175,148,41,189,29,218,357,61.06%,41.46%,1
花蓮縣,壽豐鄉,0176,360,101,461,54,515,1022,50.39%,35.23%,1
花蓮縣,壽豐鄉,0177,377,117,494,53,547,875,62.51%,43.09%,1
花蓮縣,壽豐鄉,0178,279,98,377,46,423,691,61.22%,40.38%,1
花蓮縣,壽豐鄉,0179,233,65,298,24,322,708,45.48%,32.91%,1
花蓮縣,壽豐鄉,0180,324,98,422,52,474,894,53.02%,36.24%,1
花蓮縣,壽豐鄉,0181,295,73,368,40,408,746,54.69%,39.54%,1
花蓮縣,壽豐鄉,0182,324,104,428,39,467,881,53.01%,36.78%,1
花蓮縣,壽豐鄉,0183,315,77,392,39,431,695,62.01%,45.32%,1
花蓮縣,壽豐鄉,0184,311,117,428,83,511,816,62.62%,38.11%,1
花蓮縣,壽豐鄉,0185,266,86,352,43,395,773,51.1%,34.41%,1
花蓮縣,壽豐鄉,0186,396,126,522,65,587,1029,57.05%,38.48%,1
花蓮縣,壽豐鄉,0187,184,42,226,31,257,407,63.14%,45.21%,1
花蓮縣,壽豐鄉,0188,444,147,591,55,646,1139,56.72%,38.98%,1
花蓮縣,壽豐鄉,0189,380,154,534,38,572,996,57.43%,38.15%,1
花蓮縣,壽豐鄉,0190,128,46,174,13,187,414,45.17%,30.92%,1
花蓮縣,壽豐鄉,0191,103,41,144,13,157,270,58.15%,38.15%,1
花蓮縣,壽豐鄉,0192,336,92,428,60,488,836,58.37%,40.19%,1
花蓮縣,壽豐鄉,0193,206,77,283,23,306,507,60.36%,40.63%,1
花蓮縣,壽豐鄉,0194,201,68,269,43,312,739,42.22%,27.2%,1
花蓮縣,光復鄉,0210,491,144,635,84,719,1295,55.52%,37.92%,1
花蓮縣,光復鄉,0211,380,84,464,35,499,859,58.09%,44.24%,1
花蓮縣,光復鄉,0212,340,105,445,126,571,958,59.6%,35.49%,1
花蓮縣,光復鄉,0213,355,127,482,105,587,1011,58.06%,35.11%,1
花蓮縣,光復鄉,0214,417,119,536,67,603,1041,57.93%,40.06%,1
花蓮縣,光復鄉,0215,285,85,370,78,448,821,54.57%,34.71%,1
花蓮縣,光復鄉,0216,30,7,37,0,37,188,19.68%,15.96%,1
花蓮縣,光復鄉,0217,201,49,250,32,282,514,54.86%,39.11%,1
花蓮縣,光復鄉,0218,101,43,144,14,158,446,35.43%,22.65%,1
花蓮縣,光復鄉,0219,291,91,382,49,431,851,50.65%,34.2%,1
花蓮縣,光復鄉,0220,228,92,320,26,346,932,37.12%,24.46%,1
花蓮縣,光復鄉,0221,211,33,244,24,268,471,56.9%,44.8%,1
花蓮縣,光復鄉,0222,232,77,309,48,357,640,55.78%,36.25%,1
花蓮縣,光復鄉,0223,32,8,40,5,45,116,38.79%,27.59%,1
花蓮縣,光復鄉,0224,109,25,134,11,145,496,29.23%,21.98%,1
花蓮縣,光復鄉,0225,97,34,131,15,146,324,45.06%,29.94%,1
花蓮縣,光復鄉,0226,125,32,157,19,176,454,38.77%,27.53%,1
花蓮縣,豐濱鄉,0227,185,70,255,87,342,717,47.7%,25.8%,1
花蓮縣,豐濱鄉,0228,166,80,246,57,303,751,40.35%,22.1%,1
花蓮縣,豐濱鄉,0229,161,77,238,49,287,613,46.82%,26.26%,1
花蓮縣,豐濱鄉,0230,271,63,334,30,364,809,44.99%,33.5%,1
花蓮縣,豐濱鄉,0231,44,8,52,4,56,357,15.69%,12.32%,1
花蓮縣,豐濱鄉,0232,192,70,262,78,340,669,50.82%,28.7%,1
花蓮縣,豐濱鄉,0233,153,35,188,9,197,479,41.13%,31.94%,1
花蓮縣,瑞穗鄉,0241,345,76,421,48,469,813,57.69%,42.44%,1
花蓮縣,瑞穗鄉,0242,426,109,535,73,608,1091,55.73%,39.05%,1
花蓮縣,瑞穗鄉,0243,355,80,435,44,479,839,57.09%,42.31%,1
花蓮縣,瑞穗鄉,0244,377,119,496,61,557,975,57.13%,38.67%,1
花蓮縣,瑞穗鄉,0245,169,61,230,24,254,546,46.52%,30.95%,1
花蓮縣,瑞穗鄉,0246,391,116,507,62,569,1002,56.79%,39.02%,1
花蓮縣,瑞穗鄉,0247,176,61,237,39,276,593,46.54%,29.68%,1
花蓮縣,瑞穗鄉,0248,347,121,468,82,550,965,56.99%,35.96%,1
花蓮縣,瑞穗鄉,0249,305,100,405,70,475,863,55.04%,35.34%,1
花蓮縣,瑞穗鄉,0250,53,18,71,7,78,340,22.94%,15.59%,1
花蓮縣,瑞穗鄉,0251,239,75,314,39,353,764,46.2%,31.28%,1
花蓮縣,瑞穗鄉,0252,116,38,154,11,165,868,19.01%,13.36%,1
花蓮縣,瑞穗鄉,0253,130,32,162,16,178,620,28.71%,20.97%,1
花蓮縣,富里鄉,0277,142,35,177,21,198,467,42.4%,30.41%,1
花蓮縣,富里鄉,0278,266,81,347,60,407,1032,39.44%,25.78%,1
花蓮縣,富里鄉,0279,198,41,239,38,277,638,43.42%,31.03%,1
花蓮縣,富里鄉,0280,179,64,243,79,322,591,54.48%,30.29%,1
花蓮縣,富里鄉,0281,420,116,536,56,592,1087,54.46%,38.64%,1
花蓮縣,富里鄉,0282,152,53,205,19,224,431,51.97%,35.27%,1
花蓮縣,富里鄉,0283,330,64,394,40,434,893,48.6%,36.95%,1
花蓮縣,富里鄉,0284,92,37,129,20,149,361,41.27%,25.48%,1
花蓮縣,富里鄉,0285,361,126,487,51,538,1362,39.5%,26.51%,1
花蓮縣,富里鄉,0286,162,46,208,29,237,458,51.75%,35.37%,1
花蓮縣,富里鄉,0287,124,34,158,36,194,621,31.24%,19.97%,1
花蓮縣,富里鄉,0288,149,63,212,31,243,493,49.29%,30.22%,1
花蓮縣,富里鄉,0289,207,62,269,29,298,631,47.23%,32.81%,1
花蓮縣,秀林鄉,0101,313,95,408,33,441,867,50.87%,36.1%,1
花蓮縣,秀林鄉,0102,193,74,267,29,296,575,51.48%,33.57%,1
花蓮縣,秀林鄉,0103,330,130,460,58,518,1373,37.73%,24.03%,1
花蓮縣,秀林鄉,0104,488,139,627,76,703,1644,42.76%,29.68%,1
花蓮縣,秀林鄉,0105,69,12,81,8,89,162,54.94%,42.59%,1
花蓮縣,秀林鄉,0106,115,50,165,28,193,384,50.26%,29.95%,1
花蓮縣,秀林鄉,0107,423,109,532,39,571,1382,41.32%,30.61%,1
花蓮縣,秀林鄉,0108,383,103,486,23,509,1125,45.24%,34.04%,1
花蓮縣,秀林鄉,0109,205,63,268,17,285,627,45.45%,32.7%,1
花蓮縣,秀林鄉,0110,445,122,567,51,618,987,62.61%,45.09%,1
花蓮縣,秀林鄉,0111,442,147,589,102,691,1139,60.67%,38.81%,1
花蓮縣,秀林鄉,0112,447,116,563,8,571,1213,47.07%,36.85%,1
花蓮縣,秀林鄉,0113,294,64,358,32,390,754,51.72%,38.99%,1
花蓮縣,秀林鄉,0114,107,22,129,14,143,330,43.33%,32.42%,1
花蓮縣,萬榮鄉,0234,376,135,511,82,593,1072,55.32%,35.07%,1
花蓮縣,萬榮鄉,0235,160,44,204,13,217,560,38.75%,28.57%,1
花蓮縣,萬榮鄉,0236,325,97,422,36,458,773,59.25%,42.04%,1
花蓮縣,萬榮鄉,0237,176,61,237,13,250,661,37.82%,26.63%,1
花蓮縣,萬榮鄉,0238,158,50,208,16,224,442,50.68%,35.75%,1
花蓮縣,萬榮鄉,0239,203,71,274,73,347,675,51.41%,30.07%,1
花蓮縣,萬榮鄉,0240,404,209,613,122,735,1086,67.68%,37.2%,1
花蓮縣,卓溪鄉,0290,200,65,265,17,282,533,52.91%,37.52%,1
花蓮縣,卓溪鄉,0291,203,81,284,42,326,522,62.45%,38.89%,1
花蓮縣,卓溪鄉,0292,125,37,162,18,180,493,36.51%,25.35%,1
花蓮縣,卓溪鄉,0293,307,89,396,42,438,701,62.48%,43.79%,1
花蓮縣,卓溪鄉,0294,308,82,390,53,443,746,59.38%,41.29%,1
花蓮縣,卓溪鄉,0295,211,106,317,69,386,616,62.66%,34.25%,1
花蓮縣,卓溪鄉,0296,88,26,114,16,130,405,32.1%,21.73%,1
花蓮縣,卓溪鄉,0297,131,29,160,17,177,329,53.8%,39.82%,1
花蓮縣,卓溪鄉,0298,166,31,197,21,218,428,50.93%,38.79%,1
花蓮縣,卓溪鄉,0299,80,9,89,9,98,174,56.32%,45.98%,1
臺東縣,臺東市,0001,313,89,402,26,428,874,48.97%,35.81%,1
臺東縣,臺東市,0002,760,64,824,77,901,1469,61.33%,51.74%,1
臺東縣,臺東市,0003,521,137,658,37,695,1259,55.2%,41.38%,1
臺東縣,臺東市,0004,558,164,722,44,766,1399,54.75%,39.89%,1
臺東縣,臺東市,0005,639,153,792,49,841,1363,61.7%,46.88%,1
臺東縣,臺東市,0006,671,174,845,45,890,1651,53.91%,40.64%,1
臺東縣,臺東市,0007,687,178,865,60,925,1490,62.08%,46.11%,1
臺東縣,臺東市,0008,343,70,413,32,445,859,51.8%,39.93%,1
臺東縣,臺東市,0009,394,107,501,34,535,890,60.11%,44.27%,1
臺東縣,臺東市,0010,251,79,330,46,376,651,57.76%,38.56%,1
臺東縣,臺東市,0011,579,167,746,76,822,1650,49.82%,35.09%,1
臺東縣,臺東市,0012,304,109,413,36,449,724,62.02%,41.99%,1
臺東縣,臺東市,0013,276,74,350,31,381,632,60.28%,43.67%,1
臺東縣,臺東市,0014,324,97,421,41,462,771,59.92%,42.02%,1
臺東縣,臺東市,0015,280,99,379,28,407,798,51%,35.09%,1
臺東縣,臺東市,0016,471,151,622,98,720,1299,55.43%,36.26%,1
臺東縣,臺東市,0017,344,105,449,36,485,811,59.8%,42.42%,1
臺東縣,臺東市,0018,350,102,452,37,489,764,64.01%,45.81%,1
臺東縣,臺東市,0019,267,109,376,20,396,784,50.51%,34.06%,1
臺東縣,臺東市,0020,149,42,191,15,206,427,48.24%,34.89%,1
臺東縣,臺東市,0021,480,119,599,36,635,1292,49.15%,37.15%,1
臺東縣,臺東市,0022,654,150,804,28,832,1501,55.43%,43.57%,1
臺東縣,臺東市,0023,227,51,278,19,297,601,49.42%,37.77%,1
臺東縣,臺東市,0024,154,39,193,9,202,417,48.44%,36.93%,1
臺東縣,臺東市,0025,413,99,512,47,559,1001,55.84%,41.26%,1
臺東縣,臺東市,0026,702,197,899,51,950,1638,58%,42.86%,1
臺東縣,臺東市,0027,651,161,812,58,870,1576,55.2%,41.31%,1
臺東縣,臺東市,0028,669,156,825,67,892,1595,55.92%,41.94%,1
臺東縣,臺東市,0029,729,178,907,54,961,1734,55.42%,42.04%,1
臺東縣,臺東市,0030,629,152,781,61,842,1476,57.05%,42.62%,1
臺東縣,臺東市,0031,690,185,875,51,926,1545,59.94%,44.66%,1
臺東縣,臺東市,0032,591,138,729,62,791,1313,60.24%,45.01%,1
臺東縣,臺東市,0033,629,139,768,52,820,1338,61.29%,47.01%,1
臺東縣,臺東市,0034,566,112,678,24,702,1312,53.51%,43.14%,1
臺東縣,臺東市,0035,531,151,682,51,733,1265,57.94%,41.98%,1
臺東縣,臺東市,0036,450,162,612,65,677,1407,48.12%,31.98%,1
臺東縣,臺東市,0037,574,131,705,51,756,1552,48.71%,36.98%,1
臺東縣,臺東市,0038,593,131,724,88,812,1445,56.19%,41.04%,1
臺東縣,臺東市,0039,879,233,1112,67,1179,2098,56.2%,41.9%,1
臺東縣,臺東市,0040,541,149,690,86,776,1324,58.61%,40.86%,1
臺東縣,臺東市,0041,664,130,794,46,840,1598,52.57%,41.55%,1
臺東縣,臺東市,0042,626,116,742,31,773,1513,51.09%,41.37%,1
臺東縣,臺東市,0043,644,173,817,37,854,1679,50.86%,38.36%,1
臺東縣,臺東市,0044,501,164,665,72,737,1414,52.12%,35.43%,1
臺東縣,臺東市,0045,713,173,886,62,948,1798,52.73%,39.66%,1
臺東縣,臺東市,0046,572,148,720,80,800,1749,45.74%,32.7%,1
臺東縣,臺東市,0047,647,191,838,92,930,1709,54.42%,37.86%,1
臺東縣,臺東市,0048,625,137,762,63,825,1629,50.64%,38.37%,1
臺東縣,臺東市,0049,404,115,519,71,590,1116,52.87%,36.2%,1
臺東縣,臺東市,0050,402,108,510,29,539,1259,42.81%,31.93%,1
臺東縣,臺東市,0051,384,123,507,44,551,1232,44.72%,31.17%,1
臺東縣,臺東市,0052,482,180,662,109,771,1505,51.23%,32.03%,1
臺東縣,臺東市,0053,271,76,347,57,404,836,48.33%,32.42%,1
臺東縣,臺東市,0054,547,136,683,49,732,1294,56.57%,42.27%,1
臺東縣,臺東市,0055,502,148,650,72,722,1350,53.48%,37.19%,1
臺東縣,臺東市,0056,923,197,1120,77,1197,2162,55.37%,42.69%,1
臺東縣,臺東市,0057,641,298,939,25,964,1627,59.25%,39.4%,1
臺東縣,臺東市,0058,475,130,605,58,663,1140,58.16%,41.67%,1
臺東縣,臺東市,0059,544,109,653,46,699,1359,51.43%,40.03%,1
臺東縣,臺東市,0060,520,163,683,56,739,1329,55.61%,39.13%,1
臺東縣,臺東市,0061,365,107,472,43,515,990,52.02%,36.87%,1
臺東縣,臺東市,0062,396,123,519,68,587,1038,56.55%,38.15%,1
臺東縣,臺東市,0063,573,176,749,81,830,1597,51.97%,35.88%,1
臺東縣,臺東市,0064,517,149,666,78,744,1385,53.72%,37.33%,1
臺東縣,臺東市,0065,305,85,390,18,408,939,43.45%,32.48%,1
臺東縣,臺東市,0066,382,104,486,62,548,1258,43.56%,30.37%,1
臺東縣,臺東市,0067,463,152,615,10,625,1350,46.3%,34.3%,1
臺東縣,臺東市,0068,354,84,438,36,474,1058,44.8%,33.46%,1
臺東縣,臺東市,0069,256,75,331,34,365,895,40.78%,28.6%,1
臺東縣,成功鎮,0070,171,44,215,45,260,516,50.39%,33.14%,1
臺東縣,成功鎮,0071,342,168,510,74,584,960,60.83%,35.63%,1
臺東縣,成功鎮,0072,86,16,102,17,119,365,32.6%,23.56%,1
臺東縣,成功鎮,0073,206,71,277,68,345,747,46.18%,27.58%,1
臺東縣,成功鎮,0074,108,27,135,24,159,339,46.9%,31.86%,1
臺東縣,成功鎮,0075,335,86,421,29,450,995,45.23%,33.67%,1
臺東縣,成功鎮,0076,331,93,424,59,483,863,55.97%,38.35%,1
臺東縣,成功鎮,0077,356,103,459,47,506,931,54.35%,38.24%,1
臺東縣,成功鎮,0078,365,92,457,35,492,970,50.72%,37.63%,1
臺東縣,成功鎮,0079,465,115,580,110,690,1365,50.55%,34.07%,1
臺東縣,成功鎮,0080,503,118,621,98,719,1366,52.64%,36.82%,1
臺東縣,成功鎮,0081,154,44,198,64,262,516,50.78%,29.84%,1
臺東縣,成功鎮,0082,216,71,287,85,372,887,41.94%,24.35%,1
臺東縣,成功鎮,0083,125,49,174,44,218,488,44.67%,25.61%,1
臺東縣,成功鎮,0084,106,47,153,41,194,481,40.33%,22.04%,1
臺東縣,成功鎮,0085,56,14,70,3,73,373,19.57%,15.01%,1
臺東縣,成功鎮,0086,85,35,120,26,146,264,55.3%,32.2%,1
臺東縣,關山鎮,0087,408,102,510,26,536,909,58.97%,44.88%,1
臺東縣,關山鎮,0088,246,62,308,29,337,790,42.66%,31.14%,1
臺東縣,關山鎮,0089,358,102,460,40,500,828,60.39%,43.24%,1
臺東縣,關山鎮,0090,252,80,332,35,367,887,41.38%,28.41%,1
臺東縣,關山鎮,0091,477,100,577,36,613,1137,53.91%,41.95%,1
臺東縣,關山鎮,0092,233,80,313,37,350,732,47.81%,31.83%,1
臺東縣,關山鎮,0093,322,93,415,56,471,912,51.64%,35.31%,1
臺東縣,關山鎮,0094,216,50,266,33,299,779,38.38%,27.73%,1
臺東縣,關山鎮,0095,150,32,182,21,203,535,37.94%,28.04%,1
臺東縣,卑南鄉,0096,376,159,535,64,599,1041,57.54%,36.12%,1
臺東縣,卑南鄉,0097,425,99,524,42,566,1165,48.58%,36.48%,1
臺東縣,卑南鄉,0098,47,27,74,22,96,219,43.84%,21.46%,1
臺東縣,卑南鄉,0099,136,37,173,41,214,460,46.52%,29.57%,1
臺東縣,卑南鄉,0100,109,32,141,14,155,387,40.05%,28.17%,1
臺東縣,卑南鄉,0101,235,66,301,29,330,767,43.02%,30.64%,1
臺東縣,卑南鄉,0102,188,48,236,34,270,503,53.68%,37.38%,1
臺東縣,卑南鄉,0103,227,71,298,48,346,727,47.59%,31.22%,1
臺東縣,卑南鄉,0104,151,44,195,33,228,436,52.29%,34.63%,1
臺東縣,卑南鄉,0105,51,32,83,13,96,261,36.78%,19.54%,1
臺東縣,卑南鄉,0106,70,32,102,13,115,215,53.49%,32.56%,1
臺東縣,卑南鄉,0107,577,157,734,8,742,1442,51.46%,40.01%,1
臺東縣,卑南鄉,0108,200,46,246,16,262,527,49.72%,37.95%,1
臺東縣,卑南鄉,0109,395,121,516,63,579,1046,55.35%,37.76%,1
臺東縣,卑南鄉,0110,369,145,514,80,594,1110,53.51%,33.24%,1
臺東縣,卑南鄉,0111,444,131,575,53,628,1105,56.83%,40.18%,1
臺東縣,卑南鄉,0112,455,132,587,138,725,1167,62.13%,38.99%,1
臺東縣,卑南鄉,0113,290,124,414,56,470,968,48.55%,29.96%,1
臺東縣,卑南鄉,0114,43,11,54,4,58,159,36.48%,27.04%,1
臺東縣,卑南鄉,0115,158,38,196,23,219,488,44.88%,32.38%,1
臺東縣,卑南鄉,0116,150,39,189,15,204,347,58.79%,43.23%,1
臺東縣,卑南鄉,0117,159,40,199,26,225,436,51.61%,36.47%,1
臺東縣,鹿野鄉,0118,136,43,179,10,189,522,36.21%,26.05%,1
臺東縣,鹿野鄉,0119,199,71,270,37,307,574,53.48%,34.67%,1
臺東縣,鹿野鄉,0120,286,90,376,37,413,1055,39.15%,27.11%,1
臺東縣,鹿野鄉,0121,337,133,470,40,510,1104,46.2%,30.53%,1
臺東縣,鹿野鄉,0122,114,24,138,16,154,342,45.03%,33.33%,1
臺東縣,鹿野鄉,0123,276,88,364,55,419,895,46.82%,30.84%,1
臺東縣,鹿野鄉,0124,251,104,355,53,408,864,47.22%,29.05%,1
臺東縣,鹿野鄉,0125,164,76,240,48,288,675,42.67%,24.3%,1
臺東縣,鹿野鄉,0126,138,54,192,21,213,435,48.97%,31.72%,1
臺東縣,鹿野鄉,0127,110,44,154,26,180,470,38.3%,23.4%,1
臺東縣,池上鄉,0128,329,97,426,34,460,992,46.37%,33.17%,1
臺東縣,池上鄉,0129,357,97,454,53,507,929,54.57%,38.43%,1
臺東縣,池上鄉,0130,136,46,182,28,210,434,48.39%,31.34%,1
臺東縣,池上鄉,0131,196,74,270,36,306,703,43.53%,27.88%,1
臺東縣,池上鄉,0132,191,49,240,23,263,654,40.21%,29.2%,1
臺東縣,池上鄉,0133,81,27,108,20,128,324,39.51%,25%,1
臺東縣,池上鄉,0134,236,81,317,41,358,794,45.09%,29.72%,1
臺東縣,池上鄉,0135,281,82,363,52,415,856,48.48%,32.83%,1
臺東縣,池上鄉,0136,105,21,126,13,139,344,40.41%,30.52%,1
臺東縣,池上鄉,0137,121,29,150,21,171,311,54.98%,38.91%,1
臺東縣,池上鄉,0138,83,36,119,17,136,386,35.23%,21.5%,1
臺東縣,池上鄉,0139,93,34,127,24,151,435,34.71%,21.38%,1
臺東縣,東河鄉,0140,85,13,98,24,122,290,42.07%,29.31%,1
臺東縣,東河鄉,0141,227,67,294,43,337,620,54.35%,36.61%,1
臺東縣,東河鄉,0142,456,163,619,121,740,1196,61.87%,38.13%,1
臺東縣,東河鄉,0143,259,86,345,93,438,918,47.71%,28.21%,1
臺東縣,東河鄉,0144,172,42,214,42,256,555,46.13%,30.99%,1
臺東縣,東河鄉,0145,261,96,357,36,393,977,40.23%,26.71%,1
臺東縣,東河鄉,0146,210,66,276,12,288,1197,24.06%,17.54%,1
臺東縣,東河鄉,0147,130,44,174,35,209,867,24.11%,14.99%,1
臺東縣,東河鄉,0148,94,31,125,23,148,345,42.9%,27.25%,1
臺東縣,東河鄉,0149,111,32,143,25,168,408,41.18%,27.21%,1
臺東縣,東河鄉,0150,82,23,105,9,114,262,43.51%,31.3%,1
臺東縣,長濱鄉,0151,177,75,252,57,309,536,57.65%,33.02%,1
臺東縣,長濱鄉,0152,142,40,182,36,218,689,31.64%,20.61%,1
臺東縣,長濱鄉,0153,279,97,376,123,499,913,54.65%,30.56%,1
臺東縣,長濱鄉,0154,321,70,391,32,423,1268,33.36%,25.32%,1
臺東縣,長濱鄉,0155,187,78,265,70,335,725,46.21%,25.79%,1
臺東縣,長濱鄉,0156,91,31,122,10,132,532,24.81%,17.11%,1
臺東縣,長濱鄉,0157,152,51,203,76,279,660,42.27%,23.03%,1
臺東縣,長濱鄉,0158,52,8,60,3,63,336,18.75%,15.48%,1
臺東縣,長濱鄉,0159,38,12,50,14,64,195,32.82%,19.49%,1
臺東縣,長濱鄉,0160,9,2,11,2,13,25,52%,36%,1
臺東縣,長濱鄉,0161,142,47,189,61,250,605,41.32%,23.47%,1
臺東縣,太麻里鄉,0162,264,69,333,51,384,722,53.19%,36.57%,1
臺東縣,太麻里鄉,0163,199,64,263,24,287,575,49.91%,34.61%,1
臺東縣,太麻里鄉,0164,199,75,274,36,310,623,49.76%,31.94%,1
臺東縣,太麻里鄉,0165,184,55,239,56,295,622,47.43%,29.58%,1
臺東縣,太麻里鄉,0166,149,38,187,14,201,560,35.89%,26.61%,1
臺東縣,太麻里鄉,0167,317,97,414,109,523,957,54.65%,33.12%,1
臺東縣,太麻里鄉,0168,214,103,317,39,356,809,44%,26.45%,1
臺東縣,太麻里鄉,0169,282,82,364,50,414,673,61.52%,41.9%,1
臺東縣,太麻里鄉,0170,251,76,327,52,379,737,51.42%,34.06%,1
臺東縣,太麻里鄉,0171,146,58,204,34,238,424,56.13%,34.43%,1
臺東縣,太麻里鄉,0172,101,56,157,22,179,374,47.86%,27.01%,1
臺東縣,太麻里鄉,0173,193,63,256,21,277,829,33.41%,23.28%,1
臺東縣,太麻里鄉,0174,214,47,261,8,269,869,30.96%,24.63%,1
臺東縣,太麻里鄉,0175,48,10,58,5,63,223,28.25%,21.52%,1
臺東縣,太麻里鄉,0176,236,78,314,48,362,669,54.11%,35.28%,1
臺東縣,大武鄉,0177,195,65,260,71,331,568,58.27%,34.33%,1
臺東縣,大武鄉,0178,430,133,563,157,720,1474,48.85%,29.17%,1
臺東縣,大武鄉,0179,442,149,591,118,709,1327,53.43%,33.31%,1
臺東縣,大武鄉,0180,307,113,420,114,534,1134,47.09%,27.07%,1
臺東縣,大武鄉,0181,110,39,149,64,213,386,55.18%,28.5%,1
臺東縣,大武鄉,0182,93,43,136,31,167,377,44.3%,24.67%,1
臺東縣,綠島鄉,0183,462,106,568,30,598,1474,40.57%,31.34%,1
臺東縣,綠島鄉,0184,346,89,435,38,473,1082,43.72%,31.98%,1
臺東縣,綠島鄉,0185,270,81,351,30,381,813,46.86%,33.21%,1
臺東縣,綠島鄉,0186,69,24,93,3,96,210,45.71%,32.86%,1
臺東縣,海端鄉,0187,168,54,222,41,263,497,52.92%,33.8%,1
臺東縣,海端鄉,0188,226,67,293,37,330,569,58%,39.72%,1
臺東縣,海端鄉,0189,311,109,420,60,480,971,49.43%,32.03%,1
臺東縣,海端鄉,0190,256,97,353,40,393,728,53.98%,35.16%,1
臺東縣,海端鄉,0191,89,30,119,21,140,259,54.05%,34.36%,1
臺東縣,海端鄉,0192,79,34,113,13,126,254,49.61%,31.1%,1
臺東縣,延平鄉,0193,340,105,445,56,501,1014,49.41%,33.53%,1
臺東縣,延平鄉,0194,161,69,230,66,296,426,69.48%,37.79%,1
臺東縣,延平鄉,0195,144,36,180,29,209,315,66.35%,45.71%,1
臺東縣,延平鄉,0196,154,56,210,20,230,579,39.72%,26.6%,1
臺東縣,延平鄉,0197,175,71,246,28,274,596,45.97%,29.36%,1
臺東縣,金峰鄉,0198,346,124,470,64,534,1241,43.03%,27.88%,1
臺東縣,金峰鄉,0199,245,63,308,36,344,601,57.24%,40.77%,1
臺東縣,金峰鄉,0200,266,75,341,52,393,520,75.58%,51.15%,1
臺東縣,金峰鄉,0201,124,39,163,26,189,336,56.25%,36.9%,1
臺東縣,金峰鄉,0202,79,39,118,34,152,330,46.06%,23.94%,1
臺東縣,達仁鄉,0203,97,31,128,26,154,246,62.6%,39.43%,1
臺東縣,達仁鄉,0204,169,39,208,10,218,340,64.12%,49.71%,1
臺東縣,達仁鄉,0205,143,39,182,13,195,296,65.88%,48.31%,1
臺東縣,達仁鄉,0206,178,49,227,37,264,429,61.54%,41.49%,1
臺東縣,達仁鄉,0207,139,43,182,29,211,331,63.75%,41.99%,1
臺東縣,達仁鄉,0208,164,66,230,25,255,628,40.61%,26.11%,1
臺東縣,達仁鄉,0209,401,3,404,58,462,867,53.29%,46.25%,1
臺東縣,蘭嶼鄉,0210,237,102,339,28,367,943,38.92%,25.13%,1
臺東縣,蘭嶼鄉,0211,353,124,477,47,524,1238,42.33%,28.51%,1
臺東縣,蘭嶼鄉,0212,228,108,336,26,362,1240,29.19%,18.39%,1
臺東縣,蘭嶼鄉,0213,173,67,240,39,279,760,36.71%,22.76%,1
澎湖縣,馬公市,0001,152,59,211,12,223,481,46.36%,31.6%,1
澎湖縣,馬公市,0002,218,47,265,17,282,558,50.54%,39.07%,1
澎湖縣,馬公市,0003,161,56,217,46,263,533,49.34%,30.21%,1
澎湖縣,馬公市,0004,300,110,410,31,441,922,47.83%,32.54%,1
澎湖縣,馬公市,0005,367,126,493,40,533,1021,52.2%,35.95%,1
澎湖縣,馬公市,0006,275,92,367,34,401,793,50.57%,34.68%,1
澎湖縣,馬公市,0007,350,110,460,48,508,954,53.25%,36.69%,1
澎湖縣,馬公市,0008,263,201,464,27,491,1001,49.05%,26.27%,1
澎湖縣,馬公市,0009,369,123,492,36,528,1192,44.3%,30.96%,1
澎湖縣,馬公市,0010,498,112,610,46,656,1402,46.79%,35.52%,1
澎湖縣,馬公市,0011,547,117,664,34,698,1389,50.25%,39.38%,1
澎湖縣,馬公市,0012,507,136,643,45,688,1339,51.38%,37.86%,1
澎湖縣,馬公市,0013,400,129,529,55,584,1254,46.57%,31.9%,1
澎湖縣,馬公市,0014,436,106,542,57,599,1194,50.17%,36.52%,1
澎湖縣,馬公市,0015,467,142,609,63,672,1393,48.24%,33.52%,1
澎湖縣,馬公市,0016,558,142,700,47,747,1440,51.88%,38.75%,1
澎湖縣,馬公市,0017,396,135,531,55,586,1215,48.23%,32.59%,1
澎湖縣,馬公市,0018,465,110,575,56,631,1284,49.14%,36.21%,1
澎湖縣,馬公市,0019,525,150,675,76,751,1512,49.67%,34.72%,1
澎湖縣,馬公市,0020,242,60,302,62,364,1181,30.82%,20.49%,1
澎湖縣,馬公市,0021,494,127,621,47,668,1348,49.55%,36.65%,1
澎湖縣,馬公市,0022,528,154,682,32,714,1391,51.33%,37.96%,1
澎湖縣,馬公市,0023,644,254,898,41,939,2124,44.21%,30.32%,1
澎湖縣,馬公市,0024,530,140,670,69,739,1500,49.27%,35.33%,1
澎湖縣,馬公市,0025,598,139,737,38,775,1582,48.99%,37.8%,1
澎湖縣,馬公市,0026,590,162,752,42,794,1638,48.47%,36.02%,1
澎湖縣,馬公市,0027,597,152,749,55,804,1554,51.74%,38.42%,1
澎湖縣,馬公市,0028,279,70,349,26,375,980,38.27%,28.47%,1
澎湖縣,馬公市,0029,340,78,418,27,445,892,49.89%,38.12%,1
澎湖縣,馬公市,0030,247,58,305,16,321,778,41.26%,31.75%,1
澎湖縣,馬公市,0031,362,78,440,31,471,930,50.65%,38.92%,1
澎湖縣,馬公市,0032,680,130,810,45,855,1481,57.73%,45.91%,1
澎湖縣,馬公市,0033,474,92,566,26,592,1128,52.48%,42.02%,1
澎湖縣,馬公市,0034,159,32,191,25,216,415,52.05%,38.31%,1
澎湖縣,馬公市,0035,433,81,514,43,557,1120,49.73%,38.66%,1
澎湖縣,馬公市,0036,400,81,481,34,515,950,54.21%,42.11%,1
澎湖縣,馬公市,0037,204,53,257,23,280,627,44.66%,32.54%,1
澎湖縣,馬公市,0038,395,87,482,30,512,1055,48.53%,37.44%,1
澎湖縣,馬公市,0039,372,94,466,48,514,989,51.97%,37.61%,1
澎湖縣,馬公市,0040,229,68,297,32,329,591,55.67%,38.75%,1
澎湖縣,馬公市,0041,440,150,590,67,657,1387,47.37%,31.72%,1
澎湖縣,馬公市,0042,303,95,398,65,463,1079,42.91%,28.08%,1
澎湖縣,馬公市,0043,283,68,351,46,397,797,49.81%,35.51%,1
澎湖縣,馬公市,0044,292,62,354,25,379,903,41.97%,32.34%,1
澎湖縣,馬公市,0045,105,45,150,24,174,376,46.28%,27.93%,1
澎湖縣,馬公市,0046,131,41,172,22,194,371,52.29%,35.31%,1
澎湖縣,馬公市,0047,339,84,423,17,440,1173,37.51%,28.9%,1
澎湖縣,馬公市,0048,315,98,413,31,444,1389,31.97%,22.68%,1
澎湖縣,馬公市,0049,112,40,152,61,213,761,27.99%,14.72%,1
澎湖縣,馬公市,0050,116,38,154,22,176,288,61.11%,40.28%,1
澎湖縣,湖西鄉,0051,427,87,514,58,572,1120,51.07%,38.13%,1
澎湖縣,湖西鄉,0052,99,28,127,13,140,332,42.17%,29.82%,1
澎湖縣,湖西鄉,0053,63,21,84,3,87,242,35.95%,26.03%,1
澎湖縣,湖西鄉,0054,64,26,90,9,99,293,33.79%,21.84%,1
澎湖縣,湖西鄉,0055,173,51,224,49,273,666,40.99%,25.98%,1
澎湖縣,湖西鄉,0056,115,29,144,18,162,326,49.69%,35.28%,1
澎湖縣,湖西鄉,0057,191,55,246,17,263,732,35.93%,26.09%,1
澎湖縣,湖西鄉,0058,222,50,272,25,297,651,45.62%,34.1%,1
澎湖縣,湖西鄉,0059,240,53,293,15,308,744,41.4%,32.26%,1
澎湖縣,湖西鄉,0060,53,16,69,5,74,134,55.22%,39.55%,1
澎湖縣,湖西鄉,0061,189,49,238,21,259,794,32.62%,23.8%,1
澎湖縣,湖西鄉,0062,65,12,77,1,78,216,36.11%,30.09%,1
澎湖縣,湖西鄉,0063,153,31,184,9,193,664,29.07%,23.04%,1
澎湖縣,湖西鄉,0064,98,22,120,10,130,279,46.59%,35.13%,1
澎湖縣,湖西鄉,0065,108,30,138,7,145,296,48.99%,36.49%,1
澎湖縣,湖西鄉,0066,96,17,113,5,118,257,45.91%,37.35%,1
澎湖縣,湖西鄉,0067,22,4,26,1,27,89,30.34%,24.72%,1
澎湖縣,湖西鄉,0068,254,97,351,31,382,815,46.87%,31.17%,1
澎湖縣,湖西鄉,0069,278,73,351,28,379,975,38.87%,28.51%,1
澎湖縣,湖西鄉,0070,201,76,277,39,316,648,48.77%,31.02%,1
澎湖縣,湖西鄉,0071,262,69,331,24,355,893,39.75%,29.34%,1
澎湖縣,湖西鄉,0072,274,86,360,78,438,846,51.77%,32.39%,1
澎湖縣,湖西鄉,0073,178,53,231,19,250,729,34.29%,24.42%,1
澎湖縣,白沙鄉,0074,158,77,235,20,255,514,49.61%,30.74%,1
澎湖縣,白沙鄉,0075,252,56,308,19,327,657,49.77%,38.36%,1
澎湖縣,白沙鄉,0076,53,15,68,4,72,109,66.06%,48.62%,1
澎湖縣,白沙鄉,0077,51,8,59,6,65,156,41.67%,32.69%,1
澎湖縣,白沙鄉,0078,83,32,115,5,120,293,40.96%,28.33%,1
澎湖縣,白沙鄉,0079,49,16,65,2,67,231,29%,21.21%,1
澎湖縣,白沙鄉,0080,49,25,74,12,86,161,53.42%,30.43%,1
澎湖縣,白沙鄉,0081,572,150,722,58,780,1705,45.75%,33.55%,1
澎湖縣,白沙鄉,0082,80,32,112,9,121,285,42.46%,28.07%,1
澎湖縣,白沙鄉,0083,142,59,201,10,211,723,29.18%,19.64%,1
澎湖縣,白沙鄉,0084,201,52,253,33,286,774,36.95%,25.97%,1
澎湖縣,白沙鄉,0085,261,113,374,113,487,1429,34.08%,18.26%,1
澎湖縣,白沙鄉,0086,351,74,425,73,498,1084,45.94%,32.38%,1
澎湖縣,白沙鄉,0087,96,23,119,6,125,251,49.8%,38.25%,1
澎湖縣,白沙鄉,0088,45,24,69,19,88,253,34.78%,17.79%,1
澎湖縣,西嶼鄉,0089,29,12,41,0,41,283,14.49%,10.25%,1
澎湖縣,西嶼鄉,0090,84,20,104,17,121,424,28.54%,19.81%,1
澎湖縣,西嶼鄉,0091,173,55,228,56,284,826,34.38%,20.94%,1
澎湖縣,西嶼鄉,0092,71,22,93,10,103,282,36.52%,25.18%,1
澎湖縣,西嶼鄉,0093,150,45,195,55,250,661,37.82%,22.69%,1
澎湖縣,西嶼鄉,0094,13,9,22,5,27,141,19.15%,9.22%,1
澎湖縣,西嶼鄉,0095,137,28,165,8,173,635,27.24%,21.57%,1
澎湖縣,西嶼鄉,0096,46,16,62,4,66,216,30.56%,21.3%,1
澎湖縣,西嶼鄉,0097,78,28,106,23,129,572,22.55%,13.64%,1
澎湖縣,西嶼鄉,0098,320,83,403,93,496,1267,39.15%,25.26%,1
澎湖縣,西嶼鄉,0099,264,51,315,30,345,942,36.62%,28.03%,1
澎湖縣,西嶼鄉,0100,253,92,345,81,426,1133,37.6%,22.33%,1
澎湖縣,望安鄉,0101,233,57,290,37,327,734,44.55%,31.74%,1
澎湖縣,望安鄉,0102,141,23,164,26,190,454,41.85%,31.06%,1
澎湖縣,望安鄉,0103,63,16,79,13,92,300,30.67%,21%,1
澎湖縣,望安鄉,0104,151,42,193,44,237,471,50.32%,32.06%,1
澎湖縣,望安鄉,0105,144,37,181,22,203,672,30.21%,21.43%,1
澎湖縣,望安鄉,0106,175,73,248,50,298,742,40.16%,23.58%,1
澎湖縣,望安鄉,0107,63,26,89,19,108,264,40.91%,23.86%,1
澎湖縣,望安鄉,0108,127,34,161,8,169,476,35.5%,26.68%,1
澎湖縣,望安鄉,0109,26,10,36,5,41,208,19.71%,12.5%,1
澎湖縣,望安鄉,0110,69,15,84,8,92,307,29.97%,22.48%,1
澎湖縣,七美鄉,0111,50,12,62,4,66,248,26.61%,20.16%,1
澎湖縣,七美鄉,0112,131,40,171,33,204,581,35.11%,22.55%,1
澎湖縣,七美鄉,0113,138,52,190,34,224,641,34.95%,21.53%,1
澎湖縣,七美鄉,0114,76,28,104,7,111,382,29.06%,19.9%,1
澎湖縣,七美鄉,0115,51,15,66,6,72,351,20.51%,14.53%,1
澎湖縣,七美鄉,0116,221,64,285,30,315,1171,26.9%,18.87%,1
金門縣,金城鎮,0001,400,62,462,30,492,1396,35.24%,28.65%,1
金門縣,金城鎮,0002,525,126,651,42,693,1831,37.85%,28.67%,1
金門縣,金城鎮,0003,493,106,599,44,643,1750,36.74%,28.17%,1
金門縣,金城鎮,0004,564,100,664,53,717,1889,37.96%,29.86%,1
金門縣,金城鎮,0005,403,103,506,30,536,1675,32%,24.06%,1
金門縣,金城鎮,0006,625,109,734,46,780,1901,41.03%,32.88%,1
金門縣,金城鎮,0007,405,96,501,55,556,1610,34.53%,25.16%,1
金門縣,金城鎮,0008,484,86,570,32,602,1687,35.68%,28.69%,1
金門縣,金城鎮,0009,481,77,558,22,580,1594,36.39%,30.18%,1
金門縣,金城鎮,0010,482,95,577,22,599,1726,34.7%,27.93%,1
金門縣,金城鎮,0011,512,92,604,25,629,1733,36.3%,29.54%,1
金門縣,金城鎮,0012,488,107,595,31,626,1532,40.86%,31.85%,1
金門縣,金城鎮,0013,547,115,662,55,717,2079,34.49%,26.31%,1
金門縣,金城鎮,0014,506,107,613,38,651,2033,32.02%,24.89%,1
金門縣,金城鎮,0015,705,129,834,48,882,2517,35.04%,28.01%,1
金門縣,金城鎮,0016,580,110,690,36,726,2083,34.85%,27.84%,1
金門縣,金城鎮,0017,557,123,680,55,735,2140,34.35%,26.03%,1
金門縣,金城鎮,0018,570,102,672,37,709,2435,29.12%,23.41%,1
金門縣,金城鎮,0019,243,62,305,40,345,1353,25.5%,17.96%,1
金門縣,金城鎮,0020,399,68,467,29,496,1574,31.51%,25.35%,1
金門縣,金城鎮,0021,377,59,436,42,478,1277,37.43%,29.52%,1
金門縣,金沙鎮,0066,493,109,602,52,654,1909,34.26%,25.83%,1
金門縣,金沙鎮,0067,483,91,574,51,625,1524,41.01%,31.69%,1
金門縣,金沙鎮,0068,416,81,497,47,544,1673,32.52%,24.87%,1
金門縣,金沙鎮,0069,519,87,606,54,660,2003,32.95%,25.91%,1
金門縣,金沙鎮,0070,376,86,462,31,493,1212,40.68%,31.02%,1
金門縣,金沙鎮,0071,303,67,370,40,410,1126,36.41%,26.91%,1
金門縣,金沙鎮,0072,375,69,444,35,479,1540,31.1%,24.35%,1
金門縣,金沙鎮,0073,281,60,341,35,376,1216,30.92%,23.11%,1
金門縣,金沙鎮,0074,196,44,240,18,258,950,27.16%,20.63%,1
金門縣,金沙鎮,0075,586,72,658,43,701,1895,36.99%,30.92%,1
金門縣,金沙鎮,0076,356,70,426,37,463,1135,40.79%,31.37%,1
金門縣,金沙鎮,0077,330,62,392,43,435,1252,34.74%,26.36%,1
金門縣,金沙鎮,0078,381,62,443,19,462,1125,41.07%,33.87%,1
金門縣,金湖鎮,0049,392,101,493,47,540,1348,40.06%,29.08%,1
金門縣,金湖鎮,0050,360,85,445,42,487,1386,35.14%,25.97%,1
金門縣,金湖鎮,0051,467,83,550,54,604,1403,43.05%,33.29%,1
金門縣,金湖鎮,0052,534,95,629,44,673,1771,38%,30.15%,1
金門縣,金湖鎮,0053,394,109,503,52,555,1493,37.17%,26.39%,1
金門縣,金湖鎮,0054,421,62,483,55,538,1510,35.63%,27.88%,1
金門縣,金湖鎮,0055,601,61,662,42,704,1607,43.81%,37.4%,1
金門縣,金湖鎮,0056,534,88,622,52,674,2006,33.6%,26.62%,1
金門縣,金湖鎮,0057,500,107,607,34,641,1780,36.01%,28.09%,1
金門縣,金湖鎮,0058,521,92,613,22,635,1739,36.52%,29.96%,1
金門縣,金湖鎮,0059,372,72,444,34,478,1384,34.54%,26.88%,1
金門縣,金湖鎮,0060,398,92,490,38,528,1400,37.71%,28.43%,1
金門縣,金湖鎮,0061,449,104,553,32,585,1325,44.15%,33.89%,1
金門縣,金湖鎮,0062,312,65,377,35,412,1236,33.33%,25.24%,1
金門縣,金湖鎮,0063,358,74,432,38,470,1382,34.01%,25.9%,1
金門縣,金湖鎮,0064,446,85,531,29,560,1631,34.33%,27.35%,1
金門縣,金湖鎮,0065,384,73,457,38,495,1514,32.69%,25.36%,1
金門縣,金寧鄉,0022,400,82,482,59,541,1735,31.18%,23.05%,1
金門縣,金寧鄉,0023,366,80,446,38,484,1537,31.49%,23.81%,1
金門縣,金寧鄉,0024,436,114,550,41,591,1766,33.47%,24.69%,1
金門縣,金寧鄉,0025,294,64,358,17,375,1015,36.95%,28.97%,1
金門縣,金寧鄉,0026,466,94,560,52,612,1726,35.46%,27%,1
金門縣,金寧鄉,0027,408,93,501,33,534,1691,31.58%,24.13%,1
金門縣,金寧鄉,0028,582,245,827,38,865,2044,42.32%,28.47%,1
金門縣,金寧鄉,0029,624,104,728,36,764,1848,41.34%,33.77%,1
金門縣,金寧鄉,0030,484,86,570,33,603,1735,34.76%,27.9%,1
金門縣,金寧鄉,0031,490,90,580,47,627,1795,34.93%,27.3%,1
金門縣,金寧鄉,0032,457,76,533,47,580,1834,31.62%,24.92%,1
金門縣,金寧鄉,0033,393,71,464,43,507,1528,33.18%,25.72%,1
金門縣,金寧鄉,0034,460,79,539,29,568,1473,38.56%,31.23%,1
金門縣,金寧鄉,0035,476,84,560,43,603,1679,35.91%,28.35%,1
金門縣,金寧鄉,0036,600,288,888,43,931,1921,48.46%,31.23%,1
金門縣,金寧鄉,0037,373,75,448,19,467,1298,35.98%,28.74%,1
金門縣,金寧鄉,0038,399,73,472,33,505,1537,32.86%,25.96%,1
金門縣,烈嶼鄉,0039,618,67,685,37,722,1647,43.84%,37.52%,1
金門縣,烈嶼鄉,0040,505,71,576,41,617,1733,35.6%,29.14%,1
金門縣,烈嶼鄉,0041,480,85,565,39,604,1635,36.94%,29.36%,1
金門縣,烈嶼鄉,0042,348,65,413,27,440,1296,33.95%,26.85%,1
金門縣,烈嶼鄉,0043,281,41,322,33,355,1099,32.3%,25.57%,1
金門縣,烈嶼鄉,0044,370,79,449,30,479,1425,33.61%,25.96%,1
金門縣,烈嶼鄉,0045,412,84,496,29,525,1412,37.18%,29.18%,1
金門縣,烈嶼鄉,0046,398,64,462,43,505,1429,35.34%,27.85%,1
金門縣,烏坵鄉,0047,63,11,74,4,78,275,28.36%,22.91%,1
金門縣,烏坵鄉,0048,72,9,81,6,87,292,29.79%,24.66%,1
連江縣,南竿鄉,0001,830,139,969,44,1013,1967,51.5%,42.2%,1
連江縣,南竿鄉,0002,717,115,832,46,878,1837,47.8%,39.03%,1
連江縣,南竿鄉,0003,471,93,564,23,587,1114,52.69%,42.28%,1
連江縣,南竿鄉,0004,690,78,768,26,794,1543,51.46%,44.72%,1
連江縣,北竿鄉,0005,657,108,765,49,814,1515,53.73%,43.37%,1
連江縣,北竿鄉,0006,246,34,280,10,290,610,47.54%,40.33%,1
連江縣,莒光鄉,0007,264,57,321,14,335,698,47.99%,37.82%,1
連江縣,莒光鄉,0008,346,67,413,29,442,783,56.45%,44.19%,1
連江縣,東引鄉,0009,484,78,562,16,578,1138,50.79%,42.53%,1
基隆市,中正區,0001,175,53,228,17,245,466,52.58%,37.55%,1
基隆市,中正區,0002,372,126,498,25,523,1262,41.44%,29.48%,1
基隆市,中正區,0003,343,146,489,66,555,1171,47.4%,29.29%,1
基隆市,中正區,0004,846,179,1025,30,1055,2823,37.37%,29.97%,1
基隆市,中正區,0005,437,141,578,51,629,1474,42.67%,29.65%,1
基隆市,中正區,0006,395,90,485,63,548,1271,43.12%,31.08%,1
基隆市,中正區,0007,829,255,1084,73,1157,2707,42.74%,30.62%,1
基隆市,中正區,0008,562,117,679,71,750,1545,48.54%,36.38%,1
基隆市,中正區,0009,220,39,259,13,272,761,35.74%,28.91%,1
基隆市,中正區,0010,500,124,624,18,642,1352,47.49%,36.98%,1
基隆市,中正區,0011,513,111,624,19,643,1413,45.51%,36.31%,1
基隆市,中正區,0012,883,213,1096,48,1144,2665,42.93%,33.13%,1
基隆市,中正區,0013,364,145,509,76,585,1261,46.39%,28.87%,1
基隆市,中正區,0014,590,198,788,86,874,1753,49.86%,33.66%,1
基隆市,中正區,0015,301,99,400,42,442,984,44.92%,30.59%,1
基隆市,中正區,0016,385,92,477,28,505,1166,43.31%,33.02%,1
基隆市,中正區,0017,342,100,442,29,471,973,48.41%,35.15%,1
基隆市,中正區,0018,447,142,589,21,610,1694,36.01%,26.39%,1
基隆市,中正區,0019,464,133,597,34,631,1270,49.69%,36.54%,1
基隆市,中正區,0020,419,119,538,26,564,1090,51.74%,38.44%,1
基隆市,中正區,0021,331,91,422,24,446,870,51.26%,38.05%,1
基隆市,中正區,0022,411,110,521,50,571,1138,50.18%,36.12%,1
基隆市,中正區,0023,292,40,332,48,380,862,44.08%,33.87%,1
基隆市,中正區,0024,526,90,616,68,684,1341,51.01%,39.22%,1
基隆市,中正區,0025,315,107,422,40,462,859,53.78%,36.67%,1
基隆市,中正區,0026,496,135,631,32,663,1457,45.5%,34.04%,1
基隆市,中正區,0027,458,128,586,64,650,1594,40.78%,28.73%,1
基隆市,中正區,0028,293,89,382,45,427,802,53.24%,36.53%,1
基隆市,中正區,0029,441,128,569,47,616,1267,48.62%,34.81%,1
基隆市,中正區,0030,417,131,548,70,618,1175,52.6%,35.49%,1
基隆市,中正區,0031,492,135,627,47,674,1210,55.7%,40.66%,1
基隆市,中正區,0032,351,131,482,58,540,1037,52.07%,33.85%,1
基隆市,中正區,0033,444,132,576,57,633,1219,51.93%,36.42%,1
基隆市,中正區,0034,306,108,414,18,432,904,47.79%,33.85%,1
基隆市,中正區,0035,315,90,405,34,439,709,61.92%,44.43%,1
基隆市,七堵區,0219,477,167,644,61,705,1258,56.04%,37.92%,1
基隆市,七堵區,0220,499,140,639,45,684,1237,55.3%,40.34%,1
基隆市,七堵區,0221,466,140,606,33,639,1259,50.75%,37.01%,1
基隆市,七堵區,0222,358,144,502,53,555,1120,49.55%,31.96%,1
基隆市,七堵區,0223,449,138,587,52,639,1344,47.54%,33.41%,1
基隆市,七堵區,0224,427,142,569,47,616,1011,60.93%,42.24%,1
基隆市,七堵區,0225,329,111,440,23,463,925,50.05%,35.57%,1
基隆市,七堵區,0226,713,189,902,66,968,1735,55.79%,41.1%,1
基隆市,七堵區,0227,732,239,971,62,1033,1833,56.36%,39.93%,1
基隆市,七堵區,0228,339,124,463,24,487,938,51.92%,36.14%,1
基隆市,七堵區,0229,395,126,521,51,572,962,59.46%,41.06%,1
基隆市,七堵區,0230,481,144,625,45,670,1191,56.26%,40.39%,1
基隆市,七堵區,0231,422,95,517,48,565,999,56.56%,42.24%,1
基隆市,七堵區,0232,105,21,126,12,138,282,48.94%,37.23%,1
基隆市,七堵區,0233,437,153,590,55,645,1243,51.89%,35.16%,1
基隆市,七堵區,0234,389,130,519,40,559,1092,51.19%,35.62%,1
基隆市,七堵區,0235,470,154,624,44,668,1246,53.61%,37.72%,1
基隆市,七堵區,0236,636,186,822,53,875,1722,50.81%,36.93%,1
基隆市,七堵區,0237,508,131,639,41,680,1318,51.59%,38.54%,1
基隆市,七堵區,0238,330,101,431,21,452,975,46.36%,33.85%,1
基隆市,七堵區,0239,473,168,641,30,671,1285,52.22%,36.81%,1
基隆市,七堵區,0240,352,113,465,52,517,1077,48%,32.68%,1
基隆市,七堵區,0241,322,110,432,36,468,989,47.32%,32.56%,1
基隆市,七堵區,0242,398,152,550,43,593,1193,49.71%,33.36%,1
基隆市,七堵區,0243,442,168,610,57,667,1273,52.4%,34.72%,1
基隆市,七堵區,0244,660,206,866,80,946,1774,53.33%,37.2%,1
基隆市,七堵區,0245,639,204,843,104,947,1689,56.07%,37.83%,1
基隆市,七堵區,0246,480,145,625,61,686,1355,50.63%,35.42%,1
基隆市,七堵區,0247,533,169,702,61,763,1512,50.46%,35.25%,1
基隆市,七堵區,0248,505,165,670,26,696,1486,46.84%,33.98%,1
基隆市,七堵區,0249,651,172,823,25,848,1706,49.71%,38.16%,1
基隆市,七堵區,0250,624,50,674,63,737,1384,53.25%,45.09%,1
基隆市,七堵區,0251,408,169,577,48,625,1045,59.81%,39.04%,1
基隆市,七堵區,0252,538,155,693,38,731,1374,53.2%,39.16%,1
基隆市,七堵區,0253,154,51,205,12,217,428,50.7%,35.98%,1
基隆市,七堵區,0254,119,54,173,23,196,326,60.12%,36.5%,1
基隆市,七堵區,0255,178,50,228,18,246,351,70.09%,50.71%,1
基隆市,七堵區,0256,660,166,826,38,864,1871,46.18%,35.28%,1
基隆市,七堵區,0257,144,47,191,7,198,448,44.2%,32.14%,1
基隆市,暖暖區,0191,506,146,652,46,698,1431,48.78%,35.36%,1
基隆市,暖暖區,0192,145,42,187,11,198,456,43.42%,31.8%,1
基隆市,暖暖區,0193,245,81,326,24,350,637,54.95%,38.46%,1
基隆市,暖暖區,0194,302,94,396,28,424,735,57.69%,41.09%,1
基隆市,暖暖區,0195,377,97,474,30,504,1078,46.75%,34.97%,1
基隆市,暖暖區,0196,435,146,581,44,625,1238,50.48%,35.14%,1
基隆市,暖暖區,0197,490,138,628,44,672,1325,50.72%,36.98%,1
基隆市,暖暖區,0198,575,154,729,43,772,1475,52.34%,38.98%,1
基隆市,暖暖區,0199,383,112,495,34,529,1179,44.87%,32.49%,1
基隆市,暖暖區,0200,478,129,607,41,648,1110,58.38%,43.06%,1
基隆市,暖暖區,0201,465,150,615,34,649,1443,44.98%,32.22%,1
基隆市,暖暖區,0202,140,59,199,23,222,415,53.49%,33.73%,1
基隆市,暖暖區,0203,515,122,637,20,657,1378,47.68%,37.37%,1
基隆市,暖暖區,0204,605,182,787,28,815,1570,51.91%,38.54%,1
基隆市,暖暖區,0205,693,186,879,61,940,1603,58.64%,43.23%,1
基隆市,暖暖區,0206,517,143,660,50,710,1267,56.04%,40.81%,1
基隆市,暖暖區,0207,547,133,680,34,714,1359,52.54%,40.25%,1
基隆市,暖暖區,0208,455,82,537,22,559,970,57.63%,46.91%,1
基隆市,暖暖區,0209,405,83,488,20,508,1002,50.7%,40.42%,1
基隆市,暖暖區,0210,352,87,439,28,467,944,49.47%,37.29%,1
基隆市,暖暖區,0211,623,174,797,43,840,1500,56%,41.53%,1
基隆市,暖暖區,0212,448,100,548,28,576,1442,39.94%,31.07%,1
基隆市,暖暖區,0213,473,124,597,26,623,1165,53.48%,40.6%,1
基隆市,暖暖區,0214,529,248,777,24,801,1610,49.75%,32.86%,1
基隆市,暖暖區,0215,544,149,693,29,722,1328,54.37%,40.96%,1
基隆市,暖暖區,0216,438,125,563,23,586,1173,49.96%,37.34%,1
基隆市,暖暖區,0217,454,109,563,36,599,1019,58.78%,44.55%,1
基隆市,暖暖區,0218,564,132,696,19,715,1373,52.08%,41.08%,1
基隆市,仁愛區,0072,568,144,712,106,818,1782,45.9%,31.87%,1
基隆市,仁愛區,0073,397,133,530,64,594,1055,56.3%,37.63%,1
基隆市,仁愛區,0074,545,147,692,39,731,1558,46.92%,34.98%,1
基隆市,仁愛區,0075,654,191,845,48,893,1736,51.44%,37.67%,1
基隆市,仁愛區,0076,504,177,681,52,733,1243,58.97%,40.55%,1
基隆市,仁愛區,0077,438,137,575,45,620,1109,55.91%,39.5%,1
基隆市,仁愛區,0078,763,161,924,39,963,1684,57.19%,45.31%,1
基隆市,仁愛區,0079,339,111,450,40,490,919,53.32%,36.89%,1
基隆市,仁愛區,0080,347,116,463,25,488,991,49.24%,35.02%,1
基隆市,仁愛區,0081,346,96,442,19,461,876,52.63%,39.5%,1
基隆市,仁愛區,0082,423,131,554,52,606,1046,57.93%,40.44%,1
基隆市,仁愛區,0083,189,51,240,23,263,434,60.6%,43.55%,1
基隆市,仁愛區,0084,300,91,391,58,449,764,58.77%,39.27%,1
基隆市,仁愛區,0085,337,126,463,28,491,968,50.72%,34.81%,1
基隆市,仁愛區,0086,439,165,604,72,676,1326,50.98%,33.11%,1
基隆市,仁愛區,0087,383,126,509,35,544,1315,41.37%,29.13%,1
基隆市,仁愛區,0088,292,104,396,51,447,775,57.68%,37.68%,1
基隆市,仁愛區,0089,234,84,318,55,373,652,57.21%,35.89%,1
基隆市,仁愛區,0090,270,71,341,36,377,674,55.93%,40.06%,1
基隆市,仁愛區,0091,288,82,370,41,411,789,52.09%,36.5%,1
基隆市,仁愛區,0092,630,195,825,76,901,1715,52.54%,36.73%,1
基隆市,仁愛區,0093,295,109,404,48,452,849,53.24%,34.75%,1
基隆市,仁愛區,0094,342,85,427,38,465,875,53.14%,39.09%,1
基隆市,仁愛區,0095,292,99,391,42,433,851,50.88%,34.31%,1
基隆市,仁愛區,0096,308,90,398,28,426,735,57.96%,41.9%,1
基隆市,仁愛區,0097,337,124,461,73,534,1009,52.92%,33.4%,1
基隆市,仁愛區,0098,338,139,477,51,528,1082,48.8%,31.24%,1
基隆市,仁愛區,0099,433,147,580,80,660,1278,51.64%,33.88%,1
基隆市,仁愛區,0100,667,147,814,50,864,1519,56.88%,43.91%,1
基隆市,仁愛區,0101,419,128,547,47,594,1336,44.46%,31.36%,1
基隆市,仁愛區,0102,481,158,639,61,700,1178,59.42%,40.83%,1
基隆市,仁愛區,0103,268,68,336,42,378,708,53.39%,37.85%,1
基隆市,仁愛區,0104,231,93,324,30,354,567,62.43%,40.74%,1
基隆市,仁愛區,0105,240,111,351,59,410,751,54.59%,31.96%,1
基隆市,仁愛區,0106,236,88,324,29,353,589,59.93%,40.07%,1
基隆市,中山區,0107,279,107,386,20,406,796,51.01%,35.05%,1
基隆市,中山區,0108,461,127,588,49,637,1036,61.49%,44.5%,1
基隆市,中山區,0109,274,115,389,43,432,756,57.14%,36.24%,1
基隆市,中山區,0110,281,101,382,21,403,957,42.11%,29.36%,1
基隆市,中山區,0111,299,94,393,11,404,802,50.37%,37.28%,1
基隆市,中山區,0112,488,122,610,52,662,1263,52.41%,38.64%,1
基隆市,中山區,0113,324,98,422,20,442,778,56.81%,41.65%,1
基隆市,中山區,0114,423,150,573,87,660,1180,55.93%,35.85%,1
基隆市,中山區,0115,341,85,426,34,460,990,46.46%,34.44%,1
基隆市,中山區,0116,386,129,515,32,547,1332,41.07%,28.98%,1
基隆市,中山區,0117,274,89,363,29,392,848,46.23%,32.31%,1
基隆市,中山區,0118,312,92,404,22,426,922,46.2%,33.84%,1
基隆市,中山區,0119,180,72,252,19,271,459,59.04%,39.22%,1
基隆市,中山區,0120,194,57,251,28,279,574,48.61%,33.8%,1
基隆市,中山區,0121,312,92,404,50,454,877,51.77%,35.58%,1
基隆市,中山區,0122,480,188,668,39,707,1584,44.63%,30.3%,1
基隆市,中山區,0123,340,109,449,36,485,1319,36.77%,25.78%,1
基隆市,中山區,0124,676,230,906,76,982,1938,50.67%,34.88%,1
基隆市,中山區,0125,639,210,849,53,902,1877,48.06%,34.04%,1
基隆市,中山區,0126,814,144,958,33,991,2088,47.46%,38.98%,1
基隆市,中山區,0127,861,114,975,43,1018,1946,52.31%,44.24%,1
基隆市,中山區,0128,532,172,704,60,764,1353,56.47%,39.32%,1
基隆市,中山區,0129,471,148,619,153,772,1317,58.62%,35.76%,1
基隆市,中山區,0130,315,146,461,35,496,870,57.01%,36.21%,1
基隆市,中山區,0131,565,122,687,35,722,1322,54.61%,42.74%,1
基隆市,中山區,0132,445,130,575,17,592,1295,45.71%,34.36%,1
基隆市,中山區,0133,323,106,429,30,459,756,60.71%,42.72%,1
基隆市,中山區,0134,515,167,682,26,708,1602,44.19%,32.15%,1
基隆市,中山區,0135,538,162,700,46,746,1568,47.58%,34.31%,1
基隆市,中山區,0136,502,192,694,43,737,1404,52.49%,35.75%,1
基隆市,中山區,0137,650,184,834,25,859,1909,45%,34.05%,1
基隆市,中山區,0138,490,181,671,80,751,1642,45.74%,29.84%,1
基隆市,中山區,0139,319,90,409,21,430,932,46.14%,34.23%,1
基隆市,中山區,0140,341,123,464,49,513,849,60.42%,40.16%,1
基隆市,中山區,0141,280,102,382,46,428,715,59.86%,39.16%,1
基隆市,安樂區,0142,447,142,589,67,656,1361,48.2%,32.84%,1
基隆市,安樂區,0143,419,117,536,43,579,1213,47.73%,34.54%,1
基隆市,安樂區,0144,306,101,407,44,451,1026,43.96%,29.82%,1
基隆市,安樂區,0145,424,113,537,89,626,1038,60.31%,40.85%,1
基隆市,安樂區,0146,338,141,479,64,543,897,60.54%,37.68%,1
基隆市,安樂區,0147,514,158,672,63,735,1401,52.46%,36.69%,1
基隆市,安樂區,0148,162,42,204,11,215,641,33.54%,25.27%,1
基隆市,安樂區,0149,603,84,687,58,745,1472,50.61%,40.96%,1
基隆市,安樂區,0150,183,50,233,22,255,472,54.03%,38.77%,1
基隆市,安樂區,0151,354,108,462,28,490,841,58.26%,42.09%,1
基隆市,安樂區,0152,204,69,273,30,303,571,53.06%,35.73%,1
基隆市,安樂區,0153,712,121,833,45,878,1901,46.19%,37.45%,1
基隆市,安樂區,0154,462,184,646,49,695,1349,51.52%,34.25%,1
基隆市,安樂區,0155,433,147,580,42,622,1225,50.78%,35.35%,1
基隆市,安樂區,0156,530,166,696,47,743,1351,55%,39.23%,1
基隆市,安樂區,0157,679,179,858,46,904,1601,56.46%,42.41%,1
基隆市,安樂區,0158,1067,211,1278,50,1328,2513,52.85%,42.46%,1
基隆市,安樂區,0159,658,166,824,48,872,1613,54.06%,40.79%,1
基隆市,安樂區,0160,723,179,902,34,936,1731,54.07%,41.77%,1
基隆市,安樂區,0161,617,194,811,27,838,1424,58.85%,43.33%,1
基隆市,安樂區,0162,668,174,842,60,902,1806,49.94%,36.99%,1
基隆市,安樂區,0163,685,196,881,59,940,1679,55.99%,40.8%,1
基隆市,安樂區,0164,718,224,942,40,982,1902,51.63%,37.75%,1
基隆市,安樂區,0165,808,178,986,12,998,2040,48.92%,39.61%,1
基隆市,安樂區,0166,501,154,655,54,709,1313,54%,38.16%,1
基隆市,安樂區,0167,433,149,582,20,602,1243,48.43%,34.84%,1
基隆市,安樂區,0168,677,176,853,34,887,1759,50.43%,38.49%,1
基隆市,安樂區,0169,320,99,419,18,437,694,62.97%,46.11%,1
基隆市,安樂區,0170,397,123,520,29,549,866,63.39%,45.84%,1
基隆市,安樂區,0171,486,145,631,27,658,1557,42.26%,31.21%,1
基隆市,安樂區,0172,525,158,683,26,709,1411,50.25%,37.21%,1
基隆市,安樂區,0173,687,174,861,28,889,1568,56.7%,43.81%,1
基隆市,安樂區,0174,532,151,683,42,725,1400,51.79%,38%,1
基隆市,安樂區,0175,640,124,764,8,772,1531,50.42%,41.8%,1
基隆市,安樂區,0176,619,144,763,29,792,1673,47.34%,37%,1
基隆市,安樂區,0177,391,118,509,49,558,1054,52.94%,37.1%,1
基隆市,安樂區,0178,619,155,774,33,807,1923,41.97%,32.19%,1
基隆市,安樂區,0179,765,224,989,57,1046,1960,53.37%,39.03%,1
基隆市,安樂區,0180,706,215,921,61,982,1962,50.05%,35.98%,1
基隆市,安樂區,0181,808,228,1036,59,1095,2117,51.72%,38.17%,1
基隆市,安樂區,0182,652,187,839,43,882,1829,48.22%,35.65%,1
基隆市,安樂區,0183,576,127,703,33,736,1529,48.14%,37.67%,1
基隆市,安樂區,0184,736,188,924,40,964,1869,51.58%,39.38%,1
基隆市,安樂區,0185,497,107,604,17,621,1140,54.47%,43.6%,1
基隆市,安樂區,0186,603,200,803,44,847,1641,51.61%,36.75%,1
基隆市,安樂區,0187,472,150,622,39,661,1279,51.68%,36.9%,1
基隆市,安樂區,0188,531,135,666,28,694,1360,51.03%,39.04%,1
基隆市,安樂區,0189,551,164,715,45,760,1399,54.32%,39.39%,1
基隆市,安樂區,0190,457,141,598,29,627,1251,50.12%,36.53%,1
基隆市,信義區,0036,423,122,545,42,587,1096,53.56%,38.59%,1
基隆市,信義區,0037,525,142,667,47,714,1232,57.95%,42.61%,1
基隆市,信義區,0038,483,135,618,19,637,1184,53.8%,40.79%,1
基隆市,信義區,0039,494,108,602,62,664,1133,58.61%,43.6%,1
基隆市,信義區,0040,473,140,613,45,658,1188,55.39%,39.81%,1
基隆市,信義區,0041,287,98,385,37,422,725,58.21%,39.59%,1
基隆市,信義區,0042,511,157,668,52,720,1524,47.24%,33.53%,1
基隆市,信義區,0043,285,85,370,31,401,736,54.48%,38.72%,1
基隆市,信義區,0044,215,70,285,23,308,611,50.41%,35.19%,1
基隆市,信義區,0045,323,85,408,20,428,951,45.01%,33.96%,1
基隆市,信義區,0046,621,170,791,41,832,1616,51.49%,38.43%,1
基隆市,信義區,0047,621,152,773,42,815,1516,53.76%,40.96%,1
基隆市,信義區,0048,301,107,408,29,437,1049,41.66%,28.69%,1
基隆市,信義區,0049,403,118,521,30,551,1069,51.54%,37.7%,1
基隆市,信義區,0050,306,79,385,35,420,727,57.77%,42.09%,1
基隆市,信義區,0051,425,96,521,22,543,929,58.45%,45.75%,1
基隆市,信義區,0052,510,143,653,37,690,1118,61.72%,45.62%,1
基隆市,信義區,0053,569,133,702,49,751,1339,56.09%,42.49%,1
基隆市,信義區,0054,394,87,481,25,506,999,50.65%,39.44%,1
基隆市,信義區,0055,291,71,362,16,378,764,49.48%,38.09%,1
基隆市,信義區,0056,565,146,711,36,747,1555,48.04%,36.33%,1
基隆市,信義區,0057,768,65,833,37,870,2015,43.18%,38.11%,1
基隆市,信義區,0058,538,133,671,47,718,1268,56.62%,42.43%,1
基隆市,信義區,0059,610,162,772,54,826,1569,52.64%,38.88%,1
基隆市,信義區,0060,722,164,886,67,953,1985,48.01%,36.37%,1
基隆市,信義區,0061,640,129,769,31,800,1476,54.2%,43.36%,1
基隆市,信義區,0062,651,151,802,34,836,1493,55.99%,43.6%,1
基隆市,信義區,0063,599,127,726,25,751,1249,60.13%,47.96%,1
基隆市,信義區,0064,627,136,763,25,788,1559,50.55%,40.22%,1
基隆市,信義區,0065,452,87,539,16,555,1168,47.52%,38.7%,1
基隆市,信義區,0066,655,133,788,36,824,1602,51.44%,40.89%,1
基隆市,信義區,0067,516,128,644,39,683,1485,45.99%,34.75%,1
基隆市,信義區,0068,398,81,479,26,505,1009,50.05%,39.44%,1
基隆市,信義區,0069,669,146,815,41,856,2016,42.46%,33.18%,1
基隆市,信義區,0070,577,110,687,39,726,1764,41.16%,32.71%,1
基隆市,信義區,0071,511,136,647,45,692,1295,53.44%,39.46%,1
新竹市,東區,0001,362,128,490,21,511,1512,33.8%,23.94%,1
新竹市,東區,0002,446,111,557,25,582,953,61.07%,46.8%,1
新竹市,東區,0003,308,83,391,29,420,729,57.61%,42.25%,1
新竹市,東區,0004,225,100,325,27,352,566,62.19%,39.75%,1
新竹市,東區,0005,239,99,338,26,364,640,56.88%,37.34%,1
新竹市,東區,0006,96,50,146,24,170,305,55.74%,31.48%,1
新竹市,東區,0007,229,84,313,24,337,563,59.86%,40.67%,1
新竹市,東區,0008,290,95,385,19,404,741,54.52%,39.14%,1
新竹市,東區,0009,439,138,577,23,600,1041,57.64%,42.17%,1
新竹市,東區,0010,658,175,833,37,870,1615,53.87%,40.74%,1
新竹市,東區,0011,546,147,693,44,737,1287,57.26%,42.42%,1
新竹市,東區,0012,640,212,852,23,875,1554,56.31%,41.18%,1
新竹市,東區,0013,605,177,782,19,801,1388,57.71%,43.59%,1
新竹市,東區,0014,591,201,792,38,830,1419,58.49%,41.65%,1
新竹市,東區,0015,517,172,689,64,753,1355,55.57%,38.15%,1
新竹市,東區,0016,591,191,782,38,820,1490,55.03%,39.66%,1
新竹市,東區,0017,683,186,869,28,897,1615,55.54%,42.29%,1
新竹市,東區,0018,638,208,846,48,894,1672,53.47%,38.16%,1
新竹市,東區,0019,454,126,580,31,611,1062,57.53%,42.75%,1
新竹市,東區,0020,545,162,707,44,751,1315,57.11%,41.44%,1
新竹市,東區,0021,414,133,547,47,594,1000,59.4%,41.4%,1
新竹市,東區,0022,560,189,749,42,791,1337,59.16%,41.88%,1
新竹市,東區,0023,718,197,915,36,951,1747,54.44%,41.1%,1
新竹市,東區,0024,679,239,918,39,957,1600,59.81%,42.44%,1
新竹市,東區,0025,479,145,624,33,657,1158,56.74%,41.36%,1
新竹市,東區,0026,368,140,508,33,541,828,65.34%,44.44%,1
新竹市,東區,0027,633,184,817,53,870,1573,55.31%,40.24%,1
新竹市,東區,0028,641,192,833,53,886,1550,57.16%,41.35%,1
新竹市,東區,0029,499,192,691,30,721,1317,54.75%,37.89%,1
新竹市,東區,0030,424,174,598,44,642,1040,61.73%,40.77%,1
新竹市,東區,0031,417,100,517,23,540,935,57.75%,44.6%,1
新竹市,東區,0032,444,126,570,23,593,1074,55.21%,41.34%,1
新竹市,東區,0033,500,144,644,44,688,1133,60.72%,44.13%,1
新竹市,東區,0034,551,153,704,52,756,1262,59.9%,43.66%,1
新竹市,東區,0035,506,148,654,25,679,1199,56.63%,42.2%,1
新竹市,東區,0036,553,165,718,32,750,1226,61.17%,45.11%,1
新竹市,東區,0037,629,192,821,54,875,1377,63.54%,45.68%,1
新竹市,東區,0038,454,146,600,29,629,991,63.47%,45.81%,1
新竹市,東區,0039,489,193,682,79,761,1271,59.87%,38.47%,1
新竹市,東區,0040,502,122,624,26,650,1012,64.23%,49.6%,1
新竹市,東區,0041,405,124,529,59,588,1001,58.74%,40.46%,1
新竹市,東區,0042,604,194,798,56,854,1603,53.28%,37.68%,1
新竹市,東區,0043,460,183,643,41,684,1236,55.34%,37.22%,1
新竹市,東區,0044,525,152,677,49,726,1532,47.39%,34.27%,1
新竹市,東區,0045,513,157,670,46,716,1306,54.82%,39.28%,1
新竹市,東區,0046,424,137,561,69,630,1073,58.71%,39.52%,1
新竹市,東區,0047,360,135,495,18,513,952,53.89%,37.82%,1
新竹市,東區,0048,428,136,564,36,600,1298,46.22%,32.97%,1
新竹市,東區,0049,322,75,397,15,412,778,52.96%,41.39%,1
新竹市,東區,0050,478,189,667,38,705,1195,59%,40%,1
新竹市,東區,0051,584,215,799,67,866,1569,55.19%,37.22%,1
新竹市,東區,0052,726,191,917,41,958,1533,62.49%,47.36%,1
新竹市,東區,0053,629,132,761,51,812,1336,60.78%,47.08%,1
新竹市,東區,0054,652,102,754,52,806,1367,58.96%,47.7%,1
新竹市,東區,0055,609,142,751,36,787,1289,61.06%,47.25%,1
新竹市,東區,0056,385,115,500,26,526,960,54.79%,40.1%,1
新竹市,東區,0057,395,112,507,27,534,843,63.35%,46.86%,1
新竹市,東區,0058,445,97,542,48,590,948,62.24%,46.94%,1
新竹市,東區,0059,393,87,480,36,516,915,56.39%,42.95%,1
新竹市,東區,0060,833,155,988,45,1033,1801,57.36%,46.25%,1
新竹市,東區,0061,439,121,560,37,597,1079,55.33%,40.69%,1
新竹市,東區,0062,337,62,399,14,413,676,61.09%,49.85%,1
新竹市,東區,0063,475,145,620,54,674,1132,59.54%,41.96%,1
新竹市,東區,0064,93,44,137,13,150,251,59.76%,37.05%,1
新竹市,東區,0065,655,210,865,59,924,1620,57.04%,40.43%,1
新竹市,東區,0066,576,184,760,40,800,1479,54.09%,38.95%,1
新竹市,東區,0067,528,194,722,32,754,1402,53.78%,37.66%,1
新竹市,東區,0068,513,169,682,51,733,1280,57.27%,40.08%,1
新竹市,東區,0069,530,172,702,23,725,1228,59.04%,43.16%,1
新竹市,東區,0070,456,155,611,7,618,1157,53.41%,39.41%,1
新竹市,東區,0071,562,178,740,29,769,1354,56.79%,41.51%,1
新竹市,東區,0072,615,210,825,43,868,1334,65.07%,46.1%,1
新竹市,東區,0073,561,128,689,34,723,1234,58.59%,45.46%,1
新竹市,東區,0074,673,167,840,42,882,1398,63.09%,48.14%,1
新竹市,東區,0075,383,156,539,29,568,928,61.21%,41.27%,1
新竹市,東區,0076,647,161,808,32,840,1368,61.4%,47.3%,1
新竹市,東區,0077,465,134,599,27,626,1215,51.52%,38.27%,1
新竹市,東區,0078,364,129,493,39,532,1067,49.86%,34.11%,1
新竹市,東區,0079,449,181,630,21,651,1194,54.52%,37.6%,1
新竹市,東區,0080,446,167,613,28,641,1193,53.73%,37.38%,1
新竹市,東區,0081,564,169,733,72,805,1388,58%,40.63%,1
新竹市,東區,0082,543,158,701,32,733,1267,57.85%,42.86%,1
新竹市,東區,0083,569,129,698,27,725,1299,55.81%,43.8%,1
新竹市,東區,0084,504,191,695,44,739,1288,57.38%,39.13%,1
新竹市,東區,0085,526,192,718,26,744,1228,60.59%,42.83%,1
新竹市,東區,0086,503,166,669,17,686,1135,60.44%,44.32%,1
新竹市,東區,0087,564,199,763,25,788,1237,63.7%,45.59%,1
新竹市,東區,0088,437,126,563,46,609,1135,53.66%,38.5%,1
新竹市,東區,0089,458,108,566,20,586,1165,50.3%,39.31%,1
新竹市,東區,0090,450,139,589,27,616,1124,54.8%,40.04%,1
新竹市,東區,0091,508,165,673,42,715,1210,59.09%,41.98%,1
新竹市,東區,0092,522,146,668,46,714,1323,53.97%,39.46%,1
新竹市,東區,0093,494,116,610,17,627,1207,51.95%,40.93%,1
新竹市,東區,0094,452,123,575,39,614,1264,48.58%,35.76%,1
新竹市,東區,0095,503,152,655,26,681,1248,54.57%,40.3%,1
新竹市,東區,0096,645,170,815,35,850,1400,60.71%,46.07%,1
新竹市,東區,0097,630,207,837,28,865,1473,58.72%,42.77%,1
新竹市,東區,0098,577,144,721,50,771,1367,56.4%,42.21%,1
新竹市,東區,0099,521,152,673,25,698,1233,56.61%,42.25%,1
新竹市,東區,0100,180,69,249,20,269,507,53.06%,35.5%,1
新竹市,東區,0101,289,95,384,36,420,714,58.82%,40.48%,1
新竹市,東區,0102,334,139,473,53,526,875,60.11%,38.17%,1
新竹市,東區,0103,558,181,739,53,792,1396,56.73%,39.97%,1
新竹市,東區,0104,457,149,606,43,649,1232,52.68%,37.09%,1
新竹市,東區,0105,480,186,666,47,713,1323,53.89%,36.28%,1
新竹市,東區,0106,511,158,669,25,694,1516,45.78%,33.71%,1
新竹市,東區,0107,561,141,702,43,745,1453,51.27%,38.61%,1
新竹市,東區,0108,325,146,471,46,517,880,58.75%,36.93%,1
新竹市,東區,0109,416,115,531,26,557,1058,52.65%,39.32%,1
新竹市,東區,0110,408,152,560,37,597,1061,56.27%,38.45%,1
新竹市,東區,0111,264,97,361,40,401,710,56.48%,37.18%,1
新竹市,東區,0112,293,109,402,51,453,752,60.24%,38.96%,1
新竹市,東區,0113,219,61,280,20,300,475,63.16%,46.11%,1
新竹市,東區,0114,335,114,449,35,484,880,55%,38.07%,1
新竹市,東區,0115,398,137,535,38,573,989,57.94%,40.24%,1
新竹市,東區,0116,427,142,569,42,611,1059,57.7%,40.32%,1
新竹市,東區,0117,223,104,327,43,370,607,60.96%,36.74%,1
新竹市,東區,0118,317,126,443,32,475,815,58.28%,38.9%,1
新竹市,東區,0119,348,92,440,40,480,777,61.78%,44.79%,1
新竹市,東區,0120,479,161,640,35,675,1399,48.25%,34.24%,1
新竹市,東區,0121,467,171,638,40,678,1216,55.76%,38.4%,1
新竹市,東區,0122,372,136,508,42,550,1062,51.79%,35.03%,1
新竹市,東區,0123,430,132,562,30,592,1046,56.6%,41.11%,1
新竹市,東區,0124,516,144,660,21,681,1332,51.13%,38.74%,1
新竹市,東區,0125,539,188,727,50,777,1350,57.56%,39.93%,1
新竹市,東區,0126,554,148,702,21,723,1438,50.28%,38.53%,1
新竹市,東區,0127,504,159,663,55,718,1414,50.78%,35.64%,1
新竹市,東區,0128,604,199,803,31,834,1476,56.5%,40.92%,1
新竹市,東區,0129,585,180,765,47,812,1326,61.24%,44.12%,1
新竹市,東區,0130,435,117,552,22,574,927,61.92%,46.93%,1
新竹市,東區,0131,479,201,680,28,708,1273,55.62%,37.63%,1
新竹市,東區,0132,498,152,650,37,687,1315,52.24%,37.87%,1
新竹市,東區,0133,580,172,752,37,789,1413,55.84%,41.05%,1
新竹市,東區,0134,450,128,578,25,603,1064,56.67%,42.29%,1
新竹市,東區,0135,566,192,758,24,782,1244,62.86%,45.5%,1
新竹市,東區,0136,438,138,576,6,582,1160,50.17%,37.76%,1
新竹市,東區,0137,509,150,659,24,683,1398,48.86%,36.41%,1
新竹市,東區,0138,428,120,548,21,569,1384,41.11%,30.92%,1
新竹市,東區,0139,386,115,501,32,533,874,60.98%,44.16%,1
新竹市,北區,0140,152,70,222,11,233,477,48.85%,31.87%,1
新竹市,北區,0141,205,89,294,27,321,535,60%,38.32%,1
新竹市,北區,0142,249,137,386,58,444,746,59.52%,33.38%,1
新竹市,北區,0143,192,62,254,21,275,546,50.37%,35.16%,1
新竹市,北區,0144,308,98,406,35,441,711,62.03%,43.32%,1
新竹市,北區,0145,394,128,522,42,564,1143,49.34%,34.47%,1
新竹市,北區,0146,502,169,671,40,711,1370,51.9%,36.64%,1
新竹市,北區,0147,526,190,716,37,753,1390,54.17%,37.84%,1
新竹市,北區,0148,385,120,505,8,513,962,53.33%,40.02%,1
新竹市,北區,0149,471,163,634,27,661,1237,53.44%,38.08%,1
新竹市,北區,0150,565,177,742,50,792,1604,49.38%,35.22%,1
新竹市,北區,0151,270,75,345,16,361,758,47.63%,35.62%,1
新竹市,北區,0152,505,127,632,30,662,1320,50.15%,38.26%,1
新竹市,北區,0153,533,162,695,60,755,1519,49.7%,35.09%,1
新竹市,北區,0154,86,36,122,10,132,347,38.04%,24.78%,1
新竹市,北區,0155,513,150,663,49,712,1212,58.75%,42.33%,1
新竹市,北區,0156,555,170,725,44,769,1484,51.82%,37.4%,1
新竹市,北區,0157,501,197,698,72,770,1428,53.92%,35.08%,1
新竹市,北區,0158,454,147,601,26,627,1128,55.59%,40.25%,1
新竹市,北區,0159,248,76,324,17,341,638,53.45%,38.87%,1
新竹市,北區,0160,573,91,664,44,708,1222,57.94%,46.89%,1
新竹市,北區,0161,438,119,557,24,581,1076,54%,40.71%,1
新竹市,北區,0162,436,133,569,29,598,937,63.82%,46.53%,1
新竹市,北區,0163,541,152,693,50,743,1394,53.3%,38.81%,1
新竹市,北區,0164,536,185,721,42,763,1568,48.66%,34.18%,1
新竹市,北區,0165,474,176,650,55,705,1159,60.83%,40.9%,1
新竹市,北區,0166,85,17,102,3,105,252,41.67%,33.73%,1
新竹市,北區,0167,331,104,435,30,465,761,61.1%,43.5%,1
新竹市,北區,0168,316,118,434,35,469,788,59.52%,40.1%,1
新竹市,北區,0169,232,83,315,44,359,561,63.99%,41.35%,1
新竹市,北區,0170,561,167,728,94,822,1558,52.76%,36.01%,1
新竹市,北區,0171,465,164,629,41,670,1398,47.93%,33.26%,1
新竹市,北區,0172,380,116,496,37,533,957,55.69%,39.71%,1
新竹市,北區,0173,503,129,632,49,681,1195,56.99%,42.09%,1
新竹市,北區,0174,416,147,563,45,608,1236,49.19%,33.66%,1
新竹市,北區,0175,438,167,605,54,659,1255,52.51%,34.9%,1
新竹市,北區,0176,451,144,595,27,622,1114,55.83%,40.48%,1
新竹市,北區,0177,541,180,721,32,753,1396,53.94%,38.75%,1
新竹市,北區,0178,556,216,772,62,834,1456,57.28%,38.19%,1
新竹市,北區,0179,541,165,706,34,740,1374,53.86%,39.37%,1
新竹市,北區,0180,413,111,524,48,572,1070,53.46%,38.6%,1
新竹市,北區,0181,431,141,572,67,639,1142,55.95%,37.74%,1
新竹市,北區,0182,417,117,534,21,555,1103,50.32%,37.81%,1
新竹市,北區,0183,428,173,601,76,677,1190,56.89%,35.97%,1
新竹市,北區,0184,527,116,643,28,671,1089,61.62%,48.39%,1
新竹市,北區,0185,437,123,560,18,578,1272,45.44%,34.36%,1
新竹市,北區,0186,516,177,693,60,753,1306,57.66%,39.51%,1
新竹市,北區,0187,539,155,694,48,742,1328,55.87%,40.59%,1
新竹市,北區,0188,564,144,708,44,752,1457,51.61%,38.71%,1
新竹市,北區,0189,558,211,769,58,827,1492,55.43%,37.4%,1
新竹市,北區,0190,491,154,645,55,700,1160,60.34%,42.33%,1
新竹市,北區,0191,388,134,522,49,571,971,58.81%,39.96%,1
新竹市,北區,0192,307,108,415,21,436,1401,31.12%,21.91%,1
新竹市,北區,0193,545,179,724,40,764,1340,57.01%,40.67%,1
新竹市,北區,0194,586,163,749,45,794,1371,57.91%,42.74%,1
新竹市,北區,0195,474,96,570,25,595,1267,46.96%,37.41%,1
新竹市,北區,0196,463,159,622,41,663,1073,61.79%,43.15%,1
新竹市,北區,0197,483,159,642,36,678,1159,58.5%,41.67%,1
新竹市,北區,0198,518,147,665,23,688,1294,53.17%,40.03%,1
新竹市,北區,0199,581,168,749,47,796,1442,55.2%,40.29%,1
新竹市,北區,0200,513,183,696,29,725,1270,57.09%,40.39%,1
新竹市,北區,0201,533,180,713,37,750,1179,63.61%,45.21%,1
新竹市,北區,0202,440,118,558,36,594,949,62.59%,46.36%,1
新竹市,北區,0203,470,166,636,40,676,1163,58.13%,40.41%,1
新竹市,北區,0204,520,174,694,22,716,1334,53.67%,38.98%,1
新竹市,北區,0205,565,178,743,45,788,1415,55.69%,39.93%,1
新竹市,北區,0206,564,184,748,40,788,1305,60.38%,43.22%,1
新竹市,北區,0207,533,113,646,36,682,1200,56.83%,44.42%,1
新竹市,北區,0208,454,136,590,24,614,1106,55.52%,41.05%,1
新竹市,北區,0209,463,80,543,31,574,1044,54.98%,44.35%,1
新竹市,北區,0210,426,163,589,38,627,1061,59.1%,40.15%,1
新竹市,北區,0211,627,195,822,71,893,1518,58.83%,41.3%,1
新竹市,北區,0212,524,179,703,53,756,1220,61.97%,42.95%,1
新竹市,北區,0213,633,190,823,14,837,1475,56.75%,42.92%,1
新竹市,北區,0214,513,175,688,55,743,1373,54.12%,37.36%,1
新竹市,北區,0215,601,187,788,29,817,1450,56.34%,41.45%,1
新竹市,北區,0216,642,144,786,40,826,1423,58.05%,45.12%,1
新竹市,北區,0217,474,101,575,21,596,1059,56.28%,44.76%,1
新竹市,北區,0218,544,103,647,38,685,1130,60.62%,48.14%,1
新竹市,北區,0219,589,126,715,32,747,1208,61.84%,48.76%,1
新竹市,北區,0220,625,109,734,26,760,1226,61.99%,50.98%,1
新竹市,北區,0221,452,181,633,30,663,1175,56.43%,38.47%,1
新竹市,北區,0222,571,157,728,27,755,1371,55.07%,41.65%,1
新竹市,北區,0223,507,158,665,51,716,1306,54.82%,38.82%,1
新竹市,北區,0224,500,165,665,32,697,1340,52.01%,37.31%,1
新竹市,北區,0225,461,152,613,67,680,1111,61.21%,41.49%,1
新竹市,北區,0226,551,148,699,54,753,1197,62.91%,46.03%,1
新竹市,北區,0227,429,104,533,41,574,1008,56.94%,42.56%,1
新竹市,北區,0228,361,115,476,23,499,946,52.75%,38.16%,1
新竹市,北區,0229,284,97,381,42,423,705,60%,40.28%,1
新竹市,北區,0230,317,129,446,60,506,848,59.67%,37.38%,1
新竹市,北區,0231,506,151,657,28,685,1295,52.9%,39.07%,1
新竹市,北區,0232,543,153,696,43,739,1467,50.37%,37.01%,1
新竹市,北區,0233,535,157,692,46,738,1659,44.48%,32.25%,1
新竹市,北區,0234,486,147,633,52,685,1297,52.81%,37.47%,1
新竹市,北區,0235,540,174,714,75,789,1374,57.42%,39.3%,1
新竹市,北區,0236,577,170,747,76,823,1457,56.49%,39.6%,1
新竹市,北區,0237,469,128,597,36,633,1072,59.05%,43.75%,1
新竹市,北區,0238,499,167,666,53,719,1350,53.26%,36.96%,1
新竹市,北區,0239,421,138,559,42,601,971,61.89%,43.36%,1
新竹市,北區,0240,600,175,775,73,848,1450,58.48%,41.38%,1
新竹市,北區,0241,365,107,472,34,506,895,56.54%,40.78%,1
新竹市,北區,0242,577,143,720,36,756,1378,54.86%,41.87%,1
新竹市,北區,0243,548,200,748,87,835,1609,51.9%,34.06%,1
新竹市,北區,0244,222,84,306,40,346,594,58.25%,37.37%,1
新竹市,香山區,0245,561,163,724,54,778,1443,53.92%,38.88%,1
新竹市,香山區,0246,489,149,638,47,685,1241,55.2%,39.4%,1
新竹市,香山區,0247,481,130,611,29,640,1194,53.6%,40.28%,1
新竹市,香山區,0248,460,120,580,15,595,1081,55.04%,42.55%,1
新竹市,香山區,0249,333,94,427,27,454,807,56.26%,41.26%,1
新竹市,香山區,0250,701,197,898,55,953,1760,54.15%,39.83%,1
新竹市,香山區,0251,700,175,875,40,915,1635,55.96%,42.81%,1
新竹市,香山區,0252,695,100,795,56,851,1473,57.77%,47.18%,1
新竹市,香山區,0253,620,154,774,23,797,1408,56.61%,44.03%,1
新竹市,香山區,0254,463,131,594,22,616,1318,46.74%,35.13%,1
新竹市,香山區,0255,604,150,754,50,804,1337,60.13%,45.18%,1
新竹市,香山區,0256,731,183,914,39,953,1862,51.18%,39.26%,1
新竹市,香山區,0257,439,125,564,22,586,1067,54.92%,41.14%,1
新竹市,香山區,0258,385,107,492,36,528,863,61.18%,44.61%,1
新竹市,香山區,0259,495,175,670,66,736,1198,61.44%,41.32%,1
新竹市,香山區,0260,450,174,624,63,687,1138,60.37%,39.54%,1
新竹市,香山區,0261,405,146,551,66,617,957,64.47%,42.32%,1
新竹市,香山區,0262,544,170,714,85,799,1348,59.27%,40.36%,1
新竹市,香山區,0263,487,140,627,59,686,1023,67.06%,47.61%,1
新竹市,香山區,0264,412,104,516,28,544,970,56.08%,42.47%,1
新竹市,香山區,0265,516,176,692,53,745,1318,56.53%,39.15%,1
新竹市,香山區,0266,410,147,557,49,606,1088,55.7%,37.68%,1
新竹市,香山區,0267,316,91,407,22,429,903,47.51%,34.99%,1
新竹市,香山區,0268,385,158,543,44,587,1012,58%,38.04%,1
新竹市,香山區,0269,408,128,536,33,569,1014,56.11%,40.24%,1
新竹市,香山區,0270,522,151,673,24,697,1238,56.3%,42.16%,1
新竹市,香山區,0271,472,123,595,60,655,1182,55.41%,39.93%,1
新竹市,香山區,0272,575,196,771,78,849,1331,63.79%,43.2%,1
新竹市,香山區,0273,475,117,592,25,617,976,63.22%,48.67%,1
新竹市,香山區,0274,330,92,422,22,444,834,53.24%,39.57%,1
新竹市,香山區,0275,388,97,485,44,529,919,57.56%,42.22%,1
新竹市,香山區,0276,510,154,664,36,700,1188,58.92%,42.93%,1
新竹市,香山區,0277,439,135,574,51,625,1086,57.55%,40.42%,1
新竹市,香山區,0278,501,166,667,49,716,1144,62.59%,43.79%,1
新竹市,香山區,0279,496,119,615,41,656,1112,58.99%,44.6%,1
新竹市,香山區,0280,636,171,807,44,851,1476,57.66%,43.09%,1
新竹市,香山區,0281,534,148,682,35,717,1291,55.54%,41.36%,1
新竹市,香山區,0282,751,103,854,50,904,1464,61.75%,51.3%,1
新竹市,香山區,0283,614,150,764,80,844,1427,59.15%,43.03%,1
新竹市,香山區,0284,525,183,708,33,741,1336,55.46%,39.3%,1
新竹市,香山區,0285,380,177,557,37,594,1131,52.52%,33.6%,1
新竹市,香山區,0286,448,132,580,69,649,1070,60.65%,41.87%,1
新竹市,香山區,0287,426,129,555,60,615,1006,61.13%,42.35%,1
新竹市,香山區,0288,422,98,520,41,561,1223,45.87%,34.51%,1
新竹市,香山區,0289,460,116,576,29,605,1119,54.07%,41.11%,1
新竹市,香山區,0290,491,158,649,34,683,1400,48.79%,35.07%,1
新竹市,香山區,0291,564,148,712,37,749,1627,46.04%,34.67%,1
新竹市,香山區,0292,457,145,602,42,644,1289,49.96%,35.45%,1
新竹市,香山區,0293,516,145,661,54,715,1409,50.75%,36.62%,1
新竹市,香山區,0294,278,118,396,19,415,814,50.98%,34.15%,1
新竹市,香山區,0295,279,83,362,36,398,719,55.35%,38.8%,1
新竹市,香山區,0296,356,120,476,24,500,1065,46.95%,33.43%,1
新竹市,香山區,0297,318,80,398,30,428,776,55.15%,40.98%,1
新竹市,香山區,0298,369,102,471,35,506,890,56.85%,41.46%,1
新竹市,香山區,0299,319,99,418,27,445,896,49.67%,35.6%,1
嘉義市,東區,0001,406,130,536,36,572,1025,55.8%,39.61%,1
嘉義市,東區,0002,487,147,634,28,662,1276,51.88%,38.17%,1
嘉義市,東區,0003,336,110,446,46,492,974,50.51%,34.5%,1
嘉義市,東區,0004,517,152,669,49,718,1175,61.11%,44%,1
嘉義市,東區,0005,307,89,396,35,431,702,61.4%,43.73%,1
嘉義市,東區,0006,437,118,555,21,576,1092,52.75%,40.02%,1
嘉義市,東區,0007,316,120,436,16,452,1023,44.18%,30.89%,1
嘉義市,東區,0008,662,195,857,75,932,1816,51.32%,36.45%,1
嘉義市,東區,0009,350,640,990,72,1062,1936,54.86%,18.08%,1
嘉義市,東區,0010,698,197,895,35,930,1698,54.77%,41.11%,1
嘉義市,東區,0011,499,158,657,33,690,1221,56.51%,40.87%,1
嘉義市,東區,0012,430,135,565,32,597,1113,53.64%,38.63%,1
嘉義市,東區,0013,561,214,775,44,819,1452,56.4%,38.64%,1
嘉義市,東區,0014,581,217,798,53,851,1395,61%,41.65%,1
嘉義市,東區,0015,477,168,645,54,699,1453,48.11%,32.83%,1
嘉義市,東區,0016,409,121,530,22,552,1094,50.46%,37.39%,1
嘉義市,東區,0017,574,167,741,43,784,1420,55.21%,40.42%,1
嘉義市,東區,0018,618,239,857,50,907,1552,58.44%,39.82%,1
嘉義市,東區,0019,595,223,818,69,887,1558,56.93%,38.19%,1
嘉義市,東區,0020,412,160,572,44,616,1062,58%,38.79%,1
嘉義市,東區,0021,444,151,595,58,653,1199,54.46%,37.03%,1
嘉義市,東區,0022,497,141,638,31,669,1236,54.13%,40.21%,1
嘉義市,東區,0023,325,114,439,26,465,890,52.25%,36.52%,1
嘉義市,東區,0024,363,127,490,44,534,880,60.68%,41.25%,1
嘉義市,東區,0025,441,161,602,24,626,1189,52.65%,37.09%,1
嘉義市,東區,0026,257,100,357,18,375,669,56.05%,38.42%,1
嘉義市,東區,0027,552,171,723,52,775,1435,54.01%,38.47%,1
嘉義市,東區,0028,579,195,774,42,816,1349,60.49%,42.92%,1
嘉義市,東區,0029,529,201,730,29,759,1455,52.16%,36.36%,1
嘉義市,東區,0030,361,124,485,40,525,915,57.38%,39.45%,1
嘉義市,東區,0031,313,164,477,32,509,952,53.47%,32.88%,1
嘉義市,東區,0032,346,131,477,49,526,941,55.9%,36.77%,1
嘉義市,東區,0033,361,158,519,29,548,1080,50.74%,33.43%,1
嘉義市,東區,0034,376,128,504,34,538,1157,46.5%,32.5%,1
嘉義市,東區,0035,395,175,570,30,600,1053,56.98%,37.51%,1
嘉義市,東區,0036,314,116,430,25,455,967,47.05%,32.47%,1
嘉義市,東區,0037,366,146,512,31,543,1091,49.77%,33.55%,1
嘉義市,東區,0038,369,133,502,63,565,961,58.79%,38.4%,1
嘉義市,東區,0039,232,91,323,31,354,863,41.02%,26.88%,1
嘉義市,東區,0040,437,123,560,52,612,1023,59.82%,42.72%,1
嘉義市,東區,0041,393,169,562,82,644,1078,59.74%,36.46%,1
嘉義市,東區,0042,348,116,464,17,481,938,51.28%,37.1%,1
嘉義市,東區,0043,398,126,524,39,563,1049,53.67%,37.94%,1
嘉義市,東區,0044,463,162,625,78,703,1360,51.69%,34.04%,1
嘉義市,東區,0045,461,209,670,111,781,1615,48.36%,28.54%,1
嘉義市,東區,0046,432,185,617,55,672,1267,53.04%,34.1%,1
嘉義市,東區,0047,519,158,677,77,754,1579,47.75%,32.87%,1
嘉義市,東區,0048,646,206,852,89,941,1831,51.39%,35.28%,1
嘉義市,東區,0049,394,116,510,43,553,977,56.6%,40.33%,1
嘉義市,東區,0050,384,166,550,41,591,1169,50.56%,32.85%,1
嘉義市,東區,0051,465,181,646,91,737,1238,59.53%,37.56%,1
嘉義市,東區,0052,606,50,656,22,678,1266,53.55%,47.87%,1
嘉義市,東區,0053,469,145,614,47,661,1429,46.26%,32.82%,1
嘉義市,東區,0054,516,162,678,21,699,1288,54.27%,40.06%,1
嘉義市,東區,0055,360,141,501,37,538,980,54.9%,36.73%,1
嘉義市,東區,0056,326,120,446,22,468,922,50.76%,35.36%,1
嘉義市,東區,0057,457,150,607,55,662,1133,58.43%,40.34%,1
嘉義市,東區,0058,493,147,640,53,693,1235,56.11%,39.92%,1
嘉義市,東區,0059,593,162,755,22,777,1525,50.95%,38.89%,1
嘉義市,東區,0060,412,135,547,58,605,1170,51.71%,35.21%,1
嘉義市,東區,0061,499,165,664,75,739,1177,62.79%,42.4%,1
嘉義市,東區,0062,459,141,600,74,674,1207,55.84%,38.03%,1
嘉義市,東區,0063,500,165,665,56,721,1272,56.68%,39.31%,1
嘉義市,東區,0064,418,169,587,87,674,1188,56.73%,35.19%,1
嘉義市,東區,0065,415,131,546,32,578,1172,49.32%,35.41%,1
嘉義市,東區,0066,405,147,552,43,595,1020,58.33%,39.71%,1
嘉義市,東區,0067,531,171,702,59,761,1332,57.13%,39.86%,1
嘉義市,東區,0068,414,161,575,45,620,1011,61.33%,40.95%,1
嘉義市,東區,0069,586,216,802,72,874,1682,51.96%,34.84%,1
嘉義市,東區,0070,584,196,780,77,857,1567,54.69%,37.27%,1
嘉義市,東區,0071,484,126,610,28,638,1207,52.86%,40.1%,1
嘉義市,東區,0072,415,115,530,26,556,981,56.68%,42.3%,1
嘉義市,東區,0073,516,150,666,47,713,1395,51.11%,36.99%,1
嘉義市,東區,0074,458,173,631,17,648,1434,45.19%,31.94%,1
嘉義市,東區,0075,536,44,580,34,614,1404,43.73%,38.18%,1
嘉義市,東區,0076,581,149,730,50,780,1428,54.62%,40.69%,1
嘉義市,東區,0077,546,178,724,24,748,1823,41.03%,29.95%,1
嘉義市,東區,0078,509,201,710,43,753,1570,47.96%,32.42%,1
嘉義市,東區,0079,417,160,577,65,642,1282,50.08%,32.53%,1
嘉義市,東區,0080,697,165,862,65,927,1571,59.01%,44.37%,1
嘉義市,東區,0081,560,164,724,29,753,1533,49.12%,36.53%,1
嘉義市,西區,0082,322,109,431,19,450,885,50.85%,36.38%,1
嘉義市,西區,0083,401,139,540,63,603,1109,54.37%,36.16%,1
嘉義市,西區,0084,308,139,447,49,496,1020,48.63%,30.2%,1
嘉義市,西區,0085,395,125,520,57,577,925,62.38%,42.7%,1
嘉義市,西區,0086,445,232,677,33,710,1671,42.49%,26.63%,1
嘉義市,西區,0087,443,160,603,40,643,1215,52.92%,36.46%,1
嘉義市,西區,0088,355,130,485,33,518,1036,50%,34.27%,1
嘉義市,西區,0089,352,164,516,40,556,1129,49.25%,31.18%,1
嘉義市,西區,0090,381,150,531,34,565,1127,50.13%,33.81%,1
嘉義市,西區,0091,480,199,679,56,735,1415,51.94%,33.92%,1
嘉義市,西區,0092,495,152,647,31,678,1366,49.63%,36.24%,1
嘉義市,西區,0093,415,158,573,68,641,1053,60.87%,39.41%,1
嘉義市,西區,0094,403,124,527,27,554,1067,51.92%,37.77%,1
嘉義市,西區,0095,510,207,717,34,751,1575,47.68%,32.38%,1
嘉義市,西區,0096,662,241,903,57,960,1865,51.47%,35.5%,1
嘉義市,西區,0097,401,132,533,49,582,1196,48.66%,33.53%,1
嘉義市,西區,0098,407,147,554,34,588,1280,45.94%,31.8%,1
嘉義市,西區,0099,619,183,802,69,871,1629,53.47%,38%,1
嘉義市,西區,0100,519,191,710,88,798,1393,57.29%,37.26%,1
嘉義市,西區,0101,435,148,583,41,624,1077,57.94%,40.39%,1
嘉義市,西區,0102,572,181,753,44,797,1694,47.05%,33.77%,1
嘉義市,西區,0103,325,117,442,83,525,841,62.43%,38.64%,1
嘉義市,西區,0104,405,142,547,6,553,1183,46.75%,34.23%,1
嘉義市,西區,0105,432,131,563,34,597,1000,59.7%,43.2%,1
嘉義市,西區,0106,444,151,595,29,624,1095,56.99%,40.55%,1
嘉義市,西區,0107,497,189,686,36,722,1256,57.48%,39.57%,1
嘉義市,西區,0108,396,107,503,57,560,962,58.21%,41.16%,1
嘉義市,西區,0109,376,140,516,20,536,865,61.97%,43.47%,1
嘉義市,西區,0110,479,172,651,67,718,1396,51.43%,34.31%,1
嘉義市,西區,0111,688,213,901,73,974,1799,54.14%,38.24%,1
嘉義市,西區,0112,546,147,693,34,727,1505,48.31%,36.28%,1
嘉義市,西區,0113,612,190,802,79,881,1698,51.88%,36.04%,1
嘉義市,西區,0114,697,217,914,30,944,1854,50.92%,37.59%,1
嘉義市,西區,0115,502,142,644,17,661,1537,43.01%,32.66%,1
嘉義市,西區,0116,507,215,722,94,816,1604,50.87%,31.61%,1
嘉義市,西區,0117,379,136,515,77,592,944,62.71%,40.15%,1
嘉義市,西區,0118,632,204,836,87,923,1627,56.73%,38.84%,1
嘉義市,西區,0119,449,165,614,58,672,1144,58.74%,39.25%,1
嘉義市,西區,0120,509,178,687,53,740,1362,54.33%,37.37%,1
嘉義市,西區,0121,504,173,677,43,720,1279,56.29%,39.41%,1
嘉義市,西區,0122,472,214,686,280,966,1702,56.76%,27.73%,1
嘉義市,西區,0123,564,172,736,60,796,1358,58.62%,41.53%,1
嘉義市,西區,0124,573,181,754,79,833,1360,61.25%,42.13%,1
嘉義市,西區,0125,607,210,817,76,893,1589,56.2%,38.2%,1
嘉義市,西區,0126,535,172,707,52,759,1280,59.3%,41.8%,1
嘉義市,西區,0127,396,136,532,52,584,1220,47.87%,32.46%,1
嘉義市,西區,0128,387,142,529,43,572,1172,48.81%,33.02%,1
嘉義市,西區,0129,528,149,677,54,731,1320,55.38%,40%,1
嘉義市,西區,0130,544,169,713,38,751,1185,63.38%,45.91%,1
嘉義市,西區,0131,499,202,701,64,765,1278,59.86%,39.05%,1
嘉義市,西區,0132,432,153,585,35,620,1394,44.48%,30.99%,1
嘉義市,西區,0133,612,183,795,165,960,1540,62.34%,39.74%,1
嘉義市,西區,0134,612,170,782,86,868,1548,56.07%,39.53%,1
嘉義市,西區,0135,491,149,640,43,683,1295,52.74%,37.92%,1
嘉義市,西區,0136,564,175,739,58,797,1318,60.47%,42.79%,1
嘉義市,西區,0137,609,184,793,61,854,1545,55.28%,39.42%,1
嘉義市,西區,0138,233,103,336,17,353,736,47.96%,31.66%,1
嘉義市,西區,0139,408,152,560,22,582,1168,49.83%,34.93%,1
嘉義市,西區,0140,322,114,436,37,473,756,62.57%,42.59%,1
嘉義市,西區,0141,383,77,460,13,473,869,54.43%,44.07%,1
嘉義市,西區,0142,393,134,527,52,579,983,58.9%,39.98%,1
嘉義市,西區,0143,320,97,417,50,467,828,56.4%,38.65%,1
嘉義市,西區,0144,775,160,935,43,978,1775,55.1%,43.66%,1
嘉義市,西區,0145,602,113,715,53,768,1419,54.12%,42.42%,1
嘉義市,西區,0146,269,103,372,18,390,779,50.06%,34.53%,1
嘉義市,西區,0147,310,78,388,20,408,855,47.72%,36.26%,1
嘉義市,西區,0148,450,142,592,81,673,1146,58.73%,39.27%,1
嘉義市,西區,0149,420,161,581,35,616,1111,55.45%,37.8%,1
嘉義市,西區,0150,319,115,434,58,492,767,64.15%,41.59%,1
嘉義市,西區,0151,264,93,357,26,383,817,46.88%,32.31%,1
嘉義市,西區,0152,272,116,388,59,447,770,58.05%,35.32%,1
嘉義市,西區,0153,324,127,451,25,476,1135,41.94%,28.55%,1
嘉義市,西區,0154,266,103,369,86,455,835,54.49%,31.86%,1
嘉義市,西區,0155,397,119,516,40,556,1182,47.04%,33.59%,1
嘉義市,西區,0156,272,125,397,42,439,944,46.5%,28.81%,1
嘉義市,西區,0157,334,122,456,41,497,997,49.85%,33.5%,1
嘉義市,西區,0158,372,146,518,38,556,1074,51.77%,34.64%,1
嘉義市,西區,0159,418,178,596,24,620,1460,42.47%,28.63%,1
嘉義市,西區,0160,490,160,650,27,677,1352,50.07%,36.24%,1
嘉義市,西區,0161,542,196,738,56,794,1499,52.97%,36.16%,1
嘉義市,西區,0162,428,163,591,108,699,1262,55.39%,33.91%,1
嘉義市,西區,0163,450,173,623,38,661,1299,50.89%,34.64%,1
嘉義市,西區,0164,579,209,788,95,883,1734,50.92%,33.39%,1
嘉義市,西區,0165,627,126,753,32,785,1674,46.89%,37.46%,1
嘉義市,西區,0166,572,159,731,34,765,1540,49.68%,37.14%,1
嘉義市,西區,0167,417,151,568,28,596,1056,56.44%,39.49%,1
嘉義市,西區,0168,537,208,745,107,852,1467,58.08%,36.61%,1
嘉義市,西區,0169,495,175,670,74,744,1431,51.99%,34.59%,1
嘉義市,西區,0170,517,168,685,87,772,1234,62.56%,41.9%,1
嘉義市,西區,0171,472,147,619,23,642,1266,50.71%,37.28%,1
嘉義市,西區,0172,464,160,624,34,658,1211,54.34%,38.32%,1
嘉義市,西區,0173,464,147,611,25,636,1121,56.74%,41.39%,1
嘉義市,西區,0174,368,127,495,30,525,1155,45.45%,31.86%,1
嘉義市,西區,0175,585,215,800,105,905,1546,58.54%,37.84%,1
嘉義市,西區,0176,475,140,615,35,650,1322,49.17%,35.93%,1
嘉義市,西區,0177,583,207,790,88,878,1549,56.68%,37.64%,1
