縣市,鄉鎮市區,開票所,同意票,不同意票,有效票,無效票,投票數,投票權人數,投票率,投票權人數百分比,總數
臺北市,松山區,0527,686,180,866,46,912,1583,57.61%,43.34%,1
臺北市,松山區,0528,692,213,905,75,980,1691,57.95%,40.92%,1
臺北市,松山區,0529,579,171,750,43,793,1386,57.22%,41.77%,1
臺北市,松山區,0530,575,197,772,52,824,1362,60.5%,42.22%,1
臺北市,松山區,0531,595,196,791,50,841,1399,60.11%,42.53%,1
臺北市,松山區,0532,537,219,756,47,803,1324,60.65%,40.56%,1
臺北市,松山區,0533,580,195,775,54,829,1296,63.97%,44.75%,1
臺北市,松山區,0534,582,217,799,53,852,1386,61.47%,41.99%,1
臺北市,松山區,0535,657,231,888,72,960,1529,62.79%,42.97%,1
臺北市,松山區,0536,613,166,779,40,819,1416,57.84%,43.29%,1
臺北市,松山區,0537,659,182,841,55,896,1619,55.34%,40.7%,1
臺北市,松山區,0538,566,218,784,52,836,1386,60.32%,40.84%,1
臺北市,松山區,0539,642,214,856,33,889,1380,64.42%,46.52%,1
臺北市,松山區,0540,586,194,780,46,826,1357,60.87%,43.18%,1
臺北市,松山區,0541,603,167,770,44,814,1296,62.81%,46.53%,1
臺北市,松山區,0542,750,181,931,57,988,1632,60.54%,45.96%,1
臺北市,松山區,0543,592,186,778,46,824,1414,58.27%,41.87%,1
臺北市,松山區,0544,604,199,803,39,842,1404,59.97%,43.02%,1
臺北市,松山區,0545,629,154,783,68,851,1365,62.34%,46.08%,1
臺北市,松山區,0546,625,172,797,60,857,1431,59.89%,43.68%,1
臺北市,松山區,0547,622,215,837,61,898,1483,60.55%,41.94%,1
臺北市,松山區,0548,582,172,754,58,812,1293,62.8%,45.01%,1
臺北市,松山區,0549,621,141,762,43,805,1410,57.09%,44.04%,1
臺北市,松山區,0550,597,155,752,42,794,1307,60.75%,45.68%,1
臺北市,松山區,0551,563,173,736,52,788,1242,63.45%,45.33%,1
臺北市,松山區,0552,545,152,697,30,727,1192,60.99%,45.72%,1
臺北市,松山區,0553,570,179,749,50,799,1276,62.62%,44.67%,1
臺北市,松山區,0554,512,163,675,28,703,1201,58.53%,42.63%,1
臺北市,松山區,0555,592,157,749,43,792,1318,60.09%,44.92%,1
臺北市,松山區,0556,509,161,670,40,710,1157,61.37%,43.99%,1
臺北市,松山區,0557,497,148,645,18,663,1157,57.3%,42.96%,1
臺北市,松山區,0558,615,166,781,53,834,1357,61.46%,45.32%,1
臺北市,松山區,0559,444,152,596,31,627,1215,51.6%,36.54%,1
臺北市,松山區,0560,569,168,737,41,778,1345,57.84%,42.3%,1
臺北市,松山區,0561,532,169,701,44,745,1237,60.23%,43.01%,1
臺北市,松山區,0562,747,118,865,43,908,1393,65.18%,53.63%,1
臺北市,松山區,0563,612,200,812,45,857,1331,64.39%,45.98%,1
臺北市,松山區,0564,669,232,901,57,958,1550,61.81%,43.16%,1
臺北市,松山區,0565,621,99,720,21,741,1308,56.65%,47.48%,1
臺北市,松山區,0566,692,113,805,46,851,1490,57.11%,46.44%,1
臺北市,松山區,0567,693,165,858,38,896,1406,63.73%,49.29%,1
臺北市,松山區,0568,542,187,729,38,767,1191,64.4%,45.51%,1
臺北市,松山區,0569,457,168,625,37,662,1095,60.46%,41.74%,1
臺北市,松山區,0570,496,166,662,42,704,1198,58.76%,41.4%,1
臺北市,松山區,0571,553,152,705,45,750,1265,59.29%,43.72%,1
臺北市,松山區,0572,505,166,671,52,723,1225,59.02%,41.22%,1
臺北市,松山區,0573,758,240,998,50,1048,1698,61.72%,44.64%,1
臺北市,松山區,0574,787,203,990,49,1039,1819,57.12%,43.27%,1
臺北市,松山區,0575,764,224,988,70,1058,1754,60.32%,43.56%,1
臺北市,松山區,0576,567,235,802,44,846,1361,62.16%,41.66%,1
臺北市,松山區,0577,549,153,702,25,727,1189,61.14%,46.17%,1
臺北市,松山區,0578,519,184,703,43,746,1214,61.45%,42.75%,1
臺北市,松山區,0579,533,181,714,47,761,1284,59.27%,41.51%,1
臺北市,松山區,0580,552,202,754,48,802,1297,61.84%,42.56%,1
臺北市,松山區,0581,543,192,735,35,770,1330,57.89%,40.83%,1
臺北市,松山區,0582,655,160,815,53,868,1396,62.18%,46.92%,1
臺北市,松山區,0583,663,150,813,27,840,1480,56.76%,44.8%,1
臺北市,松山區,0584,646,186,832,33,865,1419,60.96%,45.53%,1
臺北市,松山區,0585,607,181,788,55,843,1390,60.65%,43.67%,1
臺北市,松山區,0586,662,207,869,45,914,1525,59.93%,43.41%,1
臺北市,松山區,0587,641,206,847,48,895,1633,54.81%,39.25%,1
臺北市,松山區,0588,651,190,841,51,892,2677,33.32%,24.32%,1
臺北市,松山區,0589,632,80,712,57,769,1281,60.03%,49.34%,1
臺北市,松山區,0590,492,177,669,47,716,1469,48.74%,33.49%,1
臺北市,松山區,0591,664,228,892,69,961,1700,56.53%,39.06%,1
臺北市,松山區,0592,597,177,774,39,813,1503,54.09%,39.72%,1
臺北市,松山區,0593,548,159,707,50,757,1309,57.83%,41.86%,1
臺北市,松山區,0594,598,174,772,65,837,1376,60.83%,43.46%,1
臺北市,松山區,0595,609,321,930,32,962,1654,58.16%,36.82%,1
臺北市,松山區,0596,633,190,823,79,902,1601,56.34%,39.54%,1
臺北市,松山區,0597,708,135,843,33,876,1496,58.56%,47.33%,1
臺北市,松山區,0598,719,218,937,75,1012,1598,63.33%,44.99%,1
臺北市,松山區,0599,769,231,1000,57,1057,1751,60.37%,43.92%,1
臺北市,松山區,0600,770,156,926,43,969,1557,62.24%,49.45%,1
臺北市,松山區,0601,885,162,1047,54,1101,1686,65.3%,52.49%,1
臺北市,松山區,0602,880,132,1012,40,1052,1707,61.63%,51.55%,1
臺北市,松山區,0603,993,155,1148,44,1192,1854,64.29%,53.56%,1
臺北市,松山區,0604,745,198,943,40,983,1740,56.49%,42.82%,1
臺北市,松山區,0605,627,192,819,66,885,1494,59.24%,41.97%,1
臺北市,松山區,0606,649,181,830,44,874,1453,60.15%,44.67%,1
臺北市,松山區,0607,651,182,833,38,871,1458,59.74%,44.65%,1
臺北市,松山區,0608,657,180,837,46,883,1536,57.49%,42.77%,1
臺北市,松山區,0609,638,200,838,39,877,1463,59.95%,43.61%,1
臺北市,松山區,0610,704,210,914,39,953,1790,53.24%,39.33%,1
臺北市,松山區,0611,705,248,953,54,1007,1679,59.98%,41.99%,1
臺北市,松山區,0612,640,220,860,72,932,1785,52.21%,35.85%,1
臺北市,松山區,0613,737,233,970,67,1037,1793,57.84%,41.1%,1
臺北市,松山區,0614,614,156,770,50,820,1381,59.38%,44.46%,1
臺北市,松山區,0615,564,164,728,46,774,1279,60.52%,44.1%,1
臺北市,松山區,0616,716,225,941,71,1012,1681,60.2%,42.59%,1
臺北市,松山區,0617,589,137,726,46,772,1232,62.66%,47.81%,1
臺北市,松山區,0618,644,177,821,58,879,1533,57.34%,42.01%,1
臺北市,松山區,0619,677,231,908,39,947,1540,61.49%,43.96%,1
臺北市,松山區,0620,693,212,905,56,961,1716,56%,40.38%,1
臺北市,松山區,0621,653,216,869,53,922,1664,55.41%,39.24%,1
臺北市,松山區,0622,553,194,747,31,778,1350,57.63%,40.96%,1
臺北市,松山區,0623,761,236,997,50,1047,1837,57%,41.43%,1
臺北市,松山區,0624,579,200,779,75,854,1558,54.81%,37.16%,1
臺北市,松山區,0625,642,180,822,48,870,1420,61.27%,45.21%,1
臺北市,松山區,0626,594,197,791,55,846,1474,57.39%,40.3%,1
臺北市,松山區,0627,641,221,862,47,909,1591,57.13%,40.29%,1
臺北市,松山區,0628,743,213,956,58,1014,1726,58.75%,43.05%,1
臺北市,松山區,0629,570,229,799,43,842,1452,57.99%,39.26%,1
臺北市,松山區,0630,582,205,787,42,829,1482,55.94%,39.27%,1
臺北市,松山區,0631,628,192,820,43,863,1460,59.11%,43.01%,1
臺北市,松山區,0632,545,216,761,43,804,1398,57.51%,38.98%,1
臺北市,松山區,0633,623,184,807,53,860,1423,60.44%,43.78%,1
臺北市,松山區,0634,565,144,709,24,733,1226,59.79%,46.08%,1
臺北市,松山區,0635,515,135,650,51,701,1158,60.54%,44.47%,1
臺北市,松山區,0636,594,190,784,39,823,1426,57.71%,41.65%,1
臺北市,松山區,0637,509,154,663,27,690,1177,58.62%,43.25%,1
臺北市,松山區,0638,545,200,745,49,794,1363,58.25%,39.99%,1
臺北市,松山區,0639,550,170,720,49,769,1240,62.02%,44.35%,1
臺北市,松山區,0640,627,181,808,50,858,1375,62.4%,45.6%,1
臺北市,松山區,0641,587,196,783,42,825,1377,59.91%,42.63%,1
臺北市,松山區,0642,488,155,643,29,672,1225,54.86%,39.84%,1
臺北市,松山區,0643,425,182,607,40,647,1017,63.62%,41.79%,1
臺北市,信義區,0644,626,149,775,26,801,2476,32.35%,25.28%,1
臺北市,信義區,0645,726,132,858,17,875,1381,63.36%,52.57%,1
臺北市,信義區,0646,615,152,767,53,820,1294,63.37%,47.53%,1
臺北市,信義區,0647,577,180,757,41,798,1351,59.07%,42.71%,1
臺北市,信義區,0648,563,152,715,43,758,1296,58.49%,43.44%,1
臺北市,信義區,0649,597,156,753,48,801,1302,61.52%,45.85%,1
臺北市,信義區,0650,409,118,527,57,584,1025,56.98%,39.9%,1
臺北市,信義區,0651,595,163,758,28,786,1421,55.31%,41.87%,1
臺北市,信義區,0652,633,167,800,48,848,1501,56.5%,42.17%,1
臺北市,信義區,0653,594,178,772,42,814,1575,51.68%,37.71%,1
臺北市,信義區,0654,677,165,842,21,863,1516,56.93%,44.66%,1
臺北市,信義區,0655,598,190,788,23,811,1382,58.68%,43.27%,1
臺北市,信義區,0656,494,113,607,50,657,1128,58.24%,43.79%,1
臺北市,信義區,0657,562,185,747,50,797,1397,57.05%,40.23%,1
臺北市,信義區,0658,506,167,673,54,727,1161,62.62%,43.58%,1
臺北市,信義區,0659,580,172,752,43,795,1368,58.11%,42.4%,1
臺北市,信義區,0660,470,128,598,25,623,1049,59.39%,44.8%,1
臺北市,信義區,0661,562,158,720,49,769,1308,58.79%,42.97%,1
臺北市,信義區,0662,514,160,674,45,719,1154,62.31%,44.54%,1
臺北市,信義區,0663,497,145,642,23,665,1078,61.69%,46.1%,1
臺北市,信義區,0664,600,162,762,44,806,1375,58.62%,43.64%,1
臺北市,信義區,0665,651,173,824,36,860,1448,59.39%,44.96%,1
臺北市,信義區,0666,562,162,724,25,749,1250,59.92%,44.96%,1
臺北市,信義區,0667,592,195,787,34,821,1381,59.45%,42.87%,1
臺北市,信義區,0668,553,160,713,40,753,1213,62.08%,45.59%,1
臺北市,信義區,0669,636,192,828,39,867,1373,63.15%,46.32%,1
臺北市,信義區,0670,550,165,715,42,757,1226,61.75%,44.86%,1
臺北市,信義區,0671,506,161,667,17,684,1117,61.24%,45.3%,1
臺北市,信義區,0672,506,145,651,45,696,1123,61.98%,45.06%,1
臺北市,信義區,0673,538,152,690,38,728,1200,60.67%,44.83%,1
臺北市,信義區,0674,536,135,671,37,708,1335,53.03%,40.15%,1
臺北市,信義區,0675,536,159,695,34,729,1332,54.73%,40.24%,1
臺北市,信義區,0676,674,236,910,73,983,1648,59.65%,40.9%,1
臺北市,信義區,0677,602,209,811,69,880,1542,57.07%,39.04%,1
臺北市,信義區,0678,516,157,673,57,730,1228,59.45%,42.02%,1
臺北市,信義區,0679,705,243,948,56,1004,1731,58%,40.73%,1
臺北市,信義區,0680,601,180,781,52,833,1403,59.37%,42.84%,1
臺北市,信義區,0681,786,199,985,85,1070,1929,55.47%,40.75%,1
臺北市,信義區,0682,594,167,761,39,800,1300,61.54%,45.69%,1
臺北市,信義區,0683,589,161,750,31,781,1486,52.56%,39.64%,1
臺北市,信義區,0684,530,181,711,63,774,1532,50.52%,34.6%,1
臺北市,信義區,0685,611,199,810,56,866,1387,62.44%,44.05%,1
臺北市,信義區,0686,470,133,603,56,659,1195,55.15%,39.33%,1
臺北市,信義區,0687,434,118,552,37,589,1068,55.15%,40.64%,1
臺北市,信義區,0688,497,126,623,53,676,1273,53.1%,39.04%,1
臺北市,信義區,0689,596,180,776,64,840,1329,63.21%,44.85%,1
臺北市,信義區,0690,496,169,665,45,710,1311,54.16%,37.83%,1
臺北市,信義區,0691,507,150,657,48,705,1258,56.04%,40.3%,1
臺北市,信義區,0692,541,173,714,60,774,1277,60.61%,42.36%,1
臺北市,信義區,0693,569,180,749,64,813,1285,63.27%,44.28%,1
臺北市,信義區,0694,514,166,680,60,740,1161,63.74%,44.27%,1
臺北市,信義區,0695,513,183,696,41,737,1299,56.74%,39.49%,1
臺北市,信義區,0696,518,155,673,45,718,1243,57.76%,41.67%,1
臺北市,信義區,0697,495,160,655,39,694,1197,57.98%,41.35%,1
臺北市,信義區,0698,570,168,738,31,769,1224,62.83%,46.57%,1
臺北市,信義區,0699,473,127,600,34,634,1147,55.27%,41.24%,1
臺北市,信義區,0700,428,118,546,20,566,1045,54.16%,40.96%,1
臺北市,信義區,0701,513,131,644,30,674,1096,61.5%,46.81%,1
臺北市,信義區,0702,484,136,620,13,633,1115,56.77%,43.41%,1
臺北市,信義區,0703,434,155,589,55,644,1117,57.65%,38.85%,1
臺北市,信義區,0704,386,119,505,27,532,1019,52.21%,37.88%,1
臺北市,信義區,0705,585,166,751,50,801,1346,59.51%,43.46%,1
臺北市,信義區,0706,600,141,741,48,789,1405,56.16%,42.7%,1
臺北市,信義區,0707,591,167,758,37,795,1356,58.63%,43.58%,1
臺北市,信義區,0708,587,178,765,35,800,1250,64%,46.96%,1
臺北市,信義區,0709,564,159,723,41,764,1254,60.93%,44.98%,1
臺北市,信義區,0710,592,133,725,29,754,1317,57.25%,44.95%,1
臺北市,信義區,0711,581,160,741,58,799,1271,62.86%,45.71%,1
臺北市,信義區,0712,398,122,520,31,551,979,56.28%,40.65%,1
臺北市,信義區,0713,404,122,526,46,572,1025,55.8%,39.41%,1
臺北市,信義區,0714,676,42,718,39,757,1512,50.07%,44.71%,1
臺北市,信義區,0715,664,179,843,36,879,1483,59.27%,44.77%,1
臺北市,信義區,0716,635,157,792,36,828,1359,60.93%,46.73%,1
臺北市,信義區,0717,629,160,789,22,811,1387,58.47%,45.35%,1
臺北市,信義區,0718,578,176,754,28,782,1455,53.75%,39.73%,1
臺北市,信義區,0719,602,209,811,28,839,1461,57.43%,41.2%,1
臺北市,信義區,0720,663,190,853,63,916,1532,59.79%,43.28%,1
臺北市,信義區,0721,472,156,628,41,669,1043,64.14%,45.25%,1
臺北市,信義區,0722,380,136,516,37,553,875,63.2%,43.43%,1
臺北市,信義區,0723,376,122,498,24,522,927,56.31%,40.56%,1
臺北市,信義區,0724,456,165,621,61,682,1119,60.95%,40.75%,1
臺北市,信義區,0725,600,201,801,59,860,1463,58.78%,41.01%,1
臺北市,信義區,0726,595,181,776,42,818,1293,63.26%,46.02%,1
臺北市,信義區,0727,608,201,809,64,873,1553,56.21%,39.15%,1
臺北市,信義區,0728,571,169,740,38,778,1360,57.21%,41.99%,1
臺北市,信義區,0729,588,177,765,63,828,1392,59.48%,42.24%,1
臺北市,信義區,0730,559,191,750,24,774,1377,56.21%,40.6%,1
臺北市,信義區,0731,615,154,769,16,785,1377,57.01%,44.66%,1
臺北市,信義區,0732,461,169,630,36,666,1269,52.48%,36.33%,1
臺北市,信義區,0733,588,181,769,61,830,1407,58.99%,41.79%,1
臺北市,信義區,0734,477,161,638,41,679,1172,57.94%,40.7%,1
臺北市,信義區,0735,520,138,658,20,678,1182,57.36%,43.99%,1
臺北市,信義區,0736,523,167,690,58,748,1255,59.6%,41.67%,1
臺北市,信義區,0737,653,185,838,35,873,1689,51.69%,38.66%,1
臺北市,信義區,0738,651,138,789,31,820,1605,51.09%,40.56%,1
臺北市,信義區,0739,505,115,620,35,655,1143,57.31%,44.18%,1
臺北市,信義區,0740,593,147,740,37,777,1440,53.96%,41.18%,1
臺北市,信義區,0741,620,190,810,46,856,1495,57.26%,41.47%,1
臺北市,信義區,0742,630,225,855,55,910,1514,60.11%,41.61%,1
臺北市,信義區,0743,586,150,736,56,792,1449,54.66%,40.44%,1
臺北市,信義區,0744,605,187,792,58,850,1401,60.67%,43.18%,1
臺北市,信義區,0745,479,130,609,21,630,1181,53.34%,40.56%,1
臺北市,信義區,0746,762,56,818,30,848,1376,61.63%,55.38%,1
臺北市,信義區,0747,658,163,821,50,871,1422,61.25%,46.27%,1
臺北市,信義區,0748,566,132,698,25,723,1267,57.06%,44.67%,1
臺北市,信義區,0749,475,154,629,24,653,1220,53.52%,38.93%,1
臺北市,信義區,0750,602,165,767,25,792,1562,50.7%,38.54%,1
臺北市,信義區,0751,594,176,770,28,798,1455,54.85%,40.82%,1
臺北市,信義區,0752,661,172,833,48,881,1605,54.89%,41.18%,1
臺北市,信義區,0753,788,183,971,23,994,1626,61.13%,48.46%,1
臺北市,信義區,0754,678,184,862,71,933,1561,59.77%,43.43%,1
臺北市,信義區,0755,528,185,713,31,744,1547,48.09%,34.13%,1
臺北市,信義區,0756,564,169,733,26,759,1336,56.81%,42.22%,1
臺北市,信義區,0757,490,135,625,39,664,1314,50.53%,37.29%,1
臺北市,信義區,0758,509,141,650,42,692,1297,53.35%,39.24%,1
臺北市,信義區,0759,550,147,697,61,758,1366,55.49%,40.26%,1
臺北市,信義區,0760,608,183,791,47,838,1472,56.93%,41.3%,1
臺北市,信義區,0761,619,176,795,49,844,1450,58.21%,42.69%,1
臺北市,信義區,0762,548,175,723,50,773,1328,58.21%,41.27%,1
臺北市,信義區,0763,604,195,799,56,855,1399,61.12%,43.17%,1
臺北市,信義區,0764,601,179,780,66,846,1373,61.62%,43.77%,1
臺北市,信義區,0765,416,130,546,42,588,1099,53.5%,37.85%,1
臺北市,信義區,0766,512,149,661,49,710,1226,57.91%,41.76%,1
臺北市,信義區,0767,532,117,649,22,671,1267,52.96%,41.99%,1
臺北市,信義區,0768,622,199,821,58,879,1531,57.41%,40.63%,1
臺北市,信義區,0769,647,175,822,51,873,1438,60.71%,44.99%,1
臺北市,信義區,0770,677,181,858,27,885,1657,53.41%,40.86%,1
臺北市,信義區,0771,722,93,815,52,867,1621,53.49%,44.54%,1
臺北市,信義區,0772,657,185,842,26,868,1508,57.56%,43.57%,1
臺北市,信義區,0773,591,162,753,46,799,1334,59.9%,44.3%,1
臺北市,信義區,0774,427,122,549,43,592,1246,47.51%,34.27%,1
臺北市,信義區,0775,486,165,651,46,697,1196,58.28%,40.64%,1
臺北市,信義區,0776,543,146,689,27,716,1220,58.69%,44.51%,1
臺北市,信義區,0777,627,177,804,38,842,1538,54.75%,40.77%,1
臺北市,信義區,0778,696,189,885,55,940,1565,60.06%,44.47%,1
臺北市,信義區,0779,628,163,791,79,870,1621,53.67%,38.74%,1
臺北市,信義區,0780,595,180,775,65,840,1486,56.53%,40.04%,1
臺北市,信義區,0781,614,161,775,25,800,1507,53.09%,40.74%,1
臺北市,信義區,0782,649,187,836,57,893,1516,58.91%,42.81%,1
臺北市,信義區,0783,582,161,743,60,803,1287,62.39%,45.22%,1
臺北市,信義區,0784,399,106,505,56,561,1050,53.43%,38%,1
臺北市,信義區,0785,358,104,462,36,498,801,62.17%,44.69%,1
臺北市,大安區,1214,474,151,625,20,645,1184,54.48%,40.03%,1
臺北市,大安區,1215,485,132,617,35,652,1197,54.47%,40.52%,1
臺北市,大安區,1216,508,170,678,19,697,1221,57.08%,41.61%,1
臺北市,大安區,1217,574,141,715,28,743,1246,59.63%,46.07%,1
臺北市,大安區,1218,629,231,860,44,904,1478,61.16%,42.56%,1
臺北市,大安區,1219,538,161,699,54,753,1314,57.31%,40.94%,1
臺北市,大安區,1220,712,203,915,50,965,1594,60.54%,44.67%,1
臺北市,大安區,1221,623,201,824,34,858,1429,60.04%,43.6%,1
臺北市,大安區,1222,688,162,850,26,876,1452,60.33%,47.38%,1
臺北市,大安區,1223,657,213,870,23,893,1551,57.58%,42.36%,1
臺北市,大安區,1224,584,176,760,54,814,1335,60.97%,43.75%,1
臺北市,大安區,1225,480,140,620,26,646,1196,54.01%,40.13%,1
臺北市,大安區,1226,503,195,698,37,735,1339,54.89%,37.57%,1
臺北市,大安區,1227,550,225,775,35,810,1448,55.94%,37.98%,1
臺北市,大安區,1228,576,174,750,47,797,1373,58.05%,41.95%,1
臺北市,大安區,1229,546,219,765,72,837,1439,58.17%,37.94%,1
臺北市,大安區,1230,445,161,606,14,620,1174,52.81%,37.9%,1
臺北市,大安區,1231,420,146,566,33,599,1144,52.36%,36.71%,1
臺北市,大安區,1232,458,118,576,25,601,1119,53.71%,40.93%,1
臺北市,大安區,1233,347,116,463,36,499,1024,48.73%,33.89%,1
臺北市,大安區,1234,491,117,608,21,629,1032,60.95%,47.58%,1
臺北市,大安區,1235,643,104,747,43,790,1319,59.89%,48.75%,1
臺北市,大安區,1236,647,155,802,42,844,1369,61.65%,47.26%,1
臺北市,大安區,1237,537,219,756,47,803,1347,59.61%,39.87%,1
臺北市,大安區,1238,584,238,822,44,866,1655,52.33%,35.29%,1
臺北市,大安區,1239,599,184,783,22,805,1595,50.47%,37.55%,1
臺北市,大安區,1240,557,190,747,31,778,1429,54.44%,38.98%,1
臺北市,大安區,1241,491,155,646,29,675,1309,51.57%,37.51%,1
臺北市,大安區,1242,578,197,775,42,817,1508,54.18%,38.33%,1
臺北市,大安區,1243,481,197,678,41,719,1310,54.89%,36.72%,1
臺北市,大安區,1244,445,164,609,30,639,1233,51.82%,36.09%,1
臺北市,大安區,1245,483,157,640,49,689,1287,53.54%,37.53%,1
臺北市,大安區,1246,418,151,569,25,594,1147,51.79%,36.44%,1
臺北市,大安區,1247,477,167,644,32,676,1260,53.65%,37.86%,1
臺北市,大安區,1248,553,154,707,50,757,1377,54.97%,40.16%,1
臺北市,大安區,1249,472,173,645,70,715,1284,55.69%,36.76%,1
臺北市,大安區,1250,536,121,657,26,683,1314,51.98%,40.79%,1
臺北市,大安區,1251,489,155,644,34,678,1273,53.26%,38.41%,1
臺北市,大安區,1252,452,194,646,24,670,1146,58.46%,39.44%,1
臺北市,大安區,1253,525,200,725,29,754,1285,58.68%,40.86%,1
臺北市,大安區,1254,555,198,753,31,784,1297,60.45%,42.79%,1
臺北市,大安區,1255,500,146,646,39,685,1101,62.22%,45.41%,1
臺北市,大安區,1256,514,183,697,53,750,1310,57.25%,39.24%,1
臺北市,大安區,1257,577,209,786,55,841,1365,61.61%,42.27%,1
臺北市,大安區,1258,561,197,758,26,784,1372,57.14%,40.89%,1
臺北市,大安區,1259,514,177,691,29,720,1189,60.56%,43.23%,1
臺北市,大安區,1260,537,172,709,40,749,1256,59.63%,42.75%,1
臺北市,大安區,1261,503,169,672,32,704,1151,61.16%,43.7%,1
臺北市,大安區,1262,690,201,891,39,930,1501,61.96%,45.97%,1
臺北市,大安區,1263,779,85,864,44,908,1520,59.74%,51.25%,1
臺北市,大安區,1264,662,226,888,53,941,1529,61.54%,43.3%,1
臺北市,大安區,1265,695,223,918,43,961,1579,60.86%,44.02%,1
臺北市,大安區,1266,484,159,643,29,672,2619,25.66%,18.48%,1
臺北市,大安區,1267,553,153,706,25,731,1290,56.67%,42.87%,1
臺北市,大安區,1268,557,243,800,18,818,1307,62.59%,42.62%,1
臺北市,大安區,1269,629,222,851,26,877,1489,58.9%,42.24%,1
臺北市,大安區,1270,520,129,649,33,682,1097,62.17%,47.4%,1
臺北市,大安區,1271,571,171,742,35,777,1328,58.51%,43%,1
臺北市,大安區,1272,488,150,638,30,668,1189,56.18%,41.04%,1
臺北市,大安區,1273,560,144,704,25,729,1270,57.4%,44.09%,1
臺北市,大安區,1274,546,198,744,15,759,1349,56.26%,40.47%,1
臺北市,大安區,1275,542,162,704,24,728,1292,56.35%,41.95%,1
臺北市,大安區,1276,586,186,772,36,808,1314,61.49%,44.6%,1
臺北市,大安區,1277,507,186,693,47,740,1200,61.67%,42.25%,1
臺北市,大安區,1278,641,227,868,34,902,1558,57.89%,41.14%,1
臺北市,大安區,1279,665,214,879,37,916,1561,58.68%,42.6%,1
臺北市,大安區,1280,661,163,824,51,875,1446,60.51%,45.71%,1
臺北市,大安區,1281,652,207,859,27,886,1499,59.11%,43.5%,1
臺北市,大安區,1282,651,175,826,33,859,1467,58.55%,44.38%,1
臺北市,大安區,1283,586,222,808,37,845,1511,55.92%,38.78%,1
臺北市,大安區,1284,678,230,908,54,962,1600,60.12%,42.38%,1
臺北市,大安區,1285,661,232,893,39,932,1573,59.25%,42.02%,1
臺北市,大安區,1286,671,181,852,43,895,1467,61.01%,45.74%,1
臺北市,大安區,1287,575,157,732,66,798,1358,58.76%,42.34%,1
臺北市,大安區,1288,637,208,845,59,904,1568,57.65%,40.63%,1
臺北市,大安區,1289,622,181,803,42,845,1411,59.89%,44.08%,1
臺北市,大安區,1290,631,181,812,29,841,1554,54.12%,40.6%,1
臺北市,大安區,1291,633,159,792,30,822,1345,61.12%,47.06%,1
臺北市,大安區,1292,669,143,812,23,835,1435,58.19%,46.62%,1
臺北市,大安區,1293,731,165,896,28,924,1481,62.39%,49.36%,1
臺北市,大安區,1294,741,149,890,33,923,1451,63.61%,51.07%,1
臺北市,大安區,1295,629,225,854,70,924,1566,59%,40.17%,1
臺北市,大安區,1296,648,214,862,30,892,1525,58.49%,42.49%,1
臺北市,大安區,1297,564,145,709,43,752,1336,56.29%,42.22%,1
臺北市,大安區,1298,620,203,823,58,881,1483,59.41%,41.81%,1
臺北市,大安區,1299,512,169,681,29,710,1396,50.86%,36.68%,1
臺北市,大安區,1300,646,161,807,63,870,1406,61.88%,45.95%,1
臺北市,大安區,1301,620,153,773,33,806,1434,56.21%,43.24%,1
臺北市,大安區,1302,586,121,707,38,745,1288,57.84%,45.5%,1
臺北市,大安區,1303,634,169,803,30,833,1407,59.2%,45.06%,1
臺北市,大安區,1304,595,186,781,33,814,1514,53.76%,39.3%,1
臺北市,大安區,1305,563,162,725,46,771,1550,49.74%,36.32%,1
臺北市,大安區,1306,650,170,820,52,872,1490,58.52%,43.62%,1
臺北市,大安區,1307,532,145,677,36,713,1284,55.53%,41.43%,1
臺北市,大安區,1308,501,146,647,31,678,1129,60.05%,44.38%,1
臺北市,大安區,1309,502,177,679,23,702,1193,58.84%,42.08%,1
臺北市,大安區,1310,408,153,561,38,599,1057,56.67%,38.6%,1
臺北市,大安區,1311,573,169,742,44,786,1361,57.75%,42.1%,1
臺北市,大安區,1312,578,164,742,54,796,1412,56.37%,40.93%,1
臺北市,大安區,1313,481,165,646,33,679,1423,47.72%,33.8%,1
臺北市,大安區,1314,472,156,628,106,734,1257,58.39%,37.55%,1
臺北市,大安區,1315,519,144,663,40,703,1133,62.05%,45.81%,1
臺北市,大安區,1316,408,172,580,28,608,1077,56.45%,37.88%,1
臺北市,大安區,1317,555,191,746,44,790,1300,60.77%,42.69%,1
臺北市,大安區,1318,589,170,759,57,816,1319,61.87%,44.66%,1
臺北市,大安區,1319,522,164,686,75,761,1265,60.16%,41.26%,1
臺北市,大安區,1320,496,159,655,30,685,1265,54.15%,39.21%,1
臺北市,大安區,1321,501,124,625,28,653,1103,59.2%,45.42%,1
臺北市,大安區,1322,610,153,763,33,796,1341,59.36%,45.49%,1
臺北市,大安區,1323,632,149,781,42,823,1357,60.65%,46.57%,1
臺北市,大安區,1324,526,185,711,35,746,1260,59.21%,41.75%,1
臺北市,大安區,1325,572,166,738,36,774,1295,59.77%,44.17%,1
臺北市,大安區,1326,566,140,706,34,740,1399,52.89%,40.46%,1
臺北市,大安區,1327,487,142,629,35,664,1150,57.74%,42.35%,1
臺北市,大安區,1328,544,129,673,30,703,1351,52.04%,40.27%,1
臺北市,大安區,1329,566,176,742,50,792,1341,59.06%,42.21%,1
臺北市,大安區,1330,474,132,606,22,628,1129,55.62%,41.98%,1
臺北市,大安區,1331,604,136,740,20,760,1328,57.23%,45.48%,1
臺北市,大安區,1332,803,135,938,34,972,1557,62.43%,51.57%,1
臺北市,大安區,1333,711,173,884,43,927,1461,63.45%,48.67%,1
臺北市,大安區,1334,648,138,786,32,818,1589,51.48%,40.78%,1
臺北市,大安區,1335,659,133,792,37,829,1473,56.28%,44.74%,1
臺北市,大安區,1336,634,171,805,38,843,1479,57%,42.87%,1
臺北市,大安區,1337,365,127,492,34,526,833,63.15%,43.82%,1
臺北市,大安區,1338,422,114,536,29,565,999,56.56%,42.24%,1
臺北市,大安區,1339,792,206,998,45,1043,1757,59.36%,45.08%,1
臺北市,大安區,1340,578,207,785,36,821,1573,52.19%,36.75%,1
臺北市,大安區,1341,708,231,939,46,985,1587,62.07%,44.61%,1
臺北市,大安區,1342,646,220,866,48,914,1496,61.1%,43.18%,1
臺北市,大安區,1343,602,205,807,37,844,1440,58.61%,41.81%,1
臺北市,大安區,1344,696,206,902,54,956,1578,60.58%,44.11%,1
臺北市,大安區,1345,518,171,689,27,716,1223,58.54%,42.35%,1
臺北市,大安區,1346,454,171,625,17,642,1119,57.37%,40.57%,1
臺北市,大安區,1347,537,195,732,17,749,1252,59.82%,42.89%,1
臺北市,大安區,1348,673,223,896,34,930,1576,59.01%,42.7%,1
臺北市,大安區,1349,584,184,768,39,807,1425,56.63%,40.98%,1
臺北市,大安區,1350,590,196,786,21,807,1450,55.66%,40.69%,1
臺北市,大安區,1351,575,189,764,39,803,1444,55.61%,39.82%,1
臺北市,大安區,1352,594,205,799,30,829,1337,62%,44.43%,1
臺北市,大安區,1353,562,173,735,35,770,1417,54.34%,39.66%,1
臺北市,大安區,1354,519,160,679,44,723,1250,57.84%,41.52%,1
臺北市,大安區,1355,486,140,626,60,686,1176,58.33%,41.33%,1
臺北市,大安區,1356,576,156,732,52,784,1257,62.37%,45.82%,1
臺北市,大安區,1357,534,164,698,51,749,1257,59.59%,42.48%,1
臺北市,大安區,1358,495,144,639,30,669,1148,58.28%,43.12%,1
臺北市,大安區,1359,597,165,762,59,821,1418,57.9%,42.1%,1
臺北市,大安區,1360,423,128,551,24,575,1028,55.93%,41.15%,1
臺北市,大安區,1361,627,194,821,46,867,1445,60%,43.39%,1
臺北市,大安區,1362,620,146,766,43,809,1361,59.44%,45.55%,1
臺北市,大安區,1363,603,174,777,45,822,1343,61.21%,44.9%,1
臺北市,大安區,1364,547,159,706,45,751,1267,59.27%,43.17%,1
臺北市,大安區,1365,532,178,710,36,746,1380,54.06%,38.55%,1
臺北市,大安區,1366,623,179,802,54,856,1524,56.17%,40.88%,1
臺北市,大安區,1367,641,176,817,41,858,1470,58.37%,43.61%,1
臺北市,大安區,1368,533,120,653,52,705,1318,53.49%,40.44%,1
臺北市,大安區,1369,551,176,727,39,766,1430,53.57%,38.53%,1
臺北市,大安區,1370,572,179,751,45,796,1386,57.43%,41.27%,1
臺北市,大安區,1371,562,166,728,34,762,1438,52.99%,39.08%,1
臺北市,大安區,1372,487,144,631,18,649,1270,51.1%,38.35%,1
臺北市,大安區,1373,560,172,732,48,780,1395,55.91%,40.14%,1
臺北市,大安區,1374,551,145,696,43,739,1292,57.2%,42.65%,1
臺北市,大安區,1375,528,162,690,43,733,1310,55.95%,40.31%,1
臺北市,大安區,1376,535,169,704,36,740,1319,56.1%,40.56%,1
臺北市,大安區,1377,575,185,760,23,783,1355,57.79%,42.44%,1
臺北市,大安區,1378,504,158,662,28,690,1312,52.59%,38.41%,1
臺北市,大安區,1379,563,154,717,27,744,1335,55.73%,42.17%,1
臺北市,大安區,1380,575,170,745,35,780,1489,52.38%,38.62%,1
臺北市,大安區,1381,558,159,717,29,746,1307,57.08%,42.69%,1
臺北市,大安區,1382,492,177,669,31,700,1328,52.71%,37.05%,1
臺北市,大安區,1383,508,147,655,9,664,1277,52%,39.78%,1
臺北市,大安區,1384,560,152,712,36,748,1314,56.93%,42.62%,1
臺北市,大安區,1385,529,184,713,54,767,1270,60.39%,41.65%,1
臺北市,大安區,1386,531,176,707,47,754,1308,57.65%,40.6%,1
臺北市,大安區,1387,496,154,650,27,677,1138,59.49%,43.59%,1
臺北市,大安區,1388,561,149,710,29,739,1333,55.44%,42.09%,1
臺北市,大安區,1389,517,134,651,35,686,1176,58.33%,43.96%,1
臺北市,大安區,1390,528,185,713,46,759,1311,57.89%,40.27%,1
臺北市,大安區,1391,533,163,696,27,723,1295,55.83%,41.16%,1
臺北市,大安區,1392,596,181,777,51,828,1421,58.27%,41.94%,1
臺北市,大安區,1393,586,156,742,44,786,1409,55.78%,41.59%,1
臺北市,大安區,1394,623,175,798,43,841,1434,58.65%,43.44%,1
臺北市,大安區,1395,543,185,728,55,783,1449,54.04%,37.47%,1
臺北市,大安區,1396,524,175,699,60,759,1284,59.11%,40.81%,1
臺北市,大安區,1397,554,135,689,28,717,1248,57.45%,44.39%,1
臺北市,大安區,1398,553,174,727,29,756,1119,67.56%,49.42%,1
臺北市,大安區,1399,413,88,501,36,537,883,60.82%,46.77%,1
臺北市,大安區,1400,248,75,323,35,358,630,56.83%,39.37%,1
臺北市,大安區,1401,326,130,456,28,484,814,59.46%,40.05%,1
臺北市,中山區,0786,651,173,824,47,871,1522,57.23%,42.77%,1
臺北市,中山區,0787,504,174,678,34,712,1332,53.45%,37.84%,1
臺北市,中山區,0788,584,198,782,54,836,1656,50.48%,35.27%,1
臺北市,中山區,0789,474,188,662,48,710,1367,51.94%,34.67%,1
臺北市,中山區,0790,627,197,824,59,883,1732,50.98%,36.2%,1
臺北市,中山區,0791,673,210,883,54,937,1634,57.34%,41.19%,1
臺北市,中山區,0792,614,239,853,49,902,1650,54.67%,37.21%,1
臺北市,中山區,0793,557,209,766,47,813,1392,58.41%,40.01%,1
臺北市,中山區,0794,501,200,701,25,726,1177,61.68%,42.57%,1
臺北市,中山區,0795,598,214,812,50,862,1477,58.36%,40.49%,1
臺北市,中山區,0796,385,139,524,57,581,1063,54.66%,36.22%,1
臺北市,中山區,0797,510,154,664,49,713,1296,55.02%,39.35%,1
臺北市,中山區,0798,512,164,676,34,710,1330,53.38%,38.5%,1
臺北市,中山區,0799,513,229,742,54,796,1483,53.67%,34.59%,1
臺北市,中山區,0800,610,171,781,40,821,1542,53.24%,39.56%,1
臺北市,中山區,0801,634,196,830,58,888,1710,51.93%,37.08%,1
臺北市,中山區,0802,486,144,630,36,666,1315,50.65%,36.96%,1
臺北市,中山區,0803,483,144,627,70,697,1245,55.98%,38.8%,1
臺北市,中山區,0804,490,157,647,38,685,1262,54.28%,38.83%,1
臺北市,中山區,0805,584,225,809,62,871,1518,57.38%,38.47%,1
臺北市,中山區,0806,610,202,812,64,876,1522,57.56%,40.08%,1
臺北市,中山區,0807,538,224,762,67,829,1580,52.47%,34.05%,1
臺北市,中山區,0808,636,182,818,35,853,1529,55.79%,41.6%,1
臺北市,中山區,0809,505,130,635,50,685,1221,56.1%,41.36%,1
臺北市,中山區,0810,504,186,690,34,724,1221,59.3%,41.28%,1
臺北市,中山區,0811,412,137,549,25,574,1139,50.4%,36.17%,1
臺北市,中山區,0812,519,211,730,77,807,1407,57.36%,36.89%,1
臺北市,中山區,0813,533,178,711,46,757,1321,57.31%,40.35%,1
臺北市,中山區,0814,588,164,752,43,795,1578,50.38%,37.26%,1
臺北市,中山區,0815,666,181,847,48,895,1739,51.47%,38.3%,1
臺北市,中山區,0816,590,207,797,58,855,1637,52.23%,36.04%,1
臺北市,中山區,0817,564,208,772,69,841,1541,54.57%,36.6%,1
臺北市,中山區,0818,492,182,674,49,723,1210,59.75%,40.66%,1
臺北市,中山區,0819,510,169,679,45,724,1331,54.4%,38.32%,1
臺北市,中山區,0820,433,157,590,56,646,1224,52.78%,35.38%,1
臺北市,中山區,0821,672,168,840,61,901,1585,56.85%,42.4%,1
臺北市,中山區,0822,625,235,860,83,943,1523,61.92%,41.04%,1
臺北市,中山區,0823,581,186,767,64,831,1368,60.75%,42.47%,1
臺北市,中山區,0824,818,165,983,55,1038,1805,57.51%,45.32%,1
臺北市,中山區,0825,667,135,802,41,843,1404,60.04%,47.51%,1
臺北市,中山區,0826,756,267,1023,44,1067,1708,62.47%,44.26%,1
臺北市,中山區,0827,661,203,864,53,917,1451,63.2%,45.55%,1
臺北市,中山區,0828,704,268,972,69,1041,1684,61.82%,41.81%,1
臺北市,中山區,0829,688,171,859,32,891,1585,56.21%,43.41%,1
臺北市,中山區,0830,579,185,764,72,836,1391,60.1%,41.62%,1
臺北市,中山區,0831,631,219,850,62,912,1375,66.33%,45.89%,1
臺北市,中山區,0832,651,211,862,12,874,1472,59.38%,44.23%,1
臺北市,中山區,0833,529,178,707,34,741,1327,55.84%,39.86%,1
臺北市,中山區,0834,618,170,788,34,822,1401,58.67%,44.11%,1
臺北市,中山區,0835,608,171,779,56,835,1423,58.68%,42.73%,1
臺北市,中山區,0836,644,237,881,46,927,1569,59.08%,41.05%,1
臺北市,中山區,0837,686,235,921,31,952,1651,57.66%,41.55%,1
臺北市,中山區,0838,640,224,864,22,886,1624,54.56%,39.41%,1
臺北市,中山區,0839,757,230,987,57,1044,1713,60.95%,44.19%,1
臺北市,中山區,0840,745,188,933,53,986,1647,59.87%,45.23%,1
臺北市,中山區,0841,696,223,919,40,959,1762,54.43%,39.5%,1
臺北市,中山區,0842,638,176,814,46,860,1399,61.47%,45.6%,1
臺北市,中山區,0843,677,193,870,47,917,1489,61.58%,45.47%,1
臺北市,中山區,0844,600,149,749,31,780,1269,61.47%,47.28%,1
臺北市,中山區,0845,468,125,593,48,641,998,64.23%,46.89%,1
臺北市,中山區,0846,591,175,766,46,812,1472,55.16%,40.15%,1
臺北市,中山區,0847,545,213,758,49,807,1517,53.2%,35.93%,1
臺北市,中山區,0848,743,107,850,74,924,1704,54.23%,43.6%,1
臺北市,中山區,0849,573,329,902,39,941,1603,58.7%,35.75%,1
臺北市,中山區,0850,519,186,705,80,785,1432,54.82%,36.24%,1
臺北市,中山區,0851,593,223,816,76,892,1500,59.47%,39.53%,1
臺北市,中山區,0852,554,205,759,44,803,1332,60.29%,41.59%,1
臺北市,中山區,0853,597,229,826,52,878,1450,60.55%,41.17%,1
臺北市,中山區,0854,601,202,803,57,860,1434,59.97%,41.91%,1
臺北市,中山區,0855,548,175,723,53,776,1419,54.69%,38.62%,1
臺北市,中山區,0856,482,184,666,49,715,1292,55.34%,37.31%,1
臺北市,中山區,0857,634,140,774,60,834,1526,54.65%,41.55%,1
臺北市,中山區,0858,522,200,722,56,778,1582,49.18%,33%,1
臺北市,中山區,0859,561,204,765,64,829,1588,52.2%,35.33%,1
臺北市,中山區,0860,575,204,779,80,859,1463,58.71%,39.3%,1
臺北市,中山區,0861,535,203,738,50,788,1533,51.4%,34.9%,1
臺北市,中山區,0862,401,111,512,51,563,944,59.64%,42.48%,1
臺北市,中山區,0863,744,272,1016,71,1087,1745,62.29%,42.64%,1
臺北市,中山區,0864,600,186,786,50,836,1679,49.79%,35.74%,1
臺北市,中山區,0865,560,197,757,51,808,3419,23.63%,16.38%,1
臺北市,中山區,0866,567,194,761,69,830,1387,59.84%,40.88%,1
臺北市,中山區,0867,690,226,916,66,982,1672,58.73%,41.27%,1
臺北市,中山區,0868,542,159,701,65,766,1319,58.07%,41.09%,1
臺北市,中山區,0869,547,171,718,54,772,1364,56.6%,40.1%,1
臺北市,中山區,0870,555,202,757,57,814,1461,55.72%,37.99%,1
臺北市,中山區,0871,461,181,642,51,693,1173,59.08%,39.3%,1
臺北市,中山區,0872,431,140,571,60,631,1171,53.89%,36.81%,1
臺北市,中山區,0873,500,200,700,45,745,1310,56.87%,38.17%,1
臺北市,中山區,0874,604,173,777,44,821,1373,59.8%,43.99%,1
臺北市,中山區,0875,541,188,729,33,762,1290,59.07%,41.94%,1
臺北市,中山區,0876,593,177,770,54,824,1346,61.22%,44.06%,1
臺北市,中山區,0877,615,209,824,62,886,1468,60.35%,41.89%,1
臺北市,中山區,0878,496,166,662,40,702,1178,59.59%,42.11%,1
臺北市,中山區,0879,703,225,928,58,986,1654,59.61%,42.5%,1
臺北市,中山區,0880,613,186,799,61,860,1464,58.74%,41.87%,1
臺北市,中山區,0881,553,211,764,29,793,1450,54.69%,38.14%,1
臺北市,中山區,0882,607,210,817,59,876,1534,57.11%,39.57%,1
臺北市,中山區,0883,677,219,896,48,944,1703,55.43%,39.75%,1
臺北市,中山區,0884,671,207,878,76,954,1610,59.25%,41.68%,1
臺北市,中山區,0885,600,241,841,84,925,1653,55.96%,36.3%,1
臺北市,中山區,0886,683,270,953,62,1015,1694,59.92%,40.32%,1
臺北市,中山區,0887,620,233,853,58,911,1623,56.13%,38.2%,1
臺北市,中山區,0888,591,289,880,57,937,1618,57.91%,36.53%,1
臺北市,中山區,0889,605,219,824,50,874,1583,55.21%,38.22%,1
臺北市,中山區,0890,597,294,891,74,965,1605,60.12%,37.2%,1
臺北市,中山區,0891,608,228,836,53,889,1398,63.59%,43.49%,1
臺北市,中山區,0892,708,215,923,59,982,1526,64.35%,46.4%,1
臺北市,中山區,0893,698,160,858,49,907,1555,58.33%,44.89%,1
臺北市,中山區,0894,669,171,840,45,885,1597,55.42%,41.89%,1
臺北市,中山區,0895,626,218,844,87,931,1587,58.66%,39.45%,1
臺北市,中山區,0896,720,178,898,61,959,1587,60.43%,45.37%,1
臺北市,中山區,0897,635,236,871,72,943,1546,61%,41.07%,1
臺北市,中山區,0898,548,148,696,57,753,1322,56.96%,41.45%,1
臺北市,中山區,0899,536,166,702,38,740,1267,58.41%,42.3%,1
臺北市,中山區,0900,512,160,672,16,688,1210,56.86%,42.31%,1
臺北市,中山區,0901,554,132,686,60,746,1295,57.61%,42.78%,1
臺北市,中山區,0902,624,209,833,62,895,1467,61.01%,42.54%,1
臺北市,中山區,0903,719,164,883,52,935,1491,62.71%,48.22%,1
臺北市,中山區,0904,785,151,936,53,989,1516,65.24%,51.78%,1
臺北市,中山區,0905,542,174,716,37,753,1384,54.41%,39.16%,1
臺北市,中山區,0906,556,159,715,31,746,1138,65.55%,48.86%,1
臺北市,中山區,0907,554,207,761,38,799,1513,52.81%,36.62%,1
臺北市,中山區,0908,671,193,864,60,924,1559,59.27%,43.04%,1
臺北市,中山區,0909,588,212,800,76,876,1429,61.3%,41.15%,1
臺北市,中山區,0910,565,168,733,32,765,1245,61.45%,45.38%,1
臺北市,中山區,0911,568,186,754,41,795,1214,65.49%,46.79%,1
臺北市,中山區,0912,579,204,783,42,825,1394,59.18%,41.54%,1
臺北市,中山區,0913,494,173,667,23,690,1336,51.65%,36.98%,1
臺北市,中山區,0914,499,160,659,35,694,1227,56.56%,40.67%,1
臺北市,中山區,0915,582,195,777,42,819,1382,59.26%,42.11%,1
臺北市,中山區,0916,606,165,771,52,823,1436,57.31%,42.2%,1
臺北市,中山區,0917,524,173,697,37,734,1405,52.24%,37.3%,1
臺北市,中山區,0918,564,130,694,34,728,1259,57.82%,44.8%,1
臺北市,中正區,1001,568,168,736,46,782,1308,59.79%,43.43%,1
臺北市,中正區,1002,489,175,664,71,735,1317,55.81%,37.13%,1
臺北市,中正區,1003,499,132,631,30,661,1069,61.83%,46.68%,1
臺北市,中正區,1004,456,131,587,42,629,1128,55.76%,40.43%,1
臺北市,中正區,1005,445,160,605,41,646,1053,61.35%,42.26%,1
臺北市,中正區,1006,448,140,588,17,605,1048,57.73%,42.75%,1
臺北市,中正區,1007,581,110,691,47,738,1297,56.9%,44.8%,1
臺北市,中正區,1008,566,132,698,12,710,1193,59.51%,47.44%,1
臺北市,中正區,1009,694,225,919,51,970,1500,64.67%,46.27%,1
臺北市,中正區,1010,531,175,706,34,740,1346,54.98%,39.45%,1
臺北市,中正區,1011,545,153,698,28,726,1283,56.59%,42.48%,1
臺北市,中正區,1012,574,202,776,48,824,1450,56.83%,39.59%,1
臺北市,中正區,1013,605,208,813,45,858,1433,59.87%,42.22%,1
臺北市,中正區,1014,611,206,817,43,860,1309,65.7%,46.68%,1
臺北市,中正區,1015,617,164,781,33,814,1386,58.73%,44.52%,1
臺北市,中正區,1016,530,156,686,45,731,1201,60.87%,44.13%,1
臺北市,中正區,1017,608,168,776,48,824,1336,61.68%,45.51%,1
臺北市,中正區,1018,592,187,779,51,830,1358,61.12%,43.59%,1
臺北市,中正區,1019,495,170,665,49,714,1177,60.66%,42.06%,1
臺北市,中正區,1020,579,178,757,29,786,1236,63.59%,46.84%,1
臺北市,中正區,1021,619,192,811,44,855,1478,57.85%,41.88%,1
臺北市,中正區,1022,628,191,819,31,850,1474,57.67%,42.61%,1
臺北市,中正區,1023,493,154,647,43,690,1172,58.87%,42.06%,1
臺北市,中正區,1024,555,182,737,37,774,1310,59.08%,42.37%,1
臺北市,中正區,1025,540,176,716,41,757,1263,59.94%,42.76%,1
臺北市,中正區,1026,484,179,663,35,698,1169,59.71%,41.4%,1
臺北市,中正區,1027,602,160,762,30,792,1391,56.94%,43.28%,1
臺北市,中正區,1028,476,173,649,27,676,1201,56.29%,39.63%,1
臺北市,中正區,1029,581,160,741,40,781,1324,58.99%,43.88%,1
臺北市,中正區,1030,475,151,626,68,694,1216,57.07%,39.06%,1
臺北市,中正區,1031,469,163,632,50,682,1183,57.65%,39.64%,1
臺北市,中正區,1032,619,204,823,63,886,1469,60.31%,42.14%,1
臺北市,中正區,1033,595,171,766,55,821,1411,58.19%,42.17%,1
臺北市,中正區,1034,574,190,764,82,846,1398,60.52%,41.06%,1
臺北市,中正區,1035,608,162,770,70,840,1479,56.8%,41.11%,1
臺北市,中正區,1036,652,177,829,80,909,1620,56.11%,40.25%,1
臺北市,中正區,1037,459,112,571,18,589,1041,56.58%,44.09%,1
臺北市,中正區,1038,419,145,564,18,582,1056,55.11%,39.68%,1
臺北市,中正區,1039,503,139,642,41,683,1063,64.25%,47.32%,1
臺北市,中正區,1040,507,169,676,65,741,1591,46.57%,31.87%,1
臺北市,中正區,1041,484,149,633,75,708,1502,47.14%,32.22%,1
臺北市,中正區,1042,525,136,661,51,712,1331,53.49%,39.44%,1
臺北市,中正區,1043,583,176,759,58,817,1441,56.7%,40.46%,1
臺北市,中正區,1044,582,166,748,40,788,1273,61.9%,45.72%,1
臺北市,中正區,1045,473,169,642,48,690,1133,60.9%,41.75%,1
臺北市,中正區,1046,526,128,654,38,692,1156,59.86%,45.5%,1
臺北市,中正區,1047,558,186,744,54,798,1377,57.95%,40.52%,1
臺北市,中正區,1048,543,164,707,63,770,1266,60.82%,42.89%,1
臺北市,中正區,1049,538,132,670,41,711,1111,64%,48.42%,1
臺北市,中正區,1050,511,122,633,25,658,1124,58.54%,45.46%,1
臺北市,中正區,1051,608,193,801,39,840,1373,61.18%,44.28%,1
臺北市,中正區,1052,624,166,790,39,829,1351,61.36%,46.19%,1
臺北市,中正區,1053,653,195,848,34,882,1495,59%,43.68%,1
臺北市,中正區,1054,666,203,869,52,921,1436,64.14%,46.38%,1
臺北市,中正區,1055,660,175,835,26,861,1516,56.79%,43.54%,1
臺北市,中正區,1056,596,165,761,37,798,1374,58.08%,43.38%,1
臺北市,中正區,1057,712,80,792,42,834,1522,54.8%,46.78%,1
臺北市,中正區,1058,580,178,758,42,800,1336,59.88%,43.41%,1
臺北市,中正區,1059,671,204,875,36,911,1551,58.74%,43.26%,1
臺北市,中正區,1060,694,210,904,49,953,1594,59.79%,43.54%,1
臺北市,中正區,1061,616,197,813,62,875,1503,58.22%,40.98%,1
臺北市,中正區,1062,649,185,834,28,862,1455,59.24%,44.6%,1
臺北市,中正區,1063,644,176,820,20,840,1439,58.37%,44.75%,1
臺北市,中正區,1064,642,172,814,43,857,1469,58.34%,43.7%,1
臺北市,中正區,1065,689,139,828,27,855,1430,59.79%,48.18%,1
臺北市,中正區,1066,659,182,841,46,887,1444,61.43%,45.64%,1
臺北市,中正區,1067,555,154,709,15,724,1254,57.74%,44.26%,1
臺北市,中正區,1068,390,136,526,45,571,932,61.27%,41.85%,1
臺北市,中正區,1069,453,149,602,42,644,1055,61.04%,42.94%,1
臺北市,中正區,1070,516,167,683,38,721,1226,58.81%,42.09%,1
臺北市,中正區,1071,548,154,702,36,738,1390,53.09%,39.42%,1
臺北市,中正區,1072,576,163,739,34,773,1336,57.86%,43.11%,1
臺北市,中正區,1073,528,182,710,41,751,1419,52.92%,37.21%,1
臺北市,中正區,1074,591,200,791,49,840,1361,61.72%,43.42%,1
臺北市,中正區,1075,676,199,875,40,915,2520,36.31%,26.83%,1
臺北市,中正區,1076,537,153,690,14,704,1224,57.52%,43.87%,1
臺北市,中正區,1077,505,158,663,5,668,1272,52.52%,39.7%,1
臺北市,中正區,1078,541,232,773,39,812,1400,58%,38.64%,1
臺北市,中正區,1079,500,184,684,35,719,1319,54.51%,37.91%,1
臺北市,中正區,1080,564,167,731,35,766,1232,62.18%,45.78%,1
臺北市,中正區,1081,575,172,747,47,794,1265,62.77%,45.45%,1
臺北市,中正區,1082,515,128,643,25,668,1055,63.32%,48.82%,1
臺北市,中正區,1083,409,130,539,27,566,954,59.33%,42.87%,1
臺北市,中正區,1084,446,135,581,32,613,1018,60.22%,43.81%,1
臺北市,中正區,1085,550,215,765,37,802,1431,56.04%,38.43%,1
臺北市,中正區,1086,465,162,627,42,669,1271,52.64%,36.59%,1
臺北市,中正區,1087,424,147,571,43,614,983,62.46%,43.13%,1
臺北市,中正區,1088,657,205,862,36,898,1594,56.34%,41.22%,1
臺北市,中正區,1089,704,187,891,42,933,1565,59.62%,44.98%,1
臺北市,中正區,1090,709,212,921,36,957,1650,58%,42.97%,1
臺北市,中正區,1091,645,197,842,38,880,1600,55%,40.31%,1
臺北市,中正區,1092,578,177,755,21,776,1391,55.79%,41.55%,1
臺北市,中正區,1093,716,241,957,43,1000,1769,56.53%,40.47%,1
臺北市,中正區,1094,606,220,826,47,873,1487,58.71%,40.75%,1
臺北市,中正區,1095,591,170,761,23,784,1291,60.73%,45.78%,1
臺北市,中正區,1096,567,184,751,26,777,1289,60.28%,43.99%,1
臺北市,大同區,0919,499,178,677,73,750,1261,59.48%,39.57%,1
臺北市,大同區,0920,556,225,781,49,830,1352,61.39%,41.12%,1
臺北市,大同區,0921,574,209,783,53,836,1462,57.18%,39.26%,1
臺北市,大同區,0922,585,220,805,70,875,1510,57.95%,38.74%,1
臺北市,大同區,0923,552,196,748,38,786,1496,52.54%,36.9%,1
臺北市,大同區,0924,513,180,693,59,752,1329,56.58%,38.6%,1
臺北市,大同區,0925,507,189,696,72,768,1307,58.76%,38.79%,1
臺北市,大同區,0926,436,138,574,53,627,1065,58.87%,40.94%,1
臺北市,大同區,0927,435,149,584,28,612,1085,56.41%,40.09%,1
臺北市,大同區,0928,414,192,606,52,658,1047,62.85%,39.54%,1
臺北市,大同區,0929,452,157,609,33,642,1215,52.84%,37.2%,1
臺北市,大同區,0930,440,206,646,37,683,1117,61.15%,39.39%,1
臺北市,大同區,0931,501,182,683,51,734,1186,61.89%,42.24%,1
臺北市,大同區,0932,447,212,659,64,723,1185,61.01%,37.72%,1
臺北市,大同區,0933,557,175,732,35,767,1359,56.44%,40.99%,1
臺北市,大同區,0934,543,150,693,28,721,1273,56.64%,42.66%,1
臺北市,大同區,0935,538,214,752,47,799,1291,61.89%,41.67%,1
臺北市,大同區,0936,500,168,668,48,716,1288,55.59%,38.82%,1
臺北市,大同區,0937,545,191,736,43,779,1245,62.57%,43.78%,1
臺北市,大同區,0938,533,207,740,59,799,1261,63.36%,42.27%,1
臺北市,大同區,0939,514,186,700,33,733,1348,54.38%,38.13%,1
臺北市,大同區,0940,638,256,894,86,980,1676,58.47%,38.07%,1
臺北市,大同區,0941,578,160,738,64,802,1311,61.17%,44.09%,1
臺北市,大同區,0942,515,192,707,84,791,1316,60.11%,39.13%,1
臺北市,大同區,0943,534,230,764,69,833,1409,59.12%,37.9%,1
臺北市,大同區,0944,607,208,815,56,871,1436,60.65%,42.27%,1
臺北市,大同區,0945,529,249,778,58,836,1408,59.38%,37.57%,1
臺北市,大同區,0946,485,207,692,40,732,1276,57.37%,38.01%,1
臺北市,大同區,0947,485,123,608,20,628,1110,56.58%,43.69%,1
臺北市,大同區,0948,533,191,724,30,754,1324,56.95%,40.26%,1
臺北市,大同區,0949,380,166,546,42,588,1016,57.87%,37.4%,1
臺北市,大同區,0950,453,146,599,42,641,1028,62.35%,44.07%,1
臺北市,大同區,0951,490,155,645,56,701,1158,60.54%,42.31%,1
臺北市,大同區,0952,501,144,645,48,693,1138,60.9%,44.02%,1
臺北市,大同區,0953,527,150,677,53,730,1214,60.13%,43.41%,1
臺北市,大同區,0954,433,153,586,32,618,1090,56.7%,39.72%,1
臺北市,大同區,0955,612,179,791,39,830,1305,63.6%,46.9%,1
臺北市,大同區,0956,458,132,590,33,623,1167,53.38%,39.25%,1
臺北市,大同區,0957,448,180,628,46,674,1148,58.71%,39.02%,1
臺北市,大同區,0958,497,197,694,53,747,1203,62.09%,41.31%,1
臺北市,大同區,0959,558,193,751,42,793,1441,55.03%,38.72%,1
臺北市,大同區,0960,544,210,754,63,817,1315,62.13%,41.37%,1
臺北市,大同區,0961,547,180,727,61,788,1393,56.57%,39.27%,1
臺北市,大同區,0962,520,199,719,46,765,1278,59.86%,40.69%,1
臺北市,大同區,0963,463,144,607,57,664,1246,53.29%,37.16%,1
臺北市,大同區,0964,427,163,590,66,656,1142,57.44%,37.39%,1
臺北市,大同區,0965,549,200,749,63,812,1336,60.78%,41.09%,1
臺北市,大同區,0966,549,215,764,70,834,1363,61.19%,40.28%,1
臺北市,大同區,0967,677,132,809,18,827,1476,56.03%,45.87%,1
臺北市,大同區,0968,553,217,770,56,826,1418,58.25%,39%,1
臺北市,大同區,0969,575,176,751,33,784,1460,53.7%,39.38%,1
臺北市,大同區,0970,383,172,555,61,616,1222,50.41%,31.34%,1
臺北市,大同區,0971,364,167,531,93,624,1246,50.08%,29.21%,1
臺北市,大同區,0972,487,229,716,68,784,1256,62.42%,38.77%,1
臺北市,大同區,0973,527,187,714,29,743,1289,57.64%,40.88%,1
臺北市,大同區,0974,491,190,681,21,702,1340,52.39%,36.64%,1
臺北市,大同區,0975,592,192,784,62,846,1555,54.41%,38.07%,1
臺北市,大同區,0976,584,157,741,83,824,2459,33.51%,23.75%,1
臺北市,大同區,0977,326,153,479,51,530,1108,47.83%,29.42%,1
臺北市,大同區,0978,305,124,429,56,485,867,55.94%,35.18%,1
臺北市,大同區,0979,561,112,673,53,726,1329,54.63%,42.21%,1
臺北市,大同區,0980,427,192,619,37,656,1162,56.45%,36.75%,1
臺北市,大同區,0981,520,197,717,70,787,1434,54.88%,36.26%,1
臺北市,大同區,0982,528,205,733,56,789,1351,58.4%,39.08%,1
臺北市,大同區,0983,548,206,754,52,806,1531,52.65%,35.79%,1
臺北市,大同區,0984,525,203,728,15,743,1507,49.3%,34.84%,1
臺北市,大同區,0985,569,204,773,56,829,1488,55.71%,38.24%,1
臺北市,大同區,0986,559,212,771,82,853,1384,61.63%,40.39%,1
臺北市,大同區,0987,571,187,758,88,846,1460,57.95%,39.11%,1
臺北市,大同區,0988,588,191,779,59,838,1371,61.12%,42.89%,1
臺北市,大同區,0989,550,199,749,33,782,1439,54.34%,38.22%,1
臺北市,大同區,0990,551,200,751,71,822,1376,59.74%,40.04%,1
臺北市,大同區,0991,526,166,692,83,775,1366,56.73%,38.51%,1
臺北市,大同區,0992,519,204,723,64,787,1218,64.61%,42.61%,1
臺北市,大同區,0993,517,154,671,57,728,1235,58.95%,41.86%,1
臺北市,大同區,0994,525,170,695,27,722,1364,52.93%,38.49%,1
臺北市,大同區,0995,600,132,732,71,803,1408,57.03%,42.61%,1
臺北市,大同區,0996,575,214,789,65,854,1450,58.9%,39.66%,1
臺北市,大同區,0997,613,209,822,70,892,1429,62.42%,42.9%,1
臺北市,大同區,0998,477,169,646,59,705,1170,60.26%,40.77%,1
臺北市,大同區,0999,465,192,657,78,735,1245,59.04%,37.35%,1
臺北市,大同區,1000,502,200,702,87,789,1215,64.94%,41.32%,1
臺北市,萬華區,1097,531,191,722,57,779,1305,59.69%,40.69%,1
臺北市,萬華區,1098,404,136,540,65,605,1183,51.14%,34.15%,1
臺北市,萬華區,1099,468,132,600,36,636,1176,54.08%,39.8%,1
臺北市,萬華區,1100,421,136,557,31,588,1169,50.3%,36.01%,1
臺北市,萬華區,1101,530,162,692,47,739,1457,50.72%,36.38%,1
臺北市,萬華區,1102,506,175,681,73,754,1563,48.24%,32.37%,1
臺北市,萬華區,1103,618,184,802,41,843,1771,47.6%,34.9%,1
臺北市,萬華區,1104,569,214,783,51,834,1615,51.64%,35.23%,1
臺北市,萬華區,1105,531,213,744,82,826,1478,55.89%,35.93%,1
臺北市,萬華區,1106,550,184,734,38,772,1462,52.8%,37.62%,1
臺北市,萬華區,1107,515,150,665,70,735,1507,48.77%,34.17%,1
臺北市,萬華區,1108,531,198,729,62,791,1347,58.72%,39.42%,1
臺北市,萬華區,1109,502,166,668,53,721,1367,52.74%,36.72%,1
臺北市,萬華區,1110,543,185,728,56,784,1277,61.39%,42.52%,1
臺北市,萬華區,1111,547,213,760,44,804,1395,57.63%,39.21%,1
臺北市,萬華區,1112,516,200,716,61,777,1450,53.59%,35.59%,1
臺北市,萬華區,1113,462,178,640,52,692,1340,51.64%,34.48%,1
臺北市,萬華區,1114,428,185,613,53,666,1242,53.62%,34.46%,1
臺北市,萬華區,1115,464,175,639,72,711,1286,55.29%,36.08%,1
臺北市,萬華區,1116,505,150,655,51,706,1324,53.32%,38.14%,1
臺北市,萬華區,1117,578,204,782,81,863,1619,53.3%,35.7%,1
臺北市,萬華區,1118,426,192,618,62,680,1352,50.3%,31.51%,1
臺北市,萬華區,1119,500,185,685,52,737,1440,51.18%,34.72%,1
臺北市,萬華區,1120,494,174,668,46,714,1194,59.8%,41.37%,1
臺北市,萬華區,1121,499,132,631,61,692,1083,63.9%,46.08%,1
臺北市,萬華區,1122,450,165,615,65,680,1237,54.97%,36.38%,1
臺北市,萬華區,1123,611,196,807,64,871,1625,53.6%,37.6%,1
臺北市,萬華區,1124,529,199,728,73,801,1324,60.5%,39.95%,1
臺北市,萬華區,1125,549,178,727,66,793,1352,58.65%,40.61%,1
臺北市,萬華區,1126,477,196,673,62,735,2630,27.95%,18.14%,1
臺北市,萬華區,1127,622,216,838,67,905,1504,60.17%,41.36%,1
臺北市,萬華區,1128,537,178,715,58,773,1425,54.25%,37.68%,1
臺北市,萬華區,1129,554,183,737,68,805,1591,50.6%,34.82%,1
臺北市,萬華區,1130,559,163,722,85,807,1474,54.75%,37.92%,1
臺北市,萬華區,1131,575,182,757,84,841,1612,52.17%,35.67%,1
臺北市,萬華區,1132,558,180,738,58,796,1447,55.01%,38.56%,1
臺北市,萬華區,1133,628,182,810,57,867,1491,58.15%,42.12%,1
臺北市,萬華區,1134,642,193,835,47,882,1500,58.8%,42.8%,1
臺北市,萬華區,1135,638,221,859,67,926,1582,58.53%,40.33%,1
臺北市,萬華區,1136,589,190,779,55,834,1623,51.39%,36.29%,1
臺北市,萬華區,1137,456,165,621,34,655,1228,53.34%,37.13%,1
臺北市,萬華區,1138,472,191,663,59,722,1268,56.94%,37.22%,1
臺北市,萬華區,1139,496,176,672,55,727,1207,60.23%,41.09%,1
臺北市,萬華區,1140,514,158,672,42,714,1188,60.1%,43.27%,1
臺北市,萬華區,1141,564,175,739,50,789,1474,53.53%,38.26%,1
臺北市,萬華區,1142,445,119,564,30,594,1304,45.55%,34.13%,1
臺北市,萬華區,1143,303,100,403,54,457,1082,42.24%,28%,1
臺北市,萬華區,1144,336,158,494,49,543,1052,51.62%,31.94%,1
臺北市,萬華區,1145,438,148,586,49,635,1135,55.95%,38.59%,1
臺北市,萬華區,1146,453,177,630,63,693,1225,56.57%,36.98%,1
臺北市,萬華區,1147,584,184,768,65,833,1583,52.62%,36.89%,1
臺北市,萬華區,1148,548,179,727,57,784,1403,55.88%,39.06%,1
臺北市,萬華區,1149,549,188,737,74,811,1406,57.68%,39.05%,1
臺北市,萬華區,1150,555,196,751,62,813,1401,58.03%,39.61%,1
臺北市,萬華區,1151,463,174,637,68,705,1188,59.34%,38.97%,1
臺北市,萬華區,1152,570,195,765,82,847,1597,53.04%,35.69%,1
臺北市,萬華區,1153,537,192,729,65,794,1290,61.55%,41.63%,1
臺北市,萬華區,1154,580,221,801,31,832,1746,47.65%,33.22%,1
臺北市,萬華區,1155,531,172,703,43,746,1595,46.77%,33.29%,1
臺北市,萬華區,1156,602,229,831,100,931,1701,54.73%,35.39%,1
臺北市,萬華區,1157,399,181,580,85,665,1339,49.66%,29.8%,1
臺北市,萬華區,1158,497,147,644,85,729,1484,49.12%,33.49%,1
臺北市,萬華區,1159,648,201,849,79,928,1604,57.86%,40.4%,1
臺北市,萬華區,1160,489,155,644,46,690,1197,57.64%,40.85%,1
臺北市,萬華區,1161,482,177,659,79,738,1347,54.79%,35.78%,1
臺北市,萬華區,1162,582,161,743,36,779,1223,63.7%,47.59%,1
臺北市,萬華區,1163,437,134,571,31,602,1036,58.11%,42.18%,1
臺北市,萬華區,1164,448,160,608,59,667,1035,64.44%,43.29%,1
臺北市,萬華區,1165,512,142,654,52,706,1141,61.88%,44.87%,1
臺北市,萬華區,1166,540,163,703,35,738,1271,58.06%,42.49%,1
臺北市,萬華區,1167,549,170,719,93,812,1328,61.14%,41.34%,1
臺北市,萬華區,1168,531,175,706,47,753,1286,58.55%,41.29%,1
臺北市,萬華區,1169,675,224,899,86,985,1679,58.67%,40.2%,1
臺北市,萬華區,1170,616,201,817,89,906,1619,55.96%,38.05%,1
臺北市,萬華區,1171,562,188,750,61,811,1625,49.91%,34.58%,1
臺北市,萬華區,1172,680,194,874,70,944,1623,58.16%,41.9%,1
臺北市,萬華區,1173,488,163,651,71,722,1280,56.41%,38.13%,1
臺北市,萬華區,1174,634,204,838,64,902,1608,56.09%,39.43%,1
臺北市,萬華區,1175,592,194,786,64,850,1453,58.5%,40.74%,1
臺北市,萬華區,1176,642,209,851,47,898,1472,61.01%,43.61%,1
臺北市,萬華區,1177,563,195,758,33,791,1373,57.61%,41.01%,1
臺北市,萬華區,1178,548,156,704,68,772,1394,55.38%,39.31%,1
臺北市,萬華區,1179,537,153,690,40,730,1427,51.16%,37.63%,1
臺北市,萬華區,1180,568,206,774,52,826,1342,61.55%,42.32%,1
臺北市,萬華區,1181,653,194,847,83,930,1569,59.27%,41.62%,1
臺北市,萬華區,1182,520,172,692,58,750,1514,49.54%,34.35%,1
臺北市,萬華區,1183,625,157,782,40,822,1720,47.79%,36.34%,1
臺北市,萬華區,1184,645,189,834,70,904,1461,61.88%,44.15%,1
臺北市,萬華區,1185,480,155,635,43,678,1264,53.64%,37.97%,1
臺北市,萬華區,1186,567,194,761,67,828,1334,62.07%,42.5%,1
臺北市,萬華區,1187,600,180,780,42,822,1446,56.85%,41.49%,1
臺北市,萬華區,1188,508,137,645,38,683,1307,52.26%,38.87%,1
臺北市,萬華區,1189,564,180,744,90,834,1420,58.73%,39.72%,1
臺北市,萬華區,1190,522,170,692,40,732,1427,51.3%,36.58%,1
臺北市,萬華區,1191,385,116,501,41,542,956,56.69%,40.27%,1
臺北市,萬華區,1192,562,174,736,58,794,1352,58.73%,41.57%,1
臺北市,萬華區,1193,601,137,738,37,775,1370,56.57%,43.87%,1
臺北市,萬華區,1194,587,105,692,40,732,1222,59.9%,48.04%,1
臺北市,萬華區,1195,596,137,733,42,775,1375,56.36%,43.35%,1
臺北市,萬華區,1196,641,155,796,58,854,1463,58.37%,43.81%,1
臺北市,萬華區,1197,577,163,740,38,778,1527,50.95%,37.79%,1
臺北市,萬華區,1198,616,135,751,52,803,1485,54.07%,41.48%,1
臺北市,萬華區,1199,813,120,933,48,981,1591,61.66%,51.1%,1
臺北市,萬華區,1200,724,144,868,29,897,1394,64.35%,51.94%,1
臺北市,萬華區,1201,642,188,830,41,871,1522,57.23%,42.18%,1
臺北市,萬華區,1202,819,144,963,39,1002,1661,60.33%,49.31%,1
臺北市,萬華區,1203,757,169,926,36,962,1561,61.63%,48.49%,1
臺北市,萬華區,1204,695,159,854,47,901,1406,64.08%,49.43%,1
臺北市,萬華區,1205,510,148,658,37,695,1498,46.4%,34.05%,1
臺北市,萬華區,1206,486,153,639,79,718,1478,48.58%,32.88%,1
臺北市,萬華區,1207,464,139,603,55,658,1170,56.24%,39.66%,1
臺北市,萬華區,1208,628,128,756,54,810,1376,58.87%,45.64%,1
臺北市,萬華區,1209,486,103,589,25,614,1093,56.18%,44.46%,1
臺北市,萬華區,1210,493,131,624,61,685,1084,63.19%,45.48%,1
臺北市,萬華區,1211,488,124,612,65,677,1119,60.5%,43.61%,1
臺北市,萬華區,1212,654,167,821,37,858,1381,62.13%,47.36%,1
臺北市,萬華區,1213,602,170,772,34,806,1396,57.74%,43.12%,1
臺北市,文山區,1402,624,200,824,39,863,1539,56.08%,40.55%,1
臺北市,文山區,1403,602,176,778,41,819,1548,52.91%,38.89%,1
臺北市,文山區,1404,615,213,828,73,901,1493,60.35%,41.19%,1
臺北市,文山區,1405,732,207,939,57,996,1648,60.44%,44.42%,1
臺北市,文山區,1406,686,161,847,46,893,1544,57.84%,44.43%,1
臺北市,文山區,1407,676,176,852,57,909,1557,58.38%,43.42%,1
臺北市,文山區,1408,642,154,796,53,849,1514,56.08%,42.4%,1
臺北市,文山區,1409,744,183,927,57,984,1540,63.9%,48.31%,1
臺北市,文山區,1410,675,192,867,40,907,1466,61.87%,46.04%,1
臺北市,文山區,1411,690,164,854,42,896,1444,62.05%,47.78%,1
臺北市,文山區,1412,635,172,807,79,886,1455,60.89%,43.64%,1
臺北市,文山區,1413,597,162,759,51,810,1440,56.25%,41.46%,1
臺北市,文山區,1414,642,168,810,57,867,1398,62.02%,45.92%,1
臺北市,文山區,1415,574,164,738,27,765,1412,54.18%,40.65%,1
臺北市,文山區,1416,597,180,777,51,828,1426,58.06%,41.87%,1
臺北市,文山區,1417,627,181,808,45,853,1437,59.36%,43.63%,1
臺北市,文山區,1418,593,166,759,49,808,1340,60.3%,44.25%,1
臺北市,文山區,1419,682,181,863,27,890,1568,56.76%,43.49%,1
臺北市,文山區,1420,587,167,754,27,781,1372,56.92%,42.78%,1
臺北市,文山區,1421,451,123,574,29,603,1046,57.65%,43.12%,1
臺北市,文山區,1422,557,165,722,40,762,1274,59.81%,43.72%,1
臺北市,文山區,1423,600,144,744,32,776,1324,58.61%,45.32%,1
臺北市,文山區,1424,725,226,951,54,1005,1722,58.36%,42.1%,1
臺北市,文山區,1425,762,217,979,62,1041,1737,59.93%,43.87%,1
臺北市,文山區,1426,658,174,832,20,852,1370,62.19%,48.03%,1
臺北市,文山區,1427,638,191,829,51,880,1495,58.86%,42.68%,1
臺北市,文山區,1428,569,173,742,59,801,1328,60.32%,42.85%,1
臺北市,文山區,1429,490,169,659,50,709,1138,62.3%,43.06%,1
臺北市,文山區,1430,636,198,834,38,872,1471,59.28%,43.24%,1
臺北市,文山區,1431,531,145,676,35,711,1144,62.15%,46.42%,1
臺北市,文山區,1432,551,162,713,50,763,1176,64.88%,46.85%,1
臺北市,文山區,1433,554,161,715,45,760,1212,62.71%,45.71%,1
臺北市,文山區,1434,575,143,718,32,750,1214,61.78%,47.36%,1
臺北市,文山區,1435,474,160,634,41,675,1170,57.69%,40.51%,1
臺北市,文山區,1436,573,175,748,52,800,1308,61.16%,43.81%,1
臺北市,文山區,1437,511,156,667,56,723,1190,60.76%,42.94%,1
臺北市,文山區,1438,504,121,625,45,670,1110,60.36%,45.41%,1
臺北市,文山區,1439,694,141,835,55,890,1512,58.86%,45.9%,1
臺北市,文山區,1440,659,135,794,63,857,1387,61.79%,47.51%,1
臺北市,文山區,1441,600,171,771,43,814,1355,60.07%,44.28%,1
臺北市,文山區,1442,570,198,768,56,824,1370,60.15%,41.61%,1
臺北市,文山區,1443,661,164,825,63,888,1484,59.84%,44.54%,1
臺北市,文山區,1444,768,230,998,53,1051,1786,58.85%,43%,1
臺北市,文山區,1445,560,148,708,57,765,1260,60.71%,44.44%,1
臺北市,文山區,1446,583,165,748,30,778,1194,65.16%,48.83%,1
臺北市,文山區,1447,623,190,813,47,860,1444,59.56%,43.14%,1
臺北市,文山區,1448,502,139,641,55,696,1495,46.56%,33.58%,1
臺北市,文山區,1449,696,132,828,59,887,1446,61.34%,48.13%,1
臺北市,文山區,1450,624,165,789,65,854,1450,58.9%,43.03%,1
臺北市,文山區,1451,672,194,866,49,915,1486,61.57%,45.22%,1
臺北市,文山區,1452,592,147,739,34,773,1259,61.4%,47.02%,1
臺北市,文山區,1453,632,143,775,26,801,1317,60.82%,47.99%,1
臺北市,文山區,1454,616,182,798,34,832,1321,62.98%,46.63%,1
臺北市,文山區,1455,643,171,814,49,863,1475,58.51%,43.59%,1
臺北市,文山區,1456,538,140,678,55,733,1271,57.67%,42.33%,1
臺北市,文山區,1457,722,203,925,43,968,1609,60.16%,44.87%,1
臺北市,文山區,1458,642,152,794,35,829,1501,55.23%,42.77%,1
臺北市,文山區,1459,392,115,507,44,551,997,55.27%,39.32%,1
臺北市,文山區,1460,517,130,647,39,686,1052,65.21%,49.14%,1
臺北市,文山區,1461,584,150,734,29,763,1247,61.19%,46.83%,1
臺北市,文山區,1462,520,157,677,46,723,1167,61.95%,44.56%,1
臺北市,文山區,1463,578,161,739,31,770,1280,60.16%,45.16%,1
臺北市,文山區,1464,567,123,690,26,716,1153,62.1%,49.18%,1
臺北市,文山區,1465,734,180,914,42,956,1557,61.4%,47.14%,1
臺北市,文山區,1466,654,160,814,46,860,1444,59.56%,45.29%,1
臺北市,文山區,1467,713,179,892,41,933,1459,63.95%,48.87%,1
臺北市,文山區,1468,675,156,831,41,872,1357,64.26%,49.74%,1
臺北市,文山區,1469,616,137,753,40,793,1194,66.42%,51.59%,1
臺北市,文山區,1470,543,160,703,60,763,1184,64.44%,45.86%,1
臺北市,文山區,1471,537,135,672,46,718,1119,64.16%,47.99%,1
臺北市,文山區,1472,615,125,740,53,793,1350,58.74%,45.56%,1
臺北市,文山區,1473,629,166,795,48,843,1502,56.13%,41.88%,1
臺北市,文山區,1474,666,185,851,58,909,1511,60.16%,44.08%,1
臺北市,文山區,1475,746,184,930,37,967,1481,65.29%,50.37%,1
臺北市,文山區,1476,721,175,896,30,926,1477,62.69%,48.82%,1
臺北市,文山區,1477,606,157,763,42,805,1294,62.21%,46.83%,1
臺北市,文山區,1478,527,142,669,40,709,1040,68.17%,50.67%,1
臺北市,文山區,1479,624,166,790,40,830,1323,62.74%,47.17%,1
臺北市,文山區,1480,516,153,669,48,717,1153,62.19%,44.75%,1
臺北市,文山區,1481,690,154,844,52,896,1525,58.75%,45.25%,1
臺北市,文山區,1482,592,149,741,49,790,1412,55.95%,41.93%,1
臺北市,文山區,1483,644,225,869,60,929,1473,63.07%,43.72%,1
臺北市,文山區,1484,658,205,863,29,892,1486,60.03%,44.28%,1
臺北市,文山區,1485,804,156,960,53,1013,1616,62.69%,49.75%,1
臺北市,文山區,1486,709,184,893,53,946,1489,63.53%,47.62%,1
臺北市,文山區,1487,633,157,790,52,842,1414,59.55%,44.77%,1
臺北市,文山區,1488,711,203,914,52,966,1494,64.66%,47.59%,1
臺北市,文山區,1489,698,198,896,60,956,1547,61.8%,45.12%,1
臺北市,文山區,1490,691,221,912,58,970,1587,61.12%,43.54%,1
臺北市,文山區,1491,768,162,930,29,959,1515,63.3%,50.69%,1
臺北市,文山區,1492,753,179,932,53,985,1573,62.62%,47.87%,1
臺北市,文山區,1493,719,199,918,42,960,1542,62.26%,46.63%,1
臺北市,文山區,1494,598,155,753,58,811,1465,55.36%,40.82%,1
臺北市,文山區,1495,219,88,307,35,342,699,48.93%,31.33%,1
臺北市,文山區,1496,504,148,652,56,708,1372,51.6%,36.73%,1
臺北市,文山區,1497,555,140,695,50,745,1448,51.45%,38.33%,1
臺北市,文山區,1498,666,183,849,60,909,1548,58.72%,43.02%,1
臺北市,文山區,1499,683,184,867,36,903,1501,60.16%,45.5%,1
臺北市,文山區,1500,747,166,913,30,943,1560,60.45%,47.88%,1
臺北市,文山區,1501,690,184,874,44,918,1567,58.58%,44.03%,1
臺北市,文山區,1502,702,170,872,45,917,1554,59.01%,45.17%,1
臺北市,文山區,1503,668,189,857,59,916,1544,59.33%,43.26%,1
臺北市,文山區,1504,704,185,889,44,933,1528,61.06%,46.07%,1
臺北市,文山區,1505,757,174,931,31,962,1543,62.35%,49.06%,1
臺北市,文山區,1506,699,204,903,55,958,2754,34.79%,25.38%,1
臺北市,文山區,1507,631,95,726,66,792,1709,46.34%,36.92%,1
臺北市,文山區,1508,623,180,803,68,871,1515,57.49%,41.12%,1
臺北市,文山區,1509,612,173,785,75,860,1571,54.74%,38.96%,1
臺北市,文山區,1510,661,175,836,71,907,1578,57.48%,41.89%,1
臺北市,文山區,1511,590,171,761,64,825,1454,56.74%,40.58%,1
臺北市,文山區,1512,644,157,801,56,857,1436,59.68%,44.85%,1
臺北市,文山區,1513,657,164,821,55,876,1402,62.48%,46.86%,1
臺北市,文山區,1514,516,139,655,44,699,1117,62.58%,46.2%,1
臺北市,文山區,1515,453,123,576,70,646,1094,59.05%,41.41%,1
臺北市,文山區,1516,505,140,645,43,688,1070,64.3%,47.2%,1
臺北市,文山區,1517,665,143,808,38,846,1319,64.14%,50.42%,1
臺北市,文山區,1518,600,148,748,38,786,1226,64.11%,48.94%,1
臺北市,文山區,1519,600,140,740,44,784,1385,56.61%,43.32%,1
臺北市,文山區,1520,650,162,812,56,868,1416,61.3%,45.9%,1
臺北市,文山區,1521,699,150,849,53,902,1412,63.88%,49.5%,1
臺北市,文山區,1522,653,174,827,53,880,1535,57.33%,42.54%,1
臺北市,文山區,1523,793,99,892,56,948,1654,57.32%,47.94%,1
臺北市,文山區,1524,556,142,698,31,729,1156,63.06%,48.1%,1
臺北市,文山區,1525,649,100,749,33,782,1231,63.53%,52.72%,1
臺北市,文山區,1526,538,140,678,40,718,1218,58.95%,44.17%,1
臺北市,文山區,1527,580,132,712,41,753,1176,64.03%,49.32%,1
臺北市,文山區,1528,623,95,718,49,767,1392,55.1%,44.76%,1
臺北市,文山區,1529,583,165,748,80,828,1323,62.59%,44.07%,1
臺北市,文山區,1530,537,163,700,45,745,1297,57.44%,41.4%,1
臺北市,文山區,1531,599,153,752,61,813,1296,62.73%,46.22%,1
臺北市,文山區,1532,676,201,877,55,932,1613,57.78%,41.91%,1
臺北市,文山區,1533,753,206,959,69,1028,1697,60.58%,44.37%,1
臺北市,文山區,1534,680,194,874,71,945,1579,59.85%,43.07%,1
臺北市,文山區,1535,639,164,803,39,842,1320,63.79%,48.41%,1
臺北市,文山區,1536,615,170,785,36,821,1438,57.09%,42.77%,1
臺北市,文山區,1537,619,139,758,30,788,1465,53.79%,42.25%,1
臺北市,文山區,1538,697,227,924,60,984,1646,59.78%,42.35%,1
臺北市,文山區,1539,565,173,738,43,781,1286,60.73%,43.93%,1
臺北市,文山區,1540,571,150,721,29,750,1219,61.53%,46.84%,1
臺北市,文山區,1541,606,156,762,42,804,1292,62.23%,46.9%,1
臺北市,文山區,1542,613,178,791,61,852,1489,57.22%,41.17%,1
臺北市,文山區,1543,726,195,921,57,978,1611,60.71%,45.07%,1
臺北市,文山區,1544,568,191,759,48,807,1549,52.1%,36.67%,1
臺北市,文山區,1545,682,189,871,69,940,1678,56.02%,40.64%,1
臺北市,文山區,1546,678,207,885,59,944,1660,56.87%,40.84%,1
臺北市,文山區,1547,666,202,868,33,901,1816,49.61%,36.67%,1
臺北市,文山區,1548,379,146,525,33,558,985,56.65%,38.48%,1
臺北市,文山區,1549,612,159,771,38,809,1314,61.57%,46.58%,1
臺北市,文山區,1550,484,136,620,44,664,1018,65.23%,47.54%,1
臺北市,文山區,1551,683,205,888,41,929,1578,58.87%,43.28%,1
臺北市,文山區,1552,630,191,821,36,857,1457,58.82%,43.24%,1
臺北市,文山區,1553,608,162,770,47,817,1326,61.61%,45.85%,1
臺北市,文山區,1554,620,184,804,54,858,1393,61.59%,44.51%,1
臺北市,文山區,1555,568,169,737,54,791,1377,57.44%,41.25%,1
臺北市,文山區,1556,637,198,835,30,865,1448,59.74%,43.99%,1
臺北市,文山區,1557,641,217,858,55,913,1447,63.1%,44.3%,1
臺北市,文山區,1558,845,239,1084,47,1131,1739,65.04%,48.59%,1
臺北市,文山區,1559,663,179,842,33,875,1457,60.05%,45.5%,1
臺北市,文山區,1560,576,172,748,44,792,1288,61.49%,44.72%,1
臺北市,文山區,1561,514,145,659,59,718,1301,55.19%,39.51%,1
臺北市,文山區,1562,311,107,418,56,474,865,54.8%,35.95%,1
臺北市,文山區,1563,284,116,400,38,438,789,55.51%,35.99%,1
臺北市,南港區,0455,478,147,625,30,655,1280,51.17%,37.34%,1
臺北市,南港區,0456,579,142,721,26,747,1351,55.29%,42.86%,1
臺北市,南港區,0457,589,146,735,36,771,1345,57.32%,43.79%,1
臺北市,南港區,0458,545,161,706,40,746,1679,44.43%,32.46%,1
臺北市,南港區,0459,602,214,816,61,877,1680,52.2%,35.83%,1
臺北市,南港區,0460,595,185,780,57,837,1635,51.19%,36.39%,1
臺北市,南港區,0461,582,173,755,46,801,1459,54.9%,39.89%,1
臺北市,南港區,0462,738,192,930,29,959,1706,56.21%,43.26%,1
臺北市,南港區,0463,649,200,849,52,901,1674,53.82%,38.77%,1
臺北市,南港區,0464,653,145,798,27,825,1491,55.33%,43.8%,1
臺北市,南港區,0465,515,147,662,36,698,1086,64.27%,47.42%,1
臺北市,南港區,0466,549,174,723,57,780,1202,64.89%,45.67%,1
臺北市,南港區,0467,494,175,669,56,725,1198,60.52%,41.24%,1
臺北市,南港區,0468,517,179,696,35,731,1430,51.12%,36.15%,1
臺北市,南港區,0469,518,209,727,60,787,1275,61.73%,40.63%,1
臺北市,南港區,0470,604,208,812,51,863,1344,64.21%,44.94%,1
臺北市,南港區,0471,587,203,790,39,829,1391,59.6%,42.2%,1
臺北市,南港區,0472,623,170,793,28,821,1342,61.18%,46.42%,1
臺北市,南港區,0473,584,136,720,37,757,1389,54.5%,42.04%,1
臺北市,南港區,0474,626,181,807,46,853,1426,59.82%,43.9%,1
臺北市,南港區,0475,659,120,779,31,810,1359,59.6%,48.49%,1
臺北市,南港區,0476,568,167,735,55,790,1366,57.83%,41.58%,1
臺北市,南港區,0477,641,173,814,25,839,1441,58.22%,44.48%,1
臺北市,南港區,0478,600,164,764,65,829,1529,54.22%,39.24%,1
臺北市,南港區,0479,590,208,798,56,854,1618,52.78%,36.46%,1
臺北市,南港區,0480,526,163,689,64,753,1545,48.74%,34.05%,1
臺北市,南港區,0481,666,174,840,51,891,1569,56.79%,42.45%,1
臺北市,南港區,0482,619,171,790,35,825,1661,49.67%,37.27%,1
臺北市,南港區,0483,568,166,734,56,790,1518,52.04%,37.42%,1
臺北市,南港區,0484,676,209,885,61,946,1552,60.95%,43.56%,1
臺北市,南港區,0485,634,193,827,24,851,1658,51.33%,38.24%,1
臺北市,南港區,0486,678,191,869,57,926,1608,57.59%,42.16%,1
臺北市,南港區,0487,571,184,755,38,793,1475,53.76%,38.71%,1
臺北市,南港區,0488,812,213,1025,43,1068,1722,62.02%,47.15%,1
臺北市,南港區,0489,679,173,852,37,889,1383,64.28%,49.1%,1
臺北市,南港區,0490,608,165,773,47,820,1397,58.7%,43.52%,1
臺北市,南港區,0491,592,165,757,46,803,1352,59.39%,43.79%,1
臺北市,南港區,0492,610,165,775,38,813,1344,60.49%,45.39%,1
臺北市,南港區,0493,509,178,687,31,718,1385,51.84%,36.75%,1
臺北市,南港區,0494,545,193,738,49,787,1399,56.25%,38.96%,1
臺北市,南港區,0495,555,171,726,42,768,1381,55.61%,40.19%,1
臺北市,南港區,0496,607,193,800,58,858,1548,55.43%,39.21%,1
臺北市,南港區,0497,486,130,616,36,652,1190,54.79%,40.84%,1
臺北市,南港區,0498,637,199,836,32,868,1490,58.26%,42.75%,1
臺北市,南港區,0499,496,147,643,23,666,1096,60.77%,45.26%,1
臺北市,南港區,0500,572,165,737,23,760,1238,61.39%,46.2%,1
臺北市,南港區,0501,568,161,729,36,765,1271,60.19%,44.69%,1
臺北市,南港區,0502,496,128,624,49,673,1146,58.73%,43.28%,1
臺北市,南港區,0503,492,156,648,48,696,1232,56.49%,39.94%,1
臺北市,南港區,0504,630,156,786,37,823,1649,49.91%,38.2%,1
臺北市,南港區,0505,749,177,926,52,978,1688,57.94%,44.37%,1
臺北市,南港區,0506,666,192,858,34,892,1503,59.35%,44.31%,1
臺北市,南港區,0507,617,202,819,32,851,1542,55.19%,40.01%,1
臺北市,南港區,0508,613,204,817,51,868,1463,59.33%,41.9%,1
臺北市,南港區,0509,526,154,680,80,760,1195,63.6%,44.02%,1
臺北市,南港區,0510,531,186,717,20,737,1254,58.77%,42.34%,1
臺北市,南港區,0511,584,156,740,47,787,1356,58.04%,43.07%,1
臺北市,南港區,0512,581,193,774,61,835,1363,61.26%,42.63%,1
臺北市,南港區,0513,610,177,787,42,829,1317,62.95%,46.32%,1
臺北市,南港區,0514,569,170,739,37,776,1331,58.3%,42.75%,1
臺北市,南港區,0515,656,221,877,69,946,1610,58.76%,40.75%,1
臺北市,南港區,0516,623,172,795,40,835,1542,54.15%,40.4%,1
臺北市,南港區,0517,672,199,871,62,933,1581,59.01%,42.5%,1
臺北市,南港區,0518,587,144,731,31,762,1225,62.2%,47.92%,1
臺北市,南港區,0519,579,179,758,52,810,1264,64.08%,45.81%,1
臺北市,南港區,0520,701,219,920,81,1001,1649,60.7%,42.51%,1
臺北市,南港區,0521,488,235,723,20,743,1267,58.64%,38.52%,1
臺北市,南港區,0522,580,143,723,36,759,1336,56.81%,43.41%,1
臺北市,南港區,0523,551,137,688,28,716,1162,61.62%,47.42%,1
臺北市,南港區,0524,461,125,586,24,610,1045,58.37%,44.11%,1
臺北市,南港區,0525,667,171,838,51,889,1351,65.8%,49.37%,1
臺北市,南港區,0526,593,139,732,31,763,1358,56.19%,43.67%,1
臺北市,內湖區,0305,646,170,816,24,840,1661,50.57%,38.89%,1
臺北市,內湖區,0306,614,213,827,63,890,1602,55.56%,38.33%,1
臺北市,內湖區,0307,715,206,921,97,1018,1655,61.51%,43.2%,1
臺北市,內湖區,0308,681,229,910,46,956,1582,60.43%,43.05%,1
臺北市,內湖區,0309,686,128,814,36,850,1688,50.36%,40.64%,1
臺北市,內湖區,0310,730,202,932,43,975,1737,56.13%,42.03%,1
臺北市,內湖區,0311,769,213,982,72,1054,1809,58.26%,42.51%,1
臺北市,內湖區,0312,580,153,733,52,785,1376,57.05%,42.15%,1
臺北市,內湖區,0313,754,207,961,91,1052,1747,60.22%,43.16%,1
臺北市,內湖區,0314,634,164,798,34,832,1389,59.9%,45.64%,1
臺北市,內湖區,0315,683,183,866,41,907,1454,62.38%,46.97%,1
臺北市,內湖區,0316,665,216,881,48,929,1468,63.28%,45.3%,1
臺北市,內湖區,0317,762,203,965,40,1005,1603,62.69%,47.54%,1
臺北市,內湖區,0318,731,215,946,44,990,1795,55.15%,40.72%,1
臺北市,內湖區,0319,779,252,1031,55,1086,1737,62.52%,44.85%,1
臺北市,內湖區,0320,755,220,975,74,1049,1744,60.15%,43.29%,1
臺北市,內湖區,0321,719,192,911,63,974,1661,58.64%,43.29%,1
臺北市,內湖區,0322,654,213,867,39,906,1577,57.45%,41.47%,1
臺北市,內湖區,0323,697,185,882,26,908,1494,60.78%,46.65%,1
臺北市,內湖區,0324,705,186,891,61,952,1626,58.55%,43.36%,1
臺北市,內湖區,0325,714,191,905,71,976,1641,59.48%,43.51%,1
臺北市,內湖區,0326,658,202,860,44,904,1554,58.17%,42.34%,1
臺北市,內湖區,0327,661,339,1000,46,1046,1728,60.53%,38.25%,1
臺北市,內湖區,0328,714,213,927,60,987,1736,56.85%,41.13%,1
臺北市,內湖區,0329,715,182,897,41,938,1461,64.2%,48.94%,1
臺北市,內湖區,0330,665,169,834,39,873,1509,57.85%,44.07%,1
臺北市,內湖區,0331,550,185,735,27,762,1358,56.11%,40.5%,1
臺北市,內湖區,0332,731,217,948,46,994,1761,56.45%,41.51%,1
臺北市,內湖區,0333,720,190,910,30,940,1651,56.94%,43.61%,1
臺北市,內湖區,0334,793,227,1020,62,1082,1809,59.81%,43.84%,1
臺北市,內湖區,0335,788,197,985,41,1026,1773,57.87%,44.44%,1
臺北市,內湖區,0336,813,196,1009,33,1042,1890,55.13%,43.02%,1
臺北市,內湖區,0337,823,249,1072,61,1133,1760,64.38%,46.76%,1
臺北市,內湖區,0338,732,202,934,41,975,1645,59.27%,44.5%,1
臺北市,內湖區,0339,626,161,787,20,807,1324,60.95%,47.28%,1
臺北市,內湖區,0340,508,127,635,28,663,1072,61.85%,47.39%,1
臺北市,內湖區,0341,659,174,833,32,865,1509,57.32%,43.67%,1
臺北市,內湖區,0342,676,263,939,56,995,1715,58.02%,39.42%,1
臺北市,內湖區,0343,786,204,990,45,1035,1774,58.34%,44.31%,1
臺北市,內湖區,0344,840,247,1087,50,1137,1796,63.31%,46.77%,1
臺北市,內湖區,0345,720,240,960,36,996,1784,55.83%,40.36%,1
臺北市,內湖區,0346,611,205,816,60,876,1417,61.82%,43.12%,1
臺北市,內湖區,0347,693,238,931,42,973,1699,57.27%,40.79%,1
臺北市,內湖區,0348,803,231,1034,45,1079,1719,62.77%,46.71%,1
臺北市,內湖區,0349,743,212,955,23,978,1715,57.03%,43.32%,1
臺北市,內湖區,0350,630,173,803,31,834,1634,51.04%,38.56%,1
臺北市,內湖區,0351,569,176,745,71,816,1435,56.86%,39.65%,1
臺北市,內湖區,0352,622,149,771,30,801,1440,55.63%,43.19%,1
臺北市,內湖區,0353,683,172,855,32,887,1446,61.34%,47.23%,1
臺北市,內湖區,0354,673,173,846,56,902,1657,54.44%,40.62%,1
臺北市,內湖區,0355,545,155,700,75,775,1261,61.46%,43.22%,1
臺北市,內湖區,0356,138,66,204,32,236,456,51.75%,30.26%,1
臺北市,內湖區,0357,700,206,906,38,944,1433,65.88%,48.85%,1
臺北市,內湖區,0358,616,220,836,37,873,1485,58.79%,41.48%,1
臺北市,內湖區,0359,672,198,870,36,906,1590,56.98%,42.26%,1
臺北市,內湖區,0360,572,161,733,52,785,1219,64.4%,46.92%,1
臺北市,內湖區,0361,729,217,946,58,1004,1732,57.97%,42.09%,1
臺北市,內湖區,0362,767,156,923,30,953,1727,55.18%,44.41%,1
臺北市,內湖區,0363,700,213,913,50,963,1637,58.83%,42.76%,1
臺北市,內湖區,0364,625,161,786,44,830,1453,57.12%,43.01%,1
臺北市,內湖區,0365,696,170,866,35,901,1617,55.72%,43.04%,1
臺北市,內湖區,0366,722,154,876,25,901,1604,56.17%,45.01%,1
臺北市,內湖區,0367,661,194,855,34,889,1406,63.23%,47.01%,1
臺北市,內湖區,0368,589,175,764,43,807,1353,59.65%,43.53%,1
臺北市,內湖區,0369,787,196,983,50,1033,1724,59.92%,45.65%,1
臺北市,內湖區,0370,616,180,796,33,829,1378,60.16%,44.7%,1
臺北市,內湖區,0371,668,152,820,30,850,1403,60.58%,47.61%,1
臺北市,內湖區,0372,635,186,821,38,859,1547,55.53%,41.05%,1
臺北市,內湖區,0373,755,231,986,50,1036,1718,60.3%,43.95%,1
臺北市,內湖區,0374,754,238,992,44,1036,1813,57.14%,41.59%,1
臺北市,內湖區,0375,811,232,1043,65,1108,1791,61.86%,45.28%,1
臺北市,內湖區,0376,848,215,1063,48,1111,1855,59.89%,45.71%,1
臺北市,內湖區,0377,776,180,956,34,990,1731,57.19%,44.83%,1
臺北市,內湖區,0378,753,210,963,58,1021,1593,64.09%,47.27%,1
臺北市,內湖區,0379,764,191,955,48,1003,1869,53.67%,40.88%,1
臺北市,內湖區,0380,783,179,962,53,1015,1687,60.17%,46.41%,1
臺北市,內湖區,0381,661,207,868,25,893,1530,58.37%,43.2%,1
臺北市,內湖區,0382,622,131,753,47,800,1300,61.54%,47.85%,1
臺北市,內湖區,0383,650,153,803,40,843,1314,64.16%,49.47%,1
臺北市,內湖區,0384,542,152,694,33,727,1433,50.73%,37.82%,1
臺北市,內湖區,0385,606,152,758,34,792,1450,54.62%,41.79%,1
臺北市,內湖區,0386,679,179,858,59,917,1608,57.03%,42.23%,1
臺北市,內湖區,0387,635,159,794,43,837,1414,59.19%,44.91%,1
臺北市,內湖區,0388,531,184,715,47,762,1492,51.07%,35.59%,1
臺北市,內湖區,0389,604,171,775,28,803,1528,52.55%,39.53%,1
臺北市,內湖區,0390,721,213,934,45,979,1692,57.86%,42.61%,1
臺北市,內湖區,0391,665,202,867,53,920,1556,59.13%,42.74%,1
臺北市,內湖區,0392,668,202,870,25,895,1637,54.67%,40.81%,1
臺北市,內湖區,0393,687,216,903,43,946,1749,54.09%,39.28%,1
臺北市,內湖區,0394,495,141,636,39,675,1220,55.33%,40.57%,1
臺北市,內湖區,0395,660,206,866,56,922,1600,57.63%,41.25%,1
臺北市,內湖區,0396,625,181,806,44,850,1473,57.71%,42.43%,1
臺北市,內湖區,0397,615,190,805,56,861,1498,57.48%,41.05%,1
臺北市,內湖區,0398,646,198,844,47,891,1557,57.23%,41.49%,1
臺北市,內湖區,0399,662,201,863,37,900,1674,53.76%,39.55%,1
臺北市,內湖區,0400,750,237,987,46,1033,1728,59.78%,43.4%,1
臺北市,內湖區,0401,264,88,352,47,399,788,50.63%,33.5%,1
臺北市,內湖區,0402,572,231,803,70,873,1542,56.61%,37.09%,1
臺北市,內湖區,0403,613,175,788,50,838,1676,50%,36.58%,1
臺北市,內湖區,0404,481,183,664,28,692,1360,50.88%,35.37%,1
臺北市,內湖區,0405,611,151,762,29,791,1259,62.83%,48.53%,1
臺北市,內湖區,0406,562,129,691,20,711,1301,54.65%,43.2%,1
臺北市,內湖區,0407,446,159,605,41,646,1251,51.64%,35.65%,1
臺北市,內湖區,0408,616,170,786,64,850,1502,56.59%,41.01%,1
臺北市,內湖區,0409,691,164,855,36,891,1596,55.83%,43.3%,1
臺北市,內湖區,0410,711,195,906,26,932,1649,56.52%,43.12%,1
臺北市,內湖區,0411,747,174,921,60,981,1774,55.3%,42.11%,1
臺北市,內湖區,0412,681,196,877,40,917,1746,52.52%,39%,1
臺北市,內湖區,0413,584,190,774,23,797,1473,54.11%,39.65%,1
臺北市,內湖區,0414,686,217,903,67,970,2824,34.35%,24.29%,1
臺北市,內湖區,0415,705,216,921,34,955,1849,51.65%,38.13%,1
臺北市,內湖區,0416,611,192,803,52,855,1530,55.88%,39.93%,1
臺北市,內湖區,0417,671,223,894,50,944,1656,57%,40.52%,1
臺北市,內湖區,0418,606,194,800,45,845,1457,58%,41.59%,1
臺北市,內湖區,0419,755,207,962,54,1016,1695,59.94%,44.54%,1
臺北市,內湖區,0420,751,193,944,41,985,1663,59.23%,45.16%,1
臺北市,內湖區,0421,700,194,894,50,944,1654,57.07%,42.32%,1
臺北市,內湖區,0422,718,221,939,47,986,1642,60.05%,43.73%,1
臺北市,內湖區,0423,696,220,916,41,957,1685,56.8%,41.31%,1
臺北市,內湖區,0424,753,240,993,54,1047,1862,56.23%,40.44%,1
臺北市,內湖區,0425,842,238,1080,50,1130,1900,59.47%,44.32%,1
臺北市,內湖區,0426,888,186,1074,55,1129,1790,63.07%,49.61%,1
臺北市,內湖區,0427,594,167,761,52,813,1417,57.37%,41.92%,1
臺北市,內湖區,0428,709,196,905,61,966,1694,57.02%,41.85%,1
臺北市,內湖區,0429,672,172,844,68,912,1676,54.42%,40.1%,1
臺北市,內湖區,0430,669,223,892,23,915,1643,55.69%,40.72%,1
臺北市,內湖區,0431,711,178,889,44,933,1588,58.75%,44.77%,1
臺北市,內湖區,0432,705,206,911,48,959,1603,59.83%,43.98%,1
臺北市,內湖區,0433,730,182,912,42,954,1629,58.56%,44.81%,1
臺北市,內湖區,0434,769,196,965,49,1014,1646,61.6%,46.72%,1
臺北市,內湖區,0435,813,188,1001,42,1043,1883,55.39%,43.18%,1
臺北市,內湖區,0436,602,163,765,48,813,1434,56.69%,41.98%,1
臺北市,內湖區,0437,608,154,762,39,801,1418,56.49%,42.88%,1
臺北市,內湖區,0438,603,162,765,56,821,1373,59.8%,43.92%,1
臺北市,內湖區,0439,592,169,761,56,817,1349,60.56%,43.88%,1
臺北市,內湖區,0440,677,201,878,54,932,1511,61.68%,44.8%,1
臺北市,內湖區,0441,706,187,893,67,960,1563,61.42%,45.17%,1
臺北市,內湖區,0442,662,191,853,51,904,1550,58.32%,42.71%,1
臺北市,內湖區,0443,466,149,615,39,654,1157,56.53%,40.28%,1
臺北市,內湖區,0444,724,255,979,41,1020,1768,57.69%,40.95%,1
臺北市,內湖區,0445,715,198,913,58,971,1664,58.35%,42.97%,1
臺北市,內湖區,0446,735,227,962,64,1026,1743,58.86%,42.17%,1
臺北市,內湖區,0447,660,170,830,31,861,1480,58.18%,44.59%,1
臺北市,內湖區,0448,709,224,933,49,982,1589,61.8%,44.62%,1
臺北市,內湖區,0449,605,155,760,33,793,1371,57.84%,44.13%,1
臺北市,內湖區,0450,721,210,931,39,970,1575,61.59%,45.78%,1
臺北市,內湖區,0451,633,147,780,16,796,1377,57.81%,45.97%,1
臺北市,內湖區,0452,702,212,914,55,969,1469,65.96%,47.79%,1
臺北市,內湖區,0453,717,205,922,18,940,1529,61.48%,46.89%,1
臺北市,內湖區,0454,756,197,953,46,999,1649,60.58%,45.85%,1
臺北市,士林區,0142,638,224,862,77,939,1695,55.4%,37.64%,1
臺北市,士林區,0143,676,244,920,91,1011,1720,58.78%,39.3%,1
臺北市,士林區,0144,507,154,661,76,737,1288,57.22%,39.36%,1
臺北市,士林區,0145,618,185,803,55,858,1546,55.5%,39.97%,1
臺北市,士林區,0146,305,80,385,26,411,652,63.04%,46.78%,1
臺北市,士林區,0147,331,113,444,41,485,870,55.75%,38.05%,1
臺北市,士林區,0148,471,181,652,55,707,1137,62.18%,41.42%,1
臺北市,士林區,0149,439,171,610,53,663,1050,63.14%,41.81%,1
臺北市,士林區,0150,439,147,586,56,642,1031,62.27%,42.58%,1
臺北市,士林區,0151,449,155,604,33,637,1075,59.26%,41.77%,1
臺北市,士林區,0152,338,128,466,53,519,2175,23.86%,15.54%,1
臺北市,士林區,0153,672,204,876,58,934,1775,52.62%,37.86%,1
臺北市,士林區,0154,724,193,917,59,976,1669,58.48%,43.38%,1
臺北市,士林區,0155,661,291,952,60,1012,1665,60.78%,39.7%,1
臺北市,士林區,0156,701,248,949,75,1024,1648,62.14%,42.54%,1
臺北市,士林區,0157,520,165,685,28,713,1246,57.22%,41.73%,1
臺北市,士林區,0158,539,210,749,71,820,1419,57.79%,37.98%,1
臺北市,士林區,0159,491,209,700,78,778,1327,58.63%,37%,1
臺北市,士林區,0160,653,259,912,29,941,1573,59.82%,41.51%,1
臺北市,士林區,0161,616,181,797,75,872,1470,59.32%,41.9%,1
臺北市,士林區,0162,698,242,940,34,974,1775,54.87%,39.32%,1
臺北市,士林區,0163,730,174,904,62,966,1692,57.09%,43.14%,1
臺北市,士林區,0164,764,250,1014,56,1070,1842,58.09%,41.48%,1
臺北市,士林區,0165,507,163,670,47,717,1166,61.49%,43.48%,1
臺北市,士林區,0166,623,192,815,0,815,1687,48.31%,36.93%,1
臺北市,士林區,0167,625,223,848,75,923,1624,56.83%,38.49%,1
臺北市,士林區,0168,620,223,843,83,926,1477,62.69%,41.98%,1
臺北市,士林區,0169,537,175,712,48,760,1250,60.8%,42.96%,1
臺北市,士林區,0170,576,190,766,89,855,1434,59.62%,40.17%,1
臺北市,士林區,0171,578,223,801,65,866,1452,59.64%,39.81%,1
臺北市,士林區,0172,659,235,894,65,959,1533,62.56%,42.99%,1
臺北市,士林區,0173,660,197,857,67,924,1515,60.99%,43.56%,1
臺北市,士林區,0174,497,176,673,55,728,1203,60.52%,41.31%,1
臺北市,士林區,0175,642,203,845,82,927,1487,62.34%,43.17%,1
臺北市,士林區,0176,512,161,673,39,712,1252,56.87%,40.89%,1
臺北市,士林區,0177,598,208,806,54,860,1536,55.99%,38.93%,1
臺北市,士林區,0178,643,231,874,73,947,1556,60.86%,41.32%,1
臺北市,士林區,0179,627,195,822,58,880,1511,58.24%,41.5%,1
臺北市,士林區,0180,247,251,498,61,559,1572,35.56%,15.71%,1
臺北市,士林區,0181,674,194,868,78,946,1668,56.71%,40.41%,1
臺北市,士林區,0182,636,213,849,107,956,1685,56.74%,37.74%,1
臺北市,士林區,0183,641,207,848,57,905,1568,57.72%,40.88%,1
臺北市,士林區,0184,516,163,679,51,730,1327,55.01%,38.88%,1
臺北市,士林區,0185,482,189,671,75,746,1338,55.75%,36.02%,1
臺北市,士林區,0186,548,183,731,70,801,1515,52.87%,36.17%,1
臺北市,士林區,0187,613,192,805,64,869,1452,59.85%,42.22%,1
臺北市,士林區,0188,613,161,774,58,832,1448,57.46%,42.33%,1
臺北市,士林區,0189,627,211,838,52,890,1521,58.51%,41.22%,1
臺北市,士林區,0190,566,211,777,41,818,1461,55.99%,38.74%,1
臺北市,士林區,0191,532,216,748,82,830,1541,53.86%,34.52%,1
臺北市,士林區,0192,527,163,690,55,745,1611,46.24%,32.71%,1
臺北市,士林區,0193,630,205,835,69,904,1595,56.68%,39.5%,1
臺北市,士林區,0194,629,198,827,38,865,1685,51.34%,37.33%,1
臺北市,士林區,0195,679,220,899,78,977,1816,53.8%,37.39%,1
臺北市,士林區,0196,623,236,859,98,957,1687,56.73%,36.93%,1
臺北市,士林區,0197,626,217,843,83,926,1646,56.26%,38.03%,1
臺北市,士林區,0198,627,202,829,56,885,1643,53.86%,38.16%,1
臺北市,士林區,0199,721,200,921,54,975,1687,57.79%,42.74%,1
臺北市,士林區,0200,699,207,906,68,974,1655,58.85%,42.24%,1
臺北市,士林區,0201,664,246,910,32,942,1779,52.95%,37.32%,1
臺北市,士林區,0202,737,273,1010,65,1075,1855,57.95%,39.73%,1
臺北市,士林區,0203,555,168,723,58,781,1350,57.85%,41.11%,1
臺北市,士林區,0204,572,145,717,28,745,1455,51.2%,39.31%,1
臺北市,士林區,0205,452,211,663,60,723,1497,48.3%,30.19%,1
臺北市,士林區,0206,452,162,614,55,669,1398,47.85%,32.33%,1
臺北市,士林區,0207,699,252,951,75,1026,1747,58.73%,40.01%,1
臺北市,士林區,0208,573,171,744,83,827,1465,56.45%,39.11%,1
臺北市,士林區,0209,585,312,897,68,965,1530,63.07%,38.24%,1
臺北市,士林區,0210,642,237,879,83,962,1855,51.86%,34.61%,1
臺北市,士林區,0211,549,196,745,76,821,1444,56.86%,38.02%,1
臺北市,士林區,0212,574,185,759,72,831,1563,53.17%,36.72%,1
臺北市,士林區,0213,520,202,722,80,802,1482,54.12%,35.09%,1
臺北市,士林區,0214,561,212,773,92,865,1552,55.73%,36.15%,1
臺北市,士林區,0215,730,197,927,82,1009,1790,56.37%,40.78%,1
臺北市,士林區,0216,597,174,771,79,850,1628,52.21%,36.67%,1
臺北市,士林區,0217,483,196,679,68,747,1337,55.87%,36.13%,1
臺北市,士林區,0218,601,297,898,90,988,1750,56.46%,34.34%,1
臺北市,士林區,0219,578,215,793,102,895,1668,53.66%,34.65%,1
臺北市,士林區,0220,432,163,595,73,668,1403,47.61%,30.79%,1
臺北市,士林區,0221,455,192,647,58,705,1468,48.02%,30.99%,1
臺北市,士林區,0222,488,177,665,36,701,1471,47.65%,33.17%,1
臺北市,士林區,0223,605,177,782,88,870,1666,52.22%,36.31%,1
臺北市,士林區,0224,570,196,766,57,823,1587,51.86%,35.92%,1
臺北市,士林區,0225,693,197,890,80,970,1987,48.82%,34.88%,1
臺北市,士林區,0226,448,152,600,29,629,1271,49.49%,35.25%,1
臺北市,士林區,0227,720,239,959,75,1034,1728,59.84%,41.67%,1
臺北市,士林區,0228,696,220,916,62,978,1630,60%,42.7%,1
臺北市,士林區,0229,679,243,922,49,971,1619,59.98%,41.94%,1
臺北市,士林區,0230,623,161,784,54,838,1425,58.81%,43.72%,1
臺北市,士林區,0231,709,208,917,62,979,1623,60.32%,43.68%,1
臺北市,士林區,0232,641,221,862,52,914,1564,58.44%,40.98%,1
臺北市,士林區,0233,573,265,838,56,894,1376,64.97%,41.64%,1
臺北市,士林區,0234,737,165,902,38,940,1517,61.96%,48.58%,1
臺北市,士林區,0235,635,250,885,45,930,1729,53.79%,36.73%,1
臺北市,士林區,0236,673,209,882,44,926,1511,61.28%,44.54%,1
臺北市,士林區,0237,778,245,1023,53,1076,1811,59.41%,42.96%,1
臺北市,士林區,0238,637,207,844,47,891,1533,58.12%,41.55%,1
臺北市,士林區,0239,786,233,1019,53,1072,1657,64.7%,47.44%,1
臺北市,士林區,0240,647,160,807,34,841,1499,56.1%,43.16%,1
臺北市,士林區,0241,588,159,747,61,808,1402,57.63%,41.94%,1
臺北市,士林區,0242,540,224,764,66,830,1273,65.2%,42.42%,1
臺北市,士林區,0243,539,174,713,47,760,1273,59.7%,42.34%,1
臺北市,士林區,0244,550,189,739,47,786,1316,59.73%,41.79%,1
臺北市,士林區,0245,659,236,895,64,959,1659,57.81%,39.72%,1
臺北市,士林區,0246,720,191,911,41,952,1749,54.43%,41.17%,1
臺北市,士林區,0247,630,202,832,50,882,1552,56.83%,40.59%,1
臺北市,士林區,0248,700,152,852,52,904,1529,59.12%,45.78%,1
臺北市,士林區,0249,695,174,869,45,914,1644,55.6%,42.27%,1
臺北市,士林區,0250,725,224,949,58,1007,1779,56.6%,40.75%,1
臺北市,士林區,0251,635,212,847,53,900,1597,56.36%,39.76%,1
臺北市,士林區,0252,594,198,792,59,851,1454,58.53%,40.85%,1
臺北市,士林區,0253,669,251,920,46,966,1582,61.06%,42.29%,1
臺北市,士林區,0254,672,190,862,47,909,1518,59.88%,44.27%,1
臺北市,士林區,0255,564,196,760,23,783,1501,52.17%,37.57%,1
臺北市,士林區,0256,585,219,804,50,854,1420,60.14%,41.2%,1
臺北市,士林區,0257,602,213,815,57,872,1494,58.37%,40.29%,1
臺北市,士林區,0258,658,237,895,56,951,1568,60.65%,41.96%,1
臺北市,士林區,0259,519,198,717,47,764,1208,63.25%,42.96%,1
臺北市,士林區,0260,733,223,956,67,1023,1826,56.02%,40.14%,1
臺北市,士林區,0261,660,214,874,61,935,1647,56.77%,40.07%,1
臺北市,士林區,0262,660,210,870,67,937,1654,56.65%,39.9%,1
臺北市,士林區,0263,659,217,876,48,924,1550,59.61%,42.52%,1
臺北市,士林區,0264,577,187,764,53,817,1298,62.94%,44.45%,1
臺北市,士林區,0265,552,190,742,68,810,1297,62.45%,42.56%,1
臺北市,士林區,0266,547,172,719,49,768,1352,56.8%,40.46%,1
臺北市,士林區,0267,594,205,799,51,850,1522,55.85%,39.03%,1
臺北市,士林區,0268,604,233,837,82,919,1602,57.37%,37.7%,1
臺北市,士林區,0269,547,226,773,62,835,1441,57.95%,37.96%,1
臺北市,士林區,0270,502,176,678,26,704,1325,53.13%,37.89%,1
臺北市,士林區,0271,646,208,854,45,899,1567,57.37%,41.23%,1
臺北市,士林區,0272,594,226,820,25,845,1518,55.67%,39.13%,1
臺北市,士林區,0273,675,223,898,46,944,1549,60.94%,43.58%,1
臺北市,士林區,0274,674,218,892,34,926,1652,56.05%,40.8%,1
臺北市,士林區,0275,718,259,977,67,1044,1766,59.12%,40.66%,1
臺北市,士林區,0276,654,207,861,25,886,1638,54.09%,39.93%,1
臺北市,士林區,0277,662,187,849,47,896,1491,60.09%,44.4%,1
臺北市,士林區,0278,654,197,851,27,878,1521,57.73%,43%,1
臺北市,士林區,0279,586,178,764,62,826,1351,61.14%,43.38%,1
臺北市,士林區,0280,632,242,874,33,907,1742,52.07%,36.28%,1
臺北市,士林區,0281,644,219,863,50,913,1585,57.6%,40.63%,1
臺北市,士林區,0282,668,182,850,45,895,1521,58.84%,43.92%,1
臺北市,士林區,0283,614,218,832,38,870,1543,56.38%,39.79%,1
臺北市,士林區,0284,606,177,783,45,828,1404,58.97%,43.16%,1
臺北市,士林區,0285,648,199,847,44,891,1541,57.82%,42.05%,1
臺北市,士林區,0286,637,179,816,60,876,1584,55.3%,40.21%,1
臺北市,士林區,0287,636,210,846,62,908,1519,59.78%,41.87%,1
臺北市,士林區,0288,573,166,739,27,766,1482,51.69%,38.66%,1
臺北市,士林區,0289,496,162,658,52,710,1243,57.12%,39.9%,1
臺北市,士林區,0290,434,175,609,51,660,1156,57.09%,37.54%,1
臺北市,士林區,0291,417,185,602,80,682,1262,54.04%,33.04%,1
臺北市,士林區,0292,349,138,487,46,533,889,59.96%,39.26%,1
臺北市,士林區,0293,317,163,480,51,531,858,61.89%,36.95%,1
臺北市,士林區,0294,324,154,478,53,531,945,56.19%,34.29%,1
臺北市,士林區,0295,374,122,496,46,542,960,56.46%,38.96%,1
臺北市,士林區,0296,355,89,444,51,495,876,56.51%,40.53%,1
臺北市,士林區,0297,228,92,320,43,363,556,65.29%,41.01%,1
臺北市,士林區,0298,385,122,507,66,573,919,62.35%,41.89%,1
臺北市,士林區,0299,565,227,792,108,900,1360,66.18%,41.54%,1
臺北市,士林區,0300,558,185,743,83,826,1355,60.96%,41.18%,1
臺北市,士林區,0301,543,137,680,42,722,1252,57.67%,43.37%,1
臺北市,士林區,0302,557,133,690,49,739,1182,62.52%,47.12%,1
臺北市,士林區,0303,524,149,673,17,690,1431,48.22%,36.62%,1
臺北市,士林區,0304,479,152,631,43,674,1240,54.35%,38.63%,1
臺北市,北投區,0001,550,187,737,56,793,1313,60.4%,41.89%,1
臺北市,北投區,0002,626,196,822,46,868,1403,61.87%,44.62%,1
臺北市,北投區,0003,463,150,613,52,665,1081,61.52%,42.83%,1
臺北市,北投區,0004,503,178,681,45,726,1209,60.05%,41.6%,1
臺北市,北投區,0005,522,201,723,50,773,1326,58.3%,39.37%,1
臺北市,北投區,0006,531,183,714,49,763,1263,60.41%,42.04%,1
臺北市,北投區,0007,673,213,886,66,952,1580,60.25%,42.59%,1
臺北市,北投區,0008,685,221,906,47,953,1577,60.43%,43.44%,1
臺北市,北投區,0009,635,188,823,67,890,1483,60.01%,42.82%,1
臺北市,北投區,0010,605,175,780,36,816,1461,55.85%,41.41%,1
臺北市,北投區,0011,586,185,771,63,834,1466,56.89%,39.97%,1
臺北市,北投區,0012,683,204,887,63,950,1620,58.64%,42.16%,1
臺北市,北投區,0013,586,185,771,32,803,1543,52.04%,37.98%,1
臺北市,北投區,0014,586,192,778,57,835,1513,55.19%,38.73%,1
臺北市,北投區,0015,641,176,817,54,871,1534,56.78%,41.79%,1
臺北市,北投區,0016,696,203,899,84,983,1650,59.58%,42.18%,1
臺北市,北投區,0017,659,207,866,41,907,1533,59.17%,42.99%,1
臺北市,北投區,0018,681,217,898,46,944,1702,55.46%,40.01%,1
臺北市,北投區,0019,691,235,926,52,978,1721,56.83%,40.15%,1
臺北市,北投區,0020,651,253,904,56,960,1575,60.95%,41.33%,1
臺北市,北投區,0021,620,207,827,68,895,1530,58.5%,40.52%,1
臺北市,北投區,0022,696,252,948,70,1018,1728,58.91%,40.28%,1
臺北市,北投區,0023,677,202,879,84,963,1702,56.58%,39.78%,1
臺北市,北投區,0024,664,228,892,67,959,1696,56.54%,39.15%,1
臺北市,北投區,0025,579,175,754,41,795,1684,47.21%,34.38%,1
臺北市,北投區,0026,726,232,958,71,1029,1717,59.93%,42.28%,1
臺北市,北投區,0027,661,217,878,45,923,1605,57.51%,41.18%,1
臺北市,北投區,0028,727,210,937,50,987,1723,57.28%,42.19%,1
臺北市,北投區,0029,701,224,925,57,982,1597,61.49%,43.89%,1
臺北市,北投區,0030,702,216,918,52,970,1700,57.06%,41.29%,1
臺北市,北投區,0031,567,197,764,40,804,1544,52.07%,36.72%,1
臺北市,北投區,0032,620,197,817,50,867,1635,53.03%,37.92%,1
臺北市,北投區,0033,743,91,834,29,863,1495,57.73%,49.7%,1
臺北市,北投區,0034,671,237,908,31,939,1619,58%,41.45%,1
臺北市,北投區,0035,646,267,913,46,959,1683,56.98%,38.38%,1
臺北市,北投區,0036,639,190,829,55,884,1662,53.19%,38.45%,1
臺北市,北投區,0037,641,229,870,40,910,1850,49.19%,34.65%,1
臺北市,北投區,0038,622,201,823,25,848,1674,50.66%,37.16%,1
臺北市,北投區,0039,675,179,854,62,916,1511,60.62%,44.67%,1
臺北市,北投區,0040,566,167,733,27,760,1393,54.56%,40.63%,1
臺北市,北投區,0041,583,170,753,56,809,1279,63.25%,45.58%,1
臺北市,北投區,0042,452,143,595,39,634,1122,56.51%,40.29%,1
臺北市,北投區,0043,625,167,792,56,848,1238,68.5%,50.48%,1
臺北市,北投區,0044,612,226,838,70,908,1477,61.48%,41.44%,1
臺北市,北投區,0045,651,197,848,65,913,1495,61.07%,43.55%,1
臺北市,北投區,0046,654,211,865,48,913,1469,62.15%,44.52%,1
臺北市,北投區,0047,637,167,804,55,859,1462,58.76%,43.57%,1
臺北市,北投區,0048,617,166,783,64,847,1431,59.19%,43.12%,1
臺北市,北投區,0049,542,203,745,42,787,1486,52.96%,36.47%,1
臺北市,北投區,0050,609,212,821,57,878,1449,60.59%,42.03%,1
臺北市,北投區,0051,586,207,793,37,830,1456,57.01%,40.25%,1
臺北市,北投區,0052,523,173,696,39,735,1311,56.06%,39.89%,1
臺北市,北投區,0053,577,156,733,57,790,1356,58.26%,42.55%,1
臺北市,北投區,0054,558,174,732,34,766,1338,57.25%,41.7%,1
臺北市,北投區,0055,622,194,816,31,847,1525,55.54%,40.79%,1
臺北市,北投區,0056,636,177,813,54,867,1620,53.52%,39.26%,1
臺北市,北投區,0057,583,169,752,24,776,1499,51.77%,38.89%,1
臺北市,北投區,0058,681,166,847,34,881,1497,58.85%,45.49%,1
臺北市,北投區,0059,633,203,836,64,900,1624,55.42%,38.98%,1
臺北市,北投區,0060,610,166,776,71,847,1536,55.14%,39.71%,1
臺北市,北投區,0061,633,188,821,79,900,1469,61.27%,43.09%,1
臺北市,北投區,0062,628,197,825,60,885,1598,55.38%,39.3%,1
臺北市,北投區,0063,687,186,873,39,912,1690,53.96%,40.65%,1
臺北市,北投區,0064,609,193,802,105,907,1599,56.72%,38.09%,1
臺北市,北投區,0065,677,188,865,64,929,1634,56.85%,41.43%,1
臺北市,北投區,0066,617,194,811,59,870,1660,52.41%,37.17%,1
臺北市,北投區,0067,717,215,932,63,995,1900,52.37%,37.74%,1
臺北市,北投區,0068,731,242,973,52,1025,1797,57.04%,40.68%,1
臺北市,北投區,0069,731,246,977,81,1058,1832,57.75%,39.9%,1
臺北市,北投區,0070,764,226,990,55,1045,1784,58.58%,42.83%,1
臺北市,北投區,0071,735,217,952,52,1004,1732,57.97%,42.44%,1
臺北市,北投區,0072,372,134,506,52,558,2035,27.42%,18.28%,1
臺北市,北投區,0073,578,210,788,72,860,1504,57.18%,38.43%,1
臺北市,北投區,0074,743,197,940,67,1007,1683,59.83%,44.15%,1
臺北市,北投區,0075,617,209,826,77,903,1635,55.23%,37.74%,1
臺北市,北投區,0076,653,177,830,79,909,1613,56.35%,40.48%,1
臺北市,北投區,0077,652,90,742,27,769,1483,51.85%,43.96%,1
臺北市,北投區,0078,589,212,801,45,846,1500,56.4%,39.27%,1
臺北市,北投區,0079,615,181,796,65,861,1483,58.06%,41.47%,1
臺北市,北投區,0080,590,222,812,64,876,1544,56.74%,38.21%,1
臺北市,北投區,0081,542,155,697,69,766,1532,50%,35.38%,1
臺北市,北投區,0082,744,209,953,69,1022,1819,56.18%,40.9%,1
臺北市,北投區,0083,615,254,869,83,952,1863,51.1%,33.01%,1
臺北市,北投區,0084,646,214,860,40,900,1872,48.08%,34.51%,1
臺北市,北投區,0085,633,203,836,60,896,1627,55.07%,38.91%,1
臺北市,北投區,0086,652,181,833,44,877,1696,51.71%,38.44%,1
臺北市,北投區,0087,695,250,945,63,1008,1841,54.75%,37.75%,1
臺北市,北投區,0088,517,177,694,57,751,1324,56.72%,39.05%,1
臺北市,北投區,0089,611,154,765,39,804,1504,53.46%,40.63%,1
臺北市,北投區,0090,601,196,797,51,848,1511,56.12%,39.77%,1
臺北市,北投區,0091,652,243,895,53,948,1615,58.7%,40.37%,1
臺北市,北投區,0092,484,155,639,35,674,1270,53.07%,38.11%,1
臺北市,北投區,0093,527,164,691,33,724,1492,48.53%,35.32%,1
臺北市,北投區,0094,527,191,718,42,760,1429,53.18%,36.88%,1
臺北市,北投區,0095,702,71,773,30,803,1567,51.24%,44.8%,1
臺北市,北投區,0096,563,179,742,39,781,1388,56.27%,40.56%,1
臺北市,北投區,0097,518,184,702,23,725,1448,50.07%,35.77%,1
臺北市,北投區,0098,513,160,673,57,730,1356,53.83%,37.83%,1
臺北市,北投區,0099,522,162,684,48,732,1308,55.96%,39.91%,1
臺北市,北投區,0100,492,152,644,55,699,1165,60%,42.23%,1
臺北市,北投區,0101,608,176,784,71,855,1429,59.83%,42.55%,1
臺北市,北投區,0102,602,150,752,37,789,1472,53.6%,40.9%,1
臺北市,北投區,0103,674,206,880,65,945,1508,62.67%,44.69%,1
臺北市,北投區,0104,593,193,786,59,845,1480,57.09%,40.07%,1
臺北市,北投區,0105,416,142,558,45,603,1142,52.8%,36.43%,1
臺北市,北投區,0106,619,161,780,41,821,1554,52.83%,39.83%,1
臺北市,北投區,0107,695,208,903,96,999,1669,59.86%,41.64%,1
臺北市,北投區,0108,759,198,957,72,1029,1823,56.45%,41.63%,1
臺北市,北投區,0109,697,194,891,65,956,1739,54.97%,40.08%,1
臺北市,北投區,0110,681,202,883,68,951,1771,53.7%,38.45%,1
臺北市,北投區,0111,567,149,716,56,772,1468,52.59%,38.62%,1
臺北市,北投區,0112,585,180,765,34,799,1469,54.39%,39.82%,1
臺北市,北投區,0113,559,113,672,39,711,1094,64.99%,51.1%,1
臺北市,北投區,0114,535,132,667,40,707,1101,64.21%,48.59%,1
臺北市,北投區,0115,639,162,801,63,864,1422,60.76%,44.94%,1
臺北市,北投區,0116,581,139,720,56,776,1390,55.83%,41.8%,1
臺北市,北投區,0117,554,155,709,69,778,1307,59.53%,42.39%,1
臺北市,北投區,0118,505,188,693,77,770,1215,63.37%,41.56%,1
臺北市,北投區,0119,640,166,806,44,850,1642,51.77%,38.98%,1
臺北市,北投區,0120,642,148,790,40,830,1623,51.14%,39.56%,1
臺北市,北投區,0121,648,184,832,61,893,1621,55.09%,39.98%,1
臺北市,北投區,0122,548,169,717,18,735,1367,53.77%,40.09%,1
臺北市,北投區,0123,479,186,665,52,717,1309,54.77%,36.59%,1
臺北市,北投區,0124,571,163,734,37,771,1356,56.86%,42.11%,1
臺北市,北投區,0125,531,178,709,41,750,1365,54.95%,38.9%,1
臺北市,北投區,0126,616,200,816,40,856,1613,53.07%,38.19%,1
臺北市,北投區,0127,564,158,722,39,761,1590,47.86%,35.47%,1
臺北市,北投區,0128,676,217,893,72,965,1662,58.06%,40.67%,1
臺北市,北投區,0129,641,232,873,62,935,1622,57.64%,39.52%,1
臺北市,北投區,0130,686,257,943,39,982,1820,53.96%,37.69%,1
臺北市,北投區,0131,672,197,869,75,944,1615,58.45%,41.61%,1
臺北市,北投區,0132,528,159,687,64,751,1612,46.59%,32.75%,1
臺北市,北投區,0133,629,215,844,73,917,1652,55.51%,38.08%,1
臺北市,北投區,0134,665,211,876,29,905,1666,54.32%,39.92%,1
臺北市,北投區,0135,631,202,833,52,885,1641,53.93%,38.45%,1
臺北市,北投區,0136,198,82,280,38,318,528,60.23%,37.5%,1
臺北市,北投區,0137,516,192,708,74,782,1642,47.62%,31.43%,1
臺北市,北投區,0138,337,99,436,33,469,829,56.57%,40.65%,1
臺北市,北投區,0139,277,69,346,36,382,690,55.36%,40.14%,1
臺北市,北投區,0140,418,109,527,57,584,1067,54.73%,39.18%,1
臺北市,北投區,0141,336,106,442,65,507,892,56.84%,37.67%,1
新北市,板橋區,0894,528,187,715,72,787,1388,56.7%,38.04%,1
新北市,板橋區,0895,525,185,710,47,757,1294,58.5%,40.57%,1
新北市,板橋區,0896,269,101,370,23,393,667,58.92%,40.33%,1
新北市,板橋區,0897,327,108,435,40,475,898,52.9%,36.41%,1
新北市,板橋區,0898,362,107,469,34,503,829,60.68%,43.67%,1
新北市,板橋區,0899,344,83,427,34,461,739,62.38%,46.55%,1
新北市,板橋區,0900,422,157,579,50,629,1035,60.77%,40.77%,1
新北市,板橋區,0901,545,178,723,38,761,1713,44.42%,31.82%,1
新北市,板橋區,0902,230,78,308,18,326,658,49.54%,34.95%,1
新北市,板橋區,0903,489,156,645,89,734,1312,55.95%,37.27%,1
新北市,板橋區,0904,551,148,699,62,761,1492,51.01%,36.93%,1
新北市,板橋區,0905,486,170,656,63,719,1393,51.62%,34.89%,1
新北市,板橋區,0906,601,221,822,61,883,4742,18.62%,12.67%,1
新北市,板橋區,0907,548,167,715,39,754,1439,52.4%,38.08%,1
新北市,板橋區,0908,471,146,617,71,688,1187,57.96%,39.68%,1
新北市,板橋區,0909,447,123,570,40,610,1122,54.37%,39.84%,1
新北市,板橋區,0910,564,153,717,65,782,1363,57.37%,41.38%,1
新北市,板橋區,0911,440,157,597,51,648,1093,59.29%,40.26%,1
新北市,板橋區,0912,539,188,727,46,773,1331,58.08%,40.5%,1
新北市,板橋區,0913,456,139,595,45,640,1026,62.38%,44.44%,1
新北市,板橋區,0914,494,128,622,90,712,1244,57.23%,39.71%,1
新北市,板橋區,0915,455,143,598,85,683,1268,53.86%,35.88%,1
新北市,板橋區,0916,466,144,610,39,649,1313,49.43%,35.49%,1
新北市,板橋區,0917,520,161,681,49,730,1196,61.04%,43.48%,1
新北市,板橋區,0918,541,187,728,46,774,1137,68.07%,47.58%,1
新北市,板橋區,0919,559,195,754,50,804,1269,63.36%,44.05%,1
新北市,板橋區,0920,495,140,635,34,669,1117,59.89%,44.32%,1
新北市,板橋區,0921,462,147,609,52,661,1042,63.44%,44.34%,1
新北市,板橋區,0922,510,169,679,80,759,1257,60.38%,40.57%,1
新北市,板橋區,0923,505,150,655,66,721,1216,59.29%,41.53%,1
新北市,板橋區,0924,437,150,587,70,657,1126,58.35%,38.81%,1
新北市,板橋區,0925,605,180,785,58,843,1290,65.35%,46.9%,1
新北市,板橋區,0926,467,116,583,16,599,1215,49.3%,38.44%,1
新北市,板橋區,0927,424,121,545,26,571,1099,51.96%,38.58%,1
新北市,板橋區,0928,678,100,778,40,818,1329,61.55%,51.02%,1
新北市,板橋區,0929,491,85,576,34,610,996,61.24%,49.3%,1
新北市,板橋區,0930,473,114,587,39,626,1047,59.79%,45.18%,1
新北市,板橋區,0931,520,178,698,67,765,1272,60.14%,40.88%,1
新北市,板橋區,0932,587,144,731,49,780,1252,62.3%,46.88%,1
新北市,板橋區,0933,502,162,664,67,731,1238,59.05%,40.55%,1
新北市,板橋區,0934,635,184,819,64,883,1389,63.57%,45.72%,1
新北市,板橋區,0935,528,165,693,59,752,1194,62.98%,44.22%,1
新北市,板橋區,0936,417,105,522,62,584,1093,53.43%,38.15%,1
新北市,板橋區,0937,443,139,582,76,658,1148,57.32%,38.59%,1
新北市,板橋區,0938,524,163,687,49,736,1268,58.04%,41.32%,1
新北市,板橋區,0939,467,183,650,68,718,1230,58.37%,37.97%,1
新北市,板橋區,0940,410,117,527,49,576,1012,56.92%,40.51%,1
新北市,板橋區,0941,341,103,444,42,486,811,59.93%,42.05%,1
新北市,板橋區,0942,500,178,678,72,750,1197,62.66%,41.77%,1
新北市,板橋區,0943,459,121,580,37,617,1142,54.03%,40.19%,1
新北市,板橋區,0944,505,144,649,48,697,1222,57.04%,41.33%,1
新北市,板橋區,0945,363,96,459,43,502,796,63.07%,45.6%,1
新北市,板橋區,0946,459,112,571,75,646,997,64.79%,46.04%,1
新北市,板橋區,0947,365,184,549,39,588,1011,58.16%,36.1%,1
新北市,板橋區,0948,441,159,600,68,668,1157,57.74%,38.12%,1
新北市,板橋區,0949,441,130,571,63,634,1040,60.96%,42.4%,1
新北市,板橋區,0950,539,134,673,38,711,1173,60.61%,45.95%,1
新北市,板橋區,0951,498,127,625,27,652,1193,54.65%,41.74%,1
新北市,板橋區,0952,533,157,690,43,733,1255,58.41%,42.47%,1
新北市,板橋區,0953,516,185,701,51,752,1306,57.58%,39.51%,1
新北市,板橋區,0954,423,141,564,17,581,1050,55.33%,40.29%,1
新北市,板橋區,0955,387,118,505,38,543,942,57.64%,41.08%,1
新北市,板橋區,0956,521,143,664,50,714,1133,63.02%,45.98%,1
新北市,板橋區,0957,512,169,681,46,727,1251,58.11%,40.93%,1
新北市,板橋區,0958,557,157,714,40,754,1293,58.31%,43.08%,1
新北市,板橋區,0959,441,153,594,64,658,1208,54.47%,36.51%,1
新北市,板橋區,0960,474,166,640,72,712,1223,58.22%,38.76%,1
新北市,板橋區,0961,512,37,549,55,604,1061,56.93%,48.26%,1
新北市,板橋區,0962,632,179,811,44,855,1515,56.44%,41.72%,1
新北市,板橋區,0963,548,140,688,67,755,1225,61.63%,44.73%,1
新北市,板橋區,0964,555,127,682,30,712,1120,63.57%,49.55%,1
新北市,板橋區,0965,510,134,644,43,687,1091,62.97%,46.75%,1
新北市,板橋區,0966,693,111,804,39,843,1385,60.87%,50.04%,1
新北市,板橋區,0967,533,184,717,75,792,1283,61.73%,41.54%,1
新北市,板橋區,0968,479,153,632,91,723,1204,60.05%,39.78%,1
新北市,板橋區,0969,548,154,702,54,756,1191,63.48%,46.01%,1
新北市,板橋區,0970,463,157,620,65,685,1078,63.54%,42.95%,1
新北市,板橋區,0971,545,172,717,79,796,1351,58.92%,40.34%,1
新北市,板橋區,0972,542,160,702,73,775,1322,58.62%,41%,1
新北市,板橋區,0973,364,101,465,58,523,868,60.25%,41.94%,1
新北市,板橋區,0974,447,161,608,81,689,1029,66.96%,43.44%,1
新北市,板橋區,0975,705,193,898,43,941,1602,58.74%,44.01%,1
新北市,板橋區,0976,584,165,749,71,820,1362,60.21%,42.88%,1
新北市,板橋區,0977,680,208,888,74,962,1698,56.65%,40.05%,1
新北市,板橋區,0978,679,137,816,35,851,1495,56.92%,45.42%,1
新北市,板橋區,0979,545,220,765,78,843,1522,55.39%,35.81%,1
新北市,板橋區,0980,562,129,691,62,753,1279,58.87%,43.94%,1
新北市,板橋區,0981,512,162,674,59,733,1559,47.02%,32.84%,1
新北市,板橋區,0982,552,169,721,106,827,1537,53.81%,35.91%,1
新北市,板橋區,0983,530,190,720,75,795,1531,51.93%,34.62%,1
新北市,板橋區,0984,740,110,850,39,889,1720,51.69%,43.02%,1
新北市,板橋區,0985,445,117,562,39,601,1165,51.59%,38.2%,1
新北市,板橋區,0986,789,213,1002,18,1020,1857,54.93%,42.49%,1
新北市,板橋區,0987,410,135,545,73,618,1078,57.33%,38.03%,1
新北市,板橋區,0988,449,138,587,22,609,1177,51.74%,38.15%,1
新北市,板橋區,0989,747,228,975,53,1028,1798,57.17%,41.55%,1
新北市,板橋區,0990,592,175,767,113,880,1455,60.48%,40.69%,1
新北市,板橋區,0991,521,179,700,72,772,1245,62.01%,41.85%,1
新北市,板橋區,0992,591,252,843,93,936,1704,54.93%,34.68%,1
新北市,板橋區,0993,702,181,883,37,920,1600,57.5%,43.88%,1
新北市,板橋區,0994,507,169,676,34,710,1409,50.39%,35.98%,1
新北市,板橋區,0995,498,184,682,56,738,1286,57.39%,38.72%,1
新北市,板橋區,0996,393,156,549,120,669,1359,49.23%,28.92%,1
新北市,板橋區,0997,433,148,581,48,629,1188,52.95%,36.45%,1
新北市,板橋區,0998,596,189,785,57,842,1627,51.75%,36.63%,1
新北市,板橋區,0999,555,164,719,36,755,1633,46.23%,33.99%,1
新北市,板橋區,1000,700,331,1031,80,1111,1814,61.25%,38.59%,1
新北市,板橋區,1001,713,222,935,92,1027,1810,56.74%,39.39%,1
新北市,板橋區,1002,429,150,579,80,659,1133,58.16%,37.86%,1
新北市,板橋區,1003,324,108,432,41,473,841,56.24%,38.53%,1
新北市,板橋區,1004,465,135,600,55,655,1050,62.38%,44.29%,1
新北市,板橋區,1005,422,138,560,77,637,1130,56.37%,37.35%,1
新北市,板橋區,1006,438,155,593,67,660,1056,62.5%,41.48%,1
新北市,板橋區,1007,410,132,542,32,574,1129,50.84%,36.32%,1
新北市,板橋區,1008,678,201,879,92,971,1713,56.68%,39.58%,1
新北市,板橋區,1009,653,221,874,71,945,1622,58.26%,40.26%,1
新北市,板橋區,1010,658,183,841,51,892,1427,62.51%,46.11%,1
新北市,板橋區,1011,685,183,868,29,897,1471,60.98%,46.57%,1
新北市,板橋區,1012,402,128,530,23,553,1076,51.39%,37.36%,1
新北市,板橋區,1013,341,98,439,14,453,979,46.27%,34.83%,1
新北市,板橋區,1014,501,121,622,37,659,1079,61.08%,46.43%,1
新北市,板橋區,1015,304,107,411,61,472,828,57%,36.71%,1
新北市,板橋區,1016,313,134,447,68,515,820,62.8%,38.17%,1
新北市,板橋區,1017,408,125,533,49,582,989,58.85%,41.25%,1
新北市,板橋區,1018,366,162,528,73,601,1023,58.75%,35.78%,1
新北市,板橋區,1019,382,136,518,35,553,1044,52.97%,36.59%,1
新北市,板橋區,1020,376,135,511,60,571,968,58.99%,38.84%,1
新北市,板橋區,1021,501,163,664,34,698,1222,57.12%,41%,1
新北市,板橋區,1022,555,159,714,45,759,1385,54.8%,40.07%,1
新北市,板橋區,1023,574,207,781,78,859,1585,54.2%,36.21%,1
新北市,板橋區,1024,701,234,935,73,1008,1840,54.78%,38.1%,1
新北市,板橋區,1025,744,265,1009,109,1118,1806,61.9%,41.2%,1
新北市,板橋區,1026,570,203,773,89,862,1506,57.24%,37.85%,1
新北市,板橋區,1027,544,186,730,96,826,1476,55.96%,36.86%,1
新北市,板橋區,1028,619,183,802,71,873,1500,58.2%,41.27%,1
新北市,板橋區,1029,489,130,619,66,685,1096,62.5%,44.62%,1
新北市,板橋區,1030,388,145,533,70,603,963,62.62%,40.29%,1
新北市,板橋區,1031,628,168,796,45,841,1601,52.53%,39.23%,1
新北市,板橋區,1032,672,187,859,69,928,1507,61.58%,44.59%,1
新北市,板橋區,1033,550,191,741,77,818,1315,62.21%,41.83%,1
新北市,板橋區,1034,431,167,598,37,635,1178,53.9%,36.59%,1
新北市,板橋區,1035,776,225,1001,91,1092,1822,59.93%,42.59%,1
新北市,板橋區,1036,683,243,926,74,1000,1605,62.31%,42.55%,1
新北市,板橋區,1037,690,185,875,23,898,1549,57.97%,44.54%,1
新北市,板橋區,1038,893,205,1098,55,1153,1948,59.19%,45.84%,1
新北市,板橋區,1039,771,221,992,40,1032,1935,53.33%,39.84%,1
新北市,板橋區,1040,410,120,530,46,576,1097,52.51%,37.37%,1
新北市,板橋區,1041,394,149,543,54,597,1095,54.52%,35.98%,1
新北市,板橋區,1042,603,208,811,110,921,1678,54.89%,35.94%,1
新北市,板橋區,1043,637,219,856,109,965,1750,55.14%,36.4%,1
新北市,板橋區,1044,446,159,605,59,664,1187,55.94%,37.57%,1
新北市,板橋區,1045,492,144,636,29,665,1154,57.63%,42.63%,1
新北市,板橋區,1046,517,158,675,34,709,1262,56.18%,40.97%,1
新北市,板橋區,1047,474,146,620,95,715,1271,56.25%,37.29%,1
新北市,板橋區,1048,499,199,698,108,806,1410,57.16%,35.39%,1
新北市,板橋區,1049,643,166,809,92,901,1745,51.63%,36.85%,1
新北市,板橋區,1050,574,236,810,130,940,1867,50.35%,30.74%,1
新北市,板橋區,1051,724,208,932,92,1024,1753,58.41%,41.3%,1
新北市,板橋區,1052,487,170,657,66,723,1204,60.05%,40.45%,1
新北市,板橋區,1053,619,190,809,77,886,1614,54.89%,38.35%,1
新北市,板橋區,1054,521,169,690,50,740,1237,59.82%,42.12%,1
新北市,板橋區,1055,532,190,722,76,798,1361,58.63%,39.09%,1
新北市,板橋區,1056,482,176,658,31,689,1243,55.43%,38.78%,1
新北市,板橋區,1057,556,161,717,38,755,1515,49.83%,36.7%,1
新北市,板橋區,1058,618,202,820,87,907,1515,59.87%,40.79%,1
新北市,板橋區,1059,393,126,519,63,582,949,61.33%,41.41%,1
新北市,板橋區,1060,639,208,847,78,925,1629,56.78%,39.23%,1
新北市,板橋區,1061,494,169,663,46,709,1238,57.27%,39.9%,1
新北市,板橋區,1062,277,76,353,38,391,901,43.4%,30.74%,1
新北市,板橋區,1063,576,178,754,90,844,1475,57.22%,39.05%,1
新北市,板橋區,1064,549,194,743,84,827,1481,55.84%,37.07%,1
新北市,板橋區,1065,626,208,834,90,924,1800,51.33%,34.78%,1
新北市,板橋區,1066,636,202,838,61,899,1630,55.15%,39.02%,1
新北市,板橋區,1067,552,170,722,51,773,1298,59.55%,42.53%,1
新北市,板橋區,1068,376,104,480,42,522,874,59.73%,43.02%,1
新北市,板橋區,1069,377,120,497,21,518,992,52.22%,38%,1
新北市,板橋區,1070,459,153,612,20,632,1034,61.12%,44.39%,1
新北市,板橋區,1071,585,209,794,76,870,1451,59.96%,40.32%,1
新北市,板橋區,1072,485,136,621,54,675,1130,59.73%,42.92%,1
新北市,板橋區,1073,614,173,787,60,847,1440,58.82%,42.64%,1
新北市,板橋區,1074,599,214,813,95,908,1531,59.31%,39.12%,1
新北市,板橋區,1075,599,194,793,76,869,1349,64.42%,44.4%,1
新北市,板橋區,1076,564,203,767,45,812,1593,50.97%,35.4%,1
新北市,板橋區,1077,497,120,617,33,650,1174,55.37%,42.33%,1
新北市,板橋區,1078,499,143,642,53,695,1228,56.6%,40.64%,1
新北市,板橋區,1079,484,147,631,39,670,1187,56.44%,40.78%,1
新北市,板橋區,1080,364,117,481,54,535,870,61.49%,41.84%,1
新北市,板橋區,1081,918,251,1169,41,1210,2033,59.52%,45.15%,1
新北市,板橋區,1082,523,197,720,50,770,1418,54.3%,36.88%,1
新北市,板橋區,1083,398,161,559,59,618,1075,57.49%,37.02%,1
新北市,板橋區,1084,585,157,742,44,786,1515,51.88%,38.61%,1
新北市,板橋區,1085,528,162,690,49,739,1182,62.52%,44.67%,1
新北市,板橋區,1086,740,228,968,77,1045,1893,55.2%,39.09%,1
新北市,板橋區,1087,497,159,656,67,723,1302,55.53%,38.17%,1
新北市,板橋區,1088,490,172,662,47,709,1366,51.9%,35.87%,1
新北市,板橋區,1089,566,180,746,78,824,1318,62.52%,42.94%,1
新北市,板橋區,1090,488,141,629,40,669,1200,55.75%,40.67%,1
新北市,板橋區,1091,825,262,1087,48,1135,2028,55.97%,40.68%,1
新北市,板橋區,1092,668,241,909,113,1022,1746,58.53%,38.26%,1
新北市,板橋區,1093,760,180,940,31,971,1954,49.69%,38.89%,1
新北市,板橋區,1094,595,166,761,65,826,1474,56.04%,40.37%,1
新北市,板橋區,1095,544,184,728,60,788,1418,55.57%,38.36%,1
新北市,板橋區,1096,665,232,897,66,963,1563,61.61%,42.55%,1
新北市,板橋區,1097,697,206,903,101,1004,1780,56.4%,39.16%,1
新北市,板橋區,1098,667,209,876,56,932,1707,54.6%,39.07%,1
新北市,板橋區,1099,248,61,309,9,318,906,35.1%,27.37%,1
新北市,板橋區,1100,397,129,526,64,590,1030,57.28%,38.54%,1
新北市,板橋區,1101,446,157,603,46,649,1115,58.21%,40%,1
新北市,板橋區,1102,731,199,930,27,957,1836,52.12%,39.81%,1
新北市,板橋區,1103,695,244,939,86,1025,1881,54.49%,36.95%,1
新北市,板橋區,1104,695,180,875,41,916,1688,54.27%,41.17%,1
新北市,板橋區,1105,816,176,992,44,1036,1760,58.86%,46.36%,1
新北市,板橋區,1106,450,146,596,54,650,1044,62.26%,43.1%,1
新北市,板橋區,1107,469,141,610,41,651,1043,62.42%,44.97%,1
新北市,板橋區,1108,490,137,627,59,686,1099,62.42%,44.59%,1
新北市,板橋區,1109,508,163,671,53,724,1260,57.46%,40.32%,1
新北市,板橋區,1110,470,143,613,40,653,1131,57.74%,41.56%,1
新北市,板橋區,1111,497,165,662,56,718,1225,58.61%,40.57%,1
新北市,板橋區,1112,660,182,842,56,898,1455,61.72%,45.36%,1
新北市,板橋區,1113,468,184,652,66,718,1267,56.67%,36.94%,1
新北市,板橋區,1114,392,139,531,63,594,972,61.11%,40.33%,1
新北市,板橋區,1115,403,138,541,41,582,994,58.55%,40.54%,1
新北市,板橋區,1116,479,142,621,20,641,1111,57.7%,43.11%,1
新北市,板橋區,1117,530,176,706,72,778,1177,66.1%,45.03%,1
新北市,板橋區,1118,615,172,787,69,856,1544,55.44%,39.83%,1
新北市,板橋區,1119,395,118,513,78,591,1021,57.88%,38.69%,1
新北市,板橋區,1120,417,114,531,57,588,1040,56.54%,40.1%,1
新北市,板橋區,1121,603,179,782,35,817,1504,54.32%,40.09%,1
新北市,板橋區,1122,580,124,704,39,743,1373,54.12%,42.24%,1
新北市,板橋區,1123,519,154,673,32,705,1210,58.26%,42.89%,1
新北市,板橋區,1124,547,350,897,65,962,1809,53.18%,30.24%,1
新北市,板橋區,1125,659,173,832,85,917,1551,59.12%,42.49%,1
新北市,板橋區,1126,610,170,780,29,809,1408,57.46%,43.32%,1
新北市,板橋區,1127,586,125,711,32,743,1285,57.82%,45.6%,1
新北市,板橋區,1128,475,173,648,37,685,1102,62.16%,43.1%,1
新北市,板橋區,1129,542,135,677,35,712,1399,50.89%,38.74%,1
新北市,板橋區,1130,683,173,856,99,955,1692,56.44%,40.37%,1
新北市,板橋區,1131,709,215,924,35,959,1625,59.02%,43.63%,1
新北市,板橋區,1132,693,225,918,74,992,1712,57.94%,40.48%,1
新北市,板橋區,1133,509,150,659,38,697,1246,55.94%,40.85%,1
新北市,板橋區,1134,612,180,792,32,824,1471,56.02%,41.6%,1
新北市,板橋區,1135,728,196,924,70,994,1761,56.45%,41.34%,1
新北市,板橋區,1136,612,181,793,72,865,1499,57.71%,40.83%,1
新北市,板橋區,1137,561,187,748,52,800,1528,52.36%,36.71%,1
新北市,板橋區,1138,624,191,815,63,878,1536,57.16%,40.63%,1
新北市,板橋區,1139,647,190,837,50,887,1550,57.23%,41.74%,1
新北市,板橋區,1140,839,263,1102,85,1187,2050,57.9%,40.93%,1
新北市,板橋區,1141,548,161,709,59,768,1300,59.08%,42.15%,1
新北市,板橋區,1142,662,169,831,37,868,1537,56.47%,43.07%,1
新北市,板橋區,1143,491,142,633,25,658,1341,49.07%,36.61%,1
新北市,板橋區,1144,662,207,869,31,900,1606,56.04%,41.22%,1
新北市,板橋區,1145,546,139,685,44,729,1433,50.87%,38.1%,1
新北市,板橋區,1146,611,176,787,42,829,1685,49.2%,36.26%,1
新北市,板橋區,1147,542,166,708,57,765,1248,61.3%,43.43%,1
新北市,板橋區,1148,484,110,594,52,646,1172,55.12%,41.3%,1
新北市,板橋區,1149,558,161,719,29,748,1640,45.61%,34.02%,1
新北市,板橋區,1150,535,154,689,42,731,1428,51.19%,37.46%,1
新北市,板橋區,1151,603,200,803,74,877,1527,57.43%,39.49%,1
新北市,板橋區,1152,596,163,759,31,790,1350,58.52%,44.15%,1
新北市,板橋區,1153,673,159,832,62,894,1582,56.51%,42.54%,1
新北市,板橋區,1154,434,115,549,48,597,919,64.96%,47.23%,1
新北市,板橋區,1155,397,103,500,23,523,930,56.24%,42.69%,1
新北市,板橋區,1156,442,125,567,27,594,974,60.99%,45.38%,1
新北市,板橋區,1157,786,148,934,37,971,1732,56.06%,45.38%,1
新北市,板橋區,1158,605,148,753,55,808,1438,56.19%,42.07%,1
新北市,板橋區,1159,600,261,861,106,967,1777,54.42%,33.76%,1
新北市,板橋區,1160,620,195,815,63,878,1764,49.77%,35.15%,1
新北市,板橋區,1161,515,155,670,20,690,1289,53.53%,39.95%,1
新北市,板橋區,1162,508,110,618,53,671,1182,56.77%,42.98%,1
新北市,板橋區,1163,486,160,646,65,711,1174,60.56%,41.4%,1
新北市,板橋區,1164,700,203,903,105,1008,1870,53.9%,37.43%,1
新北市,板橋區,1165,796,216,1012,60,1072,1842,58.2%,43.21%,1
新北市,板橋區,1166,457,122,579,54,633,1094,57.86%,41.77%,1
新北市,板橋區,1167,473,155,628,50,678,1228,55.21%,38.52%,1
新北市,板橋區,1168,453,145,598,49,647,998,64.83%,45.39%,1
新北市,板橋區,1169,456,118,574,40,614,862,71.23%,52.9%,1
新北市,板橋區,1170,583,204,787,66,853,1622,52.59%,35.94%,1
新北市,板橋區,1171,496,158,654,67,721,1205,59.83%,41.16%,1
新北市,板橋區,1172,658,193,851,57,908,1787,50.81%,36.82%,1
新北市,板橋區,1173,712,159,871,45,916,1610,56.89%,44.22%,1
新北市,板橋區,1174,950,290,1240,39,1279,2216,57.72%,42.87%,1
新北市,板橋區,1175,931,281,1212,56,1268,2294,55.27%,40.58%,1
新北市,板橋區,1176,790,218,1008,87,1095,2090,52.39%,37.8%,1
新北市,板橋區,1177,513,116,629,39,668,1356,49.26%,37.83%,1
新北市,板橋區,1178,446,135,581,41,622,1067,58.29%,41.8%,1
新北市,板橋區,1179,531,184,715,51,766,1319,58.07%,40.26%,1
新北市,板橋區,1180,450,155,605,55,660,1316,50.15%,34.19%,1
新北市,板橋區,1181,435,145,580,70,650,1195,54.39%,36.4%,1
新北市,板橋區,1182,325,114,439,34,473,857,55.19%,37.92%,1
新北市,板橋區,1183,524,170,694,78,772,1417,54.48%,36.98%,1
新北市,板橋區,1184,595,223,818,80,898,1560,57.56%,38.14%,1
新北市,板橋區,1185,688,248,936,93,1029,1747,58.9%,39.38%,1
新北市,板橋區,1186,528,175,703,53,756,1176,64.29%,44.9%,1
新北市,板橋區,1187,469,147,616,28,644,1101,58.49%,42.6%,1
新北市,板橋區,1188,606,178,784,30,814,1458,55.83%,41.56%,1
新北市,板橋區,1189,605,147,752,48,800,1630,49.08%,37.12%,1
新北市,板橋區,1190,615,173,788,100,888,1611,55.12%,38.18%,1
新北市,板橋區,1191,428,126,554,42,596,1139,52.33%,37.58%,1
新北市,板橋區,1192,456,110,566,33,599,1120,53.48%,40.71%,1
新北市,板橋區,1193,419,147,566,88,654,1022,63.99%,41%,1
新北市,板橋區,1194,393,162,555,82,637,1049,60.72%,37.46%,1
新北市,板橋區,1195,449,113,562,23,585,1007,58.09%,44.59%,1
新北市,板橋區,1196,610,134,744,36,780,1393,55.99%,43.79%,1
新北市,板橋區,1197,126,39,165,35,200,474,42.19%,26.58%,1
新北市,板橋區,1198,206,69,275,27,302,500,60.4%,41.2%,1
新北市,板橋區,1199,441,160,601,44,645,1177,54.8%,37.47%,1
新北市,板橋區,1200,472,131,603,33,636,1186,53.63%,39.8%,1
新北市,板橋區,1201,506,147,653,58,711,1139,62.42%,44.42%,1
新北市,板橋區,1202,681,205,886,69,955,1750,54.57%,38.91%,1
新北市,板橋區,1203,914,229,1143,30,1173,3451,33.99%,26.49%,1
新北市,板橋區,1204,595,184,779,79,858,1620,52.96%,36.73%,1
新北市,板橋區,1205,328,82,410,23,433,903,47.95%,36.32%,1
新北市,板橋區,1206,513,162,675,44,719,1232,58.36%,41.64%,1
新北市,板橋區,1207,344,106,450,21,471,975,48.31%,35.28%,1
新北市,板橋區,1208,462,139,601,42,643,1224,52.53%,37.75%,1
新北市,板橋區,1209,525,144,669,39,708,1291,54.84%,40.67%,1
新北市,板橋區,1210,655,204,859,42,901,1828,49.29%,35.83%,1
新北市,板橋區,1211,629,178,807,52,859,1725,49.8%,36.46%,1
新北市,板橋區,1212,387,114,501,29,530,1085,48.85%,35.67%,1
新北市,板橋區,1213,911,225,1136,71,1207,2357,51.21%,38.65%,1
新北市,板橋區,1214,612,174,786,35,821,1560,52.63%,39.23%,1
新北市,板橋區,1215,740,152,892,32,924,2201,41.98%,33.62%,1
新北市,板橋區,1216,605,187,792,115,907,1626,55.78%,37.21%,1
新北市,板橋區,1217,598,161,759,54,813,1786,45.52%,33.48%,1
新北市,板橋區,1218,666,203,869,54,923,1763,52.35%,37.78%,1
新北市,板橋區,1219,645,157,802,34,836,1744,47.94%,36.98%,1
新北市,板橋區,1220,639,163,802,53,855,1645,51.98%,38.84%,1
新北市,板橋區,1221,699,154,853,47,900,1861,48.36%,37.56%,1
新北市,板橋區,1222,586,159,745,31,776,1596,48.62%,36.72%,1
新北市,板橋區,1223,713,237,950,61,1011,1871,54.04%,38.11%,1
新北市,板橋區,1224,883,213,1096,69,1165,1938,60.11%,45.56%,1
新北市,板橋區,1225,760,206,966,47,1013,1827,55.45%,41.6%,1
新北市,板橋區,1226,566,119,685,29,714,1359,52.54%,41.65%,1
新北市,板橋區,1227,675,148,823,60,883,1613,54.74%,41.85%,1
新北市,板橋區,1228,599,202,801,81,882,1566,56.32%,38.25%,1
新北市,板橋區,1229,695,184,879,47,926,1552,59.66%,44.78%,1
新北市,板橋區,1230,698,239,937,34,971,1885,51.51%,37.03%,1
新北市,板橋區,1231,684,238,922,66,988,1893,52.19%,36.13%,1
新北市,三重區,0659,564,168,732,75,807,1509,53.48%,37.38%,1
新北市,三重區,0660,663,198,861,68,929,1591,58.39%,41.67%,1
新北市,三重區,0661,640,238,878,70,948,1653,57.35%,38.72%,1
新北市,三重區,0662,558,185,743,81,824,1392,59.2%,40.09%,1
新北市,三重區,0663,594,186,780,99,879,1451,60.58%,40.94%,1
新北市,三重區,0664,479,199,678,87,765,1329,57.56%,36.04%,1
新北市,三重區,0665,589,196,785,47,832,1459,57.03%,40.37%,1
新北市,三重區,0666,418,131,549,68,617,1024,60.25%,40.82%,1
新北市,三重區,0667,427,152,579,62,641,1066,60.13%,40.06%,1
新北市,三重區,0668,360,136,496,70,566,856,66.12%,42.06%,1
新北市,三重區,0669,299,101,400,40,440,764,57.59%,39.14%,1
新北市,三重區,0670,327,134,461,47,508,821,61.88%,39.83%,1
新北市,三重區,0671,703,210,913,70,983,1887,52.09%,37.25%,1
新北市,三重區,0672,598,217,815,51,866,1646,52.61%,36.33%,1
新北市,三重區,0673,143,51,194,19,213,358,59.5%,39.94%,1
新北市,三重區,0674,452,118,570,52,622,1039,59.87%,43.5%,1
新北市,三重區,0675,445,188,633,42,675,1114,60.59%,39.95%,1
新北市,三重區,0676,676,214,890,41,931,1588,58.63%,42.57%,1
新北市,三重區,0677,652,215,867,43,910,1702,53.47%,38.31%,1
新北市,三重區,0678,538,191,729,61,790,1288,61.34%,41.77%,1
新北市,三重區,0679,667,236,903,74,977,1629,59.98%,40.95%,1
新北市,三重區,0680,768,199,967,78,1045,1861,56.15%,41.27%,1
新北市,三重區,0681,661,182,843,42,885,1727,51.24%,38.27%,1
新北市,三重區,0682,733,216,949,55,1004,1813,55.38%,40.43%,1
新北市,三重區,0683,647,179,826,74,900,1595,56.43%,40.56%,1
新北市,三重區,0684,602,207,809,75,884,1513,58.43%,39.79%,1
新北市,三重區,0685,533,231,764,57,821,4433,18.52%,12.02%,1
新北市,三重區,0686,535,167,702,43,745,1283,58.07%,41.7%,1
新北市,三重區,0687,647,177,824,48,872,1430,60.98%,45.24%,1
新北市,三重區,0688,609,167,776,40,816,1357,60.13%,44.88%,1
新北市,三重區,0689,401,128,529,41,570,963,59.19%,41.64%,1
新北市,三重區,0690,344,129,473,52,525,883,59.46%,38.96%,1
新北市,三重區,0691,569,206,775,99,874,1494,58.5%,38.09%,1
新北市,三重區,0692,636,197,833,96,929,1616,57.49%,39.36%,1
新北市,三重區,0693,529,153,682,77,759,1329,57.11%,39.8%,1
新北市,三重區,0694,557,191,748,58,806,1289,62.53%,43.21%,1
新北市,三重區,0695,535,186,721,85,806,1380,58.41%,38.77%,1
新北市,三重區,0696,714,180,894,46,940,1668,56.35%,42.81%,1
新北市,三重區,0697,541,161,702,74,776,1226,63.3%,44.13%,1
新北市,三重區,0698,578,198,776,99,875,1421,61.58%,40.68%,1
新北市,三重區,0699,570,176,746,55,801,1364,58.72%,41.79%,1
新北市,三重區,0700,515,161,676,56,732,1232,59.42%,41.8%,1
新北市,三重區,0701,549,163,712,67,779,1248,62.42%,43.99%,1
新北市,三重區,0702,491,196,687,64,751,1256,59.79%,39.09%,1
新北市,三重區,0703,636,227,863,68,931,1506,61.82%,42.23%,1
新北市,三重區,0704,695,220,915,72,987,1669,59.14%,41.64%,1
新北市,三重區,0705,500,163,663,102,765,1308,58.49%,38.23%,1
新北市,三重區,0706,594,167,761,68,829,1263,65.64%,47.03%,1
新北市,三重區,0707,565,184,749,88,837,1471,56.9%,38.41%,1
新北市,三重區,0708,581,182,763,110,873,1447,60.33%,40.15%,1
新北市,三重區,0709,564,196,760,71,831,1693,49.08%,33.31%,1
新北市,三重區,0710,792,241,1033,53,1086,2015,53.9%,39.31%,1
新北市,三重區,0711,651,191,842,105,947,1812,52.26%,35.93%,1
新北市,三重區,0712,525,188,713,41,754,1509,49.97%,34.79%,1
新北市,三重區,0713,580,175,755,63,818,1439,56.85%,40.31%,1
新北市,三重區,0714,559,192,751,59,810,1437,56.37%,38.9%,1
新北市,三重區,0715,644,209,853,66,919,1697,54.15%,37.95%,1
新北市,三重區,0716,751,115,866,47,913,1793,50.92%,41.89%,1
新北市,三重區,0717,689,214,903,56,959,1603,59.83%,42.98%,1
新北市,三重區,0718,445,146,591,44,635,1166,54.46%,38.16%,1
新北市,三重區,0719,468,151,619,45,664,1126,58.97%,41.56%,1
新北市,三重區,0720,447,136,583,64,647,1291,50.12%,34.62%,1
新北市,三重區,0721,615,110,725,81,806,1597,50.47%,38.51%,1
新北市,三重區,0722,439,155,594,68,662,1081,61.24%,40.61%,1
新北市,三重區,0723,403,125,528,60,588,911,64.54%,44.24%,1
新北市,三重區,0724,581,201,782,57,839,1719,48.81%,33.8%,1
新北市,三重區,0725,482,152,634,90,724,1289,56.17%,37.39%,1
新北市,三重區,0726,547,164,711,93,804,1318,61%,41.5%,1
新北市,三重區,0727,643,224,867,75,942,1822,51.7%,35.29%,1
新北市,三重區,0728,440,151,591,100,691,1185,58.31%,37.13%,1
新北市,三重區,0729,466,164,630,92,722,1369,52.74%,34.04%,1
新北市,三重區,0730,587,197,784,73,857,1507,56.87%,38.95%,1
新北市,三重區,0731,371,113,484,69,553,926,59.72%,40.06%,1
新北市,三重區,0732,329,114,443,24,467,950,49.16%,34.63%,1
新北市,三重區,0733,605,200,805,83,888,1678,52.92%,36.05%,1
新北市,三重區,0734,412,150,562,76,638,1117,57.12%,36.88%,1
新北市,三重區,0735,483,151,634,66,700,1318,53.11%,36.65%,1
新北市,三重區,0736,516,198,714,40,754,1388,54.32%,37.18%,1
新北市,三重區,0737,386,139,525,74,599,1026,58.38%,37.62%,1
新北市,三重區,0738,483,154,637,48,685,1096,62.5%,44.07%,1
新北市,三重區,0739,411,123,534,37,571,967,59.05%,42.5%,1
新北市,三重區,0740,660,241,901,71,972,1871,51.95%,35.28%,1
新北市,三重區,0741,628,212,840,96,936,1663,56.28%,37.76%,1
新北市,三重區,0742,477,130,607,30,637,1208,52.73%,39.49%,1
新北市,三重區,0743,490,165,655,67,722,1398,51.65%,35.05%,1
新北市,三重區,0744,411,128,539,31,570,1078,52.88%,38.13%,1
新北市,三重區,0745,413,121,534,70,604,1102,54.81%,37.48%,1
新北市,三重區,0746,503,187,690,77,767,1393,55.06%,36.11%,1
新北市,三重區,0747,490,182,672,67,739,1251,59.07%,39.17%,1
新北市,三重區,0748,545,166,711,75,786,1234,63.7%,44.17%,1
新北市,三重區,0749,657,219,876,84,960,1661,57.8%,39.55%,1
新北市,三重區,0750,615,207,822,85,907,1590,57.04%,38.68%,1
新北市,三重區,0751,474,166,640,64,704,1182,59.56%,40.1%,1
新北市,三重區,0752,547,201,748,70,818,1369,59.75%,39.96%,1
新北市,三重區,0753,521,181,702,56,758,1222,62.03%,42.64%,1
新北市,三重區,0754,484,160,644,97,741,1304,56.83%,37.12%,1
新北市,三重區,0755,398,119,517,48,565,1054,53.61%,37.76%,1
新北市,三重區,0756,623,223,846,70,916,1635,56.02%,38.1%,1
新北市,三重區,0757,650,208,858,78,936,1779,52.61%,36.54%,1
新北市,三重區,0758,624,213,837,97,934,1633,57.2%,38.21%,1
新北市,三重區,0759,444,137,581,59,640,1107,57.81%,40.11%,1
新北市,三重區,0760,427,154,581,52,633,1021,62%,41.82%,1
新北市,三重區,0761,538,208,746,105,851,1649,51.61%,32.63%,1
新北市,三重區,0762,378,103,481,37,518,874,59.27%,43.25%,1
新北市,三重區,0763,540,176,716,104,820,1402,58.49%,38.52%,1
新北市,三重區,0764,570,192,762,101,863,1713,50.38%,33.27%,1
新北市,三重區,0765,323,108,431,59,490,973,50.36%,33.2%,1
新北市,三重區,0766,417,141,558,56,614,1038,59.15%,40.17%,1
新北市,三重區,0767,615,201,816,123,939,1833,51.23%,33.55%,1
新北市,三重區,0768,311,105,416,32,448,817,54.83%,38.07%,1
新北市,三重區,0769,637,170,807,66,873,1387,62.94%,45.93%,1
新北市,三重區,0770,336,100,436,37,473,784,60.33%,42.86%,1
新北市,三重區,0771,400,145,545,35,580,1096,52.92%,36.5%,1
新北市,三重區,0772,452,162,614,74,688,1163,59.16%,38.87%,1
新北市,三重區,0773,719,190,909,63,972,1868,52.03%,38.49%,1
新北市,三重區,0774,397,144,541,74,615,1117,55.06%,35.54%,1
新北市,三重區,0775,330,122,452,49,501,934,53.64%,35.33%,1
新北市,三重區,0776,485,179,664,76,740,1412,52.41%,34.35%,1
新北市,三重區,0777,482,138,620,50,670,1062,63.09%,45.39%,1
新北市,三重區,0778,328,100,428,85,513,891,57.58%,36.81%,1
新北市,三重區,0779,455,123,578,67,645,936,68.91%,48.61%,1
新北市,三重區,0780,390,141,531,69,600,1085,55.3%,35.94%,1
新北市,三重區,0781,337,151,488,21,509,1065,47.79%,31.64%,1
新北市,三重區,0782,567,166,733,68,801,1398,57.3%,40.56%,1
新北市,三重區,0783,652,168,820,65,885,1550,57.1%,42.06%,1
新北市,三重區,0784,626,185,811,96,907,1674,54.18%,37.4%,1
新北市,三重區,0785,475,162,637,72,709,1215,58.35%,39.09%,1
新北市,三重區,0786,581,221,802,77,879,1606,54.73%,36.18%,1
新北市,三重區,0787,467,140,607,56,663,1182,56.09%,39.51%,1
新北市,三重區,0788,481,161,642,86,728,1238,58.8%,38.85%,1
新北市,三重區,0789,559,179,738,59,797,1342,59.39%,41.65%,1
新北市,三重區,0790,570,185,755,64,819,1408,58.17%,40.48%,1
新北市,三重區,0791,663,230,893,98,991,1770,55.99%,37.46%,1
新北市,三重區,0792,362,134,496,54,550,940,58.51%,38.51%,1
新北市,三重區,0793,365,125,490,21,511,975,52.41%,37.44%,1
新北市,三重區,0794,584,174,758,43,801,1507,53.15%,38.75%,1
新北市,三重區,0795,521,212,733,80,813,1419,57.29%,36.72%,1
新北市,三重區,0796,515,145,660,58,718,1257,57.12%,40.97%,1
新北市,三重區,0797,631,199,830,90,920,1619,56.83%,38.97%,1
新北市,三重區,0798,688,180,868,85,953,1745,54.61%,39.43%,1
新北市,三重區,0799,578,197,775,79,854,1519,56.22%,38.05%,1
新北市,三重區,0800,605,204,809,80,889,1682,52.85%,35.97%,1
新北市,三重區,0801,703,220,923,71,994,1697,58.57%,41.43%,1
新北市,三重區,0802,367,143,510,72,582,1073,54.24%,34.2%,1
新北市,三重區,0803,350,109,459,51,510,924,55.19%,37.88%,1
新北市,三重區,0804,524,173,697,60,757,1613,46.93%,32.49%,1
新北市,三重區,0805,378,113,491,64,555,1034,53.68%,36.56%,1
新北市,三重區,0806,430,151,581,62,643,1118,57.51%,38.46%,1
新北市,三重區,0807,454,165,619,86,705,1269,55.56%,35.78%,1
新北市,三重區,0808,339,136,475,77,552,990,55.76%,34.24%,1
新北市,三重區,0809,507,158,665,91,756,1336,56.59%,37.95%,1
新北市,三重區,0810,637,186,823,76,899,1601,56.15%,39.79%,1
新北市,三重區,0811,649,217,866,87,953,1581,60.28%,41.05%,1
新北市,三重區,0812,556,157,713,70,783,1345,58.22%,41.34%,1
新北市,三重區,0813,502,186,688,65,753,1226,61.42%,40.95%,1
新北市,三重區,0814,606,162,768,93,861,1650,52.18%,36.73%,1
新北市,三重區,0815,458,123,581,73,654,1140,57.37%,40.18%,1
新北市,三重區,0816,635,176,811,43,854,1639,52.1%,38.74%,1
新北市,三重區,0817,692,178,870,80,950,1699,55.92%,40.73%,1
新北市,三重區,0818,711,189,900,94,994,1501,66.22%,47.37%,1
新北市,三重區,0819,605,187,792,76,868,1538,56.44%,39.34%,1
新北市,三重區,0820,580,176,756,88,844,1540,54.81%,37.66%,1
新北市,三重區,0821,513,146,659,56,715,1276,56.03%,40.2%,1
新北市,三重區,0822,547,210,757,78,835,1539,54.26%,35.54%,1
新北市,三重區,0823,468,180,648,55,703,1170,60.09%,40%,1
新北市,三重區,0824,433,150,583,55,638,1120,56.96%,38.66%,1
新北市,三重區,0825,669,238,907,97,1004,1789,56.12%,37.4%,1
新北市,三重區,0826,553,180,733,77,810,1520,53.29%,36.38%,1
新北市,三重區,0827,700,231,931,85,1016,1821,55.79%,38.44%,1
新北市,三重區,0828,541,178,719,74,793,1407,56.36%,38.45%,1
新北市,三重區,0829,584,178,762,73,835,1491,56%,39.17%,1
新北市,三重區,0830,570,179,749,71,820,1381,59.38%,41.27%,1
新北市,三重區,0831,450,173,623,85,708,1222,57.94%,36.82%,1
新北市,三重區,0832,752,202,954,65,1019,1938,52.58%,38.8%,1
新北市,三重區,0833,613,199,812,52,864,1639,52.72%,37.4%,1
新北市,三重區,0834,660,162,822,83,905,1614,56.07%,40.89%,1
新北市,三重區,0835,729,145,874,57,931,1709,54.48%,42.66%,1
新北市,三重區,0836,659,173,832,79,911,1753,51.97%,37.59%,1
新北市,三重區,0837,546,195,741,77,818,1398,58.51%,39.06%,1
新北市,三重區,0838,613,216,829,88,917,1706,53.75%,35.93%,1
新北市,三重區,0839,639,218,857,67,924,1614,57.25%,39.59%,1
新北市,三重區,0840,605,223,828,98,926,1591,58.2%,38.03%,1
新北市,三重區,0841,601,204,805,64,869,1627,53.41%,36.94%,1
新北市,三重區,0842,610,186,796,81,877,1505,58.27%,40.53%,1
新北市,三重區,0843,554,142,696,56,752,1331,56.5%,41.62%,1
新北市,三重區,0844,624,181,805,58,863,1678,51.43%,37.19%,1
新北市,三重區,0845,585,192,777,69,846,1498,56.48%,39.05%,1
新北市,三重區,0846,726,251,977,74,1051,1800,58.39%,40.33%,1
新北市,三重區,0847,630,157,787,49,836,1703,49.09%,36.99%,1
新北市,三重區,0848,714,208,922,55,977,1975,49.47%,36.15%,1
新北市,三重區,0849,687,231,918,64,982,1894,51.85%,36.27%,1
新北市,三重區,0850,591,179,770,54,824,1405,58.65%,42.06%,1
新北市,三重區,0851,600,100,700,42,742,1293,57.39%,46.4%,1
新北市,三重區,0852,473,195,668,57,725,1259,57.59%,37.57%,1
新北市,三重區,0853,478,147,625,83,708,1144,61.89%,41.78%,1
新北市,三重區,0854,527,155,682,85,767,1254,61.16%,42.03%,1
新北市,三重區,0855,510,170,680,63,743,1313,56.59%,38.84%,1
新北市,三重區,0856,596,192,788,86,874,1594,54.83%,37.39%,1
新北市,三重區,0857,697,205,902,70,972,1775,54.76%,39.27%,1
新北市,三重區,0858,562,184,746,103,849,1516,56%,37.07%,1
新北市,三重區,0859,548,178,726,94,820,1315,62.36%,41.67%,1
新北市,三重區,0860,325,126,451,68,519,843,61.57%,38.55%,1
新北市,三重區,0861,429,127,556,66,622,1160,53.62%,36.98%,1
新北市,三重區,0862,416,138,554,63,617,1052,58.65%,39.54%,1
新北市,三重區,0863,434,170,604,62,666,1054,63.19%,41.18%,1
新北市,三重區,0864,370,149,519,68,587,997,58.88%,37.11%,1
新北市,三重區,0865,339,117,456,45,501,936,53.53%,36.22%,1
新北市,三重區,0866,630,197,827,81,908,1658,54.76%,38%,1
新北市,三重區,0867,552,185,737,78,815,1496,54.48%,36.9%,1
新北市,三重區,0868,453,143,596,59,655,1064,61.56%,42.58%,1
新北市,三重區,0869,492,149,641,63,704,1152,61.11%,42.71%,1
新北市,三重區,0870,595,141,736,50,786,1532,51.31%,38.84%,1
新北市,三重區,0871,475,124,599,39,638,1338,47.68%,35.5%,1
新北市,三重區,0872,528,162,690,68,758,1303,58.17%,40.52%,1
新北市,三重區,0873,574,194,768,88,856,1369,62.53%,41.93%,1
新北市,三重區,0874,575,169,744,89,833,1491,55.87%,38.56%,1
新北市,三重區,0875,626,216,842,106,948,1821,52.06%,34.38%,1
新北市,三重區,0876,705,202,907,58,965,1906,50.63%,36.99%,1
新北市,三重區,0877,732,249,981,62,1043,1842,56.62%,39.74%,1
新北市,三重區,0878,320,105,425,48,473,878,53.87%,36.45%,1
新北市,三重區,0879,412,143,555,58,613,963,63.66%,42.78%,1
新北市,三重區,0880,471,148,619,30,649,1381,46.99%,34.11%,1
新北市,三重區,0881,557,204,761,75,836,1681,49.73%,33.14%,1
新北市,三重區,0882,565,183,748,43,791,1548,51.1%,36.5%,1
新北市,三重區,0883,632,199,831,63,894,1542,57.98%,40.99%,1
新北市,三重區,0884,567,186,753,71,824,1557,52.92%,36.42%,1
新北市,三重區,0885,667,172,839,61,900,1661,54.18%,40.16%,1
新北市,三重區,0886,830,217,1047,34,1081,2024,53.41%,41.01%,1
新北市,三重區,0887,541,176,717,78,795,1588,50.06%,34.07%,1
新北市,三重區,0888,545,293,838,127,965,1706,56.57%,31.95%,1
新北市,三重區,0889,550,183,733,49,782,1341,58.31%,41.01%,1
新北市,三重區,0890,376,115,491,42,533,1025,52%,36.68%,1
新北市,三重區,0891,546,139,685,78,763,1339,56.98%,40.78%,1
新北市,三重區,0892,628,224,852,107,959,1725,55.59%,36.41%,1
新北市,三重區,0893,694,222,916,82,998,1826,54.65%,38.01%,1
新北市,中和區,1232,601,177,778,67,845,1630,51.84%,36.87%,1
新北市,中和區,1233,731,202,933,59,992,1775,55.89%,41.18%,1
新北市,中和區,1234,722,159,881,36,917,1844,49.73%,39.15%,1
新北市,中和區,1235,494,148,642,32,674,1019,66.14%,48.48%,1
新北市,中和區,1236,539,118,657,35,692,1138,60.81%,47.36%,1
新北市,中和區,1237,761,140,901,48,949,1878,50.53%,40.52%,1
新北市,中和區,1238,911,171,1082,47,1129,1980,57.02%,46.01%,1
新北市,中和區,1239,761,201,962,74,1036,1844,56.18%,41.27%,1
新北市,中和區,1240,902,193,1095,37,1132,2085,54.29%,43.26%,1
新北市,中和區,1241,603,176,779,54,833,1498,55.61%,40.25%,1
新北市,中和區,1242,708,193,901,34,935,1761,53.09%,40.2%,1
新北市,中和區,1243,486,164,650,27,677,1254,53.99%,38.76%,1
新北市,中和區,1244,607,138,745,39,784,1343,58.38%,45.2%,1
新北市,中和區,1245,736,192,928,37,965,1789,53.94%,41.14%,1
新北市,中和區,1246,855,204,1059,35,1094,2000,54.7%,42.75%,1
新北市,中和區,1247,572,326,898,44,942,1953,48.23%,29.29%,1
新北市,中和區,1248,688,205,893,57,950,1712,55.49%,40.19%,1
新北市,中和區,1249,690,147,837,64,901,1582,56.95%,43.62%,1
新北市,中和區,1250,705,183,888,63,951,1742,54.59%,40.47%,1
新北市,中和區,1251,659,206,865,51,916,1493,61.35%,44.14%,1
新北市,中和區,1252,519,142,661,77,738,1352,54.59%,38.39%,1
新北市,中和區,1253,560,131,691,42,733,1244,58.92%,45.02%,1
新北市,中和區,1254,592,160,752,64,816,1394,58.54%,42.47%,1
新北市,中和區,1255,661,153,814,27,841,1917,43.87%,34.48%,1
新北市,中和區,1256,664,204,868,84,952,1830,52.02%,36.28%,1
新北市,中和區,1257,476,140,616,46,662,1124,58.9%,42.35%,1
新北市,中和區,1258,497,161,658,38,696,1412,49.29%,35.2%,1
新北市,中和區,1259,531,155,686,56,742,1356,54.72%,39.16%,1
新北市,中和區,1260,547,156,703,49,752,1425,52.77%,38.39%,1
新北市,中和區,1261,519,160,679,78,757,1259,60.13%,41.22%,1
新北市,中和區,1262,505,154,659,69,728,1256,57.96%,40.21%,1
新北市,中和區,1263,594,169,763,44,807,1423,56.71%,41.74%,1
新北市,中和區,1264,524,125,649,58,707,1221,57.9%,42.92%,1
新北市,中和區,1265,720,168,888,56,944,1858,50.81%,38.75%,1
新北市,中和區,1266,688,189,877,53,930,1804,51.55%,38.14%,1
新北市,中和區,1267,723,193,916,31,947,1669,56.74%,43.32%,1
新北市,中和區,1268,634,159,793,43,836,1485,56.3%,42.69%,1
新北市,中和區,1269,438,120,558,49,607,1005,60.4%,43.58%,1
新北市,中和區,1270,547,155,702,59,761,1175,64.77%,46.55%,1
新北市,中和區,1271,516,132,648,41,689,1171,58.84%,44.06%,1
新北市,中和區,1272,655,164,819,34,853,1746,48.85%,37.51%,1
新北市,中和區,1273,574,159,733,43,776,1555,49.9%,36.91%,1
新北市,中和區,1274,453,122,575,57,632,1112,56.83%,40.74%,1
新北市,中和區,1275,794,210,1004,47,1051,1780,59.04%,44.61%,1
新北市,中和區,1276,806,191,997,34,1031,1918,53.75%,42.02%,1
新北市,中和區,1277,575,150,725,37,762,1689,45.12%,34.04%,1
新北市,中和區,1278,775,194,969,32,1001,1781,56.2%,43.51%,1
新北市,中和區,1279,570,172,742,55,797,1419,56.17%,40.17%,1
新北市,中和區,1280,548,142,690,37,727,1344,54.09%,40.77%,1
新北市,中和區,1281,851,224,1075,49,1124,1804,62.31%,47.17%,1
新北市,中和區,1282,661,218,879,77,956,1788,53.47%,36.97%,1
新北市,中和區,1283,752,182,934,62,996,1793,55.55%,41.94%,1
新北市,中和區,1284,580,145,725,61,786,1352,58.14%,42.9%,1
新北市,中和區,1285,781,187,968,53,1021,1813,56.32%,43.08%,1
新北市,中和區,1286,644,131,775,41,816,1288,63.35%,50%,1
新北市,中和區,1287,470,157,627,35,662,1186,55.82%,39.63%,1
新北市,中和區,1288,451,156,607,9,616,1237,49.8%,36.46%,1
新北市,中和區,1289,569,155,724,42,766,1406,54.48%,40.47%,1
新北市,中和區,1290,567,162,729,80,809,1442,56.1%,39.32%,1
新北市,中和區,1291,457,127,584,51,635,1040,61.06%,43.94%,1
新北市,中和區,1292,563,176,739,50,789,1292,61.07%,43.58%,1
新北市,中和區,1293,722,198,920,61,981,1811,54.17%,39.87%,1
新北市,中和區,1294,711,206,917,104,1021,1789,57.07%,39.74%,1
新北市,中和區,1295,444,93,537,30,567,859,66.01%,51.69%,1
新北市,中和區,1296,506,87,593,33,626,972,64.4%,52.06%,1
新北市,中和區,1297,530,191,721,46,767,1346,56.98%,39.38%,1
新北市,中和區,1298,428,135,563,38,601,1034,58.12%,41.39%,1
新北市,中和區,1299,600,142,742,54,796,1387,57.39%,43.26%,1
新北市,中和區,1300,858,228,1086,88,1174,2067,56.8%,41.51%,1
新北市,中和區,1301,668,180,848,54,902,1670,54.01%,40%,1
新北市,中和區,1302,481,130,611,51,662,1166,56.78%,41.25%,1
新北市,中和區,1303,417,108,525,49,574,963,59.61%,43.3%,1
新北市,中和區,1304,413,109,522,37,559,1070,52.24%,38.6%,1
新北市,中和區,1305,560,138,698,47,745,1319,56.48%,42.46%,1
新北市,中和區,1306,649,158,807,62,869,1438,60.43%,45.13%,1
新北市,中和區,1307,729,157,886,31,917,1808,50.72%,40.32%,1
新北市,中和區,1308,498,89,587,22,609,1191,51.13%,41.81%,1
新北市,中和區,1309,667,168,835,64,899,1632,55.09%,40.87%,1
新北市,中和區,1310,705,155,860,41,901,1765,51.05%,39.94%,1
新北市,中和區,1311,581,94,675,28,703,1168,60.19%,49.74%,1
新北市,中和區,1312,506,100,606,31,637,1176,54.17%,43.03%,1
新北市,中和區,1313,793,135,928,55,983,1565,62.81%,50.67%,1
新北市,中和區,1314,597,166,763,47,810,1578,51.33%,37.83%,1
新北市,中和區,1315,865,165,1030,43,1073,2029,52.88%,42.63%,1
新北市,中和區,1316,390,99,489,32,521,905,57.57%,43.09%,1
新北市,中和區,1317,302,104,406,37,443,839,52.8%,36%,1
新北市,中和區,1318,312,98,410,28,438,762,57.48%,40.94%,1
新北市,中和區,1319,590,145,735,66,801,1420,56.41%,41.55%,1
新北市,中和區,1320,512,126,638,55,693,1272,54.48%,40.25%,1
新北市,中和區,1321,774,202,976,72,1048,1976,53.04%,39.17%,1
新北市,中和區,1322,763,146,909,48,957,1779,53.79%,42.89%,1
新北市,中和區,1323,504,147,651,51,702,1454,48.28%,34.66%,1
新北市,中和區,1324,563,101,664,39,703,1374,51.16%,40.98%,1
新北市,中和區,1325,561,88,649,45,694,1369,50.69%,40.98%,1
新北市,中和區,1326,605,158,763,64,827,1501,55.1%,40.31%,1
新北市,中和區,1327,429,114,543,56,599,920,65.11%,46.63%,1
新北市,中和區,1328,467,123,590,61,651,1050,62%,44.48%,1
新北市,中和區,1329,145,34,179,19,198,321,61.68%,45.17%,1
新北市,中和區,1330,603,117,720,62,782,1474,53.05%,40.91%,1
新北市,中和區,1331,616,154,770,68,838,1461,57.36%,42.16%,1
新北市,中和區,1332,653,148,801,58,859,1621,52.99%,40.28%,1
新北市,中和區,1333,565,188,753,68,821,1327,61.87%,42.58%,1
新北市,中和區,1334,312,101,413,33,446,775,57.55%,40.26%,1
新北市,中和區,1335,723,192,915,41,956,1916,49.9%,37.73%,1
新北市,中和區,1336,751,166,917,69,986,1901,51.87%,39.51%,1
新北市,中和區,1337,554,155,709,44,753,4411,17.07%,12.56%,1
新北市,中和區,1338,484,142,626,41,667,1212,55.03%,39.93%,1
新北市,中和區,1339,468,139,607,42,649,1126,57.64%,41.56%,1
新北市,中和區,1340,593,155,748,27,775,1507,51.43%,39.35%,1
新北市,中和區,1341,646,144,790,27,817,1519,53.79%,42.53%,1
新北市,中和區,1342,624,167,791,46,837,1467,57.06%,42.54%,1
新北市,中和區,1343,631,181,812,72,884,1453,60.84%,43.43%,1
新北市,中和區,1344,619,149,768,53,821,1364,60.19%,45.38%,1
新北市,中和區,1345,555,127,682,47,729,1302,55.99%,42.63%,1
新北市,中和區,1346,559,149,708,35,743,1627,45.67%,34.36%,1
新北市,中和區,1347,562,162,724,39,763,1503,50.77%,37.39%,1
新北市,中和區,1348,545,139,684,21,705,1392,50.65%,39.15%,1
新北市,中和區,1349,499,103,602,36,638,1067,59.79%,46.77%,1
新北市,中和區,1350,632,176,808,50,858,1623,52.87%,38.94%,1
新北市,中和區,1351,555,132,687,21,708,1208,58.61%,45.94%,1
新北市,中和區,1352,670,170,840,50,890,1991,44.7%,33.65%,1
新北市,中和區,1353,698,152,850,46,896,1932,46.38%,36.13%,1
新北市,中和區,1354,468,119,587,35,622,947,65.68%,49.42%,1
新北市,中和區,1355,707,187,894,58,952,1660,57.35%,42.59%,1
新北市,中和區,1356,580,139,719,66,785,1574,49.87%,36.85%,1
新北市,中和區,1357,800,205,1005,57,1062,2136,49.72%,37.45%,1
新北市,中和區,1358,538,166,704,76,780,1462,53.35%,36.8%,1
新北市,中和區,1359,593,144,737,71,808,1548,52.2%,38.31%,1
新北市,中和區,1360,349,86,435,22,457,692,66.04%,50.43%,1
新北市,中和區,1361,604,117,721,49,770,1221,63.06%,49.47%,1
新北市,中和區,1362,552,186,738,53,791,1331,59.43%,41.47%,1
新北市,中和區,1363,444,118,562,41,603,984,61.28%,45.12%,1
新北市,中和區,1364,720,174,894,51,945,1871,50.51%,38.48%,1
新北市,中和區,1365,512,128,640,36,676,1279,52.85%,40.03%,1
新北市,中和區,1366,679,199,878,44,922,1629,56.6%,41.68%,1
新北市,中和區,1367,638,167,805,36,841,1482,56.75%,43.05%,1
新北市,中和區,1368,729,205,934,64,998,1715,58.19%,42.51%,1
新北市,中和區,1369,835,189,1024,65,1089,1952,55.79%,42.78%,1
新北市,中和區,1370,277,89,366,34,400,686,58.31%,40.38%,1
新北市,中和區,1371,549,174,723,32,755,1577,47.88%,34.81%,1
新北市,中和區,1372,496,151,647,32,679,1158,58.64%,42.83%,1
新北市,中和區,1373,589,128,717,22,739,1195,61.84%,49.29%,1
新北市,中和區,1374,516,124,640,34,674,1054,63.95%,48.96%,1
新北市,中和區,1375,296,74,370,21,391,612,63.89%,48.37%,1
新北市,中和區,1376,742,158,900,36,936,1668,56.12%,44.48%,1
新北市,中和區,1377,454,154,608,72,680,1071,63.49%,42.39%,1
新北市,中和區,1378,580,158,738,59,797,1169,68.18%,49.62%,1
新北市,中和區,1379,525,158,683,49,732,1370,53.43%,38.32%,1
新北市,中和區,1380,672,186,858,89,947,1574,60.17%,42.69%,1
新北市,中和區,1381,892,233,1125,32,1157,2614,44.26%,34.12%,1
新北市,中和區,1382,646,179,825,40,865,1477,58.56%,43.74%,1
新北市,中和區,1383,394,158,552,59,611,1041,58.69%,37.85%,1
新北市,中和區,1384,563,163,726,62,788,1538,51.24%,36.61%,1
新北市,中和區,1385,600,193,793,53,846,1599,52.91%,37.52%,1
新北市,中和區,1386,669,196,865,79,944,1586,59.52%,42.18%,1
新北市,中和區,1387,676,246,922,97,1019,1726,59.04%,39.17%,1
新北市,中和區,1388,791,250,1041,85,1126,1854,60.73%,42.66%,1
新北市,中和區,1389,627,207,834,60,894,1472,60.73%,42.6%,1
新北市,中和區,1390,631,172,803,67,870,1430,60.84%,44.13%,1
新北市,中和區,1391,651,185,836,57,893,1488,60.01%,43.75%,1
新北市,中和區,1392,499,154,653,29,682,1251,54.52%,39.89%,1
新北市,中和區,1393,650,168,818,47,865,1487,58.17%,43.71%,1
新北市,中和區,1394,476,170,646,98,744,1328,56.02%,35.84%,1
新北市,中和區,1395,505,140,645,52,697,1128,61.79%,44.77%,1
新北市,中和區,1396,505,123,628,28,656,1008,65.08%,50.1%,1
新北市,中和區,1397,763,213,976,33,1009,1786,56.49%,42.72%,1
新北市,中和區,1398,885,239,1124,55,1179,2219,53.13%,39.88%,1
新北市,中和區,1399,458,170,628,37,665,1322,50.3%,34.64%,1
新北市,中和區,1400,702,140,842,26,868,1495,58.06%,46.96%,1
新北市,中和區,1401,550,154,704,57,761,1414,53.82%,38.9%,1
新北市,中和區,1402,675,216,891,76,967,1681,57.53%,40.15%,1
新北市,中和區,1403,535,157,692,59,751,1361,55.18%,39.31%,1
新北市,中和區,1404,574,170,744,58,802,1442,55.62%,39.81%,1
新北市,中和區,1405,527,163,690,24,714,1383,51.63%,38.11%,1
新北市,中和區,1406,530,142,672,39,711,1264,56.25%,41.93%,1
新北市,中和區,1407,731,226,957,105,1062,1810,58.67%,40.39%,1
新北市,中和區,1408,705,200,905,47,952,1951,48.8%,36.14%,1
新北市,中和區,1409,591,133,724,51,775,1582,48.99%,37.36%,1
新北市,中和區,1410,827,237,1064,88,1152,1945,59.23%,42.52%,1
新北市,中和區,1411,605,152,757,47,804,1390,57.84%,43.53%,1
新北市,中和區,1412,490,142,632,23,655,1161,56.42%,42.2%,1
新北市,中和區,1413,657,97,754,31,785,1399,56.11%,46.96%,1
新北市,中和區,1414,430,124,554,28,582,1070,54.39%,40.19%,1
新北市,中和區,1415,463,127,590,33,623,1169,53.29%,39.61%,1
新北市,中和區,1416,562,139,701,64,765,1214,63.01%,46.29%,1
新北市,中和區,1417,643,134,777,57,834,1398,59.66%,45.99%,1
新北市,中和區,1418,436,128,564,37,601,1049,57.29%,41.56%,1
新北市,中和區,1419,610,155,765,43,808,1324,61.03%,46.07%,1
新北市,中和區,1420,619,161,780,36,816,1765,46.23%,35.07%,1
新北市,中和區,1421,655,162,817,56,873,1709,51.08%,38.33%,1
新北市,中和區,1422,486,148,634,62,696,1186,58.68%,40.98%,1
新北市,中和區,1423,549,170,719,51,770,1318,58.42%,41.65%,1
新北市,中和區,1424,586,189,775,55,830,1430,58.04%,40.98%,1
新北市,中和區,1425,519,149,668,61,729,1637,44.53%,31.7%,1
新北市,中和區,1426,498,169,667,50,717,1283,55.88%,38.82%,1
新北市,中和區,1427,543,157,700,39,739,1310,56.41%,41.45%,1
新北市,中和區,1428,554,156,710,52,762,1301,58.57%,42.58%,1
新北市,中和區,1429,717,179,896,69,965,1681,57.41%,42.65%,1
新北市,中和區,1430,592,146,738,43,781,1384,56.43%,42.77%,1
新北市,中和區,1431,481,145,626,57,683,1187,57.54%,40.52%,1
新北市,中和區,1432,602,172,774,7,781,1779,43.9%,33.84%,1
新北市,中和區,1433,742,173,915,50,965,1712,56.37%,43.34%,1
新北市,中和區,1434,582,164,746,51,797,1462,54.51%,39.81%,1
新北市,中和區,1435,723,211,934,34,968,1824,53.07%,39.64%,1
新北市,中和區,1436,546,153,699,70,769,1389,55.36%,39.31%,1
新北市,中和區,1437,634,169,803,40,843,1434,58.79%,44.21%,1
新北市,中和區,1438,788,187,975,61,1036,1953,53.05%,40.35%,1
新北市,中和區,1439,838,230,1068,61,1129,2002,56.39%,41.86%,1
新北市,中和區,1440,756,170,926,36,962,1858,51.78%,40.69%,1
新北市,中和區,1441,755,168,923,34,957,1801,53.14%,41.92%,1
新北市,中和區,1442,732,176,908,57,965,1691,57.07%,43.29%,1
新北市,中和區,1443,606,151,757,51,808,1363,59.28%,44.46%,1
新北市,中和區,1444,602,123,725,26,751,1220,61.56%,49.34%,1
新北市,中和區,1445,660,146,806,29,835,1365,61.17%,48.35%,1
新北市,中和區,1446,518,120,638,27,665,1178,56.45%,43.97%,1
新北市,中和區,1447,360,108,468,36,504,830,60.72%,43.37%,1
新北市,中和區,1448,457,126,583,51,634,1197,52.97%,38.18%,1
新北市,中和區,1449,580,167,747,54,801,1369,58.51%,42.37%,1
新北市,中和區,1450,612,136,748,50,798,1336,59.73%,45.81%,1
新北市,中和區,1451,658,147,805,57,862,1377,62.6%,47.79%,1
新北市,中和區,1452,659,162,821,62,883,1499,58.91%,43.96%,1
新北市,中和區,1453,767,166,933,45,978,1689,57.9%,45.41%,1
新北市,中和區,1454,599,159,758,54,812,1323,61.38%,45.28%,1
新北市,中和區,1455,492,136,628,49,677,1079,62.74%,45.6%,1
新北市,中和區,1456,659,175,834,67,901,1545,58.32%,42.65%,1
新北市,中和區,1457,590,89,679,60,739,1326,55.73%,44.49%,1
新北市,中和區,1458,592,153,745,36,781,1443,54.12%,41.03%,1
新北市,中和區,1459,730,177,907,30,937,1712,54.73%,42.64%,1
新北市,中和區,1460,785,202,987,55,1042,1916,54.38%,40.97%,1
新北市,中和區,1461,384,116,500,41,541,863,62.69%,44.5%,1
新北市,中和區,1462,583,139,722,14,736,1203,61.18%,48.46%,1
新北市,中和區,1463,646,128,774,17,791,1483,53.34%,43.56%,1
新北市,中和區,1464,682,123,805,33,838,1575,53.21%,43.3%,1
新北市,中和區,1465,533,136,669,57,726,1432,50.7%,37.22%,1
新北市,中和區,1466,620,134,754,58,812,1441,56.35%,43.03%,1
新北市,中和區,1467,573,136,709,51,760,1269,59.89%,45.15%,1
新北市,中和區,1468,670,110,780,31,811,1363,59.5%,49.16%,1
新北市,中和區,1469,507,88,595,29,624,1089,57.3%,46.56%,1
新北市,中和區,1470,436,136,572,33,605,1171,51.67%,37.23%,1
新北市,中和區,1471,486,119,605,40,645,1150,56.09%,42.26%,1
新北市,中和區,1472,549,153,702,47,749,1154,64.9%,47.57%,1
新北市,中和區,1473,517,100,617,40,657,1067,61.57%,48.45%,1
新北市,中和區,1474,625,152,777,45,822,1526,53.87%,40.96%,1
新北市,中和區,1475,645,154,799,41,840,1447,58.05%,44.57%,1
新北市,永和區,1476,650,187,837,82,919,1554,59.14%,41.83%,1
新北市,永和區,1477,464,109,573,22,595,1065,55.87%,43.57%,1
新北市,永和區,1478,403,97,500,38,538,854,63%,47.19%,1
新北市,永和區,1479,553,133,686,53,739,1253,58.98%,44.13%,1
新北市,永和區,1480,755,179,934,40,974,1733,56.2%,43.57%,1
新北市,永和區,1481,690,149,839,55,894,1581,56.55%,43.64%,1
新北市,永和區,1482,713,176,889,52,941,1735,54.24%,41.1%,1
新北市,永和區,1483,662,146,808,22,830,1563,53.1%,42.35%,1
新北市,永和區,1484,714,207,921,56,977,1650,59.21%,43.27%,1
新北市,永和區,1485,659,127,786,39,825,1454,56.74%,45.32%,1
新北市,永和區,1486,607,163,770,53,823,1568,52.49%,38.71%,1
新北市,永和區,1487,616,148,764,39,803,1444,55.61%,42.66%,1
新北市,永和區,1488,422,150,572,51,623,1140,54.65%,37.02%,1
新北市,永和區,1489,548,138,686,49,735,1188,61.87%,46.13%,1
新北市,永和區,1490,611,181,792,59,851,1516,56.13%,40.3%,1
新北市,永和區,1491,590,129,719,61,780,1397,55.83%,42.23%,1
新北市,永和區,1492,593,170,763,44,807,1438,56.12%,41.24%,1
新北市,永和區,1493,482,127,609,40,649,1084,59.87%,44.46%,1
新北市,永和區,1494,407,104,511,33,544,941,57.81%,43.25%,1
新北市,永和區,1495,575,141,716,50,766,1598,47.93%,35.98%,1
新北市,永和區,1496,645,161,806,32,838,2842,29.49%,22.7%,1
新北市,永和區,1497,567,172,739,49,788,1261,62.49%,44.96%,1
新北市,永和區,1498,692,187,879,47,926,1449,63.91%,47.76%,1
新北市,永和區,1499,644,197,841,43,884,1511,58.5%,42.62%,1
新北市,永和區,1500,730,163,893,50,943,1470,64.15%,49.66%,1
新北市,永和區,1501,696,164,860,41,901,1580,57.03%,44.05%,1
新北市,永和區,1502,701,160,861,44,905,1438,62.93%,48.75%,1
新北市,永和區,1503,641,137,778,32,810,1305,62.07%,49.12%,1
新北市,永和區,1504,486,118,604,28,632,1046,60.42%,46.46%,1
新北市,永和區,1505,674,189,863,28,891,1566,56.9%,43.04%,1
新北市,永和區,1506,636,190,826,35,861,1468,58.65%,43.32%,1
新北市,永和區,1507,700,156,856,41,897,1305,68.74%,53.64%,1
新北市,永和區,1508,521,144,665,40,705,1181,59.7%,44.12%,1
新北市,永和區,1509,675,204,879,57,936,1720,54.42%,39.24%,1
新北市,永和區,1510,505,145,650,30,680,1103,61.65%,45.78%,1
新北市,永和區,1511,698,161,859,103,962,1649,58.34%,42.33%,1
新北市,永和區,1512,565,158,723,33,756,1206,62.69%,46.85%,1
新北市,永和區,1513,664,195,859,48,907,1506,60.23%,44.09%,1
新北市,永和區,1514,627,165,792,63,855,1488,57.46%,42.14%,1
新北市,永和區,1515,592,152,744,51,795,1288,61.72%,45.96%,1
新北市,永和區,1516,574,127,701,34,735,1413,52.02%,40.62%,1
新北市,永和區,1517,597,120,717,55,772,1329,58.09%,44.92%,1
新北市,永和區,1518,695,158,853,34,887,1436,61.77%,48.4%,1
新北市,永和區,1519,479,137,616,48,664,1112,59.71%,43.08%,1
新北市,永和區,1520,589,111,700,42,742,1100,67.45%,53.55%,1
新北市,永和區,1521,730,172,902,52,954,1545,61.75%,47.25%,1
新北市,永和區,1522,626,146,772,29,801,1436,55.78%,43.59%,1
新北市,永和區,1523,831,180,1011,61,1072,1731,61.93%,48.01%,1
新北市,永和區,1524,782,231,1013,72,1085,1762,61.58%,44.38%,1
新北市,永和區,1525,533,161,694,47,741,1320,56.14%,40.38%,1
新北市,永和區,1526,478,124,602,22,624,1297,48.11%,36.85%,1
新北市,永和區,1527,739,196,935,62,997,1798,55.45%,41.1%,1
新北市,永和區,1528,639,193,832,71,903,1491,60.56%,42.86%,1
新北市,永和區,1529,545,116,661,24,685,1223,56.01%,44.56%,1
新北市,永和區,1530,471,141,612,52,664,1108,59.93%,42.51%,1
新北市,永和區,1531,622,174,796,64,860,1408,61.08%,44.18%,1
新北市,永和區,1532,565,156,721,53,774,1265,61.19%,44.66%,1
新北市,永和區,1533,459,122,581,22,603,1115,54.08%,41.17%,1
新北市,永和區,1534,509,154,663,64,727,1133,64.17%,44.92%,1
新北市,永和區,1535,529,144,673,52,725,1217,59.57%,43.47%,1
新北市,永和區,1536,693,202,895,59,954,1713,55.69%,40.46%,1
新北市,永和區,1537,701,184,885,57,942,1721,54.74%,40.73%,1
新北市,永和區,1538,550,137,687,61,748,1327,56.37%,41.45%,1
新北市,永和區,1539,595,153,748,32,780,1257,62.05%,47.33%,1
新北市,永和區,1540,671,139,810,42,852,1348,63.2%,49.78%,1
新北市,永和區,1541,728,156,884,41,925,1461,63.31%,49.83%,1
新北市,永和區,1542,588,157,745,70,815,1368,59.58%,42.98%,1
新北市,永和區,1543,541,111,652,70,722,1234,58.51%,43.84%,1
新北市,永和區,1544,574,137,711,51,762,1303,58.48%,44.05%,1
新北市,永和區,1545,656,133,789,30,819,1516,54.02%,43.27%,1
新北市,永和區,1546,672,141,813,54,867,1422,60.97%,47.26%,1
新北市,永和區,1547,460,128,588,31,619,991,62.46%,46.42%,1
新北市,永和區,1548,481,117,598,35,633,1016,62.3%,47.34%,1
新北市,永和區,1549,534,121,655,38,693,1146,60.47%,46.6%,1
新北市,永和區,1550,478,118,596,24,620,1043,59.44%,45.83%,1
新北市,永和區,1551,560,137,697,23,720,1210,59.5%,46.28%,1
新北市,永和區,1552,732,166,898,28,926,1630,56.81%,44.91%,1
新北市,永和區,1553,508,116,624,22,646,1092,59.16%,46.52%,1
新北市,永和區,1554,830,214,1044,57,1101,1872,58.81%,44.34%,1
新北市,永和區,1555,788,164,952,43,995,1781,55.87%,44.24%,1
新北市,永和區,1556,471,127,598,46,644,1049,61.39%,44.9%,1
新北市,永和區,1557,606,162,768,38,806,1285,62.72%,47.16%,1
新北市,永和區,1558,562,139,701,36,737,1209,60.96%,46.48%,1
新北市,永和區,1559,537,141,678,31,709,1132,62.63%,47.44%,1
新北市,永和區,1560,634,154,788,49,837,1287,65.03%,49.26%,1
新北市,永和區,1561,502,121,623,45,668,1068,62.55%,47%,1
新北市,永和區,1562,512,141,653,45,698,1098,63.57%,46.63%,1
新北市,永和區,1563,587,124,711,49,760,1222,62.19%,48.04%,1
新北市,永和區,1564,510,138,648,64,712,1157,61.54%,44.08%,1
新北市,永和區,1565,548,170,718,57,775,1168,66.35%,46.92%,1
新北市,永和區,1566,531,162,693,56,749,1283,58.38%,41.39%,1
新北市,永和區,1567,601,151,752,43,795,1372,57.94%,43.8%,1
新北市,永和區,1568,869,191,1060,52,1112,1876,59.28%,46.32%,1
新北市,永和區,1569,734,192,926,72,998,1576,63.32%,46.57%,1
新北市,永和區,1570,858,92,950,44,994,1661,59.84%,51.66%,1
新北市,永和區,1571,797,183,980,28,1008,1808,55.75%,44.08%,1
新北市,永和區,1572,831,217,1048,39,1087,1898,57.27%,43.78%,1
新北市,永和區,1573,684,187,871,52,923,1508,61.21%,45.36%,1
新北市,永和區,1574,610,147,757,67,824,1341,61.45%,45.49%,1
新北市,永和區,1575,638,140,778,49,827,1422,58.16%,44.87%,1
新北市,永和區,1576,515,136,651,34,685,1177,58.2%,43.76%,1
新北市,永和區,1577,671,177,848,64,912,1557,58.57%,43.1%,1
新北市,永和區,1578,568,207,775,50,825,1491,55.33%,38.1%,1
新北市,永和區,1579,670,181,851,48,899,1586,56.68%,42.24%,1
新北市,永和區,1580,544,137,681,20,701,1313,53.39%,41.43%,1
新北市,永和區,1581,671,198,869,67,936,1636,57.21%,41.01%,1
新北市,永和區,1582,680,177,857,60,917,1598,57.38%,42.55%,1
新北市,永和區,1583,736,181,917,58,975,1609,60.6%,45.74%,1
新北市,永和區,1584,635,176,811,40,851,1375,61.89%,46.18%,1
新北市,永和區,1585,814,169,983,54,1037,1648,62.92%,49.39%,1
新北市,永和區,1586,482,124,606,42,648,1077,60.17%,44.75%,1
新北市,永和區,1587,507,168,675,33,708,1157,61.19%,43.82%,1
新北市,永和區,1588,658,165,823,30,853,1339,63.7%,49.14%,1
新北市,永和區,1589,629,150,779,18,797,1306,61.03%,48.16%,1
新北市,永和區,1590,623,131,754,22,776,1236,62.78%,50.4%,1
新北市,永和區,1591,563,119,682,21,703,1133,62.05%,49.69%,1
新北市,永和區,1592,695,137,832,34,866,1425,60.77%,48.77%,1
新北市,永和區,1593,817,214,1031,80,1111,1938,57.33%,42.16%,1
新北市,永和區,1594,697,198,895,62,957,1607,59.55%,43.37%,1
新北市,永和區,1595,407,84,491,37,528,853,61.9%,47.71%,1
新北市,永和區,1596,310,70,380,46,426,768,55.47%,40.36%,1
新北市,永和區,1597,303,75,378,31,409,893,45.8%,33.93%,1
新北市,永和區,1598,332,70,402,34,436,743,58.68%,44.68%,1
新北市,永和區,1599,529,145,674,42,716,1155,61.99%,45.8%,1
新北市,永和區,1600,585,153,738,43,781,1263,61.84%,46.32%,1
新北市,永和區,1601,591,108,699,28,727,1189,61.14%,49.71%,1
新北市,永和區,1602,569,134,703,35,738,1346,54.83%,42.27%,1
新北市,永和區,1603,562,171,733,49,782,1368,57.16%,41.08%,1
新北市,永和區,1604,478,114,592,21,613,1043,58.77%,45.83%,1
新北市,永和區,1605,743,232,975,46,1021,1709,59.74%,43.48%,1
新北市,永和區,1606,364,92,456,23,479,879,54.49%,41.41%,1
新北市,永和區,1607,372,133,505,36,541,904,59.85%,41.15%,1
新北市,永和區,1608,581,135,716,55,771,1221,63.14%,47.58%,1
新北市,永和區,1609,467,113,580,48,628,1018,61.69%,45.87%,1
新北市,永和區,1610,654,173,827,35,862,1551,55.58%,42.17%,1
新北市,永和區,1611,645,165,810,49,859,1428,60.15%,45.17%,1
新北市,永和區,1612,468,126,594,56,650,1044,62.26%,44.83%,1
新北市,永和區,1613,448,114,562,40,602,967,62.25%,46.33%,1
新北市,新莊區,0302,452,142,594,66,660,1123,58.77%,40.25%,1
新北市,新莊區,0303,513,180,693,73,766,1278,59.94%,40.14%,1
新北市,新莊區,0304,524,150,674,62,736,1163,63.28%,45.06%,1
新北市,新莊區,0305,523,178,701,55,756,1228,61.56%,42.59%,1
新北市,新莊區,0306,468,187,655,55,710,1211,58.63%,38.65%,1
新北市,新莊區,0307,492,158,650,55,705,1176,59.95%,41.84%,1
新北市,新莊區,0308,681,195,876,55,931,1536,60.61%,44.34%,1
新北市,新莊區,0309,707,165,872,59,931,1486,62.65%,47.58%,1
新北市,新莊區,0310,692,206,898,75,973,1513,64.31%,45.74%,1
新北市,新莊區,0311,613,202,815,74,889,1395,63.73%,43.94%,1
新北市,新莊區,0312,560,132,692,82,774,1353,57.21%,41.39%,1
新北市,新莊區,0313,612,195,807,64,871,1409,61.82%,43.44%,1
新北市,新莊區,0314,614,147,761,42,803,1478,54.33%,41.54%,1
新北市,新莊區,0315,379,143,522,53,575,921,62.43%,41.15%,1
新北市,新莊區,0316,417,146,563,48,611,971,62.92%,42.95%,1
新北市,新莊區,0317,709,170,879,84,963,1534,62.78%,46.22%,1
新北市,新莊區,0318,620,162,782,47,829,1516,54.68%,40.9%,1
新北市,新莊區,0319,265,105,370,38,408,697,58.54%,38.02%,1
新北市,新莊區,0320,547,119,666,37,703,1235,56.92%,44.29%,1
新北市,新莊區,0321,454,146,600,45,645,1138,56.68%,39.89%,1
新北市,新莊區,0322,392,135,527,27,554,1063,52.12%,36.88%,1
新北市,新莊區,0323,587,190,777,65,842,3399,24.77%,17.27%,1
新北市,新莊區,0324,660,190,850,83,933,1575,59.24%,41.9%,1
新北市,新莊區,0325,690,234,924,73,997,1615,61.73%,42.72%,1
新北市,新莊區,0326,569,200,769,81,850,1612,52.73%,35.3%,1
新北市,新莊區,0327,582,174,756,81,837,1514,55.28%,38.44%,1
新北市,新莊區,0328,482,167,649,36,685,1382,49.57%,34.88%,1
新北市,新莊區,0329,598,177,775,51,826,1475,56%,40.54%,1
新北市,新莊區,0330,626,170,796,31,827,1462,56.57%,42.82%,1
新北市,新莊區,0331,587,159,746,42,788,1426,55.26%,41.16%,1
新北市,新莊區,0332,540,189,729,60,789,1421,55.52%,38%,1
新北市,新莊區,0333,632,171,803,48,851,1536,55.4%,41.15%,1
新北市,新莊區,0334,671,198,869,46,915,1587,57.66%,42.28%,1
新北市,新莊區,0335,285,85,370,18,388,749,51.8%,38.05%,1
新北市,新莊區,0336,567,153,720,47,767,1276,60.11%,44.44%,1
新北市,新莊區,0337,493,159,652,47,699,1303,53.65%,37.84%,1
新北市,新莊區,0338,555,168,723,57,780,1259,61.95%,44.08%,1
新北市,新莊區,0339,568,154,722,56,778,1291,60.26%,44%,1
新北市,新莊區,0340,660,158,818,30,848,1493,56.8%,44.21%,1
新北市,新莊區,0341,628,195,823,53,876,1507,58.13%,41.67%,1
新北市,新莊區,0342,604,174,778,17,795,1456,54.6%,41.48%,1
新北市,新莊區,0343,579,177,756,27,783,1396,56.09%,41.48%,1
新北市,新莊區,0344,503,126,629,56,685,1351,50.7%,37.23%,1
新北市,新莊區,0345,546,182,728,69,797,1403,56.81%,38.92%,1
新北市,新莊區,0346,587,172,759,74,833,1497,55.64%,39.21%,1
新北市,新莊區,0347,529,148,677,94,771,1272,60.61%,41.59%,1
新北市,新莊區,0348,447,130,577,47,624,1269,49.17%,35.22%,1
新北市,新莊區,0349,532,187,719,69,788,1335,59.03%,39.85%,1
新北市,新莊區,0350,574,146,720,38,758,1300,58.31%,44.15%,1
新北市,新莊區,0351,587,156,743,39,782,1286,60.81%,45.65%,1
新北市,新莊區,0352,619,160,779,49,828,1255,65.98%,49.32%,1
新北市,新莊區,0353,611,194,805,96,901,1558,57.83%,39.22%,1
新北市,新莊區,0354,620,159,779,73,852,1567,54.37%,39.57%,1
新北市,新莊區,0355,692,174,866,0,866,1603,54.02%,43.17%,1
新北市,新莊區,0356,641,170,811,43,854,1538,55.53%,41.68%,1
新北市,新莊區,0357,700,193,893,58,951,1671,56.91%,41.89%,1
新北市,新莊區,0358,651,186,837,39,876,1698,51.59%,38.34%,1
新北市,新莊區,0359,667,213,880,57,937,1545,60.65%,43.17%,1
新北市,新莊區,0360,696,207,903,127,1030,1696,60.73%,41.04%,1
新北市,新莊區,0361,623,179,802,87,889,1626,54.67%,38.31%,1
新北市,新莊區,0362,428,168,596,76,672,1170,57.44%,36.58%,1
新北市,新莊區,0363,473,145,618,100,718,1236,58.09%,38.27%,1
新北市,新莊區,0364,419,118,537,62,599,1071,55.93%,39.12%,1
新北市,新莊區,0365,437,152,589,56,645,1129,57.13%,38.71%,1
新北市,新莊區,0366,647,222,869,50,919,1586,57.94%,40.79%,1
新北市,新莊區,0367,573,185,758,68,826,1597,51.72%,35.88%,1
新北市,新莊區,0368,536,173,709,107,816,1573,51.88%,34.08%,1
新北市,新莊區,0369,456,138,594,45,639,1225,52.16%,37.22%,1
新北市,新莊區,0370,450,116,566,45,611,1217,50.21%,36.98%,1
新北市,新莊區,0371,613,189,802,84,886,1571,56.4%,39.02%,1
新北市,新莊區,0372,627,169,796,64,860,1594,53.95%,39.34%,1
新北市,新莊區,0373,626,174,800,62,862,1583,54.45%,39.55%,1
新北市,新莊區,0374,551,145,696,58,754,1245,60.56%,44.26%,1
新北市,新莊區,0375,370,163,533,47,580,1203,48.21%,30.76%,1
新北市,新莊區,0376,592,156,748,53,801,1265,63.32%,46.8%,1
新北市,新莊區,0377,529,149,678,72,750,1255,59.76%,42.15%,1
新北市,新莊區,0378,559,149,708,38,746,1287,57.96%,43.43%,1
新北市,新莊區,0379,500,178,678,54,732,1167,62.72%,42.84%,1
新北市,新莊區,0380,502,169,671,70,741,1299,57.04%,38.65%,1
新北市,新莊區,0381,497,151,648,50,698,1207,57.83%,41.18%,1
新北市,新莊區,0382,612,152,764,62,826,1415,58.37%,43.25%,1
新北市,新莊區,0383,537,173,710,72,782,1342,58.27%,40.01%,1
新北市,新莊區,0384,515,186,701,79,780,1341,58.17%,38.4%,1
新北市,新莊區,0385,476,161,637,78,715,1247,57.34%,38.17%,1
新北市,新莊區,0386,506,108,614,34,648,984,65.85%,51.42%,1
新北市,新莊區,0387,467,125,592,52,644,1043,61.74%,44.77%,1
新北市,新莊區,0388,538,171,709,45,754,1135,66.43%,47.4%,1
新北市,新莊區,0389,502,142,644,43,687,1185,57.97%,42.36%,1
新北市,新莊區,0390,553,171,724,51,775,1346,57.58%,41.08%,1
新北市,新莊區,0391,575,168,743,75,818,1372,59.62%,41.91%,1
新北市,新莊區,0392,566,193,759,69,828,1350,61.33%,41.93%,1
新北市,新莊區,0393,479,159,638,82,720,1307,55.09%,36.65%,1
新北市,新莊區,0394,533,151,684,89,773,1353,57.13%,39.39%,1
新北市,新莊區,0395,491,187,678,83,761,1287,59.13%,38.15%,1
新北市,新莊區,0396,516,144,660,33,693,1567,44.22%,32.93%,1
新北市,新莊區,0397,624,203,827,85,912,1709,53.36%,36.51%,1
新北市,新莊區,0398,595,147,742,43,785,1616,48.58%,36.82%,1
新北市,新莊區,0399,583,162,745,69,814,1628,50%,35.81%,1
新北市,新莊區,0400,474,166,640,71,711,1148,61.93%,41.29%,1
新北市,新莊區,0401,492,150,642,10,652,1201,54.29%,40.97%,1
新北市,新莊區,0402,527,147,674,56,730,1135,64.32%,46.43%,1
新北市,新莊區,0403,647,205,852,69,921,1495,61.61%,43.28%,1
新北市,新莊區,0404,663,190,853,63,916,1486,61.64%,44.62%,1
新北市,新莊區,0405,696,174,870,45,915,1483,61.7%,46.93%,1
新北市,新莊區,0406,643,156,799,52,851,1553,54.8%,41.4%,1
新北市,新莊區,0407,781,181,962,38,1000,1625,61.54%,48.06%,1
新北市,新莊區,0408,723,181,904,27,931,1671,55.72%,43.27%,1
新北市,新莊區,0409,623,180,803,64,867,1389,62.42%,44.85%,1
新北市,新莊區,0410,548,144,692,41,733,1272,57.63%,43.08%,1
新北市,新莊區,0411,681,149,830,48,878,1409,62.31%,48.33%,1
新北市,新莊區,0412,596,206,802,40,842,1372,61.37%,43.44%,1
新北市,新莊區,0413,382,122,504,56,560,955,58.64%,40%,1
新北市,新莊區,0414,341,130,471,68,539,952,56.62%,35.82%,1
新北市,新莊區,0415,569,174,743,37,780,1412,55.24%,40.3%,1
新北市,新莊區,0416,568,182,750,73,823,1415,58.16%,40.14%,1
新北市,新莊區,0417,602,190,792,61,853,1421,60.03%,42.36%,1
新北市,新莊區,0418,595,164,759,54,813,1293,62.88%,46.02%,1
新北市,新莊區,0419,541,181,722,30,752,1475,50.98%,36.68%,1
新北市,新莊區,0420,595,143,738,78,816,1429,57.1%,41.64%,1
新北市,新莊區,0421,620,158,778,66,844,1481,56.99%,41.86%,1
新北市,新莊區,0422,643,155,798,78,876,1472,59.51%,43.68%,1
新北市,新莊區,0423,647,178,825,39,864,1474,58.62%,43.89%,1
新北市,新莊區,0424,631,185,816,22,838,1462,57.32%,43.16%,1
新北市,新莊區,0425,660,184,844,37,881,1484,59.37%,44.47%,1
新北市,新莊區,0426,627,165,792,47,839,1461,57.43%,42.92%,1
新北市,新莊區,0427,656,162,818,34,852,1444,59%,45.43%,1
新北市,新莊區,0428,649,162,811,29,840,1437,58.46%,45.16%,1
新北市,新莊區,0429,615,170,785,45,830,1641,50.58%,37.48%,1
新北市,新莊區,0430,618,185,803,41,844,1633,51.68%,37.84%,1
新北市,新莊區,0431,668,162,830,27,857,1531,55.98%,43.63%,1
新北市,新莊區,0432,674,176,850,55,905,1517,59.66%,44.43%,1
新北市,新莊區,0433,602,170,772,47,819,1487,55.08%,40.48%,1
新北市,新莊區,0434,656,183,839,46,885,1560,56.73%,42.05%,1
新北市,新莊區,0435,620,193,813,75,888,1584,56.06%,39.14%,1
新北市,新莊區,0436,666,165,831,34,865,1602,54%,41.57%,1
新北市,新莊區,0437,316,117,433,53,486,818,59.41%,38.63%,1
新北市,新莊區,0438,552,162,714,64,778,1633,47.64%,33.8%,1
新北市,新莊區,0439,613,203,816,68,884,1652,53.51%,37.11%,1
新北市,新莊區,0440,603,161,764,66,830,1498,55.41%,40.25%,1
新北市,新莊區,0441,529,155,684,47,731,1379,53.01%,38.36%,1
新北市,新莊區,0442,587,169,756,50,806,1381,58.36%,42.51%,1
新北市,新莊區,0443,661,168,829,76,905,1535,58.96%,43.06%,1
新北市,新莊區,0444,742,193,935,61,996,1492,66.76%,49.73%,1
新北市,新莊區,0445,646,173,819,94,913,1450,62.97%,44.55%,1
新北市,新莊區,0446,438,150,588,66,654,1107,59.08%,39.57%,1
新北市,新莊區,0447,465,151,616,53,669,1063,62.94%,43.74%,1
新北市,新莊區,0448,455,155,610,56,666,1143,58.27%,39.81%,1
新北市,新莊區,0449,496,139,635,118,753,1341,56.15%,36.99%,1
新北市,新莊區,0450,439,134,573,50,623,1063,58.61%,41.3%,1
新北市,新莊區,0451,445,163,608,50,658,1096,60.04%,40.6%,1
新北市,新莊區,0452,540,167,707,41,748,1309,57.14%,41.25%,1
新北市,新莊區,0453,509,174,683,49,732,1216,60.2%,41.86%,1
新北市,新莊區,0454,503,137,640,48,688,1278,53.83%,39.36%,1
新北市,新莊區,0455,502,198,700,74,774,1352,57.25%,37.13%,1
新北市,新莊區,0456,462,157,619,59,678,1298,52.23%,35.59%,1
新北市,新莊區,0457,425,128,553,59,612,1042,58.73%,40.79%,1
新北市,新莊區,0458,329,113,442,25,467,881,53.01%,37.34%,1
新北市,新莊區,0459,491,183,674,43,717,1109,64.65%,44.27%,1
新北市,新莊區,0460,476,177,653,64,717,1291,55.54%,36.87%,1
新北市,新莊區,0461,519,139,658,29,687,1293,53.13%,40.14%,1
新北市,新莊區,0462,533,186,719,68,787,1336,58.91%,39.9%,1
新北市,新莊區,0463,556,137,693,46,739,1384,53.4%,40.17%,1
新北市,新莊區,0464,476,105,581,29,610,1231,49.55%,38.67%,1
新北市,新莊區,0465,399,92,491,31,522,940,55.53%,42.45%,1
新北市,新莊區,0466,474,182,656,110,766,1369,55.95%,34.62%,1
新北市,新莊區,0467,546,164,710,66,776,1384,56.07%,39.45%,1
新北市,新莊區,0468,509,159,668,73,741,1272,58.25%,40.02%,1
新北市,新莊區,0469,471,128,599,38,637,1073,59.37%,43.9%,1
新北市,新莊區,0470,440,122,562,37,599,1058,56.62%,41.59%,1
新北市,新莊區,0471,635,166,801,26,827,1528,54.12%,41.56%,1
新北市,新莊區,0472,513,119,632,46,678,1244,54.5%,41.24%,1
新北市,新莊區,0473,536,135,671,54,725,1356,53.47%,39.53%,1
新北市,新莊區,0474,487,93,580,30,610,1164,52.41%,41.84%,1
新北市,新莊區,0475,612,159,771,69,840,1423,59.03%,43.01%,1
新北市,新莊區,0476,566,170,736,38,774,1250,61.92%,45.28%,1
新北市,新莊區,0477,508,148,656,30,686,1252,54.79%,40.58%,1
新北市,新莊區,0478,422,121,543,21,564,1022,55.19%,41.29%,1
新北市,新莊區,0479,392,126,518,44,562,959,58.6%,40.88%,1
新北市,新莊區,0480,689,215,904,52,956,1646,58.08%,41.86%,1
新北市,新莊區,0481,609,169,778,66,844,1551,54.42%,39.26%,1
新北市,新莊區,0482,639,203,842,60,902,1526,59.11%,41.87%,1
新北市,新莊區,0483,630,184,814,36,850,1518,55.99%,41.5%,1
新北市,新莊區,0484,697,164,861,42,903,1547,58.37%,45.05%,1
新北市,新莊區,0485,564,170,734,93,827,1505,54.95%,37.48%,1
新北市,新莊區,0486,553,186,739,84,823,1527,53.9%,36.21%,1
新北市,新莊區,0487,532,189,721,59,780,1482,52.63%,35.9%,1
新北市,新莊區,0488,571,173,744,76,820,1586,51.7%,36%,1
新北市,新莊區,0489,392,140,532,89,621,1065,58.31%,36.81%,1
新北市,新莊區,0490,476,138,614,56,670,1040,64.42%,45.77%,1
新北市,新莊區,0491,408,151,559,52,611,1090,56.06%,37.43%,1
新北市,新莊區,0492,437,137,574,50,624,1071,58.26%,40.8%,1
新北市,新莊區,0493,632,177,809,40,849,1704,49.82%,37.09%,1
新北市,新莊區,0494,666,141,807,36,843,1698,49.65%,39.22%,1
新北市,新莊區,0495,612,176,788,63,851,1362,62.48%,44.93%,1
新北市,新莊區,0496,570,171,741,42,783,1350,58%,42.22%,1
新北市,新莊區,0497,690,189,879,82,961,1689,56.9%,40.85%,1
新北市,新莊區,0498,631,201,832,101,933,1612,57.88%,39.14%,1
新北市,新莊區,0499,473,140,613,58,671,1130,59.38%,41.86%,1
新北市,新莊區,0500,461,162,623,72,695,1111,62.56%,41.49%,1
新北市,新莊區,0501,626,155,781,44,825,1539,53.61%,40.68%,1
新北市,新莊區,0502,629,213,842,43,885,1586,55.8%,39.66%,1
新北市,新莊區,0503,673,186,859,73,932,1631,57.14%,41.26%,1
新北市,新莊區,0504,616,180,796,59,855,1540,55.52%,40%,1
新北市,新莊區,0505,473,166,639,57,696,1388,50.14%,34.08%,1
新北市,新莊區,0506,461,165,626,89,715,1388,51.51%,33.21%,1
新北市,新莊區,0507,485,143,628,63,691,1387,49.82%,34.97%,1
新北市,新莊區,0508,467,120,587,44,631,1181,53.43%,39.54%,1
新北市,新莊區,0509,432,169,601,62,663,1135,58.41%,38.06%,1
新北市,新莊區,0510,452,162,614,58,672,1173,57.29%,38.53%,1
新北市,新莊區,0511,524,139,663,41,704,1215,57.94%,43.13%,1
新北市,新莊區,0512,636,183,819,47,866,1488,58.2%,42.74%,1
新北市,新莊區,0513,623,163,786,47,833,1444,57.69%,43.14%,1
新北市,新莊區,0514,604,179,783,44,827,1499,55.17%,40.29%,1
新北市,新莊區,0515,601,168,769,31,800,1449,55.21%,41.48%,1
新北市,新莊區,0516,646,192,838,81,919,1640,56.04%,39.39%,1
新北市,新莊區,0517,647,182,829,73,902,1648,54.73%,39.26%,1
新北市,新莊區,0518,513,148,661,61,722,1371,52.66%,37.42%,1
新北市,新莊區,0519,517,188,705,66,771,1400,55.07%,36.93%,1
新北市,新莊區,0520,578,163,741,77,818,1457,56.14%,39.67%,1
新北市,新莊區,0521,549,190,739,83,822,1502,54.73%,36.55%,1
新北市,新莊區,0522,539,168,707,78,785,1412,55.59%,38.17%,1
新北市,新莊區,0523,509,146,655,76,731,1318,55.46%,38.62%,1
新北市,新莊區,0524,626,146,772,49,821,1411,58.19%,44.37%,1
新北市,新莊區,0525,540,153,693,35,728,1262,57.69%,42.79%,1
新北市,新莊區,0526,583,123,706,38,744,1228,60.59%,47.48%,1
新北市,新莊區,0527,760,176,936,73,1009,1748,57.72%,43.48%,1
新北市,新莊區,0528,742,209,951,76,1027,1761,58.32%,42.14%,1
新北市,新莊區,0529,495,147,642,61,703,1326,53.02%,37.33%,1
新北市,新莊區,0530,471,147,618,52,670,1344,49.85%,35.04%,1
新北市,新莊區,0531,552,157,709,56,765,1355,56.46%,40.74%,1
新北市,新莊區,0532,521,163,684,73,757,1306,57.96%,39.89%,1
新北市,新莊區,0533,598,162,760,38,798,1349,59.15%,44.33%,1
新北市,新莊區,0534,528,139,667,42,709,1265,56.05%,41.74%,1
新北市,新莊區,0535,565,147,712,63,775,1282,60.45%,44.07%,1
新北市,新莊區,0536,562,118,680,65,745,1237,60.23%,45.43%,1
新北市,新莊區,0537,556,129,685,27,712,1301,54.73%,42.74%,1
新北市,新莊區,0538,539,135,674,50,724,1262,57.37%,42.71%,1
新北市,新莊區,0539,546,141,687,45,732,1270,57.64%,42.99%,1
新北市,新莊區,0540,479,181,660,64,724,1245,58.15%,38.47%,1
新北市,新莊區,0541,459,152,611,74,685,1220,56.15%,37.62%,1
新北市,新莊區,0542,443,162,605,44,649,1245,52.13%,35.58%,1
新北市,新莊區,0543,462,130,592,50,642,1212,52.97%,38.12%,1
新北市,新莊區,0544,457,160,617,69,686,1253,54.75%,36.47%,1
新北市,新莊區,0545,476,145,621,56,677,1272,53.22%,37.42%,1
新北市,新莊區,0546,553,130,683,41,724,1227,59.01%,45.07%,1
新北市,新莊區,0547,489,139,628,46,674,1126,59.86%,43.43%,1
新北市,新莊區,0548,530,147,677,42,719,1240,57.98%,42.74%,1
新北市,新莊區,0549,610,175,785,45,830,1460,56.85%,41.78%,1
新北市,新莊區,0550,435,122,557,43,600,1072,55.97%,40.58%,1
新北市,新莊區,0551,404,123,527,38,565,1127,50.13%,35.85%,1
新北市,新莊區,0552,584,158,742,31,773,1332,58.03%,43.84%,1
新北市,新莊區,0553,527,134,661,21,682,1341,50.86%,39.3%,1
新北市,新莊區,0554,349,102,451,27,478,1140,41.93%,30.61%,1
新北市,新店區,1987,650,172,822,56,878,1603,54.77%,40.55%,1
新北市,新店區,1988,814,172,986,42,1028,1921,53.51%,42.37%,1
新北市,新店區,1989,432,125,557,23,580,1082,53.6%,39.93%,1
新北市,新店區,1990,516,159,675,44,719,1235,58.22%,41.78%,1
新北市,新店區,1991,717,154,871,37,908,1568,57.91%,45.73%,1
新北市,新店區,1992,324,103,427,30,457,771,59.27%,42.02%,1
新北市,新店區,1993,488,164,652,44,696,1256,55.41%,38.85%,1
新北市,新店區,1994,436,125,561,39,600,1008,59.52%,43.25%,1
新北市,新店區,1995,707,131,838,52,890,1515,58.75%,46.67%,1
新北市,新店區,1996,795,183,978,40,1018,1637,62.19%,48.56%,1
新北市,新店區,1997,671,179,850,51,901,1549,58.17%,43.32%,1
新北市,新店區,1998,983,216,1199,51,1250,2011,62.16%,48.88%,1
新北市,新店區,1999,649,175,824,75,899,1554,57.85%,41.76%,1
新北市,新店區,2000,721,191,912,71,983,1770,55.54%,40.73%,1
新北市,新店區,2001,590,145,735,47,782,1316,59.42%,44.83%,1
新北市,新店區,2002,461,122,583,62,645,1126,57.28%,40.94%,1
新北市,新店區,2003,579,170,749,46,795,1460,54.45%,39.66%,1
新北市,新店區,2004,699,185,884,54,938,1584,59.22%,44.13%,1
新北市,新店區,2005,611,163,774,51,825,1449,56.94%,42.17%,1
新北市,新店區,2006,744,162,906,47,953,1520,62.7%,48.95%,1
新北市,新店區,2007,856,190,1046,24,1070,1821,58.76%,47.01%,1
新北市,新店區,2008,836,210,1046,44,1090,1956,55.73%,42.74%,1
新北市,新店區,2009,755,169,924,51,975,1665,58.56%,45.35%,1
新北市,新店區,2010,768,159,927,39,966,1588,60.83%,48.36%,1
新北市,新店區,2011,679,144,823,20,843,1519,55.5%,44.7%,1
新北市,新店區,2012,548,164,712,31,743,1185,62.7%,46.24%,1
新北市,新店區,2013,535,137,672,22,694,1095,63.38%,48.86%,1
新北市,新店區,2014,506,128,634,55,689,1106,62.3%,45.75%,1
新北市,新店區,2015,288,104,392,18,410,2700,15.19%,10.67%,1
新北市,新店區,2016,461,106,567,23,590,995,59.3%,46.33%,1
新北市,新店區,2017,516,117,633,38,671,1168,57.45%,44.18%,1
新北市,新店區,2018,582,125,707,53,760,1123,67.68%,51.83%,1
新北市,新店區,2019,518,144,662,40,702,1085,64.7%,47.74%,1
新北市,新店區,2020,663,170,833,50,883,1412,62.54%,46.95%,1
新北市,新店區,2021,730,182,912,48,960,1659,57.87%,44%,1
新北市,新店區,2022,608,111,719,44,763,1198,63.69%,50.75%,1
新北市,新店區,2023,566,143,709,35,744,1376,54.07%,41.13%,1
新北市,新店區,2024,559,119,678,32,710,1300,54.62%,43%,1
新北市,新店區,2025,546,142,688,35,723,1238,58.4%,44.1%,1
新北市,新店區,2026,568,144,712,24,736,1388,53.03%,40.92%,1
新北市,新店區,2027,433,117,550,37,587,933,62.92%,46.41%,1
新北市,新店區,2028,438,117,555,26,581,908,63.99%,48.24%,1
新北市,新店區,2029,667,180,847,64,911,1582,57.59%,42.16%,1
新北市,新店區,2030,589,142,731,45,776,1247,62.23%,47.23%,1
新北市,新店區,2031,442,108,550,51,601,971,61.89%,45.52%,1
新北市,新店區,2032,555,107,662,50,712,1145,62.18%,48.47%,1
新北市,新店區,2033,645,143,788,49,837,1392,60.13%,46.34%,1
新北市,新店區,2034,724,139,863,53,916,1452,63.09%,49.86%,1
新北市,新店區,2035,631,148,779,56,835,1440,57.99%,43.82%,1
新北市,新店區,2036,745,196,941,77,1018,1786,57%,41.71%,1
新北市,新店區,2037,838,168,1006,54,1060,1825,58.08%,45.92%,1
新北市,新店區,2038,676,177,853,33,886,1477,59.99%,45.77%,1
新北市,新店區,2039,783,203,986,44,1030,1750,58.86%,44.74%,1
新北市,新店區,2040,780,172,952,72,1024,1792,57.14%,43.53%,1
新北市,新店區,2041,890,169,1059,59,1118,1979,56.49%,44.97%,1
新北市,新店區,2042,393,77,470,29,499,826,60.41%,47.58%,1
新北市,新店區,2043,919,180,1099,38,1137,1924,59.1%,47.77%,1
新北市,新店區,2044,695,131,826,22,848,1383,61.32%,50.25%,1
新北市,新店區,2045,299,83,382,42,424,830,51.08%,36.02%,1
新北市,新店區,2046,854,189,1043,33,1076,1759,61.17%,48.55%,1
新北市,新店區,2047,939,197,1136,50,1186,1957,60.6%,47.98%,1
新北市,新店區,2048,705,161,866,31,897,1481,60.57%,47.6%,1
新北市,新店區,2049,672,178,850,73,923,1552,59.47%,43.3%,1
新北市,新店區,2050,615,154,769,74,843,1467,57.46%,41.92%,1
新北市,新店區,2051,587,164,751,49,800,1371,58.35%,42.82%,1
新北市,新店區,2052,452,112,564,35,599,991,60.44%,45.61%,1
新北市,新店區,2053,562,128,690,49,739,1231,60.03%,45.65%,1
新北市,新店區,2054,728,207,935,59,994,1701,58.44%,42.8%,1
新北市,新店區,2055,759,173,932,53,985,1707,57.7%,44.46%,1
新北市,新店區,2056,779,175,954,34,988,1773,55.72%,43.94%,1
新北市,新店區,2057,756,184,940,46,986,1866,52.84%,40.51%,1
新北市,新店區,2058,781,198,979,52,1031,1735,59.42%,45.01%,1
新北市,新店區,2059,806,198,1004,41,1045,1632,64.03%,49.39%,1
新北市,新店區,2060,736,149,885,55,940,1591,59.08%,46.26%,1
新北市,新店區,2061,603,151,754,62,816,1495,54.58%,40.33%,1
新北市,新店區,2062,613,122,735,23,758,1511,50.17%,40.57%,1
新北市,新店區,2063,544,135,679,56,735,1260,58.33%,43.17%,1
新北市,新店區,2064,916,198,1114,50,1164,1948,59.75%,47.02%,1
新北市,新店區,2065,743,189,932,48,980,1582,61.95%,46.97%,1
新北市,新店區,2066,544,175,719,46,765,1315,58.17%,41.37%,1
新北市,新店區,2067,640,152,792,54,846,1562,54.16%,40.97%,1
新北市,新店區,2068,975,165,1140,28,1168,1982,58.93%,49.19%,1
新北市,新店區,2069,662,177,839,60,899,1518,59.22%,43.61%,1
新北市,新店區,2070,762,174,936,35,971,1735,55.97%,43.92%,1
新北市,新店區,2071,756,153,909,52,961,1716,56%,44.06%,1
新北市,新店區,2072,712,152,864,51,915,1580,57.91%,45.06%,1
新北市,新店區,2073,640,160,800,45,845,1358,62.22%,47.13%,1
新北市,新店區,2074,735,188,923,79,1002,1610,62.24%,45.65%,1
新北市,新店區,2075,571,171,742,33,775,1383,56.04%,41.29%,1
新北市,新店區,2076,715,158,873,36,909,1596,56.95%,44.8%,1
新北市,新店區,2077,556,123,679,41,720,1360,52.94%,40.88%,1
新北市,新店區,2078,493,83,576,19,595,1160,51.29%,42.5%,1
新北市,新店區,2079,668,109,777,40,817,1236,66.1%,54.05%,1
新北市,新店區,2080,647,119,766,29,795,1234,64.42%,52.43%,1
新北市,新店區,2081,656,193,849,65,914,1579,57.88%,41.55%,1
新北市,新店區,2082,534,130,664,45,709,1241,57.13%,43.03%,1
新北市,新店區,2083,555,126,681,22,703,1275,55.14%,43.53%,1
新北市,新店區,2084,471,126,597,49,646,1214,53.21%,38.8%,1
新北市,新店區,2085,540,187,727,61,788,1578,49.94%,34.22%,1
新北市,新店區,2086,580,170,750,46,796,1442,55.2%,40.22%,1
新北市,新店區,2087,513,169,682,88,770,1475,52.2%,34.78%,1
新北市,新店區,2088,685,190,875,51,926,1580,58.61%,43.35%,1
新北市,新店區,2089,620,179,799,39,838,1585,52.87%,39.12%,1
新北市,新店區,2090,647,186,833,60,893,1586,56.31%,40.79%,1
新北市,新店區,2091,802,209,1011,62,1073,1931,55.57%,41.53%,1
新北市,新店區,2092,524,123,647,36,683,1239,55.13%,42.29%,1
新北市,新店區,2093,823,164,987,58,1045,1892,55.23%,43.5%,1
新北市,新店區,2094,599,152,751,47,798,1529,52.19%,39.18%,1
新北市,新店區,2095,631,106,737,51,788,1358,58.03%,46.47%,1
新北市,新店區,2096,739,195,934,41,975,1905,51.18%,38.79%,1
新北市,新店區,2097,769,179,948,45,993,1885,52.68%,40.8%,1
新北市,新店區,2098,538,138,676,55,731,1345,54.35%,40%,1
新北市,新店區,2099,570,153,723,70,793,1387,57.17%,41.1%,1
新北市,新店區,2100,818,199,1017,64,1081,1960,55.15%,41.73%,1
新北市,新店區,2101,784,171,955,72,1027,1837,55.91%,42.68%,1
新北市,新店區,2102,716,175,891,54,945,1662,56.86%,43.08%,1
新北市,新店區,2103,749,187,936,59,995,1617,61.53%,46.32%,1
新北市,新店區,2104,730,197,927,31,958,1704,56.22%,42.84%,1
新北市,新店區,2105,694,225,919,69,988,1835,53.84%,37.82%,1
新北市,新店區,2106,811,197,1008,76,1084,2009,53.96%,40.37%,1
新北市,新店區,2107,578,173,751,61,812,1450,56%,39.86%,1
新北市,新店區,2108,734,176,910,49,959,1726,55.56%,42.53%,1
新北市,新店區,2109,735,174,909,57,966,1797,53.76%,40.9%,1
新北市,新店區,2110,730,184,914,38,952,1739,54.74%,41.98%,1
新北市,新店區,2111,680,137,817,30,847,1523,55.61%,44.65%,1
新北市,新店區,2112,707,136,843,30,873,1642,53.17%,43.06%,1
新北市,新店區,2113,710,168,878,19,897,1644,54.56%,43.19%,1
新北市,新店區,2114,599,192,791,43,834,1662,50.18%,36.04%,1
新北市,新店區,2115,903,221,1124,55,1179,2067,57.04%,43.69%,1
新北市,新店區,2116,604,182,786,47,833,1870,44.55%,32.3%,1
新北市,新店區,2117,800,208,1008,54,1062,1982,53.58%,40.36%,1
新北市,新店區,2118,689,152,841,33,874,1546,56.53%,44.57%,1
新北市,新店區,2119,792,204,996,37,1033,1712,60.34%,46.26%,1
新北市,新店區,2120,719,142,861,23,884,1423,62.12%,50.53%,1
新北市,新店區,2121,747,195,942,56,998,1666,59.9%,44.84%,1
新北市,新店區,2122,846,200,1046,49,1095,1769,61.9%,47.82%,1
新北市,新店區,2123,356,142,498,44,542,1079,50.23%,32.99%,1
新北市,新店區,2124,422,141,563,23,586,1140,51.4%,37.02%,1
新北市,新店區,2125,789,151,940,59,999,1825,54.74%,43.23%,1
新北市,新店區,2126,523,155,678,33,711,1178,60.36%,44.4%,1
新北市,新店區,2127,613,142,755,42,797,1463,54.48%,41.9%,1
新北市,新店區,2128,507,123,630,28,658,1152,57.12%,44.01%,1
新北市,新店區,2129,738,163,901,36,937,2008,46.66%,36.75%,1
新北市,新店區,2130,779,154,933,50,983,2120,46.37%,36.75%,1
新北市,新店區,2131,534,119,653,22,675,1153,58.54%,46.31%,1
新北市,新店區,2132,625,162,787,43,830,1573,52.77%,39.73%,1
新北市,新店區,2133,678,207,885,78,963,1992,48.34%,34.04%,1
新北市,新店區,2134,596,161,757,60,817,1668,48.98%,35.73%,1
新北市,新店區,2135,600,148,748,54,802,1617,49.6%,37.11%,1
新北市,新店區,2136,751,200,951,125,1076,2013,53.45%,37.31%,1
新北市,新店區,2137,800,172,972,59,1031,1791,57.57%,44.67%,1
新北市,新店區,2138,697,174,871,49,920,1624,56.65%,42.92%,1
新北市,新店區,2139,571,110,681,32,713,1178,60.53%,48.47%,1
新北市,新店區,2140,600,119,719,29,748,1277,58.57%,46.99%,1
新北市,新店區,2141,828,180,1008,55,1063,1879,56.57%,44.07%,1
新北市,新店區,2142,302,104,406,33,439,939,46.75%,32.16%,1
新北市,新店區,2143,396,121,517,30,547,960,56.98%,41.25%,1
新北市,新店區,2144,673,178,851,20,871,1434,60.74%,46.93%,1
新北市,新店區,2145,718,184,902,53,955,1838,51.96%,39.06%,1
新北市,新店區,2146,608,158,766,50,816,1453,56.16%,41.84%,1
新北市,新店區,2147,602,181,783,48,831,1549,53.65%,38.86%,1
新北市,新店區,2148,805,227,1032,44,1076,1860,57.85%,43.28%,1
新北市,新店區,2149,687,157,844,31,875,1743,50.2%,39.41%,1
新北市,新店區,2150,566,127,693,41,734,1122,65.42%,50.45%,1
新北市,新店區,2151,628,140,768,44,812,1468,55.31%,42.78%,1
新北市,新店區,2152,746,187,933,35,968,1763,54.91%,42.31%,1
新北市,新店區,2153,545,131,676,40,716,1344,53.27%,40.55%,1
新北市,新店區,2154,273,86,359,46,405,753,53.78%,36.25%,1
新北市,新店區,2155,201,83,284,14,298,602,49.5%,33.39%,1
新北市,新店區,2156,834,269,1103,61,1164,2237,52.03%,37.28%,1
新北市,新店區,2157,430,125,555,31,586,1096,53.47%,39.23%,1
新北市,新店區,2158,362,125,487,47,534,1143,46.72%,31.67%,1
新北市,新店區,2159,560,181,741,83,824,1569,52.52%,35.69%,1
新北市,新店區,2160,463,155,618,68,686,1284,53.43%,36.06%,1
新北市,新店區,2161,89,35,124,13,137,439,31.21%,20.27%,1
新北市,新店區,2162,280,117,397,39,436,750,58.13%,37.33%,1
新北市,樹林區,1614,506,163,669,72,741,1408,52.63%,35.94%,1
新北市,樹林區,1615,491,149,640,32,672,1310,51.3%,37.48%,1
新北市,樹林區,1616,530,162,692,50,742,1534,48.37%,34.55%,1
新北市,樹林區,1617,457,154,611,60,671,1211,55.41%,37.74%,1
新北市,樹林區,1618,466,150,616,44,660,1125,58.67%,41.42%,1
新北市,樹林區,1619,486,159,645,37,682,1134,60.14%,42.86%,1
新北市,樹林區,1620,577,230,807,84,891,1897,46.97%,30.42%,1
新北市,樹林區,1621,616,220,836,78,914,1716,53.26%,35.9%,1
新北市,樹林區,1622,299,121,420,38,458,736,62.23%,40.63%,1
新北市,樹林區,1623,503,151,654,35,689,1137,60.6%,44.24%,1
新北市,樹林區,1624,563,185,748,51,799,1542,51.82%,36.51%,1
新北市,樹林區,1625,569,169,738,64,802,1470,54.56%,38.71%,1
新北市,樹林區,1626,498,149,647,32,679,1456,46.63%,34.2%,1
新北市,樹林區,1627,467,127,594,22,616,1124,54.8%,41.55%,1
新北市,樹林區,1628,470,154,624,32,656,1235,53.12%,38.06%,1
新北市,樹林區,1629,463,173,636,32,668,1212,55.12%,38.2%,1
新北市,樹林區,1630,424,136,560,35,595,1223,48.65%,34.67%,1
新北市,樹林區,1631,483,179,662,73,735,1335,55.06%,36.18%,1
新北市,樹林區,1632,467,159,626,37,663,1206,54.98%,38.72%,1
新北市,樹林區,1633,465,171,636,79,715,1927,37.1%,24.13%,1
新北市,樹林區,1634,361,113,474,46,520,914,56.89%,39.5%,1
新北市,樹林區,1635,599,179,778,58,836,1456,57.42%,41.14%,1
新北市,樹林區,1636,522,171,693,47,740,1409,52.52%,37.05%,1
新北市,樹林區,1637,614,222,836,63,899,1500,59.93%,40.93%,1
新北市,樹林區,1638,624,186,810,59,869,1545,56.25%,40.39%,1
新北市,樹林區,1639,569,178,747,25,772,1483,52.06%,38.37%,1
新北市,樹林區,1640,592,157,749,42,791,1524,51.9%,38.85%,1
新北市,樹林區,1641,593,166,759,38,797,1431,55.7%,41.44%,1
新北市,樹林區,1642,432,155,587,69,656,1181,55.55%,36.58%,1
新北市,樹林區,1643,453,142,595,58,653,1116,58.51%,40.59%,1
新北市,樹林區,1644,361,169,530,35,565,1077,52.46%,33.52%,1
新北市,樹林區,1645,384,135,519,15,534,1103,48.41%,34.81%,1
新北市,樹林區,1646,563,154,717,55,772,1385,55.74%,40.65%,1
新北市,樹林區,1647,472,148,620,44,664,1266,52.45%,37.28%,1
新北市,樹林區,1648,442,162,604,45,649,1195,54.31%,36.99%,1
新北市,樹林區,1649,462,163,625,54,679,1254,54.15%,36.84%,1
新北市,樹林區,1650,515,168,683,46,729,1263,57.72%,40.78%,1
新北市,樹林區,1651,594,224,818,78,896,1473,60.83%,40.33%,1
新北市,樹林區,1652,375,95,470,26,496,870,57.01%,43.1%,1
新北市,樹林區,1653,560,185,745,74,819,1338,61.21%,41.85%,1
新北市,樹林區,1654,400,99,499,35,534,1010,52.87%,39.6%,1
新北市,樹林區,1655,682,224,906,53,959,1658,57.84%,41.13%,1
新北市,樹林區,1656,676,225,901,60,961,1538,62.48%,43.95%,1
新北市,樹林區,1657,646,156,802,81,883,1405,62.85%,45.98%,1
新北市,樹林區,1658,607,221,828,60,888,1587,55.95%,38.25%,1
新北市,樹林區,1659,614,210,824,48,872,1566,55.68%,39.21%,1
新北市,樹林區,1660,401,94,495,14,509,997,51.05%,40.22%,1
新北市,樹林區,1661,480,141,621,52,673,1187,56.7%,40.44%,1
新北市,樹林區,1662,417,112,529,50,579,1061,54.57%,39.3%,1
新北市,樹林區,1663,730,176,906,48,954,1701,56.08%,42.92%,1
新北市,樹林區,1664,527,139,666,57,723,1278,56.57%,41.24%,1
新北市,樹林區,1665,628,178,806,59,865,1433,60.36%,43.82%,1
新北市,樹林區,1666,561,168,729,70,799,1306,61.18%,42.96%,1
新北市,樹林區,1667,528,178,706,66,772,1268,60.88%,41.64%,1
新北市,樹林區,1668,535,167,702,27,729,1281,56.91%,41.76%,1
新北市,樹林區,1669,492,172,664,50,714,1200,59.5%,41%,1
新北市,樹林區,1670,553,182,735,33,768,1491,51.51%,37.09%,1
新北市,樹林區,1671,400,130,530,23,553,1066,51.88%,37.52%,1
新北市,樹林區,1672,389,110,499,59,558,877,63.63%,44.36%,1
新北市,樹林區,1673,629,180,809,66,875,1616,54.15%,38.92%,1
新北市,樹林區,1674,527,152,679,64,743,1589,46.76%,33.17%,1
新北市,樹林區,1675,583,148,731,65,796,1367,58.23%,42.65%,1
新北市,樹林區,1676,485,155,640,46,686,1144,59.97%,42.4%,1
新北市,樹林區,1677,398,123,521,33,554,1059,52.31%,37.58%,1
新北市,樹林區,1678,446,167,613,67,680,1224,55.56%,36.44%,1
新北市,樹林區,1679,425,123,548,42,590,1141,51.71%,37.25%,1
新北市,樹林區,1680,457,116,573,25,598,1396,42.84%,32.74%,1
新北市,樹林區,1681,435,162,597,37,634,1157,54.8%,37.6%,1
新北市,樹林區,1682,498,196,694,81,775,1498,51.74%,33.24%,1
新北市,樹林區,1683,585,176,761,71,832,1514,54.95%,38.64%,1
新北市,樹林區,1684,561,168,729,51,780,1546,50.45%,36.29%,1
新北市,樹林區,1685,554,168,722,50,772,1392,55.46%,39.8%,1
新北市,樹林區,1686,685,138,823,49,872,1566,55.68%,43.74%,1
新北市,樹林區,1687,648,169,817,24,841,1566,53.7%,41.38%,1
新北市,樹林區,1688,601,168,769,53,822,1517,54.19%,39.62%,1
新北市,樹林區,1689,617,161,778,37,815,1481,55.03%,41.66%,1
新北市,樹林區,1690,488,143,631,50,681,1261,54%,38.7%,1
新北市,樹林區,1691,459,119,578,30,608,1163,52.28%,39.47%,1
新北市,樹林區,1692,669,251,920,74,994,1661,59.84%,40.28%,1
新北市,樹林區,1693,649,197,846,48,894,1585,56.4%,40.95%,1
新北市,樹林區,1694,460,120,580,37,617,1018,60.61%,45.19%,1
新北市,樹林區,1695,482,148,630,70,700,1247,56.13%,38.65%,1
新北市,樹林區,1696,535,140,675,78,753,1390,54.17%,38.49%,1
新北市,樹林區,1697,539,159,698,44,742,1293,57.39%,41.69%,1
新北市,樹林區,1698,480,138,618,32,650,1301,49.96%,36.89%,1
新北市,樹林區,1699,620,166,786,63,849,1606,52.86%,38.61%,1
新北市,樹林區,1700,445,182,627,71,698,1277,54.66%,34.85%,1
新北市,樹林區,1701,459,173,632,63,695,1219,57.01%,37.65%,1
新北市,樹林區,1702,558,139,697,36,733,1454,50.41%,38.38%,1
新北市,樹林區,1703,514,144,658,42,700,1314,53.27%,39.12%,1
新北市,樹林區,1704,468,144,612,26,638,1008,63.29%,46.43%,1
新北市,樹林區,1705,603,173,776,70,846,1574,53.75%,38.31%,1
新北市,樹林區,1706,586,144,730,37,767,1364,56.23%,42.96%,1
新北市,樹林區,1707,581,185,766,84,850,1677,50.69%,34.65%,1
新北市,樹林區,1708,523,158,681,40,721,1683,42.84%,31.08%,1
新北市,樹林區,1709,628,171,799,46,845,1452,58.2%,43.25%,1
新北市,樹林區,1710,721,168,889,31,920,1592,57.79%,45.29%,1
新北市,樹林區,1711,731,167,898,37,935,1619,57.75%,45.15%,1
新北市,樹林區,1712,785,197,982,32,1014,1642,61.75%,47.81%,1
新北市,樹林區,1713,593,138,731,24,755,1357,55.64%,43.7%,1
新北市,樹林區,1714,604,250,854,88,942,1638,57.51%,36.87%,1
新北市,樹林區,1715,647,166,813,47,860,1592,54.02%,40.64%,1
新北市,樹林區,1716,665,168,833,52,885,1521,58.19%,43.72%,1
新北市,樹林區,1717,755,212,967,60,1027,1707,60.16%,44.23%,1
新北市,樹林區,1718,741,232,973,64,1037,1741,59.56%,42.56%,1
新北市,樹林區,1719,703,165,868,41,909,1655,54.92%,42.48%,1
新北市,樹林區,1720,650,174,824,79,903,1775,50.87%,36.62%,1
新北市,樹林區,1721,756,173,929,60,989,1781,55.53%,42.45%,1
新北市,樹林區,1722,488,175,663,48,711,1565,45.43%,31.18%,1
新北市,樹林區,1723,330,129,459,45,504,936,53.85%,35.26%,1
新北市,樹林區,1724,396,141,537,21,558,1030,54.17%,38.45%,1
新北市,鶯歌區,1725,215,57,272,21,293,515,56.89%,41.75%,1
新北市,鶯歌區,1726,407,129,536,43,579,965,60%,42.18%,1
新北市,鶯歌區,1727,746,231,977,88,1065,1931,55.15%,38.63%,1
新北市,鶯歌區,1728,598,198,796,92,888,1797,49.42%,33.28%,1
新北市,鶯歌區,1729,427,118,545,45,590,1057,55.82%,40.4%,1
新北市,鶯歌區,1730,365,100,465,15,480,962,49.9%,37.94%,1
新北市,鶯歌區,1731,415,130,545,39,584,934,62.53%,44.43%,1
新北市,鶯歌區,1732,769,207,976,76,1052,1742,60.39%,44.14%,1
新北市,鶯歌區,1733,602,197,799,61,860,1634,52.63%,36.84%,1
新北市,鶯歌區,1734,626,149,775,48,823,1676,49.11%,37.35%,1
新北市,鶯歌區,1735,783,237,1020,100,1120,2052,54.58%,38.16%,1
新北市,鶯歌區,1736,679,187,866,39,905,1977,45.78%,34.34%,1
新北市,鶯歌區,1737,759,230,989,31,1020,1957,52.12%,38.78%,1
新北市,鶯歌區,1738,272,78,350,29,379,850,44.59%,32%,1
新北市,鶯歌區,1739,673,186,859,52,911,1782,51.12%,37.77%,1
新北市,鶯歌區,1740,591,155,746,45,791,1496,52.87%,39.51%,1
新北市,鶯歌區,1741,719,226,945,47,992,2071,47.9%,34.72%,1
新北市,鶯歌區,1742,559,169,728,61,789,1753,45.01%,31.89%,1
新北市,鶯歌區,1743,676,142,818,47,865,1737,49.8%,38.92%,1
新北市,鶯歌區,1744,621,157,778,57,835,1669,50.03%,37.21%,1
新北市,鶯歌區,1745,603,179,782,43,825,1842,44.79%,32.74%,1
新北市,鶯歌區,1746,508,172,680,56,736,1454,50.62%,34.94%,1
新北市,鶯歌區,1747,350,115,465,35,500,942,53.08%,37.15%,1
新北市,鶯歌區,1748,475,168,643,57,700,1317,53.15%,36.07%,1
新北市,鶯歌區,1749,312,87,399,24,423,949,44.57%,32.88%,1
新北市,鶯歌區,1750,614,183,797,51,848,1440,58.89%,42.64%,1
新北市,鶯歌區,1751,695,224,919,70,989,1809,54.67%,38.42%,1
新北市,鶯歌區,1752,728,192,920,65,985,1758,56.03%,41.41%,1
新北市,鶯歌區,1753,626,191,817,47,864,1589,54.37%,39.4%,1
新北市,鶯歌區,1754,457,140,597,34,631,1067,59.14%,42.83%,1
新北市,鶯歌區,1755,473,134,607,36,643,1092,58.88%,43.32%,1
新北市,鶯歌區,1756,739,161,900,51,951,1730,54.97%,42.72%,1
新北市,鶯歌區,1757,533,127,660,53,713,1281,55.66%,41.61%,1
新北市,鶯歌區,1758,553,161,714,53,767,1238,61.95%,44.67%,1
新北市,鶯歌區,1759,604,192,796,73,869,1568,55.42%,38.52%,1
新北市,鶯歌區,1760,504,128,632,53,685,1271,53.89%,39.65%,1
新北市,鶯歌區,1761,342,118,460,30,490,1183,41.42%,28.91%,1
新北市,鶯歌區,1762,364,91,455,28,483,1026,47.08%,35.48%,1
新北市,鶯歌區,1763,634,164,798,44,842,1721,48.93%,36.84%,1
新北市,鶯歌區,1764,469,149,618,71,689,1317,52.32%,35.61%,1
新北市,鶯歌區,1765,445,129,574,52,626,1046,59.85%,42.54%,1
新北市,鶯歌區,1766,457,174,631,56,687,1144,60.05%,39.95%,1
新北市,鶯歌區,1767,459,161,620,60,680,1336,50.9%,34.36%,1
新北市,鶯歌區,1768,481,131,612,66,678,1479,45.84%,32.52%,1
新北市,鶯歌區,1769,642,190,832,59,891,1736,51.32%,36.98%,1
新北市,鶯歌區,1770,576,173,749,58,807,1389,58.1%,41.47%,1
新北市,鶯歌區,1771,765,83,848,82,930,1956,47.55%,39.11%,1
新北市,鶯歌區,1772,492,203,695,49,744,1371,54.27%,35.89%,1
新北市,鶯歌區,1773,543,143,686,46,732,1810,40.44%,30%,1
新北市,鶯歌區,1774,76,21,97,5,102,227,44.93%,33.48%,1
新北市,三峽區,1917,115,49,164,22,186,274,67.88%,41.97%,1
新北市,三峽區,1918,213,77,290,32,322,583,55.23%,36.54%,1
新北市,三峽區,1919,547,193,740,22,762,1765,43.17%,30.99%,1
新北市,三峽區,1920,630,218,848,56,904,1714,52.74%,36.76%,1
新北市,三峽區,1921,517,127,644,33,677,1355,49.96%,38.15%,1
新北市,三峽區,1922,557,144,701,44,745,1329,56.06%,41.91%,1
新北市,三峽區,1923,372,133,505,49,554,1059,52.31%,35.13%,1
新北市,三峽區,1924,536,187,723,59,782,1364,57.33%,39.3%,1
新北市,三峽區,1925,416,177,593,53,646,1098,58.83%,37.89%,1
新北市,三峽區,1926,526,127,653,56,709,1296,54.71%,40.59%,1
新北市,三峽區,1927,450,149,599,63,662,1240,53.39%,36.29%,1
新北市,三峽區,1928,576,183,759,49,808,1531,52.78%,37.62%,1
新北市,三峽區,1929,525,127,652,42,694,1444,48.06%,36.36%,1
新北市,三峽區,1930,509,152,661,69,730,1347,54.19%,37.79%,1
新北市,三峽區,1931,525,200,725,53,778,1455,53.47%,36.08%,1
新北市,三峽區,1932,523,144,667,38,705,1556,45.31%,33.61%,1
新北市,三峽區,1933,407,150,557,39,596,1390,42.88%,29.28%,1
新北市,三峽區,1934,598,168,766,54,820,1532,53.52%,39.03%,1
新北市,三峽區,1935,466,144,610,64,674,1377,48.95%,33.84%,1
新北市,三峽區,1936,663,172,835,59,894,1731,51.65%,38.3%,1
新北市,三峽區,1937,635,183,818,31,849,1705,49.79%,37.24%,1
新北市,三峽區,1938,666,162,828,33,861,1590,54.15%,41.89%,1
新北市,三峽區,1939,729,169,898,25,923,1650,55.94%,44.18%,1
新北市,三峽區,1940,601,152,753,29,782,1441,54.27%,41.71%,1
新北市,三峽區,1941,629,164,793,23,816,1404,58.12%,44.8%,1
新北市,三峽區,1942,592,145,737,33,770,1295,59.46%,45.71%,1
新北市,三峽區,1943,496,130,626,25,651,1348,48.29%,36.8%,1
新北市,三峽區,1944,678,155,833,24,857,1579,54.27%,42.94%,1
新北市,三峽區,1945,601,140,741,21,762,1435,53.1%,41.88%,1
新北市,三峽區,1946,769,168,937,32,969,1659,58.41%,46.35%,1
新北市,三峽區,1947,723,158,881,34,915,1512,60.52%,47.82%,1
新北市,三峽區,1948,654,151,805,42,847,1463,57.89%,44.7%,1
新北市,三峽區,1949,669,141,810,24,834,1465,56.93%,45.67%,1
新北市,三峽區,1950,679,135,814,21,835,1463,57.07%,46.41%,1
新北市,三峽區,1951,653,141,794,31,825,1443,57.17%,45.25%,1
新北市,三峽區,1952,604,158,762,61,823,1634,50.37%,36.96%,1
新北市,三峽區,1953,656,197,853,58,911,1716,53.09%,38.23%,1
新北市,三峽區,1954,630,170,800,64,864,1675,51.58%,37.61%,1
新北市,三峽區,1955,513,155,668,51,719,1649,43.6%,31.11%,1
新北市,三峽區,1956,537,176,713,73,786,1489,52.79%,36.06%,1
新北市,三峽區,1957,650,164,814,50,864,1771,48.79%,36.7%,1
新北市,三峽區,1958,679,207,886,52,938,1726,54.35%,39.34%,1
新北市,三峽區,1959,509,149,658,70,728,1363,53.41%,37.34%,1
新北市,三峽區,1960,630,165,795,45,840,1624,51.72%,38.79%,1
新北市,三峽區,1961,541,162,703,52,755,1352,55.84%,40.01%,1
新北市,三峽區,1962,426,156,582,24,606,1608,37.69%,26.49%,1
新北市,三峽區,1963,561,154,715,63,778,1458,53.36%,38.48%,1
新北市,三峽區,1964,578,165,743,46,789,1641,48.08%,35.22%,1
新北市,三峽區,1965,523,181,704,106,810,1530,52.94%,34.18%,1
新北市,三峽區,1966,424,132,556,74,630,1389,45.36%,30.53%,1
新北市,三峽區,1967,447,145,592,75,667,1315,50.72%,33.99%,1
新北市,三峽區,1968,444,90,534,35,569,934,60.92%,47.54%,1
新北市,三峽區,1969,423,136,559,35,594,1270,46.77%,33.31%,1
新北市,三峽區,1970,296,113,409,48,457,929,49.19%,31.86%,1
新北市,三峽區,1971,372,112,484,19,503,1035,48.6%,35.94%,1
新北市,三峽區,1972,158,38,196,24,220,502,43.82%,31.47%,1
新北市,三峽區,1973,263,89,352,55,407,836,48.68%,31.46%,1
新北市,三峽區,1974,204,68,272,55,327,669,48.88%,30.49%,1
新北市,三峽區,1975,260,100,360,71,431,733,58.8%,35.47%,1
新北市,三峽區,1976,677,195,872,67,939,1560,60.19%,43.4%,1
新北市,三峽區,1977,623,177,800,43,843,1638,51.47%,38.03%,1
新北市,三峽區,1978,469,142,611,48,659,1394,47.27%,33.64%,1
新北市,三峽區,1979,293,108,401,43,444,771,57.59%,38%,1
新北市,三峽區,1980,467,164,631,32,663,1367,48.5%,34.16%,1
新北市,三峽區,1981,449,136,585,59,644,1241,51.89%,36.18%,1
新北市,三峽區,1982,525,150,675,37,712,1520,46.84%,34.54%,1
新北市,三峽區,1983,387,118,505,52,557,873,63.8%,44.33%,1
新北市,三峽區,1984,207,89,296,77,373,768,48.57%,26.95%,1
新北市,三峽區,1985,360,113,473,38,511,1097,46.58%,32.82%,1
新北市,三峽區,1986,390,115,505,66,571,1322,43.19%,29.5%,1
新北市,淡水區,0029,173,78,251,37,288,544,52.94%,31.8%,1
新北市,淡水區,0030,376,142,518,58,576,1044,55.17%,36.02%,1
新北市,淡水區,0031,513,173,686,39,725,1462,49.59%,35.09%,1
新北市,淡水區,0032,535,186,721,71,792,1525,51.93%,35.08%,1
新北市,淡水區,0033,324,97,421,46,467,986,47.36%,32.86%,1
新北市,淡水區,0034,332,82,414,33,447,806,55.46%,41.19%,1
新北市,淡水區,0035,447,136,583,73,656,1173,55.92%,38.11%,1
新北市,淡水區,0036,460,116,576,49,625,1343,46.54%,34.25%,1
新北市,淡水區,0037,342,115,457,33,490,1153,42.5%,29.66%,1
新北市,淡水區,0038,263,119,382,36,418,874,47.83%,30.09%,1
新北市,淡水區,0039,360,136,496,89,585,1063,55.03%,33.87%,1
新北市,淡水區,0040,448,134,582,43,625,1309,47.75%,34.22%,1
新北市,淡水區,0041,487,156,643,48,691,1290,53.57%,37.75%,1
新北市,淡水區,0042,716,187,903,34,937,1675,55.94%,42.75%,1
新北市,淡水區,0043,636,202,838,42,880,1589,55.38%,40.03%,1
新北市,淡水區,0044,693,199,892,48,940,1624,57.88%,42.67%,1
新北市,淡水區,0045,481,137,618,36,654,1241,52.7%,38.76%,1
新北市,淡水區,0046,493,149,642,62,704,1317,53.45%,37.43%,1
新北市,淡水區,0047,588,82,670,22,692,1225,56.49%,48%,1
新北市,淡水區,0048,596,151,747,41,788,1426,55.26%,41.8%,1
新北市,淡水區,0049,690,197,887,49,936,1610,58.14%,42.86%,1
新北市,淡水區,0050,797,243,1040,36,1076,1982,54.29%,40.21%,1
新北市,淡水區,0051,642,203,845,50,895,1924,46.52%,33.37%,1
新北市,淡水區,0052,652,218,870,52,922,1822,50.6%,35.78%,1
新北市,淡水區,0053,496,171,667,71,738,1232,59.9%,40.26%,1
新北市,淡水區,0054,655,177,832,71,903,1588,56.86%,41.25%,1
新北市,淡水區,0055,684,180,864,33,897,1784,50.28%,38.34%,1
新北市,淡水區,0056,639,218,857,68,925,1762,52.5%,36.27%,1
新北市,淡水區,0057,595,183,778,41,819,1546,52.98%,38.49%,1
新北市,淡水區,0058,802,168,970,43,1013,1897,53.4%,42.28%,1
新北市,淡水區,0059,606,151,757,41,798,1489,53.59%,40.7%,1
新北市,淡水區,0060,640,172,812,43,855,1679,50.92%,38.12%,1
新北市,淡水區,0061,622,179,801,39,840,1693,49.62%,36.74%,1
新北市,淡水區,0062,628,151,779,23,802,1674,47.91%,37.51%,1
新北市,淡水區,0063,547,149,696,28,724,1330,54.44%,41.13%,1
新北市,淡水區,0064,597,146,743,23,766,1467,52.22%,40.7%,1
新北市,淡水區,0065,774,158,932,46,978,1837,53.24%,42.13%,1
新北市,淡水區,0066,501,128,629,22,651,1924,33.84%,26.04%,1
新北市,淡水區,0067,904,218,1122,35,1157,2340,49.44%,38.63%,1
新北市,淡水區,0068,596,142,738,51,789,1704,46.3%,34.98%,1
新北市,淡水區,0069,536,146,682,36,718,1363,52.68%,39.33%,1
新北市,淡水區,0070,1122,233,1355,46,1401,3068,45.66%,36.57%,1
新北市,淡水區,0071,560,143,703,40,743,1528,48.63%,36.65%,1
新北市,淡水區,0072,568,175,743,59,802,1600,50.13%,35.5%,1
新北市,淡水區,0073,787,198,985,60,1045,1874,55.76%,42%,1
新北市,淡水區,0074,613,156,769,65,834,1567,53.22%,39.12%,1
新北市,淡水區,0075,506,142,648,50,698,1245,56.06%,40.64%,1
新北市,淡水區,0076,463,140,603,26,629,1211,51.94%,38.23%,1
新北市,淡水區,0077,857,191,1048,44,1092,1992,54.82%,43.02%,1
新北市,淡水區,0078,823,196,1019,47,1066,2028,52.56%,40.58%,1
新北市,淡水區,0079,566,144,710,71,781,1373,56.88%,41.22%,1
新北市,淡水區,0080,735,150,885,35,920,1732,53.12%,42.44%,1
新北市,淡水區,0081,548,163,711,51,762,1519,50.16%,36.08%,1
新北市,淡水區,0082,598,183,781,34,815,1727,47.19%,34.63%,1
新北市,淡水區,0083,541,137,678,32,710,1297,54.74%,41.71%,1
新北市,淡水區,0084,398,118,516,53,569,1066,53.38%,37.34%,1
新北市,淡水區,0085,565,146,711,57,768,1387,55.37%,40.74%,1
新北市,淡水區,0086,742,243,985,51,1036,1909,54.27%,38.87%,1
新北市,淡水區,0087,685,215,900,47,947,1770,53.5%,38.7%,1
新北市,淡水區,0088,768,152,920,57,977,2049,47.68%,37.48%,1
新北市,淡水區,0089,683,183,866,39,905,1680,53.87%,40.65%,1
新北市,淡水區,0090,602,183,785,60,845,1433,58.97%,42.01%,1
新北市,淡水區,0091,534,155,689,32,721,1365,52.82%,39.12%,1
新北市,淡水區,0092,652,156,808,49,857,1452,59.02%,44.9%,1
新北市,淡水區,0093,753,165,918,45,963,1804,53.38%,41.74%,1
新北市,淡水區,0094,500,160,660,41,701,1322,53.03%,37.82%,1
新北市,淡水區,0095,798,203,1001,31,1032,2019,51.11%,39.52%,1
新北市,淡水區,0096,737,197,934,48,982,1696,57.9%,43.46%,1
新北市,淡水區,0097,655,191,846,32,878,1576,55.71%,41.56%,1
新北市,淡水區,0098,747,203,950,43,993,1781,55.76%,41.94%,1
新北市,淡水區,0099,706,216,922,48,970,1665,58.26%,42.4%,1
新北市,淡水區,0100,768,238,1006,63,1069,2013,53.1%,38.15%,1
新北市,淡水區,0101,411,147,558,36,594,1108,53.61%,37.09%,1
新北市,淡水區,0102,531,133,664,49,713,1305,54.64%,40.69%,1
新北市,淡水區,0103,463,150,613,16,629,1199,52.46%,38.62%,1
新北市,淡水區,0104,767,237,1004,60,1064,2017,52.75%,38.03%,1
新北市,淡水區,0105,743,227,970,62,1032,2125,48.56%,34.96%,1
新北市,淡水區,0106,436,133,569,29,598,1289,46.39%,33.82%,1
新北市,淡水區,0107,583,151,734,49,783,1319,59.36%,44.2%,1
新北市,淡水區,0108,435,109,544,24,568,1051,54.04%,41.39%,1
新北市,淡水區,0109,537,145,682,35,717,1348,53.19%,39.84%,1
新北市,淡水區,0110,400,127,527,37,564,1106,50.99%,36.17%,1
新北市,淡水區,0111,301,89,390,28,418,717,58.3%,41.98%,1
新北市,淡水區,0112,517,163,680,34,714,1385,51.55%,37.33%,1
新北市,淡水區,0113,342,124,466,36,502,841,59.69%,40.67%,1
新北市,淡水區,0114,272,79,351,27,378,665,56.84%,40.9%,1
新北市,淡水區,0115,173,58,231,19,250,419,59.67%,41.29%,1
新北市,淡水區,0116,660,185,845,29,874,1599,54.66%,41.28%,1
新北市,淡水區,0117,642,188,830,50,880,1670,52.69%,38.44%,1
新北市,淡水區,0118,689,207,896,55,951,1683,56.51%,40.94%,1
新北市,淡水區,0119,565,167,732,59,791,1577,50.16%,35.83%,1
新北市,淡水區,0120,598,167,765,51,816,1618,50.43%,36.96%,1
新北市,淡水區,0121,785,198,983,45,1028,2214,46.43%,35.46%,1
新北市,淡水區,0122,694,198,892,55,947,1832,51.69%,37.88%,1
新北市,淡水區,0123,824,218,1042,66,1108,2123,52.19%,38.81%,1
新北市,淡水區,0124,1070,194,1264,27,1291,2998,43.06%,35.69%,1
新北市,汐止區,2336,592,182,774,85,859,1595,53.86%,37.12%,1
新北市,汐止區,2337,531,131,662,44,706,1262,55.94%,42.08%,1
新北市,汐止區,2338,350,127,477,64,541,917,59%,38.17%,1
新北市,汐止區,2339,800,206,1006,61,1067,1929,55.31%,41.47%,1
新北市,汐止區,2340,859,258,1117,67,1184,2227,53.17%,38.57%,1
新北市,汐止區,2341,444,94,538,59,597,1143,52.23%,38.85%,1
新北市,汐止區,2342,569,151,720,37,757,1367,55.38%,41.62%,1
新北市,汐止區,2343,113,40,153,20,173,322,53.73%,35.09%,1
新北市,汐止區,2344,584,193,777,7,784,1460,53.7%,40%,1
新北市,汐止區,2345,618,196,814,63,877,1719,51.02%,35.95%,1
新北市,汐止區,2346,622,151,773,55,828,1661,49.85%,37.45%,1
新北市,汐止區,2347,671,175,846,53,899,1590,56.54%,42.2%,1
新北市,汐止區,2348,647,163,810,61,871,1599,54.47%,40.46%,1
新北市,汐止區,2349,765,152,917,52,969,1749,55.4%,43.74%,1
新北市,汐止區,2350,240,88,328,28,356,1809,19.68%,13.27%,1
新北市,汐止區,2351,520,174,694,36,730,1601,45.6%,32.48%,1
新北市,汐止區,2352,528,143,671,66,737,1387,53.14%,38.07%,1
新北市,汐止區,2353,691,222,913,85,998,1779,56.1%,38.84%,1
新北市,汐止區,2354,834,259,1093,71,1164,2074,56.12%,40.21%,1
新北市,汐止區,2355,830,237,1067,44,1111,2072,53.62%,40.06%,1
新北市,汐止區,2356,942,233,1175,56,1231,2120,58.07%,44.43%,1
新北市,汐止區,2357,800,193,993,40,1033,1952,52.92%,40.98%,1
新北市,汐止區,2358,636,171,807,71,878,1654,53.08%,38.45%,1
新北市,汐止區,2359,536,160,696,62,758,1444,52.49%,37.12%,1
新北市,汐止區,2360,720,195,915,47,962,1627,59.13%,44.25%,1
新北市,汐止區,2361,643,196,839,68,907,1751,51.8%,36.72%,1
新北市,汐止區,2362,832,208,1040,44,1084,2066,52.47%,40.27%,1
新北市,汐止區,2363,633,180,813,55,868,1941,44.72%,32.61%,1
新北市,汐止區,2364,667,191,858,51,909,1906,47.69%,34.99%,1
新北市,汐止區,2365,509,132,641,77,718,1363,52.68%,37.34%,1
新北市,汐止區,2366,470,175,645,52,697,1368,50.95%,34.36%,1
新北市,汐止區,2367,407,144,551,54,605,1233,49.07%,33.01%,1
新北市,汐止區,2368,578,151,729,37,766,1554,49.29%,37.19%,1
新北市,汐止區,2369,628,180,808,36,844,1700,49.65%,36.94%,1
新北市,汐止區,2370,481,123,604,24,628,1124,55.87%,42.79%,1
新北市,汐止區,2371,785,230,1015,67,1082,1900,56.95%,41.32%,1
新北市,汐止區,2372,829,201,1030,62,1092,2050,53.27%,40.44%,1
新北市,汐止區,2373,475,135,610,56,666,1244,53.54%,38.18%,1
新北市,汐止區,2374,488,134,622,41,663,1320,50.23%,36.97%,1
新北市,汐止區,2375,608,180,788,45,833,1473,56.55%,41.28%,1
新北市,汐止區,2376,764,170,934,56,990,1802,54.94%,42.4%,1
新北市,汐止區,2377,570,132,702,38,740,1266,58.45%,45.02%,1
新北市,汐止區,2378,535,151,686,51,737,1481,49.76%,36.12%,1
新北市,汐止區,2379,541,162,703,66,769,1497,51.37%,36.14%,1
新北市,汐止區,2380,223,64,287,17,304,556,54.68%,40.11%,1
新北市,汐止區,2381,721,172,893,55,948,1913,49.56%,37.69%,1
新北市,汐止區,2382,777,196,973,41,1014,2027,50.02%,38.33%,1
新北市,汐止區,2383,714,185,899,45,944,1927,48.99%,37.05%,1
新北市,汐止區,2384,261,83,344,44,388,696,55.75%,37.5%,1
新北市,汐止區,2385,765,216,981,70,1051,2127,49.41%,35.97%,1
新北市,汐止區,2386,545,174,719,56,775,1642,47.2%,33.19%,1
新北市,汐止區,2387,724,200,924,73,997,1912,52.14%,37.87%,1
新北市,汐止區,2388,609,202,811,62,873,1893,46.12%,32.17%,1
新北市,汐止區,2389,482,163,645,69,714,1466,48.7%,32.88%,1
新北市,汐止區,2390,568,137,705,87,792,1538,51.5%,36.93%,1
新北市,汐止區,2391,572,164,736,45,781,1550,50.39%,36.9%,1
新北市,汐止區,2392,492,172,664,68,732,1456,50.27%,33.79%,1
新北市,汐止區,2393,395,119,514,58,572,947,60.4%,41.71%,1
新北市,汐止區,2394,357,128,485,20,505,923,54.71%,38.68%,1
新北市,汐止區,2395,661,247,908,118,1026,2043,50.22%,32.35%,1
新北市,汐止區,2396,630,247,877,83,960,2012,47.71%,31.31%,1
新北市,汐止區,2397,515,117,632,38,670,1471,45.55%,35.01%,1
新北市,汐止區,2398,594,173,767,47,814,1603,50.78%,37.06%,1
新北市,汐止區,2399,618,152,770,54,824,1530,53.86%,40.39%,1
新北市,汐止區,2400,627,203,830,28,858,1988,43.16%,31.54%,1
新北市,汐止區,2401,831,210,1041,50,1091,2198,49.64%,37.81%,1
新北市,汐止區,2402,619,193,812,58,870,1712,50.82%,36.16%,1
新北市,汐止區,2403,742,199,941,68,1009,1806,55.87%,41.09%,1
新北市,汐止區,2404,594,156,750,88,838,1576,53.17%,37.69%,1
新北市,汐止區,2405,606,142,748,28,776,1511,51.36%,40.11%,1
新北市,汐止區,2406,608,161,769,35,804,1691,47.55%,35.96%,1
新北市,汐止區,2407,654,168,822,44,866,1636,52.93%,39.98%,1
新北市,汐止區,2408,632,166,798,58,856,1676,51.07%,37.71%,1
新北市,汐止區,2409,469,146,615,39,654,1264,51.74%,37.1%,1
新北市,汐止區,2410,443,123,566,35,601,1165,51.59%,38.03%,1
新北市,汐止區,2411,651,187,838,49,887,1765,50.25%,36.88%,1
新北市,汐止區,2412,587,172,759,36,795,1815,43.8%,32.34%,1
新北市,汐止區,2413,605,207,812,63,875,1778,49.21%,34.03%,1
新北市,汐止區,2414,620,171,791,82,873,1580,55.25%,39.24%,1
新北市,汐止區,2415,588,159,747,59,806,1516,53.17%,38.79%,1
新北市,汐止區,2416,520,143,663,42,705,1425,49.47%,36.49%,1
新北市,汐止區,2417,578,146,724,34,758,1388,54.61%,41.64%,1
新北市,汐止區,2418,563,161,724,54,778,1436,54.18%,39.21%,1
新北市,汐止區,2419,627,161,788,51,839,1591,52.73%,39.41%,1
新北市,汐止區,2420,596,183,779,32,811,1639,49.48%,36.36%,1
新北市,汐止區,2421,532,125,657,24,681,1394,48.85%,38.16%,1
新北市,汐止區,2422,708,224,932,52,984,2035,48.35%,34.79%,1
新北市,汐止區,2423,709,214,923,57,980,1895,51.72%,37.41%,1
新北市,汐止區,2424,617,139,756,20,776,1374,56.48%,44.91%,1
新北市,汐止區,2425,482,120,602,20,622,1061,58.62%,45.43%,1
新北市,汐止區,2426,645,149,794,28,822,1312,62.65%,49.16%,1
新北市,汐止區,2427,661,148,809,42,851,1548,54.97%,42.7%,1
新北市,汐止區,2428,595,149,744,29,773,1350,57.26%,44.07%,1
新北市,汐止區,2429,616,164,780,34,814,1499,54.3%,41.09%,1
新北市,汐止區,2430,585,137,722,65,787,1366,57.61%,42.83%,1
新北市,汐止區,2431,551,155,706,59,765,1335,57.3%,41.27%,1
新北市,汐止區,2432,601,149,750,56,806,1324,60.88%,45.39%,1
新北市,汐止區,2433,564,142,706,75,781,1286,60.73%,43.86%,1
新北市,汐止區,2434,452,141,593,43,636,1155,55.06%,39.13%,1
新北市,汐止區,2435,776,214,990,41,1031,1682,61.3%,46.14%,1
新北市,汐止區,2436,694,170,864,59,923,1494,61.78%,46.45%,1
新北市,汐止區,2437,463,163,626,73,699,1166,59.95%,39.71%,1
新北市,汐止區,2438,832,262,1094,110,1204,2184,55.13%,38.1%,1
新北市,汐止區,2439,810,230,1040,77,1117,2031,55%,39.88%,1
新北市,汐止區,2440,700,201,901,77,978,1759,55.6%,39.8%,1
新北市,汐止區,2441,643,187,830,64,894,1577,56.69%,40.77%,1
新北市,汐止區,2442,542,142,684,24,708,1364,51.91%,39.74%,1
新北市,汐止區,2443,594,145,739,45,784,1401,55.96%,42.4%,1
新北市,汐止區,2444,481,170,651,42,693,1173,59.08%,41.01%,1
新北市,汐止區,2445,453,101,554,25,579,993,58.31%,45.62%,1
新北市,汐止區,2446,652,157,809,26,835,1587,52.61%,41.08%,1
新北市,瑞芳區,2220,311,74,385,35,420,725,57.93%,42.9%,1
新北市,瑞芳區,2221,440,112,552,52,604,1074,56.24%,40.97%,1
新北市,瑞芳區,2222,314,81,395,22,417,825,50.55%,38.06%,1
新北市,瑞芳區,2223,502,141,643,32,675,1242,54.35%,40.42%,1
新北市,瑞芳區,2224,225,74,299,25,324,598,54.18%,37.63%,1
新北市,瑞芳區,2225,330,98,428,39,467,872,53.56%,37.84%,1
新北市,瑞芳區,2226,238,86,324,42,366,760,48.16%,31.32%,1
新北市,瑞芳區,2227,459,130,589,37,626,1330,47.07%,34.51%,1
新北市,瑞芳區,2228,561,157,718,67,785,1683,46.64%,33.33%,1
新北市,瑞芳區,2229,386,90,476,50,526,980,53.67%,39.39%,1
新北市,瑞芳區,2230,352,107,459,41,500,946,52.85%,37.21%,1
新北市,瑞芳區,2231,483,120,603,20,623,1375,45.31%,35.13%,1
新北市,瑞芳區,2232,595,173,768,54,822,1671,49.19%,35.61%,1
新北市,瑞芳區,2233,308,88,396,24,420,978,42.94%,31.49%,1
新北市,瑞芳區,2234,206,79,285,29,314,645,48.68%,31.94%,1
新北市,瑞芳區,2235,358,136,494,63,557,1089,51.15%,32.87%,1
新北市,瑞芳區,2236,87,23,110,11,121,286,42.31%,30.42%,1
新北市,瑞芳區,2237,134,63,197,33,230,461,49.89%,29.07%,1
新北市,瑞芳區,2238,86,33,119,18,137,274,50%,31.39%,1
新北市,瑞芳區,2239,59,21,80,13,93,155,60%,38.06%,1
新北市,瑞芳區,2240,319,88,407,41,448,817,54.83%,39.05%,1
新北市,瑞芳區,2241,293,99,392,68,460,884,52.04%,33.14%,1
新北市,瑞芳區,2242,442,130,572,42,614,1333,46.06%,33.16%,1
新北市,瑞芳區,2243,191,35,226,7,233,607,38.39%,31.47%,1
新北市,瑞芳區,2244,385,110,495,44,539,1045,51.58%,36.84%,1
新北市,瑞芳區,2245,258,59,317,46,363,673,53.94%,38.34%,1
新北市,瑞芳區,2246,167,53,220,11,231,618,37.38%,27.02%,1
新北市,瑞芳區,2247,371,90,461,31,492,1063,46.28%,34.9%,1
新北市,瑞芳區,2248,321,102,423,42,465,860,54.07%,37.33%,1
新北市,瑞芳區,2249,93,32,125,2,127,432,29.4%,21.53%,1
新北市,瑞芳區,2250,121,41,162,8,170,445,38.2%,27.19%,1
新北市,瑞芳區,2251,104,16,120,12,132,318,41.51%,32.7%,1
新北市,瑞芳區,2252,48,17,65,12,77,159,48.43%,30.19%,1
新北市,瑞芳區,2253,93,38,131,14,145,337,43.03%,27.6%,1
新北市,瑞芳區,2254,70,20,90,8,98,180,54.44%,38.89%,1
新北市,瑞芳區,2255,50,18,68,14,82,187,43.85%,26.74%,1
新北市,瑞芳區,2256,132,39,171,20,191,369,51.76%,35.77%,1
新北市,瑞芳區,2257,114,51,165,22,187,335,55.82%,34.03%,1
新北市,瑞芳區,2258,141,41,182,18,200,470,42.55%,30%,1
新北市,瑞芳區,2259,85,24,109,6,115,297,38.72%,28.62%,1
新北市,瑞芳區,2260,132,24,156,8,164,267,61.42%,49.44%,1
新北市,瑞芳區,2261,167,52,219,6,225,876,25.68%,19.06%,1
新北市,瑞芳區,2262,332,94,426,26,452,1241,36.42%,26.75%,1
新北市,瑞芳區,2263,321,130,451,81,532,998,53.31%,32.16%,1
新北市,瑞芳區,2264,325,112,437,61,498,948,52.53%,34.28%,1
新北市,瑞芳區,2265,380,98,478,32,510,1308,38.99%,29.05%,1
新北市,土城區,1775,546,187,733,68,801,1505,53.22%,36.28%,1
新北市,土城區,1776,573,134,707,39,746,1242,60.06%,46.14%,1
新北市,土城區,1777,542,141,683,31,714,1206,59.2%,44.94%,1
新北市,土城區,1778,536,185,721,80,801,1474,54.34%,36.36%,1
新北市,土城區,1779,537,163,700,54,754,1489,50.64%,36.06%,1
新北市,土城區,1780,627,174,801,57,858,1675,51.22%,37.43%,1
新北市,土城區,1781,578,182,760,60,820,1499,54.7%,38.56%,1
新北市,土城區,1782,570,156,726,49,775,1495,51.84%,38.13%,1
新北市,土城區,1783,511,179,690,70,760,1411,53.86%,36.22%,1
新北市,土城區,1784,517,141,658,47,705,1378,51.16%,37.52%,1
新北市,土城區,1785,465,153,618,48,666,1256,53.03%,37.02%,1
新北市,土城區,1786,553,176,729,61,790,1379,57.29%,40.1%,1
新北市,土城區,1787,507,177,684,59,743,1424,52.18%,35.6%,1
新北市,土城區,1788,546,168,714,70,784,1455,53.88%,37.53%,1
新北市,土城區,1789,515,164,679,55,734,1419,51.73%,36.29%,1
新北市,土城區,1790,612,153,765,46,811,1357,59.76%,45.1%,1
新北市,土城區,1791,607,150,757,45,802,1501,53.43%,40.44%,1
新北市,土城區,1792,462,158,620,73,693,1206,57.46%,38.31%,1
新北市,土城區,1793,492,198,690,37,727,1255,57.93%,39.2%,1
新北市,土城區,1794,718,177,895,74,969,1869,51.85%,38.42%,1
新北市,土城區,1795,509,153,662,35,697,1292,53.95%,39.4%,1
新北市,土城區,1796,486,128,614,32,646,1324,48.79%,36.71%,1
新北市,土城區,1797,420,132,552,61,613,1155,53.07%,36.36%,1
新北市,土城區,1798,469,127,596,59,655,1183,55.37%,39.64%,1
新北市,土城區,1799,378,120,498,51,549,2518,21.8%,15.01%,1
新北市,土城區,1800,478,141,619,43,662,1218,54.35%,39.24%,1
新北市,土城區,1801,469,115,584,64,648,1133,57.19%,41.39%,1
新北市,土城區,1802,336,119,455,39,494,894,55.26%,37.58%,1
新北市,土城區,1803,355,135,490,58,548,931,58.86%,38.13%,1
新北市,土城區,1804,937,174,1111,41,1152,1820,63.3%,51.48%,1
新北市,土城區,1805,525,127,652,33,685,1320,51.89%,39.77%,1
新北市,土城區,1806,464,146,610,42,652,1241,52.54%,37.39%,1
新北市,土城區,1807,537,185,722,53,775,1414,54.81%,37.98%,1
新北市,土城區,1808,564,162,726,54,780,1378,56.6%,40.93%,1
新北市,土城區,1809,571,196,767,60,827,1421,58.2%,40.18%,1
新北市,土城區,1810,567,117,684,37,721,1340,53.81%,42.31%,1
新北市,土城區,1811,484,152,636,42,678,1144,59.27%,42.31%,1
新北市,土城區,1812,497,169,666,60,726,1268,57.26%,39.2%,1
新北市,土城區,1813,468,138,606,83,689,1196,57.61%,39.13%,1
新北市,土城區,1814,577,158,735,43,778,1308,59.48%,44.11%,1
新北市,土城區,1815,489,122,611,60,671,1175,57.11%,41.62%,1
新北市,土城區,1816,476,157,633,67,700,1230,56.91%,38.7%,1
新北市,土城區,1817,516,180,696,74,770,1342,57.38%,38.45%,1
新北市,土城區,1818,492,192,684,60,744,1268,58.68%,38.8%,1
新北市,土城區,1819,529,173,702,72,774,1227,63.08%,43.11%,1
新北市,土城區,1820,525,161,686,93,779,1356,57.45%,38.72%,1
新北市,土城區,1821,599,163,762,77,839,1496,56.08%,40.04%,1
新北市,土城區,1822,506,164,670,75,745,1309,56.91%,38.66%,1
新北市,土城區,1823,472,157,629,67,696,1175,59.23%,40.17%,1
新北市,土城區,1824,484,140,624,73,697,1237,56.35%,39.13%,1
新北市,土城區,1825,522,131,653,64,717,1256,57.09%,41.56%,1
新北市,土城區,1826,490,137,627,33,660,1228,53.75%,39.9%,1
新北市,土城區,1827,437,153,590,75,665,1182,56.26%,36.97%,1
新北市,土城區,1828,627,156,783,54,837,1558,53.72%,40.24%,1
新北市,土城區,1829,487,132,619,44,663,1160,57.16%,41.98%,1
新北市,土城區,1830,530,168,698,66,764,1357,56.3%,39.06%,1
新北市,土城區,1831,537,163,700,92,792,1464,54.1%,36.68%,1
新北市,土城區,1832,444,181,625,71,696,1335,52.13%,33.26%,1
新北市,土城區,1833,507,167,674,75,749,1346,55.65%,37.67%,1
新北市,土城區,1834,605,203,808,54,862,1435,60.07%,42.16%,1
新北市,土城區,1835,652,182,834,68,902,1639,55.03%,39.78%,1
新北市,土城區,1836,698,221,919,60,979,1728,56.66%,40.39%,1
新北市,土城區,1837,569,154,723,32,755,1665,45.35%,34.17%,1
新北市,土城區,1838,544,190,734,74,808,1333,60.62%,40.81%,1
新北市,土城區,1839,650,209,859,52,911,1567,58.14%,41.48%,1
新北市,土城區,1840,606,173,779,81,860,1576,54.57%,38.45%,1
新北市,土城區,1841,587,186,773,62,835,1458,57.27%,40.26%,1
新北市,土城區,1842,612,183,795,75,870,1517,57.35%,40.34%,1
新北市,土城區,1843,647,163,810,41,851,1489,57.15%,43.45%,1
新北市,土城區,1844,638,165,803,37,840,1463,57.42%,43.61%,1
新北市,土城區,1845,660,167,827,24,851,1584,53.72%,41.67%,1
新北市,土城區,1846,598,160,758,41,799,1464,54.58%,40.85%,1
新北市,土城區,1847,634,192,826,74,900,1598,56.32%,39.67%,1
新北市,土城區,1848,540,169,709,87,796,1500,53.07%,36%,1
新北市,土城區,1849,637,166,803,39,842,1542,54.6%,41.31%,1
新北市,土城區,1850,711,184,895,64,959,1619,59.23%,43.92%,1
新北市,土城區,1851,558,161,719,35,754,1521,49.57%,36.69%,1
新北市,土城區,1852,656,213,869,38,907,1691,53.64%,38.79%,1
新北市,土城區,1853,642,187,829,52,881,1657,53.17%,38.74%,1
新北市,土城區,1854,775,212,987,38,1025,1772,57.84%,43.74%,1
新北市,土城區,1855,629,134,763,25,788,1423,55.38%,44.2%,1
新北市,土城區,1856,549,203,752,57,809,1321,61.24%,41.56%,1
新北市,土城區,1857,654,164,818,57,875,1429,61.23%,45.77%,1
新北市,土城區,1858,553,167,720,53,773,1445,53.49%,38.27%,1
新北市,土城區,1859,638,183,821,59,880,1520,57.89%,41.97%,1
新北市,土城區,1860,519,131,650,29,679,1484,45.75%,34.97%,1
新北市,土城區,1861,531,162,693,33,726,1362,53.3%,38.99%,1
新北市,土城區,1862,503,139,642,34,676,1262,53.57%,39.86%,1
新北市,土城區,1863,584,143,727,44,771,1343,57.41%,43.48%,1
新北市,土城區,1864,427,176,603,51,654,1337,48.92%,31.94%,1
新北市,土城區,1865,389,133,522,60,582,1325,43.92%,29.36%,1
新北市,土城區,1866,494,165,659,48,707,1390,50.86%,35.54%,1
新北市,土城區,1867,615,152,767,64,831,1534,54.17%,40.09%,1
新北市,土城區,1868,530,177,707,79,786,1484,52.96%,35.71%,1
新北市,土城區,1869,537,152,689,105,794,1532,51.83%,35.05%,1
新北市,土城區,1870,611,164,775,71,846,1507,56.14%,40.54%,1
新北市,土城區,1871,648,172,820,51,871,1550,56.19%,41.81%,1
新北市,土城區,1872,630,168,798,59,857,1567,54.69%,40.2%,1
新北市,土城區,1873,565,179,744,38,782,1367,57.21%,41.33%,1
新北市,土城區,1874,493,143,636,57,693,1293,53.6%,38.13%,1
新北市,土城區,1875,534,187,721,60,781,1402,55.71%,38.09%,1
新北市,土城區,1876,541,164,705,51,756,1379,54.82%,39.23%,1
新北市,土城區,1877,557,149,706,49,755,1471,51.33%,37.87%,1
新北市,土城區,1878,575,134,709,36,745,1410,52.84%,40.78%,1
新北市,土城區,1879,570,187,757,71,828,1542,53.7%,36.96%,1
新北市,土城區,1880,472,153,625,58,683,1238,55.17%,38.13%,1
新北市,土城區,1881,497,119,616,57,673,1301,51.73%,38.2%,1
新北市,土城區,1882,648,160,808,34,842,1311,64.23%,49.43%,1
新北市,土城區,1883,553,142,695,32,727,1511,48.11%,36.6%,1
新北市,土城區,1884,564,180,744,70,814,1531,53.17%,36.84%,1
新北市,土城區,1885,596,182,778,69,847,1638,51.71%,36.39%,1
新北市,土城區,1886,599,154,753,36,789,1335,59.1%,44.87%,1
新北市,土城區,1887,609,147,756,49,805,1459,55.17%,41.74%,1
新北市,土城區,1888,608,158,766,36,802,1489,53.86%,40.83%,1
新北市,土城區,1889,725,196,921,38,959,1774,54.06%,40.87%,1
新北市,土城區,1890,754,172,926,52,978,1792,54.58%,42.08%,1
新北市,土城區,1891,745,166,911,68,979,1798,54.45%,41.43%,1
新北市,土城區,1892,475,160,635,68,703,1312,53.58%,36.2%,1
新北市,土城區,1893,494,121,615,60,675,1301,51.88%,37.97%,1
新北市,土城區,1894,449,159,608,57,665,1254,53.03%,35.81%,1
新北市,土城區,1895,445,133,578,45,623,1215,51.28%,36.63%,1
新北市,土城區,1896,574,165,739,55,794,1448,54.83%,39.64%,1
新北市,土城區,1897,508,154,662,65,727,1321,55.03%,38.46%,1
新北市,土城區,1898,397,143,540,62,602,1150,52.35%,34.52%,1
新北市,土城區,1899,472,174,646,53,699,1425,49.05%,33.12%,1
新北市,土城區,1900,561,179,740,71,811,1366,59.37%,41.07%,1
新北市,土城區,1901,508,163,671,59,730,1292,56.5%,39.32%,1
新北市,土城區,1902,505,145,650,66,716,1317,54.37%,38.34%,1
新北市,土城區,1903,538,161,699,54,753,1324,56.87%,40.63%,1
新北市,土城區,1904,460,113,573,61,634,1189,53.32%,38.69%,1
新北市,土城區,1905,484,147,631,77,708,1223,57.89%,39.57%,1
新北市,土城區,1906,584,182,766,58,824,1550,53.16%,37.68%,1
新北市,土城區,1907,626,211,837,74,911,1606,56.72%,38.98%,1
新北市,土城區,1908,595,184,779,48,827,1509,54.8%,39.43%,1
新北市,土城區,1909,599,162,761,66,827,1529,54.09%,39.18%,1
新北市,土城區,1910,537,145,682,79,761,1458,52.19%,36.83%,1
新北市,土城區,1911,578,178,756,90,846,1468,57.63%,39.37%,1
新北市,土城區,1912,578,183,761,46,807,1495,53.98%,38.66%,1
新北市,土城區,1913,486,173,659,80,739,1303,56.72%,37.3%,1
新北市,土城區,1914,549,165,714,49,763,1365,55.9%,40.22%,1
新北市,土城區,1915,553,188,741,79,820,1476,55.56%,37.47%,1
新北市,土城區,1916,650,160,810,37,847,1519,55.76%,42.79%,1
新北市,蘆洲區,0555,612,216,828,90,918,1600,57.38%,38.25%,1
新北市,蘆洲區,0556,603,186,789,71,860,1549,55.52%,38.93%,1
新北市,蘆洲區,0557,597,191,788,99,887,1516,58.51%,39.38%,1
新北市,蘆洲區,0558,536,148,684,90,774,1404,55.13%,38.18%,1
新北市,蘆洲區,0559,506,161,667,87,754,1381,54.6%,36.64%,1
新北市,蘆洲區,0560,639,149,788,50,838,1485,56.43%,43.03%,1
新北市,蘆洲區,0561,504,139,643,31,674,1779,37.89%,28.33%,1
新北市,蘆洲區,0562,687,202,889,58,947,1797,52.7%,38.23%,1
新北市,蘆洲區,0563,533,179,712,78,790,1364,57.92%,39.08%,1
新北市,蘆洲區,0564,665,186,851,59,910,1635,55.66%,40.67%,1
新北市,蘆洲區,0565,548,151,699,45,744,1567,47.48%,34.97%,1
新北市,蘆洲區,0566,590,164,754,56,810,1524,53.15%,38.71%,1
新北市,蘆洲區,0567,592,169,761,66,827,1612,51.3%,36.72%,1
新北市,蘆洲區,0568,613,189,802,53,855,1674,51.08%,36.62%,1
新北市,蘆洲區,0569,639,217,856,62,918,1838,49.95%,34.77%,1
新北市,蘆洲區,0570,599,180,779,52,831,1814,45.81%,33.02%,1
新北市,蘆洲區,0571,525,237,762,46,808,1473,54.85%,35.64%,1
新北市,蘆洲區,0572,588,141,729,56,785,1465,53.58%,40.14%,1
新北市,蘆洲區,0573,660,216,876,75,951,1652,57.57%,39.95%,1
新北市,蘆洲區,0574,619,192,811,100,911,1650,55.21%,37.52%,1
新北市,蘆洲區,0575,727,152,879,39,918,1656,55.43%,43.9%,1
新北市,蘆洲區,0576,556,206,762,59,821,1571,52.26%,35.39%,1
新北市,蘆洲區,0577,551,189,740,79,819,1523,53.78%,36.18%,1
新北市,蘆洲區,0578,575,163,738,51,789,1475,53.49%,38.98%,1
新北市,蘆洲區,0579,505,149,654,66,720,1367,52.67%,36.94%,1
新北市,蘆洲區,0580,609,189,798,63,861,1514,56.87%,40.22%,1
新北市,蘆洲區,0581,748,244,992,56,1048,1791,58.51%,41.76%,1
新北市,蘆洲區,0582,790,190,980,61,1041,1714,60.74%,46.09%,1
新北市,蘆洲區,0583,780,189,969,41,1010,1780,56.74%,43.82%,1
新北市,蘆洲區,0584,718,192,910,43,953,1713,55.63%,41.91%,1
新北市,蘆洲區,0585,749,186,935,53,988,1720,57.44%,43.55%,1
新北市,蘆洲區,0586,744,185,929,42,971,1766,54.98%,42.13%,1
新北市,蘆洲區,0587,639,167,806,73,879,1623,54.16%,39.37%,1
新北市,蘆洲區,0588,681,216,897,52,949,1740,54.54%,39.14%,1
新北市,蘆洲區,0589,721,219,940,76,1016,1759,57.76%,40.99%,1
新北市,蘆洲區,0590,704,236,940,86,1026,1775,57.8%,39.66%,1
新北市,蘆洲區,0591,789,231,1020,69,1089,1909,57.05%,41.33%,1
新北市,蘆洲區,0592,720,237,957,95,1052,1805,58.28%,39.89%,1
新北市,蘆洲區,0593,635,179,814,55,869,1642,52.92%,38.67%,1
新北市,蘆洲區,0594,669,197,866,50,916,1713,53.47%,39.05%,1
新北市,蘆洲區,0595,630,189,819,80,899,1746,51.49%,36.08%,1
新北市,蘆洲區,0596,617,198,815,59,874,1596,54.76%,38.66%,1
新北市,蘆洲區,0597,557,141,698,58,756,1434,52.72%,38.84%,1
新北市,蘆洲區,0598,542,180,722,76,798,1450,55.03%,37.38%,1
新北市,蘆洲區,0599,576,171,747,25,772,1543,50.03%,37.33%,1
新北市,蘆洲區,0600,602,172,774,45,819,1525,53.7%,39.48%,1
新北市,蘆洲區,0601,480,177,657,77,734,1419,51.73%,33.83%,1
新北市,蘆洲區,0602,530,160,690,50,740,1298,57.01%,40.83%,1
新北市,蘆洲區,0603,483,149,632,74,706,1304,54.14%,37.04%,1
新北市,蘆洲區,0604,670,217,887,74,961,1806,53.21%,37.1%,1
新北市,蘆洲區,0605,675,235,910,85,995,1910,52.09%,35.34%,1
新北市,蘆洲區,0606,620,180,800,63,863,1873,46.08%,33.1%,1
新北市,蘆洲區,0607,621,178,799,49,848,1785,47.51%,34.79%,1
新北市,蘆洲區,0608,578,223,801,69,870,1760,49.43%,32.84%,1
新北市,蘆洲區,0609,755,204,959,68,1027,1841,55.78%,41.01%,1
新北市,蘆洲區,0610,682,187,869,48,917,1855,49.43%,36.77%,1
新北市,蘆洲區,0611,480,173,653,77,730,1450,50.34%,33.1%,1
新北市,蘆洲區,0612,555,195,750,81,831,1585,52.43%,35.02%,1
新北市,蘆洲區,0613,498,151,649,127,776,1541,50.36%,32.32%,1
新北市,蘆洲區,0614,605,190,795,74,869,1626,53.44%,37.21%,1
新北市,蘆洲區,0615,500,144,644,71,715,1241,57.61%,40.29%,1
新北市,蘆洲區,0616,611,201,812,71,883,1634,54.04%,37.39%,1
新北市,蘆洲區,0617,597,198,795,70,865,1573,54.99%,37.95%,1
新北市,蘆洲區,0618,638,221,859,52,911,1619,56.27%,39.41%,1
新北市,蘆洲區,0619,664,200,864,90,954,1878,50.8%,35.36%,1
新北市,蘆洲區,0620,645,224,869,95,964,1797,53.64%,35.89%,1
新北市,蘆洲區,0621,747,224,971,40,1011,1816,55.67%,41.13%,1
新北市,蘆洲區,0622,523,196,719,77,796,1344,59.23%,38.91%,1
新北市,蘆洲區,0623,579,235,814,62,876,1492,58.71%,38.81%,1
新北市,蘆洲區,0624,690,233,923,124,1047,1959,53.45%,35.22%,1
新北市,蘆洲區,0625,563,216,779,104,883,1611,54.81%,34.95%,1
新北市,蘆洲區,0626,669,57,726,77,803,1574,51.02%,42.5%,1
新北市,蘆洲區,0627,647,203,850,79,929,1653,56.2%,39.14%,1
新北市,蘆洲區,0628,753,240,993,61,1054,3085,34.17%,24.41%,1
新北市,蘆洲區,0629,647,249,896,71,967,1812,53.37%,35.71%,1
新北市,蘆洲區,0630,501,169,670,63,733,1332,55.03%,37.61%,1
新北市,蘆洲區,0631,541,168,709,88,797,1648,48.36%,32.83%,1
新北市,蘆洲區,0632,514,147,661,30,691,1355,51%,37.93%,1
新北市,蘆洲區,0633,497,160,657,50,707,1371,51.57%,36.25%,1
新北市,蘆洲區,0634,417,160,577,63,640,1111,57.61%,37.53%,1
新北市,蘆洲區,0635,438,155,593,103,696,1176,59.18%,37.24%,1
新北市,蘆洲區,0636,624,200,824,64,888,1602,55.43%,38.95%,1
新北市,蘆洲區,0637,476,161,637,56,693,1361,50.92%,34.97%,1
新北市,蘆洲區,0638,584,174,758,66,824,1530,53.86%,38.17%,1
新北市,蘆洲區,0639,340,115,455,72,527,925,56.97%,36.76%,1
新北市,蘆洲區,0640,694,213,907,85,992,1851,53.59%,37.49%,1
新北市,蘆洲區,0641,620,189,809,67,876,1791,48.91%,34.62%,1
新北市,蘆洲區,0642,631,208,839,81,920,1853,49.65%,34.05%,1
新北市,蘆洲區,0643,628,181,809,49,858,1758,48.81%,35.72%,1
新北市,蘆洲區,0644,700,198,898,70,968,1798,53.84%,38.93%,1
新北市,蘆洲區,0645,660,184,844,66,910,1645,55.32%,40.12%,1
新北市,蘆洲區,0646,548,180,728,64,792,1612,49.13%,34%,1
新北市,蘆洲區,0647,591,171,762,93,855,1784,47.93%,33.13%,1
新北市,蘆洲區,0648,538,177,715,73,788,1701,46.33%,31.63%,1
新北市,蘆洲區,0649,587,171,758,51,809,1581,51.17%,37.13%,1
新北市,蘆洲區,0650,568,204,772,71,843,1534,54.95%,37.03%,1
新北市,蘆洲區,0651,640,218,858,70,928,1620,57.28%,39.51%,1
新北市,蘆洲區,0652,635,176,811,76,887,1494,59.37%,42.5%,1
新北市,蘆洲區,0653,471,143,614,42,656,1183,55.45%,39.81%,1
新北市,蘆洲區,0654,387,131,518,52,570,985,57.87%,39.29%,1
新北市,蘆洲區,0655,607,182,789,77,866,1673,51.76%,36.28%,1
新北市,蘆洲區,0656,640,206,846,96,942,1688,55.81%,37.91%,1
新北市,蘆洲區,0657,483,150,633,49,682,1249,54.6%,38.67%,1
新北市,蘆洲區,0658,541,161,702,76,778,1476,52.71%,36.65%,1
新北市,五股區,0207,509,182,691,103,794,1456,54.53%,34.96%,1
新北市,五股區,0208,555,152,707,77,784,1482,52.9%,37.45%,1
新北市,五股區,0209,494,177,671,51,722,1287,56.1%,38.38%,1
新北市,五股區,0210,365,147,512,44,556,1106,50.27%,33%,1
新北市,五股區,0211,443,150,593,87,680,1283,53%,34.53%,1
新北市,五股區,0212,752,107,859,63,922,1833,50.3%,41.03%,1
新北市,五股區,0213,464,139,603,52,655,1141,57.41%,40.67%,1
新北市,五股區,0214,168,75,243,40,283,463,61.12%,36.29%,1
新北市,五股區,0215,729,162,891,58,949,1786,53.14%,40.82%,1
新北市,五股區,0216,580,228,808,38,846,1660,50.96%,34.94%,1
新北市,五股區,0217,556,202,758,84,842,1534,54.89%,36.25%,1
新北市,五股區,0218,479,157,636,88,724,1285,56.34%,37.28%,1
新北市,五股區,0219,623,217,840,125,965,1832,52.67%,34.01%,1
新北市,五股區,0220,568,194,762,35,797,1542,51.69%,36.84%,1
新北市,五股區,0221,625,181,806,51,857,1897,45.18%,32.95%,1
新北市,五股區,0222,664,189,853,104,957,1964,48.73%,33.81%,1
新北市,五股區,0223,587,211,798,87,885,1779,49.75%,33%,1
新北市,五股區,0224,503,295,798,97,895,1735,51.59%,28.99%,1
新北市,五股區,0225,863,207,1070,55,1125,2299,48.93%,37.54%,1
新北市,五股區,0226,599,185,784,60,844,1755,48.09%,34.13%,1
新北市,五股區,0227,660,195,855,66,921,1674,55.02%,39.43%,1
新北市,五股區,0228,652,184,836,81,917,1661,55.21%,39.25%,1
新北市,五股區,0229,409,149,558,37,595,1281,46.45%,31.93%,1
新北市,五股區,0230,579,189,768,75,843,1566,53.83%,36.97%,1
新北市,五股區,0231,517,144,661,33,694,1560,44.49%,33.14%,1
新北市,五股區,0232,642,170,812,49,861,1622,53.08%,39.58%,1
新北市,五股區,0233,696,202,898,52,950,1779,53.4%,39.12%,1
新北市,五股區,0234,526,170,696,74,770,1487,51.78%,35.37%,1
新北市,五股區,0235,632,175,807,51,858,1567,54.75%,40.33%,1
新北市,五股區,0236,353,125,478,41,519,1333,38.93%,26.48%,1
新北市,五股區,0237,532,164,696,54,750,1263,59.38%,42.12%,1
新北市,五股區,0238,507,175,682,80,762,1314,57.99%,38.58%,1
新北市,五股區,0239,544,184,728,36,764,1513,50.5%,35.96%,1
新北市,五股區,0240,599,174,773,46,819,1517,53.99%,39.49%,1
新北市,五股區,0241,617,178,795,80,875,1613,54.25%,38.25%,1
新北市,五股區,0242,621,173,794,76,870,1616,53.84%,38.43%,1
新北市,五股區,0243,597,194,791,74,865,1616,53.53%,36.94%,1
新北市,五股區,0244,654,246,900,12,912,1689,54%,38.72%,1
新北市,五股區,0245,720,198,918,27,945,1894,49.89%,38.01%,1
新北市,五股區,0246,531,166,697,65,762,1210,62.98%,43.88%,1
新北市,五股區,0247,632,161,793,55,848,1643,51.61%,38.47%,1
新北市,五股區,0248,571,144,715,27,742,1441,51.49%,39.63%,1
新北市,五股區,0249,574,119,693,58,751,1305,57.55%,43.98%,1
新北市,五股區,0250,501,164,665,55,720,1170,61.54%,42.82%,1
新北市,五股區,0251,655,133,788,63,851,1397,60.92%,46.89%,1
新北市,五股區,0252,618,110,728,60,788,1312,60.06%,47.1%,1
新北市,五股區,0253,460,88,548,25,573,1127,50.84%,40.82%,1
新北市,五股區,0254,478,83,561,40,601,1154,52.08%,41.42%,1
新北市,泰山區,0255,218,77,295,33,328,643,51.01%,33.9%,1
新北市,泰山區,0256,88,19,107,7,114,186,61.29%,47.31%,1
新北市,泰山區,0257,540,144,684,44,728,1457,49.97%,37.06%,1
新北市,泰山區,0258,644,181,825,65,890,1594,55.83%,40.4%,1
新北市,泰山區,0259,606,136,742,60,802,1598,50.19%,37.92%,1
新北市,泰山區,0260,574,140,714,37,751,1503,49.97%,38.19%,1
新北市,泰山區,0261,541,137,678,70,748,1436,52.09%,37.67%,1
新北市,泰山區,0262,549,160,709,53,762,1384,55.06%,39.67%,1
新北市,泰山區,0263,486,147,633,55,688,1231,55.89%,39.48%,1
新北市,泰山區,0264,500,132,632,30,662,1295,51.12%,38.61%,1
新北市,泰山區,0265,654,181,835,62,897,1563,57.39%,41.84%,1
新北市,泰山區,0266,700,169,869,64,933,1610,57.95%,43.48%,1
新北市,泰山區,0267,512,133,645,32,677,1253,54.03%,40.86%,1
新北市,泰山區,0268,484,134,618,46,664,1294,51.31%,37.4%,1
新北市,泰山區,0269,558,193,751,38,789,1354,58.27%,41.21%,1
新北市,泰山區,0270,503,135,638,38,676,1259,53.69%,39.95%,1
新北市,泰山區,0271,520,153,673,22,695,1252,55.51%,41.53%,1
新北市,泰山區,0272,406,131,537,27,564,1094,51.55%,37.11%,1
新北市,泰山區,0273,642,191,833,57,890,1590,55.97%,40.38%,1
新北市,泰山區,0274,616,222,838,69,907,1634,55.51%,37.7%,1
新北市,泰山區,0275,535,154,689,40,729,1536,47.46%,34.83%,1
新北市,泰山區,0276,669,169,838,45,883,1534,57.56%,43.61%,1
新北市,泰山區,0277,751,139,890,58,948,1545,61.36%,48.61%,1
新北市,泰山區,0278,608,125,733,49,782,1399,55.9%,43.46%,1
新北市,泰山區,0279,522,145,667,29,696,1315,52.93%,39.7%,1
新北市,泰山區,0280,510,161,671,59,730,1201,60.78%,42.46%,1
新北市,泰山區,0281,427,163,590,65,655,1182,55.41%,36.13%,1
新北市,泰山區,0282,644,154,798,75,873,1665,52.43%,38.68%,1
新北市,泰山區,0283,701,233,934,75,1009,1855,54.39%,37.79%,1
新北市,泰山區,0284,719,219,938,89,1027,1866,55.04%,38.53%,1
新北市,泰山區,0285,768,209,977,54,1031,1935,53.28%,39.69%,1
新北市,泰山區,0286,618,151,769,49,818,1589,51.48%,38.89%,1
新北市,泰山區,0287,439,119,558,41,599,1152,52%,38.11%,1
新北市,泰山區,0288,432,148,580,45,625,1114,56.1%,38.78%,1
新北市,泰山區,0289,454,145,599,48,647,1040,62.21%,43.65%,1
新北市,泰山區,0290,437,118,555,43,598,1003,59.62%,43.57%,1
新北市,泰山區,0291,417,129,546,24,570,975,58.46%,42.77%,1
新北市,泰山區,0292,571,175,746,40,786,1440,54.58%,39.65%,1
新北市,泰山區,0293,580,161,741,22,763,1480,51.55%,39.19%,1
新北市,泰山區,0294,480,153,633,41,674,1211,55.66%,39.64%,1
新北市,泰山區,0295,503,143,646,23,669,1237,54.08%,40.66%,1
新北市,泰山區,0296,428,111,539,38,577,1069,53.98%,40.04%,1
新北市,泰山區,0297,734,180,914,72,986,1680,58.69%,43.69%,1
新北市,泰山區,0298,678,188,866,45,911,1651,55.18%,41.07%,1
新北市,泰山區,0299,568,124,692,35,727,1420,51.2%,40%,1
新北市,泰山區,0300,567,153,720,39,759,1337,56.77%,42.41%,1
新北市,泰山區,0301,650,93,743,43,786,1591,49.4%,40.85%,1
新北市,林口區,0145,439,174,613,63,676,1268,53.31%,34.62%,1
新北市,林口區,0146,417,139,556,51,607,1171,51.84%,35.61%,1
新北市,林口區,0147,512,134,646,52,698,1218,57.31%,42.04%,1
新北市,林口區,0148,660,195,855,55,910,1788,50.89%,36.91%,1
新北市,林口區,0149,554,198,752,69,821,1625,50.52%,34.09%,1
新北市,林口區,0150,530,157,687,67,754,1448,52.07%,36.6%,1
新北市,林口區,0151,467,135,602,81,683,1328,51.43%,35.17%,1
新北市,林口區,0152,494,150,644,63,707,1523,46.42%,32.44%,1
新北市,林口區,0153,521,123,644,40,684,1245,54.94%,41.85%,1
新北市,林口區,0154,649,146,795,36,831,1329,62.53%,48.83%,1
新北市,林口區,0155,642,173,815,42,857,1465,58.5%,43.82%,1
新北市,林口區,0156,616,161,777,31,808,1369,59.02%,45%,1
新北市,林口區,0157,559,172,731,57,788,1346,58.54%,41.53%,1
新北市,林口區,0158,432,153,585,64,649,1181,54.95%,36.58%,1
新北市,林口區,0159,671,98,769,27,796,1291,61.66%,51.98%,1
新北市,林口區,0160,494,131,625,48,673,1213,55.48%,40.73%,1
新北市,林口區,0161,577,122,699,35,734,1256,58.44%,45.94%,1
新北市,林口區,0162,435,157,592,52,644,1185,54.35%,36.71%,1
新北市,林口區,0163,514,166,680,56,736,1361,54.08%,37.77%,1
新北市,林口區,0164,733,133,866,29,895,1756,50.97%,41.74%,1
新北市,林口區,0165,683,142,825,40,865,1676,51.61%,40.75%,1
新北市,林口區,0166,694,150,844,25,869,1540,56.43%,45.06%,1
新北市,林口區,0167,695,116,811,37,848,1569,54.05%,44.3%,1
新北市,林口區,0168,643,159,802,35,837,1514,55.28%,42.47%,1
新北市,林口區,0169,538,128,666,26,692,1193,58.01%,45.1%,1
新北市,林口區,0170,713,174,887,29,916,1610,56.89%,44.29%,1
新北市,林口區,0171,604,130,734,39,773,1338,57.77%,45.14%,1
新北市,林口區,0172,480,136,616,35,651,1141,57.06%,42.07%,1
新北市,林口區,0173,559,146,705,33,738,1307,56.47%,42.77%,1
新北市,林口區,0174,587,146,733,29,762,1327,57.42%,44.24%,1
新北市,林口區,0175,577,133,710,34,744,1285,57.9%,44.9%,1
新北市,林口區,0176,638,153,791,38,829,1481,55.98%,43.08%,1
新北市,林口區,0177,685,152,837,23,860,1510,56.95%,45.36%,1
新北市,林口區,0178,717,191,908,42,950,1785,53.22%,40.17%,1
新北市,林口區,0179,750,191,941,29,970,1792,54.13%,41.85%,1
新北市,林口區,0180,678,147,825,31,856,1517,56.43%,44.69%,1
新北市,林口區,0181,703,165,868,31,899,1564,57.48%,44.95%,1
新北市,林口區,0182,725,140,865,30,895,1560,57.37%,46.47%,1
新北市,林口區,0183,643,158,801,38,839,1544,54.34%,41.65%,1
新北市,林口區,0184,673,147,820,38,858,1593,53.86%,42.25%,1
新北市,林口區,0185,629,138,767,35,802,1431,56.04%,43.96%,1
新北市,林口區,0186,620,186,806,41,847,1571,53.91%,39.47%,1
新北市,林口區,0187,628,165,793,35,828,1439,57.54%,43.64%,1
新北市,林口區,0188,619,175,794,47,841,1451,57.96%,42.66%,1
新北市,林口區,0189,625,172,797,43,840,1391,60.39%,44.93%,1
新北市,林口區,0190,634,153,787,24,811,1461,55.51%,43.39%,1
新北市,林口區,0191,697,177,874,20,894,1691,52.87%,41.22%,1
新北市,林口區,0192,629,170,799,49,848,1524,55.64%,41.27%,1
新北市,林口區,0193,658,147,805,33,838,1343,62.4%,48.99%,1
新北市,林口區,0194,648,159,807,32,839,1398,60.01%,46.35%,1
新北市,林口區,0195,613,165,778,40,818,1380,59.28%,44.42%,1
新北市,林口區,0196,551,161,712,53,765,1367,55.96%,40.31%,1
新北市,林口區,0197,565,159,724,42,766,1350,56.74%,41.85%,1
新北市,林口區,0198,526,130,656,43,699,1194,58.54%,44.05%,1
新北市,林口區,0199,543,134,677,60,737,1344,54.84%,40.4%,1
新北市,林口區,0200,486,130,616,35,651,1154,56.41%,42.11%,1
新北市,林口區,0201,525,132,657,37,694,1119,62.02%,46.92%,1
新北市,林口區,0202,329,129,458,44,502,1026,48.93%,32.07%,1
新北市,林口區,0203,466,153,619,52,671,1210,55.45%,38.51%,1
新北市,林口區,0204,335,112,447,66,513,912,56.25%,36.73%,1
新北市,林口區,0205,324,115,439,36,475,824,57.65%,39.32%,1
新北市,林口區,0206,579,169,748,84,832,1411,58.97%,41.03%,1
新北市,深坑區,2163,417,135,552,33,585,1142,51.23%,36.51%,1
新北市,深坑區,2164,489,133,622,48,670,1139,58.82%,42.93%,1
新北市,深坑區,2165,380,142,522,51,573,1065,53.8%,35.68%,1
新北市,深坑區,2166,531,136,667,49,716,1400,51.14%,37.93%,1
新北市,深坑區,2167,483,140,623,53,676,1330,50.83%,36.32%,1
新北市,深坑區,2168,496,138,634,38,672,1380,48.7%,35.94%,1
新北市,深坑區,2169,505,133,638,20,658,1496,43.98%,33.76%,1
新北市,深坑區,2170,617,173,790,71,861,1508,57.1%,40.92%,1
新北市,深坑區,2171,653,198,851,76,927,1624,57.08%,40.21%,1
新北市,深坑區,2172,853,256,1109,56,1165,2165,53.81%,39.4%,1
新北市,深坑區,2173,757,235,992,60,1052,1790,58.77%,42.29%,1
新北市,深坑區,2174,274,88,362,23,385,782,49.23%,35.04%,1
新北市,深坑區,2175,531,117,648,20,668,1164,57.39%,45.62%,1
新北市,深坑區,2176,582,163,745,55,800,1344,59.52%,43.3%,1
新北市,深坑區,2177,325,103,428,27,455,739,61.57%,43.98%,1
新北市,深坑區,2178,245,64,309,29,338,556,60.79%,44.06%,1
新北市,石碇區,2179,161,59,220,23,243,391,62.15%,41.18%,1
新北市,石碇區,2180,271,83,354,43,397,789,50.32%,34.35%,1
新北市,石碇區,2181,185,68,253,23,276,662,41.69%,27.95%,1
新北市,石碇區,2182,103,39,142,13,155,310,50%,33.23%,1
新北市,石碇區,2183,103,28,131,17,148,280,52.86%,36.79%,1
新北市,石碇區,2184,18,15,33,5,38,93,40.86%,19.35%,1
新北市,石碇區,2185,204,90,294,15,309,683,45.24%,29.87%,1
新北市,石碇區,2186,148,46,194,10,204,323,63.16%,45.82%,1
新北市,石碇區,2187,192,53,245,13,258,726,35.54%,26.45%,1
新北市,石碇區,2188,210,71,281,34,315,591,53.3%,35.53%,1
新北市,石碇區,2189,115,44,159,30,189,282,67.02%,40.78%,1
新北市,石碇區,2190,230,64,294,20,314,788,39.85%,29.19%,1
新北市,石碇區,2191,355,141,496,59,555,943,58.85%,37.65%,1
新北市,坪林區,2192,442,137,579,57,636,1248,50.96%,35.42%,1
新北市,坪林區,2193,197,54,251,41,292,612,47.71%,32.19%,1
新北市,坪林區,2194,419,128,547,103,650,1141,56.97%,36.72%,1
新北市,坪林區,2195,110,39,149,11,160,417,38.37%,26.38%,1
新北市,坪林區,2196,213,68,281,50,331,595,55.63%,35.8%,1
新北市,坪林區,2197,100,32,132,20,152,248,61.29%,40.32%,1
新北市,坪林區,2198,115,33,148,14,162,338,47.93%,34.02%,1
新北市,坪林區,2199,144,44,188,18,206,478,43.1%,30.13%,1
新北市,坪林區,2200,93,41,134,12,146,390,37.44%,23.85%,1
新北市,坪林區,2201,120,45,165,28,193,424,45.52%,28.3%,1
新北市,三芝區,0011,102,34,136,12,148,312,47.44%,32.69%,1
新北市,三芝區,0012,513,126,639,30,669,1421,47.08%,36.1%,1
新北市,三芝區,0013,561,186,747,54,801,1557,51.45%,36.03%,1
新北市,三芝區,0014,653,198,851,72,923,1828,50.49%,35.72%,1
新北市,三芝區,0015,377,118,495,45,540,1060,50.94%,35.57%,1
新北市,三芝區,0016,238,78,316,40,356,819,43.47%,29.06%,1
新北市,三芝區,0017,511,162,673,42,715,1701,42.03%,30.04%,1
新北市,三芝區,0018,569,196,765,72,837,1740,48.1%,32.7%,1
新北市,三芝區,0019,389,139,528,43,571,1451,39.35%,26.81%,1
新北市,三芝區,0020,395,119,514,61,575,1248,46.07%,31.65%,1
新北市,三芝區,0021,227,78,305,15,320,629,50.87%,36.09%,1
新北市,三芝區,0022,166,49,215,19,234,504,46.43%,32.94%,1
新北市,三芝區,0023,221,73,294,13,307,698,43.98%,31.66%,1
新北市,三芝區,0024,733,172,905,52,957,2069,46.25%,35.43%,1
新北市,三芝區,0025,282,98,380,34,414,784,52.81%,35.97%,1
新北市,三芝區,0026,157,76,233,30,263,522,50.38%,30.08%,1
新北市,三芝區,0027,176,62,238,65,303,587,51.62%,29.98%,1
新北市,三芝區,0028,408,145,553,50,603,1189,50.71%,34.31%,1
新北市,石門區,0001,366,159,525,54,579,1121,51.65%,32.65%,1
新北市,石門區,0002,459,134,593,76,669,1389,48.16%,33.05%,1
新北市,石門區,0003,337,94,431,58,489,933,52.41%,36.12%,1
新北市,石門區,0004,426,122,548,70,618,1244,49.68%,34.24%,1
新北市,石門區,0005,325,92,417,68,485,883,54.93%,36.81%,1
新北市,石門區,0006,619,159,778,50,828,1564,52.94%,39.58%,1
新北市,石門區,0007,546,185,731,64,795,1500,53%,36.4%,1
新北市,石門區,0008,114,18,132,19,151,328,46.04%,34.76%,1
新北市,石門區,0009,281,86,367,36,403,651,61.9%,43.16%,1
新北市,石門區,0010,290,81,371,40,411,915,44.92%,31.69%,1
新北市,八里區,0125,524,157,681,65,746,1498,49.8%,34.98%,1
新北市,八里區,0126,663,190,853,38,891,1939,45.95%,34.19%,1
新北市,八里區,0127,591,151,742,67,809,1516,53.36%,38.98%,1
新北市,八里區,0128,670,205,875,60,935,1642,56.94%,40.8%,1
新北市,八里區,0129,639,201,840,99,939,1927,48.73%,33.16%,1
新北市,八里區,0130,482,147,629,62,691,1276,54.15%,37.77%,1
新北市,八里區,0131,572,165,737,48,785,1349,58.19%,42.4%,1
新北市,八里區,0132,556,173,729,54,783,1403,55.81%,39.63%,1
新北市,八里區,0133,644,193,837,50,887,1644,53.95%,39.17%,1
新北市,八里區,0134,726,193,919,62,981,1853,52.94%,39.18%,1
新北市,八里區,0135,753,210,963,80,1043,1793,58.17%,42%,1
新北市,八里區,0136,645,190,835,47,882,1644,53.65%,39.23%,1
新北市,八里區,0137,681,211,892,72,964,1846,52.22%,36.89%,1
新北市,八里區,0138,506,153,659,58,717,1346,53.27%,37.59%,1
新北市,八里區,0139,632,186,818,52,870,1621,53.67%,38.99%,1
新北市,八里區,0140,670,197,867,74,941,2110,44.6%,31.75%,1
新北市,八里區,0141,692,236,928,74,1002,1967,50.94%,35.18%,1
新北市,八里區,0142,664,164,828,69,897,1626,55.17%,40.84%,1
新北市,八里區,0143,581,170,751,81,832,1514,54.95%,38.38%,1
新北市,八里區,0144,588,143,731,101,832,1456,57.14%,40.38%,1
新北市,平溪區,2208,125,36,161,26,187,384,48.7%,32.55%,1
新北市,平溪區,2209,73,17,90,5,95,232,40.95%,31.47%,1
新北市,平溪區,2210,95,32,127,13,140,249,56.22%,38.15%,1
新北市,平溪區,2211,155,60,215,37,252,458,55.02%,33.84%,1
新北市,平溪區,2212,82,29,111,18,129,232,55.6%,35.34%,1
新北市,平溪區,2213,180,55,235,20,255,635,40.16%,28.35%,1
新北市,平溪區,2214,147,51,198,38,236,427,55.27%,34.43%,1
新北市,平溪區,2215,242,68,310,33,343,862,39.79%,28.07%,1
新北市,平溪區,2216,52,18,70,3,73,147,49.66%,35.37%,1
新北市,平溪區,2217,98,25,123,12,135,365,36.99%,26.85%,1
新北市,平溪區,2218,39,26,65,8,73,153,47.71%,25.49%,1
新北市,平溪區,2219,68,23,91,18,109,177,61.58%,38.42%,1
新北市,雙溪區,2266,146,40,186,28,214,455,47.03%,32.09%,1
新北市,雙溪區,2267,107,28,135,13,148,286,51.75%,37.41%,1
新北市,雙溪區,2268,205,49,254,21,275,496,55.44%,41.33%,1
新北市,雙溪區,2269,124,24,148,12,160,383,41.78%,32.38%,1
新北市,雙溪區,2270,256,81,337,40,377,887,42.5%,28.86%,1
新北市,雙溪區,2271,174,71,245,33,278,652,42.64%,26.69%,1
新北市,雙溪區,2272,114,38,152,15,167,333,50.15%,34.23%,1
新北市,雙溪區,2273,224,61,285,35,320,642,49.84%,34.89%,1
新北市,雙溪區,2274,93,28,121,14,135,282,47.87%,32.98%,1
新北市,雙溪區,2275,187,55,242,26,268,621,43.16%,30.11%,1
新北市,雙溪區,2276,115,36,151,17,168,422,39.81%,27.25%,1
新北市,雙溪區,2277,81,26,107,27,134,369,36.31%,21.95%,1
新北市,雙溪區,2278,45,13,58,7,65,120,54.17%,37.5%,1
新北市,雙溪區,2279,98,20,118,16,134,271,49.45%,36.16%,1
新北市,雙溪區,2280,142,38,180,32,212,362,58.56%,39.23%,1
新北市,雙溪區,2281,128,35,163,30,193,371,52.02%,34.5%,1
新北市,雙溪區,2282,445,120,565,49,614,1047,58.64%,42.5%,1
新北市,貢寮區,2283,290,96,386,49,435,876,49.66%,33.11%,1
新北市,貢寮區,2284,140,53,193,25,218,433,50.35%,32.33%,1
新北市,貢寮區,2285,146,38,184,17,201,516,38.95%,28.29%,1
新北市,貢寮區,2286,90,35,125,26,151,373,40.48%,24.13%,1
新北市,貢寮區,2287,85,32,117,32,149,313,47.6%,27.16%,1
新北市,貢寮區,2288,163,56,219,16,235,485,48.45%,33.61%,1
新北市,貢寮區,2289,114,60,174,36,210,415,50.6%,27.47%,1
新北市,貢寮區,2290,230,67,297,25,322,812,39.66%,28.33%,1
新北市,貢寮區,2291,257,106,363,49,412,861,47.85%,29.85%,1
新北市,貢寮區,2292,159,72,231,32,263,676,38.91%,23.52%,1
新北市,貢寮區,2293,279,85,364,23,387,1091,35.47%,25.57%,1
新北市,貢寮區,2294,260,77,337,49,386,955,40.42%,27.23%,1
新北市,貢寮區,2295,209,61,270,10,280,769,36.41%,27.18%,1
新北市,貢寮區,2296,310,113,423,40,463,962,48.13%,32.22%,1
新北市,貢寮區,2297,148,34,182,9,191,390,48.97%,37.95%,1
新北市,貢寮區,2298,112,31,143,2,145,349,41.55%,32.09%,1
新北市,貢寮區,2299,111,49,160,37,197,508,38.78%,21.85%,1
新北市,貢寮區,2300,109,38,147,14,161,495,32.53%,22.02%,1
新北市,金山區,2301,129,103,232,30,262,481,54.47%,26.82%,1
新北市,金山區,2302,241,105,346,33,379,715,53.01%,33.71%,1
新北市,金山區,2303,143,44,187,27,214,481,44.49%,29.73%,1
新北市,金山區,2304,581,161,742,84,826,1792,46.09%,32.42%,1
新北市,金山區,2305,634,205,839,73,912,1781,51.21%,35.6%,1
新北市,金山區,2306,779,208,987,87,1074,2010,53.43%,38.76%,1
新北市,金山區,2307,530,170,700,63,763,1572,48.54%,33.72%,1
新北市,金山區,2308,653,174,827,81,908,1777,51.1%,36.75%,1
新北市,金山區,2309,554,155,709,64,773,1631,47.39%,33.97%,1
新北市,金山區,2310,312,84,396,38,434,828,52.42%,37.68%,1
新北市,金山區,2311,317,104,421,29,450,888,50.68%,35.7%,1
新北市,金山區,2312,399,134,533,79,612,1211,50.54%,32.95%,1
新北市,金山區,2313,171,53,224,15,239,416,57.45%,41.11%,1
新北市,金山區,2314,267,86,353,46,399,682,58.5%,39.15%,1
新北市,金山區,2315,234,57,291,57,348,644,54.04%,36.34%,1
新北市,金山區,2316,283,78,361,48,409,830,49.28%,34.1%,1
新北市,金山區,2317,62,26,88,11,99,188,52.66%,32.98%,1
新北市,金山區,2318,161,70,231,28,259,469,55.22%,34.33%,1
新北市,金山區,2319,142,35,177,36,213,582,36.6%,24.4%,1
新北市,萬里區,2320,506,143,649,47,696,1286,54.12%,39.35%,1
新北市,萬里區,2321,634,165,799,60,859,1576,54.51%,40.23%,1
新北市,萬里區,2322,487,152,639,46,685,1447,47.34%,33.66%,1
新北市,萬里區,2323,475,128,603,66,669,1466,45.63%,32.4%,1
新北市,萬里區,2324,407,123,530,55,585,1369,42.73%,29.73%,1
新北市,萬里區,2325,333,96,429,46,475,1215,39.09%,27.41%,1
新北市,萬里區,2326,497,131,628,61,689,1317,52.32%,37.74%,1
新北市,萬里區,2327,513,139,652,71,723,1676,43.14%,30.61%,1
新北市,萬里區,2328,506,155,661,79,740,1550,47.74%,32.65%,1
新北市,萬里區,2329,421,104,525,59,584,945,61.8%,44.55%,1
新北市,萬里區,2330,675,197,872,86,958,1760,54.43%,38.35%,1
新北市,萬里區,2331,201,60,261,26,287,570,50.35%,35.26%,1
新北市,萬里區,2332,282,129,411,35,446,952,46.85%,29.62%,1
新北市,萬里區,2333,261,74,335,60,395,674,58.61%,38.72%,1
新北市,萬里區,2334,138,51,189,19,208,405,51.36%,34.07%,1
新北市,萬里區,2335,370,113,483,65,548,1089,50.32%,33.98%,1
新北市,烏來區,2202,671,188,859,60,919,1568,58.61%,42.79%,1
新北市,烏來區,2203,441,120,561,20,581,1198,48.5%,36.81%,1
新北市,烏來區,2204,414,101,515,32,547,1169,46.79%,35.41%,1
新北市,烏來區,2205,91,17,108,4,112,228,49.12%,39.91%,1
新北市,烏來區,2206,187,48,235,28,263,486,54.12%,38.48%,1
新北市,烏來區,2207,194,57,251,23,274,615,44.55%,31.54%,1
桃園市,桃園區,0001,564,184,748,57,805,1593,50.53%,35.4%,1
桃園市,桃園區,0002,639,186,825,30,855,1934,44.21%,33.04%,1
桃園市,桃園區,0003,686,170,856,59,915,1661,55.09%,41.3%,1
桃園市,桃園區,0004,527,113,640,28,668,1448,46.13%,36.4%,1
桃園市,桃園區,0005,734,169,903,43,946,1974,47.92%,37.18%,1
桃園市,桃園區,0006,598,183,781,85,866,1882,46.01%,31.77%,1
桃園市,桃園區,0007,655,185,840,41,881,1800,48.94%,36.39%,1
桃園市,桃園區,0008,639,178,817,50,867,1598,54.26%,39.99%,1
桃園市,桃園區,0009,539,162,701,70,771,1626,47.42%,33.15%,1
桃園市,桃園區,0010,574,142,716,48,764,1590,48.05%,36.1%,1
桃園市,桃園區,0011,589,189,778,55,833,1637,50.89%,35.98%,1
桃園市,桃園區,0012,667,215,882,71,953,1943,49.05%,34.33%,1
桃園市,桃園區,0013,569,163,732,44,776,1482,52.36%,38.39%,1
桃園市,桃園區,0014,558,170,728,46,774,1423,54.39%,39.21%,1
桃園市,桃園區,0015,602,170,772,55,827,1509,54.8%,39.89%,1
桃園市,桃園區,0016,675,142,817,34,851,1567,54.31%,43.08%,1
桃園市,桃園區,0017,556,110,666,40,706,1305,54.1%,42.61%,1
桃園市,桃園區,0018,514,129,643,39,682,1416,48.16%,36.3%,1
桃園市,桃園區,0019,604,169,773,35,808,1439,56.15%,41.97%,1
桃園市,桃園區,0020,551,182,733,48,781,1399,55.83%,39.39%,1
桃園市,桃園區,0021,648,67,715,48,763,1540,49.55%,42.08%,1
桃園市,桃園區,0022,608,154,762,39,801,1638,48.9%,37.12%,1
桃園市,桃園區,0023,504,116,620,42,662,1228,53.91%,41.04%,1
桃園市,桃園區,0024,606,153,759,67,826,1649,50.09%,36.75%,1
桃園市,桃園區,0025,617,184,801,36,837,1601,52.28%,38.54%,1
桃園市,桃園區,0026,520,163,683,67,750,1477,50.78%,35.21%,1
桃園市,桃園區,0027,600,149,749,33,782,1503,52.03%,39.92%,1
桃園市,桃園區,0028,532,173,705,89,794,1375,57.75%,38.69%,1
桃園市,桃園區,0029,666,221,887,48,935,1743,53.64%,38.21%,1
桃園市,桃園區,0030,623,219,842,69,911,1862,48.93%,33.46%,1
桃園市,桃園區,0031,660,187,847,59,906,1728,52.43%,38.19%,1
桃園市,桃園區,0032,256,86,342,19,361,690,52.32%,37.1%,1
桃園市,桃園區,0033,364,117,481,33,514,852,60.33%,42.72%,1
桃園市,桃園區,0034,552,171,723,57,780,1353,57.65%,40.8%,1
桃園市,桃園區,0035,477,129,606,26,632,1698,37.22%,28.09%,1
桃園市,桃園區,0036,514,173,687,52,739,1452,50.9%,35.4%,1
桃園市,桃園區,0037,619,186,805,62,867,1681,51.58%,36.82%,1
桃園市,桃園區,0038,603,191,794,58,852,1669,51.05%,36.13%,1
桃園市,桃園區,0039,622,192,814,56,870,1530,56.86%,40.65%,1
桃園市,桃園區,0040,593,206,799,51,850,1582,53.73%,37.48%,1
桃園市,桃園區,0041,575,147,722,44,766,1587,48.27%,36.23%,1
桃園市,桃園區,0042,566,176,742,67,809,1451,55.75%,39.01%,1
桃園市,桃園區,0043,508,166,674,49,723,1582,45.7%,32.11%,1
桃園市,桃園區,0044,397,144,541,41,582,1028,56.61%,38.62%,1
桃園市,桃園區,0045,682,222,904,62,966,1934,49.95%,35.26%,1
桃園市,桃園區,0046,395,105,500,52,552,1016,54.33%,38.88%,1
桃園市,桃園區,0047,412,136,548,35,583,1079,54.03%,38.18%,1
桃園市,桃園區,0048,690,168,858,30,888,1837,48.34%,37.56%,1
桃園市,桃園區,0049,513,176,689,58,747,1390,53.74%,36.91%,1
桃園市,桃園區,0050,612,141,753,39,792,1489,53.19%,41.1%,1
桃園市,桃園區,0051,795,192,987,21,1008,1821,55.35%,43.66%,1
桃園市,桃園區,0052,576,133,709,22,731,1563,46.77%,36.85%,1
桃園市,桃園區,0053,776,125,901,41,942,1697,55.51%,45.73%,1
桃園市,桃園區,0054,722,180,902,37,939,1740,53.97%,41.49%,1
桃園市,桃園區,0055,627,177,804,46,850,1626,52.28%,38.56%,1
桃園市,桃園區,0056,541,131,672,15,687,1239,55.45%,43.66%,1
桃園市,桃園區,0057,710,176,886,49,935,1766,52.94%,40.2%,1
桃園市,桃園區,0058,604,174,778,53,831,1555,53.44%,38.84%,1
桃園市,桃園區,0059,697,209,906,49,955,1831,52.16%,38.07%,1
桃園市,桃園區,0060,477,151,628,37,665,1115,59.64%,42.78%,1
桃園市,桃園區,0061,596,217,813,46,859,1562,54.99%,38.16%,1
桃園市,桃園區,0062,702,148,850,46,896,1744,51.38%,40.25%,1
桃園市,桃園區,0063,628,186,814,45,859,1838,46.74%,34.17%,1
桃園市,桃園區,0064,739,216,955,70,1025,1889,54.26%,39.12%,1
桃園市,桃園區,0065,687,195,882,57,939,1985,47.3%,34.61%,1
桃園市,桃園區,0066,665,164,829,46,875,1524,57.41%,43.64%,1
桃園市,桃園區,0067,655,176,831,41,872,1425,61.19%,45.96%,1
桃園市,桃園區,0068,714,165,879,41,920,1606,57.29%,44.46%,1
桃園市,桃園區,0069,887,221,1108,33,1141,2056,55.5%,43.14%,1
桃園市,桃園區,0070,864,207,1071,35,1106,2010,55.02%,42.99%,1
桃園市,桃園區,0071,850,193,1043,59,1102,2245,49.09%,37.86%,1
桃園市,桃園區,0072,637,171,808,33,841,1590,52.89%,40.06%,1
桃園市,桃園區,0073,825,68,893,24,917,1536,59.7%,53.71%,1
桃園市,桃園區,0074,694,194,888,53,941,1949,48.28%,35.61%,1
桃園市,桃園區,0075,739,179,918,50,968,1965,49.26%,37.61%,1
桃園市,桃園區,0076,803,226,1029,60,1089,2414,45.11%,33.26%,1
桃園市,桃園區,0077,742,190,932,60,992,1942,51.08%,38.21%,1
桃園市,桃園區,0078,806,236,1042,71,1113,2156,51.62%,37.38%,1
桃園市,桃園區,0079,542,184,726,49,775,1404,55.2%,38.6%,1
桃園市,桃園區,0080,542,123,665,36,701,1194,58.71%,45.39%,1
桃園市,桃園區,0081,576,186,762,69,831,1449,57.35%,39.75%,1
桃園市,桃園區,0082,602,193,795,80,875,1803,48.53%,33.39%,1
桃園市,桃園區,0083,636,209,845,53,898,1692,53.07%,37.59%,1
桃園市,桃園區,0084,727,207,934,52,986,1913,51.54%,38%,1
桃園市,桃園區,0085,734,157,891,48,939,1815,51.74%,40.44%,1
桃園市,桃園區,0086,415,118,533,52,585,1173,49.87%,35.38%,1
桃園市,桃園區,0087,440,88,528,26,554,1162,47.68%,37.87%,1
桃園市,桃園區,0088,365,116,481,72,553,1194,46.31%,30.57%,1
桃園市,桃園區,0089,658,187,845,48,893,1695,52.68%,38.82%,1
桃園市,桃園區,0090,673,188,861,36,897,1797,49.92%,37.45%,1
桃園市,桃園區,0091,642,136,778,36,814,1592,51.13%,40.33%,1
桃園市,桃園區,0092,650,171,821,78,899,1780,50.51%,36.52%,1
桃園市,桃園區,0093,680,153,833,39,872,1904,45.8%,35.71%,1
桃園市,桃園區,0094,770,179,949,31,980,2021,48.49%,38.1%,1
桃園市,桃園區,0095,603,144,747,48,795,1545,51.46%,39.03%,1
桃園市,桃園區,0096,604,145,749,32,781,1617,48.3%,37.35%,1
桃園市,桃園區,0097,662,152,814,34,848,1683,50.39%,39.33%,1
桃園市,桃園區,0098,750,189,939,59,998,1834,54.42%,40.89%,1
桃園市,桃園區,0099,707,214,921,39,960,2055,46.72%,34.4%,1
桃園市,桃園區,0100,677,173,850,25,875,1828,47.87%,37.04%,1
桃園市,桃園區,0101,722,166,888,32,920,1873,49.12%,38.55%,1
桃園市,桃園區,0102,587,128,715,35,750,3687,20.34%,15.92%,1
桃園市,桃園區,0103,696,206,902,33,935,1850,50.54%,37.62%,1
桃園市,桃園區,0104,716,153,869,42,911,1827,49.86%,39.19%,1
桃園市,桃園區,0105,515,129,644,44,688,1149,59.88%,44.82%,1
桃園市,桃園區,0106,449,130,579,43,622,1061,58.62%,42.32%,1
桃園市,桃園區,0107,633,178,811,36,847,1831,46.26%,34.57%,1
桃園市,桃園區,0108,794,218,1012,56,1068,2168,49.26%,36.62%,1
桃園市,桃園區,0109,693,180,873,33,906,1874,48.35%,36.98%,1
桃園市,桃園區,0110,530,142,672,29,701,1524,46%,34.78%,1
桃園市,桃園區,0111,623,153,776,32,808,1528,52.88%,40.77%,1
桃園市,桃園區,0112,629,129,758,46,804,1489,54%,42.24%,1
桃園市,桃園區,0113,489,136,625,55,680,1308,51.99%,37.39%,1
桃園市,桃園區,0114,592,57,649,56,705,1583,44.54%,37.4%,1
桃園市,桃園區,0115,633,197,830,50,880,1618,54.39%,39.12%,1
桃園市,桃園區,0116,726,226,952,78,1030,2127,48.43%,34.13%,1
桃園市,桃園區,0117,731,203,934,19,953,2033,46.88%,35.96%,1
桃園市,桃園區,0118,824,193,1017,41,1058,2098,50.43%,39.28%,1
桃園市,桃園區,0119,834,128,962,77,1039,2126,48.87%,39.23%,1
桃園市,桃園區,0120,745,160,905,45,950,1917,49.56%,38.86%,1
桃園市,桃園區,0121,741,176,917,53,970,1997,48.57%,37.11%,1
桃園市,桃園區,0122,771,178,949,48,997,1929,51.68%,39.97%,1
桃園市,桃園區,0123,637,183,820,38,858,1691,50.74%,37.67%,1
桃園市,桃園區,0124,744,172,916,48,964,1900,50.74%,39.16%,1
桃園市,桃園區,0125,689,187,876,59,935,1761,53.09%,39.13%,1
桃園市,桃園區,0126,702,206,908,34,942,1922,49.01%,36.52%,1
桃園市,桃園區,0127,733,159,892,57,949,1995,47.57%,36.74%,1
桃園市,桃園區,0128,412,121,533,43,576,1063,54.19%,38.76%,1
桃園市,桃園區,0129,548,136,684,46,730,1412,51.7%,38.81%,1
桃園市,桃園區,0130,699,201,900,23,923,1746,52.86%,40.03%,1
桃園市,桃園區,0131,612,143,755,57,812,1689,48.08%,36.23%,1
桃園市,桃園區,0132,477,149,626,38,664,1542,43.06%,30.93%,1
桃園市,桃園區,0133,547,126,673,51,724,1437,50.38%,38.07%,1
桃園市,桃園區,0134,621,173,794,36,830,1679,49.43%,36.99%,1
桃園市,桃園區,0135,625,198,823,52,875,1886,46.39%,33.14%,1
桃園市,桃園區,0136,656,176,832,59,891,1657,53.77%,39.59%,1
桃園市,桃園區,0137,511,163,674,41,715,1349,53%,37.88%,1
桃園市,桃園區,0138,708,184,892,44,936,1805,51.86%,39.22%,1
桃園市,桃園區,0139,657,206,863,69,932,1846,50.49%,35.59%,1
桃園市,桃園區,0140,514,219,733,43,776,1644,47.2%,31.27%,1
桃園市,桃園區,0141,595,154,749,54,803,1674,47.97%,35.54%,1
桃園市,桃園區,0142,647,189,836,46,882,1737,50.78%,37.25%,1
桃園市,桃園區,0143,605,183,788,48,836,1566,53.38%,38.63%,1
桃園市,桃園區,0144,611,160,771,39,810,1517,53.39%,40.28%,1
桃園市,桃園區,0145,556,153,709,32,741,1619,45.77%,34.34%,1
桃園市,桃園區,0146,675,189,864,41,905,1774,51.01%,38.05%,1
桃園市,桃園區,0147,664,167,831,32,863,1666,51.8%,39.86%,1
桃園市,桃園區,0148,612,160,772,22,794,1528,51.96%,40.05%,1
桃園市,桃園區,0149,622,196,818,51,869,1709,50.85%,36.4%,1
桃園市,桃園區,0150,644,181,825,28,853,1719,49.62%,37.46%,1
桃園市,桃園區,0151,520,158,678,56,734,1569,46.78%,33.14%,1
桃園市,桃園區,0152,571,132,703,41,744,1505,49.44%,37.94%,1
桃園市,桃園區,0153,554,151,705,51,756,1496,50.53%,37.03%,1
桃園市,桃園區,0154,618,142,760,41,801,1505,53.22%,41.06%,1
桃園市,桃園區,0155,671,193,864,45,909,1807,50.3%,37.13%,1
桃園市,桃園區,0156,730,176,906,42,948,1857,51.05%,39.31%,1
桃園市,桃園區,0157,639,181,820,69,889,1589,55.95%,40.21%,1
桃園市,桃園區,0158,765,225,990,50,1040,2088,49.81%,36.64%,1
桃園市,桃園區,0159,730,181,911,35,946,1893,49.97%,38.56%,1
桃園市,桃園區,0160,443,104,547,36,583,1303,44.74%,34%,1
桃園市,桃園區,0161,561,153,714,37,751,1416,53.04%,39.62%,1
桃園市,桃園區,0162,499,128,627,35,662,1351,49%,36.94%,1
桃園市,桃園區,0163,622,151,773,43,816,1659,49.19%,37.49%,1
桃園市,桃園區,0164,797,180,977,42,1019,2103,48.45%,37.9%,1
桃園市,桃園區,0165,755,165,920,42,962,1943,49.51%,38.86%,1
桃園市,桃園區,0166,727,199,926,48,974,1927,50.54%,37.73%,1
桃園市,桃園區,0167,689,146,835,46,881,1929,45.67%,35.72%,1
桃園市,桃園區,0168,938,243,1181,41,1222,2204,55.44%,42.56%,1
桃園市,桃園區,0169,678,218,896,34,930,2033,45.75%,33.35%,1
桃園市,桃園區,0170,687,137,824,20,844,1656,50.97%,41.49%,1
桃園市,桃園區,0171,583,204,787,57,844,1712,49.3%,34.05%,1
桃園市,桃園區,0172,630,184,814,57,871,1738,50.12%,36.25%,1
桃園市,桃園區,0173,673,155,828,18,846,1432,59.08%,47%,1
桃園市,桃園區,0174,631,153,784,44,828,1421,58.27%,44.41%,1
桃園市,桃園區,0175,519,146,665,27,692,1344,51.49%,38.62%,1
桃園市,桃園區,0176,649,213,862,37,899,1942,46.29%,33.42%,1
桃園市,桃園區,0177,758,197,955,45,1000,2001,49.98%,37.88%,1
桃園市,桃園區,0178,774,61,835,25,860,1941,44.31%,39.88%,1
桃園市,桃園區,0179,649,194,843,46,889,1702,52.23%,38.13%,1
桃園市,桃園區,0180,603,172,775,42,817,1589,51.42%,37.95%,1
桃園市,桃園區,0181,600,151,751,34,785,1544,50.84%,38.86%,1
桃園市,桃園區,0182,591,147,738,42,780,1860,41.94%,31.77%,1
桃園市,桃園區,0183,635,175,810,56,866,1726,50.17%,36.79%,1
桃園市,桃園區,0184,631,189,820,49,869,1798,48.33%,35.09%,1
桃園市,桃園區,0185,719,205,924,39,963,1925,50.03%,37.35%,1
桃園市,桃園區,0186,681,222,903,44,947,1945,48.69%,35.01%,1
桃園市,桃園區,0187,587,185,772,53,825,1764,46.77%,33.28%,1
桃園市,桃園區,0188,788,174,962,70,1032,1899,54.34%,41.5%,1
桃園市,桃園區,0189,540,147,687,23,710,1415,50.18%,38.16%,1
桃園市,桃園區,0190,651,158,809,42,851,1790,47.54%,36.37%,1
桃園市,桃園區,0191,617,164,781,28,809,1693,47.78%,36.44%,1
桃園市,桃園區,0192,665,205,870,48,918,1916,47.91%,34.71%,1
桃園市,桃園區,0193,488,147,635,25,660,1434,46.03%,34.03%,1
桃園市,桃園區,0194,609,186,795,39,834,1494,55.82%,40.76%,1
桃園市,桃園區,0195,490,165,655,63,718,1311,54.77%,37.38%,1
桃園市,桃園區,0196,542,185,727,43,770,1476,52.17%,36.72%,1
桃園市,桃園區,0197,598,180,778,53,831,1484,56%,40.3%,1
桃園市,桃園區,0198,544,186,730,38,768,1514,50.73%,35.93%,1
桃園市,桃園區,0199,532,150,682,74,756,1446,52.28%,36.79%,1
桃園市,桃園區,0200,595,126,721,22,743,1573,47.23%,37.83%,1
桃園市,桃園區,0201,538,150,688,36,724,1564,46.29%,34.4%,1
桃園市,桃園區,0202,393,135,528,42,570,1015,56.16%,38.72%,1
桃園市,桃園區,0203,344,108,452,30,482,955,50.47%,36.02%,1
桃園市,桃園區,0204,673,185,858,37,895,1796,49.83%,37.47%,1
桃園市,桃園區,0205,719,161,880,23,903,1878,48.08%,38.29%,1
桃園市,桃園區,0206,631,170,801,41,842,1729,48.7%,36.5%,1
桃園市,桃園區,0207,622,161,783,30,813,1843,44.11%,33.75%,1
桃園市,桃園區,0208,614,137,751,32,783,1817,43.09%,33.79%,1
桃園市,桃園區,0209,381,130,511,41,552,979,56.38%,38.92%,1
桃園市,桃園區,0210,535,156,691,34,725,1363,53.19%,39.25%,1
桃園市,桃園區,0211,608,136,744,20,764,1546,49.42%,39.33%,1
桃園市,桃園區,0212,518,107,625,31,656,1308,50.15%,39.6%,1
桃園市,桃園區,0213,783,222,1005,61,1066,2164,49.26%,36.18%,1
桃園市,桃園區,0214,692,213,905,63,968,2020,47.92%,34.26%,1
桃園市,桃園區,0215,645,157,802,52,854,1924,44.39%,33.52%,1
桃園市,桃園區,0216,701,196,897,41,938,2088,44.92%,33.57%,1
桃園市,中壢區,0591,579,115,694,48,742,1401,52.96%,41.33%,1
桃園市,中壢區,0592,652,193,845,57,902,1798,50.17%,36.26%,1
桃園市,中壢區,0593,580,142,722,47,769,1642,46.83%,35.32%,1
桃園市,中壢區,0594,664,161,825,61,886,1670,53.05%,39.76%,1
桃園市,中壢區,0595,616,150,766,24,790,1456,54.26%,42.31%,1
桃園市,中壢區,0596,710,154,864,48,912,1531,59.57%,46.37%,1
桃園市,中壢區,0597,725,161,886,46,932,1623,57.42%,44.67%,1
桃園市,中壢區,0598,742,108,850,39,889,1953,45.52%,37.99%,1
桃園市,中壢區,0599,508,125,633,26,659,1155,57.06%,43.98%,1
桃園市,中壢區,0600,653,141,794,47,841,1800,46.72%,36.28%,1
桃園市,中壢區,0601,702,122,824,29,853,1757,48.55%,39.95%,1
桃園市,中壢區,0602,585,122,707,47,754,1281,58.86%,45.67%,1
桃園市,中壢區,0603,661,134,795,28,823,1462,56.29%,45.21%,1
桃園市,中壢區,0604,565,131,696,56,752,1560,48.21%,36.22%,1
桃園市,中壢區,0605,736,154,890,36,926,1602,57.8%,45.94%,1
桃園市,中壢區,0606,505,114,619,27,646,1006,64.21%,50.2%,1
桃園市,中壢區,0607,561,133,694,21,715,1474,48.51%,38.06%,1
桃園市,中壢區,0608,647,144,791,93,884,1627,54.33%,39.77%,1
桃園市,中壢區,0609,675,150,825,34,859,1519,56.55%,44.44%,1
桃園市,中壢區,0610,630,143,773,76,849,1526,55.64%,41.28%,1
桃園市,中壢區,0611,650,145,795,78,873,1618,53.96%,40.17%,1
桃園市,中壢區,0612,744,109,853,51,904,1554,58.17%,47.88%,1
桃園市,中壢區,0613,725,129,854,69,923,1706,54.1%,42.5%,1
桃園市,中壢區,0614,826,151,977,50,1027,1818,56.49%,45.43%,1
桃園市,中壢區,0615,758,153,911,51,962,1991,48.32%,38.07%,1
桃園市,中壢區,0616,674,141,815,28,843,1609,52.39%,41.89%,1
桃園市,中壢區,0617,528,66,594,38,632,1329,47.55%,39.73%,1
桃園市,中壢區,0618,580,132,712,83,795,1587,50.09%,36.55%,1
桃園市,中壢區,0619,775,163,938,41,979,1955,50.08%,39.64%,1
桃園市,中壢區,0620,652,187,839,46,885,1711,51.72%,38.11%,1
桃園市,中壢區,0621,652,156,808,62,870,1712,50.82%,38.08%,1
桃園市,中壢區,0622,649,134,783,53,836,1448,57.73%,44.82%,1
桃園市,中壢區,0623,598,174,772,45,817,1605,50.9%,37.26%,1
桃園市,中壢區,0624,632,102,734,14,748,1633,45.81%,38.7%,1
桃園市,中壢區,0625,789,162,951,63,1014,1795,56.49%,43.96%,1
桃園市,中壢區,0626,714,170,884,28,912,1689,54%,42.27%,1
桃園市,中壢區,0627,502,130,632,37,669,1201,55.7%,41.8%,1
桃園市,中壢區,0628,534,138,672,40,712,1353,52.62%,39.47%,1
桃園市,中壢區,0629,621,138,759,35,794,1587,50.03%,39.13%,1
桃園市,中壢區,0630,763,188,951,53,1004,1883,53.32%,40.52%,1
桃園市,中壢區,0631,571,145,716,24,740,1448,51.1%,39.43%,1
桃園市,中壢區,0632,718,186,904,42,946,1810,52.27%,39.67%,1
桃園市,中壢區,0633,722,188,910,70,980,1916,51.15%,37.68%,1
桃園市,中壢區,0634,541,97,638,31,669,1177,56.84%,45.96%,1
桃園市,中壢區,0635,628,157,785,47,832,1410,59.01%,44.54%,1
桃園市,中壢區,0636,553,143,696,16,712,1368,52.05%,40.42%,1
桃園市,中壢區,0637,672,131,803,43,846,1424,59.41%,47.19%,1
桃園市,中壢區,0638,673,168,841,35,876,1573,55.69%,42.78%,1
桃園市,中壢區,0639,492,126,618,27,645,1152,55.99%,42.71%,1
桃園市,中壢區,0640,497,115,612,23,635,1178,53.9%,42.19%,1
桃園市,中壢區,0641,728,201,929,60,989,1966,50.31%,37.03%,1
桃園市,中壢區,0642,535,138,673,32,705,3474,20.29%,15.4%,1
桃園市,中壢區,0643,904,165,1069,53,1122,2099,53.45%,43.07%,1
桃園市,中壢區,0644,497,111,608,43,651,1178,55.26%,42.19%,1
桃園市,中壢區,0645,644,151,795,62,857,1397,61.35%,46.1%,1
桃園市,中壢區,0646,687,191,878,44,922,1669,55.24%,41.16%,1
桃園市,中壢區,0647,793,184,977,49,1026,2087,49.16%,38%,1
桃園市,中壢區,0648,748,178,926,39,965,1900,50.79%,39.37%,1
桃園市,中壢區,0649,538,138,676,35,711,1640,43.35%,32.8%,1
桃園市,中壢區,0650,453,109,562,30,592,994,59.56%,45.57%,1
桃園市,中壢區,0651,574,106,680,49,729,1131,64.46%,50.75%,1
桃園市,中壢區,0652,731,181,912,42,954,1625,58.71%,44.98%,1
桃園市,中壢區,0653,622,201,823,38,861,1384,62.21%,44.94%,1
桃園市,中壢區,0654,643,159,802,53,855,1588,53.84%,40.49%,1
桃園市,中壢區,0655,621,123,744,36,780,1445,53.98%,42.98%,1
桃園市,中壢區,0656,615,138,753,42,795,1743,45.61%,35.28%,1
桃園市,中壢區,0657,682,142,824,33,857,1812,47.3%,37.64%,1
桃園市,中壢區,0658,612,122,734,54,788,1546,50.97%,39.59%,1
桃園市,中壢區,0659,505,137,642,44,686,1290,53.18%,39.15%,1
桃園市,中壢區,0660,813,144,957,87,1044,2145,48.67%,37.9%,1
桃園市,中壢區,0661,530,151,681,37,718,1451,49.48%,36.53%,1
桃園市,中壢區,0662,644,97,741,38,779,1489,52.32%,43.25%,1
桃園市,中壢區,0663,352,78,430,31,461,827,55.74%,42.56%,1
桃園市,中壢區,0664,578,129,707,38,745,1442,51.66%,40.08%,1
桃園市,中壢區,0665,690,152,842,26,868,1842,47.12%,37.46%,1
桃園市,中壢區,0666,560,110,670,32,702,1520,46.18%,36.84%,1
桃園市,中壢區,0667,640,141,781,40,821,1764,46.54%,36.28%,1
桃園市,中壢區,0668,673,127,800,26,826,1488,55.51%,45.23%,1
桃園市,中壢區,0669,631,168,799,47,846,1593,53.11%,39.61%,1
桃園市,中壢區,0670,604,168,772,31,803,1505,53.36%,40.13%,1
桃園市,中壢區,0671,677,141,818,33,851,1661,51.23%,40.76%,1
桃園市,中壢區,0672,666,122,788,26,814,1492,54.56%,44.64%,1
桃園市,中壢區,0673,455,138,593,24,617,1249,49.4%,36.43%,1
桃園市,中壢區,0674,554,118,672,30,702,1257,55.85%,44.07%,1
桃園市,中壢區,0675,627,163,790,73,863,1659,52.02%,37.79%,1
桃園市,中壢區,0676,762,181,943,46,989,1815,54.49%,41.98%,1
桃園市,中壢區,0677,653,161,814,42,856,1702,50.29%,38.37%,1
桃園市,中壢區,0678,761,25,786,20,806,1541,52.3%,49.38%,1
桃園市,中壢區,0679,654,116,770,48,818,1659,49.31%,39.42%,1
桃園市,中壢區,0680,728,147,875,81,956,1874,51.01%,38.85%,1
桃園市,中壢區,0681,652,107,759,45,804,1603,50.16%,40.67%,1
桃園市,中壢區,0682,667,169,836,40,876,1735,50.49%,38.44%,1
桃園市,中壢區,0683,727,151,878,23,901,1815,49.64%,40.06%,1
桃園市,中壢區,0684,600,150,750,33,783,1873,41.8%,32.03%,1
桃園市,中壢區,0685,772,140,912,55,967,1739,55.61%,44.39%,1
桃園市,中壢區,0686,648,150,798,41,839,1709,49.09%,37.92%,1
桃園市,中壢區,0687,708,170,878,34,912,1655,55.11%,42.78%,1
桃園市,中壢區,0688,735,108,843,37,880,1664,52.88%,44.17%,1
桃園市,中壢區,0689,391,109,500,18,518,1087,47.65%,35.97%,1
桃園市,中壢區,0690,434,115,549,51,600,1065,56.34%,40.75%,1
桃園市,中壢區,0691,718,206,924,71,995,1844,53.96%,38.94%,1
桃園市,中壢區,0692,420,107,527,52,579,1220,47.46%,34.43%,1
桃園市,中壢區,0693,490,129,619,34,653,1219,53.57%,40.2%,1
桃園市,中壢區,0694,471,173,644,48,692,1260,54.92%,37.38%,1
桃園市,中壢區,0695,684,178,862,65,927,1594,58.16%,42.91%,1
桃園市,中壢區,0696,675,184,859,78,937,1733,54.07%,38.95%,1
桃園市,中壢區,0697,825,160,985,51,1036,1979,52.35%,41.69%,1
桃園市,中壢區,0698,644,161,805,34,839,1621,51.76%,39.73%,1
桃園市,中壢區,0699,561,177,738,38,776,1391,55.79%,40.33%,1
桃園市,中壢區,0700,697,118,815,26,841,1531,54.93%,45.53%,1
桃園市,中壢區,0701,723,168,891,67,958,1943,49.31%,37.21%,1
桃園市,中壢區,0702,573,110,683,28,711,1363,52.16%,42.04%,1
桃園市,中壢區,0703,766,184,950,52,1002,2172,46.13%,35.27%,1
桃園市,中壢區,0704,704,130,834,45,879,1798,48.89%,39.15%,1
桃園市,中壢區,0705,662,137,799,25,824,1671,49.31%,39.62%,1
桃園市,中壢區,0706,750,162,912,60,972,1969,49.37%,38.09%,1
桃園市,中壢區,0707,779,51,830,45,875,1563,55.98%,49.84%,1
桃園市,中壢區,0708,749,172,921,53,974,1762,55.28%,42.51%,1
桃園市,中壢區,0709,623,142,765,48,813,1923,42.28%,32.4%,1
桃園市,中壢區,0710,680,156,836,56,892,1572,56.74%,43.26%,1
桃園市,中壢區,0711,810,167,977,36,1013,1850,54.76%,43.78%,1
桃園市,中壢區,0712,617,151,768,50,818,1583,51.67%,38.98%,1
桃園市,中壢區,0713,672,167,839,50,889,1735,51.24%,38.73%,1
桃園市,中壢區,0714,478,161,639,33,672,1292,52.01%,37%,1
桃園市,中壢區,0715,514,120,634,23,657,1265,51.94%,40.63%,1
桃園市,中壢區,0716,737,167,904,35,939,1798,52.22%,40.99%,1
桃園市,中壢區,0717,777,205,982,57,1039,1822,57.03%,42.65%,1
桃園市,中壢區,0718,665,160,825,25,850,1613,52.7%,41.23%,1
桃園市,中壢區,0719,581,136,717,41,758,1405,53.95%,41.35%,1
桃園市,中壢區,0720,677,224,901,70,971,1730,56.13%,39.13%,1
桃園市,中壢區,0721,653,165,818,30,848,1384,61.27%,47.18%,1
桃園市,中壢區,0722,475,132,607,21,628,1122,55.97%,42.34%,1
桃園市,中壢區,0723,439,121,560,44,604,992,60.89%,44.25%,1
桃園市,中壢區,0724,675,200,875,46,921,1820,50.6%,37.09%,1
桃園市,中壢區,0725,724,163,887,55,942,1847,51%,39.2%,1
桃園市,中壢區,0726,571,134,705,52,757,1302,58.14%,43.86%,1
桃園市,中壢區,0727,513,131,644,42,686,1203,57.02%,42.64%,1
桃園市,中壢區,0728,577,168,745,47,792,1226,64.6%,47.06%,1
桃園市,中壢區,0729,554,135,689,46,735,1234,59.56%,44.89%,1
桃園市,中壢區,0730,756,143,899,53,952,2023,47.06%,37.37%,1
桃園市,中壢區,0731,596,126,722,16,738,1555,47.46%,38.33%,1
桃園市,中壢區,0732,728,197,925,54,979,1951,50.18%,37.31%,1
桃園市,中壢區,0733,579,152,731,43,774,1383,55.97%,41.87%,1
桃園市,中壢區,0734,545,103,648,54,702,1164,60.31%,46.82%,1
桃園市,中壢區,0735,658,126,784,29,813,1482,54.86%,44.4%,1
桃園市,中壢區,0736,731,166,897,48,945,1770,53.39%,41.3%,1
桃園市,中壢區,0737,722,200,922,66,988,1703,58.02%,42.4%,1
桃園市,中壢區,0738,717,179,896,75,971,1841,52.74%,38.95%,1
桃園市,中壢區,0739,821,199,1020,41,1061,1941,54.66%,42.3%,1
桃園市,中壢區,0740,896,172,1068,44,1112,2029,54.81%,44.16%,1
桃園市,中壢區,0741,740,157,897,38,935,1636,57.15%,45.23%,1
桃園市,中壢區,0742,698,134,832,38,870,1528,56.94%,45.68%,1
桃園市,中壢區,0743,805,227,1032,76,1108,2289,48.41%,35.17%,1
桃園市,中壢區,0744,728,211,939,45,984,2020,48.71%,36.04%,1
桃園市,中壢區,0745,811,191,1002,46,1048,2027,51.7%,40.01%,1
桃園市,中壢區,0746,671,135,806,26,832,1883,44.18%,35.63%,1
桃園市,中壢區,0747,786,185,971,57,1028,2080,49.42%,37.79%,1
桃園市,中壢區,0748,240,73,313,17,330,646,51.08%,37.15%,1
桃園市,中壢區,0749,833,215,1048,58,1106,1780,62.13%,46.8%,1
桃園市,中壢區,0750,635,120,755,19,774,1372,56.41%,46.28%,1
桃園市,中壢區,0751,715,192,907,44,951,1668,57.01%,42.87%,1
桃園市,中壢區,0752,778,179,957,34,991,1987,49.87%,39.15%,1
桃園市,中壢區,0753,638,147,785,24,809,1520,53.22%,41.97%,1
桃園市,中壢區,0754,325,104,429,36,465,852,54.58%,38.15%,1
桃園市,中壢區,0755,498,133,631,33,664,1209,54.92%,41.19%,1
桃園市,中壢區,0756,565,151,716,84,800,1481,54.02%,38.15%,1
桃園市,中壢區,0757,604,112,716,22,738,1564,47.19%,38.62%,1
桃園市,中壢區,0758,784,225,1009,57,1066,1957,54.47%,40.06%,1
桃園市,中壢區,0759,530,154,684,53,737,1223,60.26%,43.34%,1
桃園市,中壢區,0760,487,139,626,43,669,1182,56.6%,41.2%,1
桃園市,中壢區,0761,443,142,585,45,630,1066,59.1%,41.56%,1
桃園市,中壢區,0762,742,168,910,58,968,1701,56.91%,43.62%,1
桃園市,中壢區,0763,359,96,455,44,499,943,52.92%,38.07%,1
桃園市,中壢區,0764,321,92,413,29,442,731,60.47%,43.91%,1
桃園市,中壢區,0765,334,103,437,50,487,851,57.23%,39.25%,1
桃園市,中壢區,0766,389,127,516,35,551,1011,54.5%,38.48%,1
桃園市,中壢區,0767,630,161,791,39,830,1532,54.18%,41.12%,1
桃園市,中壢區,0768,421,99,520,37,557,1028,54.18%,40.95%,1
桃園市,中壢區,0769,466,158,624,42,666,1157,57.56%,40.28%,1
桃園市,中壢區,0770,580,192,772,50,822,1591,51.67%,36.46%,1
桃園市,中壢區,0771,768,199,967,55,1022,2156,47.4%,35.62%,1
桃園市,中壢區,0772,510,150,660,25,685,1479,46.32%,34.48%,1
桃園市,中壢區,0773,731,155,886,44,930,1780,52.25%,41.07%,1
桃園市,中壢區,0774,639,193,832,58,890,1651,53.91%,38.7%,1
桃園市,中壢區,0775,756,203,959,41,1000,1870,53.48%,40.43%,1
桃園市,中壢區,0776,674,168,842,27,869,1913,45.43%,35.23%,1
桃園市,中壢區,0777,549,152,701,42,743,1609,46.18%,34.12%,1
桃園市,中壢區,0778,585,149,734,27,761,1539,49.45%,38.01%,1
桃園市,中壢區,0779,551,167,718,42,760,1426,53.3%,38.64%,1
桃園市,中壢區,0780,583,154,737,37,774,1618,47.84%,36.03%,1
桃園市,中壢區,0781,601,130,731,53,784,1441,54.41%,41.71%,1
桃園市,中壢區,0782,679,144,823,23,846,1528,55.37%,44.44%,1
桃園市,中壢區,0783,636,193,829,54,883,1683,52.47%,37.79%,1
桃園市,中壢區,0784,787,211,998,76,1074,1945,55.22%,40.46%,1
桃園市,中壢區,0785,577,158,735,63,798,1534,52.02%,37.61%,1
桃園市,中壢區,0786,653,192,845,77,922,1810,50.94%,36.08%,1
桃園市,中壢區,0787,386,124,510,52,562,1097,51.23%,35.19%,1
桃園市,中壢區,0788,727,188,915,20,935,1917,48.77%,37.92%,1
桃園市,中壢區,0789,708,193,901,51,952,1858,51.24%,38.11%,1
桃園市,中壢區,0790,651,158,809,38,847,1576,53.74%,41.31%,1
桃園市,中壢區,0791,624,163,787,43,830,1478,56.16%,42.22%,1
桃園市,中壢區,0792,621,180,801,39,840,1589,52.86%,39.08%,1
桃園市,中壢區,0793,761,249,1010,105,1115,2037,54.74%,37.36%,1
桃園市,中壢區,0794,524,135,659,40,699,1158,60.36%,45.25%,1
桃園市,中壢區,0795,787,203,990,72,1062,1967,53.99%,40.01%,1
桃園市,中壢區,0796,699,153,852,75,927,1830,50.66%,38.2%,1
桃園市,中壢區,0797,651,202,853,48,901,1856,48.55%,35.08%,1
桃園市,中壢區,0798,730,219,949,78,1027,2068,49.66%,35.3%,1
桃園市,中壢區,0799,675,163,838,53,891,2152,41.4%,31.37%,1
桃園市,中壢區,0800,723,184,907,53,960,2158,44.49%,33.5%,1
桃園市,大溪區,0522,549,207,756,68,824,1477,55.79%,37.17%,1
桃園市,大溪區,0523,372,123,495,48,543,1006,53.98%,36.98%,1
桃園市,大溪區,0524,563,171,734,81,815,1553,52.48%,36.25%,1
桃園市,大溪區,0525,614,184,798,76,874,1597,54.73%,38.45%,1
桃園市,大溪區,0526,493,168,661,66,727,1358,53.53%,36.3%,1
桃園市,大溪區,0527,526,170,696,55,751,1585,47.38%,33.19%,1
桃園市,大溪區,0528,606,187,793,43,836,1612,51.86%,37.59%,1
桃園市,大溪區,0529,506,164,670,35,705,1555,45.34%,32.54%,1
桃園市,大溪區,0530,558,169,727,43,770,1282,60.06%,43.53%,1
桃園市,大溪區,0531,536,136,672,60,732,1392,52.59%,38.51%,1
桃園市,大溪區,0532,478,184,662,57,719,1422,50.56%,33.61%,1
桃園市,大溪區,0533,535,181,716,72,788,1448,54.42%,36.95%,1
桃園市,大溪區,0534,539,179,718,57,775,1269,61.07%,42.47%,1
桃園市,大溪區,0535,334,175,509,82,591,977,60.49%,34.19%,1
桃園市,大溪區,0536,520,175,695,58,753,1359,55.41%,38.26%,1
桃園市,大溪區,0537,436,181,617,69,686,1135,60.44%,38.41%,1
桃園市,大溪區,0538,233,83,316,36,352,660,53.33%,35.3%,1
桃園市,大溪區,0539,351,133,484,38,522,1056,49.43%,33.24%,1
桃園市,大溪區,0540,479,115,594,58,652,1263,51.62%,37.93%,1
桃園市,大溪區,0541,255,96,351,45,396,717,55.23%,35.56%,1
桃園市,大溪區,0542,364,143,507,25,532,1299,40.95%,28.02%,1
桃園市,大溪區,0543,377,106,483,56,539,976,55.23%,38.63%,1
桃園市,大溪區,0544,348,103,451,52,503,938,53.62%,37.1%,1
桃園市,大溪區,0545,268,92,360,45,405,832,48.68%,32.21%,1
桃園市,大溪區,0546,291,69,360,25,385,866,44.46%,33.6%,1
桃園市,大溪區,0547,214,84,298,33,331,694,47.69%,30.84%,1
桃園市,大溪區,0548,451,169,620,42,662,1410,46.95%,31.99%,1
桃園市,大溪區,0549,450,130,580,66,646,1303,49.58%,34.54%,1
桃園市,大溪區,0550,424,112,536,53,589,1125,52.36%,37.69%,1
桃園市,大溪區,0551,494,104,598,36,634,1170,54.19%,42.22%,1
桃園市,大溪區,0552,549,168,717,45,762,1308,58.26%,41.97%,1
桃園市,大溪區,0553,422,132,554,65,619,1094,56.58%,38.57%,1
桃園市,大溪區,0554,825,261,1086,59,1145,2153,53.18%,38.32%,1
桃園市,大溪區,0555,540,91,631,46,677,1173,57.72%,46.04%,1
桃園市,大溪區,0556,544,129,673,28,701,1369,51.21%,39.74%,1
桃園市,大溪區,0557,556,125,681,64,745,1446,51.52%,38.45%,1
桃園市,大溪區,0558,483,90,573,53,626,1406,44.52%,34.35%,1
桃園市,大溪區,0559,674,150,824,35,859,1592,53.96%,42.34%,1
桃園市,大溪區,0560,607,174,781,72,853,1497,56.98%,40.55%,1
桃園市,大溪區,0561,602,198,800,86,886,1559,56.83%,38.61%,1
桃園市,大溪區,0562,653,148,801,24,825,1684,48.99%,38.78%,1
桃園市,大溪區,0563,819,91,910,66,976,1959,49.82%,41.81%,1
桃園市,大溪區,0564,552,154,706,73,779,1369,56.9%,40.32%,1
桃園市,大溪區,0565,590,141,731,66,797,1431,55.7%,41.23%,1
桃園市,大溪區,0566,492,129,621,32,653,1657,39.41%,29.69%,1
桃園市,大溪區,0567,426,139,565,28,593,1387,42.75%,30.71%,1
桃園市,大溪區,0568,410,109,519,50,569,1085,52.44%,37.79%,1
桃園市,大溪區,0569,577,164,741,54,795,1403,56.66%,41.13%,1
桃園市,大溪區,0570,524,178,702,82,784,1511,51.89%,34.68%,1
桃園市,大溪區,0571,507,202,709,88,797,1719,46.36%,29.49%,1
桃園市,大溪區,0572,535,164,699,94,793,1717,46.19%,31.16%,1
桃園市,大溪區,0573,433,141,574,76,650,1207,53.85%,35.87%,1
桃園市,大溪區,0574,473,127,600,72,672,1188,56.57%,39.81%,1
桃園市,大溪區,0575,516,159,675,33,708,1514,46.76%,34.08%,1
桃園市,大溪區,0576,634,145,779,75,854,1529,55.85%,41.47%,1
桃園市,大溪區,0577,545,154,699,43,742,1260,58.89%,43.25%,1
桃園市,大溪區,0578,360,92,452,19,471,831,56.68%,43.32%,1
桃園市,大溪區,0579,575,147,722,59,781,1407,55.51%,40.87%,1
桃園市,大溪區,0580,509,142,651,70,721,1494,48.26%,34.07%,1
桃園市,楊梅區,0926,514,139,653,55,708,1269,55.79%,40.5%,1
桃園市,楊梅區,0927,586,133,719,50,769,1246,61.72%,47.03%,1
桃園市,楊梅區,0928,653,125,778,40,818,1408,58.1%,46.38%,1
桃園市,楊梅區,0929,600,146,746,55,801,1434,55.86%,41.84%,1
桃園市,楊梅區,0930,604,107,711,55,766,1515,50.56%,39.87%,1
桃園市,楊梅區,0931,597,154,751,48,799,1657,48.22%,36.03%,1
桃園市,楊梅區,0932,498,113,611,34,645,1137,56.73%,43.8%,1
桃園市,楊梅區,0933,877,180,1057,43,1100,2211,49.75%,39.67%,1
桃園市,楊梅區,0934,772,187,959,35,994,2008,49.5%,38.45%,1
桃園市,楊梅區,0935,776,181,957,41,998,1911,52.22%,40.61%,1
桃園市,楊梅區,0936,587,161,748,67,815,1449,56.25%,40.51%,1
桃園市,楊梅區,0937,650,161,811,56,867,1877,46.19%,34.63%,1
桃園市,楊梅區,0938,739,165,904,47,951,1988,47.84%,37.17%,1
桃園市,楊梅區,0939,809,178,987,28,1015,1931,52.56%,41.9%,1
桃園市,楊梅區,0940,752,159,911,44,955,1938,49.28%,38.8%,1
桃園市,楊梅區,0941,718,135,853,28,881,1677,52.53%,42.81%,1
桃園市,楊梅區,0942,695,195,890,33,923,1848,49.95%,37.61%,1
桃園市,楊梅區,0943,748,169,917,32,949,1882,50.43%,39.74%,1
桃園市,楊梅區,0944,479,103,582,20,602,1541,39.07%,31.08%,1
桃園市,楊梅區,0945,731,160,891,44,935,1938,48.25%,37.72%,1
桃園市,楊梅區,0946,535,144,679,14,693,1562,44.37%,34.25%,1
桃園市,楊梅區,0947,883,245,1128,55,1183,2125,55.67%,41.55%,1
桃園市,楊梅區,0948,668,172,840,48,888,1516,58.58%,44.06%,1
桃園市,楊梅區,0949,683,180,863,29,892,1807,49.36%,37.8%,1
桃園市,楊梅區,0950,770,178,948,43,991,2101,47.17%,36.65%,1
桃園市,楊梅區,0951,819,187,1006,62,1068,2054,52%,39.87%,1
桃園市,楊梅區,0952,814,176,990,34,1024,2226,46%,36.57%,1
桃園市,楊梅區,0953,588,148,736,14,750,1405,53.38%,41.85%,1
桃園市,楊梅區,0954,660,165,825,47,872,1843,47.31%,35.81%,1
桃園市,楊梅區,0955,785,195,980,50,1030,2324,44.32%,33.78%,1
桃園市,楊梅區,0956,689,56,745,30,775,1713,45.24%,40.22%,1
桃園市,楊梅區,0957,718,159,877,60,937,1587,59.04%,45.24%,1
桃園市,楊梅區,0958,619,134,753,29,782,1416,55.23%,43.71%,1
桃園市,楊梅區,0959,674,157,831,40,871,1591,54.75%,42.36%,1
桃園市,楊梅區,0960,728,170,898,53,951,1943,48.94%,37.47%,1
桃園市,楊梅區,0961,703,151,854,35,889,1762,50.45%,39.9%,1
桃園市,楊梅區,0962,447,92,539,35,574,1083,53%,41.27%,1
桃園市,楊梅區,0963,795,187,982,65,1047,2027,51.65%,39.22%,1
桃園市,楊梅區,0964,523,142,665,62,727,1274,57.06%,41.05%,1
桃園市,楊梅區,0965,607,121,728,54,782,1359,57.54%,44.67%,1
桃園市,楊梅區,0966,652,167,819,52,871,2444,35.64%,26.68%,1
桃園市,楊梅區,0967,787,173,960,36,996,2298,43.34%,34.25%,1
桃園市,楊梅區,0968,835,198,1033,49,1082,2222,48.69%,37.58%,1
桃園市,楊梅區,0969,603,172,775,71,846,1610,52.55%,37.45%,1
桃園市,楊梅區,0970,602,169,771,94,865,1627,53.17%,37%,1
桃園市,楊梅區,0971,651,169,820,50,870,1589,54.75%,40.97%,1
桃園市,楊梅區,0972,676,184,860,78,938,1758,53.36%,38.45%,1
桃園市,楊梅區,0973,562,147,709,65,774,1776,43.58%,31.64%,1
桃園市,楊梅區,0974,377,83,460,23,483,1000,48.3%,37.7%,1
桃園市,楊梅區,0975,807,160,967,76,1043,2290,45.55%,35.24%,1
桃園市,楊梅區,0976,581,189,770,48,818,1551,52.74%,37.46%,1
桃園市,楊梅區,0977,669,167,836,82,918,1861,49.33%,35.95%,1
桃園市,楊梅區,0978,353,129,482,54,536,1141,46.98%,30.94%,1
桃園市,楊梅區,0979,654,153,807,54,861,1785,48.24%,36.64%,1
桃園市,楊梅區,0980,575,157,732,68,800,1498,53.4%,38.38%,1
桃園市,楊梅區,0981,435,139,574,49,623,1187,52.49%,36.65%,1
桃園市,楊梅區,0982,498,151,649,56,705,1270,55.51%,39.21%,1
桃園市,楊梅區,0983,572,133,705,43,748,1424,52.53%,40.17%,1
桃園市,楊梅區,0984,623,26,649,21,670,1273,52.63%,48.94%,1
桃園市,楊梅區,0985,479,176,655,30,685,1534,44.65%,31.23%,1
桃園市,楊梅區,0986,587,157,744,70,814,1783,45.65%,32.92%,1
桃園市,楊梅區,0987,644,145,789,23,812,1709,47.51%,37.68%,1
桃園市,楊梅區,0988,646,174,820,64,884,1920,46.04%,33.65%,1
桃園市,楊梅區,0989,486,109,595,31,626,1194,52.43%,40.7%,1
桃園市,楊梅區,0990,595,124,719,24,743,1408,52.77%,42.26%,1
桃園市,楊梅區,0991,578,158,736,34,770,1737,44.33%,33.28%,1
桃園市,楊梅區,0992,759,143,902,38,940,1920,48.96%,39.53%,1
桃園市,楊梅區,0993,461,154,615,34,649,1234,52.59%,37.36%,1
桃園市,楊梅區,0994,615,154,769,60,829,1491,55.6%,41.25%,1
桃園市,楊梅區,0995,729,168,897,45,942,2020,46.63%,36.09%,1
桃園市,楊梅區,0996,638,164,802,33,835,1863,44.82%,34.25%,1
桃園市,楊梅區,0997,663,162,825,64,889,1692,52.54%,39.18%,1
桃園市,楊梅區,0998,658,161,819,32,851,1686,50.47%,39.03%,1
桃園市,楊梅區,0999,670,156,826,62,888,1626,54.61%,41.21%,1
桃園市,楊梅區,1000,664,146,810,28,838,1557,53.82%,42.65%,1
桃園市,楊梅區,1001,691,183,874,55,929,1603,57.95%,43.11%,1
桃園市,楊梅區,1002,685,165,850,74,924,1889,48.91%,36.26%,1
桃園市,楊梅區,1003,630,136,766,31,797,1448,55.04%,43.51%,1
桃園市,楊梅區,1004,583,137,720,48,768,1351,56.85%,43.15%,1
桃園市,楊梅區,1005,549,142,691,70,761,1313,57.96%,41.81%,1
桃園市,楊梅區,1006,643,171,814,61,875,1689,51.81%,38.07%,1
桃園市,楊梅區,1007,723,191,914,44,958,2063,46.44%,35.05%,1
桃園市,蘆竹區,0396,458,151,609,94,703,1358,51.77%,33.73%,1
桃園市,蘆竹區,0397,493,192,685,88,773,1538,50.26%,32.05%,1
桃園市,蘆竹區,0398,628,189,817,70,887,2118,41.88%,29.65%,1
桃園市,蘆竹區,0399,677,182,859,69,928,1673,55.47%,40.47%,1
桃園市,蘆竹區,0400,597,149,746,34,780,1500,52%,39.8%,1
桃園市,蘆竹區,0401,677,176,853,54,907,1699,53.38%,39.85%,1
桃園市,蘆竹區,0402,891,188,1079,58,1137,2250,50.53%,39.6%,1
桃園市,蘆竹區,0403,806,200,1006,29,1035,2354,43.97%,34.24%,1
桃園市,蘆竹區,0404,492,126,618,32,650,1446,44.95%,34.02%,1
桃園市,蘆竹區,0405,527,166,693,62,755,1623,46.52%,32.47%,1
桃園市,蘆竹區,0406,628,155,783,37,820,1747,46.94%,35.95%,1
桃園市,蘆竹區,0407,720,226,946,73,1019,1988,51.26%,36.22%,1
桃園市,蘆竹區,0408,569,136,705,49,754,1437,52.47%,39.6%,1
桃園市,蘆竹區,0409,596,187,783,69,852,1532,55.61%,38.9%,1
桃園市,蘆竹區,0410,516,132,648,43,691,1447,47.75%,35.66%,1
桃園市,蘆竹區,0411,804,217,1021,66,1087,2189,49.66%,36.73%,1
桃園市,蘆竹區,0412,890,200,1090,64,1154,2498,46.2%,35.63%,1
桃園市,蘆竹區,0413,557,100,657,33,690,1322,52.19%,42.13%,1
桃園市,蘆竹區,0414,599,190,789,92,881,1991,44.25%,30.09%,1
桃園市,蘆竹區,0415,712,198,910,80,990,2097,47.21%,33.95%,1
桃園市,蘆竹區,0416,628,176,804,43,847,1558,54.36%,40.31%,1
桃園市,蘆竹區,0417,754,188,942,45,987,1891,52.19%,39.87%,1
桃園市,蘆竹區,0418,568,164,732,40,772,1590,48.55%,35.72%,1
桃園市,蘆竹區,0419,788,230,1018,56,1074,2404,44.68%,32.78%,1
桃園市,蘆竹區,0420,979,222,1201,48,1249,2522,49.52%,38.82%,1
桃園市,蘆竹區,0421,628,176,804,37,841,1633,51.5%,38.46%,1
桃園市,蘆竹區,0422,664,169,833,48,881,1715,51.37%,38.72%,1
桃園市,蘆竹區,0423,713,231,944,30,974,2215,43.97%,32.19%,1
桃園市,蘆竹區,0424,734,204,938,42,980,2029,48.3%,36.18%,1
桃園市,蘆竹區,0425,607,183,790,44,834,1731,48.18%,35.07%,1
桃園市,蘆竹區,0426,702,182,884,38,922,1820,50.66%,38.57%,1
桃園市,蘆竹區,0427,634,180,814,61,875,1633,53.58%,38.82%,1
桃園市,蘆竹區,0428,515,173,688,25,713,1668,42.75%,30.88%,1
桃園市,蘆竹區,0429,638,138,776,33,809,1493,54.19%,42.73%,1
桃園市,蘆竹區,0430,685,218,903,61,964,1864,51.72%,36.75%,1
桃園市,蘆竹區,0431,593,165,758,29,787,1703,46.21%,34.82%,1
桃園市,蘆竹區,0432,672,187,859,44,903,1893,47.7%,35.5%,1
桃園市,蘆竹區,0433,741,245,986,71,1057,1922,54.99%,38.55%,1
桃園市,蘆竹區,0434,553,147,700,40,740,1393,53.12%,39.7%,1
桃園市,蘆竹區,0435,521,171,692,42,734,1338,54.86%,38.94%,1
桃園市,蘆竹區,0436,667,153,820,35,855,1688,50.65%,39.51%,1
桃園市,蘆竹區,0437,516,180,696,57,753,1462,51.5%,35.29%,1
桃園市,蘆竹區,0438,442,132,574,31,605,1232,49.11%,35.88%,1
桃園市,蘆竹區,0439,483,116,599,45,644,1356,47.49%,35.62%,1
桃園市,蘆竹區,0440,543,117,660,51,711,1181,60.2%,45.98%,1
桃園市,蘆竹區,0441,473,113,586,22,608,1199,50.71%,39.45%,1
桃園市,蘆竹區,0442,691,198,889,27,916,1710,53.57%,40.41%,1
桃園市,蘆竹區,0443,552,130,682,41,723,1423,50.81%,38.79%,1
桃園市,蘆竹區,0444,592,179,771,44,815,1522,53.55%,38.9%,1
桃園市,蘆竹區,0445,647,193,840,34,874,1639,53.33%,39.48%,1
桃園市,蘆竹區,0446,769,205,974,52,1026,2055,49.93%,37.42%,1
桃園市,蘆竹區,0447,805,243,1048,38,1086,2178,49.86%,36.96%,1
桃園市,蘆竹區,0448,672,195,867,44,911,1709,53.31%,39.32%,1
桃園市,蘆竹區,0449,697,167,864,53,917,1667,55.01%,41.81%,1
桃園市,蘆竹區,0450,737,166,903,35,938,1745,53.75%,42.23%,1
桃園市,蘆竹區,0451,815,207,1022,48,1070,1967,54.4%,41.43%,1
桃園市,蘆竹區,0452,755,205,960,35,995,1802,55.22%,41.9%,1
桃園市,蘆竹區,0453,1006,253,1259,52,1311,2727,48.07%,36.89%,1
桃園市,蘆竹區,0454,649,176,825,38,863,1868,46.2%,34.74%,1
桃園市,蘆竹區,0455,567,172,739,39,778,1537,50.62%,36.89%,1
桃園市,蘆竹區,0456,605,201,806,38,844,1616,52.23%,37.44%,1
桃園市,蘆竹區,0457,619,183,802,54,856,1483,57.72%,41.74%,1
桃園市,蘆竹區,0458,647,150,797,50,847,1689,50.15%,38.31%,1
桃園市,蘆竹區,0459,395,109,504,56,560,1318,42.49%,29.97%,1
桃園市,蘆竹區,0460,503,159,662,95,757,1203,62.93%,41.81%,1
桃園市,蘆竹區,0461,603,168,771,30,801,1771,45.23%,34.05%,1
桃園市,蘆竹區,0462,531,203,734,95,829,1832,45.25%,28.98%,1
桃園市,蘆竹區,0463,587,206,793,100,893,1763,50.65%,33.3%,1
桃園市,蘆竹區,0464,526,53,579,20,599,1497,40.01%,35.14%,1
桃園市,蘆竹區,0465,671,196,867,121,988,1671,59.13%,40.16%,1
桃園市,蘆竹區,0466,341,112,453,80,533,929,57.37%,36.71%,1
桃園市,蘆竹區,0467,533,217,750,120,870,1559,55.81%,34.19%,1
桃園市,蘆竹區,0468,568,134,702,37,739,1497,49.37%,37.94%,1
桃園市,蘆竹區,0469,619,208,827,84,911,1441,63.22%,42.96%,1
桃園市,蘆竹區,0470,508,161,669,67,736,1465,50.24%,34.68%,1
桃園市,蘆竹區,0471,344,128,472,56,528,1029,51.31%,33.43%,1
桃園市,大園區,0472,497,152,649,55,704,1538,45.77%,32.31%,1
桃園市,大園區,0473,480,130,610,30,640,1616,39.6%,29.7%,1
桃園市,大園區,0474,580,172,752,56,808,1437,56.23%,40.36%,1
桃園市,大園區,0475,641,153,794,45,839,1554,53.99%,41.25%,1
桃園市,大園區,0476,459,137,596,46,642,1237,51.9%,37.11%,1
桃園市,大園區,0477,490,147,637,58,695,1347,51.6%,36.38%,1
桃園市,大園區,0478,456,124,580,30,610,1261,48.37%,36.16%,1
桃園市,大園區,0479,481,113,594,41,635,1256,50.56%,38.3%,1
桃園市,大園區,0480,470,121,591,31,622,1370,45.4%,34.31%,1
桃園市,大園區,0481,520,171,691,47,738,1610,45.84%,32.3%,1
桃園市,大園區,0482,494,160,654,52,706,1419,49.75%,34.81%,1
桃園市,大園區,0483,466,127,593,26,619,1588,38.98%,29.35%,1
桃園市,大園區,0484,594,158,752,50,802,1612,49.75%,36.85%,1
桃園市,大園區,0485,510,155,665,47,712,1440,49.44%,35.42%,1
桃園市,大園區,0486,438,157,595,49,644,1326,48.57%,33.03%,1
桃園市,大園區,0487,605,156,761,57,818,1455,56.22%,41.58%,1
桃園市,大園區,0488,611,166,777,60,837,1562,53.59%,39.12%,1
桃園市,大園區,0489,541,136,677,36,713,1284,55.53%,42.13%,1
桃園市,大園區,0490,525,142,667,20,687,1454,47.25%,36.11%,1
桃園市,大園區,0491,599,137,736,22,758,1490,50.87%,40.2%,1
桃園市,大園區,0492,516,151,667,47,714,1617,44.16%,31.91%,1
桃園市,大園區,0493,558,181,739,86,825,1594,51.76%,35.01%,1
桃園市,大園區,0494,614,172,786,58,844,1650,51.15%,37.21%,1
桃園市,大園區,0495,495,144,639,25,664,1467,45.26%,33.74%,1
桃園市,大園區,0496,540,163,703,37,740,1494,49.53%,36.14%,1
桃園市,大園區,0497,561,149,710,62,772,1538,50.2%,36.48%,1
桃園市,大園區,0498,506,140,646,27,673,1397,48.17%,36.22%,1
桃園市,大園區,0499,572,155,727,29,756,1637,46.18%,34.94%,1
桃園市,大園區,0500,498,143,641,58,699,1452,48.14%,34.3%,1
桃園市,大園區,0501,587,164,751,58,809,1414,57.21%,41.51%,1
桃園市,大園區,0502,588,166,754,49,803,1670,48.08%,35.21%,1
桃園市,大園區,0503,568,52,620,28,648,1701,38.1%,33.39%,1
桃園市,大園區,0504,542,156,698,39,737,1813,40.65%,29.9%,1
桃園市,大園區,0505,552,168,720,46,766,1687,45.41%,32.72%,1
桃園市,大園區,0506,652,148,800,16,816,1650,49.45%,39.52%,1
桃園市,大園區,0507,649,166,815,49,864,1556,55.53%,41.71%,1
桃園市,大園區,0508,575,192,767,44,811,1844,43.98%,31.18%,1
桃園市,大園區,0509,451,142,593,60,653,1336,48.88%,33.76%,1
桃園市,大園區,0510,521,199,720,64,784,1414,55.45%,36.85%,1
桃園市,大園區,0511,529,145,674,62,736,1238,59.45%,42.73%,1
桃園市,大園區,0512,518,166,684,57,741,1227,60.39%,42.22%,1
桃園市,大園區,0513,414,134,548,29,577,1199,48.12%,34.53%,1
桃園市,大園區,0514,424,153,577,26,603,1349,44.7%,31.43%,1
桃園市,大園區,0515,414,112,526,29,555,1120,49.55%,36.96%,1
桃園市,大園區,0516,398,120,518,28,546,1080,50.56%,36.85%,1
桃園市,大園區,0517,475,136,611,46,657,1341,48.99%,35.42%,1
桃園市,大園區,0518,502,168,670,41,711,1345,52.86%,37.32%,1
桃園市,大園區,0519,518,139,657,48,705,1565,45.05%,33.1%,1
桃園市,大園區,0520,504,130,634,23,657,1519,43.25%,33.18%,1
桃園市,大園區,0521,726,200,926,59,985,2130,46.24%,34.08%,1
桃園市,龜山區,0217,390,65,455,27,482,874,55.15%,44.62%,1
桃園市,龜山區,0218,825,170,995,79,1074,2014,53.33%,40.96%,1
桃園市,龜山區,0219,796,204,1000,35,1035,2145,48.25%,37.11%,1
桃園市,龜山區,0220,785,106,891,58,949,1744,54.42%,45.01%,1
桃園市,龜山區,0221,770,154,924,58,982,1885,52.1%,40.85%,1
桃園市,龜山區,0222,524,162,686,66,752,1546,48.64%,33.89%,1
桃園市,龜山區,0223,592,173,765,71,836,1684,49.64%,35.15%,1
桃園市,龜山區,0224,469,151,620,44,664,1477,44.96%,31.75%,1
桃園市,龜山區,0225,664,135,799,58,857,1528,56.09%,43.46%,1
桃園市,龜山區,0226,215,61,276,15,291,1428,20.38%,15.06%,1
桃園市,龜山區,0227,609,169,778,62,840,1525,55.08%,39.93%,1
桃園市,龜山區,0228,413,138,551,59,610,1041,58.6%,39.67%,1
桃園市,龜山區,0229,496,150,646,36,682,1404,48.58%,35.33%,1
桃園市,龜山區,0230,590,163,753,58,811,1478,54.87%,39.92%,1
桃園市,龜山區,0231,812,232,1044,64,1108,2178,50.87%,37.28%,1
桃園市,龜山區,0232,611,211,822,72,894,1672,53.47%,36.54%,1
桃園市,龜山區,0233,520,119,639,42,681,1376,49.49%,37.79%,1
桃園市,龜山區,0234,519,182,701,49,750,1480,50.68%,35.07%,1
桃園市,龜山區,0235,505,146,651,40,691,1258,54.93%,40.14%,1
桃園市,龜山區,0236,569,146,715,23,738,1464,50.41%,38.87%,1
桃園市,龜山區,0237,625,202,827,95,922,1844,50%,33.89%,1
桃園市,龜山區,0238,460,118,578,26,604,1169,51.67%,39.35%,1
桃園市,龜山區,0239,546,155,701,34,735,1921,38.26%,28.42%,1
桃園市,龜山區,0240,576,190,766,30,796,1694,46.99%,34%,1
桃園市,龜山區,0241,703,211,914,67,981,1771,55.39%,39.7%,1
桃園市,龜山區,0242,546,182,728,61,789,1665,47.39%,32.79%,1
桃園市,龜山區,0243,481,166,647,87,734,1439,51.01%,33.43%,1
桃園市,龜山區,0244,546,158,704,70,774,1728,44.79%,31.6%,1
桃園市,龜山區,0245,722,168,890,36,926,1788,51.79%,40.38%,1
桃園市,龜山區,0246,498,146,644,52,696,1465,47.51%,33.99%,1
桃園市,龜山區,0247,509,144,653,37,690,1659,41.59%,30.68%,1
桃園市,龜山區,0248,538,153,691,34,725,1693,42.82%,31.78%,1
桃園市,龜山區,0249,512,140,652,26,678,1818,37.29%,28.16%,1
桃園市,龜山區,0250,626,189,815,69,884,1752,50.46%,35.73%,1
桃園市,龜山區,0251,601,244,845,41,886,1818,48.73%,33.06%,1
桃園市,龜山區,0252,549,160,709,23,732,1499,48.83%,36.62%,1
桃園市,龜山區,0253,714,187,901,53,954,1916,49.79%,37.27%,1
桃園市,龜山區,0254,593,210,803,61,864,1804,47.89%,32.87%,1
桃園市,龜山區,0255,720,236,956,36,992,2127,46.64%,33.85%,1
桃園市,龜山區,0256,351,134,485,49,534,1005,53.13%,34.93%,1
桃園市,龜山區,0257,578,162,740,39,779,1449,53.76%,39.89%,1
桃園市,龜山區,0258,481,177,658,61,719,1498,48%,32.11%,1
桃園市,龜山區,0259,666,234,900,55,955,2149,44.44%,30.99%,1
桃園市,龜山區,0260,487,137,624,30,654,1771,36.93%,27.5%,1
桃園市,龜山區,0261,299,95,394,34,428,841,50.89%,35.55%,1
桃園市,龜山區,0262,716,234,950,96,1046,2284,45.8%,31.35%,1
桃園市,龜山區,0263,441,134,575,65,640,1228,52.12%,35.91%,1
桃園市,龜山區,0264,574,150,724,56,780,1979,39.41%,29%,1
桃園市,龜山區,0265,433,146,579,40,619,1378,44.92%,31.42%,1
桃園市,龜山區,0266,365,119,484,49,533,1061,50.24%,34.4%,1
桃園市,龜山區,0267,666,175,841,62,903,1917,47.1%,34.74%,1
桃園市,龜山區,0268,674,188,862,42,904,1540,58.7%,43.77%,1
桃園市,龜山區,0269,627,119,746,28,774,1433,54.01%,43.75%,1
桃園市,龜山區,0270,515,189,704,22,726,1455,49.9%,35.4%,1
桃園市,龜山區,0271,876,269,1145,71,1216,2280,53.33%,38.42%,1
桃園市,龜山區,0272,594,204,798,43,841,1668,50.42%,35.61%,1
桃園市,龜山區,0273,656,185,841,43,884,1885,46.9%,34.8%,1
桃園市,龜山區,0274,682,186,868,28,896,1849,48.46%,36.88%,1
桃園市,龜山區,0275,654,258,912,30,942,1704,55.28%,38.38%,1
桃園市,龜山區,0276,427,154,581,36,617,1156,53.37%,36.94%,1
桃園市,龜山區,0277,620,200,820,64,884,2114,41.82%,29.33%,1
桃園市,龜山區,0278,597,187,784,35,819,1943,42.15%,30.73%,1
桃園市,龜山區,0279,610,198,808,26,834,1800,46.33%,33.89%,1
桃園市,龜山區,0280,691,225,916,53,969,2020,47.97%,34.21%,1
桃園市,龜山區,0281,530,164,694,35,729,1319,55.27%,40.18%,1
桃園市,龜山區,0282,856,265,1121,43,1164,2229,52.22%,38.4%,1
桃園市,龜山區,0283,718,189,907,31,938,1992,47.09%,36.04%,1
桃園市,龜山區,0284,787,206,993,59,1052,2237,47.03%,35.18%,1
桃園市,龜山區,0285,805,192,997,31,1028,2133,48.2%,37.74%,1
桃園市,龜山區,0286,773,267,1040,65,1105,2187,50.53%,35.35%,1
桃園市,龜山區,0287,701,205,906,47,953,1959,48.65%,35.78%,1
桃園市,龜山區,0288,623,204,827,41,868,1910,45.45%,32.62%,1
桃園市,龜山區,0289,653,221,874,105,979,1840,53.21%,35.49%,1
桃園市,龜山區,0290,852,228,1080,51,1131,2266,49.91%,37.6%,1
桃園市,龜山區,0291,864,166,1030,29,1059,2387,44.37%,36.2%,1
桃園市,龜山區,0292,596,153,749,36,785,1692,46.39%,35.22%,1
桃園市,龜山區,0293,348,98,446,14,460,904,50.88%,38.5%,1
桃園市,龜山區,0294,606,146,752,30,782,1469,53.23%,41.25%,1
桃園市,八德區,0295,582,173,755,74,829,1761,47.08%,33.05%,1
桃園市,八德區,0296,643,62,705,17,722,1804,40.02%,35.64%,1
桃園市,八德區,0297,362,112,474,36,510,1813,28.13%,19.97%,1
桃園市,八德區,0298,618,150,768,37,805,1784,45.12%,34.64%,1
桃園市,八德區,0299,741,165,906,43,949,2257,42.05%,32.83%,1
桃園市,八德區,0300,575,135,710,37,747,1857,40.23%,30.96%,1
桃園市,八德區,0301,761,192,953,42,995,2261,44.01%,33.66%,1
桃園市,八德區,0302,738,194,932,54,986,1903,51.81%,38.78%,1
桃園市,八德區,0303,734,197,931,46,977,1955,49.97%,37.54%,1
桃園市,八德區,0304,553,140,693,11,704,1665,42.28%,33.21%,1
桃園市,八德區,0305,550,170,720,61,781,1431,54.58%,38.43%,1
桃園市,八德區,0306,511,137,648,37,685,1263,54.24%,40.46%,1
桃園市,八德區,0307,643,168,811,71,882,1583,55.72%,40.62%,1
桃園市,八德區,0308,523,126,649,35,684,1246,54.9%,41.97%,1
桃園市,八德區,0309,547,142,689,32,721,1356,53.17%,40.34%,1
桃園市,八德區,0310,655,175,830,74,904,1630,55.46%,40.18%,1
桃園市,八德區,0311,558,120,678,42,720,1586,45.4%,35.18%,1
桃園市,八德區,0312,608,165,773,88,861,1649,52.21%,36.87%,1
桃園市,八德區,0313,643,161,804,87,891,1910,46.65%,33.66%,1
桃園市,八德區,0314,637,167,804,88,892,1612,55.33%,39.52%,1
桃園市,八德區,0315,660,140,800,47,847,1640,51.65%,40.24%,1
桃園市,八德區,0316,476,149,625,38,663,1303,50.88%,36.53%,1
桃園市,八德區,0317,599,149,748,61,809,1413,57.25%,42.39%,1
桃園市,八德區,0318,644,167,811,55,866,1711,50.61%,37.64%,1
桃園市,八德區,0319,614,136,750,83,833,1562,53.33%,39.31%,1
桃園市,八德區,0320,693,137,830,52,882,1735,50.84%,39.94%,1
桃園市,八德區,0321,643,156,799,45,844,1658,50.9%,38.78%,1
桃園市,八德區,0322,445,118,563,49,612,1022,59.88%,43.54%,1
桃園市,八德區,0323,562,149,711,54,765,1673,45.73%,33.59%,1
桃園市,八德區,0324,648,150,798,37,835,1741,47.96%,37.22%,1
桃園市,八德區,0325,799,189,988,78,1066,2110,50.52%,37.87%,1
桃園市,八德區,0326,480,97,577,27,604,1145,52.75%,41.92%,1
桃園市,八德區,0327,458,105,563,37,600,1010,59.41%,45.35%,1
桃園市,八德區,0328,610,157,767,27,794,1848,42.97%,33.01%,1
桃園市,八德區,0329,543,123,666,52,718,1334,53.82%,40.7%,1
桃園市,八德區,0330,449,107,556,27,583,1349,43.22%,33.28%,1
桃園市,八德區,0331,569,150,719,42,761,1341,56.75%,42.43%,1
桃園市,八德區,0332,504,122,626,55,681,1178,57.81%,42.78%,1
桃園市,八德區,0333,541,154,695,50,745,1374,54.22%,39.37%,1
桃園市,八德區,0334,490,173,663,72,735,1462,50.27%,33.52%,1
桃園市,八德區,0335,596,176,772,71,843,1943,43.39%,30.67%,1
桃園市,八德區,0336,528,161,689,73,762,1928,39.52%,27.39%,1
桃園市,八德區,0337,463,155,618,32,650,1403,46.33%,33%,1
桃園市,八德區,0338,580,159,739,63,802,1672,47.97%,34.69%,1
桃園市,八德區,0339,636,202,838,53,891,1947,45.76%,32.67%,1
桃園市,八德區,0340,491,121,612,45,657,1200,54.75%,40.92%,1
桃園市,八德區,0341,628,188,816,76,892,1895,47.07%,33.14%,1
桃園市,八德區,0342,646,203,849,66,915,1988,46.03%,32.49%,1
桃園市,八德區,0343,737,220,957,83,1040,2006,51.84%,36.74%,1
桃園市,八德區,0344,696,187,883,13,896,2061,43.47%,33.77%,1
桃園市,八德區,0345,682,211,893,72,965,2108,45.78%,32.35%,1
桃園市,八德區,0346,671,165,836,51,887,1862,47.64%,36.04%,1
桃園市,八德區,0347,641,143,784,35,819,1681,48.72%,38.13%,1
桃園市,八德區,0348,493,157,650,60,710,1317,53.91%,37.43%,1
桃園市,八德區,0349,872,222,1094,68,1162,2093,55.52%,41.66%,1
桃園市,八德區,0350,605,184,789,63,852,1499,56.84%,40.36%,1
桃園市,八德區,0351,677,180,857,52,909,1782,51.01%,37.99%,1
桃園市,八德區,0352,683,180,863,31,894,1763,50.71%,38.74%,1
桃園市,八德區,0353,474,149,623,58,681,1226,55.55%,38.66%,1
桃園市,八德區,0354,547,135,682,40,722,1311,55.07%,41.72%,1
桃園市,八德區,0355,500,123,623,38,661,1170,56.5%,42.74%,1
桃園市,八德區,0356,561,114,675,37,712,1313,54.23%,42.73%,1
桃園市,八德區,0357,510,111,621,28,649,1186,54.72%,43%,1
桃園市,八德區,0358,539,134,673,48,721,1481,48.68%,36.39%,1
桃園市,八德區,0359,765,193,958,62,1020,1998,51.05%,38.29%,1
桃園市,八德區,0360,385,94,479,31,510,916,55.68%,42.03%,1
桃園市,八德區,0361,705,169,874,55,929,1943,47.81%,36.28%,1
桃園市,八德區,0362,818,135,953,42,995,2076,47.93%,39.4%,1
桃園市,八德區,0363,525,145,670,59,729,1363,53.48%,38.52%,1
桃園市,八德區,0364,579,158,737,52,789,1491,52.92%,38.83%,1
桃園市,八德區,0365,555,157,712,71,783,1474,53.12%,37.65%,1
桃園市,八德區,0366,133,31,164,10,174,718,24.23%,18.52%,1
桃園市,八德區,0367,519,166,685,50,735,1386,53.03%,37.45%,1
桃園市,八德區,0368,574,129,703,71,774,1487,52.05%,38.6%,1
桃園市,八德區,0369,604,126,730,82,812,1552,52.32%,38.92%,1
桃園市,八德區,0370,446,98,544,71,615,1255,49%,35.54%,1
桃園市,八德區,0371,628,151,779,58,837,1505,55.61%,41.73%,1
桃園市,八德區,0372,487,149,636,65,701,1436,48.82%,33.91%,1
桃園市,八德區,0373,617,191,808,70,878,1618,54.26%,38.13%,1
桃園市,八德區,0374,637,146,783,72,855,1685,50.74%,37.8%,1
桃園市,八德區,0375,629,158,787,54,841,1835,45.83%,34.28%,1
桃園市,八德區,0376,698,172,870,74,944,1881,50.19%,37.11%,1
桃園市,八德區,0377,630,158,788,46,834,1766,47.23%,35.67%,1
桃園市,八德區,0378,639,192,831,87,918,1817,50.52%,35.17%,1
桃園市,八德區,0379,923,174,1097,34,1131,2198,51.46%,41.99%,1
桃園市,八德區,0380,691,160,851,44,895,1732,51.67%,39.9%,1
桃園市,八德區,0381,840,197,1037,40,1077,2089,51.56%,40.21%,1
桃園市,八德區,0382,504,135,639,37,676,1257,53.78%,40.1%,1
桃園市,八德區,0383,464,135,599,56,655,1267,51.7%,36.62%,1
桃園市,八德區,0384,634,111,745,22,767,1427,53.75%,44.43%,1
桃園市,八德區,0385,718,199,917,53,970,1685,57.57%,42.61%,1
桃園市,八德區,0386,688,196,884,60,944,1748,54%,39.36%,1
桃園市,八德區,0387,906,167,1073,52,1125,1650,68.18%,54.91%,1
桃園市,八德區,0388,579,154,733,54,787,1478,53.25%,39.17%,1
桃園市,八德區,0389,657,155,812,53,865,1607,53.83%,40.88%,1
桃園市,八德區,0390,710,190,900,118,1018,1841,55.3%,38.57%,1
桃園市,八德區,0391,785,267,1052,13,1065,2082,51.15%,37.7%,1
桃園市,八德區,0392,641,192,833,66,899,1959,45.89%,32.72%,1
桃園市,八德區,0393,849,222,1071,57,1128,2209,51.06%,38.43%,1
桃園市,八德區,0394,774,150,924,50,974,1864,52.25%,41.52%,1
桃園市,八德區,0395,710,194,904,68,972,2000,48.6%,35.5%,1
桃園市,龍潭區,1008,564,145,709,29,738,1482,49.8%,38.06%,1
桃園市,龍潭區,1009,600,132,732,39,771,1528,50.46%,39.27%,1
桃園市,龍潭區,1010,586,150,736,41,777,1503,51.7%,38.99%,1
桃園市,龍潭區,1011,562,180,742,52,794,1568,50.64%,35.84%,1
桃園市,龍潭區,1012,463,112,575,55,630,1216,51.81%,38.08%,1
桃園市,龍潭區,1013,700,182,882,67,949,2088,45.45%,33.52%,1
桃園市,龍潭區,1014,831,195,1026,86,1112,1987,55.96%,41.82%,1
桃園市,龍潭區,1015,692,173,865,43,908,1586,57.25%,43.63%,1
桃園市,龍潭區,1016,427,147,574,44,618,1221,50.61%,34.97%,1
桃園市,龍潭區,1017,476,121,597,46,643,1134,56.7%,41.98%,1
桃園市,龍潭區,1018,731,192,923,56,979,2081,47.04%,35.13%,1
桃園市,龍潭區,1019,673,170,843,43,886,1925,46.03%,34.96%,1
桃園市,龍潭區,1020,907,176,1083,40,1123,2095,53.6%,43.29%,1
桃園市,龍潭區,1021,941,166,1107,49,1156,2040,56.67%,46.13%,1
桃園市,龍潭區,1022,615,207,822,58,880,1790,49.16%,34.36%,1
桃園市,龍潭區,1023,702,218,920,100,1020,1872,54.49%,37.5%,1
桃園市,龍潭區,1024,704,194,898,74,972,1726,56.32%,40.79%,1
桃園市,龍潭區,1025,709,192,901,67,968,1792,54.02%,39.56%,1
桃園市,龍潭區,1026,576,127,703,32,735,1398,52.58%,41.2%,1
桃園市,龍潭區,1027,487,145,632,34,666,1345,49.52%,36.21%,1
桃園市,龍潭區,1028,575,147,722,48,770,1409,54.65%,40.81%,1
桃園市,龍潭區,1029,482,122,604,35,639,1362,46.92%,35.39%,1
桃園市,龍潭區,1030,672,210,882,53,935,1650,56.67%,40.73%,1
桃園市,龍潭區,1031,605,173,778,51,829,1597,51.91%,37.88%,1
桃園市,龍潭區,1032,548,165,713,13,726,1410,51.49%,38.87%,1
桃園市,龍潭區,1033,533,131,664,53,717,1275,56.24%,41.8%,1
桃園市,龍潭區,1034,822,206,1028,65,1093,1909,57.26%,43.06%,1
桃園市,龍潭區,1035,878,178,1056,33,1089,2024,53.8%,43.38%,1
桃園市,龍潭區,1036,832,201,1033,45,1078,2002,53.85%,41.56%,1
桃園市,龍潭區,1037,773,180,953,54,1007,1786,56.38%,43.28%,1
桃園市,龍潭區,1038,726,179,905,41,946,1756,53.87%,41.34%,1
桃園市,龍潭區,1039,808,155,963,34,997,1830,54.48%,44.15%,1
桃園市,龍潭區,1040,808,158,966,32,998,1697,58.81%,47.61%,1
桃園市,龍潭區,1041,660,127,787,43,830,1519,54.64%,43.45%,1
桃園市,龍潭區,1042,693,150,843,36,879,1805,48.7%,38.39%,1
桃園市,龍潭區,1043,646,135,781,31,812,1792,45.31%,36.05%,1
桃園市,龍潭區,1044,637,171,808,67,875,1500,58.33%,42.47%,1
桃園市,龍潭區,1045,529,136,665,29,694,1427,48.63%,37.07%,1
桃園市,龍潭區,1046,468,136,604,46,650,1444,45.01%,32.41%,1
桃園市,龍潭區,1047,496,127,623,48,671,1321,50.79%,37.55%,1
桃園市,龍潭區,1048,569,128,697,30,727,1215,59.84%,46.83%,1
桃園市,龍潭區,1049,511,133,644,50,694,1297,53.51%,39.4%,1
桃園市,龍潭區,1050,526,118,644,18,662,1407,47.05%,37.38%,1
桃園市,龍潭區,1051,573,151,724,45,769,1564,49.17%,36.64%,1
桃園市,龍潭區,1052,494,139,633,64,697,1317,52.92%,37.51%,1
桃園市,龍潭區,1053,374,87,461,47,508,1023,49.66%,36.56%,1
桃園市,龍潭區,1054,683,190,873,47,920,1721,53.46%,39.69%,1
桃園市,龍潭區,1055,762,147,909,69,978,1764,55.44%,43.2%,1
桃園市,龍潭區,1056,580,160,740,65,805,1499,53.7%,38.69%,1
桃園市,龍潭區,1057,774,180,954,47,1001,2151,46.54%,35.98%,1
桃園市,龍潭區,1058,667,150,817,31,848,1524,55.64%,43.77%,1
桃園市,龍潭區,1059,670,165,835,26,861,1456,59.13%,46.02%,1
桃園市,龍潭區,1060,915,148,1063,39,1102,1847,59.66%,49.54%,1
桃園市,龍潭區,1061,903,179,1082,43,1125,1899,59.24%,47.55%,1
桃園市,龍潭區,1062,849,45,894,36,930,1725,53.91%,49.22%,1
桃園市,龍潭區,1063,784,177,961,51,1012,1665,60.78%,47.09%,1
桃園市,龍潭區,1064,620,156,776,38,814,1649,49.36%,37.6%,1
桃園市,龍潭區,1065,565,118,683,51,734,1539,47.69%,36.71%,1
桃園市,龍潭區,1066,645,181,826,54,880,1541,57.11%,41.86%,1
桃園市,龍潭區,1067,534,162,696,53,749,1375,54.47%,38.84%,1
桃園市,龍潭區,1068,604,147,751,31,782,1453,53.82%,41.57%,1
桃園市,龍潭區,1069,437,130,567,43,610,1074,56.8%,40.69%,1
桃園市,龍潭區,1070,593,135,728,22,750,1299,57.74%,45.65%,1
桃園市,龍潭區,1071,223,67,290,29,319,678,47.05%,32.89%,1
桃園市,平鎮區,0801,521,157,678,45,723,1487,48.62%,35.04%,1
桃園市,平鎮區,0802,575,136,711,50,761,1453,52.37%,39.57%,1
桃園市,平鎮區,0803,156,601,757,50,807,1491,54.12%,10.46%,1
桃園市,平鎮區,0804,486,157,643,57,700,1346,52.01%,36.11%,1
桃園市,平鎮區,0805,652,151,803,35,838,1660,50.48%,39.28%,1
桃園市,平鎮區,0806,677,165,842,39,881,1921,45.86%,35.24%,1
桃園市,平鎮區,0807,847,169,1016,52,1068,1974,54.1%,42.91%,1
桃園市,平鎮區,0808,726,170,896,37,933,1867,49.97%,38.89%,1
桃園市,平鎮區,0809,754,124,878,40,918,1786,51.4%,42.22%,1
桃園市,平鎮區,0810,529,127,656,29,685,1634,41.92%,32.37%,1
桃園市,平鎮區,0811,458,103,561,21,582,1080,53.89%,42.41%,1
桃園市,平鎮區,0812,616,153,769,28,797,1514,52.64%,40.69%,1
桃園市,平鎮區,0813,653,153,806,79,885,1918,46.14%,34.05%,1
桃園市,平鎮區,0814,445,141,586,73,659,1182,55.75%,37.65%,1
桃園市,平鎮區,0815,615,150,765,39,804,1667,48.23%,36.89%,1
桃園市,平鎮區,0816,606,135,741,33,774,1640,47.2%,36.95%,1
桃園市,平鎮區,0817,637,149,786,34,820,1603,51.15%,39.74%,1
桃園市,平鎮區,0818,703,137,840,13,853,1556,54.82%,45.18%,1
桃園市,平鎮區,0819,659,134,793,37,830,1697,48.91%,38.83%,1
桃園市,平鎮區,0820,420,84,504,21,525,1130,46.46%,37.17%,1
桃園市,平鎮區,0821,490,94,584,43,627,1196,52.42%,40.97%,1
桃園市,平鎮區,0822,678,141,819,53,872,1685,51.75%,40.24%,1
桃園市,平鎮區,0823,682,152,834,44,878,1532,57.31%,44.52%,1
桃園市,平鎮區,0824,594,148,742,41,783,1564,50.06%,37.98%,1
桃園市,平鎮區,0825,622,113,735,24,759,1824,41.61%,34.1%,1
桃園市,平鎮區,0826,717,166,883,25,908,1912,47.49%,37.5%,1
桃園市,平鎮區,0827,403,109,512,49,561,1048,53.53%,38.45%,1
桃園市,平鎮區,0828,527,126,653,55,708,1259,56.24%,41.86%,1
桃園市,平鎮區,0829,422,103,525,22,547,1061,51.56%,39.77%,1
桃園市,平鎮區,0830,494,104,598,36,634,1072,59.14%,46.08%,1
桃園市,平鎮區,0831,689,153,842,53,895,1788,50.06%,38.53%,1
桃園市,平鎮區,0832,619,137,756,39,795,1510,52.65%,40.99%,1
桃園市,平鎮區,0833,552,139,691,48,739,1403,52.67%,39.34%,1
桃園市,平鎮區,0834,561,156,717,50,767,1407,54.51%,39.87%,1
桃園市,平鎮區,0835,773,183,956,60,1016,1901,53.45%,40.66%,1
桃園市,平鎮區,0836,739,149,888,35,923,1994,46.29%,37.06%,1
桃園市,平鎮區,0837,676,182,858,9,867,1730,50.12%,39.08%,1
桃園市,平鎮區,0838,781,174,955,50,1005,1905,52.76%,41%,1
桃園市,平鎮區,0839,728,173,901,30,931,1723,54.03%,42.25%,1
桃園市,平鎮區,0840,533,128,661,49,710,1307,54.32%,40.78%,1
桃園市,平鎮區,0841,545,140,685,49,734,1337,54.9%,40.76%,1
桃園市,平鎮區,0842,486,113,599,36,635,980,64.8%,49.59%,1
桃園市,平鎮區,0843,715,166,881,53,934,1818,51.38%,39.33%,1
桃園市,平鎮區,0844,593,164,757,46,803,1463,54.89%,40.53%,1
桃園市,平鎮區,0845,555,126,681,25,706,1213,58.2%,45.75%,1
桃園市,平鎮區,0846,449,116,565,51,616,1085,56.77%,41.38%,1
桃園市,平鎮區,0847,547,135,682,34,716,1458,49.11%,37.52%,1
桃園市,平鎮區,0848,555,167,722,51,773,1408,54.9%,39.42%,1
桃園市,平鎮區,0849,504,164,668,51,719,1396,51.5%,36.1%,1
桃園市,平鎮區,0850,507,133,640,29,669,1044,64.08%,48.56%,1
桃園市,平鎮區,0851,482,114,596,15,611,1124,54.36%,42.88%,1
桃園市,平鎮區,0852,643,148,791,27,818,1517,53.92%,42.39%,1
桃園市,平鎮區,0853,619,172,791,24,815,1571,51.88%,39.4%,1
桃園市,平鎮區,0854,770,170,940,32,972,1752,55.48%,43.95%,1
桃園市,平鎮區,0855,671,154,825,30,855,1434,59.62%,46.79%,1
桃園市,平鎮區,0856,754,183,937,44,981,1710,57.37%,44.09%,1
桃園市,平鎮區,0857,663,159,822,33,855,1555,54.98%,42.64%,1
桃園市,平鎮區,0858,726,193,919,42,961,2051,46.86%,35.4%,1
桃園市,平鎮區,0859,592,167,759,28,787,1477,53.28%,40.08%,1
桃園市,平鎮區,0860,610,146,756,22,778,1501,51.83%,40.64%,1
桃園市,平鎮區,0861,569,147,716,58,774,1405,55.09%,40.5%,1
桃園市,平鎮區,0862,634,177,811,68,879,1656,53.08%,38.29%,1
桃園市,平鎮區,0863,694,161,855,33,888,1921,46.23%,36.13%,1
桃園市,平鎮區,0864,662,126,788,24,812,1717,47.29%,38.56%,1
桃園市,平鎮區,0865,522,152,674,41,715,1319,54.21%,39.58%,1
桃園市,平鎮區,0866,680,175,855,56,911,1745,52.21%,38.97%,1
桃園市,平鎮區,0867,689,193,882,62,944,1721,54.85%,40.03%,1
桃園市,平鎮區,0868,503,125,628,30,658,1206,54.56%,41.71%,1
桃園市,平鎮區,0869,604,146,750,28,778,1202,64.73%,50.25%,1
桃園市,平鎮區,0870,531,133,664,41,705,1208,58.36%,43.96%,1
桃園市,平鎮區,0871,558,139,697,47,744,1267,58.72%,44.04%,1
桃園市,平鎮區,0872,489,97,586,23,609,1094,55.67%,44.7%,1
桃園市,平鎮區,0873,593,173,766,52,818,1394,58.68%,42.54%,1
桃園市,平鎮區,0874,574,118,692,17,709,1215,58.35%,47.24%,1
桃園市,平鎮區,0875,439,112,551,29,580,1010,57.43%,43.47%,1
桃園市,平鎮區,0876,521,145,666,28,694,1261,55.04%,41.32%,1
桃園市,平鎮區,0877,588,145,733,28,761,1314,57.91%,44.75%,1
桃園市,平鎮區,0878,301,83,384,38,422,722,58.45%,41.69%,1
桃園市,平鎮區,0879,315,97,412,28,440,839,52.44%,37.54%,1
桃園市,平鎮區,0880,569,147,716,29,745,1399,53.25%,40.67%,1
桃園市,平鎮區,0881,755,176,931,59,990,1968,50.3%,38.36%,1
桃園市,平鎮區,0882,702,157,859,33,892,1672,53.35%,41.99%,1
桃園市,平鎮區,0883,442,183,625,24,649,2213,29.33%,19.97%,1
桃園市,平鎮區,0884,472,95,567,25,592,949,62.38%,49.74%,1
桃園市,平鎮區,0885,734,182,916,48,964,1621,59.47%,45.28%,1
桃園市,平鎮區,0886,673,140,813,26,839,1643,51.07%,40.96%,1
桃園市,平鎮區,0887,782,189,971,36,1007,1844,54.61%,42.41%,1
桃園市,平鎮區,0888,732,178,910,35,945,1752,53.94%,41.78%,1
桃園市,平鎮區,0889,583,146,729,51,780,1577,49.46%,36.97%,1
桃園市,平鎮區,0890,673,135,808,31,839,1517,55.31%,44.36%,1
桃園市,平鎮區,0891,447,131,578,32,610,1039,58.71%,43.02%,1
桃園市,平鎮區,0892,584,145,729,47,776,1318,58.88%,44.31%,1
桃園市,平鎮區,0893,671,150,821,45,866,1636,52.93%,41.01%,1
桃園市,平鎮區,0894,565,147,712,32,744,1316,56.53%,42.93%,1
桃園市,平鎮區,0895,609,181,790,27,817,1474,55.43%,41.32%,1
桃園市,平鎮區,0896,523,124,647,54,701,1480,47.36%,35.34%,1
桃園市,平鎮區,0897,564,105,669,27,696,1330,52.33%,42.41%,1
桃園市,平鎮區,0898,518,130,648,31,679,1228,55.29%,42.18%,1
桃園市,平鎮區,0899,632,143,775,35,810,1377,58.82%,45.9%,1
桃園市,平鎮區,0900,579,122,701,22,723,1198,60.35%,48.33%,1
桃園市,平鎮區,0901,583,124,707,37,744,1231,60.44%,47.36%,1
桃園市,平鎮區,0902,506,139,645,65,710,1243,57.12%,40.71%,1
桃園市,平鎮區,0903,669,131,800,40,840,1590,52.83%,42.08%,1
桃園市,平鎮區,0904,561,120,681,57,738,1366,54.03%,41.07%,1
桃園市,平鎮區,0905,547,124,671,49,720,1332,54.05%,41.07%,1
桃園市,平鎮區,0906,449,99,548,21,569,1201,47.38%,37.39%,1
桃園市,平鎮區,0907,575,154,729,31,760,1668,45.56%,34.47%,1
桃園市,平鎮區,0908,511,138,649,54,703,1351,52.04%,37.82%,1
桃園市,平鎮區,0909,521,115,636,27,663,1460,45.41%,35.68%,1
桃園市,平鎮區,0910,706,179,885,42,927,1841,50.35%,38.35%,1
桃園市,平鎮區,0911,552,116,668,17,685,1475,46.44%,37.42%,1
桃園市,平鎮區,0912,427,103,530,27,557,1011,55.09%,42.24%,1
桃園市,平鎮區,0913,381,97,478,34,512,1052,48.67%,36.22%,1
桃園市,平鎮區,0914,518,128,646,61,707,1154,61.27%,44.89%,1
桃園市,平鎮區,0915,629,148,777,25,802,1645,48.75%,38.24%,1
桃園市,平鎮區,0916,545,147,692,79,771,1539,50.1%,35.41%,1
桃園市,平鎮區,0917,549,125,674,72,746,1385,53.86%,39.64%,1
桃園市,平鎮區,0918,579,123,702,35,737,1395,52.83%,41.51%,1
桃園市,平鎮區,0919,683,135,818,33,851,1711,49.74%,39.92%,1
桃園市,平鎮區,0920,664,120,784,49,833,1631,51.07%,40.71%,1
桃園市,平鎮區,0921,500,88,588,16,604,1110,54.41%,45.05%,1
桃園市,平鎮區,0922,854,143,997,49,1046,1931,54.17%,44.23%,1
桃園市,平鎮區,0923,453,116,569,50,619,1127,54.92%,40.2%,1
桃園市,平鎮區,0924,601,106,707,70,777,1414,54.95%,42.5%,1
桃園市,平鎮區,0925,666,130,796,46,842,1609,52.33%,41.39%,1
桃園市,新屋區,1072,586,144,730,25,755,1306,57.81%,44.87%,1
桃園市,新屋區,1073,614,206,820,43,863,1556,55.46%,39.46%,1
桃園市,新屋區,1074,809,235,1044,72,1116,1849,60.36%,43.75%,1
桃園市,新屋區,1075,897,199,1096,84,1180,2096,56.3%,42.8%,1
桃園市,新屋區,1076,578,170,748,48,796,1517,52.47%,38.1%,1
桃園市,新屋區,1077,879,247,1126,63,1189,2095,56.75%,41.96%,1
桃園市,新屋區,1078,631,186,817,45,862,1856,46.44%,34%,1
桃園市,新屋區,1079,801,211,1012,73,1085,1986,54.63%,40.33%,1
桃園市,新屋區,1080,495,129,624,49,673,1425,47.23%,34.74%,1
桃園市,新屋區,1081,505,136,641,41,682,1385,49.24%,36.46%,1
桃園市,新屋區,1082,541,187,728,54,782,1271,61.53%,42.56%,1
桃園市,新屋區,1083,493,151,644,38,682,1271,53.66%,38.79%,1
桃園市,新屋區,1084,481,172,653,49,702,1234,56.89%,38.98%,1
桃園市,新屋區,1085,417,138,555,50,605,1085,55.76%,38.43%,1
桃園市,新屋區,1086,847,177,1024,48,1072,1992,53.82%,42.52%,1
桃園市,新屋區,1087,865,243,1108,81,1189,2032,58.51%,42.57%,1
桃園市,新屋區,1088,503,144,647,55,702,1291,54.38%,38.96%,1
桃園市,新屋區,1089,594,154,748,41,789,1401,56.32%,42.4%,1
桃園市,新屋區,1090,470,130,600,47,647,1106,58.5%,42.5%,1
桃園市,新屋區,1091,318,115,433,25,458,908,50.44%,35.02%,1
桃園市,新屋區,1092,280,86,366,42,408,663,61.54%,42.23%,1
桃園市,新屋區,1093,402,119,521,57,578,1088,53.13%,36.95%,1
桃園市,新屋區,1094,467,144,611,56,667,1050,63.52%,44.48%,1
桃園市,新屋區,1095,380,102,482,25,507,896,56.58%,42.41%,1
桃園市,新屋區,1096,577,152,729,88,817,1369,59.68%,42.15%,1
桃園市,新屋區,1097,339,105,444,39,483,995,48.54%,34.07%,1
桃園市,新屋區,1098,297,80,377,27,404,741,54.52%,40.08%,1
桃園市,新屋區,1099,380,135,515,67,582,943,61.72%,40.3%,1
桃園市,新屋區,1100,642,180,822,79,901,1714,52.57%,37.46%,1
桃園市,新屋區,1101,536,137,673,22,695,1340,51.87%,40%,1
桃園市,觀音區,1102,454,132,586,39,625,1371,45.59%,33.11%,1
桃園市,觀音區,1103,420,110,530,27,557,1362,40.9%,30.84%,1
桃園市,觀音區,1104,306,157,463,67,530,997,53.16%,30.69%,1
桃園市,觀音區,1105,497,120,617,32,649,1407,46.13%,35.32%,1
桃園市,觀音區,1106,671,169,840,31,871,1692,51.48%,39.66%,1
桃園市,觀音區,1107,503,117,620,27,647,1279,50.59%,39.33%,1
桃園市,觀音區,1108,300,85,385,20,405,791,51.2%,37.93%,1
桃園市,觀音區,1109,355,110,465,38,503,892,56.39%,39.8%,1
桃園市,觀音區,1110,403,103,506,26,532,886,60.05%,45.49%,1
桃園市,觀音區,1111,291,68,359,39,398,712,55.9%,40.87%,1
桃園市,觀音區,1112,533,170,703,109,812,1609,50.47%,33.13%,1
桃園市,觀音區,1113,478,174,652,54,706,1274,55.42%,37.52%,1
桃園市,觀音區,1114,442,114,556,20,576,1351,42.64%,32.72%,1
桃園市,觀音區,1115,534,134,668,60,728,1262,57.69%,42.31%,1
桃園市,觀音區,1116,515,125,640,66,706,1242,56.84%,41.47%,1
桃園市,觀音區,1117,545,163,708,69,777,1461,53.18%,37.3%,1
桃園市,觀音區,1118,597,180,777,43,820,1613,50.84%,37.01%,1
桃園市,觀音區,1119,575,163,738,53,791,1479,53.48%,38.88%,1
桃園市,觀音區,1120,516,171,687,57,744,1552,47.94%,33.25%,1
桃園市,觀音區,1121,444,273,717,35,752,1517,49.57%,29.27%,1
桃園市,觀音區,1122,604,169,773,62,835,1691,49.38%,35.72%,1
桃園市,觀音區,1123,486,124,610,21,631,1157,54.54%,42.01%,1
桃園市,觀音區,1124,644,48,692,49,741,1455,50.93%,44.26%,1
桃園市,觀音區,1125,482,99,581,26,607,1150,52.78%,41.91%,1
桃園市,觀音區,1126,435,139,574,50,624,1112,56.12%,39.12%,1
桃園市,觀音區,1127,469,118,587,20,607,1251,48.52%,37.49%,1
桃園市,觀音區,1128,528,159,687,91,778,1446,53.8%,36.51%,1
桃園市,觀音區,1129,508,179,687,101,788,1493,52.78%,34.03%,1
桃園市,觀音區,1130,502,134,636,66,702,1339,52.43%,37.49%,1
桃園市,觀音區,1131,489,124,613,43,656,1137,57.7%,43.01%,1
桃園市,觀音區,1132,379,107,486,40,526,1043,50.43%,36.34%,1
桃園市,觀音區,1133,323,110,433,27,460,993,46.32%,32.53%,1
桃園市,觀音區,1134,339,120,459,26,485,975,49.74%,34.77%,1
桃園市,觀音區,1135,628,181,809,53,862,2029,42.48%,30.95%,1
桃園市,觀音區,1136,701,201,902,42,944,1765,53.48%,39.72%,1
桃園市,觀音區,1137,692,179,871,49,920,1809,50.86%,38.25%,1
桃園市,觀音區,1138,667,189,856,42,898,1869,48.05%,35.69%,1
桃園市,觀音區,1139,603,153,756,56,812,1870,43.42%,32.25%,1
桃園市,觀音區,1140,493,155,648,40,688,1932,35.61%,25.52%,1
桃園市,觀音區,1141,257,95,352,13,365,899,40.6%,28.59%,1
桃園市,觀音區,1142,317,77,394,15,409,985,41.52%,32.18%,1
桃園市,復興區,0581,766,224,990,111,1101,1991,55.3%,38.47%,1
桃園市,復興區,0582,531,159,690,93,783,1392,56.25%,38.15%,1
桃園市,復興區,0583,214,60,274,19,293,564,51.95%,37.94%,1
桃園市,復興區,0584,237,77,314,28,342,716,47.77%,33.1%,1
桃園市,復興區,0585,443,126,569,57,626,1016,61.61%,43.6%,1
桃園市,復興區,0586,193,61,254,14,268,669,40.06%,28.85%,1
桃園市,復興區,0587,268,63,331,23,354,760,46.58%,35.26%,1
桃園市,復興區,0588,254,80,334,21,355,751,47.27%,33.82%,1
桃園市,復興區,0589,188,37,225,7,232,683,33.97%,27.53%,1
桃園市,復興區,0590,429,121,550,41,591,1224,48.28%,35.05%,1
臺中市,中區,1070,729,210,939,69,1008,1652,61.02%,44.13%,1
臺中市,中區,1071,600,210,810,58,868,1531,56.69%,39.19%,1
臺中市,中區,1072,562,197,759,32,791,1431,55.28%,39.27%,1
臺中市,中區,1073,450,124,574,43,617,1060,58.21%,42.45%,1
臺中市,中區,1074,382,115,497,51,548,982,55.8%,38.9%,1
臺中市,中區,1075,468,164,632,54,686,1191,57.6%,39.29%,1
臺中市,中區,1076,332,117,449,38,487,855,56.96%,38.83%,1
臺中市,中區,1077,384,119,503,28,531,1135,46.78%,33.83%,1
臺中市,中區,1078,287,91,378,18,396,705,56.17%,40.71%,1
臺中市,中區,1079,449,116,565,29,594,1009,58.87%,44.5%,1
臺中市,中區,1080,498,168,666,70,736,1304,56.44%,38.19%,1
臺中市,中區,1081,650,192,842,36,878,1841,47.69%,35.31%,1
臺中市,東區,1148,307,107,414,25,439,1138,38.58%,26.98%,1
臺中市,東區,1149,428,111,539,20,559,984,56.81%,43.5%,1
臺中市,東區,1150,381,105,486,37,523,877,59.64%,43.44%,1
臺中市,東區,1151,474,145,619,54,673,1070,62.9%,44.3%,1
臺中市,東區,1152,483,155,638,45,683,1106,61.75%,43.67%,1
臺中市,東區,1153,384,139,523,54,577,953,60.55%,40.29%,1
臺中市,東區,1154,531,137,668,31,699,1195,58.49%,44.44%,1
臺中市,東區,1155,518,136,654,55,709,1251,56.67%,41.41%,1
臺中市,東區,1156,445,172,617,51,668,1190,56.13%,37.39%,1
臺中市,東區,1157,560,170,730,60,790,1394,56.67%,40.17%,1
臺中市,東區,1158,612,197,809,63,872,1443,60.43%,42.41%,1
臺中市,東區,1159,310,86,396,45,441,762,57.87%,40.68%,1
臺中市,東區,1160,533,141,674,49,723,1140,63.42%,46.75%,1
臺中市,東區,1161,481,204,685,69,754,1211,62.26%,39.72%,1
臺中市,東區,1162,376,81,457,24,481,755,63.71%,49.8%,1
臺中市,東區,1163,585,185,770,65,835,1491,56%,39.24%,1
臺中市,東區,1164,375,127,502,30,532,1000,53.2%,37.5%,1
臺中市,東區,1165,449,171,620,58,678,1114,60.86%,40.31%,1
臺中市,東區,1166,441,136,577,39,616,1101,55.95%,40.05%,1
臺中市,東區,1167,535,163,698,62,760,1169,65.01%,45.77%,1
臺中市,東區,1168,575,164,739,68,807,1283,62.9%,44.82%,1
臺中市,東區,1169,557,139,696,40,736,1168,63.01%,47.69%,1
臺中市,東區,1170,539,178,717,37,754,1386,54.4%,38.89%,1
臺中市,東區,1171,706,182,888,52,940,1557,60.37%,45.34%,1
臺中市,東區,1172,547,200,747,67,814,1380,58.99%,39.64%,1
臺中市,東區,1173,688,205,893,47,940,1674,56.15%,41.1%,1
臺中市,東區,1174,764,190,954,43,997,1604,62.16%,47.63%,1
臺中市,東區,1175,815,228,1043,49,1092,1815,60.17%,44.9%,1
臺中市,東區,1176,698,190,888,57,945,1700,55.59%,41.06%,1
臺中市,東區,1177,668,182,850,59,909,1592,57.1%,41.96%,1
臺中市,東區,1178,732,214,946,72,1018,1850,55.03%,39.57%,1
臺中市,東區,1179,588,122,710,39,749,1252,59.82%,46.96%,1
臺中市,東區,1180,577,169,746,45,791,1250,63.28%,46.16%,1
臺中市,東區,1181,572,130,702,46,748,1241,60.27%,46.09%,1
臺中市,東區,1182,496,165,661,46,707,1318,53.64%,37.63%,1
臺中市,東區,1183,515,151,666,66,732,1288,56.83%,39.98%,1
臺中市,東區,1184,644,163,807,86,893,1442,61.93%,44.66%,1
臺中市,東區,1185,539,134,673,45,718,1202,59.73%,44.84%,1
臺中市,東區,1186,674,130,804,54,858,1452,59.09%,46.42%,1
臺中市,東區,1187,636,150,786,40,826,1480,55.81%,42.97%,1
臺中市,東區,1188,801,138,939,44,983,1736,56.62%,46.14%,1
臺中市,東區,1189,338,112,450,46,496,867,57.21%,38.99%,1
臺中市,東區,1190,694,137,831,48,879,1693,51.92%,40.99%,1
臺中市,東區,1191,703,161,864,72,936,1538,60.86%,45.71%,1
臺中市,東區,1192,651,248,899,104,1003,1593,62.96%,40.87%,1
臺中市,東區,1193,620,165,785,23,808,1481,54.56%,41.86%,1
臺中市,東區,1194,668,150,818,46,864,1414,61.1%,47.24%,1
臺中市,東區,1195,541,131,672,46,718,1297,55.36%,41.71%,1
臺中市,東區,1196,568,199,767,65,832,1394,59.68%,40.75%,1
臺中市,南區,1197,409,122,531,41,572,937,61.05%,43.65%,1
臺中市,南區,1198,463,146,609,47,656,1001,65.53%,46.25%,1
臺中市,南區,1199,598,157,755,66,821,1249,65.73%,47.88%,1
臺中市,南區,1200,602,165,767,51,818,1202,68.05%,50.08%,1
臺中市,南區,1201,497,139,636,78,714,1130,63.19%,43.98%,1
臺中市,南區,1202,543,172,715,68,783,1239,63.2%,43.83%,1
臺中市,南區,1203,508,161,669,58,727,1238,58.72%,41.03%,1
臺中市,南區,1204,551,177,728,60,788,1272,61.95%,43.32%,1
臺中市,南區,1205,554,166,720,46,766,1273,60.17%,43.52%,1
臺中市,南區,1206,539,195,734,72,806,1317,61.2%,40.93%,1
臺中市,南區,1207,577,170,747,42,789,1160,68.02%,49.74%,1
臺中市,南區,1208,541,184,725,60,785,1205,65.15%,44.9%,1
臺中市,南區,1209,486,149,635,46,681,1111,61.3%,43.74%,1
臺中市,南區,1210,661,210,871,58,929,1407,66.03%,46.98%,1
臺中市,南區,1211,615,188,803,51,854,1419,60.18%,43.34%,1
臺中市,南區,1212,520,152,672,61,733,1157,63.35%,44.94%,1
臺中市,南區,1213,619,142,761,40,801,1415,56.61%,43.75%,1
臺中市,南區,1214,608,177,785,64,849,1289,65.87%,47.17%,1
臺中市,南區,1215,620,201,821,55,876,1454,60.25%,42.64%,1
臺中市,南區,1216,648,142,790,62,852,1491,57.14%,43.46%,1
臺中市,南區,1217,640,161,801,27,828,1394,59.4%,45.91%,1
臺中市,南區,1218,632,176,808,52,860,1430,60.14%,44.2%,1
臺中市,南區,1219,578,148,726,110,836,1342,62.3%,43.07%,1
臺中市,南區,1220,588,205,793,91,884,1304,67.79%,45.09%,1
臺中市,南區,1221,541,162,703,42,745,1190,62.61%,45.46%,1
臺中市,南區,1222,564,140,704,57,761,1273,59.78%,44.3%,1
臺中市,南區,1223,661,176,837,67,904,1387,65.18%,47.66%,1
臺中市,南區,1224,566,189,755,55,810,1356,59.73%,41.74%,1
臺中市,南區,1225,600,156,756,59,815,1304,62.5%,46.01%,1
臺中市,南區,1226,614,155,769,30,799,1256,63.61%,48.89%,1
臺中市,南區,1227,656,186,842,36,878,1364,64.37%,48.09%,1
臺中市,南區,1228,573,198,771,76,847,1361,62.23%,42.1%,1
臺中市,南區,1229,689,161,850,22,872,1407,61.98%,48.97%,1
臺中市,南區,1230,568,175,743,55,798,1308,61.01%,43.43%,1
臺中市,南區,1231,546,150,696,33,729,1250,58.32%,43.68%,1
臺中市,南區,1232,524,173,697,43,740,1284,57.63%,40.81%,1
臺中市,南區,1233,542,145,687,66,753,1175,64.09%,46.13%,1
臺中市,南區,1234,570,156,726,41,767,1158,66.23%,49.22%,1
臺中市,南區,1235,499,149,648,63,711,1168,60.87%,42.72%,1
臺中市,南區,1236,795,185,980,56,1036,1626,63.71%,48.89%,1
臺中市,南區,1237,646,191,837,39,876,2115,41.42%,30.54%,1
臺中市,南區,1238,788,178,966,39,1005,1805,55.68%,43.66%,1
臺中市,南區,1239,723,191,914,34,948,1695,55.93%,42.65%,1
臺中市,南區,1240,793,201,994,50,1044,1643,63.54%,48.27%,1
臺中市,南區,1241,647,200,847,45,892,1423,62.68%,45.47%,1
臺中市,南區,1242,689,183,872,51,923,1542,59.86%,44.68%,1
臺中市,南區,1243,712,177,889,6,895,1533,58.38%,46.44%,1
臺中市,南區,1244,745,180,925,64,989,1531,64.6%,48.66%,1
臺中市,南區,1245,553,157,710,36,746,1392,53.59%,39.73%,1
臺中市,南區,1246,706,161,867,44,911,1592,57.22%,44.35%,1
臺中市,南區,1247,655,190,845,48,893,1431,62.4%,45.77%,1
臺中市,南區,1248,749,195,944,43,987,1799,54.86%,41.63%,1
臺中市,南區,1249,829,202,1031,53,1084,1708,63.47%,48.54%,1
臺中市,南區,1250,727,193,920,56,976,1700,57.41%,42.76%,1
臺中市,南區,1251,874,178,1052,35,1087,1751,62.08%,49.91%,1
臺中市,南區,1252,968,247,1215,59,1274,2109,60.41%,45.9%,1
臺中市,南區,1253,736,212,948,55,1003,1697,59.1%,43.37%,1
臺中市,南區,1254,646,166,812,53,865,1456,59.41%,44.37%,1
臺中市,南區,1255,840,254,1094,53,1147,1726,66.45%,48.67%,1
臺中市,南區,1256,841,182,1023,57,1080,1723,62.68%,48.81%,1
臺中市,南區,1257,740,178,918,55,973,1569,62.01%,47.16%,1
臺中市,南區,1258,576,179,755,38,793,1274,62.24%,45.21%,1
臺中市,南區,1259,716,157,873,42,915,1390,65.83%,51.51%,1
臺中市,南區,1260,679,157,836,30,866,1295,66.87%,52.43%,1
臺中市,南區,1261,592,148,740,70,810,1312,61.74%,45.12%,1
臺中市,南區,1262,689,179,868,33,901,1417,63.59%,48.62%,1
臺中市,南區,1263,673,136,809,43,852,1230,69.27%,54.72%,1
臺中市,南區,1264,546,177,723,58,781,1308,59.71%,41.74%,1
臺中市,南區,1265,584,208,792,86,878,1467,59.85%,39.81%,1
臺中市,南區,1266,646,160,806,48,854,1399,61.04%,46.18%,1
臺中市,南區,1267,517,153,670,61,731,1207,60.56%,42.83%,1
臺中市,南區,1268,573,154,727,50,777,1317,59%,43.51%,1
臺中市,南區,1269,673,196,869,43,912,1563,58.35%,43.06%,1
臺中市,南區,1270,583,147,730,38,768,1221,62.9%,47.75%,1
臺中市,西區,1082,393,88,481,32,513,1400,36.64%,28.07%,1
臺中市,西區,1083,400,125,525,20,545,861,63.3%,46.46%,1
臺中市,西區,1084,636,167,803,45,848,1416,59.89%,44.92%,1
臺中市,西區,1085,453,141,594,42,636,1020,62.35%,44.41%,1
臺中市,西區,1086,370,115,485,28,513,778,65.94%,47.56%,1
臺中市,西區,1087,586,162,748,51,799,1465,54.54%,40%,1
臺中市,西區,1088,446,126,572,18,590,1017,58.01%,43.85%,1
臺中市,西區,1089,392,115,507,21,528,868,60.83%,45.16%,1
臺中市,西區,1090,584,174,758,47,805,1251,64.35%,46.68%,1
臺中市,西區,1091,490,153,643,42,685,1044,65.61%,46.93%,1
臺中市,西區,1092,630,184,814,39,853,1487,57.36%,42.37%,1
臺中市,西區,1093,668,188,856,51,907,1573,57.66%,42.47%,1
臺中市,西區,1094,759,214,973,59,1032,1731,59.62%,43.85%,1
臺中市,西區,1095,551,142,693,27,720,1209,59.55%,45.57%,1
臺中市,西區,1096,673,174,847,41,888,1564,56.78%,43.03%,1
臺中市,西區,1097,534,145,679,40,719,1175,61.19%,45.45%,1
臺中市,西區,1098,634,175,809,33,842,1505,55.95%,42.13%,1
臺中市,西區,1099,629,181,810,38,848,1418,59.8%,44.36%,1
臺中市,西區,1100,530,134,664,15,679,1497,45.36%,35.4%,1
臺中市,西區,1101,545,169,714,40,754,1260,59.84%,43.25%,1
臺中市,西區,1102,596,201,797,53,850,1399,60.76%,42.6%,1
臺中市,西區,1103,597,183,780,41,821,1447,56.74%,41.26%,1
臺中市,西區,1104,711,220,931,58,989,1683,58.76%,42.25%,1
臺中市,西區,1105,694,190,884,60,944,1585,59.56%,43.79%,1
臺中市,西區,1106,681,204,885,43,928,1557,59.6%,43.74%,1
臺中市,西區,1107,672,181,853,51,904,1663,54.36%,40.41%,1
臺中市,西區,1108,791,274,1065,57,1122,1921,58.41%,41.18%,1
臺中市,西區,1109,739,224,963,52,1015,1952,52%,37.86%,1
臺中市,西區,1110,700,206,906,47,953,1708,55.8%,40.98%,1
臺中市,西區,1111,555,136,691,20,711,1131,62.86%,49.07%,1
臺中市,西區,1112,798,207,1005,40,1045,1916,54.54%,41.65%,1
臺中市,西區,1113,577,174,751,23,774,1275,60.71%,45.25%,1
臺中市,西區,1114,711,181,892,54,946,1822,51.92%,39.02%,1
臺中市,西區,1115,598,176,774,34,808,1374,58.81%,43.52%,1
臺中市,西區,1116,432,153,585,69,654,1129,57.93%,38.26%,1
臺中市,西區,1117,476,157,633,32,665,1201,55.37%,39.63%,1
臺中市,西區,1118,660,204,864,68,932,1639,56.86%,40.27%,1
臺中市,西區,1119,768,250,1018,72,1090,1863,58.51%,41.22%,1
臺中市,西區,1120,643,145,788,33,821,1287,63.79%,49.96%,1
臺中市,西區,1121,661,204,865,48,913,1504,60.7%,43.95%,1
臺中市,西區,1122,544,177,721,43,764,1308,58.41%,41.59%,1
臺中市,西區,1123,621,156,777,63,840,1433,58.62%,43.34%,1
臺中市,西區,1124,591,190,781,37,818,1450,56.41%,40.76%,1
臺中市,西區,1125,695,179,874,48,922,1465,62.94%,47.44%,1
臺中市,西區,1126,690,234,924,66,990,1818,54.46%,37.95%,1
臺中市,西區,1127,695,279,974,56,1030,1782,57.8%,39%,1
臺中市,西區,1128,583,218,801,54,855,1428,59.87%,40.83%,1
臺中市,西區,1129,531,154,685,41,726,1366,53.15%,38.87%,1
臺中市,西區,1130,626,179,805,38,843,1498,56.28%,41.79%,1
臺中市,西區,1131,632,142,774,45,819,1350,60.67%,46.81%,1
臺中市,西區,1132,640,138,778,25,803,1339,59.97%,47.8%,1
臺中市,西區,1133,733,183,916,44,960,1613,59.52%,45.44%,1
臺中市,西區,1134,633,166,799,49,848,1454,58.32%,43.54%,1
臺中市,西區,1135,708,210,918,33,951,1597,59.55%,44.33%,1
臺中市,西區,1136,667,177,844,49,893,1411,63.29%,47.27%,1
臺中市,西區,1137,635,185,820,62,882,1493,59.08%,42.53%,1
臺中市,西區,1138,746,189,935,42,977,1600,61.06%,46.63%,1
臺中市,西區,1139,698,212,910,57,967,1710,56.55%,40.82%,1
臺中市,西區,1140,491,152,643,35,678,1139,59.53%,43.11%,1
臺中市,西區,1141,493,143,636,39,675,1105,61.09%,44.62%,1
臺中市,西區,1142,631,179,810,47,857,1498,57.21%,42.12%,1
臺中市,西區,1143,691,213,904,39,943,1921,49.09%,35.97%,1
臺中市,西區,1144,535,192,727,58,785,1340,58.58%,39.93%,1
臺中市,西區,1145,684,207,891,33,924,1536,60.16%,44.53%,1
臺中市,西區,1146,536,193,729,76,805,1361,59.15%,39.38%,1
臺中市,西區,1147,693,176,869,28,897,1430,62.73%,48.46%,1
臺中市,北區,0983,550,175,725,34,759,1437,52.82%,38.27%,1
臺中市,北區,0984,620,216,836,77,913,1708,53.45%,36.3%,1
臺中市,北區,0985,403,103,506,37,543,1051,51.67%,38.34%,1
臺中市,北區,0986,421,124,545,38,583,996,58.53%,42.27%,1
臺中市,北區,0987,700,132,832,31,863,1504,57.38%,46.54%,1
臺中市,北區,0988,403,145,548,55,603,975,61.85%,41.33%,1
臺中市,北區,0989,388,99,487,35,522,886,58.92%,43.79%,1
臺中市,北區,0990,433,105,538,35,573,1276,44.91%,33.93%,1
臺中市,北區,0991,353,99,452,34,486,938,51.81%,37.63%,1
臺中市,北區,0992,550,147,697,71,768,1404,54.7%,39.17%,1
臺中市,北區,0993,414,120,534,20,554,996,55.62%,41.57%,1
臺中市,北區,0994,312,126,438,56,494,869,56.85%,35.9%,1
臺中市,北區,0995,332,80,412,20,432,704,61.36%,47.16%,1
臺中市,北區,0996,386,107,493,28,521,979,53.22%,39.43%,1
臺中市,北區,0997,310,78,388,16,404,773,52.26%,40.1%,1
臺中市,北區,0998,354,78,432,20,452,759,59.55%,46.64%,1
臺中市,北區,0999,687,114,801,46,847,1438,58.9%,47.77%,1
臺中市,北區,1000,506,96,602,22,624,1212,51.49%,41.75%,1
臺中市,北區,1001,711,193,904,45,949,1731,54.82%,41.07%,1
臺中市,北區,1002,667,186,853,41,894,1445,61.87%,46.16%,1
臺中市,北區,1003,755,217,972,51,1023,1855,55.15%,40.7%,1
臺中市,北區,1004,653,160,813,59,872,1728,50.46%,37.79%,1
臺中市,北區,1005,768,155,923,44,967,1878,51.49%,40.89%,1
臺中市,北區,1006,668,186,854,81,935,1793,52.15%,37.26%,1
臺中市,北區,1007,868,12,880,19,899,1555,57.81%,55.82%,1
臺中市,北區,1008,660,168,828,30,858,1761,48.72%,37.48%,1
臺中市,北區,1009,676,151,827,39,866,1579,54.84%,42.81%,1
臺中市,北區,1010,854,241,1095,86,1181,2192,53.88%,38.96%,1
臺中市,北區,1011,670,196,866,64,930,1560,59.62%,42.95%,1
臺中市,北區,1012,643,160,803,46,849,1476,57.52%,43.56%,1
臺中市,北區,1013,482,115,597,27,624,1006,62.03%,47.91%,1
臺中市,北區,1014,628,136,764,37,801,1403,57.09%,44.76%,1
臺中市,北區,1015,604,133,737,25,762,1446,52.7%,41.77%,1
臺中市,北區,1016,591,174,765,50,815,1460,55.82%,40.48%,1
臺中市,北區,1017,524,143,667,21,688,1233,55.8%,42.5%,1
臺中市,北區,1018,497,148,645,26,671,1027,65.34%,48.39%,1
臺中市,北區,1019,541,131,672,19,691,1207,57.25%,44.82%,1
臺中市,北區,1020,523,152,675,38,713,1167,61.1%,44.82%,1
臺中市,北區,1021,478,142,620,24,644,1150,56%,41.57%,1
臺中市,北區,1022,473,122,595,33,628,1061,59.19%,44.58%,1
臺中市,北區,1023,426,134,560,31,591,1005,58.81%,42.39%,1
臺中市,北區,1024,516,160,676,18,694,1250,55.52%,41.28%,1
臺中市,北區,1025,624,174,798,56,854,1448,58.98%,43.09%,1
臺中市,北區,1026,616,164,780,52,832,1379,60.33%,44.67%,1
臺中市,北區,1027,722,180,902,55,957,1652,57.93%,43.7%,1
臺中市,北區,1028,769,202,971,40,1011,1867,54.15%,41.19%,1
臺中市,北區,1029,412,112,524,24,548,2078,26.37%,19.83%,1
臺中市,北區,1030,716,185,901,44,945,1562,60.5%,45.84%,1
臺中市,北區,1031,650,137,787,36,823,1430,57.55%,45.45%,1
臺中市,北區,1032,864,250,1114,44,1158,2018,57.38%,42.81%,1
臺中市,北區,1033,657,177,834,28,862,1710,50.41%,38.42%,1
臺中市,北區,1034,610,145,755,32,787,1432,54.96%,42.6%,1
臺中市,北區,1035,555,125,680,26,706,1157,61.02%,47.97%,1
臺中市,北區,1036,523,122,645,40,685,1188,57.66%,44.02%,1
臺中市,北區,1037,589,169,758,38,796,1419,56.1%,41.51%,1
臺中市,北區,1038,676,170,846,31,877,1653,53.06%,40.9%,1
臺中市,北區,1039,532,155,687,45,732,1233,59.37%,43.15%,1
臺中市,北區,1040,543,145,688,26,714,1243,57.44%,43.68%,1
臺中市,北區,1041,491,126,617,23,640,1219,52.5%,40.28%,1
臺中市,北區,1042,544,170,714,45,759,1272,59.67%,42.77%,1
臺中市,北區,1043,571,139,710,26,736,1285,57.28%,44.44%,1
臺中市,北區,1044,751,221,972,39,1011,1780,56.8%,42.19%,1
臺中市,北區,1045,571,146,717,28,745,1461,50.99%,39.08%,1
臺中市,北區,1046,628,157,785,28,813,1310,62.06%,47.94%,1
臺中市,北區,1047,710,157,867,31,898,1669,53.8%,42.54%,1
臺中市,北區,1048,827,217,1044,72,1116,1932,57.76%,42.81%,1
臺中市,北區,1049,703,200,903,29,932,1682,55.41%,41.8%,1
臺中市,北區,1050,702,253,955,29,984,1891,52.04%,37.12%,1
臺中市,北區,1051,794,200,994,71,1065,1882,56.59%,42.19%,1
臺中市,北區,1052,497,126,623,27,650,1159,56.08%,42.88%,1
臺中市,北區,1053,643,174,817,55,872,1553,56.15%,41.4%,1
臺中市,北區,1054,639,203,842,41,883,1607,54.95%,39.76%,1
臺中市,北區,1055,718,232,950,43,993,1773,56.01%,40.5%,1
臺中市,北區,1056,647,180,827,54,881,1524,57.81%,42.45%,1
臺中市,北區,1057,725,214,939,61,1000,1613,62%,44.95%,1
臺中市,北區,1058,837,199,1036,47,1083,1877,57.7%,44.59%,1
臺中市,北區,1059,749,218,967,65,1032,1792,57.59%,41.8%,1
臺中市,北區,1060,615,163,778,46,824,1392,59.2%,44.18%,1
臺中市,北區,1061,543,149,692,31,723,1297,55.74%,41.87%,1
臺中市,北區,1062,677,216,893,40,933,1556,59.96%,43.51%,1
臺中市,北區,1063,596,205,801,23,824,1497,55.04%,39.81%,1
臺中市,北區,1064,652,162,814,50,864,1550,55.74%,42.06%,1
臺中市,北區,1065,493,166,659,32,691,1434,48.19%,34.38%,1
臺中市,北區,1066,771,206,977,61,1038,1793,57.89%,43%,1
臺中市,北區,1067,775,232,1007,37,1044,1866,55.95%,41.53%,1
臺中市,北區,1068,578,156,734,64,798,1346,59.29%,42.94%,1
臺中市,北區,1069,536,135,671,58,729,1267,57.54%,42.3%,1
臺中市,西屯區,0625,739,220,959,60,1019,1638,62.21%,45.12%,1
臺中市,西屯區,0626,544,145,689,42,731,1335,54.76%,40.75%,1
臺中市,西屯區,0627,792,202,994,51,1045,1776,58.84%,44.59%,1
臺中市,西屯區,0628,581,167,748,25,773,1351,57.22%,43.01%,1
臺中市,西屯區,0629,598,168,766,51,817,1338,61.06%,44.69%,1
臺中市,西屯區,0630,687,172,859,51,910,1582,57.52%,43.43%,1
臺中市,西屯區,0631,700,157,857,32,889,1710,51.99%,40.94%,1
臺中市,西屯區,0632,592,177,769,54,823,1595,51.6%,37.12%,1
臺中市,西屯區,0633,739,144,883,56,939,1585,59.24%,46.62%,1
臺中市,西屯區,0634,709,194,903,73,976,1749,55.8%,40.54%,1
臺中市,西屯區,0635,844,183,1027,61,1088,1877,57.96%,44.97%,1
臺中市,西屯區,0636,692,188,880,44,924,1697,54.45%,40.78%,1
臺中市,西屯區,0637,687,175,862,40,902,1480,60.95%,46.42%,1
臺中市,西屯區,0638,723,196,919,53,972,1483,65.54%,48.75%,1
臺中市,西屯區,0639,660,191,851,43,894,2484,35.99%,26.57%,1
臺中市,西屯區,0640,370,108,478,44,522,781,66.84%,47.38%,1
臺中市,西屯區,0641,666,171,837,50,887,1477,60.05%,45.09%,1
臺中市,西屯區,0642,763,191,954,33,987,1784,55.33%,42.77%,1
臺中市,西屯區,0643,772,163,935,33,968,1686,57.41%,45.79%,1
臺中市,西屯區,0644,718,197,915,39,954,1692,56.38%,42.43%,1
臺中市,西屯區,0645,725,152,877,18,895,1659,53.95%,43.7%,1
臺中市,西屯區,0646,723,178,901,38,939,1648,56.98%,43.87%,1
臺中市,西屯區,0647,683,203,886,39,925,1536,60.22%,44.47%,1
臺中市,西屯區,0648,741,212,953,46,999,1666,59.96%,44.48%,1
臺中市,西屯區,0649,658,143,801,49,850,1428,59.52%,46.08%,1
臺中市,西屯區,0650,777,161,938,52,990,1810,54.7%,42.93%,1
臺中市,西屯區,0651,708,153,861,33,894,1574,56.8%,44.98%,1
臺中市,西屯區,0652,753,164,917,17,934,1650,56.61%,45.64%,1
臺中市,西屯區,0653,708,191,899,72,971,1681,57.76%,42.12%,1
臺中市,西屯區,0654,673,212,885,44,929,1656,56.1%,40.64%,1
臺中市,西屯區,0655,579,136,715,50,765,1243,61.54%,46.58%,1
臺中市,西屯區,0656,698,171,869,62,931,1471,63.29%,47.45%,1
臺中市,西屯區,0657,677,178,855,39,894,1431,62.47%,47.31%,1
臺中市,西屯區,0658,747,197,944,32,976,1714,56.94%,43.58%,1
臺中市,西屯區,0659,646,152,798,48,846,1424,59.41%,45.37%,1
臺中市,西屯區,0660,539,119,658,43,701,1176,59.61%,45.83%,1
臺中市,西屯區,0661,630,177,807,69,876,1456,60.16%,43.27%,1
臺中市,西屯區,0662,710,153,863,47,910,1451,62.72%,48.93%,1
臺中市,西屯區,0663,551,113,664,31,695,1063,65.38%,51.83%,1
臺中市,西屯區,0664,637,134,771,62,833,1357,61.39%,46.94%,1
臺中市,西屯區,0665,690,93,783,58,841,1355,62.07%,50.92%,1
臺中市,西屯區,0666,721,108,829,22,851,1384,61.49%,52.1%,1
臺中市,西屯區,0667,715,203,918,48,966,1613,59.89%,44.33%,1
臺中市,西屯區,0668,658,195,853,55,908,1562,58.13%,42.13%,1
臺中市,西屯區,0669,563,169,732,63,795,1219,65.22%,46.19%,1
臺中市,西屯區,0670,521,161,682,39,721,1235,58.38%,42.19%,1
臺中市,西屯區,0671,496,136,632,47,679,1131,60.04%,43.85%,1
臺中市,西屯區,0672,709,173,882,51,933,1494,62.45%,47.46%,1
臺中市,西屯區,0673,574,138,712,32,744,1325,56.15%,43.32%,1
臺中市,西屯區,0674,589,202,791,34,825,1386,59.52%,42.5%,1
臺中市,西屯區,0675,775,224,999,75,1074,1816,59.14%,42.68%,1
臺中市,西屯區,0676,717,178,895,36,931,1734,53.69%,41.35%,1
臺中市,西屯區,0677,808,188,996,71,1067,1777,60.05%,45.47%,1
臺中市,西屯區,0678,746,187,933,67,1000,1818,55.01%,41.03%,1
臺中市,西屯區,0679,693,197,890,72,962,1699,56.62%,40.79%,1
臺中市,西屯區,0680,663,177,840,45,885,1715,51.6%,38.66%,1
臺中市,西屯區,0681,670,183,853,39,892,1654,53.93%,40.51%,1
臺中市,西屯區,0682,714,162,876,24,900,1636,55.01%,43.64%,1
臺中市,西屯區,0683,525,159,684,34,718,1298,55.32%,40.45%,1
臺中市,西屯區,0684,596,193,789,48,837,1391,60.17%,42.85%,1
臺中市,西屯區,0685,802,218,1020,63,1083,1853,58.45%,43.28%,1
臺中市,西屯區,0686,760,86,846,64,910,1820,50%,41.76%,1
臺中市,西屯區,0687,803,188,991,47,1038,1809,57.38%,44.39%,1
臺中市,西屯區,0688,625,168,793,49,842,1352,62.28%,46.23%,1
臺中市,西屯區,0689,644,174,818,65,883,1521,58.05%,42.34%,1
臺中市,西屯區,0690,668,187,855,46,901,1486,60.63%,44.95%,1
臺中市,西屯區,0691,729,208,937,45,982,1674,58.66%,43.55%,1
臺中市,西屯區,0692,741,211,952,53,1005,1610,62.42%,46.02%,1
臺中市,西屯區,0693,755,190,945,45,990,1695,58.41%,44.54%,1
臺中市,西屯區,0694,700,198,898,47,945,1684,56.12%,41.57%,1
臺中市,西屯區,0695,547,159,706,29,735,1221,60.2%,44.8%,1
臺中市,西屯區,0696,613,167,780,63,843,1252,67.33%,48.96%,1
臺中市,西屯區,0697,574,184,758,53,811,1301,62.34%,44.12%,1
臺中市,西屯區,0698,535,92,627,40,667,1049,63.58%,51%,1
臺中市,西屯區,0699,534,80,614,63,677,1113,60.83%,47.98%,1
臺中市,西屯區,0700,661,140,801,54,855,1557,54.91%,42.45%,1
臺中市,西屯區,0701,706,189,895,50,945,1640,57.62%,43.05%,1
臺中市,西屯區,0702,688,182,870,70,940,1402,67.05%,49.07%,1
臺中市,西屯區,0703,675,161,836,70,906,1717,52.77%,39.31%,1
臺中市,西屯區,0704,697,194,891,68,959,1688,56.81%,41.29%,1
臺中市,西屯區,0705,480,146,626,91,717,1168,61.39%,41.1%,1
臺中市,西屯區,0706,716,181,897,49,946,1729,54.71%,41.41%,1
臺中市,西屯區,0707,807,209,1016,48,1064,2007,53.01%,40.21%,1
臺中市,西屯區,0708,556,158,714,81,795,1296,61.34%,42.9%,1
臺中市,西屯區,0709,412,101,513,26,539,1068,50.47%,38.58%,1
臺中市,西屯區,0710,664,163,827,78,905,1707,53.02%,38.9%,1
臺中市,西屯區,0711,732,190,922,49,971,1636,59.35%,44.74%,1
臺中市,西屯區,0712,657,132,789,49,838,1761,47.59%,37.31%,1
臺中市,西屯區,0713,559,164,723,47,770,1314,58.6%,42.54%,1
臺中市,西屯區,0714,601,144,745,43,788,1233,63.91%,48.74%,1
臺中市,西屯區,0715,636,172,808,48,856,1549,55.26%,41.06%,1
臺中市,西屯區,0716,691,151,842,29,871,1639,53.14%,42.16%,1
臺中市,西屯區,0717,626,142,768,44,812,1486,54.64%,42.13%,1
臺中市,西屯區,0718,775,187,962,21,983,1806,54.43%,42.91%,1
臺中市,西屯區,0719,625,150,775,22,797,1451,54.93%,43.07%,1
臺中市,西屯區,0720,617,114,731,36,767,1302,58.91%,47.39%,1
臺中市,西屯區,0721,614,177,791,51,842,1353,62.23%,45.38%,1
臺中市,西屯區,0722,973,226,1199,53,1252,2162,57.91%,45%,1
臺中市,西屯區,0723,626,194,820,45,865,1520,56.91%,41.18%,1
臺中市,西屯區,0724,842,171,1013,40,1053,1935,54.42%,43.51%,1
臺中市,西屯區,0725,782,206,988,45,1033,1847,55.93%,42.34%,1
臺中市,西屯區,0726,764,195,959,45,1004,1738,57.77%,43.96%,1
臺中市,西屯區,0727,750,213,963,42,1005,1640,61.28%,45.73%,1
臺中市,西屯區,0728,811,221,1032,38,1070,1908,56.08%,42.51%,1
臺中市,西屯區,0729,640,146,786,27,813,1402,57.99%,45.65%,1
臺中市,西屯區,0730,633,155,788,24,812,1515,53.6%,41.78%,1
臺中市,西屯區,0731,565,144,709,34,743,1541,48.22%,36.66%,1
臺中市,西屯區,0732,630,166,796,39,835,1502,55.59%,41.94%,1
臺中市,西屯區,0733,651,206,857,51,908,1526,59.5%,42.66%,1
臺中市,西屯區,0734,631,172,803,61,864,1425,60.63%,44.28%,1
臺中市,西屯區,0735,571,216,787,33,820,1334,61.47%,42.8%,1
臺中市,西屯區,0736,755,190,945,34,979,1649,59.37%,45.79%,1
臺中市,西屯區,0737,654,160,814,40,854,1566,54.53%,41.76%,1
臺中市,西屯區,0738,768,177,945,46,991,1629,60.83%,47.15%,1
臺中市,西屯區,0739,724,203,927,40,967,1628,59.4%,44.47%,1
臺中市,西屯區,0740,689,153,842,40,882,1442,61.17%,47.78%,1
臺中市,西屯區,0741,482,133,615,57,672,1206,55.72%,39.97%,1
臺中市,西屯區,0742,469,163,632,51,683,1086,62.89%,43.19%,1
臺中市,西屯區,0743,510,127,637,41,678,1088,62.32%,46.88%,1
臺中市,西屯區,0744,499,143,642,34,676,1140,59.3%,43.77%,1
臺中市,南屯區,0745,581,162,743,64,807,1321,61.09%,43.98%,1
臺中市,南屯區,0746,588,193,781,63,844,1346,62.7%,43.68%,1
臺中市,南屯區,0747,625,185,810,48,858,1428,60.08%,43.77%,1
臺中市,南屯區,0748,653,145,798,36,834,1442,57.84%,45.28%,1
臺中市,南屯區,0749,719,163,882,27,909,1408,64.56%,51.07%,1
臺中市,南屯區,0750,683,146,829,30,859,1404,61.18%,48.65%,1
臺中市,南屯區,0751,664,148,812,48,860,1354,63.52%,49.04%,1
臺中市,南屯區,0752,614,170,784,53,837,1332,62.84%,46.1%,1
臺中市,南屯區,0753,663,212,875,49,924,1463,63.16%,45.32%,1
臺中市,南屯區,0754,588,223,811,41,852,1413,60.3%,41.61%,1
臺中市,南屯區,0755,588,161,749,25,774,1218,63.55%,48.28%,1
臺中市,南屯區,0756,561,167,728,33,761,1308,58.18%,42.89%,1
臺中市,南屯區,0757,735,197,932,40,972,1527,63.65%,48.13%,1
臺中市,南屯區,0758,608,168,776,33,809,1294,62.52%,46.99%,1
臺中市,南屯區,0759,571,194,765,51,816,1516,53.83%,37.66%,1
臺中市,南屯區,0760,664,198,862,86,948,1529,62%,43.43%,1
臺中市,南屯區,0761,616,180,796,63,859,1397,61.49%,44.09%,1
臺中市,南屯區,0762,611,136,747,40,787,1406,55.97%,43.46%,1
臺中市,南屯區,0763,613,165,778,50,828,1497,55.31%,40.95%,1
臺中市,南屯區,0764,578,170,748,70,818,1424,57.44%,40.59%,1
臺中市,南屯區,0765,532,148,680,47,727,1488,48.86%,35.75%,1
臺中市,南屯區,0766,285,77,362,46,408,608,67.11%,46.88%,1
臺中市,南屯區,0767,324,140,464,64,528,813,64.94%,39.85%,1
臺中市,南屯區,0768,520,147,667,65,732,1190,61.51%,43.7%,1
臺中市,南屯區,0769,507,121,628,35,663,1174,56.47%,43.19%,1
臺中市,南屯區,0770,574,124,698,17,715,1224,58.42%,46.9%,1
臺中市,南屯區,0771,535,120,655,43,698,1466,47.61%,36.49%,1
臺中市,南屯區,0772,442,102,544,31,575,1333,43.14%,33.16%,1
臺中市,南屯區,0773,347,111,458,62,520,814,63.88%,42.63%,1
臺中市,南屯區,0774,572,157,729,61,790,1436,55.01%,39.83%,1
臺中市,南屯區,0775,657,189,846,59,905,1515,59.74%,43.37%,1
臺中市,南屯區,0776,572,148,720,81,801,1545,51.84%,37.02%,1
臺中市,南屯區,0777,626,151,777,37,814,1383,58.86%,45.26%,1
臺中市,南屯區,0778,667,155,822,39,861,1433,60.08%,46.55%,1
臺中市,南屯區,0779,457,137,594,28,622,1134,54.85%,40.3%,1
臺中市,南屯區,0780,585,138,723,39,762,1216,62.66%,48.11%,1
臺中市,南屯區,0781,510,154,664,71,735,1271,57.83%,40.13%,1
臺中市,南屯區,0782,522,116,638,24,662,1203,55.03%,43.39%,1
臺中市,南屯區,0783,552,158,710,33,743,1268,58.6%,43.53%,1
臺中市,南屯區,0784,608,176,784,50,834,1390,60%,43.74%,1
臺中市,南屯區,0785,522,238,760,50,810,1397,57.98%,37.37%,1
臺中市,南屯區,0786,646,208,854,71,925,1607,57.56%,40.2%,1
臺中市,南屯區,0787,720,176,896,48,944,1582,59.67%,45.51%,1
臺中市,南屯區,0788,743,176,919,49,968,1611,60.09%,46.12%,1
臺中市,南屯區,0789,616,179,795,46,841,1322,63.62%,46.6%,1
臺中市,南屯區,0790,641,178,819,38,857,1321,64.88%,48.52%,1
臺中市,南屯區,0791,622,145,767,45,812,1360,59.71%,45.74%,1
臺中市,南屯區,0792,631,171,802,15,817,1361,60.03%,46.36%,1
臺中市,南屯區,0793,570,176,746,40,786,1257,62.53%,45.35%,1
臺中市,南屯區,0794,612,142,754,27,781,1207,64.71%,50.7%,1
臺中市,南屯區,0795,640,138,778,34,812,1282,63.34%,49.92%,1
臺中市,南屯區,0796,637,152,789,30,819,1248,65.63%,51.04%,1
臺中市,南屯區,0797,629,183,812,40,852,1304,65.34%,48.24%,1
臺中市,南屯區,0798,566,146,712,31,743,1214,61.2%,46.62%,1
臺中市,南屯區,0799,536,129,665,50,715,1102,64.88%,48.64%,1
臺中市,南屯區,0800,847,174,1021,37,1058,1630,64.91%,51.96%,1
臺中市,南屯區,0801,635,156,791,41,832,1333,62.42%,47.64%,1
臺中市,南屯區,0802,611,167,778,36,814,1292,63%,47.29%,1
臺中市,南屯區,0803,602,144,746,40,786,1272,61.79%,47.33%,1
臺中市,南屯區,0804,652,134,786,38,824,1345,61.26%,48.48%,1
臺中市,南屯區,0805,494,137,631,59,690,981,70.34%,50.36%,1
臺中市,南屯區,0806,532,121,653,53,706,1097,64.36%,48.5%,1
臺中市,南屯區,0807,506,116,622,25,647,991,65.29%,51.06%,1
臺中市,南屯區,0808,540,150,690,23,713,1170,60.94%,46.15%,1
臺中市,南屯區,0809,552,166,718,33,751,1171,64.13%,47.14%,1
臺中市,南屯區,0810,575,178,753,56,809,1349,59.97%,42.62%,1
臺中市,南屯區,0811,657,184,841,33,874,1368,63.89%,48.03%,1
臺中市,南屯區,0812,641,135,776,42,818,1263,64.77%,50.75%,1
臺中市,南屯區,0813,705,216,921,41,962,1547,62.18%,45.57%,1
臺中市,南屯區,0814,714,219,933,53,986,1649,59.79%,43.3%,1
臺中市,南屯區,0815,706,174,880,36,916,1629,56.23%,43.34%,1
臺中市,南屯區,0816,621,190,811,43,854,1580,54.05%,39.3%,1
臺中市,南屯區,0817,745,166,911,36,947,1444,65.58%,51.59%,1
臺中市,南屯區,0818,654,137,791,25,816,1413,57.75%,46.28%,1
臺中市,南屯區,0819,625,146,771,38,809,1377,58.75%,45.39%,1
臺中市,南屯區,0820,658,229,887,44,931,1527,60.97%,43.09%,1
臺中市,南屯區,0821,618,171,789,52,841,1335,63%,46.29%,1
臺中市,南屯區,0822,781,209,990,44,1034,1544,66.97%,50.58%,1
臺中市,南屯區,0823,682,253,935,47,982,1482,66.26%,46.02%,1
臺中市,南屯區,0824,663,197,860,68,928,1488,62.37%,44.56%,1
臺中市,南屯區,0825,602,168,770,45,815,1538,52.99%,39.14%,1
臺中市,南屯區,0826,773,209,982,74,1056,1674,63.08%,46.18%,1
臺中市,南屯區,0827,645,181,826,36,862,1996,43.19%,32.31%,1
臺中市,南屯區,0828,681,176,857,65,922,1514,60.9%,44.98%,1
臺中市,南屯區,0829,599,133,732,51,783,1217,64.34%,49.22%,1
臺中市,南屯區,0830,589,161,750,53,803,1347,59.61%,43.73%,1
臺中市,南屯區,0831,517,127,644,34,678,1109,61.14%,46.62%,1
臺中市,南屯區,0832,701,157,858,37,895,1546,57.89%,45.34%,1
臺中市,南屯區,0833,701,168,869,39,908,1408,64.49%,49.79%,1
臺中市,南屯區,0834,448,113,561,20,581,1057,54.97%,42.38%,1
臺中市,南屯區,0835,485,158,643,50,693,1133,61.17%,42.81%,1
臺中市,南屯區,0836,588,151,739,27,766,1278,59.94%,46.01%,1
臺中市,南屯區,0837,557,151,708,46,754,1144,65.91%,48.69%,1
臺中市,南屯區,0838,508,160,668,32,700,1140,61.4%,44.56%,1
臺中市,南屯區,0839,547,153,700,42,742,1171,63.36%,46.71%,1
臺中市,南屯區,0840,614,181,795,42,837,1303,64.24%,47.12%,1
臺中市,南屯區,0841,590,143,733,43,776,1402,55.35%,42.08%,1
臺中市,南屯區,0842,688,179,867,49,916,1571,58.31%,43.79%,1
臺中市,南屯區,0843,524,168,692,42,734,1139,64.44%,46.01%,1
臺中市,南屯區,0844,563,163,726,54,780,1216,64.14%,46.3%,1
臺中市,南屯區,0845,568,133,701,35,736,1162,63.34%,48.88%,1
臺中市,北屯區,0846,784,193,977,61,1038,1670,62.16%,46.95%,1
臺中市,北屯區,0847,700,179,879,57,936,1706,54.87%,41.03%,1
臺中市,北屯區,0848,616,171,787,76,863,1507,57.27%,40.88%,1
臺中市,北屯區,0849,723,207,930,55,985,1652,59.62%,43.77%,1
臺中市,北屯區,0850,462,108,570,17,587,1107,53.03%,41.73%,1
臺中市,北屯區,0851,850,216,1066,90,1156,2151,53.74%,39.52%,1
臺中市,北屯區,0852,751,174,925,28,953,1612,59.12%,46.59%,1
臺中市,北屯區,0853,743,186,929,46,975,1743,55.94%,42.63%,1
臺中市,北屯區,0854,817,201,1018,55,1073,2099,51.12%,38.92%,1
臺中市,北屯區,0855,692,163,855,32,887,1595,55.61%,43.39%,1
臺中市,北屯區,0856,763,189,952,64,1016,1923,52.83%,39.68%,1
臺中市,北屯區,0857,688,152,840,64,904,1641,55.09%,41.93%,1
臺中市,北屯區,0858,572,124,696,36,732,1157,63.27%,49.44%,1
臺中市,北屯區,0859,514,110,624,40,664,1041,63.78%,49.38%,1
臺中市,北屯區,0860,641,159,800,48,848,1563,54.25%,41.01%,1
臺中市,北屯區,0861,633,151,784,56,840,1559,53.88%,40.6%,1
臺中市,北屯區,0862,570,104,674,22,696,1411,49.33%,40.4%,1
臺中市,北屯區,0863,831,159,990,39,1029,1761,58.43%,47.19%,1
臺中市,北屯區,0864,634,156,790,66,856,1361,62.89%,46.58%,1
臺中市,北屯區,0865,771,178,949,85,1034,1852,55.83%,41.63%,1
臺中市,北屯區,0866,824,229,1053,53,1106,1928,57.37%,42.74%,1
臺中市,北屯區,0867,756,164,920,39,959,1492,64.28%,50.67%,1
臺中市,北屯區,0868,815,211,1026,69,1095,1998,54.8%,40.79%,1
臺中市,北屯區,0869,643,144,787,40,827,1272,65.02%,50.55%,1
臺中市,北屯區,0870,644,138,782,38,820,1317,62.26%,48.9%,1
臺中市,北屯區,0871,510,131,641,58,699,1327,52.68%,38.43%,1
臺中市,北屯區,0872,518,129,647,28,675,1280,52.73%,40.47%,1
臺中市,北屯區,0873,739,83,822,58,880,1865,47.18%,39.62%,1
臺中市,北屯區,0874,652,68,720,63,783,1230,63.66%,53.01%,1
臺中市,北屯區,0875,549,130,679,48,727,1356,53.61%,40.49%,1
臺中市,北屯區,0876,771,162,933,57,990,1732,57.16%,44.52%,1
臺中市,北屯區,0877,730,166,896,42,938,1586,59.14%,46.03%,1
臺中市,北屯區,0878,609,172,781,32,813,1441,56.42%,42.26%,1
臺中市,北屯區,0879,907,119,1026,80,1106,2045,54.08%,44.35%,1
臺中市,北屯區,0880,729,209,938,69,1007,1914,52.61%,38.09%,1
臺中市,北屯區,0881,862,163,1025,50,1075,1918,56.05%,44.94%,1
臺中市,北屯區,0882,890,164,1054,30,1084,2079,52.14%,42.81%,1
臺中市,北屯區,0883,872,217,1089,58,1147,2040,56.23%,42.75%,1
臺中市,北屯區,0884,746,209,955,54,1009,2027,49.78%,36.8%,1
臺中市,北屯區,0885,597,144,741,46,787,1402,56.13%,42.58%,1
臺中市,北屯區,0886,805,195,1000,67,1067,1826,58.43%,44.09%,1
臺中市,北屯區,0887,1047,156,1203,40,1243,2162,57.49%,48.43%,1
臺中市,北屯區,0888,875,213,1088,26,1114,2332,47.77%,37.52%,1
臺中市,北屯區,0889,435,96,531,49,580,985,58.88%,44.16%,1
臺中市,北屯區,0890,742,196,938,54,992,2037,48.7%,36.43%,1
臺中市,北屯區,0891,465,124,589,40,629,1032,60.95%,45.06%,1
臺中市,北屯區,0892,469,104,573,45,618,1062,58.19%,44.16%,1
臺中市,北屯區,0893,377,84,461,61,522,909,57.43%,41.47%,1
臺中市,北屯區,0894,646,167,813,54,867,1445,60%,44.71%,1
臺中市,北屯區,0895,755,191,946,37,983,1842,53.37%,40.99%,1
臺中市,北屯區,0896,536,133,669,46,715,1187,60.24%,45.16%,1
臺中市,北屯區,0897,636,153,789,52,841,1456,57.76%,43.68%,1
臺中市,北屯區,0898,885,127,1012,58,1070,1866,57.34%,47.43%,1
臺中市,北屯區,0899,695,151,846,56,902,1667,54.11%,41.69%,1
臺中市,北屯區,0900,753,169,922,32,954,1683,56.68%,44.74%,1
臺中市,北屯區,0901,695,183,878,31,909,1642,55.36%,42.33%,1
臺中市,北屯區,0902,646,179,825,23,848,1475,57.49%,43.8%,1
臺中市,北屯區,0903,732,130,862,28,890,1644,54.14%,44.53%,1
臺中市,北屯區,0904,766,157,923,28,951,1603,59.33%,47.79%,1
臺中市,北屯區,0905,891,196,1087,65,1152,1949,59.11%,45.72%,1
臺中市,北屯區,0906,900,200,1100,34,1134,1790,63.35%,50.28%,1
臺中市,北屯區,0907,631,176,807,42,849,1440,58.96%,43.82%,1
臺中市,北屯區,0908,717,193,910,62,972,1601,60.71%,44.78%,1
臺中市,北屯區,0909,646,151,797,59,856,1527,56.06%,42.31%,1
臺中市,北屯區,0910,664,167,831,59,890,1675,53.13%,39.64%,1
臺中市,北屯區,0911,583,150,733,49,782,1579,49.53%,36.92%,1
臺中市,北屯區,0912,638,165,803,82,885,1524,58.07%,41.86%,1
臺中市,北屯區,0913,695,168,863,53,916,1677,54.62%,41.44%,1
臺中市,北屯區,0914,688,160,848,47,895,1599,55.97%,43.03%,1
臺中市,北屯區,0915,633,194,827,58,885,1458,60.7%,43.42%,1
臺中市,北屯區,0916,774,196,970,60,1030,1571,65.56%,49.27%,1
臺中市,北屯區,0917,642,217,859,79,938,1579,59.4%,40.66%,1
臺中市,北屯區,0918,845,197,1042,47,1089,1849,58.9%,45.7%,1
臺中市,北屯區,0919,744,175,919,44,963,1682,57.25%,44.23%,1
臺中市,北屯區,0920,753,172,925,41,966,1760,54.89%,42.78%,1
臺中市,北屯區,0921,727,197,924,66,990,1699,58.27%,42.79%,1
臺中市,北屯區,0922,749,213,962,50,1012,1626,62.24%,46.06%,1
臺中市,北屯區,0923,666,202,868,8,876,1491,58.75%,44.67%,1
臺中市,北屯區,0924,687,187,874,34,908,1640,55.37%,41.89%,1
臺中市,北屯區,0925,872,207,1079,58,1137,2052,55.41%,42.5%,1
臺中市,北屯區,0926,820,196,1016,54,1070,1875,57.07%,43.73%,1
臺中市,北屯區,0927,655,161,816,32,848,1559,54.39%,42.01%,1
臺中市,北屯區,0928,640,164,804,77,881,1480,59.53%,43.24%,1
臺中市,北屯區,0929,576,190,766,63,829,1397,59.34%,41.23%,1
臺中市,北屯區,0930,841,195,1036,53,1089,1889,57.65%,44.52%,1
臺中市,北屯區,0931,693,203,896,70,966,1728,55.9%,40.1%,1
臺中市,北屯區,0932,650,177,827,67,894,1592,56.16%,40.83%,1
臺中市,北屯區,0933,659,186,845,72,917,1656,55.37%,39.79%,1
臺中市,北屯區,0934,610,163,773,61,834,1524,54.72%,40.03%,1
臺中市,北屯區,0935,628,202,830,43,873,1502,58.12%,41.81%,1
臺中市,北屯區,0936,787,167,954,43,997,1772,56.26%,44.41%,1
臺中市,北屯區,0937,655,163,818,55,873,1461,59.75%,44.83%,1
臺中市,北屯區,0938,689,160,849,33,882,1769,49.86%,38.95%,1
臺中市,北屯區,0939,812,249,1061,63,1124,1894,59.35%,42.87%,1
臺中市,北屯區,0940,807,199,1006,60,1066,2033,52.43%,39.7%,1
臺中市,北屯區,0941,803,214,1017,49,1066,1947,54.75%,41.24%,1
臺中市,北屯區,0942,908,274,1182,73,1255,2188,57.36%,41.5%,1
臺中市,北屯區,0943,757,187,944,64,1008,1661,60.69%,45.57%,1
臺中市,北屯區,0944,715,208,923,43,966,1667,57.95%,42.89%,1
臺中市,北屯區,0945,729,201,930,47,977,1728,56.54%,42.19%,1
臺中市,北屯區,0946,700,162,862,41,903,1688,53.5%,41.47%,1
臺中市,北屯區,0947,660,166,826,28,854,1475,57.9%,44.75%,1
臺中市,北屯區,0948,786,198,984,38,1022,1681,60.8%,46.76%,1
臺中市,北屯區,0949,965,197,1162,53,1215,2078,58.47%,46.44%,1
臺中市,北屯區,0950,902,206,1108,56,1164,2059,56.53%,43.81%,1
臺中市,北屯區,0951,806,171,977,43,1020,1792,56.92%,44.98%,1
臺中市,北屯區,0952,807,199,1006,38,1044,2974,35.1%,27.14%,1
臺中市,北屯區,0953,465,111,576,53,629,1072,58.68%,43.38%,1
臺中市,北屯區,0954,926,203,1129,54,1183,2099,56.36%,44.12%,1
臺中市,北屯區,0955,896,230,1126,51,1177,1823,64.56%,49.15%,1
臺中市,北屯區,0956,938,220,1158,75,1233,2022,60.98%,46.39%,1
臺中市,北屯區,0957,893,204,1097,35,1132,1992,56.83%,44.83%,1
臺中市,北屯區,0958,714,199,913,59,972,1585,61.32%,45.05%,1
臺中市,北屯區,0959,728,182,910,54,964,1565,61.6%,46.52%,1
臺中市,北屯區,0960,663,189,852,42,894,1780,50.22%,37.25%,1
臺中市,北屯區,0961,867,223,1090,57,1147,1874,61.21%,46.26%,1
臺中市,北屯區,0962,861,149,1010,38,1048,1755,59.72%,49.06%,1
臺中市,北屯區,0963,783,172,955,44,999,1497,66.73%,52.3%,1
臺中市,北屯區,0964,775,138,913,65,978,1567,62.41%,49.46%,1
臺中市,北屯區,0965,730,135,865,42,907,1624,55.85%,44.95%,1
臺中市,北屯區,0966,773,169,942,44,986,1614,61.09%,47.89%,1
臺中市,北屯區,0967,721,156,877,34,911,1595,57.12%,45.2%,1
臺中市,北屯區,0968,701,186,887,67,954,1782,53.54%,39.34%,1
臺中市,北屯區,0969,511,141,652,39,691,1357,50.92%,37.66%,1
臺中市,北屯區,0970,456,113,569,57,626,1071,58.45%,42.58%,1
臺中市,北屯區,0971,548,158,706,52,758,1372,55.25%,39.94%,1
臺中市,北屯區,0972,630,160,790,59,849,1415,60%,44.52%,1
臺中市,北屯區,0973,834,195,1029,67,1096,1789,61.26%,46.62%,1
臺中市,北屯區,0974,915,206,1121,73,1194,1907,62.61%,47.98%,1
臺中市,北屯區,0975,909,217,1126,58,1184,2008,58.96%,45.27%,1
臺中市,北屯區,0976,654,172,826,54,880,1541,57.11%,42.44%,1
臺中市,北屯區,0977,746,196,942,50,992,1669,59.44%,44.7%,1
臺中市,北屯區,0978,772,153,925,31,956,1685,56.74%,45.82%,1
臺中市,北屯區,0979,748,229,977,106,1083,1785,60.67%,41.9%,1
臺中市,北屯區,0980,726,183,909,70,979,1596,61.34%,45.49%,1
臺中市,北屯區,0981,756,225,981,66,1047,1731,60.49%,43.67%,1
臺中市,北屯區,0982,607,170,777,73,850,1496,56.82%,40.57%,1
臺中市,豐原區,0394,402,104,506,50,556,983,56.56%,40.9%,1
臺中市,豐原區,0395,539,193,732,46,778,1309,59.43%,41.18%,1
臺中市,豐原區,0396,465,177,642,53,695,1116,62.28%,41.67%,1
臺中市,豐原區,0397,423,134,557,44,601,945,63.6%,44.76%,1
臺中市,豐原區,0398,364,125,489,63,552,850,64.94%,42.82%,1
臺中市,豐原區,0399,362,91,453,35,488,760,64.21%,47.63%,1
臺中市,豐原區,0400,706,189,895,9,904,1617,55.91%,43.66%,1
臺中市,豐原區,0401,675,150,825,59,884,1677,52.71%,40.25%,1
臺中市,豐原區,0402,868,209,1077,41,1118,1771,63.13%,49.01%,1
臺中市,豐原區,0403,435,176,611,49,660,1145,57.64%,37.99%,1
臺中市,豐原區,0404,573,160,733,35,768,1362,56.39%,42.07%,1
臺中市,豐原區,0405,641,152,793,44,837,1389,60.26%,46.15%,1
臺中市,豐原區,0406,698,197,895,46,941,1530,61.5%,45.62%,1
臺中市,豐原區,0407,619,175,794,89,883,1471,60.03%,42.08%,1
臺中市,豐原區,0408,608,178,786,81,867,1410,61.49%,43.12%,1
臺中市,豐原區,0409,478,136,614,58,672,1162,57.83%,41.14%,1
臺中市,豐原區,0410,701,194,895,40,935,1656,56.46%,42.33%,1
臺中市,豐原區,0411,816,179,995,49,1044,1838,56.8%,44.4%,1
臺中市,豐原區,0412,696,195,891,56,947,1666,56.84%,41.78%,1
臺中市,豐原區,0413,847,207,1054,45,1099,1821,60.35%,46.51%,1
臺中市,豐原區,0414,918,228,1146,66,1212,1821,66.56%,50.41%,1
臺中市,豐原區,0415,665,210,875,38,913,1647,55.43%,40.38%,1
臺中市,豐原區,0416,597,163,760,78,838,1256,66.72%,47.53%,1
臺中市,豐原區,0417,733,204,937,61,998,1552,64.3%,47.23%,1
臺中市,豐原區,0418,795,199,994,52,1046,1793,58.34%,44.34%,1
臺中市,豐原區,0419,364,124,488,46,534,759,70.36%,47.96%,1
臺中市,豐原區,0420,266,114,380,42,422,642,65.73%,41.43%,1
臺中市,豐原區,0421,664,201,865,34,899,1528,58.84%,43.46%,1
臺中市,豐原區,0422,855,217,1072,65,1137,1788,63.59%,47.82%,1
臺中市,豐原區,0423,815,186,1001,76,1077,1663,64.76%,49.01%,1
臺中市,豐原區,0424,646,164,810,59,869,1260,68.97%,51.27%,1
臺中市,豐原區,0425,389,96,485,33,518,902,57.43%,43.13%,1
臺中市,豐原區,0426,571,133,704,25,729,1357,53.72%,42.08%,1
臺中市,豐原區,0427,738,188,926,40,966,1592,60.68%,46.36%,1
臺中市,豐原區,0428,824,204,1028,76,1104,1873,58.94%,43.99%,1
臺中市,豐原區,0429,826,167,993,70,1063,1867,56.94%,44.24%,1
臺中市,豐原區,0430,756,214,970,90,1060,1823,58.15%,41.47%,1
臺中市,豐原區,0431,759,208,967,67,1034,1962,52.7%,38.69%,1
臺中市,豐原區,0432,1059,269,1328,88,1416,2313,61.22%,45.78%,1
臺中市,豐原區,0433,687,185,872,63,935,1510,61.92%,45.5%,1
臺中市,豐原區,0434,842,198,1040,61,1101,1824,60.36%,46.16%,1
臺中市,豐原區,0435,600,163,763,48,811,1363,59.5%,44.02%,1
臺中市,豐原區,0436,721,188,909,62,971,1535,63.26%,46.97%,1
臺中市,豐原區,0437,642,213,855,56,911,1457,62.53%,44.06%,1
臺中市,豐原區,0438,521,168,689,44,733,1184,61.91%,44%,1
臺中市,豐原區,0439,838,217,1055,63,1118,2299,48.63%,36.45%,1
臺中市,豐原區,0440,863,211,1074,79,1153,1940,59.43%,44.48%,1
臺中市,豐原區,0441,881,213,1094,44,1138,2067,55.06%,42.62%,1
臺中市,豐原區,0442,831,234,1065,88,1153,2038,56.58%,40.78%,1
臺中市,豐原區,0443,676,6,682,67,749,1835,40.82%,36.84%,1
臺中市,豐原區,0444,845,235,1080,95,1175,1979,59.37%,42.7%,1
臺中市,豐原區,0445,859,190,1049,94,1143,2014,56.75%,42.65%,1
臺中市,豐原區,0446,948,269,1217,98,1315,2257,58.26%,42%,1
臺中市,豐原區,0447,624,197,821,66,887,1406,63.09%,44.38%,1
臺中市,豐原區,0448,648,154,802,51,853,1418,60.16%,45.7%,1
臺中市,豐原區,0449,852,203,1055,59,1114,1772,62.87%,48.08%,1
臺中市,豐原區,0450,553,171,724,38,762,1202,63.39%,46.01%,1
臺中市,豐原區,0451,696,158,854,40,894,1447,61.78%,48.1%,1
臺中市,豐原區,0452,785,218,1003,80,1083,1758,61.6%,44.65%,1
臺中市,豐原區,0453,753,185,938,57,995,1546,64.36%,48.71%,1
臺中市,豐原區,0454,886,184,1070,53,1123,1815,61.87%,48.82%,1
臺中市,豐原區,0455,867,226,1093,62,1155,1932,59.78%,44.88%,1
臺中市,豐原區,0456,878,206,1084,54,1138,1770,64.29%,49.6%,1
臺中市,豐原區,0457,669,153,822,45,867,1560,55.58%,42.88%,1
臺中市,豐原區,0458,805,198,1003,42,1045,1810,57.73%,44.48%,1
臺中市,豐原區,0459,797,189,986,49,1035,1653,62.61%,48.22%,1
臺中市,豐原區,0460,648,152,800,61,861,1444,59.63%,44.88%,1
臺中市,豐原區,0461,637,153,790,47,837,1318,63.51%,48.33%,1
臺中市,豐原區,0462,670,195,865,83,948,1566,60.54%,42.78%,1
臺中市,豐原區,0463,754,201,955,65,1020,1748,58.35%,43.14%,1
臺中市,豐原區,0464,686,206,892,87,979,1772,55.25%,38.71%,1
臺中市,豐原區,0465,715,210,925,87,1012,1721,58.8%,41.55%,1
臺中市,豐原區,0466,689,204,893,55,948,1578,60.08%,43.66%,1
臺中市,豐原區,0467,727,258,985,81,1066,1859,57.34%,39.11%,1
臺中市,豐原區,0468,632,193,825,51,876,1479,59.23%,42.73%,1
臺中市,豐原區,0469,822,222,1044,55,1099,1889,58.18%,43.52%,1
臺中市,豐原區,0470,789,199,988,45,1033,1803,57.29%,43.76%,1
臺中市,豐原區,0471,571,179,750,66,816,1421,57.42%,40.18%,1
臺中市,豐原區,0472,720,197,917,83,1000,1585,63.09%,45.43%,1
臺中市,豐原區,0473,821,207,1028,82,1110,1774,62.57%,46.28%,1
臺中市,豐原區,0474,942,239,1181,74,1255,2132,58.86%,44.18%,1
臺中市,豐原區,0475,655,191,846,59,905,1515,59.74%,43.23%,1
臺中市,豐原區,0476,548,131,679,26,705,1359,51.88%,40.32%,1
臺中市,豐原區,0477,390,155,545,50,595,948,62.76%,41.14%,1
臺中市,豐原區,0478,487,166,653,57,710,1134,62.61%,42.95%,1
臺中市,豐原區,0479,545,148,693,56,749,1114,67.24%,48.92%,1
臺中市,豐原區,0480,438,149,587,50,637,1050,60.67%,41.71%,1
臺中市,豐原區,0481,579,144,723,51,774,1182,65.48%,48.98%,1
臺中市,東勢區,1513,524,128,652,70,722,1299,55.58%,40.34%,1
臺中市,東勢區,1514,386,122,508,55,563,1007,55.91%,38.33%,1
臺中市,東勢區,1515,323,96,419,60,479,859,55.76%,37.6%,1
臺中市,東勢區,1516,432,130,562,86,648,991,65.39%,43.59%,1
臺中市,東勢區,1517,340,73,413,25,438,863,50.75%,39.4%,1
臺中市,東勢區,1518,638,160,798,113,911,1628,55.96%,39.19%,1
臺中市,東勢區,1519,493,150,643,56,699,1335,52.36%,36.93%,1
臺中市,東勢區,1520,516,136,652,47,699,1092,64.01%,47.25%,1
臺中市,東勢區,1521,488,132,620,49,669,1050,63.71%,46.48%,1
臺中市,東勢區,1522,605,151,756,60,816,1431,57.02%,42.28%,1
臺中市,東勢區,1523,632,138,770,55,825,1372,60.13%,46.06%,1
臺中市,東勢區,1524,645,151,796,43,839,1412,59.42%,45.68%,1
臺中市,東勢區,1525,361,76,437,80,517,878,58.88%,41.12%,1
臺中市,東勢區,1526,511,152,663,87,750,1475,50.85%,34.64%,1
臺中市,東勢區,1527,374,70,444,24,468,872,53.67%,42.89%,1
臺中市,東勢區,1528,392,104,496,71,567,1006,56.36%,38.97%,1
臺中市,東勢區,1529,528,124,652,28,680,1222,55.65%,43.21%,1
臺中市,東勢區,1530,573,166,739,70,809,1228,65.88%,46.66%,1
臺中市,東勢區,1531,468,123,591,34,625,1036,60.33%,45.17%,1
臺中市,東勢區,1532,435,128,563,24,587,977,60.08%,44.52%,1
臺中市,東勢區,1533,597,113,710,50,760,1395,54.48%,42.8%,1
臺中市,東勢區,1534,513,138,651,88,739,1169,63.22%,43.88%,1
臺中市,東勢區,1535,473,108,581,61,642,1027,62.51%,46.06%,1
臺中市,東勢區,1536,442,106,548,35,583,984,59.25%,44.92%,1
臺中市,東勢區,1537,464,81,545,42,587,866,67.78%,53.58%,1
臺中市,東勢區,1538,429,105,534,102,636,1031,61.69%,41.61%,1
臺中市,東勢區,1539,431,86,517,58,575,865,66.47%,49.83%,1
臺中市,東勢區,1540,643,149,792,70,862,1357,63.52%,47.38%,1
臺中市,東勢區,1541,344,77,421,30,451,736,61.28%,46.74%,1
臺中市,東勢區,1542,566,147,713,57,770,1314,58.6%,43.07%,1
臺中市,東勢區,1543,608,191,799,109,908,1677,54.14%,36.26%,1
臺中市,東勢區,1544,442,98,540,35,575,950,60.53%,46.53%,1
臺中市,東勢區,1545,463,117,580,45,625,1007,62.07%,45.98%,1
臺中市,東勢區,1546,388,177,565,55,620,1214,51.07%,31.96%,1
臺中市,東勢區,1547,367,118,485,32,517,907,57%,40.46%,1
臺中市,東勢區,1548,366,86,452,46,498,902,55.21%,40.58%,1
臺中市,東勢區,1549,231,76,307,12,319,720,44.31%,32.08%,1
臺中市,東勢區,1550,219,74,293,12,305,666,45.8%,32.88%,1
臺中市,東勢區,1551,537,147,684,59,743,1361,54.59%,39.46%,1
臺中市,大甲區,0001,592,134,726,79,805,1356,59.37%,43.66%,1
臺中市,大甲區,0002,496,123,619,41,660,1059,62.32%,46.84%,1
臺中市,大甲區,0003,295,105,400,41,441,694,63.54%,42.51%,1
臺中市,大甲區,0004,365,121,486,30,516,874,59.04%,41.76%,1
臺中市,大甲區,0005,315,93,408,21,429,763,56.23%,41.28%,1
臺中市,大甲區,0006,402,102,504,43,547,856,63.9%,46.96%,1
臺中市,大甲區,0007,557,130,687,42,729,1249,58.37%,44.6%,1
臺中市,大甲區,0008,363,103,466,32,498,922,54.01%,39.37%,1
臺中市,大甲區,0009,502,146,648,47,695,1189,58.45%,42.22%,1
臺中市,大甲區,0010,503,113,616,67,683,1065,64.13%,47.23%,1
臺中市,大甲區,0011,578,143,721,80,801,1252,63.98%,46.17%,1
臺中市,大甲區,0012,432,124,556,47,603,1057,57.05%,40.87%,1
臺中市,大甲區,0013,447,113,560,28,588,1031,57.03%,43.36%,1
臺中市,大甲區,0014,473,146,619,48,667,1060,62.92%,44.62%,1
臺中市,大甲區,0015,566,145,711,55,766,1311,58.43%,43.17%,1
臺中市,大甲區,0016,624,143,767,53,820,1424,57.58%,43.82%,1
臺中市,大甲區,0017,742,79,821,57,878,1670,52.57%,44.43%,1
臺中市,大甲區,0018,346,84,430,46,476,812,58.62%,42.61%,1
臺中市,大甲區,0019,386,91,477,30,507,863,58.75%,44.73%,1
臺中市,大甲區,0020,714,190,904,44,948,1598,59.32%,44.68%,1
臺中市,大甲區,0021,707,145,852,48,900,1588,56.68%,44.52%,1
臺中市,大甲區,0022,512,127,639,55,694,1197,57.98%,42.77%,1
臺中市,大甲區,0023,385,137,522,90,612,1106,55.33%,34.81%,1
臺中市,大甲區,0024,413,104,517,50,567,903,62.79%,45.74%,1
臺中市,大甲區,0025,394,105,499,42,541,869,62.26%,45.34%,1
臺中市,大甲區,0026,544,194,738,36,774,1350,57.33%,40.3%,1
臺中市,大甲區,0027,463,133,596,92,688,1144,60.14%,40.47%,1
臺中市,大甲區,0028,533,150,683,49,732,1208,60.6%,44.12%,1
臺中市,大甲區,0029,663,196,859,37,896,1567,57.18%,42.31%,1
臺中市,大甲區,0030,611,139,750,36,786,1246,63.08%,49.04%,1
臺中市,大甲區,0031,388,91,479,37,516,767,67.28%,50.59%,1
臺中市,大甲區,0032,332,101,433,47,480,790,60.76%,42.03%,1
臺中市,大甲區,0033,464,79,543,37,580,972,59.67%,47.74%,1
臺中市,大甲區,0034,561,147,708,56,764,1388,55.04%,40.42%,1
臺中市,大甲區,0035,523,137,660,41,701,1331,52.67%,39.29%,1
臺中市,大甲區,0036,547,133,680,43,723,1167,61.95%,46.87%,1
臺中市,大甲區,0037,836,208,1044,50,1094,1934,56.57%,43.23%,1
臺中市,大甲區,0038,477,128,605,49,654,1263,51.78%,37.77%,1
臺中市,大甲區,0039,583,160,743,50,793,1390,57.05%,41.94%,1
臺中市,大甲區,0040,406,114,520,40,560,1186,47.22%,34.23%,1
臺中市,大甲區,0041,570,162,732,39,771,1397,55.19%,40.8%,1
臺中市,大甲區,0042,389,87,476,20,496,1173,42.28%,33.16%,1
臺中市,大甲區,0043,528,158,686,86,772,1398,55.22%,37.77%,1
臺中市,大甲區,0044,456,134,590,49,639,1228,52.04%,37.13%,1
臺中市,大甲區,0045,487,141,628,53,681,1258,54.13%,38.71%,1
臺中市,大甲區,0046,609,47,656,29,685,1435,47.74%,42.44%,1
臺中市,大甲區,0047,596,190,786,50,836,1532,54.57%,38.9%,1
臺中市,大甲區,0048,280,55,335,41,376,652,57.67%,42.94%,1
臺中市,大甲區,0049,301,89,390,34,424,870,48.74%,34.6%,1
臺中市,大甲區,0050,328,99,427,31,458,891,51.4%,36.81%,1
臺中市,大甲區,0051,307,115,422,31,453,784,57.78%,39.16%,1
臺中市,大甲區,0052,532,124,656,88,744,1368,54.39%,38.89%,1
臺中市,大甲區,0053,437,113,550,53,603,1126,53.55%,38.81%,1
臺中市,大甲區,0054,498,153,651,81,732,1486,49.26%,33.51%,1
臺中市,清水區,0091,430,121,551,30,581,1076,54%,39.96%,1
臺中市,清水區,0092,448,127,575,50,625,953,65.58%,47.01%,1
臺中市,清水區,0093,384,129,513,54,567,914,62.04%,42.01%,1
臺中市,清水區,0094,551,125,676,54,730,1143,63.87%,48.21%,1
臺中市,清水區,0095,303,96,399,26,425,680,62.5%,44.56%,1
臺中市,清水區,0096,419,105,524,38,562,904,62.17%,46.35%,1
臺中市,清水區,0097,413,115,528,47,575,893,64.39%,46.25%,1
臺中市,清水區,0098,682,195,877,42,919,1577,58.28%,43.25%,1
臺中市,清水區,0099,310,71,381,25,406,690,58.84%,44.93%,1
臺中市,清水區,0100,169,51,220,26,246,403,61.04%,41.94%,1
臺中市,清水區,0101,609,162,771,70,841,1413,59.52%,43.1%,1
臺中市,清水區,0102,309,104,413,45,458,777,58.94%,39.77%,1
臺中市,清水區,0103,592,145,737,50,787,1313,59.94%,45.09%,1
臺中市,清水區,0104,579,243,822,51,873,1439,60.67%,40.24%,1
臺中市,清水區,0105,527,126,653,27,680,1265,53.75%,41.66%,1
臺中市,清水區,0106,626,133,759,40,799,1277,62.57%,49.02%,1
臺中市,清水區,0107,612,106,718,49,767,1276,60.11%,47.96%,1
臺中市,清水區,0108,688,141,829,37,866,1376,62.94%,50%,1
臺中市,清水區,0109,650,128,778,27,805,1291,62.35%,50.35%,1
臺中市,清水區,0110,669,189,858,61,919,1510,60.86%,44.3%,1
臺中市,清水區,0111,764,70,834,74,908,1524,59.58%,50.13%,1
臺中市,清水區,0112,602,145,747,36,783,1474,53.12%,40.84%,1
臺中市,清水區,0113,661,146,807,53,860,1507,57.07%,43.86%,1
臺中市,清水區,0114,628,161,789,72,861,1321,65.18%,47.54%,1
臺中市,清水區,0115,437,133,570,36,606,1157,52.38%,37.77%,1
臺中市,清水區,0116,583,123,706,44,750,1255,59.76%,46.45%,1
臺中市,清水區,0117,347,115,462,35,497,881,56.41%,39.39%,1
臺中市,清水區,0118,507,110,617,52,669,1083,61.77%,46.81%,1
臺中市,清水區,0119,437,110,547,31,578,951,60.78%,45.95%,1
臺中市,清水區,0120,587,153,740,41,781,1424,54.85%,41.22%,1
臺中市,清水區,0121,455,155,610,65,675,1233,54.74%,36.9%,1
臺中市,清水區,0122,448,126,574,54,628,1288,48.76%,34.78%,1
臺中市,清水區,0123,600,126,726,50,776,1200,64.67%,50%,1
臺中市,清水區,0124,782,132,914,45,959,1609,59.6%,48.6%,1
臺中市,清水區,0125,547,139,686,22,708,1136,62.32%,48.15%,1
臺中市,清水區,0126,526,141,667,56,723,1302,55.53%,40.4%,1
臺中市,清水區,0127,538,159,697,71,768,1373,55.94%,39.18%,1
臺中市,清水區,0128,443,144,587,69,656,1257,52.19%,35.24%,1
臺中市,清水區,0129,449,102,551,64,615,1184,51.94%,37.92%,1
臺中市,清水區,0130,554,133,687,62,749,1322,56.66%,41.91%,1
臺中市,清水區,0131,448,134,582,50,632,1193,52.98%,37.55%,1
臺中市,清水區,0132,357,118,475,67,542,927,58.47%,38.51%,1
臺中市,清水區,0133,469,150,619,50,669,1073,62.35%,43.71%,1
臺中市,清水區,0134,494,156,650,68,718,1163,61.74%,42.48%,1
臺中市,清水區,0135,319,106,425,52,477,855,55.79%,37.31%,1
臺中市,清水區,0136,324,114,438,66,504,902,55.88%,35.92%,1
臺中市,清水區,0137,605,152,757,59,816,1415,57.67%,42.76%,1
臺中市,清水區,0138,419,124,543,35,578,1066,54.22%,39.31%,1
臺中市,清水區,0139,555,160,715,68,783,1391,56.29%,39.9%,1
臺中市,清水區,0140,593,127,720,43,763,1449,52.66%,40.92%,1
臺中市,清水區,0141,598,165,763,63,826,1377,59.99%,43.43%,1
臺中市,清水區,0142,640,141,781,59,840,1423,59.03%,44.98%,1
臺中市,清水區,0143,724,168,892,44,936,1624,57.64%,44.58%,1
臺中市,清水區,0144,327,356,683,72,755,1358,55.6%,24.08%,1
臺中市,清水區,0145,618,133,751,102,853,1464,58.27%,42.21%,1
臺中市,清水區,0146,523,156,679,68,747,1211,61.68%,43.19%,1
臺中市,清水區,0147,593,139,732,28,760,1456,52.2%,40.73%,1
臺中市,清水區,0148,538,106,644,83,727,1162,62.56%,46.3%,1
臺中市,清水區,0149,682,140,822,60,882,1368,64.47%,49.85%,1
臺中市,沙鹿區,0186,677,23,700,38,738,1380,53.48%,49.06%,1
臺中市,沙鹿區,0187,371,108,479,41,520,852,61.03%,43.54%,1
臺中市,沙鹿區,0188,564,119,683,40,723,1176,61.48%,47.96%,1
臺中市,沙鹿區,0189,414,166,580,67,647,958,67.54%,43.22%,1
臺中市,沙鹿區,0190,241,68,309,30,339,488,69.47%,49.39%,1
臺中市,沙鹿區,0191,494,152,646,43,689,1177,58.54%,41.97%,1
臺中市,沙鹿區,0192,523,162,685,55,740,1285,57.59%,40.7%,1
臺中市,沙鹿區,0193,652,198,850,82,932,1736,53.69%,37.56%,1
臺中市,沙鹿區,0194,691,232,923,74,997,1628,61.24%,42.44%,1
臺中市,沙鹿區,0195,615,143,758,36,794,1469,54.05%,41.87%,1
臺中市,沙鹿區,0196,656,173,829,43,872,1423,61.28%,46.1%,1
臺中市,沙鹿區,0197,622,156,778,82,860,1444,59.56%,43.07%,1
臺中市,沙鹿區,0198,641,138,779,78,857,1469,58.34%,43.64%,1
臺中市,沙鹿區,0199,815,193,1008,89,1097,1902,57.68%,42.85%,1
臺中市,沙鹿區,0200,745,192,937,48,985,1675,58.81%,44.48%,1
臺中市,沙鹿區,0201,444,143,587,48,635,1098,57.83%,40.44%,1
臺中市,沙鹿區,0202,659,202,861,74,935,1539,60.75%,42.82%,1
臺中市,沙鹿區,0203,595,153,748,38,786,1329,59.14%,44.77%,1
臺中市,沙鹿區,0204,523,135,658,48,706,1255,56.25%,41.67%,1
臺中市,沙鹿區,0205,742,90,832,69,901,1507,59.79%,49.24%,1
臺中市,沙鹿區,0206,604,201,805,86,891,1463,60.9%,41.29%,1
臺中市,沙鹿區,0207,509,127,636,70,706,1279,55.2%,39.8%,1
臺中市,沙鹿區,0208,405,90,495,39,534,1024,52.15%,39.55%,1
臺中市,沙鹿區,0209,565,114,679,74,753,1388,54.25%,40.71%,1
臺中市,沙鹿區,0210,477,141,618,36,654,1074,60.89%,44.41%,1
臺中市,沙鹿區,0211,501,115,616,34,650,1072,60.63%,46.74%,1
臺中市,沙鹿區,0212,505,118,623,64,687,1107,62.06%,45.62%,1
臺中市,沙鹿區,0213,775,165,940,45,985,1947,50.59%,39.8%,1
臺中市,沙鹿區,0214,671,161,832,70,902,1682,53.63%,39.89%,1
臺中市,沙鹿區,0215,728,170,898,54,952,1633,58.3%,44.58%,1
臺中市,沙鹿區,0216,595,148,743,59,802,1533,52.32%,38.81%,1
臺中市,沙鹿區,0217,557,151,708,43,751,1605,46.79%,34.7%,1
臺中市,沙鹿區,0218,674,163,837,27,864,1694,51%,39.79%,1
臺中市,沙鹿區,0219,666,158,824,50,874,1628,53.69%,40.91%,1
臺中市,沙鹿區,0220,771,172,943,21,964,1665,57.9%,46.31%,1
臺中市,沙鹿區,0221,680,175,855,51,906,1651,54.88%,41.19%,1
臺中市,沙鹿區,0222,531,131,662,11,673,1108,60.74%,47.92%,1
臺中市,沙鹿區,0223,548,121,669,36,705,1142,61.73%,47.99%,1
臺中市,沙鹿區,0224,457,110,567,31,598,1039,57.56%,43.98%,1
臺中市,沙鹿區,0225,780,167,947,66,1013,1840,55.05%,42.39%,1
臺中市,沙鹿區,0226,801,191,992,45,1037,1872,55.4%,42.79%,1
臺中市,沙鹿區,0227,622,159,781,60,841,1558,53.98%,39.92%,1
臺中市,沙鹿區,0228,698,155,853,45,898,1739,51.64%,40.14%,1
臺中市,沙鹿區,0229,633,163,796,46,842,1672,50.36%,37.86%,1
臺中市,沙鹿區,0230,701,163,864,47,911,1634,55.75%,42.9%,1
臺中市,沙鹿區,0231,631,149,780,46,826,1616,51.11%,39.05%,1
臺中市,沙鹿區,0232,666,193,859,46,905,1593,56.81%,41.81%,1
臺中市,沙鹿區,0233,387,110,497,28,525,981,53.52%,39.45%,1
臺中市,沙鹿區,0234,801,167,968,54,1022,1740,58.74%,46.03%,1
臺中市,沙鹿區,0235,542,161,703,60,763,1247,61.19%,43.46%,1
臺中市,沙鹿區,0236,485,99,584,20,604,1047,57.69%,46.32%,1
臺中市,沙鹿區,0237,453,139,592,74,666,1119,59.52%,40.48%,1
臺中市,沙鹿區,0238,421,102,523,21,544,1025,53.07%,41.07%,1
臺中市,梧棲區,0150,629,177,806,63,869,1541,56.39%,40.82%,1
臺中市,梧棲區,0151,541,289,830,51,881,1581,55.72%,34.22%,1
臺中市,梧棲區,0152,464,129,593,43,636,1083,58.73%,42.84%,1
臺中市,梧棲區,0153,401,95,496,32,528,876,60.27%,45.78%,1
臺中市,梧棲區,0154,412,137,549,69,618,1043,59.25%,39.5%,1
臺中市,梧棲區,0155,609,138,747,33,780,1502,51.93%,40.55%,1
臺中市,梧棲區,0156,599,137,736,53,789,1384,57.01%,43.28%,1
臺中市,梧棲區,0157,244,69,313,32,345,517,66.73%,47.2%,1
臺中市,梧棲區,0158,574,115,689,59,748,1169,63.99%,49.1%,1
臺中市,梧棲區,0159,363,129,492,32,524,863,60.72%,42.06%,1
臺中市,梧棲區,0160,477,126,603,40,643,1277,50.35%,37.35%,1
臺中市,梧棲區,0161,623,267,890,49,939,1742,53.9%,35.76%,1
臺中市,梧棲區,0162,582,158,740,49,789,1342,58.79%,43.37%,1
臺中市,梧棲區,0163,713,227,940,83,1023,1767,57.89%,40.35%,1
臺中市,梧棲區,0164,564,162,726,56,782,1542,50.71%,36.58%,1
臺中市,梧棲區,0165,682,168,850,47,897,1636,54.83%,41.69%,1
臺中市,梧棲區,0166,702,170,872,67,939,1796,52.28%,39.09%,1
臺中市,梧棲區,0167,579,161,740,57,797,1450,54.97%,39.93%,1
臺中市,梧棲區,0168,570,157,727,122,849,1548,54.84%,36.82%,1
臺中市,梧棲區,0169,636,130,766,37,803,1366,58.78%,46.56%,1
臺中市,梧棲區,0170,474,97,571,41,612,955,64.08%,49.63%,1
臺中市,梧棲區,0171,517,146,663,54,717,1305,54.94%,39.62%,1
臺中市,梧棲區,0172,552,136,688,39,727,1239,58.68%,44.55%,1
臺中市,梧棲區,0173,485,120,605,62,667,1079,61.82%,44.95%,1
臺中市,梧棲區,0174,531,113,644,35,679,1220,55.66%,43.52%,1
臺中市,梧棲區,0175,703,166,869,62,931,1544,60.3%,45.53%,1
臺中市,梧棲區,0176,634,188,822,57,879,1460,60.21%,43.42%,1
臺中市,梧棲區,0177,586,142,728,57,785,1292,60.76%,45.36%,1
臺中市,梧棲區,0178,542,132,674,65,739,1300,56.85%,41.69%,1
臺中市,梧棲區,0179,625,163,788,47,835,1555,53.7%,40.19%,1
臺中市,梧棲區,0180,421,107,528,45,573,1031,55.58%,40.83%,1
臺中市,梧棲區,0181,573,128,701,65,766,1277,59.98%,44.87%,1
臺中市,梧棲區,0182,409,125,534,41,575,1037,55.45%,39.44%,1
臺中市,梧棲區,0183,515,133,648,57,705,1187,59.39%,43.39%,1
臺中市,梧棲區,0184,573,137,710,42,752,1399,53.75%,40.96%,1
臺中市,梧棲區,0185,500,93,593,45,638,1135,56.21%,44.05%,1
臺中市,后里區,0357,398,100,498,45,543,852,63.73%,46.71%,1
臺中市,后里區,0358,455,133,588,60,648,1135,57.09%,40.09%,1
臺中市,后里區,0359,406,118,524,52,576,1079,53.38%,37.63%,1
臺中市,后里區,0360,680,168,848,62,910,1539,59.13%,44.18%,1
臺中市,后里區,0361,669,189,858,67,925,1591,58.14%,42.05%,1
臺中市,后里區,0362,561,112,673,41,714,1376,51.89%,40.77%,1
臺中市,后里區,0363,538,142,680,34,714,1298,55.01%,41.45%,1
臺中市,后里區,0364,619,148,767,83,850,1428,59.52%,43.35%,1
臺中市,后里區,0365,581,145,726,57,783,1178,66.47%,49.32%,1
臺中市,后里區,0366,463,147,610,47,657,1095,60%,42.28%,1
臺中市,后里區,0367,394,114,508,25,533,963,55.35%,40.91%,1
臺中市,后里區,0368,485,127,612,46,658,1163,56.58%,41.7%,1
臺中市,后里區,0369,461,119,580,39,619,1018,60.81%,45.28%,1
臺中市,后里區,0370,415,95,510,40,550,854,64.4%,48.59%,1
臺中市,后里區,0371,614,150,764,49,813,1485,54.75%,41.35%,1
臺中市,后里區,0372,669,133,802,56,858,1355,63.32%,49.37%,1
臺中市,后里區,0373,325,91,416,50,466,840,55.48%,38.69%,1
臺中市,后里區,0374,517,122,639,48,687,1146,59.95%,45.11%,1
臺中市,后里區,0375,754,201,955,66,1021,1669,61.17%,45.18%,1
臺中市,后里區,0376,539,406,945,96,1041,1673,62.22%,32.22%,1
臺中市,后里區,0377,661,156,817,48,865,1493,57.94%,44.27%,1
臺中市,后里區,0378,458,128,586,65,651,1052,61.88%,43.54%,1
臺中市,后里區,0379,364,94,458,21,479,909,52.7%,40.04%,1
臺中市,后里區,0380,466,135,601,68,669,1091,61.32%,42.71%,1
臺中市,后里區,0381,602,152,754,65,819,1342,61.03%,44.86%,1
臺中市,后里區,0382,444,136,580,60,640,1138,56.24%,39.02%,1
臺中市,后里區,0383,434,115,549,41,590,977,60.39%,44.42%,1
臺中市,后里區,0384,577,133,710,35,745,1584,47.03%,36.43%,1
臺中市,后里區,0385,390,103,493,30,523,915,57.16%,42.62%,1
臺中市,后里區,0386,529,149,678,59,737,1225,60.16%,43.18%,1
臺中市,后里區,0387,669,144,813,41,854,1552,55.03%,43.11%,1
臺中市,后里區,0388,699,150,849,26,875,1600,54.69%,43.69%,1
臺中市,后里區,0389,396,105,501,31,532,942,56.48%,42.04%,1
臺中市,后里區,0390,383,110,493,31,524,943,55.57%,40.62%,1
臺中市,后里區,0391,407,112,519,40,559,1055,52.99%,38.58%,1
臺中市,后里區,0392,439,132,571,59,630,1067,59.04%,41.14%,1
臺中市,后里區,0393,517,150,667,59,726,1340,54.18%,38.58%,1
臺中市,神岡區,0482,771,166,937,61,998,1684,59.26%,45.78%,1
臺中市,神岡區,0483,676,194,870,49,919,1559,58.95%,43.36%,1
臺中市,神岡區,0484,466,116,582,34,616,1095,56.26%,42.56%,1
臺中市,神岡區,0485,526,133,659,50,709,1044,67.91%,50.38%,1
臺中市,神岡區,0486,609,175,784,69,853,1310,65.11%,46.49%,1
臺中市,神岡區,0487,556,181,737,91,828,1294,63.99%,42.97%,1
臺中市,神岡區,0488,493,138,631,56,687,1143,60.1%,43.13%,1
臺中市,神岡區,0489,437,145,582,51,633,1022,61.94%,42.76%,1
臺中市,神岡區,0490,494,148,642,51,693,1269,54.61%,38.93%,1
臺中市,神岡區,0491,393,95,488,21,509,1085,46.91%,36.22%,1
臺中市,神岡區,0492,395,130,525,67,592,942,62.85%,41.93%,1
臺中市,神岡區,0493,467,143,610,32,642,1154,55.63%,40.47%,1
臺中市,神岡區,0494,534,183,717,55,772,1390,55.54%,38.42%,1
臺中市,神岡區,0495,594,185,779,89,868,1372,63.27%,43.29%,1
臺中市,神岡區,0496,481,160,641,42,683,1328,51.43%,36.22%,1
臺中市,神岡區,0497,412,130,542,23,565,1038,54.43%,39.69%,1
臺中市,神岡區,0498,582,167,749,39,788,1452,54.27%,40.08%,1
臺中市,神岡區,0499,697,180,877,76,953,1551,61.44%,44.94%,1
臺中市,神岡區,0500,653,139,792,66,858,1567,54.75%,41.67%,1
臺中市,神岡區,0501,634,167,801,42,843,1449,58.18%,43.75%,1
臺中市,神岡區,0502,481,132,613,29,642,1246,51.52%,38.6%,1
臺中市,神岡區,0503,638,142,780,66,846,1431,59.12%,44.58%,1
臺中市,神岡區,0504,540,135,675,60,735,1163,63.2%,46.43%,1
臺中市,神岡區,0505,644,188,832,63,895,1402,63.84%,45.93%,1
臺中市,神岡區,0506,556,150,706,43,749,1271,58.93%,43.75%,1
臺中市,神岡區,0507,536,137,673,51,724,1198,60.43%,44.74%,1
臺中市,神岡區,0508,601,135,736,69,805,1312,61.36%,45.81%,1
臺中市,神岡區,0509,651,184,835,69,904,1590,56.86%,40.94%,1
臺中市,神岡區,0510,536,159,695,29,724,1324,54.68%,40.48%,1
臺中市,神岡區,0511,585,133,718,41,759,1415,53.64%,41.34%,1
臺中市,神岡區,0512,687,199,886,54,940,1483,63.39%,46.33%,1
臺中市,神岡區,0513,550,145,695,38,733,1402,52.28%,39.23%,1
臺中市,神岡區,0514,529,137,666,44,710,1275,55.69%,41.49%,1
臺中市,神岡區,0515,480,167,647,58,705,1288,54.74%,37.27%,1
臺中市,神岡區,0516,431,131,562,53,615,1080,56.94%,39.91%,1
臺中市,神岡區,0517,550,140,690,28,718,1344,53.42%,40.92%,1
臺中市,神岡區,0518,478,127,605,60,665,1061,62.68%,45.05%,1
臺中市,神岡區,0519,530,164,694,50,744,1176,63.27%,45.07%,1
臺中市,神岡區,0520,534,181,715,62,777,1244,62.46%,42.93%,1
臺中市,神岡區,0521,632,159,791,61,852,1318,64.64%,47.95%,1
臺中市,神岡區,0522,587,163,750,51,801,1471,54.45%,39.9%,1
臺中市,神岡區,0523,619,168,787,88,875,1323,66.14%,46.79%,1
臺中市,潭子區,0570,593,142,735,51,786,1306,60.18%,45.41%,1
臺中市,潭子區,0571,502,143,645,43,688,1128,60.99%,44.5%,1
臺中市,潭子區,0572,557,131,688,58,746,1159,64.37%,48.06%,1
臺中市,潭子區,0573,745,191,936,67,1003,1630,61.53%,45.71%,1
臺中市,潭子區,0574,691,146,837,39,876,1532,57.18%,45.1%,1
臺中市,潭子區,0575,637,192,829,39,868,1677,51.76%,37.98%,1
臺中市,潭子區,0576,704,165,869,55,924,1744,52.98%,40.37%,1
臺中市,潭子區,0577,854,122,976,57,1033,1795,57.55%,47.58%,1
臺中市,潭子區,0578,501,129,630,41,671,1171,57.3%,42.78%,1
臺中市,潭子區,0579,628,150,778,38,816,1427,57.18%,44.01%,1
臺中市,潭子區,0580,724,218,942,63,1005,1709,58.81%,42.36%,1
臺中市,潭子區,0581,751,187,938,40,978,1723,56.76%,43.59%,1
臺中市,潭子區,0582,730,203,933,51,984,1782,55.22%,40.97%,1
臺中市,潭子區,0583,593,136,729,39,768,1407,54.58%,42.15%,1
臺中市,潭子區,0584,771,199,970,35,1005,1771,56.75%,43.53%,1
臺中市,潭子區,0585,794,200,994,90,1084,1795,60.39%,44.23%,1
臺中市,潭子區,0586,762,193,955,54,1009,1612,62.59%,47.27%,1
臺中市,潭子區,0587,692,207,899,40,939,1894,49.58%,36.54%,1
臺中市,潭子區,0588,611,191,802,47,849,1689,50.27%,36.18%,1
臺中市,潭子區,0589,579,162,741,51,792,1525,51.93%,37.97%,1
臺中市,潭子區,0590,700,179,879,45,924,1622,56.97%,43.16%,1
臺中市,潭子區,0591,537,128,665,60,725,1200,60.42%,44.75%,1
臺中市,潭子區,0592,567,138,705,16,721,1355,53.21%,41.85%,1
臺中市,潭子區,0593,732,194,926,36,962,1777,54.14%,41.19%,1
臺中市,潭子區,0594,850,200,1050,34,1084,1923,56.37%,44.2%,1
臺中市,潭子區,0595,697,160,857,64,921,1674,55.02%,41.64%,1
臺中市,潭子區,0596,694,160,854,53,907,1451,62.51%,47.83%,1
臺中市,潭子區,0597,649,169,818,55,873,1486,58.75%,43.67%,1
臺中市,潭子區,0598,660,191,851,56,907,1511,60.03%,43.68%,1
臺中市,潭子區,0599,791,155,946,48,994,1666,59.66%,47.48%,1
臺中市,潭子區,0600,722,202,924,63,987,1750,56.4%,41.26%,1
臺中市,潭子區,0601,639,124,763,47,810,1437,56.37%,44.47%,1
臺中市,潭子區,0602,765,163,928,45,973,1735,56.08%,44.09%,1
臺中市,潭子區,0603,632,225,857,54,911,1612,56.51%,39.21%,1
臺中市,潭子區,0604,557,112,669,37,706,1143,61.77%,48.73%,1
臺中市,潭子區,0605,857,216,1073,47,1120,2096,53.44%,40.89%,1
臺中市,潭子區,0606,679,194,873,63,936,1549,60.43%,43.83%,1
臺中市,潭子區,0607,685,175,860,33,893,1573,56.77%,43.55%,1
臺中市,潭子區,0608,649,150,799,40,839,1585,52.93%,40.95%,1
臺中市,潭子區,0609,678,167,845,40,885,1572,56.3%,43.13%,1
臺中市,潭子區,0610,830,166,996,42,1038,1738,59.72%,47.76%,1
臺中市,潭子區,0611,776,201,977,71,1048,1883,55.66%,41.21%,1
臺中市,潭子區,0612,598,178,776,31,807,1401,57.6%,42.68%,1
臺中市,潭子區,0613,611,168,779,53,832,1352,61.54%,45.19%,1
臺中市,潭子區,0614,914,235,1149,87,1236,2085,59.28%,43.84%,1
臺中市,潭子區,0615,941,216,1157,84,1241,2047,60.63%,45.97%,1
臺中市,潭子區,0616,667,181,848,31,879,1673,52.54%,39.87%,1
臺中市,潭子區,0617,785,233,1018,98,1116,1874,59.55%,41.89%,1
臺中市,潭子區,0618,423,146,569,65,634,1051,60.32%,40.25%,1
臺中市,潭子區,0619,659,180,839,43,882,1674,52.69%,39.37%,1
臺中市,潭子區,0620,779,230,1009,71,1080,1831,58.98%,42.55%,1
臺中市,潭子區,0621,787,229,1016,66,1082,2003,54.02%,39.29%,1
臺中市,潭子區,0622,654,161,815,48,863,1535,56.22%,42.61%,1
臺中市,潭子區,0623,842,223,1065,105,1170,2286,51.18%,36.83%,1
臺中市,潭子區,0624,759,181,940,57,997,1861,53.57%,40.78%,1
臺中市,大雅區,0524,878,221,1099,73,1172,2027,57.82%,43.32%,1
臺中市,大雅區,0525,752,199,951,36,987,1967,50.18%,38.23%,1
臺中市,大雅區,0526,798,179,977,48,1025,1912,53.61%,41.74%,1
臺中市,大雅區,0527,720,179,899,43,942,1537,61.29%,46.84%,1
臺中市,大雅區,0528,637,177,814,59,873,1439,60.67%,44.27%,1
臺中市,大雅區,0529,624,166,790,48,838,1402,59.77%,44.51%,1
臺中市,大雅區,0530,842,202,1044,71,1115,2013,55.39%,41.83%,1
臺中市,大雅區,0531,834,211,1045,74,1119,1917,58.37%,43.51%,1
臺中市,大雅區,0532,830,216,1046,52,1098,2011,54.6%,41.27%,1
臺中市,大雅區,0533,877,159,1036,47,1083,1887,57.39%,46.48%,1
臺中市,大雅區,0534,668,179,847,58,905,1480,61.15%,45.14%,1
臺中市,大雅區,0535,771,204,975,57,1032,1816,56.83%,42.46%,1
臺中市,大雅區,0536,718,176,894,93,987,1898,52%,37.83%,1
臺中市,大雅區,0537,952,128,1080,68,1148,2008,57.17%,47.41%,1
臺中市,大雅區,0538,892,200,1092,54,1146,1976,58%,45.14%,1
臺中市,大雅區,0539,743,181,924,50,974,1673,58.22%,44.41%,1
臺中市,大雅區,0540,658,171,829,39,868,1409,61.6%,46.7%,1
臺中市,大雅區,0541,754,25,779,25,804,1382,58.18%,54.56%,1
臺中市,大雅區,0542,693,168,861,70,931,1635,56.94%,42.39%,1
臺中市,大雅區,0543,717,163,880,51,931,1565,59.49%,45.81%,1
臺中市,大雅區,0544,606,179,785,52,837,1528,54.78%,39.66%,1
臺中市,大雅區,0545,773,181,954,35,989,1963,50.38%,39.38%,1
臺中市,大雅區,0546,808,203,1011,49,1060,2073,51.13%,38.98%,1
臺中市,大雅區,0547,817,215,1032,64,1096,1984,55.24%,41.18%,1
臺中市,大雅區,0548,712,170,882,59,941,1688,55.75%,42.18%,1
臺中市,大雅區,0549,603,172,775,52,827,1387,59.63%,43.48%,1
臺中市,大雅區,0550,771,176,947,85,1032,1701,60.67%,45.33%,1
臺中市,大雅區,0551,739,170,909,59,968,1721,56.25%,42.94%,1
臺中市,大雅區,0552,658,150,808,56,864,1879,45.98%,35.02%,1
臺中市,大雅區,0553,754,182,936,69,1005,1568,64.09%,48.09%,1
臺中市,大雅區,0554,710,219,929,81,1010,1761,57.35%,40.32%,1
臺中市,大雅區,0555,781,185,966,103,1069,1752,61.02%,44.58%,1
臺中市,大雅區,0556,578,136,714,46,760,1264,60.13%,45.73%,1
臺中市,大雅區,0557,613,133,746,40,786,1302,60.37%,47.08%,1
臺中市,大雅區,0558,626,152,778,55,833,1449,57.49%,43.2%,1
臺中市,大雅區,0559,724,190,914,82,996,1621,61.44%,44.66%,1
臺中市,大雅區,0560,668,170,838,81,919,1647,55.8%,40.56%,1
臺中市,大雅區,0561,609,135,744,39,783,1441,54.34%,42.26%,1
臺中市,大雅區,0562,617,147,764,30,794,1460,54.38%,42.26%,1
臺中市,大雅區,0563,836,224,1060,66,1126,1832,61.46%,45.63%,1
臺中市,大雅區,0564,631,171,802,69,871,1371,63.53%,46.02%,1
臺中市,大雅區,0565,534,142,676,11,687,1418,48.45%,37.66%,1
臺中市,大雅區,0566,681,148,829,34,863,1473,58.59%,46.23%,1
臺中市,大雅區,0567,582,148,730,63,793,1335,59.4%,43.6%,1
臺中市,大雅區,0568,750,163,913,66,979,1733,56.49%,43.28%,1
臺中市,大雅區,0569,695,165,860,103,963,1884,51.11%,36.89%,1
臺中市,新社區,1562,429,106,535,25,560,1011,55.39%,42.43%,1
臺中市,新社區,1563,503,134,637,39,676,1195,56.57%,42.09%,1
臺中市,新社區,1564,504,103,607,23,630,1053,59.83%,47.86%,1
臺中市,新社區,1565,291,91,382,21,403,961,41.94%,30.28%,1
臺中市,新社區,1566,372,85,457,16,473,919,51.47%,40.48%,1
臺中市,新社區,1567,622,151,773,64,837,1367,61.23%,45.5%,1
臺中市,新社區,1568,369,115,484,41,525,1010,51.98%,36.53%,1
臺中市,新社區,1569,388,117,505,53,558,1169,47.73%,33.19%,1
臺中市,新社區,1570,387,121,508,55,563,989,56.93%,39.13%,1
臺中市,新社區,1571,377,70,447,21,468,894,52.35%,42.17%,1
臺中市,新社區,1572,415,90,505,28,533,1033,51.6%,40.17%,1
臺中市,新社區,1573,335,70,405,32,437,1058,41.3%,31.66%,1
臺中市,新社區,1574,301,84,385,17,402,845,47.57%,35.62%,1
臺中市,新社區,1575,285,74,359,33,392,576,68.06%,49.48%,1
臺中市,新社區,1576,450,115,565,60,625,1229,50.85%,36.62%,1
臺中市,新社區,1577,285,85,370,34,404,890,45.39%,32.02%,1
臺中市,新社區,1578,275,90,365,30,395,781,50.58%,35.21%,1
臺中市,新社區,1579,505,113,618,61,679,1244,54.58%,40.59%,1
臺中市,新社區,1580,51,18,69,10,79,213,37.09%,23.94%,1
臺中市,新社區,1581,216,66,282,27,309,676,45.71%,31.95%,1
臺中市,新社區,1582,201,56,257,22,279,585,47.69%,34.36%,1
臺中市,新社區,1583,399,80,479,44,523,938,55.76%,42.54%,1
臺中市,新社區,1584,91,15,106,4,110,224,49.11%,40.63%,1
臺中市,石岡區,1552,530,154,684,47,731,1244,58.76%,42.6%,1
臺中市,石岡區,1553,631,173,804,57,861,1539,55.95%,41%,1
臺中市,石岡區,1554,512,157,669,41,710,1202,59.07%,42.6%,1
臺中市,石岡區,1555,486,143,629,68,697,1272,54.8%,38.21%,1
臺中市,石岡區,1556,279,78,357,34,391,652,59.97%,42.79%,1
臺中市,石岡區,1557,691,184,875,81,956,1457,65.61%,47.43%,1
臺中市,石岡區,1558,731,228,959,76,1035,1836,56.37%,39.81%,1
臺中市,石岡區,1559,415,115,530,56,586,1001,58.54%,41.46%,1
臺中市,石岡區,1560,637,201,838,54,892,1448,61.6%,43.99%,1
臺中市,石岡區,1561,550,143,693,71,764,1229,62.16%,44.75%,1
臺中市,外埔區,0071,434,125,559,43,602,1059,56.85%,40.98%,1
臺中市,外埔區,0072,463,111,574,19,593,1013,58.54%,45.71%,1
臺中市,外埔區,0073,538,126,664,48,712,1150,61.91%,46.78%,1
臺中市,外埔區,0074,920,189,1109,68,1177,1855,63.45%,49.6%,1
臺中市,外埔區,0075,628,139,767,28,795,1327,59.91%,47.32%,1
臺中市,外埔區,0076,690,145,835,45,880,1453,60.56%,47.49%,1
臺中市,外埔區,0077,805,54,859,72,931,1653,56.32%,48.7%,1
臺中市,外埔區,0078,682,152,834,40,874,1615,54.12%,42.23%,1
臺中市,外埔區,0079,622,118,740,36,776,1470,52.79%,42.31%,1
臺中市,外埔區,0080,670,193,863,53,916,1559,58.76%,42.98%,1
臺中市,外埔區,0081,778,204,982,88,1070,1902,56.26%,40.9%,1
臺中市,外埔區,0082,550,132,682,49,731,1138,64.24%,48.33%,1
臺中市,外埔區,0083,471,136,607,73,680,1065,63.85%,44.23%,1
臺中市,外埔區,0084,569,161,730,46,776,1243,62.43%,45.78%,1
臺中市,外埔區,0085,380,108,488,41,529,962,54.99%,39.5%,1
臺中市,外埔區,0086,492,114,606,46,652,1169,55.77%,42.09%,1
臺中市,外埔區,0087,590,131,721,59,780,1216,64.14%,48.52%,1
臺中市,外埔區,0088,622,129,751,44,795,1391,57.15%,44.72%,1
臺中市,外埔區,0089,622,201,823,84,907,1616,56.13%,38.49%,1
臺中市,外埔區,0090,414,106,520,35,555,1203,46.13%,34.41%,1
臺中市,大安區,0055,405,98,503,67,570,1068,53.37%,37.92%,1
臺中市,大安區,0056,419,122,541,72,613,1050,58.38%,39.9%,1
臺中市,大安區,0057,515,150,665,85,750,1246,60.19%,41.33%,1
臺中市,大安區,0058,557,169,726,56,782,1397,55.98%,39.87%,1
臺中市,大安區,0059,558,134,692,67,759,1227,61.86%,45.48%,1
臺中市,大安區,0060,481,133,614,73,687,1170,58.72%,41.11%,1
臺中市,大安區,0061,419,122,541,55,596,914,65.21%,45.84%,1
臺中市,大安區,0062,244,61,305,40,345,667,51.72%,36.58%,1
臺中市,大安區,0063,341,93,434,49,483,890,54.27%,38.31%,1
臺中市,大安區,0064,515,146,661,67,728,1289,56.48%,39.95%,1
臺中市,大安區,0065,165,49,214,27,241,455,52.97%,36.26%,1
臺中市,大安區,0066,418,121,539,43,582,1028,56.61%,40.66%,1
臺中市,大安區,0067,623,159,782,79,861,1446,59.54%,43.08%,1
臺中市,大安區,0068,340,69,409,37,446,688,64.83%,49.42%,1
臺中市,大安區,0069,465,125,590,56,646,1062,60.83%,43.79%,1
臺中市,大安區,0070,412,153,565,34,599,923,64.9%,44.64%,1
臺中市,烏日區,0317,631,218,849,79,928,1480,62.7%,42.64%,1
臺中市,烏日區,0318,840,219,1059,72,1131,1841,61.43%,45.63%,1
臺中市,烏日區,0319,720,209,929,69,998,1751,57%,41.12%,1
臺中市,烏日區,0320,680,207,887,62,949,1547,61.34%,43.96%,1
臺中市,烏日區,0321,821,188,1009,48,1057,1836,57.57%,44.72%,1
臺中市,烏日區,0322,542,192,734,94,828,1239,66.83%,43.74%,1
臺中市,烏日區,0323,530,149,679,63,742,1295,57.3%,40.93%,1
臺中市,烏日區,0324,510,142,652,57,709,1263,56.14%,40.38%,1
臺中市,烏日區,0325,677,191,868,39,907,1622,55.92%,41.74%,1
臺中市,烏日區,0326,771,176,947,83,1030,1822,56.53%,42.32%,1
臺中市,烏日區,0327,828,206,1034,65,1099,1966,55.9%,42.12%,1
臺中市,烏日區,0328,731,164,895,56,951,1615,58.89%,45.26%,1
臺中市,烏日區,0329,568,144,712,35,747,1232,60.63%,46.1%,1
臺中市,烏日區,0330,569,120,689,37,726,1347,53.9%,42.24%,1
臺中市,烏日區,0331,461,125,586,42,628,1165,53.91%,39.57%,1
臺中市,烏日區,0332,734,195,929,54,983,1664,59.07%,44.11%,1
臺中市,烏日區,0333,547,167,714,57,771,1230,62.68%,44.47%,1
臺中市,烏日區,0334,687,218,905,75,980,1574,62.26%,43.65%,1
臺中市,烏日區,0335,679,189,868,51,919,1452,63.29%,46.76%,1
臺中市,烏日區,0336,736,163,899,75,974,1879,51.84%,39.17%,1
臺中市,烏日區,0337,672,169,841,53,894,1601,55.84%,41.97%,1
臺中市,烏日區,0338,700,197,897,57,954,1546,61.71%,45.28%,1
臺中市,烏日區,0339,790,95,885,44,929,1866,49.79%,42.34%,1
臺中市,烏日區,0340,851,230,1081,76,1157,1938,59.7%,43.91%,1
臺中市,烏日區,0341,736,212,948,75,1023,1759,58.16%,41.84%,1
臺中市,烏日區,0342,836,214,1050,79,1129,2061,54.78%,40.56%,1
臺中市,烏日區,0343,762,191,953,48,1001,1691,59.2%,45.06%,1
臺中市,烏日區,0344,486,146,632,38,670,1039,64.49%,46.78%,1
臺中市,烏日區,0345,553,135,688,39,727,1221,59.54%,45.29%,1
臺中市,烏日區,0346,695,212,907,89,996,1650,60.36%,42.12%,1
臺中市,烏日區,0347,409,128,537,42,579,937,61.79%,43.65%,1
臺中市,烏日區,0348,544,142,686,43,729,1220,59.75%,44.59%,1
臺中市,烏日區,0349,783,234,1017,128,1145,2139,53.53%,36.61%,1
臺中市,烏日區,0350,633,169,802,74,876,1371,63.89%,46.17%,1
臺中市,烏日區,0351,557,144,701,50,751,1277,58.81%,43.62%,1
臺中市,烏日區,0352,669,182,851,85,936,1708,54.8%,39.17%,1
臺中市,烏日區,0353,848,220,1068,77,1145,2048,55.91%,41.41%,1
臺中市,烏日區,0354,630,223,853,62,915,1632,56.07%,38.6%,1
臺中市,烏日區,0355,576,165,741,64,805,1327,60.66%,43.41%,1
臺中市,烏日區,0356,327,100,427,70,497,854,58.2%,38.29%,1
臺中市,大肚區,0284,589,158,747,42,789,1415,55.76%,41.63%,1
臺中市,大肚區,0285,528,154,682,64,746,1392,53.59%,37.93%,1
臺中市,大肚區,0286,663,184,847,74,921,1520,60.59%,43.62%,1
臺中市,大肚區,0287,402,118,520,63,583,862,67.63%,46.64%,1
臺中市,大肚區,0288,581,144,725,52,777,1256,61.86%,46.26%,1
臺中市,大肚區,0289,529,152,681,66,747,1292,57.82%,40.94%,1
臺中市,大肚區,0290,437,135,572,44,616,1010,60.99%,43.27%,1
臺中市,大肚區,0291,644,186,830,88,918,1485,61.82%,43.37%,1
臺中市,大肚區,0292,572,114,686,71,757,1190,63.61%,48.07%,1
臺中市,大肚區,0293,550,130,680,62,742,1250,59.36%,44%,1
臺中市,大肚區,0294,587,139,726,51,777,1310,59.31%,44.81%,1
臺中市,大肚區,0295,551,137,688,48,736,1294,56.88%,42.58%,1
臺中市,大肚區,0296,807,212,1019,64,1083,1734,62.46%,46.54%,1
臺中市,大肚區,0297,530,153,683,63,746,1316,56.69%,40.27%,1
臺中市,大肚區,0298,353,117,470,41,511,854,59.84%,41.33%,1
臺中市,大肚區,0299,609,142,751,43,794,1273,62.37%,47.84%,1
臺中市,大肚區,0300,409,90,499,32,531,851,62.4%,48.06%,1
臺中市,大肚區,0301,709,156,865,38,903,1629,55.43%,43.52%,1
臺中市,大肚區,0302,670,182,852,104,956,1709,55.94%,39.2%,1
臺中市,大肚區,0303,383,93,476,34,510,953,53.52%,40.19%,1
臺中市,大肚區,0304,594,167,761,51,812,1336,60.78%,44.46%,1
臺中市,大肚區,0305,824,245,1069,74,1143,2113,54.09%,39%,1
臺中市,大肚區,0306,716,201,917,100,1017,1730,58.79%,41.39%,1
臺中市,大肚區,0307,740,160,900,43,943,1692,55.73%,43.74%,1
臺中市,大肚區,0308,770,159,929,54,983,1747,56.27%,44.08%,1
臺中市,大肚區,0309,743,151,894,67,961,1672,57.48%,44.44%,1
臺中市,大肚區,0310,649,178,827,51,878,1675,52.42%,38.75%,1
臺中市,大肚區,0311,694,185,879,59,938,1673,56.07%,41.48%,1
臺中市,大肚區,0312,732,178,910,49,959,1636,58.62%,44.74%,1
臺中市,大肚區,0313,646,202,848,97,945,1753,53.91%,36.85%,1
臺中市,大肚區,0314,509,133,642,38,680,1343,50.63%,37.9%,1
臺中市,大肚區,0315,733,193,926,65,991,1822,54.39%,40.23%,1
臺中市,大肚區,0316,755,177,932,101,1033,1670,61.86%,45.21%,1
臺中市,龍井區,0239,730,207,937,89,1026,1758,58.36%,41.52%,1
臺中市,龍井區,0240,535,155,690,36,726,1275,56.94%,41.96%,1
臺中市,龍井區,0241,500,133,633,32,665,1379,48.22%,36.26%,1
臺中市,龍井區,0242,549,142,691,57,748,1403,53.31%,39.13%,1
臺中市,龍井區,0243,397,122,519,42,561,974,57.6%,40.76%,1
臺中市,龍井區,0244,398,97,495,40,535,901,59.38%,44.17%,1
臺中市,龍井區,0245,713,200,913,70,983,1779,55.26%,40.08%,1
臺中市,龍井區,0246,711,177,888,69,957,1609,59.48%,44.19%,1
臺中市,龍井區,0247,400,108,508,29,537,1038,51.73%,38.54%,1
臺中市,龍井區,0248,583,162,745,60,805,1328,60.62%,43.9%,1
臺中市,龍井區,0249,401,126,527,35,562,921,61.02%,43.54%,1
臺中市,龍井區,0250,625,154,779,64,843,1609,52.39%,38.84%,1
臺中市,龍井區,0251,432,119,551,23,574,1227,46.78%,35.21%,1
臺中市,龍井區,0252,528,135,663,60,723,1278,56.57%,41.31%,1
臺中市,龍井區,0253,288,92,380,26,406,914,44.42%,31.51%,1
臺中市,龍井區,0254,596,154,750,44,794,1678,47.32%,35.52%,1
臺中市,龍井區,0255,455,120,575,49,624,1233,50.61%,36.9%,1
臺中市,龍井區,0256,624,160,784,76,860,1520,56.58%,41.05%,1
臺中市,龍井區,0257,736,193,929,38,967,1905,50.76%,38.64%,1
臺中市,龍井區,0258,643,193,836,61,897,1520,59.01%,42.3%,1
臺中市,龍井區,0259,538,153,691,59,750,1385,54.15%,38.84%,1
臺中市,龍井區,0260,505,145,650,36,686,1212,56.6%,41.67%,1
臺中市,龍井區,0261,652,134,786,23,809,1432,56.49%,45.53%,1
臺中市,龍井區,0262,656,160,816,41,857,1663,51.53%,39.45%,1
臺中市,龍井區,0263,558,154,712,40,752,1422,52.88%,39.24%,1
臺中市,龍井區,0264,596,157,753,60,813,1616,50.31%,36.88%,1
臺中市,龍井區,0265,633,146,779,59,838,1422,58.93%,44.51%,1
臺中市,龍井區,0266,555,108,663,25,688,1165,59.06%,47.64%,1
臺中市,龍井區,0267,714,166,880,20,900,1624,55.42%,43.97%,1
臺中市,龍井區,0268,691,168,859,46,905,1613,56.11%,42.84%,1
臺中市,龍井區,0269,425,113,538,48,586,943,62.14%,45.07%,1
臺中市,龍井區,0270,591,171,762,90,852,1595,53.42%,37.05%,1
臺中市,龍井區,0271,661,149,810,78,888,1508,58.89%,43.83%,1
臺中市,龍井區,0272,594,151,745,43,788,1479,53.28%,40.16%,1
臺中市,龍井區,0273,643,178,821,51,872,1509,57.79%,42.61%,1
臺中市,龍井區,0274,693,175,868,68,936,1582,59.17%,43.81%,1
臺中市,龍井區,0275,737,182,919,56,975,1725,56.52%,42.72%,1
臺中市,龍井區,0276,712,146,858,46,904,1616,55.94%,44.06%,1
臺中市,龍井區,0277,738,187,925,49,974,1657,58.78%,44.54%,1
臺中市,龍井區,0278,781,196,977,59,1036,1774,58.4%,44.02%,1
臺中市,龍井區,0279,724,253,977,57,1034,1701,60.79%,42.56%,1
臺中市,龍井區,0280,480,143,623,39,662,1121,59.05%,42.82%,1
臺中市,龍井區,0281,437,140,577,38,615,987,62.31%,44.28%,1
臺中市,龍井區,0282,461,180,641,56,697,1206,57.79%,38.23%,1
臺中市,龍井區,0283,648,154,802,42,844,1378,61.25%,47.02%,1
臺中市,霧峰區,1470,559,150,709,34,743,1205,61.66%,46.39%,1
臺中市,霧峰區,1471,666,200,866,51,917,1620,56.6%,41.11%,1
臺中市,霧峰區,1472,713,180,893,61,954,1559,61.19%,45.73%,1
臺中市,霧峰區,1473,702,191,893,61,954,1660,57.47%,42.29%,1
臺中市,霧峰區,1474,734,191,925,50,975,1602,60.86%,45.82%,1
臺中市,霧峰區,1475,547,136,683,45,728,1325,54.94%,41.28%,1
臺中市,霧峰區,1476,669,164,833,57,890,1515,58.75%,44.16%,1
臺中市,霧峰區,1477,623,181,804,75,879,1561,56.31%,39.91%,1
臺中市,霧峰區,1478,656,190,846,62,908,1691,53.7%,38.79%,1
臺中市,霧峰區,1479,607,169,776,51,827,1486,55.65%,40.85%,1
臺中市,霧峰區,1480,423,134,557,55,612,975,62.77%,43.38%,1
臺中市,霧峰區,1481,656,127,783,64,847,1358,62.37%,48.31%,1
臺中市,霧峰區,1482,569,151,720,32,752,1141,65.91%,49.87%,1
臺中市,霧峰區,1483,412,92,504,60,564,855,65.96%,48.19%,1
臺中市,霧峰區,1484,513,135,648,72,720,1202,59.9%,42.68%,1
臺中市,霧峰區,1485,437,117,554,46,600,1078,55.66%,40.54%,1
臺中市,霧峰區,1486,644,182,826,69,895,1456,61.47%,44.23%,1
臺中市,霧峰區,1487,817,101,918,42,960,1573,61.03%,51.94%,1
臺中市,霧峰區,1488,728,159,887,51,938,1591,58.96%,45.76%,1
臺中市,霧峰區,1489,600,117,717,62,779,1214,64.17%,49.42%,1
臺中市,霧峰區,1490,528,132,660,63,723,1267,57.06%,41.67%,1
臺中市,霧峰區,1491,558,133,691,66,757,1277,59.28%,43.7%,1
臺中市,霧峰區,1492,551,173,724,54,778,1366,56.95%,40.34%,1
臺中市,霧峰區,1493,487,155,642,44,686,994,69.01%,48.99%,1
臺中市,霧峰區,1494,385,117,502,39,541,863,62.69%,44.61%,1
臺中市,霧峰區,1495,510,170,680,50,730,1274,57.3%,40.03%,1
臺中市,霧峰區,1496,473,136,609,71,680,1162,58.52%,40.71%,1
臺中市,霧峰區,1497,543,151,694,83,777,1252,62.06%,43.37%,1
臺中市,霧峰區,1498,569,159,728,61,789,1322,59.68%,43.04%,1
臺中市,霧峰區,1499,475,164,639,64,703,1116,62.99%,42.56%,1
臺中市,霧峰區,1500,470,180,650,77,727,1156,62.89%,40.66%,1
臺中市,霧峰區,1501,526,133,659,61,720,1147,62.77%,45.86%,1
臺中市,霧峰區,1502,452,123,575,53,628,928,67.67%,48.71%,1
臺中市,霧峰區,1503,527,145,672,56,728,1296,56.17%,40.66%,1
臺中市,霧峰區,1504,493,152,645,69,714,1314,54.34%,37.52%,1
臺中市,霧峰區,1505,578,159,737,72,809,1328,60.92%,43.52%,1
臺中市,霧峰區,1506,406,117,523,67,590,989,59.66%,41.05%,1
臺中市,霧峰區,1507,496,128,624,66,690,1088,63.42%,45.59%,1
臺中市,霧峰區,1508,637,140,777,73,850,1363,62.36%,46.74%,1
臺中市,霧峰區,1509,703,182,885,79,964,1573,61.28%,44.69%,1
臺中市,霧峰區,1510,457,130,587,62,649,1117,58.1%,40.91%,1
臺中市,霧峰區,1511,603,183,786,71,857,1342,63.86%,44.93%,1
臺中市,霧峰區,1512,456,157,613,70,683,1024,66.7%,44.53%,1
臺中市,太平區,1271,685,226,911,84,995,1821,54.64%,37.62%,1
臺中市,太平區,1272,631,163,794,46,840,1680,50%,37.56%,1
臺中市,太平區,1273,831,210,1041,87,1128,1947,57.94%,42.68%,1
臺中市,太平區,1274,819,229,1048,94,1142,1910,59.79%,42.88%,1
臺中市,太平區,1275,641,317,958,49,1007,1894,53.17%,33.84%,1
臺中市,太平區,1276,819,203,1022,58,1080,1953,55.3%,41.94%,1
臺中市,太平區,1277,776,205,981,74,1055,1846,57.15%,42.04%,1
臺中市,太平區,1278,663,165,828,48,876,1493,58.67%,44.41%,1
臺中市,太平區,1279,668,174,842,55,897,1605,55.89%,41.62%,1
臺中市,太平區,1280,740,170,910,35,945,1619,58.37%,45.71%,1
臺中市,太平區,1281,799,205,1004,77,1081,2011,53.75%,39.73%,1
臺中市,太平區,1282,822,196,1018,38,1056,2056,51.36%,39.98%,1
臺中市,太平區,1283,764,179,943,73,1016,1876,54.16%,40.72%,1
臺中市,太平區,1284,725,186,911,70,981,1815,54.05%,39.94%,1
臺中市,太平區,1285,505,154,659,49,708,1281,55.27%,39.42%,1
臺中市,太平區,1286,459,121,580,66,646,1004,64.34%,45.72%,1
臺中市,太平區,1287,824,240,1064,66,1130,1886,59.92%,43.69%,1
臺中市,太平區,1288,606,193,799,63,862,1431,60.24%,42.35%,1
臺中市,太平區,1289,776,202,978,73,1051,1930,54.46%,40.21%,1
臺中市,太平區,1290,807,236,1043,82,1125,2164,51.99%,37.29%,1
臺中市,太平區,1291,843,188,1031,80,1111,2048,54.25%,41.16%,1
臺中市,太平區,1292,819,203,1022,62,1084,2035,53.27%,40.25%,1
臺中市,太平區,1293,641,206,847,86,933,1685,55.37%,38.04%,1
臺中市,太平區,1294,769,217,986,89,1075,2185,49.2%,35.19%,1
臺中市,太平區,1295,463,125,588,26,614,1176,52.21%,39.37%,1
臺中市,太平區,1296,664,169,833,52,885,1597,55.42%,41.58%,1
臺中市,太平區,1297,528,145,673,79,752,1378,54.57%,38.32%,1
臺中市,太平區,1298,616,179,795,39,834,1546,53.95%,39.84%,1
臺中市,太平區,1299,701,182,883,110,993,1890,52.54%,37.09%,1
臺中市,太平區,1300,422,112,534,60,594,1053,56.41%,40.08%,1
臺中市,太平區,1301,704,171,875,80,955,1582,60.37%,44.5%,1
臺中市,太平區,1302,783,156,939,60,999,1699,58.8%,46.09%,1
臺中市,太平區,1303,579,165,744,66,810,1493,54.25%,38.78%,1
臺中市,太平區,1304,401,109,510,47,557,1063,52.4%,37.72%,1
臺中市,太平區,1305,498,126,624,50,674,1117,60.34%,44.58%,1
臺中市,太平區,1306,515,90,605,45,650,1084,59.96%,47.51%,1
臺中市,太平區,1307,696,161,857,43,900,1776,50.68%,39.19%,1
臺中市,太平區,1308,712,179,891,46,937,1729,54.19%,41.18%,1
臺中市,太平區,1309,606,134,740,65,805,1658,48.55%,36.55%,1
臺中市,太平區,1310,836,167,1003,64,1067,2010,53.08%,41.59%,1
臺中市,太平區,1311,707,171,878,77,955,1752,54.51%,40.35%,1
臺中市,太平區,1312,761,173,934,83,1017,1654,61.49%,46.01%,1
臺中市,太平區,1313,600,128,728,41,769,1951,39.42%,30.75%,1
臺中市,太平區,1314,1009,253,1262,87,1349,2170,62.17%,46.5%,1
臺中市,太平區,1315,991,285,1276,57,1333,2231,59.75%,44.42%,1
臺中市,太平區,1316,739,134,873,39,912,1623,56.19%,45.53%,1
臺中市,太平區,1317,564,145,709,55,764,1548,49.35%,36.43%,1
臺中市,太平區,1318,596,141,737,58,795,1442,55.13%,41.33%,1
臺中市,太平區,1319,519,159,678,43,721,1501,48.03%,34.58%,1
臺中市,太平區,1320,740,193,933,27,960,2025,47.41%,36.54%,1
臺中市,太平區,1321,740,179,919,64,983,1885,52.15%,39.26%,1
臺中市,太平區,1322,764,215,979,73,1052,2155,48.82%,35.45%,1
臺中市,太平區,1323,644,197,841,41,882,1775,49.69%,36.28%,1
臺中市,太平區,1324,677,176,853,80,933,2021,46.17%,33.5%,1
臺中市,太平區,1325,917,216,1133,75,1208,2075,58.22%,44.19%,1
臺中市,太平區,1326,677,172,849,56,905,1723,52.52%,39.29%,1
臺中市,太平區,1327,897,184,1081,58,1139,2049,55.59%,43.78%,1
臺中市,太平區,1328,596,153,749,25,774,1415,54.7%,42.12%,1
臺中市,太平區,1329,741,190,931,44,975,1778,54.84%,41.68%,1
臺中市,太平區,1330,663,190,853,54,907,1706,53.17%,38.86%,1
臺中市,太平區,1331,847,221,1068,50,1118,2090,53.49%,40.53%,1
臺中市,太平區,1332,796,194,990,50,1040,2093,49.69%,38.03%,1
臺中市,太平區,1333,612,144,756,36,792,1688,46.92%,36.26%,1
臺中市,太平區,1334,589,128,717,36,753,1488,50.6%,39.58%,1
臺中市,太平區,1335,623,173,796,53,849,1667,50.93%,37.37%,1
臺中市,太平區,1336,755,187,942,71,1013,1793,56.5%,42.11%,1
臺中市,太平區,1337,866,160,1026,40,1066,1903,56.02%,45.51%,1
臺中市,太平區,1338,758,204,962,61,1023,1834,55.78%,41.33%,1
臺中市,太平區,1339,638,134,772,35,807,1526,52.88%,41.81%,1
臺中市,太平區,1340,743,141,884,28,912,1483,61.5%,50.1%,1
臺中市,太平區,1341,754,166,920,31,951,1694,56.14%,44.51%,1
臺中市,太平區,1342,739,189,928,48,976,1952,50%,37.86%,1
臺中市,太平區,1343,837,195,1032,40,1072,1995,53.73%,41.95%,1
臺中市,太平區,1344,598,140,738,23,761,1311,58.05%,45.61%,1
臺中市,太平區,1345,782,178,960,56,1016,1537,66.1%,50.88%,1
臺中市,太平區,1346,756,66,822,57,879,1974,44.53%,38.3%,1
臺中市,太平區,1347,769,205,974,46,1020,1828,55.8%,42.07%,1
臺中市,太平區,1348,826,201,1027,41,1068,2191,48.74%,37.7%,1
臺中市,太平區,1349,697,183,880,93,973,1825,53.32%,38.19%,1
臺中市,太平區,1350,560,176,736,12,748,1559,47.98%,35.92%,1
臺中市,太平區,1351,486,117,603,81,684,1225,55.84%,39.67%,1
臺中市,太平區,1352,725,162,887,60,947,1678,56.44%,43.21%,1
臺中市,太平區,1353,530,168,698,100,798,1501,53.16%,35.31%,1
臺中市,太平區,1354,651,194,845,0,845,1450,58.28%,44.9%,1
臺中市,太平區,1355,799,226,1025,80,1105,2126,51.98%,37.58%,1
臺中市,太平區,1356,309,92,401,47,448,699,64.09%,44.21%,1
臺中市,太平區,1357,487,156,643,27,670,1428,46.92%,34.1%,1
臺中市,太平區,1358,698,187,885,82,967,1666,58.04%,41.9%,1
臺中市,太平區,1359,489,160,649,44,693,1241,55.84%,39.4%,1
臺中市,太平區,1360,569,139,708,69,777,1266,61.37%,44.94%,1
臺中市,太平區,1361,498,124,622,45,667,1166,57.2%,42.71%,1
臺中市,太平區,1362,793,187,980,77,1057,1790,59.05%,44.3%,1
臺中市,太平區,1363,583,175,758,51,809,1754,46.12%,33.24%,1
臺中市,大里區,1364,628,175,803,48,851,1614,52.73%,38.91%,1
臺中市,大里區,1365,608,158,766,37,803,1599,50.22%,38.02%,1
臺中市,大里區,1366,640,176,816,57,873,1715,50.9%,37.32%,1
臺中市,大里區,1367,548,129,677,27,704,1264,55.7%,43.35%,1
臺中市,大里區,1368,572,123,695,45,740,1416,52.26%,40.4%,1
臺中市,大里區,1369,512,107,619,33,652,1188,54.88%,43.1%,1
臺中市,大里區,1370,522,138,660,59,719,1359,52.91%,38.41%,1
臺中市,大里區,1371,615,170,785,58,843,1457,57.86%,42.21%,1
臺中市,大里區,1372,602,174,776,52,828,1403,59.02%,42.91%,1
臺中市,大里區,1373,668,186,854,65,919,1697,54.15%,39.36%,1
臺中市,大里區,1374,738,245,983,100,1083,1811,59.8%,40.75%,1
臺中市,大里區,1375,725,207,932,57,989,1830,54.04%,39.62%,1
臺中市,大里區,1376,653,169,822,109,931,2228,41.79%,29.31%,1
臺中市,大里區,1377,841,200,1041,89,1130,1997,56.58%,42.11%,1
臺中市,大里區,1378,1030,228,1258,38,1296,2033,63.75%,50.66%,1
臺中市,大里區,1379,767,243,1010,43,1053,1835,57.38%,41.8%,1
臺中市,大里區,1380,542,141,683,36,719,1268,56.7%,42.74%,1
臺中市,大里區,1381,716,176,892,57,949,1645,57.69%,43.53%,1
臺中市,大里區,1382,744,130,874,40,914,1561,58.55%,47.66%,1
臺中市,大里區,1383,656,154,810,32,842,1301,64.72%,50.42%,1
臺中市,大里區,1384,629,176,805,71,876,1621,54.04%,38.8%,1
臺中市,大里區,1385,660,235,895,76,971,1797,54.03%,36.73%,1
臺中市,大里區,1386,498,103,601,39,640,1230,52.03%,40.49%,1
臺中市,大里區,1387,616,145,761,55,816,1488,54.84%,41.4%,1
臺中市,大里區,1388,554,173,727,72,799,1459,54.76%,37.97%,1
臺中市,大里區,1389,696,173,869,64,933,1647,56.65%,42.26%,1
臺中市,大里區,1390,488,140,628,68,696,1100,63.27%,44.36%,1
臺中市,大里區,1391,603,157,760,47,807,1410,57.23%,42.77%,1
臺中市,大里區,1392,716,167,883,74,957,1807,52.96%,39.62%,1
臺中市,大里區,1393,541,146,687,62,749,1331,56.27%,40.65%,1
臺中市,大里區,1394,755,167,922,45,967,1801,53.69%,41.92%,1
臺中市,大里區,1395,763,160,923,44,967,1909,50.65%,39.97%,1
臺中市,大里區,1396,620,163,783,77,860,1699,50.62%,36.49%,1
臺中市,大里區,1397,704,170,874,69,943,1627,57.96%,43.27%,1
臺中市,大里區,1398,775,192,967,72,1039,1912,54.34%,40.53%,1
臺中市,大里區,1399,690,173,863,77,940,1753,53.62%,39.36%,1
臺中市,大里區,1400,667,161,828,49,877,1602,54.74%,41.64%,1
臺中市,大里區,1401,445,156,601,66,667,1144,58.3%,38.9%,1
臺中市,大里區,1402,689,102,791,71,862,1655,52.08%,41.63%,1
臺中市,大里區,1403,580,178,758,47,805,1438,55.98%,40.33%,1
臺中市,大里區,1404,415,118,533,61,594,1000,59.4%,41.5%,1
臺中市,大里區,1405,697,187,884,72,956,1711,55.87%,40.74%,1
臺中市,大里區,1406,723,131,854,11,865,1698,50.94%,42.58%,1
臺中市,大里區,1407,762,227,989,86,1075,1914,56.17%,39.81%,1
臺中市,大里區,1408,630,160,790,41,831,1465,56.72%,43%,1
臺中市,大里區,1409,652,180,832,71,903,1581,57.12%,41.24%,1
臺中市,大里區,1410,665,158,823,78,901,1509,59.71%,44.07%,1
臺中市,大里區,1411,642,145,787,34,821,1570,52.29%,40.89%,1
臺中市,大里區,1412,625,171,796,43,839,1425,58.88%,43.86%,1
臺中市,大里區,1413,601,159,760,58,818,1384,59.1%,43.42%,1
臺中市,大里區,1414,414,135,549,33,582,1204,48.34%,34.39%,1
臺中市,大里區,1415,650,151,801,49,850,1761,48.27%,36.91%,1
臺中市,大里區,1416,555,113,668,33,701,1473,47.59%,37.68%,1
臺中市,大里區,1417,693,194,887,61,948,1675,56.6%,41.37%,1
臺中市,大里區,1418,765,159,924,64,988,1755,56.3%,43.59%,1
臺中市,大里區,1419,657,188,845,97,942,1593,59.13%,41.24%,1
臺中市,大里區,1420,707,215,922,74,996,1799,55.36%,39.3%,1
臺中市,大里區,1421,647,179,826,82,908,1606,56.54%,40.29%,1
臺中市,大里區,1422,752,178,930,54,984,1875,52.48%,40.11%,1
臺中市,大里區,1423,685,208,893,62,955,1670,57.19%,41.02%,1
臺中市,大里區,1424,734,217,951,61,1012,1898,53.32%,38.67%,1
臺中市,大里區,1425,628,202,830,42,872,1679,51.94%,37.4%,1
臺中市,大里區,1426,554,135,689,58,747,1373,54.41%,40.35%,1
臺中市,大里區,1427,538,151,689,63,752,1299,57.89%,41.42%,1
臺中市,大里區,1428,632,136,768,45,813,1430,56.85%,44.2%,1
臺中市,大里區,1429,869,220,1089,49,1138,1805,63.05%,48.14%,1
臺中市,大里區,1430,900,225,1125,35,1160,1806,64.23%,49.83%,1
臺中市,大里區,1431,918,209,1127,62,1189,1826,65.12%,50.27%,1
臺中市,大里區,1432,931,203,1134,38,1172,1805,64.93%,51.58%,1
臺中市,大里區,1433,915,182,1097,54,1151,1907,60.36%,47.98%,1
臺中市,大里區,1434,525,126,651,44,695,1103,63.01%,47.6%,1
臺中市,大里區,1435,591,140,731,64,795,1419,56.03%,41.65%,1
臺中市,大里區,1436,576,140,716,74,790,1434,55.09%,40.17%,1
臺中市,大里區,1437,687,162,849,39,888,1875,47.36%,36.64%,1
臺中市,大里區,1438,733,215,948,53,1001,1862,53.76%,39.37%,1
臺中市,大里區,1439,766,178,944,35,979,1850,52.92%,41.41%,1
臺中市,大里區,1440,700,176,876,56,932,1622,57.46%,43.16%,1
臺中市,大里區,1441,736,196,932,76,1008,1638,61.54%,44.93%,1
臺中市,大里區,1442,697,232,929,88,1017,1633,62.28%,42.68%,1
臺中市,大里區,1443,706,196,902,45,947,1662,56.98%,42.48%,1
臺中市,大里區,1444,894,195,1089,40,1129,1917,58.89%,46.64%,1
臺中市,大里區,1445,637,178,815,77,892,1701,52.44%,37.45%,1
臺中市,大里區,1446,589,174,763,68,831,1549,53.65%,38.02%,1
臺中市,大里區,1447,684,176,860,64,924,1567,58.97%,43.65%,1
臺中市,大里區,1448,676,180,856,59,915,1614,56.69%,41.88%,1
臺中市,大里區,1449,750,207,957,83,1040,1811,57.43%,41.41%,1
臺中市,大里區,1450,165,540,705,48,753,1336,56.36%,12.35%,1
臺中市,大里區,1451,771,173,944,54,998,1759,56.74%,43.83%,1
臺中市,大里區,1452,682,187,869,72,941,1783,52.78%,38.25%,1
臺中市,大里區,1453,622,182,804,79,883,1736,50.86%,35.83%,1
臺中市,大里區,1454,754,217,971,76,1047,1874,55.87%,40.23%,1
臺中市,大里區,1455,770,211,981,85,1066,1889,56.43%,40.76%,1
臺中市,大里區,1456,795,220,1015,50,1065,1947,54.7%,40.83%,1
臺中市,大里區,1457,846,225,1071,60,1131,1938,58.36%,43.65%,1
臺中市,大里區,1458,772,174,946,81,1027,1836,55.94%,42.05%,1
臺中市,大里區,1459,763,203,966,79,1045,1913,54.63%,39.88%,1
臺中市,大里區,1460,730,205,935,77,1012,1913,52.9%,38.16%,1
臺中市,大里區,1461,765,173,938,60,998,1937,51.52%,39.49%,1
臺中市,大里區,1462,637,144,781,40,821,1508,54.44%,42.24%,1
臺中市,大里區,1463,603,143,746,30,776,1340,57.91%,45%,1
臺中市,大里區,1464,730,180,910,60,970,1656,58.57%,44.08%,1
臺中市,大里區,1465,552,131,683,51,734,1290,56.9%,42.79%,1
臺中市,大里區,1466,685,190,875,47,922,1655,55.71%,41.39%,1
臺中市,大里區,1467,460,128,588,24,612,1260,48.57%,36.51%,1
臺中市,大里區,1468,548,150,698,45,743,1247,59.58%,43.95%,1
臺中市,大里區,1469,595,171,766,98,864,1548,55.81%,38.44%,1
臺中市,和平區,1585,426,141,567,47,614,956,64.23%,44.56%,1
臺中市,和平區,1586,459,107,566,57,623,963,64.69%,47.66%,1
臺中市,和平區,1587,182,63,245,14,259,456,56.8%,39.91%,1
臺中市,和平區,1588,486,104,590,46,636,1011,62.91%,48.07%,1
臺中市,和平區,1589,275,75,350,22,372,636,58.49%,43.24%,1
臺中市,和平區,1590,90,30,120,8,128,270,47.41%,33.33%,1
臺中市,和平區,1591,280,49,329,28,357,460,77.61%,60.87%,1
臺中市,和平區,1592,185,45,230,12,242,321,75.39%,57.63%,1
臺中市,和平區,1593,365,94,459,31,490,783,62.58%,46.62%,1
臺中市,和平區,1594,139,44,183,17,200,336,59.52%,41.37%,1
臺中市,和平區,1595,238,59,297,9,306,451,67.85%,52.77%,1
臺中市,和平區,1596,130,41,171,20,191,366,52.19%,35.52%,1
臺中市,和平區,1597,272,47,319,12,331,771,42.93%,35.28%,1
臺中市,和平區,1598,239,51,290,28,318,574,55.4%,41.64%,1
臺中市,和平區,1599,116,35,151,18,169,274,61.68%,42.34%,1
臺中市,和平區,1600,64,16,80,6,86,157,54.78%,40.76%,1
臺中市,和平區,1601,273,50,323,18,341,713,47.83%,38.29%,1
臺南市,新營區,0116,557,166,723,64,787,1693,46.49%,32.9%,1
臺南市,新營區,0117,640,166,806,62,868,1561,55.61%,41%,1
臺南市,新營區,0118,566,180,746,54,800,1487,53.8%,38.06%,1
臺南市,新營區,0119,443,139,582,28,610,1232,49.51%,35.96%,1
臺南市,新營區,0120,388,113,501,33,534,1067,50.05%,36.36%,1
臺南市,新營區,0121,436,155,591,32,623,1419,43.9%,30.73%,1
臺南市,新營區,0122,599,131,730,33,763,1466,52.05%,40.86%,1
臺南市,新營區,0123,376,134,510,55,565,932,60.62%,40.34%,1
臺南市,新營區,0124,336,124,460,25,485,1099,44.13%,30.57%,1
臺南市,新營區,0125,253,66,319,28,347,757,45.84%,33.42%,1
臺南市,新營區,0126,325,128,453,36,489,888,55.07%,36.6%,1
臺南市,新營區,0127,391,133,524,16,540,1115,48.43%,35.07%,1
臺南市,新營區,0128,324,83,407,21,428,937,45.68%,34.58%,1
臺南市,新營區,0129,489,155,644,36,680,1387,49.03%,35.26%,1
臺南市,新營區,0130,557,148,705,43,748,1526,49.02%,36.5%,1
臺南市,新營區,0131,545,145,690,33,723,1301,55.57%,41.89%,1
臺南市,新營區,0132,627,179,806,58,864,1538,56.18%,40.77%,1
臺南市,新營區,0133,635,171,806,47,853,1584,53.85%,40.09%,1
臺南市,新營區,0134,693,162,855,37,892,1583,56.35%,43.78%,1
臺南市,新營區,0135,630,164,794,32,826,1530,53.99%,41.18%,1
臺南市,新營區,0136,500,139,639,44,683,1193,57.25%,41.91%,1
臺南市,新營區,0137,392,115,507,7,514,1439,35.72%,27.24%,1
臺南市,新營區,0138,599,161,760,45,805,1438,55.98%,41.66%,1
臺南市,新營區,0139,137,52,189,20,209,359,58.22%,38.16%,1
臺南市,新營區,0140,352,110,462,29,491,1233,39.82%,28.55%,1
臺南市,新營區,0141,381,95,476,17,493,1227,40.18%,31.05%,1
臺南市,新營區,0142,425,116,541,23,564,1320,42.73%,32.2%,1
臺南市,新營區,0143,566,177,743,21,764,1930,39.59%,29.33%,1
臺南市,新營區,0144,565,170,735,52,787,1501,52.43%,37.64%,1
臺南市,新營區,0145,539,139,678,37,715,1475,48.47%,36.54%,1
臺南市,新營區,0146,686,188,874,55,929,1753,52.99%,39.13%,1
臺南市,新營區,0147,621,188,809,36,845,1748,48.34%,35.53%,1
臺南市,新營區,0148,656,175,831,47,878,1741,50.43%,37.68%,1
臺南市,新營區,0149,505,142,647,24,671,1433,46.82%,35.24%,1
臺南市,新營區,0150,592,183,775,52,827,1595,51.85%,37.12%,1
臺南市,新營區,0151,305,83,388,18,406,959,42.34%,31.8%,1
臺南市,新營區,0152,624,192,816,70,886,1865,47.51%,33.46%,1
臺南市,新營區,0153,510,182,692,87,779,1678,46.42%,30.39%,1
臺南市,新營區,0154,430,127,557,59,616,1373,44.87%,31.32%,1
臺南市,新營區,0155,348,140,488,27,515,1431,35.99%,24.32%,1
臺南市,新營區,0156,65,29,94,4,98,291,33.68%,22.34%,1
臺南市,新營區,0157,549,201,750,41,791,1749,45.23%,31.39%,1
臺南市,新營區,0158,618,168,786,42,828,1862,44.47%,33.19%,1
臺南市,新營區,0159,732,164,896,88,984,1821,54.04%,40.2%,1
臺南市,新營區,0160,621,169,790,56,846,1845,45.85%,33.66%,1
臺南市,新營區,0161,143,38,181,9,190,542,35.06%,26.38%,1
臺南市,新營區,0162,102,29,131,3,134,402,33.33%,25.37%,1
臺南市,新營區,0163,252,101,353,57,410,703,58.32%,35.85%,1
臺南市,新營區,0164,283,100,383,35,418,941,44.42%,30.07%,1
臺南市,鹽水區,0085,375,111,486,64,550,1037,53.04%,36.16%,1
臺南市,鹽水區,0086,164,71,235,21,256,480,53.33%,34.17%,1
臺南市,鹽水區,0087,270,78,348,30,378,636,59.43%,42.45%,1
臺南市,鹽水區,0088,107,34,141,11,152,321,47.35%,33.33%,1
臺南市,鹽水區,0089,204,54,258,36,294,497,59.15%,41.05%,1
臺南市,鹽水區,0090,312,89,401,13,414,759,54.55%,41.11%,1
臺南市,鹽水區,0091,124,20,144,18,162,341,47.51%,36.36%,1
臺南市,鹽水區,0092,187,61,248,23,271,507,53.45%,36.88%,1
臺南市,鹽水區,0093,251,83,334,21,355,863,41.14%,29.08%,1
臺南市,鹽水區,0094,424,161,585,24,609,1373,44.36%,30.88%,1
臺南市,鹽水區,0095,513,171,684,64,748,1507,49.64%,34.04%,1
臺南市,鹽水區,0096,489,170,659,67,726,1374,52.84%,35.59%,1
臺南市,鹽水區,0097,393,120,513,49,562,1244,45.18%,31.59%,1
臺南市,鹽水區,0098,378,103,481,53,534,1022,52.25%,36.99%,1
臺南市,鹽水區,0099,204,79,283,40,323,921,35.07%,22.15%,1
臺南市,鹽水區,0100,280,131,411,46,457,847,53.96%,33.06%,1
臺南市,鹽水區,0101,166,44,210,7,217,736,29.48%,22.55%,1
臺南市,鹽水區,0102,242,84,326,13,339,761,44.55%,31.8%,1
臺南市,鹽水區,0103,91,35,126,10,136,285,47.72%,31.93%,1
臺南市,鹽水區,0104,141,53,194,33,227,493,46.04%,28.6%,1
臺南市,鹽水區,0105,159,53,212,16,228,621,36.71%,25.6%,1
臺南市,鹽水區,0106,84,31,115,11,126,392,32.14%,21.43%,1
臺南市,鹽水區,0107,286,100,386,27,413,925,44.65%,30.92%,1
臺南市,鹽水區,0108,197,78,275,35,310,728,42.58%,27.06%,1
臺南市,鹽水區,0109,44,17,61,19,80,214,37.38%,20.56%,1
臺南市,鹽水區,0110,131,33,164,12,176,387,45.48%,33.85%,1
臺南市,鹽水區,0111,88,41,129,21,150,301,49.83%,29.24%,1
臺南市,鹽水區,0112,182,76,258,27,285,755,37.75%,24.11%,1
臺南市,鹽水區,0113,84,41,125,19,144,365,39.45%,23.01%,1
臺南市,鹽水區,0114,260,103,363,31,394,935,42.14%,27.81%,1
臺南市,鹽水區,0115,142,48,190,25,215,494,43.52%,28.74%,1
臺南市,白河區,0030,410,139,549,72,621,1176,52.81%,34.86%,1
臺南市,白河區,0031,199,52,251,17,268,546,49.08%,36.45%,1
臺南市,白河區,0032,319,111,430,30,460,859,53.55%,37.14%,1
臺南市,白河區,0033,367,109,476,38,514,946,54.33%,38.79%,1
臺南市,白河區,0034,386,124,510,37,547,1116,49.01%,34.59%,1
臺南市,白河區,0035,357,109,466,29,495,1397,35.43%,25.55%,1
臺南市,白河區,0036,197,60,257,20,277,756,36.64%,26.06%,1
臺南市,白河區,0037,294,77,371,51,422,871,48.45%,33.75%,1
臺南市,白河區,0038,314,92,406,34,440,897,49.05%,35.01%,1
臺南市,白河區,0039,165,57,222,39,261,784,33.29%,21.05%,1
臺南市,白河區,0040,158,56,214,17,231,572,40.38%,27.62%,1
臺南市,白河區,0041,102,24,126,7,133,457,29.1%,22.32%,1
臺南市,白河區,0042,150,36,186,10,196,600,32.67%,25%,1
臺南市,白河區,0043,74,26,100,6,106,375,28.27%,19.73%,1
臺南市,白河區,0044,82,33,115,10,125,508,24.61%,16.14%,1
臺南市,白河區,0045,123,44,167,11,178,631,28.21%,19.49%,1
臺南市,白河區,0046,74,25,99,12,111,391,28.39%,18.93%,1
臺南市,白河區,0047,167,59,226,12,238,799,29.79%,20.9%,1
臺南市,白河區,0048,109,30,139,14,153,506,30.24%,21.54%,1
臺南市,白河區,0049,220,81,301,24,325,832,39.06%,26.44%,1
臺南市,白河區,0050,344,146,490,32,522,1179,44.27%,29.18%,1
臺南市,白河區,0051,165,59,224,9,233,744,31.32%,22.18%,1
臺南市,白河區,0052,183,53,236,14,250,699,35.77%,26.18%,1
臺南市,白河區,0053,147,55,202,8,210,633,33.18%,23.22%,1
臺南市,白河區,0054,290,113,403,55,458,859,53.32%,33.76%,1
臺南市,白河區,0055,246,81,327,52,379,884,42.87%,27.83%,1
臺南市,白河區,0056,136,42,178,12,190,740,25.68%,18.38%,1
臺南市,白河區,0057,362,131,493,50,543,1334,40.7%,27.14%,1
臺南市,白河區,0058,210,81,291,61,352,723,48.69%,29.05%,1
臺南市,白河區,0059,220,92,312,61,373,682,54.69%,32.26%,1
臺南市,白河區,0060,283,111,394,44,438,855,51.23%,33.1%,1
臺南市,白河區,0061,128,62,190,21,211,543,38.86%,23.57%,1
臺南市,柳營區,0165,381,130,511,50,561,1166,48.11%,32.68%,1
臺南市,柳營區,0166,233,91,324,11,335,625,53.6%,37.28%,1
臺南市,柳營區,0167,218,63,281,27,308,738,41.73%,29.54%,1
臺南市,柳營區,0168,330,83,413,19,432,834,51.8%,39.57%,1
臺南市,柳營區,0169,342,113,455,41,496,1104,44.93%,30.98%,1
臺南市,柳營區,0170,304,97,401,18,419,1015,41.28%,29.95%,1
臺南市,柳營區,0171,643,168,811,123,934,1720,54.3%,37.38%,1
臺南市,柳營區,0172,448,136,584,71,655,1391,47.09%,32.21%,1
臺南市,柳營區,0173,137,36,173,6,179,425,42.12%,32.24%,1
臺南市,柳營區,0174,84,20,104,21,125,318,39.31%,26.42%,1
臺南市,柳營區,0175,247,81,328,44,372,753,49.4%,32.8%,1
臺南市,柳營區,0176,237,68,305,40,345,730,47.26%,32.47%,1
臺南市,柳營區,0177,234,77,311,38,349,725,48.14%,32.28%,1
臺南市,柳營區,0178,300,87,387,34,421,787,53.49%,38.12%,1
臺南市,柳營區,0179,105,32,137,33,170,297,57.24%,35.35%,1
臺南市,柳營區,0180,244,81,325,44,369,673,54.83%,36.26%,1
臺南市,柳營區,0181,227,67,294,64,358,640,55.94%,35.47%,1
臺南市,柳營區,0182,169,82,251,31,282,660,42.73%,25.61%,1
臺南市,柳營區,0183,365,103,468,40,508,1212,41.91%,30.12%,1
臺南市,柳營區,0184,68,15,83,6,89,202,44.06%,33.66%,1
臺南市,柳營區,0185,324,101,425,81,506,1049,48.24%,30.89%,1
臺南市,柳營區,0186,47,23,70,1,71,158,44.94%,29.75%,1
臺南市,柳營區,0187,274,122,396,68,464,921,50.38%,29.75%,1
臺南市,柳營區,0188,143,45,188,22,210,504,41.67%,28.37%,1
臺南市,柳營區,0189,48,13,61,4,65,157,41.4%,30.57%,1
臺南市,後壁區,0001,284,86,370,56,426,743,57.34%,38.22%,1
臺南市,後壁區,0002,310,92,402,19,421,898,46.88%,34.52%,1
臺南市,後壁區,0003,240,76,316,48,364,786,46.31%,30.53%,1
臺南市,後壁區,0004,152,67,219,53,272,534,50.94%,28.46%,1
臺南市,後壁區,0005,351,110,461,68,529,1034,51.16%,33.95%,1
臺南市,後壁區,0006,49,39,88,18,106,232,45.69%,21.12%,1
臺南市,後壁區,0007,150,47,197,36,233,479,48.64%,31.32%,1
臺南市,後壁區,0008,252,86,338,28,366,837,43.73%,30.11%,1
臺南市,後壁區,0009,290,87,377,34,411,1085,37.88%,26.73%,1
臺南市,後壁區,0010,281,85,366,19,385,1157,33.28%,24.29%,1
臺南市,後壁區,0011,270,58,328,56,384,755,50.86%,35.76%,1
臺南市,後壁區,0012,173,47,220,28,248,458,54.15%,37.77%,1
臺南市,後壁區,0013,122,25,147,25,172,371,46.36%,32.88%,1
臺南市,後壁區,0014,205,68,273,51,324,676,47.93%,30.33%,1
臺南市,後壁區,0015,123,35,158,32,190,428,44.39%,28.74%,1
臺南市,後壁區,0016,144,38,182,13,195,547,35.65%,26.33%,1
臺南市,後壁區,0017,130,57,187,44,231,455,50.77%,28.57%,1
臺南市,後壁區,0018,250,81,331,70,401,984,40.75%,25.41%,1
臺南市,後壁區,0019,131,44,175,34,209,483,43.27%,27.12%,1
臺南市,後壁區,0020,151,42,193,30,223,536,41.6%,28.17%,1
臺南市,後壁區,0021,233,62,295,8,303,958,31.63%,24.32%,1
臺南市,後壁區,0022,172,49,221,33,254,441,57.6%,39%,1
臺南市,後壁區,0023,211,80,291,68,359,677,53.03%,31.17%,1
臺南市,後壁區,0024,332,111,443,76,519,996,52.11%,33.33%,1
臺南市,後壁區,0025,391,102,493,31,524,1255,41.75%,31.16%,1
臺南市,後壁區,0026,216,52,268,18,286,678,42.18%,31.86%,1
臺南市,後壁區,0027,146,44,190,9,199,553,35.99%,26.4%,1
臺南市,後壁區,0028,151,38,189,16,205,616,33.28%,24.51%,1
臺南市,後壁區,0029,380,121,501,25,526,1189,44.24%,31.96%,1
臺南市,東山區,0062,406,156,562,62,624,1401,44.54%,28.98%,1
臺南市,東山區,0063,342,88,430,34,464,1185,39.16%,28.86%,1
臺南市,東山區,0064,366,105,471,54,525,1303,40.29%,28.09%,1
臺南市,東山區,0065,186,74,260,32,292,732,39.89%,25.41%,1
臺南市,東山區,0066,169,67,236,34,270,721,37.45%,23.44%,1
臺南市,東山區,0067,226,124,350,47,397,1104,35.96%,20.47%,1
臺南市,東山區,0068,269,66,335,27,362,943,38.39%,28.53%,1
臺南市,東山區,0069,103,28,131,6,137,653,20.98%,15.77%,1
臺南市,東山區,0070,167,50,217,69,286,596,47.99%,28.02%,1
臺南市,東山區,0071,243,87,330,62,392,878,44.65%,27.68%,1
臺南市,東山區,0072,173,92,265,54,319,771,41.37%,22.44%,1
臺南市,東山區,0073,137,48,185,24,209,483,43.27%,28.36%,1
臺南市,東山區,0074,224,62,286,33,319,640,49.84%,35%,1
臺南市,東山區,0075,63,28,91,3,94,425,22.12%,14.82%,1
臺南市,東山區,0076,99,28,127,17,144,394,36.55%,25.13%,1
臺南市,東山區,0077,118,38,156,30,186,373,49.87%,31.64%,1
臺南市,東山區,0078,272,77,349,40,389,1257,30.95%,21.64%,1
臺南市,東山區,0079,140,44,184,8,192,887,21.65%,15.78%,1
臺南市,東山區,0080,109,38,147,14,161,658,24.47%,16.57%,1
臺南市,東山區,0081,202,82,284,24,308,1101,27.97%,18.35%,1
臺南市,東山區,0082,176,68,244,16,260,1057,24.6%,16.65%,1
臺南市,東山區,0083,186,70,256,46,302,639,47.26%,29.11%,1
臺南市,東山區,0084,70,37,107,10,117,270,43.33%,25.93%,1
臺南市,麻豆區,0381,413,136,549,52,601,1205,49.88%,34.27%,1
臺南市,麻豆區,0382,234,99,333,35,368,660,55.76%,35.45%,1
臺南市,麻豆區,0383,175,82,257,18,275,523,52.58%,33.46%,1
臺南市,麻豆區,0384,549,189,738,37,775,1597,48.53%,34.38%,1
臺南市,麻豆區,0385,478,169,647,55,702,1262,55.63%,37.88%,1
臺南市,麻豆區,0386,535,161,696,44,740,1325,55.85%,40.38%,1
臺南市,麻豆區,0387,454,164,618,37,655,1384,47.33%,32.8%,1
臺南市,麻豆區,0388,381,152,533,25,558,1121,49.78%,33.99%,1
臺南市,麻豆區,0389,326,131,457,12,469,1021,45.94%,31.93%,1
臺南市,麻豆區,0390,301,119,420,43,463,954,48.53%,31.55%,1
臺南市,麻豆區,0391,449,154,603,28,631,1513,41.71%,29.68%,1
臺南市,麻豆區,0392,523,173,696,42,738,1726,42.76%,30.3%,1
臺南市,麻豆區,0393,653,177,830,60,890,1804,49.33%,36.2%,1
臺南市,麻豆區,0394,340,104,444,29,473,1106,42.77%,30.74%,1
臺南市,麻豆區,0395,498,185,683,48,731,1503,48.64%,33.13%,1
臺南市,麻豆區,0396,466,143,609,47,656,1302,50.38%,35.79%,1
臺南市,麻豆區,0397,211,74,285,17,302,645,46.82%,32.71%,1
臺南市,麻豆區,0398,316,94,410,27,437,777,56.24%,40.67%,1
臺南市,麻豆區,0399,502,169,671,48,719,1612,44.6%,31.14%,1
臺南市,麻豆區,0400,222,61,283,17,300,718,41.78%,30.92%,1
臺南市,麻豆區,0401,481,146,627,33,660,1656,39.86%,29.05%,1
臺南市,麻豆區,0402,419,178,597,69,666,1355,49.15%,30.92%,1
臺南市,麻豆區,0403,256,74,330,35,365,977,37.36%,26.2%,1
臺南市,麻豆區,0404,302,102,404,32,436,1012,43.08%,29.84%,1
臺南市,麻豆區,0405,224,81,305,22,327,626,52.24%,35.78%,1
臺南市,麻豆區,0406,97,29,126,5,131,467,28.05%,20.77%,1
臺南市,麻豆區,0407,394,127,521,24,545,1260,43.25%,31.27%,1
臺南市,麻豆區,0408,378,138,516,41,557,1111,50.14%,34.02%,1
臺南市,麻豆區,0409,178,83,261,23,284,550,51.64%,32.36%,1
臺南市,麻豆區,0410,265,95,360,43,403,798,50.5%,33.21%,1
臺南市,麻豆區,0411,315,111,426,80,506,852,59.39%,36.97%,1
臺南市,麻豆區,0412,235,70,305,11,316,830,38.07%,28.31%,1
臺南市,麻豆區,0413,254,105,359,17,376,941,39.96%,26.99%,1
臺南市,麻豆區,0414,399,135,534,27,561,1158,48.45%,34.46%,1
臺南市,麻豆區,0415,180,70,250,10,260,612,42.48%,29.41%,1
臺南市,下營區,0343,438,134,572,48,620,1558,39.79%,28.11%,1
臺南市,下營區,0344,285,106,391,31,422,1112,37.95%,25.63%,1
臺南市,下營區,0345,268,95,363,59,422,893,47.26%,30.01%,1
臺南市,下營區,0346,433,149,582,51,633,1623,39%,26.68%,1
臺南市,下營區,0347,510,159,669,94,763,1568,48.66%,32.53%,1
臺南市,下營區,0348,339,112,451,54,505,985,51.27%,34.42%,1
臺南市,下營區,0349,305,72,377,18,395,953,41.45%,32%,1
臺南市,下營區,0350,321,104,425,32,457,1031,44.33%,31.13%,1
臺南市,下營區,0351,411,117,528,68,596,1077,55.34%,38.16%,1
臺南市,下營區,0352,175,57,232,48,280,703,39.83%,24.89%,1
臺南市,下營區,0353,258,62,320,19,339,854,39.7%,30.21%,1
臺南市,下營區,0354,368,136,504,48,552,1164,47.42%,31.62%,1
臺南市,下營區,0355,319,104,423,25,448,1091,41.06%,29.24%,1
臺南市,下營區,0356,333,90,423,65,488,959,50.89%,34.72%,1
臺南市,下營區,0357,306,87,393,31,424,935,45.35%,32.73%,1
臺南市,下營區,0358,308,86,394,53,447,893,50.06%,34.49%,1
臺南市,下營區,0359,451,124,575,94,669,1293,51.74%,34.88%,1
臺南市,下營區,0360,359,153,512,112,624,1185,52.66%,30.3%,1
臺南市,下營區,0361,256,82,338,19,357,1070,33.36%,23.93%,1
臺南市,六甲區,0362,307,101,408,56,464,819,56.65%,37.48%,1
臺南市,六甲區,0363,222,71,293,20,313,645,48.53%,34.42%,1
臺南市,六甲區,0364,466,140,606,37,643,1444,44.53%,32.27%,1
臺南市,六甲區,0365,402,171,573,58,631,1554,40.6%,25.87%,1
臺南市,六甲區,0366,311,117,428,52,480,1171,40.99%,26.56%,1
臺南市,六甲區,0367,436,142,578,69,647,1351,47.89%,32.27%,1
臺南市,六甲區,0368,284,110,394,71,465,1010,46.04%,28.12%,1
臺南市,六甲區,0369,264,110,374,58,432,919,47.01%,28.73%,1
臺南市,六甲區,0370,414,173,587,64,651,1369,47.55%,30.24%,1
臺南市,六甲區,0371,341,94,435,66,501,976,51.33%,34.94%,1
臺南市,六甲區,0372,374,124,498,51,549,1015,54.09%,36.85%,1
臺南市,六甲區,0373,364,114,478,33,511,1176,43.45%,30.95%,1
臺南市,六甲區,0374,315,113,428,51,479,939,51.01%,33.55%,1
臺南市,六甲區,0375,228,100,328,43,371,712,52.11%,32.02%,1
臺南市,六甲區,0376,315,99,414,43,457,881,51.87%,35.75%,1
臺南市,六甲區,0377,472,153,625,63,688,1184,58.11%,39.86%,1
臺南市,六甲區,0378,244,91,335,26,361,599,60.27%,40.73%,1
臺南市,六甲區,0379,160,50,210,8,218,759,28.72%,21.08%,1
臺南市,六甲區,0380,148,70,218,26,244,621,39.29%,23.83%,1
臺南市,官田區,0416,364,87,451,17,468,1104,42.39%,32.97%,1
臺南市,官田區,0417,322,111,433,41,474,965,49.12%,33.37%,1
臺南市,官田區,0418,475,156,631,44,675,1402,48.15%,33.88%,1
臺南市,官田區,0419,579,234,813,92,905,1653,54.75%,35.03%,1
臺南市,官田區,0420,269,116,385,56,441,966,45.65%,27.85%,1
臺南市,官田區,0421,73,33,106,15,121,284,42.61%,25.7%,1
臺南市,官田區,0422,80,25,105,5,110,402,27.36%,19.9%,1
臺南市,官田區,0423,338,114,452,10,462,982,47.05%,34.42%,1
臺南市,官田區,0424,291,87,378,26,404,975,41.44%,29.85%,1
臺南市,官田區,0425,255,100,355,42,397,802,49.5%,31.8%,1
臺南市,官田區,0426,401,149,550,47,597,1118,53.4%,35.87%,1
臺南市,官田區,0427,487,171,658,28,686,1455,47.15%,33.47%,1
臺南市,官田區,0428,410,147,557,29,586,1208,48.51%,33.94%,1
臺南市,官田區,0429,388,132,520,59,579,1293,44.78%,30.01%,1
臺南市,官田區,0430,158,60,218,18,236,607,38.88%,26.03%,1
臺南市,官田區,0431,144,65,209,30,239,501,47.7%,28.74%,1
臺南市,官田區,0432,265,85,350,48,398,728,54.67%,36.4%,1
臺南市,官田區,0433,255,103,358,19,377,842,44.77%,30.29%,1
臺南市,官田區,0434,170,62,232,42,274,515,53.2%,33.01%,1
臺南市,官田區,0435,245,62,307,19,326,873,37.34%,28.06%,1
臺南市,大內區,0436,208,68,276,46,322,759,42.42%,27.4%,1
臺南市,大內區,0437,59,22,81,2,83,262,31.68%,22.52%,1
臺南市,大內區,0438,148,50,198,15,213,646,32.97%,22.91%,1
臺南市,大內區,0439,409,110,519,65,584,1473,39.65%,27.77%,1
臺南市,大內區,0440,324,96,420,71,491,915,53.66%,35.41%,1
臺南市,大內區,0441,286,101,387,41,428,779,54.94%,36.71%,1
臺南市,大內區,0442,248,94,342,46,388,637,60.91%,38.93%,1
臺南市,大內區,0443,272,112,384,29,413,993,41.59%,27.39%,1
臺南市,大內區,0444,284,86,370,38,408,766,53.26%,37.08%,1
臺南市,大內區,0445,294,80,374,35,409,841,48.63%,34.96%,1
臺南市,大內區,0446,186,56,242,41,283,583,48.54%,31.9%,1
臺南市,佳里區,0282,552,162,714,56,770,1391,55.36%,39.68%,1
臺南市,佳里區,0283,338,106,444,35,479,829,57.78%,40.77%,1
臺南市,佳里區,0284,418,157,575,32,607,1401,43.33%,29.84%,1
臺南市,佳里區,0285,449,130,579,21,600,1452,41.32%,30.92%,1
臺南市,佳里區,0286,510,157,667,66,733,1382,53.04%,36.9%,1
臺南市,佳里區,0287,557,151,708,61,769,1463,52.56%,38.07%,1
臺南市,佳里區,0288,452,121,573,39,612,1280,47.81%,35.31%,1
臺南市,佳里區,0289,551,182,733,71,804,1486,54.1%,37.08%,1
臺南市,佳里區,0290,535,148,683,73,756,1378,54.86%,38.82%,1
臺南市,佳里區,0291,570,172,742,60,802,1505,53.29%,37.87%,1
臺南市,佳里區,0292,705,180,885,82,967,1860,51.99%,37.9%,1
臺南市,佳里區,0293,414,123,537,96,633,1134,55.82%,36.51%,1
臺南市,佳里區,0294,548,150,698,55,753,1426,52.81%,38.43%,1
臺南市,佳里區,0295,672,187,859,64,923,1779,51.88%,37.77%,1
臺南市,佳里區,0296,765,196,961,62,1023,1906,53.67%,40.14%,1
臺南市,佳里區,0297,494,163,657,50,707,1425,49.61%,34.67%,1
臺南市,佳里區,0298,466,136,602,51,653,1255,52.03%,37.13%,1
臺南市,佳里區,0299,517,145,662,81,743,1524,48.75%,33.92%,1
臺南市,佳里區,0300,599,172,771,42,813,1631,49.85%,36.73%,1
臺南市,佳里區,0301,630,179,809,54,863,1546,55.82%,40.75%,1
臺南市,佳里區,0302,504,147,651,50,701,1187,59.06%,42.46%,1
臺南市,佳里區,0303,512,148,660,48,708,1381,51.27%,37.07%,1
臺南市,佳里區,0304,496,127,623,27,650,1364,47.65%,36.36%,1
臺南市,佳里區,0305,491,151,642,33,675,1314,51.37%,37.37%,1
臺南市,佳里區,0306,419,160,579,54,633,1164,54.38%,36%,1
臺南市,佳里區,0307,351,118,469,47,516,961,53.69%,36.52%,1
臺南市,佳里區,0308,405,129,534,53,587,1218,48.19%,33.25%,1
臺南市,佳里區,0309,327,119,446,20,466,919,50.71%,35.58%,1
臺南市,佳里區,0310,238,83,321,26,347,689,50.36%,34.54%,1
臺南市,佳里區,0311,118,35,153,16,169,383,44.13%,30.81%,1
臺南市,佳里區,0312,514,145,659,55,714,1507,47.38%,34.11%,1
臺南市,佳里區,0313,224,94,318,26,344,702,49%,31.91%,1
臺南市,佳里區,0314,349,93,442,49,491,907,54.13%,38.48%,1
臺南市,佳里區,0315,407,105,512,41,553,937,59.02%,43.44%,1
臺南市,佳里區,0316,339,131,470,63,533,1030,51.75%,32.91%,1
臺南市,佳里區,0317,332,118,450,53,503,981,51.27%,33.84%,1
臺南市,佳里區,0318,251,78,329,21,350,787,44.47%,31.89%,1
臺南市,佳里區,0319,539,153,692,67,759,1513,50.17%,35.62%,1
臺南市,佳里區,0320,199,69,268,22,290,714,40.62%,27.87%,1
臺南市,佳里區,0321,240,88,328,39,367,745,49.26%,32.21%,1
臺南市,佳里區,0322,295,102,397,25,422,951,44.37%,31.02%,1
臺南市,學甲區,0208,293,130,423,57,480,862,55.68%,33.99%,1
臺南市,學甲區,0209,258,69,327,8,335,611,54.83%,42.23%,1
臺南市,學甲區,0210,329,113,442,30,472,936,50.43%,35.15%,1
臺南市,學甲區,0211,307,145,452,46,498,1066,46.72%,28.8%,1
臺南市,學甲區,0212,317,129,446,32,478,869,55.01%,36.48%,1
臺南市,學甲區,0213,233,55,288,35,323,635,50.87%,36.69%,1
臺南市,學甲區,0214,277,64,341,25,366,822,44.53%,33.7%,1
臺南市,學甲區,0215,137,31,168,18,186,443,41.99%,30.93%,1
臺南市,學甲區,0216,519,124,643,43,686,1370,50.07%,37.88%,1
臺南市,學甲區,0217,440,112,552,50,602,1117,53.89%,39.39%,1
臺南市,學甲區,0218,476,128,604,77,681,1365,49.89%,34.87%,1
臺南市,學甲區,0219,491,140,631,80,711,1489,47.75%,32.98%,1
臺南市,學甲區,0220,150,66,216,38,254,627,40.51%,23.92%,1
臺南市,學甲區,0221,373,110,483,20,503,1052,47.81%,35.46%,1
臺南市,學甲區,0222,412,109,521,24,545,1183,46.07%,34.83%,1
臺南市,學甲區,0223,273,91,364,25,389,979,39.73%,27.89%,1
臺南市,學甲區,0224,359,133,492,62,554,1241,44.64%,28.93%,1
臺南市,學甲區,0225,231,63,294,23,317,843,37.6%,27.4%,1
臺南市,學甲區,0226,186,58,244,36,280,580,48.28%,32.07%,1
臺南市,學甲區,0227,214,56,270,21,291,832,34.98%,25.72%,1
臺南市,學甲區,0228,99,39,138,4,142,406,34.98%,24.38%,1
臺南市,學甲區,0229,291,96,387,37,424,818,51.83%,35.57%,1
臺南市,學甲區,0230,264,99,363,19,382,1052,36.31%,25.1%,1
臺南市,學甲區,0231,159,57,216,12,228,578,39.45%,27.51%,1
臺南市,學甲區,0232,105,43,148,20,168,430,39.07%,24.42%,1
臺南市,學甲區,0233,125,25,150,13,163,361,45.15%,34.63%,1
臺南市,西港區,0323,322,102,424,17,441,933,47.27%,34.51%,1
臺南市,西港區,0324,319,108,427,35,462,901,51.28%,35.41%,1
臺南市,西港區,0325,418,133,551,32,583,1314,44.37%,31.81%,1
臺南市,西港區,0326,475,140,615,73,688,1349,51%,35.21%,1
臺南市,西港區,0327,382,118,500,60,560,1014,55.23%,37.67%,1
臺南市,西港區,0328,488,181,669,34,703,1900,37%,25.68%,1
臺南市,西港區,0329,509,157,666,55,721,1663,43.36%,30.61%,1
臺南市,西港區,0330,209,74,283,13,296,738,40.11%,28.32%,1
臺南市,西港區,0331,441,141,582,64,646,1211,53.34%,36.42%,1
臺南市,西港區,0332,112,40,152,28,180,382,47.12%,29.32%,1
臺南市,西港區,0333,241,62,303,21,324,786,41.22%,30.66%,1
臺南市,西港區,0334,268,81,349,14,363,838,43.32%,31.98%,1
臺南市,西港區,0335,392,132,524,46,570,1449,39.34%,27.05%,1
臺南市,西港區,0336,395,126,521,31,552,1479,37.32%,26.71%,1
臺南市,西港區,0337,270,80,350,72,422,763,55.31%,35.39%,1
臺南市,西港區,0338,393,98,491,30,521,1297,40.17%,30.3%,1
臺南市,西港區,0339,419,141,560,40,600,1393,43.07%,30.08%,1
臺南市,西港區,0340,245,88,333,18,351,958,36.64%,25.57%,1
臺南市,西港區,0341,139,43,182,19,201,391,51.41%,35.55%,1
臺南市,西港區,0342,275,87,362,59,421,805,52.3%,34.16%,1
臺南市,七股區,0258,155,52,207,15,222,534,41.57%,29.03%,1
臺南市,七股區,0259,182,52,234,18,252,508,49.61%,35.83%,1
臺南市,七股區,0260,157,42,199,6,205,665,30.83%,23.61%,1
臺南市,七股區,0261,244,64,308,22,330,834,39.57%,29.26%,1
臺南市,七股區,0262,192,85,277,18,295,810,36.42%,23.7%,1
臺南市,七股區,0263,112,29,141,10,151,480,31.46%,23.33%,1
臺南市,七股區,0264,108,39,147,6,153,445,34.38%,24.27%,1
臺南市,七股區,0265,128,41,169,12,181,680,26.62%,18.82%,1
臺南市,七股區,0266,171,67,238,9,247,838,29.47%,20.41%,1
臺南市,七股區,0267,181,52,233,18,251,780,32.18%,23.21%,1
臺南市,七股區,0268,123,45,168,14,182,350,52%,35.14%,1
臺南市,七股區,0269,335,115,450,69,519,907,57.22%,36.93%,1
臺南市,七股區,0270,243,52,295,20,315,780,40.38%,31.15%,1
臺南市,七股區,0271,481,146,627,47,674,1658,40.65%,29.01%,1
臺南市,七股區,0272,269,73,342,34,376,913,41.18%,29.46%,1
臺南市,七股區,0273,389,138,527,63,590,1202,49.08%,32.36%,1
臺南市,七股區,0274,174,56,230,9,239,696,34.34%,25%,1
臺南市,七股區,0275,188,75,263,39,302,647,46.68%,29.06%,1
臺南市,七股區,0276,261,73,334,51,385,622,61.9%,41.96%,1
臺南市,七股區,0277,430,147,577,88,665,1175,56.6%,36.6%,1
臺南市,七股區,0278,211,62,273,30,303,698,43.41%,30.23%,1
臺南市,七股區,0279,339,101,440,70,510,983,51.88%,34.49%,1
臺南市,七股區,0280,327,109,436,41,477,1366,34.92%,23.94%,1
臺南市,七股區,0281,354,175,529,72,601,1379,43.58%,25.67%,1
臺南市,將軍區,0234,398,150,548,73,621,1110,55.95%,35.86%,1
臺南市,將軍區,0235,472,123,595,27,622,1418,43.86%,33.29%,1
臺南市,將軍區,0236,294,105,399,26,425,969,43.86%,30.34%,1
臺南市,將軍區,0237,201,58,259,41,300,519,57.8%,38.73%,1
臺南市,將軍區,0238,399,78,477,22,499,1106,45.12%,36.08%,1
臺南市,將軍區,0239,153,73,226,42,268,542,49.45%,28.23%,1
臺南市,將軍區,0240,80,24,104,11,115,315,36.51%,25.4%,1
臺南市,將軍區,0241,166,51,217,19,236,584,40.41%,28.42%,1
臺南市,將軍區,0242,127,38,165,7,172,398,43.22%,31.91%,1
臺南市,將軍區,0243,155,51,206,16,222,608,36.51%,25.49%,1
臺南市,將軍區,0244,154,43,197,20,217,442,49.1%,34.84%,1
臺南市,將軍區,0245,152,58,210,9,219,650,33.69%,23.38%,1
臺南市,將軍區,0246,130,40,170,12,182,573,31.76%,22.69%,1
臺南市,將軍區,0247,149,47,196,10,206,617,33.39%,24.15%,1
臺南市,將軍區,0248,184,47,231,23,254,573,44.33%,32.11%,1
臺南市,將軍區,0249,142,44,186,26,212,434,48.85%,32.72%,1
臺南市,將軍區,0250,213,81,294,11,305,849,35.92%,25.09%,1
臺南市,將軍區,0251,177,49,226,30,256,645,39.69%,27.44%,1
臺南市,將軍區,0252,161,55,216,28,244,690,35.36%,23.33%,1
臺南市,將軍區,0253,132,45,177,6,183,663,27.6%,19.91%,1
臺南市,將軍區,0254,286,87,373,28,401,1175,34.13%,24.34%,1
臺南市,將軍區,0255,193,57,250,30,280,837,33.45%,23.06%,1
臺南市,將軍區,0256,336,95,431,124,555,1061,52.31%,31.67%,1
臺南市,將軍區,0257,218,59,277,24,301,976,30.84%,22.34%,1
臺南市,北門區,0190,132,57,189,11,200,484,41.32%,27.27%,1
臺南市,北門區,0191,128,21,149,14,163,401,40.65%,31.92%,1
臺南市,北門區,0192,117,29,146,7,153,456,33.55%,25.66%,1
臺南市,北門區,0193,131,49,180,20,200,382,52.36%,34.29%,1
臺南市,北門區,0194,116,34,150,25,175,356,49.16%,32.58%,1
臺南市,北門區,0195,102,26,128,7,135,389,34.7%,26.22%,1
臺南市,北門區,0196,226,58,284,3,287,742,38.68%,30.46%,1
臺南市,北門區,0197,158,56,214,16,230,599,38.4%,26.38%,1
臺南市,北門區,0198,164,53,217,27,244,594,41.08%,27.61%,1
臺南市,北門區,0199,159,59,218,26,244,572,42.66%,27.8%,1
臺南市,北門區,0200,68,22,90,4,94,318,29.56%,21.38%,1
臺南市,北門區,0201,116,47,163,13,176,473,37.21%,24.52%,1
臺南市,北門區,0202,190,75,265,14,279,954,29.25%,19.92%,1
臺南市,北門區,0203,267,84,351,37,388,737,52.65%,36.23%,1
臺南市,北門區,0204,151,51,202,15,217,679,31.96%,22.24%,1
臺南市,北門區,0205,129,39,168,29,197,521,37.81%,24.76%,1
臺南市,北門區,0206,148,45,193,14,207,632,32.75%,23.42%,1
臺南市,北門區,0207,161,41,202,10,212,636,33.33%,25.31%,1
臺南市,新化區,0581,329,85,414,38,452,746,60.59%,44.1%,1
臺南市,新化區,0582,445,163,608,41,649,1102,58.89%,40.38%,1
臺南市,新化區,0583,153,37,190,24,214,370,57.84%,41.35%,1
臺南市,新化區,0584,360,132,492,75,567,947,59.87%,38.01%,1
臺南市,新化區,0585,428,120,548,64,612,1154,53.03%,37.09%,1
臺南市,新化區,0586,406,131,537,70,607,1082,56.1%,37.52%,1
臺南市,新化區,0587,425,132,557,54,611,1075,56.84%,39.53%,1
臺南市,新化區,0588,248,65,313,25,338,640,52.81%,38.75%,1
臺南市,新化區,0589,128,52,180,20,200,410,48.78%,31.22%,1
臺南市,新化區,0590,185,55,240,30,270,533,50.66%,34.71%,1
臺南市,新化區,0591,300,103,403,27,430,836,51.44%,35.89%,1
臺南市,新化區,0592,288,101,389,29,418,978,42.74%,29.45%,1
臺南市,新化區,0593,492,172,664,47,711,1348,52.74%,36.5%,1
臺南市,新化區,0594,361,126,487,48,535,1015,52.71%,35.57%,1
臺南市,新化區,0595,415,120,535,33,568,1228,46.25%,33.79%,1
臺南市,新化區,0596,303,99,402,50,452,789,57.29%,38.4%,1
臺南市,新化區,0597,346,125,471,25,496,1022,48.53%,33.86%,1
臺南市,新化區,0598,355,103,458,23,481,1021,47.11%,34.77%,1
臺南市,新化區,0599,493,147,640,66,706,1229,57.45%,40.11%,1
臺南市,新化區,0600,441,122,563,17,580,1153,50.3%,38.25%,1
臺南市,新化區,0601,294,92,386,19,405,1012,40.02%,29.05%,1
臺南市,新化區,0602,534,184,718,75,793,1458,54.39%,36.63%,1
臺南市,新化區,0603,665,179,844,67,911,1645,55.38%,40.43%,1
臺南市,新化區,0604,396,129,525,58,583,1016,57.38%,38.98%,1
臺南市,新化區,0605,195,62,257,10,267,559,47.76%,34.88%,1
臺南市,新化區,0606,475,161,636,43,679,1222,55.56%,38.87%,1
臺南市,新化區,0607,656,196,852,64,916,1562,58.64%,42%,1
臺南市,新化區,0608,314,104,418,30,448,994,45.07%,31.59%,1
臺南市,新化區,0609,380,94,474,86,560,1013,55.28%,37.51%,1
臺南市,新化區,0610,439,153,592,79,671,1197,56.06%,36.68%,1
臺南市,新化區,0611,329,121,450,58,508,1021,49.76%,32.22%,1
臺南市,新化區,0612,434,131,565,82,647,1428,45.31%,30.39%,1
臺南市,新化區,0613,120,56,176,39,215,456,47.15%,26.32%,1
臺南市,新化區,0614,390,129,519,58,577,1037,55.64%,37.61%,1
臺南市,新化區,0615,403,116,519,93,612,1097,55.79%,36.74%,1
臺南市,新化區,0616,315,123,438,59,497,902,55.1%,34.92%,1
臺南市,新化區,0617,308,100,408,100,508,999,50.85%,30.83%,1
臺南市,善化區,0492,349,115,464,29,493,1132,43.55%,30.83%,1
臺南市,善化區,0493,644,196,840,67,907,1845,49.16%,34.91%,1
臺南市,善化區,0494,731,216,947,101,1048,2090,50.14%,34.98%,1
臺南市,善化區,0495,619,170,789,83,872,1582,55.12%,39.13%,1
臺南市,善化區,0496,710,248,958,85,1043,1901,54.87%,37.35%,1
臺南市,善化區,0497,657,219,876,57,933,1818,51.32%,36.14%,1
臺南市,善化區,0498,602,174,776,71,847,1639,51.68%,36.73%,1
臺南市,善化區,0499,428,135,563,33,596,1061,56.17%,40.34%,1
臺南市,善化區,0500,666,217,883,100,983,1786,55.04%,37.29%,1
臺南市,善化區,0501,416,127,543,42,585,1147,51%,36.27%,1
臺南市,善化區,0502,531,180,711,74,785,1581,49.65%,33.59%,1
臺南市,善化區,0503,404,162,566,88,654,1240,52.74%,32.58%,1
臺南市,善化區,0504,453,163,616,32,648,1743,37.18%,25.99%,1
臺南市,善化區,0505,459,173,632,63,695,1246,55.78%,36.84%,1
臺南市,善化區,0506,327,104,431,28,459,961,47.76%,34.03%,1
臺南市,善化區,0507,310,97,407,16,423,938,45.1%,33.05%,1
臺南市,善化區,0508,243,90,333,19,352,722,48.75%,33.66%,1
臺南市,善化區,0509,330,100,430,21,451,1062,42.47%,31.07%,1
臺南市,善化區,0510,579,193,772,95,867,1715,50.55%,33.76%,1
臺南市,善化區,0511,361,118,479,56,535,1120,47.77%,32.23%,1
臺南市,善化區,0512,277,105,382,47,429,865,49.6%,32.02%,1
臺南市,善化區,0513,552,196,748,68,816,1574,51.84%,35.07%,1
臺南市,善化區,0514,429,178,607,83,690,1535,44.95%,27.95%,1
臺南市,善化區,0515,370,150,520,59,579,1106,52.35%,33.45%,1
臺南市,善化區,0516,459,154,613,43,656,1402,46.79%,32.74%,1
臺南市,善化區,0517,569,206,775,93,868,1458,59.53%,39.03%,1
臺南市,善化區,0518,446,147,593,45,638,1380,46.23%,32.32%,1
臺南市,善化區,0519,491,141,632,10,642,1232,52.11%,39.85%,1
臺南市,善化區,0520,445,118,563,12,575,1069,53.79%,41.63%,1
臺南市,新市區,0545,330,94,424,26,450,960,46.88%,34.38%,1
臺南市,新市區,0546,454,157,611,39,650,1118,58.14%,40.61%,1
臺南市,新市區,0547,297,89,386,28,414,850,48.71%,34.94%,1
臺南市,新市區,0548,489,114,603,58,661,1241,53.26%,39.4%,1
臺南市,新市區,0549,508,151,659,41,700,1297,53.97%,39.17%,1
臺南市,新市區,0550,407,89,496,44,540,962,56.13%,42.31%,1
臺南市,新市區,0551,494,146,640,57,697,1237,56.35%,39.94%,1
臺南市,新市區,0552,489,174,663,47,710,1326,53.54%,36.88%,1
臺南市,新市區,0553,483,148,631,63,694,1211,57.31%,39.88%,1
臺南市,新市區,0554,447,167,614,42,656,1305,50.27%,34.25%,1
臺南市,新市區,0555,242,75,317,59,376,688,54.65%,35.17%,1
臺南市,新市區,0556,357,119,476,36,512,911,56.2%,39.19%,1
臺南市,新市區,0557,493,169,662,57,719,1525,47.15%,32.33%,1
臺南市,新市區,0558,335,78,413,6,419,1091,38.41%,30.71%,1
臺南市,新市區,0559,417,118,535,28,563,1122,50.18%,37.17%,1
臺南市,新市區,0560,377,95,472,31,503,1049,47.95%,35.94%,1
臺南市,新市區,0561,504,130,634,22,656,1564,41.94%,32.23%,1
臺南市,新市區,0562,566,188,754,54,808,1515,53.33%,37.36%,1
臺南市,新市區,0563,465,169,634,39,673,1378,48.84%,33.74%,1
臺南市,新市區,0564,354,97,451,62,513,827,62.03%,42.81%,1
臺南市,新市區,0565,392,124,516,93,609,960,63.44%,40.83%,1
臺南市,新市區,0566,323,117,440,58,498,951,52.37%,33.96%,1
臺南市,新市區,0567,458,171,629,67,696,1264,55.06%,36.23%,1
臺南市,新市區,0568,421,133,554,42,596,1173,50.81%,35.89%,1
臺南市,新市區,0569,252,106,358,25,383,684,55.99%,36.84%,1
臺南市,新市區,0570,442,130,572,75,647,1055,61.33%,41.9%,1
臺南市,新市區,0571,502,131,633,51,684,1122,60.96%,44.74%,1
臺南市,安定區,0521,504,171,675,93,768,1251,61.39%,40.29%,1
臺南市,安定區,0522,328,94,422,48,470,899,52.28%,36.48%,1
臺南市,安定區,0523,404,118,522,80,602,1106,54.43%,36.53%,1
臺南市,安定區,0524,350,113,463,62,525,948,55.38%,36.92%,1
臺南市,安定區,0525,488,148,636,33,669,1442,46.39%,33.84%,1
臺南市,安定區,0526,426,151,577,63,640,1385,46.21%,30.76%,1
臺南市,安定區,0527,321,86,407,51,458,801,57.18%,40.07%,1
臺南市,安定區,0528,213,84,297,36,333,736,45.24%,28.94%,1
臺南市,安定區,0529,285,74,359,42,401,781,51.34%,36.49%,1
臺南市,安定區,0530,306,92,398,20,418,795,52.58%,38.49%,1
臺南市,安定區,0531,343,108,451,53,504,862,58.47%,39.79%,1
臺南市,安定區,0532,530,137,667,27,694,1487,46.67%,35.64%,1
臺南市,安定區,0533,497,148,645,29,674,1385,48.66%,35.88%,1
臺南市,安定區,0534,489,151,640,34,674,1518,44.4%,32.21%,1
臺南市,安定區,0535,447,127,574,62,636,1094,58.14%,40.86%,1
臺南市,安定區,0536,573,196,769,109,878,1590,55.22%,36.04%,1
臺南市,安定區,0537,293,87,380,42,422,754,55.97%,38.86%,1
臺南市,安定區,0538,262,91,353,47,400,716,55.87%,36.59%,1
臺南市,安定區,0539,573,175,748,63,811,1492,54.36%,38.4%,1
臺南市,安定區,0540,358,114,472,43,515,943,54.61%,37.96%,1
臺南市,安定區,0541,418,124,542,36,578,1157,49.96%,36.13%,1
臺南市,安定區,0542,502,158,660,107,767,1384,55.42%,36.27%,1
臺南市,安定區,0543,344,118,462,57,519,967,53.67%,35.57%,1
臺南市,安定區,0544,216,79,295,26,321,611,52.54%,35.35%,1
臺南市,山上區,0572,226,77,303,54,357,855,41.75%,26.43%,1
臺南市,山上區,0573,215,61,276,40,316,836,37.8%,25.72%,1
臺南市,山上區,0574,235,83,318,47,365,753,48.47%,31.21%,1
臺南市,山上區,0575,254,76,330,41,371,788,47.08%,32.23%,1
臺南市,山上區,0576,337,104,441,48,489,984,49.7%,34.25%,1
臺南市,山上區,0577,266,109,375,8,383,972,39.4%,27.37%,1
臺南市,山上區,0578,118,33,151,5,156,553,28.21%,21.34%,1
臺南市,山上區,0579,109,25,134,7,141,378,37.3%,28.84%,1
臺南市,山上區,0580,113,41,154,25,179,392,45.66%,28.83%,1
臺南市,玉井區,0466,430,115,545,27,572,1242,46.05%,34.62%,1
臺南市,玉井區,0467,443,109,552,37,589,1141,51.62%,38.83%,1
臺南市,玉井區,0468,223,79,302,21,323,698,46.28%,31.95%,1
臺南市,玉井區,0469,302,85,387,17,404,849,47.59%,35.57%,1
臺南市,玉井區,0470,371,86,457,50,507,949,53.42%,39.09%,1
臺南市,玉井區,0471,210,68,278,23,301,618,48.71%,33.98%,1
臺南市,玉井區,0472,181,38,219,10,229,594,38.55%,30.47%,1
臺南市,玉井區,0473,280,73,353,21,374,927,40.35%,30.2%,1
臺南市,玉井區,0474,166,56,222,49,271,512,52.93%,32.42%,1
臺南市,玉井區,0475,161,48,209,33,242,509,47.54%,31.63%,1
臺南市,玉井區,0476,186,51,237,24,261,496,52.62%,37.5%,1
臺南市,玉井區,0477,234,69,303,15,318,759,41.9%,30.83%,1
臺南市,玉井區,0478,168,58,226,12,238,669,35.58%,25.11%,1
臺南市,玉井區,0479,229,89,318,64,382,787,48.54%,29.1%,1
臺南市,玉井區,0480,180,57,237,46,283,620,45.65%,29.03%,1
臺南市,玉井區,0481,340,105,445,56,501,987,50.76%,34.45%,1
臺南市,楠西區,0447,305,111,416,60,476,978,48.67%,31.19%,1
臺南市,楠西區,0448,326,104,430,42,472,870,54.25%,37.47%,1
臺南市,楠西區,0449,265,65,330,10,340,1160,29.31%,22.84%,1
臺南市,楠西區,0450,196,59,255,27,282,699,40.34%,28.04%,1
臺南市,楠西區,0451,254,65,319,15,334,990,33.74%,25.66%,1
臺南市,楠西區,0452,281,78,359,32,391,928,42.13%,30.28%,1
臺南市,楠西區,0453,210,58,268,44,312,660,47.27%,31.82%,1
臺南市,楠西區,0454,394,106,500,76,576,1187,48.53%,33.19%,1
臺南市,楠西區,0455,341,98,439,35,474,1056,44.89%,32.29%,1
臺南市,南化區,0456,233,88,321,46,367,690,53.19%,33.77%,1
臺南市,南化區,0457,243,81,324,57,381,695,54.82%,34.96%,1
臺南市,南化區,0458,231,87,318,38,356,806,44.17%,28.66%,1
臺南市,南化區,0459,168,53,221,48,269,654,41.13%,25.69%,1
臺南市,南化區,0460,186,65,251,33,284,783,36.27%,23.75%,1
臺南市,南化區,0461,127,58,185,20,205,425,48.24%,29.88%,1
臺南市,南化區,0462,185,57,242,32,274,559,49.02%,33.09%,1
臺南市,南化區,0463,346,98,444,25,469,1189,39.44%,29.1%,1
臺南市,南化區,0464,361,130,491,35,526,1044,50.38%,34.58%,1
臺南市,南化區,0465,376,91,467,21,488,941,51.86%,39.96%,1
臺南市,左鎮區,0482,130,37,167,20,187,392,47.7%,33.16%,1
臺南市,左鎮區,0483,230,64,294,41,335,644,52.02%,35.71%,1
臺南市,左鎮區,0484,116,47,163,18,181,468,38.68%,24.79%,1
臺南市,左鎮區,0485,181,84,265,47,312,753,41.43%,24.04%,1
臺南市,左鎮區,0486,103,31,134,23,157,345,45.51%,29.86%,1
臺南市,左鎮區,0487,112,39,151,13,164,393,41.73%,28.5%,1
臺南市,左鎮區,0488,122,38,160,13,173,420,41.19%,29.05%,1
臺南市,左鎮區,0489,79,25,104,8,112,313,35.78%,25.24%,1
臺南市,左鎮區,0490,39,22,61,3,64,186,34.41%,20.97%,1
臺南市,左鎮區,0491,122,52,174,45,219,504,43.45%,24.21%,1
臺南市,仁德區,1188,498,152,650,71,721,1318,54.7%,37.78%,1
臺南市,仁德區,1189,533,155,688,80,768,1406,54.62%,37.91%,1
臺南市,仁德區,1190,517,159,676,86,762,1465,52.01%,35.29%,1
臺南市,仁德區,1191,463,176,639,78,717,1192,60.15%,38.84%,1
臺南市,仁德區,1192,571,183,754,66,820,1429,57.38%,39.96%,1
臺南市,仁德區,1193,429,176,605,118,723,1320,54.77%,32.5%,1
臺南市,仁德區,1194,588,147,735,92,827,1373,60.23%,42.83%,1
臺南市,仁德區,1195,532,168,700,59,759,1330,57.07%,40%,1
臺南市,仁德區,1196,684,190,874,40,914,1687,54.18%,40.55%,1
臺南市,仁德區,1197,529,168,697,57,754,1491,50.57%,35.48%,1
臺南市,仁德區,1198,375,122,497,41,538,1151,46.74%,32.58%,1
臺南市,仁德區,1199,573,118,691,24,715,1407,50.82%,40.72%,1
臺南市,仁德區,1200,609,165,774,53,827,1465,56.45%,41.57%,1
臺南市,仁德區,1201,520,178,698,49,747,1335,55.96%,38.95%,1
臺南市,仁德區,1202,539,173,712,71,783,1490,52.55%,36.17%,1
臺南市,仁德區,1203,628,164,792,58,850,1453,58.5%,43.22%,1
臺南市,仁德區,1204,328,127,455,27,482,990,48.69%,33.13%,1
臺南市,仁德區,1205,641,175,816,65,881,1573,56.01%,40.75%,1
臺南市,仁德區,1206,372,125,497,69,566,1031,54.9%,36.08%,1
臺南市,仁德區,1207,436,152,588,32,620,1194,51.93%,36.52%,1
臺南市,仁德區,1208,459,133,592,60,652,1268,51.42%,36.2%,1
臺南市,仁德區,1209,338,129,467,42,509,929,54.79%,36.38%,1
臺南市,仁德區,1210,387,106,493,16,509,1145,44.45%,33.8%,1
臺南市,仁德區,1211,500,144,644,61,705,1413,49.89%,35.39%,1
臺南市,仁德區,1212,526,171,697,89,786,1465,53.65%,35.9%,1
臺南市,仁德區,1213,571,167,738,58,796,1390,57.27%,41.08%,1
臺南市,仁德區,1214,486,208,694,70,764,1396,54.73%,34.81%,1
臺南市,仁德區,1215,724,221,945,48,993,1906,52.1%,37.99%,1
臺南市,仁德區,1216,595,141,736,36,772,1546,49.94%,38.49%,1
臺南市,仁德區,1217,492,145,637,33,670,1546,43.34%,31.82%,1
臺南市,仁德區,1218,546,146,692,51,743,1399,53.11%,39.03%,1
臺南市,仁德區,1219,636,187,823,102,925,1748,52.92%,36.38%,1
臺南市,仁德區,1220,458,144,602,43,645,1140,56.58%,40.18%,1
臺南市,仁德區,1221,448,121,569,34,603,1277,47.22%,35.08%,1
臺南市,仁德區,1222,478,121,599,44,643,1019,63.1%,46.91%,1
臺南市,仁德區,1223,484,136,620,34,654,1414,46.25%,34.23%,1
臺南市,仁德區,1224,433,129,562,33,595,1349,44.11%,32.1%,1
臺南市,仁德區,1225,530,146,676,31,707,1471,48.06%,36.03%,1
臺南市,仁德區,1226,482,142,624,20,644,1324,48.64%,36.4%,1
臺南市,仁德區,1227,481,90,571,51,622,1310,47.48%,36.72%,1
臺南市,仁德區,1228,221,73,294,27,321,554,57.94%,39.89%,1
臺南市,仁德區,1229,601,104,705,43,748,1395,53.62%,43.08%,1
臺南市,仁德區,1230,503,98,601,18,619,1264,48.97%,39.79%,1
臺南市,仁德區,1231,424,105,529,87,616,1180,52.2%,35.93%,1
臺南市,仁德區,1232,276,102,378,31,409,928,44.07%,29.74%,1
臺南市,仁德區,1233,294,98,392,25,417,965,43.21%,30.47%,1
臺南市,仁德區,1234,351,110,461,35,496,1119,44.33%,31.37%,1
臺南市,仁德區,1235,446,131,577,71,648,1206,53.73%,36.98%,1
臺南市,仁德區,1236,474,127,601,44,645,1466,44%,32.33%,1
臺南市,歸仁區,1237,539,184,723,73,796,1560,51.03%,34.55%,1
臺南市,歸仁區,1238,578,177,755,80,835,1383,60.38%,41.79%,1
臺南市,歸仁區,1239,540,188,728,39,767,1491,51.44%,36.22%,1
臺南市,歸仁區,1240,474,180,654,71,725,1482,48.92%,31.98%,1
臺南市,歸仁區,1241,478,165,643,33,676,1330,50.83%,35.94%,1
臺南市,歸仁區,1242,560,171,731,49,780,1399,55.75%,40.03%,1
臺南市,歸仁區,1243,488,155,643,34,677,1416,47.81%,34.46%,1
臺南市,歸仁區,1244,371,139,510,48,558,1336,41.77%,27.77%,1
臺南市,歸仁區,1245,379,140,519,67,586,1183,49.54%,32.04%,1
臺南市,歸仁區,1246,396,142,538,27,565,1237,45.68%,32.01%,1
臺南市,歸仁區,1247,437,115,552,77,629,1133,55.52%,38.57%,1
臺南市,歸仁區,1248,387,135,522,48,570,1149,49.61%,33.68%,1
臺南市,歸仁區,1249,416,121,537,7,544,1105,49.23%,37.65%,1
臺南市,歸仁區,1250,395,148,543,57,600,1099,54.6%,35.94%,1
臺南市,歸仁區,1251,417,123,540,88,628,1082,58.04%,38.54%,1
臺南市,歸仁區,1252,673,61,734,57,791,1519,52.07%,44.31%,1
臺南市,歸仁區,1253,580,181,761,73,834,1467,56.85%,39.54%,1
臺南市,歸仁區,1254,392,128,520,51,571,1090,52.39%,35.96%,1
臺南市,歸仁區,1255,383,131,514,37,551,1131,48.72%,33.86%,1
臺南市,歸仁區,1256,361,115,476,39,515,1080,47.69%,33.43%,1
臺南市,歸仁區,1257,352,110,462,28,490,1121,43.71%,31.4%,1
臺南市,歸仁區,1258,464,172,636,84,720,1336,53.89%,34.73%,1
臺南市,歸仁區,1259,383,156,539,74,613,1128,54.34%,33.95%,1
臺南市,歸仁區,1260,382,118,500,27,527,1055,49.95%,36.21%,1
臺南市,歸仁區,1261,401,140,541,34,575,1102,52.18%,36.39%,1
臺南市,歸仁區,1262,417,112,529,49,578,1068,54.12%,39.04%,1
臺南市,歸仁區,1263,390,129,519,74,593,1033,57.41%,37.75%,1
臺南市,歸仁區,1264,492,137,629,44,673,1772,37.98%,27.77%,1
臺南市,歸仁區,1265,523,167,690,82,772,1399,55.18%,37.38%,1
臺南市,歸仁區,1266,584,154,738,33,771,1544,49.94%,37.82%,1
臺南市,歸仁區,1267,220,58,278,12,290,684,42.4%,32.16%,1
臺南市,歸仁區,1268,312,129,441,46,487,839,58.05%,37.19%,1
臺南市,歸仁區,1269,371,147,518,68,586,1014,57.79%,36.59%,1
臺南市,歸仁區,1270,512,138,650,40,690,1906,36.2%,26.86%,1
臺南市,歸仁區,1271,486,156,642,68,710,1245,57.03%,39.04%,1
臺南市,歸仁區,1272,380,133,513,43,556,1048,53.05%,36.26%,1
臺南市,歸仁區,1273,410,127,537,29,566,1175,48.17%,34.89%,1
臺南市,歸仁區,1274,473,138,611,31,642,1411,45.5%,33.52%,1
臺南市,歸仁區,1275,621,179,800,55,855,1514,56.47%,41.02%,1
臺南市,歸仁區,1276,627,199,826,77,903,1678,53.81%,37.37%,1
臺南市,歸仁區,1277,354,121,475,31,506,949,53.32%,37.3%,1
臺南市,歸仁區,1278,376,154,530,65,595,1009,58.97%,37.26%,1
臺南市,歸仁區,1279,445,131,576,5,581,984,59.04%,45.22%,1
臺南市,歸仁區,1280,310,91,401,43,444,756,58.73%,41.01%,1
臺南市,歸仁區,1281,626,176,802,69,871,1478,58.93%,42.35%,1
臺南市,歸仁區,1282,607,186,793,72,865,1467,58.96%,41.38%,1
臺南市,關廟區,1283,344,114,458,27,485,982,49.39%,35.03%,1
臺南市,關廟區,1284,459,157,616,45,661,1156,57.18%,39.71%,1
臺南市,關廟區,1285,320,111,431,33,464,1006,46.12%,31.81%,1
臺南市,關廟區,1286,409,162,571,59,630,1043,60.4%,39.21%,1
臺南市,關廟區,1287,375,119,494,87,581,1012,57.41%,37.06%,1
臺南市,關廟區,1288,312,100,412,23,435,1013,42.94%,30.8%,1
臺南市,關廟區,1289,449,154,603,41,644,1294,49.77%,34.7%,1
臺南市,關廟區,1290,413,164,577,46,623,1264,49.29%,32.67%,1
臺南市,關廟區,1291,413,138,551,41,592,1166,50.77%,35.42%,1
臺南市,關廟區,1292,335,107,442,20,462,1018,45.38%,32.91%,1
臺南市,關廟區,1293,226,75,301,40,341,733,46.52%,30.83%,1
臺南市,關廟區,1294,449,129,578,32,610,1093,55.81%,41.08%,1
臺南市,關廟區,1295,446,102,548,23,571,1081,52.82%,41.26%,1
臺南市,關廟區,1296,392,137,529,41,570,978,58.28%,40.08%,1
臺南市,關廟區,1297,358,116,474,31,505,1116,45.25%,32.08%,1
臺南市,關廟區,1298,353,116,469,48,517,972,53.19%,36.32%,1
臺南市,關廟區,1299,366,147,513,89,602,1045,57.61%,35.02%,1
臺南市,關廟區,1300,332,95,427,32,459,872,52.64%,38.07%,1
臺南市,關廟區,1301,395,136,531,37,568,1007,56.41%,39.23%,1
臺南市,關廟區,1302,283,115,398,59,457,763,59.9%,37.09%,1
臺南市,關廟區,1303,240,60,300,34,334,630,53.02%,38.1%,1
臺南市,關廟區,1304,352,136,488,65,553,959,57.66%,36.7%,1
臺南市,關廟區,1305,388,136,524,35,559,1123,49.78%,34.55%,1
臺南市,關廟區,1306,270,114,384,72,456,804,56.72%,33.58%,1
臺南市,關廟區,1307,246,77,323,18,341,720,47.36%,34.17%,1
臺南市,關廟區,1308,278,52,330,22,352,843,41.76%,32.98%,1
臺南市,關廟區,1309,124,30,154,11,165,358,46.09%,34.64%,1
臺南市,關廟區,1310,270,94,364,61,425,797,53.32%,33.88%,1
臺南市,關廟區,1311,223,59,282,15,297,709,41.89%,31.45%,1
臺南市,關廟區,1312,277,104,381,20,401,904,44.36%,30.64%,1
臺南市,關廟區,1313,335,103,438,27,465,963,48.29%,34.79%,1
臺南市,關廟區,1314,175,60,235,9,244,489,49.9%,35.79%,1
臺南市,龍崎區,1315,353,113,466,67,533,1047,50.91%,33.72%,1
臺南市,龍崎區,1316,198,51,249,19,268,630,42.54%,31.43%,1
臺南市,龍崎區,1317,34,12,46,3,49,141,34.75%,24.11%,1
臺南市,龍崎區,1318,114,45,159,15,174,367,47.41%,31.06%,1
臺南市,龍崎區,1319,116,34,150,10,160,337,47.48%,34.42%,1
臺南市,龍崎區,1320,94,25,119,6,125,318,39.31%,29.56%,1
臺南市,龍崎區,1321,162,25,187,26,213,427,49.88%,37.94%,1
臺南市,龍崎區,1322,120,43,163,14,177,446,39.69%,26.91%,1
臺南市,永康區,0708,544,147,691,67,758,1398,54.22%,38.91%,1
臺南市,永康區,0709,448,133,581,42,623,1478,42.15%,30.31%,1
臺南市,永康區,0710,500,175,675,40,715,1442,49.58%,34.67%,1
臺南市,永康區,0711,491,119,610,53,663,1353,49%,36.29%,1
臺南市,永康區,0712,404,137,541,28,569,1160,49.05%,34.83%,1
臺南市,永康區,0713,445,121,566,32,598,1122,53.3%,39.66%,1
臺南市,永康區,0714,422,115,537,22,559,1165,47.98%,36.22%,1
臺南市,永康區,0715,472,135,607,48,655,1317,49.73%,35.84%,1
臺南市,永康區,0716,515,140,655,48,703,1376,51.09%,37.43%,1
臺南市,永康區,0717,509,176,685,39,724,1361,53.2%,37.4%,1
臺南市,永康區,0718,586,167,753,46,799,1374,58.15%,42.65%,1
臺南市,永康區,0719,565,185,750,77,827,1709,48.39%,33.06%,1
臺南市,永康區,0720,591,178,769,65,834,1717,48.57%,34.42%,1
臺南市,永康區,0721,586,196,782,57,839,1759,47.7%,33.31%,1
臺南市,永康區,0722,619,188,807,48,855,1636,52.26%,37.84%,1
臺南市,永康區,0723,502,143,645,62,707,1442,49.03%,34.81%,1
臺南市,永康區,0724,579,152,731,50,781,1545,50.55%,37.48%,1
臺南市,永康區,0725,592,147,739,47,786,1565,50.22%,37.83%,1
臺南市,永康區,0726,593,172,765,44,809,1684,48.04%,35.21%,1
臺南市,永康區,0727,550,146,696,29,725,1548,46.83%,35.53%,1
臺南市,永康區,0728,530,176,706,32,738,1389,53.13%,38.16%,1
臺南市,永康區,0729,495,152,647,70,717,1369,52.37%,36.16%,1
臺南市,永康區,0730,519,155,674,91,765,1415,54.06%,36.68%,1
臺南市,永康區,0731,453,126,579,19,598,1386,43.15%,32.68%,1
臺南市,永康區,0732,305,80,385,5,390,1747,22.32%,17.46%,1
臺南市,永康區,0733,541,160,701,57,758,1485,51.04%,36.43%,1
臺南市,永康區,0734,623,173,796,91,887,1747,50.77%,35.66%,1
臺南市,永康區,0735,541,166,707,41,748,1744,42.89%,31.02%,1
臺南市,永康區,0736,612,166,778,45,823,1797,45.8%,34.06%,1
臺南市,永康區,0737,684,208,892,71,963,1800,53.5%,38%,1
臺南市,永康區,0738,621,155,776,28,804,1720,46.74%,36.1%,1
臺南市,永康區,0739,692,178,870,45,915,1708,53.57%,40.52%,1
臺南市,永康區,0740,603,174,777,31,808,1519,53.19%,39.7%,1
臺南市,永康區,0741,563,187,750,89,839,1497,56.05%,37.61%,1
臺南市,永康區,0742,559,144,703,23,726,1509,48.11%,37.04%,1
臺南市,永康區,0743,646,174,820,79,899,1542,58.3%,41.89%,1
臺南市,永康區,0744,636,171,807,28,835,1536,54.36%,41.41%,1
臺南市,永康區,0745,571,191,762,61,823,1531,53.76%,37.3%,1
臺南市,永康區,0746,539,164,703,54,757,1327,57.05%,40.62%,1
臺南市,永康區,0747,546,159,705,30,735,1456,50.48%,37.5%,1
臺南市,永康區,0748,551,173,724,48,772,1396,55.3%,39.47%,1
臺南市,永康區,0749,563,225,788,52,840,1636,51.34%,34.41%,1
臺南市,永康區,0750,612,188,800,51,851,1592,53.45%,38.44%,1
臺南市,永康區,0751,712,208,920,35,955,2017,47.35%,35.3%,1
臺南市,永康區,0752,231,99,330,21,351,672,52.23%,34.38%,1
臺南市,永康區,0753,560,159,719,26,745,1611,46.24%,34.76%,1
臺南市,永康區,0754,562,169,731,60,791,1502,52.66%,37.42%,1
臺南市,永康區,0755,551,154,705,21,726,1660,43.73%,33.19%,1
臺南市,永康區,0756,482,165,647,34,681,1561,43.63%,30.88%,1
臺南市,永康區,0757,520,192,712,29,741,1590,46.6%,32.7%,1
臺南市,永康區,0758,333,114,447,16,463,924,50.11%,36.04%,1
臺南市,永康區,0759,393,106,499,33,532,938,56.72%,41.9%,1
臺南市,永康區,0760,395,99,494,44,538,957,56.22%,41.27%,1
臺南市,永康區,0761,164,70,234,42,276,496,55.65%,33.06%,1
臺南市,永康區,0762,638,197,835,71,906,1717,52.77%,37.16%,1
臺南市,永康區,0763,528,167,695,49,744,1615,46.07%,32.69%,1
臺南市,永康區,0764,543,181,724,26,750,1554,48.26%,34.94%,1
臺南市,永康區,0765,414,122,536,23,559,1196,46.74%,34.62%,1
臺南市,永康區,0766,495,120,615,44,659,1274,51.73%,38.85%,1
臺南市,永康區,0767,469,137,606,44,650,1215,53.5%,38.6%,1
臺南市,永康區,0768,571,133,704,32,736,1457,50.51%,39.19%,1
臺南市,永康區,0769,568,147,715,22,737,1451,50.79%,39.15%,1
臺南市,永康區,0770,466,166,632,51,683,1423,48%,32.75%,1
臺南市,永康區,0771,539,163,702,42,744,1394,53.37%,38.67%,1
臺南市,永康區,0772,365,101,466,49,515,890,57.87%,41.01%,1
臺南市,永康區,0773,415,143,558,53,611,1018,60.02%,40.77%,1
臺南市,永康區,0774,143,50,193,21,214,368,58.15%,38.86%,1
臺南市,永康區,0775,497,163,660,53,713,1208,59.02%,41.14%,1
臺南市,永康區,0776,379,152,531,39,570,1187,48.02%,31.93%,1
臺南市,永康區,0777,525,140,665,35,700,1381,50.69%,38.02%,1
臺南市,永康區,0778,514,151,665,65,730,1405,51.96%,36.58%,1
臺南市,永康區,0779,481,173,654,68,722,1445,49.97%,33.29%,1
臺南市,永康區,0780,607,174,781,68,849,1687,50.33%,35.98%,1
臺南市,永康區,0781,487,152,639,41,680,1535,44.3%,31.73%,1
臺南市,永康區,0782,613,167,780,55,835,1542,54.15%,39.75%,1
臺南市,永康區,0783,619,163,782,34,816,1618,50.43%,38.26%,1
臺南市,永康區,0784,562,143,705,36,741,1338,55.38%,42%,1
臺南市,永康區,0785,497,151,648,86,734,1285,57.12%,38.68%,1
臺南市,永康區,0786,458,123,581,33,614,1240,49.52%,36.94%,1
臺南市,永康區,0787,463,149,612,58,670,1343,49.89%,34.48%,1
臺南市,永康區,0788,531,170,701,60,761,1327,57.35%,40.02%,1
臺南市,永康區,0789,577,177,754,58,812,1565,51.88%,36.87%,1
臺南市,永康區,0790,570,163,733,89,822,1476,55.69%,38.62%,1
臺南市,永康區,0791,561,160,721,38,759,1476,51.42%,38.01%,1
臺南市,永康區,0792,579,201,780,53,833,1463,56.94%,39.58%,1
臺南市,永康區,0793,380,112,492,80,572,983,58.19%,38.66%,1
臺南市,永康區,0794,404,167,571,76,647,1116,57.97%,36.2%,1
臺南市,永康區,0795,399,113,512,75,587,1117,52.55%,35.72%,1
臺南市,永康區,0796,337,134,471,33,504,1069,47.15%,31.52%,1
臺南市,永康區,0797,524,130,654,43,697,1180,59.07%,44.41%,1
臺南市,永康區,0798,418,134,552,90,642,1176,54.59%,35.54%,1
臺南市,永康區,0799,391,159,550,56,606,1158,52.33%,33.77%,1
臺南市,永康區,0800,466,158,624,84,708,1208,58.61%,38.58%,1
臺南市,永康區,0801,524,184,708,91,799,1501,53.23%,34.91%,1
臺南市,永康區,0802,531,128,659,43,702,1298,54.08%,40.91%,1
臺南市,永康區,0803,558,170,728,34,762,1542,49.42%,36.19%,1
臺南市,永康區,0804,618,178,796,61,857,1537,55.76%,40.21%,1
臺南市,永康區,0805,584,168,752,67,819,1359,60.26%,42.97%,1
臺南市,永康區,0806,353,119,472,44,516,1139,45.3%,30.99%,1
臺南市,永康區,0807,393,134,527,46,573,1158,49.48%,33.94%,1
臺南市,永康區,0808,515,171,686,91,777,1538,50.52%,33.49%,1
臺南市,永康區,0809,395,112,507,32,539,1166,46.23%,33.88%,1
臺南市,永康區,0810,424,130,554,21,575,1228,46.82%,34.53%,1
臺南市,永康區,0811,453,157,610,59,669,1200,55.75%,37.75%,1
臺南市,永康區,0812,431,160,591,42,633,1131,55.97%,38.11%,1
臺南市,永康區,0813,396,152,548,32,580,1147,50.57%,34.52%,1
臺南市,永康區,0814,528,144,672,57,729,1442,50.55%,36.62%,1
臺南市,永康區,0815,455,144,599,33,632,1325,47.7%,34.34%,1
臺南市,永康區,0816,399,132,531,36,567,1260,45%,31.67%,1
臺南市,永康區,0817,595,152,747,52,799,1631,48.99%,36.48%,1
臺南市,永康區,0818,565,152,717,51,768,1549,49.58%,36.48%,1
臺南市,永康區,0819,603,177,780,28,808,1666,48.5%,36.19%,1
臺南市,永康區,0820,353,89,442,54,496,1012,49.01%,34.88%,1
臺南市,永康區,0821,304,91,395,26,421,976,43.14%,31.15%,1
臺南市,永康區,0822,208,50,258,22,280,531,52.73%,39.17%,1
臺南市,永康區,0823,349,71,420,52,472,859,54.95%,40.63%,1
臺南市,永康區,0824,328,95,423,39,462,937,49.31%,35.01%,1
臺南市,永康區,0825,515,136,651,47,698,1307,53.4%,39.4%,1
臺南市,永康區,0826,521,124,645,27,672,1482,45.34%,35.16%,1
臺南市,永康區,0827,459,119,578,40,618,1341,46.09%,34.23%,1
臺南市,永康區,0828,523,134,657,40,697,1376,50.65%,38.01%,1
臺南市,永康區,0829,492,147,639,51,690,1390,49.64%,35.4%,1
臺南市,永康區,0830,591,178,769,58,827,1534,53.91%,38.53%,1
臺南市,永康區,0831,606,148,754,48,802,1460,54.93%,41.51%,1
臺南市,永康區,0832,514,144,658,29,687,1383,49.67%,37.17%,1
臺南市,永康區,0833,457,139,596,42,638,1299,49.11%,35.18%,1
臺南市,永康區,0834,524,143,667,30,697,1264,55.14%,41.46%,1
臺南市,永康區,0835,563,154,717,49,766,1355,56.53%,41.55%,1
臺南市,永康區,0836,526,125,651,29,680,1414,48.09%,37.2%,1
臺南市,永康區,0837,443,154,597,31,628,1109,56.63%,39.95%,1
臺南市,永康區,0838,424,117,541,47,588,1151,51.09%,36.84%,1
臺南市,永康區,0839,501,114,615,45,660,1026,64.33%,48.83%,1
臺南市,永康區,0840,379,101,480,24,504,1071,47.06%,35.39%,1
臺南市,永康區,0841,611,192,803,65,868,1387,62.58%,44.05%,1
臺南市,永康區,0842,569,192,761,42,803,1377,58.32%,41.32%,1
臺南市,永康區,0843,641,191,832,62,894,1687,52.99%,38%,1
臺南市,永康區,0844,602,200,802,41,843,1700,49.59%,35.41%,1
臺南市,永康區,0845,564,196,760,44,804,1444,55.68%,39.06%,1
臺南市,永康區,0846,552,155,707,46,753,1485,50.71%,37.17%,1
臺南市,永康區,0847,607,158,765,37,802,1717,46.71%,35.35%,1
臺南市,永康區,0848,563,183,746,50,796,1701,46.8%,33.1%,1
臺南市,永康區,0849,506,131,637,30,667,1382,48.26%,36.61%,1
臺南市,東區,1095,764,222,986,58,1044,2681,38.94%,28.5%,1
臺南市,東區,1096,634,226,860,41,901,1811,49.75%,35.01%,1
臺南市,東區,1097,631,215,846,85,931,1491,62.44%,42.32%,1
臺南市,東區,1098,544,171,715,41,756,1378,54.86%,39.48%,1
臺南市,東區,1099,625,190,815,57,872,1552,56.19%,40.27%,1
臺南市,東區,1100,574,160,734,24,758,1326,57.16%,43.29%,1
臺南市,東區,1101,622,202,824,70,894,1594,56.09%,39.02%,1
臺南市,東區,1102,661,218,879,60,939,1639,57.29%,40.33%,1
臺南市,東區,1103,638,219,857,66,923,1724,53.54%,37.01%,1
臺南市,東區,1104,631,199,830,77,907,1629,55.68%,38.74%,1
臺南市,東區,1105,564,151,715,33,748,1399,53.47%,40.31%,1
臺南市,東區,1106,608,169,777,33,810,1534,52.8%,39.63%,1
臺南市,東區,1107,669,220,889,43,932,1656,56.28%,40.4%,1
臺南市,東區,1108,526,141,667,61,728,1322,55.07%,39.79%,1
臺南市,東區,1109,657,184,841,31,872,1620,53.83%,40.56%,1
臺南市,東區,1110,636,140,776,34,810,1331,60.86%,47.78%,1
臺南市,東區,1111,425,113,538,46,584,1039,56.21%,40.9%,1
臺南市,東區,1112,429,124,553,38,591,1257,47.02%,34.13%,1
臺南市,東區,1113,722,221,943,104,1047,2067,50.65%,34.93%,1
臺南市,東區,1114,886,193,1079,36,1115,2153,51.79%,41.15%,1
臺南市,東區,1115,928,233,1161,63,1224,2363,51.8%,39.27%,1
臺南市,東區,1116,545,188,733,48,781,1427,54.73%,38.19%,1
臺南市,東區,1117,633,178,811,40,851,1555,54.73%,40.71%,1
臺南市,東區,1118,688,198,886,66,952,2115,45.01%,32.53%,1
臺南市,東區,1119,824,247,1071,90,1161,2340,49.62%,35.21%,1
臺南市,東區,1120,830,293,1123,69,1192,2474,48.18%,33.55%,1
臺南市,東區,1121,893,273,1166,70,1236,2391,51.69%,37.35%,1
臺南市,東區,1122,634,236,870,49,919,1673,54.93%,37.9%,1
臺南市,東區,1123,578,201,779,47,826,1594,51.82%,36.26%,1
臺南市,東區,1124,673,187,860,60,920,1607,57.25%,41.88%,1
臺南市,東區,1125,898,262,1160,33,1193,2087,57.16%,43.03%,1
臺南市,東區,1126,1021,294,1315,32,1347,2369,56.86%,43.1%,1
臺南市,東區,1127,616,192,808,100,908,1696,53.54%,36.32%,1
臺南市,東區,1128,576,216,792,52,844,1612,52.36%,35.73%,1
臺南市,東區,1129,611,191,802,72,874,1708,51.17%,35.77%,1
臺南市,東區,1130,618,185,803,50,853,1560,54.68%,39.62%,1
臺南市,東區,1131,691,221,912,75,987,1854,53.24%,37.27%,1
臺南市,東區,1132,761,279,1040,42,1082,2278,47.5%,33.41%,1
臺南市,東區,1133,770,215,985,68,1053,2093,50.31%,36.79%,1
臺南市,東區,1134,947,266,1213,64,1277,2242,56.96%,42.24%,1
臺南市,東區,1135,473,156,629,61,690,1152,59.9%,41.06%,1
臺南市,東區,1136,603,169,772,24,796,1318,60.39%,45.75%,1
臺南市,東區,1137,855,251,1106,56,1162,2200,52.82%,38.86%,1
臺南市,東區,1138,853,237,1090,41,1131,1960,57.7%,43.52%,1
臺南市,東區,1139,537,191,728,49,777,1489,52.18%,36.06%,1
臺南市,東區,1140,516,205,721,74,795,1443,55.09%,35.76%,1
臺南市,東區,1141,621,245,866,40,906,1498,60.48%,41.46%,1
臺南市,東區,1142,645,210,855,22,877,1622,54.07%,39.77%,1
臺南市,東區,1143,713,215,928,33,961,1738,55.29%,41.02%,1
臺南市,東區,1144,566,164,730,64,794,1501,52.9%,37.71%,1
臺南市,東區,1145,471,300,771,58,829,1482,55.94%,31.78%,1
臺南市,東區,1146,641,213,854,34,888,1829,48.55%,35.05%,1
臺南市,東區,1147,699,201,900,52,952,1764,53.97%,39.63%,1
臺南市,東區,1148,625,158,783,42,825,1427,57.81%,43.8%,1
臺南市,東區,1149,553,157,710,60,770,1427,53.96%,38.75%,1
臺南市,東區,1150,580,156,736,45,781,1388,56.27%,41.79%,1
臺南市,東區,1151,449,199,648,36,684,1131,60.48%,39.7%,1
臺南市,東區,1152,370,122,492,41,533,1000,53.3%,37%,1
臺南市,東區,1153,398,116,514,39,553,996,55.52%,39.96%,1
臺南市,東區,1154,339,117,456,42,498,935,53.26%,36.26%,1
臺南市,東區,1155,322,160,482,63,545,947,57.55%,34%,1
臺南市,東區,1156,390,172,562,20,582,1090,53.39%,35.78%,1
臺南市,東區,1157,323,102,425,51,476,896,53.13%,36.05%,1
臺南市,東區,1158,572,218,790,27,817,1589,51.42%,36%,1
臺南市,東區,1159,589,210,799,43,842,1497,56.25%,39.35%,1
臺南市,東區,1160,489,193,682,53,735,1386,53.03%,35.28%,1
臺南市,東區,1161,430,121,551,24,575,1101,52.23%,39.06%,1
臺南市,東區,1162,521,184,705,66,771,1332,57.88%,39.11%,1
臺南市,東區,1163,505,116,621,50,671,1185,56.62%,42.62%,1
臺南市,東區,1164,542,139,681,53,734,1262,58.16%,42.95%,1
臺南市,東區,1165,556,157,713,46,759,1517,50.03%,36.65%,1
臺南市,東區,1166,466,173,639,70,709,1287,55.09%,36.21%,1
臺南市,東區,1167,648,197,845,71,916,1657,55.28%,39.11%,1
臺南市,東區,1168,833,273,1106,104,1210,2238,54.07%,37.22%,1
臺南市,東區,1169,812,269,1081,69,1150,2246,51.2%,36.15%,1
臺南市,東區,1170,782,286,1068,58,1126,2191,51.39%,35.69%,1
臺南市,東區,1171,789,226,1015,59,1074,2063,52.06%,38.25%,1
臺南市,東區,1172,876,286,1162,84,1246,2177,57.23%,40.24%,1
臺南市,東區,1173,761,240,1001,73,1074,1863,57.65%,40.85%,1
臺南市,東區,1174,905,244,1149,40,1189,2185,54.42%,41.42%,1
臺南市,東區,1175,571,194,765,46,811,1721,47.12%,33.18%,1
臺南市,東區,1176,585,189,774,88,862,1556,55.4%,37.6%,1
臺南市,東區,1177,672,195,867,53,920,1602,57.43%,41.95%,1
臺南市,東區,1178,554,166,720,80,800,1523,52.53%,36.38%,1
臺南市,東區,1179,476,168,644,52,696,1382,50.36%,34.44%,1
臺南市,東區,1180,545,205,750,36,786,1486,52.89%,36.68%,1
臺南市,東區,1181,559,239,798,71,869,1560,55.71%,35.83%,1
臺南市,東區,1182,568,198,766,72,838,1684,49.76%,33.73%,1
臺南市,東區,1183,645,225,870,40,910,1653,55.05%,39.02%,1
臺南市,東區,1184,592,221,813,26,839,1554,53.99%,38.1%,1
臺南市,東區,1185,569,189,758,26,784,1408,55.68%,40.41%,1
臺南市,東區,1186,869,276,1145,39,1184,2084,56.81%,41.7%,1
臺南市,東區,1187,734,237,971,65,1036,1896,54.64%,38.71%,1
臺南市,南區,1015,460,162,622,48,670,1221,54.87%,37.67%,1
臺南市,南區,1016,708,212,920,85,1005,2171,46.29%,32.61%,1
臺南市,南區,1017,485,142,627,38,665,1150,57.83%,42.17%,1
臺南市,南區,1018,457,125,582,28,610,1122,54.37%,40.73%,1
臺南市,南區,1019,485,144,629,53,682,1444,47.23%,33.59%,1
臺南市,南區,1020,589,208,797,66,863,1765,48.9%,33.37%,1
臺南市,南區,1021,510,163,673,58,731,1298,56.32%,39.29%,1
臺南市,南區,1022,609,157,766,38,804,1458,55.14%,41.77%,1
臺南市,南區,1023,740,146,886,34,920,1940,47.42%,38.14%,1
臺南市,南區,1024,592,222,814,56,870,1637,53.15%,36.16%,1
臺南市,南區,1025,282,84,366,19,385,871,44.2%,32.38%,1
臺南市,南區,1026,229,83,312,22,334,589,56.71%,38.88%,1
臺南市,南區,1027,342,135,477,46,523,801,65.29%,42.7%,1
臺南市,南區,1028,397,123,520,48,568,990,57.37%,40.1%,1
臺南市,南區,1029,525,156,681,56,737,1222,60.31%,42.96%,1
臺南市,南區,1030,383,132,515,84,599,997,60.08%,38.42%,1
臺南市,南區,1031,410,144,554,35,589,1204,48.92%,34.05%,1
臺南市,南區,1032,482,189,671,30,701,1570,44.65%,30.7%,1
臺南市,南區,1033,449,167,616,54,670,1222,54.83%,36.74%,1
臺南市,南區,1034,362,102,464,28,492,1076,45.72%,33.64%,1
臺南市,南區,1035,351,182,533,31,564,1127,50.04%,31.14%,1
臺南市,南區,1036,412,147,559,60,619,1135,54.54%,36.3%,1
臺南市,南區,1037,432,175,607,63,670,1263,53.05%,34.2%,1
臺南市,南區,1038,364,97,461,33,494,1014,48.72%,35.9%,1
臺南市,南區,1039,557,205,762,70,832,1491,55.8%,37.36%,1
臺南市,南區,1040,658,203,861,52,913,1815,50.3%,36.25%,1
臺南市,南區,1041,466,181,647,23,670,1398,47.93%,33.33%,1
臺南市,南區,1042,645,192,837,52,889,2107,42.19%,30.61%,1
臺南市,南區,1043,670,210,880,55,935,1587,58.92%,42.22%,1
臺南市,南區,1044,550,236,786,78,864,1626,53.14%,33.83%,1
臺南市,南區,1045,564,209,773,43,816,1761,46.34%,32.03%,1
臺南市,南區,1046,583,205,788,78,866,1630,53.13%,35.77%,1
臺南市,南區,1047,567,200,767,59,826,1542,53.57%,36.77%,1
臺南市,南區,1048,510,168,678,91,769,1464,52.53%,34.84%,1
臺南市,南區,1049,586,217,803,101,904,1727,52.35%,33.93%,1
臺南市,南區,1050,419,166,585,59,644,1085,59.35%,38.62%,1
臺南市,南區,1051,327,108,435,18,453,939,48.24%,34.82%,1
臺南市,南區,1052,422,165,587,87,674,1419,47.5%,29.74%,1
臺南市,南區,1053,467,137,604,63,667,1333,50.04%,35.03%,1
臺南市,南區,1054,471,188,659,67,726,1465,49.56%,32.15%,1
臺南市,南區,1055,397,125,522,27,549,1099,49.95%,36.12%,1
臺南市,南區,1056,381,126,507,28,535,1133,47.22%,33.63%,1
臺南市,南區,1057,438,167,605,105,710,1375,51.64%,31.85%,1
臺南市,南區,1058,565,174,739,43,782,1781,43.91%,31.72%,1
臺南市,南區,1059,642,171,813,62,875,1542,56.74%,41.63%,1
臺南市,南區,1060,484,182,666,38,704,1486,47.38%,32.57%,1
臺南市,南區,1061,601,204,805,100,905,1640,55.18%,36.65%,1
臺南市,南區,1062,513,203,716,49,765,1701,44.97%,30.16%,1
臺南市,南區,1063,474,167,641,108,749,1541,48.6%,30.76%,1
臺南市,南區,1064,705,196,901,117,1018,2027,50.22%,34.78%,1
臺南市,南區,1065,703,239,942,85,1027,1774,57.89%,39.63%,1
臺南市,南區,1066,553,210,763,67,830,1613,51.46%,34.28%,1
臺南市,南區,1067,586,185,771,27,798,1707,46.75%,34.33%,1
臺南市,南區,1068,368,138,506,23,529,1657,31.93%,22.21%,1
臺南市,南區,1069,412,126,538,38,576,1077,53.48%,38.25%,1
臺南市,南區,1070,448,136,584,42,626,1185,52.83%,37.81%,1
臺南市,南區,1071,418,176,594,61,655,1249,52.44%,33.47%,1
臺南市,南區,1072,610,193,803,37,840,1985,42.32%,30.73%,1
臺南市,南區,1073,576,252,828,78,906,2017,44.92%,28.56%,1
臺南市,南區,1074,549,212,761,83,844,1717,49.16%,31.97%,1
臺南市,南區,1075,338,126,464,42,506,929,54.47%,36.38%,1
臺南市,南區,1076,265,105,370,24,394,695,56.69%,38.13%,1
臺南市,南區,1077,297,92,389,31,420,997,42.13%,29.79%,1
臺南市,南區,1078,248,60,308,23,331,784,42.22%,31.63%,1
臺南市,南區,1079,432,136,568,80,648,1119,57.91%,38.61%,1
臺南市,南區,1080,290,107,397,33,430,1054,40.8%,27.51%,1
臺南市,南區,1081,380,164,544,95,639,1245,51.33%,30.52%,1
臺南市,南區,1082,572,254,826,92,918,2064,44.48%,27.71%,1
臺南市,南區,1083,569,175,744,27,771,2056,37.5%,27.68%,1
臺南市,南區,1084,413,135,548,27,575,1373,41.88%,30.08%,1
臺南市,南區,1085,261,106,367,39,406,1002,40.52%,26.05%,1
臺南市,南區,1086,260,106,366,72,438,760,57.63%,34.21%,1
臺南市,南區,1087,338,140,478,82,560,1031,54.32%,32.78%,1
臺南市,南區,1088,256,101,357,52,409,744,54.97%,34.41%,1
臺南市,南區,1089,430,144,574,66,640,1186,53.96%,36.26%,1
臺南市,南區,1090,481,178,659,83,742,1358,54.64%,35.42%,1
臺南市,南區,1091,257,107,364,29,393,897,43.81%,28.65%,1
臺南市,南區,1092,446,143,589,68,657,1265,51.94%,35.26%,1
臺南市,南區,1093,326,123,449,41,490,1093,44.83%,29.83%,1
臺南市,南區,1094,404,94,498,34,532,1016,52.36%,39.76%,1
臺南市,北區,0850,643,186,829,79,908,1793,50.64%,35.86%,1
臺南市,北區,0851,558,171,729,53,782,1708,45.78%,32.67%,1
臺南市,北區,0852,379,109,488,21,509,997,51.05%,38.01%,1
臺南市,北區,0853,465,143,608,42,650,1452,44.77%,32.02%,1
臺南市,北區,0854,481,159,640,21,661,1351,48.93%,35.6%,1
臺南市,北區,0855,570,194,764,60,824,1323,62.28%,43.08%,1
臺南市,北區,0856,409,138,547,35,582,1073,54.24%,38.12%,1
臺南市,北區,0857,455,126,581,31,612,1138,53.78%,39.98%,1
臺南市,北區,0858,434,135,569,46,615,1189,51.72%,36.5%,1
臺南市,北區,0859,543,153,696,43,739,1262,58.56%,43.03%,1
臺南市,北區,0860,443,122,565,30,595,1017,58.51%,43.56%,1
臺南市,北區,0861,307,94,401,24,425,847,50.18%,36.25%,1
臺南市,北區,0862,482,102,584,39,623,1076,57.9%,44.8%,1
臺南市,北區,0863,401,133,534,32,566,954,59.33%,42.03%,1
臺南市,北區,0864,493,128,621,65,686,1300,52.77%,37.92%,1
臺南市,北區,0865,543,136,679,51,730,1390,52.52%,39.06%,1
臺南市,北區,0866,541,154,695,45,740,1318,56.15%,41.05%,1
臺南市,北區,0867,369,107,476,16,492,974,50.51%,37.89%,1
臺南市,北區,0868,389,112,501,14,515,990,52.02%,39.29%,1
臺南市,北區,0869,411,165,576,27,603,1016,59.35%,40.45%,1
臺南市,北區,0870,411,144,555,32,587,1053,55.75%,39.03%,1
臺南市,北區,0871,484,195,679,82,761,1466,51.91%,33.02%,1
臺南市,北區,0872,594,187,781,68,849,1535,55.31%,38.7%,1
臺南市,北區,0873,541,195,736,68,804,1544,52.07%,35.04%,1
臺南市,北區,0874,697,205,902,72,974,1760,55.34%,39.6%,1
臺南市,北區,0875,413,162,575,42,617,1372,44.97%,30.1%,1
臺南市,北區,0876,426,127,553,33,586,1002,58.48%,42.51%,1
臺南市,北區,0877,486,150,636,42,678,1171,57.9%,41.5%,1
臺南市,北區,0878,471,115,586,24,610,1285,47.47%,36.65%,1
臺南市,北區,0879,410,90,500,38,538,1036,51.93%,39.58%,1
臺南市,北區,0880,568,133,701,45,746,1392,53.59%,40.8%,1
臺南市,北區,0881,441,138,579,55,634,1147,55.27%,38.45%,1
臺南市,北區,0882,477,143,620,38,658,1526,43.12%,31.26%,1
臺南市,北區,0883,544,192,736,39,775,1559,49.71%,34.89%,1
臺南市,北區,0884,329,122,451,61,512,892,57.4%,36.88%,1
臺南市,北區,0885,329,102,431,45,476,937,50.8%,35.11%,1
臺南市,北區,0886,538,200,738,91,829,1449,57.21%,37.13%,1
臺南市,北區,0887,392,151,543,28,571,1160,49.22%,33.79%,1
臺南市,北區,0888,385,142,527,66,593,1567,37.84%,24.57%,1
臺南市,北區,0889,451,200,651,57,708,1346,52.6%,33.51%,1
臺南市,北區,0890,492,153,645,16,661,1451,45.55%,33.91%,1
臺南市,北區,0891,521,176,697,38,735,1522,48.29%,34.23%,1
臺南市,北區,0892,479,129,608,25,633,1278,49.53%,37.48%,1
臺南市,北區,0893,397,136,533,62,595,1164,51.12%,34.11%,1
臺南市,北區,0894,353,128,481,25,506,1091,46.38%,32.36%,1
臺南市,北區,0895,334,122,456,33,489,993,49.24%,33.64%,1
臺南市,北區,0896,337,113,450,35,485,1119,43.34%,30.12%,1
臺南市,北區,0897,636,204,840,83,923,1685,54.78%,37.74%,1
臺南市,北區,0898,513,162,675,23,698,1368,51.02%,37.5%,1
臺南市,北區,0899,516,165,681,60,741,1389,53.35%,37.15%,1
臺南市,北區,0900,603,184,787,29,816,1469,55.55%,41.05%,1
臺南市,北區,0901,703,187,890,58,948,1655,57.28%,42.48%,1
臺南市,北區,0902,520,164,684,29,713,1261,56.54%,41.24%,1
臺南市,北區,0903,583,135,718,26,744,1490,49.93%,39.13%,1
臺南市,北區,0904,605,178,783,43,826,1436,57.52%,42.13%,1
臺南市,北區,0905,553,165,718,68,786,1340,58.66%,41.27%,1
臺南市,北區,0906,547,201,748,44,792,1464,54.1%,37.36%,1
臺南市,北區,0907,645,192,837,21,858,1513,56.71%,42.63%,1
臺南市,北區,0908,684,211,895,30,925,1709,54.13%,40.02%,1
臺南市,北區,0909,645,220,865,43,908,1517,59.85%,42.52%,1
臺南市,北區,0910,579,208,787,34,821,1598,51.38%,36.23%,1
臺南市,北區,0911,505,185,690,48,738,1399,52.75%,36.1%,1
臺南市,北區,0912,431,152,583,51,634,1214,52.22%,35.5%,1
臺南市,北區,0913,427,142,569,26,595,1064,55.92%,40.13%,1
臺南市,北區,0914,491,158,649,52,701,1148,61.06%,42.77%,1
臺南市,北區,0915,547,178,725,34,759,1391,54.57%,39.32%,1
臺南市,北區,0916,636,182,818,46,864,1584,54.55%,40.15%,1
臺南市,北區,0917,645,200,845,43,888,1595,55.67%,40.44%,1
臺南市,北區,0918,537,166,703,29,732,1397,52.4%,38.44%,1
臺南市,北區,0919,658,167,825,59,884,1662,53.19%,39.59%,1
臺南市,北區,0920,598,180,778,31,809,1634,49.51%,36.6%,1
臺南市,北區,0921,722,204,926,89,1015,1793,56.61%,40.27%,1
臺南市,北區,0922,691,257,948,53,1001,1872,53.47%,36.91%,1
臺南市,北區,0923,662,231,893,114,1007,1874,53.74%,35.33%,1
臺南市,北區,0924,636,192,828,73,901,1760,51.19%,36.14%,1
臺南市,北區,0925,626,196,822,67,889,1753,50.71%,35.71%,1
臺南市,北區,0926,449,145,594,39,633,1502,42.14%,29.89%,1
臺南市,北區,0927,555,176,731,50,781,1470,53.13%,37.76%,1
臺南市,北區,0928,461,158,619,87,706,1319,53.53%,34.95%,1
臺南市,北區,0929,748,213,961,73,1034,1876,55.12%,39.87%,1
臺南市,北區,0930,634,205,839,40,879,1720,51.1%,36.86%,1
臺南市,安南區,0618,976,283,1259,42,1301,2549,51.04%,38.29%,1
臺南市,安南區,0619,773,283,1056,85,1141,2321,49.16%,33.3%,1
臺南市,安南區,0620,873,277,1150,78,1228,2156,56.96%,40.49%,1
臺南市,安南區,0621,660,232,892,78,970,1662,58.36%,39.71%,1
臺南市,安南區,0622,589,179,768,106,874,1512,57.8%,38.96%,1
臺南市,安南區,0623,553,194,747,74,821,1625,50.52%,34.03%,1
臺南市,安南區,0624,691,200,891,52,943,2143,44%,32.24%,1
臺南市,安南區,0625,1002,238,1240,86,1326,2457,53.97%,40.78%,1
臺南市,安南區,0626,810,277,1087,110,1197,2148,55.73%,37.71%,1
臺南市,安南區,0627,972,147,1119,105,1224,2364,51.78%,41.12%,1
臺南市,安南區,0628,608,181,789,73,862,1868,46.15%,32.55%,1
臺南市,安南區,0629,734,217,951,86,1037,1797,57.71%,40.85%,1
臺南市,安南區,0630,915,225,1140,73,1213,2268,53.48%,40.34%,1
臺南市,安南區,0631,686,241,927,85,1012,2291,44.17%,29.94%,1
臺南市,安南區,0632,826,232,1058,81,1139,2255,50.51%,36.63%,1
臺南市,安南區,0633,655,205,860,75,935,1940,48.2%,33.76%,1
臺南市,安南區,0634,770,234,1004,40,1044,2013,51.86%,38.25%,1
臺南市,安南區,0635,726,215,941,97,1038,2024,51.28%,35.87%,1
臺南市,安南區,0636,671,222,893,91,984,1613,61%,41.6%,1
臺南市,安南區,0637,416,129,545,43,588,1178,49.92%,35.31%,1
臺南市,安南區,0638,787,241,1028,92,1120,2143,52.26%,36.72%,1
臺南市,安南區,0639,632,243,875,89,964,1721,56.01%,36.72%,1
臺南市,安南區,0640,716,222,938,68,1006,1773,56.74%,40.38%,1
臺南市,安南區,0641,516,162,678,26,704,1428,49.3%,36.13%,1
臺南市,安南區,0642,644,185,829,61,890,1626,54.74%,39.61%,1
臺南市,安南區,0643,491,187,678,53,731,1358,53.83%,36.16%,1
臺南市,安南區,0644,623,162,785,57,842,1447,58.19%,43.05%,1
臺南市,安南區,0645,498,187,685,87,772,1358,56.85%,36.67%,1
臺南市,安南區,0646,716,236,952,51,1003,2116,47.4%,33.84%,1
臺南市,安南區,0647,756,265,1021,48,1069,2321,46.06%,32.57%,1
臺南市,安南區,0648,751,226,977,45,1022,2117,48.28%,35.47%,1
臺南市,安南區,0649,545,336,881,70,951,1927,49.35%,28.28%,1
臺南市,安南區,0650,755,235,990,105,1095,2242,48.84%,33.68%,1
臺南市,安南區,0651,806,232,1038,56,1094,2334,46.87%,34.53%,1
臺南市,安南區,0652,693,212,905,85,990,1822,54.34%,38.04%,1
臺南市,安南區,0653,668,230,898,111,1009,1813,55.65%,36.85%,1
臺南市,安南區,0654,795,242,1037,120,1157,2188,52.88%,36.33%,1
臺南市,安南區,0655,831,246,1077,94,1171,2399,48.81%,34.64%,1
臺南市,安南區,0656,709,241,950,80,1030,2247,45.84%,31.55%,1
臺南市,安南區,0657,470,165,635,86,721,1165,61.89%,40.34%,1
臺南市,安南區,0658,532,179,711,54,765,1539,49.71%,34.57%,1
臺南市,安南區,0659,648,248,896,114,1010,1835,55.04%,35.31%,1
臺南市,安南區,0660,639,234,873,95,968,1797,53.87%,35.56%,1
臺南市,安南區,0661,719,253,972,108,1080,2223,48.58%,32.34%,1
臺南市,安南區,0662,416,139,555,65,620,977,63.46%,42.58%,1
臺南市,安南區,0663,543,174,717,38,755,1642,45.98%,33.07%,1
臺南市,安南區,0664,675,194,869,68,937,1697,55.22%,39.78%,1
臺南市,安南區,0665,647,205,852,55,907,1966,46.13%,32.91%,1
臺南市,安南區,0666,467,156,623,74,697,1319,52.84%,35.41%,1
臺南市,安南區,0667,638,211,849,82,931,1909,48.77%,33.42%,1
臺南市,安南區,0668,653,220,873,71,944,1763,53.55%,37.04%,1
臺南市,安南區,0669,359,101,460,55,515,965,53.37%,37.2%,1
臺南市,安南區,0670,464,149,613,84,697,1547,45.05%,29.99%,1
臺南市,安南區,0671,604,219,823,76,899,1784,50.39%,33.86%,1
臺南市,安南區,0672,700,220,920,95,1015,2145,47.32%,32.63%,1
臺南市,安南區,0673,955,253,1208,84,1292,2443,52.89%,39.09%,1
臺南市,安南區,0674,806,255,1061,62,1123,2565,43.78%,31.42%,1
臺南市,安南區,0675,939,259,1198,88,1286,2480,51.85%,37.86%,1
臺南市,安南區,0676,704,241,945,109,1054,2349,44.87%,29.97%,1
臺南市,安南區,0677,775,280,1055,96,1151,2168,53.09%,35.75%,1
臺南市,安南區,0678,609,157,766,59,825,1630,50.61%,37.36%,1
臺南市,安南區,0679,510,161,671,55,726,1675,43.34%,30.45%,1
臺南市,安南區,0680,704,187,891,118,1009,1627,62.02%,43.27%,1
臺南市,安南區,0681,536,187,723,59,782,1493,52.38%,35.9%,1
臺南市,安南區,0682,511,194,705,79,784,1397,56.12%,36.58%,1
臺南市,安南區,0683,500,161,661,70,731,1416,51.62%,35.31%,1
臺南市,安南區,0684,553,160,713,29,742,1460,50.82%,37.88%,1
臺南市,安南區,0685,710,200,910,53,963,2222,43.34%,31.95%,1
臺南市,安南區,0686,766,226,992,104,1096,2070,52.95%,37%,1
臺南市,安南區,0687,673,213,886,63,949,1739,54.57%,38.7%,1
臺南市,安南區,0688,614,220,834,105,939,1830,51.31%,33.55%,1
臺南市,安南區,0689,727,245,972,82,1054,1803,58.46%,40.32%,1
臺南市,安南區,0690,692,246,938,77,1015,1800,56.39%,38.44%,1
臺南市,安南區,0691,575,203,778,73,851,1815,46.89%,31.68%,1
臺南市,安南區,0692,623,201,824,34,858,1846,46.48%,33.75%,1
臺南市,安南區,0693,354,146,500,52,552,905,60.99%,39.12%,1
臺南市,安南區,0694,432,142,574,80,654,1073,60.95%,40.26%,1
臺南市,安南區,0695,623,209,832,80,912,1579,57.76%,39.46%,1
臺南市,安南區,0696,624,225,849,115,964,1876,51.39%,33.26%,1
臺南市,安南區,0697,406,140,546,53,599,1194,50.17%,34%,1
臺南市,安南區,0698,390,123,513,30,543,1475,36.81%,26.44%,1
臺南市,安南區,0699,466,154,620,23,643,1380,46.59%,33.77%,1
臺南市,安南區,0700,448,168,616,30,646,1462,44.19%,30.64%,1
臺南市,安南區,0701,427,106,533,69,602,1044,57.66%,40.9%,1
臺南市,安南區,0702,239,94,333,62,395,603,65.51%,39.64%,1
臺南市,安南區,0703,275,92,367,31,398,690,57.68%,39.86%,1
臺南市,安南區,0704,510,152,662,53,715,1447,49.41%,35.25%,1
臺南市,安南區,0705,414,133,547,50,597,910,65.6%,45.49%,1
臺南市,安南區,0706,599,192,791,90,881,1850,47.62%,32.38%,1
臺南市,安南區,0707,628,178,806,66,872,1501,58.09%,41.84%,1
臺南市,安平區,0983,683,197,880,81,961,1753,54.82%,38.96%,1
臺南市,安平區,0984,696,194,890,58,948,1859,51%,37.44%,1
臺南市,安平區,0985,587,169,756,48,804,1382,58.18%,42.47%,1
臺南市,安平區,0986,887,290,1177,76,1253,2547,49.2%,34.83%,1
臺南市,安平區,0987,906,287,1193,56,1249,2407,51.89%,37.64%,1
臺南市,安平區,0988,677,209,886,49,935,2070,45.17%,32.71%,1
臺南市,安平區,0989,784,240,1024,40,1064,2132,49.91%,36.77%,1
臺南市,安平區,0990,568,160,728,25,753,1450,51.93%,39.17%,1
臺南市,安平區,0991,588,156,744,27,771,1605,48.04%,36.64%,1
臺南市,安平區,0992,614,242,856,84,940,1755,53.56%,34.99%,1
臺南市,安平區,0993,555,207,762,51,813,1728,47.05%,32.12%,1
臺南市,安平區,0994,509,186,695,23,718,1754,40.94%,29.02%,1
臺南市,安平區,0995,625,190,815,57,872,1686,51.72%,37.07%,1
臺南市,安平區,0996,722,223,945,50,995,1843,53.99%,39.18%,1
臺南市,安平區,0997,630,186,816,49,865,1565,55.27%,40.26%,1
臺南市,安平區,0998,511,139,650,23,673,1288,52.25%,39.67%,1
臺南市,安平區,0999,557,186,743,30,773,1653,46.76%,33.7%,1
臺南市,安平區,1000,612,165,777,25,802,1697,47.26%,36.06%,1
臺南市,安平區,1001,751,208,959,48,1007,2154,46.75%,34.87%,1
臺南市,安平區,1002,753,221,974,52,1026,2107,48.69%,35.74%,1
臺南市,安平區,1003,661,194,855,68,923,1675,55.1%,39.46%,1
臺南市,安平區,1004,682,268,950,64,1014,1979,51.24%,34.46%,1
臺南市,安平區,1005,565,194,759,33,792,1602,49.44%,35.27%,1
臺南市,安平區,1006,592,171,763,41,804,1586,50.69%,37.33%,1
臺南市,安平區,1007,126,44,170,9,179,438,40.87%,28.77%,1
臺南市,安平區,1008,611,209,820,76,896,1780,50.34%,34.33%,1
臺南市,安平區,1009,509,203,712,45,757,1623,46.64%,31.36%,1
臺南市,安平區,1010,710,240,950,101,1051,2157,48.73%,32.92%,1
臺南市,安平區,1011,401,147,548,56,604,1286,46.97%,31.18%,1
臺南市,安平區,1012,502,195,697,86,783,1492,52.48%,33.65%,1
臺南市,安平區,1013,405,126,531,39,570,1325,43.02%,30.57%,1
臺南市,安平區,1014,694,204,898,91,989,2001,49.43%,34.68%,1
臺南市,中西區,0931,470,209,679,55,734,1332,55.11%,35.29%,1
臺南市,中西區,0932,459,191,650,63,713,1246,57.22%,36.84%,1
臺南市,中西區,0933,435,174,609,59,668,1276,52.35%,34.09%,1
臺南市,中西區,0934,608,236,844,48,892,1583,56.35%,38.41%,1
臺南市,中西區,0935,569,216,785,49,834,1464,56.97%,38.87%,1
臺南市,中西區,0936,481,128,609,21,630,1234,51.05%,38.98%,1
臺南市,中西區,0937,558,183,741,44,785,1368,57.38%,40.79%,1
臺南市,中西區,0938,434,148,582,32,614,1322,46.44%,32.83%,1
臺南市,中西區,0939,428,158,586,54,640,1216,52.63%,35.2%,1
臺南市,中西區,0940,441,183,624,38,662,1289,51.36%,34.21%,1
臺南市,中西區,0941,477,168,645,47,692,1237,55.94%,38.56%,1
臺南市,中西區,0942,377,142,519,33,552,1189,46.43%,31.71%,1
臺南市,中西區,0943,447,172,619,56,675,1201,56.2%,37.22%,1
臺南市,中西區,0944,434,141,575,60,635,1065,59.62%,40.75%,1
臺南市,中西區,0945,424,125,549,48,597,1055,56.59%,40.19%,1
臺南市,中西區,0946,502,172,674,37,711,1170,60.77%,42.91%,1
臺南市,中西區,0947,567,151,718,40,758,1280,59.22%,44.3%,1
臺南市,中西區,0948,463,186,649,40,689,1223,56.34%,37.86%,1
臺南市,中西區,0949,518,164,682,68,750,1292,58.05%,40.09%,1
臺南市,中西區,0950,413,142,555,21,576,993,58.01%,41.59%,1
臺南市,中西區,0951,580,188,768,58,826,1541,53.6%,37.64%,1
臺南市,中西區,0952,694,233,927,59,986,1652,59.69%,42.01%,1
臺南市,中西區,0953,481,177,658,29,687,1212,56.68%,39.69%,1
臺南市,中西區,0954,607,243,850,70,920,1621,56.76%,37.45%,1
臺南市,中西區,0955,618,247,865,41,906,1660,54.58%,37.23%,1
臺南市,中西區,0956,592,215,807,60,867,1595,54.36%,37.12%,1
臺南市,中西區,0957,505,193,698,64,762,1436,53.06%,35.17%,1
臺南市,中西區,0958,482,193,675,48,723,1265,57.15%,38.1%,1
臺南市,中西區,0959,364,111,475,51,526,856,61.45%,42.52%,1
臺南市,中西區,0960,410,166,576,45,621,1168,53.17%,35.1%,1
臺南市,中西區,0961,448,162,610,50,660,1134,58.2%,39.51%,1
臺南市,中西區,0962,425,141,566,53,619,995,62.21%,42.71%,1
臺南市,中西區,0963,597,171,768,36,804,1313,61.23%,45.47%,1
臺南市,中西區,0964,508,191,699,49,748,1265,59.13%,40.16%,1
臺南市,中西區,0965,429,172,601,48,649,1215,53.42%,35.31%,1
臺南市,中西區,0966,476,147,623,57,680,1248,54.49%,38.14%,1
臺南市,中西區,0967,247,94,341,37,378,687,55.02%,35.95%,1
臺南市,中西區,0968,430,141,571,63,634,1139,55.66%,37.75%,1
臺南市,中西區,0969,390,131,521,46,567,971,58.39%,40.16%,1
臺南市,中西區,0970,355,131,486,58,544,1254,43.38%,28.31%,1
臺南市,中西區,0971,387,109,496,35,531,979,54.24%,39.53%,1
臺南市,中西區,0972,623,204,827,59,886,1745,50.77%,35.7%,1
臺南市,中西區,0973,358,170,528,51,579,1074,53.91%,33.33%,1
臺南市,中西區,0974,471,191,662,47,709,1436,49.37%,32.8%,1
臺南市,中西區,0975,306,138,444,46,490,865,56.65%,35.38%,1
臺南市,中西區,0976,418,171,589,48,637,1164,54.73%,35.91%,1
臺南市,中西區,0977,392,172,564,31,595,1285,46.3%,30.51%,1
臺南市,中西區,0978,383,160,543,48,591,1078,54.82%,35.53%,1
臺南市,中西區,0979,502,167,669,54,723,1704,42.43%,29.46%,1
臺南市,中西區,0980,496,170,666,88,754,1296,58.18%,38.27%,1
臺南市,中西區,0981,424,151,575,43,618,1128,54.79%,37.59%,1
臺南市,中西區,0982,471,175,646,31,677,1245,54.38%,37.83%,1
高雄市,鹽埕區,0845,541,204,745,62,807,1304,61.89%,41.49%,1
高雄市,鹽埕區,0846,132,61,193,23,216,357,60.5%,36.97%,1
高雄市,鹽埕區,0847,242,106,348,29,377,651,57.91%,37.17%,1
高雄市,鹽埕區,0848,464,151,615,30,645,1322,48.79%,35.1%,1
高雄市,鹽埕區,0849,516,38,554,27,581,1056,55.02%,48.86%,1
高雄市,鹽埕區,0850,359,143,502,21,523,904,57.85%,39.71%,1
高雄市,鹽埕區,0851,404,170,574,36,610,1130,53.98%,35.75%,1
高雄市,鹽埕區,0852,378,106,484,19,503,840,59.88%,45%,1
高雄市,鹽埕區,0853,290,113,403,32,435,616,70.62%,47.08%,1
高雄市,鹽埕區,0854,482,195,677,40,717,1397,51.32%,34.5%,1
高雄市,鹽埕區,0855,293,116,409,16,425,766,55.48%,38.25%,1
高雄市,鹽埕區,0856,355,115,470,42,512,839,61.03%,42.31%,1
高雄市,鹽埕區,0857,353,102,455,19,474,805,58.88%,43.85%,1
高雄市,鹽埕區,0858,276,96,372,21,393,750,52.4%,36.8%,1
高雄市,鹽埕區,0859,358,136,494,36,530,986,53.75%,36.31%,1
高雄市,鹽埕區,0860,359,134,493,11,504,1068,47.19%,33.61%,1
高雄市,鹽埕區,0861,410,172,582,52,634,1060,59.81%,38.68%,1
高雄市,鹽埕區,0862,308,97,405,36,441,805,54.78%,38.26%,1
高雄市,鹽埕區,0863,383,111,494,21,515,1073,48%,35.69%,1
高雄市,鹽埕區,0864,294,137,431,35,466,921,50.6%,31.92%,1
高雄市,鹽埕區,0865,448,158,606,22,628,1171,53.63%,38.26%,1
高雄市,鹽埕區,0866,217,102,319,20,339,594,57.07%,36.53%,1
高雄市,鹽埕區,0867,241,88,329,16,345,592,58.28%,40.71%,1
高雄市,鹽埕區,0868,206,92,298,10,308,610,50.49%,33.77%,1
高雄市,鼓山區,0768,359,108,467,23,490,959,51.09%,37.43%,1
高雄市,鼓山區,0769,470,139,609,50,659,1000,65.9%,47%,1
高雄市,鼓山區,0770,402,89,491,12,503,910,55.27%,44.18%,1
高雄市,鼓山區,0771,531,120,651,62,713,1085,65.71%,48.94%,1
高雄市,鼓山區,0772,512,147,659,54,713,1484,48.05%,34.5%,1
高雄市,鼓山區,0773,584,201,785,35,820,1393,58.87%,41.92%,1
高雄市,鼓山區,0774,627,143,770,61,831,1270,65.43%,49.37%,1
高雄市,鼓山區,0775,403,139,542,43,585,1055,55.45%,38.2%,1
高雄市,鼓山區,0776,462,163,625,30,655,1172,55.89%,39.42%,1
高雄市,鼓山區,0777,515,168,683,52,735,1175,62.55%,43.83%,1
高雄市,鼓山區,0778,515,178,693,52,745,1274,58.48%,40.42%,1
高雄市,鼓山區,0779,373,132,505,53,558,1085,51.43%,34.38%,1
高雄市,鼓山區,0780,590,176,766,68,834,1470,56.73%,40.14%,1
高雄市,鼓山區,0781,424,150,574,60,634,974,65.09%,43.53%,1
高雄市,鼓山區,0782,536,171,707,88,795,1275,62.35%,42.04%,1
高雄市,鼓山區,0783,437,174,611,73,684,1206,56.72%,36.24%,1
高雄市,鼓山區,0784,499,164,663,32,695,1238,56.14%,40.31%,1
高雄市,鼓山區,0785,415,55,470,23,493,721,68.38%,57.56%,1
高雄市,鼓山區,0786,478,133,611,34,645,1220,52.87%,39.18%,1
高雄市,鼓山區,0787,650,206,856,56,912,1966,46.39%,33.06%,1
高雄市,鼓山區,0788,611,205,816,92,908,1722,52.73%,35.48%,1
高雄市,鼓山區,0789,638,202,840,29,869,1720,50.52%,37.09%,1
高雄市,鼓山區,0790,538,154,692,109,801,1287,62.24%,41.8%,1
高雄市,鼓山區,0791,434,141,575,47,622,1369,45.43%,31.7%,1
高雄市,鼓山區,0792,534,152,686,55,741,1222,60.64%,43.7%,1
高雄市,鼓山區,0793,687,208,895,54,949,1770,53.62%,38.81%,1
高雄市,鼓山區,0794,799,230,1029,40,1069,1860,57.47%,42.96%,1
高雄市,鼓山區,0795,729,246,975,60,1035,1857,55.74%,39.26%,1
高雄市,鼓山區,0796,772,255,1027,52,1079,1841,58.61%,41.93%,1
高雄市,鼓山區,0797,812,248,1060,65,1125,1830,61.48%,44.37%,1
高雄市,鼓山區,0798,779,227,1006,66,1072,1809,59.26%,43.06%,1
高雄市,鼓山區,0799,863,229,1092,43,1135,1894,59.93%,45.56%,1
高雄市,鼓山區,0800,845,273,1118,30,1148,1882,61%,44.9%,1
高雄市,鼓山區,0801,860,296,1156,53,1209,1894,63.83%,45.41%,1
高雄市,鼓山區,0802,793,164,957,42,999,1745,57.25%,45.44%,1
高雄市,鼓山區,0803,792,228,1020,21,1041,1887,55.17%,41.97%,1
高雄市,鼓山區,0804,900,270,1170,59,1229,1891,64.99%,47.59%,1
高雄市,鼓山區,0805,901,212,1113,52,1165,1903,61.22%,47.35%,1
高雄市,鼓山區,0806,907,265,1172,37,1209,1998,60.51%,45.4%,1
高雄市,鼓山區,0807,894,225,1119,61,1180,1912,61.72%,46.76%,1
高雄市,鼓山區,0808,863,255,1118,68,1186,1923,61.67%,44.88%,1
高雄市,鼓山區,0809,865,264,1129,33,1162,1888,61.55%,45.82%,1
高雄市,鼓山區,0810,892,235,1127,24,1151,1873,61.45%,47.62%,1
高雄市,鼓山區,0811,974,283,1257,49,1306,1959,66.67%,49.72%,1
高雄市,鼓山區,0812,943,240,1183,52,1235,1897,65.1%,49.71%,1
高雄市,鼓山區,0813,1104,305,1409,53,1462,2362,61.9%,46.74%,1
高雄市,鼓山區,0814,854,214,1068,78,1146,1850,61.95%,46.16%,1
高雄市,鼓山區,0815,1091,50,1141,35,1176,1928,61%,56.59%,1
高雄市,鼓山區,0816,860,203,1063,33,1096,1937,56.58%,44.4%,1
高雄市,鼓山區,0817,933,269,1202,60,1262,2123,59.44%,43.95%,1
高雄市,鼓山區,0818,825,229,1054,38,1092,1861,58.68%,44.33%,1
高雄市,鼓山區,0819,850,206,1056,30,1086,1892,57.4%,44.93%,1
高雄市,鼓山區,0820,983,264,1247,54,1301,2147,60.6%,45.78%,1
高雄市,鼓山區,0821,860,243,1103,54,1157,1897,60.99%,45.33%,1
高雄市,鼓山區,0822,890,232,1122,40,1162,2041,56.93%,43.61%,1
高雄市,鼓山區,0823,570,150,720,55,775,1309,59.21%,43.54%,1
高雄市,鼓山區,0824,844,210,1054,56,1110,1867,59.45%,45.21%,1
高雄市,鼓山區,0825,589,143,732,49,781,1152,67.8%,51.13%,1
高雄市,鼓山區,0826,659,194,853,53,906,1404,64.53%,46.94%,1
高雄市,鼓山區,0827,341,82,423,29,452,1210,37.36%,28.18%,1
高雄市,鼓山區,0828,421,154,575,53,628,1135,55.33%,37.09%,1
高雄市,鼓山區,0829,437,137,574,89,663,1831,36.21%,23.87%,1
高雄市,鼓山區,0830,522,162,684,68,752,1288,58.39%,40.53%,1
高雄市,鼓山區,0831,473,134,607,44,651,1241,52.46%,38.11%,1
高雄市,鼓山區,0832,568,184,752,73,825,1342,61.48%,42.32%,1
高雄市,鼓山區,0833,570,185,755,114,869,1422,61.11%,40.08%,1
高雄市,鼓山區,0834,613,188,801,112,913,1453,62.84%,42.19%,1
高雄市,鼓山區,0835,256,96,352,46,398,616,64.61%,41.56%,1
高雄市,鼓山區,0836,300,123,423,75,498,834,59.71%,35.97%,1
高雄市,鼓山區,0837,352,144,496,73,569,969,58.72%,36.33%,1
高雄市,鼓山區,0838,346,139,485,84,569,978,58.18%,35.38%,1
高雄市,鼓山區,0839,286,134,420,65,485,760,63.82%,37.63%,1
高雄市,鼓山區,0840,500,167,667,76,743,1248,59.54%,40.06%,1
高雄市,鼓山區,0841,380,164,544,29,573,1143,50.13%,33.25%,1
高雄市,鼓山區,0842,433,161,594,79,673,1358,49.56%,31.89%,1
高雄市,鼓山區,0843,391,101,492,18,510,1036,49.23%,37.74%,1
高雄市,鼓山區,0844,199,82,281,17,298,580,51.38%,34.31%,1
高雄市,左營區,0534,629,182,811,65,876,2604,33.64%,24.16%,1
高雄市,左營區,0535,422,140,562,82,644,1037,62.1%,40.69%,1
高雄市,左營區,0536,227,79,306,47,353,542,65.13%,41.88%,1
高雄市,左營區,0537,239,91,330,56,386,635,60.79%,37.64%,1
高雄市,左營區,0538,160,64,224,20,244,518,47.1%,30.89%,1
高雄市,左營區,0539,274,105,379,66,445,813,54.74%,33.7%,1
高雄市,左營區,0540,298,144,442,91,533,889,59.96%,33.52%,1
高雄市,左營區,0541,268,121,389,82,471,731,64.43%,36.66%,1
高雄市,左營區,0542,165,586,751,56,807,1592,50.69%,10.36%,1
高雄市,左營區,0543,697,209,906,57,963,1709,56.35%,40.78%,1
高雄市,左營區,0544,709,150,859,66,925,1588,58.25%,44.65%,1
高雄市,左營區,0545,166,23,189,8,197,358,55.03%,46.37%,1
高雄市,左營區,0546,381,55,436,20,456,666,68.47%,57.21%,1
高雄市,左營區,0547,743,178,921,81,1002,1748,57.32%,42.51%,1
高雄市,左營區,0548,529,165,694,73,767,1196,64.13%,44.23%,1
高雄市,左營區,0549,558,158,716,68,784,1240,63.23%,45%,1
高雄市,左營區,0550,724,96,820,51,871,1402,62.13%,51.64%,1
高雄市,左營區,0551,644,83,727,22,749,1173,63.85%,54.9%,1
高雄市,左營區,0552,365,74,439,21,460,641,71.76%,56.94%,1
高雄市,左營區,0553,327,151,478,45,523,951,54.99%,34.38%,1
高雄市,左營區,0554,254,108,362,54,416,732,56.83%,34.7%,1
高雄市,左營區,0555,122,44,166,14,180,339,53.1%,35.99%,1
高雄市,左營區,0556,205,66,271,18,289,519,55.68%,39.5%,1
高雄市,左營區,0557,191,93,284,58,342,514,66.54%,37.16%,1
高雄市,左營區,0558,296,96,392,66,458,720,63.61%,41.11%,1
高雄市,左營區,0559,152,64,216,53,269,411,65.45%,36.98%,1
高雄市,左營區,0560,244,104,348,48,396,603,65.67%,40.46%,1
高雄市,左營區,0561,389,89,478,77,555,904,61.39%,43.03%,1
高雄市,左營區,0562,474,137,611,45,656,1318,49.77%,35.96%,1
高雄市,左營區,0563,338,125,463,29,492,966,50.93%,34.99%,1
高雄市,左營區,0564,655,148,803,38,841,1440,58.4%,45.49%,1
高雄市,左營區,0565,901,201,1102,49,1151,1990,57.84%,45.28%,1
高雄市,左營區,0566,547,86,633,42,675,1090,61.93%,50.18%,1
高雄市,左營區,0567,611,106,717,77,794,1272,62.42%,48.03%,1
高雄市,左營區,0568,750,196,946,32,978,1558,62.77%,48.14%,1
高雄市,左營區,0569,736,195,931,34,965,1501,64.29%,49.03%,1
高雄市,左營區,0570,202,37,239,9,248,360,68.89%,56.11%,1
高雄市,左營區,0571,668,79,747,39,786,1335,58.88%,50.04%,1
高雄市,左營區,0572,659,105,764,28,792,1359,58.28%,48.49%,1
高雄市,左營區,0573,698,170,868,65,933,1487,62.74%,46.94%,1
高雄市,左營區,0574,690,165,855,71,926,1637,56.57%,42.15%,1
高雄市,左營區,0575,738,176,914,43,957,1553,61.62%,47.52%,1
高雄市,左營區,0576,720,210,930,72,1002,1564,64.07%,46.04%,1
高雄市,左營區,0577,839,250,1089,60,1149,1788,64.26%,46.92%,1
高雄市,左營區,0578,905,245,1150,93,1243,2028,61.29%,44.63%,1
高雄市,左營區,0579,863,235,1098,101,1199,2037,58.86%,42.37%,1
高雄市,左營區,0580,1001,244,1245,52,1297,2101,61.73%,47.64%,1
高雄市,左營區,0581,966,211,1177,56,1233,2018,61.1%,47.87%,1
高雄市,左營區,0582,845,312,1157,85,1242,1925,64.52%,43.9%,1
高雄市,左營區,0583,838,247,1085,30,1115,1989,56.06%,42.13%,1
高雄市,左營區,0584,679,194,873,43,916,1780,51.46%,38.15%,1
高雄市,左營區,0585,779,240,1019,40,1059,1778,59.56%,43.81%,1
高雄市,左營區,0586,682,188,870,37,907,1496,60.63%,45.59%,1
高雄市,左營區,0587,697,216,913,46,959,1538,62.35%,45.32%,1
高雄市,左營區,0588,898,286,1184,72,1256,2058,61.03%,43.63%,1
高雄市,左營區,0589,864,265,1129,41,1170,1992,58.73%,43.37%,1
高雄市,左營區,0590,911,269,1180,81,1261,2058,61.27%,44.27%,1
高雄市,左營區,0591,901,323,1224,63,1287,2090,61.58%,43.11%,1
高雄市,左營區,0592,890,86,976,39,1015,2157,47.06%,41.26%,1
高雄市,左營區,0593,982,285,1267,45,1312,2096,62.6%,46.85%,1
高雄市,左營區,0594,924,304,1228,85,1313,2101,62.49%,43.98%,1
高雄市,左營區,0595,731,182,913,77,990,1649,60.04%,44.33%,1
高雄市,左營區,0596,596,210,806,89,895,1516,59.04%,39.31%,1
高雄市,左營區,0597,761,210,971,86,1057,1678,62.99%,45.35%,1
高雄市,左營區,0598,800,245,1045,90,1135,1898,59.8%,42.15%,1
高雄市,左營區,0599,782,226,1008,56,1064,1837,57.92%,42.57%,1
高雄市,左營區,0600,806,203,1009,42,1051,1922,54.68%,41.94%,1
高雄市,左營區,0601,792,260,1052,68,1120,1785,62.75%,44.37%,1
高雄市,左營區,0602,821,209,1030,32,1062,1886,56.31%,43.53%,1
高雄市,左營區,0603,891,224,1115,47,1162,1895,61.32%,47.02%,1
高雄市,左營區,0604,854,210,1064,41,1105,1831,60.35%,46.64%,1
高雄市,左營區,0605,886,224,1110,48,1158,2050,56.49%,43.22%,1
高雄市,左營區,0606,1130,300,1430,49,1479,2251,65.7%,50.2%,1
高雄市,左營區,0607,1012,272,1284,38,1322,2126,62.18%,47.6%,1
高雄市,左營區,0608,806,209,1015,36,1051,1928,54.51%,41.8%,1
高雄市,左營區,0609,883,293,1176,71,1247,2166,57.57%,40.77%,1
高雄市,左營區,0610,922,237,1159,55,1214,2031,59.77%,45.4%,1
高雄市,左營區,0611,917,248,1165,58,1223,1987,61.55%,46.15%,1
高雄市,左營區,0612,1020,262,1282,37,1319,2166,60.9%,47.09%,1
高雄市,左營區,0613,827,241,1068,71,1139,1856,61.37%,44.56%,1
高雄市,左營區,0614,1065,286,1351,49,1400,2289,61.16%,46.53%,1
高雄市,左營區,0615,895,219,1114,49,1163,1973,58.95%,45.36%,1
高雄市,左營區,0616,821,213,1034,93,1127,1818,61.99%,45.16%,1
高雄市,左營區,0617,678,191,869,27,896,1565,57.25%,43.32%,1
高雄市,左營區,0618,809,183,992,50,1042,1608,64.8%,50.31%,1
高雄市,左營區,0619,845,250,1095,70,1165,1812,64.29%,46.63%,1
高雄市,左營區,0620,766,201,967,24,991,1821,54.42%,42.06%,1
高雄市,左營區,0621,889,236,1125,68,1193,1907,62.56%,46.62%,1
高雄市,左營區,0622,836,252,1088,46,1134,1812,62.58%,46.14%,1
高雄市,左營區,0623,899,208,1107,46,1153,1833,62.9%,49.05%,1
高雄市,左營區,0624,825,252,1077,59,1136,1850,61.41%,44.59%,1
高雄市,左營區,0625,766,196,962,69,1031,1738,59.32%,44.07%,1
高雄市,左營區,0626,921,236,1157,54,1211,1864,64.97%,49.41%,1
高雄市,左營區,0627,913,228,1141,47,1188,1887,62.96%,48.38%,1
高雄市,左營區,0628,825,185,1010,28,1038,1870,55.51%,44.12%,1
高雄市,左營區,0629,867,193,1060,27,1087,1866,58.25%,46.46%,1
高雄市,左營區,0630,826,209,1035,22,1057,1862,56.77%,44.36%,1
高雄市,左營區,0631,840,221,1061,36,1097,1816,60.41%,46.26%,1
高雄市,左營區,0632,851,207,1058,52,1110,1833,60.56%,46.43%,1
高雄市,左營區,0633,761,229,990,64,1054,1676,62.89%,45.41%,1
高雄市,左營區,0634,878,200,1078,54,1132,1843,61.42%,47.64%,1
高雄市,左營區,0635,899,213,1112,40,1152,1872,61.54%,48.02%,1
高雄市,左營區,0636,1043,246,1289,52,1341,2259,59.36%,46.17%,1
高雄市,楠梓區,0435,633,140,773,46,819,1309,62.57%,48.36%,1
高雄市,楠梓區,0436,598,192,790,43,833,1408,59.16%,42.47%,1
高雄市,楠梓區,0437,815,213,1028,64,1092,1851,59%,44.03%,1
高雄市,楠梓區,0438,706,203,909,66,975,1578,61.79%,44.74%,1
高雄市,楠梓區,0439,758,178,936,39,975,1715,56.85%,44.2%,1
高雄市,楠梓區,0440,622,237,859,31,890,1611,55.25%,38.61%,1
高雄市,楠梓區,0441,852,202,1054,56,1110,2024,54.84%,42.09%,1
高雄市,楠梓區,0442,747,217,964,42,1006,1890,53.23%,39.52%,1
高雄市,楠梓區,0443,671,177,848,32,880,1762,49.94%,38.08%,1
高雄市,楠梓區,0444,771,201,972,59,1031,1888,54.61%,40.84%,1
高雄市,楠梓區,0445,750,208,958,79,1037,1822,56.92%,41.16%,1
高雄市,楠梓區,0446,745,234,979,64,1043,1846,56.5%,40.36%,1
高雄市,楠梓區,0447,576,139,715,77,792,1268,62.46%,45.43%,1
高雄市,楠梓區,0448,594,154,748,60,808,1240,65.16%,47.9%,1
高雄市,楠梓區,0449,634,209,843,35,878,1432,61.31%,44.27%,1
高雄市,楠梓區,0450,633,191,824,62,886,1490,59.46%,42.48%,1
高雄市,楠梓區,0451,672,189,861,52,913,1464,62.36%,45.9%,1
高雄市,楠梓區,0452,538,179,717,82,799,1435,55.68%,37.49%,1
高雄市,楠梓區,0453,627,190,817,79,896,1602,55.93%,39.14%,1
高雄市,楠梓區,0454,589,178,767,68,835,1500,55.67%,39.27%,1
高雄市,楠梓區,0455,626,200,826,106,932,1591,58.58%,39.35%,1
高雄市,楠梓區,0456,429,175,604,55,659,1669,39.48%,25.7%,1
高雄市,楠梓區,0457,543,287,830,64,894,1469,60.86%,36.96%,1
高雄市,楠梓區,0458,606,191,797,87,884,1559,56.7%,38.87%,1
高雄市,楠梓區,0459,619,217,836,88,924,1638,56.41%,37.79%,1
高雄市,楠梓區,0460,823,249,1072,89,1161,1960,59.23%,41.99%,1
高雄市,楠梓區,0461,752,264,1016,133,1149,1912,60.09%,39.33%,1
高雄市,楠梓區,0462,663,173,836,61,897,1559,57.54%,42.53%,1
高雄市,楠梓區,0463,613,144,757,47,804,1423,56.5%,43.08%,1
高雄市,楠梓區,0464,749,197,946,41,987,1696,58.2%,44.16%,1
高雄市,楠梓區,0465,509,210,719,163,882,1493,59.08%,34.09%,1
高雄市,楠梓區,0466,601,220,821,101,922,1527,60.38%,39.36%,1
高雄市,楠梓區,0467,399,163,562,81,643,1020,63.04%,39.12%,1
高雄市,楠梓區,0468,446,168,614,96,710,1197,59.31%,37.26%,1
高雄市,楠梓區,0469,485,193,678,90,768,1528,50.26%,31.74%,1
高雄市,楠梓區,0470,706,202,908,110,1018,1918,53.08%,36.81%,1
高雄市,楠梓區,0471,550,192,742,100,842,1458,57.75%,37.72%,1
高雄市,楠梓區,0472,767,231,998,108,1106,1790,61.79%,42.85%,1
高雄市,楠梓區,0473,815,232,1047,95,1142,1845,61.9%,44.17%,1
高雄市,楠梓區,0474,905,251,1156,73,1229,2037,60.33%,44.43%,1
高雄市,楠梓區,0475,842,206,1048,63,1111,1964,56.57%,42.87%,1
高雄市,楠梓區,0476,878,189,1067,45,1112,2006,55.43%,43.77%,1
高雄市,楠梓區,0477,818,224,1042,61,1103,1951,56.54%,41.93%,1
高雄市,楠梓區,0478,813,203,1016,70,1086,1951,55.66%,41.67%,1
高雄市,楠梓區,0479,913,186,1099,105,1204,2008,59.96%,45.47%,1
高雄市,楠梓區,0480,830,237,1067,93,1160,1923,60.32%,43.16%,1
高雄市,楠梓區,0481,878,211,1089,57,1146,1921,59.66%,45.71%,1
高雄市,楠梓區,0482,438,107,545,35,580,832,69.71%,52.64%,1
高雄市,楠梓區,0483,462,171,633,56,689,1156,59.6%,39.97%,1
高雄市,楠梓區,0484,467,161,628,69,697,1125,61.96%,41.51%,1
高雄市,楠梓區,0485,449,160,609,69,678,1060,63.96%,42.36%,1
高雄市,楠梓區,0486,679,167,846,70,916,1502,60.99%,45.21%,1
高雄市,楠梓區,0487,555,202,757,101,858,1404,61.11%,39.53%,1
高雄市,楠梓區,0488,574,166,740,83,823,1552,53.03%,36.98%,1
高雄市,楠梓區,0489,568,191,759,82,841,1460,57.6%,38.9%,1
高雄市,楠梓區,0490,532,118,650,67,717,1315,54.52%,40.46%,1
高雄市,楠梓區,0491,471,128,599,71,670,1062,63.09%,44.35%,1
高雄市,楠梓區,0492,484,113,597,64,661,1078,61.32%,44.9%,1
高雄市,楠梓區,0493,409,118,527,84,611,914,66.85%,44.75%,1
高雄市,楠梓區,0494,472,137,609,101,710,1064,66.73%,44.36%,1
高雄市,楠梓區,0495,728,230,958,83,1041,1705,61.06%,42.7%,1
高雄市,楠梓區,0496,776,195,971,76,1047,1728,60.59%,44.91%,1
高雄市,楠梓區,0497,898,189,1087,72,1159,1917,60.46%,46.84%,1
高雄市,楠梓區,0498,525,184,709,106,815,1439,56.64%,36.48%,1
高雄市,楠梓區,0499,579,157,736,77,813,1287,63.17%,44.99%,1
高雄市,楠梓區,0500,712,167,879,76,955,1504,63.5%,47.34%,1
高雄市,楠梓區,0501,673,174,847,69,916,1405,65.2%,47.9%,1
高雄市,楠梓區,0502,514,184,698,87,785,1287,60.99%,39.94%,1
高雄市,楠梓區,0503,584,163,747,63,810,1295,62.55%,45.1%,1
高雄市,楠梓區,0504,677,182,859,66,925,1483,62.37%,45.65%,1
高雄市,楠梓區,0505,807,214,1021,72,1093,1649,66.28%,48.94%,1
高雄市,楠梓區,0506,424,156,580,67,647,998,64.83%,42.48%,1
高雄市,楠梓區,0507,473,132,605,61,666,1025,64.98%,46.15%,1
高雄市,楠梓區,0508,809,246,1055,69,1124,1671,67.27%,48.41%,1
高雄市,楠梓區,0509,661,196,857,99,956,1453,65.79%,45.49%,1
高雄市,楠梓區,0510,691,202,893,107,1000,1673,59.77%,41.3%,1
高雄市,楠梓區,0511,732,161,893,61,954,1653,57.71%,44.28%,1
高雄市,楠梓區,0512,461,122,583,58,641,1034,61.99%,44.58%,1
高雄市,楠梓區,0513,565,151,716,61,777,1127,68.94%,50.13%,1
高雄市,楠梓區,0514,605,201,806,96,902,1575,57.27%,38.41%,1
高雄市,楠梓區,0515,691,193,884,65,949,1559,60.87%,44.32%,1
高雄市,楠梓區,0516,567,173,740,60,800,1378,58.06%,41.15%,1
高雄市,楠梓區,0517,734,233,967,82,1049,1714,61.2%,42.82%,1
高雄市,楠梓區,0518,749,215,964,84,1048,1721,60.89%,43.52%,1
高雄市,楠梓區,0519,704,197,901,74,975,1628,59.89%,43.24%,1
高雄市,楠梓區,0520,770,204,974,89,1063,1590,66.86%,48.43%,1
高雄市,楠梓區,0521,733,198,931,65,996,1628,61.18%,45.02%,1
高雄市,楠梓區,0522,839,244,1083,56,1139,1739,65.5%,48.25%,1
高雄市,楠梓區,0523,804,190,994,69,1063,1642,64.74%,48.96%,1
高雄市,楠梓區,0524,700,199,899,85,984,1766,55.72%,39.64%,1
高雄市,楠梓區,0525,601,181,782,79,861,1482,58.1%,40.55%,1
高雄市,楠梓區,0526,755,120,875,41,916,1749,52.37%,43.17%,1
高雄市,楠梓區,0527,745,170,915,49,964,1591,60.59%,46.83%,1
高雄市,楠梓區,0528,787,160,947,45,992,1545,64.21%,50.94%,1
高雄市,楠梓區,0529,839,190,1029,41,1070,1651,64.81%,50.82%,1
高雄市,楠梓區,0530,800,173,973,68,1041,1646,63.24%,48.6%,1
高雄市,楠梓區,0531,677,195,872,94,966,1496,64.57%,45.25%,1
高雄市,楠梓區,0532,519,186,705,103,808,1403,57.59%,36.99%,1
高雄市,楠梓區,0533,697,188,885,53,938,1624,57.76%,42.92%,1
高雄市,三民區,0887,720,265,985,92,1077,1893,56.89%,38.03%,1
高雄市,三民區,0888,796,158,954,107,1061,1982,53.53%,40.16%,1
高雄市,三民區,0889,695,195,890,81,971,1661,58.46%,41.84%,1
高雄市,三民區,0890,768,222,990,24,1014,1894,53.54%,40.55%,1
高雄市,三民區,0891,763,221,984,60,1044,1839,56.77%,41.49%,1
高雄市,三民區,0892,841,231,1072,79,1151,2014,57.15%,41.76%,1
高雄市,三民區,0893,791,200,991,128,1119,1897,58.99%,41.7%,1
高雄市,三民區,0894,729,245,974,61,1035,2016,51.34%,36.16%,1
高雄市,三民區,0895,734,241,975,61,1036,1924,53.85%,38.15%,1
高雄市,三民區,0896,747,200,947,85,1032,1749,59.01%,42.71%,1
高雄市,三民區,0897,1014,79,1093,68,1161,1845,62.93%,54.96%,1
高雄市,三民區,0898,663,196,859,40,899,1724,52.15%,38.46%,1
高雄市,三民區,0899,835,199,1034,43,1077,1889,57.01%,44.2%,1
高雄市,三民區,0900,638,227,865,84,949,1622,58.51%,39.33%,1
高雄市,三民區,0901,729,268,997,44,1041,1870,55.67%,38.98%,1
高雄市,三民區,0902,656,240,896,60,956,1523,62.77%,43.07%,1
高雄市,三民區,0903,714,243,957,64,1021,2006,50.9%,35.59%,1
高雄市,三民區,0904,959,273,1232,71,1303,2076,62.76%,46.19%,1
高雄市,三民區,0905,877,253,1130,38,1168,2073,56.34%,42.31%,1
高雄市,三民區,0906,908,213,1121,79,1200,2045,58.68%,44.4%,1
高雄市,三民區,0907,750,211,961,74,1035,2070,50%,36.23%,1
高雄市,三民區,0908,778,272,1050,72,1122,2035,55.14%,38.23%,1
高雄市,三民區,0909,933,283,1216,56,1272,2075,61.3%,44.96%,1
高雄市,三民區,0910,961,197,1158,43,1201,2053,58.5%,46.81%,1
高雄市,三民區,0911,970,219,1189,67,1256,2063,60.88%,47.02%,1
高雄市,三民區,0912,1018,272,1290,52,1342,2143,62.62%,47.5%,1
高雄市,三民區,0913,741,256,997,87,1084,1746,62.08%,42.44%,1
高雄市,三民區,0914,638,195,833,34,867,1735,49.97%,36.77%,1
高雄市,三民區,0915,696,149,845,69,914,1655,55.23%,42.05%,1
高雄市,三民區,0916,690,184,874,70,944,1583,59.63%,43.59%,1
高雄市,三民區,0917,762,204,966,55,1021,1800,56.72%,42.33%,1
高雄市,三民區,0918,779,193,972,43,1015,1730,58.67%,45.03%,1
高雄市,三民區,0919,730,200,930,28,958,1715,55.86%,42.57%,1
高雄市,三民區,0920,716,233,949,60,1009,1691,59.67%,42.34%,1
高雄市,三民區,0921,819,228,1047,57,1104,1865,59.2%,43.91%,1
高雄市,三民區,0922,510,146,656,38,694,1073,64.68%,47.53%,1
高雄市,三民區,0923,438,132,570,64,634,917,69.14%,47.76%,1
高雄市,三民區,0924,668,239,907,71,978,1647,59.38%,40.56%,1
高雄市,三民區,0925,693,232,925,78,1003,1654,60.64%,41.9%,1
高雄市,三民區,0926,727,211,938,49,987,1639,60.22%,44.36%,1
高雄市,三民區,0927,810,230,1040,69,1109,1833,60.5%,44.19%,1
高雄市,三民區,0928,654,186,840,39,879,1362,64.54%,48.02%,1
高雄市,三民區,0929,720,202,922,66,988,1557,63.46%,46.24%,1
高雄市,三民區,0930,704,168,872,27,899,1482,60.66%,47.5%,1
高雄市,三民區,0931,702,224,926,41,967,1563,61.87%,44.91%,1
高雄市,三民區,0932,650,211,861,34,895,1497,59.79%,43.42%,1
高雄市,三民區,0933,719,204,923,36,959,1523,62.97%,47.21%,1
高雄市,三民區,0934,628,180,808,55,863,1293,66.74%,48.57%,1
高雄市,三民區,0935,789,202,991,51,1042,1662,62.7%,47.47%,1
高雄市,三民區,0936,628,170,798,66,864,1441,59.96%,43.58%,1
高雄市,三民區,0937,650,191,841,51,892,1326,67.27%,49.02%,1
高雄市,三民區,0938,699,214,913,34,947,1476,64.16%,47.36%,1
高雄市,三民區,0939,762,212,974,26,1000,1968,50.81%,38.72%,1
高雄市,三民區,0940,593,209,802,27,829,1618,51.24%,36.65%,1
高雄市,三民區,0941,794,230,1024,58,1082,1873,57.77%,42.39%,1
高雄市,三民區,0942,605,212,817,75,892,1487,59.99%,40.69%,1
高雄市,三民區,0943,645,225,870,21,891,1640,54.33%,39.33%,1
高雄市,三民區,0944,719,245,964,32,996,1889,52.73%,38.06%,1
高雄市,三民區,0945,802,210,1012,39,1051,1969,53.38%,40.73%,1
高雄市,三民區,0946,481,220,701,192,893,1466,60.91%,32.81%,1
高雄市,三民區,0947,740,224,964,63,1027,1697,60.52%,43.61%,1
高雄市,三民區,0948,723,214,937,68,1005,1663,60.43%,43.48%,1
高雄市,三民區,0949,680,226,906,53,959,1649,58.16%,41.24%,1
高雄市,三民區,0950,613,170,783,47,830,1486,55.85%,41.25%,1
高雄市,三民區,0951,597,169,766,33,799,1495,53.44%,39.93%,1
高雄市,三民區,0952,745,183,928,35,963,1548,62.21%,48.13%,1
高雄市,三民區,0953,606,198,804,22,826,1493,55.32%,40.59%,1
高雄市,三民區,0954,674,183,857,33,890,1445,61.59%,46.64%,1
高雄市,三民區,0955,656,157,813,45,858,1529,56.12%,42.9%,1
高雄市,三民區,0956,623,176,799,32,831,1506,55.18%,41.37%,1
高雄市,三民區,0957,724,180,904,65,969,1549,62.56%,46.74%,1
高雄市,三民區,0958,755,214,969,63,1032,1620,63.7%,46.6%,1
高雄市,三民區,0959,710,211,921,61,982,1550,63.35%,45.81%,1
高雄市,三民區,0960,682,208,890,49,939,1488,63.1%,45.83%,1
高雄市,三民區,0961,583,172,755,59,814,1335,60.97%,43.67%,1
高雄市,三民區,0962,574,181,755,62,817,1332,61.34%,43.09%,1
高雄市,三民區,0963,757,240,997,86,1083,1764,61.39%,42.91%,1
高雄市,三民區,0964,759,228,987,52,1039,1811,57.37%,41.91%,1
高雄市,三民區,0965,746,253,999,75,1074,1693,63.44%,44.06%,1
高雄市,三民區,0966,762,246,1008,81,1089,1684,64.67%,45.25%,1
高雄市,三民區,0967,619,157,776,66,842,1464,57.51%,42.28%,1
高雄市,三民區,0968,825,247,1072,35,1107,1719,64.4%,47.99%,1
高雄市,三民區,0969,753,216,969,33,1002,1749,57.29%,43.05%,1
高雄市,三民區,0970,782,218,1000,38,1038,1908,54.4%,40.99%,1
高雄市,三民區,0971,715,194,909,68,977,1573,62.11%,45.45%,1
高雄市,三民區,0972,661,217,878,49,927,1628,56.94%,40.6%,1
高雄市,三民區,0973,491,156,647,60,707,1377,51.34%,35.66%,1
高雄市,三民區,0974,724,191,915,53,968,1530,63.27%,47.32%,1
高雄市,三民區,0975,475,135,610,64,674,1188,56.73%,39.98%,1
高雄市,三民區,0976,599,185,784,40,824,2791,29.52%,21.46%,1
高雄市,三民區,0977,779,223,1002,82,1084,1840,58.91%,42.34%,1
高雄市,三民區,0978,713,232,945,95,1040,1671,62.24%,42.67%,1
高雄市,三民區,0979,705,206,911,69,980,1624,60.34%,43.41%,1
高雄市,三民區,0980,763,234,997,60,1057,1555,67.97%,49.07%,1
高雄市,三民區,0981,717,212,929,54,983,1489,66.02%,48.15%,1
高雄市,三民區,0982,737,229,966,70,1036,1662,62.33%,44.34%,1
高雄市,三民區,0983,699,193,892,20,912,1639,55.64%,42.65%,1
高雄市,三民區,0984,780,215,995,93,1088,1872,58.12%,41.67%,1
高雄市,三民區,0985,799,259,1058,70,1128,1968,57.32%,40.6%,1
高雄市,三民區,0986,514,152,666,120,786,1471,53.43%,34.94%,1
高雄市,三民區,0987,621,192,813,77,890,1534,58.02%,40.48%,1
高雄市,三民區,0988,630,185,815,88,903,1659,54.43%,37.97%,1
高雄市,三民區,0989,665,186,851,46,897,1815,49.42%,36.64%,1
高雄市,三民區,0990,715,212,927,52,979,1808,54.15%,39.55%,1
高雄市,三民區,0991,453,149,602,39,641,1224,52.37%,37.01%,1
高雄市,三民區,0992,578,158,736,34,770,1406,54.77%,41.11%,1
高雄市,三民區,0993,382,120,502,29,531,945,56.19%,40.42%,1
高雄市,三民區,0994,400,149,549,51,600,944,63.56%,42.37%,1
高雄市,三民區,0995,671,219,890,79,969,1669,58.06%,40.2%,1
高雄市,三民區,0996,616,196,812,104,916,1473,62.19%,41.82%,1
高雄市,三民區,0997,682,211,893,64,957,1876,51.01%,36.35%,1
高雄市,三民區,0998,440,160,600,60,660,1682,39.24%,26.16%,1
高雄市,三民區,0999,662,254,916,52,968,1791,54.05%,36.96%,1
高雄市,三民區,1000,779,257,1036,57,1093,1808,60.45%,43.09%,1
高雄市,三民區,1001,689,242,931,56,987,1798,54.89%,38.32%,1
高雄市,三民區,1002,856,277,1133,66,1199,2030,59.06%,42.17%,1
高雄市,三民區,1003,890,225,1115,29,1144,2034,56.24%,43.76%,1
高雄市,三民區,1004,875,227,1102,39,1141,1998,57.11%,43.79%,1
高雄市,三民區,1005,715,227,942,41,983,1914,51.36%,37.36%,1
高雄市,三民區,1006,790,227,1017,41,1058,1965,53.84%,40.2%,1
高雄市,三民區,1007,722,276,998,97,1095,1885,58.09%,38.3%,1
高雄市,三民區,1008,540,164,704,14,718,1220,58.85%,44.26%,1
高雄市,三民區,1009,411,139,550,84,634,1057,59.98%,38.88%,1
高雄市,三民區,1010,457,159,616,29,645,1434,44.98%,31.87%,1
高雄市,三民區,1011,466,131,597,46,643,1350,47.63%,34.52%,1
高雄市,三民區,1012,282,88,370,32,402,872,46.1%,32.34%,1
高雄市,三民區,1013,333,129,462,30,492,954,51.57%,34.91%,1
高雄市,三民區,1014,775,196,971,27,998,1689,59.09%,45.89%,1
高雄市,三民區,1015,548,198,746,22,768,1390,55.25%,39.42%,1
高雄市,三民區,1016,561,183,744,83,827,1336,61.9%,41.99%,1
高雄市,三民區,1017,657,246,903,51,954,1437,66.39%,45.72%,1
高雄市,三民區,1018,623,193,816,28,844,1452,58.13%,42.91%,1
高雄市,三民區,1019,640,209,849,82,931,1513,61.53%,42.3%,1
高雄市,三民區,1020,641,226,867,89,956,1467,65.17%,43.69%,1
高雄市,三民區,1021,599,250,849,85,934,1381,67.63%,43.37%,1
高雄市,三民區,1022,434,172,606,50,656,1117,58.73%,38.85%,1
高雄市,三民區,1023,578,203,781,37,818,1327,61.64%,43.56%,1
高雄市,三民區,1024,542,187,729,48,777,1304,59.59%,41.56%,1
高雄市,三民區,1025,519,208,727,38,765,1483,51.58%,35%,1
高雄市,三民區,1026,638,214,852,52,904,1473,61.37%,43.31%,1
高雄市,三民區,1027,419,146,565,32,597,980,60.92%,42.76%,1
高雄市,三民區,1028,610,190,800,71,871,1409,61.82%,43.29%,1
高雄市,三民區,1029,494,204,698,53,751,1230,61.06%,40.16%,1
高雄市,三民區,1030,458,162,620,63,683,1024,66.7%,44.73%,1
高雄市,三民區,1031,482,171,653,60,713,1130,63.1%,42.65%,1
高雄市,三民區,1032,700,231,931,34,965,1889,51.09%,37.06%,1
高雄市,三民區,1033,595,191,786,33,819,1427,57.39%,41.7%,1
高雄市,三民區,1034,352,96,448,23,471,791,59.54%,44.5%,1
高雄市,三民區,1035,503,168,671,87,758,1079,70.25%,46.62%,1
高雄市,三民區,1036,594,212,806,87,893,1492,59.85%,39.81%,1
高雄市,三民區,1037,436,172,608,51,659,1020,64.61%,42.75%,1
高雄市,三民區,1038,395,163,558,16,574,1001,57.34%,39.46%,1
高雄市,三民區,1039,684,174,858,55,913,1581,57.75%,43.26%,1
高雄市,三民區,1040,572,209,781,50,831,1471,56.49%,38.89%,1
高雄市,三民區,1041,400,229,629,29,658,1151,57.17%,34.75%,1
高雄市,三民區,1042,566,201,767,73,840,1334,62.97%,42.43%,1
高雄市,三民區,1043,551,170,721,52,773,1275,60.63%,43.22%,1
高雄市,三民區,1044,513,206,719,45,764,1688,45.26%,30.39%,1
高雄市,三民區,1045,473,184,657,39,696,1214,57.33%,38.96%,1
高雄市,三民區,1046,529,165,694,32,726,1149,63.19%,46.04%,1
高雄市,三民區,1047,675,233,908,96,1004,1667,60.23%,40.49%,1
高雄市,三民區,1048,641,232,873,40,913,1786,51.12%,35.89%,1
高雄市,三民區,1049,383,138,521,18,539,896,60.16%,42.75%,1
高雄市,三民區,1050,410,106,516,64,580,925,62.7%,44.32%,1
高雄市,三民區,1051,303,109,412,52,464,684,67.84%,44.3%,1
高雄市,三民區,1052,426,161,587,69,656,981,66.87%,43.43%,1
高雄市,三民區,1053,487,180,667,88,755,1383,54.59%,35.21%,1
高雄市,三民區,1054,556,196,752,49,801,1382,57.96%,40.23%,1
高雄市,三民區,1055,321,104,425,27,452,808,55.94%,39.73%,1
高雄市,三民區,1056,542,190,732,23,755,1197,63.07%,45.28%,1
高雄市,三民區,1057,520,177,697,57,754,1344,56.1%,38.69%,1
高雄市,三民區,1058,550,209,759,55,814,1344,60.57%,40.92%,1
高雄市,三民區,1059,586,185,771,20,791,1359,58.2%,43.12%,1
高雄市,三民區,1060,467,161,628,53,681,1073,63.47%,43.52%,1
高雄市,三民區,1061,449,165,614,55,669,1186,56.41%,37.86%,1
高雄市,三民區,1062,705,220,925,87,1012,1749,57.86%,40.31%,1
高雄市,三民區,1063,336,86,422,24,446,877,50.86%,38.31%,1
高雄市,三民區,1064,599,201,800,112,912,1402,65.05%,42.72%,1
高雄市,三民區,1065,350,117,467,20,487,769,63.33%,45.51%,1
高雄市,三民區,1066,518,170,688,60,748,1207,61.97%,42.92%,1
高雄市,三民區,1067,438,163,601,50,651,1270,51.26%,34.49%,1
高雄市,三民區,1068,392,275,667,52,719,1248,57.61%,31.41%,1
高雄市,三民區,1069,534,162,696,88,784,1263,62.07%,42.28%,1
高雄市,三民區,1070,449,154,603,42,645,1101,58.58%,40.78%,1
高雄市,三民區,1071,475,159,634,21,655,1116,58.69%,42.56%,1
高雄市,三民區,1072,479,149,628,42,670,1152,58.16%,41.58%,1
高雄市,三民區,1073,442,144,586,75,661,1057,62.54%,41.82%,1
高雄市,三民區,1074,342,125,467,56,523,971,53.86%,35.22%,1
高雄市,三民區,1075,408,156,564,18,582,1062,54.8%,38.42%,1
高雄市,新興區,1098,333,125,458,32,490,828,59.18%,40.22%,1
高雄市,新興區,1099,419,160,579,57,636,963,66.04%,43.51%,1
高雄市,新興區,1100,422,132,554,27,581,1075,54.05%,39.26%,1
高雄市,新興區,1101,632,200,832,30,862,1488,57.93%,42.47%,1
高雄市,新興區,1102,631,181,812,30,842,1438,58.55%,43.88%,1
高雄市,新興區,1103,461,149,610,27,637,1049,60.72%,43.95%,1
高雄市,新興區,1104,579,258,837,85,922,1378,66.91%,42.02%,1
高雄市,新興區,1105,314,86,400,36,436,666,65.47%,47.15%,1
高雄市,新興區,1106,375,173,548,28,576,981,58.72%,38.23%,1
高雄市,新興區,1107,417,150,567,38,605,933,64.84%,44.69%,1
高雄市,新興區,1108,425,116,541,28,569,987,57.65%,43.06%,1
高雄市,新興區,1109,459,117,576,46,622,988,62.96%,46.46%,1
高雄市,新興區,1110,332,118,450,33,483,735,65.71%,45.17%,1
高雄市,新興區,1111,548,202,750,34,784,1317,59.53%,41.61%,1
高雄市,新興區,1112,288,111,399,10,409,800,51.13%,36%,1
高雄市,新興區,1113,417,145,562,37,599,968,61.88%,43.08%,1
高雄市,新興區,1114,405,123,528,29,557,913,61.01%,44.36%,1
高雄市,新興區,1115,583,231,814,26,840,1389,60.48%,41.97%,1
高雄市,新興區,1116,565,208,773,53,826,1228,67.26%,46.01%,1
高雄市,新興區,1117,532,157,689,75,764,1211,63.09%,43.93%,1
高雄市,新興區,1118,505,125,630,21,651,1101,59.13%,45.87%,1
高雄市,新興區,1119,361,96,457,12,469,752,62.37%,48.01%,1
高雄市,新興區,1120,421,154,575,41,616,873,70.56%,48.22%,1
高雄市,新興區,1121,686,253,939,38,977,1609,60.72%,42.64%,1
高雄市,新興區,1122,746,278,1024,64,1088,1736,62.67%,42.97%,1
高雄市,新興區,1123,528,154,682,27,709,1258,56.36%,41.97%,1
高雄市,新興區,1124,455,174,629,59,688,1105,62.26%,41.18%,1
高雄市,新興區,1125,317,169,486,47,533,851,62.63%,37.25%,1
高雄市,新興區,1126,432,162,594,42,636,1011,62.91%,42.73%,1
高雄市,新興區,1127,380,166,546,68,614,888,69.14%,42.79%,1
高雄市,新興區,1128,420,122,542,29,571,1005,56.82%,41.79%,1
高雄市,新興區,1129,442,143,585,14,599,1375,43.56%,32.15%,1
高雄市,新興區,1130,534,254,788,65,853,1388,61.46%,38.47%,1
高雄市,新興區,1131,274,105,379,50,429,719,59.67%,38.11%,1
高雄市,新興區,1132,404,169,573,76,649,1077,60.26%,37.51%,1
高雄市,新興區,1133,311,98,409,19,428,875,48.91%,35.54%,1
高雄市,新興區,1134,369,108,477,27,504,936,53.85%,39.42%,1
高雄市,新興區,1135,368,124,492,62,554,944,58.69%,38.98%,1
高雄市,新興區,1136,294,109,403,36,439,833,52.7%,35.29%,1
高雄市,新興區,1137,285,107,392,13,405,708,57.2%,40.25%,1
高雄市,新興區,1138,315,92,407,16,423,741,57.09%,42.51%,1
高雄市,新興區,1139,420,184,604,29,633,1235,51.26%,34.01%,1
高雄市,前金區,1076,251,86,337,19,356,673,52.9%,37.3%,1
高雄市,前金區,1077,460,125,585,33,618,1022,60.47%,45.01%,1
高雄市,前金區,1078,521,151,672,38,710,1324,53.63%,39.35%,1
高雄市,前金區,1079,335,117,452,55,507,839,60.43%,39.93%,1
高雄市,前金區,1080,359,148,507,77,584,975,59.9%,36.82%,1
高雄市,前金區,1081,770,223,993,70,1063,1806,58.86%,42.64%,1
高雄市,前金區,1082,731,250,981,41,1022,1781,57.38%,41.04%,1
高雄市,前金區,1083,291,119,410,41,451,717,62.9%,40.59%,1
高雄市,前金區,1084,451,152,603,14,617,1097,56.24%,41.11%,1
高雄市,前金區,1085,639,248,887,32,919,1633,56.28%,39.13%,1
高雄市,前金區,1086,361,116,477,36,513,759,67.59%,47.56%,1
高雄市,前金區,1087,395,173,568,54,622,948,65.61%,41.67%,1
高雄市,前金區,1088,339,155,494,67,561,1009,55.6%,33.6%,1
高雄市,前金區,1089,388,143,531,37,568,945,60.11%,41.06%,1
高雄市,前金區,1090,340,106,446,26,472,772,61.14%,44.04%,1
高雄市,前金區,1091,327,131,458,31,489,757,64.6%,43.2%,1
高雄市,前金區,1092,455,152,607,40,647,1047,61.8%,43.46%,1
高雄市,前金區,1093,424,161,585,41,626,985,63.55%,43.05%,1
高雄市,前金區,1094,649,221,870,30,900,1674,53.76%,38.77%,1
高雄市,前金區,1095,443,143,586,31,617,1088,56.71%,40.72%,1
高雄市,前金區,1096,412,136,548,52,600,893,67.19%,46.14%,1
高雄市,前金區,1097,458,161,619,39,658,1184,55.57%,38.68%,1
高雄市,苓雅區,1140,322,101,423,24,447,718,62.26%,44.85%,1
高雄市,苓雅區,1141,659,150,809,44,853,1492,57.17%,44.17%,1
高雄市,苓雅區,1142,513,162,675,54,729,1210,60.25%,42.4%,1
高雄市,苓雅區,1143,606,159,765,33,798,1617,49.35%,37.48%,1
高雄市,苓雅區,1144,613,174,787,93,880,1428,61.62%,42.93%,1
高雄市,苓雅區,1145,503,181,684,55,739,1444,51.18%,34.83%,1
高雄市,苓雅區,1146,580,202,782,80,862,1452,59.37%,39.94%,1
高雄市,苓雅區,1147,228,89,317,38,355,554,64.08%,41.16%,1
高雄市,苓雅區,1148,361,143,504,19,523,950,55.05%,38%,1
高雄市,苓雅區,1149,363,139,502,15,517,978,52.86%,37.12%,1
高雄市,苓雅區,1150,624,185,809,35,844,1673,50.45%,37.3%,1
高雄市,苓雅區,1151,738,252,990,72,1062,2045,51.93%,36.09%,1
高雄市,苓雅區,1152,391,120,511,79,590,939,62.83%,41.64%,1
高雄市,苓雅區,1153,499,155,654,38,692,1284,53.89%,38.86%,1
高雄市,苓雅區,1154,397,118,515,31,546,908,60.13%,43.72%,1
高雄市,苓雅區,1155,336,107,443,19,462,838,55.13%,40.1%,1
高雄市,苓雅區,1156,525,185,710,44,754,1267,59.51%,41.44%,1
高雄市,苓雅區,1157,420,164,584,64,648,994,65.19%,42.25%,1
高雄市,苓雅區,1158,264,117,381,27,408,774,52.71%,34.11%,1
高雄市,苓雅區,1159,480,150,630,28,658,1121,58.7%,42.82%,1
高雄市,苓雅區,1160,586,215,801,63,864,1474,58.62%,39.76%,1
高雄市,苓雅區,1161,654,212,866,71,937,1525,61.44%,42.89%,1
高雄市,苓雅區,1162,470,143,613,36,649,1147,56.58%,40.98%,1
高雄市,苓雅區,1163,444,164,608,42,650,1014,64.1%,43.79%,1
高雄市,苓雅區,1164,602,246,848,60,908,1496,60.7%,40.24%,1
高雄市,苓雅區,1165,651,228,879,62,941,1499,62.78%,43.43%,1
高雄市,苓雅區,1166,521,143,664,30,694,1138,60.98%,45.78%,1
高雄市,苓雅區,1167,392,139,531,47,578,839,68.89%,46.72%,1
高雄市,苓雅區,1168,506,155,661,52,713,2088,34.15%,24.23%,1
高雄市,苓雅區,1169,710,216,926,43,969,1648,58.8%,43.08%,1
高雄市,苓雅區,1170,683,195,878,73,951,1623,58.6%,42.08%,1
高雄市,苓雅區,1171,894,278,1172,62,1234,1932,63.87%,46.27%,1
高雄市,苓雅區,1172,576,162,738,28,766,1127,67.97%,51.11%,1
高雄市,苓雅區,1173,576,158,734,26,760,1156,65.74%,49.83%,1
高雄市,苓雅區,1174,648,218,866,39,905,1465,61.77%,44.23%,1
高雄市,苓雅區,1175,255,83,338,25,363,690,52.61%,36.96%,1
高雄市,苓雅區,1176,478,165,643,96,739,1283,57.6%,37.26%,1
高雄市,苓雅區,1177,582,201,783,78,861,1432,60.13%,40.64%,1
高雄市,苓雅區,1178,513,225,738,36,774,1313,58.95%,39.07%,1
高雄市,苓雅區,1179,598,213,811,34,845,1579,53.51%,37.87%,1
高雄市,苓雅區,1180,572,202,774,69,843,1385,60.87%,41.3%,1
高雄市,苓雅區,1181,660,179,839,62,901,1449,62.18%,45.55%,1
高雄市,苓雅區,1182,836,258,1094,53,1147,1834,62.54%,45.58%,1
高雄市,苓雅區,1183,612,215,827,65,892,1436,62.12%,42.62%,1
高雄市,苓雅區,1184,649,216,865,51,916,1431,64.01%,45.35%,1
高雄市,苓雅區,1185,582,187,769,22,791,1248,63.38%,46.63%,1
高雄市,苓雅區,1186,684,207,891,42,933,1470,63.47%,46.53%,1
高雄市,苓雅區,1187,748,192,940,79,1019,1540,66.17%,48.57%,1
高雄市,苓雅區,1188,645,185,830,28,858,1374,62.45%,46.94%,1
高雄市,苓雅區,1189,397,125,522,31,553,839,65.91%,47.32%,1
高雄市,苓雅區,1190,511,143,654,37,691,1022,67.61%,50%,1
高雄市,苓雅區,1191,506,138,644,25,669,1062,62.99%,47.65%,1
高雄市,苓雅區,1192,474,154,628,22,650,1078,60.3%,43.97%,1
高雄市,苓雅區,1193,497,179,676,33,709,1117,63.47%,44.49%,1
高雄市,苓雅區,1194,687,189,876,60,936,1516,61.74%,45.32%,1
高雄市,苓雅區,1195,542,237,779,122,901,1440,62.57%,37.64%,1
高雄市,苓雅區,1196,353,118,471,40,511,839,60.91%,42.07%,1
高雄市,苓雅區,1197,368,90,458,32,490,888,55.18%,41.44%,1
高雄市,苓雅區,1198,491,160,651,42,693,1101,62.94%,44.6%,1
高雄市,苓雅區,1199,489,160,649,63,712,1004,70.92%,48.71%,1
高雄市,苓雅區,1200,605,196,801,68,869,1427,60.9%,42.4%,1
高雄市,苓雅區,1201,508,149,657,32,689,1168,58.99%,43.49%,1
高雄市,苓雅區,1202,539,197,736,61,797,1184,67.31%,45.52%,1
高雄市,苓雅區,1203,440,144,584,35,619,974,63.55%,45.17%,1
高雄市,苓雅區,1204,325,101,426,14,440,849,51.83%,38.28%,1
高雄市,苓雅區,1205,833,211,1044,48,1092,1821,59.97%,45.74%,1
高雄市,苓雅區,1206,576,202,778,57,835,1306,63.94%,44.1%,1
高雄市,苓雅區,1207,523,74,597,29,626,1185,52.83%,44.14%,1
高雄市,苓雅區,1208,582,202,784,59,843,1415,59.58%,41.13%,1
高雄市,苓雅區,1209,450,136,586,46,632,962,65.7%,46.78%,1
高雄市,苓雅區,1210,400,134,534,58,592,964,61.41%,41.49%,1
高雄市,苓雅區,1211,673,186,859,47,906,1524,59.45%,44.16%,1
高雄市,苓雅區,1212,631,196,827,39,866,1455,59.52%,43.37%,1
高雄市,苓雅區,1213,463,163,626,42,668,1272,52.52%,36.4%,1
高雄市,苓雅區,1214,484,161,645,35,680,1256,54.14%,38.54%,1
高雄市,苓雅區,1215,504,138,642,34,676,1203,56.19%,41.9%,1
高雄市,苓雅區,1216,487,125,612,32,644,1062,60.64%,45.86%,1
高雄市,苓雅區,1217,379,123,502,66,568,850,66.82%,44.59%,1
高雄市,苓雅區,1218,442,148,590,92,682,1010,67.52%,43.76%,1
高雄市,苓雅區,1219,461,142,603,30,633,1118,56.62%,41.23%,1
高雄市,苓雅區,1220,411,135,546,57,603,937,64.35%,43.86%,1
高雄市,苓雅區,1221,542,162,704,36,740,1493,49.56%,36.3%,1
高雄市,苓雅區,1222,534,148,682,37,719,1183,60.78%,45.14%,1
高雄市,苓雅區,1223,489,129,618,45,663,1318,50.3%,37.1%,1
高雄市,苓雅區,1224,557,184,741,54,795,1362,58.37%,40.9%,1
高雄市,苓雅區,1225,418,177,595,76,671,1102,60.89%,37.93%,1
高雄市,苓雅區,1226,733,78,811,63,874,1481,59.01%,49.49%,1
高雄市,苓雅區,1227,394,119,513,66,579,878,65.95%,44.87%,1
高雄市,苓雅區,1228,318,109,427,42,469,908,51.65%,35.02%,1
高雄市,苓雅區,1229,507,132,639,53,692,1056,65.53%,48.01%,1
高雄市,苓雅區,1230,420,130,550,42,592,1091,54.26%,38.5%,1
高雄市,苓雅區,1231,419,163,582,32,614,976,62.91%,42.93%,1
高雄市,苓雅區,1232,470,183,653,50,703,1063,66.13%,44.21%,1
高雄市,苓雅區,1233,672,192,864,73,937,1484,63.14%,45.28%,1
高雄市,苓雅區,1234,515,227,742,37,779,1290,60.39%,39.92%,1
高雄市,苓雅區,1235,778,216,994,70,1064,1740,61.15%,44.71%,1
高雄市,苓雅區,1236,670,215,885,59,944,1594,59.22%,42.03%,1
高雄市,苓雅區,1237,686,206,892,31,923,1648,56.01%,41.63%,1
高雄市,苓雅區,1238,576,164,740,61,801,1236,64.81%,46.6%,1
高雄市,苓雅區,1239,511,178,689,54,743,1211,61.35%,42.2%,1
高雄市,苓雅區,1240,551,157,708,30,738,1283,57.52%,42.95%,1
高雄市,苓雅區,1241,795,247,1042,89,1131,1804,62.69%,44.07%,1
高雄市,苓雅區,1242,737,248,985,79,1064,1718,61.93%,42.9%,1
高雄市,苓雅區,1243,577,171,748,65,813,1297,62.68%,44.49%,1
高雄市,苓雅區,1244,596,208,804,87,891,1449,61.49%,41.13%,1
高雄市,苓雅區,1245,575,165,740,55,795,1307,60.83%,43.99%,1
高雄市,苓雅區,1246,528,166,694,58,752,1184,63.51%,44.59%,1
高雄市,苓雅區,1247,569,195,764,76,840,1250,67.2%,45.52%,1
高雄市,苓雅區,1248,526,149,675,36,711,1248,56.97%,42.15%,1
高雄市,苓雅區,1249,576,149,725,33,758,1283,59.08%,44.89%,1
高雄市,苓雅區,1250,507,123,630,34,664,1121,59.23%,45.23%,1
高雄市,苓雅區,1251,541,162,703,33,736,1258,58.51%,43%,1
高雄市,苓雅區,1252,561,170,731,39,770,1339,57.51%,41.9%,1
高雄市,苓雅區,1253,758,271,1029,80,1109,1986,55.84%,38.17%,1
高雄市,苓雅區,1254,447,118,565,34,599,1028,58.27%,43.48%,1
高雄市,苓雅區,1255,422,125,547,22,569,948,60.02%,44.51%,1
高雄市,前鎮區,1484,630,232,862,140,1002,1809,55.39%,34.83%,1
高雄市,前鎮區,1485,667,229,896,95,991,1835,54.01%,36.35%,1
高雄市,前鎮區,1486,580,175,755,81,836,1890,44.23%,30.69%,1
高雄市,前鎮區,1487,672,235,907,70,977,2013,48.53%,33.38%,1
高雄市,前鎮區,1488,671,199,870,75,945,1776,53.21%,37.78%,1
高雄市,前鎮區,1489,559,182,741,97,838,1705,49.15%,32.79%,1
高雄市,前鎮區,1490,272,81,353,69,422,672,62.8%,40.48%,1
高雄市,前鎮區,1491,553,192,745,104,849,1726,49.19%,32.04%,1
高雄市,前鎮區,1492,651,187,838,48,886,1597,55.48%,40.76%,1
高雄市,前鎮區,1493,662,250,912,91,1003,1690,59.35%,39.17%,1
高雄市,前鎮區,1494,475,142,617,78,695,1080,64.35%,43.98%,1
高雄市,前鎮區,1495,512,181,693,72,765,1159,66.01%,44.18%,1
高雄市,前鎮區,1496,478,158,636,77,713,1314,54.26%,36.38%,1
高雄市,前鎮區,1497,387,104,491,65,556,896,62.05%,43.19%,1
高雄市,前鎮區,1498,417,137,554,39,593,1002,59.18%,41.62%,1
高雄市,前鎮區,1499,714,242,956,110,1066,2765,38.55%,25.82%,1
高雄市,前鎮區,1500,230,82,312,65,377,600,62.83%,38.33%,1
高雄市,前鎮區,1501,344,131,475,42,517,1466,35.27%,23.47%,1
高雄市,前鎮區,1502,544,160,704,57,761,1449,52.52%,37.54%,1
高雄市,前鎮區,1503,374,116,490,58,548,991,55.3%,37.74%,1
高雄市,前鎮區,1504,514,151,665,91,756,1248,60.58%,41.19%,1
高雄市,前鎮區,1505,443,142,585,92,677,1066,63.51%,41.56%,1
高雄市,前鎮區,1506,215,73,288,43,331,706,46.88%,30.45%,1
高雄市,前鎮區,1507,241,93,334,39,373,713,52.31%,33.8%,1
高雄市,前鎮區,1508,468,161,629,50,679,1344,50.52%,34.82%,1
高雄市,前鎮區,1509,348,116,464,54,518,856,60.51%,40.65%,1
高雄市,前鎮區,1510,282,118,400,44,444,873,50.86%,32.3%,1
高雄市,前鎮區,1511,380,132,512,55,567,1114,50.9%,34.11%,1
高雄市,前鎮區,1512,356,132,488,19,507,1112,45.59%,32.01%,1
高雄市,前鎮區,1513,402,123,525,64,589,1044,56.42%,38.51%,1
高雄市,前鎮區,1514,340,120,460,54,514,940,54.68%,36.17%,1
高雄市,前鎮區,1515,485,147,632,73,705,1342,52.53%,36.14%,1
高雄市,前鎮區,1516,654,210,864,55,919,1402,65.55%,46.65%,1
高雄市,前鎮區,1517,604,173,777,39,816,1320,61.82%,45.76%,1
高雄市,前鎮區,1518,376,135,511,61,572,958,59.71%,39.25%,1
高雄市,前鎮區,1519,652,173,825,44,869,1276,68.1%,51.1%,1
高雄市,前鎮區,1520,665,160,825,85,910,1459,62.37%,45.58%,1
高雄市,前鎮區,1521,229,110,339,21,360,761,47.31%,30.09%,1
高雄市,前鎮區,1522,383,147,530,27,557,1093,50.96%,35.04%,1
高雄市,前鎮區,1523,782,133,915,46,961,1521,63.18%,51.41%,1
高雄市,前鎮區,1524,759,154,913,47,960,1557,61.66%,48.75%,1
高雄市,前鎮區,1525,711,167,878,35,913,1821,50.14%,39.04%,1
高雄市,前鎮區,1526,587,106,693,44,737,1066,69.14%,55.07%,1
高雄市,前鎮區,1527,572,89,661,20,681,1046,65.11%,54.68%,1
高雄市,前鎮區,1528,671,253,924,68,992,1709,58.05%,39.26%,1
高雄市,前鎮區,1529,743,231,974,90,1064,1723,61.75%,43.12%,1
高雄市,前鎮區,1530,567,167,734,54,788,1202,65.56%,47.17%,1
高雄市,前鎮區,1531,590,208,798,38,836,1279,65.36%,46.13%,1
高雄市,前鎮區,1532,729,196,925,48,973,1513,64.31%,48.18%,1
高雄市,前鎮區,1533,516,171,687,23,710,1260,56.35%,40.95%,1
高雄市,前鎮區,1534,488,173,661,88,749,1139,65.76%,42.84%,1
高雄市,前鎮區,1535,553,162,715,45,760,1140,66.67%,48.51%,1
高雄市,前鎮區,1536,561,255,816,92,908,1462,62.11%,38.37%,1
高雄市,前鎮區,1537,610,190,800,45,845,1359,62.18%,44.89%,1
高雄市,前鎮區,1538,703,268,971,91,1062,2037,52.14%,34.51%,1
高雄市,前鎮區,1539,586,157,743,27,770,1410,54.61%,41.56%,1
高雄市,前鎮區,1540,520,186,706,24,730,1307,55.85%,39.79%,1
高雄市,前鎮區,1541,580,214,794,92,886,1512,58.6%,38.36%,1
高雄市,前鎮區,1542,616,215,831,85,916,1491,61.44%,41.31%,1
高雄市,前鎮區,1543,656,204,860,90,950,1621,58.61%,40.47%,1
高雄市,前鎮區,1544,560,172,732,77,809,1522,53.15%,36.79%,1
高雄市,前鎮區,1545,658,231,889,60,949,1593,59.57%,41.31%,1
高雄市,前鎮區,1546,807,253,1060,89,1149,1885,60.95%,42.81%,1
高雄市,前鎮區,1547,818,250,1068,97,1165,1870,62.3%,43.74%,1
高雄市,前鎮區,1548,596,185,781,26,807,1388,58.14%,42.94%,1
高雄市,前鎮區,1549,563,180,743,69,812,1348,60.24%,41.77%,1
高雄市,前鎮區,1550,519,148,667,106,773,1341,57.64%,38.7%,1
高雄市,前鎮區,1551,634,179,813,54,867,1364,63.56%,46.48%,1
高雄市,前鎮區,1552,552,200,752,76,828,1367,60.57%,40.38%,1
高雄市,前鎮區,1553,516,176,692,82,774,1326,58.37%,38.91%,1
高雄市,前鎮區,1554,434,136,570,44,614,1059,57.98%,40.98%,1
高雄市,前鎮區,1555,520,129,649,20,669,1119,59.79%,46.47%,1
高雄市,前鎮區,1556,612,174,786,47,833,1565,53.23%,39.11%,1
高雄市,前鎮區,1557,637,198,835,68,903,1549,58.3%,41.12%,1
高雄市,前鎮區,1558,800,221,1021,41,1062,1691,62.8%,47.31%,1
高雄市,前鎮區,1559,831,232,1063,38,1101,1837,59.93%,45.24%,1
高雄市,前鎮區,1560,480,157,637,28,665,1092,60.9%,43.96%,1
高雄市,前鎮區,1561,478,167,645,63,708,1126,62.88%,42.45%,1
高雄市,前鎮區,1562,472,145,617,89,706,1215,58.11%,38.85%,1
高雄市,前鎮區,1563,660,158,818,37,855,1443,59.25%,45.74%,1
高雄市,前鎮區,1564,709,214,923,24,947,1448,65.4%,48.96%,1
高雄市,前鎮區,1565,709,220,929,85,1014,1648,61.53%,43.02%,1
高雄市,前鎮區,1566,593,215,808,85,893,1603,55.71%,36.99%,1
高雄市,前鎮區,1567,580,165,745,33,778,1596,48.75%,36.34%,1
高雄市,前鎮區,1568,521,152,673,37,710,1450,48.97%,35.93%,1
高雄市,前鎮區,1569,597,155,752,88,840,1510,55.63%,39.54%,1
高雄市,前鎮區,1570,711,224,935,100,1035,1647,62.84%,43.17%,1
高雄市,前鎮區,1571,557,148,705,69,774,1342,57.68%,41.51%,1
高雄市,前鎮區,1572,524,161,685,56,741,1384,53.54%,37.86%,1
高雄市,前鎮區,1573,563,178,741,75,816,1479,55.17%,38.07%,1
高雄市,前鎮區,1574,667,164,831,44,875,1546,56.6%,43.14%,1
高雄市,前鎮區,1575,635,256,891,64,955,1595,59.87%,39.81%,1
高雄市,前鎮區,1576,533,138,671,70,741,1201,61.7%,44.38%,1
高雄市,前鎮區,1577,412,135,547,26,573,1082,52.96%,38.08%,1
高雄市,前鎮區,1578,379,111,490,46,536,996,53.82%,38.05%,1
高雄市,前鎮區,1579,376,114,490,86,576,932,61.8%,40.34%,1
高雄市,前鎮區,1580,451,184,635,52,687,1146,59.95%,39.35%,1
高雄市,前鎮區,1581,497,123,620,37,657,1096,59.95%,45.35%,1
高雄市,前鎮區,1582,643,157,800,19,819,1332,61.49%,48.27%,1
高雄市,前鎮區,1583,503,129,632,41,673,1175,57.28%,42.81%,1
高雄市,前鎮區,1584,407,125,532,67,599,986,60.75%,41.28%,1
高雄市,前鎮區,1585,566,186,752,73,825,1316,62.69%,43.01%,1
高雄市,前鎮區,1586,574,163,737,71,808,1559,51.83%,36.82%,1
高雄市,前鎮區,1587,704,199,903,84,987,1622,60.85%,43.4%,1
高雄市,前鎮區,1588,509,175,684,37,721,1310,55.04%,38.85%,1
高雄市,前鎮區,1589,512,182,694,101,795,1299,61.2%,39.41%,1
高雄市,前鎮區,1590,567,156,723,70,793,1191,66.58%,47.61%,1
高雄市,前鎮區,1591,564,122,686,32,718,1375,52.22%,41.02%,1
高雄市,前鎮區,1592,565,170,735,25,760,1338,56.8%,42.23%,1
高雄市,前鎮區,1593,435,160,595,38,633,1175,53.87%,37.02%,1
高雄市,前鎮區,1594,546,158,704,35,739,1357,54.46%,40.24%,1
高雄市,前鎮區,1595,534,177,711,62,773,1187,65.12%,44.99%,1
高雄市,前鎮區,1596,460,153,613,50,663,1164,56.96%,39.52%,1
高雄市,前鎮區,1597,541,164,705,61,766,1219,62.84%,44.38%,1
高雄市,前鎮區,1598,552,187,739,25,764,1428,53.5%,38.66%,1
高雄市,前鎮區,1599,575,202,777,104,881,1495,58.93%,38.46%,1
高雄市,前鎮區,1600,643,200,843,37,880,1531,57.48%,42%,1
高雄市,前鎮區,1601,613,158,771,83,854,1509,56.59%,40.62%,1
高雄市,前鎮區,1602,623,198,821,77,898,1591,56.44%,39.16%,1
高雄市,旗津區,0869,437,187,624,122,746,1177,63.38%,37.13%,1
高雄市,旗津區,0870,367,133,500,58,558,1109,50.32%,33.09%,1
高雄市,旗津區,0871,485,191,676,31,707,1642,43.06%,29.54%,1
高雄市,旗津區,0872,429,119,548,111,659,1209,54.51%,35.48%,1
高雄市,旗津區,0873,362,103,465,57,522,1112,46.94%,32.55%,1
高雄市,旗津區,0874,553,200,753,94,847,1483,57.11%,37.29%,1
高雄市,旗津區,0875,465,125,590,34,624,1460,42.74%,31.85%,1
高雄市,旗津區,0876,588,237,825,172,997,1572,63.42%,37.4%,1
高雄市,旗津區,0877,490,96,586,32,618,1384,44.65%,35.4%,1
高雄市,旗津區,0878,436,155,591,44,635,1390,45.68%,31.37%,1
高雄市,旗津區,0879,398,133,531,67,598,1239,48.26%,32.12%,1
高雄市,旗津區,0880,617,284,901,139,1040,2045,50.86%,30.17%,1
高雄市,旗津區,0881,292,107,399,23,422,893,47.26%,32.7%,1
高雄市,旗津區,0882,594,238,832,136,968,1866,51.88%,31.83%,1
高雄市,旗津區,0883,516,170,686,45,731,1874,39.01%,27.53%,1
高雄市,旗津區,0884,277,113,390,68,458,893,51.29%,31.02%,1
高雄市,旗津區,0885,402,186,588,44,632,1215,52.02%,33.09%,1
高雄市,旗津區,0886,424,133,557,47,604,1297,46.57%,32.69%,1
高雄市,小港區,1603,508,141,649,45,694,1108,62.64%,45.85%,1
高雄市,小港區,1604,509,155,664,66,730,1171,62.34%,43.47%,1
高雄市,小港區,1605,701,236,937,23,960,1557,61.66%,45.02%,1
高雄市,小港區,1606,667,177,844,21,865,1668,51.86%,39.99%,1
高雄市,小港區,1607,553,136,689,30,719,1183,60.78%,46.75%,1
高雄市,小港區,1608,607,146,753,31,784,1372,57.14%,44.24%,1
高雄市,小港區,1609,765,206,971,72,1043,1737,60.05%,44.04%,1
高雄市,小港區,1610,616,216,832,104,936,1586,59.02%,38.84%,1
高雄市,小港區,1611,595,164,759,74,833,1558,53.47%,38.19%,1
高雄市,小港區,1612,563,212,775,76,851,1284,66.28%,43.85%,1
高雄市,小港區,1613,552,157,709,60,769,1249,61.57%,44.2%,1
高雄市,小港區,1614,800,215,1015,109,1124,2400,46.83%,33.33%,1
高雄市,小港區,1615,500,168,668,41,709,1181,60.03%,42.34%,1
高雄市,小港區,1616,448,121,569,36,605,1079,56.07%,41.52%,1
高雄市,小港區,1617,567,168,735,48,783,1335,58.65%,42.47%,1
高雄市,小港區,1618,568,133,701,65,766,1241,61.72%,45.77%,1
高雄市,小港區,1619,630,172,802,71,873,1513,57.7%,41.64%,1
高雄市,小港區,1620,594,170,764,71,835,1349,61.9%,44.03%,1
高雄市,小港區,1621,585,189,774,54,828,1483,55.83%,39.45%,1
高雄市,小港區,1622,634,167,801,31,832,1451,57.34%,43.69%,1
高雄市,小港區,1623,505,121,626,31,657,1241,52.94%,40.69%,1
高雄市,小港區,1624,581,193,774,71,845,1262,66.96%,46.04%,1
高雄市,小港區,1625,797,208,1005,93,1098,1813,60.56%,43.96%,1
高雄市,小港區,1626,706,165,871,43,914,1877,48.69%,37.61%,1
高雄市,小港區,1627,585,170,755,21,776,1391,55.79%,42.06%,1
高雄市,小港區,1628,630,198,828,31,859,1453,59.12%,43.36%,1
高雄市,小港區,1629,571,191,762,49,811,1374,59.02%,41.56%,1
高雄市,小港區,1630,561,167,728,61,789,1348,58.53%,41.62%,1
高雄市,小港區,1631,606,161,767,70,837,1334,62.74%,45.43%,1
高雄市,小港區,1632,569,194,763,32,795,1433,55.48%,39.71%,1
高雄市,小港區,1633,541,170,711,18,729,1448,50.35%,37.36%,1
高雄市,小港區,1634,684,203,887,64,951,1488,63.91%,45.97%,1
高雄市,小港區,1635,574,146,720,61,781,1278,61.11%,44.91%,1
高雄市,小港區,1636,668,180,848,46,894,1306,68.45%,51.15%,1
高雄市,小港區,1637,680,112,792,89,881,1625,54.22%,41.85%,1
高雄市,小港區,1638,724,233,957,88,1045,1640,63.72%,44.15%,1
高雄市,小港區,1639,651,168,819,53,872,1506,57.9%,43.23%,1
高雄市,小港區,1640,582,147,729,69,798,1438,55.49%,40.47%,1
高雄市,小港區,1641,554,145,699,40,739,1105,66.88%,50.14%,1
高雄市,小港區,1642,517,111,628,17,645,1167,55.27%,44.3%,1
高雄市,小港區,1643,662,157,819,33,852,1420,60%,46.62%,1
高雄市,小港區,1644,678,167,845,67,912,1380,66.09%,49.13%,1
高雄市,小港區,1645,545,127,672,32,704,1239,56.82%,43.99%,1
高雄市,小港區,1646,743,158,901,59,960,1563,61.42%,47.54%,1
高雄市,小港區,1647,773,183,956,22,978,1644,59.49%,47.02%,1
高雄市,小港區,1648,884,113,997,89,1086,1895,57.31%,46.65%,1
高雄市,小港區,1649,692,216,908,96,1004,1748,57.44%,39.59%,1
高雄市,小港區,1650,619,263,882,94,976,1579,61.81%,39.2%,1
高雄市,小港區,1651,871,231,1102,51,1153,2135,54%,40.8%,1
高雄市,小港區,1652,708,214,922,84,1006,1728,58.22%,40.97%,1
高雄市,小港區,1653,791,220,1011,46,1057,2022,52.27%,39.12%,1
高雄市,小港區,1654,465,115,580,30,610,1329,45.9%,34.99%,1
高雄市,小港區,1655,495,190,685,47,732,1320,55.45%,37.5%,1
高雄市,小港區,1656,551,138,689,86,775,1267,61.17%,43.49%,1
高雄市,小港區,1657,555,191,746,78,824,1298,63.48%,42.76%,1
高雄市,小港區,1658,568,177,745,36,781,1289,60.59%,44.07%,1
高雄市,小港區,1659,653,197,850,56,906,1534,59.06%,42.57%,1
高雄市,小港區,1660,637,190,827,52,879,1494,58.84%,42.64%,1
高雄市,小港區,1661,566,184,750,79,829,1377,60.2%,41.1%,1
高雄市,小港區,1662,639,148,787,84,871,1344,64.81%,47.54%,1
高雄市,小港區,1663,648,155,803,69,872,1508,57.82%,42.97%,1
高雄市,小港區,1664,572,187,759,36,795,1400,56.79%,40.86%,1
高雄市,小港區,1665,673,162,835,61,896,1457,61.5%,46.19%,1
高雄市,小港區,1666,580,163,743,30,773,1392,55.53%,41.67%,1
高雄市,小港區,1667,805,209,1014,70,1084,1983,54.66%,40.6%,1
高雄市,小港區,1668,508,114,622,34,656,1204,54.49%,42.19%,1
高雄市,小港區,1669,538,171,709,45,754,1300,58%,41.38%,1
高雄市,小港區,1670,785,276,1061,88,1149,1857,61.87%,42.27%,1
高雄市,小港區,1671,664,177,841,42,883,1566,56.39%,42.4%,1
高雄市,小港區,1672,634,175,809,83,892,1343,66.42%,47.21%,1
高雄市,小港區,1673,537,179,716,77,793,1236,64.16%,43.45%,1
高雄市,小港區,1674,675,202,877,102,979,1564,62.6%,43.16%,1
高雄市,小港區,1675,592,182,774,39,813,1484,54.78%,39.89%,1
高雄市,小港區,1676,638,157,795,38,833,1477,56.4%,43.2%,1
高雄市,小港區,1677,653,218,871,49,920,1482,62.08%,44.06%,1
高雄市,小港區,1678,675,185,860,49,909,1708,53.22%,39.52%,1
高雄市,小港區,1679,721,279,1000,68,1068,1867,57.2%,38.62%,1
高雄市,小港區,1680,630,179,809,32,841,1709,49.21%,36.86%,1
高雄市,小港區,1681,545,159,704,82,786,1425,55.16%,38.25%,1
高雄市,小港區,1682,587,162,749,52,801,1696,47.23%,34.61%,1
高雄市,小港區,1683,505,173,678,45,723,1522,47.5%,33.18%,1
高雄市,小港區,1684,596,205,801,103,904,1531,59.05%,38.93%,1
高雄市,小港區,1685,818,262,1080,127,1207,2215,54.49%,36.93%,1
高雄市,小港區,1686,565,176,741,41,782,1515,51.62%,37.29%,1
高雄市,小港區,1687,539,164,703,33,736,1535,47.95%,35.11%,1
高雄市,小港區,1688,508,145,653,34,687,1276,53.84%,39.81%,1
高雄市,小港區,1689,432,128,560,40,600,1217,49.3%,35.5%,1
高雄市,小港區,1690,585,175,760,85,845,1707,49.5%,34.27%,1
高雄市,小港區,1691,664,232,896,127,1023,1920,53.28%,34.58%,1
高雄市,鳳山區,1256,507,144,651,59,710,1080,65.74%,46.94%,1
高雄市,鳳山區,1257,369,111,480,34,514,819,62.76%,45.05%,1
高雄市,鳳山區,1258,357,105,462,69,531,851,62.4%,41.95%,1
高雄市,鳳山區,1259,492,141,633,40,673,1075,62.6%,45.77%,1
高雄市,鳳山區,1260,562,151,713,40,753,1223,61.57%,45.95%,1
高雄市,鳳山區,1261,545,161,706,38,744,1207,61.64%,45.15%,1
高雄市,鳳山區,1262,519,172,691,42,733,1339,54.74%,38.76%,1
高雄市,鳳山區,1263,463,111,574,39,613,1188,51.6%,38.97%,1
高雄市,鳳山區,1264,448,128,576,62,638,1055,60.47%,42.46%,1
高雄市,鳳山區,1265,455,111,566,69,635,1109,57.26%,41.03%,1
高雄市,鳳山區,1266,366,109,475,44,519,756,68.65%,48.41%,1
高雄市,鳳山區,1267,486,121,607,38,645,1182,54.57%,41.12%,1
高雄市,鳳山區,1268,623,185,808,79,887,1496,59.29%,41.64%,1
高雄市,鳳山區,1269,784,203,987,59,1046,2094,49.95%,37.44%,1
高雄市,鳳山區,1270,693,174,867,29,896,1672,53.59%,41.45%,1
高雄市,鳳山區,1271,755,174,929,22,951,1761,54%,42.87%,1
高雄市,鳳山區,1272,605,181,786,74,860,1450,59.31%,41.72%,1
高雄市,鳳山區,1273,558,159,717,33,750,1455,51.55%,38.35%,1
高雄市,鳳山區,1274,551,125,676,57,733,1234,59.4%,44.65%,1
高雄市,鳳山區,1275,776,116,892,80,972,1713,56.74%,45.3%,1
高雄市,鳳山區,1276,677,164,841,37,878,1698,51.71%,39.87%,1
高雄市,鳳山區,1277,561,147,708,64,772,1247,61.91%,44.99%,1
高雄市,鳳山區,1278,466,145,611,47,658,1087,60.53%,42.87%,1
高雄市,鳳山區,1279,527,162,689,27,716,1199,59.72%,43.95%,1
高雄市,鳳山區,1280,731,116,847,52,899,1559,57.67%,46.89%,1
高雄市,鳳山區,1281,537,145,682,43,725,1233,58.8%,43.55%,1
高雄市,鳳山區,1282,549,157,706,50,756,1277,59.2%,42.99%,1
高雄市,鳳山區,1283,645,136,781,20,801,1481,54.09%,43.55%,1
高雄市,鳳山區,1284,574,149,723,13,736,1154,63.78%,49.74%,1
高雄市,鳳山區,1285,674,203,877,20,897,1475,60.81%,45.69%,1
高雄市,鳳山區,1286,502,113,615,37,652,1247,52.29%,40.26%,1
高雄市,鳳山區,1287,604,166,770,72,842,1538,54.75%,39.27%,1
高雄市,鳳山區,1288,441,134,575,39,614,1097,55.97%,40.2%,1
高雄市,鳳山區,1289,500,94,594,29,623,1221,51.02%,40.95%,1
高雄市,鳳山區,1290,529,139,668,60,728,1075,67.72%,49.21%,1
高雄市,鳳山區,1291,811,203,1014,45,1059,1751,60.48%,46.32%,1
高雄市,鳳山區,1292,780,219,999,45,1044,1758,59.39%,44.37%,1
高雄市,鳳山區,1293,729,224,953,82,1035,1749,59.18%,41.68%,1
高雄市,鳳山區,1294,741,199,940,22,962,1746,55.1%,42.44%,1
高雄市,鳳山區,1295,740,178,918,46,964,1712,56.31%,43.22%,1
高雄市,鳳山區,1296,552,159,711,33,744,1247,59.66%,44.27%,1
高雄市,鳳山區,1297,604,199,803,54,857,1409,60.82%,42.87%,1
高雄市,鳳山區,1298,561,193,754,60,814,1347,60.43%,41.65%,1
高雄市,鳳山區,1299,766,195,961,26,987,1771,55.73%,43.25%,1
高雄市,鳳山區,1300,665,182,847,17,864,1537,56.21%,43.27%,1
高雄市,鳳山區,1301,740,179,919,28,947,1605,59%,46.11%,1
高雄市,鳳山區,1302,626,153,779,46,825,1375,60%,45.53%,1
高雄市,鳳山區,1303,642,177,819,53,872,1393,62.6%,46.09%,1
高雄市,鳳山區,1304,675,150,825,33,858,1584,54.17%,42.61%,1
高雄市,鳳山區,1305,254,82,336,25,361,618,58.41%,41.1%,1
高雄市,鳳山區,1306,179,55,234,16,250,423,59.1%,42.32%,1
高雄市,鳳山區,1307,517,179,696,63,759,1312,57.85%,39.41%,1
高雄市,鳳山區,1308,323,102,425,31,456,769,59.3%,42%,1
高雄市,鳳山區,1309,636,110,746,27,773,1213,63.73%,52.43%,1
高雄市,鳳山區,1310,539,133,672,49,721,1107,65.13%,48.69%,1
高雄市,鳳山區,1311,503,172,675,31,706,1188,59.43%,42.34%,1
高雄市,鳳山區,1312,539,156,695,40,735,1183,62.13%,45.56%,1
高雄市,鳳山區,1313,555,174,729,50,779,1264,61.63%,43.91%,1
高雄市,鳳山區,1314,356,130,486,34,520,882,58.96%,40.36%,1
高雄市,鳳山區,1315,500,142,642,60,702,1007,69.71%,49.65%,1
高雄市,鳳山區,1316,360,114,474,61,535,853,62.72%,42.2%,1
高雄市,鳳山區,1317,299,115,414,58,472,1660,28.43%,18.01%,1
高雄市,鳳山區,1318,517,142,659,31,690,1124,61.39%,46%,1
高雄市,鳳山區,1319,469,159,628,63,691,1112,62.14%,42.18%,1
高雄市,鳳山區,1320,491,118,609,43,652,1182,55.16%,41.54%,1
高雄市,鳳山區,1321,445,129,574,49,623,875,71.2%,50.86%,1
高雄市,鳳山區,1322,423,157,580,58,638,1040,61.35%,40.67%,1
高雄市,鳳山區,1323,523,144,667,30,697,1094,63.71%,47.81%,1
高雄市,鳳山區,1324,568,145,713,62,775,1217,63.68%,46.67%,1
高雄市,鳳山區,1325,494,136,630,36,666,974,68.38%,50.72%,1
高雄市,鳳山區,1326,446,110,556,42,598,987,60.59%,45.19%,1
高雄市,鳳山區,1327,589,169,758,18,776,1210,64.13%,48.68%,1
高雄市,鳳山區,1328,587,190,777,57,834,1391,59.96%,42.2%,1
高雄市,鳳山區,1329,448,144,592,25,617,1241,49.72%,36.1%,1
高雄市,鳳山區,1330,494,102,596,48,644,1000,64.4%,49.4%,1
高雄市,鳳山區,1331,490,129,619,44,663,1092,60.71%,44.87%,1
高雄市,鳳山區,1332,603,156,759,46,805,1308,61.54%,46.1%,1
高雄市,鳳山區,1333,465,123,588,58,646,1031,62.66%,45.1%,1
高雄市,鳳山區,1334,521,152,673,64,737,1159,63.59%,44.95%,1
高雄市,鳳山區,1335,481,132,613,61,674,1127,59.8%,42.68%,1
高雄市,鳳山區,1336,565,183,748,48,796,1109,71.78%,50.95%,1
高雄市,鳳山區,1337,930,202,1132,60,1192,1879,63.44%,49.49%,1
高雄市,鳳山區,1338,944,214,1158,37,1195,1803,66.28%,52.36%,1
高雄市,鳳山區,1339,823,195,1018,85,1103,2045,53.94%,40.24%,1
高雄市,鳳山區,1340,619,143,762,56,818,1432,57.12%,43.23%,1
高雄市,鳳山區,1341,421,93,514,20,534,1033,51.69%,40.76%,1
高雄市,鳳山區,1342,530,179,709,89,798,1253,63.69%,42.3%,1
高雄市,鳳山區,1343,516,155,671,34,705,1217,57.93%,42.4%,1
高雄市,鳳山區,1344,613,152,765,49,814,1267,64.25%,48.38%,1
高雄市,鳳山區,1345,502,146,648,40,688,1251,55%,40.13%,1
高雄市,鳳山區,1346,696,165,861,85,946,1563,60.52%,44.53%,1
高雄市,鳳山區,1347,882,215,1097,58,1155,1888,61.18%,46.72%,1
高雄市,鳳山區,1348,579,196,775,60,835,1368,61.04%,42.32%,1
高雄市,鳳山區,1349,638,165,803,47,850,1588,53.53%,40.18%,1
高雄市,鳳山區,1350,623,108,731,66,797,1255,63.51%,49.64%,1
高雄市,鳳山區,1351,533,164,697,69,766,1264,60.6%,42.17%,1
高雄市,鳳山區,1352,553,150,703,86,789,1291,61.12%,42.84%,1
高雄市,鳳山區,1353,542,116,658,35,693,1224,56.62%,44.28%,1
高雄市,鳳山區,1354,599,129,728,31,759,1296,58.56%,46.22%,1
高雄市,鳳山區,1355,395,107,502,54,556,826,67.31%,47.82%,1
高雄市,鳳山區,1356,584,116,700,46,746,1229,60.7%,47.52%,1
高雄市,鳳山區,1357,702,156,858,43,901,1467,61.42%,47.85%,1
高雄市,鳳山區,1358,530,155,685,62,747,1218,61.33%,43.51%,1
高雄市,鳳山區,1359,907,236,1143,86,1229,2173,56.56%,41.74%,1
高雄市,鳳山區,1360,1002,235,1237,74,1311,2255,58.14%,44.43%,1
高雄市,鳳山區,1361,714,172,886,40,926,1556,59.51%,45.89%,1
高雄市,鳳山區,1362,623,173,796,54,850,1521,55.88%,40.96%,1
高雄市,鳳山區,1363,555,141,696,39,735,1407,52.24%,39.45%,1
高雄市,鳳山區,1364,710,165,875,63,938,1542,60.83%,46.04%,1
高雄市,鳳山區,1365,614,148,762,24,786,1502,52.33%,40.88%,1
高雄市,鳳山區,1366,626,151,777,45,822,1320,62.27%,47.42%,1
高雄市,鳳山區,1367,701,95,796,38,834,1507,55.34%,46.52%,1
高雄市,鳳山區,1368,690,89,779,41,820,1284,63.86%,53.74%,1
高雄市,鳳山區,1369,604,149,753,40,793,1441,55.03%,41.92%,1
高雄市,鳳山區,1370,689,143,832,83,915,1485,61.62%,46.4%,1
高雄市,鳳山區,1371,471,169,640,61,701,1205,58.17%,39.09%,1
高雄市,鳳山區,1372,507,151,658,26,684,1284,53.27%,39.49%,1
高雄市,鳳山區,1373,573,190,763,62,825,1326,62.22%,43.21%,1
高雄市,鳳山區,1374,466,149,615,27,642,1096,58.58%,42.52%,1
高雄市,鳳山區,1375,485,191,676,82,758,1182,64.13%,41.03%,1
高雄市,鳳山區,1376,476,161,637,56,693,1017,68.14%,46.8%,1
高雄市,鳳山區,1377,441,175,616,92,708,1198,59.1%,36.81%,1
高雄市,鳳山區,1378,462,157,619,34,653,1281,50.98%,36.07%,1
高雄市,鳳山區,1379,617,200,817,44,861,1358,63.4%,45.43%,1
高雄市,鳳山區,1380,592,169,761,48,809,1226,65.99%,48.29%,1
高雄市,鳳山區,1381,491,153,644,66,710,1098,64.66%,44.72%,1
高雄市,鳳山區,1382,524,158,682,41,723,1200,60.25%,43.67%,1
高雄市,鳳山區,1383,393,114,507,43,550,942,58.39%,41.72%,1
高雄市,鳳山區,1384,491,144,635,24,659,1206,54.64%,40.71%,1
高雄市,鳳山區,1385,534,168,702,43,745,1159,64.28%,46.07%,1
高雄市,鳳山區,1386,732,105,837,49,886,1401,63.24%,52.25%,1
高雄市,鳳山區,1387,736,62,798,18,816,1525,53.51%,48.26%,1
高雄市,鳳山區,1388,535,197,732,36,768,1345,57.1%,39.78%,1
高雄市,鳳山區,1389,513,177,690,41,731,1180,61.95%,43.47%,1
高雄市,鳳山區,1390,417,139,556,24,580,1106,52.44%,37.7%,1
高雄市,鳳山區,1391,663,187,850,63,913,1442,63.31%,45.98%,1
高雄市,鳳山區,1392,621,180,801,54,855,1376,62.14%,45.13%,1
高雄市,鳳山區,1393,534,160,694,32,726,1243,58.41%,42.96%,1
高雄市,鳳山區,1394,615,139,754,25,779,1361,57.24%,45.19%,1
高雄市,鳳山區,1395,626,192,818,64,882,1416,62.29%,44.21%,1
高雄市,鳳山區,1396,716,220,936,70,1006,1536,65.49%,46.61%,1
高雄市,鳳山區,1397,532,162,694,33,727,1388,52.38%,38.33%,1
高雄市,鳳山區,1398,534,157,691,78,769,1241,61.97%,43.03%,1
高雄市,鳳山區,1399,640,214,854,17,871,1394,62.48%,45.91%,1
高雄市,鳳山區,1400,589,155,744,29,773,1188,65.07%,49.58%,1
高雄市,鳳山區,1401,477,147,624,39,663,1112,59.62%,42.9%,1
高雄市,鳳山區,1402,559,176,735,53,788,1198,65.78%,46.66%,1
高雄市,鳳山區,1403,626,185,811,48,859,1475,58.24%,42.44%,1
高雄市,鳳山區,1404,476,137,613,34,647,1216,53.21%,39.14%,1
高雄市,鳳山區,1405,462,154,616,36,652,1318,49.47%,35.05%,1
高雄市,鳳山區,1406,700,82,782,25,807,1465,55.09%,47.78%,1
高雄市,鳳山區,1407,488,148,636,46,682,1314,51.9%,37.14%,1
高雄市,鳳山區,1408,628,157,785,28,813,1649,49.3%,38.08%,1
高雄市,鳳山區,1409,595,197,792,100,892,1601,55.72%,37.16%,1
高雄市,鳳山區,1410,472,136,608,29,637,1155,55.15%,40.87%,1
高雄市,鳳山區,1411,433,140,573,72,645,1050,61.43%,41.24%,1
高雄市,鳳山區,1412,543,144,687,28,715,1417,50.46%,38.32%,1
高雄市,鳳山區,1413,629,187,816,65,881,1525,57.77%,41.25%,1
高雄市,鳳山區,1414,699,162,861,63,924,1514,61.03%,46.17%,1
高雄市,鳳山區,1415,520,137,657,49,706,1190,59.33%,43.7%,1
高雄市,鳳山區,1416,540,142,682,24,706,1325,53.28%,40.75%,1
高雄市,鳳山區,1417,464,132,596,58,654,1049,62.35%,44.23%,1
高雄市,鳳山區,1418,443,122,565,33,598,1026,58.28%,43.18%,1
高雄市,鳳山區,1419,492,165,657,63,720,1152,62.5%,42.71%,1
高雄市,鳳山區,1420,479,143,622,19,641,1254,51.12%,38.2%,1
高雄市,鳳山區,1421,642,183,825,50,875,1688,51.84%,38.03%,1
高雄市,鳳山區,1422,733,168,901,58,959,1657,57.88%,44.24%,1
高雄市,鳳山區,1423,678,196,874,36,910,1729,52.63%,39.21%,1
高雄市,鳳山區,1424,744,185,929,56,985,1628,60.5%,45.7%,1
高雄市,鳳山區,1425,733,176,909,19,928,1891,49.07%,38.76%,1
高雄市,鳳山區,1426,751,182,933,44,977,1594,61.29%,47.11%,1
高雄市,鳳山區,1427,662,157,819,20,839,1342,62.52%,49.33%,1
高雄市,鳳山區,1428,723,184,907,40,947,1448,65.4%,49.93%,1
高雄市,鳳山區,1429,615,187,802,65,867,1405,61.71%,43.77%,1
高雄市,鳳山區,1430,482,154,636,79,715,1097,65.18%,43.94%,1
高雄市,鳳山區,1431,504,215,719,98,817,1248,65.46%,40.38%,1
高雄市,鳳山區,1432,516,176,692,70,762,1225,62.2%,42.12%,1
高雄市,鳳山區,1433,469,161,630,39,669,1214,55.11%,38.63%,1
高雄市,鳳山區,1434,894,238,1132,104,1236,2032,60.83%,44%,1
高雄市,鳳山區,1435,855,214,1069,72,1141,1927,59.21%,44.37%,1
高雄市,鳳山區,1436,966,240,1206,58,1264,2097,60.28%,46.07%,1
高雄市,鳳山區,1437,387,127,514,54,568,968,58.68%,39.98%,1
高雄市,鳳山區,1438,465,139,604,69,673,1200,56.08%,38.75%,1
高雄市,鳳山區,1439,455,143,598,72,670,1101,60.85%,41.33%,1
高雄市,鳳山區,1440,539,158,697,42,739,1369,53.98%,39.37%,1
高雄市,鳳山區,1441,769,68,837,67,904,1542,58.63%,49.87%,1
高雄市,鳳山區,1442,704,184,888,63,951,1536,61.91%,45.83%,1
高雄市,鳳山區,1443,502,183,685,33,718,1382,51.95%,36.32%,1
高雄市,鳳山區,1444,599,199,798,99,897,1452,61.78%,41.25%,1
高雄市,鳳山區,1445,462,123,585,62,647,1058,61.15%,43.67%,1
高雄市,鳳山區,1446,467,111,578,56,634,976,64.96%,47.85%,1
高雄市,鳳山區,1447,593,165,758,39,797,1545,51.59%,38.38%,1
高雄市,鳳山區,1448,480,187,667,6,673,1143,58.88%,41.99%,1
高雄市,鳳山區,1449,241,73,314,24,338,1301,25.98%,18.52%,1
高雄市,鳳山區,1450,427,129,556,32,588,1250,47.04%,34.16%,1
高雄市,鳳山區,1451,512,137,649,58,707,1208,58.53%,42.38%,1
高雄市,鳳山區,1452,502,149,651,86,737,1202,61.31%,41.76%,1
高雄市,鳳山區,1453,587,183,770,87,857,1499,57.17%,39.16%,1
高雄市,鳳山區,1454,591,208,799,55,854,1522,56.11%,38.83%,1
高雄市,鳳山區,1455,506,147,653,59,712,1125,63.29%,44.98%,1
高雄市,鳳山區,1456,578,168,746,27,773,1307,59.14%,44.22%,1
高雄市,鳳山區,1457,562,198,760,67,827,1405,58.86%,40%,1
高雄市,鳳山區,1458,546,142,688,64,752,1252,60.06%,43.61%,1
高雄市,鳳山區,1459,594,152,746,29,775,1291,60.03%,46.01%,1
高雄市,鳳山區,1460,414,112,526,68,594,938,63.33%,44.14%,1
高雄市,鳳山區,1461,767,230,997,42,1039,1783,58.27%,43.02%,1
高雄市,鳳山區,1462,489,133,622,42,664,1105,60.09%,44.25%,1
高雄市,鳳山區,1463,550,191,741,93,834,1392,59.91%,39.51%,1
高雄市,鳳山區,1464,613,169,782,48,830,1244,66.72%,49.28%,1
高雄市,鳳山區,1465,458,147,605,49,654,1154,56.67%,39.69%,1
高雄市,鳳山區,1466,510,133,643,54,697,1153,60.45%,44.23%,1
高雄市,鳳山區,1467,435,106,541,19,560,1148,48.78%,37.89%,1
高雄市,鳳山區,1468,526,185,711,115,826,1432,57.68%,36.73%,1
高雄市,鳳山區,1469,420,150,570,20,590,1429,41.29%,29.39%,1
高雄市,鳳山區,1470,623,151,774,35,809,1479,54.7%,42.12%,1
高雄市,鳳山區,1471,451,127,578,51,629,1026,61.31%,43.96%,1
高雄市,鳳山區,1472,529,52,581,93,674,993,67.88%,53.27%,1
高雄市,鳳山區,1473,427,120,547,69,616,947,65.05%,45.09%,1
高雄市,鳳山區,1474,419,116,535,69,604,1042,57.97%,40.21%,1
高雄市,鳳山區,1475,459,134,593,68,661,1098,60.2%,41.8%,1
高雄市,鳳山區,1476,468,156,624,23,647,1284,50.39%,36.45%,1
高雄市,鳳山區,1477,479,146,625,40,665,1242,53.54%,38.57%,1
高雄市,鳳山區,1478,477,134,611,77,688,1093,62.95%,43.64%,1
高雄市,鳳山區,1479,533,167,700,53,753,1353,55.65%,39.39%,1
高雄市,鳳山區,1480,526,141,667,33,700,1353,51.74%,38.88%,1
高雄市,鳳山區,1481,556,170,726,75,801,1309,61.19%,42.48%,1
高雄市,鳳山區,1482,679,201,880,64,944,1627,58.02%,41.73%,1
高雄市,鳳山區,1483,560,179,739,94,833,1372,60.71%,40.82%,1
高雄市,林園區,1773,514,156,670,91,761,1262,60.3%,40.73%,1
高雄市,林園區,1774,562,177,739,81,820,1562,52.5%,35.98%,1
高雄市,林園區,1775,460,113,573,31,604,1078,56.03%,42.67%,1
高雄市,林園區,1776,428,135,563,61,624,979,63.74%,43.72%,1
高雄市,林園區,1777,484,129,613,53,666,1195,55.73%,40.5%,1
高雄市,林園區,1778,512,163,675,78,753,1380,54.57%,37.1%,1
高雄市,林園區,1779,470,173,643,83,726,1280,56.72%,36.72%,1
高雄市,林園區,1780,461,175,636,34,670,1269,52.8%,36.33%,1
高雄市,林園區,1781,486,182,668,26,694,1568,44.26%,30.99%,1
高雄市,林園區,1782,488,185,673,65,738,1226,60.2%,39.8%,1
高雄市,林園區,1783,580,158,738,68,806,1480,54.46%,39.19%,1
高雄市,林園區,1784,629,159,788,70,858,1459,58.81%,43.11%,1
高雄市,林園區,1785,570,183,753,59,812,1593,50.97%,35.78%,1
高雄市,林園區,1786,321,127,448,89,537,895,60%,35.87%,1
高雄市,林園區,1787,402,130,532,42,574,1110,51.71%,36.22%,1
高雄市,林園區,1788,514,148,662,69,731,1348,54.23%,38.13%,1
高雄市,林園區,1789,347,131,478,64,542,912,59.43%,38.05%,1
高雄市,林園區,1790,489,142,631,70,701,1085,64.61%,45.07%,1
高雄市,林園區,1791,373,101,474,35,509,955,53.3%,39.06%,1
高雄市,林園區,1792,366,122,488,54,542,879,61.66%,41.64%,1
高雄市,林園區,1793,448,118,566,75,641,1103,58.11%,40.62%,1
高雄市,林園區,1794,464,127,591,77,668,1054,63.38%,44.02%,1
高雄市,林園區,1795,455,119,574,19,593,1292,45.9%,35.22%,1
高雄市,林園區,1796,565,157,722,36,758,1683,45.04%,33.57%,1
高雄市,林園區,1797,247,65,312,39,351,607,57.83%,40.69%,1
高雄市,林園區,1798,390,121,511,81,592,1012,58.5%,38.54%,1
高雄市,林園區,1799,421,119,540,76,616,1046,58.89%,40.25%,1
高雄市,林園區,1800,311,82,393,26,419,914,45.84%,34.03%,1
高雄市,林園區,1801,584,163,747,72,819,1405,58.29%,41.57%,1
高雄市,林園區,1802,542,176,718,74,792,1299,60.97%,41.72%,1
高雄市,林園區,1803,483,105,588,35,623,1170,53.25%,41.28%,1
高雄市,林園區,1804,406,140,546,44,590,1299,45.42%,31.25%,1
高雄市,林園區,1805,400,150,550,34,584,1031,56.64%,38.8%,1
高雄市,林園區,1806,315,92,407,25,432,849,50.88%,37.1%,1
高雄市,林園區,1807,276,119,395,56,451,838,53.82%,32.94%,1
高雄市,林園區,1808,385,103,488,35,523,938,55.76%,41.04%,1
高雄市,林園區,1809,358,102,460,47,507,1051,48.24%,34.06%,1
高雄市,林園區,1810,314,105,419,58,477,786,60.69%,39.95%,1
高雄市,林園區,1811,366,107,473,80,553,894,61.86%,40.94%,1
高雄市,林園區,1812,198,58,256,22,278,749,37.12%,26.44%,1
高雄市,林園區,1813,653,167,820,44,864,1485,58.18%,43.97%,1
高雄市,林園區,1814,602,187,789,105,894,1478,60.49%,40.73%,1
高雄市,林園區,1815,559,205,764,84,848,1345,63.05%,41.56%,1
高雄市,林園區,1816,344,167,511,62,573,1038,55.2%,33.14%,1
高雄市,林園區,1817,521,144,665,29,694,1203,57.69%,43.31%,1
高雄市,林園區,1818,455,129,584,37,621,1138,54.57%,39.98%,1
高雄市,林園區,1819,397,88,485,18,503,1025,49.07%,38.73%,1
高雄市,林園區,1820,543,159,702,87,789,1341,58.84%,40.49%,1
高雄市,林園區,1821,404,120,524,24,548,1218,44.99%,33.17%,1
高雄市,林園區,1822,360,90,450,32,482,1147,42.02%,31.39%,1
高雄市,林園區,1823,353,116,469,22,491,1176,41.75%,30.02%,1
高雄市,大寮區,1692,243,87,330,25,355,727,48.83%,33.43%,1
高雄市,大寮區,1693,233,85,318,19,337,718,46.94%,32.45%,1
高雄市,大寮區,1694,468,140,608,46,654,1340,48.81%,34.93%,1
高雄市,大寮區,1695,528,163,691,47,738,1575,46.86%,33.52%,1
高雄市,大寮區,1696,166,66,232,29,261,444,58.78%,37.39%,1
高雄市,大寮區,1697,792,206,998,55,1053,2374,44.36%,33.36%,1
高雄市,大寮區,1698,503,140,643,78,721,1291,55.85%,38.96%,1
高雄市,大寮區,1699,544,172,716,81,797,1400,56.93%,38.86%,1
高雄市,大寮區,1700,539,162,701,37,738,1390,53.09%,38.78%,1
高雄市,大寮區,1701,515,178,693,88,781,1401,55.75%,36.76%,1
高雄市,大寮區,1702,447,124,571,38,609,1199,50.79%,37.28%,1
高雄市,大寮區,1703,420,129,549,34,583,1210,48.18%,34.71%,1
高雄市,大寮區,1704,460,156,616,47,663,1195,55.48%,38.49%,1
高雄市,大寮區,1705,431,117,548,36,584,1166,50.09%,36.96%,1
高雄市,大寮區,1706,527,167,694,45,739,1353,54.62%,38.95%,1
高雄市,大寮區,1707,428,140,568,73,641,1052,60.93%,40.68%,1
高雄市,大寮區,1708,330,95,425,32,457,1024,44.63%,32.23%,1
高雄市,大寮區,1709,484,149,633,26,659,1189,55.42%,40.71%,1
高雄市,大寮區,1710,633,191,824,91,915,1512,60.52%,41.87%,1
高雄市,大寮區,1711,612,181,793,80,873,1633,53.46%,37.48%,1
高雄市,大寮區,1712,506,160,666,53,719,1214,59.23%,41.68%,1
高雄市,大寮區,1713,545,180,725,79,804,1258,63.91%,43.32%,1
高雄市,大寮區,1714,525,183,708,42,750,1323,56.69%,39.68%,1
高雄市,大寮區,1715,556,141,697,57,754,1253,60.18%,44.37%,1
高雄市,大寮區,1716,350,229,579,75,654,1035,63.19%,33.82%,1
高雄市,大寮區,1717,458,120,578,28,606,1106,54.79%,41.41%,1
高雄市,大寮區,1718,494,144,638,46,684,1195,57.24%,41.34%,1
高雄市,大寮區,1719,436,149,585,21,606,1051,57.66%,41.48%,1
高雄市,大寮區,1720,581,184,765,86,851,1425,59.72%,40.77%,1
高雄市,大寮區,1721,648,196,844,65,909,1635,55.6%,39.63%,1
高雄市,大寮區,1722,542,196,738,68,806,1359,59.31%,39.88%,1
高雄市,大寮區,1723,601,140,741,64,805,1361,59.15%,44.16%,1
高雄市,大寮區,1724,681,181,862,51,913,1629,56.05%,41.8%,1
高雄市,大寮區,1725,670,161,831,55,886,1518,58.37%,44.14%,1
高雄市,大寮區,1726,645,204,849,71,920,1620,56.79%,39.81%,1
高雄市,大寮區,1727,645,192,837,29,866,1648,52.55%,39.14%,1
高雄市,大寮區,1728,592,146,738,52,790,1385,57.04%,42.74%,1
高雄市,大寮區,1729,572,140,712,36,748,1435,52.13%,39.86%,1
高雄市,大寮區,1730,426,112,538,28,566,1046,54.11%,40.73%,1
高雄市,大寮區,1731,272,108,380,37,417,789,52.85%,34.47%,1
高雄市,大寮區,1732,333,121,454,38,492,909,54.13%,36.63%,1
高雄市,大寮區,1733,284,106,390,43,433,733,59.07%,38.74%,1
高雄市,大寮區,1734,693,77,770,71,841,1553,54.15%,44.62%,1
高雄市,大寮區,1735,358,110,468,31,499,922,54.12%,38.83%,1
高雄市,大寮區,1736,385,130,515,71,586,1012,57.91%,38.04%,1
高雄市,大寮區,1737,330,132,462,74,536,968,55.37%,34.09%,1
高雄市,大寮區,1738,362,154,516,38,554,1021,54.26%,35.46%,1
高雄市,大寮區,1739,517,157,674,79,753,1554,48.46%,33.27%,1
高雄市,大寮區,1740,474,136,610,75,685,1120,61.16%,42.32%,1
高雄市,大寮區,1741,572,134,706,56,762,1225,62.2%,46.69%,1
高雄市,大寮區,1742,383,103,486,25,511,1320,38.71%,29.02%,1
高雄市,大寮區,1743,514,168,682,61,743,1317,56.42%,39.03%,1
高雄市,大寮區,1744,446,130,576,21,597,1119,53.35%,39.86%,1
高雄市,大寮區,1745,582,80,662,59,721,1190,60.59%,48.91%,1
高雄市,大寮區,1746,566,137,703,54,757,1229,61.59%,46.05%,1
高雄市,大寮區,1747,557,147,704,51,755,1178,64.09%,47.28%,1
高雄市,大寮區,1748,587,170,757,35,792,1272,62.26%,46.15%,1
高雄市,大寮區,1749,601,140,741,29,770,1413,54.49%,42.53%,1
高雄市,大寮區,1750,535,138,673,66,739,1185,62.36%,45.15%,1
高雄市,大寮區,1751,237,62,299,5,304,553,54.97%,42.86%,1
高雄市,大寮區,1752,436,119,555,72,627,1121,55.93%,38.89%,1
高雄市,大寮區,1753,487,144,631,46,677,1227,55.18%,39.69%,1
高雄市,大寮區,1754,520,133,653,63,716,1058,67.67%,49.15%,1
高雄市,大寮區,1755,520,141,661,34,695,1209,57.49%,43.01%,1
高雄市,大寮區,1756,481,121,602,23,625,1100,56.82%,43.73%,1
高雄市,大寮區,1757,442,117,559,25,584,1122,52.05%,39.39%,1
高雄市,大寮區,1758,424,140,564,76,640,983,65.11%,43.13%,1
高雄市,大寮區,1759,430,137,567,32,599,1192,50.25%,36.07%,1
高雄市,大寮區,1760,249,103,352,37,389,719,54.1%,34.63%,1
高雄市,大寮區,1761,328,124,452,33,485,829,58.5%,39.57%,1
高雄市,大寮區,1762,346,116,462,71,533,771,69.13%,44.88%,1
高雄市,大寮區,1763,414,174,588,90,678,1075,63.07%,38.51%,1
高雄市,大寮區,1764,528,163,691,88,779,1280,60.86%,41.25%,1
高雄市,大寮區,1765,423,160,583,106,689,1179,58.44%,35.88%,1
高雄市,大寮區,1766,462,136,598,36,634,1210,52.4%,38.18%,1
高雄市,大寮區,1767,88,21,109,7,116,189,61.38%,46.56%,1
高雄市,大寮區,1768,530,152,682,68,750,1228,61.07%,43.16%,1
高雄市,大寮區,1769,490,130,620,50,670,1170,57.26%,41.88%,1
高雄市,大寮區,1770,669,145,814,60,874,1416,61.72%,47.25%,1
高雄市,大寮區,1771,677,172,849,33,882,1482,59.51%,45.68%,1
高雄市,大寮區,1772,617,136,753,68,821,1478,55.55%,41.75%,1
高雄市,大樹區,0736,559,166,725,23,748,1386,53.97%,40.33%,1
高雄市,大樹區,0737,647,163,810,25,835,1315,63.5%,49.2%,1
高雄市,大樹區,0738,985,263,1248,69,1317,2461,53.51%,40.02%,1
高雄市,大樹區,0739,510,127,637,35,672,1274,52.75%,40.03%,1
高雄市,大樹區,0740,507,129,636,78,714,1265,56.44%,40.08%,1
高雄市,大樹區,0741,576,201,777,78,855,1504,56.85%,38.3%,1
高雄市,大樹區,0742,372,119,491,30,521,1049,49.67%,35.46%,1
高雄市,大樹區,0743,589,195,784,65,849,1573,53.97%,37.44%,1
高雄市,大樹區,0744,376,107,483,41,524,1121,46.74%,33.54%,1
高雄市,大樹區,0745,500,143,643,60,703,1207,58.24%,41.43%,1
高雄市,大樹區,0746,417,139,556,38,594,1134,52.38%,36.77%,1
高雄市,大樹區,0747,429,167,596,56,652,1124,58.01%,38.17%,1
高雄市,大樹區,0748,463,152,615,102,717,1259,56.95%,36.78%,1
高雄市,大樹區,0749,478,149,627,65,692,1105,62.62%,43.26%,1
高雄市,大樹區,0750,440,143,583,68,651,1128,57.71%,39.01%,1
高雄市,大樹區,0751,360,128,488,99,587,1079,54.4%,33.36%,1
高雄市,大樹區,0752,339,113,452,52,504,1025,49.17%,33.07%,1
高雄市,大樹區,0753,342,122,464,65,529,950,55.68%,36%,1
高雄市,大樹區,0754,525,189,714,99,813,1433,56.73%,36.64%,1
高雄市,大樹區,0755,263,90,353,22,375,794,47.23%,33.12%,1
高雄市,大樹區,0756,208,69,277,17,294,781,37.64%,26.63%,1
高雄市,大樹區,0757,421,145,566,24,590,1318,44.76%,31.94%,1
高雄市,大樹區,0758,266,88,354,51,405,736,55.03%,36.14%,1
高雄市,大樹區,0759,342,101,443,36,479,1047,45.75%,32.66%,1
高雄市,大樹區,0760,478,193,671,75,746,1271,58.69%,37.61%,1
高雄市,大樹區,0761,365,147,512,44,556,1186,46.88%,30.78%,1
高雄市,大樹區,0762,392,133,525,56,581,1007,57.7%,38.93%,1
高雄市,大樹區,0763,336,122,458,60,518,859,60.3%,39.12%,1
高雄市,大樹區,0764,253,60,313,18,331,735,45.03%,34.42%,1
高雄市,大樹區,0765,421,135,556,82,638,1046,60.99%,40.25%,1
高雄市,大樹區,0766,542,60,602,49,651,880,73.98%,61.59%,1
高雄市,大樹區,0767,271,66,337,22,359,720,49.86%,37.64%,1
高雄市,大社區,0637,341,114,455,80,535,950,56.32%,35.89%,1
高雄市,大社區,0638,482,134,616,45,661,1306,50.61%,36.91%,1
高雄市,大社區,0639,656,132,788,37,825,1856,44.45%,35.34%,1
高雄市,大社區,0640,423,148,571,63,634,986,64.3%,42.9%,1
高雄市,大社區,0641,381,133,514,59,573,1116,51.34%,34.14%,1
高雄市,大社區,0642,518,201,719,87,806,1253,64.33%,41.34%,1
高雄市,大社區,0643,684,193,877,49,926,1613,57.41%,42.41%,1
高雄市,大社區,0644,546,173,719,53,772,1455,53.06%,37.53%,1
高雄市,大社區,0645,688,246,934,48,982,1674,58.66%,41.1%,1
高雄市,大社區,0646,430,114,544,64,608,1004,60.56%,42.83%,1
高雄市,大社區,0647,349,109,458,42,500,879,56.88%,39.7%,1
高雄市,大社區,0648,274,107,381,20,401,778,51.54%,35.22%,1
高雄市,大社區,0649,438,180,618,58,676,1110,60.9%,39.46%,1
高雄市,大社區,0650,548,194,742,66,808,1432,56.42%,38.27%,1
高雄市,大社區,0651,606,191,797,52,849,1466,57.91%,41.34%,1
高雄市,大社區,0652,569,302,871,100,971,1383,70.21%,41.14%,1
高雄市,大社區,0653,680,212,892,85,977,1645,59.39%,41.34%,1
高雄市,大社區,0654,549,171,720,66,786,1555,50.55%,35.31%,1
高雄市,大社區,0655,711,218,929,79,1008,1750,57.6%,40.63%,1
高雄市,大社區,0656,441,142,583,68,651,1111,58.6%,39.69%,1
高雄市,大社區,0657,460,158,618,75,693,1133,61.17%,40.6%,1
高雄市,大社區,0658,375,113,488,48,536,912,58.77%,41.12%,1
高雄市,大社區,0659,219,97,316,16,332,745,44.56%,29.4%,1
高雄市,大社區,0660,376,126,502,36,538,934,57.6%,40.26%,1
高雄市,仁武區,0661,822,229,1051,57,1108,1777,62.35%,46.26%,1
高雄市,仁武區,0662,1102,197,1299,89,1388,2273,61.06%,48.48%,1
高雄市,仁武區,0663,634,201,835,75,910,1384,65.75%,45.81%,1
高雄市,仁武區,0664,477,151,628,60,688,1170,58.8%,40.77%,1
高雄市,仁武區,0665,558,189,747,67,814,1216,66.94%,45.89%,1
高雄市,仁武區,0666,674,193,867,21,888,1598,55.57%,42.18%,1
高雄市,仁武區,0667,1052,234,1286,37,1323,2143,61.74%,49.09%,1
高雄市,仁武區,0668,528,158,686,60,746,1300,57.38%,40.62%,1
高雄市,仁武區,0669,551,184,735,78,813,1338,60.76%,41.18%,1
高雄市,仁武區,0670,455,158,613,27,640,1217,52.59%,37.39%,1
高雄市,仁武區,0671,423,127,550,65,615,1202,51.16%,35.19%,1
高雄市,仁武區,0672,531,143,674,46,720,1404,51.28%,37.82%,1
高雄市,仁武區,0673,324,102,426,54,480,830,57.83%,39.04%,1
高雄市,仁武區,0674,567,166,733,41,774,1802,42.95%,31.47%,1
高雄市,仁武區,0675,718,212,930,72,1002,1877,53.38%,38.25%,1
高雄市,仁武區,0676,578,202,780,48,828,1738,47.64%,33.26%,1
高雄市,仁武區,0677,605,190,795,53,848,1549,54.74%,39.06%,1
高雄市,仁武區,0678,674,177,851,77,928,1579,58.77%,42.69%,1
高雄市,仁武區,0679,550,145,695,51,746,1406,53.06%,39.12%,1
高雄市,仁武區,0680,658,132,790,35,825,1461,56.47%,45.04%,1
高雄市,仁武區,0681,568,205,773,47,820,1311,62.55%,43.33%,1
高雄市,仁武區,0682,553,167,720,27,747,1373,54.41%,40.28%,1
高雄市,仁武區,0683,325,145,470,22,492,1035,47.54%,31.4%,1
高雄市,仁武區,0684,405,179,584,47,631,1181,53.43%,34.29%,1
高雄市,仁武區,0685,658,185,843,53,896,1670,53.65%,39.4%,1
高雄市,仁武區,0686,624,184,808,42,850,1576,53.93%,39.59%,1
高雄市,仁武區,0687,714,190,904,74,978,1576,62.06%,45.3%,1
高雄市,仁武區,0688,882,245,1127,45,1172,1915,61.2%,46.06%,1
高雄市,仁武區,0689,739,171,910,33,943,1758,53.64%,42.04%,1
高雄市,仁武區,0690,936,209,1145,48,1193,1892,63.05%,49.47%,1
高雄市,仁武區,0691,895,250,1145,76,1221,2025,60.3%,44.2%,1
高雄市,仁武區,0692,939,237,1176,64,1240,2014,61.57%,46.62%,1
高雄市,仁武區,0693,749,196,945,49,994,1473,67.48%,50.85%,1
高雄市,仁武區,0694,366,106,472,39,511,979,52.2%,37.39%,1
高雄市,仁武區,0695,394,108,502,27,529,944,56.04%,41.74%,1
高雄市,仁武區,0696,476,133,609,98,707,1153,61.32%,41.28%,1
高雄市,仁武區,0697,527,139,666,42,708,1328,53.31%,39.68%,1
高雄市,仁武區,0698,699,210,909,85,994,1657,59.99%,42.18%,1
高雄市,仁武區,0699,570,172,742,76,818,1545,52.94%,36.89%,1
高雄市,仁武區,0700,583,211,794,68,862,1417,60.83%,41.14%,1
高雄市,仁武區,0701,751,217,968,59,1027,1602,64.11%,46.88%,1
高雄市,仁武區,0702,844,248,1092,76,1168,1823,64.07%,46.3%,1
高雄市,仁武區,0703,763,260,1023,45,1068,1914,55.8%,39.86%,1
高雄市,仁武區,0704,856,229,1085,60,1145,1992,57.48%,42.97%,1
高雄市,仁武區,0705,806,216,1022,45,1067,2045,52.18%,39.41%,1
高雄市,仁武區,0706,905,244,1149,54,1203,1982,60.7%,45.66%,1
高雄市,仁武區,0707,850,250,1100,56,1156,2167,53.35%,39.22%,1
高雄市,鳥松區,0708,692,228,920,62,982,1678,58.52%,41.24%,1
高雄市,鳥松區,0709,648,190,838,75,913,1682,54.28%,38.53%,1
高雄市,鳥松區,0710,530,159,689,58,747,1225,60.98%,43.27%,1
高雄市,鳥松區,0711,501,168,669,62,731,1322,55.3%,37.9%,1
高雄市,鳥松區,0712,528,158,686,47,733,1215,60.33%,43.46%,1
高雄市,鳥松區,0713,679,234,913,50,963,1779,54.13%,38.17%,1
高雄市,鳥松區,0714,503,206,709,23,732,1129,64.84%,44.55%,1
高雄市,鳥松區,0715,625,166,791,64,855,1374,62.23%,45.49%,1
高雄市,鳥松區,0716,424,167,591,35,626,1089,57.48%,38.93%,1
高雄市,鳥松區,0717,963,334,1297,62,1359,2219,61.24%,43.4%,1
高雄市,鳥松區,0718,662,227,889,35,924,1634,56.55%,40.51%,1
高雄市,鳥松區,0719,713,204,917,69,986,1553,63.49%,45.91%,1
高雄市,鳥松區,0720,729,212,941,53,994,1572,63.23%,46.37%,1
高雄市,鳥松區,0721,752,257,1009,52,1061,1688,62.86%,44.55%,1
高雄市,鳥松區,0722,690,254,944,38,982,1626,60.39%,42.44%,1
高雄市,鳥松區,0723,818,237,1055,66,1121,1744,64.28%,46.9%,1
高雄市,鳥松區,0724,471,147,618,61,679,1230,55.2%,38.29%,1
高雄市,鳥松區,0725,525,155,680,94,774,1201,64.45%,43.71%,1
高雄市,鳥松區,0726,517,153,670,46,716,1117,64.1%,46.28%,1
高雄市,鳥松區,0727,484,155,639,77,716,1255,57.05%,38.57%,1
高雄市,鳥松區,0728,527,157,684,49,733,1432,51.19%,36.8%,1
高雄市,鳥松區,0729,504,161,665,38,703,1370,51.31%,36.79%,1
高雄市,鳥松區,0730,601,173,774,76,850,1364,62.32%,44.06%,1
高雄市,鳥松區,0731,445,153,598,56,654,1041,62.82%,42.75%,1
高雄市,鳥松區,0732,360,111,471,40,511,702,72.79%,51.28%,1
高雄市,鳥松區,0733,469,195,664,67,731,1212,60.31%,38.7%,1
高雄市,鳥松區,0734,563,125,688,63,751,1289,58.26%,43.68%,1
高雄市,鳥松區,0735,697,196,893,32,925,1449,63.84%,48.1%,1
高雄市,岡山區,0261,646,162,808,64,872,1345,64.83%,48.03%,1
高雄市,岡山區,0262,327,113,440,27,467,1045,44.69%,31.29%,1
高雄市,岡山區,0263,473,119,592,46,638,1051,60.7%,45%,1
高雄市,岡山區,0264,409,115,524,20,544,917,59.32%,44.6%,1
高雄市,岡山區,0265,446,121,567,35,602,934,64.45%,47.75%,1
高雄市,岡山區,0266,511,123,634,54,688,1097,62.72%,46.58%,1
高雄市,岡山區,0267,610,146,756,46,802,1208,66.39%,50.5%,1
高雄市,岡山區,0268,515,178,693,74,767,1159,66.18%,44.43%,1
高雄市,岡山區,0269,416,138,554,69,623,1018,61.2%,40.86%,1
高雄市,岡山區,0270,471,135,606,44,650,1316,49.39%,35.79%,1
高雄市,岡山區,0271,613,123,736,35,771,1345,57.32%,45.58%,1
高雄市,岡山區,0272,597,153,750,53,803,1295,62.01%,46.1%,1
高雄市,岡山區,0273,621,170,791,49,840,1425,58.95%,43.58%,1
高雄市,岡山區,0274,533,135,668,39,707,1328,53.24%,40.14%,1
高雄市,岡山區,0275,614,161,775,25,800,1382,57.89%,44.43%,1
高雄市,岡山區,0276,652,140,792,33,825,1381,59.74%,47.21%,1
高雄市,岡山區,0277,552,145,697,72,769,1282,59.98%,43.06%,1
高雄市,岡山區,0278,508,164,672,18,690,1240,55.65%,40.97%,1
高雄市,岡山區,0279,590,139,729,65,794,1327,59.83%,44.46%,1
高雄市,岡山區,0280,701,182,883,68,951,1736,54.78%,40.38%,1
高雄市,岡山區,0281,670,208,878,68,946,1566,60.41%,42.78%,1
高雄市,岡山區,0282,648,169,817,50,867,1779,48.74%,36.42%,1
高雄市,岡山區,0283,702,182,884,83,967,1593,60.7%,44.07%,1
高雄市,岡山區,0284,660,186,846,72,918,1480,62.03%,44.59%,1
高雄市,岡山區,0285,610,167,777,36,813,1364,59.6%,44.72%,1
高雄市,岡山區,0286,620,184,804,58,862,1410,61.13%,43.97%,1
高雄市,岡山區,0287,564,163,727,61,788,1148,68.64%,49.13%,1
高雄市,岡山區,0288,264,96,360,46,406,625,64.96%,42.24%,1
高雄市,岡山區,0289,425,128,553,44,597,969,61.61%,43.86%,1
高雄市,岡山區,0290,379,130,509,23,532,861,61.79%,44.02%,1
高雄市,岡山區,0291,321,93,414,19,433,823,52.61%,39%,1
高雄市,岡山區,0292,397,129,526,68,594,889,66.82%,44.66%,1
高雄市,岡山區,0293,566,155,721,55,776,1283,60.48%,44.12%,1
高雄市,岡山區,0294,625,159,784,43,827,1512,54.7%,41.34%,1
高雄市,岡山區,0295,462,148,610,62,672,983,68.36%,47%,1
高雄市,岡山區,0296,571,140,711,42,753,1262,59.67%,45.25%,1
高雄市,岡山區,0297,464,150,614,65,679,1096,61.95%,42.34%,1
高雄市,岡山區,0298,471,128,599,49,648,1066,60.79%,44.18%,1
高雄市,岡山區,0299,513,115,628,36,664,1188,55.89%,43.18%,1
高雄市,岡山區,0300,592,184,776,59,835,1360,61.4%,43.53%,1
高雄市,岡山區,0301,605,182,787,47,834,1363,61.19%,44.39%,1
高雄市,岡山區,0302,637,172,809,67,876,1352,64.79%,47.12%,1
高雄市,岡山區,0303,635,161,796,73,869,1460,59.52%,43.49%,1
高雄市,岡山區,0304,584,144,728,51,779,1272,61.24%,45.91%,1
高雄市,岡山區,0305,491,145,636,56,692,1080,64.07%,45.46%,1
高雄市,岡山區,0306,519,178,697,83,780,1255,62.15%,41.35%,1
高雄市,岡山區,0307,446,119,565,63,628,938,66.95%,47.55%,1
高雄市,岡山區,0308,572,158,730,62,792,1237,64.03%,46.24%,1
高雄市,岡山區,0309,505,177,682,24,706,1413,49.96%,35.74%,1
高雄市,岡山區,0310,317,102,419,15,434,765,56.73%,41.44%,1
高雄市,岡山區,0311,497,146,643,35,678,1043,65%,47.65%,1
高雄市,岡山區,0312,327,69,396,40,436,844,51.66%,38.74%,1
高雄市,岡山區,0313,519,168,687,43,730,993,73.51%,52.27%,1
高雄市,岡山區,0314,460,139,599,71,670,1038,64.55%,44.32%,1
高雄市,岡山區,0315,435,145,580,78,658,1070,61.5%,40.65%,1
高雄市,岡山區,0316,445,159,604,80,684,1023,66.86%,43.5%,1
高雄市,岡山區,0317,559,176,735,31,766,1349,56.78%,41.44%,1
高雄市,岡山區,0318,568,161,729,48,777,1452,53.51%,39.12%,1
高雄市,岡山區,0319,127,60,187,16,203,301,67.44%,42.19%,1
高雄市,岡山區,0320,310,120,430,82,512,756,67.72%,41.01%,1
高雄市,岡山區,0321,249,86,335,20,355,733,48.43%,33.97%,1
高雄市,岡山區,0322,385,129,514,98,612,854,71.66%,45.08%,1
高雄市,岡山區,0323,277,79,356,22,378,866,43.65%,31.99%,1
高雄市,岡山區,0324,398,112,510,58,568,978,58.08%,40.7%,1
高雄市,岡山區,0325,663,116,779,40,819,1336,61.3%,49.63%,1
高雄市,岡山區,0326,663,77,740,21,761,1218,62.48%,54.43%,1
高雄市,岡山區,0327,178,67,245,14,259,341,75.95%,52.2%,1
高雄市,岡山區,0328,617,65,682,32,714,955,74.76%,64.61%,1
高雄市,岡山區,0329,576,63,639,11,650,940,69.15%,61.28%,1
高雄市,岡山區,0330,425,105,530,45,575,851,67.57%,49.94%,1
高雄市,岡山區,0331,440,77,517,18,535,762,70.21%,57.74%,1
高雄市,岡山區,0332,176,50,226,14,240,318,75.47%,55.35%,1
高雄市,橋頭區,0404,431,145,576,79,655,1005,65.17%,42.89%,1
高雄市,橋頭區,0405,483,149,632,48,680,1073,63.37%,45.01%,1
高雄市,橋頭區,0406,427,171,598,50,648,1129,57.4%,37.82%,1
高雄市,橋頭區,0407,552,148,700,81,781,1244,62.78%,44.37%,1
高雄市,橋頭區,0408,441,130,571,48,619,1091,56.74%,40.42%,1
高雄市,橋頭區,0409,634,172,806,52,858,1329,64.56%,47.71%,1
高雄市,橋頭區,0410,482,173,655,51,706,1140,61.93%,42.28%,1
高雄市,橋頭區,0411,476,188,664,86,750,1220,61.48%,39.02%,1
高雄市,橋頭區,0412,477,162,639,72,711,1047,67.91%,45.56%,1
高雄市,橋頭區,0413,511,166,677,110,787,1315,59.85%,38.86%,1
高雄市,橋頭區,0414,263,89,352,37,389,691,56.3%,38.06%,1
高雄市,橋頭區,0415,314,95,409,69,478,720,66.39%,43.61%,1
高雄市,橋頭區,0416,471,172,643,98,741,1192,62.16%,39.51%,1
高雄市,橋頭區,0417,556,179,735,104,839,1318,63.66%,42.19%,1
高雄市,橋頭區,0418,331,98,429,62,491,761,64.52%,43.5%,1
高雄市,橋頭區,0419,396,124,520,35,555,973,57.04%,40.7%,1
高雄市,橋頭區,0420,248,81,329,34,363,587,61.84%,42.25%,1
高雄市,橋頭區,0421,346,126,472,55,527,812,64.9%,42.61%,1
高雄市,橋頭區,0422,139,65,204,9,213,343,62.1%,40.52%,1
高雄市,橋頭區,0423,627,158,785,30,815,1266,64.38%,49.53%,1
高雄市,橋頭區,0424,496,151,647,93,740,1128,65.6%,43.97%,1
高雄市,橋頭區,0425,371,130,501,63,564,884,63.8%,41.97%,1
高雄市,橋頭區,0426,474,125,599,91,690,1187,58.13%,39.93%,1
高雄市,橋頭區,0427,524,165,689,86,775,1259,61.56%,41.62%,1
高雄市,橋頭區,0428,515,156,671,80,751,1361,55.18%,37.84%,1
高雄市,橋頭區,0429,256,64,320,37,357,671,53.2%,38.15%,1
高雄市,橋頭區,0430,548,170,718,61,779,1215,64.12%,45.1%,1
高雄市,橋頭區,0431,530,171,701,93,794,1255,63.27%,42.23%,1
高雄市,橋頭區,0432,574,154,728,70,798,1219,65.46%,47.09%,1
高雄市,橋頭區,0433,547,166,713,34,747,1372,54.45%,39.87%,1
高雄市,橋頭區,0434,210,80,290,11,301,758,39.71%,27.7%,1
高雄市,燕巢區,0333,443,130,573,93,666,1152,57.81%,38.45%,1
高雄市,燕巢區,0334,465,139,604,30,634,1120,56.61%,41.52%,1
高雄市,燕巢區,0335,447,130,577,64,641,974,65.81%,45.89%,1
高雄市,燕巢區,0336,396,118,514,23,537,1019,52.7%,38.86%,1
高雄市,燕巢區,0337,391,124,515,82,597,1058,56.43%,36.96%,1
高雄市,燕巢區,0338,295,102,397,33,430,1017,42.28%,29.01%,1
高雄市,燕巢區,0339,30,7,37,4,41,259,15.83%,11.58%,1
高雄市,燕巢區,0340,421,126,547,66,613,926,66.2%,45.46%,1
高雄市,燕巢區,0341,207,80,287,19,306,624,49.04%,33.17%,1
高雄市,燕巢區,0342,492,157,649,68,717,1102,65.06%,44.65%,1
高雄市,燕巢區,0343,413,116,529,48,577,1072,53.82%,38.53%,1
高雄市,燕巢區,0344,512,193,705,66,771,1361,56.65%,37.62%,1
高雄市,燕巢區,0345,193,62,255,31,286,472,60.59%,40.89%,1
高雄市,燕巢區,0346,444,134,578,63,641,1197,53.55%,37.09%,1
高雄市,燕巢區,0347,471,167,638,97,735,1134,64.81%,41.53%,1
高雄市,燕巢區,0348,423,134,557,48,605,1148,52.7%,36.85%,1
高雄市,燕巢區,0349,463,114,577,77,654,1207,54.18%,38.36%,1
高雄市,燕巢區,0350,627,193,820,55,875,1402,62.41%,44.72%,1
高雄市,燕巢區,0351,397,136,533,73,606,1000,60.6%,39.7%,1
高雄市,燕巢區,0352,458,143,601,78,679,1110,61.17%,41.26%,1
高雄市,燕巢區,0353,511,159,670,75,745,1291,57.71%,39.58%,1
高雄市,燕巢區,0354,288,117,405,80,485,797,60.85%,36.14%,1
高雄市,燕巢區,0355,378,114,492,75,567,1098,51.64%,34.43%,1
高雄市,燕巢區,0356,524,155,679,73,752,1393,53.98%,37.62%,1
高雄市,燕巢區,0357,353,90,443,23,466,1079,43.19%,32.72%,1
高雄市,田寮區,0237,100,36,136,6,142,369,38.48%,27.1%,1
高雄市,田寮區,0238,196,45,241,28,269,656,41.01%,29.88%,1
高雄市,田寮區,0239,74,33,107,9,116,406,28.57%,18.23%,1
高雄市,田寮區,0240,117,51,168,20,188,380,49.47%,30.79%,1
高雄市,田寮區,0241,137,41,178,13,191,379,50.4%,36.15%,1
高雄市,田寮區,0242,207,91,298,58,356,625,56.96%,33.12%,1
高雄市,田寮區,0243,323,82,405,29,434,946,45.88%,34.14%,1
高雄市,田寮區,0244,241,85,326,49,375,794,47.23%,30.35%,1
高雄市,田寮區,0245,110,39,149,19,168,382,43.98%,28.8%,1
高雄市,田寮區,0246,105,42,147,51,198,513,38.6%,20.47%,1
高雄市,田寮區,0247,197,72,269,22,291,601,48.42%,32.78%,1
高雄市,田寮區,0248,214,89,303,54,357,620,57.58%,34.52%,1
高雄市,阿蓮區,0216,413,150,563,35,598,1299,46.04%,31.79%,1
高雄市,阿蓮區,0217,415,127,542,30,572,1107,51.67%,37.49%,1
高雄市,阿蓮區,0218,293,112,405,30,435,898,48.44%,32.63%,1
高雄市,阿蓮區,0219,425,163,588,86,674,1259,53.53%,33.76%,1
高雄市,阿蓮區,0220,601,158,759,52,811,1579,51.36%,38.06%,1
高雄市,阿蓮區,0221,235,70,305,11,316,564,56.03%,41.67%,1
高雄市,阿蓮區,0222,334,110,444,52,496,768,64.58%,43.49%,1
高雄市,阿蓮區,0223,446,130,576,61,637,1092,58.33%,40.84%,1
高雄市,阿蓮區,0224,409,155,564,61,625,1099,56.87%,37.22%,1
高雄市,阿蓮區,0225,492,102,594,28,622,1134,54.85%,43.39%,1
高雄市,阿蓮區,0226,555,188,743,31,774,1561,49.58%,35.55%,1
高雄市,阿蓮區,0227,571,226,797,103,900,1533,58.71%,37.25%,1
高雄市,阿蓮區,0228,377,134,511,40,551,1116,49.37%,33.78%,1
高雄市,阿蓮區,0229,389,123,512,41,553,1054,52.47%,36.91%,1
高雄市,阿蓮區,0230,476,146,622,60,682,1260,54.13%,37.78%,1
高雄市,阿蓮區,0231,557,156,713,79,792,1504,52.66%,37.03%,1
高雄市,阿蓮區,0232,292,87,379,19,398,848,46.93%,34.43%,1
高雄市,阿蓮區,0233,329,73,402,20,422,823,51.28%,39.98%,1
高雄市,阿蓮區,0234,422,107,529,28,557,1021,54.55%,41.33%,1
高雄市,阿蓮區,0235,600,205,805,33,838,1715,48.86%,34.99%,1
高雄市,阿蓮區,0236,472,156,628,54,682,1300,52.46%,36.31%,1
高雄市,路竹區,0175,373,118,491,29,520,1026,50.68%,36.35%,1
高雄市,路竹區,0176,418,130,548,77,625,1069,58.47%,39.1%,1
高雄市,路竹區,0177,455,164,619,70,689,1127,61.14%,40.37%,1
高雄市,路竹區,0178,454,129,583,81,664,1179,56.32%,38.51%,1
高雄市,路竹區,0179,452,145,597,105,702,1237,56.75%,36.54%,1
高雄市,路竹區,0180,451,138,589,67,656,1096,59.85%,41.15%,1
高雄市,路竹區,0181,557,162,719,82,801,1272,62.97%,43.79%,1
高雄市,路竹區,0182,500,121,621,70,691,1182,58.46%,42.3%,1
高雄市,路竹區,0183,454,149,603,48,651,1127,57.76%,40.28%,1
高雄市,路竹區,0184,415,95,510,61,571,956,59.73%,43.41%,1
高雄市,路竹區,0185,441,162,603,59,662,1132,58.48%,38.96%,1
高雄市,路竹區,0186,420,144,564,91,655,1025,63.9%,40.98%,1
高雄市,路竹區,0187,362,129,491,31,522,1007,51.84%,35.95%,1
高雄市,路竹區,0188,485,139,624,74,698,1301,53.65%,37.28%,1
高雄市,路竹區,0189,354,111,465,42,507,885,57.29%,40%,1
高雄市,路竹區,0190,257,104,361,31,392,837,46.83%,30.7%,1
高雄市,路竹區,0191,368,131,499,65,564,930,60.65%,39.57%,1
高雄市,路竹區,0192,249,93,342,62,404,781,51.73%,31.88%,1
高雄市,路竹區,0193,387,156,543,66,609,1023,59.53%,37.83%,1
高雄市,路竹區,0194,758,194,952,85,1037,1763,58.82%,42.99%,1
高雄市,路竹區,0195,618,218,836,69,905,1637,55.28%,37.75%,1
高雄市,路竹區,0196,407,126,533,52,585,1070,54.67%,38.04%,1
高雄市,路竹區,0197,493,133,626,82,708,1177,60.15%,41.89%,1
高雄市,路竹區,0198,413,128,541,51,592,1007,58.79%,41.01%,1
高雄市,路竹區,0199,415,134,549,38,587,1026,57.21%,40.45%,1
高雄市,路竹區,0200,420,124,544,49,593,1017,58.31%,41.3%,1
高雄市,路竹區,0201,528,149,677,55,732,1264,57.91%,41.77%,1
高雄市,路竹區,0202,464,137,601,58,659,1089,60.51%,42.61%,1
高雄市,路竹區,0203,338,116,454,39,493,851,57.93%,39.72%,1
高雄市,路竹區,0204,422,122,544,79,623,1011,61.62%,41.74%,1
高雄市,路竹區,0205,421,139,560,44,604,937,64.46%,44.93%,1
高雄市,路竹區,0206,262,99,361,16,377,820,45.98%,31.95%,1
高雄市,路竹區,0207,400,149,549,34,583,910,64.07%,43.96%,1
高雄市,路竹區,0208,329,107,436,57,493,867,56.86%,37.95%,1
高雄市,路竹區,0209,374,120,494,35,529,937,56.46%,39.91%,1
高雄市,路竹區,0210,375,114,489,21,510,900,56.67%,41.67%,1
高雄市,路竹區,0211,391,105,496,56,552,900,61.33%,43.44%,1
高雄市,路竹區,0212,399,105,504,42,546,918,59.48%,43.46%,1
高雄市,路竹區,0213,400,121,521,37,558,870,64.14%,45.98%,1
高雄市,路竹區,0214,511,165,676,45,721,1150,62.7%,44.43%,1
高雄市,路竹區,0215,749,184,933,52,985,1537,64.09%,48.73%,1
高雄市,湖內區,0151,373,137,510,41,551,1112,49.55%,33.54%,1
高雄市,湖內區,0152,355,128,483,94,577,1017,56.74%,34.91%,1
高雄市,湖內區,0153,266,99,365,30,395,796,49.62%,33.42%,1
高雄市,湖內區,0154,138,469,607,37,644,1079,59.68%,12.79%,1
高雄市,湖內區,0155,408,149,557,37,594,1115,53.27%,36.59%,1
高雄市,湖內區,0156,484,154,638,42,680,1311,51.87%,36.92%,1
高雄市,湖內區,0157,512,121,633,43,676,1319,51.25%,38.82%,1
高雄市,湖內區,0158,559,154,713,71,784,1244,63.02%,44.94%,1
高雄市,湖內區,0159,573,138,711,54,765,1227,62.35%,46.7%,1
高雄市,湖內區,0160,517,122,639,76,715,1163,61.48%,44.45%,1
高雄市,湖內區,0161,416,133,549,40,589,981,60.04%,42.41%,1
高雄市,湖內區,0162,288,88,376,20,396,780,50.77%,36.92%,1
高雄市,湖內區,0163,318,105,423,51,474,832,56.97%,38.22%,1
高雄市,湖內區,0164,462,133,595,43,638,1017,62.73%,45.43%,1
高雄市,湖內區,0165,452,117,569,21,590,1051,56.14%,43.01%,1
高雄市,湖內區,0166,337,111,448,37,485,941,51.54%,35.81%,1
高雄市,湖內區,0167,326,95,421,55,476,863,55.16%,37.78%,1
高雄市,湖內區,0168,428,147,575,55,630,1160,54.31%,36.9%,1
高雄市,湖內區,0169,323,105,428,27,455,1090,41.74%,29.63%,1
高雄市,湖內區,0170,436,148,584,60,644,1122,57.4%,38.86%,1
高雄市,湖內區,0171,347,117,464,37,501,1123,44.61%,30.9%,1
高雄市,湖內區,0172,230,97,327,30,357,684,52.19%,33.63%,1
高雄市,湖內區,0173,430,146,576,25,601,1249,48.12%,34.43%,1
高雄市,湖內區,0174,519,143,662,53,715,1453,49.21%,35.72%,1
高雄市,茄萣區,0130,302,110,412,16,428,976,43.85%,30.94%,1
高雄市,茄萣區,0131,287,133,420,64,484,887,54.57%,32.36%,1
高雄市,茄萣區,0132,639,168,807,43,850,1710,49.71%,37.37%,1
高雄市,茄萣區,0133,392,118,510,51,561,1280,43.83%,30.63%,1
高雄市,茄萣區,0134,495,183,678,38,716,1314,54.49%,37.67%,1
高雄市,茄萣區,0135,479,164,643,33,676,1157,58.43%,41.4%,1
高雄市,茄萣區,0136,652,208,860,124,984,1785,55.13%,36.53%,1
高雄市,茄萣區,0137,274,119,393,93,486,838,58%,32.7%,1
高雄市,茄萣區,0138,527,169,696,96,792,1249,63.41%,42.19%,1
高雄市,茄萣區,0139,380,124,504,103,607,1116,54.39%,34.05%,1
高雄市,茄萣區,0140,302,113,415,56,471,978,48.16%,30.88%,1
高雄市,茄萣區,0141,323,120,443,51,494,1125,43.91%,28.71%,1
高雄市,茄萣區,0142,360,172,532,75,607,1139,53.29%,31.61%,1
高雄市,茄萣區,0143,496,143,639,119,758,1363,55.61%,36.39%,1
高雄市,茄萣區,0144,557,197,754,171,925,1598,57.88%,34.86%,1
高雄市,茄萣區,0145,382,146,528,66,594,1111,53.47%,34.38%,1
高雄市,茄萣區,0146,273,93,366,50,416,925,44.97%,29.51%,1
高雄市,茄萣區,0147,418,128,546,68,614,1148,53.48%,36.41%,1
高雄市,茄萣區,0148,469,150,619,40,659,1353,48.71%,34.66%,1
高雄市,茄萣區,0149,491,160,651,69,720,1331,54.09%,36.89%,1
高雄市,茄萣區,0150,595,214,809,76,885,1829,48.39%,32.53%,1
高雄市,永安區,0249,350,101,451,47,498,756,65.87%,46.3%,1
高雄市,永安區,0250,305,134,439,73,512,818,62.59%,37.29%,1
高雄市,永安區,0251,432,116,548,47,595,866,68.71%,49.88%,1
高雄市,永安區,0252,401,148,549,63,612,951,64.35%,42.17%,1
高雄市,永安區,0253,422,131,553,69,622,992,62.7%,42.54%,1
高雄市,永安區,0254,196,89,285,24,309,682,45.31%,28.74%,1
高雄市,永安區,0255,268,87,355,25,380,665,57.14%,40.3%,1
高雄市,永安區,0256,145,43,188,16,204,371,54.99%,39.08%,1
高雄市,永安區,0257,461,181,642,87,729,1114,65.44%,41.38%,1
高雄市,永安區,0258,634,200,834,42,876,1418,61.78%,44.71%,1
高雄市,永安區,0259,680,191,871,86,957,1477,64.79%,46.04%,1
高雄市,永安區,0260,852,233,1085,103,1188,1891,62.82%,45.06%,1
高雄市,彌陀區,0358,494,185,679,70,749,1246,60.11%,39.65%,1
高雄市,彌陀區,0359,365,125,490,58,548,885,61.92%,41.24%,1
高雄市,彌陀區,0360,425,146,571,76,647,955,67.75%,44.5%,1
高雄市,彌陀區,0361,188,79,267,48,315,534,58.99%,35.21%,1
高雄市,彌陀區,0362,317,98,415,30,445,738,60.3%,42.95%,1
高雄市,彌陀區,0363,413,111,524,51,575,855,67.25%,48.3%,1
高雄市,彌陀區,0364,30,468,498,57,555,877,63.28%,3.42%,1
高雄市,彌陀區,0365,324,118,442,61,503,781,64.4%,41.49%,1
高雄市,彌陀區,0366,317,112,429,36,465,808,57.55%,39.23%,1
高雄市,彌陀區,0367,328,92,420,34,454,904,50.22%,36.28%,1
高雄市,彌陀區,0368,325,112,437,62,499,825,60.48%,39.39%,1
高雄市,彌陀區,0369,325,113,438,81,519,941,55.15%,34.54%,1
高雄市,彌陀區,0370,393,137,530,40,570,1013,56.27%,38.8%,1
高雄市,彌陀區,0371,425,145,570,74,644,1024,62.89%,41.5%,1
高雄市,彌陀區,0372,320,100,420,26,446,861,51.8%,37.17%,1
高雄市,彌陀區,0373,490,156,646,79,725,1163,62.34%,42.13%,1
高雄市,彌陀區,0374,526,159,685,104,789,1216,64.88%,43.26%,1
高雄市,彌陀區,0375,396,131,527,95,622,861,72.24%,45.99%,1
高雄市,梓官區,0376,440,158,598,64,662,1061,62.39%,41.47%,1
高雄市,梓官區,0377,411,139,550,78,628,1063,59.08%,38.66%,1
高雄市,梓官區,0378,367,140,507,40,547,969,56.45%,37.87%,1
高雄市,梓官區,0379,376,134,510,34,544,1078,50.46%,34.88%,1
高雄市,梓官區,0380,328,135,463,57,520,838,62.05%,39.14%,1
高雄市,梓官區,0381,257,91,348,32,380,611,62.19%,42.06%,1
高雄市,梓官區,0382,300,102,402,37,439,782,56.14%,38.36%,1
高雄市,梓官區,0383,663,208,871,84,955,1451,65.82%,45.69%,1
高雄市,梓官區,0384,433,141,574,33,607,1144,53.06%,37.85%,1
高雄市,梓官區,0385,347,105,452,22,474,975,48.62%,35.59%,1
高雄市,梓官區,0386,527,157,684,51,735,1317,55.81%,40.02%,1
高雄市,梓官區,0387,494,170,664,89,753,1218,61.82%,40.56%,1
高雄市,梓官區,0388,446,123,569,49,618,1073,57.6%,41.57%,1
高雄市,梓官區,0389,410,99,509,43,552,1112,49.64%,36.87%,1
高雄市,梓官區,0390,259,97,356,45,401,715,56.08%,36.22%,1
高雄市,梓官區,0391,488,145,633,62,695,1311,53.01%,37.22%,1
高雄市,梓官區,0392,339,131,470,41,511,939,54.42%,36.1%,1
高雄市,梓官區,0393,368,108,476,37,513,824,62.26%,44.66%,1
高雄市,梓官區,0394,430,160,590,104,694,1052,65.97%,40.87%,1
高雄市,梓官區,0395,400,135,535,110,645,1020,63.24%,39.22%,1
高雄市,梓官區,0396,423,172,595,51,646,1260,51.27%,33.57%,1
高雄市,梓官區,0397,608,184,792,58,850,1595,53.29%,38.12%,1
高雄市,梓官區,0398,356,97,453,45,498,829,60.07%,42.94%,1
高雄市,梓官區,0399,593,161,754,37,791,1532,51.63%,38.71%,1
高雄市,梓官區,0400,507,180,687,76,763,1195,63.85%,42.43%,1
高雄市,梓官區,0401,471,150,621,80,701,1143,61.33%,41.21%,1
高雄市,梓官區,0402,517,143,660,77,737,1186,62.14%,43.59%,1
高雄市,梓官區,0403,621,149,770,46,816,1732,47.11%,35.85%,1
高雄市,旗山區,0060,459,116,575,55,630,1060,59.43%,43.3%,1
高雄市,旗山區,0061,433,116,549,41,590,1125,52.44%,38.49%,1
高雄市,旗山區,0062,485,131,616,30,646,1100,58.73%,44.09%,1
高雄市,旗山區,0063,535,152,687,26,713,1238,57.59%,43.21%,1
高雄市,旗山區,0064,404,99,503,19,522,933,55.95%,43.3%,1
高雄市,旗山區,0065,251,72,323,21,344,727,47.32%,34.53%,1
高雄市,旗山區,0066,406,131,537,59,596,1071,55.65%,37.91%,1
高雄市,旗山區,0067,261,92,353,29,382,744,51.34%,35.08%,1
高雄市,旗山區,0068,354,118,472,41,513,1100,46.64%,32.18%,1
高雄市,旗山區,0069,140,38,178,15,193,369,52.3%,37.94%,1
高雄市,旗山區,0070,255,104,359,14,373,888,42%,28.72%,1
高雄市,旗山區,0071,141,54,195,10,205,510,40.2%,27.65%,1
高雄市,旗山區,0072,399,160,559,88,647,1042,62.09%,38.29%,1
高雄市,旗山區,0073,282,99,381,50,431,791,54.49%,35.65%,1
高雄市,旗山區,0074,364,124,488,78,566,939,60.28%,38.76%,1
高雄市,旗山區,0075,419,133,552,40,592,1218,48.6%,34.4%,1
高雄市,旗山區,0076,54,22,76,20,96,178,53.93%,30.34%,1
高雄市,旗山區,0077,402,118,520,66,586,946,61.95%,42.49%,1
高雄市,旗山區,0078,361,138,499,40,539,1025,52.59%,35.22%,1
高雄市,旗山區,0079,431,115,546,82,628,1040,60.38%,41.44%,1
高雄市,旗山區,0080,392,133,525,49,574,900,63.78%,43.56%,1
高雄市,旗山區,0081,233,64,297,33,330,663,49.77%,35.14%,1
高雄市,旗山區,0082,370,98,468,62,530,954,55.56%,38.78%,1
高雄市,旗山區,0083,401,111,512,36,548,1060,51.7%,37.83%,1
高雄市,旗山區,0084,456,146,602,60,662,1110,59.64%,41.08%,1
高雄市,旗山區,0085,436,137,573,56,629,1062,59.23%,41.05%,1
高雄市,旗山區,0086,461,121,582,37,619,1151,53.78%,40.05%,1
高雄市,旗山區,0087,108,31,139,25,164,266,61.65%,40.6%,1
高雄市,旗山區,0088,272,74,346,40,386,633,60.98%,42.97%,1
高雄市,旗山區,0089,436,155,591,33,624,1307,47.74%,33.36%,1
高雄市,旗山區,0090,251,113,364,61,425,754,56.37%,33.29%,1
高雄市,旗山區,0091,456,183,639,100,739,1296,57.02%,35.19%,1
高雄市,旗山區,0092,252,91,343,23,366,839,43.62%,30.04%,1
高雄市,旗山區,0093,541,155,696,53,749,1329,56.36%,40.71%,1
高雄市,旗山區,0094,245,92,337,33,370,628,58.92%,39.01%,1
高雄市,美濃區,0095,460,141,601,88,689,1175,58.64%,39.15%,1
高雄市,美濃區,0096,515,146,661,29,690,1438,47.98%,35.81%,1
高雄市,美濃區,0097,362,91,453,44,497,989,50.25%,36.6%,1
高雄市,美濃區,0098,568,72,640,79,719,1427,50.39%,39.8%,1
高雄市,美濃區,0099,513,160,673,63,736,1309,56.23%,39.19%,1
高雄市,美濃區,0100,520,155,675,89,764,1263,60.49%,41.17%,1
高雄市,美濃區,0101,418,120,538,60,598,997,59.98%,41.93%,1
高雄市,美濃區,0102,422,137,559,56,615,1064,57.8%,39.66%,1
高雄市,美濃區,0103,583,145,728,91,819,1498,54.67%,38.92%,1
高雄市,美濃區,0104,451,130,581,75,656,1119,58.62%,40.3%,1
高雄市,美濃區,0105,427,111,538,62,600,1031,58.2%,41.42%,1
高雄市,美濃區,0106,511,157,668,94,762,1437,53.03%,35.56%,1
高雄市,美濃區,0107,419,129,548,59,607,1071,56.68%,39.12%,1
高雄市,美濃區,0108,311,27,338,39,377,687,54.88%,45.27%,1
高雄市,美濃區,0109,222,67,289,24,313,775,40.39%,28.65%,1
高雄市,美濃區,0110,467,150,617,77,694,1353,51.29%,34.52%,1
高雄市,美濃區,0111,413,128,541,43,584,1191,49.03%,34.68%,1
高雄市,美濃區,0112,315,80,395,34,429,906,47.35%,34.77%,1
高雄市,美濃區,0113,519,124,643,48,691,1178,58.66%,44.06%,1
高雄市,美濃區,0114,424,116,540,44,584,1252,46.65%,33.87%,1
高雄市,美濃區,0115,622,177,799,61,860,1549,55.52%,40.15%,1
高雄市,美濃區,0116,386,107,493,59,552,1088,50.74%,35.48%,1
高雄市,美濃區,0117,445,136,581,54,635,1116,56.9%,39.87%,1
高雄市,美濃區,0118,361,126,487,31,518,977,53.02%,36.95%,1
高雄市,美濃區,0119,321,120,441,70,511,816,62.62%,39.34%,1
高雄市,美濃區,0120,318,73,391,32,423,955,44.29%,33.3%,1
高雄市,美濃區,0121,350,123,473,76,549,943,58.22%,37.12%,1
高雄市,美濃區,0122,504,127,631,58,689,1371,50.26%,36.76%,1
高雄市,美濃區,0123,329,121,450,64,514,919,55.93%,35.8%,1
高雄市,美濃區,0124,380,124,504,58,562,915,61.42%,41.53%,1
高雄市,美濃區,0125,275,118,393,64,457,828,55.19%,33.21%,1
高雄市,美濃區,0126,187,76,263,54,317,674,47.03%,27.74%,1
高雄市,六龜區,0020,245,101,346,36,382,760,50.26%,32.24%,1
高雄市,六龜區,0021,205,67,272,35,307,666,46.1%,30.78%,1
高雄市,六龜區,0022,268,82,350,50,400,704,56.82%,38.07%,1
高雄市,六龜區,0023,325,131,456,56,512,1003,51.05%,32.4%,1
高雄市,六龜區,0024,414,129,543,110,653,1382,47.25%,29.96%,1
高雄市,六龜區,0025,240,96,336,74,410,986,41.58%,24.34%,1
高雄市,六龜區,0026,353,132,485,38,523,1046,50%,33.75%,1
高雄市,六龜區,0027,222,98,320,62,382,812,47.04%,27.34%,1
高雄市,六龜區,0028,439,143,582,81,663,1431,46.33%,30.68%,1
高雄市,六龜區,0029,320,80,400,79,479,912,52.52%,35.09%,1
高雄市,六龜區,0030,381,136,517,49,566,1472,38.45%,25.88%,1
高雄市,六龜區,0031,84,31,115,28,143,327,43.73%,25.69%,1
高雄市,甲仙區,0013,124,25,149,11,160,472,33.9%,26.27%,1
高雄市,甲仙區,0014,386,106,492,62,554,882,62.81%,43.76%,1
高雄市,甲仙區,0015,239,72,311,43,354,668,52.99%,35.78%,1
高雄市,甲仙區,0016,505,156,661,134,795,1581,50.28%,31.94%,1
高雄市,甲仙區,0017,150,53,203,12,215,673,31.95%,22.29%,1
高雄市,甲仙區,0018,188,54,242,36,278,607,45.8%,30.97%,1
高雄市,甲仙區,0019,175,52,227,16,243,534,45.51%,32.77%,1
高雄市,杉林區,0032,190,73,263,52,315,640,49.22%,29.69%,1
高雄市,杉林區,0033,197,64,261,34,295,696,42.39%,28.3%,1
高雄市,杉林區,0034,275,128,403,45,448,1284,34.89%,21.42%,1
高雄市,杉林區,0035,269,120,389,49,438,1027,42.65%,26.19%,1
高雄市,杉林區,0036,154,48,202,26,228,482,47.3%,31.95%,1
高雄市,杉林區,0037,573,208,781,119,900,1627,55.32%,35.22%,1
高雄市,杉林區,0038,509,163,672,40,712,1630,43.68%,31.23%,1
高雄市,杉林區,0039,231,93,324,25,349,973,35.87%,23.74%,1
高雄市,杉林區,0040,260,91,351,34,385,987,39.01%,26.34%,1
高雄市,杉林區,0041,430,149,579,83,662,1261,52.5%,34.1%,1
高雄市,內門區,0042,280,94,374,64,438,969,45.2%,28.9%,1
高雄市,內門區,0043,165,62,227,22,249,652,38.19%,25.31%,1
高雄市,內門區,0044,302,122,424,88,512,961,53.28%,31.43%,1
高雄市,內門區,0045,133,28,161,7,168,426,39.44%,31.22%,1
高雄市,內門區,0046,123,40,163,19,182,398,45.73%,30.9%,1
高雄市,內門區,0047,162,38,200,19,219,508,43.11%,31.89%,1
高雄市,內門區,0048,367,123,490,81,571,980,58.27%,37.45%,1
高雄市,內門區,0049,368,121,489,46,535,1225,43.67%,30.04%,1
高雄市,內門區,0050,599,191,790,156,946,1722,54.94%,34.79%,1
高雄市,內門區,0051,172,74,246,29,275,560,49.11%,30.71%,1
高雄市,內門區,0052,210,78,288,22,310,801,38.7%,26.22%,1
高雄市,內門區,0053,138,58,196,19,215,423,50.83%,32.62%,1
高雄市,內門區,0054,153,49,202,33,235,497,47.28%,30.78%,1
高雄市,內門區,0055,200,82,282,34,316,677,46.68%,29.54%,1
高雄市,內門區,0056,137,43,180,12,192,593,32.38%,23.1%,1
高雄市,內門區,0057,144,52,196,54,250,597,41.88%,24.12%,1
高雄市,內門區,0058,101,31,132,9,141,343,41.11%,29.45%,1
高雄市,內門區,0059,244,73,317,48,365,670,54.48%,36.42%,1
高雄市,茂林區,0127,242,77,319,37,356,507,70.22%,47.73%,1
高雄市,茂林區,0128,190,49,239,23,262,382,68.59%,49.74%,1
高雄市,茂林區,0129,326,87,413,30,443,726,61.02%,44.9%,1
高雄市,桃源區,0001,56,19,75,1,76,264,28.79%,21.21%,1
高雄市,桃源區,0002,112,39,151,20,171,233,73.39%,48.07%,1
高雄市,桃源區,0003,138,28,166,8,174,279,62.37%,49.46%,1
高雄市,桃源區,0004,65,39,104,4,108,223,48.43%,29.15%,1
高雄市,桃源區,0005,221,79,300,11,311,783,39.72%,28.22%,1
高雄市,桃源區,0006,185,48,233,7,240,632,37.97%,29.27%,1
高雄市,桃源區,0007,291,93,384,31,415,612,67.81%,47.55%,1
高雄市,桃源區,0008,171,50,221,27,248,472,52.54%,36.23%,1
高雄市,那瑪夏區,0009,222,75,297,29,326,741,43.99%,29.96%,1
高雄市,那瑪夏區,0010,250,99,349,68,417,585,71.28%,42.74%,1
高雄市,那瑪夏區,0011,316,88,404,62,466,609,76.52%,51.89%,1
高雄市,那瑪夏區,0012,129,41,170,6,176,489,35.99%,26.38%,1
新竹縣,竹北市,0001,671,150,821,30,851,1319,64.52%,50.87%,1
新竹縣,竹北市,0002,634,143,777,25,802,1321,60.71%,47.99%,1
新竹縣,竹北市,0003,607,151,758,40,798,1272,62.74%,47.72%,1
新竹縣,竹北市,0004,660,150,810,30,840,1467,57.26%,44.99%,1
新竹縣,竹北市,0005,528,151,679,14,693,1226,56.53%,43.07%,1
新竹縣,竹北市,0006,654,133,787,13,800,1412,56.66%,46.32%,1
新竹縣,竹北市,0007,719,150,869,6,875,1400,62.5%,51.36%,1
新竹縣,竹北市,0008,697,159,856,22,878,1415,62.05%,49.26%,1
新竹縣,竹北市,0009,618,154,772,20,792,1361,58.19%,45.41%,1
新竹縣,竹北市,0010,643,171,814,21,835,1515,55.12%,42.44%,1
新竹縣,竹北市,0011,676,188,864,23,887,1495,59.33%,45.22%,1
新竹縣,竹北市,0012,639,170,809,28,837,1417,59.07%,45.1%,1
新竹縣,竹北市,0013,654,201,855,28,883,1548,57.04%,42.25%,1
新竹縣,竹北市,0014,584,175,759,23,782,1434,54.53%,40.73%,1
新竹縣,竹北市,0015,651,129,780,34,814,1385,58.77%,47%,1
新竹縣,竹北市,0016,636,122,758,34,792,1247,63.51%,51%,1
新竹縣,竹北市,0017,608,160,768,27,795,1373,57.9%,44.28%,1
新竹縣,竹北市,0018,667,165,832,27,859,1345,63.87%,49.59%,1
新竹縣,竹北市,0019,527,106,633,36,669,1165,57.42%,45.24%,1
新竹縣,竹北市,0020,552,162,714,35,749,1164,64.35%,47.42%,1
新竹縣,竹北市,0021,560,163,723,31,754,1212,62.21%,46.2%,1
新竹縣,竹北市,0022,600,136,736,23,759,1507,50.36%,39.81%,1
新竹縣,竹北市,0023,639,128,767,43,810,1576,51.4%,40.55%,1
新竹縣,竹北市,0024,661,136,797,31,828,1464,56.56%,45.15%,1
新竹縣,竹北市,0025,640,153,793,23,816,1428,57.14%,44.82%,1
新竹縣,竹北市,0026,557,153,710,17,727,1442,50.42%,38.63%,1
新竹縣,竹北市,0027,640,147,787,54,841,1415,59.43%,45.23%,1
新竹縣,竹北市,0028,655,162,817,29,846,1666,50.78%,39.32%,1
新竹縣,竹北市,0029,700,207,907,32,939,1751,53.63%,39.98%,1
新竹縣,竹北市,0030,549,155,704,29,733,1196,61.29%,45.9%,1
新竹縣,竹北市,0031,588,134,722,19,741,1235,60%,47.61%,1
新竹縣,竹北市,0032,552,115,667,17,684,1204,56.81%,45.85%,1
新竹縣,竹北市,0033,628,148,776,18,794,1308,60.7%,48.01%,1
新竹縣,竹北市,0034,536,148,684,16,700,1233,56.77%,43.47%,1
新竹縣,竹北市,0035,515,133,648,25,673,1129,59.61%,45.62%,1
新竹縣,竹北市,0036,527,110,637,22,659,1069,61.65%,49.3%,1
新竹縣,竹北市,0037,554,117,671,41,712,1114,63.91%,49.73%,1
新竹縣,竹北市,0038,530,119,649,20,669,1103,60.65%,48.05%,1
新竹縣,竹北市,0039,512,128,640,30,670,1029,65.11%,49.76%,1
新竹縣,竹北市,0040,575,132,707,24,731,1133,64.52%,50.75%,1
新竹縣,竹北市,0041,591,142,733,23,756,1301,58.11%,45.43%,1
新竹縣,竹北市,0042,813,189,1002,47,1049,1798,58.34%,45.22%,1
新竹縣,竹北市,0043,660,163,823,26,849,1427,59.5%,46.25%,1
新竹縣,竹北市,0044,733,135,868,34,902,1462,61.7%,50.14%,1
新竹縣,竹北市,0045,678,137,815,35,850,1342,63.34%,50.52%,1
新竹縣,竹北市,0046,715,146,861,28,889,1480,60.07%,48.31%,1
新竹縣,竹北市,0047,734,162,896,31,927,1645,56.35%,44.62%,1
新竹縣,竹北市,0048,652,131,783,20,803,1256,63.93%,51.91%,1
新竹縣,竹北市,0049,554,137,691,34,725,1181,61.39%,46.91%,1
新竹縣,竹北市,0050,675,150,825,33,858,1329,64.56%,50.79%,1
新竹縣,竹北市,0051,617,136,753,25,778,1228,63.36%,50.24%,1
新竹縣,竹北市,0052,659,177,836,40,876,1552,56.44%,42.46%,1
新竹縣,竹北市,0053,685,176,861,30,891,1480,60.2%,46.28%,1
新竹縣,竹北市,0054,606,165,771,31,802,1487,53.93%,40.75%,1
新竹縣,竹北市,0055,595,169,764,40,804,1470,54.69%,40.48%,1
新竹縣,竹北市,0056,623,130,753,32,785,1477,53.15%,42.18%,1
新竹縣,竹北市,0057,716,215,931,52,983,1611,61.02%,44.44%,1
新竹縣,竹北市,0058,691,145,836,68,904,1555,58.14%,44.44%,1
新竹縣,竹北市,0059,619,138,757,42,799,1468,54.43%,42.17%,1
新竹縣,竹北市,0060,667,177,844,50,894,1509,59.24%,44.2%,1
新竹縣,竹北市,0061,688,156,844,45,889,1602,55.49%,42.95%,1
新竹縣,竹北市,0062,642,169,811,53,864,1448,59.67%,44.34%,1
新竹縣,竹北市,0063,599,137,736,59,795,1318,60.32%,45.45%,1
新竹縣,竹北市,0064,764,181,945,49,994,1634,60.83%,46.76%,1
新竹縣,竹北市,0065,566,145,711,58,769,1345,57.17%,42.08%,1
新竹縣,竹北市,0066,485,116,601,27,628,958,65.55%,50.63%,1
新竹縣,竹北市,0067,555,106,661,40,701,1112,63.04%,49.91%,1
新竹縣,竹北市,0068,475,128,603,66,669,1134,58.99%,41.89%,1
新竹縣,竹北市,0069,674,154,828,26,854,1483,57.59%,45.45%,1
新竹縣,竹北市,0070,568,145,713,35,748,1332,56.16%,42.64%,1
新竹縣,竹北市,0071,621,115,736,26,762,1482,51.42%,41.9%,1
新竹縣,竹北市,0072,469,126,595,24,619,1449,42.72%,32.37%,1
新竹縣,竹北市,0073,582,112,694,24,718,1319,54.44%,44.12%,1
新竹縣,竹北市,0074,550,137,687,40,727,1332,54.58%,41.29%,1
新竹縣,竹北市,0075,547,169,716,34,750,1412,53.12%,38.74%,1
新竹縣,竹北市,0076,689,154,843,45,888,1640,54.15%,42.01%,1
新竹縣,竹北市,0077,556,165,721,41,762,1323,57.6%,42.03%,1
新竹縣,竹北市,0078,627,169,796,54,850,1428,59.52%,43.91%,1
新竹縣,竹北市,0079,694,143,837,58,895,1533,58.38%,45.27%,1
新竹縣,竹北市,0080,544,129,673,27,700,1346,52.01%,40.42%,1
新竹縣,竹北市,0081,509,113,622,47,669,1219,54.88%,41.76%,1
新竹縣,竹北市,0082,674,163,837,56,893,1466,60.91%,45.98%,1
新竹縣,竹北市,0083,468,128,596,36,632,1147,55.1%,40.8%,1
新竹縣,竹北市,0084,597,111,708,43,751,1529,49.12%,39.05%,1
新竹縣,竹北市,0085,679,147,826,51,877,1522,57.62%,44.61%,1
新竹縣,竹北市,0086,635,142,777,52,829,1383,59.94%,45.91%,1
新竹縣,竹北市,0087,548,305,853,42,895,1569,57.04%,34.93%,1
新竹縣,竹北市,0088,632,131,763,21,784,1506,52.06%,41.97%,1
新竹縣,竹北市,0089,386,79,465,41,506,877,57.7%,44.01%,1
新竹縣,竹北市,0090,446,133,579,47,626,1074,58.29%,41.53%,1
新竹縣,竹北市,0091,531,134,665,37,702,1089,64.46%,48.76%,1
新竹縣,竹北市,0092,588,152,740,53,793,1336,59.36%,44.01%,1
新竹縣,竹北市,0093,431,115,546,57,603,1058,56.99%,40.74%,1
新竹縣,竹北市,0094,441,125,566,59,625,937,66.7%,47.07%,1
新竹縣,竹北市,0095,505,146,651,41,692,1206,57.38%,41.87%,1
新竹縣,竹北市,0096,481,148,629,52,681,1205,56.51%,39.92%,1
新竹縣,竹北市,0097,749,205,954,74,1028,1718,59.84%,43.6%,1
新竹縣,竹北市,0098,358,115,473,51,524,917,57.14%,39.04%,1
新竹縣,竹北市,0099,293,81,374,30,404,668,60.48%,43.86%,1
新竹縣,竹北市,0100,334,87,421,34,455,824,55.22%,40.53%,1
新竹縣,竹北市,0101,312,83,395,69,464,782,59.34%,39.9%,1
新竹縣,竹北市,0102,401,121,522,76,598,977,61.21%,41.04%,1
新竹縣,竹北市,0103,328,95,423,22,445,937,47.49%,35.01%,1
新竹縣,竹東鎮,0104,117,25,142,10,152,309,49.19%,37.86%,1
新竹縣,竹東鎮,0105,140,46,186,29,215,416,51.68%,33.65%,1
新竹縣,竹東鎮,0106,142,40,182,10,192,386,49.74%,36.79%,1
新竹縣,竹東鎮,0107,371,80,451,22,473,950,49.79%,39.05%,1
新竹縣,竹東鎮,0108,536,106,642,16,658,1275,51.61%,42.04%,1
新竹縣,竹東鎮,0109,480,133,613,44,657,1213,54.16%,39.57%,1
新竹縣,竹東鎮,0110,672,153,825,38,863,1548,55.75%,43.41%,1
新竹縣,竹東鎮,0111,478,113,591,33,624,1246,50.08%,38.36%,1
新竹縣,竹東鎮,0112,429,104,533,42,575,1252,45.93%,34.27%,1
新竹縣,竹東鎮,0113,555,116,671,47,718,1359,52.83%,40.84%,1
新竹縣,竹東鎮,0114,490,136,626,43,669,1255,53.31%,39.04%,1
新竹縣,竹東鎮,0115,566,146,712,38,750,1304,57.52%,43.4%,1
新竹縣,竹東鎮,0116,559,121,680,44,724,1292,56.04%,43.27%,1
新竹縣,竹東鎮,0117,455,85,540,14,554,1111,49.86%,40.95%,1
新竹縣,竹東鎮,0118,385,95,480,43,523,880,59.43%,43.75%,1
新竹縣,竹東鎮,0119,293,76,369,24,393,670,58.66%,43.73%,1
新竹縣,竹東鎮,0120,557,123,680,45,725,1244,58.28%,44.77%,1
新竹縣,竹東鎮,0121,436,118,554,54,608,1126,54%,38.72%,1
新竹縣,竹東鎮,0122,442,103,545,40,585,1073,54.52%,41.19%,1
新竹縣,竹東鎮,0123,520,131,651,45,696,1215,57.28%,42.8%,1
新竹縣,竹東鎮,0124,526,111,637,22,659,1155,57.06%,45.54%,1
新竹縣,竹東鎮,0125,338,103,441,43,484,852,56.81%,39.67%,1
新竹縣,竹東鎮,0126,365,132,497,29,526,875,60.11%,41.71%,1
新竹縣,竹東鎮,0127,504,118,622,32,654,1070,61.12%,47.1%,1
新竹縣,竹東鎮,0128,287,67,354,26,380,704,53.98%,40.77%,1
新竹縣,竹東鎮,0129,273,75,348,34,382,951,40.17%,28.71%,1
新竹縣,竹東鎮,0130,436,102,538,19,557,984,56.61%,44.31%,1
新竹縣,竹東鎮,0131,374,88,462,13,475,1113,42.68%,33.6%,1
新竹縣,竹東鎮,0132,255,81,336,20,356,595,59.83%,42.86%,1
新竹縣,竹東鎮,0133,320,94,414,52,466,762,61.15%,41.99%,1
新竹縣,竹東鎮,0134,311,89,400,21,421,763,55.18%,40.76%,1
新竹縣,竹東鎮,0135,320,83,403,16,419,813,51.54%,39.36%,1
新竹縣,竹東鎮,0136,465,125,590,29,619,1310,47.25%,35.5%,1
新竹縣,竹東鎮,0137,547,119,666,38,704,1434,49.09%,38.15%,1
新竹縣,竹東鎮,0138,486,119,605,29,634,1131,56.06%,42.97%,1
新竹縣,竹東鎮,0139,408,102,510,19,529,967,54.71%,42.19%,1
新竹縣,竹東鎮,0140,441,133,574,38,612,1196,51.17%,36.87%,1
新竹縣,竹東鎮,0141,495,124,619,36,655,1154,56.76%,42.89%,1
新竹縣,竹東鎮,0142,309,95,404,35,439,715,61.4%,43.22%,1
新竹縣,竹東鎮,0143,296,75,371,14,385,685,56.2%,43.21%,1
新竹縣,竹東鎮,0144,532,136,668,50,718,1352,53.11%,39.35%,1
新竹縣,竹東鎮,0145,611,139,750,56,806,1407,57.29%,43.43%,1
新竹縣,竹東鎮,0146,595,105,700,29,729,1362,53.52%,43.69%,1
新竹縣,竹東鎮,0147,593,126,719,32,751,1330,56.47%,44.59%,1
新竹縣,竹東鎮,0148,585,143,728,60,788,1441,54.68%,40.6%,1
新竹縣,竹東鎮,0149,503,103,606,22,628,1248,50.32%,40.3%,1
新竹縣,竹東鎮,0150,434,105,539,27,566,1263,44.81%,34.36%,1
新竹縣,竹東鎮,0151,450,113,563,27,590,1232,47.89%,36.53%,1
新竹縣,竹東鎮,0152,407,103,510,31,541,1143,47.33%,35.61%,1
新竹縣,竹東鎮,0153,652,148,800,29,829,1529,54.22%,42.64%,1
新竹縣,竹東鎮,0154,475,105,580,45,625,1140,54.82%,41.67%,1
新竹縣,竹東鎮,0155,255,91,346,18,364,570,63.86%,44.74%,1
新竹縣,竹東鎮,0156,515,114,629,25,654,1345,48.62%,38.29%,1
新竹縣,竹東鎮,0157,529,147,676,56,732,1381,53.01%,38.31%,1
新竹縣,竹東鎮,0158,568,141,709,55,764,1379,55.4%,41.19%,1
新竹縣,竹東鎮,0159,437,110,547,53,600,1033,58.08%,42.3%,1
新竹縣,竹東鎮,0160,462,85,547,35,582,1066,54.6%,43.34%,1
新竹縣,竹東鎮,0161,412,104,516,38,554,938,59.06%,43.92%,1
新竹縣,竹東鎮,0162,444,102,546,40,586,952,61.55%,46.64%,1
新竹縣,竹東鎮,0163,677,151,828,43,871,1468,59.33%,46.12%,1
新竹縣,竹東鎮,0164,744,198,942,34,976,1915,50.97%,38.85%,1
新竹縣,竹東鎮,0165,464,121,585,43,628,1220,51.48%,38.03%,1
新竹縣,竹東鎮,0166,419,92,511,20,531,1166,45.54%,35.93%,1
新竹縣,竹東鎮,0167,551,132,683,30,713,1492,47.79%,36.93%,1
新竹縣,竹東鎮,0168,473,140,613,38,651,1245,52.29%,37.99%,1
新竹縣,竹東鎮,0169,451,135,586,36,622,1083,57.43%,41.64%,1
新竹縣,竹東鎮,0170,445,132,577,29,606,1102,54.99%,40.38%,1
新竹縣,竹東鎮,0171,466,94,560,20,580,1068,54.31%,43.63%,1
新竹縣,竹東鎮,0172,452,149,601,25,626,1097,57.06%,41.2%,1
新竹縣,竹東鎮,0173,391,68,459,22,481,962,50%,40.64%,1
新竹縣,竹東鎮,0174,373,115,488,26,514,909,56.55%,41.03%,1
新竹縣,竹東鎮,0175,219,53,272,30,302,603,50.08%,36.32%,1
新竹縣,新埔鎮,0176,440,97,537,49,586,983,59.61%,44.76%,1
新竹縣,新埔鎮,0177,262,81,343,26,369,597,61.81%,43.89%,1
新竹縣,新埔鎮,0178,464,92,556,27,583,1070,54.49%,43.36%,1
新竹縣,新埔鎮,0179,406,83,489,38,527,935,56.36%,43.42%,1
新竹縣,新埔鎮,0180,316,89,405,27,432,753,57.37%,41.97%,1
新竹縣,新埔鎮,0181,427,99,526,26,552,838,65.87%,50.95%,1
新竹縣,新埔鎮,0182,395,86,481,37,518,924,56.06%,42.75%,1
新竹縣,新埔鎮,0183,353,66,419,28,447,905,49.39%,39.01%,1
新竹縣,新埔鎮,0184,407,93,500,38,538,948,56.75%,42.93%,1
新竹縣,新埔鎮,0185,440,102,542,52,594,1017,58.41%,43.26%,1
新竹縣,新埔鎮,0186,550,127,677,41,718,1176,61.05%,46.77%,1
新竹縣,新埔鎮,0187,499,143,642,56,698,1122,62.21%,44.47%,1
新竹縣,新埔鎮,0188,340,98,438,17,455,1022,44.52%,33.27%,1
新竹縣,新埔鎮,0189,521,140,661,49,710,1429,49.69%,36.46%,1
新竹縣,新埔鎮,0190,209,55,264,41,305,451,67.63%,46.34%,1
新竹縣,新埔鎮,0191,283,103,386,24,410,724,56.63%,39.09%,1
新竹縣,新埔鎮,0192,273,80,353,39,392,617,63.53%,44.25%,1
新竹縣,新埔鎮,0193,487,139,626,52,678,1144,59.27%,42.57%,1
新竹縣,新埔鎮,0194,482,134,616,40,656,1139,57.59%,42.32%,1
新竹縣,新埔鎮,0195,380,81,461,20,481,861,55.87%,44.13%,1
新竹縣,新埔鎮,0196,417,108,525,34,559,1093,51.14%,38.15%,1
新竹縣,新埔鎮,0197,366,102,468,40,508,978,51.94%,37.42%,1
新竹縣,新埔鎮,0198,366,103,469,38,507,1040,48.75%,35.19%,1
新竹縣,新埔鎮,0199,469,115,584,38,622,1160,53.62%,40.43%,1
新竹縣,新埔鎮,0200,430,120,550,25,575,950,60.53%,45.26%,1
新竹縣,新埔鎮,0201,372,93,465,32,497,882,56.35%,42.18%,1
新竹縣,新埔鎮,0202,549,136,685,54,739,1281,57.69%,42.86%,1
新竹縣,新埔鎮,0203,484,128,612,39,651,1212,53.71%,39.93%,1
新竹縣,新埔鎮,0204,376,70,446,38,484,1013,47.78%,37.12%,1
新竹縣,新埔鎮,0205,283,92,375,28,403,630,63.97%,44.92%,1
新竹縣,關西鎮,0206,222,56,278,29,307,480,63.96%,46.25%,1
新竹縣,關西鎮,0207,401,104,505,38,543,903,60.13%,44.41%,1
新竹縣,關西鎮,0208,433,123,556,38,594,1020,58.24%,42.45%,1
新竹縣,關西鎮,0209,268,84,352,25,377,705,53.48%,38.01%,1
新竹縣,關西鎮,0210,432,113,545,34,579,1056,54.83%,40.91%,1
新竹縣,關西鎮,0211,488,165,653,46,699,1275,54.82%,38.27%,1
新竹縣,關西鎮,0212,571,134,705,49,754,1287,58.59%,44.37%,1
新竹縣,關西鎮,0213,330,107,437,29,466,771,60.44%,42.8%,1
新竹縣,關西鎮,0214,411,115,526,43,569,1046,54.4%,39.29%,1
新竹縣,關西鎮,0215,427,126,553,49,602,1030,58.45%,41.46%,1
新竹縣,關西鎮,0216,530,115,645,40,685,1208,56.71%,43.87%,1
新竹縣,關西鎮,0217,417,85,502,26,528,1095,48.22%,38.08%,1
新竹縣,關西鎮,0218,505,145,650,61,711,1350,52.67%,37.41%,1
新竹縣,關西鎮,0219,401,108,509,26,535,846,63.24%,47.4%,1
新竹縣,關西鎮,0220,524,145,669,74,743,1362,54.55%,38.47%,1
新竹縣,關西鎮,0221,309,102,411,34,445,903,49.28%,34.22%,1
新竹縣,關西鎮,0222,185,59,244,21,265,551,48.09%,33.58%,1
新竹縣,關西鎮,0223,128,48,176,15,191,461,41.43%,27.77%,1
新竹縣,關西鎮,0224,232,53,285,34,319,572,55.77%,40.56%,1
新竹縣,關西鎮,0225,359,115,474,32,506,943,53.66%,38.07%,1
新竹縣,關西鎮,0226,305,121,426,42,468,808,57.92%,37.75%,1
新竹縣,關西鎮,0227,463,96,559,24,583,923,63.16%,50.16%,1
新竹縣,關西鎮,0228,406,93,499,36,535,903,59.25%,44.96%,1
新竹縣,關西鎮,0229,435,95,530,43,573,977,58.65%,44.52%,1
新竹縣,關西鎮,0230,357,107,464,40,504,824,61.17%,43.33%,1
新竹縣,關西鎮,0231,272,54,326,16,342,559,61.18%,48.66%,1
新竹縣,關西鎮,0232,424,80,504,30,534,854,62.53%,49.65%,1
新竹縣,湖口鄉,0233,496,58,554,50,604,1393,43.36%,35.61%,1
新竹縣,湖口鄉,0234,649,174,823,49,872,1505,57.94%,43.12%,1
新竹縣,湖口鄉,0235,545,167,712,44,756,1188,63.64%,45.88%,1
新竹縣,湖口鄉,0236,541,141,682,45,727,1267,57.38%,42.7%,1
新竹縣,湖口鄉,0237,741,162,903,31,934,1668,56%,44.42%,1
新竹縣,湖口鄉,0238,757,182,939,59,998,1719,58.06%,44.04%,1
新竹縣,湖口鄉,0239,535,139,674,45,719,1162,61.88%,46.04%,1
新竹縣,湖口鄉,0240,713,181,894,44,938,1833,51.17%,38.9%,1
新竹縣,湖口鄉,0241,595,171,766,52,818,1444,56.65%,41.2%,1
新竹縣,湖口鄉,0242,625,151,776,61,837,1347,62.14%,46.4%,1
新竹縣,湖口鄉,0243,559,127,686,17,703,1202,58.49%,46.51%,1
新竹縣,湖口鄉,0244,380,94,474,41,515,851,60.52%,44.65%,1
新竹縣,湖口鄉,0245,554,143,697,58,755,1272,59.36%,43.55%,1
新竹縣,湖口鄉,0246,548,135,683,40,723,1275,56.71%,42.98%,1
新竹縣,湖口鄉,0247,728,176,904,12,916,1560,58.72%,46.67%,1
新竹縣,湖口鄉,0248,518,139,657,77,734,1147,63.99%,45.16%,1
新竹縣,湖口鄉,0249,752,165,917,51,968,1729,55.99%,43.49%,1
新竹縣,湖口鄉,0250,554,160,714,39,753,1402,53.71%,39.51%,1
新竹縣,湖口鄉,0251,507,144,651,52,703,1183,59.43%,42.86%,1
新竹縣,湖口鄉,0252,578,152,730,50,780,1282,60.84%,45.09%,1
新竹縣,湖口鄉,0253,579,181,760,38,798,1335,59.78%,43.37%,1
新竹縣,湖口鄉,0254,719,165,884,43,927,1493,62.09%,48.16%,1
新竹縣,湖口鄉,0255,825,156,981,18,999,1877,53.22%,43.95%,1
新竹縣,湖口鄉,0256,511,114,625,43,668,1082,61.74%,47.23%,1
新竹縣,湖口鄉,0257,461,163,624,62,686,1115,61.52%,41.35%,1
新竹縣,湖口鄉,0258,437,131,568,32,600,1193,50.29%,36.63%,1
新竹縣,湖口鄉,0259,789,171,960,44,1004,1947,51.57%,40.52%,1
新竹縣,湖口鄉,0260,445,178,623,49,672,1125,59.73%,39.56%,1
新竹縣,湖口鄉,0261,469,101,570,41,611,1050,58.19%,44.67%,1
新竹縣,湖口鄉,0262,753,198,951,49,1000,1733,57.7%,43.45%,1
新竹縣,湖口鄉,0263,571,144,715,45,760,1284,59.19%,44.47%,1
新竹縣,湖口鄉,0264,489,112,601,32,633,1062,59.6%,46.05%,1
新竹縣,湖口鄉,0265,687,134,821,69,890,1547,57.53%,44.41%,1
新竹縣,湖口鄉,0266,561,136,697,41,738,1494,49.4%,37.55%,1
新竹縣,湖口鄉,0267,600,151,751,34,785,1634,48.04%,36.72%,1
新竹縣,湖口鄉,0268,545,110,655,13,668,1444,46.26%,37.74%,1
新竹縣,湖口鄉,0269,546,123,669,25,694,1324,52.42%,41.24%,1
新竹縣,湖口鄉,0270,459,106,565,36,601,1058,56.81%,43.38%,1
新竹縣,湖口鄉,0271,369,103,472,25,497,1220,40.74%,30.25%,1
新竹縣,湖口鄉,0272,552,160,712,36,748,1333,56.11%,41.41%,1
新竹縣,湖口鄉,0273,574,137,711,55,766,1461,52.43%,39.29%,1
新竹縣,湖口鄉,0274,568,145,713,32,745,1429,52.13%,39.75%,1
新竹縣,湖口鄉,0275,560,117,677,23,700,1506,46.48%,37.18%,1
新竹縣,湖口鄉,0276,511,111,622,44,666,1103,60.38%,46.33%,1
新竹縣,湖口鄉,0277,550,151,701,40,741,1495,49.57%,36.79%,1
新竹縣,湖口鄉,0278,328,78,406,28,434,752,57.71%,43.62%,1
新竹縣,湖口鄉,0279,433,95,528,18,546,986,55.38%,43.91%,1
新竹縣,新豐鄉,0280,403,117,520,57,577,1080,53.43%,37.31%,1
新竹縣,新豐鄉,0281,335,104,439,27,466,887,52.54%,37.77%,1
新竹縣,新豐鄉,0282,379,122,501,35,536,954,56.18%,39.73%,1
新竹縣,新豐鄉,0283,412,106,518,32,550,1003,54.84%,41.08%,1
新竹縣,新豐鄉,0284,448,117,565,39,604,1106,54.61%,40.51%,1
新竹縣,新豐鄉,0285,495,134,629,29,658,1123,58.59%,44.08%,1
新竹縣,新豐鄉,0286,370,115,485,43,528,891,59.26%,41.53%,1
新竹縣,新豐鄉,0287,323,85,408,32,440,874,50.34%,36.96%,1
新竹縣,新豐鄉,0288,326,99,425,33,458,824,55.58%,39.56%,1
新竹縣,新豐鄉,0289,380,86,466,24,490,975,50.26%,38.97%,1
新竹縣,新豐鄉,0290,321,106,427,49,476,847,56.2%,37.9%,1
新竹縣,新豐鄉,0291,598,151,749,82,831,1477,56.26%,40.49%,1
新竹縣,新豐鄉,0292,425,183,608,57,665,1266,52.53%,33.57%,1
新竹縣,新豐鄉,0293,375,122,497,63,560,1029,54.42%,36.44%,1
新竹縣,新豐鄉,0294,369,150,519,52,571,1063,53.72%,34.71%,1
新竹縣,新豐鄉,0295,467,91,558,23,581,1055,55.07%,44.27%,1
新竹縣,新豐鄉,0296,638,137,775,28,803,1445,55.57%,44.15%,1
新竹縣,新豐鄉,0297,698,134,832,34,866,1413,61.29%,49.4%,1
新竹縣,新豐鄉,0298,489,115,604,31,635,971,65.4%,50.36%,1
新竹縣,新豐鄉,0299,526,126,652,28,680,1135,59.91%,46.34%,1
新竹縣,新豐鄉,0300,509,133,642,38,680,1269,53.59%,40.11%,1
新竹縣,新豐鄉,0301,533,141,674,37,711,1257,56.56%,42.4%,1
新竹縣,新豐鄉,0302,749,170,919,47,966,1662,58.12%,45.07%,1
新竹縣,新豐鄉,0303,550,174,724,31,755,1486,50.81%,37.01%,1
新竹縣,新豐鄉,0304,459,146,605,62,667,1067,62.51%,43.02%,1
新竹縣,新豐鄉,0305,604,126,730,56,786,1302,60.37%,46.39%,1
新竹縣,新豐鄉,0306,555,171,726,63,789,1410,55.96%,39.36%,1
新竹縣,新豐鄉,0307,514,141,655,40,695,1267,54.85%,40.57%,1
新竹縣,新豐鄉,0308,469,117,586,45,631,1258,50.16%,37.28%,1
新竹縣,新豐鄉,0309,470,100,570,17,587,1217,48.23%,38.62%,1
新竹縣,新豐鄉,0310,625,147,772,29,801,1456,55.01%,42.93%,1
新竹縣,新豐鄉,0311,516,128,644,35,679,1157,58.69%,44.6%,1
新竹縣,新豐鄉,0312,438,108,546,26,572,1089,52.53%,40.22%,1
新竹縣,新豐鄉,0313,532,108,640,9,649,1160,55.95%,45.86%,1
新竹縣,新豐鄉,0314,502,90,592,15,607,976,62.19%,51.43%,1
新竹縣,新豐鄉,0315,606,161,767,39,806,1443,55.86%,42%,1
新竹縣,新豐鄉,0316,489,115,604,24,628,1247,50.36%,39.21%,1
新竹縣,新豐鄉,0317,645,119,764,27,791,1411,56.06%,45.71%,1
新竹縣,新豐鄉,0318,571,115,686,50,736,1238,59.45%,46.12%,1
新竹縣,芎林鄉,0319,173,61,234,9,243,417,58.27%,41.49%,1
新竹縣,芎林鄉,0320,260,85,345,29,374,534,70.04%,48.69%,1
新竹縣,芎林鄉,0321,436,90,526,39,565,963,58.67%,45.28%,1
新竹縣,芎林鄉,0322,203,49,252,20,272,418,65.07%,48.56%,1
新竹縣,芎林鄉,0323,531,142,673,48,721,1312,54.95%,40.47%,1
新竹縣,芎林鄉,0324,487,158,645,35,680,1354,50.22%,35.97%,1
新竹縣,芎林鄉,0325,324,106,430,40,470,785,59.87%,41.27%,1
新竹縣,芎林鄉,0326,338,83,421,68,489,797,61.36%,42.41%,1
新竹縣,芎林鄉,0327,280,75,355,19,374,623,60.03%,44.94%,1
新竹縣,芎林鄉,0328,310,95,405,31,436,759,57.44%,40.84%,1
新竹縣,芎林鄉,0329,478,126,604,41,645,1272,50.71%,37.58%,1
新竹縣,芎林鄉,0330,525,110,635,35,670,1129,59.34%,46.5%,1
新竹縣,芎林鄉,0331,319,99,418,25,443,713,62.13%,44.74%,1
新竹縣,芎林鄉,0332,375,106,481,40,521,839,62.1%,44.7%,1
新竹縣,芎林鄉,0333,556,145,701,34,735,1123,65.45%,49.51%,1
新竹縣,芎林鄉,0334,453,99,552,25,577,981,58.82%,46.18%,1
新竹縣,芎林鄉,0335,467,148,615,42,657,1078,60.95%,43.32%,1
新竹縣,芎林鄉,0336,449,110,559,36,595,1094,54.39%,41.04%,1
新竹縣,芎林鄉,0337,458,135,593,57,650,1102,58.98%,41.56%,1
新竹縣,橫山鄉,0338,556,149,705,46,751,1231,61.01%,45.17%,1
新竹縣,橫山鄉,0339,458,118,576,53,629,1041,60.42%,44%,1
新竹縣,橫山鄉,0340,506,138,644,42,686,1132,60.6%,44.7%,1
新竹縣,橫山鄉,0341,372,103,475,33,508,859,59.14%,43.31%,1
新竹縣,橫山鄉,0342,80,25,105,13,118,204,57.84%,39.22%,1
新竹縣,橫山鄉,0343,65,24,89,11,100,222,45.05%,29.28%,1
新竹縣,橫山鄉,0344,131,47,178,40,218,338,64.5%,38.76%,1
新竹縣,橫山鄉,0345,367,91,458,34,492,916,53.71%,40.07%,1
新竹縣,橫山鄉,0346,177,44,221,17,238,573,41.54%,30.89%,1
新竹縣,橫山鄉,0347,133,43,176,12,188,275,68.36%,48.36%,1
新竹縣,橫山鄉,0348,157,45,202,24,226,463,48.81%,33.91%,1
新竹縣,橫山鄉,0349,333,67,400,39,439,690,63.62%,48.26%,1
新竹縣,橫山鄉,0350,93,34,127,14,141,288,48.96%,32.29%,1
新竹縣,橫山鄉,0351,329,83,412,30,442,685,64.53%,48.03%,1
新竹縣,橫山鄉,0352,401,99,500,37,537,868,61.87%,46.2%,1
新竹縣,橫山鄉,0353,713,178,891,71,962,1561,61.63%,45.68%,1
新竹縣,北埔鄉,0354,422,124,546,19,565,1158,48.79%,36.44%,1
新竹縣,北埔鄉,0355,519,156,675,57,732,1238,59.13%,41.92%,1
新竹縣,北埔鄉,0356,256,59,315,22,337,580,58.1%,44.14%,1
新竹縣,北埔鄉,0357,412,95,507,31,538,931,57.79%,44.25%,1
新竹縣,北埔鄉,0358,701,158,859,68,927,1653,56.08%,42.41%,1
新竹縣,北埔鄉,0359,349,97,446,38,484,845,57.28%,41.3%,1
新竹縣,北埔鄉,0360,164,36,200,10,210,384,54.69%,42.71%,1
新竹縣,北埔鄉,0361,333,69,402,18,420,763,55.05%,43.64%,1
新竹縣,北埔鄉,0362,131,38,169,14,183,333,54.95%,39.34%,1
新竹縣,北埔鄉,0363,121,21,142,7,149,295,50.51%,41.02%,1
新竹縣,寶山鄉,0364,477,129,606,56,662,1158,57.17%,41.19%,1
新竹縣,寶山鄉,0365,641,159,800,24,824,1437,57.34%,44.61%,1
新竹縣,寶山鄉,0366,594,195,789,52,841,1470,57.21%,40.41%,1
新竹縣,寶山鄉,0367,517,150,667,41,708,1170,60.51%,44.19%,1
新竹縣,寶山鄉,0368,845,208,1053,47,1100,1900,57.89%,44.47%,1
新竹縣,寶山鄉,0369,414,99,513,24,537,1056,50.85%,39.2%,1
新竹縣,寶山鄉,0370,546,150,696,60,756,1205,62.74%,45.31%,1
新竹縣,寶山鄉,0371,318,89,407,32,439,766,57.31%,41.51%,1
新竹縣,寶山鄉,0372,392,93,485,34,519,846,61.35%,46.34%,1
新竹縣,寶山鄉,0373,352,100,452,36,488,804,60.7%,43.78%,1
新竹縣,寶山鄉,0374,269,77,346,14,360,607,59.31%,44.32%,1
新竹縣,寶山鄉,0375,255,84,339,11,350,554,63.18%,46.03%,1
新竹縣,峨眉鄉,0376,409,114,523,47,570,879,64.85%,46.53%,1
新竹縣,峨眉鄉,0377,295,85,380,50,430,683,62.96%,43.19%,1
新竹縣,峨眉鄉,0378,257,82,339,26,365,604,60.43%,42.55%,1
新竹縣,峨眉鄉,0379,139,39,178,21,199,339,58.7%,41%,1
新竹縣,峨眉鄉,0380,76,31,107,7,114,276,41.3%,27.54%,1
新竹縣,峨眉鄉,0381,628,145,773,84,857,1406,60.95%,44.67%,1
新竹縣,峨眉鄉,0382,220,45,265,24,289,462,62.55%,47.62%,1
新竹縣,峨眉鄉,0383,151,54,205,20,225,419,53.7%,36.04%,1
新竹縣,尖石鄉,0384,136,38,174,11,185,474,39.03%,28.69%,1
新竹縣,尖石鄉,0385,127,32,159,9,168,357,47.06%,35.57%,1
新竹縣,尖石鄉,0386,73,21,94,16,110,225,48.89%,32.44%,1
新竹縣,尖石鄉,0387,134,28,162,6,168,374,44.92%,35.83%,1
新竹縣,尖石鄉,0388,234,65,299,10,309,773,39.97%,30.27%,1
新竹縣,尖石鄉,0389,151,43,194,17,211,490,43.06%,30.82%,1
新竹縣,尖石鄉,0390,138,39,177,4,181,531,34.09%,25.99%,1
新竹縣,尖石鄉,0391,206,51,257,10,267,660,40.45%,31.21%,1
新竹縣,尖石鄉,0392,236,102,338,62,400,613,65.25%,38.5%,1
新竹縣,尖石鄉,0393,179,72,251,2,253,593,42.66%,30.19%,1
新竹縣,尖石鄉,0394,176,64,240,18,258,575,44.87%,30.61%,1
新竹縣,尖石鄉,0395,63,13,76,8,84,126,66.67%,50%,1
新竹縣,尖石鄉,0396,128,29,157,5,162,499,32.46%,25.65%,1
新竹縣,尖石鄉,0397,141,59,200,19,219,785,27.9%,17.96%,1
新竹縣,尖石鄉,0398,90,57,147,16,163,289,56.4%,31.14%,1
新竹縣,五峰鄉,0399,247,76,323,33,356,672,52.98%,36.76%,1
新竹縣,五峰鄉,0400,220,68,288,15,303,713,42.5%,30.86%,1
新竹縣,五峰鄉,0401,149,41,190,7,197,594,33.16%,25.08%,1
新竹縣,五峰鄉,0402,255,79,334,33,367,896,40.96%,28.46%,1
新竹縣,五峰鄉,0403,199,77,276,5,281,727,38.65%,27.37%,1
新竹縣,五峰鄉,0404,97,40,137,10,147,395,37.22%,24.56%,1
苗栗縣,苗栗市,0001,502,90,592,32,624,1087,57.41%,46.18%,1
苗栗縣,苗栗市,0002,450,89,539,32,571,1018,56.09%,44.2%,1
苗栗縣,苗栗市,0003,506,103,609,25,634,1156,54.84%,43.77%,1
苗栗縣,苗栗市,0004,477,102,579,35,614,1118,54.92%,42.67%,1
苗栗縣,苗栗市,0005,488,109,597,41,638,1084,58.86%,45.02%,1
苗栗縣,苗栗市,0006,561,120,681,40,721,1203,59.93%,46.63%,1
苗栗縣,苗栗市,0007,586,138,724,49,773,1306,59.19%,44.87%,1
苗栗縣,苗栗市,0008,530,147,677,38,715,1193,59.93%,44.43%,1
苗栗縣,苗栗市,0009,516,114,630,30,660,1115,59.19%,46.28%,1
苗栗縣,苗栗市,0010,526,114,640,47,687,1119,61.39%,47.01%,1
苗栗縣,苗栗市,0011,525,139,664,32,696,1132,61.48%,46.38%,1
苗栗縣,苗栗市,0012,584,122,706,34,740,1289,57.41%,45.31%,1
苗栗縣,苗栗市,0013,590,132,722,36,758,1264,59.97%,46.68%,1
苗栗縣,苗栗市,0014,382,84,466,26,492,870,56.55%,43.91%,1
苗栗縣,苗栗市,0015,397,80,477,34,511,1008,50.69%,39.38%,1
苗栗縣,苗栗市,0016,429,107,536,32,568,1078,52.69%,39.8%,1
苗栗縣,苗栗市,0017,507,112,619,26,645,1077,59.89%,47.08%,1
苗栗縣,苗栗市,0018,382,94,476,33,509,880,57.84%,43.41%,1
苗栗縣,苗栗市,0019,364,91,455,48,503,894,56.26%,40.72%,1
苗栗縣,苗栗市,0020,221,57,278,25,303,522,58.05%,42.34%,1
苗栗縣,苗栗市,0021,655,159,814,58,872,1376,63.37%,47.6%,1
苗栗縣,苗栗市,0022,589,128,717,34,751,1391,53.99%,42.34%,1
苗栗縣,苗栗市,0023,479,117,596,52,648,1081,59.94%,44.31%,1
苗栗縣,苗栗市,0024,532,128,660,49,709,1272,55.74%,41.82%,1
苗栗縣,苗栗市,0025,549,123,672,41,713,1112,64.12%,49.37%,1
苗栗縣,苗栗市,0026,432,87,519,25,544,813,66.91%,53.14%,1
苗栗縣,苗栗市,0027,329,83,412,25,437,767,56.98%,42.89%,1
苗栗縣,苗栗市,0028,450,96,546,18,564,1010,55.84%,44.55%,1
苗栗縣,苗栗市,0029,532,103,635,32,667,1182,56.43%,45.01%,1
苗栗縣,苗栗市,0030,451,86,537,15,552,965,57.2%,46.74%,1
苗栗縣,苗栗市,0031,299,53,352,12,364,607,59.97%,49.26%,1
苗栗縣,苗栗市,0032,475,112,587,25,612,990,61.82%,47.98%,1
苗栗縣,苗栗市,0033,475,104,579,89,668,1230,54.31%,38.62%,1
苗栗縣,苗栗市,0034,613,134,747,44,791,1372,57.65%,44.68%,1
苗栗縣,苗栗市,0035,537,126,663,47,710,1213,58.53%,44.27%,1
苗栗縣,苗栗市,0036,560,123,683,41,724,1272,56.92%,44.03%,1
苗栗縣,苗栗市,0037,571,135,706,43,749,1221,61.34%,46.76%,1
苗栗縣,苗栗市,0038,495,106,601,45,646,1104,58.51%,44.84%,1
苗栗縣,苗栗市,0039,474,120,594,12,606,1171,51.75%,40.48%,1
苗栗縣,苗栗市,0040,600,135,735,50,785,1392,56.39%,43.1%,1
苗栗縣,苗栗市,0041,599,162,761,35,796,1356,58.7%,44.17%,1
苗栗縣,苗栗市,0042,604,158,762,48,810,1387,58.4%,43.55%,1
苗栗縣,苗栗市,0043,524,113,637,39,676,1206,56.05%,43.45%,1
苗栗縣,苗栗市,0044,471,130,601,36,637,1004,63.45%,46.91%,1
苗栗縣,苗栗市,0045,515,129,644,31,675,1202,56.16%,42.85%,1
苗栗縣,苗栗市,0046,499,113,612,30,642,1052,61.03%,47.43%,1
苗栗縣,苗栗市,0047,418,96,514,27,541,873,61.97%,47.88%,1
苗栗縣,苗栗市,0048,528,95,623,30,653,975,66.97%,54.15%,1
苗栗縣,苗栗市,0049,498,119,617,26,643,1003,64.11%,49.65%,1
苗栗縣,苗栗市,0050,451,113,564,16,580,1000,58%,45.1%,1
苗栗縣,苗栗市,0051,467,83,550,37,587,1047,56.06%,44.6%,1
苗栗縣,苗栗市,0052,499,90,589,36,625,1025,60.98%,48.68%,1
苗栗縣,苗栗市,0053,485,109,594,16,610,1130,53.98%,42.92%,1
苗栗縣,苗栗市,0054,526,100,626,28,654,1146,57.07%,45.9%,1
苗栗縣,苗栗市,0055,627,160,787,45,832,1432,58.1%,43.78%,1
苗栗縣,苗栗市,0056,543,111,654,40,694,1492,46.51%,36.39%,1
苗栗縣,苗栗市,0057,533,128,661,29,690,1125,61.33%,47.38%,1
苗栗縣,苗栗市,0058,530,130,660,35,695,1241,56%,42.71%,1
苗栗縣,苗栗市,0059,595,127,722,45,767,1278,60.02%,46.56%,1
苗栗縣,苗栗市,0060,588,104,692,22,714,1293,55.22%,45.48%,1
苗栗縣,苗栗市,0061,554,123,677,32,709,1342,52.83%,41.28%,1
苗栗縣,苗栗市,0062,361,86,447,29,476,857,55.54%,42.12%,1
苗栗縣,苗栗市,0063,493,116,609,38,647,1180,54.83%,41.78%,1
苗栗縣,苗栗市,0064,501,109,610,26,636,1072,59.33%,46.74%,1
苗栗縣,苗栗市,0065,392,62,454,29,483,912,52.96%,42.98%,1
苗栗縣,苗栗市,0066,314,81,395,31,426,796,53.52%,39.45%,1
苗栗縣,苗栗市,0067,323,83,406,24,430,869,49.48%,37.17%,1
苗栗縣,苑裡鎮,0183,351,116,467,56,523,873,59.91%,40.21%,1
苗栗縣,苑裡鎮,0184,594,145,739,49,788,1346,58.54%,44.13%,1
苗栗縣,苑裡鎮,0185,447,128,575,56,631,951,66.35%,47%,1
苗栗縣,苑裡鎮,0186,235,68,303,18,321,615,52.2%,38.21%,1
苗栗縣,苑裡鎮,0187,415,78,493,53,546,878,62.19%,47.27%,1
苗栗縣,苑裡鎮,0188,335,106,441,26,467,767,60.89%,43.68%,1
苗栗縣,苑裡鎮,0189,288,102,390,44,434,776,55.93%,37.11%,1
苗栗縣,苑裡鎮,0190,453,128,581,56,637,1231,51.75%,36.8%,1
苗栗縣,苑裡鎮,0191,480,153,633,39,672,1145,58.69%,41.92%,1
苗栗縣,苑裡鎮,0192,329,104,433,38,471,850,55.41%,38.71%,1
苗栗縣,苑裡鎮,0193,379,137,516,62,578,1052,54.94%,36.03%,1
苗栗縣,苑裡鎮,0194,469,128,597,42,639,1114,57.36%,42.1%,1
苗栗縣,苑裡鎮,0195,446,168,614,58,672,1136,59.15%,39.26%,1
苗栗縣,苑裡鎮,0196,479,145,624,44,668,1194,55.95%,40.12%,1
苗栗縣,苑裡鎮,0197,677,172,849,51,900,1579,57%,42.88%,1
苗栗縣,苑裡鎮,0198,491,165,656,57,713,1149,62.05%,42.73%,1
苗栗縣,苑裡鎮,0199,425,149,574,66,640,1057,60.55%,40.21%,1
苗栗縣,苑裡鎮,0200,417,98,515,24,539,1101,48.96%,37.87%,1
苗栗縣,苑裡鎮,0201,284,99,383,43,426,912,46.71%,31.14%,1
苗栗縣,苑裡鎮,0202,238,88,326,38,364,652,55.83%,36.5%,1
苗栗縣,苑裡鎮,0203,558,156,714,71,785,1348,58.23%,41.39%,1
苗栗縣,苑裡鎮,0204,240,89,329,18,347,733,47.34%,32.74%,1
苗栗縣,苑裡鎮,0205,260,52,312,15,327,662,49.4%,39.27%,1
苗栗縣,苑裡鎮,0206,370,102,472,44,516,893,57.78%,41.43%,1
苗栗縣,苑裡鎮,0207,397,102,499,46,545,910,59.89%,43.63%,1
苗栗縣,苑裡鎮,0208,469,165,634,62,696,1270,54.8%,36.93%,1
苗栗縣,苑裡鎮,0209,203,60,263,29,292,545,53.58%,37.25%,1
苗栗縣,苑裡鎮,0210,349,90,439,62,501,792,63.26%,44.07%,1
苗栗縣,苑裡鎮,0211,288,94,382,36,418,726,57.58%,39.67%,1
苗栗縣,苑裡鎮,0212,254,70,324,20,344,827,41.6%,30.71%,1
苗栗縣,苑裡鎮,0213,306,98,404,60,464,782,59.34%,39.13%,1
苗栗縣,苑裡鎮,0214,301,98,399,35,434,788,55.08%,38.2%,1
苗栗縣,苑裡鎮,0215,317,104,421,41,462,846,54.61%,37.47%,1
苗栗縣,苑裡鎮,0216,340,111,451,53,504,828,60.87%,41.06%,1
苗栗縣,苑裡鎮,0217,377,125,502,48,550,943,58.32%,39.98%,1
苗栗縣,苑裡鎮,0218,458,142,600,33,633,1082,58.5%,42.33%,1
苗栗縣,苑裡鎮,0219,520,166,686,63,749,1234,60.7%,42.14%,1
苗栗縣,苑裡鎮,0220,582,148,730,53,783,1434,54.6%,40.59%,1
苗栗縣,苑裡鎮,0221,423,108,531,39,570,987,57.75%,42.86%,1
苗栗縣,苑裡鎮,0222,385,128,513,49,562,882,63.72%,43.65%,1
苗栗縣,通霄鎮,0149,417,163,580,71,651,1142,57.01%,36.51%,1
苗栗縣,通霄鎮,0150,370,141,511,59,570,884,64.48%,41.86%,1
苗栗縣,通霄鎮,0151,394,135,529,69,598,1068,55.99%,36.89%,1
苗栗縣,通霄鎮,0152,408,118,526,42,568,1009,56.29%,40.44%,1
苗栗縣,通霄鎮,0153,387,123,510,50,560,859,65.19%,45.05%,1
苗栗縣,通霄鎮,0154,420,141,561,41,602,1040,57.88%,40.38%,1
苗栗縣,通霄鎮,0155,323,82,405,19,424,1008,42.06%,32.04%,1
苗栗縣,通霄鎮,0156,262,90,352,56,408,686,59.48%,38.19%,1
苗栗縣,通霄鎮,0157,352,97,449,55,504,761,66.23%,46.25%,1
苗栗縣,通霄鎮,0158,280,83,363,34,397,790,50.25%,35.44%,1
苗栗縣,通霄鎮,0159,367,115,482,48,530,966,54.87%,37.99%,1
苗栗縣,通霄鎮,0160,314,117,431,72,503,972,51.75%,32.3%,1
苗栗縣,通霄鎮,0161,291,90,381,49,430,771,55.77%,37.74%,1
苗栗縣,通霄鎮,0162,219,76,295,34,329,758,43.4%,28.89%,1
苗栗縣,通霄鎮,0163,401,138,539,43,582,1078,53.99%,37.2%,1
苗栗縣,通霄鎮,0164,126,46,172,27,199,459,43.36%,27.45%,1
苗栗縣,通霄鎮,0165,317,86,403,46,449,894,50.22%,35.46%,1
苗栗縣,通霄鎮,0166,106,42,148,11,159,402,39.55%,26.37%,1
苗栗縣,通霄鎮,0167,292,107,399,35,434,802,54.11%,36.41%,1
苗栗縣,通霄鎮,0168,233,86,319,28,347,684,50.73%,34.06%,1
苗栗縣,通霄鎮,0169,321,78,399,41,440,943,46.66%,34.04%,1
苗栗縣,通霄鎮,0170,309,110,419,60,479,790,60.63%,39.11%,1
苗栗縣,通霄鎮,0171,210,55,265,12,277,673,41.16%,31.2%,1
苗栗縣,通霄鎮,0172,460,123,583,65,648,1232,52.6%,37.34%,1
苗栗縣,通霄鎮,0173,526,143,669,84,753,1286,58.55%,40.9%,1
苗栗縣,通霄鎮,0174,249,92,341,46,387,649,59.63%,38.37%,1
苗栗縣,通霄鎮,0175,267,87,354,32,386,769,50.2%,34.72%,1
苗栗縣,通霄鎮,0176,395,162,557,76,633,1148,55.14%,34.41%,1
苗栗縣,通霄鎮,0177,357,133,490,85,575,1138,50.53%,31.37%,1
苗栗縣,通霄鎮,0178,370,117,487,57,544,1121,48.53%,33.01%,1
苗栗縣,通霄鎮,0179,321,82,403,24,427,769,55.53%,41.74%,1
苗栗縣,通霄鎮,0180,188,98,286,8,294,616,47.73%,30.52%,1
苗栗縣,通霄鎮,0181,258,142,400,36,436,799,54.57%,32.29%,1
苗栗縣,通霄鎮,0182,257,80,337,35,372,743,50.07%,34.59%,1
苗栗縣,竹南鎮,0270,460,155,615,35,650,1086,59.85%,42.36%,1
苗栗縣,竹南鎮,0271,363,90,453,32,485,826,58.72%,43.95%,1
苗栗縣,竹南鎮,0272,391,110,501,51,552,1051,52.52%,37.2%,1
苗栗縣,竹南鎮,0273,576,115,691,39,730,1235,59.11%,46.64%,1
苗栗縣,竹南鎮,0274,437,120,557,58,615,1016,60.53%,43.01%,1
苗栗縣,竹南鎮,0275,543,191,734,64,798,1472,54.21%,36.89%,1
苗栗縣,竹南鎮,0276,486,121,607,32,639,1301,49.12%,37.36%,1
苗栗縣,竹南鎮,0277,589,148,737,42,779,1544,50.45%,38.15%,1
苗栗縣,竹南鎮,0278,637,155,792,38,830,1512,54.89%,42.13%,1
苗栗縣,竹南鎮,0279,589,136,725,49,774,1463,52.9%,40.26%,1
苗栗縣,竹南鎮,0280,453,120,573,27,600,1073,55.92%,42.22%,1
苗栗縣,竹南鎮,0281,643,152,795,33,828,1453,56.99%,44.25%,1
苗栗縣,竹南鎮,0282,592,122,714,40,754,1245,60.56%,47.55%,1
苗栗縣,竹南鎮,0283,692,158,850,39,889,1487,59.78%,46.54%,1
苗栗縣,竹南鎮,0284,412,150,562,36,598,1018,58.74%,40.47%,1
苗栗縣,竹南鎮,0285,486,145,631,25,656,1105,59.37%,43.98%,1
苗栗縣,竹南鎮,0286,518,139,657,44,701,1322,53.03%,39.18%,1
苗栗縣,竹南鎮,0287,530,104,634,27,661,1140,57.98%,46.49%,1
苗栗縣,竹南鎮,0288,504,114,618,36,654,1067,61.29%,47.24%,1
苗栗縣,竹南鎮,0289,518,151,669,48,717,1136,63.12%,45.6%,1
苗栗縣,竹南鎮,0290,496,111,607,46,653,1253,52.11%,39.58%,1
苗栗縣,竹南鎮,0291,363,104,467,46,513,963,53.27%,37.69%,1
苗栗縣,竹南鎮,0292,386,123,509,47,556,1021,54.46%,37.81%,1
苗栗縣,竹南鎮,0293,519,132,651,41,692,1154,59.97%,44.97%,1
苗栗縣,竹南鎮,0294,449,117,566,30,596,1042,57.2%,43.09%,1
苗栗縣,竹南鎮,0295,567,142,709,34,743,1293,57.46%,43.85%,1
苗栗縣,竹南鎮,0296,364,98,462,18,480,816,58.82%,44.61%,1
苗栗縣,竹南鎮,0297,410,104,514,48,562,989,56.83%,41.46%,1
苗栗縣,竹南鎮,0298,541,98,639,39,678,1122,60.43%,48.22%,1
苗栗縣,竹南鎮,0299,393,100,493,30,523,1111,47.07%,35.37%,1
苗栗縣,竹南鎮,0300,442,120,562,53,615,1036,59.36%,42.66%,1
苗栗縣,竹南鎮,0301,433,99,532,28,560,1112,50.36%,38.94%,1
苗栗縣,竹南鎮,0302,545,125,670,29,699,1348,51.85%,40.43%,1
苗栗縣,竹南鎮,0303,484,143,627,26,653,1114,58.62%,43.45%,1
苗栗縣,竹南鎮,0304,484,142,626,44,670,1119,59.87%,43.25%,1
苗栗縣,竹南鎮,0305,387,83,470,29,499,878,56.83%,44.08%,1
苗栗縣,竹南鎮,0306,478,129,607,44,651,1059,61.47%,45.14%,1
苗栗縣,竹南鎮,0307,356,132,488,34,522,869,60.07%,40.97%,1
苗栗縣,竹南鎮,0308,309,105,414,29,443,800,55.38%,38.63%,1
苗栗縣,竹南鎮,0309,545,126,671,41,712,1165,61.12%,46.78%,1
苗栗縣,竹南鎮,0310,328,87,415,41,456,791,57.65%,41.47%,1
苗栗縣,竹南鎮,0311,257,89,346,27,373,677,55.1%,37.96%,1
苗栗縣,竹南鎮,0312,361,108,469,49,518,797,64.99%,45.29%,1
苗栗縣,竹南鎮,0313,508,107,615,33,648,1191,54.41%,42.65%,1
苗栗縣,竹南鎮,0314,390,122,512,22,534,1027,52%,37.97%,1
苗栗縣,竹南鎮,0315,599,146,745,46,791,1341,58.99%,44.67%,1
苗栗縣,竹南鎮,0316,504,147,651,52,703,1378,51.02%,36.57%,1
苗栗縣,竹南鎮,0317,514,140,654,26,680,1216,55.92%,42.27%,1
苗栗縣,竹南鎮,0318,643,148,791,34,825,1570,52.55%,40.96%,1
苗栗縣,竹南鎮,0319,218,83,301,28,329,538,61.15%,40.52%,1
苗栗縣,竹南鎮,0320,423,97,520,24,544,1166,46.66%,36.28%,1
苗栗縣,竹南鎮,0321,575,172,747,28,775,1488,52.08%,38.64%,1
苗栗縣,竹南鎮,0322,553,138,691,28,719,1449,49.62%,38.16%,1
苗栗縣,竹南鎮,0323,449,137,586,75,661,1182,55.92%,37.99%,1
苗栗縣,竹南鎮,0324,439,156,595,75,670,1175,57.02%,37.36%,1
苗栗縣,竹南鎮,0325,401,110,511,46,557,983,56.66%,40.79%,1
苗栗縣,竹南鎮,0326,225,64,289,20,309,492,62.8%,45.73%,1
苗栗縣,竹南鎮,0327,435,145,580,42,622,1074,57.91%,40.5%,1
苗栗縣,竹南鎮,0328,314,113,427,41,468,852,54.93%,36.85%,1
苗栗縣,竹南鎮,0329,544,111,655,29,684,1297,52.74%,41.94%,1
苗栗縣,竹南鎮,0330,384,125,509,49,558,1028,54.28%,37.35%,1
苗栗縣,頭份市,0331,321,101,422,75,497,915,54.32%,35.08%,1
苗栗縣,頭份市,0332,509,165,674,61,735,1292,56.89%,39.4%,1
苗栗縣,頭份市,0333,394,133,527,25,552,928,59.48%,42.46%,1
苗栗縣,頭份市,0334,312,80,392,15,407,835,48.74%,37.37%,1
苗栗縣,頭份市,0335,444,113,557,30,587,1070,54.86%,41.5%,1
苗栗縣,頭份市,0336,339,78,417,12,429,879,48.81%,38.57%,1
苗栗縣,頭份市,0337,370,126,496,43,539,1039,51.88%,35.61%,1
苗栗縣,頭份市,0338,500,104,604,52,656,1129,58.1%,44.29%,1
苗栗縣,頭份市,0339,441,97,538,34,572,1041,54.95%,42.36%,1
苗栗縣,頭份市,0340,557,159,716,74,790,1546,51.1%,36.03%,1
苗栗縣,頭份市,0341,423,127,550,35,585,935,62.57%,45.24%,1
苗栗縣,頭份市,0342,429,142,571,46,617,1180,52.29%,36.36%,1
苗栗縣,頭份市,0343,547,163,710,50,760,1499,50.7%,36.49%,1
苗栗縣,頭份市,0344,305,83,388,16,404,747,54.08%,40.83%,1
苗栗縣,頭份市,0345,574,144,718,30,748,1406,53.2%,40.83%,1
苗栗縣,頭份市,0346,498,119,617,54,671,1193,56.24%,41.74%,1
苗栗縣,頭份市,0347,387,120,507,45,552,948,58.23%,40.82%,1
苗栗縣,頭份市,0348,370,70,440,25,465,869,53.51%,42.58%,1
苗栗縣,頭份市,0349,487,148,635,33,668,1142,58.49%,42.64%,1
苗栗縣,頭份市,0350,536,129,665,31,696,1286,54.12%,41.68%,1
苗栗縣,頭份市,0351,395,108,503,33,536,903,59.36%,43.74%,1
苗栗縣,頭份市,0352,564,127,691,44,735,1186,61.97%,47.55%,1
苗栗縣,頭份市,0353,467,102,569,19,588,1016,57.87%,45.96%,1
苗栗縣,頭份市,0354,422,107,529,30,559,985,56.75%,42.84%,1
苗栗縣,頭份市,0355,428,106,534,28,562,1037,54.19%,41.27%,1
苗栗縣,頭份市,0356,338,92,430,34,464,947,49%,35.69%,1
苗栗縣,頭份市,0357,404,82,486,32,518,890,58.2%,45.39%,1
苗栗縣,頭份市,0358,284,89,373,33,406,646,62.85%,43.96%,1
苗栗縣,頭份市,0359,399,129,528,49,577,975,59.18%,40.92%,1
苗栗縣,頭份市,0360,282,95,377,15,392,1015,38.62%,27.78%,1
苗栗縣,頭份市,0361,636,155,791,57,848,1399,60.61%,45.46%,1
苗栗縣,頭份市,0362,500,140,640,46,686,1143,60.02%,43.74%,1
苗栗縣,頭份市,0363,514,110,624,47,671,1030,65.15%,49.9%,1
苗栗縣,頭份市,0364,580,157,737,36,773,1338,57.77%,43.35%,1
苗栗縣,頭份市,0365,604,136,740,35,775,1450,53.45%,41.66%,1
苗栗縣,頭份市,0366,477,105,582,23,605,1042,58.06%,45.78%,1
苗栗縣,頭份市,0367,601,148,749,49,798,1326,60.18%,45.32%,1
苗栗縣,頭份市,0368,641,128,769,34,803,1270,63.23%,50.47%,1
苗栗縣,頭份市,0369,557,120,677,36,713,1288,55.36%,43.25%,1
苗栗縣,頭份市,0370,568,119,687,32,719,1243,57.84%,45.7%,1
苗栗縣,頭份市,0371,588,133,721,30,751,1280,58.67%,45.94%,1
苗栗縣,頭份市,0372,642,187,829,79,908,1618,56.12%,39.68%,1
苗栗縣,頭份市,0373,715,173,888,49,937,1759,53.27%,40.65%,1
苗栗縣,頭份市,0374,584,124,708,41,749,1264,59.26%,46.2%,1
苗栗縣,頭份市,0375,593,132,725,39,764,1326,57.62%,44.72%,1
苗栗縣,頭份市,0376,711,142,853,34,887,1551,57.19%,45.84%,1
苗栗縣,頭份市,0377,631,146,777,36,813,1574,51.65%,40.09%,1
苗栗縣,頭份市,0378,543,154,697,37,734,1262,58.16%,43.03%,1
苗栗縣,頭份市,0379,518,129,647,39,686,1171,58.58%,44.24%,1
苗栗縣,頭份市,0380,526,137,663,33,696,1074,64.8%,48.98%,1
苗栗縣,頭份市,0381,540,124,664,26,690,1141,60.47%,47.33%,1
苗栗縣,頭份市,0382,545,149,694,36,730,1259,57.98%,43.29%,1
苗栗縣,頭份市,0383,488,126,614,41,655,1186,55.23%,41.15%,1
苗栗縣,頭份市,0384,447,105,552,31,583,1121,52.01%,39.88%,1
苗栗縣,頭份市,0385,349,109,458,28,486,847,57.38%,41.2%,1
苗栗縣,頭份市,0386,430,135,565,33,598,993,60.22%,43.3%,1
苗栗縣,頭份市,0387,409,29,438,33,471,1055,44.64%,38.77%,1
苗栗縣,頭份市,0388,624,144,768,59,827,1655,49.97%,37.7%,1
苗栗縣,頭份市,0389,734,174,908,81,989,1799,54.97%,40.8%,1
苗栗縣,頭份市,0390,485,139,624,38,662,1141,58.02%,42.51%,1
苗栗縣,頭份市,0391,605,139,744,37,781,1431,54.58%,42.28%,1
苗栗縣,頭份市,0392,498,126,624,26,650,1412,46.03%,35.27%,1
苗栗縣,頭份市,0393,431,101,532,32,564,1074,52.51%,40.13%,1
苗栗縣,頭份市,0394,568,129,697,46,743,1245,59.68%,45.62%,1
苗栗縣,頭份市,0395,564,186,750,51,801,1344,59.6%,41.96%,1
苗栗縣,頭份市,0396,611,173,784,58,842,1363,61.78%,44.83%,1
苗栗縣,頭份市,0397,420,102,522,41,563,898,62.69%,46.77%,1
苗栗縣,頭份市,0398,502,131,633,76,709,1182,59.98%,42.47%,1
苗栗縣,頭份市,0399,582,148,730,41,771,1413,54.56%,41.19%,1
苗栗縣,頭份市,0400,460,126,586,30,616,991,62.16%,46.42%,1
苗栗縣,頭份市,0401,515,139,654,42,696,1180,58.98%,43.64%,1
苗栗縣,後龍鎮,0223,216,83,299,36,335,590,56.78%,36.61%,1
苗栗縣,後龍鎮,0224,379,130,509,49,558,883,63.19%,42.92%,1
苗栗縣,後龍鎮,0225,340,97,437,57,494,793,62.3%,42.88%,1
苗栗縣,後龍鎮,0226,298,108,406,33,439,732,59.97%,40.71%,1
苗栗縣,後龍鎮,0227,238,87,325,35,360,592,60.81%,40.2%,1
苗栗縣,後龍鎮,0228,450,152,602,61,663,1113,59.57%,40.43%,1
苗栗縣,後龍鎮,0229,486,132,618,59,677,1195,56.65%,40.67%,1
苗栗縣,後龍鎮,0230,437,130,567,48,615,997,61.69%,43.83%,1
苗栗縣,後龍鎮,0231,282,128,410,28,438,913,47.97%,30.89%,1
苗栗縣,後龍鎮,0232,221,77,298,39,337,641,52.57%,34.48%,1
苗栗縣,後龍鎮,0233,313,87,400,37,437,848,51.53%,36.91%,1
苗栗縣,後龍鎮,0234,471,140,611,91,702,1264,55.54%,37.26%,1
苗栗縣,後龍鎮,0235,332,115,447,42,489,965,50.67%,34.4%,1
苗栗縣,後龍鎮,0236,624,152,776,76,852,1216,70.07%,51.32%,1
苗栗縣,後龍鎮,0237,400,92,492,39,531,977,54.35%,40.94%,1
苗栗縣,後龍鎮,0238,312,112,424,51,475,943,50.37%,33.09%,1
苗栗縣,後龍鎮,0239,333,119,452,69,521,910,57.25%,36.59%,1
苗栗縣,後龍鎮,0240,344,83,427,47,474,851,55.7%,40.42%,1
苗栗縣,後龍鎮,0241,295,119,414,33,447,725,61.66%,40.69%,1
苗栗縣,後龍鎮,0242,260,83,343,45,388,650,59.69%,40%,1
苗栗縣,後龍鎮,0243,226,93,319,49,368,706,52.12%,32.01%,1
苗栗縣,後龍鎮,0244,272,109,381,50,431,748,57.62%,36.36%,1
苗栗縣,後龍鎮,0245,268,69,337,40,377,801,47.07%,33.46%,1
苗栗縣,後龍鎮,0246,438,137,575,50,625,1107,56.46%,39.57%,1
苗栗縣,後龍鎮,0247,454,138,592,61,653,1197,54.55%,37.93%,1
苗栗縣,後龍鎮,0248,363,110,473,53,526,1036,50.77%,35.04%,1
苗栗縣,後龍鎮,0249,274,100,374,38,412,913,45.13%,30.01%,1
苗栗縣,後龍鎮,0250,287,96,383,57,440,719,61.2%,39.92%,1
苗栗縣,後龍鎮,0251,410,97,507,92,599,1037,57.76%,39.54%,1
苗栗縣,後龍鎮,0252,226,60,286,20,306,601,50.92%,37.6%,1
苗栗縣,後龍鎮,0253,405,124,529,49,578,1269,45.55%,31.91%,1
苗栗縣,後龍鎮,0254,254,69,323,34,357,735,48.57%,34.56%,1
苗栗縣,後龍鎮,0255,95,36,131,14,145,422,34.36%,22.51%,1
苗栗縣,後龍鎮,0256,267,64,331,24,355,625,56.8%,42.72%,1
苗栗縣,後龍鎮,0257,393,117,510,64,574,1234,46.52%,31.85%,1
苗栗縣,卓蘭鎮,0442,369,187,556,31,587,961,61.08%,38.4%,1
苗栗縣,卓蘭鎮,0443,399,111,510,62,572,1017,56.24%,39.23%,1
苗栗縣,卓蘭鎮,0444,452,175,627,75,702,1095,64.11%,41.28%,1
苗栗縣,卓蘭鎮,0445,336,82,418,29,447,745,60%,45.1%,1
苗栗縣,卓蘭鎮,0446,294,88,382,48,430,783,54.92%,37.55%,1
苗栗縣,卓蘭鎮,0447,267,72,339,18,357,745,47.92%,35.84%,1
苗栗縣,卓蘭鎮,0448,356,100,456,28,484,999,48.45%,35.64%,1
苗栗縣,卓蘭鎮,0449,299,81,380,38,418,671,62.3%,44.56%,1
苗栗縣,卓蘭鎮,0450,336,85,421,59,480,734,65.4%,45.78%,1
苗栗縣,卓蘭鎮,0451,389,88,477,57,534,865,61.73%,44.97%,1
苗栗縣,卓蘭鎮,0452,367,102,469,50,519,828,62.68%,44.32%,1
苗栗縣,卓蘭鎮,0453,168,47,215,30,245,386,63.47%,43.52%,1
苗栗縣,卓蘭鎮,0454,322,86,408,36,444,688,64.53%,46.8%,1
苗栗縣,卓蘭鎮,0455,348,99,447,47,494,792,62.37%,43.94%,1
苗栗縣,卓蘭鎮,0456,303,92,395,34,429,729,58.85%,41.56%,1
苗栗縣,卓蘭鎮,0457,360,123,483,28,511,1093,46.75%,32.94%,1
苗栗縣,卓蘭鎮,0458,262,69,331,13,344,615,55.93%,42.6%,1
苗栗縣,卓蘭鎮,0459,41,2,43,2,45,86,52.33%,47.67%,1
苗栗縣,卓蘭鎮,0460,400,96,496,13,509,940,54.15%,42.55%,1
苗栗縣,大湖鄉,0420,277,97,374,28,402,744,54.03%,37.23%,1
苗栗縣,大湖鄉,0421,376,81,457,31,488,881,55.39%,42.68%,1
苗栗縣,大湖鄉,0422,253,49,302,37,339,596,56.88%,42.45%,1
苗栗縣,大湖鄉,0423,461,108,569,83,652,1260,51.75%,36.59%,1
苗栗縣,大湖鄉,0424,339,82,421,34,455,867,52.48%,39.1%,1
苗栗縣,大湖鄉,0425,373,90,463,47,510,923,55.25%,40.41%,1
苗栗縣,大湖鄉,0426,504,169,673,64,737,1395,52.83%,36.13%,1
苗栗縣,大湖鄉,0427,142,47,189,14,203,561,36.19%,25.31%,1
苗栗縣,大湖鄉,0428,267,76,343,27,370,638,57.99%,41.85%,1
苗栗縣,大湖鄉,0429,274,86,360,39,399,754,52.92%,36.34%,1
苗栗縣,大湖鄉,0430,175,60,235,12,247,501,49.3%,34.93%,1
苗栗縣,大湖鄉,0431,229,93,322,38,360,652,55.21%,35.12%,1
苗栗縣,大湖鄉,0432,300,87,387,21,408,843,48.4%,35.59%,1
苗栗縣,大湖鄉,0433,424,110,534,44,578,1020,56.67%,41.57%,1
苗栗縣,大湖鄉,0434,432,105,537,42,579,1018,56.88%,42.44%,1
苗栗縣,公館鄉,0068,365,108,473,48,521,789,66.03%,46.26%,1
苗栗縣,公館鄉,0069,397,95,492,29,521,792,65.78%,50.13%,1
苗栗縣,公館鄉,0070,478,150,628,90,718,1117,64.28%,42.79%,1
苗栗縣,公館鄉,0071,569,149,718,67,785,1255,62.55%,45.34%,1
苗栗縣,公館鄉,0072,517,124,641,40,681,1141,59.68%,45.31%,1
苗栗縣,公館鄉,0073,494,152,646,41,687,1172,58.62%,42.15%,1
苗栗縣,公館鄉,0074,501,152,653,42,695,1100,63.18%,45.55%,1
苗栗縣,公館鄉,0075,488,123,611,41,652,1232,52.92%,39.61%,1
苗栗縣,公館鄉,0076,409,101,510,59,569,1081,52.64%,37.84%,1
苗栗縣,公館鄉,0077,615,122,737,38,775,1250,62%,49.2%,1
苗栗縣,公館鄉,0078,457,134,591,40,631,1081,58.37%,42.28%,1
苗栗縣,公館鄉,0079,374,115,489,64,553,964,57.37%,38.8%,1
苗栗縣,公館鄉,0080,436,130,566,66,632,1038,60.89%,42%,1
苗栗縣,公館鄉,0081,154,54,208,19,227,360,63.06%,42.78%,1
苗栗縣,公館鄉,0082,350,107,457,42,499,865,57.69%,40.46%,1
苗栗縣,公館鄉,0083,484,124,608,44,652,1166,55.92%,41.51%,1
苗栗縣,公館鄉,0084,325,78,403,25,428,719,59.53%,45.2%,1
苗栗縣,公館鄉,0085,300,92,392,43,435,788,55.2%,38.07%,1
苗栗縣,公館鄉,0086,135,42,177,25,202,303,66.67%,44.55%,1
苗栗縣,公館鄉,0087,601,157,758,37,795,1322,60.14%,45.46%,1
苗栗縣,公館鄉,0088,368,110,478,55,533,933,57.13%,39.44%,1
苗栗縣,公館鄉,0089,576,158,734,58,792,1455,54.43%,39.59%,1
苗栗縣,公館鄉,0090,677,222,899,100,999,1615,61.86%,41.92%,1
苗栗縣,公館鄉,0091,588,150,738,68,806,1451,55.55%,40.52%,1
苗栗縣,公館鄉,0092,641,169,810,72,882,1462,60.33%,43.84%,1
苗栗縣,公館鄉,0093,522,149,671,66,737,1317,55.96%,39.64%,1
苗栗縣,公館鄉,0094,107,18,125,6,131,221,59.28%,48.42%,1
苗栗縣,公館鄉,0095,129,35,164,11,175,329,53.19%,39.21%,1
苗栗縣,銅鑼鄉,0108,430,83,513,35,548,887,61.78%,48.48%,1
苗栗縣,銅鑼鄉,0109,465,118,583,47,630,1052,59.89%,44.2%,1
苗栗縣,銅鑼鄉,0110,646,154,800,26,826,1347,61.32%,47.96%,1
苗栗縣,銅鑼鄉,0111,400,226,626,45,671,1177,57.01%,33.98%,1
苗栗縣,銅鑼鄉,0112,500,138,638,45,683,1268,53.86%,39.43%,1
苗栗縣,銅鑼鄉,0113,423,124,547,31,578,1185,48.78%,35.7%,1
苗栗縣,銅鑼鄉,0114,476,78,554,42,596,1029,57.92%,46.26%,1
苗栗縣,銅鑼鄉,0115,411,79,490,31,521,905,57.57%,45.41%,1
苗栗縣,銅鑼鄉,0116,342,94,436,30,466,750,62.13%,45.6%,1
苗栗縣,銅鑼鄉,0117,425,96,521,41,562,1080,52.04%,39.35%,1
苗栗縣,銅鑼鄉,0118,434,115,549,52,601,1108,54.24%,39.17%,1
苗栗縣,銅鑼鄉,0119,338,76,414,43,457,862,53.02%,39.21%,1
苗栗縣,銅鑼鄉,0120,491,128,619,28,647,1216,53.21%,40.38%,1
苗栗縣,銅鑼鄉,0121,222,51,273,30,303,588,51.53%,37.76%,1
苗栗縣,銅鑼鄉,0122,156,48,204,30,234,429,54.55%,36.36%,1
苗栗縣,銅鑼鄉,0123,231,65,296,21,317,541,58.6%,42.7%,1
苗栗縣,南庄鄉,0411,434,146,580,59,639,1155,55.32%,37.58%,1
苗栗縣,南庄鄉,0412,237,87,324,41,365,650,56.15%,36.46%,1
苗栗縣,南庄鄉,0413,474,164,638,62,700,1353,51.74%,35.03%,1
苗栗縣,南庄鄉,0414,238,77,315,40,355,813,43.67%,29.27%,1
苗栗縣,南庄鄉,0415,262,67,329,28,357,837,42.65%,31.3%,1
苗栗縣,南庄鄉,0416,418,118,536,36,572,1093,52.33%,38.24%,1
苗栗縣,南庄鄉,0417,390,131,521,50,571,1048,54.48%,37.21%,1
苗栗縣,南庄鄉,0418,314,89,403,46,449,872,51.49%,36.01%,1
苗栗縣,南庄鄉,0419,218,68,286,14,300,963,31.15%,22.64%,1
苗栗縣,頭屋鄉,0096,670,163,833,60,893,1335,66.89%,50.19%,1
苗栗縣,頭屋鄉,0097,619,143,762,65,827,1168,70.8%,53%,1
苗栗縣,頭屋鄉,0098,397,91,488,28,516,792,65.15%,50.13%,1
苗栗縣,頭屋鄉,0099,479,139,618,40,658,918,71.68%,52.18%,1
苗栗縣,頭屋鄉,0100,364,71,435,28,463,725,63.86%,50.21%,1
苗栗縣,頭屋鄉,0101,410,115,525,29,554,899,61.62%,45.61%,1
苗栗縣,頭屋鄉,0102,135,32,167,14,181,369,49.05%,36.59%,1
苗栗縣,頭屋鄉,0103,379,100,479,25,504,844,59.72%,44.91%,1
苗栗縣,頭屋鄉,0104,458,110,568,26,594,1007,58.99%,45.48%,1
苗栗縣,頭屋鄉,0105,80,391,471,30,501,794,63.1%,10.08%,1
苗栗縣,頭屋鄉,0106,117,23,140,17,157,211,74.41%,55.45%,1
苗栗縣,頭屋鄉,0107,166,54,220,17,237,328,72.26%,50.61%,1
苗栗縣,三義鄉,0124,385,96,481,42,523,853,61.31%,45.13%,1
苗栗縣,三義鄉,0125,483,104,587,24,611,983,62.16%,49.14%,1
苗栗縣,三義鄉,0126,485,126,611,37,648,1080,60%,44.91%,1
苗栗縣,三義鄉,0127,523,99,622,26,648,1216,53.29%,43.01%,1
苗栗縣,三義鄉,0128,494,80,574,29,603,1017,59.29%,48.57%,1
苗栗縣,三義鄉,0129,489,116,605,28,633,1180,53.64%,41.44%,1
苗栗縣,三義鄉,0130,569,95,664,20,684,1198,57.1%,47.5%,1
苗栗縣,三義鄉,0131,179,46,225,16,241,417,57.79%,42.93%,1
苗栗縣,三義鄉,0132,391,101,492,24,516,991,52.07%,39.46%,1
苗栗縣,三義鄉,0133,381,89,470,17,487,834,58.39%,45.68%,1
苗栗縣,三義鄉,0134,254,81,335,31,366,622,58.84%,40.84%,1
苗栗縣,三義鄉,0135,338,86,424,36,460,749,61.42%,45.13%,1
苗栗縣,三義鄉,0136,338,94,432,28,460,692,66.47%,48.84%,1
苗栗縣,三義鄉,0137,396,100,496,39,535,759,70.49%,52.17%,1
苗栗縣,三義鄉,0138,238,72,310,25,335,629,53.26%,37.84%,1
苗栗縣,三義鄉,0139,272,83,355,31,386,669,57.7%,40.66%,1
苗栗縣,西湖鄉,0140,238,66,304,21,325,601,54.08%,39.6%,1
苗栗縣,西湖鄉,0141,249,71,320,21,341,566,60.25%,43.99%,1
苗栗縣,西湖鄉,0142,352,106,458,32,490,843,58.13%,41.76%,1
苗栗縣,西湖鄉,0143,257,65,322,22,344,648,53.09%,39.66%,1
苗栗縣,西湖鄉,0144,349,95,444,30,474,936,50.64%,37.29%,1
苗栗縣,西湖鄉,0145,178,52,230,16,246,461,53.36%,38.61%,1
苗栗縣,西湖鄉,0146,222,59,281,12,293,515,56.89%,43.11%,1
苗栗縣,西湖鄉,0147,431,121,552,63,615,1141,53.9%,37.77%,1
苗栗縣,西湖鄉,0148,296,68,364,30,394,671,58.72%,44.11%,1
苗栗縣,造橋鄉,0258,571,131,702,62,764,1171,65.24%,48.76%,1
苗栗縣,造橋鄉,0259,405,87,492,36,528,889,59.39%,45.56%,1
苗栗縣,造橋鄉,0260,173,40,213,24,237,479,49.48%,36.12%,1
苗栗縣,造橋鄉,0261,441,123,564,36,600,1024,58.59%,43.07%,1
苗栗縣,造橋鄉,0262,465,128,593,64,657,1214,54.12%,38.3%,1
苗栗縣,造橋鄉,0263,380,132,512,50,562,1071,52.47%,35.48%,1
苗栗縣,造橋鄉,0264,439,117,556,51,607,1157,52.46%,37.94%,1
苗栗縣,造橋鄉,0265,208,53,261,36,297,512,58.01%,40.63%,1
苗栗縣,造橋鄉,0266,225,60,285,25,310,491,63.14%,45.82%,1
苗栗縣,造橋鄉,0267,553,148,701,65,766,1272,60.22%,43.47%,1
苗栗縣,造橋鄉,0268,315,95,410,42,452,785,57.58%,40.13%,1
苗栗縣,造橋鄉,0269,386,147,533,100,633,962,65.8%,40.12%,1
苗栗縣,三灣鄉,0402,437,113,550,44,594,996,59.64%,43.88%,1
苗栗縣,三灣鄉,0403,482,137,619,72,691,1205,57.34%,40%,1
苗栗縣,三灣鄉,0404,253,101,354,33,387,635,60.94%,39.84%,1
苗栗縣,三灣鄉,0405,334,120,454,39,493,862,57.19%,38.75%,1
苗栗縣,三灣鄉,0406,83,23,106,12,118,238,49.58%,34.87%,1
苗栗縣,三灣鄉,0407,196,64,260,33,293,541,54.16%,36.23%,1
苗栗縣,三灣鄉,0408,206,65,271,28,299,578,51.73%,35.64%,1
苗栗縣,三灣鄉,0409,180,64,244,34,278,405,68.64%,44.44%,1
苗栗縣,三灣鄉,0410,142,55,197,25,222,392,56.63%,36.22%,1
苗栗縣,獅潭鄉,0435,96,23,119,8,127,328,38.72%,29.27%,1
苗栗縣,獅潭鄉,0436,147,61,208,41,249,565,44.07%,26.02%,1
苗栗縣,獅潭鄉,0437,369,93,462,62,524,911,57.52%,40.5%,1
苗栗縣,獅潭鄉,0438,193,47,240,26,266,568,46.83%,33.98%,1
苗栗縣,獅潭鄉,0439,250,66,316,25,341,580,58.79%,43.1%,1
苗栗縣,獅潭鄉,0440,128,29,157,9,166,333,49.85%,38.44%,1
苗栗縣,獅潭鄉,0441,267,55,322,23,345,683,50.51%,39.09%,1
苗栗縣,泰安鄉,0461,100,29,129,17,146,325,44.92%,30.77%,1
苗栗縣,泰安鄉,0462,195,68,263,23,286,484,59.09%,40.29%,1
苗栗縣,泰安鄉,0463,337,100,437,48,485,666,72.82%,50.6%,1
苗栗縣,泰安鄉,0464,273,72,345,44,389,574,67.77%,47.56%,1
苗栗縣,泰安鄉,0465,135,21,156,13,169,333,50.75%,40.54%,1
苗栗縣,泰安鄉,0466,253,65,318,17,335,495,67.68%,51.11%,1
苗栗縣,泰安鄉,0467,265,90,355,38,393,544,72.24%,48.71%,1
苗栗縣,泰安鄉,0468,152,60,212,23,235,500,47%,30.4%,1
苗栗縣,泰安鄉,0469,325,106,431,46,477,670,71.19%,48.51%,1
苗栗縣,泰安鄉,0470,359,77,436,6,442,589,75.04%,60.95%,1
彰化縣,彰化市,0001,378,108,486,38,524,871,60.16%,43.4%,1
彰化縣,彰化市,0002,241,80,321,40,361,751,48.07%,32.09%,1
彰化縣,彰化市,0003,424,132,556,51,607,923,65.76%,45.94%,1
彰化縣,彰化市,0004,312,122,434,49,483,779,62%,40.05%,1
彰化縣,彰化市,0005,334,111,445,33,478,779,61.36%,42.88%,1
彰化縣,彰化市,0006,276,110,386,38,424,720,58.89%,38.33%,1
彰化縣,彰化市,0007,304,101,405,40,445,749,59.41%,40.59%,1
彰化縣,彰化市,0008,362,96,458,42,500,767,65.19%,47.2%,1
彰化縣,彰化市,0009,437,153,590,63,653,1047,62.37%,41.74%,1
彰化縣,彰化市,0010,404,140,544,41,585,1027,56.96%,39.34%,1
彰化縣,彰化市,0011,523,143,666,56,722,1249,57.81%,41.87%,1
彰化縣,彰化市,0012,474,149,623,46,669,1136,58.89%,41.73%,1
彰化縣,彰化市,0013,529,139,668,57,725,1169,62.02%,45.25%,1
彰化縣,彰化市,0014,340,113,453,30,483,766,63.05%,44.39%,1
彰化縣,彰化市,0015,277,80,357,19,376,643,58.48%,43.08%,1
彰化縣,彰化市,0016,557,121,678,63,741,1251,59.23%,44.52%,1
彰化縣,彰化市,0017,351,116,467,41,508,1301,39.05%,26.98%,1
彰化縣,彰化市,0018,566,161,727,40,767,1280,59.92%,44.22%,1
彰化縣,彰化市,0019,542,142,684,41,725,1179,61.49%,45.97%,1
彰化縣,彰化市,0020,512,144,656,32,688,1168,58.9%,43.84%,1
彰化縣,彰化市,0021,531,139,670,48,718,1218,58.95%,43.6%,1
彰化縣,彰化市,0022,634,201,835,37,872,1351,64.54%,46.93%,1
彰化縣,彰化市,0023,625,63,688,30,718,1204,59.63%,51.91%,1
彰化縣,彰化市,0024,541,152,693,17,710,1189,59.71%,45.5%,1
彰化縣,彰化市,0025,476,160,636,57,693,1207,57.42%,39.44%,1
彰化縣,彰化市,0026,523,18,541,51,592,1161,50.99%,45.05%,1
彰化縣,彰化市,0027,446,169,615,40,655,1166,56.17%,38.25%,1
彰化縣,彰化市,0028,632,147,779,56,835,1362,61.31%,46.4%,1
彰化縣,彰化市,0029,540,190,730,40,770,1236,62.3%,43.69%,1
彰化縣,彰化市,0030,480,123,603,43,646,1065,60.66%,45.07%,1
彰化縣,彰化市,0031,514,158,672,51,723,1199,60.3%,42.87%,1
彰化縣,彰化市,0032,537,170,707,34,741,1233,60.1%,43.55%,1
彰化縣,彰化市,0033,551,130,681,41,722,1245,57.99%,44.26%,1
彰化縣,彰化市,0034,493,180,673,36,709,1153,61.49%,42.76%,1
彰化縣,彰化市,0035,439,112,551,43,594,1045,56.84%,42.01%,1
彰化縣,彰化市,0036,471,144,615,15,630,1097,57.43%,42.94%,1
彰化縣,彰化市,0037,488,152,640,53,693,1190,58.24%,41.01%,1
彰化縣,彰化市,0038,476,160,636,56,692,1106,62.57%,43.04%,1
彰化縣,彰化市,0039,500,131,631,30,661,1097,60.26%,45.58%,1
彰化縣,彰化市,0040,427,163,590,50,640,1048,61.07%,40.74%,1
彰化縣,彰化市,0041,445,131,576,39,615,980,62.76%,45.41%,1
彰化縣,彰化市,0042,304,108,412,27,439,707,62.09%,43%,1
彰化縣,彰化市,0043,347,103,450,41,491,809,60.69%,42.89%,1
彰化縣,彰化市,0044,428,153,581,50,631,1008,62.6%,42.46%,1
彰化縣,彰化市,0045,341,118,459,58,517,901,57.38%,37.85%,1
彰化縣,彰化市,0046,400,119,519,29,548,951,57.62%,42.06%,1
彰化縣,彰化市,0047,466,141,607,42,649,1076,60.32%,43.31%,1
彰化縣,彰化市,0048,391,103,494,33,527,1022,51.57%,38.26%,1
彰化縣,彰化市,0049,373,119,492,44,536,894,59.96%,41.72%,1
彰化縣,彰化市,0050,457,127,584,43,627,1016,61.71%,44.98%,1
彰化縣,彰化市,0051,317,130,447,48,495,771,64.2%,41.12%,1
彰化縣,彰化市,0052,344,137,481,43,524,868,60.37%,39.63%,1
彰化縣,彰化市,0053,448,178,626,63,689,1135,60.7%,39.47%,1
彰化縣,彰化市,0054,356,136,492,65,557,910,61.21%,39.12%,1
彰化縣,彰化市,0055,406,162,568,42,610,1004,60.76%,40.44%,1
彰化縣,彰化市,0056,498,132,630,42,672,1077,62.4%,46.24%,1
彰化縣,彰化市,0057,625,153,778,50,828,1258,65.82%,49.68%,1
彰化縣,彰化市,0058,479,131,610,42,652,1025,63.61%,46.73%,1
彰化縣,彰化市,0059,534,150,684,59,743,1177,63.13%,45.37%,1
彰化縣,彰化市,0060,531,132,663,52,715,1262,56.66%,42.08%,1
彰化縣,彰化市,0061,473,149,622,58,680,1209,56.24%,39.12%,1
彰化縣,彰化市,0062,458,156,614,46,660,1041,63.4%,44%,1
彰化縣,彰化市,0063,510,123,633,37,670,1075,62.33%,47.44%,1
彰化縣,彰化市,0064,438,101,539,52,591,1029,57.43%,42.57%,1
彰化縣,彰化市,0065,476,146,622,76,698,1203,58.02%,39.57%,1
彰化縣,彰化市,0066,434,106,540,43,583,1014,57.5%,42.8%,1
彰化縣,彰化市,0067,479,131,610,35,645,1069,60.34%,44.81%,1
彰化縣,彰化市,0068,371,98,469,28,497,969,51.29%,38.29%,1
彰化縣,彰化市,0069,403,137,540,31,571,1105,51.67%,36.47%,1
彰化縣,彰化市,0070,449,138,587,42,629,981,64.12%,45.77%,1
彰化縣,彰化市,0071,462,167,629,57,686,1095,62.65%,42.19%,1
彰化縣,彰化市,0072,493,140,633,34,667,1087,61.36%,45.35%,1
彰化縣,彰化市,0073,459,138,597,37,634,1050,60.38%,43.71%,1
彰化縣,彰化市,0074,551,165,716,51,767,1252,61.26%,44.01%,1
彰化縣,彰化市,0075,455,126,581,32,613,1113,55.08%,40.88%,1
彰化縣,彰化市,0076,482,118,600,35,635,1009,62.93%,47.77%,1
彰化縣,彰化市,0077,417,120,537,40,577,999,57.76%,41.74%,1
彰化縣,彰化市,0078,420,153,573,25,598,997,59.98%,42.13%,1
彰化縣,彰化市,0079,557,149,706,38,744,1145,64.98%,48.65%,1
彰化縣,彰化市,0080,537,159,696,27,723,1227,58.92%,43.77%,1
彰化縣,彰化市,0081,541,177,718,34,752,1208,62.25%,44.78%,1
彰化縣,彰化市,0082,712,178,890,38,928,1598,58.07%,44.56%,1
彰化縣,彰化市,0083,402,104,506,43,549,890,61.69%,45.17%,1
彰化縣,彰化市,0084,517,167,684,27,711,1104,64.4%,46.83%,1
彰化縣,彰化市,0085,477,127,604,27,631,1097,57.52%,43.48%,1
彰化縣,彰化市,0086,347,76,423,43,466,799,58.32%,43.43%,1
彰化縣,彰化市,0087,455,123,578,42,620,1000,62%,45.5%,1
彰化縣,彰化市,0088,461,136,597,80,677,1153,58.72%,39.98%,1
彰化縣,彰化市,0089,433,117,550,52,602,977,61.62%,44.32%,1
彰化縣,彰化市,0090,492,147,639,57,696,1201,57.95%,40.97%,1
彰化縣,彰化市,0091,435,169,604,60,664,1057,62.82%,41.15%,1
彰化縣,彰化市,0092,485,171,656,70,726,1238,58.64%,39.18%,1
彰化縣,彰化市,0093,546,159,705,42,747,1210,61.74%,45.12%,1
彰化縣,彰化市,0094,462,128,590,47,637,1026,62.09%,45.03%,1
彰化縣,彰化市,0095,515,157,672,39,711,1061,67.01%,48.54%,1
彰化縣,彰化市,0096,527,146,673,50,723,1213,59.6%,43.45%,1
彰化縣,彰化市,0097,580,157,737,35,772,1264,61.08%,45.89%,1
彰化縣,彰化市,0098,298,118,416,48,464,691,67.15%,43.13%,1
彰化縣,彰化市,0099,384,144,528,48,576,893,64.5%,43%,1
彰化縣,彰化市,0100,300,112,412,44,456,733,62.21%,40.93%,1
彰化縣,彰化市,0101,293,107,400,44,444,692,64.16%,42.34%,1
彰化縣,彰化市,0102,302,91,393,40,433,728,59.48%,41.48%,1
彰化縣,彰化市,0103,345,120,465,36,501,773,64.81%,44.63%,1
彰化縣,彰化市,0104,378,91,469,21,490,975,50.26%,38.77%,1
彰化縣,彰化市,0105,394,113,507,46,553,908,60.9%,43.39%,1
彰化縣,彰化市,0106,495,166,661,7,668,1156,57.79%,42.82%,1
彰化縣,彰化市,0107,516,172,688,63,751,1235,60.81%,41.78%,1
彰化縣,彰化市,0108,588,150,738,45,783,1376,56.9%,42.73%,1
彰化縣,彰化市,0109,599,158,757,32,789,1389,56.8%,43.12%,1
彰化縣,彰化市,0110,373,134,507,52,559,846,66.08%,44.09%,1
彰化縣,彰化市,0111,414,106,520,33,553,859,64.38%,48.2%,1
彰化縣,彰化市,0112,338,121,459,23,482,781,61.72%,43.28%,1
彰化縣,彰化市,0113,372,107,479,43,522,875,59.66%,42.51%,1
彰化縣,彰化市,0114,338,113,451,33,484,816,59.31%,41.42%,1
彰化縣,彰化市,0115,300,100,400,38,438,687,63.76%,43.67%,1
彰化縣,彰化市,0116,333,93,426,48,474,727,65.2%,45.8%,1
彰化縣,彰化市,0117,307,94,401,26,427,662,64.5%,46.37%,1
彰化縣,彰化市,0118,300,83,383,21,404,633,63.82%,47.39%,1
彰化縣,彰化市,0119,432,117,549,38,587,906,64.79%,47.68%,1
彰化縣,彰化市,0120,349,101,450,42,492,853,57.68%,40.91%,1
彰化縣,彰化市,0121,491,112,603,41,644,1027,62.71%,47.81%,1
彰化縣,彰化市,0122,481,125,606,40,646,993,65.06%,48.44%,1
彰化縣,彰化市,0123,361,115,476,46,522,848,61.56%,42.57%,1
彰化縣,彰化市,0124,526,152,678,26,704,1118,62.97%,47.05%,1
彰化縣,彰化市,0125,514,184,698,72,770,1263,60.97%,40.7%,1
彰化縣,彰化市,0126,585,159,744,54,798,1268,62.93%,46.14%,1
彰化縣,彰化市,0127,568,150,718,58,776,1258,61.69%,45.15%,1
彰化縣,彰化市,0128,571,141,712,31,743,1212,61.3%,47.11%,1
彰化縣,彰化市,0129,404,103,507,66,573,924,62.01%,43.72%,1
彰化縣,彰化市,0130,435,119,554,42,596,939,63.47%,46.33%,1
彰化縣,彰化市,0131,434,138,572,69,641,953,67.26%,45.54%,1
彰化縣,彰化市,0132,473,128,601,48,649,981,66.16%,48.22%,1
彰化縣,彰化市,0133,567,164,731,72,803,1249,64.29%,45.4%,1
彰化縣,彰化市,0134,355,98,453,58,511,817,62.55%,43.45%,1
彰化縣,彰化市,0135,366,117,483,49,532,872,61.01%,41.97%,1
彰化縣,彰化市,0136,288,82,370,32,402,689,58.35%,41.8%,1
彰化縣,彰化市,0137,564,125,689,37,726,1156,62.8%,48.79%,1
彰化縣,彰化市,0138,558,153,711,29,740,1291,57.32%,43.22%,1
彰化縣,彰化市,0139,509,120,629,27,656,1139,57.59%,44.69%,1
彰化縣,彰化市,0140,511,137,648,50,698,1125,62.04%,45.42%,1
彰化縣,彰化市,0141,501,160,661,52,713,1258,56.68%,39.83%,1
彰化縣,彰化市,0142,487,134,621,43,664,1123,59.13%,43.37%,1
彰化縣,彰化市,0143,516,133,649,52,701,1175,59.66%,43.91%,1
彰化縣,彰化市,0144,384,147,531,39,570,862,66.13%,44.55%,1
彰化縣,彰化市,0145,355,135,490,38,528,872,60.55%,40.71%,1
彰化縣,彰化市,0146,442,111,553,26,579,897,64.55%,49.28%,1
彰化縣,彰化市,0147,412,120,532,27,559,1003,55.73%,41.08%,1
彰化縣,彰化市,0148,384,103,487,21,508,915,55.52%,41.97%,1
彰化縣,彰化市,0149,485,135,620,48,668,1158,57.69%,41.88%,1
彰化縣,彰化市,0150,510,135,645,38,683,1084,63.01%,47.05%,1
彰化縣,彰化市,0151,660,153,813,65,878,1372,63.99%,48.1%,1
彰化縣,彰化市,0152,479,141,620,59,679,1113,61.01%,43.04%,1
彰化縣,彰化市,0153,371,104,475,31,506,800,63.25%,46.38%,1
彰化縣,彰化市,0154,362,115,477,53,530,885,59.89%,40.9%,1
彰化縣,彰化市,0155,477,106,583,23,606,1000,60.6%,47.7%,1
彰化縣,彰化市,0156,471,123,594,38,632,1159,54.53%,40.64%,1
彰化縣,彰化市,0157,478,118,596,41,637,1123,56.72%,42.56%,1
彰化縣,彰化市,0158,410,120,530,64,594,907,65.49%,45.2%,1
彰化縣,彰化市,0159,394,104,498,63,561,989,56.72%,39.84%,1
彰化縣,彰化市,0160,451,122,573,65,638,1012,63.04%,44.57%,1
彰化縣,彰化市,0161,416,96,512,29,541,1033,52.37%,40.27%,1
彰化縣,彰化市,0162,496,193,689,42,731,1116,65.5%,44.44%,1
彰化縣,彰化市,0163,554,124,678,34,712,1154,61.7%,48.01%,1
彰化縣,彰化市,0164,500,113,613,47,660,1064,62.03%,46.99%,1
彰化縣,彰化市,0165,368,95,463,40,503,770,65.32%,47.79%,1
彰化縣,彰化市,0166,390,127,517,40,557,889,62.65%,43.87%,1
彰化縣,彰化市,0167,350,103,453,48,501,786,63.74%,44.53%,1
彰化縣,彰化市,0168,413,154,567,46,613,1120,54.73%,36.88%,1
彰化縣,彰化市,0169,489,150,639,35,674,1269,53.11%,38.53%,1
彰化縣,彰化市,0170,504,140,644,62,706,1159,60.91%,43.49%,1
彰化縣,彰化市,0171,499,165,664,62,726,1184,61.32%,42.15%,1
彰化縣,彰化市,0172,455,138,593,42,635,1089,58.31%,41.78%,1
彰化縣,彰化市,0173,424,131,555,50,605,968,62.5%,43.8%,1
彰化縣,彰化市,0174,421,100,521,24,545,930,58.6%,45.27%,1
彰化縣,彰化市,0175,444,126,570,32,602,973,61.87%,45.63%,1
彰化縣,彰化市,0176,431,137,568,40,608,1184,51.35%,36.4%,1
彰化縣,彰化市,0177,432,115,547,67,614,1002,61.28%,43.11%,1
彰化縣,彰化市,0178,486,128,614,27,641,1148,55.84%,42.33%,1
彰化縣,彰化市,0179,487,117,604,42,646,1112,58.09%,43.79%,1
彰化縣,彰化市,0180,463,96,559,61,620,907,68.36%,51.05%,1
彰化縣,彰化市,0181,474,132,606,72,678,1112,60.97%,42.63%,1
彰化縣,彰化市,0182,292,83,375,48,423,823,51.4%,35.48%,1
彰化縣,彰化市,0183,645,133,778,84,862,1276,67.55%,50.55%,1
彰化縣,彰化市,0184,479,120,599,60,659,1161,56.76%,41.26%,1
彰化縣,鹿港鎮,0243,475,176,651,59,710,1140,62.28%,41.67%,1
彰化縣,鹿港鎮,0244,199,75,274,30,304,511,59.49%,38.94%,1
彰化縣,鹿港鎮,0245,292,84,376,25,401,857,46.79%,34.07%,1
彰化縣,鹿港鎮,0246,420,130,550,61,611,946,64.59%,44.4%,1
彰化縣,鹿港鎮,0247,404,124,528,35,563,945,59.58%,42.75%,1
彰化縣,鹿港鎮,0248,458,138,596,48,644,1097,58.71%,41.75%,1
彰化縣,鹿港鎮,0249,538,133,671,45,716,1479,48.41%,36.38%,1
彰化縣,鹿港鎮,0250,594,168,762,103,865,1425,60.7%,41.68%,1
彰化縣,鹿港鎮,0251,362,128,490,69,559,880,63.52%,41.14%,1
彰化縣,鹿港鎮,0252,457,128,585,73,658,1183,55.62%,38.63%,1
彰化縣,鹿港鎮,0253,444,134,578,73,651,1047,62.18%,42.41%,1
彰化縣,鹿港鎮,0254,415,132,547,23,570,1097,51.96%,37.83%,1
彰化縣,鹿港鎮,0255,413,126,539,54,593,1030,57.57%,40.1%,1
彰化縣,鹿港鎮,0256,488,132,620,45,665,1161,57.28%,42.03%,1
彰化縣,鹿港鎮,0257,228,63,291,51,342,540,63.33%,42.22%,1
彰化縣,鹿港鎮,0258,457,139,596,49,645,1135,56.83%,40.26%,1
彰化縣,鹿港鎮,0259,470,137,607,58,665,1155,57.58%,40.69%,1
彰化縣,鹿港鎮,0260,526,126,652,44,696,1127,61.76%,46.67%,1
彰化縣,鹿港鎮,0261,440,137,577,42,619,1045,59.23%,42.11%,1
彰化縣,鹿港鎮,0262,456,131,587,78,665,1127,59.01%,40.46%,1
彰化縣,鹿港鎮,0263,559,143,702,56,758,1178,64.35%,47.45%,1
彰化縣,鹿港鎮,0264,115,40,155,14,169,284,59.51%,40.49%,1
彰化縣,鹿港鎮,0265,247,63,310,35,345,584,59.08%,42.29%,1
彰化縣,鹿港鎮,0266,304,96,400,33,433,659,65.71%,46.13%,1
彰化縣,鹿港鎮,0267,342,122,464,21,485,915,53.01%,37.38%,1
彰化縣,鹿港鎮,0268,463,152,615,66,681,1079,63.11%,42.91%,1
彰化縣,鹿港鎮,0269,525,138,663,67,730,1129,64.66%,46.5%,1
彰化縣,鹿港鎮,0270,512,121,633,70,703,1273,55.22%,40.22%,1
彰化縣,鹿港鎮,0271,263,72,335,36,371,706,52.55%,37.25%,1
彰化縣,鹿港鎮,0272,413,113,526,104,630,1137,55.41%,36.32%,1
彰化縣,鹿港鎮,0273,476,133,609,53,662,1195,55.4%,39.83%,1
彰化縣,鹿港鎮,0274,485,114,599,63,662,1225,54.04%,39.59%,1
彰化縣,鹿港鎮,0275,441,129,570,60,630,957,65.83%,46.08%,1
彰化縣,鹿港鎮,0276,268,65,333,72,405,758,53.43%,35.36%,1
彰化縣,鹿港鎮,0277,286,88,374,56,430,723,59.47%,39.56%,1
彰化縣,鹿港鎮,0278,423,83,506,31,537,984,54.57%,42.99%,1
彰化縣,鹿港鎮,0279,490,99,589,54,643,1018,63.16%,48.13%,1
彰化縣,鹿港鎮,0280,466,123,589,56,645,1165,55.36%,40%,1
彰化縣,鹿港鎮,0281,425,124,549,61,610,1161,52.54%,36.61%,1
彰化縣,鹿港鎮,0282,499,14,513,44,557,1020,54.61%,48.92%,1
彰化縣,鹿港鎮,0283,409,141,550,65,615,1068,57.58%,38.3%,1
彰化縣,鹿港鎮,0284,429,134,563,42,605,1024,59.08%,41.89%,1
彰化縣,鹿港鎮,0285,395,111,506,90,596,974,61.19%,40.55%,1
彰化縣,鹿港鎮,0286,574,154,728,79,807,1505,53.62%,38.14%,1
彰化縣,鹿港鎮,0287,450,109,559,44,603,1092,55.22%,41.21%,1
彰化縣,鹿港鎮,0288,550,129,679,63,742,1223,60.67%,44.97%,1
彰化縣,鹿港鎮,0289,559,132,691,44,735,1572,46.76%,35.56%,1
彰化縣,鹿港鎮,0290,452,118,570,49,619,1003,61.71%,45.06%,1
彰化縣,鹿港鎮,0291,425,98,523,32,555,933,59.49%,45.55%,1
彰化縣,鹿港鎮,0292,485,119,604,59,663,1093,60.66%,44.37%,1
彰化縣,鹿港鎮,0293,382,96,478,29,507,907,55.9%,42.12%,1
彰化縣,鹿港鎮,0294,484,139,623,48,671,1219,55.05%,39.7%,1
彰化縣,鹿港鎮,0295,658,162,820,66,886,1397,63.42%,47.1%,1
彰化縣,鹿港鎮,0296,537,131,668,36,704,1229,57.28%,43.69%,1
彰化縣,鹿港鎮,0297,625,127,752,31,783,1444,54.22%,43.28%,1
彰化縣,鹿港鎮,0298,538,136,674,65,739,1227,60.23%,43.85%,1
彰化縣,鹿港鎮,0299,510,142,652,63,715,1187,60.24%,42.97%,1
彰化縣,鹿港鎮,0300,529,128,657,28,685,1296,52.85%,40.82%,1
彰化縣,鹿港鎮,0301,514,168,682,71,753,1451,51.9%,35.42%,1
彰化縣,鹿港鎮,0302,503,154,657,72,729,1299,56.12%,38.72%,1
彰化縣,鹿港鎮,0303,620,142,762,42,804,1298,61.94%,47.77%,1
彰化縣,鹿港鎮,0304,626,166,792,49,841,1458,57.68%,42.94%,1
彰化縣,鹿港鎮,0305,470,148,618,44,662,1138,58.17%,41.3%,1
彰化縣,鹿港鎮,0306,469,152,621,64,685,1170,58.55%,40.09%,1
彰化縣,鹿港鎮,0307,557,126,683,58,741,1221,60.69%,45.62%,1
彰化縣,和美鎮,0373,508,172,680,56,736,1341,54.88%,37.88%,1
彰化縣,和美鎮,0374,555,158,713,56,769,1480,51.96%,37.5%,1
彰化縣,和美鎮,0375,626,185,811,44,855,1529,55.92%,40.94%,1
彰化縣,和美鎮,0376,623,191,814,25,839,1711,49.04%,36.41%,1
彰化縣,和美鎮,0377,446,136,582,32,614,1057,58.09%,42.19%,1
彰化縣,和美鎮,0378,461,122,583,39,622,1032,60.27%,44.67%,1
彰化縣,和美鎮,0379,423,132,555,58,613,1015,60.39%,41.67%,1
彰化縣,和美鎮,0380,533,153,686,46,732,1209,60.55%,44.09%,1
彰化縣,和美鎮,0381,181,55,236,15,251,430,58.37%,42.09%,1
彰化縣,和美鎮,0382,343,103,446,19,465,856,54.32%,40.07%,1
彰化縣,和美鎮,0383,463,104,567,27,594,966,61.49%,47.93%,1
彰化縣,和美鎮,0384,410,134,544,36,580,1059,54.77%,38.72%,1
彰化縣,和美鎮,0385,474,127,601,34,635,1117,56.85%,42.44%,1
彰化縣,和美鎮,0386,411,130,541,50,591,1066,55.44%,38.56%,1
彰化縣,和美鎮,0387,485,140,625,49,674,1252,53.83%,38.74%,1
彰化縣,和美鎮,0388,596,164,760,45,805,1528,52.68%,39.01%,1
彰化縣,和美鎮,0389,356,104,460,35,495,826,59.93%,43.1%,1
彰化縣,和美鎮,0390,364,88,452,29,481,854,56.32%,42.62%,1
彰化縣,和美鎮,0391,531,157,688,50,738,1387,53.21%,38.28%,1
彰化縣,和美鎮,0392,352,100,452,26,478,765,62.48%,46.01%,1
彰化縣,和美鎮,0393,565,137,702,48,750,1438,52.16%,39.29%,1
彰化縣,和美鎮,0394,613,151,764,66,830,1396,59.46%,43.91%,1
彰化縣,和美鎮,0395,276,78,354,25,379,658,57.6%,41.95%,1
彰化縣,和美鎮,0396,372,114,486,29,515,809,63.66%,45.98%,1
彰化縣,和美鎮,0397,362,103,465,15,480,932,51.5%,38.84%,1
彰化縣,和美鎮,0398,359,96,455,32,487,888,54.84%,40.43%,1
彰化縣,和美鎮,0399,500,148,648,50,698,1144,61.01%,43.71%,1
彰化縣,和美鎮,0400,470,100,570,39,609,1077,56.55%,43.64%,1
彰化縣,和美鎮,0401,498,155,653,58,711,1349,52.71%,36.92%,1
彰化縣,和美鎮,0402,500,164,664,57,721,1155,62.42%,43.29%,1
彰化縣,和美鎮,0403,546,117,663,32,695,1253,55.47%,43.58%,1
彰化縣,和美鎮,0404,519,123,642,42,684,1252,54.63%,41.45%,1
彰化縣,和美鎮,0405,662,100,762,32,794,1474,53.87%,44.91%,1
彰化縣,和美鎮,0406,531,130,661,35,696,1396,49.86%,38.04%,1
彰化縣,和美鎮,0407,493,161,654,53,707,1348,52.45%,36.57%,1
彰化縣,和美鎮,0408,459,126,585,35,620,999,62.06%,45.95%,1
彰化縣,和美鎮,0409,385,115,500,46,546,911,59.93%,42.26%,1
彰化縣,和美鎮,0410,414,146,560,30,590,1005,58.71%,41.19%,1
彰化縣,和美鎮,0411,410,107,517,44,561,967,58.01%,42.4%,1
彰化縣,和美鎮,0412,553,174,727,37,764,1308,58.41%,42.28%,1
彰化縣,和美鎮,0413,564,139,703,38,741,1324,55.97%,42.6%,1
彰化縣,和美鎮,0414,444,161,605,53,658,1102,59.71%,40.29%,1
彰化縣,和美鎮,0415,437,131,568,51,619,1124,55.07%,38.88%,1
彰化縣,和美鎮,0416,506,135,641,63,704,1211,58.13%,41.78%,1
彰化縣,和美鎮,0417,433,122,555,39,594,884,67.19%,48.98%,1
彰化縣,和美鎮,0418,439,149,588,64,652,1119,58.27%,39.23%,1
彰化縣,和美鎮,0419,527,136,663,62,725,1300,55.77%,40.54%,1
彰化縣,和美鎮,0420,436,126,562,44,606,1104,54.89%,39.49%,1
彰化縣,和美鎮,0421,586,145,731,7,738,1213,60.84%,48.31%,1
彰化縣,和美鎮,0422,403,135,538,41,579,1127,51.38%,35.76%,1
彰化縣,和美鎮,0423,382,91,473,51,524,919,57.02%,41.57%,1
彰化縣,和美鎮,0424,472,119,591,1,592,987,59.98%,47.82%,1
彰化縣,和美鎮,0425,408,136,544,48,592,958,61.8%,42.59%,1
彰化縣,和美鎮,0426,592,153,745,44,789,1362,57.93%,43.47%,1
彰化縣,和美鎮,0427,612,157,769,24,793,1461,54.28%,41.89%,1
彰化縣,和美鎮,0428,614,153,767,31,798,1405,56.8%,43.7%,1
彰化縣,和美鎮,0429,374,102,476,45,521,860,60.58%,43.49%,1
彰化縣,和美鎮,0430,367,80,447,25,472,875,53.94%,41.94%,1
彰化縣,和美鎮,0431,362,105,467,39,506,871,58.09%,41.56%,1
彰化縣,和美鎮,0432,389,112,501,49,550,883,62.29%,44.05%,1
彰化縣,和美鎮,0433,469,138,607,69,676,1224,55.23%,38.32%,1
彰化縣,和美鎮,0434,446,103,549,49,598,1075,55.63%,41.49%,1
彰化縣,和美鎮,0435,389,108,497,44,541,956,56.59%,40.69%,1
彰化縣,和美鎮,0436,418,111,529,51,580,1037,55.93%,40.31%,1
彰化縣,和美鎮,0437,431,101,532,25,557,1011,55.09%,42.63%,1
彰化縣,和美鎮,0438,390,130,520,54,574,1023,56.11%,38.12%,1
彰化縣,和美鎮,0439,274,85,359,31,390,719,54.24%,38.11%,1
彰化縣,和美鎮,0440,358,116,474,42,516,913,56.52%,39.21%,1
彰化縣,線西鄉,0469,466,103,569,35,604,1071,56.4%,43.51%,1
彰化縣,線西鄉,0470,512,135,647,44,691,1166,59.26%,43.91%,1
彰化縣,線西鄉,0471,552,132,684,68,752,1269,59.26%,43.5%,1
彰化縣,線西鄉,0472,460,141,601,50,651,1138,57.21%,40.42%,1
彰化縣,線西鄉,0473,487,158,645,76,721,1128,63.92%,43.17%,1
彰化縣,線西鄉,0474,528,149,677,86,763,1275,59.84%,41.41%,1
彰化縣,線西鄉,0475,502,150,652,55,707,1187,59.56%,42.29%,1
彰化縣,線西鄉,0476,404,141,545,58,603,991,60.85%,40.77%,1
彰化縣,線西鄉,0477,380,113,493,68,561,938,59.81%,40.51%,1
彰化縣,線西鄉,0478,488,132,620,60,680,1276,53.29%,38.24%,1
彰化縣,線西鄉,0479,538,161,699,57,756,1285,58.83%,41.87%,1
彰化縣,線西鄉,0480,640,170,810,65,875,1341,65.25%,47.73%,1
彰化縣,伸港鄉,0441,453,98,551,43,594,1182,50.25%,38.32%,1
彰化縣,伸港鄉,0442,560,123,683,37,720,1166,61.75%,48.03%,1
彰化縣,伸港鄉,0443,400,109,509,51,560,966,57.97%,41.41%,1
彰化縣,伸港鄉,0444,362,80,442,44,486,873,55.67%,41.47%,1
彰化縣,伸港鄉,0445,365,81,446,46,492,812,60.59%,44.95%,1
彰化縣,伸港鄉,0446,369,90,459,33,492,875,56.23%,42.17%,1
彰化縣,伸港鄉,0447,350,105,455,49,504,904,55.75%,38.72%,1
彰化縣,伸港鄉,0448,421,95,516,44,560,1008,55.56%,41.77%,1
彰化縣,伸港鄉,0449,554,72,626,58,684,1154,59.27%,48.01%,1
彰化縣,伸港鄉,0450,542,165,707,77,784,1486,52.76%,36.47%,1
彰化縣,伸港鄉,0451,436,122,558,50,608,1095,55.53%,39.82%,1
彰化縣,伸港鄉,0452,410,118,528,30,558,1087,51.33%,37.72%,1
彰化縣,伸港鄉,0453,440,149,589,58,647,1085,59.63%,40.55%,1
彰化縣,伸港鄉,0454,399,109,508,35,543,908,59.8%,43.94%,1
彰化縣,伸港鄉,0455,593,125,718,47,765,1264,60.52%,46.91%,1
彰化縣,伸港鄉,0456,318,99,417,53,470,854,55.04%,37.24%,1
彰化縣,伸港鄉,0457,312,82,394,32,426,846,50.35%,36.88%,1
彰化縣,伸港鄉,0458,387,119,506,103,609,1143,53.28%,33.86%,1
彰化縣,伸港鄉,0459,569,146,715,34,749,1357,55.2%,41.93%,1
彰化縣,伸港鄉,0460,511,166,677,71,748,1349,55.45%,37.88%,1
彰化縣,伸港鄉,0461,490,129,619,57,676,1154,58.58%,42.46%,1
彰化縣,伸港鄉,0462,526,131,657,39,696,1279,54.42%,41.13%,1
彰化縣,伸港鄉,0463,547,166,713,61,774,1317,58.77%,41.53%,1
彰化縣,伸港鄉,0464,435,124,559,49,608,990,61.41%,43.94%,1
彰化縣,伸港鄉,0465,378,89,467,36,503,852,59.04%,44.37%,1
彰化縣,伸港鄉,0466,501,139,640,35,675,1178,57.3%,42.53%,1
彰化縣,伸港鄉,0467,410,132,542,76,618,1088,56.8%,37.68%,1
彰化縣,伸港鄉,0468,465,127,592,54,646,1135,56.92%,40.97%,1
彰化縣,福興鄉,0308,487,195,682,58,740,1363,54.29%,35.73%,1
彰化縣,福興鄉,0309,351,95,446,39,485,821,59.07%,42.75%,1
彰化縣,福興鄉,0310,486,111,597,60,657,1256,52.31%,38.69%,1
彰化縣,福興鄉,0311,404,137,541,94,635,1166,54.46%,34.65%,1
彰化縣,福興鄉,0312,500,211,711,52,763,1464,52.12%,34.15%,1
彰化縣,福興鄉,0313,486,128,614,51,665,1251,53.16%,38.85%,1
彰化縣,福興鄉,0314,562,154,716,58,774,1465,52.83%,38.36%,1
彰化縣,福興鄉,0315,334,104,438,32,470,960,48.96%,34.79%,1
彰化縣,福興鄉,0316,470,167,637,79,716,1323,54.12%,35.53%,1
彰化縣,福興鄉,0317,533,156,689,64,753,1365,55.16%,39.05%,1
彰化縣,福興鄉,0318,457,139,596,50,646,1458,44.31%,31.34%,1
彰化縣,福興鄉,0319,537,158,695,89,784,1492,52.55%,35.99%,1
彰化縣,福興鄉,0320,299,97,396,29,425,888,47.86%,33.67%,1
彰化縣,福興鄉,0321,428,135,563,62,625,1054,59.3%,40.61%,1
彰化縣,福興鄉,0322,388,81,469,52,521,1043,49.95%,37.2%,1
彰化縣,福興鄉,0323,487,172,659,82,741,1340,55.3%,36.34%,1
彰化縣,福興鄉,0324,382,131,513,38,551,1085,50.78%,35.21%,1
彰化縣,福興鄉,0325,522,136,658,46,704,1392,50.57%,37.5%,1
彰化縣,福興鄉,0326,536,148,684,88,772,1316,58.66%,40.73%,1
彰化縣,福興鄉,0327,523,175,698,56,754,1255,60.08%,41.67%,1
彰化縣,福興鄉,0328,509,120,629,42,671,1101,60.94%,46.23%,1
彰化縣,福興鄉,0329,454,112,566,87,653,1167,55.96%,38.9%,1
彰化縣,福興鄉,0330,486,161,647,86,733,1393,52.62%,34.89%,1
彰化縣,福興鄉,0331,498,131,629,64,693,1216,56.99%,40.95%,1
彰化縣,福興鄉,0332,368,106,474,57,531,1063,49.95%,34.62%,1
彰化縣,福興鄉,0333,501,135,636,69,705,1306,53.98%,38.36%,1
彰化縣,福興鄉,0334,412,121,533,63,596,1287,46.31%,32.01%,1
彰化縣,福興鄉,0335,401,108,509,49,558,994,56.14%,40.34%,1
彰化縣,福興鄉,0336,527,123,650,91,741,1311,56.52%,40.2%,1
彰化縣,福興鄉,0337,389,111,500,49,549,926,59.29%,42.01%,1
彰化縣,福興鄉,0338,337,118,455,58,513,995,51.56%,33.87%,1
彰化縣,福興鄉,0339,447,138,585,88,673,1079,62.37%,41.43%,1
彰化縣,福興鄉,0340,415,106,521,84,605,1150,52.61%,36.09%,1
彰化縣,秀水鄉,0341,459,126,585,82,667,1066,62.57%,43.06%,1
彰化縣,秀水鄉,0342,271,80,351,46,397,620,64.03%,43.71%,1
彰化縣,秀水鄉,0343,333,92,425,16,441,876,50.34%,38.01%,1
彰化縣,秀水鄉,0344,507,181,688,48,736,1196,61.54%,42.39%,1
彰化縣,秀水鄉,0345,577,167,744,47,791,1369,57.78%,42.15%,1
彰化縣,秀水鄉,0346,527,173,700,57,757,1273,59.47%,41.4%,1
彰化縣,秀水鄉,0347,605,146,751,55,806,1433,56.25%,42.22%,1
彰化縣,秀水鄉,0348,435,109,544,26,570,967,58.95%,44.98%,1
彰化縣,秀水鄉,0349,409,103,512,23,535,921,58.09%,44.41%,1
彰化縣,秀水鄉,0350,316,78,394,40,434,689,62.99%,45.86%,1
彰化縣,秀水鄉,0351,286,97,383,38,421,688,61.19%,41.57%,1
彰化縣,秀水鄉,0352,530,190,720,60,780,1252,62.3%,42.33%,1
彰化縣,秀水鄉,0353,500,153,653,38,691,1281,53.94%,39.03%,1
彰化縣,秀水鄉,0354,294,99,393,23,416,754,55.17%,38.99%,1
彰化縣,秀水鄉,0355,393,138,531,51,582,1024,56.84%,38.38%,1
彰化縣,秀水鄉,0356,594,142,736,28,764,1433,53.31%,41.45%,1
彰化縣,秀水鄉,0357,617,208,825,52,877,1366,64.2%,45.17%,1
彰化縣,秀水鄉,0358,382,115,497,47,544,895,60.78%,42.68%,1
彰化縣,秀水鄉,0359,543,141,684,68,752,1386,54.26%,39.18%,1
彰化縣,秀水鄉,0360,357,122,479,65,544,896,60.71%,39.84%,1
彰化縣,秀水鄉,0361,376,117,493,35,528,804,65.67%,46.77%,1
彰化縣,秀水鄉,0362,409,85,494,24,518,827,62.64%,49.46%,1
彰化縣,秀水鄉,0363,432,120,552,41,593,996,59.54%,43.37%,1
彰化縣,秀水鄉,0364,443,129,572,47,619,931,66.49%,47.58%,1
彰化縣,秀水鄉,0365,270,98,368,35,403,715,56.36%,37.76%,1
彰化縣,秀水鄉,0366,532,177,709,58,767,1229,62.41%,43.29%,1
彰化縣,秀水鄉,0367,338,89,427,30,457,890,51.35%,37.98%,1
彰化縣,秀水鄉,0368,348,116,464,45,509,811,62.76%,42.91%,1
彰化縣,秀水鄉,0369,346,109,455,31,486,786,61.83%,44.02%,1
彰化縣,秀水鄉,0370,402,106,508,34,542,931,58.22%,43.18%,1
彰化縣,秀水鄉,0371,540,151,691,77,768,1265,60.71%,42.69%,1
彰化縣,秀水鄉,0372,342,82,424,40,464,824,56.31%,41.5%,1
彰化縣,花壇鄉,0185,388,104,492,49,541,901,60.04%,43.06%,1
彰化縣,花壇鄉,0186,467,128,595,36,631,1042,60.56%,44.82%,1
彰化縣,花壇鄉,0187,528,133,661,20,681,1314,51.83%,40.18%,1
彰化縣,花壇鄉,0188,332,93,425,56,481,808,59.53%,41.09%,1
彰化縣,花壇鄉,0189,416,127,543,43,586,1019,57.51%,40.82%,1
彰化縣,花壇鄉,0190,466,158,624,76,700,1144,61.19%,40.73%,1
彰化縣,花壇鄉,0191,506,119,625,105,730,1240,58.87%,40.81%,1
彰化縣,花壇鄉,0192,632,158,790,84,874,1425,61.33%,44.35%,1
彰化縣,花壇鄉,0193,477,138,615,71,686,1095,62.65%,43.56%,1
彰化縣,花壇鄉,0194,391,122,513,43,556,910,61.1%,42.97%,1
彰化縣,花壇鄉,0195,407,138,545,31,576,982,58.66%,41.45%,1
彰化縣,花壇鄉,0196,399,153,552,21,573,1070,53.55%,37.29%,1
彰化縣,花壇鄉,0197,268,87,355,18,373,700,53.29%,38.29%,1
彰化縣,花壇鄉,0198,339,116,455,45,500,764,65.45%,44.37%,1
彰化縣,花壇鄉,0199,417,129,546,55,601,953,63.06%,43.76%,1
彰化縣,花壇鄉,0200,423,107,530,25,555,974,56.98%,43.43%,1
彰化縣,花壇鄉,0201,441,138,579,68,647,1111,58.24%,39.69%,1
彰化縣,花壇鄉,0202,503,104,607,66,673,1101,61.13%,45.69%,1
彰化縣,花壇鄉,0203,457,110,567,44,611,1110,55.05%,41.17%,1
彰化縣,花壇鄉,0204,525,153,678,59,737,1262,58.4%,41.6%,1
彰化縣,花壇鄉,0205,452,164,616,32,648,1103,58.75%,40.98%,1
彰化縣,花壇鄉,0206,469,160,629,68,697,1347,51.74%,34.82%,1
彰化縣,花壇鄉,0207,459,126,585,49,634,1169,54.23%,39.26%,1
彰化縣,花壇鄉,0208,570,139,709,55,764,1274,59.97%,44.74%,1
彰化縣,花壇鄉,0209,606,147,753,41,794,1280,62.03%,47.34%,1
彰化縣,花壇鄉,0210,539,131,670,43,713,1244,57.32%,43.33%,1
彰化縣,花壇鄉,0211,476,145,621,59,680,1159,58.67%,41.07%,1
彰化縣,花壇鄉,0212,508,113,621,35,656,1042,62.96%,48.75%,1
彰化縣,花壇鄉,0213,436,157,593,44,637,1111,57.34%,39.24%,1
彰化縣,花壇鄉,0214,416,102,518,49,567,893,63.49%,46.58%,1
彰化縣,花壇鄉,0215,380,120,500,65,565,953,59.29%,39.87%,1
彰化縣,花壇鄉,0216,389,99,488,30,518,987,52.48%,39.41%,1
彰化縣,花壇鄉,0217,411,134,545,53,598,925,64.65%,44.43%,1
彰化縣,花壇鄉,0218,398,93,491,36,527,951,55.42%,41.85%,1
彰化縣,花壇鄉,0219,411,108,519,25,544,955,56.96%,43.04%,1
彰化縣,花壇鄉,0220,345,111,456,31,487,895,54.41%,38.55%,1
彰化縣,花壇鄉,0221,302,88,390,21,411,711,57.81%,42.48%,1
彰化縣,芬園鄉,0222,374,119,493,42,535,958,55.85%,39.04%,1
彰化縣,芬園鄉,0223,318,88,406,50,456,794,57.43%,40.05%,1
彰化縣,芬園鄉,0224,499,159,658,88,746,1415,52.72%,35.27%,1
彰化縣,芬園鄉,0225,436,102,538,32,570,927,61.49%,47.03%,1
彰化縣,芬園鄉,0226,353,82,435,39,474,831,57.04%,42.48%,1
彰化縣,芬園鄉,0227,224,72,296,27,323,570,56.67%,39.3%,1
彰化縣,芬園鄉,0228,465,125,590,48,638,1227,52%,37.9%,1
彰化縣,芬園鄉,0229,482,129,611,68,679,1238,54.85%,38.93%,1
彰化縣,芬園鄉,0230,550,168,718,67,785,1362,57.64%,40.38%,1
彰化縣,芬園鄉,0231,403,110,513,68,581,989,58.75%,40.75%,1
彰化縣,芬園鄉,0232,485,119,604,62,666,1054,63.19%,46.02%,1
彰化縣,芬園鄉,0233,293,75,368,29,397,607,65.4%,48.27%,1
彰化縣,芬園鄉,0234,390,101,491,45,536,882,60.77%,44.22%,1
彰化縣,芬園鄉,0235,415,106,521,41,562,1143,49.17%,36.31%,1
彰化縣,芬園鄉,0236,224,57,281,20,301,661,45.54%,33.89%,1
彰化縣,芬園鄉,0237,296,105,401,3,404,838,48.21%,35.32%,1
彰化縣,芬園鄉,0238,306,104,410,33,443,847,52.3%,36.13%,1
彰化縣,芬園鄉,0239,412,115,527,65,592,987,59.98%,41.74%,1
彰化縣,芬園鄉,0240,390,159,549,82,631,1217,51.85%,32.05%,1
彰化縣,芬園鄉,0241,279,98,377,69,446,865,51.56%,32.25%,1
彰化縣,芬園鄉,0242,353,143,496,43,539,996,54.12%,35.44%,1
彰化縣,員林市,0481,452,83,535,25,560,1087,51.52%,41.58%,1
彰化縣,員林市,0482,508,145,653,43,696,1353,51.44%,37.55%,1
彰化縣,員林市,0483,507,138,645,54,699,1313,53.24%,38.61%,1
彰化縣,員林市,0484,453,113,566,30,596,1328,44.88%,34.11%,1
彰化縣,員林市,0485,425,135,560,35,595,1055,56.4%,40.28%,1
彰化縣,員林市,0486,375,111,486,43,529,959,55.16%,39.1%,1
彰化縣,員林市,0487,303,106,409,42,451,772,58.42%,39.25%,1
彰化縣,員林市,0488,355,111,466,45,511,831,61.49%,42.72%,1
彰化縣,員林市,0489,279,59,338,11,349,854,40.87%,32.67%,1
彰化縣,員林市,0490,381,110,491,38,529,1190,44.45%,32.02%,1
彰化縣,員林市,0491,302,76,378,21,399,726,54.96%,41.6%,1
彰化縣,員林市,0492,429,133,562,65,627,1124,55.78%,38.17%,1
彰化縣,員林市,0493,278,117,395,57,452,860,52.56%,32.33%,1
彰化縣,員林市,0494,502,132,634,47,681,1122,60.7%,44.74%,1
彰化縣,員林市,0495,435,153,588,51,639,1075,59.44%,40.47%,1
彰化縣,員林市,0496,370,117,487,63,550,993,55.39%,37.26%,1
彰化縣,員林市,0497,392,85,477,28,505,967,52.22%,40.54%,1
彰化縣,員林市,0498,396,124,520,57,577,1008,57.24%,39.29%,1
彰化縣,員林市,0499,314,95,409,47,456,804,56.72%,39.05%,1
彰化縣,員林市,0500,342,102,444,31,475,867,54.79%,39.45%,1
彰化縣,員林市,0501,350,88,438,30,468,885,52.88%,39.55%,1
彰化縣,員林市,0502,370,80,450,19,469,1097,42.75%,33.73%,1
彰化縣,員林市,0503,524,104,628,35,663,1255,52.83%,41.75%,1
彰化縣,員林市,0504,446,118,564,50,614,1063,57.76%,41.96%,1
彰化縣,員林市,0505,325,160,485,32,517,925,55.89%,35.14%,1
彰化縣,員林市,0506,380,136,516,43,559,947,59.03%,40.13%,1
彰化縣,員林市,0507,384,134,518,28,546,916,59.61%,41.92%,1
彰化縣,員林市,0508,358,88,446,32,478,862,55.45%,41.53%,1
彰化縣,員林市,0509,408,126,534,21,555,987,56.23%,41.34%,1
彰化縣,員林市,0510,437,109,546,45,591,1085,54.47%,40.28%,1
彰化縣,員林市,0511,494,116,610,27,637,1110,57.39%,44.5%,1
彰化縣,員林市,0512,421,116,537,22,559,1095,51.05%,38.45%,1
彰化縣,員林市,0513,584,163,747,35,782,1278,61.19%,45.7%,1
彰化縣,員林市,0514,491,129,620,33,653,1109,58.88%,44.27%,1
彰化縣,員林市,0515,411,122,533,70,603,1055,57.16%,38.96%,1
彰化縣,員林市,0516,360,110,470,29,499,876,56.96%,41.1%,1
彰化縣,員林市,0517,369,137,506,51,557,1115,49.96%,33.09%,1
彰化縣,員林市,0518,521,126,647,42,689,1186,58.09%,43.93%,1
彰化縣,員林市,0519,447,114,561,40,601,995,60.4%,44.92%,1
彰化縣,員林市,0520,398,103,501,12,513,999,51.35%,39.84%,1
彰化縣,員林市,0521,512,113,625,33,658,1201,54.79%,42.63%,1
彰化縣,員林市,0522,548,153,701,39,740,1342,55.14%,40.83%,1
彰化縣,員林市,0523,420,127,547,27,574,1086,52.85%,38.67%,1
彰化縣,員林市,0524,322,99,421,37,458,854,53.63%,37.7%,1
彰化縣,員林市,0525,446,112,558,27,585,1064,54.98%,41.92%,1
彰化縣,員林市,0526,393,115,508,10,518,879,58.93%,44.71%,1
彰化縣,員林市,0527,430,99,529,27,556,827,67.23%,52%,1
彰化縣,員林市,0528,346,92,438,16,454,867,52.36%,39.91%,1
彰化縣,員林市,0529,507,132,639,38,677,1201,56.37%,42.21%,1
彰化縣,員林市,0530,484,118,602,40,642,1106,58.05%,43.76%,1
彰化縣,員林市,0531,338,123,461,43,504,845,59.64%,40%,1
彰化縣,員林市,0532,388,102,490,35,525,894,58.72%,43.4%,1
彰化縣,員林市,0533,363,100,463,39,502,849,59.13%,42.76%,1
彰化縣,員林市,0534,331,96,427,44,471,747,63.05%,44.31%,1
彰化縣,員林市,0535,401,119,520,32,552,884,62.44%,45.36%,1
彰化縣,員林市,0536,344,105,449,27,476,900,52.89%,38.22%,1
彰化縣,員林市,0537,397,109,506,37,543,1040,52.21%,38.17%,1
彰化縣,員林市,0538,323,110,433,20,453,831,54.51%,38.87%,1
彰化縣,員林市,0539,254,86,340,41,381,591,64.47%,42.98%,1
彰化縣,員林市,0540,515,153,668,54,722,1330,54.29%,38.72%,1
彰化縣,員林市,0541,575,130,705,29,734,1295,56.68%,44.4%,1
彰化縣,員林市,0542,498,159,657,58,715,1283,55.73%,38.82%,1
彰化縣,員林市,0543,408,124,532,36,568,943,60.23%,43.27%,1
彰化縣,員林市,0544,602,198,800,50,850,1388,61.24%,43.37%,1
彰化縣,員林市,0545,506,138,644,37,681,1176,57.91%,43.03%,1
彰化縣,員林市,0546,335,71,406,9,415,867,47.87%,38.64%,1
彰化縣,員林市,0547,438,130,568,52,620,1121,55.31%,39.07%,1
彰化縣,員林市,0548,476,122,598,33,631,1190,53.03%,40%,1
彰化縣,員林市,0549,415,111,526,39,565,945,59.79%,43.92%,1
彰化縣,員林市,0550,411,99,510,36,546,906,60.26%,45.36%,1
彰化縣,員林市,0551,397,132,529,59,588,978,60.12%,40.59%,1
彰化縣,員林市,0552,404,103,507,48,555,949,58.48%,42.57%,1
彰化縣,員林市,0553,431,101,532,23,555,949,58.48%,45.42%,1
彰化縣,員林市,0554,439,97,536,29,565,1006,56.16%,43.64%,1
彰化縣,員林市,0555,352,127,479,49,528,889,59.39%,39.6%,1
彰化縣,員林市,0556,429,126,555,20,575,923,62.3%,46.48%,1
彰化縣,員林市,0557,559,140,699,46,745,1209,61.62%,46.24%,1
彰化縣,員林市,0558,484,126,610,40,650,1075,60.47%,45.02%,1
彰化縣,員林市,0559,637,152,789,35,824,1342,61.4%,47.47%,1
彰化縣,員林市,0560,502,149,651,37,688,1039,66.22%,48.32%,1
彰化縣,員林市,0561,451,94,545,84,629,1131,55.61%,39.88%,1
彰化縣,員林市,0562,507,163,670,31,701,1356,51.7%,37.39%,1
彰化縣,員林市,0563,580,141,721,53,774,1370,56.5%,42.34%,1
彰化縣,員林市,0564,459,127,586,42,628,1090,57.61%,42.11%,1
彰化縣,員林市,0565,407,105,512,18,530,821,64.56%,49.57%,1
彰化縣,員林市,0566,395,113,508,33,541,910,59.45%,43.41%,1
彰化縣,員林市,0567,496,144,640,47,687,1203,57.11%,41.23%,1
彰化縣,員林市,0568,573,144,717,56,773,1378,56.1%,41.58%,1
彰化縣,員林市,0569,577,160,737,31,768,1352,56.8%,42.68%,1
彰化縣,員林市,0570,480,144,624,25,649,1060,61.23%,45.28%,1
彰化縣,員林市,0571,541,134,675,44,719,1317,54.59%,41.08%,1
彰化縣,員林市,0572,437,131,568,41,609,1120,54.38%,39.02%,1
彰化縣,員林市,0573,420,94,514,42,556,1025,54.24%,40.98%,1
彰化縣,員林市,0574,444,139,583,45,628,1097,57.25%,40.47%,1
彰化縣,員林市,0575,363,126,489,40,529,859,61.58%,42.26%,1
彰化縣,員林市,0576,315,113,428,37,465,837,55.56%,37.63%,1
彰化縣,員林市,0577,480,150,630,53,683,1090,62.66%,44.04%,1
彰化縣,員林市,0578,420,112,532,64,596,1073,55.55%,39.14%,1
彰化縣,溪湖鎮,0640,474,154,628,49,677,1221,55.45%,38.82%,1
彰化縣,溪湖鎮,0641,296,77,373,36,409,638,64.11%,46.39%,1
彰化縣,溪湖鎮,0642,370,69,439,45,484,817,59.24%,45.29%,1
彰化縣,溪湖鎮,0643,458,90,548,38,586,968,60.54%,47.31%,1
彰化縣,溪湖鎮,0644,224,55,279,16,295,448,65.85%,50%,1
彰化縣,溪湖鎮,0645,430,104,534,26,560,1123,49.87%,38.29%,1
彰化縣,溪湖鎮,0646,446,160,606,50,656,1166,56.26%,38.25%,1
彰化縣,溪湖鎮,0647,472,131,603,30,633,1151,55%,41.01%,1
彰化縣,溪湖鎮,0648,548,142,690,34,724,1249,57.97%,43.88%,1
彰化縣,溪湖鎮,0649,493,126,619,54,673,1146,58.73%,43.02%,1
彰化縣,溪湖鎮,0650,515,124,639,65,704,1199,58.72%,42.95%,1
彰化縣,溪湖鎮,0651,369,104,473,50,523,895,58.44%,41.23%,1
彰化縣,溪湖鎮,0652,439,111,550,19,569,964,59.02%,45.54%,1
彰化縣,溪湖鎮,0653,360,110,470,30,500,851,58.75%,42.3%,1
彰化縣,溪湖鎮,0654,447,118,565,44,609,1072,56.81%,41.7%,1
彰化縣,溪湖鎮,0655,487,129,616,50,666,1113,59.84%,43.76%,1
彰化縣,溪湖鎮,0656,485,127,612,42,654,1090,60%,44.5%,1
彰化縣,溪湖鎮,0657,543,175,718,43,761,1193,63.79%,45.52%,1
彰化縣,溪湖鎮,0658,433,101,534,52,586,952,61.55%,45.48%,1
彰化縣,溪湖鎮,0659,473,135,608,71,679,1172,57.94%,40.36%,1
彰化縣,溪湖鎮,0660,445,111,556,36,592,1027,57.64%,43.33%,1
彰化縣,溪湖鎮,0661,572,117,689,57,746,1188,62.79%,48.15%,1
彰化縣,溪湖鎮,0662,529,170,699,50,749,1403,53.39%,37.7%,1
彰化縣,溪湖鎮,0663,486,149,635,76,711,1397,50.89%,34.79%,1
彰化縣,溪湖鎮,0664,681,180,861,49,910,1636,55.62%,41.63%,1
彰化縣,溪湖鎮,0665,552,146,698,74,772,1298,59.48%,42.53%,1
彰化縣,溪湖鎮,0666,520,109,629,70,699,1214,57.58%,42.83%,1
彰化縣,溪湖鎮,0667,590,139,729,47,776,1297,59.83%,45.49%,1
彰化縣,溪湖鎮,0668,441,105,546,59,605,968,62.5%,45.56%,1
彰化縣,溪湖鎮,0669,356,110,466,35,501,839,59.71%,42.43%,1
彰化縣,溪湖鎮,0670,368,133,501,51,552,907,60.86%,40.57%,1
彰化縣,溪湖鎮,0671,329,88,417,21,438,898,48.78%,36.64%,1
彰化縣,溪湖鎮,0672,327,84,411,38,449,650,69.08%,50.31%,1
彰化縣,溪湖鎮,0673,532,124,656,81,737,1279,57.62%,41.59%,1
彰化縣,溪湖鎮,0674,323,97,420,56,476,730,65.21%,44.25%,1
彰化縣,溪湖鎮,0675,598,145,743,72,815,1407,57.92%,42.5%,1
彰化縣,溪湖鎮,0676,423,149,572,62,634,1273,49.8%,33.23%,1
彰化縣,溪湖鎮,0677,403,109,512,29,541,988,54.76%,40.79%,1
彰化縣,溪湖鎮,0678,326,104,430,51,481,754,63.79%,43.24%,1
彰化縣,溪湖鎮,0679,354,114,468,57,525,1052,49.9%,33.65%,1
彰化縣,溪湖鎮,0680,434,135,569,48,617,1149,53.7%,37.77%,1
彰化縣,溪湖鎮,0681,587,182,769,93,862,1365,63.15%,43%,1
彰化縣,田中鎮,0742,290,109,399,77,476,854,55.74%,33.96%,1
彰化縣,田中鎮,0743,347,96,443,48,491,963,50.99%,36.03%,1
彰化縣,田中鎮,0744,27,11,38,7,45,175,25.71%,15.43%,1
彰化縣,田中鎮,0745,274,81,355,39,394,739,53.32%,37.08%,1
彰化縣,田中鎮,0746,313,91,404,36,440,826,53.27%,37.89%,1
彰化縣,田中鎮,0747,303,85,388,59,447,741,60.32%,40.89%,1
彰化縣,田中鎮,0748,163,42,205,5,210,506,41.5%,32.21%,1
彰化縣,田中鎮,0749,355,119,474,49,523,1001,52.25%,35.46%,1
彰化縣,田中鎮,0750,519,139,658,76,734,1281,57.3%,40.52%,1
彰化縣,田中鎮,0751,415,125,540,54,594,1035,57.39%,40.1%,1
彰化縣,田中鎮,0752,569,151,720,55,775,1327,58.4%,42.88%,1
彰化縣,田中鎮,0753,377,107,484,35,519,844,61.49%,44.67%,1
彰化縣,田中鎮,0754,352,117,469,52,521,913,57.06%,38.55%,1
彰化縣,田中鎮,0755,285,69,354,49,403,613,65.74%,46.49%,1
彰化縣,田中鎮,0756,597,157,754,65,819,1382,59.26%,43.2%,1
彰化縣,田中鎮,0757,515,115,630,41,671,1034,64.89%,49.81%,1
彰化縣,田中鎮,0758,457,121,578,39,617,935,65.99%,48.88%,1
彰化縣,田中鎮,0759,523,186,709,51,760,1301,58.42%,40.2%,1
彰化縣,田中鎮,0760,484,136,620,40,660,1100,60%,44%,1
彰化縣,田中鎮,0761,430,155,585,55,640,1071,59.76%,40.15%,1
彰化縣,田中鎮,0762,507,157,664,61,725,1163,62.34%,43.59%,1
彰化縣,田中鎮,0763,383,104,487,46,533,809,65.88%,47.34%,1
彰化縣,田中鎮,0764,489,148,637,58,695,1155,60.17%,42.34%,1
彰化縣,田中鎮,0765,482,158,640,82,722,1270,56.85%,37.95%,1
彰化縣,田中鎮,0766,332,109,441,47,488,870,56.09%,38.16%,1
彰化縣,田中鎮,0767,293,86,379,43,422,736,57.34%,39.81%,1
彰化縣,田中鎮,0768,491,141,632,61,693,1335,51.91%,36.78%,1
彰化縣,田中鎮,0769,299,146,445,45,490,876,55.94%,34.13%,1
彰化縣,田中鎮,0770,297,137,434,60,494,898,55.01%,33.07%,1
彰化縣,田中鎮,0771,571,162,733,21,754,1298,58.09%,43.99%,1
彰化縣,田中鎮,0772,538,197,735,80,815,1451,56.17%,37.08%,1
彰化縣,田中鎮,0773,512,268,780,54,834,1475,56.54%,34.71%,1
彰化縣,田中鎮,0774,275,84,359,44,403,766,52.61%,35.9%,1
彰化縣,田中鎮,0775,380,24,404,31,435,810,53.7%,46.91%,1
彰化縣,田中鎮,0776,354,141,495,72,567,953,59.5%,37.15%,1
彰化縣,田中鎮,0777,363,123,486,71,557,885,62.94%,41.02%,1
彰化縣,大村鄉,0579,639,197,836,65,901,1426,63.18%,44.81%,1
彰化縣,大村鄉,0580,789,210,999,86,1085,1726,62.86%,45.71%,1
彰化縣,大村鄉,0581,339,104,443,60,503,797,63.11%,42.53%,1
彰化縣,大村鄉,0582,306,81,387,29,416,745,55.84%,41.07%,1
彰化縣,大村鄉,0583,494,120,614,73,687,1125,61.07%,43.91%,1
彰化縣,大村鄉,0584,571,201,772,91,863,1486,58.08%,38.43%,1
彰化縣,大村鄉,0585,598,154,752,83,835,1426,58.56%,41.94%,1
彰化縣,大村鄉,0586,381,105,486,39,525,824,63.71%,46.24%,1
彰化縣,大村鄉,0587,436,124,560,45,605,1177,51.4%,37.04%,1
彰化縣,大村鄉,0588,647,164,811,70,881,1478,59.61%,43.78%,1
彰化縣,大村鄉,0589,284,100,384,22,406,779,52.12%,36.46%,1
彰化縣,大村鄉,0590,353,107,460,48,508,812,62.56%,43.47%,1
彰化縣,大村鄉,0591,472,129,601,40,641,1161,55.21%,40.65%,1
彰化縣,大村鄉,0592,505,114,619,36,655,1238,52.91%,40.79%,1
彰化縣,大村鄉,0593,505,152,657,69,726,1259,57.66%,40.11%,1
彰化縣,大村鄉,0594,599,164,763,57,820,1412,58.07%,42.42%,1
彰化縣,大村鄉,0595,615,143,758,35,793,1401,56.6%,43.9%,1
彰化縣,大村鄉,0596,612,157,769,69,838,1395,60.07%,43.87%,1
彰化縣,大村鄉,0597,399,141,540,61,601,996,60.34%,40.06%,1
彰化縣,大村鄉,0598,455,112,567,44,611,1047,58.36%,43.46%,1
彰化縣,大村鄉,0599,416,118,534,48,582,985,59.09%,42.23%,1
彰化縣,大村鄉,0600,481,130,611,46,657,1054,62.33%,45.64%,1
彰化縣,大村鄉,0601,498,166,664,46,710,1200,59.17%,41.5%,1
彰化縣,大村鄉,0602,430,113,543,75,618,1003,61.62%,42.87%,1
彰化縣,大村鄉,0603,400,134,534,46,580,1046,55.45%,38.24%,1
彰化縣,大村鄉,0604,516,146,662,48,710,1189,59.71%,43.4%,1
彰化縣,大村鄉,0605,523,128,651,61,712,1305,54.56%,40.08%,1
彰化縣,埔鹽鄉,0682,465,86,551,41,592,958,61.8%,48.54%,1
彰化縣,埔鹽鄉,0683,356,102,458,34,492,754,65.25%,47.21%,1
彰化縣,埔鹽鄉,0684,376,95,471,31,502,757,66.31%,49.67%,1
彰化縣,埔鹽鄉,0685,366,106,472,31,503,806,62.41%,45.41%,1
彰化縣,埔鹽鄉,0686,595,101,696,61,757,1280,59.14%,46.48%,1
彰化縣,埔鹽鄉,0687,409,96,505,45,550,928,59.27%,44.07%,1
彰化縣,埔鹽鄉,0688,409,190,599,60,659,895,73.63%,45.7%,1
彰化縣,埔鹽鄉,0689,369,99,468,59,527,815,64.66%,45.28%,1
彰化縣,埔鹽鄉,0690,415,100,515,44,559,957,58.41%,43.36%,1
彰化縣,埔鹽鄉,0691,557,129,686,100,786,1338,58.74%,41.63%,1
彰化縣,埔鹽鄉,0692,474,98,572,63,635,1106,57.41%,42.86%,1
彰化縣,埔鹽鄉,0693,359,70,429,42,471,690,68.26%,52.03%,1
彰化縣,埔鹽鄉,0694,518,142,660,88,748,1230,60.81%,42.11%,1
彰化縣,埔鹽鄉,0695,364,88,452,34,486,847,57.38%,42.98%,1
彰化縣,埔鹽鄉,0696,425,103,528,34,562,897,62.65%,47.38%,1
彰化縣,埔鹽鄉,0697,358,121,479,50,529,882,59.98%,40.59%,1
彰化縣,埔鹽鄉,0698,535,135,670,45,715,1180,60.59%,45.34%,1
彰化縣,埔鹽鄉,0699,478,153,631,74,705,1215,58.02%,39.34%,1
彰化縣,埔鹽鄉,0700,218,41,259,22,281,422,66.59%,51.66%,1
彰化縣,埔鹽鄉,0701,490,83,573,47,620,1106,56.06%,44.3%,1
彰化縣,埔鹽鄉,0702,399,106,505,57,562,874,64.3%,45.65%,1
彰化縣,埔鹽鄉,0703,565,190,755,105,860,1445,59.52%,39.1%,1
彰化縣,埔鹽鄉,0704,373,107,480,67,547,875,62.51%,42.63%,1
彰化縣,埔鹽鄉,0705,304,86,390,59,449,837,53.64%,36.32%,1
彰化縣,埔鹽鄉,0706,305,70,375,37,412,685,60.15%,44.53%,1
彰化縣,埔鹽鄉,0707,330,83,413,50,463,733,63.17%,45.02%,1
彰化縣,埔鹽鄉,0708,308,106,414,83,497,798,62.28%,38.6%,1
彰化縣,埔鹽鄉,0709,576,145,721,76,797,1381,57.71%,41.71%,1
彰化縣,埔鹽鄉,0710,506,141,647,61,708,1335,53.03%,37.9%,1
彰化縣,埔心鄉,0711,506,123,629,81,710,1139,62.34%,44.42%,1
彰化縣,埔心鄉,0712,473,166,639,72,711,1217,58.42%,38.87%,1
彰化縣,埔心鄉,0713,539,168,707,55,762,1248,61.06%,43.19%,1
彰化縣,埔心鄉,0714,527,187,714,87,801,1248,64.18%,42.23%,1
彰化縣,埔心鄉,0715,392,123,515,49,564,916,61.57%,42.79%,1
彰化縣,埔心鄉,0716,285,96,381,30,411,625,65.76%,45.6%,1
彰化縣,埔心鄉,0717,502,152,654,76,730,1271,57.44%,39.5%,1
彰化縣,埔心鄉,0718,267,79,346,31,377,608,62.01%,43.91%,1
彰化縣,埔心鄉,0719,517,140,657,71,728,1132,64.31%,45.67%,1
彰化縣,埔心鄉,0720,449,131,580,61,641,1027,62.41%,43.72%,1
彰化縣,埔心鄉,0721,405,125,530,57,587,926,63.39%,43.74%,1
彰化縣,埔心鄉,0722,315,100,415,67,482,778,61.95%,40.49%,1
彰化縣,埔心鄉,0723,304,84,388,32,420,660,63.64%,46.06%,1
彰化縣,埔心鄉,0724,592,158,750,67,817,1330,61.43%,44.51%,1
彰化縣,埔心鄉,0725,417,127,544,35,579,991,58.43%,42.08%,1
彰化縣,埔心鄉,0726,440,108,548,42,590,985,59.9%,44.67%,1
彰化縣,埔心鄉,0727,496,60,556,39,595,1034,57.54%,47.97%,1
彰化縣,埔心鄉,0728,271,77,348,48,396,612,64.71%,44.28%,1
彰化縣,埔心鄉,0729,583,149,732,58,790,1236,63.92%,47.17%,1
彰化縣,埔心鄉,0730,333,109,442,44,486,775,62.71%,42.97%,1
彰化縣,埔心鄉,0731,334,107,441,49,490,738,66.4%,45.26%,1
彰化縣,埔心鄉,0732,445,151,596,43,639,1036,61.68%,42.95%,1
彰化縣,埔心鄉,0733,375,113,488,70,558,975,57.23%,38.46%,1
彰化縣,埔心鄉,0734,354,120,474,47,521,885,58.87%,40%,1
彰化縣,埔心鄉,0735,407,129,536,53,589,939,62.73%,43.34%,1
彰化縣,埔心鄉,0736,287,79,366,47,413,689,59.94%,41.65%,1
彰化縣,埔心鄉,0737,284,72,356,29,385,659,58.42%,43.1%,1
彰化縣,埔心鄉,0738,349,114,463,32,495,910,54.4%,38.35%,1
彰化縣,埔心鄉,0739,614,204,818,75,893,1352,66.05%,45.41%,1
彰化縣,埔心鄉,0740,295,105,400,42,442,759,58.23%,38.87%,1
彰化縣,埔心鄉,0741,408,104,512,55,567,942,60.19%,43.31%,1
彰化縣,永靖鄉,0606,456,140,596,67,663,1255,52.83%,36.33%,1
彰化縣,永靖鄉,0607,366,115,481,60,541,889,60.85%,41.17%,1
彰化縣,永靖鄉,0608,413,121,534,43,577,1026,56.24%,40.25%,1
彰化縣,永靖鄉,0609,319,89,408,42,450,724,62.15%,44.06%,1
彰化縣,永靖鄉,0610,407,107,514,39,553,924,59.85%,44.05%,1
彰化縣,永靖鄉,0611,298,83,381,39,420,659,63.73%,45.22%,1
彰化縣,永靖鄉,0612,299,102,401,31,432,734,58.86%,40.74%,1
彰化縣,永靖鄉,0613,241,93,334,19,353,758,46.57%,31.79%,1
彰化縣,永靖鄉,0614,394,120,514,43,557,848,65.68%,46.46%,1
彰化縣,永靖鄉,0615,507,170,677,80,757,1404,53.92%,36.11%,1
彰化縣,永靖鄉,0616,406,98,504,42,546,792,68.94%,51.26%,1
彰化縣,永靖鄉,0617,311,94,405,39,444,695,63.88%,44.75%,1
彰化縣,永靖鄉,0618,396,78,474,35,509,821,62%,48.23%,1
彰化縣,永靖鄉,0619,468,116,584,67,651,1064,61.18%,43.98%,1
彰化縣,永靖鄉,0620,333,111,444,41,485,840,57.74%,39.64%,1
彰化縣,永靖鄉,0621,446,168,614,40,654,1079,60.61%,41.33%,1
彰化縣,永靖鄉,0622,474,137,611,43,654,1048,62.4%,45.23%,1
彰化縣,永靖鄉,0623,445,119,564,43,607,960,63.23%,46.35%,1
彰化縣,永靖鄉,0624,351,102,453,25,478,798,59.9%,43.98%,1
彰化縣,永靖鄉,0625,374,113,487,39,526,796,66.08%,46.98%,1
彰化縣,永靖鄉,0626,268,65,333,46,379,662,57.25%,40.48%,1
彰化縣,永靖鄉,0627,397,155,552,58,610,1040,58.65%,38.17%,1
彰化縣,永靖鄉,0628,411,129,540,49,589,1025,57.46%,40.1%,1
彰化縣,永靖鄉,0629,644,173,817,60,877,1357,64.63%,47.46%,1
彰化縣,永靖鄉,0630,518,134,652,68,720,1236,58.25%,41.91%,1
彰化縣,永靖鄉,0631,357,106,463,53,516,871,59.24%,40.99%,1
彰化縣,永靖鄉,0632,261,84,345,40,385,706,54.53%,36.97%,1
彰化縣,永靖鄉,0633,364,85,449,33,482,770,62.6%,47.27%,1
彰化縣,永靖鄉,0634,322,84,406,34,440,669,65.77%,48.13%,1
彰化縣,永靖鄉,0635,332,113,445,49,494,862,57.31%,38.52%,1
彰化縣,永靖鄉,0636,339,95,434,38,472,847,55.73%,40.02%,1
彰化縣,永靖鄉,0637,313,68,381,48,429,668,64.22%,46.86%,1
彰化縣,永靖鄉,0638,391,124,515,31,546,1073,50.89%,36.44%,1
彰化縣,永靖鄉,0639,452,140,592,65,657,1339,49.07%,33.76%,1
彰化縣,社頭鄉,0778,287,135,422,41,463,791,58.53%,36.28%,1
彰化縣,社頭鄉,0779,408,108,516,43,559,984,56.81%,41.46%,1
彰化縣,社頭鄉,0780,385,107,492,21,513,990,51.82%,38.89%,1
彰化縣,社頭鄉,0781,465,114,579,50,629,1016,61.91%,45.77%,1
彰化縣,社頭鄉,0782,576,52,628,31,659,1091,60.4%,52.8%,1
彰化縣,社頭鄉,0783,493,177,670,73,743,1236,60.11%,39.89%,1
彰化縣,社頭鄉,0784,494,130,624,25,649,1203,53.95%,41.06%,1
彰化縣,社頭鄉,0785,322,72,394,34,428,753,56.84%,42.76%,1
彰化縣,社頭鄉,0786,263,89,352,34,386,725,53.24%,36.28%,1
彰化縣,社頭鄉,0787,430,122,552,71,623,1023,60.9%,42.03%,1
彰化縣,社頭鄉,0788,251,93,344,33,377,562,67.08%,44.66%,1
彰化縣,社頭鄉,0789,426,117,543,38,581,1049,55.39%,40.61%,1
彰化縣,社頭鄉,0790,407,114,521,38,559,933,59.91%,43.62%,1
彰化縣,社頭鄉,0791,409,145,554,51,605,990,61.11%,41.31%,1
彰化縣,社頭鄉,0792,401,123,524,39,563,1076,52.32%,37.27%,1
彰化縣,社頭鄉,0793,322,104,426,21,447,742,60.24%,43.4%,1
彰化縣,社頭鄉,0794,275,59,334,26,360,672,53.57%,40.92%,1
彰化縣,社頭鄉,0795,477,98,575,51,626,1235,50.69%,38.62%,1
彰化縣,社頭鄉,0796,314,105,419,32,451,750,60.13%,41.87%,1
彰化縣,社頭鄉,0797,352,99,451,35,486,895,54.3%,39.33%,1
彰化縣,社頭鄉,0798,291,73,364,18,382,688,55.52%,42.3%,1
彰化縣,社頭鄉,0799,357,88,445,30,475,870,54.6%,41.03%,1
彰化縣,社頭鄉,0800,528,127,655,25,680,1140,59.65%,46.32%,1
彰化縣,社頭鄉,0801,409,136,545,38,583,985,59.19%,41.52%,1
彰化縣,社頭鄉,0802,599,130,729,58,787,1266,62.16%,47.31%,1
彰化縣,社頭鄉,0803,403,102,505,47,552,937,58.91%,43.01%,1
彰化縣,社頭鄉,0804,526,126,652,38,690,1219,56.6%,43.15%,1
彰化縣,社頭鄉,0805,447,154,601,70,671,1165,57.6%,38.37%,1
彰化縣,社頭鄉,0806,406,126,532,52,584,986,59.23%,41.18%,1
彰化縣,社頭鄉,0807,330,96,426,32,458,724,63.26%,45.58%,1
彰化縣,社頭鄉,0808,455,100,555,36,591,1015,58.23%,44.83%,1
彰化縣,社頭鄉,0809,411,135,546,25,571,1116,51.16%,36.83%,1
彰化縣,社頭鄉,0810,386,136,522,52,574,1061,54.1%,36.38%,1
彰化縣,社頭鄉,0811,417,129,546,55,601,992,60.58%,42.04%,1
彰化縣,社頭鄉,0812,415,121,536,34,570,1092,52.2%,38%,1
彰化縣,社頭鄉,0813,344,117,461,45,506,828,61.11%,41.55%,1
彰化縣,社頭鄉,0814,288,87,375,51,426,787,54.13%,36.59%,1
彰化縣,社頭鄉,0815,264,64,328,16,344,719,47.84%,36.72%,1
彰化縣,二水鄉,0816,374,149,523,84,607,1028,59.05%,36.38%,1
彰化縣,二水鄉,0817,289,93,382,51,433,689,62.84%,41.94%,1
彰化縣,二水鄉,0818,313,95,408,64,472,871,54.19%,35.94%,1
彰化縣,二水鄉,0819,379,112,491,70,561,953,58.87%,39.77%,1
彰化縣,二水鄉,0820,220,74,294,46,340,624,54.49%,35.26%,1
彰化縣,二水鄉,0821,276,102,378,49,427,645,66.2%,42.79%,1
彰化縣,二水鄉,0822,494,118,612,40,652,986,66.13%,50.1%,1
彰化縣,二水鄉,0823,410,143,553,66,619,943,65.64%,43.48%,1
彰化縣,二水鄉,0824,209,52,261,3,264,455,58.02%,45.93%,1
彰化縣,二水鄉,0825,396,117,513,47,560,831,67.39%,47.65%,1
彰化縣,二水鄉,0826,351,105,456,41,497,831,59.81%,42.24%,1
彰化縣,二水鄉,0827,385,139,524,29,553,1013,54.59%,38.01%,1
彰化縣,二水鄉,0828,301,140,441,64,505,796,63.44%,37.81%,1
彰化縣,二水鄉,0829,312,96,408,44,452,781,57.87%,39.95%,1
彰化縣,二水鄉,0830,244,82,326,21,347,692,50.14%,35.26%,1
彰化縣,二水鄉,0831,265,79,344,28,372,635,58.58%,41.73%,1
彰化縣,二水鄉,0832,210,80,290,36,326,566,57.6%,37.1%,1
彰化縣,北斗鎮,0833,353,96,449,68,517,925,55.89%,38.16%,1
彰化縣,北斗鎮,0834,357,112,469,52,521,869,59.95%,41.08%,1
彰化縣,北斗鎮,0835,389,125,514,43,557,855,65.15%,45.5%,1
彰化縣,北斗鎮,0836,500,123,623,51,674,1065,63.29%,46.95%,1
彰化縣,北斗鎮,0837,338,101,439,61,500,828,60.39%,40.82%,1
彰化縣,北斗鎮,0838,511,112,623,48,671,1124,59.7%,45.46%,1
彰化縣,北斗鎮,0839,502,120,622,45,667,1096,60.86%,45.8%,1
彰化縣,北斗鎮,0840,509,148,657,56,713,1213,58.78%,41.96%,1
彰化縣,北斗鎮,0841,436,136,572,74,646,1164,55.5%,37.46%,1
彰化縣,北斗鎮,0842,291,92,383,26,409,730,56.03%,39.86%,1
彰化縣,北斗鎮,0843,369,94,463,26,489,878,55.69%,42.03%,1
彰化縣,北斗鎮,0844,370,98,468,41,509,833,61.1%,44.42%,1
彰化縣,北斗鎮,0845,428,109,537,32,569,957,59.46%,44.72%,1
彰化縣,北斗鎮,0846,323,92,415,30,445,783,56.83%,41.25%,1
彰化縣,北斗鎮,0847,215,70,285,29,314,573,54.8%,37.52%,1
彰化縣,北斗鎮,0848,259,85,344,32,376,672,55.95%,38.54%,1
彰化縣,北斗鎮,0849,253,84,337,41,378,695,54.39%,36.4%,1
彰化縣,北斗鎮,0850,278,77,355,43,398,747,53.28%,37.22%,1
彰化縣,北斗鎮,0851,303,79,382,27,409,643,63.61%,47.12%,1
彰化縣,北斗鎮,0852,296,63,359,34,393,662,59.37%,44.71%,1
彰化縣,北斗鎮,0853,494,139,633,60,693,1085,63.87%,45.53%,1
彰化縣,北斗鎮,0854,463,140,603,65,668,1121,59.59%,41.3%,1
彰化縣,北斗鎮,0855,389,77,466,42,508,830,61.2%,46.87%,1
彰化縣,北斗鎮,0856,391,111,502,42,544,975,55.79%,40.1%,1
彰化縣,北斗鎮,0857,502,125,627,33,660,1212,54.46%,41.42%,1
彰化縣,北斗鎮,0858,552,148,700,79,779,1302,59.83%,42.4%,1
彰化縣,北斗鎮,0859,384,109,493,35,528,1077,49.03%,35.65%,1
彰化縣,北斗鎮,0860,356,91,447,59,506,917,55.18%,38.82%,1
彰化縣,北斗鎮,0861,323,104,427,33,460,825,55.76%,39.15%,1
彰化縣,北斗鎮,0862,382,126,508,46,554,937,59.12%,40.77%,1
彰化縣,二林鎮,0942,208,88,296,22,318,731,43.5%,28.45%,1
彰化縣,二林鎮,0943,426,112,538,48,586,1025,57.17%,41.56%,1
彰化縣,二林鎮,0944,320,105,425,27,452,784,57.65%,40.82%,1
彰化縣,二林鎮,0945,361,114,475,41,516,892,57.85%,40.47%,1
彰化縣,二林鎮,0946,502,156,658,61,719,1256,57.25%,39.97%,1
彰化縣,二林鎮,0947,404,121,525,45,570,1043,54.65%,38.73%,1
彰化縣,二林鎮,0948,488,123,611,38,649,1076,60.32%,45.35%,1
彰化縣,二林鎮,0949,450,126,576,58,634,1082,58.6%,41.59%,1
彰化縣,二林鎮,0950,551,141,692,64,756,1427,52.98%,38.61%,1
彰化縣,二林鎮,0951,347,112,459,69,528,1030,51.26%,33.69%,1
彰化縣,二林鎮,0952,355,117,472,68,540,1033,52.27%,34.37%,1
彰化縣,二林鎮,0953,374,117,491,50,541,977,55.37%,38.28%,1
彰化縣,二林鎮,0954,250,70,320,31,351,683,51.39%,36.6%,1
彰化縣,二林鎮,0955,356,89,445,64,509,975,52.21%,36.51%,1
彰化縣,二林鎮,0956,423,109,532,64,596,1336,44.61%,31.66%,1
彰化縣,二林鎮,0957,312,107,419,63,482,1019,47.3%,30.62%,1
彰化縣,二林鎮,0958,284,94,378,50,428,1003,42.67%,28.32%,1
彰化縣,二林鎮,0959,470,108,578,67,645,1151,56.04%,40.83%,1
彰化縣,二林鎮,0960,627,184,811,99,910,1598,56.95%,39.24%,1
彰化縣,二林鎮,0961,597,150,747,49,796,1488,53.49%,40.12%,1
彰化縣,二林鎮,0962,741,201,942,64,1006,1771,56.8%,41.84%,1
彰化縣,二林鎮,0963,400,127,527,54,581,1360,42.72%,29.41%,1
彰化縣,二林鎮,0964,539,141,680,71,751,1613,46.56%,33.42%,1
彰化縣,二林鎮,0965,428,115,543,91,634,1228,51.63%,34.85%,1
彰化縣,二林鎮,0966,336,74,410,29,439,771,56.94%,43.58%,1
彰化縣,二林鎮,0967,351,118,469,34,503,858,58.62%,40.91%,1
彰化縣,二林鎮,0968,228,57,285,1,286,661,43.27%,34.49%,1
彰化縣,二林鎮,0969,427,118,545,83,628,1268,49.53%,33.68%,1
彰化縣,二林鎮,0970,365,100,465,44,509,1081,47.09%,33.77%,1
彰化縣,二林鎮,0971,425,121,546,38,584,1213,48.15%,35.04%,1
彰化縣,二林鎮,0972,520,151,671,72,743,1328,55.95%,39.16%,1
彰化縣,二林鎮,0973,342,111,453,81,534,1118,47.76%,30.59%,1
彰化縣,二林鎮,0974,350,126,476,59,535,1157,46.24%,30.25%,1
彰化縣,二林鎮,0975,340,95,435,38,473,972,48.66%,34.98%,1
彰化縣,二林鎮,0976,332,104,436,47,483,902,53.55%,36.81%,1
彰化縣,二林鎮,0977,536,172,708,98,806,1273,63.32%,42.11%,1
彰化縣,二林鎮,0978,393,111,504,43,547,1087,50.32%,36.15%,1
彰化縣,二林鎮,0979,378,124,502,76,578,987,58.56%,38.3%,1
彰化縣,二林鎮,0980,202,65,267,29,296,719,41.17%,28.09%,1
彰化縣,田尾鄉,0863,462,142,604,53,657,1284,51.17%,35.98%,1
彰化縣,田尾鄉,0864,512,149,661,62,723,1187,60.91%,43.13%,1
彰化縣,田尾鄉,0865,433,138,571,43,614,1033,59.44%,41.92%,1
彰化縣,田尾鄉,0866,326,54,380,45,425,696,61.06%,46.84%,1
彰化縣,田尾鄉,0867,412,93,505,30,535,872,61.35%,47.25%,1
彰化縣,田尾鄉,0868,276,66,342,20,362,680,53.24%,40.59%,1
彰化縣,田尾鄉,0869,389,125,514,40,554,875,63.31%,44.46%,1
彰化縣,田尾鄉,0870,495,155,650,54,704,1337,52.66%,37.02%,1
彰化縣,田尾鄉,0871,640,149,789,47,836,1376,60.76%,46.51%,1
彰化縣,田尾鄉,0872,576,118,694,41,735,1186,61.97%,48.57%,1
彰化縣,田尾鄉,0873,455,105,560,45,605,874,69.22%,52.06%,1
彰化縣,田尾鄉,0874,231,87,318,38,356,647,55.02%,35.7%,1
彰化縣,田尾鄉,0875,400,115,515,50,565,959,58.92%,41.71%,1
彰化縣,田尾鄉,0876,98,34,132,11,143,263,54.37%,37.26%,1
彰化縣,田尾鄉,0877,237,67,304,31,335,618,54.21%,38.35%,1
彰化縣,田尾鄉,0878,409,143,552,26,578,938,61.62%,43.6%,1
彰化縣,田尾鄉,0879,419,97,516,47,563,880,63.98%,47.61%,1
彰化縣,田尾鄉,0880,293,90,383,41,424,804,52.74%,36.44%,1
彰化縣,田尾鄉,0881,227,68,295,30,325,592,54.9%,38.34%,1
彰化縣,田尾鄉,0882,451,140,591,91,682,1079,63.21%,41.8%,1
彰化縣,田尾鄉,0883,567,148,715,58,773,1336,57.86%,42.44%,1
彰化縣,田尾鄉,0884,464,131,595,56,651,1198,54.34%,38.73%,1
彰化縣,田尾鄉,0885,227,81,308,46,354,621,57%,36.55%,1
彰化縣,田尾鄉,0886,299,82,381,33,414,760,54.47%,39.34%,1
彰化縣,田尾鄉,0887,469,156,625,76,701,1084,64.67%,43.27%,1
彰化縣,埤頭鄉,0888,386,122,508,64,572,1178,48.56%,32.77%,1
彰化縣,埤頭鄉,0889,495,139,634,51,685,1290,53.1%,38.37%,1
彰化縣,埤頭鄉,0890,385,84,469,58,527,973,54.16%,39.57%,1
彰化縣,埤頭鄉,0891,289,90,379,37,416,783,53.13%,36.91%,1
彰化縣,埤頭鄉,0892,280,84,364,52,416,733,56.75%,38.2%,1
彰化縣,埤頭鄉,0893,346,111,457,68,525,899,58.4%,38.49%,1
彰化縣,埤頭鄉,0894,375,111,486,58,544,965,56.37%,38.86%,1
彰化縣,埤頭鄉,0895,514,132,646,66,712,1356,52.51%,37.91%,1
彰化縣,埤頭鄉,0896,487,125,612,75,687,1265,54.31%,38.5%,1
彰化縣,埤頭鄉,0897,387,92,479,66,545,877,62.14%,44.13%,1
彰化縣,埤頭鄉,0898,268,69,337,45,382,705,54.18%,38.01%,1
彰化縣,埤頭鄉,0899,470,64,534,103,637,1062,59.98%,44.26%,1
彰化縣,埤頭鄉,0900,541,139,680,59,739,1300,56.85%,41.62%,1
彰化縣,埤頭鄉,0901,387,89,476,62,538,923,58.29%,41.93%,1
彰化縣,埤頭鄉,0902,381,103,484,46,530,1085,48.85%,35.12%,1
彰化縣,埤頭鄉,0903,476,111,587,66,653,1103,59.2%,43.16%,1
彰化縣,埤頭鄉,0904,314,28,342,35,377,735,51.29%,42.72%,1
彰化縣,埤頭鄉,0905,196,63,259,57,316,574,55.05%,34.15%,1
彰化縣,埤頭鄉,0906,271,64,335,49,384,767,50.07%,35.33%,1
彰化縣,埤頭鄉,0907,259,89,348,58,406,737,55.09%,35.14%,1
彰化縣,埤頭鄉,0908,306,119,425,66,491,1058,46.41%,28.92%,1
彰化縣,埤頭鄉,0909,270,85,355,70,425,826,51.45%,32.69%,1
彰化縣,埤頭鄉,0910,361,96,457,88,545,1082,50.37%,33.36%,1
彰化縣,埤頭鄉,0911,319,78,397,49,446,737,60.52%,43.28%,1
彰化縣,埤頭鄉,0912,275,73,348,28,376,711,52.88%,38.68%,1
彰化縣,埤頭鄉,0913,394,130,524,69,593,1043,56.86%,37.78%,1
彰化縣,埤頭鄉,0914,315,95,410,31,441,910,48.46%,34.62%,1
彰化縣,芳苑鄉,0998,201,71,272,58,330,940,35.11%,21.38%,1
彰化縣,芳苑鄉,0999,91,35,126,26,152,403,37.72%,22.58%,1
彰化縣,芳苑鄉,1000,256,80,336,39,375,756,49.6%,33.86%,1
彰化縣,芳苑鄉,1001,107,40,147,31,178,548,32.48%,19.53%,1
彰化縣,芳苑鄉,1002,360,101,461,54,515,997,51.65%,36.11%,1
彰化縣,芳苑鄉,1003,389,123,512,67,579,1300,44.54%,29.92%,1
彰化縣,芳苑鄉,1004,292,112,404,38,442,859,51.46%,33.99%,1
彰化縣,芳苑鄉,1005,253,75,328,18,346,734,47.14%,34.47%,1
彰化縣,芳苑鄉,1006,227,52,279,25,304,636,47.8%,35.69%,1
彰化縣,芳苑鄉,1007,222,84,306,69,375,808,46.41%,27.48%,1
彰化縣,芳苑鄉,1008,197,58,255,40,295,668,44.16%,29.49%,1
彰化縣,芳苑鄉,1009,261,87,348,28,376,744,50.54%,35.08%,1
彰化縣,芳苑鄉,1010,332,81,413,72,485,1026,47.27%,32.36%,1
彰化縣,芳苑鄉,1011,156,47,203,11,214,586,36.52%,26.62%,1
彰化縣,芳苑鄉,1012,211,72,283,30,313,593,52.78%,35.58%,1
彰化縣,芳苑鄉,1013,386,123,509,72,581,1071,54.25%,36.04%,1
彰化縣,芳苑鄉,1014,336,128,464,91,555,1060,52.36%,31.7%,1
彰化縣,芳苑鄉,1015,212,73,285,27,312,708,44.07%,29.94%,1
彰化縣,芳苑鄉,1016,225,63,288,60,348,735,47.35%,30.61%,1
彰化縣,芳苑鄉,1017,199,71,270,60,330,571,57.79%,34.85%,1
彰化縣,芳苑鄉,1018,218,56,274,33,307,729,42.11%,29.9%,1
彰化縣,芳苑鄉,1019,211,73,284,65,349,674,51.78%,31.31%,1
彰化縣,芳苑鄉,1020,280,107,387,41,428,846,50.59%,33.1%,1
彰化縣,芳苑鄉,1021,321,82,403,50,453,806,56.2%,39.83%,1
彰化縣,芳苑鄉,1022,122,36,158,13,171,470,36.38%,25.96%,1
彰化縣,芳苑鄉,1023,486,104,590,58,648,1124,57.65%,43.24%,1
彰化縣,芳苑鄉,1024,106,23,129,23,152,317,47.95%,33.44%,1
彰化縣,芳苑鄉,1025,342,99,441,57,498,1158,43.01%,29.53%,1
彰化縣,芳苑鄉,1026,327,76,403,27,430,967,44.47%,33.82%,1
彰化縣,芳苑鄉,1027,297,62,359,41,400,762,52.49%,38.98%,1
彰化縣,芳苑鄉,1028,335,92,427,50,477,1086,43.92%,30.85%,1
彰化縣,芳苑鄉,1029,271,72,343,25,368,747,49.26%,36.28%,1
彰化縣,芳苑鄉,1030,198,37,235,31,266,653,40.74%,30.32%,1
彰化縣,芳苑鄉,1031,361,90,451,61,512,872,58.72%,41.4%,1
彰化縣,芳苑鄉,1032,532,158,690,55,745,1235,60.32%,43.08%,1
彰化縣,芳苑鄉,1033,401,130,531,61,592,1102,53.72%,36.39%,1
彰化縣,大城鄉,0981,299,69,368,30,398,1288,30.9%,23.21%,1
彰化縣,大城鄉,0982,261,81,342,83,425,1104,38.5%,23.64%,1
彰化縣,大城鄉,0983,367,104,471,66,537,964,55.71%,38.07%,1
彰化縣,大城鄉,0984,418,128,546,62,608,1312,46.34%,31.86%,1
彰化縣,大城鄉,0985,237,68,305,61,366,853,42.91%,27.78%,1
彰化縣,大城鄉,0986,133,22,155,26,181,518,34.94%,25.68%,1
彰化縣,大城鄉,0987,170,53,223,26,249,574,43.38%,29.62%,1
彰化縣,大城鄉,0988,162,65,227,41,268,702,38.18%,23.08%,1
彰化縣,大城鄉,0989,76,25,101,16,117,376,31.12%,20.21%,1
彰化縣,大城鄉,0990,153,41,194,20,214,693,30.88%,22.08%,1
彰化縣,大城鄉,0991,239,103,342,43,385,877,43.9%,27.25%,1
彰化縣,大城鄉,0992,116,55,171,13,184,655,28.09%,17.71%,1
彰化縣,大城鄉,0993,295,80,375,29,404,1103,36.63%,26.75%,1
彰化縣,大城鄉,0994,285,88,373,33,406,1192,34.06%,23.91%,1
彰化縣,大城鄉,0995,245,80,325,36,361,917,39.37%,26.72%,1
彰化縣,大城鄉,0996,159,40,199,26,225,686,32.8%,23.18%,1
彰化縣,大城鄉,0997,197,57,254,22,276,899,30.7%,21.91%,1
彰化縣,竹塘鄉,1034,457,135,592,75,667,1168,57.11%,39.13%,1
彰化縣,竹塘鄉,1035,370,134,504,34,538,965,55.75%,38.34%,1
彰化縣,竹塘鄉,1036,402,134,536,61,597,960,62.19%,41.88%,1
彰化縣,竹塘鄉,1037,321,97,418,66,484,743,65.14%,43.2%,1
彰化縣,竹塘鄉,1038,233,67,300,37,337,751,44.87%,31.03%,1
彰化縣,竹塘鄉,1039,250,87,337,43,380,792,47.98%,31.57%,1
彰化縣,竹塘鄉,1040,231,65,296,17,313,733,42.7%,31.51%,1
彰化縣,竹塘鄉,1041,238,63,301,45,346,657,52.66%,36.23%,1
彰化縣,竹塘鄉,1042,375,114,489,40,529,1063,49.76%,35.28%,1
彰化縣,竹塘鄉,1043,420,131,551,80,631,1114,56.64%,37.7%,1
彰化縣,竹塘鄉,1044,204,84,288,55,343,506,67.79%,40.32%,1
彰化縣,竹塘鄉,1045,289,89,378,43,421,823,51.15%,35.12%,1
彰化縣,竹塘鄉,1046,203,91,294,42,336,654,51.38%,31.04%,1
彰化縣,竹塘鄉,1047,160,51,211,33,244,577,42.29%,27.73%,1
彰化縣,竹塘鄉,1048,258,88,346,61,407,772,52.72%,33.42%,1
彰化縣,竹塘鄉,1049,152,57,209,40,249,543,45.86%,27.99%,1
彰化縣,溪州鄉,0915,308,73,381,49,430,778,55.27%,39.59%,1
彰化縣,溪州鄉,0916,350,110,460,36,496,1061,46.75%,32.99%,1
彰化縣,溪州鄉,0917,224,66,290,34,324,701,46.22%,31.95%,1
彰化縣,溪州鄉,0918,340,133,473,57,530,879,60.3%,38.68%,1
彰化縣,溪州鄉,0919,298,93,391,39,430,654,65.75%,45.57%,1
彰化縣,溪州鄉,0920,347,97,444,45,489,878,55.69%,39.52%,1
彰化縣,溪州鄉,0921,420,105,525,50,575,942,61.04%,44.59%,1
彰化縣,溪州鄉,0922,333,99,432,37,469,871,53.85%,38.23%,1
彰化縣,溪州鄉,0923,385,106,491,26,517,1047,49.38%,36.77%,1
彰化縣,溪州鄉,0924,326,118,444,57,501,858,58.39%,38%,1
彰化縣,溪州鄉,0925,454,116,570,72,642,1409,45.56%,32.22%,1
彰化縣,溪州鄉,0926,276,73,349,28,377,792,47.6%,34.85%,1
彰化縣,溪州鄉,0927,235,92,327,59,386,714,54.06%,32.91%,1
彰化縣,溪州鄉,0928,349,123,472,66,538,1109,48.51%,31.47%,1
彰化縣,溪州鄉,0929,270,107,377,50,427,962,44.39%,28.07%,1
彰化縣,溪州鄉,0930,371,89,460,63,523,1157,45.2%,32.07%,1
彰化縣,溪州鄉,0931,349,99,448,42,490,952,51.47%,36.66%,1
彰化縣,溪州鄉,0932,333,108,441,35,476,887,53.66%,37.54%,1
彰化縣,溪州鄉,0933,264,72,336,44,380,866,43.88%,30.48%,1
彰化縣,溪州鄉,0934,287,129,416,65,481,1010,47.62%,28.42%,1
彰化縣,溪州鄉,0935,295,102,397,25,422,853,49.47%,34.58%,1
彰化縣,溪州鄉,0936,298,73,371,63,434,843,51.48%,35.35%,1
彰化縣,溪州鄉,0937,177,55,232,11,243,711,34.18%,24.89%,1
彰化縣,溪州鄉,0938,300,101,401,69,470,851,55.23%,35.25%,1
彰化縣,溪州鄉,0939,278,83,361,40,401,883,45.41%,31.48%,1
彰化縣,溪州鄉,0940,400,113,513,58,571,1247,45.79%,32.08%,1
彰化縣,溪州鄉,0941,573,175,748,88,836,1490,56.11%,38.46%,1
南投縣,南投市,0001,406,118,524,26,550,927,59.33%,43.8%,1
南投縣,南投市,0002,335,88,423,31,454,667,68.07%,50.22%,1
南投縣,南投市,0003,370,73,443,34,477,773,61.71%,47.87%,1
南投縣,南投市,0004,365,111,476,38,514,818,62.84%,44.62%,1
南投縣,南投市,0005,244,84,328,28,356,525,67.81%,46.48%,1
南投縣,南投市,0006,283,69,352,29,381,575,66.26%,49.22%,1
南投縣,南投市,0007,179,58,237,16,253,368,68.75%,48.64%,1
南投縣,南投市,0008,438,147,585,47,632,956,66.11%,45.82%,1
南投縣,南投市,0009,513,120,633,22,655,1245,52.61%,41.2%,1
南投縣,南投市,0010,795,20,815,28,843,1484,56.81%,53.57%,1
南投縣,南投市,0011,596,133,729,49,778,1191,65.32%,50.04%,1
南投縣,南投市,0012,705,154,859,58,917,1506,60.89%,46.81%,1
南投縣,南投市,0013,485,146,631,45,676,1070,63.18%,45.33%,1
南投縣,南投市,0014,318,78,396,23,419,670,62.54%,47.46%,1
南投縣,南投市,0015,499,148,647,46,693,1050,66%,47.52%,1
南投縣,南投市,0016,427,130,557,52,609,1122,54.28%,38.06%,1
南投縣,南投市,0017,393,128,521,36,557,984,56.61%,39.94%,1
南投縣,南投市,0018,533,117,650,29,679,1062,63.94%,50.19%,1
南投縣,南投市,0019,475,120,595,48,643,1053,61.06%,45.11%,1
南投縣,南投市,0020,486,180,666,36,702,1104,63.59%,44.02%,1
南投縣,南投市,0021,505,140,645,56,701,1192,58.81%,42.37%,1
南投縣,南投市,0022,395,118,513,35,548,960,57.08%,41.15%,1
南投縣,南投市,0023,418,101,519,39,558,906,61.59%,46.14%,1
南投縣,南投市,0024,440,114,554,45,599,957,62.59%,45.98%,1
南投縣,南投市,0025,447,150,597,55,652,997,65.4%,44.83%,1
南投縣,南投市,0026,450,131,581,46,627,1008,62.2%,44.64%,1
南投縣,南投市,0027,521,136,657,27,684,1164,58.76%,44.76%,1
南投縣,南投市,0028,256,67,323,28,351,587,59.8%,43.61%,1
南投縣,南投市,0029,276,95,371,33,404,734,55.04%,37.6%,1
南投縣,南投市,0030,298,79,377,44,421,724,58.15%,41.16%,1
南投縣,南投市,0031,461,98,559,37,596,1003,59.42%,45.96%,1
南投縣,南投市,0032,595,145,740,48,788,1356,58.11%,43.88%,1
南投縣,南投市,0033,544,141,685,59,744,1373,54.19%,39.62%,1
南投縣,南投市,0034,595,162,757,48,805,1452,55.44%,40.98%,1
南投縣,南投市,0035,160,22,182,14,196,362,54.14%,44.2%,1
南投縣,南投市,0036,161,48,209,27,236,389,60.67%,41.39%,1
南投縣,南投市,0037,594,177,771,60,831,1276,65.13%,46.55%,1
南投縣,南投市,0038,507,144,651,51,702,1089,64.46%,46.56%,1
南投縣,南投市,0039,426,115,541,52,593,921,64.39%,46.25%,1
南投縣,南投市,0040,488,112,600,19,619,892,69.39%,54.71%,1
南投縣,南投市,0041,542,102,644,33,677,1050,64.48%,51.62%,1
南投縣,南投市,0042,552,107,659,22,681,1078,63.17%,51.21%,1
南投縣,南投市,0043,537,94,631,36,667,1078,61.87%,49.81%,1
南投縣,南投市,0044,496,97,593,28,621,861,72.13%,57.61%,1
南投縣,南投市,0045,522,148,670,58,728,1221,59.62%,42.75%,1
南投縣,南投市,0046,513,101,614,34,648,1105,58.64%,46.43%,1
南投縣,南投市,0047,579,150,729,27,756,1230,61.46%,47.07%,1
南投縣,南投市,0048,557,98,655,20,675,1092,61.81%,51.01%,1
南投縣,南投市,0049,689,116,805,17,822,1286,63.92%,53.58%,1
南投縣,南投市,0050,326,85,411,40,451,655,68.85%,49.77%,1
南投縣,南投市,0051,346,91,437,34,471,719,65.51%,48.12%,1
南投縣,南投市,0052,306,82,388,28,416,720,57.78%,42.5%,1
南投縣,南投市,0053,261,61,322,20,342,509,67.19%,51.28%,1
南投縣,南投市,0054,226,31,257,22,279,492,56.71%,45.93%,1
南投縣,南投市,0055,307,51,358,19,377,616,61.2%,49.84%,1
南投縣,南投市,0056,526,78,604,31,635,1010,62.87%,52.08%,1
南投縣,南投市,0057,420,70,490,21,511,848,60.26%,49.53%,1
南投縣,南投市,0058,649,162,811,67,878,1387,63.3%,46.79%,1
南投縣,南投市,0059,592,148,740,48,788,1245,63.29%,47.55%,1
南投縣,南投市,0060,536,121,657,33,690,1199,57.55%,44.7%,1
南投縣,南投市,0061,588,140,728,54,782,1288,60.71%,45.65%,1
南投縣,南投市,0062,467,109,576,45,621,1040,59.71%,44.9%,1
南投縣,南投市,0063,494,117,611,53,664,1070,62.06%,46.17%,1
南投縣,南投市,0064,647,133,780,36,816,1299,62.82%,49.81%,1
南投縣,南投市,0065,545,151,696,26,722,1122,64.35%,48.57%,1
南投縣,南投市,0066,633,156,789,44,833,1414,58.91%,44.77%,1
南投縣,南投市,0067,492,133,625,41,666,1121,59.41%,43.89%,1
南投縣,南投市,0068,628,153,781,29,810,1434,56.49%,43.79%,1
南投縣,南投市,0069,588,136,724,49,773,1393,55.49%,42.21%,1
南投縣,南投市,0070,454,120,574,17,591,1059,55.81%,42.87%,1
南投縣,南投市,0071,529,139,668,30,698,1218,57.31%,43.43%,1
南投縣,南投市,0072,510,126,636,25,661,1293,51.12%,39.44%,1
南投縣,南投市,0073,529,107,636,32,668,1337,49.96%,39.57%,1
南投縣,南投市,0074,383,131,514,40,554,876,63.24%,43.72%,1
南投縣,南投市,0075,415,124,539,26,565,971,58.19%,42.74%,1
南投縣,南投市,0076,427,127,554,40,594,1012,58.7%,42.19%,1
南投縣,南投市,0077,404,83,487,49,536,973,55.09%,41.52%,1
南投縣,南投市,0078,449,140,589,40,629,1002,62.77%,44.81%,1
南投縣,南投市,0079,459,109,568,41,609,1024,59.47%,44.82%,1
南投縣,南投市,0080,377,114,491,103,594,1122,52.94%,33.6%,1
南投縣,南投市,0081,251,105,356,41,397,790,50.25%,31.77%,1
南投縣,南投市,0082,200,46,246,22,268,647,41.42%,30.91%,1
南投縣,南投市,0083,394,96,490,47,537,950,56.53%,41.47%,1
南投縣,南投市,0084,384,97,481,26,507,980,51.73%,39.18%,1
南投縣,埔里鎮,0085,362,94,456,45,501,828,60.51%,43.72%,1
南投縣,埔里鎮,0086,343,102,445,40,485,786,61.7%,43.64%,1
南投縣,埔里鎮,0087,451,111,562,45,607,1062,57.16%,42.47%,1
南投縣,埔里鎮,0088,532,145,677,41,718,1201,59.78%,44.3%,1
南投縣,埔里鎮,0089,589,140,729,32,761,1415,53.78%,41.63%,1
南投縣,埔里鎮,0090,556,129,685,30,715,1282,55.77%,43.37%,1
南投縣,埔里鎮,0091,374,80,454,46,500,859,58.21%,43.54%,1
南投縣,埔里鎮,0092,531,139,670,74,744,1288,57.76%,41.23%,1
南投縣,埔里鎮,0093,585,141,726,32,758,1330,56.99%,43.98%,1
南投縣,埔里鎮,0094,577,131,708,58,766,1416,54.1%,40.75%,1
南投縣,埔里鎮,0095,475,125,600,38,638,1283,49.73%,37.02%,1
南投縣,埔里鎮,0096,484,36,520,80,600,1151,52.13%,42.05%,1
南投縣,埔里鎮,0097,468,127,595,39,634,1193,53.14%,39.23%,1
南投縣,埔里鎮,0098,618,166,784,74,858,1471,58.33%,42.01%,1
南投縣,埔里鎮,0099,374,89,463,70,533,1044,51.05%,35.82%,1
南投縣,埔里鎮,0100,481,125,606,64,670,1122,59.71%,42.87%,1
南投縣,埔里鎮,0101,550,127,677,48,725,1129,64.22%,48.72%,1
南投縣,埔里鎮,0102,367,97,464,21,485,901,53.83%,40.73%,1
南投縣,埔里鎮,0103,396,84,480,58,538,997,53.96%,39.72%,1
南投縣,埔里鎮,0104,506,127,633,45,678,1209,56.08%,41.85%,1
南投縣,埔里鎮,0105,399,102,501,45,546,838,65.16%,47.61%,1
南投縣,埔里鎮,0106,450,111,561,50,611,1226,49.84%,36.7%,1
南投縣,埔里鎮,0107,586,137,723,63,786,1263,62.23%,46.4%,1
南投縣,埔里鎮,0108,509,100,609,29,638,1045,61.05%,48.71%,1
南投縣,埔里鎮,0109,518,114,632,45,677,1120,60.45%,46.25%,1
南投縣,埔里鎮,0110,517,122,639,52,691,1062,65.07%,48.68%,1
南投縣,埔里鎮,0111,443,106,549,36,585,1022,57.24%,43.35%,1
南投縣,埔里鎮,0112,468,102,570,26,596,1051,56.71%,44.53%,1
南投縣,埔里鎮,0113,475,104,579,38,617,1106,55.79%,42.95%,1
南投縣,埔里鎮,0114,471,110,581,28,609,1098,55.46%,42.9%,1
南投縣,埔里鎮,0115,504,98,602,31,633,1067,59.33%,47.24%,1
南投縣,埔里鎮,0116,281,99,380,48,428,725,59.03%,38.76%,1
南投縣,埔里鎮,0117,416,86,502,30,532,905,58.78%,45.97%,1
南投縣,埔里鎮,0118,455,129,584,51,635,1179,53.86%,38.59%,1
南投縣,埔里鎮,0119,367,87,454,37,491,944,52.01%,38.88%,1
南投縣,埔里鎮,0120,195,45,240,29,269,465,57.85%,41.94%,1
南投縣,埔里鎮,0121,458,127,585,45,630,1133,55.6%,40.42%,1
南投縣,埔里鎮,0122,437,101,538,40,578,1100,52.55%,39.73%,1
南投縣,埔里鎮,0123,512,119,631,56,687,1155,59.48%,44.33%,1
南投縣,埔里鎮,0124,485,130,615,58,673,1254,53.67%,38.68%,1
南投縣,埔里鎮,0125,515,123,638,60,698,1296,53.86%,39.74%,1
南投縣,埔里鎮,0126,476,142,618,46,664,1023,64.91%,46.53%,1
南投縣,埔里鎮,0127,375,68,443,18,461,964,47.82%,38.9%,1
南投縣,埔里鎮,0128,437,98,535,33,568,986,57.61%,44.32%,1
南投縣,埔里鎮,0129,483,106,589,28,617,1016,60.73%,47.54%,1
南投縣,埔里鎮,0130,368,118,486,46,532,898,59.24%,40.98%,1
南投縣,埔里鎮,0131,440,111,551,42,593,980,60.51%,44.9%,1
南投縣,埔里鎮,0132,425,106,531,27,558,933,59.81%,45.55%,1
南投縣,埔里鎮,0133,445,151,596,54,650,929,69.97%,47.9%,1
南投縣,埔里鎮,0134,418,105,523,66,589,1032,57.07%,40.5%,1
南投縣,埔里鎮,0135,113,25,138,9,147,315,46.67%,35.87%,1
南投縣,埔里鎮,0136,503,148,651,62,713,1363,52.31%,36.9%,1
南投縣,埔里鎮,0137,313,88,401,38,439,725,60.55%,43.17%,1
南投縣,埔里鎮,0138,287,112,399,29,428,705,60.71%,40.71%,1
南投縣,埔里鎮,0139,350,105,455,33,488,751,64.98%,46.6%,1
南投縣,埔里鎮,0140,402,88,490,44,534,932,57.3%,43.13%,1
南投縣,埔里鎮,0141,412,118,530,37,567,956,59.31%,43.1%,1
南投縣,埔里鎮,0142,156,39,195,13,208,376,55.32%,41.49%,1
南投縣,埔里鎮,0143,284,85,369,38,407,682,59.68%,41.64%,1
南投縣,埔里鎮,0144,534,56,590,55,645,990,65.15%,53.94%,1
南投縣,埔里鎮,0145,486,105,591,79,670,1324,50.6%,36.71%,1
南投縣,埔里鎮,0146,90,39,129,15,144,298,48.32%,30.2%,1
南投縣,埔里鎮,0147,473,102,575,76,651,1170,55.64%,40.43%,1
南投縣,埔里鎮,0148,258,74,332,22,354,604,58.61%,42.72%,1
南投縣,埔里鎮,0149,387,121,508,47,555,999,55.56%,38.74%,1
南投縣,埔里鎮,0150,344,78,422,25,447,923,48.43%,37.27%,1
南投縣,埔里鎮,0151,403,103,506,31,537,887,60.54%,45.43%,1
南投縣,埔里鎮,0152,380,97,477,37,514,981,52.4%,38.74%,1
南投縣,草屯鎮,0153,482,101,583,24,607,998,60.82%,48.3%,1
南投縣,草屯鎮,0154,491,106,597,26,623,1127,55.28%,43.57%,1
南投縣,草屯鎮,0155,603,101,704,27,731,1401,52.18%,43.04%,1
南投縣,草屯鎮,0156,428,152,580,35,615,1110,55.41%,38.56%,1
南投縣,草屯鎮,0157,568,144,712,49,761,1285,59.22%,44.2%,1
南投縣,草屯鎮,0158,399,101,500,34,534,936,57.05%,42.63%,1
南投縣,草屯鎮,0159,474,138,612,48,660,1141,57.84%,41.54%,1
南投縣,草屯鎮,0160,335,83,418,27,445,705,63.12%,47.52%,1
南投縣,草屯鎮,0161,484,157,641,26,667,1121,59.5%,43.18%,1
南投縣,草屯鎮,0162,426,117,543,38,581,877,66.25%,48.57%,1
南投縣,草屯鎮,0163,620,141,761,54,815,1401,58.17%,44.25%,1
南投縣,草屯鎮,0164,514,136,650,48,698,1267,55.09%,40.57%,1
南投縣,草屯鎮,0165,563,87,650,71,721,1214,59.39%,46.38%,1
南投縣,草屯鎮,0166,529,152,681,63,744,1259,59.09%,42.02%,1
南投縣,草屯鎮,0167,666,174,840,29,869,1442,60.26%,46.19%,1
南投縣,草屯鎮,0168,572,144,716,45,761,1273,59.78%,44.93%,1
南投縣,草屯鎮,0169,499,118,617,35,652,1145,56.94%,43.58%,1
南投縣,草屯鎮,0170,557,130,687,33,720,1279,56.29%,43.55%,1
南投縣,草屯鎮,0171,514,103,617,24,641,1158,55.35%,44.39%,1
南投縣,草屯鎮,0172,715,113,828,53,881,1335,65.99%,53.56%,1
南投縣,草屯鎮,0173,592,132,724,35,759,1178,64.43%,50.25%,1
南投縣,草屯鎮,0174,608,136,744,38,782,1327,58.93%,45.82%,1
南投縣,草屯鎮,0175,429,139,568,23,591,1000,59.1%,42.9%,1
南投縣,草屯鎮,0176,574,110,684,30,714,1257,56.8%,45.66%,1
南投縣,草屯鎮,0177,431,101,532,33,565,883,63.99%,48.81%,1
南投縣,草屯鎮,0178,481,112,593,29,622,1121,55.49%,42.91%,1
南投縣,草屯鎮,0179,494,91,585,36,621,1043,59.54%,47.36%,1
南投縣,草屯鎮,0180,489,96,585,21,606,979,61.9%,49.95%,1
南投縣,草屯鎮,0181,387,106,493,30,523,1048,49.9%,36.93%,1
南投縣,草屯鎮,0182,427,107,534,39,573,1009,56.79%,42.32%,1
南投縣,草屯鎮,0183,495,90,585,22,607,1138,53.34%,43.5%,1
南投縣,草屯鎮,0184,466,161,627,38,665,1197,55.56%,38.93%,1
南投縣,草屯鎮,0185,620,147,767,40,807,1364,59.16%,45.45%,1
南投縣,草屯鎮,0186,450,125,575,44,619,1059,58.45%,42.49%,1
南投縣,草屯鎮,0187,495,113,608,48,656,1108,59.21%,44.68%,1
南投縣,草屯鎮,0188,375,96,471,31,502,879,57.11%,42.66%,1
南投縣,草屯鎮,0189,415,100,515,49,564,957,58.93%,43.36%,1
南投縣,草屯鎮,0190,515,121,636,20,656,1395,47.03%,36.92%,1
南投縣,草屯鎮,0191,512,130,642,40,682,1101,61.94%,46.5%,1
南投縣,草屯鎮,0192,521,142,663,34,697,1297,53.74%,40.17%,1
南投縣,草屯鎮,0193,287,80,367,25,392,877,44.7%,32.73%,1
南投縣,草屯鎮,0194,487,133,620,56,676,1376,49.13%,35.39%,1
南投縣,草屯鎮,0195,493,115,608,43,651,1008,64.58%,48.91%,1
南投縣,草屯鎮,0196,506,121,627,40,667,1080,61.76%,46.85%,1
南投縣,草屯鎮,0197,393,111,504,58,562,1017,55.26%,38.64%,1
南投縣,草屯鎮,0198,433,135,568,44,612,961,63.68%,45.06%,1
南投縣,草屯鎮,0199,510,141,651,57,708,1160,61.03%,43.97%,1
南投縣,草屯鎮,0200,495,107,602,40,642,1121,57.27%,44.16%,1
南投縣,草屯鎮,0201,518,143,661,39,700,1243,56.32%,41.67%,1
南投縣,草屯鎮,0202,404,115,519,25,544,932,58.37%,43.35%,1
南投縣,草屯鎮,0203,608,192,800,58,858,1323,64.85%,45.96%,1
南投縣,草屯鎮,0204,565,159,724,44,768,1518,50.59%,37.22%,1
南投縣,草屯鎮,0205,389,125,514,55,569,923,61.65%,42.15%,1
南投縣,草屯鎮,0206,375,124,499,36,535,970,55.15%,38.66%,1
南投縣,草屯鎮,0207,421,120,541,27,568,1026,55.36%,41.03%,1
南投縣,草屯鎮,0208,596,174,770,53,823,1466,56.14%,40.65%,1
南投縣,草屯鎮,0209,494,136,630,44,674,1180,57.12%,41.86%,1
南投縣,草屯鎮,0210,473,124,597,18,615,1006,61.13%,47.02%,1
南投縣,草屯鎮,0211,368,100,468,37,505,1000,50.5%,36.8%,1
南投縣,草屯鎮,0212,518,135,653,35,688,1128,60.99%,45.92%,1
南投縣,草屯鎮,0213,254,69,323,14,337,623,54.09%,40.77%,1
南投縣,草屯鎮,0214,265,104,369,52,421,707,59.55%,37.48%,1
南投縣,草屯鎮,0215,288,67,355,33,388,719,53.96%,40.06%,1
南投縣,草屯鎮,0216,188,44,232,26,258,527,48.96%,35.67%,1
南投縣,草屯鎮,0217,514,128,642,51,693,1183,58.58%,43.45%,1
南投縣,草屯鎮,0218,387,109,496,36,532,869,61.22%,44.53%,1
南投縣,草屯鎮,0219,403,129,532,24,556,1132,49.12%,35.6%,1
南投縣,草屯鎮,0220,399,115,514,50,564,949,59.43%,42.04%,1
南投縣,草屯鎮,0221,455,99,554,36,590,965,61.14%,47.15%,1
南投縣,草屯鎮,0222,421,107,528,36,564,1068,52.81%,39.42%,1
南投縣,草屯鎮,0223,453,125,578,49,627,1024,61.23%,44.24%,1
南投縣,草屯鎮,0224,261,64,325,27,352,642,54.83%,40.65%,1
南投縣,草屯鎮,0225,383,111,494,46,540,1017,53.1%,37.66%,1
南投縣,草屯鎮,0226,480,104,584,39,623,1092,57.05%,43.96%,1
南投縣,草屯鎮,0227,458,137,595,61,656,1170,56.07%,39.15%,1
南投縣,草屯鎮,0228,487,118,605,60,665,1106,60.13%,44.03%,1
南投縣,竹山鎮,0229,515,132,647,57,704,1170,60.17%,44.02%,1
南投縣,竹山鎮,0230,361,124,485,47,532,850,62.59%,42.47%,1
南投縣,竹山鎮,0231,242,60,302,40,342,621,55.07%,38.97%,1
南投縣,竹山鎮,0232,362,108,470,30,500,905,55.25%,40%,1
南投縣,竹山鎮,0233,401,94,495,61,556,1099,50.59%,36.49%,1
南投縣,竹山鎮,0234,466,113,579,64,643,1214,52.97%,38.39%,1
南投縣,竹山鎮,0235,575,138,713,64,777,1287,60.37%,44.68%,1
南投縣,竹山鎮,0236,480,128,608,67,675,1191,56.68%,40.3%,1
南投縣,竹山鎮,0237,445,124,569,68,637,1118,56.98%,39.8%,1
南投縣,竹山鎮,0238,562,126,688,37,725,1278,56.73%,43.97%,1
南投縣,竹山鎮,0239,486,126,612,53,665,1153,57.68%,42.15%,1
南投縣,竹山鎮,0240,476,113,589,88,677,1243,54.47%,38.29%,1
南投縣,竹山鎮,0241,543,135,678,54,732,1308,55.96%,41.51%,1
南投縣,竹山鎮,0242,519,147,666,52,718,1358,52.87%,38.22%,1
南投縣,竹山鎮,0243,406,106,512,60,572,1044,54.79%,38.89%,1
南投縣,竹山鎮,0244,241,47,288,33,321,511,62.82%,47.16%,1
南投縣,竹山鎮,0245,289,57,346,15,361,682,52.93%,42.38%,1
南投縣,竹山鎮,0246,335,126,461,25,486,989,49.14%,33.87%,1
南投縣,竹山鎮,0247,553,154,707,43,750,1378,54.43%,40.13%,1
南投縣,竹山鎮,0248,75,30,105,6,111,217,51.15%,34.56%,1
南投縣,竹山鎮,0249,206,54,260,28,288,479,60.13%,43.01%,1
南投縣,竹山鎮,0250,131,46,177,22,199,430,46.28%,30.47%,1
南投縣,竹山鎮,0251,587,153,740,70,810,1437,56.37%,40.85%,1
南投縣,竹山鎮,0252,559,169,728,43,771,1286,59.95%,43.47%,1
南投縣,竹山鎮,0253,478,118,596,61,657,1080,60.83%,44.26%,1
南投縣,竹山鎮,0254,446,107,553,40,593,1070,55.42%,41.68%,1
南投縣,竹山鎮,0255,540,143,683,54,737,1295,56.91%,41.7%,1
南投縣,竹山鎮,0256,443,117,560,32,592,1047,56.54%,42.31%,1
南投縣,竹山鎮,0257,544,120,664,60,724,1300,55.69%,41.85%,1
南投縣,竹山鎮,0258,321,82,403,25,428,908,47.14%,35.35%,1
南投縣,竹山鎮,0259,265,107,372,48,420,821,51.16%,32.28%,1
南投縣,竹山鎮,0260,562,154,716,49,765,1320,57.95%,42.58%,1
南投縣,竹山鎮,0261,378,88,466,28,494,967,51.09%,39.09%,1
南投縣,竹山鎮,0262,219,48,267,24,291,595,48.91%,36.81%,1
南投縣,竹山鎮,0263,301,100,401,71,472,859,54.95%,35.04%,1
南投縣,竹山鎮,0264,472,110,582,65,647,1196,54.1%,39.46%,1
南投縣,竹山鎮,0265,265,68,333,36,369,649,56.86%,40.83%,1
南投縣,竹山鎮,0266,525,152,677,64,741,1341,55.26%,39.15%,1
南投縣,竹山鎮,0267,415,125,540,73,613,1222,50.16%,33.96%,1
南投縣,竹山鎮,0268,252,68,320,27,347,602,57.64%,41.86%,1
南投縣,竹山鎮,0269,251,62,313,33,346,617,56.08%,40.68%,1
南投縣,竹山鎮,0270,338,99,437,52,489,793,61.66%,42.62%,1
南投縣,竹山鎮,0271,387,86,473,21,494,922,53.58%,41.97%,1
南投縣,竹山鎮,0272,141,30,171,23,194,366,53.01%,38.52%,1
南投縣,竹山鎮,0273,185,29,214,10,224,509,44.01%,36.35%,1
南投縣,竹山鎮,0274,78,19,97,7,104,193,53.89%,40.41%,1
南投縣,竹山鎮,0275,182,47,229,22,251,406,61.82%,44.83%,1
南投縣,竹山鎮,0276,176,50,226,26,252,495,50.91%,35.56%,1
南投縣,竹山鎮,0277,78,20,98,8,106,307,34.53%,25.41%,1
南投縣,竹山鎮,0278,171,31,202,32,234,440,53.18%,38.86%,1
南投縣,竹山鎮,0279,220,50,270,43,313,577,54.25%,38.13%,1
南投縣,竹山鎮,0280,109,64,173,39,212,486,43.62%,22.43%,1
南投縣,竹山鎮,0281,103,24,127,21,148,403,36.72%,25.56%,1
南投縣,集集鎮,0282,498,104,602,47,649,1070,60.65%,46.54%,1
南投縣,集集鎮,0283,421,107,528,33,561,918,61.11%,45.86%,1
南投縣,集集鎮,0284,247,72,319,29,348,581,59.9%,42.51%,1
南投縣,集集鎮,0285,523,138,661,52,713,1194,59.72%,43.8%,1
南投縣,集集鎮,0286,141,58,199,22,221,488,45.29%,28.89%,1
南投縣,集集鎮,0287,218,57,275,38,313,504,62.1%,43.25%,1
南投縣,集集鎮,0288,353,106,459,104,563,910,61.87%,38.79%,1
南投縣,集集鎮,0289,332,88,420,63,483,773,62.48%,42.95%,1
南投縣,集集鎮,0290,275,89,364,38,402,709,56.7%,38.79%,1
南投縣,集集鎮,0291,380,125,505,28,533,960,55.52%,39.58%,1
南投縣,集集鎮,0292,193,61,254,21,275,503,54.67%,38.37%,1
南投縣,集集鎮,0293,155,28,183,28,211,419,50.36%,36.99%,1
南投縣,集集鎮,0294,187,51,238,23,261,582,44.85%,32.13%,1
南投縣,名間鄉,0295,502,158,660,70,730,1050,69.52%,47.81%,1
南投縣,名間鄉,0296,396,103,499,55,554,920,60.22%,43.04%,1
南投縣,名間鄉,0297,340,102,442,32,474,727,65.2%,46.77%,1
南投縣,名間鄉,0298,420,93,513,39,552,861,64.11%,48.78%,1
南投縣,名間鄉,0299,377,108,485,35,520,897,57.97%,42.03%,1
南投縣,名間鄉,0300,472,129,601,47,648,1055,61.42%,44.74%,1
南投縣,名間鄉,0301,502,127,629,70,699,1184,59.04%,42.4%,1
南投縣,名間鄉,0302,302,105,407,39,446,783,56.96%,38.57%,1
南投縣,名間鄉,0303,349,91,440,46,486,781,62.23%,44.69%,1
南投縣,名間鄉,0304,399,92,491,42,533,977,54.55%,40.84%,1
南投縣,名間鄉,0305,396,102,498,63,561,1015,55.27%,39.01%,1
南投縣,名間鄉,0306,416,95,511,37,548,914,59.96%,45.51%,1
南投縣,名間鄉,0307,446,114,560,18,578,1028,56.23%,43.39%,1
南投縣,名間鄉,0308,471,105,576,37,613,1018,60.22%,46.27%,1
南投縣,名間鄉,0309,520,154,674,75,749,1274,58.79%,40.82%,1
南投縣,名間鄉,0310,309,103,412,40,452,755,59.87%,40.93%,1
南投縣,名間鄉,0311,422,124,546,46,592,895,66.15%,47.15%,1
南投縣,名間鄉,0312,419,73,492,31,523,892,58.63%,46.97%,1
南投縣,名間鄉,0313,360,135,495,57,552,951,58.04%,37.85%,1
南投縣,名間鄉,0314,515,147,662,62,724,1261,57.41%,40.84%,1
南投縣,名間鄉,0315,297,101,398,44,442,768,57.55%,38.67%,1
南投縣,名間鄉,0316,390,127,517,68,585,962,60.81%,40.54%,1
南投縣,名間鄉,0317,359,97,456,76,532,867,61.36%,41.41%,1
南投縣,名間鄉,0318,400,105,505,57,562,930,60.43%,43.01%,1
南投縣,名間鄉,0319,247,82,329,59,388,641,60.53%,38.53%,1
南投縣,名間鄉,0320,183,67,250,30,280,530,52.83%,34.53%,1
南投縣,名間鄉,0321,385,110,495,60,555,931,59.61%,41.35%,1
南投縣,名間鄉,0322,480,128,608,63,671,1127,59.54%,42.59%,1
南投縣,名間鄉,0323,189,60,249,45,294,443,66.37%,42.66%,1
南投縣,名間鄉,0324,379,106,485,47,532,870,61.15%,43.56%,1
南投縣,名間鄉,0325,247,89,336,54,390,621,62.8%,39.77%,1
南投縣,名間鄉,0326,413,143,556,45,601,1179,50.98%,35.03%,1
南投縣,名間鄉,0327,406,89,495,61,556,881,63.11%,46.08%,1
南投縣,名間鄉,0328,418,113,531,65,596,876,68.04%,47.72%,1
南投縣,名間鄉,0329,339,78,417,57,474,783,60.54%,43.3%,1
南投縣,名間鄉,0330,298,75,373,46,419,778,53.86%,38.3%,1
南投縣,名間鄉,0331,387,100,487,52,539,983,54.83%,39.37%,1
南投縣,鹿谷鄉,0332,355,87,442,41,483,934,51.71%,38.01%,1
南投縣,鹿谷鄉,0333,382,106,488,49,537,940,57.13%,40.64%,1
南投縣,鹿谷鄉,0334,327,98,425,30,455,852,53.4%,38.38%,1
南投縣,鹿谷鄉,0335,134,34,168,33,201,451,44.57%,29.71%,1
南投縣,鹿谷鄉,0336,377,82,459,30,489,810,60.37%,46.54%,1
南投縣,鹿谷鄉,0337,526,129,655,57,712,1142,62.35%,46.06%,1
南投縣,鹿谷鄉,0338,279,53,332,29,361,766,47.13%,36.42%,1
南投縣,鹿谷鄉,0339,370,99,469,48,517,884,58.48%,41.86%,1
南投縣,鹿谷鄉,0340,319,98,417,43,460,811,56.72%,39.33%,1
南投縣,鹿谷鄉,0341,191,55,246,30,276,581,47.5%,32.87%,1
南投縣,鹿谷鄉,0342,204,63,267,27,294,578,50.87%,35.29%,1
南投縣,鹿谷鄉,0343,200,52,252,27,279,467,59.74%,42.83%,1
南投縣,鹿谷鄉,0344,255,60,315,31,346,622,55.63%,41%,1
南投縣,鹿谷鄉,0345,271,82,353,28,381,740,51.49%,36.62%,1
南投縣,鹿谷鄉,0346,299,90,389,44,433,767,56.45%,38.98%,1
南投縣,鹿谷鄉,0347,398,89,487,42,529,909,58.2%,43.78%,1
南投縣,鹿谷鄉,0348,278,68,346,29,375,713,52.59%,38.99%,1
南投縣,鹿谷鄉,0349,255,56,311,25,336,717,46.86%,35.56%,1
南投縣,鹿谷鄉,0350,278,86,364,36,400,794,50.38%,35.01%,1
南投縣,鹿谷鄉,0351,239,73,312,24,336,726,46.28%,32.92%,1
南投縣,鹿谷鄉,0352,221,60,281,34,315,737,42.74%,29.99%,1
南投縣,中寮鄉,0353,347,101,448,59,507,822,61.68%,42.21%,1
南投縣,中寮鄉,0354,109,36,145,10,155,253,61.26%,43.08%,1
南投縣,中寮鄉,0355,69,19,88,6,94,221,42.53%,31.22%,1
南投縣,中寮鄉,0356,126,25,151,6,157,353,44.48%,35.69%,1
南投縣,中寮鄉,0357,167,40,207,30,237,427,55.5%,39.11%,1
南投縣,中寮鄉,0358,156,49,205,22,227,406,55.91%,38.42%,1
南投縣,中寮鄉,0359,109,34,143,16,159,307,51.79%,35.5%,1
南投縣,中寮鄉,0360,286,80,366,35,401,661,60.67%,43.27%,1
南投縣,中寮鄉,0361,130,39,169,24,193,290,66.55%,44.83%,1
南投縣,中寮鄉,0362,409,128,537,36,573,973,58.89%,42.03%,1
南投縣,中寮鄉,0363,333,92,425,31,456,754,60.48%,44.16%,1
南投縣,中寮鄉,0364,263,74,337,31,368,662,55.59%,39.73%,1
南投縣,中寮鄉,0365,177,40,217,12,229,490,46.73%,36.12%,1
南投縣,中寮鄉,0366,122,33,155,20,175,335,52.24%,36.42%,1
南投縣,中寮鄉,0367,436,97,533,43,576,990,58.18%,44.04%,1
南投縣,中寮鄉,0368,212,56,268,24,292,461,63.34%,45.99%,1
南投縣,中寮鄉,0369,263,86,349,31,380,614,61.89%,42.83%,1
南投縣,中寮鄉,0370,341,101,442,76,518,895,57.88%,38.1%,1
南投縣,中寮鄉,0371,177,52,229,37,266,465,57.2%,38.06%,1
南投縣,中寮鄉,0372,286,66,352,50,402,682,58.94%,41.94%,1
南投縣,中寮鄉,0373,210,57,267,36,303,490,61.84%,42.86%,1
南投縣,中寮鄉,0374,277,69,346,49,395,643,61.43%,43.08%,1
南投縣,中寮鄉,0375,218,47,265,19,284,459,61.87%,47.49%,1
南投縣,中寮鄉,0376,183,52,235,32,267,528,50.57%,34.66%,1
南投縣,魚池鄉,0377,377,109,486,46,532,922,57.7%,40.89%,1
南投縣,魚池鄉,0378,471,119,590,56,646,1098,58.83%,42.9%,1
南投縣,魚池鄉,0379,275,78,353,33,386,720,53.61%,38.19%,1
南投縣,魚池鄉,0380,379,88,467,40,507,860,58.95%,44.07%,1
南投縣,魚池鄉,0381,162,64,226,36,262,514,50.97%,31.52%,1
南投縣,魚池鄉,0382,218,53,271,11,282,574,49.13%,37.98%,1
南投縣,魚池鄉,0383,473,139,612,59,671,1249,53.72%,37.87%,1
南投縣,魚池鄉,0384,144,31,175,17,192,293,65.53%,49.15%,1
南投縣,魚池鄉,0385,176,73,249,29,278,513,54.19%,34.31%,1
南投縣,魚池鄉,0386,72,24,96,6,102,186,54.84%,38.71%,1
南投縣,魚池鄉,0387,318,83,401,26,427,841,50.77%,37.81%,1
南投縣,魚池鄉,0388,115,39,154,15,169,270,62.59%,42.59%,1
南投縣,魚池鄉,0389,93,42,135,17,152,275,55.27%,33.82%,1
南投縣,魚池鄉,0390,85,36,121,8,129,282,45.74%,30.14%,1
南投縣,魚池鄉,0391,139,35,174,12,186,392,47.45%,35.46%,1
南投縣,魚池鄉,0392,213,58,271,32,303,556,54.5%,38.31%,1
南投縣,魚池鄉,0393,72,13,85,11,96,176,54.55%,40.91%,1
南投縣,魚池鄉,0394,202,49,251,21,272,578,47.06%,34.95%,1
南投縣,魚池鄉,0395,155,53,208,16,224,439,51.03%,35.31%,1
南投縣,魚池鄉,0396,387,78,465,27,492,844,58.29%,45.85%,1
南投縣,魚池鄉,0397,338,90,428,39,467,868,53.8%,38.94%,1
南投縣,魚池鄉,0398,149,29,178,12,190,405,46.91%,36.79%,1
南投縣,魚池鄉,0399,214,66,280,25,305,537,56.8%,39.85%,1
南投縣,魚池鄉,0400,134,30,164,20,184,335,54.93%,40%,1
南投縣,魚池鄉,0401,71,15,86,18,104,231,45.02%,30.74%,1
南投縣,國姓鄉,0402,440,100,540,60,600,964,62.24%,45.64%,1
南投縣,國姓鄉,0403,320,72,392,23,415,736,56.39%,43.48%,1
南投縣,國姓鄉,0404,343,80,423,54,477,801,59.55%,42.82%,1
南投縣,國姓鄉,0405,434,85,519,15,534,964,55.39%,45.02%,1
南投縣,國姓鄉,0406,283,65,348,37,385,686,56.12%,41.25%,1
南投縣,國姓鄉,0407,267,62,329,33,362,661,54.77%,40.39%,1
南投縣,國姓鄉,0408,281,54,335,43,378,730,51.78%,38.49%,1
南投縣,國姓鄉,0409,276,99,375,59,434,774,56.07%,35.66%,1
南投縣,國姓鄉,0410,313,87,400,23,423,706,59.92%,44.33%,1
南投縣,國姓鄉,0411,386,129,515,53,568,1012,56.13%,38.14%,1
南投縣,國姓鄉,0412,288,82,370,23,393,868,45.28%,33.18%,1
南投縣,國姓鄉,0413,452,78,530,32,562,918,61.22%,49.24%,1
南投縣,國姓鄉,0414,391,87,478,57,535,937,57.1%,41.73%,1
南投縣,國姓鄉,0415,309,93,402,51,453,815,55.58%,37.91%,1
南投縣,國姓鄉,0416,356,280,636,44,680,1134,59.96%,31.39%,1
南投縣,國姓鄉,0417,275,69,344,34,378,714,52.94%,38.52%,1
南投縣,國姓鄉,0418,454,102,556,48,604,1095,55.16%,41.46%,1
南投縣,國姓鄉,0419,166,50,216,21,237,448,52.9%,37.05%,1
南投縣,國姓鄉,0420,421,98,519,51,570,1064,53.57%,39.57%,1
南投縣,國姓鄉,0421,222,52,274,23,297,570,52.11%,38.95%,1
南投縣,水里鄉,0422,312,78,390,32,422,757,55.75%,41.22%,1
南投縣,水里鄉,0423,216,62,278,35,313,554,56.5%,38.99%,1
南投縣,水里鄉,0424,381,148,529,50,579,999,57.96%,38.14%,1
南投縣,水里鄉,0425,228,63,291,23,314,616,50.97%,37.01%,1
南投縣,水里鄉,0426,381,92,473,37,510,875,58.29%,43.54%,1
南投縣,水里鄉,0427,221,52,273,9,282,480,58.75%,46.04%,1
南投縣,水里鄉,0428,173,42,215,30,245,450,54.44%,38.44%,1
南投縣,水里鄉,0429,244,67,311,43,354,643,55.05%,37.95%,1
南投縣,水里鄉,0430,426,130,556,30,586,1004,58.37%,42.43%,1
南投縣,水里鄉,0431,316,65,381,15,396,741,53.44%,42.65%,1
南投縣,水里鄉,0432,343,109,452,18,470,802,58.6%,42.77%,1
南投縣,水里鄉,0433,454,125,579,62,641,998,64.23%,45.49%,1
南投縣,水里鄉,0434,284,91,375,64,439,800,54.88%,35.5%,1
南投縣,水里鄉,0435,270,73,343,21,364,589,61.8%,45.84%,1
南投縣,水里鄉,0436,326,88,414,58,472,887,53.21%,36.75%,1
南投縣,水里鄉,0437,472,117,589,44,633,1217,52.01%,38.78%,1
南投縣,水里鄉,0438,60,11,71,1,72,205,35.12%,29.27%,1
南投縣,水里鄉,0439,148,33,181,28,209,330,63.33%,44.85%,1
南投縣,水里鄉,0440,418,110,528,33,561,1100,51%,38%,1
南投縣,水里鄉,0441,70,18,88,3,91,275,33.09%,25.45%,1
南投縣,水里鄉,0442,96,27,123,4,127,318,39.94%,30.19%,1
南投縣,水里鄉,0443,304,92,396,53,449,818,54.89%,37.16%,1
南投縣,信義鄉,0444,448,128,576,105,681,1201,56.7%,37.3%,1
南投縣,信義鄉,0445,121,24,145,22,167,329,50.76%,36.78%,1
南投縣,信義鄉,0446,169,74,243,21,264,516,51.16%,32.75%,1
南投縣,信義鄉,0447,136,31,167,23,190,424,44.81%,32.08%,1
南投縣,信義鄉,0448,117,27,144,7,151,321,47.04%,36.45%,1
南投縣,信義鄉,0449,267,81,348,30,378,648,58.33%,41.2%,1
南投縣,信義鄉,0450,253,73,326,98,424,584,72.6%,43.32%,1
南投縣,信義鄉,0451,268,71,339,10,349,1376,25.36%,19.48%,1
南投縣,信義鄉,0452,307,88,395,26,421,979,43%,31.36%,1
南投縣,信義鄉,0453,219,90,309,82,391,530,73.77%,41.32%,1
南投縣,信義鄉,0454,348,84,432,54,486,961,50.57%,36.21%,1
南投縣,信義鄉,0455,204,31,235,20,255,464,54.96%,43.97%,1
南投縣,信義鄉,0456,60,213,273,30,303,517,58.61%,11.61%,1
南投縣,信義鄉,0457,53,22,75,13,88,149,59.06%,35.57%,1
南投縣,信義鄉,0458,423,170,593,167,760,1020,74.51%,41.47%,1
南投縣,信義鄉,0459,357,106,463,174,637,929,68.57%,38.43%,1
南投縣,信義鄉,0460,75,30,105,18,123,274,44.89%,27.37%,1
南投縣,信義鄉,0461,445,112,557,75,632,900,70.22%,49.44%,1
南投縣,信義鄉,0462,297,98,395,56,451,617,73.1%,48.14%,1
南投縣,信義鄉,0463,235,70,305,40,345,560,61.61%,41.96%,1
南投縣,仁愛鄉,0464,377,110,487,31,518,973,53.24%,38.75%,1
南投縣,仁愛鄉,0465,109,33,142,8,150,296,50.68%,36.82%,1
南投縣,仁愛鄉,0466,320,64,384,17,401,900,44.56%,35.56%,1
南投縣,仁愛鄉,0467,223,61,284,14,298,460,64.78%,48.48%,1
南投縣,仁愛鄉,0468,149,27,176,7,183,305,60%,48.85%,1
南投縣,仁愛鄉,0469,14,3,17,3,20,58,34.48%,24.14%,1
南投縣,仁愛鄉,0470,285,68,353,16,369,952,38.76%,29.94%,1
南投縣,仁愛鄉,0471,185,47,232,5,237,679,34.9%,27.25%,1
南投縣,仁愛鄉,0472,244,71,315,54,369,623,59.23%,39.17%,1
南投縣,仁愛鄉,0473,116,40,156,5,161,597,26.97%,19.43%,1
南投縣,仁愛鄉,0474,184,39,223,24,247,384,64.32%,47.92%,1
南投縣,仁愛鄉,0475,45,12,57,5,62,121,51.24%,37.19%,1
南投縣,仁愛鄉,0476,106,21,127,4,131,264,49.62%,40.15%,1
南投縣,仁愛鄉,0477,273,72,345,36,381,509,74.85%,53.63%,1
南投縣,仁愛鄉,0478,133,42,175,32,207,338,61.24%,39.35%,1
南投縣,仁愛鄉,0479,69,15,84,8,92,169,54.44%,40.83%,1
南投縣,仁愛鄉,0480,213,51,264,29,293,613,47.8%,34.75%,1
南投縣,仁愛鄉,0481,127,46,173,17,190,404,47.03%,31.44%,1
南投縣,仁愛鄉,0482,50,22,72,5,77,134,57.46%,37.31%,1
南投縣,仁愛鄉,0483,235,91,326,64,390,630,61.9%,37.3%,1
南投縣,仁愛鄉,0484,215,67,282,16,298,763,39.06%,28.18%,1
南投縣,仁愛鄉,0485,448,77,525,39,564,889,63.44%,50.39%,1
南投縣,仁愛鄉,0486,311,81,392,47,439,672,65.33%,46.28%,1
南投縣,仁愛鄉,0487,57,197,254,18,272,447,60.85%,12.75%,1
南投縣,仁愛鄉,0488,239,48,287,15,302,409,73.84%,58.44%,1
雲林縣,斗六市,0411,242,80,322,10,332,644,51.55%,37.58%,1
雲林縣,斗六市,0412,226,80,306,36,342,617,55.43%,36.63%,1
雲林縣,斗六市,0413,378,91,469,33,502,764,65.71%,49.48%,1
雲林縣,斗六市,0414,335,120,455,32,487,784,62.12%,42.73%,1
雲林縣,斗六市,0415,307,100,407,32,439,760,57.76%,40.39%,1
雲林縣,斗六市,0416,840,223,1063,76,1139,1881,60.55%,44.66%,1
雲林縣,斗六市,0417,730,191,921,64,985,1829,53.85%,39.91%,1
雲林縣,斗六市,0418,603,127,730,39,769,1255,61.27%,48.05%,1
雲林縣,斗六市,0419,557,117,674,30,704,1090,64.59%,51.1%,1
雲林縣,斗六市,0420,527,113,640,33,673,1103,61.02%,47.78%,1
雲林縣,斗六市,0421,524,133,657,49,706,1176,60.03%,44.56%,1
雲林縣,斗六市,0422,648,168,816,30,846,1529,55.33%,42.38%,1
雲林縣,斗六市,0423,614,125,739,44,783,1335,58.65%,45.99%,1
雲林縣,斗六市,0424,767,214,981,58,1039,1770,58.7%,43.33%,1
雲林縣,斗六市,0425,547,159,706,36,742,1308,56.73%,41.82%,1
雲林縣,斗六市,0426,882,205,1087,78,1165,2171,53.66%,40.63%,1
雲林縣,斗六市,0427,528,179,707,42,749,1193,62.78%,44.26%,1
雲林縣,斗六市,0428,760,167,927,52,979,1572,62.28%,48.35%,1
雲林縣,斗六市,0429,420,101,521,30,551,1009,54.61%,41.63%,1
雲林縣,斗六市,0430,561,138,699,45,744,1195,62.26%,46.95%,1
雲林縣,斗六市,0431,631,208,839,32,871,1415,61.55%,44.59%,1
雲林縣,斗六市,0432,470,154,624,48,672,1101,61.04%,42.69%,1
雲林縣,斗六市,0433,655,169,824,40,864,1648,52.43%,39.75%,1
雲林縣,斗六市,0434,627,142,769,31,800,1588,50.38%,39.48%,1
雲林縣,斗六市,0435,637,140,777,36,813,1392,58.41%,45.76%,1
雲林縣,斗六市,0436,638,143,781,43,824,1422,57.95%,44.87%,1
雲林縣,斗六市,0437,433,92,525,31,556,1187,46.84%,36.48%,1
雲林縣,斗六市,0438,418,133,551,44,595,1142,52.1%,36.6%,1
雲林縣,斗六市,0439,669,151,820,46,866,1421,60.94%,47.08%,1
雲林縣,斗六市,0440,537,144,681,33,714,1261,56.62%,42.59%,1
雲林縣,斗六市,0441,581,166,747,42,789,1506,52.39%,38.58%,1
雲林縣,斗六市,0442,528,144,672,29,701,1214,57.74%,43.49%,1
雲林縣,斗六市,0443,712,71,783,79,862,1362,63.29%,52.28%,1
雲林縣,斗六市,0444,448,127,575,22,597,1097,54.42%,40.84%,1
雲林縣,斗六市,0445,552,132,684,34,718,1262,56.89%,43.74%,1
雲林縣,斗六市,0446,456,139,595,40,635,1154,55.03%,39.51%,1
雲林縣,斗六市,0447,360,99,459,47,506,847,59.74%,42.5%,1
雲林縣,斗六市,0448,633,144,777,38,815,1439,56.64%,43.99%,1
雲林縣,斗六市,0449,788,215,1003,62,1065,1747,60.96%,45.11%,1
雲林縣,斗六市,0450,603,151,754,61,815,1418,57.48%,42.52%,1
雲林縣,斗六市,0451,470,112,582,47,629,1112,56.56%,42.27%,1
雲林縣,斗六市,0452,564,135,699,49,748,1302,57.45%,43.32%,1
雲林縣,斗六市,0453,303,94,397,25,422,669,63.08%,45.29%,1
雲林縣,斗六市,0454,310,70,380,47,427,752,56.78%,41.22%,1
雲林縣,斗六市,0455,569,140,709,33,742,1450,51.17%,39.24%,1
雲林縣,斗六市,0456,220,61,281,38,319,555,57.48%,39.64%,1
雲林縣,斗六市,0457,582,135,717,51,768,1470,52.24%,39.59%,1
雲林縣,斗六市,0458,426,102,528,20,548,927,59.12%,45.95%,1
雲林縣,斗六市,0459,844,202,1046,56,1102,1893,58.21%,44.59%,1
雲林縣,斗六市,0460,658,217,875,101,976,1708,57.14%,38.52%,1
雲林縣,斗六市,0461,640,175,815,58,873,1773,49.24%,36.1%,1
雲林縣,斗六市,0462,650,150,800,43,843,1412,59.7%,46.03%,1
雲林縣,斗六市,0463,632,162,794,35,829,1354,61.23%,46.68%,1
雲林縣,斗六市,0464,522,141,663,32,695,1267,54.85%,41.2%,1
雲林縣,斗六市,0465,495,148,643,36,679,1273,53.34%,38.88%,1
雲林縣,斗六市,0466,645,163,808,95,903,1748,51.66%,36.9%,1
雲林縣,斗六市,0467,491,152,643,87,730,1238,58.97%,39.66%,1
雲林縣,斗六市,0468,664,159,823,69,892,1648,54.13%,40.29%,1
雲林縣,斗六市,0469,677,181,858,62,920,1520,60.53%,44.54%,1
雲林縣,斗六市,0470,405,113,518,39,557,1087,51.24%,37.26%,1
雲林縣,斗六市,0471,794,213,1007,80,1087,1904,57.09%,41.7%,1
雲林縣,斗六市,0472,299,86,385,39,424,702,60.4%,42.59%,1
雲林縣,斗六市,0473,426,143,569,66,635,1111,57.16%,38.34%,1
雲林縣,斗六市,0474,378,116,494,41,535,1123,47.64%,33.66%,1
雲林縣,斗六市,0475,424,118,542,45,587,1146,51.22%,37%,1
雲林縣,斗六市,0476,694,197,891,44,935,1786,52.35%,38.86%,1
雲林縣,斗六市,0477,387,129,516,67,583,1023,56.99%,37.83%,1
雲林縣,斗六市,0478,886,166,1052,94,1146,2072,55.31%,42.76%,1
雲林縣,斗六市,0479,430,115,545,33,578,1128,51.24%,38.12%,1
雲林縣,斗南鎮,0498,502,128,630,52,682,1166,58.49%,43.05%,1
雲林縣,斗南鎮,0499,504,143,647,41,688,1135,60.62%,44.41%,1
雲林縣,斗南鎮,0500,461,111,572,32,604,975,61.95%,47.28%,1
雲林縣,斗南鎮,0501,648,163,811,44,855,1459,58.6%,44.41%,1
雲林縣,斗南鎮,0502,581,152,733,58,791,1351,58.55%,43.01%,1
雲林縣,斗南鎮,0503,528,153,681,53,734,1321,55.56%,39.97%,1
雲林縣,斗南鎮,0504,375,73,448,49,497,907,54.8%,41.35%,1
雲林縣,斗南鎮,0505,658,175,833,86,919,1473,62.39%,44.67%,1
雲林縣,斗南鎮,0506,552,193,745,58,803,1277,62.88%,43.23%,1
雲林縣,斗南鎮,0507,495,161,656,93,749,1333,56.19%,37.13%,1
雲林縣,斗南鎮,0508,297,78,375,37,412,777,53.02%,38.22%,1
雲林縣,斗南鎮,0509,405,28,433,43,476,877,54.28%,46.18%,1
雲林縣,斗南鎮,0510,351,84,435,57,492,899,54.73%,39.04%,1
雲林縣,斗南鎮,0511,212,60,272,42,314,688,45.64%,30.81%,1
雲林縣,斗南鎮,0512,409,94,503,41,544,1147,47.43%,35.66%,1
雲林縣,斗南鎮,0513,596,246,842,98,940,1709,55%,34.87%,1
雲林縣,斗南鎮,0514,440,143,583,43,626,1042,60.08%,42.23%,1
雲林縣,斗南鎮,0515,594,216,810,62,872,1631,53.46%,36.42%,1
雲林縣,斗南鎮,0516,727,208,935,89,1024,1702,60.16%,42.71%,1
雲林縣,斗南鎮,0517,633,206,839,74,913,1564,58.38%,40.47%,1
雲林縣,斗南鎮,0518,296,84,380,41,421,910,46.26%,32.53%,1
雲林縣,斗南鎮,0519,558,150,708,50,758,1276,59.4%,43.73%,1
雲林縣,斗南鎮,0520,289,79,368,21,389,897,43.37%,32.22%,1
雲林縣,斗南鎮,0521,306,89,395,30,425,803,52.93%,38.11%,1
雲林縣,斗南鎮,0522,364,91,455,48,503,866,58.08%,42.03%,1
雲林縣,斗南鎮,0523,311,122,433,69,502,852,58.92%,36.5%,1
雲林縣,斗南鎮,0524,235,93,328,50,378,671,56.33%,35.02%,1
雲林縣,斗南鎮,0525,364,107,471,31,502,981,51.17%,37.1%,1
雲林縣,斗南鎮,0526,375,111,486,33,519,1129,45.97%,33.22%,1
雲林縣,斗南鎮,0527,643,177,820,116,936,1586,59.02%,40.54%,1
雲林縣,斗南鎮,0528,547,125,672,84,756,1243,60.82%,44.01%,1
雲林縣,斗南鎮,0529,333,104,437,27,464,984,47.15%,33.84%,1
雲林縣,斗南鎮,0530,600,141,741,83,824,1507,54.68%,39.81%,1
雲林縣,虎尾鎮,0109,559,132,691,53,744,1347,55.23%,41.5%,1
雲林縣,虎尾鎮,0110,535,160,695,44,739,1258,58.74%,42.53%,1
雲林縣,虎尾鎮,0111,288,101,389,38,427,785,54.39%,36.69%,1
雲林縣,虎尾鎮,0112,301,86,387,51,438,890,49.21%,33.82%,1
雲林縣,虎尾鎮,0113,610,136,746,52,798,1413,56.48%,43.17%,1
雲林縣,虎尾鎮,0114,634,170,804,62,866,1431,60.52%,44.3%,1
雲林縣,虎尾鎮,0115,462,124,586,71,657,1224,53.68%,37.75%,1
雲林縣,虎尾鎮,0116,486,117,603,49,652,1325,49.21%,36.68%,1
雲林縣,虎尾鎮,0117,386,112,498,70,568,941,60.36%,41.02%,1
雲林縣,虎尾鎮,0118,669,160,829,26,855,1613,53.01%,41.48%,1
雲林縣,虎尾鎮,0119,613,164,777,42,819,1641,49.91%,37.36%,1
雲林縣,虎尾鎮,0120,543,130,673,49,722,1200,60.17%,45.25%,1
雲林縣,虎尾鎮,0121,517,164,681,75,756,1294,58.42%,39.95%,1
雲林縣,虎尾鎮,0122,548,133,681,36,717,1273,56.32%,43.05%,1
雲林縣,虎尾鎮,0123,641,173,814,45,859,1438,59.74%,44.58%,1
雲林縣,虎尾鎮,0124,622,137,759,33,792,1361,58.19%,45.7%,1
雲林縣,虎尾鎮,0125,658,168,826,42,868,1444,60.11%,45.57%,1
雲林縣,虎尾鎮,0126,735,159,894,36,930,1490,62.42%,49.33%,1
雲林縣,虎尾鎮,0127,621,154,775,52,827,1307,63.27%,47.51%,1
雲林縣,虎尾鎮,0128,340,111,451,34,485,967,50.16%,35.16%,1
雲林縣,虎尾鎮,0129,752,163,915,41,956,1865,51.26%,40.32%,1
雲林縣,虎尾鎮,0130,772,209,981,38,1019,1880,54.2%,41.06%,1
雲林縣,虎尾鎮,0131,385,136,521,43,564,1099,51.32%,35.03%,1
雲林縣,虎尾鎮,0132,353,108,461,28,489,901,54.27%,39.18%,1
雲林縣,虎尾鎮,0133,440,113,553,19,572,1120,51.07%,39.29%,1
雲林縣,虎尾鎮,0134,171,53,224,16,240,545,44.04%,31.38%,1
雲林縣,虎尾鎮,0135,542,144,686,62,748,1420,52.68%,38.17%,1
雲林縣,虎尾鎮,0136,483,119,602,0,602,1248,48.24%,38.7%,1
雲林縣,虎尾鎮,0137,299,86,385,31,416,799,52.07%,37.42%,1
雲林縣,虎尾鎮,0138,284,101,385,61,446,836,53.35%,33.97%,1
雲林縣,虎尾鎮,0139,295,103,398,53,451,924,48.81%,31.93%,1
雲林縣,虎尾鎮,0140,510,142,652,33,685,1648,41.57%,30.95%,1
雲林縣,虎尾鎮,0141,486,175,661,110,771,1616,47.71%,30.07%,1
雲林縣,虎尾鎮,0142,519,175,694,55,749,1546,48.45%,33.57%,1
雲林縣,虎尾鎮,0143,448,137,585,39,624,1283,48.64%,34.92%,1
雲林縣,虎尾鎮,0144,379,103,482,37,519,1078,48.14%,35.16%,1
雲林縣,虎尾鎮,0145,414,140,554,48,602,1313,45.85%,31.53%,1
雲林縣,虎尾鎮,0146,406,154,560,36,596,1284,46.42%,31.62%,1
雲林縣,虎尾鎮,0147,506,123,629,99,728,1356,53.69%,37.32%,1
雲林縣,虎尾鎮,0148,536,176,712,92,804,1504,53.46%,35.64%,1
雲林縣,虎尾鎮,0149,393,99,492,40,532,1224,43.46%,32.11%,1
雲林縣,虎尾鎮,0150,515,129,644,65,709,1509,46.98%,34.13%,1
雲林縣,虎尾鎮,0151,220,82,302,60,362,855,42.34%,25.73%,1
雲林縣,虎尾鎮,0152,468,155,623,95,718,1549,46.35%,30.21%,1
雲林縣,虎尾鎮,0153,272,88,360,31,391,851,45.95%,31.96%,1
雲林縣,虎尾鎮,0154,438,119,557,78,635,1272,49.92%,34.43%,1
雲林縣,西螺鎮,0340,541,190,731,67,798,1590,50.19%,34.03%,1
雲林縣,西螺鎮,0341,660,191,851,91,942,1741,54.11%,37.91%,1
雲林縣,西螺鎮,0342,505,125,630,63,693,1080,64.17%,46.76%,1
雲林縣,西螺鎮,0343,464,113,577,70,647,1040,62.21%,44.62%,1
雲林縣,西螺鎮,0344,565,146,711,36,747,1346,55.5%,41.98%,1
雲林縣,西螺鎮,0345,665,152,817,57,874,1625,53.78%,40.92%,1
雲林縣,西螺鎮,0346,164,37,201,17,218,354,61.58%,46.33%,1
雲林縣,西螺鎮,0347,209,67,276,43,319,580,55%,36.03%,1
雲林縣,西螺鎮,0348,258,82,340,33,373,591,63.11%,43.65%,1
雲林縣,西螺鎮,0349,431,130,561,59,620,1050,59.05%,41.05%,1
雲林縣,西螺鎮,0350,476,157,633,73,706,1147,61.55%,41.5%,1
雲林縣,西螺鎮,0351,588,189,777,86,863,1602,53.87%,36.7%,1
雲林縣,西螺鎮,0352,505,194,699,56,755,1452,52%,34.78%,1
雲林縣,西螺鎮,0353,832,20,852,23,875,1578,55.45%,52.72%,1
雲林縣,西螺鎮,0354,499,126,625,32,657,1305,50.34%,38.24%,1
雲林縣,西螺鎮,0355,404,142,546,52,598,1327,45.06%,30.44%,1
雲林縣,西螺鎮,0356,558,151,709,66,775,1516,51.12%,36.81%,1
雲林縣,西螺鎮,0357,201,78,279,32,311,828,37.56%,24.28%,1
雲林縣,西螺鎮,0358,199,60,259,25,284,788,36.04%,25.25%,1
雲林縣,西螺鎮,0359,261,116,377,77,454,863,52.61%,30.24%,1
雲林縣,西螺鎮,0360,303,123,426,87,513,984,52.13%,30.79%,1
雲林縣,西螺鎮,0361,471,187,658,151,809,1514,53.43%,31.11%,1
雲林縣,西螺鎮,0362,281,128,409,57,466,870,53.56%,32.3%,1
雲林縣,西螺鎮,0363,344,107,451,65,516,971,53.14%,35.43%,1
雲林縣,西螺鎮,0364,405,120,525,61,586,1304,44.94%,31.06%,1
雲林縣,西螺鎮,0365,256,66,322,32,354,726,48.76%,35.26%,1
雲林縣,西螺鎮,0366,316,89,405,43,448,823,54.43%,38.4%,1
雲林縣,西螺鎮,0367,254,71,325,22,347,886,39.16%,28.67%,1
雲林縣,西螺鎮,0368,455,136,591,95,686,1373,49.96%,33.14%,1
雲林縣,西螺鎮,0369,358,107,465,68,533,983,54.22%,36.42%,1
雲林縣,西螺鎮,0370,385,101,486,58,544,1014,53.65%,37.97%,1
雲林縣,西螺鎮,0371,291,98,389,83,472,939,50.27%,30.99%,1
雲林縣,西螺鎮,0372,276,99,375,50,425,866,49.08%,31.87%,1
雲林縣,西螺鎮,0373,497,132,629,95,724,1486,48.72%,33.45%,1
雲林縣,土庫鎮,0080,352,100,452,60,512,809,63.29%,43.51%,1
雲林縣,土庫鎮,0081,345,131,476,59,535,896,59.71%,38.5%,1
雲林縣,土庫鎮,0082,266,84,350,48,398,687,57.93%,38.72%,1
雲林縣,土庫鎮,0083,354,81,435,35,470,702,66.95%,50.43%,1
雲林縣,土庫鎮,0084,471,128,599,37,636,1032,61.63%,45.64%,1
雲林縣,土庫鎮,0085,235,74,309,61,370,697,53.08%,33.72%,1
雲林縣,土庫鎮,0086,140,47,187,39,226,427,52.93%,32.79%,1
雲林縣,土庫鎮,0087,595,161,756,71,827,1451,57%,41.01%,1
雲林縣,土庫鎮,0088,528,157,685,31,716,1283,55.81%,41.15%,1
雲林縣,土庫鎮,0089,202,64,266,12,278,634,43.85%,31.86%,1
雲林縣,土庫鎮,0090,290,87,377,44,421,796,52.89%,36.43%,1
雲林縣,土庫鎮,0091,198,85,283,47,330,745,44.3%,26.58%,1
雲林縣,土庫鎮,0092,190,75,265,23,288,576,50%,32.99%,1
雲林縣,土庫鎮,0093,225,69,294,60,354,743,47.64%,30.28%,1
雲林縣,土庫鎮,0094,153,63,216,16,232,534,43.45%,28.65%,1
雲林縣,土庫鎮,0095,349,115,464,82,546,1199,45.54%,29.11%,1
雲林縣,土庫鎮,0096,331,119,450,90,540,1077,50.14%,30.73%,1
雲林縣,土庫鎮,0097,231,69,300,33,333,819,40.66%,28.21%,1
雲林縣,土庫鎮,0098,235,84,319,48,367,684,53.65%,34.36%,1
雲林縣,土庫鎮,0099,306,86,392,64,456,843,54.09%,36.3%,1
雲林縣,土庫鎮,0100,307,93,400,87,487,916,53.17%,33.52%,1
雲林縣,土庫鎮,0101,316,97,413,52,465,948,49.05%,33.33%,1
雲林縣,土庫鎮,0102,328,103,431,35,466,914,50.98%,35.89%,1
雲林縣,土庫鎮,0103,309,87,396,69,465,860,54.07%,35.93%,1
雲林縣,土庫鎮,0104,305,106,411,60,471,929,50.7%,32.83%,1
雲林縣,土庫鎮,0105,254,92,346,71,417,875,47.66%,29.03%,1
雲林縣,土庫鎮,0106,255,64,319,44,363,896,40.51%,28.46%,1
雲林縣,土庫鎮,0107,210,78,288,53,341,757,45.05%,27.74%,1
雲林縣,土庫鎮,0108,214,73,287,40,327,683,47.88%,31.33%,1
雲林縣,北港鎮,0256,279,86,365,62,427,724,58.98%,38.54%,1
雲林縣,北港鎮,0257,272,91,363,68,431,688,62.65%,39.53%,1
雲林縣,北港鎮,0258,168,55,223,41,264,452,58.41%,37.17%,1
雲林縣,北港鎮,0259,329,105,434,72,506,866,58.43%,37.99%,1
雲林縣,北港鎮,0260,109,47,156,22,178,336,52.98%,32.44%,1
雲林縣,北港鎮,0261,156,32,188,27,215,395,54.43%,39.49%,1
雲林縣,北港鎮,0262,174,31,205,32,237,376,63.03%,46.28%,1
雲林縣,北港鎮,0263,364,138,502,43,545,950,57.37%,38.32%,1
雲林縣,北港鎮,0264,197,77,274,45,319,512,62.3%,38.48%,1
雲林縣,北港鎮,0265,123,46,169,29,198,324,61.11%,37.96%,1
雲林縣,北港鎮,0266,189,73,262,36,298,546,54.58%,34.62%,1
雲林縣,北港鎮,0267,185,50,235,23,258,433,59.58%,42.73%,1
雲林縣,北港鎮,0268,271,96,367,64,431,751,57.39%,36.09%,1
雲林縣,北港鎮,0269,193,50,243,30,273,442,61.76%,43.67%,1
雲林縣,北港鎮,0270,455,142,597,70,667,1151,57.95%,39.53%,1
雲林縣,北港鎮,0271,516,144,660,56,716,1224,58.5%,42.16%,1
雲林縣,北港鎮,0272,442,146,588,60,648,1211,53.51%,36.5%,1
雲林縣,北港鎮,0273,503,166,669,75,744,1326,56.11%,37.93%,1
雲林縣,北港鎮,0274,333,100,433,45,478,744,64.25%,44.76%,1
雲林縣,北港鎮,0275,453,114,567,60,627,977,64.18%,46.37%,1
雲林縣,北港鎮,0276,328,125,453,74,527,960,54.9%,34.17%,1
雲林縣,北港鎮,0277,121,40,161,10,171,494,34.62%,24.49%,1
雲林縣,北港鎮,0278,564,157,721,64,785,1364,57.55%,41.35%,1
雲林縣,北港鎮,0279,479,118,597,59,656,1123,58.41%,42.65%,1
雲林縣,北港鎮,0280,606,142,748,72,820,1451,56.51%,41.76%,1
雲林縣,北港鎮,0281,488,132,620,72,692,1162,59.55%,42%,1
雲林縣,北港鎮,0282,414,117,531,59,590,1130,52.21%,36.64%,1
雲林縣,北港鎮,0283,408,118,526,44,570,1149,49.61%,35.51%,1
雲林縣,北港鎮,0284,154,51,205,35,240,533,45.03%,28.89%,1
雲林縣,北港鎮,0285,174,66,240,31,271,433,62.59%,40.18%,1
雲林縣,北港鎮,0286,132,34,166,12,178,377,47.21%,35.01%,1
雲林縣,北港鎮,0287,242,82,324,25,349,809,43.14%,29.91%,1
雲林縣,北港鎮,0288,426,126,552,92,644,1397,46.1%,30.49%,1
雲林縣,北港鎮,0289,314,106,420,105,525,1145,45.85%,27.42%,1
雲林縣,北港鎮,0290,170,67,237,75,312,828,37.68%,20.53%,1
雲林縣,北港鎮,0291,143,51,194,26,220,557,39.5%,25.67%,1
雲林縣,北港鎮,0292,309,137,446,53,499,1060,47.08%,29.15%,1
雲林縣,北港鎮,0293,183,58,241,37,278,577,48.18%,31.72%,1
雲林縣,北港鎮,0294,248,84,332,73,405,931,43.5%,26.64%,1
雲林縣,北港鎮,0295,388,115,503,44,547,1018,53.73%,38.11%,1
雲林縣,北港鎮,0296,417,107,524,28,552,1032,53.49%,40.41%,1
雲林縣,古坑鄉,0531,422,124,546,70,616,1126,54.71%,37.48%,1
雲林縣,古坑鄉,0532,338,110,448,74,522,994,52.52%,34%,1
雲林縣,古坑鄉,0533,510,184,694,63,757,1517,49.9%,33.62%,1
雲林縣,古坑鄉,0534,508,136,644,55,699,1302,53.69%,39.02%,1
雲林縣,古坑鄉,0535,616,178,794,73,867,1772,48.93%,34.76%,1
雲林縣,古坑鄉,0536,417,128,545,100,645,1122,57.49%,37.17%,1
雲林縣,古坑鄉,0537,69,21,90,5,95,304,31.25%,22.7%,1
雲林縣,古坑鄉,0538,479,109,588,93,681,1169,58.25%,40.98%,1
雲林縣,古坑鄉,0539,420,134,554,90,644,1255,51.31%,33.47%,1
雲林縣,古坑鄉,0540,472,131,603,49,652,1078,60.48%,43.78%,1
雲林縣,古坑鄉,0541,331,75,406,36,442,943,46.87%,35.1%,1
雲林縣,古坑鄉,0542,447,129,576,94,670,1300,51.54%,34.38%,1
雲林縣,古坑鄉,0543,322,95,417,61,478,964,49.59%,33.4%,1
雲林縣,古坑鄉,0544,436,125,561,56,617,1144,53.93%,38.11%,1
雲林縣,古坑鄉,0545,579,131,710,78,788,1482,53.17%,39.07%,1
雲林縣,古坑鄉,0546,279,64,343,43,386,688,56.1%,40.55%,1
雲林縣,古坑鄉,0547,324,105,429,58,487,998,48.8%,32.46%,1
雲林縣,古坑鄉,0548,477,120,597,53,650,1140,57.02%,41.84%,1
雲林縣,古坑鄉,0549,388,152,540,49,589,1102,53.45%,35.21%,1
雲林縣,古坑鄉,0550,358,102,460,36,496,956,51.88%,37.45%,1
雲林縣,古坑鄉,0551,252,85,337,26,363,695,52.23%,36.26%,1
雲林縣,古坑鄉,0552,380,150,530,31,561,1233,45.5%,30.82%,1
雲林縣,古坑鄉,0553,70,32,102,7,109,285,38.25%,24.56%,1
雲林縣,古坑鄉,0554,200,52,252,13,265,734,36.1%,27.25%,1
雲林縣,古坑鄉,0555,385,156,541,92,633,1150,55.04%,33.48%,1
雲林縣,古坑鄉,0556,160,52,212,18,230,453,50.77%,35.32%,1
雲林縣,古坑鄉,0557,198,48,246,31,277,571,48.51%,34.68%,1
雲林縣,大埤鄉,0480,306,72,378,44,422,750,56.27%,40.8%,1
雲林縣,大埤鄉,0481,249,74,323,31,354,719,49.24%,34.63%,1
雲林縣,大埤鄉,0482,237,52,289,24,313,603,51.91%,39.3%,1
雲林縣,大埤鄉,0483,345,115,460,57,517,1106,46.75%,31.19%,1
雲林縣,大埤鄉,0484,521,185,706,69,775,1495,51.84%,34.85%,1
雲林縣,大埤鄉,0485,250,74,324,32,356,600,59.33%,41.67%,1
雲林縣,大埤鄉,0486,401,130,531,59,590,1004,58.76%,39.94%,1
雲林縣,大埤鄉,0487,259,82,341,20,361,948,38.08%,27.32%,1
雲林縣,大埤鄉,0488,573,179,752,79,831,1539,54%,37.23%,1
雲林縣,大埤鄉,0489,460,165,625,65,690,1430,48.25%,32.17%,1
雲林縣,大埤鄉,0490,153,46,199,34,233,465,50.11%,32.9%,1
雲林縣,大埤鄉,0491,457,130,587,55,642,1307,49.12%,34.97%,1
雲林縣,大埤鄉,0492,157,59,216,23,239,474,50.42%,33.12%,1
雲林縣,大埤鄉,0493,446,179,625,101,726,1220,59.51%,36.56%,1
雲林縣,大埤鄉,0494,74,249,323,21,344,733,46.93%,10.1%,1
雲林縣,大埤鄉,0495,255,73,328,41,369,681,54.19%,37.44%,1
雲林縣,大埤鄉,0496,188,72,260,35,295,712,41.43%,26.4%,1
雲林縣,大埤鄉,0497,214,85,299,49,348,723,48.13%,29.6%,1
雲林縣,莿桐鄉,0374,561,194,755,96,851,1507,56.47%,37.23%,1
雲林縣,莿桐鄉,0375,510,139,649,47,696,1300,53.54%,39.23%,1
雲林縣,莿桐鄉,0376,485,156,641,101,742,1272,58.33%,38.13%,1
雲林縣,莿桐鄉,0377,275,113,388,71,459,861,53.31%,31.94%,1
雲林縣,莿桐鄉,0378,488,152,640,85,725,1565,46.33%,31.18%,1
雲林縣,莿桐鄉,0379,196,64,260,21,281,577,48.7%,33.97%,1
雲林縣,莿桐鄉,0380,174,82,256,43,299,636,47.01%,27.36%,1
雲林縣,莿桐鄉,0381,354,143,497,97,594,1110,53.51%,31.89%,1
雲林縣,莿桐鄉,0382,382,130,512,68,580,973,59.61%,39.26%,1
雲林縣,莿桐鄉,0383,333,138,471,78,549,985,55.74%,33.81%,1
雲林縣,莿桐鄉,0384,677,207,884,126,1010,1707,59.17%,39.66%,1
雲林縣,莿桐鄉,0385,475,160,635,89,724,1284,56.39%,36.99%,1
雲林縣,莿桐鄉,0386,431,225,656,76,732,1293,56.61%,33.33%,1
雲林縣,莿桐鄉,0387,340,109,449,61,510,900,56.67%,37.78%,1
雲林縣,莿桐鄉,0388,385,127,512,108,620,1040,59.62%,37.02%,1
雲林縣,莿桐鄉,0389,417,130,547,36,583,1165,50.04%,35.79%,1
雲林縣,莿桐鄉,0390,326,106,432,62,494,871,56.72%,37.43%,1
雲林縣,莿桐鄉,0391,359,117,476,62,538,885,60.79%,40.56%,1
雲林縣,莿桐鄉,0392,474,171,645,75,720,1489,48.35%,31.83%,1
雲林縣,莿桐鄉,0393,443,129,572,96,668,1347,49.59%,32.89%,1
雲林縣,莿桐鄉,0394,429,155,584,83,667,1150,58%,37.3%,1
雲林縣,莿桐鄉,0395,246,95,341,46,387,653,59.26%,37.67%,1
雲林縣,林內鄉,0396,446,126,572,83,655,1036,63.22%,43.05%,1
雲林縣,林內鄉,0397,561,192,753,81,834,1490,55.97%,37.65%,1
雲林縣,林內鄉,0398,548,169,717,81,798,1491,53.52%,36.75%,1
雲林縣,林內鄉,0399,234,67,301,61,362,671,53.95%,34.87%,1
雲林縣,林內鄉,0400,568,177,745,117,862,1436,60.03%,39.55%,1
雲林縣,林內鄉,0401,275,93,368,75,443,751,58.99%,36.62%,1
雲林縣,林內鄉,0402,189,70,259,34,293,535,54.77%,35.33%,1
雲林縣,林內鄉,0403,258,73,331,52,383,811,47.23%,31.81%,1
雲林縣,林內鄉,0404,515,150,665,99,764,1339,57.06%,38.46%,1
雲林縣,林內鄉,0405,514,115,629,78,707,1286,54.98%,39.97%,1
雲林縣,林內鄉,0406,239,83,322,33,355,646,54.95%,37%,1
雲林縣,林內鄉,0407,415,150,565,87,652,1158,56.3%,35.84%,1
雲林縣,林內鄉,0408,420,130,550,64,614,1090,56.33%,38.53%,1
雲林縣,林內鄉,0409,386,112,498,76,574,950,60.42%,40.63%,1
雲林縣,林內鄉,0410,317,93,410,40,450,861,52.26%,36.82%,1
雲林縣,二崙鄉,0317,464,149,613,38,651,1463,44.5%,31.72%,1
雲林縣,二崙鄉,0318,502,206,708,65,773,1738,44.48%,28.88%,1
雲林縣,二崙鄉,0319,176,70,246,51,297,625,47.52%,28.16%,1
雲林縣,二崙鄉,0320,322,98,420,73,493,1018,48.43%,31.63%,1
雲林縣,二崙鄉,0321,107,42,149,6,155,448,34.6%,23.88%,1
雲林縣,二崙鄉,0322,266,80,346,51,397,1048,37.88%,25.38%,1
雲林縣,二崙鄉,0323,412,134,546,86,632,1161,54.44%,35.49%,1
雲林縣,二崙鄉,0324,349,109,458,49,507,991,51.16%,35.22%,1
雲林縣,二崙鄉,0325,323,109,432,67,499,849,58.78%,38.04%,1
雲林縣,二崙鄉,0326,288,107,395,55,450,890,50.56%,32.36%,1
雲林縣,二崙鄉,0327,462,143,605,101,706,1427,49.47%,32.38%,1
雲林縣,二崙鄉,0328,286,88,374,41,415,891,46.58%,32.1%,1
雲林縣,二崙鄉,0329,223,64,287,26,313,757,41.35%,29.46%,1
雲林縣,二崙鄉,0330,409,200,609,117,726,1497,48.5%,27.32%,1
雲林縣,二崙鄉,0331,338,140,478,78,556,1171,47.48%,28.86%,1
雲林縣,二崙鄉,0332,248,89,337,60,397,686,57.87%,36.15%,1
雲林縣,二崙鄉,0333,220,75,295,91,386,864,44.68%,25.46%,1
雲林縣,二崙鄉,0334,408,129,537,78,615,1073,57.32%,38.02%,1
雲林縣,二崙鄉,0335,196,63,259,25,284,696,40.8%,28.16%,1
雲林縣,二崙鄉,0336,283,104,387,61,448,1271,35.25%,22.27%,1
雲林縣,二崙鄉,0337,265,94,359,47,406,912,44.52%,29.06%,1
雲林縣,二崙鄉,0338,233,100,333,37,370,861,42.97%,27.06%,1
雲林縣,二崙鄉,0339,279,102,381,67,448,1030,43.5%,27.09%,1
雲林縣,崙背鄉,0297,448,129,577,75,652,1176,55.44%,38.1%,1
雲林縣,崙背鄉,0298,518,125,643,50,693,1439,48.16%,36%,1
雲林縣,崙背鄉,0299,438,117,555,54,609,1027,59.3%,42.65%,1
雲林縣,崙背鄉,0300,519,114,633,55,688,1259,54.65%,41.22%,1
雲林縣,崙背鄉,0301,370,111,481,38,519,1058,49.05%,34.97%,1
雲林縣,崙背鄉,0302,318,95,413,32,445,998,44.59%,31.86%,1
雲林縣,崙背鄉,0303,318,99,417,33,450,968,46.49%,32.85%,1
雲林縣,崙背鄉,0304,374,122,496,56,552,1055,52.32%,35.45%,1
雲林縣,崙背鄉,0305,397,136,533,84,617,1315,46.92%,30.19%,1
雲林縣,崙背鄉,0306,214,84,298,26,324,1027,31.55%,20.84%,1
雲林縣,崙背鄉,0307,367,118,485,105,590,997,59.18%,36.81%,1
雲林縣,崙背鄉,0308,298,80,378,42,420,807,52.04%,36.93%,1
雲林縣,崙背鄉,0309,178,79,257,27,284,698,40.69%,25.5%,1
雲林縣,崙背鄉,0310,227,79,306,60,366,804,45.52%,28.23%,1
雲林縣,崙背鄉,0311,288,79,367,38,405,867,46.71%,33.22%,1
雲林縣,崙背鄉,0312,235,65,300,38,338,886,38.15%,26.52%,1
雲林縣,崙背鄉,0313,401,112,513,103,616,1476,41.73%,27.17%,1
雲林縣,崙背鄉,0314,249,84,333,45,378,1159,32.61%,21.48%,1
雲林縣,崙背鄉,0315,393,174,567,96,663,1220,54.34%,32.21%,1
雲林縣,崙背鄉,0316,278,92,370,38,408,814,50.12%,34.15%,1
雲林縣,麥寮鄉,0001,446,116,562,74,636,1497,42.48%,29.79%,1
雲林縣,麥寮鄉,0002,660,152,812,60,872,1738,50.17%,37.97%,1
雲林縣,麥寮鄉,0003,702,160,862,95,957,1921,49.82%,36.54%,1
雲林縣,麥寮鄉,0004,509,266,775,79,854,1832,46.62%,27.78%,1
雲林縣,麥寮鄉,0005,426,119,545,59,604,1340,45.07%,31.79%,1
雲林縣,麥寮鄉,0006,372,108,480,73,553,1138,48.59%,32.69%,1
雲林縣,麥寮鄉,0007,544,141,685,70,755,1551,48.68%,35.07%,1
雲林縣,麥寮鄉,0008,216,55,271,40,311,715,43.5%,30.21%,1
雲林縣,麥寮鄉,0009,329,111,440,51,491,1194,41.12%,27.55%,1
雲林縣,麥寮鄉,0010,337,101,438,50,488,1023,47.7%,32.94%,1
雲林縣,麥寮鄉,0011,425,126,551,36,587,1558,37.68%,27.28%,1
雲林縣,麥寮鄉,0012,327,110,437,36,473,1187,39.85%,27.55%,1
雲林縣,麥寮鄉,0013,298,89,387,33,420,983,42.73%,30.32%,1
雲林縣,麥寮鄉,0014,470,142,612,83,695,1363,50.99%,34.48%,1
雲林縣,麥寮鄉,0015,526,141,667,93,760,1596,47.62%,32.96%,1
雲林縣,麥寮鄉,0016,576,167,743,119,862,1469,58.68%,39.21%,1
雲林縣,麥寮鄉,0017,286,77,363,56,419,964,43.46%,29.67%,1
雲林縣,麥寮鄉,0018,307,76,383,46,429,1038,41.33%,29.58%,1
雲林縣,麥寮鄉,0019,458,81,539,81,620,1230,50.41%,37.24%,1
雲林縣,麥寮鄉,0020,460,123,583,57,640,1329,48.16%,34.61%,1
雲林縣,麥寮鄉,0021,398,120,518,89,607,1129,53.76%,35.25%,1
雲林縣,麥寮鄉,0022,466,125,591,102,693,1241,55.84%,37.55%,1
雲林縣,麥寮鄉,0023,571,133,704,101,805,1471,54.72%,38.82%,1
雲林縣,麥寮鄉,0024,418,143,561,71,632,1107,57.09%,37.76%,1
雲林縣,麥寮鄉,0025,634,175,809,85,894,1636,54.65%,38.75%,1
雲林縣,麥寮鄉,0026,601,167,768,59,827,1755,47.12%,34.25%,1
雲林縣,麥寮鄉,0027,462,101,563,40,603,1158,52.07%,39.9%,1
雲林縣,麥寮鄉,0028,388,87,475,38,513,956,53.66%,40.59%,1
雲林縣,東勢鄉,0051,365,112,477,59,536,1207,44.41%,30.24%,1
雲林縣,東勢鄉,0052,223,67,290,36,326,540,60.37%,41.3%,1
雲林縣,東勢鄉,0053,249,89,338,35,373,896,41.63%,27.79%,1
雲林縣,東勢鄉,0054,253,81,334,59,393,728,53.98%,34.75%,1
雲林縣,東勢鄉,0055,622,156,778,91,869,1533,56.69%,40.57%,1
雲林縣,東勢鄉,0056,465,148,613,101,714,1203,59.35%,38.65%,1
雲林縣,東勢鄉,0057,240,81,321,69,390,817,47.74%,29.38%,1
雲林縣,東勢鄉,0058,230,61,291,34,325,546,59.52%,42.12%,1
雲林縣,東勢鄉,0059,259,102,361,77,438,853,51.35%,30.36%,1
雲林縣,東勢鄉,0060,208,83,291,69,360,856,42.06%,24.3%,1
雲林縣,東勢鄉,0061,289,92,381,64,445,923,48.21%,31.31%,1
雲林縣,東勢鄉,0062,325,108,433,48,481,1022,47.06%,31.8%,1
雲林縣,東勢鄉,0063,164,44,208,33,241,634,38.01%,25.87%,1
雲林縣,東勢鄉,0064,113,25,138,23,161,394,40.86%,28.68%,1
雲林縣,東勢鄉,0065,279,81,360,45,405,1087,37.26%,25.67%,1
雲林縣,褒忠鄉,0066,353,86,439,71,510,923,55.25%,38.24%,1
雲林縣,褒忠鄉,0067,426,120,546,38,584,993,58.81%,42.9%,1
雲林縣,褒忠鄉,0068,287,70,357,34,391,748,52.27%,38.37%,1
雲林縣,褒忠鄉,0069,262,66,328,15,343,702,48.86%,37.32%,1
雲林縣,褒忠鄉,0070,274,58,332,22,354,752,47.07%,36.44%,1
雲林縣,褒忠鄉,0071,295,82,377,29,406,756,53.7%,39.02%,1
雲林縣,褒忠鄉,0072,172,58,230,20,250,490,51.02%,35.1%,1
雲林縣,褒忠鄉,0073,299,95,394,33,427,1034,41.3%,28.92%,1
雲林縣,褒忠鄉,0074,162,50,212,19,231,470,49.15%,34.47%,1
雲林縣,褒忠鄉,0075,146,195,341,30,371,737,50.34%,19.81%,1
雲林縣,褒忠鄉,0076,305,91,396,41,437,878,49.77%,34.74%,1
雲林縣,褒忠鄉,0077,257,73,330,60,390,778,50.13%,33.03%,1
雲林縣,褒忠鄉,0078,374,149,523,63,586,1224,47.88%,30.56%,1
雲林縣,褒忠鄉,0079,236,105,341,75,416,896,46.43%,26.34%,1
雲林縣,臺西鄉,0029,494,106,600,77,677,1238,54.68%,39.9%,1
雲林縣,臺西鄉,0030,365,108,473,49,522,1091,47.85%,33.46%,1
雲林縣,臺西鄉,0031,401,100,501,72,573,1098,52.19%,36.52%,1
雲林縣,臺西鄉,0032,300,93,393,44,437,1048,41.7%,28.63%,1
雲林縣,臺西鄉,0033,334,80,414,77,491,1025,47.9%,32.59%,1
雲林縣,臺西鄉,0034,297,78,375,55,430,850,50.59%,34.94%,1
雲林縣,臺西鄉,0035,401,138,539,102,641,1460,43.9%,27.47%,1
雲林縣,臺西鄉,0036,257,97,354,86,440,1180,37.29%,21.78%,1
雲林縣,臺西鄉,0037,161,38,199,36,235,710,33.1%,22.68%,1
雲林縣,臺西鄉,0038,153,49,202,11,213,620,34.35%,24.68%,1
雲林縣,臺西鄉,0039,130,50,180,33,213,449,47.44%,28.95%,1
雲林縣,臺西鄉,0040,170,55,225,52,277,687,40.32%,24.75%,1
雲林縣,臺西鄉,0041,366,116,482,77,559,1247,44.83%,29.35%,1
雲林縣,臺西鄉,0042,153,31,184,22,206,583,35.33%,26.24%,1
雲林縣,臺西鄉,0043,337,110,447,70,517,1042,49.62%,32.34%,1
雲林縣,臺西鄉,0044,150,38,188,31,219,472,46.4%,31.78%,1
雲林縣,臺西鄉,0045,420,88,508,35,543,1409,38.54%,29.81%,1
雲林縣,臺西鄉,0046,355,109,464,94,558,1061,52.59%,33.46%,1
雲林縣,臺西鄉,0047,276,82,358,40,398,993,40.08%,27.79%,1
雲林縣,臺西鄉,0048,299,111,410,82,492,1013,48.57%,29.52%,1
雲林縣,臺西鄉,0049,433,101,534,52,586,1233,47.53%,35.12%,1
雲林縣,臺西鄉,0050,179,55,234,30,264,616,42.86%,29.06%,1
雲林縣,元長鄉,0180,299,105,404,40,444,915,48.52%,32.68%,1
雲林縣,元長鄉,0181,401,131,532,35,567,1284,44.16%,31.23%,1
雲林縣,元長鄉,0182,359,108,467,44,511,1150,44.43%,31.22%,1
雲林縣,元長鄉,0183,202,66,268,54,322,744,43.28%,27.15%,1
雲林縣,元長鄉,0184,254,76,330,59,389,790,49.24%,32.15%,1
雲林縣,元長鄉,0185,350,130,480,76,556,1356,41%,25.81%,1
雲林縣,元長鄉,0186,195,94,289,66,355,739,48.04%,26.39%,1
雲林縣,元長鄉,0187,254,79,333,41,374,965,38.76%,26.32%,1
雲林縣,元長鄉,0188,295,94,389,75,464,1080,42.96%,27.31%,1
雲林縣,元長鄉,0189,254,72,326,51,377,948,39.77%,26.79%,1
雲林縣,元長鄉,0190,143,69,212,32,244,762,32.02%,18.77%,1
雲林縣,元長鄉,0191,179,62,241,23,264,582,45.36%,30.76%,1
雲林縣,元長鄉,0192,238,52,290,17,307,865,35.49%,27.51%,1
雲林縣,元長鄉,0193,55,16,71,6,77,362,21.27%,15.19%,1
雲林縣,元長鄉,0194,297,88,385,43,428,1162,36.83%,25.56%,1
雲林縣,元長鄉,0195,435,129,564,57,621,1527,40.67%,28.49%,1
雲林縣,元長鄉,0196,290,117,407,80,487,1006,48.41%,28.83%,1
雲林縣,元長鄉,0197,247,68,315,30,345,855,40.35%,28.89%,1
雲林縣,元長鄉,0198,352,116,468,89,557,1181,47.16%,29.81%,1
雲林縣,元長鄉,0199,221,84,305,49,354,864,40.97%,25.58%,1
雲林縣,元長鄉,0200,157,66,223,41,264,667,39.58%,23.54%,1
雲林縣,元長鄉,0201,233,74,307,33,340,878,38.72%,26.54%,1
雲林縣,元長鄉,0202,39,120,159,12,171,610,28.03%,6.39%,1
雲林縣,元長鄉,0203,227,101,328,71,399,837,47.67%,27.12%,1
雲林縣,元長鄉,0204,233,76,309,44,353,701,50.36%,33.24%,1
雲林縣,四湖鄉,0155,321,94,415,64,479,1082,44.27%,29.67%,1
雲林縣,四湖鄉,0156,237,78,315,49,364,676,53.85%,35.06%,1
雲林縣,四湖鄉,0157,304,78,382,21,403,862,46.75%,35.27%,1
雲林縣,四湖鄉,0158,105,30,135,26,161,477,33.75%,22.01%,1
雲林縣,四湖鄉,0159,365,98,463,39,502,952,52.73%,38.34%,1
雲林縣,四湖鄉,0160,169,49,218,18,236,650,36.31%,26%,1
雲林縣,四湖鄉,0161,282,93,375,28,403,969,41.59%,29.1%,1
雲林縣,四湖鄉,0162,223,96,319,52,371,925,40.11%,24.11%,1
雲林縣,四湖鄉,0163,264,76,340,39,379,914,41.47%,28.88%,1
雲林縣,四湖鄉,0164,142,46,188,54,242,759,31.88%,18.71%,1
雲林縣,四湖鄉,0165,302,90,392,54,446,1219,36.59%,24.77%,1
雲林縣,四湖鄉,0166,197,70,267,52,319,937,34.04%,21.02%,1
雲林縣,四湖鄉,0167,153,47,200,17,217,773,28.07%,19.79%,1
雲林縣,四湖鄉,0168,128,45,173,52,225,555,40.54%,23.06%,1
雲林縣,四湖鄉,0169,189,69,258,38,296,876,33.79%,21.58%,1
雲林縣,四湖鄉,0170,93,21,114,25,139,360,38.61%,25.83%,1
雲林縣,四湖鄉,0171,164,54,218,45,263,885,29.72%,18.53%,1
雲林縣,四湖鄉,0172,186,55,241,45,286,833,34.33%,22.33%,1
雲林縣,四湖鄉,0173,206,72,278,44,322,785,41.02%,26.24%,1
雲林縣,四湖鄉,0174,226,61,287,49,336,705,47.66%,32.06%,1
雲林縣,四湖鄉,0175,203,50,253,28,281,927,30.31%,21.9%,1
雲林縣,四湖鄉,0176,224,78,302,74,376,1058,35.54%,21.17%,1
雲林縣,四湖鄉,0177,244,102,346,59,405,1071,37.82%,22.78%,1
雲林縣,四湖鄉,0178,200,48,248,20,268,1022,26.22%,19.57%,1
雲林縣,四湖鄉,0179,181,58,239,38,277,711,38.96%,25.46%,1
雲林縣,口湖鄉,0205,373,136,509,66,575,1134,50.71%,32.89%,1
雲林縣,口湖鄉,0206,433,125,558,108,666,1225,54.37%,35.35%,1
雲林縣,口湖鄉,0207,162,65,227,45,272,647,42.04%,25.04%,1
雲林縣,口湖鄉,0208,221,82,303,35,338,709,47.67%,31.17%,1
雲林縣,口湖鄉,0209,230,103,333,94,427,900,47.44%,25.56%,1
雲林縣,口湖鄉,0210,316,100,416,76,492,1011,48.66%,31.26%,1
雲林縣,口湖鄉,0211,350,138,488,37,525,1437,36.53%,24.36%,1
雲林縣,口湖鄉,0212,180,55,235,10,245,848,28.89%,21.23%,1
雲林縣,口湖鄉,0213,309,103,412,38,450,1193,37.72%,25.9%,1
雲林縣,口湖鄉,0214,172,54,226,62,288,759,37.94%,22.66%,1
雲林縣,口湖鄉,0215,226,91,317,49,366,815,44.91%,27.73%,1
雲林縣,口湖鄉,0216,451,155,606,98,704,1460,48.22%,30.89%,1
雲林縣,口湖鄉,0217,96,57,153,10,163,556,29.32%,17.27%,1
雲林縣,口湖鄉,0218,507,120,627,59,686,1532,44.78%,33.09%,1
雲林縣,口湖鄉,0219,266,70,336,23,359,847,42.38%,31.4%,1
雲林縣,口湖鄉,0220,125,28,153,29,182,374,48.66%,33.42%,1
雲林縣,口湖鄉,0221,472,172,644,188,832,1508,55.17%,31.3%,1
雲林縣,口湖鄉,0222,345,93,438,84,522,951,54.89%,36.28%,1
雲林縣,口湖鄉,0223,310,126,436,89,525,910,57.69%,34.07%,1
雲林縣,口湖鄉,0224,341,110,451,55,506,879,57.57%,38.79%,1
雲林縣,口湖鄉,0225,352,105,457,130,587,1213,48.39%,29.02%,1
雲林縣,口湖鄉,0226,318,87,405,57,462,952,48.53%,33.4%,1
雲林縣,口湖鄉,0227,238,94,332,57,389,720,54.03%,33.06%,1
雲林縣,口湖鄉,0228,232,103,335,33,368,1006,36.58%,23.06%,1
雲林縣,口湖鄉,0229,150,46,196,11,207,607,34.1%,24.71%,1
雲林縣,水林鄉,0230,396,132,528,74,602,1355,44.43%,29.23%,1
雲林縣,水林鄉,0231,299,86,385,17,402,887,45.32%,33.71%,1
雲林縣,水林鄉,0232,478,166,644,66,710,1234,57.54%,38.74%,1
雲林縣,水林鄉,0233,234,101,335,16,351,763,46%,30.67%,1
雲林縣,水林鄉,0234,180,77,257,49,306,721,42.44%,24.97%,1
雲林縣,水林鄉,0235,164,46,210,15,225,647,34.78%,25.35%,1
雲林縣,水林鄉,0236,280,88,368,62,430,989,43.48%,28.31%,1
雲林縣,水林鄉,0237,197,71,268,39,307,837,36.68%,23.54%,1
雲林縣,水林鄉,0238,268,78,346,25,371,1081,34.32%,24.79%,1
雲林縣,水林鄉,0239,196,75,271,45,316,704,44.89%,27.84%,1
雲林縣,水林鄉,0240,280,117,397,94,491,1006,48.81%,27.83%,1
雲林縣,水林鄉,0241,196,54,250,8,258,651,39.63%,30.11%,1
雲林縣,水林鄉,0242,163,42,205,28,233,607,38.39%,26.85%,1
雲林縣,水林鄉,0243,259,102,361,68,429,1033,41.53%,25.07%,1
雲林縣,水林鄉,0244,140,41,181,15,196,631,31.06%,22.19%,1
雲林縣,水林鄉,0245,254,89,343,61,404,961,42.04%,26.43%,1
雲林縣,水林鄉,0246,238,94,332,87,419,951,44.06%,25.03%,1
雲林縣,水林鄉,0247,240,83,323,37,360,838,42.96%,28.64%,1
雲林縣,水林鄉,0248,297,98,395,105,500,1055,47.39%,28.15%,1
雲林縣,水林鄉,0249,114,28,142,28,170,512,33.2%,22.27%,1
雲林縣,水林鄉,0250,167,45,212,19,231,671,34.43%,24.89%,1
雲林縣,水林鄉,0251,113,51,164,47,211,693,30.45%,16.31%,1
雲林縣,水林鄉,0252,143,48,191,48,239,689,34.69%,20.75%,1
雲林縣,水林鄉,0253,327,98,425,69,494,1022,48.34%,32%,1
雲林縣,水林鄉,0254,349,80,429,39,468,1191,39.29%,29.3%,1
雲林縣,水林鄉,0255,280,84,364,50,414,779,53.15%,35.94%,1
嘉義縣,太保市,0001,464,140,604,74,678,1210,56.03%,38.35%,1
嘉義縣,太保市,0002,423,108,531,44,575,1076,53.44%,39.31%,1
嘉義縣,太保市,0003,159,51,210,26,236,488,48.36%,32.58%,1
嘉義縣,太保市,0004,477,168,645,64,709,1475,48.07%,32.34%,1
嘉義縣,太保市,0005,251,70,321,36,357,790,45.19%,31.77%,1
嘉義縣,太保市,0006,292,104,396,43,439,883,49.72%,33.07%,1
嘉義縣,太保市,0007,296,63,359,41,400,758,52.77%,39.05%,1
嘉義縣,太保市,0008,121,28,149,5,154,389,39.59%,31.11%,1
嘉義縣,太保市,0009,344,114,458,56,514,1101,46.68%,31.24%,1
嘉義縣,太保市,0010,300,96,396,18,414,853,48.53%,35.17%,1
嘉義縣,太保市,0011,54,23,77,15,92,224,41.07%,24.11%,1
嘉義縣,太保市,0012,198,65,263,55,318,662,48.04%,29.91%,1
嘉義縣,太保市,0013,770,164,934,31,965,1630,59.2%,47.24%,1
嘉義縣,太保市,0014,305,88,393,27,420,913,46%,33.41%,1
嘉義縣,太保市,0015,337,77,414,19,433,779,55.58%,43.26%,1
嘉義縣,太保市,0016,428,178,606,96,702,1278,54.93%,33.49%,1
嘉義縣,太保市,0017,257,86,343,42,385,819,47.01%,31.38%,1
嘉義縣,太保市,0018,570,179,749,30,779,1573,49.52%,36.24%,1
嘉義縣,太保市,0019,181,55,236,25,261,481,54.26%,37.63%,1
嘉義縣,太保市,0020,110,26,136,5,141,245,57.55%,44.9%,1
嘉義縣,太保市,0021,105,42,147,22,169,317,53.31%,33.12%,1
嘉義縣,太保市,0022,82,27,109,9,118,258,45.74%,31.78%,1
嘉義縣,太保市,0023,205,71,276,57,333,611,54.5%,33.55%,1
嘉義縣,太保市,0024,582,200,782,53,835,1526,54.72%,38.14%,1
嘉義縣,太保市,0025,465,154,619,30,649,1196,54.26%,38.88%,1
嘉義縣,太保市,0026,528,211,739,97,836,1536,54.43%,34.38%,1
嘉義縣,太保市,0027,551,195,746,81,827,1481,55.84%,37.2%,1
嘉義縣,太保市,0028,574,165,739,52,791,1450,54.55%,39.59%,1
嘉義縣,太保市,0029,272,93,365,23,388,840,46.19%,32.38%,1
嘉義縣,太保市,0030,334,130,464,37,501,989,50.66%,33.77%,1
嘉義縣,太保市,0031,576,160,736,109,845,1529,55.26%,37.67%,1
嘉義縣,太保市,0032,564,186,750,95,845,1511,55.92%,37.33%,1
嘉義縣,太保市,0033,211,68,279,40,319,697,45.77%,30.27%,1
嘉義縣,朴子市,0233,469,124,593,51,644,1183,54.44%,39.64%,1
嘉義縣,朴子市,0234,257,111,368,45,413,755,54.7%,34.04%,1
嘉義縣,朴子市,0235,504,125,629,40,669,1253,53.39%,40.22%,1
嘉義縣,朴子市,0236,454,122,576,68,644,1078,59.74%,42.12%,1
嘉義縣,朴子市,0237,454,161,615,70,685,1117,61.32%,40.64%,1
嘉義縣,朴子市,0238,153,61,214,16,230,387,59.43%,39.53%,1
嘉義縣,朴子市,0239,245,67,312,47,359,633,56.71%,38.7%,1
嘉義縣,朴子市,0240,297,36,333,27,360,650,55.38%,45.69%,1
嘉義縣,朴子市,0241,371,100,471,46,517,825,62.67%,44.97%,1
嘉義縣,朴子市,0242,310,84,394,52,446,810,55.06%,38.27%,1
嘉義縣,朴子市,0243,393,102,495,52,547,940,58.19%,41.81%,1
嘉義縣,朴子市,0244,326,108,434,52,486,905,53.7%,36.02%,1
嘉義縣,朴子市,0245,538,175,713,51,764,1605,47.6%,33.52%,1
嘉義縣,朴子市,0246,587,190,777,66,843,1479,57%,39.69%,1
嘉義縣,朴子市,0247,479,160,639,60,699,1218,57.39%,39.33%,1
嘉義縣,朴子市,0248,624,178,802,55,857,1496,57.29%,41.71%,1
嘉義縣,朴子市,0249,218,84,302,34,336,667,50.37%,32.68%,1
嘉義縣,朴子市,0250,160,60,220,24,244,627,38.92%,25.52%,1
嘉義縣,朴子市,0251,267,74,341,54,395,791,49.94%,33.75%,1
嘉義縣,朴子市,0252,346,121,467,106,573,1034,55.42%,33.46%,1
嘉義縣,朴子市,0253,610,163,773,25,798,1710,46.67%,35.67%,1
嘉義縣,朴子市,0254,573,135,708,44,752,1671,45%,34.29%,1
嘉義縣,朴子市,0255,454,116,570,45,615,1547,39.75%,29.35%,1
嘉義縣,朴子市,0256,430,140,570,70,640,1602,39.95%,26.84%,1
嘉義縣,朴子市,0257,579,128,707,29,736,1302,56.53%,44.47%,1
嘉義縣,朴子市,0258,245,82,327,49,376,740,50.81%,33.11%,1
嘉義縣,朴子市,0259,429,127,556,63,619,1054,58.73%,40.7%,1
嘉義縣,朴子市,0260,246,84,330,17,347,907,38.26%,27.12%,1
嘉義縣,朴子市,0261,195,78,273,33,306,720,42.5%,27.08%,1
嘉義縣,朴子市,0262,85,35,120,26,146,251,58.17%,33.86%,1
嘉義縣,朴子市,0263,182,90,272,62,334,767,43.55%,23.73%,1
嘉義縣,朴子市,0264,256,89,345,44,389,702,55.41%,36.47%,1
嘉義縣,朴子市,0265,320,110,430,56,486,1038,46.82%,30.83%,1
嘉義縣,朴子市,0266,276,79,355,30,385,1228,31.35%,22.48%,1
嘉義縣,朴子市,0267,163,48,211,46,257,499,51.5%,32.67%,1
嘉義縣,布袋鎮,0325,207,54,261,31,292,614,47.56%,33.71%,1
嘉義縣,布袋鎮,0326,115,36,151,16,167,372,44.89%,30.91%,1
嘉義縣,布袋鎮,0327,313,101,414,91,505,914,55.25%,34.25%,1
嘉義縣,布袋鎮,0328,416,128,544,93,637,1198,53.17%,34.72%,1
嘉義縣,布袋鎮,0329,343,107,450,74,524,1113,47.08%,30.82%,1
嘉義縣,布袋鎮,0330,367,98,465,80,545,992,54.94%,37%,1
嘉義縣,布袋鎮,0331,247,64,311,12,323,689,46.88%,35.85%,1
嘉義縣,布袋鎮,0332,291,103,394,72,466,882,52.83%,32.99%,1
嘉義縣,布袋鎮,0333,262,77,339,40,379,731,51.85%,35.84%,1
嘉義縣,布袋鎮,0334,297,86,383,35,418,779,53.66%,38.13%,1
嘉義縣,布袋鎮,0335,233,68,301,39,340,762,44.62%,30.58%,1
嘉義縣,布袋鎮,0336,371,97,468,48,516,1184,43.58%,31.33%,1
嘉義縣,布袋鎮,0337,362,120,482,76,558,1423,39.21%,25.44%,1
嘉義縣,布袋鎮,0338,346,114,460,71,531,1351,39.3%,25.61%,1
嘉義縣,布袋鎮,0339,81,27,108,5,113,275,41.09%,29.45%,1
嘉義縣,布袋鎮,0340,65,33,98,12,110,243,45.27%,26.75%,1
嘉義縣,布袋鎮,0341,204,75,279,84,363,661,54.92%,30.86%,1
嘉義縣,布袋鎮,0342,374,99,473,61,534,1145,46.64%,32.66%,1
嘉義縣,布袋鎮,0343,292,86,378,36,414,936,44.23%,31.2%,1
嘉義縣,布袋鎮,0344,320,95,415,38,453,958,47.29%,33.4%,1
嘉義縣,布袋鎮,0345,95,26,121,14,135,298,45.3%,31.88%,1
嘉義縣,布袋鎮,0346,167,40,207,37,244,428,57.01%,39.02%,1
嘉義縣,布袋鎮,0347,38,9,47,4,51,121,42.15%,31.4%,1
嘉義縣,布袋鎮,0348,34,11,45,4,49,174,28.16%,19.54%,1
嘉義縣,布袋鎮,0349,324,80,404,47,451,953,47.32%,34%,1
嘉義縣,布袋鎮,0350,436,172,608,80,688,1292,53.25%,33.75%,1
嘉義縣,布袋鎮,0351,410,114,524,77,601,1127,53.33%,36.38%,1
嘉義縣,布袋鎮,0352,400,145,545,31,576,1244,46.3%,32.15%,1
嘉義縣,布袋鎮,0353,305,120,425,25,450,1106,40.69%,27.58%,1
嘉義縣,大林鎮,0169,160,69,229,36,265,483,54.87%,33.13%,1
嘉義縣,大林鎮,0170,733,211,944,68,1012,1823,55.51%,40.21%,1
嘉義縣,大林鎮,0171,386,109,495,17,512,955,53.61%,40.42%,1
嘉義縣,大林鎮,0172,519,163,682,34,716,1436,49.86%,36.14%,1
嘉義縣,大林鎮,0173,483,167,650,60,710,1390,51.08%,34.75%,1
嘉義縣,大林鎮,0174,589,175,764,79,843,1512,55.75%,38.96%,1
嘉義縣,大林鎮,0175,629,177,806,52,858,1536,55.86%,40.95%,1
嘉義縣,大林鎮,0176,405,105,510,38,548,1165,47.04%,34.76%,1
嘉義縣,大林鎮,0177,708,232,940,79,1019,1730,58.9%,40.92%,1
嘉義縣,大林鎮,0178,169,57,226,15,241,602,40.03%,28.07%,1
嘉義縣,大林鎮,0179,212,82,294,66,360,716,50.28%,29.61%,1
嘉義縣,大林鎮,0180,153,43,196,9,205,625,32.8%,24.48%,1
嘉義縣,大林鎮,0181,55,12,67,1,68,193,35.23%,28.5%,1
嘉義縣,大林鎮,0182,495,186,681,70,751,1642,45.74%,30.15%,1
嘉義縣,大林鎮,0183,540,157,697,62,759,1465,51.81%,36.86%,1
嘉義縣,大林鎮,0184,284,77,361,49,410,928,44.18%,30.6%,1
嘉義縣,大林鎮,0185,107,29,136,23,159,361,44.04%,29.64%,1
嘉義縣,大林鎮,0186,243,80,323,21,344,814,42.26%,29.85%,1
嘉義縣,大林鎮,0187,524,157,681,38,719,1579,45.54%,33.19%,1
嘉義縣,大林鎮,0188,734,218,952,94,1046,2041,51.25%,35.96%,1
嘉義縣,大林鎮,0189,327,93,420,54,474,931,50.91%,35.12%,1
嘉義縣,大林鎮,0190,233,70,303,41,344,675,50.96%,34.52%,1
嘉義縣,大林鎮,0191,225,55,280,29,309,655,47.18%,34.35%,1
嘉義縣,大林鎮,0192,281,83,364,42,406,833,48.74%,33.73%,1
嘉義縣,大林鎮,0193,330,108,438,62,500,832,60.1%,39.66%,1
嘉義縣,民雄鄉,0093,528,146,674,53,727,1267,57.38%,41.67%,1
嘉義縣,民雄鄉,0094,366,120,486,38,524,1030,50.87%,35.53%,1
嘉義縣,民雄鄉,0095,732,118,850,89,939,1590,59.06%,46.04%,1
嘉義縣,民雄鄉,0096,610,163,773,40,813,1673,48.6%,36.46%,1
嘉義縣,民雄鄉,0097,644,237,881,78,959,1718,55.82%,37.49%,1
嘉義縣,民雄鄉,0098,443,121,564,50,614,1040,59.04%,42.6%,1
嘉義縣,民雄鄉,0099,408,124,532,61,593,1100,53.91%,37.09%,1
嘉義縣,民雄鄉,0100,570,156,726,72,798,1559,51.19%,36.56%,1
嘉義縣,民雄鄉,0101,639,218,857,81,938,1862,50.38%,34.32%,1
嘉義縣,民雄鄉,0102,558,178,736,72,808,1435,56.31%,38.89%,1
嘉義縣,民雄鄉,0103,532,225,757,158,915,1751,52.26%,30.38%,1
嘉義縣,民雄鄉,0104,358,101,459,61,520,933,55.73%,38.37%,1
嘉義縣,民雄鄉,0105,313,142,455,62,517,827,62.52%,37.85%,1
嘉義縣,民雄鄉,0106,258,77,335,57,392,843,46.5%,30.6%,1
嘉義縣,民雄鄉,0107,650,221,871,66,937,1774,52.82%,36.64%,1
嘉義縣,民雄鄉,0108,118,43,161,21,182,385,47.27%,30.65%,1
嘉義縣,民雄鄉,0109,512,180,692,56,748,1306,57.27%,39.2%,1
嘉義縣,民雄鄉,0110,206,69,275,45,320,535,59.81%,38.5%,1
嘉義縣,民雄鄉,0111,402,121,523,89,612,1055,58.01%,38.1%,1
嘉義縣,民雄鄉,0112,548,185,733,61,794,1476,53.79%,37.13%,1
嘉義縣,民雄鄉,0113,567,163,730,64,794,1583,50.16%,35.82%,1
嘉義縣,民雄鄉,0114,207,103,310,34,344,758,45.38%,27.31%,1
嘉義縣,民雄鄉,0115,469,145,614,59,673,1354,49.7%,34.64%,1
嘉義縣,民雄鄉,0116,445,160,605,79,684,1202,56.91%,37.02%,1
嘉義縣,民雄鄉,0117,453,146,599,47,646,1175,54.98%,38.55%,1
嘉義縣,民雄鄉,0118,503,158,661,65,726,1423,51.02%,35.35%,1
嘉義縣,民雄鄉,0119,641,162,803,44,847,1612,52.54%,39.76%,1
嘉義縣,民雄鄉,0120,687,200,887,35,922,1695,54.4%,40.53%,1
嘉義縣,民雄鄉,0121,526,177,703,51,754,1665,45.29%,31.59%,1
嘉義縣,民雄鄉,0122,323,107,430,58,488,1019,47.89%,31.7%,1
嘉義縣,民雄鄉,0123,489,157,646,60,706,1352,52.22%,36.17%,1
嘉義縣,民雄鄉,0124,589,208,797,92,889,1620,54.88%,36.36%,1
嘉義縣,民雄鄉,0125,335,106,441,32,473,943,50.16%,35.52%,1
嘉義縣,民雄鄉,0126,536,194,730,63,793,1720,46.1%,31.16%,1
嘉義縣,民雄鄉,0127,627,220,847,107,954,1875,50.88%,33.44%,1
嘉義縣,民雄鄉,0128,506,170,676,53,729,1305,55.86%,38.77%,1
嘉義縣,民雄鄉,0129,496,171,667,71,738,1441,51.21%,34.42%,1
嘉義縣,民雄鄉,0130,522,162,684,68,752,1413,53.22%,36.94%,1
嘉義縣,民雄鄉,0131,555,188,743,82,825,1560,52.88%,35.58%,1
嘉義縣,民雄鄉,0132,731,259,990,123,1113,2004,55.54%,36.48%,1
嘉義縣,民雄鄉,0133,557,168,725,69,794,1354,58.64%,41.14%,1
嘉義縣,民雄鄉,0134,415,134,549,48,597,1076,55.48%,38.57%,1
嘉義縣,民雄鄉,0135,573,213,786,124,910,1629,55.86%,35.17%,1
嘉義縣,民雄鄉,0136,711,190,901,89,990,1977,50.08%,35.96%,1
嘉義縣,民雄鄉,0137,405,193,598,86,684,1295,52.82%,31.27%,1
嘉義縣,溪口鄉,0194,480,167,647,100,747,1318,56.68%,36.42%,1
嘉義縣,溪口鄉,0195,251,87,338,52,390,677,57.61%,37.08%,1
嘉義縣,溪口鄉,0196,141,44,185,14,199,417,47.72%,33.81%,1
嘉義縣,溪口鄉,0197,88,41,129,18,147,273,53.85%,32.23%,1
嘉義縣,溪口鄉,0198,332,133,465,63,528,908,58.15%,36.56%,1
嘉義縣,溪口鄉,0199,115,39,154,9,163,386,42.23%,29.79%,1
嘉義縣,溪口鄉,0200,370,144,514,62,576,1039,55.44%,35.61%,1
嘉義縣,溪口鄉,0201,205,69,274,54,328,708,46.33%,28.95%,1
嘉義縣,溪口鄉,0202,287,90,377,15,392,909,43.12%,31.57%,1
嘉義縣,溪口鄉,0203,294,92,386,44,430,786,54.71%,37.4%,1
嘉義縣,溪口鄉,0204,239,96,335,46,381,807,47.21%,29.62%,1
嘉義縣,溪口鄉,0205,318,88,406,20,426,1168,36.47%,27.23%,1
嘉義縣,溪口鄉,0206,373,126,499,87,586,1052,55.7%,35.46%,1
嘉義縣,溪口鄉,0207,157,75,232,53,285,565,50.44%,27.79%,1
嘉義縣,溪口鄉,0208,152,31,183,22,205,388,52.84%,39.18%,1
嘉義縣,溪口鄉,0209,198,58,256,26,282,701,40.23%,28.25%,1
嘉義縣,溪口鄉,0210,264,92,356,39,395,1003,39.38%,26.32%,1
嘉義縣,新港鄉,0138,429,100,529,31,560,1087,51.52%,39.47%,1
嘉義縣,新港鄉,0139,532,129,661,72,733,1116,65.68%,47.67%,1
嘉義縣,新港鄉,0140,269,89,358,51,409,740,55.27%,36.35%,1
嘉義縣,新港鄉,0141,275,95,370,67,437,827,52.84%,33.25%,1
嘉義縣,新港鄉,0142,295,85,380,51,431,704,61.22%,41.9%,1
嘉義縣,新港鄉,0143,306,105,411,58,469,768,61.07%,39.84%,1
嘉義縣,新港鄉,0144,294,118,412,44,456,761,59.92%,38.63%,1
嘉義縣,新港鄉,0145,284,82,366,66,432,850,50.82%,33.41%,1
嘉義縣,新港鄉,0146,469,153,622,71,693,1327,52.22%,35.34%,1
嘉義縣,新港鄉,0147,254,96,350,66,416,756,55.03%,33.6%,1
嘉義縣,新港鄉,0148,279,96,375,86,461,816,56.5%,34.19%,1
嘉義縣,新港鄉,0149,190,81,271,31,302,667,45.28%,28.49%,1
嘉義縣,新港鄉,0150,324,95,419,61,480,942,50.96%,34.39%,1
嘉義縣,新港鄉,0151,277,95,372,66,438,918,47.71%,30.17%,1
嘉義縣,新港鄉,0152,160,51,211,14,225,554,40.61%,28.88%,1
嘉義縣,新港鄉,0153,301,93,394,44,438,929,47.15%,32.4%,1
嘉義縣,新港鄉,0154,129,42,171,34,205,487,42.09%,26.49%,1
嘉義縣,新港鄉,0155,163,65,228,42,270,487,55.44%,33.47%,1
嘉義縣,新港鄉,0156,235,114,349,49,398,836,47.61%,28.11%,1
嘉義縣,新港鄉,0157,284,116,400,61,461,845,54.56%,33.61%,1
嘉義縣,新港鄉,0158,304,99,403,50,453,834,54.32%,36.45%,1
嘉義縣,新港鄉,0159,268,102,370,55,425,753,56.44%,35.59%,1
嘉義縣,新港鄉,0160,461,167,628,73,701,1328,52.79%,34.71%,1
嘉義縣,新港鄉,0161,373,126,499,52,551,969,56.86%,38.49%,1
嘉義縣,新港鄉,0162,412,138,550,66,616,1043,59.06%,39.5%,1
嘉義縣,新港鄉,0163,615,170,785,65,850,1400,60.71%,43.93%,1
嘉義縣,新港鄉,0164,228,78,306,32,338,1017,33.24%,22.42%,1
嘉義縣,新港鄉,0165,332,121,453,55,508,1132,44.88%,29.33%,1
嘉義縣,新港鄉,0166,363,112,475,62,537,1037,51.78%,35%,1
嘉義縣,新港鄉,0167,207,61,268,65,333,563,59.15%,36.77%,1
嘉義縣,新港鄉,0168,338,61,399,12,411,849,48.41%,39.81%,1
嘉義縣,六腳鄉,0268,346,96,442,41,483,1165,41.46%,29.7%,1
嘉義縣,六腳鄉,0269,192,56,248,20,268,825,32.48%,23.27%,1
嘉義縣,六腳鄉,0270,234,91,325,35,360,850,42.35%,27.53%,1
嘉義縣,六腳鄉,0271,85,26,111,21,132,222,59.46%,38.29%,1
嘉義縣,六腳鄉,0272,401,125,526,60,586,1216,48.19%,32.98%,1
嘉義縣,六腳鄉,0273,305,82,387,49,436,1200,36.33%,25.42%,1
嘉義縣,六腳鄉,0274,284,76,360,49,409,877,46.64%,32.38%,1
嘉義縣,六腳鄉,0275,185,47,232,41,273,644,42.39%,28.73%,1
嘉義縣,六腳鄉,0276,144,46,190,12,202,594,34.01%,24.24%,1
嘉義縣,六腳鄉,0277,34,4,38,1,39,167,23.35%,20.36%,1
嘉義縣,六腳鄉,0278,44,24,68,1,69,204,33.82%,21.57%,1
嘉義縣,六腳鄉,0279,63,19,82,7,89,234,38.03%,26.92%,1
嘉義縣,六腳鄉,0280,84,34,118,6,124,361,34.35%,23.27%,1
嘉義縣,六腳鄉,0281,218,55,273,57,330,592,55.74%,36.82%,1
嘉義縣,六腳鄉,0282,190,81,271,37,308,619,49.76%,30.69%,1
嘉義縣,六腳鄉,0283,165,57,222,47,269,714,37.68%,23.11%,1
嘉義縣,六腳鄉,0284,342,81,423,61,484,1051,46.05%,32.54%,1
嘉義縣,六腳鄉,0285,302,113,415,67,482,934,51.61%,32.33%,1
嘉義縣,六腳鄉,0286,337,116,453,58,511,1044,48.95%,32.28%,1
嘉義縣,六腳鄉,0287,417,127,544,39,583,1476,39.5%,28.25%,1
嘉義縣,六腳鄉,0288,140,53,193,23,216,618,34.95%,22.65%,1
嘉義縣,六腳鄉,0289,84,30,114,48,162,478,33.89%,17.57%,1
嘉義縣,六腳鄉,0290,136,44,180,52,232,642,36.14%,21.18%,1
嘉義縣,六腳鄉,0291,187,62,249,14,263,883,29.78%,21.18%,1
嘉義縣,六腳鄉,0292,160,39,199,8,207,739,28.01%,21.65%,1
嘉義縣,六腳鄉,0293,134,54,188,27,215,554,38.81%,24.19%,1
嘉義縣,六腳鄉,0294,128,50,178,23,201,649,30.97%,19.72%,1
嘉義縣,六腳鄉,0295,158,46,204,27,231,689,33.53%,22.93%,1
嘉義縣,六腳鄉,0296,106,47,153,18,171,455,37.58%,23.3%,1
嘉義縣,六腳鄉,0297,22,11,33,5,38,125,30.4%,17.6%,1
嘉義縣,東石鄉,0298,507,195,702,105,807,1915,42.14%,26.48%,1
嘉義縣,東石鄉,0299,221,82,303,65,368,938,39.23%,23.56%,1
嘉義縣,東石鄉,0300,259,82,341,36,377,1366,27.6%,18.96%,1
嘉義縣,東石鄉,0301,407,139,546,7,553,1676,33%,24.28%,1
嘉義縣,東石鄉,0302,263,97,360,104,464,1151,40.31%,22.85%,1
嘉義縣,東石鄉,0303,182,55,237,85,322,716,44.97%,25.42%,1
嘉義縣,東石鄉,0304,97,23,120,11,131,387,33.85%,25.06%,1
嘉義縣,東石鄉,0305,164,54,218,13,231,864,26.74%,18.98%,1
嘉義縣,東石鄉,0306,183,67,250,17,267,910,29.34%,20.11%,1
嘉義縣,東石鄉,0307,176,50,226,17,243,760,31.97%,23.16%,1
嘉義縣,東石鄉,0308,44,25,69,16,85,166,51.2%,26.51%,1
嘉義縣,東石鄉,0309,45,17,62,15,77,212,36.32%,21.23%,1
嘉義縣,東石鄉,0310,203,71,274,48,322,993,32.43%,20.44%,1
嘉義縣,東石鄉,0311,69,26,95,16,111,306,36.27%,22.55%,1
嘉義縣,東石鄉,0312,234,84,318,93,411,1046,39.29%,22.37%,1
嘉義縣,東石鄉,0313,48,15,63,27,90,235,38.3%,20.43%,1
嘉義縣,東石鄉,0314,335,114,449,105,554,1226,45.19%,27.32%,1
嘉義縣,東石鄉,0315,222,78,300,67,367,843,43.53%,26.33%,1
嘉義縣,東石鄉,0316,84,57,141,37,178,693,25.69%,12.12%,1
嘉義縣,東石鄉,0317,260,76,336,76,412,839,49.11%,30.99%,1
嘉義縣,東石鄉,0318,108,27,135,11,146,363,40.22%,29.75%,1
嘉義縣,東石鄉,0319,77,21,98,11,109,321,33.96%,23.99%,1
嘉義縣,東石鄉,0320,350,139,489,111,600,1083,55.4%,32.32%,1
嘉義縣,東石鄉,0321,253,96,349,62,411,901,45.62%,28.08%,1
嘉義縣,東石鄉,0322,267,58,325,41,366,1216,30.1%,21.96%,1
嘉義縣,東石鄉,0323,155,49,204,45,249,418,59.57%,37.08%,1
嘉義縣,東石鄉,0324,108,32,140,15,155,371,41.78%,29.11%,1
嘉義縣,義竹鄉,0354,153,48,201,29,230,482,47.72%,31.74%,1
嘉義縣,義竹鄉,0355,87,26,113,18,131,223,58.74%,39.01%,1
嘉義縣,義竹鄉,0356,546,178,724,88,812,1529,53.11%,35.71%,1
嘉義縣,義竹鄉,0357,453,130,583,70,653,1175,55.57%,38.55%,1
嘉義縣,義竹鄉,0358,374,116,490,54,544,886,61.4%,42.21%,1
嘉義縣,義竹鄉,0359,226,69,295,39,334,743,44.95%,30.42%,1
嘉義縣,義竹鄉,0360,431,157,588,87,675,1236,54.61%,34.87%,1
嘉義縣,義竹鄉,0361,137,37,174,20,194,377,51.46%,36.34%,1
嘉義縣,義竹鄉,0362,108,25,133,19,152,338,44.97%,31.95%,1
嘉義縣,義竹鄉,0363,44,10,54,5,59,102,57.84%,43.14%,1
嘉義縣,義竹鄉,0364,231,72,303,24,327,763,42.86%,30.28%,1
嘉義縣,義竹鄉,0365,152,59,211,28,239,429,55.71%,35.43%,1
嘉義縣,義竹鄉,0366,139,45,184,23,207,427,48.48%,32.55%,1
嘉義縣,義竹鄉,0367,213,69,282,47,329,607,54.2%,35.09%,1
嘉義縣,義竹鄉,0368,485,127,612,49,661,1486,44.48%,32.64%,1
嘉義縣,義竹鄉,0369,325,88,413,63,476,835,57.01%,38.92%,1
嘉義縣,義竹鄉,0370,226,63,289,64,353,816,43.26%,27.7%,1
嘉義縣,義竹鄉,0371,217,103,320,61,381,833,45.74%,26.05%,1
嘉義縣,義竹鄉,0372,145,50,195,17,212,433,48.96%,33.49%,1
嘉義縣,義竹鄉,0373,196,37,233,6,239,558,42.83%,35.13%,1
嘉義縣,義竹鄉,0374,189,80,269,41,310,602,51.5%,31.4%,1
嘉義縣,義竹鄉,0375,43,10,53,0,53,140,37.86%,30.71%,1
嘉義縣,義竹鄉,0376,109,40,149,26,175,393,44.53%,27.74%,1
嘉義縣,義竹鄉,0377,208,54,262,22,284,585,48.55%,35.56%,1
嘉義縣,義竹鄉,0378,116,35,151,9,160,526,30.42%,22.05%,1
嘉義縣,義竹鄉,0379,36,20,56,11,67,123,54.47%,29.27%,1
嘉義縣,鹿草鄉,0034,142,52,194,46,240,522,45.98%,27.2%,1
嘉義縣,鹿草鄉,0035,180,74,254,45,299,563,53.11%,31.97%,1
嘉義縣,鹿草鄉,0036,422,128,550,89,639,1304,49%,32.36%,1
嘉義縣,鹿草鄉,0037,438,154,592,65,657,1312,50.08%,33.38%,1
嘉義縣,鹿草鄉,0038,94,31,125,3,128,320,40%,29.38%,1
嘉義縣,鹿草鄉,0039,90,17,107,3,110,418,26.32%,21.53%,1
嘉義縣,鹿草鄉,0040,295,85,380,57,437,1025,42.63%,28.78%,1
嘉義縣,鹿草鄉,0041,106,50,156,30,186,451,41.24%,23.5%,1
嘉義縣,鹿草鄉,0042,256,82,338,105,443,830,53.37%,30.84%,1
嘉義縣,鹿草鄉,0043,301,95,396,93,489,1050,46.57%,28.67%,1
嘉義縣,鹿草鄉,0044,265,77,342,57,399,972,41.05%,27.26%,1
嘉義縣,鹿草鄉,0045,277,104,381,59,440,962,45.74%,28.79%,1
嘉義縣,鹿草鄉,0046,219,73,292,56,348,678,51.33%,32.3%,1
嘉義縣,鹿草鄉,0047,76,26,102,34,136,262,51.91%,29.01%,1
嘉義縣,鹿草鄉,0048,257,85,342,48,390,906,43.05%,28.37%,1
嘉義縣,鹿草鄉,0049,73,21,94,11,105,306,34.31%,23.86%,1
嘉義縣,鹿草鄉,0050,357,106,463,74,537,1062,50.56%,33.62%,1
嘉義縣,鹿草鄉,0051,118,49,167,29,196,373,52.55%,31.64%,1
嘉義縣,鹿草鄉,0052,114,36,150,25,175,324,54.01%,35.19%,1
嘉義縣,鹿草鄉,0053,98,26,124,22,146,297,49.16%,33%,1
嘉義縣,水上鄉,0054,341,115,456,44,500,1024,48.83%,33.3%,1
嘉義縣,水上鄉,0055,390,152,542,70,612,1015,60.3%,38.42%,1
嘉義縣,水上鄉,0056,645,215,860,80,940,1932,48.65%,33.39%,1
嘉義縣,水上鄉,0057,473,158,631,47,678,1170,57.95%,40.43%,1
嘉義縣,水上鄉,0058,536,151,687,78,765,1305,58.62%,41.07%,1
嘉義縣,水上鄉,0059,405,141,546,68,614,1242,49.44%,32.61%,1
嘉義縣,水上鄉,0060,107,37,144,18,162,324,50%,33.02%,1
嘉義縣,水上鄉,0061,238,70,308,17,325,622,52.25%,38.26%,1
嘉義縣,水上鄉,0062,439,111,550,85,635,1216,52.22%,36.1%,1
嘉義縣,水上鄉,0063,421,104,525,33,558,1020,54.71%,41.27%,1
嘉義縣,水上鄉,0064,328,109,437,43,480,771,62.26%,42.54%,1
嘉義縣,水上鄉,0065,190,63,253,23,276,441,62.59%,43.08%,1
嘉義縣,水上鄉,0066,282,76,358,49,407,626,65.02%,45.05%,1
嘉義縣,水上鄉,0067,227,84,311,27,338,570,59.3%,39.82%,1
嘉義縣,水上鄉,0068,121,49,170,22,192,368,52.17%,32.88%,1
嘉義縣,水上鄉,0069,306,127,433,100,533,1037,51.4%,29.51%,1
嘉義縣,水上鄉,0070,374,126,500,75,575,1065,53.99%,35.12%,1
嘉義縣,水上鄉,0071,318,110,428,81,509,802,63.47%,39.65%,1
嘉義縣,水上鄉,0072,647,201,848,56,904,1948,46.41%,33.21%,1
嘉義縣,水上鄉,0073,329,127,456,68,524,1028,50.97%,32%,1
嘉義縣,水上鄉,0074,268,79,347,24,371,641,57.88%,41.81%,1
嘉義縣,水上鄉,0075,163,40,203,21,224,408,54.9%,39.95%,1
嘉義縣,水上鄉,0076,286,112,398,59,457,794,57.56%,36.02%,1
嘉義縣,水上鄉,0077,165,71,236,33,269,569,47.28%,29%,1
嘉義縣,水上鄉,0078,311,99,410,41,451,806,55.96%,38.59%,1
嘉義縣,水上鄉,0079,389,116,505,48,553,960,57.6%,40.52%,1
嘉義縣,水上鄉,0080,742,254,996,114,1110,2035,54.55%,36.46%,1
嘉義縣,水上鄉,0081,691,231,922,95,1017,1987,51.18%,34.78%,1
嘉義縣,水上鄉,0082,437,119,556,47,603,1154,52.25%,37.87%,1
嘉義縣,水上鄉,0083,782,240,1022,84,1106,2208,50.09%,35.42%,1
嘉義縣,水上鄉,0084,641,224,865,71,936,2102,44.53%,30.49%,1
嘉義縣,水上鄉,0085,441,137,578,83,661,1309,50.5%,33.69%,1
嘉義縣,水上鄉,0086,595,231,826,81,907,1671,54.28%,35.61%,1
嘉義縣,水上鄉,0087,292,99,391,50,441,822,53.65%,35.52%,1
嘉義縣,水上鄉,0088,571,210,781,57,838,1772,47.29%,32.22%,1
嘉義縣,水上鄉,0089,649,241,890,101,991,1919,51.64%,33.82%,1
嘉義縣,水上鄉,0090,255,87,342,26,368,912,40.35%,27.96%,1
嘉義縣,水上鄉,0091,340,92,432,37,469,992,47.28%,34.27%,1
嘉義縣,水上鄉,0092,349,149,498,65,563,1270,44.33%,27.48%,1
嘉義縣,中埔鄉,0380,302,86,388,16,404,1046,38.62%,28.87%,1
嘉義縣,中埔鄉,0381,565,181,746,95,841,1788,47.04%,31.6%,1
嘉義縣,中埔鄉,0382,529,188,717,56,773,1730,44.68%,30.58%,1
嘉義縣,中埔鄉,0383,540,171,711,59,770,1581,48.7%,34.16%,1
嘉義縣,中埔鄉,0384,479,150,629,47,676,1594,42.41%,30.05%,1
嘉義縣,中埔鄉,0385,648,183,831,48,879,1801,48.81%,35.98%,1
嘉義縣,中埔鄉,0386,663,185,848,80,928,1862,49.84%,35.61%,1
嘉義縣,中埔鄉,0387,579,164,743,33,776,1803,43.04%,32.11%,1
嘉義縣,中埔鄉,0388,553,149,702,63,765,1481,51.65%,37.34%,1
嘉義縣,中埔鄉,0389,494,153,647,70,717,1366,52.49%,36.16%,1
嘉義縣,中埔鄉,0390,471,157,628,83,711,1599,44.47%,29.46%,1
嘉義縣,中埔鄉,0391,390,137,527,48,575,1196,48.08%,32.61%,1
嘉義縣,中埔鄉,0392,557,180,737,82,819,1809,45.27%,30.79%,1
嘉義縣,中埔鄉,0393,319,103,422,31,453,953,47.53%,33.47%,1
嘉義縣,中埔鄉,0394,442,148,590,77,667,1441,46.29%,30.67%,1
嘉義縣,中埔鄉,0395,628,173,801,64,865,1882,45.96%,33.37%,1
嘉義縣,中埔鄉,0396,364,115,479,24,503,1470,34.22%,24.76%,1
嘉義縣,中埔鄉,0397,532,138,670,81,751,1699,44.2%,31.31%,1
嘉義縣,中埔鄉,0398,122,30,152,21,173,422,41%,28.91%,1
嘉義縣,中埔鄉,0399,330,114,444,69,513,1030,49.81%,32.04%,1
嘉義縣,中埔鄉,0400,255,88,343,51,394,879,44.82%,29.01%,1
嘉義縣,中埔鄉,0401,235,69,304,15,319,828,38.53%,28.38%,1
嘉義縣,中埔鄉,0402,345,93,438,60,498,881,56.53%,39.16%,1
嘉義縣,中埔鄉,0403,86,41,127,21,148,296,50%,29.05%,1
嘉義縣,中埔鄉,0404,265,116,381,98,479,979,48.93%,27.07%,1
嘉義縣,中埔鄉,0405,362,120,482,41,523,1268,41.25%,28.55%,1
嘉義縣,中埔鄉,0406,142,43,185,7,192,670,28.66%,21.19%,1
嘉義縣,中埔鄉,0407,270,101,371,60,431,754,57.16%,35.81%,1
嘉義縣,中埔鄉,0408,236,79,315,39,354,648,54.63%,36.42%,1
嘉義縣,中埔鄉,0409,210,54,264,28,292,741,39.41%,28.34%,1
嘉義縣,中埔鄉,0410,168,37,205,4,209,518,40.35%,32.43%,1
嘉義縣,中埔鄉,0411,147,55,202,39,241,482,50%,30.5%,1
嘉義縣,中埔鄉,0412,97,37,134,8,142,348,40.8%,27.87%,1
嘉義縣,中埔鄉,0413,99,31,130,14,144,294,48.98%,33.67%,1
嘉義縣,竹崎鄉,0414,431,172,603,43,646,1312,49.24%,32.85%,1
嘉義縣,竹崎鄉,0415,481,117,598,27,625,1210,51.65%,39.75%,1
嘉義縣,竹崎鄉,0416,388,114,502,51,553,991,55.8%,39.15%,1
嘉義縣,竹崎鄉,0417,429,108,537,56,593,1207,49.13%,35.54%,1
嘉義縣,竹崎鄉,0418,215,74,289,17,306,752,40.69%,28.59%,1
嘉義縣,竹崎鄉,0419,313,100,413,69,482,833,57.86%,37.58%,1
嘉義縣,竹崎鄉,0420,448,150,598,91,689,1220,56.48%,36.72%,1
嘉義縣,竹崎鄉,0421,236,86,322,18,340,616,55.19%,38.31%,1
嘉義縣,竹崎鄉,0422,350,116,466,62,528,1031,51.21%,33.95%,1
嘉義縣,竹崎鄉,0423,421,165,586,82,668,1292,51.7%,32.59%,1
嘉義縣,竹崎鄉,0424,765,235,1000,94,1094,1995,54.84%,38.35%,1
嘉義縣,竹崎鄉,0425,641,194,835,42,877,1996,43.94%,32.11%,1
嘉義縣,竹崎鄉,0426,517,146,663,93,756,1449,52.17%,35.68%,1
嘉義縣,竹崎鄉,0427,515,127,642,49,691,1420,48.66%,36.27%,1
嘉義縣,竹崎鄉,0428,596,188,784,49,833,1590,52.39%,37.48%,1
嘉義縣,竹崎鄉,0429,261,81,342,44,386,771,50.06%,33.85%,1
嘉義縣,竹崎鄉,0430,294,133,427,54,481,1014,47.44%,28.99%,1
嘉義縣,竹崎鄉,0431,71,25,96,12,108,327,33.03%,21.71%,1
嘉義縣,竹崎鄉,0432,247,81,328,27,355,687,51.67%,35.95%,1
嘉義縣,竹崎鄉,0433,209,59,268,24,292,641,45.55%,32.61%,1
嘉義縣,竹崎鄉,0434,177,38,215,10,225,474,47.47%,37.34%,1
嘉義縣,竹崎鄉,0435,129,29,158,27,185,383,48.3%,33.68%,1
嘉義縣,竹崎鄉,0436,240,73,313,61,374,619,60.42%,38.77%,1
嘉義縣,竹崎鄉,0437,66,24,90,8,98,214,45.79%,30.84%,1
嘉義縣,竹崎鄉,0438,521,173,694,120,814,1568,51.91%,33.23%,1
嘉義縣,竹崎鄉,0439,200,53,253,36,289,658,43.92%,30.4%,1
嘉義縣,竹崎鄉,0440,152,64,216,38,254,434,58.53%,35.02%,1
嘉義縣,竹崎鄉,0441,346,92,438,54,492,917,53.65%,37.73%,1
嘉義縣,竹崎鄉,0442,321,102,423,48,471,981,48.01%,32.72%,1
嘉義縣,竹崎鄉,0443,224,69,293,24,317,789,40.18%,28.39%,1
嘉義縣,竹崎鄉,0444,25,2,27,1,28,108,25.93%,23.15%,1
嘉義縣,竹崎鄉,0445,41,9,50,2,52,235,22.13%,17.45%,1
嘉義縣,竹崎鄉,0446,102,26,128,8,136,331,41.09%,30.82%,1
嘉義縣,竹崎鄉,0447,200,59,259,16,275,450,61.11%,44.44%,1
嘉義縣,竹崎鄉,0448,130,34,164,9,173,462,37.45%,28.14%,1
嘉義縣,竹崎鄉,0449,64,21,85,19,104,251,41.43%,25.5%,1
嘉義縣,梅山鄉,0211,368,116,484,30,514,1041,49.38%,35.35%,1
嘉義縣,梅山鄉,0212,471,162,633,101,734,1245,58.96%,37.83%,1
嘉義縣,梅山鄉,0213,378,121,499,64,563,917,61.4%,41.22%,1
嘉義縣,梅山鄉,0214,464,131,595,34,629,1189,52.9%,39.02%,1
嘉義縣,梅山鄉,0215,545,157,702,84,786,1388,56.63%,39.27%,1
嘉義縣,梅山鄉,0216,672,203,875,74,949,1827,51.94%,36.78%,1
嘉義縣,梅山鄉,0217,231,61,292,51,343,545,62.94%,42.39%,1
嘉義縣,梅山鄉,0218,107,43,150,33,183,407,44.96%,26.29%,1
嘉義縣,梅山鄉,0219,224,80,304,33,337,636,52.99%,35.22%,1
嘉義縣,梅山鄉,0220,204,64,268,61,329,576,57.12%,35.42%,1
嘉義縣,梅山鄉,0221,612,194,806,104,910,1674,54.36%,36.56%,1
嘉義縣,梅山鄉,0222,270,75,345,15,360,858,41.96%,31.47%,1
嘉義縣,梅山鄉,0223,205,78,283,43,326,526,61.98%,38.97%,1
嘉義縣,梅山鄉,0224,102,42,144,36,180,372,48.39%,27.42%,1
嘉義縣,梅山鄉,0225,164,56,220,33,253,506,50%,32.41%,1
嘉義縣,梅山鄉,0226,231,40,271,33,304,433,70.21%,53.35%,1
嘉義縣,梅山鄉,0227,120,31,151,12,163,404,40.35%,29.7%,1
嘉義縣,梅山鄉,0228,96,32,128,17,145,293,49.49%,32.76%,1
嘉義縣,梅山鄉,0229,317,71,388,60,448,712,62.92%,44.52%,1
嘉義縣,梅山鄉,0230,255,80,335,38,373,602,61.96%,42.36%,1
嘉義縣,梅山鄉,0231,171,49,220,30,250,515,48.54%,33.2%,1
嘉義縣,梅山鄉,0232,116,33,149,15,164,417,39.33%,27.82%,1
嘉義縣,番路鄉,0450,478,158,636,71,707,1174,60.22%,40.72%,1
嘉義縣,番路鄉,0451,194,53,247,13,260,449,57.91%,43.21%,1
嘉義縣,番路鄉,0452,320,84,404,39,443,753,58.83%,42.5%,1
嘉義縣,番路鄉,0453,176,53,229,29,258,551,46.82%,31.94%,1
嘉義縣,番路鄉,0454,731,189,920,82,1002,1791,55.95%,40.82%,1
嘉義縣,番路鄉,0455,340,132,472,65,537,849,63.25%,40.05%,1
嘉義縣,番路鄉,0456,332,110,442,47,489,866,56.47%,38.34%,1
嘉義縣,番路鄉,0457,335,66,401,38,439,800,54.88%,41.88%,1
嘉義縣,番路鄉,0458,145,66,211,39,250,444,56.31%,32.66%,1
嘉義縣,番路鄉,0459,177,49,226,18,244,635,38.43%,27.87%,1
嘉義縣,番路鄉,0460,106,21,127,16,143,319,44.83%,33.23%,1
嘉義縣,番路鄉,0461,290,58,348,28,376,642,58.57%,45.17%,1
嘉義縣,番路鄉,0462,162,42,204,25,229,509,44.99%,31.83%,1
嘉義縣,番路鄉,0463,65,14,79,0,79,162,48.77%,40.12%,1
嘉義縣,番路鄉,0464,79,24,103,10,113,212,53.3%,37.26%,1
嘉義縣,大埔鄉,0465,559,164,723,79,802,1468,54.63%,38.08%,1
嘉義縣,大埔鄉,0466,85,20,105,6,111,320,34.69%,26.56%,1
嘉義縣,大埔鄉,0467,114,40,154,14,168,304,55.26%,37.5%,1
嘉義縣,大埔鄉,0468,65,26,91,2,93,184,50.54%,35.33%,1
嘉義縣,大埔鄉,0469,107,32,139,15,154,234,65.81%,45.73%,1
嘉義縣,大埔鄉,0470,179,46,225,10,235,495,47.47%,36.16%,1
嘉義縣,大埔鄉,0471,72,25,97,5,102,199,51.26%,36.18%,1
嘉義縣,大埔鄉,0472,63,26,89,12,101,226,44.69%,27.88%,1
嘉義縣,大埔鄉,0473,261,67,328,20,348,569,61.16%,45.87%,1
嘉義縣,阿里山鄉,0474,132,31,163,5,168,371,45.28%,35.58%,1
嘉義縣,阿里山鄉,0475,59,16,75,9,84,197,42.64%,29.95%,1
嘉義縣,阿里山鄉,0476,51,15,66,3,69,152,45.39%,33.55%,1
嘉義縣,阿里山鄉,0477,51,20,71,4,75,231,32.47%,22.08%,1
嘉義縣,阿里山鄉,0478,14,5,19,2,21,72,29.17%,19.44%,1
嘉義縣,阿里山鄉,0479,93,18,111,3,114,311,36.66%,29.9%,1
嘉義縣,阿里山鄉,0480,122,26,148,16,164,306,53.59%,39.87%,1
嘉義縣,阿里山鄉,0481,329,74,403,8,411,970,42.37%,33.92%,1
嘉義縣,阿里山鄉,0482,349,81,430,24,454,827,54.9%,42.2%,1
嘉義縣,阿里山鄉,0483,88,26,114,0,114,238,47.9%,36.97%,1
嘉義縣,阿里山鄉,0484,82,29,111,7,118,479,24.63%,17.12%,1
嘉義縣,阿里山鄉,0485,69,20,89,6,95,291,32.65%,23.71%,1
嘉義縣,阿里山鄉,0486,101,39,140,18,158,246,64.23%,41.06%,1
屏東縣,屏東市,0001,78,43,121,7,128,237,54.01%,32.91%,1
屏東縣,屏東市,0002,92,46,138,27,165,294,56.12%,31.29%,1
屏東縣,屏東市,0003,188,92,280,15,295,582,50.69%,32.3%,1
屏東縣,屏東市,0004,261,110,371,27,398,713,55.82%,36.61%,1
屏東縣,屏東市,0005,205,74,279,36,315,572,55.07%,35.84%,1
屏東縣,屏東市,0006,200,68,268,12,280,455,61.54%,43.96%,1
屏東縣,屏東市,0007,107,33,140,2,142,249,57.03%,42.97%,1
屏東縣,屏東市,0008,429,127,556,30,586,1315,44.56%,32.62%,1
屏東縣,屏東市,0009,405,168,573,46,619,1373,45.08%,29.5%,1
屏東縣,屏東市,0010,288,111,399,40,439,713,61.57%,40.39%,1
屏東縣,屏東市,0011,233,89,322,42,364,573,63.53%,40.66%,1
屏東縣,屏東市,0012,122,56,178,21,199,297,67%,41.08%,1
屏東縣,屏東市,0013,189,74,263,18,281,409,68.7%,46.21%,1
屏東縣,屏東市,0014,105,39,144,16,160,286,55.94%,36.71%,1
屏東縣,屏東市,0015,155,53,208,17,225,421,53.44%,36.82%,1
屏東縣,屏東市,0016,219,89,308,15,323,569,56.77%,38.49%,1
屏東縣,屏東市,0017,146,91,237,12,249,459,54.25%,31.81%,1
屏東縣,屏東市,0018,291,98,389,25,414,672,61.61%,43.3%,1
屏東縣,屏東市,0019,254,126,380,43,423,668,63.32%,38.02%,1
屏東縣,屏東市,0020,156,69,225,14,239,411,58.15%,37.96%,1
屏東縣,屏東市,0021,292,114,406,33,439,768,57.16%,38.02%,1
屏東縣,屏東市,0022,299,104,403,34,437,786,55.6%,38.04%,1
屏東縣,屏東市,0023,348,135,483,38,521,890,58.54%,39.1%,1
屏東縣,屏東市,0024,559,156,715,45,760,1353,56.17%,41.32%,1
屏東縣,屏東市,0025,523,163,686,27,713,1386,51.44%,37.73%,1
屏東縣,屏東市,0026,580,139,719,37,756,1413,53.5%,41.05%,1
屏東縣,屏東市,0027,516,136,652,35,687,1272,54.01%,40.57%,1
屏東縣,屏東市,0028,526,135,661,35,696,1287,54.08%,40.87%,1
屏東縣,屏東市,0029,549,162,711,46,757,1311,57.74%,41.88%,1
屏東縣,屏東市,0030,495,174,669,26,695,1285,54.09%,38.52%,1
屏東縣,屏東市,0031,521,157,678,53,731,1297,56.36%,40.17%,1
屏東縣,屏東市,0032,536,145,681,29,710,1361,52.17%,39.38%,1
屏東縣,屏東市,0033,525,144,669,42,711,1381,51.48%,38.02%,1
屏東縣,屏東市,0034,530,153,683,55,738,1258,58.66%,42.13%,1
屏東縣,屏東市,0035,484,167,651,58,709,1259,56.31%,38.44%,1
屏東縣,屏東市,0036,425,119,544,41,585,1076,54.37%,39.5%,1
屏東縣,屏東市,0037,484,147,631,33,664,1162,57.14%,41.65%,1
屏東縣,屏東市,0038,558,154,712,33,745,1318,56.53%,42.34%,1
屏東縣,屏東市,0039,386,60,446,38,484,939,51.54%,41.11%,1
屏東縣,屏東市,0040,417,114,531,30,561,972,57.72%,42.9%,1
屏東縣,屏東市,0041,652,178,830,30,860,1535,56.03%,42.48%,1
屏東縣,屏東市,0042,514,129,643,44,687,1419,48.41%,36.22%,1
屏東縣,屏東市,0043,503,145,648,22,670,1398,47.93%,35.98%,1
屏東縣,屏東市,0044,534,152,686,60,746,1405,53.1%,38.01%,1
屏東縣,屏東市,0045,602,77,679,31,710,1486,47.78%,40.51%,1
屏東縣,屏東市,0046,406,123,529,62,591,1061,55.7%,38.27%,1
屏東縣,屏東市,0047,472,161,633,107,740,1540,48.05%,30.65%,1
屏東縣,屏東市,0048,356,132,488,20,508,1141,44.52%,31.2%,1
屏東縣,屏東市,0049,455,119,574,36,610,1247,48.92%,36.49%,1
屏東縣,屏東市,0050,550,142,692,38,730,1446,50.48%,38.04%,1
屏東縣,屏東市,0051,558,145,703,40,743,1303,57.02%,42.82%,1
屏東縣,屏東市,0052,506,128,634,51,685,1253,54.67%,40.38%,1
屏東縣,屏東市,0053,517,145,662,50,712,1315,54.14%,39.32%,1
屏東縣,屏東市,0054,520,170,690,43,733,1425,51.44%,36.49%,1
屏東縣,屏東市,0055,521,152,673,33,706,1423,49.61%,36.61%,1
屏東縣,屏東市,0056,558,162,720,51,771,1400,55.07%,39.86%,1
屏東縣,屏東市,0057,548,191,739,45,784,1359,57.69%,40.32%,1
屏東縣,屏東市,0058,593,95,688,27,715,1328,53.84%,44.65%,1
屏東縣,屏東市,0059,649,116,765,43,808,1539,52.5%,42.17%,1
屏東縣,屏東市,0060,105,2,107,4,111,391,28.39%,26.85%,1
屏東縣,屏東市,0061,79,27,106,11,117,200,58.5%,39.5%,1
屏東縣,屏東市,0062,103,38,141,25,166,328,50.61%,31.4%,1
屏東縣,屏東市,0063,94,23,117,4,121,231,52.38%,40.69%,1
屏東縣,屏東市,0064,332,130,462,55,517,945,54.71%,35.13%,1
屏東縣,屏東市,0065,367,123,490,58,548,1053,52.04%,34.85%,1
屏東縣,屏東市,0066,356,117,473,53,526,1043,50.43%,34.13%,1
屏東縣,屏東市,0067,365,116,481,73,554,1061,52.21%,34.4%,1
屏東縣,屏東市,0068,289,124,413,41,454,876,51.83%,32.99%,1
屏東縣,屏東市,0069,481,177,658,111,769,1468,52.38%,32.77%,1
屏東縣,屏東市,0070,486,161,647,66,713,1454,49.04%,33.43%,1
屏東縣,屏東市,0071,453,150,603,23,626,1205,51.95%,37.59%,1
屏東縣,屏東市,0072,447,153,600,31,631,1284,49.14%,34.81%,1
屏東縣,屏東市,0073,450,130,580,35,615,1219,50.45%,36.92%,1
屏東縣,屏東市,0074,601,181,782,87,869,1544,56.28%,38.92%,1
屏東縣,屏東市,0075,536,184,720,87,807,1485,54.34%,36.09%,1
屏東縣,屏東市,0076,547,155,702,61,763,1387,55.01%,39.44%,1
屏東縣,屏東市,0077,358,88,446,35,481,953,50.47%,37.57%,1
屏東縣,屏東市,0078,605,222,827,52,879,1603,54.83%,37.74%,1
屏東縣,屏東市,0079,187,63,250,36,286,535,53.46%,34.95%,1
屏東縣,屏東市,0080,430,100,530,44,574,1119,51.3%,38.43%,1
屏東縣,屏東市,0081,333,101,434,38,472,847,55.73%,39.32%,1
屏東縣,屏東市,0082,346,125,471,73,544,923,58.94%,37.49%,1
屏東縣,屏東市,0083,441,127,568,41,609,1227,49.63%,35.94%,1
屏東縣,屏東市,0084,388,125,513,52,565,1039,54.38%,37.34%,1
屏東縣,屏東市,0085,507,182,689,97,786,1485,52.93%,34.14%,1
屏東縣,屏東市,0086,321,95,416,57,473,867,54.56%,37.02%,1
屏東縣,屏東市,0087,376,104,480,39,519,918,56.54%,40.96%,1
屏東縣,屏東市,0088,216,78,294,49,343,663,51.73%,32.58%,1
屏東縣,屏東市,0089,397,134,531,18,549,1215,45.19%,32.67%,1
屏東縣,屏東市,0090,520,192,712,85,797,1628,48.96%,31.94%,1
屏東縣,屏東市,0091,508,121,629,42,671,1209,55.5%,42.02%,1
屏東縣,屏東市,0092,550,123,673,23,696,1110,62.7%,49.55%,1
屏東縣,屏東市,0093,223,78,301,21,322,684,47.08%,32.6%,1
屏東縣,屏東市,0094,428,103,531,32,563,1349,41.73%,31.73%,1
屏東縣,屏東市,0095,623,37,660,57,717,1457,49.21%,42.76%,1
屏東縣,屏東市,0096,581,162,743,49,792,1447,54.73%,40.15%,1
屏東縣,屏東市,0097,473,157,630,28,658,1354,48.6%,34.93%,1
屏東縣,屏東市,0098,609,201,810,72,882,1583,55.72%,38.47%,1
屏東縣,屏東市,0099,675,155,830,25,855,1707,50.09%,39.54%,1
屏東縣,屏東市,0100,697,56,753,27,780,1637,47.65%,42.58%,1
屏東縣,屏東市,0101,547,138,685,11,696,1459,47.7%,37.49%,1
屏東縣,屏東市,0102,740,205,945,47,992,1759,56.4%,42.07%,1
屏東縣,屏東市,0103,808,160,968,33,1001,1950,51.33%,41.44%,1
屏東縣,屏東市,0104,791,79,870,50,920,1729,53.21%,45.75%,1
屏東縣,屏東市,0105,601,158,759,25,784,1592,49.25%,37.75%,1
屏東縣,屏東市,0106,549,135,684,38,722,1437,50.24%,38.2%,1
屏東縣,屏東市,0107,474,94,568,31,599,1204,49.75%,39.37%,1
屏東縣,屏東市,0108,557,139,696,38,734,1340,54.78%,41.57%,1
屏東縣,屏東市,0109,534,146,680,37,717,1322,54.24%,40.39%,1
屏東縣,屏東市,0110,565,127,692,39,731,1462,50%,38.65%,1
屏東縣,屏東市,0111,1259,261,1520,48,1568,3241,48.38%,38.85%,1
屏東縣,屏東市,0112,569,118,687,30,717,1477,48.54%,38.52%,1
屏東縣,屏東市,0113,293,72,365,24,389,821,47.38%,35.69%,1
屏東縣,屏東市,0114,318,108,426,21,447,1099,40.67%,28.94%,1
屏東縣,屏東市,0115,676,142,818,47,865,1688,51.24%,40.05%,1
屏東縣,屏東市,0116,408,130,538,45,583,1167,49.96%,34.96%,1
屏東縣,屏東市,0117,323,114,437,52,489,915,53.44%,35.3%,1
屏東縣,屏東市,0118,387,94,481,42,523,1683,31.08%,22.99%,1
屏東縣,屏東市,0119,568,142,710,21,731,1497,48.83%,37.94%,1
屏東縣,屏東市,0120,404,133,537,26,563,1129,49.87%,35.78%,1
屏東縣,屏東市,0121,509,120,629,39,668,1232,54.22%,41.31%,1
屏東縣,屏東市,0122,324,106,430,26,456,853,53.46%,37.98%,1
屏東縣,屏東市,0123,373,112,485,18,503,869,57.88%,42.92%,1
屏東縣,屏東市,0124,494,129,623,46,669,1169,57.23%,42.26%,1
屏東縣,屏東市,0125,444,115,559,26,585,1058,55.29%,41.97%,1
屏東縣,屏東市,0126,512,124,636,36,672,1344,50%,38.1%,1
屏東縣,屏東市,0127,577,136,713,25,738,1299,56.81%,44.42%,1
屏東縣,屏東市,0128,420,121,541,32,573,1204,47.59%,34.88%,1
屏東縣,屏東市,0129,426,123,549,33,582,1123,51.83%,37.93%,1
屏東縣,屏東市,0130,417,132,549,39,588,1318,44.61%,31.64%,1
屏東縣,屏東市,0131,334,120,454,60,514,865,59.42%,38.61%,1
屏東縣,屏東市,0132,350,100,450,27,477,1100,43.36%,31.82%,1
屏東縣,屏東市,0133,416,114,530,33,563,1215,46.34%,34.24%,1
屏東縣,屏東市,0134,555,128,683,42,725,1370,52.92%,40.51%,1
屏東縣,屏東市,0135,488,122,610,15,625,1240,50.4%,39.35%,1
屏東縣,屏東市,0136,479,143,622,45,667,1168,57.11%,41.01%,1
屏東縣,屏東市,0137,453,121,574,3,577,1079,53.48%,41.98%,1
屏東縣,屏東市,0138,541,148,689,49,738,1289,57.25%,41.97%,1
屏東縣,屏東市,0139,413,136,549,29,578,1115,51.84%,37.04%,1
屏東縣,屏東市,0140,585,204,789,47,836,1491,56.07%,39.24%,1
屏東縣,屏東市,0141,505,133,638,39,677,1411,47.98%,35.79%,1
屏東縣,屏東市,0142,675,185,860,33,893,1803,49.53%,37.44%,1
屏東縣,屏東市,0143,314,85,399,27,426,744,57.26%,42.2%,1
屏東縣,屏東市,0144,260,77,337,28,365,678,53.83%,38.35%,1
屏東縣,屏東市,0145,271,87,358,35,393,681,57.71%,39.79%,1
屏東縣,屏東市,0146,88,136,224,32,256,1535,16.68%,5.73%,1
屏東縣,屏東市,0147,355,121,476,77,553,954,57.97%,37.21%,1
屏東縣,屏東市,0148,448,121,569,35,604,1018,59.33%,44.01%,1
屏東縣,屏東市,0149,488,133,621,31,652,1154,56.5%,42.29%,1
屏東縣,潮州鎮,0150,203,65,268,37,305,504,60.52%,40.28%,1
屏東縣,潮州鎮,0151,559,187,746,56,802,1711,46.87%,32.67%,1
屏東縣,潮州鎮,0152,580,200,780,28,808,1634,49.45%,35.5%,1
屏東縣,潮州鎮,0153,483,136,619,29,648,1414,45.83%,34.16%,1
屏東縣,潮州鎮,0154,220,108,328,47,375,603,62.19%,36.48%,1
屏東縣,潮州鎮,0155,319,105,424,63,487,896,54.35%,35.6%,1
屏東縣,潮州鎮,0156,458,159,617,58,675,1285,52.53%,35.64%,1
屏東縣,潮州鎮,0157,658,154,812,70,882,1744,50.57%,37.73%,1
屏東縣,潮州鎮,0158,436,145,581,46,627,1071,58.54%,40.71%,1
屏東縣,潮州鎮,0159,439,204,643,66,709,1209,58.64%,36.31%,1
屏東縣,潮州鎮,0160,429,132,561,46,607,1159,52.37%,37.01%,1
屏東縣,潮州鎮,0161,408,145,553,54,607,1296,46.84%,31.48%,1
屏東縣,潮州鎮,0162,586,154,740,45,785,1466,53.55%,39.97%,1
屏東縣,潮州鎮,0163,447,144,591,54,645,1130,57.08%,39.56%,1
屏東縣,潮州鎮,0164,550,176,726,47,773,1439,53.72%,38.22%,1
屏東縣,潮州鎮,0165,380,89,469,53,522,897,58.19%,42.36%,1
屏東縣,潮州鎮,0166,508,128,636,49,685,1225,55.92%,41.47%,1
屏東縣,潮州鎮,0167,400,137,537,48,585,1158,50.52%,34.54%,1
屏東縣,潮州鎮,0168,121,56,177,39,216,481,44.91%,25.16%,1
屏東縣,潮州鎮,0169,422,71,493,53,546,972,56.17%,43.42%,1
屏東縣,潮州鎮,0170,513,169,682,50,732,1245,58.8%,41.2%,1
屏東縣,潮州鎮,0171,518,172,690,52,742,1415,52.44%,36.61%,1
屏東縣,潮州鎮,0172,408,111,519,17,536,1255,42.71%,32.51%,1
屏東縣,潮州鎮,0173,268,103,371,30,401,1058,37.9%,25.33%,1
屏東縣,潮州鎮,0174,450,125,575,35,610,1187,51.39%,37.91%,1
屏東縣,潮州鎮,0175,439,102,541,65,606,1083,55.96%,40.54%,1
屏東縣,潮州鎮,0176,559,147,706,40,746,1590,46.92%,35.16%,1
屏東縣,潮州鎮,0177,510,171,681,66,747,1543,48.41%,33.05%,1
屏東縣,潮州鎮,0178,577,185,762,46,808,1631,49.54%,35.38%,1
屏東縣,潮州鎮,0179,474,114,588,35,623,1159,53.75%,40.9%,1
屏東縣,潮州鎮,0180,433,143,576,41,617,1099,56.14%,39.4%,1
屏東縣,潮州鎮,0181,404,136,540,57,597,1200,49.75%,33.67%,1
屏東縣,潮州鎮,0182,502,137,639,65,704,1391,50.61%,36.09%,1
屏東縣,潮州鎮,0183,333,109,442,65,507,881,57.55%,37.8%,1
屏東縣,潮州鎮,0184,115,52,167,27,194,454,42.73%,25.33%,1
屏東縣,潮州鎮,0185,561,219,780,95,875,1658,52.77%,33.84%,1
屏東縣,潮州鎮,0186,262,87,349,36,385,822,46.84%,31.87%,1
屏東縣,潮州鎮,0187,264,105,369,20,389,948,41.03%,27.85%,1
屏東縣,潮州鎮,0188,334,110,444,32,476,1194,39.87%,27.97%,1
屏東縣,潮州鎮,0189,116,40,156,35,191,337,56.68%,34.42%,1
屏東縣,東港鎮,0190,450,80,530,66,596,981,60.75%,45.87%,1
屏東縣,東港鎮,0191,406,155,561,68,629,1070,58.79%,37.94%,1
屏東縣,東港鎮,0192,222,67,289,52,341,527,64.71%,42.13%,1
屏東縣,東港鎮,0193,144,64,208,29,237,395,60%,36.46%,1
屏東縣,東港鎮,0194,224,67,291,47,338,659,51.29%,33.99%,1
屏東縣,東港鎮,0195,177,72,249,26,275,513,53.61%,34.5%,1
屏東縣,東港鎮,0196,609,206,815,66,881,1732,50.87%,35.16%,1
屏東縣,東港鎮,0197,710,187,897,52,949,1779,53.34%,39.91%,1
屏東縣,東港鎮,0198,434,152,586,57,643,1270,50.63%,34.17%,1
屏東縣,東港鎮,0199,472,159,631,56,687,1327,51.77%,35.57%,1
屏東縣,東港鎮,0200,477,151,628,65,693,1242,55.8%,38.41%,1
屏東縣,東港鎮,0201,649,132,781,99,880,1607,54.76%,40.39%,1
屏東縣,東港鎮,0202,444,133,577,40,617,1305,47.28%,34.02%,1
屏東縣,東港鎮,0203,260,95,355,36,391,695,56.26%,37.41%,1
屏東縣,東港鎮,0204,412,157,569,91,660,1076,61.34%,38.29%,1
屏東縣,東港鎮,0205,182,70,252,36,288,567,50.79%,32.1%,1
屏東縣,東港鎮,0206,262,90,352,48,400,806,49.63%,32.51%,1
屏東縣,東港鎮,0207,452,154,606,77,683,1227,55.66%,36.84%,1
屏東縣,東港鎮,0208,187,72,259,62,321,599,53.59%,31.22%,1
屏東縣,東港鎮,0209,362,142,504,46,550,1354,40.62%,26.74%,1
屏東縣,東港鎮,0210,230,88,318,70,388,734,52.86%,31.34%,1
屏東縣,東港鎮,0211,361,148,509,126,635,1107,57.36%,32.61%,1
屏東縣,東港鎮,0212,380,119,499,93,592,1198,49.42%,31.72%,1
屏東縣,東港鎮,0213,503,181,684,137,821,1614,50.87%,31.16%,1
屏東縣,東港鎮,0214,289,84,373,47,420,826,50.85%,34.99%,1
屏東縣,東港鎮,0215,330,115,445,72,517,912,56.69%,36.18%,1
屏東縣,東港鎮,0216,117,56,173,52,225,432,52.08%,27.08%,1
屏東縣,東港鎮,0217,394,165,559,123,682,1204,56.64%,32.72%,1
屏東縣,東港鎮,0218,492,170,662,61,723,1304,55.44%,37.73%,1
屏東縣,東港鎮,0219,517,163,680,66,746,1317,56.64%,39.26%,1
屏東縣,東港鎮,0220,505,146,651,51,702,1387,50.61%,36.41%,1
屏東縣,東港鎮,0221,426,127,553,42,595,1310,45.42%,32.52%,1
屏東縣,東港鎮,0222,388,147,535,49,584,1228,47.56%,31.6%,1
屏東縣,東港鎮,0223,215,102,317,56,373,766,48.69%,28.07%,1
屏東縣,東港鎮,0224,280,123,403,67,470,823,57.11%,34.02%,1
屏東縣,東港鎮,0225,192,52,244,22,266,755,35.23%,25.43%,1
屏東縣,東港鎮,0226,389,149,538,84,622,1094,56.86%,35.56%,1
屏東縣,東港鎮,0227,265,77,342,27,369,753,49%,35.19%,1
屏東縣,恆春鎮,0228,309,95,404,33,437,902,48.45%,34.26%,1
屏東縣,恆春鎮,0229,394,121,515,38,553,969,57.07%,40.66%,1
屏東縣,恆春鎮,0230,485,94,579,46,625,1280,48.83%,37.89%,1
屏東縣,恆春鎮,0231,442,133,575,31,606,1133,53.49%,39.01%,1
屏東縣,恆春鎮,0232,482,118,600,18,618,1552,39.82%,31.06%,1
屏東縣,恆春鎮,0233,421,138,559,55,614,1485,41.35%,28.35%,1
屏東縣,恆春鎮,0234,311,134,445,36,481,896,53.68%,34.71%,1
屏東縣,恆春鎮,0235,154,65,219,26,245,531,46.14%,29%,1
屏東縣,恆春鎮,0236,141,55,196,14,210,478,43.93%,29.5%,1
屏東縣,恆春鎮,0237,322,127,449,40,489,1020,47.94%,31.57%,1
屏東縣,恆春鎮,0238,272,137,409,23,432,924,46.75%,29.44%,1
屏東縣,恆春鎮,0239,320,101,421,19,440,1079,40.78%,29.66%,1
屏東縣,恆春鎮,0240,186,66,252,25,277,775,35.74%,24%,1
屏東縣,恆春鎮,0241,299,85,384,48,432,813,53.14%,36.78%,1
屏東縣,恆春鎮,0242,364,104,468,51,519,1104,47.01%,32.97%,1
屏東縣,恆春鎮,0243,299,139,438,56,494,1110,44.5%,26.94%,1
屏東縣,恆春鎮,0244,162,73,235,62,297,692,42.92%,23.41%,1
屏東縣,恆春鎮,0245,173,57,230,7,237,708,33.47%,24.44%,1
屏東縣,恆春鎮,0246,511,161,672,35,707,1505,46.98%,33.95%,1
屏東縣,恆春鎮,0247,359,107,466,48,514,1111,46.26%,32.31%,1
屏東縣,恆春鎮,0248,525,132,657,42,699,1543,45.3%,34.02%,1
屏東縣,恆春鎮,0249,216,80,296,21,317,828,38.29%,26.09%,1
屏東縣,恆春鎮,0250,301,110,411,30,441,844,52.25%,35.66%,1
屏東縣,恆春鎮,0251,418,138,556,47,603,1253,48.12%,33.36%,1
屏東縣,恆春鎮,0252,372,98,470,43,513,1126,45.56%,33.04%,1
屏東縣,萬丹鄉,0253,407,129,536,59,595,1527,38.97%,26.65%,1
屏東縣,萬丹鄉,0254,390,103,493,71,564,1147,49.17%,34%,1
屏東縣,萬丹鄉,0255,292,106,398,47,445,949,46.89%,30.77%,1
屏東縣,萬丹鄉,0256,326,119,445,30,475,990,47.98%,32.93%,1
屏東縣,萬丹鄉,0257,311,92,403,14,417,1022,40.8%,30.43%,1
屏東縣,萬丹鄉,0258,229,80,309,58,367,545,67.34%,42.02%,1
屏東縣,萬丹鄉,0259,442,136,578,93,671,1159,57.89%,38.14%,1
屏東縣,萬丹鄉,0260,302,122,424,72,496,837,59.26%,36.08%,1
屏東縣,萬丹鄉,0261,134,48,182,15,197,392,50.26%,34.18%,1
屏東縣,萬丹鄉,0262,334,120,454,31,485,847,57.26%,39.43%,1
屏東縣,萬丹鄉,0263,403,130,533,47,580,1149,50.48%,35.07%,1
屏東縣,萬丹鄉,0264,438,117,555,51,606,1131,53.58%,38.73%,1
屏東縣,萬丹鄉,0265,409,148,557,50,607,1178,51.53%,34.72%,1
屏東縣,萬丹鄉,0266,289,98,387,39,426,711,59.92%,40.65%,1
屏東縣,萬丹鄉,0267,235,84,319,28,347,595,58.32%,39.5%,1
屏東縣,萬丹鄉,0268,573,162,735,64,799,1403,56.95%,40.84%,1
屏東縣,萬丹鄉,0269,400,99,499,34,533,1094,48.72%,36.56%,1
屏東縣,萬丹鄉,0270,445,142,587,45,632,1158,54.58%,38.43%,1
屏東縣,萬丹鄉,0271,362,185,547,53,600,963,62.31%,37.59%,1
屏東縣,萬丹鄉,0272,371,131,502,59,561,1062,52.82%,34.93%,1
屏東縣,萬丹鄉,0273,575,208,783,107,890,1684,52.85%,34.14%,1
屏東縣,萬丹鄉,0274,586,151,737,50,787,1702,46.24%,34.43%,1
屏東縣,萬丹鄉,0275,312,146,458,49,507,976,51.95%,31.97%,1
屏東縣,萬丹鄉,0276,354,138,492,64,556,1013,54.89%,34.95%,1
屏東縣,萬丹鄉,0277,223,116,339,41,380,847,44.86%,26.33%,1
屏東縣,萬丹鄉,0278,580,203,783,129,912,1570,58.09%,36.94%,1
屏東縣,萬丹鄉,0279,473,140,613,78,691,1411,48.97%,33.52%,1
屏東縣,萬丹鄉,0280,382,145,527,73,600,1046,57.36%,36.52%,1
屏東縣,萬丹鄉,0281,423,171,594,36,630,1385,45.49%,30.54%,1
屏東縣,萬丹鄉,0282,282,104,386,59,445,804,55.35%,35.07%,1
屏東縣,萬丹鄉,0283,440,172,612,79,691,1284,53.82%,34.27%,1
屏東縣,萬丹鄉,0284,585,58,643,58,701,1430,49.02%,40.91%,1
屏東縣,萬丹鄉,0285,400,129,529,68,597,960,62.19%,41.67%,1
屏東縣,萬丹鄉,0286,315,113,428,48,476,786,60.56%,40.08%,1
屏東縣,萬丹鄉,0287,383,175,558,91,649,1158,56.04%,33.07%,1
屏東縣,萬丹鄉,0288,493,152,645,64,709,1647,43.05%,29.93%,1
屏東縣,萬丹鄉,0289,532,155,687,83,770,1666,46.22%,31.93%,1
屏東縣,萬丹鄉,0290,392,150,542,80,622,1023,60.8%,38.32%,1
屏東縣,萬丹鄉,0291,496,152,648,65,713,1227,58.11%,40.42%,1
屏東縣,長治鄉,0292,375,128,503,68,571,1018,56.09%,36.84%,1
屏東縣,長治鄉,0293,598,197,795,83,878,1614,54.4%,37.05%,1
屏東縣,長治鄉,0294,742,217,959,88,1047,1848,56.66%,40.15%,1
屏東縣,長治鄉,0295,666,209,875,77,952,1707,55.77%,39.02%,1
屏東縣,長治鄉,0296,401,109,510,40,550,972,56.58%,41.26%,1
屏東縣,長治鄉,0297,383,122,505,63,568,989,57.43%,38.73%,1
屏東縣,長治鄉,0298,280,110,390,55,445,735,60.54%,38.1%,1
屏東縣,長治鄉,0299,611,220,831,62,893,1813,49.26%,33.7%,1
屏東縣,長治鄉,0300,446,149,595,53,648,1073,60.39%,41.57%,1
屏東縣,長治鄉,0301,697,98,795,78,873,1654,52.78%,42.14%,1
屏東縣,長治鄉,0302,434,174,608,73,681,1205,56.51%,36.02%,1
屏東縣,長治鄉,0303,279,106,385,46,431,758,56.86%,36.81%,1
屏東縣,長治鄉,0304,500,210,710,97,807,1492,54.09%,33.51%,1
屏東縣,長治鄉,0305,341,103,444,59,503,884,56.9%,38.57%,1
屏東縣,長治鄉,0306,423,129,552,70,622,1090,57.06%,38.81%,1
屏東縣,長治鄉,0307,307,268,575,108,683,1422,48.03%,21.59%,1
屏東縣,長治鄉,0308,286,111,397,64,461,845,54.56%,33.85%,1
屏東縣,長治鄉,0309,304,123,427,99,526,925,56.86%,32.86%,1
屏東縣,長治鄉,0310,401,115,516,98,614,1138,53.95%,35.24%,1
屏東縣,長治鄉,0311,428,149,577,113,690,1242,55.56%,34.46%,1
屏東縣,長治鄉,0312,332,99,431,22,453,1159,39.09%,28.65%,1
屏東縣,長治鄉,0313,261,104,365,37,402,673,59.73%,38.78%,1
屏東縣,麟洛鄉,0314,315,93,408,37,445,788,56.47%,39.97%,1
屏東縣,麟洛鄉,0315,592,170,762,28,790,1386,57%,42.71%,1
屏東縣,麟洛鄉,0316,405,119,524,53,577,957,60.29%,42.32%,1
屏東縣,麟洛鄉,0317,305,87,392,51,443,731,60.6%,41.72%,1
屏東縣,麟洛鄉,0318,341,104,445,59,504,806,62.53%,42.31%,1
屏東縣,麟洛鄉,0319,403,135,538,17,555,1207,45.98%,33.39%,1
屏東縣,麟洛鄉,0320,573,154,727,80,807,1340,60.22%,42.76%,1
屏東縣,麟洛鄉,0321,466,172,638,64,702,1221,57.49%,38.17%,1
屏東縣,麟洛鄉,0322,307,95,402,19,421,851,49.47%,36.08%,1
屏東縣,麟洛鄉,0323,231,79,310,15,325,683,47.58%,33.82%,1
屏東縣,九如鄉,0324,567,188,755,81,836,1491,56.07%,38.03%,1
屏東縣,九如鄉,0325,497,163,660,73,733,1375,53.31%,36.15%,1
屏東縣,九如鄉,0326,597,143,740,51,791,1678,47.14%,35.58%,1
屏東縣,九如鄉,0327,449,144,593,85,678,1166,58.15%,38.51%,1
屏東縣,九如鄉,0328,359,132,491,56,547,1276,42.87%,28.13%,1
屏東縣,九如鄉,0329,391,111,502,76,578,1033,55.95%,37.85%,1
屏東縣,九如鄉,0330,281,82,363,34,397,577,68.8%,48.7%,1
屏東縣,九如鄉,0331,240,91,331,67,398,649,61.33%,36.98%,1
屏東縣,九如鄉,0332,699,239,938,151,1089,1999,54.48%,34.97%,1
屏東縣,九如鄉,0333,639,189,828,92,920,1766,52.1%,36.18%,1
屏東縣,九如鄉,0334,507,199,706,118,824,1600,51.5%,31.69%,1
屏東縣,九如鄉,0335,435,154,589,91,680,1248,54.49%,34.86%,1
屏東縣,九如鄉,0336,595,243,838,199,1037,1792,57.87%,33.2%,1
屏東縣,九如鄉,0337,533,175,708,102,810,1482,54.66%,35.96%,1
屏東縣,里港鄉,0338,619,197,816,94,910,1552,58.63%,39.88%,1
屏東縣,里港鄉,0339,538,174,712,76,788,1480,53.24%,36.35%,1
屏東縣,里港鄉,0340,430,192,622,55,677,1534,44.13%,28.03%,1
屏東縣,里港鄉,0341,549,188,737,113,850,1578,53.87%,34.79%,1
屏東縣,里港鄉,0342,451,165,616,61,677,1127,60.07%,40.02%,1
屏東縣,里港鄉,0343,339,97,436,56,492,845,58.22%,40.12%,1
屏東縣,里港鄉,0344,450,151,601,64,665,1282,51.87%,35.1%,1
屏東縣,里港鄉,0345,388,123,511,56,567,981,57.8%,39.55%,1
屏東縣,里港鄉,0346,384,135,519,75,594,1031,57.61%,37.25%,1
屏東縣,里港鄉,0347,493,200,693,107,800,1423,56.22%,34.65%,1
屏東縣,里港鄉,0348,94,46,140,26,166,363,45.73%,25.9%,1
屏東縣,里港鄉,0349,400,166,566,131,697,1203,57.94%,33.25%,1
屏東縣,里港鄉,0350,401,161,562,72,634,1027,61.73%,39.05%,1
屏東縣,里港鄉,0351,430,155,585,61,646,1384,46.68%,31.07%,1
屏東縣,里港鄉,0352,526,159,685,92,777,1512,51.39%,34.79%,1
屏東縣,里港鄉,0353,241,47,288,20,308,522,59%,46.17%,1
屏東縣,里港鄉,0354,287,104,391,68,459,822,55.84%,34.91%,1
屏東縣,里港鄉,0355,296,137,433,97,530,1007,52.63%,29.39%,1
屏東縣,里港鄉,0356,317,152,469,68,537,956,56.17%,33.16%,1
屏東縣,里港鄉,0357,195,62,257,25,282,499,56.51%,39.08%,1
屏東縣,鹽埔鄉,0358,350,89,439,35,474,951,49.84%,36.8%,1
屏東縣,鹽埔鄉,0359,292,103,395,29,424,899,47.16%,32.48%,1
屏東縣,鹽埔鄉,0360,334,98,432,36,468,1116,41.94%,29.93%,1
屏東縣,鹽埔鄉,0361,441,132,573,48,621,1241,50.04%,35.54%,1
屏東縣,鹽埔鄉,0362,251,84,335,53,388,770,50.39%,32.6%,1
屏東縣,鹽埔鄉,0363,354,97,451,51,502,962,52.18%,36.8%,1
屏東縣,鹽埔鄉,0364,429,130,559,71,630,1041,60.52%,41.21%,1
屏東縣,鹽埔鄉,0365,458,177,635,73,708,1367,51.79%,33.5%,1
屏東縣,鹽埔鄉,0366,459,138,597,65,662,1465,45.19%,31.33%,1
屏東縣,鹽埔鄉,0367,252,111,363,54,417,894,46.64%,28.19%,1
屏東縣,鹽埔鄉,0368,290,104,394,4,398,958,41.54%,30.27%,1
屏東縣,鹽埔鄉,0369,303,98,401,90,491,924,53.14%,32.79%,1
屏東縣,鹽埔鄉,0370,498,143,641,44,685,1598,42.87%,31.16%,1
屏東縣,鹽埔鄉,0371,500,215,715,114,829,1550,53.48%,32.26%,1
屏東縣,鹽埔鄉,0372,406,122,528,73,601,1127,53.33%,36.02%,1
屏東縣,鹽埔鄉,0373,437,152,589,80,669,1150,58.17%,38%,1
屏東縣,鹽埔鄉,0374,453,157,610,65,675,1233,54.74%,36.74%,1
屏東縣,鹽埔鄉,0375,433,121,554,37,591,984,60.06%,44%,1
屏東縣,鹽埔鄉,0376,546,237,783,71,854,1619,52.75%,33.72%,1
屏東縣,鹽埔鄉,0377,196,76,272,33,305,553,55.15%,35.44%,1
屏東縣,高樹鄉,0378,331,126,457,88,545,883,61.72%,37.49%,1
屏東縣,高樹鄉,0379,311,117,428,29,457,1255,36.41%,24.78%,1
屏東縣,高樹鄉,0380,412,156,568,38,606,1278,47.42%,32.24%,1
屏東縣,高樹鄉,0381,217,72,289,28,317,738,42.95%,29.4%,1
屏東縣,高樹鄉,0382,167,68,235,14,249,585,42.56%,28.55%,1
屏東縣,高樹鄉,0383,330,124,454,134,588,1012,58.1%,32.61%,1
屏東縣,高樹鄉,0384,352,122,474,89,563,1148,49.04%,30.66%,1
屏東縣,高樹鄉,0385,173,82,255,40,295,591,49.92%,29.27%,1
屏東縣,高樹鄉,0386,221,74,295,58,353,786,44.91%,28.12%,1
屏東縣,高樹鄉,0387,181,59,240,24,264,649,40.68%,27.89%,1
屏東縣,高樹鄉,0388,303,120,423,78,501,1229,40.76%,24.65%,1
屏東縣,高樹鄉,0389,392,125,517,68,585,1446,40.46%,27.11%,1
屏東縣,高樹鄉,0390,218,107,325,15,340,899,37.82%,24.25%,1
屏東縣,高樹鄉,0391,294,116,410,62,472,922,51.19%,31.89%,1
屏東縣,高樹鄉,0392,379,135,514,73,587,1259,46.62%,30.1%,1
屏東縣,高樹鄉,0393,273,81,354,28,382,1056,36.17%,25.85%,1
屏東縣,高樹鄉,0394,384,143,527,74,601,1116,53.85%,34.41%,1
屏東縣,高樹鄉,0395,361,133,494,89,583,1020,57.16%,35.39%,1
屏東縣,高樹鄉,0396,341,140,481,92,573,1055,54.31%,32.32%,1
屏東縣,高樹鄉,0397,267,108,375,48,423,738,57.32%,36.18%,1
屏東縣,高樹鄉,0398,147,46,193,27,220,493,44.62%,29.82%,1
屏東縣,高樹鄉,0399,552,196,748,108,856,1539,55.62%,35.87%,1
屏東縣,萬巒鄉,0400,385,147,532,40,572,1239,46.17%,31.07%,1
屏東縣,萬巒鄉,0401,270,97,367,58,425,759,55.99%,35.57%,1
屏東縣,萬巒鄉,0402,342,112,454,93,547,932,58.69%,36.7%,1
屏東縣,萬巒鄉,0403,307,94,401,62,463,769,60.21%,39.92%,1
屏東縣,萬巒鄉,0404,313,116,429,73,502,920,54.57%,34.02%,1
屏東縣,萬巒鄉,0405,210,77,287,39,326,560,58.21%,37.5%,1
屏東縣,萬巒鄉,0406,359,111,470,29,499,1120,44.55%,32.05%,1
屏東縣,萬巒鄉,0407,350,103,453,31,484,1048,46.18%,33.4%,1
屏東縣,萬巒鄉,0408,437,133,570,47,617,1438,42.91%,30.39%,1
屏東縣,萬巒鄉,0409,244,109,353,63,416,834,49.88%,29.26%,1
屏東縣,萬巒鄉,0410,245,103,348,75,423,813,52.03%,30.14%,1
屏東縣,萬巒鄉,0411,285,99,384,47,431,1020,42.25%,27.94%,1
屏東縣,萬巒鄉,0412,362,135,497,80,577,1007,57.3%,35.95%,1
屏東縣,萬巒鄉,0413,466,168,634,95,729,1648,44.24%,28.28%,1
屏東縣,萬巒鄉,0414,487,167,654,67,721,1437,50.17%,33.89%,1
屏東縣,萬巒鄉,0415,355,122,477,22,499,1228,40.64%,28.91%,1
屏東縣,萬巒鄉,0416,248,59,307,53,360,597,60.3%,41.54%,1
屏東縣,萬巒鄉,0417,186,76,262,52,314,576,54.51%,32.29%,1
屏東縣,內埔鄉,0418,422,136,558,39,597,1305,45.75%,32.34%,1
屏東縣,內埔鄉,0419,414,121,535,38,573,1287,44.52%,32.17%,1
屏東縣,內埔鄉,0420,471,134,605,17,622,1387,44.84%,33.96%,1
屏東縣,內埔鄉,0421,515,142,657,53,710,1540,46.1%,33.44%,1
屏東縣,內埔鄉,0422,541,157,698,53,751,1605,46.79%,33.71%,1
屏東縣,內埔鄉,0423,457,141,598,56,654,1326,49.32%,34.46%,1
屏東縣,內埔鄉,0424,201,83,284,50,334,591,56.51%,34.01%,1
屏東縣,內埔鄉,0425,363,117,480,47,527,1123,46.93%,32.32%,1
屏東縣,內埔鄉,0426,372,115,487,21,508,1079,47.08%,34.48%,1
屏東縣,內埔鄉,0427,530,165,695,71,766,1485,51.58%,35.69%,1
屏東縣,內埔鄉,0428,534,121,655,44,699,1248,56.01%,42.79%,1
屏東縣,內埔鄉,0429,572,161,733,50,783,1569,49.9%,36.46%,1
屏東縣,內埔鄉,0430,485,164,649,61,710,1493,47.56%,32.48%,1
屏東縣,內埔鄉,0431,457,114,571,22,593,1420,41.76%,32.18%,1
屏東縣,內埔鄉,0432,472,137,609,83,692,1334,51.87%,35.38%,1
屏東縣,內埔鄉,0433,493,168,661,77,738,1519,48.58%,32.46%,1
屏東縣,內埔鄉,0434,281,86,367,54,421,784,53.7%,35.84%,1
屏東縣,內埔鄉,0435,325,107,432,69,501,888,56.42%,36.6%,1
屏東縣,內埔鄉,0436,187,56,243,15,258,747,34.54%,25.03%,1
屏東縣,內埔鄉,0437,310,114,424,29,453,1168,38.78%,26.54%,1
屏東縣,內埔鄉,0438,197,74,271,41,312,546,57.14%,36.08%,1
屏東縣,內埔鄉,0439,444,138,582,55,637,1278,49.84%,34.74%,1
屏東縣,內埔鄉,0440,383,143,526,50,576,1348,42.73%,28.41%,1
屏東縣,內埔鄉,0441,423,136,559,89,648,1550,41.81%,27.29%,1
屏東縣,內埔鄉,0442,364,128,492,82,574,947,60.61%,38.44%,1
屏東縣,內埔鄉,0443,354,134,488,77,565,1097,51.5%,32.27%,1
屏東縣,內埔鄉,0444,290,137,427,48,475,1128,42.11%,25.71%,1
屏東縣,內埔鄉,0445,283,98,381,24,405,1253,32.32%,22.59%,1
屏東縣,內埔鄉,0446,390,127,517,31,548,1525,35.93%,25.57%,1
屏東縣,內埔鄉,0447,407,143,550,87,637,1215,52.43%,33.5%,1
屏東縣,內埔鄉,0448,377,93,470,24,494,1216,40.63%,31%,1
屏東縣,內埔鄉,0449,437,112,549,34,583,1353,43.09%,32.3%,1
屏東縣,內埔鄉,0450,342,100,442,44,486,1026,47.37%,33.33%,1
屏東縣,內埔鄉,0451,267,79,346,30,376,862,43.62%,30.97%,1
屏東縣,內埔鄉,0452,228,103,331,25,356,921,38.65%,24.76%,1
屏東縣,內埔鄉,0453,285,93,378,24,402,854,47.07%,33.37%,1
屏東縣,內埔鄉,0454,362,109,471,44,515,1230,41.87%,29.43%,1
屏東縣,內埔鄉,0455,349,112,461,21,482,1204,40.03%,28.99%,1
屏東縣,內埔鄉,0456,387,105,492,40,532,1301,40.89%,29.75%,1
屏東縣,內埔鄉,0457,319,83,402,45,447,806,55.46%,39.58%,1
屏東縣,竹田鄉,0458,561,182,743,92,835,1503,55.56%,37.33%,1
屏東縣,竹田鄉,0459,391,119,510,44,554,899,61.62%,43.49%,1
屏東縣,竹田鄉,0460,298,105,403,47,450,716,62.85%,41.62%,1
屏東縣,竹田鄉,0461,232,104,336,46,382,581,65.75%,39.93%,1
屏東縣,竹田鄉,0462,462,168,630,110,740,1327,55.76%,34.82%,1
屏東縣,竹田鄉,0463,372,165,537,83,620,997,62.19%,37.31%,1
屏東縣,竹田鄉,0464,239,82,321,22,343,649,52.85%,36.83%,1
屏東縣,竹田鄉,0465,247,70,317,28,345,476,72.48%,51.89%,1
屏東縣,竹田鄉,0466,500,171,671,64,735,1259,58.38%,39.71%,1
屏東縣,竹田鄉,0467,433,140,573,68,641,1227,52.24%,35.29%,1
屏東縣,竹田鄉,0468,219,58,277,45,322,504,63.89%,43.45%,1
屏東縣,竹田鄉,0469,308,102,410,52,462,860,53.72%,35.81%,1
屏東縣,竹田鄉,0470,306,83,389,17,406,800,50.75%,38.25%,1
屏東縣,竹田鄉,0471,435,155,590,63,653,1134,57.58%,38.36%,1
屏東縣,竹田鄉,0472,437,175,612,65,677,1229,55.09%,35.56%,1
屏東縣,竹田鄉,0473,430,124,554,63,617,1192,51.76%,36.07%,1
屏東縣,新埤鄉,0474,568,158,726,50,776,1712,45.33%,33.18%,1
屏東縣,新埤鄉,0475,107,42,149,24,173,314,55.1%,34.08%,1
屏東縣,新埤鄉,0476,269,99,368,38,406,752,53.99%,35.77%,1
屏東縣,新埤鄉,0477,116,45,161,22,183,334,54.79%,34.73%,1
屏東縣,新埤鄉,0478,360,122,482,54,536,957,56.01%,37.62%,1
屏東縣,新埤鄉,0479,279,112,391,60,451,764,59.03%,36.52%,1
屏東縣,新埤鄉,0480,116,63,179,34,213,373,57.1%,31.1%,1
屏東縣,新埤鄉,0481,203,77,280,34,314,678,46.31%,29.94%,1
屏東縣,新埤鄉,0482,216,65,281,31,312,701,44.51%,30.81%,1
屏東縣,新埤鄉,0483,323,147,470,64,534,1323,40.36%,24.41%,1
屏東縣,新埤鄉,0484,188,74,262,47,309,541,57.12%,34.75%,1
屏東縣,新埤鄉,0485,177,54,231,32,263,584,45.03%,30.31%,1
屏東縣,枋寮鄉,0486,463,141,604,76,680,1213,56.06%,38.17%,1
屏東縣,枋寮鄉,0487,324,111,435,77,512,891,57.46%,36.36%,1
屏東縣,枋寮鄉,0488,292,118,410,87,497,970,51.24%,30.1%,1
屏東縣,枋寮鄉,0489,232,72,304,32,336,629,53.42%,36.88%,1
屏東縣,枋寮鄉,0490,313,115,428,48,476,840,56.67%,37.26%,1
屏東縣,枋寮鄉,0491,295,100,395,41,436,774,56.33%,38.11%,1
屏東縣,枋寮鄉,0492,454,179,633,83,716,1379,51.92%,32.92%,1
屏東縣,枋寮鄉,0493,567,172,739,76,815,1502,54.26%,37.75%,1
屏東縣,枋寮鄉,0494,418,150,568,88,656,1276,51.41%,32.76%,1
屏東縣,枋寮鄉,0495,327,113,440,71,511,964,53.01%,33.92%,1
屏東縣,枋寮鄉,0496,402,111,513,91,604,1005,60.1%,40%,1
屏東縣,枋寮鄉,0497,244,71,315,24,339,734,46.19%,33.24%,1
屏東縣,枋寮鄉,0498,273,70,343,65,408,725,56.28%,37.66%,1
屏東縣,枋寮鄉,0499,299,138,437,76,513,1046,49.04%,28.59%,1
屏東縣,枋寮鄉,0500,404,130,534,69,603,1067,56.51%,37.86%,1
屏東縣,枋寮鄉,0501,137,73,210,66,276,718,38.44%,19.08%,1
屏東縣,枋寮鄉,0502,269,106,375,50,425,903,47.07%,29.79%,1
屏東縣,枋寮鄉,0503,426,174,600,89,689,1387,49.68%,30.71%,1
屏東縣,枋寮鄉,0504,501,151,652,86,738,1367,53.99%,36.65%,1
屏東縣,枋寮鄉,0505,210,122,332,53,385,618,62.3%,33.98%,1
屏東縣,枋寮鄉,0506,260,90,350,36,386,959,40.25%,27.11%,1
屏東縣,枋寮鄉,0507,164,37,201,34,235,427,55.04%,38.41%,1
屏東縣,新園鄉,0508,307,115,422,50,472,820,57.56%,37.44%,1
屏東縣,新園鄉,0509,357,94,451,58,509,843,60.38%,42.35%,1
屏東縣,新園鄉,0510,454,131,585,58,643,1242,51.77%,36.55%,1
屏東縣,新園鄉,0511,508,167,675,66,741,1290,57.44%,39.38%,1
屏東縣,新園鄉,0512,390,123,513,51,564,1073,52.56%,36.35%,1
屏東縣,新園鄉,0513,277,171,448,110,558,1088,51.29%,25.46%,1
屏東縣,新園鄉,0514,283,97,380,38,418,845,49.47%,33.49%,1
屏東縣,新園鄉,0515,298,123,421,48,469,862,54.41%,34.57%,1
屏東縣,新園鄉,0516,371,144,515,74,589,1183,49.79%,31.36%,1
屏東縣,新園鄉,0517,374,147,521,90,611,1109,55.09%,33.72%,1
屏東縣,新園鄉,0518,354,114,468,13,481,1119,42.98%,31.64%,1
屏東縣,新園鄉,0519,385,139,524,42,566,1152,49.13%,33.42%,1
屏東縣,新園鄉,0520,380,139,519,54,573,1030,55.63%,36.89%,1
屏東縣,新園鄉,0521,367,124,491,96,587,1104,53.17%,33.24%,1
屏東縣,新園鄉,0522,376,131,507,0,507,1240,40.89%,30.32%,1
屏東縣,新園鄉,0523,284,106,390,29,419,1120,37.41%,25.36%,1
屏東縣,新園鄉,0524,412,142,554,70,624,1074,58.1%,38.36%,1
屏東縣,新園鄉,0525,265,88,353,44,397,849,46.76%,31.21%,1
屏東縣,新園鄉,0526,244,99,343,68,411,749,54.87%,32.58%,1
屏東縣,新園鄉,0527,457,165,622,94,716,1416,50.56%,32.27%,1
屏東縣,新園鄉,0528,312,96,408,72,480,895,53.63%,34.86%,1
屏東縣,新園鄉,0529,353,98,451,67,518,933,55.52%,37.83%,1
屏東縣,新園鄉,0530,338,116,454,57,511,972,52.57%,34.77%,1
屏東縣,新園鄉,0531,383,136,519,89,608,1454,41.82%,26.34%,1
屏東縣,新園鄉,0532,619,194,813,152,965,1653,58.38%,37.45%,1
屏東縣,新園鄉,0533,392,134,526,105,631,1270,49.69%,30.87%,1
屏東縣,新園鄉,0534,375,156,531,146,677,1123,60.28%,33.39%,1
屏東縣,新園鄉,0535,356,130,486,126,612,1198,51.09%,29.72%,1
屏東縣,崁頂鄉,0536,399,119,518,43,561,1190,47.14%,33.53%,1
屏東縣,崁頂鄉,0537,385,130,515,68,583,1044,55.84%,36.88%,1
屏東縣,崁頂鄉,0538,283,121,404,48,452,818,55.26%,34.6%,1
屏東縣,崁頂鄉,0539,431,139,570,53,623,1214,51.32%,35.5%,1
屏東縣,崁頂鄉,0540,429,134,563,40,603,1325,45.51%,32.38%,1
屏東縣,崁頂鄉,0541,484,149,633,66,699,1253,55.79%,38.63%,1
屏東縣,崁頂鄉,0542,367,107,474,54,528,1039,50.82%,35.32%,1
屏東縣,崁頂鄉,0543,248,93,341,44,385,813,47.36%,30.5%,1
屏東縣,崁頂鄉,0544,218,90,308,22,330,736,44.84%,29.62%,1
屏東縣,崁頂鄉,0545,355,128,483,42,525,934,56.21%,38.01%,1
屏東縣,崁頂鄉,0546,296,120,416,55,471,900,52.33%,32.89%,1
屏東縣,崁頂鄉,0547,369,106,475,53,528,1004,52.59%,36.75%,1
屏東縣,林邊鄉,0548,555,186,741,117,858,1458,58.85%,38.07%,1
屏東縣,林邊鄉,0549,350,119,469,50,519,891,58.25%,39.28%,1
屏東縣,林邊鄉,0550,303,75,378,38,416,695,59.86%,43.6%,1
屏東縣,林邊鄉,0551,372,153,525,78,603,1015,59.41%,36.65%,1
屏東縣,林邊鄉,0552,476,141,617,57,674,1171,57.56%,40.65%,1
屏東縣,林邊鄉,0553,347,114,461,64,525,1003,52.34%,34.6%,1
屏東縣,林邊鄉,0554,291,130,421,39,460,725,63.45%,40.14%,1
屏東縣,林邊鄉,0555,297,122,419,69,488,841,58.03%,35.32%,1
屏東縣,林邊鄉,0556,293,120,413,57,470,793,59.27%,36.95%,1
屏東縣,林邊鄉,0557,362,121,483,62,545,919,59.3%,39.39%,1
屏東縣,林邊鄉,0558,420,158,578,61,639,1283,49.81%,32.74%,1
屏東縣,林邊鄉,0559,217,102,319,52,371,783,47.38%,27.71%,1
屏東縣,林邊鄉,0560,308,103,411,53,464,1033,44.92%,29.82%,1
屏東縣,林邊鄉,0561,393,140,533,101,634,1186,53.46%,33.14%,1
屏東縣,林邊鄉,0562,255,94,349,71,420,773,54.33%,32.99%,1
屏東縣,林邊鄉,0563,356,116,472,38,510,1122,45.45%,31.73%,1
屏東縣,南州鄉,0564,300,89,389,48,437,872,50.11%,34.4%,1
屏東縣,南州鄉,0565,285,98,383,50,433,794,54.53%,35.89%,1
屏東縣,南州鄉,0566,369,136,505,51,556,962,57.8%,38.36%,1
屏東縣,南州鄉,0567,378,145,523,63,586,1033,56.73%,36.59%,1
屏東縣,南州鄉,0568,341,119,460,54,514,1007,51.04%,33.86%,1
屏東縣,南州鄉,0569,176,71,247,24,271,466,58.15%,37.77%,1
屏東縣,南州鄉,0570,303,77,380,36,416,708,58.76%,42.8%,1
屏東縣,南州鄉,0571,397,71,468,123,591,1044,56.61%,38.03%,1
屏東縣,南州鄉,0572,270,107,377,51,428,1071,39.96%,25.21%,1
屏東縣,南州鄉,0573,284,122,406,37,443,979,45.25%,29.01%,1
屏東縣,南州鄉,0574,184,55,239,34,273,543,50.28%,33.89%,1
屏東縣,佳冬鄉,0575,460,144,604,83,687,1472,46.67%,31.25%,1
屏東縣,佳冬鄉,0576,392,131,523,73,596,1360,43.82%,28.82%,1
屏東縣,佳冬鄉,0577,273,118,391,72,463,804,57.59%,33.96%,1
屏東縣,佳冬鄉,0578,287,123,410,76,486,925,52.54%,31.03%,1
屏東縣,佳冬鄉,0579,348,0,348,25,373,855,43.63%,40.7%,1
屏東縣,佳冬鄉,0580,331,94,425,57,482,981,49.13%,33.74%,1
屏東縣,佳冬鄉,0581,332,95,427,70,497,1007,49.35%,32.97%,1
屏東縣,佳冬鄉,0582,235,107,342,57,399,872,45.76%,26.95%,1
屏東縣,佳冬鄉,0583,362,134,496,49,545,1255,43.43%,28.84%,1
屏東縣,佳冬鄉,0584,414,101,515,101,616,995,61.91%,41.61%,1
屏東縣,佳冬鄉,0585,184,67,251,28,279,734,38.01%,25.07%,1
屏東縣,佳冬鄉,0586,343,100,443,39,482,1178,40.92%,29.12%,1
屏東縣,佳冬鄉,0587,325,123,448,53,501,1095,45.75%,29.68%,1
屏東縣,佳冬鄉,0588,384,139,523,118,641,1097,58.43%,35%,1
屏東縣,佳冬鄉,0589,549,34,583,80,663,1273,52.08%,43.13%,1
屏東縣,佳冬鄉,0590,423,163,586,69,655,1160,56.47%,36.47%,1
屏東縣,琉球鄉,0591,312,83,395,49,444,1111,39.96%,28.08%,1
屏東縣,琉球鄉,0592,287,84,371,56,427,972,43.93%,29.53%,1
屏東縣,琉球鄉,0593,439,130,569,80,649,1278,50.78%,34.35%,1
屏東縣,琉球鄉,0594,330,80,410,85,495,976,50.72%,33.81%,1
屏東縣,琉球鄉,0595,549,148,697,90,787,1658,47.47%,33.11%,1
屏東縣,琉球鄉,0596,300,84,384,56,440,1146,38.39%,26.18%,1
屏東縣,琉球鄉,0597,88,79,167,48,215,1079,19.93%,8.16%,1
屏東縣,琉球鄉,0598,328,87,415,31,446,1613,27.65%,20.33%,1
屏東縣,琉球鄉,0599,295,92,387,57,444,873,50.86%,33.79%,1
屏東縣,車城鄉,0600,183,79,262,47,309,737,41.93%,24.83%,1
屏東縣,車城鄉,0601,155,51,206,35,241,647,37.25%,23.96%,1
屏東縣,車城鄉,0602,146,46,192,24,216,491,43.99%,29.74%,1
屏東縣,車城鄉,0603,266,99,365,32,397,856,46.38%,31.07%,1
屏東縣,車城鄉,0604,155,59,214,9,223,554,40.25%,27.98%,1
屏東縣,車城鄉,0605,104,32,136,4,140,388,36.08%,26.8%,1
屏東縣,車城鄉,0606,229,87,316,47,363,922,39.37%,24.84%,1
屏東縣,車城鄉,0607,134,41,175,4,179,597,29.98%,22.45%,1
屏東縣,車城鄉,0608,122,44,166,13,179,623,28.73%,19.58%,1
屏東縣,車城鄉,0609,121,46,167,24,191,425,44.94%,28.47%,1
屏東縣,車城鄉,0610,146,47,193,22,215,428,50.23%,34.11%,1
屏東縣,車城鄉,0611,112,38,150,14,164,504,32.54%,22.22%,1
屏東縣,車城鄉,0612,124,59,183,22,205,423,48.46%,29.31%,1
屏東縣,滿州鄉,0613,478,176,654,48,702,1575,44.57%,30.35%,1
屏東縣,滿州鄉,0614,142,35,177,9,186,420,44.29%,33.81%,1
屏東縣,滿州鄉,0615,232,86,318,31,349,602,57.97%,38.54%,1
屏東縣,滿州鄉,0616,318,121,439,18,457,1302,35.1%,24.42%,1
屏東縣,滿州鄉,0617,500,58,558,50,608,1314,46.27%,38.05%,1
屏東縣,滿州鄉,0618,261,101,362,28,390,1308,29.82%,19.95%,1
屏東縣,滿州鄉,0619,78,46,124,12,136,367,37.06%,21.25%,1
屏東縣,滿州鄉,0620,116,27,143,23,166,318,52.2%,36.48%,1
屏東縣,枋山鄉,0621,260,79,339,26,365,604,60.43%,43.05%,1
屏東縣,枋山鄉,0622,168,58,226,32,258,428,60.28%,39.25%,1
屏東縣,枋山鄉,0623,382,119,501,77,578,928,62.28%,41.16%,1
屏東縣,枋山鄉,0624,314,118,432,27,459,972,47.22%,32.3%,1
屏東縣,枋山鄉,0625,282,103,385,66,451,1041,43.32%,27.09%,1
屏東縣,枋山鄉,0626,171,100,271,19,290,883,32.84%,19.37%,1
屏東縣,三地門鄉,0627,178,61,239,19,258,616,41.88%,28.9%,1
屏東縣,三地門鄉,0628,198,76,274,72,346,572,60.49%,34.62%,1
屏東縣,三地門鄉,0629,94,31,125,16,141,323,43.65%,29.1%,1
屏東縣,三地門鄉,0630,537,197,734,60,794,1448,54.83%,37.09%,1
屏東縣,三地門鄉,0631,172,44,216,3,219,726,30.17%,23.69%,1
屏東縣,三地門鄉,0632,188,72,260,26,286,554,51.62%,33.94%,1
屏東縣,三地門鄉,0633,103,60,163,17,180,346,52.02%,29.77%,1
屏東縣,三地門鄉,0634,104,50,154,2,156,458,34.06%,22.71%,1
屏東縣,三地門鄉,0635,260,83,343,15,358,692,51.73%,37.57%,1
屏東縣,三地門鄉,0636,280,102,382,66,448,638,70.22%,43.89%,1
屏東縣,霧臺鄉,0637,175,66,241,26,267,346,77.17%,50.58%,1
屏東縣,霧臺鄉,0638,252,75,327,13,340,677,50.22%,37.22%,1
屏東縣,霧臺鄉,0639,40,11,51,0,51,162,31.48%,24.69%,1
屏東縣,霧臺鄉,0640,66,18,84,5,89,189,47.09%,34.92%,1
屏東縣,霧臺鄉,0641,138,37,175,35,210,296,70.95%,46.62%,1
屏東縣,霧臺鄉,0642,180,78,258,10,268,483,55.49%,37.27%,1
屏東縣,霧臺鄉,0643,91,41,132,5,137,347,39.48%,26.22%,1
屏東縣,霧臺鄉,0644,135,55,190,18,208,450,46.22%,30%,1
屏東縣,瑪家鄉,0645,149,62,211,3,214,455,47.03%,32.75%,1
屏東縣,瑪家鄉,0646,331,163,494,46,540,821,65.77%,40.32%,1
屏東縣,瑪家鄉,0647,274,119,393,69,462,635,72.76%,43.15%,1
屏東縣,瑪家鄉,0648,373,110,483,33,516,695,74.24%,53.67%,1
屏東縣,瑪家鄉,0649,327,76,403,26,429,671,63.93%,48.73%,1
屏東縣,瑪家鄉,0650,310,107,417,12,429,1057,40.59%,29.33%,1
屏東縣,瑪家鄉,0651,351,98,449,36,485,900,53.89%,39%,1
屏東縣,瑪家鄉,0652,149,45,194,10,204,429,47.55%,34.73%,1
屏東縣,泰武鄉,0653,272,64,336,19,355,669,53.06%,40.66%,1
屏東縣,泰武鄉,0654,63,23,86,9,95,190,50%,33.16%,1
屏東縣,泰武鄉,0655,382,152,534,73,607,922,65.84%,41.43%,1
屏東縣,泰武鄉,0656,270,112,382,61,443,598,74.08%,45.15%,1
屏東縣,泰武鄉,0657,353,89,442,61,503,771,65.24%,45.78%,1
屏東縣,泰武鄉,0658,182,64,246,56,302,414,72.95%,43.96%,1
屏東縣,泰武鄉,0659,249,107,356,39,395,780,50.64%,31.92%,1
屏東縣,來義鄉,0660,383,86,469,120,589,917,64.23%,41.77%,1
屏東縣,來義鄉,0661,123,41,164,17,181,361,50.14%,34.07%,1
屏東縣,來義鄉,0662,58,15,73,1,74,216,34.26%,26.85%,1
屏東縣,來義鄉,0663,260,51,311,25,336,445,75.51%,58.43%,1
屏東縣,來義鄉,0664,124,31,155,27,182,280,65%,44.29%,1
屏東縣,來義鄉,0665,497,96,593,56,649,1097,59.16%,45.31%,1
屏東縣,來義鄉,0666,389,105,494,65,559,840,66.55%,46.31%,1
屏東縣,來義鄉,0667,303,97,400,19,419,889,47.13%,34.08%,1
屏東縣,來義鄉,0668,378,140,518,59,577,1212,47.61%,31.19%,1
屏東縣,春日鄉,0669,143,48,191,4,195,909,21.45%,15.73%,1
屏東縣,春日鄉,0670,123,60,183,15,198,663,29.86%,18.55%,1
屏東縣,春日鄉,0671,33,8,41,0,41,304,13.49%,10.86%,1
屏東縣,春日鄉,0672,226,83,309,18,327,928,35.24%,24.35%,1
屏東縣,春日鄉,0673,118,37,155,8,163,641,25.43%,18.41%,1
屏東縣,春日鄉,0674,76,25,101,3,104,478,21.76%,15.9%,1
屏東縣,獅子鄉,0675,299,35,334,20,354,751,47.14%,39.81%,1
屏東縣,獅子鄉,0676,246,80,326,28,354,776,45.62%,31.7%,1
屏東縣,獅子鄉,0677,201,60,261,11,272,711,38.26%,28.27%,1
屏東縣,獅子鄉,0678,112,43,155,28,183,243,75.31%,46.09%,1
屏東縣,獅子鄉,0679,114,50,164,14,178,325,54.77%,35.08%,1
屏東縣,獅子鄉,0680,99,30,129,5,134,476,28.15%,20.8%,1
屏東縣,獅子鄉,0681,178,50,228,9,237,602,39.37%,29.57%,1
屏東縣,獅子鄉,0682,97,19,116,6,122,346,35.26%,28.03%,1
屏東縣,牡丹鄉,0683,98,34,132,10,142,342,41.52%,28.65%,1
屏東縣,牡丹鄉,0684,493,116,609,54,663,1306,50.77%,37.75%,1
屏東縣,牡丹鄉,0685,134,31,165,3,168,693,24.24%,19.34%,1
屏東縣,牡丹鄉,0686,100,46,146,14,160,437,36.61%,22.88%,1
屏東縣,牡丹鄉,0687,136,47,183,11,194,392,49.49%,34.69%,1
屏東縣,牡丹鄉,0688,188,73,261,10,271,593,45.7%,31.7%,1
屏東縣,牡丹鄉,0689,102,23,125,6,131,551,23.77%,18.51%,1
宜蘭縣,宜蘭市,0001,376,117,493,23,516,982,52.55%,38.29%,1
宜蘭縣,宜蘭市,0002,510,140,650,48,698,1270,54.96%,40.16%,1
宜蘭縣,宜蘭市,0003,356,87,443,18,461,849,54.3%,41.93%,1
宜蘭縣,宜蘭市,0004,318,94,412,28,440,756,58.2%,42.06%,1
宜蘭縣,宜蘭市,0005,367,136,503,43,546,1107,49.32%,33.15%,1
宜蘭縣,宜蘭市,0006,364,88,452,44,496,893,55.54%,40.76%,1
宜蘭縣,宜蘭市,0007,374,96,470,33,503,912,55.15%,41.01%,1
宜蘭縣,宜蘭市,0008,539,155,694,57,751,1335,56.25%,40.37%,1
宜蘭縣,宜蘭市,0009,256,74,330,35,365,686,53.21%,37.32%,1
宜蘭縣,宜蘭市,0010,635,150,785,30,815,1366,59.66%,46.49%,1
宜蘭縣,宜蘭市,0011,586,155,741,35,776,1363,56.93%,42.99%,1
宜蘭縣,宜蘭市,0012,674,166,840,44,884,1540,57.4%,43.77%,1
宜蘭縣,宜蘭市,0013,563,140,703,24,727,1341,54.21%,41.98%,1
宜蘭縣,宜蘭市,0014,487,140,627,57,684,1209,56.58%,40.28%,1
宜蘭縣,宜蘭市,0015,351,116,467,40,507,900,56.33%,39%,1
宜蘭縣,宜蘭市,0016,369,105,474,40,514,980,52.45%,37.65%,1
宜蘭縣,宜蘭市,0017,473,142,615,27,642,1165,55.11%,40.6%,1
宜蘭縣,宜蘭市,0018,383,96,479,24,503,904,55.64%,42.37%,1
宜蘭縣,宜蘭市,0019,341,87,428,29,457,813,56.21%,41.94%,1
宜蘭縣,宜蘭市,0020,376,119,495,44,539,978,55.11%,38.45%,1
宜蘭縣,宜蘭市,0021,416,130,546,30,576,1282,44.93%,32.45%,1
宜蘭縣,宜蘭市,0022,187,74,261,13,274,465,58.92%,40.22%,1
宜蘭縣,宜蘭市,0023,251,91,342,51,393,669,58.74%,37.52%,1
宜蘭縣,宜蘭市,0024,392,96,488,39,527,923,57.1%,42.47%,1
宜蘭縣,宜蘭市,0025,383,108,491,37,528,1006,52.49%,38.07%,1
宜蘭縣,宜蘭市,0026,345,108,453,44,497,762,65.22%,45.28%,1
宜蘭縣,宜蘭市,0027,306,109,415,36,451,727,62.04%,42.09%,1
宜蘭縣,宜蘭市,0028,370,126,496,61,557,833,66.87%,44.42%,1
宜蘭縣,宜蘭市,0029,469,133,602,42,644,1143,56.34%,41.03%,1
宜蘭縣,宜蘭市,0030,400,112,512,21,533,979,54.44%,40.86%,1
宜蘭縣,宜蘭市,0031,482,125,607,54,661,1214,54.45%,39.7%,1
宜蘭縣,宜蘭市,0032,488,165,653,67,720,1283,56.12%,38.04%,1
宜蘭縣,宜蘭市,0033,402,109,511,37,548,946,57.93%,42.49%,1
宜蘭縣,宜蘭市,0034,459,93,552,34,586,1090,53.76%,42.11%,1
宜蘭縣,宜蘭市,0035,398,115,513,18,531,943,56.31%,42.21%,1
宜蘭縣,宜蘭市,0036,333,119,452,40,492,774,63.57%,43.02%,1
宜蘭縣,宜蘭市,0037,440,118,558,33,591,968,61.05%,45.45%,1
宜蘭縣,宜蘭市,0038,424,121,545,27,572,926,61.77%,45.79%,1
宜蘭縣,宜蘭市,0039,433,129,562,50,612,1019,60.06%,42.49%,1
宜蘭縣,宜蘭市,0040,438,123,561,51,612,1084,56.46%,40.41%,1
宜蘭縣,宜蘭市,0041,449,111,560,33,593,1095,54.16%,41%,1
宜蘭縣,宜蘭市,0042,483,116,599,23,622,1083,57.43%,44.6%,1
宜蘭縣,宜蘭市,0043,450,104,554,37,591,1108,53.34%,40.61%,1
宜蘭縣,宜蘭市,0044,363,110,473,21,494,848,58.25%,42.81%,1
宜蘭縣,宜蘭市,0045,454,111,565,38,603,1095,55.07%,41.46%,1
宜蘭縣,宜蘭市,0046,481,118,599,26,625,1110,56.31%,43.33%,1
宜蘭縣,宜蘭市,0047,478,110,588,56,644,1104,58.33%,43.3%,1
宜蘭縣,宜蘭市,0048,475,126,601,39,640,1134,56.44%,41.89%,1
宜蘭縣,宜蘭市,0049,478,138,616,43,659,1146,57.5%,41.71%,1
宜蘭縣,宜蘭市,0050,378,99,477,51,528,876,60.27%,43.15%,1
宜蘭縣,宜蘭市,0051,378,74,452,54,506,905,55.91%,41.77%,1
宜蘭縣,宜蘭市,0052,381,104,485,49,534,910,58.68%,41.87%,1
宜蘭縣,宜蘭市,0053,489,151,640,32,672,1434,46.86%,34.1%,1
宜蘭縣,宜蘭市,0054,419,151,570,67,637,1152,55.3%,36.37%,1
宜蘭縣,宜蘭市,0055,393,145,538,37,575,966,59.52%,40.68%,1
宜蘭縣,宜蘭市,0056,279,94,373,41,414,711,58.23%,39.24%,1
宜蘭縣,宜蘭市,0057,378,112,490,44,534,884,60.41%,42.76%,1
宜蘭縣,宜蘭市,0058,538,172,710,56,766,1326,57.77%,40.57%,1
宜蘭縣,宜蘭市,0059,326,111,437,27,464,909,51.05%,35.86%,1
宜蘭縣,宜蘭市,0060,350,101,451,39,490,894,54.81%,39.15%,1
宜蘭縣,宜蘭市,0061,487,113,600,35,635,1259,50.44%,38.68%,1
宜蘭縣,宜蘭市,0062,308,81,389,30,419,789,53.11%,39.04%,1
宜蘭縣,宜蘭市,0063,355,88,443,31,474,867,54.67%,40.95%,1
宜蘭縣,宜蘭市,0064,548,172,720,87,807,1454,55.5%,37.69%,1
宜蘭縣,宜蘭市,0065,575,71,646,47,693,1130,61.33%,50.88%,1
宜蘭縣,宜蘭市,0066,399,91,490,18,508,1087,46.73%,36.71%,1
宜蘭縣,宜蘭市,0067,401,119,520,57,577,938,61.51%,42.75%,1
宜蘭縣,宜蘭市,0068,500,145,645,67,712,1285,55.41%,38.91%,1
宜蘭縣,宜蘭市,0069,335,118,453,27,480,952,50.42%,35.19%,1
宜蘭縣,宜蘭市,0070,360,148,508,63,571,948,60.23%,37.97%,1
宜蘭縣,宜蘭市,0071,429,127,556,49,605,1160,52.16%,36.98%,1
宜蘭縣,宜蘭市,0072,432,95,527,74,601,1015,59.21%,42.56%,1
宜蘭縣,宜蘭市,0073,190,54,244,17,261,424,61.56%,44.81%,1
宜蘭縣,宜蘭市,0074,389,124,513,49,562,964,58.3%,40.35%,1
宜蘭縣,宜蘭市,0075,333,124,457,58,515,959,53.7%,34.72%,1
宜蘭縣,宜蘭市,0076,354,109,463,46,509,814,62.53%,43.49%,1
宜蘭縣,宜蘭市,0077,351,127,478,50,528,885,59.66%,39.66%,1
宜蘭縣,宜蘭市,0078,443,174,617,58,675,1162,58.09%,38.12%,1
宜蘭縣,羅東鎮,0079,280,95,375,32,407,689,59.07%,40.64%,1
宜蘭縣,羅東鎮,0080,281,88,369,29,398,718,55.43%,39.14%,1
宜蘭縣,羅東鎮,0081,543,214,757,66,823,1475,55.8%,36.81%,1
宜蘭縣,羅東鎮,0082,552,178,730,65,795,1466,54.23%,37.65%,1
宜蘭縣,羅東鎮,0083,436,131,567,36,603,1075,56.09%,40.56%,1
宜蘭縣,羅東鎮,0084,366,108,474,62,536,963,55.66%,38.01%,1
宜蘭縣,羅東鎮,0085,573,148,721,92,813,1511,53.81%,37.92%,1
宜蘭縣,羅東鎮,0086,446,144,590,36,626,1166,53.69%,38.25%,1
宜蘭縣,羅東鎮,0087,506,163,669,62,731,1273,57.42%,39.75%,1
宜蘭縣,羅東鎮,0088,688,183,871,44,915,1735,52.74%,39.65%,1
宜蘭縣,羅東鎮,0089,608,175,783,57,840,1487,56.49%,40.89%,1
宜蘭縣,羅東鎮,0090,372,103,475,27,502,837,59.98%,44.44%,1
宜蘭縣,羅東鎮,0091,549,170,719,66,785,1312,59.83%,41.84%,1
宜蘭縣,羅東鎮,0092,580,166,746,55,801,1502,53.33%,38.62%,1
宜蘭縣,羅東鎮,0093,431,128,559,23,582,1138,51.14%,37.87%,1
宜蘭縣,羅東鎮,0094,372,140,512,50,562,1010,55.64%,36.83%,1
宜蘭縣,羅東鎮,0095,498,202,700,90,790,1373,57.54%,36.27%,1
宜蘭縣,羅東鎮,0096,441,135,576,36,612,1089,56.2%,40.5%,1
宜蘭縣,羅東鎮,0097,515,146,661,46,707,1304,54.22%,39.49%,1
宜蘭縣,羅東鎮,0098,462,160,622,67,689,1288,53.49%,35.87%,1
宜蘭縣,羅東鎮,0099,448,137,585,57,642,1036,61.97%,43.24%,1
宜蘭縣,羅東鎮,0100,457,117,574,39,613,969,63.26%,47.16%,1
宜蘭縣,羅東鎮,0101,439,113,552,40,592,985,60.1%,44.57%,1
宜蘭縣,羅東鎮,0102,557,212,769,70,839,1420,59.08%,39.23%,1
宜蘭縣,羅東鎮,0103,622,152,774,46,820,1430,57.34%,43.5%,1
宜蘭縣,羅東鎮,0104,453,131,584,47,631,1075,58.7%,42.14%,1
宜蘭縣,羅東鎮,0105,374,111,485,36,521,879,59.27%,42.55%,1
宜蘭縣,羅東鎮,0106,340,104,444,25,469,850,55.18%,40%,1
宜蘭縣,羅東鎮,0107,498,134,632,30,662,1111,59.59%,44.82%,1
宜蘭縣,羅東鎮,0108,524,144,668,41,709,1139,62.25%,46.01%,1
宜蘭縣,羅東鎮,0109,528,132,660,34,694,1130,61.42%,46.73%,1
宜蘭縣,羅東鎮,0110,396,139,535,44,579,980,59.08%,40.41%,1
宜蘭縣,羅東鎮,0111,587,164,751,54,805,1431,56.25%,41.02%,1
宜蘭縣,羅東鎮,0112,464,128,592,40,632,1109,56.99%,41.84%,1
宜蘭縣,羅東鎮,0113,462,116,578,32,610,1083,56.33%,42.66%,1
宜蘭縣,羅東鎮,0114,591,165,756,54,810,1404,57.69%,42.09%,1
宜蘭縣,羅東鎮,0115,509,180,689,50,739,1288,57.38%,39.52%,1
宜蘭縣,羅東鎮,0116,357,143,500,46,546,1183,46.15%,30.18%,1
宜蘭縣,羅東鎮,0117,481,140,621,40,661,1105,59.82%,43.53%,1
宜蘭縣,羅東鎮,0118,423,141,564,37,601,987,60.89%,42.86%,1
宜蘭縣,羅東鎮,0119,344,88,432,41,473,773,61.19%,44.5%,1
宜蘭縣,羅東鎮,0120,664,160,824,41,865,1366,63.32%,48.61%,1
宜蘭縣,羅東鎮,0121,434,123,557,27,584,907,64.39%,47.85%,1
宜蘭縣,羅東鎮,0122,546,128,674,43,717,1158,61.92%,47.15%,1
宜蘭縣,羅東鎮,0123,382,128,510,52,562,977,57.52%,39.1%,1
宜蘭縣,羅東鎮,0124,354,124,478,52,530,972,54.53%,36.42%,1
宜蘭縣,羅東鎮,0125,405,136,541,35,576,977,58.96%,41.45%,1
宜蘭縣,羅東鎮,0126,576,191,767,55,822,1398,58.8%,41.2%,1
宜蘭縣,羅東鎮,0127,410,137,547,28,575,1022,56.26%,40.12%,1
宜蘭縣,羅東鎮,0128,509,135,644,47,691,1131,61.1%,45%,1
宜蘭縣,蘇澳鎮,0129,458,142,600,72,672,1194,56.28%,38.36%,1
宜蘭縣,蘇澳鎮,0130,402,141,543,44,587,1128,52.04%,35.64%,1
宜蘭縣,蘇澳鎮,0131,453,136,589,54,643,1042,61.71%,43.47%,1
宜蘭縣,蘇澳鎮,0132,429,115,544,39,583,997,58.48%,43.03%,1
宜蘭縣,蘇澳鎮,0133,506,169,675,63,738,1303,56.64%,38.83%,1
宜蘭縣,蘇澳鎮,0134,508,164,672,74,746,1260,59.21%,40.32%,1
宜蘭縣,蘇澳鎮,0135,419,132,551,78,629,1130,55.66%,37.08%,1
宜蘭縣,蘇澳鎮,0136,210,57,267,48,315,559,56.35%,37.57%,1
宜蘭縣,蘇澳鎮,0137,109,39,148,32,180,351,51.28%,31.05%,1
宜蘭縣,蘇澳鎮,0138,323,108,431,57,488,889,54.89%,36.33%,1
宜蘭縣,蘇澳鎮,0139,156,55,211,23,234,434,53.92%,35.94%,1
宜蘭縣,蘇澳鎮,0140,357,114,471,31,502,835,60.12%,42.75%,1
宜蘭縣,蘇澳鎮,0141,384,122,506,47,553,975,56.72%,39.38%,1
宜蘭縣,蘇澳鎮,0142,446,153,599,74,673,1135,59.3%,39.3%,1
宜蘭縣,蘇澳鎮,0143,357,119,476,35,511,788,64.85%,45.3%,1
宜蘭縣,蘇澳鎮,0144,150,67,217,31,248,469,52.88%,31.98%,1
宜蘭縣,蘇澳鎮,0145,304,94,398,33,431,811,53.14%,37.48%,1
宜蘭縣,蘇澳鎮,0146,362,77,439,21,460,867,53.06%,41.75%,1
宜蘭縣,蘇澳鎮,0147,446,137,583,57,640,1139,56.19%,39.16%,1
宜蘭縣,蘇澳鎮,0148,439,124,563,36,599,1146,52.27%,38.31%,1
宜蘭縣,蘇澳鎮,0149,463,125,588,65,653,1154,56.59%,40.12%,1
宜蘭縣,蘇澳鎮,0150,307,105,412,30,442,908,48.68%,33.81%,1
宜蘭縣,蘇澳鎮,0151,273,69,342,22,364,656,55.49%,41.62%,1
宜蘭縣,蘇澳鎮,0152,365,95,460,58,518,834,62.11%,43.76%,1
宜蘭縣,蘇澳鎮,0153,417,142,559,46,605,1025,59.02%,40.68%,1
宜蘭縣,蘇澳鎮,0154,163,81,244,20,264,455,58.02%,35.82%,1
宜蘭縣,蘇澳鎮,0155,223,65,288,25,313,535,58.5%,41.68%,1
宜蘭縣,蘇澳鎮,0156,226,76,302,36,338,536,63.06%,42.16%,1
宜蘭縣,蘇澳鎮,0157,181,70,251,23,274,451,60.75%,40.13%,1
宜蘭縣,蘇澳鎮,0158,205,82,287,43,330,593,55.65%,34.57%,1
宜蘭縣,蘇澳鎮,0159,172,47,219,28,247,441,56.01%,39%,1
宜蘭縣,蘇澳鎮,0160,384,109,493,55,548,954,57.44%,40.25%,1
宜蘭縣,蘇澳鎮,0161,338,113,451,67,518,952,54.41%,35.5%,1
宜蘭縣,蘇澳鎮,0162,363,149,512,75,587,1125,52.18%,32.27%,1
宜蘭縣,蘇澳鎮,0163,283,73,356,72,428,763,56.09%,37.09%,1
宜蘭縣,蘇澳鎮,0164,200,70,270,41,311,706,44.05%,28.33%,1
宜蘭縣,蘇澳鎮,0165,327,114,441,74,515,1068,48.22%,30.62%,1
宜蘭縣,蘇澳鎮,0166,234,90,324,64,388,666,58.26%,35.14%,1
宜蘭縣,蘇澳鎮,0167,178,69,247,78,325,574,56.62%,31.01%,1
宜蘭縣,蘇澳鎮,0168,97,28,125,9,134,351,38.18%,27.64%,1
宜蘭縣,蘇澳鎮,0169,260,86,346,59,405,717,56.49%,36.26%,1
宜蘭縣,蘇澳鎮,0170,117,19,136,18,154,373,41.29%,31.37%,1
宜蘭縣,蘇澳鎮,0171,53,23,76,14,90,223,40.36%,23.77%,1
宜蘭縣,頭城鎮,0172,62,31,93,11,104,292,35.62%,21.23%,1
宜蘭縣,頭城鎮,0173,239,84,323,45,368,688,53.49%,34.74%,1
宜蘭縣,頭城鎮,0174,280,78,358,38,396,688,57.56%,40.7%,1
宜蘭縣,頭城鎮,0175,279,109,388,56,444,879,50.51%,31.74%,1
宜蘭縣,頭城鎮,0176,126,51,177,27,204,335,60.9%,37.61%,1
宜蘭縣,頭城鎮,0177,235,117,352,41,393,624,62.98%,37.66%,1
宜蘭縣,頭城鎮,0178,212,84,296,47,343,732,46.86%,28.96%,1
宜蘭縣,頭城鎮,0179,280,92,372,47,419,892,46.97%,31.39%,1
宜蘭縣,頭城鎮,0180,211,74,285,28,313,690,45.36%,30.58%,1
宜蘭縣,頭城鎮,0181,311,98,409,43,452,842,53.68%,36.94%,1
宜蘭縣,頭城鎮,0182,272,99,371,39,410,736,55.71%,36.96%,1
宜蘭縣,頭城鎮,0183,281,81,362,32,394,788,50%,35.66%,1
宜蘭縣,頭城鎮,0184,177,79,256,30,286,560,51.07%,31.61%,1
宜蘭縣,頭城鎮,0185,302,90,392,31,423,712,59.41%,42.42%,1
宜蘭縣,頭城鎮,0186,229,58,287,34,321,502,63.94%,45.62%,1
宜蘭縣,頭城鎮,0187,253,71,324,35,359,569,63.09%,44.46%,1
宜蘭縣,頭城鎮,0188,258,70,328,33,361,633,57.03%,40.76%,1
宜蘭縣,頭城鎮,0189,328,127,455,73,528,1132,46.64%,28.98%,1
宜蘭縣,頭城鎮,0190,345,108,453,42,495,1035,47.83%,33.33%,1
宜蘭縣,頭城鎮,0191,342,124,466,37,503,847,59.39%,40.38%,1
宜蘭縣,頭城鎮,0192,462,144,606,52,658,1172,56.14%,39.42%,1
宜蘭縣,頭城鎮,0193,348,95,443,22,465,896,51.9%,38.84%,1
宜蘭縣,頭城鎮,0194,481,116,597,28,625,1075,58.14%,44.74%,1
宜蘭縣,頭城鎮,0195,356,126,482,66,548,931,58.86%,38.24%,1
宜蘭縣,頭城鎮,0196,403,106,509,53,562,1021,55.04%,39.47%,1
宜蘭縣,頭城鎮,0197,222,74,296,51,347,709,48.94%,31.31%,1
宜蘭縣,頭城鎮,0198,310,92,402,40,442,689,64.15%,44.99%,1
宜蘭縣,頭城鎮,0199,265,73,338,46,384,615,62.44%,43.09%,1
宜蘭縣,頭城鎮,0200,284,81,365,50,415,759,54.68%,37.42%,1
宜蘭縣,頭城鎮,0201,376,113,489,73,562,917,61.29%,41%,1
宜蘭縣,頭城鎮,0202,409,128,537,63,600,1045,57.42%,39.14%,1
宜蘭縣,頭城鎮,0203,441,127,568,68,636,1130,56.28%,39.03%,1
宜蘭縣,礁溪鄉,0204,397,95,492,38,530,1122,47.24%,35.38%,1
宜蘭縣,礁溪鄉,0205,178,60,238,28,266,505,52.67%,35.25%,1
宜蘭縣,礁溪鄉,0206,356,111,467,42,509,988,51.52%,36.03%,1
宜蘭縣,礁溪鄉,0207,346,127,473,40,513,971,52.83%,35.63%,1
宜蘭縣,礁溪鄉,0208,434,126,560,56,616,1246,49.44%,34.83%,1
宜蘭縣,礁溪鄉,0209,560,179,739,45,784,1655,47.37%,33.84%,1
宜蘭縣,礁溪鄉,0210,349,128,477,35,512,1132,45.23%,30.83%,1
宜蘭縣,礁溪鄉,0211,317,88,405,30,435,783,55.56%,40.49%,1
宜蘭縣,礁溪鄉,0212,348,112,460,38,498,928,53.66%,37.5%,1
宜蘭縣,礁溪鄉,0213,331,80,411,42,453,848,53.42%,39.03%,1
宜蘭縣,礁溪鄉,0214,291,91,382,35,417,663,62.9%,43.89%,1
宜蘭縣,礁溪鄉,0215,236,74,310,27,337,608,55.43%,38.82%,1
宜蘭縣,礁溪鄉,0216,327,98,425,39,464,833,55.7%,39.26%,1
宜蘭縣,礁溪鄉,0217,421,113,534,23,557,1233,45.17%,34.14%,1
宜蘭縣,礁溪鄉,0218,310,112,422,57,479,854,56.09%,36.3%,1
宜蘭縣,礁溪鄉,0219,185,75,260,28,288,575,50.09%,32.17%,1
宜蘭縣,礁溪鄉,0220,311,112,423,43,466,835,55.81%,37.25%,1
宜蘭縣,礁溪鄉,0221,523,164,687,57,744,1305,57.01%,40.08%,1
宜蘭縣,礁溪鄉,0222,321,104,425,35,460,830,55.42%,38.67%,1
宜蘭縣,礁溪鄉,0223,254,129,383,45,428,649,65.95%,39.14%,1
宜蘭縣,礁溪鄉,0224,336,107,443,49,492,923,53.3%,36.4%,1
宜蘭縣,礁溪鄉,0225,381,102,483,49,532,1177,45.2%,32.37%,1
宜蘭縣,礁溪鄉,0226,310,106,416,44,460,840,54.76%,36.9%,1
宜蘭縣,礁溪鄉,0227,414,122,536,35,571,1051,54.33%,39.39%,1
宜蘭縣,礁溪鄉,0228,457,148,605,54,659,1339,49.22%,34.13%,1
宜蘭縣,礁溪鄉,0229,522,127,649,53,702,1194,58.79%,43.72%,1
宜蘭縣,礁溪鄉,0230,517,164,681,91,772,1314,58.75%,39.35%,1
宜蘭縣,礁溪鄉,0231,435,137,572,23,595,1125,52.89%,38.67%,1
宜蘭縣,礁溪鄉,0232,502,147,649,71,720,1207,59.65%,41.59%,1
宜蘭縣,礁溪鄉,0233,377,117,494,55,549,979,56.08%,38.51%,1
宜蘭縣,礁溪鄉,0234,432,143,575,10,585,954,61.32%,45.28%,1
宜蘭縣,礁溪鄉,0235,159,54,213,7,220,418,52.63%,38.04%,1
宜蘭縣,壯圍鄉,0236,563,206,769,92,861,1435,60%,39.23%,1
宜蘭縣,壯圍鄉,0237,419,155,574,51,625,1049,59.58%,39.94%,1
宜蘭縣,壯圍鄉,0238,430,156,586,70,656,1068,61.42%,40.26%,1
宜蘭縣,壯圍鄉,0239,299,118,417,80,497,868,57.26%,34.45%,1
宜蘭縣,壯圍鄉,0240,382,92,474,34,508,967,52.53%,39.5%,1
宜蘭縣,壯圍鄉,0241,395,111,506,71,577,940,61.38%,42.02%,1
宜蘭縣,壯圍鄉,0242,322,92,414,38,452,975,46.36%,33.03%,1
宜蘭縣,壯圍鄉,0243,306,108,414,76,490,797,61.48%,38.39%,1
宜蘭縣,壯圍鄉,0244,305,96,401,64,465,808,57.55%,37.75%,1
宜蘭縣,壯圍鄉,0245,307,149,456,82,538,911,59.06%,33.7%,1
宜蘭縣,壯圍鄉,0246,222,65,287,29,316,612,51.63%,36.27%,1
宜蘭縣,壯圍鄉,0247,329,123,452,51,503,790,63.67%,41.65%,1
宜蘭縣,壯圍鄉,0248,356,111,467,56,523,878,59.57%,40.55%,1
宜蘭縣,壯圍鄉,0249,329,83,412,51,463,723,64.04%,45.5%,1
宜蘭縣,壯圍鄉,0250,134,187,321,36,357,737,48.44%,18.18%,1
宜蘭縣,壯圍鄉,0251,264,97,361,52,413,686,60.2%,38.48%,1
宜蘭縣,壯圍鄉,0252,340,104,444,1,445,895,49.72%,37.99%,1
宜蘭縣,壯圍鄉,0253,543,143,686,67,753,1237,60.87%,43.9%,1
宜蘭縣,壯圍鄉,0254,455,133,588,62,650,1134,57.32%,40.12%,1
宜蘭縣,壯圍鄉,0255,423,128,551,61,612,1107,55.28%,38.21%,1
宜蘭縣,壯圍鄉,0256,413,136,549,47,596,1057,56.39%,39.07%,1
宜蘭縣,壯圍鄉,0257,476,21,497,38,535,1051,50.9%,45.29%,1
宜蘭縣,壯圍鄉,0258,255,92,347,50,397,722,54.99%,35.32%,1
宜蘭縣,員山鄉,0259,519,151,670,29,699,1393,50.18%,37.26%,1
宜蘭縣,員山鄉,0260,331,99,430,29,459,895,51.28%,36.98%,1
宜蘭縣,員山鄉,0261,484,109,593,76,669,1231,54.35%,39.32%,1
宜蘭縣,員山鄉,0262,440,93,533,27,560,1098,51%,40.07%,1
宜蘭縣,員山鄉,0263,396,93,489,39,528,1031,51.21%,38.41%,1
宜蘭縣,員山鄉,0264,377,105,482,73,555,1030,53.88%,36.6%,1
宜蘭縣,員山鄉,0265,379,114,493,52,545,1168,46.66%,32.45%,1
宜蘭縣,員山鄉,0266,288,114,402,56,458,809,56.61%,35.6%,1
宜蘭縣,員山鄉,0267,300,93,393,54,447,778,57.46%,38.56%,1
宜蘭縣,員山鄉,0268,616,158,774,68,842,1465,57.47%,42.05%,1
宜蘭縣,員山鄉,0269,398,125,523,55,578,979,59.04%,40.65%,1
宜蘭縣,員山鄉,0270,329,101,430,47,477,860,55.47%,38.26%,1
宜蘭縣,員山鄉,0271,384,139,523,74,597,1205,49.54%,31.87%,1
宜蘭縣,員山鄉,0272,397,125,522,86,608,1082,56.19%,36.69%,1
宜蘭縣,員山鄉,0273,141,62,203,40,243,412,58.98%,34.22%,1
宜蘭縣,員山鄉,0274,113,55,168,18,186,403,46.15%,28.04%,1
宜蘭縣,員山鄉,0275,66,27,93,11,104,232,44.83%,28.45%,1
宜蘭縣,員山鄉,0276,316,134,450,55,505,944,53.5%,33.47%,1
宜蘭縣,員山鄉,0277,336,100,436,56,492,894,55.03%,37.58%,1
宜蘭縣,員山鄉,0278,530,134,664,88,752,1356,55.46%,39.09%,1
宜蘭縣,員山鄉,0279,299,101,400,53,453,780,58.08%,38.33%,1
宜蘭縣,員山鄉,0280,318,181,499,85,584,932,62.66%,34.12%,1
宜蘭縣,員山鄉,0281,175,85,260,34,294,583,50.43%,30.02%,1
宜蘭縣,員山鄉,0282,346,88,434,70,504,900,56%,38.44%,1
宜蘭縣,員山鄉,0283,264,100,364,40,404,747,54.08%,35.34%,1
宜蘭縣,員山鄉,0284,289,94,383,43,426,788,54.06%,36.68%,1
宜蘭縣,員山鄉,0285,313,102,415,50,465,884,52.6%,35.41%,1
宜蘭縣,員山鄉,0286,307,80,387,23,410,857,47.84%,35.82%,1
宜蘭縣,員山鄉,0287,344,112,456,29,485,1016,47.74%,33.86%,1
宜蘭縣,員山鄉,0288,204,68,272,33,305,690,44.2%,29.57%,1
宜蘭縣,員山鄉,0289,228,76,304,58,362,689,52.54%,33.09%,1
宜蘭縣,冬山鄉,0290,340,104,444,43,487,807,60.35%,42.13%,1
宜蘭縣,冬山鄉,0291,343,98,441,15,456,817,55.81%,41.98%,1
宜蘭縣,冬山鄉,0292,472,129,601,57,658,1156,56.92%,40.83%,1
宜蘭縣,冬山鄉,0293,331,106,437,37,474,892,53.14%,37.11%,1
宜蘭縣,冬山鄉,0294,362,120,482,43,525,897,58.53%,40.36%,1
宜蘭縣,冬山鄉,0295,585,181,766,66,832,1392,59.77%,42.03%,1
宜蘭縣,冬山鄉,0296,603,190,793,44,837,1471,56.9%,40.99%,1
宜蘭縣,冬山鄉,0297,453,149,602,32,634,1435,44.18%,31.57%,1
宜蘭縣,冬山鄉,0298,566,166,732,37,769,1519,50.63%,37.26%,1
宜蘭縣,冬山鄉,0299,628,168,796,21,817,1456,56.11%,43.13%,1
宜蘭縣,冬山鄉,0300,272,106,378,51,429,711,60.34%,38.26%,1
宜蘭縣,冬山鄉,0301,300,67,367,38,405,694,58.36%,43.23%,1
宜蘭縣,冬山鄉,0302,655,237,892,61,953,1526,62.45%,42.92%,1
宜蘭縣,冬山鄉,0303,332,110,442,31,473,884,53.51%,37.56%,1
宜蘭縣,冬山鄉,0304,505,139,644,73,717,1465,48.94%,34.47%,1
宜蘭縣,冬山鄉,0305,173,66,239,37,276,488,56.56%,35.45%,1
宜蘭縣,冬山鄉,0306,466,122,588,59,647,1218,53.12%,38.26%,1
宜蘭縣,冬山鄉,0307,498,114,612,43,655,1291,50.74%,38.57%,1
宜蘭縣,冬山鄉,0308,484,144,628,35,663,1324,50.08%,36.56%,1
宜蘭縣,冬山鄉,0309,416,116,532,40,572,1160,49.31%,35.86%,1
宜蘭縣,冬山鄉,0310,476,137,613,58,671,1246,53.85%,38.2%,1
宜蘭縣,冬山鄉,0311,682,159,841,37,878,1754,50.06%,38.88%,1
宜蘭縣,冬山鄉,0312,444,112,556,86,642,1217,52.75%,36.48%,1
宜蘭縣,冬山鄉,0313,526,131,657,61,718,1495,48.03%,35.18%,1
宜蘭縣,冬山鄉,0314,359,113,472,38,510,937,54.43%,38.31%,1
宜蘭縣,冬山鄉,0315,402,127,529,29,558,1101,50.68%,36.51%,1
宜蘭縣,冬山鄉,0316,394,126,520,60,580,1118,51.88%,35.24%,1
宜蘭縣,冬山鄉,0317,554,149,703,49,752,1301,57.8%,42.58%,1
宜蘭縣,冬山鄉,0318,469,124,593,35,628,1225,51.27%,38.29%,1
宜蘭縣,冬山鄉,0319,497,161,658,46,704,1206,58.37%,41.21%,1
宜蘭縣,冬山鄉,0320,443,152,595,33,628,1278,49.14%,34.66%,1
宜蘭縣,冬山鄉,0321,431,133,564,30,594,1151,51.61%,37.45%,1
宜蘭縣,冬山鄉,0322,382,111,493,48,541,1094,49.45%,34.92%,1
宜蘭縣,冬山鄉,0323,507,139,646,61,707,1247,56.7%,40.66%,1
宜蘭縣,冬山鄉,0324,443,125,568,59,627,1247,50.28%,35.53%,1
宜蘭縣,冬山鄉,0325,403,100,503,27,530,979,54.14%,41.16%,1
宜蘭縣,冬山鄉,0326,310,89,399,24,423,698,60.6%,44.41%,1
宜蘭縣,冬山鄉,0327,601,195,796,67,863,1726,50%,34.82%,1
宜蘭縣,冬山鄉,0328,230,80,310,19,329,782,42.07%,29.41%,1
宜蘭縣,五結鄉,0329,387,109,496,54,550,1076,51.12%,35.97%,1
宜蘭縣,五結鄉,0330,345,112,457,26,483,944,51.17%,36.55%,1
宜蘭縣,五結鄉,0331,347,78,425,27,452,836,54.07%,41.51%,1
宜蘭縣,五結鄉,0332,371,108,479,48,527,937,56.24%,39.59%,1
宜蘭縣,五結鄉,0333,468,149,617,40,657,1255,52.35%,37.29%,1
宜蘭縣,五結鄉,0334,446,170,616,67,683,1270,53.78%,35.12%,1
宜蘭縣,五結鄉,0335,295,76,371,25,396,801,49.44%,36.83%,1
宜蘭縣,五結鄉,0336,294,86,380,37,417,802,52%,36.66%,1
宜蘭縣,五結鄉,0337,476,135,611,39,650,1306,49.77%,36.45%,1
宜蘭縣,五結鄉,0338,455,118,573,53,626,1190,52.61%,38.24%,1
宜蘭縣,五結鄉,0339,504,141,645,29,674,1316,51.22%,38.3%,1
宜蘭縣,五結鄉,0340,399,92,491,27,518,965,53.68%,41.35%,1
宜蘭縣,五結鄉,0341,315,83,398,37,435,814,53.44%,38.7%,1
宜蘭縣,五結鄉,0342,469,132,601,42,643,1254,51.28%,37.4%,1
宜蘭縣,五結鄉,0343,439,107,546,59,605,1060,57.08%,41.42%,1
宜蘭縣,五結鄉,0344,527,164,691,36,727,1323,54.95%,39.83%,1
宜蘭縣,五結鄉,0345,464,135,599,42,641,1120,57.23%,41.43%,1
宜蘭縣,五結鄉,0346,357,91,448,25,473,893,52.97%,39.98%,1
宜蘭縣,五結鄉,0347,448,154,602,45,647,1220,53.03%,36.72%,1
宜蘭縣,五結鄉,0348,408,107,515,21,536,924,58.01%,44.16%,1
宜蘭縣,五結鄉,0349,409,106,515,46,561,933,60.13%,43.84%,1
宜蘭縣,五結鄉,0350,399,98,497,31,528,986,53.55%,40.47%,1
宜蘭縣,五結鄉,0351,285,82,367,41,408,748,54.55%,38.1%,1
宜蘭縣,五結鄉,0352,573,160,733,100,833,1550,53.74%,36.97%,1
宜蘭縣,五結鄉,0353,247,82,329,26,355,629,56.44%,39.27%,1
宜蘭縣,五結鄉,0354,298,106,404,36,440,806,54.59%,36.97%,1
宜蘭縣,五結鄉,0355,313,135,448,45,493,956,51.57%,32.74%,1
宜蘭縣,五結鄉,0356,387,134,521,45,566,1066,53.1%,36.3%,1
宜蘭縣,五結鄉,0357,531,148,679,70,749,1513,49.5%,35.1%,1
宜蘭縣,五結鄉,0358,584,189,773,51,824,1566,52.62%,37.29%,1
宜蘭縣,五結鄉,0359,319,109,428,65,493,894,55.15%,35.68%,1
宜蘭縣,五結鄉,0360,361,153,514,67,581,1235,47.04%,29.23%,1
宜蘭縣,五結鄉,0361,267,86,353,43,396,704,56.25%,37.93%,1
宜蘭縣,三星鄉,0362,78,22,100,14,114,215,53.02%,36.28%,1
宜蘭縣,三星鄉,0363,150,54,204,37,241,523,46.08%,28.68%,1
宜蘭縣,三星鄉,0364,224,114,338,52,390,745,52.35%,30.07%,1
宜蘭縣,三星鄉,0365,201,69,270,33,303,617,49.11%,32.58%,1
宜蘭縣,三星鄉,0366,157,68,225,39,264,497,53.12%,31.59%,1
宜蘭縣,三星鄉,0367,261,89,350,61,411,735,55.92%,35.51%,1
宜蘭縣,三星鄉,0368,205,70,275,49,324,583,55.57%,35.16%,1
宜蘭縣,三星鄉,0369,160,42,202,31,233,436,53.44%,36.7%,1
宜蘭縣,三星鄉,0370,425,143,568,68,636,1224,51.96%,34.72%,1
宜蘭縣,三星鄉,0371,369,121,490,53,543,1151,47.18%,32.06%,1
宜蘭縣,三星鄉,0372,318,123,441,36,477,870,54.83%,36.55%,1
宜蘭縣,三星鄉,0373,378,107,485,47,532,1284,41.43%,29.44%,1
宜蘭縣,三星鄉,0374,361,123,484,46,530,897,59.09%,40.25%,1
宜蘭縣,三星鄉,0375,558,156,714,60,774,1439,53.79%,38.78%,1
宜蘭縣,三星鄉,0376,504,172,676,55,731,1445,50.59%,34.88%,1
宜蘭縣,三星鄉,0377,543,140,683,43,726,1402,51.78%,38.73%,1
宜蘭縣,三星鄉,0378,416,169,585,55,640,1230,52.03%,33.82%,1
宜蘭縣,三星鄉,0379,288,83,371,61,432,774,55.81%,37.21%,1
宜蘭縣,三星鄉,0380,330,104,434,43,477,827,57.68%,39.9%,1
宜蘭縣,三星鄉,0381,260,96,356,34,390,736,52.99%,35.33%,1
宜蘭縣,三星鄉,0382,534,137,671,74,745,1421,52.43%,37.58%,1
宜蘭縣,大同鄉,0383,222,81,303,56,359,893,40.2%,24.86%,1
宜蘭縣,大同鄉,0384,322,86,408,53,461,632,72.94%,50.95%,1
宜蘭縣,大同鄉,0385,220,49,269,23,292,684,42.69%,32.16%,1
宜蘭縣,大同鄉,0386,106,37,143,32,175,264,66.29%,40.15%,1
宜蘭縣,大同鄉,0387,93,14,107,6,113,337,33.53%,27.6%,1
宜蘭縣,大同鄉,0388,102,29,131,9,140,404,34.65%,25.25%,1
宜蘭縣,大同鄉,0389,16,6,22,4,26,55,47.27%,29.09%,1
宜蘭縣,大同鄉,0390,83,46,129,24,153,199,76.88%,41.71%,1
宜蘭縣,大同鄉,0391,165,62,227,21,248,787,31.51%,20.97%,1
宜蘭縣,大同鄉,0392,223,76,299,57,356,680,52.35%,32.79%,1
宜蘭縣,南澳鄉,0393,173,40,213,12,225,444,50.68%,38.96%,1
宜蘭縣,南澳鄉,0394,463,100,563,28,591,1210,48.84%,38.26%,1
宜蘭縣,南澳鄉,0395,402,101,503,77,580,962,60.29%,41.79%,1
宜蘭縣,南澳鄉,0396,112,34,146,4,150,411,36.5%,27.25%,1
宜蘭縣,南澳鄉,0397,238,51,289,18,307,447,68.68%,53.24%,1
宜蘭縣,南澳鄉,0398,251,79,330,38,368,475,77.47%,52.84%,1
宜蘭縣,南澳鄉,0399,299,71,370,41,411,695,59.14%,43.02%,1
花蓮縣,花蓮市,0001,653,177,830,29,859,1522,56.44%,42.9%,1
花蓮縣,花蓮市,0002,510,113,623,28,651,1114,58.44%,45.78%,1
花蓮縣,花蓮市,0003,275,79,354,21,375,670,55.97%,41.04%,1
花蓮縣,花蓮市,0004,581,134,715,22,737,1397,52.76%,41.59%,1
花蓮縣,花蓮市,0005,164,49,213,25,238,470,50.64%,34.89%,1
花蓮縣,花蓮市,0006,320,67,387,43,430,838,51.31%,38.19%,1
花蓮縣,花蓮市,0007,238,45,283,18,301,721,41.75%,33.01%,1
花蓮縣,花蓮市,0008,380,109,489,39,528,918,57.52%,41.39%,1
花蓮縣,花蓮市,0009,596,170,766,41,807,1539,52.44%,38.73%,1
花蓮縣,花蓮市,0010,569,128,697,48,745,1403,53.1%,40.56%,1
花蓮縣,花蓮市,0011,434,99,533,30,563,1068,52.72%,40.64%,1
花蓮縣,花蓮市,0012,499,113,612,31,643,1167,55.1%,42.76%,1
花蓮縣,花蓮市,0013,548,141,689,61,750,1259,59.57%,43.53%,1
花蓮縣,花蓮市,0014,399,114,513,68,581,1071,54.25%,37.25%,1
花蓮縣,花蓮市,0015,384,108,492,35,527,925,56.97%,41.51%,1
花蓮縣,花蓮市,0016,521,138,659,51,710,1141,62.23%,45.66%,1
花蓮縣,花蓮市,0017,462,110,572,27,599,1163,51.5%,39.72%,1
花蓮縣,花蓮市,0018,570,126,696,46,742,1279,58.01%,44.57%,1
花蓮縣,花蓮市,0019,542,147,689,28,717,1512,47.42%,35.85%,1
花蓮縣,花蓮市,0020,244,64,308,25,333,615,54.15%,39.67%,1
花蓮縣,花蓮市,0021,247,84,331,16,347,606,57.26%,40.76%,1
花蓮縣,花蓮市,0022,212,42,254,32,286,559,51.16%,37.92%,1
花蓮縣,花蓮市,0023,195,38,233,16,249,442,56.33%,44.12%,1
花蓮縣,花蓮市,0024,452,82,534,26,560,1114,50.27%,40.57%,1
花蓮縣,花蓮市,0025,180,39,219,15,234,416,56.25%,43.27%,1
花蓮縣,花蓮市,0026,265,68,333,19,352,577,61.01%,45.93%,1
花蓮縣,花蓮市,0027,371,91,462,32,494,810,60.99%,45.8%,1
花蓮縣,花蓮市,0028,226,59,285,24,309,538,57.43%,42.01%,1
花蓮縣,花蓮市,0029,221,55,276,33,309,566,54.59%,39.05%,1
花蓮縣,花蓮市,0030,192,41,233,12,245,469,52.24%,40.94%,1
花蓮縣,花蓮市,0031,251,52,303,20,323,565,57.17%,44.42%,1
花蓮縣,花蓮市,0032,302,69,371,30,401,816,49.14%,37.01%,1
花蓮縣,花蓮市,0033,356,80,436,40,476,911,52.25%,39.08%,1
花蓮縣,花蓮市,0034,391,97,488,48,536,1029,52.09%,38%,1
花蓮縣,花蓮市,0035,447,109,556,49,605,1043,58.01%,42.86%,1
花蓮縣,花蓮市,0036,371,95,466,23,489,856,57.13%,43.34%,1
花蓮縣,花蓮市,0037,405,103,508,29,537,979,54.85%,41.37%,1
花蓮縣,花蓮市,0038,559,138,697,54,751,1331,56.42%,42%,1
花蓮縣,花蓮市,0039,533,119,652,39,691,1228,56.27%,43.4%,1
花蓮縣,花蓮市,0040,413,102,515,29,544,955,56.96%,43.25%,1
花蓮縣,花蓮市,0041,485,119,604,36,640,1268,50.47%,38.25%,1
花蓮縣,花蓮市,0042,483,123,606,40,646,1230,52.52%,39.27%,1
花蓮縣,花蓮市,0043,595,117,712,59,771,1369,56.32%,43.46%,1
花蓮縣,花蓮市,0044,486,120,606,33,639,1435,44.53%,33.87%,1
花蓮縣,花蓮市,0045,487,113,600,40,640,1164,54.98%,41.84%,1
花蓮縣,花蓮市,0046,568,124,692,43,735,1249,58.85%,45.48%,1
花蓮縣,花蓮市,0047,480,119,599,59,658,1184,55.57%,40.54%,1
花蓮縣,花蓮市,0048,612,133,745,36,781,1490,52.42%,41.07%,1
花蓮縣,花蓮市,0049,486,114,600,40,640,1022,62.62%,47.55%,1
花蓮縣,花蓮市,0050,507,112,619,19,638,1135,56.21%,44.67%,1
花蓮縣,花蓮市,0051,469,101,570,40,610,1084,56.27%,43.27%,1
花蓮縣,花蓮市,0052,365,99,464,34,498,1339,37.19%,27.26%,1
花蓮縣,花蓮市,0053,224,54,278,22,300,501,59.88%,44.71%,1
花蓮縣,花蓮市,0054,379,94,473,24,497,904,54.98%,41.92%,1
花蓮縣,花蓮市,0055,217,69,286,18,304,490,62.04%,44.29%,1
花蓮縣,花蓮市,0056,441,92,533,32,565,1192,47.4%,37%,1
花蓮縣,花蓮市,0057,337,72,409,26,435,869,50.06%,38.78%,1
花蓮縣,花蓮市,0058,527,115,642,35,677,1267,53.43%,41.59%,1
花蓮縣,花蓮市,0059,410,99,509,49,558,959,58.19%,42.75%,1
花蓮縣,花蓮市,0060,419,89,508,32,540,993,54.38%,42.2%,1
花蓮縣,花蓮市,0061,403,100,503,49,552,982,56.21%,41.04%,1
花蓮縣,花蓮市,0062,489,112,601,18,619,1311,47.22%,37.3%,1
花蓮縣,花蓮市,0063,549,151,700,47,747,1455,51.34%,37.73%,1
花蓮縣,花蓮市,0064,407,109,516,20,536,1151,46.57%,35.36%,1
花蓮縣,花蓮市,0065,467,117,584,26,610,1237,49.31%,37.75%,1
花蓮縣,花蓮市,0066,500,101,601,43,644,1339,48.1%,37.34%,1
花蓮縣,花蓮市,0067,313,76,389,25,414,715,57.9%,43.78%,1
花蓮縣,花蓮市,0068,417,95,512,43,555,1000,55.5%,41.7%,1
花蓮縣,花蓮市,0069,515,136,651,48,699,1410,49.57%,36.52%,1
花蓮縣,花蓮市,0070,552,119,671,19,690,1303,52.95%,42.36%,1
花蓮縣,花蓮市,0071,512,131,643,31,674,1256,53.66%,40.76%,1
花蓮縣,花蓮市,0072,472,121,593,43,636,1105,57.56%,42.71%,1
花蓮縣,花蓮市,0073,417,116,533,24,557,1089,51.15%,38.29%,1
花蓮縣,花蓮市,0074,396,96,492,22,514,1043,49.28%,37.97%,1
花蓮縣,花蓮市,0075,494,94,588,28,616,1080,57.04%,45.74%,1
花蓮縣,花蓮市,0076,426,77,503,37,540,971,55.61%,43.87%,1
花蓮縣,花蓮市,0077,448,131,579,30,609,1068,57.02%,41.95%,1
花蓮縣,花蓮市,0078,560,100,660,34,694,1379,50.33%,40.61%,1
花蓮縣,花蓮市,0079,538,132,670,47,717,1362,52.64%,39.5%,1
花蓮縣,花蓮市,0080,567,151,718,40,758,1323,57.29%,42.86%,1
花蓮縣,花蓮市,0081,483,156,639,35,674,1482,45.48%,32.59%,1
花蓮縣,鳳林鎮,0195,547,123,670,64,734,1192,61.58%,45.89%,1
花蓮縣,鳳林鎮,0196,239,59,298,25,323,639,50.55%,37.4%,1
花蓮縣,鳳林鎮,0197,286,70,356,44,400,601,66.56%,47.59%,1
花蓮縣,鳳林鎮,0198,563,113,676,49,725,1137,63.76%,49.52%,1
花蓮縣,鳳林鎮,0199,270,96,366,51,417,742,56.2%,36.39%,1
花蓮縣,鳳林鎮,0200,277,43,320,29,349,610,57.21%,45.41%,1
花蓮縣,鳳林鎮,0201,105,45,150,42,192,295,65.08%,35.59%,1
花蓮縣,鳳林鎮,0202,52,10,62,4,66,218,30.28%,23.85%,1
花蓮縣,鳳林鎮,0203,213,60,273,26,299,720,41.53%,29.58%,1
花蓮縣,鳳林鎮,0204,198,56,254,32,286,528,54.17%,37.5%,1
花蓮縣,鳳林鎮,0205,189,70,259,29,288,560,51.43%,33.75%,1
花蓮縣,鳳林鎮,0206,199,43,242,49,291,541,53.79%,36.78%,1
花蓮縣,鳳林鎮,0207,325,76,401,63,464,818,56.72%,39.73%,1
花蓮縣,鳳林鎮,0208,293,77,370,40,410,984,41.67%,29.78%,1
花蓮縣,鳳林鎮,0209,29,12,41,8,49,91,53.85%,31.87%,1
花蓮縣,玉里鎮,0254,400,103,503,43,546,1008,54.17%,39.68%,1
花蓮縣,玉里鎮,0255,419,94,513,43,556,939,59.21%,44.62%,1
花蓮縣,玉里鎮,0256,493,97,590,66,656,1256,52.23%,39.25%,1
花蓮縣,玉里鎮,0257,337,111,448,57,505,929,54.36%,36.28%,1
花蓮縣,玉里鎮,0258,381,114,495,40,535,979,54.65%,38.92%,1
花蓮縣,玉里鎮,0259,551,132,683,47,730,1244,58.68%,44.29%,1
花蓮縣,玉里鎮,0260,290,81,371,45,416,847,49.11%,34.24%,1
花蓮縣,玉里鎮,0261,250,75,325,55,380,772,49.22%,32.38%,1
花蓮縣,玉里鎮,0262,196,59,255,22,277,558,49.64%,35.13%,1
花蓮縣,玉里鎮,0263,184,56,240,21,261,800,32.63%,23%,1
花蓮縣,玉里鎮,0264,407,119,526,69,595,1286,46.27%,31.65%,1
花蓮縣,玉里鎮,0265,402,118,520,79,599,1246,48.07%,32.26%,1
花蓮縣,玉里鎮,0266,184,95,279,66,345,647,53.32%,28.44%,1
花蓮縣,玉里鎮,0267,159,41,200,21,221,990,22.32%,16.06%,1
花蓮縣,玉里鎮,0268,148,64,212,51,263,530,49.62%,27.92%,1
花蓮縣,玉里鎮,0269,225,91,316,47,363,979,37.08%,22.98%,1
花蓮縣,玉里鎮,0270,173,47,220,100,320,557,57.45%,31.06%,1
花蓮縣,玉里鎮,0271,107,32,139,19,158,434,36.41%,24.65%,1
花蓮縣,玉里鎮,0272,197,80,277,84,361,1065,33.9%,18.5%,1
花蓮縣,玉里鎮,0273,239,114,353,108,461,866,53.23%,27.6%,1
花蓮縣,玉里鎮,0274,191,76,267,51,318,769,41.35%,24.84%,1
花蓮縣,玉里鎮,0275,245,83,328,43,371,869,42.69%,28.19%,1
花蓮縣,玉里鎮,0276,293,98,391,55,446,1080,41.3%,27.13%,1
花蓮縣,新城鄉,0082,148,48,196,16,212,367,57.77%,40.33%,1
花蓮縣,新城鄉,0083,344,82,426,16,442,929,47.58%,37.03%,1
花蓮縣,新城鄉,0084,217,80,297,57,354,590,60%,36.78%,1
花蓮縣,新城鄉,0085,95,51,146,26,172,307,56.03%,30.94%,1
花蓮縣,新城鄉,0086,105,36,141,19,160,260,61.54%,40.38%,1
花蓮縣,新城鄉,0087,509,146,655,65,720,1283,56.12%,39.67%,1
花蓮縣,新城鄉,0088,324,94,418,25,443,885,50.06%,36.61%,1
花蓮縣,新城鄉,0089,310,96,406,35,441,770,57.27%,40.26%,1
花蓮縣,新城鄉,0090,538,146,684,54,738,1363,54.15%,39.47%,1
花蓮縣,新城鄉,0091,134,45,179,13,192,366,52.46%,36.61%,1
花蓮縣,新城鄉,0092,404,135,539,51,590,1163,50.73%,34.74%,1
花蓮縣,新城鄉,0093,623,180,803,34,837,1605,52.15%,38.82%,1
花蓮縣,新城鄉,0094,478,119,597,42,639,1194,53.52%,40.03%,1
花蓮縣,新城鄉,0095,407,102,509,42,551,979,56.28%,41.57%,1
花蓮縣,新城鄉,0096,611,161,772,49,821,1485,55.29%,41.14%,1
花蓮縣,新城鄉,0097,416,105,521,34,555,1070,51.87%,38.88%,1
花蓮縣,新城鄉,0098,481,120,601,34,635,1164,54.55%,41.32%,1
花蓮縣,新城鄉,0099,309,104,413,55,468,880,53.18%,35.11%,1
花蓮縣,新城鄉,0100,124,47,171,18,189,369,51.22%,33.6%,1
花蓮縣,吉安鄉,0115,429,89,518,36,554,1059,52.31%,40.51%,1
花蓮縣,吉安鄉,0116,429,81,510,35,545,983,55.44%,43.64%,1
花蓮縣,吉安鄉,0117,438,89,527,35,562,1031,54.51%,42.48%,1
花蓮縣,吉安鄉,0118,404,120,524,37,561,1105,50.77%,36.56%,1
花蓮縣,吉安鄉,0119,421,119,540,34,574,1107,51.85%,38.03%,1
花蓮縣,吉安鄉,0120,422,128,550,37,587,1179,49.79%,35.79%,1
花蓮縣,吉安鄉,0121,476,131,607,56,663,1453,45.63%,32.76%,1
花蓮縣,吉安鄉,0122,657,139,796,45,841,1432,58.73%,45.88%,1
花蓮縣,吉安鄉,0123,556,134,690,40,730,1320,55.3%,42.12%,1
花蓮縣,吉安鄉,0124,531,118,649,31,680,1356,50.15%,39.16%,1
花蓮縣,吉安鄉,0125,512,108,620,39,659,1295,50.89%,39.54%,1
花蓮縣,吉安鄉,0126,614,129,743,54,797,1467,54.33%,41.85%,1
花蓮縣,吉安鄉,0127,567,184,751,33,784,1515,51.75%,37.43%,1
花蓮縣,吉安鄉,0128,477,99,576,53,629,1063,59.17%,44.87%,1
花蓮縣,吉安鄉,0129,437,106,543,19,562,1284,43.77%,34.03%,1
花蓮縣,吉安鄉,0130,600,138,738,34,772,1380,55.94%,43.48%,1
花蓮縣,吉安鄉,0131,536,135,671,61,732,1297,56.44%,41.33%,1
花蓮縣,吉安鄉,0132,601,171,772,81,853,1662,51.32%,36.16%,1
花蓮縣,吉安鄉,0133,481,173,654,95,749,1563,47.92%,30.77%,1
花蓮縣,吉安鄉,0134,452,121,573,48,621,1288,48.21%,35.09%,1
花蓮縣,吉安鄉,0135,360,97,457,41,498,907,54.91%,39.69%,1
花蓮縣,吉安鄉,0136,342,102,444,29,473,917,51.58%,37.3%,1
花蓮縣,吉安鄉,0137,382,112,494,32,526,1021,51.52%,37.41%,1
花蓮縣,吉安鄉,0138,471,99,570,44,614,1033,59.44%,45.6%,1
花蓮縣,吉安鄉,0139,404,93,497,53,550,966,56.94%,41.82%,1
花蓮縣,吉安鄉,0140,454,102,556,67,623,1188,52.44%,38.22%,1
花蓮縣,吉安鄉,0141,594,141,735,30,765,1480,51.69%,40.14%,1
花蓮縣,吉安鄉,0142,514,116,630,45,675,1393,48.46%,36.9%,1
花蓮縣,吉安鄉,0143,455,107,562,31,593,1193,49.71%,38.14%,1
花蓮縣,吉安鄉,0144,544,118,662,31,693,1445,47.96%,37.65%,1
花蓮縣,吉安鄉,0145,472,134,606,90,696,1301,53.5%,36.28%,1
花蓮縣,吉安鄉,0146,501,140,641,51,692,1215,56.95%,41.23%,1
花蓮縣,吉安鄉,0147,470,105,575,34,609,1135,53.66%,41.41%,1
花蓮縣,吉安鄉,0148,570,97,667,28,695,1223,56.83%,46.61%,1
花蓮縣,吉安鄉,0149,552,100,652,45,697,1274,54.71%,43.33%,1
花蓮縣,吉安鄉,0150,451,111,562,32,594,1124,52.85%,40.12%,1
花蓮縣,吉安鄉,0151,509,108,617,33,650,1158,56.13%,43.96%,1
花蓮縣,吉安鄉,0152,510,108,618,27,645,1157,55.75%,44.08%,1
花蓮縣,吉安鄉,0153,528,115,643,43,686,1258,54.53%,41.97%,1
花蓮縣,吉安鄉,0154,498,144,642,29,671,1257,53.38%,39.62%,1
花蓮縣,吉安鄉,0155,504,113,617,31,648,1245,52.05%,40.48%,1
花蓮縣,吉安鄉,0156,511,116,627,17,644,1166,55.23%,43.83%,1
花蓮縣,吉安鄉,0157,522,123,645,63,708,1358,52.14%,38.44%,1
花蓮縣,吉安鄉,0158,502,97,599,31,630,1214,51.89%,41.35%,1
花蓮縣,吉安鄉,0159,452,116,568,54,622,1151,54.04%,39.27%,1
花蓮縣,吉安鄉,0160,475,121,596,44,640,1157,55.32%,41.05%,1
花蓮縣,吉安鄉,0161,499,110,609,39,648,1161,55.81%,42.98%,1
花蓮縣,吉安鄉,0162,558,129,687,49,736,1304,56.44%,42.79%,1
花蓮縣,吉安鄉,0163,511,151,662,52,714,1367,52.23%,37.38%,1
花蓮縣,吉安鄉,0164,489,140,629,35,664,1411,47.06%,34.66%,1
花蓮縣,吉安鄉,0165,517,111,628,33,661,1409,46.91%,36.69%,1
花蓮縣,吉安鄉,0166,393,97,490,41,531,1125,47.2%,34.93%,1
花蓮縣,吉安鄉,0167,457,132,589,80,669,1213,55.15%,37.68%,1
花蓮縣,吉安鄉,0168,452,137,589,35,624,1141,54.69%,39.61%,1
花蓮縣,吉安鄉,0169,414,83,497,32,529,1156,45.76%,35.81%,1
花蓮縣,吉安鄉,0170,421,87,508,52,560,1092,51.28%,38.55%,1
花蓮縣,吉安鄉,0171,317,108,425,38,463,1026,45.13%,30.9%,1
花蓮縣,吉安鄉,0172,330,73,403,15,418,804,51.99%,41.04%,1
花蓮縣,吉安鄉,0173,481,100,581,44,625,1132,55.21%,42.49%,1
花蓮縣,壽豐鄉,0174,350,105,455,46,501,1052,47.62%,33.27%,1
花蓮縣,壽豐鄉,0175,147,41,188,30,218,357,61.06%,41.18%,1
花蓮縣,壽豐鄉,0176,366,99,465,52,517,1022,50.59%,35.81%,1
花蓮縣,壽豐鄉,0177,367,132,499,49,548,875,62.63%,41.94%,1
花蓮縣,壽豐鄉,0178,270,103,373,50,423,691,61.22%,39.07%,1
花蓮縣,壽豐鄉,0179,231,70,301,23,324,708,45.76%,32.63%,1
花蓮縣,壽豐鄉,0180,339,89,428,45,473,894,52.91%,37.92%,1
花蓮縣,壽豐鄉,0181,296,79,375,32,407,746,54.56%,39.68%,1
花蓮縣,壽豐鄉,0182,304,115,419,50,469,881,53.23%,34.51%,1
花蓮縣,壽豐鄉,0183,318,79,397,32,429,695,61.73%,45.76%,1
花蓮縣,壽豐鄉,0184,306,126,432,79,511,816,62.62%,37.5%,1
花蓮縣,壽豐鄉,0185,259,99,358,37,395,773,51.1%,33.51%,1
花蓮縣,壽豐鄉,0186,404,128,532,60,592,1029,57.53%,39.26%,1
花蓮縣,壽豐鄉,0187,186,38,224,33,257,407,63.14%,45.7%,1
花蓮縣,壽豐鄉,0188,464,132,596,53,649,1139,56.98%,40.74%,1
花蓮縣,壽豐鄉,0189,390,149,539,34,573,996,57.53%,39.16%,1
花蓮縣,壽豐鄉,0190,135,40,175,12,187,414,45.17%,32.61%,1
花蓮縣,壽豐鄉,0191,110,38,148,9,157,270,58.15%,40.74%,1
花蓮縣,壽豐鄉,0192,319,107,426,62,488,836,58.37%,38.16%,1
花蓮縣,壽豐鄉,0193,205,77,282,25,307,507,60.55%,40.43%,1
花蓮縣,壽豐鄉,0194,195,73,268,48,316,739,42.76%,26.39%,1
花蓮縣,光復鄉,0210,498,130,628,89,717,1295,55.37%,38.46%,1
花蓮縣,光復鄉,0211,387,73,460,43,503,859,58.56%,45.05%,1
花蓮縣,光復鄉,0212,346,120,466,103,569,958,59.39%,36.12%,1
花蓮縣,光復鄉,0213,356,134,490,97,587,1011,58.06%,35.21%,1
花蓮縣,光復鄉,0214,366,158,524,79,603,1041,57.93%,35.16%,1
花蓮縣,光復鄉,0215,266,96,362,86,448,821,54.57%,32.4%,1
花蓮縣,光復鄉,0216,31,5,36,1,37,188,19.68%,16.49%,1
花蓮縣,光復鄉,0217,198,50,248,34,282,514,54.86%,38.52%,1
花蓮縣,光復鄉,0218,111,34,145,13,158,446,35.43%,24.89%,1
花蓮縣,光復鄉,0219,287,90,377,53,430,851,50.53%,33.73%,1
花蓮縣,光復鄉,0220,233,90,323,23,346,932,37.12%,25%,1
花蓮縣,光復鄉,0221,211,30,241,27,268,471,56.9%,44.8%,1
花蓮縣,光復鄉,0222,215,94,309,49,358,640,55.94%,33.59%,1
花蓮縣,光復鄉,0223,35,7,42,3,45,116,38.79%,30.17%,1
花蓮縣,光復鄉,0224,105,28,133,10,143,496,28.83%,21.17%,1
花蓮縣,光復鄉,0225,101,34,135,11,146,324,45.06%,31.17%,1
花蓮縣,光復鄉,0226,123,33,156,20,176,454,38.77%,27.09%,1
花蓮縣,豐濱鄉,0227,179,78,257,85,342,717,47.7%,24.97%,1
花蓮縣,豐濱鄉,0228,150,100,250,54,304,751,40.48%,19.97%,1
花蓮縣,豐濱鄉,0229,162,75,237,50,287,613,46.82%,26.43%,1
花蓮縣,豐濱鄉,0230,270,68,338,26,364,809,44.99%,33.37%,1
花蓮縣,豐濱鄉,0231,41,11,52,2,54,357,15.13%,11.48%,1
花蓮縣,豐濱鄉,0232,175,90,265,75,340,669,50.82%,26.16%,1
花蓮縣,豐濱鄉,0233,152,34,186,10,196,479,40.92%,31.73%,1
花蓮縣,瑞穗鄉,0241,341,78,419,50,469,813,57.69%,41.94%,1
花蓮縣,瑞穗鄉,0242,434,102,536,74,610,1091,55.91%,39.78%,1
花蓮縣,瑞穗鄉,0243,337,89,426,47,473,839,56.38%,40.17%,1
花蓮縣,瑞穗鄉,0244,386,111,497,60,557,975,57.13%,39.59%,1
花蓮縣,瑞穗鄉,0245,172,62,234,20,254,546,46.52%,31.5%,1
花蓮縣,瑞穗鄉,0246,376,119,495,75,570,1002,56.89%,37.52%,1
花蓮縣,瑞穗鄉,0247,179,57,236,40,276,593,46.54%,30.19%,1
花蓮縣,瑞穗鄉,0248,362,115,477,81,558,965,57.82%,37.51%,1
花蓮縣,瑞穗鄉,0249,291,103,394,81,475,863,55.04%,33.72%,1
花蓮縣,瑞穗鄉,0250,51,18,69,8,77,340,22.65%,15%,1
花蓮縣,瑞穗鄉,0251,243,73,316,38,354,764,46.34%,31.81%,1
花蓮縣,瑞穗鄉,0252,118,40,158,11,169,868,19.47%,13.59%,1
花蓮縣,瑞穗鄉,0253,128,36,164,16,180,620,29.03%,20.65%,1
花蓮縣,富里鄉,0277,131,43,174,22,196,467,41.97%,28.05%,1
花蓮縣,富里鄉,0278,260,84,344,63,407,1032,39.44%,25.19%,1
花蓮縣,富里鄉,0279,184,56,240,37,277,638,43.42%,28.84%,1
花蓮縣,富里鄉,0280,174,65,239,84,323,591,54.65%,29.44%,1
花蓮縣,富里鄉,0281,402,122,524,69,593,1087,54.55%,36.98%,1
花蓮縣,富里鄉,0282,145,57,202,22,224,431,51.97%,33.64%,1
花蓮縣,富里鄉,0283,312,78,390,46,436,893,48.82%,34.94%,1
花蓮縣,富里鄉,0284,90,31,121,28,149,361,41.27%,24.93%,1
花蓮縣,富里鄉,0285,359,127,486,53,539,1362,39.57%,26.36%,1
花蓮縣,富里鄉,0286,158,53,211,28,239,458,52.18%,34.5%,1
花蓮縣,富里鄉,0287,121,40,161,33,194,621,31.24%,19.48%,1
花蓮縣,富里鄉,0288,151,65,216,27,243,493,49.29%,30.63%,1
花蓮縣,富里鄉,0289,194,69,263,35,298,631,47.23%,30.74%,1
花蓮縣,秀林鄉,0101,313,92,405,34,439,867,50.63%,36.1%,1
花蓮縣,秀林鄉,0102,182,88,270,27,297,575,51.65%,31.65%,1
花蓮縣,秀林鄉,0103,310,151,461,56,517,1373,37.65%,22.58%,1
花蓮縣,秀林鄉,0104,463,159,622,85,707,1644,43%,28.16%,1
花蓮縣,秀林鄉,0105,66,19,85,4,89,162,54.94%,40.74%,1
花蓮縣,秀林鄉,0106,118,46,164,29,193,384,50.26%,30.73%,1
花蓮縣,秀林鄉,0107,425,109,534,42,576,1382,41.68%,30.75%,1
花蓮縣,秀林鄉,0108,354,116,470,42,512,1125,45.51%,31.47%,1
花蓮縣,秀林鄉,0109,190,77,267,18,285,627,45.45%,30.3%,1
花蓮縣,秀林鄉,0110,405,138,543,51,594,987,60.18%,41.03%,1
花蓮縣,秀林鄉,0111,444,158,602,102,704,1139,61.81%,38.98%,1
花蓮縣,秀林鄉,0112,435,141,576,10,586,1213,48.31%,35.86%,1
花蓮縣,秀林鄉,0113,274,79,353,32,385,754,51.06%,36.34%,1
花蓮縣,秀林鄉,0114,101,25,126,18,144,330,43.64%,30.61%,1
花蓮縣,萬榮鄉,0234,362,154,516,78,594,1072,55.41%,33.77%,1
花蓮縣,萬榮鄉,0235,158,49,207,11,218,560,38.93%,28.21%,1
花蓮縣,萬榮鄉,0236,316,103,419,39,458,773,59.25%,40.88%,1
花蓮縣,萬榮鄉,0237,170,67,237,13,250,661,37.82%,25.72%,1
花蓮縣,萬榮鄉,0238,150,55,205,18,223,442,50.45%,33.94%,1
花蓮縣,萬榮鄉,0239,183,94,277,70,347,675,51.41%,27.11%,1
花蓮縣,萬榮鄉,0240,409,212,621,115,736,1086,67.77%,37.66%,1
花蓮縣,卓溪鄉,0290,204,55,259,23,282,533,52.91%,38.27%,1
花蓮縣,卓溪鄉,0291,192,82,274,51,325,522,62.26%,36.78%,1
花蓮縣,卓溪鄉,0292,127,36,163,17,180,493,36.51%,25.76%,1
花蓮縣,卓溪鄉,0293,309,80,389,49,438,701,62.48%,44.08%,1
花蓮縣,卓溪鄉,0294,298,87,385,58,443,746,59.38%,39.95%,1
花蓮縣,卓溪鄉,0295,219,97,316,70,386,616,62.66%,35.55%,1
花蓮縣,卓溪鄉,0296,87,24,111,19,130,405,32.1%,21.48%,1
花蓮縣,卓溪鄉,0297,127,32,159,20,179,329,54.41%,38.6%,1
花蓮縣,卓溪鄉,0298,160,36,196,22,218,428,50.93%,37.38%,1
花蓮縣,卓溪鄉,0299,78,11,89,9,98,174,56.32%,44.83%,1
臺東縣,臺東市,0001,326,84,410,19,429,874,49.08%,37.3%,1
臺東縣,臺東市,0002,667,168,835,66,901,1469,61.33%,45.41%,1
臺東縣,臺東市,0003,539,124,663,32,695,1259,55.2%,42.81%,1
臺東縣,臺東市,0004,564,153,717,44,761,1399,54.4%,40.31%,1
臺東縣,臺東市,0005,640,150,790,51,841,1363,61.7%,46.96%,1
臺東縣,臺東市,0006,668,179,847,48,895,1651,54.21%,40.46%,1
臺東縣,臺東市,0007,690,186,876,50,926,1490,62.15%,46.31%,1
臺東縣,臺東市,0008,315,98,413,32,445,859,51.8%,36.67%,1
臺東縣,臺東市,0009,384,119,503,32,535,890,60.11%,43.15%,1
臺東縣,臺東市,0010,253,85,338,38,376,651,57.76%,38.86%,1
臺東縣,臺東市,0011,583,172,755,71,826,1650,50.06%,35.33%,1
臺東縣,臺東市,0012,309,106,415,35,450,724,62.15%,42.68%,1
臺東縣,臺東市,0013,262,92,354,27,381,632,60.28%,41.46%,1
臺東縣,臺東市,0014,326,91,417,46,463,771,60.05%,42.28%,1
臺東縣,臺東市,0015,282,98,380,27,407,798,51%,35.34%,1
臺東縣,臺東市,0016,467,161,628,92,720,1299,55.43%,35.95%,1
臺東縣,臺東市,0017,339,114,453,32,485,811,59.8%,41.8%,1
臺東縣,臺東市,0018,355,90,445,44,489,764,64.01%,46.47%,1
臺東縣,臺東市,0019,282,104,386,11,397,784,50.64%,35.97%,1
臺東縣,臺東市,0020,145,49,194,14,208,427,48.71%,33.96%,1
臺東縣,臺東市,0021,493,115,608,29,637,1292,49.3%,38.16%,1
臺東縣,臺東市,0022,664,153,817,16,833,1501,55.5%,44.24%,1
臺東縣,臺東市,0023,206,66,272,24,296,601,49.25%,34.28%,1
臺東縣,臺東市,0024,151,41,192,11,203,417,48.68%,36.21%,1
臺東縣,臺東市,0025,397,106,503,48,551,1001,55.04%,39.66%,1
臺東縣,臺東市,0026,712,185,897,53,950,1638,58%,43.47%,1
臺東縣,臺東市,0027,655,157,812,57,869,1576,55.14%,41.56%,1
臺東縣,臺東市,0028,679,147,826,66,892,1595,55.92%,42.57%,1
臺東縣,臺東市,0029,750,174,924,44,968,1734,55.82%,43.25%,1
臺東縣,臺東市,0030,612,163,775,67,842,1476,57.05%,41.46%,1
臺東縣,臺東市,0031,700,180,880,44,924,1545,59.81%,45.31%,1
臺東縣,臺東市,0032,595,134,729,56,785,1313,59.79%,45.32%,1
臺東縣,臺東市,0033,632,135,767,51,818,1338,61.14%,47.23%,1
臺東縣,臺東市,0034,564,99,663,36,699,1312,53.28%,42.99%,1
臺東縣,臺東市,0035,552,146,698,47,745,1265,58.89%,43.64%,1
臺東縣,臺東市,0036,450,158,608,69,677,1407,48.12%,31.98%,1
臺東縣,臺東市,0037,572,133,705,52,757,1552,48.78%,36.86%,1
臺東縣,臺東市,0038,574,164,738,72,810,1445,56.06%,39.72%,1
臺東縣,臺東市,0039,877,232,1109,77,1186,2098,56.53%,41.8%,1
臺東縣,臺東市,0040,544,153,697,83,780,1324,58.91%,41.09%,1
臺東縣,臺東市,0041,633,165,798,42,840,1598,52.57%,39.61%,1
臺東縣,臺東市,0042,605,138,743,30,773,1513,51.09%,39.99%,1
臺東縣,臺東市,0043,641,170,811,38,849,1679,50.57%,38.18%,1
臺東縣,臺東市,0044,517,155,672,67,739,1414,52.26%,36.56%,1
臺東縣,臺東市,0045,692,186,878,67,945,1798,52.56%,38.49%,1
臺東縣,臺東市,0046,548,188,736,66,802,1749,45.85%,31.33%,1
臺東縣,臺東市,0047,650,191,841,92,933,1709,54.59%,38.03%,1
臺東縣,臺東市,0048,617,140,757,67,824,1629,50.58%,37.88%,1
臺東縣,臺東市,0049,401,121,522,69,591,1116,52.96%,35.93%,1
臺東縣,臺東市,0050,398,110,508,31,539,1259,42.81%,31.61%,1
臺東縣,臺東市,0051,380,130,510,44,554,1232,44.97%,30.84%,1
臺東縣,臺東市,0052,480,182,662,110,772,1505,51.3%,31.89%,1
臺東縣,臺東市,0053,272,71,343,61,404,836,48.33%,32.54%,1
臺東縣,臺東市,0054,529,157,686,48,734,1294,56.72%,40.88%,1
臺東縣,臺東市,0055,499,157,656,63,719,1350,53.26%,36.96%,1
臺東縣,臺東市,0056,910,209,1119,77,1196,2162,55.32%,42.09%,1
臺東縣,臺東市,0057,734,171,905,60,965,1627,59.31%,45.11%,1
臺東縣,臺東市,0058,477,137,614,57,671,1140,58.86%,41.84%,1
臺東縣,臺東市,0059,538,113,651,47,698,1359,51.36%,39.59%,1
臺東縣,臺東市,0060,525,155,680,59,739,1329,55.61%,39.5%,1
臺東縣,臺東市,0061,366,107,473,42,515,990,52.02%,36.97%,1
臺東縣,臺東市,0062,407,121,528,59,587,1038,56.55%,39.21%,1
臺東縣,臺東市,0063,582,174,756,82,838,1597,52.47%,36.44%,1
臺東縣,臺東市,0064,478,172,650,94,744,1385,53.72%,34.51%,1
臺東縣,臺東市,0065,307,81,388,21,409,939,43.56%,32.69%,1
臺東縣,臺東市,0066,374,125,499,56,555,1258,44.12%,29.73%,1
臺東縣,臺東市,0067,450,171,621,5,626,1350,46.37%,33.33%,1
臺東縣,臺東市,0068,357,83,440,34,474,1058,44.8%,33.74%,1
臺東縣,臺東市,0069,256,81,337,30,367,895,41.01%,28.6%,1
臺東縣,成功鎮,0070,164,49,213,41,254,516,49.22%,31.78%,1
臺東縣,成功鎮,0071,367,145,512,81,593,960,61.77%,38.23%,1
臺東縣,成功鎮,0072,83,19,102,17,119,365,32.6%,22.74%,1
臺東縣,成功鎮,0073,193,84,277,68,345,747,46.18%,25.84%,1
臺東縣,成功鎮,0074,102,37,139,21,160,339,47.2%,30.09%,1
臺東縣,成功鎮,0075,332,91,423,27,450,995,45.23%,33.37%,1
臺東縣,成功鎮,0076,325,101,426,57,483,863,55.97%,37.66%,1
臺東縣,成功鎮,0077,354,103,457,46,503,931,54.03%,38.02%,1
臺東縣,成功鎮,0078,389,79,468,27,495,970,51.03%,40.1%,1
臺東縣,成功鎮,0079,476,114,590,104,694,1365,50.84%,34.87%,1
臺東縣,成功鎮,0080,501,126,627,89,716,1366,52.42%,36.68%,1
臺東縣,成功鎮,0081,148,55,203,60,263,516,50.97%,28.68%,1
臺東縣,成功鎮,0082,223,65,288,83,371,887,41.83%,25.14%,1
臺東縣,成功鎮,0083,125,41,166,52,218,488,44.67%,25.61%,1
臺東縣,成功鎮,0084,114,37,151,43,194,481,40.33%,23.7%,1
臺東縣,成功鎮,0085,54,17,71,2,73,373,19.57%,14.48%,1
臺東縣,成功鎮,0086,84,34,118,28,146,264,55.3%,31.82%,1
臺東縣,關山鎮,0087,406,106,512,25,537,909,59.08%,44.66%,1
臺東縣,關山鎮,0088,240,77,317,19,336,790,42.53%,30.38%,1
臺東縣,關山鎮,0089,364,93,457,43,500,828,60.39%,43.96%,1
臺東縣,關山鎮,0090,268,74,342,25,367,887,41.38%,30.21%,1
臺東縣,關山鎮,0091,470,114,584,32,616,1137,54.18%,41.34%,1
臺東縣,關山鎮,0092,240,76,316,34,350,732,47.81%,32.79%,1
臺東縣,關山鎮,0093,324,98,422,43,465,912,50.99%,35.53%,1
臺東縣,關山鎮,0094,208,73,281,18,299,779,38.38%,26.7%,1
臺東縣,關山鎮,0095,144,39,183,20,203,535,37.94%,26.92%,1
臺東縣,卑南鄉,0096,379,147,526,73,599,1041,57.54%,36.41%,1
臺東縣,卑南鄉,0097,426,100,526,39,565,1165,48.5%,36.57%,1
臺東縣,卑南鄉,0098,50,24,74,22,96,219,43.84%,22.83%,1
臺東縣,卑南鄉,0099,128,50,178,36,214,460,46.52%,27.83%,1
臺東縣,卑南鄉,0100,110,30,140,15,155,387,40.05%,28.42%,1
臺東縣,卑南鄉,0101,226,74,300,29,329,767,42.89%,29.47%,1
臺東縣,卑南鄉,0102,186,49,235,35,270,503,53.68%,36.98%,1
臺東縣,卑南鄉,0103,232,71,303,43,346,727,47.59%,31.91%,1
臺東縣,卑南鄉,0104,149,48,197,31,228,436,52.29%,34.17%,1
臺東縣,卑南鄉,0105,51,37,88,8,96,261,36.78%,19.54%,1
臺東縣,卑南鄉,0106,74,28,102,13,115,215,53.49%,34.42%,1
臺東縣,卑南鄉,0107,587,162,749,52,801,1442,55.55%,40.71%,1
臺東縣,卑南鄉,0108,203,42,245,17,262,527,49.72%,38.52%,1
臺東縣,卑南鄉,0109,394,129,523,56,579,1046,55.35%,37.67%,1
臺東縣,卑南鄉,0110,370,152,522,72,594,1110,53.51%,33.33%,1
臺東縣,卑南鄉,0111,442,134,576,49,625,1105,56.56%,40%,1
臺東縣,卑南鄉,0112,437,161,598,128,726,1167,62.21%,37.45%,1
臺東縣,卑南鄉,0113,301,120,421,49,470,968,48.55%,31.1%,1
臺東縣,卑南鄉,0114,38,16,54,5,59,159,37.11%,23.9%,1
臺東縣,卑南鄉,0115,165,31,196,23,219,488,44.88%,33.81%,1
臺東縣,卑南鄉,0116,151,34,185,19,204,347,58.79%,43.52%,1
臺東縣,卑南鄉,0117,161,38,199,26,225,436,51.61%,36.93%,1
臺東縣,鹿野鄉,0118,139,41,180,9,189,522,36.21%,26.63%,1
臺東縣,鹿野鄉,0119,216,63,279,28,307,574,53.48%,37.63%,1
臺東縣,鹿野鄉,0120,282,99,381,34,415,1055,39.34%,26.73%,1
臺東縣,鹿野鄉,0121,365,109,474,38,512,1104,46.38%,33.06%,1
臺東縣,鹿野鄉,0122,113,24,137,17,154,342,45.03%,33.04%,1
臺東縣,鹿野鄉,0123,273,88,361,58,419,895,46.82%,30.5%,1
臺東縣,鹿野鄉,0124,245,106,351,56,407,864,47.11%,28.36%,1
臺東縣,鹿野鄉,0125,157,79,236,52,288,675,42.67%,23.26%,1
臺東縣,鹿野鄉,0126,137,53,190,23,213,435,48.97%,31.49%,1
臺東縣,鹿野鄉,0127,110,45,155,27,182,470,38.72%,23.4%,1
臺東縣,池上鄉,0128,337,99,436,24,460,992,46.37%,33.97%,1
臺東縣,池上鄉,0129,355,99,454,54,508,929,54.68%,38.21%,1
臺東縣,池上鄉,0130,134,47,181,29,210,434,48.39%,30.88%,1
臺東縣,池上鄉,0131,186,86,272,33,305,703,43.39%,26.46%,1
臺東縣,池上鄉,0132,187,53,240,22,262,654,40.06%,28.59%,1
臺東縣,池上鄉,0133,79,33,112,16,128,324,39.51%,24.38%,1
臺東縣,池上鄉,0134,234,82,316,40,356,794,44.84%,29.47%,1
臺東縣,池上鄉,0135,277,88,365,48,413,856,48.25%,32.36%,1
臺東縣,池上鄉,0136,105,23,128,12,140,344,40.7%,30.52%,1
臺東縣,池上鄉,0137,115,34,149,23,172,311,55.31%,36.98%,1
臺東縣,池上鄉,0138,81,36,117,19,136,386,35.23%,20.98%,1
臺東縣,池上鄉,0139,90,39,129,22,151,435,34.71%,20.69%,1
臺東縣,東河鄉,0140,73,23,96,26,122,290,42.07%,25.17%,1
臺東縣,東河鄉,0141,221,77,298,38,336,620,54.19%,35.65%,1
臺東縣,東河鄉,0142,443,185,628,108,736,1196,61.54%,37.04%,1
臺東縣,東河鄉,0143,260,84,344,84,428,918,46.62%,28.32%,1
臺東縣,東河鄉,0144,165,49,214,41,255,555,45.95%,29.73%,1
臺東縣,東河鄉,0145,264,101,365,30,395,977,40.43%,27.02%,1
臺東縣,東河鄉,0146,206,70,276,12,288,1197,24.06%,17.21%,1
臺東縣,東河鄉,0147,126,51,177,33,210,867,24.22%,14.53%,1
臺東縣,東河鄉,0148,96,30,126,22,148,345,42.9%,27.83%,1
臺東縣,東河鄉,0149,100,46,146,22,168,408,41.18%,24.51%,1
臺東縣,東河鄉,0150,83,23,106,8,114,262,43.51%,31.68%,1
臺東縣,長濱鄉,0151,166,90,256,53,309,536,57.65%,30.97%,1
臺東縣,長濱鄉,0152,149,45,194,27,221,689,32.08%,21.63%,1
臺東縣,長濱鄉,0153,280,107,387,112,499,913,54.65%,30.67%,1
臺東縣,長濱鄉,0154,321,79,400,27,427,1268,33.68%,25.32%,1
臺東縣,長濱鄉,0155,190,78,268,67,335,725,46.21%,26.21%,1
臺東縣,長濱鄉,0156,89,34,123,10,133,532,25%,16.73%,1
臺東縣,長濱鄉,0157,148,62,210,69,279,660,42.27%,22.42%,1
臺東縣,長濱鄉,0158,48,11,59,4,63,336,18.75%,14.29%,1
臺東縣,長濱鄉,0159,37,14,51,13,64,195,32.82%,18.97%,1
臺東縣,長濱鄉,0160,8,3,11,2,13,25,52%,32%,1
臺東縣,長濱鄉,0161,142,44,186,64,250,605,41.32%,23.47%,1
臺東縣,太麻里鄉,0162,274,63,337,47,384,722,53.19%,37.95%,1
臺東縣,太麻里鄉,0163,196,69,265,26,291,575,50.61%,34.09%,1
臺東縣,太麻里鄉,0164,203,70,273,37,310,623,49.76%,32.58%,1
臺東縣,太麻里鄉,0165,185,61,246,49,295,622,47.43%,29.74%,1
臺東縣,太麻里鄉,0166,154,37,191,11,202,560,36.07%,27.5%,1
臺東縣,太麻里鄉,0167,338,100,438,101,539,957,56.32%,35.32%,1
臺東縣,太麻里鄉,0168,211,109,320,38,358,809,44.25%,26.08%,1
臺東縣,太麻里鄉,0169,283,83,366,48,414,673,61.52%,42.05%,1
臺東縣,太麻里鄉,0170,255,74,329,50,379,737,51.42%,34.6%,1
臺東縣,太麻里鄉,0171,140,67,207,31,238,424,56.13%,33.02%,1
臺東縣,太麻里鄉,0172,98,58,156,23,179,374,47.86%,26.2%,1
臺東縣,太麻里鄉,0173,195,62,257,20,277,829,33.41%,23.52%,1
臺東縣,太麻里鄉,0174,199,62,261,9,270,869,31.07%,22.9%,1
臺東縣,太麻里鄉,0175,49,10,59,5,64,223,28.7%,21.97%,1
臺東縣,太麻里鄉,0176,229,83,312,50,362,669,54.11%,34.23%,1
臺東縣,大武鄉,0177,189,73,262,68,330,568,58.1%,33.27%,1
臺東縣,大武鄉,0178,433,134,567,153,720,1474,48.85%,29.38%,1
臺東縣,大武鄉,0179,450,140,590,116,706,1327,53.2%,33.91%,1
臺東縣,大武鄉,0180,298,120,418,117,535,1134,47.18%,26.28%,1
臺東縣,大武鄉,0181,102,51,153,60,213,386,55.18%,26.42%,1
臺東縣,大武鄉,0182,91,47,138,29,167,377,44.3%,24.14%,1
臺東縣,綠島鄉,0183,448,115,563,35,598,1474,40.57%,30.39%,1
臺東縣,綠島鄉,0184,346,98,444,28,472,1082,43.62%,31.98%,1
臺東縣,綠島鄉,0185,272,83,355,26,381,813,46.86%,33.46%,1
臺東縣,綠島鄉,0186,73,21,94,3,97,210,46.19%,34.76%,1
臺東縣,海端鄉,0187,164,58,222,41,263,497,52.92%,33%,1
臺東縣,海端鄉,0188,219,80,299,31,330,569,58%,38.49%,1
臺東縣,海端鄉,0189,311,109,420,60,480,971,49.43%,32.03%,1
臺東縣,海端鄉,0190,250,102,352,41,393,728,53.98%,34.34%,1
臺東縣,海端鄉,0191,83,38,121,19,140,259,54.05%,32.05%,1
臺東縣,海端鄉,0192,75,37,112,14,126,254,49.61%,29.53%,1
臺東縣,延平鄉,0193,341,104,445,55,500,1014,49.31%,33.63%,1
臺東縣,延平鄉,0194,155,78,233,63,296,426,69.48%,36.38%,1
臺東縣,延平鄉,0195,141,42,183,25,208,315,66.03%,44.76%,1
臺東縣,延平鄉,0196,157,56,213,19,232,579,40.07%,27.12%,1
臺東縣,延平鄉,0197,185,66,251,24,275,596,46.14%,31.04%,1
臺東縣,金峰鄉,0198,339,136,475,62,537,1241,43.27%,27.32%,1
臺東縣,金峰鄉,0199,225,82,307,38,345,601,57.4%,37.44%,1
臺東縣,金峰鄉,0200,256,86,342,51,393,520,75.58%,49.23%,1
臺東縣,金峰鄉,0201,109,54,163,26,189,336,56.25%,32.44%,1
臺東縣,金峰鄉,0202,82,38,120,33,153,330,46.36%,24.85%,1
臺東縣,達仁鄉,0203,101,29,130,24,154,246,62.6%,41.06%,1
臺東縣,達仁鄉,0204,171,33,204,14,218,340,64.12%,50.29%,1
臺東縣,達仁鄉,0205,148,35,183,12,195,296,65.88%,50%,1
臺東縣,達仁鄉,0206,173,55,228,37,265,429,61.77%,40.33%,1
臺東縣,達仁鄉,0207,138,48,186,25,211,331,63.75%,41.69%,1
臺東縣,達仁鄉,0208,166,70,236,23,259,628,41.24%,26.43%,1
臺東縣,達仁鄉,0209,294,118,412,51,463,867,53.4%,33.91%,1
臺東縣,蘭嶼鄉,0210,245,91,336,34,370,943,39.24%,25.98%,1
臺東縣,蘭嶼鄉,0211,350,140,490,39,529,1238,42.73%,28.27%,1
臺東縣,蘭嶼鄉,0212,219,128,347,18,365,1240,29.44%,17.66%,1
臺東縣,蘭嶼鄉,0213,158,84,242,37,279,760,36.71%,20.79%,1
澎湖縣,馬公市,0001,164,44,208,15,223,481,46.36%,34.1%,1
澎湖縣,馬公市,0002,218,48,266,18,284,558,50.9%,39.07%,1
澎湖縣,馬公市,0003,169,52,221,42,263,533,49.34%,31.71%,1
澎湖縣,馬公市,0004,303,108,411,34,445,922,48.26%,32.86%,1
澎湖縣,馬公市,0005,387,114,501,37,538,1021,52.69%,37.9%,1
澎湖縣,馬公市,0006,291,78,369,34,403,793,50.82%,36.7%,1
澎湖縣,馬公市,0007,367,101,468,41,509,954,53.35%,38.47%,1
澎湖縣,馬公市,0008,370,91,461,32,493,1001,49.25%,36.96%,1
澎湖縣,馬公市,0009,380,105,485,43,528,1192,44.3%,31.88%,1
澎湖縣,馬公市,0010,486,123,609,46,655,1402,46.72%,34.66%,1
澎湖縣,馬公市,0011,551,110,661,30,691,1389,49.75%,39.67%,1
澎湖縣,馬公市,0012,521,123,644,44,688,1339,51.38%,38.91%,1
澎湖縣,馬公市,0013,416,117,533,53,586,1254,46.73%,33.17%,1
澎湖縣,馬公市,0014,443,103,546,53,599,1194,50.17%,37.1%,1
澎湖縣,馬公市,0015,461,148,609,63,672,1393,48.24%,33.09%,1
澎湖縣,馬公市,0016,578,130,708,42,750,1440,52.08%,40.14%,1
澎湖縣,馬公市,0017,420,120,540,53,593,1215,48.81%,34.57%,1
澎湖縣,馬公市,0018,486,94,580,51,631,1284,49.14%,37.85%,1
澎湖縣,馬公市,0019,542,142,684,67,751,1512,49.67%,35.85%,1
澎湖縣,馬公市,0020,397,110,507,60,567,1181,48.01%,33.62%,1
澎湖縣,馬公市,0021,518,113,631,40,671,1348,49.78%,38.43%,1
澎湖縣,馬公市,0022,550,138,688,27,715,1391,51.4%,39.54%,1
澎湖縣,馬公市,0023,656,252,908,39,947,2124,44.59%,30.89%,1
澎湖縣,馬公市,0024,553,130,683,58,741,1500,49.4%,36.87%,1
澎湖縣,馬公市,0025,623,117,740,34,774,1582,48.93%,39.38%,1
澎湖縣,馬公市,0026,607,145,752,40,792,1638,48.35%,37.06%,1
澎湖縣,馬公市,0027,611,150,761,49,810,1554,52.12%,39.32%,1
澎湖縣,馬公市,0028,289,60,349,27,376,980,38.37%,29.49%,1
澎湖縣,馬公市,0029,345,67,412,33,445,892,49.89%,38.68%,1
澎湖縣,馬公市,0030,268,38,306,15,321,778,41.26%,34.45%,1
澎湖縣,馬公市,0031,361,79,440,31,471,930,50.65%,38.82%,1
澎湖縣,馬公市,0032,681,133,814,38,852,1481,57.53%,45.98%,1
澎湖縣,馬公市,0033,462,108,570,22,592,1128,52.48%,40.96%,1
澎湖縣,馬公市,0034,150,38,188,28,216,415,52.05%,36.14%,1
澎湖縣,馬公市,0035,438,77,515,42,557,1120,49.73%,39.11%,1
澎湖縣,馬公市,0036,411,71,482,32,514,950,54.11%,43.26%,1
澎湖縣,馬公市,0037,207,49,256,24,280,627,44.66%,33.01%,1
澎湖縣,馬公市,0038,409,82,491,21,512,1055,48.53%,38.77%,1
澎湖縣,馬公市,0039,385,89,474,40,514,989,51.97%,38.93%,1
澎湖縣,馬公市,0040,235,61,296,33,329,591,55.67%,39.76%,1
澎湖縣,馬公市,0041,453,133,586,71,657,1387,47.37%,32.66%,1
澎湖縣,馬公市,0042,307,102,409,56,465,1079,43.1%,28.45%,1
澎湖縣,馬公市,0043,289,65,354,43,397,797,49.81%,36.26%,1
澎湖縣,馬公市,0044,287,72,359,21,380,903,42.08%,31.78%,1
澎湖縣,馬公市,0045,118,33,151,23,174,376,46.28%,31.38%,1
澎湖縣,馬公市,0046,130,47,177,17,194,371,52.29%,35.04%,1
澎湖縣,馬公市,0047,340,83,423,18,441,1173,37.6%,28.99%,1
澎湖縣,馬公市,0048,335,90,425,29,454,1389,32.69%,24.12%,1
澎湖縣,馬公市,0049,108,46,154,59,213,761,27.99%,14.19%,1
澎湖縣,馬公市,0050,114,41,155,21,176,288,61.11%,39.58%,1
澎湖縣,湖西鄉,0051,430,81,511,61,572,1120,51.07%,38.39%,1
澎湖縣,湖西鄉,0052,101,26,127,13,140,332,42.17%,30.42%,1
澎湖縣,湖西鄉,0053,64,21,85,2,87,242,35.95%,26.45%,1
澎湖縣,湖西鄉,0054,67,23,90,9,99,293,33.79%,22.87%,1
澎湖縣,湖西鄉,0055,172,53,225,48,273,666,40.99%,25.83%,1
澎湖縣,湖西鄉,0056,118,25,143,19,162,326,49.69%,36.2%,1
澎湖縣,湖西鄉,0057,199,51,250,17,267,732,36.48%,27.19%,1
澎湖縣,湖西鄉,0058,234,39,273,24,297,651,45.62%,35.94%,1
澎湖縣,湖西鄉,0059,237,60,297,12,309,744,41.53%,31.85%,1
澎湖縣,湖西鄉,0060,56,15,71,3,74,134,55.22%,41.79%,1
澎湖縣,湖西鄉,0061,188,49,237,22,259,794,32.62%,23.68%,1
澎湖縣,湖西鄉,0062,65,11,76,2,78,216,36.11%,30.09%,1
澎湖縣,湖西鄉,0063,143,41,184,9,193,664,29.07%,21.54%,1
澎湖縣,湖西鄉,0064,99,26,125,5,130,279,46.59%,35.48%,1
澎湖縣,湖西鄉,0065,113,25,138,7,145,296,48.99%,38.18%,1
澎湖縣,湖西鄉,0066,96,16,112,6,118,257,45.91%,37.35%,1
澎湖縣,湖西鄉,0067,22,4,26,1,27,89,30.34%,24.72%,1
澎湖縣,湖西鄉,0068,265,89,354,29,383,815,46.99%,32.52%,1
澎湖縣,湖西鄉,0069,287,70,357,21,378,975,38.77%,29.44%,1
澎湖縣,湖西鄉,0070,222,51,273,42,315,648,48.61%,34.26%,1
澎湖縣,湖西鄉,0071,266,68,334,23,357,893,39.98%,29.79%,1
澎湖縣,湖西鄉,0072,283,79,362,76,438,846,51.77%,33.45%,1
澎湖縣,湖西鄉,0073,168,65,233,18,251,729,34.43%,23.05%,1
澎湖縣,白沙鄉,0074,167,70,237,18,255,514,49.61%,32.49%,1
澎湖縣,白沙鄉,0075,235,80,315,18,333,657,50.68%,35.77%,1
澎湖縣,白沙鄉,0076,56,11,67,5,72,109,66.06%,51.38%,1
澎湖縣,白沙鄉,0077,54,7,61,4,65,156,41.67%,34.62%,1
澎湖縣,白沙鄉,0078,84,30,114,6,120,293,40.96%,28.67%,1
澎湖縣,白沙鄉,0079,58,11,69,2,71,231,30.74%,25.11%,1
澎湖縣,白沙鄉,0080,58,20,78,9,87,161,54.04%,36.02%,1
澎湖縣,白沙鄉,0081,581,142,723,60,783,1705,45.92%,34.08%,1
澎湖縣,白沙鄉,0082,90,23,113,8,121,285,42.46%,31.58%,1
澎湖縣,白沙鄉,0083,142,57,199,11,210,723,29.05%,19.64%,1
澎湖縣,白沙鄉,0084,197,59,256,29,285,774,36.82%,25.45%,1
澎湖縣,白沙鄉,0085,260,118,378,108,486,1429,34.01%,18.19%,1
澎湖縣,白沙鄉,0086,354,72,426,73,499,1084,46.03%,32.66%,1
澎湖縣,白沙鄉,0087,99,21,120,5,125,251,49.8%,39.44%,1
澎湖縣,白沙鄉,0088,52,20,72,16,88,253,34.78%,20.55%,1
澎湖縣,西嶼鄉,0089,28,13,41,1,42,283,14.84%,9.89%,1
澎湖縣,西嶼鄉,0090,84,24,108,14,122,424,28.77%,19.81%,1
澎湖縣,西嶼鄉,0091,181,55,236,48,284,826,34.38%,21.91%,1
澎湖縣,西嶼鄉,0092,63,32,95,10,105,282,37.23%,22.34%,1
澎湖縣,西嶼鄉,0093,136,59,195,55,250,661,37.82%,20.57%,1
澎湖縣,西嶼鄉,0094,16,7,23,4,27,141,19.15%,11.35%,1
澎湖縣,西嶼鄉,0095,132,32,164,12,176,635,27.72%,20.79%,1
澎湖縣,西嶼鄉,0096,49,13,62,4,66,216,30.56%,22.69%,1
澎湖縣,西嶼鄉,0097,84,22,106,26,132,572,23.08%,14.69%,1
澎湖縣,西嶼鄉,0098,316,93,409,90,499,1267,39.38%,24.94%,1
澎湖縣,西嶼鄉,0099,201,73,274,24,298,942,31.63%,21.34%,1
澎湖縣,西嶼鄉,0100,255,99,354,74,428,1133,37.78%,22.51%,1
澎湖縣,望安鄉,0101,226,62,288,39,327,734,44.55%,30.79%,1
澎湖縣,望安鄉,0102,131,28,159,31,190,454,41.85%,28.85%,1
澎湖縣,望安鄉,0103,58,19,77,15,92,300,30.67%,19.33%,1
澎湖縣,望安鄉,0104,135,62,197,41,238,471,50.53%,28.66%,1
澎湖縣,望安鄉,0105,147,35,182,21,203,672,30.21%,21.88%,1
澎湖縣,望安鄉,0106,163,83,246,52,298,742,40.16%,21.97%,1
澎湖縣,望安鄉,0107,64,28,92,16,108,264,40.91%,24.24%,1
澎湖縣,望安鄉,0108,129,34,163,7,170,476,35.71%,27.1%,1
澎湖縣,望安鄉,0109,26,11,37,5,42,208,20.19%,12.5%,1
澎湖縣,望安鄉,0110,67,18,85,6,91,307,29.64%,21.82%,1
澎湖縣,七美鄉,0111,45,16,61,5,66,248,26.61%,18.15%,1
澎湖縣,七美鄉,0112,122,50,172,32,204,581,35.11%,21%,1
澎湖縣,七美鄉,0113,139,50,189,35,224,641,34.95%,21.68%,1
澎湖縣,七美鄉,0114,87,20,107,5,112,382,29.32%,22.77%,1
澎湖縣,七美鄉,0115,51,15,66,6,72,351,20.51%,14.53%,1
澎湖縣,七美鄉,0116,216,64,280,35,315,1171,26.9%,18.45%,1
金門縣,金城鎮,0001,400,67,467,25,492,1396,35.24%,28.65%,1
金門縣,金城鎮,0002,504,124,628,60,688,1831,37.58%,27.53%,1
金門縣,金城鎮,0003,487,104,591,47,638,1750,36.46%,27.83%,1
金門縣,金城鎮,0004,570,94,664,54,718,1889,38.01%,30.17%,1
金門縣,金城鎮,0005,411,90,501,36,537,1675,32.06%,24.54%,1
金門縣,金城鎮,0006,626,106,732,48,780,1901,41.03%,32.93%,1
金門縣,金城鎮,0007,395,99,494,62,556,1610,34.53%,24.53%,1
金門縣,金城鎮,0008,484,85,569,33,602,1687,35.68%,28.69%,1
金門縣,金城鎮,0009,474,79,553,27,580,1594,36.39%,29.74%,1
金門縣,金城鎮,0010,488,83,571,27,598,1726,34.65%,28.27%,1
金門縣,金城鎮,0011,505,93,598,33,631,1733,36.41%,29.14%,1
金門縣,金城鎮,0012,508,88,596,29,625,1532,40.8%,33.16%,1
金門縣,金城鎮,0013,554,108,662,59,721,2079,34.68%,26.65%,1
金門縣,金城鎮,0014,529,81,610,39,649,2033,31.92%,26.02%,1
金門縣,金城鎮,0015,709,127,836,46,882,2517,35.04%,28.17%,1
金門縣,金城鎮,0016,569,114,683,43,726,2083,34.85%,27.32%,1
金門縣,金城鎮,0017,586,107,693,41,734,2140,34.3%,27.38%,1
金門縣,金城鎮,0018,549,98,647,60,707,2435,29.03%,22.55%,1
金門縣,金城鎮,0019,239,63,302,43,345,1353,25.5%,17.66%,1
金門縣,金城鎮,0020,398,76,474,22,496,1574,31.51%,25.29%,1
金門縣,金城鎮,0021,372,68,440,38,478,1277,37.43%,29.13%,1
金門縣,金沙鎮,0066,505,98,603,52,655,1909,34.31%,26.45%,1
金門縣,金沙鎮,0067,487,87,574,51,625,1524,41.01%,31.96%,1
金門縣,金沙鎮,0068,431,59,490,55,545,1673,32.58%,25.76%,1
金門縣,金沙鎮,0069,502,85,587,73,660,2003,32.95%,25.06%,1
金門縣,金沙鎮,0070,382,81,463,30,493,1212,40.68%,31.52%,1
金門縣,金沙鎮,0071,297,79,376,34,410,1126,36.41%,26.38%,1
金門縣,金沙鎮,0072,371,65,436,43,479,1540,31.1%,24.09%,1
金門縣,金沙鎮,0073,280,59,339,37,376,1216,30.92%,23.03%,1
金門縣,金沙鎮,0074,200,34,234,24,258,950,27.16%,21.05%,1
金門縣,金沙鎮,0075,581,73,654,47,701,1895,36.99%,30.66%,1
金門縣,金沙鎮,0076,357,72,429,34,463,1135,40.79%,31.45%,1
金門縣,金沙鎮,0077,336,60,396,39,435,1252,34.74%,26.84%,1
金門縣,金沙鎮,0078,381,55,436,26,462,1125,41.07%,33.87%,1
金門縣,金湖鎮,0049,401,91,492,48,540,1348,40.06%,29.75%,1
金門縣,金湖鎮,0050,348,91,439,45,484,1386,34.92%,25.11%,1
金門縣,金湖鎮,0051,481,79,560,44,604,1403,43.05%,34.28%,1
金門縣,金湖鎮,0052,540,93,633,40,673,1771,38%,30.49%,1
金門縣,金湖鎮,0053,415,86,501,59,560,1493,37.51%,27.8%,1
金門縣,金湖鎮,0054,399,72,471,64,535,1510,35.43%,26.42%,1
金門縣,金湖鎮,0055,399,64,463,45,508,1607,31.61%,24.83%,1
金門縣,金湖鎮,0056,510,96,606,60,666,2006,33.2%,25.42%,1
金門縣,金湖鎮,0057,431,186,617,26,643,1780,36.12%,24.21%,1
金門縣,金湖鎮,0058,516,88,604,31,635,1739,36.52%,29.67%,1
金門縣,金湖鎮,0059,374,72,446,32,478,1384,34.54%,27.02%,1
金門縣,金湖鎮,0060,397,94,491,37,528,1400,37.71%,28.36%,1
金門縣,金湖鎮,0061,450,102,552,33,585,1325,44.15%,33.96%,1
金門縣,金湖鎮,0062,314,62,376,36,412,1236,33.33%,25.4%,1
金門縣,金湖鎮,0063,347,79,426,45,471,1382,34.08%,25.11%,1
金門縣,金湖鎮,0064,452,66,518,42,560,1631,34.33%,27.71%,1
金門縣,金湖鎮,0065,374,77,451,43,494,1514,32.63%,24.7%,1
金門縣,金寧鄉,0022,388,77,465,76,541,1735,31.18%,22.36%,1
金門縣,金寧鄉,0023,367,83,450,34,484,1537,31.49%,23.88%,1
金門縣,金寧鄉,0024,445,103,548,43,591,1766,33.47%,25.2%,1
金門縣,金寧鄉,0025,303,55,358,17,375,1015,36.95%,29.85%,1
金門縣,金寧鄉,0026,466,91,557,53,610,1726,35.34%,27%,1
金門縣,金寧鄉,0027,414,82,496,36,532,1691,31.46%,24.48%,1
金門縣,金寧鄉,0028,586,237,823,42,865,2044,42.32%,28.67%,1
金門縣,金寧鄉,0029,636,90,726,38,764,1848,41.34%,34.42%,1
金門縣,金寧鄉,0030,498,69,567,31,598,1735,34.47%,28.7%,1
金門縣,金寧鄉,0031,487,100,587,40,627,1795,34.93%,27.13%,1
金門縣,金寧鄉,0032,441,89,530,51,581,1834,31.68%,24.05%,1
金門縣,金寧鄉,0033,433,88,521,31,552,1528,36.13%,28.34%,1
金門縣,金寧鄉,0034,470,72,542,26,568,1473,38.56%,31.91%,1
金門縣,金寧鄉,0035,473,75,548,51,599,1679,35.68%,28.17%,1
金門縣,金寧鄉,0036,661,240,901,30,931,1921,48.46%,34.41%,1
金門縣,金寧鄉,0037,371,78,449,18,467,1298,35.98%,28.58%,1
金門縣,金寧鄉,0038,394,77,471,34,505,1537,32.86%,25.63%,1
金門縣,烈嶼鄉,0039,604,80,684,38,722,1647,43.84%,36.67%,1
金門縣,烈嶼鄉,0040,506,77,583,34,617,1733,35.6%,29.2%,1
金門縣,烈嶼鄉,0041,472,88,560,44,604,1635,36.94%,28.87%,1
金門縣,烈嶼鄉,0042,334,66,400,40,440,1296,33.95%,25.77%,1
金門縣,烈嶼鄉,0043,275,54,329,26,355,1099,32.3%,25.02%,1
金門縣,烈嶼鄉,0044,374,73,447,39,486,1425,34.11%,26.25%,1
金門縣,烈嶼鄉,0045,426,75,501,24,525,1412,37.18%,30.17%,1
金門縣,烈嶼鄉,0046,408,59,467,38,505,1429,35.34%,28.55%,1
金門縣,烏坵鄉,0047,64,10,74,4,78,275,28.36%,23.27%,1
金門縣,烏坵鄉,0048,71,9,80,7,87,292,29.79%,24.32%,1
連江縣,南竿鄉,0001,837,126,963,50,1013,1967,51.5%,42.55%,1
連江縣,南竿鄉,0002,727,111,838,40,878,1837,47.8%,39.58%,1
連江縣,南竿鄉,0003,476,92,568,21,589,1114,52.87%,42.73%,1
連江縣,南竿鄉,0004,706,67,773,21,794,1543,51.46%,45.76%,1
連江縣,北竿鄉,0005,640,130,770,45,815,1515,53.8%,42.24%,1
連江縣,北竿鄉,0006,248,32,280,8,288,610,47.21%,40.66%,1
連江縣,莒光鄉,0007,270,48,318,17,335,698,47.99%,38.68%,1
連江縣,莒光鄉,0008,350,64,414,28,442,783,56.45%,44.7%,1
連江縣,東引鄉,0009,497,66,563,18,581,1138,51.05%,43.67%,1
基隆市,中正區,0001,181,46,227,21,248,466,53.22%,38.84%,1
基隆市,中正區,0002,386,114,500,26,526,1262,41.68%,30.59%,1
基隆市,中正區,0003,344,158,502,52,554,1171,47.31%,29.38%,1
基隆市,中正區,0004,846,187,1033,22,1055,2823,37.37%,29.97%,1
基隆市,中正區,0005,428,152,580,56,636,1474,43.15%,29.04%,1
基隆市,中正區,0006,398,92,490,60,550,1271,43.27%,31.31%,1
基隆市,中正區,0007,831,254,1085,75,1160,2707,42.85%,30.7%,1
基隆市,中正區,0008,564,121,685,65,750,1545,48.54%,36.5%,1
基隆市,中正區,0009,209,44,253,16,269,761,35.35%,27.46%,1
基隆市,中正區,0010,484,142,626,17,643,1352,47.56%,35.8%,1
基隆市,中正區,0011,496,123,619,19,638,1413,45.15%,35.1%,1
基隆市,中正區,0012,869,228,1097,47,1144,2665,42.93%,32.61%,1
基隆市,中正區,0013,394,125,519,68,587,1261,46.55%,31.25%,1
基隆市,中正區,0014,556,226,782,85,867,1753,49.46%,31.72%,1
基隆市,中正區,0015,296,109,405,37,442,984,44.92%,30.08%,1
基隆市,中正區,0016,393,85,478,30,508,1166,43.57%,33.7%,1
基隆市,中正區,0017,339,97,436,33,469,973,48.2%,34.84%,1
基隆市,中正區,0018,461,122,583,30,613,1694,36.19%,27.21%,1
基隆市,中正區,0019,470,130,600,32,632,1270,49.76%,37.01%,1
基隆市,中正區,0020,421,107,528,33,561,1090,51.47%,38.62%,1
基隆市,中正區,0021,321,107,428,19,447,870,51.38%,36.9%,1
基隆市,中正區,0022,407,118,525,48,573,1138,50.35%,35.76%,1
基隆市,中正區,0023,291,77,368,42,410,862,47.56%,33.76%,1
基隆市,中正區,0024,517,155,672,65,737,1341,54.96%,38.55%,1
基隆市,中正區,0025,330,97,427,43,470,859,54.71%,38.42%,1
基隆市,中正區,0026,510,124,634,31,665,1457,45.64%,35%,1
基隆市,中正區,0027,471,123,594,61,655,1594,41.09%,29.55%,1
基隆市,中正區,0028,284,98,382,46,428,802,53.37%,35.41%,1
基隆市,中正區,0029,451,115,566,50,616,1267,48.62%,35.6%,1
基隆市,中正區,0030,406,144,550,66,616,1175,52.43%,34.55%,1
基隆市,中正區,0031,485,148,633,45,678,1210,56.03%,40.08%,1
基隆市,中正區,0032,354,123,477,62,539,1037,51.98%,34.14%,1
基隆市,中正區,0033,438,137,575,59,634,1219,52.01%,35.93%,1
基隆市,中正區,0034,293,110,403,27,430,904,47.57%,32.41%,1
基隆市,中正區,0035,313,100,413,26,439,709,61.92%,44.15%,1
基隆市,七堵區,0219,487,154,641,64,705,1258,56.04%,38.71%,1
基隆市,七堵區,0220,477,157,634,52,686,1237,55.46%,38.56%,1
基隆市,七堵區,0221,472,137,609,32,641,1259,50.91%,37.49%,1
基隆市,七堵區,0222,384,120,504,52,556,1120,49.64%,34.29%,1
基隆市,七堵區,0223,468,122,590,46,636,1344,47.32%,34.82%,1
基隆市,七堵區,0224,449,120,569,47,616,1011,60.93%,44.41%,1
基隆市,七堵區,0225,324,111,435,29,464,925,50.16%,35.03%,1
基隆市,七堵區,0226,718,186,904,64,968,1735,55.79%,41.38%,1
基隆市,七堵區,0227,637,330,967,63,1030,1833,56.19%,34.75%,1
基隆市,七堵區,0228,345,117,462,25,487,938,51.92%,36.78%,1
基隆市,七堵區,0229,411,112,523,49,572,962,59.46%,42.72%,1
基隆市,七堵區,0230,480,158,638,35,673,1191,56.51%,40.3%,1
基隆市,七堵區,0231,399,118,517,45,562,999,56.26%,39.94%,1
基隆市,七堵區,0232,105,24,129,8,137,282,48.58%,37.23%,1
基隆市,七堵區,0233,443,149,592,44,636,1243,51.17%,35.64%,1
基隆市,七堵區,0234,391,124,515,47,562,1092,51.47%,35.81%,1
基隆市,七堵區,0235,456,153,609,59,668,1246,53.61%,36.6%,1
基隆市,七堵區,0236,636,206,842,44,886,1722,51.45%,36.93%,1
基隆市,七堵區,0237,488,158,646,38,684,1318,51.9%,37.03%,1
基隆市,七堵區,0238,341,93,434,18,452,975,46.36%,34.97%,1
基隆市,七堵區,0239,493,149,642,29,671,1285,52.22%,38.37%,1
基隆市,七堵區,0240,364,107,471,46,517,1077,48%,33.8%,1
基隆市,七堵區,0241,333,105,438,29,467,989,47.22%,33.67%,1
基隆市,七堵區,0242,423,130,553,42,595,1193,49.87%,35.46%,1
基隆市,七堵區,0243,464,151,615,49,664,1273,52.16%,36.45%,1
基隆市,七堵區,0244,655,218,873,71,944,1774,53.21%,36.92%,1
基隆市,七堵區,0245,655,180,835,60,895,1689,52.99%,38.78%,1
基隆市,七堵區,0246,510,120,630,60,690,1355,50.92%,37.64%,1
基隆市,七堵區,0247,518,187,705,56,761,1512,50.33%,34.26%,1
基隆市,七堵區,0248,526,153,679,20,699,1486,47.04%,35.4%,1
基隆市,七堵區,0249,662,158,820,24,844,1706,49.47%,38.8%,1
基隆市,七堵區,0250,531,159,690,56,746,1384,53.9%,38.37%,1
基隆市,七堵區,0251,437,150,587,39,626,1045,59.9%,41.82%,1
基隆市,七堵區,0252,546,154,700,31,731,1374,53.2%,39.74%,1
基隆市,七堵區,0253,156,55,211,7,218,428,50.93%,36.45%,1
基隆市,七堵區,0254,114,52,166,30,196,326,60.12%,34.97%,1
基隆市,七堵區,0255,176,49,225,23,248,351,70.66%,50.14%,1
基隆市,七堵區,0256,676,165,841,32,873,1871,46.66%,36.13%,1
基隆市,七堵區,0257,142,52,194,5,199,448,44.42%,31.7%,1
基隆市,暖暖區,0191,495,160,655,45,700,1431,48.92%,34.59%,1
基隆市,暖暖區,0192,158,37,195,7,202,456,44.3%,34.65%,1
基隆市,暖暖區,0193,245,88,333,20,353,637,55.42%,38.46%,1
基隆市,暖暖區,0194,303,94,397,25,422,735,57.41%,41.22%,1
基隆市,暖暖區,0195,380,101,481,26,507,1078,47.03%,35.25%,1
基隆市,暖暖區,0196,447,150,597,38,635,1238,51.29%,36.11%,1
基隆市,暖暖區,0197,513,119,632,37,669,1325,50.49%,38.72%,1
基隆市,暖暖區,0198,581,150,731,39,770,1475,52.2%,39.39%,1
基隆市,暖暖區,0199,385,112,497,28,525,1179,44.53%,32.65%,1
基隆市,暖暖區,0200,474,132,606,40,646,1110,58.2%,42.7%,1
基隆市,暖暖區,0201,498,134,632,26,658,1443,45.6%,34.51%,1
基隆市,暖暖區,0202,146,52,198,25,223,415,53.73%,35.18%,1
基隆市,暖暖區,0203,501,129,630,22,652,1378,47.31%,36.36%,1
基隆市,暖暖區,0204,601,185,786,21,807,1570,51.4%,38.28%,1
基隆市,暖暖區,0205,689,180,869,58,927,1603,57.83%,42.98%,1
基隆市,暖暖區,0206,529,149,678,39,717,1267,56.59%,41.75%,1
基隆市,暖暖區,0207,534,142,676,39,715,1359,52.61%,39.29%,1
基隆市,暖暖區,0208,442,95,537,21,558,970,57.53%,45.57%,1
基隆市,暖暖區,0209,416,74,490,23,513,1002,51.2%,41.52%,1
基隆市,暖暖區,0210,340,106,446,23,469,944,49.68%,36.02%,1
基隆市,暖暖區,0211,615,183,798,42,840,1500,56%,41%,1
基隆市,暖暖區,0212,426,123,549,28,577,1442,40.01%,29.54%,1
基隆市,暖暖區,0213,484,116,600,23,623,1165,53.48%,41.55%,1
基隆市,暖暖區,0214,608,168,776,24,800,1610,49.69%,37.76%,1
基隆市,暖暖區,0215,538,150,688,33,721,1328,54.29%,40.51%,1
基隆市,暖暖區,0216,418,143,561,27,588,1173,50.13%,35.64%,1
基隆市,暖暖區,0217,455,109,564,35,599,1019,58.78%,44.65%,1
基隆市,暖暖區,0218,555,154,709,18,727,1373,52.95%,40.42%,1
基隆市,仁愛區,0072,556,172,728,94,822,1782,46.13%,31.2%,1
基隆市,仁愛區,0073,428,116,544,49,593,1055,56.21%,40.57%,1
基隆市,仁愛區,0074,515,153,668,43,711,1558,45.64%,33.06%,1
基隆市,仁愛區,0075,674,171,845,46,891,1736,51.32%,38.82%,1
基隆市,仁愛區,0076,519,166,685,48,733,1243,58.97%,41.75%,1
基隆市,仁愛區,0077,447,139,586,37,623,1109,56.18%,40.31%,1
基隆市,仁愛區,0078,768,154,922,48,970,1684,57.6%,45.61%,1
基隆市,仁愛區,0079,354,107,461,40,501,919,54.52%,38.52%,1
基隆市,仁愛區,0080,359,131,490,22,512,991,51.66%,36.23%,1
基隆市,仁愛區,0081,355,87,442,22,464,876,52.97%,40.53%,1
基隆市,仁愛區,0082,442,119,561,43,604,1046,57.74%,42.26%,1
基隆市,仁愛區,0083,185,51,236,27,263,434,60.6%,42.63%,1
基隆市,仁愛區,0084,306,91,397,48,445,764,58.25%,40.05%,1
基隆市,仁愛區,0085,341,129,470,26,496,968,51.24%,35.23%,1
基隆市,仁愛區,0086,433,158,591,62,653,1326,49.25%,32.65%,1
基隆市,仁愛區,0087,379,124,503,41,544,1315,41.37%,28.82%,1
基隆市,仁愛區,0088,297,99,396,50,446,775,57.55%,38.32%,1
基隆市,仁愛區,0089,226,104,330,45,375,652,57.52%,34.66%,1
基隆市,仁愛區,0090,265,78,343,34,377,674,55.93%,39.32%,1
基隆市,仁愛區,0091,283,91,374,36,410,789,51.96%,35.87%,1
基隆市,仁愛區,0092,665,173,838,66,904,1715,52.71%,38.78%,1
基隆市,仁愛區,0093,304,97,401,50,451,849,53.12%,35.81%,1
基隆市,仁愛區,0094,353,87,440,29,469,875,53.6%,40.34%,1
基隆市,仁愛區,0095,310,85,395,38,433,851,50.88%,36.43%,1
基隆市,仁愛區,0096,307,90,397,29,426,735,57.96%,41.77%,1
基隆市,仁愛區,0097,347,119,466,69,535,1009,53.02%,34.39%,1
基隆市,仁愛區,0098,350,129,479,49,528,1082,48.8%,32.35%,1
基隆市,仁愛區,0099,438,157,595,66,661,1278,51.72%,34.27%,1
基隆市,仁愛區,0100,681,143,824,45,869,1519,57.21%,44.83%,1
基隆市,仁愛區,0101,419,134,553,41,594,1336,44.46%,31.36%,1
基隆市,仁愛區,0102,479,156,635,57,692,1178,58.74%,40.66%,1
基隆市,仁愛區,0103,259,78,337,44,381,708,53.81%,36.58%,1
基隆市,仁愛區,0104,242,90,332,23,355,567,62.61%,42.68%,1
基隆市,仁愛區,0105,270,93,363,53,416,751,55.39%,35.95%,1
基隆市,仁愛區,0106,240,90,330,23,353,589,59.93%,40.75%,1
基隆市,中山區,0107,293,80,373,28,401,796,50.38%,36.81%,1
基隆市,中山區,0108,483,106,589,49,638,1036,61.58%,46.62%,1
基隆市,中山區,0109,302,86,388,44,432,756,57.14%,39.95%,1
基隆市,中山區,0110,271,112,383,24,407,957,42.53%,28.32%,1
基隆市,中山區,0111,312,78,390,15,405,802,50.5%,38.9%,1
基隆市,中山區,0112,498,133,631,44,675,1263,53.44%,39.43%,1
基隆市,中山區,0113,331,91,422,20,442,778,56.81%,42.54%,1
基隆市,中山區,0114,442,146,588,85,673,1180,57.03%,37.46%,1
基隆市,中山區,0115,336,102,438,25,463,990,46.77%,33.94%,1
基隆市,中山區,0116,394,117,511,31,542,1332,40.69%,29.58%,1
基隆市,中山區,0117,278,79,357,35,392,848,46.23%,32.78%,1
基隆市,中山區,0118,330,80,410,16,426,922,46.2%,35.79%,1
基隆市,中山區,0119,184,76,260,11,271,459,59.04%,40.09%,1
基隆市,中山區,0120,208,39,247,33,280,574,48.78%,36.24%,1
基隆市,中山區,0121,301,101,402,52,454,877,51.77%,34.32%,1
基隆市,中山區,0122,505,165,670,33,703,1584,44.38%,31.88%,1
基隆市,中山區,0123,344,107,451,34,485,1319,36.77%,26.08%,1
基隆市,中山區,0124,702,217,919,58,977,1938,50.41%,36.22%,1
基隆市,中山區,0125,650,184,834,53,887,1877,47.26%,34.63%,1
基隆市,中山區,0126,855,213,1068,30,1098,2088,52.59%,40.95%,1
基隆市,中山區,0127,785,208,993,32,1025,1946,52.67%,40.34%,1
基隆市,中山區,0128,537,169,706,59,765,1353,56.54%,39.69%,1
基隆市,中山區,0129,472,154,626,48,674,1317,51.18%,35.84%,1
基隆市,中山區,0130,351,115,466,30,496,870,57.01%,40.34%,1
基隆市,中山區,0131,560,128,688,28,716,1322,54.16%,42.36%,1
基隆市,中山區,0132,459,120,579,12,591,1295,45.64%,35.44%,1
基隆市,中山區,0133,342,96,438,21,459,756,60.71%,45.24%,1
基隆市,中山區,0134,536,147,683,30,713,1602,44.51%,33.46%,1
基隆市,中山區,0135,536,174,710,38,748,1568,47.7%,34.18%,1
基隆市,中山區,0136,519,186,705,32,737,1404,52.49%,36.97%,1
基隆市,中山區,0137,681,151,832,26,858,1909,44.94%,35.67%,1
基隆市,中山區,0138,498,185,683,72,755,1642,45.98%,30.33%,1
基隆市,中山區,0139,322,91,413,19,432,932,46.35%,34.55%,1
基隆市,中山區,0140,323,142,465,48,513,849,60.42%,38.04%,1
基隆市,中山區,0141,270,109,379,49,428,715,59.86%,37.76%,1
基隆市,安樂區,0142,451,155,606,65,671,1361,49.3%,33.14%,1
基隆市,安樂區,0143,435,109,544,35,579,1213,47.73%,35.86%,1
基隆市,安樂區,0144,317,104,421,29,450,1026,43.86%,30.9%,1
基隆市,安樂區,0145,422,120,542,85,627,1038,60.4%,40.66%,1
基隆市,安樂區,0146,314,137,451,55,506,897,56.41%,35.01%,1
基隆市,安樂區,0147,518,164,682,59,741,1401,52.89%,36.97%,1
基隆市,安樂區,0148,157,49,206,9,215,641,33.54%,24.49%,1
基隆市,安樂區,0149,515,160,675,55,730,1472,49.59%,34.99%,1
基隆市,安樂區,0150,179,49,228,27,255,472,54.03%,37.92%,1
基隆市,安樂區,0151,361,100,461,29,490,841,58.26%,42.93%,1
基隆市,安樂區,0152,204,70,274,29,303,571,53.06%,35.73%,1
基隆市,安樂區,0153,633,204,837,43,880,1901,46.29%,33.3%,1
基隆市,安樂區,0154,487,162,649,46,695,1349,51.52%,36.1%,1
基隆市,安樂區,0155,472,109,581,40,621,1225,50.69%,38.53%,1
基隆市,安樂區,0156,538,153,691,53,744,1351,55.07%,39.82%,1
基隆市,安樂區,0157,706,154,860,47,907,1601,56.65%,44.1%,1
基隆市,安樂區,0158,1042,203,1245,44,1289,2513,51.29%,41.46%,1
基隆市,安樂區,0159,699,136,835,37,872,1613,54.06%,43.34%,1
基隆市,安樂區,0160,703,200,903,36,939,1731,54.25%,40.61%,1
基隆市,安樂區,0161,630,186,816,26,842,1424,59.13%,44.24%,1
基隆市,安樂區,0162,678,176,854,54,908,1806,50.28%,37.54%,1
基隆市,安樂區,0163,716,173,889,48,937,1679,55.81%,42.64%,1
基隆市,安樂區,0164,761,210,971,38,1009,1902,53.05%,40.01%,1
基隆市,安樂區,0165,806,203,1009,40,1049,2040,51.42%,39.51%,1
基隆市,安樂區,0166,514,144,658,47,705,1313,53.69%,39.15%,1
基隆市,安樂區,0167,440,143,583,21,604,1243,48.59%,35.4%,1
基隆市,安樂區,0168,670,186,856,31,887,1759,50.43%,38.09%,1
基隆市,安樂區,0169,309,113,422,15,437,694,62.97%,44.52%,1
基隆市,安樂區,0170,406,126,532,18,550,866,63.51%,46.88%,1
基隆市,安樂區,0171,496,145,641,21,662,1557,42.52%,31.86%,1
基隆市,安樂區,0172,524,152,676,31,707,1411,50.11%,37.14%,1
基隆市,安樂區,0173,703,155,858,31,889,1568,56.7%,44.83%,1
基隆市,安樂區,0174,535,138,673,40,713,1400,50.93%,38.21%,1
基隆市,安樂區,0175,655,103,758,13,771,1531,50.36%,42.78%,1
基隆市,安樂區,0176,632,142,774,19,793,1673,47.4%,37.78%,1
基隆市,安樂區,0177,398,112,510,48,558,1054,52.94%,37.76%,1
基隆市,安樂區,0178,630,144,774,33,807,1923,41.97%,32.76%,1
基隆市,安樂區,0179,771,212,983,63,1046,1960,53.37%,39.34%,1
基隆市,安樂區,0180,710,214,924,214,1138,1962,58%,36.19%,1
基隆市,安樂區,0181,822,211,1033,63,1096,2117,51.77%,38.83%,1
基隆市,安樂區,0182,665,131,796,38,834,1829,45.6%,36.36%,1
基隆市,安樂區,0183,581,125,706,30,736,1529,48.14%,38%,1
基隆市,安樂區,0184,740,172,912,40,952,1869,50.94%,39.59%,1
基隆市,安樂區,0185,508,98,606,14,620,1140,54.39%,44.56%,1
基隆市,安樂區,0186,622,174,796,51,847,1641,51.61%,37.9%,1
基隆市,安樂區,0187,473,147,620,39,659,1279,51.52%,36.98%,1
基隆市,安樂區,0188,542,122,664,24,688,1360,50.59%,39.85%,1
基隆市,安樂區,0189,547,176,723,36,759,1399,54.25%,39.1%,1
基隆市,安樂區,0190,480,131,611,30,641,1251,51.24%,38.37%,1
基隆市,信義區,0036,426,120,546,45,591,1096,53.92%,38.87%,1
基隆市,信義區,0037,546,150,696,37,733,1232,59.5%,44.32%,1
基隆市,信義區,0038,464,131,595,17,612,1184,51.69%,39.19%,1
基隆市,信義區,0039,470,130,600,63,663,1133,58.52%,41.48%,1
基隆市,信義區,0040,485,133,618,41,659,1188,55.47%,40.82%,1
基隆市,信義區,0041,287,96,383,39,422,725,58.21%,39.59%,1
基隆市,信義區,0042,518,159,677,43,720,1524,47.24%,33.99%,1
基隆市,信義區,0043,279,84,363,34,397,736,53.94%,37.91%,1
基隆市,信義區,0044,226,57,283,23,306,611,50.08%,36.99%,1
基隆市,信義區,0045,301,107,408,16,424,951,44.58%,31.65%,1
基隆市,信義區,0046,617,164,781,40,821,1616,50.8%,38.18%,1
基隆市,信義區,0047,625,157,782,35,817,1516,53.89%,41.23%,1
基隆市,信義區,0048,403,111,514,24,538,1049,51.29%,38.42%,1
基隆市,信義區,0049,402,122,524,29,553,1069,51.73%,37.61%,1
基隆市,信義區,0050,311,84,395,25,420,727,57.77%,42.78%,1
基隆市,信義區,0051,436,87,523,20,543,929,58.45%,46.93%,1
基隆市,信義區,0052,500,152,652,38,690,1118,61.72%,44.72%,1
基隆市,信義區,0053,564,146,710,41,751,1339,56.09%,42.12%,1
基隆市,信義區,0054,398,90,488,20,508,999,50.85%,39.84%,1
基隆市,信義區,0055,287,79,366,14,380,764,49.74%,37.57%,1
基隆市,信義區,0056,564,149,713,30,743,1555,47.78%,36.27%,1
基隆市,信義區,0057,734,200,934,30,964,2015,47.84%,36.43%,1
基隆市,信義區,0058,564,114,678,42,720,1268,56.78%,44.48%,1
基隆市,信義區,0059,615,151,766,60,826,1569,52.64%,39.2%,1
基隆市,信義區,0060,723,168,891,62,953,1985,48.01%,36.42%,1
基隆市,信義區,0061,656,117,773,28,801,1476,54.27%,44.44%,1
基隆市,信義區,0062,648,161,809,28,837,1493,56.06%,43.4%,1
基隆市,信義區,0063,589,134,723,27,750,1249,60.05%,47.16%,1
基隆市,信義區,0064,581,158,739,22,761,1559,48.81%,37.27%,1
基隆市,信義區,0065,446,90,536,18,554,1168,47.43%,38.18%,1
基隆市,信義區,0066,671,125,796,28,824,1602,51.44%,41.89%,1
基隆市,信義區,0067,534,108,642,37,679,1485,45.72%,35.96%,1
基隆市,信義區,0068,383,95,478,25,503,1009,49.85%,37.96%,1
基隆市,信義區,0069,681,141,822,39,861,2016,42.71%,33.78%,1
基隆市,信義區,0070,558,131,689,35,724,1764,41.04%,31.63%,1
基隆市,信義區,0071,505,147,652,43,695,1295,53.67%,39%,1
新竹市,東區,0001,363,116,479,15,494,1512,32.67%,24.01%,1
新竹市,東區,0002,446,112,558,23,581,953,60.97%,46.8%,1
新竹市,東區,0003,314,86,400,20,420,729,57.61%,43.07%,1
新竹市,東區,0004,238,86,324,28,352,566,62.19%,42.05%,1
新竹市,東區,0005,256,87,343,24,367,640,57.34%,40%,1
新竹市,東區,0006,114,35,149,23,172,305,56.39%,37.38%,1
新竹市,東區,0007,233,85,318,19,337,563,59.86%,41.39%,1
新竹市,東區,0008,308,78,386,18,404,741,54.52%,41.57%,1
新竹市,東區,0009,442,131,573,17,590,1041,56.68%,42.46%,1
新竹市,東區,0010,689,152,841,24,865,1615,53.56%,42.66%,1
新竹市,東區,0011,555,147,702,38,740,1287,57.5%,43.12%,1
新竹市,東區,0012,685,166,851,28,879,1554,56.56%,44.08%,1
新竹市,東區,0013,612,160,772,29,801,1388,57.71%,44.09%,1
新竹市,東區,0014,627,157,784,38,822,1419,57.93%,44.19%,1
新竹市,東區,0015,529,168,697,58,755,1355,55.72%,39.04%,1
新竹市,東區,0016,621,164,785,39,824,1490,55.3%,41.68%,1
新竹市,東區,0017,702,165,867,31,898,1615,55.6%,43.47%,1
新竹市,東區,0018,724,186,910,36,946,1672,56.58%,43.3%,1
新竹市,東區,0019,475,95,570,40,610,1062,57.44%,44.73%,1
新竹市,東區,0020,551,152,703,49,752,1315,57.19%,41.9%,1
新竹市,東區,0021,433,110,543,51,594,1000,59.4%,43.3%,1
新竹市,東區,0022,574,175,749,39,788,1337,58.94%,42.93%,1
新竹市,東區,0023,747,164,911,29,940,1747,53.81%,42.76%,1
新竹市,東區,0024,729,190,919,38,957,1600,59.81%,45.56%,1
新竹市,東區,0025,509,119,628,28,656,1158,56.65%,43.96%,1
新竹市,東區,0026,399,112,511,30,541,828,65.34%,48.19%,1
新竹市,東區,0027,657,172,829,42,871,1573,55.37%,41.77%,1
新竹市,東區,0028,681,164,845,45,890,1550,57.42%,43.94%,1
新竹市,東區,0029,526,165,691,31,722,1317,54.82%,39.94%,1
新竹市,東區,0030,441,158,599,44,643,1040,61.83%,42.4%,1
新竹市,東區,0031,438,78,516,27,543,935,58.07%,46.84%,1
新竹市,東區,0032,465,106,571,24,595,1074,55.4%,43.3%,1
新竹市,東區,0033,517,134,651,38,689,1133,60.81%,45.63%,1
新竹市,東區,0034,553,164,717,41,758,1262,60.06%,43.82%,1
新竹市,東區,0035,525,130,655,25,680,1199,56.71%,43.79%,1
新竹市,東區,0036,581,136,717,36,753,1226,61.42%,47.39%,1
新竹市,東區,0037,674,159,833,43,876,1377,63.62%,48.95%,1
新竹市,東區,0038,458,147,605,26,631,991,63.67%,46.22%,1
新竹市,東區,0039,536,153,689,76,765,1271,60.19%,42.17%,1
新竹市,東區,0040,511,120,631,20,651,1012,64.33%,50.49%,1
新竹市,東區,0041,413,115,528,59,587,1001,58.64%,41.26%,1
新竹市,東區,0042,599,199,798,55,853,1603,53.21%,37.37%,1
新竹市,東區,0043,471,158,629,41,670,1236,54.21%,38.11%,1
新竹市,東區,0044,553,138,691,47,738,1532,48.17%,36.1%,1
新竹市,東區,0045,534,148,682,39,721,1306,55.21%,40.89%,1
新竹市,東區,0046,450,113,563,63,626,1073,58.34%,41.94%,1
新竹市,東區,0047,382,99,481,30,511,952,53.68%,40.13%,1
新竹市,東區,0048,448,122,570,34,604,1298,46.53%,34.51%,1
新竹市,東區,0049,328,67,395,17,412,778,52.96%,42.16%,1
新竹市,東區,0050,488,180,668,38,706,1195,59.08%,40.84%,1
新竹市,東區,0051,636,170,806,62,868,1569,55.32%,40.54%,1
新竹市,東區,0052,761,164,925,34,959,1533,62.56%,49.64%,1
新竹市,東區,0053,639,132,771,41,812,1336,60.78%,47.83%,1
新竹市,東區,0054,676,95,771,36,807,1367,59.03%,49.45%,1
新竹市,東區,0055,627,118,745,42,787,1289,61.06%,48.64%,1
新竹市,東區,0056,388,111,499,29,528,960,55%,40.42%,1
新竹市,東區,0057,400,105,505,29,534,843,63.35%,47.45%,1
新竹市,東區,0058,412,115,527,44,571,948,60.23%,43.46%,1
新竹市,東區,0059,408,69,477,37,514,915,56.17%,44.59%,1
新竹市,東區,0060,840,157,997,38,1035,1801,57.47%,46.64%,1
新竹市,東區,0061,456,128,584,26,610,1079,56.53%,42.26%,1
新竹市,東區,0062,338,65,403,12,415,676,61.39%,50%,1
新竹市,東區,0063,500,125,625,49,674,1132,59.54%,44.17%,1
新竹市,東區,0064,97,44,141,11,152,251,60.56%,38.65%,1
新竹市,東區,0065,675,202,877,49,926,1620,57.16%,41.67%,1
新竹市,東區,0066,595,168,763,37,800,1479,54.09%,40.23%,1
新竹市,東區,0067,555,174,729,24,753,1402,53.71%,39.59%,1
新竹市,東區,0068,532,146,678,39,717,1280,56.02%,41.56%,1
新竹市,東區,0069,541,162,703,23,726,1228,59.12%,44.06%,1
新竹市,東區,0070,484,126,610,8,618,1157,53.41%,41.83%,1
新竹市,東區,0071,578,163,741,27,768,1354,56.72%,42.69%,1
新竹市,東區,0072,622,145,767,30,797,1334,59.75%,46.63%,1
新竹市,東區,0073,555,128,683,38,721,1234,58.43%,44.98%,1
新竹市,東區,0074,670,176,846,33,879,1398,62.88%,47.93%,1
新竹市,東區,0075,403,145,548,22,570,928,61.42%,43.43%,1
新竹市,東區,0076,684,133,817,29,846,1368,61.84%,50%,1
新竹市,東區,0077,467,125,592,22,614,1215,50.53%,38.44%,1
新竹市,東區,0078,390,108,498,38,536,1067,50.23%,36.55%,1
新竹市,東區,0079,491,148,639,17,656,1194,54.94%,41.12%,1
新竹市,東區,0080,490,131,621,18,639,1193,53.56%,41.07%,1
新竹市,東區,0081,568,167,735,70,805,1388,58%,40.92%,1
新竹市,東區,0082,570,137,707,24,731,1267,57.7%,44.99%,1
新竹市,東區,0083,579,129,708,22,730,1299,56.2%,44.57%,1
新竹市,東區,0084,570,133,703,36,739,1288,57.38%,44.25%,1
新竹市,東區,0085,549,174,723,21,744,1228,60.59%,44.71%,1
新竹市,東區,0086,547,130,677,12,689,1135,60.7%,48.19%,1
新竹市,東區,0087,607,157,764,21,785,1237,63.46%,49.07%,1
新竹市,東區,0088,464,96,560,40,600,1135,52.86%,40.88%,1
新竹市,東區,0089,463,101,564,24,588,1165,50.47%,39.74%,1
新竹市,東區,0090,465,121,586,33,619,1124,55.07%,41.37%,1
新竹市,東區,0091,521,154,675,36,711,1210,58.76%,43.06%,1
新竹市,東區,0092,542,138,680,36,716,1323,54.12%,40.97%,1
新竹市,東區,0093,515,98,613,21,634,1207,52.53%,42.67%,1
新竹市,東區,0094,493,98,591,33,624,1264,49.37%,39%,1
新竹市,東區,0095,513,149,662,16,678,1248,54.33%,41.11%,1
新竹市,東區,0096,660,163,823,35,858,1400,61.29%,47.14%,1
新竹市,東區,0097,684,185,869,30,899,1473,61.03%,46.44%,1
新竹市,東區,0098,578,151,729,40,769,1367,56.25%,42.28%,1
新竹市,東區,0099,525,148,673,27,700,1233,56.77%,42.58%,1
新竹市,東區,0100,188,67,255,14,269,507,53.06%,37.08%,1
新竹市,東區,0101,293,95,388,31,419,714,58.68%,41.04%,1
新竹市,東區,0102,337,119,456,52,508,875,58.06%,38.51%,1
新竹市,東區,0103,574,157,731,54,785,1396,56.23%,41.12%,1
新竹市,東區,0104,465,146,611,38,649,1232,52.68%,37.74%,1
新竹市,東區,0105,507,162,669,46,715,1323,54.04%,38.32%,1
新竹市,東區,0106,544,125,669,22,691,1516,45.58%,35.88%,1
新竹市,東區,0107,534,167,701,43,744,1453,51.2%,36.75%,1
新竹市,東區,0108,349,129,478,39,517,880,58.75%,39.66%,1
新竹市,東區,0109,440,90,530,32,562,1058,53.12%,41.59%,1
新竹市,東區,0110,420,142,562,34,596,1061,56.17%,39.59%,1
新竹市,東區,0111,275,98,373,29,402,710,56.62%,38.73%,1
新竹市,東區,0112,309,99,408,45,453,752,60.24%,41.09%,1
新竹市,東區,0113,215,66,281,19,300,475,63.16%,45.26%,1
新竹市,東區,0114,320,115,435,30,465,880,52.84%,36.36%,1
新竹市,東區,0115,394,152,546,30,576,989,58.24%,39.84%,1
新竹市,東區,0116,446,134,580,31,611,1059,57.7%,42.12%,1
新竹市,東區,0117,240,82,322,48,370,607,60.96%,39.54%,1
新竹市,東區,0118,322,114,436,38,474,815,58.16%,39.51%,1
新竹市,東區,0119,344,96,440,41,481,777,61.9%,44.27%,1
新竹市,東區,0120,496,149,645,30,675,1399,48.25%,35.45%,1
新竹市,東區,0121,475,157,632,39,671,1216,55.18%,39.06%,1
新竹市,東區,0122,406,112,518,37,555,1062,52.26%,38.23%,1
新竹市,東區,0123,470,105,575,25,600,1046,57.36%,44.93%,1
新竹市,東區,0124,528,137,665,19,684,1332,51.35%,39.64%,1
新竹市,東區,0125,532,197,729,53,782,1350,57.93%,39.41%,1
新竹市,東區,0126,551,155,706,17,723,1438,50.28%,38.32%,1
新竹市,東區,0127,509,160,669,48,717,1414,50.71%,36%,1
新竹市,東區,0128,604,199,803,29,832,1476,56.37%,40.92%,1
新竹市,東區,0129,604,154,758,52,810,1326,61.09%,45.55%,1
新竹市,東區,0130,448,111,559,14,573,927,61.81%,48.33%,1
新竹市,東區,0131,533,151,684,25,709,1273,55.7%,41.87%,1
新竹市,東區,0132,509,150,659,34,693,1315,52.7%,38.71%,1
新竹市,東區,0133,593,154,747,34,781,1413,55.27%,41.97%,1
新竹市,東區,0134,454,114,568,30,598,1064,56.2%,42.67%,1
新竹市,東區,0135,584,177,761,25,786,1244,63.18%,46.95%,1
新竹市,東區,0136,450,139,589,7,596,1160,51.38%,38.79%,1
新竹市,東區,0137,520,141,661,23,684,1398,48.93%,37.2%,1
新竹市,東區,0138,432,118,550,14,564,1384,40.75%,31.21%,1
新竹市,東區,0139,411,94,505,31,536,874,61.33%,47.03%,1
新竹市,北區,0140,164,59,223,11,234,477,49.06%,34.38%,1
新竹市,北區,0141,226,73,299,22,321,535,60%,42.24%,1
新竹市,北區,0142,278,110,388,56,444,746,59.52%,37.27%,1
新竹市,北區,0143,188,74,262,16,278,546,50.92%,34.43%,1
新竹市,北區,0144,305,95,400,39,439,711,61.74%,42.9%,1
新竹市,北區,0145,414,114,528,38,566,1143,49.52%,36.22%,1
新竹市,北區,0146,508,156,664,46,710,1370,51.82%,37.08%,1
新竹市,北區,0147,529,180,709,40,749,1390,53.88%,38.06%,1
新竹市,北區,0148,407,93,500,30,530,962,55.09%,42.31%,1
新竹市,北區,0149,499,152,651,17,668,1237,54%,40.34%,1
新竹市,北區,0150,568,179,747,45,792,1604,49.38%,35.41%,1
新竹市,北區,0151,262,83,345,15,360,758,47.49%,34.56%,1
新竹市,北區,0152,520,116,636,26,662,1320,50.15%,39.39%,1
新竹市,北區,0153,562,143,705,58,763,1519,50.23%,37%,1
新竹市,北區,0154,99,29,128,5,133,347,38.33%,28.53%,1
新竹市,北區,0155,529,134,663,44,707,1212,58.33%,43.65%,1
新竹市,北區,0156,566,165,731,37,768,1484,51.75%,38.14%,1
新竹市,北區,0157,534,177,711,64,775,1428,54.27%,37.39%,1
新竹市,北區,0158,474,127,601,24,625,1128,55.41%,42.02%,1
新竹市,北區,0159,247,81,328,16,344,638,53.92%,38.71%,1
新竹市,北區,0160,576,79,655,50,705,1222,57.69%,47.14%,1
新竹市,北區,0161,510,108,618,27,645,1076,59.94%,47.4%,1
新竹市,北區,0162,484,98,582,29,611,937,65.21%,51.65%,1
新竹市,北區,0163,566,130,696,52,748,1394,53.66%,40.6%,1
新竹市,北區,0164,545,174,719,45,764,1568,48.72%,34.76%,1
新竹市,北區,0165,482,178,660,45,705,1159,60.83%,41.59%,1
新竹市,北區,0166,86,14,100,5,105,252,41.67%,34.13%,1
新竹市,北區,0167,350,89,439,26,465,761,61.1%,45.99%,1
新竹市,北區,0168,316,111,427,41,468,788,59.39%,40.1%,1
新竹市,北區,0169,253,61,314,46,360,561,64.17%,45.1%,1
新竹市,北區,0170,574,163,737,85,822,1558,52.76%,36.84%,1
新竹市,北區,0171,483,154,637,32,669,1398,47.85%,34.55%,1
新竹市,北區,0172,384,112,496,36,532,957,55.59%,40.13%,1
新竹市,北區,0173,502,124,626,52,678,1195,56.74%,42.01%,1
新竹市,北區,0174,431,142,573,36,609,1236,49.27%,34.87%,1
新竹市,北區,0175,456,144,600,54,654,1255,52.11%,36.33%,1
新竹市,北區,0176,466,121,587,34,621,1114,55.75%,41.83%,1
新竹市,北區,0177,577,153,730,24,754,1396,54.01%,41.33%,1
新竹市,北區,0178,603,178,781,55,836,1456,57.42%,41.41%,1
新竹市,北區,0179,583,129,712,29,741,1374,53.93%,42.43%,1
新竹市,北區,0180,411,118,529,44,573,1070,53.55%,38.41%,1
新竹市,北區,0181,461,118,579,60,639,1142,55.95%,40.37%,1
新竹市,北區,0182,402,131,533,22,555,1103,50.32%,36.45%,1
新竹市,北區,0183,457,149,606,71,677,1190,56.89%,38.4%,1
新竹市,北區,0184,528,115,643,27,670,1089,61.52%,48.48%,1
新竹市,北區,0185,444,124,568,23,591,1272,46.46%,34.91%,1
新竹市,北區,0186,530,152,682,60,742,1306,56.81%,40.58%,1
新竹市,北區,0187,533,149,682,65,747,1328,56.25%,40.14%,1
新竹市,北區,0188,568,148,716,38,754,1457,51.75%,38.98%,1
新竹市,北區,0189,601,182,783,49,832,1492,55.76%,40.28%,1
新竹市,北區,0190,506,143,649,55,704,1160,60.69%,43.62%,1
新竹市,北區,0191,404,118,522,48,570,971,58.7%,41.61%,1
新竹市,北區,0192,330,91,421,19,440,1401,31.41%,23.55%,1
新竹市,北區,0193,581,143,724,38,762,1340,56.87%,43.36%,1
新竹市,北區,0194,595,163,758,37,795,1371,57.99%,43.4%,1
新竹市,北區,0195,516,135,651,22,673,1267,53.12%,40.73%,1
新竹市,北區,0196,500,122,622,44,666,1073,62.07%,46.6%,1
新竹市,北區,0197,499,131,630,48,678,1159,58.5%,43.05%,1
新竹市,北區,0198,513,149,662,25,687,1294,53.09%,39.64%,1
新竹市,北區,0199,594,158,752,44,796,1442,55.2%,41.19%,1
新竹市,北區,0200,546,156,702,24,726,1270,57.17%,42.99%,1
新竹市,北區,0201,528,156,684,40,724,1179,61.41%,44.78%,1
新竹市,北區,0202,448,113,561,36,597,949,62.91%,47.21%,1
新竹市,北區,0203,500,129,629,44,673,1163,57.87%,42.99%,1
新竹市,北區,0204,544,147,691,26,717,1334,53.75%,40.78%,1
新竹市,北區,0205,616,140,756,38,794,1415,56.11%,43.53%,1
新竹市,北區,0206,588,169,757,32,789,1305,60.46%,45.06%,1
新竹市,北區,0207,540,114,654,28,682,1200,56.83%,45%,1
新竹市,北區,0208,459,130,589,25,614,1106,55.52%,41.5%,1
新竹市,北區,0209,481,124,605,23,628,1044,60.15%,46.07%,1
新竹市,北區,0210,457,136,593,35,628,1061,59.19%,43.07%,1
新竹市,北區,0211,651,174,825,69,894,1518,58.89%,42.89%,1
新竹市,北區,0212,551,155,706,50,756,1220,61.97%,45.16%,1
新竹市,北區,0213,646,175,821,16,837,1475,56.75%,43.8%,1
新竹市,北區,0214,542,149,691,54,745,1373,54.26%,39.48%,1
新竹市,北區,0215,632,159,791,28,819,1450,56.48%,43.59%,1
新竹市,北區,0216,638,147,785,42,827,1423,58.12%,44.83%,1
新竹市,北區,0217,403,192,595,17,612,1059,57.79%,38.05%,1
新竹市,北區,0218,547,101,648,38,686,1130,60.71%,48.41%,1
新竹市,北區,0219,603,110,713,37,750,1208,62.09%,49.92%,1
新竹市,北區,0220,621,100,721,40,761,1226,62.07%,50.65%,1
新竹市,北區,0221,514,124,638,28,666,1175,56.68%,43.74%,1
新竹市,北區,0222,604,136,740,24,764,1371,55.73%,44.06%,1
新竹市,北區,0223,530,138,668,49,717,1306,54.9%,40.58%,1
新竹市,北區,0224,541,136,677,24,701,1340,52.31%,40.37%,1
新竹市,北區,0225,478,146,624,59,683,1111,61.48%,43.02%,1
新竹市,北區,0226,561,147,708,51,759,1197,63.41%,46.87%,1
新竹市,北區,0227,452,88,540,34,574,1008,56.94%,44.84%,1
新竹市,北區,0228,366,108,474,26,500,946,52.85%,38.69%,1
新竹市,北區,0229,299,91,390,32,422,705,59.86%,42.41%,1
新竹市,北區,0230,333,108,441,63,504,848,59.43%,39.27%,1
新竹市,北區,0231,523,131,654,31,685,1295,52.9%,40.39%,1
新竹市,北區,0232,573,125,698,40,738,1467,50.31%,39.06%,1
新竹市,北區,0233,555,148,703,47,750,1659,45.21%,33.45%,1
新竹市,北區,0234,497,131,628,44,672,1297,51.81%,38.32%,1
新竹市,北區,0235,557,168,725,64,789,1374,57.42%,40.54%,1
新竹市,北區,0236,631,136,767,73,840,1457,57.65%,43.31%,1
新竹市,北區,0237,498,102,600,32,632,1072,58.96%,46.46%,1
新竹市,北區,0238,544,127,671,54,725,1350,53.7%,40.3%,1
新竹市,北區,0239,442,124,566,39,605,971,62.31%,45.52%,1
新竹市,北區,0240,641,150,791,58,849,1450,58.55%,44.21%,1
新竹市,北區,0241,364,116,480,26,506,895,56.54%,40.67%,1
新竹市,北區,0242,586,132,718,35,753,1378,54.64%,42.53%,1
新竹市,北區,0243,577,179,756,93,849,1609,52.77%,35.86%,1
新竹市,北區,0244,232,71,303,43,346,594,58.25%,39.06%,1
新竹市,香山區,0245,599,124,723,55,778,1443,53.92%,41.51%,1
新竹市,香山區,0246,502,143,645,40,685,1241,55.2%,40.45%,1
新竹市,香山區,0247,516,105,621,25,646,1194,54.1%,43.22%,1
新竹市,香山區,0248,485,93,578,19,597,1081,55.23%,44.87%,1
新竹市,香山區,0249,346,83,429,25,454,807,56.26%,42.87%,1
新竹市,香山區,0250,714,189,903,53,956,1760,54.32%,40.57%,1
新竹市,香山區,0251,718,155,873,40,913,1635,55.84%,43.91%,1
新竹市,香山區,0252,628,173,801,51,852,1473,57.84%,42.63%,1
新竹市,香山區,0253,629,136,765,23,788,1408,55.97%,44.67%,1
新竹市,香山區,0254,467,120,587,30,617,1318,46.81%,35.43%,1
新竹市,香山區,0255,571,131,702,54,756,1337,56.54%,42.71%,1
新竹市,香山區,0256,736,187,923,33,956,1862,51.34%,39.53%,1
新竹市,香山區,0257,450,116,566,20,586,1067,54.92%,42.17%,1
新竹市,香山區,0258,389,107,496,33,529,863,61.3%,45.08%,1
新竹市,香山區,0259,541,136,677,64,741,1198,61.85%,45.16%,1
新竹市,香山區,0260,473,159,632,58,690,1138,60.63%,41.56%,1
新竹市,香山區,0261,460,114,574,56,630,957,65.83%,48.07%,1
新竹市,香山區,0262,581,140,721,79,800,1348,59.35%,43.1%,1
新竹市,香山區,0263,493,130,623,58,681,1023,66.57%,48.19%,1
新竹市,香山區,0264,410,107,517,27,544,970,56.08%,42.27%,1
新竹市,香山區,0265,571,133,704,45,749,1318,56.83%,43.32%,1
新竹市,香山區,0266,431,128,559,47,606,1088,55.7%,39.61%,1
新竹市,香山區,0267,330,80,410,20,430,903,47.62%,36.54%,1
新竹市,香山區,0268,398,152,550,39,589,1012,58.2%,39.33%,1
新竹市,香山區,0269,422,117,539,36,575,1014,56.71%,41.62%,1
新竹市,香山區,0270,538,134,672,28,700,1238,56.54%,43.46%,1
新竹市,香山區,0271,474,118,592,66,658,1182,55.67%,40.1%,1
新竹市,香山區,0272,592,171,763,83,846,1331,63.56%,44.48%,1
新竹市,香山區,0273,464,139,603,15,618,976,63.32%,47.54%,1
新竹市,香山區,0274,328,99,427,17,444,834,53.24%,39.33%,1
新竹市,香山區,0275,401,91,492,38,530,919,57.67%,43.63%,1
新竹市,香山區,0276,531,133,664,37,701,1188,59.01%,44.7%,1
新竹市,香山區,0277,439,147,586,39,625,1086,57.55%,40.42%,1
新竹市,香山區,0278,529,140,669,44,713,1144,62.33%,46.24%,1
新竹市,香山區,0279,498,116,614,42,656,1112,58.99%,44.78%,1
新竹市,香山區,0280,655,146,801,50,851,1476,57.66%,44.38%,1
新竹市,香山區,0281,560,130,690,29,719,1291,55.69%,43.38%,1
新竹市,香山區,0282,660,193,853,49,902,1464,61.61%,45.08%,1
新竹市,香山區,0283,638,143,781,70,851,1427,59.64%,44.71%,1
新竹市,香山區,0284,559,156,715,33,748,1336,55.99%,41.84%,1
新竹市,香山區,0285,390,232,622,34,656,1131,58%,34.48%,1
新竹市,香山區,0286,432,136,568,81,649,1070,60.65%,40.37%,1
新竹市,香山區,0287,429,127,556,61,617,1006,61.33%,42.64%,1
新竹市,香山區,0288,425,101,526,33,559,1223,45.71%,34.75%,1
新竹市,香山區,0289,449,128,577,28,605,1119,54.07%,40.13%,1
新竹市,香山區,0290,509,135,644,40,684,1400,48.86%,36.36%,1
新竹市,香山區,0291,566,148,714,38,752,1627,46.22%,34.79%,1
新竹市,香山區,0292,475,121,596,51,647,1289,50.19%,36.85%,1
新竹市,香山區,0293,520,139,659,56,715,1409,50.75%,36.91%,1
新竹市,香山區,0294,290,97,387,28,415,814,50.98%,35.63%,1
新竹市,香山區,0295,288,81,369,30,399,719,55.49%,40.06%,1
新竹市,香山區,0296,368,111,479,19,498,1065,46.76%,34.55%,1
新竹市,香山區,0297,323,83,406,24,430,776,55.41%,41.62%,1
新竹市,香山區,0298,381,90,471,41,512,890,57.53%,42.81%,1
新竹市,香山區,0299,345,76,421,25,446,896,49.78%,38.5%,1
嘉義市,東區,0001,427,114,541,30,571,1025,55.71%,41.66%,1
嘉義市,東區,0002,504,134,638,23,661,1276,51.8%,39.5%,1
嘉義市,東區,0003,348,109,457,38,495,974,50.82%,35.73%,1
嘉義市,東區,0004,515,158,673,45,718,1175,61.11%,43.83%,1
嘉義市,東區,0005,298,100,398,33,431,702,61.4%,42.45%,1
嘉義市,東區,0006,442,111,553,21,574,1092,52.56%,40.48%,1
嘉義市,東區,0007,332,106,438,13,451,1023,44.09%,32.45%,1
嘉義市,東區,0008,681,186,867,66,933,1816,51.38%,37.5%,1
嘉義市,東區,0009,261,741,1002,52,1054,1936,54.44%,13.48%,1
嘉義市,東區,0010,690,213,903,27,930,1698,54.77%,40.64%,1
嘉義市,東區,0011,500,167,667,27,694,1221,56.84%,40.95%,1
嘉義市,東區,0012,418,157,575,24,599,1113,53.82%,37.56%,1
嘉義市,東區,0013,574,200,774,49,823,1452,56.68%,39.53%,1
嘉義市,東區,0014,632,179,811,36,847,1395,60.72%,45.3%,1
嘉義市,東區,0015,489,160,649,50,699,1453,48.11%,33.65%,1
嘉義市,東區,0016,423,109,532,22,554,1094,50.64%,38.67%,1
嘉義市,東區,0017,596,152,748,36,784,1420,55.21%,41.97%,1
嘉義市,東區,0018,645,218,863,45,908,1552,58.51%,41.56%,1
嘉義市,東區,0019,644,184,828,56,884,1558,56.74%,41.34%,1
嘉義市,東區,0020,434,143,577,40,617,1062,58.1%,40.87%,1
嘉義市,東區,0021,459,146,605,52,657,1199,54.8%,38.28%,1
嘉義市,東區,0022,522,119,641,30,671,1236,54.29%,42.23%,1
嘉義市,東區,0023,352,97,449,21,470,890,52.81%,39.55%,1
嘉義市,東區,0024,374,120,494,39,533,880,60.57%,42.5%,1
嘉義市,東區,0025,466,144,610,17,627,1189,52.73%,39.19%,1
嘉義市,東區,0026,269,89,358,22,380,669,56.8%,40.21%,1
嘉義市,東區,0027,569,167,736,44,780,1435,54.36%,39.65%,1
嘉義市,東區,0028,582,181,763,47,810,1349,60.04%,43.14%,1
嘉義市,東區,0029,570,165,735,24,759,1455,52.16%,39.18%,1
嘉義市,東區,0030,368,126,494,32,526,915,57.49%,40.22%,1
嘉義市,東區,0031,336,150,486,26,512,952,53.78%,35.29%,1
嘉義市,東區,0032,359,115,474,55,529,941,56.22%,38.15%,1
嘉義市,東區,0033,386,138,524,23,547,1080,50.65%,35.74%,1
嘉義市,東區,0034,381,133,514,24,538,1157,46.5%,32.93%,1
嘉義市,東區,0035,430,145,575,31,606,1053,57.55%,40.84%,1
嘉義市,東區,0036,318,109,427,26,453,967,46.85%,32.89%,1
嘉義市,東區,0037,380,141,521,27,548,1091,50.23%,34.83%,1
嘉義市,東區,0038,388,116,504,61,565,961,58.79%,40.37%,1
嘉義市,東區,0039,244,84,328,26,354,863,41.02%,28.27%,1
嘉義市,東區,0040,442,113,555,59,614,1023,60.02%,43.21%,1
嘉義市,東區,0041,403,154,557,87,644,1078,59.74%,37.38%,1
嘉義市,東區,0042,303,163,466,19,485,938,51.71%,32.3%,1
嘉義市,東區,0043,413,122,535,31,566,1049,53.96%,39.37%,1
嘉義市,東區,0044,469,167,636,69,705,1360,51.84%,34.49%,1
嘉義市,東區,0045,464,219,683,99,782,1615,48.42%,28.73%,1
嘉義市,東區,0046,464,156,620,52,672,1267,53.04%,36.62%,1
嘉義市,東區,0047,515,167,682,70,752,1579,47.63%,32.62%,1
嘉義市,東區,0048,652,206,858,80,938,1831,51.23%,35.61%,1
嘉義市,東區,0049,400,120,520,33,553,977,56.6%,40.94%,1
嘉義市,東區,0050,413,147,560,31,591,1169,50.56%,35.33%,1
嘉義市,東區,0051,479,181,660,77,737,1238,59.53%,38.69%,1
嘉義市,東區,0052,519,149,668,14,682,1266,53.87%,41%,1
嘉義市,東區,0053,490,131,621,40,661,1429,46.26%,34.29%,1
嘉義市,東區,0054,528,138,666,22,688,1288,53.42%,40.99%,1
嘉義市,東區,0055,391,118,509,29,538,980,54.9%,39.9%,1
嘉義市,東區,0056,334,106,440,27,467,922,50.65%,36.23%,1
嘉義市,東區,0057,458,155,613,49,662,1133,58.43%,40.42%,1
嘉義市,東區,0058,517,140,657,50,707,1235,57.25%,41.86%,1
嘉義市,東區,0059,606,157,763,18,781,1525,51.21%,39.74%,1
嘉義市,東區,0060,429,128,557,46,603,1170,51.54%,36.67%,1
嘉義市,東區,0061,518,157,675,63,738,1177,62.7%,44.01%,1
嘉義市,東區,0062,470,153,623,60,683,1207,56.59%,38.94%,1
嘉義市,東區,0063,533,137,670,53,723,1272,56.84%,41.9%,1
嘉義市,東區,0064,432,152,584,88,672,1188,56.57%,36.36%,1
嘉義市,東區,0065,418,131,549,25,574,1172,48.98%,35.67%,1
嘉義市,東區,0066,426,127,553,41,594,1020,58.24%,41.76%,1
嘉義市,東區,0067,534,163,697,55,752,1332,56.46%,40.09%,1
嘉義市,東區,0068,440,145,585,37,622,1011,61.52%,43.52%,1
嘉義市,東區,0069,571,234,805,71,876,1682,52.08%,33.95%,1
嘉義市,東區,0070,624,166,790,67,857,1567,54.69%,39.82%,1
嘉義市,東區,0071,488,130,618,21,639,1207,52.94%,40.43%,1
嘉義市,東區,0072,433,110,543,18,561,981,57.19%,44.14%,1
嘉義市,東區,0073,534,149,683,39,722,1395,51.76%,38.28%,1
嘉義市,東區,0074,473,148,621,22,643,1434,44.84%,32.98%,1
嘉義市,東區,0075,458,134,592,24,616,1404,43.87%,32.62%,1
嘉義市,東區,0076,595,144,739,41,780,1428,54.62%,41.67%,1
嘉義市,東區,0077,570,148,718,30,748,1823,41.03%,31.27%,1
嘉義市,東區,0078,555,164,719,35,754,1570,48.03%,35.35%,1
嘉義市,東區,0079,440,149,589,53,642,1282,50.08%,34.32%,1
嘉義市,東區,0080,710,164,874,54,928,1571,59.07%,45.19%,1
嘉義市,東區,0081,576,155,731,30,761,1533,49.64%,37.57%,1
嘉義市,西區,0082,323,111,434,25,459,885,51.86%,36.5%,1
嘉義市,西區,0083,411,133,544,59,603,1109,54.37%,37.06%,1
嘉義市,西區,0084,336,116,452,43,495,1020,48.53%,32.94%,1
嘉義市,西區,0085,400,123,523,53,576,925,62.27%,43.24%,1
嘉義市,西區,0086,471,211,682,40,722,1671,43.21%,28.19%,1
嘉義市,西區,0087,484,135,619,26,645,1215,53.09%,39.84%,1
嘉義市,西區,0088,397,98,495,26,521,1036,50.29%,38.32%,1
嘉義市,西區,0089,388,146,534,30,564,1129,49.96%,34.37%,1
嘉義市,西區,0090,419,23,442,29,471,1127,41.79%,37.18%,1
嘉義市,西區,0091,514,175,689,51,740,1415,52.3%,36.33%,1
嘉義市,西區,0092,521,134,655,27,682,1366,49.93%,38.14%,1
嘉義市,西區,0093,440,139,579,64,643,1053,61.06%,41.79%,1
嘉義市,西區,0094,416,112,528,27,555,1067,52.01%,38.99%,1
嘉義市,西區,0095,533,81,614,33,647,1575,41.08%,33.84%,1
嘉義市,西區,0096,699,219,918,53,971,1865,52.06%,37.48%,1
嘉義市,西區,0097,432,106,538,47,585,1196,48.91%,36.12%,1
嘉義市,西區,0098,431,135,566,25,591,1280,46.17%,33.67%,1
嘉義市,西區,0099,603,189,792,86,878,1629,53.9%,37.02%,1
嘉義市,西區,0100,554,162,716,72,788,1393,56.57%,39.77%,1
嘉義市,西區,0101,428,145,573,53,626,1077,58.12%,39.74%,1
嘉義市,西區,0102,580,176,756,42,798,1694,47.11%,34.24%,1
嘉義市,西區,0103,331,116,447,78,525,841,62.43%,39.36%,1
嘉義市,西區,0104,426,120,546,8,554,1183,46.83%,36.01%,1
嘉義市,西區,0105,456,117,573,26,599,1000,59.9%,45.6%,1
嘉義市,西區,0106,469,132,601,24,625,1095,57.08%,42.83%,1
嘉義市,西區,0107,528,160,688,39,727,1256,57.88%,42.04%,1
嘉義市,西區,0108,425,89,514,45,559,962,58.11%,44.18%,1
嘉義市,西區,0109,378,127,505,22,527,865,60.92%,43.7%,1
嘉義市,西區,0110,503,149,652,67,719,1396,51.5%,36.03%,1
嘉義市,西區,0111,731,175,906,69,975,1799,54.2%,40.63%,1
嘉義市,西區,0112,565,128,693,34,727,1505,48.31%,37.54%,1
嘉義市,西區,0113,661,158,819,65,884,1698,52.06%,38.93%,1
嘉義市,西區,0114,727,194,921,27,948,1854,51.13%,39.21%,1
嘉義市,西區,0115,512,135,647,17,664,1537,43.2%,33.31%,1
嘉義市,西區,0116,553,188,741,77,818,1604,51%,34.48%,1
嘉義市,西區,0117,400,130,530,65,595,944,63.03%,42.37%,1
嘉義市,西區,0118,769,78,847,84,931,1627,57.22%,47.26%,1
嘉義市,西區,0119,472,150,622,50,672,1144,58.74%,41.26%,1
嘉義市,西區,0120,532,160,692,49,741,1362,54.41%,39.06%,1
嘉義市,西區,0121,514,171,685,36,721,1279,56.37%,40.19%,1
嘉義市,西區,0122,759,177,936,1,937,1702,55.05%,44.59%,1
嘉義市,西區,0123,575,168,743,50,793,1358,58.39%,42.34%,1
嘉義市,西區,0124,582,180,762,67,829,1360,60.96%,42.79%,1
嘉義市,西區,0125,662,180,842,51,893,1589,56.2%,41.66%,1
嘉義市,西區,0126,571,150,721,38,759,1280,59.3%,44.61%,1
嘉義市,西區,0127,437,119,556,32,588,1220,48.2%,35.82%,1
嘉義市,西區,0128,524,110,634,33,667,1172,56.91%,44.71%,1
嘉義市,西區,0129,531,157,688,43,731,1320,55.38%,40.23%,1
嘉義市,西區,0130,594,129,723,28,751,1185,63.38%,50.13%,1
嘉義市,西區,0131,527,180,707,59,766,1278,59.94%,41.24%,1
嘉義市,西區,0132,467,120,587,33,620,1394,44.48%,33.5%,1
嘉義市,西區,0133,623,188,811,55,866,1540,56.23%,40.45%,1
嘉義市,西區,0134,637,156,793,74,867,1548,56.01%,41.15%,1
嘉義市,西區,0135,502,145,647,35,682,1295,52.66%,38.76%,1
嘉義市,西區,0136,581,161,742,55,797,1318,60.47%,44.08%,1
嘉義市,西區,0137,648,151,799,52,851,1545,55.08%,41.94%,1
嘉義市,西區,0138,259,74,333,22,355,736,48.23%,35.19%,1
嘉義市,西區,0139,444,119,563,21,584,1168,50%,38.01%,1
嘉義市,西區,0140,336,101,437,37,474,756,62.7%,44.44%,1
嘉義市,西區,0141,386,70,456,15,471,869,54.2%,44.42%,1
嘉義市,西區,0142,410,120,530,48,578,983,58.8%,41.71%,1
嘉義市,西區,0143,341,93,434,35,469,828,56.64%,41.18%,1
嘉義市,西區,0144,776,159,935,44,979,1775,55.15%,43.72%,1
嘉義市,西區,0145,594,100,694,44,738,1419,52.01%,41.86%,1
嘉義市,西區,0146,282,90,372,18,390,779,50.06%,36.2%,1
嘉義市,西區,0147,314,81,395,16,411,855,48.07%,36.73%,1
嘉義市,西區,0148,483,119,602,71,673,1146,58.73%,42.15%,1
嘉義市,西區,0149,448,144,592,26,618,1111,55.63%,40.32%,1
嘉義市,西區,0150,330,111,441,51,492,767,64.15%,43.02%,1
嘉義市,西區,0151,262,94,356,26,382,817,46.76%,32.07%,1
嘉義市,西區,0152,286,109,395,50,445,770,57.79%,37.14%,1
嘉義市,西區,0153,310,149,459,16,475,1135,41.85%,27.31%,1
嘉義市,西區,0154,271,101,372,83,455,835,54.49%,32.46%,1
嘉義市,西區,0155,405,119,524,36,560,1182,47.38%,34.26%,1
嘉義市,西區,0156,292,105,397,40,437,944,46.29%,30.93%,1
嘉義市,西區,0157,350,112,462,37,499,997,50.05%,35.11%,1
嘉義市,西區,0158,398,130,528,29,557,1074,51.86%,37.06%,1
嘉義市,西區,0159,460,141,601,21,622,1460,42.6%,31.51%,1
嘉義市,西區,0160,508,143,651,30,681,1352,50.37%,37.57%,1
嘉義市,西區,0161,584,181,765,45,810,1499,54.04%,38.96%,1
嘉義市,西區,0162,413,178,591,102,693,1262,54.91%,32.73%,1
嘉義市,西區,0163,458,162,620,43,663,1299,51.04%,35.26%,1
嘉義市,西區,0164,604,187,791,64,855,1734,49.31%,34.83%,1
嘉義市,西區,0165,656,130,786,1,787,1674,47.01%,39.19%,1
嘉義市,西區,0166,569,164,733,26,759,1540,49.29%,36.95%,1
嘉義市,西區,0167,430,137,567,30,597,1056,56.53%,40.72%,1
嘉義市,西區,0168,550,188,738,114,852,1467,58.08%,37.49%,1
嘉義市,西區,0169,509,164,673,71,744,1431,51.99%,35.57%,1
嘉義市,西區,0170,548,144,692,78,770,1234,62.4%,44.41%,1
嘉義市,西區,0171,505,125,630,13,643,1266,50.79%,39.89%,1
嘉義市,西區,0172,492,140,632,28,660,1211,54.5%,40.63%,1
嘉義市,西區,0173,479,128,607,24,631,1121,56.29%,42.73%,1
嘉義市,西區,0174,398,115,513,20,533,1155,46.15%,34.46%,1
嘉義市,西區,0175,583,231,814,87,901,1546,58.28%,37.71%,1
嘉義市,西區,0176,473,147,620,30,650,1322,49.17%,35.78%,1
嘉義市,西區,0177,584,196,780,88,868,1549,56.04%,37.7%,1
