縣市,鄉鎮市區,開票所,同意票,不同意票,有效票,無效票,投票數,投票權人數,投票率,投票權人數百分比,總數
臺北市,松山區,0527,597,324,921,24,945,1583,59.7%,37.71%,1
臺北市,松山區,0528,625,320,945,38,983,1691,58.13%,36.96%,1
臺北市,松山區,0529,517,250,767,26,793,1386,57.22%,37.3%,1
臺北市,松山區,0530,509,278,787,39,826,1362,60.65%,37.37%,1
臺北市,松山區,0531,527,290,817,30,847,1399,60.54%,37.67%,1
臺北市,松山區,0532,486,297,783,32,815,1324,61.56%,36.71%,1
臺北市,松山區,0533,501,298,799,33,832,1296,64.2%,38.66%,1
臺北市,松山區,0534,547,272,819,34,853,1386,61.54%,39.47%,1
臺北市,松山區,0535,565,369,934,45,979,1529,64.03%,36.95%,1
臺北市,松山區,0536,526,273,799,28,827,1416,58.4%,37.15%,1
臺北市,松山區,0537,539,313,852,39,891,1619,55.03%,33.29%,1
臺北市,松山區,0538,489,334,823,19,842,1386,60.75%,35.28%,1
臺北市,松山區,0539,529,323,852,31,883,1380,63.99%,38.33%,1
臺北市,松山區,0540,504,300,804,21,825,1357,60.8%,37.14%,1
臺北市,松山區,0541,524,275,799,21,820,1296,63.27%,40.43%,1
臺北市,松山區,0542,606,320,926,53,979,1632,59.99%,37.13%,1
臺北市,松山區,0543,502,299,801,28,829,1414,58.63%,35.5%,1
臺北市,松山區,0544,521,296,817,21,838,1404,59.69%,37.11%,1
臺北市,松山區,0545,554,260,814,36,850,1365,62.27%,40.59%,1
臺北市,松山區,0546,544,292,836,29,865,1431,60.45%,38.02%,1
臺北市,松山區,0547,548,318,866,46,912,1483,61.5%,36.95%,1
臺北市,松山區,0548,508,284,792,29,821,1293,63.5%,39.29%,1
臺北市,松山區,0549,487,291,778,28,806,1410,57.16%,34.54%,1
臺北市,松山區,0550,514,249,763,31,794,1307,60.75%,39.33%,1
臺北市,松山區,0551,486,284,770,23,793,1242,63.85%,39.13%,1
臺北市,松山區,0552,466,240,706,30,736,1192,61.74%,39.09%,1
臺北市,松山區,0553,519,247,766,36,802,1276,62.85%,40.67%,1
臺北市,松山區,0554,459,240,699,14,713,1201,59.37%,38.22%,1
臺北市,松山區,0555,499,272,771,24,795,1318,60.32%,37.86%,1
臺北市,松山區,0556,458,245,703,25,728,1157,62.92%,39.59%,1
臺北市,松山區,0557,425,240,665,17,682,1157,58.95%,36.73%,1
臺北市,松山區,0558,557,251,808,31,839,1357,61.83%,41.05%,1
臺北市,松山區,0559,423,239,662,20,682,1215,56.13%,34.81%,1
臺北市,松山區,0560,507,252,759,28,787,1345,58.51%,37.7%,1
臺北市,松山區,0561,467,265,732,24,756,1237,61.12%,37.75%,1
臺北市,松山區,0562,644,226,870,24,894,1393,64.18%,46.23%,1
臺北市,松山區,0563,531,310,841,25,866,1331,65.06%,39.89%,1
臺北市,松山區,0564,566,371,937,37,974,1550,62.84%,36.52%,1
臺北市,松山區,0565,530,190,720,21,741,1308,56.65%,40.52%,1
臺北市,松山區,0566,588,251,839,40,879,1490,58.99%,39.46%,1
臺北市,松山區,0567,585,285,870,22,892,1406,63.44%,41.61%,1
臺北市,松山區,0568,479,276,755,18,773,1191,64.9%,40.22%,1
臺北市,松山區,0569,404,236,640,34,674,1095,61.55%,36.89%,1
臺北市,松山區,0570,464,215,679,34,713,1198,59.52%,38.73%,1
臺北市,松山區,0571,506,211,717,28,745,1265,58.89%,40%,1
臺北市,松山區,0572,448,253,701,17,718,1225,58.61%,36.57%,1
臺北市,松山區,0573,663,364,1027,44,1071,1698,63.07%,39.05%,1
臺北市,松山區,0574,697,320,1017,31,1048,1819,57.61%,38.32%,1
臺北市,松山區,0575,670,350,1020,42,1062,1754,60.55%,38.2%,1
臺北市,松山區,0576,483,324,807,42,849,1361,62.38%,35.49%,1
臺北市,松山區,0577,485,237,722,22,744,1189,62.57%,40.79%,1
臺北市,松山區,0578,465,259,724,25,749,1214,61.7%,38.3%,1
臺北市,松山區,0579,455,286,741,31,772,1284,60.12%,35.44%,1
臺北市,松山區,0580,474,302,776,35,811,1297,62.53%,36.55%,1
臺北市,松山區,0581,474,280,754,30,784,1330,58.95%,35.64%,1
臺北市,松山區,0582,567,270,837,29,866,1396,62.03%,40.62%,1
臺北市,松山區,0583,590,256,846,20,866,1480,58.51%,39.86%,1
臺北市,松山區,0584,558,286,844,22,866,1419,61.03%,39.32%,1
臺北市,松山區,0585,535,286,821,31,852,1390,61.29%,38.49%,1
臺北市,松山區,0586,556,338,894,32,926,1525,60.72%,36.46%,1
臺北市,松山區,0587,597,295,892,26,918,1633,56.22%,36.56%,1
臺北市,松山區,0588,545,327,872,24,896,2677,33.47%,20.36%,1
臺北市,松山區,0589,460,277,737,36,773,1281,60.34%,35.91%,1
臺北市,松山區,0590,447,249,696,28,724,1469,49.29%,30.43%,1
臺北市,松山區,0591,579,330,909,55,964,1700,56.71%,34.06%,1
臺北市,松山區,0592,497,308,805,30,835,1503,55.56%,33.07%,1
臺北市,松山區,0593,489,261,750,25,775,1309,59.21%,37.36%,1
臺北市,松山區,0594,538,265,803,34,837,1376,60.83%,39.1%,1
臺北市,松山區,0595,587,343,930,31,961,1654,58.1%,35.49%,1
臺北市,松山區,0596,561,298,859,52,911,1601,56.9%,35.04%,1
臺北市,松山區,0597,563,297,860,23,883,1496,59.02%,37.63%,1
臺北市,松山區,0598,624,342,966,49,1015,1598,63.52%,39.05%,1
臺北市,松山區,0599,668,347,1015,44,1059,1751,60.48%,38.15%,1
臺北市,松山區,0600,628,319,947,32,979,1557,62.88%,40.33%,1
臺北市,松山區,0601,760,331,1091,28,1119,1686,66.37%,45.08%,1
臺北市,松山區,0602,753,262,1015,38,1053,1707,61.69%,44.11%,1
臺北市,松山區,0603,686,378,1064,47,1111,1854,59.92%,37%,1
臺北市,松山區,0604,608,340,948,32,980,1740,56.32%,34.94%,1
臺北市,松山區,0605,566,279,845,43,888,1494,59.44%,37.88%,1
臺北市,松山區,0606,588,263,851,30,881,1453,60.63%,40.47%,1
臺北市,松山區,0607,558,297,855,24,879,1458,60.29%,38.27%,1
臺北市,松山區,0608,542,326,868,27,895,1536,58.27%,35.29%,1
臺北市,松山區,0609,560,293,853,29,882,1463,60.29%,38.28%,1
臺北市,松山區,0610,577,358,935,22,957,1790,53.46%,32.23%,1
臺北市,松山區,0611,637,350,987,32,1019,1679,60.69%,37.94%,1
臺北市,松山區,0612,583,312,895,39,934,1785,52.32%,32.66%,1
臺北市,松山區,0613,606,378,984,36,1020,1793,56.89%,33.8%,1
臺北市,松山區,0614,545,244,789,32,821,1381,59.45%,39.46%,1
臺北市,松山區,0615,500,254,754,23,777,1279,60.75%,39.09%,1
臺北市,松山區,0616,626,342,968,45,1013,1681,60.26%,37.24%,1
臺北市,松山區,0617,484,259,743,34,777,1232,63.07%,39.29%,1
臺北市,松山區,0618,546,309,855,32,887,1533,57.86%,35.62%,1
臺北市,松山區,0619,591,336,927,25,952,1540,61.82%,38.38%,1
臺北市,松山區,0620,610,338,948,28,976,1716,56.88%,35.55%,1
臺北市,松山區,0621,549,341,890,36,926,1664,55.65%,32.99%,1
臺北市,松山區,0622,504,252,756,24,780,1350,57.78%,37.33%,1
臺北市,松山區,0623,660,355,1015,35,1050,1837,57.16%,35.93%,1
臺北市,松山區,0624,529,286,815,43,858,1558,55.07%,33.95%,1
臺北市,松山區,0625,551,296,847,33,880,1420,61.97%,38.8%,1
臺北市,松山區,0626,548,269,817,30,847,1474,57.46%,37.18%,1
臺北市,松山區,0627,584,301,885,31,916,1591,57.57%,36.71%,1
臺北市,松山區,0628,623,341,964,38,1002,1726,58.05%,36.1%,1
臺北市,松山區,0629,476,333,809,31,840,1452,57.85%,32.78%,1
臺北市,松山區,0630,523,296,819,27,846,1482,57.09%,35.29%,1
臺北市,松山區,0631,562,280,842,36,878,1460,60.14%,38.49%,1
臺北市,松山區,0632,496,282,778,31,809,1398,57.87%,35.48%,1
臺北市,松山區,0633,537,295,832,38,870,1423,61.14%,37.74%,1
臺北市,松山區,0634,502,227,729,21,750,1226,61.17%,40.95%,1
臺北市,松山區,0635,448,227,675,30,705,1158,60.88%,38.69%,1
臺北市,松山區,0636,511,289,800,23,823,1426,57.71%,35.83%,1
臺北市,松山區,0637,444,245,689,14,703,1177,59.73%,37.72%,1
臺北市,松山區,0638,485,297,782,25,807,1363,59.21%,35.58%,1
臺北市,松山區,0639,519,230,749,27,776,1240,62.58%,41.85%,1
臺北市,松山區,0640,549,278,827,30,857,1375,62.33%,39.93%,1
臺北市,松山區,0641,508,281,789,36,825,1377,59.91%,36.89%,1
臺北市,松山區,0642,428,238,666,15,681,1225,55.59%,34.94%,1
臺北市,松山區,0643,387,244,631,23,654,1017,64.31%,38.05%,1
臺北市,信義區,0644,540,258,798,19,817,2476,33%,21.81%,1
臺北市,信義區,0645,606,259,865,20,885,1381,64.08%,43.88%,1
臺北市,信義區,0646,538,242,780,37,817,1294,63.14%,41.58%,1
臺北市,信義區,0647,512,274,786,26,812,1351,60.1%,37.9%,1
臺北市,信義區,0648,512,247,759,23,782,1296,60.34%,39.51%,1
臺北市,信義區,0649,523,260,783,26,809,1302,62.14%,40.17%,1
臺北市,信義區,0650,382,169,551,36,587,1025,57.27%,37.27%,1
臺北市,信義區,0651,486,278,764,22,786,1421,55.31%,34.2%,1
臺北市,信義區,0652,529,310,839,17,856,1501,57.03%,35.24%,1
臺北市,信義區,0653,500,302,802,24,826,1575,52.44%,31.75%,1
臺北市,信義區,0654,563,294,857,19,876,1516,57.78%,37.14%,1
臺北市,信義區,0655,508,309,817,17,834,1382,60.35%,36.76%,1
臺北市,信義區,0656,421,211,632,29,661,1128,58.6%,37.32%,1
臺北市,信義區,0657,521,245,766,32,798,1397,57.12%,37.29%,1
臺北市,信義區,0658,486,218,704,27,731,1161,62.96%,41.86%,1
臺北市,信義區,0659,507,258,765,32,797,1368,58.26%,37.06%,1
臺北市,信義區,0660,413,209,622,18,640,1049,61.01%,39.37%,1
臺北市,信義區,0661,516,245,761,25,786,1308,60.09%,39.45%,1
臺北市,信義區,0662,437,258,695,36,731,1154,63.34%,37.87%,1
臺北市,信義區,0663,361,289,650,14,664,1078,61.6%,33.49%,1
臺北市,信義區,0664,513,270,783,30,813,1375,59.13%,37.31%,1
臺北市,信義區,0665,581,249,830,32,862,1448,59.53%,40.12%,1
臺北市,信義區,0666,488,250,738,25,763,1250,61.04%,39.04%,1
臺北市,信義區,0667,517,300,817,13,830,1381,60.1%,37.44%,1
臺北市,信義區,0668,486,237,723,27,750,1213,61.83%,40.07%,1
臺北市,信義區,0669,575,279,854,22,876,1373,63.8%,41.88%,1
臺北市,信義區,0670,487,237,724,28,752,1226,61.34%,39.72%,1
臺北市,信義區,0671,433,258,691,15,706,1117,63.21%,38.76%,1
臺北市,信義區,0672,479,200,679,23,702,1123,62.51%,42.65%,1
臺北市,信義區,0673,456,241,697,32,729,1200,60.75%,38%,1
臺北市,信義區,0674,436,256,692,20,712,1335,53.33%,32.66%,1
臺北市,信義區,0675,484,226,710,26,736,1332,55.26%,36.34%,1
臺北市,信義區,0676,644,296,940,44,984,1648,59.71%,39.08%,1
臺北市,信義區,0677,561,290,851,47,898,1542,58.24%,36.38%,1
臺北市,信義區,0678,458,241,699,34,733,1228,59.69%,37.3%,1
臺北市,信義區,0679,653,331,984,29,1013,1731,58.52%,37.72%,1
臺北市,信義區,0680,532,286,818,27,845,1403,60.23%,37.92%,1
臺北市,信義區,0681,721,296,1017,55,1072,1929,55.57%,37.38%,1
臺北市,信義區,0682,501,276,777,26,803,1300,61.77%,38.54%,1
臺北市,信義區,0683,512,261,773,25,798,1486,53.7%,34.45%,1
臺北市,信義區,0684,484,273,757,30,787,1532,51.37%,31.59%,1
臺北市,信義區,0685,563,268,831,38,869,1387,62.65%,40.59%,1
臺北市,信義區,0686,440,185,625,35,660,1195,55.23%,36.82%,1
臺北市,信義區,0687,402,194,596,23,619,1068,57.96%,37.64%,1
臺北市,信義區,0688,470,208,678,31,709,1273,55.7%,36.92%,1
臺北市,信義區,0689,521,276,797,44,841,1329,63.28%,39.2%,1
臺北市,信義區,0690,477,242,719,30,749,1311,57.13%,36.38%,1
臺北市,信義區,0691,443,221,664,39,703,1258,55.88%,35.21%,1
臺北市,信義區,0692,483,259,742,32,774,1277,60.61%,37.82%,1
臺北市,信義區,0693,515,266,781,37,818,1285,63.66%,40.08%,1
臺北市,信義區,0694,456,246,702,36,738,1161,63.57%,39.28%,1
臺北市,信義區,0695,456,284,740,26,766,1299,58.97%,35.1%,1
臺北市,信義區,0696,453,238,691,29,720,1243,57.92%,36.44%,1
臺北市,信義區,0697,437,233,670,17,687,1197,57.39%,36.51%,1
臺北市,信義區,0698,496,270,766,22,788,1224,64.38%,40.52%,1
臺北市,信義區,0699,426,202,628,25,653,1147,56.93%,37.14%,1
臺北市,信義區,0700,392,222,614,15,629,1045,60.19%,37.51%,1
臺北市,信義區,0701,476,194,670,23,693,1096,63.23%,43.43%,1
臺北市,信義區,0702,426,218,644,10,654,1115,58.65%,38.21%,1
臺北市,信義區,0703,450,175,625,24,649,1117,58.1%,40.29%,1
臺北市,信義區,0704,321,196,517,21,538,1019,52.8%,31.5%,1
臺北市,信義區,0705,500,265,765,29,794,1346,58.99%,37.15%,1
臺北市,信義區,0706,514,264,778,26,804,1405,57.22%,36.58%,1
臺北市,信義區,0707,500,261,761,33,794,1356,58.55%,36.87%,1
臺北市,信義區,0708,516,271,787,23,810,1250,64.8%,41.28%,1
臺北市,信義區,0709,514,237,751,18,769,1254,61.32%,40.99%,1
臺北市,信義區,0710,503,252,755,26,781,1317,59.3%,38.19%,1
臺北市,信義區,0711,577,259,836,32,868,1271,68.29%,45.4%,1
臺北市,信義區,0712,353,181,534,24,558,979,57%,36.06%,1
臺北市,信義區,0713,358,185,543,32,575,1025,56.1%,34.93%,1
臺北市,信義區,0714,488,256,744,30,774,1512,51.19%,32.28%,1
臺北市,信義區,0715,557,320,877,21,898,1483,60.55%,37.56%,1
臺北市,信義區,0716,543,277,820,29,849,1359,62.47%,39.96%,1
臺北市,信義區,0717,567,274,841,15,856,1387,61.72%,40.88%,1
臺北市,信義區,0718,530,244,774,32,806,1455,55.4%,36.43%,1
臺北市,信義區,0719,544,296,840,21,861,1461,58.93%,37.23%,1
臺北市,信義區,0720,573,306,879,41,920,1532,60.05%,37.4%,1
臺北市,信義區,0721,408,244,652,21,673,1043,64.53%,39.12%,1
臺北市,信義區,0722,354,177,531,28,559,875,63.89%,40.46%,1
臺北市,信義區,0723,354,177,531,10,541,927,58.36%,38.19%,1
臺北市,信義區,0724,454,199,653,33,686,1119,61.3%,40.57%,1
臺北市,信義區,0725,540,287,827,38,865,1463,59.13%,36.91%,1
臺北市,信義區,0726,518,283,801,28,829,1293,64.11%,40.06%,1
臺北市,信義區,0727,571,278,849,32,881,1553,56.73%,36.77%,1
臺北市,信義區,0728,489,294,783,19,802,1360,58.97%,35.96%,1
臺北市,信義區,0729,517,286,803,31,834,1392,59.91%,37.14%,1
臺北市,信義區,0730,533,264,797,15,812,1377,58.97%,38.71%,1
臺北市,信義區,0731,523,272,795,19,814,1377,59.11%,37.98%,1
臺北市,信義區,0732,453,219,672,21,693,1269,54.61%,35.7%,1
臺北市,信義區,0733,552,250,802,61,863,1407,61.34%,39.23%,1
臺北市,信義區,0734,445,217,662,28,690,1172,58.87%,37.97%,1
臺北市,信義區,0735,447,226,673,22,695,1182,58.8%,37.82%,1
臺北市,信義區,0736,486,237,723,42,765,1255,60.96%,38.73%,1
臺北市,信義區,0737,599,298,897,27,924,1689,54.71%,35.46%,1
臺北市,信義區,0738,569,286,855,33,888,1605,55.33%,35.45%,1
臺北市,信義區,0739,444,194,638,19,657,1143,57.48%,38.85%,1
臺北市,信義區,0740,525,247,772,21,793,1440,55.07%,36.46%,1
臺北市,信義區,0741,564,275,839,24,863,1495,57.73%,37.73%,1
臺北市,信義區,0742,588,301,889,42,931,1514,61.49%,38.84%,1
臺北市,信義區,0743,564,238,802,26,828,1449,57.14%,38.92%,1
臺北市,信義區,0744,563,263,826,31,857,1401,61.17%,40.19%,1
臺北市,信義區,0745,433,205,638,17,655,1181,55.46%,36.66%,1
臺北市,信義區,0746,564,281,845,36,881,1376,64.03%,40.99%,1
臺北市,信義區,0747,596,243,839,37,876,1422,61.6%,41.91%,1
臺北市,信義區,0748,477,248,725,17,742,1267,58.56%,37.65%,1
臺北市,信義區,0749,436,223,659,20,679,1220,55.66%,35.74%,1
臺北市,信義區,0750,563,248,811,20,831,1562,53.2%,36.04%,1
臺北市,信義區,0751,498,295,793,22,815,1455,56.01%,34.23%,1
臺北市,信義區,0752,565,301,866,28,894,1605,55.7%,35.2%,1
臺北市,信義區,0753,673,301,974,28,1002,1626,61.62%,41.39%,1
臺北市,信義區,0754,580,328,908,34,942,1561,60.35%,37.16%,1
臺北市,信義區,0755,499,259,758,18,776,1547,50.16%,32.26%,1
臺北市,信義區,0756,469,281,750,16,766,1336,57.34%,35.1%,1
臺北市,信義區,0757,451,224,675,21,696,1314,52.97%,34.32%,1
臺北市,信義區,0758,464,234,698,31,729,1297,56.21%,35.77%,1
臺北市,信義區,0759,518,224,742,37,779,1366,57.03%,37.92%,1
臺北市,信義區,0760,517,308,825,22,847,1472,57.54%,35.12%,1
臺北市,信義區,0761,522,279,801,41,842,1450,58.07%,36%,1
臺北市,信義區,0762,505,243,748,28,776,1328,58.43%,38.03%,1
臺北市,信義區,0763,529,290,819,36,855,1399,61.12%,37.81%,1
臺北市,信義區,0764,542,263,805,40,845,1373,61.54%,39.48%,1
臺北市,信義區,0765,425,183,608,19,627,1099,57.05%,38.67%,1
臺北市,信義區,0766,443,237,680,0,680,1226,55.46%,36.13%,1
臺北市,信義區,0767,463,225,688,19,707,1267,55.8%,36.54%,1
臺北市,信義區,0768,488,393,881,30,911,1531,59.5%,31.87%,1
臺北市,信義區,0769,571,266,837,38,875,1438,60.85%,39.71%,1
臺北市,信義區,0770,614,297,911,17,928,1657,56%,37.05%,1
臺北市,信義區,0771,600,333,933,30,963,1621,59.41%,37.01%,1
臺北市,信義區,0772,601,293,894,17,911,1508,60.41%,39.85%,1
臺北市,信義區,0773,524,267,791,25,816,1334,61.17%,39.28%,1
臺北市,信義區,0774,402,171,573,25,598,1246,47.99%,32.26%,1
臺北市,信義區,0775,463,276,739,21,760,1196,63.55%,38.71%,1
臺北市,信義區,0776,466,254,720,19,739,1220,60.57%,38.2%,1
臺北市,信義區,0777,560,297,857,22,879,1538,57.15%,36.41%,1
臺北市,信義區,0778,608,299,907,39,946,1565,60.45%,38.85%,1
臺北市,信義區,0779,514,307,821,58,879,1621,54.23%,31.71%,1
臺北市,信義區,0780,534,269,803,42,845,1486,56.86%,35.94%,1
臺北市,信義區,0781,548,261,809,26,835,1507,55.41%,36.36%,1
臺北市,信義區,0782,599,274,873,31,904,1516,59.63%,39.51%,1
臺北市,信義區,0783,539,225,764,44,808,1287,62.78%,41.88%,1
臺北市,信義區,0784,361,157,518,47,565,1050,53.81%,34.38%,1
臺北市,信義區,0785,376,96,472,27,499,801,62.3%,46.94%,1
臺北市,大安區,1214,435,208,643,23,666,1184,56.25%,36.74%,1
臺北市,大安區,1215,415,212,627,33,660,1197,55.14%,34.67%,1
臺北市,大安區,1216,433,262,695,16,711,1221,58.23%,35.46%,1
臺北市,大安區,1217,499,230,729,20,749,1246,60.11%,40.05%,1
臺北市,大安區,1218,531,360,891,30,921,1478,62.31%,35.93%,1
臺北市,大安區,1219,429,292,721,35,756,1314,57.53%,32.65%,1
臺北市,大安區,1220,583,349,932,33,965,1594,60.54%,36.57%,1
臺北市,大安區,1221,523,311,834,23,857,1429,59.97%,36.6%,1
臺北市,大安區,1222,594,275,869,21,890,1452,61.29%,40.91%,1
臺北市,大安區,1223,523,367,890,20,910,1551,58.67%,33.72%,1
臺北市,大安區,1224,495,288,783,32,815,1335,61.05%,37.08%,1
臺北市,大安區,1225,409,243,652,13,665,1196,55.6%,34.2%,1
臺北市,大安區,1226,458,261,719,20,739,1339,55.19%,34.2%,1
臺北市,大安區,1227,490,330,820,24,844,1448,58.29%,33.84%,1
臺北市,大安區,1228,492,252,744,37,781,1373,56.88%,35.83%,1
臺北市,大安區,1229,536,265,801,39,840,1439,58.37%,37.25%,1
臺北市,大安區,1230,407,229,636,4,640,1174,54.51%,34.67%,1
臺北市,大安區,1231,404,197,601,18,619,1144,54.11%,35.31%,1
臺北市,大安區,1232,443,140,583,20,603,1119,53.89%,39.59%,1
臺北市,大安區,1233,321,163,484,15,499,1024,48.73%,31.35%,1
臺北市,大安區,1234,435,178,613,16,629,1032,60.95%,42.15%,1
臺北市,大安區,1235,569,204,773,20,793,1319,60.12%,43.14%,1
臺北市,大安區,1236,548,274,822,25,847,1369,61.87%,40.03%,1
臺北市,大安區,1237,481,287,768,36,804,1347,59.69%,35.71%,1
臺北市,大安區,1238,513,330,843,26,869,1655,52.51%,31%,1
臺北市,大安區,1239,523,273,796,24,820,1595,51.41%,32.79%,1
臺北市,大安區,1240,495,268,763,27,790,1429,55.28%,34.64%,1
臺北市,大安區,1241,466,223,689,22,711,1309,54.32%,35.6%,1
臺北市,大安區,1242,538,264,802,24,826,1508,54.77%,35.68%,1
臺北市,大安區,1243,437,244,681,34,715,1310,54.58%,33.36%,1
臺北市,大安區,1244,434,205,639,28,667,1233,54.1%,35.2%,1
臺北市,大安區,1245,438,232,670,27,697,1287,54.16%,34.03%,1
臺北市,大安區,1246,379,213,592,20,612,1147,53.36%,33.04%,1
臺北市,大安區,1247,435,221,656,21,677,1260,53.73%,34.52%,1
臺北市,大安區,1248,499,237,736,24,760,1377,55.19%,36.24%,1
臺北市,大安區,1249,416,257,673,51,724,1284,56.39%,32.4%,1
臺北市,大安區,1250,427,233,660,26,686,1314,52.21%,32.5%,1
臺北市,大安區,1251,419,243,662,24,686,1273,53.89%,32.91%,1
臺北市,大安區,1252,393,263,656,20,676,1146,58.99%,34.29%,1
臺北市,大安區,1253,475,276,751,21,772,1285,60.08%,36.96%,1
臺北市,大安區,1254,475,301,776,19,795,1297,61.3%,36.62%,1
臺北市,大安區,1255,429,231,660,24,684,1101,62.13%,38.96%,1
臺北市,大安區,1256,438,282,720,38,758,1310,57.86%,33.44%,1
臺北市,大安區,1257,511,315,826,28,854,1365,62.56%,37.44%,1
臺北市,大安區,1258,491,287,778,23,801,1372,58.38%,35.79%,1
臺北市,大安區,1259,454,262,716,19,735,1189,61.82%,38.18%,1
臺北市,大安區,1260,466,276,742,20,762,1256,60.67%,37.1%,1
臺北市,大安區,1261,428,242,670,26,696,1151,60.47%,37.19%,1
臺北市,大安區,1262,574,331,905,22,927,1501,61.76%,38.24%,1
臺北市,大安區,1263,608,293,901,22,923,1520,60.72%,40%,1
臺北市,大安區,1264,594,331,925,30,955,1529,62.46%,38.85%,1
臺北市,大安區,1265,593,350,943,26,969,1579,61.37%,37.56%,1
臺北市,大安區,1266,401,262,663,21,684,2619,26.12%,15.31%,1
臺北市,大安區,1267,476,270,746,18,764,1290,59.22%,36.9%,1
臺北市,大安區,1268,480,306,786,26,812,1307,62.13%,36.73%,1
臺北市,大安區,1269,511,378,889,22,911,1489,61.18%,34.32%,1
臺北市,大安區,1270,429,229,658,28,686,1097,62.53%,39.11%,1
臺北市,大安區,1271,469,283,752,24,776,1328,58.43%,35.32%,1
臺北市,大安區,1272,400,269,669,13,682,1189,57.36%,33.64%,1
臺北市,大安區,1273,460,278,738,17,755,1270,59.45%,36.22%,1
臺北市,大安區,1274,447,325,772,10,782,1349,57.97%,33.14%,1
臺北市,大安區,1275,430,289,719,19,738,1292,57.12%,33.28%,1
臺北市,大安區,1276,497,284,781,31,812,1314,61.8%,37.82%,1
臺北市,大安區,1277,421,281,702,32,734,1200,61.17%,35.08%,1
臺北市,大安區,1278,587,295,882,29,911,1558,58.47%,37.68%,1
臺北市,大安區,1279,554,319,873,24,897,1561,57.46%,35.49%,1
臺北市,大安區,1280,551,292,843,22,865,1446,59.82%,38.11%,1
臺北市,大安區,1281,533,223,756,21,777,1499,51.83%,35.56%,1
臺北市,大安區,1282,557,289,846,23,869,1467,59.24%,37.97%,1
臺北市,大安區,1283,537,281,818,28,846,1511,55.99%,35.54%,1
臺北市,大安區,1284,612,321,933,34,967,1600,60.44%,38.25%,1
臺北市,大安區,1285,577,333,910,29,939,1573,59.69%,36.68%,1
臺北市,大安區,1286,575,324,899,23,922,1467,62.85%,39.2%,1
臺北市,大安區,1287,524,261,785,22,807,1358,59.43%,38.59%,1
臺北市,大安區,1288,557,311,868,27,895,1568,57.08%,35.52%,1
臺北市,大安區,1289,529,292,821,29,850,1411,60.24%,37.49%,1
臺北市,大安區,1290,560,306,866,11,877,1554,56.44%,36.04%,1
臺北市,大安區,1291,519,285,804,24,828,1345,61.56%,38.59%,1
臺北市,大安區,1292,538,294,832,18,850,1435,59.23%,37.49%,1
臺北市,大安區,1293,618,302,920,20,940,1481,63.47%,41.73%,1
臺北市,大安區,1294,614,305,919,22,941,1451,64.85%,42.32%,1
臺北市,大安區,1295,577,321,898,42,940,1566,60.03%,36.85%,1
臺北市,大安區,1296,569,318,887,18,905,1525,59.34%,37.31%,1
臺北市,大安區,1297,475,268,743,25,768,1336,57.49%,35.55%,1
臺北市,大安區,1298,574,281,855,38,893,1483,60.22%,38.71%,1
臺北市,大安區,1299,469,249,718,18,736,1396,52.72%,33.6%,1
臺北市,大安區,1300,537,307,844,30,874,1406,62.16%,38.19%,1
臺北市,大安區,1301,546,298,844,24,868,1434,60.53%,38.08%,1
臺北市,大安區,1302,462,269,731,23,754,1288,58.54%,35.87%,1
臺北市,大安區,1303,532,282,814,21,835,1407,59.35%,37.81%,1
臺北市,大安區,1304,530,292,822,23,845,1514,55.81%,35.01%,1
臺北市,大安區,1305,508,248,756,28,784,1550,50.58%,32.77%,1
臺北市,大安區,1306,570,281,851,25,876,1490,58.79%,38.26%,1
臺北市,大安區,1307,440,270,710,22,732,1284,57.01%,34.27%,1
臺北市,大安區,1308,462,203,665,22,687,1129,60.85%,40.92%,1
臺北市,大安區,1309,428,255,683,24,707,1193,59.26%,35.88%,1
臺北市,大安區,1310,367,209,576,24,600,1057,56.76%,34.72%,1
臺北市,大安區,1311,468,289,757,32,789,1361,57.97%,34.39%,1
臺北市,大安區,1312,524,238,762,41,803,1412,56.87%,37.11%,1
臺北市,大安區,1313,422,255,677,21,698,1423,49.05%,29.66%,1
臺北市,大安區,1314,460,236,696,41,737,1257,58.63%,36.6%,1
臺北市,大安區,1315,472,206,678,25,703,1133,62.05%,41.66%,1
臺北市,大安區,1316,389,226,615,16,631,1077,58.59%,36.12%,1
臺北市,大安區,1317,496,256,752,32,784,1300,60.31%,38.15%,1
臺北市,大安區,1318,529,265,794,35,829,1319,62.85%,40.11%,1
臺北市,大安區,1319,492,238,730,31,761,1265,60.16%,38.89%,1
臺北市,大安區,1320,465,219,684,18,702,1265,55.49%,36.76%,1
臺北市,大安區,1321,412,225,637,32,669,1103,60.65%,37.35%,1
臺北市,大安區,1322,513,256,769,30,799,1341,59.58%,38.26%,1
臺北市,大安區,1323,522,271,793,32,825,1357,60.8%,38.47%,1
臺北市,大安區,1324,449,273,722,31,753,1260,59.76%,35.63%,1
臺北市,大安區,1325,470,278,748,23,771,1295,59.54%,36.29%,1
臺北市,大安區,1326,475,264,739,27,766,1399,54.75%,33.95%,1
臺北市,大安區,1327,414,220,634,26,660,1150,57.39%,36%,1
臺北市,大安區,1328,441,256,697,16,713,1351,52.78%,32.64%,1
臺北市,大安區,1329,478,290,768,30,798,1341,59.51%,35.65%,1
臺北市,大安區,1330,424,194,618,12,630,1129,55.8%,37.56%,1
臺北市,大安區,1331,507,232,739,24,763,1328,57.45%,38.18%,1
臺北市,大安區,1332,696,272,968,22,990,1557,63.58%,44.7%,1
臺北市,大安區,1333,614,283,897,36,933,1461,63.86%,42.03%,1
臺北市,大安區,1334,525,278,803,20,823,1589,51.79%,33.04%,1
臺北市,大安區,1335,546,265,811,22,833,1473,56.55%,37.07%,1
臺北市,大安區,1336,478,332,810,30,840,1479,56.8%,32.32%,1
臺北市,大安區,1337,347,150,497,24,521,833,62.55%,41.66%,1
臺北市,大安區,1338,351,200,551,23,574,999,57.46%,35.14%,1
臺北市,大安區,1339,660,366,1026,22,1048,1757,59.65%,37.56%,1
臺北市,大安區,1340,608,313,921,22,943,1573,59.95%,38.65%,1
臺北市,大安區,1341,596,363,959,26,985,1587,62.07%,37.56%,1
臺北市,大安區,1342,534,342,876,38,914,1496,61.1%,35.7%,1
臺北市,大安區,1343,490,355,845,24,869,1440,60.35%,34.03%,1
臺北市,大安區,1344,600,332,932,38,970,1578,61.47%,38.02%,1
臺北市,大安區,1345,429,291,720,17,737,1223,60.26%,35.08%,1
臺北市,大安區,1346,406,264,670,11,681,1119,60.86%,36.28%,1
臺北市,大安區,1347,468,288,756,17,773,1252,61.74%,37.38%,1
臺北市,大安區,1348,565,363,928,29,957,1576,60.72%,35.85%,1
臺北市,大安區,1349,522,288,810,25,835,1425,58.6%,36.63%,1
臺北市,大安區,1350,509,268,777,17,794,1450,54.76%,35.1%,1
臺北市,大安區,1351,552,260,812,18,830,1444,57.48%,38.23%,1
臺北市,大安區,1352,507,319,826,27,853,1337,63.8%,37.92%,1
臺北市,大安區,1353,513,263,776,20,796,1417,56.18%,36.2%,1
臺北市,大安區,1354,483,228,711,30,741,1250,59.28%,38.64%,1
臺北市,大安區,1355,437,221,658,28,686,1176,58.33%,37.16%,1
臺北市,大安區,1356,472,152,624,27,651,1257,51.79%,37.55%,1
臺北市,大安區,1357,481,231,712,39,751,1257,59.75%,38.27%,1
臺北市,大安區,1358,444,225,669,24,693,1148,60.37%,38.68%,1
臺北市,大安區,1359,535,271,806,24,830,1418,58.53%,37.73%,1
臺北市,大安區,1360,382,198,580,20,600,1028,58.37%,37.16%,1
臺北市,大安區,1361,516,328,844,20,864,1445,59.79%,35.71%,1
臺北市,大安區,1362,510,276,786,27,813,1361,59.74%,37.47%,1
臺北市,大安區,1363,567,231,798,28,826,1343,61.5%,42.22%,1
臺北市,大安區,1364,475,251,726,30,756,1267,59.67%,37.49%,1
臺北市,大安區,1365,438,290,728,24,752,1380,54.49%,31.74%,1
臺北市,大安區,1366,547,286,833,37,870,1524,57.09%,35.89%,1
臺北市,大安區,1367,534,321,855,25,880,1470,59.86%,36.33%,1
臺北市,大安區,1368,467,229,696,29,725,1318,55.01%,35.43%,1
臺北市,大安區,1369,491,269,760,22,782,1430,54.69%,34.34%,1
臺北市,大安區,1370,517,255,772,27,799,1386,57.65%,37.3%,1
臺北市,大安區,1371,500,247,747,26,773,1438,53.76%,34.77%,1
臺北市,大安區,1372,427,226,653,18,671,1270,52.83%,33.62%,1
臺北市,大安區,1373,472,266,738,41,779,1395,55.84%,33.84%,1
臺北市,大安區,1374,496,226,722,22,744,1292,57.59%,38.39%,1
臺北市,大安區,1375,437,273,710,28,738,1310,56.34%,33.36%,1
臺北市,大安區,1376,484,258,742,20,762,1319,57.77%,36.69%,1
臺北市,大安區,1377,504,288,792,10,802,1355,59.19%,37.2%,1
臺北市,大安區,1378,431,248,679,24,703,1312,53.58%,32.85%,1
臺北市,大安區,1379,495,257,752,22,774,1335,57.98%,37.08%,1
臺北市,大安區,1380,493,288,781,25,806,1489,54.13%,33.11%,1
臺北市,大安區,1381,490,265,755,14,769,1307,58.84%,37.49%,1
臺北市,大安區,1382,433,253,686,19,705,1328,53.09%,32.61%,1
臺北市,大安區,1383,440,259,699,5,704,1277,55.13%,34.46%,1
臺北市,大安區,1384,480,255,735,28,763,1314,58.07%,36.53%,1
臺北市,大安區,1385,476,259,735,31,766,1270,60.31%,37.48%,1
臺北市,大安區,1386,434,290,724,32,756,1308,57.8%,33.18%,1
臺北市,大安區,1387,418,252,670,17,687,1138,60.37%,36.73%,1
臺北市,大安區,1388,456,267,723,20,743,1333,55.74%,34.21%,1
臺北市,大安區,1389,418,246,664,29,693,1176,58.93%,35.54%,1
臺北市,大安區,1390,453,246,699,40,739,1311,56.37%,34.55%,1
臺北市,大安區,1391,478,233,711,19,730,1295,56.37%,36.91%,1
臺北市,大安區,1392,544,258,802,36,838,1421,58.97%,38.28%,1
臺北市,大安區,1393,478,278,756,28,784,1409,55.64%,33.92%,1
臺北市,大安區,1394,420,293,713,28,741,1434,51.67%,29.29%,1
臺北市,大安區,1395,484,271,755,30,785,1449,54.18%,33.4%,1
臺北市,大安區,1396,468,265,733,28,761,1284,59.27%,36.45%,1
臺北市,大安區,1397,459,244,703,17,720,1248,57.69%,36.78%,1
臺北市,大安區,1398,449,273,722,20,742,1119,66.31%,40.13%,1
臺北市,大安區,1399,349,159,508,30,538,883,60.93%,39.52%,1
臺北市,大安區,1400,247,80,327,34,361,630,57.3%,39.21%,1
臺北市,大安區,1401,299,158,457,27,484,814,59.46%,36.73%,1
臺北市,中山區,0786,537,318,855,29,884,1522,58.08%,35.28%,1
臺北市,中山區,0787,475,249,724,20,744,1332,55.86%,35.66%,1
臺北市,中山區,0788,515,293,808,29,837,1656,50.54%,31.1%,1
臺北市,中山區,0789,444,231,675,46,721,1367,52.74%,32.48%,1
臺北市,中山區,0790,526,316,842,35,877,1732,50.64%,30.37%,1
臺北市,中山區,0791,577,322,899,41,940,1634,57.53%,35.31%,1
臺北市,中山區,0792,569,300,869,25,894,1650,54.18%,34.48%,1
臺北市,中山區,0793,521,277,798,27,825,1392,59.27%,37.43%,1
臺北市,中山區,0794,439,281,720,17,737,1177,62.62%,37.3%,1
臺北市,中山區,0795,545,316,861,37,898,1477,60.8%,36.9%,1
臺北市,中山區,0796,354,192,546,35,581,1063,54.66%,33.3%,1
臺北市,中山區,0797,476,209,685,24,709,1296,54.71%,36.73%,1
臺北市,中山區,0798,428,257,685,26,711,1330,53.46%,32.18%,1
臺北市,中山區,0799,513,267,780,30,810,1483,54.62%,34.59%,1
臺北市,中山區,0800,525,276,801,18,819,1542,53.11%,34.05%,1
臺北市,中山區,0801,547,304,851,38,889,1710,51.99%,31.99%,1
臺北市,中山區,0802,441,228,669,16,685,1315,52.09%,33.54%,1
臺北市,中山區,0803,459,210,669,37,706,1245,56.71%,36.87%,1
臺北市,中山區,0804,465,196,661,26,687,1262,54.44%,36.85%,1
臺北市,中山區,0805,531,318,849,35,884,1518,58.23%,34.98%,1
臺北市,中山區,0806,568,285,853,36,889,1522,58.41%,37.32%,1
臺北市,中山區,0807,518,289,807,26,833,1580,52.72%,32.78%,1
臺北市,中山區,0808,523,315,838,25,863,1529,56.44%,34.21%,1
臺北市,中山區,0809,425,227,652,28,680,1221,55.69%,34.81%,1
臺北市,中山區,0810,477,231,708,21,729,1221,59.71%,39.07%,1
臺北市,中山區,0811,376,184,560,23,583,1139,51.19%,33.01%,1
臺北市,中山區,0812,490,265,755,52,807,1407,57.36%,34.83%,1
臺北市,中山區,0813,443,290,733,23,756,1321,57.23%,33.54%,1
臺北市,中山區,0814,505,268,773,26,799,1578,50.63%,32%,1
臺北市,中山區,0815,557,303,860,41,901,1739,51.81%,32.03%,1
臺北市,中山區,0816,525,286,811,29,840,1637,51.31%,32.07%,1
臺北市,中山區,0817,499,296,795,46,841,1541,54.57%,32.38%,1
臺北市,中山區,0818,439,251,690,29,719,1210,59.42%,36.28%,1
臺北市,中山區,0819,455,259,714,30,744,1331,55.9%,34.18%,1
臺北市,中山區,0820,397,218,615,41,656,1224,53.59%,32.43%,1
臺北市,中山區,0821,616,261,877,39,916,1585,57.79%,38.86%,1
臺北市,中山區,0822,607,302,909,43,952,1523,62.51%,39.86%,1
臺北市,中山區,0823,547,274,821,31,852,1368,62.28%,39.99%,1
臺北市,中山區,0824,739,263,1002,32,1034,1805,57.29%,40.94%,1
臺北市,中山區,0825,587,244,831,19,850,1404,60.54%,41.81%,1
臺北市,中山區,0826,637,403,1040,32,1072,1708,62.76%,37.3%,1
臺北市,中山區,0827,547,347,894,26,920,1451,63.4%,37.7%,1
臺北市,中山區,0828,640,364,1004,39,1043,1684,61.94%,38%,1
臺北市,中山區,0829,596,299,895,17,912,1585,57.54%,37.6%,1
臺北市,中山區,0830,507,294,801,43,844,1391,60.68%,36.45%,1
臺北市,中山區,0831,585,272,857,47,904,1375,65.75%,42.55%,1
臺北市,中山區,0832,530,328,858,18,876,1472,59.51%,36.01%,1
臺北市,中山區,0833,445,271,716,22,738,1327,55.61%,33.53%,1
臺北市,中山區,0834,523,290,813,12,825,1401,58.89%,37.33%,1
臺北市,中山區,0835,557,266,823,27,850,1423,59.73%,39.14%,1
臺北市,中山區,0836,579,333,912,25,937,1569,59.72%,36.9%,1
臺北市,中山區,0837,573,354,927,29,956,1651,57.9%,34.71%,1
臺北市,中山區,0838,534,369,903,18,921,1624,56.71%,32.88%,1
臺北市,中山區,0839,600,419,1019,33,1052,1713,61.41%,35.03%,1
臺北市,中山區,0840,642,331,973,21,994,1647,60.35%,38.98%,1
臺北市,中山區,0841,582,341,923,37,960,1762,54.48%,33.03%,1
臺北市,中山區,0842,584,257,841,23,864,1399,61.76%,41.74%,1
臺北市,中山區,0843,602,300,902,20,922,1489,61.92%,40.43%,1
臺北市,中山區,0844,513,257,770,20,790,1269,62.25%,40.43%,1
臺北市,中山區,0845,421,188,609,26,635,998,63.63%,42.18%,1
臺北市,中山區,0846,522,288,810,29,839,1472,57%,35.46%,1
臺北市,中山區,0847,513,291,804,31,835,1517,55.04%,33.82%,1
臺北市,中山區,0848,661,336,997,35,1032,1704,60.56%,38.79%,1
臺北市,中山區,0849,608,259,867,66,933,1603,58.2%,37.93%,1
臺北市,中山區,0850,511,232,743,51,794,1432,55.45%,35.68%,1
臺北市,中山區,0851,532,317,849,48,897,1500,59.8%,35.47%,1
臺北市,中山區,0852,534,256,790,32,822,1332,61.71%,40.09%,1
臺北市,中山區,0853,548,303,851,37,888,1450,61.24%,37.79%,1
臺北市,中山區,0854,536,330,866,25,891,1434,62.13%,37.38%,1
臺北市,中山區,0855,521,250,771,37,808,1419,56.94%,36.72%,1
臺北市,中山區,0856,465,250,715,23,738,1292,57.12%,35.99%,1
臺北市,中山區,0857,511,305,816,39,855,1526,56.03%,33.49%,1
臺北市,中山區,0858,480,279,759,28,787,1582,49.75%,30.34%,1
臺北市,中山區,0859,500,299,799,33,832,1588,52.39%,31.49%,1
臺北市,中山區,0860,533,274,807,41,848,1463,57.96%,36.43%,1
臺北市,中山區,0861,465,302,767,35,802,1533,52.32%,30.33%,1
臺北市,中山區,0862,376,132,508,20,528,944,55.93%,39.83%,1
臺北市,中山區,0863,703,356,1059,32,1091,1745,62.52%,40.29%,1
臺北市,中山區,0864,524,317,841,21,862,1679,51.34%,31.21%,1
臺北市,中山區,0865,490,298,788,36,824,3419,24.1%,14.33%,1
臺北市,中山區,0866,514,292,806,30,836,1387,60.27%,37.06%,1
臺北市,中山區,0867,642,323,965,27,992,1672,59.33%,38.4%,1
臺北市,中山區,0868,477,262,739,39,778,1319,58.98%,36.16%,1
臺北市,中山區,0869,497,232,729,41,770,1364,56.45%,36.44%,1
臺北市,中山區,0870,502,290,792,31,823,1461,56.33%,34.36%,1
臺北市,中山區,0871,442,239,681,25,706,1173,60.19%,37.68%,1
臺北市,中山區,0872,412,214,626,30,656,1171,56.02%,35.18%,1
臺北市,中山區,0873,465,278,743,14,757,1310,57.79%,35.5%,1
臺北市,中山區,0874,508,295,803,38,841,1373,61.25%,37%,1
臺北市,中山區,0875,531,252,783,25,808,1290,62.64%,41.16%,1
臺北市,中山區,0876,485,295,780,31,811,1346,60.25%,36.03%,1
臺北市,中山區,0877,510,343,853,39,892,1468,60.76%,34.74%,1
臺北市,中山區,0878,455,238,693,17,710,1178,60.27%,38.62%,1
臺北市,中山區,0879,607,336,943,44,987,1654,59.67%,36.7%,1
臺北市,中山區,0880,531,296,827,34,861,1464,58.81%,36.27%,1
臺北市,中山區,0881,497,288,785,32,817,1450,56.34%,34.28%,1
臺北市,中山區,0882,525,320,845,43,888,1534,57.89%,34.22%,1
臺北市,中山區,0883,593,349,942,31,973,1703,57.13%,34.82%,1
臺北市,中山區,0884,596,304,900,46,946,1610,58.76%,37.02%,1
臺北市,中山區,0885,540,338,878,51,929,1653,56.2%,32.67%,1
臺北市,中山區,0886,627,367,994,42,1036,1694,61.16%,37.01%,1
臺北市,中山區,0887,562,318,880,34,914,1623,56.32%,34.63%,1
臺北市,中山區,0888,576,339,915,32,947,1618,58.53%,35.6%,1
臺北市,中山區,0889,548,323,871,39,910,1583,57.49%,34.62%,1
臺北市,中山區,0890,454,459,913,48,961,1605,59.88%,28.29%,1
臺北市,中山區,0891,546,311,857,42,899,1398,64.31%,39.06%,1
臺北市,中山區,0892,602,355,957,33,990,1526,64.88%,39.45%,1
臺北市,中山區,0893,540,318,858,51,909,1555,58.46%,34.73%,1
臺北市,中山區,0894,559,312,871,29,900,1597,56.36%,35%,1
臺北市,中山區,0895,552,345,897,44,941,1587,59.29%,34.78%,1
臺北市,中山區,0896,567,360,927,31,958,1587,60.37%,35.73%,1
臺北市,中山區,0897,577,336,913,47,960,1546,62.1%,37.32%,1
臺北市,中山區,0898,477,238,715,41,756,1322,57.19%,36.08%,1
臺北市,中山區,0899,472,242,714,31,745,1267,58.8%,37.25%,1
臺北市,中山區,0900,454,230,684,16,700,1210,57.85%,37.52%,1
臺北市,中山區,0901,485,232,717,29,746,1295,57.61%,37.45%,1
臺北市,中山區,0902,552,317,869,35,904,1467,61.62%,37.63%,1
臺北市,中山區,0903,604,272,876,29,905,1491,60.7%,40.51%,1
臺北市,中山區,0904,654,293,947,33,980,1516,64.64%,43.14%,1
臺北市,中山區,0905,443,293,736,24,760,1384,54.91%,32.01%,1
臺北市,中山區,0906,432,278,710,22,732,1138,64.32%,37.96%,1
臺北市,中山區,0907,486,301,787,31,818,1513,54.06%,32.12%,1
臺北市,中山區,0908,569,316,885,45,930,1559,59.65%,36.5%,1
臺北市,中山區,0909,559,294,853,39,892,1429,62.42%,39.12%,1
臺北市,中山區,0910,473,274,747,25,772,1245,62.01%,37.99%,1
臺北市,中山區,0911,490,250,740,30,770,1214,63.43%,40.36%,1
臺北市,中山區,0912,518,296,814,21,835,1394,59.9%,37.16%,1
臺北市,中山區,0913,449,265,714,11,725,1336,54.27%,33.61%,1
臺北市,中山區,0914,434,247,681,26,707,1227,57.62%,35.37%,1
臺北市,中山區,0915,527,261,788,32,820,1382,59.33%,38.13%,1
臺北市,中山區,0916,540,251,791,37,828,1436,57.66%,37.6%,1
臺北市,中山區,0917,425,280,705,32,737,1405,52.46%,30.25%,1
臺北市,中山區,0918,462,248,710,25,735,1259,58.38%,36.7%,1
臺北市,中正區,1001,500,265,765,22,787,1308,60.17%,38.23%,1
臺北市,中正區,1002,454,260,714,26,740,1317,56.19%,34.47%,1
臺北市,中正區,1003,437,208,645,18,663,1069,62.02%,40.88%,1
臺北市,中正區,1004,414,196,610,27,637,1128,56.47%,36.7%,1
臺北市,中正區,1005,395,222,617,32,649,1053,61.63%,37.51%,1
臺北市,中正區,1006,406,217,623,11,634,1048,60.5%,38.74%,1
臺北市,中正區,1007,502,210,712,28,740,1297,57.05%,38.7%,1
臺北市,中正區,1008,481,232,713,10,723,1193,60.6%,40.32%,1
臺北市,中正區,1009,624,341,965,24,989,1500,65.93%,41.6%,1
臺北市,中正區,1010,469,275,744,19,763,1346,56.69%,34.84%,1
臺北市,中正區,1011,462,272,734,13,747,1283,58.22%,36.01%,1
臺北市,中正區,1012,475,305,780,36,816,1450,56.28%,32.76%,1
臺北市,中正區,1013,506,315,821,36,857,1433,59.8%,35.31%,1
臺北市,中正區,1014,528,312,840,24,864,1309,66%,40.34%,1
臺北市,中正區,1015,534,283,817,15,832,1386,60.03%,38.53%,1
臺北市,中正區,1016,456,253,709,21,730,1201,60.78%,37.97%,1
臺北市,中正區,1017,525,270,795,31,826,1336,61.83%,39.3%,1
臺北市,中正區,1018,530,275,805,32,837,1358,61.63%,39.03%,1
臺北市,中正區,1019,433,253,686,33,719,1177,61.09%,36.79%,1
臺北市,中正區,1020,493,265,758,31,789,1236,63.83%,39.89%,1
臺北市,中正區,1021,552,268,820,42,862,1478,58.32%,37.35%,1
臺北市,中正區,1022,558,302,860,22,882,1474,59.84%,37.86%,1
臺北市,中正區,1023,419,246,665,27,692,1172,59.04%,35.75%,1
臺北市,中正區,1024,472,264,736,35,771,1310,58.85%,36.03%,1
臺北市,中正區,1025,489,231,720,41,761,1263,60.25%,38.72%,1
臺北市,中正區,1026,442,232,674,31,705,1169,60.31%,37.81%,1
臺北市,中正區,1027,531,263,794,22,816,1391,58.66%,38.17%,1
臺北市,中正區,1028,470,186,656,18,674,1201,56.12%,39.13%,1
臺北市,中正區,1029,510,249,759,32,791,1324,59.74%,38.52%,1
臺北市,中正區,1030,460,203,663,33,696,1216,57.24%,37.83%,1
臺北市,中正區,1031,419,237,656,31,687,1183,58.07%,35.42%,1
臺北市,中正區,1032,555,304,859,41,900,1469,61.27%,37.78%,1
臺北市,中正區,1033,499,301,800,25,825,1411,58.47%,35.36%,1
臺北市,中正區,1034,534,262,796,53,849,1398,60.73%,38.2%,1
臺北市,中正區,1035,560,251,811,36,847,1479,57.27%,37.86%,1
臺北市,中正區,1036,600,287,887,29,916,1620,56.54%,37.04%,1
臺北市,中正區,1037,394,217,611,14,625,1041,60.04%,37.85%,1
臺北市,中正區,1038,372,230,602,20,622,1056,58.9%,35.23%,1
臺北市,中正區,1039,459,217,676,17,693,1063,65.19%,43.18%,1
臺北市,中正區,1040,496,223,719,33,752,1591,47.27%,31.18%,1
臺北市,中正區,1041,488,189,677,38,715,1502,47.6%,32.49%,1
臺北市,中正區,1042,478,208,686,29,715,1331,53.72%,35.91%,1
臺北市,中正區,1043,545,231,776,44,820,1441,56.9%,37.82%,1
臺北市,中正區,1044,489,277,766,28,794,1273,62.37%,38.41%,1
臺北市,中正區,1045,457,209,666,31,697,1133,61.52%,40.34%,1
臺北市,中正區,1046,487,187,674,20,694,1156,60.03%,42.13%,1
臺北市,中正區,1047,474,289,763,34,797,1377,57.88%,34.42%,1
臺北市,中正區,1048,511,242,753,28,781,1266,61.69%,40.36%,1
臺北市,中正區,1049,471,215,686,27,713,1111,64.18%,42.39%,1
臺北市,中正區,1050,419,242,661,20,681,1124,60.59%,37.28%,1
臺北市,中正區,1051,543,273,816,29,845,1373,61.54%,39.55%,1
臺北市,中正區,1052,560,258,818,23,841,1351,62.25%,41.45%,1
臺北市,中正區,1053,572,308,880,19,899,1495,60.13%,38.26%,1
臺北市,中正區,1054,576,324,900,26,926,1436,64.48%,40.11%,1
臺北市,中正區,1055,553,311,864,15,879,1516,57.98%,36.48%,1
臺北市,中正區,1056,514,271,785,24,809,1374,58.88%,37.41%,1
臺北市,中正區,1057,555,269,824,16,840,1522,55.19%,36.47%,1
臺北市,中正區,1058,518,270,788,21,809,1336,60.55%,38.77%,1
臺北市,中正區,1059,549,342,891,29,920,1551,59.32%,35.4%,1
臺北市,中正區,1060,586,334,920,39,959,1594,60.16%,36.76%,1
臺北市,中正區,1061,545,303,848,26,874,1503,58.15%,36.26%,1
臺北市,中正區,1062,588,257,845,22,867,1455,59.59%,40.41%,1
臺北市,中正區,1063,542,308,850,16,866,1439,60.18%,37.67%,1
臺北市,中正區,1064,603,250,853,25,878,1469,59.77%,41.05%,1
臺北市,中正區,1065,618,232,850,29,879,1430,61.47%,43.22%,1
臺北市,中正區,1066,554,311,865,26,891,1444,61.7%,38.37%,1
臺北市,中正區,1067,473,245,718,14,732,1254,58.37%,37.72%,1
臺北市,中正區,1068,367,176,543,29,572,932,61.37%,39.38%,1
臺北市,中正區,1069,376,224,600,44,644,1055,61.04%,35.64%,1
臺北市,中正區,1070,476,226,702,22,724,1226,59.05%,38.83%,1
臺北市,中正區,1071,555,157,712,27,739,1390,53.17%,39.93%,1
臺北市,中正區,1072,491,261,752,27,779,1336,58.31%,36.75%,1
臺北市,中正區,1073,466,269,735,26,761,1419,53.63%,32.84%,1
臺北市,中正區,1074,540,283,823,31,854,1361,62.75%,39.68%,1
臺北市,中正區,1075,606,262,868,27,895,2520,35.52%,24.05%,1
臺北市,中正區,1076,488,222,710,13,723,1224,59.07%,39.87%,1
臺北市,中正區,1077,447,223,670,5,675,1272,53.07%,35.14%,1
臺北市,中正區,1078,478,314,792,27,819,1400,58.5%,34.14%,1
臺北市,中正區,1079,454,272,726,27,753,1319,57.09%,34.42%,1
臺北市,中正區,1080,487,254,741,25,766,1232,62.18%,39.53%,1
臺北市,中正區,1081,506,279,785,31,816,1265,64.51%,40%,1
臺北市,中正區,1082,419,238,657,19,676,1055,64.08%,39.72%,1
臺北市,中正區,1083,361,178,539,29,568,954,59.54%,37.84%,1
臺北市,中正區,1084,412,198,610,19,629,1018,61.79%,40.47%,1
臺北市,中正區,1085,494,299,793,32,825,1431,57.65%,34.52%,1
臺北市,中正區,1086,386,257,643,34,677,1271,53.27%,30.37%,1
臺北市,中正區,1087,381,212,593,22,615,983,62.56%,38.76%,1
臺北市,中正區,1088,583,300,883,35,918,1594,57.59%,36.57%,1
臺北市,中正區,1089,595,316,911,32,943,1565,60.26%,38.02%,1
臺北市,中正區,1090,604,328,932,26,958,1650,58.06%,36.61%,1
臺北市,中正區,1091,563,297,860,27,887,1600,55.44%,35.19%,1
臺北市,中正區,1092,484,290,774,20,794,1391,57.08%,34.8%,1
臺北市,中正區,1093,633,350,983,22,1005,1769,56.81%,35.78%,1
臺北市,中正區,1094,527,319,846,31,877,1487,58.98%,35.44%,1
臺北市,中正區,1095,488,270,758,26,784,1291,60.73%,37.8%,1
臺北市,中正區,1096,481,282,763,21,784,1289,60.82%,37.32%,1
臺北市,大同區,0919,443,264,707,49,756,1261,59.95%,35.13%,1
臺北市,大同區,0920,513,289,802,35,837,1352,61.91%,37.94%,1
臺北市,大同區,0921,530,285,815,30,845,1462,57.8%,36.25%,1
臺北市,大同區,0922,550,245,795,45,840,1510,55.63%,36.42%,1
臺北市,大同區,0923,498,287,785,24,809,1496,54.08%,33.29%,1
臺北市,大同區,0924,479,251,730,24,754,1329,56.73%,36.04%,1
臺北市,大同區,0925,481,235,716,52,768,1307,58.76%,36.8%,1
臺北市,大同區,0926,374,233,607,27,634,1065,59.53%,35.12%,1
臺北市,大同區,0927,387,236,623,19,642,1085,59.17%,35.67%,1
臺北市,大同區,0928,398,242,640,37,677,1047,64.66%,38.01%,1
臺北市,大同區,0929,371,268,639,27,666,1215,54.81%,30.53%,1
臺北市,大同區,0930,422,255,677,24,701,1117,62.76%,37.78%,1
臺北市,大同區,0931,549,161,710,23,733,1186,61.8%,46.29%,1
臺北市,大同區,0932,455,238,693,36,729,1185,61.52%,38.4%,1
臺北市,大同區,0933,512,250,762,27,789,1359,58.06%,37.67%,1
臺北市,大同區,0934,486,235,721,16,737,1273,57.89%,38.18%,1
臺北市,大同區,0935,474,309,783,29,812,1291,62.9%,36.72%,1
臺北市,大同區,0936,450,250,700,21,721,1288,55.98%,34.94%,1
臺北市,大同區,0937,500,266,766,27,793,1245,63.69%,40.16%,1
臺北市,大同區,0938,466,298,764,31,795,1261,63.05%,36.95%,1
臺北市,大同區,0939,465,266,731,19,750,1348,55.64%,34.5%,1
臺北市,大同區,0940,588,354,942,49,991,1676,59.13%,35.08%,1
臺北市,大同區,0941,521,254,775,37,812,1311,61.94%,39.74%,1
臺北市,大同區,0942,506,254,760,41,801,1316,60.87%,38.45%,1
臺北市,大同區,0943,499,285,784,48,832,1409,59.05%,35.42%,1
臺北市,大同區,0944,509,324,833,38,871,1436,60.65%,35.45%,1
臺北市,大同區,0945,516,281,797,40,837,1408,59.45%,36.65%,1
臺北市,大同區,0946,481,229,710,27,737,1276,57.76%,37.7%,1
臺北市,大同區,0947,433,196,629,14,643,1110,57.93%,39.01%,1
臺北市,大同區,0948,478,282,760,20,780,1324,58.91%,36.1%,1
臺北市,大同區,0949,384,180,564,25,589,1016,57.97%,37.8%,1
臺北市,大同區,0950,421,202,623,21,644,1028,62.65%,40.95%,1
臺北市,大同區,0951,471,209,680,27,707,1158,61.05%,40.67%,1
臺北市,大同區,0952,467,213,680,26,706,1138,62.04%,41.04%,1
臺北市,大同區,0953,471,235,706,29,735,1214,60.54%,38.8%,1
臺北市,大同區,0954,421,193,614,24,638,1090,58.53%,38.62%,1
臺北市,大同區,0955,629,159,788,36,824,1305,63.14%,48.2%,1
臺北市,大同區,0956,424,223,647,19,666,1167,57.07%,36.33%,1
臺北市,大同區,0957,411,238,649,28,677,1148,58.97%,35.8%,1
臺北市,大同區,0958,474,257,731,26,757,1203,62.93%,39.4%,1
臺北市,大同區,0959,503,296,799,21,820,1441,56.9%,34.91%,1
臺北市,大同區,0960,513,266,779,44,823,1315,62.59%,39.01%,1
臺北市,大同區,0961,478,298,776,31,807,1393,57.93%,34.31%,1
臺北市,大同區,0962,450,284,734,31,765,1278,59.86%,35.21%,1
臺北市,大同區,0963,415,239,654,27,681,1246,54.65%,33.31%,1
臺北市,大同區,0964,432,200,632,40,672,1142,58.84%,37.83%,1
臺北市,大同區,0965,543,257,800,34,834,1336,62.43%,40.64%,1
臺北市,大同區,0966,500,296,796,40,836,1363,61.34%,36.68%,1
臺北市,大同區,0967,581,281,862,15,877,1476,59.42%,39.36%,1
臺北市,大同區,0968,490,322,812,30,842,1418,59.38%,34.56%,1
臺北市,大同區,0969,546,254,800,25,825,1460,56.51%,37.4%,1
臺北市,大同區,0970,385,213,598,38,636,1222,52.05%,31.51%,1
臺北市,大同區,0971,405,194,599,60,659,1246,52.89%,32.5%,1
臺北市,大同區,0972,501,250,751,36,787,1256,62.66%,39.89%,1
臺北市,大同區,0973,467,276,743,20,763,1289,59.19%,36.23%,1
臺北市,大同區,0974,463,257,720,27,747,1340,55.75%,34.55%,1
臺北市,大同區,0975,499,311,810,37,847,1555,54.47%,32.09%,1
臺北市,大同區,0976,578,231,809,36,845,2459,34.36%,23.51%,1
臺北市,大同區,0977,363,144,507,36,543,1108,49.01%,32.76%,1
臺北市,大同區,0978,327,129,456,35,491,867,56.63%,37.72%,1
臺北市,大同區,0979,500,287,787,43,830,1329,62.45%,37.62%,1
臺北市,大同區,0980,398,255,653,29,682,1162,58.69%,34.25%,1
臺北市,大同區,0981,494,244,738,56,794,1434,55.37%,34.45%,1
臺北市,大同區,0982,483,272,755,40,795,1351,58.85%,35.75%,1
臺北市,大同區,0983,534,273,807,31,838,1531,54.74%,34.88%,1
臺北市,大同區,0984,453,295,748,25,773,1507,51.29%,30.06%,1
臺北市,大同區,0985,493,318,811,30,841,1488,56.52%,33.13%,1
臺北市,大同區,0986,542,274,816,37,853,1384,61.63%,39.16%,1
臺北市,大同區,0987,570,254,824,34,858,1460,58.77%,39.04%,1
臺北市,大同區,0988,534,282,816,26,842,1371,61.42%,38.95%,1
臺北市,大同區,0989,505,285,790,13,803,1439,55.8%,35.09%,1
臺北市,大同區,0990,506,290,796,37,833,1376,60.54%,36.77%,1
臺北市,大同區,0991,510,236,746,39,785,1366,57.47%,37.34%,1
臺北市,大同區,0992,490,267,757,36,793,1218,65.11%,40.23%,1
臺北市,大同區,0993,469,234,703,29,732,1235,59.27%,37.98%,1
臺北市,大同區,0994,549,196,745,18,763,1364,55.94%,40.25%,1
臺北市,大同區,0995,515,301,816,48,864,1408,61.36%,36.58%,1
臺北市,大同區,0996,515,297,812,42,854,1450,58.9%,35.52%,1
臺北市,大同區,0997,545,304,849,44,893,1429,62.49%,38.14%,1
臺北市,大同區,0998,476,218,694,33,727,1170,62.14%,40.68%,1
臺北市,大同區,0999,463,243,706,33,739,1245,59.36%,37.19%,1
臺北市,大同區,1000,509,249,758,43,801,1215,65.93%,41.89%,1
臺北市,萬華區,1097,491,248,739,35,774,1305,59.31%,37.62%,1
臺北市,萬華區,1098,397,168,565,41,606,1183,51.23%,33.56%,1
臺北市,萬華區,1099,444,208,652,18,670,1176,56.97%,37.76%,1
臺北市,萬華區,1100,378,217,595,21,616,1169,52.69%,32.34%,1
臺北市,萬華區,1101,522,198,720,25,745,1457,51.13%,35.83%,1
臺北市,萬華區,1102,474,236,710,43,753,1563,48.18%,30.33%,1
臺北市,萬華區,1103,535,313,848,23,871,1771,49.18%,30.21%,1
臺北市,萬華區,1104,502,310,812,24,836,1615,51.76%,31.08%,1
臺北市,萬華區,1105,524,249,773,56,829,1478,56.09%,35.45%,1
臺北市,萬華區,1106,512,271,783,32,815,1462,55.75%,35.02%,1
臺北市,萬華區,1107,488,212,700,39,739,1507,49.04%,32.38%,1
臺北市,萬華區,1108,485,274,759,34,793,1347,58.87%,36.01%,1
臺北市,萬華區,1109,446,247,693,37,730,1367,53.4%,32.63%,1
臺北市,萬華區,1110,507,250,757,29,786,1277,61.55%,39.7%,1
臺北市,萬華區,1111,510,299,809,39,848,1395,60.79%,36.56%,1
臺北市,萬華區,1112,476,280,756,40,796,1450,54.9%,32.83%,1
臺北市,萬華區,1113,429,238,667,31,698,1340,52.09%,32.01%,1
臺北市,萬華區,1114,422,215,637,34,671,1242,54.03%,33.98%,1
臺北市,萬華區,1115,476,196,672,47,719,1286,55.91%,37.01%,1
臺北市,萬華區,1116,502,185,687,39,726,1324,54.83%,37.92%,1
臺北市,萬華區,1117,528,294,822,44,866,1619,53.49%,32.61%,1
臺北市,萬華區,1118,441,197,638,41,679,1352,50.22%,32.62%,1
臺北市,萬華區,1119,530,224,754,38,792,1440,55%,36.81%,1
臺北市,萬華區,1120,430,260,690,34,724,1194,60.64%,36.01%,1
臺北市,萬華區,1121,447,198,645,49,694,1083,64.08%,41.27%,1
臺北市,萬華區,1122,420,222,642,45,687,1237,55.54%,33.95%,1
臺北市,萬華區,1123,544,313,857,41,898,1625,55.26%,33.48%,1
臺北市,萬華區,1124,496,270,766,37,803,1324,60.65%,37.46%,1
臺北市,萬華區,1125,480,292,772,31,803,1352,59.39%,35.5%,1
臺北市,萬華區,1126,484,242,726,31,757,2630,28.78%,18.4%,1
臺北市,萬華區,1127,567,309,876,35,911,1504,60.57%,37.7%,1
臺北市,萬華區,1128,490,281,771,26,797,1425,55.93%,34.39%,1
臺北市,萬華區,1129,527,264,791,36,827,1591,51.98%,33.12%,1
臺北市,萬華區,1130,534,249,783,31,814,1474,55.22%,36.23%,1
臺北市,萬華區,1131,527,280,807,45,852,1612,52.85%,32.69%,1
臺北市,萬華區,1132,525,283,808,37,845,1447,58.4%,36.28%,1
臺北市,萬華區,1133,556,244,800,45,845,1491,56.67%,37.29%,1
臺北市,萬華區,1134,585,284,869,25,894,1500,59.6%,39%,1
臺北市,萬華區,1135,604,291,895,42,937,1582,59.23%,38.18%,1
臺北市,萬華區,1136,567,245,812,41,853,1623,52.56%,34.94%,1
臺北市,萬華區,1137,420,237,657,25,682,1228,55.54%,34.2%,1
臺北市,萬華區,1138,470,215,685,36,721,1268,56.86%,37.07%,1
臺北市,萬華區,1139,475,226,701,34,735,1207,60.89%,39.35%,1
臺北市,萬華區,1140,455,238,693,23,716,1188,60.27%,38.3%,1
臺北市,萬華區,1141,519,250,769,33,802,1474,54.41%,35.21%,1
臺北市,萬華區,1142,434,177,611,23,634,1304,48.62%,33.28%,1
臺北市,萬華區,1143,332,122,454,25,479,1082,44.27%,30.68%,1
臺北市,萬華區,1144,366,184,550,30,580,1052,55.13%,34.79%,1
臺北市,萬華區,1145,381,238,619,26,645,1135,56.83%,33.57%,1
臺北市,萬華區,1146,430,225,655,43,698,1225,56.98%,35.1%,1
臺北市,萬華區,1147,533,261,794,38,832,1583,52.56%,33.67%,1
臺北市,萬華區,1148,458,302,760,30,790,1403,56.31%,32.64%,1
臺北市,萬華區,1149,510,270,780,37,817,1406,58.11%,36.27%,1
臺北市,萬華區,1150,527,295,822,37,859,1401,61.31%,37.62%,1
臺北市,萬華區,1151,426,262,688,33,721,1188,60.69%,35.86%,1
臺北市,萬華區,1152,558,256,814,55,869,1597,54.41%,34.94%,1
臺北市,萬華區,1153,508,246,754,43,797,1290,61.78%,39.38%,1
臺北市,萬華區,1154,563,300,863,24,887,1746,50.8%,32.25%,1
臺北市,萬華區,1155,479,261,740,30,770,1595,48.28%,30.03%,1
臺北市,萬華區,1156,593,289,882,58,940,1701,55.26%,34.86%,1
臺北市,萬華區,1157,417,194,611,51,662,1339,49.44%,31.14%,1
臺北市,萬華區,1158,489,193,682,55,737,1484,49.66%,32.95%,1
臺北市,萬華區,1159,606,261,867,45,912,1604,56.86%,37.78%,1
臺北市,萬華區,1160,467,211,678,32,710,1197,59.31%,39.01%,1
臺北市,萬華區,1161,444,243,687,51,738,1347,54.79%,32.96%,1
臺北市,萬華區,1162,483,275,758,26,784,1223,64.1%,39.49%,1
臺北市,萬華區,1163,411,195,606,23,629,1036,60.71%,39.67%,1
臺北市,萬華區,1164,418,228,646,19,665,1035,64.25%,40.39%,1
臺北市,萬華區,1165,455,233,688,24,712,1141,62.4%,39.88%,1
臺北市,萬華區,1166,506,233,739,22,761,1271,59.87%,39.81%,1
臺北市,萬華區,1167,492,260,752,57,809,1328,60.92%,37.05%,1
臺北市,萬華區,1168,496,240,736,30,766,1286,59.56%,38.57%,1
臺北市,萬華區,1169,626,328,954,43,997,1679,59.38%,37.28%,1
臺北市,萬華區,1170,579,304,883,36,919,1619,56.76%,35.76%,1
臺北市,萬華區,1171,537,258,795,30,825,1625,50.77%,33.05%,1
臺北市,萬華區,1172,648,280,928,34,962,1623,59.27%,39.93%,1
臺北市,萬華區,1173,483,216,699,35,734,1280,57.34%,37.73%,1
臺北市,萬華區,1174,571,290,861,38,899,1608,55.91%,35.51%,1
臺北市,萬華區,1175,545,266,811,40,851,1453,58.57%,37.51%,1
臺北市,萬華區,1176,593,287,880,27,907,1472,61.62%,40.29%,1
臺北市,萬華區,1177,508,272,780,20,800,1373,58.27%,37%,1
臺北市,萬華區,1178,504,249,753,28,781,1394,56.03%,36.15%,1
臺北市,萬華區,1179,496,252,748,25,773,1427,54.17%,34.76%,1
臺北市,萬華區,1180,534,265,799,35,834,1342,62.15%,39.79%,1
臺北市,萬華區,1181,608,280,888,43,931,1569,59.34%,38.75%,1
臺北市,萬華區,1182,515,227,742,31,773,1514,51.06%,34.02%,1
臺北市,萬華區,1183,573,254,827,30,857,1720,49.83%,33.31%,1
臺北市,萬華區,1184,606,273,879,41,920,1461,62.97%,41.48%,1
臺北市,萬華區,1185,479,207,686,30,716,1264,56.65%,37.9%,1
臺北市,萬華區,1186,560,244,804,34,838,1334,62.82%,41.98%,1
臺北市,萬華區,1187,559,268,827,25,852,1446,58.92%,38.66%,1
臺北市,萬華區,1188,488,193,681,32,713,1307,54.55%,37.34%,1
臺北市,萬華區,1189,555,243,798,41,839,1420,59.08%,39.08%,1
臺北市,萬華區,1190,501,238,739,28,767,1427,53.75%,35.11%,1
臺北市,萬華區,1191,365,152,517,30,547,956,57.22%,38.18%,1
臺北市,萬華區,1192,519,239,758,48,806,1352,59.62%,38.39%,1
臺北市,萬華區,1193,529,205,734,46,780,1370,56.93%,38.61%,1
臺北市,萬華區,1194,507,201,708,26,734,1222,60.07%,41.49%,1
臺北市,萬華區,1195,633,165,798,39,837,1375,60.87%,46.04%,1
臺北市,萬華區,1196,601,225,826,41,867,1463,59.26%,41.08%,1
臺北市,萬華區,1197,583,222,805,27,832,1527,54.49%,38.18%,1
臺北市,萬華區,1198,574,207,781,38,819,1485,55.15%,38.65%,1
臺北市,萬華區,1199,723,218,941,41,982,1591,61.72%,45.44%,1
臺北市,萬華區,1200,629,241,870,27,897,1394,64.35%,45.12%,1
臺北市,萬華區,1201,588,271,859,27,886,1522,58.21%,38.63%,1
臺北市,萬華區,1202,704,271,975,34,1009,1661,60.75%,42.38%,1
臺北市,萬華區,1203,570,271,841,27,868,1561,55.61%,36.52%,1
臺北市,萬華區,1204,600,256,856,38,894,1406,63.58%,42.67%,1
臺北市,萬華區,1205,489,216,705,23,728,1498,48.6%,32.64%,1
臺北市,萬華區,1206,482,193,675,39,714,1478,48.31%,32.61%,1
臺北市,萬華區,1207,443,183,626,32,658,1170,56.24%,37.86%,1
臺北市,萬華區,1208,574,229,803,22,825,1376,59.96%,41.72%,1
臺北市,萬華區,1209,438,182,620,16,636,1093,58.19%,40.07%,1
臺北市,萬華區,1210,476,181,657,30,687,1084,63.38%,43.91%,1
臺北市,萬華區,1211,458,184,642,35,677,1119,60.5%,40.93%,1
臺北市,萬華區,1212,578,244,822,38,860,1381,62.27%,41.85%,1
臺北市,萬華區,1213,540,261,801,28,829,1396,59.38%,38.68%,1
臺北市,文山區,1402,552,294,846,31,877,1539,56.99%,35.87%,1
臺北市,文山區,1403,576,258,834,17,851,1548,54.97%,37.21%,1
臺北市,文山區,1404,591,272,863,42,905,1493,60.62%,39.58%,1
臺北市,文山區,1405,633,337,970,32,1002,1648,60.8%,38.41%,1
臺北市,文山區,1406,591,280,871,27,898,1544,58.16%,38.28%,1
臺北市,文山區,1407,610,269,879,30,909,1557,58.38%,39.18%,1
臺北市,文山區,1408,558,284,842,29,871,1514,57.53%,36.86%,1
臺北市,文山區,1409,649,314,963,27,990,1540,64.29%,42.14%,1
臺北市,文山區,1410,592,288,880,29,909,1466,62.01%,40.38%,1
臺北市,文山區,1411,589,271,860,38,898,1444,62.19%,40.79%,1
臺北市,文山區,1412,567,279,846,35,881,1455,60.55%,38.97%,1
臺北市,文山區,1413,533,251,784,27,811,1440,56.32%,37.01%,1
臺北市,文山區,1414,458,261,719,41,760,1398,54.36%,32.76%,1
臺北市,文山區,1415,508,292,800,13,813,1412,57.58%,35.98%,1
臺北市,文山區,1416,552,255,807,27,834,1426,58.49%,38.71%,1
臺北市,文山區,1417,552,277,829,28,857,1437,59.64%,38.41%,1
臺北市,文山區,1418,509,268,777,28,805,1340,60.07%,37.99%,1
臺北市,文山區,1419,562,326,888,25,913,1568,58.23%,35.84%,1
臺北市,文山區,1420,544,240,784,18,802,1372,58.45%,39.65%,1
臺北市,文山區,1421,380,213,593,24,617,1046,58.99%,36.33%,1
臺北市,文山區,1422,477,260,737,35,772,1274,60.6%,37.44%,1
臺北市,文山區,1423,521,246,767,21,788,1324,59.52%,39.35%,1
臺北市,文山區,1424,642,326,968,26,994,1722,57.72%,37.28%,1
臺北市,文山區,1425,691,348,1039,39,1078,1737,62.06%,39.78%,1
臺北市,文山區,1426,535,311,846,21,867,1370,63.28%,39.05%,1
臺北市,文山區,1427,557,302,859,38,897,1495,60%,37.26%,1
臺北市,文山區,1428,491,281,772,38,810,1328,60.99%,36.97%,1
臺北市,文山區,1429,472,224,696,29,725,1138,63.71%,41.48%,1
臺北市,文山區,1430,612,278,890,22,912,1471,62%,41.6%,1
臺北市,文山區,1431,466,231,697,18,715,1144,62.5%,40.73%,1
臺北市,文山區,1432,480,244,724,28,752,1176,63.95%,40.82%,1
臺北市,文山區,1433,527,224,751,30,781,1212,64.44%,43.48%,1
臺北市,文山區,1434,514,261,775,20,795,1214,65.49%,42.34%,1
臺北市,文山區,1435,411,240,651,23,674,1170,57.61%,35.13%,1
臺北市,文山區,1436,505,267,772,33,805,1308,61.54%,38.61%,1
臺北市,文山區,1437,450,234,684,38,722,1190,60.67%,37.82%,1
臺北市,文山區,1438,439,101,540,26,566,1110,50.99%,39.55%,1
臺北市,文山區,1439,588,272,860,31,891,1512,58.93%,38.89%,1
臺北市,文山區,1440,586,240,826,37,863,1387,62.22%,42.25%,1
臺北市,文山區,1441,519,263,782,36,818,1355,60.37%,38.3%,1
臺北市,文山區,1442,503,282,785,40,825,1370,60.22%,36.72%,1
臺北市,文山區,1443,587,287,874,31,905,1484,60.98%,39.56%,1
臺北市,文山區,1444,647,349,996,52,1048,1786,58.68%,36.23%,1
臺北市,文山區,1445,512,223,735,36,771,1260,61.19%,40.63%,1
臺北市,文山區,1446,471,290,761,23,784,1194,65.66%,39.45%,1
臺北市,文山區,1447,576,255,831,35,866,1444,59.97%,39.89%,1
臺北市,文山區,1448,555,314,869,31,900,1495,60.2%,37.12%,1
臺北市,文山區,1449,591,270,861,23,884,1446,61.13%,40.87%,1
臺北市,文山區,1450,538,262,800,53,853,1450,58.83%,37.1%,1
臺北市,文山區,1451,575,310,885,27,912,1486,61.37%,38.69%,1
臺北市,文山區,1452,515,238,753,20,773,1259,61.4%,40.91%,1
臺北市,文山區,1453,533,272,805,15,820,1317,62.26%,40.47%,1
臺北市,文山區,1454,540,266,806,28,834,1321,63.13%,40.88%,1
臺北市,文山區,1455,550,283,833,33,866,1475,58.71%,37.29%,1
臺北市,文山區,1456,462,242,704,28,732,1271,57.59%,36.35%,1
臺北市,文山區,1457,619,330,949,27,976,1609,60.66%,38.47%,1
臺北市,文山區,1458,582,248,830,22,852,1501,56.76%,38.77%,1
臺北市,文山區,1459,347,180,527,25,552,997,55.37%,34.8%,1
臺北市,文山區,1460,426,233,659,28,687,1052,65.3%,40.49%,1
臺北市,文山區,1461,499,235,734,31,765,1247,61.35%,40.02%,1
臺北市,文山區,1462,443,244,687,37,724,1167,62.04%,37.96%,1
臺北市,文山區,1463,513,256,769,17,786,1280,61.41%,40.08%,1
臺北市,文山區,1464,470,219,689,25,714,1153,61.93%,40.76%,1
臺北市,文山區,1465,604,300,904,35,939,1557,60.31%,38.79%,1
臺北市,文山區,1466,581,247,828,35,863,1444,59.76%,40.24%,1
臺北市,文山區,1467,611,314,925,20,945,1459,64.77%,41.88%,1
臺北市,文山區,1468,602,256,858,24,882,1357,65%,44.36%,1
臺北市,文山區,1469,521,247,768,27,795,1194,66.58%,43.63%,1
臺北市,文山區,1470,476,249,725,42,767,1184,64.78%,40.2%,1
臺北市,文山區,1471,454,250,704,31,735,1119,65.68%,40.57%,1
臺北市,文山區,1472,550,286,836,27,863,1350,63.93%,40.74%,1
臺北市,文山區,1473,576,242,818,30,848,1502,56.46%,38.35%,1
臺北市,文山區,1474,615,274,889,29,918,1511,60.75%,40.7%,1
臺北市,文山區,1475,583,334,917,21,938,1481,63.34%,39.37%,1
臺北市,文山區,1476,630,291,921,27,948,1477,64.18%,42.65%,1
臺北市,文山區,1477,543,249,792,19,811,1294,62.67%,41.96%,1
臺北市,文山區,1478,456,232,688,21,709,1040,68.17%,43.85%,1
臺北市,文山區,1479,551,258,809,26,835,1323,63.11%,41.65%,1
臺北市,文山區,1480,454,239,693,25,718,1153,62.27%,39.38%,1
臺北市,文山區,1481,581,279,860,31,891,1525,58.43%,38.1%,1
臺北市,文山區,1482,531,224,755,35,790,1412,55.95%,37.61%,1
臺北市,文山區,1483,550,340,890,34,924,1473,62.73%,37.34%,1
臺北市,文山區,1484,504,380,884,32,916,1486,61.64%,33.92%,1
臺北市,文山區,1485,651,339,990,28,1018,1616,63%,40.28%,1
臺北市,文山區,1486,629,291,920,35,955,1489,64.14%,42.24%,1
臺北市,文山區,1487,576,237,813,29,842,1414,59.55%,40.74%,1
臺北市,文山區,1488,609,321,930,31,961,1494,64.32%,40.76%,1
臺北市,文山區,1489,640,288,928,36,964,1547,62.31%,41.37%,1
臺北市,文山區,1490,637,304,941,30,971,1587,61.18%,40.14%,1
臺北市,文山區,1491,612,350,962,30,992,1515,65.48%,40.4%,1
臺北市,文山區,1492,648,313,961,31,992,1573,63.06%,41.2%,1
臺北市,文山區,1493,600,338,938,30,968,1542,62.78%,38.91%,1
臺北市,文山區,1494,523,256,779,32,811,1465,55.36%,35.7%,1
臺北市,文山區,1495,210,102,312,25,337,699,48.21%,30.04%,1
臺北市,文山區,1496,450,230,680,34,714,1372,52.04%,32.8%,1
臺北市,文山區,1497,480,228,708,42,750,1448,51.8%,33.15%,1
臺北市,文山區,1498,597,274,871,42,913,1548,58.98%,38.57%,1
臺北市,文山區,1499,568,305,873,27,900,1501,59.96%,37.84%,1
臺北市,文山區,1500,578,329,907,34,941,1560,60.32%,37.05%,1
臺北市,文山區,1501,593,310,903,29,932,1567,59.48%,37.84%,1
臺北市,文山區,1502,563,337,900,24,924,1554,59.46%,36.23%,1
臺北市,文山區,1503,615,274,889,29,918,1544,59.46%,39.83%,1
臺北市,文山區,1504,579,312,891,38,929,1528,60.8%,37.89%,1
臺北市,文山區,1505,661,281,942,22,964,1543,62.48%,42.84%,1
臺北市,文山區,1506,602,310,912,52,964,2754,35%,21.86%,1
臺北市,文山區,1507,561,293,854,40,894,1709,52.31%,32.83%,1
臺北市,文山區,1508,578,243,821,50,871,1515,57.49%,38.15%,1
臺北市,文山區,1509,552,270,822,40,862,1571,54.87%,35.14%,1
臺北市,文山區,1510,557,323,880,31,911,1578,57.73%,35.3%,1
臺北市,文山區,1511,532,268,800,24,824,1454,56.67%,36.59%,1
臺北市,文山區,1512,532,287,819,42,861,1436,59.96%,37.05%,1
臺北市,文山區,1513,604,246,850,36,886,1402,63.2%,43.08%,1
臺北市,文山區,1514,262,215,477,29,506,1117,45.3%,23.46%,1
臺北市,文山區,1515,394,222,616,39,655,1094,59.87%,36.01%,1
臺北市,文山區,1516,464,196,660,30,690,1070,64.49%,43.36%,1
臺北市,文山區,1517,570,245,815,36,851,1319,64.52%,43.21%,1
臺北市,文山區,1518,539,229,768,22,790,1226,64.44%,43.96%,1
臺北市,文山區,1519,533,242,775,32,807,1385,58.27%,38.48%,1
臺北市,文山區,1520,541,287,828,36,864,1416,61.02%,38.21%,1
臺北市,文山區,1521,598,287,885,24,909,1412,64.38%,42.35%,1
臺北市,文山區,1522,565,278,843,42,885,1535,57.65%,36.81%,1
臺北市,文山區,1523,689,320,1009,41,1050,1654,63.48%,41.66%,1
臺北市,文山區,1524,474,231,705,28,733,1156,63.41%,41%,1
臺北市,文山區,1525,477,278,755,25,780,1231,63.36%,38.75%,1
臺北市,文山區,1526,409,194,603,25,628,1218,51.56%,33.58%,1
臺北市,文山區,1527,473,258,731,29,760,1176,64.63%,40.22%,1
臺北市,文山區,1528,570,287,857,7,864,1392,62.07%,40.95%,1
臺北市,文山區,1529,508,253,761,53,814,1323,61.53%,38.4%,1
臺北市,文山區,1530,513,229,742,24,766,1297,59.06%,39.55%,1
臺北市,文山區,1531,507,270,777,38,815,1296,62.89%,39.12%,1
臺北市,文山區,1532,628,289,917,33,950,1613,58.9%,38.93%,1
臺北市,文山區,1533,673,324,997,37,1034,1697,60.93%,39.66%,1
臺北市,文山區,1534,580,320,900,49,949,1579,60.1%,36.73%,1
臺北市,文山區,1535,541,265,806,39,845,1320,64.02%,40.98%,1
臺北市,文山區,1536,571,283,854,23,877,1438,60.99%,39.71%,1
臺北市,文山區,1537,565,248,813,17,830,1465,56.66%,38.57%,1
臺北市,文山區,1538,544,392,936,42,978,1646,59.42%,33.05%,1
臺北市,文山區,1539,498,260,758,28,786,1286,61.12%,38.72%,1
臺北市,文山區,1540,461,269,730,22,752,1219,61.69%,37.82%,1
臺北市,文山區,1541,516,263,779,25,804,1292,62.23%,39.94%,1
臺北市,文山區,1542,550,249,799,39,838,1489,56.28%,36.94%,1
臺北市,文山區,1543,552,405,957,32,989,1611,61.39%,34.26%,1
臺北市,文山區,1544,516,261,777,38,815,1549,52.61%,33.31%,1
臺北市,文山區,1545,613,286,899,49,948,1678,56.5%,36.53%,1
臺北市,文山區,1546,606,293,899,39,938,1660,56.51%,36.51%,1
臺北市,文山區,1547,562,328,890,27,917,1816,50.5%,30.95%,1
臺北市,文山區,1548,350,198,548,18,566,985,57.46%,35.53%,1
臺北市,文山區,1549,521,267,788,18,806,1314,61.34%,39.65%,1
臺北市,文山區,1550,440,201,641,32,673,1018,66.11%,43.22%,1
臺北市,文山區,1551,554,358,912,26,938,1578,59.44%,35.11%,1
臺北市,文山區,1552,521,313,834,25,859,1457,58.96%,35.76%,1
臺北市,文山區,1553,517,273,790,28,818,1326,61.69%,38.99%,1
臺北市,文山區,1554,538,300,838,24,862,1393,61.88%,38.62%,1
臺北市,文山區,1555,472,283,755,41,796,1377,57.81%,34.28%,1
臺北市,文山區,1556,512,336,848,26,874,1448,60.36%,35.36%,1
臺北市,文山區,1557,548,346,894,29,923,1447,63.79%,37.87%,1
臺北市,文山區,1558,649,447,1096,42,1138,1739,65.44%,37.32%,1
臺北市,文山區,1559,507,351,858,26,884,1457,60.67%,34.8%,1
臺北市,文山區,1560,471,295,766,33,799,1288,62.03%,36.57%,1
臺北市,文山區,1561,427,248,675,47,722,1301,55.5%,32.82%,1
臺北市,文山區,1562,303,135,438,41,479,865,55.38%,35.03%,1
臺北市,文山區,1563,293,122,415,28,443,789,56.15%,37.14%,1
臺北市,南港區,0455,465,230,695,17,712,1280,55.63%,36.33%,1
臺北市,南港區,0456,525,246,771,18,789,1351,58.4%,38.86%,1
臺北市,南港區,0457,511,275,786,22,808,1345,60.07%,37.99%,1
臺北市,南港區,0458,475,249,724,28,752,1679,44.79%,28.29%,1
臺北市,南港區,0459,575,309,884,25,909,1680,54.11%,34.23%,1
臺北市,南港區,0460,555,261,816,37,853,1635,52.17%,33.94%,1
臺北市,南港區,0461,559,237,796,21,817,1459,56%,38.31%,1
臺北市,南港區,0462,594,377,971,21,992,1706,58.15%,34.82%,1
臺北市,南港區,0463,568,299,867,37,904,1674,54%,33.93%,1
臺北市,南港區,0464,518,311,829,17,846,1491,56.74%,34.74%,1
臺北市,南港區,0465,448,233,681,23,704,1086,64.83%,41.25%,1
臺北市,南港區,0466,489,249,738,43,781,1202,64.98%,40.68%,1
臺北市,南港區,0467,475,242,717,17,734,1198,61.27%,39.65%,1
臺北市,南港區,0468,493,281,774,26,800,1430,55.94%,34.48%,1
臺北市,南港區,0469,438,322,760,29,789,1275,61.88%,34.35%,1
臺北市,南港區,0470,473,352,825,43,868,1344,64.58%,35.19%,1
臺北市,南港區,0471,481,337,818,19,837,1391,60.17%,34.58%,1
臺北市,南港區,0472,490,309,799,22,821,1342,61.18%,36.51%,1
臺北市,南港區,0473,465,272,737,24,761,1389,54.79%,33.48%,1
臺北市,南港區,0474,552,266,818,55,873,1426,61.22%,38.71%,1
臺北市,南港區,0475,579,220,799,18,817,1359,60.12%,42.6%,1
臺北市,南港區,0476,538,223,761,26,787,1366,57.61%,39.39%,1
臺北市,南港區,0477,678,258,936,28,964,1441,66.9%,47.05%,1
臺北市,南港區,0478,552,254,806,38,844,1529,55.2%,36.1%,1
臺北市,南港區,0479,538,299,837,33,870,1618,53.77%,33.25%,1
臺北市,南港區,0480,501,223,724,34,758,1545,49.06%,32.43%,1
臺北市,南港區,0481,578,302,880,27,907,1569,57.81%,36.84%,1
臺北市,南港區,0482,545,280,825,34,859,1661,51.72%,32.81%,1
臺北市,南港區,0483,465,270,735,40,775,1518,51.05%,30.63%,1
臺北市,南港區,0484,626,323,949,34,983,1552,63.34%,40.34%,1
臺北市,南港區,0485,563,332,895,14,909,1658,54.83%,33.96%,1
臺北市,南港區,0486,618,294,912,31,943,1608,58.64%,38.43%,1
臺北市,南港區,0487,517,265,782,32,814,1475,55.19%,35.05%,1
臺北市,南港區,0488,659,396,1055,28,1083,1722,62.89%,38.27%,1
臺北市,南港區,0489,561,321,882,24,906,1383,65.51%,40.56%,1
臺北市,南港區,0490,548,265,813,20,833,1397,59.63%,39.23%,1
臺北市,南港區,0491,556,244,800,24,824,1352,60.95%,41.12%,1
臺北市,南港區,0492,510,278,788,25,813,1344,60.49%,37.95%,1
臺北市,南港區,0493,476,271,747,13,760,1385,54.87%,34.37%,1
臺北市,南港區,0494,506,268,774,31,805,1399,57.54%,36.17%,1
臺北市,南港區,0495,500,251,751,21,772,1381,55.9%,36.21%,1
臺北市,南港區,0496,587,262,849,30,879,1548,56.78%,37.92%,1
臺北市,南港區,0497,440,223,663,22,685,1190,57.56%,36.97%,1
臺北市,南港區,0498,548,317,865,27,892,1490,59.87%,36.78%,1
臺北市,南港區,0499,439,227,666,16,682,1096,62.23%,40.05%,1
臺北市,南港區,0500,581,175,756,27,783,1238,63.25%,46.93%,1
臺北市,南港區,0501,512,257,769,28,797,1271,62.71%,40.28%,1
臺北市,南港區,0502,436,206,642,29,671,1146,58.55%,38.05%,1
臺北市,南港區,0503,457,239,696,26,722,1232,58.6%,37.09%,1
臺北市,南港區,0504,527,282,809,24,833,1649,50.52%,31.96%,1
臺北市,南港區,0505,698,306,1004,24,1028,1688,60.9%,41.35%,1
臺北市,南港區,0506,601,285,886,34,920,1503,61.21%,39.99%,1
臺北市,南港區,0507,586,300,886,15,901,1542,58.43%,38%,1
臺北市,南港區,0508,588,252,840,27,867,1463,59.26%,40.19%,1
臺北市,南港區,0509,482,245,727,34,761,1195,63.68%,40.33%,1
臺北市,南港區,0510,462,282,744,9,753,1254,60.05%,36.84%,1
臺北市,南港區,0511,526,245,771,44,815,1356,60.1%,38.79%,1
臺北市,南港區,0512,530,272,802,40,842,1363,61.78%,38.88%,1
臺北市,南港區,0513,525,287,812,25,837,1317,63.55%,39.86%,1
臺北市,南港區,0514,508,261,769,21,790,1331,59.35%,38.17%,1
臺北市,南港區,0515,585,315,900,42,942,1610,58.51%,36.34%,1
臺北市,南港區,0516,574,288,862,22,884,1542,57.33%,37.22%,1
臺北市,南港區,0517,623,284,907,35,942,1581,59.58%,39.41%,1
臺北市,南港區,0518,526,231,757,24,781,1225,63.76%,42.94%,1
臺北市,南港區,0519,521,250,771,34,805,1264,63.69%,41.22%,1
臺北市,南港區,0520,624,337,961,56,1017,1649,61.67%,37.84%,1
臺北市,南港區,0521,457,287,744,21,765,1267,60.38%,36.07%,1
臺北市,南港區,0522,514,259,773,21,794,1336,59.43%,38.47%,1
臺北市,南港區,0523,464,229,693,25,718,1162,61.79%,39.93%,1
臺北市,南港區,0524,391,220,611,22,633,1045,60.57%,37.42%,1
臺北市,南港區,0525,590,280,870,28,898,1351,66.47%,43.67%,1
臺北市,南港區,0526,545,249,794,16,810,1358,59.65%,40.13%,1
臺北市,內湖區,0305,570,306,876,12,888,1661,53.46%,34.32%,1
臺北市,內湖區,0306,536,317,853,38,891,1602,55.62%,33.46%,1
臺北市,內湖區,0307,652,325,977,42,1019,1655,61.57%,39.4%,1
臺北市,內湖區,0308,577,354,931,30,961,1582,60.75%,36.47%,1
臺北市,內湖區,0309,553,336,889,31,920,1688,54.5%,32.76%,1
臺北市,內湖區,0310,566,384,950,39,989,1737,56.94%,32.58%,1
臺北市,內湖區,0311,636,394,1030,38,1068,1809,59.04%,35.16%,1
臺北市,內湖區,0312,485,277,762,26,788,1376,57.27%,35.25%,1
臺北市,內湖區,0313,674,344,1018,47,1065,1747,60.96%,38.58%,1
臺北市,內湖區,0314,554,283,837,19,856,1389,61.63%,39.88%,1
臺北市,內湖區,0315,563,341,904,23,927,1454,63.76%,38.72%,1
臺北市,內湖區,0316,559,351,910,26,936,1468,63.76%,38.08%,1
臺北市,內湖區,0317,653,321,974,37,1011,1603,63.07%,40.74%,1
臺北市,內湖區,0318,645,347,992,24,1016,1795,56.6%,35.93%,1
臺北市,內湖區,0319,653,398,1051,43,1094,1737,62.98%,37.59%,1
臺北市,內湖區,0320,668,348,1016,36,1052,1744,60.32%,38.3%,1
臺北市,內湖區,0321,613,345,958,29,987,1661,59.42%,36.91%,1
臺北市,內湖區,0322,542,339,881,33,914,1577,57.96%,34.37%,1
臺北市,內湖區,0323,574,327,901,23,924,1494,61.85%,38.42%,1
臺北市,內湖區,0324,641,289,930,34,964,1626,59.29%,39.42%,1
臺北市,內湖區,0325,635,313,948,36,984,1641,59.96%,38.7%,1
臺北市,內湖區,0326,591,317,908,31,939,1554,60.42%,38.03%,1
臺北市,內湖區,0327,651,374,1025,38,1063,1728,61.52%,37.67%,1
臺北市,內湖區,0328,657,317,974,25,999,1736,57.55%,37.85%,1
臺北市,內湖區,0329,606,313,919,28,947,1461,64.82%,41.48%,1
臺北市,內湖區,0330,595,285,880,20,900,1509,59.64%,39.43%,1
臺北市,內湖區,0331,482,291,773,20,793,1358,58.39%,35.49%,1
臺北市,內湖區,0332,633,356,989,27,1016,1761,57.69%,35.95%,1
臺北市,內湖區,0333,585,359,944,20,964,1651,58.39%,35.43%,1
臺北市,內湖區,0334,696,354,1050,50,1100,1809,60.81%,38.47%,1
臺北市,內湖區,0335,655,363,1018,28,1046,1773,59%,36.94%,1
臺北市,內湖區,0336,645,354,999,34,1033,1890,54.66%,34.13%,1
臺北市,內湖區,0337,700,399,1099,41,1140,1760,64.77%,39.77%,1
臺北市,內湖區,0338,623,336,959,23,982,1645,59.7%,37.87%,1
臺北市,內湖區,0339,533,293,826,10,836,1324,63.14%,40.26%,1
臺北市,內湖區,0340,457,197,654,23,677,1072,63.15%,42.63%,1
臺北市,內湖區,0341,550,288,838,25,863,1509,57.19%,36.45%,1
臺北市,內湖區,0342,648,331,979,121,1100,1715,64.14%,37.78%,1
臺北市,內湖區,0343,682,337,1019,32,1051,1774,59.24%,38.44%,1
臺北市,內湖區,0344,731,349,1080,24,1104,1796,61.47%,40.7%,1
臺北市,內湖區,0345,692,314,1006,29,1035,1784,58.02%,38.79%,1
臺北市,內湖區,0346,506,335,841,46,887,1417,62.6%,35.71%,1
臺北市,內湖區,0347,536,418,954,23,977,1699,57.5%,31.55%,1
臺北市,內湖區,0348,648,417,1065,18,1083,1719,63%,37.7%,1
臺北市,內湖區,0349,612,326,938,23,961,1715,56.03%,35.69%,1
臺北市,內湖區,0350,552,304,856,18,874,1634,53.49%,33.78%,1
臺北市,內湖區,0351,531,256,787,30,817,1435,56.93%,37%,1
臺北市,內湖區,0352,546,283,829,17,846,1440,58.75%,37.92%,1
臺北市,內湖區,0353,547,331,878,25,903,1446,62.45%,37.83%,1
臺北市,內湖區,0354,574,288,862,31,893,1657,53.89%,34.64%,1
臺北市,內湖區,0355,504,243,747,37,784,1261,62.17%,39.97%,1
臺北市,內湖區,0356,159,67,226,14,240,456,52.63%,34.87%,1
臺北市,內湖區,0357,581,338,919,20,939,1433,65.53%,40.54%,1
臺北市,內湖區,0358,588,284,872,19,891,1485,60%,39.6%,1
臺北市,內湖區,0359,595,310,905,17,922,1590,57.99%,37.42%,1
臺北市,內湖區,0360,486,276,762,34,796,1219,65.3%,39.87%,1
臺北市,內湖區,0361,639,301,940,36,976,1732,56.35%,36.89%,1
臺北市,內湖區,0362,683,327,1010,28,1038,1727,60.1%,39.55%,1
臺北市,內湖區,0363,620,323,943,31,974,1637,59.5%,37.87%,1
臺北市,內湖區,0364,499,311,810,10,820,1453,56.43%,34.34%,1
臺北市,內湖區,0365,597,307,904,20,924,1617,57.14%,36.92%,1
臺北市,內湖區,0366,563,319,882,29,911,1604,56.8%,35.1%,1
臺北市,內湖區,0367,575,311,886,15,901,1406,64.08%,40.9%,1
臺北市,內湖區,0368,512,298,810,21,831,1353,61.42%,37.84%,1
臺北市,內湖區,0369,665,353,1018,27,1045,1724,60.61%,38.57%,1
臺北市,內湖區,0370,518,305,823,24,847,1378,61.47%,37.59%,1
臺北市,內湖區,0371,555,296,851,19,870,1403,62.01%,39.56%,1
臺北市,內湖區,0372,531,328,859,27,886,1547,57.27%,34.32%,1
臺北市,內湖區,0373,707,300,1007,21,1028,1718,59.84%,41.15%,1
臺北市,內湖區,0374,633,382,1015,29,1044,1813,57.58%,34.91%,1
臺北市,內湖區,0375,708,347,1055,41,1096,1791,61.19%,39.53%,1
臺北市,內湖區,0376,705,410,1115,33,1148,1855,61.89%,38.01%,1
臺北市,內湖區,0377,673,316,989,24,1013,1731,58.52%,38.88%,1
臺北市,內湖區,0378,635,341,976,51,1027,1593,64.47%,39.86%,1
臺北市,內湖區,0379,657,310,967,36,1003,1869,53.67%,35.15%,1
臺北市,內湖區,0380,638,352,990,32,1022,1687,60.58%,37.82%,1
臺北市,內湖區,0381,587,330,917,17,934,1530,61.05%,38.37%,1
臺北市,內湖區,0382,511,264,775,28,803,1300,61.77%,39.31%,1
臺北市,內湖區,0383,561,258,819,27,846,1314,64.38%,42.69%,1
臺北市,內湖區,0384,491,261,752,19,771,1433,53.8%,34.26%,1
臺北市,內湖區,0385,490,278,768,31,799,1450,55.1%,33.79%,1
臺北市,內湖區,0386,574,309,883,40,923,1608,57.4%,35.7%,1
臺北市,內湖區,0387,522,295,817,32,849,1414,60.04%,36.92%,1
臺北市,內湖區,0388,547,321,868,27,895,1492,59.99%,36.66%,1
臺北市,內湖區,0389,517,282,799,15,814,1528,53.27%,33.84%,1
臺北市,內湖區,0390,613,341,954,30,984,1692,58.16%,36.23%,1
臺北市,內湖區,0391,557,316,873,40,913,1556,58.68%,35.8%,1
臺北市,內湖區,0392,578,328,906,18,924,1637,56.44%,35.31%,1
臺北市,內湖區,0393,581,355,936,32,968,1749,55.35%,33.22%,1
臺北市,內湖區,0394,447,217,664,20,684,1220,56.07%,36.64%,1
臺北市,內湖區,0395,570,325,895,33,928,1600,58%,35.63%,1
臺北市,內湖區,0396,545,285,830,25,855,1473,58.04%,37%,1
臺北市,內湖區,0397,527,301,828,34,862,1498,57.54%,35.18%,1
臺北市,內湖區,0398,547,313,860,39,899,1557,57.74%,35.13%,1
臺北市,內湖區,0399,558,308,866,32,898,1674,53.64%,33.33%,1
臺北市,內湖區,0400,650,353,1003,36,1039,1728,60.13%,37.62%,1
臺北市,內湖區,0401,260,110,370,33,403,788,51.14%,32.99%,1
臺北市,內湖區,0402,538,293,831,42,873,1542,56.61%,34.89%,1
臺北市,內湖區,0403,498,306,804,39,843,1676,50.3%,29.71%,1
臺北市,內湖區,0404,448,239,687,32,719,1360,52.87%,32.94%,1
臺北市,內湖區,0405,514,270,784,16,800,1259,63.54%,40.83%,1
臺北市,內湖區,0406,464,255,719,9,728,1301,55.96%,35.66%,1
臺北市,內湖區,0407,399,224,623,26,649,1251,51.88%,31.89%,1
臺北市,內湖區,0408,525,286,811,46,857,1502,57.06%,34.95%,1
臺北市,內湖區,0409,606,280,886,20,906,1596,56.77%,37.97%,1
臺北市,內湖區,0410,615,321,936,15,951,1649,57.67%,37.3%,1
臺北市,內湖區,0411,616,331,947,37,984,1774,55.47%,34.72%,1
臺北市,內湖區,0412,610,347,957,17,974,1746,55.78%,34.94%,1
臺北市,內湖區,0413,521,291,812,20,832,1473,56.48%,35.37%,1
臺北市,內湖區,0414,591,346,937,35,972,2824,34.42%,20.93%,1
臺北市,內湖區,0415,585,373,958,19,977,1849,52.84%,31.64%,1
臺北市,內湖區,0416,531,288,819,43,862,1530,56.34%,34.71%,1
臺北市,內湖區,0417,591,340,931,26,957,1656,57.79%,35.69%,1
臺北市,內湖區,0418,525,316,841,27,868,1457,59.57%,36.03%,1
臺北市,內湖區,0419,673,320,993,26,1019,1695,60.12%,39.71%,1
臺北市,內湖區,0420,609,352,961,24,985,1663,59.23%,36.62%,1
臺北市,內湖區,0421,612,308,920,34,954,1654,57.68%,37%,1
臺北市,內湖區,0422,498,361,859,26,885,1642,53.9%,30.33%,1
臺北市,內湖區,0423,602,363,965,23,988,1685,58.64%,35.73%,1
臺北市,內湖區,0424,667,349,1016,34,1050,1862,56.39%,35.82%,1
臺北市,內湖區,0425,680,423,1103,48,1151,1900,60.58%,35.79%,1
臺北市,內湖區,0426,709,388,1097,47,1144,1790,63.91%,39.61%,1
臺北市,內湖區,0427,521,264,785,32,817,1417,57.66%,36.77%,1
臺北市,內湖區,0428,617,316,933,37,970,1694,57.26%,36.42%,1
臺北市,內湖區,0429,602,284,886,37,923,1676,55.07%,35.92%,1
臺北市,內湖區,0430,559,362,921,18,939,1643,57.15%,34.02%,1
臺北市,內湖區,0431,568,351,919,22,941,1588,59.26%,35.77%,1
臺北市,內湖區,0432,580,341,921,44,965,1603,60.2%,36.18%,1
臺北市,內湖區,0433,564,367,931,24,955,1629,58.62%,34.62%,1
臺北市,內湖區,0434,618,374,992,28,1020,1646,61.97%,37.55%,1
臺北市,內湖區,0435,670,348,1018,27,1045,1883,55.5%,35.58%,1
臺北市,內湖區,0436,533,295,828,23,851,1434,59.34%,37.17%,1
臺北市,內湖區,0437,514,289,803,21,824,1418,58.11%,36.25%,1
臺北市,內湖區,0438,532,267,799,34,833,1373,60.67%,38.75%,1
臺北市,內湖區,0439,505,284,789,30,819,1349,60.71%,37.44%,1
臺北市,內湖區,0440,603,296,899,31,930,1511,61.55%,39.91%,1
臺北市,內湖區,0441,603,350,953,24,977,1563,62.51%,38.58%,1
臺北市,內湖區,0442,563,313,876,27,903,1550,58.26%,36.32%,1
臺北市,內湖區,0443,427,202,629,27,656,1157,56.7%,36.91%,1
臺北市,內湖區,0444,595,424,1019,28,1047,1768,59.22%,33.65%,1
臺北市,內湖區,0445,630,310,940,35,975,1664,58.59%,37.86%,1
臺北市,內湖區,0446,613,376,989,37,1026,1743,58.86%,35.17%,1
臺北市,內湖區,0447,569,307,876,13,889,1480,60.07%,38.45%,1
臺北市,內湖區,0448,577,377,954,37,991,1589,62.37%,36.31%,1
臺北市,內湖區,0449,488,278,766,28,794,1371,57.91%,35.59%,1
臺北市,內湖區,0450,587,372,959,26,985,1575,62.54%,37.27%,1
臺北市,內湖區,0451,496,300,796,18,814,1377,59.11%,36.02%,1
臺北市,內湖區,0452,549,382,931,35,966,1469,65.76%,37.37%,1
臺北市,內湖區,0453,585,370,955,16,971,1529,63.51%,38.26%,1
臺北市,內湖區,0454,587,394,981,21,1002,1649,60.76%,35.6%,1
臺北市,士林區,0142,601,313,914,46,960,1695,56.64%,35.46%,1
臺北市,士林區,0143,654,309,963,61,1024,1720,59.53%,38.02%,1
臺北市,士林區,0144,478,234,712,30,742,1288,57.61%,37.11%,1
臺北市,士林區,0145,551,284,835,43,878,1546,56.79%,35.64%,1
臺北市,士林區,0146,265,137,402,13,415,652,63.65%,40.64%,1
臺北市,士林區,0147,295,165,460,23,483,870,55.52%,33.91%,1
臺北市,士林區,0148,455,218,673,37,710,1137,62.45%,40.02%,1
臺北市,士林區,0149,429,201,630,36,666,1050,63.43%,40.86%,1
臺北市,士林區,0150,428,185,613,29,642,1031,62.27%,41.51%,1
臺北市,士林區,0151,396,229,625,20,645,1075,60%,36.84%,1
臺北市,士林區,0152,328,168,496,30,526,2175,24.18%,15.08%,1
臺北市,士林區,0153,595,310,905,42,947,1775,53.35%,33.52%,1
臺北市,士林區,0154,636,325,961,25,986,1669,59.08%,38.11%,1
臺北市,士林區,0155,608,371,979,36,1015,1665,60.96%,36.52%,1
臺北市,士林區,0156,618,362,980,44,1024,1648,62.14%,37.5%,1
臺北市,士林區,0157,500,219,719,18,737,1246,59.15%,40.13%,1
臺北市,士林區,0158,528,264,792,32,824,1419,58.07%,37.21%,1
臺北市,士林區,0159,487,244,731,54,785,1327,59.16%,36.7%,1
臺北市,士林區,0160,605,360,965,30,995,1573,63.25%,38.46%,1
臺北市,士林區,0161,566,264,830,44,874,1470,59.46%,38.5%,1
臺北市,士林區,0162,687,328,1015,29,1044,1775,58.82%,38.7%,1
臺北市,士林區,0163,620,357,977,24,1001,1692,59.16%,36.64%,1
臺北市,士林區,0164,725,345,1070,33,1103,1842,59.88%,39.36%,1
臺北市,士林區,0165,472,221,693,24,717,1166,61.49%,40.48%,1
臺北市,士林區,0166,578,273,851,34,885,1687,52.46%,34.26%,1
臺北市,士林區,0167,588,313,901,36,937,1624,57.7%,36.21%,1
臺北市,士林區,0168,686,206,892,42,934,1477,63.24%,46.45%,1
臺北市,士林區,0169,474,271,745,20,765,1250,61.2%,37.92%,1
臺北市,士林區,0170,522,291,813,48,861,1434,60.04%,36.4%,1
臺北市,士林區,0171,533,304,837,44,881,1452,60.67%,36.71%,1
臺北市,士林區,0172,597,334,931,33,964,1533,62.88%,38.94%,1
臺北市,士林區,0173,599,291,890,42,932,1515,61.52%,39.54%,1
臺北市,士林區,0174,449,256,705,28,733,1203,60.93%,37.32%,1
臺北市,士林區,0175,571,310,881,47,928,1487,62.41%,38.4%,1
臺北市,士林區,0176,505,227,732,18,750,1252,59.9%,40.34%,1
臺北市,士林區,0177,595,260,855,38,893,1536,58.14%,38.74%,1
臺北市,士林區,0178,619,295,914,35,949,1556,60.99%,39.78%,1
臺北市,士林區,0179,585,306,891,16,907,1511,60.03%,38.72%,1
臺北市,士林區,0180,608,320,928,37,965,1572,61.39%,38.68%,1
臺北市,士林區,0181,631,292,923,52,975,1668,58.45%,37.83%,1
臺北市,士林區,0182,643,279,922,46,968,1685,57.45%,38.16%,1
臺北市,士林區,0183,502,380,882,30,912,1568,58.16%,32.02%,1
臺北市,士林區,0184,477,234,711,24,735,1327,55.39%,35.95%,1
臺北市,士林區,0185,513,225,738,31,769,1338,57.47%,38.34%,1
臺北市,士林區,0186,500,265,765,40,805,1515,53.14%,33%,1
臺北市,士林區,0187,535,288,823,39,862,1452,59.37%,36.85%,1
臺北市,士林區,0188,538,295,833,28,861,1448,59.46%,37.15%,1
臺北市,士林區,0189,591,303,894,31,925,1521,60.82%,38.86%,1
臺北市,士林區,0190,554,292,846,16,862,1461,59%,37.92%,1
臺北市,士林區,0191,501,295,796,54,850,1541,55.16%,32.51%,1
臺北市,士林區,0192,461,271,732,61,793,1611,49.22%,28.62%,1
臺北市,士林區,0193,561,269,830,42,872,1595,54.67%,35.17%,1
臺北市,士林區,0194,596,261,857,28,885,1685,52.52%,35.37%,1
臺北市,士林區,0195,655,283,938,47,985,1816,54.24%,36.07%,1
臺北市,士林區,0196,625,287,912,49,961,1687,56.97%,37.05%,1
臺北市,士林區,0197,616,292,908,33,941,1646,57.17%,37.42%,1
臺北市,士林區,0198,578,293,871,28,899,1643,54.72%,35.18%,1
臺北市,士林區,0199,658,284,942,35,977,1687,57.91%,39%,1
臺北市,士林區,0200,626,311,937,34,971,1655,58.67%,37.82%,1
臺北市,士林區,0201,599,328,927,29,956,1779,53.74%,33.67%,1
臺北市,士林區,0202,694,357,1051,39,1090,1855,58.76%,37.41%,1
臺北市,士林區,0203,486,270,756,34,790,1350,58.52%,36%,1
臺北市,士林區,0204,627,113,740,28,768,1455,52.78%,43.09%,1
臺北市,士林區,0205,449,235,684,40,724,1497,48.36%,29.99%,1
臺北市,士林區,0206,425,223,648,23,671,1398,48%,30.4%,1
臺北市,士林區,0207,683,305,988,40,1028,1747,58.84%,39.1%,1
臺北市,士林區,0208,516,248,764,52,816,1465,55.7%,35.22%,1
臺北市,士林區,0209,569,264,833,40,873,1530,57.06%,37.19%,1
臺北市,士林區,0210,630,313,943,32,975,1855,52.56%,33.96%,1
臺北市,士林區,0211,523,277,800,38,838,1444,58.03%,36.22%,1
臺北市,士林區,0212,486,259,745,42,787,1563,50.35%,31.09%,1
臺北市,士林區,0213,579,247,826,33,859,1482,57.96%,39.07%,1
臺北市,士林區,0214,487,244,731,35,766,1552,49.36%,31.38%,1
臺北市,士林區,0215,679,295,974,42,1016,1790,56.76%,37.93%,1
臺北市,士林區,0216,567,249,816,47,863,1628,53.01%,34.83%,1
臺北市,士林區,0217,470,235,705,46,751,1337,56.17%,35.15%,1
臺北市,士林區,0218,644,316,960,31,991,1750,56.63%,36.8%,1
臺北市,士林區,0219,574,266,840,59,899,1668,53.9%,34.41%,1
臺北市,士林區,0220,425,200,625,52,677,1403,48.25%,30.29%,1
臺北市,士林區,0221,441,230,671,32,703,1468,47.89%,30.04%,1
臺北市,士林區,0222,502,207,709,27,736,1471,50.03%,34.13%,1
臺北市,士林區,0223,588,238,826,37,863,1666,51.8%,35.29%,1
臺北市,士林區,0224,553,245,798,36,834,1587,52.55%,34.85%,1
臺北市,士林區,0225,1229,289,1518,47,1565,1987,78.76%,61.85%,1
臺北市,士林區,0226,431,210,641,20,661,1271,52.01%,33.91%,1
臺北市,士林區,0227,647,355,1002,40,1042,1728,60.3%,37.44%,1
臺北市,士林區,0228,620,313,933,48,981,1630,60.18%,38.04%,1
臺北市,士林區,0229,591,358,949,24,973,1619,60.1%,36.5%,1
臺北市,士林區,0230,539,268,807,34,841,1425,59.02%,37.82%,1
臺北市,士林區,0231,622,351,973,32,1005,1623,61.92%,38.32%,1
臺北市,士林區,0232,575,314,889,36,925,1564,59.14%,36.76%,1
臺北市,士林區,0233,541,328,869,37,906,1376,65.84%,39.32%,1
臺北市,士林區,0234,619,303,922,21,943,1517,62.16%,40.8%,1
臺北市,士林區,0235,559,341,900,30,930,1729,53.79%,32.33%,1
臺北市,士林區,0236,583,317,900,32,932,1511,61.68%,38.58%,1
臺北市,士林區,0237,702,359,1061,27,1088,1811,60.08%,38.76%,1
臺北市,士林區,0238,550,340,890,21,911,1533,59.43%,35.88%,1
臺北市,士林區,0239,672,368,1040,36,1076,1657,64.94%,40.56%,1
臺北市,士林區,0240,547,292,839,19,858,1499,57.24%,36.49%,1
臺北市,士林區,0241,565,207,772,38,810,1402,57.77%,40.3%,1
臺北市,士林區,0242,498,286,784,46,830,1273,65.2%,39.12%,1
臺北市,士林區,0243,483,262,745,23,768,1273,60.33%,37.94%,1
臺北市,士林區,0244,489,274,763,26,789,1316,59.95%,37.16%,1
臺北市,士林區,0245,617,306,923,43,966,1659,58.23%,37.19%,1
臺北市,士林區,0246,581,379,960,34,994,1749,56.83%,33.22%,1
臺北市,士林區,0247,559,298,857,31,888,1552,57.22%,36.02%,1
臺北市,士林區,0248,608,261,869,32,901,1529,58.93%,39.76%,1
臺北市,士林區,0249,622,270,892,25,917,1644,55.78%,37.83%,1
臺北市,士林區,0250,632,348,980,34,1014,1779,57%,35.53%,1
臺北市,士林區,0251,556,341,897,20,917,1597,57.42%,34.82%,1
臺北市,士林區,0252,503,310,813,29,842,1454,57.91%,34.59%,1
臺北市,士林區,0253,577,356,933,39,972,1582,61.44%,36.47%,1
臺北市,士林區,0254,555,325,880,35,915,1518,60.28%,36.56%,1
臺北市,士林區,0255,501,287,788,32,820,1501,54.63%,33.38%,1
臺北市,士林區,0256,531,295,826,35,861,1420,60.63%,37.39%,1
臺北市,士林區,0257,529,308,837,39,876,1494,58.63%,35.41%,1
臺北市,士林區,0258,609,352,961,28,989,1568,63.07%,38.84%,1
臺北市,士林區,0259,455,279,734,32,766,1208,63.41%,37.67%,1
臺北市,士林區,0260,659,338,997,41,1038,1826,56.85%,36.09%,1
臺北市,士林區,0261,571,347,918,33,951,1647,57.74%,34.67%,1
臺北市,士林區,0262,580,325,905,43,948,1654,57.32%,35.07%,1
臺北市,士林區,0263,582,336,918,27,945,1550,60.97%,37.55%,1
臺北市,士林區,0264,472,325,797,27,824,1298,63.48%,36.36%,1
臺北市,士林區,0265,531,277,808,24,832,1297,64.15%,40.94%,1
臺北市,士林區,0266,452,286,738,33,771,1352,57.03%,33.43%,1
臺北市,士林區,0267,549,292,841,36,877,1522,57.62%,36.07%,1
臺北市,士林區,0268,503,368,871,47,918,1602,57.3%,31.4%,1
臺北市,士林區,0269,503,314,817,25,842,1441,58.43%,34.91%,1
臺北市,士林區,0270,420,290,710,15,725,1325,54.72%,31.7%,1
臺北市,士林區,0271,528,345,873,33,906,1567,57.82%,33.69%,1
臺北市,士林區,0272,495,333,828,21,849,1518,55.93%,32.61%,1
臺北市,士林區,0273,554,358,912,37,949,1549,61.27%,35.77%,1
臺北市,士林區,0274,570,366,936,26,962,1652,58.23%,34.5%,1
臺北市,士林區,0275,615,389,1004,48,1052,1766,59.57%,34.82%,1
臺北市,士林區,0276,553,345,898,18,916,1638,55.92%,33.76%,1
臺北市,士林區,0277,590,289,879,36,915,1491,61.37%,39.57%,1
臺北市,士林區,0278,563,306,869,22,891,1521,58.58%,37.02%,1
臺北市,士林區,0279,508,280,788,32,820,1351,60.7%,37.6%,1
臺北市,士林區,0280,574,350,924,18,942,1742,54.08%,32.95%,1
臺北市,士林區,0281,550,327,877,37,914,1585,57.67%,34.7%,1
臺北市,士林區,0282,578,290,868,27,895,1521,58.84%,38%,1
臺北市,士林區,0283,531,313,844,23,867,1543,56.19%,34.41%,1
臺北市,士林區,0284,547,273,820,17,837,1404,59.62%,38.96%,1
臺北市,士林區,0285,542,313,855,33,888,1541,57.62%,35.17%,1
臺北市,士林區,0286,550,289,839,31,870,1584,54.92%,34.72%,1
臺北市,士林區,0287,540,332,872,40,912,1519,60.04%,35.55%,1
臺北市,士林區,0288,486,284,770,19,789,1482,53.24%,32.79%,1
臺北市,士林區,0289,431,252,683,36,719,1243,57.84%,34.67%,1
臺北市,士林區,0290,447,190,637,30,667,1156,57.7%,38.67%,1
臺北市,士林區,0291,431,226,657,43,700,1262,55.47%,34.15%,1
臺北市,士林區,0292,361,150,511,22,533,889,59.96%,40.61%,1
臺北市,士林區,0293,330,179,509,30,539,858,62.82%,38.46%,1
臺北市,士林區,0294,337,158,495,49,544,945,57.57%,35.66%,1
臺北市,士林區,0295,338,163,501,34,535,960,55.73%,35.21%,1
臺北市,士林區,0296,325,137,462,35,497,876,56.74%,37.1%,1
臺北市,士林區,0297,237,113,350,17,367,556,66.01%,42.63%,1
臺北市,士林區,0298,383,152,535,39,574,919,62.46%,41.68%,1
臺北市,士林區,0299,596,248,844,60,904,1360,66.47%,43.82%,1
臺北市,士林區,0300,567,227,794,43,837,1355,61.77%,41.85%,1
臺北市,士林區,0301,483,228,711,32,743,1252,59.35%,38.58%,1
臺北市,士林區,0302,479,224,703,39,742,1182,62.77%,40.52%,1
臺北市,士林區,0303,466,233,699,20,719,1431,50.24%,32.56%,1
臺北市,士林區,0304,432,218,650,31,681,1240,54.92%,34.84%,1
臺北市,北投區,0001,525,236,761,37,798,1313,60.78%,39.98%,1
臺北市,北投區,0002,535,297,832,31,863,1403,61.51%,38.13%,1
臺北市,北投區,0003,402,239,641,22,663,1081,61.33%,37.19%,1
臺北市,北投區,0004,438,250,688,40,728,1209,60.22%,36.23%,1
臺北市,北投區,0005,481,288,769,26,795,1326,59.95%,36.27%,1
臺北市,北投區,0006,486,260,746,24,770,1263,60.97%,38.48%,1
臺北市,北投區,0007,591,335,926,41,967,1580,61.2%,37.41%,1
臺北市,北投區,0008,600,305,905,33,938,1577,59.48%,38.05%,1
臺北市,北投區,0009,584,296,880,37,917,1483,61.83%,39.38%,1
臺北市,北投區,0010,519,292,811,22,833,1461,57.02%,35.52%,1
臺北市,北投區,0011,523,286,809,33,842,1466,57.44%,35.68%,1
臺北市,北投區,0012,627,301,928,34,962,1620,59.38%,38.7%,1
臺北市,北投區,0013,543,236,779,53,832,1543,53.92%,35.19%,1
臺北市,北投區,0014,540,254,794,33,827,1513,54.66%,35.69%,1
臺北市,北投區,0015,606,266,872,33,905,1534,59%,39.5%,1
臺北市,北投區,0016,635,304,939,46,985,1650,59.7%,38.48%,1
臺北市,北投區,0017,565,310,875,25,900,1533,58.71%,36.86%,1
臺北市,北投區,0018,571,338,909,28,937,1702,55.05%,33.55%,1
臺北市,北投區,0019,543,400,943,35,978,1721,56.83%,31.55%,1
臺北市,北投區,0020,551,371,922,41,963,1575,61.14%,34.98%,1
臺北市,北投區,0021,545,308,853,52,905,1530,59.15%,35.62%,1
臺北市,北投區,0022,629,332,961,51,1012,1728,58.56%,36.4%,1
臺北市,北投區,0023,615,319,934,48,982,1702,57.7%,36.13%,1
臺北市,北投區,0024,577,340,917,50,967,1696,57.02%,34.02%,1
臺北市,北投區,0025,523,258,781,24,805,1684,47.8%,31.06%,1
臺北市,北投區,0026,658,342,1000,40,1040,1717,60.57%,38.32%,1
臺北市,北投區,0027,586,329,915,30,945,1605,58.88%,36.51%,1
臺北市,北投區,0028,679,286,965,32,997,1723,57.86%,39.41%,1
臺北市,北投區,0029,615,353,968,20,988,1597,61.87%,38.51%,1
臺北市,北投區,0030,634,317,951,25,976,1700,57.41%,37.29%,1
臺北市,北投區,0031,465,323,788,27,815,1544,52.78%,30.12%,1
臺北市,北投區,0032,567,287,854,25,879,1635,53.76%,34.68%,1
臺北市,北投區,0033,540,310,850,24,874,1495,58.46%,36.12%,1
臺北市,北投區,0034,591,325,916,29,945,1619,58.37%,36.5%,1
臺北市,北投區,0035,545,378,923,34,957,1683,56.86%,32.38%,1
臺北市,北投區,0036,558,301,859,39,898,1662,54.03%,33.57%,1
臺北市,北投區,0037,568,322,890,21,911,1850,49.24%,30.7%,1
臺北市,北投區,0038,512,345,857,19,876,1674,52.33%,30.59%,1
臺北市,北投區,0039,597,282,879,41,920,1511,60.89%,39.51%,1
臺北市,北投區,0040,529,249,778,16,794,1393,57%,37.98%,1
臺北市,北投區,0041,532,249,781,30,811,1279,63.41%,41.59%,1
臺北市,北投區,0042,412,206,618,25,643,1122,57.31%,36.72%,1
臺北市,北投區,0043,554,265,819,38,857,1238,69.22%,44.75%,1
臺北市,北投區,0044,565,303,868,52,920,1477,62.29%,38.25%,1
臺北市,北投區,0045,581,303,884,32,916,1495,61.27%,38.86%,1
臺北市,北投區,0046,584,315,899,26,925,1469,62.97%,39.75%,1
臺北市,北投區,0047,601,239,840,23,863,1462,59.03%,41.11%,1
臺北市,北投區,0048,572,247,819,37,856,1431,59.82%,39.97%,1
臺北市,北投區,0049,549,317,866,30,896,1486,60.3%,36.94%,1
臺北市,北投區,0050,576,275,851,34,885,1449,61.08%,39.75%,1
臺北市,北投區,0051,513,321,834,25,859,1456,59%,35.23%,1
臺北市,北投區,0052,545,253,798,29,827,1311,63.08%,41.57%,1
臺北市,北投區,0053,517,267,784,31,815,1356,60.1%,38.13%,1
臺北市,北投區,0054,504,261,765,27,792,1338,59.19%,37.67%,1
臺北市,北投區,0055,575,295,870,20,890,1525,58.36%,37.7%,1
臺北市,北投區,0056,570,302,872,28,900,1620,55.56%,35.19%,1
臺北市,北投區,0057,535,260,795,17,812,1499,54.17%,35.69%,1
臺北市,北投區,0058,609,276,885,27,912,1497,60.92%,40.68%,1
臺北市,北投區,0059,562,324,886,37,923,1624,56.83%,34.61%,1
臺北市,北投區,0060,525,273,798,45,843,1536,54.88%,34.18%,1
臺北市,北投區,0061,558,289,847,52,899,1469,61.2%,37.99%,1
臺北市,北投區,0062,559,307,866,26,892,1598,55.82%,34.98%,1
臺北市,北投區,0063,586,327,913,33,946,1690,55.98%,34.67%,1
臺北市,北投區,0064,574,282,856,56,912,1599,57.04%,35.9%,1
臺北市,北投區,0065,557,338,895,37,932,1634,57.04%,34.09%,1
臺北市,北投區,0066,585,271,856,33,889,1660,53.55%,35.24%,1
臺北市,北投區,0067,611,354,965,38,1003,1900,52.79%,32.16%,1
臺北市,北投區,0068,632,368,1000,37,1037,1797,57.71%,35.17%,1
臺北市,北投區,0069,654,372,1026,42,1068,1832,58.3%,35.7%,1
臺北市,北投區,0070,667,342,1009,42,1051,1784,58.91%,37.39%,1
臺北市,北投區,0071,631,342,973,38,1011,1732,58.37%,36.43%,1
臺北市,北投區,0072,352,174,526,32,558,2035,27.42%,17.3%,1
臺北市,北投區,0073,538,287,825,36,861,1504,57.25%,35.77%,1
臺北市,北投區,0074,673,280,953,42,995,1683,59.12%,39.99%,1
臺北市,北投區,0075,583,275,858,52,910,1635,55.66%,35.66%,1
臺北市,北投區,0076,584,283,867,47,914,1613,56.66%,36.21%,1
臺北市,北投區,0077,543,276,819,20,839,1483,56.57%,36.61%,1
臺北市,北投區,0078,556,270,826,30,856,1500,57.07%,37.07%,1
臺北市,北投區,0079,537,298,835,34,869,1483,58.6%,36.21%,1
臺北市,北投區,0080,555,280,835,43,878,1544,56.87%,35.95%,1
臺北市,北投區,0081,489,257,746,29,775,1532,50.59%,31.92%,1
臺北市,北投區,0082,643,336,979,44,1023,1819,56.24%,35.35%,1
臺北市,北投區,0083,580,360,940,36,976,1863,52.39%,31.13%,1
臺北市,北投區,0084,572,345,917,15,932,1872,49.79%,30.56%,1
臺北市,北投區,0085,598,274,872,41,913,1627,56.12%,36.75%,1
臺北市,北投區,0086,580,311,891,21,912,1696,53.77%,34.2%,1
臺北市,北投區,0087,638,357,995,30,1025,1841,55.68%,34.66%,1
臺北市,北投區,0088,484,253,737,27,764,1324,57.7%,36.56%,1
臺北市,北投區,0089,539,260,799,23,822,1504,54.65%,35.84%,1
臺北市,北投區,0090,564,264,828,35,863,1511,57.11%,37.33%,1
臺北市,北投區,0091,586,343,929,26,955,1615,59.13%,36.28%,1
臺北市,北投區,0092,445,210,655,19,674,1270,53.07%,35.04%,1
臺北市,北投區,0093,433,288,721,31,752,1492,50.4%,29.02%,1
臺北市,北投區,0094,462,287,749,21,770,1429,53.88%,32.33%,1
臺北市,北投區,0095,503,305,808,15,823,1567,52.52%,32.1%,1
臺北市,北投區,0096,506,255,761,32,793,1388,57.13%,36.46%,1
臺北市,北投區,0097,484,262,746,17,763,1448,52.69%,33.43%,1
臺北市,北投區,0098,477,221,698,37,735,1356,54.2%,35.18%,1
臺北市,北投區,0099,504,213,717,19,736,1308,56.27%,38.53%,1
臺北市,北投區,0100,456,224,680,29,709,1165,60.86%,39.14%,1
臺北市,北投區,0101,591,234,825,38,863,1429,60.39%,41.36%,1
臺北市,北投區,0102,551,241,792,21,813,1472,55.23%,37.43%,1
臺北市,北投區,0103,570,337,907,36,943,1508,62.53%,37.8%,1
臺北市,北投區,0104,561,250,811,33,844,1480,57.03%,37.91%,1
臺北市,北投區,0105,402,205,607,30,637,1142,55.78%,35.2%,1
臺北市,北投區,0106,547,262,809,18,827,1554,53.22%,35.2%,1
臺北市,北投區,0107,627,323,950,47,997,1669,59.74%,37.57%,1
臺北市,北投區,0108,669,297,966,43,1009,1823,55.35%,36.7%,1
臺北市,北投區,0109,603,313,916,42,958,1739,55.09%,34.68%,1
臺北市,北投區,0110,617,292,909,43,952,1771,53.75%,34.84%,1
臺北市,北投區,0111,543,210,753,53,806,1468,54.9%,36.99%,1
臺北市,北投區,0112,554,259,813,19,832,1469,56.64%,37.71%,1
臺北市,北投區,0113,499,194,693,21,714,1094,65.27%,45.61%,1
臺北市,北投區,0114,496,189,685,30,715,1101,64.94%,45.05%,1
臺北市,北投區,0115,571,271,842,25,867,1422,60.97%,40.15%,1
臺北市,北投區,0116,558,197,755,26,781,1390,56.19%,40.14%,1
臺北市,北投區,0117,523,227,750,31,781,1307,59.76%,40.02%,1
臺北市,北投區,0118,470,261,731,42,773,1215,63.62%,38.68%,1
臺北市,北投區,0119,576,284,860,28,888,1642,54.08%,35.08%,1
臺北市,北投區,0120,588,244,832,32,864,1623,53.23%,36.23%,1
臺北市,北投區,0121,578,275,853,45,898,1621,55.4%,35.66%,1
臺北市,北投區,0122,470,277,747,22,769,1367,56.25%,34.38%,1
臺北市,北投區,0123,465,239,704,24,728,1309,55.61%,35.52%,1
臺北市,北投區,0124,491,287,778,21,799,1356,58.92%,36.21%,1
臺北市,北投區,0125,503,245,748,30,778,1365,57%,36.85%,1
臺北市,北投區,0126,550,315,865,23,888,1613,55.05%,34.1%,1
臺北市,北投區,0127,517,275,792,15,807,1590,50.75%,32.52%,1
臺北市,北投區,0128,627,309,936,30,966,1662,58.12%,37.73%,1
臺北市,北投區,0129,573,326,899,40,939,1622,57.89%,35.33%,1
臺北市,北投區,0130,614,379,993,20,1013,1820,55.66%,33.74%,1
臺北市,北投區,0131,615,288,903,46,949,1615,58.76%,38.08%,1
臺北市,北投區,0132,501,216,717,37,754,1612,46.77%,31.08%,1
臺北市,北投區,0133,581,306,887,40,927,1652,56.11%,35.17%,1
臺北市,北投區,0134,633,299,932,16,948,1666,56.9%,38%,1
臺北市,北投區,0135,582,291,873,31,904,1641,55.09%,35.47%,1
臺北市,北投區,0136,191,118,309,16,325,528,61.55%,36.17%,1
臺北市,北投區,0137,512,227,739,49,788,1642,47.99%,31.18%,1
臺北市,北投區,0138,316,128,444,27,471,829,56.82%,38.12%,1
臺北市,北投區,0139,254,103,357,26,383,690,55.51%,36.81%,1
臺北市,北投區,0140,394,153,547,41,588,1067,55.11%,36.93%,1
臺北市,北投區,0141,336,134,470,37,507,892,56.84%,37.67%,1
新北市,板橋區,0894,491,261,752,35,787,1388,56.7%,35.37%,1
新北市,板橋區,0895,472,264,736,34,770,1294,59.51%,36.48%,1
新北市,板橋區,0896,253,153,406,13,419,667,62.82%,37.93%,1
新北市,板橋區,0897,343,133,476,28,504,898,56.12%,38.2%,1
新北市,板橋區,0898,339,143,482,25,507,829,61.16%,40.89%,1
新北市,板橋區,0899,325,108,433,31,464,739,62.79%,43.98%,1
新北市,板橋區,0900,429,177,606,29,635,1035,61.35%,41.45%,1
新北市,板橋區,0901,517,282,799,8,807,1713,47.11%,30.18%,1
新北市,板橋區,0902,247,94,341,14,355,658,53.95%,37.54%,1
新北市,板橋區,0903,481,203,684,53,737,1312,56.17%,36.66%,1
新北市,板橋區,0904,529,220,749,33,782,1492,52.41%,35.46%,1
新北市,板橋區,0905,491,200,691,34,725,1393,52.05%,35.25%,1
新北市,板橋區,0906,594,252,846,37,883,4742,18.62%,12.53%,1
新北市,板橋區,0907,539,235,774,30,804,1439,55.87%,37.46%,1
新北市,板橋區,0908,483,200,683,43,726,1187,61.16%,40.69%,1
新北市,板橋區,0909,423,194,617,27,644,1122,57.4%,37.7%,1
新北市,板橋區,0910,541,221,762,47,809,1363,59.35%,39.69%,1
新北市,板橋區,0911,442,181,623,28,651,1093,59.56%,40.44%,1
新北市,板橋區,0912,529,239,768,33,801,1331,60.18%,39.74%,1
新北市,板橋區,0913,430,187,617,26,643,1026,62.67%,41.91%,1
新北市,板橋區,0914,486,223,709,27,736,1244,59.16%,39.07%,1
新北市,板橋區,0915,454,206,660,36,696,1268,54.89%,35.8%,1
新北市,板橋區,0916,512,184,696,24,720,1313,54.84%,38.99%,1
新北市,板橋區,0917,470,231,701,32,733,1196,61.29%,39.3%,1
新北市,板橋區,0918,496,259,755,27,782,1137,68.78%,43.62%,1
新北市,板橋區,0919,496,285,781,30,811,1269,63.91%,39.09%,1
新北市,板橋區,0920,453,210,663,24,687,1117,61.5%,40.56%,1
新北市,板橋區,0921,441,191,632,32,664,1042,63.72%,42.32%,1
新北市,板橋區,0922,521,200,721,52,773,1257,61.5%,41.45%,1
新北市,板橋區,0923,501,194,695,34,729,1216,59.95%,41.2%,1
新北市,板橋區,0924,411,216,627,34,661,1126,58.7%,36.5%,1
新北市,板橋區,0925,544,255,799,46,845,1290,65.5%,42.17%,1
新北市,板橋區,0926,431,194,625,19,644,1215,53%,35.47%,1
新北市,板橋區,0927,425,178,603,13,616,1099,56.05%,38.67%,1
新北市,板橋區,0928,598,221,819,29,848,1329,63.81%,45%,1
新北市,板橋區,0929,439,143,582,23,605,996,60.74%,44.08%,1
新北市,板橋區,0930,421,195,616,16,632,1047,60.36%,40.21%,1
新北市,板橋區,0931,528,208,736,40,776,1272,61.01%,41.51%,1
新北市,板橋區,0932,521,214,735,27,762,1252,60.86%,41.61%,1
新北市,板橋區,0933,527,168,695,36,731,1238,59.05%,42.57%,1
新北市,板橋區,0934,586,260,846,44,890,1389,64.07%,42.19%,1
新北市,板橋區,0935,495,212,707,37,744,1194,62.31%,41.46%,1
新北市,板橋區,0936,410,174,584,29,613,1093,56.08%,37.51%,1
新北市,板橋區,0937,438,185,623,47,670,1148,58.36%,38.15%,1
新北市,板橋區,0938,529,214,743,37,780,1268,61.51%,41.72%,1
新北市,板橋區,0939,492,185,677,41,718,1230,58.37%,40%,1
新北市,板橋區,0940,405,145,550,29,579,1012,57.21%,40.02%,1
新北市,板橋區,0941,333,131,464,29,493,811,60.79%,41.06%,1
新北市,板橋區,0942,497,222,719,43,762,1197,63.66%,41.52%,1
新北市,板橋區,0943,451,173,624,32,656,1142,57.44%,39.49%,1
新北市,板橋區,0944,500,201,701,26,727,1222,59.49%,40.92%,1
新北市,板橋區,0945,339,136,475,36,511,796,64.2%,42.59%,1
新北市,板橋區,0946,410,195,605,43,648,997,64.99%,41.12%,1
新北市,板橋區,0947,412,184,596,25,621,1011,61.42%,40.75%,1
新北市,板橋區,0948,476,196,672,33,705,1157,60.93%,41.14%,1
新北市,板橋區,0949,436,178,614,29,643,1040,61.83%,41.92%,1
新北市,板橋區,0950,471,220,691,26,717,1173,61.13%,40.15%,1
新北市,板橋區,0951,436,216,652,25,677,1193,56.75%,36.55%,1
新北市,板橋區,0952,520,224,744,17,761,1255,60.64%,41.43%,1
新北市,板橋區,0953,523,242,765,24,789,1306,60.41%,40.05%,1
新北市,板橋區,0954,456,183,639,12,651,1050,62%,43.43%,1
新北市,板橋區,0955,380,167,547,25,572,942,60.72%,40.34%,1
新北市,板橋區,0956,508,181,689,30,719,1133,63.46%,44.84%,1
新北市,板橋區,0957,493,217,710,36,746,1251,59.63%,39.41%,1
新北市,板橋區,0958,541,216,757,22,779,1293,60.25%,41.84%,1
新北市,板橋區,0959,452,181,633,30,663,1208,54.88%,37.42%,1
新北市,板橋區,0960,466,213,679,32,711,1223,58.14%,38.1%,1
新北市,板橋區,0961,407,157,564,40,604,1061,56.93%,38.36%,1
新北市,板橋區,0962,586,269,855,35,890,1515,58.75%,38.68%,1
新北市,板橋區,0963,543,187,730,24,754,1225,61.55%,44.33%,1
新北市,板橋區,0964,498,202,700,21,721,1120,64.38%,44.46%,1
新北市,板橋區,0965,457,203,660,33,693,1091,63.52%,41.89%,1
新北市,板橋區,0966,612,219,831,22,853,1385,61.59%,44.19%,1
新北市,板橋區,0967,530,235,765,32,797,1283,62.12%,41.31%,1
新北市,板橋區,0968,489,192,681,42,723,1204,60.05%,40.61%,1
新北市,板橋區,0969,512,231,743,21,764,1191,64.15%,42.99%,1
新北市,板橋區,0970,487,169,656,33,689,1078,63.91%,45.18%,1
新北市,板橋區,0971,563,204,767,39,806,1351,59.66%,41.67%,1
新北市,板橋區,0972,522,229,751,35,786,1322,59.46%,39.49%,1
新北市,板橋區,0973,360,142,502,28,530,868,61.06%,41.47%,1
新北市,板橋區,0974,458,200,658,33,691,1029,67.15%,44.51%,1
新北市,板橋區,0975,620,304,924,24,948,1602,59.18%,38.7%,1
新北市,板橋區,0976,578,225,803,24,827,1362,60.72%,42.44%,1
新北市,板橋區,0977,600,321,921,48,969,1698,57.07%,35.34%,1
新北市,板橋區,0978,552,278,830,23,853,1495,57.06%,36.92%,1
新北市,板橋區,0979,536,271,807,43,850,1522,55.85%,35.22%,1
新北市,板橋區,0980,519,201,720,37,757,1279,59.19%,40.58%,1
新北市,板橋區,0981,519,238,757,23,780,1559,50.03%,33.29%,1
新北市,板橋區,0982,547,236,783,47,830,1537,54%,35.59%,1
新北市,板橋區,0983,525,246,771,37,808,1531,52.78%,34.29%,1
新北市,板橋區,0984,628,304,932,19,951,1720,55.29%,36.51%,1
新北市,板橋區,0985,444,188,632,21,653,1165,56.05%,38.11%,1
新北市,板橋區,0986,681,350,1031,42,1073,1857,57.78%,36.67%,1
新北市,板橋區,0987,422,164,586,39,625,1078,57.98%,39.15%,1
新北市,板橋區,0988,442,194,636,22,658,1177,55.9%,37.55%,1
新北市,板橋區,0989,672,334,1006,41,1047,1798,58.23%,37.37%,1
新北市,板橋區,0990,578,254,832,45,877,1455,60.27%,39.73%,1
新北市,板橋區,0991,518,205,723,45,768,1245,61.69%,41.61%,1
新北市,板橋區,0992,587,317,904,40,944,1704,55.4%,34.45%,1
新北市,板橋區,0993,585,322,907,19,926,1600,57.88%,36.56%,1
新北市,板橋區,0994,537,196,733,20,753,1409,53.44%,38.11%,1
新北市,板橋區,0995,519,192,711,31,742,1286,57.7%,40.36%,1
新北市,板橋區,0996,432,174,606,65,671,1359,49.37%,31.79%,1
新北市,板橋區,0997,409,186,595,37,632,1188,53.2%,34.43%,1
新北市,板橋區,0998,604,254,858,47,905,1627,55.62%,37.12%,1
新北市,板橋區,0999,577,264,841,26,867,1633,53.09%,35.33%,1
新北市,板橋區,1000,695,350,1045,36,1081,1814,59.59%,38.31%,1
新北市,板橋區,1001,696,323,1019,41,1060,1810,58.56%,38.45%,1
新北市,板橋區,1002,448,188,636,34,670,1133,59.14%,39.54%,1
新北市,板橋區,1003,363,123,486,19,505,841,60.05%,43.16%,1
新北市,板橋區,1004,453,177,630,28,658,1050,62.67%,43.14%,1
新北市,板橋區,1005,426,184,610,35,645,1130,57.08%,37.7%,1
新北市,板橋區,1006,441,197,638,25,663,1056,62.78%,41.76%,1
新北市,板橋區,1007,421,177,598,30,628,1129,55.62%,37.29%,1
新北市,板橋區,1008,684,264,948,41,989,1713,57.73%,39.93%,1
新北市,板橋區,1009,615,290,905,42,947,1622,58.38%,37.92%,1
新北市,板橋區,1010,580,287,867,32,899,1427,63%,40.64%,1
新北市,板橋區,1011,629,283,912,13,925,1471,62.88%,42.76%,1
新北市,板橋區,1012,247,156,403,14,417,1076,38.75%,22.96%,1
新北市,板橋區,1013,356,156,512,10,522,979,53.32%,36.36%,1
新北市,板橋區,1014,499,183,682,16,698,1079,64.69%,46.25%,1
新北市,板橋區,1015,324,136,460,15,475,828,57.37%,39.13%,1
新北市,板橋區,1016,345,135,480,40,520,820,63.41%,42.07%,1
新北市,板橋區,1017,336,166,502,22,524,989,52.98%,33.97%,1
新北市,板橋區,1018,392,170,562,38,600,1023,58.65%,38.32%,1
新北市,板橋區,1019,417,162,579,30,609,1044,58.33%,39.94%,1
新北市,板橋區,1020,396,152,548,27,575,968,59.4%,40.91%,1
新北市,板橋區,1021,476,229,705,20,725,1222,59.33%,38.95%,1
新北市,板橋區,1022,527,214,741,40,781,1385,56.39%,38.05%,1
新北市,板橋區,1023,570,284,854,40,894,1585,56.4%,35.96%,1
新北市,板橋區,1024,678,306,984,53,1037,1840,56.36%,36.85%,1
新北市,板橋區,1025,762,330,1092,40,1132,1806,62.68%,42.19%,1
新北市,板橋區,1026,578,243,821,41,862,1506,57.24%,38.38%,1
新北市,板橋區,1027,546,247,793,34,827,1476,56.03%,36.99%,1
新北市,板橋區,1028,556,280,836,45,881,1500,58.73%,37.07%,1
新北市,板橋區,1029,470,198,668,30,698,1096,63.69%,42.88%,1
新北市,板橋區,1030,394,173,567,35,602,963,62.51%,40.91%,1
新北市,板橋區,1031,600,313,913,33,946,1601,59.09%,37.48%,1
新北市,板橋區,1032,592,307,899,49,948,1507,62.91%,39.28%,1
新北市,板橋區,1033,514,258,772,47,819,1315,62.28%,39.09%,1
新北市,板橋區,1034,510,192,702,19,721,1178,61.21%,43.29%,1
新北市,板橋區,1035,730,348,1078,42,1120,1822,61.47%,40.07%,1
新北市,板橋區,1036,650,301,951,48,999,1605,62.24%,40.5%,1
新北市,板橋區,1037,614,292,906,14,920,1549,59.39%,39.64%,1
新北市,板橋區,1038,774,473,1247,15,1262,1948,64.78%,39.73%,1
新北市,板橋區,1039,712,369,1081,25,1106,1935,57.16%,36.8%,1
新北市,板橋區,1040,418,173,591,25,616,1097,56.15%,38.1%,1
新北市,板橋區,1041,401,187,588,21,609,1095,55.62%,36.62%,1
新北市,板橋區,1042,620,246,866,59,925,1678,55.13%,36.95%,1
新北市,板橋區,1043,666,248,914,50,964,1750,55.09%,38.06%,1
新北市,板橋區,1044,455,184,639,29,668,1187,56.28%,38.33%,1
新北市,板橋區,1045,455,216,671,22,693,1154,60.05%,39.43%,1
新北市,板橋區,1046,509,233,742,20,762,1262,60.38%,40.33%,1
新北市,板橋區,1047,509,184,693,29,722,1271,56.81%,40.05%,1
新北市,板橋區,1048,529,232,761,48,809,1410,57.38%,37.52%,1
新北市,板橋區,1049,628,249,877,43,920,1745,52.72%,35.99%,1
新北市,板橋區,1050,719,284,1003,60,1063,1867,56.94%,38.51%,1
新北市,板橋區,1051,714,287,1001,51,1052,1753,60.01%,40.73%,1
新北市,板橋區,1052,482,199,681,45,726,1204,60.3%,40.03%,1
新北市,板橋區,1053,583,276,859,40,899,1614,55.7%,36.12%,1
新北市,板橋區,1054,497,216,713,29,742,1237,59.98%,40.18%,1
新北市,板橋區,1055,526,255,781,36,817,1361,60.03%,38.65%,1
新北市,板橋區,1056,444,247,691,38,729,1243,58.65%,35.72%,1
新北市,板橋區,1057,556,223,779,23,802,1515,52.94%,36.7%,1
新北市,板橋區,1058,613,259,872,39,911,1515,60.13%,40.46%,1
新北市,板橋區,1059,411,145,556,33,589,949,62.07%,43.31%,1
新北市,板橋區,1060,620,259,879,34,913,1629,56.05%,38.06%,1
新北市,板橋區,1061,485,207,692,31,723,1238,58.4%,39.18%,1
新北市,板橋區,1062,285,95,380,16,396,901,43.95%,31.63%,1
新北市,板橋區,1063,537,259,796,78,874,1475,59.25%,36.41%,1
新北市,板橋區,1064,558,239,797,39,836,1481,56.45%,37.68%,1
新北市,板橋區,1065,643,261,904,62,966,1800,53.67%,35.72%,1
新北市,板橋區,1066,605,264,869,46,915,1630,56.13%,37.12%,1
新北市,板橋區,1067,509,253,762,24,786,1298,60.55%,39.21%,1
新北市,板橋區,1068,340,157,497,29,526,874,60.18%,38.9%,1
新北市,板橋區,1069,413,168,581,16,597,992,60.18%,41.63%,1
新北市,板橋區,1070,454,216,670,12,682,1034,65.96%,43.91%,1
新北市,板橋區,1071,540,289,829,41,870,1451,59.96%,37.22%,1
新北市,板橋區,1072,467,206,673,30,703,1130,62.21%,41.33%,1
新北市,板橋區,1073,572,250,822,27,849,1440,58.96%,39.72%,1
新北市,板橋區,1074,598,257,855,53,908,1531,59.31%,39.06%,1
新北市,板橋區,1075,576,257,833,34,867,1349,64.27%,42.7%,1
新北市,板橋區,1076,628,238,866,19,885,1593,55.56%,39.42%,1
新北市,板橋區,1077,463,199,662,28,690,1174,58.77%,39.44%,1
新北市,板橋區,1078,523,175,698,28,726,1228,59.12%,42.59%,1
新北市,板橋區,1079,404,305,709,22,731,1187,61.58%,34.04%,1
新北市,板橋區,1080,366,138,504,34,538,870,61.84%,42.07%,1
新北市,板橋區,1081,765,428,1193,26,1219,2033,59.96%,37.63%,1
新北市,板橋區,1082,495,245,740,33,773,1418,54.51%,34.91%,1
新北市,板橋區,1083,417,181,598,21,619,1075,57.58%,38.79%,1
新北市,板橋區,1084,548,236,784,36,820,1515,54.13%,36.17%,1
新北市,板橋區,1085,542,199,741,28,769,1182,65.06%,45.85%,1
新北市,板橋區,1086,657,372,1029,48,1077,1893,56.89%,34.71%,1
新北市,板橋區,1087,483,211,694,33,727,1302,55.84%,37.1%,1
新北市,板橋區,1088,506,223,729,28,757,1366,55.42%,37.04%,1
新北市,板橋區,1089,538,243,781,47,828,1318,62.82%,40.82%,1
新北市,板橋區,1090,459,212,671,25,696,1200,58%,38.25%,1
新北市,板橋區,1091,694,417,1111,32,1143,2028,56.36%,34.22%,1
新北市,板橋區,1092,709,276,985,40,1025,1746,58.71%,40.61%,1
新北市,板橋區,1093,660,339,999,11,1010,1954,51.69%,33.78%,1
新北市,板橋區,1094,549,250,799,33,832,1474,56.45%,37.25%,1
新北市,板橋區,1095,589,217,806,24,830,1418,58.53%,41.54%,1
新北市,板橋區,1096,647,294,941,43,984,1563,62.96%,41.39%,1
新北市,板橋區,1097,669,259,928,54,982,1780,55.17%,37.58%,1
新北市,板橋區,1098,605,316,921,41,962,1707,56.36%,35.44%,1
新北市,板橋區,1099,283,94,377,9,386,906,42.6%,31.24%,1
新北市,板橋區,1100,396,174,570,29,599,1030,58.16%,38.45%,1
新北市,板橋區,1101,432,199,631,28,659,1115,59.1%,38.74%,1
新北市,板橋區,1102,722,297,1019,22,1041,1836,56.7%,39.32%,1
新北市,板橋區,1103,703,307,1010,46,1056,1881,56.14%,37.37%,1
新北市,板橋區,1104,602,316,918,25,943,1688,55.86%,35.66%,1
新北市,板橋區,1105,665,349,1014,25,1039,1760,59.03%,37.78%,1
新北市,板橋區,1106,446,179,625,34,659,1044,63.12%,42.72%,1
新北市,板橋區,1107,475,183,658,21,679,1043,65.1%,45.54%,1
新北市,板橋區,1108,457,190,647,48,695,1099,63.24%,41.58%,1
新北市,板橋區,1109,492,207,699,32,731,1260,58.02%,39.05%,1
新北市,板橋區,1110,457,183,640,22,662,1131,58.53%,40.41%,1
新北市,板橋區,1111,476,211,687,34,721,1225,58.86%,38.86%,1
新北市,板橋區,1112,602,277,879,30,909,1455,62.47%,41.37%,1
新北市,板橋區,1113,503,202,705,24,729,1267,57.54%,39.7%,1
新北市,板橋區,1114,389,173,562,31,593,972,61.01%,40.02%,1
新北市,板橋區,1115,401,176,577,26,603,994,60.66%,40.34%,1
新北市,板橋區,1116,432,205,637,23,660,1111,59.41%,38.88%,1
新北市,板橋區,1117,490,251,741,39,780,1177,66.27%,41.63%,1
新北市,板橋區,1118,553,267,820,42,862,1544,55.83%,35.82%,1
新北市,板橋區,1119,405,149,554,45,599,1021,58.67%,39.67%,1
新北市,板橋區,1120,393,164,557,38,595,1040,57.21%,37.79%,1
新北市,板橋區,1121,538,276,814,27,841,1504,55.92%,35.77%,1
新北市,板橋區,1122,463,250,713,32,745,1373,54.26%,33.72%,1
新北市,板橋區,1123,457,254,711,18,729,1210,60.25%,37.77%,1
新北市,板橋區,1124,646,280,926,34,960,1809,53.07%,35.71%,1
新北市,板橋區,1125,637,221,858,58,916,1551,59.06%,41.07%,1
新北市,板橋區,1126,536,272,808,20,828,1408,58.81%,38.07%,1
新北市,板橋區,1127,525,239,764,23,787,1285,61.25%,40.86%,1
新北市,板橋區,1128,489,208,697,22,719,1102,65.25%,44.37%,1
新北市,板橋區,1129,520,209,729,21,750,1399,53.61%,37.17%,1
新北市,板橋區,1130,670,256,926,51,977,1692,57.74%,39.6%,1
新北市,板橋區,1131,687,301,988,20,1008,1625,62.03%,42.28%,1
新北市,板橋區,1132,636,214,850,51,901,1712,52.63%,37.15%,1
新北市,板橋區,1133,517,195,712,22,734,1246,58.91%,41.49%,1
新北市,板橋區,1134,593,256,849,30,879,1471,59.76%,40.31%,1
新北市,板橋區,1135,730,255,985,52,1037,1761,58.89%,41.45%,1
新北市,板橋區,1136,551,276,827,35,862,1499,57.51%,36.76%,1
新北市,板橋區,1137,507,267,774,37,811,1528,53.08%,33.18%,1
新北市,板橋區,1138,589,293,882,39,921,1536,59.96%,38.35%,1
新北市,板橋區,1139,610,271,881,28,909,1550,58.65%,39.35%,1
新北市,板橋區,1140,771,357,1128,50,1178,2050,57.46%,37.61%,1
新北市,板橋區,1141,514,219,733,45,778,1300,59.85%,39.54%,1
新北市,板橋區,1142,635,222,857,29,886,1537,57.64%,41.31%,1
新北市,板橋區,1143,484,235,719,19,738,1341,55.03%,36.09%,1
新北市,板橋區,1144,584,325,909,12,921,1606,57.35%,36.36%,1
新北市,板橋區,1145,504,228,732,36,768,1433,53.59%,35.17%,1
新北市,板橋區,1146,630,246,876,35,911,1685,54.07%,37.39%,1
新北市,板橋區,1147,511,218,729,46,775,1248,62.1%,40.95%,1
新北市,板橋區,1148,467,168,635,30,665,1172,56.74%,39.85%,1
新北市,板橋區,1149,550,270,820,19,839,1640,51.16%,33.54%,1
新北市,板橋區,1150,586,223,809,23,832,1428,58.26%,41.04%,1
新北市,板橋區,1151,570,266,836,49,885,1527,57.96%,37.33%,1
新北市,板橋區,1152,520,251,771,26,797,1350,59.04%,38.52%,1
新北市,板橋區,1153,624,249,873,26,899,1582,56.83%,39.44%,1
新北市,板橋區,1154,424,158,582,23,605,919,65.83%,46.14%,1
新北市,板橋區,1155,405,151,556,14,570,930,61.29%,43.55%,1
新北市,板橋區,1156,441,161,602,21,623,974,63.96%,45.28%,1
新北市,板橋區,1157,701,292,993,27,1020,1732,58.89%,40.47%,1
新北市,板橋區,1158,524,243,767,43,810,1438,56.33%,36.44%,1
新北市,板橋區,1159,634,294,928,50,978,1777,55.04%,35.68%,1
新北市,板橋區,1160,608,241,849,36,885,1764,50.17%,34.47%,1
新北市,板橋區,1161,513,217,730,16,746,1289,57.87%,39.8%,1
新北市,板橋區,1162,497,185,682,20,702,1182,59.39%,42.05%,1
新北市,板橋區,1163,484,200,684,15,699,1174,59.54%,41.23%,1
新北市,板橋區,1164,642,306,948,53,1001,1870,53.53%,34.33%,1
新北市,板橋區,1165,712,335,1047,33,1080,1842,58.63%,38.65%,1
新北市,板橋區,1166,423,286,709,39,748,1094,68.37%,38.67%,1
新北市,板橋區,1167,445,190,635,43,678,1228,55.21%,36.24%,1
新北市,板橋區,1168,455,181,636,21,657,998,65.83%,45.59%,1
新北市,板橋區,1169,385,174,559,15,574,862,66.59%,44.66%,1
新北市,板橋區,1170,558,263,821,42,863,1622,53.21%,34.4%,1
新北市,板橋區,1171,539,163,702,27,729,1205,60.5%,44.73%,1
新北市,板橋區,1172,615,274,889,41,930,1787,52.04%,34.42%,1
新北市,板橋區,1173,588,311,899,24,923,1610,57.33%,36.52%,1
新北市,板橋區,1174,837,459,1296,21,1317,2216,59.43%,37.77%,1
新北市,板橋區,1175,987,452,1439,39,1478,2294,64.43%,43.03%,1
新北市,板橋區,1176,803,298,1101,41,1142,2090,54.64%,38.42%,1
新北市,板橋區,1177,414,192,606,23,629,1356,46.39%,30.53%,1
新北市,板橋區,1178,451,171,622,20,642,1067,60.17%,42.27%,1
新北市,板橋區,1179,521,213,734,24,758,1319,57.47%,39.5%,1
新北市,板橋區,1180,497,207,704,32,736,1316,55.93%,37.77%,1
新北市,板橋區,1181,451,167,618,35,653,1195,54.64%,37.74%,1
新北市,板橋區,1182,333,145,478,20,498,857,58.11%,38.86%,1
新北市,板橋區,1183,507,215,722,54,776,1417,54.76%,35.78%,1
新北市,板橋區,1184,596,265,861,55,916,1560,58.72%,38.21%,1
新北市,板橋區,1185,686,291,977,40,1017,1747,58.21%,39.27%,1
新北市,板橋區,1186,504,232,736,20,756,1176,64.29%,42.86%,1
新北市,板橋區,1187,440,197,637,21,658,1101,59.76%,39.96%,1
新北市,板橋區,1188,585,253,838,27,865,1458,59.33%,40.12%,1
新北市,板橋區,1189,575,222,797,39,836,1630,51.29%,35.28%,1
新北市,板橋區,1190,461,265,726,64,790,1611,49.04%,28.62%,1
新北市,板橋區,1191,454,160,614,18,632,1139,55.49%,39.86%,1
新北市,板橋區,1192,450,162,612,23,635,1120,56.7%,40.18%,1
新北市,板橋區,1193,426,168,594,58,652,1022,63.8%,41.68%,1
新北市,板橋區,1194,440,167,607,40,647,1049,61.68%,41.94%,1
新北市,板橋區,1195,390,176,566,17,583,1007,57.89%,38.73%,1
新北市,板橋區,1196,549,219,768,21,789,1393,56.64%,39.41%,1
新北市,板橋區,1197,140,35,175,29,204,474,43.04%,29.54%,1
新北市,板橋區,1198,197,89,286,15,301,500,60.2%,39.4%,1
新北市,板橋區,1199,491,183,674,20,694,1177,58.96%,41.72%,1
新北市,板橋區,1200,483,175,658,30,688,1186,58.01%,40.73%,1
新北市,板橋區,1201,466,205,671,33,704,1139,61.81%,40.91%,1
新北市,板橋區,1202,679,255,934,27,961,1750,54.91%,38.8%,1
新北市,板橋區,1203,817,362,1179,32,1211,3451,35.09%,23.67%,1
新北市,板橋區,1204,571,244,815,47,862,1620,53.21%,35.25%,1
新北市,板橋區,1205,324,127,451,19,470,903,52.05%,35.88%,1
新北市,板橋區,1206,504,194,698,25,723,1232,58.69%,40.91%,1
新北市,板橋區,1207,355,140,495,17,512,975,52.51%,36.41%,1
新北市,板橋區,1208,490,170,660,33,693,1224,56.62%,40.03%,1
新北市,板橋區,1209,521,202,723,27,750,1291,58.09%,40.36%,1
新北市,板橋區,1210,720,281,1001,43,1044,1828,57.11%,39.39%,1
新北市,板橋區,1211,573,265,838,41,879,1725,50.96%,33.22%,1
新北市,板橋區,1212,370,163,533,23,556,1085,51.24%,34.1%,1
新北市,板橋區,1213,812,364,1176,56,1232,2357,52.27%,34.45%,1
新北市,板橋區,1214,570,252,822,27,849,1560,54.42%,36.54%,1
新北市,板橋區,1215,674,298,972,25,997,2201,45.3%,30.62%,1
新北市,板橋區,1216,613,244,857,25,882,1626,54.24%,37.7%,1
新北市,板橋區,1217,565,254,819,19,838,1786,46.92%,31.63%,1
新北市,板橋區,1218,673,258,931,36,967,1763,54.85%,38.17%,1
新北市,板橋區,1219,592,274,866,28,894,1744,51.26%,33.94%,1
新北市,板橋區,1220,628,240,868,33,901,1645,54.77%,38.18%,1
新北市,板橋區,1221,634,278,912,23,935,1861,50.24%,34.07%,1
新北市,板橋區,1222,578,215,793,27,820,1596,51.38%,36.22%,1
新北市,板橋區,1223,668,287,955,47,1002,1871,53.55%,35.7%,1
新北市,板橋區,1224,715,309,1024,35,1059,1938,54.64%,36.89%,1
新北市,板橋區,1225,686,300,986,29,1015,1827,55.56%,37.55%,1
新北市,板橋區,1226,494,203,697,26,723,1359,53.2%,36.35%,1
新北市,板橋區,1227,600,257,857,37,894,1613,55.42%,37.2%,1
新北市,板橋區,1228,614,246,860,33,893,1566,57.02%,39.21%,1
新北市,板橋區,1229,147,290,437,32,469,1552,30.22%,9.47%,1
新北市,板橋區,1230,665,313,978,24,1002,1885,53.16%,35.28%,1
新北市,板橋區,1231,701,279,980,27,1007,1893,53.2%,37.03%,1
新北市,三重區,0659,522,256,778,32,810,1509,53.68%,34.59%,1
新北市,三重區,0660,615,262,877,50,927,1591,58.27%,38.65%,1
新北市,三重區,0661,620,286,906,54,960,1653,58.08%,37.51%,1
新北市,三重區,0662,541,244,785,51,836,1392,60.06%,38.86%,1
新北市,三重區,0663,588,246,834,46,880,1451,60.65%,40.52%,1
新北市,三重區,0664,519,204,723,42,765,1329,57.56%,39.05%,1
新北市,三重區,0665,571,241,812,31,843,1459,57.78%,39.14%,1
新北市,三重區,0666,424,160,584,43,627,1024,61.23%,41.41%,1
新北市,三重區,0667,447,177,624,29,653,1066,61.26%,41.93%,1
新北市,三重區,0668,367,172,539,32,571,856,66.71%,42.87%,1
新北市,三重區,0669,285,124,409,27,436,764,57.07%,37.3%,1
新北市,三重區,0670,362,135,497,24,521,821,63.46%,44.09%,1
新北市,三重區,0671,636,320,956,46,1002,1887,53.1%,33.7%,1
新北市,三重區,0672,594,258,852,40,892,1646,54.19%,36.09%,1
新北市,三重區,0673,146,67,213,15,228,358,63.69%,40.78%,1
新北市,三重區,0674,414,177,591,36,627,1039,60.35%,39.85%,1
新北市,三重區,0675,407,236,643,35,678,1114,60.86%,36.54%,1
新北市,三重區,0676,604,304,908,29,937,1588,59.01%,38.04%,1
新北市,三重區,0677,602,276,878,30,908,1702,53.35%,35.37%,1
新北市,三重區,0678,413,243,656,40,696,1288,54.04%,32.07%,1
新北市,三重區,0679,655,292,947,38,985,1629,60.47%,40.21%,1
新北市,三重區,0680,687,317,1004,52,1056,1861,56.74%,36.92%,1
新北市,三重區,0681,600,264,864,38,902,1727,52.23%,34.74%,1
新北市,三重區,0682,572,398,970,45,1015,1813,55.98%,31.55%,1
新北市,三重區,0683,631,247,878,42,920,1595,57.68%,39.56%,1
新北市,三重區,0684,586,251,837,55,892,1513,58.96%,38.73%,1
新北市,三重區,0685,509,272,781,47,828,4433,18.68%,11.48%,1
新北市,三重區,0686,527,201,728,22,750,1283,58.46%,41.08%,1
新北市,三重區,0687,587,253,840,35,875,1430,61.19%,41.05%,1
新北市,三重區,0688,526,265,791,23,814,1357,59.99%,38.76%,1
新北市,三重區,0689,391,161,552,22,574,963,59.61%,40.6%,1
新北市,三重區,0690,326,168,494,33,527,883,59.68%,36.92%,1
新北市,三重區,0691,577,235,812,52,864,1494,57.83%,38.62%,1
新北市,三重區,0692,613,286,899,57,956,1616,59.16%,37.93%,1
新北市,三重區,0693,498,219,717,44,761,1329,57.26%,37.47%,1
新北市,三重區,0694,528,244,772,33,805,1289,62.45%,40.96%,1
新北市,三重區,0695,541,238,779,38,817,1380,59.2%,39.2%,1
新北市,三重區,0696,603,331,934,29,963,1668,57.73%,36.15%,1
新北市,三重區,0697,508,224,732,44,776,1226,63.3%,41.44%,1
新北市,三重區,0698,564,264,828,27,855,1421,60.17%,39.69%,1
新北市,三重區,0699,549,223,772,35,807,1364,59.16%,40.25%,1
新北市,三重區,0700,500,206,706,27,733,1232,59.5%,40.58%,1
新北市,三重區,0701,531,227,758,30,788,1248,63.14%,42.55%,1
新北市,三重區,0702,499,215,714,36,750,1256,59.71%,39.73%,1
新北市,三重區,0703,631,270,901,32,933,1506,61.95%,41.9%,1
新北市,三重區,0704,670,294,964,27,991,1669,59.38%,40.14%,1
新北市,三重區,0705,414,302,716,46,762,1308,58.26%,31.65%,1
新北市,三重區,0706,556,251,807,26,833,1263,65.95%,44.02%,1
新北市,三重區,0707,532,260,792,45,837,1471,56.9%,36.17%,1
新北市,三重區,0708,556,274,830,47,877,1447,60.61%,38.42%,1
新北市,三重區,0709,523,275,798,38,836,1693,49.38%,30.89%,1
新北市,三重區,0710,718,350,1068,27,1095,2015,54.34%,35.63%,1
新北市,三重區,0711,666,229,895,57,952,1812,52.54%,36.75%,1
新北市,三重區,0712,527,253,780,26,806,1509,53.41%,34.92%,1
新北市,三重區,0713,563,241,804,31,835,1439,58.03%,39.12%,1
新北市,三重區,0714,567,225,792,31,823,1437,57.27%,39.46%,1
新北市,三重區,0715,561,312,873,53,926,1697,54.57%,33.06%,1
新北市,三重區,0716,600,309,909,24,933,1793,52.04%,33.46%,1
新北市,三重區,0717,646,297,943,27,970,1603,60.51%,40.3%,1
新北市,三重區,0718,418,200,618,17,635,1166,54.46%,35.85%,1
新北市,三重區,0719,420,226,646,21,667,1126,59.24%,37.3%,1
新北市,三重區,0720,460,165,625,29,654,1291,50.66%,35.63%,1
新北市,三重區,0721,559,296,855,49,904,1597,56.61%,35%,1
新北市,三重區,0722,436,181,617,48,665,1081,61.52%,40.33%,1
新北市,三重區,0723,388,167,555,35,590,911,64.76%,42.59%,1
新北市,三重區,0724,575,259,834,26,860,1719,50.03%,33.45%,1
新北市,三重區,0725,448,225,673,55,728,1289,56.48%,34.76%,1
新北市,三重區,0726,551,215,766,38,804,1318,61%,41.81%,1
新北市,三重區,0727,613,306,919,46,965,1822,52.96%,33.64%,1
新北市,三重區,0728,455,182,637,59,696,1185,58.73%,38.4%,1
新北市,三重區,0729,381,289,670,52,722,1369,52.74%,27.83%,1
新北市,三重區,0730,575,244,819,46,865,1507,57.4%,38.16%,1
新北市,三重區,0731,352,162,514,41,555,926,59.94%,38.01%,1
新北市,三重區,0732,362,139,501,9,510,950,53.68%,38.11%,1
新北市,三重區,0733,573,280,853,45,898,1678,53.52%,34.15%,1
新北市,三重區,0734,400,186,586,52,638,1117,57.12%,35.81%,1
新北市,三重區,0735,472,206,678,36,714,1318,54.17%,35.81%,1
新北市,三重區,0736,512,261,773,31,804,1388,57.93%,36.89%,1
新北市,三重區,0737,367,201,568,35,603,1026,58.77%,35.77%,1
新北市,三重區,0738,428,215,643,37,680,1096,62.04%,39.05%,1
新北市,三重區,0739,384,169,553,20,573,967,59.26%,39.71%,1
新北市,三重區,0740,623,327,950,41,991,1871,52.97%,33.3%,1
新北市,三重區,0741,598,290,888,50,938,1663,56.4%,35.96%,1
新北市,三重區,0742,460,195,655,26,681,1208,56.37%,38.08%,1
新北市,三重區,0743,457,255,712,34,746,1398,53.36%,32.69%,1
新北市,三重區,0744,404,174,578,13,591,1078,54.82%,37.48%,1
新北市,三重區,0745,426,146,572,40,612,1102,55.54%,38.66%,1
新北市,三重區,0746,474,239,713,54,767,1393,55.06%,34.03%,1
新北市,三重區,0747,495,203,698,44,742,1251,59.31%,39.57%,1
新北市,三重區,0748,516,234,750,39,789,1234,63.94%,41.82%,1
新北市,三重區,0749,635,283,918,42,960,1661,57.8%,38.23%,1
新北市,三重區,0750,598,264,862,48,910,1590,57.23%,37.61%,1
新北市,三重區,0751,490,182,672,32,704,1182,59.56%,41.46%,1
新北市,三重區,0752,546,225,771,47,818,1369,59.75%,39.88%,1
新北市,三重區,0753,498,222,720,38,758,1222,62.03%,40.75%,1
新北市,三重區,0754,470,204,674,66,740,1304,56.75%,36.04%,1
新北市,三重區,0755,394,147,541,28,569,1054,53.98%,37.38%,1
新北市,三重區,0756,589,276,865,51,916,1635,56.02%,36.02%,1
新北市,三重區,0757,617,274,891,49,940,1779,52.84%,34.68%,1
新北市,三重區,0758,619,268,887,49,936,1633,57.32%,37.91%,1
新北市,三重區,0759,435,186,621,24,645,1107,58.27%,39.3%,1
新北市,三重區,0760,435,179,614,30,644,1021,63.08%,42.61%,1
新北市,三重區,0761,543,239,782,72,854,1649,51.79%,32.93%,1
新北市,三重區,0762,341,130,471,30,501,874,57.32%,39.02%,1
新北市,三重區,0763,528,234,762,63,825,1402,58.84%,37.66%,1
新北市,三重區,0764,573,247,820,53,873,1713,50.96%,33.45%,1
新北市,三重區,0765,320,131,451,41,492,973,50.57%,32.89%,1
新北市,三重區,0766,384,195,579,40,619,1038,59.63%,36.99%,1
新北市,三重區,0767,625,269,894,53,947,1833,51.66%,34.1%,1
新北市,三重區,0768,301,148,449,16,465,817,56.92%,36.84%,1
新北市,三重區,0769,529,253,782,43,825,1387,59.48%,38.14%,1
新北市,三重區,0770,322,145,467,22,489,784,62.37%,41.07%,1
新北市,三重區,0771,400,178,578,35,613,1096,55.93%,36.5%,1
新北市,三重區,0772,468,184,652,32,684,1163,58.81%,40.24%,1
新北市,三重區,0773,650,288,938,43,981,1868,52.52%,34.8%,1
新北市,三重區,0774,412,158,570,44,614,1117,54.97%,36.88%,1
新北市,三重區,0775,339,138,477,24,501,934,53.64%,36.3%,1
新北市,三重區,0776,485,212,697,51,748,1412,52.97%,34.35%,1
新北市,三重區,0777,447,199,646,31,677,1062,63.75%,42.09%,1
新北市,三重區,0778,340,121,461,47,508,891,57.01%,38.16%,1
新北市,三重區,0779,393,183,576,69,645,936,68.91%,41.99%,1
新北市,三重區,0780,415,154,569,45,614,1085,56.59%,38.25%,1
新北市,三重區,0781,352,177,529,12,541,1065,50.8%,33.05%,1
新北市,三重區,0782,551,234,785,30,815,1398,58.3%,39.41%,1
新北市,三重區,0783,620,233,853,36,889,1550,57.35%,40%,1
新北市,三重區,0784,603,245,848,63,911,1674,54.42%,36.02%,1
新北市,三重區,0785,464,192,656,53,709,1215,58.35%,38.19%,1
新北市,三重區,0786,599,242,841,45,886,1606,55.17%,37.3%,1
新北市,三重區,0787,447,193,640,34,674,1182,57.02%,37.82%,1
新北市,三重區,0788,467,210,677,56,733,1238,59.21%,37.72%,1
新北市,三重區,0789,525,231,756,44,800,1342,59.61%,39.12%,1
新北市,三重區,0790,534,241,775,45,820,1408,58.24%,37.93%,1
新北市,三重區,0791,655,286,941,64,1005,1770,56.78%,37.01%,1
新北市,三重區,0792,344,172,516,39,555,940,59.04%,36.6%,1
新北市,三重區,0793,361,164,525,21,546,975,56%,37.03%,1
新北市,三重區,0794,534,249,783,24,807,1507,53.55%,35.43%,1
新北市,三重區,0795,532,227,759,54,813,1419,57.29%,37.49%,1
新北市,三重區,0796,489,185,674,46,720,1257,57.28%,38.9%,1
新北市,三重區,0797,621,257,878,42,920,1619,56.83%,38.36%,1
新北市,三重區,0798,664,257,921,48,969,1745,55.53%,38.05%,1
新北市,三重區,0799,543,256,799,60,859,1519,56.55%,35.75%,1
新北市,三重區,0800,609,244,853,36,889,1682,52.85%,36.21%,1
新北市,三重區,0801,654,290,944,47,991,1697,58.4%,38.54%,1
新北市,三重區,0802,410,150,560,30,590,1073,54.99%,38.21%,1
新北市,三重區,0803,363,125,488,24,512,924,55.41%,39.29%,1
新北市,三重區,0804,562,204,766,34,800,1613,49.6%,34.84%,1
新北市,三重區,0805,386,139,525,24,549,1034,53.09%,37.33%,1
新北市,三重區,0806,442,165,607,50,657,1118,58.77%,39.53%,1
新北市,三重區,0807,482,197,679,51,730,1269,57.53%,37.98%,1
新北市,三重區,0808,368,151,519,38,557,990,56.26%,37.17%,1
新北市,三重區,0809,515,202,717,47,764,1336,57.19%,38.55%,1
新北市,三重區,0810,565,295,860,50,910,1601,56.84%,35.29%,1
新北市,三重區,0811,644,255,899,42,941,1581,59.52%,40.73%,1
新北市,三重區,0812,520,226,746,32,778,1345,57.84%,38.66%,1
新北市,三重區,0813,499,213,712,45,757,1226,61.75%,40.7%,1
新北市,三重區,0814,563,231,794,78,872,1650,52.85%,34.12%,1
新北市,三重區,0815,438,177,615,44,659,1140,57.81%,38.42%,1
新北市,三重區,0816,568,247,815,34,849,1639,51.8%,34.66%,1
新北市,三重區,0817,652,263,915,41,956,1699,56.27%,38.38%,1
新北市,三重區,0818,678,270,948,46,994,1501,66.22%,45.17%,1
新北市,三重區,0819,587,240,827,43,870,1538,56.57%,38.17%,1
新北市,三重區,0820,568,225,793,54,847,1540,55%,36.88%,1
新北市,三重區,0821,490,193,683,39,722,1276,56.58%,38.4%,1
新北市,三重區,0822,544,239,783,48,831,1539,54%,35.35%,1
新北市,三重區,0823,443,231,674,30,704,1170,60.17%,37.86%,1
新北市,三重區,0824,402,200,602,35,637,1120,56.88%,35.89%,1
新北市,三重區,0825,669,295,964,49,1013,1789,56.62%,37.4%,1
新北市,三重區,0826,489,265,754,57,811,1520,53.36%,32.17%,1
新北市,三重區,0827,669,302,971,45,1016,1821,55.79%,36.74%,1
新北市,三重區,0828,514,248,762,42,804,1407,57.14%,36.53%,1
新北市,三重區,0829,545,247,792,43,835,1491,56%,36.55%,1
新北市,三重區,0830,545,247,792,39,831,1381,60.17%,39.46%,1
新北市,三重區,0831,453,230,683,46,729,1222,59.66%,37.07%,1
新北市,三重區,0832,689,311,1000,36,1036,1938,53.46%,35.55%,1
新北市,三重區,0833,636,246,882,29,911,1639,55.58%,38.8%,1
新北市,三重區,0834,592,264,856,51,907,1614,56.2%,36.68%,1
新北市,三重區,0835,630,244,874,44,918,1709,53.72%,36.86%,1
新北市,三重區,0836,615,238,853,57,910,1753,51.91%,35.08%,1
新北市,三重區,0837,539,212,751,67,818,1398,58.51%,38.56%,1
新北市,三重區,0838,616,273,889,44,933,1706,54.69%,36.11%,1
新北市,三重區,0839,623,265,888,42,930,1614,57.62%,38.6%,1
新北市,三重區,0840,596,264,860,38,898,1591,56.44%,37.46%,1
新北市,三重區,0841,592,300,892,30,922,1627,56.67%,36.39%,1
新北市,三重區,0842,579,275,854,51,905,1505,60.13%,38.47%,1
新北市,三重區,0843,539,205,744,24,768,1331,57.7%,40.5%,1
新北市,三重區,0844,573,231,804,37,841,1678,50.12%,34.15%,1
新北市,三重區,0845,558,255,813,38,851,1498,56.81%,37.25%,1
新北市,三重區,0846,668,349,1017,40,1057,1800,58.72%,37.11%,1
新北市,三重區,0847,558,270,828,38,866,1703,50.85%,32.77%,1
新北市,三重區,0848,641,305,946,39,985,1975,49.87%,32.46%,1
新北市,三重區,0849,658,288,946,41,987,1894,52.11%,34.74%,1
新北市,三重區,0850,539,247,786,37,823,1405,58.58%,38.36%,1
新北市,三重區,0851,512,221,733,23,756,1293,58.47%,39.6%,1
新北市,三重區,0852,652,248,900,29,929,1259,73.79%,51.79%,1
新北市,三重區,0853,480,174,654,59,713,1144,62.33%,41.96%,1
新北市,三重區,0854,583,135,718,52,770,1254,61.4%,46.49%,1
新北市,三重區,0855,495,218,713,36,749,1313,57.04%,37.7%,1
新北市,三重區,0856,544,260,804,72,876,1594,54.96%,34.13%,1
新北市,三重區,0857,651,289,940,35,975,1775,54.93%,36.68%,1
新北市,三重區,0858,583,209,792,60,852,1516,56.2%,38.46%,1
新北市,三重區,0859,538,227,765,60,825,1315,62.74%,40.91%,1
新北市,三重區,0860,338,137,475,46,521,843,61.8%,40.09%,1
新北市,三重區,0861,402,165,567,45,612,1160,52.76%,34.66%,1
新北市,三重區,0862,443,150,593,31,624,1052,59.32%,42.11%,1
新北市,三重區,0863,458,178,636,35,671,1054,63.66%,43.45%,1
新北市,三重區,0864,396,169,565,34,599,997,60.08%,39.72%,1
新北市,三重區,0865,348,135,483,30,513,936,54.81%,37.18%,1
新北市,三重區,0866,505,319,824,51,875,1658,52.77%,30.46%,1
新北市,三重區,0867,519,242,761,38,799,1496,53.41%,34.69%,1
新北市,三重區,0868,446,187,633,29,662,1064,62.22%,41.92%,1
新北市,三重區,0869,480,190,670,34,704,1152,61.11%,41.67%,1
新北市,三重區,0870,543,240,783,36,819,1532,53.46%,35.44%,1
新北市,三重區,0871,477,173,650,23,673,1338,50.3%,35.65%,1
新北市,三重區,0872,512,201,713,42,755,1303,57.94%,39.29%,1
新北市,三重區,0873,548,230,778,44,822,1369,60.04%,40.03%,1
新北市,三重區,0874,572,217,789,45,834,1491,55.94%,38.36%,1
新北市,三重區,0875,640,257,897,51,948,1821,52.06%,35.15%,1
新北市,三重區,0876,639,305,944,27,971,1906,50.94%,33.53%,1
新北市,三重區,0877,688,331,1019,35,1054,1842,57.22%,37.35%,1
新北市,三重區,0878,329,112,441,35,476,878,54.21%,37.47%,1
新北市,三重區,0879,386,188,574,44,618,963,64.17%,40.08%,1
新北市,三重區,0880,439,218,657,31,688,1381,49.82%,31.79%,1
新北市,三重區,0881,518,262,780,63,843,1681,50.15%,30.81%,1
新北市,三重區,0882,529,255,784,28,812,1548,52.45%,34.17%,1
新北市,三重區,0883,452,403,855,39,894,1542,57.98%,29.31%,1
新北市,三重區,0884,547,272,819,52,871,1557,55.94%,35.13%,1
新北市,三重區,0885,580,282,862,41,903,1661,54.36%,34.92%,1
新北市,三重區,0886,737,345,1082,13,1095,2024,54.1%,36.41%,1
新北市,三重區,0887,510,247,757,41,798,1588,50.25%,32.12%,1
新北市,三重區,0888,635,248,883,54,937,1706,54.92%,37.22%,1
新北市,三重區,0889,523,235,758,28,786,1341,58.61%,39%,1
新北市,三重區,0890,401,153,554,24,578,1025,56.39%,39.12%,1
新北市,三重區,0891,504,224,728,38,766,1339,57.21%,37.64%,1
新北市,三重區,0892,646,262,908,61,969,1725,56.17%,37.45%,1
新北市,三重區,0893,634,290,924,52,976,1826,53.45%,34.72%,1
新北市,中和區,1232,550,254,804,41,845,1630,51.84%,33.74%,1
新北市,中和區,1233,613,331,944,47,991,1775,55.83%,34.54%,1
新北市,中和區,1234,632,283,915,21,936,1844,50.76%,34.27%,1
新北市,中和區,1235,414,204,618,23,641,1019,62.9%,40.63%,1
新北市,中和區,1236,474,199,673,22,695,1138,61.07%,41.65%,1
新北市,中和區,1237,666,273,939,36,975,1878,51.92%,35.46%,1
新北市,中和區,1238,833,271,1104,33,1137,1980,57.42%,42.07%,1
新北市,中和區,1239,690,296,986,53,1039,1844,56.34%,37.42%,1
新北市,中和區,1240,786,353,1139,15,1154,2085,55.35%,37.7%,1
新北市,中和區,1241,583,217,800,33,833,1498,55.61%,38.92%,1
新北市,中和區,1242,660,320,980,26,1006,1761,57.13%,37.48%,1
新北市,中和區,1243,461,236,697,25,722,1254,57.58%,36.76%,1
新北市,中和區,1244,528,245,773,24,797,1343,59.34%,39.31%,1
新北市,中和區,1245,619,354,973,27,1000,1789,55.9%,34.6%,1
新北市,中和區,1246,705,372,1077,42,1119,2000,55.95%,35.25%,1
新北市,中和區,1247,608,340,948,32,980,1953,50.18%,31.13%,1
新北市,中和區,1248,615,290,905,58,963,1712,56.25%,35.92%,1
新北市,中和區,1249,632,242,874,40,914,1582,57.77%,39.95%,1
新北市,中和區,1250,630,282,912,47,959,1742,55.05%,36.17%,1
新北市,中和區,1251,624,270,894,33,927,1493,62.09%,41.8%,1
新北市,中和區,1252,482,220,702,37,739,1352,54.66%,35.65%,1
新北市,中和區,1253,537,177,714,27,741,1244,59.57%,43.17%,1
新北市,中和區,1254,541,238,779,41,820,1394,58.82%,38.81%,1
新北市,中和區,1255,570,284,854,25,879,1917,45.85%,29.73%,1
新北市,中和區,1256,637,279,916,48,964,1830,52.68%,34.81%,1
新北市,中和區,1257,416,217,633,29,662,1124,58.9%,37.01%,1
新北市,中和區,1258,472,214,686,39,725,1412,51.35%,33.43%,1
新北市,中和區,1259,483,241,724,31,755,1356,55.68%,35.62%,1
新北市,中和區,1260,539,200,739,19,758,1425,53.19%,37.82%,1
新北市,中和區,1261,520,210,730,32,762,1259,60.52%,41.3%,1
新北市,中和區,1262,485,216,701,37,738,1256,58.76%,38.61%,1
新北市,中和區,1263,548,225,773,31,804,1423,56.5%,38.51%,1
新北市,中和區,1264,484,201,685,32,717,1221,58.72%,39.64%,1
新北市,中和區,1265,625,281,906,38,944,1858,50.81%,33.64%,1
新北市,中和區,1266,631,287,918,36,954,1804,52.88%,34.98%,1
新北市,中和區,1267,638,300,938,28,966,1669,57.88%,38.23%,1
新北市,中和區,1268,590,225,815,26,841,1485,56.63%,39.73%,1
新北市,中和區,1269,415,164,579,31,610,1005,60.7%,41.29%,1
新北市,中和區,1270,480,239,719,34,753,1175,64.09%,40.85%,1
新北市,中和區,1271,473,190,663,28,691,1171,59.01%,40.39%,1
新北市,中和區,1272,600,254,854,35,889,1746,50.92%,34.36%,1
新北市,中和區,1273,515,249,764,15,779,1555,50.1%,33.12%,1
新北市,中和區,1274,405,178,583,50,633,1112,56.92%,36.42%,1
新北市,中和區,1275,685,341,1026,32,1058,1780,59.44%,38.48%,1
新北市,中和區,1276,679,358,1037,24,1061,1918,55.32%,35.4%,1
新北市,中和區,1277,500,244,744,24,768,1689,45.47%,29.6%,1
新北市,中和區,1278,685,327,1012,25,1037,1781,58.23%,38.46%,1
新北市,中和區,1279,520,247,767,39,806,1419,56.8%,36.65%,1
新北市,中和區,1280,516,198,714,22,736,1344,54.76%,38.39%,1
新北市,中和區,1281,737,342,1079,43,1122,1804,62.2%,40.85%,1
新北市,中和區,1282,635,285,920,44,964,1788,53.91%,35.51%,1
新北市,中和區,1283,694,282,976,28,1004,1793,56%,38.71%,1
新北市,中和區,1284,539,222,761,31,792,1352,58.58%,39.87%,1
新北市,中和區,1285,679,308,987,38,1025,1813,56.54%,37.45%,1
新北市,中和區,1286,557,240,797,19,816,1288,63.35%,43.25%,1
新北市,中和區,1287,445,209,654,36,690,1186,58.18%,37.52%,1
新北市,中和區,1288,496,172,668,11,679,1237,54.89%,40.1%,1
新北市,中和區,1289,550,214,764,41,805,1406,57.25%,39.12%,1
新北市,中和區,1290,540,232,772,39,811,1442,56.24%,37.45%,1
新北市,中和區,1291,438,186,624,26,650,1040,62.5%,42.12%,1
新北市,中和區,1292,546,205,751,33,784,1292,60.68%,42.26%,1
新北市,中和區,1293,661,300,961,33,994,1811,54.89%,36.5%,1
新北市,中和區,1294,705,278,983,47,1030,1789,57.57%,39.41%,1
新北市,中和區,1295,408,139,547,26,573,859,66.71%,47.5%,1
新北市,中和區,1296,470,137,607,19,626,972,64.4%,48.35%,1
新北市,中和區,1297,537,210,747,29,776,1346,57.65%,39.9%,1
新北市,中和區,1298,421,177,598,22,620,1034,59.96%,40.72%,1
新北市,中和區,1299,546,238,784,23,807,1387,58.18%,39.37%,1
新北市,中和區,1300,789,330,1119,65,1184,2067,57.28%,38.17%,1
新北市,中和區,1301,522,258,780,25,805,1670,48.2%,31.26%,1
新北市,中和區,1302,465,166,631,28,659,1166,56.52%,39.88%,1
新北市,中和區,1303,409,140,549,25,574,963,59.61%,42.47%,1
新北市,中和區,1304,414,141,555,24,579,1070,54.11%,38.69%,1
新北市,中和區,1305,548,227,775,24,799,1319,60.58%,41.55%,1
新北市,中和區,1306,596,238,834,45,879,1438,61.13%,41.45%,1
新北市,中和區,1307,653,277,930,21,951,1808,52.6%,36.12%,1
新北市,中和區,1308,472,152,624,17,641,1191,53.82%,39.63%,1
新北市,中和區,1309,638,234,872,43,915,1632,56.07%,39.09%,1
新北市,中和區,1310,648,231,879,35,914,1765,51.78%,36.71%,1
新北市,中和區,1311,514,167,681,21,702,1168,60.1%,44.01%,1
新北市,中和區,1312,478,158,636,23,659,1176,56.04%,40.65%,1
新北市,中和區,1313,702,245,947,47,994,1565,63.51%,44.86%,1
新北市,中和區,1314,573,203,776,34,810,1578,51.33%,36.31%,1
新北市,中和區,1315,705,373,1078,27,1105,2029,54.46%,34.75%,1
新北市,中和區,1316,359,141,500,25,525,905,58.01%,39.67%,1
新北市,中和區,1317,330,93,423,21,444,839,52.92%,39.33%,1
新北市,中和區,1318,295,142,437,17,454,762,59.58%,38.71%,1
新北市,中和區,1319,559,207,766,36,802,1420,56.48%,39.37%,1
新北市,中和區,1320,494,170,664,35,699,1272,54.95%,38.84%,1
新北市,中和區,1321,692,294,986,55,1041,1976,52.68%,35.02%,1
新北市,中和區,1322,670,268,938,33,971,1779,54.58%,37.66%,1
新北市,中和區,1323,496,195,691,27,718,1454,49.38%,34.11%,1
新北市,中和區,1324,547,164,711,30,741,1374,53.93%,39.81%,1
新北市,中和區,1325,472,206,678,20,698,1369,50.99%,34.48%,1
新北市,中和區,1326,537,258,795,31,826,1501,55.03%,35.78%,1
新北市,中和區,1327,425,151,576,27,603,920,65.54%,46.2%,1
新北市,中和區,1328,473,156,629,27,656,1050,62.48%,45.05%,1
新北市,中和區,1329,136,49,185,12,197,321,61.37%,42.37%,1
新北市,中和區,1330,557,193,750,39,789,1474,53.53%,37.79%,1
新北市,中和區,1331,573,216,789,52,841,1461,57.56%,39.22%,1
新北市,中和區,1332,618,233,851,31,882,1621,54.41%,38.12%,1
新北市,中和區,1333,562,225,787,37,824,1327,62.09%,42.35%,1
新北市,中和區,1334,309,131,440,13,453,775,58.45%,39.87%,1
新北市,中和區,1335,638,295,933,31,964,1916,50.31%,33.3%,1
新北市,中和區,1336,673,287,960,39,999,1901,52.55%,35.4%,1
新北市,中和區,1337,550,218,768,31,799,4411,18.11%,12.47%,1
新北市,中和區,1338,447,215,662,17,679,1212,56.02%,36.88%,1
新北市,中和區,1339,454,183,637,14,651,1126,57.82%,40.32%,1
新北市,中和區,1340,568,242,810,17,827,1507,54.88%,37.69%,1
新北市,中和區,1341,566,266,832,17,849,1519,55.89%,37.26%,1
新北市,中和區,1342,547,293,840,29,869,1467,59.24%,37.29%,1
新北市,中和區,1343,616,237,853,37,890,1453,61.25%,42.4%,1
新北市,中和區,1344,552,243,795,30,825,1364,60.48%,40.47%,1
新北市,中和區,1345,505,206,711,25,736,1302,56.53%,38.79%,1
新北市,中和區,1346,518,204,722,26,748,1627,45.97%,31.84%,1
新北市,中和區,1347,589,203,792,25,817,1503,54.36%,39.19%,1
新北市,中和區,1348,538,196,734,19,753,1392,54.09%,38.65%,1
新北市,中和區,1349,430,180,610,26,636,1067,59.61%,40.3%,1
新北市,中和區,1350,592,242,834,28,862,1623,53.11%,36.48%,1
新北市,中和區,1351,460,234,694,18,712,1208,58.94%,38.08%,1
新北市,中和區,1352,613,249,862,25,887,1991,44.55%,30.79%,1
新北市,中和區,1353,633,264,897,27,924,1932,47.83%,32.76%,1
新北市,中和區,1354,403,203,606,20,626,947,66.1%,42.56%,1
新北市,中和區,1355,658,255,913,42,955,1660,57.53%,39.64%,1
新北市,中和區,1356,539,221,760,26,786,1574,49.94%,34.24%,1
新北市,中和區,1357,709,325,1034,37,1071,2136,50.14%,33.19%,1
新北市,中和區,1358,524,207,731,49,780,1462,53.35%,35.84%,1
新北市,中和區,1359,559,206,765,53,818,1548,52.84%,36.11%,1
新北市,中和區,1360,308,131,439,18,457,692,66.04%,44.51%,1
新北市,中和區,1361,528,211,739,30,769,1221,62.98%,43.24%,1
新北市,中和區,1362,496,201,697,83,780,1331,58.6%,37.27%,1
新北市,中和區,1363,33,576,609,22,631,984,64.13%,3.35%,1
新北市,中和區,1364,638,278,916,30,946,1871,50.56%,34.1%,1
新北市,中和區,1365,555,183,738,28,766,1279,59.89%,43.39%,1
新北市,中和區,1366,628,270,898,28,926,1629,56.84%,38.55%,1
新北市,中和區,1367,556,272,828,20,848,1482,57.22%,37.52%,1
新北市,中和區,1368,691,279,970,30,1000,1715,58.31%,40.29%,1
新北市,中和區,1369,772,277,1049,42,1091,1952,55.89%,39.55%,1
新北市,中和區,1370,270,111,381,22,403,686,58.75%,39.36%,1
新北市,中和區,1371,513,247,760,20,780,1577,49.46%,32.53%,1
新北市,中和區,1372,451,210,661,20,681,1158,58.81%,38.95%,1
新北市,中和區,1373,523,217,740,16,756,1195,63.26%,43.77%,1
新北市,中和區,1374,457,205,662,16,678,1054,64.33%,43.36%,1
新北市,中和區,1375,267,118,385,15,400,612,65.36%,43.63%,1
新北市,中和區,1376,677,267,944,23,967,1668,57.97%,40.59%,1
新北市,中和區,1377,475,180,655,31,686,1071,64.05%,44.35%,1
新北市,中和區,1378,541,226,767,38,805,1169,68.86%,46.28%,1
新北市,中和區,1379,564,194,758,25,783,1370,57.15%,41.17%,1
新北市,中和區,1380,667,240,907,46,953,1574,60.55%,42.38%,1
新北市,中和區,1381,930,334,1264,13,1277,2614,48.85%,35.58%,1
新北市,中和區,1382,603,249,852,23,875,1477,59.24%,40.83%,1
新北市,中和區,1383,392,178,570,41,611,1041,58.69%,37.66%,1
新北市,中和區,1384,580,215,795,44,839,1538,54.55%,37.71%,1
新北市,中和區,1385,619,244,863,36,899,1599,56.22%,38.71%,1
新北市,中和區,1386,627,266,893,139,1032,1586,65.07%,39.53%,1
新北市,中和區,1387,733,280,1013,34,1047,1726,60.66%,42.47%,1
新北市,中和區,1388,758,344,1102,38,1140,1854,61.49%,40.88%,1
新北市,中和區,1389,639,223,862,43,905,1472,61.48%,43.41%,1
新北市,中和區,1390,601,240,841,35,876,1430,61.26%,42.03%,1
新北市,中和區,1391,585,272,857,30,887,1488,59.61%,39.31%,1
新北市,中和區,1392,472,211,683,33,716,1251,57.23%,37.73%,1
新北市,中和區,1393,589,242,831,33,864,1487,58.1%,39.61%,1
新北市,中和區,1394,486,207,693,49,742,1328,55.87%,36.6%,1
新北市,中和區,1395,453,219,672,25,697,1128,61.79%,40.16%,1
新北市,中和區,1396,473,163,636,28,664,1008,65.87%,46.92%,1
新北市,中和區,1397,688,318,1006,30,1036,1786,58.01%,38.52%,1
新北市,中和區,1398,795,365,1160,34,1194,2219,53.81%,35.83%,1
新北市,中和區,1399,497,199,696,29,725,1322,54.84%,37.59%,1
新北市,中和區,1400,613,139,752,8,760,1495,50.84%,41%,1
新北市,中和區,1401,452,307,759,34,793,1414,56.08%,31.97%,1
新北市,中和區,1402,719,210,929,45,974,1681,57.94%,42.77%,1
新北市,中和區,1403,508,241,749,32,781,1361,57.38%,37.33%,1
新北市,中和區,1404,557,223,780,30,810,1442,56.17%,38.63%,1
新北市,中和區,1405,512,223,735,25,760,1383,54.95%,37.02%,1
新北市,中和區,1406,510,192,702,31,733,1264,57.99%,40.35%,1
新北市,中和區,1407,755,278,1033,42,1075,1810,59.39%,41.71%,1
新北市,中和區,1408,659,275,934,24,958,1951,49.1%,33.78%,1
新北市,中和區,1409,577,213,790,34,824,1582,52.09%,36.47%,1
新北市,中和區,1410,783,321,1104,48,1152,1945,59.23%,40.26%,1
新北市,中和區,1411,554,222,776,38,814,1390,58.56%,39.86%,1
新北市,中和區,1412,462,201,663,13,676,1161,58.23%,39.79%,1
新北市,中和區,1413,595,170,765,96,861,1399,61.54%,42.53%,1
新北市,中和區,1414,450,148,598,16,614,1070,57.38%,42.06%,1
新北市,中和區,1415,483,167,650,24,674,1169,57.66%,41.32%,1
新北市,中和區,1416,550,188,738,32,770,1214,63.43%,45.3%,1
新北市,中和區,1417,540,250,790,39,829,1398,59.3%,38.63%,1
新北市,中和區,1418,423,174,597,19,616,1049,58.72%,40.32%,1
新北市,中和區,1419,561,237,798,34,832,1324,62.84%,42.37%,1
新北市,中和區,1420,555,263,818,22,840,1765,47.59%,31.44%,1
新北市,中和區,1421,600,265,865,30,895,1709,52.37%,35.11%,1
新北市,中和區,1422,496,165,661,35,696,1186,58.68%,41.82%,1
新北市,中和區,1423,577,192,769,23,792,1318,60.09%,43.78%,1
新北市,中和區,1424,529,275,804,36,840,1430,58.74%,36.99%,1
新北市,中和區,1425,501,203,704,29,733,1637,44.78%,30.6%,1
新北市,中和區,1426,485,239,724,26,750,1283,58.46%,37.8%,1
新北市,中和區,1427,515,216,731,31,762,1310,58.17%,39.31%,1
新北市,中和區,1428,520,216,736,32,768,1301,59.03%,39.97%,1
新北市,中和區,1429,629,308,937,27,964,1681,57.35%,37.42%,1
新北市,中和區,1430,545,255,800,21,821,1384,59.32%,39.38%,1
新北市,中和區,1431,445,220,665,24,689,1187,58.05%,37.49%,1
新北市,中和區,1432,561,243,804,10,814,1779,45.76%,31.53%,1
新北市,中和區,1433,663,277,940,36,976,1712,57.01%,38.73%,1
新北市,中和區,1434,506,261,767,32,799,1462,54.65%,34.61%,1
新北市,中和區,1435,640,304,944,21,965,1824,52.91%,35.09%,1
新北市,中和區,1436,502,237,739,10,749,1389,53.92%,36.14%,1
新北市,中和區,1437,579,246,825,27,852,1434,59.41%,40.38%,1
新北市,中和區,1438,724,284,1008,46,1054,1953,53.97%,37.07%,1
新北市,中和區,1439,727,367,1094,35,1129,2002,56.39%,36.31%,1
新北市,中和區,1440,706,279,985,28,1013,1858,54.52%,38%,1
新北市,中和區,1441,639,318,957,23,980,1801,54.41%,35.48%,1
新北市,中和區,1442,658,281,939,41,980,1691,57.95%,38.91%,1
新北市,中和區,1443,525,257,782,33,815,1363,59.79%,38.52%,1
新北市,中和區,1444,529,224,753,22,775,1220,63.52%,43.36%,1
新北市,中和區,1445,580,268,848,21,869,1365,63.66%,42.49%,1
新北市,中和區,1446,489,188,677,18,695,1178,59%,41.51%,1
新北市,中和區,1447,357,135,492,18,510,830,61.45%,43.01%,1
新北市,中和區,1448,422,183,605,36,641,1197,53.55%,35.25%,1
新北市,中和區,1449,565,207,772,38,810,1369,59.17%,41.27%,1
新北市,中和區,1450,560,207,767,29,796,1336,59.58%,41.92%,1
新北市,中和區,1451,572,249,821,37,858,1377,62.31%,41.54%,1
新北市,中和區,1452,623,231,854,32,886,1499,59.11%,41.56%,1
新北市,中和區,1453,705,282,987,25,1012,1689,59.92%,41.74%,1
新北市,中和區,1454,529,237,766,34,800,1323,60.47%,39.98%,1
新北市,中和區,1455,463,188,651,28,679,1079,62.93%,42.91%,1
新北市,中和區,1456,602,266,868,35,903,1545,58.45%,38.96%,1
新北市,中和區,1457,473,246,719,29,748,1326,56.41%,35.67%,1
新北市,中和區,1458,508,259,767,28,795,1443,55.09%,35.2%,1
新北市,中和區,1459,671,265,936,24,960,1712,56.07%,39.19%,1
新北市,中和區,1460,722,294,1016,33,1049,1916,54.75%,37.68%,1
新北市,中和區,1461,369,151,520,21,541,863,62.69%,42.76%,1
新北市,中和區,1462,506,224,730,5,735,1203,61.1%,42.06%,1
新北市,中和區,1463,538,253,791,16,807,1483,54.42%,36.28%,1
新北市,中和區,1464,588,240,828,21,849,1575,53.9%,37.33%,1
新北市,中和區,1465,504,185,689,39,728,1432,50.84%,35.2%,1
新北市,中和區,1466,555,227,782,37,819,1441,56.84%,38.51%,1
新北市,中和區,1467,506,219,725,34,759,1269,59.81%,39.87%,1
新北市,中和區,1468,566,235,801,14,815,1363,59.79%,41.53%,1
新北市,中和區,1469,483,143,626,15,641,1089,58.86%,44.35%,1
新北市,中和區,1470,420,191,611,21,632,1171,53.97%,35.87%,1
新北市,中和區,1471,473,187,660,32,692,1150,60.17%,41.13%,1
新北市,中和區,1472,494,202,696,52,748,1154,64.82%,42.81%,1
新北市,中和區,1473,513,135,648,17,665,1067,62.32%,48.08%,1
新北市,中和區,1474,579,221,800,31,831,1526,54.46%,37.94%,1
新北市,中和區,1475,559,273,832,21,853,1447,58.95%,38.63%,1
新北市,永和區,1476,592,275,867,49,916,1554,58.94%,38.1%,1
新北市,永和區,1477,464,159,623,20,643,1065,60.38%,43.57%,1
新北市,永和區,1478,379,145,524,22,546,854,63.93%,44.38%,1
新北市,永和區,1479,524,206,730,31,761,1253,60.73%,41.82%,1
新北市,永和區,1480,646,325,971,29,1000,1733,57.7%,37.28%,1
新北市,永和區,1481,596,270,866,33,899,1581,56.86%,37.7%,1
新北市,永和區,1482,665,262,927,36,963,1735,55.5%,38.33%,1
新北市,永和區,1483,582,249,831,17,848,1563,54.25%,37.24%,1
新北市,永和區,1484,644,308,952,35,987,1650,59.82%,39.03%,1
新北市,永和區,1485,575,230,805,26,831,1454,57.15%,39.55%,1
新北市,永和區,1486,549,266,815,32,847,1568,54.02%,35.01%,1
新北市,永和區,1487,522,220,742,35,777,1444,53.81%,36.15%,1
新北市,永和區,1488,401,207,608,35,643,1140,56.4%,35.18%,1
新北市,永和區,1489,519,199,718,22,740,1188,62.29%,43.69%,1
新北市,永和區,1490,584,233,817,42,859,1516,56.66%,38.52%,1
新北市,永和區,1491,519,228,747,32,779,1397,55.76%,37.15%,1
新北市,永和區,1492,550,237,787,25,812,1438,56.47%,38.25%,1
新北市,永和區,1493,448,194,642,12,654,1084,60.33%,41.33%,1
新北市,永和區,1494,373,162,535,21,556,941,59.09%,39.64%,1
新北市,永和區,1495,684,168,852,23,875,1598,54.76%,42.8%,1
新北市,永和區,1496,582,277,859,20,879,2842,30.93%,20.48%,1
新北市,永和區,1497,514,253,767,25,792,1261,62.81%,40.76%,1
新北市,永和區,1498,623,278,901,27,928,1449,64.04%,43%,1
新北市,永和區,1499,606,245,851,40,891,1511,58.97%,40.11%,1
新北市,永和區,1500,629,267,896,30,926,1470,62.99%,42.79%,1
新北市,永和區,1501,604,291,895,25,920,1580,58.23%,38.23%,1
新北市,永和區,1502,616,257,873,32,905,1438,62.93%,42.84%,1
新北市,永和區,1503,557,248,805,23,828,1305,63.45%,42.68%,1
新北市,永和區,1504,446,193,639,23,662,1046,63.29%,42.64%,1
新北市,永和區,1505,628,286,914,16,930,1566,59.39%,40.1%,1
新北市,永和區,1506,582,257,839,36,875,1468,59.6%,39.65%,1
新北市,永和區,1507,579,257,836,32,868,1305,66.51%,44.37%,1
新北市,永和區,1508,482,226,708,23,731,1181,61.9%,40.81%,1
新北市,永和區,1509,613,306,919,40,959,1720,55.76%,35.64%,1
新北市,永和區,1510,453,221,674,32,706,1103,64.01%,41.07%,1
新北市,永和區,1511,608,312,920,33,953,1649,57.79%,36.87%,1
新北市,永和區,1512,489,234,723,31,754,1206,62.52%,40.55%,1
新北市,永和區,1513,581,318,899,22,921,1506,61.16%,38.58%,1
新北市,永和區,1514,565,257,822,30,852,1488,57.26%,37.97%,1
新北市,永和區,1515,503,260,763,42,805,1288,62.5%,39.05%,1
新北市,永和區,1516,497,232,729,30,759,1413,53.72%,35.17%,1
新北市,永和區,1517,541,206,747,30,777,1329,58.47%,40.71%,1
新北市,永和區,1518,609,255,864,25,889,1436,61.91%,42.41%,1
新北市,永和區,1519,462,181,643,25,668,1112,60.07%,41.55%,1
新北市,永和區,1520,520,202,722,25,747,1100,67.91%,47.27%,1
新北市,永和區,1521,649,276,925,34,959,1545,62.07%,42.01%,1
新北市,永和區,1522,591,219,810,17,827,1436,57.59%,41.16%,1
新北市,永和區,1523,748,297,1045,41,1086,1731,62.74%,43.21%,1
新北市,永和區,1524,727,315,1042,52,1094,1762,62.09%,41.26%,1
新北市,永和區,1525,487,234,721,29,750,1320,56.82%,36.89%,1
新北市,永和區,1526,438,198,636,17,653,1297,50.35%,33.77%,1
新北市,永和區,1527,342,166,508,35,543,1798,30.2%,19.02%,1
新北市,永和區,1528,594,282,876,41,917,1491,61.5%,39.84%,1
新北市,永和區,1529,488,218,706,10,716,1223,58.54%,39.9%,1
新北市,永和區,1530,459,173,632,33,665,1108,60.02%,41.43%,1
新北市,永和區,1531,564,274,838,23,861,1408,61.15%,40.06%,1
新北市,永和區,1532,509,225,734,44,778,1265,61.5%,40.24%,1
新北市,永和區,1533,448,179,627,8,635,1115,56.95%,40.18%,1
新北市,永和區,1534,503,194,697,32,729,1133,64.34%,44.4%,1
新北市,永和區,1535,509,198,707,32,739,1217,60.72%,41.82%,1
新北市,永和區,1536,645,283,928,43,971,1713,56.68%,37.65%,1
新北市,永和區,1537,616,292,908,41,949,1721,55.14%,35.79%,1
新北市,永和區,1538,522,208,730,30,760,1327,57.27%,39.34%,1
新北市,永和區,1539,535,235,770,19,789,1257,62.77%,42.56%,1
新北市,永和區,1540,587,246,833,23,856,1348,63.5%,43.55%,1
新北市,永和區,1541,606,288,894,28,922,1461,63.11%,41.48%,1
新北市,永和區,1542,546,225,771,47,818,1368,59.8%,39.91%,1
新北市,永和區,1543,504,191,695,31,726,1234,58.83%,40.84%,1
新北市,永和區,1544,509,227,736,26,762,1303,58.48%,39.06%,1
新北市,永和區,1545,593,239,832,27,859,1516,56.66%,39.12%,1
新北市,永和區,1546,607,230,837,39,876,1422,61.6%,42.69%,1
新北市,永和區,1547,416,186,602,19,621,991,62.66%,41.98%,1
新北市,永和區,1548,437,182,619,20,639,1016,62.89%,43.01%,1
新北市,永和區,1549,468,204,672,21,693,1146,60.47%,40.84%,1
新北市,永和區,1550,467,146,613,26,639,1043,61.27%,44.77%,1
新北市,永和區,1551,495,228,723,25,748,1210,61.82%,40.91%,1
新北市,永和區,1552,641,290,931,28,959,1630,58.83%,39.33%,1
新北市,永和區,1553,450,199,649,22,671,1092,61.45%,41.21%,1
新北市,永和區,1554,738,330,1068,46,1114,1872,59.51%,39.42%,1
新北市,永和區,1555,686,306,992,24,1016,1781,57.05%,38.52%,1
新北市,永和區,1556,441,190,631,22,653,1049,62.25%,42.04%,1
新北市,永和區,1557,545,247,792,23,815,1285,63.42%,42.41%,1
新北市,永和區,1558,467,251,718,36,754,1209,62.37%,38.63%,1
新北市,永和區,1559,452,237,689,23,712,1132,62.9%,39.93%,1
新北市,永和區,1560,544,249,793,31,824,1287,64.02%,42.27%,1
新北市,永和區,1561,435,198,633,39,672,1068,62.92%,40.73%,1
新北市,永和區,1562,436,236,672,33,705,1098,64.21%,39.71%,1
新北市,永和區,1563,534,202,736,33,769,1222,62.93%,43.7%,1
新北市,永和區,1564,494,180,674,41,715,1157,61.8%,42.7%,1
新北市,永和區,1565,473,258,731,34,765,1168,65.5%,40.5%,1
新北市,永和區,1566,487,230,717,37,754,1283,58.77%,37.96%,1
新北市,永和區,1567,553,229,782,27,809,1372,58.97%,40.31%,1
新北市,永和區,1568,737,357,1094,39,1133,1876,60.39%,39.29%,1
新北市,永和區,1569,686,265,951,53,1004,1576,63.71%,43.53%,1
新北市,永和區,1570,660,305,965,34,999,1661,60.14%,39.74%,1
新北市,永和區,1571,702,278,980,26,1006,1808,55.64%,38.83%,1
新北市,永和區,1572,701,343,1044,51,1095,1898,57.69%,36.93%,1
新北市,永和區,1573,635,279,914,28,942,1508,62.47%,42.11%,1
新北市,永和區,1574,580,218,798,32,830,1341,61.89%,43.25%,1
新北市,永和區,1575,549,247,796,41,837,1422,58.86%,38.61%,1
新北市,永和區,1576,460,203,663,26,689,1177,58.54%,39.08%,1
新北市,永和區,1577,622,262,884,43,927,1557,59.54%,39.95%,1
新北市,永和區,1578,554,254,808,22,830,1491,55.67%,37.16%,1
新北市,永和區,1579,601,282,883,28,911,1586,57.44%,37.89%,1
新北市,永和區,1580,492,228,720,15,735,1313,55.98%,37.47%,1
新北市,永和區,1581,607,297,904,38,942,1636,57.58%,37.1%,1
新北市,永和區,1582,620,282,902,27,929,1598,58.14%,38.8%,1
新北市,永和區,1583,625,323,948,23,971,1609,60.35%,38.84%,1
新北市,永和區,1584,511,302,813,38,851,1375,61.89%,37.16%,1
新北市,永和區,1585,646,346,992,46,1038,1648,62.99%,39.2%,1
新北市,永和區,1586,432,197,629,28,657,1077,61%,40.11%,1
新北市,永和區,1587,476,210,686,18,704,1157,60.85%,41.14%,1
新北市,永和區,1588,539,297,836,20,856,1339,63.93%,40.25%,1
新北市,永和區,1589,546,254,800,13,813,1306,62.25%,41.81%,1
新北市,永和區,1590,532,236,768,10,778,1236,62.94%,43.04%,1
新北市,永和區,1591,472,209,681,23,704,1133,62.14%,41.66%,1
新北市,永和區,1592,566,274,840,27,867,1425,60.84%,39.72%,1
新北市,永和區,1593,735,315,1050,53,1103,1938,56.91%,37.93%,1
新北市,永和區,1594,634,293,927,34,961,1607,59.8%,39.45%,1
新北市,永和區,1595,384,117,501,32,533,853,62.49%,45.02%,1
新北市,永和區,1596,309,92,401,29,430,768,55.99%,40.23%,1
新北市,永和區,1597,329,95,424,22,446,893,49.94%,36.84%,1
新北市,永和區,1598,305,115,420,18,438,743,58.95%,41.05%,1
新北市,永和區,1599,467,211,678,36,714,1155,61.82%,40.43%,1
新北市,永和區,1600,532,229,761,30,791,1263,62.63%,42.12%,1
新北市,永和區,1601,496,225,721,19,740,1189,62.24%,41.72%,1
新北市,永和區,1602,519,213,732,33,765,1346,56.84%,38.56%,1
新北市,永和區,1603,508,239,747,32,779,1368,56.94%,37.13%,1
新北市,永和區,1604,424,182,606,19,625,1043,59.92%,40.65%,1
新北市,永和區,1605,674,319,993,39,1032,1709,60.39%,39.44%,1
新北市,永和區,1606,318,154,472,13,485,879,55.18%,36.18%,1
新北市,永和區,1607,347,174,521,20,541,904,59.85%,38.38%,1
新北市,永和區,1608,525,211,736,34,770,1221,63.06%,43%,1
新北市,永和區,1609,407,194,601,34,635,1018,62.38%,39.98%,1
新北市,永和區,1610,544,312,856,28,884,1551,57%,35.07%,1
新北市,永和區,1611,558,262,820,42,862,1428,60.36%,39.08%,1
新北市,永和區,1612,432,184,616,38,654,1044,62.64%,41.38%,1
新北市,永和區,1613,397,178,575,34,609,967,62.98%,41.05%,1
新北市,新莊區,0302,440,185,625,38,663,1123,59.04%,39.18%,1
新北市,新莊區,0303,513,230,743,35,778,1278,60.88%,40.14%,1
新北市,新莊區,0304,512,195,707,32,739,1163,63.54%,44.02%,1
新北市,新莊區,0305,515,219,734,24,758,1228,61.73%,41.94%,1
新北市,新莊區,0306,476,202,678,42,720,1211,59.45%,39.31%,1
新北市,新莊區,0307,484,186,670,28,698,1176,59.35%,41.16%,1
新北市,新莊區,0308,634,284,918,31,949,1536,61.78%,41.28%,1
新北市,新莊區,0309,618,277,895,43,938,1486,63.12%,41.59%,1
新北市,新莊區,0310,614,304,918,39,957,1513,63.25%,40.58%,1
新北市,新莊區,0311,588,267,855,35,890,1395,63.8%,42.15%,1
新北市,新莊區,0312,515,203,718,46,764,1353,56.47%,38.06%,1
新北市,新莊區,0313,596,237,833,47,880,1409,62.46%,42.3%,1
新北市,新莊區,0314,568,231,799,26,825,1478,55.82%,38.43%,1
新北市,新莊區,0315,392,159,551,28,579,921,62.87%,42.56%,1
新北市,新莊區,0316,417,174,591,20,611,971,62.92%,42.95%,1
新北市,新莊區,0317,679,243,922,45,967,1534,63.04%,44.26%,1
新北市,新莊區,0318,593,223,816,33,849,1516,56%,39.12%,1
新北市,新莊區,0319,261,130,391,19,410,697,58.82%,37.45%,1
新北市,新莊區,0320,483,216,699,28,727,1235,58.87%,39.11%,1
新北市,新莊區,0321,442,191,633,29,662,1138,58.17%,38.84%,1
新北市,新莊區,0322,407,163,570,25,595,1063,55.97%,38.29%,1
新北市,新莊區,0323,552,262,814,32,846,3399,24.89%,16.24%,1
新北市,新莊區,0324,617,267,884,53,937,1575,59.49%,39.17%,1
新北市,新莊區,0325,630,341,971,39,1010,1615,62.54%,39.01%,1
新北市,新莊區,0326,576,243,819,34,853,1612,52.92%,35.73%,1
新北市,新莊區,0327,556,241,797,49,846,1514,55.88%,36.72%,1
新北市,新莊區,0328,466,226,692,28,720,1382,52.1%,33.72%,1
新北市,新莊區,0329,485,311,796,37,833,1475,56.47%,32.88%,1
新北市,新莊區,0330,548,278,826,21,847,1462,57.93%,37.48%,1
新北市,新莊區,0331,492,265,757,34,791,1426,55.47%,34.5%,1
新北市,新莊區,0332,498,253,751,40,791,1421,55.67%,35.05%,1
新北市,新莊區,0333,559,277,836,26,862,1536,56.12%,36.39%,1
新北市,新莊區,0334,561,332,893,31,924,1587,58.22%,35.35%,1
新北市,新莊區,0335,275,122,397,11,408,749,54.47%,36.72%,1
新北市,新莊區,0336,551,185,736,31,767,1276,60.11%,43.18%,1
新北市,新莊區,0337,475,230,705,33,738,1303,56.64%,36.45%,1
新北市,新莊區,0338,518,111,629,44,673,1259,53.46%,41.14%,1
新北市,新莊區,0339,529,221,750,33,783,1291,60.65%,40.98%,1
新北市,新莊區,0340,557,274,831,18,849,1493,56.87%,37.31%,1
新北市,新莊區,0341,574,275,849,33,882,1507,58.53%,38.09%,1
新北市,新莊區,0342,544,266,810,11,821,1456,56.39%,37.36%,1
新北市,新莊區,0343,599,203,802,18,820,1396,58.74%,42.91%,1
新北市,新莊區,0344,498,192,690,32,722,1351,53.44%,36.86%,1
新北市,新莊區,0345,516,254,770,34,804,1403,57.31%,36.78%,1
新北市,新莊區,0346,559,245,804,34,838,1497,55.98%,37.34%,1
新北市,新莊區,0347,506,215,721,51,772,1272,60.69%,39.78%,1
新北市,新莊區,0348,467,177,644,23,667,1269,52.56%,36.8%,1
新北市,新莊區,0349,522,229,751,49,800,1335,59.93%,39.1%,1
新北市,新莊區,0350,501,276,777,18,795,1300,61.15%,38.54%,1
新北市,新莊區,0351,532,229,761,33,794,1286,61.74%,41.37%,1
新北市,新莊區,0352,576,226,802,28,830,1255,66.14%,45.9%,1
新北市,新莊區,0353,598,241,839,53,892,1558,57.25%,38.38%,1
新北市,新莊區,0354,596,234,830,39,869,1567,55.46%,38.03%,1
新北市,新莊區,0355,661,245,906,45,951,1603,59.33%,41.24%,1
新北市,新莊區,0356,568,296,864,14,878,1538,57.09%,36.93%,1
新北市,新莊區,0357,608,322,930,34,964,1671,57.69%,36.39%,1
新北市,新莊區,0358,632,267,899,18,917,1698,54%,37.22%,1
新北市,新莊區,0359,581,325,906,35,941,1545,60.91%,37.61%,1
新北市,新莊區,0360,683,286,969,65,1034,1696,60.97%,40.27%,1
新北市,新莊區,0361,626,218,844,59,903,1626,55.54%,38.5%,1
新北市,新莊區,0362,429,197,626,39,665,1170,56.84%,36.67%,1
新北市,新莊區,0363,501,176,677,47,724,1236,58.58%,40.53%,1
新北市,新莊區,0364,430,134,564,34,598,1071,55.84%,40.15%,1
新北市,新莊區,0365,438,192,630,22,652,1129,57.75%,38.8%,1
新北市,新莊區,0366,656,289,945,24,969,1586,61.1%,41.36%,1
新北市,新莊區,0367,588,219,807,26,833,1597,52.16%,36.82%,1
新北市,新莊區,0368,547,215,762,68,830,1573,52.77%,34.77%,1
新北市,新莊區,0369,508,173,681,29,710,1225,57.96%,41.47%,1
新北市,新莊區,0370,482,146,628,25,653,1217,53.66%,39.61%,1
新北市,新莊區,0371,597,258,855,37,892,1571,56.78%,38%,1
新北市,新莊區,0372,588,240,828,35,863,1594,54.14%,36.89%,1
新北市,新莊區,0373,596,243,839,35,874,1583,55.21%,37.65%,1
新北市,新莊區,0374,558,193,751,34,785,1245,63.05%,44.82%,1
新北市,新莊區,0375,512,189,701,29,730,1203,60.68%,42.56%,1
新北市,新莊區,0376,528,243,771,43,814,1265,64.35%,41.74%,1
新北市,新莊區,0377,531,196,727,34,761,1255,60.64%,42.31%,1
新北市,新莊區,0378,494,229,723,30,753,1287,58.51%,38.38%,1
新北市,新莊區,0379,492,198,690,39,729,1167,62.47%,42.16%,1
新北市,新莊區,0380,500,195,695,31,726,1299,55.89%,38.49%,1
新北市,新莊區,0381,463,216,679,27,706,1207,58.49%,38.36%,1
新北市,新莊區,0382,574,225,799,34,833,1415,58.87%,40.57%,1
新北市,新莊區,0383,493,243,736,49,785,1342,58.49%,36.74%,1
新北市,新莊區,0384,501,233,734,49,783,1341,58.39%,37.36%,1
新北市,新莊區,0385,442,237,679,36,715,1247,57.34%,35.45%,1
新北市,新莊區,0386,468,164,632,22,654,984,66.46%,47.56%,1
新北市,新莊區,0387,426,185,611,31,642,1043,61.55%,40.84%,1
新北市,新莊區,0388,518,218,736,28,764,1135,67.31%,45.64%,1
新北市,新莊區,0389,460,221,681,24,705,1185,59.49%,38.82%,1
新北市,新莊區,0390,516,248,764,20,784,1346,58.25%,38.34%,1
新北市,新莊區,0391,545,230,775,43,818,1372,59.62%,39.72%,1
新北市,新莊區,0392,584,212,796,40,836,1350,61.93%,43.26%,1
新北市,新莊區,0393,479,220,699,34,733,1307,56.08%,36.65%,1
新北市,新莊區,0394,528,209,737,42,779,1353,57.58%,39.02%,1
新北市,新莊區,0395,544,185,729,44,773,1287,60.06%,42.27%,1
新北市,新莊區,0396,504,228,732,28,760,1567,48.5%,32.16%,1
新北市,新莊區,0397,636,333,969,44,1013,1709,59.27%,37.21%,1
新北市,新莊區,0398,608,233,841,24,865,1616,53.53%,37.62%,1
新北市,新莊區,0399,571,262,833,39,872,1628,53.56%,35.07%,1
新北市,新莊區,0400,502,174,676,35,711,1148,61.93%,43.73%,1
新北市,新莊區,0401,490,192,682,8,690,1201,57.45%,40.8%,1
新北市,新莊區,0402,503,210,713,25,738,1135,65.02%,44.32%,1
新北市,新莊區,0403,613,276,889,33,922,1495,61.67%,41%,1
新北市,新莊區,0404,616,254,870,42,912,1486,61.37%,41.45%,1
新北市,新莊區,0405,625,285,910,27,937,1483,63.18%,42.14%,1
新北市,新莊區,0406,570,246,816,34,850,1553,54.73%,36.7%,1
新北市,新莊區,0407,656,334,990,22,1012,1625,62.28%,40.37%,1
新北市,新莊區,0408,607,325,932,23,955,1671,57.15%,36.33%,1
新北市,新莊區,0409,563,260,823,44,867,1389,62.42%,40.53%,1
新北市,新莊區,0410,516,205,721,33,754,1272,59.28%,40.57%,1
新北市,新莊區,0411,577,286,863,28,891,1409,63.24%,40.95%,1
新北市,新莊區,0412,547,277,824,27,851,1372,62.03%,39.87%,1
新北市,新莊區,0413,386,151,537,26,563,955,58.95%,40.42%,1
新北市,新莊區,0414,375,126,501,42,543,952,57.04%,39.39%,1
新北市,新莊區,0415,564,241,805,18,823,1412,58.29%,39.94%,1
新北市,新莊區,0416,580,222,802,26,828,1415,58.52%,40.99%,1
新北市,新莊區,0417,567,247,814,46,860,1421,60.52%,39.9%,1
新北市,新莊區,0418,524,257,781,31,812,1293,62.8%,40.53%,1
新北市,新莊區,0419,531,249,780,26,806,1475,54.64%,36%,1
新北市,新莊區,0420,546,241,787,36,823,1429,57.59%,38.21%,1
新北市,新莊區,0421,548,260,808,39,847,1481,57.19%,37%,1
新北市,新莊區,0422,598,226,824,44,868,1472,58.97%,40.63%,1
新北市,新莊區,0423,285,567,852,23,875,1474,59.36%,19.34%,1
新北市,新莊區,0424,572,280,852,24,876,1462,59.92%,39.12%,1
新北市,新莊區,0425,569,298,867,19,886,1484,59.7%,38.34%,1
新北市,新莊區,0426,566,240,806,36,842,1461,57.63%,38.74%,1
新北市,新莊區,0427,555,278,833,28,861,1444,59.63%,38.43%,1
新北市,新莊區,0428,571,263,834,22,856,1437,59.57%,39.74%,1
新北市,新莊區,0429,540,275,815,17,832,1641,50.7%,32.91%,1
新北市,新莊區,0430,570,290,860,15,875,1633,53.58%,34.91%,1
新北市,新莊區,0431,579,288,867,19,886,1531,57.87%,37.82%,1
新北市,新莊區,0432,602,274,876,30,906,1517,59.72%,39.68%,1
新北市,新莊區,0433,572,224,796,32,828,1487,55.68%,38.47%,1
新北市,新莊區,0434,586,269,855,36,891,1560,57.12%,37.56%,1
新北市,新莊區,0435,576,283,859,42,901,1584,56.88%,36.36%,1
新北市,新莊區,0436,597,255,852,19,871,1602,54.37%,37.27%,1
新北市,新莊區,0437,330,126,456,29,485,818,59.29%,40.34%,1
新北市,新莊區,0438,580,210,790,37,827,1633,50.64%,35.52%,1
新北市,新莊區,0439,632,234,866,32,898,1652,54.36%,38.26%,1
新北市,新莊區,0440,458,242,700,32,732,1498,48.87%,30.57%,1
新北市,新莊區,0441,520,222,742,50,792,1379,57.43%,37.71%,1
新北市,新莊區,0442,577,221,798,40,838,1381,60.68%,41.78%,1
新北市,新莊區,0443,622,249,871,39,910,1535,59.28%,40.52%,1
新北市,新莊區,0444,642,267,909,45,954,1492,63.94%,43.03%,1
新北市,新莊區,0445,611,251,862,55,917,1450,63.24%,42.14%,1
新北市,新莊區,0446,431,198,629,30,659,1107,59.53%,38.93%,1
新北市,新莊區,0447,457,203,660,17,677,1063,63.69%,42.99%,1
新北市,新莊區,0448,479,189,668,32,700,1143,61.24%,41.91%,1
新北市,新莊區,0449,491,218,709,49,758,1341,56.52%,36.61%,1
新北市,新莊區,0450,444,157,601,24,625,1063,58.8%,41.77%,1
新北市,新莊區,0451,448,192,640,20,660,1096,60.22%,40.88%,1
新北市,新莊區,0452,518,210,728,22,750,1309,57.3%,39.57%,1
新北市,新莊區,0453,492,221,713,35,748,1216,61.51%,40.46%,1
新北市,新莊區,0454,492,185,677,20,697,1278,54.54%,38.5%,1
新北市,新莊區,0455,518,212,730,44,774,1352,57.25%,38.31%,1
新北市,新莊區,0456,451,194,645,37,682,1298,52.54%,34.75%,1
新北市,新莊區,0457,421,158,579,36,615,1042,59.02%,40.4%,1
新北市,新莊區,0458,324,133,457,16,473,881,53.69%,36.78%,1
新北市,新莊區,0459,484,201,685,29,714,1109,64.38%,43.64%,1
新北市,新莊區,0460,474,197,671,53,724,1291,56.08%,36.72%,1
新北市,新莊區,0461,451,241,692,18,710,1293,54.91%,34.88%,1
新北市,新莊區,0462,535,217,752,37,789,1336,59.06%,40.04%,1
新北市,新莊區,0463,535,190,725,24,749,1384,54.12%,38.66%,1
新北市,新莊區,0464,475,165,640,18,658,1231,53.45%,38.59%,1
新北市,新莊區,0465,393,141,534,24,558,940,59.36%,41.81%,1
新北市,新莊區,0466,505,208,713,57,770,1369,56.25%,36.89%,1
新北市,新莊區,0467,547,185,732,44,776,1384,56.07%,39.52%,1
新北市,新莊區,0468,500,219,719,37,756,1272,59.43%,39.31%,1
新北市,新莊區,0469,435,170,605,33,638,1073,59.46%,40.54%,1
新北市,新莊區,0470,410,172,582,24,606,1058,57.28%,38.75%,1
新北市,新莊區,0471,533,297,830,17,847,1528,55.43%,34.88%,1
新北市,新莊區,0472,472,178,650,31,681,1244,54.74%,37.94%,1
新北市,新莊區,0473,535,166,701,25,726,1356,53.54%,39.45%,1
新北市,新莊區,0474,456,142,598,12,610,1164,52.41%,39.18%,1
新北市,新莊區,0475,572,222,794,44,838,1423,58.89%,40.2%,1
新北市,新莊區,0476,530,226,756,21,777,1250,62.16%,42.4%,1
新北市,新莊區,0477,440,226,666,23,689,1252,55.03%,35.14%,1
新北市,新莊區,0478,384,156,540,17,557,1022,54.5%,37.57%,1
新北市,新莊區,0479,379,160,539,31,570,959,59.44%,39.52%,1
新北市,新莊區,0480,623,311,934,31,965,1646,58.63%,37.85%,1
新北市,新莊區,0481,541,284,825,45,870,1551,56.09%,34.88%,1
新北市,新莊區,0482,625,258,883,24,907,1526,59.44%,40.96%,1
新北市,新莊區,0483,535,289,824,23,847,1518,55.8%,35.24%,1
新北市,新莊區,0484,563,309,872,30,902,1547,58.31%,36.39%,1
新北市,新莊區,0485,549,232,781,46,827,1505,54.95%,36.48%,1
新北市,新莊區,0486,575,215,790,37,827,1527,54.16%,37.66%,1
新北市,新莊區,0487,529,211,740,41,781,1482,52.7%,35.7%,1
新北市,新莊區,0488,552,231,783,45,828,1586,52.21%,34.8%,1
新北市,新莊區,0489,410,154,564,60,624,1065,58.59%,38.5%,1
新北市,新莊區,0490,470,173,643,30,673,1040,64.71%,45.19%,1
新北市,新莊區,0491,402,170,572,37,609,1090,55.87%,36.88%,1
新北市,新莊區,0492,443,149,592,32,624,1071,58.26%,41.36%,1
新北市,新莊區,0493,600,316,916,28,944,1704,55.4%,35.21%,1
新北市,新莊區,0494,577,272,849,20,869,1698,51.18%,33.98%,1
新北市,新莊區,0495,569,254,823,30,853,1362,62.63%,41.78%,1
新北市,新莊區,0496,516,275,791,25,816,1350,60.44%,38.22%,1
新北市,新莊區,0497,673,268,941,30,971,1689,57.49%,39.85%,1
新北市,新莊區,0498,663,254,917,21,938,1612,58.19%,41.13%,1
新北市,新莊區,0499,477,174,651,38,689,1130,60.97%,42.21%,1
新北市,新莊區,0500,461,198,659,44,703,1111,63.28%,41.49%,1
新北市,新莊區,0501,569,256,825,24,849,1539,55.17%,36.97%,1
新北市,新莊區,0502,587,275,862,30,892,1586,56.24%,37.01%,1
新北市,新莊區,0503,623,289,912,26,938,1631,57.51%,38.2%,1
新北市,新莊區,0504,562,278,840,25,865,1540,56.17%,36.49%,1
新北市,新莊區,0505,465,204,669,31,700,1388,50.43%,33.5%,1
新北市,新莊區,0506,482,184,666,50,716,1388,51.59%,34.73%,1
新北市,新莊區,0507,478,189,667,36,703,1387,50.68%,34.46%,1
新北市,新莊區,0508,430,178,608,36,644,1181,54.53%,36.41%,1
新北市,新莊區,0509,446,187,633,32,665,1135,58.59%,39.3%,1
新北市,新莊區,0510,453,199,652,23,675,1173,57.54%,38.62%,1
新北市,新莊區,0511,404,276,680,24,704,1215,57.94%,33.25%,1
新北市,新莊區,0512,555,283,838,33,871,1488,58.53%,37.3%,1
新北市,新莊區,0513,534,263,797,29,826,1444,57.2%,36.98%,1
新北市,新莊區,0514,557,257,814,24,838,1499,55.9%,37.16%,1
新北市,新莊區,0515,519,261,780,26,806,1449,55.62%,35.82%,1
新北市,新莊區,0516,601,274,875,48,923,1640,56.28%,36.65%,1
新北市,新莊區,0517,597,270,867,46,913,1648,55.4%,36.23%,1
新北市,新莊區,0518,491,198,689,33,722,1371,52.66%,35.81%,1
新北市,新莊區,0519,521,213,734,34,768,1400,54.86%,37.21%,1
新北市,新莊區,0520,559,203,762,60,822,1457,56.42%,38.37%,1
新北市,新莊區,0521,535,243,778,50,828,1502,55.13%,35.62%,1
新北市,新莊區,0522,505,230,735,53,788,1412,55.81%,35.76%,1
新北市,新莊區,0523,514,180,694,46,740,1318,56.15%,39%,1
新北市,新莊區,0524,553,254,807,28,835,1411,59.18%,39.19%,1
新北市,新莊區,0525,486,236,722,24,746,1262,59.11%,38.51%,1
新北市,新莊區,0526,516,205,721,26,747,1228,60.83%,42.02%,1
新北市,新莊區,0527,641,337,978,46,1024,1748,58.58%,36.67%,1
新北市,新莊區,0528,684,294,978,50,1028,1761,58.38%,38.84%,1
新北市,新莊區,0529,503,179,682,23,705,1326,53.17%,37.93%,1
新北市,新莊區,0530,480,169,649,21,670,1344,49.85%,35.71%,1
新北市,新莊區,0531,551,183,734,32,766,1355,56.53%,40.66%,1
新北市,新莊區,0532,540,197,737,30,767,1306,58.73%,41.35%,1
新北市,新莊區,0533,530,243,773,26,799,1349,59.23%,39.29%,1
新北市,新莊區,0534,529,185,714,22,736,1265,58.18%,41.82%,1
新北市,新莊區,0535,547,208,755,26,781,1282,60.92%,42.67%,1
新北市,新莊區,0536,532,189,721,31,752,1237,60.79%,43.01%,1
新北市,新莊區,0537,522,190,712,25,737,1301,56.65%,40.12%,1
新北市,新莊區,0538,495,192,687,42,729,1262,57.77%,39.22%,1
新北市,新莊區,0539,507,191,698,29,727,1270,57.24%,39.92%,1
新北市,新莊區,0540,491,207,698,37,735,1245,59.04%,39.44%,1
新北市,新莊區,0541,481,173,654,37,691,1220,56.64%,39.43%,1
新北市,新莊區,0542,442,184,626,41,667,1245,53.57%,35.5%,1
新北市,新莊區,0543,455,180,635,33,668,1212,55.12%,37.54%,1
新北市,新莊區,0544,457,190,647,43,690,1253,55.07%,36.47%,1
新北市,新莊區,0545,470,163,633,44,677,1272,53.22%,36.95%,1
新北市,新莊區,0546,494,215,709,20,729,1227,59.41%,40.26%,1
新北市,新莊區,0547,479,184,663,14,677,1126,60.12%,42.54%,1
新北市,新莊區,0548,471,219,690,34,724,1240,58.39%,37.98%,1
新北市,新莊區,0549,556,241,797,39,836,1460,57.26%,38.08%,1
新北市,新莊區,0550,402,175,577,23,600,1072,55.97%,37.5%,1
新北市,新莊區,0551,388,175,563,21,584,1127,51.82%,34.43%,1
新北市,新莊區,0552,545,216,761,16,777,1332,58.33%,40.92%,1
新北市,新莊區,0553,438,250,688,17,705,1341,52.57%,32.66%,1
新北市,新莊區,0554,365,135,500,22,522,1140,45.79%,32.02%,1
新北市,新店區,1987,620,257,877,26,903,1603,56.33%,38.68%,1
新北市,新店區,1988,442,599,1041,40,1081,1921,56.27%,23.01%,1
新北市,新店區,1989,412,173,585,13,598,1082,55.27%,38.08%,1
新北市,新店區,1990,478,216,694,29,723,1235,58.54%,38.7%,1
新北市,新店區,1991,667,232,899,22,921,1568,58.74%,42.54%,1
新北市,新店區,1992,305,152,457,15,472,771,61.22%,39.56%,1
新北市,新店區,1993,471,228,699,20,719,1256,57.25%,37.5%,1
新北市,新店區,1994,405,163,568,36,604,1008,59.92%,40.18%,1
新北市,新店區,1995,609,250,859,23,882,1515,58.22%,40.2%,1
新北市,新店區,1996,714,278,992,32,1024,1637,62.55%,43.62%,1
新北市,新店區,1997,587,292,879,25,904,1549,58.36%,37.9%,1
新北市,新店區,1998,853,373,1226,39,1265,2011,62.9%,42.42%,1
新北市,新店區,1999,622,239,861,49,910,1554,58.56%,40.03%,1
新北市,新店區,2000,646,308,954,39,993,1770,56.1%,36.5%,1
新北市,新店區,2001,514,231,745,38,783,1316,59.5%,39.06%,1
新北市,新店區,2002,459,155,614,33,647,1126,57.46%,40.76%,1
新北市,新店區,2003,560,211,771,35,806,1460,55.21%,38.36%,1
新北市,新店區,2004,632,271,903,47,950,1584,59.97%,39.9%,1
新北市,新店區,2005,565,245,810,26,836,1449,57.69%,38.99%,1
新北市,新店區,2006,669,271,940,22,962,1520,63.29%,44.01%,1
新北市,新店區,2007,717,330,1047,24,1071,1821,58.81%,39.37%,1
新北市,新店區,2008,712,378,1090,26,1116,1956,57.06%,36.4%,1
新北市,新店區,2009,663,286,949,33,982,1665,58.98%,39.82%,1
新北市,新店區,2010,633,313,946,24,970,1588,61.08%,39.86%,1
新北市,新店區,2011,568,270,838,22,860,1519,56.62%,37.39%,1
新北市,新店區,2012,461,266,727,29,756,1185,63.8%,38.9%,1
新北市,新店區,2013,429,259,688,16,704,1095,64.29%,39.18%,1
新北市,新店區,2014,490,175,665,34,699,1106,63.2%,44.3%,1
新北市,新店區,2015,246,138,384,15,399,2700,14.78%,9.11%,1
新北市,新店區,2016,435,157,592,16,608,995,61.11%,43.72%,1
新北市,新店區,2017,488,181,669,24,693,1168,59.33%,41.78%,1
新北市,新店區,2018,522,202,724,39,763,1123,67.94%,46.48%,1
新北市,新店區,2019,461,218,679,30,709,1085,65.35%,42.49%,1
新北市,新店區,2020,601,253,854,34,888,1412,62.89%,42.56%,1
新北市,新店區,2021,693,249,942,32,974,1659,58.71%,41.77%,1
新北市,新店區,2022,514,213,727,37,764,1198,63.77%,42.9%,1
新北市,新店區,2023,535,187,722,29,751,1376,54.58%,38.88%,1
新北市,新店區,2024,511,193,704,26,730,1300,56.15%,39.31%,1
新北市,新店區,2025,512,193,705,25,730,1238,58.97%,41.36%,1
新北市,新店區,2026,531,215,746,20,766,1388,55.19%,38.26%,1
新北市,新店區,2027,379,181,560,27,587,933,62.92%,40.62%,1
新北市,新店區,2028,408,156,564,19,583,908,64.21%,44.93%,1
新北市,新店區,2029,640,234,874,40,914,1582,57.77%,40.46%,1
新北市,新店區,2030,537,217,754,26,780,1247,62.55%,43.06%,1
新北市,新店區,2031,402,176,578,27,605,971,62.31%,41.4%,1
新北市,新店區,2032,488,198,686,25,711,1145,62.1%,42.62%,1
新北市,新店區,2033,566,242,808,30,838,1392,60.2%,40.66%,1
新北市,新店區,2034,641,234,875,43,918,1452,63.22%,44.15%,1
新北市,新店區,2035,561,240,801,36,837,1440,58.13%,38.96%,1
新北市,新店區,2036,690,287,977,48,1025,1786,57.39%,38.63%,1
新北市,新店區,2037,714,297,1011,39,1050,1825,57.53%,39.12%,1
新北市,新店區,2038,636,257,893,19,912,1477,61.75%,43.06%,1
新北市,新店區,2039,677,326,1003,31,1034,1750,59.09%,38.69%,1
新北市,新店區,2040,720,273,993,28,1021,1792,56.98%,40.18%,1
新北市,新店區,2041,779,307,1086,37,1123,1979,56.75%,39.36%,1
新北市,新店區,2042,337,149,486,20,506,826,61.26%,40.8%,1
新北市,新店區,2043,787,324,1111,34,1145,1924,59.51%,40.9%,1
新北市,新店區,2044,586,265,851,20,871,1383,62.98%,42.37%,1
新北市,新店區,2045,302,103,405,26,431,830,51.93%,36.39%,1
新北市,新店區,2046,718,313,1031,26,1057,1759,60.09%,40.82%,1
新北市,新店區,2047,800,347,1147,40,1187,1957,60.65%,40.88%,1
新北市,新店區,2048,599,293,892,15,907,1481,61.24%,40.45%,1
新北市,新店區,2049,600,278,878,43,921,1552,59.34%,38.66%,1
新北市,新店區,2050,566,242,808,43,851,1467,58.01%,38.58%,1
新北市,新店區,2051,543,223,766,40,806,1371,58.79%,39.61%,1
新北市,新店區,2052,418,168,586,16,602,991,60.75%,42.18%,1
新北市,新店區,2053,491,234,725,26,751,1231,61.01%,39.89%,1
新北市,新店區,2054,678,294,972,27,999,1701,58.73%,39.86%,1
新北市,新店區,2055,763,307,1070,41,1111,1707,65.08%,44.7%,1
新北市,新店區,2056,675,307,982,31,1013,1773,57.13%,38.07%,1
新北市,新店區,2057,658,306,964,32,996,1866,53.38%,35.26%,1
新北市,新店區,2058,677,326,1003,29,1032,1735,59.48%,39.02%,1
新北市,新店區,2059,679,342,1021,34,1055,1632,64.64%,41.61%,1
新北市,新店區,2060,622,289,911,43,954,1591,59.96%,39.09%,1
新北市,新店區,2061,559,215,774,46,820,1495,54.85%,37.39%,1
新北市,新店區,2062,579,201,780,24,804,1511,53.21%,38.32%,1
新北市,新店區,2063,502,206,708,31,739,1260,58.65%,39.84%,1
新北市,新店區,2064,766,349,1115,42,1157,1948,59.39%,39.32%,1
新北市,新店區,2065,465,477,942,43,985,1582,62.26%,29.39%,1
新北市,新店區,2066,523,206,729,26,755,1315,57.41%,39.77%,1
新北市,新店區,2067,569,273,842,36,878,1562,56.21%,36.43%,1
新北市,新店區,2068,798,365,1163,23,1186,1982,59.84%,40.26%,1
新北市,新店區,2069,605,271,876,33,909,1518,59.88%,39.86%,1
新北市,新店區,2070,680,299,979,20,999,1735,57.58%,39.19%,1
新北市,新店區,2071,664,270,934,34,968,1716,56.41%,38.69%,1
新北市,新店區,2072,622,278,900,36,936,1580,59.24%,39.37%,1
新北市,新店區,2073,544,271,815,35,850,1358,62.59%,40.06%,1
新北市,新店區,2074,669,284,953,49,1002,1610,62.24%,41.55%,1
新北市,新店區,2075,552,224,776,16,792,1383,57.27%,39.91%,1
新北市,新店區,2076,644,267,911,30,941,1596,58.96%,40.35%,1
新北市,新店區,2077,513,175,688,35,723,1360,53.16%,37.72%,1
新北市,新店區,2078,456,148,604,14,618,1160,53.28%,39.31%,1
新北市,新店區,2079,600,197,797,23,820,1236,66.34%,48.54%,1
新北市,新店區,2080,548,229,777,23,800,1234,64.83%,44.41%,1
新北市,新店區,2081,617,265,882,33,915,1579,57.95%,39.08%,1
新北市,新店區,2082,492,178,670,40,710,1241,57.21%,39.65%,1
新北市,新店區,2083,516,195,711,18,729,1275,57.18%,40.47%,1
新北市,新店區,2084,428,185,613,34,647,1214,53.29%,35.26%,1
新北市,新店區,2085,557,187,744,46,790,1578,50.06%,35.3%,1
新北市,新店區,2086,493,277,770,31,801,1442,55.55%,34.19%,1
新北市,新店區,2087,535,183,718,55,773,1475,52.41%,36.27%,1
新北市,新店區,2088,614,279,893,39,932,1580,58.99%,38.86%,1
新北市,新店區,2089,618,248,866,21,887,1585,55.96%,38.99%,1
新北市,新店區,2090,587,267,854,52,906,1586,57.12%,37.01%,1
新北市,新店區,2091,728,302,1030,44,1074,1931,55.62%,37.7%,1
新北市,新店區,2092,469,195,664,22,686,1239,55.37%,37.85%,1
新北市,新店區,2093,734,282,1016,35,1051,1892,55.55%,38.79%,1
新北市,新店區,2094,480,303,783,34,817,1529,53.43%,31.39%,1
新北市,新店區,2095,567,203,770,23,793,1358,58.39%,41.75%,1
新北市,新店區,2096,665,302,967,26,993,1905,52.13%,34.91%,1
新北市,新店區,2097,698,279,977,41,1018,1885,54.01%,37.03%,1
新北市,新店區,2098,528,168,696,43,739,1345,54.94%,39.26%,1
新北市,新店區,2099,560,209,769,37,806,1387,58.11%,40.37%,1
新北市,新店區,2100,726,325,1051,29,1080,1960,55.1%,37.04%,1
新北市,新店區,2101,696,280,976,54,1030,1837,56.07%,37.89%,1
新北市,新店區,2102,628,290,918,33,951,1662,57.22%,37.79%,1
新北市,新店區,2103,661,286,947,48,995,1617,61.53%,40.88%,1
新北市,新店區,2104,671,285,956,34,990,1704,58.1%,39.38%,1
新北市,新店區,2105,687,262,949,43,992,1835,54.06%,37.44%,1
新北市,新店區,2106,734,319,1053,36,1089,2009,54.21%,36.54%,1
新北市,新店區,2107,566,207,773,39,812,1450,56%,39.03%,1
新北市,新店區,2108,668,262,930,30,960,1726,55.62%,38.7%,1
新北市,新店區,2109,650,283,933,42,975,1797,54.26%,36.17%,1
新北市,新店區,2110,652,280,932,35,967,1739,55.61%,37.49%,1
新北市,新店區,2111,601,232,833,27,860,1523,56.47%,39.46%,1
新北市,新店區,2112,622,272,894,14,908,1642,55.3%,37.88%,1
新北市,新店區,2113,618,306,924,12,936,1644,56.93%,37.59%,1
新北市,新店區,2114,598,240,838,30,868,1662,52.23%,35.98%,1
新北市,新店區,2115,792,360,1152,32,1184,2067,57.28%,38.32%,1
新北市,新店區,2116,595,263,858,29,887,1870,47.43%,31.82%,1
新北市,新店區,2117,725,317,1042,37,1079,1982,54.44%,36.58%,1
新北市,新店區,2118,803,53,856,26,882,1546,57.05%,51.94%,1
新北市,新店區,2119,706,293,999,39,1038,1712,60.63%,41.24%,1
新北市,新店區,2120,593,256,849,34,883,1423,62.05%,41.67%,1
新北市,新店區,2121,719,262,981,38,1019,1666,61.16%,43.16%,1
新北市,新店區,2122,733,332,1065,42,1107,1769,62.58%,41.44%,1
新北市,新店區,2123,377,139,516,30,546,1079,50.6%,34.94%,1
新北市,新店區,2124,467,154,621,19,640,1140,56.14%,40.96%,1
新北市,新店區,2125,676,278,954,52,1006,1825,55.12%,37.04%,1
新北市,新店區,2126,482,204,686,29,715,1178,60.7%,40.92%,1
新北市,新店區,2127,524,246,770,31,801,1463,54.75%,35.82%,1
新北市,新店區,2128,442,192,634,26,660,1152,57.29%,38.37%,1
新北市,新店區,2129,653,272,925,22,947,2008,47.16%,32.52%,1
新北市,新店區,2130,668,282,950,23,973,2120,45.9%,31.51%,1
新北市,新店區,2131,466,216,682,17,699,1153,60.62%,40.42%,1
新北市,新店區,2132,564,247,811,19,830,1573,52.77%,35.86%,1
新北市,新店區,2133,704,225,929,47,976,1992,49%,35.34%,1
新北市,新店區,2134,573,225,798,26,824,1668,49.4%,34.35%,1
新北市,新店區,2135,572,195,767,32,799,1617,49.41%,35.37%,1
新北市,新店區,2136,728,294,1022,55,1077,2013,53.5%,36.16%,1
新北市,新店區,2137,730,289,1019,32,1051,1791,58.68%,40.76%,1
新北市,新店區,2138,654,251,905,24,929,1624,57.2%,40.27%,1
新北市,新店區,2139,497,198,695,23,718,1178,60.95%,42.19%,1
新北市,新店區,2140,521,217,738,17,755,1277,59.12%,40.8%,1
新北市,新店區,2141,708,335,1043,26,1069,1879,56.89%,37.68%,1
新北市,新店區,2142,360,93,453,25,478,939,50.91%,38.34%,1
新北市,新店區,2143,340,188,528,20,548,960,57.08%,35.42%,1
新北市,新店區,2144,558,296,854,31,885,1434,61.72%,38.91%,1
新北市,新店區,2145,644,289,933,32,965,1838,52.5%,35.04%,1
新北市,新店區,2146,538,244,782,35,817,1453,56.23%,37.03%,1
新北市,新店區,2147,589,213,802,27,829,1549,53.52%,38.02%,1
新北市,新店區,2148,754,313,1067,23,1090,1860,58.6%,40.54%,1
新北市,新店區,2149,657,239,896,31,927,1743,53.18%,37.69%,1
新北市,新店區,2150,494,212,706,33,739,1122,65.86%,44.03%,1
新北市,新店區,2151,610,175,785,31,816,1468,55.59%,41.55%,1
新北市,新店區,2152,671,279,950,27,977,1763,55.42%,38.06%,1
新北市,新店區,2153,503,193,696,22,718,1344,53.42%,37.43%,1
新北市,新店區,2154,315,73,388,22,410,753,54.45%,41.83%,1
新北市,新店區,2155,223,105,328,11,339,602,56.31%,37.04%,1
新北市,新店區,2156,698,427,1125,51,1176,2237,52.57%,31.2%,1
新北市,新店區,2157,446,151,597,19,616,1096,56.2%,40.69%,1
新北市,新店區,2158,371,141,512,26,538,1143,47.07%,32.46%,1
新北市,新店區,2159,507,281,788,43,831,1569,52.96%,32.31%,1
新北市,新店區,2160,513,148,661,55,716,1284,55.76%,39.95%,1
新北市,新店區,2161,107,50,157,6,163,439,37.13%,24.37%,1
新北市,新店區,2162,275,135,410,26,436,750,58.13%,36.67%,1
新北市,樹林區,1614,496,198,694,50,744,1408,52.84%,35.23%,1
新北市,樹林區,1615,481,206,687,18,705,1310,53.82%,36.72%,1
新北市,樹林區,1616,537,185,722,38,760,1534,49.54%,35.01%,1
新北市,樹林區,1617,469,165,634,43,677,1211,55.9%,38.73%,1
新北市,樹林區,1618,446,178,624,34,658,1125,58.49%,39.64%,1
新北市,樹林區,1619,489,170,659,29,688,1134,60.67%,43.12%,1
新北市,樹林區,1620,583,253,836,63,899,1897,47.39%,30.73%,1
新北市,樹林區,1621,592,272,864,52,916,1716,53.38%,34.5%,1
新北市,樹林區,1622,299,132,431,27,458,736,62.23%,40.63%,1
新北市,樹林區,1623,473,204,677,18,695,1137,61.13%,41.6%,1
新北市,樹林區,1624,535,243,778,30,808,1542,52.4%,34.7%,1
新北市,樹林區,1625,549,223,772,43,815,1470,55.44%,37.35%,1
新北市,樹林區,1626,469,212,681,33,714,1456,49.04%,32.21%,1
新北市,樹林區,1627,460,177,637,15,652,1124,58.01%,40.93%,1
新北市,樹林區,1628,457,175,632,20,652,1235,52.79%,37%,1
新北市,樹林區,1629,452,199,651,24,675,1212,55.69%,37.29%,1
新北市,樹林區,1630,442,166,608,27,635,1223,51.92%,36.14%,1
新北市,樹林區,1631,518,170,688,48,736,1335,55.13%,38.8%,1
新北市,樹林區,1632,446,186,632,33,665,1206,55.14%,36.98%,1
新北市,樹林區,1633,460,196,656,57,713,1927,37%,23.87%,1
新北市,樹林區,1634,341,137,478,45,523,914,57.22%,37.31%,1
新北市,樹林區,1635,562,240,802,42,844,1456,57.97%,38.6%,1
新北市,樹林區,1636,518,218,736,39,775,1409,55%,36.76%,1
新北市,樹林區,1637,616,230,846,56,902,1500,60.13%,41.07%,1
新北市,樹林區,1638,553,283,836,30,866,1545,56.05%,35.79%,1
新北市,樹林區,1639,533,234,767,18,785,1483,52.93%,35.94%,1
新北市,樹林區,1640,565,254,819,34,853,1524,55.97%,37.07%,1
新北市,樹林區,1641,540,235,775,35,810,1431,56.6%,37.74%,1
新北市,樹林區,1642,461,169,630,26,656,1181,55.55%,39.03%,1
新北市,樹林區,1643,443,168,611,41,652,1116,58.42%,39.7%,1
新北市,樹林區,1644,378,160,538,28,566,1077,52.55%,35.1%,1
新北市,樹林區,1645,385,169,554,22,576,1103,52.22%,34.9%,1
新北市,樹林區,1646,502,235,737,38,775,1385,55.96%,36.25%,1
新北市,樹林區,1647,476,173,649,29,678,1266,53.55%,37.6%,1
新北市,樹林區,1648,415,191,606,47,653,1195,54.64%,34.73%,1
新北市,樹林區,1649,443,206,649,38,687,1254,54.78%,35.33%,1
新北市,樹林區,1650,455,242,697,31,728,1263,57.64%,36.03%,1
新北市,樹林區,1651,581,261,842,61,903,1473,61.3%,39.44%,1
新北市,樹林區,1652,351,122,473,30,503,870,57.82%,40.34%,1
新北市,樹林區,1653,564,214,778,44,822,1338,61.43%,42.15%,1
新北市,樹林區,1654,384,155,539,29,568,1010,56.24%,38.02%,1
新北市,樹林區,1655,614,315,929,50,979,1658,59.05%,37.03%,1
新北市,樹林區,1656,612,323,935,40,975,1538,63.39%,39.79%,1
新北市,樹林區,1657,578,259,837,51,888,1405,63.2%,41.14%,1
新北市,樹林區,1658,572,280,852,38,890,1587,56.08%,36.04%,1
新北市,樹林區,1659,575,286,861,31,892,1566,56.96%,36.72%,1
新北市,樹林區,1660,363,168,531,13,544,997,54.56%,36.41%,1
新北市,樹林區,1661,446,192,638,47,685,1187,57.71%,37.57%,1
新北市,樹林區,1662,379,165,544,37,581,1061,54.76%,35.72%,1
新北市,樹林區,1663,692,257,949,32,981,1701,57.67%,40.68%,1
新北市,樹林區,1664,484,197,681,44,725,1278,56.73%,37.87%,1
新北市,樹林區,1665,603,241,844,31,875,1433,61.06%,42.08%,1
新北市,樹林區,1666,523,244,767,40,807,1306,61.79%,40.05%,1
新北市,樹林區,1667,516,220,736,39,775,1268,61.12%,40.69%,1
新北市,樹林區,1668,503,215,718,33,751,1281,58.63%,39.27%,1
新北市,樹林區,1669,470,215,685,30,715,1200,59.58%,39.17%,1
新北市,樹林區,1670,566,207,773,32,805,1491,53.99%,37.96%,1
新北市,樹林區,1671,399,162,561,25,586,1066,54.97%,37.43%,1
新北市,樹林區,1672,393,137,530,30,560,877,63.85%,44.81%,1
新北市,樹林區,1673,612,219,831,48,879,1616,54.39%,37.87%,1
新北市,樹林區,1674,522,197,719,37,756,1589,47.58%,32.85%,1
新北市,樹林區,1675,561,200,761,34,795,1367,58.16%,41.04%,1
新北市,樹林區,1676,476,186,662,28,690,1144,60.31%,41.61%,1
新北市,樹林區,1677,428,133,561,18,579,1059,54.67%,40.42%,1
新北市,樹林區,1678,445,189,634,42,676,1224,55.23%,36.36%,1
新北市,樹林區,1679,383,171,554,28,582,1141,51.01%,33.57%,1
新北市,樹林區,1680,464,181,645,20,665,1396,47.64%,33.24%,1
新北市,樹林區,1681,407,197,604,32,636,1157,54.97%,35.18%,1
新北市,樹林區,1682,524,208,732,55,787,1498,52.54%,34.98%,1
新北市,樹林區,1683,549,228,777,57,834,1514,55.09%,36.26%,1
新北市,樹林區,1684,525,229,754,29,783,1546,50.65%,33.96%,1
新北市,樹林區,1685,520,230,750,35,785,1392,56.39%,37.36%,1
新北市,樹林區,1686,614,247,861,28,889,1566,56.77%,39.21%,1
新北市,樹林區,1687,579,263,842,18,860,1566,54.92%,36.97%,1
新北市,樹林區,1688,533,261,794,39,833,1517,54.91%,35.14%,1
新北市,樹林區,1689,555,253,808,18,826,1481,55.77%,37.47%,1
新北市,樹林區,1690,485,174,659,31,690,1261,54.72%,38.46%,1
新北市,樹林區,1691,439,155,594,21,615,1163,52.88%,37.75%,1
新北市,樹林區,1692,652,296,948,47,995,1661,59.9%,39.25%,1
新北市,樹林區,1693,595,273,868,32,900,1585,56.78%,37.54%,1
新北市,樹林區,1694,448,152,600,17,617,1018,60.61%,44.01%,1
新北市,樹林區,1695,468,182,650,55,705,1247,56.54%,37.53%,1
新北市,樹林區,1696,523,177,700,55,755,1390,54.32%,37.63%,1
新北市,樹林區,1697,515,201,716,29,745,1293,57.62%,39.83%,1
新北市,樹林區,1698,479,183,662,31,693,1301,53.27%,36.82%,1
新北市,樹林區,1699,631,191,822,33,855,1606,53.24%,39.29%,1
新北市,樹林區,1700,470,176,646,65,711,1277,55.68%,36.81%,1
新北市,樹林區,1701,456,190,646,43,689,1219,56.52%,37.41%,1
新北市,樹林區,1702,540,195,735,33,768,1454,52.82%,37.14%,1
新北市,樹林區,1703,511,169,680,21,701,1314,53.35%,38.89%,1
新北市,樹林區,1704,466,159,625,16,641,1008,63.59%,46.23%,1
新北市,樹林區,1705,570,214,784,66,850,1574,54%,36.21%,1
新北市,樹林區,1706,552,219,771,30,801,1364,58.72%,40.47%,1
新北市,樹林區,1707,590,221,811,48,859,1677,51.22%,35.18%,1
新北市,樹林區,1708,548,204,752,23,775,1683,46.05%,32.56%,1
新北市,樹林區,1709,585,221,806,39,845,1452,58.2%,40.29%,1
新北市,樹林區,1710,570,326,896,29,925,1592,58.1%,35.8%,1
新北市,樹林區,1711,628,283,911,28,939,1619,58%,38.79%,1
新北市,樹林區,1712,674,308,982,24,1006,1642,61.27%,41.05%,1
新北市,樹林區,1713,484,264,748,13,761,1357,56.08%,35.67%,1
新北市,樹林區,1714,645,233,878,69,947,1638,57.81%,39.38%,1
新北市,樹林區,1715,571,274,845,35,880,1592,55.28%,35.87%,1
新北市,樹林區,1716,626,230,856,29,885,1521,58.19%,41.16%,1
新北市,樹林區,1717,691,313,1004,31,1035,1707,60.63%,40.48%,1
新北市,樹林區,1718,615,368,983,35,1018,1741,58.47%,35.32%,1
新北市,樹林區,1719,604,306,910,19,929,1655,56.13%,36.5%,1
新北市,樹林區,1720,600,282,882,34,916,1775,51.61%,33.8%,1
新北市,樹林區,1721,729,231,960,29,989,1781,55.53%,40.93%,1
新北市,樹林區,1722,509,218,727,32,759,1565,48.5%,32.52%,1
新北市,樹林區,1723,351,133,484,20,504,936,53.85%,37.5%,1
新北市,樹林區,1724,404,169,573,23,596,1030,57.86%,39.22%,1
新北市,鶯歌區,1725,218,65,283,17,300,515,58.25%,42.33%,1
新北市,鶯歌區,1726,395,163,558,25,583,965,60.41%,40.93%,1
新北市,鶯歌區,1727,720,300,1020,44,1064,1931,55.1%,37.29%,1
新北市,鶯歌區,1728,576,282,858,38,896,1797,49.86%,32.05%,1
新北市,鶯歌區,1729,434,144,578,21,599,1057,56.67%,41.06%,1
新北市,鶯歌區,1730,347,136,483,24,507,962,52.7%,36.07%,1
新北市,鶯歌區,1731,387,176,563,24,587,934,62.85%,41.43%,1
新北市,鶯歌區,1732,700,311,1011,57,1068,1742,61.31%,40.18%,1
新北市,鶯歌區,1733,588,269,857,26,883,1634,54.04%,35.99%,1
新北市,鶯歌區,1734,615,248,863,12,875,1676,52.21%,36.69%,1
新北市,鶯歌區,1735,743,358,1101,44,1145,2052,55.8%,36.21%,1
新北市,鶯歌區,1736,591,314,905,40,945,1977,47.8%,29.89%,1
新北市,鶯歌區,1737,716,337,1053,11,1064,1957,54.37%,36.59%,1
新北市,鶯歌區,1738,324,112,436,10,446,850,52.47%,38.12%,1
新北市,鶯歌區,1739,654,219,873,41,914,1782,51.29%,36.7%,1
新北市,鶯歌區,1740,535,233,768,33,801,1496,53.54%,35.76%,1
新北市,鶯歌區,1741,726,269,995,36,1031,2071,49.78%,35.06%,1
新北市,鶯歌區,1742,549,215,764,29,793,1753,45.24%,31.32%,1
新北市,鶯歌區,1743,645,232,877,29,906,1737,52.16%,37.13%,1
新北市,鶯歌區,1744,579,226,805,45,850,1669,50.93%,34.69%,1
新北市,鶯歌區,1745,553,261,814,36,850,1842,46.15%,30.02%,1
新北市,鶯歌區,1746,500,214,714,37,751,1454,51.65%,34.39%,1
新北市,鶯歌區,1747,326,149,475,33,508,942,53.93%,34.61%,1
新北市,鶯歌區,1748,470,206,676,30,706,1317,53.61%,35.69%,1
新北市,鶯歌區,1749,356,112,468,14,482,949,50.79%,37.51%,1
新北市,鶯歌區,1750,584,230,814,31,845,1440,58.68%,40.56%,1
新北市,鶯歌區,1751,660,267,927,70,997,1809,55.11%,36.48%,1
新北市,鶯歌區,1752,677,278,955,32,987,1758,56.14%,38.51%,1
新北市,鶯歌區,1753,593,235,828,39,867,1589,54.56%,37.32%,1
新北市,鶯歌區,1754,430,188,618,21,639,1067,59.89%,40.3%,1
新北市,鶯歌區,1755,442,177,619,27,646,1092,59.16%,40.48%,1
新北市,鶯歌區,1756,712,229,941,33,974,1730,56.3%,41.16%,1
新北市,鶯歌區,1757,528,163,691,23,714,1281,55.74%,41.22%,1
新北市,鶯歌區,1758,556,188,744,32,776,1238,62.68%,44.91%,1
新北市,鶯歌區,1759,599,226,825,44,869,1568,55.42%,38.2%,1
新北市,鶯歌區,1760,498,160,658,28,686,1271,53.97%,39.18%,1
新北市,鶯歌區,1761,388,129,517,18,535,1183,45.22%,32.8%,1
新北市,鶯歌區,1762,384,122,506,17,523,1026,50.97%,37.43%,1
新北市,鶯歌區,1763,604,231,835,29,864,1721,50.2%,35.1%,1
新北市,鶯歌區,1764,475,172,647,44,691,1317,52.47%,36.07%,1
新北市,鶯歌區,1765,435,169,604,24,628,1046,60.04%,41.59%,1
新北市,鶯歌區,1766,476,182,658,35,693,1144,60.58%,41.61%,1
新北市,鶯歌區,1767,472,175,647,48,695,1336,52.02%,35.33%,1
新北市,鶯歌區,1768,530,176,706,17,723,1479,48.88%,35.84%,1
新北市,鶯歌區,1769,591,263,854,49,903,1736,52.02%,34.04%,1
新北市,鶯歌區,1770,561,205,766,40,806,1389,58.03%,40.39%,1
新北市,鶯歌區,1771,722,254,976,63,1039,1956,53.12%,36.91%,1
新北市,鶯歌區,1772,501,209,710,44,754,1371,55%,36.54%,1
新北市,鶯歌區,1773,532,186,718,20,738,1810,40.77%,29.39%,1
新北市,鶯歌區,1774,98,29,127,1,128,227,56.39%,43.17%,1
新北市,三峽區,1917,132,39,171,15,186,274,67.88%,48.18%,1
新北市,三峽區,1918,228,80,308,15,323,583,55.4%,39.11%,1
新北市,三峽區,1919,552,247,799,18,817,1765,46.29%,31.27%,1
新北市,三峽區,1920,582,277,859,47,906,1714,52.86%,33.96%,1
新北市,三峽區,1921,508,186,694,20,714,1355,52.69%,37.49%,1
新北市,三峽區,1922,523,204,727,28,755,1329,56.81%,39.35%,1
新北市,三峽區,1923,392,158,550,13,563,1059,53.16%,37.02%,1
新北市,三峽區,1924,501,244,745,40,785,1364,57.55%,36.73%,1
新北市,三峽區,1925,425,190,615,31,646,1098,58.83%,38.71%,1
新北市,三峽區,1926,483,193,676,42,718,1296,55.4%,37.27%,1
新北市,三峽區,1927,438,209,647,20,667,1240,53.79%,35.32%,1
新北市,三峽區,1928,522,265,787,27,814,1531,53.17%,34.1%,1
新北市,三峽區,1929,497,200,697,28,725,1444,50.21%,34.42%,1
新北市,三峽區,1930,480,189,669,66,735,1347,54.57%,35.63%,1
新北市,三峽區,1931,527,222,749,43,792,1455,54.43%,36.22%,1
新北市,三峽區,1932,507,208,715,23,738,1556,47.43%,32.58%,1
新北市,三峽區,1933,421,174,595,28,623,1390,44.82%,30.29%,1
新北市,三峽區,1934,565,223,788,32,820,1532,53.52%,36.88%,1
新北市,三峽區,1935,491,153,644,31,675,1377,49.02%,35.66%,1
新北市,三峽區,1936,821,50,871,28,899,1731,51.94%,47.43%,1
新北市,三峽區,1937,596,248,844,23,867,1705,50.85%,34.96%,1
新北市,三峽區,1938,567,286,853,28,881,1590,55.41%,35.66%,1
新北市,三峽區,1939,670,252,922,28,950,1650,57.58%,40.61%,1
新北市,三峽區,1940,526,257,783,16,799,1441,55.45%,36.5%,1
新北市,三峽區,1941,558,236,794,23,817,1404,58.19%,39.74%,1
新北市,三峽區,1942,499,246,745,21,766,1295,59.15%,38.53%,1
新北市,三峽區,1943,456,189,645,28,673,1348,49.93%,33.83%,1
新北市,三峽區,1944,590,276,866,8,874,1579,55.35%,37.37%,1
新北市,三峽區,1945,523,226,749,23,772,1435,53.8%,36.45%,1
新北市,三峽區,1946,664,280,944,26,970,1659,58.47%,40.02%,1
新北市,三峽區,1947,596,301,897,21,918,1512,60.71%,39.42%,1
新北市,三峽區,1948,586,244,830,23,853,1463,58.3%,40.05%,1
新北市,三峽區,1949,577,263,840,21,861,1465,58.77%,39.39%,1
新北市,三峽區,1950,587,251,838,20,858,1463,58.65%,40.12%,1
新北市,三峽區,1951,607,200,807,28,835,1443,57.87%,42.07%,1
新北市,三峽區,1952,568,226,794,39,833,1634,50.98%,34.76%,1
新北市,三峽區,1953,654,248,902,28,930,1716,54.2%,38.11%,1
新北市,三峽區,1954,614,234,848,24,872,1675,52.06%,36.66%,1
新北市,三峽區,1955,513,207,720,31,751,1649,45.54%,31.11%,1
新北市,三峽區,1956,548,204,752,35,787,1489,52.85%,36.8%,1
新北市,三峽區,1957,572,273,845,24,869,1771,49.07%,32.3%,1
新北市,三峽區,1958,602,323,925,21,946,1726,54.81%,34.88%,1
新北市,三峽區,1959,512,90,602,33,635,1363,46.59%,37.56%,1
新北市,三峽區,1960,624,250,874,21,895,1624,55.11%,38.42%,1
新北市,三峽區,1961,513,232,745,20,765,1352,56.58%,37.94%,1
新北市,三峽區,1962,459,205,664,17,681,1608,42.35%,28.54%,1
新北市,三峽區,1963,538,217,755,29,784,1458,53.77%,36.9%,1
新北市,三峽區,1964,539,236,775,29,804,1641,48.99%,32.85%,1
新北市,三峽區,1965,531,210,741,73,814,1530,53.2%,34.71%,1
新北市,三峽區,1966,466,139,605,35,640,1389,46.08%,33.55%,1
新北市,三峽區,1967,452,179,631,38,669,1315,50.87%,34.37%,1
新北市,三峽區,1968,431,107,538,32,570,934,61.03%,46.15%,1
新北市,三峽區,1969,444,164,608,32,640,1270,50.39%,34.96%,1
新北市,三峽區,1970,322,97,419,41,460,929,49.52%,34.66%,1
新北市,三峽區,1971,394,136,530,15,545,1035,52.66%,38.07%,1
新北市,三峽區,1972,178,54,232,21,253,502,50.4%,35.46%,1
新北市,三峽區,1973,307,78,385,30,415,836,49.64%,36.72%,1
新北市,三峽區,1974,222,61,283,46,329,669,49.18%,33.18%,1
新北市,三峽區,1975,284,90,374,63,437,733,59.62%,38.74%,1
新北市,三峽區,1976,662,224,886,50,936,1560,60%,42.44%,1
新北市,三峽區,1977,597,215,812,37,849,1638,51.83%,36.45%,1
新北市,三峽區,1978,549,149,698,26,724,1394,51.94%,39.38%,1
新北市,三峽區,1979,303,120,423,23,446,771,57.85%,39.3%,1
新北市,三峽區,1980,497,179,676,32,708,1367,51.79%,36.36%,1
新北市,三峽區,1981,452,147,599,48,647,1241,52.14%,36.42%,1
新北市,三峽區,1982,538,188,726,23,749,1520,49.28%,35.39%,1
新北市,三峽區,1983,400,128,528,30,558,873,63.92%,45.82%,1
新北市,三峽區,1984,258,72,330,43,373,768,48.57%,33.59%,1
新北市,三峽區,1985,387,120,507,26,533,1097,48.59%,35.28%,1
新北市,三峽區,1986,419,125,544,49,593,1322,44.86%,31.69%,1
新北市,淡水區,0029,198,71,269,23,292,544,53.68%,36.4%,1
新北市,淡水區,0030,397,140,537,48,585,1044,56.03%,38.03%,1
新北市,淡水區,0031,552,160,712,42,754,1462,51.57%,37.76%,1
新北市,淡水區,0032,538,200,738,60,798,1525,52.33%,35.28%,1
新北市,淡水區,0033,337,108,445,31,476,986,48.28%,34.18%,1
新北市,淡水區,0034,333,110,443,20,463,806,57.44%,41.32%,1
新北市,淡水區,0035,435,149,584,73,657,1173,56.01%,37.08%,1
新北市,淡水區,0036,469,148,617,36,653,1343,48.62%,34.92%,1
新北市,淡水區,0037,359,149,508,20,528,1153,45.79%,31.14%,1
新北市,淡水區,0038,307,101,408,42,450,874,51.49%,35.13%,1
新北市,淡水區,0039,412,119,531,61,592,1063,55.69%,38.76%,1
新北市,淡水區,0040,465,173,638,33,671,1309,51.26%,35.52%,1
新北市,淡水區,0041,450,194,644,49,693,1290,53.72%,34.88%,1
新北市,淡水區,0042,659,274,933,22,955,1675,57.01%,39.34%,1
新北市,淡水區,0043,562,280,842,40,882,1589,55.51%,35.37%,1
新北市,淡水區,0044,592,299,891,50,941,1624,57.94%,36.45%,1
新北市,淡水區,0045,421,214,635,27,662,1241,53.34%,33.92%,1
新北市,淡水區,0046,481,199,680,37,717,1317,54.44%,36.52%,1
新北市,淡水區,0047,479,207,686,36,722,1225,58.94%,39.1%,1
新北市,淡水區,0048,545,249,794,23,817,1426,57.29%,38.22%,1
新北市,淡水區,0049,579,322,901,20,921,1610,57.2%,35.96%,1
新北市,淡水區,0050,695,381,1076,38,1114,1982,56.21%,35.07%,1
新北市,淡水區,0051,597,274,871,37,908,1924,47.19%,31.03%,1
新北市,淡水區,0052,588,309,897,28,925,1822,50.77%,32.27%,1
新北市,淡水區,0053,469,230,699,37,736,1232,59.74%,38.07%,1
新北市,淡水區,0054,638,223,861,48,909,1588,57.24%,40.18%,1
新北市,淡水區,0055,559,318,877,25,902,1784,50.56%,31.33%,1
新北市,淡水區,0056,568,302,870,55,925,1762,52.5%,32.24%,1
新北市,淡水區,0057,511,278,789,34,823,1546,53.23%,33.05%,1
新北市,淡水區,0058,517,361,878,27,905,1897,47.71%,27.25%,1
新北市,淡水區,0059,510,263,773,34,807,1489,54.2%,34.25%,1
新北市,淡水區,0060,599,262,861,31,892,1679,53.13%,35.68%,1
新北市,淡水區,0061,521,287,808,33,841,1693,49.68%,30.77%,1
新北市,淡水區,0062,613,237,850,11,861,1674,51.43%,36.62%,1
新北市,淡水區,0063,489,226,715,15,730,1330,54.89%,36.77%,1
新北市,淡水區,0064,503,242,745,22,767,1467,52.28%,34.29%,1
新北市,淡水區,0065,686,265,951,30,981,1837,53.4%,37.34%,1
新北市,淡水區,0066,422,214,636,15,651,1924,33.84%,21.93%,1
新北市,淡水區,0067,790,380,1170,27,1197,2340,51.15%,33.76%,1
新北市,淡水區,0068,563,217,780,24,804,1704,47.18%,33.04%,1
新北市,淡水區,0069,462,232,694,26,720,1363,52.82%,33.9%,1
新北市,淡水區,0070,979,409,1388,36,1424,3068,46.41%,31.91%,1
新北市,淡水區,0071,553,181,734,31,765,1528,50.07%,36.19%,1
新北市,淡水區,0072,550,262,812,24,836,1600,52.25%,34.38%,1
新北市,淡水區,0073,720,283,1003,52,1055,1874,56.3%,38.42%,1
新北市,淡水區,0074,561,242,803,32,835,1567,53.29%,35.8%,1
新北市,淡水區,0075,422,255,677,27,704,1245,56.55%,33.9%,1
新北市,淡水區,0076,406,214,620,19,639,1211,52.77%,33.53%,1
新北市,淡水區,0077,738,346,1084,32,1116,1992,56.02%,37.05%,1
新北市,淡水區,0078,769,325,1094,33,1127,2028,55.57%,37.92%,1
新北市,淡水區,0079,560,185,745,36,781,1373,56.88%,40.79%,1
新北市,淡水區,0080,629,290,919,24,943,1732,54.45%,36.32%,1
新北市,淡水區,0081,472,256,728,38,766,1519,50.43%,31.07%,1
新北市,淡水區,0082,560,257,817,20,837,1727,48.47%,32.43%,1
新北市,淡水區,0083,501,199,700,35,735,1297,56.67%,38.63%,1
新北市,淡水區,0084,382,148,530,44,574,1066,53.85%,35.83%,1
新北市,淡水區,0085,579,181,760,36,796,1387,57.39%,41.74%,1
新北市,淡水區,0086,733,286,1019,29,1048,1909,54.9%,38.4%,1
新北市,淡水區,0087,633,290,923,34,957,1770,54.07%,35.76%,1
新北市,淡水區,0088,722,302,1024,36,1060,2049,51.73%,35.24%,1
新北市,淡水區,0089,583,302,885,19,904,1680,53.81%,34.7%,1
新北市,淡水區,0090,551,268,819,30,849,1433,59.25%,38.45%,1
新北市,淡水區,0091,472,237,709,19,728,1365,53.33%,34.58%,1
新北市,淡水區,0092,459,249,708,41,749,1452,51.58%,31.61%,1
新北市,淡水區,0093,647,282,929,33,962,1804,53.33%,35.86%,1
新北市,淡水區,0094,501,222,723,24,747,1322,56.51%,37.9%,1
新北市,淡水區,0095,693,367,1060,23,1083,2019,53.64%,34.32%,1
新北市,淡水區,0096,643,303,946,41,987,1696,58.2%,37.91%,1
新北市,淡水區,0097,567,291,858,25,883,1576,56.03%,35.98%,1
新北市,淡水區,0098,620,346,966,25,991,1781,55.64%,34.81%,1
新北市,淡水區,0099,620,314,934,39,973,1665,58.44%,37.24%,1
新北市,淡水區,0100,708,335,1043,34,1077,2013,53.5%,35.17%,1
新北市,淡水區,0101,400,179,579,19,598,1108,53.97%,36.1%,1
新北市,淡水區,0102,500,196,696,34,730,1305,55.94%,38.31%,1
新北市,淡水區,0103,463,175,638,23,661,1199,55.13%,38.62%,1
新北市,淡水區,0104,727,317,1044,29,1073,2017,53.2%,36.04%,1
新北市,淡水區,0105,676,338,1014,31,1045,2125,49.18%,31.81%,1
新北市,淡水區,0106,432,166,598,20,618,1289,47.94%,33.51%,1
新北市,淡水區,0107,546,211,757,29,786,1319,59.59%,41.39%,1
新北市,淡水區,0108,431,170,601,21,622,1051,59.18%,41.01%,1
新北市,淡水區,0109,520,207,727,20,747,1348,55.42%,38.58%,1
新北市,淡水區,0110,407,159,566,30,596,1106,53.89%,36.8%,1
新北市,淡水區,0111,301,103,404,18,422,717,58.86%,41.98%,1
新北市,淡水區,0112,498,235,733,21,754,1385,54.44%,35.96%,1
新北市,淡水區,0113,333,146,479,28,507,841,60.29%,39.6%,1
新北市,淡水區,0114,253,110,363,21,384,665,57.74%,38.05%,1
新北市,淡水區,0115,161,83,244,9,253,419,60.38%,38.42%,1
新北市,淡水區,0116,643,242,885,19,904,1599,56.54%,40.21%,1
新北市,淡水區,0117,606,238,844,43,887,1670,53.11%,36.29%,1
新北市,淡水區,0118,638,281,919,39,958,1683,56.92%,37.91%,1
新北市,淡水區,0119,554,224,778,32,810,1577,51.36%,35.13%,1
新北市,淡水區,0120,557,217,774,36,810,1618,50.06%,34.43%,1
新北市,淡水區,0121,735,296,1031,23,1054,2214,47.61%,33.2%,1
新北市,淡水區,0122,640,286,926,32,958,1832,52.29%,34.93%,1
新北市,淡水區,0123,768,319,1087,46,1133,2123,53.37%,36.18%,1
新北市,淡水區,0124,902,362,1264,26,1290,2998,43.03%,30.09%,1
新北市,汐止區,2336,583,236,819,51,870,1595,54.55%,36.55%,1
新北市,汐止區,2337,471,204,675,34,709,1262,56.18%,37.32%,1
新北市,汐止區,2338,336,153,489,52,541,917,59%,36.64%,1
新北市,汐止區,2339,686,355,1041,33,1074,1929,55.68%,35.56%,1
新北市,汐止區,2340,743,408,1151,35,1186,2227,53.26%,33.36%,1
新北市,汐止區,2341,406,191,597,50,647,1143,56.61%,35.52%,1
新北市,汐止區,2342,496,230,726,19,745,1367,54.5%,36.28%,1
新北市,汐止區,2343,105,55,160,17,177,322,54.97%,32.61%,1
新北市,汐止區,2344,530,268,798,4,802,1460,54.93%,36.3%,1
新北市,汐止區,2345,558,291,849,39,888,1719,51.66%,32.46%,1
新北市,汐止區,2346,607,242,849,42,891,1661,53.64%,36.54%,1
新北市,汐止區,2347,563,296,859,43,902,1590,56.73%,35.41%,1
新北市,汐止區,2348,582,267,849,33,882,1599,55.16%,36.4%,1
新北市,汐止區,2349,650,294,944,27,971,1749,55.52%,37.16%,1
新北市,汐止區,2350,208,126,334,22,356,1809,19.68%,11.5%,1
新北市,汐止區,2351,505,251,756,25,781,1601,48.78%,31.54%,1
新北市,汐止區,2352,488,200,688,51,739,1387,53.28%,35.18%,1
新北市,汐止區,2353,615,413,1028,55,1083,1779,60.88%,34.57%,1
新北市,汐止區,2354,776,341,1117,44,1161,2074,55.98%,37.42%,1
新北市,汐止區,2355,730,349,1079,38,1117,2072,53.91%,35.23%,1
新北市,汐止區,2356,784,403,1187,52,1239,2120,58.44%,36.98%,1
新北市,汐止區,2357,687,357,1044,37,1081,1952,55.38%,35.19%,1
新北市,汐止區,2358,576,259,835,46,881,1654,53.26%,34.82%,1
新北市,汐止區,2359,529,206,735,32,767,1444,53.12%,36.63%,1
新北市,汐止區,2360,608,325,933,32,965,1627,59.31%,37.37%,1
新北市,汐止區,2361,603,256,859,47,906,1751,51.74%,34.44%,1
新北市,汐止區,2362,683,366,1049,35,1084,2066,52.47%,33.06%,1
新北市,汐止區,2363,577,261,838,36,874,1941,45.03%,29.73%,1
新北市,汐止區,2364,567,322,889,30,919,1906,48.22%,29.75%,1
新北市,汐止區,2365,493,183,676,42,718,1363,52.68%,36.17%,1
新北市,汐止區,2366,473,204,677,28,705,1368,51.54%,34.58%,1
新北市,汐止區,2367,413,172,585,33,618,1233,50.12%,33.5%,1
新北市,汐止區,2368,554,249,803,23,826,1554,53.15%,35.65%,1
新北市,汐止區,2369,579,278,857,26,883,1700,51.94%,34.06%,1
新北市,汐止區,2370,394,225,619,13,632,1124,56.23%,35.05%,1
新北市,汐止區,2371,712,332,1044,44,1088,1900,57.26%,37.47%,1
新北市,汐止區,2372,708,339,1047,53,1100,2050,53.66%,34.54%,1
新北市,汐止區,2373,416,213,629,38,667,1244,53.62%,33.44%,1
新北市,汐止區,2374,462,190,652,21,673,1320,50.98%,35%,1
新北市,汐止區,2375,522,274,796,39,835,1473,56.69%,35.44%,1
新北市,汐止區,2376,661,285,946,45,991,1802,54.99%,36.68%,1
新北市,汐止區,2377,512,200,712,27,739,1266,58.37%,40.44%,1
新北市,汐止區,2378,503,198,701,49,750,1481,50.64%,33.96%,1
新北市,汐止區,2379,478,251,729,50,779,1497,52.04%,31.93%,1
新北市,汐止區,2380,224,77,301,18,319,556,57.37%,40.29%,1
新北市,汐止區,2381,628,293,921,41,962,1913,50.29%,32.83%,1
新北市,汐止區,2382,678,311,989,30,1019,2027,50.27%,33.45%,1
新北市,汐止區,2383,602,302,904,39,943,1927,48.94%,31.24%,1
新北市,汐止區,2384,271,89,360,28,388,696,55.75%,38.94%,1
新北市,汐止區,2385,678,331,1009,44,1053,2127,49.51%,31.88%,1
新北市,汐止區,2386,505,259,764,43,807,1642,49.15%,30.76%,1
新北市,汐止區,2387,661,286,947,52,999,1912,52.25%,34.57%,1
新北市,汐止區,2388,587,272,859,25,884,1893,46.7%,31.01%,1
新北市,汐止區,2389,466,201,667,52,719,1466,49.05%,31.79%,1
新北市,汐止區,2390,546,220,766,28,794,1538,51.63%,35.5%,1
新北市,汐止區,2391,500,240,740,45,785,1550,50.65%,32.26%,1
新北市,汐止區,2392,523,187,710,42,752,1456,51.65%,35.92%,1
新北市,汐止區,2393,417,125,542,34,576,947,60.82%,44.03%,1
新北市,汐止區,2394,326,180,506,19,525,923,56.88%,35.32%,1
新北市,汐止區,2395,711,273,984,47,1031,2043,50.47%,34.8%,1
新北市,汐止區,2396,636,271,907,58,965,2012,47.96%,31.61%,1
新北市,汐止區,2397,491,184,675,25,700,1471,47.59%,33.38%,1
新北市,汐止區,2398,536,250,786,29,815,1603,50.84%,33.44%,1
新北市,汐止區,2399,556,225,781,44,825,1530,53.92%,36.34%,1
新北市,汐止區,2400,626,234,860,25,885,1988,44.52%,31.49%,1
新北市,汐止區,2401,698,363,1061,33,1094,2198,49.77%,31.76%,1
新北市,汐止區,2402,597,239,836,38,874,1712,51.05%,34.87%,1
新北市,汐止區,2403,649,315,964,44,1008,1806,55.81%,35.94%,1
新北市,汐止區,2404,583,192,775,40,815,1576,51.71%,36.99%,1
新北市,汐止區,2405,576,203,779,19,798,1511,52.81%,38.12%,1
新北市,汐止區,2406,555,252,807,30,837,1691,49.5%,32.82%,1
新北市,汐止區,2407,603,237,840,31,871,1636,53.24%,36.86%,1
新北市,汐止區,2408,589,253,842,32,874,1676,52.15%,35.14%,1
新北市,汐止區,2409,466,181,647,18,665,1264,52.61%,36.87%,1
新北市,汐止區,2410,429,165,594,19,613,1165,52.62%,36.82%,1
新北市,汐止區,2411,608,252,860,33,893,1765,50.59%,34.45%,1
新北市,汐止區,2412,672,120,792,30,822,1815,45.29%,37.02%,1
新北市,汐止區,2413,573,271,844,48,892,1778,50.17%,32.23%,1
新北市,汐止區,2414,576,257,833,44,877,1580,55.51%,36.46%,1
新北市,汐止區,2415,526,244,770,38,808,1516,53.3%,34.7%,1
新北市,汐止區,2416,480,202,682,28,710,1425,49.82%,33.68%,1
新北市,汐止區,2417,507,226,733,32,765,1388,55.12%,36.53%,1
新北市,汐止區,2418,547,200,747,42,789,1436,54.94%,38.09%,1
新北市,汐止區,2419,513,293,806,34,840,1591,52.8%,32.24%,1
新北市,汐止區,2420,543,248,791,24,815,1639,49.73%,33.13%,1
新北市,汐止區,2421,446,242,688,21,709,1394,50.86%,31.99%,1
新北市,汐止區,2422,609,357,966,32,998,2035,49.04%,29.93%,1
新北市,汐止區,2423,694,261,955,41,996,1895,52.56%,36.62%,1
新北市,汐止區,2424,500,271,771,18,789,1374,57.42%,36.39%,1
新北市,汐止區,2425,358,240,598,29,627,1061,59.1%,33.74%,1
新北市,汐止區,2426,525,279,804,26,830,1312,63.26%,40.02%,1
新北市,汐止區,2427,577,247,824,29,853,1548,55.1%,37.27%,1
新北市,汐止區,2428,511,248,759,15,774,1350,57.33%,37.85%,1
新北市,汐止區,2429,504,287,791,27,818,1499,54.57%,33.62%,1
新北市,汐止區,2430,508,252,760,31,791,1366,57.91%,37.19%,1
新北市,汐止區,2431,501,227,728,37,765,1335,57.3%,37.53%,1
新北市,汐止區,2432,543,234,777,35,812,1324,61.33%,41.01%,1
新北市,汐止區,2433,519,228,747,39,786,1286,61.12%,40.36%,1
新北市,汐止區,2434,393,209,602,35,637,1155,55.15%,34.03%,1
新北市,汐止區,2435,696,321,1017,30,1047,1682,62.25%,41.38%,1
新北市,汐止區,2436,639,248,887,40,927,1494,62.05%,42.77%,1
新北市,汐止區,2437,473,190,663,43,706,1166,60.55%,40.57%,1
新北市,汐止區,2438,780,360,1140,73,1213,2184,55.54%,35.71%,1
新北市,汐止區,2439,760,298,1058,62,1120,2031,55.15%,37.42%,1
新北市,汐止區,2440,649,286,935,42,977,1759,55.54%,36.9%,1
新北市,汐止區,2441,566,307,873,32,905,1577,57.39%,35.89%,1
新北市,汐止區,2442,506,216,722,25,747,1364,54.77%,37.1%,1
新北市,汐止區,2443,553,223,776,46,822,1401,58.67%,39.47%,1
新北市,汐止區,2444,453,221,674,26,700,1173,59.68%,38.62%,1
新北市,汐止區,2445,378,190,568,4,572,993,57.6%,38.07%,1
新北市,汐止區,2446,553,263,816,29,845,1587,53.25%,34.85%,1
新北市,瑞芳區,2220,309,90,399,23,422,725,58.21%,42.62%,1
新北市,瑞芳區,2221,411,166,577,32,609,1074,56.7%,38.27%,1
新北市,瑞芳區,2222,312,103,415,17,432,825,52.36%,37.82%,1
新北市,瑞芳區,2223,436,201,637,40,677,1242,54.51%,35.1%,1
新北市,瑞芳區,2224,232,80,312,16,328,598,54.85%,38.8%,1
新北市,瑞芳區,2225,329,116,445,23,468,872,53.67%,37.73%,1
新北市,瑞芳區,2226,257,92,349,21,370,760,48.68%,33.82%,1
新北市,瑞芳區,2227,428,171,599,29,628,1330,47.22%,32.18%,1
新北市,瑞芳區,2228,535,217,752,40,792,1683,47.06%,31.79%,1
新北市,瑞芳區,2229,355,127,482,38,520,980,53.06%,36.22%,1
新北市,瑞芳區,2230,338,132,470,33,503,946,53.17%,35.73%,1
新北市,瑞芳區,2231,497,144,641,26,667,1375,48.51%,36.15%,1
新北市,瑞芳區,2232,587,211,798,28,826,1671,49.43%,35.13%,1
新北市,瑞芳區,2233,316,97,413,28,441,978,45.09%,32.31%,1
新北市,瑞芳區,2234,228,67,295,20,315,645,48.84%,35.35%,1
新北市,瑞芳區,2235,376,144,520,40,560,1089,51.42%,34.53%,1
新北市,瑞芳區,2236,80,34,114,9,123,286,43.01%,27.97%,1
新北市,瑞芳區,2237,169,52,221,18,239,461,51.84%,36.66%,1
新北市,瑞芳區,2238,92,24,116,21,137,274,50%,33.58%,1
新北市,瑞芳區,2239,66,24,90,6,96,155,61.94%,42.58%,1
新北市,瑞芳區,2240,308,118,426,24,450,817,55.08%,37.7%,1
新北市,瑞芳區,2241,311,130,441,24,465,884,52.6%,35.18%,1
新北市,瑞芳區,2242,417,159,576,39,615,1333,46.14%,31.28%,1
新北市,瑞芳區,2243,180,77,257,7,264,607,43.49%,29.65%,1
新北市,瑞芳區,2244,385,144,529,25,554,1045,53.01%,36.84%,1
新北市,瑞芳區,2245,245,92,337,31,368,673,54.68%,36.4%,1
新北市,瑞芳區,2246,186,60,246,10,256,618,41.42%,30.1%,1
新北市,瑞芳區,2247,345,134,479,20,499,1063,46.94%,32.46%,1
新北市,瑞芳區,2248,314,122,436,33,469,860,54.53%,36.51%,1
新北市,瑞芳區,2249,99,42,141,3,144,432,33.33%,22.92%,1
新北市,瑞芳區,2250,143,25,168,11,179,445,40.22%,32.13%,1
新北市,瑞芳區,2251,107,24,131,9,140,318,44.03%,33.65%,1
新北市,瑞芳區,2252,60,12,72,5,77,159,48.43%,37.74%,1
新北市,瑞芳區,2253,105,30,135,13,148,337,43.92%,31.16%,1
新北市,瑞芳區,2254,65,24,89,10,99,180,55%,36.11%,1
新北市,瑞芳區,2255,61,12,73,8,81,187,43.32%,32.62%,1
新北市,瑞芳區,2256,135,37,172,18,190,369,51.49%,36.59%,1
新北市,瑞芳區,2257,121,45,166,21,187,335,55.82%,36.12%,1
新北市,瑞芳區,2258,141,53,194,13,207,470,44.04%,30%,1
新北市,瑞芳區,2259,88,21,109,6,115,297,38.72%,29.63%,1
新北市,瑞芳區,2260,142,32,174,4,178,267,66.67%,53.18%,1
新北市,瑞芳區,2261,215,38,253,11,264,876,30.14%,24.54%,1
新北市,瑞芳區,2262,359,100,459,20,479,1241,38.6%,28.93%,1
新北市,瑞芳區,2263,371,122,493,35,528,998,52.91%,37.17%,1
新北市,瑞芳區,2264,370,94,464,39,503,948,53.06%,39.03%,1
新北市,瑞芳區,2265,398,98,496,25,521,1308,39.83%,30.43%,1
新北市,土城區,1775,542,225,767,39,806,1505,53.55%,36.01%,1
新北市,土城區,1776,499,222,721,29,750,1242,60.39%,40.18%,1
新北市,土城區,1777,487,205,692,24,716,1206,59.37%,40.38%,1
新北市,土城區,1778,549,228,777,40,817,1474,55.43%,37.25%,1
新北市,土城區,1779,533,201,734,36,770,1489,51.71%,35.8%,1
新北市,土城區,1780,603,226,829,33,862,1675,51.46%,36%,1
新北市,土城區,1781,543,244,787,37,824,1499,54.97%,36.22%,1
新北市,土城區,1782,554,209,763,19,782,1495,52.31%,37.06%,1
新北市,土城區,1783,516,195,711,49,760,1411,53.86%,36.57%,1
新北市,土城區,1784,472,206,678,30,708,1378,51.38%,34.25%,1
新北市,土城區,1785,459,193,652,17,669,1256,53.26%,36.54%,1
新北市,土城區,1786,526,219,745,45,790,1379,57.29%,38.14%,1
新北市,土城區,1787,513,189,702,36,738,1424,51.83%,36.03%,1
新北市,土城區,1788,545,208,753,35,788,1455,54.16%,37.46%,1
新北市,土城區,1789,514,195,709,29,738,1419,52.01%,36.22%,1
新北市,土城區,1790,552,240,792,24,816,1357,60.13%,40.68%,1
新北市,土城區,1791,540,230,770,34,804,1501,53.56%,35.98%,1
新北市,土城區,1792,498,173,671,33,704,1206,58.37%,41.29%,1
新北市,土城區,1793,491,210,701,29,730,1255,58.17%,39.12%,1
新北市,土城區,1794,667,251,918,51,969,1869,51.85%,35.69%,1
新北市,土城區,1795,606,107,713,20,733,1292,56.73%,46.9%,1
新北市,土城區,1796,498,201,699,19,718,1324,54.23%,37.61%,1
新北市,土城區,1797,415,171,586,34,620,1155,53.68%,35.93%,1
新北市,土城區,1798,442,187,629,27,656,1183,55.45%,37.36%,1
新北市,土城區,1799,352,160,512,26,538,2518,21.37%,13.98%,1
新北市,土城區,1800,448,191,639,26,665,1218,54.6%,36.78%,1
新北市,土城區,1801,465,165,630,32,662,1133,58.43%,41.04%,1
新北市,土城區,1802,359,137,496,12,508,894,56.82%,40.16%,1
新北市,土城區,1803,375,143,518,30,548,931,58.86%,40.28%,1
新北市,土城區,1804,814,286,1100,56,1156,1820,63.52%,44.73%,1
新北市,土城區,1805,547,166,713,18,731,1320,55.38%,41.44%,1
新北市,土城區,1806,445,198,643,20,663,1241,53.42%,35.86%,1
新北市,土城區,1807,528,237,765,19,784,1414,55.45%,37.34%,1
新北市,土城區,1808,506,250,756,30,786,1378,57.04%,36.72%,1
新北市,土城區,1809,522,261,783,46,829,1421,58.34%,36.73%,1
新北市,土城區,1810,510,199,709,32,741,1340,55.3%,38.06%,1
新北市,土城區,1811,435,219,654,26,680,1144,59.44%,38.02%,1
新北市,土城區,1812,482,209,691,37,728,1268,57.41%,38.01%,1
新北市,土城區,1813,473,178,651,39,690,1196,57.69%,39.55%,1
新北市,土城區,1814,518,241,759,20,779,1308,59.56%,39.6%,1
新北市,土城區,1815,470,187,657,17,674,1175,57.36%,40%,1
新北市,土城區,1816,500,171,671,34,705,1230,57.32%,40.65%,1
新北市,土城區,1817,513,215,728,39,767,1342,57.15%,38.23%,1
新北市,土城區,1818,505,212,717,32,749,1268,59.07%,39.83%,1
新北市,土城區,1819,531,201,732,49,781,1227,63.65%,43.28%,1
新北市,土城區,1820,530,195,725,54,779,1356,57.45%,39.09%,1
新北市,土城區,1821,572,229,801,39,840,1496,56.15%,38.24%,1
新北市,土城區,1822,511,190,701,44,745,1309,56.91%,39.04%,1
新北市,土城區,1823,459,207,666,34,700,1175,59.57%,39.06%,1
新北市,土城區,1824,461,202,663,40,703,1237,56.83%,37.27%,1
新北市,土城區,1825,512,191,703,23,726,1256,57.8%,40.76%,1
新北市,土城區,1826,449,205,654,18,672,1228,54.72%,36.56%,1
新北市,土城區,1827,462,183,645,32,677,1182,57.28%,39.09%,1
新北市,土城區,1828,582,269,851,23,874,1558,56.1%,37.36%,1
新北市,土城區,1829,443,206,649,21,670,1160,57.76%,38.19%,1
新北市,土城區,1830,516,232,748,20,768,1357,56.6%,38.03%,1
新北市,土城區,1831,528,242,770,42,812,1464,55.46%,36.07%,1
新北市,土城區,1832,474,207,681,22,703,1335,52.66%,35.51%,1
新北市,土城區,1833,515,195,710,45,755,1346,56.09%,38.26%,1
新北市,土城區,1834,339,504,843,24,867,1435,60.42%,23.62%,1
新北市,土城區,1835,587,286,873,35,908,1639,55.4%,35.81%,1
新北市,土城區,1836,622,342,964,23,987,1728,57.12%,36%,1
新北市,土城區,1837,501,255,756,6,762,1665,45.77%,30.09%,1
新北市,土城區,1838,549,232,781,32,813,1333,60.99%,41.19%,1
新北市,土城區,1839,619,283,902,34,936,1567,59.73%,39.5%,1
新北市,土城區,1840,573,259,832,36,868,1576,55.08%,36.36%,1
新北市,土城區,1841,542,259,801,34,835,1458,57.27%,37.17%,1
新北市,土城區,1842,577,257,834,37,871,1517,57.42%,38.04%,1
新北市,土城區,1843,585,273,858,23,881,1489,59.17%,39.29%,1
新北市,土城區,1844,535,314,849,17,866,1463,59.19%,36.57%,1
新北市,土城區,1845,619,278,897,15,912,1584,57.58%,39.08%,1
新北市,土城區,1846,517,269,786,21,807,1464,55.12%,35.31%,1
新北市,土城區,1847,584,276,860,38,898,1598,56.2%,36.55%,1
新北市,土城區,1848,502,262,764,40,804,1500,53.6%,33.47%,1
新北市,土城區,1849,554,264,818,28,846,1542,54.86%,35.93%,1
新北市,土城區,1850,596,321,917,42,959,1619,59.23%,36.81%,1
新北市,土城區,1851,555,218,773,22,795,1521,52.27%,36.49%,1
新北市,土城區,1852,561,337,898,27,925,1691,54.7%,33.18%,1
新北市,土城區,1853,554,298,852,38,890,1657,53.71%,33.43%,1
新北市,土城區,1854,626,380,1006,25,1031,1772,58.18%,35.33%,1
新北市,土城區,1855,558,239,797,16,813,1423,57.13%,39.21%,1
新北市,土城區,1856,515,260,775,34,809,1321,61.24%,38.99%,1
新北市,土城區,1857,560,275,835,40,875,1429,61.23%,39.19%,1
新北市,土城區,1858,521,236,757,23,780,1445,53.98%,36.06%,1
新北市,土城區,1859,604,261,865,25,890,1520,58.55%,39.74%,1
新北市,土城區,1860,467,226,693,9,702,1484,47.3%,31.47%,1
新北市,土城區,1861,478,228,706,20,726,1362,53.3%,35.1%,1
新北市,土城區,1862,488,191,679,22,701,1262,55.55%,38.67%,1
新北市,土城區,1863,511,238,749,27,776,1343,57.78%,38.05%,1
新北市,土城區,1864,422,216,638,22,660,1337,49.36%,31.56%,1
新北市,土城區,1865,443,163,606,19,625,1325,47.17%,33.43%,1
新北市,土城區,1866,492,190,682,30,712,1390,51.22%,35.4%,1
新北市,土城區,1867,531,262,793,38,831,1534,54.17%,34.62%,1
新北市,土城區,1868,533,208,741,50,791,1484,53.3%,35.92%,1
新北市,土城區,1869,550,248,798,0,798,1532,52.09%,35.9%,1
新北市,土城區,1870,587,232,819,35,854,1507,56.67%,38.95%,1
新北市,土城區,1871,575,269,844,31,875,1550,56.45%,37.1%,1
新北市,土城區,1872,611,230,841,25,866,1567,55.26%,38.99%,1
新北市,土城區,1873,525,239,764,18,782,1367,57.21%,38.41%,1
新北市,土城區,1874,460,183,643,52,695,1293,53.75%,35.58%,1
新北市,土城區,1875,532,233,765,26,791,1402,56.42%,37.95%,1
新北市,土城區,1876,497,231,728,35,763,1379,55.33%,36.04%,1
新北市,土城區,1877,524,231,755,27,782,1471,53.16%,35.62%,1
新北市,土城區,1878,533,201,734,21,755,1410,53.55%,37.8%,1
新北市,土城區,1879,559,256,815,21,836,1542,54.22%,36.25%,1
新北市,土城區,1880,456,195,651,32,683,1238,55.17%,36.83%,1
新北市,土城區,1881,386,193,579,21,600,1301,46.12%,29.67%,1
新北市,土城區,1882,564,253,817,21,838,1311,63.92%,43.02%,1
新北市,土城區,1883,538,208,746,20,766,1511,50.69%,35.61%,1
新北市,土城區,1884,569,213,782,36,818,1531,53.43%,37.17%,1
新北市,土城區,1885,558,267,825,33,858,1638,52.38%,34.07%,1
新北市,土城區,1886,539,221,760,30,790,1335,59.18%,40.37%,1
新北市,土城區,1887,574,209,783,23,806,1459,55.24%,39.34%,1
新北市,土城區,1888,534,255,789,17,806,1489,54.13%,35.86%,1
新北市,土城區,1889,647,285,932,42,974,1774,54.9%,36.47%,1
新北市,土城區,1890,642,303,945,36,981,1792,54.74%,35.83%,1
新北市,土城區,1891,714,277,991,44,1035,1798,57.56%,39.71%,1
新北市,土城區,1892,495,175,670,34,704,1312,53.66%,37.73%,1
新北市,土城區,1893,472,169,641,39,680,1301,52.27%,36.28%,1
新北市,土城區,1894,447,177,624,39,663,1254,52.87%,35.65%,1
新北市,土城區,1895,450,182,632,24,656,1215,53.99%,37.04%,1
新北市,土城區,1896,546,226,772,27,799,1448,55.18%,37.71%,1
新北市,土城區,1897,500,160,660,40,700,1321,52.99%,37.85%,1
新北市,土城區,1898,383,178,561,40,601,1150,52.26%,33.3%,1
新北市,土城區,1899,470,201,671,35,706,1425,49.54%,32.98%,1
新北市,土城區,1900,562,207,769,47,816,1366,59.74%,41.14%,1
新北市,土城區,1901,505,218,723,31,754,1292,58.36%,39.09%,1
新北市,土城區,1902,516,169,685,35,720,1317,54.67%,39.18%,1
新北市,土城區,1903,510,209,719,35,754,1324,56.95%,38.52%,1
新北市,土城區,1904,420,178,598,36,634,1189,53.32%,35.32%,1
新北市,土城區,1905,488,185,673,44,717,1223,58.63%,39.9%,1
新北市,土城區,1906,578,236,814,24,838,1550,54.06%,37.29%,1
新北市,土城區,1907,585,296,881,43,924,1606,57.53%,36.43%,1
新北市,土城區,1908,557,237,794,20,814,1509,53.94%,36.91%,1
新北市,土城區,1909,547,251,798,37,835,1529,54.61%,35.78%,1
新北市,土城區,1910,530,201,731,40,771,1458,52.88%,36.35%,1
新北市,土城區,1911,518,276,794,43,837,1468,57.02%,35.29%,1
新北市,土城區,1912,505,262,767,38,805,1495,53.85%,33.78%,1
新北市,土城區,1913,510,206,716,32,748,1303,57.41%,39.14%,1
新北市,土城區,1914,504,232,736,31,767,1365,56.19%,36.92%,1
新北市,土城區,1915,531,237,768,52,820,1476,55.56%,35.98%,1
新北市,土城區,1916,567,260,827,21,848,1519,55.83%,37.33%,1
新北市,蘆洲區,0555,594,288,882,38,920,1600,57.5%,37.13%,1
新北市,蘆洲區,0556,591,241,832,32,864,1549,55.78%,38.15%,1
新北市,蘆洲區,0557,575,257,832,58,890,1516,58.71%,37.93%,1
新北市,蘆洲區,0558,543,192,735,40,775,1404,55.2%,38.68%,1
新北市,蘆洲區,0559,515,201,716,46,762,1381,55.18%,37.29%,1
新北市,蘆洲區,0560,567,249,816,26,842,1485,56.7%,38.18%,1
新北市,蘆洲區,0561,469,189,658,35,693,1779,38.95%,26.36%,1
新北市,蘆洲區,0562,643,287,930,35,965,1797,53.7%,35.78%,1
新北市,蘆洲區,0563,537,226,763,28,791,1364,57.99%,39.37%,1
新北市,蘆洲區,0564,599,278,877,43,920,1635,56.27%,36.64%,1
新北市,蘆洲區,0565,522,210,732,31,763,1567,48.69%,33.31%,1
新北市,蘆洲區,0566,551,236,787,31,818,1524,53.67%,36.15%,1
新北市,蘆洲區,0567,582,220,802,27,829,1612,51.43%,36.1%,1
新北市,蘆洲區,0568,596,252,848,30,878,1674,52.45%,35.6%,1
新北市,蘆洲區,0569,601,263,864,42,906,1838,49.29%,32.7%,1
新北市,蘆洲區,0570,569,242,811,18,829,1814,45.7%,31.37%,1
新北市,蘆洲區,0571,530,253,783,31,814,1473,55.26%,35.98%,1
新北市,蘆洲區,0572,526,239,765,31,796,1465,54.33%,35.9%,1
新北市,蘆洲區,0573,610,308,918,40,958,1652,57.99%,36.92%,1
新北市,蘆洲區,0574,583,282,865,53,918,1650,55.64%,35.33%,1
新北市,蘆洲區,0575,650,236,886,34,920,1656,55.56%,39.25%,1
新北市,蘆洲區,0576,542,249,791,43,834,1571,53.09%,34.5%,1
新北市,蘆洲區,0577,518,269,787,33,820,1523,53.84%,34.01%,1
新北市,蘆洲區,0578,525,243,768,35,803,1475,54.44%,35.59%,1
新北市,蘆洲區,0579,485,212,697,34,731,1367,53.47%,35.48%,1
新北市,蘆洲區,0580,575,249,824,37,861,1514,56.87%,37.98%,1
新北市,蘆洲區,0581,675,352,1027,30,1057,1791,59.02%,37.69%,1
新北市,蘆洲區,0582,804,230,1034,10,1044,1714,60.91%,46.91%,1
新北市,蘆洲區,0583,662,342,1004,20,1024,1780,57.53%,37.19%,1
新北市,蘆洲區,0584,623,324,947,29,976,1713,56.98%,36.37%,1
新北市,蘆洲區,0585,690,274,964,25,989,1720,57.5%,40.12%,1
新北市,蘆洲區,0586,688,278,966,29,995,1766,56.34%,38.96%,1
新北市,蘆洲區,0587,610,236,846,40,886,1623,54.59%,37.58%,1
新北市,蘆洲區,0588,618,315,933,34,967,1740,55.57%,35.52%,1
新北市,蘆洲區,0589,678,313,991,29,1020,1759,57.99%,38.54%,1
新北市,蘆洲區,0590,667,323,990,44,1034,1775,58.25%,37.58%,1
新北市,蘆洲區,0591,723,340,1063,30,1093,1909,57.26%,37.87%,1
新北市,蘆洲區,0592,674,333,1007,44,1051,1805,58.23%,37.34%,1
新北市,蘆洲區,0593,573,273,846,29,875,1642,53.29%,34.9%,1
新北市,蘆洲區,0594,612,281,893,26,919,1713,53.65%,35.73%,1
新北市,蘆洲區,0595,575,278,853,40,893,1746,51.15%,32.93%,1
新北市,蘆洲區,0596,591,250,841,38,879,1596,55.08%,37.03%,1
新北市,蘆洲區,0597,517,213,730,36,766,1434,53.42%,36.05%,1
新北市,蘆洲區,0598,550,232,782,31,813,1450,56.07%,37.93%,1
新北市,蘆洲區,0599,511,266,777,22,799,1543,51.78%,33.12%,1
新北市,蘆洲區,0600,547,260,807,19,826,1525,54.16%,35.87%,1
新北市,蘆洲區,0601,465,236,701,36,737,1419,51.94%,32.77%,1
新北市,蘆洲區,0602,466,247,713,27,740,1298,57.01%,35.9%,1
新北市,蘆洲區,0603,468,205,673,37,710,1304,54.45%,35.89%,1
新北市,蘆洲區,0604,641,290,931,30,961,1806,53.21%,35.49%,1
新北市,蘆洲區,0605,668,278,946,53,999,1910,52.3%,34.97%,1
新北市,蘆洲區,0606,587,250,837,32,869,1873,46.4%,31.34%,1
新北市,蘆洲區,0607,573,260,833,45,878,1785,49.19%,32.1%,1
新北市,蘆洲區,0608,585,254,839,50,889,1760,50.51%,33.24%,1
新北市,蘆洲區,0609,690,280,970,46,1016,1841,55.19%,37.48%,1
新北市,蘆洲區,0610,621,285,906,34,940,1855,50.67%,33.48%,1
新北市,蘆洲區,0611,464,211,675,56,731,1450,50.41%,32%,1
新北市,蘆洲區,0612,545,246,791,50,841,1585,53.06%,34.38%,1
新北市,蘆洲區,0613,536,214,750,40,790,1541,51.27%,34.78%,1
新北市,蘆洲區,0614,598,254,852,36,888,1626,54.61%,36.78%,1
新北市,蘆洲區,0615,460,217,677,40,717,1241,57.78%,37.07%,1
新北市,蘆洲區,0616,594,262,856,34,890,1634,54.47%,36.35%,1
新北市,蘆洲區,0617,567,264,831,38,869,1573,55.24%,36.05%,1
新北市,蘆洲區,0618,586,301,887,33,920,1619,56.83%,36.2%,1
新北市,蘆洲區,0619,660,296,956,71,1027,1878,54.69%,35.14%,1
新北市,蘆洲區,0620,650,267,917,52,969,1797,53.92%,36.17%,1
新北市,蘆洲區,0621,667,319,986,32,1018,1816,56.06%,36.73%,1
新北市,蘆洲區,0622,530,209,739,54,793,1344,59%,39.43%,1
新北市,蘆洲區,0623,600,253,853,36,889,1492,59.58%,40.21%,1
新北市,蘆洲區,0624,728,282,1010,49,1059,1959,54.06%,37.16%,1
新北市,蘆洲區,0625,602,225,827,57,884,1611,54.87%,37.37%,1
新北市,蘆洲區,0626,598,282,880,36,916,1574,58.2%,37.99%,1
新北市,蘆洲區,0627,625,267,892,36,928,1653,56.14%,37.81%,1
新北市,蘆洲區,0628,696,328,1024,36,1060,3085,34.36%,22.56%,1
新北市,蘆洲區,0629,639,291,930,41,971,1812,53.59%,35.26%,1
新北市,蘆洲區,0630,463,234,697,36,733,1332,55.03%,34.76%,1
新北市,蘆洲區,0631,542,229,771,49,820,1648,49.76%,32.89%,1
新北市,蘆洲區,0632,481,211,692,27,719,1355,53.06%,35.5%,1
新北市,蘆洲區,0633,513,200,713,27,740,1371,53.98%,37.42%,1
新北市,蘆洲區,0634,406,200,606,42,648,1111,58.33%,36.54%,1
新北市,蘆洲區,0635,476,186,662,37,699,1176,59.44%,40.48%,1
新北市,蘆洲區,0636,576,283,859,40,899,1602,56.12%,35.96%,1
新北市,蘆洲區,0637,449,212,661,33,694,1361,50.99%,32.99%,1
新北市,蘆洲區,0638,571,220,791,42,833,1530,54.44%,37.32%,1
新北市,蘆洲區,0639,351,121,472,56,528,925,57.08%,37.95%,1
新北市,蘆洲區,0640,652,301,953,48,1001,1851,54.08%,35.22%,1
新北市,蘆洲區,0641,586,261,847,34,881,1791,49.19%,32.72%,1
新北市,蘆洲區,0642,605,285,890,37,927,1853,50.03%,32.65%,1
新北市,蘆洲區,0643,553,276,829,37,866,1758,49.26%,31.46%,1
新北市,蘆洲區,0644,610,305,915,53,968,1798,53.84%,33.93%,1
新北市,蘆洲區,0645,592,280,872,40,912,1645,55.44%,35.99%,1
新北市,蘆洲區,0646,520,253,773,24,797,1612,49.44%,32.26%,1
新北市,蘆洲區,0647,574,258,832,33,865,1784,48.49%,32.17%,1
新北市,蘆洲區,0648,530,229,759,34,793,1701,46.62%,31.16%,1
新北市,蘆洲區,0649,556,234,790,29,819,1581,51.8%,35.17%,1
新北市,蘆洲區,0650,516,295,811,35,846,1534,55.15%,33.64%,1
新北市,蘆洲區,0651,607,297,904,33,937,1620,57.84%,37.47%,1
新北市,蘆洲區,0652,596,245,841,51,892,1494,59.71%,39.89%,1
新北市,蘆洲區,0653,418,222,640,21,661,1183,55.87%,35.33%,1
新北市,蘆洲區,0654,465,73,538,33,571,985,57.97%,47.21%,1
新北市,蘆洲區,0655,572,254,826,50,876,1673,52.36%,34.19%,1
新北市,蘆洲區,0656,620,269,889,59,948,1688,56.16%,36.73%,1
新北市,蘆洲區,0657,470,187,657,28,685,1249,54.84%,37.63%,1
新北市,蘆洲區,0658,502,242,744,39,783,1476,53.05%,34.01%,1
新北市,五股區,0207,518,238,756,44,800,1456,54.95%,35.58%,1
新北市,五股區,0208,526,228,754,33,787,1482,53.1%,35.49%,1
新北市,五股區,0209,458,234,692,35,727,1287,56.49%,35.59%,1
新北市,五股區,0210,400,169,569,16,585,1106,52.89%,36.17%,1
新北市,五股區,0211,464,158,622,60,682,1283,53.16%,36.17%,1
新北市,五股區,0212,666,278,944,40,984,1833,53.68%,36.33%,1
新北市,五股區,0213,417,205,622,35,657,1141,57.58%,36.55%,1
新北市,五股區,0214,196,73,269,17,286,463,61.77%,42.33%,1
新北市,五股區,0215,709,239,948,39,987,1786,55.26%,39.7%,1
新北市,五股區,0216,575,272,847,22,869,1660,52.35%,34.64%,1
新北市,五股區,0217,546,253,799,49,848,1534,55.28%,35.59%,1
新北市,五股區,0218,509,193,702,40,742,1285,57.74%,39.61%,1
新北市,五股區,0219,645,253,898,72,970,1832,52.95%,35.21%,1
新北市,五股區,0220,577,225,802,29,831,1542,53.89%,37.42%,1
新北市,五股區,0221,632,242,874,39,913,1897,48.13%,33.32%,1
新北市,五股區,0222,614,251,865,98,963,1964,49.03%,31.26%,1
新北市,五股區,0223,589,240,829,56,885,1779,49.75%,33.11%,1
新北市,五股區,0224,637,250,887,27,914,1735,52.68%,36.71%,1
新北市,五股區,0225,726,376,1102,30,1132,2299,49.24%,31.58%,1
新北市,五股區,0226,644,199,843,26,869,1755,49.52%,36.7%,1
新北市,五股區,0227,661,224,885,31,916,1674,54.72%,39.49%,1
新北市,五股區,0228,642,232,874,46,920,1661,55.39%,38.65%,1
新北市,五股區,0229,414,207,621,20,641,1281,50.04%,32.32%,1
新北市,五股區,0230,599,228,827,25,852,1566,54.41%,38.25%,1
新北市,五股區,0231,566,196,762,27,789,1560,50.58%,36.28%,1
新北市,五股區,0232,618,240,858,26,884,1622,54.5%,38.1%,1
新北市,五股區,0233,672,265,937,21,958,1779,53.85%,37.77%,1
新北市,五股區,0234,518,217,735,39,774,1487,52.05%,34.84%,1
新北市,五股區,0235,573,254,827,34,861,1567,54.95%,36.57%,1
新北市,五股區,0236,342,170,512,26,538,1333,40.36%,25.66%,1
新北市,五股區,0237,499,230,729,33,762,1263,60.33%,39.51%,1
新北市,五股區,0238,530,91,621,47,668,1314,50.84%,40.33%,1
新北市,五股區,0239,508,247,755,26,781,1513,51.62%,33.58%,1
新北市,五股區,0240,599,225,824,37,861,1517,56.76%,39.49%,1
新北市,五股區,0241,575,256,831,45,876,1613,54.31%,35.65%,1
新北市,五股區,0242,599,230,829,44,873,1616,54.02%,37.07%,1
新北市,五股區,0243,537,273,810,56,866,1616,53.59%,33.23%,1
新北市,五股區,0244,627,242,869,50,919,1689,54.41%,37.12%,1
新北市,五股區,0245,630,326,956,30,986,1894,52.06%,33.26%,1
新北市,五股區,0246,541,195,736,27,763,1210,63.06%,44.71%,1
新北市,五股區,0247,590,228,818,29,847,1643,51.55%,35.91%,1
新北市,五股區,0248,530,219,749,25,774,1441,53.71%,36.78%,1
新北市,五股區,0249,545,189,734,22,756,1305,57.93%,41.76%,1
新北市,五股區,0250,514,188,702,21,723,1170,61.79%,43.93%,1
新北市,五股區,0251,608,193,801,53,854,1397,61.13%,43.52%,1
新北市,五股區,0252,593,180,773,36,809,1312,61.66%,45.2%,1
新北市,五股區,0253,423,126,549,26,575,1127,51.02%,37.53%,1
新北市,五股區,0254,443,137,580,22,602,1154,52.17%,38.39%,1
新北市,泰山區,0255,230,83,313,13,326,643,50.7%,35.77%,1
新北市,泰山區,0256,75,33,108,7,115,186,61.83%,40.32%,1
新北市,泰山區,0257,528,188,716,28,744,1457,51.06%,36.24%,1
新北市,泰山區,0258,607,237,844,47,891,1594,55.9%,38.08%,1
新北市,泰山區,0259,572,197,769,36,805,1598,50.38%,35.79%,1
新北市,泰山區,0260,508,239,747,28,775,1503,51.56%,33.8%,1
新北市,泰山區,0261,525,202,727,21,748,1436,52.09%,36.56%,1
新北市,泰山區,0262,531,203,734,34,768,1384,55.49%,38.37%,1
新北市,泰山區,0263,509,160,669,40,709,1231,57.6%,41.35%,1
新北市,泰山區,0264,495,173,668,21,689,1295,53.2%,38.22%,1
新北市,泰山區,0265,593,271,864,36,900,1563,57.58%,37.94%,1
新北市,泰山區,0266,653,245,898,37,935,1610,58.07%,40.56%,1
新北市,泰山區,0267,458,192,650,27,677,1253,54.03%,36.55%,1
新北市,泰山區,0268,477,164,641,26,667,1294,51.55%,36.86%,1
新北市,泰山區,0269,627,132,759,31,790,1354,58.35%,46.31%,1
新北市,泰山區,0270,461,206,667,28,695,1259,55.2%,36.62%,1
新北市,泰山區,0271,475,235,710,16,726,1252,57.99%,37.94%,1
新北市,泰山區,0272,403,161,564,25,589,1094,53.84%,36.84%,1
新北市,泰山區,0273,607,265,872,23,895,1590,56.29%,38.18%,1
新北市,泰山區,0274,626,244,870,45,915,1634,56%,38.31%,1
新北市,泰山區,0275,499,210,709,20,729,1536,47.46%,32.49%,1
新北市,泰山區,0276,601,263,864,24,888,1534,57.89%,39.18%,1
新北市,泰山區,0277,702,223,925,28,953,1545,61.68%,45.44%,1
新北市,泰山區,0278,543,208,751,32,783,1399,55.97%,38.81%,1
新北市,泰山區,0279,490,205,695,19,714,1315,54.3%,37.26%,1
新北市,泰山區,0280,486,219,705,33,738,1201,61.45%,40.47%,1
新北市,泰山區,0281,535,83,618,50,668,1182,56.51%,45.26%,1
新北市,泰山區,0282,610,242,852,34,886,1665,53.21%,36.64%,1
新北市,泰山區,0283,701,276,977,33,1010,1855,54.45%,37.79%,1
新北市,泰山區,0284,683,296,979,52,1031,1866,55.25%,36.6%,1
新北市,泰山區,0285,664,326,990,43,1033,1935,53.39%,34.32%,1
新北市,泰山區,0286,560,234,794,25,819,1589,51.54%,35.24%,1
新北市,泰山區,0287,430,164,594,22,616,1152,53.47%,37.33%,1
新北市,泰山區,0288,399,204,603,27,630,1114,56.55%,35.82%,1
新北市,泰山區,0289,438,178,616,34,650,1040,62.5%,42.12%,1
新北市,泰山區,0290,405,168,573,28,601,1003,59.92%,40.38%,1
新北市,泰山區,0291,372,208,580,16,596,975,61.13%,38.15%,1
新北市,泰山區,0292,541,204,745,42,787,1440,54.65%,37.57%,1
新北市,泰山區,0293,570,207,777,24,801,1480,54.12%,38.51%,1
新北市,泰山區,0294,480,193,673,18,691,1211,57.06%,39.64%,1
新北市,泰山區,0295,487,199,686,25,711,1237,57.48%,39.37%,1
新北市,泰山區,0296,430,148,578,27,605,1069,56.59%,40.22%,1
新北市,泰山區,0297,673,288,961,38,999,1680,59.46%,40.06%,1
新北市,泰山區,0298,646,271,917,24,941,1651,57%,39.13%,1
新北市,泰山區,0299,517,207,724,26,750,1420,52.82%,36.41%,1
新北市,泰山區,0300,533,233,766,29,795,1337,59.46%,39.87%,1
新北市,泰山區,0301,625,252,877,34,911,1591,57.26%,39.28%,1
新北市,林口區,0145,456,185,641,44,685,1268,54.02%,35.96%,1
新北市,林口區,0146,382,189,571,36,607,1171,51.84%,32.62%,1
新北市,林口區,0147,477,184,661,41,702,1218,57.64%,39.16%,1
新北市,林口區,0148,613,276,889,30,919,1788,51.4%,34.28%,1
新北市,林口區,0149,540,237,777,51,828,1625,50.95%,33.23%,1
新北市,林口區,0150,478,233,711,48,759,1448,52.42%,33.01%,1
新北市,林口區,0151,481,164,645,41,686,1328,51.66%,36.22%,1
新北市,林口區,0152,474,193,667,41,708,1523,46.49%,31.12%,1
新北市,林口區,0153,475,185,660,26,686,1245,55.1%,38.15%,1
新北市,林口區,0154,576,229,805,24,829,1329,62.38%,43.34%,1
新北市,林口區,0155,531,293,824,33,857,1465,58.5%,36.25%,1
新北市,林口區,0156,514,278,792,17,809,1369,59.09%,37.55%,1
新北市,林口區,0157,519,236,755,35,790,1346,58.69%,38.56%,1
新北市,林口區,0158,441,161,602,47,649,1181,54.95%,37.34%,1
新北市,林口區,0159,515,260,775,25,800,1291,61.97%,39.89%,1
新北市,林口區,0160,474,161,635,40,675,1213,55.65%,39.08%,1
新北市,林口區,0161,521,193,714,21,735,1256,58.52%,41.48%,1
新北市,林口區,0162,444,180,624,29,653,1185,55.11%,37.47%,1
新北市,林口區,0163,544,180,724,42,766,1361,56.28%,39.97%,1
新北市,林口區,0164,606,269,875,25,900,1756,51.25%,34.51%,1
新北市,林口區,0165,588,251,839,24,863,1676,51.49%,35.08%,1
新北市,林口區,0166,594,265,859,17,876,1540,56.88%,38.57%,1
新北市,林口區,0167,557,265,822,32,854,1569,54.43%,35.5%,1
新北市,林口區,0168,544,270,814,23,837,1514,55.28%,35.93%,1
新北市,林口區,0169,423,251,674,19,693,1193,58.09%,35.46%,1
新北市,林口區,0170,621,280,901,16,917,1610,56.96%,38.57%,1
新北市,林口區,0171,501,257,758,22,780,1338,58.3%,37.44%,1
新北市,林口區,0172,449,193,642,17,659,1141,57.76%,39.35%,1
新北市,林口區,0173,481,230,711,29,740,1307,56.62%,36.8%,1
新北市,林口區,0174,496,242,738,27,765,1327,57.65%,37.38%,1
新北市,林口區,0175,496,227,723,23,746,1285,58.05%,38.6%,1
新北市,林口區,0176,541,268,809,33,842,1481,56.85%,36.53%,1
新北市,林口區,0177,548,312,860,12,872,1510,57.75%,36.29%,1
新北市,林口區,0178,613,311,924,31,955,1785,53.5%,34.34%,1
新北市,林口區,0179,642,325,967,14,981,1792,54.74%,35.83%,1
新北市,林口區,0180,545,288,833,27,860,1517,56.69%,35.93%,1
新北市,林口區,0181,577,296,873,27,900,1564,57.54%,36.89%,1
新北市,林口區,0182,613,261,874,21,895,1560,57.37%,39.29%,1
新北市,林口區,0183,519,293,812,28,840,1544,54.4%,33.61%,1
新北市,林口區,0184,561,281,842,19,861,1593,54.05%,35.22%,1
新北市,林口區,0185,506,274,780,24,804,1431,56.18%,35.36%,1
新北市,林口區,0186,531,288,819,28,847,1571,53.91%,33.8%,1
新北市,林口區,0187,521,297,818,18,836,1439,58.1%,36.21%,1
新北市,林口區,0188,536,281,817,24,841,1451,57.96%,36.94%,1
新北市,林口區,0189,529,280,809,34,843,1391,60.6%,38.03%,1
新北市,林口區,0190,545,246,791,24,815,1461,55.78%,37.3%,1
新北市,林口區,0191,590,297,887,16,903,1691,53.4%,34.89%,1
新北市,林口區,0192,543,263,806,41,847,1524,55.58%,35.63%,1
新北市,林口區,0193,547,262,809,31,840,1343,62.55%,40.73%,1
新北市,林口區,0194,541,275,816,28,844,1398,60.37%,38.7%,1
新北市,林口區,0195,560,239,799,17,816,1380,59.13%,40.58%,1
新北市,林口區,0196,512,219,731,32,763,1367,55.82%,37.45%,1
新北市,林口區,0197,499,239,738,40,778,1350,57.63%,36.96%,1
新北市,林口區,0198,450,216,666,38,704,1194,58.96%,37.69%,1
新北市,林口區,0199,491,203,694,43,737,1344,54.84%,36.53%,1
新北市,林口區,0200,454,172,626,27,653,1154,56.59%,39.34%,1
新北市,林口區,0201,457,220,677,21,698,1119,62.38%,40.84%,1
新北市,林口區,0202,344,111,455,49,504,1026,49.12%,33.53%,1
新北市,林口區,0203,458,176,634,42,676,1210,55.87%,37.85%,1
新北市,林口區,0204,325,142,467,50,517,912,56.69%,35.64%,1
新北市,林口區,0205,318,143,461,23,484,824,58.74%,38.59%,1
新北市,林口區,0206,538,242,780,56,836,1411,59.25%,38.13%,1
新北市,深坑區,2163,406,178,584,22,606,1142,53.06%,35.55%,1
新北市,深坑區,2164,457,195,652,25,677,1139,59.44%,40.12%,1
新北市,深坑區,2165,379,159,538,40,578,1065,54.27%,35.59%,1
新北市,深坑區,2166,467,209,676,47,723,1400,51.64%,33.36%,1
新北市,深坑區,2167,448,199,647,40,687,1330,51.65%,33.68%,1
新北市,深坑區,2168,473,202,675,26,701,1380,50.8%,34.28%,1
新北市,深坑區,2169,469,231,700,20,720,1496,48.13%,31.35%,1
新北市,深坑區,2170,573,242,815,47,862,1508,57.16%,38%,1
新北市,深坑區,2171,634,270,904,31,935,1624,57.57%,39.04%,1
新北市,深坑區,2172,796,344,1140,32,1172,2165,54.13%,36.77%,1
新北市,深坑區,2173,715,319,1034,31,1065,1790,59.5%,39.94%,1
新北市,深坑區,2174,290,100,390,18,408,782,52.17%,37.08%,1
新北市,深坑區,2175,464,205,669,14,683,1164,58.68%,39.86%,1
新北市,深坑區,2176,517,238,755,49,804,1344,59.82%,38.47%,1
新北市,深坑區,2177,306,123,429,25,454,739,61.43%,41.41%,1
新北市,深坑區,2178,234,86,320,22,342,556,61.51%,42.09%,1
新北市,石碇區,2179,165,66,231,14,245,391,62.66%,42.2%,1
新北市,石碇區,2180,276,96,372,32,404,789,51.2%,34.98%,1
新北市,石碇區,2181,202,48,250,27,277,662,41.84%,30.51%,1
新北市,石碇區,2182,115,34,149,10,159,310,51.29%,37.1%,1
新北市,石碇區,2183,106,32,138,11,149,280,53.21%,37.86%,1
新北市,石碇區,2184,30,5,35,3,38,93,40.86%,32.26%,1
新北市,石碇區,2185,216,69,285,26,311,683,45.53%,31.63%,1
新北市,石碇區,2186,138,62,200,9,209,323,64.71%,42.72%,1
新北市,石碇區,2187,218,64,282,9,291,726,40.08%,30.03%,1
新北市,石碇區,2188,225,72,297,18,315,591,53.3%,38.07%,1
新北市,石碇區,2189,136,43,179,14,193,282,68.44%,48.23%,1
新北市,石碇區,2190,283,91,374,10,384,788,48.73%,35.91%,1
新北市,石碇區,2191,391,137,528,29,557,943,59.07%,41.46%,1
新北市,坪林區,2192,484,147,631,39,670,1248,53.69%,38.78%,1
新北市,坪林區,2193,199,63,262,30,292,612,47.71%,32.52%,1
新北市,坪林區,2194,461,124,585,63,648,1141,56.79%,40.4%,1
新北市,坪林區,2195,127,50,177,10,187,417,44.84%,30.46%,1
新北市,坪林區,2196,241,66,307,27,334,595,56.13%,40.5%,1
新北市,坪林區,2197,116,21,137,19,156,248,62.9%,46.77%,1
新北市,坪林區,2198,118,42,160,7,167,338,49.41%,34.91%,1
新北市,坪林區,2199,158,44,202,14,216,478,45.19%,33.05%,1
新北市,坪林區,2200,105,42,147,12,159,390,40.77%,26.92%,1
新北市,坪林區,2201,158,39,197,12,209,424,49.29%,37.26%,1
新北市,三芝區,0011,113,32,145,6,151,312,48.4%,36.22%,1
新北市,三芝區,0012,498,182,680,33,713,1421,50.18%,35.05%,1
新北市,三芝區,0013,531,231,762,42,804,1557,51.64%,34.1%,1
新北市,三芝區,0014,658,245,903,42,945,1828,51.7%,36%,1
新北市,三芝區,0015,374,137,511,32,543,1060,51.23%,35.28%,1
新北市,三芝區,0016,253,77,330,28,358,819,43.71%,30.89%,1
新北市,三芝區,0017,518,180,698,29,727,1701,42.74%,30.45%,1
新北市,三芝區,0018,586,221,807,33,840,1740,48.28%,33.68%,1
新北市,三芝區,0019,482,172,654,27,681,1451,46.93%,33.22%,1
新北市,三芝區,0020,399,134,533,43,576,1248,46.15%,31.97%,1
新北市,三芝區,0021,229,90,319,16,335,629,53.26%,36.41%,1
新北市,三芝區,0022,173,45,218,16,234,504,46.43%,34.33%,1
新北市,三芝區,0023,242,76,318,12,330,698,47.28%,34.67%,1
新北市,三芝區,0024,683,257,940,40,980,2069,47.37%,33.01%,1
新北市,三芝區,0025,256,134,390,25,415,784,52.93%,32.65%,1
新北市,三芝區,0026,186,58,244,19,263,522,50.38%,35.63%,1
新北市,三芝區,0027,220,71,291,18,309,587,52.64%,37.48%,1
新北市,三芝區,0028,407,176,583,40,623,1189,52.4%,34.23%,1
新北市,石門區,0001,372,180,552,30,582,1121,51.92%,33.18%,1
新北市,石門區,0002,460,165,625,46,671,1389,48.31%,33.12%,1
新北市,石門區,0003,362,107,469,25,494,933,52.95%,38.8%,1
新北市,石門區,0004,450,126,576,44,620,1244,49.84%,36.17%,1
新北市,石門區,0005,351,111,462,26,488,883,55.27%,39.75%,1
新北市,石門區,0006,586,209,795,50,845,1564,54.03%,37.47%,1
新北市,石門區,0007,564,193,757,42,799,1500,53.27%,37.6%,1
新北市,石門區,0008,106,36,142,9,151,328,46.04%,32.32%,1
新北市,石門區,0009,277,99,376,27,403,651,61.9%,42.55%,1
新北市,石門區,0010,287,94,381,31,412,915,45.03%,31.37%,1
新北市,八里區,0125,496,211,707,45,752,1498,50.2%,33.11%,1
新北市,八里區,0126,568,293,861,37,898,1939,46.31%,29.29%,1
新北市,八里區,0127,593,183,776,25,801,1516,52.84%,39.12%,1
新北市,八里區,0128,621,272,893,42,935,1642,56.94%,37.82%,1
新北市,八里區,0129,614,281,895,50,945,1927,49.04%,31.86%,1
新北市,八里區,0130,480,179,659,33,692,1276,54.23%,37.62%,1
新北市,八里區,0131,564,183,747,46,793,1349,58.78%,41.81%,1
新北市,八里區,0132,539,215,754,35,789,1403,56.24%,38.42%,1
新北市,八里區,0133,605,252,857,32,889,1644,54.08%,36.8%,1
新北市,八里區,0134,715,247,962,43,1005,1853,54.24%,38.59%,1
新北市,八里區,0135,718,273,991,54,1045,1793,58.28%,40.04%,1
新北市,八里區,0136,620,229,849,37,886,1644,53.89%,37.71%,1
新北市,八里區,0137,658,263,921,46,967,1846,52.38%,35.64%,1
新北市,八里區,0138,487,202,689,33,722,1346,53.64%,36.18%,1
新北市,八里區,0139,589,256,845,31,876,1621,54.04%,36.34%,1
新北市,八里區,0140,676,221,897,48,945,2110,44.79%,32.04%,1
新北市,八里區,0141,695,267,962,48,1010,1967,51.35%,35.33%,1
新北市,八里區,0142,613,235,848,50,898,1626,55.23%,37.7%,1
新北市,八里區,0143,577,199,776,58,834,1514,55.09%,38.11%,1
新北市,八里區,0144,568,199,767,70,837,1456,57.49%,39.01%,1
新北市,平溪區,2208,147,40,187,8,195,384,50.78%,38.28%,1
新北市,平溪區,2209,78,23,101,3,104,232,44.83%,33.62%,1
新北市,平溪區,2210,103,29,132,10,142,249,57.03%,41.37%,1
新北市,平溪區,2211,185,53,238,18,256,458,55.9%,40.39%,1
新北市,平溪區,2212,98,17,115,13,128,232,55.17%,42.24%,1
新北市,平溪區,2213,196,61,257,10,267,635,42.05%,30.87%,1
新北市,平溪區,2214,184,35,219,32,251,427,58.78%,43.09%,1
新北市,平溪區,2215,287,69,356,27,383,862,44.43%,33.29%,1
新北市,平溪區,2216,53,19,72,2,74,147,50.34%,36.05%,1
新北市,平溪區,2217,116,12,128,16,144,365,39.45%,31.78%,1
新北市,平溪區,2218,49,13,62,8,70,153,45.75%,32.03%,1
新北市,平溪區,2219,86,14,100,9,109,177,61.58%,48.59%,1
新北市,雙溪區,2266,159,43,202,15,217,455,47.69%,34.95%,1
新北市,雙溪區,2267,113,24,137,12,149,286,52.1%,39.51%,1
新北市,雙溪區,2268,208,54,262,15,277,496,55.85%,41.94%,1
新北市,雙溪區,2269,132,26,158,9,167,383,43.6%,34.46%,1
新北市,雙溪區,2270,286,75,361,24,385,887,43.4%,32.24%,1
新北市,雙溪區,2271,197,55,252,28,280,652,42.94%,30.21%,1
新北市,雙溪區,2272,125,32,157,11,168,333,50.45%,37.54%,1
新北市,雙溪區,2273,234,66,300,21,321,642,50%,36.45%,1
新北市,雙溪區,2274,79,47,126,11,137,282,48.58%,28.01%,1
新北市,雙溪區,2275,181,63,244,28,272,621,43.8%,29.15%,1
新北市,雙溪區,2276,124,41,165,9,174,422,41.23%,29.38%,1
新北市,雙溪區,2277,99,23,122,13,135,369,36.59%,26.83%,1
新北市,雙溪區,2278,43,19,62,4,66,120,55%,35.83%,1
新北市,雙溪區,2279,94,30,124,12,136,271,50.18%,34.69%,1
新北市,雙溪區,2280,150,51,201,12,213,362,58.84%,41.44%,1
新北市,雙溪區,2281,131,36,167,26,193,371,52.02%,35.31%,1
新北市,雙溪區,2282,467,113,580,31,611,1047,58.36%,44.6%,1
新北市,貢寮區,2283,315,87,402,37,439,876,50.11%,35.96%,1
新北市,貢寮區,2284,149,58,207,14,221,433,51.04%,34.41%,1
新北市,貢寮區,2285,164,45,209,16,225,516,43.6%,31.78%,1
新北市,貢寮區,2286,100,27,127,26,153,373,41.02%,26.81%,1
新北市,貢寮區,2287,106,32,138,13,151,313,48.24%,33.87%,1
新北市,貢寮區,2288,186,44,230,14,244,485,50.31%,38.35%,1
新北市,貢寮區,2289,137,47,184,27,211,415,50.84%,33.01%,1
新北市,貢寮區,2290,266,75,341,17,358,812,44.09%,32.76%,1
新北市,貢寮區,2291,292,108,400,17,417,861,48.43%,33.91%,1
新北市,貢寮區,2292,170,69,239,35,274,676,40.53%,25.15%,1
新北市,貢寮區,2293,295,114,409,20,429,1091,39.32%,27.04%,1
新北市,貢寮區,2294,263,87,350,39,389,955,40.73%,27.54%,1
新北市,貢寮區,2295,233,79,312,12,324,769,42.13%,30.3%,1
新北市,貢寮區,2296,312,126,438,35,473,962,49.17%,32.43%,1
新北市,貢寮區,2297,148,34,182,8,190,390,48.72%,37.95%,1
新北市,貢寮區,2298,127,28,155,8,163,349,46.7%,36.39%,1
新北市,貢寮區,2299,155,46,201,13,214,508,42.13%,30.51%,1
新北市,貢寮區,2300,115,42,157,13,170,495,34.34%,23.23%,1
新北市,金山區,2301,184,55,239,23,262,481,54.47%,38.25%,1
新北市,金山區,2302,253,94,347,33,380,715,53.15%,35.38%,1
新北市,金山區,2303,163,30,193,21,214,481,44.49%,33.89%,1
新北市,金山區,2304,633,168,801,41,842,1792,46.99%,35.32%,1
新北市,金山區,2305,644,221,865,48,913,1781,51.26%,36.16%,1
新北市,金山區,2306,742,283,1025,47,1072,2010,53.33%,36.92%,1
新北市,金山區,2307,521,199,720,51,771,1572,49.05%,33.14%,1
新北市,金山區,2308,612,246,858,51,909,1777,51.15%,34.44%,1
新北市,金山區,2309,534,198,732,49,781,1631,47.88%,32.74%,1
新北市,金山區,2310,309,104,413,25,438,828,52.9%,37.32%,1
新北市,金山區,2311,326,122,448,20,468,888,52.7%,36.71%,1
新北市,金山區,2312,413,159,572,41,613,1211,50.62%,34.1%,1
新北市,金山區,2313,179,45,224,16,240,416,57.69%,43.03%,1
新北市,金山區,2314,281,90,371,29,400,682,58.65%,41.2%,1
新北市,金山區,2315,239,68,307,43,350,644,54.35%,37.11%,1
新北市,金山區,2316,311,73,384,27,411,830,49.52%,37.47%,1
新北市,金山區,2317,72,20,92,9,101,188,53.72%,38.3%,1
新北市,金山區,2318,186,52,238,24,262,469,55.86%,39.66%,1
新北市,金山區,2319,153,40,193,28,221,582,37.97%,26.29%,1
新北市,萬里區,2320,502,164,666,33,699,1286,54.35%,39.04%,1
新北市,萬里區,2321,602,221,823,39,862,1576,54.7%,38.2%,1
新北市,萬里區,2322,520,161,681,23,704,1447,48.65%,35.94%,1
新北市,萬里區,2323,492,126,618,52,670,1466,45.7%,33.56%,1
新北市,萬里區,2324,443,120,563,26,589,1369,43.02%,32.36%,1
新北市,萬里區,2325,329,106,435,42,477,1215,39.26%,27.08%,1
新北市,萬里區,2326,515,147,662,30,692,1317,52.54%,39.1%,1
新北市,萬里區,2327,572,153,725,33,758,1676,45.23%,34.13%,1
新北市,萬里區,2328,518,159,677,64,741,1550,47.81%,33.42%,1
新北市,萬里區,2329,413,131,544,37,581,945,61.48%,43.7%,1
新北市,萬里區,2330,589,314,903,59,962,1760,54.66%,33.47%,1
新北市,萬里區,2331,225,47,272,18,290,570,50.88%,39.47%,1
新北市,萬里區,2332,342,103,445,33,478,952,50.21%,35.92%,1
新北市,萬里區,2333,293,63,356,41,397,674,58.9%,43.47%,1
新北市,萬里區,2334,140,55,195,17,212,405,52.35%,34.57%,1
新北市,萬里區,2335,400,109,509,42,551,1089,50.6%,36.73%,1
新北市,烏來區,2202,695,225,920,34,954,1568,60.84%,44.32%,1
新北市,烏來區,2203,421,172,593,11,604,1198,50.42%,35.14%,1
新北市,烏來區,2204,451,131,582,24,606,1169,51.84%,38.58%,1
新北市,烏來區,2205,94,30,124,2,126,228,55.26%,41.23%,1
新北市,烏來區,2206,220,42,262,16,278,486,57.2%,45.27%,1
新北市,烏來區,2207,237,72,309,13,322,615,52.36%,38.54%,1
桃園市,桃園區,0001,554,217,771,34,805,1593,50.53%,34.78%,1
桃園市,桃園區,0002,583,245,828,26,854,1934,44.16%,30.14%,1
桃園市,桃園區,0003,623,243,866,48,914,1661,55.03%,37.51%,1
桃園市,桃園區,0004,479,188,667,19,686,1448,47.38%,33.08%,1
桃園市,桃園區,0005,637,285,922,37,959,1974,48.58%,32.27%,1
桃園市,桃園區,0006,606,225,831,41,872,1882,46.33%,32.2%,1
桃園市,桃園區,0007,558,301,859,29,888,1800,49.33%,31%,1
桃園市,桃園區,0008,604,267,871,32,903,1598,56.51%,37.8%,1
桃園市,桃園區,0009,500,217,717,55,772,1626,47.48%,30.75%,1
桃園市,桃園區,0010,538,236,774,38,812,1590,51.07%,33.84%,1
桃園市,桃園區,0011,541,260,801,38,839,1637,51.25%,33.05%,1
桃園市,桃園區,0012,643,272,915,42,957,1943,49.25%,33.09%,1
桃園市,桃園區,0013,512,233,745,33,778,1482,52.5%,34.55%,1
桃園市,桃園區,0014,534,221,755,31,786,1423,55.24%,37.53%,1
桃園市,桃園區,0015,491,315,806,28,834,1509,55.27%,32.54%,1
桃園市,桃園區,0016,588,241,829,22,851,1567,54.31%,37.52%,1
桃園市,桃園區,0017,491,195,686,29,715,1305,54.79%,37.62%,1
桃園市,桃園區,0018,478,192,670,28,698,1416,49.29%,33.76%,1
桃園市,桃園區,0019,543,242,785,25,810,1439,56.29%,37.73%,1
桃園市,桃園區,0020,528,219,747,41,788,1399,56.33%,37.74%,1
桃園市,桃園區,0021,574,256,830,33,863,1540,56.04%,37.27%,1
桃園市,桃園區,0022,555,231,786,21,807,1638,49.27%,33.88%,1
桃園市,桃園區,0023,444,201,645,24,669,1228,54.48%,36.16%,1
桃園市,桃園區,0024,576,222,798,31,829,1649,50.27%,34.93%,1
桃園市,桃園區,0025,579,227,806,34,840,1601,52.47%,36.16%,1
桃園市,桃園區,0026,490,226,716,44,760,1477,51.46%,33.18%,1
桃園市,桃園區,0027,581,217,798,26,824,1503,54.82%,38.66%,1
桃園市,桃園區,0028,514,242,756,45,801,1375,58.25%,37.38%,1
桃園市,桃園區,0029,663,248,911,35,946,1743,54.27%,38.04%,1
桃園市,桃園區,0030,637,248,885,29,914,1862,49.09%,34.21%,1
桃園市,桃園區,0031,606,270,876,30,906,1728,52.43%,35.07%,1
桃園市,桃園區,0032,232,116,348,17,365,690,52.9%,33.62%,1
桃園市,桃園區,0033,345,145,490,26,516,852,60.56%,40.49%,1
桃園市,桃園區,0034,516,236,752,37,789,1353,58.31%,38.14%,1
桃園市,桃園區,0035,478,188,666,18,684,1698,40.28%,28.15%,1
桃園市,桃園區,0036,478,224,702,40,742,1452,51.1%,32.92%,1
桃園市,桃園區,0037,597,250,847,36,883,1681,52.53%,35.51%,1
桃園市,桃園區,0038,570,277,847,34,881,1669,52.79%,34.15%,1
桃園市,桃園區,0039,598,268,866,21,887,1530,57.97%,39.08%,1
桃園市,桃園區,0040,530,302,832,35,867,1582,54.8%,33.5%,1
桃園市,桃園區,0041,524,209,733,30,763,1587,48.08%,33.02%,1
桃園市,桃園區,0042,545,227,772,34,806,1451,55.55%,37.56%,1
桃園市,桃園區,0043,498,217,715,23,738,1582,46.65%,31.48%,1
桃園市,桃園區,0044,369,182,551,34,585,1028,56.91%,35.89%,1
桃園市,桃園區,0045,682,247,929,37,966,1934,49.95%,35.26%,1
桃園市,桃園區,0046,394,137,531,32,563,1016,55.41%,38.78%,1
桃園市,桃園區,0047,383,178,561,20,581,1079,53.85%,35.5%,1
桃園市,桃園區,0048,628,255,883,16,899,1837,48.94%,34.19%,1
桃園市,桃園區,0049,536,189,725,38,763,1390,54.89%,38.56%,1
桃園市,桃園區,0050,538,233,771,25,796,1489,53.46%,36.13%,1
桃園市,桃園區,0051,656,315,971,18,989,1821,54.31%,36.02%,1
桃園市,桃園區,0052,531,225,756,16,772,1563,49.39%,33.97%,1
桃園市,桃園區,0053,600,298,898,24,922,1697,54.33%,35.36%,1
桃園市,桃園區,0054,648,266,914,26,940,1740,54.02%,37.24%,1
桃園市,桃園區,0055,606,227,833,30,863,1626,53.08%,37.27%,1
桃園市,桃園區,0056,481,203,684,14,698,1239,56.34%,38.82%,1
桃園市,桃園區,0057,625,279,904,22,926,1766,52.43%,35.39%,1
桃園市,桃園區,0058,588,226,814,28,842,1555,54.15%,37.81%,1
桃園市,桃園區,0059,636,295,931,29,960,1831,52.43%,34.74%,1
桃園市,桃園區,0060,475,168,643,28,671,1115,60.18%,42.6%,1
桃園市,桃園區,0061,561,275,836,28,864,1562,55.31%,35.92%,1
桃園市,桃園區,0062,637,233,870,28,898,1744,51.49%,36.53%,1
桃園市,桃園區,0063,583,267,850,18,868,1838,47.23%,31.72%,1
桃園市,桃園區,0064,688,311,999,35,1034,1889,54.74%,36.42%,1
桃園市,桃園區,0065,610,290,900,44,944,1985,47.56%,30.73%,1
桃園市,桃園區,0066,598,245,843,30,873,1524,57.28%,39.24%,1
桃園市,桃園區,0067,615,236,851,23,874,1425,61.33%,43.16%,1
桃園市,桃園區,0068,616,280,896,27,923,1606,57.47%,38.36%,1
桃園市,桃園區,0069,832,252,1084,16,1100,2056,53.5%,40.47%,1
桃園市,桃園區,0070,745,331,1076,32,1108,2010,55.12%,37.06%,1
桃園市,桃園區,0071,749,321,1070,40,1110,2245,49.44%,33.36%,1
桃園市,桃園區,0072,534,284,818,27,845,1590,53.14%,33.58%,1
桃園市,桃園區,0073,594,299,893,19,912,1536,59.38%,38.67%,1
桃園市,桃園區,0074,619,295,914,34,948,1949,48.64%,31.76%,1
桃園市,桃園區,0075,661,272,933,42,975,1965,49.62%,33.64%,1
桃園市,桃園區,0076,734,307,1041,44,1085,2414,44.95%,30.41%,1
桃園市,桃園區,0077,687,266,953,36,989,1942,50.93%,35.38%,1
桃園市,桃園區,0078,764,300,1064,49,1113,2156,51.62%,35.44%,1
桃園市,桃園區,0079,523,221,744,47,791,1404,56.34%,37.25%,1
桃園市,桃園區,0080,498,205,703,25,728,1194,60.97%,41.71%,1
桃園市,桃園區,0081,533,249,782,54,836,1449,57.69%,36.78%,1
桃園市,桃園區,0082,584,238,822,54,876,1803,48.59%,32.39%,1
桃園市,桃園區,0083,602,267,869,30,899,1692,53.13%,35.58%,1
桃園市,桃園區,0084,680,301,981,23,1004,1913,52.48%,35.55%,1
桃園市,桃園區,0085,651,264,915,32,947,1815,52.18%,35.87%,1
桃園市,桃園區,0086,399,157,556,33,589,1173,50.21%,34.02%,1
桃園市,桃園區,0087,423,152,575,21,596,1162,51.29%,36.4%,1
桃園市,桃園區,0088,387,124,511,44,555,1194,46.48%,32.41%,1
桃園市,桃園區,0089,598,273,871,35,906,1695,53.45%,35.28%,1
桃園市,桃園區,0090,587,295,882,30,912,1797,50.75%,32.67%,1
桃園市,桃園區,0091,579,217,796,27,823,1592,51.7%,36.37%,1
桃園市,桃園區,0092,630,228,858,42,900,1780,50.56%,35.39%,1
桃園市,桃園區,0093,586,272,858,18,876,1904,46.01%,30.78%,1
桃園市,桃園區,0094,667,304,971,29,1000,2021,49.48%,33%,1
桃園市,桃園區,0095,593,181,774,28,802,1545,51.91%,38.38%,1
桃園市,桃園區,0096,554,204,758,27,785,1617,48.55%,34.26%,1
桃園市,桃園區,0097,591,246,837,20,857,1683,50.92%,35.12%,1
桃園市,桃園區,0098,709,253,962,42,1004,1834,54.74%,38.66%,1
桃園市,桃園區,0099,645,300,945,36,981,2055,47.74%,31.39%,1
桃園市,桃園區,0100,624,265,889,14,903,1828,49.4%,34.14%,1
桃園市,桃園區,0101,639,281,920,27,947,1873,50.56%,34.12%,1
桃園市,桃園區,0102,550,191,741,22,763,3687,20.69%,14.92%,1
桃園市,桃園區,0103,671,267,938,28,966,1850,52.22%,36.27%,1
桃園市,桃園區,0104,640,260,900,27,927,1827,50.74%,35.03%,1
桃園市,桃園區,0105,506,167,673,22,695,1149,60.49%,44.04%,1
桃園市,桃園區,0106,434,160,594,35,629,1061,59.28%,40.9%,1
桃園市,桃園區,0107,556,273,829,38,867,1831,47.35%,30.37%,1
桃園市,桃園區,0108,706,332,1038,34,1072,2168,49.45%,32.56%,1
桃園市,桃園區,0109,610,304,914,8,922,1874,49.2%,32.55%,1
桃園市,桃園區,0110,472,218,690,15,705,1524,46.26%,30.97%,1
桃園市,桃園區,0111,525,271,796,15,811,1528,53.08%,34.36%,1
桃園市,桃園區,0112,513,268,781,24,805,1489,54.06%,34.45%,1
桃園市,桃園區,0113,449,191,640,40,680,1308,51.99%,34.33%,1
桃園市,桃園區,0114,567,215,782,35,817,1583,51.61%,35.82%,1
桃園市,桃園區,0115,601,254,855,32,887,1618,54.82%,37.14%,1
桃園市,桃園區,0116,689,317,1006,39,1045,2127,49.13%,32.39%,1
桃園市,桃園區,0117,659,307,966,22,988,2033,48.6%,32.42%,1
桃園市,桃園區,0118,630,302,932,23,955,2098,45.52%,30.03%,1
桃園市,桃園區,0119,798,311,1109,42,1151,2126,54.14%,37.54%,1
桃園市,桃園區,0120,655,257,912,33,945,1917,49.3%,34.17%,1
桃園市,桃園區,0121,647,310,957,22,979,1997,49.02%,32.4%,1
桃園市,桃園區,0122,688,306,994,29,1023,1929,53.03%,35.67%,1
桃園市,桃園區,0123,537,293,830,29,859,1691,50.8%,31.76%,1
桃園市,桃園區,0124,632,308,940,20,960,1900,50.53%,33.26%,1
桃園市,桃園區,0125,621,270,891,42,933,1761,52.98%,35.26%,1
桃園市,桃園區,0126,658,371,1029,19,1048,1922,54.53%,34.24%,1
桃園市,桃園區,0127,699,255,954,42,996,1995,49.92%,35.04%,1
桃園市,桃園區,0128,410,158,568,22,590,1063,55.5%,38.57%,1
桃園市,桃園區,0129,493,209,702,31,733,1412,51.91%,34.92%,1
桃園市,桃園區,0130,602,329,931,21,952,1746,54.52%,34.48%,1
桃園市,桃園區,0131,523,255,778,37,815,1689,48.25%,30.97%,1
桃園市,桃園區,0132,592,189,781,17,798,1542,51.75%,38.39%,1
桃園市,桃園區,0133,498,190,688,35,723,1437,50.31%,34.66%,1
桃園市,桃園區,0134,610,242,852,19,871,1679,51.88%,36.33%,1
桃園市,桃園區,0135,583,258,841,34,875,1886,46.39%,30.91%,1
桃園市,桃園區,0136,583,270,853,38,891,1657,53.77%,35.18%,1
桃園市,桃園區,0137,503,216,719,15,734,1349,54.41%,37.29%,1
桃園市,桃園區,0138,648,272,920,23,943,1805,52.24%,35.9%,1
桃園市,桃園區,0139,628,266,894,48,942,1846,51.03%,34.02%,1
桃園市,桃園區,0140,533,221,754,26,780,1644,47.45%,32.42%,1
桃園市,桃園區,0141,539,242,781,28,809,1674,48.33%,32.2%,1
桃園市,桃園區,0142,577,275,852,28,880,1737,50.66%,33.22%,1
桃園市,桃園區,0143,575,238,813,38,851,1566,54.34%,36.72%,1
桃園市,桃園區,0144,524,262,786,26,812,1517,53.53%,34.54%,1
桃園市,桃園區,0145,478,253,731,27,758,1619,46.82%,29.52%,1
桃園市,桃園區,0146,578,299,877,28,905,1774,51.01%,32.58%,1
桃園市,桃園區,0147,582,265,847,21,868,1666,52.1%,34.93%,1
桃園市,桃園區,0148,540,244,784,15,799,1528,52.29%,35.34%,1
桃園市,桃園區,0149,562,278,840,30,870,1709,50.91%,32.88%,1
桃園市,桃園區,0150,540,300,840,25,865,1719,50.32%,31.41%,1
桃園市,桃園區,0151,486,213,699,34,733,1569,46.72%,30.98%,1
桃園市,桃園區,0152,516,210,726,23,749,1505,49.77%,34.29%,1
桃園市,桃園區,0153,524,214,738,27,765,1496,51.14%,35.03%,1
桃園市,桃園區,0154,544,236,780,23,803,1505,53.36%,36.15%,1
桃園市,桃園區,0155,601,292,893,19,912,1807,50.47%,33.26%,1
桃園市,桃園區,0156,637,285,922,28,950,1857,51.16%,34.3%,1
桃園市,桃園區,0157,624,231,855,40,895,1589,56.32%,39.27%,1
桃園市,桃園區,0158,705,334,1039,22,1061,2088,50.81%,33.76%,1
桃園市,桃園區,0159,618,308,926,27,953,1893,50.34%,32.65%,1
桃園市,桃園區,0160,414,154,568,24,592,1303,45.43%,31.77%,1
桃園市,桃園區,0161,489,238,727,30,757,1416,53.46%,34.53%,1
桃園市,桃園區,0162,454,190,644,23,667,1351,49.37%,33.6%,1
桃園市,桃園區,0163,539,265,804,15,819,1659,49.37%,32.49%,1
桃園市,桃園區,0164,734,262,996,16,1012,2103,48.12%,34.9%,1
桃園市,桃園區,0165,661,282,943,21,964,1943,49.61%,34.02%,1
桃園市,桃園區,0166,621,323,944,36,980,1927,50.86%,32.23%,1
桃園市,桃園區,0167,612,233,845,34,879,1929,45.57%,31.73%,1
桃園市,桃園區,0168,824,393,1217,22,1239,2204,56.22%,37.39%,1
桃園市,桃園區,0169,566,349,915,17,932,2033,45.84%,27.84%,1
桃園市,桃園區,0170,568,249,817,16,833,1656,50.3%,34.3%,1
桃園市,桃園區,0171,556,273,829,41,870,1712,50.82%,32.48%,1
桃園市,桃園區,0172,568,291,859,19,878,1738,50.52%,32.68%,1
桃園市,桃園區,0173,590,261,851,16,867,1432,60.54%,41.2%,1
桃園市,桃園區,0174,529,263,792,31,823,1421,57.92%,37.23%,1
桃園市,桃園區,0175,463,222,685,18,703,1344,52.31%,34.45%,1
桃園市,桃園區,0176,595,286,881,22,903,1942,46.5%,30.64%,1
桃園市,桃園區,0177,680,298,978,28,1006,2001,50.27%,33.98%,1
桃園市,桃園區,0178,575,296,871,18,889,1941,45.8%,29.62%,1
桃園市,桃園區,0179,590,305,895,25,920,1702,54.05%,34.67%,1
桃園市,桃園區,0180,516,275,791,26,817,1589,51.42%,32.47%,1
桃園市,桃園區,0181,540,237,777,20,797,1544,51.62%,34.97%,1
桃園市,桃園區,0182,577,220,797,24,821,1860,44.14%,31.02%,1
桃園市,桃園區,0183,586,239,825,44,869,1726,50.35%,33.95%,1
桃園市,桃園區,0184,599,247,846,23,869,1798,48.33%,33.31%,1
桃園市,桃園區,0185,651,312,963,25,988,1925,51.32%,33.82%,1
桃園市,桃園區,0186,626,336,962,18,980,1945,50.39%,32.19%,1
桃園市,桃園區,0187,561,244,805,29,834,1764,47.28%,31.8%,1
桃園市,桃園區,0188,747,240,987,49,1036,1899,54.56%,39.34%,1
桃園市,桃園區,0189,516,203,719,15,734,1415,51.87%,36.47%,1
桃園市,桃園區,0190,575,259,834,22,856,1790,47.82%,32.12%,1
桃園市,桃園區,0191,645,164,809,15,824,1693,48.67%,38.1%,1
桃園市,桃園區,0192,649,265,914,34,948,1916,49.48%,33.87%,1
桃園市,桃園區,0193,443,222,665,18,683,1434,47.63%,30.89%,1
桃園市,桃園區,0194,532,269,801,37,838,1494,56.09%,35.61%,1
桃園市,桃園區,0195,483,189,672,49,721,1311,55%,36.84%,1
桃園市,桃園區,0196,542,220,762,25,787,1476,53.32%,36.72%,1
桃園市,桃園區,0197,519,287,806,28,834,1484,56.2%,34.97%,1
桃園市,桃園區,0198,536,233,769,22,791,1514,52.25%,35.4%,1
桃園市,桃園區,0199,546,184,730,37,767,1446,53.04%,37.76%,1
桃園市,桃園區,0200,540,212,752,33,785,1573,49.9%,34.33%,1
桃園市,桃園區,0201,498,200,698,30,728,1564,46.55%,31.84%,1
桃園市,桃園區,0202,383,168,551,23,574,1015,56.55%,37.73%,1
桃園市,桃園區,0203,326,145,471,22,493,955,51.62%,34.14%,1
桃園市,桃園區,0204,598,277,875,29,904,1796,50.33%,33.3%,1
桃園市,桃園區,0205,505,298,803,14,817,1878,43.5%,26.89%,1
桃園市,桃園區,0206,575,253,828,23,851,1729,49.22%,33.26%,1
桃園市,桃園區,0207,580,251,831,16,847,1843,45.96%,31.47%,1
桃園市,桃園區,0208,523,243,766,19,785,1817,43.2%,28.78%,1
桃園市,桃園區,0209,396,134,530,25,555,979,56.69%,40.45%,1
桃園市,桃園區,0210,497,222,719,13,732,1363,53.71%,36.46%,1
桃園市,桃園區,0211,543,241,784,12,796,1546,51.49%,35.12%,1
桃園市,桃園區,0212,432,212,644,18,662,1308,50.61%,33.03%,1
桃園市,桃園區,0213,742,296,1038,32,1070,2164,49.45%,34.29%,1
桃園市,桃園區,0214,627,314,941,34,975,2020,48.27%,31.04%,1
桃園市,桃園區,0215,588,243,831,31,862,1924,44.8%,30.56%,1
桃園市,桃園區,0216,641,234,875,31,906,2088,43.39%,30.7%,1
桃園市,中壢區,0591,537,193,730,15,745,1401,53.18%,38.33%,1
桃園市,中壢區,0592,602,261,863,38,901,1798,50.11%,33.48%,1
桃園市,中壢區,0593,513,229,742,32,774,1642,47.14%,31.24%,1
桃園市,中壢區,0594,622,244,866,24,890,1670,53.29%,37.25%,1
桃園市,中壢區,0595,560,229,789,20,809,1456,55.56%,38.46%,1
桃園市,中壢區,0596,644,248,892,25,917,1531,59.9%,42.06%,1
桃園市,中壢區,0597,689,227,916,22,938,1623,57.79%,42.45%,1
桃園市,中壢區,0598,664,116,780,22,802,1953,41.07%,34%,1
桃園市,中壢區,0599,468,174,642,19,661,1155,57.23%,40.52%,1
桃園市,中壢區,0600,620,207,827,22,849,1800,47.17%,34.44%,1
桃園市,中壢區,0601,599,233,832,18,850,1757,48.38%,34.09%,1
桃園市,中壢區,0602,578,157,735,26,761,1281,59.41%,45.12%,1
桃園市,中壢區,0603,589,223,812,19,831,1462,56.84%,40.29%,1
桃園市,中壢區,0604,571,168,739,37,776,1560,49.74%,36.6%,1
桃園市,中壢區,0605,681,230,911,17,928,1602,57.93%,42.51%,1
桃園市,中壢區,0606,480,143,623,24,647,1006,64.31%,47.71%,1
桃園市,中壢區,0607,638,214,852,23,875,1474,59.36%,43.28%,1
桃園市,中壢區,0608,693,187,880,26,906,1627,55.69%,42.59%,1
桃園市,中壢區,0609,618,214,832,27,859,1519,56.55%,40.68%,1
桃園市,中壢區,0610,612,179,791,48,839,1526,54.98%,40.1%,1
桃園市,中壢區,0611,632,206,838,35,873,1618,53.96%,39.06%,1
桃園市,中壢區,0612,661,206,867,37,904,1554,58.17%,42.54%,1
桃園市,中壢區,0613,677,190,867,66,933,1706,54.69%,39.68%,1
桃園市,中壢區,0614,735,257,992,41,1033,1818,56.82%,40.43%,1
桃園市,中壢區,0615,722,249,971,26,997,1991,50.08%,36.26%,1
桃園市,中壢區,0616,644,192,836,22,858,1609,53.33%,40.02%,1
桃園市,中壢區,0617,499,144,643,19,662,1329,49.81%,37.55%,1
桃園市,中壢區,0618,567,189,756,40,796,1587,50.16%,35.73%,1
桃園市,中壢區,0619,724,269,993,14,1007,1955,51.51%,37.03%,1
桃園市,中壢區,0620,619,240,859,32,891,1711,52.07%,36.18%,1
桃園市,中壢區,0621,640,214,854,23,877,1712,51.23%,37.38%,1
桃園市,中壢區,0622,602,204,806,29,835,1448,57.67%,41.57%,1
桃園市,中壢區,0623,587,206,793,30,823,1605,51.28%,36.57%,1
桃園市,中壢區,0624,574,195,769,16,785,1633,48.07%,35.15%,1
桃園市,中壢區,0625,728,252,980,41,1021,1795,56.88%,40.56%,1
桃園市,中壢區,0626,703,198,901,18,919,1689,54.41%,41.62%,1
桃園市,中壢區,0627,488,166,654,19,673,1201,56.04%,40.63%,1
桃園市,中壢區,0628,498,207,705,21,726,1353,53.66%,36.81%,1
桃園市,中壢區,0629,568,210,778,18,796,1587,50.16%,35.79%,1
桃園市,中壢區,0630,713,252,965,28,993,1883,52.73%,37.87%,1
桃園市,中壢區,0631,512,225,737,15,752,1448,51.93%,35.36%,1
桃園市,中壢區,0632,646,289,935,31,966,1810,53.37%,35.69%,1
桃園市,中壢區,0633,688,258,946,39,985,1916,51.41%,35.91%,1
桃園市,中壢區,0634,512,143,655,26,681,1177,57.86%,43.5%,1
桃園市,中壢區,0635,608,207,815,32,847,1410,60.07%,43.12%,1
桃園市,中壢區,0636,514,202,716,15,731,1368,53.44%,37.57%,1
桃園市,中壢區,0637,617,226,843,26,869,1424,61.03%,43.33%,1
桃園市,中壢區,0638,610,251,861,19,880,1573,55.94%,38.78%,1
桃園市,中壢區,0639,457,183,640,21,661,1152,57.38%,39.67%,1
桃園市,中壢區,0640,476,188,664,14,678,1178,57.56%,40.41%,1
桃園市,中壢區,0641,724,283,1007,36,1043,1966,53.05%,36.83%,1
桃園市,中壢區,0642,494,200,694,26,720,3474,20.73%,14.22%,1
桃園市,中壢區,0643,755,341,1096,39,1135,2099,54.07%,35.97%,1
桃園市,中壢區,0644,446,183,629,25,654,1178,55.52%,37.86%,1
桃園市,中壢區,0645,578,240,818,35,853,1397,61.06%,41.37%,1
桃園市,中壢區,0646,622,264,886,39,925,1669,55.42%,37.27%,1
桃園市,中壢區,0647,595,402,997,29,1026,2087,49.16%,28.51%,1
桃園市,中壢區,0648,687,250,937,40,977,1900,51.42%,36.16%,1
桃園市,中壢區,0649,489,214,703,22,725,1640,44.21%,29.82%,1
桃園市,中壢區,0650,434,138,572,22,594,994,59.76%,43.66%,1
桃園市,中壢區,0651,529,156,685,41,726,1131,64.19%,46.77%,1
桃園市,中壢區,0652,655,260,915,38,953,1625,58.65%,40.31%,1
桃園市,中壢區,0653,600,229,829,30,859,1384,62.07%,43.35%,1
桃園市,中壢區,0654,605,233,838,31,869,1588,54.72%,38.1%,1
桃園市,中壢區,0655,601,163,764,23,787,1445,54.46%,41.59%,1
桃園市,中壢區,0656,615,168,783,31,814,1743,46.7%,35.28%,1
桃園市,中壢區,0657,632,208,840,20,860,1812,47.46%,34.88%,1
桃園市,中壢區,0658,559,203,762,29,791,1546,51.16%,36.16%,1
桃園市,中壢區,0659,512,145,657,31,688,1290,53.33%,39.69%,1
桃園市,中壢區,0660,782,217,999,48,1047,2145,48.81%,36.46%,1
桃園市,中壢區,0661,497,197,694,22,716,1451,49.35%,34.25%,1
桃園市,中壢區,0662,564,185,749,32,781,1489,52.45%,37.88%,1
桃園市,中壢區,0663,323,125,448,16,464,827,56.11%,39.06%,1
桃園市,中壢區,0664,532,193,725,25,750,1442,52.01%,36.89%,1
桃園市,中壢區,0665,614,264,878,13,891,1842,48.37%,33.33%,1
桃園市,中壢區,0666,517,207,724,20,744,1520,48.95%,34.01%,1
桃園市,中壢區,0667,578,220,798,26,824,1764,46.71%,32.77%,1
桃園市,中壢區,0668,611,206,817,9,826,1488,55.51%,41.06%,1
桃園市,中壢區,0669,606,218,824,25,849,1593,53.3%,38.04%,1
桃園市,中壢區,0670,550,232,782,21,803,1505,53.36%,36.54%,1
桃園市,中壢區,0671,614,233,847,17,864,1661,52.02%,36.97%,1
桃園市,中壢區,0672,582,210,792,25,817,1492,54.76%,39.01%,1
桃園市,中壢區,0673,433,165,598,21,619,1249,49.56%,34.67%,1
桃園市,中壢區,0674,488,197,685,15,700,1257,55.69%,38.82%,1
桃園市,中壢區,0675,585,243,828,38,866,1659,52.2%,35.26%,1
桃園市,中壢區,0676,683,293,976,16,992,1815,54.66%,37.63%,1
桃園市,中壢區,0677,616,226,842,27,869,1702,51.06%,36.19%,1
桃園市,中壢區,0678,561,245,806,19,825,1541,53.54%,36.4%,1
桃園市,中壢區,0679,597,208,805,26,831,1659,50.09%,35.99%,1
桃園市,中壢區,0680,720,223,943,40,983,1874,52.45%,38.42%,1
桃園市,中壢區,0681,638,143,781,19,800,1603,49.91%,39.8%,1
桃園市,中壢區,0682,601,248,849,32,881,1735,50.78%,34.64%,1
桃園市,中壢區,0683,639,270,909,18,927,1815,51.07%,35.21%,1
桃園市,中壢區,0684,649,263,912,26,938,1873,50.08%,34.65%,1
桃園市,中壢區,0685,717,211,928,43,971,1739,55.84%,41.23%,1
桃園市,中壢區,0686,605,212,817,36,853,1709,49.91%,35.4%,1
桃園市,中壢區,0687,656,225,881,31,912,1655,55.11%,39.64%,1
桃園市,中壢區,0688,685,205,890,34,924,1664,55.53%,41.17%,1
桃園市,中壢區,0689,405,117,522,21,543,1087,49.95%,37.26%,1
桃園市,中壢區,0690,409,162,571,30,601,1065,56.43%,38.4%,1
桃園市,中壢區,0691,705,247,952,45,997,1844,54.07%,38.23%,1
桃園市,中壢區,0692,431,132,563,33,596,1220,48.85%,35.33%,1
桃園市,中壢區,0693,446,191,637,20,657,1219,53.9%,36.59%,1
桃園市,中壢區,0694,466,202,668,35,703,1260,55.79%,36.98%,1
桃園市,中壢區,0695,657,239,896,32,928,1594,58.22%,41.22%,1
桃園市,中壢區,0696,622,269,891,50,941,1733,54.3%,35.89%,1
桃園市,中壢區,0697,734,285,1019,32,1051,1979,53.11%,37.09%,1
桃園市,中壢區,0698,598,280,878,22,900,1621,55.52%,36.89%,1
桃園市,中壢區,0699,547,223,770,18,788,1391,56.65%,39.32%,1
桃園市,中壢區,0700,586,254,840,9,849,1531,55.45%,38.28%,1
桃園市,中壢區,0701,694,219,913,28,941,1943,48.43%,35.72%,1
桃園市,中壢區,0702,507,196,703,18,721,1363,52.9%,37.2%,1
桃園市,中壢區,0703,682,274,956,34,990,2172,45.58%,31.4%,1
桃園市,中壢區,0704,649,207,856,23,879,1798,48.89%,36.1%,1
桃園市,中壢區,0705,594,223,817,15,832,1671,49.79%,35.55%,1
桃園市,中壢區,0706,179,156,335,14,349,1969,17.72%,9.09%,1
桃園市,中壢區,0707,703,249,952,34,986,1563,63.08%,44.98%,1
桃園市,中壢區,0708,667,279,946,34,980,1762,55.62%,37.85%,1
桃園市,中壢區,0709,592,211,803,25,828,1923,43.06%,30.79%,1
桃園市,中壢區,0710,640,222,862,35,897,1572,57.06%,40.71%,1
桃園市,中壢區,0711,625,367,992,17,1009,1850,54.54%,33.78%,1
桃園市,中壢區,0712,582,211,793,27,820,1583,51.8%,36.77%,1
桃園市,中壢區,0713,604,271,875,30,905,1735,52.16%,34.81%,1
桃園市,中壢區,0714,481,187,668,26,694,1292,53.72%,37.23%,1
桃園市,中壢區,0715,499,175,674,17,691,1265,54.62%,39.45%,1
桃園市,中壢區,0716,685,232,917,23,940,1798,52.28%,38.1%,1
桃園市,中壢區,0717,741,267,1008,35,1043,1822,57.24%,40.67%,1
桃園市,中壢區,0718,624,228,852,19,871,1613,54%,38.69%,1
桃園市,中壢區,0719,506,228,734,23,757,1405,53.88%,36.01%,1
桃園市,中壢區,0720,639,292,931,53,984,1730,56.88%,36.94%,1
桃園市,中壢區,0721,596,239,835,22,857,1384,61.92%,43.06%,1
桃園市,中壢區,0722,431,188,619,15,634,1122,56.51%,38.41%,1
桃園市,中壢區,0723,403,161,564,39,603,992,60.79%,40.63%,1
桃園市,中壢區,0724,630,287,917,24,941,1820,51.7%,34.62%,1
桃園市,中壢區,0725,680,230,910,39,949,1847,51.38%,36.82%,1
桃園市,中壢區,0726,536,187,723,34,757,1302,58.14%,41.17%,1
桃園市,中壢區,0727,498,185,683,14,697,1203,57.94%,41.4%,1
桃園市,中壢區,0728,550,212,762,28,790,1226,64.44%,44.86%,1
桃園市,中壢區,0729,534,167,701,33,734,1234,59.48%,43.27%,1
桃園市,中壢區,0730,669,249,918,38,956,2023,47.26%,33.07%,1
桃園市,中壢區,0731,544,183,727,25,752,1555,48.36%,34.98%,1
桃園市,中壢區,0732,665,279,944,33,977,1951,50.08%,34.09%,1
桃園市,中壢區,0733,538,216,754,24,778,1383,56.25%,38.9%,1
桃園市,中壢區,0734,519,154,673,31,704,1164,60.48%,44.59%,1
桃園市,中壢區,0735,567,234,801,22,823,1482,55.53%,38.26%,1
桃園市,中壢區,0736,678,230,908,35,943,1770,53.28%,38.31%,1
桃園市,中壢區,0737,682,266,948,37,985,1703,57.84%,40.05%,1
桃園市,中壢區,0738,692,233,925,50,975,1841,52.96%,37.59%,1
桃園市,中壢區,0739,675,363,1038,27,1065,1941,54.87%,34.78%,1
桃園市,中壢區,0740,753,326,1079,37,1116,2029,55%,37.11%,1
桃園市,中壢區,0741,697,320,1017,20,1037,1636,63.39%,42.6%,1
桃園市,中壢區,0742,621,221,842,31,873,1528,57.13%,40.64%,1
桃園市,中壢區,0743,696,363,1059,51,1110,2289,48.49%,30.41%,1
桃園市,中壢區,0744,659,313,972,24,996,2020,49.31%,32.62%,1
桃園市,中壢區,0745,771,283,1054,31,1085,2027,53.53%,38.04%,1
桃園市,中壢區,0746,571,250,821,17,838,1883,44.5%,30.32%,1
桃園市,中壢區,0747,703,294,997,33,1030,2080,49.52%,33.8%,1
桃園市,中壢區,0748,238,99,337,9,346,646,53.56%,36.84%,1
桃園市,中壢區,0749,798,277,1075,38,1113,1780,62.53%,44.83%,1
桃園市,中壢區,0750,595,185,780,16,796,1372,58.02%,43.37%,1
桃園市,中壢區,0751,675,271,946,19,965,1668,57.85%,40.47%,1
桃園市,中壢區,0752,686,300,986,16,1002,1987,50.43%,34.52%,1
桃園市,中壢區,0753,565,244,809,18,827,1520,54.41%,37.17%,1
桃園市,中壢區,0754,312,135,447,20,467,852,54.81%,36.62%,1
桃園市,中壢區,0755,405,236,641,27,668,1209,55.25%,33.5%,1
桃園市,中壢區,0756,537,220,757,50,807,1481,54.49%,36.26%,1
桃園市,中壢區,0757,519,219,738,12,750,1564,47.95%,33.18%,1
桃園市,中壢區,0758,744,284,1028,42,1070,1957,54.68%,38.02%,1
桃園市,中壢區,0759,490,214,704,37,741,1223,60.59%,40.07%,1
桃園市,中壢區,0760,502,199,701,21,722,1182,61.08%,42.47%,1
桃園市,中壢區,0761,447,167,614,37,651,1066,61.07%,41.93%,1
桃園市,中壢區,0762,691,250,941,40,981,1701,57.67%,40.62%,1
桃園市,中壢區,0763,350,121,471,33,504,943,53.45%,37.12%,1
桃園市,中壢區,0764,302,119,421,23,444,731,60.74%,41.31%,1
桃園市,中壢區,0765,342,128,470,22,492,851,57.81%,40.19%,1
桃園市,中壢區,0766,363,174,537,20,557,1011,55.09%,35.91%,1
桃園市,中壢區,0767,619,247,866,30,896,1532,58.49%,40.4%,1
桃園市,中壢區,0768,383,146,529,33,562,1028,54.67%,37.26%,1
桃園市,中壢區,0769,479,178,657,20,677,1157,58.51%,41.4%,1
桃園市,中壢區,0770,551,261,812,42,854,1591,53.68%,34.63%,1
桃園市,中壢區,0771,681,302,983,46,1029,2156,47.73%,31.59%,1
桃園市,中壢區,0772,491,198,689,23,712,1479,48.14%,33.2%,1
桃園市,中壢區,0773,645,263,908,39,947,1780,53.2%,36.24%,1
桃園市,中壢區,0774,648,218,866,28,894,1651,54.15%,39.25%,1
桃園市,中壢區,0775,657,322,979,21,1000,1870,53.48%,35.13%,1
桃園市,中壢區,0776,601,261,862,15,877,1913,45.84%,31.42%,1
桃園市,中壢區,0777,561,187,748,29,777,1609,48.29%,34.87%,1
桃園市,中壢區,0778,553,205,758,19,777,1539,50.49%,35.93%,1
桃園市,中壢區,0779,531,220,751,24,775,1426,54.35%,37.24%,1
桃園市,中壢區,0780,577,198,775,21,796,1618,49.2%,35.66%,1
桃園市,中壢區,0781,558,198,756,29,785,1441,54.48%,38.72%,1
桃園市,中壢區,0782,544,255,799,23,822,1528,53.8%,35.6%,1
桃園市,中壢區,0783,616,244,860,45,905,1683,53.77%,36.6%,1
桃園市,中壢區,0784,754,282,1036,38,1074,1945,55.22%,38.77%,1
桃園市,中壢區,0785,570,209,779,34,813,1534,53%,37.16%,1
桃園市,中壢區,0786,633,241,874,42,916,1810,50.61%,34.97%,1
桃園市,中壢區,0787,381,137,518,44,562,1097,51.23%,34.73%,1
桃園市,中壢區,0788,586,339,925,15,940,1917,49.03%,30.57%,1
桃園市,中壢區,0789,591,335,926,26,952,1858,51.24%,31.81%,1
桃園市,中壢區,0790,615,238,853,33,886,1576,56.22%,39.02%,1
桃園市,中壢區,0791,597,204,801,24,825,1478,55.82%,40.39%,1
桃園市,中壢區,0792,586,243,829,12,841,1589,52.93%,36.88%,1
桃園市,中壢區,0793,757,284,1041,75,1116,2037,54.79%,37.16%,1
桃園市,中壢區,0794,506,174,680,24,704,1158,60.79%,43.7%,1
桃園市,中壢區,0795,770,253,1023,39,1062,1967,53.99%,39.15%,1
桃園市,中壢區,0796,674,221,895,38,933,1830,50.98%,36.83%,1
桃園市,中壢區,0797,767,219,986,39,1025,1856,55.23%,41.33%,1
桃園市,中壢區,0798,740,269,1009,51,1060,2068,51.26%,35.78%,1
桃園市,中壢區,0799,581,278,859,35,894,2152,41.54%,27%,1
桃園市,中壢區,0800,643,321,964,24,988,2158,45.78%,29.8%,1
桃園市,大溪區,0522,573,231,804,34,838,1477,56.74%,38.79%,1
桃園市,大溪區,0523,411,133,544,19,563,1006,55.96%,40.85%,1
桃園市,大溪區,0524,570,203,773,41,814,1553,52.41%,36.7%,1
桃園市,大溪區,0525,586,243,829,44,873,1597,54.66%,36.69%,1
桃園市,大溪區,0526,498,200,698,30,728,1358,53.61%,36.67%,1
桃園市,大溪區,0527,544,203,747,18,765,1585,48.26%,34.32%,1
桃園市,大溪區,0528,548,256,804,33,837,1612,51.92%,34%,1
桃園市,大溪區,0529,535,170,705,35,740,1555,47.59%,34.41%,1
桃園市,大溪區,0530,533,202,735,39,774,1282,60.37%,41.58%,1
桃園市,大溪區,0531,530,175,705,28,733,1392,52.66%,38.07%,1
桃園市,大溪區,0532,526,162,688,34,722,1422,50.77%,36.99%,1
桃園市,大溪區,0533,561,185,746,46,792,1448,54.7%,38.74%,1
桃園市,大溪區,0534,551,190,741,38,779,1269,61.39%,43.42%,1
桃園市,大溪區,0535,425,118,543,50,593,977,60.7%,43.5%,1
桃園市,大溪區,0536,572,174,746,30,776,1359,57.1%,42.09%,1
桃園市,大溪區,0537,459,179,638,47,685,1135,60.35%,40.44%,1
桃園市,大溪區,0538,230,95,325,27,352,660,53.33%,34.85%,1
桃園市,大溪區,0539,356,140,496,37,533,1056,50.47%,33.71%,1
桃園市,大溪區,0540,451,159,610,44,654,1263,51.78%,35.71%,1
桃園市,大溪區,0541,292,83,375,25,400,717,55.79%,40.73%,1
桃園市,大溪區,0542,410,144,554,11,565,1299,43.49%,31.56%,1
桃園市,大溪區,0543,377,128,505,38,543,976,55.64%,38.63%,1
桃園市,大溪區,0544,380,105,485,25,510,938,54.37%,40.51%,1
桃園市,大溪區,0545,325,85,410,23,433,832,52.04%,39.06%,1
桃園市,大溪區,0546,291,92,383,22,405,866,46.77%,33.6%,1
桃園市,大溪區,0547,246,82,328,20,348,694,50.14%,35.45%,1
桃園市,大溪區,0548,514,162,676,37,713,1410,50.57%,36.45%,1
桃園市,大溪區,0549,490,113,603,47,650,1303,49.88%,37.61%,1
桃園市,大溪區,0550,411,151,562,29,591,1125,52.53%,36.53%,1
桃園市,大溪區,0551,439,178,617,26,643,1170,54.96%,37.52%,1
桃園市,大溪區,0552,533,192,725,40,765,1308,58.49%,40.75%,1
桃園市,大溪區,0553,419,143,562,59,621,1094,56.76%,38.3%,1
桃園市,大溪區,0554,860,251,1111,39,1150,2153,53.41%,39.94%,1
桃園市,大溪區,0555,525,126,651,29,680,1173,57.97%,44.76%,1
桃園市,大溪區,0556,513,177,690,14,704,1369,51.42%,37.47%,1
桃園市,大溪區,0557,550,153,703,41,744,1446,51.45%,38.04%,1
桃園市,大溪區,0558,465,124,589,33,622,1406,44.24%,33.07%,1
桃園市,大溪區,0559,641,203,844,18,862,1592,54.15%,40.26%,1
桃園市,大溪區,0560,618,189,807,49,856,1497,57.18%,41.28%,1
桃園市,大溪區,0561,622,220,842,45,887,1559,56.9%,39.9%,1
桃園市,大溪區,0562,631,213,844,24,868,1684,51.54%,37.47%,1
桃園市,大溪區,0563,785,268,1053,29,1082,1959,55.23%,40.07%,1
桃園市,大溪區,0564,584,156,740,41,781,1369,57.05%,42.66%,1
桃園市,大溪區,0565,576,194,770,35,805,1431,56.25%,40.25%,1
桃園市,大溪區,0566,501,171,672,21,693,1657,41.82%,30.24%,1
桃園市,大溪區,0567,459,143,602,26,628,1387,45.28%,33.09%,1
桃園市,大溪區,0568,420,135,555,23,578,1085,53.27%,38.71%,1
桃園市,大溪區,0569,585,187,772,20,792,1403,56.45%,41.7%,1
桃園市,大溪區,0570,532,205,737,47,784,1511,51.89%,35.21%,1
桃園市,大溪區,0571,543,213,756,49,805,1719,46.83%,31.59%,1
桃園市,大溪區,0572,551,196,747,47,794,1717,46.24%,32.09%,1
桃園市,大溪區,0573,464,150,614,39,653,1207,54.1%,38.44%,1
桃園市,大溪區,0574,480,149,629,46,675,1188,56.82%,40.4%,1
桃園市,大溪區,0575,550,187,737,18,755,1514,49.87%,36.33%,1
桃園市,大溪區,0576,626,200,826,34,860,1529,56.25%,40.94%,1
桃園市,大溪區,0577,538,174,712,31,743,1260,58.97%,42.7%,1
桃園市,大溪區,0578,380,100,480,11,491,831,59.09%,45.73%,1
桃園市,大溪區,0579,553,195,748,41,789,1407,56.08%,39.3%,1
桃園市,大溪區,0580,546,169,715,45,760,1494,50.87%,36.55%,1
桃園市,楊梅區,0926,522,140,662,49,711,1269,56.03%,41.13%,1
桃園市,楊梅區,0927,570,169,739,34,773,1246,62.04%,45.75%,1
桃園市,楊梅區,0928,619,172,791,32,823,1408,58.45%,43.96%,1
桃園市,楊梅區,0929,587,183,770,34,804,1434,56.07%,40.93%,1
桃園市,楊梅區,0930,571,176,747,45,792,1515,52.28%,37.69%,1
桃園市,楊梅區,0931,592,189,781,39,820,1657,49.49%,35.73%,1
桃園市,楊梅區,0932,487,144,631,32,663,1137,58.31%,42.83%,1
桃園市,楊梅區,0933,793,290,1083,26,1109,2211,50.16%,35.87%,1
桃園市,楊梅區,0934,734,259,993,20,1013,2008,50.45%,36.55%,1
桃園市,楊梅區,0935,713,297,1010,23,1033,1911,54.06%,37.31%,1
桃園市,楊梅區,0936,591,184,775,40,815,1449,56.25%,40.79%,1
桃園市,楊梅區,0937,601,223,824,44,868,1877,46.24%,32.02%,1
桃園市,楊梅區,0938,731,214,945,14,959,1988,48.24%,36.77%,1
桃園市,楊梅區,0939,715,283,998,19,1017,1931,52.67%,37.03%,1
桃園市,楊梅區,0940,718,204,922,28,950,1938,49.02%,37.05%,1
桃園市,楊梅區,0941,676,196,872,17,889,1677,53.01%,40.31%,1
桃園市,楊梅區,0942,666,234,900,23,923,1848,49.95%,36.04%,1
桃園市,楊梅區,0943,688,264,952,21,973,1882,51.7%,36.56%,1
桃園市,楊梅區,0944,442,178,620,17,637,1541,41.34%,28.68%,1
桃園市,楊梅區,0945,681,249,930,30,960,1938,49.54%,35.14%,1
桃園市,楊梅區,0946,526,187,713,12,725,1562,46.41%,33.67%,1
桃園市,楊梅區,0947,923,218,1141,41,1182,2125,55.62%,43.44%,1
桃園市,楊梅區,0948,664,205,869,24,893,1516,58.91%,43.8%,1
桃園市,楊梅區,0949,661,217,878,18,896,1807,49.58%,36.58%,1
桃園市,楊梅區,0950,721,253,974,30,1004,2101,47.79%,34.32%,1
桃園市,楊梅區,0951,747,285,1032,38,1070,2054,52.09%,36.37%,1
桃園市,楊梅區,0952,737,260,997,29,1026,2226,46.09%,33.11%,1
桃園市,楊梅區,0953,567,193,760,13,773,1405,55.02%,40.36%,1
桃園市,楊梅區,0954,600,257,857,18,875,1843,47.48%,32.56%,1
桃園市,楊梅區,0955,743,267,1010,40,1050,2324,45.18%,31.97%,1
桃園市,楊梅區,0956,661,229,890,11,901,1713,52.6%,38.59%,1
桃園市,楊梅區,0957,704,211,915,28,943,1587,59.42%,44.36%,1
桃園市,楊梅區,0958,582,220,802,16,818,1416,57.77%,41.1%,1
桃園市,楊梅區,0959,640,214,854,20,874,1591,54.93%,40.23%,1
桃園市,楊梅區,0960,748,225,973,27,1000,1943,51.47%,38.5%,1
桃園市,楊梅區,0961,732,193,925,25,950,1762,53.92%,41.54%,1
桃園市,楊梅區,0962,440,141,581,12,593,1083,54.76%,40.63%,1
桃園市,楊梅區,0963,769,234,1003,47,1050,2027,51.8%,37.94%,1
桃園市,楊梅區,0964,533,166,699,35,734,1274,57.61%,41.84%,1
桃園市,楊梅區,0965,689,73,762,28,790,1359,58.13%,50.7%,1
桃園市,楊梅區,0966,604,239,843,26,869,2444,35.56%,24.71%,1
桃園市,楊梅區,0967,769,244,1013,32,1045,2298,45.47%,33.46%,1
桃園市,楊梅區,0968,812,266,1078,21,1099,2222,49.46%,36.54%,1
桃園市,楊梅區,0969,617,207,824,40,864,1610,53.66%,38.32%,1
桃園市,楊梅區,0970,621,219,840,32,872,1627,53.6%,38.17%,1
桃園市,楊梅區,0971,661,174,835,39,874,1589,55%,41.6%,1
桃園市,楊梅區,0972,666,233,899,38,937,1758,53.3%,37.88%,1
桃園市,楊梅區,0973,568,181,749,39,788,1776,44.37%,31.98%,1
桃園市,楊梅區,0974,347,124,471,18,489,1000,48.9%,34.7%,1
桃園市,楊梅區,0975,737,236,973,61,1034,2290,45.15%,32.18%,1
桃園市,楊梅區,0976,571,208,779,38,817,1551,52.68%,36.81%,1
桃園市,楊梅區,0977,684,207,891,41,932,1861,50.08%,36.75%,1
桃園市,楊梅區,0978,388,123,511,29,540,1141,47.33%,34.01%,1
桃園市,楊梅區,0979,654,184,838,31,869,1785,48.68%,36.64%,1
桃園市,楊梅區,0980,570,173,743,57,800,1498,53.4%,38.05%,1
桃園市,楊梅區,0981,442,147,589,35,624,1187,52.57%,37.24%,1
桃園市,楊梅區,0982,507,170,677,35,712,1270,56.06%,39.92%,1
桃園市,楊梅區,0983,554,166,720,29,749,1424,52.6%,38.9%,1
桃園市,楊梅區,0984,600,195,795,19,814,1273,63.94%,47.13%,1
桃園市,楊梅區,0985,526,171,697,25,722,1534,47.07%,34.29%,1
桃園市,楊梅區,0986,558,210,768,47,815,1783,45.71%,31.3%,1
桃園市,楊梅區,0987,632,169,801,19,820,1709,47.98%,36.98%,1
桃園市,楊梅區,0988,628,225,853,36,889,1920,46.3%,32.71%,1
桃園市,楊梅區,0989,466,155,621,29,650,1194,54.44%,39.03%,1
桃園市,楊梅區,0990,568,177,745,15,760,1408,53.98%,40.34%,1
桃園市,楊梅區,0991,594,170,764,23,787,1737,45.31%,34.2%,1
桃園市,楊梅區,0992,718,215,933,23,956,1920,49.79%,37.4%,1
桃園市,楊梅區,0993,483,130,613,24,637,1234,51.62%,39.14%,1
桃園市,楊梅區,0994,697,85,782,47,829,1491,55.6%,46.75%,1
桃園市,楊梅區,0995,674,241,915,28,943,2020,46.68%,33.37%,1
桃園市,楊梅區,0996,605,234,839,24,863,1863,46.32%,32.47%,1
桃園市,楊梅區,0997,700,186,886,34,920,1692,54.37%,41.37%,1
桃園市,楊梅區,0998,621,231,852,19,871,1686,51.66%,36.83%,1
桃園市,楊梅區,0999,628,222,850,38,888,1626,54.61%,38.62%,1
桃園市,楊梅區,1000,613,211,824,33,857,1557,55.04%,39.37%,1
桃園市,楊梅區,1001,655,236,891,41,932,1603,58.14%,40.86%,1
桃園市,楊梅區,1002,668,228,896,35,931,1889,49.29%,35.36%,1
桃園市,楊梅區,1003,613,172,785,27,812,1448,56.08%,42.33%,1
桃園市,楊梅區,1004,561,161,722,44,766,1351,56.7%,41.52%,1
桃園市,楊梅區,1005,557,171,728,40,768,1313,58.49%,42.42%,1
桃園市,楊梅區,1006,658,200,858,22,880,1689,52.1%,38.96%,1
桃園市,楊梅區,1007,740,225,965,17,982,2063,47.6%,35.87%,1
桃園市,蘆竹區,0396,506,179,685,26,711,1358,52.36%,37.26%,1
桃園市,蘆竹區,0397,532,189,721,57,778,1538,50.59%,34.59%,1
桃園市,蘆竹區,0398,642,202,844,54,898,2118,42.4%,30.31%,1
桃園市,蘆竹區,0399,662,233,895,43,938,1673,56.07%,39.57%,1
桃園市,蘆竹區,0400,569,225,794,24,818,1500,54.53%,37.93%,1
桃園市,蘆竹區,0401,642,237,879,30,909,1699,53.5%,37.79%,1
桃園市,蘆竹區,0402,808,314,1122,27,1149,2250,51.07%,35.91%,1
桃園市,蘆竹區,0403,715,327,1042,18,1060,2354,45.03%,30.37%,1
桃園市,蘆竹區,0404,525,169,694,26,720,1446,49.79%,36.31%,1
桃園市,蘆竹區,0405,547,200,747,33,780,1623,48.06%,33.7%,1
桃園市,蘆竹區,0406,598,243,841,19,860,1747,49.23%,34.23%,1
桃園市,蘆竹區,0407,705,282,987,41,1028,1988,51.71%,35.46%,1
桃園市,蘆竹區,0408,531,205,736,24,760,1437,52.89%,36.95%,1
桃園市,蘆竹區,0409,730,110,840,32,872,1532,56.92%,47.65%,1
桃園市,蘆竹區,0410,543,174,717,23,740,1447,51.14%,37.53%,1
桃園市,蘆竹區,0411,785,315,1100,26,1126,2189,51.44%,35.86%,1
桃園市,蘆竹區,0412,837,303,1140,40,1180,2498,47.24%,33.51%,1
桃園市,蘆竹區,0413,521,189,710,14,724,1322,54.77%,39.41%,1
桃園市,蘆竹區,0414,593,214,807,43,850,1991,42.69%,29.78%,1
桃園市,蘆竹區,0415,661,273,934,60,994,2097,47.4%,31.52%,1
桃園市,蘆竹區,0416,550,229,779,22,801,1558,51.41%,35.3%,1
桃園市,蘆竹區,0417,624,343,967,26,993,1891,52.51%,33%,1
桃園市,蘆竹區,0418,508,242,750,23,773,1590,48.62%,31.95%,1
桃園市,蘆竹區,0419,734,306,1040,43,1083,2404,45.05%,30.53%,1
桃園市,蘆竹區,0420,856,370,1226,27,1253,2522,49.68%,33.94%,1
桃園市,蘆竹區,0421,580,243,823,20,843,1633,51.62%,35.52%,1
桃園市,蘆竹區,0422,584,272,856,30,886,1715,51.66%,34.05%,1
桃園市,蘆竹區,0423,738,282,1020,25,1045,2215,47.18%,33.32%,1
桃園市,蘆竹區,0424,662,292,954,35,989,2029,48.74%,32.63%,1
桃園市,蘆竹區,0425,586,243,829,23,852,1731,49.22%,33.85%,1
桃園市,蘆竹區,0426,626,279,905,19,924,1820,50.77%,34.4%,1
桃園市,蘆竹區,0427,611,239,850,32,882,1633,54.01%,37.42%,1
桃園市,蘆竹區,0428,576,203,779,17,796,1668,47.72%,34.53%,1
桃園市,蘆竹區,0429,556,253,809,20,829,1493,55.53%,37.24%,1
桃園市,蘆竹區,0430,718,240,958,25,983,1864,52.74%,38.52%,1
桃園市,蘆竹區,0431,564,274,838,21,859,1703,50.44%,33.12%,1
桃園市,蘆竹區,0432,666,286,952,25,977,1893,51.61%,35.18%,1
桃園市,蘆竹區,0433,704,339,1043,17,1060,1922,55.15%,36.63%,1
桃園市,蘆竹區,0434,548,192,740,9,749,1393,53.77%,39.34%,1
桃園市,蘆竹區,0435,502,222,724,15,739,1338,55.23%,37.52%,1
桃園市,蘆竹區,0436,599,237,836,19,855,1688,50.65%,35.49%,1
桃園市,蘆竹區,0437,516,197,713,39,752,1462,51.44%,35.29%,1
桃園市,蘆竹區,0438,497,144,641,19,660,1232,53.57%,40.34%,1
桃園市,蘆竹區,0439,462,174,636,19,655,1356,48.3%,34.07%,1
桃園市,蘆竹區,0440,481,215,696,24,720,1181,60.97%,40.73%,1
桃園市,蘆竹區,0441,434,163,597,21,618,1199,51.54%,36.2%,1
桃園市,蘆竹區,0442,624,278,902,12,914,1710,53.45%,36.49%,1
桃園市,蘆竹區,0443,492,203,695,19,714,1423,50.18%,34.57%,1
桃園市,蘆竹區,0444,548,249,797,21,818,1522,53.75%,36.01%,1
桃園市,蘆竹區,0445,612,225,837,25,862,1639,52.59%,37.34%,1
桃園市,蘆竹區,0446,691,316,1007,31,1038,2055,50.51%,33.63%,1
桃園市,蘆竹區,0447,703,360,1063,31,1094,2178,50.23%,32.28%,1
桃園市,蘆竹區,0448,582,307,889,31,920,1709,53.83%,34.06%,1
桃園市,蘆竹區,0449,625,259,884,34,918,1667,55.07%,37.49%,1
桃園市,蘆竹區,0450,633,297,930,16,946,1745,54.21%,36.28%,1
桃園市,蘆竹區,0451,705,346,1051,33,1084,1967,55.11%,35.84%,1
桃園市,蘆竹區,0452,695,290,985,22,1007,1802,55.88%,38.57%,1
桃園市,蘆竹區,0453,891,392,1283,19,1302,2727,47.74%,32.67%,1
桃園市,蘆竹區,0454,594,277,871,24,895,1868,47.91%,31.8%,1
桃園市,蘆竹區,0455,536,221,757,23,780,1537,50.75%,34.87%,1
桃園市,蘆竹區,0456,552,270,822,28,850,1616,52.6%,34.16%,1
桃園市,蘆竹區,0457,589,242,831,30,861,1483,58.06%,39.72%,1
桃園市,蘆竹區,0458,571,236,807,36,843,1689,49.91%,33.81%,1
桃園市,蘆竹區,0459,415,130,545,27,572,1318,43.4%,31.49%,1
桃園市,蘆竹區,0460,553,169,722,46,768,1203,63.84%,45.97%,1
桃園市,蘆竹區,0461,597,221,818,27,845,1771,47.71%,33.71%,1
桃園市,蘆竹區,0462,602,221,823,45,868,1832,47.38%,32.86%,1
桃園市,蘆竹區,0463,617,216,833,57,890,1763,50.48%,35%,1
桃園市,蘆竹區,0464,486,187,673,11,684,1497,45.69%,32.46%,1
桃園市,蘆竹區,0465,708,201,909,84,993,1671,59.43%,42.37%,1
桃園市,蘆竹區,0466,382,120,502,36,538,929,57.91%,41.12%,1
桃園市,蘆竹區,0467,595,216,811,55,866,1559,55.55%,38.17%,1
桃園市,蘆竹區,0468,604,189,793,22,815,1497,54.44%,40.35%,1
桃園市,蘆竹區,0469,672,203,875,37,912,1441,63.29%,46.63%,1
桃園市,蘆竹區,0470,542,174,716,41,757,1465,51.67%,37%,1
桃園市,蘆竹區,0471,393,111,504,29,533,1029,51.8%,38.19%,1
桃園市,大園區,0472,487,189,676,35,711,1538,46.23%,31.66%,1
桃園市,大園區,0473,465,187,652,16,668,1616,41.34%,28.77%,1
桃園市,大園區,0474,549,227,776,38,814,1437,56.65%,38.2%,1
桃園市,大園區,0475,629,213,842,19,861,1554,55.41%,40.48%,1
桃園市,大園區,0476,452,175,627,18,645,1237,52.14%,36.54%,1
桃園市,大園區,0477,491,175,666,34,700,1347,51.97%,36.45%,1
桃園市,大園區,0478,445,190,635,26,661,1261,52.42%,35.29%,1
桃園市,大園區,0479,457,160,617,22,639,1256,50.88%,36.39%,1
桃園市,大園區,0480,466,158,624,27,651,1370,47.52%,34.01%,1
桃園市,大園區,0481,519,191,710,32,742,1610,46.09%,32.24%,1
桃園市,大園區,0482,529,148,677,37,714,1419,50.32%,37.28%,1
桃園市,大園區,0483,488,152,640,23,663,1588,41.75%,30.73%,1
桃園市,大園區,0484,563,222,785,31,816,1612,50.62%,34.93%,1
桃園市,大園區,0485,512,174,686,33,719,1440,49.93%,35.56%,1
桃園市,大園區,0486,434,182,616,34,650,1326,49.02%,32.73%,1
桃園市,大園區,0487,598,190,788,30,818,1455,56.22%,41.1%,1
桃園市,大園區,0488,585,225,810,33,843,1562,53.97%,37.45%,1
桃園市,大園區,0489,480,217,697,30,727,1284,56.62%,37.38%,1
桃園市,大園區,0490,451,238,689,4,693,1454,47.66%,31.02%,1
桃園市,大園區,0491,473,264,737,23,760,1490,51.01%,31.74%,1
桃園市,大園區,0492,557,192,749,30,779,1617,48.18%,34.45%,1
桃園市,大園區,0493,601,204,805,28,833,1594,52.26%,37.7%,1
桃園市,大園區,0494,595,201,796,41,837,1650,50.73%,36.06%,1
桃園市,大園區,0495,521,178,699,19,718,1467,48.94%,35.51%,1
桃園市,大園區,0496,544,194,738,29,767,1494,51.34%,36.41%,1
桃園市,大園區,0497,566,190,756,31,787,1538,51.17%,36.8%,1
桃園市,大園區,0498,519,182,701,22,723,1397,51.75%,37.15%,1
桃園市,大園區,0499,584,187,771,17,788,1637,48.14%,35.68%,1
桃園市,大園區,0500,495,175,670,22,692,1452,47.66%,34.09%,1
桃園市,大園區,0501,637,192,829,37,866,1414,61.24%,45.05%,1
桃園市,大園區,0502,617,214,831,38,869,1670,52.04%,36.95%,1
桃園市,大園區,0503,582,212,794,11,805,1701,47.33%,34.22%,1
桃園市,大園區,0504,598,190,788,16,804,1813,44.35%,32.98%,1
桃園市,大園區,0505,582,219,801,16,817,1687,48.43%,34.5%,1
桃園市,大園區,0506,605,229,834,10,844,1650,51.15%,36.67%,1
桃園市,大園區,0507,597,241,838,44,882,1556,56.68%,38.37%,1
桃園市,大園區,0508,571,236,807,19,826,1844,44.79%,30.97%,1
桃園市,大園區,0509,454,159,613,40,653,1336,48.88%,33.98%,1
桃園市,大園區,0510,573,178,751,38,789,1414,55.8%,40.52%,1
桃園市,大園區,0511,539,179,718,28,746,1238,60.26%,43.54%,1
桃園市,大園區,0512,549,156,705,34,739,1227,60.23%,44.74%,1
桃園市,大園區,0513,412,182,594,23,617,1199,51.46%,34.36%,1
桃園市,大園區,0514,469,138,607,30,637,1349,47.22%,34.77%,1
桃園市,大園區,0515,519,37,556,24,580,1120,51.79%,46.34%,1
桃園市,大園區,0516,406,136,542,29,571,1080,52.87%,37.59%,1
桃園市,大園區,0517,455,169,624,35,659,1341,49.14%,33.93%,1
桃園市,大園區,0518,519,165,684,28,712,1345,52.94%,38.59%,1
桃園市,大園區,0519,517,176,693,25,718,1565,45.88%,33.04%,1
桃園市,大園區,0520,474,169,643,13,656,1519,43.19%,31.2%,1
桃園市,大園區,0521,693,244,937,52,989,2130,46.43%,32.54%,1
桃園市,龜山區,0217,349,117,466,25,491,874,56.18%,39.93%,1
桃園市,龜山區,0218,785,232,1017,60,1077,2014,53.48%,38.98%,1
桃園市,龜山區,0219,697,341,1038,16,1054,2145,49.14%,32.49%,1
桃園市,龜山區,0220,740,169,909,40,949,1744,54.42%,42.43%,1
桃園市,龜山區,0221,757,220,977,47,1024,1885,54.32%,40.16%,1
桃園市,龜山區,0222,545,178,723,33,756,1546,48.9%,35.25%,1
桃園市,龜山區,0223,570,229,799,39,838,1684,49.76%,33.85%,1
桃園市,龜山區,0224,490,187,677,25,702,1477,47.53%,33.18%,1
桃園市,龜山區,0225,646,179,825,32,857,1528,56.09%,42.28%,1
桃園市,龜山區,0226,205,77,282,11,293,1428,20.52%,14.36%,1
桃園市,龜山區,0227,586,223,809,29,838,1525,54.95%,38.43%,1
桃園市,龜山區,0228,398,183,581,28,609,1041,58.5%,38.23%,1
桃園市,龜山區,0229,490,211,701,20,721,1404,51.35%,34.9%,1
桃園市,龜山區,0230,579,212,791,26,817,1478,55.28%,39.17%,1
桃園市,龜山區,0231,786,290,1076,49,1125,2178,51.65%,36.09%,1
桃園市,龜山區,0232,621,219,840,61,901,1672,53.89%,37.14%,1
桃園市,龜山區,0233,475,177,652,29,681,1376,49.49%,34.52%,1
桃園市,龜山區,0234,514,204,718,37,755,1480,51.01%,34.73%,1
桃園市,龜山區,0235,500,178,678,23,701,1258,55.72%,39.75%,1
桃園市,龜山區,0236,534,196,730,15,745,1464,50.89%,36.48%,1
桃園市,龜山區,0237,631,265,896,41,937,1844,50.81%,34.22%,1
桃園市,龜山區,0238,402,190,592,20,612,1169,52.35%,34.39%,1
桃園市,龜山區,0239,532,221,753,21,774,1921,40.29%,27.69%,1
桃園市,龜山區,0240,553,228,781,28,809,1694,47.76%,32.64%,1
桃園市,龜山區,0241,652,295,947,42,989,1771,55.84%,36.82%,1
桃園市,龜山區,0242,537,205,742,45,787,1665,47.27%,32.25%,1
桃園市,龜山區,0243,499,209,708,29,737,1439,51.22%,34.68%,1
桃園市,龜山區,0244,548,199,747,41,788,1728,45.6%,31.71%,1
桃園市,龜山區,0245,669,236,905,29,934,1788,52.24%,37.42%,1
桃園市,龜山區,0246,488,184,672,30,702,1465,47.92%,33.31%,1
桃園市,龜山區,0247,481,180,661,34,695,1659,41.89%,28.99%,1
桃園市,龜山區,0248,524,198,722,26,748,1693,44.18%,30.95%,1
桃園市,龜山區,0249,480,219,699,9,708,1818,38.94%,26.4%,1
桃園市,龜山區,0250,613,246,859,38,897,1752,51.2%,34.99%,1
桃園市,龜山區,0251,643,268,911,27,938,1818,51.6%,35.37%,1
桃園市,龜山區,0252,517,229,746,14,760,1499,50.7%,34.49%,1
桃園市,龜山區,0253,676,282,958,29,987,1916,51.51%,35.28%,1
桃園市,龜山區,0254,622,281,903,21,924,1804,51.22%,34.48%,1
桃園市,龜山區,0255,697,309,1006,22,1028,2127,48.33%,32.77%,1
桃園市,龜山區,0256,342,139,481,58,539,1005,53.63%,34.03%,1
桃園市,龜山區,0257,514,221,735,31,766,1449,52.86%,35.47%,1
桃園市,龜山區,0258,469,213,682,47,729,1498,48.66%,31.31%,1
桃園市,龜山區,0259,681,251,932,38,970,2149,45.14%,31.69%,1
桃園市,龜山區,0260,511,180,691,22,713,1771,40.26%,28.85%,1
桃園市,龜山區,0261,308,116,424,20,444,841,52.79%,36.62%,1
桃園市,龜山區,0262,748,253,1001,45,1046,2284,45.8%,32.75%,1
桃園市,龜山區,0263,474,146,620,36,656,1228,53.42%,38.6%,1
桃園市,龜山區,0264,676,214,890,17,907,1979,45.83%,34.16%,1
桃園市,龜山區,0265,486,136,622,32,654,1378,47.46%,35.27%,1
桃園市,龜山區,0266,373,133,506,30,536,1061,50.52%,35.16%,1
桃園市,龜山區,0267,655,236,891,34,925,1917,48.25%,34.17%,1
桃園市,龜山區,0268,641,229,870,33,903,1540,58.64%,41.62%,1
桃園市,龜山區,0269,543,211,754,24,778,1433,54.29%,37.89%,1
桃園市,龜山區,0270,503,218,721,23,744,1455,51.13%,34.57%,1
桃園市,龜山區,0271,844,335,1179,42,1221,2280,53.55%,37.02%,1
桃園市,龜山區,0272,588,236,824,33,857,1668,51.38%,35.25%,1
桃園市,龜山區,0273,645,263,908,26,934,1885,49.55%,34.22%,1
桃園市,龜山區,0274,503,384,887,18,905,1849,48.95%,27.2%,1
桃園市,龜山區,0275,514,418,932,13,945,1704,55.46%,30.16%,1
桃園市,龜山區,0276,430,161,591,27,618,1156,53.46%,37.2%,1
桃園市,龜山區,0277,616,254,870,33,903,2114,42.72%,29.14%,1
桃園市,龜山區,0278,562,259,821,27,848,1943,43.64%,28.92%,1
桃園市,龜山區,0279,520,298,818,20,838,1800,46.56%,28.89%,1
桃園市,龜山區,0280,577,347,924,51,975,2020,48.27%,28.56%,1
桃園市,龜山區,0281,500,216,716,18,734,1319,55.65%,37.91%,1
桃園市,龜山區,0282,787,364,1151,28,1179,2229,52.89%,35.31%,1
桃園市,龜山區,0283,624,308,932,22,954,1992,47.89%,31.33%,1
桃園市,龜山區,0284,682,334,1016,39,1055,2237,47.16%,30.49%,1
桃園市,龜山區,0285,678,334,1012,18,1030,2133,48.29%,31.79%,1
桃園市,龜山區,0286,723,356,1079,27,1106,2187,50.57%,33.06%,1
桃園市,龜山區,0287,619,282,901,22,923,1959,47.12%,31.6%,1
桃園市,龜山區,0288,561,311,872,22,894,1910,46.81%,29.37%,1
桃園市,龜山區,0289,671,273,944,37,981,1840,53.32%,36.47%,1
桃園市,龜山區,0290,822,283,1105,30,1135,2266,50.09%,36.28%,1
桃園市,龜山區,0291,751,356,1107,22,1129,2387,47.3%,31.46%,1
桃園市,龜山區,0292,542,254,796,23,819,1692,48.4%,32.03%,1
桃園市,龜山區,0293,293,165,458,10,468,904,51.77%,32.41%,1
桃園市,龜山區,0294,510,257,767,18,785,1469,53.44%,34.72%,1
桃園市,八德區,0295,567,219,786,43,829,1761,47.08%,32.2%,1
桃園市,八德區,0296,485,243,728,12,740,1804,41.02%,26.88%,1
桃園市,八德區,0297,343,154,497,15,512,1813,28.24%,18.92%,1
桃園市,八德區,0298,583,229,812,24,836,1784,46.86%,32.68%,1
桃園市,八德區,0299,682,248,930,24,954,2257,42.27%,30.22%,1
桃園市,八德區,0300,577,197,774,26,800,1857,43.08%,31.07%,1
桃園市,八德區,0301,684,284,968,27,995,2261,44.01%,30.25%,1
桃園市,八德區,0302,700,250,950,39,989,1903,51.97%,36.78%,1
桃園市,八德區,0303,704,223,927,53,980,1955,50.13%,36.01%,1
桃園市,八德區,0304,502,220,722,15,737,1665,44.26%,30.15%,1
桃園市,八德區,0305,508,225,733,44,777,1431,54.3%,35.5%,1
桃園市,八德區,0306,419,259,678,25,703,1263,55.66%,33.17%,1
桃園市,八德區,0307,644,226,870,33,903,1583,57.04%,40.68%,1
桃園市,八德區,0308,491,168,659,25,684,1246,54.9%,39.41%,1
桃園市,八德區,0309,515,180,695,34,729,1356,53.76%,37.98%,1
桃園市,八德區,0310,621,217,838,59,897,1630,55.03%,38.1%,1
桃園市,八德區,0311,599,189,788,19,807,1586,50.88%,37.77%,1
桃園市,八德區,0312,606,209,815,53,868,1649,52.64%,36.75%,1
桃園市,八德區,0313,622,211,833,62,895,1910,46.86%,32.57%,1
桃園市,八德區,0314,631,205,836,62,898,1612,55.71%,39.14%,1
桃園市,八德區,0315,613,208,821,35,856,1640,52.2%,37.38%,1
桃園市,八德區,0316,470,174,644,31,675,1303,51.8%,36.07%,1
桃園市,八德區,0317,537,234,771,38,809,1413,57.25%,38%,1
桃園市,八德區,0318,615,229,844,30,874,1711,51.08%,35.94%,1
桃園市,八德區,0319,706,110,816,29,845,1562,54.1%,45.2%,1
桃園市,八德區,0320,645,213,858,26,884,1735,50.95%,37.18%,1
桃園市,八德區,0321,583,239,822,25,847,1658,51.09%,35.16%,1
桃園市,八德區,0322,462,133,595,21,616,1022,60.27%,45.21%,1
桃園市,八德區,0323,556,179,735,39,774,1673,46.26%,33.23%,1
桃園市,八德區,0324,618,209,827,30,857,1741,49.22%,35.5%,1
桃園市,八德區,0325,777,238,1015,54,1069,2110,50.66%,36.82%,1
桃園市,八德區,0326,457,120,577,29,606,1145,52.93%,39.91%,1
桃園市,八德區,0327,481,112,593,29,622,1010,61.58%,47.62%,1
桃園市,八德區,0328,581,221,802,20,822,1848,44.48%,31.44%,1
桃園市,八德區,0329,525,181,706,23,729,1334,54.65%,39.36%,1
桃園市,八德區,0330,408,155,563,29,592,1349,43.88%,30.24%,1
桃園市,八德區,0331,514,226,740,30,770,1341,57.42%,38.33%,1
桃園市,八德區,0332,514,141,655,33,688,1178,58.4%,43.63%,1
桃園市,八德區,0333,518,195,713,34,747,1374,54.37%,37.7%,1
桃園市,八德區,0334,485,206,691,52,743,1462,50.82%,33.17%,1
桃園市,八德區,0335,626,206,832,34,866,1943,44.57%,32.22%,1
桃園市,八德區,0336,479,220,699,62,761,1928,39.47%,24.84%,1
桃園市,八德區,0337,496,176,672,15,687,1403,48.97%,35.35%,1
桃園市,八德區,0338,558,213,771,27,798,1672,47.73%,33.37%,1
桃園市,八德區,0339,616,264,880,40,920,1947,47.25%,31.64%,1
桃園市,八德區,0340,466,159,625,34,659,1200,54.92%,38.83%,1
桃園市,八德區,0341,634,223,857,40,897,1895,47.34%,33.46%,1
桃園市,八德區,0342,597,272,869,35,904,1988,45.47%,30.03%,1
桃園市,八德區,0343,738,266,1004,56,1060,2006,52.84%,36.79%,1
桃園市,八德區,0344,664,256,920,8,928,2061,45.03%,32.22%,1
桃園市,八德區,0345,665,261,926,45,971,2108,46.06%,31.55%,1
桃園市,八德區,0346,620,218,838,46,884,1862,47.48%,33.3%,1
桃園市,八德區,0347,597,216,813,19,832,1681,49.49%,35.51%,1
桃園市,八德區,0348,515,163,678,45,723,1317,54.9%,39.1%,1
桃園市,八德區,0349,716,325,1041,30,1071,2093,51.17%,34.21%,1
桃園市,八德區,0350,642,198,840,24,864,1499,57.64%,42.83%,1
桃園市,八德區,0351,628,240,868,38,906,1782,50.84%,35.24%,1
桃園市,八德區,0352,647,249,896,13,909,1763,51.56%,36.7%,1
桃園市,八德區,0353,466,165,631,43,674,1226,54.98%,38.01%,1
桃園市,八德區,0354,489,204,693,27,720,1311,54.92%,37.3%,1
桃園市,八德區,0355,450,200,650,22,672,1170,57.44%,38.46%,1
桃園市,八德區,0356,524,178,702,29,731,1313,55.67%,39.91%,1
桃園市,八德區,0357,454,180,634,20,654,1186,55.14%,38.28%,1
桃園市,八德區,0358,493,203,696,26,722,1481,48.75%,33.29%,1
桃園市,八德區,0359,700,296,996,30,1026,1998,51.35%,35.04%,1
桃園市,八德區,0360,359,134,493,22,515,916,56.22%,39.19%,1
桃園市,八德區,0361,661,241,902,25,927,1943,47.71%,34.02%,1
桃園市,八德區,0362,689,249,938,31,969,2076,46.68%,33.19%,1
桃園市,八德區,0363,514,175,689,47,736,1363,54%,37.71%,1
桃園市,八德區,0364,550,181,731,58,789,1491,52.92%,36.89%,1
桃園市,八德區,0365,543,179,722,41,763,1474,51.76%,36.84%,1
桃園市,八德區,0366,142,21,163,12,175,718,24.37%,19.78%,1
桃園市,八德區,0367,512,182,694,42,736,1386,53.1%,36.94%,1
桃園市,八德區,0368,544,184,728,47,775,1487,52.12%,36.58%,1
桃園市,八德區,0369,600,162,762,55,817,1552,52.64%,38.66%,1
桃園市,八德區,0370,473,117,590,31,621,1255,49.48%,37.69%,1
桃園市,八德區,0371,576,229,805,41,846,1505,56.21%,38.27%,1
桃園市,八德區,0372,495,181,676,27,703,1436,48.96%,34.47%,1
桃園市,八德區,0373,573,258,831,51,882,1618,54.51%,35.41%,1
桃園市,八德區,0374,622,192,814,44,858,1685,50.92%,36.91%,1
桃園市,八德區,0375,577,239,816,37,853,1835,46.49%,31.44%,1
桃園市,八德區,0376,665,242,907,43,950,1881,50.51%,35.35%,1
桃園市,八德區,0377,625,205,830,37,867,1766,49.09%,35.39%,1
桃園市,八德區,0378,634,238,872,54,926,1817,50.96%,34.89%,1
桃園市,八德區,0379,800,307,1107,26,1133,2198,51.55%,36.4%,1
桃園市,八德區,0380,608,270,878,29,907,1732,52.37%,35.1%,1
桃園市,八德區,0381,708,348,1056,14,1070,2089,51.22%,33.89%,1
桃園市,八德區,0382,508,185,693,33,726,1257,57.76%,40.41%,1
桃園市,八德區,0383,442,177,619,36,655,1267,51.7%,34.89%,1
桃園市,八德區,0384,548,213,761,18,779,1427,54.59%,38.4%,1
桃園市,八德區,0385,668,268,936,36,972,1685,57.69%,39.64%,1
桃園市,八德區,0386,656,253,909,37,946,1748,54.12%,37.53%,1
桃園市,八德區,0387,844,256,1100,50,1150,1650,69.7%,51.15%,1
桃園市,八德區,0388,538,232,770,39,809,1478,54.74%,36.4%,1
桃園市,八德區,0389,613,214,827,45,872,1607,54.26%,38.15%,1
桃園市,八德區,0390,702,266,968,58,1026,1841,55.73%,38.13%,1
桃園市,八德區,0391,720,308,1028,33,1061,2082,50.96%,34.58%,1
桃園市,八德區,0392,650,224,874,39,913,1959,46.61%,33.18%,1
桃園市,八德區,0393,752,338,1090,49,1139,2209,51.56%,34.04%,1
桃園市,八德區,0394,687,267,954,38,992,1864,53.22%,36.86%,1
桃園市,八德區,0395,644,300,944,35,979,2000,48.95%,32.2%,1
桃園市,龍潭區,1008,594,168,762,20,782,1482,52.77%,40.08%,1
桃園市,龍潭區,1009,549,198,747,28,775,1528,50.72%,35.93%,1
桃園市,龍潭區,1010,600,176,776,29,805,1503,53.56%,39.92%,1
桃園市,龍潭區,1011,586,177,763,31,794,1568,50.64%,37.37%,1
桃園市,龍潭區,1012,465,129,594,37,631,1216,51.89%,38.24%,1
桃園市,龍潭區,1013,670,228,898,51,949,2088,45.45%,32.09%,1
桃園市,龍潭區,1014,799,273,1072,41,1113,1987,56.01%,40.21%,1
桃園市,龍潭區,1015,654,236,890,27,917,1586,57.82%,41.24%,1
桃園市,龍潭區,1016,455,154,609,24,633,1221,51.84%,37.26%,1
桃園市,龍潭區,1017,497,130,627,20,647,1134,57.05%,43.83%,1
桃園市,龍潭區,1018,742,235,977,32,1009,2081,48.49%,35.66%,1
桃園市,龍潭區,1019,692,213,905,29,934,1925,48.52%,35.95%,1
桃園市,龍潭區,1020,808,314,1122,20,1142,2095,54.51%,38.57%,1
桃園市,龍潭區,1021,838,298,1136,26,1162,2040,56.96%,41.08%,1
桃園市,龍潭區,1022,647,212,859,33,892,1790,49.83%,36.15%,1
桃園市,龍潭區,1023,737,243,980,42,1022,1872,54.59%,39.37%,1
桃園市,龍潭區,1024,719,222,941,32,973,1726,56.37%,41.66%,1
桃園市,龍潭區,1025,742,197,939,41,980,1792,54.69%,41.41%,1
桃園市,龍潭區,1026,577,174,751,23,774,1398,55.36%,41.27%,1
桃園市,龍潭區,1027,513,150,663,19,682,1345,50.71%,38.14%,1
桃園市,龍潭區,1028,554,178,732,38,770,1409,54.65%,39.32%,1
桃園市,龍潭區,1029,460,203,663,15,678,1362,49.78%,33.77%,1
桃園市,龍潭區,1030,688,216,904,38,942,1650,57.09%,41.7%,1
桃園市,龍潭區,1031,639,170,809,22,831,1597,52.04%,40.01%,1
桃園市,龍潭區,1032,549,184,733,17,750,1410,53.19%,38.94%,1
桃園市,龍潭區,1033,509,176,685,27,712,1275,55.84%,39.92%,1
桃園市,龍潭區,1034,787,295,1082,37,1119,1909,58.62%,41.23%,1
桃園市,龍潭區,1035,822,277,1099,20,1119,2024,55.29%,40.61%,1
桃園市,龍潭區,1036,786,257,1043,35,1078,2002,53.85%,39.26%,1
桃園市,龍潭區,1037,729,261,990,26,1016,1786,56.89%,40.82%,1
桃園市,龍潭區,1038,695,244,939,15,954,1756,54.33%,39.58%,1
桃園市,龍潭區,1039,766,242,1008,16,1024,1830,55.96%,41.86%,1
桃園市,龍潭區,1040,738,246,984,20,1004,1697,59.16%,43.49%,1
桃園市,龍潭區,1041,628,205,833,28,861,1519,56.68%,41.34%,1
桃園市,龍潭區,1042,681,201,882,41,923,1805,51.14%,37.73%,1
桃園市,龍潭區,1043,630,167,797,15,812,1792,45.31%,35.16%,1
桃園市,龍潭區,1044,702,142,844,39,883,1500,58.87%,46.8%,1
桃園市,龍潭區,1045,531,169,700,17,717,1427,50.25%,37.21%,1
桃園市,龍潭區,1046,472,145,617,34,651,1444,45.08%,32.69%,1
桃園市,龍潭區,1047,499,144,643,28,671,1321,50.79%,37.77%,1
桃園市,龍潭區,1048,503,197,700,33,733,1215,60.33%,41.4%,1
桃園市,龍潭區,1049,499,147,646,47,693,1297,53.43%,38.47%,1
桃園市,龍潭區,1050,534,161,695,16,711,1407,50.53%,37.95%,1
桃園市,龍潭區,1051,567,180,747,28,775,1564,49.55%,36.25%,1
桃園市,龍潭區,1052,524,150,674,27,701,1317,53.23%,39.79%,1
桃園市,龍潭區,1053,392,98,490,18,508,1023,49.66%,38.32%,1
桃園市,龍潭區,1054,701,231,932,32,964,1721,56.01%,40.73%,1
桃園市,龍潭區,1055,727,220,947,28,975,1764,55.27%,41.21%,1
桃園市,龍潭區,1056,624,163,787,37,824,1499,54.97%,41.63%,1
桃園市,龍潭區,1057,764,242,1006,25,1031,2151,47.93%,35.52%,1
桃園市,龍潭區,1058,650,201,851,15,866,1524,56.82%,42.65%,1
桃園市,龍潭區,1059,623,235,858,21,879,1456,60.37%,42.79%,1
桃園市,龍潭區,1060,854,227,1081,31,1112,1847,60.21%,46.24%,1
桃園市,龍潭區,1061,901,230,1131,31,1162,1899,61.19%,47.45%,1
桃園市,龍潭區,1062,740,173,913,32,945,1725,54.78%,42.9%,1
桃園市,龍潭區,1063,748,223,971,44,1015,1665,60.96%,44.92%,1
桃園市,龍潭區,1064,584,215,799,30,829,1649,50.27%,35.42%,1
桃園市,龍潭區,1065,582,154,736,26,762,1539,49.51%,37.82%,1
桃園市,龍潭區,1066,662,197,859,35,894,1541,58.01%,42.96%,1
桃園市,龍潭區,1067,517,204,721,33,754,1375,54.84%,37.6%,1
桃園市,龍潭區,1068,566,202,768,19,787,1453,54.16%,38.95%,1
桃園市,龍潭區,1069,443,148,591,23,614,1074,57.17%,41.25%,1
桃園市,龍潭區,1070,512,232,744,16,760,1299,58.51%,39.41%,1
桃園市,龍潭區,1071,262,66,328,17,345,678,50.88%,38.64%,1
桃園市,平鎮區,0801,533,163,696,35,731,1487,49.16%,35.84%,1
桃園市,平鎮區,0802,565,170,735,26,761,1453,52.37%,38.89%,1
桃園市,平鎮區,0803,562,218,780,36,816,1491,54.73%,37.69%,1
桃園市,平鎮區,0804,488,181,669,35,704,1346,52.3%,36.26%,1
桃園市,平鎮區,0805,638,190,828,25,853,1660,51.39%,38.43%,1
桃園市,平鎮區,0806,702,200,902,35,937,1921,48.78%,36.54%,1
桃園市,平鎮區,0807,775,262,1037,35,1072,1974,54.31%,39.26%,1
桃園市,平鎮區,0808,674,234,908,30,938,1867,50.24%,36.1%,1
桃園市,平鎮區,0809,687,230,917,10,927,1786,51.9%,38.47%,1
桃園市,平鎮區,0810,487,174,661,23,684,1634,41.86%,29.8%,1
桃園市,平鎮區,0811,435,148,583,29,612,1080,56.67%,40.28%,1
桃園市,平鎮區,0812,667,114,781,22,803,1514,53.04%,44.06%,1
桃園市,平鎮區,0813,623,223,846,42,888,1918,46.3%,32.48%,1
桃園市,平鎮區,0814,482,137,619,47,666,1182,56.35%,40.78%,1
桃園市,平鎮區,0815,572,209,781,23,804,1667,48.23%,34.31%,1
桃園市,平鎮區,0816,549,194,743,23,766,1640,46.71%,33.48%,1
桃園市,平鎮區,0817,707,106,813,29,842,1603,52.53%,44.1%,1
桃園市,平鎮區,0818,648,211,859,18,877,1556,56.36%,41.65%,1
桃園市,平鎮區,0819,641,205,846,18,864,1697,50.91%,37.77%,1
桃園市,平鎮區,0820,437,127,564,16,580,1130,51.33%,38.67%,1
桃園市,平鎮區,0821,490,147,637,22,659,1196,55.1%,40.97%,1
桃園市,平鎮區,0822,641,218,859,27,886,1685,52.58%,38.04%,1
桃園市,平鎮區,0823,605,219,824,37,861,1532,56.2%,39.49%,1
桃園市,平鎮區,0824,613,192,805,21,826,1564,52.81%,39.19%,1
桃園市,平鎮區,0825,613,185,798,22,820,1824,44.96%,33.61%,1
桃園市,平鎮區,0826,683,244,927,17,944,1912,49.37%,35.72%,1
桃園市,平鎮區,0827,416,128,544,21,565,1048,53.91%,39.69%,1
桃園市,平鎮區,0828,515,152,667,40,707,1259,56.16%,40.91%,1
桃園市,平鎮區,0829,412,121,533,31,564,1061,53.16%,38.83%,1
桃園市,平鎮區,0830,494,126,620,21,641,1072,59.79%,46.08%,1
桃園市,平鎮區,0831,685,206,891,35,926,1788,51.79%,38.31%,1
桃園市,平鎮區,0832,593,180,773,23,796,1510,52.72%,39.27%,1
桃園市,平鎮區,0833,562,150,712,35,747,1403,53.24%,40.06%,1
桃園市,平鎮區,0834,553,184,737,31,768,1407,54.58%,39.3%,1
桃園市,平鎮區,0835,733,253,986,30,1016,1901,53.45%,38.56%,1
桃園市,平鎮區,0836,672,243,915,23,938,1994,47.04%,33.7%,1
桃園市,平鎮區,0837,622,252,874,30,904,1730,52.25%,35.95%,1
桃園市,平鎮區,0838,702,290,992,22,1014,1905,53.23%,36.85%,1
桃園市,平鎮區,0839,648,282,930,19,949,1723,55.08%,37.61%,1
桃園市,平鎮區,0840,549,155,704,31,735,1307,56.24%,42%,1
桃園市,平鎮區,0841,517,201,718,31,749,1337,56.02%,38.67%,1
桃園市,平鎮區,0842,440,180,620,20,640,980,65.31%,44.9%,1
桃園市,平鎮區,0843,616,290,906,28,934,1818,51.38%,33.88%,1
桃園市,平鎮區,0844,550,228,778,29,807,1463,55.16%,37.59%,1
桃園市,平鎮區,0845,505,197,702,19,721,1213,59.44%,41.63%,1
桃園市,平鎮區,0846,447,167,614,25,639,1085,58.89%,41.2%,1
桃園市,平鎮區,0847,559,157,716,20,736,1458,50.48%,38.34%,1
桃園市,平鎮區,0848,570,180,750,35,785,1408,55.75%,40.48%,1
桃園市,平鎮區,0849,503,195,698,26,724,1396,51.86%,36.03%,1
桃園市,平鎮區,0850,431,216,647,22,669,1044,64.08%,41.28%,1
桃園市,平鎮區,0851,448,175,623,9,632,1124,56.23%,39.86%,1
桃園市,平鎮區,0852,559,248,807,15,822,1517,54.19%,36.85%,1
桃園市,平鎮區,0853,540,274,814,16,830,1571,52.83%,34.37%,1
桃園市,平鎮區,0854,719,268,987,24,1011,1752,57.71%,41.04%,1
桃園市,平鎮區,0855,603,238,841,26,867,1434,60.46%,42.05%,1
桃園市,平鎮區,0856,636,318,954,29,983,1710,57.49%,37.19%,1
桃園市,平鎮區,0857,608,243,851,23,874,1555,56.21%,39.1%,1
桃園市,平鎮區,0858,688,289,977,18,995,2051,48.51%,33.54%,1
桃園市,平鎮區,0859,524,255,779,12,791,1477,53.55%,35.48%,1
桃園市,平鎮區,0860,589,224,813,16,829,1501,55.23%,39.24%,1
桃園市,平鎮區,0861,568,182,750,33,783,1405,55.73%,40.43%,1
桃園市,平鎮區,0862,636,219,855,45,900,1656,54.35%,38.41%,1
桃園市,平鎮區,0863,637,251,888,18,906,1921,47.16%,33.16%,1
桃園市,平鎮區,0864,608,217,825,21,846,1717,49.27%,35.41%,1
桃園市,平鎮區,0865,496,198,694,26,720,1319,54.59%,37.6%,1
桃園市,平鎮區,0866,611,249,860,32,892,1745,51.12%,35.01%,1
桃園市,平鎮區,0867,659,243,902,42,944,1721,54.85%,38.29%,1
桃園市,平鎮區,0868,479,184,663,15,678,1206,56.22%,39.72%,1
桃園市,平鎮區,0869,511,246,757,23,780,1202,64.89%,42.51%,1
桃園市,平鎮區,0870,500,183,683,22,705,1208,58.36%,41.39%,1
桃園市,平鎮區,0871,539,204,743,24,767,1267,60.54%,42.54%,1
桃園市,平鎮區,0872,415,178,593,22,615,1094,56.22%,37.93%,1
桃園市,平鎮區,0873,575,219,794,30,824,1394,59.11%,41.25%,1
桃園市,平鎮區,0874,499,224,723,12,735,1215,60.49%,41.07%,1
桃園市,平鎮區,0875,424,152,576,14,590,1010,58.42%,41.98%,1
桃園市,平鎮區,0876,555,159,714,17,731,1261,57.97%,44.01%,1
桃園市,平鎮區,0877,556,190,746,26,772,1314,58.75%,42.31%,1
桃園市,平鎮區,0878,298,105,403,19,422,722,58.45%,41.27%,1
桃園市,平鎮區,0879,318,118,436,10,446,839,53.16%,37.9%,1
桃園市,平鎮區,0880,554,202,756,21,777,1399,55.54%,39.6%,1
桃園市,平鎮區,0881,654,305,959,29,988,1968,50.2%,33.23%,1
桃園市,平鎮區,0882,639,240,879,17,896,1672,53.59%,38.22%,1
桃園市,平鎮區,0883,491,137,628,17,645,2213,29.15%,22.19%,1
桃園市,平鎮區,0884,380,194,574,15,589,949,62.07%,40.04%,1
桃園市,平鎮區,0885,623,319,942,26,968,1621,59.72%,38.43%,1
桃園市,平鎮區,0886,571,255,826,15,841,1643,51.19%,34.75%,1
桃園市,平鎮區,0887,672,312,984,27,1011,1844,54.83%,36.44%,1
桃園市,平鎮區,0888,650,270,920,28,948,1752,54.11%,37.1%,1
桃園市,平鎮區,0889,537,201,738,51,789,1577,50.03%,34.05%,1
桃園市,平鎮區,0890,611,212,823,20,843,1517,55.57%,40.28%,1
桃園市,平鎮區,0891,427,158,585,26,611,1039,58.81%,41.1%,1
桃園市,平鎮區,0892,554,194,748,29,777,1318,58.95%,42.03%,1
桃園市,平鎮區,0893,620,213,833,39,872,1636,53.3%,37.9%,1
桃園市,平鎮區,0894,495,219,714,30,744,1316,56.53%,37.61%,1
桃園市,平鎮區,0895,560,247,807,18,825,1474,55.97%,37.99%,1
桃園市,平鎮區,0896,514,165,679,33,712,1480,48.11%,34.73%,1
桃園市,平鎮區,0897,536,158,694,16,710,1330,53.38%,40.3%,1
桃園市,平鎮區,0898,465,187,652,29,681,1228,55.46%,37.87%,1
桃園市,平鎮區,0899,554,230,784,30,814,1377,59.11%,40.23%,1
桃園市,平鎮區,0900,517,195,712,19,731,1198,61.02%,43.16%,1
桃園市,平鎮區,0901,549,180,729,21,750,1231,60.93%,44.6%,1
桃園市,平鎮區,0902,493,176,669,46,715,1243,57.52%,39.66%,1
桃園市,平鎮區,0903,626,193,819,23,842,1590,52.96%,39.37%,1
桃園市,平鎮區,0904,550,163,713,28,741,1366,54.25%,40.26%,1
桃園市,平鎮區,0905,535,147,682,38,720,1332,54.05%,40.17%,1
桃園市,平鎮區,0906,485,80,565,24,589,1201,49.04%,40.38%,1
桃園市,平鎮區,0907,569,195,764,23,787,1668,47.18%,34.11%,1
桃園市,平鎮區,0908,515,138,653,32,685,1351,50.7%,38.12%,1
桃園市,平鎮區,0909,518,177,695,18,713,1460,48.84%,35.48%,1
桃園市,平鎮區,0910,712,208,920,22,942,1841,51.17%,38.67%,1
桃園市,平鎮區,0911,526,184,710,15,725,1475,49.15%,35.66%,1
桃園市,平鎮區,0912,436,112,548,13,561,1011,55.49%,43.13%,1
桃園市,平鎮區,0913,386,111,497,24,521,1052,49.52%,36.69%,1
桃園市,平鎮區,0914,498,165,663,43,706,1154,61.18%,43.15%,1
桃園市,平鎮區,0915,619,191,810,17,827,1645,50.27%,37.63%,1
桃園市,平鎮區,0916,549,190,739,34,773,1539,50.23%,35.67%,1
桃園市,平鎮區,0917,506,192,698,49,747,1385,53.94%,36.53%,1
桃園市,平鎮區,0918,554,169,723,27,750,1395,53.76%,39.71%,1
桃園市,平鎮區,0919,643,201,844,22,866,1711,50.61%,37.58%,1
桃園市,平鎮區,0920,579,215,794,42,836,1631,51.26%,35.5%,1
桃園市,平鎮區,0921,415,183,598,21,619,1110,55.77%,37.39%,1
桃園市,平鎮區,0922,819,225,1044,18,1062,1931,55%,42.41%,1
桃園市,平鎮區,0923,446,153,599,23,622,1127,55.19%,39.57%,1
桃園市,平鎮區,0924,578,166,744,37,781,1414,55.23%,40.88%,1
桃園市,平鎮區,0925,648,184,832,21,853,1609,53.01%,40.27%,1
桃園市,新屋區,1072,578,183,761,18,779,1306,59.65%,44.26%,1
桃園市,新屋區,1073,614,217,831,32,863,1556,55.46%,39.46%,1
桃園市,新屋區,1074,800,274,1074,49,1123,1849,60.74%,43.27%,1
桃園市,新屋區,1075,855,319,1174,57,1231,2096,58.73%,40.79%,1
桃園市,新屋區,1076,574,181,755,42,797,1517,52.54%,37.84%,1
桃園市,新屋區,1077,848,288,1136,57,1193,2095,56.95%,40.48%,1
桃園市,新屋區,1078,652,198,850,35,885,1856,47.68%,35.13%,1
桃園市,新屋區,1079,821,221,1042,55,1097,1986,55.24%,41.34%,1
桃園市,新屋區,1080,528,161,689,20,709,1425,49.75%,37.05%,1
桃園市,新屋區,1081,517,152,669,28,697,1385,50.32%,37.33%,1
桃園市,新屋區,1082,541,200,741,40,781,1271,61.45%,42.56%,1
桃園市,新屋區,1083,502,142,644,39,683,1271,53.74%,39.5%,1
桃園市,新屋區,1084,494,174,668,39,707,1234,57.29%,40.03%,1
桃園市,新屋區,1085,432,140,572,35,607,1085,55.94%,39.82%,1
桃園市,新屋區,1086,866,257,1123,29,1152,1992,57.83%,43.47%,1
桃園市,新屋區,1087,849,298,1147,48,1195,2032,58.81%,41.78%,1
桃園市,新屋區,1088,522,123,645,63,708,1291,54.84%,40.43%,1
桃園市,新屋區,1089,549,151,700,31,731,1401,52.18%,39.19%,1
桃園市,新屋區,1090,472,144,616,31,647,1106,58.5%,42.68%,1
桃園市,新屋區,1091,383,115,498,11,509,908,56.06%,42.18%,1
桃園市,新屋區,1092,295,89,384,24,408,663,61.54%,44.49%,1
桃園市,新屋區,1093,456,97,553,34,587,1088,53.95%,41.91%,1
桃園市,新屋區,1094,511,109,620,47,667,1050,63.52%,48.67%,1
桃園市,新屋區,1095,407,103,510,16,526,896,58.71%,45.42%,1
桃園市,新屋區,1096,565,185,750,69,819,1369,59.82%,41.27%,1
桃園市,新屋區,1097,371,96,467,41,508,995,51.06%,37.29%,1
桃園市,新屋區,1098,332,84,416,19,435,741,58.7%,44.8%,1
桃園市,新屋區,1099,408,134,542,40,582,943,61.72%,43.27%,1
桃園市,新屋區,1100,704,165,869,37,906,1714,52.86%,41.07%,1
桃園市,新屋區,1101,567,147,714,20,734,1340,54.78%,42.31%,1
桃園市,觀音區,1102,475,151,626,28,654,1371,47.7%,34.65%,1
桃園市,觀音區,1103,425,139,564,22,586,1362,43.02%,31.2%,1
桃園市,觀音區,1104,344,136,480,53,533,997,53.46%,34.5%,1
桃園市,觀音區,1105,510,151,661,27,688,1407,48.9%,36.25%,1
桃園市,觀音區,1106,634,234,868,33,901,1692,53.25%,37.47%,1
桃園市,觀音區,1107,520,140,660,12,672,1279,52.54%,40.66%,1
桃園市,觀音區,1108,310,94,404,15,419,791,52.97%,39.19%,1
桃園市,觀音區,1109,372,116,488,18,506,892,56.73%,41.7%,1
桃園市,觀音區,1110,389,122,511,21,532,886,60.05%,43.91%,1
桃園市,觀音區,1111,293,82,375,26,401,712,56.32%,41.15%,1
桃園市,觀音區,1112,575,178,753,63,816,1609,50.71%,35.74%,1
桃園市,觀音區,1113,486,179,665,41,706,1274,55.42%,38.15%,1
桃園市,觀音區,1114,429,145,574,31,605,1351,44.78%,31.75%,1
桃園市,觀音區,1115,511,195,706,23,729,1262,57.77%,40.49%,1
桃園市,觀音區,1116,502,170,672,33,705,1242,56.76%,40.42%,1
桃園市,觀音區,1117,531,215,746,29,775,1461,53.05%,36.34%,1
桃園市,觀音區,1118,596,217,813,34,847,1613,52.51%,36.95%,1
桃園市,觀音區,1119,589,191,780,29,809,1479,54.7%,39.82%,1
桃園市,觀音區,1120,524,199,723,24,747,1552,48.13%,33.76%,1
桃園市,觀音區,1121,569,206,775,15,790,1517,52.08%,37.51%,1
桃園市,觀音區,1122,573,229,802,32,834,1691,49.32%,33.89%,1
桃園市,觀音區,1123,468,164,632,18,650,1157,56.18%,40.45%,1
桃園市,觀音區,1124,527,183,710,40,750,1455,51.55%,36.22%,1
桃園市,觀音區,1125,470,127,597,14,611,1150,53.13%,40.87%,1
桃園市,觀音區,1126,459,140,599,25,624,1112,56.12%,41.28%,1
桃園市,觀音區,1127,458,152,610,13,623,1251,49.8%,36.61%,1
桃園市,觀音區,1128,526,193,719,51,770,1446,53.25%,36.38%,1
桃園市,觀音區,1129,542,207,749,44,793,1493,53.11%,36.3%,1
桃園市,觀音區,1130,500,184,684,25,709,1339,52.95%,37.34%,1
桃園市,觀音區,1131,489,146,635,34,669,1137,58.84%,43.01%,1
桃園市,觀音區,1132,396,113,509,22,531,1043,50.91%,37.97%,1
桃園市,觀音區,1133,331,113,444,18,462,993,46.53%,33.33%,1
桃園市,觀音區,1134,353,132,485,19,504,975,51.69%,36.21%,1
桃園市,觀音區,1135,631,239,870,36,906,2029,44.65%,31.1%,1
桃園市,觀音區,1136,673,262,935,33,968,1765,54.84%,38.13%,1
桃園市,觀音區,1137,670,230,900,29,929,1809,51.35%,37.04%,1
桃園市,觀音區,1138,665,221,886,30,916,1869,49.01%,35.58%,1
桃園市,觀音區,1139,597,176,773,43,816,1870,43.64%,31.93%,1
桃園市,觀音區,1140,495,179,674,23,697,1932,36.08%,25.62%,1
桃園市,觀音區,1141,311,101,412,6,418,899,46.5%,34.59%,1
桃園市,觀音區,1142,313,101,414,17,431,985,43.76%,31.78%,1
桃園市,復興區,0581,902,160,1062,70,1132,1991,56.86%,45.3%,1
桃園市,復興區,0582,656,118,774,26,800,1392,57.47%,47.13%,1
桃園市,復興區,0583,272,52,324,10,334,564,59.22%,48.23%,1
桃園市,復興區,0584,339,70,409,19,428,716,59.78%,47.35%,1
桃園市,復興區,0585,539,71,610,39,649,1016,63.88%,53.05%,1
桃園市,復興區,0586,230,71,301,8,309,669,46.19%,34.38%,1
桃園市,復興區,0587,327,53,380,13,393,760,51.71%,43.03%,1
桃園市,復興區,0588,364,58,422,18,440,751,58.59%,48.47%,1
桃園市,復興區,0589,331,50,381,15,396,683,57.98%,48.46%,1
桃園市,復興區,0590,633,59,692,17,709,1224,57.92%,51.72%,1
臺中市,中區,1070,691,275,966,61,1027,1652,62.17%,41.83%,1
臺中市,中區,1071,611,230,841,21,862,1531,56.3%,39.91%,1
臺中市,中區,1072,604,108,712,35,747,1431,52.2%,42.21%,1
臺中市,中區,1073,430,155,585,30,615,1060,58.02%,40.57%,1
臺中市,中區,1074,393,139,532,21,553,982,56.31%,40.02%,1
臺中市,中區,1075,480,173,653,51,704,1191,59.11%,40.3%,1
臺中市,中區,1076,338,138,476,20,496,855,58.01%,39.53%,1
臺中市,中區,1077,389,124,513,34,547,1135,48.19%,34.27%,1
臺中市,中區,1078,324,96,420,11,431,705,61.13%,45.96%,1
臺中市,中區,1079,435,150,585,29,614,1009,60.85%,43.11%,1
臺中市,中區,1080,511,172,683,51,734,1304,56.29%,39.19%,1
臺中市,中區,1081,658,232,890,26,916,1841,49.76%,35.74%,1
臺中市,東區,1148,309,129,438,21,459,1138,40.33%,27.15%,1
臺中市,東區,1149,430,140,570,16,586,984,59.55%,43.7%,1
臺中市,東區,1150,376,114,490,34,524,877,59.75%,42.87%,1
臺中市,東區,1151,467,184,651,33,684,1070,63.93%,43.64%,1
臺中市,東區,1152,459,184,643,44,687,1106,62.12%,41.5%,1
臺中市,東區,1153,410,133,543,39,582,953,61.07%,43.02%,1
臺中市,東區,1154,540,187,727,27,754,1195,63.1%,45.19%,1
臺中市,東區,1155,523,169,692,35,727,1251,58.11%,41.81%,1
臺中市,東區,1156,509,178,687,34,721,1190,60.59%,42.77%,1
臺中市,東區,1157,629,110,739,55,794,1394,56.96%,45.12%,1
臺中市,東區,1158,619,235,854,46,900,1443,62.37%,42.9%,1
臺中市,東區,1159,337,100,437,35,472,762,61.94%,44.23%,1
臺中市,東區,1160,516,195,711,32,743,1140,65.18%,45.26%,1
臺中市,東區,1161,523,179,702,49,751,1211,62.01%,43.19%,1
臺中市,東區,1162,332,134,466,20,486,755,64.37%,43.97%,1
臺中市,東區,1163,595,215,810,41,851,1491,57.08%,39.91%,1
臺中市,東區,1164,434,125,559,23,582,1000,58.2%,43.4%,1
臺中市,東區,1165,471,180,651,37,688,1114,61.76%,42.28%,1
臺中市,東區,1166,461,162,623,22,645,1101,58.58%,41.87%,1
臺中市,東區,1167,537,164,701,45,746,1169,63.82%,45.94%,1
臺中市,東區,1168,584,190,774,41,815,1283,63.52%,45.52%,1
臺中市,東區,1169,526,194,720,25,745,1168,63.78%,45.03%,1
臺中市,東區,1170,573,190,763,32,795,1386,57.36%,41.34%,1
臺中市,東區,1171,607,287,894,34,928,1557,59.6%,38.99%,1
臺中市,東區,1172,571,203,774,44,818,1380,59.28%,41.38%,1
臺中市,東區,1173,713,255,968,38,1006,1674,60.1%,42.59%,1
臺中市,東區,1174,671,286,957,44,1001,1604,62.41%,41.83%,1
臺中市,東區,1175,741,316,1057,41,1098,1815,60.5%,40.83%,1
臺中市,東區,1176,671,254,925,43,968,1700,56.94%,39.47%,1
臺中市,東區,1177,645,247,892,27,919,1592,57.73%,40.52%,1
臺中市,東區,1178,716,261,977,46,1023,1850,55.3%,38.7%,1
臺中市,東區,1179,557,173,730,39,769,1252,61.42%,44.49%,1
臺中市,東區,1180,516,241,757,38,795,1250,63.6%,41.28%,1
臺中市,東區,1181,541,178,719,31,750,1241,60.44%,43.59%,1
臺中市,東區,1182,465,204,669,41,710,1318,53.87%,35.28%,1
臺中市,東區,1183,527,171,698,42,740,1288,57.45%,40.92%,1
臺中市,東區,1184,631,233,864,47,911,1442,63.18%,43.76%,1
臺中市,東區,1185,482,189,671,47,718,1202,59.73%,40.1%,1
臺中市,東區,1186,620,177,797,59,856,1452,58.95%,42.7%,1
臺中市,東區,1187,581,224,805,34,839,1480,56.69%,39.26%,1
臺中市,東區,1188,724,220,944,46,990,1736,57.03%,41.71%,1
臺中市,東區,1189,335,134,469,26,495,867,57.09%,38.64%,1
臺中市,東區,1190,670,189,859,43,902,1693,53.28%,39.57%,1
臺中市,東區,1191,670,231,901,53,954,1538,62.03%,43.56%,1
臺中市,東區,1192,666,282,948,53,1001,1593,62.84%,41.81%,1
臺中市,東區,1193,565,228,793,21,814,1481,54.96%,38.15%,1
臺中市,東區,1194,611,242,853,32,885,1414,62.59%,43.21%,1
臺中市,東區,1195,538,199,737,29,766,1297,59.06%,41.48%,1
臺中市,東區,1196,593,211,804,37,841,1394,60.33%,42.54%,1
臺中市,南區,1197,398,155,553,25,578,937,61.69%,42.48%,1
臺中市,南區,1198,450,171,621,34,655,1001,65.43%,44.96%,1
臺中市,南區,1199,571,215,786,38,824,1249,65.97%,45.72%,1
臺中市,南區,1200,589,197,786,36,822,1202,68.39%,49%,1
臺中市,南區,1201,495,200,695,28,723,1130,63.98%,43.81%,1
臺中市,南區,1202,560,190,750,37,787,1239,63.52%,45.2%,1
臺中市,南區,1203,498,200,698,34,732,1238,59.13%,40.23%,1
臺中市,南區,1204,540,212,752,37,789,1272,62.03%,42.45%,1
臺中市,南區,1205,547,210,757,24,781,1273,61.35%,42.97%,1
臺中市,南區,1206,540,215,755,53,808,1317,61.35%,41%,1
臺中市,南區,1207,546,221,767,30,797,1160,68.71%,47.07%,1
臺中市,南區,1208,510,240,750,46,796,1205,66.06%,42.32%,1
臺中市,南區,1209,469,187,656,33,689,1111,62.02%,42.21%,1
臺中市,南區,1210,668,282,950,26,976,1407,69.37%,47.48%,1
臺中市,南區,1211,587,237,824,31,855,1419,60.25%,41.37%,1
臺中市,南區,1212,517,187,704,34,738,1157,63.79%,44.68%,1
臺中市,南區,1213,557,239,796,46,842,1415,59.51%,39.36%,1
臺中市,南區,1214,593,210,803,46,849,1289,65.87%,46%,1
臺中市,南區,1215,608,242,850,29,879,1454,60.45%,41.82%,1
臺中市,南區,1216,596,244,840,39,879,1491,58.95%,39.97%,1
臺中市,南區,1217,582,219,801,33,834,1394,59.83%,41.75%,1
臺中市,南區,1218,566,254,820,38,858,1430,60%,39.58%,1
臺中市,南區,1219,591,222,813,34,847,1342,63.11%,44.04%,1
臺中市,南區,1220,614,227,841,43,884,1304,67.79%,47.09%,1
臺中市,南區,1221,520,221,741,33,774,1190,65.04%,43.7%,1
臺中市,南區,1222,546,168,714,47,761,1273,59.78%,42.89%,1
臺中市,南區,1223,604,253,857,46,903,1387,65.1%,43.55%,1
臺中市,南區,1224,560,222,782,39,821,1356,60.55%,41.3%,1
臺中市,南區,1225,572,216,788,39,827,1304,63.42%,43.87%,1
臺中市,南區,1226,560,237,797,24,821,1256,65.37%,44.59%,1
臺中市,南區,1227,571,274,845,24,869,1364,63.71%,41.86%,1
臺中市,南區,1228,563,232,795,57,852,1361,62.6%,41.37%,1
臺中市,南區,1229,582,271,853,22,875,1407,62.19%,41.36%,1
臺中市,南區,1230,562,205,767,37,804,1308,61.47%,42.97%,1
臺中市,南區,1231,500,225,725,25,750,1250,60%,40%,1
臺中市,南區,1232,490,221,711,29,740,1284,57.63%,38.16%,1
臺中市,南區,1233,512,208,720,43,763,1175,64.94%,43.57%,1
臺中市,南區,1234,540,187,727,43,770,1158,66.49%,46.63%,1
臺中市,南區,1235,460,226,686,35,721,1168,61.73%,39.38%,1
臺中市,南區,1236,710,288,998,40,1038,1626,63.84%,43.67%,1
臺中市,南區,1237,601,281,882,28,910,2115,43.03%,28.42%,1
臺中市,南區,1238,693,296,989,27,1016,1805,56.29%,38.39%,1
臺中市,南區,1239,657,269,926,28,954,1695,56.28%,38.76%,1
臺中市,南區,1240,701,314,1015,36,1051,1643,63.97%,42.67%,1
臺中市,南區,1241,600,257,857,36,893,1423,62.75%,42.16%,1
臺中市,南區,1242,632,255,887,43,930,1542,60.31%,40.99%,1
臺中市,南區,1243,604,304,908,27,935,1533,60.99%,39.4%,1
臺中市,南區,1244,649,292,941,49,990,1531,64.66%,42.39%,1
臺中市,南區,1245,605,183,788,24,812,1392,58.33%,43.46%,1
臺中市,南區,1246,614,271,885,28,913,1592,57.35%,38.57%,1
臺中市,南區,1247,596,264,860,39,899,1431,62.82%,41.65%,1
臺中市,南區,1248,665,289,954,33,987,1799,54.86%,36.96%,1
臺中市,南區,1249,760,285,1045,47,1092,1708,63.93%,44.5%,1
臺中市,南區,1250,687,266,953,43,996,1700,58.59%,40.41%,1
臺中市,南區,1251,796,267,1063,28,1091,1751,62.31%,45.46%,1
臺中市,南區,1252,830,375,1205,64,1269,2109,60.17%,39.36%,1
臺中市,南區,1253,678,303,981,36,1017,1697,59.93%,39.95%,1
臺中市,南區,1254,540,288,828,34,862,1456,59.2%,37.09%,1
臺中市,南區,1255,785,326,1111,42,1153,1726,66.8%,45.48%,1
臺中市,南區,1256,723,319,1042,39,1081,1723,62.74%,41.96%,1
臺中市,南區,1257,656,283,939,35,974,1569,62.08%,41.81%,1
臺中市,南區,1258,563,217,780,20,800,1274,62.79%,44.19%,1
臺中市,南區,1259,630,269,899,27,926,1390,66.62%,45.32%,1
臺中市,南區,1260,553,274,827,24,851,1295,65.71%,42.7%,1
臺中市,南區,1261,586,199,785,33,818,1312,62.35%,44.66%,1
臺中市,南區,1262,634,247,881,26,907,1417,64.01%,44.74%,1
臺中市,南區,1263,577,238,815,42,857,1230,69.67%,46.91%,1
臺中市,南區,1264,553,209,762,32,794,1308,60.7%,42.28%,1
臺中市,南區,1265,567,267,834,52,886,1467,60.4%,38.65%,1
臺中市,南區,1266,567,236,803,30,833,1399,59.54%,40.53%,1
臺中市,南區,1267,519,173,692,41,733,1207,60.73%,43%,1
臺中市,南區,1268,530,239,769,31,800,1317,60.74%,40.24%,1
臺中市,南區,1269,584,303,887,30,917,1563,58.67%,37.36%,1
臺中市,南區,1270,513,230,743,28,771,1221,63.14%,42.01%,1
臺中市,西區,1082,378,129,507,18,525,1400,37.5%,27%,1
臺中市,西區,1083,380,170,550,17,567,861,65.85%,44.13%,1
臺中市,西區,1084,570,245,815,30,845,1416,59.68%,40.25%,1
臺中市,西區,1085,422,188,610,35,645,1020,63.24%,41.37%,1
臺中市,西區,1086,341,147,488,26,514,778,66.07%,43.83%,1
臺中市,西區,1087,600,225,825,26,851,1465,58.09%,40.96%,1
臺中市,西區,1088,436,173,609,13,622,1017,61.16%,42.87%,1
臺中市,西區,1089,348,161,509,21,530,868,61.06%,40.09%,1
臺中市,西區,1090,545,243,788,27,815,1251,65.15%,43.57%,1
臺中市,西區,1091,455,204,659,29,688,1044,65.9%,43.58%,1
臺中市,西區,1092,548,281,829,29,858,1487,57.7%,36.85%,1
臺中市,西區,1093,613,281,894,41,935,1573,59.44%,38.97%,1
臺中市,西區,1094,720,311,1031,26,1057,1731,61.06%,41.59%,1
臺中市,西區,1095,531,183,714,30,744,1209,61.54%,43.92%,1
臺中市,西區,1096,604,277,881,25,906,1564,57.93%,38.62%,1
臺中市,西區,1097,463,241,704,33,737,1175,62.72%,39.4%,1
臺中市,西區,1098,555,297,852,26,878,1505,58.34%,36.88%,1
臺中市,西區,1099,563,273,836,32,868,1418,61.21%,39.7%,1
臺中市,西區,1100,521,167,688,19,707,1497,47.23%,34.8%,1
臺中市,西區,1101,540,220,760,20,780,1260,61.9%,42.86%,1
臺中市,西區,1102,561,258,819,37,856,1399,61.19%,40.1%,1
臺中市,西區,1103,563,252,815,35,850,1447,58.74%,38.91%,1
臺中市,西區,1104,645,309,954,30,984,1683,58.47%,38.32%,1
臺中市,西區,1105,632,288,920,35,955,1585,60.25%,39.87%,1
臺中市,西區,1106,607,338,945,26,971,1557,62.36%,38.99%,1
臺中市,西區,1107,607,260,867,43,910,1663,54.72%,36.5%,1
臺中市,西區,1108,688,393,1081,43,1124,1921,58.51%,35.81%,1
臺中市,西區,1109,705,330,1035,23,1058,1952,54.2%,36.12%,1
臺中市,西區,1110,683,302,985,31,1016,1708,59.48%,39.99%,1
臺中市,西區,1111,473,231,704,16,720,1131,63.66%,41.82%,1
臺中市,西區,1112,777,253,1030,33,1063,1916,55.48%,40.55%,1
臺中市,西區,1113,538,237,775,15,790,1275,61.96%,42.2%,1
臺中市,西區,1114,655,264,919,49,968,1822,53.13%,35.95%,1
臺中市,西區,1115,522,248,770,38,808,1374,58.81%,37.99%,1
臺中市,西區,1116,470,156,626,36,662,1129,58.64%,41.63%,1
臺中市,西區,1117,436,201,637,42,679,1201,56.54%,36.3%,1
臺中市,西區,1118,637,244,881,48,929,1639,56.68%,38.87%,1
臺中市,西區,1119,726,321,1047,45,1092,1863,58.62%,38.97%,1
臺中市,西區,1120,576,207,783,42,825,1287,64.1%,44.76%,1
臺中市,西區,1121,610,271,881,40,921,1504,61.24%,40.56%,1
臺中市,西區,1122,510,240,750,21,771,1308,58.94%,38.99%,1
臺中市,西區,1123,569,245,814,36,850,1433,59.32%,39.71%,1
臺中市,西區,1124,547,256,803,27,830,1450,57.24%,37.72%,1
臺中市,西區,1125,603,286,889,32,921,1465,62.87%,41.16%,1
臺中市,西區,1126,670,283,953,45,998,1818,54.9%,36.85%,1
臺中市,西區,1127,699,304,1003,44,1047,1782,58.75%,39.23%,1
臺中市,西區,1128,587,271,858,31,889,1428,62.25%,41.11%,1
臺中市,西區,1129,472,204,676,25,701,1366,51.32%,34.55%,1
臺中市,西區,1130,571,256,827,31,858,1498,57.28%,38.12%,1
臺中市,西區,1131,556,247,803,30,833,1350,61.7%,41.19%,1
臺中市,西區,1132,547,250,797,24,821,1339,61.31%,40.85%,1
臺中市,西區,1133,644,289,933,32,965,1613,59.83%,39.93%,1
臺中市,西區,1134,531,289,820,37,857,1454,58.94%,36.52%,1
臺中市,西區,1135,652,306,958,30,988,1597,61.87%,40.83%,1
臺中市,西區,1136,583,288,871,30,901,1411,63.86%,41.32%,1
臺中市,西區,1137,580,273,853,43,896,1493,60.01%,38.85%,1
臺中市,西區,1138,699,248,947,37,984,1600,61.5%,43.69%,1
臺中市,西區,1139,623,320,943,36,979,1710,57.25%,36.43%,1
臺中市,西區,1140,445,215,660,21,681,1139,59.79%,39.07%,1
臺中市,西區,1141,461,200,661,21,682,1105,61.72%,41.72%,1
臺中市,西區,1142,604,234,838,29,867,1498,57.88%,40.32%,1
臺中市,西區,1143,681,271,952,38,990,1921,51.54%,35.45%,1
臺中市,西區,1144,521,230,751,31,782,1340,58.36%,38.88%,1
臺中市,西區,1145,658,276,934,28,962,1536,62.63%,42.84%,1
臺中市,西區,1146,529,229,758,49,807,1361,59.29%,38.87%,1
臺中市,西區,1147,605,269,874,24,898,1430,62.8%,42.31%,1
臺中市,北區,0983,545,225,770,29,799,1437,55.6%,37.93%,1
臺中市,北區,0984,633,285,918,0,918,1708,53.75%,37.06%,1
臺中市,北區,0985,380,150,530,29,559,1051,53.19%,36.16%,1
臺中市,北區,0986,416,146,562,33,595,996,59.74%,41.77%,1
臺中市,北區,0987,647,194,841,34,875,1504,58.18%,43.02%,1
臺中市,北區,0988,403,173,576,31,607,975,62.26%,41.33%,1
臺中市,北區,0989,367,141,508,24,532,886,60.05%,41.42%,1
臺中市,北區,0990,410,170,580,32,612,1276,47.96%,32.13%,1
臺中市,北區,0991,353,150,503,18,521,938,55.54%,37.63%,1
臺中市,北區,0992,539,192,731,41,772,1404,54.99%,38.39%,1
臺中市,北區,0993,390,164,554,15,569,996,57.13%,39.16%,1
臺中市,北區,0994,324,149,473,35,508,869,58.46%,37.28%,1
臺中市,北區,0995,313,119,432,21,453,704,64.35%,44.46%,1
臺中市,北區,0996,389,137,526,21,547,979,55.87%,39.73%,1
臺中市,北區,0997,299,101,400,14,414,773,53.56%,38.68%,1
臺中市,北區,0998,325,122,447,23,470,759,61.92%,42.82%,1
臺中市,北區,0999,622,172,794,48,842,1438,58.55%,43.25%,1
臺中市,北區,1000,492,130,622,28,650,1212,53.63%,40.59%,1
臺中市,北區,1001,695,283,978,28,1006,1731,58.12%,40.15%,1
臺中市,北區,1002,673,218,891,27,918,1445,63.53%,46.57%,1
臺中市,北區,1003,733,262,995,41,1036,1855,55.85%,39.51%,1
臺中市,北區,1004,625,221,846,31,877,1728,50.75%,36.17%,1
臺中市,北區,1005,667,262,929,49,978,1878,52.08%,35.52%,1
臺中市,北區,1006,664,217,881,48,929,1793,51.81%,37.03%,1
臺中市,北區,1007,634,224,858,51,909,1555,58.46%,40.77%,1
臺中市,北區,1008,623,256,879,22,901,1761,51.16%,35.38%,1
臺中市,北區,1009,643,209,852,31,883,1579,55.92%,40.72%,1
臺中市,北區,1010,847,300,1147,53,1200,2192,54.74%,38.64%,1
臺中市,北區,1011,619,281,900,34,934,1560,59.87%,39.68%,1
臺中市,北區,1012,591,240,831,31,862,1476,58.4%,40.04%,1
臺中市,北區,1013,428,164,592,33,625,1006,62.13%,42.54%,1
臺中市,北區,1014,605,185,790,28,818,1403,58.3%,43.12%,1
臺中市,北區,1015,578,199,777,16,793,1446,54.84%,39.97%,1
臺中市,北區,1016,571,224,795,33,828,1460,56.71%,39.11%,1
臺中市,北區,1017,492,217,709,23,732,1233,59.37%,39.9%,1
臺中市,北區,1018,448,207,655,28,683,1027,66.5%,43.62%,1
臺中市,北區,1019,477,217,694,19,713,1207,59.07%,39.52%,1
臺中市,北區,1020,493,207,700,22,722,1167,61.87%,42.25%,1
臺中市,北區,1021,439,209,648,27,675,1150,58.7%,38.17%,1
臺中市,北區,1022,425,178,603,24,627,1061,59.1%,40.06%,1
臺中市,北區,1023,418,182,600,25,625,1005,62.19%,41.59%,1
臺中市,北區,1024,470,227,697,27,724,1250,57.92%,37.6%,1
臺中市,北區,1025,590,251,841,40,881,1448,60.84%,40.75%,1
臺中市,北區,1026,540,246,786,41,827,1379,59.97%,39.16%,1
臺中市,北區,1027,660,266,926,38,964,1652,58.35%,39.95%,1
臺中市,北區,1028,651,338,989,35,1024,1867,54.85%,34.87%,1
臺中市,北區,1029,405,158,563,22,585,2078,28.15%,19.49%,1
臺中市,北區,1030,675,251,926,33,959,1562,61.4%,43.21%,1
臺中市,北區,1031,560,246,806,19,825,1430,57.69%,39.16%,1
臺中市,北區,1032,792,356,1148,45,1193,2018,59.12%,39.25%,1
臺中市,北區,1033,625,232,857,23,880,1710,51.46%,36.55%,1
臺中市,北區,1034,567,198,765,22,787,1432,54.96%,39.59%,1
臺中市,北區,1035,478,200,678,31,709,1157,61.28%,41.31%,1
臺中市,北區,1036,474,225,699,31,730,1188,61.45%,39.9%,1
臺中市,北區,1037,588,199,787,25,812,1419,57.22%,41.44%,1
臺中市,北區,1038,605,281,886,26,912,1653,55.17%,36.6%,1
臺中市,北區,1039,488,216,704,30,734,1233,59.53%,39.58%,1
臺中市,北區,1040,490,222,712,21,733,1243,58.97%,39.42%,1
臺中市,北區,1041,446,197,643,12,655,1219,53.73%,36.59%,1
臺中市,北區,1042,484,228,712,45,757,1272,59.51%,38.05%,1
臺中市,北區,1043,501,250,751,14,765,1285,59.53%,38.99%,1
臺中市,北區,1044,694,323,1017,35,1052,1780,59.1%,38.99%,1
臺中市,北區,1045,540,219,759,22,781,1461,53.46%,36.96%,1
臺中市,北區,1046,585,187,772,35,807,1310,61.6%,44.66%,1
臺中市,北區,1047,591,309,900,25,925,1669,55.42%,35.41%,1
臺中市,北區,1048,754,340,1094,35,1129,1932,58.44%,39.03%,1
臺中市,北區,1049,655,272,927,23,950,1682,56.48%,38.94%,1
臺中市,北區,1050,657,347,1004,21,1025,1891,54.2%,34.74%,1
臺中市,北區,1051,745,280,1025,44,1069,1882,56.8%,39.59%,1
臺中市,北區,1052,458,191,649,19,668,1159,57.64%,39.52%,1
臺中市,北區,1053,586,274,860,43,903,1553,58.15%,37.73%,1
臺中市,北區,1054,584,281,865,28,893,1607,55.57%,36.34%,1
臺中市,北區,1055,632,332,964,36,1000,1773,56.4%,35.65%,1
臺中市,北區,1056,610,224,834,42,876,1524,57.48%,40.03%,1
臺中市,北區,1057,673,284,957,52,1009,1613,62.55%,41.72%,1
臺中市,北區,1058,738,330,1068,45,1113,1877,59.3%,39.32%,1
臺中市,北區,1059,721,286,1007,29,1036,1792,57.81%,40.23%,1
臺中市,北區,1060,600,194,794,35,829,1392,59.55%,43.1%,1
臺中市,北區,1061,516,206,722,28,750,1297,57.83%,39.78%,1
臺中市,北區,1062,617,333,950,26,976,1556,62.72%,39.65%,1
臺中市,北區,1063,554,254,808,34,842,1497,56.25%,37.01%,1
臺中市,北區,1064,607,229,836,33,869,1550,56.06%,39.16%,1
臺中市,北區,1065,508,268,776,32,808,1434,56.35%,35.43%,1
臺中市,北區,1066,679,323,1002,41,1043,1793,58.17%,37.87%,1
臺中市,北區,1067,686,334,1020,33,1053,1866,56.43%,36.76%,1
臺中市,北區,1068,583,194,777,28,805,1346,59.81%,43.31%,1
臺中市,北區,1069,513,191,704,31,735,1267,58.01%,40.49%,1
臺中市,西屯區,0625,642,397,1039,37,1076,1638,65.69%,39.19%,1
臺中市,西屯區,0626,498,227,725,26,751,1335,56.25%,37.3%,1
臺中市,西屯區,0627,712,322,1034,23,1057,1776,59.52%,40.09%,1
臺中市,西屯區,0628,520,248,768,20,788,1351,58.33%,38.49%,1
臺中市,西屯區,0629,540,250,790,30,820,1338,61.29%,40.36%,1
臺中市,西屯區,0630,614,304,918,30,948,1582,59.92%,38.81%,1
臺中市,西屯區,0631,659,240,899,29,928,1710,54.27%,38.54%,1
臺中市,西屯區,0632,570,261,831,32,863,1595,54.11%,35.74%,1
臺中市,西屯區,0633,665,216,881,50,931,1585,58.74%,41.96%,1
臺中市,西屯區,0634,676,272,948,41,989,1749,56.55%,38.65%,1
臺中市,西屯區,0635,756,290,1046,41,1087,1877,57.91%,40.28%,1
臺中市,西屯區,0636,591,306,897,28,925,1697,54.51%,34.83%,1
臺中市,西屯區,0637,622,258,880,30,910,1480,61.49%,42.03%,1
臺中市,西屯區,0638,601,317,918,55,973,1483,65.61%,40.53%,1
臺中市,西屯區,0639,602,271,873,30,903,2484,36.35%,24.24%,1
臺中市,西屯區,0640,387,109,496,32,528,781,67.61%,49.55%,1
臺中市,西屯區,0641,620,246,866,40,906,1477,61.34%,41.98%,1
臺中市,西屯區,0642,664,317,981,23,1004,1784,56.28%,37.22%,1
臺中市,西屯區,0643,662,287,949,35,984,1686,58.36%,39.26%,1
臺中市,西屯區,0644,614,318,932,34,966,1692,57.09%,36.29%,1
臺中市,西屯區,0645,610,260,870,29,899,1659,54.19%,36.77%,1
臺中市,西屯區,0646,639,289,928,35,963,1648,58.43%,38.77%,1
臺中市,西屯區,0647,598,311,909,32,941,1536,61.26%,38.93%,1
臺中市,西屯區,0648,692,285,977,30,1007,1666,60.44%,41.54%,1
臺中市,西屯區,0649,545,264,809,46,855,1428,59.87%,38.17%,1
臺中市,西屯區,0650,660,294,954,35,989,1810,54.64%,36.46%,1
臺中市,西屯區,0651,616,274,890,15,905,1574,57.5%,39.14%,1
臺中市,西屯區,0652,650,278,928,29,957,1650,58%,39.39%,1
臺中市,西屯區,0653,637,299,936,39,975,1681,58%,37.89%,1
臺中市,西屯區,0654,585,315,900,36,936,1656,56.52%,35.33%,1
臺中市,西屯區,0655,547,184,731,40,771,1243,62.03%,44.01%,1
臺中市,西屯區,0656,614,288,902,39,941,1471,63.97%,41.74%,1
臺中市,西屯區,0657,595,292,887,20,907,1431,63.38%,41.58%,1
臺中市,西屯區,0658,652,298,950,30,980,1714,57.18%,38.04%,1
臺中市,西屯區,0659,594,207,801,41,842,1424,59.13%,41.71%,1
臺中市,西屯區,0660,512,163,675,29,704,1176,59.86%,43.54%,1
臺中市,西屯區,0661,613,241,854,35,889,1456,61.06%,42.1%,1
臺中市,西屯區,0662,599,288,887,25,912,1451,62.85%,41.28%,1
臺中市,西屯區,0663,461,222,683,19,702,1063,66.04%,43.37%,1
臺中市,西屯區,0664,583,190,773,37,810,1357,59.69%,42.96%,1
臺中市,西屯區,0665,621,178,799,46,845,1355,62.36%,45.83%,1
臺中市,西屯區,0666,633,200,833,25,858,1384,61.99%,45.74%,1
臺中市,西屯區,0667,660,278,938,31,969,1613,60.07%,40.92%,1
臺中市,西屯區,0668,637,239,876,42,918,1562,58.77%,40.78%,1
臺中市,西屯區,0669,537,233,770,37,807,1219,66.2%,44.05%,1
臺中市,西屯區,0670,439,232,671,29,700,1235,56.68%,35.55%,1
臺中市,西屯區,0671,452,200,652,30,682,1131,60.3%,39.96%,1
臺中市,西屯區,0672,627,284,911,28,939,1494,62.85%,41.97%,1
臺中市,西屯區,0673,486,291,777,15,792,1325,59.77%,36.68%,1
臺中市,西屯區,0674,527,269,796,32,828,1386,59.74%,38.02%,1
臺中市,西屯區,0675,688,341,1029,45,1074,1816,59.14%,37.89%,1
臺中市,西屯區,0676,636,291,927,27,954,1734,55.02%,36.68%,1
臺中市,西屯區,0677,693,337,1030,39,1069,1777,60.16%,39%,1
臺中市,西屯區,0678,625,317,942,51,993,1818,54.62%,34.38%,1
臺中市,西屯區,0679,640,274,914,53,967,1699,56.92%,37.67%,1
臺中市,西屯區,0680,635,245,880,33,913,1715,53.24%,37.03%,1
臺中市,西屯區,0681,599,281,880,27,907,1654,54.84%,36.22%,1
臺中市,西屯區,0682,619,273,892,14,906,1636,55.38%,37.84%,1
臺中市,西屯區,0683,501,212,713,28,741,1298,57.09%,38.6%,1
臺中市,西屯區,0684,592,224,816,29,845,1391,60.75%,42.56%,1
臺中市,西屯區,0685,740,310,1050,50,1100,1853,59.36%,39.94%,1
臺中市,西屯區,0686,691,280,971,45,1016,1820,55.82%,37.97%,1
臺中市,西屯區,0687,716,301,1017,38,1055,1809,58.32%,39.58%,1
臺中市,西屯區,0688,579,240,819,27,846,1352,62.57%,42.83%,1
臺中市,西屯區,0689,613,229,842,51,893,1521,58.71%,40.3%,1
臺中市,西屯區,0690,626,251,877,36,913,1486,61.44%,42.13%,1
臺中市,西屯區,0691,675,291,966,31,997,1674,59.56%,40.32%,1
臺中市,西屯區,0692,672,300,972,47,1019,1610,63.29%,41.74%,1
臺中市,西屯區,0693,631,227,858,58,916,1695,54.04%,37.23%,1
臺中市,西屯區,0694,610,295,905,39,944,1684,56.06%,36.22%,1
臺中市,西屯區,0695,529,200,729,30,759,1221,62.16%,43.33%,1
臺中市,西屯區,0696,602,194,796,54,850,1252,67.89%,48.08%,1
臺中市,西屯區,0697,549,229,778,38,816,1301,62.72%,42.2%,1
臺中市,西屯區,0698,516,129,645,27,672,1049,64.06%,49.19%,1
臺中市,西屯區,0699,515,129,644,36,680,1113,61.1%,46.27%,1
臺中市,西屯區,0700,644,183,827,28,855,1557,54.91%,41.36%,1
臺中市,西屯區,0701,641,234,875,43,918,1640,55.98%,39.09%,1
臺中市,西屯區,0702,678,207,885,50,935,1402,66.69%,48.36%,1
臺中市,西屯區,0703,647,215,862,47,909,1717,52.94%,37.68%,1
臺中市,西屯區,0704,653,263,916,44,960,1688,56.87%,38.68%,1
臺中市,西屯區,0705,519,169,688,34,722,1168,61.82%,44.43%,1
臺中市,西屯區,0706,683,234,917,40,957,1729,55.35%,39.5%,1
臺中市,西屯區,0707,728,307,1035,51,1086,2007,54.11%,36.27%,1
臺中市,西屯區,0708,547,209,756,49,805,1296,62.11%,42.21%,1
臺中市,西屯區,0709,405,144,549,27,576,1068,53.93%,37.92%,1
臺中市,西屯區,0710,833,211,1044,69,1113,1707,65.2%,48.8%,1
臺中市,西屯區,0711,668,279,947,34,981,1636,59.96%,40.83%,1
臺中市,西屯區,0712,617,232,849,41,890,1761,50.54%,35.04%,1
臺中市,西屯區,0713,532,230,762,30,792,1314,60.27%,40.49%,1
臺中市,西屯區,0714,525,237,762,33,795,1233,64.48%,42.58%,1
臺中市,西屯區,0715,611,219,830,34,864,1549,55.78%,39.44%,1
臺中市,西屯區,0716,626,242,868,36,904,1639,55.16%,38.19%,1
臺中市,西屯區,0717,576,192,768,47,815,1486,54.85%,38.76%,1
臺中市,西屯區,0718,620,345,965,21,986,1806,54.6%,34.33%,1
臺中市,西屯區,0719,501,277,778,13,791,1451,54.51%,34.53%,1
臺中市,西屯區,0720,564,200,764,20,784,1302,60.22%,43.32%,1
臺中市,西屯區,0721,551,254,805,41,846,1353,62.53%,40.72%,1
臺中市,西屯區,0722,849,367,1216,48,1264,2162,58.46%,39.27%,1
臺中市,西屯區,0723,573,254,827,39,866,1520,56.97%,37.7%,1
臺中市,西屯區,0724,744,307,1051,31,1082,1935,55.92%,38.45%,1
臺中市,西屯區,0725,687,333,1020,39,1059,1847,57.34%,37.2%,1
臺中市,西屯區,0726,648,234,882,33,915,1738,52.65%,37.28%,1
臺中市,西屯區,0727,669,304,973,37,1010,1640,61.59%,40.79%,1
臺中市,西屯區,0728,704,357,1061,41,1102,1908,57.76%,36.9%,1
臺中市,西屯區,0729,527,272,799,20,819,1402,58.42%,37.59%,1
臺中市,西屯區,0730,539,262,801,24,825,1515,54.46%,35.58%,1
臺中市,西屯區,0731,504,226,730,31,761,1541,49.38%,32.71%,1
臺中市,西屯區,0732,515,288,803,31,834,1502,55.53%,34.29%,1
臺中市,西屯區,0733,611,273,884,30,914,1526,59.9%,40.04%,1
臺中市,西屯區,0734,575,257,832,46,878,1425,61.61%,40.35%,1
臺中市,西屯區,0735,567,244,811,23,834,1334,62.52%,42.5%,1
臺中市,西屯區,0736,682,293,975,37,1012,1649,61.37%,41.36%,1
臺中市,西屯區,0737,597,270,867,25,892,1566,56.96%,38.12%,1
臺中市,西屯區,0738,646,324,970,28,998,1629,61.26%,39.66%,1
臺中市,西屯區,0739,627,297,924,42,966,1628,59.34%,38.51%,1
臺中市,西屯區,0740,584,294,878,17,895,1442,62.07%,40.5%,1
臺中市,西屯區,0741,452,185,637,36,673,1206,55.8%,37.48%,1
臺中市,西屯區,0742,482,162,644,43,687,1086,63.26%,44.38%,1
臺中市,西屯區,0743,490,158,648,35,683,1088,62.78%,45.04%,1
臺中市,西屯區,0744,467,195,662,26,688,1140,60.35%,40.96%,1
臺中市,南屯區,0745,589,200,789,38,827,1321,62.6%,44.59%,1
臺中市,南屯區,0746,548,264,812,33,845,1346,62.78%,40.71%,1
臺中市,南屯區,0747,624,237,861,38,899,1428,62.96%,43.7%,1
臺中市,南屯區,0748,601,244,845,20,865,1442,59.99%,41.68%,1
臺中市,南屯區,0749,576,302,878,32,910,1408,64.63%,40.91%,1
臺中市,南屯區,0750,577,268,845,19,864,1404,61.54%,41.1%,1
臺中市,南屯區,0751,590,256,846,21,867,1354,64.03%,43.57%,1
臺中市,南屯區,0752,545,262,807,34,841,1332,63.14%,40.92%,1
臺中市,南屯區,0753,602,293,895,29,924,1463,63.16%,41.15%,1
臺中市,南屯區,0754,535,276,811,43,854,1413,60.44%,37.86%,1
臺中市,南屯區,0755,514,258,772,20,792,1218,65.02%,42.2%,1
臺中市,南屯區,0756,559,216,775,33,808,1308,61.77%,42.74%,1
臺中市,南屯區,0757,660,275,935,34,969,1527,63.46%,43.22%,1
臺中市,南屯區,0758,445,349,794,32,826,1294,63.83%,34.39%,1
臺中市,南屯區,0759,578,214,792,24,816,1516,53.83%,38.13%,1
臺中市,南屯區,0760,650,262,912,33,945,1529,61.81%,42.51%,1
臺中市,南屯區,0761,607,219,826,38,864,1397,61.85%,43.45%,1
臺中市,南屯區,0762,589,194,783,19,802,1406,57.04%,41.89%,1
臺中市,南屯區,0763,613,196,809,30,839,1497,56.05%,40.95%,1
臺中市,南屯區,0764,557,219,776,50,826,1424,58.01%,39.12%,1
臺中市,南屯區,0765,521,224,745,30,775,1488,52.08%,35.01%,1
臺中市,南屯區,0766,269,109,378,30,408,608,67.11%,44.24%,1
臺中市,南屯區,0767,378,125,503,34,537,813,66.05%,46.49%,1
臺中市,南屯區,0768,512,183,695,45,740,1190,62.18%,43.03%,1
臺中市,南屯區,0769,503,164,667,21,688,1174,58.6%,42.84%,1
臺中市,南屯區,0770,539,178,717,14,731,1224,59.72%,44.04%,1
臺中市,南屯區,0771,544,170,714,38,752,1466,51.3%,37.11%,1
臺中市,南屯區,0772,429,124,553,20,573,1333,42.99%,32.18%,1
臺中市,南屯區,0773,348,144,492,29,521,814,64%,42.75%,1
臺中市,南屯區,0774,588,169,757,42,799,1436,55.64%,40.95%,1
臺中市,南屯區,0775,608,262,870,35,905,1515,59.74%,40.13%,1
臺中市,南屯區,0776,544,238,782,16,798,1545,51.65%,35.21%,1
臺中市,南屯區,0777,564,219,783,41,824,1383,59.58%,40.78%,1
臺中市,南屯區,0778,611,228,839,28,867,1433,60.5%,42.64%,1
臺中市,南屯區,0779,394,199,593,29,622,1134,54.85%,34.74%,1
臺中市,南屯區,0780,512,216,728,34,762,1216,62.66%,42.11%,1
臺中市,南屯區,0781,494,190,684,52,736,1271,57.91%,38.87%,1
臺中市,南屯區,0782,446,204,650,22,672,1203,55.86%,37.07%,1
臺中市,南屯區,0783,518,206,724,26,750,1268,59.15%,40.85%,1
臺中市,南屯區,0784,610,198,808,26,834,1390,60%,43.88%,1
臺中市,南屯區,0785,553,228,781,40,821,1397,58.77%,39.58%,1
臺中市,南屯區,0786,613,263,876,52,928,1607,57.75%,38.15%,1
臺中市,南屯區,0787,687,229,916,39,955,1582,60.37%,43.43%,1
臺中市,南屯區,0788,692,245,937,32,969,1611,60.15%,42.95%,1
臺中市,南屯區,0789,577,238,815,28,843,1322,63.77%,43.65%,1
臺中市,南屯區,0790,576,254,830,29,859,1321,65.03%,43.6%,1
臺中市,南屯區,0791,595,228,823,30,853,1360,62.72%,43.75%,1
臺中市,南屯區,0792,580,250,830,13,843,1361,61.94%,42.62%,1
臺中市,南屯區,0793,520,251,771,24,795,1257,63.25%,41.37%,1
臺中市,南屯區,0794,532,231,763,21,784,1207,64.95%,44.08%,1
臺中市,南屯區,0795,521,275,796,25,821,1282,64.04%,40.64%,1
臺中市,南屯區,0796,520,261,781,38,819,1248,65.63%,41.67%,1
臺中市,南屯區,0797,566,253,819,36,855,1304,65.57%,43.4%,1
臺中市,南屯區,0798,480,240,720,25,745,1214,61.37%,39.54%,1
臺中市,南屯區,0799,464,223,687,25,712,1102,64.61%,42.11%,1
臺中市,南屯區,0800,710,317,1027,30,1057,1630,64.85%,43.56%,1
臺中市,南屯區,0801,526,281,807,25,832,1333,62.42%,39.46%,1
臺中市,南屯區,0802,522,276,798,20,818,1292,63.31%,40.4%,1
臺中市,南屯區,0803,505,247,752,35,787,1272,61.87%,39.7%,1
臺中市,南屯區,0804,551,244,795,23,818,1345,60.82%,40.97%,1
臺中市,南屯區,0805,484,186,670,21,691,981,70.44%,49.34%,1
臺中市,南屯區,0806,488,179,667,36,703,1097,64.08%,44.48%,1
臺中市,南屯區,0807,466,158,624,26,650,991,65.59%,47.02%,1
臺中市,南屯區,0808,521,183,704,22,726,1170,62.05%,44.53%,1
臺中市,南屯區,0809,487,242,729,22,751,1171,64.13%,41.59%,1
臺中市,南屯區,0810,519,206,725,40,765,1349,56.71%,38.47%,1
臺中市,南屯區,0811,572,267,839,33,872,1368,63.74%,41.81%,1
臺中市,南屯區,0812,601,202,803,21,824,1263,65.24%,47.59%,1
臺中市,南屯區,0813,609,311,920,41,961,1547,62.12%,39.37%,1
臺中市,南屯區,0814,629,321,950,44,994,1649,60.28%,38.14%,1
臺中市,南屯區,0815,619,284,903,33,936,1629,57.46%,38%,1
臺中市,南屯區,0816,538,285,823,32,855,1580,54.11%,34.05%,1
臺中市,南屯區,0817,645,278,923,25,948,1444,65.65%,44.67%,1
臺中市,南屯區,0818,572,253,825,21,846,1413,59.87%,40.48%,1
臺中市,南屯區,0819,548,232,780,33,813,1377,59.04%,39.8%,1
臺中市,南屯區,0820,574,335,909,23,932,1527,61.03%,37.59%,1
臺中市,南屯區,0821,539,277,816,31,847,1335,63.45%,40.37%,1
臺中市,南屯區,0822,691,325,1016,25,1041,1544,67.42%,44.75%,1
臺中市,南屯區,0823,549,387,936,35,971,1482,65.52%,37.04%,1
臺中市,南屯區,0824,656,239,895,39,934,1488,62.77%,44.09%,1
臺中市,南屯區,0825,537,247,784,34,818,1538,53.19%,34.92%,1
臺中市,南屯區,0826,695,315,1010,49,1059,1674,63.26%,41.52%,1
臺中市,南屯區,0827,560,283,843,22,865,1996,43.34%,28.06%,1
臺中市,南屯區,0828,630,258,888,37,925,1514,61.1%,41.61%,1
臺中市,南屯區,0829,528,213,741,44,785,1217,64.5%,43.39%,1
臺中市,南屯區,0830,521,253,774,34,808,1347,59.99%,38.68%,1
臺中市,南屯區,0831,485,183,668,29,697,1109,62.85%,43.73%,1
臺中市,南屯區,0832,599,289,888,18,906,1546,58.6%,38.75%,1
臺中市,南屯區,0833,604,274,878,30,908,1408,64.49%,42.9%,1
臺中市,南屯區,0834,481,114,595,24,619,1057,58.56%,45.51%,1
臺中市,南屯區,0835,458,190,648,47,695,1133,61.34%,40.42%,1
臺中市,南屯區,0836,515,256,771,29,800,1278,62.6%,40.3%,1
臺中市,南屯區,0837,503,216,719,37,756,1144,66.08%,43.97%,1
臺中市,南屯區,0838,415,262,677,26,703,1140,61.67%,36.4%,1
臺中市,南屯區,0839,492,224,716,25,741,1171,63.28%,42.02%,1
臺中市,南屯區,0840,573,242,815,24,839,1303,64.39%,43.98%,1
臺中市,南屯區,0841,560,222,782,22,804,1402,57.35%,39.94%,1
臺中市,南屯區,0842,625,249,874,43,917,1571,58.37%,39.78%,1
臺中市,南屯區,0843,482,237,719,21,740,1139,64.97%,42.32%,1
臺中市,南屯區,0844,537,224,761,26,787,1216,64.72%,44.16%,1
臺中市,南屯區,0845,515,199,714,28,742,1162,63.86%,44.32%,1
臺中市,北屯區,0846,701,306,1007,43,1050,1670,62.87%,41.98%,1
臺中市,北屯區,0847,651,245,896,40,936,1706,54.87%,38.16%,1
臺中市,北屯區,0848,584,235,819,55,874,1507,58%,38.75%,1
臺中市,北屯區,0849,672,278,950,38,988,1652,59.81%,40.68%,1
臺中市,北屯區,0850,430,175,605,25,630,1107,56.91%,38.84%,1
臺中市,北屯區,0851,815,287,1102,64,1166,2151,54.21%,37.89%,1
臺中市,北屯區,0852,690,266,956,25,981,1612,60.86%,42.8%,1
臺中市,北屯區,0853,711,271,982,22,1004,1743,57.6%,40.79%,1
臺中市,北屯區,0854,766,319,1085,23,1108,2099,52.79%,36.49%,1
臺中市,北屯區,0855,657,247,904,24,928,1595,58.18%,41.19%,1
臺中市,北屯區,0856,617,271,888,33,921,1923,47.89%,32.09%,1
臺中市,北屯區,0857,664,204,868,40,908,1641,55.33%,40.46%,1
臺中市,北屯區,0858,528,214,742,22,764,1157,66.03%,45.64%,1
臺中市,北屯區,0859,455,177,632,33,665,1041,63.88%,43.71%,1
臺中市,北屯區,0860,593,225,818,29,847,1563,54.19%,37.94%,1
臺中市,北屯區,0861,639,181,820,28,848,1559,54.39%,40.99%,1
臺中市,北屯區,0862,543,181,724,17,741,1411,52.52%,38.48%,1
臺中市,北屯區,0863,692,310,1002,34,1036,1761,58.83%,39.3%,1
臺中市,北屯區,0864,597,220,817,55,872,1361,64.07%,43.86%,1
臺中市,北屯區,0865,862,165,1027,34,1061,1852,57.29%,46.54%,1
臺中市,北屯區,0866,809,297,1106,31,1137,1928,58.97%,41.96%,1
臺中市,北屯區,0867,678,263,941,24,965,1492,64.68%,45.44%,1
臺中市,北屯區,0868,755,290,1045,61,1106,1998,55.36%,37.79%,1
臺中市,北屯區,0869,588,214,802,29,831,1272,65.33%,46.23%,1
臺中市,北屯區,0870,570,226,796,25,821,1317,62.34%,43.28%,1
臺中市,北屯區,0871,513,164,677,41,718,1327,54.11%,38.66%,1
臺中市,北屯區,0872,521,170,691,19,710,1280,55.47%,40.7%,1
臺中市,北屯區,0873,684,266,950,44,994,1865,53.3%,36.68%,1
臺中市,北屯區,0874,531,220,751,38,789,1230,64.15%,43.17%,1
臺中市,北屯區,0875,504,214,718,35,753,1356,55.53%,37.17%,1
臺中市,北屯區,0876,695,264,959,33,992,1732,57.27%,40.13%,1
臺中市,北屯區,0877,629,274,903,32,935,1586,58.95%,39.66%,1
臺中市,北屯區,0878,542,257,799,23,822,1441,57.04%,37.61%,1
臺中市,北屯區,0879,780,283,1063,57,1120,2045,54.77%,38.14%,1
臺中市,北屯區,0880,682,280,962,48,1010,1914,52.77%,35.63%,1
臺中市,北屯區,0881,788,280,1068,35,1103,1918,57.51%,41.08%,1
臺中市,北屯區,0882,743,319,1062,22,1084,2079,52.14%,35.74%,1
臺中市,北屯區,0883,822,344,1166,41,1207,2040,59.17%,40.29%,1
臺中市,北屯區,0884,652,309,961,47,1008,2027,49.73%,32.17%,1
臺中市,北屯區,0885,585,176,761,31,792,1402,56.49%,41.73%,1
臺中市,北屯區,0886,756,284,1040,35,1075,1826,58.87%,41.4%,1
臺中市,北屯區,0887,740,317,1057,40,1097,2162,50.74%,34.23%,1
臺中市,北屯區,0888,715,384,1099,24,1123,2332,48.16%,30.66%,1
臺中市,北屯區,0889,436,113,549,33,582,985,59.09%,44.26%,1
臺中市,北屯區,0890,568,476,1044,36,1080,2037,53.02%,27.88%,1
臺中市,北屯區,0891,563,136,699,36,735,1032,71.22%,54.55%,1
臺中市,北屯區,0892,433,160,593,31,624,1062,58.76%,40.77%,1
臺中市,北屯區,0893,382,113,495,30,525,909,57.76%,42.02%,1
臺中市,北屯區,0894,609,226,835,45,880,1445,60.9%,42.15%,1
臺中市,北屯區,0895,698,257,955,35,990,1842,53.75%,37.89%,1
臺中市,北屯區,0896,489,202,691,30,721,1187,60.74%,41.2%,1
臺中市,北屯區,0897,633,211,844,31,875,1456,60.1%,43.48%,1
臺中市,北屯區,0898,738,307,1045,46,1091,1866,58.47%,39.55%,1
臺中市,北屯區,0899,624,243,867,38,905,1667,54.29%,37.43%,1
臺中市,北屯區,0900,690,289,979,25,1004,1683,59.66%,41%,1
臺中市,北屯區,0901,616,287,903,25,928,1642,56.52%,37.52%,1
臺中市,北屯區,0902,646,232,878,16,894,1475,60.61%,43.8%,1
臺中市,北屯區,0903,667,237,904,17,921,1644,56.02%,40.57%,1
臺中市,北屯區,0904,636,297,933,26,959,1603,59.83%,39.68%,1
臺中市,北屯區,0905,820,300,1120,43,1163,1949,59.67%,42.07%,1
臺中市,北屯區,0906,796,307,1103,36,1139,1790,63.63%,44.47%,1
臺中市,北屯區,0907,569,258,827,28,855,1440,59.38%,39.51%,1
臺中市,北屯區,0908,685,263,948,42,990,1601,61.84%,42.79%,1
臺中市,北屯區,0909,599,231,830,35,865,1527,56.65%,39.23%,1
臺中市,北屯區,0910,599,256,855,38,893,1675,53.31%,35.76%,1
臺中市,北屯區,0911,569,204,773,38,811,1579,51.36%,36.04%,1
臺中市,北屯區,0912,631,226,857,40,897,1524,58.86%,41.4%,1
臺中市,北屯區,0913,646,244,890,38,928,1677,55.34%,38.52%,1
臺中市,北屯區,0914,617,260,877,33,910,1599,56.91%,38.59%,1
臺中市,北屯區,0915,543,293,836,51,887,1458,60.84%,37.24%,1
臺中市,北屯區,0916,622,299,921,32,953,1571,60.66%,39.59%,1
臺中市,北屯區,0917,638,283,921,26,947,1579,59.97%,40.41%,1
臺中市,北屯區,0918,728,332,1060,35,1095,1849,59.22%,39.37%,1
臺中市,北屯區,0919,644,306,950,22,972,1682,57.79%,38.29%,1
臺中市,北屯區,0920,666,267,933,34,967,1760,54.94%,37.84%,1
臺中市,北屯區,0921,677,271,948,46,994,1699,58.51%,39.85%,1
臺中市,北屯區,0922,695,295,990,37,1027,1626,63.16%,42.74%,1
臺中市,北屯區,0923,605,285,890,12,902,1491,60.5%,40.58%,1
臺中市,北屯區,0924,646,269,915,34,949,1640,57.87%,39.39%,1
臺中市,北屯區,0925,764,328,1092,51,1143,2052,55.7%,37.23%,1
臺中市,北屯區,0926,736,315,1051,34,1085,1875,57.87%,39.25%,1
臺中市,北屯區,0927,603,254,857,38,895,1559,57.41%,38.68%,1
臺中市,北屯區,0928,601,244,845,39,884,1480,59.73%,40.61%,1
臺中市,北屯區,0929,570,223,793,47,840,1397,60.13%,40.8%,1
臺中市,北屯區,0930,770,293,1063,39,1102,1889,58.34%,40.76%,1
臺中市,北屯區,0931,652,309,961,31,992,1728,57.41%,37.73%,1
臺中市,北屯區,0932,610,254,864,37,901,1592,56.6%,38.32%,1
臺中市,北屯區,0933,625,264,889,38,927,1656,55.98%,37.74%,1
臺中市,北屯區,0934,564,237,801,30,831,1524,54.53%,37.01%,1
臺中市,北屯區,0935,618,244,862,25,887,1502,59.05%,41.15%,1
臺中市,北屯區,0936,695,267,962,33,995,1772,56.15%,39.22%,1
臺中市,北屯區,0937,588,255,843,39,882,1461,60.37%,40.25%,1
臺中市,北屯區,0938,662,268,930,21,951,1769,53.76%,37.42%,1
臺中市,北屯區,0939,713,370,1083,52,1135,1894,59.93%,37.65%,1
臺中市,北屯區,0940,722,313,1035,41,1076,2033,52.93%,35.51%,1
臺中市,北屯區,0941,706,336,1042,30,1072,1947,55.06%,36.26%,1
臺中市,北屯區,0942,839,394,1233,43,1276,2188,58.32%,38.35%,1
臺中市,北屯區,0943,652,314,966,42,1008,1661,60.69%,39.25%,1
臺中市,北屯區,0944,663,273,936,32,968,1667,58.07%,39.77%,1
臺中市,北屯區,0945,658,301,959,26,985,1728,57%,38.08%,1
臺中市,北屯區,0946,665,267,932,26,958,1688,56.75%,39.4%,1
臺中市,北屯區,0947,567,254,821,24,845,1475,57.29%,38.44%,1
臺中市,北屯區,0948,715,322,1037,29,1066,1681,63.41%,42.53%,1
臺中市,北屯區,0949,858,337,1195,45,1240,2078,59.67%,41.29%,1
臺中市,北屯區,0950,806,324,1130,42,1172,2059,56.92%,39.15%,1
臺中市,北屯區,0951,699,330,1029,35,1064,1792,59.38%,39.01%,1
臺中市,北屯區,0952,712,316,1028,31,1059,2974,35.61%,23.94%,1
臺中市,北屯區,0953,439,160,599,36,635,1072,59.24%,40.95%,1
臺中市,北屯區,0954,891,346,1237,45,1282,2099,61.08%,42.45%,1
臺中市,北屯區,0955,817,319,1136,47,1183,1823,64.89%,44.82%,1
臺中市,北屯區,0956,863,322,1185,63,1248,2022,61.72%,42.68%,1
臺中市,北屯區,0957,810,310,1120,31,1151,1992,57.78%,40.66%,1
臺中市,北屯區,0958,688,250,938,44,982,1585,61.96%,43.41%,1
臺中市,北屯區,0959,683,251,934,28,962,1565,61.47%,43.64%,1
臺中市,北屯區,0960,679,226,905,43,948,1780,53.26%,38.15%,1
臺中市,北屯區,0961,814,329,1143,49,1192,1874,63.61%,43.44%,1
臺中市,北屯區,0962,795,263,1058,28,1086,1755,61.88%,45.3%,1
臺中市,北屯區,0963,722,293,1015,33,1048,1497,70.01%,48.23%,1
臺中市,北屯區,0964,678,265,943,44,987,1567,62.99%,43.27%,1
臺中市,北屯區,0965,667,225,892,29,921,1624,56.71%,41.07%,1
臺中市,北屯區,0966,708,250,958,30,988,1614,61.21%,43.87%,1
臺中市,北屯區,0967,612,269,881,35,916,1595,57.43%,38.37%,1
臺中市,北屯區,0968,689,228,917,42,959,1782,53.82%,38.66%,1
臺中市,北屯區,0969,519,174,693,23,716,1357,52.76%,38.25%,1
臺中市,北屯區,0970,441,144,585,40,625,1071,58.36%,41.18%,1
臺中市,北屯區,0971,542,199,741,26,767,1372,55.9%,39.5%,1
臺中市,北屯區,0972,603,214,817,34,851,1415,60.14%,42.61%,1
臺中市,北屯區,0973,733,321,1054,51,1105,1789,61.77%,40.97%,1
臺中市,北屯區,0974,863,280,1143,50,1193,1907,62.56%,45.25%,1
臺中市,北屯區,0975,839,308,1147,41,1188,2008,59.16%,41.78%,1
臺中市,北屯區,0976,625,215,840,46,886,1541,57.5%,40.56%,1
臺中市,北屯區,0977,726,255,981,30,1011,1669,60.58%,43.5%,1
臺中市,北屯區,0978,712,248,960,34,994,1685,58.99%,42.26%,1
臺中市,北屯區,0979,847,170,1017,41,1058,1785,59.27%,47.45%,1
臺中市,北屯區,0980,710,232,942,35,977,1596,61.22%,44.49%,1
臺中市,北屯區,0981,712,293,1005,41,1046,1731,60.43%,41.13%,1
臺中市,北屯區,0982,600,189,789,63,852,1496,56.95%,40.11%,1
臺中市,豐原區,0394,404,130,534,30,564,983,57.38%,41.1%,1
臺中市,豐原區,0395,588,197,785,37,822,1309,62.8%,44.92%,1
臺中市,豐原區,0396,468,195,663,33,696,1116,62.37%,41.94%,1
臺中市,豐原區,0397,437,148,585,27,612,945,64.76%,46.24%,1
臺中市,豐原區,0398,355,155,510,47,557,850,65.53%,41.76%,1
臺中市,豐原區,0399,349,121,470,26,496,760,65.26%,45.92%,1
臺中市,豐原區,0400,701,243,944,11,955,1617,59.06%,43.35%,1
臺中市,豐原區,0401,641,218,859,46,905,1677,53.97%,38.22%,1
臺中市,豐原區,0402,816,277,1093,39,1132,1771,63.92%,46.08%,1
臺中市,豐原區,0403,479,132,611,59,670,1145,58.52%,41.83%,1
臺中市,豐原區,0404,540,217,757,26,783,1362,57.49%,39.65%,1
臺中市,豐原區,0405,605,207,812,32,844,1389,60.76%,43.56%,1
臺中市,豐原區,0406,674,227,901,46,947,1530,61.9%,44.05%,1
臺中市,豐原區,0407,632,196,828,57,885,1471,60.16%,42.96%,1
臺中市,豐原區,0408,619,186,805,60,865,1410,61.35%,43.9%,1
臺中市,豐原區,0409,487,153,640,39,679,1162,58.43%,41.91%,1
臺中市,豐原區,0410,701,216,917,39,956,1656,57.73%,42.33%,1
臺中市,豐原區,0411,777,229,1006,38,1044,1838,56.8%,42.27%,1
臺中市,豐原區,0412,651,228,879,56,935,1666,56.12%,39.08%,1
臺中市,豐原區,0413,764,266,1030,66,1096,1821,60.19%,41.95%,1
臺中市,豐原區,0414,859,301,1160,57,1217,1821,66.83%,47.17%,1
臺中市,豐原區,0415,688,224,912,39,951,1647,57.74%,41.77%,1
臺中市,豐原區,0416,578,229,807,40,847,1256,67.44%,46.02%,1
臺中市,豐原區,0417,690,256,946,55,1001,1552,64.5%,44.46%,1
臺中市,豐原區,0418,771,270,1041,29,1070,1793,59.68%,43%,1
臺中市,豐原區,0419,373,132,505,36,541,759,71.28%,49.14%,1
臺中市,豐原區,0420,288,115,403,21,424,642,66.04%,44.86%,1
臺中市,豐原區,0421,664,268,932,28,960,1528,62.83%,43.46%,1
臺中市,豐原區,0422,825,268,1093,49,1142,1788,63.87%,46.14%,1
臺中市,豐原區,0423,742,301,1043,48,1091,1663,65.6%,44.62%,1
臺中市,豐原區,0424,605,215,820,55,875,1260,69.44%,48.02%,1
臺中市,豐原區,0425,373,135,508,31,539,902,59.76%,41.35%,1
臺中市,豐原區,0426,568,168,736,29,765,1357,56.37%,41.86%,1
臺中市,豐原區,0427,685,239,924,56,980,1592,61.56%,43.03%,1
臺中市,豐原區,0428,801,250,1051,50,1101,1873,58.78%,42.77%,1
臺中市,豐原區,0429,803,264,1067,35,1102,1867,59.03%,43.01%,1
臺中市,豐原區,0430,712,304,1016,45,1061,1823,58.2%,39.06%,1
臺中市,豐原區,0431,724,279,1003,42,1045,1962,53.26%,36.9%,1
臺中市,豐原區,0432,973,381,1354,67,1421,2313,61.44%,42.07%,1
臺中市,豐原區,0433,675,221,896,44,940,1510,62.25%,44.7%,1
臺中市,豐原區,0434,781,275,1056,47,1103,1824,60.47%,42.82%,1
臺中市,豐原區,0435,577,221,798,35,833,1363,61.12%,42.33%,1
臺中市,豐原區,0436,719,217,936,47,983,1535,64.04%,46.84%,1
臺中市,豐原區,0437,605,271,876,43,919,1457,63.07%,41.52%,1
臺中市,豐原區,0438,516,192,708,29,737,1184,62.25%,43.58%,1
臺中市,豐原區,0439,753,316,1069,48,1117,2299,48.59%,32.75%,1
臺中市,豐原區,0440,858,247,1105,50,1155,1940,59.54%,44.23%,1
臺中市,豐原區,0441,818,317,1135,44,1179,2067,57.04%,39.57%,1
臺中市,豐原區,0442,698,390,1088,74,1162,2038,57.02%,34.25%,1
臺中市,豐原區,0443,730,299,1029,37,1066,1835,58.09%,39.78%,1
臺中市,豐原區,0444,820,260,1080,68,1148,1979,58.01%,41.44%,1
臺中市,豐原區,0445,820,256,1076,67,1143,2014,56.75%,40.71%,1
臺中市,豐原區,0446,947,305,1252,81,1333,2257,59.06%,41.96%,1
臺中市,豐原區,0447,638,203,841,52,893,1406,63.51%,45.38%,1
臺中市,豐原區,0448,614,225,839,31,870,1418,61.35%,43.3%,1
臺中市,豐原區,0449,828,231,1059,60,1119,1772,63.15%,46.73%,1
臺中市,豐原區,0450,527,211,738,45,783,1202,65.14%,43.84%,1
臺中市,豐原區,0451,660,212,872,30,902,1447,62.34%,45.61%,1
臺中市,豐原區,0452,777,244,1021,66,1087,1758,61.83%,44.2%,1
臺中市,豐原區,0453,710,236,946,53,999,1546,64.62%,45.92%,1
臺中市,豐原區,0454,824,263,1087,47,1134,1815,62.48%,45.4%,1
臺中市,豐原區,0455,789,338,1127,45,1172,1932,60.66%,40.84%,1
臺中市,豐原區,0456,804,290,1094,40,1134,1770,64.07%,45.42%,1
臺中市,豐原區,0457,633,215,848,22,870,1560,55.77%,40.58%,1
臺中市,豐原區,0458,752,270,1022,45,1067,1810,58.95%,41.55%,1
臺中市,豐原區,0459,693,316,1009,40,1049,1653,63.46%,41.92%,1
臺中市,豐原區,0460,604,216,820,43,863,1444,59.76%,41.83%,1
臺中市,豐原區,0461,590,210,800,39,839,1318,63.66%,44.76%,1
臺中市,豐原區,0462,618,275,893,68,961,1566,61.37%,39.46%,1
臺中市,豐原區,0463,696,277,973,50,1023,1748,58.52%,39.82%,1
臺中市,豐原區,0464,664,271,935,74,1009,1772,56.94%,37.47%,1
臺中市,豐原區,0465,737,222,959,56,1015,1721,58.98%,42.82%,1
臺中市,豐原區,0466,706,208,914,37,951,1578,60.27%,44.74%,1
臺中市,豐原區,0467,704,314,1018,69,1087,1859,58.47%,37.87%,1
臺中市,豐原區,0468,597,254,851,37,888,1479,60.04%,40.37%,1
臺中市,豐原區,0469,820,271,1091,46,1137,1889,60.19%,43.41%,1
臺中市,豐原區,0470,749,245,994,44,1038,1803,57.57%,41.54%,1
臺中市,豐原區,0471,560,215,775,49,824,1421,57.99%,39.41%,1
臺中市,豐原區,0472,721,223,944,61,1005,1585,63.41%,45.49%,1
臺中市,豐原區,0473,822,241,1063,67,1130,1774,63.7%,46.34%,1
臺中市,豐原區,0474,934,274,1208,59,1267,2132,59.43%,43.81%,1
臺中市,豐原區,0475,679,188,867,42,909,1515,60%,44.82%,1
臺中市,豐原區,0476,564,174,738,24,762,1359,56.07%,41.5%,1
臺中市,豐原區,0477,424,138,562,44,606,948,63.92%,44.73%,1
臺中市,豐原區,0478,497,165,662,52,714,1134,62.96%,43.83%,1
臺中市,豐原區,0479,517,171,688,63,751,1114,67.41%,46.41%,1
臺中市,豐原區,0480,457,149,606,37,643,1050,61.24%,43.52%,1
臺中市,豐原區,0481,537,181,718,57,775,1182,65.57%,45.43%,1
臺中市,東勢區,1513,528,143,671,58,729,1299,56.12%,40.65%,1
臺中市,東勢區,1514,441,114,555,30,585,1007,58.09%,43.79%,1
臺中市,東勢區,1515,367,76,443,38,481,859,56%,42.72%,1
臺中市,東勢區,1516,501,119,620,31,651,991,65.69%,50.55%,1
臺中市,東勢區,1517,351,87,438,26,464,863,53.77%,40.67%,1
臺中市,東勢區,1518,692,169,861,66,927,1628,56.94%,42.51%,1
臺中市,東勢區,1519,495,173,668,60,728,1335,54.53%,37.08%,1
臺中市,東勢區,1520,512,165,677,31,708,1092,64.84%,46.89%,1
臺中市,東勢區,1521,505,139,644,34,678,1050,64.57%,48.1%,1
臺中市,東勢區,1522,614,166,780,47,827,1431,57.79%,42.91%,1
臺中市,東勢區,1523,635,157,792,34,826,1372,60.2%,46.28%,1
臺中市,東勢區,1524,655,168,823,20,843,1412,59.7%,46.39%,1
臺中市,東勢區,1525,415,85,500,20,520,878,59.23%,47.27%,1
臺中市,東勢區,1526,581,151,732,37,769,1475,52.14%,39.39%,1
臺中市,東勢區,1527,392,74,466,14,480,872,55.05%,44.95%,1
臺中市,東勢區,1528,432,108,540,32,572,1006,56.86%,42.94%,1
臺中市,東勢區,1529,519,149,668,28,696,1222,56.96%,42.47%,1
臺中市,東勢區,1530,602,160,762,52,814,1228,66.29%,49.02%,1
臺中市,東勢區,1531,511,130,641,28,669,1036,64.58%,49.32%,1
臺中市,東勢區,1532,480,126,606,23,629,977,64.38%,49.13%,1
臺中市,東勢區,1533,602,168,770,28,798,1395,57.2%,43.15%,1
臺中市,東勢區,1534,560,148,708,36,744,1169,63.64%,47.9%,1
臺中市,東勢區,1535,474,127,601,41,642,1027,62.51%,46.15%,1
臺中市,東勢區,1536,473,112,585,21,606,984,61.59%,48.07%,1
臺中市,東勢區,1537,428,125,553,36,589,866,68.01%,49.42%,1
臺中市,東勢區,1538,504,120,624,19,643,1031,62.37%,48.88%,1
臺中市,東勢區,1539,439,100,539,39,578,865,66.82%,50.75%,1
臺中市,東勢區,1540,677,148,825,38,863,1357,63.6%,49.89%,1
臺中市,東勢區,1541,332,86,418,38,456,736,61.96%,45.11%,1
臺中市,東勢區,1542,599,137,736,45,781,1314,59.44%,45.59%,1
臺中市,東勢區,1543,670,189,859,66,925,1677,55.16%,39.95%,1
臺中市,東勢區,1544,468,116,584,14,598,950,62.95%,49.26%,1
臺中市,東勢區,1545,489,121,610,22,632,1007,62.76%,48.56%,1
臺中市,東勢區,1546,461,132,593,49,642,1214,52.88%,37.97%,1
臺中市,東勢區,1547,398,79,477,44,521,907,57.44%,43.88%,1
臺中市,東勢區,1548,355,114,469,34,503,902,55.76%,39.36%,1
臺中市,東勢區,1549,256,64,320,16,336,720,46.67%,35.56%,1
臺中市,東勢區,1550,242,67,309,11,320,666,48.05%,36.34%,1
臺中市,東勢區,1551,536,143,679,70,749,1361,55.03%,39.38%,1
臺中市,大甲區,0001,580,200,780,39,819,1356,60.4%,42.77%,1
臺中市,大甲區,0002,461,181,642,25,667,1059,62.98%,43.53%,1
臺中市,大甲區,0003,315,119,434,14,448,694,64.55%,45.39%,1
臺中市,大甲區,0004,388,128,516,19,535,874,61.21%,44.39%,1
臺中市,大甲區,0005,310,100,410,20,430,763,56.36%,40.63%,1
臺中市,大甲區,0006,398,130,528,24,552,856,64.49%,46.5%,1
臺中市,大甲區,0007,333,381,714,33,747,1249,59.81%,26.66%,1
臺中市,大甲區,0008,390,126,516,18,534,922,57.92%,42.3%,1
臺中市,大甲區,0009,504,184,688,27,715,1189,60.13%,42.39%,1
臺中市,大甲區,0010,482,151,633,50,683,1065,64.13%,45.26%,1
臺中市,大甲區,0011,589,172,761,44,805,1252,64.3%,47.04%,1
臺中市,大甲區,0012,440,144,584,48,632,1057,59.79%,41.63%,1
臺中市,大甲區,0013,467,131,598,29,627,1031,60.81%,45.3%,1
臺中市,大甲區,0014,476,167,643,29,672,1060,63.4%,44.91%,1
臺中市,大甲區,0015,548,186,734,34,768,1311,58.58%,41.8%,1
臺中市,大甲區,0016,612,170,782,38,820,1424,57.58%,42.98%,1
臺中市,大甲區,0017,704,235,939,51,990,1670,59.28%,42.16%,1
臺中市,大甲區,0018,345,112,457,28,485,812,59.73%,42.49%,1
臺中市,大甲區,0019,434,104,538,26,564,863,65.35%,50.29%,1
臺中市,大甲區,0020,690,223,913,37,950,1598,59.45%,43.18%,1
臺中市,大甲區,0021,680,204,884,26,910,1588,57.3%,42.82%,1
臺中市,大甲區,0022,504,150,654,48,702,1197,58.65%,42.11%,1
臺中市,大甲區,0023,433,130,563,55,618,1106,55.88%,39.15%,1
臺中市,大甲區,0024,413,123,536,36,572,903,63.34%,45.74%,1
臺中市,大甲區,0025,398,109,507,30,537,869,61.8%,45.8%,1
臺中市,大甲區,0026,582,218,800,29,829,1350,61.41%,43.11%,1
臺中市,大甲區,0027,500,150,650,39,689,1144,60.23%,43.71%,1
臺中市,大甲區,0028,566,155,721,25,746,1208,61.75%,46.85%,1
臺中市,大甲區,0029,581,265,846,47,893,1567,56.99%,37.08%,1
臺中市,大甲區,0030,542,224,766,42,808,1246,64.85%,43.5%,1
臺中市,大甲區,0031,350,104,454,20,474,767,61.8%,45.63%,1
臺中市,大甲區,0032,363,101,464,24,488,790,61.77%,45.95%,1
臺中市,大甲區,0033,445,142,587,28,615,972,63.27%,45.78%,1
臺中市,大甲區,0034,580,174,754,16,770,1388,55.48%,41.79%,1
臺中市,大甲區,0035,518,175,693,28,721,1331,54.17%,38.92%,1
臺中市,大甲區,0036,533,167,700,26,726,1167,62.21%,45.67%,1
臺中市,大甲區,0037,735,372,1107,33,1140,1934,58.95%,38%,1
臺中市,大甲區,0038,472,148,620,41,661,1263,52.34%,37.37%,1
臺中市,大甲區,0039,572,194,766,36,802,1390,57.7%,41.15%,1
臺中市,大甲區,0040,456,123,579,27,606,1186,51.1%,38.45%,1
臺中市,大甲區,0041,591,181,772,31,803,1397,57.48%,42.3%,1
臺中市,大甲區,0042,421,124,545,16,561,1173,47.83%,35.89%,1
臺中市,大甲區,0043,547,187,734,39,773,1398,55.29%,39.13%,1
臺中市,大甲區,0044,431,182,613,28,641,1228,52.2%,35.1%,1
臺中市,大甲區,0045,501,157,658,24,682,1258,54.21%,39.83%,1
臺中市,大甲區,0046,603,170,773,32,805,1435,56.1%,42.02%,1
臺中市,大甲區,0047,591,218,809,37,846,1532,55.22%,38.58%,1
臺中市,大甲區,0048,265,89,354,26,380,652,58.28%,40.64%,1
臺中市,大甲區,0049,315,103,418,27,445,870,51.15%,36.21%,1
臺中市,大甲區,0050,346,107,453,28,481,891,53.98%,38.83%,1
臺中市,大甲區,0051,351,86,437,31,468,784,59.69%,44.77%,1
臺中市,大甲區,0052,526,149,675,74,749,1368,54.75%,38.45%,1
臺中市,大甲區,0053,415,140,555,45,600,1126,53.29%,36.86%,1
臺中市,大甲區,0054,500,184,684,54,738,1486,49.66%,33.65%,1
臺中市,清水區,0091,410,158,568,22,590,1076,54.83%,38.1%,1
臺中市,清水區,0092,419,172,591,34,625,953,65.58%,43.97%,1
臺中市,清水區,0093,382,145,527,45,572,914,62.58%,41.79%,1
臺中市,清水區,0094,515,179,694,38,732,1143,64.04%,45.06%,1
臺中市,清水區,0095,266,132,398,30,428,680,62.94%,39.12%,1
臺中市,清水區,0096,407,123,530,32,562,904,62.17%,45.02%,1
臺中市,清水區,0097,407,139,546,37,583,893,65.29%,45.58%,1
臺中市,清水區,0098,669,218,887,32,919,1577,58.28%,42.42%,1
臺中市,清水區,0099,302,85,387,30,417,690,60.43%,43.77%,1
臺中市,清水區,0100,177,60,237,13,250,403,62.03%,43.92%,1
臺中市,清水區,0101,581,218,799,48,847,1413,59.94%,41.12%,1
臺中市,清水區,0102,326,105,431,29,460,777,59.2%,41.96%,1
臺中市,清水區,0103,570,195,765,35,800,1313,60.93%,43.41%,1
臺中市,清水區,0104,617,222,839,53,892,1439,61.99%,42.88%,1
臺中市,清水區,0105,493,176,669,29,698,1265,55.18%,38.97%,1
臺中市,清水區,0106,568,198,766,40,806,1277,63.12%,44.48%,1
臺中市,清水區,0107,556,184,740,40,780,1276,61.13%,43.57%,1
臺中市,清水區,0108,604,236,840,27,867,1376,63.01%,43.9%,1
臺中市,清水區,0109,593,210,803,23,826,1291,63.98%,45.93%,1
臺中市,清水區,0110,638,240,878,47,925,1510,61.26%,42.25%,1
臺中市,清水區,0111,638,217,855,54,909,1524,59.65%,41.86%,1
臺中市,清水區,0112,623,147,770,36,806,1474,54.68%,42.27%,1
臺中市,清水區,0113,618,206,824,41,865,1507,57.4%,41.01%,1
臺中市,清水區,0114,598,200,798,63,861,1321,65.18%,45.27%,1
臺中市,清水區,0115,436,150,586,29,615,1157,53.15%,37.68%,1
臺中市,清水區,0116,528,185,713,45,758,1255,60.4%,42.07%,1
臺中市,清水區,0117,364,119,483,25,508,881,57.66%,41.32%,1
臺中市,清水區,0118,464,143,607,50,657,1083,60.66%,42.84%,1
臺中市,清水區,0119,423,138,561,10,571,951,60.04%,44.48%,1
臺中市,清水區,0120,558,188,746,46,792,1424,55.62%,39.19%,1
臺中市,清水區,0121,475,159,634,43,677,1233,54.91%,38.52%,1
臺中市,清水區,0122,431,167,598,35,633,1288,49.15%,33.46%,1
臺中市,清水區,0123,528,145,673,41,714,1200,59.5%,44%,1
臺中市,清水區,0124,736,180,916,48,964,1609,59.91%,45.74%,1
臺中市,清水區,0125,508,198,706,21,727,1136,64%,44.72%,1
臺中市,清水區,0126,553,133,686,61,747,1302,57.37%,42.47%,1
臺中市,清水區,0127,531,182,713,83,796,1373,57.98%,38.67%,1
臺中市,清水區,0128,446,158,604,52,656,1257,52.19%,35.48%,1
臺中市,清水區,0129,445,154,599,26,625,1184,52.79%,37.58%,1
臺中市,清水區,0130,537,153,690,60,750,1322,56.73%,40.62%,1
臺中市,清水區,0131,452,145,597,41,638,1193,53.48%,37.89%,1
臺中市,清水區,0132,403,120,523,27,550,927,59.33%,43.47%,1
臺中市,清水區,0133,446,165,611,58,669,1073,62.35%,41.57%,1
臺中市,清水區,0134,502,177,679,50,729,1163,62.68%,43.16%,1
臺中市,清水區,0135,338,96,434,43,477,855,55.79%,39.53%,1
臺中市,清水區,0136,352,105,457,46,503,902,55.76%,39.02%,1
臺中市,清水區,0137,560,217,777,40,817,1415,57.74%,39.58%,1
臺中市,清水區,0138,429,127,556,31,587,1066,55.07%,40.24%,1
臺中市,清水區,0139,551,167,718,63,781,1391,56.15%,39.61%,1
臺中市,清水區,0140,567,169,736,29,765,1449,52.8%,39.13%,1
臺中市,清水區,0141,612,186,798,38,836,1377,60.71%,44.44%,1
臺中市,清水區,0142,621,202,823,33,856,1423,60.15%,43.64%,1
臺中市,清水區,0143,669,237,906,36,942,1624,58%,41.19%,1
臺中市,清水區,0144,529,170,699,59,758,1358,55.82%,38.95%,1
臺中市,清水區,0145,619,183,802,57,859,1464,58.67%,42.28%,1
臺中市,清水區,0146,519,169,688,64,752,1211,62.1%,42.86%,1
臺中市,清水區,0147,592,175,767,31,798,1456,54.81%,40.66%,1
臺中市,清水區,0148,546,129,675,52,727,1162,62.56%,46.99%,1
臺中市,清水區,0149,675,161,836,143,979,1368,71.56%,49.34%,1
臺中市,沙鹿區,0186,507,220,727,27,754,1380,54.64%,36.74%,1
臺中市,沙鹿區,0187,366,122,488,33,521,852,61.15%,42.96%,1
臺中市,沙鹿區,0188,535,167,702,28,730,1176,62.07%,45.49%,1
臺中市,沙鹿區,0189,434,159,593,53,646,958,67.43%,45.3%,1
臺中市,沙鹿區,0190,233,81,314,22,336,488,68.85%,47.75%,1
臺中市,沙鹿區,0191,459,200,659,35,694,1177,58.96%,39%,1
臺中市,沙鹿區,0192,516,191,707,35,742,1285,57.74%,40.16%,1
臺中市,沙鹿區,0193,638,238,876,61,937,1736,53.97%,36.75%,1
臺中市,沙鹿區,0194,695,267,962,39,1001,1628,61.49%,42.69%,1
臺中市,沙鹿區,0195,568,198,766,33,799,1469,54.39%,38.67%,1
臺中市,沙鹿區,0196,625,205,830,43,873,1423,61.35%,43.92%,1
臺中市,沙鹿區,0197,636,181,817,46,863,1444,59.76%,44.04%,1
臺中市,沙鹿區,0198,604,205,809,57,866,1469,58.95%,41.12%,1
臺中市,沙鹿區,0199,746,311,1057,44,1101,1902,57.89%,39.22%,1
臺中市,沙鹿區,0200,682,266,948,43,991,1675,59.16%,40.72%,1
臺中市,沙鹿區,0201,466,141,607,29,636,1098,57.92%,42.44%,1
臺中市,沙鹿區,0202,633,251,884,59,943,1539,61.27%,41.13%,1
臺中市,沙鹿區,0203,504,282,786,27,813,1329,61.17%,37.92%,1
臺中市,沙鹿區,0204,501,186,687,31,718,1255,57.21%,39.92%,1
臺中市,沙鹿區,0205,598,262,860,49,909,1507,60.32%,39.68%,1
臺中市,沙鹿區,0206,590,218,808,63,871,1463,59.54%,40.33%,1
臺中市,沙鹿區,0207,500,155,655,56,711,1279,55.59%,39.09%,1
臺中市,沙鹿區,0208,408,118,526,26,552,1024,53.91%,39.84%,1
臺中市,沙鹿區,0209,540,159,699,60,759,1388,54.68%,38.9%,1
臺中市,沙鹿區,0210,451,181,632,19,651,1074,60.61%,41.99%,1
臺中市,沙鹿區,0211,459,171,630,25,655,1072,61.1%,42.82%,1
臺中市,沙鹿區,0212,507,128,635,53,688,1107,62.15%,45.8%,1
臺中市,沙鹿區,0213,704,257,961,33,994,1947,51.05%,36.16%,1
臺中市,沙鹿區,0214,671,200,871,40,911,1682,54.16%,39.89%,1
臺中市,沙鹿區,0215,674,237,911,45,956,1633,58.54%,41.27%,1
臺中市,沙鹿區,0216,692,195,887,29,916,1533,59.75%,45.14%,1
臺中市,沙鹿區,0217,577,201,778,21,799,1605,49.78%,35.95%,1
臺中市,沙鹿區,0218,660,118,778,29,807,1694,47.64%,38.96%,1
臺中市,沙鹿區,0219,600,238,838,40,878,1628,53.93%,36.86%,1
臺中市,沙鹿區,0220,687,278,965,21,986,1665,59.22%,41.26%,1
臺中市,沙鹿區,0221,647,229,876,36,912,1651,55.24%,39.19%,1
臺中市,沙鹿區,0222,520,145,665,24,689,1108,62.18%,46.93%,1
臺中市,沙鹿區,0223,499,172,671,34,705,1142,61.73%,43.7%,1
臺中市,沙鹿區,0224,450,131,581,23,604,1039,58.13%,43.31%,1
臺中市,沙鹿區,0225,725,257,982,37,1019,1840,55.38%,39.4%,1
臺中市,沙鹿區,0226,733,269,1002,37,1039,1872,55.5%,39.16%,1
臺中市,沙鹿區,0227,574,216,790,47,837,1558,53.72%,36.84%,1
臺中市,沙鹿區,0228,639,235,874,32,906,1739,52.1%,36.75%,1
臺中市,沙鹿區,0229,590,224,814,29,843,1672,50.42%,35.29%,1
臺中市,沙鹿區,0230,637,232,869,40,909,1634,55.63%,38.98%,1
臺中市,沙鹿區,0231,575,220,795,34,829,1616,51.3%,35.58%,1
臺中市,沙鹿區,0232,632,241,873,35,908,1593,57%,39.67%,1
臺中市,沙鹿區,0233,409,111,520,19,539,981,54.94%,41.69%,1
臺中市,沙鹿區,0234,763,235,998,51,1049,1740,60.29%,43.85%,1
臺中市,沙鹿區,0235,549,179,728,41,769,1247,61.67%,44.03%,1
臺中市,沙鹿區,0236,484,126,610,22,632,1047,60.36%,46.23%,1
臺中市,沙鹿區,0237,475,141,616,48,664,1119,59.34%,42.45%,1
臺中市,沙鹿區,0238,433,117,550,23,573,1025,55.9%,42.24%,1
臺中市,梧棲區,0150,604,229,833,36,869,1541,56.39%,39.2%,1
臺中市,梧棲區,0151,581,222,803,83,886,1581,56.04%,36.75%,1
臺中市,梧棲區,0152,422,174,596,43,639,1083,59%,38.97%,1
臺中市,梧棲區,0153,364,136,500,29,529,876,60.39%,41.55%,1
臺中市,梧棲區,0154,429,152,581,42,623,1043,59.73%,41.13%,1
臺中市,梧棲區,0155,534,223,757,27,784,1502,52.2%,35.55%,1
臺中市,梧棲區,0156,576,193,769,38,807,1384,58.31%,41.62%,1
臺中市,梧棲區,0157,244,83,327,23,350,517,67.7%,47.2%,1
臺中市,梧棲區,0158,525,166,691,61,752,1169,64.33%,44.91%,1
臺中市,梧棲區,0159,360,136,496,28,524,863,60.72%,41.71%,1
臺中市,梧棲區,0160,440,161,601,43,644,1277,50.43%,34.46%,1
臺中市,梧棲區,0161,669,241,910,38,948,1742,54.42%,38.4%,1
臺中市,梧棲區,0162,527,219,746,47,793,1342,59.09%,39.27%,1
臺中市,梧棲區,0163,724,246,970,53,1023,1767,57.89%,40.97%,1
臺中市,梧棲區,0164,528,212,740,50,790,1542,51.23%,34.24%,1
臺中市,梧棲區,0165,701,164,865,32,897,1636,54.83%,42.85%,1
臺中市,梧棲區,0166,669,241,910,48,958,1796,53.34%,37.25%,1
臺中市,梧棲區,0167,566,191,757,47,804,1450,55.45%,39.03%,1
臺中市,梧棲區,0168,578,192,770,85,855,1548,55.23%,37.34%,1
臺中市,梧棲區,0169,561,216,777,30,807,1366,59.08%,41.07%,1
臺中市,梧棲區,0170,440,158,598,24,622,955,65.13%,46.07%,1
臺中市,梧棲區,0171,519,163,682,36,718,1305,55.02%,39.77%,1
臺中市,梧棲區,0172,505,194,699,36,735,1239,59.32%,40.76%,1
臺中市,梧棲區,0173,489,142,631,38,669,1079,62%,45.32%,1
臺中市,梧棲區,0174,500,157,657,33,690,1220,56.56%,40.98%,1
臺中市,梧棲區,0175,665,211,876,54,930,1544,60.23%,43.07%,1
臺中市,梧棲區,0176,598,241,839,46,885,1460,60.62%,40.96%,1
臺中市,梧棲區,0177,554,203,757,33,790,1292,61.15%,42.88%,1
臺中市,梧棲區,0178,525,174,699,41,740,1300,56.92%,40.38%,1
臺中市,梧棲區,0179,594,205,799,41,840,1555,54.02%,38.2%,1
臺中市,梧棲區,0180,397,152,549,29,578,1031,56.06%,38.51%,1
臺中市,梧棲區,0181,555,190,745,37,782,1277,61.24%,43.46%,1
臺中市,梧棲區,0182,389,157,546,36,582,1037,56.12%,37.51%,1
臺中市,梧棲區,0183,493,173,666,50,716,1187,60.32%,41.53%,1
臺中市,梧棲區,0184,568,163,731,45,776,1399,55.47%,40.6%,1
臺中市,梧棲區,0185,479,134,613,38,651,1135,57.36%,42.2%,1
臺中市,后里區,0357,389,116,505,40,545,852,63.97%,45.66%,1
臺中市,后里區,0358,472,121,593,57,650,1135,57.27%,41.59%,1
臺中市,后里區,0359,427,133,560,19,579,1079,53.66%,39.57%,1
臺中市,后里區,0360,644,212,856,63,919,1539,59.71%,41.85%,1
臺中市,后里區,0361,623,252,875,52,927,1591,58.27%,39.16%,1
臺中市,后里區,0362,505,176,681,41,722,1376,52.47%,36.7%,1
臺中市,后里區,0363,190,532,722,26,748,1298,57.63%,14.64%,1
臺中市,后里區,0364,603,202,805,63,868,1428,60.78%,42.23%,1
臺中市,后里區,0365,498,245,743,43,786,1178,66.72%,42.28%,1
臺中市,后里區,0366,468,149,617,41,658,1095,60.09%,42.74%,1
臺中市,后里區,0367,389,140,529,25,554,963,57.53%,40.39%,1
臺中市,后里區,0368,468,167,635,40,675,1163,58.04%,40.24%,1
臺中市,后里區,0369,440,144,584,37,621,1018,61%,43.22%,1
臺中市,后里區,0370,393,123,516,40,556,854,65.11%,46.02%,1
臺中市,后里區,0371,580,186,766,49,815,1485,54.88%,39.06%,1
臺中市,后里區,0372,630,199,829,34,863,1355,63.69%,46.49%,1
臺中市,后里區,0373,314,115,429,37,466,840,55.48%,37.38%,1
臺中市,后里區,0374,490,146,636,50,686,1146,59.86%,42.76%,1
臺中市,后里區,0375,744,225,969,61,1030,1669,61.71%,44.58%,1
臺中市,后里區,0376,756,226,982,62,1044,1673,62.4%,45.19%,1
臺中市,后里區,0377,637,207,844,30,874,1493,58.54%,42.67%,1
臺中市,后里區,0378,451,157,608,52,660,1052,62.74%,42.87%,1
臺中市,后里區,0379,366,123,489,21,510,909,56.11%,40.26%,1
臺中市,后里區,0380,462,148,610,64,674,1091,61.78%,42.35%,1
臺中市,后里區,0381,619,194,813,17,830,1342,61.85%,46.13%,1
臺中市,后里區,0382,468,145,613,37,650,1138,57.12%,41.12%,1
臺中市,后里區,0383,446,117,563,27,590,977,60.39%,45.65%,1
臺中市,后里區,0384,595,156,751,30,781,1584,49.31%,37.56%,1
臺中市,后里區,0385,400,92,492,38,530,915,57.92%,43.72%,1
臺中市,后里區,0386,510,171,681,60,741,1225,60.49%,41.63%,1
臺中市,后里區,0387,617,210,827,37,864,1552,55.67%,39.76%,1
臺中市,后里區,0388,677,192,869,29,898,1600,56.13%,42.31%,1
臺中市,后里區,0389,397,122,519,31,550,942,58.39%,42.14%,1
臺中市,后里區,0390,364,130,494,34,528,943,55.99%,38.6%,1
臺中市,后里區,0391,408,128,536,26,562,1055,53.27%,38.67%,1
臺中市,后里區,0392,437,144,581,52,633,1067,59.33%,40.96%,1
臺中市,后里區,0393,531,139,670,45,715,1340,53.36%,39.63%,1
臺中市,神岡區,0482,728,242,970,49,1019,1684,60.51%,43.23%,1
臺中市,神岡區,0483,686,208,894,34,928,1559,59.53%,44%,1
臺中市,神岡區,0484,470,148,618,21,639,1095,58.36%,42.92%,1
臺中市,神岡區,0485,506,164,670,39,709,1044,67.91%,48.47%,1
臺中市,神岡區,0486,616,192,808,49,857,1310,65.42%,47.02%,1
臺中市,神岡區,0487,576,204,780,45,825,1294,63.76%,44.51%,1
臺中市,神岡區,0488,498,160,658,43,701,1143,61.33%,43.57%,1
臺中市,神岡區,0489,456,155,611,29,640,1022,62.62%,44.62%,1
臺中市,神岡區,0490,527,161,688,38,726,1269,57.21%,41.53%,1
臺中市,神岡區,0491,420,107,527,22,549,1085,50.6%,38.71%,1
臺中市,神岡區,0492,419,145,564,35,599,942,63.59%,44.48%,1
臺中市,神岡區,0493,498,167,665,26,691,1154,59.88%,43.15%,1
臺中市,神岡區,0494,568,177,745,50,795,1390,57.19%,40.86%,1
臺中市,神岡區,0495,642,182,824,43,867,1372,63.19%,46.79%,1
臺中市,神岡區,0496,546,160,706,37,743,1328,55.95%,41.11%,1
臺中市,神岡區,0497,434,152,586,21,607,1038,58.48%,41.81%,1
臺中市,神岡區,0498,609,186,795,33,828,1452,57.02%,41.94%,1
臺中市,神岡區,0499,704,218,922,37,959,1551,61.83%,45.39%,1
臺中市,神岡區,0500,624,195,819,50,869,1567,55.46%,39.82%,1
臺中市,神岡區,0501,608,213,821,22,843,1449,58.18%,41.96%,1
臺中市,神岡區,0502,504,141,645,31,676,1246,54.25%,40.45%,1
臺中市,神岡區,0503,635,188,823,36,859,1431,60.03%,44.37%,1
臺中市,神岡區,0504,502,177,679,56,735,1163,63.2%,43.16%,1
臺中市,神岡區,0505,620,240,860,43,903,1402,64.41%,44.22%,1
臺中市,神岡區,0506,546,193,739,34,773,1271,60.82%,42.96%,1
臺中市,神岡區,0507,556,144,700,52,752,1198,62.77%,46.41%,1
臺中市,神岡區,0508,611,163,774,40,814,1312,62.04%,46.57%,1
臺中市,神岡區,0509,655,217,872,45,917,1590,57.67%,41.19%,1
臺中市,神岡區,0510,540,178,718,27,745,1324,56.27%,40.79%,1
臺中市,神岡區,0511,545,221,766,26,792,1415,55.97%,38.52%,1
臺中市,神岡區,0512,723,217,940,25,965,1483,65.07%,48.75%,1
臺中市,神岡區,0513,585,154,739,38,777,1402,55.42%,41.73%,1
臺中市,神岡區,0514,494,177,671,45,716,1275,56.16%,38.75%,1
臺中市,神岡區,0515,502,171,673,34,707,1288,54.89%,38.98%,1
臺中市,神岡區,0516,454,130,584,34,618,1080,57.22%,42.04%,1
臺中市,神岡區,0517,649,101,750,17,767,1344,57.07%,48.29%,1
臺中市,神岡區,0518,475,164,639,32,671,1061,63.24%,44.77%,1
臺中市,神岡區,0519,522,197,719,32,751,1176,63.86%,44.39%,1
臺中市,神岡區,0520,545,182,727,54,781,1244,62.78%,43.81%,1
臺中市,神岡區,0521,640,177,817,40,857,1318,65.02%,48.56%,1
臺中市,神岡區,0522,431,180,611,43,654,1471,44.46%,29.3%,1
臺中市,神岡區,0523,637,188,825,59,884,1323,66.82%,48.15%,1
臺中市,潭子區,0570,581,201,782,27,809,1306,61.94%,44.49%,1
臺中市,潭子區,0571,494,170,664,34,698,1128,61.88%,43.79%,1
臺中市,潭子區,0572,526,174,700,50,750,1159,64.71%,45.38%,1
臺中市,潭子區,0573,709,234,943,66,1009,1630,61.9%,43.5%,1
臺中市,潭子區,0574,656,195,851,37,888,1532,57.96%,42.82%,1
臺中市,潭子區,0575,624,237,861,30,891,1677,53.13%,37.21%,1
臺中市,潭子區,0576,671,224,895,34,929,1744,53.27%,38.47%,1
臺中市,潭子區,0577,724,268,992,46,1038,1795,57.83%,40.33%,1
臺中市,潭子區,0578,479,173,652,31,683,1171,58.33%,40.91%,1
臺中市,潭子區,0579,581,210,791,26,817,1427,57.25%,40.71%,1
臺中市,潭子區,0580,699,229,928,63,991,1709,57.99%,40.9%,1
臺中市,潭子區,0581,709,237,946,45,991,1723,57.52%,41.15%,1
臺中市,潭子區,0582,714,221,935,46,981,1782,55.05%,40.07%,1
臺中市,潭子區,0583,555,187,742,28,770,1407,54.73%,39.45%,1
臺中市,潭子區,0584,746,286,1032,32,1064,1771,60.08%,42.12%,1
臺中市,潭子區,0585,784,241,1025,61,1086,1795,60.5%,43.68%,1
臺中市,潭子區,0586,731,252,983,35,1018,1612,63.15%,45.35%,1
臺中市,潭子區,0587,747,292,1039,27,1066,1894,56.28%,39.44%,1
臺中市,潭子區,0588,670,268,938,38,976,1689,57.79%,39.67%,1
臺中市,潭子區,0589,582,210,792,35,827,1525,54.23%,38.16%,1
臺中市,潭子區,0590,654,229,883,36,919,1622,56.66%,40.32%,1
臺中市,潭子區,0591,610,66,676,49,725,1200,60.42%,50.83%,1
臺中市,潭子區,0592,544,192,736,17,753,1355,55.57%,40.15%,1
臺中市,潭子區,0593,682,275,957,26,983,1777,55.32%,38.38%,1
臺中市,潭子區,0594,776,284,1060,36,1096,1923,56.99%,40.35%,1
臺中市,潭子區,0595,678,201,879,43,922,1674,55.08%,40.5%,1
臺中市,潭子區,0596,636,248,884,24,908,1451,62.58%,43.83%,1
臺中市,潭子區,0597,623,217,840,42,882,1486,59.35%,41.92%,1
臺中市,潭子區,0598,625,218,843,39,882,1511,58.37%,41.36%,1
臺中市,潭子區,0599,737,221,958,40,998,1666,59.9%,44.24%,1
臺中市,潭子區,0600,693,250,943,48,991,1750,56.63%,39.6%,1
臺中市,潭子區,0601,603,186,789,29,818,1437,56.92%,41.96%,1
臺中市,潭子區,0602,708,254,962,34,996,1735,57.41%,40.81%,1
臺中市,潭子區,0603,642,249,891,25,916,1612,56.82%,39.83%,1
臺中市,潭子區,0604,486,201,687,21,708,1143,61.94%,42.52%,1
臺中市,潭子區,0605,866,267,1133,39,1172,2096,55.92%,41.32%,1
臺中市,潭子區,0606,664,239,903,38,941,1549,60.75%,42.87%,1
臺中市,潭子區,0607,712,213,925,29,954,1573,60.65%,45.26%,1
臺中市,潭子區,0608,659,182,841,36,877,1585,55.33%,41.58%,1
臺中市,潭子區,0609,625,224,849,23,872,1572,55.47%,39.76%,1
臺中市,潭子區,0610,751,265,1016,42,1058,1738,60.87%,43.21%,1
臺中市,潭子區,0611,753,251,1004,51,1055,1883,56.03%,39.99%,1
臺中市,潭子區,0612,647,198,845,33,878,1401,62.67%,46.18%,1
臺中市,潭子區,0613,601,201,802,33,835,1352,61.76%,44.45%,1
臺中市,潭子區,0614,923,260,1183,59,1242,2085,59.57%,44.27%,1
臺中市,潭子區,0615,889,286,1175,67,1242,2047,60.67%,43.43%,1
臺中市,潭子區,0616,655,250,905,19,924,1673,55.23%,39.15%,1
臺中市,潭子區,0617,760,284,1044,73,1117,1874,59.61%,40.55%,1
臺中市,潭子區,0618,463,155,618,22,640,1051,60.89%,44.05%,1
臺中市,潭子區,0619,631,245,876,17,893,1674,53.35%,37.69%,1
臺中市,潭子區,0620,773,251,1024,61,1085,1831,59.26%,42.22%,1
臺中市,潭子區,0621,799,281,1080,45,1125,2003,56.17%,39.89%,1
臺中市,潭子區,0622,700,184,884,36,920,1535,59.93%,45.6%,1
臺中市,潭子區,0623,841,259,1100,78,1178,2286,51.53%,36.79%,1
臺中市,潭子區,0624,758,206,964,41,1005,1861,54%,40.73%,1
臺中市,大雅區,0524,859,263,1122,52,1174,2027,57.92%,42.38%,1
臺中市,大雅區,0525,725,283,1008,34,1042,1967,52.97%,36.86%,1
臺中市,大雅區,0526,717,292,1009,36,1045,1912,54.65%,37.5%,1
臺中市,大雅區,0527,650,262,912,32,944,1537,61.42%,42.29%,1
臺中市,大雅區,0528,649,230,879,28,907,1439,63.03%,45.1%,1
臺中市,大雅區,0529,580,234,814,25,839,1402,59.84%,41.37%,1
臺中市,大雅區,0530,755,300,1055,33,1088,2013,54.05%,37.51%,1
臺中市,大雅區,0531,782,279,1061,59,1120,1917,58.42%,40.79%,1
臺中市,大雅區,0532,783,293,1076,49,1125,2011,55.94%,38.94%,1
臺中市,大雅區,0533,831,243,1074,46,1120,1887,59.35%,44.04%,1
臺中市,大雅區,0534,609,258,867,45,912,1480,61.62%,41.15%,1
臺中市,大雅區,0535,771,256,1027,52,1079,1816,59.42%,42.46%,1
臺中市,大雅區,0536,684,259,943,36,979,1898,51.58%,36.04%,1
臺中市,大雅區,0537,851,255,1106,44,1150,2008,57.27%,42.38%,1
臺中市,大雅區,0538,834,280,1114,44,1158,1976,58.6%,42.21%,1
臺中市,大雅區,0539,691,265,956,27,983,1673,58.76%,41.3%,1
臺中市,大雅區,0540,639,216,855,30,885,1409,62.81%,45.35%,1
臺中市,大雅區,0541,211,603,814,17,831,1382,60.13%,15.27%,1
臺中市,大雅區,0542,704,184,888,47,935,1635,57.19%,43.06%,1
臺中市,大雅區,0543,655,222,877,52,929,1565,59.36%,41.85%,1
臺中市,大雅區,0544,628,189,817,41,858,1528,56.15%,41.1%,1
臺中市,大雅區,0545,813,234,1047,33,1080,1963,55.02%,41.42%,1
臺中市,大雅區,0546,792,282,1074,37,1111,2073,53.59%,38.21%,1
臺中市,大雅區,0547,803,271,1074,30,1104,1984,55.65%,40.47%,1
臺中市,大雅區,0548,701,221,922,31,953,1688,56.46%,41.53%,1
臺中市,大雅區,0549,586,184,770,32,802,1387,57.82%,42.25%,1
臺中市,大雅區,0550,743,240,983,55,1038,1701,61.02%,43.68%,1
臺中市,大雅區,0551,727,217,944,41,985,1721,57.23%,42.24%,1
臺中市,大雅區,0552,665,195,860,45,905,1879,48.16%,35.39%,1
臺中市,大雅區,0553,744,221,965,42,1007,1568,64.22%,47.45%,1
臺中市,大雅區,0554,669,279,948,36,984,1761,55.88%,37.99%,1
臺中市,大雅區,0555,779,252,1031,42,1073,1752,61.24%,44.46%,1
臺中市,大雅區,0556,544,187,731,30,761,1264,60.21%,43.04%,1
臺中市,大雅區,0557,614,172,786,32,818,1302,62.83%,47.16%,1
臺中市,大雅區,0558,580,209,789,48,837,1449,57.76%,40.03%,1
臺中市,大雅區,0559,702,235,937,63,1000,1621,61.69%,43.31%,1
臺中市,大雅區,0560,686,193,879,49,928,1647,56.34%,41.65%,1
臺中市,大雅區,0561,593,193,786,39,825,1441,57.25%,41.15%,1
臺中市,大雅區,0562,601,207,808,24,832,1460,56.99%,41.16%,1
臺中市,大雅區,0563,829,242,1071,58,1129,1832,61.63%,45.25%,1
臺中市,大雅區,0564,627,201,828,45,873,1371,63.68%,45.73%,1
臺中市,大雅區,0565,577,184,761,13,774,1418,54.58%,40.69%,1
臺中市,大雅區,0566,642,222,864,37,901,1473,61.17%,43.58%,1
臺中市,大雅區,0567,548,199,747,38,785,1335,58.8%,41.05%,1
臺中市,大雅區,0568,759,188,947,50,997,1733,57.53%,43.8%,1
臺中市,大雅區,0569,707,193,900,57,957,1884,50.8%,37.53%,1
臺中市,新社區,1562,459,112,571,21,592,1011,58.56%,45.4%,1
臺中市,新社區,1563,440,163,603,23,626,1195,52.38%,36.82%,1
臺中市,新社區,1564,498,149,647,24,671,1053,63.72%,47.29%,1
臺中市,新社區,1565,340,86,426,27,453,961,47.14%,35.38%,1
臺中市,新社區,1566,373,106,479,10,489,919,53.21%,40.59%,1
臺中市,新社區,1567,636,158,794,50,844,1367,61.74%,46.53%,1
臺中市,新社區,1568,409,122,531,26,557,1010,55.15%,40.5%,1
臺中市,新社區,1569,404,119,523,59,582,1169,49.79%,34.56%,1
臺中市,新社區,1570,406,123,529,36,565,989,57.13%,41.05%,1
臺中市,新社區,1571,388,110,498,14,512,894,57.27%,43.4%,1
臺中市,新社區,1572,488,85,573,29,602,1033,58.28%,47.24%,1
臺中市,新社區,1573,356,104,460,27,487,1058,46.03%,33.65%,1
臺中市,新社區,1574,318,95,413,20,433,845,51.24%,37.63%,1
臺中市,新社區,1575,290,67,357,32,389,576,67.53%,50.35%,1
臺中市,新社區,1576,463,132,595,34,629,1229,51.18%,37.67%,1
臺中市,新社區,1577,296,108,404,23,427,890,47.98%,33.26%,1
臺中市,新社區,1578,315,84,399,27,426,781,54.55%,40.33%,1
臺中市,新社區,1579,491,140,631,50,681,1244,54.74%,39.47%,1
臺中市,新社區,1580,55,13,68,12,80,213,37.56%,25.82%,1
臺中市,新社區,1581,236,61,297,26,323,676,47.78%,34.91%,1
臺中市,新社區,1582,221,49,270,14,284,585,48.55%,37.78%,1
臺中市,新社區,1583,419,94,513,23,536,938,57.14%,44.67%,1
臺中市,新社區,1584,95,12,107,4,111,224,49.55%,42.41%,1
臺中市,石岡區,1552,518,172,690,34,724,1244,58.2%,41.64%,1
臺中市,石岡區,1553,645,175,820,48,868,1539,56.4%,41.91%,1
臺中市,石岡區,1554,523,152,675,42,717,1202,59.65%,43.51%,1
臺中市,石岡區,1555,495,142,637,60,697,1272,54.8%,38.92%,1
臺中市,石岡區,1556,279,71,350,41,391,652,59.97%,42.79%,1
臺中市,石岡區,1557,679,204,883,77,960,1457,65.89%,46.6%,1
臺中市,石岡區,1558,746,240,986,61,1047,1836,57.03%,40.63%,1
臺中市,石岡區,1559,439,121,560,27,587,1001,58.64%,43.86%,1
臺中市,石岡區,1560,676,167,843,49,892,1448,61.6%,46.69%,1
臺中市,石岡區,1561,561,168,729,35,764,1229,62.16%,45.65%,1
臺中市,外埔區,0071,436,128,564,37,601,1059,56.75%,41.17%,1
臺中市,外埔區,0072,452,136,588,22,610,1013,60.22%,44.62%,1
臺中市,外埔區,0073,528,156,684,35,719,1150,62.52%,45.91%,1
臺中市,外埔區,0074,880,259,1139,42,1181,1855,63.67%,47.44%,1
臺中市,外埔區,0075,598,163,761,40,801,1327,60.36%,45.06%,1
臺中市,外埔區,0076,666,181,847,40,887,1453,61.05%,45.84%,1
臺中市,外埔區,0077,693,187,880,50,930,1653,56.26%,41.92%,1
臺中市,外埔區,0078,663,175,838,38,876,1615,54.24%,41.05%,1
臺中市,外埔區,0079,614,178,792,29,821,1470,55.85%,41.77%,1
臺中市,外埔區,0080,695,206,901,42,943,1559,60.49%,44.58%,1
臺中市,外埔區,0081,791,215,1006,65,1071,1902,56.31%,41.59%,1
臺中市,外埔區,0082,531,168,699,35,734,1138,64.5%,46.66%,1
臺中市,外埔區,0083,493,142,635,48,683,1065,64.13%,46.29%,1
臺中市,外埔區,0084,559,193,752,29,781,1243,62.83%,44.97%,1
臺中市,外埔區,0085,364,133,497,33,530,962,55.09%,37.84%,1
臺中市,外埔區,0086,469,158,627,34,661,1169,56.54%,40.12%,1
臺中市,外埔區,0087,602,161,763,31,794,1216,65.3%,49.51%,1
臺中市,外埔區,0088,593,155,748,47,795,1391,57.15%,42.63%,1
臺中市,外埔區,0089,678,183,861,55,916,1616,56.68%,41.96%,1
臺中市,外埔區,0090,423,141,564,35,599,1203,49.79%,35.16%,1
臺中市,大安區,0055,419,103,522,48,570,1068,53.37%,39.23%,1
臺中市,大安區,0056,449,126,575,42,617,1050,58.76%,42.76%,1
臺中市,大安區,0057,540,173,713,58,771,1246,61.88%,43.34%,1
臺中市,大安區,0058,568,169,737,45,782,1397,55.98%,40.66%,1
臺中市,大安區,0059,546,166,712,54,766,1227,62.43%,44.5%,1
臺中市,大安區,0060,503,132,635,57,692,1170,59.15%,42.99%,1
臺中市,大安區,0061,445,127,572,24,596,914,65.21%,48.69%,1
臺中市,大安區,0062,255,64,319,28,347,667,52.02%,38.23%,1
臺中市,大安區,0063,338,113,451,36,487,890,54.72%,37.98%,1
臺中市,大安區,0064,544,147,691,45,736,1289,57.1%,42.2%,1
臺中市,大安區,0065,172,56,228,15,243,455,53.41%,37.8%,1
臺中市,大安區,0066,466,107,573,25,598,1028,58.17%,45.33%,1
臺中市,大安區,0067,615,199,814,57,871,1446,60.24%,42.53%,1
臺中市,大安區,0068,333,87,420,28,448,688,65.12%,48.4%,1
臺中市,大安區,0069,470,141,611,39,650,1062,61.21%,44.26%,1
臺中市,大安區,0070,432,148,580,25,605,923,65.55%,46.8%,1
臺中市,烏日區,0317,648,232,880,53,933,1480,63.04%,43.78%,1
臺中市,烏日區,0318,778,291,1069,64,1133,1841,61.54%,42.26%,1
臺中市,烏日區,0319,679,271,950,49,999,1751,57.05%,38.78%,1
臺中市,烏日區,0320,676,219,895,56,951,1547,61.47%,43.7%,1
臺中市,烏日區,0321,773,257,1030,38,1068,1836,58.17%,42.1%,1
臺中市,烏日區,0322,542,212,754,77,831,1239,67.07%,43.74%,1
臺中市,烏日區,0323,510,190,700,46,746,1295,57.61%,39.38%,1
臺中市,烏日區,0324,489,204,693,23,716,1263,56.69%,38.72%,1
臺中市,烏日區,0325,600,277,877,37,914,1622,56.35%,36.99%,1
臺中市,烏日區,0326,750,215,965,75,1040,1822,57.08%,41.16%,1
臺中市,烏日區,0327,758,282,1040,66,1106,1966,56.26%,38.56%,1
臺中市,烏日區,0328,677,234,911,44,955,1615,59.13%,41.92%,1
臺中市,烏日區,0329,503,219,722,35,757,1232,61.44%,40.83%,1
臺中市,烏日區,0330,553,162,715,34,749,1347,55.61%,41.05%,1
臺中市,烏日區,0331,441,155,596,32,628,1165,53.91%,37.85%,1
臺中市,烏日區,0332,696,259,955,46,1001,1664,60.16%,41.83%,1
臺中市,烏日區,0333,555,181,736,38,774,1230,62.93%,45.12%,1
臺中市,烏日區,0334,722,210,932,67,999,1574,63.47%,45.87%,1
臺中市,烏日區,0335,631,258,889,37,926,1452,63.77%,43.46%,1
臺中市,烏日區,0336,747,232,979,41,1020,1879,54.28%,39.76%,1
臺中市,烏日區,0337,649,246,895,32,927,1601,57.9%,40.54%,1
臺中市,烏日區,0338,667,253,920,37,957,1546,61.9%,43.14%,1
臺中市,烏日區,0339,606,259,865,46,911,1866,48.82%,32.48%,1
臺中市,烏日區,0340,830,274,1104,61,1165,1938,60.11%,42.83%,1
臺中市,烏日區,0341,705,267,972,55,1027,1759,58.39%,40.08%,1
臺中市,烏日區,0342,661,407,1068,68,1136,2061,55.12%,32.07%,1
臺中市,烏日區,0343,740,241,981,31,1012,1691,59.85%,43.76%,1
臺中市,烏日區,0344,495,148,643,36,679,1039,65.35%,47.64%,1
臺中市,烏日區,0345,560,163,723,35,758,1221,62.08%,45.86%,1
臺中市,烏日區,0346,704,247,951,57,1008,1650,61.09%,42.67%,1
臺中市,烏日區,0347,433,133,566,37,603,937,64.35%,46.21%,1
臺中市,烏日區,0348,513,191,704,36,740,1220,60.66%,42.05%,1
臺中市,烏日區,0349,782,268,1050,98,1148,2139,53.67%,36.56%,1
臺中市,烏日區,0350,630,200,830,61,891,1371,64.99%,45.95%,1
臺中市,烏日區,0351,530,169,699,54,753,1277,58.97%,41.5%,1
臺中市,烏日區,0352,654,240,894,52,946,1708,55.39%,38.29%,1
臺中市,烏日區,0353,869,237,1106,51,1157,2048,56.49%,42.43%,1
臺中市,烏日區,0354,645,209,854,57,911,1632,55.82%,39.52%,1
臺中市,烏日區,0355,561,186,747,62,809,1327,60.96%,42.28%,1
臺中市,烏日區,0356,360,89,449,59,508,854,59.48%,42.15%,1
臺中市,大肚區,0284,599,170,769,42,811,1415,57.31%,42.33%,1
臺中市,大肚區,0285,530,176,706,42,748,1392,53.74%,38.07%,1
臺中市,大肚區,0286,670,184,854,68,922,1520,60.66%,44.08%,1
臺中市,大肚區,0287,399,133,532,51,583,862,67.63%,46.29%,1
臺中市,大肚區,0288,572,176,748,33,781,1256,62.18%,45.54%,1
臺中市,大肚區,0289,530,175,705,43,748,1292,57.89%,41.02%,1
臺中市,大肚區,0290,447,133,580,38,618,1010,61.19%,44.26%,1
臺中市,大肚區,0291,621,226,847,71,918,1485,61.82%,41.82%,1
臺中市,大肚區,0292,567,164,731,38,769,1190,64.62%,47.65%,1
臺中市,大肚區,0293,529,164,693,53,746,1250,59.68%,42.32%,1
臺中市,大肚區,0294,546,188,734,46,780,1310,59.54%,41.68%,1
臺中市,大肚區,0295,524,166,690,49,739,1294,57.11%,40.49%,1
臺中市,大肚區,0296,809,237,1046,52,1098,1734,63.32%,46.66%,1
臺中市,大肚區,0297,537,157,694,57,751,1316,57.07%,40.81%,1
臺中市,大肚區,0298,348,121,469,41,510,854,59.72%,40.75%,1
臺中市,大肚區,0299,585,211,796,25,821,1273,64.49%,45.95%,1
臺中市,大肚區,0300,405,114,519,18,537,851,63.1%,47.59%,1
臺中市,大肚區,0301,703,181,884,35,919,1629,56.41%,43.16%,1
臺中市,大肚區,0302,688,205,893,65,958,1709,56.06%,40.26%,1
臺中市,大肚區,0303,378,111,489,32,521,953,54.67%,39.66%,1
臺中市,大肚區,0304,600,176,776,38,814,1336,60.93%,44.91%,1
臺中市,大肚區,0305,802,267,1069,76,1145,2113,54.19%,37.96%,1
臺中市,大肚區,0306,711,238,949,74,1023,1730,59.13%,41.1%,1
臺中市,大肚區,0307,676,258,934,21,955,1692,56.44%,39.95%,1
臺中市,大肚區,0308,776,200,976,38,1014,1747,58.04%,44.42%,1
臺中市,大肚區,0309,700,202,902,58,960,1672,57.42%,41.87%,1
臺中市,大肚區,0310,627,245,872,43,915,1675,54.63%,37.43%,1
臺中市,大肚區,0311,724,198,922,41,963,1673,57.56%,43.28%,1
臺中市,大肚區,0312,710,236,946,36,982,1636,60.02%,43.4%,1
臺中市,大肚區,0313,677,219,896,61,957,1753,54.59%,38.62%,1
臺中市,大肚區,0314,540,157,697,27,724,1343,53.91%,40.21%,1
臺中市,大肚區,0315,750,234,984,52,1036,1822,56.86%,41.16%,1
臺中市,大肚區,0316,761,240,1001,34,1035,1670,61.98%,45.57%,1
臺中市,龍井區,0239,738,262,1000,62,1062,1758,60.41%,41.98%,1
臺中市,龍井區,0240,544,157,701,42,743,1275,58.27%,42.67%,1
臺中市,龍井區,0241,535,137,672,24,696,1379,50.47%,38.8%,1
臺中市,龍井區,0242,537,170,707,44,751,1403,53.53%,38.28%,1
臺中市,龍井區,0243,410,129,539,33,572,974,58.73%,42.09%,1
臺中市,龍井區,0244,398,118,516,32,548,901,60.82%,44.17%,1
臺中市,龍井區,0245,674,244,918,71,989,1779,55.59%,37.89%,1
臺中市,龍井區,0246,661,251,912,49,961,1609,59.73%,41.08%,1
臺中市,龍井區,0247,405,122,527,22,549,1038,52.89%,39.02%,1
臺中市,龍井區,0248,569,195,764,52,816,1328,61.45%,42.85%,1
臺中市,龍井區,0249,407,131,538,36,574,921,62.32%,44.19%,1
臺中市,龍井區,0250,588,208,796,45,841,1609,52.27%,36.54%,1
臺中市,龍井區,0251,457,136,593,27,620,1227,50.53%,37.25%,1
臺中市,龍井區,0252,550,134,684,46,730,1278,57.12%,43.04%,1
臺中市,龍井區,0253,312,105,417,20,437,914,47.81%,34.14%,1
臺中市,龍井區,0254,581,207,788,34,822,1678,48.99%,34.62%,1
臺中市,龍井區,0255,456,152,608,40,648,1233,52.55%,36.98%,1
臺中市,龍井區,0256,608,203,811,42,853,1520,56.12%,40%,1
臺中市,龍井區,0257,753,224,977,25,1002,1905,52.6%,39.53%,1
臺中市,龍井區,0258,633,205,838,79,917,1520,60.33%,41.64%,1
臺中市,龍井區,0259,533,166,699,51,750,1385,54.15%,38.48%,1
臺中市,龍井區,0260,476,180,656,33,689,1212,56.85%,39.27%,1
臺中市,龍井區,0261,593,207,800,27,827,1432,57.75%,41.41%,1
臺中市,龍井區,0262,672,201,873,36,909,1663,54.66%,40.41%,1
臺中市,龍井區,0263,543,181,724,39,763,1422,53.66%,38.19%,1
臺中市,龍井區,0264,562,216,778,39,817,1616,50.56%,34.78%,1
臺中市,龍井區,0265,622,184,806,45,851,1422,59.85%,43.74%,1
臺中市,龍井區,0266,491,185,676,20,696,1165,59.74%,42.15%,1
臺中市,龍井區,0267,622,257,879,21,900,1624,55.42%,38.3%,1
臺中市,龍井區,0268,667,210,877,33,910,1613,56.42%,41.35%,1
臺中市,龍井區,0269,492,77,569,27,596,943,63.2%,52.17%,1
臺中市,龍井區,0270,630,191,821,47,868,1595,54.42%,39.5%,1
臺中市,龍井區,0271,641,209,850,39,889,1508,58.95%,42.51%,1
臺中市,龍井區,0272,603,187,790,29,819,1479,55.38%,40.77%,1
臺中市,龍井區,0273,610,225,835,47,882,1509,58.45%,40.42%,1
臺中市,龍井區,0274,691,228,919,59,978,1582,61.82%,43.68%,1
臺中市,龍井區,0275,672,262,934,45,979,1725,56.75%,38.96%,1
臺中市,龍井區,0276,690,220,910,26,936,1616,57.92%,42.7%,1
臺中市,龍井區,0277,689,272,961,32,993,1657,59.93%,41.58%,1
臺中市,龍井區,0278,641,350,991,43,1034,1774,58.29%,36.13%,1
臺中市,龍井區,0279,640,352,992,49,1041,1701,61.2%,37.62%,1
臺中市,龍井區,0280,465,177,642,24,666,1121,59.41%,41.48%,1
臺中市,龍井區,0281,428,154,582,40,622,987,63.02%,43.36%,1
臺中市,龍井區,0282,478,204,682,33,715,1206,59.29%,39.64%,1
臺中市,龍井區,0283,592,228,820,29,849,1378,61.61%,42.96%,1
臺中市,霧峰區,1470,553,172,725,28,753,1205,62.49%,45.89%,1
臺中市,霧峰區,1471,660,234,894,33,927,1620,57.22%,40.74%,1
臺中市,霧峰區,1472,685,243,928,42,970,1559,62.22%,43.94%,1
臺中市,霧峰區,1473,668,240,908,51,959,1660,57.77%,40.24%,1
臺中市,霧峰區,1474,707,234,941,41,982,1602,61.3%,44.13%,1
臺中市,霧峰區,1475,538,164,702,34,736,1325,55.55%,40.6%,1
臺中市,霧峰區,1476,665,192,857,41,898,1515,59.27%,43.89%,1
臺中市,霧峰區,1477,622,207,829,51,880,1561,56.37%,39.85%,1
臺中市,霧峰區,1478,669,211,880,39,919,1691,54.35%,39.56%,1
臺中市,霧峰區,1479,627,195,822,42,864,1486,58.14%,42.19%,1
臺中市,霧峰區,1480,447,133,580,37,617,975,63.28%,45.85%,1
臺中市,霧峰區,1481,631,180,811,32,843,1358,62.08%,46.47%,1
臺中市,霧峰區,1482,544,189,733,28,761,1141,66.7%,47.68%,1
臺中市,霧峰區,1483,418,114,532,33,565,855,66.08%,48.89%,1
臺中市,霧峰區,1484,489,185,674,51,725,1202,60.32%,40.68%,1
臺中市,霧峰區,1485,435,139,574,33,607,1078,56.31%,40.35%,1
臺中市,霧峰區,1486,623,247,870,33,903,1456,62.02%,42.79%,1
臺中市,霧峰區,1487,665,260,925,31,956,1573,60.78%,42.28%,1
臺中市,霧峰區,1488,699,199,898,37,935,1591,58.77%,43.93%,1
臺中市,霧峰區,1489,568,173,741,45,786,1214,64.74%,46.79%,1
臺中市,霧峰區,1490,525,167,692,39,731,1267,57.7%,41.44%,1
臺中市,霧峰區,1491,533,177,710,51,761,1277,59.59%,41.74%,1
臺中市,霧峰區,1492,558,187,745,44,789,1366,57.76%,40.85%,1
臺中市,霧峰區,1493,493,153,646,42,688,994,69.22%,49.6%,1
臺中市,霧峰區,1494,391,123,514,32,546,863,63.27%,45.31%,1
臺中市,霧峰區,1495,500,178,678,46,724,1274,56.83%,39.25%,1
臺中市,霧峰區,1496,480,159,639,46,685,1162,58.95%,41.31%,1
臺中市,霧峰區,1497,558,166,724,63,787,1252,62.86%,44.57%,1
臺中市,霧峰區,1498,557,187,744,45,789,1322,59.68%,42.13%,1
臺中市,霧峰區,1499,493,171,664,50,714,1116,63.98%,44.18%,1
臺中市,霧峰區,1500,506,182,688,50,738,1156,63.84%,43.77%,1
臺中市,霧峰區,1501,557,126,683,44,727,1147,63.38%,48.56%,1
臺中市,霧峰區,1502,481,102,583,47,630,928,67.89%,51.83%,1
臺中市,霧峰區,1503,539,159,698,36,734,1296,56.64%,41.59%,1
臺中市,霧峰區,1504,487,159,646,70,716,1314,54.49%,37.06%,1
臺中市,霧峰區,1505,609,164,773,46,819,1328,61.67%,45.86%,1
臺中市,霧峰區,1506,391,144,535,52,587,989,59.35%,39.53%,1
臺中市,霧峰區,1507,508,133,641,50,691,1088,63.51%,46.69%,1
臺中市,霧峰區,1508,658,181,839,54,893,1363,65.52%,48.28%,1
臺中市,霧峰區,1509,705,208,913,51,964,1573,61.28%,44.82%,1
臺中市,霧峰區,1510,499,127,626,36,662,1117,59.27%,44.67%,1
臺中市,霧峰區,1511,634,171,805,66,871,1342,64.9%,47.24%,1
臺中市,霧峰區,1512,468,159,627,56,683,1024,66.7%,45.7%,1
臺中市,太平區,1271,715,228,943,58,1001,1821,54.97%,39.26%,1
臺中市,太平區,1272,637,208,845,43,888,1680,52.86%,37.92%,1
臺中市,太平區,1273,801,261,1062,69,1131,1947,58.09%,41.14%,1
臺中市,太平區,1274,853,246,1099,48,1147,1910,60.05%,44.66%,1
臺中市,太平區,1275,719,254,973,44,1017,1894,53.7%,37.96%,1
臺中市,太平區,1276,697,283,980,51,1031,1953,52.79%,35.69%,1
臺中市,太平區,1277,761,249,1010,54,1064,1846,57.64%,41.22%,1
臺中市,太平區,1278,673,185,858,35,893,1493,59.81%,45.08%,1
臺中市,太平區,1279,673,194,867,34,901,1605,56.14%,41.93%,1
臺中市,太平區,1280,745,207,952,33,985,1619,60.84%,46.02%,1
臺中市,太平區,1281,802,263,1065,48,1113,2011,55.35%,39.88%,1
臺中市,太平區,1282,831,270,1101,27,1128,2056,54.86%,40.42%,1
臺中市,太平區,1283,733,253,986,43,1029,1876,54.85%,39.07%,1
臺中市,太平區,1284,718,229,947,43,990,1815,54.55%,39.56%,1
臺中市,太平區,1285,557,148,705,29,734,1281,57.3%,43.48%,1
臺中市,太平區,1286,477,145,622,31,653,1004,65.04%,47.51%,1
臺中市,太平區,1287,804,279,1083,50,1133,1886,60.07%,42.63%,1
臺中市,太平區,1288,624,182,806,59,865,1431,60.45%,43.61%,1
臺中市,太平區,1289,720,286,1006,52,1058,1930,54.82%,37.31%,1
臺中市,太平區,1290,821,243,1064,61,1125,2164,51.99%,37.94%,1
臺中市,太平區,1291,812,259,1071,53,1124,2048,54.88%,39.65%,1
臺中市,太平區,1292,813,238,1051,45,1096,2035,53.86%,39.95%,1
臺中市,太平區,1293,637,243,880,55,935,1685,55.49%,37.8%,1
臺中市,太平區,1294,764,277,1041,44,1085,2185,49.66%,34.97%,1
臺中市,太平區,1295,482,145,627,20,647,1176,55.02%,40.99%,1
臺中市,太平區,1296,612,230,842,26,868,1597,54.35%,38.32%,1
臺中市,太平區,1297,521,167,688,68,756,1378,54.86%,37.81%,1
臺中市,太平區,1298,654,183,837,48,885,1546,57.24%,42.3%,1
臺中市,太平區,1299,683,246,929,41,970,1890,51.32%,36.14%,1
臺中市,太平區,1300,445,116,561,35,596,1053,56.6%,42.26%,1
臺中市,太平區,1301,679,216,895,67,962,1582,60.81%,42.92%,1
臺中市,太平區,1302,721,265,986,29,1015,1699,59.74%,42.44%,1
臺中市,太平區,1303,548,211,759,53,812,1493,54.39%,36.7%,1
臺中市,太平區,1304,403,141,544,41,585,1063,55.03%,37.91%,1
臺中市,太平區,1305,478,159,637,38,675,1117,60.43%,42.79%,1
臺中市,太平區,1306,474,150,624,35,659,1084,60.79%,43.73%,1
臺中市,太平區,1307,665,140,805,31,836,1776,47.07%,37.44%,1
臺中市,太平區,1308,667,226,893,40,933,1729,53.96%,38.58%,1
臺中市,太平區,1309,607,197,804,38,842,1658,50.78%,36.61%,1
臺中市,太平區,1310,775,225,1000,53,1053,2010,52.39%,38.56%,1
臺中市,太平區,1311,664,233,897,42,939,1752,53.6%,37.9%,1
臺中市,太平區,1312,716,231,947,50,997,1654,60.28%,43.29%,1
臺中市,太平區,1313,544,200,744,26,770,1951,39.47%,27.88%,1
臺中市,太平區,1314,946,345,1291,54,1345,2170,61.98%,43.59%,1
臺中市,太平區,1315,950,338,1288,56,1344,2231,60.24%,42.58%,1
臺中市,太平區,1316,690,226,916,36,952,1623,58.66%,42.51%,1
臺中市,太平區,1317,579,174,753,26,779,1548,50.32%,37.4%,1
臺中市,太平區,1318,607,186,793,50,843,1442,58.46%,42.09%,1
臺中市,太平區,1319,558,172,730,28,758,1501,50.5%,37.18%,1
臺中市,太平區,1320,671,306,977,31,1008,2025,49.78%,33.14%,1
臺中市,太平區,1321,692,284,976,35,1011,1885,53.63%,36.71%,1
臺中市,太平區,1322,742,291,1033,35,1068,2155,49.56%,34.43%,1
臺中市,太平區,1323,673,217,890,34,924,1775,52.06%,37.92%,1
臺中市,太平區,1324,637,235,872,59,931,2021,46.07%,31.52%,1
臺中市,太平區,1325,874,278,1152,63,1215,2075,58.55%,42.12%,1
臺中市,太平區,1326,597,264,861,42,903,1723,52.41%,34.65%,1
臺中市,太平區,1327,786,318,1104,38,1142,2049,55.73%,38.36%,1
臺中市,太平區,1328,565,205,770,15,785,1415,55.48%,39.93%,1
臺中市,太平區,1329,718,263,981,41,1022,1778,57.48%,40.38%,1
臺中市,太平區,1330,646,228,874,37,911,1706,53.4%,37.87%,1
臺中市,太平區,1331,792,320,1112,41,1153,2090,55.17%,37.89%,1
臺中市,太平區,1332,735,256,991,47,1038,2093,49.59%,35.12%,1
臺中市,太平區,1333,634,169,803,35,838,1688,49.64%,37.56%,1
臺中市,太平區,1334,516,211,727,29,756,1488,50.81%,34.68%,1
臺中市,太平區,1335,718,222,940,41,981,1667,58.85%,43.07%,1
臺中市,太平區,1336,937,227,1164,40,1204,1793,67.15%,52.26%,1
臺中市,太平區,1337,751,310,1061,33,1094,1903,57.49%,39.46%,1
臺中市,太平區,1338,746,252,998,28,1026,1834,55.94%,40.68%,1
臺中市,太平區,1339,624,192,816,28,844,1526,55.31%,40.89%,1
臺中市,太平區,1340,606,298,904,26,930,1483,62.71%,40.86%,1
臺中市,太平區,1341,640,296,936,24,960,1694,56.67%,37.78%,1
臺中市,太平區,1342,654,277,931,33,964,1952,49.39%,33.5%,1
臺中市,太平區,1343,770,290,1060,39,1099,1995,55.09%,38.6%,1
臺中市,太平區,1344,513,230,743,17,760,1311,57.97%,39.13%,1
臺中市,太平區,1345,634,340,974,43,1017,1537,66.17%,41.25%,1
臺中市,太平區,1346,675,264,939,44,983,1974,49.8%,34.19%,1
臺中市,太平區,1347,706,303,1009,35,1044,1828,57.11%,38.62%,1
臺中市,太平區,1348,726,332,1058,47,1105,2191,50.43%,33.14%,1
臺中市,太平區,1349,728,178,906,53,959,1825,52.55%,39.89%,1
臺中市,太平區,1350,613,172,785,11,796,1559,51.06%,39.32%,1
臺中市,太平區,1351,505,143,648,44,692,1225,56.49%,41.22%,1
臺中市,太平區,1352,690,183,873,58,931,1678,55.48%,41.12%,1
臺中市,太平區,1353,578,198,776,35,811,1501,54.03%,38.51%,1
臺中市,太平區,1354,625,266,891,33,924,1450,63.72%,43.1%,1
臺中市,太平區,1355,794,258,1052,67,1119,2126,52.63%,37.35%,1
臺中市,太平區,1356,337,77,414,37,451,699,64.52%,48.21%,1
臺中市,太平區,1357,539,185,724,31,755,1428,52.87%,37.75%,1
臺中市,太平區,1358,657,254,911,63,974,1666,58.46%,39.44%,1
臺中市,太平區,1359,508,181,689,40,729,1241,58.74%,40.93%,1
臺中市,太平區,1360,560,161,721,51,772,1266,60.98%,44.23%,1
臺中市,太平區,1361,504,134,638,31,669,1166,57.38%,43.22%,1
臺中市,太平區,1362,762,251,1013,25,1038,1790,57.99%,42.57%,1
臺中市,太平區,1363,594,180,774,39,813,1754,46.35%,33.87%,1
臺中市,大里區,1364,610,208,818,32,850,1614,52.66%,37.79%,1
臺中市,大里區,1365,593,216,809,27,836,1599,52.28%,37.09%,1
臺中市,大里區,1366,604,229,833,42,875,1715,51.02%,35.22%,1
臺中市,大里區,1367,548,178,726,22,748,1264,59.18%,43.35%,1
臺中市,大里區,1368,534,203,737,26,763,1416,53.88%,37.71%,1
臺中市,大里區,1369,468,168,636,28,664,1188,55.89%,39.39%,1
臺中市,大里區,1370,564,171,735,24,759,1359,55.85%,41.5%,1
臺中市,大里區,1371,590,213,803,42,845,1457,58%,40.49%,1
臺中市,大里區,1372,579,211,790,43,833,1403,59.37%,41.27%,1
臺中市,大里區,1373,687,231,918,47,965,1697,56.87%,40.48%,1
臺中市,大里區,1374,755,262,1017,64,1081,1811,59.69%,41.69%,1
臺中市,大里區,1375,804,144,948,39,987,1830,53.93%,43.93%,1
臺中市,大里區,1376,699,234,933,29,962,2228,43.18%,31.37%,1
臺中市,大里區,1377,832,276,1108,41,1149,1997,57.54%,41.66%,1
臺中市,大里區,1378,902,361,1263,36,1299,2033,63.9%,44.37%,1
臺中市,大里區,1379,772,316,1088,28,1116,1835,60.82%,42.07%,1
臺中市,大里區,1380,510,208,718,24,742,1268,58.52%,40.22%,1
臺中市,大里區,1381,684,233,917,38,955,1645,58.05%,41.58%,1
臺中市,大里區,1382,661,273,934,24,958,1561,61.37%,42.34%,1
臺中市,大里區,1383,624,207,831,22,853,1301,65.56%,47.96%,1
臺中市,大里區,1384,628,224,852,47,899,1621,55.46%,38.74%,1
臺中市,大里區,1385,670,252,922,52,974,1797,54.2%,37.28%,1
臺中市,大里區,1386,480,179,659,29,688,1230,55.93%,39.02%,1
臺中市,大里區,1387,604,189,793,33,826,1488,55.51%,40.59%,1
臺中市,大里區,1388,523,228,751,48,799,1459,54.76%,35.85%,1
臺中市,大里區,1389,673,239,912,33,945,1647,57.38%,40.86%,1
臺中市,大里區,1390,479,174,653,40,693,1100,63%,43.55%,1
臺中市,大里區,1391,560,205,765,49,814,1410,57.73%,39.72%,1
臺中市,大里區,1392,683,234,917,42,959,1807,53.07%,37.8%,1
臺中市,大里區,1393,523,100,623,54,677,1331,50.86%,39.29%,1
臺中市,大里區,1394,683,270,953,21,974,1801,54.08%,37.92%,1
臺中市,大里區,1395,713,235,948,28,976,1909,51.13%,37.35%,1
臺中市,大里區,1396,616,206,822,38,860,1699,50.62%,36.26%,1
臺中市,大里區,1397,670,243,913,37,950,1627,58.39%,41.18%,1
臺中市,大里區,1398,712,312,1024,23,1047,1912,54.76%,37.24%,1
臺中市,大里區,1399,674,222,896,50,946,1753,53.96%,38.45%,1
臺中市,大里區,1400,648,225,873,27,900,1602,56.18%,40.45%,1
臺中市,大里區,1401,438,177,615,46,661,1144,57.78%,38.29%,1
臺中市,大里區,1402,700,228,928,49,977,1655,59.03%,42.3%,1
臺中市,大里區,1403,553,153,706,39,745,1438,51.81%,38.46%,1
臺中市,大里區,1404,401,152,553,45,598,1000,59.8%,40.1%,1
臺中市,大里區,1405,696,248,944,38,982,1711,57.39%,40.68%,1
臺中市,大里區,1406,720,217,937,11,948,1698,55.83%,42.4%,1
臺中市,大里區,1407,751,265,1016,61,1077,1914,56.27%,39.24%,1
臺中市,大里區,1408,596,233,829,26,855,1465,58.36%,40.68%,1
臺中市,大里區,1409,640,216,856,48,904,1581,57.18%,40.48%,1
臺中市,大里區,1410,670,199,869,36,905,1509,59.97%,44.4%,1
臺中市,大里區,1411,632,196,828,28,856,1570,54.52%,40.25%,1
臺中市,大里區,1412,551,243,794,35,829,1425,58.18%,38.67%,1
臺中市,大里區,1413,570,211,781,42,823,1384,59.47%,41.18%,1
臺中市,大里區,1414,454,136,590,24,614,1204,51%,37.71%,1
臺中市,大里區,1415,647,227,874,26,900,1761,51.11%,36.74%,1
臺中市,大里區,1416,531,167,698,29,727,1473,49.36%,36.05%,1
臺中市,大里區,1417,683,224,907,39,946,1675,56.48%,40.78%,1
臺中市,大里區,1418,721,231,952,42,994,1755,56.64%,41.08%,1
臺中市,大里區,1419,676,219,895,66,961,1593,60.33%,42.44%,1
臺中市,大里區,1420,723,218,941,61,1002,1799,55.7%,40.19%,1
臺中市,大里區,1421,643,225,868,41,909,1606,56.6%,40.04%,1
臺中市,大里區,1422,711,295,1006,28,1034,1875,55.15%,37.92%,1
臺中市,大里區,1423,663,268,931,32,963,1670,57.66%,39.7%,1
臺中市,大里區,1424,709,282,991,50,1041,1898,54.85%,37.36%,1
臺中市,大里區,1425,632,237,869,34,903,1679,53.78%,37.64%,1
臺中市,大里區,1426,542,186,728,29,757,1373,55.13%,39.48%,1
臺中市,大里區,1427,546,180,726,27,753,1299,57.97%,42.03%,1
臺中市,大里區,1428,564,221,785,34,819,1430,57.27%,39.44%,1
臺中市,大里區,1429,818,296,1114,31,1145,1805,63.43%,45.32%,1
臺中市,大里區,1430,806,353,1159,25,1184,1806,65.56%,44.63%,1
臺中市,大里區,1431,835,319,1154,39,1193,1826,65.33%,45.73%,1
臺中市,大里區,1432,866,277,1143,38,1181,1805,65.43%,47.98%,1
臺中市,大里區,1433,796,324,1120,33,1153,1907,60.46%,41.74%,1
臺中市,大里區,1434,518,160,678,24,702,1103,63.64%,46.96%,1
臺中市,大里區,1435,565,193,758,41,799,1419,56.31%,39.82%,1
臺中市,大里區,1436,635,153,788,37,825,1434,57.53%,44.28%,1
臺中市,大里區,1437,708,222,930,44,974,1875,51.95%,37.76%,1
臺中市,大里區,1438,720,287,1007,32,1039,1862,55.8%,38.67%,1
臺中市,大里區,1439,712,264,976,35,1011,1850,54.65%,38.49%,1
臺中市,大里區,1440,647,245,892,42,934,1622,57.58%,39.89%,1
臺中市,大里區,1441,708,267,975,46,1021,1638,62.33%,43.22%,1
臺中市,大里區,1442,725,261,986,35,1021,1633,62.52%,44.4%,1
臺中市,大里區,1443,641,282,923,37,960,1662,57.76%,38.57%,1
臺中市,大里區,1444,749,357,1106,27,1133,1917,59.1%,39.07%,1
臺中市,大里區,1445,646,209,855,43,898,1701,52.79%,37.98%,1
臺中市,大里區,1446,588,207,795,38,833,1549,53.78%,37.96%,1
臺中市,大里區,1447,697,200,897,25,922,1567,58.84%,44.48%,1
臺中市,大里區,1448,674,207,881,48,929,1614,57.56%,41.76%,1
臺中市,大里區,1449,725,252,977,64,1041,1811,57.48%,40.03%,1
臺中市,大里區,1450,540,193,733,32,765,1336,57.26%,40.42%,1
臺中市,大里區,1451,710,227,937,27,964,1759,54.8%,40.36%,1
臺中市,大里區,1452,672,234,906,43,949,1783,53.22%,37.69%,1
臺中市,大里區,1453,641,210,851,34,885,1736,50.98%,36.92%,1
臺中市,大里區,1454,804,239,1043,43,1086,1874,57.95%,42.9%,1
臺中市,大里區,1455,777,285,1062,20,1082,1889,57.28%,41.13%,1
臺中市,大里區,1456,830,219,1049,36,1085,1947,55.73%,42.63%,1
臺中市,大里區,1457,820,269,1089,41,1130,1938,58.31%,42.31%,1
臺中市,大里區,1458,742,254,996,56,1052,1836,57.3%,40.41%,1
臺中市,大里區,1459,754,254,1008,41,1049,1913,54.84%,39.41%,1
臺中市,大里區,1460,741,223,964,60,1024,1913,53.53%,38.73%,1
臺中市,大里區,1461,753,227,980,34,1014,1937,52.35%,38.87%,1
臺中市,大里區,1462,602,200,802,29,831,1508,55.11%,39.92%,1
臺中市,大里區,1463,607,186,793,20,813,1340,60.67%,45.3%,1
臺中市,大里區,1464,723,219,942,32,974,1656,58.82%,43.66%,1
臺中市,大里區,1465,548,153,701,31,732,1290,56.74%,42.48%,1
臺中市,大里區,1466,654,227,881,40,921,1655,55.65%,39.52%,1
臺中市,大里區,1467,442,178,620,29,649,1260,51.51%,35.08%,1
臺中市,大里區,1468,537,198,735,20,755,1247,60.55%,43.06%,1
臺中市,大里區,1469,636,212,848,20,868,1548,56.07%,41.09%,1
臺中市,和平區,1585,448,138,586,29,615,956,64.33%,46.86%,1
臺中市,和平區,1586,504,91,595,32,627,963,65.11%,52.34%,1
臺中市,和平區,1587,193,54,247,20,267,456,58.55%,42.32%,1
臺中市,和平區,1588,521,95,616,44,660,1011,65.28%,51.53%,1
臺中市,和平區,1589,312,59,371,15,386,636,60.69%,49.06%,1
臺中市,和平區,1590,115,14,129,8,137,270,50.74%,42.59%,1
臺中市,和平區,1591,287,37,324,33,357,460,77.61%,62.39%,1
臺中市,和平區,1592,187,40,227,15,242,321,75.39%,58.26%,1
臺中市,和平區,1593,365,113,478,38,516,783,65.9%,46.62%,1
臺中市,和平區,1594,161,38,199,12,211,336,62.8%,47.92%,1
臺中市,和平區,1595,238,65,303,13,316,451,70.07%,52.77%,1
臺中市,和平區,1596,179,27,206,14,220,366,60.11%,48.91%,1
臺中市,和平區,1597,306,52,358,12,370,771,47.99%,39.69%,1
臺中市,和平區,1598,267,37,304,17,321,574,55.92%,46.52%,1
臺中市,和平區,1599,135,23,158,13,171,274,62.41%,49.27%,1
臺中市,和平區,1600,68,15,83,5,88,157,56.05%,43.31%,1
臺中市,和平區,1601,342,58,400,11,411,713,57.64%,47.97%,1
臺南市,新營區,0116,552,221,773,29,802,1693,47.37%,32.6%,1
臺南市,新營區,0117,627,224,851,22,873,1561,55.93%,40.17%,1
臺南市,新營區,0118,568,210,778,31,809,1487,54.4%,38.2%,1
臺南市,新營區,0119,474,161,635,22,657,1232,53.33%,38.47%,1
臺南市,新營區,0120,386,155,541,19,560,1067,52.48%,36.18%,1
臺南市,新營區,0121,473,184,657,24,681,1419,47.99%,33.33%,1
臺南市,新營區,0122,577,230,807,20,827,1466,56.41%,39.36%,1
臺南市,新營區,0123,378,164,542,33,575,932,61.7%,40.56%,1
臺南市,新營區,0124,399,135,534,18,552,1099,50.23%,36.31%,1
臺南市,新營區,0125,272,83,355,21,376,757,49.67%,35.93%,1
臺南市,新營區,0126,344,149,493,19,512,888,57.66%,38.74%,1
臺南市,新營區,0127,392,184,576,7,583,1115,52.29%,35.16%,1
臺南市,新營區,0128,338,123,461,12,473,937,50.48%,36.07%,1
臺南市,新營區,0129,483,191,674,21,695,1387,50.11%,34.82%,1
臺南市,新營區,0130,551,184,735,27,762,1526,49.93%,36.11%,1
臺南市,新營區,0131,508,198,706,29,735,1301,56.5%,39.05%,1
臺南市,新營區,0132,607,233,840,31,871,1538,56.63%,39.47%,1
臺南市,新營區,0133,591,241,832,27,859,1584,54.23%,37.31%,1
臺南市,新營區,0134,594,276,870,25,895,1583,56.54%,37.52%,1
臺南市,新營區,0135,561,262,823,18,841,1530,54.97%,36.67%,1
臺南市,新營區,0136,479,202,681,30,711,1193,59.6%,40.15%,1
臺南市,新營區,0137,386,178,564,15,579,1439,40.24%,26.82%,1
臺南市,新營區,0138,581,204,785,25,810,1438,56.33%,40.4%,1
臺南市,新營區,0139,142,53,195,15,210,359,58.5%,39.55%,1
臺南市,新營區,0140,367,160,527,13,540,1233,43.8%,29.76%,1
臺南市,新營區,0141,391,120,511,16,527,1227,42.95%,31.87%,1
臺南市,新營區,0142,444,155,599,18,617,1320,46.74%,33.64%,1
臺南市,新營區,0143,585,252,837,11,848,1930,43.94%,30.31%,1
臺南市,新營區,0144,561,212,773,21,794,1501,52.9%,37.38%,1
臺南市,新營區,0145,516,185,701,25,726,1475,49.22%,34.98%,1
臺南市,新營區,0146,645,259,904,31,935,1753,53.34%,36.79%,1
臺南市,新營區,0147,595,251,846,25,871,1748,49.83%,34.04%,1
臺南市,新營區,0148,636,237,873,30,903,1741,51.87%,36.53%,1
臺南市,新營區,0149,485,199,684,18,702,1433,48.99%,33.85%,1
臺南市,新營區,0150,572,232,804,30,834,1595,52.29%,35.86%,1
臺南市,新營區,0151,348,105,453,17,470,959,49.01%,36.29%,1
臺南市,新營區,0152,635,221,856,43,899,1865,48.2%,34.05%,1
臺南市,新營區,0153,537,198,735,53,788,1678,46.96%,32%,1
臺南市,新營區,0154,465,135,600,27,627,1373,45.67%,33.87%,1
臺南市,新營區,0155,408,156,564,16,580,1431,40.53%,28.51%,1
臺南市,新營區,0156,85,28,113,2,115,291,39.52%,29.21%,1
臺南市,新營區,0157,626,233,859,37,896,1749,51.23%,35.79%,1
臺南市,新營區,0158,602,231,833,32,865,1862,46.46%,32.33%,1
臺南市,新營區,0159,672,258,930,48,978,1821,53.71%,36.9%,1
臺南市,新營區,0160,624,215,839,31,870,1845,47.15%,33.82%,1
臺南市,新營區,0161,167,47,214,5,219,542,40.41%,30.81%,1
臺南市,新營區,0162,109,42,151,3,154,402,38.31%,27.11%,1
臺南市,新營區,0163,280,88,368,43,411,703,58.46%,39.83%,1
臺南市,新營區,0164,309,90,399,28,427,941,45.38%,32.84%,1
臺南市,鹽水區,0085,414,112,526,38,564,1037,54.39%,39.92%,1
臺南市,鹽水區,0086,188,60,248,10,258,480,53.75%,39.17%,1
臺南市,鹽水區,0087,256,104,360,21,381,636,59.91%,40.25%,1
臺南市,鹽水區,0088,131,43,174,9,183,321,57.01%,40.81%,1
臺南市,鹽水區,0089,215,63,278,20,298,497,59.96%,43.26%,1
臺南市,鹽水區,0090,314,121,435,10,445,759,58.63%,41.37%,1
臺南市,鹽水區,0091,120,39,159,8,167,341,48.97%,35.19%,1
臺南市,鹽水區,0092,205,68,273,10,283,507,55.82%,40.43%,1
臺南市,鹽水區,0093,293,99,392,8,400,863,46.35%,33.95%,1
臺南市,鹽水區,0094,474,164,638,18,656,1373,47.78%,34.52%,1
臺南市,鹽水區,0095,536,185,721,34,755,1507,50.1%,35.57%,1
臺南市,鹽水區,0096,517,177,694,39,733,1374,53.35%,37.63%,1
臺南市,鹽水區,0097,423,160,583,17,600,1244,48.23%,34%,1
臺南市,鹽水區,0098,396,106,502,37,539,1022,52.74%,38.75%,1
臺南市,鹽水區,0099,239,89,328,35,363,921,39.41%,25.95%,1
臺南市,鹽水區,0100,312,123,435,24,459,847,54.19%,36.84%,1
臺南市,鹽水區,0101,185,66,251,8,259,736,35.19%,25.14%,1
臺南市,鹽水區,0102,295,91,386,8,394,761,51.77%,38.76%,1
臺南市,鹽水區,0103,101,31,132,10,142,285,49.82%,35.44%,1
臺南市,鹽水區,0104,148,56,204,23,227,493,46.04%,30.02%,1
臺南市,鹽水區,0105,186,41,227,24,251,621,40.42%,29.95%,1
臺南市,鹽水區,0106,116,27,143,9,152,392,38.78%,29.59%,1
臺南市,鹽水區,0107,343,89,432,24,456,925,49.3%,37.08%,1
臺南市,鹽水區,0108,249,59,308,21,329,728,45.19%,34.2%,1
臺南市,鹽水區,0109,64,11,75,10,85,214,39.72%,29.91%,1
臺南市,鹽水區,0110,138,35,173,6,179,387,46.25%,35.66%,1
臺南市,鹽水區,0111,109,35,144,13,157,301,52.16%,36.21%,1
臺南市,鹽水區,0112,215,72,287,21,308,755,40.79%,28.48%,1
臺南市,鹽水區,0113,115,28,143,13,156,365,42.74%,31.51%,1
臺南市,鹽水區,0114,322,115,437,22,459,935,49.09%,34.44%,1
臺南市,鹽水區,0115,159,53,212,23,235,494,47.57%,32.19%,1
臺南市,白河區,0030,440,157,597,45,642,1176,54.59%,37.41%,1
臺南市,白河區,0031,196,76,272,12,284,546,52.01%,35.9%,1
臺南市,白河區,0032,323,138,461,17,478,859,55.65%,37.6%,1
臺南市,白河區,0033,399,118,517,24,541,946,57.19%,42.18%,1
臺南市,白河區,0034,428,137,565,18,583,1116,52.24%,38.35%,1
臺南市,白河區,0035,431,127,558,24,582,1397,41.66%,30.85%,1
臺南市,白河區,0036,223,79,302,15,317,756,41.93%,29.5%,1
臺南市,白河區,0037,304,87,391,37,428,871,49.14%,34.9%,1
臺南市,白河區,0038,337,93,430,21,451,897,50.28%,37.57%,1
臺南市,白河區,0039,193,62,255,29,284,784,36.22%,24.62%,1
臺南市,白河區,0040,166,74,240,11,251,572,43.88%,29.02%,1
臺南市,白河區,0041,118,39,157,5,162,457,35.45%,25.82%,1
臺南市,白河區,0042,191,44,235,7,242,600,40.33%,31.83%,1
臺南市,白河區,0043,89,25,114,3,117,375,31.2%,23.73%,1
臺南市,白河區,0044,111,29,140,6,146,508,28.74%,21.85%,1
臺南市,白河區,0045,156,54,210,12,222,631,35.18%,24.72%,1
臺南市,白河區,0046,90,23,113,10,123,391,31.46%,23.02%,1
臺南市,白河區,0047,265,45,310,14,324,799,40.55%,33.17%,1
臺南市,白河區,0048,143,30,173,13,186,506,36.76%,28.26%,1
臺南市,白河區,0049,270,88,358,15,373,832,44.83%,32.45%,1
臺南市,白河區,0050,410,122,532,21,553,1179,46.9%,34.78%,1
臺南市,白河區,0051,194,75,269,10,279,744,37.5%,26.08%,1
臺南市,白河區,0052,198,60,258,12,270,699,38.63%,28.33%,1
臺南市,白河區,0053,174,51,225,14,239,633,37.76%,27.49%,1
臺南市,白河區,0054,303,111,414,50,464,859,54.02%,35.27%,1
臺南市,白河區,0055,270,94,364,28,392,884,44.34%,30.54%,1
臺南市,白河區,0056,161,46,207,10,217,740,29.32%,21.76%,1
臺南市,白河區,0057,418,122,540,37,577,1334,43.25%,31.33%,1
臺南市,白河區,0058,239,68,307,48,355,723,49.1%,33.06%,1
臺南市,白河區,0059,278,70,348,39,387,682,56.74%,40.76%,1
臺南市,白河區,0060,293,116,409,32,441,855,51.58%,34.27%,1
臺南市,白河區,0061,164,48,212,18,230,543,42.36%,30.2%,1
臺南市,柳營區,0165,412,144,556,23,579,1166,49.66%,35.33%,1
臺南市,柳營區,0166,248,95,343,9,352,625,56.32%,39.68%,1
臺南市,柳營區,0167,273,67,340,13,353,738,47.83%,36.99%,1
臺南市,柳營區,0168,375,113,488,9,497,834,59.59%,44.96%,1
臺南市,柳營區,0169,392,124,516,25,541,1104,49%,35.51%,1
臺南市,柳營區,0170,349,117,466,18,484,1015,47.68%,34.38%,1
臺南市,柳營區,0171,687,201,888,67,955,1720,55.52%,39.94%,1
臺南市,柳營區,0172,446,161,607,57,664,1391,47.74%,32.06%,1
臺南市,柳營區,0173,146,53,199,10,209,425,49.18%,34.35%,1
臺南市,柳營區,0174,95,31,126,10,136,318,42.77%,29.87%,1
臺南市,柳營區,0175,262,89,351,25,376,753,49.93%,34.79%,1
臺南市,柳營區,0176,242,72,314,29,343,730,46.99%,33.15%,1
臺南市,柳營區,0177,271,75,346,27,373,725,51.45%,37.38%,1
臺南市,柳營區,0178,314,99,413,18,431,787,54.76%,39.9%,1
臺南市,柳營區,0179,118,37,155,17,172,297,57.91%,39.73%,1
臺南市,柳營區,0180,274,78,352,23,375,673,55.72%,40.71%,1
臺南市,柳營區,0181,273,65,338,33,371,640,57.97%,42.66%,1
臺南市,柳營區,0182,191,60,251,38,289,660,43.79%,28.94%,1
臺南市,柳營區,0183,426,100,526,35,561,1212,46.29%,35.15%,1
臺南市,柳營區,0184,67,17,84,6,90,202,44.55%,33.17%,1
臺南市,柳營區,0185,376,99,475,39,514,1049,49%,35.84%,1
臺南市,柳營區,0186,56,21,77,2,79,158,50%,35.44%,1
臺南市,柳營區,0187,308,101,409,55,464,921,50.38%,33.44%,1
臺南市,柳營區,0188,177,51,228,8,236,504,46.83%,35.12%,1
臺南市,柳營區,0189,50,12,62,3,65,157,41.4%,31.85%,1
臺南市,後壁區,0001,303,92,395,30,425,743,57.2%,40.78%,1
臺南市,後壁區,0002,330,117,447,13,460,898,51.22%,36.75%,1
臺南市,後壁區,0003,268,87,355,29,384,786,48.85%,34.1%,1
臺南市,後壁區,0004,205,51,256,21,277,534,51.87%,38.39%,1
臺南市,後壁區,0005,372,125,497,44,541,1034,52.32%,35.98%,1
臺南市,後壁區,0006,52,39,91,15,106,232,45.69%,22.41%,1
臺南市,後壁區,0007,155,55,210,23,233,479,48.64%,32.36%,1
臺南市,後壁區,0008,298,91,389,18,407,837,48.63%,35.6%,1
臺南市,後壁區,0009,304,127,431,28,459,1085,42.3%,28.02%,1
臺南市,後壁區,0010,315,115,430,10,440,1157,38.03%,27.23%,1
臺南市,後壁區,0011,286,73,359,29,388,755,51.39%,37.88%,1
臺南市,後壁區,0012,173,75,248,11,259,458,56.55%,37.77%,1
臺南市,後壁區,0013,129,29,158,19,177,371,47.71%,34.77%,1
臺南市,後壁區,0014,235,79,314,19,333,676,49.26%,34.76%,1
臺南市,後壁區,0015,134,35,169,21,190,428,44.39%,31.31%,1
臺南市,後壁區,0016,190,43,233,11,244,547,44.61%,34.73%,1
臺南市,後壁區,0017,182,34,216,19,235,455,51.65%,40%,1
臺南市,後壁區,0018,320,82,402,32,434,984,44.11%,32.52%,1
臺南市,後壁區,0019,155,48,203,21,224,483,46.38%,32.09%,1
臺南市,後壁區,0020,166,46,212,16,228,536,42.54%,30.97%,1
臺南市,後壁區,0021,277,69,346,8,354,958,36.95%,28.91%,1
臺南市,後壁區,0022,194,23,217,38,255,441,57.82%,43.99%,1
臺南市,後壁區,0023,258,81,339,41,380,677,56.13%,38.11%,1
臺南市,後壁區,0024,419,102,521,25,546,996,54.82%,42.07%,1
臺南市,後壁區,0025,424,137,561,18,579,1255,46.14%,33.78%,1
臺南市,後壁區,0026,224,65,289,10,299,678,44.1%,33.04%,1
臺南市,後壁區,0027,187,55,242,7,249,553,45.03%,33.82%,1
臺南市,後壁區,0028,161,61,222,12,234,616,37.99%,26.14%,1
臺南市,後壁區,0029,439,129,568,17,585,1189,49.2%,36.92%,1
臺南市,東山區,0062,473,126,599,23,622,1401,44.4%,33.76%,1
臺南市,東山區,0063,367,115,482,27,509,1185,42.95%,30.97%,1
臺南市,東山區,0064,368,127,495,39,534,1303,40.98%,28.24%,1
臺南市,東山區,0065,214,62,276,21,297,732,40.57%,29.23%,1
臺南市,東山區,0066,208,61,269,16,285,721,39.53%,28.85%,1
臺南市,東山區,0067,277,96,373,32,405,1104,36.68%,25.09%,1
臺南市,東山區,0068,317,82,399,13,412,943,43.69%,33.62%,1
臺南市,東山區,0069,141,40,181,4,185,653,28.33%,21.59%,1
臺南市,東山區,0070,198,64,262,31,293,596,49.16%,33.22%,1
臺南市,東山區,0071,281,85,366,36,402,878,45.79%,32%,1
臺南市,東山區,0072,223,80,303,26,329,771,42.67%,28.92%,1
臺南市,東山區,0073,147,54,201,11,212,483,43.89%,30.43%,1
臺南市,東山區,0074,206,80,286,32,318,640,49.69%,32.19%,1
臺南市,東山區,0075,88,19,107,2,109,425,25.65%,20.71%,1
臺南市,東山區,0076,123,19,142,9,151,394,38.32%,31.22%,1
臺南市,東山區,0077,139,40,179,13,192,373,51.47%,37.27%,1
臺南市,東山區,0078,393,74,467,25,492,1257,39.14%,31.26%,1
臺南市,東山區,0079,206,60,266,6,272,887,30.67%,23.22%,1
臺南市,東山區,0080,164,30,194,7,201,658,30.55%,24.92%,1
臺南市,東山區,0081,258,67,325,19,344,1101,31.24%,23.43%,1
臺南市,東山區,0082,258,70,328,11,339,1057,32.07%,24.41%,1
臺南市,東山區,0083,228,68,296,15,311,639,48.67%,35.68%,1
臺南市,東山區,0084,86,25,111,6,117,270,43.33%,31.85%,1
臺南市,麻豆區,0381,452,157,609,31,640,1205,53.11%,37.51%,1
臺南市,麻豆區,0382,256,98,354,17,371,660,56.21%,38.79%,1
臺南市,麻豆區,0383,211,77,288,10,298,523,56.98%,40.34%,1
臺南市,麻豆區,0384,545,241,786,26,812,1597,50.85%,34.13%,1
臺南市,麻豆區,0385,482,191,673,29,702,1262,55.63%,38.19%,1
臺南市,麻豆區,0386,527,210,737,24,761,1325,57.43%,39.77%,1
臺南市,麻豆區,0387,474,215,689,20,709,1384,51.23%,34.25%,1
臺南市,麻豆區,0388,426,166,592,15,607,1121,54.15%,38%,1
臺南市,麻豆區,0389,356,138,494,9,503,1021,49.27%,34.87%,1
臺南市,麻豆區,0390,326,134,460,17,477,954,50%,34.17%,1
臺南市,麻豆區,0391,500,191,691,14,705,1513,46.6%,33.05%,1
臺南市,麻豆區,0392,565,202,767,24,791,1726,45.83%,32.73%,1
臺南市,麻豆區,0393,654,221,875,34,909,1804,50.39%,36.25%,1
臺南市,麻豆區,0394,410,117,527,20,547,1106,49.46%,37.07%,1
臺南市,麻豆區,0395,540,220,760,32,792,1503,52.69%,35.93%,1
臺南市,麻豆區,0396,457,164,621,43,664,1302,51%,35.1%,1
臺南市,麻豆區,0397,241,78,319,11,330,645,51.16%,37.36%,1
臺南市,麻豆區,0398,332,88,420,18,438,777,56.37%,42.73%,1
臺南市,麻豆區,0399,544,205,749,33,782,1612,48.51%,33.75%,1
臺南市,麻豆區,0400,226,94,320,13,333,718,46.38%,31.48%,1
臺南市,麻豆區,0401,552,183,735,15,750,1656,45.29%,33.33%,1
臺南市,麻豆區,0402,438,188,626,43,669,1355,49.37%,32.32%,1
臺南市,麻豆區,0403,291,105,396,16,412,977,42.17%,29.79%,1
臺南市,麻豆區,0404,332,124,456,26,482,1012,47.63%,32.81%,1
臺南市,麻豆區,0405,229,105,334,15,349,626,55.75%,36.58%,1
臺南市,麻豆區,0406,124,33,157,2,159,467,34.05%,26.55%,1
臺南市,麻豆區,0407,434,146,580,19,599,1260,47.54%,34.44%,1
臺南市,麻豆區,0408,438,133,571,28,599,1111,53.92%,39.42%,1
臺南市,麻豆區,0409,190,91,281,19,300,550,54.55%,34.55%,1
臺南市,麻豆區,0410,303,92,395,32,427,798,53.51%,37.97%,1
臺南市,麻豆區,0411,344,117,461,48,509,852,59.74%,40.38%,1
臺南市,麻豆區,0412,251,92,343,7,350,830,42.17%,30.24%,1
臺南市,麻豆區,0413,281,121,402,18,420,941,44.63%,29.86%,1
臺南市,麻豆區,0414,458,162,620,15,635,1158,54.84%,39.55%,1
臺南市,麻豆區,0415,211,75,286,8,294,612,48.04%,34.48%,1
臺南市,下營區,0343,519,158,677,31,708,1558,45.44%,33.31%,1
臺南市,下營區,0344,310,140,450,20,470,1112,42.27%,27.88%,1
臺南市,下營區,0345,303,98,401,28,429,893,48.04%,33.93%,1
臺南市,下營區,0346,530,166,696,34,730,1623,44.98%,32.66%,1
臺南市,下營區,0347,549,191,740,50,790,1568,50.38%,35.01%,1
臺南市,下營區,0348,388,103,491,19,510,985,51.78%,39.39%,1
臺南市,下營區,0349,333,99,432,14,446,953,46.8%,34.94%,1
臺南市,下營區,0350,360,130,490,14,504,1031,48.88%,34.92%,1
臺南市,下營區,0351,438,136,574,33,607,1077,56.36%,40.67%,1
臺南市,下營區,0352,198,75,273,24,297,703,42.25%,28.17%,1
臺南市,下營區,0353,281,83,364,14,378,854,44.26%,32.9%,1
臺南市,下營區,0354,439,136,575,38,613,1164,52.66%,37.71%,1
臺南市,下營區,0355,367,118,485,11,496,1091,45.46%,33.64%,1
臺南市,下營區,0356,353,103,456,33,489,959,50.99%,36.81%,1
臺南市,下營區,0357,319,108,427,22,449,935,48.02%,34.12%,1
臺南市,下營區,0358,331,112,443,24,467,893,52.3%,37.07%,1
臺南市,下營區,0359,507,138,645,40,685,1293,52.98%,39.21%,1
臺南市,下營區,0360,419,150,569,57,626,1185,52.83%,35.36%,1
臺南市,下營區,0361,335,82,417,15,432,1070,40.37%,31.31%,1
臺南市,六甲區,0362,345,96,441,29,470,819,57.39%,42.12%,1
臺南市,六甲區,0363,232,84,316,18,334,645,51.78%,35.97%,1
臺南市,六甲區,0364,191,465,656,23,679,1444,47.02%,13.23%,1
臺南市,六甲區,0365,470,153,623,54,677,1554,43.56%,30.24%,1
臺南市,六甲區,0366,336,153,489,37,526,1171,44.92%,28.69%,1
臺南市,六甲區,0367,454,165,619,35,654,1351,48.41%,33.6%,1
臺南市,六甲區,0368,303,114,417,50,467,1010,46.24%,30%,1
臺南市,六甲區,0369,292,99,391,49,440,919,47.88%,31.77%,1
臺南市,六甲區,0370,444,185,629,39,668,1369,48.79%,32.43%,1
臺南市,六甲區,0371,355,128,483,34,517,976,52.97%,36.37%,1
臺南市,六甲區,0372,391,126,517,37,554,1015,54.58%,38.52%,1
臺南市,六甲區,0373,389,137,526,19,545,1176,46.34%,33.08%,1
臺南市,六甲區,0374,348,110,458,30,488,939,51.97%,37.06%,1
臺南市,六甲區,0375,253,102,355,21,376,712,52.81%,35.53%,1
臺南市,六甲區,0376,313,132,445,19,464,881,52.67%,35.53%,1
臺南市,六甲區,0377,487,165,652,38,690,1184,58.28%,41.13%,1
臺南市,六甲區,0378,284,64,348,19,367,599,61.27%,47.41%,1
臺南市,六甲區,0379,193,42,235,7,242,759,31.88%,25.43%,1
臺南市,六甲區,0380,181,55,236,14,250,621,40.26%,29.15%,1
臺南市,官田區,0416,389,120,509,13,522,1104,47.28%,35.24%,1
臺南市,官田區,0417,334,112,446,28,474,965,49.12%,34.61%,1
臺南市,官田區,0418,520,178,698,25,723,1402,51.57%,37.09%,1
臺南市,官田區,0419,633,219,852,58,910,1653,55.05%,38.29%,1
臺南市,官田區,0420,301,116,417,33,450,966,46.58%,31.16%,1
臺南市,官田區,0421,89,29,118,8,126,284,44.37%,31.34%,1
臺南市,官田區,0422,90,42,132,2,134,402,33.33%,22.39%,1
臺南市,官田區,0423,371,134,505,6,511,982,52.04%,37.78%,1
臺南市,官田區,0424,332,92,424,24,448,975,45.95%,34.05%,1
臺南市,官田區,0425,276,108,384,15,399,802,49.75%,34.41%,1
臺南市,官田區,0426,450,150,600,21,621,1118,55.55%,40.25%,1
臺南市,官田區,0427,505,218,723,19,742,1455,51%,34.71%,1
臺南市,官田區,0428,441,143,584,24,608,1208,50.33%,36.51%,1
臺南市,官田區,0429,450,143,593,53,646,1293,49.96%,34.8%,1
臺南市,官田區,0430,171,75,246,19,265,607,43.66%,28.17%,1
臺南市,官田區,0431,183,57,240,8,248,501,49.5%,36.53%,1
臺南市,官田區,0432,286,98,384,24,408,728,56.04%,39.29%,1
臺南市,官田區,0433,308,115,423,12,435,842,51.66%,36.58%,1
臺南市,官田區,0434,197,58,255,23,278,515,53.98%,38.25%,1
臺南市,官田區,0435,298,73,371,14,385,873,44.1%,34.14%,1
臺南市,大內區,0436,264,53,317,19,336,759,44.27%,34.78%,1
臺南市,大內區,0437,69,16,85,4,89,262,33.97%,26.34%,1
臺南市,大內區,0438,199,57,256,13,269,646,41.64%,30.8%,1
臺南市,大內區,0439,452,138,590,20,610,1473,41.41%,30.69%,1
臺南市,大內區,0440,378,79,457,42,499,915,54.54%,41.31%,1
臺南市,大內區,0441,303,106,409,36,445,779,57.12%,38.9%,1
臺南市,大內區,0442,272,95,367,26,393,637,61.7%,42.7%,1
臺南市,大內區,0443,367,91,458,23,481,993,48.44%,36.96%,1
臺南市,大內區,0444,334,62,396,21,417,766,54.44%,43.6%,1
臺南市,大內區,0445,343,75,418,26,444,841,52.79%,40.78%,1
臺南市,大內區,0446,219,49,268,23,291,583,49.91%,37.56%,1
臺南市,佳里區,0282,565,186,751,31,782,1391,56.22%,40.62%,1
臺南市,佳里區,0283,358,120,478,15,493,829,59.47%,43.18%,1
臺南市,佳里區,0284,500,171,671,22,693,1401,49.46%,35.69%,1
臺南市,佳里區,0285,501,155,656,18,674,1452,46.42%,34.5%,1
臺南市,佳里區,0286,520,199,719,31,750,1382,54.27%,37.63%,1
臺南市,佳里區,0287,547,186,733,49,782,1463,53.45%,37.39%,1
臺南市,佳里區,0288,481,138,619,27,646,1280,50.47%,37.58%,1
臺南市,佳里區,0289,560,206,766,38,804,1486,54.1%,37.69%,1
臺南市,佳里區,0290,508,217,725,46,771,1378,55.95%,36.87%,1
臺南市,佳里區,0291,628,184,812,35,847,1505,56.28%,41.73%,1
臺南市,佳里區,0292,719,223,942,30,972,1860,52.26%,38.66%,1
臺南市,佳里區,0293,448,162,610,23,633,1134,55.82%,39.51%,1
臺南市,佳里區,0294,553,198,751,20,771,1426,54.07%,38.78%,1
臺南市,佳里區,0295,671,251,922,25,947,1779,53.23%,37.72%,1
臺南市,佳里區,0296,755,274,1029,22,1051,1906,55.14%,39.61%,1
臺南市,佳里區,0297,499,202,701,28,729,1425,51.16%,35.02%,1
臺南市,佳里區,0298,475,159,634,26,660,1255,52.59%,37.85%,1
臺南市,佳里區,0299,532,190,722,40,762,1524,50%,34.91%,1
臺南市,佳里區,0300,570,248,818,19,837,1631,51.32%,34.95%,1
臺南市,佳里區,0301,612,207,819,53,872,1546,56.4%,39.59%,1
臺南市,佳里區,0302,506,180,686,26,712,1187,59.98%,42.63%,1
臺南市,佳里區,0303,519,195,714,22,736,1381,53.29%,37.58%,1
臺南市,佳里區,0304,498,173,671,16,687,1364,50.37%,36.51%,1
臺南市,佳里區,0305,496,196,692,14,706,1314,53.73%,37.75%,1
臺南市,佳里區,0306,484,138,622,28,650,1164,55.84%,41.58%,1
臺南市,佳里區,0307,372,126,498,23,521,961,54.21%,38.71%,1
臺南市,佳里區,0308,474,144,618,30,648,1218,53.2%,38.92%,1
臺南市,佳里區,0309,382,121,503,12,515,919,56.04%,41.57%,1
臺南市,佳里區,0310,262,80,342,19,361,689,52.39%,38.03%,1
臺南市,佳里區,0311,128,54,182,8,190,383,49.61%,33.42%,1
臺南市,佳里區,0312,524,162,686,36,722,1507,47.91%,34.77%,1
臺南市,佳里區,0313,255,71,326,20,346,702,49.29%,36.32%,1
臺南市,佳里區,0314,391,83,474,26,500,907,55.13%,43.11%,1
臺南市,佳里區,0315,396,134,530,31,561,937,59.87%,42.26%,1
臺南市,佳里區,0316,395,148,543,20,563,1030,54.66%,38.35%,1
臺南市,佳里區,0317,382,106,488,31,519,981,52.91%,38.94%,1
臺南市,佳里區,0318,305,70,375,17,392,787,49.81%,38.75%,1
臺南市,佳里區,0319,567,179,746,35,781,1513,51.62%,37.48%,1
臺南市,佳里區,0320,245,72,317,15,332,714,46.5%,34.31%,1
臺南市,佳里區,0321,271,81,352,25,377,745,50.6%,36.38%,1
臺南市,佳里區,0322,316,123,439,21,460,951,48.37%,33.23%,1
臺南市,學甲區,0208,332,125,457,34,491,862,56.96%,38.52%,1
臺南市,學甲區,0209,257,96,353,3,356,611,58.27%,42.06%,1
臺南市,學甲區,0210,366,104,470,15,485,936,51.82%,39.1%,1
臺南市,學甲區,0211,378,120,498,27,525,1066,49.25%,35.46%,1
臺南市,學甲區,0212,345,130,475,11,486,869,55.93%,39.7%,1
臺南市,學甲區,0213,238,78,316,24,340,635,53.54%,37.48%,1
臺南市,學甲區,0214,282,92,374,11,385,822,46.84%,34.31%,1
臺南市,學甲區,0215,157,29,186,12,198,443,44.7%,35.44%,1
臺南市,學甲區,0216,525,162,687,24,711,1370,51.9%,38.32%,1
臺南市,學甲區,0217,445,142,587,27,614,1117,54.97%,39.84%,1
臺南市,學甲區,0218,506,143,649,38,687,1365,50.33%,37.07%,1
臺南市,學甲區,0219,528,155,683,34,717,1489,48.15%,35.46%,1
臺南市,學甲區,0220,198,47,245,25,270,627,43.06%,31.58%,1
臺南市,學甲區,0221,393,126,519,17,536,1052,50.95%,37.36%,1
臺南市,學甲區,0222,411,153,564,12,576,1183,48.69%,34.74%,1
臺南市,學甲區,0223,329,93,422,12,434,979,44.33%,33.61%,1
臺南市,學甲區,0224,386,129,515,44,559,1241,45.04%,31.1%,1
臺南市,學甲區,0225,267,62,329,13,342,843,40.57%,31.67%,1
臺南市,學甲區,0226,209,53,262,23,285,580,49.14%,36.03%,1
臺南市,學甲區,0227,251,66,317,15,332,832,39.9%,30.17%,1
臺南市,學甲區,0228,108,38,146,6,152,406,37.44%,26.6%,1
臺南市,學甲區,0229,319,87,406,23,429,818,52.44%,39%,1
臺南市,學甲區,0230,304,106,410,7,417,1052,39.64%,28.9%,1
臺南市,學甲區,0231,190,61,251,11,262,578,45.33%,32.87%,1
臺南市,學甲區,0232,139,33,172,12,184,430,42.79%,32.33%,1
臺南市,學甲區,0233,138,29,167,9,176,361,48.75%,38.23%,1
臺南市,西港區,0323,346,114,460,15,475,933,50.91%,37.08%,1
臺南市,西港區,0324,330,131,461,15,476,901,52.83%,36.63%,1
臺南市,西港區,0325,463,154,617,17,634,1314,48.25%,35.24%,1
臺南市,西港區,0326,474,174,648,46,694,1349,51.45%,35.14%,1
臺南市,西港區,0327,405,133,538,29,567,1014,55.92%,39.94%,1
臺南市,西港區,0328,566,189,755,22,777,1900,40.89%,29.79%,1
臺南市,西港區,0329,516,206,722,40,762,1663,45.82%,31.03%,1
臺南市,西港區,0330,238,87,325,7,332,738,44.99%,32.25%,1
臺南市,西港區,0331,449,168,617,29,646,1211,53.34%,37.08%,1
臺南市,西港區,0332,141,38,179,14,193,382,50.52%,36.91%,1
臺南市,西港區,0333,298,72,370,18,388,786,49.36%,37.91%,1
臺南市,西港區,0334,294,95,389,10,399,838,47.61%,35.08%,1
臺南市,西港區,0335,428,171,599,30,629,1449,43.41%,29.54%,1
臺南市,西港區,0336,451,152,603,20,623,1479,42.12%,30.49%,1
臺南市,西港區,0337,326,79,405,27,432,763,56.62%,42.73%,1
臺南市,西港區,0338,417,43,460,20,480,1297,37.01%,32.15%,1
臺南市,西港區,0339,497,159,656,22,678,1393,48.67%,35.68%,1
臺南市,西港區,0340,302,94,396,10,406,958,42.38%,31.52%,1
臺南市,西港區,0341,156,53,209,10,219,391,56.01%,39.9%,1
臺南市,西港區,0342,312,90,402,21,423,805,52.55%,38.76%,1
臺南市,七股區,0258,189,59,248,9,257,534,48.13%,35.39%,1
臺南市,七股區,0259,221,64,285,5,290,508,57.09%,43.5%,1
臺南市,七股區,0260,212,58,270,6,276,665,41.5%,31.88%,1
臺南市,七股區,0261,290,83,373,16,389,834,46.64%,34.77%,1
臺南市,七股區,0262,338,55,393,9,402,810,49.63%,41.73%,1
臺南市,七股區,0263,178,26,204,4,208,480,43.33%,37.08%,1
臺南市,七股區,0264,145,36,181,5,186,445,41.8%,32.58%,1
臺南市,七股區,0265,178,35,213,4,217,680,31.91%,26.18%,1
臺南市,七股區,0266,290,65,355,15,370,838,44.15%,34.61%,1
臺南市,七股區,0267,283,55,338,11,349,780,44.74%,36.28%,1
臺南市,七股區,0268,144,47,191,7,198,350,56.57%,41.14%,1
臺南市,七股區,0269,365,133,498,37,535,907,58.99%,40.24%,1
臺南市,七股區,0270,268,72,340,15,355,780,45.51%,34.36%,1
臺南市,七股區,0271,556,187,743,20,763,1658,46.02%,33.53%,1
臺南市,七股區,0272,377,72,449,17,466,913,51.04%,41.29%,1
臺南市,七股區,0273,406,163,569,33,602,1202,50.08%,33.78%,1
臺南市,七股區,0274,216,60,276,9,285,696,40.95%,31.03%,1
臺南市,七股區,0275,235,78,313,21,334,647,51.62%,36.32%,1
臺南市,七股區,0276,295,77,372,18,390,622,62.7%,47.43%,1
臺南市,七股區,0277,515,135,650,35,685,1175,58.3%,43.83%,1
臺南市,七股區,0278,233,89,322,11,333,698,47.71%,33.38%,1
臺南市,七股區,0279,394,95,489,26,515,983,52.39%,40.08%,1
臺南市,七股區,0280,480,131,611,27,638,1366,46.71%,35.14%,1
臺南市,七股區,0281,450,136,586,27,613,1379,44.45%,32.63%,1
臺南市,將軍區,0234,470,149,619,34,653,1110,58.83%,42.34%,1
臺南市,將軍區,0235,544,152,696,19,715,1418,50.42%,38.36%,1
臺南市,將軍區,0236,372,102,474,19,493,969,50.88%,38.39%,1
臺南市,將軍區,0237,215,76,291,22,313,519,60.31%,41.43%,1
臺南市,將軍區,0238,413,137,550,9,559,1106,50.54%,37.34%,1
臺南市,將軍區,0239,178,72,250,24,274,542,50.55%,32.84%,1
臺南市,將軍區,0240,106,28,134,3,137,315,43.49%,33.65%,1
臺南市,將軍區,0241,189,53,242,9,251,584,42.98%,32.36%,1
臺南市,將軍區,0242,136,47,183,8,191,398,47.99%,34.17%,1
臺南市,將軍區,0243,191,63,254,12,266,608,43.75%,31.41%,1
臺南市,將軍區,0244,154,60,214,15,229,442,51.81%,34.84%,1
臺南市,將軍區,0245,206,55,261,4,265,650,40.77%,31.69%,1
臺南市,將軍區,0246,182,38,220,9,229,573,39.97%,31.76%,1
臺南市,將軍區,0247,213,55,268,7,275,617,44.57%,34.52%,1
臺南市,將軍區,0248,222,57,279,16,295,573,51.48%,38.74%,1
臺南市,將軍區,0249,180,37,217,6,223,434,51.38%,41.47%,1
臺南市,將軍區,0250,286,84,370,6,376,849,44.29%,33.69%,1
臺南市,將軍區,0251,207,47,254,13,267,645,41.4%,32.09%,1
臺南市,將軍區,0252,255,48,303,14,317,690,45.94%,36.96%,1
臺南市,將軍區,0253,200,38,238,6,244,663,36.8%,30.17%,1
臺南市,將軍區,0254,41,495,536,23,559,1175,47.57%,3.49%,1
臺南市,將軍區,0255,275,53,328,16,344,837,41.1%,32.86%,1
臺南市,將軍區,0256,396,105,501,56,557,1061,52.5%,37.32%,1
臺南市,將軍區,0257,340,69,409,9,418,976,42.83%,34.84%,1
臺南市,北門區,0190,164,68,232,11,243,484,50.21%,33.88%,1
臺南市,北門區,0191,119,37,156,9,165,401,41.15%,29.68%,1
臺南市,北門區,0192,169,31,200,2,202,456,44.3%,37.06%,1
臺南市,北門區,0193,161,43,204,11,215,382,56.28%,42.15%,1
臺南市,北門區,0194,139,40,179,8,187,356,52.53%,39.04%,1
臺南市,北門區,0195,134,29,163,7,170,389,43.7%,34.45%,1
臺南市,北門區,0196,266,52,318,5,323,742,43.53%,35.85%,1
臺南市,北門區,0197,215,47,262,8,270,599,45.08%,35.89%,1
臺南市,北門區,0198,190,46,236,14,250,594,42.09%,31.99%,1
臺南市,北門區,0199,188,48,236,11,247,572,43.18%,32.87%,1
臺南市,北門區,0200,78,32,110,2,112,318,35.22%,24.53%,1
臺南市,北門區,0201,132,43,175,4,179,473,37.84%,27.91%,1
臺南市,北門區,0202,279,58,337,13,350,954,36.69%,29.25%,1
臺南市,北門區,0203,303,77,380,22,402,737,54.55%,41.11%,1
臺南市,北門區,0204,185,43,228,11,239,679,35.2%,27.25%,1
臺南市,北門區,0205,145,37,182,24,206,521,39.54%,27.83%,1
臺南市,北門區,0206,186,42,228,14,242,632,38.29%,29.43%,1
臺南市,北門區,0207,189,63,252,7,259,636,40.72%,29.72%,1
臺南市,新化區,0581,339,93,432,23,455,746,60.99%,45.44%,1
臺南市,新化區,0582,461,174,635,19,654,1102,59.35%,41.83%,1
臺南市,新化區,0583,164,44,208,11,219,370,59.19%,44.32%,1
臺南市,新化區,0584,398,149,547,20,567,947,59.87%,42.03%,1
臺南市,新化區,0585,461,123,584,28,612,1154,53.03%,39.95%,1
臺南市,新化區,0586,402,166,568,39,607,1082,56.1%,37.15%,1
臺南市,新化區,0587,442,145,587,24,611,1075,56.84%,41.12%,1
臺南市,新化區,0588,246,84,330,12,342,640,53.44%,38.44%,1
臺南市,新化區,0589,153,58,211,9,220,410,53.66%,37.32%,1
臺南市,新化區,0590,202,62,264,18,282,533,52.91%,37.9%,1
臺南市,新化區,0591,341,136,477,10,487,836,58.25%,40.79%,1
臺南市,新化區,0592,304,105,409,14,423,978,43.25%,31.08%,1
臺南市,新化區,0593,523,217,740,24,764,1348,56.68%,38.8%,1
臺南市,新化區,0594,366,133,499,39,538,1015,53%,36.06%,1
臺南市,新化區,0595,436,138,574,27,601,1228,48.94%,35.5%,1
臺南市,新化區,0596,311,119,430,26,456,789,57.79%,39.42%,1
臺南市,新化區,0597,426,141,567,17,584,1022,57.14%,41.68%,1
臺南市,新化區,0598,408,115,523,16,539,1021,52.79%,39.96%,1
臺南市,新化區,0599,493,195,688,30,718,1229,58.42%,40.11%,1
臺南市,新化區,0600,428,161,589,13,602,1153,52.21%,37.12%,1
臺南市,新化區,0601,344,101,445,13,458,1012,45.26%,33.99%,1
臺南市,新化區,0602,592,195,787,23,810,1458,55.56%,40.6%,1
臺南市,新化區,0603,670,231,901,25,926,1645,56.29%,40.73%,1
臺南市,新化區,0604,410,158,568,27,595,1016,58.56%,40.35%,1
臺南市,新化區,0605,199,88,287,13,300,559,53.67%,35.6%,1
臺南市,新化區,0606,505,166,671,16,687,1222,56.22%,41.33%,1
臺南市,新化區,0607,612,283,895,29,924,1562,59.15%,39.18%,1
臺南市,新化區,0608,343,114,457,22,479,994,48.19%,34.51%,1
臺南市,新化區,0609,400,124,524,42,566,1013,55.87%,39.49%,1
臺南市,新化區,0610,506,151,657,24,681,1197,56.89%,42.27%,1
臺南市,新化區,0611,388,91,479,40,519,1021,50.83%,38%,1
臺南市,新化區,0612,488,145,633,26,659,1428,46.15%,34.17%,1
臺南市,新化區,0613,152,46,198,20,218,456,47.81%,33.33%,1
臺南市,新化區,0614,434,128,562,34,596,1037,57.47%,41.85%,1
臺南市,新化區,0615,455,133,588,30,618,1097,56.34%,41.48%,1
臺南市,新化區,0616,362,112,474,29,503,902,55.76%,40.13%,1
臺南市,新化區,0617,370,100,470,46,516,999,51.65%,37.04%,1
臺南市,善化區,0492,371,155,526,14,540,1132,47.7%,32.77%,1
臺南市,善化區,0493,614,279,893,33,926,1845,50.19%,33.28%,1
臺南市,善化區,0494,710,314,1024,31,1055,2090,50.48%,33.97%,1
臺南市,善化區,0495,614,228,842,36,878,1582,55.5%,38.81%,1
臺南市,善化區,0496,701,313,1014,45,1059,1901,55.71%,36.88%,1
臺南市,善化區,0497,663,261,924,34,958,1818,52.7%,36.47%,1
臺南市,善化區,0498,586,233,819,39,858,1639,52.35%,35.75%,1
臺南市,善化區,0499,412,163,575,22,597,1061,56.27%,38.83%,1
臺南市,善化區,0500,691,257,948,62,1010,1786,56.55%,38.69%,1
臺南市,善化區,0501,451,141,592,34,626,1147,54.58%,39.32%,1
臺南市,善化區,0502,554,208,762,28,790,1581,49.97%,35.04%,1
臺南市,善化區,0503,441,176,617,51,668,1240,53.87%,35.56%,1
臺南市,善化區,0504,606,199,805,26,831,1743,47.68%,34.77%,1
臺南市,善化區,0505,468,218,686,36,722,1246,57.95%,37.56%,1
臺南市,善化區,0506,345,134,479,19,498,961,51.82%,35.9%,1
臺南市,善化區,0507,331,117,448,8,456,938,48.61%,35.29%,1
臺南市,善化區,0508,304,88,392,11,403,722,55.82%,42.11%,1
臺南市,善化區,0509,397,129,526,14,540,1062,50.85%,37.38%,1
臺南市,善化區,0510,646,191,837,50,887,1715,51.72%,37.67%,1
臺南市,善化區,0511,389,133,522,35,557,1120,49.73%,34.73%,1
臺南市,善化區,0512,318,98,416,24,440,865,50.87%,36.76%,1
臺南市,善化區,0513,532,257,789,35,824,1574,52.35%,33.8%,1
臺南市,善化區,0514,493,175,668,31,699,1535,45.54%,32.12%,1
臺南市,善化區,0515,387,156,543,46,589,1106,53.25%,34.99%,1
臺南市,善化區,0516,511,190,701,25,726,1402,51.78%,36.45%,1
臺南市,善化區,0517,605,226,831,45,876,1458,60.08%,41.5%,1
臺南市,善化區,0518,422,203,625,20,645,1380,46.74%,30.58%,1
臺南市,善化區,0519,379,251,630,12,642,1232,52.11%,30.76%,1
臺南市,善化區,0520,342,232,574,9,583,1069,54.54%,31.99%,1
臺南市,新市區,0545,365,110,475,14,489,960,50.94%,38.02%,1
臺南市,新市區,0546,451,180,631,28,659,1118,58.94%,40.34%,1
臺南市,新市區,0547,303,107,410,8,418,850,49.18%,35.65%,1
臺南市,新市區,0548,444,189,633,28,661,1241,53.26%,35.78%,1
臺南市,新市區,0549,502,178,680,26,706,1297,54.43%,38.7%,1
臺南市,新市區,0550,379,139,518,28,546,962,56.76%,39.4%,1
臺南市,新市區,0551,488,186,674,27,701,1237,56.67%,39.45%,1
臺南市,新市區,0552,499,192,691,29,720,1326,54.3%,37.63%,1
臺南市,新市區,0553,481,175,656,41,697,1211,57.56%,39.72%,1
臺南市,新市區,0554,461,188,649,21,670,1305,51.34%,35.33%,1
臺南市,新市區,0555,274,75,349,28,377,688,54.8%,39.83%,1
臺南市,新市區,0556,361,133,494,23,517,911,56.75%,39.63%,1
臺南市,新市區,0557,514,205,719,21,740,1525,48.52%,33.7%,1
臺南市,新市區,0558,349,124,473,8,481,1091,44.09%,31.99%,1
臺南市,新市區,0559,419,138,557,12,569,1122,50.71%,37.34%,1
臺南市,新市區,0560,407,106,513,19,532,1049,50.71%,38.8%,1
臺南市,新市區,0561,514,212,726,16,742,1564,47.44%,32.86%,1
臺南市,新市區,0562,592,193,785,33,818,1515,53.99%,39.08%,1
臺南市,新市區,0563,560,165,725,20,745,1378,54.06%,40.64%,1
臺南市,新市區,0564,361,123,484,33,517,827,62.52%,43.65%,1
臺南市,新市區,0565,461,126,587,30,617,960,64.27%,48.02%,1
臺南市,新市區,0566,374,98,472,28,500,951,52.58%,39.33%,1
臺南市,新市區,0567,394,267,661,35,696,1264,55.06%,31.17%,1
臺南市,新市區,0568,432,179,611,28,639,1173,54.48%,36.83%,1
臺南市,新市區,0569,283,103,386,11,397,684,58.04%,41.37%,1
臺南市,新市區,0570,478,142,620,33,653,1055,61.9%,45.31%,1
臺南市,新市區,0571,486,183,669,23,692,1122,61.68%,43.32%,1
臺南市,安定區,0521,538,177,715,65,780,1251,62.35%,43.01%,1
臺南市,安定區,0522,355,121,476,34,510,899,56.73%,39.49%,1
臺南市,安定區,0523,399,166,565,47,612,1106,55.33%,36.08%,1
臺南市,安定區,0524,395,100,495,39,534,948,56.33%,41.67%,1
臺南市,安定區,0525,482,197,679,42,721,1442,50%,33.43%,1
臺南市,安定區,0526,542,171,713,24,737,1385,53.21%,39.13%,1
臺南市,安定區,0527,352,86,438,22,460,801,57.43%,43.95%,1
臺南市,安定區,0528,231,92,323,20,343,736,46.6%,31.39%,1
臺南市,安定區,0529,290,87,377,31,408,781,52.24%,37.13%,1
臺南市,安定區,0530,316,102,418,22,440,795,55.35%,39.75%,1
臺南市,安定區,0531,354,120,474,37,511,862,59.28%,41.07%,1
臺南市,安定區,0532,547,181,728,11,739,1487,49.7%,36.79%,1
臺南市,安定區,0533,528,184,712,18,730,1385,52.71%,38.12%,1
臺南市,安定區,0534,548,170,718,31,749,1518,49.34%,36.1%,1
臺南市,安定區,0535,468,144,612,30,642,1094,58.68%,42.78%,1
臺南市,安定區,0536,623,195,818,73,891,1590,56.04%,39.18%,1
臺南市,安定區,0537,313,85,398,30,428,754,56.76%,41.51%,1
臺南市,安定區,0538,280,95,375,33,408,716,56.98%,39.11%,1
臺南市,安定區,0539,565,211,776,41,817,1492,54.76%,37.87%,1
臺南市,安定區,0540,371,125,496,27,523,943,55.46%,39.34%,1
臺南市,安定區,0541,469,154,623,21,644,1157,55.66%,40.54%,1
臺南市,安定區,0542,534,181,715,56,771,1384,55.71%,38.58%,1
臺南市,安定區,0543,354,133,487,45,532,967,55.02%,36.61%,1
臺南市,安定區,0544,266,80,346,15,361,611,59.08%,43.54%,1
臺南市,山上區,0572,261,72,333,33,366,855,42.81%,30.53%,1
臺南市,山上區,0573,264,64,328,20,348,836,41.63%,31.58%,1
臺南市,山上區,0574,255,102,357,25,382,753,50.73%,33.86%,1
臺南市,山上區,0575,285,74,359,20,379,788,48.1%,36.17%,1
臺南市,山上區,0576,345,118,463,34,497,984,50.51%,35.06%,1
臺南市,山上區,0577,318,115,433,14,447,972,45.99%,32.72%,1
臺南市,山上區,0578,139,39,178,3,181,553,32.73%,25.14%,1
臺南市,山上區,0579,127,33,160,7,167,378,44.18%,33.6%,1
臺南市,山上區,0580,140,29,169,17,186,392,47.45%,35.71%,1
臺南市,玉井區,0466,457,133,590,28,618,1242,49.76%,36.8%,1
臺南市,玉井區,0467,455,135,590,18,608,1141,53.29%,39.88%,1
臺南市,玉井區,0468,252,84,336,12,348,698,49.86%,36.1%,1
臺南市,玉井區,0469,307,108,415,21,436,849,51.35%,36.16%,1
臺南市,玉井區,0470,388,108,496,17,513,949,54.06%,40.89%,1
臺南市,玉井區,0471,242,60,302,18,320,618,51.78%,39.16%,1
臺南市,玉井區,0472,211,46,257,6,263,594,44.28%,35.52%,1
臺南市,玉井區,0473,290,98,388,13,401,927,43.26%,31.28%,1
臺南市,玉井區,0474,195,55,250,25,275,512,53.71%,38.09%,1
臺南市,玉井區,0475,181,45,226,19,245,509,48.13%,35.56%,1
臺南市,玉井區,0476,220,47,267,15,282,496,56.85%,44.35%,1
臺南市,玉井區,0477,297,60,357,7,364,759,47.96%,39.13%,1
臺南市,玉井區,0478,210,48,258,11,269,669,40.21%,31.39%,1
臺南市,玉井區,0479,294,58,352,31,383,787,48.67%,37.36%,1
臺南市,玉井區,0480,221,61,282,21,303,620,48.87%,35.65%,1
臺南市,玉井區,0481,362,102,464,38,502,987,50.86%,36.68%,1
臺南市,楠西區,0447,353,94,447,29,476,978,48.67%,36.09%,1
臺南市,楠西區,0448,343,106,449,28,477,870,54.83%,39.43%,1
臺南市,楠西區,0449,321,79,400,10,410,1160,35.34%,27.67%,1
臺南市,楠西區,0450,239,61,300,11,311,699,44.49%,34.19%,1
臺南市,楠西區,0451,316,70,386,8,394,990,39.8%,31.92%,1
臺南市,楠西區,0452,329,76,405,20,425,928,45.8%,35.45%,1
臺南市,楠西區,0453,262,51,313,24,337,660,51.06%,39.7%,1
臺南市,楠西區,0454,416,117,533,52,585,1187,49.28%,35.05%,1
臺南市,楠西區,0455,362,107,469,28,497,1056,47.06%,34.28%,1
臺南市,南化區,0456,260,91,351,24,375,690,54.35%,37.68%,1
臺南市,南化區,0457,265,91,356,31,387,695,55.68%,38.13%,1
臺南市,南化區,0458,272,73,345,22,367,806,45.53%,33.75%,1
臺南市,南化區,0459,192,51,243,29,272,654,41.59%,29.36%,1
臺南市,南化區,0460,211,50,261,24,285,783,36.4%,26.95%,1
臺南市,南化區,0461,154,45,199,9,208,425,48.94%,36.24%,1
臺南市,南化區,0462,210,44,254,23,277,559,49.55%,37.57%,1
臺南市,南化區,0463,420,105,525,6,531,1189,44.66%,35.32%,1
臺南市,南化區,0464,418,108,526,22,548,1044,52.49%,40.04%,1
臺南市,南化區,0465,380,98,478,12,490,941,52.07%,40.38%,1
臺南市,左鎮區,0482,153,24,177,14,191,392,48.72%,39.03%,1
臺南市,左鎮區,0483,273,49,322,22,344,644,53.42%,42.39%,1
臺南市,左鎮區,0484,157,37,194,7,201,468,42.95%,33.55%,1
臺南市,左鎮區,0485,252,55,307,28,335,753,44.49%,33.47%,1
臺南市,左鎮區,0486,121,32,153,9,162,345,46.96%,35.07%,1
臺南市,左鎮區,0487,128,38,166,8,174,393,44.27%,32.57%,1
臺南市,左鎮區,0488,191,31,222,7,229,420,54.52%,45.48%,1
臺南市,左鎮區,0489,100,25,125,7,132,313,42.17%,31.95%,1
臺南市,左鎮區,0490,66,8,74,3,77,186,41.4%,35.48%,1
臺南市,左鎮區,0491,174,33,207,24,231,504,45.83%,34.52%,1
臺南市,仁德區,1188,502,197,699,33,732,1318,55.54%,38.09%,1
臺南市,仁德區,1189,533,200,733,38,771,1406,54.84%,37.91%,1
臺南市,仁德區,1190,552,181,733,38,771,1465,52.63%,37.68%,1
臺南市,仁德區,1191,490,183,673,47,720,1192,60.4%,41.11%,1
臺南市,仁德區,1192,568,226,794,36,830,1429,58.08%,39.75%,1
臺南市,仁德區,1193,485,182,667,60,727,1320,55.08%,36.74%,1
臺南市,仁德區,1194,619,191,810,27,837,1373,60.96%,45.08%,1
臺南市,仁德區,1195,570,177,747,24,771,1330,57.97%,42.86%,1
臺南市,仁德區,1196,676,261,937,14,951,1687,56.37%,40.07%,1
臺南市,仁德區,1197,521,201,722,38,760,1491,50.97%,34.94%,1
臺南市,仁德區,1198,402,127,529,19,548,1151,47.61%,34.93%,1
臺南市,仁德區,1199,525,190,715,19,734,1407,52.17%,37.31%,1
臺南市,仁德區,1200,613,200,813,24,837,1465,57.13%,41.84%,1
臺南市,仁德區,1201,550,185,735,23,758,1335,56.78%,41.2%,1
臺南市,仁德區,1202,529,210,739,46,785,1490,52.68%,35.5%,1
臺南市,仁德區,1203,603,231,834,23,857,1453,58.98%,41.5%,1
臺南市,仁德區,1204,388,126,514,15,529,990,53.43%,39.19%,1
臺南市,仁德區,1205,659,202,861,25,886,1573,56.33%,41.89%,1
臺南市,仁德區,1206,411,137,548,20,568,1031,55.09%,39.86%,1
臺南市,仁德區,1207,470,154,624,21,645,1194,54.02%,39.36%,1
臺南市,仁德區,1208,495,148,643,21,664,1268,52.37%,39.04%,1
臺南市,仁德區,1209,365,147,512,19,531,929,57.16%,39.29%,1
臺南市,仁德區,1210,410,155,565,7,572,1145,49.96%,35.81%,1
臺南市,仁德區,1211,510,204,714,26,740,1413,52.37%,36.09%,1
臺南市,仁德區,1212,562,182,744,44,788,1465,53.79%,38.36%,1
臺南市,仁德區,1213,565,205,770,32,802,1390,57.7%,40.65%,1
臺南市,仁德區,1214,526,202,728,39,767,1396,54.94%,37.68%,1
臺南市,仁德區,1215,666,300,966,32,998,1906,52.36%,34.94%,1
臺南市,仁德區,1216,547,210,757,18,775,1546,50.13%,35.38%,1
臺南市,仁德區,1217,501,190,691,20,711,1546,45.99%,32.41%,1
臺南市,仁德區,1218,521,202,723,23,746,1399,53.32%,37.24%,1
臺南市,仁德區,1219,660,234,894,39,933,1748,53.38%,37.76%,1
臺南市,仁德區,1220,463,162,625,23,648,1140,56.84%,40.61%,1
臺南市,仁德區,1221,503,170,673,23,696,1277,54.5%,39.39%,1
臺南市,仁德區,1222,487,143,630,24,654,1019,64.18%,47.79%,1
臺南市,仁德區,1223,559,175,734,14,748,1414,52.9%,39.53%,1
臺南市,仁德區,1224,490,172,662,13,675,1349,50.04%,36.32%,1
臺南市,仁德區,1225,540,201,741,20,761,1471,51.73%,36.71%,1
臺南市,仁德區,1226,514,185,699,19,718,1324,54.23%,38.82%,1
臺南市,仁德區,1227,500,134,634,19,653,1310,49.85%,38.17%,1
臺南市,仁德區,1228,221,76,297,17,314,554,56.68%,39.89%,1
臺南市,仁德區,1229,580,148,728,23,751,1395,53.84%,41.58%,1
臺南市,仁德區,1230,483,161,644,12,656,1264,51.9%,38.21%,1
臺南市,仁德區,1231,467,140,607,55,662,1180,56.1%,39.58%,1
臺南市,仁德區,1232,364,97,461,17,478,928,51.51%,39.22%,1
臺南市,仁德區,1233,365,119,484,11,495,965,51.3%,37.82%,1
臺南市,仁德區,1234,433,144,577,19,596,1119,53.26%,38.7%,1
臺南市,仁德區,1235,493,135,628,32,660,1206,54.73%,40.88%,1
臺南市,仁德區,1236,556,174,730,26,756,1466,51.57%,37.93%,1
臺南市,歸仁區,1237,572,213,785,34,819,1560,52.5%,36.67%,1
臺南市,歸仁區,1238,611,212,823,21,844,1383,61.03%,44.18%,1
臺南市,歸仁區,1239,568,221,789,14,803,1491,53.86%,38.1%,1
臺南市,歸仁區,1240,551,180,731,30,761,1482,51.35%,37.18%,1
臺南市,歸仁區,1241,552,183,735,16,751,1330,56.47%,41.5%,1
臺南市,歸仁區,1242,546,223,769,26,795,1399,56.83%,39.03%,1
臺南市,歸仁區,1243,519,190,709,26,735,1416,51.91%,36.65%,1
臺南市,歸仁區,1244,404,162,566,31,597,1336,44.69%,30.24%,1
臺南市,歸仁區,1245,429,127,556,41,597,1183,50.46%,36.26%,1
臺南市,歸仁區,1246,451,167,618,17,635,1237,51.33%,36.46%,1
臺南市,歸仁區,1247,433,175,608,32,640,1133,56.49%,38.22%,1
臺南市,歸仁區,1248,422,156,578,23,601,1149,52.31%,36.73%,1
臺南市,歸仁區,1249,429,159,588,7,595,1105,53.85%,38.82%,1
臺南市,歸仁區,1250,420,159,579,32,611,1099,55.6%,38.22%,1
臺南市,歸仁區,1251,449,149,598,39,637,1082,58.87%,41.5%,1
臺南市,歸仁區,1252,645,204,849,29,878,1519,57.8%,42.46%,1
臺南市,歸仁區,1253,588,225,813,27,840,1467,57.26%,40.08%,1
臺南市,歸仁區,1254,385,167,552,28,580,1090,53.21%,35.32%,1
臺南市,歸仁區,1255,413,161,574,24,598,1131,52.87%,36.52%,1
臺南市,歸仁區,1256,422,144,566,20,586,1080,54.26%,39.07%,1
臺南市,歸仁區,1257,384,137,521,22,543,1121,48.44%,34.26%,1
臺南市,歸仁區,1258,485,209,694,33,727,1336,54.42%,36.3%,1
臺南市,歸仁區,1259,424,151,575,42,617,1128,54.7%,37.59%,1
臺南市,歸仁區,1260,409,144,553,14,567,1055,53.74%,38.77%,1
臺南市,歸仁區,1261,431,141,572,22,594,1102,53.9%,39.11%,1
臺南市,歸仁區,1262,405,165,570,28,598,1068,55.99%,37.92%,1
臺南市,歸仁區,1263,397,165,562,38,600,1033,58.08%,38.43%,1
臺南市,歸仁區,1264,552,187,739,10,749,1772,42.27%,31.15%,1
臺南市,歸仁區,1265,563,196,759,22,781,1399,55.83%,40.24%,1
臺南市,歸仁區,1266,579,232,811,14,825,1544,53.43%,37.5%,1
臺南市,歸仁區,1267,231,67,298,9,307,684,44.88%,33.77%,1
臺南市,歸仁區,1268,348,132,480,26,506,839,60.31%,41.48%,1
臺南市,歸仁區,1269,409,167,576,33,609,1014,60.06%,40.34%,1
臺南市,歸仁區,1270,522,180,702,15,717,1906,37.62%,27.39%,1
臺南市,歸仁區,1271,496,198,694,25,719,1245,57.75%,39.84%,1
臺南市,歸仁區,1272,412,138,550,10,560,1048,53.44%,39.31%,1
臺南市,歸仁區,1273,457,155,612,16,628,1175,53.45%,38.89%,1
臺南市,歸仁區,1274,499,194,693,24,717,1411,50.82%,35.36%,1
臺南市,歸仁區,1275,585,250,835,24,859,1514,56.74%,38.64%,1
臺南市,歸仁區,1276,610,256,866,38,904,1678,53.87%,36.35%,1
臺南市,歸仁區,1277,386,126,512,31,543,949,57.22%,40.67%,1
臺南市,歸仁區,1278,448,133,581,35,616,1009,61.05%,44.4%,1
臺南市,歸仁區,1279,441,167,608,5,613,984,62.3%,44.82%,1
臺南市,歸仁區,1280,346,91,437,19,456,756,60.32%,45.77%,1
臺南市,歸仁區,1281,507,325,832,47,879,1478,59.47%,34.3%,1
臺南市,歸仁區,1282,584,236,820,53,873,1467,59.51%,39.81%,1
臺南市,關廟區,1283,382,144,526,8,534,982,54.38%,38.9%,1
臺南市,關廟區,1284,514,162,676,25,701,1156,60.64%,44.46%,1
臺南市,關廟區,1285,378,105,483,16,499,1006,49.6%,37.57%,1
臺南市,關廟區,1286,437,168,605,35,640,1043,61.36%,41.9%,1
臺南市,關廟區,1287,401,153,554,36,590,1012,58.3%,39.62%,1
臺南市,關廟區,1288,351,120,471,19,490,1013,48.37%,34.65%,1
臺南市,關廟區,1289,468,161,629,24,653,1294,50.46%,36.17%,1
臺南市,關廟區,1290,466,165,631,31,662,1264,52.37%,36.87%,1
臺南市,關廟區,1291,463,144,607,28,635,1166,54.46%,39.71%,1
臺南市,關廟區,1292,379,146,525,13,538,1018,52.85%,37.23%,1
臺南市,關廟區,1293,246,75,321,21,342,733,46.66%,33.56%,1
臺南市,關廟區,1294,492,143,635,17,652,1093,59.65%,45.01%,1
臺南市,關廟區,1295,464,143,607,13,620,1081,57.35%,42.92%,1
臺南市,關廟區,1296,420,136,556,26,582,978,59.51%,42.94%,1
臺南市,關廟區,1297,381,141,522,26,548,1116,49.1%,34.14%,1
臺南市,關廟區,1298,384,111,495,27,522,972,53.7%,39.51%,1
臺南市,關廟區,1299,392,156,548,51,599,1045,57.32%,37.51%,1
臺南市,關廟區,1300,342,123,465,24,489,872,56.08%,39.22%,1
臺南市,關廟區,1301,411,148,559,34,593,1007,58.89%,40.81%,1
臺南市,關廟區,1302,326,111,437,24,461,763,60.42%,42.73%,1
臺南市,關廟區,1303,224,82,306,28,334,630,53.02%,35.56%,1
臺南市,關廟區,1304,400,120,520,44,564,959,58.81%,41.71%,1
臺南市,關廟區,1305,461,120,581,22,603,1123,53.7%,41.05%,1
臺南市,關廟區,1306,341,96,437,31,468,804,58.21%,42.41%,1
臺南市,關廟區,1307,288,98,386,13,399,720,55.42%,40%,1
臺南市,關廟區,1308,297,79,376,13,389,843,46.14%,35.23%,1
臺南市,關廟區,1309,132,41,173,11,184,358,51.4%,36.87%,1
臺南市,關廟區,1310,315,77,392,39,431,797,54.08%,39.52%,1
臺南市,關廟區,1311,259,61,320,11,331,709,46.69%,36.53%,1
臺南市,關廟區,1312,347,80,427,18,445,904,49.23%,38.38%,1
臺南市,關廟區,1313,388,120,508,18,526,963,54.62%,40.29%,1
臺南市,關廟區,1314,208,78,286,11,297,489,60.74%,42.54%,1
臺南市,龍崎區,1315,408,127,535,27,562,1047,53.68%,38.97%,1
臺南市,龍崎區,1316,254,56,310,14,324,630,51.43%,40.32%,1
臺南市,龍崎區,1317,40,12,52,7,59,141,41.84%,28.37%,1
臺南市,龍崎區,1318,134,43,177,8,185,367,50.41%,36.51%,1
臺南市,龍崎區,1319,148,30,178,7,185,337,54.9%,43.92%,1
臺南市,龍崎區,1320,114,29,143,3,146,318,45.91%,35.85%,1
臺南市,龍崎區,1321,166,28,194,20,214,427,50.12%,38.88%,1
臺南市,龍崎區,1322,147,42,189,15,204,446,45.74%,32.96%,1
臺南市,永康區,0708,508,227,735,30,765,1398,54.72%,36.34%,1
臺南市,永康區,0709,475,195,670,21,691,1478,46.75%,32.14%,1
臺南市,永康區,0710,479,229,708,17,725,1442,50.28%,33.22%,1
臺南市,永康區,0711,473,172,645,24,669,1353,49.45%,34.96%,1
臺南市,永康區,0712,460,143,603,20,623,1160,53.71%,39.66%,1
臺南市,永康區,0713,443,170,613,18,631,1122,56.24%,39.48%,1
臺南市,永康區,0714,419,164,583,7,590,1165,50.64%,35.97%,1
臺南市,永康區,0715,450,200,650,10,660,1317,50.11%,34.17%,1
臺南市,永康區,0716,527,165,692,18,710,1376,51.6%,38.3%,1
臺南市,永康區,0717,472,241,713,18,731,1361,53.71%,34.68%,1
臺南市,永康區,0718,505,279,784,18,802,1374,58.37%,36.75%,1
臺南市,永康區,0719,561,241,802,37,839,1709,49.09%,32.83%,1
臺南市,永康區,0720,597,215,812,24,836,1717,48.69%,34.77%,1
臺南市,永康區,0721,583,237,820,30,850,1759,48.32%,33.14%,1
臺南市,永康區,0722,595,239,834,20,854,1636,52.2%,36.37%,1
臺南市,永康區,0723,529,208,737,28,765,1442,53.05%,36.69%,1
臺南市,永康區,0724,536,217,753,26,779,1545,50.42%,34.69%,1
臺南市,永康區,0725,609,175,784,21,805,1565,51.44%,38.91%,1
臺南市,永康區,0726,546,251,797,20,817,1684,48.52%,32.42%,1
臺南市,永康區,0727,546,220,766,12,778,1548,50.26%,35.27%,1
臺南市,永康區,0728,564,193,757,17,774,1389,55.72%,40.6%,1
臺南市,永康區,0729,497,215,712,24,736,1369,53.76%,36.3%,1
臺南市,永康區,0730,559,180,739,39,778,1415,54.98%,39.51%,1
臺南市,永康區,0731,429,202,631,9,640,1386,46.18%,30.95%,1
臺南市,永康區,0732,335,98,433,5,438,1747,25.07%,19.18%,1
臺南市,永康區,0733,531,218,749,21,770,1485,51.85%,35.76%,1
臺南市,永康區,0734,604,258,862,32,894,1747,51.17%,34.57%,1
臺南市,永康區,0735,560,223,783,23,806,1744,46.22%,32.11%,1
臺南市,永康區,0736,641,220,861,18,879,1797,48.91%,35.67%,1
臺南市,永康區,0737,713,260,973,24,997,1800,55.39%,39.61%,1
臺南市,永康區,0738,634,203,837,14,851,1720,49.48%,36.86%,1
臺南市,永康區,0739,638,266,904,23,927,1708,54.27%,37.35%,1
臺南市,永康區,0740,642,217,859,16,875,1519,57.6%,42.26%,1
臺南市,永康區,0741,616,196,812,35,847,1497,56.58%,41.15%,1
臺南市,永康區,0742,618,203,821,18,839,1509,55.6%,40.95%,1
臺南市,永康區,0743,673,205,878,40,918,1542,59.53%,43.64%,1
臺南市,永康區,0744,552,275,827,15,842,1536,54.82%,35.94%,1
臺南市,永康區,0745,552,248,800,23,823,1531,53.76%,36.05%,1
臺南市,永康區,0746,530,220,750,17,767,1327,57.8%,39.94%,1
臺南市,永康區,0747,527,240,767,7,774,1456,53.16%,36.2%,1
臺南市,永康區,0748,514,263,777,13,790,1396,56.59%,36.82%,1
臺南市,永康區,0749,569,243,812,37,849,1636,51.89%,34.78%,1
臺南市,永康區,0750,552,283,835,29,864,1592,54.27%,34.67%,1
臺南市,永康區,0751,579,371,950,10,960,2017,47.6%,28.71%,1
臺南市,永康區,0752,261,104,365,10,375,672,55.8%,38.84%,1
臺南市,永康區,0753,554,230,784,13,797,1611,49.47%,34.39%,1
臺南市,永康區,0754,519,255,774,22,796,1502,53%,34.55%,1
臺南市,永康區,0755,506,231,737,16,753,1660,45.36%,30.48%,1
臺南市,永康區,0756,456,230,686,15,701,1561,44.91%,29.21%,1
臺南市,永康區,0757,540,239,779,21,800,1590,50.31%,33.96%,1
臺南市,永康區,0758,335,152,487,14,501,924,54.22%,36.26%,1
臺南市,永康區,0759,381,147,528,22,550,938,58.64%,40.62%,1
臺南市,永康區,0760,378,147,525,27,552,957,57.68%,39.5%,1
臺南市,永康區,0761,170,76,246,33,279,496,56.25%,34.27%,1
臺南市,永康區,0762,647,233,880,31,911,1717,53.06%,37.68%,1
臺南市,永康區,0763,552,207,759,21,780,1615,48.3%,34.18%,1
臺南市,永康區,0764,580,203,783,12,795,1554,51.16%,37.32%,1
臺南市,永康區,0765,452,147,599,19,618,1196,51.67%,37.79%,1
臺南市,永康區,0766,459,193,652,16,668,1274,52.43%,36.03%,1
臺南市,永康區,0767,454,183,637,17,654,1215,53.83%,37.37%,1
臺南市,永康區,0768,545,218,763,11,774,1457,53.12%,37.41%,1
臺南市,永康區,0769,569,215,784,10,794,1451,54.72%,39.21%,1
臺南市,永康區,0770,488,184,672,19,691,1423,48.56%,34.29%,1
臺南市,永康區,0771,572,170,742,29,771,1394,55.31%,41.03%,1
臺南市,永康區,0772,348,138,486,30,516,890,57.98%,39.1%,1
臺南市,永康區,0773,446,147,593,25,618,1018,60.71%,43.81%,1
臺南市,永康區,0774,145,55,200,15,215,368,58.42%,39.4%,1
臺南市,永康區,0775,533,176,709,22,731,1208,60.51%,44.12%,1
臺南市,永康區,0776,392,192,584,25,609,1187,51.31%,33.02%,1
臺南市,永康區,0777,483,202,685,18,703,1381,50.91%,34.97%,1
臺南市,永康區,0778,526,186,712,32,744,1405,52.95%,37.44%,1
臺南市,永康區,0779,461,211,672,56,728,1445,50.38%,31.9%,1
臺南市,永康區,0780,559,265,824,28,852,1687,50.5%,33.14%,1
臺南市,永康區,0781,498,198,696,34,730,1535,47.56%,32.44%,1
臺南市,永康區,0782,559,228,787,49,836,1542,54.22%,36.25%,1
臺南市,永康區,0783,573,232,805,22,827,1618,51.11%,35.41%,1
臺南市,永康區,0784,514,216,730,16,746,1338,55.75%,38.42%,1
臺南市,永康區,0785,517,191,708,37,745,1285,57.98%,40.23%,1
臺南市,永康區,0786,465,179,644,18,662,1240,53.39%,37.5%,1
臺南市,永康區,0787,487,162,649,26,675,1343,50.26%,36.26%,1
臺南市,永康區,0788,522,221,743,23,766,1327,57.72%,39.34%,1
臺南市,永康區,0789,552,236,788,30,818,1565,52.27%,35.27%,1
臺南市,永康區,0790,569,205,774,53,827,1476,56.03%,38.55%,1
臺南市,永康區,0791,538,216,754,30,784,1476,53.12%,36.45%,1
臺南市,永康區,0792,580,249,829,16,845,1463,57.76%,39.64%,1
臺南市,永康區,0793,390,143,533,40,573,983,58.29%,39.67%,1
臺南市,永康區,0794,444,174,618,39,657,1116,58.87%,39.78%,1
臺南市,永康區,0795,409,154,563,33,596,1117,53.36%,36.62%,1
臺南市,永康區,0796,373,139,512,25,537,1069,50.23%,34.89%,1
臺南市,永康區,0797,490,183,673,28,701,1180,59.41%,41.53%,1
臺南市,永康區,0798,461,142,603,50,653,1176,55.53%,39.2%,1
臺南市,永康區,0799,417,174,591,19,610,1158,52.68%,36.01%,1
臺南市,永康區,0800,468,196,664,48,712,1208,58.94%,38.74%,1
臺南市,永康區,0801,562,202,764,46,810,1501,53.96%,37.44%,1
臺南市,永康區,0802,514,206,720,25,745,1298,57.4%,39.6%,1
臺南市,永康區,0803,560,238,798,19,817,1542,52.98%,36.32%,1
臺南市,永康區,0804,575,260,835,25,860,1537,55.95%,37.41%,1
臺南市,永康區,0805,554,234,788,39,827,1359,60.85%,40.77%,1
臺南市,永康區,0806,394,139,533,25,558,1139,48.99%,34.59%,1
臺南市,永康區,0807,399,153,552,28,580,1158,50.09%,34.46%,1
臺南市,永康區,0808,529,221,750,37,787,1538,51.17%,34.4%,1
臺南市,永康區,0809,442,143,585,18,603,1166,51.72%,37.91%,1
臺南市,永康區,0810,463,167,630,21,651,1228,53.01%,37.7%,1
臺南市,永康區,0811,472,181,653,28,681,1200,56.75%,39.33%,1
臺南市,永康區,0812,430,193,623,17,640,1131,56.59%,38.02%,1
臺南市,永康區,0813,433,188,621,9,630,1147,54.93%,37.75%,1
臺南市,永康區,0814,522,190,712,26,738,1442,51.18%,36.2%,1
臺南市,永康區,0815,469,197,666,20,686,1325,51.77%,35.4%,1
臺南市,永康區,0816,434,145,579,23,602,1260,47.78%,34.44%,1
臺南市,永康區,0817,571,207,778,22,800,1631,49.05%,35.01%,1
臺南市,永康區,0818,537,206,743,26,769,1549,49.64%,34.67%,1
臺南市,永康區,0819,591,234,825,16,841,1666,50.48%,35.47%,1
臺南市,永康區,0820,360,102,462,36,498,1012,49.21%,35.57%,1
臺南市,永康區,0821,340,113,453,12,465,976,47.64%,34.84%,1
臺南市,永康區,0822,215,70,285,10,295,531,55.56%,40.49%,1
臺南市,永康區,0823,361,121,482,19,501,859,58.32%,42.03%,1
臺南市,永康區,0824,324,131,455,14,469,937,50.05%,34.58%,1
臺南市,永康區,0825,509,175,684,22,706,1307,54.02%,38.94%,1
臺南市,永康區,0826,522,174,696,18,714,1482,48.18%,35.22%,1
臺南市,永康區,0827,433,176,609,23,632,1341,47.13%,32.29%,1
臺南市,永康區,0828,470,205,675,30,705,1376,51.24%,34.16%,1
臺南市,永康區,0829,481,184,665,26,691,1390,49.71%,34.6%,1
臺南市,永康區,0830,575,235,810,26,836,1534,54.5%,37.48%,1
臺南市,永康區,0831,590,199,789,21,810,1460,55.48%,40.41%,1
臺南市,永康區,0832,495,196,691,21,712,1383,51.48%,35.79%,1
臺南市,永康區,0833,500,186,686,20,706,1299,54.35%,38.49%,1
臺南市,永康區,0834,481,210,691,11,702,1264,55.54%,38.05%,1
臺南市,永康區,0835,511,239,750,23,773,1355,57.05%,37.71%,1
臺南市,永康區,0836,507,191,698,20,718,1414,50.78%,35.86%,1
臺南市,永康區,0837,433,183,616,13,629,1109,56.72%,39.04%,1
臺南市,永康區,0838,421,137,558,32,590,1151,51.26%,36.58%,1
臺南市,永康區,0839,464,174,638,24,662,1026,64.52%,45.22%,1
臺南市,永康區,0840,437,129,566,14,580,1071,54.15%,40.8%,1
臺南市,永康區,0841,618,245,863,15,878,1387,63.3%,44.56%,1
臺南市,永康區,0842,541,246,787,27,814,1377,59.11%,39.29%,1
臺南市,永康區,0843,647,231,878,36,914,1687,54.18%,38.35%,1
臺南市,永康區,0844,588,241,829,20,849,1700,49.94%,34.59%,1
臺南市,永康區,0845,556,226,782,18,800,1444,55.4%,38.5%,1
臺南市,永康區,0846,548,198,746,21,767,1485,51.65%,36.9%,1
臺南市,永康區,0847,570,239,809,25,834,1717,48.57%,33.2%,1
臺南市,永康區,0848,529,233,762,37,799,1701,46.97%,31.1%,1
臺南市,永康區,0849,493,202,695,19,714,1382,51.66%,35.67%,1
臺南市,東區,1095,761,287,1048,33,1081,2681,40.32%,28.38%,1
臺南市,東區,1096,684,282,966,17,983,1811,54.28%,37.77%,1
臺南市,東區,1097,630,266,896,42,938,1491,62.91%,42.25%,1
臺南市,東區,1098,492,237,729,24,753,1378,54.64%,35.7%,1
臺南市,東區,1099,623,259,882,21,903,1552,58.18%,40.14%,1
臺南市,東區,1100,556,219,775,6,781,1326,58.9%,41.93%,1
臺南市,東區,1101,588,287,875,28,903,1594,56.65%,36.89%,1
臺南市,東區,1102,615,308,923,25,948,1639,57.84%,37.52%,1
臺南市,東區,1103,630,288,918,29,947,1724,54.93%,36.54%,1
臺南市,東區,1104,638,242,880,29,909,1629,55.8%,39.17%,1
臺南市,東區,1105,520,258,778,20,798,1399,57.04%,37.17%,1
臺南市,東區,1106,571,269,840,18,858,1534,55.93%,37.22%,1
臺南市,東區,1107,619,279,898,19,917,1656,55.37%,37.38%,1
臺南市,東區,1108,497,208,705,27,732,1322,55.37%,37.59%,1
臺南市,東區,1109,582,292,874,25,899,1620,55.49%,35.93%,1
臺南市,東區,1110,557,243,800,17,817,1331,61.38%,41.85%,1
臺南市,東區,1111,436,151,587,17,604,1039,58.13%,41.96%,1
臺南市,東區,1112,490,152,642,17,659,1257,52.43%,38.98%,1
臺南市,東區,1113,753,285,1038,36,1074,2067,51.96%,36.43%,1
臺南市,東區,1114,886,278,1164,19,1183,2153,54.95%,41.15%,1
臺南市,東區,1115,869,354,1223,29,1252,2363,52.98%,36.78%,1
臺南市,東區,1116,548,205,753,33,786,1427,55.08%,38.4%,1
臺南市,東區,1117,670,244,914,19,933,1555,60%,43.09%,1
臺南市,東區,1118,673,265,938,30,968,2115,45.77%,31.82%,1
臺南市,東區,1119,790,348,1138,27,1165,2340,49.79%,33.76%,1
臺南市,東區,1120,887,404,1291,22,1313,2474,53.07%,35.85%,1
臺南市,東區,1121,838,378,1216,29,1245,2391,52.07%,35.05%,1
臺南市,東區,1122,633,290,923,19,942,1673,56.31%,37.84%,1
臺南市,東區,1123,613,255,868,17,885,1594,55.52%,38.46%,1
臺南市,東區,1124,638,250,888,32,920,1607,57.25%,39.7%,1
臺南市,東區,1125,804,393,1197,23,1220,2087,58.46%,38.52%,1
臺南市,東區,1126,893,448,1341,24,1365,2369,57.62%,37.7%,1
臺南市,東區,1127,639,237,876,40,916,1696,54.01%,37.68%,1
臺南市,東區,1128,627,254,881,34,915,1612,56.76%,38.9%,1
臺南市,東區,1129,607,265,872,24,896,1708,52.46%,35.54%,1
臺南市,東區,1130,587,252,839,26,865,1560,55.45%,37.63%,1
臺南市,東區,1131,623,323,946,46,992,1854,53.51%,33.6%,1
臺南市,東區,1132,769,344,1113,29,1142,2278,50.13%,33.76%,1
臺南市,東區,1133,752,334,1086,26,1112,2093,53.13%,35.93%,1
臺南市,東區,1134,853,402,1255,26,1281,2242,57.14%,38.05%,1
臺南市,東區,1135,470,205,675,24,699,1152,60.68%,40.8%,1
臺南市,東區,1136,539,248,787,11,798,1318,60.55%,40.9%,1
臺南市,東區,1137,827,393,1220,28,1248,2200,56.73%,37.59%,1
臺南市,東區,1138,753,369,1122,18,1140,1960,58.16%,38.42%,1
臺南市,東區,1139,574,226,800,27,827,1489,55.54%,38.55%,1
臺南市,東區,1140,517,247,764,34,798,1443,55.3%,35.83%,1
臺南市,東區,1141,552,329,881,30,911,1498,60.81%,36.85%,1
臺南市,東區,1142,620,281,901,17,918,1622,56.6%,38.22%,1
臺南市,東區,1143,653,306,959,16,975,1738,56.1%,37.57%,1
臺南市,東區,1144,513,260,773,23,796,1501,53.03%,34.18%,1
臺南市,東區,1145,580,222,802,37,839,1482,56.61%,39.14%,1
臺南市,東區,1146,620,265,885,28,913,1829,49.92%,33.9%,1
臺南市,東區,1147,609,321,930,36,966,1764,54.76%,34.52%,1
臺南市,東區,1148,571,241,812,23,835,1427,58.51%,40.01%,1
臺南市,東區,1149,499,242,741,34,775,1427,54.31%,34.97%,1
臺南市,東區,1150,527,236,763,21,784,1388,56.48%,37.97%,1
臺南市,東區,1151,421,248,669,26,695,1131,61.45%,37.22%,1
臺南市,東區,1152,371,145,516,32,548,1000,54.8%,37.1%,1
臺南市,東區,1153,400,143,543,15,558,996,56.02%,40.16%,1
臺南市,東區,1154,348,123,471,28,499,935,53.37%,37.22%,1
臺南市,東區,1155,344,173,517,31,548,947,57.87%,36.33%,1
臺南市,東區,1156,388,208,596,6,602,1090,55.23%,35.6%,1
臺南市,東區,1157,329,121,450,28,478,896,53.35%,36.72%,1
臺南市,東區,1158,575,280,855,21,876,1589,55.13%,36.19%,1
臺南市,東區,1159,567,260,827,26,853,1497,56.98%,37.88%,1
臺南市,東區,1160,506,189,695,42,737,1386,53.17%,36.51%,1
臺南市,東區,1161,422,187,609,16,625,1101,56.77%,38.33%,1
臺南市,東區,1162,520,227,747,29,776,1332,58.26%,39.04%,1
臺南市,東區,1163,469,191,660,21,681,1185,57.47%,39.58%,1
臺南市,東區,1164,535,185,720,29,749,1262,59.35%,42.39%,1
臺南市,東區,1165,580,196,776,19,795,1517,52.41%,38.23%,1
臺南市,東區,1166,487,195,682,34,716,1287,55.63%,37.84%,1
臺南市,東區,1167,654,248,902,28,930,1657,56.13%,39.47%,1
臺南市,東區,1168,824,332,1156,65,1221,2238,54.56%,36.82%,1
臺南市,東區,1169,781,376,1157,38,1195,2246,53.21%,34.77%,1
臺南市,東區,1170,796,342,1138,28,1166,2191,53.22%,36.33%,1
臺南市,東區,1171,697,355,1052,41,1093,2063,52.98%,33.79%,1
臺南市,東區,1172,881,342,1223,39,1262,2177,57.97%,40.47%,1
臺南市,東區,1173,751,302,1053,40,1093,1863,58.67%,40.31%,1
臺南市,東區,1174,840,360,1200,28,1228,2185,56.2%,38.44%,1
臺南市,東區,1175,593,219,812,30,842,1721,48.93%,34.46%,1
臺南市,東區,1176,578,234,812,52,864,1556,55.53%,37.15%,1
臺南市,東區,1177,617,275,892,29,921,1602,57.49%,38.51%,1
臺南市,東區,1178,587,190,777,34,811,1523,53.25%,38.54%,1
臺南市,東區,1179,483,216,699,23,722,1382,52.24%,34.95%,1
臺南市,東區,1180,560,237,797,15,812,1486,54.64%,37.69%,1
臺南市,東區,1181,585,262,847,37,884,1560,56.67%,37.5%,1
臺南市,東區,1182,542,264,806,39,845,1684,50.18%,32.19%,1
臺南市,東區,1183,582,307,889,27,916,1653,55.41%,35.21%,1
臺南市,東區,1184,540,316,856,11,867,1554,55.79%,34.75%,1
臺南市,東區,1185,524,267,791,15,806,1408,57.24%,37.22%,1
臺南市,東區,1186,837,361,1198,22,1220,2084,58.54%,40.16%,1
臺南市,東區,1187,636,378,1014,27,1041,1896,54.91%,33.54%,1
臺南市,南區,1015,479,198,677,32,709,1221,58.07%,39.23%,1
臺南市,南區,1016,710,268,978,37,1015,2171,46.75%,32.7%,1
臺南市,南區,1017,458,194,652,19,671,1150,58.35%,39.83%,1
臺南市,南區,1018,469,174,643,18,661,1122,58.91%,41.8%,1
臺南市,南區,1019,491,202,693,32,725,1444,50.21%,34%,1
臺南市,南區,1020,591,262,853,29,882,1765,49.97%,33.48%,1
臺南市,南區,1021,550,191,741,27,768,1298,59.17%,42.37%,1
臺南市,南區,1022,598,181,779,29,808,1458,55.42%,41.02%,1
臺南市,南區,1023,675,278,953,20,973,1940,50.15%,34.79%,1
臺南市,南區,1024,580,257,837,31,868,1637,53.02%,35.43%,1
臺南市,南區,1025,261,132,393,9,402,871,46.15%,29.97%,1
臺南市,南區,1026,197,125,322,16,338,589,57.39%,33.45%,1
臺南市,南區,1027,352,155,507,28,535,801,66.79%,43.95%,1
臺南市,南區,1028,428,116,544,32,576,990,58.18%,43.23%,1
臺南市,南區,1029,539,174,713,28,741,1222,60.64%,44.11%,1
臺南市,南區,1030,399,159,558,41,599,997,60.08%,40.02%,1
臺南市,南區,1031,424,173,597,32,629,1204,52.24%,35.22%,1
臺南市,南區,1032,503,235,738,19,757,1570,48.22%,32.04%,1
臺南市,南區,1033,436,210,646,32,678,1222,55.48%,35.68%,1
臺南市,南區,1034,368,152,520,21,541,1076,50.28%,34.2%,1
臺南市,南區,1035,446,171,617,26,643,1127,57.05%,39.57%,1
臺南市,南區,1036,459,159,618,30,648,1135,57.09%,40.44%,1
臺南市,南區,1037,459,181,640,32,672,1263,53.21%,36.34%,1
臺南市,南區,1038,368,149,517,14,531,1014,52.37%,36.29%,1
臺南市,南區,1039,594,209,803,39,842,1491,56.47%,39.84%,1
臺南市,南區,1040,665,287,952,27,979,1815,53.94%,36.64%,1
臺南市,南區,1041,481,220,701,35,736,1398,52.65%,34.41%,1
臺南市,南區,1042,532,246,778,47,825,2107,39.16%,25.25%,1
臺南市,南區,1043,664,242,906,38,944,1587,59.48%,41.84%,1
臺南市,南區,1044,603,242,845,36,881,1626,54.18%,37.08%,1
臺南市,南區,1045,610,234,844,40,884,1761,50.2%,34.64%,1
臺南市,南區,1046,609,239,848,28,876,1630,53.74%,37.36%,1
臺南市,南區,1047,598,206,804,33,837,1542,54.28%,38.78%,1
臺南市,南區,1048,527,217,744,41,785,1464,53.62%,36%,1
臺南市,南區,1049,652,214,866,52,918,1727,53.16%,37.75%,1
臺南市,南區,1050,467,167,634,33,667,1085,61.47%,43.04%,1
臺南市,南區,1051,368,120,488,23,511,939,54.42%,39.19%,1
臺南市,南區,1052,498,162,660,28,688,1419,48.48%,35.1%,1
臺南市,南區,1053,447,187,634,38,672,1333,50.41%,33.53%,1
臺南市,南區,1054,497,213,710,34,744,1465,50.78%,33.92%,1
臺南市,南區,1055,432,155,587,24,611,1099,55.6%,39.31%,1
臺南市,南區,1056,428,136,564,16,580,1133,51.19%,37.78%,1
臺南市,南區,1057,504,171,675,46,721,1375,52.44%,36.65%,1
臺南市,南區,1058,559,254,813,25,838,1781,47.05%,31.39%,1
臺南市,南區,1059,618,237,855,24,879,1542,57%,40.08%,1
臺南市,南區,1060,535,199,734,12,746,1486,50.2%,36%,1
臺南市,南區,1061,644,227,871,42,913,1640,55.67%,39.27%,1
臺南市,南區,1062,544,209,753,20,773,1701,45.44%,31.98%,1
臺南市,南區,1063,551,187,738,33,771,1541,50.03%,35.76%,1
臺南市,南區,1064,712,266,978,51,1029,2027,50.76%,35.13%,1
臺南市,南區,1065,736,270,1006,40,1046,1774,58.96%,41.49%,1
臺南市,南區,1066,602,210,812,35,847,1613,52.51%,37.32%,1
臺南市,南區,1067,610,232,842,18,860,1707,50.38%,35.74%,1
臺南市,南區,1068,424,154,578,24,602,1657,36.33%,25.59%,1
臺南市,南區,1069,430,136,566,18,584,1077,54.22%,39.93%,1
臺南市,南區,1070,465,157,622,15,637,1185,53.76%,39.24%,1
臺南市,南區,1071,465,179,644,17,661,1249,52.92%,37.23%,1
臺南市,南區,1072,662,226,888,15,903,1985,45.49%,33.35%,1
臺南市,南區,1073,626,265,891,28,919,2017,45.56%,31.04%,1
臺南市,南區,1074,613,233,846,37,883,1717,51.43%,35.7%,1
臺南市,南區,1075,374,128,502,22,524,929,56.4%,40.26%,1
臺南市,南區,1076,263,115,378,17,395,695,56.83%,37.84%,1
臺南市,南區,1077,372,116,488,12,500,997,50.15%,37.31%,1
臺南市,南區,1078,293,89,382,17,399,784,50.89%,37.37%,1
臺南市,南區,1079,469,119,588,63,651,1119,58.18%,41.91%,1
臺南市,南區,1080,369,114,483,27,510,1054,48.39%,35.01%,1
臺南市,南區,1081,439,146,585,60,645,1245,51.81%,35.26%,1
臺南市,南區,1082,708,236,944,36,980,2064,47.48%,34.3%,1
臺南市,南區,1083,631,236,867,16,883,2056,42.95%,30.69%,1
臺南市,南區,1084,515,147,662,17,679,1373,49.45%,37.51%,1
臺南市,南區,1085,381,117,498,21,519,1002,51.8%,38.02%,1
臺南市,南區,1086,308,106,414,37,451,760,59.34%,40.53%,1
臺南市,南區,1087,383,136,519,63,582,1031,56.45%,37.15%,1
臺南市,南區,1088,283,105,388,25,413,744,55.51%,38.04%,1
臺南市,南區,1089,435,168,603,46,649,1186,54.72%,36.68%,1
臺南市,南區,1090,524,195,719,29,748,1358,55.08%,38.59%,1
臺南市,南區,1091,303,107,410,28,438,897,48.83%,33.78%,1
臺南市,南區,1092,463,177,640,30,670,1265,52.96%,36.6%,1
臺南市,南區,1093,393,118,511,50,561,1093,51.33%,35.96%,1
臺南市,南區,1094,399,180,579,13,592,1016,58.27%,39.27%,1
臺南市,北區,0850,647,228,875,39,914,1793,50.98%,36.08%,1
臺南市,北區,0851,611,216,827,33,860,1708,50.35%,35.77%,1
臺南市,北區,0852,326,184,510,5,515,997,51.65%,32.7%,1
臺南市,北區,0853,386,255,641,13,654,1452,45.04%,26.58%,1
臺南市,北區,0854,460,221,681,11,692,1351,51.22%,34.05%,1
臺南市,北區,0855,577,231,808,26,834,1323,63.04%,43.61%,1
臺南市,北區,0856,463,155,618,14,632,1073,58.9%,43.15%,1
臺南市,北區,0857,487,177,664,16,680,1138,59.75%,42.79%,1
臺南市,北區,0858,476,149,625,16,641,1189,53.91%,40.03%,1
臺南市,北區,0859,514,233,747,23,770,1262,61.01%,40.73%,1
臺南市,北區,0860,411,188,599,13,612,1017,60.18%,40.41%,1
臺南市,北區,0861,327,141,468,8,476,847,56.2%,38.61%,1
臺南市,北區,0862,468,137,605,20,625,1076,58.09%,43.49%,1
臺南市,北區,0863,391,167,558,11,569,954,59.64%,40.99%,1
臺南市,北區,0864,496,170,666,36,702,1300,54%,38.15%,1
臺南市,北區,0865,540,179,719,21,740,1390,53.24%,38.85%,1
臺南市,北區,0866,555,168,723,18,741,1318,56.22%,42.11%,1
臺南市,北區,0867,374,145,519,7,526,974,54%,38.4%,1
臺南市,北區,0868,386,147,533,11,544,990,54.95%,38.99%,1
臺南市,北區,0869,394,223,617,11,628,1016,61.81%,38.78%,1
臺南市,北區,0870,422,151,573,19,592,1053,56.22%,40.08%,1
臺南市,北區,0871,525,215,740,38,778,1466,53.07%,35.81%,1
臺南市,北區,0872,617,214,831,25,856,1535,55.77%,40.2%,1
臺南市,北區,0873,591,186,777,37,814,1544,52.72%,38.28%,1
臺南市,北區,0874,700,258,958,35,993,1760,56.42%,39.77%,1
臺南市,北區,0875,537,183,720,26,746,1372,54.37%,39.14%,1
臺南市,北區,0876,428,143,571,15,586,1002,58.48%,42.71%,1
臺南市,北區,0877,500,160,660,26,686,1171,58.58%,42.7%,1
臺南市,北區,0878,456,167,623,14,637,1285,49.57%,35.49%,1
臺南市,北區,0879,418,112,530,19,549,1036,52.99%,40.35%,1
臺南市,北區,0880,528,200,728,23,751,1392,53.95%,37.93%,1
臺南市,北區,0881,479,142,621,21,642,1147,55.97%,41.76%,1
臺南市,北區,0882,535,174,709,13,722,1526,47.31%,35.06%,1
臺南市,北區,0883,608,219,827,24,851,1559,54.59%,39%,1
臺南市,北區,0884,358,124,482,34,516,892,57.85%,40.13%,1
臺南市,北區,0885,335,135,470,20,490,937,52.29%,35.75%,1
臺南市,北區,0886,562,234,796,39,835,1449,57.63%,38.79%,1
臺南市,北區,0887,452,157,609,13,622,1160,53.62%,38.97%,1
臺南市,北區,0888,409,173,582,21,603,1567,38.48%,26.1%,1
臺南市,北區,0889,517,192,709,20,729,1346,54.16%,38.41%,1
臺南市,北區,0890,497,208,705,12,717,1451,49.41%,34.25%,1
臺南市,北區,0891,582,217,799,11,810,1522,53.22%,38.24%,1
臺南市,北區,0892,486,175,661,19,680,1278,53.21%,38.03%,1
臺南市,北區,0893,445,145,590,24,614,1164,52.75%,38.23%,1
臺南市,北區,0894,391,162,553,12,565,1091,51.79%,35.84%,1
臺南市,北區,0895,391,128,519,23,542,993,54.58%,39.38%,1
臺南市,北區,0896,418,109,527,14,541,1119,48.35%,37.35%,1
臺南市,北區,0897,610,289,899,31,930,1685,55.19%,36.2%,1
臺南市,北區,0898,512,221,733,11,744,1368,54.39%,37.43%,1
臺南市,北區,0899,498,229,727,30,757,1389,54.5%,35.85%,1
臺南市,北區,0900,572,270,842,12,854,1469,58.13%,38.94%,1
臺南市,北區,0901,614,315,929,26,955,1655,57.7%,37.1%,1
臺南市,北區,0902,488,218,706,13,719,1261,57.02%,38.7%,1
臺南市,北區,0903,440,243,683,12,695,1490,46.64%,29.53%,1
臺南市,北區,0904,550,262,812,20,832,1436,57.94%,38.3%,1
臺南市,北區,0905,558,199,757,36,793,1340,59.18%,41.64%,1
臺南市,北區,0906,521,262,783,23,806,1464,55.05%,35.59%,1
臺南市,北區,0907,582,273,855,20,875,1513,57.83%,38.47%,1
臺南市,北區,0908,610,339,949,24,973,1709,56.93%,35.69%,1
臺南市,北區,0909,587,298,885,24,909,1517,59.92%,38.69%,1
臺南市,北區,0910,566,266,832,19,851,1598,53.25%,35.42%,1
臺南市,北區,0911,455,264,719,26,745,1399,53.25%,32.52%,1
臺南市,北區,0912,464,175,639,30,669,1214,55.11%,38.22%,1
臺南市,北區,0913,393,201,594,10,604,1064,56.77%,36.94%,1
臺南市,北區,0914,453,229,682,23,705,1148,61.41%,39.46%,1
臺南市,北區,0915,552,228,780,25,805,1391,57.87%,39.68%,1
臺南市,北區,0916,624,258,882,22,904,1584,57.07%,39.39%,1
臺南市,北區,0917,613,260,873,19,892,1595,55.92%,38.43%,1
臺南市,北區,0918,526,216,742,22,764,1397,54.69%,37.65%,1
臺南市,北區,0919,599,273,872,21,893,1662,53.73%,36.04%,1
臺南市,北區,0920,561,277,838,13,851,1634,52.08%,34.33%,1
臺南市,北區,0921,715,278,993,24,1017,1793,56.72%,39.88%,1
臺南市,北區,0922,710,296,1006,30,1036,1872,55.34%,37.93%,1
臺南市,北區,0923,691,288,979,40,1019,1874,54.38%,36.87%,1
臺南市,北區,0924,645,236,881,38,919,1760,52.22%,36.65%,1
臺南市,北區,0925,603,262,865,41,906,1753,51.68%,34.4%,1
臺南市,北區,0926,471,212,683,15,698,1502,46.47%,31.36%,1
臺南市,北區,0927,543,238,781,20,801,1470,54.49%,36.94%,1
臺南市,北區,0928,483,197,680,30,710,1319,53.83%,36.62%,1
臺南市,北區,0929,742,283,1025,30,1055,1876,56.24%,39.55%,1
臺南市,北區,0930,613,286,899,12,911,1720,52.97%,35.64%,1
臺南市,安南區,0618,869,444,1313,48,1361,2549,53.39%,34.09%,1
臺南市,安南區,0619,884,307,1191,31,1222,2321,52.65%,38.09%,1
臺南市,安南區,0620,832,318,1150,43,1193,2156,55.33%,38.59%,1
臺南市,安南區,0621,704,226,930,45,975,1662,58.66%,42.36%,1
臺南市,安南區,0622,646,200,846,57,903,1512,59.72%,42.72%,1
臺南市,安南區,0623,599,195,794,32,826,1625,50.83%,36.86%,1
臺南市,安南區,0624,713,276,989,40,1029,2143,48.02%,33.27%,1
臺南市,安南區,0625,1014,267,1281,47,1328,2457,54.05%,41.27%,1
臺南市,安南區,0626,827,327,1154,49,1203,2148,56.01%,38.5%,1
臺南市,安南區,0627,827,355,1182,46,1228,2364,51.95%,34.98%,1
臺南市,安南區,0628,636,269,905,30,935,1868,50.05%,34.05%,1
臺南市,安南區,0629,725,282,1007,42,1049,1797,58.38%,40.35%,1
臺南市,安南區,0630,891,304,1195,33,1228,2268,54.14%,39.29%,1
臺南市,安南區,0631,730,301,1031,36,1067,2291,46.57%,31.86%,1
臺南市,安南區,0632,800,320,1120,38,1158,2255,51.35%,35.48%,1
臺南市,安南區,0633,632,281,913,36,949,1940,48.92%,32.58%,1
臺南市,安南區,0634,791,312,1103,22,1125,2013,55.89%,39.29%,1
臺南市,安南區,0635,738,272,1010,34,1044,2024,51.58%,36.46%,1
臺南市,安南區,0636,632,307,939,46,985,1613,61.07%,39.18%,1
臺南市,安南區,0637,449,150,599,29,628,1178,53.31%,38.12%,1
臺南市,安南區,0638,828,283,1111,46,1157,2143,53.99%,38.64%,1
臺南市,安南區,0639,651,280,931,36,967,1721,56.19%,37.83%,1
臺南市,安南區,0640,688,275,963,49,1012,1773,57.08%,38.8%,1
臺南市,安南區,0641,560,217,777,12,789,1428,55.25%,39.22%,1
臺南市,安南區,0642,654,216,870,24,894,1626,54.98%,40.22%,1
臺南市,安南區,0643,472,231,703,32,735,1358,54.12%,34.76%,1
臺南市,安南區,0644,609,221,830,22,852,1447,58.88%,42.09%,1
臺南市,安南區,0645,527,191,718,56,774,1358,57%,38.81%,1
臺南市,安南區,0646,772,268,1040,25,1065,2116,50.33%,36.48%,1
臺南市,安南區,0647,845,274,1119,21,1140,2321,49.12%,36.41%,1
臺南市,安南區,0648,754,306,1060,31,1091,2117,51.54%,35.62%,1
臺南市,安南區,0649,665,252,917,46,963,1927,49.97%,34.51%,1
臺南市,安南區,0650,774,326,1100,46,1146,2242,51.12%,34.52%,1
臺南市,安南區,0651,821,297,1118,37,1155,2334,49.49%,35.18%,1
臺南市,安南區,0652,676,271,947,46,993,1822,54.5%,37.1%,1
臺南市,安南區,0653,735,256,991,42,1033,1813,56.98%,40.54%,1
臺南市,安南區,0654,806,316,1122,53,1175,2188,53.7%,36.84%,1
臺南市,安南區,0655,848,288,1136,41,1177,2399,49.06%,35.35%,1
臺南市,安南區,0656,736,272,1008,60,1068,2247,47.53%,32.75%,1
臺南市,安南區,0657,505,177,682,46,728,1165,62.49%,43.35%,1
臺南市,安南區,0658,553,201,754,31,785,1539,51.01%,35.93%,1
臺南市,安南區,0659,728,264,992,50,1042,1835,56.78%,39.67%,1
臺南市,安南區,0660,686,229,915,67,982,1797,54.65%,38.17%,1
臺南市,安南區,0661,746,288,1034,63,1097,2223,49.35%,33.56%,1
臺南市,安南區,0662,440,139,579,44,623,977,63.77%,45.04%,1
臺南市,安南區,0663,569,189,758,19,777,1642,47.32%,34.65%,1
臺南市,安南區,0664,668,229,897,43,940,1697,55.39%,39.36%,1
臺南市,安南區,0665,688,244,932,30,962,1966,48.93%,34.99%,1
臺南市,安南區,0666,483,171,654,49,703,1319,53.3%,36.62%,1
臺南市,安南區,0667,627,275,902,32,934,1909,48.93%,32.84%,1
臺南市,安南區,0668,681,225,906,41,947,1763,53.72%,38.63%,1
臺南市,安南區,0669,354,131,485,35,520,965,53.89%,36.68%,1
臺南市,安南區,0670,507,175,682,35,717,1547,46.35%,32.77%,1
臺南市,安南區,0671,637,234,871,41,912,1784,51.12%,35.71%,1
臺南市,安南區,0672,739,270,1009,22,1031,2145,48.07%,34.45%,1
臺南市,安南區,0673,786,496,1282,24,1306,2443,53.46%,32.17%,1
臺南市,安南區,0674,852,266,1118,17,1135,2565,44.25%,33.22%,1
臺南市,安南區,0675,931,326,1257,35,1292,2480,52.1%,37.54%,1
臺南市,安南區,0676,704,299,1003,56,1059,2349,45.08%,29.97%,1
臺南市,安南區,0677,800,322,1122,43,1165,2168,53.74%,36.9%,1
臺南市,安南區,0678,627,195,822,27,849,1630,52.09%,38.47%,1
臺南市,安南區,0679,581,195,776,28,804,1675,48%,34.69%,1
臺南市,安南區,0680,758,225,983,36,1019,1627,62.63%,46.59%,1
臺南市,安南區,0681,622,184,806,21,827,1493,55.39%,41.66%,1
臺南市,安南區,0682,568,192,760,30,790,1397,56.55%,40.66%,1
臺南市,安南區,0683,556,175,731,33,764,1416,53.95%,39.27%,1
臺南市,安南區,0684,561,198,759,25,784,1460,53.7%,38.42%,1
臺南市,安南區,0685,694,292,986,31,1017,2222,45.77%,31.23%,1
臺南市,安南區,0686,753,300,1053,45,1098,2070,53.04%,36.38%,1
臺南市,安南區,0687,693,247,940,27,967,1739,55.61%,39.85%,1
臺南市,安南區,0688,682,217,899,38,937,1830,51.2%,37.27%,1
臺南市,安南區,0689,735,278,1013,43,1056,1803,58.57%,40.77%,1
臺南市,安南區,0690,698,295,993,27,1020,1800,56.67%,38.78%,1
臺南市,安南區,0691,578,233,811,40,851,1815,46.89%,31.85%,1
臺南市,安南區,0692,647,233,880,34,914,1846,49.51%,35.05%,1
臺南市,安南區,0693,401,137,538,20,558,905,61.66%,44.31%,1
臺南市,安南區,0694,464,177,641,30,671,1073,62.53%,43.24%,1
臺南市,安南區,0695,668,199,867,49,916,1579,58.01%,42.31%,1
臺南市,安南區,0696,685,216,901,74,975,1876,51.97%,36.51%,1
臺南市,安南區,0697,423,169,592,29,621,1194,52.01%,35.43%,1
臺南市,安南區,0698,455,146,601,21,622,1475,42.17%,30.85%,1
臺南市,安南區,0699,528,154,682,25,707,1380,51.23%,38.26%,1
臺南市,安南區,0700,217,501,718,27,745,1462,50.96%,14.84%,1
臺南市,安南區,0701,453,135,588,29,617,1044,59.1%,43.39%,1
臺南市,安南區,0702,262,98,360,35,395,603,65.51%,43.45%,1
臺南市,安南區,0703,285,96,381,18,399,690,57.83%,41.3%,1
臺南市,安南區,0704,471,214,685,38,723,1447,49.97%,32.55%,1
臺南市,安南區,0705,436,130,566,32,598,910,65.71%,47.91%,1
臺南市,安南區,0706,670,206,876,37,913,1850,49.35%,36.22%,1
臺南市,安南區,0707,651,209,860,31,891,1501,59.36%,43.37%,1
臺南市,安平區,0983,661,264,925,47,972,1753,55.45%,37.71%,1
臺南市,安平區,0984,639,291,930,31,961,1859,51.69%,34.37%,1
臺南市,安平區,0985,574,213,787,22,809,1382,58.54%,41.53%,1
臺南市,安平區,0986,878,361,1239,45,1284,2547,50.41%,34.47%,1
臺南市,安平區,0987,838,384,1222,37,1259,2407,52.31%,34.82%,1
臺南市,安平區,0988,624,325,949,35,984,2070,47.54%,30.14%,1
臺南市,安平區,0989,742,367,1109,29,1138,2132,53.38%,34.8%,1
臺南市,安平區,0990,547,239,786,20,806,1450,55.59%,37.72%,1
臺南市,安平區,0991,543,252,795,26,821,1605,51.15%,33.83%,1
臺南市,安平區,0992,650,262,912,34,946,1755,53.9%,37.04%,1
臺南市,安平區,0993,540,248,788,32,820,1728,47.45%,31.25%,1
臺南市,安平區,0994,502,239,741,18,759,1754,43.27%,28.62%,1
臺南市,安平區,0995,562,264,826,46,872,1686,51.72%,33.33%,1
臺南市,安平區,0996,692,276,968,31,999,1843,54.21%,37.55%,1
臺南市,安平區,0997,615,253,868,21,889,1565,56.81%,39.3%,1
臺南市,安平區,0998,491,196,687,28,715,1288,55.51%,38.12%,1
臺南市,安平區,0999,517,281,798,22,820,1653,49.61%,31.28%,1
臺南市,安平區,1000,579,228,807,33,840,1697,49.5%,34.12%,1
臺南市,安平區,1001,692,298,990,28,1018,2154,47.26%,32.13%,1
臺南市,安平區,1002,717,278,995,36,1031,2107,48.93%,34.03%,1
臺南市,安平區,1003,589,289,878,50,928,1675,55.4%,35.16%,1
臺南市,安平區,1004,648,344,992,46,1038,1979,52.45%,32.74%,1
臺南市,安平區,1005,531,246,777,22,799,1602,49.88%,33.15%,1
臺南市,安平區,1006,523,256,779,27,806,1586,50.82%,32.98%,1
臺南市,安平區,1007,151,51,202,9,211,438,48.17%,34.47%,1
臺南市,安平區,1008,577,282,859,43,902,1780,50.67%,32.42%,1
臺南市,安平區,1009,529,244,773,41,814,1623,50.15%,32.59%,1
臺南市,安平區,1010,757,277,1034,35,1069,2157,49.56%,35.1%,1
臺南市,安平區,1011,466,169,635,41,676,1286,52.57%,36.24%,1
臺南市,安平區,1012,529,193,722,66,788,1492,52.82%,35.46%,1
臺南市,安平區,1013,453,152,605,33,638,1325,48.15%,34.19%,1
臺南市,安平區,1014,697,251,948,44,992,2001,49.58%,34.83%,1
臺南市,中西區,0931,483,231,714,26,740,1332,55.56%,36.26%,1
臺南市,中西區,0932,520,177,697,29,726,1246,58.27%,41.73%,1
臺南市,中西區,0933,472,169,641,37,678,1276,53.13%,36.99%,1
臺南市,中西區,0934,598,289,887,23,910,1583,57.49%,37.78%,1
臺南市,中西區,0935,534,287,821,19,840,1464,57.38%,36.48%,1
臺南市,中西區,0936,423,218,641,15,656,1234,53.16%,34.28%,1
臺南市,中西區,0937,530,237,767,23,790,1368,57.75%,38.74%,1
臺南市,中西區,0938,470,182,652,18,670,1322,50.68%,35.55%,1
臺南市,中西區,0939,421,192,613,32,645,1216,53.04%,34.62%,1
臺南市,中西區,0940,485,191,676,25,701,1289,54.38%,37.63%,1
臺南市,中西區,0941,513,173,686,21,707,1237,57.15%,41.47%,1
臺南市,中西區,0942,415,156,571,21,592,1189,49.79%,34.9%,1
臺南市,中西區,0943,471,185,656,30,686,1201,57.12%,39.22%,1
臺南市,中西區,0944,438,159,597,41,638,1065,59.91%,41.13%,1
臺南市,中西區,0945,433,163,596,25,621,1055,58.86%,41.04%,1
臺南市,中西區,0946,471,233,704,14,718,1170,61.37%,40.26%,1
臺南市,中西區,0947,568,214,782,19,801,1280,62.58%,44.38%,1
臺南市,中西區,0948,450,226,676,21,697,1223,56.99%,36.79%,1
臺南市,中西區,0949,537,191,728,35,763,1292,59.06%,41.56%,1
臺南市,中西區,0950,395,185,580,12,592,993,59.62%,39.78%,1
臺南市,中西區,0951,567,260,827,30,857,1541,55.61%,36.79%,1
臺南市,中西區,0952,668,289,957,39,996,1652,60.29%,40.44%,1
臺南市,中西區,0953,465,204,669,20,689,1212,56.85%,38.37%,1
臺南市,中西區,0954,617,277,894,30,924,1621,57%,38.06%,1
臺南市,中西區,0955,593,336,929,18,947,1660,57.05%,35.72%,1
臺南市,中西區,0956,609,240,849,18,867,1595,54.36%,38.18%,1
臺南市,中西區,0957,538,213,751,19,770,1436,53.62%,37.47%,1
臺南市,中西區,0958,487,200,687,40,727,1265,57.47%,38.5%,1
臺南市,中西區,0959,384,138,522,11,533,856,62.27%,44.86%,1
臺南市,中西區,0960,430,172,602,25,627,1168,53.68%,36.82%,1
臺南市,中西區,0961,437,207,644,24,668,1134,58.91%,38.54%,1
臺南市,中西區,0962,429,173,602,25,627,995,63.02%,43.12%,1
臺南市,中西區,0963,582,206,788,24,812,1313,61.84%,44.33%,1
臺南市,中西區,0964,501,229,730,28,758,1265,59.92%,39.6%,1
臺南市,中西區,0965,439,191,630,20,650,1215,53.5%,36.13%,1
臺南市,中西區,0966,480,188,668,23,691,1248,55.37%,38.46%,1
臺南市,中西區,0967,244,120,364,18,382,687,55.6%,35.52%,1
臺南市,中西區,0968,431,176,607,34,641,1139,56.28%,37.84%,1
臺南市,中西區,0969,399,145,544,23,567,971,58.39%,41.09%,1
臺南市,中西區,0970,393,128,521,31,552,1254,44.02%,31.34%,1
臺南市,中西區,0971,411,148,559,23,582,979,59.45%,41.98%,1
臺南市,中西區,0972,633,245,878,31,909,1745,52.09%,36.28%,1
臺南市,中西區,0973,421,149,570,23,593,1074,55.21%,39.2%,1
臺南市,中西區,0974,503,204,707,22,729,1436,50.77%,35.03%,1
臺南市,中西區,0975,317,149,466,35,501,865,57.92%,36.65%,1
臺南市,中西區,0976,449,172,621,17,638,1164,54.81%,38.57%,1
臺南市,中西區,0977,444,194,638,22,660,1285,51.36%,34.55%,1
臺南市,中西區,0978,417,148,565,29,594,1078,55.1%,38.68%,1
臺南市,中西區,0979,591,209,800,20,820,1704,48.12%,34.68%,1
臺南市,中西區,0980,553,176,729,30,759,1296,58.56%,42.67%,1
臺南市,中西區,0981,429,181,610,25,635,1128,56.29%,38.03%,1
臺南市,中西區,0982,459,213,672,18,690,1245,55.42%,36.87%,1
高雄市,鹽埕區,0845,550,262,812,26,838,1304,64.26%,42.18%,1
高雄市,鹽埕區,0846,171,52,223,7,230,357,64.43%,47.9%,1
高雄市,鹽埕區,0847,290,107,397,14,411,651,63.13%,44.55%,1
高雄市,鹽埕區,0848,512,182,694,17,711,1322,53.78%,38.73%,1
高雄市,鹽埕區,0849,438,206,644,15,659,1056,62.41%,41.48%,1
高雄市,鹽埕區,0850,377,198,575,9,584,904,64.6%,41.7%,1
高雄市,鹽埕區,0851,466,190,656,20,676,1130,59.82%,41.24%,1
高雄市,鹽埕區,0852,387,136,523,16,539,840,64.17%,46.07%,1
高雄市,鹽埕區,0853,299,127,426,15,441,616,71.59%,48.54%,1
高雄市,鹽埕區,0854,486,249,735,19,754,1397,53.97%,34.79%,1
高雄市,鹽埕區,0855,318,141,459,9,468,766,61.1%,41.51%,1
高雄市,鹽埕區,0856,343,157,500,22,522,839,62.22%,40.88%,1
高雄市,鹽埕區,0857,370,136,506,13,519,805,64.47%,45.96%,1
高雄市,鹽埕區,0858,309,126,435,9,444,750,59.2%,41.2%,1
高雄市,鹽埕區,0859,502,67,569,13,582,986,59.03%,50.91%,1
高雄市,鹽埕區,0860,438,166,604,7,611,1068,57.21%,41.01%,1
高雄市,鹽埕區,0861,414,197,611,26,637,1060,60.09%,39.06%,1
高雄市,鹽埕區,0862,320,132,452,16,468,805,58.14%,39.75%,1
高雄市,鹽埕區,0863,418,159,577,8,585,1073,54.52%,38.96%,1
高雄市,鹽埕區,0864,348,135,483,17,500,921,54.29%,37.79%,1
高雄市,鹽埕區,0865,470,190,660,19,679,1171,57.98%,40.14%,1
高雄市,鹽埕區,0866,234,119,353,7,360,594,60.61%,39.39%,1
高雄市,鹽埕區,0867,275,93,368,12,380,592,64.19%,46.45%,1
高雄市,鹽埕區,0868,234,99,333,10,343,610,56.23%,38.36%,1
高雄市,鼓山區,0768,399,134,533,11,544,959,56.73%,41.61%,1
高雄市,鼓山區,0769,471,177,648,23,671,1000,67.1%,47.1%,1
高雄市,鼓山區,0770,428,117,545,17,562,910,61.76%,47.03%,1
高雄市,鼓山區,0771,529,160,689,27,716,1085,65.99%,48.76%,1
高雄市,鼓山區,0772,580,189,769,20,789,1484,53.17%,39.08%,1
高雄市,鼓山區,0773,636,196,832,27,859,1393,61.67%,45.66%,1
高雄市,鼓山區,0774,609,218,827,31,858,1270,67.56%,47.95%,1
高雄市,鼓山區,0775,471,154,625,21,646,1055,61.23%,44.64%,1
高雄市,鼓山區,0776,506,181,687,14,701,1172,59.81%,43.17%,1
高雄市,鼓山區,0777,562,175,737,33,770,1175,65.53%,47.83%,1
高雄市,鼓山區,0778,594,178,772,26,798,1274,62.64%,46.62%,1
高雄市,鼓山區,0779,416,155,571,19,590,1085,54.38%,38.34%,1
高雄市,鼓山區,0780,605,229,834,30,864,1470,58.78%,41.16%,1
高雄市,鼓山區,0781,455,171,626,27,653,974,67.04%,46.71%,1
高雄市,鼓山區,0782,563,200,763,37,800,1275,62.75%,44.16%,1
高雄市,鼓山區,0783,529,184,713,30,743,1206,61.61%,43.86%,1
高雄市,鼓山區,0784,551,201,752,17,769,1238,62.12%,44.51%,1
高雄市,鼓山區,0785,408,82,490,9,499,721,69.21%,56.59%,1
高雄市,鼓山區,0786,510,174,684,16,700,1220,57.38%,41.8%,1
高雄市,鼓山區,0787,738,274,1012,31,1043,1966,53.05%,37.54%,1
高雄市,鼓山區,0788,725,251,976,25,1001,1722,58.13%,42.1%,1
高雄市,鼓山區,0789,710,245,955,24,979,1720,56.92%,41.28%,1
高雄市,鼓山區,0790,563,214,777,59,836,1287,64.96%,43.75%,1
高雄市,鼓山區,0791,434,190,624,14,638,1369,46.6%,31.7%,1
高雄市,鼓山區,0792,581,189,770,18,788,1222,64.48%,47.55%,1
高雄市,鼓山區,0793,780,258,1038,29,1067,1770,60.28%,44.07%,1
高雄市,鼓山區,0794,702,328,1030,27,1057,1860,56.83%,37.74%,1
高雄市,鼓山區,0795,748,326,1074,22,1096,1857,59.02%,40.28%,1
高雄市,鼓山區,0796,758,336,1094,18,1112,1841,60.4%,41.17%,1
高雄市,鼓山區,0797,771,327,1098,37,1135,1830,62.02%,42.13%,1
高雄市,鼓山區,0798,752,305,1057,32,1089,1809,60.2%,41.57%,1
高雄市,鼓山區,0799,702,439,1141,35,1176,1894,62.09%,37.06%,1
高雄市,鼓山區,0800,779,370,1149,14,1163,1882,61.8%,41.39%,1
高雄市,鼓山區,0801,767,410,1177,39,1216,1894,64.2%,40.5%,1
高雄市,鼓山區,0802,716,276,992,21,1013,1745,58.05%,41.03%,1
高雄市,鼓山區,0803,697,376,1073,10,1083,1887,57.39%,36.94%,1
高雄市,鼓山區,0804,804,410,1214,24,1238,1891,65.47%,42.52%,1
高雄市,鼓山區,0805,787,366,1153,22,1175,1903,61.74%,41.36%,1
高雄市,鼓山區,0806,755,453,1208,20,1228,1998,61.46%,37.79%,1
高雄市,鼓山區,0807,806,351,1157,24,1181,1912,61.77%,42.15%,1
高雄市,鼓山區,0808,812,367,1179,30,1209,1923,62.87%,42.23%,1
高雄市,鼓山區,0809,785,394,1179,21,1200,1888,63.56%,41.58%,1
高雄市,鼓山區,0810,798,367,1165,14,1179,1873,62.95%,42.61%,1
高雄市,鼓山區,0811,856,438,1294,20,1314,1959,67.08%,43.7%,1
高雄市,鼓山區,0812,828,390,1218,25,1243,1897,65.52%,43.65%,1
高雄市,鼓山區,0813,948,408,1356,23,1379,2362,58.38%,40.14%,1
高雄市,鼓山區,0814,841,307,1148,19,1167,1850,63.08%,45.46%,1
高雄市,鼓山區,0815,824,369,1193,22,1215,1928,63.02%,42.74%,1
高雄市,鼓山區,0816,794,312,1106,17,1123,1937,57.98%,40.99%,1
高雄市,鼓山區,0817,858,368,1226,32,1258,2123,59.26%,40.41%,1
高雄市,鼓山區,0818,822,324,1146,23,1169,1861,62.82%,44.17%,1
高雄市,鼓山區,0819,783,333,1116,19,1135,1892,59.99%,41.38%,1
高雄市,鼓山區,0820,857,410,1267,28,1295,2147,60.32%,39.92%,1
高雄市,鼓山區,0821,850,322,1172,15,1187,1897,62.57%,44.81%,1
高雄市,鼓山區,0822,842,378,1220,27,1247,2041,61.1%,41.25%,1
高雄市,鼓山區,0823,575,184,759,34,793,1309,60.58%,43.93%,1
高雄市,鼓山區,0824,813,299,1112,29,1141,1867,61.11%,43.55%,1
高雄市,鼓山區,0825,554,214,768,16,784,1152,68.06%,48.09%,1
高雄市,鼓山區,0826,646,229,875,37,912,1404,64.96%,46.01%,1
高雄市,鼓山區,0827,436,112,548,25,573,1210,47.36%,36.03%,1
高雄市,鼓山區,0828,502,174,676,32,708,1135,62.38%,44.23%,1
高雄市,鼓山區,0829,469,166,635,49,684,1831,37.36%,25.61%,1
高雄市,鼓山區,0830,554,181,735,41,776,1288,60.25%,43.01%,1
高雄市,鼓山區,0831,542,164,706,24,730,1241,58.82%,43.67%,1
高雄市,鼓山區,0832,573,229,802,28,830,1342,61.85%,42.7%,1
高雄市,鼓山區,0833,641,205,846,37,883,1422,62.1%,45.08%,1
高雄市,鼓山區,0834,650,220,870,62,932,1453,64.14%,44.74%,1
高雄市,鼓山區,0835,300,87,387,18,405,616,65.75%,48.7%,1
高雄市,鼓山區,0836,368,115,483,35,518,834,62.11%,44.12%,1
高雄市,鼓山區,0837,427,132,559,24,583,969,60.17%,44.07%,1
高雄市,鼓山區,0838,433,140,573,30,603,978,61.66%,44.27%,1
高雄市,鼓山區,0839,346,128,474,32,506,760,66.58%,45.53%,1
高雄市,鼓山區,0840,530,188,718,38,756,1248,60.58%,42.47%,1
高雄市,鼓山區,0841,456,165,621,22,643,1143,56.26%,39.9%,1
高雄市,鼓山區,0842,539,170,709,32,741,1358,54.57%,39.69%,1
高雄市,鼓山區,0843,421,133,554,11,565,1036,54.54%,40.64%,1
高雄市,鼓山區,0844,265,75,340,6,346,580,59.66%,45.69%,1
高雄市,左營區,0534,665,217,882,35,917,2604,35.22%,25.54%,1
高雄市,左營區,0535,446,167,613,35,648,1037,62.49%,43.01%,1
高雄市,左營區,0536,256,81,337,24,361,542,66.61%,47.23%,1
高雄市,左營區,0537,289,87,376,24,400,635,62.99%,45.51%,1
高雄市,左營區,0538,210,59,269,8,277,518,53.47%,40.54%,1
高雄市,左營區,0539,359,109,468,28,496,813,61.01%,44.16%,1
高雄市,左營區,0540,384,125,509,46,555,889,62.43%,43.19%,1
高雄市,左營區,0541,329,99,428,43,471,731,64.43%,45.01%,1
高雄市,左營區,0542,626,216,842,29,871,1592,54.71%,39.32%,1
高雄市,左營區,0543,760,227,987,28,1015,1709,59.39%,44.47%,1
高雄市,左營區,0544,728,170,898,36,934,1588,58.82%,45.84%,1
高雄市,左營區,0545,182,27,209,6,215,358,60.06%,50.84%,1
高雄市,左營區,0546,392,55,447,10,457,666,68.62%,58.86%,1
高雄市,左營區,0547,765,145,910,28,938,1748,53.66%,43.76%,1
高雄市,左營區,0548,570,169,739,28,767,1196,64.13%,47.66%,1
高雄市,左營區,0549,582,199,781,23,804,1240,64.84%,46.94%,1
高雄市,左營區,0550,692,155,847,30,877,1402,62.55%,49.36%,1
高雄市,左營區,0551,615,110,725,23,748,1173,63.77%,52.43%,1
高雄市,左營區,0552,344,96,440,21,461,641,71.92%,53.67%,1
高雄市,左營區,0553,419,157,576,28,604,951,63.51%,44.06%,1
高雄市,左營區,0554,302,119,421,25,446,732,60.93%,41.26%,1
高雄市,左營區,0555,141,46,187,10,197,339,58.11%,41.59%,1
高雄市,左營區,0556,251,68,319,11,330,519,63.58%,48.36%,1
高雄市,左營區,0557,230,86,316,26,342,514,66.54%,44.75%,1
高雄市,左營區,0558,341,89,430,36,466,720,64.72%,47.36%,1
高雄市,左營區,0559,196,55,251,18,269,411,65.45%,47.69%,1
高雄市,左營區,0560,276,101,377,26,403,603,66.83%,45.77%,1
高雄市,左營區,0561,390,148,538,37,575,904,63.61%,43.14%,1
高雄市,左營區,0562,564,137,701,25,726,1318,55.08%,42.79%,1
高雄市,左營區,0563,382,145,527,22,549,966,56.83%,39.54%,1
高雄市,左營區,0564,628,194,822,27,849,1440,58.96%,43.61%,1
高雄市,左營區,0565,863,223,1086,25,1111,1990,55.83%,43.37%,1
高雄市,左營區,0566,543,129,672,20,692,1090,63.49%,49.82%,1
高雄市,左營區,0567,637,127,764,38,802,1272,63.05%,50.08%,1
高雄市,左營區,0568,698,286,984,20,1004,1558,64.44%,44.8%,1
高雄市,左營區,0569,659,291,950,18,968,1501,64.49%,43.9%,1
高雄市,左營區,0570,174,69,243,6,249,360,69.17%,48.33%,1
高雄市,左營區,0571,640,135,775,36,811,1335,60.75%,47.94%,1
高雄市,左營區,0572,621,181,802,20,822,1359,60.49%,45.7%,1
高雄市,左營區,0573,699,221,920,23,943,1487,63.42%,47.01%,1
高雄市,左營區,0574,739,179,918,49,967,1637,59.07%,45.14%,1
高雄市,左營區,0575,699,276,975,23,998,1553,64.26%,45.01%,1
高雄市,左營區,0576,692,291,983,35,1018,1564,65.09%,44.25%,1
高雄市,左營區,0577,801,336,1137,34,1171,1788,65.49%,44.8%,1
高雄市,左營區,0578,838,363,1201,50,1251,2028,61.69%,41.32%,1
高雄市,左營區,0579,750,370,1120,39,1159,2037,56.9%,36.82%,1
高雄市,左營區,0580,894,392,1286,23,1309,2101,62.3%,42.55%,1
高雄市,左營區,0581,884,359,1243,32,1275,2018,63.18%,43.81%,1
高雄市,左營區,0582,875,363,1238,35,1273,1925,66.13%,45.45%,1
高雄市,左營區,0583,801,353,1154,22,1176,1989,59.13%,40.27%,1
高雄市,左營區,0584,730,271,1001,20,1021,1780,57.36%,41.01%,1
高雄市,左營區,0585,754,333,1087,16,1103,1778,62.04%,42.41%,1
高雄市,左營區,0586,645,257,902,19,921,1496,61.56%,43.11%,1
高雄市,左營區,0587,662,290,952,21,973,1538,63.26%,43.04%,1
高雄市,左營區,0588,878,376,1254,23,1277,2058,62.05%,42.66%,1
高雄市,左營區,0589,829,370,1199,26,1225,1992,61.5%,41.62%,1
高雄市,左營區,0590,824,427,1251,32,1283,2058,62.34%,40.04%,1
高雄市,左營區,0591,849,402,1251,31,1282,2090,61.34%,40.62%,1
高雄市,左營區,0592,889,409,1298,16,1314,2157,60.92%,41.21%,1
高雄市,左營區,0593,902,381,1283,30,1313,2096,62.64%,43.03%,1
高雄市,左營區,0594,880,419,1299,38,1337,2101,63.64%,41.88%,1
高雄市,左營區,0595,730,240,970,36,1006,1649,61.01%,44.27%,1
高雄市,左營區,0596,679,211,890,32,922,1516,60.82%,44.79%,1
高雄市,左營區,0597,771,277,1048,31,1079,1678,64.3%,45.95%,1
高雄市,左營區,0598,752,400,1152,23,1175,1898,61.91%,39.62%,1
高雄市,左營區,0599,752,361,1113,29,1142,1837,62.17%,40.94%,1
高雄市,左營區,0600,802,291,1093,21,1114,1922,57.96%,41.73%,1
高雄市,左營區,0601,783,324,1107,29,1136,1785,63.64%,43.87%,1
高雄市,左營區,0602,796,310,1106,16,1122,1886,59.49%,42.21%,1
高雄市,左營區,0603,815,378,1193,24,1217,1895,64.22%,43.01%,1
高雄市,左營區,0604,788,329,1117,32,1149,1831,62.75%,43.04%,1
高雄市,左營區,0605,852,342,1194,32,1226,2050,59.8%,41.56%,1
高雄市,左營區,0606,1034,431,1465,27,1492,2251,66.28%,45.94%,1
高雄市,左營區,0607,974,409,1383,22,1405,2126,66.09%,45.81%,1
高雄市,左營區,0608,831,293,1124,18,1142,1928,59.23%,43.1%,1
高雄市,左營區,0609,902,401,1303,31,1334,2166,61.59%,41.64%,1
高雄市,左營區,0610,866,330,1196,24,1220,2031,60.07%,42.64%,1
高雄市,左營區,0611,886,328,1214,20,1234,1987,62.1%,44.59%,1
高雄市,左營區,0612,1062,302,1364,19,1383,2166,63.85%,49.03%,1
高雄市,左營區,0613,793,343,1136,28,1164,1856,62.72%,42.73%,1
高雄市,左營區,0614,978,439,1417,23,1440,2289,62.91%,42.73%,1
高雄市,左營區,0615,862,320,1182,26,1208,1973,61.23%,43.69%,1
高雄市,左營區,0616,759,329,1088,40,1128,1818,62.05%,41.75%,1
高雄市,左營區,0617,645,273,918,16,934,1565,59.68%,41.21%,1
高雄市,左營區,0618,741,305,1046,22,1068,1608,66.42%,46.08%,1
高雄市,左營區,0619,795,354,1149,25,1174,1812,64.79%,43.87%,1
高雄市,左營區,0620,754,298,1052,12,1064,1821,58.43%,41.41%,1
高雄市,左營區,0621,831,331,1162,30,1192,1907,62.51%,43.58%,1
高雄市,左營區,0622,776,276,1052,15,1067,1812,58.89%,42.83%,1
高雄市,左營區,0623,826,328,1154,24,1178,1833,64.27%,45.06%,1
高雄市,左營區,0624,779,347,1126,58,1184,1850,64%,42.11%,1
高雄市,左營區,0625,755,273,1028,22,1050,1738,60.41%,43.44%,1
高雄市,左營區,0626,852,341,1193,28,1221,1864,65.5%,45.71%,1
高雄市,左營區,0627,855,323,1178,22,1200,1887,63.59%,45.31%,1
高雄市,左營區,0628,702,356,1058,18,1076,1870,57.54%,37.54%,1
高雄市,左營區,0629,795,329,1124,17,1141,1866,61.15%,42.6%,1
高雄市,左營區,0630,783,331,1114,11,1125,1862,60.42%,42.05%,1
高雄市,左營區,0631,808,302,1110,21,1131,1816,62.28%,44.49%,1
高雄市,左營區,0632,841,302,1143,23,1166,1833,63.61%,45.88%,1
高雄市,左營區,0633,753,287,1040,22,1062,1676,63.37%,44.93%,1
高雄市,左營區,0634,814,294,1108,31,1139,1843,61.8%,44.17%,1
高雄市,左營區,0635,824,333,1157,20,1177,1872,62.87%,44.02%,1
高雄市,左營區,0636,1002,329,1331,24,1355,2259,59.98%,44.36%,1
高雄市,楠梓區,0435,611,200,811,28,839,1309,64.09%,46.68%,1
高雄市,楠梓區,0436,594,260,854,22,876,1408,62.22%,42.19%,1
高雄市,楠梓區,0437,782,285,1067,33,1100,1851,59.43%,42.25%,1
高雄市,楠梓區,0438,700,264,964,28,992,1578,62.86%,44.36%,1
高雄市,楠梓區,0439,661,339,1000,25,1025,1715,59.77%,38.54%,1
高雄市,楠梓區,0440,661,249,910,16,926,1611,57.48%,41.03%,1
高雄市,楠梓區,0441,1010,74,1084,29,1113,2024,54.99%,49.9%,1
高雄市,楠梓區,0442,699,307,1006,20,1026,1890,54.29%,36.98%,1
高雄市,楠梓區,0443,635,280,915,18,933,1762,52.95%,36.04%,1
高雄市,楠梓區,0444,744,282,1026,20,1046,1888,55.4%,39.41%,1
高雄市,楠梓區,0445,723,289,1012,26,1038,1822,56.97%,39.68%,1
高雄市,楠梓區,0446,706,318,1024,22,1046,1846,56.66%,38.24%,1
高雄市,楠梓區,0447,556,214,770,37,807,1268,63.64%,43.85%,1
高雄市,楠梓區,0448,574,216,790,26,816,1240,65.81%,46.29%,1
高雄市,楠梓區,0449,627,252,879,15,894,1432,62.43%,43.78%,1
高雄市,楠梓區,0450,627,248,875,31,906,1490,60.81%,42.08%,1
高雄市,楠梓區,0451,693,213,906,24,930,1464,63.52%,47.34%,1
高雄市,楠梓區,0452,579,200,779,42,821,1435,57.21%,40.35%,1
高雄市,楠梓區,0453,658,218,876,26,902,1602,56.3%,41.07%,1
高雄市,楠梓區,0454,627,224,851,14,865,1500,57.67%,41.8%,1
高雄市,楠梓區,0455,638,253,891,35,926,1591,58.2%,40.1%,1
高雄市,楠梓區,0456,441,198,639,28,667,1669,39.96%,26.42%,1
高雄市,楠梓區,0457,626,253,879,30,909,1469,61.88%,42.61%,1
高雄市,楠梓區,0458,605,250,855,42,897,1559,57.54%,38.81%,1
高雄市,楠梓區,0459,622,206,828,52,880,1638,53.72%,37.97%,1
高雄市,楠梓區,0460,815,321,1136,48,1184,1960,60.41%,41.58%,1
高雄市,楠梓區,0461,770,325,1095,55,1150,1912,60.15%,40.27%,1
高雄市,楠梓區,0462,678,206,884,21,905,1559,58.05%,43.49%,1
高雄市,楠梓區,0463,556,227,783,26,809,1423,56.85%,39.07%,1
高雄市,楠梓區,0464,686,287,973,22,995,1696,58.67%,40.45%,1
高雄市,楠梓區,0465,615,211,826,64,890,1493,59.61%,41.19%,1
高雄市,楠梓區,0466,635,231,866,58,924,1527,60.51%,41.58%,1
高雄市,楠梓區,0467,463,153,616,31,647,1020,63.43%,45.39%,1
高雄市,楠梓區,0468,493,189,682,51,733,1197,61.24%,41.19%,1
高雄市,楠梓區,0469,594,233,827,32,859,1528,56.22%,38.87%,1
高雄市,楠梓區,0470,674,279,953,43,996,1918,51.93%,35.14%,1
高雄市,楠梓區,0471,596,227,823,53,876,1458,60.08%,40.88%,1
高雄市,楠梓區,0472,791,281,1072,34,1106,1790,61.79%,44.19%,1
高雄市,楠梓區,0473,824,281,1105,49,1154,1845,62.55%,44.66%,1
高雄市,楠梓區,0474,868,342,1210,40,1250,2037,61.36%,42.61%,1
高雄市,楠梓區,0475,767,312,1079,32,1111,1964,56.57%,39.05%,1
高雄市,楠梓區,0476,834,320,1154,14,1168,2006,58.23%,41.58%,1
高雄市,楠梓區,0477,790,304,1094,27,1121,1951,57.46%,40.49%,1
高雄市,楠梓區,0478,753,309,1062,46,1108,1951,56.79%,38.6%,1
高雄市,楠梓區,0479,866,297,1163,36,1199,2008,59.71%,43.13%,1
高雄市,楠梓區,0480,860,267,1127,43,1170,1923,60.84%,44.72%,1
高雄市,楠梓區,0481,794,331,1125,28,1153,1921,60.02%,41.33%,1
高雄市,楠梓區,0482,404,142,546,26,572,832,68.75%,48.56%,1
高雄市,楠梓區,0483,480,189,669,25,694,1156,60.03%,41.52%,1
高雄市,楠梓區,0484,492,194,686,40,726,1125,64.53%,43.73%,1
高雄市,楠梓區,0485,468,190,658,32,690,1060,65.09%,44.15%,1
高雄市,楠梓區,0486,664,233,897,34,931,1502,61.98%,44.21%,1
高雄市,楠梓區,0487,586,218,804,54,858,1404,61.11%,41.74%,1
高雄市,楠梓區,0488,561,221,782,46,828,1552,53.35%,36.15%,1
高雄市,楠梓區,0489,603,211,814,30,844,1460,57.81%,41.3%,1
高雄市,楠梓區,0490,563,136,699,30,729,1315,55.44%,42.81%,1
高雄市,楠梓區,0491,477,158,635,38,673,1062,63.37%,44.92%,1
高雄市,楠梓區,0492,484,149,633,32,665,1078,61.69%,44.9%,1
高雄市,楠梓區,0493,441,132,573,43,616,914,67.4%,48.25%,1
高雄市,楠梓區,0494,515,157,672,37,709,1064,66.64%,48.4%,1
高雄市,楠梓區,0495,757,308,1065,34,1099,1705,64.46%,44.4%,1
高雄市,楠梓區,0496,759,254,1013,50,1063,1728,61.52%,43.92%,1
高雄市,楠梓區,0497,835,300,1135,24,1159,1917,60.46%,43.56%,1
高雄市,楠梓區,0498,660,142,802,36,838,1439,58.23%,45.87%,1
高雄市,楠梓區,0499,597,191,788,35,823,1287,63.95%,46.39%,1
高雄市,楠梓區,0500,700,240,940,30,970,1504,64.49%,46.54%,1
高雄市,楠梓區,0501,676,226,902,29,931,1405,66.26%,48.11%,1
高雄市,楠梓區,0502,565,190,755,39,794,1287,61.69%,43.9%,1
高雄市,楠梓區,0503,567,212,779,29,808,1295,62.39%,43.78%,1
高雄市,楠梓區,0504,644,251,895,35,930,1483,62.71%,43.43%,1
高雄市,楠梓區,0505,811,264,1075,26,1101,1649,66.77%,49.18%,1
高雄市,楠梓區,0506,454,177,631,23,654,998,65.53%,45.49%,1
高雄市,楠梓區,0507,485,182,667,37,704,1025,68.68%,47.32%,1
高雄市,楠梓區,0508,778,298,1076,31,1107,1671,66.25%,46.56%,1
高雄市,楠梓區,0509,689,219,908,48,956,1453,65.79%,47.42%,1
高雄市,楠梓區,0510,737,250,987,46,1033,1673,61.75%,44.05%,1
高雄市,楠梓區,0511,663,284,947,47,994,1653,60.13%,40.11%,1
高雄市,楠梓區,0512,456,158,614,28,642,1034,62.09%,44.1%,1
高雄市,楠梓區,0513,518,220,738,39,777,1127,68.94%,45.96%,1
高雄市,楠梓區,0514,632,254,886,36,922,1575,58.54%,40.13%,1
高雄市,楠梓區,0515,643,244,887,23,910,1559,58.37%,41.24%,1
高雄市,楠梓區,0516,585,210,795,20,815,1378,59.14%,42.45%,1
高雄市,楠梓區,0517,790,239,1029,33,1062,1714,61.96%,46.09%,1
高雄市,楠梓區,0518,806,232,1038,32,1070,1721,62.17%,46.83%,1
高雄市,楠梓區,0519,731,236,967,46,1013,1628,62.22%,44.9%,1
高雄市,楠梓區,0520,760,276,1036,42,1078,1590,67.8%,47.8%,1
高雄市,楠梓區,0521,732,226,958,39,997,1628,61.24%,44.96%,1
高雄市,楠梓區,0522,798,306,1104,31,1135,1739,65.27%,45.89%,1
高雄市,楠梓區,0523,763,262,1025,30,1055,1642,64.25%,46.47%,1
高雄市,楠梓區,0524,717,243,960,34,994,1766,56.29%,40.6%,1
高雄市,楠梓區,0525,601,224,825,37,862,1482,58.16%,40.55%,1
高雄市,楠梓區,0526,678,222,900,23,923,1749,52.77%,38.77%,1
高雄市,楠梓區,0527,651,288,939,27,966,1591,60.72%,40.92%,1
高雄市,楠梓區,0528,708,281,989,13,1002,1545,64.85%,45.83%,1
高雄市,楠梓區,0529,777,275,1052,23,1075,1651,65.11%,47.06%,1
高雄市,楠梓區,0530,710,300,1010,33,1043,1646,63.37%,43.13%,1
高雄市,楠梓區,0531,689,234,923,47,970,1496,64.84%,46.06%,1
高雄市,楠梓區,0532,617,181,798,44,842,1403,60.01%,43.98%,1
高雄市,楠梓區,0533,622,293,915,24,939,1624,57.82%,38.3%,1
高雄市,三民區,0887,785,292,1077,40,1117,1893,59.01%,41.47%,1
高雄市,三民區,0888,790,257,1047,47,1094,1982,55.2%,39.86%,1
高雄市,三民區,0889,708,236,944,33,977,1661,58.82%,42.62%,1
高雄市,三民區,0890,752,327,1079,15,1094,1894,57.76%,39.7%,1
高雄市,三民區,0891,730,295,1025,26,1051,1839,57.15%,39.7%,1
高雄市,三民區,0892,779,328,1107,46,1153,2014,57.25%,38.68%,1
高雄市,三民區,0893,838,249,1087,53,1140,1897,60.09%,44.18%,1
高雄市,三民區,0894,734,325,1059,36,1095,2016,54.32%,36.41%,1
高雄市,三民區,0895,782,270,1052,29,1081,1924,56.19%,40.64%,1
高雄市,三民區,0896,758,264,1022,30,1052,1749,60.15%,43.34%,1
高雄市,三民區,0897,817,353,1170,14,1184,1845,64.17%,44.28%,1
高雄市,三民區,0898,697,271,968,31,999,1724,57.95%,40.43%,1
高雄市,三民區,0899,775,311,1086,28,1114,1889,58.97%,41.03%,1
高雄市,三民區,0900,684,265,949,22,971,1622,59.86%,42.17%,1
高雄市,三民區,0901,899,242,1141,17,1158,1870,61.93%,48.07%,1
高雄市,三民區,0902,687,253,940,32,972,1523,63.82%,45.11%,1
高雄市,三民區,0903,786,283,1069,42,1111,2006,55.38%,39.18%,1
高雄市,三民區,0904,846,436,1282,36,1318,2076,63.49%,40.75%,1
高雄市,三民區,0905,774,411,1185,15,1200,2073,57.89%,37.34%,1
高雄市,三民區,0906,843,342,1185,27,1212,2045,59.27%,41.22%,1
高雄市,三民區,0907,698,311,1009,43,1052,2070,50.82%,33.72%,1
高雄市,三民區,0908,790,330,1120,25,1145,2035,56.27%,38.82%,1
高雄市,三民區,0909,815,443,1258,34,1292,2075,62.27%,39.28%,1
高雄市,三民區,0910,881,342,1223,22,1245,2053,60.64%,42.91%,1
高雄市,三民區,0911,900,380,1280,22,1302,2063,63.11%,43.63%,1
高雄市,三民區,0912,925,394,1319,32,1351,2143,63.04%,43.16%,1
高雄市,三民區,0913,769,292,1061,44,1105,1746,63.29%,44.04%,1
高雄市,三民區,0914,657,272,929,24,953,1735,54.93%,37.87%,1
高雄市,三民區,0915,645,256,901,28,929,1655,56.13%,38.97%,1
高雄市,三民區,0916,621,289,910,36,946,1583,59.76%,39.23%,1
高雄市,三民區,0917,702,305,1007,22,1029,1800,57.17%,39%,1
高雄市,三民區,0918,764,278,1042,22,1064,1730,61.5%,44.16%,1
高雄市,三民區,0919,727,217,944,15,959,1715,55.92%,42.39%,1
高雄市,三民區,0920,720,273,993,29,1022,1691,60.44%,42.58%,1
高雄市,三民區,0921,751,340,1091,28,1119,1865,60%,40.27%,1
高雄市,三民區,0922,500,179,679,25,704,1073,65.61%,46.6%,1
高雄市,三民區,0923,480,149,629,27,656,917,71.54%,52.34%,1
高雄市,三民區,0924,710,263,973,19,992,1647,60.23%,43.11%,1
高雄市,三民區,0925,696,283,979,32,1011,1654,61.12%,42.08%,1
高雄市,三民區,0926,741,259,1000,34,1034,1639,63.09%,45.21%,1
高雄市,三民區,0927,782,311,1093,21,1114,1833,60.77%,42.66%,1
高雄市,三民區,0928,609,267,876,21,897,1362,65.86%,44.71%,1
高雄市,三民區,0929,675,281,956,38,994,1557,63.84%,43.35%,1
高雄市,三民區,0930,689,349,1038,22,1060,1482,71.52%,46.49%,1
高雄市,三民區,0931,692,287,979,22,1001,1563,64.04%,44.27%,1
高雄市,三民區,0932,628,294,922,22,944,1497,63.06%,41.95%,1
高雄市,三民區,0933,685,296,981,16,997,1523,65.46%,44.98%,1
高雄市,三民區,0934,641,237,878,13,891,1293,68.91%,49.57%,1
高雄市,三民區,0935,698,337,1035,25,1060,1662,63.78%,42%,1
高雄市,三民區,0936,510,233,743,21,764,1441,53.02%,35.39%,1
高雄市,三民區,0937,645,249,894,18,912,1326,68.78%,48.64%,1
高雄市,三民區,0938,668,290,958,22,980,1476,66.4%,45.26%,1
高雄市,三民區,0939,769,310,1079,28,1107,1968,56.25%,39.08%,1
高雄市,三民區,0940,651,243,894,21,915,1618,56.55%,40.23%,1
高雄市,三民區,0941,708,358,1066,32,1098,1873,58.62%,37.8%,1
高雄市,三民區,0942,618,255,873,31,904,1487,60.79%,41.56%,1
高雄市,三民區,0943,712,254,966,15,981,1640,59.82%,43.41%,1
高雄市,三民區,0944,786,296,1082,15,1097,1889,58.07%,41.61%,1
高雄市,三民區,0945,783,330,1113,24,1137,1969,57.75%,39.77%,1
高雄市,三民區,0946,639,229,868,40,908,1466,61.94%,43.59%,1
高雄市,三民區,0947,745,286,1031,27,1058,1697,62.35%,43.9%,1
高雄市,三民區,0948,737,265,1002,26,1028,1663,61.82%,44.32%,1
高雄市,三民區,0949,659,296,955,28,983,1649,59.61%,39.96%,1
高雄市,三民區,0950,653,229,882,22,904,1486,60.83%,43.94%,1
高雄市,三民區,0951,624,228,852,13,865,1495,57.86%,41.74%,1
高雄市,三民區,0952,685,304,989,20,1009,1548,65.18%,44.25%,1
高雄市,三民區,0953,607,276,883,26,909,1493,60.88%,40.66%,1
高雄市,三民區,0954,655,258,913,13,926,1445,64.08%,45.33%,1
高雄市,三民區,0955,647,248,895,15,910,1529,59.52%,42.32%,1
高雄市,三民區,0956,643,249,892,21,913,1506,60.62%,42.7%,1
高雄市,三民區,0957,671,292,963,23,986,1549,63.65%,43.32%,1
高雄市,三民區,0958,675,323,998,39,1037,1620,64.01%,41.67%,1
高雄市,三民區,0959,693,268,961,33,994,1550,64.13%,44.71%,1
高雄市,三民區,0960,675,256,931,18,949,1488,63.78%,45.36%,1
高雄市,三民區,0961,564,254,818,28,846,1335,63.37%,42.25%,1
高雄市,三民區,0962,621,178,799,23,822,1332,61.71%,46.62%,1
高雄市,三民區,0963,721,322,1043,47,1090,1764,61.79%,40.87%,1
高雄市,三民區,0964,776,301,1077,20,1097,1811,60.57%,42.85%,1
高雄市,三民區,0965,717,337,1054,37,1091,1693,64.44%,42.35%,1
高雄市,三民區,0966,770,302,1072,38,1110,1684,65.91%,45.72%,1
高雄市,三民區,0967,619,242,861,21,882,1464,60.25%,42.28%,1
高雄市,三民區,0968,762,350,1112,18,1130,1719,65.74%,44.33%,1
高雄市,三民區,0969,713,318,1031,25,1056,1749,60.38%,40.77%,1
高雄市,三民區,0970,772,312,1084,18,1102,1908,57.76%,40.46%,1
高雄市,三民區,0971,665,283,948,31,979,1573,62.24%,42.28%,1
高雄市,三民區,0972,663,270,933,10,943,1628,57.92%,40.72%,1
高雄市,三民區,0973,539,207,746,33,779,1377,56.57%,39.14%,1
高雄市,三民區,0974,675,288,963,22,985,1530,64.38%,44.12%,1
高雄市,三民區,0975,524,178,702,32,734,1188,61.78%,44.11%,1
高雄市,三民區,0976,643,218,861,16,877,2791,31.42%,23.04%,1
高雄市,三民區,0977,771,306,1077,28,1105,1840,60.05%,41.9%,1
高雄市,三民區,0978,707,296,1003,48,1051,1671,62.9%,42.31%,1
高雄市,三民區,0979,626,328,954,33,987,1624,60.78%,38.55%,1
高雄市,三民區,0980,724,313,1037,26,1063,1555,68.36%,46.56%,1
高雄市,三民區,0981,677,281,958,30,988,1489,66.35%,45.47%,1
高雄市,三民區,0982,708,298,1006,31,1037,1662,62.39%,42.6%,1
高雄市,三民區,0983,696,262,958,13,971,1639,59.24%,42.46%,1
高雄市,三民區,0984,790,287,1077,28,1105,1872,59.03%,42.2%,1
高雄市,三民區,0985,800,312,1112,29,1141,1968,57.98%,40.65%,1
高雄市,三民區,0986,569,169,738,48,786,1471,53.43%,38.68%,1
高雄市,三民區,0987,645,226,871,30,901,1534,58.74%,42.05%,1
高雄市,三民區,0988,651,216,867,52,919,1659,55.39%,39.24%,1
高雄市,三民區,0989,681,244,925,34,959,1815,52.84%,37.52%,1
高雄市,三民區,0990,695,304,999,30,1029,1808,56.91%,38.44%,1
高雄市,三民區,0991,502,177,679,25,704,1224,57.52%,41.01%,1
高雄市,三民區,0992,594,218,812,18,830,1406,59.03%,42.25%,1
高雄市,三民區,0993,431,126,557,25,582,945,61.59%,45.61%,1
高雄市,三民區,0994,451,162,613,11,624,944,66.1%,47.78%,1
高雄市,三民區,0995,714,258,972,46,1018,1669,60.99%,42.78%,1
高雄市,三民區,0996,578,225,803,37,840,1473,57.03%,39.24%,1
高雄市,三民區,0997,633,291,924,33,957,1876,51.01%,33.74%,1
高雄市,三民區,0998,469,186,655,21,676,1682,40.19%,27.88%,1
高雄市,三民區,0999,654,312,966,16,982,1791,54.83%,36.52%,1
高雄市,三民區,1000,747,323,1070,32,1102,1808,60.95%,41.32%,1
高雄市,三民區,1001,717,284,1001,25,1026,1798,57.06%,39.88%,1
高雄市,三民區,1002,789,403,1192,26,1218,2030,60%,38.87%,1
高雄市,三民區,1003,838,360,1198,10,1208,2034,59.39%,41.2%,1
高雄市,三民區,1004,814,366,1180,22,1202,1998,60.16%,40.74%,1
高雄市,三民區,1005,757,297,1054,26,1080,1914,56.43%,39.55%,1
高雄市,三民區,1006,732,380,1112,36,1148,1965,58.42%,37.25%,1
高雄市,三民區,1007,711,336,1047,53,1100,1885,58.36%,37.72%,1
高雄市,三民區,1008,535,219,754,12,766,1220,62.79%,43.85%,1
高雄市,三民區,1009,470,141,611,36,647,1057,61.21%,44.47%,1
高雄市,三民區,1010,511,209,720,18,738,1434,51.46%,35.63%,1
高雄市,三民區,1011,542,163,705,19,724,1350,53.63%,40.15%,1
高雄市,三民區,1012,362,117,479,12,491,872,56.31%,41.51%,1
高雄市,三民區,1013,383,144,527,18,545,954,57.13%,40.15%,1
高雄市,三民區,1014,734,300,1034,11,1045,1689,61.87%,43.46%,1
高雄市,三民區,1015,560,259,819,19,838,1390,60.29%,40.29%,1
高雄市,三民區,1016,578,232,810,29,839,1336,62.8%,43.26%,1
高雄市,三民區,1017,662,276,938,30,968,1437,67.36%,46.07%,1
高雄市,三民區,1018,618,263,881,17,898,1452,61.85%,42.56%,1
高雄市,三民區,1019,633,282,915,28,943,1513,62.33%,41.84%,1
高雄市,三民區,1020,666,270,936,37,973,1467,66.33%,45.4%,1
高雄市,三民區,1021,670,238,908,42,950,1381,68.79%,48.52%,1
高雄市,三民區,1022,489,179,668,21,689,1117,61.68%,43.78%,1
高雄市,三民區,1023,589,262,851,21,872,1327,65.71%,44.39%,1
高雄市,三民區,1024,587,240,827,25,852,1304,65.34%,45.02%,1
高雄市,三民區,1025,620,234,854,22,876,1483,59.07%,41.81%,1
高雄市,三民區,1026,670,247,917,20,937,1473,63.61%,45.49%,1
高雄市,三民區,1027,419,164,583,29,612,980,62.45%,42.76%,1
高雄市,三民區,1028,654,207,861,23,884,1409,62.74%,46.42%,1
高雄市,三民區,1029,553,192,745,25,770,1230,62.6%,44.96%,1
高雄市,三民區,1030,485,174,659,26,685,1024,66.89%,47.36%,1
高雄市,三民區,1031,487,189,676,40,716,1130,63.36%,43.1%,1
高雄市,三民區,1032,700,310,1010,27,1037,1889,54.9%,37.06%,1
高雄市,三民區,1033,654,215,869,21,890,1427,62.37%,45.83%,1
高雄市,三民區,1034,416,97,513,22,535,791,67.64%,52.59%,1
高雄市,三民區,1035,575,171,746,28,774,1079,71.73%,53.29%,1
高雄市,三民區,1036,621,247,868,41,909,1492,60.92%,41.62%,1
高雄市,三民區,1037,470,179,649,24,673,1020,65.98%,46.08%,1
高雄市,三民區,1038,449,194,643,13,656,1001,65.53%,44.86%,1
高雄市,三民區,1039,714,265,979,24,1003,1581,63.44%,45.16%,1
高雄市,三民區,1040,629,250,879,24,903,1471,61.39%,42.76%,1
高雄市,三民區,1041,536,206,742,12,754,1151,65.51%,46.57%,1
高雄市,三民區,1042,612,219,831,41,872,1334,65.37%,45.88%,1
高雄市,三民區,1043,554,204,758,16,774,1275,60.71%,43.45%,1
高雄市,三民區,1044,555,210,765,21,786,1688,46.56%,32.88%,1
高雄市,三民區,1045,550,197,747,17,764,1214,62.93%,45.3%,1
高雄市,三民區,1046,557,200,757,15,772,1149,67.19%,48.48%,1
高雄市,三民區,1047,708,259,967,58,1025,1667,61.49%,42.47%,1
高雄市,三民區,1048,702,297,999,22,1021,1786,57.17%,39.31%,1
高雄市,三民區,1049,411,142,553,12,565,896,63.06%,45.87%,1
高雄市,三民區,1050,434,126,560,22,582,925,62.92%,46.92%,1
高雄市,三民區,1051,319,124,443,27,470,684,68.71%,46.64%,1
高雄市,三民區,1052,451,170,621,38,659,981,67.18%,45.97%,1
高雄市,三民區,1053,549,191,740,37,777,1383,56.18%,39.7%,1
高雄市,三民區,1054,608,229,837,22,859,1382,62.16%,43.99%,1
高雄市,三民區,1055,347,119,466,19,485,808,60.02%,42.95%,1
高雄市,三民區,1056,515,217,732,20,752,1197,62.82%,43.02%,1
高雄市,三民區,1057,609,185,794,23,817,1344,60.79%,45.31%,1
高雄市,三民區,1058,574,238,812,22,834,1344,62.05%,42.71%,1
高雄市,三民區,1059,638,236,874,13,887,1359,65.27%,46.95%,1
高雄市,三民區,1060,466,187,653,37,690,1073,64.31%,43.43%,1
高雄市,三民區,1061,480,176,656,27,683,1186,57.59%,40.47%,1
高雄市,三民區,1062,732,280,1012,50,1062,1749,60.72%,41.85%,1
高雄市,三民區,1063,418,127,545,14,559,877,63.74%,47.66%,1
高雄市,三民區,1064,682,210,892,36,928,1402,66.19%,48.64%,1
高雄市,三民區,1065,382,130,512,12,524,769,68.14%,49.67%,1
高雄市,三民區,1066,568,192,760,18,778,1207,64.46%,47.06%,1
高雄市,三民區,1067,507,170,677,32,709,1270,55.83%,39.92%,1
高雄市,三民區,1068,530,203,733,28,761,1248,60.98%,42.47%,1
高雄市,三民區,1069,558,201,759,35,794,1263,62.87%,44.18%,1
高雄市,三民區,1070,507,168,675,31,706,1101,64.12%,46.05%,1
高雄市,三民區,1071,535,194,729,15,744,1116,66.67%,47.94%,1
高雄市,三民區,1072,544,179,723,17,740,1152,64.24%,47.22%,1
高雄市,三民區,1073,473,183,656,18,674,1057,63.77%,44.75%,1
高雄市,三民區,1074,424,129,553,21,574,971,59.11%,43.67%,1
高雄市,三民區,1075,467,159,626,17,643,1062,60.55%,43.97%,1
高雄市,新興區,1098,350,132,482,19,501,828,60.51%,42.27%,1
高雄市,新興區,1099,428,183,611,28,639,963,66.36%,44.44%,1
高雄市,新興區,1100,443,171,614,16,630,1075,58.6%,41.21%,1
高雄市,新興區,1101,567,301,868,15,883,1488,59.34%,38.1%,1
高雄市,新興區,1102,673,293,966,20,986,1438,68.57%,46.8%,1
高雄市,新興區,1103,432,195,627,24,651,1049,62.06%,41.18%,1
高雄市,新興區,1104,651,231,882,44,926,1378,67.2%,47.24%,1
高雄市,新興區,1105,315,106,421,26,447,666,67.12%,47.3%,1
高雄市,新興區,1106,415,172,587,9,596,981,60.75%,42.3%,1
高雄市,新興區,1107,418,182,600,19,619,933,66.35%,44.8%,1
高雄市,新興區,1108,431,147,578,17,595,987,60.28%,43.67%,1
高雄市,新興區,1109,465,153,618,16,634,988,64.17%,47.06%,1
高雄市,新興區,1110,359,118,477,18,495,735,67.35%,48.84%,1
高雄市,新興區,1111,556,233,789,24,813,1317,61.73%,42.22%,1
高雄市,新興區,1112,341,130,471,17,488,800,61%,42.63%,1
高雄市,新興區,1113,464,151,615,18,633,968,65.39%,47.93%,1
高雄市,新興區,1114,433,140,573,8,581,913,63.64%,47.43%,1
高雄市,新興區,1115,599,311,910,19,929,1389,66.88%,43.12%,1
高雄市,新興區,1116,536,273,809,30,839,1228,68.32%,43.65%,1
高雄市,新興區,1117,541,210,751,28,779,1211,64.33%,44.67%,1
高雄市,新興區,1118,487,204,691,15,706,1101,64.12%,44.23%,1
高雄市,新興區,1119,339,141,480,10,490,752,65.16%,45.08%,1
高雄市,新興區,1120,415,185,600,21,621,873,71.13%,47.54%,1
高雄市,新興區,1121,725,290,1015,18,1033,1609,64.2%,45.06%,1
高雄市,新興區,1122,791,293,1084,25,1109,1736,63.88%,45.56%,1
高雄市,新興區,1123,533,210,743,17,760,1258,60.41%,42.37%,1
高雄市,新興區,1124,481,198,679,20,699,1105,63.26%,43.53%,1
高雄市,新興區,1125,383,136,519,23,542,851,63.69%,45.01%,1
高雄市,新興區,1126,454,170,624,26,650,1011,64.29%,44.91%,1
高雄市,新興區,1127,434,167,601,28,629,888,70.83%,48.87%,1
高雄市,新興區,1128,433,186,619,18,637,1005,63.38%,43.08%,1
高雄市,新興區,1129,455,178,633,12,645,1375,46.91%,33.09%,1
高雄市,新興區,1130,573,265,838,27,865,1388,62.32%,41.28%,1
高雄市,新興區,1131,319,106,425,21,446,719,62.03%,44.37%,1
高雄市,新興區,1132,450,183,633,38,671,1077,62.3%,41.78%,1
高雄市,新興區,1133,337,130,467,13,480,875,54.86%,38.51%,1
高雄市,新興區,1134,387,152,539,9,548,936,58.55%,41.35%,1
高雄市,新興區,1135,399,142,541,30,571,944,60.49%,42.27%,1
高雄市,新興區,1136,351,117,468,14,482,833,57.86%,42.14%,1
高雄市,新興區,1137,337,117,454,12,466,708,65.82%,47.6%,1
高雄市,新興區,1138,309,126,435,11,446,741,60.19%,41.7%,1
高雄市,新興區,1139,510,190,700,21,721,1235,58.38%,41.3%,1
高雄市,前金區,1076,296,108,404,14,418,673,62.11%,43.98%,1
高雄市,前金區,1077,464,176,640,14,654,1022,63.99%,45.4%,1
高雄市,前金區,1078,602,171,773,23,796,1324,60.12%,45.47%,1
高雄市,前金區,1079,371,128,499,25,524,839,62.46%,44.22%,1
高雄市,前金區,1080,419,164,583,25,608,975,62.36%,42.97%,1
高雄市,前金區,1081,760,297,1057,37,1094,1806,60.58%,42.08%,1
高雄市,前金區,1082,746,298,1044,30,1074,1781,60.3%,41.89%,1
高雄市,前金區,1083,325,124,449,14,463,717,64.57%,45.33%,1
高雄市,前金區,1084,477,177,654,12,666,1097,60.71%,43.48%,1
高雄市,前金區,1085,687,277,964,18,982,1633,60.13%,42.07%,1
高雄市,前金區,1086,356,152,508,11,519,759,68.38%,46.9%,1
高雄市,前金區,1087,412,191,603,26,629,948,66.35%,43.46%,1
高雄市,前金區,1088,393,146,539,32,571,1009,56.59%,38.95%,1
高雄市,前金區,1089,424,155,579,18,597,945,63.17%,44.87%,1
高雄市,前金區,1090,330,149,479,13,492,772,63.73%,42.75%,1
高雄市,前金區,1091,331,144,475,15,490,757,64.73%,43.73%,1
高雄市,前金區,1092,492,170,662,19,681,1047,65.04%,46.99%,1
高雄市,前金區,1093,461,152,613,20,633,985,64.26%,46.8%,1
高雄市,前金區,1094,675,275,950,15,965,1674,57.65%,40.32%,1
高雄市,前金區,1095,480,160,640,19,659,1088,60.57%,44.12%,1
高雄市,前金區,1096,398,172,570,41,611,893,68.42%,44.57%,1
高雄市,前金區,1097,488,210,698,14,712,1184,60.14%,41.22%,1
高雄市,苓雅區,1140,318,132,450,12,462,718,64.35%,44.29%,1
高雄市,苓雅區,1141,623,235,858,28,886,1492,59.38%,41.76%,1
高雄市,苓雅區,1142,558,182,740,27,767,1210,63.39%,46.12%,1
高雄市,苓雅區,1143,668,245,913,6,919,1617,56.83%,41.31%,1
高雄市,苓雅區,1144,626,251,877,25,902,1428,63.17%,43.84%,1
高雄市,苓雅區,1145,569,219,788,35,823,1444,56.99%,39.4%,1
高雄市,苓雅區,1146,590,239,829,26,855,1452,58.88%,40.63%,1
高雄市,苓雅區,1147,264,83,347,14,361,554,65.16%,47.65%,1
高雄市,苓雅區,1148,401,150,551,15,566,950,59.58%,42.21%,1
高雄市,苓雅區,1149,419,140,559,12,571,978,58.38%,42.84%,1
高雄市,苓雅區,1150,679,239,918,22,940,1673,56.19%,40.59%,1
高雄市,苓雅區,1151,750,340,1090,28,1118,2045,54.67%,36.67%,1
高雄市,苓雅區,1152,455,129,584,28,612,939,65.18%,48.46%,1
高雄市,苓雅區,1153,479,228,707,19,726,1284,56.54%,37.31%,1
高雄市,苓雅區,1154,411,153,564,10,574,908,63.22%,45.26%,1
高雄市,苓雅區,1155,332,149,481,12,493,838,58.83%,39.62%,1
高雄市,苓雅區,1156,543,219,762,29,791,1267,62.43%,42.86%,1
高雄市,苓雅區,1157,504,156,660,18,678,994,68.21%,50.7%,1
高雄市,苓雅區,1158,372,111,483,15,498,774,64.34%,48.06%,1
高雄市,苓雅區,1159,473,204,677,22,699,1121,62.36%,42.19%,1
高雄市,苓雅區,1160,608,281,889,19,908,1474,61.6%,41.25%,1
高雄市,苓雅區,1161,666,257,923,27,950,1525,62.3%,43.67%,1
高雄市,苓雅區,1162,519,191,710,19,729,1147,63.56%,45.25%,1
高雄市,苓雅區,1163,424,201,625,35,660,1014,65.09%,41.81%,1
高雄市,苓雅區,1164,610,283,893,31,924,1496,61.76%,40.78%,1
高雄市,苓雅區,1165,668,262,930,32,962,1499,64.18%,44.56%,1
高雄市,苓雅區,1166,512,210,722,19,741,1138,65.11%,44.99%,1
高雄市,苓雅區,1167,431,142,573,14,587,839,69.96%,51.37%,1
高雄市,苓雅區,1168,536,203,739,17,756,2088,36.21%,25.67%,1
高雄市,苓雅區,1169,709,312,1021,14,1035,1648,62.8%,43.02%,1
高雄市,苓雅區,1170,673,258,931,26,957,1623,58.96%,41.47%,1
高雄市,苓雅區,1171,880,369,1249,30,1279,1932,66.2%,45.55%,1
高雄市,苓雅區,1172,551,219,770,14,784,1127,69.57%,48.89%,1
高雄市,苓雅區,1173,569,238,807,14,821,1156,71.02%,49.22%,1
高雄市,苓雅區,1174,683,262,945,18,963,1465,65.73%,46.62%,1
高雄市,苓雅區,1175,305,89,394,11,405,690,58.7%,44.2%,1
高雄市,苓雅區,1176,579,184,763,36,799,1283,62.28%,45.13%,1
高雄市,苓雅區,1177,627,214,841,38,879,1432,61.38%,43.78%,1
高雄市,苓雅區,1178,595,209,804,23,827,1313,62.99%,45.32%,1
高雄市,苓雅區,1179,667,248,915,18,933,1579,59.09%,42.24%,1
高雄市,苓雅區,1180,628,225,853,26,879,1385,63.47%,45.34%,1
高雄市,苓雅區,1181,693,210,903,26,929,1449,64.11%,47.83%,1
高雄市,苓雅區,1182,797,351,1148,23,1171,1834,63.85%,43.46%,1
高雄市,苓雅區,1183,643,248,891,26,917,1436,63.86%,44.78%,1
高雄市,苓雅區,1184,651,259,910,23,933,1431,65.2%,45.49%,1
高雄市,苓雅區,1185,588,236,824,17,841,1248,67.39%,47.12%,1
高雄市,苓雅區,1186,617,291,908,34,942,1470,64.08%,41.97%,1
高雄市,苓雅區,1187,717,262,979,46,1025,1540,66.56%,46.56%,1
高雄市,苓雅區,1188,606,281,887,17,904,1374,65.79%,44.1%,1
高雄市,苓雅區,1189,381,172,553,14,567,839,67.58%,45.41%,1
高雄市,苓雅區,1190,484,212,696,8,704,1022,68.88%,47.36%,1
高雄市,苓雅區,1191,506,187,693,12,705,1062,66.38%,47.65%,1
高雄市,苓雅區,1192,457,223,680,10,690,1078,64.01%,42.39%,1
高雄市,苓雅區,1193,523,208,731,18,749,1117,67.05%,46.82%,1
高雄市,苓雅區,1194,694,241,935,45,980,1516,64.64%,45.78%,1
高雄市,苓雅區,1195,606,243,849,50,899,1440,62.43%,42.08%,1
高雄市,苓雅區,1196,372,145,517,19,536,839,63.89%,44.34%,1
高雄市,苓雅區,1197,403,129,532,15,547,888,61.6%,45.38%,1
高雄市,苓雅區,1198,492,219,711,19,730,1101,66.3%,44.69%,1
高雄市,苓雅區,1199,486,208,694,28,722,1004,71.91%,48.41%,1
高雄市,苓雅區,1200,644,235,879,23,902,1427,63.21%,45.13%,1
高雄市,苓雅區,1201,551,171,722,14,736,1168,63.01%,47.17%,1
高雄市,苓雅區,1202,538,245,783,17,800,1184,67.57%,45.44%,1
高雄市,苓雅區,1203,450,174,624,9,633,974,64.99%,46.2%,1
高雄市,苓雅區,1204,344,135,479,7,486,849,57.24%,40.52%,1
高雄市,苓雅區,1205,807,312,1119,32,1151,1821,63.21%,44.32%,1
高雄市,苓雅區,1206,570,233,803,31,834,1306,63.86%,43.64%,1
高雄市,苓雅區,1207,528,228,756,17,773,1185,65.23%,44.56%,1
高雄市,苓雅區,1208,581,263,844,22,866,1415,61.2%,41.06%,1
高雄市,苓雅區,1209,447,189,636,16,652,962,67.78%,46.47%,1
高雄市,苓雅區,1210,434,142,576,26,602,964,62.45%,45.02%,1
高雄市,苓雅區,1211,663,273,936,20,956,1524,62.73%,43.5%,1
高雄市,苓雅區,1212,634,264,898,20,918,1455,63.09%,43.57%,1
高雄市,苓雅區,1213,534,182,716,16,732,1272,57.55%,41.98%,1
高雄市,苓雅區,1214,519,227,746,13,759,1256,60.43%,41.32%,1
高雄市,苓雅區,1215,532,170,702,23,725,1203,60.27%,44.22%,1
高雄市,苓雅區,1216,516,157,673,19,692,1062,65.16%,48.59%,1
高雄市,苓雅區,1217,396,145,541,37,578,850,68%,46.59%,1
高雄市,苓雅區,1218,464,197,661,39,700,1010,69.31%,45.94%,1
高雄市,苓雅區,1219,528,166,694,17,711,1118,63.6%,47.23%,1
高雄市,苓雅區,1220,429,160,589,29,618,937,65.96%,45.78%,1
高雄市,苓雅區,1221,635,213,848,10,858,1493,57.47%,42.53%,1
高雄市,苓雅區,1222,535,215,750,17,767,1183,64.84%,45.22%,1
高雄市,苓雅區,1223,559,189,748,18,766,1318,58.12%,42.41%,1
高雄市,苓雅區,1224,598,213,811,24,835,1362,61.31%,43.91%,1
高雄市,苓雅區,1225,503,151,654,39,693,1102,62.89%,45.64%,1
高雄市,苓雅區,1226,635,245,880,20,900,1481,60.77%,42.88%,1
高雄市,苓雅區,1227,418,155,573,26,599,878,68.22%,47.61%,1
高雄市,苓雅區,1228,403,128,531,12,543,908,59.8%,44.38%,1
高雄市,苓雅區,1229,483,195,678,20,698,1056,66.1%,45.74%,1
高雄市,苓雅區,1230,492,152,644,15,659,1091,60.4%,45.1%,1
高雄市,苓雅區,1231,441,180,621,12,633,976,64.86%,45.18%,1
高雄市,苓雅區,1232,502,202,704,21,725,1063,68.2%,47.22%,1
高雄市,苓雅區,1233,645,271,916,32,948,1484,63.88%,43.46%,1
高雄市,苓雅區,1234,567,235,802,17,819,1290,63.49%,43.95%,1
高雄市,苓雅區,1235,768,294,1062,22,1084,1740,62.3%,44.14%,1
高雄市,苓雅區,1236,697,259,956,24,980,1594,61.48%,43.73%,1
高雄市,苓雅區,1237,696,275,971,13,984,1648,59.71%,42.23%,1
高雄市,苓雅區,1238,598,188,786,23,809,1236,65.45%,48.38%,1
高雄市,苓雅區,1239,549,197,746,20,766,1211,63.25%,45.33%,1
高雄市,苓雅區,1240,609,179,788,17,805,1283,62.74%,47.47%,1
高雄市,苓雅區,1241,808,302,1110,40,1150,1804,63.75%,44.79%,1
高雄市,苓雅區,1242,788,268,1056,30,1086,1718,63.21%,45.87%,1
高雄市,苓雅區,1243,582,220,802,25,827,1297,63.76%,44.87%,1
高雄市,苓雅區,1244,615,240,855,36,891,1449,61.49%,42.44%,1
高雄市,苓雅區,1245,637,147,784,13,797,1307,60.98%,48.74%,1
高雄市,苓雅區,1246,518,216,734,24,758,1184,64.02%,43.75%,1
高雄市,苓雅區,1247,557,243,800,37,837,1250,66.96%,44.56%,1
高雄市,苓雅區,1248,540,204,744,16,760,1248,60.9%,43.27%,1
高雄市,苓雅區,1249,603,190,793,26,819,1283,63.83%,47%,1
高雄市,苓雅區,1250,566,158,724,16,740,1121,66.01%,50.49%,1
高雄市,苓雅區,1251,581,204,785,18,803,1258,63.83%,46.18%,1
高雄市,苓雅區,1252,610,208,818,13,831,1339,62.06%,45.56%,1
高雄市,苓雅區,1253,823,299,1122,49,1171,1986,58.96%,41.44%,1
高雄市,苓雅區,1254,482,148,630,19,649,1028,63.13%,46.89%,1
高雄市,苓雅區,1255,347,237,584,25,609,948,64.24%,36.6%,1
高雄市,前鎮區,1484,719,237,956,59,1015,1809,56.11%,39.75%,1
高雄市,前鎮區,1485,732,238,970,32,1002,1835,54.6%,39.89%,1
高雄市,前鎮區,1486,579,227,806,40,846,1890,44.76%,30.63%,1
高雄市,前鎮區,1487,742,266,1008,32,1040,2013,51.66%,36.86%,1
高雄市,前鎮區,1488,700,218,918,36,954,1776,53.72%,39.41%,1
高雄市,前鎮區,1489,568,231,799,47,846,1705,49.62%,33.31%,1
高雄市,前鎮區,1490,275,109,384,37,421,672,62.65%,40.92%,1
高雄市,前鎮區,1491,608,230,838,37,875,1726,50.7%,35.23%,1
高雄市,前鎮區,1492,648,277,925,19,944,1597,59.11%,40.58%,1
高雄市,前鎮區,1493,657,307,964,41,1005,1690,59.47%,38.88%,1
高雄市,前鎮區,1494,505,156,661,36,697,1080,64.54%,46.76%,1
高雄市,前鎮區,1495,568,179,747,27,774,1159,66.78%,49.01%,1
高雄市,前鎮區,1496,560,177,737,32,769,1314,58.52%,42.62%,1
高雄市,前鎮區,1497,413,136,549,24,573,896,63.95%,46.09%,1
高雄市,前鎮區,1498,429,150,579,25,604,1002,60.28%,42.81%,1
高雄市,前鎮區,1499,773,284,1057,44,1101,2765,39.82%,27.96%,1
高雄市,前鎮區,1500,282,72,354,34,388,600,64.67%,47%,1
高雄市,前鎮區,1501,439,140,579,21,600,1466,40.93%,29.95%,1
高雄市,前鎮區,1502,654,195,849,31,880,1449,60.73%,45.13%,1
高雄市,前鎮區,1503,424,117,541,30,571,991,57.62%,42.79%,1
高雄市,前鎮區,1504,577,145,722,42,764,1248,61.22%,46.23%,1
高雄市,前鎮區,1505,506,150,656,43,699,1066,65.57%,47.47%,1
高雄市,前鎮區,1506,314,90,404,23,427,706,60.48%,44.48%,1
高雄市,前鎮區,1507,321,78,399,16,415,713,58.2%,45.02%,1
高雄市,前鎮區,1508,551,190,741,32,773,1344,57.51%,41%,1
高雄市,前鎮區,1509,380,131,511,32,543,856,63.43%,44.39%,1
高雄市,前鎮區,1510,356,134,490,21,511,873,58.53%,40.78%,1
高雄市,前鎮區,1511,484,138,622,31,653,1114,58.62%,43.45%,1
高雄市,前鎮區,1512,470,145,615,15,630,1112,56.65%,42.27%,1
高雄市,前鎮區,1513,416,169,585,34,619,1044,59.29%,39.85%,1
高雄市,前鎮區,1514,383,128,511,20,531,940,56.49%,40.74%,1
高雄市,前鎮區,1515,530,159,689,37,726,1342,54.1%,39.49%,1
高雄市,前鎮區,1516,634,271,905,32,937,1402,66.83%,45.22%,1
高雄市,前鎮區,1517,555,242,797,20,817,1320,61.89%,42.05%,1
高雄市,前鎮區,1518,416,126,542,37,579,958,60.44%,43.42%,1
高雄市,前鎮區,1519,622,238,860,21,881,1276,69.04%,48.75%,1
高雄市,前鎮區,1520,650,240,890,40,930,1459,63.74%,44.55%,1
高雄市,前鎮區,1521,307,88,395,23,418,761,54.93%,40.34%,1
高雄市,前鎮區,1522,444,204,648,17,665,1093,60.84%,40.62%,1
高雄市,前鎮區,1523,741,188,929,35,964,1521,63.38%,48.72%,1
高雄市,前鎮區,1524,712,225,937,34,971,1557,62.36%,45.73%,1
高雄市,前鎮區,1525,720,255,975,21,996,1821,54.7%,39.54%,1
高雄市,前鎮區,1526,594,131,725,12,737,1066,69.14%,55.72%,1
高雄市,前鎮區,1527,531,138,669,12,681,1046,65.11%,50.76%,1
高雄市,前鎮區,1528,711,274,985,29,1014,1709,59.33%,41.6%,1
高雄市,前鎮區,1529,755,266,1021,43,1064,1723,61.75%,43.82%,1
高雄市,前鎮區,1530,538,236,774,22,796,1202,66.22%,44.76%,1
高雄市,前鎮區,1531,596,260,856,22,878,1279,68.65%,46.6%,1
高雄市,前鎮區,1532,662,297,959,22,981,1513,64.84%,43.75%,1
高雄市,前鎮區,1533,538,199,737,19,756,1260,60%,42.7%,1
高雄市,前鎮區,1534,516,206,722,44,766,1139,67.25%,45.3%,1
高雄市,前鎮區,1535,531,213,744,22,766,1140,67.19%,46.58%,1
高雄市,前鎮區,1536,648,257,905,26,931,1462,63.68%,44.32%,1
高雄市,前鎮區,1537,602,227,829,23,852,1359,62.69%,44.3%,1
高雄市,前鎮區,1538,749,291,1040,52,1092,2037,53.61%,36.77%,1
高雄市,前鎮區,1539,553,251,804,19,823,1410,58.37%,39.22%,1
高雄市,前鎮區,1540,559,211,770,10,780,1307,59.68%,42.77%,1
高雄市,前鎮區,1541,615,229,844,47,891,1512,58.93%,40.67%,1
高雄市,前鎮區,1542,601,275,876,40,916,1491,61.44%,40.31%,1
高雄市,前鎮區,1543,703,230,933,23,956,1621,58.98%,43.37%,1
高雄市,前鎮區,1544,583,218,801,17,818,1522,53.75%,38.3%,1
高雄市,前鎮區,1545,661,273,934,34,968,1593,60.77%,41.49%,1
高雄市,前鎮區,1546,833,302,1135,38,1173,1885,62.23%,44.19%,1
高雄市,前鎮區,1547,754,367,1121,52,1173,1870,62.73%,40.32%,1
高雄市,前鎮區,1548,607,246,853,15,868,1388,62.54%,43.73%,1
高雄市,前鎮區,1549,594,217,811,32,843,1348,62.54%,44.07%,1
高雄市,前鎮區,1550,569,162,731,54,785,1341,58.54%,42.43%,1
高雄市,前鎮區,1551,625,241,866,29,895,1364,65.62%,45.82%,1
高雄市,前鎮區,1552,572,233,805,35,840,1367,61.45%,41.84%,1
高雄市,前鎮區,1553,563,211,774,32,806,1326,60.78%,42.46%,1
高雄市,前鎮區,1554,441,162,603,26,629,1059,59.4%,41.64%,1
高雄市,前鎮區,1555,498,187,685,16,701,1119,62.65%,44.5%,1
高雄市,前鎮區,1556,612,266,878,29,907,1565,57.96%,39.11%,1
高雄市,前鎮區,1557,644,243,887,33,920,1549,59.39%,41.58%,1
高雄市,前鎮區,1558,739,349,1088,17,1105,1691,65.35%,43.7%,1
高雄市,前鎮區,1559,744,332,1076,19,1095,1837,59.61%,40.5%,1
高雄市,前鎮區,1560,501,186,687,19,706,1092,64.65%,45.88%,1
高雄市,前鎮區,1561,498,185,683,35,718,1126,63.77%,44.23%,1
高雄市,前鎮區,1562,518,163,681,38,719,1215,59.18%,42.63%,1
高雄市,前鎮區,1563,625,255,880,19,899,1443,62.3%,43.31%,1
高雄市,前鎮區,1564,706,286,992,12,1004,1448,69.34%,48.76%,1
高雄市,前鎮區,1565,719,269,988,34,1022,1648,62.01%,43.63%,1
高雄市,前鎮區,1566,755,140,895,23,918,1603,57.27%,47.1%,1
高雄市,前鎮區,1567,510,233,743,15,758,1596,47.49%,31.95%,1
高雄市,前鎮區,1568,600,176,776,26,802,1450,55.31%,41.38%,1
高雄市,前鎮區,1569,599,214,813,48,861,1510,57.02%,39.67%,1
高雄市,前鎮區,1570,738,264,1002,44,1046,1647,63.51%,44.81%,1
高雄市,前鎮區,1571,573,190,763,30,793,1342,59.09%,42.7%,1
高雄市,前鎮區,1572,550,205,755,20,775,1384,56%,39.74%,1
高雄市,前鎮區,1573,614,212,826,41,867,1479,58.62%,41.51%,1
高雄市,前鎮區,1574,684,227,911,23,934,1546,60.41%,44.24%,1
高雄市,前鎮區,1575,630,321,951,29,980,1595,61.44%,39.5%,1
高雄市,前鎮區,1576,549,174,723,28,751,1201,62.53%,45.71%,1
高雄市,前鎮區,1577,478,133,611,22,633,1082,58.5%,44.18%,1
高雄市,前鎮區,1578,424,129,553,18,571,996,57.33%,42.57%,1
高雄市,前鎮區,1579,436,130,566,27,593,932,63.63%,46.78%,1
高雄市,前鎮區,1580,487,176,663,28,691,1146,60.3%,42.5%,1
高雄市,前鎮區,1581,584,81,665,23,688,1096,62.77%,53.28%,1
高雄市,前鎮區,1582,624,240,864,14,878,1332,65.92%,46.85%,1
高雄市,前鎮區,1583,508,189,697,22,719,1175,61.19%,43.23%,1
高雄市,前鎮區,1584,418,148,566,40,606,986,61.46%,42.39%,1
高雄市,前鎮區,1585,572,211,783,44,827,1316,62.84%,43.47%,1
高雄市,前鎮區,1586,587,235,822,26,848,1559,54.39%,37.65%,1
高雄市,前鎮區,1587,733,235,968,33,1001,1622,61.71%,45.19%,1
高雄市,前鎮區,1588,600,175,775,30,805,1310,61.45%,45.8%,1
高雄市,前鎮區,1589,626,187,813,33,846,1299,65.13%,48.19%,1
高雄市,前鎮區,1590,588,182,770,32,802,1191,67.34%,49.37%,1
高雄市,前鎮區,1591,611,192,803,14,817,1375,59.42%,44.44%,1
高雄市,前鎮區,1592,616,186,802,18,820,1338,61.29%,46.04%,1
高雄市,前鎮區,1593,485,201,686,18,704,1175,59.91%,41.28%,1
高雄市,前鎮區,1594,569,209,778,15,793,1357,58.44%,41.93%,1
高雄市,前鎮區,1595,574,195,769,31,800,1187,67.4%,48.36%,1
高雄市,前鎮區,1596,536,162,698,19,717,1164,61.6%,46.05%,1
高雄市,前鎮區,1597,554,196,750,34,784,1219,64.32%,45.45%,1
高雄市,前鎮區,1598,593,221,814,11,825,1428,57.77%,41.53%,1
高雄市,前鎮區,1599,610,238,848,44,892,1495,59.67%,40.8%,1
高雄市,前鎮區,1600,640,300,940,25,965,1531,63.03%,41.8%,1
高雄市,前鎮區,1601,597,268,865,41,906,1509,60.04%,39.56%,1
高雄市,前鎮區,1602,688,208,896,42,938,1591,58.96%,43.24%,1
高雄市,旗津區,0869,529,176,705,49,754,1177,64.06%,44.94%,1
高雄市,旗津區,0870,460,119,579,32,611,1109,55.09%,41.48%,1
高雄市,旗津區,0871,573,243,816,20,836,1642,50.91%,34.9%,1
高雄市,旗津區,0872,508,139,647,58,705,1209,58.31%,42.02%,1
高雄市,旗津區,0873,405,156,561,30,591,1112,53.15%,36.42%,1
高雄市,旗津區,0874,630,215,845,38,883,1483,59.54%,42.48%,1
高雄市,旗津區,0875,546,161,707,20,727,1460,49.79%,37.4%,1
高雄市,旗津區,0876,457,472,929,73,1002,1572,63.74%,29.07%,1
高雄市,旗津區,0877,509,177,686,16,702,1384,50.72%,36.78%,1
高雄市,旗津區,0878,576,156,732,17,749,1390,53.88%,41.44%,1
高雄市,旗津區,0879,462,155,617,23,640,1239,51.65%,37.29%,1
高雄市,旗津區,0880,817,303,1120,27,1147,2045,56.09%,39.95%,1
高雄市,旗津區,0881,369,94,463,15,478,893,53.53%,41.32%,1
高雄市,旗津區,0882,700,254,954,49,1003,1866,53.75%,37.51%,1
高雄市,旗津區,0883,654,219,873,16,889,1874,47.44%,34.9%,1
高雄市,旗津區,0884,312,120,432,34,466,893,52.18%,34.94%,1
高雄市,旗津區,0885,522,201,723,21,744,1215,61.23%,42.96%,1
高雄市,旗津區,0886,499,180,679,16,695,1297,53.59%,38.47%,1
高雄市,小港區,1603,537,170,707,27,734,1108,66.25%,48.47%,1
高雄市,小港區,1604,544,164,708,33,741,1171,63.28%,46.46%,1
高雄市,小港區,1605,644,326,970,17,987,1557,63.39%,41.36%,1
高雄市,小港區,1606,676,224,900,19,919,1668,55.1%,40.53%,1
高雄市,小港區,1607,580,172,752,17,769,1183,65%,49.03%,1
高雄市,小港區,1608,581,217,798,26,824,1372,60.06%,42.35%,1
高雄市,小港區,1609,790,245,1035,41,1076,1737,61.95%,45.48%,1
高雄市,小港區,1610,641,234,875,40,915,1586,57.69%,40.42%,1
高雄市,小港區,1611,639,210,849,28,877,1558,56.29%,41.01%,1
高雄市,小港區,1612,617,208,825,27,852,1284,66.36%,48.05%,1
高雄市,小港區,1613,550,193,743,36,779,1249,62.37%,44.04%,1
高雄市,小港區,1614,802,297,1099,43,1142,2400,47.58%,33.42%,1
高雄市,小港區,1615,570,179,749,27,776,1181,65.71%,48.26%,1
高雄市,小港區,1616,500,160,660,21,681,1079,63.11%,46.34%,1
高雄市,小港區,1617,524,243,767,25,792,1335,59.33%,39.25%,1
高雄市,小港區,1618,561,183,744,24,768,1241,61.89%,45.21%,1
高雄市,小港區,1619,628,214,842,34,876,1513,57.9%,41.51%,1
高雄市,小港區,1620,627,210,837,25,862,1349,63.9%,46.48%,1
高雄市,小港區,1621,630,215,845,23,868,1483,58.53%,42.48%,1
高雄市,小港區,1622,624,240,864,18,882,1451,60.79%,43%,1
高雄市,小港區,1623,511,175,686,22,708,1241,57.05%,41.18%,1
高雄市,小港區,1624,609,201,810,41,851,1262,67.43%,48.26%,1
高雄市,小港區,1625,816,249,1065,44,1109,1813,61.17%,45.01%,1
高雄市,小港區,1626,756,246,1002,20,1022,1877,54.45%,40.28%,1
高雄市,小港區,1627,578,216,794,23,817,1391,58.73%,41.55%,1
高雄市,小港區,1628,661,244,905,23,928,1453,63.87%,45.49%,1
高雄市,小港區,1629,601,211,812,22,834,1374,60.7%,43.74%,1
高雄市,小港區,1630,589,190,779,28,807,1348,59.87%,43.69%,1
高雄市,小港區,1631,609,203,812,27,839,1334,62.89%,45.65%,1
高雄市,小港區,1632,580,251,831,21,852,1433,59.46%,40.47%,1
高雄市,小港區,1633,544,242,786,13,799,1448,55.18%,37.57%,1
高雄市,小港區,1634,663,259,922,38,960,1488,64.52%,44.56%,1
高雄市,小港區,1635,587,194,781,29,810,1278,63.38%,45.93%,1
高雄市,小港區,1636,627,250,877,27,904,1306,69.22%,48.01%,1
高雄市,小港區,1637,715,244,959,35,994,1625,61.17%,44%,1
高雄市,小港區,1638,717,282,999,53,1052,1640,64.15%,43.72%,1
高雄市,小港區,1639,641,205,846,37,883,1506,58.63%,42.56%,1
高雄市,小港區,1640,563,204,767,40,807,1438,56.12%,39.15%,1
高雄市,小港區,1641,559,177,736,21,757,1105,68.51%,50.59%,1
高雄市,小港區,1642,494,163,657,14,671,1167,57.5%,42.33%,1
高雄市,小港區,1643,646,231,877,21,898,1420,63.24%,45.49%,1
高雄市,小港區,1644,612,254,866,48,914,1380,66.23%,44.35%,1
高雄市,小港區,1645,536,185,721,20,741,1239,59.81%,43.26%,1
高雄市,小港區,1646,731,218,949,28,977,1563,62.51%,46.77%,1
高雄市,小港區,1647,710,262,972,24,996,1644,60.58%,43.19%,1
高雄市,小港區,1648,815,243,1058,50,1108,1895,58.47%,43.01%,1
高雄市,小港區,1649,719,239,958,51,1009,1748,57.72%,41.13%,1
高雄市,小港區,1650,681,244,925,43,968,1579,61.3%,43.13%,1
高雄市,小港區,1651,829,346,1175,29,1204,2135,56.39%,38.83%,1
高雄市,小港區,1652,746,245,991,34,1025,1728,59.32%,43.17%,1
高雄市,小港區,1653,788,333,1121,29,1150,2022,56.87%,38.97%,1
高雄市,小港區,1654,542,147,689,15,704,1329,52.97%,40.78%,1
高雄市,小港區,1655,606,172,778,23,801,1320,60.68%,45.91%,1
高雄市,小港區,1656,564,182,746,40,786,1267,62.04%,44.51%,1
高雄市,小港區,1657,609,186,795,37,832,1298,64.1%,46.92%,1
高雄市,小港區,1658,612,208,820,15,835,1289,64.78%,47.48%,1
高雄市,小港區,1659,705,240,945,24,969,1534,63.17%,45.96%,1
高雄市,小港區,1660,697,216,913,22,935,1494,62.58%,46.65%,1
高雄市,小港區,1661,622,196,818,41,859,1377,62.38%,45.17%,1
高雄市,小港區,1662,610,226,836,34,870,1344,64.73%,45.39%,1
高雄市,小港區,1663,650,219,869,32,901,1508,59.75%,43.1%,1
高雄市,小港區,1664,598,200,798,12,810,1400,57.86%,42.71%,1
高雄市,小港區,1665,644,231,875,21,896,1457,61.5%,44.2%,1
高雄市,小港區,1666,590,187,777,13,790,1392,56.75%,42.39%,1
高雄市,小港區,1667,771,306,1077,33,1110,1983,55.98%,38.88%,1
高雄市,小港區,1668,515,194,709,18,727,1204,60.38%,42.77%,1
高雄市,小港區,1669,514,233,747,18,765,1300,58.85%,39.54%,1
高雄市,小港區,1670,853,260,1113,49,1162,1857,62.57%,45.93%,1
高雄市,小港區,1671,640,247,887,25,912,1566,58.24%,40.87%,1
高雄市,小港區,1672,632,222,854,37,891,1343,66.34%,47.06%,1
高雄市,小港區,1673,582,199,781,47,828,1236,66.99%,47.09%,1
高雄市,小港區,1674,721,239,960,42,1002,1564,64.07%,46.1%,1
高雄市,小港區,1675,670,218,888,18,906,1484,61.05%,45.15%,1
高雄市,小港區,1676,641,226,867,19,886,1477,59.99%,43.4%,1
高雄市,小港區,1677,627,292,919,22,941,1482,63.5%,42.31%,1
高雄市,小港區,1678,674,291,965,16,981,1708,57.44%,39.46%,1
高雄市,小港區,1679,766,272,1038,40,1078,1867,57.74%,41.03%,1
高雄市,小港區,1680,686,257,943,31,974,1709,56.99%,40.14%,1
高雄市,小港區,1681,544,205,749,39,788,1425,55.3%,38.18%,1
高雄市,小港區,1682,578,192,770,30,800,1696,47.17%,34.08%,1
高雄市,小港區,1683,564,207,771,20,791,1522,51.97%,37.06%,1
高雄市,小港區,1684,628,223,851,53,904,1531,59.05%,41.02%,1
高雄市,小港區,1685,994,332,1326,71,1397,2215,63.07%,44.88%,1
高雄市,小港區,1686,694,205,899,24,923,1515,60.92%,45.81%,1
高雄市,小港區,1687,616,241,857,20,877,1535,57.13%,40.13%,1
高雄市,小港區,1688,535,187,722,12,734,1276,57.52%,41.93%,1
高雄市,小港區,1689,473,164,637,18,655,1217,53.82%,38.87%,1
高雄市,小港區,1690,626,195,821,41,862,1707,50.5%,36.67%,1
高雄市,小港區,1691,723,250,973,65,1038,1920,54.06%,37.66%,1
高雄市,鳳山區,1256,494,200,694,31,725,1080,67.13%,45.74%,1
高雄市,鳳山區,1257,362,130,492,29,521,819,63.61%,44.2%,1
高雄市,鳳山區,1258,391,120,511,27,538,851,63.22%,45.95%,1
高雄市,鳳山區,1259,447,222,669,19,688,1075,64%,41.58%,1
高雄市,鳳山區,1260,558,190,748,31,779,1223,63.7%,45.63%,1
高雄市,鳳山區,1261,546,188,734,29,763,1207,63.21%,45.24%,1
高雄市,鳳山區,1262,533,199,732,21,753,1339,56.24%,39.81%,1
高雄市,鳳山區,1263,446,183,629,19,648,1188,54.55%,37.54%,1
高雄市,鳳山區,1264,476,145,621,25,646,1055,61.23%,45.12%,1
高雄市,鳳山區,1265,460,151,611,43,654,1109,58.97%,41.48%,1
高雄市,鳳山區,1266,381,116,497,19,516,756,68.25%,50.4%,1
高雄市,鳳山區,1267,489,175,664,25,689,1182,58.29%,41.37%,1
高雄市,鳳山區,1268,651,220,871,32,903,1496,60.36%,43.52%,1
高雄市,鳳山區,1269,715,306,1021,33,1054,2094,50.33%,34.15%,1
高雄市,鳳山區,1270,695,239,934,15,949,1672,56.76%,41.57%,1
高雄市,鳳山區,1271,653,310,963,16,979,1761,55.59%,37.08%,1
高雄市,鳳山區,1272,625,212,837,37,874,1450,60.28%,43.1%,1
高雄市,鳳山區,1273,529,218,747,23,770,1455,52.92%,36.36%,1
高雄市,鳳山區,1274,545,164,709,31,740,1234,59.97%,44.17%,1
高雄市,鳳山區,1275,702,326,1028,41,1069,1713,62.41%,40.98%,1
高雄市,鳳山區,1276,714,227,941,33,974,1698,57.36%,42.05%,1
高雄市,鳳山區,1277,518,226,744,34,778,1247,62.39%,41.54%,1
高雄市,鳳山區,1278,471,187,658,20,678,1087,62.37%,43.33%,1
高雄市,鳳山區,1279,524,201,725,26,751,1199,62.64%,43.7%,1
高雄市,鳳山區,1280,689,184,873,30,903,1559,57.92%,44.19%,1
高雄市,鳳山區,1281,539,199,738,27,765,1233,62.04%,43.71%,1
高雄市,鳳山區,1282,555,216,771,30,801,1277,62.73%,43.46%,1
高雄市,鳳山區,1283,637,236,873,12,885,1481,59.76%,43.01%,1
高雄市,鳳山區,1284,535,213,748,13,761,1154,65.94%,46.36%,1
高雄市,鳳山區,1285,658,264,922,15,937,1475,63.53%,44.61%,1
高雄市,鳳山區,1286,494,168,662,22,684,1247,54.85%,39.62%,1
高雄市,鳳山區,1287,613,230,843,22,865,1538,56.24%,39.86%,1
高雄市,鳳山區,1288,486,163,649,14,663,1097,60.44%,44.3%,1
高雄市,鳳山區,1289,469,190,659,20,679,1221,55.61%,38.41%,1
高雄市,鳳山區,1290,473,234,707,27,734,1075,68.28%,44%,1
高雄市,鳳山區,1291,741,306,1047,26,1073,1751,61.28%,42.32%,1
高雄市,鳳山區,1292,759,296,1055,30,1085,1758,61.72%,43.17%,1
高雄市,鳳山區,1293,750,263,1013,31,1044,1749,59.69%,42.88%,1
高雄市,鳳山區,1294,717,264,981,9,990,1746,56.7%,41.07%,1
高雄市,鳳山區,1295,706,269,975,28,1003,1712,58.59%,41.24%,1
高雄市,鳳山區,1296,537,207,744,25,769,1247,61.67%,43.06%,1
高雄市,鳳山區,1297,581,241,822,44,866,1409,61.46%,41.23%,1
高雄市,鳳山區,1298,552,249,801,18,819,1347,60.8%,40.98%,1
高雄市,鳳山區,1299,720,298,1018,13,1031,1771,58.22%,40.65%,1
高雄市,鳳山區,1300,617,294,911,16,927,1537,60.31%,40.14%,1
高雄市,鳳山區,1301,690,272,962,22,984,1605,61.31%,42.99%,1
高雄市,鳳山區,1302,623,206,829,16,845,1375,61.45%,45.31%,1
高雄市,鳳山區,1303,600,246,846,37,883,1393,63.39%,43.07%,1
高雄市,鳳山區,1304,599,272,871,19,890,1584,56.19%,37.82%,1
高雄市,鳳山區,1305,278,100,378,15,393,618,63.59%,44.98%,1
高雄市,鳳山區,1306,205,66,271,7,278,423,65.72%,48.46%,1
高雄市,鳳山區,1307,577,200,777,26,803,1312,61.2%,43.98%,1
高雄市,鳳山區,1308,349,118,467,16,483,769,62.81%,45.38%,1
高雄市,鳳山區,1309,553,239,792,11,803,1213,66.2%,45.59%,1
高雄市,鳳山區,1310,578,152,730,19,749,1107,67.66%,52.21%,1
高雄市,鳳山區,1311,535,187,722,24,746,1188,62.79%,45.03%,1
高雄市,鳳山區,1312,499,236,735,18,753,1183,63.65%,42.18%,1
高雄市,鳳山區,1313,574,197,771,19,790,1264,62.5%,45.41%,1
高雄市,鳳山區,1314,409,133,542,19,561,882,63.61%,46.37%,1
高雄市,鳳山區,1315,494,179,673,35,708,1007,70.31%,49.06%,1
高雄市,鳳山區,1316,390,122,512,32,544,853,63.77%,45.72%,1
高雄市,鳳山區,1317,351,121,472,23,495,1660,29.82%,21.14%,1
高雄市,鳳山區,1318,484,202,686,20,706,1124,62.81%,43.06%,1
高雄市,鳳山區,1319,475,188,663,36,699,1112,62.86%,42.72%,1
高雄市,鳳山區,1320,494,161,655,26,681,1182,57.61%,41.79%,1
高雄市,鳳山區,1321,418,185,603,22,625,875,71.43%,47.77%,1
高雄市,鳳山區,1322,437,190,627,29,656,1040,63.08%,42.02%,1
高雄市,鳳山區,1323,490,219,709,18,727,1094,66.45%,44.79%,1
高雄市,鳳山區,1324,514,218,732,33,765,1217,62.86%,42.24%,1
高雄市,鳳山區,1325,466,174,640,25,665,974,68.28%,47.84%,1
高雄市,鳳山區,1326,419,155,574,29,603,987,61.09%,42.45%,1
高雄市,鳳山區,1327,580,210,790,16,806,1210,66.61%,47.93%,1
高雄市,鳳山區,1328,570,246,816,29,845,1391,60.75%,40.98%,1
高雄市,鳳山區,1329,451,190,641,16,657,1241,52.94%,36.34%,1
高雄市,鳳山區,1330,446,175,621,33,654,1000,65.4%,44.6%,1
高雄市,鳳山區,1331,502,172,674,17,691,1092,63.28%,45.97%,1
高雄市,鳳山區,1332,621,186,807,25,832,1308,63.61%,47.48%,1
高雄市,鳳山區,1333,466,149,615,39,654,1031,63.43%,45.2%,1
高雄市,鳳山區,1334,537,199,736,31,767,1159,66.18%,46.33%,1
高雄市,鳳山區,1335,488,153,641,34,675,1127,59.89%,43.3%,1
高雄市,鳳山區,1336,560,211,771,27,798,1109,71.96%,50.5%,1
高雄市,鳳山區,1337,880,282,1162,34,1196,1879,63.65%,46.83%,1
高雄市,鳳山區,1338,987,191,1178,29,1207,1803,66.94%,54.74%,1
高雄市,鳳山區,1339,817,270,1087,34,1121,2045,54.82%,39.95%,1
高雄市,鳳山區,1340,601,193,794,24,818,1432,57.12%,41.97%,1
高雄市,鳳山區,1341,483,134,617,14,631,1033,61.08%,46.76%,1
高雄市,鳳山區,1342,590,180,770,34,804,1253,64.17%,47.09%,1
高雄市,鳳山區,1343,543,191,734,18,752,1217,61.79%,44.62%,1
高雄市,鳳山區,1344,618,178,796,30,826,1267,65.19%,48.78%,1
高雄市,鳳山區,1345,551,184,735,20,755,1251,60.35%,44.04%,1
高雄市,鳳山區,1346,686,232,918,42,960,1563,61.42%,43.89%,1
高雄市,鳳山區,1347,819,320,1139,24,1163,1888,61.6%,43.38%,1
高雄市,鳳山區,1348,580,228,808,27,835,1368,61.04%,42.4%,1
高雄市,鳳山區,1349,638,227,865,31,896,1588,56.42%,40.18%,1
高雄市,鳳山區,1350,611,162,773,30,803,1255,63.98%,48.69%,1
高雄市,鳳山區,1351,547,177,724,43,767,1264,60.68%,43.28%,1
高雄市,鳳山區,1352,690,70,760,38,798,1291,61.81%,53.45%,1
高雄市,鳳山區,1353,593,148,741,14,755,1224,61.68%,48.45%,1
高雄市,鳳山區,1354,556,335,891,19,910,1296,70.22%,42.9%,1
高雄市,鳳山區,1355,397,136,533,25,558,826,67.55%,48.06%,1
高雄市,鳳山區,1356,573,164,737,20,757,1229,61.59%,46.62%,1
高雄市,鳳山區,1357,650,229,879,20,899,1467,61.28%,44.31%,1
高雄市,鳳山區,1358,559,164,723,27,750,1218,61.58%,45.89%,1
高雄市,鳳山區,1359,930,281,1211,42,1253,2173,57.66%,42.8%,1
高雄市,鳳山區,1360,995,305,1300,38,1338,2255,59.33%,44.12%,1
高雄市,鳳山區,1361,739,222,961,19,980,1556,62.98%,47.49%,1
高雄市,鳳山區,1362,612,221,833,30,863,1521,56.74%,40.24%,1
高雄市,鳳山區,1363,575,157,732,22,754,1407,53.59%,40.87%,1
高雄市,鳳山區,1364,685,215,900,39,939,1542,60.89%,44.42%,1
高雄市,鳳山區,1365,620,196,816,7,823,1502,54.79%,41.28%,1
高雄市,鳳山區,1366,599,201,800,31,831,1320,62.95%,45.38%,1
高雄市,鳳山區,1367,678,133,811,34,845,1507,56.07%,44.99%,1
高雄市,鳳山區,1368,662,131,793,28,821,1284,63.94%,51.56%,1
高雄市,鳳山區,1369,587,213,800,18,818,1441,56.77%,40.74%,1
高雄市,鳳山區,1370,696,199,895,37,932,1485,62.76%,46.87%,1
高雄市,鳳山區,1371,558,143,701,29,730,1205,60.58%,46.31%,1
高雄市,鳳山區,1372,587,160,747,14,761,1284,59.27%,45.72%,1
高雄市,鳳山區,1373,560,243,803,35,838,1326,63.2%,42.23%,1
高雄市,鳳山區,1374,495,167,662,22,684,1096,62.41%,45.16%,1
高雄市,鳳山區,1375,530,203,733,36,769,1182,65.06%,44.84%,1
高雄市,鳳山區,1376,503,165,668,35,703,1017,69.12%,49.46%,1
高雄市,鳳山區,1377,496,192,688,36,724,1198,60.43%,41.4%,1
高雄市,鳳山區,1378,521,200,721,16,737,1281,57.53%,40.67%,1
高雄市,鳳山區,1379,626,242,868,18,886,1358,65.24%,46.1%,1
高雄市,鳳山區,1380,575,241,816,18,834,1226,68.03%,46.9%,1
高雄市,鳳山區,1381,518,171,689,29,718,1098,65.39%,47.18%,1
高雄市,鳳山區,1382,530,203,733,23,756,1200,63%,44.17%,1
高雄市,鳳山區,1383,395,169,564,22,586,942,62.21%,41.93%,1
高雄市,鳳山區,1384,554,163,717,17,734,1206,60.86%,45.94%,1
高雄市,鳳山區,1385,530,216,746,16,762,1159,65.75%,45.73%,1
高雄市,鳳山區,1386,607,258,865,24,889,1401,63.45%,43.33%,1
高雄市,鳳山區,1387,614,251,865,18,883,1525,57.9%,40.26%,1
高雄市,鳳山區,1388,587,202,789,19,808,1345,60.07%,43.64%,1
高雄市,鳳山區,1389,568,182,750,24,774,1180,65.59%,48.14%,1
高雄市,鳳山區,1390,468,156,624,17,641,1106,57.96%,42.31%,1
高雄市,鳳山區,1391,640,245,885,39,924,1442,64.08%,44.38%,1
高雄市,鳳山區,1392,576,244,820,39,859,1376,62.43%,41.86%,1
高雄市,鳳山區,1393,527,230,757,19,776,1243,62.43%,42.4%,1
高雄市,鳳山區,1394,593,242,835,17,852,1361,62.6%,43.57%,1
高雄市,鳳山區,1395,630,230,860,32,892,1416,62.99%,44.49%,1
高雄市,鳳山區,1396,622,314,936,26,962,1536,62.63%,40.49%,1
高雄市,鳳山區,1397,554,211,765,23,788,1388,56.77%,39.91%,1
高雄市,鳳山區,1398,572,174,746,49,795,1241,64.06%,46.09%,1
高雄市,鳳山區,1399,626,241,867,22,889,1394,63.77%,44.91%,1
高雄市,鳳山區,1400,559,218,777,17,794,1188,66.84%,47.05%,1
高雄市,鳳山區,1401,539,166,705,26,731,1112,65.74%,48.47%,1
高雄市,鳳山區,1402,551,220,771,19,790,1198,65.94%,45.99%,1
高雄市,鳳山區,1403,584,270,854,10,864,1475,58.58%,39.59%,1
高雄市,鳳山區,1404,538,157,695,8,703,1216,57.81%,44.24%,1
高雄市,鳳山區,1405,531,210,741,19,760,1318,57.66%,40.29%,1
高雄市,鳳山區,1406,640,240,880,17,897,1465,61.23%,43.69%,1
高雄市,鳳山區,1407,568,171,739,23,762,1314,57.99%,43.23%,1
高雄市,鳳山區,1408,646,216,862,19,881,1649,53.43%,39.18%,1
高雄市,鳳山區,1409,637,226,863,64,927,1601,57.9%,39.79%,1
高雄市,鳳山區,1410,491,183,674,18,692,1155,59.91%,42.51%,1
高雄市,鳳山區,1411,463,153,616,36,652,1050,62.1%,44.1%,1
高雄市,鳳山區,1412,587,187,774,20,794,1417,56.03%,41.43%,1
高雄市,鳳山區,1413,662,213,875,24,899,1525,58.95%,43.41%,1
高雄市,鳳山區,1414,672,241,913,35,948,1514,62.62%,44.39%,1
高雄市,鳳山區,1415,493,198,691,22,713,1190,59.92%,41.43%,1
高雄市,鳳山區,1416,567,175,742,14,756,1325,57.06%,42.79%,1
高雄市,鳳山區,1417,487,157,644,22,666,1049,63.49%,46.43%,1
高雄市,鳳山區,1418,507,137,644,11,655,1026,63.84%,49.42%,1
高雄市,鳳山區,1419,525,173,698,31,729,1152,63.28%,45.57%,1
高雄市,鳳山區,1420,420,268,688,10,698,1254,55.66%,33.49%,1
高雄市,鳳山區,1421,694,208,902,28,930,1688,55.09%,41.11%,1
高雄市,鳳山區,1422,748,209,957,21,978,1657,59.02%,45.14%,1
高雄市,鳳山區,1423,677,234,911,24,935,1729,54.08%,39.16%,1
高雄市,鳳山區,1424,708,269,977,19,996,1628,61.18%,43.49%,1
高雄市,鳳山區,1425,709,260,969,13,982,1891,51.93%,37.49%,1
高雄市,鳳山區,1426,763,208,971,23,994,1594,62.36%,47.87%,1
高雄市,鳳山區,1427,642,223,865,12,877,1342,65.35%,47.84%,1
高雄市,鳳山區,1428,691,236,927,23,950,1448,65.61%,47.72%,1
高雄市,鳳山區,1429,638,215,853,30,883,1405,62.85%,45.41%,1
高雄市,鳳山區,1430,555,142,697,27,724,1097,66%,50.59%,1
高雄市,鳳山區,1431,592,201,793,30,823,1248,65.95%,47.44%,1
高雄市,鳳山區,1432,534,195,729,36,765,1225,62.45%,43.59%,1
高雄市,鳳山區,1433,558,180,738,21,759,1214,62.52%,45.96%,1
高雄市,鳳山區,1434,921,288,1209,47,1256,2032,61.81%,45.32%,1
高雄市,鳳山區,1435,873,257,1130,34,1164,1927,60.4%,45.3%,1
高雄市,鳳山區,1436,1086,185,1271,29,1300,2097,61.99%,51.79%,1
高雄市,鳳山區,1437,445,110,555,20,575,968,59.4%,45.97%,1
高雄市,鳳山區,1438,498,165,663,31,694,1200,57.83%,41.5%,1
高雄市,鳳山區,1439,478,168,646,30,676,1101,61.4%,43.42%,1
高雄市,鳳山區,1440,555,198,753,19,772,1369,56.39%,40.54%,1
高雄市,鳳山區,1441,662,237,899,34,933,1542,60.51%,42.93%,1
高雄市,鳳山區,1442,706,224,930,37,967,1536,62.96%,45.96%,1
高雄市,鳳山區,1443,564,215,779,22,801,1382,57.96%,40.81%,1
高雄市,鳳山區,1444,622,248,870,30,900,1452,61.98%,42.84%,1
高雄市,鳳山區,1445,468,148,616,38,654,1058,61.81%,44.23%,1
高雄市,鳳山區,1446,487,138,625,24,649,976,66.5%,49.9%,1
高雄市,鳳山區,1447,588,230,818,26,844,1545,54.63%,38.06%,1
高雄市,鳳山區,1448,490,172,662,22,684,1143,59.84%,42.87%,1
高雄市,鳳山區,1449,268,96,364,10,374,1301,28.75%,20.6%,1
高雄市,鳳山區,1450,515,169,684,25,709,1250,56.72%,41.2%,1
高雄市,鳳山區,1451,511,180,691,29,720,1208,59.6%,42.3%,1
高雄市,鳳山區,1452,529,180,709,34,743,1202,61.81%,44.01%,1
高雄市,鳳山區,1453,560,265,825,44,869,1499,57.97%,37.36%,1
高雄市,鳳山區,1454,599,237,836,26,862,1522,56.64%,39.36%,1
高雄市,鳳山區,1455,530,183,713,29,742,1125,65.96%,47.11%,1
高雄市,鳳山區,1456,598,191,789,16,805,1307,61.59%,45.75%,1
高雄市,鳳山區,1457,556,230,786,35,821,1405,58.43%,39.57%,1
高雄市,鳳山區,1458,555,193,748,32,780,1252,62.3%,44.33%,1
高雄市,鳳山區,1459,620,191,811,16,827,1291,64.06%,48.02%,1
高雄市,鳳山區,1460,450,129,579,31,610,938,65.03%,47.97%,1
高雄市,鳳山區,1461,797,260,1057,20,1077,1783,60.4%,44.7%,1
高雄市,鳳山區,1462,537,149,686,21,707,1105,63.98%,48.6%,1
高雄市,鳳山區,1463,615,180,795,41,836,1392,60.06%,44.18%,1
高雄市,鳳山區,1464,620,188,808,25,833,1244,66.96%,49.84%,1
高雄市,鳳山區,1465,466,181,647,26,673,1154,58.32%,40.38%,1
高雄市,鳳山區,1466,487,189,676,30,706,1153,61.23%,42.24%,1
高雄市,鳳山區,1467,441,195,636,13,649,1148,56.53%,38.41%,1
高雄市,鳳山區,1468,624,157,781,46,827,1432,57.75%,43.58%,1
高雄市,鳳山區,1469,456,183,639,17,656,1429,45.91%,31.91%,1
高雄市,鳳山區,1470,641,210,851,20,871,1479,58.89%,43.34%,1
高雄市,鳳山區,1471,504,146,650,20,670,1026,65.3%,49.12%,1
高雄市,鳳山區,1472,483,157,640,39,679,993,68.38%,48.64%,1
高雄市,鳳山區,1473,445,143,588,29,617,947,65.15%,46.99%,1
高雄市,鳳山區,1474,473,148,621,27,648,1042,62.19%,45.39%,1
高雄市,鳳山區,1475,485,154,639,31,670,1098,61.02%,44.17%,1
高雄市,鳳山區,1476,517,181,698,24,722,1284,56.23%,40.26%,1
高雄市,鳳山區,1477,497,181,678,30,708,1242,57%,40.02%,1
高雄市,鳳山區,1478,492,179,671,33,704,1093,64.41%,45.01%,1
高雄市,鳳山區,1479,558,196,754,30,784,1353,57.95%,41.24%,1
高雄市,鳳山區,1480,573,193,766,19,785,1353,58.02%,42.35%,1
高雄市,鳳山區,1481,554,216,770,37,807,1309,61.65%,42.32%,1
高雄市,鳳山區,1482,633,304,937,40,977,1627,60.05%,38.91%,1
高雄市,鳳山區,1483,610,199,809,48,857,1372,62.46%,44.46%,1
高雄市,林園區,1773,547,188,735,37,772,1262,61.17%,43.34%,1
高雄市,林園區,1774,603,213,816,38,854,1562,54.67%,38.6%,1
高雄市,林園區,1775,458,168,626,17,643,1078,59.65%,42.49%,1
高雄市,林園區,1776,447,154,601,27,628,979,64.15%,45.66%,1
高雄市,林園區,1777,487,166,653,28,681,1195,56.99%,40.75%,1
高雄市,林園區,1778,555,165,720,38,758,1380,54.93%,40.22%,1
高雄市,林園區,1779,520,175,695,37,732,1280,57.19%,40.63%,1
高雄市,林園區,1780,528,195,723,14,737,1269,58.08%,41.61%,1
高雄市,林園區,1781,504,186,690,15,705,1568,44.96%,32.14%,1
高雄市,林園區,1782,536,177,713,27,740,1226,60.36%,43.72%,1
高雄市,林園區,1783,618,170,788,36,824,1480,55.68%,41.76%,1
高雄市,林園區,1784,630,188,818,46,864,1459,59.22%,43.18%,1
高雄市,林園區,1785,592,225,817,36,853,1593,53.55%,37.16%,1
高雄市,林園區,1786,366,121,487,60,547,895,61.12%,40.89%,1
高雄市,林園區,1787,443,129,572,12,584,1110,52.61%,39.91%,1
高雄市,林園區,1788,519,178,697,36,733,1348,54.38%,38.5%,1
高雄市,林園區,1789,386,126,512,39,551,912,60.42%,42.32%,1
高雄市,林園區,1790,507,156,663,43,706,1085,65.07%,46.73%,1
高雄市,林園區,1791,415,127,542,18,560,955,58.64%,43.46%,1
高雄市,林園區,1792,388,126,514,35,549,879,62.46%,44.14%,1
高雄市,林園區,1793,465,137,602,36,638,1103,57.84%,42.16%,1
高雄市,林園區,1794,505,141,646,40,686,1054,65.09%,47.91%,1
高雄市,林園區,1795,499,156,655,15,670,1292,51.86%,38.62%,1
高雄市,林園區,1796,609,213,822,18,840,1683,49.91%,36.19%,1
高雄市,林園區,1797,273,62,335,21,356,607,58.65%,44.98%,1
高雄市,林園區,1798,416,130,546,50,596,1012,58.89%,41.11%,1
高雄市,林園區,1799,447,141,588,34,622,1046,59.46%,42.73%,1
高雄市,林園區,1800,340,88,428,19,447,914,48.91%,37.2%,1
高雄市,林園區,1801,564,244,808,36,844,1405,60.07%,40.14%,1
高雄市,林園區,1802,535,269,804,36,840,1299,64.67%,41.19%,1
高雄市,林園區,1803,500,156,656,26,682,1170,58.29%,42.74%,1
高雄市,林園區,1804,436,174,610,28,638,1299,49.11%,33.56%,1
高雄市,林園區,1805,437,145,582,17,599,1031,58.1%,42.39%,1
高雄市,林園區,1806,360,107,467,16,483,849,56.89%,42.4%,1
高雄市,林園區,1807,341,123,464,31,495,838,59.07%,40.69%,1
高雄市,林園區,1808,413,125,538,24,562,938,59.91%,44.03%,1
高雄市,林園區,1809,430,130,560,17,577,1051,54.9%,40.91%,1
高雄市,林園區,1810,351,110,461,24,485,786,61.7%,44.66%,1
高雄市,林園區,1811,424,101,525,36,561,894,62.75%,47.43%,1
高雄市,林園區,1812,259,72,331,13,344,749,45.93%,34.58%,1
高雄市,林園區,1813,671,209,880,24,904,1485,60.88%,45.19%,1
高雄市,林園區,1814,645,214,859,48,907,1478,61.37%,43.64%,1
高雄市,林園區,1815,605,236,841,38,879,1345,65.35%,44.98%,1
高雄市,林園區,1816,411,142,553,25,578,1038,55.68%,39.6%,1
高雄市,林園區,1817,493,187,680,18,698,1203,58.02%,40.98%,1
高雄市,林園區,1818,496,157,653,10,663,1138,58.26%,43.59%,1
高雄市,林園區,1819,392,123,515,13,528,1025,51.51%,38.24%,1
高雄市,林園區,1820,556,174,730,63,793,1341,59.13%,41.46%,1
高雄市,林園區,1821,440,136,576,14,590,1218,48.44%,36.12%,1
高雄市,林園區,1822,436,115,551,14,565,1147,49.26%,38.01%,1
高雄市,林園區,1823,456,118,574,22,596,1176,50.68%,38.78%,1
高雄市,大寮區,1692,282,91,373,21,394,727,54.2%,38.79%,1
高雄市,大寮區,1693,247,113,360,10,370,718,51.53%,34.4%,1
高雄市,大寮區,1694,547,155,702,27,729,1340,54.4%,40.82%,1
高雄市,大寮區,1695,549,187,736,20,756,1575,48%,34.86%,1
高雄市,大寮區,1696,197,58,255,11,266,444,59.91%,44.37%,1
高雄市,大寮區,1697,793,240,1033,30,1063,2374,44.78%,33.4%,1
高雄市,大寮區,1698,544,147,691,40,731,1291,56.62%,42.14%,1
高雄市,大寮區,1699,597,167,764,56,820,1400,58.57%,42.64%,1
高雄市,大寮區,1700,676,106,782,14,796,1390,57.27%,48.63%,1
高雄市,大寮區,1701,546,180,726,59,785,1401,56.03%,38.97%,1
高雄市,大寮區,1702,483,134,617,23,640,1199,53.38%,40.28%,1
高雄市,大寮區,1703,459,154,613,19,632,1210,52.23%,37.93%,1
高雄市,大寮區,1704,504,137,641,23,664,1195,55.56%,42.18%,1
高雄市,大寮區,1705,515,151,666,17,683,1166,58.58%,44.17%,1
高雄市,大寮區,1706,575,193,768,23,791,1353,58.46%,42.5%,1
高雄市,大寮區,1707,445,170,615,33,648,1052,61.6%,42.3%,1
高雄市,大寮區,1708,393,122,515,19,534,1024,52.15%,38.38%,1
高雄市,大寮區,1709,454,252,706,17,723,1189,60.81%,38.18%,1
高雄市,大寮區,1710,658,215,873,43,916,1512,60.58%,43.52%,1
高雄市,大寮區,1711,644,207,851,37,888,1633,54.38%,39.44%,1
高雄市,大寮區,1712,599,182,781,20,801,1214,65.98%,49.34%,1
高雄市,大寮區,1713,609,191,800,43,843,1258,67.01%,48.41%,1
高雄市,大寮區,1714,645,202,847,17,864,1323,65.31%,48.75%,1
高雄市,大寮區,1715,588,177,765,18,783,1253,62.49%,46.93%,1
高雄市,大寮區,1716,492,141,633,27,660,1035,63.77%,47.54%,1
高雄市,大寮區,1717,499,138,637,18,655,1106,59.22%,45.12%,1
高雄市,大寮區,1718,528,146,674,15,689,1195,57.66%,44.18%,1
高雄市,大寮區,1719,503,144,647,15,662,1051,62.99%,47.86%,1
高雄市,大寮區,1720,605,208,813,46,859,1425,60.28%,42.46%,1
高雄市,大寮區,1721,665,222,887,32,919,1635,56.21%,40.67%,1
高雄市,大寮區,1722,609,176,785,29,814,1359,59.9%,44.81%,1
高雄市,大寮區,1723,601,176,777,37,814,1361,59.81%,44.16%,1
高雄市,大寮區,1724,693,222,915,26,941,1629,57.77%,42.54%,1
高雄市,大寮區,1725,674,195,869,19,888,1518,58.5%,44.4%,1
高雄市,大寮區,1726,699,197,896,40,936,1620,57.78%,43.15%,1
高雄市,大寮區,1727,679,207,886,18,904,1648,54.85%,41.2%,1
高雄市,大寮區,1728,622,188,810,25,835,1385,60.29%,44.91%,1
高雄市,大寮區,1729,573,217,790,16,806,1435,56.17%,39.93%,1
高雄市,大寮區,1730,467,136,603,16,619,1046,59.18%,44.65%,1
高雄市,大寮區,1731,310,93,403,25,428,789,54.25%,39.29%,1
高雄市,大寮區,1732,357,115,472,20,492,909,54.13%,39.27%,1
高雄市,大寮區,1733,312,104,416,27,443,733,60.44%,42.56%,1
高雄市,大寮區,1734,601,219,820,38,858,1553,55.25%,38.7%,1
高雄市,大寮區,1735,391,117,508,23,531,922,57.59%,42.41%,1
高雄市,大寮區,1736,443,117,560,36,596,1012,58.89%,43.77%,1
高雄市,大寮區,1737,400,119,519,32,551,968,56.92%,41.32%,1
高雄市,大寮區,1738,449,168,617,15,632,1021,61.9%,43.98%,1
高雄市,大寮區,1739,555,177,732,41,773,1554,49.74%,35.71%,1
高雄市,大寮區,1740,521,144,665,28,693,1120,61.88%,46.52%,1
高雄市,大寮區,1741,557,183,740,27,767,1225,62.61%,45.47%,1
高雄市,大寮區,1742,380,121,501,14,515,1320,39.02%,28.79%,1
高雄市,大寮區,1743,564,169,733,32,765,1317,58.09%,42.82%,1
高雄市,大寮區,1744,449,176,625,16,641,1119,57.28%,40.13%,1
高雄市,大寮區,1745,543,165,708,23,731,1190,61.43%,45.63%,1
高雄市,大寮區,1746,560,176,736,25,761,1229,61.92%,45.57%,1
高雄市,大寮區,1747,559,175,734,22,756,1178,64.18%,47.45%,1
高雄市,大寮區,1748,574,204,778,20,798,1272,62.74%,45.13%,1
高雄市,大寮區,1749,608,188,796,15,811,1413,57.4%,43.03%,1
高雄市,大寮區,1750,551,164,715,25,740,1185,62.45%,46.5%,1
高雄市,大寮區,1751,260,64,324,4,328,553,59.31%,47.02%,1
高雄市,大寮區,1752,456,131,587,47,634,1121,56.56%,40.68%,1
高雄市,大寮區,1753,490,216,706,23,729,1227,59.41%,39.93%,1
高雄市,大寮區,1754,528,160,688,27,715,1058,67.58%,49.91%,1
高雄市,大寮區,1755,507,176,683,13,696,1209,57.57%,41.94%,1
高雄市,大寮區,1756,521,140,661,16,677,1100,61.55%,47.36%,1
高雄市,大寮區,1757,457,156,613,18,631,1122,56.24%,40.73%,1
高雄市,大寮區,1758,462,141,603,44,647,983,65.82%,47%,1
高雄市,大寮區,1759,512,127,639,10,649,1192,54.45%,42.95%,1
高雄市,大寮區,1760,361,83,444,19,463,719,64.39%,50.21%,1
高雄市,大寮區,1761,416,118,534,29,563,829,67.91%,50.18%,1
高雄市,大寮區,1762,411,98,509,24,533,771,69.13%,53.31%,1
高雄市,大寮區,1763,487,172,659,30,689,1075,64.09%,45.3%,1
高雄市,大寮區,1764,587,163,750,49,799,1280,62.42%,45.86%,1
高雄市,大寮區,1765,521,150,671,30,701,1179,59.46%,44.19%,1
高雄市,大寮區,1766,515,153,668,23,691,1210,57.11%,42.56%,1
高雄市,大寮區,1767,98,18,116,4,120,189,63.49%,51.85%,1
高雄市,大寮區,1768,562,157,719,40,759,1228,61.81%,45.77%,1
高雄市,大寮區,1769,542,124,666,20,686,1170,58.63%,46.32%,1
高雄市,大寮區,1770,657,197,854,27,881,1416,62.22%,46.4%,1
高雄市,大寮區,1771,654,243,897,16,913,1482,61.61%,44.13%,1
高雄市,大寮區,1772,198,599,797,29,826,1478,55.89%,13.4%,1
高雄市,大樹區,0736,581,199,780,23,803,1386,57.94%,41.92%,1
高雄市,大樹區,0737,649,191,840,22,862,1315,65.55%,49.35%,1
高雄市,大樹區,0738,1057,282,1339,35,1374,2461,55.83%,42.95%,1
高雄市,大樹區,0739,554,179,733,13,746,1274,58.56%,43.49%,1
高雄市,大樹區,0740,517,164,681,41,722,1265,57.08%,40.87%,1
高雄市,大樹區,0741,623,197,820,34,854,1504,56.78%,41.42%,1
高雄市,大樹區,0742,405,155,560,13,573,1049,54.62%,38.61%,1
高雄市,大樹區,0743,613,226,839,35,874,1573,55.56%,38.97%,1
高雄市,大樹區,0744,431,127,558,27,585,1121,52.19%,38.45%,1
高雄市,大樹區,0745,552,60,612,31,643,1207,53.27%,45.73%,1
高雄市,大樹區,0746,502,143,645,14,659,1134,58.11%,44.27%,1
高雄市,大樹區,0747,522,169,691,17,708,1124,62.99%,46.44%,1
高雄市,大樹區,0748,530,163,693,35,728,1259,57.82%,42.1%,1
高雄市,大樹區,0749,482,176,658,40,698,1105,63.17%,43.62%,1
高雄市,大樹區,0750,465,156,621,32,653,1128,57.89%,41.22%,1
高雄市,大樹區,0751,415,129,544,62,606,1079,56.16%,38.46%,1
高雄市,大樹區,0752,388,120,508,35,543,1025,52.98%,37.85%,1
高雄市,大樹區,0753,381,118,499,33,532,950,56%,40.11%,1
高雄市,大樹區,0754,565,180,745,70,815,1433,56.87%,39.43%,1
高雄市,大樹區,0755,322,97,419,15,434,794,54.66%,40.55%,1
高雄市,大樹區,0756,273,93,366,7,373,781,47.76%,34.96%,1
高雄市,大樹區,0757,499,154,653,14,667,1318,50.61%,37.86%,1
高雄市,大樹區,0758,299,92,391,25,416,736,56.52%,40.63%,1
高雄市,大樹區,0759,371,133,504,15,519,1047,49.57%,35.43%,1
高雄市,大樹區,0760,540,176,716,41,757,1271,59.56%,42.49%,1
高雄市,大樹區,0761,447,147,594,25,619,1186,52.19%,37.69%,1
高雄市,大樹區,0762,424,124,548,39,587,1007,58.29%,42.11%,1
高雄市,大樹區,0763,366,124,490,32,522,859,60.77%,42.61%,1
高雄市,大樹區,0764,291,81,372,11,383,735,52.11%,39.59%,1
高雄市,大樹區,0765,477,138,615,39,654,1046,62.52%,45.6%,1
高雄市,大樹區,0766,552,78,630,22,652,880,74.09%,62.73%,1
高雄市,大樹區,0767,330,54,384,13,397,720,55.14%,45.83%,1
高雄市,大社區,0637,384,109,493,54,547,950,57.58%,40.42%,1
高雄市,大社區,0638,510,194,704,23,727,1306,55.67%,39.05%,1
高雄市,大社區,0639,603,231,834,18,852,1856,45.91%,32.49%,1
高雄市,大社區,0640,429,190,619,27,646,986,65.52%,43.51%,1
高雄市,大社區,0641,403,140,543,30,573,1116,51.34%,36.11%,1
高雄市,大社區,0642,578,208,786,29,815,1253,65.04%,46.13%,1
高雄市,大社區,0643,731,215,946,31,977,1613,60.57%,45.32%,1
高雄市,大社區,0644,552,203,755,30,785,1455,53.95%,37.94%,1
高雄市,大社區,0645,744,259,1003,37,1040,1674,62.13%,44.44%,1
高雄市,大社區,0646,451,132,583,35,618,1004,61.55%,44.92%,1
高雄市,大社區,0647,385,125,510,31,541,879,61.55%,43.8%,1
高雄市,大社區,0648,308,139,447,13,460,778,59.13%,39.59%,1
高雄市,大社區,0649,463,181,644,37,681,1110,61.35%,41.71%,1
高雄市,大社區,0650,573,208,781,37,818,1432,57.12%,40.01%,1
高雄市,大社區,0651,643,233,876,35,911,1466,62.14%,43.86%,1
高雄市,大社區,0652,610,235,845,43,888,1383,64.21%,44.11%,1
高雄市,大社區,0653,702,246,948,43,991,1645,60.24%,42.67%,1
高雄市,大社區,0654,547,241,788,28,816,1555,52.48%,35.18%,1
高雄市,大社區,0655,679,307,986,37,1023,1750,58.46%,38.8%,1
高雄市,大社區,0656,442,182,624,43,667,1111,60.04%,39.78%,1
高雄市,大社區,0657,482,74,556,36,592,1133,52.25%,42.54%,1
高雄市,大社區,0658,393,140,533,28,561,912,61.51%,43.09%,1
高雄市,大社區,0659,265,93,358,17,375,745,50.34%,35.57%,1
高雄市,大社區,0660,413,145,558,16,574,934,61.46%,44.22%,1
高雄市,仁武區,0661,906,265,1171,26,1197,1777,67.36%,50.98%,1
高雄市,仁武區,0662,1026,348,1374,30,1404,2273,61.77%,45.14%,1
高雄市,仁武區,0663,669,221,890,37,927,1384,66.98%,48.34%,1
高雄市,仁武區,0664,513,152,665,31,696,1170,59.49%,43.85%,1
高雄市,仁武區,0665,580,208,788,33,821,1216,67.52%,47.7%,1
高雄市,仁武區,0666,665,236,901,17,918,1598,57.45%,41.61%,1
高雄市,仁武區,0667,1017,336,1353,19,1372,2143,64.02%,47.46%,1
高雄市,仁武區,0668,511,213,724,30,754,1300,58%,39.31%,1
高雄市,仁武區,0669,588,193,781,45,826,1338,61.73%,43.95%,1
高雄市,仁武區,0670,493,173,666,22,688,1217,56.53%,40.51%,1
高雄市,仁武區,0671,466,116,582,40,622,1202,51.75%,38.77%,1
高雄市,仁武區,0672,563,185,748,36,784,1404,55.84%,40.1%,1
高雄市,仁武區,0673,369,97,466,16,482,830,58.07%,44.46%,1
高雄市,仁武區,0674,650,158,808,26,834,1802,46.28%,36.07%,1
高雄市,仁武區,0675,731,256,987,34,1021,1877,54.4%,38.95%,1
高雄市,仁武區,0676,621,226,847,17,864,1738,49.71%,35.73%,1
高雄市,仁武區,0677,648,217,865,45,910,1549,58.75%,41.83%,1
高雄市,仁武區,0678,693,235,928,25,953,1579,60.35%,43.89%,1
高雄市,仁武區,0679,633,156,789,21,810,1406,57.61%,45.02%,1
高雄市,仁武區,0680,674,197,871,16,887,1461,60.71%,46.13%,1
高雄市,仁武區,0681,595,206,801,22,823,1311,62.78%,45.39%,1
高雄市,仁武區,0682,596,199,795,11,806,1373,58.7%,43.41%,1
高雄市,仁武區,0683,439,160,599,12,611,1035,59.03%,42.42%,1
高雄市,仁武區,0684,507,163,670,21,691,1181,58.51%,42.93%,1
高雄市,仁武區,0685,651,260,911,35,946,1670,56.65%,38.98%,1
高雄市,仁武區,0686,649,245,894,15,909,1576,57.68%,41.18%,1
高雄市,仁武區,0687,687,260,947,36,983,1576,62.37%,43.59%,1
高雄市,仁武區,0688,904,282,1186,20,1206,1915,62.98%,47.21%,1
高雄市,仁武區,0689,770,231,1001,19,1020,1758,58.02%,43.8%,1
高雄市,仁武區,0690,865,306,1171,27,1198,1892,63.32%,45.72%,1
高雄市,仁武區,0691,905,279,1184,45,1229,2025,60.69%,44.69%,1
高雄市,仁武區,0692,928,309,1237,19,1256,2014,62.36%,46.08%,1
高雄市,仁武區,0693,713,273,986,22,1008,1473,68.43%,48.4%,1
高雄市,仁武區,0694,440,138,578,23,601,979,61.39%,44.94%,1
高雄市,仁武區,0695,448,123,571,14,585,944,61.97%,47.46%,1
高雄市,仁武區,0696,518,149,667,46,713,1153,61.84%,44.93%,1
高雄市,仁武區,0697,569,159,728,26,754,1328,56.78%,42.85%,1
高雄市,仁武區,0698,736,225,961,42,1003,1657,60.53%,44.42%,1
高雄市,仁武區,0699,607,201,808,25,833,1545,53.92%,39.29%,1
高雄市,仁武區,0700,572,299,871,27,898,1417,63.37%,40.37%,1
高雄市,仁武區,0701,762,253,1015,18,1033,1602,64.48%,47.57%,1
高雄市,仁武區,0702,881,277,1158,31,1189,1823,65.22%,48.33%,1
高雄市,仁武區,0703,780,220,1000,21,1021,1914,53.34%,40.75%,1
高雄市,仁武區,0704,877,291,1168,31,1199,1992,60.19%,44.03%,1
高雄市,仁武區,0705,795,261,1056,18,1074,2045,52.52%,38.88%,1
高雄市,仁武區,0706,869,328,1197,31,1228,1982,61.96%,43.84%,1
高雄市,仁武區,0707,784,314,1098,21,1119,2167,51.64%,36.18%,1
高雄市,鳥松區,0708,683,281,964,34,998,1678,59.48%,40.7%,1
高雄市,鳥松區,0709,659,242,901,35,936,1682,55.65%,39.18%,1
高雄市,鳥松區,0710,567,198,765,30,795,1225,64.9%,46.29%,1
高雄市,鳥松區,0711,498,198,696,37,733,1322,55.45%,37.67%,1
高雄市,鳥松區,0712,532,192,724,21,745,1215,61.32%,43.79%,1
高雄市,鳥松區,0713,699,270,969,21,990,1779,55.65%,39.29%,1
高雄市,鳥松區,0714,391,340,731,15,746,1129,66.08%,34.63%,1
高雄市,鳥松區,0715,630,210,840,28,868,1374,63.17%,45.85%,1
高雄市,鳥松區,0716,477,181,658,17,675,1089,61.98%,43.8%,1
高雄市,鳥松區,0717,893,439,1332,42,1374,2219,61.92%,40.24%,1
高雄市,鳥松區,0718,686,285,971,19,990,1634,60.59%,41.98%,1
高雄市,鳥松區,0719,688,266,954,40,994,1553,64.01%,44.3%,1
高雄市,鳥松區,0720,677,293,970,33,1003,1572,63.8%,43.07%,1
高雄市,鳥松區,0721,715,332,1047,27,1074,1688,63.63%,42.36%,1
高雄市,鳥松區,0722,691,326,1017,20,1037,1626,63.78%,42.5%,1
高雄市,鳥松區,0723,774,320,1094,36,1130,1744,64.79%,44.38%,1
高雄市,鳥松區,0724,536,133,669,31,700,1230,56.91%,43.58%,1
高雄市,鳥松區,0725,532,197,729,49,778,1201,64.78%,44.3%,1
高雄市,鳥松區,0726,581,145,726,19,745,1117,66.7%,52.01%,1
高雄市,鳥松區,0727,578,149,727,31,758,1255,60.4%,46.06%,1
高雄市,鳥松區,0728,580,168,748,33,781,1432,54.54%,40.5%,1
高雄市,鳥松區,0729,573,157,730,20,750,1370,54.74%,41.82%,1
高雄市,鳥松區,0730,634,202,836,26,862,1364,63.2%,46.48%,1
高雄市,鳥松區,0731,535,114,649,33,682,1041,65.51%,51.39%,1
高雄市,鳥松區,0732,363,119,482,30,512,702,72.93%,51.71%,1
高雄市,鳥松區,0733,533,176,709,35,744,1212,61.39%,43.98%,1
高雄市,鳥松區,0734,588,150,738,31,769,1289,59.66%,45.62%,1
高雄市,鳥松區,0735,687,234,921,22,943,1449,65.08%,47.41%,1
高雄市,岡山區,0261,644,225,869,24,893,1345,66.39%,47.88%,1
高雄市,岡山區,0262,377,122,499,14,513,1045,49.09%,36.08%,1
高雄市,岡山區,0263,474,153,627,18,645,1051,61.37%,45.1%,1
高雄市,岡山區,0264,411,153,564,13,577,917,62.92%,44.82%,1
高雄市,岡山區,0265,429,175,604,17,621,934,66.49%,45.93%,1
高雄市,岡山區,0266,519,152,671,23,694,1097,63.26%,47.31%,1
高雄市,岡山區,0267,588,195,783,24,807,1208,66.8%,48.68%,1
高雄市,岡山區,0268,550,184,734,42,776,1159,66.95%,47.45%,1
高雄市,岡山區,0269,435,169,604,25,629,1018,61.79%,42.73%,1
高雄市,岡山區,0270,627,76,703,25,728,1316,55.32%,47.64%,1
高雄市,岡山區,0271,592,201,793,22,815,1345,60.59%,44.01%,1
高雄市,岡山區,0272,598,186,784,28,812,1295,62.7%,46.18%,1
高雄市,岡山區,0273,606,214,820,29,849,1425,59.58%,42.53%,1
高雄市,岡山區,0274,577,199,776,18,794,1328,59.79%,43.45%,1
高雄市,岡山區,0275,628,218,846,13,859,1382,62.16%,45.44%,1
高雄市,岡山區,0276,634,207,841,14,855,1381,61.91%,45.91%,1
高雄市,岡山區,0277,540,204,744,37,781,1282,60.92%,42.12%,1
高雄市,岡山區,0278,536,183,719,12,731,1240,58.95%,43.23%,1
高雄市,岡山區,0279,563,214,777,31,808,1327,60.89%,42.43%,1
高雄市,岡山區,0280,663,282,945,30,975,1736,56.16%,38.19%,1
高雄市,岡山區,0281,683,226,909,38,947,1566,60.47%,43.61%,1
高雄市,岡山區,0282,664,247,911,19,930,1779,52.28%,37.32%,1
高雄市,岡山區,0283,675,262,937,27,964,1593,60.51%,42.37%,1
高雄市,岡山區,0284,690,212,902,29,931,1480,62.91%,46.62%,1
高雄市,岡山區,0285,636,183,819,16,835,1364,61.22%,46.63%,1
高雄市,岡山區,0286,667,184,851,21,872,1410,61.84%,47.3%,1
高雄市,岡山區,0287,616,156,772,21,793,1148,69.08%,53.66%,1
高雄市,岡山區,0288,301,96,397,22,419,625,67.04%,48.16%,1
高雄市,岡山區,0289,451,135,586,16,602,969,62.13%,46.54%,1
高雄市,岡山區,0290,400,141,541,16,557,861,64.69%,46.46%,1
高雄市,岡山區,0291,343,111,454,17,471,823,57.23%,41.68%,1
高雄市,岡山區,0292,438,137,575,35,610,889,68.62%,49.27%,1
高雄市,岡山區,0293,569,185,754,25,779,1283,60.72%,44.35%,1
高雄市,岡山區,0294,628,214,842,30,872,1512,57.67%,41.53%,1
高雄市,岡山區,0295,471,170,641,31,672,983,68.36%,47.91%,1
高雄市,岡山區,0296,540,201,741,20,761,1262,60.3%,42.79%,1
高雄市,岡山區,0297,505,155,660,29,689,1096,62.86%,46.08%,1
高雄市,岡山區,0298,464,167,631,20,651,1066,61.07%,43.53%,1
高雄市,岡山區,0299,482,169,651,17,668,1188,56.23%,40.57%,1
高雄市,岡山區,0300,616,217,833,29,862,1360,63.38%,45.29%,1
高雄市,岡山區,0301,656,211,867,17,884,1363,64.86%,48.13%,1
高雄市,岡山區,0302,616,227,843,34,877,1352,64.87%,45.56%,1
高雄市,岡山區,0303,640,202,842,27,869,1460,59.52%,43.84%,1
高雄市,岡山區,0304,549,207,756,32,788,1272,61.95%,43.16%,1
高雄市,岡山區,0305,517,161,678,20,698,1080,64.63%,47.87%,1
高雄市,岡山區,0306,544,190,734,47,781,1255,62.23%,43.35%,1
高雄市,岡山區,0307,466,135,601,28,629,938,67.06%,49.68%,1
高雄市,岡山區,0308,608,167,775,20,795,1237,64.27%,49.15%,1
高雄市,岡山區,0309,622,184,806,14,820,1413,58.03%,44.02%,1
高雄市,岡山區,0310,356,115,471,7,478,765,62.48%,46.54%,1
高雄市,岡山區,0311,505,174,679,16,695,1043,66.63%,48.42%,1
高雄市,岡山區,0312,392,89,481,26,507,844,60.07%,46.45%,1
高雄市,岡山區,0313,522,177,699,33,732,993,73.72%,52.57%,1
高雄市,岡山區,0314,469,165,634,39,673,1038,64.84%,45.18%,1
高雄市,岡山區,0315,466,147,613,57,670,1070,62.62%,43.55%,1
高雄市,岡山區,0316,495,168,663,35,698,1023,68.23%,48.39%,1
高雄市,岡山區,0317,604,188,792,30,822,1349,60.93%,44.77%,1
高雄市,岡山區,0318,569,197,766,40,806,1452,55.51%,39.19%,1
高雄市,岡山區,0319,142,50,192,14,206,301,68.44%,47.18%,1
高雄市,岡山區,0320,359,106,465,52,517,756,68.39%,47.49%,1
高雄市,岡山區,0321,306,92,398,16,414,733,56.48%,41.75%,1
高雄市,岡山區,0322,433,112,545,58,603,854,70.61%,50.7%,1
高雄市,岡山區,0323,362,83,445,13,458,866,52.89%,41.8%,1
高雄市,岡山區,0324,342,105,447,38,485,978,49.59%,34.97%,1
高雄市,岡山區,0325,620,175,795,26,821,1336,61.45%,46.41%,1
高雄市,岡山區,0326,642,133,775,7,782,1218,64.2%,52.71%,1
高雄市,岡山區,0327,181,71,252,7,259,341,75.95%,53.08%,1
高雄市,岡山區,0328,571,117,688,27,715,955,74.87%,59.79%,1
高雄市,岡山區,0329,539,104,643,12,655,940,69.68%,57.34%,1
高雄市,岡山區,0330,421,135,556,20,576,851,67.69%,49.47%,1
高雄市,岡山區,0331,426,103,529,9,538,762,70.6%,55.91%,1
高雄市,岡山區,0332,173,62,235,6,241,318,75.79%,54.4%,1
高雄市,橋頭區,0404,471,173,644,38,682,1005,67.86%,46.87%,1
高雄市,橋頭區,0405,477,180,657,29,686,1073,63.93%,44.45%,1
高雄市,橋頭區,0406,550,174,724,18,742,1129,65.72%,48.72%,1
高雄市,橋頭區,0407,558,205,763,43,806,1244,64.79%,44.86%,1
高雄市,橋頭區,0408,488,158,646,23,669,1091,61.32%,44.73%,1
高雄市,橋頭區,0409,643,206,849,34,883,1329,66.44%,48.38%,1
高雄市,橋頭區,0410,500,199,699,24,723,1140,63.42%,43.86%,1
高雄市,橋頭區,0411,556,170,726,43,769,1220,63.03%,45.57%,1
高雄市,橋頭區,0412,518,170,688,26,714,1047,68.19%,49.47%,1
高雄市,橋頭區,0413,552,198,750,48,798,1315,60.68%,41.98%,1
高雄市,橋頭區,0414,301,116,417,18,435,691,62.95%,43.56%,1
高雄市,橋頭區,0415,364,94,458,29,487,720,67.64%,50.56%,1
高雄市,橋頭區,0416,516,204,720,31,751,1192,63%,43.29%,1
高雄市,橋頭區,0417,622,210,832,17,849,1318,64.42%,47.19%,1
高雄市,橋頭區,0418,362,105,467,31,498,761,65.44%,47.57%,1
高雄市,橋頭區,0419,460,153,613,13,626,973,64.34%,47.28%,1
高雄市,橋頭區,0420,257,90,347,19,366,587,62.35%,43.78%,1
高雄市,橋頭區,0421,402,105,507,25,532,812,65.52%,49.51%,1
高雄市,橋頭區,0422,160,56,216,6,222,343,64.72%,46.65%,1
高雄市,橋頭區,0423,544,264,808,12,820,1266,64.77%,42.97%,1
高雄市,橋頭區,0424,547,154,701,43,744,1128,65.96%,48.49%,1
高雄市,橋頭區,0425,438,107,545,24,569,884,64.37%,49.55%,1
高雄市,橋頭區,0426,496,165,661,35,696,1187,58.64%,41.79%,1
高雄市,橋頭區,0427,604,159,763,19,782,1259,62.11%,47.97%,1
高雄市,橋頭區,0428,562,172,734,25,759,1361,55.77%,41.29%,1
高雄市,橋頭區,0429,290,85,375,15,390,671,58.12%,43.22%,1
高雄市,橋頭區,0430,567,176,743,38,781,1215,64.28%,46.67%,1
高雄市,橋頭區,0431,602,177,779,35,814,1255,64.86%,47.97%,1
高雄市,橋頭區,0432,555,212,767,32,799,1219,65.55%,45.53%,1
高雄市,橋頭區,0433,595,204,799,26,825,1372,60.13%,43.37%,1
高雄市,橋頭區,0434,375,102,477,13,490,758,64.64%,49.47%,1
高雄市,燕巢區,0333,474,129,603,60,663,1152,57.55%,41.15%,1
高雄市,燕巢區,0334,509,152,661,14,675,1120,60.27%,45.45%,1
高雄市,燕巢區,0335,475,133,608,43,651,974,66.84%,48.77%,1
高雄市,燕巢區,0336,425,147,572,15,587,1019,57.61%,41.71%,1
高雄市,燕巢區,0337,439,141,580,31,611,1058,57.75%,41.49%,1
高雄市,燕巢區,0338,376,125,501,22,523,1017,51.43%,36.97%,1
高雄市,燕巢區,0339,42,2,44,2,46,259,17.76%,16.22%,1
高雄市,燕巢區,0340,459,128,587,34,621,926,67.06%,49.57%,1
高雄市,燕巢區,0341,264,75,339,14,353,624,56.57%,42.31%,1
高雄市,燕巢區,0342,544,154,698,28,726,1102,65.88%,49.36%,1
高雄市,燕巢區,0343,433,131,564,19,583,1072,54.38%,40.39%,1
高雄市,燕巢區,0344,543,201,744,52,796,1361,58.49%,39.9%,1
高雄市,燕巢區,0345,220,47,267,23,290,472,61.44%,46.61%,1
高雄市,燕巢區,0346,463,151,614,27,641,1197,53.55%,38.68%,1
高雄市,燕巢區,0347,527,155,682,53,735,1134,64.81%,46.47%,1
高雄市,燕巢區,0348,488,147,635,22,657,1148,57.23%,42.51%,1
高雄市,燕巢區,0349,469,137,606,49,655,1207,54.27%,38.86%,1
高雄市,燕巢區,0350,645,219,864,37,901,1402,64.27%,46.01%,1
高雄市,燕巢區,0351,314,259,573,37,610,1000,61%,31.4%,1
高雄市,燕巢區,0352,464,185,649,33,682,1110,61.44%,41.8%,1
高雄市,燕巢區,0353,545,179,724,26,750,1291,58.09%,42.22%,1
高雄市,燕巢區,0354,352,94,446,45,491,797,61.61%,44.17%,1
高雄市,燕巢區,0355,416,121,537,39,576,1098,52.46%,37.89%,1
高雄市,燕巢區,0356,533,179,712,42,754,1393,54.13%,38.26%,1
高雄市,燕巢區,0357,401,98,499,18,517,1079,47.91%,37.16%,1
高雄市,田寮區,0237,131,29,160,3,163,369,44.17%,35.5%,1
高雄市,田寮區,0238,221,56,277,12,289,656,44.05%,33.69%,1
高雄市,田寮區,0239,103,21,124,9,133,406,32.76%,25.37%,1
高雄市,田寮區,0240,144,39,183,14,197,380,51.84%,37.89%,1
高雄市,田寮區,0241,168,39,207,12,219,379,57.78%,44.33%,1
高雄市,田寮區,0242,291,37,328,34,362,625,57.92%,46.56%,1
高雄市,田寮區,0243,335,116,451,28,479,946,50.63%,35.41%,1
高雄市,田寮區,0244,294,63,357,28,385,794,48.49%,37.03%,1
高雄市,田寮區,0245,133,22,155,14,169,382,44.24%,34.82%,1
高雄市,田寮區,0246,134,41,175,30,205,513,39.96%,26.12%,1
高雄市,田寮區,0247,261,57,318,13,331,601,55.07%,43.43%,1
高雄市,田寮區,0248,265,76,341,35,376,620,60.65%,42.74%,1
高雄市,阿蓮區,0216,445,181,626,17,643,1299,49.5%,34.26%,1
高雄市,阿蓮區,0217,494,135,629,28,657,1107,59.35%,44.63%,1
高雄市,阿蓮區,0218,378,99,477,8,485,898,54.01%,42.09%,1
高雄市,阿蓮區,0219,483,152,635,57,692,1259,54.96%,38.36%,1
高雄市,阿蓮區,0220,587,231,818,28,846,1579,53.58%,37.18%,1
高雄市,阿蓮區,0221,246,76,322,6,328,564,58.16%,43.62%,1
高雄市,阿蓮區,0222,350,111,461,35,496,768,64.58%,45.57%,1
高雄市,阿蓮區,0223,475,141,616,27,643,1092,58.88%,43.5%,1
高雄市,阿蓮區,0224,463,134,597,34,631,1099,57.42%,42.13%,1
高雄市,阿蓮區,0225,467,165,632,14,646,1134,56.97%,41.18%,1
高雄市,阿蓮區,0226,594,211,805,10,815,1561,52.21%,38.05%,1
高雄市,阿蓮區,0227,600,253,853,51,904,1533,58.97%,39.14%,1
高雄市,阿蓮區,0228,412,146,558,22,580,1116,51.97%,36.92%,1
高雄市,阿蓮區,0229,438,141,579,20,599,1054,56.83%,41.56%,1
高雄市,阿蓮區,0230,508,162,670,29,699,1260,55.48%,40.32%,1
高雄市,阿蓮區,0231,562,197,759,45,804,1504,53.46%,37.37%,1
高雄市,阿蓮區,0232,329,98,427,8,435,848,51.3%,38.8%,1
高雄市,阿蓮區,0233,349,96,445,16,461,823,56.01%,42.41%,1
高雄市,阿蓮區,0234,485,96,581,26,607,1021,59.45%,47.5%,1
高雄市,阿蓮區,0235,616,243,859,26,885,1715,51.6%,35.92%,1
高雄市,阿蓮區,0236,518,152,670,32,702,1300,54%,39.85%,1
高雄市,路竹區,0175,434,116,550,15,565,1026,55.07%,42.3%,1
高雄市,路竹區,0176,459,133,592,40,632,1069,59.12%,42.94%,1
高雄市,路竹區,0177,475,172,647,44,691,1127,61.31%,42.15%,1
高雄市,路竹區,0178,517,134,651,32,683,1179,57.93%,43.85%,1
高雄市,路竹區,0179,509,150,659,43,702,1237,56.75%,41.15%,1
高雄市,路竹區,0180,462,159,621,37,658,1096,60.04%,42.15%,1
高雄市,路竹區,0181,600,169,769,42,811,1272,63.76%,47.17%,1
高雄市,路竹區,0182,520,153,673,32,705,1182,59.64%,43.99%,1
高雄市,路竹區,0183,506,125,631,25,656,1127,58.21%,44.9%,1
高雄市,路竹區,0184,415,136,551,26,577,956,60.36%,43.41%,1
高雄市,路竹區,0185,460,175,635,35,670,1132,59.19%,40.64%,1
高雄市,路竹區,0186,444,158,602,56,658,1025,64.2%,43.32%,1
高雄市,路竹區,0187,420,131,551,18,569,1007,56.5%,41.71%,1
高雄市,路竹區,0188,502,162,664,33,697,1301,53.57%,38.59%,1
高雄市,路竹區,0189,378,133,511,22,533,885,60.23%,42.71%,1
高雄市,路竹區,0190,316,101,417,10,427,837,51.02%,37.75%,1
高雄市,路竹區,0191,413,132,545,22,567,930,60.97%,44.41%,1
高雄市,路竹區,0192,295,101,396,25,421,781,53.91%,37.77%,1
高雄市,路竹區,0193,445,142,587,27,614,1023,60.02%,43.5%,1
高雄市,路竹區,0194,753,261,1014,50,1064,1763,60.35%,42.71%,1
高雄市,路竹區,0195,679,231,910,35,945,1637,57.73%,41.48%,1
高雄市,路竹區,0196,461,143,604,23,627,1070,58.6%,43.08%,1
高雄市,路竹區,0197,522,170,692,35,727,1177,61.77%,44.35%,1
高雄市,路竹區,0198,423,152,575,24,599,1007,59.48%,42.01%,1
高雄市,路竹區,0199,427,150,577,26,603,1026,58.77%,41.62%,1
高雄市,路竹區,0200,445,126,571,30,601,1017,59.1%,43.76%,1
高雄市,路竹區,0201,524,188,712,23,735,1264,58.15%,41.46%,1
高雄市,路竹區,0202,474,166,640,31,671,1089,61.62%,43.53%,1
高雄市,路竹區,0203,355,117,472,28,500,851,58.75%,41.72%,1
高雄市,路竹區,0204,442,172,614,26,640,1011,63.3%,43.72%,1
高雄市,路竹區,0205,462,138,600,16,616,937,65.74%,49.31%,1
高雄市,路竹區,0206,323,89,412,12,424,820,51.71%,39.39%,1
高雄市,路竹區,0207,412,168,580,19,599,910,65.82%,45.27%,1
高雄市,路竹區,0208,342,118,460,34,494,867,56.98%,39.45%,1
高雄市,路竹區,0209,405,127,532,33,565,937,60.3%,43.22%,1
高雄市,路竹區,0210,369,156,525,14,539,900,59.89%,41%,1
高雄市,路竹區,0211,406,127,533,30,563,900,62.56%,45.11%,1
高雄市,路竹區,0212,422,122,544,26,570,918,62.09%,45.97%,1
高雄市,路竹區,0213,409,132,541,27,568,870,65.29%,47.01%,1
高雄市,路竹區,0214,518,186,704,22,726,1150,63.13%,45.04%,1
高雄市,路竹區,0215,735,216,951,37,988,1537,64.28%,47.82%,1
高雄市,湖內區,0151,474,116,590,25,615,1112,55.31%,42.63%,1
高雄市,湖內區,0152,425,127,552,41,593,1017,58.31%,41.79%,1
高雄市,湖內區,0153,297,124,421,16,437,796,54.9%,37.31%,1
高雄市,湖內區,0154,480,174,654,23,677,1079,62.74%,44.49%,1
高雄市,湖內區,0155,476,173,649,15,664,1115,59.55%,42.69%,1
高雄市,湖內區,0156,533,163,696,24,720,1311,54.92%,40.66%,1
高雄市,湖內區,0157,518,170,688,21,709,1319,53.75%,39.27%,1
高雄市,湖內區,0158,583,174,757,33,790,1244,63.5%,46.86%,1
高雄市,湖內區,0159,581,171,752,68,820,1227,66.83%,47.35%,1
高雄市,湖內區,0160,515,163,678,38,716,1163,61.56%,44.28%,1
高雄市,湖內區,0161,455,126,581,16,597,981,60.86%,46.38%,1
高雄市,湖內區,0162,315,102,417,18,435,780,55.77%,40.38%,1
高雄市,湖內區,0163,367,90,457,30,487,832,58.53%,44.11%,1
高雄市,湖內區,0164,468,149,617,25,642,1017,63.13%,46.02%,1
高雄市,湖內區,0165,443,171,614,14,628,1051,59.75%,42.15%,1
高雄市,湖內區,0166,411,115,526,19,545,941,57.92%,43.68%,1
高雄市,湖內區,0167,368,96,464,24,488,863,56.55%,42.64%,1
高雄市,湖內區,0168,433,169,602,34,636,1160,54.83%,37.33%,1
高雄市,湖內區,0169,356,127,483,16,499,1090,45.78%,32.66%,1
高雄市,湖內區,0170,445,176,621,34,655,1122,58.38%,39.66%,1
高雄市,湖內區,0171,411,131,542,24,566,1123,50.4%,36.6%,1
高雄市,湖內區,0172,296,79,375,18,393,684,57.46%,43.27%,1
高雄市,湖內區,0173,480,136,616,16,632,1249,50.6%,38.43%,1
高雄市,湖內區,0174,520,173,693,30,723,1453,49.76%,35.79%,1
高雄市,茄萣區,0130,367,116,483,11,494,976,50.61%,37.6%,1
高雄市,茄萣區,0131,336,116,452,36,488,887,55.02%,37.88%,1
高雄市,茄萣區,0132,678,215,893,20,913,1710,53.39%,39.65%,1
高雄市,茄萣區,0133,458,152,610,20,630,1280,49.22%,35.78%,1
高雄市,茄萣區,0134,607,181,788,17,805,1314,61.26%,46.19%,1
高雄市,茄萣區,0135,533,188,721,14,735,1157,63.53%,46.07%,1
高雄市,茄萣區,0136,691,244,935,57,992,1785,55.57%,38.71%,1
高雄市,茄萣區,0137,353,103,456,33,489,838,58.35%,42.12%,1
高雄市,茄萣區,0138,594,190,784,42,826,1249,66.13%,47.56%,1
高雄市,茄萣區,0139,432,148,580,38,618,1116,55.38%,38.71%,1
高雄市,茄萣區,0140,355,132,487,38,525,978,53.68%,36.3%,1
高雄市,茄萣區,0141,417,115,532,23,555,1125,49.33%,37.07%,1
高雄市,茄萣區,0142,434,157,591,39,630,1139,55.31%,38.1%,1
高雄市,茄萣區,0143,544,166,710,64,774,1363,56.79%,39.91%,1
高雄市,茄萣區,0144,702,207,909,54,963,1598,60.26%,43.93%,1
高雄市,茄萣區,0145,441,128,569,29,598,1111,53.83%,39.69%,1
高雄市,茄萣區,0146,347,82,429,19,448,925,48.43%,37.51%,1
高雄市,茄萣區,0147,455,139,594,33,627,1148,54.62%,39.63%,1
高雄市,茄萣區,0148,516,159,675,26,701,1353,51.81%,38.14%,1
高雄市,茄萣區,0149,549,140,689,47,736,1331,55.3%,41.25%,1
高雄市,茄萣區,0150,625,237,862,40,902,1829,49.32%,34.17%,1
高雄市,永安區,0249,366,111,477,28,505,756,66.8%,48.41%,1
高雄市,永安區,0250,378,119,497,28,525,818,64.18%,46.21%,1
高雄市,永安區,0251,439,136,575,26,601,866,69.4%,50.69%,1
高雄市,永安區,0252,442,130,572,44,616,951,64.77%,46.48%,1
高雄市,永安區,0253,459,139,598,41,639,992,64.42%,46.27%,1
高雄市,永安區,0254,247,80,327,12,339,682,49.71%,36.22%,1
高雄市,永安區,0255,308,84,392,15,407,665,61.2%,46.32%,1
高雄市,永安區,0256,145,63,208,4,212,371,57.14%,39.08%,1
高雄市,永安區,0257,537,155,692,46,738,1114,66.25%,48.2%,1
高雄市,永安區,0258,667,193,860,27,887,1418,62.55%,47.04%,1
高雄市,永安區,0259,732,209,941,43,984,1477,66.62%,49.56%,1
高雄市,永安區,0260,845,297,1142,53,1195,1891,63.19%,44.69%,1
高雄市,彌陀區,0358,558,158,716,41,757,1246,60.75%,44.78%,1
高雄市,彌陀區,0359,412,121,533,24,557,885,62.94%,46.55%,1
高雄市,彌陀區,0360,484,142,626,31,657,955,68.8%,50.68%,1
高雄市,彌陀區,0361,211,86,297,25,322,534,60.3%,39.51%,1
高雄市,彌陀區,0362,343,85,428,24,452,738,61.25%,46.48%,1
高雄市,彌陀區,0363,442,122,564,22,586,855,68.54%,51.7%,1
高雄市,彌陀區,0364,427,122,549,20,569,877,64.88%,48.69%,1
高雄市,彌陀區,0365,380,98,478,32,510,781,65.3%,48.66%,1
高雄市,彌陀區,0366,379,105,484,13,497,808,61.51%,46.91%,1
高雄市,彌陀區,0367,352,100,452,19,471,904,52.1%,38.94%,1
高雄市,彌陀區,0368,360,113,473,31,504,825,61.09%,43.64%,1
高雄市,彌陀區,0369,399,113,512,28,540,941,57.39%,42.4%,1
高雄市,彌陀區,0370,425,157,582,22,604,1013,59.62%,41.95%,1
高雄市,彌陀區,0371,512,129,641,35,676,1024,66.02%,50%,1
高雄市,彌陀區,0372,370,94,464,10,474,861,55.05%,42.97%,1
高雄市,彌陀區,0373,515,179,694,41,735,1163,63.2%,44.28%,1
高雄市,彌陀區,0374,637,144,781,27,808,1216,66.45%,52.38%,1
高雄市,彌陀區,0375,489,116,605,24,629,861,73.05%,56.79%,1
高雄市,梓官區,0376,525,129,654,34,688,1061,64.84%,49.48%,1
高雄市,梓官區,0377,453,150,603,37,640,1063,60.21%,42.62%,1
高雄市,梓官區,0378,428,155,583,27,610,969,62.95%,44.17%,1
高雄市,梓官區,0379,427,152,579,12,591,1078,54.82%,39.61%,1
高雄市,梓官區,0380,372,135,507,23,530,838,63.25%,44.39%,1
高雄市,梓官區,0381,313,85,398,12,410,611,67.1%,51.23%,1
高雄市,梓官區,0382,371,116,487,21,508,782,64.96%,47.44%,1
高雄市,梓官區,0383,700,208,908,44,952,1451,65.61%,48.24%,1
高雄市,梓官區,0384,494,165,659,19,678,1144,59.27%,43.18%,1
高雄市,梓官區,0385,409,123,532,11,543,975,55.69%,41.95%,1
高雄市,梓官區,0386,599,170,769,31,800,1317,60.74%,45.48%,1
高雄市,梓官區,0387,560,180,740,29,769,1218,63.14%,45.98%,1
高雄市,梓官區,0388,481,153,634,25,659,1073,61.42%,44.83%,1
高雄市,梓官區,0389,473,115,588,25,613,1112,55.13%,42.54%,1
高雄市,梓官區,0390,298,99,397,18,415,715,58.04%,41.68%,1
高雄市,梓官區,0391,577,160,737,24,761,1311,58.05%,44.01%,1
高雄市,梓官區,0392,413,133,546,25,571,939,60.81%,43.98%,1
高雄市,梓官區,0393,387,117,504,16,520,824,63.11%,46.97%,1
高雄市,梓官區,0394,544,130,674,36,710,1052,67.49%,51.71%,1
高雄市,梓官區,0395,492,120,612,44,656,1020,64.31%,48.24%,1
高雄市,梓官區,0396,572,141,713,26,739,1260,58.65%,45.4%,1
高雄市,梓官區,0397,682,193,875,15,890,1595,55.8%,42.76%,1
高雄市,梓官區,0398,391,104,495,18,513,829,61.88%,47.17%,1
高雄市,梓官區,0399,685,293,978,14,992,1532,64.75%,44.71%,1
高雄市,梓官區,0400,572,151,723,41,764,1195,63.93%,47.87%,1
高雄市,梓官區,0401,544,131,675,36,711,1143,62.2%,47.59%,1
高雄市,梓官區,0402,568,146,714,35,749,1186,63.15%,47.89%,1
高雄市,梓官區,0403,673,188,861,21,882,1732,50.92%,38.86%,1
高雄市,旗山區,0060,460,149,609,32,641,1060,60.47%,43.4%,1
高雄市,旗山區,0061,440,123,563,25,588,1125,52.27%,39.11%,1
高雄市,旗山區,0062,496,159,655,26,681,1100,61.91%,45.09%,1
高雄市,旗山區,0063,558,183,741,25,766,1238,61.87%,45.07%,1
高雄市,旗山區,0064,422,110,532,18,550,933,58.95%,45.23%,1
高雄市,旗山區,0065,273,97,370,20,390,727,53.65%,37.55%,1
高雄市,旗山區,0066,460,131,591,19,610,1071,56.96%,42.95%,1
高雄市,旗山區,0067,289,90,379,22,401,744,53.9%,38.84%,1
高雄市,旗山區,0068,437,119,556,20,576,1100,52.36%,39.73%,1
高雄市,旗山區,0069,157,34,191,8,199,369,53.93%,42.55%,1
高雄市,旗山區,0070,347,71,418,11,429,888,48.31%,39.08%,1
高雄市,旗山區,0071,182,51,233,10,243,510,47.65%,35.69%,1
高雄市,旗山區,0072,466,111,577,73,650,1042,62.38%,44.72%,1
高雄市,旗山區,0073,334,75,409,31,440,791,55.63%,42.23%,1
高雄市,旗山區,0074,409,114,523,47,570,939,60.7%,43.56%,1
高雄市,旗山區,0075,545,137,682,28,710,1218,58.29%,44.75%,1
高雄市,旗山區,0076,69,12,81,18,99,178,55.62%,38.76%,1
高雄市,旗山區,0077,424,129,553,37,590,946,62.37%,44.82%,1
高雄市,旗山區,0078,410,141,551,29,580,1025,56.59%,40%,1
高雄市,旗山區,0079,457,136,593,41,634,1040,60.96%,43.94%,1
高雄市,旗山區,0080,418,132,550,37,587,900,65.22%,46.44%,1
高雄市,旗山區,0081,263,78,341,15,356,663,53.7%,39.67%,1
高雄市,旗山區,0082,399,124,523,21,544,954,57.02%,41.82%,1
高雄市,旗山區,0083,431,146,577,24,601,1060,56.7%,40.66%,1
高雄市,旗山區,0084,479,161,640,38,678,1110,61.08%,43.15%,1
高雄市,旗山區,0085,438,157,595,36,631,1062,59.42%,41.24%,1
高雄市,旗山區,0086,491,145,636,30,666,1151,57.86%,42.66%,1
高雄市,旗山區,0087,119,34,153,13,166,266,62.41%,44.74%,1
高雄市,旗山區,0088,291,82,373,16,389,633,61.45%,45.97%,1
高雄市,旗山區,0089,505,137,642,31,673,1307,51.49%,38.64%,1
高雄市,旗山區,0090,304,98,402,34,436,754,57.82%,40.32%,1
高雄市,旗山區,0091,534,141,675,78,753,1296,58.1%,41.2%,1
高雄市,旗山區,0092,282,95,377,15,392,839,46.72%,33.61%,1
高雄市,旗山區,0093,570,159,729,38,767,1329,57.71%,42.89%,1
高雄市,旗山區,0094,280,77,357,16,373,628,59.39%,44.59%,1
高雄市,美濃區,0095,492,132,624,66,690,1175,58.72%,41.87%,1
高雄市,美濃區,0096,562,148,710,28,738,1438,51.32%,39.08%,1
高雄市,美濃區,0097,394,83,477,36,513,989,51.87%,39.84%,1
高雄市,美濃區,0098,612,159,771,46,817,1427,57.25%,42.89%,1
高雄市,美濃區,0099,548,142,690,57,747,1309,57.07%,41.86%,1
高雄市,美濃區,0100,569,146,715,58,773,1263,61.2%,45.05%,1
高雄市,美濃區,0101,481,103,584,29,613,997,61.48%,48.24%,1
高雄市,美濃區,0102,453,119,572,44,616,1064,57.89%,42.58%,1
高雄市,美濃區,0103,611,175,786,50,836,1498,55.81%,40.79%,1
高雄市,美濃區,0104,479,129,608,50,658,1119,58.8%,42.81%,1
高雄市,美濃區,0105,459,99,558,49,607,1031,58.87%,44.52%,1
高雄市,美濃區,0106,555,151,706,59,765,1437,53.24%,38.62%,1
高雄市,美濃區,0107,452,114,566,43,609,1071,56.86%,42.2%,1
高雄市,美濃區,0108,327,58,385,13,398,687,57.93%,47.6%,1
高雄市,美濃區,0109,280,65,345,26,371,775,47.87%,36.13%,1
高雄市,美濃區,0110,551,106,657,40,697,1353,51.52%,40.72%,1
高雄市,美濃區,0111,452,120,572,24,596,1191,50.04%,37.95%,1
高雄市,美濃區,0112,355,83,438,25,463,906,51.1%,39.18%,1
高雄市,美濃區,0113,533,131,664,31,695,1178,59%,45.25%,1
高雄市,美濃區,0114,499,117,616,26,642,1252,51.28%,39.86%,1
高雄市,美濃區,0115,704,155,859,30,889,1549,57.39%,45.45%,1
高雄市,美濃區,0116,459,87,546,30,576,1088,52.94%,42.19%,1
高雄市,美濃區,0117,467,131,598,39,637,1116,57.08%,41.85%,1
高雄市,美濃區,0118,396,112,508,19,527,977,53.94%,40.53%,1
高雄市,美濃區,0119,357,110,467,46,513,816,62.87%,43.75%,1
高雄市,美濃區,0120,350,74,424,22,446,955,46.7%,36.65%,1
高雄市,美濃區,0121,400,99,499,54,553,943,58.64%,42.42%,1
高雄市,美濃區,0122,554,145,699,45,744,1371,54.27%,40.41%,1
高雄市,美濃區,0123,352,114,466,51,517,919,56.26%,38.3%,1
高雄市,美濃區,0124,412,106,518,50,568,915,62.08%,45.03%,1
高雄市,美濃區,0125,324,79,403,57,460,828,55.56%,39.13%,1
高雄市,美濃區,0126,219,64,283,39,322,674,47.77%,32.49%,1
高雄市,六龜區,0020,271,85,356,31,387,760,50.92%,35.66%,1
高雄市,六龜區,0021,234,55,289,19,308,666,46.25%,35.14%,1
高雄市,六龜區,0022,301,76,377,35,412,704,58.52%,42.76%,1
高雄市,六龜區,0023,385,91,476,38,514,1003,51.25%,38.38%,1
高雄市,六龜區,0024,464,102,566,98,664,1382,48.05%,33.57%,1
高雄市,六龜區,0025,286,84,370,45,415,986,42.09%,29.01%,1
高雄市,六龜區,0026,380,114,494,42,536,1046,51.24%,36.33%,1
高雄市,六龜區,0027,267,82,349,35,384,812,47.29%,32.88%,1
高雄市,六龜區,0028,494,128,622,40,662,1431,46.26%,34.52%,1
高雄市,六龜區,0029,369,73,442,46,488,912,53.51%,40.46%,1
高雄市,六龜區,0030,448,130,578,34,612,1472,41.58%,30.43%,1
高雄市,六龜區,0031,107,20,127,18,145,327,44.34%,32.72%,1
高雄市,甲仙區,0013,142,40,182,9,191,472,40.47%,30.08%,1
高雄市,甲仙區,0014,406,107,513,49,562,882,63.72%,46.03%,1
高雄市,甲仙區,0015,271,61,332,29,361,668,54.04%,40.57%,1
高雄市,甲仙區,0016,532,162,694,101,795,1581,50.28%,33.65%,1
高雄市,甲仙區,0017,205,54,259,11,270,673,40.12%,30.46%,1
高雄市,甲仙區,0018,222,40,262,34,296,607,48.76%,36.57%,1
高雄市,甲仙區,0019,209,59,268,16,284,534,53.18%,39.14%,1
高雄市,杉林區,0032,223,62,285,32,317,640,49.53%,34.84%,1
高雄市,杉林區,0033,258,45,303,31,334,696,47.99%,37.07%,1
高雄市,杉林區,0034,405,73,478,21,499,1284,38.86%,31.54%,1
高雄市,杉林區,0035,349,85,434,25,459,1027,44.69%,33.98%,1
高雄市,杉林區,0036,192,37,229,18,247,482,51.24%,39.83%,1
高雄市,杉林區,0037,644,197,841,71,912,1627,56.05%,39.58%,1
高雄市,杉林區,0038,606,131,737,25,762,1630,46.75%,37.18%,1
高雄市,杉林區,0039,279,87,366,29,395,973,40.6%,28.67%,1
高雄市,杉林區,0040,339,90,429,10,439,987,44.48%,34.35%,1
高雄市,杉林區,0041,486,113,599,67,666,1261,52.82%,38.54%,1
高雄市,內門區,0042,382,59,441,42,483,969,49.85%,39.42%,1
高雄市,內門區,0043,231,72,303,11,314,652,48.16%,35.43%,1
高雄市,內門區,0044,377,96,473,43,516,961,53.69%,39.23%,1
高雄市,內門區,0045,177,29,206,6,212,426,49.77%,41.55%,1
高雄市,內門區,0046,150,28,178,10,188,398,47.24%,37.69%,1
高雄市,內門區,0047,184,44,228,13,241,508,47.44%,36.22%,1
高雄市,內門區,0048,441,100,541,36,577,980,58.88%,45%,1
高雄市,內門區,0049,400,117,517,25,542,1225,44.24%,32.65%,1
高雄市,內門區,0050,674,218,892,91,983,1722,57.08%,39.14%,1
高雄市,內門區,0051,188,63,251,24,275,560,49.11%,33.57%,1
高雄市,內門區,0052,281,71,352,12,364,801,45.44%,35.08%,1
高雄市,內門區,0053,168,39,207,15,222,423,52.48%,39.72%,1
高雄市,內門區,0054,185,37,222,15,237,497,47.69%,37.22%,1
高雄市,內門區,0055,275,56,331,16,347,677,51.26%,40.62%,1
高雄市,內門區,0056,217,30,247,9,256,593,43.17%,36.59%,1
高雄市,內門區,0057,220,45,265,24,289,597,48.41%,36.85%,1
高雄市,內門區,0058,129,24,153,3,156,343,45.48%,37.61%,1
高雄市,內門區,0059,272,75,347,25,372,670,55.52%,40.6%,1
高雄市,茂林區,0127,265,65,330,26,356,507,70.22%,52.27%,1
高雄市,茂林區,0128,218,48,266,18,284,382,74.35%,57.07%,1
高雄市,茂林區,0129,382,77,459,24,483,726,66.53%,52.62%,1
高雄市,桃源區,0001,87,36,123,0,123,264,46.59%,32.95%,1
高雄市,桃源區,0002,139,25,164,8,172,233,73.82%,59.66%,1
高雄市,桃源區,0003,156,18,174,10,184,279,65.95%,55.91%,1
高雄市,桃源區,0004,136,24,160,3,163,223,73.09%,60.99%,1
高雄市,桃源區,0005,354,69,423,18,441,783,56.32%,45.21%,1
高雄市,桃源區,0006,329,62,391,7,398,632,62.97%,52.06%,1
高雄市,桃源區,0007,349,60,409,11,420,612,68.63%,57.03%,1
高雄市,桃源區,0008,197,54,251,16,267,472,56.57%,41.74%,1
高雄市,那瑪夏區,0009,397,90,487,14,501,741,67.61%,53.58%,1
高雄市,那瑪夏區,0010,329,69,398,29,427,585,72.99%,56.24%,1
高雄市,那瑪夏區,0011,378,72,450,23,473,609,77.67%,62.07%,1
高雄市,那瑪夏區,0012,320,25,345,7,352,489,71.98%,65.44%,1
新竹縣,竹北市,0001,569,266,835,20,855,1319,64.82%,43.14%,1
新竹縣,竹北市,0002,520,271,791,15,806,1321,61.01%,39.36%,1
新竹縣,竹北市,0003,527,255,782,22,804,1272,63.21%,41.43%,1
新竹縣,竹北市,0004,546,280,826,22,848,1467,57.81%,37.22%,1
新竹縣,竹北市,0005,442,258,700,14,714,1226,58.24%,36.05%,1
新竹縣,竹北市,0006,518,283,801,9,810,1412,57.37%,36.69%,1
新竹縣,竹北市,0007,545,326,871,12,883,1400,63.07%,38.93%,1
新竹縣,竹北市,0008,512,337,849,29,878,1415,62.05%,36.18%,1
新竹縣,竹北市,0009,487,299,786,18,804,1361,59.07%,35.78%,1
新竹縣,竹北市,0010,470,357,827,12,839,1515,55.38%,31.02%,1
新竹縣,竹北市,0011,534,344,878,20,898,1495,60.07%,35.72%,1
新竹縣,竹北市,0012,484,339,823,17,840,1417,59.28%,34.16%,1
新竹縣,竹北市,0013,479,391,870,18,888,1548,57.36%,30.94%,1
新竹縣,竹北市,0014,434,353,787,11,798,1434,55.65%,30.26%,1
新竹縣,竹北市,0015,509,280,789,26,815,1385,58.84%,36.75%,1
新竹縣,竹北市,0016,503,274,777,18,795,1247,63.75%,40.34%,1
新竹縣,竹北市,0017,487,290,777,21,798,1373,58.12%,35.47%,1
新竹縣,竹北市,0018,496,353,849,11,860,1345,63.94%,36.88%,1
新竹縣,竹北市,0019,466,178,644,30,674,1165,57.85%,40%,1
新竹縣,竹北市,0020,466,262,728,24,752,1164,64.6%,40.03%,1
新竹縣,竹北市,0021,465,267,732,24,756,1212,62.38%,38.37%,1
新竹縣,竹北市,0022,567,167,734,28,762,1507,50.56%,37.62%,1
新竹縣,竹北市,0023,614,197,811,32,843,1576,53.49%,38.96%,1
新竹縣,竹北市,0024,540,269,809,23,832,1464,56.83%,36.89%,1
新竹縣,竹北市,0025,491,305,796,20,816,1428,57.14%,34.38%,1
新竹縣,竹北市,0026,367,349,716,10,726,1442,50.35%,25.45%,1
新竹縣,竹北市,0027,569,241,810,34,844,1415,59.65%,40.21%,1
新竹縣,竹北市,0028,523,316,839,14,853,1666,51.2%,31.39%,1
新竹縣,竹北市,0029,562,350,912,29,941,1751,53.74%,32.1%,1
新竹縣,竹北市,0030,456,268,724,18,742,1196,62.04%,38.13%,1
新竹縣,竹北市,0031,497,228,725,18,743,1235,60.16%,40.24%,1
新竹縣,竹北市,0032,435,242,677,9,686,1204,56.98%,36.13%,1
新竹縣,竹北市,0033,546,233,779,21,800,1308,61.16%,41.74%,1
新竹縣,竹北市,0034,446,256,702,13,715,1233,57.99%,36.17%,1
新竹縣,竹北市,0035,463,194,657,19,676,1129,59.88%,41.01%,1
新竹縣,竹北市,0036,449,191,640,18,658,1069,61.55%,42%,1
新竹縣,竹北市,0037,490,202,692,22,714,1114,64.09%,43.99%,1
新竹縣,竹北市,0038,453,216,669,22,691,1103,62.65%,41.07%,1
新竹縣,竹北市,0039,438,213,651,19,670,1029,65.11%,42.57%,1
新竹縣,竹北市,0040,466,249,715,15,730,1133,64.43%,41.13%,1
新竹縣,竹北市,0041,508,242,750,11,761,1301,58.49%,39.05%,1
新竹縣,竹北市,0042,638,385,1023,25,1048,1798,58.29%,35.48%,1
新竹縣,竹北市,0043,576,251,827,23,850,1427,59.57%,40.36%,1
新竹縣,竹北市,0044,622,275,897,16,913,1462,62.45%,42.54%,1
新竹縣,竹北市,0045,577,256,833,23,856,1342,63.79%,43%,1
新竹縣,竹北市,0046,568,311,879,20,899,1480,60.74%,38.38%,1
新竹縣,竹北市,0047,593,318,911,20,931,1645,56.6%,36.05%,1
新竹縣,竹北市,0048,558,233,791,15,806,1256,64.17%,44.43%,1
新竹縣,竹北市,0049,473,234,707,18,725,1181,61.39%,40.05%,1
新竹縣,竹北市,0050,584,259,843,23,866,1329,65.16%,43.94%,1
新竹縣,竹北市,0051,558,222,780,12,792,1228,64.5%,45.44%,1
新竹縣,竹北市,0052,552,298,850,26,876,1552,56.44%,35.57%,1
新竹縣,竹北市,0053,649,225,874,21,895,1480,60.47%,43.85%,1
新竹縣,竹北市,0054,575,233,808,21,829,1487,55.75%,38.67%,1
新竹縣,竹北市,0055,565,218,783,26,809,1470,55.03%,38.44%,1
新竹縣,竹北市,0056,566,208,774,16,790,1477,53.49%,38.32%,1
新竹縣,竹北市,0057,655,295,950,29,979,1611,60.77%,40.66%,1
新竹縣,竹北市,0058,625,250,875,36,911,1555,58.59%,40.19%,1
新竹縣,竹北市,0059,552,227,779,24,803,1468,54.7%,37.6%,1
新竹縣,竹北市,0060,735,145,880,19,899,1509,59.58%,48.71%,1
新竹縣,竹北市,0061,650,228,878,13,891,1602,55.62%,40.57%,1
新竹縣,竹北市,0062,619,222,841,18,859,1448,59.32%,42.75%,1
新竹縣,竹北市,0063,585,203,788,14,802,1318,60.85%,44.39%,1
新竹縣,竹北市,0064,688,295,983,25,1008,1634,61.69%,42.11%,1
新竹縣,竹北市,0065,577,178,755,29,784,1345,58.29%,42.9%,1
新竹縣,竹北市,0066,454,149,603,18,621,958,64.82%,47.39%,1
新竹縣,竹北市,0067,513,171,684,22,706,1112,63.49%,46.13%,1
新竹縣,竹北市,0068,493,142,635,38,673,1134,59.35%,43.47%,1
新竹縣,竹北市,0069,618,220,838,30,868,1483,58.53%,41.67%,1
新竹縣,竹北市,0070,517,205,722,29,751,1332,56.38%,38.81%,1
新竹縣,竹北市,0071,548,196,744,20,764,1482,51.55%,36.98%,1
新竹縣,竹北市,0072,435,178,613,10,623,1449,43%,30.02%,1
新竹縣,竹北市,0073,515,187,702,18,720,1319,54.59%,39.04%,1
新竹縣,竹北市,0074,509,198,707,20,727,1332,54.58%,38.21%,1
新竹縣,竹北市,0075,512,221,733,21,754,1412,53.4%,36.26%,1
新竹縣,竹北市,0076,644,218,862,24,886,1640,54.02%,39.27%,1
新竹縣,竹北市,0077,434,301,735,28,763,1323,57.67%,32.8%,1
新竹縣,竹北市,0078,575,236,811,43,854,1428,59.8%,40.27%,1
新竹縣,竹北市,0079,632,239,871,24,895,1533,58.38%,41.23%,1
新竹縣,竹北市,0080,510,231,741,10,751,1346,55.79%,37.89%,1
新竹縣,竹北市,0081,492,146,638,31,669,1219,54.88%,40.36%,1
新竹縣,竹北市,0082,633,231,864,36,900,1466,61.39%,43.18%,1
新竹縣,竹北市,0083,409,198,607,26,633,1147,55.19%,35.66%,1
新竹縣,竹北市,0084,489,226,715,35,750,1529,49.05%,31.98%,1
新竹縣,竹北市,0085,620,231,851,30,881,1522,57.88%,40.74%,1
新竹縣,竹北市,0086,595,196,791,38,829,1383,59.94%,43.02%,1
新竹縣,竹北市,0087,658,231,889,27,916,1569,58.38%,41.94%,1
新竹縣,竹北市,0088,594,200,794,22,816,1506,54.18%,39.44%,1
新竹縣,竹北市,0089,378,108,486,22,508,877,57.92%,43.1%,1
新竹縣,竹北市,0090,429,177,606,22,628,1074,58.47%,39.94%,1
新竹縣,竹北市,0091,517,165,682,26,708,1089,65.01%,47.47%,1
新竹縣,竹北市,0092,570,195,765,28,793,1336,59.36%,42.66%,1
新竹縣,竹北市,0093,431,147,578,31,609,1058,57.56%,40.74%,1
新竹縣,竹北市,0094,442,152,594,34,628,937,67.02%,47.17%,1
新竹縣,竹北市,0095,502,158,660,31,691,1206,57.3%,41.63%,1
新竹縣,竹北市,0096,526,157,683,32,715,1205,59.34%,43.65%,1
新竹縣,竹北市,0097,745,252,997,34,1031,1718,60.01%,43.36%,1
新竹縣,竹北市,0098,394,121,515,17,532,917,58.02%,42.97%,1
新竹縣,竹北市,0099,291,96,387,22,409,668,61.23%,43.56%,1
新竹縣,竹北市,0100,350,103,453,20,473,824,57.4%,42.48%,1
新竹縣,竹北市,0101,334,96,430,38,468,782,59.85%,42.71%,1
新竹縣,竹北市,0102,426,119,545,54,599,977,61.31%,43.6%,1
新竹縣,竹北市,0103,373,118,491,17,508,937,54.22%,39.81%,1
新竹縣,竹東鎮,0104,124,25,149,5,154,309,49.84%,40.13%,1
新竹縣,竹東鎮,0105,152,43,195,23,218,416,52.4%,36.54%,1
新竹縣,竹東鎮,0106,155,47,202,5,207,386,53.63%,40.16%,1
新竹縣,竹東鎮,0107,384,94,478,19,497,950,52.32%,40.42%,1
新竹縣,竹東鎮,0108,522,151,673,9,682,1275,53.49%,40.94%,1
新竹縣,竹東鎮,0109,588,42,630,27,657,1213,54.16%,48.47%,1
新竹縣,竹東鎮,0110,612,226,838,33,871,1548,56.27%,39.53%,1
新竹縣,竹東鎮,0111,472,161,633,15,648,1246,52.01%,37.88%,1
新竹縣,竹東鎮,0112,430,128,558,23,581,1252,46.41%,34.35%,1
新竹縣,竹東鎮,0113,559,142,701,22,723,1359,53.2%,41.13%,1
新竹縣,竹東鎮,0114,509,145,654,24,678,1255,54.02%,40.56%,1
新竹縣,竹東鎮,0115,560,172,732,20,752,1304,57.67%,42.94%,1
新竹縣,竹東鎮,0116,532,173,705,22,727,1292,56.27%,41.18%,1
新竹縣,竹東鎮,0117,454,114,568,17,585,1111,52.66%,40.86%,1
新竹縣,竹東鎮,0118,387,111,498,33,531,880,60.34%,43.98%,1
新竹縣,竹東鎮,0119,288,85,373,22,395,670,58.96%,42.99%,1
新竹縣,竹東鎮,0120,538,164,702,23,725,1244,58.28%,43.25%,1
新竹縣,竹東鎮,0121,440,130,570,40,610,1126,54.17%,39.08%,1
新竹縣,竹東鎮,0122,448,117,565,24,589,1073,54.89%,41.75%,1
新竹縣,竹東鎮,0123,512,164,676,20,696,1215,57.28%,42.14%,1
新竹縣,竹東鎮,0124,477,168,645,16,661,1155,57.23%,41.3%,1
新竹縣,竹東鎮,0125,354,115,469,23,492,852,57.75%,41.55%,1
新竹縣,竹東鎮,0126,379,131,510,17,527,875,60.23%,43.31%,1
新竹縣,竹東鎮,0127,475,149,624,31,655,1070,61.21%,44.39%,1
新竹縣,竹東鎮,0128,291,85,376,16,392,704,55.68%,41.34%,1
新竹縣,竹東鎮,0129,294,68,362,20,382,951,40.17%,30.91%,1
新竹縣,竹東鎮,0130,420,139,559,14,573,984,58.23%,42.68%,1
新竹縣,竹東鎮,0131,384,113,497,9,506,1113,45.46%,34.5%,1
新竹縣,竹東鎮,0132,277,67,344,13,357,595,60%,46.55%,1
新竹縣,竹東鎮,0133,352,91,443,27,470,762,61.68%,46.19%,1
新竹縣,竹東鎮,0134,305,104,409,17,426,763,55.83%,39.97%,1
新竹縣,竹東鎮,0135,304,113,417,14,431,813,53.01%,37.39%,1
新竹縣,竹東鎮,0136,490,133,623,15,638,1310,48.7%,37.4%,1
新竹縣,竹東鎮,0137,533,149,682,23,705,1434,49.16%,37.17%,1
新竹縣,竹東鎮,0138,455,162,617,24,641,1131,56.68%,40.23%,1
新竹縣,竹東鎮,0139,381,135,516,16,532,967,55.02%,39.4%,1
新竹縣,竹東鎮,0140,445,143,588,25,613,1196,51.25%,37.21%,1
新竹縣,竹東鎮,0141,486,146,632,26,658,1154,57.02%,42.11%,1
新竹縣,竹東鎮,0142,307,110,417,23,440,715,61.54%,42.94%,1
新竹縣,竹東鎮,0143,292,102,394,17,411,685,60%,42.63%,1
新竹縣,竹東鎮,0144,517,176,693,25,718,1352,53.11%,38.24%,1
新竹縣,竹東鎮,0145,575,187,762,41,803,1407,57.07%,40.87%,1
新竹縣,竹東鎮,0146,564,165,729,24,753,1362,55.29%,41.41%,1
新竹縣,竹東鎮,0147,559,188,747,23,770,1330,57.89%,42.03%,1
新竹縣,竹東鎮,0148,547,217,764,25,789,1441,54.75%,37.96%,1
新竹縣,竹東鎮,0149,465,183,648,10,658,1248,52.72%,37.26%,1
新竹縣,竹東鎮,0150,383,181,564,7,571,1263,45.21%,30.32%,1
新竹縣,竹東鎮,0151,463,144,607,16,623,1232,50.57%,37.58%,1
新竹縣,竹東鎮,0152,398,122,520,21,541,1143,47.33%,34.82%,1
新竹縣,竹東鎮,0153,592,224,816,28,844,1529,55.2%,38.72%,1
新竹縣,竹東鎮,0154,457,153,610,18,628,1140,55.09%,40.09%,1
新竹縣,竹東鎮,0155,268,83,351,14,365,570,64.04%,47.02%,1
新竹縣,竹東鎮,0156,483,171,654,16,670,1345,49.81%,35.91%,1
新竹縣,竹東鎮,0157,487,229,716,25,741,1381,53.66%,35.26%,1
新竹縣,竹東鎮,0158,510,247,757,23,780,1379,56.56%,36.98%,1
新竹縣,竹東鎮,0159,445,136,581,22,603,1033,58.37%,43.08%,1
新竹縣,竹東鎮,0160,424,146,570,19,589,1066,55.25%,39.77%,1
新竹縣,竹東鎮,0161,412,115,527,29,556,938,59.28%,43.92%,1
新竹縣,竹東鎮,0162,427,133,560,29,589,952,61.87%,44.85%,1
新竹縣,竹東鎮,0163,590,272,862,24,886,1468,60.35%,40.19%,1
新竹縣,竹東鎮,0164,555,412,967,16,983,1915,51.33%,28.98%,1
新竹縣,竹東鎮,0165,482,141,623,30,653,1220,53.52%,39.51%,1
新竹縣,竹東鎮,0166,389,135,524,11,535,1166,45.88%,33.36%,1
新竹縣,竹東鎮,0167,521,194,715,18,733,1492,49.13%,34.92%,1
新竹縣,竹東鎮,0168,471,173,644,25,669,1245,53.73%,37.83%,1
新竹縣,竹東鎮,0169,439,160,599,26,625,1083,57.71%,40.54%,1
新竹縣,竹東鎮,0170,440,151,591,17,608,1102,55.17%,39.93%,1
新竹縣,竹東鎮,0171,430,140,570,14,584,1068,54.68%,40.26%,1
新竹縣,竹東鎮,0172,428,179,607,20,627,1097,57.16%,39.02%,1
新竹縣,竹東鎮,0173,396,118,514,16,530,962,55.09%,41.16%,1
新竹縣,竹東鎮,0174,406,115,521,13,534,909,58.75%,44.66%,1
新竹縣,竹東鎮,0175,220,68,288,15,303,603,50.25%,36.48%,1
新竹縣,新埔鎮,0176,450,123,573,16,589,983,59.92%,45.78%,1
新竹縣,新埔鎮,0177,251,98,349,20,369,597,61.81%,42.04%,1
新竹縣,新埔鎮,0178,448,145,593,23,616,1070,57.57%,41.87%,1
新竹縣,新埔鎮,0179,386,124,510,16,526,935,56.26%,41.28%,1
新竹縣,新埔鎮,0180,328,92,420,18,438,753,58.17%,43.56%,1
新竹縣,新埔鎮,0181,404,130,534,18,552,838,65.87%,48.21%,1
新竹縣,新埔鎮,0182,384,113,497,29,526,924,56.93%,41.56%,1
新竹縣,新埔鎮,0183,328,114,442,20,462,905,51.05%,36.24%,1
新竹縣,新埔鎮,0184,433,93,526,13,539,948,56.86%,45.68%,1
新竹縣,新埔鎮,0185,459,110,569,26,595,1017,58.51%,45.13%,1
新竹縣,新埔鎮,0186,500,191,691,30,721,1176,61.31%,42.52%,1
新竹縣,新埔鎮,0187,511,160,671,27,698,1122,62.21%,45.54%,1
新竹縣,新埔鎮,0188,358,120,478,14,492,1022,48.14%,35.03%,1
新竹縣,新埔鎮,0189,525,157,682,31,713,1429,49.9%,36.74%,1
新竹縣,新埔鎮,0190,229,59,288,17,305,451,67.63%,50.78%,1
新竹縣,新埔鎮,0191,297,98,395,17,412,724,56.91%,41.02%,1
新竹縣,新埔鎮,0192,291,78,369,25,394,617,63.86%,47.16%,1
新竹縣,新埔鎮,0193,563,71,634,45,679,1144,59.35%,49.21%,1
新竹縣,新埔鎮,0194,491,132,623,36,659,1139,57.86%,43.11%,1
新竹縣,新埔鎮,0195,382,95,477,22,499,861,57.96%,44.37%,1
新竹縣,新埔鎮,0196,402,147,549,12,561,1093,51.33%,36.78%,1
新竹縣,新埔鎮,0197,367,113,480,26,506,978,51.74%,37.53%,1
新竹縣,新埔鎮,0198,387,126,513,19,532,1040,51.15%,37.21%,1
新竹縣,新埔鎮,0199,451,142,593,28,621,1160,53.53%,38.88%,1
新竹縣,新埔鎮,0200,419,143,562,18,580,950,61.05%,44.11%,1
新竹縣,新埔鎮,0201,387,89,476,23,499,882,56.58%,43.88%,1
新竹縣,新埔鎮,0202,518,191,709,31,740,1281,57.77%,40.44%,1
新竹縣,新埔鎮,0203,452,169,621,30,651,1212,53.71%,37.29%,1
新竹縣,新埔鎮,0204,366,92,458,27,485,1013,47.88%,36.13%,1
新竹縣,新埔鎮,0205,293,83,376,27,403,630,63.97%,46.51%,1
新竹縣,關西鎮,0206,245,48,293,15,308,480,64.17%,51.04%,1
新竹縣,關西鎮,0207,393,124,517,23,540,903,59.8%,43.52%,1
新竹縣,關西鎮,0208,438,129,567,27,594,1020,58.24%,42.94%,1
新竹縣,關西鎮,0209,321,86,407,11,418,705,59.29%,45.53%,1
新竹縣,關西鎮,0210,442,115,557,19,576,1056,54.55%,41.86%,1
新竹縣,關西鎮,0211,502,170,672,29,701,1275,54.98%,39.37%,1
新竹縣,關西鎮,0212,576,154,730,28,758,1287,58.9%,44.76%,1
新竹縣,關西鎮,0213,342,95,437,29,466,771,60.44%,44.36%,1
新竹縣,關西鎮,0214,410,125,535,36,571,1046,54.59%,39.2%,1
新竹縣,關西鎮,0215,461,115,576,29,605,1030,58.74%,44.76%,1
新竹縣,關西鎮,0216,498,163,661,29,690,1208,57.12%,41.23%,1
新竹縣,關西鎮,0217,429,107,536,13,549,1095,50.14%,39.18%,1
新竹縣,關西鎮,0218,516,174,690,23,713,1350,52.81%,38.22%,1
新竹縣,關西鎮,0219,408,111,519,18,537,846,63.48%,48.23%,1
新竹縣,關西鎮,0220,552,158,710,37,747,1362,54.85%,40.53%,1
新竹縣,關西鎮,0221,389,73,462,18,480,903,53.16%,43.08%,1
新竹縣,關西鎮,0222,202,52,254,15,269,551,48.82%,36.66%,1
新竹縣,關西鎮,0223,142,39,181,10,191,461,41.43%,30.8%,1
新竹縣,關西鎮,0224,252,52,304,15,319,572,55.77%,44.06%,1
新竹縣,關西鎮,0225,402,83,485,26,511,943,54.19%,42.63%,1
新竹縣,關西鎮,0226,339,118,457,18,475,808,58.79%,41.96%,1
新竹縣,關西鎮,0227,448,120,568,16,584,923,63.27%,48.54%,1
新竹縣,關西鎮,0228,414,105,519,18,537,903,59.47%,45.85%,1
新竹縣,關西鎮,0229,436,110,546,32,578,977,59.16%,44.63%,1
新竹縣,關西鎮,0230,390,100,490,30,520,824,63.11%,47.33%,1
新竹縣,關西鎮,0231,281,64,345,16,361,559,64.58%,50.27%,1
新竹縣,關西鎮,0232,394,118,512,22,534,854,62.53%,46.14%,1
新竹縣,湖口鄉,0233,518,71,589,38,627,1393,45.01%,37.19%,1
新竹縣,湖口鄉,0234,647,196,843,29,872,1505,57.94%,42.99%,1
新竹縣,湖口鄉,0235,622,171,793,19,812,1188,68.35%,52.36%,1
新竹縣,湖口鄉,0236,502,139,641,25,666,1267,52.57%,39.62%,1
新竹縣,湖口鄉,0237,727,207,934,21,955,1668,57.25%,43.59%,1
新竹縣,湖口鄉,0238,733,231,964,33,997,1719,58%,42.64%,1
新竹縣,湖口鄉,0239,530,162,692,32,724,1162,62.31%,45.61%,1
新竹縣,湖口鄉,0240,664,228,892,46,938,1833,51.17%,36.22%,1
新竹縣,湖口鄉,0241,571,235,806,28,834,1444,57.76%,39.54%,1
新竹縣,湖口鄉,0242,612,190,802,35,837,1347,62.14%,45.43%,1
新竹縣,湖口鄉,0243,545,160,705,17,722,1202,60.07%,45.34%,1
新竹縣,湖口鄉,0244,379,119,498,19,517,851,60.75%,44.54%,1
新竹縣,湖口鄉,0245,546,193,739,33,772,1272,60.69%,42.92%,1
新竹縣,湖口鄉,0246,543,166,709,27,736,1275,57.73%,42.59%,1
新竹縣,湖口鄉,0247,845,200,1045,33,1078,1560,69.1%,54.17%,1
新竹縣,湖口鄉,0248,519,172,691,46,737,1147,64.25%,45.25%,1
新竹縣,湖口鄉,0249,742,206,948,32,980,1729,56.68%,42.91%,1
新竹縣,湖口鄉,0250,542,185,727,29,756,1402,53.92%,38.66%,1
新竹縣,湖口鄉,0251,534,157,691,23,714,1183,60.36%,45.14%,1
新竹縣,湖口鄉,0252,564,181,745,28,773,1282,60.3%,43.99%,1
新竹縣,湖口鄉,0253,584,202,786,27,813,1335,60.9%,43.75%,1
新竹縣,湖口鄉,0254,686,229,915,17,932,1493,62.42%,45.95%,1
新竹縣,湖口鄉,0255,779,226,1005,14,1019,1877,54.29%,41.5%,1
新竹縣,湖口鄉,0256,505,137,642,29,671,1082,62.01%,46.67%,1
新竹縣,湖口鄉,0257,509,154,663,24,687,1115,61.61%,45.65%,1
新竹縣,湖口鄉,0258,136,460,596,24,620,1193,51.97%,11.4%,1
新竹縣,湖口鄉,0259,791,207,998,40,1038,1947,53.31%,40.63%,1
新竹縣,湖口鄉,0260,497,147,644,40,684,1125,60.8%,44.18%,1
新竹縣,湖口鄉,0261,466,115,581,30,611,1050,58.19%,44.38%,1
新竹縣,湖口鄉,0262,737,246,983,23,1006,1733,58.05%,42.53%,1
新竹縣,湖口鄉,0263,559,165,724,33,757,1284,58.96%,43.54%,1
新竹縣,湖口鄉,0264,480,130,610,25,635,1062,59.79%,45.2%,1
新竹縣,湖口鄉,0265,658,180,838,40,878,1547,56.76%,42.53%,1
新竹縣,湖口鄉,0266,563,158,721,29,750,1494,50.2%,37.68%,1
新竹縣,湖口鄉,0267,591,171,762,22,784,1634,47.98%,36.17%,1
新竹縣,湖口鄉,0268,502,172,674,16,690,1444,47.78%,34.76%,1
新竹縣,湖口鄉,0269,510,172,682,16,698,1324,52.72%,38.52%,1
新竹縣,湖口鄉,0270,457,120,577,24,601,1058,56.81%,43.19%,1
新竹縣,湖口鄉,0271,392,120,512,18,530,1220,43.44%,32.13%,1
新竹縣,湖口鄉,0272,544,179,723,27,750,1333,56.26%,40.81%,1
新竹縣,湖口鄉,0273,571,161,732,35,767,1461,52.5%,39.08%,1
新竹縣,湖口鄉,0274,608,171,779,16,795,1429,55.63%,42.55%,1
新竹縣,湖口鄉,0275,535,165,700,15,715,1506,47.48%,35.52%,1
新竹縣,湖口鄉,0276,515,132,647,26,673,1103,61.02%,46.69%,1
新竹縣,湖口鄉,0277,550,171,721,20,741,1495,49.57%,36.79%,1
新竹縣,湖口鄉,0278,325,81,406,27,433,752,57.58%,43.22%,1
新竹縣,湖口鄉,0279,388,134,522,26,548,986,55.58%,39.35%,1
新竹縣,新豐鄉,0280,425,130,555,22,577,1080,53.43%,39.35%,1
新竹縣,新豐鄉,0281,344,108,452,15,467,887,52.65%,38.78%,1
新竹縣,新豐鄉,0282,403,117,520,19,539,954,56.5%,42.24%,1
新竹縣,新豐鄉,0283,445,111,556,20,576,1003,57.43%,44.37%,1
新竹縣,新豐鄉,0284,447,142,589,15,604,1106,54.61%,40.42%,1
新竹縣,新豐鄉,0285,470,171,641,21,662,1123,58.95%,41.85%,1
新竹縣,新豐鄉,0286,387,100,487,41,528,891,59.26%,43.43%,1
新竹縣,新豐鄉,0287,313,104,417,23,440,874,50.34%,35.81%,1
新竹縣,新豐鄉,0288,343,111,454,22,476,824,57.77%,41.63%,1
新竹縣,新豐鄉,0289,370,96,466,23,489,975,50.15%,37.95%,1
新竹縣,新豐鄉,0290,368,114,482,23,505,847,59.62%,43.45%,1
新竹縣,新豐鄉,0291,599,190,789,37,826,1477,55.92%,40.56%,1
新竹縣,新豐鄉,0292,464,176,640,28,668,1266,52.76%,36.65%,1
新竹縣,新豐鄉,0293,427,102,529,34,563,1029,54.71%,41.5%,1
新竹縣,新豐鄉,0294,420,132,552,29,581,1063,54.66%,39.51%,1
新竹縣,新豐鄉,0295,440,131,571,11,582,1055,55.17%,41.71%,1
新竹縣,新豐鄉,0296,597,199,796,18,814,1445,56.33%,41.31%,1
新竹縣,新豐鄉,0297,615,226,841,27,868,1413,61.43%,43.52%,1
新竹縣,新豐鄉,0298,439,159,598,25,623,971,64.16%,45.21%,1
新竹縣,新豐鄉,0299,494,166,660,15,675,1135,59.47%,43.52%,1
新竹縣,新豐鄉,0300,488,168,656,29,685,1269,53.98%,38.46%,1
新竹縣,新豐鄉,0301,518,166,684,27,711,1257,56.56%,41.21%,1
新竹縣,新豐鄉,0302,692,253,945,20,965,1662,58.06%,41.64%,1
新竹縣,新豐鄉,0303,598,174,772,20,792,1486,53.3%,40.24%,1
新竹縣,新豐鄉,0304,493,149,642,29,671,1067,62.89%,46.2%,1
新竹縣,新豐鄉,0305,579,174,753,32,785,1302,60.29%,44.47%,1
新竹縣,新豐鄉,0306,575,188,763,20,783,1410,55.53%,40.78%,1
新竹縣,新豐鄉,0307,523,158,681,13,694,1267,54.78%,41.28%,1
新竹縣,新豐鄉,0308,466,139,605,26,631,1258,50.16%,37.04%,1
新竹縣,新豐鄉,0309,445,158,603,12,615,1217,50.53%,36.57%,1
新竹縣,新豐鄉,0310,609,173,782,21,803,1456,55.15%,41.83%,1
新竹縣,新豐鄉,0311,501,163,664,15,679,1157,58.69%,43.3%,1
新竹縣,新豐鄉,0312,437,120,557,21,578,1089,53.08%,40.13%,1
新竹縣,新豐鄉,0313,480,171,651,15,666,1160,57.41%,41.38%,1
新竹縣,新豐鄉,0314,463,137,600,13,613,976,62.81%,47.44%,1
新竹縣,新豐鄉,0315,598,199,797,30,827,1443,57.31%,41.44%,1
新竹縣,新豐鄉,0316,463,149,612,20,632,1247,50.68%,37.13%,1
新竹縣,新豐鄉,0317,581,198,779,16,795,1411,56.34%,41.18%,1
新竹縣,新豐鄉,0318,539,163,702,34,736,1238,59.45%,43.54%,1
新竹縣,芎林鄉,0319,178,56,234,13,247,417,59.23%,42.69%,1
新竹縣,芎林鄉,0320,283,81,364,15,379,534,70.97%,53%,1
新竹縣,芎林鄉,0321,405,141,546,20,566,963,58.77%,42.06%,1
新竹縣,芎林鄉,0322,187,68,255,16,271,418,64.83%,44.74%,1
新竹縣,芎林鄉,0323,542,155,697,31,728,1312,55.49%,41.31%,1
新竹縣,芎林鄉,0324,497,165,662,25,687,1354,50.74%,36.71%,1
新竹縣,芎林鄉,0325,333,114,447,30,477,785,60.76%,42.42%,1
新竹縣,芎林鄉,0326,367,106,473,18,491,797,61.61%,46.05%,1
新竹縣,芎林鄉,0327,309,74,383,18,401,623,64.37%,49.6%,1
新竹縣,芎林鄉,0328,343,94,437,20,457,759,60.21%,45.19%,1
新竹縣,芎林鄉,0329,445,171,616,34,650,1272,51.1%,34.98%,1
新竹縣,芎林鄉,0330,507,145,652,22,674,1129,59.7%,44.91%,1
新竹縣,芎林鄉,0331,321,109,430,17,447,713,62.69%,45.02%,1
新竹縣,芎林鄉,0332,385,114,499,23,522,839,62.22%,45.89%,1
新竹縣,芎林鄉,0333,559,154,713,28,741,1123,65.98%,49.78%,1
新竹縣,芎林鄉,0334,431,142,573,20,593,981,60.45%,43.93%,1
新竹縣,芎林鄉,0335,407,225,632,31,663,1078,61.5%,37.76%,1
新竹縣,芎林鄉,0336,424,150,574,23,597,1094,54.57%,38.76%,1
新竹縣,芎林鄉,0337,468,146,614,42,656,1102,59.53%,42.47%,1
新竹縣,橫山鄉,0338,544,165,709,44,753,1231,61.17%,44.19%,1
新竹縣,橫山鄉,0339,459,129,588,40,628,1041,60.33%,44.09%,1
新竹縣,橫山鄉,0340,530,132,662,24,686,1132,60.6%,46.82%,1
新竹縣,橫山鄉,0341,407,103,510,27,537,859,62.51%,47.38%,1
新竹縣,橫山鄉,0342,92,16,108,13,121,204,59.31%,45.1%,1
新竹縣,橫山鄉,0343,83,14,97,5,102,222,45.95%,37.39%,1
新竹縣,橫山鄉,0344,151,55,206,13,219,338,64.79%,44.67%,1
新竹縣,橫山鄉,0345,385,83,468,24,492,916,53.71%,42.03%,1
新竹縣,橫山鄉,0346,184,50,234,8,242,573,42.23%,32.11%,1
新竹縣,橫山鄉,0347,133,51,184,8,192,275,69.82%,48.36%,1
新竹縣,橫山鄉,0348,182,37,219,11,230,463,49.68%,39.31%,1
新竹縣,橫山鄉,0349,314,95,409,31,440,690,63.77%,45.51%,1
新竹縣,橫山鄉,0350,116,26,142,9,151,288,52.43%,40.28%,1
新竹縣,橫山鄉,0351,311,92,403,39,442,685,64.53%,45.4%,1
新竹縣,橫山鄉,0352,408,104,512,25,537,868,61.87%,47%,1
新竹縣,橫山鄉,0353,753,158,911,57,968,1561,62.01%,48.24%,1
新竹縣,北埔鄉,0354,445,152,597,13,610,1158,52.68%,38.43%,1
新竹縣,北埔鄉,0355,516,185,701,43,744,1238,60.1%,41.68%,1
新竹縣,北埔鄉,0356,250,74,324,18,342,580,58.97%,43.1%,1
新竹縣,北埔鄉,0357,420,108,528,21,549,931,58.97%,45.11%,1
新竹縣,北埔鄉,0358,680,212,892,42,934,1653,56.5%,41.14%,1
新竹縣,北埔鄉,0359,368,96,464,20,484,845,57.28%,43.55%,1
新竹縣,北埔鄉,0360,168,41,209,11,220,384,57.29%,43.75%,1
新竹縣,北埔鄉,0361,316,90,406,24,430,763,56.36%,41.42%,1
新竹縣,北埔鄉,0362,131,40,171,13,184,333,55.26%,39.34%,1
新竹縣,北埔鄉,0363,137,22,159,4,163,295,55.25%,46.44%,1
新竹縣,寶山鄉,0364,462,181,643,20,663,1158,57.25%,39.9%,1
新竹縣,寶山鄉,0365,549,260,809,25,834,1437,58.04%,38.2%,1
新竹縣,寶山鄉,0366,601,210,811,33,844,1470,57.41%,40.88%,1
新竹縣,寶山鄉,0367,485,188,673,34,707,1170,60.43%,41.45%,1
新竹縣,寶山鄉,0368,726,337,1063,42,1105,1900,58.16%,38.21%,1
新竹縣,寶山鄉,0369,391,137,528,17,545,1056,51.61%,37.03%,1
新竹縣,寶山鄉,0370,566,146,712,45,757,1205,62.82%,46.97%,1
新竹縣,寶山鄉,0371,339,78,417,25,442,766,57.7%,44.26%,1
新竹縣,寶山鄉,0372,393,102,495,26,521,846,61.58%,46.45%,1
新竹縣,寶山鄉,0373,345,125,470,18,488,804,60.7%,42.91%,1
新竹縣,寶山鄉,0374,285,75,360,9,369,607,60.79%,46.95%,1
新竹縣,寶山鄉,0375,253,95,348,13,361,554,65.16%,45.67%,1
新竹縣,峨眉鄉,0376,420,119,539,37,576,879,65.53%,47.78%,1
新竹縣,峨眉鄉,0377,309,100,409,24,433,683,63.4%,45.24%,1
新竹縣,峨眉鄉,0378,275,71,346,21,367,604,60.76%,45.53%,1
新竹縣,峨眉鄉,0379,162,28,190,9,199,339,58.7%,47.79%,1
新竹縣,峨眉鄉,0380,104,18,122,4,126,276,45.65%,37.68%,1
新竹縣,峨眉鄉,0381,659,158,817,40,857,1406,60.95%,46.87%,1
新竹縣,峨眉鄉,0382,236,46,282,9,291,462,62.99%,51.08%,1
新竹縣,峨眉鄉,0383,162,54,216,12,228,419,54.42%,38.66%,1
新竹縣,尖石鄉,0384,193,40,233,10,243,474,51.27%,40.72%,1
新竹縣,尖石鄉,0385,172,34,206,3,209,357,58.54%,48.18%,1
新竹縣,尖石鄉,0386,90,10,100,11,111,225,49.33%,40%,1
新竹縣,尖石鄉,0387,196,22,218,10,228,374,60.96%,52.41%,1
新竹縣,尖石鄉,0388,367,60,427,11,438,773,56.66%,47.48%,1
新竹縣,尖石鄉,0389,309,35,344,11,355,490,72.45%,63.06%,1
新竹縣,尖石鄉,0390,229,32,261,4,265,531,49.91%,43.13%,1
新竹縣,尖石鄉,0391,357,36,393,9,402,660,60.91%,54.09%,1
新竹縣,尖石鄉,0392,361,47,408,22,430,613,70.15%,58.89%,1
新竹縣,尖石鄉,0393,251,62,313,3,316,593,53.29%,42.33%,1
新竹縣,尖石鄉,0394,272,54,326,12,338,575,58.78%,47.3%,1
新竹縣,尖石鄉,0395,71,10,81,3,84,126,66.67%,56.35%,1
新竹縣,尖石鄉,0396,249,23,272,4,276,499,55.31%,49.9%,1
新竹縣,尖石鄉,0397,288,64,352,17,369,785,47.01%,36.69%,1
新竹縣,尖石鄉,0398,146,44,190,10,200,289,69.2%,50.52%,1
新竹縣,五峰鄉,0399,354,55,409,21,430,672,63.99%,52.68%,1
新竹縣,五峰鄉,0400,290,64,354,9,363,713,50.91%,40.67%,1
新竹縣,五峰鄉,0401,217,49,266,8,274,594,46.13%,36.53%,1
新竹縣,五峰鄉,0402,389,75,464,12,476,896,53.13%,43.42%,1
新竹縣,五峰鄉,0403,335,61,396,11,407,727,55.98%,46.08%,1
新竹縣,五峰鄉,0404,189,39,228,4,232,395,58.73%,47.85%,1
苗栗縣,苗栗市,0001,459,148,607,24,631,1087,58.05%,42.23%,1
苗栗縣,苗栗市,0002,415,131,546,23,569,1018,55.89%,40.77%,1
苗栗縣,苗栗市,0003,479,157,636,13,649,1156,56.14%,41.44%,1
苗栗縣,苗栗市,0004,465,126,591,23,614,1118,54.92%,41.59%,1
苗栗縣,苗栗市,0005,456,149,605,33,638,1084,58.86%,42.07%,1
苗栗縣,苗栗市,0006,531,156,687,30,717,1203,59.6%,44.14%,1
苗栗縣,苗栗市,0007,583,162,745,40,785,1306,60.11%,44.64%,1
苗栗縣,苗栗市,0008,526,158,684,34,718,1193,60.18%,44.09%,1
苗栗縣,苗栗市,0009,485,143,628,33,661,1115,59.28%,43.5%,1
苗栗縣,苗栗市,0010,542,124,666,21,687,1119,61.39%,48.44%,1
苗栗縣,苗栗市,0011,508,173,681,15,696,1132,61.48%,44.88%,1
苗栗縣,苗栗市,0012,553,168,721,26,747,1289,57.95%,42.9%,1
苗栗縣,苗栗市,0013,557,180,737,24,761,1264,60.21%,44.07%,1
苗栗縣,苗栗市,0014,391,81,472,23,495,870,56.9%,44.94%,1
苗栗縣,苗栗市,0015,388,103,491,22,513,1008,50.89%,38.49%,1
苗栗縣,苗栗市,0016,407,142,549,22,571,1078,52.97%,37.76%,1
苗栗縣,苗栗市,0017,499,145,644,11,655,1077,60.82%,46.33%,1
苗栗縣,苗栗市,0018,381,122,503,17,520,880,59.09%,43.3%,1
苗栗縣,苗栗市,0019,367,106,473,30,503,894,56.26%,41.05%,1
苗栗縣,苗栗市,0020,226,56,282,23,305,522,58.43%,43.3%,1
苗栗縣,苗栗市,0021,629,213,842,33,875,1376,63.59%,45.71%,1
苗栗縣,苗栗市,0022,566,177,743,26,769,1391,55.28%,40.69%,1
苗栗縣,苗栗市,0023,463,156,619,34,653,1081,60.41%,42.83%,1
苗栗縣,苗栗市,0024,516,174,690,22,712,1272,55.97%,40.57%,1
苗栗縣,苗栗市,0025,531,165,696,20,716,1112,64.39%,47.75%,1
苗栗縣,苗栗市,0026,416,114,530,17,547,813,67.28%,51.17%,1
苗栗縣,苗栗市,0027,317,99,416,22,438,767,57.11%,41.33%,1
苗栗縣,苗栗市,0028,421,138,559,19,578,1010,57.23%,41.68%,1
苗栗縣,苗栗市,0029,502,147,649,17,666,1182,56.35%,42.47%,1
苗栗縣,苗栗市,0030,410,124,534,24,558,965,57.82%,42.49%,1
苗栗縣,苗栗市,0031,274,84,358,7,365,607,60.13%,45.14%,1
苗栗縣,苗栗市,0032,435,164,599,15,614,990,62.02%,43.94%,1
苗栗縣,苗栗市,0033,495,146,641,29,670,1230,54.47%,40.24%,1
苗栗縣,苗栗市,0034,588,177,765,34,799,1372,58.24%,42.86%,1
苗栗縣,苗栗市,0035,508,183,691,23,714,1213,58.86%,41.88%,1
苗栗縣,苗栗市,0036,508,194,702,24,726,1272,57.08%,39.94%,1
苗栗縣,苗栗市,0037,578,141,719,28,747,1221,61.18%,47.34%,1
苗栗縣,苗栗市,0038,459,156,615,33,648,1104,58.7%,41.58%,1
苗栗縣,苗栗市,0039,475,140,615,15,630,1171,53.8%,40.56%,1
苗栗縣,苗栗市,0040,588,172,760,24,784,1392,56.32%,42.24%,1
苗栗縣,苗栗市,0041,590,180,770,28,798,1356,58.85%,43.51%,1
苗栗縣,苗栗市,0042,586,208,794,23,817,1387,58.9%,42.25%,1
苗栗縣,苗栗市,0043,487,165,652,25,677,1206,56.14%,40.38%,1
苗栗縣,苗栗市,0044,473,138,611,31,642,1004,63.94%,47.11%,1
苗栗縣,苗栗市,0045,493,166,659,19,678,1202,56.41%,41.01%,1
苗栗縣,苗栗市,0046,465,159,624,17,641,1052,60.93%,44.2%,1
苗栗縣,苗栗市,0047,404,125,529,19,548,873,62.77%,46.28%,1
苗栗縣,苗栗市,0048,496,138,634,19,653,975,66.97%,50.87%,1
苗栗縣,苗栗市,0049,473,144,617,27,644,1003,64.21%,47.16%,1
苗栗縣,苗栗市,0050,416,157,573,9,582,1000,58.2%,41.6%,1
苗栗縣,苗栗市,0051,434,138,572,18,590,1047,56.35%,41.45%,1
苗栗縣,苗栗市,0052,456,143,599,31,630,1025,61.46%,44.49%,1
苗栗縣,苗栗市,0053,467,118,585,25,610,1130,53.98%,41.33%,1
苗栗縣,苗栗市,0054,470,166,636,16,652,1146,56.89%,41.01%,1
苗栗縣,苗栗市,0055,583,214,797,31,828,1432,57.82%,40.71%,1
苗栗縣,苗栗市,0056,548,133,681,30,711,1492,47.65%,36.73%,1
苗栗縣,苗栗市,0057,504,163,667,23,690,1125,61.33%,44.8%,1
苗栗縣,苗栗市,0058,498,172,670,24,694,1241,55.92%,40.13%,1
苗栗縣,苗栗市,0059,564,195,759,20,779,1278,60.95%,44.13%,1
苗栗縣,苗栗市,0060,542,171,713,18,731,1293,56.54%,41.92%,1
苗栗縣,苗栗市,0061,520,174,694,21,715,1342,53.28%,38.75%,1
苗栗縣,苗栗市,0062,362,105,467,13,480,857,56.01%,42.24%,1
苗栗縣,苗栗市,0063,488,125,613,34,647,1180,54.83%,41.36%,1
苗栗縣,苗栗市,0064,479,142,621,15,636,1072,59.33%,44.68%,1
苗栗縣,苗栗市,0065,404,82,486,23,509,912,55.81%,44.3%,1
苗栗縣,苗栗市,0066,330,74,404,22,426,796,53.52%,41.46%,1
苗栗縣,苗栗市,0067,299,128,427,15,442,869,50.86%,34.41%,1
苗栗縣,苑裡鎮,0183,379,114,493,30,523,873,59.91%,43.41%,1
苗栗縣,苑裡鎮,0184,601,173,774,23,797,1346,59.21%,44.65%,1
苗栗縣,苑裡鎮,0185,459,147,606,23,629,951,66.14%,48.26%,1
苗栗縣,苑裡鎮,0186,279,62,341,15,356,615,57.89%,45.37%,1
苗栗縣,苑裡鎮,0187,420,95,515,0,515,878,58.66%,47.84%,1
苗栗縣,苑裡鎮,0188,336,119,455,20,475,767,61.93%,43.81%,1
苗栗縣,苑裡鎮,0189,338,89,427,21,448,776,57.73%,43.56%,1
苗栗縣,苑裡鎮,0190,499,137,636,39,675,1231,54.83%,40.54%,1
苗栗縣,苑裡鎮,0191,514,150,664,24,688,1145,60.09%,44.89%,1
苗栗縣,苑裡鎮,0192,356,96,452,26,478,850,56.24%,41.88%,1
苗栗縣,苑裡鎮,0193,432,121,553,34,587,1052,55.8%,41.06%,1
苗栗縣,苑裡鎮,0194,471,137,608,31,639,1114,57.36%,42.28%,1
苗栗縣,苑裡鎮,0195,475,163,638,38,676,1136,59.51%,41.81%,1
苗栗縣,苑裡鎮,0196,493,147,640,40,680,1194,56.95%,41.29%,1
苗栗縣,苑裡鎮,0197,675,195,870,39,909,1579,57.57%,42.75%,1
苗栗縣,苑裡鎮,0198,506,182,688,28,716,1149,62.32%,44.04%,1
苗栗縣,苑裡鎮,0199,457,149,606,37,643,1057,60.83%,43.24%,1
苗栗縣,苑裡鎮,0200,420,118,538,28,566,1101,51.41%,38.15%,1
苗栗縣,苑裡鎮,0201,336,92,428,28,456,912,50%,36.84%,1
苗栗縣,苑裡鎮,0202,279,71,350,18,368,652,56.44%,42.79%,1
苗栗縣,苑裡鎮,0203,568,163,731,53,784,1348,58.16%,42.14%,1
苗栗縣,苑裡鎮,0204,275,92,367,14,381,733,51.98%,37.52%,1
苗栗縣,苑裡鎮,0205,249,81,330,18,348,662,52.57%,37.61%,1
苗栗縣,苑裡鎮,0206,372,120,492,28,520,893,58.23%,41.66%,1
苗栗縣,苑裡鎮,0207,414,112,526,23,549,910,60.33%,45.49%,1
苗栗縣,苑裡鎮,0208,511,142,653,55,708,1270,55.75%,40.24%,1
苗栗縣,苑裡鎮,0209,209,64,273,19,292,545,53.58%,38.35%,1
苗栗縣,苑裡鎮,0210,389,79,468,34,502,792,63.38%,49.12%,1
苗栗縣,苑裡鎮,0211,304,91,395,22,417,726,57.44%,41.87%,1
苗栗縣,苑裡鎮,0212,294,67,361,11,372,827,44.98%,35.55%,1
苗栗縣,苑裡鎮,0213,345,99,444,25,469,782,59.97%,44.12%,1
苗栗縣,苑裡鎮,0214,327,86,413,23,436,788,55.33%,41.5%,1
苗栗縣,苑裡鎮,0215,335,97,432,36,468,846,55.32%,39.6%,1
苗栗縣,苑裡鎮,0216,373,97,470,35,505,828,60.99%,45.05%,1
苗栗縣,苑裡鎮,0217,418,101,519,31,550,943,58.32%,44.33%,1
苗栗縣,苑裡鎮,0218,505,120,625,18,643,1082,59.43%,46.67%,1
苗栗縣,苑裡鎮,0219,541,161,702,45,747,1234,60.53%,43.84%,1
苗栗縣,苑裡鎮,0220,555,155,710,54,764,1434,53.28%,38.7%,1
苗栗縣,苑裡鎮,0221,441,112,553,18,571,987,57.85%,44.68%,1
苗栗縣,苑裡鎮,0222,415,125,540,24,564,882,63.95%,47.05%,1
苗栗縣,通霄鎮,0149,453,178,631,42,673,1142,58.93%,39.67%,1
苗栗縣,通霄鎮,0150,408,145,553,24,577,884,65.27%,46.15%,1
苗栗縣,通霄鎮,0151,463,118,581,28,609,1068,57.02%,43.35%,1
苗栗縣,通霄鎮,0152,493,133,626,25,651,1009,64.52%,48.86%,1
苗栗縣,通霄鎮,0153,417,134,551,12,563,859,65.54%,48.54%,1
苗栗縣,通霄鎮,0154,426,159,585,24,609,1040,58.56%,40.96%,1
苗栗縣,通霄鎮,0155,381,98,479,19,498,1008,49.4%,37.8%,1
苗栗縣,通霄鎮,0156,312,69,381,27,408,686,59.48%,45.48%,1
苗栗縣,通霄鎮,0157,394,103,497,23,520,761,68.33%,51.77%,1
苗栗縣,通霄鎮,0158,318,87,405,10,415,790,52.53%,40.25%,1
苗栗縣,通霄鎮,0159,401,114,515,19,534,966,55.28%,41.51%,1
苗栗縣,通霄鎮,0160,394,83,477,28,505,972,51.95%,40.53%,1
苗栗縣,通霄鎮,0161,344,78,422,18,440,771,57.07%,44.62%,1
苗栗縣,通霄鎮,0162,265,76,341,24,365,758,48.15%,34.96%,1
苗栗縣,通霄鎮,0163,424,142,566,19,585,1078,54.27%,39.33%,1
苗栗縣,通霄鎮,0164,152,28,180,19,199,459,43.36%,33.12%,1
苗栗縣,通霄鎮,0165,321,100,421,28,449,894,50.22%,35.91%,1
苗栗縣,通霄鎮,0166,116,33,149,10,159,402,39.55%,28.86%,1
苗栗縣,通霄鎮,0167,316,99,415,19,434,802,54.11%,39.4%,1
苗栗縣,通霄鎮,0168,259,97,356,9,365,684,53.36%,37.87%,1
苗栗縣,通霄鎮,0169,340,75,415,26,441,943,46.77%,36.06%,1
苗栗縣,通霄鎮,0170,334,110,444,36,480,790,60.76%,42.28%,1
苗栗縣,通霄鎮,0171,236,53,289,7,296,673,43.98%,35.07%,1
苗栗縣,通霄鎮,0172,488,125,613,38,651,1232,52.84%,39.61%,1
苗栗縣,通霄鎮,0173,587,130,717,41,758,1286,58.94%,45.65%,1
苗栗縣,通霄鎮,0174,285,84,369,20,389,649,59.94%,43.91%,1
苗栗縣,通霄鎮,0175,278,87,365,24,389,769,50.59%,36.15%,1
苗栗縣,通霄鎮,0176,448,136,584,44,628,1148,54.7%,39.02%,1
苗栗縣,通霄鎮,0177,404,135,539,36,575,1138,50.53%,35.5%,1
苗栗縣,通霄鎮,0178,423,129,552,36,588,1121,52.45%,37.73%,1
苗栗縣,通霄鎮,0179,311,95,406,21,427,769,55.53%,40.44%,1
苗栗縣,通霄鎮,0180,227,70,297,13,310,616,50.32%,36.85%,1
苗栗縣,通霄鎮,0181,322,93,415,26,441,799,55.19%,40.3%,1
苗栗縣,通霄鎮,0182,281,80,361,26,387,743,52.09%,37.82%,1
苗栗縣,竹南鎮,0270,441,190,631,25,656,1086,60.41%,40.61%,1
苗栗縣,竹南鎮,0271,336,126,462,29,491,826,59.44%,40.68%,1
苗栗縣,竹南鎮,0272,378,162,540,21,561,1051,53.38%,35.97%,1
苗栗縣,竹南鎮,0273,532,169,701,32,733,1235,59.35%,43.08%,1
苗栗縣,竹南鎮,0274,406,165,571,49,620,1016,61.02%,39.96%,1
苗栗縣,竹南鎮,0275,555,207,762,35,797,1472,54.14%,37.7%,1
苗栗縣,竹南鎮,0276,474,157,631,20,651,1301,50.04%,36.43%,1
苗栗縣,竹南鎮,0277,527,235,762,24,786,1544,50.91%,34.13%,1
苗栗縣,竹南鎮,0278,572,229,801,29,830,1512,54.89%,37.83%,1
苗栗縣,竹南鎮,0279,536,219,755,23,778,1463,53.18%,36.64%,1
苗栗縣,竹南鎮,0280,405,153,558,11,569,1073,53.03%,37.74%,1
苗栗縣,竹南鎮,0281,621,204,825,14,839,1453,57.74%,42.74%,1
苗栗縣,竹南鎮,0282,546,189,735,21,756,1245,60.72%,43.86%,1
苗栗縣,竹南鎮,0283,664,204,868,22,890,1487,59.85%,44.65%,1
苗栗縣,竹南鎮,0284,433,151,584,22,606,1018,59.53%,42.53%,1
苗栗縣,竹南鎮,0285,445,182,627,20,647,1105,58.55%,40.27%,1
苗栗縣,竹南鎮,0286,498,178,676,29,705,1322,53.33%,37.67%,1
苗栗縣,竹南鎮,0287,492,154,646,17,663,1140,58.16%,43.16%,1
苗栗縣,竹南鎮,0288,465,172,637,18,655,1067,61.39%,43.58%,1
苗栗縣,竹南鎮,0289,529,159,688,28,716,1136,63.03%,46.57%,1
苗栗縣,竹南鎮,0290,473,155,628,25,653,1253,52.11%,37.75%,1
苗栗縣,竹南鎮,0291,363,129,492,22,514,963,53.37%,37.69%,1
苗栗縣,竹南鎮,0292,403,131,534,23,557,1021,54.55%,39.47%,1
苗栗縣,竹南鎮,0293,494,181,675,23,698,1154,60.49%,42.81%,1
苗栗縣,竹南鎮,0294,433,148,581,19,600,1042,57.58%,41.55%,1
苗栗縣,竹南鎮,0295,540,175,715,30,745,1293,57.62%,41.76%,1
苗栗縣,竹南鎮,0296,360,114,474,15,489,816,59.93%,44.12%,1
苗栗縣,竹南鎮,0297,412,127,539,24,563,989,56.93%,41.66%,1
苗栗縣,竹南鎮,0298,511,137,648,31,679,1122,60.52%,45.54%,1
苗栗縣,竹南鎮,0299,366,143,509,12,521,1111,46.89%,32.94%,1
苗栗縣,竹南鎮,0300,478,113,591,26,617,1036,59.56%,46.14%,1
苗栗縣,竹南鎮,0301,431,108,539,21,560,1112,50.36%,38.76%,1
苗栗縣,竹南鎮,0302,510,176,686,16,702,1348,52.08%,37.83%,1
苗栗縣,竹南鎮,0303,465,169,634,24,658,1114,59.07%,41.74%,1
苗栗縣,竹南鎮,0304,465,179,644,30,674,1119,60.23%,41.55%,1
苗栗縣,竹南鎮,0305,363,109,472,26,498,878,56.72%,41.34%,1
苗栗縣,竹南鎮,0306,483,141,624,29,653,1059,61.66%,45.61%,1
苗栗縣,竹南鎮,0307,369,135,504,23,527,869,60.64%,42.46%,1
苗栗縣,竹南鎮,0308,344,91,435,15,450,800,56.25%,43%,1
苗栗縣,竹南鎮,0309,509,180,689,23,712,1165,61.12%,43.69%,1
苗栗縣,竹南鎮,0310,340,105,445,17,462,791,58.41%,42.98%,1
苗栗縣,竹南鎮,0311,291,83,374,16,390,677,57.61%,42.98%,1
苗栗縣,竹南鎮,0312,376,111,487,34,521,797,65.37%,47.18%,1
苗栗縣,竹南鎮,0313,512,137,649,15,664,1191,55.75%,42.99%,1
苗栗縣,竹南鎮,0314,408,122,530,19,549,1027,53.46%,39.73%,1
苗栗縣,竹南鎮,0315,535,233,768,21,789,1341,58.84%,39.9%,1
苗栗縣,竹南鎮,0316,525,153,678,26,704,1378,51.09%,38.1%,1
苗栗縣,竹南鎮,0317,515,151,666,15,681,1216,56%,42.35%,1
苗栗縣,竹南鎮,0318,638,178,816,31,847,1570,53.95%,40.64%,1
苗栗縣,竹南鎮,0319,238,77,315,24,339,538,63.01%,44.24%,1
苗栗縣,竹南鎮,0320,450,114,564,22,586,1166,50.26%,38.59%,1
苗栗縣,竹南鎮,0321,531,233,764,19,783,1488,52.62%,35.69%,1
苗栗縣,竹南鎮,0322,545,168,713,17,730,1449,50.38%,37.61%,1
苗栗縣,竹南鎮,0323,476,154,630,34,664,1182,56.18%,40.27%,1
苗栗縣,竹南鎮,0324,460,156,616,56,672,1175,57.19%,39.15%,1
苗栗縣,竹南鎮,0325,415,128,543,28,571,983,58.09%,42.22%,1
苗栗縣,竹南鎮,0326,242,48,290,19,309,492,62.8%,49.19%,1
苗栗縣,竹南鎮,0327,441,151,592,31,623,1074,58.01%,41.06%,1
苗栗縣,竹南鎮,0328,334,111,445,29,474,852,55.63%,39.2%,1
苗栗縣,竹南鎮,0329,491,182,673,16,689,1297,53.12%,37.86%,1
苗栗縣,竹南鎮,0330,398,127,525,34,559,1028,54.38%,38.72%,1
苗栗縣,頭份市,0331,359,104,463,34,497,915,54.32%,39.23%,1
苗栗縣,頭份市,0332,574,139,713,23,736,1292,56.97%,44.43%,1
苗栗縣,頭份市,0333,411,119,530,22,552,928,59.48%,44.29%,1
苗栗縣,頭份市,0334,349,85,434,14,448,835,53.65%,41.8%,1
苗栗縣,頭份市,0335,446,125,571,18,589,1070,55.05%,41.68%,1
苗栗縣,頭份市,0336,347,105,452,10,462,879,52.56%,39.48%,1
苗栗縣,頭份市,0337,380,142,522,20,542,1039,52.17%,36.57%,1
苗栗縣,頭份市,0338,502,132,634,27,661,1129,58.55%,44.46%,1
苗栗縣,頭份市,0339,431,117,548,24,572,1041,54.95%,41.4%,1
苗栗縣,頭份市,0340,596,167,763,35,798,1546,51.62%,38.55%,1
苗栗縣,頭份市,0341,435,122,557,26,583,935,62.35%,46.52%,1
苗栗縣,頭份市,0342,453,137,590,29,619,1180,52.46%,38.39%,1
苗栗縣,頭份市,0343,589,161,750,28,778,1499,51.9%,39.29%,1
苗栗縣,頭份市,0344,263,136,399,8,407,747,54.48%,35.21%,1
苗栗縣,頭份市,0345,613,140,753,26,779,1406,55.41%,43.6%,1
苗栗縣,頭份市,0346,510,115,625,48,673,1193,56.41%,42.75%,1
苗栗縣,頭份市,0347,408,121,529,28,557,948,58.76%,43.04%,1
苗栗縣,頭份市,0348,352,102,454,18,472,869,54.32%,40.51%,1
苗栗縣,頭份市,0349,480,162,642,23,665,1142,58.23%,42.03%,1
苗栗縣,頭份市,0350,503,193,696,15,711,1286,55.29%,39.11%,1
苗栗縣,頭份市,0351,393,122,515,25,540,903,59.8%,43.52%,1
苗栗縣,頭份市,0352,546,162,708,26,734,1186,61.89%,46.04%,1
苗栗縣,頭份市,0353,440,150,590,13,603,1016,59.35%,43.31%,1
苗栗縣,頭份市,0354,406,130,536,23,559,985,56.75%,41.22%,1
苗栗縣,頭份市,0355,421,122,543,22,565,1037,54.48%,40.6%,1
苗栗縣,頭份市,0356,326,122,448,16,464,947,49%,34.42%,1
苗栗縣,頭份市,0357,382,118,500,21,521,890,58.54%,42.92%,1
苗栗縣,頭份市,0358,280,109,389,23,412,646,63.78%,43.34%,1
苗栗縣,頭份市,0359,424,131,555,31,586,975,60.1%,43.49%,1
苗栗縣,頭份市,0360,293,93,386,12,398,1015,39.21%,28.87%,1
苗栗縣,頭份市,0361,629,184,813,53,866,1399,61.9%,44.96%,1
苗栗縣,頭份市,0362,500,138,638,51,689,1143,60.28%,43.74%,1
苗栗縣,頭份市,0363,497,132,629,43,672,1030,65.24%,48.25%,1
苗栗縣,頭份市,0364,553,193,746,29,775,1338,57.92%,41.33%,1
苗栗縣,頭份市,0365,574,206,780,19,799,1450,55.1%,39.59%,1
苗栗縣,頭份市,0366,451,142,593,17,610,1042,58.54%,43.28%,1
苗栗縣,頭份市,0367,573,206,779,19,798,1326,60.18%,43.21%,1
苗栗縣,頭份市,0368,588,190,778,24,802,1270,63.15%,46.3%,1
苗栗縣,頭份市,0369,534,170,704,24,728,1288,56.52%,41.46%,1
苗栗縣,頭份市,0370,547,180,727,17,744,1243,59.86%,44.01%,1
苗栗縣,頭份市,0371,573,162,735,21,756,1280,59.06%,44.77%,1
苗栗縣,頭份市,0372,663,221,884,31,915,1618,56.55%,40.98%,1
苗栗縣,頭份市,0373,670,246,916,30,946,1759,53.78%,38.09%,1
苗栗縣,頭份市,0374,532,198,730,24,754,1264,59.65%,42.09%,1
苗栗縣,頭份市,0375,532,220,752,16,768,1326,57.92%,40.12%,1
苗栗縣,頭份市,0376,636,234,870,17,887,1551,57.19%,41.01%,1
苗栗縣,頭份市,0377,597,190,787,26,813,1574,51.65%,37.93%,1
苗栗縣,頭份市,0378,519,177,696,39,735,1262,58.24%,41.13%,1
苗栗縣,頭份市,0379,499,165,664,25,689,1171,58.84%,42.61%,1
苗栗縣,頭份市,0380,493,184,677,19,696,1074,64.8%,45.9%,1
苗栗縣,頭份市,0381,512,158,670,25,695,1141,60.91%,44.87%,1
苗栗縣,頭份市,0382,534,177,711,24,735,1259,58.38%,42.41%,1
苗栗縣,頭份市,0383,482,168,650,11,661,1186,55.73%,40.64%,1
苗栗縣,頭份市,0384,443,125,568,16,584,1121,52.1%,39.52%,1
苗栗縣,頭份市,0385,355,111,466,21,487,847,57.5%,41.91%,1
苗栗縣,頭份市,0386,419,157,576,23,599,993,60.32%,42.2%,1
苗栗縣,頭份市,0387,417,146,563,18,581,1055,55.07%,39.53%,1
苗栗縣,頭份市,0388,631,186,817,19,836,1655,50.51%,38.13%,1
苗栗縣,頭份市,0389,733,223,956,34,990,1799,55.03%,40.74%,1
苗栗縣,頭份市,0390,479,154,633,30,663,1141,58.11%,41.98%,1
苗栗縣,頭份市,0391,561,196,757,27,784,1431,54.79%,39.2%,1
苗栗縣,頭份市,0392,510,150,660,21,681,1412,48.23%,36.12%,1
苗栗縣,頭份市,0393,424,116,540,25,565,1074,52.61%,39.48%,1
苗栗縣,頭份市,0394,577,155,732,11,743,1245,59.68%,46.35%,1
苗栗縣,頭份市,0395,565,194,759,44,803,1344,59.75%,42.04%,1
苗栗縣,頭份市,0396,618,206,824,19,843,1363,61.85%,45.34%,1
苗栗縣,頭份市,0397,432,112,544,28,572,898,63.7%,48.11%,1
苗栗縣,頭份市,0398,511,169,680,39,719,1182,60.83%,43.23%,1
苗栗縣,頭份市,0399,616,150,766,19,785,1413,55.56%,43.6%,1
苗栗縣,頭份市,0400,456,136,592,24,616,991,62.16%,46.01%,1
苗栗縣,頭份市,0401,501,163,664,32,696,1180,58.98%,42.46%,1
苗栗縣,後龍鎮,0223,224,77,301,29,330,590,55.93%,37.97%,1
苗栗縣,後龍鎮,0224,395,131,526,42,568,883,64.33%,44.73%,1
苗栗縣,後龍鎮,0225,343,120,463,33,496,793,62.55%,43.25%,1
苗栗縣,後龍鎮,0226,320,103,423,19,442,732,60.38%,43.72%,1
苗栗縣,後龍鎮,0227,268,83,351,13,364,592,61.49%,45.27%,1
苗栗縣,後龍鎮,0228,474,153,627,40,667,1113,59.93%,42.59%,1
苗栗縣,後龍鎮,0229,467,184,651,26,677,1195,56.65%,39.08%,1
苗栗縣,後龍鎮,0230,454,141,595,28,623,997,62.49%,45.54%,1
苗栗縣,後龍鎮,0231,352,94,446,16,462,913,50.6%,38.55%,1
苗栗縣,後龍鎮,0232,249,67,316,26,342,641,53.35%,38.85%,1
苗栗縣,後龍鎮,0233,311,117,428,23,451,848,53.18%,36.67%,1
苗栗縣,後龍鎮,0234,504,146,650,49,699,1264,55.3%,39.87%,1
苗栗縣,後龍鎮,0235,363,112,475,28,503,965,52.12%,37.62%,1
苗栗縣,後龍鎮,0236,630,166,796,56,852,1216,70.07%,51.81%,1
苗栗縣,後龍鎮,0237,405,105,510,23,533,977,54.55%,41.45%,1
苗栗縣,後龍鎮,0238,341,106,447,29,476,943,50.48%,36.16%,1
苗栗縣,後龍鎮,0239,380,117,497,25,522,910,57.36%,41.76%,1
苗栗縣,後龍鎮,0240,366,83,449,25,474,851,55.7%,43.01%,1
苗栗縣,後龍鎮,0241,324,123,447,18,465,725,64.14%,44.69%,1
苗栗縣,後龍鎮,0242,273,95,368,22,390,650,60%,42%,1
苗栗縣,後龍鎮,0243,251,77,328,41,369,706,52.27%,35.55%,1
苗栗縣,後龍鎮,0244,319,93,412,26,438,748,58.56%,42.65%,1
苗栗縣,後龍鎮,0245,258,92,350,29,379,801,47.32%,32.21%,1
苗栗縣,後龍鎮,0246,487,104,591,34,625,1107,56.46%,43.99%,1
苗栗縣,後龍鎮,0247,469,144,613,44,657,1197,54.89%,39.18%,1
苗栗縣,後龍鎮,0248,393,100,493,34,527,1036,50.87%,37.93%,1
苗栗縣,後龍鎮,0249,307,90,397,29,426,913,46.66%,33.63%,1
苗栗縣,後龍鎮,0250,309,91,400,40,440,719,61.2%,42.98%,1
苗栗縣,後龍鎮,0251,440,117,557,42,599,1037,57.76%,42.43%,1
苗栗縣,後龍鎮,0252,214,80,294,14,308,601,51.25%,35.61%,1
苗栗縣,後龍鎮,0253,430,130,560,25,585,1269,46.1%,33.88%,1
苗栗縣,後龍鎮,0254,265,79,344,21,365,735,49.66%,36.05%,1
苗栗縣,後龍鎮,0255,108,30,138,10,148,422,35.07%,25.59%,1
苗栗縣,後龍鎮,0256,273,70,343,18,361,625,57.76%,43.68%,1
苗栗縣,後龍鎮,0257,430,108,538,37,575,1234,46.6%,34.85%,1
苗栗縣,卓蘭鎮,0442,440,116,556,29,585,961,60.87%,45.79%,1
苗栗縣,卓蘭鎮,0443,411,133,544,32,576,1017,56.64%,40.41%,1
苗栗縣,卓蘭鎮,0444,496,168,664,44,708,1095,64.66%,45.3%,1
苗栗縣,卓蘭鎮,0445,341,104,445,15,460,745,61.74%,45.77%,1
苗栗縣,卓蘭鎮,0446,324,88,412,20,432,783,55.17%,41.38%,1
苗栗縣,卓蘭鎮,0447,277,94,371,12,383,745,51.41%,37.18%,1
苗栗縣,卓蘭鎮,0448,392,92,484,22,506,999,50.65%,39.24%,1
苗栗縣,卓蘭鎮,0449,321,77,398,20,418,671,62.3%,47.84%,1
苗栗縣,卓蘭鎮,0450,349,103,452,33,485,734,66.08%,47.55%,1
苗栗縣,卓蘭鎮,0451,395,120,515,25,540,865,62.43%,45.66%,1
苗栗縣,卓蘭鎮,0452,397,108,505,22,527,828,63.65%,47.95%,1
苗栗縣,卓蘭鎮,0453,173,48,221,22,243,386,62.95%,44.82%,1
苗栗縣,卓蘭鎮,0454,310,106,416,28,444,688,64.53%,45.06%,1
苗栗縣,卓蘭鎮,0455,345,124,469,24,493,792,62.25%,43.56%,1
苗栗縣,卓蘭鎮,0456,320,95,415,19,434,729,59.53%,43.9%,1
苗栗縣,卓蘭鎮,0457,380,137,517,19,536,1093,49.04%,34.77%,1
苗栗縣,卓蘭鎮,0458,275,73,348,16,364,615,59.19%,44.72%,1
苗栗縣,卓蘭鎮,0459,43,2,45,3,48,86,55.81%,50%,1
苗栗縣,卓蘭鎮,0460,387,120,507,9,516,940,54.89%,41.17%,1
苗栗縣,大湖鄉,0420,296,87,383,23,406,744,54.57%,39.78%,1
苗栗縣,大湖鄉,0421,370,94,464,23,487,881,55.28%,42%,1
苗栗縣,大湖鄉,0422,248,77,325,16,341,596,57.21%,41.61%,1
苗栗縣,大湖鄉,0423,469,137,606,46,652,1260,51.75%,37.22%,1
苗栗縣,大湖鄉,0424,336,98,434,22,456,867,52.6%,38.75%,1
苗栗縣,大湖鄉,0425,396,112,508,13,521,923,56.45%,42.9%,1
苗栗縣,大湖鄉,0426,525,162,687,49,736,1395,52.76%,37.63%,1
苗栗縣,大湖鄉,0427,158,46,204,9,213,561,37.97%,28.16%,1
苗栗縣,大湖鄉,0428,282,73,355,18,373,638,58.46%,44.2%,1
苗栗縣,大湖鄉,0429,287,86,373,27,400,754,53.05%,38.06%,1
苗栗縣,大湖鄉,0430,209,39,248,4,252,501,50.3%,41.72%,1
苗栗縣,大湖鄉,0431,253,80,333,26,359,652,55.06%,38.8%,1
苗栗縣,大湖鄉,0432,298,90,388,28,416,843,49.35%,35.35%,1
苗栗縣,大湖鄉,0433,448,105,553,24,577,1020,56.57%,43.92%,1
苗栗縣,大湖鄉,0434,439,115,554,25,579,1018,56.88%,43.12%,1
苗栗縣,公館鄉,0068,379,112,491,32,523,789,66.29%,48.04%,1
苗栗縣,公館鄉,0069,384,119,503,22,525,792,66.29%,48.48%,1
苗栗縣,公館鄉,0070,532,144,676,44,720,1117,64.46%,47.63%,1
苗栗縣,公館鄉,0071,568,187,755,36,791,1255,63.03%,45.26%,1
苗栗縣,公館鄉,0072,509,151,660,28,688,1141,60.3%,44.61%,1
苗栗縣,公館鄉,0073,476,183,659,28,687,1172,58.62%,40.61%,1
苗栗縣,公館鄉,0074,504,160,664,33,697,1100,63.36%,45.82%,1
苗栗縣,公館鄉,0075,484,134,618,34,652,1232,52.92%,39.29%,1
苗栗縣,公館鄉,0076,418,118,536,37,573,1081,53.01%,38.67%,1
苗栗縣,公館鄉,0077,574,183,757,23,780,1250,62.4%,45.92%,1
苗栗縣,公館鄉,0078,453,140,593,40,633,1081,58.56%,41.91%,1
苗栗縣,公館鄉,0079,397,111,508,47,555,964,57.57%,41.18%,1
苗栗縣,公館鄉,0080,482,108,590,44,634,1038,61.08%,46.44%,1
苗栗縣,公館鄉,0081,171,43,214,13,227,360,63.06%,47.5%,1
苗栗縣,公館鄉,0082,360,101,461,36,497,865,57.46%,41.62%,1
苗栗縣,公館鄉,0083,456,169,625,26,651,1166,55.83%,39.11%,1
苗栗縣,公館鄉,0084,308,88,396,35,431,719,59.94%,42.84%,1
苗栗縣,公館鄉,0085,313,90,403,32,435,788,55.2%,39.72%,1
苗栗縣,公館鄉,0086,135,51,186,16,202,303,66.67%,44.55%,1
苗栗縣,公館鄉,0087,572,183,755,40,795,1322,60.14%,43.27%,1
苗栗縣,公館鄉,0088,402,99,501,34,535,933,57.34%,43.09%,1
苗栗縣,公館鄉,0089,581,169,750,41,791,1455,54.36%,39.93%,1
苗栗縣,公館鄉,0090,730,236,966,36,1002,1615,62.04%,45.2%,1
苗栗縣,公館鄉,0091,617,157,774,35,809,1451,55.75%,42.52%,1
苗栗縣,公館鄉,0092,604,234,838,44,882,1462,60.33%,41.31%,1
苗栗縣,公館鄉,0093,521,157,678,59,737,1317,55.96%,39.56%,1
苗栗縣,公館鄉,0094,104,24,128,4,132,221,59.73%,47.06%,1
苗栗縣,公館鄉,0095,140,27,167,8,175,329,53.19%,42.55%,1
苗栗縣,銅鑼鄉,0108,410,117,527,21,548,887,61.78%,46.22%,1
苗栗縣,銅鑼鄉,0109,458,140,598,33,631,1052,59.98%,43.54%,1
苗栗縣,銅鑼鄉,0110,575,217,792,31,823,1347,61.1%,42.69%,1
苗栗縣,銅鑼鄉,0111,507,136,643,30,673,1177,57.18%,43.08%,1
苗栗縣,銅鑼鄉,0112,506,154,660,24,684,1268,53.94%,39.91%,1
苗栗縣,銅鑼鄉,0113,418,135,553,27,580,1185,48.95%,35.27%,1
苗栗縣,銅鑼鄉,0114,437,121,558,39,597,1029,58.02%,42.47%,1
苗栗縣,銅鑼鄉,0115,407,91,498,26,524,905,57.9%,44.97%,1
苗栗縣,銅鑼鄉,0116,341,105,446,22,468,750,62.4%,45.47%,1
苗栗縣,銅鑼鄉,0117,411,101,512,35,547,1080,50.65%,38.06%,1
苗栗縣,銅鑼鄉,0118,426,132,558,49,607,1108,54.78%,38.45%,1
苗栗縣,銅鑼鄉,0119,318,107,425,32,457,862,53.02%,36.89%,1
苗栗縣,銅鑼鄉,0120,477,144,621,28,649,1216,53.37%,39.23%,1
苗栗縣,銅鑼鄉,0121,235,49,284,19,303,588,51.53%,39.97%,1
苗栗縣,銅鑼鄉,0122,160,46,206,29,235,429,54.78%,37.3%,1
苗栗縣,銅鑼鄉,0123,224,71,295,22,317,541,58.6%,41.4%,1
苗栗縣,南庄鄉,0411,462,144,606,35,641,1155,55.5%,40%,1
苗栗縣,南庄鄉,0412,257,85,342,31,373,650,57.38%,39.54%,1
苗栗縣,南庄鄉,0413,519,133,652,47,699,1353,51.66%,38.36%,1
苗栗縣,南庄鄉,0414,261,66,327,28,355,813,43.67%,32.1%,1
苗栗縣,南庄鄉,0415,295,51,346,15,361,837,43.13%,35.24%,1
苗栗縣,南庄鄉,0416,440,113,553,24,577,1093,52.79%,40.26%,1
苗栗縣,南庄鄉,0417,421,121,542,35,577,1048,55.06%,40.17%,1
苗栗縣,南庄鄉,0418,337,88,425,23,448,872,51.38%,38.65%,1
苗栗縣,南庄鄉,0419,241,68,309,8,317,963,32.92%,25.03%,1
苗栗縣,頭屋鄉,0096,672,171,843,50,893,1335,66.89%,50.34%,1
苗栗縣,頭屋鄉,0097,626,177,803,26,829,1168,70.98%,53.6%,1
苗栗縣,頭屋鄉,0098,395,102,497,22,519,792,65.53%,49.87%,1
苗栗縣,頭屋鄉,0099,470,152,622,36,658,918,71.68%,51.2%,1
苗栗縣,頭屋鄉,0100,361,82,443,23,466,725,64.28%,49.79%,1
苗栗縣,頭屋鄉,0101,426,109,535,20,555,899,61.74%,47.39%,1
苗栗縣,頭屋鄉,0102,145,32,177,7,184,369,49.86%,39.3%,1
苗栗縣,頭屋鄉,0103,371,120,491,13,504,844,59.72%,43.96%,1
苗栗縣,頭屋鄉,0104,437,153,590,23,613,1007,60.87%,43.4%,1
苗栗縣,頭屋鄉,0105,373,109,482,22,504,794,63.48%,46.98%,1
苗栗縣,頭屋鄉,0106,112,35,147,10,157,211,74.41%,53.08%,1
苗栗縣,頭屋鄉,0107,181,44,225,14,239,328,72.87%,55.18%,1
苗栗縣,三義鄉,0124,380,100,480,44,524,853,61.43%,44.55%,1
苗栗縣,三義鄉,0125,477,117,594,18,612,983,62.26%,48.52%,1
苗栗縣,三義鄉,0126,483,132,615,33,648,1080,60%,44.72%,1
苗栗縣,三義鄉,0127,487,150,637,13,650,1216,53.45%,40.05%,1
苗栗縣,三義鄉,0128,468,118,586,19,605,1017,59.49%,46.02%,1
苗栗縣,三義鄉,0129,470,151,621,11,632,1180,53.56%,39.83%,1
苗栗縣,三義鄉,0130,521,143,664,20,684,1198,57.1%,43.49%,1
苗栗縣,三義鄉,0131,187,41,228,13,241,417,57.79%,44.84%,1
苗栗縣,三義鄉,0132,398,107,505,20,525,991,52.98%,40.16%,1
苗栗縣,三義鄉,0133,379,98,477,16,493,834,59.11%,45.44%,1
苗栗縣,三義鄉,0134,264,79,343,24,367,622,59%,42.44%,1
苗栗縣,三義鄉,0135,325,99,424,36,460,749,61.42%,43.39%,1
苗栗縣,三義鄉,0136,353,85,438,22,460,692,66.47%,51.01%,1
苗栗縣,三義鄉,0137,398,102,500,35,535,759,70.49%,52.44%,1
苗栗縣,三義鄉,0138,249,67,316,21,337,629,53.58%,39.59%,1
苗栗縣,三義鄉,0139,275,89,364,21,385,669,57.55%,41.11%,1
苗栗縣,西湖鄉,0140,255,71,326,19,345,601,57.4%,42.43%,1
苗栗縣,西湖鄉,0141,253,57,310,31,341,566,60.25%,44.7%,1
苗栗縣,西湖鄉,0142,366,106,472,21,493,843,58.48%,43.42%,1
苗栗縣,西湖鄉,0143,247,84,331,15,346,648,53.4%,38.12%,1
苗栗縣,西湖鄉,0144,350,112,462,12,474,936,50.64%,37.39%,1
苗栗縣,西湖鄉,0145,176,61,237,12,249,461,54.01%,38.18%,1
苗栗縣,西湖鄉,0146,229,55,284,14,298,515,57.86%,44.47%,1
苗栗縣,西湖鄉,0147,489,91,580,35,615,1141,53.9%,42.86%,1
苗栗縣,西湖鄉,0148,292,81,373,23,396,671,59.02%,43.52%,1
苗栗縣,造橋鄉,0258,572,151,723,46,769,1171,65.67%,48.85%,1
苗栗縣,造橋鄉,0259,434,79,513,18,531,889,59.73%,48.82%,1
苗栗縣,造橋鄉,0260,181,46,227,12,239,479,49.9%,37.79%,1
苗栗縣,造橋鄉,0261,452,122,574,30,604,1024,58.98%,44.14%,1
苗栗縣,造橋鄉,0262,442,173,615,43,658,1214,54.2%,36.41%,1
苗栗縣,造橋鄉,0263,426,107,533,28,561,1071,52.38%,39.78%,1
苗栗縣,造橋鄉,0264,440,133,573,35,608,1157,52.55%,38.03%,1
苗栗縣,造橋鄉,0265,216,63,279,23,302,512,58.98%,42.19%,1
苗栗縣,造橋鄉,0266,220,69,289,20,309,491,62.93%,44.81%,1
苗栗縣,造橋鄉,0267,573,161,734,33,767,1272,60.3%,45.05%,1
苗栗縣,造橋鄉,0268,332,87,419,33,452,785,57.58%,42.29%,1
苗栗縣,造橋鄉,0269,440,137,577,59,636,962,66.11%,45.74%,1
苗栗縣,三灣鄉,0402,446,126,572,25,597,996,59.94%,44.78%,1
苗栗縣,三灣鄉,0403,493,152,645,46,691,1205,57.34%,40.91%,1
苗栗縣,三灣鄉,0404,291,71,362,27,389,635,61.26%,45.83%,1
苗栗縣,三灣鄉,0405,382,93,475,22,497,862,57.66%,44.32%,1
苗栗縣,三灣鄉,0406,93,19,112,6,118,238,49.58%,39.08%,1
苗栗縣,三灣鄉,0407,221,50,271,23,294,541,54.34%,40.85%,1
苗栗縣,三灣鄉,0408,215,61,276,23,299,578,51.73%,37.2%,1
苗栗縣,三灣鄉,0409,191,56,247,32,279,405,68.89%,47.16%,1
苗栗縣,三灣鄉,0410,166,36,202,22,224,392,57.14%,42.35%,1
苗栗縣,獅潭鄉,0435,97,25,122,8,130,328,39.63%,29.57%,1
苗栗縣,獅潭鄉,0436,186,39,225,26,251,565,44.42%,32.92%,1
苗栗縣,獅潭鄉,0437,400,91,491,33,524,911,57.52%,43.91%,1
苗栗縣,獅潭鄉,0438,198,54,252,20,272,568,47.89%,34.86%,1
苗栗縣,獅潭鄉,0439,259,55,314,28,342,580,58.97%,44.66%,1
苗栗縣,獅潭鄉,0440,145,25,170,5,175,333,52.55%,43.54%,1
苗栗縣,獅潭鄉,0441,280,54,334,19,353,683,51.68%,41%,1
苗栗縣,泰安鄉,0461,106,36,142,7,149,325,45.85%,32.62%,1
苗栗縣,泰安鄉,0462,220,54,274,13,287,484,59.3%,45.45%,1
苗栗縣,泰安鄉,0463,372,86,458,31,489,666,73.42%,55.86%,1
苗栗縣,泰安鄉,0464,303,58,361,28,389,574,67.77%,52.79%,1
苗栗縣,泰安鄉,0465,140,32,172,5,177,333,53.15%,42.04%,1
苗栗縣,泰安鄉,0466,282,56,338,11,349,495,70.51%,56.97%,1
苗栗縣,泰安鄉,0467,280,89,369,31,400,544,73.53%,51.47%,1
苗栗縣,泰安鄉,0468,241,59,300,17,317,500,63.4%,48.2%,1
苗栗縣,泰安鄉,0469,390,74,464,16,480,670,71.64%,58.21%,1
苗栗縣,泰安鄉,0470,384,75,459,4,463,589,78.61%,65.2%,1
彰化縣,彰化市,0001,376,134,510,25,535,871,61.42%,43.17%,1
彰化縣,彰化市,0002,259,77,336,28,364,751,48.47%,34.49%,1
彰化縣,彰化市,0003,412,176,588,23,611,923,66.2%,44.64%,1
彰化縣,彰化市,0004,333,130,463,21,484,779,62.13%,42.75%,1
彰化縣,彰化市,0005,324,137,461,18,479,779,61.49%,41.59%,1
彰化縣,彰化市,0006,300,117,417,18,435,720,60.42%,41.67%,1
彰化縣,彰化市,0007,300,126,426,22,448,749,59.81%,40.05%,1
彰化縣,彰化市,0008,356,121,477,24,501,767,65.32%,46.41%,1
彰化縣,彰化市,0009,492,140,632,30,662,1047,63.23%,46.99%,1
彰化縣,彰化市,0010,397,167,564,24,588,1027,57.25%,38.66%,1
彰化縣,彰化市,0011,523,175,698,27,725,1249,58.05%,41.87%,1
彰化縣,彰化市,0012,492,166,658,22,680,1136,59.86%,43.31%,1
彰化縣,彰化市,0013,534,172,706,22,728,1169,62.28%,45.68%,1
彰化縣,彰化市,0014,329,146,475,13,488,766,63.71%,42.95%,1
彰化縣,彰化市,0015,299,80,379,11,390,643,60.65%,46.5%,1
彰化縣,彰化市,0016,547,173,720,28,748,1251,59.79%,43.73%,1
彰化縣,彰化市,0017,350,145,495,13,508,1301,39.05%,26.9%,1
彰化縣,彰化市,0018,556,210,766,9,775,1280,60.55%,43.44%,1
彰化縣,彰化市,0019,543,205,748,14,762,1179,64.63%,46.06%,1
彰化縣,彰化市,0020,494,180,674,19,693,1168,59.33%,42.29%,1
彰化縣,彰化市,0021,549,156,705,15,720,1218,59.11%,45.07%,1
彰化縣,彰化市,0022,633,234,867,16,883,1351,65.36%,46.85%,1
彰化縣,彰化市,0023,501,216,717,15,732,1204,60.8%,41.61%,1
彰化縣,彰化市,0024,520,195,715,14,729,1189,61.31%,43.73%,1
彰化縣,彰化市,0025,496,169,665,33,698,1207,57.83%,41.09%,1
彰化縣,彰化市,0026,501,168,669,31,700,1161,60.29%,43.15%,1
彰化縣,彰化市,0027,440,210,650,26,676,1166,57.98%,37.74%,1
彰化縣,彰化市,0028,568,254,822,15,837,1362,61.45%,41.7%,1
彰化縣,彰化市,0029,534,221,755,21,776,1236,62.78%,43.2%,1
彰化縣,彰化市,0030,468,157,625,22,647,1065,60.75%,43.94%,1
彰化縣,彰化市,0031,504,198,702,37,739,1199,61.63%,42.04%,1
彰化縣,彰化市,0032,504,227,731,17,748,1233,60.67%,40.88%,1
彰化縣,彰化市,0033,605,99,704,20,724,1245,58.15%,48.59%,1
彰化縣,彰化市,0034,495,207,702,20,722,1153,62.62%,42.93%,1
彰化縣,彰化市,0035,418,158,576,18,594,1045,56.84%,40%,1
彰化縣,彰化市,0036,452,188,640,10,650,1097,59.25%,41.2%,1
彰化縣,彰化市,0037,478,197,675,21,696,1190,58.49%,40.17%,1
彰化縣,彰化市,0038,460,219,679,13,692,1106,62.57%,41.59%,1
彰化縣,彰化市,0039,474,168,642,20,662,1097,60.35%,43.21%,1
彰化縣,彰化市,0040,423,189,612,31,643,1048,61.35%,40.36%,1
彰化縣,彰化市,0041,415,175,590,25,615,980,62.76%,42.35%,1
彰化縣,彰化市,0042,311,123,434,14,448,707,63.37%,43.99%,1
彰化縣,彰化市,0043,349,122,471,19,490,809,60.57%,43.14%,1
彰化縣,彰化市,0044,421,182,603,31,634,1008,62.9%,41.77%,1
彰化縣,彰化市,0045,361,135,496,24,520,901,57.71%,40.07%,1
彰化縣,彰化市,0046,388,141,529,22,551,951,57.94%,40.8%,1
彰化縣,彰化市,0047,424,197,621,26,647,1076,60.13%,39.41%,1
彰化縣,彰化市,0048,409,151,560,20,580,1022,56.75%,40.02%,1
彰化縣,彰化市,0049,388,144,532,20,552,894,61.74%,43.4%,1
彰化縣,彰化市,0050,460,148,608,24,632,1016,62.2%,45.28%,1
彰化縣,彰化市,0051,350,129,479,20,499,771,64.72%,45.4%,1
彰化縣,彰化市,0052,379,144,523,22,545,868,62.79%,43.66%,1
彰化縣,彰化市,0053,489,174,663,26,689,1135,60.7%,43.08%,1
彰化縣,彰化市,0054,383,154,537,35,572,910,62.86%,42.09%,1
彰化縣,彰化市,0055,440,185,625,17,642,1004,63.94%,43.82%,1
彰化縣,彰化市,0056,481,167,648,25,673,1077,62.49%,44.66%,1
彰化縣,彰化市,0057,588,205,793,35,828,1258,65.82%,46.74%,1
彰化縣,彰化市,0058,468,166,634,23,657,1025,64.1%,45.66%,1
彰化縣,彰化市,0059,536,191,727,24,751,1177,63.81%,45.54%,1
彰化縣,彰化市,0060,524,180,704,26,730,1262,57.84%,41.52%,1
彰化縣,彰化市,0061,541,183,724,33,757,1209,62.61%,44.75%,1
彰化縣,彰化市,0062,460,181,641,21,662,1041,63.59%,44.19%,1
彰化縣,彰化市,0063,509,149,658,20,678,1075,63.07%,47.35%,1
彰化縣,彰化市,0064,433,141,574,18,592,1029,57.53%,42.08%,1
彰化縣,彰化市,0065,478,196,674,36,710,1203,59.02%,39.73%,1
彰化縣,彰化市,0066,422,144,566,26,592,1014,58.38%,41.62%,1
彰化縣,彰化市,0067,463,166,629,17,646,1069,60.43%,43.31%,1
彰化縣,彰化市,0068,375,132,507,17,524,969,54.08%,38.7%,1
彰化縣,彰化市,0069,430,146,576,20,596,1105,53.94%,38.91%,1
彰化縣,彰化市,0070,455,152,607,30,637,981,64.93%,46.38%,1
彰化縣,彰化市,0071,486,189,675,27,702,1095,64.11%,44.38%,1
彰化縣,彰化市,0072,504,159,663,18,681,1087,62.65%,46.37%,1
彰化縣,彰化市,0073,449,186,635,16,651,1050,62%,42.76%,1
彰化縣,彰化市,0074,527,216,743,29,772,1252,61.66%,42.09%,1
彰化縣,彰化市,0075,451,170,621,15,636,1113,57.14%,40.52%,1
彰化縣,彰化市,0076,440,184,624,13,637,1009,63.13%,43.61%,1
彰化縣,彰化市,0077,417,144,561,20,581,999,58.16%,41.74%,1
彰化縣,彰化市,0078,421,154,575,14,589,997,59.08%,42.23%,1
彰化縣,彰化市,0079,516,211,727,18,745,1145,65.07%,45.07%,1
彰化縣,彰化市,0080,523,212,735,18,753,1227,61.37%,42.62%,1
彰化縣,彰化市,0081,517,218,735,17,752,1208,62.25%,42.8%,1
彰化縣,彰化市,0082,657,254,911,18,929,1598,58.14%,41.11%,1
彰化縣,彰化市,0083,421,115,536,16,552,890,62.02%,47.3%,1
彰化縣,彰化市,0084,501,182,683,19,702,1104,63.59%,45.38%,1
彰化縣,彰化市,0085,450,164,614,21,635,1097,57.89%,41.02%,1
彰化縣,彰化市,0086,352,104,456,18,474,799,59.32%,44.06%,1
彰化縣,彰化市,0087,465,135,600,25,625,1000,62.5%,46.5%,1
彰化縣,彰化市,0088,504,128,632,46,678,1153,58.8%,43.71%,1
彰化縣,彰化市,0089,423,143,566,39,605,977,61.92%,43.3%,1
彰化縣,彰化市,0090,483,184,667,27,694,1201,57.79%,40.22%,1
彰化縣,彰化市,0091,448,183,631,34,665,1057,62.91%,42.38%,1
彰化縣,彰化市,0092,539,165,704,30,734,1238,59.29%,43.54%,1
彰化縣,彰化市,0093,564,154,718,29,747,1210,61.74%,46.61%,1
彰化縣,彰化市,0094,472,140,612,27,639,1026,62.28%,46%,1
彰化縣,彰化市,0095,481,196,677,20,697,1061,65.69%,45.33%,1
彰化縣,彰化市,0096,501,194,695,30,725,1213,59.77%,41.3%,1
彰化縣,彰化市,0097,518,231,749,25,774,1264,61.23%,40.98%,1
彰化縣,彰化市,0098,319,129,448,18,466,691,67.44%,46.16%,1
彰化縣,彰化市,0099,391,156,547,29,576,893,64.5%,43.78%,1
彰化縣,彰化市,0100,311,115,426,34,460,733,62.76%,42.43%,1
彰化縣,彰化市,0101,318,108,426,21,447,692,64.6%,45.95%,1
彰化縣,彰化市,0102,298,127,425,18,443,728,60.85%,40.93%,1
彰化縣,彰化市,0103,374,114,488,16,504,773,65.2%,48.38%,1
彰化縣,彰化市,0104,395,126,521,10,531,975,54.46%,40.51%,1
彰化縣,彰化市,0105,401,138,539,24,563,908,62%,44.16%,1
彰化縣,彰化市,0106,526,161,687,11,698,1156,60.38%,45.5%,1
彰化縣,彰化市,0107,542,193,735,21,756,1235,61.21%,43.89%,1
彰化縣,彰化市,0108,554,205,759,26,785,1376,57.05%,40.26%,1
彰化縣,彰化市,0109,549,231,780,1,781,1389,56.23%,39.52%,1
彰化縣,彰化市,0110,394,133,527,31,558,846,65.96%,46.57%,1
彰化縣,彰化市,0111,416,120,536,20,556,859,64.73%,48.43%,1
彰化縣,彰化市,0112,324,142,466,19,485,781,62.1%,41.49%,1
彰化縣,彰化市,0113,381,122,503,20,523,875,59.77%,43.54%,1
彰化縣,彰化市,0114,346,120,466,21,487,816,59.68%,42.4%,1
彰化縣,彰化市,0115,302,118,420,22,442,687,64.34%,43.96%,1
彰化縣,彰化市,0116,343,118,461,13,474,727,65.2%,47.18%,1
彰化縣,彰化市,0117,314,105,419,13,432,662,65.26%,47.43%,1
彰化縣,彰化市,0118,316,81,397,10,407,633,64.3%,49.92%,1
彰化縣,彰化市,0119,416,151,567,26,593,906,65.45%,45.92%,1
彰化縣,彰化市,0120,352,113,465,29,494,853,57.91%,41.27%,1
彰化縣,彰化市,0121,460,170,630,19,649,1027,63.19%,44.79%,1
彰化縣,彰化市,0122,472,142,614,27,641,993,64.55%,47.53%,1
彰化縣,彰化市,0123,382,115,497,28,525,848,61.91%,45.05%,1
彰化縣,彰化市,0124,491,199,690,17,707,1118,63.24%,43.92%,1
彰化縣,彰化市,0125,557,197,754,23,777,1263,61.52%,44.1%,1
彰化縣,彰化市,0126,571,201,772,35,807,1268,63.64%,45.03%,1
彰化縣,彰化市,0127,558,183,741,30,771,1258,61.29%,44.36%,1
彰化縣,彰化市,0128,550,197,747,11,758,1212,62.54%,45.38%,1
彰化縣,彰化市,0129,416,135,551,23,574,924,62.12%,45.02%,1
彰化縣,彰化市,0130,437,143,580,21,601,939,64%,46.54%,1
彰化縣,彰化市,0131,448,170,618,28,646,953,67.79%,47.01%,1
彰化縣,彰化市,0132,476,152,628,22,650,981,66.26%,48.52%,1
彰化縣,彰化市,0133,574,185,759,34,793,1249,63.49%,45.96%,1
彰化縣,彰化市,0134,438,98,536,20,556,817,68.05%,53.61%,1
彰化縣,彰化市,0135,373,140,513,25,538,872,61.7%,42.78%,1
彰化縣,彰化市,0136,291,100,391,19,410,689,59.51%,42.24%,1
彰化縣,彰化市,0137,535,176,711,19,730,1156,63.15%,46.28%,1
彰化縣,彰化市,0138,536,188,724,18,742,1291,57.47%,41.52%,1
彰化縣,彰化市,0139,484,159,643,26,669,1139,58.74%,42.49%,1
彰化縣,彰化市,0140,494,79,573,25,598,1125,53.16%,43.91%,1
彰化縣,彰化市,0141,531,162,693,31,724,1258,57.55%,42.21%,1
彰化縣,彰化市,0142,503,144,647,21,668,1123,59.48%,44.79%,1
彰化縣,彰化市,0143,510,171,681,21,702,1175,59.74%,43.4%,1
彰化縣,彰化市,0144,417,129,546,25,571,862,66.24%,48.38%,1
彰化縣,彰化市,0145,361,145,506,24,530,872,60.78%,41.4%,1
彰化縣,彰化市,0146,433,142,575,6,581,897,64.77%,48.27%,1
彰化縣,彰化市,0147,434,128,562,19,581,1003,57.93%,43.27%,1
彰化縣,彰化市,0148,400,133,533,16,549,915,60%,43.72%,1
彰化縣,彰化市,0149,468,172,640,28,668,1158,57.69%,40.41%,1
彰化縣,彰化市,0150,491,169,660,25,685,1084,63.19%,45.3%,1
彰化縣,彰化市,0151,544,194,738,41,779,1372,56.78%,39.65%,1
彰化縣,彰化市,0152,506,129,635,41,676,1113,60.74%,45.46%,1
彰化縣,彰化市,0153,385,107,492,14,506,800,63.25%,48.13%,1
彰化縣,彰化市,0154,378,133,511,26,537,885,60.68%,42.71%,1
彰化縣,彰化市,0155,457,169,626,9,635,1000,63.5%,45.7%,1
彰化縣,彰化市,0156,464,168,632,23,655,1159,56.51%,40.03%,1
彰化縣,彰化市,0157,452,164,616,21,637,1123,56.72%,40.25%,1
彰化縣,彰化市,0158,420,140,560,38,598,907,65.93%,46.31%,1
彰化縣,彰化市,0159,406,129,535,32,567,989,57.33%,41.05%,1
彰化縣,彰化市,0160,473,138,611,30,641,1012,63.34%,46.74%,1
彰化縣,彰化市,0161,430,128,558,12,570,1033,55.18%,41.63%,1
彰化縣,彰化市,0162,491,163,654,32,686,1116,61.47%,44%,1
彰化縣,彰化市,0163,530,167,697,18,715,1154,61.96%,45.93%,1
彰化縣,彰化市,0164,472,187,659,13,672,1064,63.16%,44.36%,1
彰化縣,彰化市,0165,377,107,484,26,510,770,66.23%,48.96%,1
彰化縣,彰化市,0166,387,143,530,27,557,889,62.65%,43.53%,1
彰化縣,彰化市,0167,356,109,465,36,501,786,63.74%,45.29%,1
彰化縣,彰化市,0168,460,137,597,23,620,1120,55.36%,41.07%,1
彰化縣,彰化市,0169,508,179,687,27,714,1269,56.26%,40.03%,1
彰化縣,彰化市,0170,526,158,684,23,707,1159,61%,45.38%,1
彰化縣,彰化市,0171,529,167,696,31,727,1184,61.4%,44.68%,1
彰化縣,彰化市,0172,454,156,610,24,634,1089,58.22%,41.69%,1
彰化縣,彰化市,0173,448,124,572,29,601,968,62.09%,46.28%,1
彰化縣,彰化市,0174,407,122,529,19,548,930,58.92%,43.76%,1
彰化縣,彰化市,0175,457,128,585,20,605,973,62.18%,46.97%,1
彰化縣,彰化市,0176,432,166,598,20,618,1184,52.2%,36.49%,1
彰化縣,彰化市,0177,451,143,594,29,623,1002,62.18%,45.01%,1
彰化縣,彰化市,0178,516,144,660,17,677,1148,58.97%,44.95%,1
彰化縣,彰化市,0179,473,145,618,28,646,1112,58.09%,42.54%,1
彰化縣,彰化市,0180,459,131,590,39,629,907,69.35%,50.61%,1
彰化縣,彰化市,0181,491,155,646,33,679,1112,61.06%,44.15%,1
彰化縣,彰化市,0182,315,105,420,30,450,823,54.68%,38.27%,1
彰化縣,彰化市,0183,551,176,727,46,773,1276,60.58%,43.18%,1
彰化縣,彰化市,0184,513,136,649,24,673,1161,57.97%,44.19%,1
彰化縣,鹿港鎮,0243,527,177,704,19,723,1140,63.42%,46.23%,1
彰化縣,鹿港鎮,0244,212,79,291,14,305,511,59.69%,41.49%,1
彰化縣,鹿港鎮,0245,329,103,432,14,446,857,52.04%,38.39%,1
彰化縣,鹿港鎮,0246,459,138,597,23,620,946,65.54%,48.52%,1
彰化縣,鹿港鎮,0247,410,136,546,19,565,945,59.79%,43.39%,1
彰化縣,鹿港鎮,0248,487,154,641,18,659,1097,60.07%,44.39%,1
彰化縣,鹿港鎮,0249,520,205,725,17,742,1479,50.17%,35.16%,1
彰化縣,鹿港鎮,0250,622,200,822,36,858,1425,60.21%,43.65%,1
彰化縣,鹿港鎮,0251,372,141,513,50,563,880,63.98%,42.27%,1
彰化縣,鹿港鎮,0252,493,147,640,35,675,1183,57.06%,41.67%,1
彰化縣,鹿港鎮,0253,468,145,613,38,651,1047,62.18%,44.7%,1
彰化縣,鹿港鎮,0254,459,137,596,11,607,1097,55.33%,41.84%,1
彰化縣,鹿港鎮,0255,439,126,565,28,593,1030,57.57%,42.62%,1
彰化縣,鹿港鎮,0256,521,136,657,19,676,1161,58.23%,44.88%,1
彰化縣,鹿港鎮,0257,238,72,310,35,345,540,63.89%,44.07%,1
彰化縣,鹿港鎮,0258,447,176,623,24,647,1135,57%,39.38%,1
彰化縣,鹿港鎮,0259,498,143,641,33,674,1155,58.35%,43.12%,1
彰化縣,鹿港鎮,0260,492,179,671,28,699,1127,62.02%,43.66%,1
彰化縣,鹿港鎮,0261,451,151,602,25,627,1045,60%,43.16%,1
彰化縣,鹿港鎮,0262,455,168,623,42,665,1127,59.01%,40.37%,1
彰化縣,鹿港鎮,0263,554,179,733,30,763,1178,64.77%,47.03%,1
彰化縣,鹿港鎮,0264,117,45,162,7,169,284,59.51%,41.2%,1
彰化縣,鹿港鎮,0265,246,87,333,17,350,584,59.93%,42.12%,1
彰化縣,鹿港鎮,0266,338,79,417,20,437,659,66.31%,51.29%,1
彰化縣,鹿港鎮,0267,395,142,537,16,553,915,60.44%,43.17%,1
彰化縣,鹿港鎮,0268,488,157,645,41,686,1079,63.58%,45.23%,1
彰化縣,鹿港鎮,0269,534,165,699,34,733,1129,64.92%,47.3%,1
彰化縣,鹿港鎮,0270,546,140,686,23,709,1273,55.7%,42.89%,1
彰化縣,鹿港鎮,0271,282,74,356,25,381,706,53.97%,39.94%,1
彰化縣,鹿港鎮,0272,420,153,573,60,633,1137,55.67%,36.94%,1
彰化縣,鹿港鎮,0273,481,151,632,31,663,1195,55.48%,40.25%,1
彰化縣,鹿港鎮,0274,513,122,635,28,663,1225,54.12%,41.88%,1
彰化縣,鹿港鎮,0275,464,130,594,36,630,957,65.83%,48.48%,1
彰化縣,鹿港鎮,0276,315,57,372,35,407,758,53.69%,41.56%,1
彰化縣,鹿港鎮,0277,340,71,411,27,438,723,60.58%,47.03%,1
彰化縣,鹿港鎮,0278,410,124,534,22,556,984,56.5%,41.67%,1
彰化縣,鹿港鎮,0279,498,123,621,29,650,1018,63.85%,48.92%,1
彰化縣,鹿港鎮,0280,479,141,620,26,646,1165,55.45%,41.12%,1
彰化縣,鹿港鎮,0281,556,64,620,1,621,1161,53.49%,47.89%,1
彰化縣,鹿港鎮,0282,399,132,531,34,565,1020,55.39%,39.12%,1
彰化縣,鹿港鎮,0283,472,109,581,35,616,1068,57.68%,44.19%,1
彰化縣,鹿港鎮,0284,524,119,643,25,668,1024,65.23%,51.17%,1
彰化縣,鹿港鎮,0285,430,130,560,50,610,974,62.63%,44.15%,1
彰化縣,鹿港鎮,0286,583,197,780,34,814,1505,54.09%,38.74%,1
彰化縣,鹿港鎮,0287,435,142,577,29,606,1092,55.49%,39.84%,1
彰化縣,鹿港鎮,0288,528,169,697,45,742,1223,60.67%,43.17%,1
彰化縣,鹿港鎮,0289,591,162,753,23,776,1572,49.36%,37.6%,1
彰化縣,鹿港鎮,0290,449,136,585,38,623,1003,62.11%,44.77%,1
彰化縣,鹿港鎮,0291,418,122,540,23,563,933,60.34%,44.8%,1
彰化縣,鹿港鎮,0292,485,150,635,28,663,1093,60.66%,44.37%,1
彰化縣,鹿港鎮,0293,396,121,517,10,527,907,58.1%,43.66%,1
彰化縣,鹿港鎮,0294,501,152,653,21,674,1219,55.29%,41.1%,1
彰化縣,鹿港鎮,0295,664,193,857,30,887,1397,63.49%,47.53%,1
彰化縣,鹿港鎮,0296,547,138,685,22,707,1229,57.53%,44.51%,1
彰化縣,鹿港鎮,0297,613,151,764,34,798,1444,55.26%,42.45%,1
彰化縣,鹿港鎮,0298,540,154,694,38,732,1227,59.66%,44.01%,1
彰化縣,鹿港鎮,0299,598,91,689,29,718,1187,60.49%,50.38%,1
彰化縣,鹿港鎮,0300,531,155,686,25,711,1296,54.86%,40.97%,1
彰化縣,鹿港鎮,0301,513,203,716,39,755,1451,52.03%,35.35%,1
彰化縣,鹿港鎮,0302,520,173,693,48,741,1299,57.04%,40.03%,1
彰化縣,鹿港鎮,0303,614,176,790,22,812,1298,62.56%,47.3%,1
彰化縣,鹿港鎮,0304,624,186,810,35,845,1458,57.96%,42.8%,1
彰化縣,鹿港鎮,0305,490,173,663,33,696,1138,61.16%,43.06%,1
彰化縣,鹿港鎮,0306,493,155,648,40,688,1170,58.8%,42.14%,1
彰化縣,鹿港鎮,0307,572,138,710,36,746,1221,61.1%,46.85%,1
彰化縣,和美鎮,0373,514,192,706,33,739,1341,55.11%,38.33%,1
彰化縣,和美鎮,0374,552,182,734,35,769,1480,51.96%,37.3%,1
彰化縣,和美鎮,0375,626,200,826,38,864,1529,56.51%,40.94%,1
彰化縣,和美鎮,0376,626,241,867,17,884,1711,51.67%,36.59%,1
彰化縣,和美鎮,0377,413,183,596,24,620,1057,58.66%,39.07%,1
彰化縣,和美鎮,0378,406,190,596,23,619,1032,59.98%,39.34%,1
彰化縣,和美鎮,0379,455,135,590,34,624,1015,61.48%,44.83%,1
彰化縣,和美鎮,0380,463,195,658,26,684,1209,56.58%,38.3%,1
彰化縣,和美鎮,0381,159,85,244,8,252,430,58.6%,36.98%,1
彰化縣,和美鎮,0382,346,127,473,14,487,856,56.89%,40.42%,1
彰化縣,和美鎮,0383,436,132,568,15,583,966,60.35%,45.13%,1
彰化縣,和美鎮,0384,411,147,558,23,581,1059,54.86%,38.81%,1
彰化縣,和美鎮,0385,448,177,625,20,645,1117,57.74%,40.11%,1
彰化縣,和美鎮,0386,417,152,569,25,594,1066,55.72%,39.12%,1
彰化縣,和美鎮,0387,479,174,653,32,685,1252,54.71%,38.26%,1
彰化縣,和美鎮,0388,584,191,775,31,806,1528,52.75%,38.22%,1
彰化縣,和美鎮,0389,335,128,463,23,486,826,58.84%,40.56%,1
彰化縣,和美鎮,0390,357,111,468,20,488,854,57.14%,41.8%,1
彰化縣,和美鎮,0391,519,181,700,44,744,1387,53.64%,37.42%,1
彰化縣,和美鎮,0392,373,95,468,15,483,765,63.14%,48.76%,1
彰化縣,和美鎮,0393,568,152,720,33,753,1438,52.36%,39.5%,1
彰化縣,和美鎮,0394,603,187,790,41,831,1396,59.53%,43.19%,1
彰化縣,和美鎮,0395,81,293,374,14,388,658,58.97%,12.31%,1
彰化縣,和美鎮,0396,380,115,495,21,516,809,63.78%,46.97%,1
彰化縣,和美鎮,0397,405,102,507,9,516,932,55.36%,43.45%,1
彰化縣,和美鎮,0398,364,106,470,19,489,888,55.07%,40.99%,1
彰化縣,和美鎮,0399,520,141,661,38,699,1144,61.1%,45.45%,1
彰化縣,和美鎮,0400,457,136,593,21,614,1077,57.01%,42.43%,1
彰化縣,和美鎮,0401,514,160,674,41,715,1349,53%,38.1%,1
彰化縣,和美鎮,0402,534,165,699,27,726,1155,62.86%,46.23%,1
彰化縣,和美鎮,0403,514,164,678,19,697,1253,55.63%,41.02%,1
彰化縣,和美鎮,0404,502,171,673,20,693,1252,55.35%,40.1%,1
彰化縣,和美鎮,0405,562,114,676,24,700,1474,47.49%,38.13%,1
彰化縣,和美鎮,0406,509,187,696,18,714,1396,51.15%,36.46%,1
彰化縣,和美鎮,0407,523,190,713,20,733,1348,54.38%,38.8%,1
彰化縣,和美鎮,0408,483,110,593,21,614,999,61.46%,48.35%,1
彰化縣,和美鎮,0409,393,121,514,32,546,911,59.93%,43.14%,1
彰化縣,和美鎮,0410,426,153,579,19,598,1005,59.5%,42.39%,1
彰化縣,和美鎮,0411,408,121,529,32,561,967,58.01%,42.19%,1
彰化縣,和美鎮,0412,568,171,739,24,763,1308,58.33%,43.43%,1
彰化縣,和美鎮,0413,540,171,711,33,744,1324,56.19%,40.79%,1
彰化縣,和美鎮,0414,443,176,619,40,659,1102,59.8%,40.2%,1
彰化縣,和美鎮,0415,441,166,607,17,624,1124,55.52%,39.23%,1
彰化縣,和美鎮,0416,496,166,662,43,705,1211,58.22%,40.96%,1
彰化縣,和美鎮,0417,445,123,568,27,595,884,67.31%,50.34%,1
彰化縣,和美鎮,0418,467,146,613,36,649,1119,58%,41.73%,1
彰化縣,和美鎮,0419,521,173,694,43,737,1300,56.69%,40.08%,1
彰化縣,和美鎮,0420,420,163,583,10,593,1104,53.71%,38.04%,1
彰化縣,和美鎮,0421,550,171,721,25,746,1213,61.5%,45.34%,1
彰化縣,和美鎮,0422,426,129,555,28,583,1127,51.73%,37.8%,1
彰化縣,和美鎮,0423,390,116,506,22,528,919,57.45%,42.44%,1
彰化縣,和美鎮,0424,435,130,565,31,596,987,60.39%,44.07%,1
彰化縣,和美鎮,0425,443,122,565,28,593,958,61.9%,46.24%,1
彰化縣,和美鎮,0426,628,138,766,27,793,1362,58.22%,46.11%,1
彰化縣,和美鎮,0427,570,223,793,20,813,1461,55.65%,39.01%,1
彰化縣,和美鎮,0428,572,212,784,25,809,1405,57.58%,40.71%,1
彰化縣,和美鎮,0429,373,121,494,27,521,860,60.58%,43.37%,1
彰化縣,和美鎮,0430,364,109,473,21,494,875,56.46%,41.6%,1
彰化縣,和美鎮,0431,347,128,475,32,507,871,58.21%,39.84%,1
彰化縣,和美鎮,0432,380,133,513,39,552,883,62.51%,43.04%,1
彰化縣,和美鎮,0433,451,182,633,49,682,1224,55.72%,36.85%,1
彰化縣,和美鎮,0434,436,130,566,36,602,1075,56%,40.56%,1
彰化縣,和美鎮,0435,374,143,517,27,544,956,56.9%,39.12%,1
彰化縣,和美鎮,0436,415,130,545,37,582,1037,56.12%,40.02%,1
彰化縣,和美鎮,0437,426,135,561,22,583,1011,57.67%,42.14%,1
彰化縣,和美鎮,0438,410,153,563,25,588,1023,57.48%,40.08%,1
彰化縣,和美鎮,0439,279,94,373,19,392,719,54.52%,38.8%,1
彰化縣,和美鎮,0440,378,113,491,27,518,913,56.74%,41.4%,1
彰化縣,線西鄉,0469,458,156,614,14,628,1071,58.64%,42.76%,1
彰化縣,線西鄉,0470,509,176,685,19,704,1166,60.38%,43.65%,1
彰化縣,線西鄉,0471,535,163,698,57,755,1269,59.5%,42.16%,1
彰化縣,線西鄉,0472,492,132,624,27,651,1138,57.21%,43.23%,1
彰化縣,線西鄉,0473,521,142,663,60,723,1128,64.1%,46.19%,1
彰化縣,線西鄉,0474,562,160,722,51,773,1275,60.63%,44.08%,1
彰化縣,線西鄉,0475,508,164,672,37,709,1187,59.73%,42.8%,1
彰化縣,線西鄉,0476,441,125,566,39,605,991,61.05%,44.5%,1
彰化縣,線西鄉,0477,396,135,531,35,566,938,60.34%,42.22%,1
彰化縣,線西鄉,0478,507,141,648,35,683,1276,53.53%,39.73%,1
彰化縣,線西鄉,0479,566,160,726,35,761,1285,59.22%,44.05%,1
彰化縣,線西鄉,0480,655,178,833,45,878,1341,65.47%,48.84%,1
彰化縣,伸港鄉,0441,435,150,585,22,607,1182,51.35%,36.8%,1
彰化縣,伸港鄉,0442,534,156,690,31,721,1166,61.84%,45.8%,1
彰化縣,伸港鄉,0443,404,129,533,28,561,966,58.07%,41.82%,1
彰化縣,伸港鄉,0444,350,119,469,24,493,873,56.47%,40.09%,1
彰化縣,伸港鄉,0445,365,96,461,28,489,812,60.22%,44.95%,1
彰化縣,伸港鄉,0446,354,114,468,24,492,875,56.23%,40.46%,1
彰化縣,伸港鄉,0447,357,116,473,38,511,904,56.53%,39.49%,1
彰化縣,伸港鄉,0448,411,119,530,30,560,1008,55.56%,40.77%,1
彰化縣,伸港鄉,0449,495,150,645,40,685,1154,59.36%,42.89%,1
彰化縣,伸港鄉,0450,552,178,730,53,783,1486,52.69%,37.15%,1
彰化縣,伸港鄉,0451,461,120,581,29,610,1095,55.71%,42.1%,1
彰化縣,伸港鄉,0452,416,126,542,14,556,1087,51.15%,38.27%,1
彰化縣,伸港鄉,0453,471,141,612,36,648,1085,59.72%,43.41%,1
彰化縣,伸港鄉,0454,399,120,519,24,543,908,59.8%,43.94%,1
彰化縣,伸港鄉,0455,592,147,739,44,783,1264,61.95%,46.84%,1
彰化縣,伸港鄉,0456,347,98,445,34,479,854,56.09%,40.63%,1
彰化縣,伸港鄉,0457,324,88,412,20,432,846,51.06%,38.3%,1
彰化縣,伸港鄉,0458,400,141,541,70,611,1143,53.46%,35%,1
彰化縣,伸港鄉,0459,524,205,729,28,757,1357,55.78%,38.61%,1
彰化縣,伸港鄉,0460,516,197,713,41,754,1349,55.89%,38.25%,1
彰化縣,伸港鄉,0461,484,160,644,34,678,1154,58.75%,41.94%,1
彰化縣,伸港鄉,0462,474,198,672,22,694,1279,54.26%,37.06%,1
彰化縣,伸港鄉,0463,551,190,741,39,780,1317,59.23%,41.84%,1
彰化縣,伸港鄉,0464,462,126,588,19,607,990,61.31%,46.67%,1
彰化縣,伸港鄉,0465,358,129,487,20,507,852,59.51%,42.02%,1
彰化縣,伸港鄉,0466,482,180,662,15,677,1178,57.47%,40.92%,1
彰化縣,伸港鄉,0467,426,137,563,57,620,1088,56.99%,39.15%,1
彰化縣,伸港鄉,0468,443,171,614,36,650,1135,57.27%,39.03%,1
彰化縣,福興鄉,0308,480,217,697,47,744,1363,54.59%,35.22%,1
彰化縣,福興鄉,0309,329,107,436,20,456,821,55.54%,40.07%,1
彰化縣,福興鄉,0310,491,134,625,45,670,1256,53.34%,39.09%,1
彰化縣,福興鄉,0311,450,136,586,54,640,1166,54.89%,38.59%,1
彰化縣,福興鄉,0312,571,160,731,37,768,1464,52.46%,39%,1
彰化縣,福興鄉,0313,463,165,628,38,666,1251,53.24%,37.01%,1
彰化縣,福興鄉,0314,555,185,740,37,777,1465,53.04%,37.88%,1
彰化縣,福興鄉,0315,347,111,458,18,476,960,49.58%,36.15%,1
彰化縣,福興鄉,0316,489,180,669,48,717,1323,54.2%,36.96%,1
彰化縣,福興鄉,0317,554,173,727,29,756,1365,55.38%,40.59%,1
彰化縣,福興鄉,0318,500,160,660,31,691,1458,47.39%,34.29%,1
彰化縣,福興鄉,0319,610,167,777,31,808,1492,54.16%,40.88%,1
彰化縣,福興鄉,0320,370,109,479,20,499,888,56.19%,41.67%,1
彰化縣,福興鄉,0321,451,156,607,27,634,1054,60.15%,42.79%,1
彰化縣,福興鄉,0322,387,108,495,26,521,1043,49.95%,37.1%,1
彰化縣,福興鄉,0323,550,152,702,39,741,1340,55.3%,41.04%,1
彰化縣,福興鄉,0324,396,151,547,27,574,1085,52.9%,36.5%,1
彰化縣,福興鄉,0325,547,165,712,28,740,1392,53.16%,39.3%,1
彰化縣,福興鄉,0326,576,160,736,39,775,1316,58.89%,43.77%,1
彰化縣,福興鄉,0327,562,167,729,26,755,1255,60.16%,44.78%,1
彰化縣,福興鄉,0328,515,145,660,14,674,1101,61.22%,46.78%,1
彰化縣,福興鄉,0329,490,120,610,47,657,1167,56.3%,41.99%,1
彰化縣,福興鄉,0330,546,154,700,39,739,1393,53.05%,39.2%,1
彰化縣,福興鄉,0331,536,132,668,29,697,1216,57.32%,44.08%,1
彰化縣,福興鄉,0332,405,126,531,30,561,1063,52.78%,38.1%,1
彰化縣,福興鄉,0333,522,148,670,38,708,1306,54.21%,39.97%,1
彰化縣,福興鄉,0334,441,133,574,30,604,1287,46.93%,34.27%,1
彰化縣,福興鄉,0335,420,17,437,21,458,994,46.08%,42.25%,1
彰化縣,福興鄉,0336,566,136,702,38,740,1311,56.45%,43.17%,1
彰化縣,福興鄉,0337,425,112,537,21,558,926,60.26%,45.9%,1
彰化縣,福興鄉,0338,392,113,505,21,526,995,52.86%,39.4%,1
彰化縣,福興鄉,0339,488,139,627,47,674,1079,62.47%,45.23%,1
彰化縣,福興鄉,0340,459,115,574,33,607,1150,52.78%,39.91%,1
彰化縣,秀水鄉,0341,497,137,634,36,670,1066,62.85%,46.62%,1
彰化縣,秀水鄉,0342,282,86,368,29,397,620,64.03%,45.48%,1
彰化縣,秀水鄉,0343,324,124,448,11,459,876,52.4%,36.99%,1
彰化縣,秀水鄉,0344,522,182,704,31,735,1196,61.45%,43.65%,1
彰化縣,秀水鄉,0345,584,178,762,27,789,1369,57.63%,42.66%,1
彰化縣,秀水鄉,0346,574,154,728,29,757,1273,59.47%,45.09%,1
彰化縣,秀水鄉,0347,594,182,776,29,805,1433,56.18%,41.45%,1
彰化縣,秀水鄉,0348,410,148,558,16,574,967,59.36%,42.4%,1
彰化縣,秀水鄉,0349,419,127,546,9,555,921,60.26%,45.49%,1
彰化縣,秀水鄉,0350,321,96,417,19,436,689,63.28%,46.59%,1
彰化縣,秀水鄉,0351,294,99,393,28,421,688,61.19%,42.73%,1
彰化縣,秀水鄉,0352,535,203,738,43,781,1252,62.38%,42.73%,1
彰化縣,秀水鄉,0353,512,181,693,27,720,1281,56.21%,39.97%,1
彰化縣,秀水鄉,0354,293,107,400,30,430,754,57.03%,38.86%,1
彰化縣,秀水鄉,0355,418,142,560,26,586,1024,57.23%,40.82%,1
彰化縣,秀水鄉,0356,596,172,768,24,792,1433,55.27%,41.59%,1
彰化縣,秀水鄉,0357,645,202,847,32,879,1366,64.35%,47.22%,1
彰化縣,秀水鄉,0358,393,116,509,37,546,895,61.01%,43.91%,1
彰化縣,秀水鄉,0359,498,205,703,51,754,1386,54.4%,35.93%,1
彰化縣,秀水鄉,0360,390,103,493,49,542,896,60.49%,43.53%,1
彰化縣,秀水鄉,0361,401,117,518,23,541,804,67.29%,49.88%,1
彰化縣,秀水鄉,0362,402,106,508,16,524,827,63.36%,48.61%,1
彰化縣,秀水鄉,0363,415,147,562,31,593,996,59.54%,41.67%,1
彰化縣,秀水鄉,0364,433,147,580,40,620,931,66.6%,46.51%,1
彰化縣,秀水鄉,0365,291,97,388,22,410,715,57.34%,40.7%,1
彰化縣,秀水鄉,0366,557,173,730,37,767,1229,62.41%,45.32%,1
彰化縣,秀水鄉,0367,334,107,441,21,462,890,51.91%,37.53%,1
彰化縣,秀水鄉,0368,340,133,473,35,508,811,62.64%,41.92%,1
彰化縣,秀水鄉,0369,356,110,466,26,492,786,62.6%,45.29%,1
彰化縣,秀水鄉,0370,418,103,521,22,543,931,58.32%,44.9%,1
彰化縣,秀水鄉,0371,559,171,730,43,773,1265,61.11%,44.19%,1
彰化縣,秀水鄉,0372,349,90,439,28,467,824,56.67%,42.35%,1
彰化縣,花壇鄉,0185,421,117,538,19,557,901,61.82%,46.73%,1
彰化縣,花壇鄉,0186,450,176,626,26,652,1042,62.57%,43.19%,1
彰化縣,花壇鄉,0187,524,212,736,14,750,1314,57.08%,39.88%,1
彰化縣,花壇鄉,0188,397,87,484,23,507,808,62.75%,49.13%,1
彰化縣,花壇鄉,0189,444,128,572,20,592,1019,58.1%,43.57%,1
彰化縣,花壇鄉,0190,531,149,680,32,712,1144,62.24%,46.42%,1
彰化縣,花壇鄉,0191,584,140,724,21,745,1240,60.08%,47.1%,1
彰化縣,花壇鄉,0192,682,162,844,39,883,1425,61.96%,47.86%,1
彰化縣,花壇鄉,0193,537,154,691,19,710,1095,64.84%,49.04%,1
彰化縣,花壇鄉,0194,398,126,524,24,548,910,60.22%,43.74%,1
彰化縣,花壇鄉,0195,465,115,580,16,596,982,60.69%,47.35%,1
彰化縣,花壇鄉,0196,478,146,624,13,637,1070,59.53%,44.67%,1
彰化縣,花壇鄉,0197,291,108,399,10,409,700,58.43%,41.57%,1
彰化縣,花壇鄉,0198,361,118,479,27,506,764,66.23%,47.25%,1
彰化縣,花壇鄉,0199,447,137,584,25,609,953,63.9%,46.9%,1
彰化縣,花壇鄉,0200,400,141,541,16,557,974,57.19%,41.07%,1
彰化縣,花壇鄉,0201,452,152,604,43,647,1111,58.24%,40.68%,1
彰化縣,花壇鄉,0202,498,137,635,41,676,1101,61.4%,45.23%,1
彰化縣,花壇鄉,0203,475,124,599,27,626,1110,56.4%,42.79%,1
彰化縣,花壇鄉,0204,530,179,709,31,740,1262,58.64%,42%,1
彰化縣,花壇鄉,0205,422,207,629,24,653,1103,59.2%,38.26%,1
彰化縣,花壇鄉,0206,515,163,678,30,708,1347,52.56%,38.23%,1
彰化縣,花壇鄉,0207,473,138,611,26,637,1169,54.49%,40.46%,1
彰化縣,花壇鄉,0208,559,184,743,28,771,1274,60.52%,43.88%,1
彰化縣,花壇鄉,0209,613,162,775,18,793,1280,61.95%,47.89%,1
彰化縣,花壇鄉,0210,545,161,706,22,728,1244,58.52%,43.81%,1
彰化縣,花壇鄉,0211,482,166,648,39,687,1159,59.28%,41.59%,1
彰化縣,花壇鄉,0212,489,145,634,29,663,1042,63.63%,46.93%,1
彰化縣,花壇鄉,0213,472,131,603,28,631,1111,56.8%,42.48%,1
彰化縣,花壇鄉,0214,431,109,540,31,571,893,63.94%,48.26%,1
彰化縣,花壇鄉,0215,415,125,540,25,565,953,59.29%,43.55%,1
彰化縣,花壇鄉,0216,391,139,530,24,554,987,56.13%,39.61%,1
彰化縣,花壇鄉,0217,445,128,573,37,610,925,65.95%,48.11%,1
彰化縣,花壇鄉,0218,453,89,542,23,565,951,59.41%,47.63%,1
彰化縣,花壇鄉,0219,408,121,529,20,549,955,57.49%,42.72%,1
彰化縣,花壇鄉,0220,412,109,521,24,545,895,60.89%,46.03%,1
彰化縣,花壇鄉,0221,328,85,413,12,425,711,59.77%,46.13%,1
彰化縣,芬園鄉,0222,415,98,513,25,538,958,56.16%,43.32%,1
彰化縣,芬園鄉,0223,323,100,423,36,459,794,57.81%,40.68%,1
彰化縣,芬園鄉,0224,504,178,682,65,747,1415,52.79%,35.62%,1
彰化縣,芬園鄉,0225,420,121,541,30,571,927,61.6%,45.31%,1
彰化縣,芬園鄉,0226,360,83,443,31,474,831,57.04%,43.32%,1
彰化縣,芬園鄉,0227,252,70,322,15,337,570,59.12%,44.21%,1
彰化縣,芬園鄉,0228,455,180,635,23,658,1227,53.63%,37.08%,1
彰化縣,芬園鄉,0229,509,137,646,37,683,1238,55.17%,41.11%,1
彰化縣,芬園鄉,0230,561,178,739,48,787,1362,57.78%,41.19%,1
彰化縣,芬園鄉,0231,431,118,549,40,589,989,59.56%,43.58%,1
彰化縣,芬園鄉,0232,505,134,639,32,671,1054,63.66%,47.91%,1
彰化縣,芬園鄉,0233,290,84,374,27,401,607,66.06%,47.78%,1
彰化縣,芬園鄉,0234,408,99,507,29,536,882,60.77%,46.26%,1
彰化縣,芬園鄉,0235,417,123,540,27,567,1143,49.61%,36.48%,1
彰化縣,芬園鄉,0236,266,64,330,14,344,661,52.04%,40.24%,1
彰化縣,芬園鄉,0237,356,100,456,2,458,838,54.65%,42.48%,1
彰化縣,芬園鄉,0238,302,111,413,32,445,847,52.54%,35.66%,1
彰化縣,芬園鄉,0239,426,127,553,39,592,987,59.98%,43.16%,1
彰化縣,芬園鄉,0240,463,145,608,31,639,1217,52.51%,38.04%,1
彰化縣,芬園鄉,0241,333,87,420,41,461,865,53.29%,38.5%,1
彰化縣,芬園鄉,0242,364,124,488,28,516,996,51.81%,36.55%,1
彰化縣,員林市,0481,450,99,549,20,569,1087,52.35%,41.4%,1
彰化縣,員林市,0482,613,74,687,25,712,1353,52.62%,45.31%,1
彰化縣,員林市,0483,493,180,673,30,703,1313,53.54%,37.55%,1
彰化縣,員林市,0484,453,150,603,33,636,1328,47.89%,34.11%,1
彰化縣,員林市,0485,436,143,579,20,599,1055,56.78%,41.33%,1
彰化縣,員林市,0486,374,132,506,24,530,959,55.27%,39%,1
彰化縣,員林市,0487,324,99,423,29,452,772,58.55%,41.97%,1
彰化縣,員林市,0488,363,116,479,32,511,831,61.49%,43.68%,1
彰化縣,員林市,0489,282,94,376,12,388,854,45.43%,33.02%,1
彰化縣,員林市,0490,414,123,537,22,559,1190,46.97%,34.79%,1
彰化縣,員林市,0491,304,77,381,20,401,726,55.23%,41.87%,1
彰化縣,員林市,0492,447,154,601,32,633,1124,56.32%,39.77%,1
彰化縣,員林市,0493,303,124,427,30,457,860,53.14%,35.23%,1
彰化縣,員林市,0494,592,63,655,30,685,1122,61.05%,52.76%,1
彰化縣,員林市,0495,466,175,641,22,663,1075,61.67%,43.35%,1
彰化縣,員林市,0496,403,117,520,30,550,993,55.39%,40.58%,1
彰化縣,員林市,0497,386,123,509,24,533,967,55.12%,39.92%,1
彰化縣,員林市,0498,405,147,552,30,582,1008,57.74%,40.18%,1
彰化縣,員林市,0499,334,98,432,28,460,804,57.21%,41.54%,1
彰化縣,員林市,0500,345,121,466,20,486,867,56.06%,39.79%,1
彰化縣,員林市,0501,363,108,471,15,486,885,54.92%,41.02%,1
彰化縣,員林市,0502,387,126,513,21,534,1097,48.68%,35.28%,1
彰化縣,員林市,0503,486,172,658,24,682,1255,54.34%,38.73%,1
彰化縣,員林市,0504,434,152,586,33,619,1063,58.23%,40.83%,1
彰化縣,員林市,0505,327,171,498,19,517,925,55.89%,35.35%,1
彰化縣,員林市,0506,409,119,528,31,559,947,59.03%,43.19%,1
彰化縣,員林市,0507,409,120,529,20,549,916,59.93%,44.65%,1
彰化縣,員林市,0508,348,113,461,20,481,862,55.8%,40.37%,1
彰化縣,員林市,0509,398,152,550,14,564,987,57.14%,40.32%,1
彰化縣,員林市,0510,453,124,577,23,600,1085,55.3%,41.75%,1
彰化縣,員林市,0511,459,157,616,18,634,1110,57.12%,41.35%,1
彰化縣,員林市,0512,430,144,574,13,587,1095,53.61%,39.27%,1
彰化縣,員林市,0513,541,216,757,30,787,1278,61.58%,42.33%,1
彰化縣,員林市,0514,477,152,629,26,655,1109,59.06%,43.01%,1
彰化縣,員林市,0515,441,132,573,28,601,1055,56.97%,41.8%,1
彰化縣,員林市,0516,352,140,492,21,513,876,58.56%,40.18%,1
彰化縣,員林市,0517,400,134,534,21,555,1115,49.78%,35.87%,1
彰化縣,員林市,0518,500,166,666,23,689,1186,58.09%,42.16%,1
彰化縣,員林市,0519,429,138,567,35,602,995,60.5%,43.12%,1
彰化縣,員林市,0520,387,135,522,18,540,999,54.05%,38.74%,1
彰化縣,員林市,0521,466,173,639,17,656,1201,54.62%,38.8%,1
彰化縣,員林市,0522,562,177,739,13,752,1342,56.04%,41.88%,1
彰化縣,員林市,0523,448,128,576,25,601,1086,55.34%,41.25%,1
彰化縣,員林市,0524,333,104,437,22,459,854,53.75%,38.99%,1
彰化縣,員林市,0525,449,136,585,19,604,1064,56.77%,42.2%,1
彰化縣,員林市,0526,375,144,519,12,531,879,60.41%,42.66%,1
彰化縣,員林市,0527,400,141,541,22,563,827,68.08%,48.37%,1
彰化縣,員林市,0528,371,109,480,9,489,867,56.4%,42.79%,1
彰化縣,員林市,0529,493,173,666,17,683,1201,56.87%,41.05%,1
彰化縣,員林市,0530,462,169,631,16,647,1106,58.5%,41.77%,1
彰化縣,員林市,0531,367,117,484,25,509,845,60.24%,43.43%,1
彰化縣,員林市,0532,352,152,504,22,526,894,58.84%,39.37%,1
彰化縣,員林市,0533,354,129,483,21,504,849,59.36%,41.7%,1
彰化縣,員林市,0534,323,128,451,20,471,747,63.05%,43.24%,1
彰化縣,員林市,0535,375,157,532,16,548,884,61.99%,42.42%,1
彰化縣,員林市,0536,341,124,465,15,480,900,53.33%,37.89%,1
彰化縣,員林市,0537,418,119,537,10,547,1040,52.6%,40.19%,1
彰化縣,員林市,0538,333,131,464,17,481,831,57.88%,40.07%,1
彰化縣,員林市,0539,262,95,357,35,392,591,66.33%,44.33%,1
彰化縣,員林市,0540,518,191,709,16,725,1330,54.51%,38.95%,1
彰化縣,員林市,0541,518,191,709,22,731,1295,56.45%,40%,1
彰化縣,員林市,0542,507,181,688,29,717,1283,55.88%,39.52%,1
彰化縣,員林市,0543,414,145,559,13,572,943,60.66%,43.9%,1
彰化縣,員林市,0544,600,246,846,31,877,1388,63.18%,43.23%,1
彰化縣,員林市,0545,483,185,668,28,696,1176,59.18%,41.07%,1
彰化縣,員林市,0546,340,107,447,10,457,867,52.71%,39.22%,1
彰化縣,員林市,0547,409,180,589,36,625,1121,55.75%,36.49%,1
彰化縣,員林市,0548,447,172,619,14,633,1190,53.19%,37.56%,1
彰化縣,員林市,0549,417,123,540,25,565,945,59.79%,44.13%,1
彰化縣,員林市,0550,454,80,534,13,547,906,60.38%,50.11%,1
彰化縣,員林市,0551,392,174,566,32,598,978,61.15%,40.08%,1
彰化縣,員林市,0552,389,141,530,31,561,949,59.11%,40.99%,1
彰化縣,員林市,0553,408,134,542,26,568,949,59.85%,42.99%,1
彰化縣,員林市,0554,419,148,567,10,577,1006,57.36%,41.65%,1
彰化縣,員林市,0555,352,145,497,31,528,889,59.39%,39.6%,1
彰化縣,員林市,0556,412,149,561,12,573,923,62.08%,44.64%,1
彰化縣,員林市,0557,526,199,725,26,751,1209,62.12%,43.51%,1
彰化縣,員林市,0558,479,145,624,25,649,1075,60.37%,44.56%,1
彰化縣,員林市,0559,586,221,807,24,831,1342,61.92%,43.67%,1
彰化縣,員林市,0560,451,220,671,23,694,1039,66.79%,43.41%,1
彰化縣,員林市,0561,465,144,609,24,633,1131,55.97%,41.11%,1
彰化縣,員林市,0562,496,181,677,26,703,1356,51.84%,36.58%,1
彰化縣,員林市,0563,536,199,735,39,774,1370,56.5%,39.12%,1
彰化縣,員林市,0564,425,190,615,22,637,1090,58.44%,38.99%,1
彰化縣,員林市,0565,375,144,519,15,534,821,65.04%,45.68%,1
彰化縣,員林市,0566,376,148,524,19,543,910,59.67%,41.32%,1
彰化縣,員林市,0567,497,173,670,21,691,1203,57.44%,41.31%,1
彰化縣,員林市,0568,515,238,753,21,774,1378,56.17%,37.37%,1
彰化縣,員林市,0569,552,191,743,29,772,1352,57.1%,40.83%,1
彰化縣,員林市,0570,479,162,641,17,658,1060,62.08%,45.19%,1
彰化縣,員林市,0571,515,167,682,39,721,1317,54.75%,39.1%,1
彰化縣,員林市,0572,540,45,585,29,614,1120,54.82%,48.21%,1
彰化縣,員林市,0573,425,100,525,32,557,1025,54.34%,41.46%,1
彰化縣,員林市,0574,469,136,605,29,634,1097,57.79%,42.75%,1
彰化縣,員林市,0575,372,128,500,28,528,859,61.47%,43.31%,1
彰化縣,員林市,0576,341,115,456,15,471,837,56.27%,40.74%,1
彰化縣,員林市,0577,520,141,661,27,688,1090,63.12%,47.71%,1
彰化縣,員林市,0578,449,137,586,39,625,1073,58.25%,41.85%,1
彰化縣,溪湖鎮,0640,502,162,664,16,680,1221,55.69%,41.11%,1
彰化縣,溪湖鎮,0641,275,110,385,24,409,638,64.11%,43.1%,1
彰化縣,溪湖鎮,0642,346,114,460,27,487,817,59.61%,42.35%,1
彰化縣,溪湖鎮,0643,456,112,568,18,586,968,60.54%,47.11%,1
彰化縣,溪湖鎮,0644,209,80,289,6,295,448,65.85%,46.65%,1
彰化縣,溪湖鎮,0645,467,118,585,22,607,1123,54.05%,41.59%,1
彰化縣,溪湖鎮,0646,452,172,624,35,659,1166,56.52%,38.77%,1
彰化縣,溪湖鎮,0647,475,155,630,18,648,1151,56.3%,41.27%,1
彰化縣,溪湖鎮,0648,527,181,708,17,725,1249,58.05%,42.19%,1
彰化縣,溪湖鎮,0649,517,137,654,29,683,1146,59.6%,45.11%,1
彰化縣,溪湖鎮,0650,537,134,671,39,710,1199,59.22%,44.79%,1
彰化縣,溪湖鎮,0651,372,114,486,35,521,895,58.21%,41.56%,1
彰化縣,溪湖鎮,0652,453,121,574,18,592,964,61.41%,46.99%,1
彰化縣,溪湖鎮,0653,332,135,467,23,490,851,57.58%,39.01%,1
彰化縣,溪湖鎮,0654,446,140,586,32,618,1072,57.65%,41.6%,1
彰化縣,溪湖鎮,0655,476,155,631,35,666,1113,59.84%,42.77%,1
彰化縣,溪湖鎮,0656,481,157,638,16,654,1090,60%,44.13%,1
彰化縣,溪湖鎮,0657,537,155,692,27,719,1193,60.27%,45.01%,1
彰化縣,溪湖鎮,0658,452,108,560,32,592,952,62.18%,47.48%,1
彰化縣,溪湖鎮,0659,406,151,557,25,582,1172,49.66%,34.64%,1
彰化縣,溪湖鎮,0660,412,159,571,21,592,1027,57.64%,40.12%,1
彰化縣,溪湖鎮,0661,558,164,722,24,746,1188,62.79%,46.97%,1
彰化縣,溪湖鎮,0662,535,186,721,31,752,1403,53.6%,38.13%,1
彰化縣,溪湖鎮,0663,508,186,694,31,725,1397,51.9%,36.36%,1
彰化縣,溪湖鎮,0664,665,230,895,42,937,1636,57.27%,40.65%,1
彰化縣,溪湖鎮,0665,558,181,739,40,779,1298,60.02%,42.99%,1
彰化縣,溪湖鎮,0666,519,157,676,29,705,1214,58.07%,42.75%,1
彰化縣,溪湖鎮,0667,543,209,752,24,776,1297,59.83%,41.87%,1
彰化縣,溪湖鎮,0668,437,148,585,20,605,968,62.5%,45.14%,1
彰化縣,溪湖鎮,0669,363,114,477,27,504,839,60.07%,43.27%,1
彰化縣,溪湖鎮,0670,397,124,521,31,552,907,60.86%,43.77%,1
彰化縣,溪湖鎮,0671,352,96,448,21,469,898,52.23%,39.2%,1
彰化縣,溪湖鎮,0672,318,110,428,21,449,650,69.08%,48.92%,1
彰化縣,溪湖鎮,0673,543,149,692,45,737,1279,57.62%,42.46%,1
彰化縣,溪湖鎮,0674,362,79,441,24,465,730,63.7%,49.59%,1
彰化縣,溪湖鎮,0675,609,170,779,48,827,1407,58.78%,43.28%,1
彰化縣,溪湖鎮,0676,462,144,606,33,639,1273,50.2%,36.29%,1
彰化縣,溪湖鎮,0677,406,118,524,21,545,988,55.16%,41.09%,1
彰化縣,溪湖鎮,0678,350,103,453,28,481,754,63.79%,46.42%,1
彰化縣,溪湖鎮,0679,379,114,493,34,527,1052,50.1%,36.03%,1
彰化縣,溪湖鎮,0680,452,142,594,26,620,1149,53.96%,39.34%,1
彰化縣,溪湖鎮,0681,591,220,811,52,863,1365,63.22%,43.3%,1
彰化縣,田中鎮,0742,349,92,441,40,481,854,56.32%,40.87%,1
彰化縣,田中鎮,0743,368,104,472,20,492,963,51.09%,38.21%,1
彰化縣,田中鎮,0744,28,10,38,7,45,175,25.71%,16%,1
彰化縣,田中鎮,0745,309,68,377,19,396,739,53.59%,41.81%,1
彰化縣,田中鎮,0746,350,90,440,13,453,826,54.84%,42.37%,1
彰化縣,田中鎮,0747,343,81,424,27,451,741,60.86%,46.29%,1
彰化縣,田中鎮,0748,182,50,232,12,244,506,48.22%,35.97%,1
彰化縣,田中鎮,0749,382,113,495,40,535,1001,53.45%,38.16%,1
彰化縣,田中鎮,0750,565,146,711,37,748,1281,58.39%,44.11%,1
彰化縣,田中鎮,0751,480,110,590,30,620,1035,59.9%,46.38%,1
彰化縣,田中鎮,0752,584,169,753,26,779,1327,58.7%,44.01%,1
彰化縣,田中鎮,0753,389,114,503,20,523,844,61.97%,46.09%,1
彰化縣,田中鎮,0754,408,107,515,23,538,913,58.93%,44.69%,1
彰化縣,田中鎮,0755,309,68,377,29,406,613,66.23%,50.41%,1
彰化縣,田中鎮,0756,606,168,774,47,821,1382,59.41%,43.85%,1
彰化縣,田中鎮,0757,497,151,648,29,677,1034,65.47%,48.07%,1
彰化縣,田中鎮,0758,463,134,597,20,617,935,65.99%,49.52%,1
彰化縣,田中鎮,0759,541,181,722,30,752,1301,57.8%,41.58%,1
彰化縣,田中鎮,0760,493,151,644,22,666,1100,60.55%,44.82%,1
彰化縣,田中鎮,0761,460,168,628,28,656,1071,61.25%,42.95%,1
彰化縣,田中鎮,0762,541,156,697,35,732,1163,62.94%,46.52%,1
彰化縣,田中鎮,0763,394,114,508,28,536,809,66.25%,48.7%,1
彰化縣,田中鎮,0764,508,168,676,37,713,1155,61.73%,43.98%,1
彰化縣,田中鎮,0765,544,152,696,40,736,1270,57.95%,42.83%,1
彰化縣,田中鎮,0766,344,121,465,24,489,870,56.21%,39.54%,1
彰化縣,田中鎮,0767,320,85,405,22,427,736,58.02%,43.48%,1
彰化縣,田中鎮,0768,520,148,668,32,700,1335,52.43%,38.95%,1
彰化縣,田中鎮,0769,383,96,479,23,502,876,57.31%,43.72%,1
彰化縣,田中鎮,0770,353,112,465,33,498,898,55.46%,39.31%,1
彰化縣,田中鎮,0771,590,173,763,11,774,1298,59.63%,45.45%,1
彰化縣,田中鎮,0772,589,195,784,35,819,1451,56.44%,40.59%,1
彰化縣,田中鎮,0773,603,205,808,29,837,1475,56.75%,40.88%,1
彰化縣,田中鎮,0774,281,89,370,31,401,766,52.35%,36.68%,1
彰化縣,田中鎮,0775,407,27,434,10,444,810,54.81%,50.25%,1
彰化縣,田中鎮,0776,379,150,529,42,571,953,59.92%,39.77%,1
彰化縣,田中鎮,0777,415,113,528,38,566,885,63.95%,46.89%,1
彰化縣,大村鄉,0579,650,212,862,45,907,1426,63.6%,45.58%,1
彰化縣,大村鄉,0580,753,252,1005,58,1063,1726,61.59%,43.63%,1
彰化縣,大村鄉,0581,370,111,481,30,511,797,64.12%,46.42%,1
彰化縣,大村鄉,0582,326,101,427,16,443,745,59.46%,43.76%,1
彰化縣,大村鄉,0583,527,120,647,45,692,1125,61.51%,46.84%,1
彰化縣,大村鄉,0584,710,193,903,57,960,1486,64.6%,47.78%,1
彰化縣,大村鄉,0585,582,204,786,49,835,1426,58.56%,40.81%,1
彰化縣,大村鄉,0586,380,111,491,33,524,824,63.59%,46.12%,1
彰化縣,大村鄉,0587,464,138,602,26,628,1177,53.36%,39.42%,1
彰化縣,大村鄉,0588,636,218,854,28,882,1478,59.68%,43.03%,1
彰化縣,大村鄉,0589,308,95,403,20,423,779,54.3%,39.54%,1
彰化縣,大村鄉,0590,364,123,487,28,515,812,63.42%,44.83%,1
彰化縣,大村鄉,0591,459,143,602,43,645,1161,55.56%,39.53%,1
彰化縣,大村鄉,0592,492,163,655,12,667,1238,53.88%,39.74%,1
彰化縣,大村鄉,0593,538,159,697,30,727,1259,57.74%,42.73%,1
彰化縣,大村鄉,0594,578,208,786,35,821,1412,58.14%,40.93%,1
彰化縣,大村鄉,0595,592,195,787,26,813,1401,58.03%,42.26%,1
彰化縣,大村鄉,0596,646,192,838,32,870,1395,62.37%,46.31%,1
彰化縣,大村鄉,0597,419,154,573,31,604,996,60.64%,42.07%,1
彰化縣,大村鄉,0598,440,148,588,25,613,1047,58.55%,42.02%,1
彰化縣,大村鄉,0599,452,111,563,29,592,985,60.1%,45.89%,1
彰化縣,大村鄉,0600,473,150,623,37,660,1054,62.62%,44.88%,1
彰化縣,大村鄉,0601,537,152,689,24,713,1200,59.42%,44.75%,1
彰化縣,大村鄉,0602,439,135,574,44,618,1003,61.62%,43.77%,1
彰化縣,大村鄉,0603,411,150,561,14,575,1046,54.97%,39.29%,1
彰化縣,大村鄉,0604,523,156,679,36,715,1189,60.13%,43.99%,1
彰化縣,大村鄉,0605,537,145,682,21,703,1305,53.87%,41.15%,1
彰化縣,埔鹽鄉,0682,465,107,572,23,595,958,62.11%,48.54%,1
彰化縣,埔鹽鄉,0683,307,173,480,16,496,754,65.78%,40.72%,1
彰化縣,埔鹽鄉,0684,359,120,479,22,501,757,66.18%,47.42%,1
彰化縣,埔鹽鄉,0685,381,108,489,19,508,806,63.03%,47.27%,1
彰化縣,埔鹽鄉,0686,602,132,734,29,763,1280,59.61%,47.03%,1
彰化縣,埔鹽鄉,0687,404,116,520,31,551,928,59.38%,43.53%,1
彰化縣,埔鹽鄉,0688,420,132,552,40,592,895,66.15%,46.93%,1
彰化縣,埔鹽鄉,0689,396,87,483,43,526,815,64.54%,48.59%,1
彰化縣,埔鹽鄉,0690,418,122,540,20,560,957,58.52%,43.68%,1
彰化縣,埔鹽鄉,0691,604,140,744,51,795,1338,59.42%,45.14%,1
彰化縣,埔鹽鄉,0692,478,138,616,25,641,1106,57.96%,43.22%,1
彰化縣,埔鹽鄉,0693,364,98,462,22,484,690,70.14%,52.75%,1
彰化縣,埔鹽鄉,0694,532,145,677,35,712,1230,57.89%,43.25%,1
彰化縣,埔鹽鄉,0695,369,118,487,19,506,847,59.74%,43.57%,1
彰化縣,埔鹽鄉,0696,433,107,540,22,562,897,62.65%,48.27%,1
彰化縣,埔鹽鄉,0697,373,114,487,44,531,882,60.2%,42.29%,1
彰化縣,埔鹽鄉,0698,540,131,671,46,717,1180,60.76%,45.76%,1
彰化縣,埔鹽鄉,0699,586,55,641,65,706,1215,58.11%,48.23%,1
彰化縣,埔鹽鄉,0700,222,47,269,13,282,422,66.82%,52.61%,1
彰化縣,埔鹽鄉,0701,471,105,576,44,620,1106,56.06%,42.59%,1
彰化縣,埔鹽鄉,0702,416,92,508,57,565,874,64.65%,47.6%,1
彰化縣,埔鹽鄉,0703,594,194,788,66,854,1445,59.1%,41.11%,1
彰化縣,埔鹽鄉,0704,406,95,501,46,547,875,62.51%,46.4%,1
彰化縣,埔鹽鄉,0705,339,77,416,32,448,837,53.52%,40.5%,1
彰化縣,埔鹽鄉,0706,323,70,393,20,413,685,60.29%,47.15%,1
彰化縣,埔鹽鄉,0707,334,115,449,21,470,733,64.12%,45.57%,1
彰化縣,埔鹽鄉,0708,352,112,464,37,501,798,62.78%,44.11%,1
彰化縣,埔鹽鄉,0709,605,149,754,45,799,1381,57.86%,43.81%,1
彰化縣,埔鹽鄉,0710,543,142,685,36,721,1335,54.01%,40.67%,1
彰化縣,埔心鄉,0711,509,156,665,51,716,1139,62.86%,44.69%,1
彰化縣,埔心鄉,0712,546,141,687,31,718,1217,59%,44.86%,1
彰化縣,埔心鄉,0713,559,190,749,24,773,1248,61.94%,44.79%,1
彰化縣,埔心鄉,0714,571,181,752,54,806,1248,64.58%,45.75%,1
彰化縣,埔心鄉,0715,418,122,540,28,568,916,62.01%,45.63%,1
彰化縣,埔心鄉,0716,271,121,392,19,411,625,65.76%,43.36%,1
彰化縣,埔心鄉,0717,507,167,674,56,730,1271,57.44%,39.89%,1
彰化縣,埔心鄉,0718,301,74,375,21,396,608,65.13%,49.51%,1
彰化縣,埔心鄉,0719,550,139,689,46,735,1132,64.93%,48.59%,1
彰化縣,埔心鄉,0720,466,131,597,44,641,1027,62.41%,45.37%,1
彰化縣,埔心鄉,0721,423,139,562,31,593,926,64.04%,45.68%,1
彰化縣,埔心鄉,0722,350,100,450,32,482,778,61.95%,44.99%,1
彰化縣,埔心鄉,0723,331,89,420,13,433,660,65.61%,50.15%,1
彰化縣,埔心鄉,0724,607,172,779,49,828,1330,62.26%,45.64%,1
彰化縣,埔心鄉,0725,424,148,572,21,593,991,59.84%,42.79%,1
彰化縣,埔心鄉,0726,397,144,541,28,569,985,57.77%,40.3%,1
彰化縣,埔心鄉,0727,435,126,561,31,592,1034,57.25%,42.07%,1
彰化縣,埔心鄉,0728,296,79,375,26,401,612,65.52%,48.37%,1
彰化縣,埔心鄉,0729,583,171,754,39,793,1236,64.16%,47.17%,1
彰化縣,埔心鄉,0730,346,110,456,30,486,775,62.71%,44.65%,1
彰化縣,埔心鄉,0731,362,114,476,21,497,738,67.34%,49.05%,1
彰化縣,埔心鄉,0732,447,170,617,21,638,1036,61.58%,43.15%,1
彰化縣,埔心鄉,0733,398,130,528,38,566,975,58.05%,40.82%,1
彰化縣,埔心鄉,0734,377,113,490,29,519,885,58.64%,42.6%,1
彰化縣,埔心鄉,0735,414,139,553,42,595,939,63.37%,44.09%,1
彰化縣,埔心鄉,0736,329,66,395,26,421,689,61.1%,47.75%,1
彰化縣,埔心鄉,0737,321,84,405,23,428,659,64.95%,48.71%,1
彰化縣,埔心鄉,0738,375,120,495,24,519,910,57.03%,41.21%,1
彰化縣,埔心鄉,0739,647,203,850,44,894,1352,66.12%,47.86%,1
彰化縣,埔心鄉,0740,310,107,417,30,447,759,58.89%,40.84%,1
彰化縣,埔心鄉,0741,400,127,527,41,568,942,60.3%,42.46%,1
彰化縣,永靖鄉,0606,479,157,636,31,667,1255,53.15%,38.17%,1
彰化縣,永靖鄉,0607,380,129,509,38,547,889,61.53%,42.74%,1
彰化縣,永靖鄉,0608,422,139,561,21,582,1026,56.73%,41.13%,1
彰化縣,永靖鄉,0609,330,95,425,27,452,724,62.43%,45.58%,1
彰化縣,永靖鄉,0610,409,113,522,33,555,924,60.06%,44.26%,1
彰化縣,永靖鄉,0611,317,91,408,12,420,659,63.73%,48.1%,1
彰化縣,永靖鄉,0612,299,117,416,18,434,734,59.13%,40.74%,1
彰化縣,永靖鄉,0613,265,95,360,16,376,758,49.6%,34.96%,1
彰化縣,永靖鄉,0614,409,115,524,32,556,848,65.57%,48.23%,1
彰化縣,永靖鄉,0615,533,172,705,52,757,1404,53.92%,37.96%,1
彰化縣,永靖鄉,0616,382,143,525,26,551,792,69.57%,48.23%,1
彰化縣,永靖鄉,0617,298,126,424,23,447,695,64.32%,42.88%,1
彰化縣,永靖鄉,0618,376,114,490,18,508,821,61.88%,45.8%,1
彰化縣,永靖鄉,0619,469,155,624,48,672,1064,63.16%,44.08%,1
彰化縣,永靖鄉,0620,351,112,463,24,487,840,57.98%,41.79%,1
彰化縣,永靖鄉,0621,502,145,647,20,667,1079,61.82%,46.52%,1
彰化縣,永靖鄉,0622,467,163,630,24,654,1048,62.4%,44.56%,1
彰化縣,永靖鄉,0623,477,127,604,22,626,960,65.21%,49.69%,1
彰化縣,永靖鄉,0624,347,125,472,24,496,798,62.16%,43.48%,1
彰化縣,永靖鄉,0625,397,118,515,17,532,796,66.83%,49.87%,1
彰化縣,永靖鄉,0626,291,77,368,17,385,662,58.16%,43.96%,1
彰化縣,永靖鄉,0627,461,122,583,25,608,1040,58.46%,44.33%,1
彰化縣,永靖鄉,0628,424,136,560,31,591,1025,57.66%,41.37%,1
彰化縣,永靖鄉,0629,735,101,836,35,871,1357,64.19%,54.16%,1
彰化縣,永靖鄉,0630,595,172,767,37,804,1236,65.05%,48.14%,1
彰化縣,永靖鄉,0631,371,118,489,30,519,871,59.59%,42.59%,1
彰化縣,永靖鄉,0632,281,84,365,20,385,706,54.53%,39.8%,1
彰化縣,永靖鄉,0633,370,107,477,20,497,770,64.55%,48.05%,1
彰化縣,永靖鄉,0634,335,85,420,22,442,669,66.07%,50.07%,1
彰化縣,永靖鄉,0635,367,121,488,21,509,862,59.05%,42.58%,1
彰化縣,永靖鄉,0636,364,86,450,26,476,847,56.2%,42.98%,1
彰化縣,永靖鄉,0637,316,78,394,36,430,668,64.37%,47.31%,1
彰化縣,永靖鄉,0638,438,116,554,20,574,1073,53.49%,40.82%,1
彰化縣,永靖鄉,0639,516,147,663,30,693,1339,51.76%,38.54%,1
彰化縣,社頭鄉,0778,323,121,444,24,468,791,59.17%,40.83%,1
彰化縣,社頭鄉,0779,408,128,536,24,560,984,56.91%,41.46%,1
彰化縣,社頭鄉,0780,400,121,521,15,536,990,54.14%,40.4%,1
彰化縣,社頭鄉,0781,465,136,601,30,631,1016,62.11%,45.77%,1
彰化縣,社頭鄉,0782,466,161,627,32,659,1091,60.4%,42.71%,1
彰化縣,社頭鄉,0783,517,186,703,40,743,1236,60.11%,41.83%,1
彰化縣,社頭鄉,0784,502,143,645,21,666,1203,55.36%,41.73%,1
彰化縣,社頭鄉,0785,331,84,415,12,427,753,56.71%,43.96%,1
彰化縣,社頭鄉,0786,284,76,360,28,388,725,53.52%,39.17%,1
彰化縣,社頭鄉,0787,446,137,583,41,624,1023,61%,43.6%,1
彰化縣,社頭鄉,0788,274,88,362,19,381,562,67.79%,48.75%,1
彰化縣,社頭鄉,0789,432,140,572,22,594,1049,56.63%,41.18%,1
彰化縣,社頭鄉,0790,417,122,539,24,563,933,60.34%,44.69%,1
彰化縣,社頭鄉,0791,434,141,575,31,606,990,61.21%,43.84%,1
彰化縣,社頭鄉,0792,454,127,581,15,596,1076,55.39%,42.19%,1
彰化縣,社頭鄉,0793,248,200,448,12,460,742,61.99%,33.42%,1
彰化縣,社頭鄉,0794,293,86,379,11,390,672,58.04%,43.6%,1
彰化縣,社頭鄉,0795,477,130,607,22,629,1235,50.93%,38.62%,1
彰化縣,社頭鄉,0796,315,117,432,25,457,750,60.93%,42%,1
彰化縣,社頭鄉,0797,346,112,458,30,488,895,54.53%,38.66%,1
彰化縣,社頭鄉,0798,312,91,403,11,414,688,60.17%,45.35%,1
彰化縣,社頭鄉,0799,393,90,483,11,494,870,56.78%,45.17%,1
彰化縣,社頭鄉,0800,520,147,667,20,687,1140,60.26%,45.61%,1
彰化縣,社頭鄉,0801,449,114,563,21,584,985,59.29%,45.58%,1
彰化縣,社頭鄉,0802,606,145,751,39,790,1266,62.4%,47.87%,1
彰化縣,社頭鄉,0803,398,133,531,24,555,937,59.23%,42.48%,1
彰化縣,社頭鄉,0804,520,152,672,19,691,1219,56.69%,42.66%,1
彰化縣,社頭鄉,0805,510,130,640,39,679,1165,58.28%,43.78%,1
彰化縣,社頭鄉,0806,430,123,553,36,589,986,59.74%,43.61%,1
彰化縣,社頭鄉,0807,342,92,434,25,459,724,63.4%,47.24%,1
彰化縣,社頭鄉,0808,447,114,561,31,592,1015,58.33%,44.04%,1
彰化縣,社頭鄉,0809,421,130,551,21,572,1116,51.25%,37.72%,1
彰化縣,社頭鄉,0810,418,128,546,33,579,1061,54.57%,39.4%,1
彰化縣,社頭鄉,0811,438,137,575,29,604,992,60.89%,44.15%,1
彰化縣,社頭鄉,0812,427,156,583,19,602,1092,55.13%,39.1%,1
彰化縣,社頭鄉,0813,403,92,495,14,509,828,61.47%,48.67%,1
彰化縣,社頭鄉,0814,393,1,394,29,423,787,53.75%,49.94%,1
彰化縣,社頭鄉,0815,276,73,349,18,367,719,51.04%,38.39%,1
彰化縣,二水鄉,0816,438,142,580,30,610,1028,59.34%,42.61%,1
彰化縣,二水鄉,0817,321,79,400,33,433,689,62.84%,46.59%,1
彰化縣,二水鄉,0818,359,97,456,24,480,871,55.11%,41.22%,1
彰化縣,二水鄉,0819,339,183,522,50,572,953,60.02%,35.57%,1
彰化縣,二水鄉,0820,260,59,319,23,342,624,54.81%,41.67%,1
彰化縣,二水鄉,0821,319,95,414,20,434,645,67.29%,49.46%,1
彰化縣,二水鄉,0822,504,123,627,29,656,986,66.53%,51.12%,1
彰化縣,二水鄉,0823,470,128,598,28,626,943,66.38%,49.84%,1
彰化縣,二水鄉,0824,217,57,274,9,283,455,62.2%,47.69%,1
彰化縣,二水鄉,0825,427,114,541,17,558,831,67.15%,51.38%,1
彰化縣,二水鄉,0826,394,103,497,23,520,831,62.58%,47.41%,1
彰化縣,二水鄉,0827,426,129,555,25,580,1013,57.26%,42.05%,1
彰化縣,二水鄉,0828,384,84,468,37,505,796,63.44%,48.24%,1
彰化縣,二水鄉,0829,335,78,413,40,453,781,58%,42.89%,1
彰化縣,二水鄉,0830,276,80,356,17,373,692,53.9%,39.88%,1
彰化縣,二水鄉,0831,271,90,361,13,374,635,58.9%,42.68%,1
彰化縣,二水鄉,0832,236,70,306,27,333,566,58.83%,41.7%,1
彰化縣,北斗鎮,0833,406,85,491,33,524,925,56.65%,43.89%,1
彰化縣,北斗鎮,0834,396,111,507,28,535,869,61.57%,45.57%,1
彰化縣,北斗鎮,0835,430,96,526,27,553,855,64.68%,50.29%,1
彰化縣,北斗鎮,0836,493,152,645,26,671,1065,63%,46.29%,1
彰化縣,北斗鎮,0837,373,91,464,43,507,828,61.23%,45.05%,1
彰化縣,北斗鎮,0838,512,130,642,36,678,1124,60.32%,45.55%,1
彰化縣,北斗鎮,0839,467,180,647,29,676,1096,61.68%,42.61%,1
彰化縣,北斗鎮,0840,542,154,696,18,714,1213,58.86%,44.68%,1
彰化縣,北斗鎮,0841,472,141,613,34,647,1164,55.58%,40.55%,1
彰化縣,北斗鎮,0842,298,100,398,22,420,730,57.53%,40.82%,1
彰化縣,北斗鎮,0843,385,91,476,17,493,878,56.15%,43.85%,1
彰化縣,北斗鎮,0844,397,96,493,21,514,833,61.7%,47.66%,1
彰化縣,北斗鎮,0845,400,154,554,16,570,957,59.56%,41.8%,1
彰化縣,北斗鎮,0846,327,83,410,29,439,783,56.07%,41.76%,1
彰化縣,北斗鎮,0847,214,83,297,24,321,573,56.02%,37.35%,1
彰化縣,北斗鎮,0848,273,91,364,22,386,672,57.44%,40.63%,1
彰化縣,北斗鎮,0849,264,88,352,28,380,695,54.68%,37.99%,1
彰化縣,北斗鎮,0850,278,96,374,29,403,747,53.95%,37.22%,1
彰化縣,北斗鎮,0851,302,103,405,11,416,643,64.7%,46.97%,1
彰化縣,北斗鎮,0852,296,76,372,26,398,662,60.12%,44.71%,1
彰化縣,北斗鎮,0853,522,129,651,42,693,1085,63.87%,48.11%,1
彰化縣,北斗鎮,0854,495,132,627,44,671,1121,59.86%,44.16%,1
彰化縣,北斗鎮,0855,377,102,479,29,508,830,61.2%,45.42%,1
彰化縣,北斗鎮,0856,409,112,521,23,544,975,55.79%,41.95%,1
彰化縣,北斗鎮,0857,464,187,651,16,667,1212,55.03%,38.28%,1
彰化縣,北斗鎮,0858,585,160,745,35,780,1302,59.91%,44.93%,1
彰化縣,北斗鎮,0859,398,110,508,31,539,1077,50.05%,36.95%,1
彰化縣,北斗鎮,0860,370,103,473,32,505,917,55.07%,40.35%,1
彰化縣,北斗鎮,0861,342,106,448,23,471,825,57.09%,41.45%,1
彰化縣,北斗鎮,0862,424,119,543,27,570,937,60.83%,45.25%,1
彰化縣,二林鎮,0942,228,60,288,28,316,731,43.23%,31.19%,1
彰化縣,二林鎮,0943,431,129,560,31,591,1025,57.66%,42.05%,1
彰化縣,二林鎮,0944,337,103,440,19,459,784,58.55%,42.98%,1
彰化縣,二林鎮,0945,376,123,499,20,519,892,58.18%,42.15%,1
彰化縣,二林鎮,0946,513,179,692,32,724,1256,57.64%,40.84%,1
彰化縣,二林鎮,0947,424,120,544,34,578,1043,55.42%,40.65%,1
彰化縣,二林鎮,0948,451,174,625,23,648,1076,60.22%,41.91%,1
彰化縣,二林鎮,0949,471,138,609,30,639,1082,59.06%,43.53%,1
彰化縣,二林鎮,0950,567,195,762,30,792,1427,55.5%,39.73%,1
彰化縣,二林鎮,0951,378,118,496,40,536,1030,52.04%,36.7%,1
彰化縣,二林鎮,0952,373,135,508,35,543,1033,52.57%,36.11%,1
彰化縣,二林鎮,0953,375,143,518,31,549,977,56.19%,38.38%,1
彰化縣,二林鎮,0954,272,63,335,17,352,683,51.54%,39.82%,1
彰化縣,二林鎮,0955,398,90,488,26,514,975,52.72%,40.82%,1
彰化縣,二林鎮,0956,440,114,554,48,602,1336,45.06%,32.93%,1
彰化縣,二林鎮,0957,339,104,443,44,487,1019,47.79%,33.27%,1
彰化縣,二林鎮,0958,320,92,412,35,447,1003,44.57%,31.9%,1
彰化縣,二林鎮,0959,484,120,604,48,652,1151,56.65%,42.05%,1
彰化縣,二林鎮,0960,647,202,849,58,907,1598,56.76%,40.49%,1
彰化縣,二林鎮,0961,594,173,767,35,802,1488,53.9%,39.92%,1
彰化縣,二林鎮,0962,736,233,969,42,1011,1771,57.09%,41.56%,1
彰化縣,二林鎮,0963,430,124,554,34,588,1360,43.24%,31.62%,1
彰化縣,二林鎮,0964,561,153,714,42,756,1613,46.87%,34.78%,1
彰化縣,二林鎮,0965,438,146,584,57,641,1228,52.2%,35.67%,1
彰化縣,二林鎮,0966,331,94,425,17,442,771,57.33%,42.93%,1
彰化縣,二林鎮,0967,366,116,482,25,507,858,59.09%,42.66%,1
彰化縣,二林鎮,0968,245,54,299,0,299,661,45.23%,37.07%,1
彰化縣,二林鎮,0969,496,89,585,51,636,1268,50.16%,39.12%,1
彰化縣,二林鎮,0970,398,110,508,30,538,1081,49.77%,36.82%,1
彰化縣,二林鎮,0971,447,128,575,21,596,1213,49.13%,36.85%,1
彰化縣,二林鎮,0972,539,169,708,34,742,1328,55.87%,40.59%,1
彰化縣,二林鎮,0973,388,93,481,53,534,1118,47.76%,34.7%,1
彰化縣,二林鎮,0974,387,100,487,40,527,1157,45.55%,33.45%,1
彰化縣,二林鎮,0975,371,81,452,28,480,972,49.38%,38.17%,1
彰化縣,二林鎮,0976,349,112,461,27,488,902,54.1%,38.69%,1
彰化縣,二林鎮,0977,621,140,761,46,807,1273,63.39%,48.78%,1
彰化縣,二林鎮,0978,430,128,558,35,593,1087,54.55%,39.56%,1
彰化縣,二林鎮,0979,436,119,555,38,593,987,60.08%,44.17%,1
彰化縣,二林鎮,0980,245,77,322,19,341,719,47.43%,34.08%,1
彰化縣,田尾鄉,0863,480,151,631,34,665,1284,51.79%,37.38%,1
彰化縣,田尾鄉,0864,547,143,690,39,729,1187,61.42%,46.08%,1
彰化縣,田尾鄉,0865,443,150,593,41,634,1033,61.37%,42.88%,1
彰化縣,田尾鄉,0866,345,62,407,21,428,696,61.49%,49.57%,1
彰化縣,田尾鄉,0867,397,116,513,26,539,872,61.81%,45.53%,1
彰化縣,田尾鄉,0868,288,79,367,10,377,680,55.44%,42.35%,1
彰化縣,田尾鄉,0869,402,134,536,23,559,875,63.89%,45.94%,1
彰化縣,田尾鄉,0870,536,171,707,36,743,1337,55.57%,40.09%,1
彰化縣,田尾鄉,0871,602,204,806,35,841,1376,61.12%,43.75%,1
彰化縣,田尾鄉,0872,560,147,707,30,737,1186,62.14%,47.22%,1
彰化縣,田尾鄉,0873,455,118,573,33,606,874,69.34%,52.06%,1
彰化縣,田尾鄉,0874,283,69,352,16,368,647,56.88%,43.74%,1
彰化縣,田尾鄉,0875,453,100,553,24,577,959,60.17%,47.24%,1
彰化縣,田尾鄉,0876,101,33,134,10,144,263,54.75%,38.4%,1
彰化縣,田尾鄉,0877,243,64,307,30,337,618,54.53%,39.32%,1
彰化縣,田尾鄉,0878,423,158,581,17,598,938,63.75%,45.1%,1
彰化縣,田尾鄉,0879,414,115,529,38,567,880,64.43%,47.05%,1
彰化縣,田尾鄉,0880,309,97,406,24,430,804,53.48%,38.43%,1
彰化縣,田尾鄉,0881,239,74,313,16,329,592,55.57%,40.37%,1
彰化縣,田尾鄉,0882,479,141,620,67,687,1079,63.67%,44.39%,1
彰化縣,田尾鄉,0883,557,189,746,36,782,1336,58.53%,41.69%,1
彰化縣,田尾鄉,0884,461,150,611,41,652,1198,54.42%,38.48%,1
彰化縣,田尾鄉,0885,267,69,336,19,355,621,57.17%,43%,1
彰化縣,田尾鄉,0886,299,86,385,30,415,760,54.61%,39.34%,1
彰化縣,田尾鄉,0887,480,166,646,56,702,1084,64.76%,44.28%,1
彰化縣,埤頭鄉,0888,411,124,535,41,576,1178,48.9%,34.89%,1
彰化縣,埤頭鄉,0889,510,147,657,32,689,1290,53.41%,39.53%,1
彰化縣,埤頭鄉,0890,340,127,467,41,508,973,52.21%,34.94%,1
彰化縣,埤頭鄉,0891,310,88,398,24,422,783,53.9%,39.59%,1
彰化縣,埤頭鄉,0892,289,98,387,30,417,733,56.89%,39.43%,1
彰化縣,埤頭鄉,0893,370,125,495,34,529,899,58.84%,41.16%,1
彰化縣,埤頭鄉,0894,400,101,501,43,544,965,56.37%,41.45%,1
彰化縣,埤頭鄉,0895,531,142,673,39,712,1356,52.51%,39.16%,1
彰化縣,埤頭鄉,0896,504,151,655,38,693,1265,54.78%,39.84%,1
彰化縣,埤頭鄉,0897,420,98,518,30,548,877,62.49%,47.89%,1
彰化縣,埤頭鄉,0898,274,78,352,30,382,705,54.18%,38.87%,1
彰化縣,埤頭鄉,0899,49,129,178,29,207,1062,19.49%,4.61%,1
彰化縣,埤頭鄉,0900,549,166,715,30,745,1300,57.31%,42.23%,1
彰化縣,埤頭鄉,0901,423,102,525,26,551,923,59.7%,45.83%,1
彰化縣,埤頭鄉,0902,419,124,543,35,578,1085,53.27%,38.62%,1
彰化縣,埤頭鄉,0903,456,145,601,53,654,1103,59.29%,41.34%,1
彰化縣,埤頭鄉,0904,290,81,371,16,387,735,52.65%,39.46%,1
彰化縣,埤頭鄉,0905,215,65,280,36,316,574,55.05%,37.46%,1
彰化縣,埤頭鄉,0906,294,56,350,37,387,767,50.46%,38.33%,1
彰化縣,埤頭鄉,0907,317,67,384,27,411,737,55.77%,43.01%,1
彰化縣,埤頭鄉,0908,360,120,480,37,517,1058,48.87%,34.03%,1
彰化縣,埤頭鄉,0909,293,83,376,51,427,826,51.69%,35.47%,1
彰化縣,埤頭鄉,0910,410,93,503,49,552,1082,51.02%,37.89%,1
彰化縣,埤頭鄉,0911,349,78,427,22,449,737,60.92%,47.35%,1
彰化縣,埤頭鄉,0912,287,75,362,13,375,711,52.74%,40.37%,1
彰化縣,埤頭鄉,0913,423,145,568,35,603,1043,57.81%,40.56%,1
彰化縣,埤頭鄉,0914,355,90,445,24,469,910,51.54%,39.01%,1
彰化縣,芳苑鄉,0998,233,75,308,29,337,940,35.85%,24.79%,1
彰化縣,芳苑鄉,0999,129,25,154,18,172,403,42.68%,32.01%,1
彰化縣,芳苑鄉,1000,280,70,350,31,381,756,50.4%,37.04%,1
彰化縣,芳苑鄉,1001,114,43,157,21,178,548,32.48%,20.8%,1
彰化縣,芳苑鄉,1002,385,101,486,33,519,997,52.06%,38.62%,1
彰化縣,芳苑鄉,1003,405,137,542,46,588,1300,45.23%,31.15%,1
彰化縣,芳苑鄉,1004,337,77,414,30,444,859,51.69%,39.23%,1
彰化縣,芳苑鄉,1005,288,77,365,20,385,734,52.45%,39.24%,1
彰化縣,芳苑鄉,1006,226,58,284,22,306,636,48.11%,35.53%,1
彰化縣,芳苑鄉,1007,276,68,344,36,380,808,47.03%,34.16%,1
彰化縣,芳苑鄉,1008,211,60,271,24,295,668,44.16%,31.59%,1
彰化縣,芳苑鄉,1009,252,101,353,24,377,744,50.67%,33.87%,1
彰化縣,芳苑鄉,1010,361,95,456,44,500,1026,48.73%,35.19%,1
彰化縣,芳苑鄉,1011,193,39,232,11,243,586,41.47%,32.94%,1
彰化縣,芳苑鄉,1012,227,59,286,28,314,593,52.95%,38.28%,1
彰化縣,芳苑鄉,1013,427,105,532,45,577,1071,53.87%,39.87%,1
彰化縣,芳苑鄉,1014,409,102,511,52,563,1060,53.11%,38.58%,1
彰化縣,芳苑鄉,1015,322,63,385,17,402,708,56.78%,45.48%,1
彰化縣,芳苑鄉,1016,279,54,333,28,361,735,49.12%,37.96%,1
彰化縣,芳苑鄉,1017,22,70,92,26,118,571,20.67%,3.85%,1
彰化縣,芳苑鄉,1018,241,60,301,26,327,729,44.86%,33.06%,1
彰化縣,芳苑鄉,1019,260,64,324,32,356,674,52.82%,38.58%,1
彰化縣,芳苑鄉,1020,313,102,415,21,436,846,51.54%,37%,1
彰化縣,芳苑鄉,1021,366,88,454,26,480,806,59.55%,45.41%,1
彰化縣,芳苑鄉,1022,161,35,196,11,207,470,44.04%,34.26%,1
彰化縣,芳苑鄉,1023,467,106,573,43,616,1124,54.8%,41.55%,1
彰化縣,芳苑鄉,1024,116,21,137,15,152,317,47.95%,36.59%,1
彰化縣,芳苑鄉,1025,373,81,454,42,496,1158,42.83%,32.21%,1
彰化縣,芳苑鄉,1026,335,107,442,21,463,967,47.88%,34.64%,1
彰化縣,芳苑鄉,1027,299,73,372,39,411,762,53.94%,39.24%,1
彰化縣,芳苑鄉,1028,361,84,445,36,481,1086,44.29%,33.24%,1
彰化縣,芳苑鄉,1029,271,71,342,25,367,747,49.13%,36.28%,1
彰化縣,芳苑鄉,1030,201,49,250,16,266,653,40.74%,30.78%,1
彰化縣,芳苑鄉,1031,379,95,474,40,514,872,58.94%,43.46%,1
彰化縣,芳苑鄉,1032,521,176,697,48,745,1235,60.32%,42.19%,1
彰化縣,芳苑鄉,1033,453,113,566,30,596,1102,54.08%,41.11%,1
彰化縣,大城鄉,0981,349,80,429,20,449,1288,34.86%,27.1%,1
彰化縣,大城鄉,0982,307,84,391,38,429,1104,38.86%,27.81%,1
彰化縣,大城鄉,0983,404,106,510,31,541,964,56.12%,41.91%,1
彰化縣,大城鄉,0984,457,115,572,36,608,1312,46.34%,34.83%,1
彰化縣,大城鄉,0985,259,63,322,44,366,853,42.91%,30.36%,1
彰化縣,大城鄉,0986,143,28,171,12,183,518,35.33%,27.61%,1
彰化縣,大城鄉,0987,183,49,232,20,252,574,43.9%,31.88%,1
彰化縣,大城鄉,0988,206,46,252,19,271,702,38.6%,29.34%,1
彰化縣,大城鄉,0989,86,22,108,14,122,376,32.45%,22.87%,1
彰化縣,大城鄉,0990,175,29,204,10,214,693,30.88%,25.25%,1
彰化縣,大城鄉,0991,285,70,355,35,390,877,44.47%,32.5%,1
彰化縣,大城鄉,0992,154,41,195,12,207,655,31.6%,23.51%,1
彰化縣,大城鄉,0993,331,71,402,27,429,1103,38.89%,30.01%,1
彰化縣,大城鄉,0994,294,92,386,30,416,1192,34.9%,24.66%,1
彰化縣,大城鄉,0995,279,61,340,21,361,917,39.37%,30.43%,1
彰化縣,大城鄉,0996,180,32,212,18,230,686,33.53%,26.24%,1
彰化縣,大城鄉,0997,219,60,279,16,295,899,32.81%,24.36%,1
彰化縣,竹塘鄉,1034,516,136,652,49,701,1168,60.02%,44.18%,1
彰化縣,竹塘鄉,1035,422,122,544,28,572,965,59.27%,43.73%,1
彰化縣,竹塘鄉,1036,446,125,571,31,602,960,62.71%,46.46%,1
彰化縣,竹塘鄉,1037,341,100,441,42,483,743,65.01%,45.9%,1
彰化縣,竹塘鄉,1038,250,62,312,28,340,751,45.27%,33.29%,1
彰化縣,竹塘鄉,1039,285,71,356,29,385,792,48.61%,35.98%,1
彰化縣,竹塘鄉,1040,277,79,356,14,370,733,50.48%,37.79%,1
彰化縣,竹塘鄉,1041,265,69,334,26,360,657,54.79%,40.33%,1
彰化縣,竹塘鄉,1042,422,110,532,38,570,1063,53.62%,39.7%,1
彰化縣,竹塘鄉,1043,482,113,595,45,640,1114,57.45%,43.27%,1
彰化縣,竹塘鄉,1044,241,75,316,29,345,506,68.18%,47.63%,1
彰化縣,竹塘鄉,1045,301,96,397,28,425,823,51.64%,36.57%,1
彰化縣,竹塘鄉,1046,237,77,314,25,339,654,51.83%,36.24%,1
彰化縣,竹塘鄉,1047,201,55,256,16,272,577,47.14%,34.84%,1
彰化縣,竹塘鄉,1048,289,83,372,39,411,772,53.24%,37.44%,1
彰化縣,竹塘鄉,1049,172,50,222,30,252,543,46.41%,31.68%,1
彰化縣,溪州鄉,0915,331,70,401,33,434,778,55.78%,42.54%,1
彰化縣,溪州鄉,0916,401,108,509,18,527,1061,49.67%,37.79%,1
彰化縣,溪州鄉,0917,272,64,336,31,367,701,52.35%,38.8%,1
彰化縣,溪州鄉,0918,414,115,529,20,549,879,62.46%,47.1%,1
彰化縣,溪州鄉,0919,322,90,412,23,435,654,66.51%,49.24%,1
彰化縣,溪州鄉,0920,383,103,486,18,504,878,57.4%,43.62%,1
彰化縣,溪州鄉,0921,446,104,550,25,575,942,61.04%,47.35%,1
彰化縣,溪州鄉,0922,357,105,462,26,488,871,56.03%,40.99%,1
彰化縣,溪州鄉,0923,431,111,542,15,557,1047,53.2%,41.17%,1
彰化縣,溪州鄉,0924,375,98,473,36,509,858,59.32%,43.71%,1
彰化縣,溪州鄉,0925,471,134,605,46,651,1409,46.2%,33.43%,1
彰化縣,溪州鄉,0926,323,88,411,13,424,792,53.54%,40.78%,1
彰化縣,溪州鄉,0927,277,79,356,30,386,714,54.06%,38.8%,1
彰化縣,溪州鄉,0928,395,108,503,39,542,1109,48.87%,35.62%,1
彰化縣,溪州鄉,0929,321,79,400,37,437,962,45.43%,33.37%,1
彰化縣,溪州鄉,0930,379,105,484,48,532,1157,45.98%,32.76%,1
彰化縣,溪州鄉,0931,375,99,474,24,498,952,52.31%,39.39%,1
彰化縣,溪州鄉,0932,329,119,448,29,477,887,53.78%,37.09%,1
彰化縣,溪州鄉,0933,262,88,350,34,384,866,44.34%,30.25%,1
彰化縣,溪州鄉,0934,340,105,445,43,488,1010,48.32%,33.66%,1
彰化縣,溪州鄉,0935,311,94,405,23,428,853,50.18%,36.46%,1
彰化縣,溪州鄉,0936,295,98,393,49,442,843,52.43%,34.99%,1
彰化縣,溪州鄉,0937,205,61,266,8,274,711,38.54%,28.83%,1
彰化縣,溪州鄉,0938,334,102,436,36,472,851,55.46%,39.25%,1
彰化縣,溪州鄉,0939,337,84,421,27,448,883,50.74%,38.17%,1
彰化縣,溪州鄉,0940,470,117,587,47,634,1247,50.84%,37.69%,1
彰化縣,溪州鄉,0941,590,205,795,38,833,1490,55.91%,39.6%,1
南投縣,南投市,0001,407,139,546,22,568,927,61.27%,43.91%,1
南投縣,南投市,0002,340,98,438,19,457,667,68.52%,50.97%,1
南投縣,南投市,0003,367,113,480,16,496,773,64.17%,47.48%,1
南投縣,南投市,0004,369,124,493,24,517,818,63.2%,45.11%,1
南投縣,南投市,0005,255,92,347,10,357,525,68%,48.57%,1
南投縣,南投市,0006,286,80,366,20,386,575,67.13%,49.74%,1
南投縣,南投市,0007,186,62,248,8,256,368,69.57%,50.54%,1
南投縣,南投市,0008,479,134,613,21,634,956,66.32%,50.1%,1
南投縣,南投市,0009,491,162,653,22,675,1245,54.22%,39.44%,1
南投縣,南投市,0010,622,217,839,18,857,1484,57.75%,41.91%,1
南投縣,南投市,0011,602,155,757,28,785,1191,65.91%,50.55%,1
南投縣,南投市,0012,645,229,874,45,919,1506,61.02%,42.83%,1
南投縣,南投市,0013,477,164,641,35,676,1070,63.18%,44.58%,1
南投縣,南投市,0014,310,102,412,16,428,670,63.88%,46.27%,1
南投縣,南投市,0015,499,167,666,35,701,1050,66.76%,47.52%,1
南投縣,南投市,0016,453,138,591,31,622,1122,55.44%,40.37%,1
南投縣,南投市,0017,411,119,530,27,557,984,56.61%,41.77%,1
南投縣,南投市,0018,505,177,682,23,705,1062,66.38%,47.55%,1
南投縣,南投市,0019,480,119,599,40,639,1053,60.68%,45.58%,1
南投縣,南投市,0020,490,180,670,32,702,1104,63.59%,44.38%,1
南投縣,南投市,0021,486,176,662,35,697,1192,58.47%,40.77%,1
南投縣,南投市,0022,405,133,538,16,554,960,57.71%,42.19%,1
南投縣,南投市,0023,412,117,529,30,559,906,61.7%,45.47%,1
南投縣,南投市,0024,427,146,573,22,595,957,62.17%,44.62%,1
南投縣,南投市,0025,481,148,629,26,655,997,65.7%,48.24%,1
南投縣,南投市,0026,466,146,612,18,630,1008,62.5%,46.23%,1
南投縣,南投市,0027,491,180,671,13,684,1164,58.76%,42.18%,1
南投縣,南投市,0028,270,66,336,14,350,587,59.63%,46%,1
南投縣,南投市,0029,289,94,383,32,415,734,56.54%,39.37%,1
南投縣,南投市,0030,306,95,401,30,431,724,59.53%,42.27%,1
南投縣,南投市,0031,462,101,563,36,599,1003,59.72%,46.06%,1
南投縣,南投市,0032,583,180,763,29,792,1356,58.41%,42.99%,1
南投縣,南投市,0033,533,184,717,35,752,1373,54.77%,38.82%,1
南投縣,南投市,0034,580,209,789,26,815,1452,56.13%,39.94%,1
南投縣,南投市,0035,171,33,204,8,212,362,58.56%,47.24%,1
南投縣,南投市,0036,171,41,212,24,236,389,60.67%,43.96%,1
南投縣,南投市,0037,589,210,799,31,830,1276,65.05%,46.16%,1
南投縣,南投市,0038,516,172,688,26,714,1089,65.56%,47.38%,1
南投縣,南投市,0039,414,143,557,36,593,921,64.39%,44.95%,1
南投縣,南投市,0040,455,154,609,12,621,892,69.62%,51.01%,1
南投縣,南投市,0041,505,166,671,24,695,1050,66.19%,48.1%,1
南投縣,南投市,0042,506,157,663,22,685,1078,63.54%,46.94%,1
南投縣,南投市,0043,483,162,645,23,668,1078,61.97%,44.81%,1
南投縣,南投市,0044,441,160,601,23,624,861,72.47%,51.22%,1
南投縣,南投市,0045,530,159,689,45,734,1221,60.11%,43.41%,1
南投縣,南投市,0046,494,151,645,26,671,1105,60.72%,44.71%,1
南投縣,南投市,0047,549,191,740,17,757,1230,61.54%,44.63%,1
南投縣,南投市,0048,485,149,634,41,675,1092,61.81%,44.41%,1
南投縣,南投市,0049,596,208,804,20,824,1286,64.07%,46.35%,1
南投縣,南投市,0050,336,100,436,24,460,655,70.23%,51.3%,1
南投縣,南投市,0051,348,101,449,24,473,719,65.79%,48.4%,1
南投縣,南投市,0052,315,104,419,20,439,720,60.97%,43.75%,1
南投縣,南投市,0053,279,54,333,11,344,509,67.58%,54.81%,1
南投縣,南投市,0054,239,32,271,11,282,492,57.32%,48.58%,1
南投縣,南投市,0055,310,53,363,11,374,616,60.71%,50.32%,1
南投縣,南投市,0056,513,107,620,26,646,1010,63.96%,50.79%,1
南投縣,南投市,0057,404,87,491,14,505,848,59.55%,47.64%,1
南投縣,南投市,0058,668,184,852,37,889,1387,64.1%,48.16%,1
南投縣,南投市,0059,573,203,776,31,807,1245,64.82%,46.02%,1
南投縣,南投市,0060,515,163,678,20,698,1199,58.22%,42.95%,1
南投縣,南投市,0061,598,163,761,39,800,1288,62.11%,46.43%,1
南投縣,南投市,0062,460,135,595,29,624,1040,60%,44.23%,1
南投縣,南投市,0063,484,156,640,27,667,1070,62.34%,45.23%,1
南投縣,南投市,0064,588,205,793,25,818,1299,62.97%,45.27%,1
南投縣,南投市,0065,519,170,689,28,717,1122,63.9%,46.26%,1
南投縣,南投市,0066,636,184,820,23,843,1414,59.62%,44.98%,1
南投縣,南投市,0067,491,148,639,30,669,1121,59.68%,43.8%,1
南投縣,南投市,0068,608,199,807,23,830,1434,57.88%,42.4%,1
南投縣,南投市,0069,600,155,755,18,773,1393,55.49%,43.07%,1
南投縣,南投市,0070,462,135,597,15,612,1059,57.79%,43.63%,1
南投縣,南投市,0071,533,157,690,20,710,1218,58.29%,43.76%,1
南投縣,南投市,0072,534,168,702,17,719,1293,55.61%,41.3%,1
南投縣,南投市,0073,531,127,658,24,682,1337,51.01%,39.72%,1
南投縣,南投市,0074,391,150,541,25,566,876,64.61%,44.63%,1
南投縣,南投市,0075,410,129,539,26,565,971,58.19%,42.22%,1
南投縣,南投市,0076,435,140,575,19,594,1012,58.7%,42.98%,1
南投縣,南投市,0077,420,107,527,27,554,973,56.94%,43.17%,1
南投縣,南投市,0078,469,140,609,23,632,1002,63.07%,46.81%,1
南投縣,南投市,0079,444,136,580,27,607,1024,59.28%,43.36%,1
南投縣,南投市,0080,394,123,517,77,594,1122,52.94%,35.12%,1
南投縣,南投市,0081,293,82,375,25,400,790,50.63%,37.09%,1
南投縣,南投市,0082,225,62,287,20,307,647,47.45%,34.78%,1
南投縣,南投市,0083,370,116,486,39,525,950,55.26%,38.95%,1
南投縣,南投市,0084,382,130,512,17,529,980,53.98%,38.98%,1
南投縣,埔里鎮,0085,359,111,470,33,503,828,60.75%,43.36%,1
南投縣,埔里鎮,0086,353,102,455,36,491,786,62.47%,44.91%,1
南投縣,埔里鎮,0087,461,117,578,31,609,1062,57.34%,43.41%,1
南投縣,埔里鎮,0088,569,155,724,29,753,1201,62.7%,47.38%,1
南投縣,埔里鎮,0089,606,158,764,23,787,1415,55.62%,42.83%,1
南投縣,埔里鎮,0090,548,163,711,22,733,1282,57.18%,42.75%,1
南投縣,埔里鎮,0091,382,103,485,18,503,859,58.56%,44.47%,1
南投縣,埔里鎮,0092,544,159,703,47,750,1288,58.23%,42.24%,1
南投縣,埔里鎮,0093,562,175,737,27,764,1330,57.44%,42.26%,1
南投縣,埔里鎮,0094,553,176,729,37,766,1416,54.1%,39.05%,1
南投縣,埔里鎮,0095,480,147,627,17,644,1283,50.19%,37.41%,1
南投縣,埔里鎮,0096,616,28,644,52,696,1151,60.47%,53.52%,1
南投縣,埔里鎮,0097,485,128,613,22,635,1193,53.23%,40.65%,1
南投縣,埔里鎮,0098,618,185,803,54,857,1471,58.26%,42.01%,1
南投縣,埔里鎮,0099,387,103,490,43,533,1044,51.05%,37.07%,1
南投縣,埔里鎮,0100,489,131,620,51,671,1122,59.8%,43.58%,1
南投縣,埔里鎮,0101,555,145,700,26,726,1129,64.3%,49.16%,1
南投縣,埔里鎮,0102,399,100,499,6,505,901,56.05%,44.28%,1
南投縣,埔里鎮,0103,408,97,505,39,544,997,54.56%,40.92%,1
南投縣,埔里鎮,0104,471,176,647,37,684,1209,56.58%,38.96%,1
南投縣,埔里鎮,0105,431,104,535,21,556,838,66.35%,51.43%,1
南投縣,埔里鎮,0106,457,136,593,20,613,1226,50%,37.28%,1
南投縣,埔里鎮,0107,572,192,764,31,795,1263,62.95%,45.29%,1
南投縣,埔里鎮,0108,448,168,616,20,636,1045,60.86%,42.87%,1
南投縣,埔里鎮,0109,519,148,667,35,702,1120,62.68%,46.34%,1
南投縣,埔里鎮,0110,516,153,669,25,694,1062,65.35%,48.59%,1
南投縣,埔里鎮,0111,436,137,573,26,599,1022,58.61%,42.66%,1
南投縣,埔里鎮,0112,451,127,578,21,599,1051,56.99%,42.91%,1
南投縣,埔里鎮,0113,475,129,604,22,626,1106,56.6%,42.95%,1
南投縣,埔里鎮,0114,471,139,610,16,626,1098,57.01%,42.9%,1
南投縣,埔里鎮,0115,469,146,615,19,634,1067,59.42%,43.96%,1
南投縣,埔里鎮,0116,298,96,394,31,425,725,58.62%,41.1%,1
南投縣,埔里鎮,0117,397,136,533,20,553,905,61.1%,43.87%,1
南投縣,埔里鎮,0118,459,140,599,43,642,1179,54.45%,38.93%,1
南投縣,埔里鎮,0119,374,100,474,21,495,944,52.44%,39.62%,1
南投縣,埔里鎮,0120,199,42,241,28,269,465,57.85%,42.8%,1
南投縣,埔里鎮,0121,471,141,612,29,641,1133,56.58%,41.57%,1
南投縣,埔里鎮,0122,468,105,573,31,604,1100,54.91%,42.55%,1
南投縣,埔里鎮,0123,503,140,643,35,678,1155,58.7%,43.55%,1
南投縣,埔里鎮,0124,490,145,635,39,674,1254,53.75%,39.07%,1
南投縣,埔里鎮,0125,500,159,659,46,705,1296,54.4%,38.58%,1
南投縣,埔里鎮,0126,470,159,629,35,664,1023,64.91%,45.94%,1
南投縣,埔里鎮,0127,398,89,487,16,503,964,52.18%,41.29%,1
南投縣,埔里鎮,0128,435,124,559,22,581,986,58.92%,44.12%,1
南投縣,埔里鎮,0129,456,142,598,19,617,1016,60.73%,44.88%,1
南投縣,埔里鎮,0130,390,119,509,25,534,898,59.47%,43.43%,1
南投縣,埔里鎮,0131,441,127,568,24,592,980,60.41%,45%,1
南投縣,埔里鎮,0132,437,105,542,23,565,933,60.56%,46.84%,1
南投縣,埔里鎮,0133,448,165,613,39,652,929,70.18%,48.22%,1
南投縣,埔里鎮,0134,441,132,573,20,593,1032,57.46%,42.73%,1
南投縣,埔里鎮,0135,123,25,148,12,160,315,50.79%,39.05%,1
南投縣,埔里鎮,0136,544,152,696,36,732,1363,53.71%,39.91%,1
南投縣,埔里鎮,0137,316,97,413,30,443,725,61.1%,43.59%,1
南投縣,埔里鎮,0138,329,81,410,17,427,705,60.57%,46.67%,1
南投縣,埔里鎮,0139,361,105,466,22,488,751,64.98%,48.07%,1
南投縣,埔里鎮,0140,384,128,512,22,534,932,57.3%,41.2%,1
南投縣,埔里鎮,0141,415,133,548,22,570,956,59.62%,43.41%,1
南投縣,埔里鎮,0142,167,39,206,11,217,376,57.71%,44.41%,1
南投縣,埔里鎮,0143,295,82,377,30,407,682,59.68%,43.26%,1
南投縣,埔里鎮,0144,550,61,611,35,646,990,65.25%,55.56%,1
南投縣,埔里鎮,0145,463,154,617,60,677,1324,51.13%,34.97%,1
南投縣,埔里鎮,0146,96,44,140,8,148,298,49.66%,32.21%,1
南投縣,埔里鎮,0147,504,92,596,59,655,1170,55.98%,43.08%,1
南投縣,埔里鎮,0148,278,75,353,10,363,604,60.1%,46.03%,1
南投縣,埔里鎮,0149,412,110,522,30,552,999,55.26%,41.24%,1
南投縣,埔里鎮,0150,358,94,452,22,474,923,51.35%,38.79%,1
南投縣,埔里鎮,0151,406,108,514,22,536,887,60.43%,45.77%,1
南投縣,埔里鎮,0152,405,108,513,23,536,981,54.64%,41.28%,1
南投縣,草屯鎮,0153,454,157,611,17,628,998,62.93%,45.49%,1
南投縣,草屯鎮,0154,469,149,618,10,628,1127,55.72%,41.61%,1
南投縣,草屯鎮,0155,542,194,736,15,751,1401,53.6%,38.69%,1
南投縣,草屯鎮,0156,458,148,606,18,624,1110,56.22%,41.26%,1
南投縣,草屯鎮,0157,567,169,736,31,767,1285,59.69%,44.12%,1
南投縣,草屯鎮,0158,407,109,516,24,540,936,57.69%,43.48%,1
南投縣,草屯鎮,0159,480,174,654,27,681,1141,59.68%,42.07%,1
南投縣,草屯鎮,0160,327,103,430,17,447,705,63.4%,46.38%,1
南投縣,草屯鎮,0161,510,186,696,13,709,1121,63.25%,45.5%,1
南投縣,草屯鎮,0162,420,148,568,19,587,877,66.93%,47.89%,1
南投縣,草屯鎮,0163,567,211,778,42,820,1401,58.53%,40.47%,1
南投縣,草屯鎮,0164,556,111,667,34,701,1267,55.33%,43.88%,1
南投縣,草屯鎮,0165,513,161,674,47,721,1214,59.39%,42.26%,1
南投縣,草屯鎮,0166,541,170,711,43,754,1259,59.89%,42.97%,1
南投縣,草屯鎮,0167,654,201,855,20,875,1442,60.68%,45.35%,1
南投縣,草屯鎮,0168,590,157,747,20,767,1273,60.25%,46.35%,1
南投縣,草屯鎮,0169,470,158,628,28,656,1145,57.29%,41.05%,1
南投縣,草屯鎮,0170,530,170,700,23,723,1279,56.53%,41.44%,1
南投縣,草屯鎮,0171,477,163,640,16,656,1158,56.65%,41.19%,1
南投縣,草屯鎮,0172,641,219,860,27,887,1335,66.44%,48.01%,1
南投縣,草屯鎮,0173,542,190,732,33,765,1178,64.94%,46.01%,1
南投縣,草屯鎮,0174,526,224,750,21,771,1327,58.1%,39.64%,1
南投縣,草屯鎮,0175,438,156,594,14,608,1000,60.8%,43.8%,1
南投縣,草屯鎮,0176,637,171,808,30,838,1257,66.67%,50.68%,1
南投縣,草屯鎮,0177,432,115,547,22,569,883,64.44%,48.92%,1
南投縣,草屯鎮,0178,448,143,591,27,618,1121,55.13%,39.96%,1
南投縣,草屯鎮,0179,463,137,600,20,620,1043,59.44%,44.39%,1
南投縣,草屯鎮,0180,433,153,586,18,604,979,61.7%,44.23%,1
南投縣,草屯鎮,0181,408,129,537,13,550,1048,52.48%,38.93%,1
南投縣,草屯鎮,0182,443,114,557,24,581,1009,57.58%,43.9%,1
南投縣,草屯鎮,0183,478,123,601,24,625,1138,54.92%,42%,1
南投縣,草屯鎮,0184,500,147,647,33,680,1197,56.81%,41.77%,1
南投縣,草屯鎮,0185,587,192,779,34,813,1364,59.6%,43.04%,1
南投縣,草屯鎮,0186,458,148,606,39,645,1059,60.91%,43.25%,1
南投縣,草屯鎮,0187,479,156,635,28,663,1108,59.84%,43.23%,1
南投縣,草屯鎮,0188,376,103,479,26,505,879,57.45%,42.78%,1
南投縣,草屯鎮,0189,422,115,537,30,567,957,59.25%,44.1%,1
南投縣,草屯鎮,0190,473,179,652,18,670,1395,48.03%,33.91%,1
南投縣,草屯鎮,0191,508,155,663,23,686,1101,62.31%,46.14%,1
南投縣,草屯鎮,0192,481,189,670,28,698,1297,53.82%,37.09%,1
南投縣,草屯鎮,0193,300,101,401,16,417,877,47.55%,34.21%,1
南投縣,草屯鎮,0194,482,158,640,41,681,1376,49.49%,35.03%,1
南投縣,草屯鎮,0195,472,144,616,38,654,1008,64.88%,46.83%,1
南投縣,草屯鎮,0196,491,146,637,35,672,1080,62.22%,45.46%,1
南投縣,草屯鎮,0197,394,135,529,36,565,1017,55.56%,38.74%,1
南投縣,草屯鎮,0198,447,128,575,37,612,961,63.68%,46.51%,1
南投縣,草屯鎮,0199,522,157,679,35,714,1160,61.55%,45%,1
南投縣,草屯鎮,0200,482,149,631,27,658,1121,58.7%,43%,1
南投縣,草屯鎮,0201,522,168,690,26,716,1243,57.6%,42%,1
南投縣,草屯鎮,0202,417,135,552,15,567,932,60.84%,44.74%,1
南投縣,草屯鎮,0203,617,206,823,39,862,1323,65.15%,46.64%,1
南投縣,草屯鎮,0204,620,150,770,34,804,1518,52.96%,40.84%,1
南投縣,草屯鎮,0205,414,136,550,35,585,923,63.38%,44.85%,1
南投縣,草屯鎮,0206,403,117,520,19,539,970,55.57%,41.55%,1
南投縣,草屯鎮,0207,447,154,601,22,623,1026,60.72%,43.57%,1
南投縣,草屯鎮,0208,593,201,794,37,831,1466,56.68%,40.45%,1
南投縣,草屯鎮,0209,492,150,642,37,679,1180,57.54%,41.69%,1
南投縣,草屯鎮,0210,453,149,602,10,612,1006,60.83%,45.03%,1
南投縣,草屯鎮,0211,362,131,493,16,509,1000,50.9%,36.2%,1
南投縣,草屯鎮,0212,495,179,674,16,690,1128,61.17%,43.88%,1
南投縣,草屯鎮,0213,252,89,341,10,351,623,56.34%,40.45%,1
南投縣,草屯鎮,0214,301,96,397,27,424,707,59.97%,42.57%,1
南投縣,草屯鎮,0215,311,76,387,20,407,719,56.61%,43.25%,1
南投縣,草屯鎮,0216,179,57,236,23,259,527,49.15%,33.97%,1
南投縣,草屯鎮,0217,491,187,678,29,707,1183,59.76%,41.5%,1
南投縣,草屯鎮,0218,294,222,516,23,539,869,62.03%,33.83%,1
南投縣,草屯鎮,0219,417,156,573,25,598,1132,52.83%,36.84%,1
南投縣,草屯鎮,0220,418,120,538,31,569,949,59.96%,44.05%,1
南投縣,草屯鎮,0221,460,124,584,25,609,965,63.11%,47.67%,1
南投縣,草屯鎮,0222,420,149,569,19,588,1068,55.06%,39.33%,1
南投縣,草屯鎮,0223,446,134,580,47,627,1024,61.23%,43.55%,1
南投縣,草屯鎮,0224,274,62,336,16,352,642,54.83%,42.68%,1
南投縣,草屯鎮,0225,394,121,515,24,539,1017,53%,38.74%,1
南投縣,草屯鎮,0226,475,130,605,24,629,1092,57.6%,43.5%,1
南投縣,草屯鎮,0227,461,141,602,61,663,1170,56.67%,39.4%,1
南投縣,草屯鎮,0228,492,134,626,43,669,1106,60.49%,44.48%,1
南投縣,竹山鎮,0229,539,135,674,31,705,1170,60.26%,46.07%,1
南投縣,竹山鎮,0230,381,119,500,35,535,850,62.94%,44.82%,1
南投縣,竹山鎮,0231,235,82,317,27,344,621,55.39%,37.84%,1
南投縣,竹山鎮,0232,365,124,489,24,513,905,56.69%,40.33%,1
南投縣,竹山鎮,0233,414,111,525,31,556,1099,50.59%,37.67%,1
南投縣,竹山鎮,0234,465,125,590,57,647,1214,53.29%,38.3%,1
南投縣,竹山鎮,0235,566,161,727,52,779,1287,60.53%,43.98%,1
南投縣,竹山鎮,0236,503,127,630,49,679,1191,57.01%,42.23%,1
南投縣,竹山鎮,0237,461,115,576,47,623,1118,55.72%,41.23%,1
南投縣,竹山鎮,0238,534,175,709,24,733,1278,57.36%,41.78%,1
南投縣,竹山鎮,0239,488,143,631,47,678,1153,58.8%,42.32%,1
南投縣,竹山鎮,0240,492,145,637,37,674,1243,54.22%,39.58%,1
南投縣,竹山鎮,0241,541,161,702,41,743,1308,56.8%,41.36%,1
南投縣,竹山鎮,0242,541,159,700,36,736,1358,54.2%,39.84%,1
南投縣,竹山鎮,0243,427,113,540,36,576,1044,55.17%,40.9%,1
南投縣,竹山鎮,0244,248,60,308,13,321,511,62.82%,48.53%,1
南投縣,竹山鎮,0245,276,81,357,12,369,682,54.11%,40.47%,1
南投縣,竹山鎮,0246,385,119,504,19,523,989,52.88%,38.93%,1
南投縣,竹山鎮,0247,583,148,731,37,768,1378,55.73%,42.31%,1
南投縣,竹山鎮,0248,80,29,109,5,114,217,52.53%,36.87%,1
南投縣,竹山鎮,0249,209,57,266,22,288,479,60.13%,43.63%,1
南投縣,竹山鎮,0250,166,38,204,8,212,430,49.3%,38.6%,1
南投縣,竹山鎮,0251,577,190,767,43,810,1437,56.37%,40.15%,1
南投縣,竹山鎮,0252,580,165,745,30,775,1286,60.26%,45.1%,1
南投縣,竹山鎮,0253,497,138,635,23,658,1080,60.93%,46.02%,1
南投縣,竹山鎮,0254,431,139,570,29,599,1070,55.98%,40.28%,1
南投縣,竹山鎮,0255,565,153,718,24,742,1295,57.3%,43.63%,1
南投縣,竹山鎮,0256,467,103,570,35,605,1047,57.78%,44.6%,1
南投縣,竹山鎮,0257,500,157,657,27,684,1300,52.62%,38.46%,1
南投縣,竹山鎮,0258,316,96,412,20,432,908,47.58%,34.8%,1
南投縣,竹山鎮,0259,291,93,384,37,421,821,51.28%,35.44%,1
南投縣,竹山鎮,0260,580,151,731,36,767,1320,58.11%,43.94%,1
南投縣,竹山鎮,0261,371,118,489,26,515,967,53.26%,38.37%,1
南投縣,竹山鎮,0262,228,57,285,23,308,595,51.76%,38.32%,1
南投縣,竹山鎮,0263,345,92,437,39,476,859,55.41%,40.16%,1
南投縣,竹山鎮,0264,482,126,608,41,649,1196,54.26%,40.3%,1
南投縣,竹山鎮,0265,283,65,348,22,370,649,57.01%,43.61%,1
南投縣,竹山鎮,0266,563,176,739,20,759,1341,56.6%,41.98%,1
南投縣,竹山鎮,0267,475,127,602,43,645,1222,52.78%,38.87%,1
南投縣,竹山鎮,0268,255,72,327,23,350,602,58.14%,42.36%,1
南投縣,竹山鎮,0269,253,72,325,21,346,617,56.08%,41%,1
南投縣,竹山鎮,0270,341,113,454,39,493,793,62.17%,43%,1
南投縣,竹山鎮,0271,394,116,510,14,524,922,56.83%,42.73%,1
南投縣,竹山鎮,0272,145,32,177,20,197,366,53.83%,39.62%,1
南投縣,竹山鎮,0273,194,36,230,3,233,509,45.78%,38.11%,1
南投縣,竹山鎮,0274,87,18,105,3,108,193,55.96%,45.08%,1
南投縣,竹山鎮,0275,169,61,230,22,252,406,62.07%,41.63%,1
南投縣,竹山鎮,0276,187,36,223,29,252,495,50.91%,37.78%,1
南投縣,竹山鎮,0277,93,14,107,8,115,307,37.46%,30.29%,1
南投縣,竹山鎮,0278,189,37,226,10,236,440,53.64%,42.95%,1
南投縣,竹山鎮,0279,240,44,284,30,314,577,54.42%,41.59%,1
南投縣,竹山鎮,0280,145,39,184,31,215,486,44.24%,29.84%,1
南投縣,竹山鎮,0281,112,26,138,13,151,403,37.47%,27.79%,1
南投縣,集集鎮,0282,479,134,613,34,647,1070,60.47%,44.77%,1
南投縣,集集鎮,0283,431,106,537,21,558,918,60.78%,46.95%,1
南投縣,集集鎮,0284,250,75,325,27,352,581,60.59%,43.03%,1
南投縣,集集鎮,0285,545,144,689,30,719,1194,60.22%,45.64%,1
南投縣,集集鎮,0286,159,45,204,20,224,488,45.9%,32.58%,1
南投縣,集集鎮,0287,218,67,285,29,314,504,62.3%,43.25%,1
南投縣,集集鎮,0288,398,128,526,37,563,910,61.87%,43.74%,1
南投縣,集集鎮,0289,346,105,451,34,485,773,62.74%,44.76%,1
南投縣,集集鎮,0290,291,95,386,17,403,709,56.84%,41.04%,1
南投縣,集集鎮,0291,388,141,529,24,553,960,57.6%,40.42%,1
南投縣,集集鎮,0292,195,63,258,19,277,503,55.07%,38.77%,1
南投縣,集集鎮,0293,137,57,194,19,213,419,50.84%,32.7%,1
南投縣,集集鎮,0294,197,69,266,8,274,582,47.08%,33.85%,1
南投縣,名間鄉,0295,535,150,685,46,731,1050,69.62%,50.95%,1
南投縣,名間鄉,0296,418,98,516,45,561,920,60.98%,45.43%,1
南投縣,名間鄉,0297,352,90,442,33,475,727,65.34%,48.42%,1
南投縣,名間鄉,0298,436,103,539,14,553,861,64.23%,50.64%,1
南投縣,名間鄉,0299,352,148,500,29,529,897,58.97%,39.24%,1
南投縣,名間鄉,0300,479,142,621,27,648,1055,61.42%,45.4%,1
南投縣,名間鄉,0301,517,143,660,40,700,1184,59.12%,43.67%,1
南投縣,名間鄉,0302,336,83,419,27,446,783,56.96%,42.91%,1
南投縣,名間鄉,0303,368,89,457,32,489,781,62.61%,47.12%,1
南投縣,名間鄉,0304,429,103,532,21,553,977,56.6%,43.91%,1
南投縣,名間鄉,0305,390,131,521,53,574,1015,56.55%,38.42%,1
南投縣,名間鄉,0306,421,110,531,31,562,914,61.49%,46.06%,1
南投縣,名間鄉,0307,464,118,582,14,596,1028,57.98%,45.14%,1
南投縣,名間鄉,0308,470,112,582,35,617,1018,60.61%,46.17%,1
南投縣,名間鄉,0309,573,142,715,47,762,1274,59.81%,44.98%,1
南投縣,名間鄉,0310,327,97,424,31,455,755,60.26%,43.31%,1
南投縣,名間鄉,0311,438,119,557,35,592,895,66.15%,48.94%,1
南投縣,名間鄉,0312,403,98,501,29,530,892,59.42%,45.18%,1
南投縣,名間鄉,0313,402,111,513,41,554,951,58.25%,42.27%,1
南投縣,名間鄉,0314,549,127,676,52,728,1261,57.73%,43.54%,1
南投縣,名間鄉,0315,310,105,415,28,443,768,57.68%,40.36%,1
南投縣,名間鄉,0316,417,120,537,48,585,962,60.81%,43.35%,1
南投縣,名間鄉,0317,408,98,506,30,536,867,61.82%,47.06%,1
南投縣,名間鄉,0318,356,156,512,56,568,930,61.08%,38.28%,1
南投縣,名間鄉,0319,290,59,349,40,389,641,60.69%,45.24%,1
南投縣,名間鄉,0320,217,48,265,19,284,530,53.58%,40.94%,1
南投縣,名間鄉,0321,384,125,509,48,557,931,59.83%,41.25%,1
南投縣,名間鄉,0322,498,135,633,38,671,1127,59.54%,44.19%,1
南投縣,名間鄉,0323,218,57,275,21,296,443,66.82%,49.21%,1
南投縣,名間鄉,0324,405,95,500,34,534,870,61.38%,46.55%,1
南投縣,名間鄉,0325,275,100,375,18,393,621,63.29%,44.28%,1
南投縣,名間鄉,0326,464,145,609,35,644,1179,54.62%,39.36%,1
南投縣,名間鄉,0327,403,122,525,37,562,881,63.79%,45.74%,1
南投縣,名間鄉,0328,446,110,556,40,596,876,68.04%,50.91%,1
南投縣,名間鄉,0329,353,85,438,38,476,783,60.79%,45.08%,1
南投縣,名間鄉,0330,318,74,392,33,425,778,54.63%,40.87%,1
南投縣,名間鄉,0331,112,391,503,37,540,983,54.93%,11.39%,1
南投縣,鹿谷鄉,0332,390,76,466,20,486,934,52.03%,41.76%,1
南投縣,鹿谷鄉,0333,390,120,510,31,541,940,57.55%,41.49%,1
南投縣,鹿谷鄉,0334,318,113,431,25,456,852,53.52%,37.32%,1
南投縣,鹿谷鄉,0335,153,54,207,9,216,451,47.89%,33.92%,1
南投縣,鹿谷鄉,0336,462,4,466,31,497,810,61.36%,57.04%,1
南投縣,鹿谷鄉,0337,520,151,671,41,712,1142,62.35%,45.53%,1
南投縣,鹿谷鄉,0338,273,79,352,18,370,766,48.3%,35.64%,1
南投縣,鹿谷鄉,0339,400,88,488,30,518,884,58.6%,45.25%,1
南投縣,鹿谷鄉,0340,330,106,436,24,460,811,56.72%,40.69%,1
南投縣,鹿谷鄉,0341,205,58,263,15,278,581,47.85%,35.28%,1
南投縣,鹿谷鄉,0342,216,59,275,21,296,578,51.21%,37.37%,1
南投縣,鹿谷鄉,0343,212,55,267,12,279,467,59.74%,45.4%,1
南投縣,鹿谷鄉,0344,266,50,316,30,346,622,55.63%,42.77%,1
南投縣,鹿谷鄉,0345,294,68,362,23,385,740,52.03%,39.73%,1
南投縣,鹿谷鄉,0346,331,70,401,32,433,767,56.45%,43.16%,1
南投縣,鹿谷鄉,0347,390,103,493,38,531,909,58.42%,42.9%,1
南投縣,鹿谷鄉,0348,267,84,351,21,372,713,52.17%,37.45%,1
南投縣,鹿谷鄉,0349,255,69,324,15,339,717,47.28%,35.56%,1
南投縣,鹿谷鄉,0350,289,76,365,40,405,794,51.01%,36.4%,1
南投縣,鹿谷鄉,0351,271,88,359,12,371,726,51.1%,37.33%,1
南投縣,鹿谷鄉,0352,240,67,307,12,319,737,43.28%,32.56%,1
南投縣,中寮鄉,0353,389,84,473,32,505,822,61.44%,47.32%,1
南投縣,中寮鄉,0354,122,27,149,6,155,253,61.26%,48.22%,1
南投縣,中寮鄉,0355,72,15,87,7,94,221,42.53%,32.58%,1
南投縣,中寮鄉,0356,120,35,155,5,160,353,45.33%,33.99%,1
南投縣,中寮鄉,0357,181,45,226,11,237,427,55.5%,42.39%,1
南投縣,中寮鄉,0358,174,42,216,14,230,406,56.65%,42.86%,1
南投縣,中寮鄉,0359,115,31,146,14,160,307,52.12%,37.46%,1
南投縣,中寮鄉,0360,319,61,380,25,405,661,61.27%,48.26%,1
南投縣,中寮鄉,0361,149,31,180,14,194,290,66.9%,51.38%,1
南投縣,中寮鄉,0362,394,152,546,30,576,973,59.2%,40.49%,1
南投縣,中寮鄉,0363,343,87,430,27,457,754,60.61%,45.49%,1
南投縣,中寮鄉,0364,276,66,342,27,369,662,55.74%,41.69%,1
南投縣,中寮鄉,0365,214,29,243,10,253,490,51.63%,43.67%,1
南投縣,中寮鄉,0366,130,30,160,17,177,335,52.84%,38.81%,1
南投縣,中寮鄉,0367,431,118,549,27,576,990,58.18%,43.54%,1
南投縣,中寮鄉,0368,234,48,282,16,298,461,64.64%,50.76%,1
南投縣,中寮鄉,0369,287,77,364,17,381,614,62.05%,46.74%,1
南投縣,中寮鄉,0370,364,104,468,46,514,895,57.43%,40.67%,1
南投縣,中寮鄉,0371,203,50,253,14,267,465,57.42%,43.66%,1
南投縣,中寮鄉,0372,286,74,360,45,405,682,59.38%,41.94%,1
南投縣,中寮鄉,0373,215,63,278,25,303,490,61.84%,43.88%,1
南投縣,中寮鄉,0374,304,53,357,38,395,643,61.43%,47.28%,1
南投縣,中寮鄉,0375,219,51,270,15,285,459,62.09%,47.71%,1
南投縣,中寮鄉,0376,207,49,256,13,269,528,50.95%,39.2%,1
南投縣,魚池鄉,0377,379,121,500,33,533,922,57.81%,41.11%,1
南投縣,魚池鄉,0378,441,159,600,47,647,1098,58.93%,40.16%,1
南投縣,魚池鄉,0379,281,81,362,25,387,720,53.75%,39.03%,1
南投縣,魚池鄉,0380,364,107,471,37,508,860,59.07%,42.33%,1
南投縣,魚池鄉,0381,192,45,237,25,262,514,50.97%,37.35%,1
南投縣,魚池鄉,0382,218,63,281,9,290,574,50.52%,37.98%,1
南投縣,魚池鄉,0383,470,141,611,62,673,1249,53.88%,37.63%,1
南投縣,魚池鄉,0384,154,32,186,8,194,293,66.21%,52.56%,1
南投縣,魚池鄉,0385,212,55,267,11,278,513,54.19%,41.33%,1
南投縣,魚池鄉,0386,76,22,98,5,103,186,55.38%,40.86%,1
南投縣,魚池鄉,0387,342,81,423,14,437,841,51.96%,40.67%,1
南投縣,魚池鄉,0388,120,35,155,15,170,270,62.96%,44.44%,1
南投縣,魚池鄉,0389,114,26,140,13,153,275,55.64%,41.45%,1
南投縣,魚池鄉,0390,97,27,124,6,130,282,46.1%,34.4%,1
南投縣,魚池鄉,0391,144,38,182,11,193,392,49.23%,36.73%,1
南投縣,魚池鄉,0392,231,55,286,20,306,556,55.04%,41.55%,1
南投縣,魚池鄉,0393,80,12,92,5,97,176,55.11%,45.45%,1
南投縣,魚池鄉,0394,199,57,256,17,273,578,47.23%,34.43%,1
南投縣,魚池鄉,0395,162,48,210,14,224,439,51.03%,36.9%,1
南投縣,魚池鄉,0396,379,105,484,16,500,844,59.24%,44.91%,1
南投縣,魚池鄉,0397,340,102,442,33,475,868,54.72%,39.17%,1
南投縣,魚池鄉,0398,155,26,181,9,190,405,46.91%,38.27%,1
南投縣,魚池鄉,0399,222,66,288,18,306,537,56.98%,41.34%,1
南投縣,魚池鄉,0400,148,21,169,14,183,335,54.63%,44.18%,1
南投縣,魚池鄉,0401,83,9,92,12,104,231,45.02%,35.93%,1
南投縣,國姓鄉,0402,452,99,551,51,602,964,62.45%,46.89%,1
南投縣,國姓鄉,0403,334,72,406,11,417,736,56.66%,45.38%,1
南投縣,國姓鄉,0404,356,71,427,46,473,801,59.05%,44.44%,1
南投縣,國姓鄉,0405,408,123,531,16,547,964,56.74%,42.32%,1
南投縣,國姓鄉,0406,282,83,365,22,387,686,56.41%,41.11%,1
南投縣,國姓鄉,0407,276,66,342,20,362,661,54.77%,41.75%,1
南投縣,國姓鄉,0408,301,58,359,24,383,730,52.47%,41.23%,1
南投縣,國姓鄉,0409,313,88,401,36,437,774,56.46%,40.44%,1
南投縣,國姓鄉,0410,321,85,406,15,421,706,59.63%,45.47%,1
南投縣,國姓鄉,0411,435,110,545,29,574,1012,56.72%,42.98%,1
南投縣,國姓鄉,0412,317,80,397,23,420,868,48.39%,36.52%,1
南投縣,國姓鄉,0413,451,91,542,20,562,918,61.22%,49.13%,1
南投縣,國姓鄉,0414,399,99,498,44,542,937,57.84%,42.58%,1
南投縣,國姓鄉,0415,334,90,424,27,451,815,55.34%,40.98%,1
南投縣,國姓鄉,0416,504,141,645,41,686,1134,60.49%,44.44%,1
南投縣,國姓鄉,0417,289,91,380,16,396,714,55.46%,40.48%,1
南投縣,國姓鄉,0418,454,132,586,42,628,1095,57.35%,41.46%,1
南投縣,國姓鄉,0419,176,45,221,16,237,448,52.9%,39.29%,1
南投縣,國姓鄉,0420,453,82,535,38,573,1064,53.85%,42.58%,1
南投縣,國姓鄉,0421,234,48,282,17,299,570,52.46%,41.05%,1
南投縣,水里鄉,0422,315,89,404,19,423,757,55.88%,41.61%,1
南投縣,水里鄉,0423,224,60,284,30,314,554,56.68%,40.43%,1
南投縣,水里鄉,0424,410,131,541,38,579,999,57.96%,41.04%,1
南投縣,水里鄉,0425,268,64,332,11,343,616,55.68%,43.51%,1
南投縣,水里鄉,0426,405,104,509,19,528,875,60.34%,46.29%,1
南投縣,水里鄉,0427,210,66,276,16,292,480,60.83%,43.75%,1
南投縣,水里鄉,0428,191,43,234,14,248,450,55.11%,42.44%,1
南投縣,水里鄉,0429,247,75,322,34,356,643,55.37%,38.41%,1
南投縣,水里鄉,0430,442,127,569,22,591,1004,58.86%,44.02%,1
南投縣,水里鄉,0431,307,78,385,17,402,741,54.25%,41.43%,1
南投縣,水里鄉,0432,316,143,459,14,473,802,58.98%,39.4%,1
南投縣,水里鄉,0433,476,131,607,32,639,998,64.03%,47.7%,1
南投縣,水里鄉,0434,312,91,403,40,443,800,55.38%,39%,1
南投縣,水里鄉,0435,282,68,350,18,368,589,62.48%,47.88%,1
南投縣,水里鄉,0436,356,87,443,31,474,887,53.44%,40.14%,1
南投縣,水里鄉,0437,469,131,600,33,633,1217,52.01%,38.54%,1
南投縣,水里鄉,0438,60,18,78,1,79,205,38.54%,29.27%,1
南投縣,水里鄉,0439,155,35,190,19,209,330,63.33%,46.97%,1
南投縣,水里鄉,0440,429,116,545,32,577,1100,52.45%,39%,1
南投縣,水里鄉,0441,86,14,100,5,105,275,38.18%,31.27%,1
南投縣,水里鄉,0442,94,40,134,2,136,318,42.77%,29.56%,1
南投縣,水里鄉,0443,338,84,422,31,453,818,55.38%,41.32%,1
南投縣,信義鄉,0444,530,119,649,34,683,1201,56.87%,44.13%,1
南投縣,信義鄉,0445,150,17,167,10,177,329,53.8%,45.59%,1
南投縣,信義鄉,0446,206,60,266,8,274,516,53.1%,39.92%,1
南投縣,信義鄉,0447,147,39,186,13,199,424,46.93%,34.67%,1
南投縣,信義鄉,0448,134,30,164,6,170,321,52.96%,41.74%,1
南投縣,信義鄉,0449,352,63,415,17,432,648,66.67%,54.32%,1
南投縣,信義鄉,0450,365,52,417,22,439,584,75.17%,62.5%,1
南投縣,信義鄉,0451,802,98,900,27,927,1376,67.37%,58.28%,1
南投縣,信義鄉,0452,538,74,612,22,634,979,64.76%,54.95%,1
南投縣,信義鄉,0453,326,54,380,20,400,530,75.47%,61.51%,1
南投縣,信義鄉,0454,394,97,491,25,516,961,53.69%,41%,1
南投縣,信義鄉,0455,208,37,245,12,257,464,55.39%,44.83%,1
南投縣,信義鄉,0456,231,56,287,20,307,517,59.38%,44.68%,1
南投縣,信義鄉,0457,68,18,86,4,90,149,60.4%,45.64%,1
南投縣,信義鄉,0458,651,84,735,29,764,1020,74.9%,63.82%,1
南投縣,信義鄉,0459,520,78,598,44,642,929,69.11%,55.97%,1
南投縣,信義鄉,0460,107,20,127,4,131,274,47.81%,39.05%,1
南投縣,信義鄉,0461,511,80,591,43,634,900,70.44%,56.78%,1
南投縣,信義鄉,0462,360,59,419,32,451,617,73.1%,58.35%,1
南投縣,信義鄉,0463,291,81,372,20,392,560,70%,51.96%,1
南投縣,仁愛鄉,0464,452,108,560,22,582,973,59.82%,46.45%,1
南投縣,仁愛鄉,0465,110,31,141,9,150,296,50.68%,37.16%,1
南投縣,仁愛鄉,0466,331,92,423,12,435,900,48.33%,36.78%,1
南投縣,仁愛鄉,0467,212,67,279,19,298,460,64.78%,46.09%,1
南投縣,仁愛鄉,0468,140,33,173,10,183,305,60%,45.9%,1
南投縣,仁愛鄉,0469,15,2,17,3,20,58,34.48%,25.86%,1
南投縣,仁愛鄉,0470,376,68,444,13,457,952,48%,39.5%,1
南投縣,仁愛鄉,0471,277,46,323,6,329,679,48.45%,40.8%,1
南投縣,仁愛鄉,0472,285,56,341,28,369,623,59.23%,45.75%,1
南投縣,仁愛鄉,0473,274,53,327,6,333,597,55.78%,45.9%,1
南投縣,仁愛鄉,0474,201,29,230,18,248,384,64.58%,52.34%,1
南投縣,仁愛鄉,0475,50,7,57,5,62,121,51.24%,41.32%,1
南投縣,仁愛鄉,0476,142,19,161,6,167,264,63.26%,53.79%,1
南投縣,仁愛鄉,0477,308,57,365,25,390,509,76.62%,60.51%,1
南投縣,仁愛鄉,0478,166,29,195,12,207,338,61.24%,49.11%,1
南投縣,仁愛鄉,0479,72,16,88,1,89,169,52.66%,42.6%,1
南投縣,仁愛鄉,0480,205,62,267,26,293,613,47.8%,33.44%,1
南投縣,仁愛鄉,0481,139,43,182,8,190,404,47.03%,34.41%,1
南投縣,仁愛鄉,0482,63,13,76,1,77,134,57.46%,47.01%,1
南投縣,仁愛鄉,0483,313,69,382,31,413,630,65.56%,49.68%,1
南投縣,仁愛鄉,0484,293,63,356,9,365,763,47.84%,38.4%,1
南投縣,仁愛鄉,0485,485,57,542,32,574,889,64.57%,54.56%,1
南投縣,仁愛鄉,0486,348,64,412,27,439,672,65.33%,51.79%,1
南投縣,仁愛鄉,0487,205,61,266,6,272,447,60.85%,45.86%,1
南投縣,仁愛鄉,0488,240,51,291,12,303,409,74.08%,58.68%,1
雲林縣,斗六市,0411,231,110,341,13,354,644,54.97%,35.87%,1
雲林縣,斗六市,0412,235,94,329,21,350,617,56.73%,38.09%,1
雲林縣,斗六市,0413,333,145,478,24,502,764,65.71%,43.59%,1
雲林縣,斗六市,0414,350,119,469,22,491,784,62.63%,44.64%,1
雲林縣,斗六市,0415,314,108,422,27,449,760,59.08%,41.32%,1
雲林縣,斗六市,0416,794,301,1095,51,1146,1881,60.93%,42.21%,1
雲林縣,斗六市,0417,710,246,956,50,1006,1829,55%,38.82%,1
雲林縣,斗六市,0418,572,192,764,29,793,1255,63.19%,45.58%,1
雲林縣,斗六市,0419,498,172,670,34,704,1090,64.59%,45.69%,1
雲林縣,斗六市,0420,483,163,646,29,675,1103,61.2%,43.79%,1
雲林縣,斗六市,0421,516,162,678,31,709,1176,60.29%,43.88%,1
雲林縣,斗六市,0422,631,214,845,21,866,1529,56.64%,41.27%,1
雲林縣,斗六市,0423,573,182,755,47,802,1335,60.07%,42.92%,1
雲林縣,斗六市,0424,737,255,992,45,1037,1770,58.59%,41.64%,1
雲林縣,斗六市,0425,542,196,738,23,761,1308,58.18%,41.44%,1
雲林縣,斗六市,0426,848,295,1143,41,1184,2171,54.54%,39.06%,1
雲林縣,斗六市,0427,525,162,687,33,720,1193,60.35%,44.01%,1
雲林縣,斗六市,0428,716,230,946,35,981,1572,62.4%,45.55%,1
雲林縣,斗六市,0429,430,135,565,15,580,1009,57.48%,42.62%,1
雲林縣,斗六市,0430,534,183,717,33,750,1195,62.76%,44.69%,1
雲林縣,斗六市,0431,627,198,825,41,866,1415,61.2%,44.31%,1
雲林縣,斗六市,0432,495,162,657,25,682,1101,61.94%,44.96%,1
雲林縣,斗六市,0433,663,237,900,26,926,1648,56.19%,40.23%,1
雲林縣,斗六市,0434,609,195,804,22,826,1588,52.02%,38.35%,1
雲林縣,斗六市,0435,544,263,807,22,829,1392,59.55%,39.08%,1
雲林縣,斗六市,0436,591,227,818,23,841,1422,59.14%,41.56%,1
雲林縣,斗六市,0437,444,114,558,26,584,1187,49.2%,37.41%,1
雲林縣,斗六市,0438,431,148,579,20,599,1142,52.45%,37.74%,1
雲林縣,斗六市,0439,655,206,861,18,879,1421,61.86%,46.09%,1
雲林縣,斗六市,0440,529,184,713,18,731,1261,57.97%,41.95%,1
雲林縣,斗六市,0441,595,199,794,32,826,1506,54.85%,39.51%,1
雲林縣,斗六市,0442,488,210,698,34,732,1214,60.3%,40.2%,1
雲林縣,斗六市,0443,614,209,823,49,872,1362,64.02%,45.08%,1
雲林縣,斗六市,0444,421,179,600,20,620,1097,56.52%,38.38%,1
雲林縣,斗六市,0445,538,175,713,25,738,1262,58.48%,42.63%,1
雲林縣,斗六市,0446,444,168,612,24,636,1154,55.11%,38.47%,1
雲林縣,斗六市,0447,369,114,483,26,509,847,60.09%,43.57%,1
雲林縣,斗六市,0448,590,232,822,21,843,1439,58.58%,41%,1
雲林縣,斗六市,0449,733,292,1025,46,1071,1747,61.31%,41.96%,1
雲林縣,斗六市,0450,572,220,792,35,827,1418,58.32%,40.34%,1
雲林縣,斗六市,0451,459,140,599,37,636,1112,57.19%,41.28%,1
雲林縣,斗六市,0452,553,203,756,27,783,1302,60.14%,42.47%,1
雲林縣,斗六市,0453,331,99,430,14,444,669,66.37%,49.48%,1
雲林縣,斗六市,0454,309,95,404,31,435,752,57.85%,41.09%,1
雲林縣,斗六市,0455,598,188,786,22,808,1450,55.72%,41.24%,1
雲林縣,斗六市,0456,226,72,298,22,320,555,57.66%,40.72%,1
雲林縣,斗六市,0457,538,206,744,29,773,1470,52.59%,36.6%,1
雲林縣,斗六市,0458,430,124,554,10,564,927,60.84%,46.39%,1
雲林縣,斗六市,0459,777,299,1076,33,1109,1893,58.58%,41.05%,1
雲林縣,斗六市,0460,715,227,942,46,988,1708,57.85%,41.86%,1
雲林縣,斗六市,0461,665,197,862,43,905,1773,51.04%,37.51%,1
雲林縣,斗六市,0462,596,221,817,27,844,1412,59.77%,42.21%,1
雲林縣,斗六市,0463,593,217,810,31,841,1354,62.11%,43.8%,1
雲林縣,斗六市,0464,417,294,711,17,728,1267,57.46%,32.91%,1
雲林縣,斗六市,0465,486,185,671,28,699,1273,54.91%,38.18%,1
雲林縣,斗六市,0466,622,186,808,60,868,1748,49.66%,35.58%,1
雲林縣,斗六市,0467,540,138,678,56,734,1238,59.29%,43.62%,1
雲林縣,斗六市,0468,674,184,858,34,892,1648,54.13%,40.9%,1
雲林縣,斗六市,0469,655,218,873,39,912,1520,60%,43.09%,1
雲林縣,斗六市,0470,468,104,572,25,597,1087,54.92%,43.05%,1
雲林縣,斗六市,0471,809,249,1058,57,1115,1904,58.56%,42.49%,1
雲林縣,斗六市,0472,319,88,407,30,437,702,62.25%,45.44%,1
雲林縣,斗六市,0473,485,152,637,36,673,1111,60.58%,43.65%,1
雲林縣,斗六市,0474,433,114,547,20,567,1123,50.49%,38.56%,1
雲林縣,斗六市,0475,453,143,596,28,624,1146,54.45%,39.53%,1
雲林縣,斗六市,0476,694,232,926,40,966,1786,54.09%,38.86%,1
雲林縣,斗六市,0477,402,144,546,47,593,1023,57.97%,39.3%,1
雲林縣,斗六市,0478,826,278,1104,51,1155,2072,55.74%,39.86%,1
雲林縣,斗六市,0479,436,158,594,21,615,1128,54.52%,38.65%,1
雲林縣,斗南鎮,0498,522,149,671,34,705,1166,60.46%,44.77%,1
雲林縣,斗南鎮,0499,519,171,690,22,712,1135,62.73%,45.73%,1
雲林縣,斗南鎮,0500,436,147,583,22,605,975,62.05%,44.72%,1
雲林縣,斗南鎮,0501,618,225,843,34,877,1459,60.11%,42.36%,1
雲林縣,斗南鎮,0502,548,206,754,45,799,1351,59.14%,40.56%,1
雲林縣,斗南鎮,0503,545,179,724,26,750,1321,56.78%,41.26%,1
雲林縣,斗南鎮,0504,374,113,487,24,511,907,56.34%,41.23%,1
雲林縣,斗南鎮,0505,665,219,884,42,926,1473,62.86%,45.15%,1
雲林縣,斗南鎮,0506,551,208,759,45,804,1277,62.96%,43.15%,1
雲林縣,斗南鎮,0507,529,180,709,45,754,1333,56.56%,39.68%,1
雲林縣,斗南鎮,0508,323,87,410,24,434,777,55.86%,41.57%,1
雲林縣,斗南鎮,0509,340,113,453,29,482,877,54.96%,38.77%,1
雲林縣,斗南鎮,0510,368,87,455,38,493,899,54.84%,40.93%,1
雲林縣,斗南鎮,0511,242,67,309,25,334,688,48.55%,35.17%,1
雲林縣,斗南鎮,0512,479,104,583,27,610,1147,53.18%,41.76%,1
雲林縣,斗南鎮,0513,654,243,897,66,963,1709,56.35%,38.27%,1
雲林縣,斗南鎮,0514,478,143,621,23,644,1042,61.8%,45.87%,1
雲林縣,斗南鎮,0515,638,223,861,41,902,1631,55.3%,39.12%,1
雲林縣,斗南鎮,0516,742,235,977,57,1034,1702,60.75%,43.6%,1
雲林縣,斗南鎮,0517,697,188,885,42,927,1564,59.27%,44.57%,1
雲林縣,斗南鎮,0518,340,75,415,26,441,910,48.46%,37.36%,1
雲林縣,斗南鎮,0519,576,186,762,31,793,1276,62.15%,45.14%,1
雲林縣,斗南鎮,0520,352,86,438,11,449,897,50.06%,39.24%,1
雲林縣,斗南鎮,0521,317,106,423,26,449,803,55.92%,39.48%,1
雲林縣,斗南鎮,0522,376,94,470,36,506,866,58.43%,43.42%,1
雲林縣,斗南鎮,0523,344,122,466,38,504,852,59.15%,40.38%,1
雲林縣,斗南鎮,0524,297,71,368,20,388,671,57.82%,44.26%,1
雲林縣,斗南鎮,0525,394,125,519,17,536,981,54.64%,40.16%,1
雲林縣,斗南鎮,0526,390,138,528,20,548,1129,48.54%,34.54%,1
雲林縣,斗南鎮,0527,627,245,872,65,937,1586,59.08%,39.53%,1
雲林縣,斗南鎮,0528,565,164,729,38,767,1243,61.71%,45.45%,1
雲林縣,斗南鎮,0529,402,101,503,16,519,984,52.74%,40.85%,1
雲林縣,斗南鎮,0530,654,187,841,48,889,1507,58.99%,43.4%,1
雲林縣,虎尾鎮,0109,556,155,711,33,744,1347,55.23%,41.28%,1
雲林縣,虎尾鎮,0110,514,205,719,26,745,1258,59.22%,40.86%,1
雲林縣,虎尾鎮,0111,328,98,426,19,445,785,56.69%,41.78%,1
雲林縣,虎尾鎮,0112,308,105,413,25,438,890,49.21%,34.61%,1
雲林縣,虎尾鎮,0113,610,198,808,49,857,1413,60.65%,43.17%,1
雲林縣,虎尾鎮,0114,620,228,848,27,875,1431,61.15%,43.33%,1
雲林縣,虎尾鎮,0115,485,143,628,31,659,1224,53.84%,39.62%,1
雲林縣,虎尾鎮,0116,479,162,641,21,662,1325,49.96%,36.15%,1
雲林縣,虎尾鎮,0117,393,148,541,33,574,941,61%,41.76%,1
雲林縣,虎尾鎮,0118,648,219,867,20,887,1613,54.99%,40.17%,1
雲林縣,虎尾鎮,0119,604,233,837,32,869,1641,52.96%,36.81%,1
雲林縣,虎尾鎮,0120,510,174,684,27,711,1200,59.25%,42.5%,1
雲林縣,虎尾鎮,0121,517,205,722,38,760,1294,58.73%,39.95%,1
雲林縣,虎尾鎮,0122,507,194,701,27,728,1273,57.19%,39.83%,1
雲林縣,虎尾鎮,0123,655,190,845,37,882,1438,61.34%,45.55%,1
雲林縣,虎尾鎮,0124,584,188,772,21,793,1361,58.27%,42.91%,1
雲林縣,虎尾鎮,0125,639,203,842,28,870,1444,60.25%,44.25%,1
雲林縣,虎尾鎮,0126,683,231,914,23,937,1490,62.89%,45.84%,1
雲林縣,虎尾鎮,0127,564,244,808,29,837,1307,64.04%,43.15%,1
雲林縣,虎尾鎮,0128,336,136,472,18,490,967,50.67%,34.75%,1
雲林縣,虎尾鎮,0129,745,240,985,29,1014,1865,54.37%,39.95%,1
雲林縣,虎尾鎮,0130,749,279,1028,25,1053,1880,56.01%,39.84%,1
雲林縣,虎尾鎮,0131,443,116,559,25,584,1099,53.14%,40.31%,1
雲林縣,虎尾鎮,0132,369,131,500,16,516,901,57.27%,40.95%,1
雲林縣,虎尾鎮,0133,430,156,586,26,612,1120,54.64%,38.39%,1
雲林縣,虎尾鎮,0134,180,67,247,8,255,545,46.79%,33.03%,1
雲林縣,虎尾鎮,0135,552,185,737,38,775,1420,54.58%,38.87%,1
雲林縣,虎尾鎮,0136,466,154,620,21,641,1248,51.36%,37.34%,1
雲林縣,虎尾鎮,0137,329,87,416,24,440,799,55.07%,41.18%,1
雲林縣,虎尾鎮,0138,314,96,410,37,447,836,53.47%,37.56%,1
雲林縣,虎尾鎮,0139,301,125,426,30,456,924,49.35%,32.58%,1
雲林縣,虎尾鎮,0140,555,158,713,19,732,1648,44.42%,33.68%,1
雲林縣,虎尾鎮,0141,536,173,709,70,779,1616,48.21%,33.17%,1
雲林縣,虎尾鎮,0142,538,205,743,46,789,1546,51.03%,34.8%,1
雲林縣,虎尾鎮,0143,502,136,638,34,672,1283,52.38%,39.13%,1
雲林縣,虎尾鎮,0144,449,112,561,23,584,1078,54.17%,41.65%,1
雲林縣,虎尾鎮,0145,473,147,620,32,652,1313,49.66%,36.02%,1
雲林縣,虎尾鎮,0146,444,156,600,33,633,1284,49.3%,34.58%,1
雲林縣,虎尾鎮,0147,533,143,676,52,728,1356,53.69%,39.31%,1
雲林縣,虎尾鎮,0148,567,187,754,57,811,1504,53.92%,37.7%,1
雲林縣,虎尾鎮,0149,400,130,530,23,553,1224,45.18%,32.68%,1
雲林縣,虎尾鎮,0150,499,165,664,45,709,1509,46.98%,33.07%,1
雲林縣,虎尾鎮,0151,216,100,316,49,365,855,42.69%,25.26%,1
雲林縣,虎尾鎮,0152,463,183,646,74,720,1549,46.48%,29.89%,1
雲林縣,虎尾鎮,0153,306,86,392,23,415,851,48.77%,35.96%,1
雲林縣,虎尾鎮,0154,454,133,587,53,640,1272,50.31%,35.69%,1
雲林縣,西螺鎮,0340,253,565,818,54,872,1590,54.84%,15.91%,1
雲林縣,西螺鎮,0341,664,248,912,50,962,1741,55.26%,38.14%,1
雲林縣,西螺鎮,0342,509,159,668,37,705,1080,65.28%,47.13%,1
雲林縣,西螺鎮,0343,457,149,606,46,652,1040,62.69%,43.94%,1
雲林縣,西螺鎮,0344,577,176,753,30,783,1346,58.17%,42.87%,1
雲林縣,西螺鎮,0345,669,197,866,33,899,1625,55.32%,41.17%,1
雲林縣,西螺鎮,0346,169,52,221,13,234,354,66.1%,47.74%,1
雲林縣,西螺鎮,0347,236,69,305,15,320,580,55.17%,40.69%,1
雲林縣,西螺鎮,0348,254,97,351,23,374,591,63.28%,42.98%,1
雲林縣,西螺鎮,0349,437,145,582,39,621,1050,59.14%,41.62%,1
雲林縣,西螺鎮,0350,488,169,657,63,720,1147,62.77%,42.55%,1
雲林縣,西螺鎮,0351,606,209,815,45,860,1602,53.68%,37.83%,1
雲林縣,西螺鎮,0352,560,184,744,32,776,1452,53.44%,38.57%,1
雲林縣,西螺鎮,0353,615,212,827,62,889,1578,56.34%,38.97%,1
雲林縣,西螺鎮,0354,507,146,653,21,674,1305,51.65%,38.85%,1
雲林縣,西螺鎮,0355,466,154,620,35,655,1327,49.36%,35.12%,1
雲林縣,西螺鎮,0356,573,190,763,40,803,1516,52.97%,37.8%,1
雲林縣,西螺鎮,0357,275,85,360,19,379,828,45.77%,33.21%,1
雲林縣,西螺鎮,0358,258,66,324,20,344,788,43.65%,32.74%,1
雲林縣,西螺鎮,0359,296,115,411,51,462,863,53.53%,34.3%,1
雲林縣,西螺鎮,0360,352,127,479,43,522,984,53.05%,35.77%,1
雲林縣,西螺鎮,0361,559,185,744,76,820,1514,54.16%,36.92%,1
雲林縣,西螺鎮,0362,317,107,424,45,469,870,53.91%,36.44%,1
雲林縣,西螺鎮,0363,351,128,479,43,522,971,53.76%,36.15%,1
雲林縣,西螺鎮,0364,426,145,571,42,613,1304,47.01%,32.67%,1
雲林縣,西螺鎮,0365,242,91,333,26,359,726,49.45%,33.33%,1
雲林縣,西螺鎮,0366,333,80,413,35,448,823,54.43%,40.46%,1
雲林縣,西螺鎮,0367,278,82,360,14,374,886,42.21%,31.38%,1
雲林縣,西螺鎮,0368,470,160,630,57,687,1373,50.04%,34.23%,1
雲林縣,西螺鎮,0369,384,117,501,46,547,983,55.65%,39.06%,1
雲林縣,西螺鎮,0370,403,123,526,28,554,1014,54.64%,39.74%,1
雲林縣,西螺鎮,0371,319,126,445,32,477,939,50.8%,33.97%,1
雲林縣,西螺鎮,0372,319,102,421,29,450,866,51.96%,36.84%,1
雲林縣,西螺鎮,0373,514,165,679,52,731,1486,49.19%,34.59%,1
雲林縣,土庫鎮,0080,355,121,476,39,515,809,63.66%,43.88%,1
雲林縣,土庫鎮,0081,381,125,506,39,545,896,60.83%,42.52%,1
雲林縣,土庫鎮,0082,271,101,372,34,406,687,59.1%,39.45%,1
雲林縣,土庫鎮,0083,348,108,456,19,475,702,67.66%,49.57%,1
雲林縣,土庫鎮,0084,481,145,626,17,643,1032,62.31%,46.61%,1
雲林縣,土庫鎮,0085,248,81,329,44,373,697,53.52%,35.58%,1
雲林縣,土庫鎮,0086,157,37,194,35,229,427,53.63%,36.77%,1
雲林縣,土庫鎮,0087,621,179,800,43,843,1451,58.1%,42.8%,1
雲林縣,土庫鎮,0088,557,174,731,12,743,1283,57.91%,43.41%,1
雲林縣,土庫鎮,0089,198,86,284,8,292,634,46.06%,31.23%,1
雲林縣,土庫鎮,0090,294,112,406,31,437,796,54.9%,36.93%,1
雲林縣,土庫鎮,0091,237,81,318,26,344,745,46.17%,31.81%,1
雲林縣,土庫鎮,0092,202,68,270,18,288,576,50%,35.07%,1
雲林縣,土庫鎮,0093,252,57,309,48,357,743,48.05%,33.92%,1
雲林縣,土庫鎮,0094,155,68,223,15,238,534,44.57%,29.03%,1
雲林縣,土庫鎮,0095,362,130,492,61,553,1199,46.12%,30.19%,1
雲林縣,土庫鎮,0096,367,124,491,56,547,1077,50.79%,34.08%,1
雲林縣,土庫鎮,0097,277,80,357,27,384,819,46.89%,33.82%,1
雲林縣,土庫鎮,0098,272,71,343,27,370,684,54.09%,39.77%,1
雲林縣,土庫鎮,0099,347,88,435,36,471,843,55.87%,41.16%,1
雲林縣,土庫鎮,0100,350,93,443,51,494,916,53.93%,38.21%,1
雲林縣,土庫鎮,0101,342,98,440,38,478,948,50.42%,36.08%,1
雲林縣,土庫鎮,0102,371,106,477,18,495,914,54.16%,40.59%,1
雲林縣,土庫鎮,0103,347,95,442,40,482,860,56.05%,40.35%,1
雲林縣,土庫鎮,0104,320,122,442,36,478,929,51.45%,34.45%,1
雲林縣,土庫鎮,0105,296,97,393,32,425,875,48.57%,33.83%,1
雲林縣,土庫鎮,0106,277,78,355,33,388,896,43.3%,30.92%,1
雲林縣,土庫鎮,0107,234,81,315,33,348,757,45.97%,30.91%,1
雲林縣,土庫鎮,0108,221,77,298,33,331,683,48.46%,32.36%,1
雲林縣,北港鎮,0256,306,82,388,39,427,724,58.98%,42.27%,1
雲林縣,北港鎮,0257,296,115,411,41,452,688,65.7%,43.02%,1
雲林縣,北港鎮,0258,204,45,249,18,267,452,59.07%,45.13%,1
雲林縣,北港鎮,0259,362,114,476,35,511,866,59.01%,41.8%,1
雲林縣,北港鎮,0260,130,43,173,6,179,336,53.27%,38.69%,1
雲林縣,北港鎮,0261,169,34,203,13,216,395,54.68%,42.78%,1
雲林縣,北港鎮,0262,185,37,222,17,239,376,63.56%,49.2%,1
雲林縣,北港鎮,0263,388,134,522,23,545,950,57.37%,40.84%,1
雲林縣,北港鎮,0264,243,65,308,24,332,512,64.84%,47.46%,1
雲林縣,北港鎮,0265,136,40,176,25,201,324,62.04%,41.98%,1
雲林縣,北港鎮,0266,220,58,278,23,301,546,55.13%,40.29%,1
雲林縣,北港鎮,0267,200,55,255,15,270,433,62.36%,46.19%,1
雲林縣,北港鎮,0268,307,80,387,45,432,751,57.52%,40.88%,1
雲林縣,北港鎮,0269,218,43,261,12,273,442,61.76%,49.32%,1
雲林縣,北港鎮,0270,471,159,630,39,669,1151,58.12%,40.92%,1
雲林縣,北港鎮,0271,515,171,686,31,717,1224,58.58%,42.08%,1
雲林縣,北港鎮,0272,508,139,647,35,682,1211,56.32%,41.95%,1
雲林縣,北港鎮,0273,529,175,704,49,753,1326,56.79%,39.89%,1
雲林縣,北港鎮,0274,349,111,460,22,482,744,64.78%,46.91%,1
雲林縣,北港鎮,0275,444,144,588,39,627,977,64.18%,45.45%,1
雲林縣,北港鎮,0276,369,117,486,50,536,960,55.83%,38.44%,1
雲林縣,北港鎮,0277,149,37,186,8,194,494,39.27%,30.16%,1
雲林縣,北港鎮,0278,561,201,762,28,790,1364,57.92%,41.13%,1
雲林縣,北港鎮,0279,442,177,619,42,661,1123,58.86%,39.36%,1
雲林縣,北港鎮,0280,578,212,790,34,824,1451,56.79%,39.83%,1
雲林縣,北港鎮,0281,485,176,661,35,696,1162,59.9%,41.74%,1
雲林縣,北港鎮,0282,416,149,565,39,604,1130,53.45%,36.81%,1
雲林縣,北港鎮,0283,449,125,574,31,605,1149,52.65%,39.08%,1
雲林縣,北港鎮,0284,172,53,225,14,239,533,44.84%,32.27%,1
雲林縣,北港鎮,0285,202,78,280,12,292,433,67.44%,46.65%,1
雲林縣,北港鎮,0286,153,29,182,8,190,377,50.4%,40.58%,1
雲林縣,北港鎮,0287,270,71,341,16,357,809,44.13%,33.37%,1
雲林縣,北港鎮,0288,488,122,610,44,654,1397,46.81%,34.93%,1
雲林縣,北港鎮,0289,375,105,480,46,526,1145,45.94%,32.75%,1
雲林縣,北港鎮,0290,218,53,271,46,317,828,38.29%,26.33%,1
雲林縣,北港鎮,0291,182,39,221,8,229,557,41.11%,32.68%,1
雲林縣,北港鎮,0292,353,128,481,29,510,1060,48.11%,33.3%,1
雲林縣,北港鎮,0293,201,60,261,26,287,577,49.74%,34.84%,1
雲林縣,北港鎮,0294,281,95,376,37,413,931,44.36%,30.18%,1
雲林縣,北港鎮,0295,404,122,526,30,556,1018,54.62%,39.69%,1
雲林縣,北港鎮,0296,447,145,592,15,607,1032,58.82%,43.31%,1
雲林縣,古坑鄉,0531,448,138,586,38,624,1126,55.42%,39.79%,1
雲林縣,古坑鄉,0532,351,133,484,45,529,994,53.22%,35.31%,1
雲林縣,古坑鄉,0533,523,234,757,57,814,1517,53.66%,34.48%,1
雲林縣,古坑鄉,0534,533,148,681,41,722,1302,55.45%,40.94%,1
雲林縣,古坑鄉,0535,664,196,860,39,899,1772,50.73%,37.47%,1
雲林縣,古坑鄉,0536,579,13,592,53,645,1122,57.49%,51.6%,1
雲林縣,古坑鄉,0537,88,18,106,3,109,304,35.86%,28.95%,1
雲林縣,古坑鄉,0538,498,121,619,64,683,1169,58.43%,42.6%,1
雲林縣,古坑鄉,0539,464,153,617,38,655,1255,52.19%,36.97%,1
雲林縣,古坑鄉,0540,444,173,617,36,653,1078,60.58%,41.19%,1
雲林縣,古坑鄉,0541,339,109,448,28,476,943,50.48%,35.95%,1
雲林縣,古坑鄉,0542,463,151,614,59,673,1300,51.77%,35.62%,1
雲林縣,古坑鄉,0543,390,78,468,34,502,964,52.07%,40.46%,1
雲林縣,古坑鄉,0544,455,134,589,31,620,1144,54.2%,39.77%,1
雲林縣,古坑鄉,0545,585,165,750,47,797,1482,53.78%,39.47%,1
雲林縣,古坑鄉,0546,284,85,369,24,393,688,57.12%,41.28%,1
雲林縣,古坑鄉,0547,357,110,467,44,511,998,51.2%,35.77%,1
雲林縣,古坑鄉,0548,477,130,607,47,654,1140,57.37%,41.84%,1
雲林縣,古坑鄉,0549,435,134,569,34,603,1102,54.72%,39.47%,1
雲林縣,古坑鄉,0550,384,106,490,21,511,956,53.45%,40.17%,1
雲林縣,古坑鄉,0551,209,154,363,24,387,695,55.68%,30.07%,1
雲林縣,古坑鄉,0552,426,112,538,79,617,1233,50.04%,34.55%,1
雲林縣,古坑鄉,0553,93,33,126,4,130,285,45.61%,32.63%,1
雲林縣,古坑鄉,0554,239,50,289,12,301,734,41.01%,32.56%,1
雲林縣,古坑鄉,0555,444,145,589,47,636,1150,55.3%,38.61%,1
雲林縣,古坑鄉,0556,194,41,235,17,252,453,55.63%,42.83%,1
雲林縣,古坑鄉,0557,215,45,260,18,278,571,48.69%,37.65%,1
雲林縣,大埤鄉,0480,298,84,382,24,406,750,54.13%,39.73%,1
雲林縣,大埤鄉,0481,268,83,351,22,373,719,51.88%,37.27%,1
雲林縣,大埤鄉,0482,254,55,309,15,324,603,53.73%,42.12%,1
雲林縣,大埤鄉,0483,395,95,490,44,534,1106,48.28%,35.71%,1
雲林縣,大埤鄉,0484,667,90,757,39,796,1495,53.24%,44.62%,1
雲林縣,大埤鄉,0485,260,74,334,25,359,600,59.83%,43.33%,1
雲林縣,大埤鄉,0486,427,124,551,42,593,1004,59.06%,42.53%,1
雲林縣,大埤鄉,0487,287,95,382,19,401,948,42.3%,30.27%,1
雲林縣,大埤鄉,0488,629,157,786,45,831,1539,54%,40.87%,1
雲林縣,大埤鄉,0489,503,151,654,41,695,1430,48.6%,35.17%,1
雲林縣,大埤鄉,0490,186,43,229,14,243,465,52.26%,40%,1
雲林縣,大埤鄉,0491,491,143,634,26,660,1307,50.5%,37.57%,1
雲林縣,大埤鄉,0492,185,58,243,6,249,474,52.53%,39.03%,1
雲林縣,大埤鄉,0493,508,168,676,59,735,1220,60.25%,41.64%,1
雲林縣,大埤鄉,0494,294,81,375,17,392,733,53.48%,40.11%,1
雲林縣,大埤鄉,0495,265,86,351,26,377,681,55.36%,38.91%,1
雲林縣,大埤鄉,0496,217,71,288,18,306,712,42.98%,30.48%,1
雲林縣,大埤鄉,0497,238,74,312,37,349,723,48.27%,32.92%,1
雲林縣,莿桐鄉,0374,603,217,820,37,857,1507,56.87%,40.01%,1
雲林縣,莿桐鄉,0375,505,176,681,29,710,1300,54.62%,38.85%,1
雲林縣,莿桐鄉,0376,551,137,688,69,757,1272,59.51%,43.32%,1
雲林縣,莿桐鄉,0377,315,126,441,22,463,861,53.77%,36.59%,1
雲林縣,莿桐鄉,0378,542,173,715,50,765,1565,48.88%,34.63%,1
雲林縣,莿桐鄉,0379,235,56,291,20,311,577,53.9%,40.73%,1
雲林縣,莿桐鄉,0380,210,74,284,21,305,636,47.96%,33.02%,1
雲林縣,莿桐鄉,0381,397,137,534,48,582,1110,52.43%,35.77%,1
雲林縣,莿桐鄉,0382,370,155,525,49,574,973,58.99%,38.03%,1
雲林縣,莿桐鄉,0383,366,132,498,56,554,985,56.24%,37.16%,1
雲林縣,莿桐鄉,0384,735,219,954,69,1023,1707,59.93%,43.06%,1
雲林縣,莿桐鄉,0385,518,169,687,47,734,1284,57.17%,40.34%,1
雲林縣,莿桐鄉,0386,531,171,702,39,741,1293,57.31%,41.07%,1
雲林縣,莿桐鄉,0387,368,100,468,42,510,900,56.67%,40.89%,1
雲林縣,莿桐鄉,0388,412,134,546,77,623,1040,59.9%,39.62%,1
雲林縣,莿桐鄉,0389,437,141,578,25,603,1165,51.76%,37.51%,1
雲林縣,莿桐鄉,0390,346,105,451,44,495,871,56.83%,39.72%,1
雲林縣,莿桐鄉,0391,400,102,502,38,540,885,61.02%,45.2%,1
雲林縣,莿桐鄉,0392,538,163,701,37,738,1489,49.56%,36.13%,1
雲林縣,莿桐鄉,0393,475,130,605,66,671,1347,49.81%,35.26%,1
雲林縣,莿桐鄉,0394,468,141,609,60,669,1150,58.17%,40.7%,1
雲林縣,莿桐鄉,0395,275,79,354,38,392,653,60.03%,42.11%,1
雲林縣,林內鄉,0396,482,125,607,50,657,1036,63.42%,46.53%,1
雲林縣,林內鄉,0397,613,190,803,37,840,1490,56.38%,41.14%,1
雲林縣,林內鄉,0398,558,181,739,64,803,1491,53.86%,37.42%,1
雲林縣,林內鄉,0399,273,58,331,27,358,671,53.35%,40.69%,1
雲林縣,林內鄉,0400,615,172,787,74,861,1436,59.96%,42.83%,1
雲林縣,林內鄉,0401,311,87,398,48,446,751,59.39%,41.41%,1
雲林縣,林內鄉,0402,223,65,288,13,301,535,56.26%,41.68%,1
雲林縣,林內鄉,0403,289,66,355,38,393,811,48.46%,35.64%,1
雲林縣,林內鄉,0404,557,170,727,44,771,1339,57.58%,41.6%,1
雲林縣,林內鄉,0405,501,152,653,58,711,1286,55.29%,38.96%,1
雲林縣,林內鄉,0406,253,72,325,34,359,646,55.57%,39.16%,1
雲林縣,林內鄉,0407,468,145,613,40,653,1158,56.39%,40.41%,1
雲林縣,林內鄉,0408,458,120,578,41,619,1090,56.79%,42.02%,1
雲林縣,林內鄉,0409,426,108,534,61,595,950,62.63%,44.84%,1
雲林縣,林內鄉,0410,323,140,463,29,492,861,57.14%,37.51%,1
雲林縣,二崙鄉,0317,495,164,659,28,687,1463,46.96%,33.83%,1
雲林縣,二崙鄉,0318,576,197,773,48,821,1738,47.24%,33.14%,1
雲林縣,二崙鄉,0319,204,63,267,36,303,625,48.48%,32.64%,1
雲林縣,二崙鄉,0320,353,110,463,45,508,1018,49.9%,34.68%,1
雲林縣,二崙鄉,0321,140,37,177,3,180,448,40.18%,31.25%,1
雲林縣,二崙鄉,0322,283,94,377,34,411,1048,39.22%,27%,1
雲林縣,二崙鄉,0323,428,146,574,63,637,1161,54.87%,36.86%,1
雲林縣,二崙鄉,0324,379,111,490,32,522,991,52.67%,38.24%,1
雲林縣,二崙鄉,0325,348,115,463,42,505,849,59.48%,40.99%,1
雲林縣,二崙鄉,0326,327,91,418,32,450,890,50.56%,36.74%,1
雲林縣,二崙鄉,0327,510,156,666,45,711,1427,49.82%,35.74%,1
雲林縣,二崙鄉,0328,356,94,450,24,474,891,53.2%,39.96%,1
雲林縣,二崙鄉,0329,232,77,309,21,330,757,43.59%,30.65%,1
雲林縣,二崙鄉,0330,532,136,668,66,734,1497,49.03%,35.54%,1
雲林縣,二崙鄉,0331,403,116,519,43,562,1171,47.99%,34.42%,1
雲林縣,二崙鄉,0332,292,85,377,33,410,686,59.77%,42.57%,1
雲林縣,二崙鄉,0333,271,57,328,59,387,864,44.79%,31.37%,1
雲林縣,二崙鄉,0334,406,147,553,63,616,1073,57.41%,37.84%,1
雲林縣,二崙鄉,0335,211,73,284,21,305,696,43.82%,30.32%,1
雲林縣,二崙鄉,0336,345,100,445,41,486,1271,38.24%,27.14%,1
雲林縣,二崙鄉,0337,313,72,385,24,409,912,44.85%,34.32%,1
雲林縣,二崙鄉,0338,266,98,364,35,399,861,46.34%,30.89%,1
雲林縣,二崙鄉,0339,328,97,425,36,461,1030,44.76%,31.84%,1
雲林縣,崙背鄉,0297,447,165,612,51,663,1176,56.38%,38.01%,1
雲林縣,崙背鄉,0298,523,157,680,50,730,1439,50.73%,36.34%,1
雲林縣,崙背鄉,0299,437,126,563,53,616,1027,59.98%,42.55%,1
雲林縣,崙背鄉,0300,522,155,677,37,714,1259,56.71%,41.46%,1
雲林縣,崙背鄉,0301,398,104,502,13,515,1058,48.68%,37.62%,1
雲林縣,崙背鄉,0302,366,85,451,20,471,998,47.19%,36.67%,1
雲林縣,崙背鄉,0303,368,93,461,23,484,968,50%,38.02%,1
雲林縣,崙背鄉,0304,380,136,516,41,557,1055,52.8%,36.02%,1
雲林縣,崙背鄉,0305,412,159,571,56,627,1315,47.68%,31.33%,1
雲林縣,崙背鄉,0306,246,77,323,26,349,1027,33.98%,23.95%,1
雲林縣,崙背鄉,0307,446,91,537,56,593,997,59.48%,44.73%,1
雲林縣,崙背鄉,0308,309,83,392,39,431,807,53.41%,38.29%,1
雲林縣,崙背鄉,0309,216,63,279,19,298,698,42.69%,30.95%,1
雲林縣,崙背鄉,0310,238,95,333,43,376,804,46.77%,29.6%,1
雲林縣,崙背鄉,0311,325,85,410,30,440,867,50.75%,37.49%,1
雲林縣,崙背鄉,0312,273,78,351,28,379,886,42.78%,30.81%,1
雲林縣,崙背鄉,0313,426,124,550,68,618,1476,41.87%,28.86%,1
雲林縣,崙背鄉,0314,310,70,380,29,409,1159,35.29%,26.75%,1
雲林縣,崙背鄉,0315,509,141,650,50,700,1220,57.38%,41.72%,1
雲林縣,崙背鄉,0316,294,103,397,28,425,814,52.21%,36.12%,1
雲林縣,麥寮鄉,0001,475,136,611,45,656,1497,43.82%,31.73%,1
雲林縣,麥寮鄉,0002,631,205,836,38,874,1738,50.29%,36.31%,1
雲林縣,麥寮鄉,0003,685,223,908,49,957,1921,49.82%,35.66%,1
雲林縣,麥寮鄉,0004,623,230,853,46,899,1832,49.07%,34.01%,1
雲林縣,麥寮鄉,0005,415,163,578,39,617,1340,46.04%,30.97%,1
雲林縣,麥寮鄉,0006,373,129,502,53,555,1138,48.77%,32.78%,1
雲林縣,麥寮鄉,0007,555,165,720,41,761,1551,49.07%,35.78%,1
雲林縣,麥寮鄉,0008,234,59,293,24,317,715,44.34%,32.73%,1
雲林縣,麥寮鄉,0009,375,114,489,37,526,1194,44.05%,31.41%,1
雲林縣,麥寮鄉,0010,359,94,453,36,489,1023,47.8%,35.09%,1
雲林縣,麥寮鄉,0011,441,135,576,32,608,1558,39.02%,28.31%,1
雲林縣,麥寮鄉,0012,343,122,465,25,490,1187,41.28%,28.9%,1
雲林縣,麥寮鄉,0013,301,105,406,16,422,983,42.93%,30.62%,1
雲林縣,麥寮鄉,0014,479,145,624,57,681,1363,49.96%,35.14%,1
雲林縣,麥寮鄉,0015,559,150,709,59,768,1596,48.12%,35.03%,1
雲林縣,麥寮鄉,0016,591,206,797,67,864,1469,58.82%,40.23%,1
雲林縣,麥寮鄉,0017,299,104,403,33,436,964,45.23%,31.02%,1
雲林縣,麥寮鄉,0018,325,102,427,27,454,1038,43.74%,31.31%,1
雲林縣,麥寮鄉,0019,451,129,580,42,622,1230,50.57%,36.67%,1
雲林縣,麥寮鄉,0020,483,131,614,31,645,1329,48.53%,36.34%,1
雲林縣,麥寮鄉,0021,452,121,573,34,607,1129,53.76%,40.04%,1
雲林縣,麥寮鄉,0022,491,161,652,49,701,1241,56.49%,39.56%,1
雲林縣,麥寮鄉,0023,585,159,744,54,798,1471,54.25%,39.77%,1
雲林縣,麥寮鄉,0024,459,122,581,55,636,1107,57.45%,41.46%,1
雲林縣,麥寮鄉,0025,663,188,851,56,907,1636,55.44%,40.53%,1
雲林縣,麥寮鄉,0026,614,193,807,53,860,1755,49%,34.99%,1
雲林縣,麥寮鄉,0027,454,142,596,34,630,1158,54.4%,39.21%,1
雲林縣,麥寮鄉,0028,370,122,492,28,520,956,54.39%,38.7%,1
雲林縣,東勢鄉,0051,370,127,497,46,543,1207,44.99%,30.65%,1
雲林縣,東勢鄉,0052,235,68,303,26,329,540,60.93%,43.52%,1
雲林縣,東勢鄉,0053,311,75,386,14,400,896,44.64%,34.71%,1
雲林縣,東勢鄉,0054,284,84,368,26,394,728,54.12%,39.01%,1
雲林縣,東勢鄉,0055,626,195,821,56,877,1533,57.21%,40.83%,1
雲林縣,東勢鄉,0056,541,144,685,34,719,1203,59.77%,44.97%,1
雲林縣,東勢鄉,0057,280,83,363,30,393,817,48.1%,34.27%,1
雲林縣,東勢鄉,0058,235,56,291,34,325,546,59.52%,43.04%,1
雲林縣,東勢鄉,0059,312,78,390,48,438,853,51.35%,36.58%,1
雲林縣,東勢鄉,0060,269,65,334,40,374,856,43.69%,31.43%,1
雲林縣,東勢鄉,0061,304,107,411,38,449,923,48.65%,32.94%,1
雲林縣,東勢鄉,0062,395,107,502,27,529,1022,51.76%,38.65%,1
雲林縣,東勢鄉,0063,182,46,228,14,242,634,38.17%,28.71%,1
雲林縣,東勢鄉,0064,127,34,161,17,178,394,45.18%,32.23%,1
雲林縣,東勢鄉,0065,309,95,404,35,439,1087,40.39%,28.43%,1
雲林縣,褒忠鄉,0066,371,112,483,37,520,923,56.34%,40.2%,1
雲林縣,褒忠鄉,0067,405,155,560,27,587,993,59.11%,40.79%,1
雲林縣,褒忠鄉,0068,263,96,359,37,396,748,52.94%,35.16%,1
雲林縣,褒忠鄉,0069,299,50,349,10,359,702,51.14%,42.59%,1
雲林縣,褒忠鄉,0070,290,79,369,20,389,752,51.73%,38.56%,1
雲林縣,褒忠鄉,0071,289,101,390,20,410,756,54.23%,38.23%,1
雲林縣,褒忠鄉,0072,188,54,242,12,254,490,51.84%,38.37%,1
雲林縣,褒忠鄉,0073,331,110,441,24,465,1034,44.97%,32.01%,1
雲林縣,褒忠鄉,0074,163,53,216,16,232,470,49.36%,34.68%,1
雲林縣,褒忠鄉,0075,235,118,353,21,374,737,50.75%,31.89%,1
雲林縣,褒忠鄉,0076,328,93,421,21,442,878,50.34%,37.36%,1
雲林縣,褒忠鄉,0077,256,100,356,34,390,778,50.13%,32.9%,1
雲林縣,褒忠鄉,0078,419,155,574,37,611,1224,49.92%,34.23%,1
雲林縣,褒忠鄉,0079,273,97,370,61,431,896,48.1%,30.47%,1
雲林縣,臺西鄉,0029,504,140,644,39,683,1238,55.17%,40.71%,1
雲林縣,臺西鄉,0030,382,98,480,39,519,1091,47.57%,35.01%,1
雲林縣,臺西鄉,0031,436,105,541,40,581,1098,52.91%,39.71%,1
雲林縣,臺西鄉,0032,331,101,432,19,451,1048,43.03%,31.58%,1
雲林縣,臺西鄉,0033,391,75,466,31,497,1025,48.49%,38.15%,1
雲林縣,臺西鄉,0034,318,82,400,33,433,850,50.94%,37.41%,1
雲林縣,臺西鄉,0035,476,119,595,50,645,1460,44.18%,32.6%,1
雲林縣,臺西鄉,0036,304,77,381,63,444,1180,37.63%,25.76%,1
雲林縣,臺西鄉,0037,180,44,224,15,239,710,33.66%,25.35%,1
雲林縣,臺西鄉,0038,209,50,259,13,272,620,43.87%,33.71%,1
雲林縣,臺西鄉,0039,145,51,196,19,215,449,47.88%,32.29%,1
雲林縣,臺西鄉,0040,194,66,260,23,283,687,41.19%,28.24%,1
雲林縣,臺西鄉,0041,407,105,512,48,560,1247,44.91%,32.64%,1
雲林縣,臺西鄉,0042,156,39,195,14,209,583,35.85%,26.76%,1
雲林縣,臺西鄉,0043,308,166,474,53,527,1042,50.58%,29.56%,1
雲林縣,臺西鄉,0044,155,50,205,15,220,472,46.61%,32.84%,1
雲林縣,臺西鄉,0045,486,107,593,15,608,1409,43.15%,34.49%,1
雲林縣,臺西鄉,0046,390,112,502,65,567,1061,53.44%,36.76%,1
雲林縣,臺西鄉,0047,328,89,417,16,433,993,43.61%,33.03%,1
雲林縣,臺西鄉,0048,338,82,420,73,493,1013,48.67%,33.37%,1
雲林縣,臺西鄉,0049,438,136,574,38,612,1233,49.64%,35.52%,1
雲林縣,臺西鄉,0050,186,59,245,19,264,616,42.86%,30.19%,1
雲林縣,元長鄉,0180,350,96,446,19,465,915,50.82%,38.25%,1
雲林縣,元長鄉,0181,456,142,598,21,619,1284,48.21%,35.51%,1
雲林縣,元長鄉,0182,398,109,507,38,545,1150,47.39%,34.61%,1
雲林縣,元長鄉,0183,236,74,310,30,340,744,45.7%,31.72%,1
雲林縣,元長鄉,0184,290,67,357,37,394,790,49.87%,36.71%,1
雲林縣,元長鄉,0185,394,106,500,63,563,1356,41.52%,29.06%,1
雲林縣,元長鄉,0186,251,77,328,31,359,739,48.58%,33.96%,1
雲林縣,元長鄉,0187,282,87,369,30,399,965,41.35%,29.22%,1
雲林縣,元長鄉,0188,327,88,415,49,464,1080,42.96%,30.28%,1
雲林縣,元長鄉,0189,274,78,352,35,387,948,40.82%,28.9%,1
雲林縣,元長鄉,0190,177,50,227,18,245,762,32.15%,23.23%,1
雲林縣,元長鄉,0191,194,62,256,14,270,582,46.39%,33.33%,1
雲林縣,元長鄉,0192,265,60,325,12,337,865,38.96%,30.64%,1
雲林縣,元長鄉,0193,67,17,84,4,88,362,24.31%,18.51%,1
雲林縣,元長鄉,0194,360,96,456,24,480,1162,41.31%,30.98%,1
雲林縣,元長鄉,0195,478,137,615,44,659,1527,43.16%,31.3%,1
雲林縣,元長鄉,0196,329,101,430,59,489,1006,48.61%,32.7%,1
雲林縣,元長鄉,0197,286,70,356,13,369,855,43.16%,33.45%,1
雲林縣,元長鄉,0198,409,104,513,46,559,1181,47.33%,34.63%,1
雲林縣,元長鄉,0199,264,72,336,24,360,864,41.67%,30.56%,1
雲林縣,元長鄉,0200,189,52,241,28,269,667,40.33%,28.34%,1
雲林縣,元長鄉,0201,255,84,339,18,357,878,40.66%,29.04%,1
雲林縣,元長鄉,0202,175,39,214,8,222,610,36.39%,28.69%,1
雲林縣,元長鄉,0203,285,79,364,40,404,837,48.27%,34.05%,1
雲林縣,元長鄉,0204,248,79,327,32,359,701,51.21%,35.38%,1
雲林縣,四湖鄉,0155,347,103,450,33,483,1082,44.64%,32.07%,1
雲林縣,四湖鄉,0156,274,62,336,39,375,676,55.47%,40.53%,1
雲林縣,四湖鄉,0157,331,88,419,15,434,862,50.35%,38.4%,1
雲林縣,四湖鄉,0158,142,41,183,10,193,477,40.46%,29.77%,1
雲林縣,四湖鄉,0159,387,132,519,23,542,952,56.93%,40.65%,1
雲林縣,四湖鄉,0160,182,51,233,15,248,650,38.15%,28%,1
雲林縣,四湖鄉,0161,328,83,411,20,431,969,44.48%,33.85%,1
雲林縣,四湖鄉,0162,249,84,333,43,376,925,40.65%,26.92%,1
雲林縣,四湖鄉,0163,300,85,385,16,401,914,43.87%,32.82%,1
雲林縣,四湖鄉,0164,151,57,208,37,245,759,32.28%,19.89%,1
雲林縣,四湖鄉,0165,334,95,429,47,476,1219,39.05%,27.4%,1
雲林縣,四湖鄉,0166,226,71,297,27,324,937,34.58%,24.12%,1
雲林縣,四湖鄉,0167,193,58,251,9,260,773,33.64%,24.97%,1
雲林縣,四湖鄉,0168,124,72,196,29,225,555,40.54%,22.34%,1
雲林縣,四湖鄉,0169,219,68,287,23,310,876,35.39%,25%,1
雲林縣,四湖鄉,0170,103,25,128,11,139,360,38.61%,28.61%,1
雲林縣,四湖鄉,0171,196,50,246,24,270,885,30.51%,22.15%,1
雲林縣,四湖鄉,0172,196,65,261,25,286,833,34.33%,23.53%,1
雲林縣,四湖鄉,0173,231,69,300,30,330,785,42.04%,29.43%,1
雲林縣,四湖鄉,0174,255,59,314,27,341,705,48.37%,36.17%,1
雲林縣,四湖鄉,0175,259,64,323,26,349,927,37.65%,27.94%,1
雲林縣,四湖鄉,0176,267,77,344,43,387,1058,36.58%,25.24%,1
雲林縣,四湖鄉,0177,290,81,371,37,408,1071,38.1%,27.08%,1
雲林縣,四湖鄉,0178,213,63,276,15,291,1022,28.47%,20.84%,1
雲林縣,四湖鄉,0179,218,62,280,32,312,711,43.88%,30.66%,1
雲林縣,口湖鄉,0205,409,133,542,43,585,1134,51.59%,36.07%,1
雲林縣,口湖鄉,0206,456,125,581,84,665,1225,54.29%,37.22%,1
雲林縣,口湖鄉,0207,203,44,247,31,278,647,42.97%,31.38%,1
雲林縣,口湖鄉,0208,259,80,339,22,361,709,50.92%,36.53%,1
雲林縣,口湖鄉,0209,285,86,371,63,434,900,48.22%,31.67%,1
雲林縣,口湖鄉,0210,348,109,457,53,510,1011,50.45%,34.42%,1
雲林縣,口湖鄉,0211,489,107,596,30,626,1437,43.56%,34.03%,1
雲林縣,口湖鄉,0212,217,63,280,13,293,848,34.55%,25.59%,1
雲林縣,口湖鄉,0213,374,102,476,18,494,1193,41.41%,31.35%,1
雲林縣,口湖鄉,0214,204,50,254,34,288,759,37.94%,26.88%,1
雲林縣,口湖鄉,0215,256,77,333,38,371,815,45.52%,31.41%,1
雲林縣,口湖鄉,0216,514,159,673,57,730,1460,50%,35.21%,1
雲林縣,口湖鄉,0217,134,49,183,10,193,556,34.71%,24.1%,1
雲林縣,口湖鄉,0218,626,37,663,54,717,1532,46.8%,40.86%,1
雲林縣,口湖鄉,0219,300,72,372,16,388,847,45.81%,35.42%,1
雲林縣,口湖鄉,0220,127,41,168,14,182,374,48.66%,33.96%,1
雲林縣,口湖鄉,0221,553,157,710,129,839,1508,55.64%,36.67%,1
雲林縣,口湖鄉,0222,395,79,474,60,534,951,56.15%,41.54%,1
雲林縣,口湖鄉,0223,368,99,467,59,526,910,57.8%,40.44%,1
雲林縣,口湖鄉,0224,384,100,484,34,518,879,58.93%,43.69%,1
雲林縣,口湖鄉,0225,431,91,522,79,601,1213,49.55%,35.53%,1
雲林縣,口湖鄉,0226,358,68,426,50,476,952,50%,37.61%,1
雲林縣,口湖鄉,0227,282,77,359,30,389,720,54.03%,39.17%,1
雲林縣,口湖鄉,0228,293,85,378,19,397,1006,39.46%,29.13%,1
雲林縣,口湖鄉,0229,197,33,230,11,241,607,39.7%,32.45%,1
雲林縣,水林鄉,0230,440,134,574,52,626,1355,46.2%,32.47%,1
雲林縣,水林鄉,0231,339,114,453,11,464,887,52.31%,38.22%,1
雲林縣,水林鄉,0232,497,127,624,47,671,1234,54.38%,40.28%,1
雲林縣,水林鄉,0233,271,89,360,17,377,763,49.41%,35.52%,1
雲林縣,水林鄉,0234,192,71,263,42,305,721,42.3%,26.63%,1
雲林縣,水林鄉,0235,186,40,226,21,247,647,38.18%,28.75%,1
雲林縣,水林鄉,0236,304,83,387,51,438,989,44.29%,30.74%,1
雲林縣,水林鄉,0237,251,66,317,20,337,837,40.26%,29.99%,1
雲林縣,水林鄉,0238,312,79,391,18,409,1081,37.84%,28.86%,1
雲林縣,水林鄉,0239,247,65,312,28,340,704,48.3%,35.09%,1
雲林縣,水林鄉,0240,354,86,440,58,498,1006,49.5%,35.19%,1
雲林縣,水林鄉,0241,213,47,260,6,266,651,40.86%,32.72%,1
雲林縣,水林鄉,0242,190,46,236,18,254,607,41.85%,31.3%,1
雲林縣,水林鄉,0243,295,89,384,53,437,1033,42.3%,28.56%,1
雲林縣,水林鄉,0244,147,42,189,16,205,631,32.49%,23.3%,1
雲林縣,水林鄉,0245,317,61,378,38,416,961,43.29%,32.99%,1
雲林縣,水林鄉,0246,281,83,364,60,424,951,44.58%,29.55%,1
雲林縣,水林鄉,0247,285,70,355,18,373,838,44.51%,34.01%,1
雲林縣,水林鄉,0248,356,76,432,71,503,1055,47.68%,33.74%,1
雲林縣,水林鄉,0249,133,31,164,16,180,512,35.16%,25.98%,1
雲林縣,水林鄉,0250,186,43,229,16,245,671,36.51%,27.72%,1
雲林縣,水林鄉,0251,148,38,186,36,222,693,32.03%,21.36%,1
雲林縣,水林鄉,0252,179,40,219,27,246,689,35.7%,25.98%,1
雲林縣,水林鄉,0253,353,98,451,47,498,1022,48.73%,34.54%,1
雲林縣,水林鄉,0254,386,84,470,30,500,1191,41.98%,32.41%,1
雲林縣,水林鄉,0255,313,70,383,37,420,779,53.92%,40.18%,1
嘉義縣,太保市,0001,470,169,639,41,680,1210,56.2%,38.84%,1
嘉義縣,太保市,0002,436,152,588,21,609,1076,56.6%,40.52%,1
嘉義縣,太保市,0003,174,55,229,23,252,488,51.64%,35.66%,1
嘉義縣,太保市,0004,549,158,707,44,751,1475,50.92%,37.22%,1
嘉義縣,太保市,0005,247,104,351,25,376,790,47.59%,31.27%,1
嘉義縣,太保市,0006,326,97,423,25,448,883,50.74%,36.92%,1
嘉義縣,太保市,0007,280,91,371,31,402,758,53.03%,36.94%,1
嘉義縣,太保市,0008,137,34,171,5,176,389,45.24%,35.22%,1
嘉義縣,太保市,0009,358,132,490,28,518,1101,47.05%,32.52%,1
嘉義縣,太保市,0010,378,102,480,12,492,853,57.68%,44.31%,1
嘉義縣,太保市,0011,51,31,82,10,92,224,41.07%,22.77%,1
嘉義縣,太保市,0012,228,68,296,32,328,662,49.55%,34.44%,1
嘉義縣,太保市,0013,713,231,944,25,969,1630,59.45%,43.74%,1
嘉義縣,太保市,0014,348,77,425,30,455,913,49.84%,38.12%,1
嘉義縣,太保市,0015,300,119,419,15,434,779,55.71%,38.51%,1
嘉義縣,太保市,0016,483,165,648,70,718,1278,56.18%,37.79%,1
嘉義縣,太保市,0017,295,74,369,36,405,819,49.45%,36.02%,1
嘉義縣,太保市,0018,589,201,790,22,812,1573,51.62%,37.44%,1
嘉義縣,太保市,0019,201,45,246,23,269,481,55.93%,41.79%,1
嘉義縣,太保市,0020,115,29,144,3,147,245,60%,46.94%,1
嘉義縣,太保市,0021,135,35,170,14,184,317,58.04%,42.59%,1
嘉義縣,太保市,0022,99,32,131,11,142,258,55.04%,38.37%,1
嘉義縣,太保市,0023,246,56,302,31,333,611,54.5%,40.26%,1
嘉義縣,太保市,0024,643,222,865,42,907,1526,59.44%,42.14%,1
嘉義縣,太保市,0025,489,179,668,14,682,1196,57.02%,40.89%,1
嘉義縣,太保市,0026,574,202,776,68,844,1536,54.95%,37.37%,1
嘉義縣,太保市,0027,581,193,774,53,827,1481,55.84%,39.23%,1
嘉義縣,太保市,0028,597,166,763,37,800,1450,55.17%,41.17%,1
嘉義縣,太保市,0029,349,104,453,14,467,840,55.6%,41.55%,1
嘉義縣,太保市,0030,415,152,567,14,581,989,58.75%,41.96%,1
嘉義縣,太保市,0031,628,180,808,43,851,1529,55.66%,41.07%,1
嘉義縣,太保市,0032,583,228,811,44,855,1511,56.59%,38.58%,1
嘉義縣,太保市,0033,249,75,324,27,351,697,50.36%,35.72%,1
嘉義縣,朴子市,0233,464,159,623,19,642,1183,54.27%,39.22%,1
嘉義縣,朴子市,0234,289,100,389,27,416,755,55.1%,38.28%,1
嘉義縣,朴子市,0235,502,151,653,29,682,1253,54.43%,40.06%,1
嘉義縣,朴子市,0236,440,180,620,32,652,1078,60.48%,40.82%,1
嘉義縣,朴子市,0237,473,180,653,32,685,1117,61.32%,42.35%,1
嘉義縣,朴子市,0238,166,58,224,8,232,387,59.95%,42.89%,1
嘉義縣,朴子市,0239,259,77,336,23,359,633,56.71%,40.92%,1
嘉義縣,朴子市,0240,317,38,355,15,370,650,56.92%,48.77%,1
嘉義縣,朴子市,0241,391,113,504,23,527,825,63.88%,47.39%,1
嘉義縣,朴子市,0242,323,106,429,24,453,810,55.93%,39.88%,1
嘉義縣,朴子市,0243,405,114,519,32,551,940,58.62%,43.09%,1
嘉義縣,朴子市,0244,363,103,466,27,493,905,54.48%,40.11%,1
嘉義縣,朴子市,0245,551,189,740,29,769,1605,47.91%,34.33%,1
嘉義縣,朴子市,0246,619,216,835,21,856,1479,57.88%,41.85%,1
嘉義縣,朴子市,0247,489,183,672,33,705,1218,57.88%,40.15%,1
嘉義縣,朴子市,0248,608,207,815,43,858,1496,57.35%,40.64%,1
嘉義縣,朴子市,0249,264,89,353,14,367,667,55.02%,39.58%,1
嘉義縣,朴子市,0250,194,51,245,11,256,627,40.83%,30.94%,1
嘉義縣,朴子市,0251,310,66,376,20,396,791,50.06%,39.19%,1
嘉義縣,朴子市,0252,406,107,513,60,573,1034,55.42%,39.26%,1
嘉義縣,朴子市,0253,582,246,828,19,847,1710,49.53%,34.04%,1
嘉義縣,朴子市,0254,610,189,799,39,838,1671,50.15%,36.51%,1
嘉義縣,朴子市,0255,520,163,683,27,710,1547,45.9%,33.61%,1
嘉義縣,朴子市,0256,477,150,627,39,666,1602,41.57%,29.78%,1
嘉義縣,朴子市,0257,563,163,726,14,740,1302,56.84%,43.24%,1
嘉義縣,朴子市,0258,282,74,356,25,381,740,51.49%,38.11%,1
嘉義縣,朴子市,0259,445,135,580,42,622,1054,59.01%,42.22%,1
嘉義縣,朴子市,0260,318,70,388,12,400,907,44.1%,35.06%,1
嘉義縣,朴子市,0261,229,65,294,23,317,720,44.03%,31.81%,1
嘉義縣,朴子市,0262,98,34,132,18,150,251,59.76%,39.04%,1
嘉義縣,朴子市,0263,255,54,309,34,343,767,44.72%,33.25%,1
嘉義縣,朴子市,0264,296,65,361,32,393,702,55.98%,42.17%,1
嘉義縣,朴子市,0265,380,85,465,39,504,1038,48.55%,36.61%,1
嘉義縣,朴子市,0266,336,99,435,23,458,1228,37.3%,27.36%,1
嘉義縣,朴子市,0267,196,34,230,27,257,499,51.5%,39.28%,1
嘉義縣,布袋鎮,0325,243,46,289,21,310,614,50.49%,39.58%,1
嘉義縣,布袋鎮,0326,129,33,162,9,171,372,45.97%,34.68%,1
嘉義縣,布袋鎮,0327,345,114,459,53,512,914,56.02%,37.75%,1
嘉義縣,布袋鎮,0328,474,129,603,45,648,1198,54.09%,39.57%,1
嘉義縣,布袋鎮,0329,416,79,495,33,528,1113,47.44%,37.38%,1
嘉義縣,布袋鎮,0330,386,108,494,41,535,992,53.93%,38.91%,1
嘉義縣,布袋鎮,0331,261,70,331,20,351,689,50.94%,37.88%,1
嘉義縣,布袋鎮,0332,325,90,415,52,467,882,52.95%,36.85%,1
嘉義縣,布袋鎮,0333,287,75,362,20,382,731,52.26%,39.26%,1
嘉義縣,布袋鎮,0334,313,96,409,21,430,779,55.2%,40.18%,1
嘉義縣,布袋鎮,0335,238,76,314,29,343,762,45.01%,31.23%,1
嘉義縣,布袋鎮,0336,387,104,491,48,539,1184,45.52%,32.69%,1
嘉義縣,布袋鎮,0337,423,109,532,48,580,1423,40.76%,29.73%,1
嘉義縣,布袋鎮,0338,393,121,514,52,566,1351,41.89%,29.09%,1
嘉義縣,布袋鎮,0339,103,21,124,6,130,275,47.27%,37.45%,1
嘉義縣,布袋鎮,0340,89,19,108,9,117,243,48.15%,36.63%,1
嘉義縣,布袋鎮,0341,269,52,321,42,363,661,54.92%,40.7%,1
嘉義縣,布袋鎮,0342,401,107,508,38,546,1145,47.69%,35.02%,1
嘉義縣,布袋鎮,0343,321,110,431,18,449,936,47.97%,34.29%,1
嘉義縣,布袋鎮,0344,314,112,426,26,452,958,47.18%,32.78%,1
嘉義縣,布袋鎮,0345,104,29,133,10,143,298,47.99%,34.9%,1
嘉義縣,布袋鎮,0346,173,49,222,32,254,428,59.35%,40.42%,1
嘉義縣,布袋鎮,0347,37,7,44,6,50,121,41.32%,30.58%,1
嘉義縣,布袋鎮,0348,38,9,47,5,52,174,29.89%,21.84%,1
嘉義縣,布袋鎮,0349,320,105,425,34,459,953,48.16%,33.58%,1
嘉義縣,布袋鎮,0350,504,138,642,52,694,1292,53.72%,39.01%,1
嘉義縣,布袋鎮,0351,456,108,564,44,608,1127,53.95%,40.46%,1
嘉義縣,布袋鎮,0352,456,125,581,17,598,1244,48.07%,36.66%,1
嘉義縣,布袋鎮,0353,407,114,521,17,538,1106,48.64%,36.8%,1
嘉義縣,大林鎮,0169,190,64,254,16,270,483,55.9%,39.34%,1
嘉義縣,大林鎮,0170,760,239,999,32,1031,1823,56.56%,41.69%,1
嘉義縣,大林鎮,0171,428,111,539,12,551,955,57.7%,44.82%,1
嘉義縣,大林鎮,0172,539,203,742,20,762,1436,53.06%,37.53%,1
嘉義縣,大林鎮,0173,540,95,635,44,679,1390,48.85%,38.85%,1
嘉義縣,大林鎮,0174,600,215,815,38,853,1512,56.42%,39.68%,1
嘉義縣,大林鎮,0175,601,242,843,31,874,1536,56.9%,39.13%,1
嘉義縣,大林鎮,0176,411,123,534,30,564,1165,48.41%,35.28%,1
嘉義縣,大林鎮,0177,721,264,985,41,1026,1730,59.31%,41.68%,1
嘉義縣,大林鎮,0178,215,52,267,6,273,602,45.35%,35.71%,1
嘉義縣,大林鎮,0179,245,75,320,39,359,716,50.14%,34.22%,1
嘉義縣,大林鎮,0180,224,44,268,12,280,625,44.8%,35.84%,1
嘉義縣,大林鎮,0181,49,20,69,5,74,193,38.34%,25.39%,1
嘉義縣,大林鎮,0182,578,144,722,48,770,1642,46.89%,35.2%,1
嘉義縣,大林鎮,0183,565,159,724,51,775,1465,52.9%,38.57%,1
嘉義縣,大林鎮,0184,311,80,391,26,417,928,44.94%,33.51%,1
嘉義縣,大林鎮,0185,114,27,141,18,159,361,44.04%,31.58%,1
嘉義縣,大林鎮,0186,329,76,405,21,426,814,52.33%,40.42%,1
嘉義縣,大林鎮,0187,576,169,745,29,774,1579,49.02%,36.48%,1
嘉義縣,大林鎮,0188,790,219,1009,55,1064,2041,52.13%,38.71%,1
嘉義縣,大林鎮,0189,351,96,447,33,480,931,51.56%,37.7%,1
嘉義縣,大林鎮,0190,248,83,331,29,360,675,53.33%,36.74%,1
嘉義縣,大林鎮,0191,267,62,329,16,345,655,52.67%,40.76%,1
嘉義縣,大林鎮,0192,310,79,389,26,415,833,49.82%,37.21%,1
嘉義縣,大林鎮,0193,367,104,471,29,500,832,60.1%,44.11%,1
嘉義縣,民雄鄉,0093,505,195,700,34,734,1267,57.93%,39.86%,1
嘉義縣,民雄鄉,0094,377,128,505,21,526,1030,51.07%,36.6%,1
嘉義縣,民雄鄉,0095,673,233,906,44,950,1590,59.75%,42.33%,1
嘉義縣,民雄鄉,0096,624,224,848,18,866,1673,51.76%,37.3%,1
嘉義縣,民雄鄉,0097,687,265,952,42,994,1718,57.86%,39.99%,1
嘉義縣,民雄鄉,0098,443,145,588,33,621,1040,59.71%,42.6%,1
嘉義縣,民雄鄉,0099,434,141,575,19,594,1100,54%,39.45%,1
嘉義縣,民雄鄉,0100,576,184,760,48,808,1559,51.83%,36.95%,1
嘉義縣,民雄鄉,0101,676,222,898,54,952,1862,51.13%,36.31%,1
嘉義縣,民雄鄉,0102,562,193,755,54,809,1435,56.38%,39.16%,1
嘉義縣,民雄鄉,0103,631,214,845,79,924,1751,52.77%,36.04%,1
嘉義縣,民雄鄉,0104,389,109,498,40,538,933,57.66%,41.69%,1
嘉義縣,民雄鄉,0105,371,112,483,34,517,827,62.52%,44.86%,1
嘉義縣,民雄鄉,0106,295,103,398,28,426,843,50.53%,34.99%,1
嘉義縣,民雄鄉,0107,672,222,894,43,937,1774,52.82%,37.88%,1
嘉義縣,民雄鄉,0108,130,42,172,11,183,385,47.53%,33.77%,1
嘉義縣,民雄鄉,0109,520,222,742,30,772,1306,59.11%,39.82%,1
嘉義縣,民雄鄉,0110,236,60,296,24,320,535,59.81%,44.11%,1
嘉義縣,民雄鄉,0111,449,122,571,50,621,1055,58.86%,42.56%,1
嘉義縣,民雄鄉,0112,611,162,773,37,810,1476,54.88%,41.4%,1
嘉義縣,民雄鄉,0113,608,163,771,27,798,1583,50.41%,38.41%,1
嘉義縣,民雄鄉,0114,276,77,353,19,372,758,49.08%,36.41%,1
嘉義縣,民雄鄉,0115,498,156,654,20,674,1354,49.78%,36.78%,1
嘉義縣,民雄鄉,0116,506,170,676,29,705,1202,58.65%,42.1%,1
嘉義縣,民雄鄉,0117,466,164,630,19,649,1175,55.23%,39.66%,1
嘉義縣,民雄鄉,0118,501,208,709,22,731,1423,51.37%,35.21%,1
嘉義縣,民雄鄉,0119,621,190,811,23,834,1612,51.74%,38.52%,1
嘉義縣,民雄鄉,0120,695,230,925,25,950,1695,56.05%,41%,1
嘉義縣,民雄鄉,0121,614,163,777,44,821,1665,49.31%,36.88%,1
嘉義縣,民雄鄉,0122,379,89,468,35,503,1019,49.36%,37.19%,1
嘉義縣,民雄鄉,0123,532,132,664,45,709,1352,52.44%,39.35%,1
嘉義縣,民雄鄉,0124,629,220,849,55,904,1620,55.8%,38.83%,1
嘉義縣,民雄鄉,0125,339,107,446,27,473,943,50.16%,35.95%,1
嘉義縣,民雄鄉,0126,590,172,762,41,803,1720,46.69%,34.3%,1
嘉義縣,民雄鄉,0127,729,176,905,61,966,1875,51.52%,38.88%,1
嘉義縣,民雄鄉,0128,517,171,688,44,732,1305,56.09%,39.62%,1
嘉義縣,民雄鄉,0129,534,179,713,39,752,1441,52.19%,37.06%,1
嘉義縣,民雄鄉,0130,576,197,773,23,796,1413,56.33%,40.76%,1
嘉義縣,民雄鄉,0131,614,183,797,39,836,1560,53.59%,39.36%,1
嘉義縣,民雄鄉,0132,806,257,1063,60,1123,2004,56.04%,40.22%,1
嘉義縣,民雄鄉,0133,568,187,755,53,808,1354,59.68%,41.95%,1
嘉義縣,民雄鄉,0134,445,130,575,22,597,1076,55.48%,41.36%,1
嘉義縣,民雄鄉,0135,687,184,871,59,930,1629,57.09%,42.17%,1
嘉義縣,民雄鄉,0136,755,218,973,42,1015,1977,51.34%,38.19%,1
嘉義縣,民雄鄉,0137,479,165,644,56,700,1295,54.05%,36.99%,1
嘉義縣,溪口鄉,0194,466,243,709,57,766,1318,58.12%,35.36%,1
嘉義縣,溪口鄉,0195,289,86,375,24,399,677,58.94%,42.69%,1
嘉義縣,溪口鄉,0196,180,31,211,13,224,417,53.72%,43.17%,1
嘉義縣,溪口鄉,0197,109,35,144,16,160,273,58.61%,39.93%,1
嘉義縣,溪口鄉,0198,392,95,487,46,533,908,58.7%,43.17%,1
嘉義縣,溪口鄉,0199,121,50,171,7,178,386,46.11%,31.35%,1
嘉義縣,溪口鄉,0200,415,131,546,29,575,1039,55.34%,39.94%,1
嘉義縣,溪口鄉,0201,241,65,306,27,333,708,47.03%,34.04%,1
嘉義縣,溪口鄉,0202,368,99,467,14,481,909,52.92%,40.48%,1
嘉義縣,溪口鄉,0203,312,94,406,28,434,786,55.22%,39.69%,1
嘉義縣,溪口鄉,0204,305,74,379,26,405,807,50.19%,37.79%,1
嘉義縣,溪口鄉,0205,406,101,507,15,522,1168,44.69%,34.76%,1
嘉義縣,溪口鄉,0206,416,126,542,52,594,1052,56.46%,39.54%,1
嘉義縣,溪口鄉,0207,202,55,257,28,285,565,50.44%,35.75%,1
嘉義縣,溪口鄉,0208,163,32,195,15,210,388,54.12%,42.01%,1
嘉義縣,溪口鄉,0209,246,55,301,22,323,701,46.08%,35.09%,1
嘉義縣,溪口鄉,0210,351,86,437,31,468,1003,46.66%,35%,1
嘉義縣,新港鄉,0138,450,138,588,14,602,1087,55.38%,41.4%,1
嘉義縣,新港鄉,0139,530,173,703,35,738,1116,66.13%,47.49%,1
嘉義縣,新港鄉,0140,310,81,391,22,413,740,55.81%,41.89%,1
嘉義縣,新港鄉,0141,305,96,401,39,440,827,53.2%,36.88%,1
嘉義縣,新港鄉,0142,325,91,416,23,439,704,62.36%,46.16%,1
嘉義縣,新港鄉,0143,337,115,452,29,481,768,62.63%,43.88%,1
嘉義縣,新港鄉,0144,319,110,429,31,460,761,60.45%,41.92%,1
嘉義縣,新港鄉,0145,322,100,422,35,457,850,53.76%,37.88%,1
嘉義縣,新港鄉,0146,510,153,663,49,712,1327,53.65%,38.43%,1
嘉義縣,新港鄉,0147,293,88,381,42,423,756,55.95%,38.76%,1
嘉義縣,新港鄉,0148,339,84,423,45,468,816,57.35%,41.54%,1
嘉義縣,新港鄉,0149,256,78,334,20,354,667,53.07%,38.38%,1
嘉義縣,新港鄉,0150,398,98,496,23,519,942,55.1%,42.25%,1
嘉義縣,新港鄉,0151,317,81,398,46,444,918,48.37%,34.53%,1
嘉義縣,新港鄉,0152,224,48,272,12,284,554,51.26%,40.43%,1
嘉義縣,新港鄉,0153,338,96,434,30,464,929,49.95%,36.38%,1
嘉義縣,新港鄉,0154,136,53,189,18,207,487,42.51%,27.93%,1
嘉義縣,新港鄉,0155,199,46,245,25,270,487,55.44%,40.86%,1
嘉義縣,新港鄉,0156,302,111,413,29,442,836,52.87%,36.12%,1
嘉義縣,新港鄉,0157,314,132,446,36,482,845,57.04%,37.16%,1
嘉義縣,新港鄉,0158,330,107,437,30,467,834,56%,39.57%,1
嘉義縣,新港鄉,0159,301,95,396,29,425,753,56.44%,39.97%,1
嘉義縣,新港鄉,0160,495,167,662,43,705,1328,53.09%,37.27%,1
嘉義縣,新港鄉,0161,417,120,537,22,559,969,57.69%,43.03%,1
嘉義縣,新港鄉,0162,450,141,591,33,624,1043,59.83%,43.14%,1
嘉義縣,新港鄉,0163,641,173,814,45,859,1400,61.36%,45.79%,1
嘉義縣,新港鄉,0164,311,70,381,22,403,1017,39.63%,30.58%,1
嘉義縣,新港鄉,0165,406,118,524,32,556,1132,49.12%,35.87%,1
嘉義縣,新港鄉,0166,395,103,498,46,544,1037,52.46%,38.09%,1
嘉義縣,新港鄉,0167,255,54,309,24,333,563,59.15%,45.29%,1
嘉義縣,新港鄉,0168,348,92,440,13,453,849,53.36%,40.99%,1
嘉義縣,六腳鄉,0268,412,96,508,22,530,1165,45.49%,35.36%,1
嘉義縣,六腳鄉,0269,235,52,287,18,305,825,36.97%,28.48%,1
嘉義縣,六腳鄉,0270,284,83,367,21,388,850,45.65%,33.41%,1
嘉義縣,六腳鄉,0271,89,28,117,15,132,222,59.46%,40.09%,1
嘉義縣,六腳鄉,0272,451,123,574,33,607,1216,49.92%,37.09%,1
嘉義縣,六腳鄉,0273,361,88,449,34,483,1200,40.25%,30.08%,1
嘉義縣,六腳鄉,0274,302,77,379,42,421,877,48%,34.44%,1
嘉義縣,六腳鄉,0275,199,58,257,21,278,644,43.17%,30.9%,1
嘉義縣,六腳鄉,0276,192,27,219,14,233,594,39.23%,32.32%,1
嘉義縣,六腳鄉,0277,40,9,49,1,50,167,29.94%,23.95%,1
嘉義縣,六腳鄉,0278,51,20,71,3,74,204,36.27%,25%,1
嘉義縣,六腳鄉,0279,64,26,90,5,95,234,40.6%,27.35%,1
嘉義縣,六腳鄉,0280,113,29,142,3,145,361,40.17%,31.3%,1
嘉義縣,六腳鄉,0281,234,62,296,40,336,592,56.76%,39.53%,1
嘉義縣,六腳鄉,0282,210,78,288,30,318,619,51.37%,33.93%,1
嘉義縣,六腳鄉,0283,223,49,272,20,292,714,40.9%,31.23%,1
嘉義縣,六腳鄉,0284,406,95,501,33,534,1051,50.81%,38.63%,1
嘉義縣,六腳鄉,0285,374,95,469,18,487,934,52.14%,40.04%,1
嘉義縣,六腳鄉,0286,386,111,497,23,520,1044,49.81%,36.97%,1
嘉義縣,六腳鄉,0287,507,138,645,23,668,1476,45.26%,34.35%,1
嘉義縣,六腳鄉,0288,179,44,223,10,233,618,37.7%,28.96%,1
嘉義縣,六腳鄉,0289,132,16,148,14,162,478,33.89%,27.62%,1
嘉義縣,六腳鄉,0290,173,41,214,21,235,642,36.6%,26.95%,1
嘉義縣,六腳鄉,0291,224,70,294,11,305,883,34.54%,25.37%,1
嘉義縣,六腳鄉,0292,227,33,260,4,264,739,35.72%,30.72%,1
嘉義縣,六腳鄉,0293,159,47,206,13,219,554,39.53%,28.7%,1
嘉義縣,六腳鄉,0294,167,48,215,15,230,649,35.44%,25.73%,1
嘉義縣,六腳鄉,0295,197,52,249,25,274,689,39.77%,28.59%,1
嘉義縣,六腳鄉,0296,133,34,167,13,180,455,39.56%,29.23%,1
嘉義縣,六腳鄉,0297,31,6,37,1,38,125,30.4%,24.8%,1
嘉義縣,東石鄉,0298,721,164,885,55,940,1915,49.09%,37.65%,1
嘉義縣,東石鄉,0299,264,80,344,37,381,938,40.62%,28.14%,1
嘉義縣,東石鄉,0300,321,92,413,19,432,1366,31.63%,23.5%,1
嘉義縣,東石鄉,0301,551,122,673,12,685,1676,40.87%,32.88%,1
嘉義縣,東石鄉,0302,342,94,436,46,482,1151,41.88%,29.71%,1
嘉義縣,東石鄉,0303,242,58,300,23,323,716,45.11%,33.8%,1
嘉義縣,東石鄉,0304,130,20,150,7,157,387,40.57%,33.59%,1
嘉義縣,東石鄉,0305,218,48,266,10,276,864,31.94%,25.23%,1
嘉義縣,東石鄉,0306,238,68,306,10,316,910,34.73%,26.15%,1
嘉義縣,東石鄉,0307,224,63,287,12,299,760,39.34%,29.47%,1
嘉義縣,東石鄉,0308,73,11,84,5,89,166,53.61%,43.98%,1
嘉義縣,東石鄉,0309,65,9,74,6,80,212,37.74%,30.66%,1
嘉義縣,東石鄉,0310,256,55,311,38,349,993,35.15%,25.78%,1
嘉義縣,東石鄉,0311,97,20,117,9,126,306,41.18%,31.7%,1
嘉義縣,東石鄉,0312,307,64,371,40,411,1046,39.29%,29.35%,1
嘉義縣,東石鄉,0313,68,10,78,12,90,235,38.3%,28.94%,1
嘉義縣,東石鄉,0314,414,103,517,39,556,1226,45.35%,33.77%,1
嘉義縣,東石鄉,0315,254,74,328,37,365,843,43.3%,30.13%,1
嘉義縣,東石鄉,0316,219,57,276,24,300,693,43.29%,31.6%,1
嘉義縣,東石鄉,0317,316,62,378,34,412,839,49.11%,37.66%,1
嘉義縣,東石鄉,0318,126,23,149,10,159,363,43.8%,34.71%,1
嘉義縣,東石鄉,0319,92,17,109,7,116,321,36.14%,28.66%,1
嘉義縣,東石鄉,0320,449,92,541,55,596,1083,55.03%,41.46%,1
嘉義縣,東石鄉,0321,302,93,395,28,423,901,46.95%,33.52%,1
嘉義縣,東石鄉,0322,351,66,417,34,451,1216,37.09%,28.87%,1
嘉義縣,東石鄉,0323,182,45,227,25,252,418,60.29%,43.54%,1
嘉義縣,東石鄉,0324,118,30,148,12,160,371,43.13%,31.81%,1
嘉義縣,義竹鄉,0354,171,46,217,15,232,482,48.13%,35.48%,1
嘉義縣,義竹鄉,0355,99,24,123,11,134,223,60.09%,44.39%,1
嘉義縣,義竹鄉,0356,484,296,780,60,840,1529,54.94%,31.65%,1
嘉義縣,義竹鄉,0357,489,140,629,36,665,1175,56.6%,41.62%,1
嘉義縣,義竹鄉,0358,399,117,516,36,552,886,62.3%,45.03%,1
嘉義縣,義竹鄉,0359,250,71,321,16,337,743,45.36%,33.65%,1
嘉義縣,義竹鄉,0360,476,143,619,63,682,1236,55.18%,38.51%,1
嘉義縣,義竹鄉,0361,137,45,182,12,194,377,51.46%,36.34%,1
嘉義縣,義竹鄉,0362,114,29,143,13,156,338,46.15%,33.73%,1
嘉義縣,義竹鄉,0363,50,7,57,3,60,102,58.82%,49.02%,1
嘉義縣,義竹鄉,0364,273,75,348,19,367,763,48.1%,35.78%,1
嘉義縣,義竹鄉,0365,177,55,232,20,252,429,58.74%,41.26%,1
嘉義縣,義竹鄉,0366,157,36,193,21,214,427,50.12%,36.77%,1
嘉義縣,義竹鄉,0367,243,67,310,26,336,607,55.35%,40.03%,1
嘉義縣,義竹鄉,0368,511,144,655,40,695,1486,46.77%,34.39%,1
嘉義縣,義竹鄉,0369,362,89,451,33,484,835,57.96%,43.35%,1
嘉義縣,義竹鄉,0370,258,65,323,32,355,816,43.5%,31.62%,1
嘉義縣,義竹鄉,0371,248,97,345,41,386,833,46.34%,29.77%,1
嘉義縣,義竹鄉,0372,170,37,207,7,214,433,49.42%,39.26%,1
嘉義縣,義竹鄉,0373,193,50,243,5,248,558,44.44%,34.59%,1
嘉義縣,義竹鄉,0374,225,67,292,25,317,602,52.66%,37.38%,1
嘉義縣,義竹鄉,0375,51,8,59,1,60,140,42.86%,36.43%,1
嘉義縣,義竹鄉,0376,137,35,172,14,186,393,47.33%,34.86%,1
嘉義縣,義竹鄉,0377,231,50,281,12,293,585,50.09%,39.49%,1
嘉義縣,義竹鄉,0378,171,30,201,3,204,526,38.78%,32.51%,1
嘉義縣,義竹鄉,0379,61,14,75,1,76,123,61.79%,49.59%,1
嘉義縣,鹿草鄉,0034,153,59,212,32,244,522,46.74%,29.31%,1
嘉義縣,鹿草鄉,0035,197,78,275,29,304,563,54%,34.99%,1
嘉義縣,鹿草鄉,0036,448,154,602,46,648,1304,49.69%,34.36%,1
嘉義縣,鹿草鄉,0037,445,174,619,42,661,1312,50.38%,33.92%,1
嘉義縣,鹿草鄉,0038,113,34,147,3,150,320,46.88%,35.31%,1
嘉義縣,鹿草鄉,0039,82,25,107,3,110,418,26.32%,19.62%,1
嘉義縣,鹿草鄉,0040,324,80,404,47,451,1025,44%,31.61%,1
嘉義縣,鹿草鄉,0041,140,42,182,13,195,451,43.24%,31.04%,1
嘉義縣,鹿草鄉,0042,348,62,410,38,448,830,53.98%,41.93%,1
嘉義縣,鹿草鄉,0043,353,111,464,35,499,1050,47.52%,33.62%,1
嘉義縣,鹿草鄉,0044,262,95,357,42,399,972,41.05%,26.95%,1
嘉義縣,鹿草鄉,0045,317,98,415,30,445,962,46.26%,32.95%,1
嘉義縣,鹿草鄉,0046,225,86,311,38,349,678,51.47%,33.19%,1
嘉義縣,鹿草鄉,0047,114,16,130,8,138,262,52.67%,43.51%,1
嘉義縣,鹿草鄉,0048,278,98,376,22,398,906,43.93%,30.68%,1
嘉義縣,鹿草鄉,0049,77,26,103,7,110,306,35.95%,25.16%,1
嘉義縣,鹿草鄉,0050,395,119,514,40,554,1062,52.17%,37.19%,1
嘉義縣,鹿草鄉,0051,149,44,193,14,207,373,55.5%,39.95%,1
嘉義縣,鹿草鄉,0052,117,43,160,15,175,324,54.01%,36.11%,1
嘉義縣,鹿草鄉,0053,116,19,135,14,149,297,50.17%,39.06%,1
嘉義縣,水上鄉,0054,391,112,503,17,520,1024,50.78%,38.18%,1
嘉義縣,水上鄉,0055,432,148,580,35,615,1015,60.59%,42.56%,1
嘉義縣,水上鄉,0056,689,230,919,31,950,1932,49.17%,35.66%,1
嘉義縣,水上鄉,0057,488,176,664,25,689,1170,58.89%,41.71%,1
嘉義縣,水上鄉,0058,564,160,724,42,766,1305,58.7%,43.22%,1
嘉義縣,水上鄉,0059,439,150,589,31,620,1242,49.92%,35.35%,1
嘉義縣,水上鄉,0060,122,35,157,10,167,324,51.54%,37.65%,1
嘉義縣,水上鄉,0061,243,68,311,20,331,622,53.22%,39.07%,1
嘉義縣,水上鄉,0062,447,152,599,44,643,1216,52.88%,36.76%,1
嘉義縣,水上鄉,0063,424,122,546,18,564,1020,55.29%,41.57%,1
嘉義縣,水上鄉,0064,351,110,461,21,482,771,62.52%,45.53%,1
嘉義縣,水上鄉,0065,197,67,264,15,279,441,63.27%,44.67%,1
嘉義縣,水上鄉,0066,313,86,399,21,420,626,67.09%,50%,1
嘉義縣,水上鄉,0067,257,80,337,8,345,570,60.53%,45.09%,1
嘉義縣,水上鄉,0068,147,35,182,11,193,368,52.45%,39.95%,1
嘉義縣,水上鄉,0069,385,96,481,59,540,1037,52.07%,37.13%,1
嘉義縣,水上鄉,0070,424,134,558,24,582,1065,54.65%,39.81%,1
嘉義縣,水上鄉,0071,357,117,474,38,512,802,63.84%,44.51%,1
嘉義縣,水上鄉,0072,772,231,1003,44,1047,1948,53.75%,39.63%,1
嘉義縣,水上鄉,0073,398,103,501,32,533,1028,51.85%,38.72%,1
嘉義縣,水上鄉,0074,272,85,357,18,375,641,58.5%,42.43%,1
嘉義縣,水上鄉,0075,183,52,235,10,245,408,60.05%,44.85%,1
嘉義縣,水上鄉,0076,325,102,427,32,459,794,57.81%,40.93%,1
嘉義縣,水上鄉,0077,189,64,253,19,272,569,47.8%,33.22%,1
嘉義縣,水上鄉,0078,340,91,431,23,454,806,56.33%,42.18%,1
嘉義縣,水上鄉,0079,418,117,535,25,560,960,58.33%,43.54%,1
嘉義縣,水上鄉,0080,827,254,1081,33,1114,2035,54.74%,40.64%,1
嘉義縣,水上鄉,0081,795,229,1024,56,1080,1987,54.35%,40.01%,1
嘉義縣,水上鄉,0082,485,140,625,25,650,1154,56.33%,42.03%,1
嘉義縣,水上鄉,0083,808,146,954,36,990,2208,44.84%,36.59%,1
嘉義縣,水上鄉,0084,730,189,919,29,948,2102,45.1%,34.73%,1
嘉義縣,水上鄉,0085,517,124,641,32,673,1309,51.41%,39.5%,1
嘉義縣,水上鄉,0086,660,223,883,26,909,1671,54.4%,39.5%,1
嘉義縣,水上鄉,0087,333,92,425,25,450,822,54.74%,40.51%,1
嘉義縣,水上鄉,0088,725,171,896,29,925,1772,52.2%,40.91%,1
嘉義縣,水上鄉,0089,774,209,983,45,1028,1919,53.57%,40.33%,1
嘉義縣,水上鄉,0090,356,83,439,19,458,912,50.22%,39.04%,1
嘉義縣,水上鄉,0091,417,91,508,13,521,992,52.52%,42.04%,1
嘉義縣,水上鄉,0092,406,124,530,42,572,1270,45.04%,31.97%,1
嘉義縣,中埔鄉,0380,326,99,425,18,443,1046,42.35%,31.17%,1
嘉義縣,中埔鄉,0381,609,179,788,43,831,1788,46.48%,34.06%,1
嘉義縣,中埔鄉,0382,590,188,778,30,808,1730,46.71%,34.1%,1
嘉義縣,中埔鄉,0383,552,193,745,33,778,1581,49.21%,34.91%,1
嘉義縣,中埔鄉,0384,494,162,656,24,680,1594,42.66%,30.99%,1
嘉義縣,中埔鄉,0385,667,236,903,19,922,1801,51.19%,37.03%,1
嘉義縣,中埔鄉,0386,693,208,901,27,928,1862,49.84%,37.22%,1
嘉義縣,中埔鄉,0387,640,192,832,18,850,1803,47.14%,35.5%,1
嘉義縣,中埔鄉,0388,557,165,722,29,751,1481,50.71%,37.61%,1
嘉義縣,中埔鄉,0389,539,157,696,34,730,1366,53.44%,39.46%,1
嘉義縣,中埔鄉,0390,521,163,684,36,720,1599,45.03%,32.58%,1
嘉義縣,中埔鄉,0391,466,125,591,28,619,1196,51.76%,38.96%,1
嘉義縣,中埔鄉,0392,589,181,770,60,830,1809,45.88%,32.56%,1
嘉義縣,中埔鄉,0393,348,110,458,18,476,953,49.95%,36.52%,1
嘉義縣,中埔鄉,0394,484,142,626,42,668,1441,46.36%,33.59%,1
嘉義縣,中埔鄉,0395,657,171,828,43,871,1882,46.28%,34.91%,1
嘉義縣,中埔鄉,0396,552,141,693,12,705,1470,47.96%,37.55%,1
嘉義縣,中埔鄉,0397,548,156,704,53,757,1699,44.56%,32.25%,1
嘉義縣,中埔鄉,0398,125,38,163,14,177,422,41.94%,29.62%,1
嘉義縣,中埔鄉,0399,388,96,484,34,518,1030,50.29%,37.67%,1
嘉義縣,中埔鄉,0400,326,98,424,18,442,879,50.28%,37.09%,1
嘉義縣,中埔鄉,0401,279,72,351,17,368,828,44.44%,33.7%,1
嘉義縣,中埔鄉,0402,385,95,480,23,503,881,57.09%,43.7%,1
嘉義縣,中埔鄉,0403,104,34,138,10,148,296,50%,35.14%,1
嘉義縣,中埔鄉,0404,345,109,454,25,479,979,48.93%,35.24%,1
嘉義縣,中埔鄉,0405,429,121,550,30,580,1268,45.74%,33.83%,1
嘉義縣,中埔鄉,0406,173,49,222,7,229,670,34.18%,25.82%,1
嘉義縣,中埔鄉,0407,296,91,387,44,431,754,57.16%,39.26%,1
嘉義縣,中埔鄉,0408,240,87,327,32,359,648,55.4%,37.04%,1
嘉義縣,中埔鄉,0409,213,72,285,18,303,741,40.89%,28.74%,1
嘉義縣,中埔鄉,0410,180,53,233,7,240,518,46.33%,34.75%,1
嘉義縣,中埔鄉,0411,154,56,210,34,244,482,50.62%,31.95%,1
嘉義縣,中埔鄉,0412,118,33,151,7,158,348,45.4%,33.91%,1
嘉義縣,中埔鄉,0413,109,25,134,12,146,294,49.66%,37.07%,1
嘉義縣,竹崎鄉,0414,521,188,709,27,736,1312,56.1%,39.71%,1
嘉義縣,竹崎鄉,0415,524,148,672,26,698,1210,57.69%,43.31%,1
嘉義縣,竹崎鄉,0416,423,100,523,32,555,991,56%,42.68%,1
嘉義縣,竹崎鄉,0417,506,123,629,24,653,1207,54.1%,41.92%,1
嘉義縣,竹崎鄉,0418,253,105,358,15,373,752,49.6%,33.64%,1
嘉義縣,竹崎鄉,0419,364,95,459,33,492,833,59.06%,43.7%,1
嘉義縣,竹崎鄉,0420,527,131,658,35,693,1220,56.8%,43.2%,1
嘉義縣,竹崎鄉,0421,291,76,367,16,383,616,62.18%,47.24%,1
嘉義縣,竹崎鄉,0422,398,90,488,43,531,1031,51.5%,38.6%,1
嘉義縣,竹崎鄉,0423,519,126,645,26,671,1292,51.93%,40.17%,1
嘉義縣,竹崎鄉,0424,802,244,1046,56,1102,1995,55.24%,40.2%,1
嘉義縣,竹崎鄉,0425,709,208,917,31,948,1996,47.49%,35.52%,1
嘉義縣,竹崎鄉,0426,546,181,727,37,764,1449,52.73%,37.68%,1
嘉義縣,竹崎鄉,0427,578,149,727,43,770,1420,54.23%,40.7%,1
嘉義縣,竹崎鄉,0428,671,165,836,46,882,1590,55.47%,42.2%,1
嘉義縣,竹崎鄉,0429,295,77,372,21,393,771,50.97%,38.26%,1
嘉義縣,竹崎鄉,0430,331,119,450,30,480,1014,47.34%,32.64%,1
嘉義縣,竹崎鄉,0431,106,24,130,5,135,327,41.28%,32.42%,1
嘉義縣,竹崎鄉,0432,282,60,342,24,366,687,53.28%,41.05%,1
嘉義縣,竹崎鄉,0433,241,67,308,21,329,641,51.33%,37.6%,1
嘉義縣,竹崎鄉,0434,207,51,258,9,267,474,56.33%,43.67%,1
嘉義縣,竹崎鄉,0435,137,44,181,14,195,383,50.91%,35.77%,1
嘉義縣,竹崎鄉,0436,271,79,350,29,379,619,61.23%,43.78%,1
嘉義縣,竹崎鄉,0437,70,20,90,9,99,214,46.26%,32.71%,1
嘉義縣,竹崎鄉,0438,598,178,776,52,828,1568,52.81%,38.14%,1
嘉義縣,竹崎鄉,0439,247,48,295,19,314,658,47.72%,37.54%,1
嘉義縣,竹崎鄉,0440,193,49,242,15,257,434,59.22%,44.47%,1
嘉義縣,竹崎鄉,0441,375,100,475,36,511,917,55.73%,40.89%,1
嘉義縣,竹崎鄉,0442,335,77,412,37,449,981,45.77%,34.15%,1
嘉義縣,竹崎鄉,0443,297,60,357,13,370,789,46.89%,37.64%,1
嘉義縣,竹崎鄉,0444,22,6,28,4,32,108,29.63%,20.37%,1
嘉義縣,竹崎鄉,0445,62,13,75,1,76,235,32.34%,26.38%,1
嘉義縣,竹崎鄉,0446,100,34,134,8,142,331,42.9%,30.21%,1
嘉義縣,竹崎鄉,0447,196,77,273,11,284,450,63.11%,43.56%,1
嘉義縣,竹崎鄉,0448,154,27,181,12,193,462,41.77%,33.33%,1
嘉義縣,竹崎鄉,0449,91,8,99,8,107,251,42.63%,36.25%,1
嘉義縣,梅山鄉,0211,393,145,538,28,566,1041,54.37%,37.75%,1
嘉義縣,梅山鄉,0212,539,143,682,74,756,1245,60.72%,43.29%,1
嘉義縣,梅山鄉,0213,405,138,543,36,579,917,63.14%,44.17%,1
嘉義縣,梅山鄉,0214,496,148,644,51,695,1189,58.45%,41.72%,1
嘉義縣,梅山鄉,0215,541,171,712,47,759,1388,54.68%,38.98%,1
嘉義縣,梅山鄉,0216,708,232,940,61,1001,1827,54.79%,38.75%,1
嘉義縣,梅山鄉,0217,231,84,315,28,343,545,62.94%,42.39%,1
嘉義縣,梅山鄉,0218,123,40,163,20,183,407,44.96%,30.22%,1
嘉義縣,梅山鄉,0219,275,67,342,28,370,636,58.18%,43.24%,1
嘉義縣,梅山鄉,0220,240,66,306,34,340,576,59.03%,41.67%,1
嘉義縣,梅山鄉,0221,698,175,873,63,936,1674,55.91%,41.7%,1
嘉義縣,梅山鄉,0222,317,70,387,9,396,858,46.15%,36.95%,1
嘉義縣,梅山鄉,0223,234,81,315,17,332,526,63.12%,44.49%,1
嘉義縣,梅山鄉,0224,111,41,152,32,184,372,49.46%,29.84%,1
嘉義縣,梅山鄉,0225,173,53,226,29,255,506,50.4%,34.19%,1
嘉義縣,梅山鄉,0226,251,33,284,21,305,433,70.44%,57.97%,1
嘉義縣,梅山鄉,0227,129,26,155,13,168,404,41.58%,31.93%,1
嘉義縣,梅山鄉,0228,105,32,137,9,146,293,49.83%,35.84%,1
嘉義縣,梅山鄉,0229,323,101,424,23,447,712,62.78%,45.37%,1
嘉義縣,梅山鄉,0230,288,60,348,26,374,602,62.13%,47.84%,1
嘉義縣,梅山鄉,0231,183,52,235,17,252,515,48.93%,35.53%,1
嘉義縣,梅山鄉,0232,129,30,159,5,164,417,39.33%,30.94%,1
嘉義縣,番路鄉,0450,494,163,657,55,712,1174,60.65%,42.08%,1
嘉義縣,番路鄉,0451,216,55,271,12,283,449,63.03%,48.11%,1
嘉義縣,番路鄉,0452,346,93,439,23,462,753,61.35%,45.95%,1
嘉義縣,番路鄉,0453,199,47,246,17,263,551,47.73%,36.12%,1
嘉義縣,番路鄉,0454,717,240,957,49,1006,1791,56.17%,40.03%,1
嘉義縣,番路鄉,0455,393,112,505,33,538,849,63.37%,46.29%,1
嘉義縣,番路鄉,0456,377,105,482,22,504,866,58.2%,43.53%,1
嘉義縣,番路鄉,0457,351,67,418,22,440,800,55%,43.88%,1
嘉義縣,番路鄉,0458,176,57,233,23,256,444,57.66%,39.64%,1
嘉義縣,番路鄉,0459,212,42,254,10,264,635,41.57%,33.39%,1
嘉義縣,番路鄉,0460,113,27,140,9,149,319,46.71%,35.42%,1
嘉義縣,番路鄉,0461,313,45,358,19,377,642,58.72%,48.75%,1
嘉義縣,番路鄉,0462,189,27,216,15,231,509,45.38%,37.13%,1
嘉義縣,番路鄉,0463,87,9,96,0,96,162,59.26%,53.7%,1
嘉義縣,番路鄉,0464,98,16,114,6,120,212,56.6%,46.23%,1
嘉義縣,大埔鄉,0465,552,204,756,51,807,1468,54.97%,37.6%,1
嘉義縣,大埔鄉,0466,101,19,120,6,126,320,39.38%,31.56%,1
嘉義縣,大埔鄉,0467,120,49,169,6,175,304,57.57%,39.47%,1
嘉義縣,大埔鄉,0468,76,13,89,4,93,184,50.54%,41.3%,1
嘉義縣,大埔鄉,0469,114,38,152,5,157,234,67.09%,48.72%,1
嘉義縣,大埔鄉,0470,186,67,253,13,266,495,53.74%,37.58%,1
嘉義縣,大埔鄉,0471,86,20,106,5,111,199,55.78%,43.22%,1
嘉義縣,大埔鄉,0472,83,26,109,6,115,226,50.88%,36.73%,1
嘉義縣,大埔鄉,0473,267,65,332,18,350,569,61.51%,46.92%,1
嘉義縣,阿里山鄉,0474,148,31,179,5,184,371,49.6%,39.89%,1
嘉義縣,阿里山鄉,0475,67,13,80,5,85,197,43.15%,34.01%,1
嘉義縣,阿里山鄉,0476,58,12,70,4,74,152,48.68%,38.16%,1
嘉義縣,阿里山鄉,0477,59,18,77,3,80,231,34.63%,25.54%,1
嘉義縣,阿里山鄉,0478,20,0,20,1,21,72,29.17%,27.78%,1
嘉義縣,阿里山鄉,0479,101,24,125,2,127,311,40.84%,32.48%,1
嘉義縣,阿里山鄉,0480,138,18,156,8,164,306,53.59%,45.1%,1
嘉義縣,阿里山鄉,0481,341,86,427,15,442,970,45.57%,35.15%,1
嘉義縣,阿里山鄉,0482,342,83,425,29,454,827,54.9%,41.35%,1
嘉義縣,阿里山鄉,0483,108,20,128,4,132,238,55.46%,45.38%,1
嘉義縣,阿里山鄉,0484,151,20,171,6,177,479,36.95%,31.52%,1
嘉義縣,阿里山鄉,0485,103,24,127,8,135,291,46.39%,35.4%,1
嘉義縣,阿里山鄉,0486,131,22,153,7,160,246,65.04%,53.25%,1
屏東縣,屏東市,0001,82,42,124,4,128,237,54.01%,34.6%,1
屏東縣,屏東市,0002,114,41,155,11,166,294,56.46%,38.78%,1
屏東縣,屏東市,0003,201,109,310,7,317,582,54.47%,34.54%,1
屏東縣,屏東市,0004,289,111,400,18,418,713,58.63%,40.53%,1
屏東縣,屏東市,0005,208,92,300,19,319,572,55.77%,36.36%,1
屏東縣,屏東市,0006,200,72,272,10,282,455,61.98%,43.96%,1
屏東縣,屏東市,0007,99,49,148,0,148,249,59.44%,39.76%,1
屏東縣,屏東市,0008,478,155,633,24,657,1315,49.96%,36.35%,1
屏東縣,屏東市,0009,443,199,642,28,670,1373,48.8%,32.27%,1
屏東縣,屏東市,0010,285,127,412,23,435,713,61.01%,39.97%,1
屏東縣,屏東市,0011,245,95,340,29,369,573,64.4%,42.76%,1
屏東縣,屏東市,0012,138,49,187,16,203,297,68.35%,46.46%,1
屏東縣,屏東市,0013,210,58,268,13,281,409,68.7%,51.34%,1
屏東縣,屏東市,0014,104,45,149,11,160,286,55.94%,36.36%,1
屏東縣,屏東市,0015,187,66,253,5,258,421,61.28%,44.42%,1
屏東縣,屏東市,0016,232,91,323,7,330,569,58%,40.77%,1
屏東縣,屏東市,0017,143,94,237,12,249,459,54.25%,31.15%,1
屏東縣,屏東市,0018,288,131,419,13,432,672,64.29%,42.86%,1
屏東縣,屏東市,0019,266,134,400,23,423,668,63.32%,39.82%,1
屏東縣,屏東市,0020,189,64,253,4,257,411,62.53%,45.99%,1
屏東縣,屏東市,0021,320,105,425,17,442,768,57.55%,41.67%,1
屏東縣,屏東市,0022,309,106,415,22,437,786,55.6%,39.31%,1
屏東縣,屏東市,0023,389,120,509,20,529,890,59.44%,43.71%,1
屏東縣,屏東市,0024,548,183,731,31,762,1353,56.32%,40.5%,1
屏東縣,屏東市,0025,538,192,730,10,740,1386,53.39%,38.82%,1
屏東縣,屏東市,0026,524,217,741,21,762,1413,53.93%,37.08%,1
屏東縣,屏東市,0027,514,156,670,22,692,1272,54.4%,40.41%,1
屏東縣,屏東市,0028,482,213,695,12,707,1287,54.93%,37.45%,1
屏東縣,屏東市,0029,521,216,737,27,764,1311,58.28%,39.74%,1
屏東縣,屏東市,0030,529,200,729,12,741,1285,57.67%,41.17%,1
屏東縣,屏東市,0031,513,203,716,25,741,1297,57.13%,39.55%,1
屏東縣,屏東市,0032,528,205,733,14,747,1361,54.89%,38.8%,1
屏東縣,屏東市,0033,498,187,685,27,712,1381,51.56%,36.06%,1
屏東縣,屏東市,0034,521,195,716,31,747,1258,59.38%,41.41%,1
屏東縣,屏東市,0035,502,195,697,22,719,1259,57.11%,39.87%,1
屏東縣,屏東市,0036,438,145,583,13,596,1076,55.39%,40.71%,1
屏東縣,屏東市,0037,478,191,669,11,680,1162,58.52%,41.14%,1
屏東縣,屏東市,0038,532,204,736,22,758,1318,57.51%,40.36%,1
屏東縣,屏東市,0039,363,138,501,23,524,939,55.8%,38.66%,1
屏東縣,屏東市,0040,389,157,546,17,563,972,57.92%,40.02%,1
屏東縣,屏東市,0041,584,249,833,36,869,1535,56.61%,38.05%,1
屏東縣,屏東市,0042,503,171,674,19,693,1419,48.84%,35.45%,1
屏東縣,屏東市,0043,522,155,677,17,694,1398,49.64%,37.34%,1
屏東縣,屏東市,0044,543,185,728,28,756,1405,53.81%,38.65%,1
屏東縣,屏東市,0045,590,202,792,27,819,1486,55.11%,39.7%,1
屏東縣,屏東市,0046,415,147,562,31,593,1061,55.89%,39.11%,1
屏東縣,屏東市,0047,521,181,702,54,756,1540,49.09%,33.83%,1
屏東縣,屏東市,0048,424,157,581,21,602,1141,52.76%,37.16%,1
屏東縣,屏東市,0049,421,183,604,22,626,1247,50.2%,33.76%,1
屏東縣,屏東市,0050,505,203,708,27,735,1446,50.83%,34.92%,1
屏東縣,屏東市,0051,532,180,712,32,744,1303,57.1%,40.83%,1
屏東縣,屏東市,0052,512,153,665,24,689,1253,54.99%,40.86%,1
屏東縣,屏東市,0053,316,372,688,28,716,1315,54.45%,24.03%,1
屏東縣,屏東市,0054,504,198,702,24,726,1425,50.95%,35.37%,1
屏東縣,屏東市,0055,531,187,718,16,734,1423,51.58%,37.32%,1
屏東縣,屏東市,0056,560,184,744,38,782,1400,55.86%,40%,1
屏東縣,屏東市,0057,540,217,757,31,788,1359,57.98%,39.74%,1
屏東縣,屏東市,0058,543,150,693,25,718,1328,54.07%,40.89%,1
屏東縣,屏東市,0059,627,167,794,23,817,1539,53.09%,40.74%,1
屏東縣,屏東市,0060,100,40,140,3,143,391,36.57%,25.58%,1
屏東縣,屏東市,0061,82,26,108,9,117,200,58.5%,41%,1
屏東縣,屏東市,0062,112,35,147,21,168,328,51.22%,34.15%,1
屏東縣,屏東市,0063,95,23,118,3,121,231,52.38%,41.13%,1
屏東縣,屏東市,0064,376,118,494,31,525,945,55.56%,39.79%,1
屏東縣,屏東市,0065,374,152,526,40,566,1053,53.75%,35.52%,1
屏東縣,屏東市,0066,387,124,511,33,544,1043,52.16%,37.1%,1
屏東縣,屏東市,0067,391,122,513,45,558,1061,52.59%,36.85%,1
屏東縣,屏東市,0068,326,114,440,20,460,876,52.51%,37.21%,1
屏東縣,屏東市,0069,543,171,714,53,767,1468,52.25%,36.99%,1
屏東縣,屏東市,0070,524,176,700,27,727,1454,50%,36.04%,1
屏東縣,屏東市,0071,473,181,654,25,679,1205,56.35%,39.25%,1
屏東縣,屏東市,0072,468,176,644,25,669,1284,52.1%,36.45%,1
屏東縣,屏東市,0073,445,147,592,25,617,1219,50.62%,36.51%,1
屏東縣,屏東市,0074,618,210,828,50,878,1544,56.87%,40.03%,1
屏東縣,屏東市,0075,572,189,761,49,810,1485,54.55%,38.52%,1
屏東縣,屏東市,0076,564,167,731,39,770,1387,55.52%,40.66%,1
屏東縣,屏東市,0077,323,106,429,18,447,953,46.9%,33.89%,1
屏東縣,屏東市,0078,704,169,873,29,902,1603,56.27%,43.92%,1
屏東縣,屏東市,0079,207,80,287,12,299,535,55.89%,38.69%,1
屏東縣,屏東市,0080,432,145,577,27,604,1119,53.98%,38.61%,1
屏東縣,屏東市,0081,353,95,448,28,476,847,56.2%,41.68%,1
屏東縣,屏東市,0082,356,141,497,56,553,923,59.91%,38.57%,1
屏東縣,屏東市,0083,449,156,605,30,635,1227,51.75%,36.59%,1
屏東縣,屏東市,0084,414,126,540,37,577,1039,55.53%,39.85%,1
屏東縣,屏東市,0085,549,194,743,52,795,1485,53.54%,36.97%,1
屏東縣,屏東市,0086,332,105,437,38,475,867,54.79%,38.29%,1
屏東縣,屏東市,0087,387,112,499,21,520,918,56.64%,42.16%,1
屏東縣,屏東市,0088,259,67,326,20,346,663,52.19%,39.06%,1
屏東縣,屏東市,0089,421,146,567,19,586,1215,48.23%,34.65%,1
屏東縣,屏東市,0090,564,199,763,42,805,1628,49.45%,34.64%,1
屏東縣,屏東市,0091,460,199,659,27,686,1209,56.74%,38.05%,1
屏東縣,屏東市,0092,494,202,696,15,711,1110,64.05%,44.5%,1
屏東縣,屏東市,0093,265,66,331,6,337,684,49.27%,38.74%,1
屏東縣,屏東市,0094,444,150,594,28,622,1349,46.11%,32.91%,1
屏東縣,屏東市,0095,551,149,700,35,735,1457,50.45%,37.82%,1
屏東縣,屏東市,0096,564,208,772,24,796,1447,55.01%,38.98%,1
屏東縣,屏東市,0097,474,197,671,18,689,1354,50.89%,35.01%,1
屏東縣,屏東市,0098,634,221,855,38,893,1583,56.41%,40.05%,1
屏東縣,屏東市,0099,627,207,834,13,847,1707,49.62%,36.73%,1
屏東縣,屏東市,0100,599,181,780,26,806,1637,49.24%,36.59%,1
屏東縣,屏東市,0101,552,161,713,7,720,1459,49.35%,37.83%,1
屏東縣,屏東市,0102,708,223,931,19,950,1759,54.01%,40.25%,1
屏東縣,屏東市,0103,719,261,980,26,1006,1950,51.59%,36.87%,1
屏東縣,屏東市,0104,673,226,899,21,920,1729,53.21%,38.92%,1
屏東縣,屏東市,0105,650,163,813,17,830,1592,52.14%,40.83%,1
屏東縣,屏東市,0106,523,181,704,27,731,1437,50.87%,36.4%,1
屏東縣,屏東市,0107,479,125,604,23,627,1204,52.08%,39.78%,1
屏東縣,屏東市,0108,454,151,605,29,634,1340,47.31%,33.88%,1
屏東縣,屏東市,0109,522,171,693,26,719,1322,54.39%,39.49%,1
屏東縣,屏東市,0110,543,166,709,33,742,1462,50.75%,37.14%,1
屏東縣,屏東市,0111,1175,383,1558,42,1600,3241,49.37%,36.25%,1
屏東縣,屏東市,0112,543,172,715,14,729,1477,49.36%,36.76%,1
屏東縣,屏東市,0113,302,94,396,10,406,821,49.45%,36.78%,1
屏東縣,屏東市,0114,369,112,481,13,494,1099,44.95%,33.58%,1
屏東縣,屏東市,0115,648,172,820,36,856,1688,50.71%,38.39%,1
屏東縣,屏東市,0116,397,168,565,36,601,1167,51.5%,34.02%,1
屏東縣,屏東市,0117,344,121,465,27,492,915,53.77%,37.6%,1
屏東縣,屏東市,0118,394,132,526,16,542,1683,32.2%,23.41%,1
屏東縣,屏東市,0119,533,219,752,12,764,1497,51.04%,35.6%,1
屏東縣,屏東市,0120,431,142,573,25,598,1129,52.97%,38.18%,1
屏東縣,屏東市,0121,505,144,649,19,668,1232,54.22%,40.99%,1
屏東縣,屏東市,0122,358,98,456,14,470,853,55.1%,41.97%,1
屏東縣,屏東市,0123,369,130,499,10,509,869,58.57%,42.46%,1
屏東縣,屏東市,0124,473,166,639,31,670,1169,57.31%,40.46%,1
屏東縣,屏東市,0125,445,134,579,17,596,1058,56.33%,42.06%,1
屏東縣,屏東市,0126,474,180,654,20,674,1344,50.15%,35.27%,1
屏東縣,屏東市,0127,505,157,662,18,680,1299,52.35%,38.88%,1
屏東縣,屏東市,0128,463,153,616,45,661,1204,54.9%,38.46%,1
屏東縣,屏東市,0129,422,162,584,15,599,1123,53.34%,37.58%,1
屏東縣,屏東市,0130,455,163,618,20,638,1318,48.41%,34.52%,1
屏東縣,屏東市,0131,361,125,486,35,521,865,60.23%,41.73%,1
屏東縣,屏東市,0132,386,116,502,28,530,1100,48.18%,35.09%,1
屏東縣,屏東市,0133,433,159,592,18,610,1215,50.21%,35.64%,1
屏東縣,屏東市,0134,534,177,711,18,729,1370,53.21%,38.98%,1
屏東縣,屏東市,0135,498,152,650,10,660,1240,53.23%,40.16%,1
屏東縣,屏東市,0136,446,195,641,24,665,1168,56.93%,38.18%,1
屏東縣,屏東市,0137,434,146,580,14,594,1079,55.05%,40.22%,1
屏東縣,屏東市,0138,533,177,710,36,746,1289,57.87%,41.35%,1
屏東縣,屏東市,0139,411,167,578,20,598,1115,53.63%,36.86%,1
屏東縣,屏東市,0140,575,241,816,27,843,1491,56.54%,38.56%,1
屏東縣,屏東市,0141,491,174,665,24,689,1411,48.83%,34.8%,1
屏東縣,屏東市,0142,632,266,898,22,920,1803,51.03%,35.05%,1
屏東縣,屏東市,0143,304,107,411,16,427,744,57.39%,40.86%,1
屏東縣,屏東市,0144,256,105,361,11,372,678,54.87%,37.76%,1
屏東縣,屏東市,0145,283,107,390,18,408,681,59.91%,41.56%,1
屏東縣,屏東市,0146,715,0,715,20,735,1535,47.88%,46.58%,1
屏東縣,屏東市,0147,432,73,505,39,544,954,57.02%,45.28%,1
屏東縣,屏東市,0148,427,159,586,26,612,1018,60.12%,41.94%,1
屏東縣,屏東市,0149,444,196,640,17,657,1154,56.93%,38.47%,1
屏東縣,潮州鎮,0150,215,69,284,21,305,504,60.52%,42.66%,1
屏東縣,潮州鎮,0151,582,214,796,24,820,1711,47.93%,34.02%,1
屏東縣,潮州鎮,0152,617,205,822,22,844,1634,51.65%,37.76%,1
屏東縣,潮州鎮,0153,506,138,644,33,677,1414,47.88%,35.79%,1
屏東縣,潮州鎮,0154,267,92,359,21,380,603,63.02%,44.28%,1
屏東縣,潮州鎮,0155,345,107,452,37,489,896,54.58%,38.5%,1
屏東縣,潮州鎮,0156,506,149,655,23,678,1285,52.76%,39.38%,1
屏東縣,潮州鎮,0157,251,195,446,25,471,1744,27.01%,14.39%,1
屏東縣,潮州鎮,0158,464,136,600,19,619,1071,57.8%,43.32%,1
屏東縣,潮州鎮,0159,507,134,641,42,683,1209,56.49%,41.94%,1
屏東縣,潮州鎮,0160,436,161,597,26,623,1159,53.75%,37.62%,1
屏東縣,潮州鎮,0161,475,162,637,32,669,1296,51.62%,36.65%,1
屏東縣,潮州鎮,0162,588,201,789,33,822,1466,56.07%,40.11%,1
屏東縣,潮州鎮,0163,472,156,628,28,656,1130,58.05%,41.77%,1
屏東縣,潮州鎮,0164,568,182,750,32,782,1439,54.34%,39.47%,1
屏東縣,潮州鎮,0165,405,97,502,25,527,897,58.75%,45.15%,1
屏東縣,潮州鎮,0166,546,139,685,17,702,1225,57.31%,44.57%,1
屏東縣,潮州鎮,0167,425,119,544,41,585,1158,50.52%,36.7%,1
屏東縣,潮州鎮,0168,149,40,189,30,219,481,45.53%,30.98%,1
屏東縣,潮州鎮,0169,388,138,526,27,553,972,56.89%,39.92%,1
屏東縣,潮州鎮,0170,547,167,714,24,738,1245,59.28%,43.94%,1
屏東縣,潮州鎮,0171,554,156,710,47,757,1415,53.5%,39.15%,1
屏東縣,潮州鎮,0172,427,154,581,19,600,1255,47.81%,34.02%,1
屏東縣,潮州鎮,0173,339,137,476,20,496,1058,46.88%,32.04%,1
屏東縣,潮州鎮,0174,459,131,590,26,616,1187,51.9%,38.67%,1
屏東縣,潮州鎮,0175,451,126,577,37,614,1083,56.69%,41.64%,1
屏東縣,潮州鎮,0176,563,184,747,35,782,1590,49.18%,35.41%,1
屏東縣,潮州鎮,0177,630,179,809,43,852,1543,55.22%,40.83%,1
屏東縣,潮州鎮,0178,592,188,780,34,814,1631,49.91%,36.3%,1
屏東縣,潮州鎮,0179,486,124,610,21,631,1159,54.44%,41.93%,1
屏東縣,潮州鎮,0180,449,144,593,30,623,1099,56.69%,40.86%,1
屏東縣,潮州鎮,0181,451,108,559,34,593,1200,49.42%,37.58%,1
屏東縣,潮州鎮,0182,554,118,672,32,704,1391,50.61%,39.83%,1
屏東縣,潮州鎮,0183,390,93,483,38,521,881,59.14%,44.27%,1
屏東縣,潮州鎮,0184,175,39,214,15,229,454,50.44%,38.55%,1
屏東縣,潮州鎮,0185,667,203,870,40,910,1658,54.89%,40.23%,1
屏東縣,潮州鎮,0186,311,86,397,26,423,822,51.46%,37.83%,1
屏東縣,潮州鎮,0187,316,107,423,15,438,948,46.2%,33.33%,1
屏東縣,潮州鎮,0188,369,104,473,34,507,1194,42.46%,30.9%,1
屏東縣,潮州鎮,0189,146,31,177,14,191,337,56.68%,43.32%,1
屏東縣,東港鎮,0190,442,118,560,30,590,981,60.14%,45.06%,1
屏東縣,東港鎮,0191,459,145,604,38,642,1070,60%,42.9%,1
屏東縣,東港鎮,0192,269,59,328,22,350,527,66.41%,51.04%,1
屏東縣,東港鎮,0193,172,51,223,23,246,395,62.28%,43.54%,1
屏東縣,東港鎮,0194,234,77,311,27,338,659,51.29%,35.51%,1
屏東縣,東港鎮,0195,202,65,267,21,288,513,56.14%,39.38%,1
屏東縣,東港鎮,0196,645,210,855,37,892,1732,51.5%,37.24%,1
屏東縣,東港鎮,0197,690,232,922,32,954,1779,53.63%,38.79%,1
屏東縣,東港鎮,0198,517,101,618,23,641,1270,50.47%,40.71%,1
屏東縣,東港鎮,0199,510,188,698,6,704,1327,53.05%,38.43%,1
屏東縣,東港鎮,0200,502,162,664,33,697,1242,56.12%,40.42%,1
屏東縣,東港鎮,0201,649,204,853,37,890,1607,55.38%,40.39%,1
屏東縣,東港鎮,0202,460,157,617,33,650,1305,49.81%,35.25%,1
屏東縣,東港鎮,0203,265,106,371,20,391,695,56.26%,38.13%,1
屏東縣,東港鎮,0204,485,147,632,28,660,1076,61.34%,45.07%,1
屏東縣,東港鎮,0205,211,64,275,17,292,567,51.5%,37.21%,1
屏東縣,東港鎮,0206,322,95,417,22,439,806,54.47%,39.95%,1
屏東縣,東港鎮,0207,505,148,653,35,688,1227,56.07%,41.16%,1
屏東縣,東港鎮,0208,241,53,294,33,327,599,54.59%,40.23%,1
屏東縣,東港鎮,0209,428,113,541,37,578,1354,42.69%,31.61%,1
屏東縣,東港鎮,0210,276,81,357,34,391,734,53.27%,37.6%,1
屏東縣,東港鎮,0211,445,133,578,57,635,1107,57.36%,40.2%,1
屏東縣,東港鎮,0212,431,108,539,60,599,1198,50%,35.98%,1
屏東縣,東港鎮,0213,567,191,758,66,824,1614,51.05%,35.13%,1
屏東縣,東港鎮,0214,310,94,404,22,426,826,51.57%,37.53%,1
屏東縣,東港鎮,0215,375,116,491,30,521,912,57.13%,41.12%,1
屏東縣,東港鎮,0216,162,46,208,20,228,432,52.78%,37.5%,1
屏東縣,東港鎮,0217,489,134,623,64,687,1204,57.06%,40.61%,1
屏東縣,東港鎮,0218,519,155,674,43,717,1304,54.98%,39.8%,1
屏東縣,東港鎮,0219,555,165,720,31,751,1317,57.02%,42.14%,1
屏東縣,東港鎮,0220,517,170,687,23,710,1387,51.19%,37.27%,1
屏東縣,東港鎮,0221,458,140,598,17,615,1310,46.95%,34.96%,1
屏東縣,東港鎮,0222,420,149,569,42,611,1228,49.76%,34.2%,1
屏東縣,東港鎮,0223,257,83,340,33,373,766,48.69%,33.55%,1
屏東縣,東港鎮,0224,324,118,442,29,471,823,57.23%,39.37%,1
屏東縣,東港鎮,0225,245,56,301,17,318,755,42.12%,32.45%,1
屏東縣,東港鎮,0226,443,149,592,39,631,1094,57.68%,40.49%,1
屏東縣,東港鎮,0227,277,80,357,16,373,753,49.54%,36.79%,1
屏東縣,恆春鎮,0228,352,81,433,17,450,902,49.89%,39.02%,1
屏東縣,恆春鎮,0229,382,139,521,32,553,969,57.07%,39.42%,1
屏東縣,恆春鎮,0230,426,169,595,39,634,1280,49.53%,33.28%,1
屏東縣,恆春鎮,0231,426,145,571,42,613,1133,54.1%,37.6%,1
屏東縣,恆春鎮,0232,489,166,655,9,664,1552,42.78%,31.51%,1
屏東縣,恆春鎮,0233,442,145,587,38,625,1485,42.09%,29.76%,1
屏東縣,恆春鎮,0234,339,115,454,27,481,896,53.68%,37.83%,1
屏東縣,恆春鎮,0235,179,53,232,20,252,531,47.46%,33.71%,1
屏東縣,恆春鎮,0236,164,54,218,7,225,478,47.07%,34.31%,1
屏東縣,恆春鎮,0237,335,118,453,36,489,1020,47.94%,32.84%,1
屏東縣,恆春鎮,0238,309,127,436,20,456,924,49.35%,33.44%,1
屏東縣,恆春鎮,0239,333,110,443,27,470,1079,43.56%,30.86%,1
屏東縣,恆春鎮,0240,250,57,307,21,328,775,42.32%,32.26%,1
屏東縣,恆春鎮,0241,317,88,405,38,443,813,54.49%,38.99%,1
屏東縣,恆春鎮,0242,379,117,496,34,530,1104,48.01%,34.33%,1
屏東縣,恆春鎮,0243,351,106,457,41,498,1110,44.86%,31.62%,1
屏東縣,恆春鎮,0244,181,72,253,44,297,692,42.92%,26.16%,1
屏東縣,恆春鎮,0245,182,54,236,11,247,708,34.89%,25.71%,1
屏東縣,恆春鎮,0246,511,187,698,28,726,1505,48.24%,33.95%,1
屏東縣,恆春鎮,0247,396,103,499,24,523,1111,47.07%,35.64%,1
屏東縣,恆春鎮,0248,518,163,681,33,714,1543,46.27%,33.57%,1
屏東縣,恆春鎮,0249,238,89,327,15,342,828,41.3%,28.74%,1
屏東縣,恆春鎮,0250,313,105,418,25,443,844,52.49%,37.09%,1
屏東縣,恆春鎮,0251,411,160,571,39,610,1253,48.68%,32.8%,1
屏東縣,恆春鎮,0252,380,104,484,29,513,1126,45.56%,33.75%,1
屏東縣,萬丹鄉,0253,489,154,643,42,685,1527,44.86%,32.02%,1
屏東縣,萬丹鄉,0254,402,122,524,50,574,1147,50.04%,35.05%,1
屏東縣,萬丹鄉,0255,333,104,437,34,471,949,49.63%,35.09%,1
屏東縣,萬丹鄉,0256,344,115,459,25,484,990,48.89%,34.75%,1
屏東縣,萬丹鄉,0257,381,103,484,18,502,1022,49.12%,37.28%,1
屏東縣,萬丹鄉,0258,264,79,343,28,371,545,68.07%,48.44%,1
屏東縣,萬丹鄉,0259,515,135,650,43,693,1159,59.79%,44.43%,1
屏東縣,萬丹鄉,0260,354,109,463,43,506,837,60.45%,42.29%,1
屏東縣,萬丹鄉,0261,144,38,182,18,200,392,51.02%,36.73%,1
屏東縣,萬丹鄉,0262,355,111,466,24,490,847,57.85%,41.91%,1
屏東縣,萬丹鄉,0263,446,125,571,25,596,1149,51.87%,38.82%,1
屏東縣,萬丹鄉,0264,442,144,586,30,616,1131,54.47%,39.08%,1
屏東縣,萬丹鄉,0265,437,134,571,39,610,1178,51.78%,37.1%,1
屏東縣,萬丹鄉,0266,317,97,414,15,429,711,60.34%,44.59%,1
屏東縣,萬丹鄉,0267,269,93,362,19,381,595,64.03%,45.21%,1
屏東縣,萬丹鄉,0268,590,181,771,40,811,1403,57.8%,42.05%,1
屏東縣,萬丹鄉,0269,435,117,552,19,571,1094,52.19%,39.76%,1
屏東縣,萬丹鄉,0270,474,134,608,55,663,1158,57.25%,40.93%,1
屏東縣,萬丹鄉,0271,432,128,560,42,602,963,62.51%,44.86%,1
屏東縣,萬丹鄉,0272,422,136,558,34,592,1062,55.74%,39.74%,1
屏東縣,萬丹鄉,0273,629,215,844,45,889,1684,52.79%,37.35%,1
屏東縣,萬丹鄉,0274,620,199,819,41,860,1702,50.53%,36.43%,1
屏東縣,萬丹鄉,0275,438,130,568,15,583,976,59.73%,44.88%,1
屏東縣,萬丹鄉,0276,381,111,492,66,558,1013,55.08%,37.61%,1
屏東縣,萬丹鄉,0277,278,83,361,26,387,847,45.69%,32.82%,1
屏東縣,萬丹鄉,0278,614,221,835,77,912,1570,58.09%,39.11%,1
屏東縣,萬丹鄉,0279,507,148,655,46,701,1411,49.68%,35.93%,1
屏東縣,萬丹鄉,0280,414,140,554,55,609,1046,58.22%,39.58%,1
屏東縣,萬丹鄉,0281,700,171,871,35,906,1385,65.42%,50.54%,1
屏東縣,萬丹鄉,0282,329,88,417,32,449,804,55.85%,40.92%,1
屏東縣,萬丹鄉,0283,492,166,658,50,708,1284,55.14%,38.32%,1
屏東縣,萬丹鄉,0284,514,156,670,37,707,1430,49.44%,35.94%,1
屏東縣,萬丹鄉,0285,445,131,576,29,605,960,63.02%,46.35%,1
屏東縣,萬丹鄉,0286,350,95,445,38,483,786,61.45%,44.53%,1
屏東縣,萬丹鄉,0287,440,150,590,58,648,1158,55.96%,38%,1
屏東縣,萬丹鄉,0288,493,183,676,42,718,1647,43.59%,29.93%,1
屏東縣,萬丹鄉,0289,565,173,738,42,780,1666,46.82%,33.91%,1
屏東縣,萬丹鄉,0290,461,123,584,43,627,1023,61.29%,45.06%,1
屏東縣,萬丹鄉,0291,525,160,685,33,718,1227,58.52%,42.79%,1
屏東縣,長治鄉,0292,421,108,529,40,569,1018,55.89%,41.36%,1
屏東縣,長治鄉,0293,623,200,823,60,883,1614,54.71%,38.6%,1
屏東縣,長治鄉,0294,756,270,1026,34,1060,1848,57.36%,40.91%,1
屏東縣,長治鄉,0295,648,213,861,60,921,1707,53.95%,37.96%,1
屏東縣,長治鄉,0296,410,127,537,15,552,972,56.79%,42.18%,1
屏東縣,長治鄉,0297,400,133,533,40,573,989,57.94%,40.44%,1
屏東縣,長治鄉,0298,321,98,419,26,445,735,60.54%,43.67%,1
屏東縣,長治鄉,0299,595,254,849,46,895,1813,49.37%,32.82%,1
屏東縣,長治鄉,0300,458,168,626,25,651,1073,60.67%,42.68%,1
屏東縣,長治鄉,0301,650,182,832,40,872,1654,52.72%,39.3%,1
屏東縣,長治鄉,0302,448,189,637,46,683,1205,56.68%,37.18%,1
屏東縣,長治鄉,0303,305,100,405,29,434,758,57.26%,40.24%,1
屏東縣,長治鄉,0304,562,201,763,59,822,1492,55.09%,37.67%,1
屏東縣,長治鄉,0305,386,102,488,30,518,884,58.6%,43.67%,1
屏東縣,長治鄉,0306,453,128,581,46,627,1090,57.52%,41.56%,1
屏東縣,長治鄉,0307,475,176,651,78,729,1422,51.27%,33.4%,1
屏東縣,長治鄉,0308,332,99,431,37,468,845,55.38%,39.29%,1
屏東縣,長治鄉,0309,387,108,495,42,537,925,58.05%,41.84%,1
屏東縣,長治鄉,0310,476,128,604,31,635,1138,55.8%,41.83%,1
屏東縣,長治鄉,0311,484,158,642,54,696,1242,56.04%,38.97%,1
屏東縣,長治鄉,0312,413,127,540,19,559,1159,48.23%,35.63%,1
屏東縣,長治鄉,0313,285,92,377,25,402,673,59.73%,42.35%,1
屏東縣,麟洛鄉,0314,303,123,426,23,449,788,56.98%,38.45%,1
屏東縣,麟洛鄉,0315,606,202,808,39,847,1386,61.11%,43.72%,1
屏東縣,麟洛鄉,0316,406,147,553,35,588,957,61.44%,42.42%,1
屏東縣,麟洛鄉,0317,325,104,429,23,452,731,61.83%,44.46%,1
屏東縣,麟洛鄉,0318,346,130,476,28,504,806,62.53%,42.93%,1
屏東縣,麟洛鄉,0319,460,159,619,14,633,1207,52.44%,38.11%,1
屏東縣,麟洛鄉,0320,574,197,771,49,820,1340,61.19%,42.84%,1
屏東縣,麟洛鄉,0321,528,190,718,30,748,1221,61.26%,43.24%,1
屏東縣,麟洛鄉,0322,342,127,469,14,483,851,56.76%,40.19%,1
屏東縣,麟洛鄉,0323,262,86,348,12,360,683,52.71%,38.36%,1
屏東縣,九如鄉,0324,602,198,800,46,846,1491,56.74%,40.38%,1
屏東縣,九如鄉,0325,518,178,696,43,739,1375,53.75%,37.67%,1
屏東縣,九如鄉,0326,616,183,799,52,851,1678,50.72%,36.71%,1
屏東縣,九如鄉,0327,469,153,622,63,685,1166,58.75%,40.22%,1
屏東縣,九如鄉,0328,400,139,539,36,575,1276,45.06%,31.35%,1
屏東縣,九如鄉,0329,430,120,550,36,586,1033,56.73%,41.63%,1
屏東縣,九如鄉,0330,284,89,373,24,397,577,68.8%,49.22%,1
屏東縣,九如鄉,0331,293,79,372,31,403,649,62.1%,45.15%,1
屏東縣,九如鄉,0332,758,248,1006,91,1097,1999,54.88%,37.92%,1
屏東縣,九如鄉,0333,643,229,872,49,921,1766,52.15%,36.41%,1
屏東縣,九如鄉,0334,573,191,764,74,838,1600,52.38%,35.81%,1
屏東縣,九如鄉,0335,502,136,638,48,686,1248,54.97%,40.22%,1
屏東縣,九如鄉,0336,738,213,951,91,1042,1792,58.15%,41.18%,1
屏東縣,九如鄉,0337,592,168,760,55,815,1482,54.99%,39.95%,1
屏東縣,里港鄉,0338,668,203,871,53,924,1552,59.54%,43.04%,1
屏東縣,里港鄉,0339,528,202,730,59,789,1480,53.31%,35.68%,1
屏東縣,里港鄉,0340,483,175,658,34,692,1534,45.11%,31.49%,1
屏東縣,里港鄉,0341,618,196,814,42,856,1578,54.25%,39.16%,1
屏東縣,里港鄉,0342,493,165,658,28,686,1127,60.87%,43.74%,1
屏東縣,里港鄉,0343,362,105,467,31,498,845,58.93%,42.84%,1
屏東縣,里港鄉,0344,465,161,626,42,668,1282,52.11%,36.27%,1
屏東縣,里港鄉,0345,401,125,526,43,569,981,58%,40.88%,1
屏東縣,里港鄉,0346,415,143,558,41,599,1031,58.1%,40.25%,1
屏東縣,里港鄉,0347,529,198,727,193,920,1423,64.65%,37.17%,1
屏東縣,里港鄉,0348,133,39,172,8,180,363,49.59%,36.64%,1
屏東縣,里港鄉,0349,425,184,609,94,703,1203,58.44%,35.33%,1
屏東縣,里港鄉,0350,453,127,580,59,639,1027,62.22%,44.11%,1
屏東縣,里港鄉,0351,514,162,676,50,726,1384,52.46%,37.14%,1
屏東縣,里港鄉,0352,550,186,736,55,791,1512,52.31%,36.38%,1
屏東縣,里港鄉,0353,238,57,295,13,308,522,59%,45.59%,1
屏東縣,里港鄉,0354,313,105,418,41,459,822,55.84%,38.08%,1
屏東縣,里港鄉,0355,342,162,504,25,529,1007,52.53%,33.96%,1
屏東縣,里港鄉,0356,371,122,493,44,537,956,56.17%,38.81%,1
屏東縣,里港鄉,0357,191,75,266,16,282,499,56.51%,38.28%,1
屏東縣,鹽埔鄉,0358,441,48,489,21,510,951,53.63%,46.37%,1
屏東縣,鹽埔鄉,0359,324,109,433,25,458,899,50.95%,36.04%,1
屏東縣,鹽埔鄉,0360,360,123,483,27,510,1116,45.7%,32.26%,1
屏東縣,鹽埔鄉,0361,461,141,602,29,631,1241,50.85%,37.15%,1
屏東縣,鹽埔鄉,0362,269,102,371,36,407,770,52.86%,34.94%,1
屏東縣,鹽埔鄉,0363,377,110,487,23,510,962,53.01%,39.19%,1
屏東縣,鹽埔鄉,0364,453,123,576,58,634,1041,60.9%,43.52%,1
屏東縣,鹽埔鄉,0365,479,171,650,59,709,1367,51.87%,35.04%,1
屏東縣,鹽埔鄉,0366,502,137,639,51,690,1465,47.1%,34.27%,1
屏東縣,鹽埔鄉,0367,296,92,388,36,424,894,47.43%,33.11%,1
屏東縣,鹽埔鄉,0368,318,96,414,2,416,958,43.42%,33.19%,1
屏東縣,鹽埔鄉,0369,340,108,448,45,493,924,53.35%,36.8%,1
屏東縣,鹽埔鄉,0370,582,159,741,24,765,1598,47.87%,36.42%,1
屏東縣,鹽埔鄉,0371,559,200,759,74,833,1550,53.74%,36.06%,1
屏東縣,鹽埔鄉,0372,436,129,565,39,604,1127,53.59%,38.69%,1
屏東縣,鹽埔鄉,0373,494,134,628,44,672,1150,58.43%,42.96%,1
屏東縣,鹽埔鄉,0374,491,163,654,30,684,1233,55.47%,39.82%,1
屏東縣,鹽埔鄉,0375,419,125,544,50,594,984,60.37%,42.58%,1
屏東縣,鹽埔鄉,0376,633,220,853,33,886,1619,54.73%,39.1%,1
屏東縣,鹽埔鄉,0377,226,64,290,19,309,553,55.88%,40.87%,1
屏東縣,高樹鄉,0378,362,138,500,56,556,883,62.97%,41%,1
屏東縣,高樹鄉,0379,360,104,464,30,494,1255,39.36%,28.69%,1
屏東縣,高樹鄉,0380,514,148,662,20,682,1278,53.36%,40.22%,1
屏東縣,高樹鄉,0381,264,58,322,23,345,738,46.75%,35.77%,1
屏東縣,高樹鄉,0382,210,56,266,15,281,585,48.03%,35.9%,1
屏東縣,高樹鄉,0383,374,143,517,78,595,1012,58.79%,36.96%,1
屏東縣,高樹鄉,0384,282,232,514,63,577,1148,50.26%,24.56%,1
屏東縣,高樹鄉,0385,218,69,287,22,309,591,52.28%,36.89%,1
屏東縣,高樹鄉,0386,243,85,328,39,367,786,46.69%,30.92%,1
屏東縣,高樹鄉,0387,224,49,273,17,290,649,44.68%,34.51%,1
屏東縣,高樹鄉,0388,368,103,471,52,523,1229,42.55%,29.94%,1
屏東縣,高樹鄉,0389,470,103,573,43,616,1446,42.6%,32.5%,1
屏東縣,高樹鄉,0390,241,111,352,15,367,899,40.82%,26.81%,1
屏東縣,高樹鄉,0391,335,105,440,41,481,922,52.17%,36.33%,1
屏東縣,高樹鄉,0392,383,144,527,69,596,1259,47.34%,30.42%,1
屏東縣,高樹鄉,0393,356,99,455,16,471,1056,44.6%,33.71%,1
屏東縣,高樹鄉,0394,415,135,550,64,614,1116,55.02%,37.19%,1
屏東縣,高樹鄉,0395,372,124,496,77,573,1020,56.18%,36.47%,1
屏東縣,高樹鄉,0396,397,126,523,51,574,1055,54.41%,37.63%,1
屏東縣,高樹鄉,0397,312,95,407,33,440,738,59.62%,42.28%,1
屏東縣,高樹鄉,0398,163,43,206,30,236,493,47.87%,33.06%,1
屏東縣,高樹鄉,0399,612,174,786,77,863,1539,56.08%,39.77%,1
屏東縣,萬巒鄉,0400,458,148,606,25,631,1239,50.93%,36.97%,1
屏東縣,萬巒鄉,0401,303,107,410,28,438,759,57.71%,39.92%,1
屏東縣,萬巒鄉,0402,395,109,504,53,557,932,59.76%,42.38%,1
屏東縣,萬巒鄉,0403,322,99,421,46,467,769,60.73%,41.87%,1
屏東縣,萬巒鄉,0404,351,109,460,47,507,920,55.11%,38.15%,1
屏東縣,萬巒鄉,0405,225,76,301,22,323,560,57.68%,40.18%,1
屏東縣,萬巒鄉,0406,399,114,513,26,539,1120,48.13%,35.63%,1
屏東縣,萬巒鄉,0407,403,105,508,25,533,1048,50.86%,38.45%,1
屏東縣,萬巒鄉,0408,513,121,634,20,654,1438,45.48%,35.67%,1
屏東縣,萬巒鄉,0409,296,89,385,32,417,834,50%,35.49%,1
屏東縣,萬巒鄉,0410,315,81,396,37,433,813,53.26%,38.75%,1
屏東縣,萬巒鄉,0411,440,89,529,24,553,1020,54.22%,43.14%,1
屏東縣,萬巒鄉,0412,436,128,564,42,606,1007,60.18%,43.3%,1
屏東縣,萬巒鄉,0413,507,169,676,53,729,1648,44.24%,30.76%,1
屏東縣,萬巒鄉,0414,539,165,704,44,748,1437,52.05%,37.51%,1
屏東縣,萬巒鄉,0415,417,120,537,19,556,1228,45.28%,33.96%,1
屏東縣,萬巒鄉,0416,265,60,325,27,352,597,58.96%,44.39%,1
屏東縣,萬巒鄉,0417,234,65,299,29,328,576,56.94%,40.63%,1
屏東縣,內埔鄉,0418,441,126,567,37,604,1305,46.28%,33.79%,1
屏東縣,內埔鄉,0419,472,118,590,35,625,1287,48.56%,36.67%,1
屏東縣,內埔鄉,0420,473,159,632,21,653,1387,47.08%,34.1%,1
屏東縣,內埔鄉,0421,496,201,697,32,729,1540,47.34%,32.21%,1
屏東縣,內埔鄉,0422,570,184,754,31,785,1605,48.91%,35.51%,1
屏東縣,內埔鄉,0423,487,138,625,45,670,1326,50.53%,36.73%,1
屏東縣,內埔鄉,0424,241,70,311,23,334,591,56.51%,40.78%,1
屏東縣,內埔鄉,0425,373,128,501,39,540,1123,48.09%,33.21%,1
屏東縣,內埔鄉,0426,425,99,524,5,529,1079,49.03%,39.39%,1
屏東縣,內埔鄉,0427,565,163,728,46,774,1485,52.12%,38.05%,1
屏東縣,內埔鄉,0428,539,151,690,23,713,1248,57.13%,43.19%,1
屏東縣,內埔鄉,0429,606,183,789,32,821,1569,52.33%,38.62%,1
屏東縣,內埔鄉,0430,500,164,664,49,713,1493,47.76%,33.49%,1
屏東縣,內埔鄉,0431,498,156,654,17,671,1420,47.25%,35.07%,1
屏東縣,內埔鄉,0432,519,134,653,41,694,1334,52.02%,38.91%,1
屏東縣,內埔鄉,0433,594,113,707,34,741,1519,48.78%,39.1%,1
屏東縣,內埔鄉,0434,290,97,387,33,420,784,53.57%,36.99%,1
屏東縣,內埔鄉,0435,365,100,465,40,505,888,56.87%,41.1%,1
屏東縣,內埔鄉,0436,263,70,333,7,340,747,45.52%,35.21%,1
屏東縣,內埔鄉,0437,389,114,503,22,525,1168,44.95%,33.3%,1
屏東縣,內埔鄉,0438,221,67,288,24,312,546,57.14%,40.48%,1
屏東縣,內埔鄉,0439,453,147,600,41,641,1278,50.16%,35.45%,1
屏東縣,內埔鄉,0440,448,131,579,44,623,1348,46.22%,33.23%,1
屏東縣,內埔鄉,0441,465,143,608,51,659,1550,42.52%,30%,1
屏東縣,內埔鄉,0442,415,116,531,46,577,947,60.93%,43.82%,1
屏東縣,內埔鄉,0443,412,118,530,38,568,1097,51.78%,37.56%,1
屏東縣,內埔鄉,0444,302,126,428,53,481,1128,42.64%,26.77%,1
屏東縣,內埔鄉,0445,357,79,436,23,459,1253,36.63%,28.49%,1
屏東縣,內埔鄉,0446,544,126,670,15,685,1525,44.92%,35.67%,1
屏東縣,內埔鄉,0447,474,122,596,43,639,1215,52.59%,39.01%,1
屏東縣,內埔鄉,0448,412,100,512,19,531,1216,43.67%,33.88%,1
屏東縣,內埔鄉,0449,470,122,592,27,619,1353,45.75%,34.74%,1
屏東縣,內埔鄉,0450,41,451,492,26,518,1026,50.49%,4%,1
屏東縣,內埔鄉,0451,303,86,389,22,411,862,47.68%,35.15%,1
屏東縣,內埔鄉,0452,290,87,377,27,404,921,43.87%,31.49%,1
屏東縣,內埔鄉,0453,323,94,417,20,437,854,51.17%,37.82%,1
屏東縣,內埔鄉,0454,449,98,547,23,570,1230,46.34%,36.5%,1
屏東縣,內埔鄉,0455,438,113,551,23,574,1204,47.67%,36.38%,1
屏東縣,內埔鄉,0456,437,128,565,29,594,1301,45.66%,33.59%,1
屏東縣,內埔鄉,0457,343,89,432,22,454,806,56.33%,42.56%,1
屏東縣,竹田鄉,0458,635,154,789,53,842,1503,56.02%,42.25%,1
屏東縣,竹田鄉,0459,405,123,528,25,553,899,61.51%,45.05%,1
屏東縣,竹田鄉,0460,325,95,420,34,454,716,63.41%,45.39%,1
屏東縣,竹田鄉,0461,268,95,363,20,383,581,65.92%,46.13%,1
屏東縣,竹田鄉,0462,524,156,680,62,742,1327,55.92%,39.49%,1
屏東縣,竹田鄉,0463,442,125,567,51,618,997,61.99%,44.33%,1
屏東縣,竹田鄉,0464,259,80,339,25,364,649,56.09%,39.91%,1
屏東縣,竹田鄉,0465,258,68,326,20,346,476,72.69%,54.2%,1
屏東縣,竹田鄉,0466,528,159,687,55,742,1259,58.94%,41.94%,1
屏東縣,竹田鄉,0467,463,127,590,53,643,1227,52.4%,37.73%,1
屏東縣,竹田鄉,0468,233,67,300,22,322,504,63.89%,46.23%,1
屏東縣,竹田鄉,0469,335,97,432,36,468,860,54.42%,38.95%,1
屏東縣,竹田鄉,0470,307,104,411,19,430,800,53.75%,38.38%,1
屏東縣,竹田鄉,0471,481,127,608,54,662,1134,58.38%,42.42%,1
屏東縣,竹田鄉,0472,455,157,612,56,668,1229,54.35%,37.02%,1
屏東縣,竹田鄉,0473,445,154,599,46,645,1192,54.11%,37.33%,1
屏東縣,新埤鄉,0474,634,175,809,28,837,1712,48.89%,37.03%,1
屏東縣,新埤鄉,0475,124,32,156,19,175,314,55.73%,39.49%,1
屏東縣,新埤鄉,0476,288,92,380,30,410,752,54.52%,38.3%,1
屏東縣,新埤鄉,0477,138,29,167,17,184,334,55.09%,41.32%,1
屏東縣,新埤鄉,0478,411,93,504,40,544,957,56.84%,42.95%,1
屏東縣,新埤鄉,0479,315,96,411,40,451,764,59.03%,41.23%,1
屏東縣,新埤鄉,0480,154,41,195,17,212,373,56.84%,41.29%,1
屏東縣,新埤鄉,0481,230,68,298,19,317,678,46.76%,33.92%,1
屏東縣,新埤鄉,0482,237,70,307,23,330,701,47.08%,33.81%,1
屏東縣,新埤鄉,0483,393,99,492,53,545,1323,41.19%,29.71%,1
屏東縣,新埤鄉,0484,223,60,283,29,312,541,57.67%,41.22%,1
屏東縣,新埤鄉,0485,202,44,246,26,272,584,46.58%,34.59%,1
屏東縣,枋寮鄉,0486,505,139,644,40,684,1213,56.39%,41.63%,1
屏東縣,枋寮鄉,0487,367,113,480,45,525,891,58.92%,41.19%,1
屏東縣,枋寮鄉,0488,364,88,452,45,497,970,51.24%,37.53%,1
屏東縣,枋寮鄉,0489,262,57,319,20,339,629,53.9%,41.65%,1
屏東縣,枋寮鄉,0490,364,108,472,34,506,840,60.24%,43.33%,1
屏東縣,枋寮鄉,0491,339,81,420,25,445,774,57.49%,43.8%,1
屏東縣,枋寮鄉,0492,534,139,673,45,718,1379,52.07%,38.72%,1
屏東縣,枋寮鄉,0493,646,154,800,32,832,1502,55.39%,43.01%,1
屏東縣,枋寮鄉,0494,488,143,631,0,631,1276,49.45%,38.24%,1
屏東縣,枋寮鄉,0495,369,110,479,43,522,964,54.15%,38.28%,1
屏東縣,枋寮鄉,0496,455,102,557,56,613,1005,61%,45.27%,1
屏東縣,枋寮鄉,0497,296,76,372,16,388,734,52.86%,40.33%,1
屏東縣,枋寮鄉,0498,306,78,384,34,418,725,57.66%,42.21%,1
屏東縣,枋寮鄉,0499,386,112,498,56,554,1046,52.96%,36.9%,1
屏東縣,枋寮鄉,0500,446,109,555,61,616,1067,57.73%,41.8%,1
屏東縣,枋寮鄉,0501,188,62,250,34,284,718,39.55%,26.18%,1
屏東縣,枋寮鄉,0502,315,77,392,34,426,903,47.18%,34.88%,1
屏東縣,枋寮鄉,0503,457,152,609,68,677,1387,48.81%,32.95%,1
屏東縣,枋寮鄉,0504,536,170,706,50,756,1367,55.3%,39.21%,1
屏東縣,枋寮鄉,0505,254,111,365,27,392,618,63.43%,41.1%,1
屏東縣,枋寮鄉,0506,290,80,370,20,390,959,40.67%,30.24%,1
屏東縣,枋寮鄉,0507,175,42,217,21,238,427,55.74%,40.98%,1
屏東縣,新園鄉,0508,326,107,433,39,472,820,57.56%,39.76%,1
屏東縣,新園鄉,0509,357,113,470,46,516,843,61.21%,42.35%,1
屏東縣,新園鄉,0510,447,153,600,43,643,1242,51.77%,35.99%,1
屏東縣,新園鄉,0511,538,162,700,43,743,1290,57.6%,41.71%,1
屏東縣,新園鄉,0512,405,131,536,32,568,1073,52.94%,37.74%,1
屏東縣,新園鄉,0513,426,155,581,68,649,1088,59.65%,39.15%,1
屏東縣,新園鄉,0514,309,88,397,23,420,845,49.7%,36.57%,1
屏東縣,新園鄉,0515,306,129,435,37,472,862,54.76%,35.5%,1
屏東縣,新園鄉,0516,407,137,544,43,587,1183,49.62%,34.4%,1
屏東縣,新園鄉,0517,417,136,553,58,611,1109,55.09%,37.6%,1
屏東縣,新園鄉,0518,369,140,509,16,525,1119,46.92%,32.98%,1
屏東縣,新園鄉,0519,385,153,538,31,569,1152,49.39%,33.42%,1
屏東縣,新園鄉,0520,406,118,524,49,573,1030,55.63%,39.42%,1
屏東縣,新園鄉,0521,404,136,540,49,589,1104,53.35%,36.59%,1
屏東縣,新園鄉,0522,461,113,574,40,614,1240,49.52%,37.18%,1
屏東縣,新園鄉,0523,323,126,449,25,474,1120,42.32%,28.84%,1
屏東縣,新園鄉,0524,429,132,561,63,624,1074,58.1%,39.94%,1
屏東縣,新園鄉,0525,288,80,368,34,402,849,47.35%,33.92%,1
屏東縣,新園鄉,0526,280,91,371,39,410,749,54.74%,37.38%,1
屏東縣,新園鄉,0527,450,217,667,59,726,1416,51.27%,31.78%,1
屏東縣,新園鄉,0528,353,103,456,37,493,895,55.08%,39.44%,1
屏東縣,新園鄉,0529,372,99,471,51,522,933,55.95%,39.87%,1
屏東縣,新園鄉,0530,387,104,491,31,522,972,53.7%,39.81%,1
屏東縣,新園鄉,0531,511,138,649,38,687,1454,47.25%,35.14%,1
屏東縣,新園鄉,0532,703,198,901,64,965,1653,58.38%,42.53%,1
屏東縣,新園鄉,0533,497,102,599,46,645,1270,50.79%,39.13%,1
屏東縣,新園鄉,0534,505,114,619,69,688,1123,61.26%,44.97%,1
屏東縣,新園鄉,0535,471,112,583,40,623,1198,52%,39.32%,1
屏東縣,崁頂鄉,0536,421,140,561,26,587,1190,49.33%,35.38%,1
屏東縣,崁頂鄉,0537,400,145,545,32,577,1044,55.27%,38.31%,1
屏東縣,崁頂鄉,0538,308,111,419,37,456,818,55.75%,37.65%,1
屏東縣,崁頂鄉,0539,433,168,601,30,631,1214,51.98%,35.67%,1
屏東縣,崁頂鄉,0540,483,145,628,24,652,1325,49.21%,36.45%,1
屏東縣,崁頂鄉,0541,511,166,677,42,719,1253,57.38%,40.78%,1
屏東縣,崁頂鄉,0542,351,142,493,36,529,1039,50.91%,33.78%,1
屏東縣,崁頂鄉,0543,261,93,354,37,391,813,48.09%,32.1%,1
屏東縣,崁頂鄉,0544,270,87,357,18,375,736,50.95%,36.68%,1
屏東縣,崁頂鄉,0545,362,139,501,28,529,934,56.64%,38.76%,1
屏東縣,崁頂鄉,0546,333,98,431,43,474,900,52.67%,37%,1
屏東縣,崁頂鄉,0547,393,115,508,31,539,1004,53.69%,39.14%,1
屏東縣,林邊鄉,0548,643,164,807,56,863,1458,59.19%,44.1%,1
屏東縣,林邊鄉,0549,402,93,495,18,513,891,57.58%,45.12%,1
屏東縣,林邊鄉,0550,318,79,397,25,422,695,60.72%,45.76%,1
屏東縣,林邊鄉,0551,449,127,576,33,609,1015,60%,44.24%,1
屏東縣,林邊鄉,0552,493,138,631,47,678,1171,57.9%,42.1%,1
屏東縣,林邊鄉,0553,376,130,506,40,546,1003,54.44%,37.49%,1
屏東縣,林邊鄉,0554,319,114,433,29,462,725,63.72%,44%,1
屏東縣,林邊鄉,0555,360,101,461,40,501,841,59.57%,42.81%,1
屏東縣,林邊鄉,0556,333,106,439,38,477,793,60.15%,41.99%,1
屏東縣,林邊鄉,0557,405,101,506,41,547,919,59.52%,44.07%,1
屏東縣,林邊鄉,0558,471,142,613,52,665,1283,51.83%,36.71%,1
屏東縣,林邊鄉,0559,282,80,362,34,396,783,50.57%,36.02%,1
屏東縣,林邊鄉,0560,382,93,475,35,510,1033,49.37%,36.98%,1
屏東縣,林邊鄉,0561,440,116,556,86,642,1186,54.13%,37.1%,1
屏東縣,林邊鄉,0562,296,88,384,39,423,773,54.72%,38.29%,1
屏東縣,林邊鄉,0563,414,93,507,35,542,1122,48.31%,36.9%,1
屏東縣,南州鄉,0564,349,94,443,28,471,872,54.01%,40.02%,1
屏東縣,南州鄉,0565,335,80,415,24,439,794,55.29%,42.19%,1
屏東縣,南州鄉,0566,405,129,534,28,562,962,58.42%,42.1%,1
屏東縣,南州鄉,0567,401,137,538,42,580,1033,56.15%,38.82%,1
屏東縣,南州鄉,0568,350,137,487,33,520,1007,51.64%,34.76%,1
屏東縣,南州鄉,0569,214,48,262,16,278,466,59.66%,45.92%,1
屏東縣,南州鄉,0570,313,104,417,16,433,708,61.16%,44.21%,1
屏東縣,南州鄉,0571,410,144,554,37,591,1044,56.61%,39.27%,1
屏東縣,南州鄉,0572,338,96,434,45,479,1071,44.72%,31.56%,1
屏東縣,南州鄉,0573,340,149,489,28,517,979,52.81%,34.73%,1
屏東縣,南州鄉,0574,197,52,249,25,274,543,50.46%,36.28%,1
屏東縣,佳冬鄉,0575,463,180,643,44,687,1472,46.67%,31.45%,1
屏東縣,佳冬鄉,0576,448,115,563,51,614,1360,45.15%,32.94%,1
屏東縣,佳冬鄉,0577,334,90,424,45,469,804,58.33%,41.54%,1
屏東縣,佳冬鄉,0578,323,113,436,50,486,925,52.54%,34.92%,1
屏東縣,佳冬鄉,0579,299,91,390,8,398,855,46.55%,34.97%,1
屏東縣,佳冬鄉,0580,341,119,460,31,491,981,50.05%,34.76%,1
屏東縣,佳冬鄉,0581,336,126,462,40,502,1007,49.85%,33.37%,1
屏東縣,佳冬鄉,0582,278,105,383,41,424,872,48.62%,31.88%,1
屏東縣,佳冬鄉,0583,401,135,536,38,574,1255,45.74%,31.95%,1
屏東縣,佳冬鄉,0584,438,83,521,54,575,995,57.79%,44.02%,1
屏東縣,佳冬鄉,0585,217,83,300,26,326,734,44.41%,29.56%,1
屏東縣,佳冬鄉,0586,410,110,520,18,538,1178,45.67%,34.8%,1
屏東縣,佳冬鄉,0587,347,129,476,54,530,1095,48.4%,31.69%,1
屏東縣,佳冬鄉,0588,481,69,550,61,611,1097,55.7%,43.85%,1
屏東縣,佳冬鄉,0589,496,119,615,50,665,1273,52.24%,38.96%,1
屏東縣,佳冬鄉,0590,492,132,624,30,654,1160,56.38%,42.41%,1
屏東縣,琉球鄉,0591,329,109,438,30,468,1111,42.12%,29.61%,1
屏東縣,琉球鄉,0592,314,95,409,31,440,972,45.27%,32.3%,1
屏東縣,琉球鄉,0593,481,134,615,40,655,1278,51.25%,37.64%,1
屏東縣,琉球鄉,0594,364,86,450,45,495,976,50.72%,37.3%,1
屏東縣,琉球鄉,0595,572,141,713,74,787,1658,47.47%,34.5%,1
屏東縣,琉球鄉,0596,340,86,426,24,450,1146,39.27%,29.67%,1
屏東縣,琉球鄉,0597,326,71,397,28,425,1079,39.39%,30.21%,1
屏東縣,琉球鄉,0598,542,10,552,20,572,1613,35.46%,33.6%,1
屏東縣,琉球鄉,0599,309,86,395,40,435,873,49.83%,35.4%,1
屏東縣,車城鄉,0600,210,75,285,25,310,737,42.06%,28.49%,1
屏東縣,車城鄉,0601,150,67,217,24,241,647,37.25%,23.18%,1
屏東縣,車城鄉,0602,161,53,214,17,231,491,47.05%,32.79%,1
屏東縣,車城鄉,0603,286,105,391,21,412,856,48.13%,33.41%,1
屏東縣,車城鄉,0604,203,46,249,8,257,554,46.39%,36.64%,1
屏東縣,車城鄉,0605,105,32,137,7,144,388,37.11%,27.06%,1
屏東縣,車城鄉,0606,250,100,350,24,374,922,40.56%,27.11%,1
屏東縣,車城鄉,0607,146,59,205,10,215,597,36.01%,24.46%,1
屏東縣,車城鄉,0608,167,45,212,10,222,623,35.63%,26.81%,1
屏東縣,車城鄉,0609,138,51,189,12,201,425,47.29%,32.47%,1
屏東縣,車城鄉,0610,166,33,199,16,215,428,50.23%,38.79%,1
屏東縣,車城鄉,0611,131,44,175,5,180,504,35.71%,25.99%,1
屏東縣,車城鄉,0612,144,47,191,19,210,423,49.65%,34.04%,1
屏東縣,滿州鄉,0613,502,183,685,36,721,1575,45.78%,31.87%,1
屏東縣,滿州鄉,0614,147,44,191,9,200,420,47.62%,35%,1
屏東縣,滿州鄉,0615,272,65,337,13,350,602,58.14%,45.18%,1
屏東縣,滿州鄉,0616,405,89,494,19,513,1302,39.4%,31.11%,1
屏東縣,滿州鄉,0617,430,139,569,47,616,1314,46.88%,32.72%,1
屏東縣,滿州鄉,0618,274,105,379,15,394,1308,30.12%,20.95%,1
屏東縣,滿州鄉,0619,98,42,140,9,149,367,40.6%,26.7%,1
屏東縣,滿州鄉,0620,122,25,147,19,166,318,52.2%,38.36%,1
屏東縣,枋山鄉,0621,288,59,347,21,368,604,60.93%,47.68%,1
屏東縣,枋山鄉,0622,193,54,247,21,268,428,62.62%,45.09%,1
屏東縣,枋山鄉,0623,402,118,520,61,581,928,62.61%,43.32%,1
屏東縣,枋山鄉,0624,377,108,485,18,503,972,51.75%,38.79%,1
屏東縣,枋山鄉,0625,335,110,445,31,476,1041,45.73%,32.18%,1
屏東縣,枋山鄉,0626,236,84,320,16,336,883,38.05%,26.73%,1
屏東縣,三地門鄉,0627,255,47,302,9,311,616,50.49%,41.4%,1
屏東縣,三地門鄉,0628,267,66,333,26,359,572,62.76%,46.68%,1
屏東縣,三地門鄉,0629,171,31,202,3,205,323,63.47%,52.94%,1
屏東縣,三地門鄉,0630,626,245,871,32,903,1448,62.36%,43.23%,1
屏東縣,三地門鄉,0631,308,78,386,7,393,726,54.13%,42.42%,1
屏東縣,三地門鄉,0632,215,81,296,14,310,554,55.96%,38.81%,1
屏東縣,三地門鄉,0633,169,55,224,10,234,346,67.63%,48.84%,1
屏東縣,三地門鄉,0634,284,50,334,5,339,458,74.02%,62.01%,1
屏東縣,三地門鄉,0635,361,94,455,14,469,692,67.77%,52.17%,1
屏東縣,三地門鄉,0636,308,99,407,44,451,638,70.69%,48.28%,1
屏東縣,霧臺鄉,0637,203,60,263,8,271,346,78.32%,58.67%,1
屏東縣,霧臺鄉,0638,392,107,499,16,515,677,76.07%,57.9%,1
屏東縣,霧臺鄉,0639,79,15,94,2,96,162,59.26%,48.77%,1
屏東縣,霧臺鄉,0640,97,16,113,4,117,189,61.9%,51.32%,1
屏東縣,霧臺鄉,0641,199,27,226,8,234,296,79.05%,67.23%,1
屏東縣,霧臺鄉,0642,328,72,400,7,407,483,84.27%,67.91%,1
屏東縣,霧臺鄉,0643,176,56,232,6,238,347,68.59%,50.72%,1
屏東縣,霧臺鄉,0644,220,111,331,14,345,450,76.67%,48.89%,1
屏東縣,瑪家鄉,0645,177,75,252,5,257,455,56.48%,38.9%,1
屏東縣,瑪家鄉,0646,406,129,535,15,550,821,66.99%,49.45%,1
屏東縣,瑪家鄉,0647,347,92,439,29,468,635,73.7%,54.65%,1
屏東縣,瑪家鄉,0648,412,86,498,27,525,695,75.54%,59.28%,1
屏東縣,瑪家鄉,0649,417,76,493,12,505,671,75.26%,62.15%,1
屏東縣,瑪家鄉,0650,486,147,633,17,650,1057,61.49%,45.98%,1
屏東縣,瑪家鄉,0651,429,108,537,16,553,900,61.44%,47.67%,1
屏東縣,瑪家鄉,0652,223,49,272,7,279,429,65.03%,51.98%,1
屏東縣,泰武鄉,0653,293,109,402,10,412,669,61.58%,43.8%,1
屏東縣,泰武鄉,0654,97,21,118,4,122,190,64.21%,51.05%,1
屏東縣,泰武鄉,0655,428,144,572,35,607,922,65.84%,46.42%,1
屏東縣,泰武鄉,0656,367,85,452,10,462,598,77.26%,61.37%,1
屏東縣,泰武鄉,0657,388,87,475,28,503,771,65.24%,50.32%,1
屏東縣,泰武鄉,0658,247,38,285,18,303,414,73.19%,59.66%,1
屏東縣,泰武鄉,0659,373,90,463,19,482,780,61.79%,47.82%,1
屏東縣,來義鄉,0660,481,88,569,52,621,917,67.72%,52.45%,1
屏東縣,來義鄉,0661,175,45,220,13,233,361,64.54%,48.48%,1
屏東縣,來義鄉,0662,120,15,135,0,135,216,62.5%,55.56%,1
屏東縣,來義鄉,0663,272,49,321,16,337,445,75.73%,61.12%,1
屏東縣,來義鄉,0664,152,22,174,8,182,280,65%,54.29%,1
屏東縣,來義鄉,0665,492,117,609,39,648,1097,59.07%,44.85%,1
屏東縣,來義鄉,0666,442,92,534,31,565,840,67.26%,52.62%,1
屏東縣,來義鄉,0667,322,118,440,13,453,889,50.96%,36.22%,1
屏東縣,來義鄉,0668,434,155,589,33,622,1212,51.32%,35.81%,1
屏東縣,春日鄉,0669,301,87,388,10,398,909,43.78%,33.11%,1
屏東縣,春日鄉,0670,268,88,356,9,365,663,55.05%,40.42%,1
屏東縣,春日鄉,0671,105,17,122,0,122,304,40.13%,34.54%,1
屏東縣,春日鄉,0672,342,107,449,19,468,928,50.43%,36.85%,1
屏東縣,春日鄉,0673,166,59,225,5,230,641,35.88%,25.9%,1
屏東縣,春日鄉,0674,104,49,153,3,156,478,32.64%,21.76%,1
屏東縣,獅子鄉,0675,348,62,410,12,422,751,56.19%,46.34%,1
屏東縣,獅子鄉,0676,348,88,436,23,459,776,59.15%,44.85%,1
屏東縣,獅子鄉,0677,423,64,487,18,505,711,71.03%,59.49%,1
屏東縣,獅子鄉,0678,137,34,171,16,187,243,76.95%,56.38%,1
屏東縣,獅子鄉,0679,188,35,223,6,229,325,70.46%,57.85%,1
屏東縣,獅子鄉,0680,206,54,260,4,264,476,55.46%,43.28%,1
屏東縣,獅子鄉,0681,340,66,406,8,414,602,68.77%,56.48%,1
屏東縣,獅子鄉,0682,125,43,168,6,174,346,50.29%,36.13%,1
屏東縣,牡丹鄉,0683,104,34,138,5,143,342,41.81%,30.41%,1
屏東縣,牡丹鄉,0684,472,159,631,32,663,1306,50.77%,36.14%,1
屏東縣,牡丹鄉,0685,141,52,193,5,198,693,28.57%,20.35%,1
屏東縣,牡丹鄉,0686,152,42,194,8,202,437,46.22%,34.78%,1
屏東縣,牡丹鄉,0687,148,44,192,4,196,392,50%,37.76%,1
屏東縣,牡丹鄉,0688,207,90,297,7,304,593,51.26%,34.91%,1
屏東縣,牡丹鄉,0689,103,31,134,2,136,551,24.68%,18.69%,1
宜蘭縣,宜蘭市,0001,385,139,524,11,535,982,54.48%,39.21%,1
宜蘭縣,宜蘭市,0002,502,166,668,34,702,1270,55.28%,39.53%,1
宜蘭縣,宜蘭市,0003,318,146,464,11,475,849,55.95%,37.46%,1
宜蘭縣,宜蘭市,0004,303,124,427,14,441,756,58.33%,40.08%,1
宜蘭縣,宜蘭市,0005,401,130,531,25,556,1107,50.23%,36.22%,1
宜蘭縣,宜蘭市,0006,365,105,470,28,498,893,55.77%,40.87%,1
宜蘭縣,宜蘭市,0007,344,139,483,24,507,912,55.59%,37.72%,1
宜蘭縣,宜蘭市,0008,517,203,720,33,753,1335,56.4%,38.73%,1
宜蘭縣,宜蘭市,0009,244,112,356,11,367,686,53.5%,35.57%,1
宜蘭縣,宜蘭市,0010,543,249,792,35,827,1366,60.54%,39.75%,1
宜蘭縣,宜蘭市,0011,489,267,756,21,777,1363,57.01%,35.88%,1
宜蘭縣,宜蘭市,0012,603,263,866,23,889,1540,57.73%,39.16%,1
宜蘭縣,宜蘭市,0013,514,219,733,28,761,1341,56.75%,38.33%,1
宜蘭縣,宜蘭市,0014,494,174,668,21,689,1209,56.99%,40.86%,1
宜蘭縣,宜蘭市,0015,342,151,493,28,521,900,57.89%,38%,1
宜蘭縣,宜蘭市,0016,362,139,501,18,519,980,52.96%,36.94%,1
宜蘭縣,宜蘭市,0017,413,212,625,30,655,1165,56.22%,35.45%,1
宜蘭縣,宜蘭市,0018,364,119,483,22,505,904,55.86%,40.27%,1
宜蘭縣,宜蘭市,0019,336,118,454,15,469,813,57.69%,41.33%,1
宜蘭縣,宜蘭市,0020,395,124,519,27,546,978,55.83%,40.39%,1
宜蘭縣,宜蘭市,0021,462,100,562,20,582,1282,45.4%,36.04%,1
宜蘭縣,宜蘭市,0022,179,85,264,10,274,465,58.92%,38.49%,1
宜蘭縣,宜蘭市,0023,283,100,383,14,397,669,59.34%,42.3%,1
宜蘭縣,宜蘭市,0024,368,133,501,26,527,923,57.1%,39.87%,1
宜蘭縣,宜蘭市,0025,366,151,517,21,538,1006,53.48%,36.38%,1
宜蘭縣,宜蘭市,0026,332,135,467,37,504,762,66.14%,43.57%,1
宜蘭縣,宜蘭市,0027,335,115,450,19,469,727,64.51%,46.08%,1
宜蘭縣,宜蘭市,0028,406,134,540,29,569,833,68.31%,48.74%,1
宜蘭縣,宜蘭市,0029,433,192,625,32,657,1143,57.48%,37.88%,1
宜蘭縣,宜蘭市,0030,370,160,530,16,546,979,55.77%,37.79%,1
宜蘭縣,宜蘭市,0031,465,179,644,43,687,1214,56.59%,38.3%,1
宜蘭縣,宜蘭市,0032,520,180,700,44,744,1283,57.99%,40.53%,1
宜蘭縣,宜蘭市,0033,379,148,527,26,553,946,58.46%,40.06%,1
宜蘭縣,宜蘭市,0034,402,152,554,33,587,1090,53.85%,36.88%,1
宜蘭縣,宜蘭市,0035,370,174,544,14,558,943,59.17%,39.24%,1
宜蘭縣,宜蘭市,0036,290,186,476,23,499,774,64.47%,37.47%,1
宜蘭縣,宜蘭市,0037,400,173,573,17,590,968,60.95%,41.32%,1
宜蘭縣,宜蘭市,0038,380,172,552,19,571,926,61.66%,41.04%,1
宜蘭縣,宜蘭市,0039,413,184,597,16,613,1019,60.16%,40.53%,1
宜蘭縣,宜蘭市,0040,416,169,585,33,618,1084,57.01%,38.38%,1
宜蘭縣,宜蘭市,0041,405,169,574,22,596,1095,54.43%,36.99%,1
宜蘭縣,宜蘭市,0042,402,200,602,21,623,1083,57.53%,37.12%,1
宜蘭縣,宜蘭市,0043,417,165,582,12,594,1108,53.61%,37.64%,1
宜蘭縣,宜蘭市,0044,342,146,488,8,496,848,58.49%,40.33%,1
宜蘭縣,宜蘭市,0045,409,183,592,17,609,1095,55.62%,37.35%,1
宜蘭縣,宜蘭市,0046,420,187,607,21,628,1110,56.58%,37.84%,1
宜蘭縣,宜蘭市,0047,431,186,617,29,646,1104,58.51%,39.04%,1
宜蘭縣,宜蘭市,0048,435,200,635,20,655,1134,57.76%,38.36%,1
宜蘭縣,宜蘭市,0049,442,197,639,22,661,1146,57.68%,38.57%,1
宜蘭縣,宜蘭市,0050,386,131,517,18,535,876,61.07%,44.06%,1
宜蘭縣,宜蘭市,0051,359,125,484,25,509,905,56.24%,39.67%,1
宜蘭縣,宜蘭市,0052,365,140,505,30,535,910,58.79%,40.11%,1
宜蘭縣,宜蘭市,0053,501,203,704,31,735,1434,51.26%,34.94%,1
宜蘭縣,宜蘭市,0054,429,170,599,40,639,1152,55.47%,37.24%,1
宜蘭縣,宜蘭市,0055,391,164,555,26,581,966,60.14%,40.48%,1
宜蘭縣,宜蘭市,0056,289,111,400,16,416,711,58.51%,40.65%,1
宜蘭縣,宜蘭市,0057,365,147,512,25,537,884,60.75%,41.29%,1
宜蘭縣,宜蘭市,0058,524,210,734,33,767,1326,57.84%,39.52%,1
宜蘭縣,宜蘭市,0059,303,143,446,29,475,909,52.26%,33.33%,1
宜蘭縣,宜蘭市,0060,340,126,466,25,491,894,54.92%,38.03%,1
宜蘭縣,宜蘭市,0061,450,168,618,22,640,1259,50.83%,35.74%,1
宜蘭縣,宜蘭市,0062,292,109,401,16,417,789,52.85%,37.01%,1
宜蘭縣,宜蘭市,0063,327,122,449,33,482,867,55.59%,37.72%,1
宜蘭縣,宜蘭市,0064,573,209,782,33,815,1454,56.05%,39.41%,1
宜蘭縣,宜蘭市,0065,524,148,672,21,693,1130,61.33%,46.37%,1
宜蘭縣,宜蘭市,0066,398,124,522,20,542,1087,49.86%,36.61%,1
宜蘭縣,宜蘭市,0067,415,124,539,41,580,938,61.83%,44.24%,1
宜蘭縣,宜蘭市,0068,501,188,689,36,725,1285,56.42%,38.99%,1
宜蘭縣,宜蘭市,0069,139,386,525,13,538,952,56.51%,14.6%,1
宜蘭縣,宜蘭市,0070,398,142,540,32,572,948,60.34%,41.98%,1
宜蘭縣,宜蘭市,0071,398,178,576,34,610,1160,52.59%,34.31%,1
宜蘭縣,宜蘭市,0072,423,136,559,44,603,1015,59.41%,41.67%,1
宜蘭縣,宜蘭市,0073,177,72,249,14,263,424,62.03%,41.75%,1
宜蘭縣,宜蘭市,0074,390,138,528,42,570,964,59.13%,40.46%,1
宜蘭縣,宜蘭市,0075,343,147,490,28,518,959,54.01%,35.77%,1
宜蘭縣,宜蘭市,0076,380,114,494,23,517,814,63.51%,46.68%,1
宜蘭縣,宜蘭市,0077,380,129,509,19,528,885,59.66%,42.94%,1
宜蘭縣,宜蘭市,0078,454,187,641,37,678,1162,58.35%,39.07%,1
宜蘭縣,羅東鎮,0079,276,113,389,19,408,689,59.22%,40.06%,1
宜蘭縣,羅東鎮,0080,300,82,382,18,400,718,55.71%,41.78%,1
宜蘭縣,羅東鎮,0081,556,219,775,44,819,1475,55.53%,37.69%,1
宜蘭縣,羅東鎮,0082,535,234,769,31,800,1466,54.57%,36.49%,1
宜蘭縣,羅東鎮,0083,424,159,583,23,606,1075,56.37%,39.44%,1
宜蘭縣,羅東鎮,0084,381,139,520,17,537,963,55.76%,39.56%,1
宜蘭縣,羅東鎮,0085,554,199,753,62,815,1511,53.94%,36.66%,1
宜蘭縣,羅東鎮,0086,446,174,620,25,645,1166,55.32%,38.25%,1
宜蘭縣,羅東鎮,0087,477,212,689,46,735,1273,57.74%,37.47%,1
宜蘭縣,羅東鎮,0088,644,248,892,22,914,1735,52.68%,37.12%,1
宜蘭縣,羅東鎮,0089,592,227,819,31,850,1487,57.16%,39.81%,1
宜蘭縣,羅東鎮,0090,328,152,480,23,503,837,60.1%,39.19%,1
宜蘭縣,羅東鎮,0091,558,196,754,38,792,1312,60.37%,42.53%,1
宜蘭縣,羅東鎮,0092,562,217,779,20,799,1502,53.2%,37.42%,1
宜蘭縣,羅東鎮,0093,418,172,590,17,607,1138,53.34%,36.73%,1
宜蘭縣,羅東鎮,0094,400,140,540,28,568,1010,56.24%,39.6%,1
宜蘭縣,羅東鎮,0095,547,198,745,52,797,1373,58.05%,39.84%,1
宜蘭縣,羅東鎮,0096,438,168,606,28,634,1089,58.22%,40.22%,1
宜蘭縣,羅東鎮,0097,511,173,684,29,713,1304,54.68%,39.19%,1
宜蘭縣,羅東鎮,0098,466,186,652,45,697,1288,54.11%,36.18%,1
宜蘭縣,羅東鎮,0099,448,163,611,30,641,1036,61.87%,43.24%,1
宜蘭縣,羅東鎮,0100,431,154,585,35,620,969,63.98%,44.48%,1
宜蘭縣,羅東鎮,0101,385,169,554,40,594,985,60.3%,39.09%,1
宜蘭縣,羅東鎮,0102,564,213,777,55,832,1420,58.59%,39.72%,1
宜蘭縣,羅東鎮,0103,577,209,786,34,820,1430,57.34%,40.35%,1
宜蘭縣,羅東鎮,0104,426,169,595,39,634,1075,58.98%,39.63%,1
宜蘭縣,羅東鎮,0105,354,149,503,28,531,879,60.41%,40.27%,1
宜蘭縣,羅東鎮,0106,322,137,459,17,476,850,56%,37.88%,1
宜蘭縣,羅東鎮,0107,440,205,645,19,664,1111,59.77%,39.6%,1
宜蘭縣,羅東鎮,0108,507,184,691,23,714,1139,62.69%,44.51%,1
宜蘭縣,羅東鎮,0109,481,201,682,16,698,1130,61.77%,42.57%,1
宜蘭縣,羅東鎮,0110,388,171,559,20,579,980,59.08%,39.59%,1
宜蘭縣,羅東鎮,0111,528,240,768,38,806,1431,56.32%,36.9%,1
宜蘭縣,羅東鎮,0112,440,166,606,29,635,1109,57.26%,39.68%,1
宜蘭縣,羅東鎮,0113,427,164,591,22,613,1083,56.6%,39.43%,1
宜蘭縣,羅東鎮,0114,564,217,781,35,816,1404,58.12%,40.17%,1
宜蘭縣,羅東鎮,0115,493,209,702,38,740,1288,57.45%,38.28%,1
宜蘭縣,羅東鎮,0116,375,143,518,30,548,1183,46.32%,31.7%,1
宜蘭縣,羅東鎮,0117,446,179,625,38,663,1105,60%,40.36%,1
宜蘭縣,羅東鎮,0118,403,174,577,29,606,987,61.4%,40.83%,1
宜蘭縣,羅東鎮,0119,310,128,438,37,475,773,61.45%,40.1%,1
宜蘭縣,羅東鎮,0120,578,260,838,31,869,1366,63.62%,42.31%,1
宜蘭縣,羅東鎮,0121,407,161,568,18,586,907,64.61%,44.87%,1
宜蘭縣,羅東鎮,0122,522,183,705,17,722,1158,62.35%,45.08%,1
宜蘭縣,羅東鎮,0123,386,173,559,15,574,977,58.75%,39.51%,1
宜蘭縣,羅東鎮,0124,351,152,503,29,532,972,54.73%,36.11%,1
宜蘭縣,羅東鎮,0125,388,170,558,24,582,977,59.57%,39.71%,1
宜蘭縣,羅東鎮,0126,556,231,787,39,826,1398,59.08%,39.77%,1
宜蘭縣,羅東鎮,0127,397,160,557,22,579,1022,56.65%,38.85%,1
宜蘭縣,羅東鎮,0128,483,178,661,35,696,1131,61.54%,42.71%,1
宜蘭縣,蘇澳鎮,0129,470,160,630,42,672,1194,56.28%,39.36%,1
宜蘭縣,蘇澳鎮,0130,448,148,596,30,626,1128,55.5%,39.72%,1
宜蘭縣,蘇澳鎮,0131,425,179,604,41,645,1042,61.9%,40.79%,1
宜蘭縣,蘇澳鎮,0132,392,172,564,23,587,997,58.88%,39.32%,1
宜蘭縣,蘇澳鎮,0133,512,179,691,52,743,1303,57.02%,39.29%,1
宜蘭縣,蘇澳鎮,0134,509,188,697,57,754,1260,59.84%,40.4%,1
宜蘭縣,蘇澳鎮,0135,445,153,598,41,639,1130,56.55%,39.38%,1
宜蘭縣,蘇澳鎮,0136,208,82,290,26,316,559,56.53%,37.21%,1
宜蘭縣,蘇澳鎮,0137,124,42,166,16,182,351,51.85%,35.33%,1
宜蘭縣,蘇澳鎮,0138,345,112,457,40,497,889,55.91%,38.81%,1
宜蘭縣,蘇澳鎮,0139,163,58,221,20,241,434,55.53%,37.56%,1
宜蘭縣,蘇澳鎮,0140,344,139,483,26,509,835,60.96%,41.2%,1
宜蘭縣,蘇澳鎮,0141,376,158,534,25,559,975,57.33%,38.56%,1
宜蘭縣,蘇澳鎮,0142,460,165,625,51,676,1135,59.56%,40.53%,1
宜蘭縣,蘇澳鎮,0143,344,142,486,28,514,788,65.23%,43.65%,1
宜蘭縣,蘇澳鎮,0144,185,56,241,17,258,469,55.01%,39.45%,1
宜蘭縣,蘇澳鎮,0145,318,103,421,24,445,811,54.87%,39.21%,1
宜蘭縣,蘇澳鎮,0146,353,110,463,14,477,867,55.02%,40.72%,1
宜蘭縣,蘇澳鎮,0147,458,144,602,41,643,1139,56.45%,40.21%,1
宜蘭縣,蘇澳鎮,0148,439,132,571,30,601,1146,52.44%,38.31%,1
宜蘭縣,蘇澳鎮,0149,459,157,616,37,653,1154,56.59%,39.77%,1
宜蘭縣,蘇澳鎮,0150,301,254,555,12,567,908,62.44%,33.15%,1
宜蘭縣,蘇澳鎮,0151,278,75,353,11,364,656,55.49%,42.38%,1
宜蘭縣,蘇澳鎮,0152,366,118,484,40,524,834,62.83%,43.88%,1
宜蘭縣,蘇澳鎮,0153,439,149,588,27,615,1025,60%,42.83%,1
宜蘭縣,蘇澳鎮,0154,182,66,248,16,264,455,58.02%,40%,1
宜蘭縣,蘇澳鎮,0155,218,69,287,27,314,535,58.69%,40.75%,1
宜蘭縣,蘇澳鎮,0156,238,82,320,22,342,536,63.81%,44.4%,1
宜蘭縣,蘇澳鎮,0157,193,71,264,12,276,451,61.2%,42.79%,1
宜蘭縣,蘇澳鎮,0158,224,80,304,28,332,593,55.99%,37.77%,1
宜蘭縣,蘇澳鎮,0159,186,47,233,21,254,441,57.6%,42.18%,1
宜蘭縣,蘇澳鎮,0160,401,113,514,36,550,954,57.65%,42.03%,1
宜蘭縣,蘇澳鎮,0161,379,106,485,34,519,952,54.52%,39.81%,1
宜蘭縣,蘇澳鎮,0162,394,141,535,54,589,1125,52.36%,35.02%,1
宜蘭縣,蘇澳鎮,0163,280,88,368,60,428,763,56.09%,36.7%,1
宜蘭縣,蘇澳鎮,0164,235,63,298,23,321,706,45.47%,33.29%,1
宜蘭縣,蘇澳鎮,0165,371,111,482,43,525,1068,49.16%,34.74%,1
宜蘭縣,蘇澳鎮,0166,244,108,352,36,388,666,58.26%,36.64%,1
宜蘭縣,蘇澳鎮,0167,215,62,277,51,328,574,57.14%,37.46%,1
宜蘭縣,蘇澳鎮,0168,110,48,158,8,166,351,47.29%,31.34%,1
宜蘭縣,蘇澳鎮,0169,298,77,375,30,405,717,56.49%,41.56%,1
宜蘭縣,蘇澳鎮,0170,118,18,136,21,157,373,42.09%,31.64%,1
宜蘭縣,蘇澳鎮,0171,60,22,82,13,95,223,42.6%,26.91%,1
宜蘭縣,頭城鎮,0172,80,16,96,11,107,292,36.64%,27.4%,1
宜蘭縣,頭城鎮,0173,241,90,331,38,369,688,53.63%,35.03%,1
宜蘭縣,頭城鎮,0174,282,94,376,20,396,688,57.56%,40.99%,1
宜蘭縣,頭城鎮,0175,334,89,423,31,454,879,51.65%,38%,1
宜蘭縣,頭城鎮,0176,144,40,184,20,204,335,60.9%,42.99%,1
宜蘭縣,頭城鎮,0177,280,87,367,26,393,624,62.98%,44.87%,1
宜蘭縣,頭城鎮,0178,239,85,324,21,345,732,47.13%,32.65%,1
宜蘭縣,頭城鎮,0179,266,113,379,40,419,892,46.97%,29.82%,1
宜蘭縣,頭城鎮,0180,209,81,290,23,313,690,45.36%,30.29%,1
宜蘭縣,頭城鎮,0181,310,116,426,26,452,842,53.68%,36.82%,1
宜蘭縣,頭城鎮,0182,274,111,385,26,411,736,55.84%,37.23%,1
宜蘭縣,頭城鎮,0183,278,106,384,16,400,788,50.76%,35.28%,1
宜蘭縣,頭城鎮,0184,195,68,263,25,288,560,51.43%,34.82%,1
宜蘭縣,頭城鎮,0185,295,110,405,20,425,712,59.69%,41.43%,1
宜蘭縣,頭城鎮,0186,227,72,299,23,322,502,64.14%,45.22%,1
宜蘭縣,頭城鎮,0187,238,102,340,19,359,569,63.09%,41.83%,1
宜蘭縣,頭城鎮,0188,253,83,336,25,361,633,57.03%,39.97%,1
宜蘭縣,頭城鎮,0189,357,131,488,49,537,1132,47.44%,31.54%,1
宜蘭縣,頭城鎮,0190,348,114,462,34,496,1035,47.92%,33.62%,1
宜蘭縣,頭城鎮,0191,363,117,480,23,503,847,59.39%,42.86%,1
宜蘭縣,頭城鎮,0192,433,201,634,27,661,1172,56.4%,36.95%,1
宜蘭縣,頭城鎮,0193,322,124,446,26,472,896,52.68%,35.94%,1
宜蘭縣,頭城鎮,0194,430,175,605,23,628,1075,58.42%,40%,1
宜蘭縣,頭城鎮,0195,374,134,508,41,549,931,58.97%,40.17%,1
宜蘭縣,頭城鎮,0196,398,124,522,40,562,1021,55.04%,38.98%,1
宜蘭縣,頭城鎮,0197,254,76,330,21,351,709,49.51%,35.83%,1
宜蘭縣,頭城鎮,0198,332,76,408,34,442,689,64.15%,48.19%,1
宜蘭縣,頭城鎮,0199,256,99,355,29,384,615,62.44%,41.63%,1
宜蘭縣,頭城鎮,0200,298,94,392,22,414,759,54.55%,39.26%,1
宜蘭縣,頭城鎮,0201,408,119,527,36,563,917,61.4%,44.49%,1
宜蘭縣,頭城鎮,0202,414,132,546,56,602,1045,57.61%,39.62%,1
宜蘭縣,頭城鎮,0203,459,137,596,42,638,1130,56.46%,40.62%,1
宜蘭縣,礁溪鄉,0204,418,120,538,24,562,1122,50.09%,37.25%,1
宜蘭縣,礁溪鄉,0205,187,65,252,15,267,505,52.87%,37.03%,1
宜蘭縣,礁溪鄉,0206,359,124,483,29,512,988,51.82%,36.34%,1
宜蘭縣,礁溪鄉,0207,376,123,499,22,521,971,53.66%,38.72%,1
宜蘭縣,礁溪鄉,0208,437,153,590,31,621,1246,49.84%,35.07%,1
宜蘭縣,礁溪鄉,0209,538,227,765,19,784,1655,47.37%,32.51%,1
宜蘭縣,礁溪鄉,0210,363,125,488,23,511,1132,45.14%,32.07%,1
宜蘭縣,礁溪鄉,0211,305,115,420,24,444,783,56.7%,38.95%,1
宜蘭縣,礁溪鄉,0212,396,75,471,29,500,928,53.88%,42.67%,1
宜蘭縣,礁溪鄉,0213,327,109,436,23,459,848,54.13%,38.56%,1
宜蘭縣,礁溪鄉,0214,272,125,397,23,420,663,63.35%,41.03%,1
宜蘭縣,礁溪鄉,0215,239,85,324,18,342,608,56.25%,39.31%,1
宜蘭縣,礁溪鄉,0216,343,107,450,23,473,833,56.78%,41.18%,1
宜蘭縣,礁溪鄉,0217,397,179,576,25,601,1233,48.74%,32.2%,1
宜蘭縣,礁溪鄉,0218,316,122,438,43,481,854,56.32%,37%,1
宜蘭縣,礁溪鄉,0219,193,91,284,21,305,575,53.04%,33.57%,1
宜蘭縣,礁溪鄉,0220,304,129,433,36,469,835,56.17%,36.41%,1
宜蘭縣,礁溪鄉,0221,507,203,710,39,749,1305,57.39%,38.85%,1
宜蘭縣,礁溪鄉,0222,314,114,428,34,462,830,55.66%,37.83%,1
宜蘭縣,礁溪鄉,0223,285,107,392,36,428,649,65.95%,43.91%,1
宜蘭縣,礁溪鄉,0224,327,108,435,31,466,923,50.49%,35.43%,1
宜蘭縣,礁溪鄉,0225,390,132,522,37,559,1177,47.49%,33.14%,1
宜蘭縣,礁溪鄉,0226,322,115,437,25,462,840,55%,38.33%,1
宜蘭縣,礁溪鄉,0227,428,150,578,25,603,1051,57.37%,40.72%,1
宜蘭縣,礁溪鄉,0228,478,169,647,29,676,1339,50.49%,35.7%,1
宜蘭縣,礁溪鄉,0229,527,155,682,26,708,1194,59.3%,44.14%,1
宜蘭縣,礁溪鄉,0230,572,185,757,37,794,1314,60.43%,43.53%,1
宜蘭縣,礁溪鄉,0231,421,181,602,30,632,1125,56.18%,37.42%,1
宜蘭縣,礁溪鄉,0232,496,172,668,56,724,1207,59.98%,41.09%,1
宜蘭縣,礁溪鄉,0233,376,143,519,30,549,979,56.08%,38.41%,1
宜蘭縣,礁溪鄉,0234,422,121,543,41,584,954,61.22%,44.23%,1
宜蘭縣,礁溪鄉,0235,160,57,217,14,231,418,55.26%,38.28%,1
宜蘭縣,壯圍鄉,0236,598,206,804,65,869,1435,60.56%,41.67%,1
宜蘭縣,壯圍鄉,0237,487,120,607,26,633,1049,60.34%,46.43%,1
宜蘭縣,壯圍鄉,0238,450,173,623,35,658,1068,61.61%,42.13%,1
宜蘭縣,壯圍鄉,0239,338,123,461,44,505,868,58.18%,38.94%,1
宜蘭縣,壯圍鄉,0240,417,111,528,17,545,967,56.36%,43.12%,1
宜蘭縣,壯圍鄉,0241,395,148,543,42,585,940,62.23%,42.02%,1
宜蘭縣,壯圍鄉,0242,342,117,459,26,485,975,49.74%,35.08%,1
宜蘭縣,壯圍鄉,0243,329,124,453,41,494,797,61.98%,41.28%,1
宜蘭縣,壯圍鄉,0244,250,204,454,21,475,808,58.79%,30.94%,1
宜蘭縣,壯圍鄉,0245,363,141,504,44,548,911,60.15%,39.85%,1
宜蘭縣,壯圍鄉,0246,238,59,297,19,316,612,51.63%,38.89%,1
宜蘭縣,壯圍鄉,0247,358,107,465,37,502,790,63.54%,45.32%,1
宜蘭縣,壯圍鄉,0248,369,128,497,32,529,878,60.25%,42.03%,1
宜蘭縣,壯圍鄉,0249,323,121,444,31,475,723,65.7%,44.67%,1
宜蘭縣,壯圍鄉,0250,291,88,379,17,396,737,53.73%,39.48%,1
宜蘭縣,壯圍鄉,0251,288,97,385,29,414,686,60.35%,41.98%,1
宜蘭縣,壯圍鄉,0252,360,122,482,8,490,895,54.75%,40.22%,1
宜蘭縣,壯圍鄉,0253,541,169,710,47,757,1237,61.2%,43.73%,1
宜蘭縣,壯圍鄉,0254,428,175,603,48,651,1134,57.41%,37.74%,1
宜蘭縣,壯圍鄉,0255,442,144,586,34,620,1107,56.01%,39.93%,1
宜蘭縣,壯圍鄉,0256,469,145,614,32,646,1057,61.12%,44.37%,1
宜蘭縣,壯圍鄉,0257,376,133,509,36,545,1051,51.86%,35.78%,1
宜蘭縣,壯圍鄉,0258,252,118,370,34,404,722,55.96%,34.9%,1
宜蘭縣,員山鄉,0259,445,204,649,26,675,1393,48.46%,31.95%,1
宜蘭縣,員山鄉,0260,310,140,450,15,465,895,51.96%,34.64%,1
宜蘭縣,員山鄉,0261,486,139,625,49,674,1231,54.75%,39.48%,1
宜蘭縣,員山鄉,0262,406,146,552,17,569,1098,51.82%,36.98%,1
宜蘭縣,員山鄉,0263,366,145,511,36,547,1031,53.06%,35.5%,1
宜蘭縣,員山鄉,0264,402,110,512,45,557,1030,54.08%,39.03%,1
宜蘭縣,員山鄉,0265,392,127,519,39,558,1168,47.77%,33.56%,1
宜蘭縣,員山鄉,0266,328,98,426,39,465,809,57.48%,40.54%,1
宜蘭縣,員山鄉,0267,281,134,415,32,447,778,57.46%,36.12%,1
宜蘭縣,員山鄉,0268,582,217,799,49,848,1465,57.88%,39.73%,1
宜蘭縣,員山鄉,0269,390,152,542,42,584,979,59.65%,39.84%,1
宜蘭縣,員山鄉,0270,339,115,454,29,483,860,56.16%,39.42%,1
宜蘭縣,員山鄉,0271,337,135,472,128,600,1205,49.79%,27.97%,1
宜蘭縣,員山鄉,0272,435,137,572,42,614,1082,56.75%,40.2%,1
宜蘭縣,員山鄉,0273,181,53,234,13,247,412,59.95%,43.93%,1
宜蘭縣,員山鄉,0274,150,38,188,17,205,403,50.87%,37.22%,1
宜蘭縣,員山鄉,0275,84,15,99,5,104,232,44.83%,36.21%,1
宜蘭縣,員山鄉,0276,352,135,487,25,512,944,54.24%,37.29%,1
宜蘭縣,員山鄉,0277,326,130,456,45,501,894,56.04%,36.47%,1
宜蘭縣,員山鄉,0278,562,172,734,26,760,1356,56.05%,41.45%,1
宜蘭縣,員山鄉,0279,328,105,433,26,459,780,58.85%,42.05%,1
宜蘭縣,員山鄉,0280,409,150,559,30,589,932,63.2%,43.88%,1
宜蘭縣,員山鄉,0281,220,69,289,17,306,583,52.49%,37.74%,1
宜蘭縣,員山鄉,0282,369,97,466,34,500,900,55.56%,41%,1
宜蘭縣,員山鄉,0283,281,96,377,36,413,747,55.29%,37.62%,1
宜蘭縣,員山鄉,0284,303,107,410,24,434,788,55.08%,38.45%,1
宜蘭縣,員山鄉,0285,308,124,432,36,468,884,52.94%,34.84%,1
宜蘭縣,員山鄉,0286,324,104,428,18,446,857,52.04%,37.81%,1
宜蘭縣,員山鄉,0287,364,138,502,22,524,1016,51.57%,35.83%,1
宜蘭縣,員山鄉,0288,202,79,281,29,310,690,44.93%,29.28%,1
宜蘭縣,員山鄉,0289,244,78,322,45,367,689,53.27%,35.41%,1
宜蘭縣,冬山鄉,0290,321,127,448,38,486,807,60.22%,39.78%,1
宜蘭縣,冬山鄉,0291,335,141,476,12,488,817,59.73%,41%,1
宜蘭縣,冬山鄉,0292,444,182,626,34,660,1156,57.09%,38.41%,1
宜蘭縣,冬山鄉,0293,345,108,453,33,486,892,54.48%,38.68%,1
宜蘭縣,冬山鄉,0294,482,22,504,24,528,897,58.86%,53.73%,1
宜蘭縣,冬山鄉,0295,614,193,807,35,842,1392,60.49%,44.11%,1
宜蘭縣,冬山鄉,0296,507,307,814,28,842,1471,57.24%,34.47%,1
宜蘭縣,冬山鄉,0297,491,175,666,25,691,1435,48.15%,34.22%,1
宜蘭縣,冬山鄉,0298,546,217,763,28,791,1519,52.07%,35.94%,1
宜蘭縣,冬山鄉,0299,566,255,821,24,845,1456,58.04%,38.87%,1
宜蘭縣,冬山鄉,0300,297,111,408,32,440,711,61.88%,41.77%,1
宜蘭縣,冬山鄉,0301,292,98,390,19,409,694,58.93%,42.07%,1
宜蘭縣,冬山鄉,0302,616,319,935,46,981,1526,64.29%,40.37%,1
宜蘭縣,冬山鄉,0303,346,129,475,22,497,884,56.22%,39.14%,1
宜蘭縣,冬山鄉,0304,474,200,674,46,720,1465,49.15%,32.35%,1
宜蘭縣,冬山鄉,0305,219,53,272,14,286,488,58.61%,44.88%,1
宜蘭縣,冬山鄉,0306,480,132,612,39,651,1218,53.45%,39.41%,1
宜蘭縣,冬山鄉,0307,488,148,636,29,665,1291,51.51%,37.8%,1
宜蘭縣,冬山鄉,0308,497,150,647,25,672,1324,50.76%,37.54%,1
宜蘭縣,冬山鄉,0309,397,143,540,35,575,1160,49.57%,34.22%,1
宜蘭縣,冬山鄉,0310,472,159,631,40,671,1246,53.85%,37.88%,1
宜蘭縣,冬山鄉,0311,659,231,890,26,916,1754,52.22%,37.57%,1
宜蘭縣,冬山鄉,0312,459,159,618,29,647,1217,53.16%,37.72%,1
宜蘭縣,冬山鄉,0313,496,189,685,37,722,1495,48.29%,33.18%,1
宜蘭縣,冬山鄉,0314,335,140,475,36,511,937,54.54%,35.75%,1
宜蘭縣,冬山鄉,0315,403,149,552,24,576,1101,52.32%,36.6%,1
宜蘭縣,冬山鄉,0316,409,142,551,35,586,1118,52.42%,36.58%,1
宜蘭縣,冬山鄉,0317,529,206,735,30,765,1301,58.8%,40.66%,1
宜蘭縣,冬山鄉,0318,454,180,634,17,651,1225,53.14%,37.06%,1
宜蘭縣,冬山鄉,0319,489,189,678,28,706,1206,58.54%,40.55%,1
宜蘭縣,冬山鄉,0320,470,158,628,24,652,1278,51.02%,36.78%,1
宜蘭縣,冬山鄉,0321,424,150,574,30,604,1151,52.48%,36.84%,1
宜蘭縣,冬山鄉,0322,388,115,503,37,540,1094,49.36%,35.47%,1
宜蘭縣,冬山鄉,0323,483,190,673,35,708,1247,56.78%,38.73%,1
宜蘭縣,冬山鄉,0324,433,160,593,38,631,1247,50.6%,34.72%,1
宜蘭縣,冬山鄉,0325,377,139,516,22,538,979,54.95%,38.51%,1
宜蘭縣,冬山鄉,0326,294,116,410,13,423,698,60.6%,42.12%,1
宜蘭縣,冬山鄉,0327,625,254,879,38,917,1726,53.13%,36.21%,1
宜蘭縣,冬山鄉,0328,273,85,358,15,373,782,47.7%,34.91%,1
宜蘭縣,五結鄉,0329,404,121,525,34,559,1076,51.95%,37.55%,1
宜蘭縣,五結鄉,0330,339,152,491,14,505,944,53.5%,35.91%,1
宜蘭縣,五結鄉,0331,363,117,480,14,494,836,59.09%,43.42%,1
宜蘭縣,五結鄉,0332,362,149,511,23,534,937,56.99%,38.63%,1
宜蘭縣,五結鄉,0333,469,172,641,22,663,1255,52.83%,37.37%,1
宜蘭縣,五結鄉,0334,446,208,654,33,687,1270,54.09%,35.12%,1
宜蘭縣,五結鄉,0335,310,89,399,18,417,801,52.06%,38.7%,1
宜蘭縣,五結鄉,0336,289,109,398,20,418,802,52.12%,36.03%,1
宜蘭縣,五結鄉,0337,456,167,623,33,656,1306,50.23%,34.92%,1
宜蘭縣,五結鄉,0338,401,199,600,28,628,1190,52.77%,33.7%,1
宜蘭縣,五結鄉,0339,488,191,679,23,702,1316,53.34%,37.08%,1
宜蘭縣,五結鄉,0340,380,140,520,26,546,965,56.58%,39.38%,1
宜蘭縣,五結鄉,0341,308,106,414,25,439,814,53.93%,37.84%,1
宜蘭縣,五結鄉,0342,479,153,632,23,655,1254,52.23%,38.2%,1
宜蘭縣,五結鄉,0343,440,141,581,24,605,1060,57.08%,41.51%,1
宜蘭縣,五結鄉,0344,485,227,712,28,740,1323,55.93%,36.66%,1
宜蘭縣,五結鄉,0345,451,161,612,29,641,1120,57.23%,40.27%,1
宜蘭縣,五結鄉,0346,343,121,464,15,479,893,53.64%,38.41%,1
宜蘭縣,五結鄉,0347,414,188,602,43,645,1220,52.87%,33.93%,1
宜蘭縣,五結鄉,0348,381,137,518,21,539,924,58.33%,41.23%,1
宜蘭縣,五結鄉,0349,395,146,541,26,567,933,60.77%,42.34%,1
宜蘭縣,五結鄉,0350,399,109,508,20,528,986,53.55%,40.47%,1
宜蘭縣,五結鄉,0351,280,98,378,30,408,748,54.55%,37.43%,1
宜蘭縣,五結鄉,0352,563,217,780,58,838,1550,54.06%,36.32%,1
宜蘭縣,五結鄉,0353,271,72,343,20,363,629,57.71%,43.08%,1
宜蘭縣,五結鄉,0354,329,90,419,25,444,806,55.09%,40.82%,1
宜蘭縣,五結鄉,0355,323,151,474,28,502,956,52.51%,33.79%,1
宜蘭縣,五結鄉,0356,414,123,537,32,569,1066,53.38%,38.84%,1
宜蘭縣,五結鄉,0357,503,189,692,59,751,1513,49.64%,33.25%,1
宜蘭縣,五結鄉,0358,604,193,797,35,832,1566,53.13%,38.57%,1
宜蘭縣,五結鄉,0359,329,138,467,30,497,894,55.59%,36.8%,1
宜蘭縣,五結鄉,0360,373,163,536,47,583,1235,47.21%,30.2%,1
宜蘭縣,五結鄉,0361,284,89,373,25,398,704,56.53%,40.34%,1
宜蘭縣,三星鄉,0362,81,28,109,9,118,215,54.88%,37.67%,1
宜蘭縣,三星鄉,0363,185,40,225,16,241,523,46.08%,35.37%,1
宜蘭縣,三星鄉,0364,257,106,363,27,390,745,52.35%,34.5%,1
宜蘭縣,三星鄉,0365,225,79,304,20,324,617,52.51%,36.47%,1
宜蘭縣,三星鄉,0366,196,56,252,16,268,497,53.92%,39.44%,1
宜蘭縣,三星鄉,0367,290,89,379,36,415,735,56.46%,39.46%,1
宜蘭縣,三星鄉,0368,229,72,301,26,327,583,56.09%,39.28%,1
宜蘭縣,三星鄉,0369,187,32,219,15,234,436,53.67%,42.89%,1
宜蘭縣,三星鄉,0370,461,162,623,28,651,1224,53.19%,37.66%,1
宜蘭縣,三星鄉,0371,435,131,566,18,584,1151,50.74%,37.79%,1
宜蘭縣,三星鄉,0372,358,107,465,15,480,870,55.17%,41.15%,1
宜蘭縣,三星鄉,0373,392,109,501,35,536,1284,41.74%,30.53%,1
宜蘭縣,三星鄉,0374,361,139,500,33,533,897,59.42%,40.25%,1
宜蘭縣,三星鄉,0375,570,180,750,35,785,1439,54.55%,39.61%,1
宜蘭縣,三星鄉,0376,510,197,707,33,740,1445,51.21%,35.29%,1
宜蘭縣,三星鄉,0377,545,164,709,37,746,1402,53.21%,38.87%,1
宜蘭縣,三星鄉,0378,461,165,626,22,648,1230,52.68%,37.48%,1
宜蘭縣,三星鄉,0379,289,103,392,40,432,774,55.81%,37.34%,1
宜蘭縣,三星鄉,0380,120,335,455,27,482,827,58.28%,14.51%,1
宜蘭縣,三星鄉,0381,271,118,389,21,410,736,55.71%,36.82%,1
宜蘭縣,三星鄉,0382,527,185,712,38,750,1421,52.78%,37.09%,1
宜蘭縣,大同鄉,0383,472,84,556,24,580,893,64.95%,52.86%,1
宜蘭縣,大同鄉,0384,384,67,451,11,462,632,73.1%,60.76%,1
宜蘭縣,大同鄉,0385,385,59,444,16,460,684,67.25%,56.29%,1
宜蘭縣,大同鄉,0386,136,35,171,6,177,264,67.05%,51.52%,1
宜蘭縣,大同鄉,0387,204,21,225,4,229,337,67.95%,60.53%,1
宜蘭縣,大同鄉,0388,287,31,318,7,325,404,80.45%,71.04%,1
宜蘭縣,大同鄉,0389,20,4,24,3,27,55,49.09%,36.36%,1
宜蘭縣,大同鄉,0390,130,18,148,8,156,199,78.39%,65.33%,1
宜蘭縣,大同鄉,0391,525,71,596,21,617,787,78.4%,66.71%,1
宜蘭縣,大同鄉,0392,458,53,511,13,524,680,77.06%,67.35%,1
宜蘭縣,南澳鄉,0393,229,50,279,7,286,444,64.41%,51.58%,1
宜蘭縣,南澳鄉,0394,487,111,598,19,617,1210,50.99%,40.25%,1
宜蘭縣,南澳鄉,0395,537,64,601,38,639,962,66.42%,55.82%,1
宜蘭縣,南澳鄉,0396,214,35,249,4,253,411,61.56%,52.07%,1
宜蘭縣,南澳鄉,0397,259,40,299,15,314,447,70.25%,57.94%,1
宜蘭縣,南澳鄉,0398,295,55,350,18,368,475,77.47%,62.11%,1
宜蘭縣,南澳鄉,0399,345,46,391,23,414,695,59.57%,49.64%,1
花蓮縣,花蓮市,0001,631,228,859,9,868,1522,57.03%,41.46%,1
花蓮縣,花蓮市,0002,473,155,628,24,652,1114,58.53%,42.46%,1
花蓮縣,花蓮市,0003,277,87,364,13,377,670,56.27%,41.34%,1
花蓮縣,花蓮市,0004,530,194,724,14,738,1397,52.83%,37.94%,1
花蓮縣,花蓮市,0005,176,52,228,11,239,470,50.85%,37.45%,1
花蓮縣,花蓮市,0006,339,70,409,28,437,838,52.15%,40.45%,1
花蓮縣,花蓮市,0007,263,45,308,10,318,721,44.11%,36.48%,1
花蓮縣,花蓮市,0008,386,116,502,30,532,918,57.95%,42.05%,1
花蓮縣,花蓮市,0009,562,225,787,25,812,1539,52.76%,36.52%,1
花蓮縣,花蓮市,0010,569,159,728,20,748,1403,53.31%,40.56%,1
花蓮縣,花蓮市,0011,535,21,556,12,568,1068,53.18%,50.09%,1
花蓮縣,花蓮市,0012,485,145,630,16,646,1167,55.36%,41.56%,1
花蓮縣,花蓮市,0013,566,163,729,28,757,1259,60.13%,44.96%,1
花蓮縣,花蓮市,0014,448,114,562,33,595,1071,55.56%,41.83%,1
花蓮縣,花蓮市,0015,385,127,512,17,529,925,57.19%,41.62%,1
花蓮縣,花蓮市,0016,502,181,683,30,713,1141,62.49%,44%,1
花蓮縣,花蓮市,0017,453,155,608,9,617,1163,53.05%,38.95%,1
花蓮縣,花蓮市,0018,556,177,733,18,751,1279,58.72%,43.47%,1
花蓮縣,花蓮市,0019,553,184,737,18,755,1512,49.93%,36.57%,1
花蓮縣,花蓮市,0020,245,80,325,9,334,615,54.31%,39.84%,1
花蓮縣,花蓮市,0021,248,98,346,11,357,606,58.91%,40.92%,1
花蓮縣,花蓮市,0022,220,56,276,5,281,559,50.27%,39.36%,1
花蓮縣,花蓮市,0023,190,56,246,4,250,442,56.56%,42.99%,1
花蓮縣,花蓮市,0024,434,127,561,17,578,1114,51.89%,38.96%,1
花蓮縣,花蓮市,0025,178,54,232,9,241,416,57.93%,42.79%,1
花蓮縣,花蓮市,0026,262,82,344,11,355,577,61.53%,45.41%,1
花蓮縣,花蓮市,0027,343,129,472,22,494,810,60.99%,42.35%,1
花蓮縣,花蓮市,0028,224,70,294,15,309,538,57.43%,41.64%,1
花蓮縣,花蓮市,0029,223,69,292,18,310,566,54.77%,39.4%,1
花蓮縣,花蓮市,0030,205,61,266,6,272,469,58%,43.71%,1
花蓮縣,花蓮市,0031,234,81,315,11,326,565,57.7%,41.42%,1
花蓮縣,花蓮市,0032,294,94,388,16,404,816,49.51%,36.03%,1
花蓮縣,花蓮市,0033,363,100,463,19,482,911,52.91%,39.85%,1
花蓮縣,花蓮市,0034,412,102,514,25,539,1029,52.38%,40.04%,1
花蓮縣,花蓮市,0035,463,130,593,23,616,1043,59.06%,44.39%,1
花蓮縣,花蓮市,0036,362,116,478,17,495,856,57.83%,42.29%,1
花蓮縣,花蓮市,0037,388,142,530,15,545,979,55.67%,39.63%,1
花蓮縣,花蓮市,0038,551,173,724,30,754,1331,56.65%,41.4%,1
花蓮縣,花蓮市,0039,519,161,680,16,696,1228,56.68%,42.26%,1
花蓮縣,花蓮市,0040,419,109,528,19,547,955,57.28%,43.87%,1
花蓮縣,花蓮市,0041,470,156,626,19,645,1268,50.87%,37.07%,1
花蓮縣,花蓮市,0042,479,143,622,23,645,1230,52.44%,38.94%,1
花蓮縣,花蓮市,0043,585,155,740,34,774,1369,56.54%,42.73%,1
花蓮縣,花蓮市,0044,482,171,653,22,675,1435,47.04%,33.59%,1
花蓮縣,花蓮市,0045,476,142,618,21,639,1164,54.9%,40.89%,1
花蓮縣,花蓮市,0046,552,164,716,26,742,1249,59.41%,44.2%,1
花蓮縣,花蓮市,0047,470,153,623,35,658,1184,55.57%,39.7%,1
花蓮縣,花蓮市,0048,556,209,765,17,782,1490,52.48%,37.32%,1
花蓮縣,花蓮市,0049,458,158,616,25,641,1022,62.72%,44.81%,1
花蓮縣,花蓮市,0050,477,140,617,20,637,1135,56.12%,42.03%,1
花蓮縣,花蓮市,0051,478,112,590,20,610,1084,56.27%,44.1%,1
花蓮縣,花蓮市,0052,350,130,480,19,499,1339,37.27%,26.14%,1
花蓮縣,花蓮市,0053,219,69,288,13,301,501,60.08%,43.71%,1
花蓮縣,花蓮市,0054,377,116,493,11,504,904,55.75%,41.7%,1
花蓮縣,花蓮市,0055,222,72,294,10,304,490,62.04%,45.31%,1
花蓮縣,花蓮市,0056,426,128,554,25,579,1192,48.57%,35.74%,1
花蓮縣,花蓮市,0057,314,105,419,16,435,869,50.06%,36.13%,1
花蓮縣,花蓮市,0058,488,169,657,20,677,1267,53.43%,38.52%,1
花蓮縣,花蓮市,0059,412,127,539,19,558,959,58.19%,42.96%,1
花蓮縣,花蓮市,0060,415,112,527,18,545,993,54.88%,41.79%,1
花蓮縣,花蓮市,0061,380,139,519,33,552,982,56.21%,38.7%,1
花蓮縣,花蓮市,0062,462,170,632,13,645,1311,49.2%,35.24%,1
花蓮縣,花蓮市,0063,540,180,720,30,750,1455,51.55%,37.11%,1
花蓮縣,花蓮市,0064,422,108,530,8,538,1151,46.74%,36.66%,1
花蓮縣,花蓮市,0065,467,131,598,12,610,1237,49.31%,37.75%,1
花蓮縣,花蓮市,0066,445,175,620,26,646,1339,48.24%,33.23%,1
花蓮縣,花蓮市,0067,296,97,393,25,418,715,58.46%,41.4%,1
花蓮縣,花蓮市,0068,411,131,542,18,560,1000,56%,41.1%,1
花蓮縣,花蓮市,0069,516,164,680,20,700,1410,49.65%,36.6%,1
花蓮縣,花蓮市,0070,527,166,693,16,709,1303,54.41%,40.45%,1
花蓮縣,花蓮市,0071,516,139,655,19,674,1256,53.66%,41.08%,1
花蓮縣,花蓮市,0072,478,123,601,35,636,1105,57.56%,43.26%,1
花蓮縣,花蓮市,0073,396,141,537,21,558,1089,51.24%,36.36%,1
花蓮縣,花蓮市,0074,401,112,513,17,530,1043,50.81%,38.45%,1
花蓮縣,花蓮市,0075,476,132,608,12,620,1080,57.41%,44.07%,1
花蓮縣,花蓮市,0076,427,117,544,4,548,971,56.44%,43.98%,1
花蓮縣,花蓮市,0077,413,171,584,29,613,1068,57.4%,38.67%,1
花蓮縣,花蓮市,0078,520,155,675,18,693,1379,50.25%,37.71%,1
花蓮縣,花蓮市,0079,516,182,698,19,717,1362,52.64%,37.89%,1
花蓮縣,花蓮市,0080,520,216,736,22,758,1323,57.29%,39.3%,1
花蓮縣,花蓮市,0081,518,148,666,15,681,1482,45.95%,34.95%,1
花蓮縣,鳳林鎮,0195,567,113,680,55,735,1192,61.66%,47.57%,1
花蓮縣,鳳林鎮,0196,249,55,304,22,326,639,51.02%,38.97%,1
花蓮縣,鳳林鎮,0197,297,75,372,30,402,601,66.89%,49.42%,1
花蓮縣,鳳林鎮,0198,540,146,686,43,729,1137,64.12%,47.49%,1
花蓮縣,鳳林鎮,0199,300,87,387,30,417,742,56.2%,40.43%,1
花蓮縣,鳳林鎮,0200,275,58,333,18,351,610,57.54%,45.08%,1
花蓮縣,鳳林鎮,0201,128,44,172,20,192,295,65.08%,43.39%,1
花蓮縣,鳳林鎮,0202,67,9,76,1,77,218,35.32%,30.73%,1
花蓮縣,鳳林鎮,0203,241,63,304,27,331,720,45.97%,33.47%,1
花蓮縣,鳳林鎮,0204,206,65,271,20,291,528,55.11%,39.02%,1
花蓮縣,鳳林鎮,0205,220,60,280,13,293,560,52.32%,39.29%,1
花蓮縣,鳳林鎮,0206,221,45,266,25,291,541,53.79%,40.85%,1
花蓮縣,鳳林鎮,0207,338,81,419,45,464,818,56.72%,41.32%,1
花蓮縣,鳳林鎮,0208,312,87,399,35,434,984,44.11%,31.71%,1
花蓮縣,鳳林鎮,0209,31,10,41,9,50,91,54.95%,34.07%,1
花蓮縣,玉里鎮,0254,409,109,518,31,549,1008,54.46%,40.58%,1
花蓮縣,玉里鎮,0255,445,78,523,37,560,939,59.64%,47.39%,1
花蓮縣,玉里鎮,0256,506,114,620,38,658,1256,52.39%,40.29%,1
花蓮縣,玉里鎮,0257,362,106,468,41,509,929,54.79%,38.97%,1
花蓮縣,玉里鎮,0258,405,106,511,25,536,979,54.75%,41.37%,1
花蓮縣,玉里鎮,0259,547,149,696,34,730,1244,58.68%,43.97%,1
花蓮縣,玉里鎮,0260,301,90,391,27,418,847,49.35%,35.54%,1
花蓮縣,玉里鎮,0261,276,78,354,28,382,772,49.48%,35.75%,1
花蓮縣,玉里鎮,0262,206,57,263,16,279,558,50%,36.92%,1
花蓮縣,玉里鎮,0263,200,45,245,16,261,800,32.63%,25%,1
花蓮縣,玉里鎮,0264,469,95,564,39,603,1286,46.89%,36.47%,1
花蓮縣,玉里鎮,0265,446,108,554,44,598,1246,47.99%,35.79%,1
花蓮縣,玉里鎮,0266,247,64,311,37,348,647,53.79%,38.18%,1
花蓮縣,玉里鎮,0267,311,54,365,25,390,990,39.39%,31.41%,1
花蓮縣,玉里鎮,0268,204,42,246,21,267,530,50.38%,38.49%,1
花蓮縣,玉里鎮,0269,323,68,391,35,426,979,43.51%,32.99%,1
花蓮縣,玉里鎮,0270,249,34,283,37,320,557,57.45%,44.7%,1
花蓮縣,玉里鎮,0271,160,26,186,21,207,434,47.7%,36.87%,1
花蓮縣,玉里鎮,0272,280,60,340,54,394,1065,37%,26.29%,1
花蓮縣,玉里鎮,0273,348,75,423,45,468,866,54.04%,40.18%,1
花蓮縣,玉里鎮,0274,327,55,382,22,404,769,52.54%,42.52%,1
花蓮縣,玉里鎮,0275,256,83,339,32,371,869,42.69%,29.46%,1
花蓮縣,玉里鎮,0276,320,86,406,44,450,1080,41.67%,29.63%,1
花蓮縣,新城鄉,0082,159,50,209,5,214,367,58.31%,43.32%,1
花蓮縣,新城鄉,0083,364,87,451,21,472,929,50.81%,39.18%,1
花蓮縣,新城鄉,0084,238,75,313,44,357,590,60.51%,40.34%,1
花蓮縣,新城鄉,0085,117,40,157,16,173,307,56.35%,38.11%,1
花蓮縣,新城鄉,0086,120,27,147,14,161,260,61.92%,46.15%,1
花蓮縣,新城鄉,0087,511,169,680,39,719,1283,56.04%,39.83%,1
花蓮縣,新城鄉,0088,370,74,444,19,463,885,52.32%,41.81%,1
花蓮縣,新城鄉,0089,316,101,417,32,449,770,58.31%,41.04%,1
花蓮縣,新城鄉,0090,564,153,717,23,740,1363,54.29%,41.38%,1
花蓮縣,新城鄉,0091,140,45,185,10,195,366,53.28%,38.25%,1
花蓮縣,新城鄉,0092,428,131,559,31,590,1163,50.73%,36.8%,1
花蓮縣,新城鄉,0093,632,197,829,25,854,1605,53.21%,39.38%,1
花蓮縣,新城鄉,0094,509,131,640,21,661,1194,55.36%,42.63%,1
花蓮縣,新城鄉,0095,421,112,533,24,557,979,56.89%,43%,1
花蓮縣,新城鄉,0096,625,175,800,27,827,1485,55.69%,42.09%,1
花蓮縣,新城鄉,0097,416,121,537,22,559,1070,52.24%,38.88%,1
花蓮縣,新城鄉,0098,452,163,615,20,635,1164,54.55%,38.83%,1
花蓮縣,新城鄉,0099,350,85,435,35,470,880,53.41%,39.77%,1
花蓮縣,新城鄉,0100,139,39,178,8,186,369,50.41%,37.67%,1
花蓮縣,吉安鄉,0115,414,124,538,21,559,1059,52.79%,39.09%,1
花蓮縣,吉安鄉,0116,386,128,514,33,547,983,55.65%,39.27%,1
花蓮縣,吉安鄉,0117,423,107,530,34,564,1031,54.7%,41.03%,1
花蓮縣,吉安鄉,0118,422,128,550,21,571,1105,51.67%,38.19%,1
花蓮縣,吉安鄉,0119,531,28,559,23,582,1107,52.57%,47.97%,1
花蓮縣,吉安鄉,0120,439,126,565,26,591,1179,50.13%,37.23%,1
花蓮縣,吉安鄉,0121,489,146,635,32,667,1453,45.91%,33.65%,1
花蓮縣,吉安鄉,0122,595,208,803,40,843,1432,58.87%,41.55%,1
花蓮縣,吉安鄉,0123,532,167,699,30,729,1320,55.23%,40.3%,1
花蓮縣,吉安鄉,0124,536,145,681,23,704,1356,51.92%,39.53%,1
花蓮縣,吉安鄉,0125,518,139,657,22,679,1295,52.43%,40%,1
花蓮縣,吉安鄉,0126,590,175,765,33,798,1467,54.4%,40.22%,1
花蓮縣,吉安鄉,0127,598,175,773,18,791,1515,52.21%,39.47%,1
花蓮縣,吉安鄉,0128,467,140,607,23,630,1063,59.27%,43.93%,1
花蓮縣,吉安鄉,0129,409,147,556,11,567,1284,44.16%,31.85%,1
花蓮縣,吉安鄉,0130,557,190,747,27,774,1380,56.09%,40.36%,1
花蓮縣,吉安鄉,0131,537,173,710,27,737,1297,56.82%,41.4%,1
花蓮縣,吉安鄉,0132,599,212,811,50,861,1662,51.81%,36.04%,1
花蓮縣,吉安鄉,0133,563,156,719,39,758,1563,48.5%,36.02%,1
花蓮縣,吉安鄉,0134,472,107,579,42,621,1288,48.21%,36.65%,1
花蓮縣,吉安鄉,0135,403,109,512,17,529,907,58.32%,44.43%,1
花蓮縣,吉安鄉,0136,362,91,453,21,474,917,51.69%,39.48%,1
花蓮縣,吉安鄉,0137,398,117,515,11,526,1021,51.52%,38.98%,1
花蓮縣,吉安鄉,0138,447,136,583,31,614,1033,59.44%,43.27%,1
花蓮縣,吉安鄉,0139,413,113,526,29,555,966,57.45%,42.75%,1
花蓮縣,吉安鄉,0140,469,123,592,35,627,1188,52.78%,39.48%,1
花蓮縣,吉安鄉,0141,592,155,747,27,774,1480,52.3%,40%,1
花蓮縣,吉安鄉,0142,506,140,646,29,675,1393,48.46%,36.32%,1
花蓮縣,吉安鄉,0143,458,129,587,25,612,1193,51.3%,38.39%,1
花蓮縣,吉安鄉,0144,527,148,675,28,703,1445,48.65%,36.47%,1
花蓮縣,吉安鄉,0145,490,152,642,70,712,1301,54.73%,37.66%,1
花蓮縣,吉安鄉,0146,515,145,660,32,692,1215,56.95%,42.39%,1
花蓮縣,吉安鄉,0147,459,136,595,16,611,1135,53.83%,40.44%,1
花蓮縣,吉安鄉,0148,549,127,676,17,693,1223,56.66%,44.89%,1
花蓮縣,吉安鄉,0149,540,139,679,20,699,1274,54.87%,42.39%,1
花蓮縣,吉安鄉,0150,453,121,574,24,598,1124,53.2%,40.3%,1
花蓮縣,吉安鄉,0151,476,157,633,18,651,1158,56.22%,41.11%,1
花蓮縣,吉安鄉,0152,483,156,639,10,649,1157,56.09%,41.75%,1
花蓮縣,吉安鄉,0153,515,153,668,26,694,1258,55.17%,40.94%,1
花蓮縣,吉安鄉,0154,499,144,643,27,670,1257,53.3%,39.7%,1
花蓮縣,吉安鄉,0155,499,144,643,10,653,1245,52.45%,40.08%,1
花蓮縣,吉安鄉,0156,479,162,641,8,649,1166,55.66%,41.08%,1
花蓮縣,吉安鄉,0157,555,134,689,23,712,1358,52.43%,40.87%,1
花蓮縣,吉安鄉,0158,490,117,607,22,629,1214,51.81%,40.36%,1
花蓮縣,吉安鄉,0159,451,134,585,29,614,1151,53.34%,39.18%,1
花蓮縣,吉安鄉,0160,494,136,630,18,648,1157,56.01%,42.7%,1
花蓮縣,吉安鄉,0161,504,140,644,15,659,1161,56.76%,43.41%,1
花蓮縣,吉安鄉,0162,538,177,715,22,737,1304,56.52%,41.26%,1
花蓮縣,吉安鄉,0163,533,163,696,28,724,1367,52.96%,38.99%,1
花蓮縣,吉安鄉,0164,495,148,643,19,662,1411,46.92%,35.08%,1
花蓮縣,吉安鄉,0165,537,136,673,13,686,1409,48.69%,38.11%,1
花蓮縣,吉安鄉,0166,419,100,519,20,539,1125,47.91%,37.24%,1
花蓮縣,吉安鄉,0167,511,120,631,39,670,1213,55.23%,42.13%,1
花蓮縣,吉安鄉,0168,497,118,615,11,626,1141,54.86%,43.56%,1
花蓮縣,吉安鄉,0169,424,104,528,19,547,1156,47.32%,36.68%,1
花蓮縣,吉安鄉,0170,427,107,534,31,565,1092,51.74%,39.1%,1
花蓮縣,吉安鄉,0171,348,94,442,25,467,1026,45.52%,33.92%,1
花蓮縣,吉安鄉,0172,335,75,410,18,428,804,53.23%,41.67%,1
花蓮縣,吉安鄉,0173,481,123,604,25,629,1132,55.57%,42.49%,1
花蓮縣,壽豐鄉,0174,425,87,512,33,545,1052,51.81%,40.4%,1
花蓮縣,壽豐鄉,0175,165,36,201,17,218,357,61.06%,46.22%,1
花蓮縣,壽豐鄉,0176,379,91,470,45,515,1022,50.39%,37.08%,1
花蓮縣,壽豐鄉,0177,409,108,517,31,548,875,62.63%,46.74%,1
花蓮縣,壽豐鄉,0178,293,102,395,31,426,691,61.65%,42.4%,1
花蓮縣,壽豐鄉,0179,288,63,351,18,369,708,52.12%,40.68%,1
花蓮縣,壽豐鄉,0180,328,107,435,40,475,894,53.13%,36.69%,1
花蓮縣,壽豐鄉,0181,300,91,391,16,407,746,54.56%,40.21%,1
花蓮縣,壽豐鄉,0182,349,101,450,24,474,881,53.8%,39.61%,1
花蓮縣,壽豐鄉,0183,327,87,414,17,431,695,62.01%,47.05%,1
花蓮縣,壽豐鄉,0184,386,98,484,38,522,816,63.97%,47.3%,1
花蓮縣,壽豐鄉,0185,301,73,374,21,395,773,51.1%,38.94%,1
花蓮縣,壽豐鄉,0186,432,125,557,33,590,1029,57.34%,41.98%,1
花蓮縣,壽豐鄉,0187,203,40,243,14,257,407,63.14%,49.88%,1
花蓮縣,壽豐鄉,0188,468,143,611,41,652,1139,57.24%,41.09%,1
花蓮縣,壽豐鄉,0189,365,184,549,25,574,996,57.63%,36.65%,1
花蓮縣,壽豐鄉,0190,143,36,179,10,189,414,45.65%,34.54%,1
花蓮縣,壽豐鄉,0191,116,30,146,11,157,270,58.15%,42.96%,1
花蓮縣,壽豐鄉,0192,378,86,464,24,488,836,58.37%,45.22%,1
花蓮縣,壽豐鄉,0193,224,66,290,20,310,507,61.14%,44.18%,1
花蓮縣,壽豐鄉,0194,238,50,288,28,316,739,42.76%,32.21%,1
花蓮縣,光復鄉,0210,552,144,696,36,732,1295,56.53%,42.63%,1
花蓮縣,光復鄉,0211,363,110,473,36,509,859,59.25%,42.26%,1
花蓮縣,光復鄉,0212,442,82,524,50,574,958,59.92%,46.14%,1
花蓮縣,光復鄉,0213,447,86,533,59,592,1011,58.56%,44.21%,1
花蓮縣,光復鄉,0214,458,102,560,46,606,1041,58.21%,44%,1
花蓮縣,光復鄉,0215,323,86,409,47,456,821,55.54%,39.34%,1
花蓮縣,光復鄉,0216,45,7,52,6,58,188,30.85%,23.94%,1
花蓮縣,光復鄉,0217,213,48,261,22,283,514,55.06%,41.44%,1
花蓮縣,光復鄉,0218,148,30,178,14,192,446,43.05%,33.18%,1
花蓮縣,光復鄉,0219,380,70,450,31,481,851,56.52%,44.65%,1
花蓮縣,光復鄉,0220,296,91,387,23,410,932,43.99%,31.76%,1
花蓮縣,光復鄉,0221,201,50,251,17,268,471,56.9%,42.68%,1
花蓮縣,光復鄉,0222,242,68,310,47,357,640,55.78%,37.81%,1
花蓮縣,光復鄉,0223,41,4,45,3,48,116,41.38%,35.34%,1
花蓮縣,光復鄉,0224,140,34,174,8,182,496,36.69%,28.23%,1
花蓮縣,光復鄉,0225,108,30,138,8,146,324,45.06%,33.33%,1
花蓮縣,光復鄉,0226,131,28,159,20,179,454,39.43%,28.85%,1
花蓮縣,豐濱鄉,0227,256,75,331,19,350,717,48.81%,35.7%,1
花蓮縣,豐濱鄉,0228,215,90,305,21,326,751,43.41%,28.63%,1
花蓮縣,豐濱鄉,0229,216,58,274,24,298,613,48.61%,35.24%,1
花蓮縣,豐濱鄉,0230,361,87,448,23,471,809,58.22%,44.62%,1
花蓮縣,豐濱鄉,0231,115,23,138,5,143,357,40.06%,32.21%,1
花蓮縣,豐濱鄉,0232,248,72,320,21,341,669,50.97%,37.07%,1
花蓮縣,豐濱鄉,0233,163,56,219,7,226,479,47.18%,34.03%,1
花蓮縣,瑞穗鄉,0241,370,71,441,32,473,813,58.18%,45.51%,1
花蓮縣,瑞穗鄉,0242,462,109,571,35,606,1091,55.55%,42.35%,1
花蓮縣,瑞穗鄉,0243,372,94,466,12,478,839,56.97%,44.34%,1
花蓮縣,瑞穗鄉,0244,435,87,522,35,557,975,57.13%,44.62%,1
花蓮縣,瑞穗鄉,0245,206,42,248,11,259,546,47.44%,37.73%,1
花蓮縣,瑞穗鄉,0246,420,115,535,36,571,1002,56.99%,41.92%,1
花蓮縣,瑞穗鄉,0247,202,46,248,28,276,593,46.54%,34.06%,1
花蓮縣,瑞穗鄉,0248,400,105,505,51,556,965,57.62%,41.45%,1
花蓮縣,瑞穗鄉,0249,361,84,445,33,478,863,55.39%,41.83%,1
花蓮縣,瑞穗鄉,0250,95,12,107,6,113,340,33.24%,27.94%,1
花蓮縣,瑞穗鄉,0251,260,60,320,34,354,764,46.34%,34.03%,1
花蓮縣,瑞穗鄉,0252,209,46,255,13,268,868,30.88%,24.08%,1
花蓮縣,瑞穗鄉,0253,195,31,226,10,236,620,38.06%,31.45%,1
花蓮縣,富里鄉,0277,153,28,181,18,199,467,42.61%,32.76%,1
花蓮縣,富里鄉,0278,289,73,362,44,406,1032,39.34%,28%,1
花蓮縣,富里鄉,0279,220,40,260,23,283,638,44.36%,34.48%,1
花蓮縣,富里鄉,0280,241,51,292,29,321,591,54.31%,40.78%,1
花蓮縣,富里鄉,0281,429,118,547,46,593,1087,54.55%,39.47%,1
花蓮縣,富里鄉,0282,153,56,209,15,224,431,51.97%,35.5%,1
花蓮縣,富里鄉,0283,315,81,396,38,434,893,48.6%,35.27%,1
花蓮縣,富里鄉,0284,108,25,133,16,149,361,41.27%,29.92%,1
花蓮縣,富里鄉,0285,386,116,502,47,549,1362,40.31%,28.34%,1
花蓮縣,富里鄉,0286,165,40,205,33,238,458,51.97%,36.03%,1
花蓮縣,富里鄉,0287,135,40,175,33,208,621,33.49%,21.74%,1
花蓮縣,富里鄉,0288,176,41,217,26,243,493,49.29%,35.7%,1
花蓮縣,富里鄉,0289,224,56,280,21,301,631,47.7%,35.5%,1
花蓮縣,秀林鄉,0101,347,75,422,28,450,867,51.9%,40.02%,1
花蓮縣,秀林鄉,0102,214,82,296,11,307,575,53.39%,37.22%,1
花蓮縣,秀林鄉,0103,424,111,535,31,566,1373,41.22%,30.88%,1
花蓮縣,秀林鄉,0104,616,140,756,35,791,1644,48.11%,37.47%,1
花蓮縣,秀林鄉,0105,77,11,88,2,90,162,55.56%,47.53%,1
花蓮縣,秀林鄉,0106,134,48,182,19,201,384,52.34%,34.9%,1
花蓮縣,秀林鄉,0107,468,155,623,43,666,1382,48.19%,33.86%,1
花蓮縣,秀林鄉,0108,437,139,576,25,601,1125,53.42%,38.84%,1
花蓮縣,秀林鄉,0109,215,80,295,19,314,627,50.08%,34.29%,1
花蓮縣,秀林鄉,0110,403,118,521,30,551,987,55.83%,40.83%,1
花蓮縣,秀林鄉,0111,500,147,647,56,703,1139,61.72%,43.9%,1
花蓮縣,秀林鄉,0112,559,100,659,11,670,1213,55.23%,46.08%,1
花蓮縣,秀林鄉,0113,317,97,414,16,430,754,57.03%,42.04%,1
花蓮縣,秀林鄉,0114,134,22,156,9,165,330,50%,40.61%,1
花蓮縣,萬榮鄉,0234,433,126,559,44,603,1072,56.25%,40.39%,1
花蓮縣,萬榮鄉,0235,252,52,304,6,310,560,55.36%,45%,1
花蓮縣,萬榮鄉,0236,378,80,458,25,483,773,62.48%,48.9%,1
花蓮縣,萬榮鄉,0237,258,57,315,11,326,661,49.32%,39.03%,1
花蓮縣,萬榮鄉,0238,226,39,265,15,280,442,63.35%,51.13%,1
花蓮縣,萬榮鄉,0239,283,55,338,23,361,675,53.48%,41.93%,1
花蓮縣,萬榮鄉,0240,546,152,698,48,746,1086,68.69%,50.28%,1
花蓮縣,卓溪鄉,0290,212,56,268,25,293,533,54.97%,39.77%,1
花蓮縣,卓溪鄉,0291,255,63,318,21,339,522,64.94%,48.85%,1
花蓮縣,卓溪鄉,0292,233,74,307,10,317,493,64.3%,47.26%,1
花蓮縣,卓溪鄉,0293,373,49,422,19,441,701,62.91%,53.21%,1
花蓮縣,卓溪鄉,0294,337,79,416,27,443,746,59.38%,45.17%,1
花蓮縣,卓溪鄉,0295,287,67,354,35,389,616,63.15%,46.59%,1
花蓮縣,卓溪鄉,0296,156,39,195,7,202,405,49.88%,38.52%,1
花蓮縣,卓溪鄉,0297,145,28,173,7,180,329,54.71%,44.07%,1
花蓮縣,卓溪鄉,0298,198,29,227,9,236,428,55.14%,46.26%,1
花蓮縣,卓溪鄉,0299,82,12,94,4,98,174,56.32%,47.13%,1
臺東縣,臺東市,0001,339,82,421,16,437,874,50%,38.79%,1
臺東縣,臺東市,0002,648,220,868,37,905,1469,61.61%,44.11%,1
臺東縣,臺東市,0003,528,151,679,25,704,1259,55.92%,41.94%,1
臺東縣,臺東市,0004,564,192,756,25,781,1399,55.83%,40.31%,1
臺東縣,臺東市,0005,608,209,817,25,842,1363,61.78%,44.61%,1
臺東縣,臺東市,0006,689,187,876,31,907,1651,54.94%,41.73%,1
臺東縣,臺東市,0007,709,188,897,32,929,1490,62.35%,47.58%,1
臺東縣,臺東市,0008,343,93,436,24,460,859,53.55%,39.93%,1
臺東縣,臺東市,0009,381,139,520,22,542,890,60.9%,42.81%,1
臺東縣,臺東市,0010,284,72,356,21,377,651,57.91%,43.63%,1
臺東縣,臺東市,0011,614,192,806,24,830,1650,50.3%,37.21%,1
臺東縣,臺東市,0012,330,103,433,18,451,724,62.29%,45.58%,1
臺東縣,臺東市,0013,279,87,366,16,382,632,60.44%,44.15%,1
臺東縣,臺東市,0014,336,97,433,31,464,771,60.18%,43.58%,1
臺東縣,臺東市,0015,312,99,411,17,428,798,53.63%,39.1%,1
臺東縣,臺東市,0016,533,137,670,49,719,1299,55.35%,41.03%,1
臺東縣,臺東市,0017,340,122,462,26,488,811,60.17%,41.92%,1
臺東縣,臺東市,0018,362,115,477,16,493,764,64.53%,47.38%,1
臺東縣,臺東市,0019,305,110,415,11,426,784,54.34%,38.9%,1
臺東縣,臺東市,0020,163,56,219,6,225,427,52.69%,38.17%,1
臺東縣,臺東市,0021,485,145,630,26,656,1292,50.77%,37.54%,1
臺東縣,臺東市,0022,739,137,876,1,877,1501,58.43%,49.23%,1
臺東縣,臺東市,0023,229,66,295,17,312,601,51.91%,38.1%,1
臺東縣,臺東市,0024,144,69,213,9,222,417,53.24%,34.53%,1
臺東縣,臺東市,0025,427,103,530,34,564,1001,56.34%,42.66%,1
臺東縣,臺東市,0026,707,214,921,33,954,1638,58.24%,43.16%,1
臺東縣,臺東市,0027,662,176,838,37,875,1576,55.52%,42.01%,1
臺東縣,臺東市,0028,654,198,852,40,892,1595,55.92%,41%,1
臺東縣,臺東市,0029,720,225,945,24,969,1734,55.88%,41.52%,1
臺東縣,臺東市,0030,614,202,816,40,856,1476,57.99%,41.6%,1
臺東縣,臺東市,0031,656,255,911,23,934,1545,60.45%,42.46%,1
臺東縣,臺東市,0032,580,137,717,41,758,1313,57.73%,44.17%,1
臺東縣,臺東市,0033,644,151,795,24,819,1338,61.21%,48.13%,1
臺東縣,臺東市,0034,607,128,735,17,752,1312,57.32%,46.27%,1
臺東縣,臺東市,0035,569,161,730,18,748,1265,59.13%,44.98%,1
臺東縣,臺東市,0036,489,162,651,32,683,1407,48.54%,34.75%,1
臺東縣,臺東市,0037,575,155,730,31,761,1552,49.03%,37.05%,1
臺東縣,臺東市,0038,600,164,764,49,813,1445,56.26%,41.52%,1
臺東縣,臺東市,0039,878,294,1172,46,1218,2098,58.06%,41.85%,1
臺東縣,臺東市,0040,588,140,728,58,786,1324,59.37%,44.41%,1
臺東縣,臺東市,0041,696,168,864,23,887,1598,55.51%,43.55%,1
臺東縣,臺東市,0042,619,163,782,22,804,1513,53.14%,40.91%,1
臺東縣,臺東市,0043,650,185,835,23,858,1679,51.1%,38.71%,1
臺東縣,臺東市,0044,557,190,747,26,773,1414,54.67%,39.39%,1
臺東縣,臺東市,0045,699,238,937,22,959,1798,53.34%,38.88%,1
臺東縣,臺東市,0046,638,178,816,36,852,1749,48.71%,36.48%,1
臺東縣,臺東市,0047,690,193,883,59,942,1709,55.12%,40.37%,1
臺東縣,臺東市,0048,651,178,829,31,860,1629,52.79%,39.96%,1
臺東縣,臺東市,0049,450,113,563,34,597,1116,53.49%,40.32%,1
臺東縣,臺東市,0050,423,137,560,17,577,1259,45.83%,33.6%,1
臺東縣,臺東市,0051,434,127,561,19,580,1232,47.08%,35.23%,1
臺東縣,臺東市,0052,543,159,702,69,771,1505,51.23%,36.08%,1
臺東縣,臺東市,0053,298,80,378,26,404,836,48.33%,35.65%,1
臺東縣,臺東市,0054,544,161,705,31,736,1294,56.88%,42.04%,1
臺東縣,臺東市,0055,513,166,679,44,723,1350,53.56%,38%,1
臺東縣,臺東市,0056,878,250,1128,70,1198,2162,55.41%,40.61%,1
臺東縣,臺東市,0057,687,246,933,35,968,1627,59.5%,42.22%,1
臺東縣,臺東市,0058,504,150,654,25,679,1140,59.56%,44.21%,1
臺東縣,臺東市,0059,550,163,713,22,735,1359,54.08%,40.47%,1
臺東縣,臺東市,0060,553,156,709,30,739,1329,55.61%,41.61%,1
臺東縣,臺東市,0061,398,100,498,20,518,990,52.32%,40.2%,1
臺東縣,臺東市,0062,448,111,559,34,593,1038,57.13%,43.16%,1
臺東縣,臺東市,0063,633,167,800,42,842,1597,52.72%,39.64%,1
臺東縣,臺東市,0064,509,185,694,53,747,1385,53.94%,36.75%,1
臺東縣,臺東市,0065,325,114,439,12,451,939,48.03%,34.61%,1
臺東縣,臺東市,0066,426,122,548,28,576,1258,45.79%,33.86%,1
臺東縣,臺東市,0067,484,159,643,7,650,1350,48.15%,35.85%,1
臺東縣,臺東市,0068,397,95,492,14,506,1058,47.83%,37.52%,1
臺東縣,臺東市,0069,335,73,408,19,427,895,47.71%,37.43%,1
臺東縣,成功鎮,0070,227,47,274,17,291,516,56.4%,43.99%,1
臺東縣,成功鎮,0071,439,103,542,41,583,960,60.73%,45.73%,1
臺東縣,成功鎮,0072,139,17,156,8,164,365,44.93%,38.08%,1
臺東縣,成功鎮,0073,258,53,311,34,345,747,46.18%,34.54%,1
臺東縣,成功鎮,0074,123,25,148,12,160,339,47.2%,36.28%,1
臺東縣,成功鎮,0075,361,93,454,19,473,995,47.54%,36.28%,1
臺東縣,成功鎮,0076,356,87,443,40,483,863,55.97%,41.25%,1
臺東縣,成功鎮,0077,302,76,378,34,412,931,44.25%,32.44%,1
臺東縣,成功鎮,0078,380,100,480,19,499,970,51.44%,39.18%,1
臺東縣,成功鎮,0079,514,126,640,60,700,1365,51.28%,37.66%,1
臺東縣,成功鎮,0080,559,104,663,60,723,1366,52.93%,40.92%,1
臺東縣,成功鎮,0081,204,41,245,20,265,516,51.36%,39.53%,1
臺東縣,成功鎮,0082,304,71,375,37,412,887,46.45%,34.27%,1
臺東縣,成功鎮,0083,167,37,204,15,219,488,44.88%,34.22%,1
臺東縣,成功鎮,0084,134,40,174,22,196,481,40.75%,27.86%,1
臺東縣,成功鎮,0085,135,21,156,5,161,373,43.16%,36.19%,1
臺東縣,成功鎮,0086,91,33,124,22,146,264,55.3%,34.47%,1
臺東縣,關山鎮,0087,392,129,521,19,540,909,59.41%,43.12%,1
臺東縣,關山鎮,0088,243,80,323,19,342,790,43.29%,30.76%,1
臺東縣,關山鎮,0089,360,103,463,38,501,828,60.51%,43.48%,1
臺東縣,關山鎮,0090,299,83,382,15,397,887,44.76%,33.71%,1
臺東縣,關山鎮,0091,463,122,585,38,623,1137,54.79%,40.72%,1
臺東縣,關山鎮,0092,256,66,322,30,352,732,48.09%,34.97%,1
臺東縣,關山鎮,0093,331,113,444,32,476,912,52.19%,36.29%,1
臺東縣,關山鎮,0094,246,64,310,10,320,779,41.08%,31.58%,1
臺東縣,關山鎮,0095,138,50,188,15,203,535,37.94%,25.79%,1
臺東縣,卑南鄉,0096,444,122,566,41,607,1041,58.31%,42.65%,1
臺東縣,卑南鄉,0097,436,114,550,28,578,1165,49.61%,37.42%,1
臺東縣,卑南鄉,0098,72,18,90,13,103,219,47.03%,32.88%,1
臺東縣,卑南鄉,0099,163,47,210,13,223,460,48.48%,35.43%,1
臺東縣,卑南鄉,0100,108,36,144,11,155,387,40.05%,27.91%,1
臺東縣,卑南鄉,0101,276,69,345,18,363,767,47.33%,35.98%,1
臺東縣,卑南鄉,0102,211,45,256,17,273,503,54.27%,41.95%,1
臺東縣,卑南鄉,0103,243,71,314,38,352,727,48.42%,33.43%,1
臺東縣,卑南鄉,0104,173,39,212,19,231,436,52.98%,39.68%,1
臺東縣,卑南鄉,0105,64,24,88,8,96,261,36.78%,24.52%,1
臺東縣,卑南鄉,0106,77,29,106,11,117,215,54.42%,35.81%,1
臺東縣,卑南鄉,0107,518,252,770,39,809,1442,56.1%,35.92%,1
臺東縣,卑南鄉,0108,223,36,259,5,264,527,50.09%,42.31%,1
臺東縣,卑南鄉,0109,413,129,542,40,582,1046,55.64%,39.48%,1
臺東縣,卑南鄉,0110,432,121,553,44,597,1110,53.78%,38.92%,1
臺東縣,卑南鄉,0111,456,145,601,33,634,1105,57.38%,41.27%,1
臺東縣,卑南鄉,0112,564,126,690,45,735,1167,62.98%,48.33%,1
臺東縣,卑南鄉,0113,331,97,428,39,467,968,48.24%,34.19%,1
臺東縣,卑南鄉,0114,43,16,59,3,62,159,38.99%,27.04%,1
臺東縣,卑南鄉,0115,167,38,205,15,220,488,45.08%,34.22%,1
臺東縣,卑南鄉,0116,159,29,188,16,204,347,58.79%,45.82%,1
臺東縣,卑南鄉,0117,174,40,214,24,238,436,54.59%,39.91%,1
臺東縣,鹿野鄉,0118,139,52,191,6,197,522,37.74%,26.63%,1
臺東縣,鹿野鄉,0119,221,70,291,21,312,574,54.36%,38.5%,1
臺東縣,鹿野鄉,0120,292,109,401,24,425,1055,40.28%,27.68%,1
臺東縣,鹿野鄉,0121,366,122,488,31,519,1104,47.01%,33.15%,1
臺東縣,鹿野鄉,0122,115,26,141,14,155,342,45.32%,33.63%,1
臺東縣,鹿野鄉,0123,316,75,391,32,423,895,47.26%,35.31%,1
臺東縣,鹿野鄉,0124,275,100,375,47,422,864,48.84%,31.83%,1
臺東縣,鹿野鄉,0125,204,67,271,21,292,675,43.26%,30.22%,1
臺東縣,鹿野鄉,0126,148,49,197,18,215,435,49.43%,34.02%,1
臺東縣,鹿野鄉,0127,114,48,162,26,188,470,40%,24.26%,1
臺東縣,池上鄉,0128,341,108,449,23,472,992,47.58%,34.38%,1
臺東縣,池上鄉,0129,384,107,491,25,516,929,55.54%,41.33%,1
臺東縣,池上鄉,0130,146,36,182,29,211,434,48.62%,33.64%,1
臺東縣,池上鄉,0131,202,66,268,40,308,703,43.81%,28.73%,1
臺東縣,池上鄉,0132,213,54,267,19,286,654,43.73%,32.57%,1
臺東縣,池上鄉,0133,87,26,113,15,128,324,39.51%,26.85%,1
臺東縣,池上鄉,0134,252,81,333,28,361,794,45.47%,31.74%,1
臺東縣,池上鄉,0135,316,74,390,25,415,856,48.48%,36.92%,1
臺東縣,池上鄉,0136,103,20,123,19,142,344,41.28%,29.94%,1
臺東縣,池上鄉,0137,116,36,152,22,174,311,55.95%,37.3%,1
臺東縣,池上鄉,0138,99,27,126,11,137,386,35.49%,25.65%,1
臺東縣,池上鄉,0139,98,33,131,20,151,435,34.71%,22.53%,1
臺東縣,東河鄉,0140,98,22,120,8,128,290,44.14%,33.79%,1
臺東縣,東河鄉,0141,268,66,334,18,352,620,56.77%,43.23%,1
臺東縣,東河鄉,0142,533,161,694,48,742,1196,62.04%,44.57%,1
臺東縣,東河鄉,0143,324,86,410,46,456,918,49.67%,35.29%,1
臺東縣,東河鄉,0144,211,41,252,9,261,555,47.03%,38.02%,1
臺東縣,東河鄉,0145,320,84,404,23,427,977,43.71%,32.75%,1
臺東縣,東河鄉,0146,281,69,350,27,377,1197,31.5%,23.48%,1
臺東縣,東河鄉,0147,158,40,198,15,213,867,24.57%,18.22%,1
臺東縣,東河鄉,0148,110,27,137,11,148,345,42.9%,31.88%,1
臺東縣,東河鄉,0149,116,40,156,14,170,408,41.67%,28.43%,1
臺東縣,東河鄉,0150,87,21,108,6,114,262,43.51%,33.21%,1
臺東縣,長濱鄉,0151,210,67,277,32,309,536,57.65%,39.18%,1
臺東縣,長濱鄉,0152,167,44,211,20,231,689,33.53%,24.24%,1
臺東縣,長濱鄉,0153,366,80,446,64,510,913,55.86%,40.09%,1
臺東縣,長濱鄉,0154,381,88,469,18,487,1268,38.41%,30.05%,1
臺東縣,長濱鄉,0155,259,84,343,27,370,725,51.03%,35.72%,1
臺東縣,長濱鄉,0156,121,34,155,4,159,532,29.89%,22.74%,1
臺東縣,長濱鄉,0157,194,49,243,36,279,660,42.27%,29.39%,1
臺東縣,長濱鄉,0158,93,11,104,5,109,336,32.44%,27.68%,1
臺東縣,長濱鄉,0159,45,13,58,6,64,195,32.82%,23.08%,1
臺東縣,長濱鄉,0160,9,0,9,4,13,25,52%,36%,1
臺東縣,長濱鄉,0161,192,47,239,30,269,605,44.46%,31.74%,1
臺東縣,太麻里鄉,0162,274,81,355,29,384,722,53.19%,37.95%,1
臺東縣,太麻里鄉,0163,232,53,285,13,298,575,51.83%,40.35%,1
臺東縣,太麻里鄉,0164,225,62,287,27,314,623,50.4%,36.12%,1
臺東縣,太麻里鄉,0165,229,51,280,24,304,622,48.87%,36.82%,1
臺東縣,太麻里鄉,0166,226,54,280,13,293,560,52.32%,40.36%,1
臺東縣,太麻里鄉,0167,454,80,534,26,560,957,58.52%,47.44%,1
臺東縣,太麻里鄉,0168,323,68,391,19,410,809,50.68%,39.93%,1
臺東縣,太麻里鄉,0169,300,98,398,18,416,673,61.81%,44.58%,1
臺東縣,太麻里鄉,0170,298,58,356,24,380,737,51.56%,40.43%,1
臺東縣,太麻里鄉,0171,187,38,225,17,242,424,57.08%,44.1%,1
臺東縣,太麻里鄉,0172,133,38,171,8,179,374,47.86%,35.56%,1
臺東縣,太麻里鄉,0173,442,98,540,10,550,829,66.34%,53.32%,1
臺東縣,太麻里鄉,0174,435,81,516,12,528,869,60.76%,50.06%,1
臺東縣,太麻里鄉,0175,95,17,112,9,121,223,54.26%,42.6%,1
臺東縣,太麻里鄉,0176,275,55,330,35,365,669,54.56%,41.11%,1
臺東縣,大武鄉,0177,298,46,344,7,351,568,61.8%,52.46%,1
臺東縣,大武鄉,0178,527,138,665,72,737,1474,50%,35.75%,1
臺東縣,大武鄉,0179,537,139,676,32,708,1327,53.35%,40.47%,1
臺東縣,大武鄉,0180,377,117,494,48,542,1134,47.8%,33.25%,1
臺東縣,大武鄉,0181,173,39,212,10,222,386,57.51%,44.82%,1
臺東縣,大武鄉,0182,160,41,201,18,219,377,58.09%,42.44%,1
臺東縣,綠島鄉,0183,446,171,617,16,633,1474,42.94%,30.26%,1
臺東縣,綠島鄉,0184,325,131,456,16,472,1082,43.62%,30.04%,1
臺東縣,綠島鄉,0185,256,111,367,14,381,813,46.86%,31.49%,1
臺東縣,綠島鄉,0186,72,30,102,2,104,210,49.52%,34.29%,1
臺東縣,海端鄉,0187,200,53,253,10,263,497,52.92%,40.24%,1
臺東縣,海端鄉,0188,272,45,317,13,330,569,58%,47.8%,1
臺東縣,海端鄉,0189,374,99,473,15,488,971,50.26%,38.52%,1
臺東縣,海端鄉,0190,308,62,370,24,394,728,54.12%,42.31%,1
臺東縣,海端鄉,0191,116,24,140,8,148,259,57.14%,44.79%,1
臺東縣,海端鄉,0192,112,33,145,3,148,254,58.27%,44.09%,1
臺東縣,延平鄉,0193,421,115,536,22,558,1014,55.03%,41.52%,1
臺東縣,延平鄉,0194,228,46,274,23,297,426,69.72%,53.52%,1
臺東縣,延平鄉,0195,174,29,203,6,209,315,66.35%,55.24%,1
臺東縣,延平鄉,0196,291,64,355,7,362,579,62.52%,50.26%,1
臺東縣,延平鄉,0197,212,53,265,10,275,596,46.14%,35.57%,1
臺東縣,金峰鄉,0198,571,134,705,19,724,1241,58.34%,46.01%,1
臺東縣,金峰鄉,0199,333,85,418,15,433,601,72.05%,55.41%,1
臺東縣,金峰鄉,0200,256,106,362,31,393,520,75.58%,49.23%,1
臺東縣,金峰鄉,0201,153,29,182,9,191,336,56.85%,45.54%,1
臺東縣,金峰鄉,0202,214,43,257,8,265,330,80.3%,64.85%,1
臺東縣,達仁鄉,0203,124,21,145,9,154,246,62.6%,50.41%,1
臺東縣,達仁鄉,0204,194,28,222,3,225,340,66.18%,57.06%,1
臺東縣,達仁鄉,0205,150,37,187,8,195,296,65.88%,50.68%,1
臺東縣,達仁鄉,0206,235,46,281,12,293,429,68.3%,54.78%,1
臺東縣,達仁鄉,0207,195,30,225,9,234,331,70.69%,58.91%,1
臺東縣,達仁鄉,0208,220,73,293,10,303,628,48.25%,35.03%,1
臺東縣,達仁鄉,0209,328,117,445,29,474,867,54.67%,37.83%,1
臺東縣,蘭嶼鄉,0210,291,87,378,14,392,943,41.57%,30.86%,1
臺東縣,蘭嶼鄉,0211,377,130,507,18,525,1238,42.41%,30.45%,1
臺東縣,蘭嶼鄉,0212,370,91,461,9,470,1240,37.9%,29.84%,1
臺東縣,蘭嶼鄉,0213,179,91,270,9,279,760,36.71%,23.55%,1
澎湖縣,馬公市,0001,162,47,209,16,225,481,46.78%,33.68%,1
澎湖縣,馬公市,0002,225,55,280,8,288,558,51.61%,40.32%,1
澎湖縣,馬公市,0003,190,50,240,24,264,533,49.53%,35.65%,1
澎湖縣,馬公市,0004,348,121,469,16,485,922,52.6%,37.74%,1
澎湖縣,馬公市,0005,391,138,529,26,555,1021,54.36%,38.3%,1
澎湖縣,馬公市,0006,291,97,388,18,406,793,51.2%,36.7%,1
澎湖縣,馬公市,0007,365,124,489,24,513,954,53.77%,38.26%,1
澎湖縣,馬公市,0008,362,119,481,21,502,1001,50.15%,36.16%,1
澎湖縣,馬公市,0009,383,132,515,21,536,1192,44.97%,32.13%,1
澎湖縣,馬公市,0010,490,135,625,34,659,1402,47%,34.95%,1
澎湖縣,馬公市,0011,543,165,708,25,733,1389,52.77%,39.09%,1
澎湖縣,馬公市,0012,508,163,671,27,698,1339,52.13%,37.94%,1
澎湖縣,馬公市,0013,449,133,582,26,608,1254,48.48%,35.81%,1
澎湖縣,馬公市,0014,457,114,571,30,601,1194,50.34%,38.27%,1
澎湖縣,馬公市,0015,478,154,632,41,673,1393,48.31%,34.31%,1
澎湖縣,馬公市,0016,538,192,730,21,751,1440,52.15%,37.36%,1
澎湖縣,馬公市,0017,416,157,573,28,601,1215,49.47%,34.24%,1
澎湖縣,馬公市,0018,487,119,606,27,633,1284,49.3%,37.93%,1
澎湖縣,馬公市,0019,554,160,714,32,746,1512,49.34%,36.64%,1
澎湖縣,馬公市,0020,419,126,545,29,574,1181,48.6%,35.48%,1
澎湖縣,馬公市,0021,502,152,654,24,678,1348,50.3%,37.24%,1
澎湖縣,馬公市,0022,511,188,699,18,717,1391,51.55%,36.74%,1
澎湖縣,馬公市,0023,287,644,931,14,945,2124,44.49%,13.51%,1
澎湖縣,馬公市,0024,575,142,717,24,741,1500,49.4%,38.33%,1
澎湖縣,馬公市,0025,609,151,760,20,780,1582,49.3%,38.5%,1
澎湖縣,馬公市,0026,600,172,772,18,790,1638,48.23%,36.63%,1
澎湖縣,馬公市,0027,597,189,786,26,812,1554,52.25%,38.42%,1
澎湖縣,馬公市,0028,280,89,369,17,386,980,39.39%,28.57%,1
澎湖縣,馬公市,0029,335,100,435,16,451,892,50.56%,37.56%,1
澎湖縣,馬公市,0030,229,82,311,11,322,778,41.39%,29.43%,1
澎湖縣,馬公市,0031,362,99,461,19,480,930,51.61%,38.92%,1
澎湖縣,馬公市,0032,669,189,858,22,880,1481,59.42%,45.17%,1
澎湖縣,馬公市,0033,471,120,591,13,604,1128,53.55%,41.76%,1
澎湖縣,馬公市,0034,179,35,214,15,229,415,55.18%,43.13%,1
澎湖縣,馬公市,0035,423,119,542,18,560,1120,50%,37.77%,1
澎湖縣,馬公市,0036,407,83,490,26,516,950,54.32%,42.84%,1
澎湖縣,馬公市,0037,216,52,268,13,281,627,44.82%,34.45%,1
澎湖縣,馬公市,0038,420,116,536,14,550,1055,52.13%,39.81%,1
澎湖縣,馬公市,0039,409,89,498,24,522,989,52.78%,41.35%,1
澎湖縣,馬公市,0040,233,71,304,28,332,591,56.18%,39.42%,1
澎湖縣,馬公市,0041,474,140,614,48,662,1387,47.73%,34.17%,1
澎湖縣,馬公市,0042,332,97,429,39,468,1079,43.37%,30.77%,1
澎湖縣,馬公市,0043,307,74,381,24,405,797,50.82%,38.52%,1
澎湖縣,馬公市,0044,327,87,414,16,430,903,47.62%,36.21%,1
澎湖縣,馬公市,0045,103,54,157,18,175,376,46.54%,27.39%,1
澎湖縣,馬公市,0046,139,49,188,7,195,371,52.56%,37.47%,1
澎湖縣,馬公市,0047,398,87,485,15,500,1173,42.63%,33.93%,1
澎湖縣,馬公市,0048,407,104,511,18,529,1389,38.08%,29.3%,1
澎湖縣,馬公市,0049,159,37,196,18,214,761,28.12%,20.89%,1
澎湖縣,馬公市,0050,126,42,168,10,178,288,61.81%,43.75%,1
澎湖縣,湖西鄉,0051,456,105,561,22,583,1120,52.05%,40.71%,1
澎湖縣,湖西鄉,0052,104,27,131,10,141,332,42.47%,31.33%,1
澎湖縣,湖西鄉,0053,73,18,91,3,94,242,38.84%,30.17%,1
澎湖縣,湖西鄉,0054,84,25,109,6,115,293,39.25%,28.67%,1
澎湖縣,湖西鄉,0055,203,47,250,26,276,666,41.44%,30.48%,1
澎湖縣,湖西鄉,0056,127,28,155,8,163,326,50%,38.96%,1
澎湖縣,湖西鄉,0057,220,66,286,13,299,732,40.85%,30.05%,1
澎湖縣,湖西鄉,0058,235,59,294,6,300,651,46.08%,36.1%,1
澎湖縣,湖西鄉,0059,242,78,320,14,334,744,44.89%,32.53%,1
澎湖縣,湖西鄉,0060,55,17,72,1,73,134,54.48%,41.04%,1
澎湖縣,湖西鄉,0061,213,74,287,14,301,794,37.91%,26.83%,1
澎湖縣,湖西鄉,0062,62,15,77,1,78,216,36.11%,28.7%,1
澎湖縣,湖西鄉,0063,151,42,193,3,196,664,29.52%,22.74%,1
澎湖縣,湖西鄉,0064,108,18,126,9,135,279,48.39%,38.71%,1
澎湖縣,湖西鄉,0065,130,20,150,4,154,296,52.03%,43.92%,1
澎湖縣,湖西鄉,0066,87,34,121,0,121,257,47.08%,33.85%,1
澎湖縣,湖西鄉,0067,23,5,28,1,29,89,32.58%,25.84%,1
澎湖縣,湖西鄉,0068,275,104,379,21,400,815,49.08%,33.74%,1
澎湖縣,湖西鄉,0069,309,70,379,18,397,975,40.72%,31.69%,1
澎湖縣,湖西鄉,0070,241,63,304,18,322,648,49.69%,37.19%,1
澎湖縣,湖西鄉,0071,286,86,372,21,393,893,44.01%,32.03%,1
澎湖縣,湖西鄉,0072,308,92,400,38,438,846,51.77%,36.41%,1
澎湖縣,湖西鄉,0073,224,60,284,8,292,729,40.05%,30.73%,1
澎湖縣,白沙鄉,0074,192,62,254,4,258,514,50.19%,37.35%,1
澎湖縣,白沙鄉,0075,253,72,325,14,339,657,51.6%,38.51%,1
澎湖縣,白沙鄉,0076,58,10,68,4,72,109,66.06%,53.21%,1
澎湖縣,白沙鄉,0077,50,15,65,4,69,156,44.23%,32.05%,1
澎湖縣,白沙鄉,0078,87,30,117,6,123,293,41.98%,29.69%,1
澎湖縣,白沙鄉,0079,55,15,70,5,75,231,32.47%,23.81%,1
澎湖縣,白沙鄉,0080,62,20,82,5,87,161,54.04%,38.51%,1
澎湖縣,白沙鄉,0081,602,160,762,31,793,1705,46.51%,35.31%,1
澎湖縣,白沙鄉,0082,99,22,121,6,127,285,44.56%,34.74%,1
澎湖縣,白沙鄉,0083,172,53,225,5,230,723,31.81%,23.79%,1
澎湖縣,白沙鄉,0084,211,55,266,23,289,774,37.34%,27.26%,1
澎湖縣,白沙鄉,0085,398,84,482,36,518,1429,36.25%,27.85%,1
澎湖縣,白沙鄉,0086,410,68,478,30,508,1084,46.86%,37.82%,1
澎湖縣,白沙鄉,0087,99,23,122,5,127,251,50.6%,39.44%,1
澎湖縣,白沙鄉,0088,60,22,82,9,91,253,35.97%,23.72%,1
澎湖縣,西嶼鄉,0089,45,8,53,0,53,283,18.73%,15.9%,1
澎湖縣,西嶼鄉,0090,85,26,111,10,121,424,28.54%,20.05%,1
澎湖縣,西嶼鄉,0091,207,55,262,30,292,826,35.35%,25.06%,1
澎湖縣,西嶼鄉,0092,70,31,101,9,110,282,39.01%,24.82%,1
澎湖縣,西嶼鄉,0093,174,67,241,23,264,661,39.94%,26.32%,1
澎湖縣,西嶼鄉,0094,21,8,29,2,31,141,21.99%,14.89%,1
澎湖縣,西嶼鄉,0095,164,37,201,6,207,635,32.6%,25.83%,1
澎湖縣,西嶼鄉,0096,63,9,72,3,75,216,34.72%,29.17%,1
澎湖縣,西嶼鄉,0097,109,23,132,14,146,572,25.52%,19.06%,1
澎湖縣,西嶼鄉,0098,373,86,459,60,519,1267,40.96%,29.44%,1
澎湖縣,西嶼鄉,0099,239,51,290,20,310,942,32.91%,25.37%,1
澎湖縣,西嶼鄉,0100,292,113,405,45,450,1133,39.72%,25.77%,1
澎湖縣,望安鄉,0101,231,80,311,20,331,734,45.1%,31.47%,1
澎湖縣,望安鄉,0102,159,25,184,6,190,454,41.85%,35.02%,1
澎湖縣,望安鄉,0103,84,24,108,6,114,300,38%,28%,1
澎湖縣,望安鄉,0104,172,46,218,20,238,471,50.53%,36.52%,1
澎湖縣,望安鄉,0105,182,54,236,9,245,672,36.46%,27.08%,1
澎湖縣,望安鄉,0106,250,57,307,7,314,742,42.32%,33.69%,1
澎湖縣,望安鄉,0107,92,17,109,2,111,264,42.05%,34.85%,1
澎湖縣,望安鄉,0108,151,57,208,4,212,476,44.54%,31.72%,1
澎湖縣,望安鄉,0109,41,20,61,4,65,208,31.25%,19.71%,1
澎湖縣,望安鄉,0110,72,16,88,3,91,307,29.64%,23.45%,1
澎湖縣,七美鄉,0111,48,17,65,3,68,248,27.42%,19.35%,1
澎湖縣,七美鄉,0112,145,51,196,8,204,581,35.11%,24.96%,1
澎湖縣,七美鄉,0113,140,70,210,18,228,641,35.57%,21.84%,1
澎湖縣,七美鄉,0114,95,23,118,3,121,382,31.68%,24.87%,1
澎湖縣,七美鄉,0115,61,20,81,4,85,351,24.22%,17.38%,1
澎湖縣,七美鄉,0116,238,78,316,6,322,1171,27.5%,20.32%,1
金門縣,金城鎮,0001,412,80,492,22,514,1396,36.82%,29.51%,1
金門縣,金城鎮,0002,555,127,682,20,702,1831,38.34%,30.31%,1
金門縣,金城鎮,0003,485,127,612,29,641,1750,36.63%,27.71%,1
金門縣,金城鎮,0004,556,135,691,27,718,1889,38.01%,29.43%,1
金門縣,金城鎮,0005,372,140,512,24,536,1675,32%,22.21%,1
金門縣,金城鎮,0006,600,147,747,34,781,1901,41.08%,31.56%,1
金門縣,金城鎮,0007,376,135,511,47,558,1610,34.66%,23.35%,1
金門縣,金城鎮,0008,455,114,569,33,602,1687,35.68%,26.97%,1
金門縣,金城鎮,0009,448,117,565,16,581,1594,36.45%,28.11%,1
金門縣,金城鎮,0010,461,128,589,29,618,1726,35.81%,26.71%,1
金門縣,金城鎮,0011,496,110,606,25,631,1733,36.41%,28.62%,1
金門縣,金城鎮,0012,484,118,602,26,628,1532,40.99%,31.59%,1
金門縣,金城鎮,0013,534,139,673,44,717,2079,34.49%,25.69%,1
金門縣,金城鎮,0014,467,155,622,33,655,2033,32.22%,22.97%,1
金門縣,金城鎮,0015,671,178,849,33,882,2517,35.04%,26.66%,1
金門縣,金城鎮,0016,555,126,681,47,728,2083,34.95%,26.64%,1
金門縣,金城鎮,0017,572,130,702,34,736,2140,34.39%,26.73%,1
金門縣,金城鎮,0018,549,160,709,11,720,2435,29.57%,22.55%,1
金門縣,金城鎮,0019,260,61,321,25,346,1353,25.57%,19.22%,1
金門縣,金城鎮,0020,390,82,472,24,496,1574,31.51%,24.78%,1
金門縣,金城鎮,0021,367,101,468,13,481,1277,37.67%,28.74%,1
金門縣,金沙鎮,0066,527,99,626,29,655,1909,34.31%,27.61%,1
金門縣,金沙鎮,0067,506,90,596,29,625,1524,41.01%,33.2%,1
金門縣,金沙鎮,0068,440,75,515,32,547,1673,32.7%,26.3%,1
金門縣,金沙鎮,0069,549,90,639,21,660,2003,32.95%,27.41%,1
金門縣,金沙鎮,0070,384,89,473,22,495,1212,40.84%,31.68%,1
金門縣,金沙鎮,0071,327,65,392,18,410,1126,36.41%,29.04%,1
金門縣,金沙鎮,0072,368,86,454,25,479,1540,31.1%,23.9%,1
金門縣,金沙鎮,0073,291,66,357,21,378,1216,31.09%,23.93%,1
金門縣,金沙鎮,0074,204,43,247,12,259,950,27.26%,21.47%,1
金門縣,金沙鎮,0075,565,102,667,34,701,1895,36.99%,29.82%,1
金門縣,金沙鎮,0076,361,70,431,35,466,1135,41.06%,31.81%,1
金門縣,金沙鎮,0077,328,90,418,20,438,1252,34.98%,26.2%,1
金門縣,金沙鎮,0078,367,78,445,18,463,1125,41.16%,32.62%,1
金門縣,金湖鎮,0049,394,126,520,20,540,1348,40.06%,29.23%,1
金門縣,金湖鎮,0050,343,121,464,24,488,1386,35.21%,24.75%,1
金門縣,金湖鎮,0051,463,107,570,35,605,1403,43.12%,33%,1
金門縣,金湖鎮,0052,506,136,642,33,675,1771,38.11%,28.57%,1
金門縣,金湖鎮,0053,400,131,531,30,561,1493,37.58%,26.79%,1
金門縣,金湖鎮,0054,433,87,520,20,540,1510,35.76%,28.68%,1
金門縣,金湖鎮,0055,484,95,579,29,608,1607,37.83%,30.12%,1
金門縣,金湖鎮,0056,526,116,642,32,674,2006,33.6%,26.22%,1
金門縣,金湖鎮,0057,466,151,617,25,642,1780,36.07%,26.18%,1
金門縣,金湖鎮,0058,495,128,623,12,635,1739,36.52%,28.46%,1
金門縣,金湖鎮,0059,354,89,443,36,479,1384,34.61%,25.58%,1
金門縣,金湖鎮,0060,397,109,506,22,528,1400,37.71%,28.36%,1
金門縣,金湖鎮,0061,461,105,566,19,585,1325,44.15%,34.79%,1
金門縣,金湖鎮,0062,315,73,388,28,416,1236,33.66%,25.49%,1
金門縣,金湖鎮,0063,354,98,452,31,483,1382,34.95%,25.62%,1
金門縣,金湖鎮,0064,456,95,551,9,560,1631,34.33%,27.96%,1
金門縣,金湖鎮,0065,367,74,441,52,493,1514,32.56%,24.24%,1
金門縣,金寧鄉,0022,427,87,514,27,541,1735,31.18%,24.61%,1
金門縣,金寧鄉,0023,371,85,456,28,484,1537,31.49%,24.14%,1
金門縣,金寧鄉,0024,398,167,565,31,596,1766,33.75%,22.54%,1
金門縣,金寧鄉,0025,294,73,367,8,375,1015,36.95%,28.97%,1
金門縣,金寧鄉,0026,494,103,597,22,619,1726,35.86%,28.62%,1
金門縣,金寧鄉,0027,417,92,509,31,540,1691,31.93%,24.66%,1
金門縣,金寧鄉,0028,340,508,848,18,866,2044,42.37%,16.63%,1
金門縣,金寧鄉,0029,578,167,745,19,764,1848,41.34%,31.28%,1
金門縣,金寧鄉,0030,468,114,582,23,605,1735,34.87%,26.97%,1
金門縣,金寧鄉,0031,464,131,595,32,627,1795,34.93%,25.85%,1
金門縣,金寧鄉,0032,454,92,546,36,582,1834,31.73%,24.75%,1
金門縣,金寧鄉,0033,367,104,471,40,511,1528,33.44%,24.02%,1
金門縣,金寧鄉,0034,453,94,547,21,568,1473,38.56%,30.75%,1
金門縣,金寧鄉,0035,543,34,577,26,603,1679,35.91%,32.34%,1
金門縣,金寧鄉,0036,262,662,924,9,933,1921,48.57%,13.64%,1
金門縣,金寧鄉,0037,348,103,451,17,468,1298,36.06%,26.81%,1
金門縣,金寧鄉,0038,380,95,475,31,506,1537,32.92%,24.72%,1
金門縣,烈嶼鄉,0039,564,120,684,38,722,1647,43.84%,34.24%,1
金門縣,烈嶼鄉,0040,481,100,581,36,617,1733,35.6%,27.76%,1
金門縣,烈嶼鄉,0041,463,123,586,21,607,1635,37.13%,28.32%,1
金門縣,烈嶼鄉,0042,341,81,422,18,440,1296,33.95%,26.31%,1
金門縣,烈嶼鄉,0043,278,54,332,23,355,1099,32.3%,25.3%,1
金門縣,烈嶼鄉,0044,370,92,462,29,491,1425,34.46%,25.96%,1
金門縣,烈嶼鄉,0045,410,95,505,20,525,1412,37.18%,29.04%,1
金門縣,烈嶼鄉,0046,397,83,480,25,505,1429,35.34%,27.78%,1
金門縣,烏坵鄉,0047,57,17,74,4,78,275,28.36%,20.73%,1
金門縣,烏坵鄉,0048,76,7,83,4,87,292,29.79%,26.03%,1
連江縣,南竿鄉,0001,731,241,972,42,1014,1967,51.55%,37.16%,1
連江縣,南竿鄉,0002,667,187,854,30,884,1837,48.12%,36.31%,1
連江縣,南竿鄉,0003,435,128,563,16,579,1114,51.97%,39.05%,1
連江縣,南竿鄉,0004,652,135,787,13,800,1543,51.85%,42.26%,1
連江縣,北竿鄉,0005,614,171,785,30,815,1515,53.8%,40.53%,1
連江縣,北竿鄉,0006,218,63,281,14,295,610,48.36%,35.74%,1
連江縣,莒光鄉,0007,262,78,340,11,351,698,50.29%,37.54%,1
連江縣,莒光鄉,0008,330,104,434,11,445,783,56.83%,42.15%,1
連江縣,東引鄉,0009,432,142,574,12,586,1138,51.49%,37.96%,1
基隆市,中正區,0001,190,59,249,12,261,466,56.01%,40.77%,1
基隆市,中正區,0002,408,136,544,14,558,1262,44.22%,32.33%,1
基隆市,中正區,0003,384,136,520,40,560,1171,47.82%,32.79%,1
基隆市,中正區,0004,781,287,1068,13,1081,2823,38.29%,27.67%,1
基隆市,中正區,0005,478,156,634,37,671,1474,45.52%,32.43%,1
基隆市,中正區,0006,390,133,523,37,560,1271,44.06%,30.68%,1
基隆市,中正區,0007,856,293,1149,31,1180,2707,43.59%,31.62%,1
基隆市,中正區,0008,557,165,722,31,753,1545,48.74%,36.05%,1
基隆市,中正區,0009,243,69,312,12,324,761,42.58%,31.93%,1
基隆市,中正區,0010,443,196,639,19,658,1352,48.67%,32.77%,1
基隆市,中正區,0011,578,71,649,13,662,1413,46.85%,40.91%,1
基隆市,中正區,0012,803,321,1124,26,1150,2665,43.15%,30.13%,1
基隆市,中正區,0013,434,140,574,27,601,1261,47.66%,34.42%,1
基隆市,中正區,0014,619,223,842,52,894,1753,51%,35.31%,1
基隆市,中正區,0015,320,109,429,18,447,984,45.43%,32.52%,1
基隆市,中正區,0016,448,102,550,21,571,1166,48.97%,38.42%,1
基隆市,中正區,0017,322,125,447,29,476,973,48.92%,33.09%,1
基隆市,中正區,0018,419,201,620,20,640,1694,37.78%,24.73%,1
基隆市,中正區,0019,451,164,615,21,636,1270,50.08%,35.51%,1
基隆市,中正區,0020,438,133,571,18,589,1090,54.04%,40.18%,1
基隆市,中正區,0021,345,109,454,17,471,870,54.14%,39.66%,1
基隆市,中正區,0022,392,149,541,35,576,1138,50.62%,34.45%,1
基隆市,中正區,0023,296,86,382,39,421,862,48.84%,34.34%,1
基隆市,中正區,0024,515,176,691,46,737,1341,54.96%,38.4%,1
基隆市,中正區,0025,339,106,445,24,469,859,54.6%,39.46%,1
基隆市,中正區,0026,475,185,660,16,676,1457,46.4%,32.6%,1
基隆市,中正區,0027,453,177,630,23,653,1594,40.97%,28.42%,1
基隆市,中正區,0028,292,101,393,36,429,802,53.49%,36.41%,1
基隆市,中正區,0029,438,149,587,36,623,1267,49.17%,34.57%,1
基隆市,中正區,0030,412,166,578,45,623,1175,53.02%,35.06%,1
基隆市,中正區,0031,491,162,653,29,682,1210,56.36%,40.58%,1
基隆市,中正區,0032,373,143,516,36,552,1037,53.23%,35.97%,1
基隆市,中正區,0033,434,171,605,38,643,1219,52.75%,35.6%,1
基隆市,中正區,0034,320,125,445,29,474,904,52.43%,35.4%,1
基隆市,中正區,0035,308,111,419,26,445,709,62.76%,43.44%,1
基隆市,七堵區,0219,527,143,670,33,703,1258,55.88%,41.89%,1
基隆市,七堵區,0220,499,166,665,20,685,1237,55.38%,40.34%,1
基隆市,七堵區,0221,460,193,653,17,670,1259,53.22%,36.54%,1
基隆市,七堵區,0222,389,145,534,44,578,1120,51.61%,34.73%,1
基隆市,七堵區,0223,462,159,621,23,644,1344,47.92%,34.38%,1
基隆市,七堵區,0224,442,152,594,25,619,1011,61.23%,43.72%,1
基隆市,七堵區,0225,359,133,492,12,504,925,54.49%,38.81%,1
基隆市,七堵區,0226,709,231,940,38,978,1735,56.37%,40.86%,1
基隆市,七堵區,0227,733,274,1007,31,1038,1833,56.63%,39.99%,1
基隆市,七堵區,0228,386,134,520,17,537,938,57.25%,41.15%,1
基隆市,七堵區,0229,400,151,551,23,574,962,59.67%,41.58%,1
基隆市,七堵區,0230,473,187,660,22,682,1191,57.26%,39.71%,1
基隆市,七堵區,0231,425,132,557,18,575,999,57.56%,42.54%,1
基隆市,七堵區,0232,98,37,135,4,139,282,49.29%,34.75%,1
基隆市,七堵區,0233,436,178,614,26,640,1243,51.49%,35.08%,1
基隆市,七堵區,0234,404,148,552,30,582,1092,53.3%,37%,1
基隆市,七堵區,0235,472,164,636,35,671,1246,53.85%,37.88%,1
基隆市,七堵區,0236,599,240,839,28,867,1722,50.35%,34.79%,1
基隆市,七堵區,0237,520,173,693,24,717,1318,54.4%,39.45%,1
基隆市,七堵區,0238,374,104,478,10,488,975,50.05%,38.36%,1
基隆市,七堵區,0239,459,192,651,25,676,1285,52.61%,35.72%,1
基隆市,七堵區,0240,353,137,490,31,521,1077,48.38%,32.78%,1
基隆市,七堵區,0241,332,118,450,21,471,989,47.62%,33.57%,1
基隆市,七堵區,0242,431,153,584,17,601,1193,50.38%,36.13%,1
基隆市,七堵區,0243,412,175,587,32,619,1273,48.63%,32.36%,1
基隆市,七堵區,0244,638,275,913,51,964,1774,54.34%,35.96%,1
基隆市,七堵區,0245,618,246,864,41,905,1689,53.58%,36.59%,1
基隆市,七堵區,0246,381,282,663,29,692,1355,51.07%,28.12%,1
基隆市,七堵區,0247,498,239,737,32,769,1512,50.86%,32.94%,1
基隆市,七堵區,0248,530,187,717,14,731,1486,49.19%,35.67%,1
基隆市,七堵區,0249,623,232,855,16,871,1706,51.06%,36.52%,1
基隆市,七堵區,0250,542,187,729,29,758,1384,54.77%,39.16%,1
基隆市,七堵區,0251,433,180,613,20,633,1045,60.57%,41.44%,1
基隆市,七堵區,0252,514,201,715,20,735,1374,53.49%,37.41%,1
基隆市,七堵區,0253,159,67,226,9,235,428,54.91%,37.15%,1
基隆市,七堵區,0254,142,43,185,15,200,326,61.35%,43.56%,1
基隆市,七堵區,0255,191,51,242,9,251,351,71.51%,54.42%,1
基隆市,七堵區,0256,627,250,877,18,895,1871,47.84%,33.51%,1
基隆市,七堵區,0257,181,46,227,8,235,448,52.46%,40.4%,1
基隆市,暖暖區,0191,490,195,685,24,709,1431,49.55%,34.24%,1
基隆市,暖暖區,0192,186,50,236,6,242,456,53.07%,40.79%,1
基隆市,暖暖區,0193,252,95,347,16,363,637,56.99%,39.56%,1
基隆市,暖暖區,0194,304,119,423,20,443,735,60.27%,41.36%,1
基隆市,暖暖區,0195,398,112,510,19,529,1078,49.07%,36.92%,1
基隆市,暖暖區,0196,419,191,610,27,637,1238,51.45%,33.84%,1
基隆市,暖暖區,0197,467,195,662,18,680,1325,51.32%,35.25%,1
基隆市,暖暖區,0198,532,240,772,23,795,1475,53.9%,36.07%,1
基隆市,暖暖區,0199,394,170,564,14,578,1179,49.02%,33.42%,1
基隆市,暖暖區,0200,459,186,645,17,662,1110,59.64%,41.35%,1
基隆市,暖暖區,0201,564,91,655,28,683,1443,47.33%,39.09%,1
基隆市,暖暖區,0202,152,61,213,14,227,415,54.7%,36.63%,1
基隆市,暖暖區,0203,465,218,683,15,698,1378,50.65%,33.74%,1
基隆市,暖暖區,0204,569,232,801,25,826,1570,52.61%,36.24%,1
基隆市,暖暖區,0205,637,261,898,44,942,1603,58.76%,39.74%,1
基隆市,暖暖區,0206,518,199,717,19,736,1267,58.09%,40.88%,1
基隆市,暖暖區,0207,526,165,691,27,718,1359,52.83%,38.7%,1
基隆市,暖暖區,0208,431,120,551,23,574,970,59.18%,44.43%,1
基隆市,暖暖區,0209,330,192,522,12,534,1002,53.29%,32.93%,1
基隆市,暖暖區,0210,333,147,480,13,493,944,52.22%,35.28%,1
基隆市,暖暖區,0211,582,248,830,17,847,1500,56.47%,38.8%,1
基隆市,暖暖區,0212,436,153,589,10,599,1442,41.54%,30.24%,1
基隆市,暖暖區,0213,437,187,624,10,634,1165,54.42%,37.51%,1
基隆市,暖暖區,0214,563,242,805,23,828,1610,51.43%,34.97%,1
基隆市,暖暖區,0215,498,224,722,18,740,1328,55.72%,37.5%,1
基隆市,暖暖區,0216,457,161,618,11,629,1173,53.62%,38.96%,1
基隆市,暖暖區,0217,388,204,592,15,607,1019,59.57%,38.08%,1
基隆市,暖暖區,0218,534,211,745,9,754,1373,54.92%,38.89%,1
基隆市,仁愛區,0072,600,200,800,51,851,1782,47.76%,33.67%,1
基隆市,仁愛區,0073,370,155,525,24,549,1055,52.04%,35.07%,1
基隆市,仁愛區,0074,522,209,731,19,750,1558,48.14%,33.5%,1
基隆市,仁愛區,0075,663,215,878,28,906,1736,52.19%,38.19%,1
基隆市,仁愛區,0076,530,178,708,25,733,1243,58.97%,42.64%,1
基隆市,仁愛區,0077,447,150,597,30,627,1109,56.54%,40.31%,1
基隆市,仁愛區,0078,689,245,934,32,966,1684,57.36%,40.91%,1
基隆市,仁愛區,0079,338,153,491,20,511,919,55.6%,36.78%,1
基隆市,仁愛區,0080,335,170,505,11,516,991,52.07%,33.8%,1
基隆市,仁愛區,0081,357,126,483,8,491,876,56.05%,40.75%,1
基隆市,仁愛區,0082,425,159,584,28,612,1046,58.51%,40.63%,1
基隆市,仁愛區,0083,186,66,252,11,263,434,60.6%,42.86%,1
基隆市,仁愛區,0084,315,109,424,30,454,764,59.42%,41.23%,1
基隆市,仁愛區,0085,344,145,489,18,507,968,52.38%,35.54%,1
基隆市,仁愛區,0086,471,175,646,40,686,1326,51.73%,35.52%,1
基隆市,仁愛區,0087,404,141,545,27,572,1315,43.5%,30.72%,1
基隆市,仁愛區,0088,323,111,434,17,451,775,58.19%,41.68%,1
基隆市,仁愛區,0089,251,98,349,27,376,652,57.67%,38.5%,1
基隆市,仁愛區,0090,263,99,362,17,379,674,56.23%,39.02%,1
基隆市,仁愛區,0091,284,102,386,26,412,789,52.22%,35.99%,1
基隆市,仁愛區,0092,636,224,860,40,900,1715,52.48%,37.08%,1
基隆市,仁愛區,0093,304,125,429,33,462,849,54.42%,35.81%,1
基隆市,仁愛區,0094,354,123,477,13,490,875,56%,40.46%,1
基隆市,仁愛區,0095,291,118,409,26,435,851,51.12%,34.2%,1
基隆市,仁愛區,0096,301,112,413,14,427,735,58.1%,40.95%,1
基隆市,仁愛區,0097,365,143,508,30,538,1009,53.32%,36.17%,1
基隆市,仁愛區,0098,364,143,507,33,540,1082,49.91%,33.64%,1
基隆市,仁愛區,0099,447,175,622,42,664,1278,51.96%,34.98%,1
基隆市,仁愛區,0100,618,237,855,23,878,1519,57.8%,40.68%,1
基隆市,仁愛區,0101,417,170,587,19,606,1336,45.36%,31.21%,1
基隆市,仁愛區,0102,512,167,679,28,707,1178,60.02%,43.46%,1
基隆市,仁愛區,0103,254,106,360,21,381,708,53.81%,35.88%,1
基隆市,仁愛區,0104,242,96,338,17,355,567,62.61%,42.68%,1
基隆市,仁愛區,0105,253,129,382,34,416,751,55.39%,33.69%,1
基隆市,仁愛區,0106,228,110,338,17,355,589,60.27%,38.71%,1
基隆市,中山區,0107,292,106,398,22,420,796,52.76%,36.68%,1
基隆市,中山區,0108,468,149,617,27,644,1036,62.16%,45.17%,1
基隆市,中山區,0109,325,99,424,17,441,756,58.33%,42.99%,1
基隆市,中山區,0110,308,150,458,17,475,957,49.63%,32.18%,1
基隆市,中山區,0111,309,112,421,7,428,802,53.37%,38.53%,1
基隆市,中山區,0112,471,475,946,35,981,1263,77.67%,37.29%,1
基隆市,中山區,0113,320,115,435,14,449,778,57.71%,41.13%,1
基隆市,中山區,0114,451,147,598,68,666,1180,56.44%,38.22%,1
基隆市,中山區,0115,343,115,458,24,482,990,48.69%,34.65%,1
基隆市,中山區,0116,398,145,543,29,572,1332,42.94%,29.88%,1
基隆市,中山區,0117,268,113,381,26,407,848,48%,31.6%,1
基隆市,中山區,0118,330,109,439,16,455,922,49.35%,35.79%,1
基隆市,中山區,0119,203,55,258,14,272,459,59.26%,44.23%,1
基隆市,中山區,0120,224,48,272,19,291,574,50.7%,39.02%,1
基隆市,中山區,0121,305,125,430,25,455,877,51.88%,34.78%,1
基隆市,中山區,0122,490,215,705,19,724,1584,45.71%,30.93%,1
基隆市,中山區,0123,365,115,480,16,496,1319,37.6%,27.67%,1
基隆市,中山區,0124,698,262,960,38,998,1938,51.5%,36.02%,1
基隆市,中山區,0125,601,289,890,20,910,1877,48.48%,32.02%,1
基隆市,中山區,0126,794,315,1109,29,1138,2088,54.5%,38.03%,1
基隆市,中山區,0127,711,311,1022,22,1044,1946,53.65%,36.54%,1
基隆市,中山區,0128,548,189,737,31,768,1353,56.76%,40.5%,1
基隆市,中山區,0129,607,65,672,33,705,1317,53.53%,46.09%,1
基隆市,中山區,0130,332,142,474,21,495,870,56.9%,38.16%,1
基隆市,中山區,0131,510,184,694,23,717,1322,54.24%,38.58%,1
基隆市,中山區,0132,425,182,607,13,620,1295,47.88%,32.82%,1
基隆市,中山區,0133,333,110,443,17,460,756,60.85%,44.05%,1
基隆市,中山區,0134,518,205,723,19,742,1602,46.32%,32.33%,1
基隆市,中山區,0135,546,193,739,15,754,1568,48.09%,34.82%,1
基隆市,中山區,0136,524,189,713,25,738,1404,52.56%,37.32%,1
基隆市,中山區,0137,711,213,924,20,944,1909,49.45%,37.24%,1
基隆市,中山區,0138,509,203,712,50,762,1642,46.41%,31%,1
基隆市,中山區,0139,363,103,466,15,481,932,51.61%,38.95%,1
基隆市,中山區,0140,384,111,495,24,519,849,61.13%,45.23%,1
基隆市,中山區,0141,265,132,397,25,422,715,59.02%,37.06%,1
基隆市,安樂區,0142,497,123,620,46,666,1361,48.93%,36.52%,1
基隆市,安樂區,0143,462,126,588,19,607,1213,50.04%,38.09%,1
基隆市,安樂區,0144,356,102,458,12,470,1026,45.81%,34.7%,1
基隆市,安樂區,0145,442,151,593,36,629,1038,60.6%,42.58%,1
基隆市,安樂區,0146,344,140,484,36,520,897,57.97%,38.35%,1
基隆市,安樂區,0147,521,203,724,25,749,1401,53.46%,37.19%,1
基隆市,安樂區,0148,178,60,238,8,246,641,38.38%,27.77%,1
基隆市,安樂區,0149,501,216,717,21,738,1472,50.14%,34.04%,1
基隆市,安樂區,0150,192,61,253,11,264,472,55.93%,40.68%,1
基隆市,安樂區,0151,368,126,494,12,506,841,60.17%,43.76%,1
基隆市,安樂區,0152,205,89,294,19,313,571,54.82%,35.9%,1
基隆市,安樂區,0153,684,261,945,30,975,1901,51.29%,35.98%,1
基隆市,安樂區,0154,475,192,667,34,701,1349,51.96%,35.21%,1
基隆市,安樂區,0155,464,146,610,18,628,1225,51.27%,37.88%,1
基隆市,安樂區,0156,532,189,721,30,751,1351,55.59%,39.38%,1
基隆市,安樂區,0157,602,286,888,26,914,1601,57.09%,37.6%,1
基隆市,安樂區,0158,936,329,1265,29,1294,2513,51.49%,37.25%,1
基隆市,安樂區,0159,587,261,848,24,872,1613,54.06%,36.39%,1
基隆市,安樂區,0160,660,271,931,19,950,1731,54.88%,38.13%,1
基隆市,安樂區,0161,562,268,830,18,848,1424,59.55%,39.47%,1
基隆市,安樂區,0162,666,222,888,33,921,1806,51%,36.88%,1
基隆市,安樂區,0163,630,264,894,45,939,1679,55.93%,37.52%,1
基隆市,安樂區,0164,685,310,995,24,1019,1902,53.58%,36.01%,1
基隆市,安樂區,0165,600,405,1005,30,1035,2040,50.74%,29.41%,1
基隆市,安樂區,0166,489,191,680,34,714,1313,54.38%,37.24%,1
基隆市,安樂區,0167,443,167,610,18,628,1243,50.52%,35.64%,1
基隆市,安樂區,0168,608,262,870,33,903,1759,51.34%,34.57%,1
基隆市,安樂區,0169,269,156,425,13,438,694,63.11%,38.76%,1
基隆市,安樂區,0170,339,197,536,15,551,866,63.63%,39.15%,1
基隆市,安樂區,0171,474,196,670,18,688,1557,44.19%,30.44%,1
基隆市,安樂區,0172,479,220,699,23,722,1411,51.17%,33.95%,1
基隆市,安樂區,0173,597,277,874,18,892,1568,56.89%,38.07%,1
基隆市,安樂區,0174,489,213,702,26,728,1400,52%,34.93%,1
基隆市,安樂區,0175,537,248,785,10,795,1531,51.93%,35.08%,1
基隆市,安樂區,0176,585,224,809,11,820,1673,49.01%,34.97%,1
基隆市,安樂區,0177,398,143,541,21,562,1054,53.32%,37.76%,1
基隆市,安樂區,0178,557,241,798,24,822,1923,42.75%,28.97%,1
基隆市,安樂區,0179,745,276,1021,32,1053,1960,53.72%,38.01%,1
基隆市,安樂區,0180,702,256,958,30,988,1962,50.36%,35.78%,1
基隆市,安樂區,0181,787,278,1065,38,1103,2117,52.1%,37.18%,1
基隆市,安樂區,0182,608,257,865,24,889,1829,48.61%,33.24%,1
基隆市,安樂區,0183,519,205,724,15,739,1529,48.33%,33.94%,1
基隆市,安樂區,0184,634,287,921,29,950,1869,50.83%,33.92%,1
基隆市,安樂區,0185,455,170,625,9,634,1140,55.61%,39.91%,1
基隆市,安樂區,0186,574,242,816,33,849,1641,51.74%,34.98%,1
基隆市,安樂區,0187,476,162,638,25,663,1279,51.84%,37.22%,1
基隆市,安樂區,0188,485,198,683,20,703,1360,51.69%,35.66%,1
基隆市,安樂區,0189,495,233,728,38,766,1399,54.75%,35.38%,1
基隆市,安樂區,0190,435,188,623,21,644,1251,51.48%,34.77%,1
基隆市,信義區,0036,397,194,591,27,618,1096,56.39%,36.22%,1
基隆市,信義區,0037,502,212,714,22,736,1232,59.74%,40.75%,1
基隆市,信義區,0038,460,210,670,14,684,1184,57.77%,38.85%,1
基隆市,信義區,0039,482,154,636,31,667,1133,58.87%,42.54%,1
基隆市,信義區,0040,466,178,644,26,670,1188,56.4%,39.23%,1
基隆市,信義區,0041,299,106,405,22,427,725,58.9%,41.24%,1
基隆市,信義區,0042,499,188,687,37,724,1524,47.51%,32.74%,1
基隆市,信義區,0043,273,124,397,16,413,736,56.11%,37.09%,1
基隆市,信義區,0044,233,82,315,12,327,611,53.52%,38.13%,1
基隆市,信義區,0045,347,120,467,12,479,951,50.37%,36.49%,1
基隆市,信義區,0046,597,229,826,32,858,1616,53.09%,36.94%,1
基隆市,信義區,0047,579,223,802,24,826,1516,54.49%,38.19%,1
基隆市,信義區,0048,396,136,532,21,553,1049,52.72%,37.75%,1
基隆市,信義區,0049,372,178,550,12,562,1069,52.57%,34.8%,1
基隆市,信義區,0050,294,115,409,15,424,727,58.32%,40.44%,1
基隆市,信義區,0051,381,159,540,17,557,929,59.96%,41.01%,1
基隆市,信義區,0052,461,208,669,23,692,1118,61.9%,41.23%,1
基隆市,信義區,0053,487,241,728,26,754,1339,56.31%,36.37%,1
基隆市,信義區,0054,374,140,514,15,529,999,52.95%,37.44%,1
基隆市,信義區,0055,296,104,400,8,408,764,53.4%,38.74%,1
基隆市,信義區,0056,537,199,736,22,758,1555,48.75%,34.53%,1
基隆市,信義區,0057,677,310,987,16,1003,2015,49.78%,33.6%,1
基隆市,信義區,0058,512,191,703,21,724,1268,57.1%,40.38%,1
基隆市,信義區,0059,559,244,803,31,834,1569,53.15%,35.63%,1
基隆市,信義區,0060,661,274,935,25,960,1985,48.36%,33.3%,1
基隆市,信義區,0061,590,204,794,18,812,1476,55.01%,39.97%,1
基隆市,信義區,0062,539,278,817,24,841,1493,56.33%,36.1%,1
基隆市,信義區,0063,505,239,744,22,766,1249,61.33%,40.43%,1
基隆市,信義區,0064,555,216,771,19,790,1559,50.67%,35.6%,1
基隆市,信義區,0065,406,163,569,12,581,1168,49.74%,34.76%,1
基隆市,信義區,0066,597,212,809,18,827,1602,51.62%,37.27%,1
基隆市,信義區,0067,493,176,669,26,695,1485,46.8%,33.2%,1
基隆市,信義區,0068,380,134,514,19,533,1009,52.82%,37.66%,1
基隆市,信義區,0069,631,206,837,33,870,2016,43.15%,31.3%,1
基隆市,信義區,0070,571,177,748,20,768,1764,43.54%,32.37%,1
基隆市,信義區,0071,488,195,683,21,704,1295,54.36%,37.68%,1
新竹市,東區,0001,348,158,506,10,516,1512,34.13%,23.02%,1
新竹市,東區,0002,368,205,573,13,586,953,61.49%,38.61%,1
新竹市,東區,0003,270,137,407,14,421,729,57.75%,37.04%,1
新竹市,東區,0004,248,88,336,18,354,566,62.54%,43.82%,1
新竹市,東區,0005,255,101,356,18,374,640,58.44%,39.84%,1
新竹市,東區,0006,107,52,159,14,173,305,56.72%,35.08%,1
新竹市,東區,0007,248,89,337,11,348,563,61.81%,44.05%,1
新竹市,東區,0008,283,127,410,10,420,741,56.68%,38.19%,1
新竹市,東區,0009,388,210,598,14,612,1041,58.79%,37.27%,1
新竹市,東區,0010,574,282,856,28,884,1615,54.74%,35.54%,1
新竹市,東區,0011,507,215,722,26,748,1287,58.12%,39.39%,1
新竹市,東區,0012,644,246,890,13,903,1554,58.11%,41.44%,1
新竹市,東區,0013,548,257,805,19,824,1388,59.37%,39.48%,1
新竹市,東區,0014,570,267,837,31,868,1419,61.17%,40.17%,1
新竹市,東區,0015,490,234,724,32,756,1355,55.79%,36.16%,1
新竹市,東區,0016,573,248,821,23,844,1490,56.64%,38.46%,1
新竹市,東區,0017,639,262,901,20,921,1615,57.03%,39.57%,1
新竹市,東區,0018,643,305,948,21,969,1672,57.95%,38.46%,1
新竹市,東區,0019,391,216,607,21,628,1062,59.13%,36.82%,1
新竹市,東區,0020,498,232,730,23,753,1315,57.26%,37.87%,1
新竹市,東區,0021,409,165,574,23,597,1000,59.7%,40.9%,1
新竹市,東區,0022,534,229,763,30,793,1337,59.31%,39.94%,1
新竹市,東區,0023,590,346,936,15,951,1747,54.44%,33.77%,1
新竹市,東區,0024,581,356,937,20,957,1600,59.81%,36.31%,1
新竹市,東區,0025,436,197,633,23,656,1158,56.65%,37.65%,1
新竹市,東區,0026,345,175,520,21,541,828,65.34%,41.67%,1
新竹市,東區,0027,565,279,844,30,874,1573,55.56%,35.92%,1
新竹市,東區,0028,599,267,866,24,890,1550,57.42%,38.65%,1
新竹市,東區,0029,499,236,735,24,759,1317,57.63%,37.89%,1
新竹市,東區,0030,405,214,619,30,649,1040,62.4%,38.94%,1
新竹市,東區,0031,452,100,552,15,567,935,60.64%,48.34%,1
新竹市,東區,0032,427,179,606,14,620,1074,57.73%,39.76%,1
新竹市,東區,0033,475,206,681,20,701,1133,61.87%,41.92%,1
新竹市,東區,0034,498,230,728,30,758,1262,60.06%,39.46%,1
新竹市,東區,0035,472,206,678,9,687,1199,57.3%,39.37%,1
新竹市,東區,0036,504,243,747,22,769,1226,62.72%,41.11%,1
新竹市,東區,0037,548,306,854,31,885,1377,64.27%,39.8%,1
新竹市,東區,0038,399,219,618,19,637,991,64.28%,40.26%,1
新竹市,東區,0039,492,229,721,42,763,1271,60.03%,38.71%,1
新竹市,東區,0040,417,218,635,18,653,1012,64.53%,41.21%,1
新竹市,東區,0041,406,157,563,29,592,1001,59.14%,40.56%,1
新竹市,東區,0042,520,297,817,32,849,1603,52.96%,32.44%,1
新竹市,東區,0043,582,89,671,30,701,1236,56.72%,47.09%,1
新竹市,東區,0044,567,168,735,23,758,1532,49.48%,37.01%,1
新竹市,東區,0045,545,184,729,19,748,1306,57.27%,41.73%,1
新竹市,東區,0046,446,153,599,36,635,1073,59.18%,41.57%,1
新竹市,東區,0047,369,176,545,9,554,952,58.19%,38.76%,1
新竹市,東區,0048,464,172,636,18,654,1298,50.39%,35.75%,1
新竹市,東區,0049,341,101,442,10,452,778,58.1%,43.83%,1
新竹市,東區,0050,418,262,680,25,705,1195,59%,34.98%,1
新竹市,東區,0051,561,269,830,38,868,1569,55.32%,35.76%,1
新竹市,東區,0052,595,347,942,20,962,1533,62.75%,38.81%,1
新竹市,東區,0053,602,188,790,23,813,1336,60.85%,45.06%,1
新竹市,東區,0054,558,229,787,23,810,1367,59.25%,40.82%,1
新竹市,東區,0055,520,251,771,20,791,1289,61.37%,40.34%,1
新竹市,東區,0056,385,153,538,14,552,960,57.5%,40.1%,1
新竹市,東區,0057,342,174,516,22,538,843,63.82%,40.57%,1
新竹市,東區,0058,417,136,553,25,578,948,60.97%,43.99%,1
新竹市,東區,0059,370,123,493,27,520,915,56.83%,40.44%,1
新竹市,東區,0060,725,289,1014,36,1050,1801,58.3%,40.26%,1
新竹市,東區,0061,424,178,602,24,626,1079,58.02%,39.3%,1
新竹市,東區,0062,279,132,411,12,423,676,62.57%,41.27%,1
新竹市,東區,0063,439,208,647,30,677,1132,59.81%,38.78%,1
新竹市,東區,0064,81,64,145,7,152,251,60.56%,32.27%,1
新竹市,東區,0065,581,326,907,34,941,1620,58.09%,35.86%,1
新竹市,東區,0066,463,315,778,23,801,1479,54.16%,31.3%,1
新竹市,東區,0067,438,298,736,20,756,1402,53.92%,31.24%,1
新竹市,東區,0068,453,263,716,22,738,1280,57.66%,35.39%,1
新竹市,東區,0069,399,324,723,10,733,1228,59.69%,32.49%,1
新竹市,東區,0070,300,332,632,6,638,1157,55.14%,25.93%,1
新竹市,東區,0071,497,250,747,23,770,1354,56.87%,36.71%,1
新竹市,東區,0072,532,315,847,26,873,1334,65.44%,39.88%,1
新竹市,東區,0073,514,222,736,20,756,1234,61.26%,41.65%,1
新竹市,東區,0074,593,278,871,26,897,1398,64.16%,42.42%,1
新竹市,東區,0075,315,245,560,11,571,928,61.53%,33.94%,1
新竹市,東區,0076,555,289,844,24,868,1368,63.45%,40.57%,1
新竹市,東區,0077,443,223,666,21,687,1215,56.54%,36.46%,1
新竹市,東區,0078,408,146,554,21,575,1067,53.89%,38.24%,1
新竹市,東區,0079,305,336,641,15,656,1194,54.94%,25.54%,1
新竹市,東區,0080,320,306,626,15,641,1193,53.73%,26.82%,1
新竹市,東區,0081,519,251,770,38,808,1388,58.21%,37.39%,1
新竹市,東區,0082,513,219,732,22,754,1267,59.51%,40.49%,1
新竹市,東區,0083,512,207,719,13,732,1299,56.35%,39.41%,1
新竹市,東區,0084,455,266,721,18,739,1288,57.38%,35.33%,1
新竹市,東區,0085,400,330,730,19,749,1228,60.99%,32.57%,1
新竹市,東區,0086,360,324,684,10,694,1135,61.15%,31.72%,1
新竹市,東區,0087,428,348,776,12,788,1237,63.7%,34.6%,1
新竹市,東區,0088,445,148,593,20,613,1135,54.01%,39.21%,1
新竹市,東區,0089,434,157,591,26,617,1165,52.96%,37.25%,1
新竹市,東區,0090,418,198,616,18,634,1124,56.41%,37.19%,1
新竹市,東區,0091,468,226,694,21,715,1210,59.09%,38.68%,1
新竹市,東區,0092,480,210,690,27,717,1323,54.2%,36.28%,1
新竹市,東區,0093,489,163,652,15,667,1207,55.26%,40.51%,1
新竹市,東區,0094,445,176,621,24,645,1264,51.03%,35.21%,1
新竹市,東區,0095,427,249,676,13,689,1248,55.21%,34.21%,1
新竹市,東區,0096,550,290,840,32,872,1400,62.29%,39.29%,1
新竹市,東區,0097,549,327,876,16,892,1473,60.56%,37.27%,1
新竹市,東區,0098,480,252,732,38,770,1367,56.33%,35.11%,1
新竹市,東區,0099,579,133,712,16,728,1233,59.04%,46.96%,1
新竹市,東區,0100,202,75,277,9,286,507,56.41%,39.84%,1
新竹市,東區,0101,278,123,401,21,422,714,59.1%,38.94%,1
新竹市,東區,0102,339,148,487,28,515,875,58.86%,38.74%,1
新竹市,東區,0103,569,196,765,37,802,1396,57.45%,40.76%,1
新竹市,東區,0104,460,200,660,29,689,1232,55.93%,37.34%,1
新竹市,東區,0105,435,249,684,34,718,1323,54.27%,32.88%,1
新竹市,東區,0106,510,220,730,16,746,1516,49.21%,33.64%,1
新竹市,東區,0107,484,241,725,22,747,1453,51.41%,33.31%,1
新竹市,東區,0108,364,127,491,26,517,880,58.75%,41.36%,1
新竹市,東區,0109,425,136,561,19,580,1058,54.82%,40.17%,1
新竹市,東區,0110,405,170,575,26,601,1061,56.64%,38.17%,1
新竹市,東區,0111,298,106,404,22,426,710,60%,41.97%,1
新竹市,東區,0112,315,118,433,27,460,752,61.17%,41.89%,1
新竹市,東區,0113,224,66,290,13,303,475,63.79%,47.16%,1
新竹市,東區,0114,308,148,456,26,482,880,54.77%,35%,1
新竹市,東區,0115,384,185,569,17,586,989,59.25%,38.83%,1
新竹市,東區,0116,411,179,590,24,614,1059,57.98%,38.81%,1
新竹市,東區,0117,234,109,343,29,372,607,61.29%,38.55%,1
新竹市,東區,0118,301,149,450,27,477,815,58.53%,36.93%,1
新竹市,東區,0119,337,130,467,17,484,777,62.29%,43.37%,1
新竹市,東區,0120,484,210,694,19,713,1399,50.96%,34.6%,1
新竹市,東區,0121,462,196,658,23,681,1216,56%,37.99%,1
新竹市,東區,0122,383,147,530,31,561,1062,52.82%,36.06%,1
新竹市,東區,0123,450,162,612,17,629,1046,60.13%,43.02%,1
新竹市,東區,0124,511,189,700,11,711,1332,53.38%,38.36%,1
新竹市,東區,0125,499,241,740,30,770,1350,57.04%,36.96%,1
新竹市,東區,0126,514,222,736,21,757,1438,52.64%,35.74%,1
新竹市,東區,0127,533,192,725,32,757,1414,53.54%,37.69%,1
新竹市,東區,0128,559,288,847,19,866,1476,58.67%,37.87%,1
新竹市,東區,0129,575,218,793,24,817,1326,61.61%,43.36%,1
新竹市,東區,0130,368,217,585,16,601,927,64.83%,39.7%,1
新竹市,東區,0131,518,207,725,14,739,1273,58.05%,40.69%,1
新竹市,東區,0132,479,203,682,26,708,1315,53.84%,36.43%,1
新竹市,東區,0133,533,261,794,22,816,1413,57.75%,37.72%,1
新竹市,東區,0134,359,198,557,22,579,1064,54.42%,33.74%,1
新竹市,東區,0135,473,294,767,18,785,1244,63.1%,38.02%,1
新竹市,東區,0136,446,168,614,8,622,1160,53.62%,38.45%,1
新竹市,東區,0137,471,221,692,12,704,1398,50.36%,33.69%,1
新竹市,東區,0138,384,175,559,11,570,1384,41.18%,27.75%,1
新竹市,東區,0139,383,126,509,30,539,874,61.67%,43.82%,1
新竹市,北區,0140,193,68,261,7,268,477,56.18%,40.46%,1
新竹市,北區,0141,224,84,308,21,329,535,61.5%,41.87%,1
新竹市,北區,0142,287,128,415,34,449,746,60.19%,38.47%,1
新竹市,北區,0143,207,79,286,14,300,546,54.95%,37.91%,1
新竹市,北區,0144,305,114,419,23,442,711,62.17%,42.9%,1
新竹市,北區,0145,445,148,593,24,617,1143,53.98%,38.93%,1
新竹市,北區,0146,497,211,708,26,734,1370,53.58%,36.28%,1
新竹市,北區,0147,493,229,722,24,746,1390,53.67%,35.47%,1
新竹市,北區,0148,347,194,541,17,558,962,58%,36.07%,1
新竹市,北區,0149,447,229,676,16,692,1237,55.94%,36.14%,1
新竹市,北區,0150,534,234,768,28,796,1604,49.63%,33.29%,1
新竹市,北區,0151,281,91,372,18,390,758,51.45%,37.07%,1
新竹市,北區,0152,480,188,668,24,692,1320,52.42%,36.36%,1
新竹市,北區,0153,523,211,734,45,779,1519,51.28%,34.43%,1
新竹市,北區,0154,90,37,127,7,134,347,38.62%,25.94%,1
新竹市,北區,0155,515,178,693,33,726,1212,59.9%,42.49%,1
新竹市,北區,0156,549,245,794,20,814,1484,54.85%,36.99%,1
新竹市,北區,0157,523,225,748,44,792,1428,55.46%,36.62%,1
新竹市,北區,0158,506,144,650,17,667,1128,59.13%,44.86%,1
新竹市,北區,0159,236,109,345,15,360,638,56.43%,36.99%,1
新竹市,北區,0160,518,163,681,33,714,1222,58.43%,42.39%,1
新竹市,北區,0161,389,173,562,20,582,1076,54.09%,36.15%,1
新竹市,北區,0162,413,176,589,13,602,937,64.25%,44.08%,1
新竹市,北區,0163,556,178,734,39,773,1394,55.45%,39.89%,1
新竹市,北區,0164,584,217,801,31,832,1568,53.06%,37.24%,1
新竹市,北區,0165,452,216,668,38,706,1159,60.91%,39%,1
新竹市,北區,0166,76,28,104,1,105,252,41.67%,30.16%,1
新竹市,北區,0167,320,144,464,18,482,761,63.34%,42.05%,1
新竹市,北區,0168,310,141,451,22,473,788,60.03%,39.34%,1
新竹市,北區,0169,256,85,341,18,359,561,63.99%,45.63%,1
新竹市,北區,0170,528,247,775,54,829,1558,53.21%,33.89%,1
新竹市,北區,0171,461,228,689,26,715,1398,51.14%,32.98%,1
新竹市,北區,0172,373,142,515,23,538,957,56.22%,38.98%,1
新竹市,北區,0173,503,173,676,28,704,1195,58.91%,42.09%,1
新竹市,北區,0174,396,200,596,19,615,1236,49.76%,32.04%,1
新竹市,北區,0175,454,182,636,34,670,1255,53.39%,36.18%,1
新竹市,北區,0176,434,191,625,19,644,1114,57.81%,38.96%,1
新竹市,北區,0177,542,215,757,22,779,1396,55.8%,38.83%,1
新竹市,北區,0178,584,219,803,35,838,1456,57.55%,40.11%,1
新竹市,北區,0179,510,228,738,20,758,1374,55.17%,37.12%,1
新竹市,北區,0180,407,147,554,26,580,1070,54.21%,38.04%,1
新竹市,北區,0181,479,136,615,31,646,1142,56.57%,41.94%,1
新竹市,北區,0182,412,164,576,19,595,1103,53.94%,37.35%,1
新竹市,北區,0183,469,168,637,42,679,1190,57.06%,39.41%,1
新竹市,北區,0184,490,167,657,19,676,1089,62.08%,45%,1
新竹市,北區,0185,429,185,614,8,622,1272,48.9%,33.73%,1
新竹市,北區,0186,535,170,705,35,740,1306,56.66%,40.96%,1
新竹市,北區,0187,491,231,722,27,749,1328,56.4%,36.97%,1
新竹市,北區,0188,520,235,755,18,773,1457,53.05%,35.69%,1
新竹市,北區,0189,549,247,796,31,827,1492,55.43%,36.8%,1
新竹市,北區,0190,474,198,672,35,707,1160,60.95%,40.86%,1
新竹市,北區,0191,416,139,555,20,575,971,59.22%,42.84%,1
新竹市,北區,0192,308,143,451,5,456,1401,32.55%,21.98%,1
新竹市,北區,0193,485,264,749,26,775,1340,57.84%,36.19%,1
新竹市,北區,0194,524,275,799,26,825,1371,60.18%,38.22%,1
新竹市,北區,0195,460,218,678,24,702,1267,55.41%,36.31%,1
新竹市,北區,0196,436,211,647,28,675,1073,62.91%,40.63%,1
新竹市,北區,0197,465,202,667,13,680,1159,58.67%,40.12%,1
新竹市,北區,0198,459,260,719,15,734,1294,56.72%,35.47%,1
新竹市,北區,0199,514,262,776,27,803,1442,55.69%,35.64%,1
新竹市,北區,0200,491,243,734,20,754,1270,59.37%,38.66%,1
新竹市,北區,0201,541,208,749,17,766,1179,64.97%,45.89%,1
新竹市,北區,0202,424,155,579,22,601,949,63.33%,44.68%,1
新竹市,北區,0203,435,222,657,28,685,1163,58.9%,37.4%,1
新竹市,北區,0204,474,252,726,16,742,1334,55.62%,35.53%,1
新竹市,北區,0205,502,276,778,27,805,1415,56.89%,35.48%,1
新竹市,北區,0206,484,292,776,19,795,1305,60.92%,37.09%,1
新竹市,北區,0207,423,243,666,17,683,1200,56.92%,35.25%,1
新竹市,北區,0208,434,196,630,24,654,1106,59.13%,39.24%,1
新竹市,北區,0209,425,187,612,16,628,1044,60.15%,40.71%,1
新竹市,北區,0210,412,199,611,20,631,1061,59.47%,38.83%,1
新竹市,北區,0211,597,261,858,44,902,1518,59.42%,39.33%,1
新竹市,北區,0212,521,222,743,18,761,1220,62.38%,42.7%,1
新竹市,北區,0213,578,282,860,10,870,1475,58.98%,39.19%,1
新竹市,北區,0214,551,185,736,14,750,1373,54.62%,40.13%,1
新竹市,北區,0215,578,251,829,19,848,1450,58.48%,39.86%,1
新竹市,北區,0216,541,264,805,20,825,1423,57.98%,38.02%,1
新竹市,北區,0217,446,148,594,18,612,1059,57.79%,42.12%,1
新竹市,北區,0218,501,153,654,33,687,1130,60.8%,44.34%,1
新竹市,北區,0219,532,194,726,24,750,1208,62.09%,44.04%,1
新竹市,北區,0220,595,149,744,21,765,1226,62.4%,48.53%,1
新竹市,北區,0221,465,202,667,22,689,1175,58.64%,39.57%,1
新竹市,北區,0222,505,293,798,36,834,1371,60.83%,36.83%,1
新竹市,北區,0223,509,183,692,35,727,1306,55.67%,38.97%,1
新竹市,北區,0224,525,187,712,18,730,1340,54.48%,39.18%,1
新竹市,北區,0225,458,197,655,37,692,1111,62.29%,41.22%,1
新竹市,北區,0226,529,207,736,31,767,1197,64.08%,44.19%,1
新竹市,北區,0227,455,118,573,13,586,1008,58.13%,45.14%,1
新竹市,北區,0228,378,137,515,12,527,946,55.71%,39.96%,1
新竹市,北區,0229,313,98,411,18,429,705,60.85%,44.4%,1
新竹市,北區,0230,360,116,476,32,508,848,59.91%,42.45%,1
新竹市,北區,0231,491,180,671,28,699,1295,53.98%,37.92%,1
新竹市,北區,0232,548,198,746,22,768,1467,52.35%,37.36%,1
新竹市,北區,0233,534,209,743,34,777,1659,46.84%,32.19%,1
新竹市,北區,0234,505,158,663,24,687,1297,52.97%,38.94%,1
新竹市,北區,0235,551,211,762,29,791,1374,57.57%,40.1%,1
新竹市,北區,0236,575,238,813,34,847,1457,58.13%,39.46%,1
新竹市,北區,0237,468,149,617,19,636,1072,59.33%,43.66%,1
新竹市,北區,0238,504,190,694,34,728,1350,53.93%,37.33%,1
新竹市,北區,0239,404,184,588,21,609,971,62.72%,41.61%,1
新竹市,北區,0240,695,113,808,43,851,1450,58.69%,47.93%,1
新竹市,北區,0241,379,112,491,20,511,895,57.09%,42.35%,1
新竹市,北區,0242,544,191,735,21,756,1378,54.86%,39.48%,1
新竹市,北區,0243,606,178,784,50,834,1609,51.83%,37.66%,1
新竹市,北區,0244,237,77,314,33,347,594,58.42%,39.9%,1
新竹市,香山區,0245,554,201,755,29,784,1443,54.33%,38.39%,1
新竹市,香山區,0246,450,217,667,17,684,1241,55.12%,36.26%,1
新竹市,香山區,0247,464,180,644,18,662,1194,55.44%,38.86%,1
新竹市,香山區,0248,396,199,595,8,603,1081,55.78%,36.63%,1
新竹市,香山區,0249,334,130,464,18,482,807,59.73%,41.39%,1
新竹市,香山區,0250,672,237,909,51,960,1760,54.55%,38.18%,1
新竹市,香山區,0251,638,244,882,36,918,1635,56.15%,39.02%,1
新竹市,香山區,0252,602,241,843,30,873,1473,59.27%,40.87%,1
新竹市,香山區,0253,587,193,780,22,802,1408,56.96%,41.69%,1
新竹市,香山區,0254,462,169,631,18,649,1318,49.24%,35.05%,1
新竹市,香山區,0255,512,219,731,25,756,1337,56.54%,38.29%,1
新竹市,香山區,0256,668,277,945,21,966,1862,51.88%,35.88%,1
新竹市,香山區,0257,314,271,585,20,605,1067,56.7%,29.43%,1
新竹市,香山區,0258,354,136,490,29,519,863,60.14%,41.02%,1
新竹市,香山區,0259,519,181,700,41,741,1198,61.85%,43.32%,1
新竹市,香山區,0260,473,186,659,35,694,1138,60.98%,41.56%,1
新竹市,香山區,0261,433,158,591,27,618,957,64.58%,45.25%,1
新竹市,香山區,0262,570,191,761,44,805,1348,59.72%,42.28%,1
新竹市,香山區,0263,489,165,654,38,692,1023,67.64%,47.8%,1
新竹市,香山區,0264,411,124,535,23,558,970,57.53%,42.37%,1
新竹市,香山區,0265,546,192,738,25,763,1318,57.89%,41.43%,1
新竹市,香山區,0266,429,144,573,35,608,1088,55.88%,39.43%,1
新竹市,香山區,0267,328,114,442,20,462,903,51.16%,36.32%,1
新竹市,香山區,0268,410,163,573,24,597,1012,58.99%,40.51%,1
新竹市,香山區,0269,433,116,549,27,576,1014,56.8%,42.7%,1
新竹市,香山區,0270,541,177,718,22,740,1238,59.77%,43.7%,1
新竹市,香山區,0271,486,142,628,42,670,1182,56.68%,41.12%,1
新竹市,香山區,0272,629,182,811,46,857,1331,64.39%,47.26%,1
新竹市,香山區,0273,389,227,616,13,629,976,64.45%,39.86%,1
新竹市,香山區,0274,320,126,446,18,464,834,55.64%,38.37%,1
新竹市,香山區,0275,381,132,513,19,532,919,57.89%,41.46%,1
新竹市,香山區,0276,450,234,684,20,704,1188,59.26%,37.88%,1
新竹市,香山區,0277,449,152,601,38,639,1086,58.84%,41.34%,1
新竹市,香山區,0278,498,200,698,18,716,1144,62.59%,43.53%,1
新竹市,香山區,0279,467,190,657,12,669,1112,60.16%,42%,1
新竹市,香山區,0280,593,220,813,40,853,1476,57.79%,40.18%,1
新竹市,香山區,0281,520,187,707,25,732,1291,56.7%,40.28%,1
新竹市,香山區,0282,653,215,868,39,907,1464,61.95%,44.6%,1
新竹市,香山區,0283,622,189,811,35,846,1427,59.29%,43.59%,1
新竹市,香山區,0284,525,195,720,28,748,1336,55.99%,39.3%,1
新竹市,香山區,0285,393,148,541,23,564,1131,49.87%,34.75%,1
新竹市,香山區,0286,453,161,614,37,651,1070,60.84%,42.34%,1
新竹市,香山區,0287,447,147,594,26,620,1006,61.63%,44.43%,1
新竹市,香山區,0288,464,102,566,35,601,1223,49.14%,37.94%,1
新竹市,香山區,0289,444,161,605,28,633,1119,56.57%,39.68%,1
新竹市,香山區,0290,537,167,704,23,727,1400,51.93%,38.36%,1
新竹市,香山區,0291,546,207,753,25,778,1627,47.82%,33.56%,1
新竹市,香山區,0292,458,176,634,18,652,1289,50.58%,35.53%,1
新竹市,香山區,0293,504,182,686,29,715,1409,50.75%,35.77%,1
新竹市,香山區,0294,294,109,403,25,428,814,52.58%,36.12%,1
新竹市,香山區,0295,288,103,391,16,407,719,56.61%,40.06%,1
新竹市,香山區,0296,359,141,500,21,521,1065,48.92%,33.71%,1
新竹市,香山區,0297,316,100,416,18,434,776,55.93%,40.72%,1
新竹市,香山區,0298,373,120,493,24,517,890,58.09%,41.91%,1
新竹市,香山區,0299,336,103,439,23,462,896,51.56%,37.5%,1
嘉義市,東區,0001,410,175,585,11,596,1025,58.15%,40%,1
嘉義市,東區,0002,494,191,685,12,697,1276,54.62%,38.71%,1
嘉義市,東區,0003,352,134,486,16,502,974,51.54%,36.14%,1
嘉義市,東區,0004,508,197,705,18,723,1175,61.53%,43.23%,1
嘉義市,東區,0005,308,123,431,9,440,702,62.68%,43.87%,1
嘉義市,東區,0006,405,185,590,19,609,1092,55.77%,37.09%,1
嘉義市,東區,0007,353,130,483,12,495,1023,48.39%,34.51%,1
嘉義市,東區,0008,676,243,919,27,946,1816,52.09%,37.22%,1
嘉義市,東區,0009,707,338,1045,24,1069,1936,55.22%,36.52%,1
嘉義市,東區,0010,596,346,942,17,959,1698,56.48%,35.1%,1
嘉義市,東區,0011,498,226,724,16,740,1221,60.61%,40.79%,1
嘉義市,東區,0012,433,201,634,14,648,1113,58.22%,38.9%,1
嘉義市,東區,0013,580,235,815,17,832,1452,57.3%,39.94%,1
嘉義市,東區,0014,569,262,831,21,852,1395,61.08%,40.79%,1
嘉義市,東區,0015,567,199,766,0,766,1453,52.72%,39.02%,1
嘉義市,東區,0016,446,133,579,13,592,1094,54.11%,40.77%,1
嘉義市,東區,0017,587,209,796,21,817,1420,57.54%,41.34%,1
嘉義市,東區,0018,655,240,895,21,916,1552,59.02%,42.2%,1
嘉義市,東區,0019,605,264,869,27,896,1558,57.51%,38.83%,1
嘉義市,東區,0020,457,155,612,21,633,1062,59.6%,43.03%,1
嘉義市,東區,0021,479,148,627,27,654,1199,54.55%,39.95%,1
嘉義市,東區,0022,525,153,678,19,697,1236,56.39%,42.48%,1
嘉義市,東區,0023,357,132,489,15,504,890,56.63%,40.11%,1
嘉義市,東區,0024,380,132,512,25,537,880,61.02%,43.18%,1
嘉義市,東區,0025,458,207,665,13,678,1189,57.02%,38.52%,1
嘉義市,東區,0026,280,106,386,11,397,669,59.34%,41.85%,1
嘉義市,東區,0027,392,377,769,21,790,1435,55.05%,27.32%,1
嘉義市,東區,0028,563,235,798,20,818,1349,60.64%,41.73%,1
嘉義市,東區,0029,526,231,757,18,775,1455,53.26%,36.15%,1
嘉義市,東區,0030,374,142,516,19,535,915,58.47%,40.87%,1
嘉義市,東區,0031,397,143,540,12,552,952,57.98%,41.7%,1
嘉義市,東區,0032,375,136,511,20,531,941,56.43%,39.85%,1
嘉義市,東區,0033,397,175,572,19,591,1080,54.72%,36.76%,1
嘉義市,東區,0034,440,150,590,24,614,1157,53.07%,38.03%,1
嘉義市,東區,0035,428,183,611,27,638,1053,60.59%,40.65%,1
嘉義市,東區,0036,360,128,488,13,501,967,51.81%,37.23%,1
嘉義市,東區,0037,400,168,568,24,592,1091,54.26%,36.66%,1
嘉義市,東區,0038,412,144,556,26,582,961,60.56%,42.87%,1
嘉義市,東區,0039,261,90,351,10,361,863,41.83%,30.24%,1
嘉義市,東區,0040,408,173,581,35,616,1023,60.22%,39.88%,1
嘉義市,東區,0041,455,157,612,37,649,1078,60.2%,42.21%,1
嘉義市,東區,0042,371,141,512,14,526,938,56.08%,39.55%,1
嘉義市,東區,0043,427,151,578,17,595,1049,56.72%,40.71%,1
嘉義市,東區,0044,524,166,690,27,717,1360,52.72%,38.53%,1
嘉義市,東區,0045,567,214,781,38,819,1615,50.71%,35.11%,1
嘉義市,東區,0046,467,191,658,23,681,1267,53.75%,36.86%,1
嘉義市,東區,0047,572,177,749,26,775,1579,49.08%,36.23%,1
嘉義市,東區,0048,642,270,912,34,946,1831,51.67%,35.06%,1
嘉義市,東區,0049,416,136,552,16,568,977,58.14%,42.58%,1
嘉義市,東區,0050,431,184,615,7,622,1169,53.21%,36.87%,1
嘉義市,東區,0051,504,200,704,40,744,1238,60.1%,40.71%,1
嘉義市,東區,0052,523,191,714,13,727,1266,57.42%,41.31%,1
嘉義市,東區,0053,529,139,668,25,693,1429,48.5%,37.02%,1
嘉義市,東區,0054,506,189,695,21,716,1288,55.59%,39.29%,1
嘉義市,東區,0055,372,159,531,14,545,980,55.61%,37.96%,1
嘉義市,東區,0056,340,127,467,17,484,922,52.49%,36.88%,1
嘉義市,東區,0057,480,165,645,23,668,1133,58.96%,42.37%,1
嘉義市,東區,0058,476,201,677,24,701,1235,56.76%,38.54%,1
嘉義市,東區,0059,579,244,823,12,835,1525,54.75%,37.97%,1
嘉義市,東區,0060,428,165,593,23,616,1170,52.65%,36.58%,1
嘉義市,東區,0061,511,204,715,26,741,1177,62.96%,43.42%,1
嘉義市,東區,0062,482,174,656,31,687,1207,56.92%,39.93%,1
嘉義市,東區,0063,521,181,702,20,722,1272,56.76%,40.96%,1
嘉義市,東區,0064,463,181,644,38,682,1188,57.41%,38.97%,1
嘉義市,東區,0065,413,172,585,11,596,1172,50.85%,35.24%,1
嘉義市,東區,0066,433,161,594,9,603,1020,59.12%,42.45%,1
嘉義市,東區,0067,508,236,744,20,764,1332,57.36%,38.14%,1
嘉義市,東區,0068,435,175,610,15,625,1011,61.82%,43.03%,1
嘉義市,東區,0069,609,242,851,32,883,1682,52.5%,36.21%,1
嘉義市,東區,0070,619,217,836,30,866,1567,55.26%,39.5%,1
嘉義市,東區,0071,468,202,670,15,685,1207,56.75%,38.77%,1
嘉義市,東區,0072,442,162,604,13,617,981,62.9%,45.06%,1
嘉義市,東區,0073,519,221,740,19,759,1395,54.41%,37.2%,1
嘉義市,東區,0074,490,202,692,14,706,1434,49.23%,34.17%,1
嘉義市,東區,0075,437,198,635,11,646,1404,46.01%,31.13%,1
嘉義市,東區,0076,594,218,812,12,824,1428,57.7%,41.6%,1
嘉義市,東區,0077,561,232,793,9,802,1823,43.99%,30.77%,1
嘉義市,東區,0078,548,221,769,17,786,1570,50.06%,34.9%,1
嘉義市,東區,0079,514,179,693,24,717,1282,55.93%,40.09%,1
嘉義市,東區,0080,666,233,899,26,925,1571,58.88%,42.39%,1
嘉義市,東區,0081,546,232,778,21,799,1533,52.12%,35.62%,1
嘉義市,西區,0082,362,119,481,13,494,885,55.82%,40.9%,1
嘉義市,西區,0083,414,159,573,32,605,1109,54.55%,37.33%,1
嘉義市,西區,0084,414,125,539,14,553,1020,54.22%,40.59%,1
嘉義市,西區,0085,421,132,553,29,582,925,62.92%,45.51%,1
嘉義市,西區,0086,550,244,794,15,809,1671,48.41%,32.91%,1
嘉義市,西區,0087,513,166,679,18,697,1215,57.37%,42.22%,1
嘉義市,西區,0088,433,139,572,20,592,1036,57.14%,41.8%,1
嘉義市,西區,0089,438,157,595,15,610,1129,54.03%,38.8%,1
嘉義市,西區,0090,444,154,598,16,614,1127,54.48%,39.4%,1
嘉義市,西區,0091,571,231,802,27,829,1415,58.59%,40.35%,1
嘉義市,西區,0092,525,182,707,16,723,1366,52.93%,38.43%,1
嘉義市,西區,0093,473,144,617,29,646,1053,61.35%,44.92%,1
嘉義市,西區,0094,491,117,608,11,619,1067,58.01%,46.02%,1
嘉義市,西區,0095,569,200,769,18,787,1575,49.97%,36.13%,1
嘉義市,西區,0096,631,283,914,25,939,1865,50.35%,33.83%,1
嘉義市,西區,0097,426,179,605,27,632,1196,52.84%,35.62%,1
嘉義市,西區,0098,467,178,645,18,663,1280,51.8%,36.48%,1
嘉義市,西區,0099,617,238,855,31,886,1629,54.39%,37.88%,1
嘉義市,西區,0100,554,216,770,42,812,1393,58.29%,39.77%,1
嘉義市,西區,0101,467,166,633,28,661,1077,61.37%,43.36%,1
嘉義市,西區,0102,523,264,787,14,801,1694,47.28%,30.87%,1
嘉義市,西區,0103,351,133,484,42,526,841,62.54%,41.74%,1
嘉義市,西區,0104,440,156,596,4,600,1183,50.72%,37.19%,1
嘉義市,西區,0105,448,166,614,17,631,1000,63.1%,44.8%,1
嘉義市,西區,0106,487,177,664,12,676,1095,61.74%,44.47%,1
嘉義市,西區,0107,520,225,745,21,766,1256,60.99%,41.4%,1
嘉義市,西區,0108,395,146,541,23,564,962,58.63%,41.06%,1
嘉義市,西區,0109,383,161,544,18,562,865,64.97%,44.28%,1
嘉義市,西區,0110,500,179,679,40,719,1396,51.5%,35.82%,1
嘉義市,西區,0111,669,282,951,40,991,1799,55.09%,37.19%,1
嘉義市,西區,0112,562,196,758,12,770,1505,51.16%,37.34%,1
嘉義市,西區,0113,674,223,897,26,923,1698,54.36%,39.69%,1
嘉義市,西區,0114,749,260,1009,23,1032,1854,55.66%,40.4%,1
嘉義市,西區,0115,495,189,684,13,697,1537,45.35%,32.21%,1
嘉義市,西區,0116,569,228,797,27,824,1604,51.37%,35.47%,1
嘉義市,西區,0117,438,137,575,28,603,944,63.88%,46.4%,1
嘉義市,西區,0118,679,234,913,29,942,1627,57.9%,41.73%,1
嘉義市,西區,0119,486,175,661,24,685,1144,59.88%,42.48%,1
嘉義市,西區,0120,526,191,717,33,750,1362,55.07%,38.62%,1
嘉義市,西區,0121,536,206,742,17,759,1279,59.34%,41.91%,1
嘉義市,西區,0122,698,232,930,27,957,1702,56.23%,41.01%,1
嘉義市,西區,0123,572,214,786,20,806,1358,59.35%,42.12%,1
嘉義市,西區,0124,593,216,809,24,833,1360,61.25%,43.6%,1
嘉義市,西區,0125,660,208,868,38,906,1589,57.02%,41.54%,1
嘉義市,西區,0126,573,177,750,22,772,1280,60.31%,44.77%,1
嘉義市,西區,0127,429,176,605,23,628,1220,51.48%,35.16%,1
嘉義市,西區,0128,523,175,698,9,707,1172,60.32%,44.62%,1
嘉義市,西區,0129,539,200,739,19,758,1320,57.42%,40.83%,1
嘉義市,西區,0130,559,207,766,12,778,1185,65.65%,47.17%,1
嘉義市,西區,0131,541,236,777,15,792,1278,61.97%,42.33%,1
嘉義市,西區,0132,421,200,621,11,632,1394,45.34%,30.2%,1
嘉義市,西區,0133,611,239,850,32,882,1540,57.27%,39.68%,1
嘉義市,西區,0134,612,229,841,36,877,1548,56.65%,39.53%,1
嘉義市,西區,0135,495,191,686,19,705,1295,54.44%,38.22%,1
嘉義市,西區,0136,566,209,775,23,798,1318,60.55%,42.94%,1
嘉義市,西區,0137,611,223,834,31,865,1545,55.99%,39.55%,1
嘉義市,西區,0138,266,113,379,22,401,736,54.48%,36.14%,1
嘉義市,西區,0139,466,144,610,10,620,1168,53.08%,39.9%,1
嘉義市,西區,0140,367,120,487,11,498,756,65.87%,48.54%,1
嘉義市,西區,0141,391,107,498,9,507,869,58.34%,44.99%,1
嘉義市,西區,0142,402,159,561,25,586,983,59.61%,40.9%,1
嘉義市,西區,0143,374,91,465,15,480,828,57.97%,45.17%,1
嘉義市,西區,0144,720,231,951,27,978,1775,55.1%,40.56%,1
嘉義市,西區,0145,564,179,743,21,764,1419,53.84%,39.75%,1
嘉義市,西區,0146,323,108,431,14,445,779,57.12%,41.46%,1
嘉義市,西區,0147,344,118,462,8,470,855,54.97%,40.23%,1
嘉義市,西區,0148,453,186,639,34,673,1146,58.73%,39.53%,1
嘉義市,西區,0149,484,144,628,25,653,1111,58.78%,43.56%,1
嘉義市,西區,0150,363,107,470,27,497,767,64.8%,47.33%,1
嘉義市,西區,0151,292,115,407,11,418,817,51.16%,35.74%,1
嘉義市,西區,0152,313,123,436,16,452,770,58.7%,40.65%,1
嘉義市,西區,0153,386,147,533,15,548,1135,48.28%,34.01%,1
嘉義市,西區,0154,282,139,421,35,456,835,54.61%,33.77%,1
嘉義市,西區,0155,450,131,581,25,606,1182,51.27%,38.07%,1
嘉義市,西區,0156,373,107,480,20,500,944,52.97%,39.51%,1
嘉義市,西區,0157,371,145,516,19,535,997,53.66%,37.21%,1
嘉義市,西區,0158,428,163,591,18,609,1074,56.7%,39.85%,1
嘉義市,西區,0159,436,213,649,13,662,1460,45.34%,29.86%,1
嘉義市,西區,0160,532,170,702,23,725,1352,53.62%,39.35%,1
嘉義市,西區,0161,571,228,799,25,824,1499,54.97%,38.09%,1
嘉義市,西區,0162,491,188,679,42,721,1262,57.13%,38.91%,1
嘉義市,西區,0163,507,186,693,15,708,1299,54.5%,39.03%,1
嘉義市,西區,0164,697,219,916,21,937,1734,54.04%,40.2%,1
嘉義市,西區,0165,604,204,808,25,833,1674,49.76%,36.08%,1
嘉義市,西區,0166,537,263,800,27,827,1540,53.7%,34.87%,1
嘉義市,西區,0167,477,161,638,8,646,1056,61.17%,45.17%,1
嘉義市,西區,0168,607,212,819,45,864,1467,58.9%,41.38%,1
嘉義市,西區,0169,524,195,719,30,749,1431,52.34%,36.62%,1
嘉義市,西區,0170,535,193,728,43,771,1234,62.48%,43.35%,1
嘉義市,西區,0171,481,197,678,12,690,1266,54.5%,37.99%,1
嘉義市,西區,0172,498,205,703,14,717,1211,59.21%,41.12%,1
嘉義市,西區,0173,445,194,639,12,651,1121,58.07%,39.7%,1
嘉義市,西區,0174,417,159,576,11,587,1155,50.82%,36.1%,1
嘉義市,西區,0175,596,248,844,54,898,1546,58.09%,38.55%,1
嘉義市,西區,0176,561,170,731,18,749,1322,56.66%,42.44%,1
嘉義市,西區,0177,636,195,831,48,879,1549,56.75%,41.06%,1
