縣市,鄉鎮市區,開票所,同意票,不同意票,有效票,無效票,投票數,投票權人數,投票率,投票權人數百分比,總數
臺北市,松山區,0527,594,340,934,27,961,1583,60.71%,37.52%,1
臺北市,松山區,0528,586,356,942,40,982,1691,58.07%,34.65%,1
臺北市,松山區,0529,505,260,765,28,793,1386,57.22%,36.44%,1
臺北市,松山區,0530,494,292,786,39,825,1362,60.57%,36.27%,1
臺北市,松山區,0531,522,292,814,32,846,1399,60.47%,37.31%,1
臺北市,松山區,0532,466,306,772,41,813,1324,61.4%,35.2%,1
臺北市,松山區,0533,492,306,798,33,831,1296,64.12%,37.96%,1
臺北市,松山區,0534,514,303,817,37,854,1386,61.62%,37.09%,1
臺北市,松山區,0535,551,372,923,48,971,1529,63.51%,36.04%,1
臺北市,松山區,0536,509,286,795,35,830,1416,58.62%,35.95%,1
臺北市,松山區,0537,648,194,842,64,906,1619,55.96%,40.02%,1
臺北市,松山區,0538,484,317,801,27,828,1386,59.74%,34.92%,1
臺北市,松山區,0539,506,356,862,30,892,1380,64.64%,36.67%,1
臺北市,松山區,0540,488,309,797,32,829,1357,61.09%,35.96%,1
臺北市,松山區,0541,505,294,799,19,818,1296,63.12%,38.97%,1
臺北市,松山區,0542,595,364,959,51,1010,1632,61.89%,36.46%,1
臺北市,松山區,0543,486,308,794,37,831,1414,58.77%,34.37%,1
臺北市,松山區,0544,533,297,830,25,855,1404,60.9%,37.96%,1
臺北市,松山區,0545,548,270,818,38,856,1365,62.71%,40.15%,1
臺北市,松山區,0546,517,303,820,46,866,1431,60.52%,36.13%,1
臺北市,松山區,0547,530,338,868,44,912,1483,61.5%,35.74%,1
臺北市,松山區,0548,489,300,789,29,818,1293,63.26%,37.82%,1
臺北市,松山區,0549,482,296,778,28,806,1410,57.16%,34.18%,1
臺北市,松山區,0550,503,249,752,43,795,1307,60.83%,38.49%,1
臺北市,松山區,0551,454,304,758,34,792,1242,63.77%,36.55%,1
臺北市,松山區,0552,475,242,717,21,738,1192,61.91%,39.85%,1
臺北市,松山區,0553,486,279,765,36,801,1276,62.77%,38.09%,1
臺北市,松山區,0554,446,243,689,20,709,1201,59.03%,37.14%,1
臺北市,松山區,0555,483,284,767,27,794,1318,60.24%,36.65%,1
臺北市,松山區,0556,453,247,700,28,728,1157,62.92%,39.15%,1
臺北市,松山區,0557,400,260,660,20,680,1157,58.77%,34.57%,1
臺北市,松山區,0558,535,266,801,34,835,1357,61.53%,39.43%,1
臺北市,松山區,0559,419,236,655,22,677,1215,55.72%,34.49%,1
臺北市,松山區,0560,474,282,756,32,788,1345,58.59%,35.24%,1
臺北市,松山區,0561,437,266,703,40,743,1237,60.06%,35.33%,1
臺北市,松山區,0562,599,245,844,32,876,1393,62.89%,43%,1
臺北市,松山區,0563,504,335,839,21,860,1331,64.61%,37.87%,1
臺北市,松山區,0564,562,363,925,45,970,1550,62.58%,36.26%,1
臺北市,松山區,0565,523,206,729,16,745,1308,56.96%,39.98%,1
臺北市,松山區,0566,560,280,840,39,879,1490,58.99%,37.58%,1
臺北市,松山區,0567,573,297,870,31,901,1406,64.08%,40.75%,1
臺北市,松山區,0568,429,314,743,29,772,1191,64.82%,36.02%,1
臺北市,松山區,0569,398,252,650,28,678,1095,61.92%,36.35%,1
臺北市,松山區,0570,454,231,685,28,713,1198,59.52%,37.9%,1
臺北市,松山區,0571,469,247,716,31,747,1265,59.05%,37.08%,1
臺北市,松山區,0572,426,276,702,23,725,1225,59.18%,34.78%,1
臺北市,松山區,0573,624,385,1009,43,1052,1698,61.96%,36.75%,1
臺北市,松山區,0574,686,325,1011,35,1046,1819,57.5%,37.71%,1
臺北市,松山區,0575,649,367,1016,37,1053,1754,60.03%,37%,1
臺北市,松山區,0576,471,335,806,42,848,1361,62.31%,34.61%,1
臺北市,松山區,0577,458,267,725,20,745,1189,62.66%,38.52%,1
臺北市,松山區,0578,455,265,720,28,748,1214,61.61%,37.48%,1
臺北市,松山區,0579,430,312,742,28,770,1284,59.97%,33.49%,1
臺北市,松山區,0580,470,298,768,36,804,1297,61.99%,36.24%,1
臺北市,松山區,0581,468,290,758,26,784,1330,58.95%,35.19%,1
臺北市,松山區,0582,545,284,829,38,867,1396,62.11%,39.04%,1
臺北市,松山區,0583,560,279,839,16,855,1480,57.77%,37.84%,1
臺北市,松山區,0584,561,283,844,22,866,1419,61.03%,39.53%,1
臺北市,松山區,0585,513,314,827,24,851,1390,61.22%,36.91%,1
臺北市,松山區,0586,525,361,886,33,919,1525,60.26%,34.43%,1
臺北市,松山區,0587,540,350,890,35,925,1633,56.64%,33.07%,1
臺北市,松山區,0588,508,355,863,33,896,2677,33.47%,18.98%,1
臺北市,松山區,0589,448,293,741,32,773,1281,60.34%,34.97%,1
臺北市,松山區,0590,414,275,689,34,723,1469,49.22%,28.18%,1
臺北市,松山區,0591,560,339,899,64,963,1700,56.65%,32.94%,1
臺北市,松山區,0592,487,318,805,34,839,1503,55.82%,32.4%,1
臺北市,松山區,0593,449,303,752,24,776,1309,59.28%,34.3%,1
臺北市,松山區,0594,505,285,790,47,837,1376,60.83%,36.7%,1
臺北市,松山區,0595,587,343,930,31,961,1654,58.1%,35.49%,1
臺北市,松山區,0596,523,323,846,53,899,1601,56.15%,32.67%,1
臺北市,松山區,0597,626,229,855,29,884,1496,59.09%,41.84%,1
臺北市,松山區,0598,578,381,959,55,1014,1598,63.45%,36.17%,1
臺北市,松山區,0599,632,373,1005,44,1049,1751,59.91%,36.09%,1
臺北市,松山區,0600,610,323,933,36,969,1557,62.24%,39.18%,1
臺北市,松山區,0601,733,340,1073,41,1114,1686,66.07%,43.48%,1
臺北市,松山區,0602,727,279,1006,41,1047,1707,61.34%,42.59%,1
臺北市,松山區,0603,781,367,1148,54,1202,1854,64.83%,42.13%,1
臺北市,松山區,0604,587,363,950,31,981,1740,56.38%,33.74%,1
臺北市,松山區,0605,535,299,834,49,883,1494,59.1%,35.81%,1
臺北市,松山區,0606,533,318,851,30,881,1453,60.63%,36.68%,1
臺北市,松山區,0607,530,306,836,39,875,1458,60.01%,36.35%,1
臺北市,松山區,0608,419,453,872,23,895,1536,58.27%,27.28%,1
臺北市,松山區,0609,550,304,854,25,879,1463,60.08%,37.59%,1
臺北市,松山區,0610,579,355,934,25,959,1790,53.58%,32.35%,1
臺北市,松山區,0611,593,386,979,35,1014,1679,60.39%,35.32%,1
臺北市,松山區,0612,552,343,895,40,935,1785,52.38%,30.92%,1
臺北市,松山區,0613,574,393,967,52,1019,1793,56.83%,32.01%,1
臺北市,松山區,0614,547,233,780,43,823,1381,59.59%,39.61%,1
臺北市,松山區,0615,478,273,751,25,776,1279,60.67%,37.37%,1
臺北市,松山區,0616,602,348,950,65,1015,1681,60.38%,35.81%,1
臺北市,松山區,0617,457,279,736,43,779,1232,63.23%,37.09%,1
臺北市,松山區,0618,542,328,870,27,897,1533,58.51%,35.36%,1
臺北市,松山區,0619,551,366,917,35,952,1540,61.82%,35.78%,1
臺北市,松山區,0620,590,361,951,32,983,1716,57.28%,34.38%,1
臺北市,松山區,0621,529,370,899,42,941,1664,56.55%,31.79%,1
臺北市,松山區,0622,467,287,754,26,780,1350,57.78%,34.59%,1
臺北市,松山區,0623,624,387,1011,39,1050,1837,57.16%,33.97%,1
臺北市,松山區,0624,503,305,808,48,856,1558,54.94%,32.28%,1
臺北市,松山區,0625,540,298,838,34,872,1420,61.41%,38.03%,1
臺北市,松山區,0626,500,300,800,30,830,1474,56.31%,33.92%,1
臺北市,松山區,0627,545,324,869,49,918,1591,57.7%,34.26%,1
臺北市,松山區,0628,611,350,961,39,1000,1726,57.94%,35.4%,1
臺北市,松山區,0629,486,337,823,29,852,1452,58.68%,33.47%,1
臺北市,松山區,0630,502,320,822,25,847,1482,57.15%,33.87%,1
臺北市,松山區,0631,514,329,843,36,879,1460,60.21%,35.21%,1
臺北市,松山區,0632,436,336,772,35,807,1398,57.73%,31.19%,1
臺北市,松山區,0633,514,320,834,36,870,1423,61.14%,36.12%,1
臺北市,松山區,0634,474,253,727,20,747,1226,60.93%,38.66%,1
臺北市,松山區,0635,418,244,662,35,697,1158,60.19%,36.1%,1
臺北市,松山區,0636,481,321,802,23,825,1426,57.85%,33.73%,1
臺北市,松山區,0637,464,235,699,10,709,1177,60.24%,39.42%,1
臺北市,松山區,0638,468,304,772,25,797,1363,58.47%,34.34%,1
臺北市,松山區,0639,478,256,734,37,771,1240,62.18%,38.55%,1
臺北市,松山區,0640,539,283,822,34,856,1375,62.25%,39.2%,1
臺北市,松山區,0641,496,306,802,24,826,1377,59.99%,36.02%,1
臺北市,松山區,0642,427,229,656,16,672,1225,54.86%,34.86%,1
臺北市,松山區,0643,374,258,632,22,654,1017,64.31%,36.77%,1
臺北市,信義區,0644,522,274,796,21,817,2476,33%,21.08%,1
臺北市,信義區,0645,593,273,866,16,882,1381,63.87%,42.94%,1
臺北市,信義區,0646,527,253,780,39,819,1294,63.29%,40.73%,1
臺北市,信義區,0647,487,284,771,31,802,1351,59.36%,36.05%,1
臺北市,信義區,0648,489,262,751,24,775,1296,59.8%,37.73%,1
臺北市,信義區,0649,504,282,786,26,812,1302,62.37%,38.71%,1
臺北市,信義區,0650,350,196,546,46,592,1025,57.76%,34.15%,1
臺北市,信義區,0651,467,294,761,27,788,1421,55.45%,32.86%,1
臺北市,信義區,0652,530,298,828,28,856,1501,57.03%,35.31%,1
臺北市,信義區,0653,480,317,797,27,824,1575,52.32%,30.48%,1
臺北市,信義區,0654,572,294,866,21,887,1516,58.51%,37.73%,1
臺北市,信義區,0655,489,322,811,27,838,1382,60.64%,35.38%,1
臺北市,信義區,0656,411,220,631,30,661,1128,58.6%,36.44%,1
臺北市,信義區,0657,498,271,769,30,799,1397,57.19%,35.65%,1
臺北市,信義區,0658,433,250,683,40,723,1161,62.27%,37.3%,1
臺北市,信義區,0659,471,300,771,32,803,1368,58.7%,34.43%,1
臺北市,信義區,0660,416,207,623,17,640,1049,61.01%,39.66%,1
臺北市,信義區,0661,498,258,756,31,787,1308,60.17%,38.07%,1
臺北市,信義區,0662,423,275,698,33,731,1154,63.34%,36.66%,1
臺北市,信義區,0663,353,291,644,19,663,1078,61.5%,32.75%,1
臺北市,信義區,0664,492,287,779,30,809,1375,58.84%,35.78%,1
臺北市,信義區,0665,544,273,817,40,857,1448,59.19%,37.57%,1
臺北市,信義區,0666,483,269,752,17,769,1250,61.52%,38.64%,1
臺北市,信義區,0667,470,343,813,14,827,1381,59.88%,34.03%,1
臺北市,信義區,0668,460,259,719,30,749,1213,61.75%,37.92%,1
臺北市,信義區,0669,526,300,826,25,851,1373,61.98%,38.31%,1
臺北市,信義區,0670,453,269,722,33,755,1226,61.58%,36.95%,1
臺北市,信義區,0671,429,243,672,9,681,1117,60.97%,38.41%,1
臺北市,信義區,0672,438,233,671,27,698,1123,62.15%,39%,1
臺北市,信義區,0673,450,247,697,31,728,1200,60.67%,37.5%,1
臺北市,信義區,0674,437,252,689,21,710,1335,53.18%,32.73%,1
臺北市,信義區,0675,470,245,715,22,737,1332,55.33%,35.29%,1
臺北市,信義區,0676,609,322,931,54,985,1648,59.77%,36.95%,1
臺北市,信義區,0677,519,304,823,53,876,1542,56.81%,33.66%,1
臺北市,信義區,0678,429,263,692,42,734,1228,59.77%,34.93%,1
臺北市,信義區,0679,564,376,940,39,979,1731,56.56%,32.58%,1
臺北市,信義區,0680,497,317,814,30,844,1403,60.16%,35.42%,1
臺北市,信義區,0681,647,344,991,74,1065,1929,55.21%,33.54%,1
臺北市,信義區,0682,469,298,767,32,799,1300,61.46%,36.08%,1
臺北市,信義區,0683,467,311,778,23,801,1486,53.9%,31.43%,1
臺北市,信義區,0684,469,287,756,33,789,1532,51.5%,30.61%,1
臺北市,信義區,0685,543,291,834,35,869,1387,62.65%,39.15%,1
臺北市,信義區,0686,402,223,625,35,660,1195,55.23%,33.64%,1
臺北市,信義區,0687,357,229,586,28,614,1068,57.49%,33.43%,1
臺北市,信義區,0688,439,236,675,28,703,1273,55.22%,34.49%,1
臺北市,信義區,0689,495,301,796,47,843,1329,63.43%,37.25%,1
臺北市,信義區,0690,453,263,716,30,746,1311,56.9%,34.55%,1
臺北市,信義區,0691,441,231,672,44,716,1258,56.92%,35.06%,1
臺北市,信義區,0692,445,289,734,40,774,1277,60.61%,34.85%,1
臺北市,信義區,0693,484,298,782,36,818,1285,63.66%,37.67%,1
臺北市,信義區,0694,421,283,704,38,742,1161,63.91%,36.26%,1
臺北市,信義區,0695,424,310,734,30,764,1299,58.81%,32.64%,1
臺北市,信義區,0696,442,247,689,29,718,1243,57.76%,35.56%,1
臺北市,信義區,0697,395,273,668,29,697,1197,58.23%,33%,1
臺北市,信義區,0698,474,283,757,26,783,1224,63.97%,38.73%,1
臺北市,信義區,0699,388,236,624,32,656,1147,57.19%,33.83%,1
臺北市,信義區,0700,369,245,614,16,630,1045,60.29%,35.31%,1
臺北市,信義區,0701,439,229,668,29,697,1096,63.59%,40.05%,1
臺北市,信義區,0702,380,252,632,15,647,1115,58.03%,34.08%,1
臺北市,信義區,0703,407,206,613,35,648,1117,58.01%,36.44%,1
臺北市,信義區,0704,297,218,515,23,538,1019,52.8%,29.15%,1
臺北市,信義區,0705,469,292,761,38,799,1346,59.36%,34.84%,1
臺北市,信義區,0706,490,281,771,32,803,1405,57.15%,34.88%,1
臺北市,信義區,0707,482,292,774,24,798,1356,58.85%,35.55%,1
臺北市,信義區,0708,474,301,775,31,806,1250,64.48%,37.92%,1
臺北市,信義區,0709,491,258,749,24,773,1254,61.64%,39.15%,1
臺北市,信義區,0710,461,295,756,24,780,1317,59.23%,35%,1
臺北市,信義區,0711,483,276,759,39,798,1271,62.79%,38%,1
臺北市,信義區,0712,326,214,540,27,567,979,57.92%,33.3%,1
臺北市,信義區,0713,330,207,537,40,577,1025,56.29%,32.2%,1
臺北市,信義區,0714,480,267,747,26,773,1512,51.12%,31.75%,1
臺北市,信義區,0715,546,329,875,24,899,1483,60.62%,36.82%,1
臺北市,信義區,0716,511,298,809,28,837,1359,61.59%,37.6%,1
臺北市,信義區,0717,536,284,820,23,843,1387,60.78%,38.64%,1
臺北市,信義區,0718,487,291,778,25,803,1455,55.19%,33.47%,1
臺北市,信義區,0719,512,321,833,22,855,1461,58.52%,35.04%,1
臺北市,信義區,0720,541,342,883,34,917,1532,59.86%,35.31%,1
臺北市,信義區,0721,364,270,634,29,663,1043,63.57%,34.9%,1
臺北市,信義區,0722,323,209,532,27,559,875,63.89%,36.91%,1
臺北市,信義區,0723,330,185,515,24,539,927,58.14%,35.6%,1
臺北市,信義區,0724,424,222,646,41,687,1119,61.39%,37.89%,1
臺北市,信義區,0725,514,307,821,38,859,1463,58.71%,35.13%,1
臺北市,信義區,0726,480,312,792,38,830,1293,64.19%,37.12%,1
臺北市,信義區,0727,540,303,843,38,881,1553,56.73%,34.77%,1
臺北市,信義區,0728,454,320,774,19,793,1360,58.31%,33.38%,1
臺北市,信義區,0729,483,311,794,42,836,1392,60.06%,34.7%,1
臺北市,信義區,0730,493,303,796,21,817,1377,59.33%,35.8%,1
臺北市,信義區,0731,484,315,799,12,811,1377,58.9%,35.15%,1
臺北市,信義區,0732,428,241,669,26,695,1269,54.77%,33.73%,1
臺北市,信義區,0733,518,278,796,45,841,1407,59.77%,36.82%,1
臺北市,信義區,0734,416,243,659,31,690,1172,58.87%,35.49%,1
臺北市,信義區,0735,412,254,666,28,694,1182,58.71%,34.86%,1
臺北市,信義區,0736,449,273,722,39,761,1255,60.64%,35.78%,1
臺北市,信義區,0737,564,319,883,28,911,1689,53.94%,33.39%,1
臺北市,信義區,0738,553,306,859,26,885,1605,55.14%,34.45%,1
臺北市,信義區,0739,429,207,636,21,657,1143,57.48%,37.53%,1
臺北市,信義區,0740,487,277,764,28,792,1440,55%,33.82%,1
臺北市,信義區,0741,542,290,832,29,861,1495,57.59%,36.25%,1
臺北市,信義區,0742,539,342,881,48,929,1514,61.36%,35.6%,1
臺北市,信義區,0743,524,272,796,29,825,1449,56.94%,36.16%,1
臺北市,信義區,0744,526,296,822,39,861,1401,61.46%,37.54%,1
臺北市,信義區,0745,417,224,641,16,657,1181,55.63%,35.31%,1
臺北市,信義區,0746,560,303,863,20,883,1376,64.17%,40.7%,1
臺北市,信義區,0747,578,259,837,39,876,1422,61.6%,40.65%,1
臺北市,信義區,0748,475,249,724,14,738,1267,58.25%,37.49%,1
臺北市,信義區,0749,375,286,661,18,679,1220,55.66%,30.74%,1
臺北市,信義區,0750,528,270,798,31,829,1562,53.07%,33.8%,1
臺北市,信義區,0751,487,316,803,23,826,1455,56.77%,33.47%,1
臺北市,信義區,0752,547,311,858,35,893,1605,55.64%,34.08%,1
臺北市,信義區,0753,647,327,974,30,1004,1626,61.75%,39.79%,1
臺北市,信義區,0754,548,349,897,44,941,1561,60.28%,35.11%,1
臺北市,信義區,0755,469,283,752,26,778,1547,50.29%,30.32%,1
臺北市,信義區,0756,447,300,747,19,766,1336,57.34%,33.46%,1
臺北市,信義區,0757,424,241,665,26,691,1314,52.59%,32.27%,1
臺北市,信義區,0758,454,241,695,33,728,1297,56.13%,35%,1
臺北市,信義區,0759,471,262,733,32,765,1366,56%,34.48%,1
臺北市,信義區,0760,499,306,805,34,839,1472,57%,33.9%,1
臺北市,信義區,0761,511,290,801,31,832,1450,57.38%,35.24%,1
臺北市,信義區,0762,477,270,747,26,773,1328,58.21%,35.92%,1
臺北市,信義區,0763,517,306,823,33,856,1399,61.19%,36.95%,1
臺北市,信義區,0764,504,284,788,55,843,1373,61.4%,36.71%,1
臺北市,信義區,0765,413,193,606,21,627,1099,57.05%,37.58%,1
臺北市,信義區,0766,427,251,678,32,710,1226,57.91%,34.83%,1
臺北市,信義區,0767,440,246,686,17,703,1267,55.49%,34.73%,1
臺北市,信義區,0768,571,297,868,38,906,1531,59.18%,37.3%,1
臺北市,信義區,0769,546,289,835,32,867,1438,60.29%,37.97%,1
臺北市,信義區,0770,557,338,895,21,916,1657,55.28%,33.61%,1
臺北市,信義區,0771,597,341,938,31,969,1621,59.78%,36.83%,1
臺北市,信義區,0772,545,342,887,23,910,1508,60.34%,36.14%,1
臺北市,信義區,0773,486,295,781,33,814,1334,61.02%,36.43%,1
臺北市,信義區,0774,368,201,569,30,599,1246,48.07%,29.53%,1
臺北市,信義區,0775,448,291,739,12,751,1196,62.79%,37.46%,1
臺北市,信義區,0776,454,262,716,25,741,1220,60.74%,37.21%,1
臺北市,信義區,0777,538,312,850,26,876,1538,56.96%,34.98%,1
臺北市,信義區,0778,583,310,893,51,944,1565,60.32%,37.25%,1
臺北市,信義區,0779,499,332,831,57,888,1621,54.78%,30.78%,1
臺北市,信義區,0780,504,296,800,47,847,1486,57%,33.92%,1
臺北市,信義區,0781,496,294,790,37,827,1507,54.88%,32.91%,1
臺北市,信義區,0782,550,313,863,39,902,1516,59.5%,36.28%,1
臺北市,信義區,0783,527,240,767,42,809,1287,62.86%,40.95%,1
臺北市,信義區,0784,331,185,516,49,565,1050,53.81%,31.52%,1
臺北市,信義區,0785,323,133,456,43,499,801,62.3%,40.32%,1
臺北市,大安區,1214,408,221,629,25,654,1184,55.24%,34.46%,1
臺北市,大安區,1215,407,219,626,34,660,1197,55.14%,34%,1
臺北市,大安區,1216,414,270,684,27,711,1221,58.23%,33.91%,1
臺北市,大安區,1217,476,248,724,25,749,1246,60.11%,38.2%,1
臺北市,大安區,1218,526,350,876,27,903,1478,61.1%,35.59%,1
臺北市,大安區,1219,410,314,724,35,759,1314,57.76%,31.2%,1
臺北市,大安區,1220,562,355,917,43,960,1594,60.23%,35.26%,1
臺北市,大安區,1221,500,332,832,26,858,1429,60.04%,34.99%,1
臺北市,大安區,1222,564,306,870,22,892,1452,61.43%,38.84%,1
臺北市,大安區,1223,521,354,875,28,903,1551,58.22%,33.59%,1
臺北市,大安區,1224,502,275,777,33,810,1335,60.67%,37.6%,1
臺北市,大安區,1225,399,250,649,19,668,1196,55.85%,33.36%,1
臺北市,大安區,1226,427,280,707,30,737,1339,55.04%,31.89%,1
臺北市,大安區,1227,467,342,809,25,834,1448,57.6%,32.25%,1
臺北市,大安區,1228,488,279,767,31,798,1373,58.12%,35.54%,1
臺北市,大安區,1229,493,305,798,42,840,1439,58.37%,34.26%,1
臺北市,大安區,1230,394,239,633,5,638,1174,54.34%,33.56%,1
臺北市,大安區,1231,384,213,597,19,616,1144,53.85%,33.57%,1
臺北市,大安區,1232,421,160,581,20,601,1119,53.71%,37.62%,1
臺北市,大安區,1233,325,164,489,16,505,1024,49.32%,31.74%,1
臺北市,大安區,1234,413,202,615,13,628,1032,60.85%,40.02%,1
臺北市,大安區,1235,550,215,765,24,789,1319,59.82%,41.7%,1
臺北市,大安區,1236,507,305,812,28,840,1369,61.36%,37.03%,1
臺北市,大安區,1237,447,324,771,28,799,1347,59.32%,33.18%,1
臺北市,大安區,1238,491,346,837,28,865,1655,52.27%,29.67%,1
臺北市,大安區,1239,524,273,797,21,818,1595,51.29%,32.85%,1
臺北市,大安區,1240,469,295,764,31,795,1429,55.63%,32.82%,1
臺北市,大安區,1241,435,251,686,17,703,1309,53.71%,33.23%,1
臺北市,大安區,1242,519,283,802,26,828,1508,54.91%,34.42%,1
臺北市,大安區,1243,428,281,709,34,743,1310,56.72%,32.67%,1
臺北市,大安區,1244,412,231,643,23,666,1233,54.01%,33.41%,1
臺北市,大安區,1245,411,253,664,34,698,1287,54.23%,31.93%,1
臺北市,大安區,1246,359,235,594,19,613,1147,53.44%,31.3%,1
臺北市,大安區,1247,404,245,649,27,676,1260,53.65%,32.06%,1
臺北市,大安區,1248,475,250,725,33,758,1377,55.05%,34.5%,1
臺北市,大安區,1249,408,260,668,52,720,1284,56.07%,31.78%,1
臺北市,大安區,1250,424,241,665,23,688,1314,52.36%,32.27%,1
臺北市,大安區,1251,403,250,653,26,679,1273,53.34%,31.66%,1
臺北市,大安區,1252,367,286,653,22,675,1146,58.9%,32.02%,1
臺北市,大安區,1253,458,294,752,18,770,1285,59.92%,35.64%,1
臺北市,大安區,1254,445,330,775,17,792,1297,61.06%,34.31%,1
臺北市,大安區,1255,405,254,659,22,681,1101,61.85%,36.78%,1
臺北市,大安區,1256,422,296,718,42,760,1310,58.02%,32.21%,1
臺北市,大安區,1257,471,340,811,35,846,1365,61.98%,34.51%,1
臺北市,大安區,1258,483,292,775,24,799,1372,58.24%,35.2%,1
臺北市,大安區,1259,434,275,709,22,731,1189,61.48%,36.5%,1
臺北市,大安區,1260,457,288,745,18,763,1256,60.75%,36.39%,1
臺北市,大安區,1261,398,262,660,31,691,1151,60.03%,34.58%,1
臺北市,大安區,1262,537,379,916,25,941,1501,62.69%,35.78%,1
臺北市,大安區,1263,587,322,909,25,934,1520,61.45%,38.62%,1
臺北市,大安區,1264,578,342,920,34,954,1529,62.39%,37.8%,1
臺北市,大安區,1265,565,369,934,26,960,1579,60.8%,35.78%,1
臺北市,大安區,1266,407,257,664,14,678,2619,25.89%,15.54%,1
臺北市,大安區,1267,575,162,737,17,754,1290,58.45%,44.57%,1
臺北市,大安區,1268,479,319,798,26,824,1307,63.05%,36.65%,1
臺北市,大安區,1269,528,365,893,25,918,1489,61.65%,35.46%,1
臺北市,大安區,1270,424,238,662,24,686,1097,62.53%,38.65%,1
臺北市,大安區,1271,460,313,773,20,793,1328,59.71%,34.64%,1
臺北市,大安區,1272,416,246,662,18,680,1189,57.19%,34.99%,1
臺北市,大安區,1273,444,288,732,20,752,1270,59.21%,34.96%,1
臺北市,大安區,1274,423,337,760,15,775,1349,57.45%,31.36%,1
臺北市,大安區,1275,434,276,710,21,731,1292,56.58%,33.59%,1
臺北市,大安區,1276,498,288,786,28,814,1314,61.95%,37.9%,1
臺北市,大安區,1277,425,282,707,23,730,1200,60.83%,35.42%,1
臺北市,大安區,1278,547,327,874,28,902,1558,57.89%,35.11%,1
臺北市,大安區,1279,525,343,868,25,893,1561,57.21%,33.63%,1
臺北市,大安區,1280,529,308,837,32,869,1446,60.1%,36.58%,1
臺北市,大安區,1281,531,335,866,18,884,1499,58.97%,35.42%,1
臺北市,大安區,1282,554,299,853,21,874,1467,59.58%,37.76%,1
臺北市,大安區,1283,522,287,809,25,834,1511,55.2%,34.55%,1
臺北市,大安區,1284,582,346,928,38,966,1600,60.38%,36.38%,1
臺北市,大安區,1285,556,353,909,30,939,1573,59.69%,35.35%,1
臺北市,大安區,1286,562,330,892,28,920,1467,62.71%,38.31%,1
臺北市,大安區,1287,509,273,782,23,805,1358,59.28%,37.48%,1
臺北市,大安區,1288,553,332,885,23,908,1568,57.91%,35.27%,1
臺北市,大安區,1289,516,303,819,33,852,1411,60.38%,36.57%,1
臺北市,大安區,1290,556,301,857,16,873,1554,56.18%,35.78%,1
臺北市,大安區,1291,501,297,798,28,826,1345,61.41%,37.25%,1
臺北市,大安區,1292,584,253,837,11,848,1435,59.09%,40.7%,1
臺北市,大安區,1293,590,328,918,16,934,1481,63.07%,39.84%,1
臺北市,大安區,1294,624,297,921,24,945,1451,65.13%,43%,1
臺北市,大安區,1295,539,242,781,52,833,1566,53.19%,34.42%,1
臺北市,大安區,1296,543,336,879,21,900,1525,59.02%,35.61%,1
臺北市,大安區,1297,461,276,737,26,763,1336,57.11%,34.51%,1
臺北市,大安區,1298,546,317,863,32,895,1483,60.35%,36.82%,1
臺北市,大安區,1299,445,280,725,18,743,1396,53.22%,31.88%,1
臺北市,大安區,1300,514,320,834,34,868,1406,61.74%,36.56%,1
臺北市,大安區,1301,539,301,840,22,862,1434,60.11%,37.59%,1
臺北市,大安區,1302,447,287,734,25,759,1288,58.93%,34.7%,1
臺北市,大安區,1303,524,298,822,24,846,1407,60.13%,37.24%,1
臺北市,大安區,1304,507,315,822,24,846,1514,55.88%,33.49%,1
臺北市,大安區,1305,484,257,741,39,780,1550,50.32%,31.23%,1
臺北市,大安區,1306,540,299,839,30,869,1490,58.32%,36.24%,1
臺北市,大安區,1307,414,292,706,27,733,1284,57.09%,32.24%,1
臺北市,大安區,1308,407,255,662,21,683,1129,60.5%,36.05%,1
臺北市,大安區,1309,412,275,687,20,707,1193,59.26%,34.53%,1
臺北市,大安區,1310,367,211,578,32,610,1057,57.71%,34.72%,1
臺北市,大安區,1311,460,295,755,33,788,1361,57.9%,33.8%,1
臺北市,大安區,1312,498,267,765,39,804,1412,56.94%,35.27%,1
臺北市,大安區,1313,400,267,667,17,684,1423,48.07%,28.11%,1
臺北市,大安區,1314,411,264,675,62,737,1257,58.63%,32.7%,1
臺北市,大安區,1315,457,228,685,21,706,1133,62.31%,40.34%,1
臺北市,大安區,1316,367,247,614,18,632,1077,58.68%,34.08%,1
臺北市,大安區,1317,481,268,749,36,785,1300,60.38%,37%,1
臺北市,大安區,1318,514,267,781,44,825,1319,62.55%,38.97%,1
臺北市,大安區,1319,465,251,716,41,757,1265,59.84%,36.76%,1
臺北市,大安區,1320,445,229,674,28,702,1265,55.49%,35.18%,1
臺北市,大安區,1321,403,226,629,36,665,1103,60.29%,36.54%,1
臺北市,大安區,1322,486,288,774,26,800,1341,59.66%,36.24%,1
臺北市,大安區,1323,510,286,796,30,826,1357,60.87%,37.58%,1
臺北市,大安區,1324,428,286,714,32,746,1260,59.21%,33.97%,1
臺北市,大安區,1325,447,290,737,34,771,1295,59.54%,34.52%,1
臺北市,大安區,1326,451,294,745,18,763,1399,54.54%,32.24%,1
臺北市,大安區,1327,401,228,629,30,659,1150,57.3%,34.87%,1
臺北市,大安區,1328,427,272,699,15,714,1351,52.85%,31.61%,1
臺北市,大安區,1329,463,295,758,36,794,1341,59.21%,34.53%,1
臺北市,大安區,1330,400,213,613,17,630,1129,55.8%,35.43%,1
臺北市,大安區,1331,485,253,738,24,762,1328,57.38%,36.52%,1
臺北市,大安區,1332,671,290,961,29,990,1557,63.58%,43.1%,1
臺北市,大安區,1333,587,310,897,34,931,1461,63.72%,40.18%,1
臺北市,大安區,1334,513,288,801,22,823,1589,51.79%,32.28%,1
臺北市,大安區,1335,539,274,813,20,833,1473,56.55%,36.59%,1
臺北市,大安區,1336,470,343,813,28,841,1479,56.86%,31.78%,1
臺北市,大安區,1337,338,157,495,29,524,833,62.91%,40.58%,1
臺北市,大安區,1338,340,209,549,26,575,999,57.56%,34.03%,1
臺北市,大安區,1339,643,370,1013,25,1038,1757,59.08%,36.6%,1
臺北市,大安區,1340,571,329,900,26,926,1573,58.87%,36.3%,1
臺北市,大安區,1341,576,384,960,22,982,1587,61.88%,36.29%,1
臺北市,大安區,1342,533,341,874,40,914,1496,61.1%,35.63%,1
臺北市,大安區,1343,481,367,848,20,868,1440,60.28%,33.4%,1
臺北市,大安區,1344,587,343,930,36,966,1578,61.22%,37.2%,1
臺北市,大安區,1345,412,297,709,19,728,1223,59.53%,33.69%,1
臺北市,大安區,1346,370,268,638,13,651,1119,58.18%,33.07%,1
臺北市,大安區,1347,466,296,762,11,773,1252,61.74%,37.22%,1
臺北市,大安區,1348,553,367,920,37,957,1576,60.72%,35.09%,1
臺北市,大安區,1349,496,307,803,31,834,1425,58.53%,34.81%,1
臺北市,大安區,1350,486,298,784,19,803,1450,55.38%,33.52%,1
臺北市,大安區,1351,699,201,900,22,922,1444,63.85%,48.41%,1
臺北市,大安區,1352,496,327,823,30,853,1337,63.8%,37.1%,1
臺北市,大安區,1353,482,288,770,17,787,1417,55.54%,34.02%,1
臺北市,大安區,1354,466,262,728,23,751,1250,60.08%,37.28%,1
臺北市,大安區,1355,410,238,648,37,685,1176,58.25%,34.86%,1
臺北市,大安區,1356,500,263,763,24,787,1257,62.61%,39.78%,1
臺北市,大安區,1357,451,264,715,36,751,1257,59.75%,35.88%,1
臺北市,大安區,1358,406,256,662,28,690,1148,60.1%,35.37%,1
臺北市,大安區,1359,483,316,799,27,826,1418,58.25%,34.06%,1
臺北市,大安區,1360,345,230,575,23,598,1028,58.17%,33.56%,1
臺北市,大安區,1361,508,338,846,26,872,1445,60.35%,35.16%,1
臺北市,大安區,1362,486,297,783,34,817,1361,60.03%,35.71%,1
臺北市,大安區,1363,556,262,818,26,844,1343,62.84%,41.4%,1
臺北市,大安區,1364,456,271,727,30,757,1267,59.75%,35.99%,1
臺北市,大安區,1365,436,288,724,23,747,1380,54.13%,31.59%,1
臺北市,大安區,1366,502,326,828,45,873,1524,57.28%,32.94%,1
臺北市,大安區,1367,564,291,855,24,879,1470,59.8%,38.37%,1
臺北市,大安區,1368,418,230,648,32,680,1318,51.59%,31.71%,1
臺北市,大安區,1369,482,275,757,26,783,1430,54.76%,33.71%,1
臺北市,大安區,1370,510,261,771,28,799,1386,57.65%,36.8%,1
臺北市,大安區,1371,493,265,758,19,777,1438,54.03%,34.28%,1
臺北市,大安區,1372,410,237,647,17,664,1270,52.28%,32.28%,1
臺北市,大安區,1373,480,263,743,37,780,1395,55.91%,34.41%,1
臺北市,大安區,1374,465,243,708,31,739,1292,57.2%,35.99%,1
臺北市,大安區,1375,419,289,708,25,733,1310,55.95%,31.98%,1
臺北市,大安區,1376,448,281,729,27,756,1319,57.32%,33.97%,1
臺北市,大安區,1377,474,309,783,19,802,1355,59.19%,34.98%,1
臺北市,大安區,1378,428,247,675,17,692,1312,52.74%,32.62%,1
臺北市,大安區,1379,472,277,749,21,770,1335,57.68%,35.36%,1
臺北市,大安區,1380,481,292,773,25,798,1489,53.59%,32.3%,1
臺北市,大安區,1381,473,279,752,19,771,1307,58.99%,36.19%,1
臺北市,大安區,1382,418,270,688,17,705,1328,53.09%,31.48%,1
臺北市,大安區,1383,440,258,698,7,705,1277,55.21%,34.46%,1
臺北市,大安區,1384,443,289,732,30,762,1314,57.99%,33.71%,1
臺北市,大安區,1385,459,278,737,30,767,1270,60.39%,36.14%,1
臺北市,大安區,1386,416,303,719,40,759,1308,58.03%,31.8%,1
臺北市,大安區,1387,419,250,669,15,684,1138,60.11%,36.82%,1
臺北市,大安區,1388,464,254,718,26,744,1333,55.81%,34.81%,1
臺北市,大安區,1389,406,254,660,32,692,1176,58.84%,34.52%,1
臺北市,大安區,1390,459,259,718,30,748,1311,57.06%,35.01%,1
臺北市,大安區,1391,466,246,712,18,730,1295,56.37%,35.98%,1
臺北市,大安區,1392,527,279,806,34,840,1421,59.11%,37.09%,1
臺北市,大安區,1393,477,275,752,28,780,1409,55.36%,33.85%,1
臺北市,大安區,1394,492,325,817,30,847,1434,59.07%,34.31%,1
臺北市,大安區,1395,464,279,743,46,789,1449,54.45%,32.02%,1
臺北市,大安區,1396,445,291,736,26,762,1284,59.35%,34.66%,1
臺北市,大安區,1397,441,250,691,21,712,1248,57.05%,35.34%,1
臺北市,大安區,1398,442,277,719,18,737,1119,65.86%,39.5%,1
臺北市,大安區,1399,319,189,508,27,535,883,60.59%,36.13%,1
臺北市,大安區,1400,214,102,316,44,360,630,57.14%,33.97%,1
臺北市,大安區,1401,277,174,451,34,485,814,59.58%,34.03%,1
臺北市,中山區,0786,508,333,841,27,868,1522,57.03%,33.38%,1
臺北市,中山區,0787,467,272,739,21,760,1332,57.06%,35.06%,1
臺北市,中山區,0788,483,321,804,33,837,1656,50.54%,29.17%,1
臺北市,中山區,0789,416,256,672,39,711,1367,52.01%,30.43%,1
臺北市,中山區,0790,515,346,861,29,890,1732,51.39%,29.73%,1
臺北市,中山區,0791,543,352,895,42,937,1634,57.34%,33.23%,1
臺北市,中山區,0792,533,336,869,30,899,1650,54.48%,32.3%,1
臺北市,中山區,0793,481,301,782,42,824,1392,59.2%,34.55%,1
臺北市,中山區,0794,417,292,709,19,728,1177,61.85%,35.43%,1
臺北市,中山區,0795,528,335,863,31,894,1477,60.53%,35.75%,1
臺北市,中山區,0796,325,218,543,38,581,1063,54.66%,30.57%,1
臺北市,中山區,0797,457,228,685,31,716,1296,55.25%,35.26%,1
臺北市,中山區,0798,410,276,686,22,708,1330,53.23%,30.83%,1
臺北市,中山區,0799,461,301,762,36,798,1483,53.81%,31.09%,1
臺北市,中山區,0800,492,310,802,28,830,1542,53.83%,31.91%,1
臺北市,中山區,0801,511,333,844,43,887,1710,51.87%,29.88%,1
臺北市,中山區,0802,422,238,660,16,676,1315,51.41%,32.09%,1
臺北市,中山區,0803,439,233,672,33,705,1245,56.63%,35.26%,1
臺北市,中山區,0804,418,237,655,32,687,1262,54.44%,33.12%,1
臺北市,中山區,0805,496,347,843,38,881,1518,58.04%,32.67%,1
臺北市,中山區,0806,531,305,836,45,881,1522,57.88%,34.89%,1
臺北市,中山區,0807,490,315,805,26,831,1580,52.59%,31.01%,1
臺北市,中山區,0808,491,339,830,31,861,1529,56.31%,32.11%,1
臺北市,中山區,0809,507,260,767,27,794,1221,65.03%,41.52%,1
臺北市,中山區,0810,410,285,695,33,728,1221,59.62%,33.58%,1
臺北市,中山區,0811,341,209,550,30,580,1139,50.92%,29.94%,1
臺北市,中山區,0812,472,284,756,52,808,1407,57.43%,33.55%,1
臺北市,中山區,0813,419,307,726,35,761,1321,57.61%,31.72%,1
臺北市,中山區,0814,501,267,768,26,794,1578,50.32%,31.75%,1
臺北市,中山區,0815,524,336,860,40,900,1739,51.75%,30.13%,1
臺北市,中山區,0816,503,321,824,32,856,1637,52.29%,30.73%,1
臺北市,中山區,0817,473,323,796,43,839,1541,54.45%,30.69%,1
臺北市,中山區,0818,421,261,682,31,713,1210,58.93%,34.79%,1
臺北市,中山區,0819,441,274,715,30,745,1331,55.97%,33.13%,1
臺北市,中山區,0820,350,265,615,39,654,1224,53.43%,28.59%,1
臺北市,中山區,0821,567,312,879,35,914,1585,57.67%,35.77%,1
臺北市,中山區,0822,564,343,907,41,948,1523,62.25%,37.03%,1
臺北市,中山區,0823,529,284,813,32,845,1368,61.77%,38.67%,1
臺北市,中山區,0824,711,253,964,36,1000,1805,55.4%,39.39%,1
臺北市,中山區,0825,587,229,816,17,833,1404,59.33%,41.81%,1
臺北市,中山區,0826,593,421,1014,45,1059,1708,62%,34.72%,1
臺北市,中山區,0827,554,343,897,26,923,1451,63.61%,38.18%,1
臺北市,中山區,0828,603,403,1006,38,1044,1684,62%,35.81%,1
臺北市,中山區,0829,593,294,887,21,908,1585,57.29%,37.41%,1
臺北市,中山區,0830,500,289,789,47,836,1391,60.1%,35.95%,1
臺北市,中山區,0831,553,313,866,49,915,1375,66.55%,40.22%,1
臺北市,中山區,0832,554,341,895,11,906,1472,61.55%,37.64%,1
臺北市,中山區,0833,432,283,715,23,738,1327,55.61%,32.55%,1
臺北市,中山區,0834,511,297,808,18,826,1401,58.96%,36.47%,1
臺北市,中山區,0835,527,294,821,28,849,1423,59.66%,37.03%,1
臺北市,中山區,0836,561,355,916,24,940,1569,59.91%,35.76%,1
臺北市,中山區,0837,556,346,902,19,921,1651,55.78%,33.68%,1
臺北市,中山區,0838,527,372,899,17,916,1624,56.4%,32.45%,1
臺北市,中山區,0839,596,413,1009,34,1043,1713,60.89%,34.79%,1
臺北市,中山區,0840,610,358,968,27,995,1647,60.41%,37.04%,1
臺北市,中山區,0841,556,359,915,36,951,1762,53.97%,31.56%,1
臺北市,中山區,0842,554,299,853,21,874,1399,62.47%,39.6%,1
臺北市,中山區,0843,591,317,908,23,931,1489,62.53%,39.69%,1
臺北市,中山區,0844,484,270,754,22,776,1269,61.15%,38.14%,1
臺北市,中山區,0845,411,194,605,28,633,998,63.43%,41.18%,1
臺北市,中山區,0846,477,324,801,28,829,1472,56.32%,32.4%,1
臺北市,中山區,0847,467,328,795,40,835,1517,55.04%,30.78%,1
臺北市,中山區,0848,624,371,995,37,1032,1704,60.56%,36.62%,1
臺北市,中山區,0849,548,367,915,33,948,1603,59.14%,34.19%,1
臺北市,中山區,0850,474,264,738,57,795,1432,55.52%,33.1%,1
臺北市,中山區,0851,502,350,852,50,902,1500,60.13%,33.47%,1
臺北市,中山區,0852,505,286,791,29,820,1332,61.56%,37.91%,1
臺北市,中山區,0853,523,330,853,35,888,1450,61.24%,36.07%,1
臺北市,中山區,0854,522,329,851,31,882,1434,61.51%,36.4%,1
臺北市,中山區,0855,503,259,762,42,804,1419,56.66%,35.45%,1
臺北市,中山區,0856,439,266,705,32,737,1292,57.04%,33.98%,1
臺北市,中山區,0857,471,351,822,27,849,1526,55.64%,30.87%,1
臺北市,中山區,0858,437,300,737,30,767,1582,48.48%,27.62%,1
臺北市,中山區,0859,473,319,792,46,838,1588,52.77%,29.79%,1
臺北市,中山區,0860,504,298,802,45,847,1463,57.89%,34.45%,1
臺北市,中山區,0861,467,311,778,33,811,1533,52.9%,30.46%,1
臺北市,中山區,0862,333,187,520,30,550,944,58.26%,35.28%,1
臺北市,中山區,0863,683,372,1055,35,1090,1745,62.46%,39.14%,1
臺北市,中山區,0864,473,341,814,29,843,1679,50.21%,28.17%,1
臺北市,中山區,0865,454,333,787,38,825,3419,24.13%,13.28%,1
臺北市,中山區,0866,489,311,800,36,836,1387,60.27%,35.26%,1
臺北市,中山區,0867,596,356,952,40,992,1672,59.33%,35.65%,1
臺北市,中山區,0868,484,262,746,30,776,1319,58.83%,36.69%,1
臺北市,中山區,0869,460,274,734,31,765,1364,56.09%,33.72%,1
臺北市,中山區,0870,470,317,787,36,823,1461,56.33%,32.17%,1
臺北市,中山區,0871,421,255,676,29,705,1173,60.1%,35.89%,1
臺北市,中山區,0872,386,233,619,41,660,1171,56.36%,32.96%,1
臺北市,中山區,0873,435,303,738,20,758,1310,57.86%,33.21%,1
臺北市,中山區,0874,507,305,812,26,838,1373,61.03%,36.93%,1
臺北市,中山區,0875,489,284,773,29,802,1290,62.17%,37.91%,1
臺北市,中山區,0876,498,302,800,35,835,1346,62.04%,37%,1
臺北市,中山區,0877,484,371,855,31,886,1468,60.35%,32.97%,1
臺北市,中山區,0878,452,243,695,18,713,1178,60.53%,38.37%,1
臺北市,中山區,0879,570,377,947,40,987,1654,59.67%,34.46%,1
臺北市,中山區,0880,497,324,821,40,861,1464,58.81%,33.95%,1
臺北市,中山區,0881,504,288,792,27,819,1450,56.48%,34.76%,1
臺北市,中山區,0882,504,330,834,38,872,1534,56.84%,32.86%,1
臺北市,中山區,0883,580,364,944,31,975,1703,57.25%,34.06%,1
臺北市,中山區,0884,559,349,908,47,955,1610,59.32%,34.72%,1
臺北市,中山區,0885,524,57,581,50,631,1653,38.17%,31.7%,1
臺北市,中山區,0886,595,392,987,54,1041,1694,61.45%,35.12%,1
臺北市,中山區,0887,537,341,878,35,913,1623,56.25%,33.09%,1
臺北市,中山區,0888,538,366,904,43,947,1618,58.53%,33.25%,1
臺北市,中山區,0889,519,342,861,42,903,1583,57.04%,32.79%,1
臺北市,中山區,0890,519,401,920,52,972,1605,60.56%,32.34%,1
臺北市,中山區,0891,488,361,849,43,892,1398,63.81%,34.91%,1
臺北市,中山區,0892,587,359,946,40,986,1526,64.61%,38.47%,1
臺北市,中山區,0893,492,358,850,51,901,1555,57.94%,31.64%,1
臺北市,中山區,0894,535,332,867,23,890,1597,55.73%,33.5%,1
臺北市,中山區,0895,543,349,892,48,940,1587,59.23%,34.22%,1
臺北市,中山區,0896,559,390,949,28,977,1587,61.56%,35.22%,1
臺北市,中山區,0897,547,358,905,47,952,1546,61.58%,35.38%,1
臺北市,中山區,0898,481,237,718,39,757,1322,57.26%,36.38%,1
臺北市,中山區,0899,453,263,716,27,743,1267,58.64%,35.75%,1
臺北市,中山區,0900,410,263,673,24,697,1210,57.6%,33.88%,1
臺北市,中山區,0901,460,255,715,31,746,1295,57.61%,35.52%,1
臺北市,中山區,0902,515,336,851,36,887,1467,60.46%,35.11%,1
臺北市,中山區,0903,613,285,898,34,932,1491,62.51%,41.11%,1
臺北市,中山區,0904,637,308,945,41,986,1516,65.04%,42.02%,1
臺北市,中山區,0905,428,302,730,22,752,1384,54.34%,30.92%,1
臺北市,中山區,0906,398,292,690,33,723,1138,63.53%,34.97%,1
臺北市,中山區,0907,455,326,781,33,814,1513,53.8%,30.07%,1
臺北市,中山區,0908,532,355,887,42,929,1559,59.59%,34.12%,1
臺北市,中山區,0909,522,318,840,49,889,1429,62.21%,36.53%,1
臺北市,中山區,0910,464,283,747,21,768,1245,61.69%,37.27%,1
臺北市,中山區,0911,454,277,731,36,767,1214,63.18%,37.4%,1
臺北市,中山區,0912,477,332,809,23,832,1394,59.68%,34.22%,1
臺北市,中山區,0913,430,276,706,13,719,1336,53.82%,32.19%,1
臺北市,中山區,0914,426,252,678,23,701,1227,57.13%,34.72%,1
臺北市,中山區,0915,511,279,790,28,818,1382,59.19%,36.98%,1
臺北市,中山區,0916,508,282,790,39,829,1436,57.73%,35.38%,1
臺北市,中山區,0917,419,286,705,33,738,1405,52.53%,29.82%,1
臺北市,中山區,0918,447,272,719,24,743,1259,59.02%,35.5%,1
臺北市,中正區,1001,478,288,766,24,790,1308,60.4%,36.54%,1
臺北市,中正區,1002,433,278,711,29,740,1317,56.19%,32.88%,1
臺北市,中正區,1003,419,219,638,25,663,1069,62.02%,39.2%,1
臺北市,中正區,1004,393,207,600,36,636,1128,56.38%,34.84%,1
臺北市,中正區,1005,385,230,615,32,647,1053,61.44%,36.56%,1
臺北市,中正區,1006,400,222,622,11,633,1048,60.4%,38.17%,1
臺北市,中正區,1007,479,222,701,38,739,1297,56.98%,36.93%,1
臺北市,中正區,1008,461,248,709,15,724,1193,60.69%,38.64%,1
臺北市,中正區,1009,583,359,942,28,970,1500,64.67%,38.87%,1
臺北市,中正區,1010,462,277,739,20,759,1346,56.39%,34.32%,1
臺北市,中正區,1011,437,269,706,22,728,1283,56.74%,34.06%,1
臺北市,中正區,1012,456,340,796,34,830,1450,57.24%,31.45%,1
臺北市,中正區,1013,492,324,816,31,847,1433,59.11%,34.33%,1
臺北市,中正區,1014,494,336,830,31,861,1309,65.78%,37.74%,1
臺北市,中正區,1015,523,292,815,19,834,1386,60.17%,37.73%,1
臺北市,中正區,1016,443,262,705,34,739,1201,61.53%,36.89%,1
臺北市,中正區,1017,498,292,790,35,825,1336,61.75%,37.28%,1
臺北市,中正區,1018,495,307,802,35,837,1358,61.63%,36.45%,1
臺北市,中正區,1019,424,263,687,32,719,1177,61.09%,36.02%,1
臺北市,中正區,1020,506,266,772,18,790,1236,63.92%,40.94%,1
臺北市,中正區,1021,531,292,823,40,863,1478,58.39%,35.93%,1
臺北市,中正區,1022,526,324,850,27,877,1474,59.5%,35.69%,1
臺北市,中正區,1023,404,258,662,30,692,1172,59.04%,34.47%,1
臺北市,中正區,1024,455,279,734,40,774,1310,59.08%,34.73%,1
臺北市,中正區,1025,470,251,721,36,757,1263,59.94%,37.21%,1
臺北市,中正區,1026,436,246,682,23,705,1169,60.31%,37.3%,1
臺北市,中正區,1027,469,273,742,29,771,1391,55.43%,33.72%,1
臺北市,中正區,1028,448,246,694,16,710,1201,59.12%,37.3%,1
臺北市,中正區,1029,466,279,745,37,782,1324,59.06%,35.2%,1
臺北市,中正區,1030,488,162,650,44,694,1216,57.07%,40.13%,1
臺北市,中正區,1031,389,264,653,37,690,1183,58.33%,32.88%,1
臺北市,中正區,1032,532,313,845,53,898,1469,61.13%,36.22%,1
臺北市,中正區,1033,480,323,803,28,831,1411,58.89%,34.02%,1
臺北市,中正區,1034,487,303,790,59,849,1398,60.73%,34.84%,1
臺北市,中正區,1035,508,288,796,47,843,1479,57%,34.35%,1
臺北市,中正區,1036,580,304,884,36,920,1620,56.79%,35.8%,1
臺北市,中正區,1037,388,221,609,16,625,1041,60.04%,37.27%,1
臺北市,中正區,1038,367,238,605,17,622,1056,58.9%,34.75%,1
臺北市,中正區,1039,422,242,664,25,689,1063,64.82%,39.7%,1
臺北市,中正區,1040,451,266,717,33,750,1591,47.14%,28.35%,1
臺北市,中正區,1041,438,218,656,55,711,1502,47.34%,29.16%,1
臺北市,中正區,1042,432,245,677,38,715,1331,53.72%,32.46%,1
臺北市,中正區,1043,523,258,781,42,823,1441,57.11%,36.29%,1
臺北市,中正區,1044,488,288,776,29,805,1273,63.24%,38.33%,1
臺北市,中正區,1045,415,252,667,26,693,1133,61.17%,36.63%,1
臺北市,中正區,1046,449,235,684,22,706,1156,61.07%,38.84%,1
臺北市,中正區,1047,473,300,773,32,805,1377,58.46%,34.35%,1
臺北市,中正區,1048,482,263,745,37,782,1266,61.77%,38.07%,1
臺北市,中正區,1049,457,224,681,29,710,1111,63.91%,41.13%,1
臺北市,中正區,1050,392,268,660,24,684,1124,60.85%,34.88%,1
臺北市,中正區,1051,422,301,723,31,754,1373,54.92%,30.74%,1
臺北市,中正區,1052,540,267,807,26,833,1351,61.66%,39.97%,1
臺北市,中正區,1053,557,330,887,20,907,1495,60.67%,37.26%,1
臺北市,中正區,1054,563,334,897,25,922,1436,64.21%,39.21%,1
臺北市,中正區,1055,555,311,866,14,880,1516,58.05%,36.61%,1
臺北市,中正區,1056,492,294,786,22,808,1374,58.81%,35.81%,1
臺北市,中正區,1057,533,300,833,17,850,1522,55.85%,35.02%,1
臺北市,中正區,1058,496,281,777,23,800,1336,59.88%,37.13%,1
臺北市,中正區,1059,551,342,893,24,917,1551,59.12%,35.53%,1
臺北市,中正區,1060,561,353,914,47,961,1594,60.29%,35.19%,1
臺北市,中正區,1061,529,320,849,28,877,1503,58.35%,35.2%,1
臺北市,中正區,1062,557,289,846,20,866,1455,59.52%,38.28%,1
臺北市,中正區,1063,546,308,854,16,870,1439,60.46%,37.94%,1
臺北市,中正區,1064,520,315,835,36,871,1469,59.29%,35.4%,1
臺北市,中正區,1065,594,253,847,32,879,1430,61.47%,41.54%,1
臺北市,中正區,1066,542,324,866,28,894,1444,61.91%,37.53%,1
臺北市,中正區,1067,458,262,720,14,734,1254,58.53%,36.52%,1
臺北市,中正區,1068,333,208,541,32,573,932,61.48%,35.73%,1
臺北市,中正區,1069,364,245,609,36,645,1055,61.14%,34.5%,1
臺北市,中正區,1070,460,244,704,20,724,1226,59.05%,37.52%,1
臺北市,中正區,1071,476,231,707,37,744,1390,53.53%,34.24%,1
臺北市,中正區,1072,463,295,758,27,785,1336,58.76%,34.66%,1
臺北市,中正區,1073,452,279,731,35,766,1419,53.98%,31.85%,1
臺北市,中正區,1074,508,299,807,42,849,1361,62.38%,37.33%,1
臺北市,中正區,1075,566,314,880,37,917,2520,36.39%,22.46%,1
臺北市,中正區,1076,476,233,709,14,723,1224,59.07%,38.89%,1
臺北市,中正區,1077,422,250,672,3,675,1272,53.07%,33.18%,1
臺北市,中正區,1078,453,334,787,32,819,1400,58.5%,32.36%,1
臺北市,中正區,1079,446,280,726,22,748,1319,56.71%,33.81%,1
臺北市,中正區,1080,472,263,735,33,768,1232,62.34%,38.31%,1
臺北市,中正區,1081,482,290,772,34,806,1265,63.72%,38.1%,1
臺北市,中正區,1082,397,251,648,26,674,1055,63.89%,37.63%,1
臺北市,中正區,1083,340,203,543,25,568,954,59.54%,35.64%,1
臺北市,中正區,1084,385,213,598,23,621,1018,61%,37.82%,1
臺北市,中正區,1085,494,297,791,25,816,1431,57.02%,34.52%,1
臺北市,中正區,1086,369,270,639,40,679,1271,53.42%,29.03%,1
臺北市,中正區,1087,362,226,588,27,615,983,62.56%,36.83%,1
臺北市,中正區,1088,547,337,884,33,917,1594,57.53%,34.32%,1
臺北市,中正區,1089,644,333,977,33,1010,1565,64.54%,41.15%,1
臺北市,中正區,1090,554,329,883,31,914,1650,55.39%,33.58%,1
臺北市,中正區,1091,530,330,860,28,888,1600,55.5%,33.13%,1
臺北市,中正區,1092,468,311,779,18,797,1391,57.3%,33.64%,1
臺北市,中正區,1093,607,363,970,34,1004,1769,56.76%,34.31%,1
臺北市,中正區,1094,517,347,864,18,882,1487,59.31%,34.77%,1
臺北市,中正區,1095,481,277,758,25,783,1291,60.65%,37.26%,1
臺北市,中正區,1096,467,287,754,28,782,1289,60.67%,36.23%,1
臺北市,大同區,0919,422,289,711,44,755,1261,59.87%,33.47%,1
臺北市,大同區,0920,470,325,795,42,837,1352,61.91%,34.76%,1
臺北市,大同區,0921,514,302,816,37,853,1462,58.34%,35.16%,1
臺北市,大同區,0922,526,305,831,48,879,1510,58.21%,34.83%,1
臺北市,大同區,0923,466,316,782,25,807,1496,53.94%,31.15%,1
臺北市,大同區,0924,434,277,711,43,754,1329,56.73%,32.66%,1
臺北市,大同區,0925,452,263,715,53,768,1307,58.76%,34.58%,1
臺北市,大同區,0926,374,229,603,31,634,1065,59.53%,35.12%,1
臺北市,大同區,0927,347,269,616,26,642,1085,59.17%,31.98%,1
臺北市,大同區,0928,373,285,658,40,698,1047,66.67%,35.63%,1
臺北市,大同區,0929,342,285,627,32,659,1215,54.24%,28.15%,1
臺北市,大同區,0930,401,273,674,28,702,1117,62.85%,35.9%,1
臺北市,大同區,0931,418,282,700,31,731,1186,61.64%,35.24%,1
臺北市,大同區,0932,431,263,694,35,729,1185,61.52%,36.37%,1
臺北市,大同區,0933,462,287,749,37,786,1359,57.84%,34%,1
臺北市,大同區,0934,440,288,728,16,744,1273,58.44%,34.56%,1
臺北市,大同區,0935,331,339,670,31,701,1291,54.3%,25.64%,1
臺北市,大同區,0936,422,269,691,23,714,1288,55.43%,32.76%,1
臺北市,大同區,0937,482,277,759,25,784,1245,62.97%,38.71%,1
臺北市,大同區,0938,440,318,758,36,794,1261,62.97%,34.89%,1
臺北市,大同區,0939,453,288,741,17,758,1348,56.23%,33.61%,1
臺北市,大同區,0940,566,360,926,61,987,1676,58.89%,33.77%,1
臺北市,大同區,0941,489,286,775,34,809,1311,61.71%,37.3%,1
臺北市,大同區,0942,450,302,752,44,796,1316,60.49%,34.19%,1
臺北市,大同區,0943,456,326,782,51,833,1409,59.12%,32.36%,1
臺北市,大同區,0944,485,329,814,55,869,1436,60.52%,33.77%,1
臺北市,大同區,0945,488,311,799,38,837,1408,59.45%,34.66%,1
臺北市,大同區,0946,428,273,701,33,734,1276,57.52%,33.54%,1
臺北市,大同區,0947,384,238,622,16,638,1110,57.48%,34.59%,1
臺北市,大同區,0948,436,317,753,24,777,1324,58.69%,32.93%,1
臺北市,大同區,0949,356,220,576,23,599,1016,58.96%,35.04%,1
臺北市,大同區,0950,399,220,619,26,645,1028,62.74%,38.81%,1
臺北市,大同區,0951,465,211,676,31,707,1158,61.05%,40.16%,1
臺北市,大同區,0952,435,240,675,30,705,1138,61.95%,38.22%,1
臺北市,大同區,0953,442,260,702,32,734,1214,60.46%,36.41%,1
臺北市,大同區,0954,388,300,688,22,710,1090,65.14%,35.6%,1
臺北市,大同區,0955,501,299,800,34,834,1305,63.91%,38.39%,1
臺北市,大同區,0956,405,230,635,25,660,1167,56.56%,34.7%,1
臺北市,大同區,0957,392,254,646,26,672,1148,58.54%,34.15%,1
臺北市,大同區,0958,439,282,721,27,748,1203,62.18%,36.49%,1
臺北市,大同區,0959,482,312,794,28,822,1441,57.04%,33.45%,1
臺北市,大同區,0960,489,276,765,43,808,1315,61.44%,37.19%,1
臺北市,大同區,0961,429,337,766,40,806,1393,57.86%,30.8%,1
臺北市,大同區,0962,439,300,739,31,770,1278,60.25%,34.35%,1
臺北市,大同區,0963,401,254,655,26,681,1246,54.65%,32.18%,1
臺北市,大同區,0964,396,235,631,41,672,1142,58.84%,34.68%,1
臺北市,大同區,0965,488,305,793,34,827,1336,61.9%,36.53%,1
臺北市,大同區,0966,482,303,785,51,836,1363,61.34%,35.36%,1
臺北市,大同區,0967,545,306,851,23,874,1476,59.21%,36.92%,1
臺北市,大同區,0968,459,343,802,41,843,1418,59.45%,32.37%,1
臺北市,大同區,0969,507,284,791,28,819,1460,56.1%,34.73%,1
臺北市,大同區,0970,365,131,496,39,535,1222,43.78%,29.87%,1
臺北市,大同區,0971,357,228,585,57,642,1246,51.52%,28.65%,1
臺北市,大同區,0972,471,279,750,35,785,1256,62.5%,37.5%,1
臺北市,大同區,0973,452,291,743,18,761,1289,59.04%,35.07%,1
臺北市,大同區,0974,442,295,737,12,749,1340,55.9%,32.99%,1
臺北市,大同區,0975,468,332,800,34,834,1555,53.63%,30.1%,1
臺北市,大同區,0976,521,263,784,53,837,2459,34.04%,21.19%,1
臺北市,大同區,0977,316,187,503,41,544,1108,49.1%,28.52%,1
臺北市,大同區,0978,308,142,450,37,487,867,56.17%,35.52%,1
臺北市,大同區,0979,482,309,791,41,832,1329,62.6%,36.27%,1
臺北市,大同區,0980,387,268,655,24,679,1162,58.43%,33.3%,1
臺北市,大同區,0981,476,269,745,48,793,1434,55.3%,33.19%,1
臺北市,大同區,0982,444,300,744,49,793,1351,58.7%,32.86%,1
臺北市,大同區,0983,478,308,786,47,833,1531,54.41%,31.22%,1
臺北市,大同區,0984,439,295,734,32,766,1507,50.83%,29.13%,1
臺北市,大同區,0985,467,334,801,39,840,1488,56.45%,31.38%,1
臺北市,大同區,0986,506,309,815,40,855,1384,61.78%,36.56%,1
臺北市,大同區,0987,555,261,816,38,854,1460,58.49%,38.01%,1
臺北市,大同區,0988,529,262,791,30,821,1371,59.88%,38.58%,1
臺北市,大同區,0989,471,319,790,16,806,1439,56.01%,32.73%,1
臺北市,大同區,0990,452,337,789,46,835,1376,60.68%,32.85%,1
臺北市,大同區,0991,475,265,740,42,782,1366,57.25%,34.77%,1
臺北市,大同區,0992,459,286,745,41,786,1218,64.53%,37.68%,1
臺北市,大同區,0993,417,261,678,41,719,1235,58.22%,33.77%,1
臺北市,大同區,0994,599,140,739,16,755,1364,55.35%,43.91%,1
臺北市,大同區,0995,498,350,848,52,900,1408,63.92%,35.37%,1
臺北市,大同區,0996,495,328,823,37,860,1450,59.31%,34.14%,1
臺北市,大同區,0997,532,318,850,47,897,1429,62.77%,37.23%,1
臺北市,大同區,0998,435,248,683,37,720,1170,61.54%,37.18%,1
臺北市,大同區,0999,411,291,702,39,741,1245,59.52%,33.01%,1
臺北市,大同區,1000,458,290,748,44,792,1215,65.19%,37.7%,1
臺北市,萬華區,1097,445,291,736,45,781,1305,59.85%,34.1%,1
臺北市,萬華區,1098,354,191,545,57,602,1183,50.89%,29.92%,1
臺北市,萬華區,1099,405,239,644,25,669,1176,56.89%,34.44%,1
臺北市,萬華區,1100,347,242,589,24,613,1169,52.44%,29.68%,1
臺北市,萬華區,1101,490,256,746,30,776,1457,53.26%,33.63%,1
臺北市,萬華區,1102,421,282,703,48,751,1563,48.05%,26.94%,1
臺北市,萬華區,1103,510,332,842,28,870,1771,49.12%,28.8%,1
臺北市,萬華區,1104,480,328,808,36,844,1615,52.26%,29.72%,1
臺北市,萬華區,1105,492,281,773,57,830,1478,56.16%,33.29%,1
臺北市,萬華區,1106,474,312,786,29,815,1462,55.75%,32.42%,1
臺北市,萬華區,1107,457,236,693,45,738,1507,48.97%,30.33%,1
臺北市,萬華區,1108,469,285,754,41,795,1347,59.02%,34.82%,1
臺北市,萬華區,1109,423,268,691,39,730,1367,53.4%,30.94%,1
臺北市,萬華區,1110,452,292,744,39,783,1277,61.32%,35.4%,1
臺北市,萬華區,1111,477,327,804,42,846,1395,60.65%,34.19%,1
臺北市,萬華區,1112,437,311,748,46,794,1450,54.76%,30.14%,1
臺北市,萬華區,1113,400,257,657,41,698,1340,52.09%,29.85%,1
臺北市,萬華區,1114,378,248,626,39,665,1242,53.54%,30.43%,1
臺北市,萬華區,1115,412,241,653,66,719,1286,55.91%,32.04%,1
臺北市,萬華區,1116,455,229,684,41,725,1324,54.76%,34.37%,1
臺北市,萬華區,1117,496,311,807,52,859,1619,53.06%,30.64%,1
臺北市,萬華區,1118,418,228,646,35,681,1352,50.37%,30.92%,1
臺北市,萬華區,1119,485,261,746,37,783,1440,54.38%,33.68%,1
臺北市,萬華區,1120,398,282,680,44,724,1194,60.64%,33.33%,1
臺北市,萬華區,1121,430,218,648,46,694,1083,64.08%,39.7%,1
臺北市,萬華區,1122,401,231,632,50,682,1237,55.13%,32.42%,1
臺北市,萬華區,1123,499,359,858,31,889,1625,54.71%,30.71%,1
臺北市,萬華區,1124,463,298,761,42,803,1324,60.65%,34.97%,1
臺北市,萬華區,1125,459,309,768,35,803,1352,59.39%,33.95%,1
臺北市,萬華區,1126,451,268,719,38,757,2630,28.78%,17.15%,1
臺北市,萬華區,1127,532,341,873,39,912,1504,60.64%,35.37%,1
臺北市,萬華區,1128,455,307,762,29,791,1425,55.51%,31.93%,1
臺北市,萬華區,1129,477,316,793,42,835,1591,52.48%,29.98%,1
臺北市,萬華區,1130,490,283,773,42,815,1474,55.29%,33.24%,1
臺北市,萬華區,1131,480,312,792,60,852,1612,52.85%,29.78%,1
臺北市,萬華區,1132,453,307,760,52,812,1447,56.12%,31.31%,1
臺北市,萬華區,1133,527,298,825,41,866,1491,58.08%,35.35%,1
臺北市,萬華區,1134,542,323,865,33,898,1500,59.87%,36.13%,1
臺北市,萬華區,1135,557,337,894,41,935,1582,59.1%,35.21%,1
臺北市,萬華區,1136,510,304,814,45,859,1623,52.93%,31.42%,1
臺北市,萬華區,1137,404,252,656,25,681,1228,55.46%,32.9%,1
臺北市,萬華區,1138,439,242,681,41,722,1268,56.94%,34.62%,1
臺北市,萬華區,1139,435,252,687,47,734,1207,60.81%,36.04%,1
臺北市,萬華區,1140,401,281,682,35,717,1188,60.35%,33.75%,1
臺北市,萬華區,1141,475,282,757,35,792,1474,53.73%,32.23%,1
臺北市,萬華區,1142,416,201,617,21,638,1304,48.93%,31.9%,1
臺北市,萬華區,1143,284,147,431,48,479,1082,44.27%,26.25%,1
臺北市,萬華區,1144,340,207,547,32,579,1052,55.04%,32.32%,1
臺北市,萬華區,1145,360,253,613,31,644,1135,56.74%,31.72%,1
臺北市,萬華區,1146,390,246,636,47,683,1225,55.76%,31.84%,1
臺北市,萬華區,1147,486,314,800,29,829,1583,52.37%,30.7%,1
臺北市,萬華區,1148,429,311,740,41,781,1403,55.67%,30.58%,1
臺北市,萬華區,1149,473,295,768,48,816,1406,58.04%,33.64%,1
臺北市,萬華區,1150,494,281,775,41,816,1401,58.24%,35.26%,1
臺北市,萬華區,1151,396,282,678,43,721,1188,60.69%,33.33%,1
臺北市,萬華區,1152,486,307,793,75,868,1597,54.35%,30.43%,1
臺北市,萬華區,1153,490,267,757,44,801,1290,62.09%,37.98%,1
臺北市,萬華區,1154,508,346,854,25,879,1746,50.34%,29.1%,1
臺北市,萬華區,1155,458,283,741,24,765,1595,47.96%,28.71%,1
臺北市,萬華區,1156,534,341,875,63,938,1701,55.14%,31.39%,1
臺北市,萬華區,1157,354,251,605,59,664,1339,49.59%,26.44%,1
臺北市,萬華區,1158,452,228,680,56,736,1484,49.6%,30.46%,1
臺北市,萬華區,1159,557,307,864,48,912,1604,56.86%,34.73%,1
臺北市,萬華區,1160,416,262,678,32,710,1197,59.31%,34.75%,1
臺北市,萬華區,1161,395,290,685,58,743,1347,55.16%,29.32%,1
臺北市,萬華區,1162,455,299,754,30,784,1223,64.1%,37.2%,1
臺北市,萬華區,1163,375,232,607,25,632,1036,61%,36.2%,1
臺北市,萬華區,1164,400,247,647,21,668,1035,64.54%,38.65%,1
臺北市,萬華區,1165,447,247,694,28,722,1141,63.28%,39.18%,1
臺北市,萬華區,1166,457,268,725,31,756,1271,59.48%,35.96%,1
臺北市,萬華區,1167,451,300,751,62,813,1328,61.22%,33.96%,1
臺北市,萬華區,1168,477,259,736,29,765,1286,59.49%,37.09%,1
臺北市,萬華區,1169,576,361,937,49,986,1679,58.73%,34.31%,1
臺北市,萬華區,1170,549,332,881,37,918,1619,56.7%,33.91%,1
臺北市,萬華區,1171,515,282,797,28,825,1625,50.77%,31.69%,1
臺北市,萬華區,1172,596,322,918,42,960,1623,59.15%,36.72%,1
臺北市,萬華區,1173,434,247,681,40,721,1280,56.33%,33.91%,1
臺北市,萬華區,1174,533,326,859,39,898,1608,55.85%,33.15%,1
臺北市,萬華區,1175,507,298,805,46,851,1453,58.57%,34.89%,1
臺北市,萬華區,1176,561,319,880,33,913,1472,62.02%,38.11%,1
臺北市,萬華區,1177,459,305,764,33,797,1373,58.05%,33.43%,1
臺北市,萬華區,1178,463,278,741,38,779,1394,55.88%,33.21%,1
臺北市,萬華區,1179,486,264,750,23,773,1427,54.17%,34.06%,1
臺北市,萬華區,1180,466,320,786,35,821,1342,61.18%,34.72%,1
臺北市,萬華區,1181,560,302,862,56,918,1569,58.51%,35.69%,1
臺北市,萬華區,1182,487,241,728,41,769,1514,50.79%,32.17%,1
臺北市,萬華區,1183,524,308,832,34,866,1720,50.35%,30.47%,1
臺北市,萬華區,1184,537,329,866,50,916,1461,62.7%,36.76%,1
臺北市,萬華區,1185,448,241,689,27,716,1264,56.65%,35.44%,1
臺北市,萬華區,1186,475,303,778,47,825,1334,61.84%,35.61%,1
臺北市,萬華區,1187,517,304,821,33,854,1446,59.06%,35.75%,1
臺北市,萬華區,1188,419,221,640,46,686,1307,52.49%,32.06%,1
臺北市,萬華區,1189,507,278,785,50,835,1420,58.8%,35.7%,1
臺北市,萬華區,1190,436,294,730,33,763,1427,53.47%,30.55%,1
臺北市,萬華區,1191,344,174,518,29,547,956,57.22%,35.98%,1
臺北市,萬華區,1192,487,268,755,37,792,1352,58.58%,36.02%,1
臺北市,萬華區,1193,512,217,729,47,776,1370,56.64%,37.37%,1
臺北市,萬華區,1194,491,214,705,29,734,1222,60.07%,40.18%,1
臺北市,萬華區,1195,607,203,810,31,841,1375,61.16%,44.15%,1
臺北市,萬華區,1196,546,269,815,46,861,1463,58.85%,37.32%,1
臺北市,萬華區,1197,522,277,799,31,830,1527,54.35%,34.18%,1
臺北市,萬華區,1198,542,226,768,38,806,1485,54.28%,36.5%,1
臺北市,萬華區,1199,691,259,950,33,983,1591,61.79%,43.43%,1
臺北市,萬華區,1200,598,280,878,30,908,1394,65.14%,42.9%,1
臺北市,萬華區,1201,557,98,655,28,683,1522,44.88%,36.6%,1
臺北市,萬華區,1202,669,314,983,26,1009,1661,60.75%,40.28%,1
臺北市,萬華區,1203,654,289,943,25,968,1561,62.01%,41.9%,1
臺北市,萬華區,1204,601,273,874,32,906,1406,64.44%,42.75%,1
臺北市,萬華區,1205,446,244,690,33,723,1498,48.26%,29.77%,1
臺北市,萬華區,1206,436,227,663,45,708,1478,47.9%,29.5%,1
臺北市,萬華區,1207,388,227,615,49,664,1170,56.75%,33.16%,1
臺北市,萬華區,1208,545,239,784,32,816,1376,59.3%,39.61%,1
臺北市,萬華區,1209,398,224,622,16,638,1093,58.37%,36.41%,1
臺北市,萬華區,1210,452,205,657,30,687,1084,63.38%,41.7%,1
臺北市,萬華區,1211,429,210,639,40,679,1119,60.68%,38.34%,1
臺北市,萬華區,1212,573,265,838,23,861,1381,62.35%,41.49%,1
臺北市,萬華區,1213,531,290,821,25,846,1396,60.6%,38.04%,1
臺北市,文山區,1402,525,315,840,28,868,1539,56.4%,34.11%,1
臺北市,文山區,1403,550,277,827,23,850,1548,54.91%,35.53%,1
臺北市,文山區,1404,555,300,855,48,903,1493,60.48%,37.17%,1
臺北市,文山區,1405,601,362,963,37,1000,1648,60.68%,36.47%,1
臺北市,文山區,1406,546,324,870,23,893,1544,57.84%,35.36%,1
臺北市,文山區,1407,577,297,874,35,909,1557,58.38%,37.06%,1
臺北市,文山區,1408,514,304,818,35,853,1514,56.34%,33.95%,1
臺北市,文山區,1409,615,341,956,29,985,1540,63.96%,39.94%,1
臺北市,文山區,1410,570,309,879,25,904,1466,61.66%,38.88%,1
臺北市,文山區,1411,582,279,861,34,895,1444,61.98%,40.3%,1
臺北市,文山區,1412,553,293,846,40,886,1455,60.89%,38.01%,1
臺北市,文山區,1413,524,269,793,20,813,1440,56.46%,36.39%,1
臺北市,文山區,1414,620,297,917,32,949,1398,67.88%,44.35%,1
臺北市,文山區,1415,494,295,789,20,809,1412,57.29%,34.99%,1
臺北市,文山區,1416,527,280,807,28,835,1426,58.56%,36.96%,1
臺北市,文山區,1417,520,308,828,29,857,1437,59.64%,36.19%,1
臺北市,文山區,1418,507,270,777,28,805,1340,60.07%,37.84%,1
臺北市,文山區,1419,555,334,889,24,913,1568,58.23%,35.4%,1
臺北市,文山區,1420,537,260,797,20,817,1372,59.55%,39.14%,1
臺北市,文山區,1421,373,224,597,19,616,1046,58.89%,35.66%,1
臺北市,文山區,1422,429,281,710,42,752,1274,59.03%,33.67%,1
臺北市,文山區,1423,512,249,761,26,787,1324,59.44%,38.67%,1
臺北市,文山區,1424,609,344,953,33,986,1722,57.26%,35.37%,1
臺北市,文山區,1425,665,332,997,42,1039,1737,59.82%,38.28%,1
臺北市,文山區,1426,527,324,851,15,866,1370,63.21%,38.47%,1
臺北市,文山區,1427,537,305,842,39,881,1495,58.93%,35.92%,1
臺北市,文山區,1428,482,295,777,34,811,1328,61.07%,36.3%,1
臺北市,文山區,1429,443,237,680,29,709,1138,62.3%,38.93%,1
臺北市,文山區,1430,572,307,879,22,901,1471,61.25%,38.89%,1
臺北市,文山區,1431,453,242,695,20,715,1144,62.5%,39.6%,1
臺北市,文山區,1432,467,260,727,33,760,1176,64.63%,39.71%,1
臺北市,文山區,1433,489,255,744,28,772,1212,63.7%,40.35%,1
臺北市,文山區,1434,509,268,777,18,795,1214,65.49%,41.93%,1
臺北市,文山區,1435,392,253,645,29,674,1170,57.61%,33.5%,1
臺北市,文山區,1436,489,288,777,33,810,1308,61.93%,37.39%,1
臺北市,文山區,1437,553,158,711,22,733,1190,61.6%,46.47%,1
臺北市,文山區,1438,414,231,645,26,671,1110,60.45%,37.3%,1
臺北市,文山區,1439,564,298,862,36,898,1512,59.39%,37.3%,1
臺北市,文山區,1440,564,256,820,38,858,1387,61.86%,40.66%,1
臺北市,文山區,1441,499,281,780,37,817,1355,60.3%,36.83%,1
臺北市,文山區,1442,464,320,784,42,826,1370,60.29%,33.87%,1
臺北市,文山區,1443,544,308,852,39,891,1484,60.04%,36.66%,1
臺北市,文山區,1444,635,363,998,49,1047,1786,58.62%,35.55%,1
臺北市,文山區,1445,480,246,726,44,770,1260,61.11%,38.1%,1
臺北市,文山區,1446,466,296,762,21,783,1194,65.58%,39.03%,1
臺北市,文山區,1447,520,308,828,33,861,1444,59.63%,36.01%,1
臺北市,文山區,1448,579,292,871,32,903,1495,60.4%,38.73%,1
臺北市,文山區,1449,584,281,865,26,891,1446,61.62%,40.39%,1
臺北市,文山區,1450,532,271,803,47,850,1450,58.62%,36.69%,1
臺北市,文山區,1451,558,322,880,36,916,1486,61.64%,37.55%,1
臺北市,文山區,1452,484,265,749,24,773,1259,61.4%,38.44%,1
臺北市,文山區,1453,534,266,800,18,818,1317,62.11%,40.55%,1
臺北市,文山區,1454,478,323,801,24,825,1321,62.45%,36.18%,1
臺北市,文山區,1455,513,325,838,28,866,1475,58.71%,34.78%,1
臺北市,文山區,1456,446,257,703,32,735,1271,57.83%,35.09%,1
臺北市,文山區,1457,629,312,941,32,973,1609,60.47%,39.09%,1
臺北市,文山區,1458,536,279,815,29,844,1501,56.23%,35.71%,1
臺北市,文山區,1459,337,194,531,21,552,997,55.37%,33.8%,1
臺北市,文山區,1460,394,259,653,30,683,1052,64.92%,37.45%,1
臺北市,文山區,1461,481,253,734,31,765,1247,61.35%,38.57%,1
臺北市,文山區,1462,448,250,698,39,737,1167,63.15%,38.39%,1
臺北市,文山區,1463,499,274,773,18,791,1280,61.8%,38.98%,1
臺北市,文山區,1464,461,237,698,23,721,1153,62.53%,39.98%,1
臺北市,文山區,1465,587,337,924,33,957,1557,61.46%,37.7%,1
臺北市,文山區,1466,566,253,819,42,861,1444,59.63%,39.2%,1
臺北市,文山區,1467,575,325,900,33,933,1459,63.95%,39.41%,1
臺北市,文山區,1468,571,268,839,24,863,1357,63.6%,42.08%,1
臺北市,文山區,1469,520,256,776,23,799,1194,66.92%,43.55%,1
臺北市,文山區,1470,462,264,726,38,764,1184,64.53%,39.02%,1
臺北市,文山區,1471,442,248,690,22,712,1119,63.63%,39.5%,1
臺北市,文山區,1472,516,307,823,34,857,1350,63.48%,38.22%,1
臺北市,文山區,1473,566,257,823,24,847,1502,56.39%,37.68%,1
臺北市,文山區,1474,630,276,906,38,944,1511,62.48%,41.69%,1
臺北市,文山區,1475,583,334,917,25,942,1481,63.61%,39.37%,1
臺北市,文山區,1476,605,299,904,27,931,1477,63.03%,40.96%,1
臺北市,文山區,1477,504,275,779,21,800,1294,61.82%,38.95%,1
臺北市,文山區,1478,447,235,682,26,708,1040,68.08%,42.98%,1
臺北市,文山區,1479,533,274,807,28,835,1323,63.11%,40.29%,1
臺北市,文山區,1480,439,252,691,22,713,1153,61.84%,38.07%,1
臺北市,文山區,1481,559,289,848,31,879,1525,57.64%,36.66%,1
臺北市,文山區,1482,514,250,764,33,797,1412,56.44%,36.4%,1
臺北市,文山區,1483,520,374,894,39,933,1473,63.34%,35.3%,1
臺北市,文山區,1484,502,376,878,27,905,1486,60.9%,33.78%,1
臺北市,文山區,1485,651,336,987,31,1018,1616,63%,40.28%,1
臺北市,文山區,1486,605,304,909,37,946,1489,63.53%,40.63%,1
臺北市,文山區,1487,555,260,815,27,842,1414,59.55%,39.25%,1
臺北市,文山區,1488,575,360,935,29,964,1494,64.52%,38.49%,1
臺北市,文山區,1489,601,320,921,41,962,1547,62.18%,38.85%,1
臺北市,文山區,1490,614,317,931,37,968,1587,61%,38.69%,1
臺北市,文山區,1491,577,351,928,26,954,1515,62.97%,38.09%,1
臺北市,文山區,1492,611,342,953,39,992,1573,63.06%,38.84%,1
臺北市,文山區,1493,582,358,940,25,965,1542,62.58%,37.74%,1
臺北市,文山區,1494,494,277,771,39,810,1465,55.29%,33.72%,1
臺北市,文山區,1495,201,117,318,29,347,699,49.64%,28.76%,1
臺北市,文山區,1496,434,253,687,25,712,1372,51.9%,31.63%,1
臺北市,文山區,1497,451,250,701,45,746,1448,51.52%,31.15%,1
臺北市,文山區,1498,592,293,885,31,916,1548,59.17%,38.24%,1
臺北市,文山區,1499,553,323,876,27,903,1501,60.16%,36.84%,1
臺北市,文山區,1500,583,354,937,31,968,1560,62.05%,37.37%,1
臺北市,文山區,1501,578,326,904,27,931,1567,59.41%,36.89%,1
臺北市,文山區,1502,552,350,902,21,923,1554,59.4%,35.52%,1
臺北市,文山區,1503,566,317,883,35,918,1544,59.46%,36.66%,1
臺北市,文山區,1504,578,332,910,27,937,1528,61.32%,37.83%,1
臺北市,文山區,1505,621,320,941,26,967,1543,62.67%,40.25%,1
臺北市,文山區,1506,562,344,906,45,951,2754,34.53%,20.41%,1
臺北市,文山區,1507,541,305,846,48,894,1709,52.31%,31.66%,1
臺北市,文山區,1508,551,264,815,56,871,1515,57.49%,36.37%,1
臺北市,文山區,1509,520,300,820,42,862,1571,54.87%,33.1%,1
臺北市,文山區,1510,515,356,871,39,910,1578,57.67%,32.64%,1
臺北市,文山區,1511,516,284,800,26,826,1454,56.81%,35.49%,1
臺北市,文山區,1512,526,285,811,44,855,1436,59.54%,36.63%,1
臺北市,文山區,1513,569,289,858,34,892,1402,63.62%,40.58%,1
臺北市,文山區,1514,428,244,672,28,700,1117,62.67%,38.32%,1
臺北市,文山區,1515,389,224,613,44,657,1094,60.05%,35.56%,1
臺北市,文山區,1516,445,214,659,30,689,1070,64.39%,41.59%,1
臺北市,文山區,1517,549,271,820,33,853,1319,64.67%,41.62%,1
臺北市,文山區,1518,506,259,765,26,791,1226,64.52%,41.27%,1
臺北市,文山區,1519,492,263,755,30,785,1385,56.68%,35.52%,1
臺北市,文山區,1520,492,315,807,39,846,1416,59.75%,34.75%,1
臺北市,文山區,1521,577,296,873,34,907,1412,64.24%,40.86%,1
臺北市,文山區,1522,545,302,847,46,893,1535,58.18%,35.5%,1
臺北市,文山區,1523,656,344,1000,44,1044,1654,63.12%,39.66%,1
臺北市,文山區,1524,446,260,706,25,731,1156,63.24%,38.58%,1
臺北市,文山區,1525,465,292,757,28,785,1231,63.77%,37.77%,1
臺北市,文山區,1526,523,173,696,38,734,1218,60.26%,42.94%,1
臺北市,文山區,1527,455,276,731,27,758,1176,64.46%,38.69%,1
臺北市,文山區,1528,534,327,861,4,865,1392,62.14%,38.36%,1
臺北市,文山區,1529,459,268,727,57,784,1323,59.26%,34.69%,1
臺北市,文山區,1530,482,257,739,24,763,1297,58.83%,37.16%,1
臺北市,文山區,1531,500,287,787,31,818,1296,63.12%,38.58%,1
臺北市,文山區,1532,573,322,895,37,932,1613,57.78%,35.52%,1
臺北市,文山區,1533,620,351,971,63,1034,1697,60.93%,36.54%,1
臺北市,文山區,1534,556,335,891,53,944,1579,59.78%,35.21%,1
臺北市,文山區,1535,513,285,798,39,837,1320,63.41%,38.86%,1
臺北市,文山區,1536,553,300,853,21,874,1438,60.78%,38.46%,1
臺北市,文山區,1537,539,257,796,18,814,1465,55.56%,36.79%,1
臺北市,文山區,1538,571,389,960,36,996,1646,60.51%,34.69%,1
臺北市,文山區,1539,480,269,749,39,788,1286,61.28%,37.33%,1
臺北市,文山區,1540,443,276,719,17,736,1219,60.38%,36.34%,1
臺北市,文山區,1541,493,288,781,32,813,1292,62.93%,38.16%,1
臺北市,文山區,1542,543,279,822,40,862,1489,57.89%,36.47%,1
臺北市,文山區,1543,550,403,953,36,989,1611,61.39%,34.14%,1
臺北市,文山區,1544,490,290,780,36,816,1549,52.68%,31.63%,1
臺北市,文山區,1545,601,310,911,41,952,1678,56.73%,35.82%,1
臺北市,文山區,1546,592,311,903,46,949,1660,57.17%,35.66%,1
臺北市,文山區,1547,544,338,882,28,910,1816,50.11%,29.96%,1
臺北市,文山區,1548,342,231,573,23,596,985,60.51%,34.72%,1
臺北市,文山區,1549,497,297,794,17,811,1314,61.72%,37.82%,1
臺北市,文山區,1550,366,228,594,24,618,1018,60.71%,35.95%,1
臺北市,文山區,1551,548,364,912,29,941,1578,59.63%,34.73%,1
臺北市,文山區,1552,505,317,822,36,858,1457,58.89%,34.66%,1
臺北市,文山區,1553,521,273,794,28,822,1326,61.99%,39.29%,1
臺北市,文山區,1554,515,321,836,26,862,1393,61.88%,36.97%,1
臺北市,文山區,1555,467,290,757,39,796,1377,57.81%,33.91%,1
臺北市,文山區,1556,487,359,846,25,871,1448,60.15%,33.63%,1
臺北市,文山區,1557,533,351,884,34,918,1447,63.44%,36.83%,1
臺北市,文山區,1558,645,459,1104,33,1137,1739,65.38%,37.09%,1
臺北市,文山區,1559,507,355,862,21,883,1457,60.6%,34.8%,1
臺北市,文山區,1560,465,293,758,37,795,1288,61.72%,36.1%,1
臺北市,文山區,1561,410,269,679,37,716,1301,55.03%,31.51%,1
臺北市,文山區,1562,263,168,431,47,478,865,55.26%,30.4%,1
臺北市,文山區,1563,263,153,416,27,443,789,56.15%,33.33%,1
臺北市,南港區,0455,441,257,698,21,719,1280,56.17%,34.45%,1
臺北市,南港區,0456,485,278,763,21,784,1351,58.03%,35.9%,1
臺北市,南港區,0457,485,283,768,34,802,1345,59.63%,36.06%,1
臺北市,南港區,0458,448,264,712,33,745,1679,44.37%,26.68%,1
臺北市,南港區,0459,499,349,848,32,880,1680,52.38%,29.7%,1
臺北市,南港區,0460,517,301,818,38,856,1635,52.35%,31.62%,1
臺北市,南港區,0461,491,281,772,26,798,1459,54.69%,33.65%,1
臺北市,南港區,0462,610,360,970,20,990,1706,58.03%,35.76%,1
臺北市,南港區,0463,554,328,882,37,919,1674,54.9%,33.09%,1
臺北市,南港區,0464,513,310,823,14,837,1491,56.14%,34.41%,1
臺北市,南港區,0465,429,245,674,24,698,1086,64.27%,39.5%,1
臺北市,南港區,0466,460,278,738,41,779,1202,64.81%,38.27%,1
臺北市,南港區,0467,422,269,691,39,730,1198,60.93%,35.23%,1
臺北市,南港區,0468,456,314,770,22,792,1430,55.38%,31.89%,1
臺北市,南港區,0469,434,324,758,34,792,1275,62.12%,34.04%,1
臺北市,南港區,0470,450,376,826,42,868,1344,64.58%,33.48%,1
臺北市,南港區,0471,469,353,822,16,838,1391,60.24%,33.72%,1
臺北市,南港區,0472,474,327,801,20,821,1342,61.18%,35.32%,1
臺北市,南港區,0473,449,286,735,28,763,1389,54.93%,32.33%,1
臺北市,南港區,0474,509,329,838,33,871,1426,61.08%,35.69%,1
臺北市,南港區,0475,533,252,785,21,806,1359,59.31%,39.22%,1
臺北市,南港區,0476,490,281,771,27,798,1366,58.42%,35.87%,1
臺北市,南港區,0477,532,297,829,24,853,1441,59.2%,36.92%,1
臺北市,南港區,0478,505,292,797,43,840,1529,54.94%,33.03%,1
臺北市,南港區,0479,492,335,827,43,870,1618,53.77%,30.41%,1
臺北市,南港區,0480,447,272,719,41,760,1545,49.19%,28.93%,1
臺北市,南港區,0481,581,288,869,33,902,1569,57.49%,37.03%,1
臺北市,南港區,0482,505,319,824,36,860,1661,51.78%,30.4%,1
臺北市,南港區,0483,466,300,766,37,803,1518,52.9%,30.7%,1
臺北市,南港區,0484,579,346,925,34,959,1552,61.79%,37.31%,1
臺北市,南港區,0485,559,329,888,17,905,1658,54.58%,33.72%,1
臺北市,南港區,0486,548,346,894,43,937,1608,58.27%,34.08%,1
臺北市,南港區,0487,473,319,792,35,827,1475,56.07%,32.07%,1
臺北市,南港區,0488,646,392,1038,29,1067,1722,61.96%,37.51%,1
臺北市,南港區,0489,561,323,884,24,908,1383,65.65%,40.56%,1
臺北市,南港區,0490,487,312,799,27,826,1397,59.13%,34.86%,1
臺北市,南港區,0491,502,284,786,28,814,1352,60.21%,37.13%,1
臺北市,南港區,0492,500,291,791,20,811,1344,60.34%,37.2%,1
臺北市,南港區,0493,438,301,739,26,765,1385,55.23%,31.62%,1
臺北市,南港區,0494,474,296,770,34,804,1399,57.47%,33.88%,1
臺北市,南港區,0495,456,285,741,24,765,1381,55.39%,33.02%,1
臺北市,南港區,0496,514,299,813,42,855,1548,55.23%,33.2%,1
臺北市,南港區,0497,377,263,640,24,664,1190,55.8%,31.68%,1
臺北市,南港區,0498,528,333,861,28,889,1490,59.66%,35.44%,1
臺北市,南港區,0499,428,235,663,19,682,1096,62.23%,39.05%,1
臺北市,南港區,0500,458,292,750,21,771,1238,62.28%,37%,1
臺北市,南港區,0501,485,281,766,29,795,1271,62.55%,38.16%,1
臺北市,南港區,0502,423,222,645,25,670,1146,58.46%,36.91%,1
臺北市,南港區,0503,419,267,686,32,718,1232,58.28%,34.01%,1
臺北市,南港區,0504,505,309,814,25,839,1649,50.88%,30.62%,1
臺北市,南港區,0505,620,345,965,37,1002,1688,59.36%,36.73%,1
臺北市,南港區,0506,552,328,880,34,914,1503,60.81%,36.73%,1
臺北市,南港區,0507,557,328,885,22,907,1542,58.82%,36.12%,1
臺北市,南港區,0508,544,287,831,37,868,1463,59.33%,37.18%,1
臺北市,南港區,0509,446,271,717,40,757,1195,63.35%,37.32%,1
臺北市,南港區,0510,440,303,743,7,750,1254,59.81%,35.09%,1
臺北市,南港區,0511,495,283,778,34,812,1356,59.88%,36.5%,1
臺北市,南港區,0512,478,295,773,66,839,1363,61.56%,35.07%,1
臺北市,南港區,0513,400,396,796,24,820,1317,62.26%,30.37%,1
臺北市,南港區,0514,469,305,774,17,791,1331,59.43%,35.24%,1
臺北市,南港區,0515,543,361,904,36,940,1610,58.39%,33.73%,1
臺北市,南港區,0516,593,263,856,21,877,1542,56.87%,38.46%,1
臺北市,南港區,0517,577,328,905,36,941,1581,59.52%,36.5%,1
臺北市,南港區,0518,489,258,747,28,775,1225,63.27%,39.92%,1
臺北市,南港區,0519,578,283,861,11,872,1264,68.99%,45.73%,1
臺北市,南港區,0520,590,375,965,57,1022,1649,61.98%,35.78%,1
臺北市,南港區,0521,460,287,747,21,768,1267,60.62%,36.31%,1
臺北市,南港區,0522,502,265,767,28,795,1336,59.51%,37.57%,1
臺北市,南港區,0523,455,252,707,26,733,1162,63.08%,39.16%,1
臺北市,南港區,0524,354,255,609,25,634,1045,60.67%,33.88%,1
臺北市,南港區,0525,569,305,874,33,907,1351,67.14%,42.12%,1
臺北市,南港區,0526,521,266,787,20,807,1358,59.43%,38.37%,1
臺北市,內湖區,0305,550,315,865,18,883,1661,53.16%,33.11%,1
臺北市,內湖區,0306,525,334,859,38,897,1602,55.99%,32.77%,1
臺北市,內湖區,0307,633,342,975,40,1015,1655,61.33%,38.25%,1
臺北市,內湖區,0308,550,382,932,35,967,1582,61.13%,34.77%,1
臺北市,內湖區,0309,543,370,913,31,944,1688,55.92%,32.17%,1
臺北市,內湖區,0310,569,389,958,46,1004,1737,57.8%,32.76%,1
臺北市,內湖區,0311,634,401,1035,31,1066,1809,58.93%,35.05%,1
臺北市,內湖區,0312,482,283,765,23,788,1376,57.27%,35.03%,1
臺北市,內湖區,0313,643,364,1007,59,1066,1747,61.02%,36.81%,1
臺北市,內湖區,0314,516,322,838,18,856,1389,61.63%,37.15%,1
臺北市,內湖區,0315,542,337,879,35,914,1454,62.86%,37.28%,1
臺北市,內湖區,0316,529,378,907,31,938,1468,63.9%,36.04%,1
臺北市,內湖區,0317,625,352,977,33,1010,1603,63.01%,38.99%,1
臺北市,內湖區,0318,618,379,997,21,1018,1795,56.71%,34.43%,1
臺北市,內湖區,0319,655,403,1058,36,1094,1737,62.98%,37.71%,1
臺北市,內湖區,0320,634,379,1013,38,1051,1744,60.26%,36.35%,1
臺北市,內湖區,0321,598,346,944,38,982,1661,59.12%,36%,1
臺北市,內湖區,0322,513,362,875,34,909,1577,57.64%,32.53%,1
臺北市,內湖區,0323,580,325,905,17,922,1494,61.71%,38.82%,1
臺北市,內湖區,0324,589,341,930,29,959,1626,58.98%,36.22%,1
臺北市,內湖區,0325,584,353,937,39,976,1641,59.48%,35.59%,1
臺北市,內湖區,0326,545,342,887,32,919,1554,59.14%,35.07%,1
臺北市,內湖區,0327,710,318,1028,40,1068,1728,61.81%,41.09%,1
臺北市,內湖區,0328,614,339,953,31,984,1736,56.68%,35.37%,1
臺北市,內湖區,0329,559,346,905,35,940,1461,64.34%,38.26%,1
臺北市,內湖區,0330,574,297,871,26,897,1509,59.44%,38.04%,1
臺北市,內湖區,0331,462,306,768,15,783,1358,57.66%,34.02%,1
臺北市,內湖區,0332,607,377,984,24,1008,1761,57.24%,34.47%,1
臺北市,內湖區,0333,573,360,933,34,967,1651,58.57%,34.71%,1
臺北市,內湖區,0334,644,387,1031,49,1080,1809,59.7%,35.6%,1
臺北市,內湖區,0335,609,380,989,42,1031,1773,58.15%,34.35%,1
臺北市,內湖區,0336,670,359,1029,39,1068,1890,56.51%,35.45%,1
臺北市,內湖區,0337,647,438,1085,39,1124,1760,63.86%,36.76%,1
臺北市,內湖區,0338,605,350,955,27,982,1645,59.7%,36.78%,1
臺北市,內湖區,0339,507,309,816,18,834,1324,62.99%,38.29%,1
臺北市,內湖區,0340,438,204,642,22,664,1072,61.94%,40.86%,1
臺北市,內湖區,0341,520,313,833,30,863,1509,57.19%,34.46%,1
臺北市,內湖區,0342,610,370,980,31,1011,1715,58.95%,35.57%,1
臺北市,內湖區,0343,655,270,925,34,959,1774,54.06%,36.92%,1
臺北市,內湖區,0344,710,387,1097,31,1128,1796,62.81%,39.53%,1
臺北市,內湖區,0345,641,355,996,31,1027,1784,57.57%,35.93%,1
臺北市,內湖區,0346,494,343,837,50,887,1417,62.6%,34.86%,1
臺北市,內湖區,0347,529,431,960,20,980,1699,57.68%,31.14%,1
臺北市,內湖區,0348,633,421,1054,29,1083,1719,63%,36.82%,1
臺北市,內湖區,0349,603,393,996,21,1017,1715,59.3%,35.16%,1
臺北市,內湖區,0350,510,344,854,24,878,1634,53.73%,31.21%,1
臺北市,內湖區,0351,528,253,781,37,818,1435,57%,36.79%,1
臺北市,內湖區,0352,525,292,817,19,836,1440,58.06%,36.46%,1
臺北市,內湖區,0353,534,337,871,28,899,1446,62.17%,36.93%,1
臺北市,內湖區,0354,541,320,861,42,903,1657,54.5%,32.65%,1
臺北市,內湖區,0355,457,285,742,39,781,1261,61.93%,36.24%,1
臺北市,內湖區,0356,144,78,222,17,239,456,52.41%,31.58%,1
臺北市,內湖區,0357,559,361,920,25,945,1433,65.95%,39.01%,1
臺北市,內湖區,0358,525,348,873,26,899,1485,60.54%,35.35%,1
臺北市,內湖區,0359,567,329,896,24,920,1590,57.86%,35.66%,1
臺北市,內湖區,0360,477,276,753,43,796,1219,65.3%,39.13%,1
臺北市,內湖區,0361,608,317,925,44,969,1732,55.95%,35.1%,1
臺北市,內湖區,0362,659,334,993,29,1022,1727,59.18%,38.16%,1
臺北市,內湖區,0363,604,331,935,34,969,1637,59.19%,36.9%,1
臺北市,內湖區,0364,500,312,812,31,843,1453,58.02%,34.41%,1
臺北市,內湖區,0365,584,321,905,19,924,1617,57.14%,36.12%,1
臺北市,內湖區,0366,546,338,884,21,905,1604,56.42%,34.04%,1
臺北市,內湖區,0367,535,346,881,19,900,1406,64.01%,38.05%,1
臺北市,內湖區,0368,479,323,802,27,829,1353,61.27%,35.4%,1
臺北市,內湖區,0369,647,371,1018,28,1046,1724,60.67%,37.53%,1
臺北市,內湖區,0370,493,328,821,20,841,1378,61.03%,35.78%,1
臺北市,內湖區,0371,536,311,847,20,867,1403,61.8%,38.2%,1
臺北市,內湖區,0372,522,333,855,25,880,1547,56.88%,33.74%,1
臺北市,內湖區,0373,606,412,1018,27,1045,1718,60.83%,35.27%,1
臺北市,內湖區,0374,606,403,1009,34,1043,1813,57.53%,33.43%,1
臺北市,內湖區,0375,692,367,1059,43,1102,1791,61.53%,38.64%,1
臺北市,內湖區,0376,667,432,1099,38,1137,1855,61.29%,35.96%,1
臺北市,內湖區,0377,668,345,1013,18,1031,1731,59.56%,38.59%,1
臺北市,內湖區,0378,610,381,991,32,1023,1593,64.22%,38.29%,1
臺北市,內湖區,0379,647,329,976,41,1017,1869,54.41%,34.62%,1
臺北市,內湖區,0380,623,358,981,41,1022,1687,60.58%,36.93%,1
臺北市,內湖區,0381,567,340,907,18,925,1530,60.46%,37.06%,1
臺北市,內湖區,0382,496,278,774,29,803,1300,61.77%,38.15%,1
臺北市,內湖區,0383,541,267,808,38,846,1314,64.38%,41.17%,1
臺北市,內湖區,0384,458,291,749,20,769,1433,53.66%,31.96%,1
臺北市,內湖區,0385,478,298,776,23,799,1450,55.1%,32.97%,1
臺北市,內湖區,0386,525,359,884,47,931,1608,57.9%,32.65%,1
臺北市,內湖區,0387,484,325,809,37,846,1414,59.83%,34.23%,1
臺北市,內湖區,0388,520,348,868,23,891,1492,59.72%,34.85%,1
臺北市,內湖區,0389,511,342,853,19,872,1528,57.07%,33.44%,1
臺北市,內湖區,0390,587,362,949,35,984,1692,58.16%,34.69%,1
臺北市,內湖區,0391,538,331,869,51,920,1556,59.13%,34.58%,1
臺北市,內湖區,0392,547,354,901,22,923,1637,56.38%,33.41%,1
臺北市,內湖區,0393,652,287,939,29,968,1749,55.35%,37.28%,1
臺北市,內湖區,0394,422,240,662,19,681,1220,55.82%,34.59%,1
臺北市,內湖區,0395,560,329,889,43,932,1600,58.25%,35%,1
臺北市,內湖區,0396,506,324,830,25,855,1473,58.04%,34.35%,1
臺北市,內湖區,0397,482,333,815,47,862,1498,57.54%,32.18%,1
臺北市,內湖區,0398,530,340,870,29,899,1557,57.74%,34.04%,1
臺北市,內湖區,0399,528,332,860,38,898,1674,53.64%,31.54%,1
臺北市,內湖區,0400,623,375,998,41,1039,1728,60.13%,36.05%,1
臺北市,內湖區,0401,234,143,377,26,403,788,51.14%,29.7%,1
臺北市,內湖區,0402,490,340,830,38,868,1542,56.29%,31.78%,1
臺北市,內湖區,0403,460,334,794,51,845,1676,50.42%,27.45%,1
臺北市,內湖區,0404,435,277,712,18,730,1360,53.68%,31.99%,1
臺北市,內湖區,0405,501,279,780,21,801,1259,63.62%,39.79%,1
臺北市,內湖區,0406,479,237,716,14,730,1301,56.11%,36.82%,1
臺北市,內湖區,0407,381,239,620,28,648,1251,51.8%,30.46%,1
臺北市,內湖區,0408,515,299,814,44,858,1502,57.12%,34.29%,1
臺北市,內湖區,0409,572,304,876,30,906,1596,56.77%,35.84%,1
臺北市,內湖區,0410,586,346,932,18,950,1649,57.61%,35.54%,1
臺北市,內湖區,0411,598,347,945,37,982,1774,55.36%,33.71%,1
臺北市,內湖區,0412,596,340,936,26,962,1746,55.1%,34.14%,1
臺北市,內湖區,0413,498,313,811,19,830,1473,56.35%,33.81%,1
臺北市,內湖區,0414,560,377,937,34,971,2824,34.38%,19.83%,1
臺北市,內湖區,0415,547,404,951,24,975,1849,52.73%,29.58%,1
臺北市,內湖區,0416,499,320,819,40,859,1530,56.14%,32.61%,1
臺北市,內湖區,0417,561,402,963,31,994,1656,60.02%,33.88%,1
臺北市,內湖區,0418,503,339,842,25,867,1457,59.51%,34.52%,1
臺北市,內湖區,0419,641,350,991,28,1019,1695,60.12%,37.82%,1
臺北市,內湖區,0420,600,355,955,29,984,1663,59.17%,36.08%,1
臺北市,內湖區,0421,602,320,922,30,952,1654,57.56%,36.4%,1
臺北市,內湖區,0422,566,393,959,28,987,1642,60.11%,34.47%,1
臺北市,內湖區,0423,570,395,965,18,983,1685,58.34%,33.83%,1
臺北市,內湖區,0424,666,365,1031,30,1061,1862,56.98%,35.77%,1
臺北市,內湖區,0425,672,431,1103,43,1146,1900,60.32%,35.37%,1
臺北市,內湖區,0426,706,399,1105,36,1141,1790,63.74%,39.44%,1
臺北市,內湖區,0427,465,317,782,27,809,1417,57.09%,32.82%,1
臺北市,內湖區,0428,486,446,932,37,969,1694,57.2%,28.69%,1
臺北市,內湖區,0429,562,320,882,40,922,1676,55.01%,33.53%,1
臺北市,內湖區,0430,542,378,920,14,934,1643,56.85%,32.99%,1
臺北市,內湖區,0431,539,369,908,25,933,1588,58.75%,33.94%,1
臺北市,內湖區,0432,565,341,906,53,959,1603,59.83%,35.25%,1
臺北市,內湖區,0433,574,364,938,17,955,1629,58.62%,35.24%,1
臺北市,內湖區,0434,607,378,985,33,1018,1646,61.85%,36.88%,1
臺北市,內湖區,0435,660,363,1023,22,1045,1883,55.5%,35.05%,1
臺北市,內湖區,0436,499,309,808,26,834,1434,58.16%,34.8%,1
臺北市,內湖區,0437,500,307,807,17,824,1418,58.11%,35.26%,1
臺北市,內湖區,0438,502,293,795,33,828,1373,60.31%,36.56%,1
臺北市,內湖區,0439,505,285,790,29,819,1349,60.71%,37.44%,1
臺北市,內湖區,0440,570,332,902,30,932,1511,61.68%,37.72%,1
臺北市,內湖區,0441,601,344,945,27,972,1563,62.19%,38.45%,1
臺北市,內湖區,0442,538,342,880,28,908,1550,58.58%,34.71%,1
臺北市,內湖區,0443,387,239,626,32,658,1157,56.87%,33.45%,1
臺北市,內湖區,0444,583,428,1011,34,1045,1768,59.11%,32.98%,1
臺北市,內湖區,0445,594,340,934,39,973,1664,58.47%,35.7%,1
臺北市,內湖區,0446,578,419,997,31,1028,1743,58.98%,33.16%,1
臺北市,內湖區,0447,444,331,775,13,788,1480,53.24%,30%,1
臺北市,內湖區,0448,578,373,951,36,987,1589,62.11%,36.38%,1
臺北市,內湖區,0449,481,288,769,24,793,1371,57.84%,35.08%,1
臺北市,內湖區,0450,604,358,962,18,980,1575,62.22%,38.35%,1
臺北市,內湖區,0451,488,306,794,14,808,1377,58.68%,35.44%,1
臺北市,內湖區,0452,538,385,923,44,967,1469,65.83%,36.62%,1
臺北市,內湖區,0453,575,379,954,11,965,1529,63.11%,37.61%,1
臺北市,內湖區,0454,567,403,970,37,1007,1649,61.07%,34.38%,1
臺北市,士林區,0142,573,338,911,55,966,1695,56.99%,33.81%,1
臺北市,士林區,0143,628,352,980,55,1035,1720,60.17%,36.51%,1
臺北市,士林區,0144,444,263,707,43,750,1288,58.23%,34.47%,1
臺北市,士林區,0145,526,322,848,34,882,1546,57.05%,34.02%,1
臺北市,士林區,0146,247,147,394,21,415,652,63.65%,37.88%,1
臺北市,士林區,0147,277,180,457,24,481,870,55.29%,31.84%,1
臺北市,士林區,0148,411,267,678,34,712,1137,62.62%,36.15%,1
臺北市,士林區,0149,417,219,636,30,666,1050,63.43%,39.71%,1
臺北市,士林區,0150,396,215,611,33,644,1031,62.46%,38.41%,1
臺北市,士林區,0151,388,237,625,22,647,1075,60.19%,36.09%,1
臺北市,士林區,0152,302,193,495,29,524,2175,24.09%,13.89%,1
臺北市,士林區,0153,564,337,901,48,949,1775,53.46%,31.77%,1
臺北市,士林區,0154,616,345,961,25,986,1669,59.08%,36.91%,1
臺北市,士林區,0155,591,383,974,42,1016,1665,61.02%,35.5%,1
臺北市,士林區,0156,601,379,980,45,1025,1648,62.2%,36.47%,1
臺北市,士林區,0157,487,229,716,19,735,1246,58.99%,39.09%,1
臺北市,士林區,0158,485,293,778,42,820,1419,57.79%,34.18%,1
臺北市,士林區,0159,444,284,728,46,774,1327,58.33%,33.46%,1
臺北市,士林區,0160,565,376,941,41,982,1573,62.43%,35.92%,1
臺北市,士林區,0161,544,280,824,50,874,1470,59.46%,37.01%,1
臺北市,士林區,0162,655,358,1013,32,1045,1775,58.87%,36.9%,1
臺北市,士林區,0163,588,383,971,31,1002,1692,59.22%,34.75%,1
臺北市,士林區,0164,670,369,1039,45,1084,1842,58.85%,36.37%,1
臺北市,士林區,0165,467,224,691,28,719,1166,61.66%,40.05%,1
臺北市,士林區,0166,535,302,837,40,877,1687,51.99%,31.71%,1
臺北市,士林區,0167,565,333,898,38,936,1624,57.64%,34.79%,1
臺北市,士林區,0168,547,330,877,51,928,1477,62.83%,37.03%,1
臺北市,士林區,0169,478,274,752,28,780,1250,62.4%,38.24%,1
臺北市,士林區,0170,480,340,820,40,860,1434,59.97%,33.47%,1
臺北市,士林區,0171,514,327,841,36,877,1452,60.4%,35.4%,1
臺北市,士林區,0172,586,330,916,40,956,1533,62.36%,38.23%,1
臺北市,士林區,0173,573,316,889,45,934,1515,61.65%,37.82%,1
臺北市,士林區,0174,425,283,708,26,734,1203,61.01%,35.33%,1
臺北市,士林區,0175,552,327,879,49,928,1487,62.41%,37.12%,1
臺北市,士林區,0176,479,251,730,19,749,1252,59.82%,38.26%,1
臺北市,士林區,0177,544,303,847,40,887,1536,57.75%,35.42%,1
臺北市,士林區,0178,600,319,919,33,952,1556,61.18%,38.56%,1
臺北市,士林區,0179,529,349,878,28,906,1511,59.96%,35.01%,1
臺北市,士林區,0180,564,368,932,37,969,1572,61.64%,35.88%,1
臺北市,士林區,0181,592,325,917,56,973,1668,58.33%,35.49%,1
臺北市,士林區,0182,588,326,914,55,969,1685,57.51%,34.9%,1
臺北市,士林區,0183,515,350,865,38,903,1568,57.59%,32.84%,1
臺北市,士林區,0184,460,248,708,26,734,1327,55.31%,34.66%,1
臺北市,士林區,0185,461,257,718,30,748,1338,55.9%,34.45%,1
臺北市,士林區,0186,483,278,761,43,804,1515,53.07%,31.88%,1
臺北市,士林區,0187,511,294,805,45,850,1452,58.54%,35.19%,1
臺北市,士林區,0188,505,320,825,27,852,1448,58.84%,34.88%,1
臺北市,士林區,0189,548,331,879,38,917,1521,60.29%,36.03%,1
臺北市,士林區,0190,538,303,841,18,859,1461,58.8%,36.82%,1
臺北市,士林區,0191,466,307,773,67,840,1541,54.51%,30.24%,1
臺北市,士林區,0192,448,290,738,31,769,1611,47.73%,27.81%,1
臺北市,士林區,0193,508,301,809,49,858,1595,53.79%,31.85%,1
臺北市,士林區,0194,565,290,855,30,885,1685,52.52%,33.53%,1
臺北市,士林區,0195,594,347,941,48,989,1816,54.46%,32.71%,1
臺北市,士林區,0196,582,334,916,42,958,1687,56.79%,34.5%,1
臺北市,士林區,0197,581,308,889,47,936,1646,56.87%,35.3%,1
臺北市,士林區,0198,537,321,858,33,891,1643,54.23%,32.68%,1
臺北市,士林區,0199,606,351,957,29,986,1687,58.45%,35.92%,1
臺北市,士林區,0200,667,226,893,45,938,1655,56.68%,40.3%,1
臺北市,士林區,0201,543,377,920,25,945,1779,53.12%,30.52%,1
臺北市,士林區,0202,633,412,1045,43,1088,1855,58.65%,34.12%,1
臺北市,士林區,0203,463,290,753,35,788,1350,58.37%,34.3%,1
臺北市,士林區,0204,500,241,741,24,765,1455,52.58%,34.36%,1
臺北市,士林區,0205,398,283,681,40,721,1497,48.16%,26.59%,1
臺北市,士林區,0206,400,245,645,26,671,1398,48%,28.61%,1
臺北市,士林區,0207,620,362,982,50,1032,1747,59.07%,35.49%,1
臺北市,士林區,0208,490,249,739,45,784,1465,53.52%,33.45%,1
臺北市,士林區,0209,502,304,806,42,848,1530,55.42%,32.81%,1
臺北市,士林區,0210,587,344,931,46,977,1855,52.67%,31.64%,1
臺北市,士林區,0211,491,298,789,44,833,1444,57.69%,34%,1
臺北市,士林區,0212,501,294,795,37,832,1563,53.23%,32.05%,1
臺北市,士林區,0213,538,276,814,44,858,1482,57.89%,36.3%,1
臺北市,士林區,0214,504,303,807,59,866,1552,55.8%,32.47%,1
臺北市,士林區,0215,631,342,973,42,1015,1790,56.7%,35.25%,1
臺北市,士林區,0216,522,280,802,55,857,1628,52.64%,32.06%,1
臺北市,士林區,0217,450,266,716,45,761,1337,56.92%,33.66%,1
臺北市,士林區,0218,614,339,953,40,993,1750,56.74%,35.09%,1
臺北市,士林區,0219,532,313,845,65,910,1668,54.56%,31.89%,1
臺北市,士林區,0220,392,232,624,53,677,1403,48.25%,27.94%,1
臺北市,士林區,0221,393,277,670,34,704,1468,47.96%,26.77%,1
臺北市,士林區,0222,461,242,703,33,736,1471,50.03%,31.34%,1
臺北市,士林區,0223,538,279,817,56,873,1666,52.4%,32.29%,1
臺北市,士林區,0224,493,297,790,4,794,1587,50.03%,31.06%,1
臺北市,士林區,0225,563,339,902,57,959,1987,48.26%,28.33%,1
臺北市,士林區,0226,418,226,644,20,664,1271,52.24%,32.89%,1
臺北市,士林區,0227,610,392,1002,39,1041,1728,60.24%,35.3%,1
臺北市,士林區,0228,613,321,934,47,981,1630,60.18%,37.61%,1
臺北市,士林區,0229,573,360,933,34,967,1619,59.73%,35.39%,1
臺北市,士林區,0230,499,305,804,34,838,1425,58.81%,35.02%,1
臺北市,士林區,0231,588,377,965,36,1001,1623,61.68%,36.23%,1
臺北市,士林區,0232,544,340,884,39,923,1564,59.02%,34.78%,1
臺北市,士林區,0233,509,350,859,34,893,1376,64.9%,36.99%,1
臺北市,士林區,0234,592,321,913,26,939,1517,61.9%,39.02%,1
臺北市,士林區,0235,565,331,896,27,923,1729,53.38%,32.68%,1
臺北市,士林區,0236,563,323,886,44,930,1511,61.55%,37.26%,1
臺北市,士林區,0237,715,345,1060,26,1086,1811,59.97%,39.48%,1
臺北市,士林區,0238,537,351,888,19,907,1533,59.17%,35.03%,1
臺北市,士林區,0239,649,387,1036,41,1077,1657,65%,39.17%,1
臺北市,士林區,0240,517,316,833,28,861,1499,57.44%,34.49%,1
臺北市,士林區,0241,535,233,768,43,811,1402,57.85%,38.16%,1
臺北市,士林區,0242,456,323,779,51,830,1273,65.2%,35.82%,1
臺北市,士林區,0243,453,289,742,28,770,1273,60.49%,35.59%,1
臺北市,士林區,0244,459,293,752,26,778,1316,59.12%,34.88%,1
臺北市,士林區,0245,565,350,915,51,966,1659,58.23%,34.06%,1
臺北市,士林區,0246,553,398,951,40,991,1749,56.66%,31.62%,1
臺北市,士林區,0247,516,321,837,47,884,1552,56.96%,33.25%,1
臺北市,士林區,0248,593,281,874,37,911,1529,59.58%,38.78%,1
臺北市,士林區,0249,590,299,889,28,917,1644,55.78%,35.89%,1
臺北市,士林區,0250,626,350,976,38,1014,1779,57%,35.19%,1
臺北市,士林區,0251,545,342,887,26,913,1597,57.17%,34.13%,1
臺北市,士林區,0252,480,323,803,35,838,1454,57.63%,33.01%,1
臺北市,士林區,0253,516,410,926,52,978,1582,61.82%,32.62%,1
臺北市,士林區,0254,540,339,879,37,916,1518,60.34%,35.57%,1
臺北市,士林區,0255,462,324,786,27,813,1501,54.16%,30.78%,1
臺北市,士林區,0256,515,314,829,32,861,1420,60.63%,36.27%,1
臺北市,士林區,0257,511,328,839,39,878,1494,58.77%,34.2%,1
臺北市,士林區,0258,581,376,957,32,989,1568,63.07%,37.05%,1
臺北市,士林區,0259,417,307,724,42,766,1208,63.41%,34.52%,1
臺北市,士林區,0260,636,369,1005,31,1036,1826,56.74%,34.83%,1
臺北市,士林區,0261,534,381,915,36,951,1647,57.74%,32.42%,1
臺北市,士林區,0262,547,355,902,44,946,1654,57.19%,33.07%,1
臺北市,士林區,0263,541,357,898,41,939,1550,60.58%,34.9%,1
臺北市,士林區,0264,454,340,794,30,824,1298,63.48%,34.98%,1
臺北市,士林區,0265,490,300,790,31,821,1297,63.3%,37.78%,1
臺北市,士林區,0266,440,291,731,36,767,1352,56.73%,32.54%,1
臺北市,士林區,0267,517,327,844,36,880,1522,57.82%,33.97%,1
臺北市,士林區,0268,483,384,867,56,923,1602,57.62%,30.15%,1
臺北市,士林區,0269,483,326,809,32,841,1441,58.36%,33.52%,1
臺北市,士林區,0270,417,294,711,12,723,1325,54.57%,31.47%,1
臺北市,士林區,0271,532,334,866,41,907,1567,57.88%,33.95%,1
臺北市,士林區,0272,505,320,825,25,850,1518,55.99%,33.27%,1
臺北市,士林區,0273,542,370,912,37,949,1549,61.27%,34.99%,1
臺北市,士林區,0274,533,396,929,26,955,1652,57.81%,32.26%,1
臺北市,士林區,0275,622,383,1005,51,1056,1766,59.8%,35.22%,1
臺北市,士林區,0276,526,369,895,20,915,1638,55.86%,32.11%,1
臺北市,士林區,0277,564,305,869,27,896,1491,60.09%,37.83%,1
臺北市,士林區,0278,530,339,869,27,896,1521,58.91%,34.85%,1
臺北市,士林區,0279,504,288,792,35,827,1351,61.21%,37.31%,1
臺北市,士林區,0280,548,372,920,20,940,1742,53.96%,31.46%,1
臺北市,士林區,0281,524,355,879,34,913,1585,57.6%,33.06%,1
臺北市,士林區,0282,565,295,860,34,894,1521,58.78%,37.15%,1
臺北市,士林區,0283,494,351,845,19,864,1543,55.99%,32.02%,1
臺北市,士林區,0284,515,306,821,21,842,1404,59.97%,36.68%,1
臺北市,士林區,0285,536,325,861,33,894,1541,58.01%,34.78%,1
臺北市,士林區,0286,546,299,845,40,885,1584,55.87%,34.47%,1
臺北市,士林區,0287,519,351,870,41,911,1519,59.97%,34.17%,1
臺北市,士林區,0288,470,296,766,17,783,1482,52.83%,31.71%,1
臺北市,士林區,0289,407,272,679,37,716,1243,57.6%,32.74%,1
臺北市,士林區,0290,424,206,630,34,664,1156,57.44%,36.68%,1
臺北市,士林區,0291,384,254,638,47,685,1262,54.28%,30.43%,1
臺北市,士林區,0292,314,187,501,32,533,889,59.96%,35.32%,1
臺北市,士林區,0293,291,207,498,32,530,858,61.77%,33.92%,1
臺北市,士林區,0294,293,200,493,46,539,945,57.04%,31.01%,1
臺北市,士林區,0295,295,199,494,42,536,960,55.83%,30.73%,1
臺北市,士林區,0296,299,161,460,37,497,876,56.74%,34.13%,1
臺北市,士林區,0297,200,137,337,30,367,556,66.01%,35.97%,1
臺北市,士林區,0298,344,190,534,41,575,919,62.57%,37.43%,1
臺北市,士林區,0299,543,298,841,63,904,1360,66.47%,39.93%,1
臺北市,士林區,0300,517,273,790,45,835,1355,61.62%,38.15%,1
臺北市,士林區,0301,450,272,722,24,746,1252,59.58%,35.94%,1
臺北市,士林區,0302,473,232,705,38,743,1182,62.86%,40.02%,1
臺北市,士林區,0303,232,446,678,27,705,1431,49.27%,16.21%,1
臺北市,士林區,0304,409,236,645,37,682,1240,55%,32.98%,1
臺北市,北投區,0001,483,273,756,48,804,1313,61.23%,36.79%,1
臺北市,北投區,0002,499,337,836,35,871,1403,62.08%,35.57%,1
臺北市,北投區,0003,375,259,634,29,663,1081,61.33%,34.69%,1
臺北市,北投區,0004,402,285,687,43,730,1209,60.38%,33.25%,1
臺北市,北投區,0005,449,320,769,25,794,1326,59.88%,33.86%,1
臺北市,北投區,0006,449,291,740,29,769,1263,60.89%,35.55%,1
臺北市,北投區,0007,568,366,934,38,972,1580,61.52%,35.95%,1
臺北市,北投區,0008,578,323,901,37,938,1577,59.48%,36.65%,1
臺北市,北投區,0009,530,322,852,42,894,1483,60.28%,35.74%,1
臺北市,北投區,0010,505,293,798,32,830,1461,56.81%,34.57%,1
臺北市,北投區,0011,495,310,805,32,837,1466,57.09%,33.77%,1
臺北市,北投區,0012,639,302,941,30,971,1620,59.94%,39.44%,1
臺北市,北投區,0013,546,261,807,32,839,1543,54.37%,35.39%,1
臺北市,北投區,0014,512,279,791,54,845,1513,55.85%,33.84%,1
臺北市,北投區,0015,564,307,871,31,902,1534,58.8%,36.77%,1
臺北市,北投區,0016,602,331,933,51,984,1650,59.64%,36.48%,1
臺北市,北投區,0017,558,318,876,28,904,1533,58.97%,36.4%,1
臺北市,北投區,0018,561,356,917,27,944,1702,55.46%,32.96%,1
臺北市,北投區,0019,541,400,941,33,974,1721,56.6%,31.44%,1
臺北市,北投區,0020,539,385,924,40,964,1575,61.21%,34.22%,1
臺北市,北投區,0021,501,344,845,56,901,1530,58.89%,32.75%,1
臺北市,北投區,0022,602,360,962,48,1010,1728,58.45%,34.84%,1
臺北市,北投區,0023,602,326,928,42,970,1702,56.99%,35.37%,1
臺北市,北投區,0024,552,363,915,44,959,1696,56.54%,32.55%,1
臺北市,北投區,0025,518,260,778,23,801,1684,47.57%,30.76%,1
臺北市,北投區,0026,634,364,998,36,1034,1717,60.22%,36.92%,1
臺北市,北投區,0027,588,338,926,22,948,1605,59.07%,36.64%,1
臺北市,北投區,0028,644,311,955,37,992,1723,57.57%,37.38%,1
臺北市,北投區,0029,605,356,961,25,986,1597,61.74%,37.88%,1
臺北市,北投區,0030,606,349,955,23,978,1700,57.53%,35.65%,1
臺北市,北投區,0031,443,338,781,32,813,1544,52.66%,28.69%,1
臺北市,北投區,0032,536,321,857,24,881,1635,53.88%,32.78%,1
臺北市,北投區,0033,529,320,849,27,876,1495,58.6%,35.38%,1
臺北市,北投區,0034,569,345,914,33,947,1619,58.49%,35.15%,1
臺北市,北投區,0035,522,401,923,32,955,1683,56.74%,31.02%,1
臺北市,北投區,0036,559,301,860,36,896,1662,53.91%,33.63%,1
臺北市,北投區,0037,574,323,897,22,919,1850,49.68%,31.03%,1
臺北市,北投區,0038,487,358,845,24,869,1674,51.91%,29.09%,1
臺北市,北投區,0039,589,291,880,41,921,1511,60.95%,38.98%,1
臺北市,北投區,0040,497,284,781,12,793,1393,56.93%,35.68%,1
臺北市,北投區,0041,512,265,777,35,812,1279,63.49%,40.03%,1
臺北市,北投區,0042,368,238,606,33,639,1122,56.95%,32.8%,1
臺北市,北投區,0043,510,315,825,49,874,1238,70.6%,41.2%,1
臺北市,北投區,0044,557,316,873,45,918,1477,62.15%,37.71%,1
臺北市,北投區,0045,560,313,873,37,910,1495,60.87%,37.46%,1
臺北市,北投區,0046,577,330,907,29,936,1469,63.72%,39.28%,1
臺北市,北投區,0047,589,252,841,24,865,1462,59.17%,40.29%,1
臺北市,北投區,0048,530,277,807,37,844,1431,58.98%,37.04%,1
臺北市,北投區,0049,507,340,847,27,874,1486,58.82%,34.12%,1
臺北市,北投區,0050,544,303,847,39,886,1449,61.15%,37.54%,1
臺北市,北投區,0051,491,340,831,26,857,1456,58.86%,33.72%,1
臺北市,北投區,0052,487,257,744,25,769,1311,58.66%,37.15%,1
臺北市,北投區,0053,481,298,779,34,813,1356,59.96%,35.47%,1
臺北市,北投區,0054,481,267,748,38,786,1338,58.74%,35.95%,1
臺北市,北投區,0055,546,311,857,26,883,1525,57.9%,35.8%,1
臺北市,北投區,0056,527,337,864,28,892,1620,55.06%,32.53%,1
臺北市,北投區,0057,527,269,796,16,812,1499,54.17%,35.16%,1
臺北市,北投區,0058,605,284,889,24,913,1497,60.99%,40.41%,1
臺北市,北投區,0059,557,332,889,33,922,1624,56.77%,34.3%,1
臺北市,北投區,0060,488,305,793,51,844,1536,54.95%,31.77%,1
臺北市,北投區,0061,545,310,855,44,899,1469,61.2%,37.1%,1
臺北市,北投區,0062,544,314,858,31,889,1598,55.63%,34.04%,1
臺北市,北投區,0063,553,350,903,35,938,1690,55.5%,32.72%,1
臺北市,北投區,0064,528,319,847,66,913,1599,57.1%,33.02%,1
臺北市,北投區,0065,529,370,899,34,933,1634,57.1%,32.37%,1
臺北市,北投區,0066,522,321,843,44,887,1660,53.43%,31.45%,1
臺北市,北投區,0067,595,365,960,44,1004,1900,52.84%,31.32%,1
臺北市,北投區,0068,597,380,977,52,1029,1797,57.26%,33.22%,1
臺北市,北投區,0069,601,420,1021,46,1067,1832,58.24%,32.81%,1
臺北市,北投區,0070,631,366,997,51,1048,1784,58.74%,35.37%,1
臺北市,北投區,0071,601,273,874,38,912,1732,52.66%,34.7%,1
臺北市,北投區,0072,319,200,519,40,559,2035,27.47%,15.68%,1
臺北市,北投區,0073,511,299,810,38,848,1504,56.38%,33.98%,1
臺北市,北投區,0074,617,325,942,55,997,1683,59.24%,36.66%,1
臺北市,北投區,0075,532,323,855,55,910,1635,55.66%,32.54%,1
臺北市,北投區,0076,554,314,868,45,913,1613,56.6%,34.35%,1
臺北市,北投區,0077,526,267,793,33,826,1483,55.7%,35.47%,1
臺北市,北投區,0078,527,300,827,32,859,1500,57.27%,35.13%,1
臺北市,北投區,0079,499,330,829,37,866,1483,58.4%,33.65%,1
臺北市,北投區,0080,514,321,835,43,878,1544,56.87%,33.29%,1
臺北市,北投區,0081,448,278,726,42,768,1532,50.13%,29.24%,1
臺北市,北投區,0082,603,366,969,52,1021,1819,56.13%,33.15%,1
臺北市,北投區,0083,553,385,938,38,976,1863,52.39%,29.68%,1
臺北市,北投區,0084,554,360,914,19,933,1872,49.84%,29.59%,1
臺北市,北投區,0085,557,304,861,44,905,1627,55.62%,34.23%,1
臺北市,北投區,0086,556,326,882,27,909,1696,53.6%,32.78%,1
臺北市,北投區,0087,582,399,981,43,1024,1841,55.62%,31.61%,1
臺北市,北投區,0088,449,278,727,35,762,1324,57.55%,33.91%,1
臺北市,北投區,0089,506,288,794,30,824,1504,54.79%,33.64%,1
臺北市,北投區,0090,517,310,827,36,863,1511,57.11%,34.22%,1
臺北市,北投區,0091,549,380,929,26,955,1615,59.13%,33.99%,1
臺北市,北投區,0092,408,235,643,32,675,1270,53.15%,32.13%,1
臺北市,北投區,0093,433,289,722,25,747,1492,50.07%,29.02%,1
臺北市,北投區,0094,437,309,746,21,767,1429,53.67%,30.58%,1
臺北市,北投區,0095,489,320,809,16,825,1567,52.65%,31.21%,1
臺北市,北投區,0096,480,286,766,29,795,1388,57.28%,34.58%,1
臺北市,北投區,0097,460,284,744,16,760,1448,52.49%,31.77%,1
臺北市,北投區,0098,454,250,704,31,735,1356,54.2%,33.48%,1
臺北市,北投區,0099,476,237,713,19,732,1308,55.96%,36.39%,1
臺北市,北投區,0100,424,260,684,29,713,1165,61.2%,36.39%,1
臺北市,北投區,0101,553,266,819,45,864,1429,60.46%,38.7%,1
臺北市,北投區,0102,526,262,788,21,809,1472,54.96%,35.73%,1
臺北市,北投區,0103,555,353,908,38,946,1508,62.73%,36.8%,1
臺北市,北投區,0104,534,278,812,37,849,1480,57.36%,36.08%,1
臺北市,北投區,0105,363,238,601,27,628,1142,54.99%,31.79%,1
臺北市,北投區,0106,521,287,808,24,832,1554,53.54%,33.53%,1
臺北市,北投區,0107,601,331,932,55,987,1669,59.14%,36.01%,1
臺北市,北投區,0108,664,308,972,49,1021,1823,56.01%,36.42%,1
臺北市,北投區,0109,564,341,905,51,956,1739,54.97%,32.43%,1
臺北市,北投區,0110,609,333,942,42,984,1771,55.56%,34.39%,1
臺北市,北投區,0111,494,235,729,40,769,1468,52.38%,33.65%,1
臺北市,北投區,0112,510,303,813,27,840,1469,57.18%,34.72%,1
臺北市,北投區,0113,464,228,692,21,713,1094,65.17%,42.41%,1
臺北市,北投區,0114,484,193,677,25,702,1101,63.76%,43.96%,1
臺北市,北投區,0115,537,298,835,34,869,1422,61.11%,37.76%,1
臺北市,北投區,0116,520,232,752,29,781,1390,56.19%,37.41%,1
臺北市,北投區,0117,501,249,750,35,785,1307,60.06%,38.33%,1
臺北市,北投區,0118,442,284,726,46,772,1215,63.54%,36.38%,1
臺北市,北投區,0119,552,315,867,27,894,1642,54.45%,33.62%,1
臺北市,北投區,0120,551,281,832,36,868,1623,53.48%,33.95%,1
臺北市,北投區,0121,565,285,850,44,894,1621,55.15%,34.86%,1
臺北市,北投區,0122,454,302,756,17,773,1367,56.55%,33.21%,1
臺北市,北投區,0123,420,275,695,34,729,1309,55.69%,32.09%,1
臺北市,北投區,0124,477,310,787,29,816,1356,60.18%,35.18%,1
臺北市,北投區,0125,461,280,741,37,778,1365,57%,33.77%,1
臺北市,北投區,0126,504,353,857,29,886,1613,54.93%,31.25%,1
臺北市,北投區,0127,483,297,780,30,810,1590,50.94%,30.38%,1
臺北市,北投區,0128,594,329,923,44,967,1662,58.18%,35.74%,1
臺北市,北投區,0129,545,358,903,34,937,1622,57.77%,33.6%,1
臺北市,北投區,0130,573,401,974,33,1007,1820,55.33%,31.48%,1
臺北市,北投區,0131,583,317,900,50,950,1615,58.82%,36.1%,1
臺北市,北投區,0132,487,232,719,40,759,1612,47.08%,30.21%,1
臺北市,北投區,0133,538,336,874,53,927,1652,56.11%,32.57%,1
臺北市,北投區,0134,592,346,938,17,955,1666,57.32%,35.53%,1
臺北市,北投區,0135,559,307,866,37,903,1641,55.03%,34.06%,1
臺北市,北投區,0136,179,131,310,14,324,528,61.36%,33.9%,1
臺北市,北投區,0137,442,291,733,54,787,1642,47.93%,26.92%,1
臺北市,北投區,0138,300,143,443,28,471,829,56.82%,36.19%,1
臺北市,北投區,0139,244,110,354,25,379,690,54.93%,35.36%,1
臺北市,北投區,0140,369,186,555,33,588,1067,55.11%,34.58%,1
臺北市,北投區,0141,291,161,452,55,507,892,56.84%,32.62%,1
新北市,板橋區,0894,449,281,730,47,777,1388,55.98%,32.35%,1
新北市,板橋區,0895,439,289,728,31,759,1294,58.66%,33.93%,1
新北市,板橋區,0896,235,167,402,13,415,667,62.22%,35.23%,1
新北市,板橋區,0897,313,156,469,30,499,898,55.57%,34.86%,1
新北市,板橋區,0898,312,164,476,31,507,829,61.16%,37.64%,1
新北市,板橋區,0899,306,136,442,21,463,739,62.65%,41.41%,1
新北市,板橋區,0900,385,215,600,35,635,1035,61.35%,37.2%,1
新北市,板橋區,0901,476,308,784,17,801,1713,46.76%,27.79%,1
新北市,板橋區,0902,228,105,333,15,348,658,52.89%,34.65%,1
新北市,板橋區,0903,452,225,677,60,737,1312,56.17%,34.45%,1
新北市,板橋區,0904,486,253,739,45,784,1492,52.55%,32.57%,1
新北市,板橋區,0905,455,234,689,35,724,1393,51.97%,32.66%,1
新北市,板橋區,0906,535,306,841,29,870,4742,18.35%,11.28%,1
新北市,板橋區,0907,518,263,781,22,803,1439,55.8%,36%,1
新北市,板橋區,0908,458,227,685,42,727,1187,61.25%,38.58%,1
新北市,板橋區,0909,409,204,613,30,643,1122,57.31%,36.45%,1
新北市,板橋區,0910,522,239,761,47,808,1363,59.28%,38.3%,1
新北市,板橋區,0911,400,221,621,29,650,1093,59.47%,36.6%,1
新北市,板橋區,0912,477,278,755,40,795,1331,59.73%,35.84%,1
新北市,板橋區,0913,394,223,617,24,641,1026,62.48%,38.4%,1
新北市,板橋區,0914,447,235,682,48,730,1244,58.68%,35.93%,1
新北市,板橋區,0915,432,216,648,47,695,1268,54.81%,34.07%,1
新北市,板橋區,0916,452,233,685,26,711,1313,54.15%,34.42%,1
新北市,板橋區,0917,431,271,702,32,734,1196,61.37%,36.04%,1
新北市,板橋區,0918,480,270,750,34,784,1137,68.95%,42.22%,1
新北市,板橋區,0919,479,303,782,29,811,1269,63.91%,37.75%,1
新北市,板橋區,0920,420,248,668,28,696,1117,62.31%,37.6%,1
新北市,板橋區,0921,434,200,634,29,663,1042,63.63%,41.65%,1
新北市,板橋區,0922,487,220,707,49,756,1257,60.14%,38.74%,1
新北市,板橋區,0923,462,233,695,30,725,1216,59.62%,37.99%,1
新北市,板橋區,0924,383,240,623,32,655,1126,58.17%,34.01%,1
新北市,板橋區,0925,526,273,799,40,839,1290,65.04%,40.78%,1
新北市,板橋區,0926,398,228,626,22,648,1215,53.33%,32.76%,1
新北市,板橋區,0927,407,201,608,17,625,1099,56.87%,37.03%,1
新北市,板橋區,0928,570,254,824,23,847,1329,63.73%,42.89%,1
新北市,板橋區,0929,425,166,591,17,608,996,61.04%,42.67%,1
新北市,板橋區,0930,390,212,602,29,631,1047,60.27%,37.25%,1
新北市,板橋區,0931,506,225,731,39,770,1272,60.53%,39.78%,1
新北市,板橋區,0932,483,265,748,2,750,1252,59.9%,38.58%,1
新北市,板橋區,0933,485,212,697,35,732,1238,59.13%,39.18%,1
新北市,板橋區,0934,540,295,835,48,883,1389,63.57%,38.88%,1
新北市,板橋區,0935,467,302,769,33,802,1194,67.17%,39.11%,1
新北市,板橋區,0936,371,204,575,36,611,1093,55.9%,33.94%,1
新北市,板橋區,0937,428,198,626,45,671,1148,58.45%,37.28%,1
新北市,板橋區,0938,482,262,744,34,778,1268,61.36%,38.01%,1
新北市,板橋區,0939,443,238,681,37,718,1230,58.37%,36.02%,1
新北市,板橋區,0940,375,172,547,30,577,1012,57.02%,37.06%,1
新北市,板橋區,0941,315,149,464,28,492,811,60.67%,38.84%,1
新北市,板橋區,0942,467,252,719,43,762,1197,63.66%,39.01%,1
新北市,板橋區,0943,442,198,640,18,658,1142,57.62%,38.7%,1
新北市,板橋區,0944,463,239,702,23,725,1222,59.33%,37.89%,1
新北市,板橋區,0945,327,149,476,34,510,796,64.07%,41.08%,1
新北市,板橋區,0946,385,211,596,51,647,997,64.89%,38.62%,1
新北市,板橋區,0947,370,219,589,32,621,1011,61.42%,36.6%,1
新北市,板橋區,0948,432,230,662,42,704,1157,60.85%,37.34%,1
新北市,板橋區,0949,402,200,602,38,640,1040,61.54%,38.65%,1
新北市,板橋區,0950,458,237,695,18,713,1173,60.78%,39.05%,1
新北市,板橋區,0951,427,221,648,24,672,1193,56.33%,35.79%,1
新北市,板橋區,0952,484,251,735,22,757,1255,60.32%,38.57%,1
新北市,板橋區,0953,470,282,752,27,779,1306,59.65%,35.99%,1
新北市,板橋區,0954,427,189,616,16,632,1050,60.19%,40.67%,1
新北市,板橋區,0955,362,192,554,14,568,942,60.3%,38.43%,1
新北市,板橋區,0956,474,211,685,26,711,1133,62.75%,41.84%,1
新北市,板橋區,0957,455,256,711,32,743,1251,59.39%,36.37%,1
新北市,板橋區,0958,504,254,758,27,785,1293,60.71%,38.98%,1
新北市,板橋區,0959,418,204,622,43,665,1208,55.05%,34.6%,1
新北市,板橋區,0960,437,238,675,43,718,1223,58.71%,35.73%,1
新北市,板橋區,0961,360,197,557,47,604,1061,56.93%,33.93%,1
新北市,板橋區,0962,554,297,851,34,885,1515,58.42%,36.57%,1
新北市,板橋區,0963,493,233,726,29,755,1225,61.63%,40.24%,1
新北市,板橋區,0964,480,219,699,21,720,1120,64.29%,42.86%,1
新北市,板橋區,0965,437,224,661,32,693,1091,63.52%,40.05%,1
新北市,板橋區,0966,598,232,830,23,853,1385,61.59%,43.18%,1
新北市,板橋區,0967,512,244,756,40,796,1283,62.04%,39.91%,1
新北市,板橋區,0968,451,231,682,41,723,1204,60.05%,37.46%,1
新北市,板橋區,0969,493,241,734,30,764,1191,64.15%,41.39%,1
新北市,板橋區,0970,443,207,650,39,689,1078,63.91%,41.09%,1
新北市,板橋區,0971,534,241,775,31,806,1351,59.66%,39.53%,1
新北市,板橋區,0972,503,247,750,32,782,1322,59.15%,38.05%,1
新北市,板橋區,0973,330,169,499,27,526,868,60.6%,38.02%,1
新北市,板橋區,0974,436,221,657,34,691,1029,67.15%,42.37%,1
新北市,板橋區,0975,588,339,927,27,954,1602,59.55%,36.7%,1
新北市,板橋區,0976,535,241,776,35,811,1362,59.54%,39.28%,1
新北市,板橋區,0977,588,330,918,43,961,1698,56.6%,34.63%,1
新北市,板橋區,0978,523,309,832,21,853,1495,57.06%,34.98%,1
新北市,板橋區,0979,519,290,809,40,849,1522,55.78%,34.1%,1
新北市,板橋區,0980,251,464,715,41,756,1279,59.11%,19.62%,1
新北市,板橋區,0981,481,266,747,27,774,1559,49.65%,30.85%,1
新北市,板橋區,0982,498,281,779,50,829,1537,53.94%,32.4%,1
新北市,板橋區,0983,481,283,764,43,807,1531,52.71%,31.42%,1
新北市,板橋區,0984,566,243,809,24,833,1720,48.43%,32.91%,1
新北市,板橋區,0985,415,212,627,24,651,1165,55.88%,35.62%,1
新北市,板橋區,0986,657,379,1036,38,1074,1857,57.84%,35.38%,1
新北市,板橋區,0987,385,201,586,37,623,1078,57.79%,35.71%,1
新北市,板橋區,0988,414,212,626,20,646,1177,54.89%,35.17%,1
新北市,板橋區,0989,657,354,1011,39,1050,1798,58.4%,36.54%,1
新北市,板橋區,0990,545,286,831,51,882,1455,60.62%,37.46%,1
新北市,板橋區,0991,476,251,727,41,768,1245,61.69%,38.23%,1
新北市,板橋區,0992,549,350,899,41,940,1704,55.16%,32.22%,1
新北市,板橋區,0993,537,354,891,21,912,1600,57%,33.56%,1
新北市,板橋區,0994,525,324,849,8,857,1409,60.82%,37.26%,1
新北市,板橋區,0995,478,232,710,33,743,1286,57.78%,37.17%,1
新北市,板橋區,0996,408,187,595,77,672,1359,49.45%,30.02%,1
新北市,板橋區,0997,381,220,601,30,631,1188,53.11%,32.07%,1
新北市,板橋區,0998,574,289,863,39,902,1627,55.44%,35.28%,1
新北市,板橋區,0999,525,300,825,29,854,1633,52.3%,32.15%,1
新北市,板橋區,1000,642,405,1047,35,1082,1814,59.65%,35.39%,1
新北市,板橋區,1001,703,341,1044,41,1085,1810,59.94%,38.84%,1
新北市,板橋區,1002,419,210,629,37,666,1133,58.78%,36.98%,1
新北市,板橋區,1003,349,150,499,16,515,841,61.24%,41.5%,1
新北市,板橋區,1004,432,201,633,26,659,1050,62.76%,41.14%,1
新北市,板橋區,1005,407,209,616,33,649,1130,57.43%,36.02%,1
新北市,板橋區,1006,402,225,627,34,661,1056,62.59%,38.07%,1
新北市,板橋區,1007,395,200,595,28,623,1129,55.18%,34.99%,1
新北市,板橋區,1008,664,294,958,44,1002,1713,58.49%,38.76%,1
新北市,板橋區,1009,595,321,916,38,954,1622,58.82%,36.68%,1
新北市,板橋區,1010,544,315,859,39,898,1427,62.93%,38.12%,1
新北市,板橋區,1011,598,311,909,17,926,1471,62.95%,40.65%,1
新北市,板橋區,1012,363,220,583,15,598,1076,55.58%,33.74%,1
新北市,板橋區,1013,352,165,517,11,528,979,53.93%,35.96%,1
新北市,板橋區,1014,471,206,677,18,695,1079,64.41%,43.65%,1
新北市,板橋區,1015,315,149,464,13,477,828,57.61%,38.04%,1
新北市,板橋區,1016,317,164,481,38,519,820,63.29%,38.66%,1
新北市,板橋區,1017,402,199,601,23,624,989,63.09%,40.65%,1
新北市,板橋區,1018,362,200,562,39,601,1023,58.75%,35.39%,1
新北市,板橋區,1019,388,193,581,26,607,1044,58.14%,37.16%,1
新北市,板橋區,1020,380,167,547,30,577,968,59.61%,39.26%,1
新北市,板橋區,1021,445,257,702,22,724,1222,59.25%,36.42%,1
新北市,板橋區,1022,484,264,748,35,783,1385,56.53%,34.95%,1
新北市,板橋區,1023,550,300,850,44,894,1585,56.4%,34.7%,1
新北市,板橋區,1024,647,340,987,50,1037,1840,56.36%,35.16%,1
新北市,板橋區,1025,737,350,1087,44,1131,1806,62.62%,40.81%,1
新北市,板橋區,1026,535,276,811,52,863,1506,57.3%,35.52%,1
新北市,板橋區,1027,526,257,783,44,827,1476,56.03%,35.64%,1
新北市,板橋區,1028,537,302,839,44,883,1500,58.87%,35.8%,1
新北市,板橋區,1029,429,222,651,43,694,1096,63.32%,39.14%,1
新北市,板橋區,1030,390,179,569,35,604,963,62.72%,40.5%,1
新北市,板橋區,1031,582,299,881,31,912,1601,56.96%,36.35%,1
新北市,板橋區,1032,583,325,908,48,956,1507,63.44%,38.69%,1
新北市,板橋區,1033,502,262,764,54,818,1315,62.21%,38.17%,1
新北市,板橋區,1034,437,223,660,27,687,1178,58.32%,37.1%,1
新北市,板橋區,1035,689,358,1047,51,1098,1822,60.26%,37.82%,1
新北市,板橋區,1036,626,334,960,38,998,1605,62.18%,39%,1
新北市,板橋區,1037,582,309,891,26,917,1549,59.2%,37.57%,1
新北市,板橋區,1038,717,426,1143,19,1162,1948,59.65%,36.81%,1
新北市,板橋區,1039,693,384,1077,22,1099,1935,56.8%,35.81%,1
新北市,板橋區,1040,397,175,572,41,613,1097,55.88%,36.19%,1
新北市,板橋區,1041,388,199,587,20,607,1095,55.43%,35.43%,1
新北市,板橋區,1042,530,287,817,60,877,1678,52.26%,31.59%,1
新北市,板橋區,1043,626,295,921,45,966,1750,55.2%,35.77%,1
新北市,板橋區,1044,415,215,630,35,665,1187,56.02%,34.96%,1
新北市,板橋區,1045,429,241,670,24,694,1154,60.14%,37.18%,1
新北市,板橋區,1046,487,275,762,20,782,1262,61.97%,38.59%,1
新北市,板橋區,1047,463,212,675,45,720,1271,56.65%,36.43%,1
新北市,板橋區,1048,502,257,759,45,804,1410,57.02%,35.6%,1
新北市,板橋區,1049,562,305,867,58,925,1745,53.01%,32.21%,1
新北市,板橋區,1050,663,332,995,66,1061,1867,56.83%,35.51%,1
新北市,板橋區,1051,680,301,981,57,1038,1753,59.21%,38.79%,1
新北市,板橋區,1052,418,254,672,52,724,1204,60.13%,34.72%,1
新北市,板橋區,1053,571,324,895,44,939,1614,58.18%,35.38%,1
新北市,板橋區,1054,452,258,710,32,742,1237,59.98%,36.54%,1
新北市,板橋區,1055,481,294,775,39,814,1361,59.81%,35.34%,1
新北市,板橋區,1056,422,280,702,26,728,1243,58.57%,33.95%,1
新北市,板橋區,1057,492,280,772,31,803,1515,53%,32.48%,1
新北市,板橋區,1058,314,546,860,51,911,1515,60.13%,20.73%,1
新北市,板橋區,1059,386,159,545,41,586,949,61.75%,40.67%,1
新北市,板橋區,1060,562,295,857,43,900,1629,55.25%,34.5%,1
新北市,板橋區,1061,437,250,687,31,718,1238,58%,35.3%,1
新北市,板橋區,1062,260,118,378,15,393,901,43.62%,28.86%,1
新北市,板橋區,1063,498,290,788,79,867,1475,58.78%,33.76%,1
新北市,板橋區,1064,522,265,787,50,837,1481,56.52%,35.25%,1
新北市,板橋區,1065,566,317,883,79,962,1800,53.44%,31.44%,1
新北市,板橋區,1066,583,281,864,48,912,1630,55.95%,35.77%,1
新北市,板橋區,1067,495,265,760,17,777,1298,59.86%,38.14%,1
新北市,板橋區,1068,315,187,502,26,528,874,60.41%,36.04%,1
新北市,板橋區,1069,370,199,569,17,586,992,59.07%,37.3%,1
新北市,板橋區,1070,432,231,663,19,682,1034,65.96%,41.78%,1
新北市,板橋區,1071,506,304,810,44,854,1451,58.86%,34.87%,1
新北市,板橋區,1072,418,251,669,33,702,1130,62.12%,36.99%,1
新北市,板橋區,1073,554,270,824,23,847,1440,58.82%,38.47%,1
新北市,板橋區,1074,560,292,852,56,908,1531,59.31%,36.58%,1
新北市,板橋區,1075,531,299,830,41,871,1349,64.57%,39.36%,1
新北市,板橋區,1076,536,285,821,48,869,1593,54.55%,33.65%,1
新北市,板橋區,1077,451,223,674,20,694,1174,59.11%,38.42%,1
新北市,板橋區,1078,497,201,698,28,726,1228,59.12%,40.47%,1
新北市,板橋區,1079,441,255,696,26,722,1187,60.83%,37.15%,1
新北市,板橋區,1080,337,167,504,34,538,870,61.84%,38.74%,1
新北市,板橋區,1081,750,450,1200,28,1228,2033,60.4%,36.89%,1
新北市,板橋區,1082,470,264,734,37,771,1418,54.37%,33.15%,1
新北市,板橋區,1083,425,197,622,30,652,1075,60.65%,39.53%,1
新北市,板橋區,1084,500,300,800,37,837,1515,55.25%,33%,1
新北市,板橋區,1085,516,227,743,28,771,1182,65.23%,43.65%,1
新北市,板橋區,1086,625,374,999,56,1055,1893,55.73%,33.02%,1
新北市,板橋區,1087,459,241,700,31,731,1302,56.14%,35.25%,1
新北市,板橋區,1088,452,241,693,29,722,1366,52.86%,33.09%,1
新北市,板橋區,1089,516,265,781,43,824,1318,62.52%,39.15%,1
新北市,板橋區,1090,419,239,658,29,687,1200,57.25%,34.92%,1
新北市,板橋區,1091,672,443,1115,27,1142,2028,56.31%,33.14%,1
新北市,板橋區,1092,660,320,980,46,1026,1746,58.76%,37.8%,1
新北市,板橋區,1093,625,353,978,25,1003,1954,51.33%,31.99%,1
新北市,板橋區,1094,505,295,800,32,832,1474,56.45%,34.26%,1
新北市,板橋區,1095,545,248,793,31,824,1418,58.11%,38.43%,1
新北市,板橋區,1096,611,334,945,40,985,1563,63.02%,39.09%,1
新北市,板橋區,1097,642,293,935,54,989,1780,55.56%,36.07%,1
新北市,板橋區,1098,572,352,924,38,962,1707,56.36%,33.51%,1
新北市,板橋區,1099,252,122,374,10,384,906,42.38%,27.81%,1
新北市,板橋區,1100,358,207,565,33,598,1030,58.06%,34.76%,1
新北市,板橋區,1101,383,225,608,37,645,1115,57.85%,34.35%,1
新北市,板橋區,1102,662,328,990,25,1015,1836,55.28%,36.06%,1
新北市,板橋區,1103,644,347,991,56,1047,1881,55.66%,34.24%,1
新北市,板橋區,1104,565,338,903,59,962,1688,56.99%,33.47%,1
新北市,板橋區,1105,645,369,1014,23,1037,1760,58.92%,36.65%,1
新北市,板橋區,1106,409,211,620,35,655,1044,62.74%,39.18%,1
新北市,板橋區,1107,420,213,633,28,661,1043,63.37%,40.27%,1
新北市,板橋區,1108,433,216,649,46,695,1099,63.24%,39.4%,1
新北市,板橋區,1109,452,240,692,39,731,1260,58.02%,35.87%,1
新北市,板橋區,1110,434,201,635,28,663,1131,58.62%,38.37%,1
新北市,板橋區,1111,462,223,685,36,721,1225,58.86%,37.71%,1
新北市,板橋區,1112,579,305,884,37,921,1455,63.3%,39.79%,1
新北市,板橋區,1113,485,219,704,24,728,1267,57.46%,38.28%,1
新北市,板橋區,1114,371,192,563,28,591,972,60.8%,38.17%,1
新北市,板橋區,1115,381,198,579,26,605,994,60.87%,38.33%,1
新北市,板橋區,1116,421,222,643,10,653,1111,58.78%,37.89%,1
新北市,板橋區,1117,509,232,741,39,780,1177,66.27%,43.25%,1
新北市,板橋區,1118,538,286,824,35,859,1544,55.63%,34.84%,1
新北市,板橋區,1119,378,176,554,47,601,1021,58.86%,37.02%,1
新北市,板橋區,1120,388,168,556,40,596,1040,57.31%,37.31%,1
新北市,板橋區,1121,505,297,802,23,825,1504,54.85%,33.58%,1
新北市,板橋區,1122,463,253,716,29,745,1373,54.26%,33.72%,1
新北市,板橋區,1123,449,260,709,16,725,1210,59.92%,37.11%,1
新北市,板橋區,1124,605,322,927,38,965,1809,53.34%,33.44%,1
新北市,板橋區,1125,592,262,854,63,917,1551,59.12%,38.17%,1
新北市,板橋區,1126,520,277,797,24,821,1408,58.31%,36.93%,1
新北市,板橋區,1127,502,265,767,18,785,1285,61.09%,39.07%,1
新北市,板橋區,1128,471,225,696,21,717,1102,65.06%,42.74%,1
新北市,板橋區,1129,496,239,735,17,752,1399,53.75%,35.45%,1
新北市,板橋區,1130,624,283,907,57,964,1692,56.97%,36.88%,1
新北市,板橋區,1131,630,341,971,30,1001,1625,61.6%,38.77%,1
新北市,板橋區,1132,617,459,1076,47,1123,1712,65.6%,36.04%,1
新北市,板橋區,1133,460,238,698,30,728,1246,58.43%,36.92%,1
新北市,板橋區,1134,560,285,845,34,879,1471,59.76%,38.07%,1
新北市,板橋區,1135,709,284,993,44,1037,1761,58.89%,40.26%,1
新北市,板橋區,1136,537,297,834,33,867,1499,57.84%,35.82%,1
新北市,板橋區,1137,489,284,773,37,810,1528,53.01%,32%,1
新北市,板橋區,1138,566,307,873,44,917,1536,59.7%,36.85%,1
新北市,板橋區,1139,569,310,879,30,909,1550,58.65%,36.71%,1
新北市,板橋區,1140,708,404,1112,69,1181,2050,57.61%,34.54%,1
新北市,板橋區,1141,486,249,735,37,772,1300,59.38%,37.38%,1
新北市,板橋區,1142,565,233,798,35,833,1537,54.2%,36.76%,1
新北市,板橋區,1143,475,237,712,24,736,1341,54.88%,35.42%,1
新北市,板橋區,1144,551,345,896,22,918,1606,57.16%,34.31%,1
新北市,板橋區,1145,496,247,743,28,771,1433,53.8%,34.61%,1
新北市,板橋區,1146,590,290,880,29,909,1685,53.95%,35.01%,1
新北市,板橋區,1147,486,244,730,44,774,1248,62.02%,38.94%,1
新北市,板橋區,1148,434,198,632,28,660,1172,56.31%,37.03%,1
新北市,板橋區,1149,504,298,802,26,828,1640,50.49%,30.73%,1
新北市,板橋區,1150,543,261,804,26,830,1428,58.12%,38.03%,1
新北市,板橋區,1151,527,312,839,42,881,1527,57.69%,34.51%,1
新北市,板橋區,1152,503,260,763,32,795,1350,58.89%,37.26%,1
新北市,板橋區,1153,574,275,849,45,894,1582,56.51%,36.28%,1
新北市,板橋區,1154,391,185,576,28,604,919,65.72%,42.55%,1
新北市,板橋區,1155,379,167,546,22,568,930,61.08%,40.75%,1
新北市,板橋區,1156,427,183,610,20,630,974,64.68%,43.84%,1
新北市,板橋區,1157,657,314,971,32,1003,1732,57.91%,37.93%,1
新北市,板橋區,1158,499,261,760,35,795,1438,55.29%,34.7%,1
新北市,板橋區,1159,587,334,921,54,975,1777,54.87%,33.03%,1
新北市,板橋區,1160,578,278,856,28,884,1764,50.11%,32.77%,1
新北市,板橋區,1161,483,246,729,20,749,1289,58.11%,37.47%,1
新北市,板橋區,1162,463,209,672,32,704,1182,59.56%,39.17%,1
新北市,板橋區,1163,455,224,679,28,707,1174,60.22%,38.76%,1
新北市,板橋區,1164,622,329,951,60,1011,1870,54.06%,33.26%,1
新北市,板橋區,1165,666,377,1043,36,1079,1842,58.58%,36.16%,1
新北市,板橋區,1166,399,212,611,35,646,1094,59.05%,36.47%,1
新北市,板橋區,1167,431,217,648,31,679,1228,55.29%,35.1%,1
新北市,板橋區,1168,438,212,650,24,674,998,67.54%,43.89%,1
新北市,板橋區,1169,359,197,556,15,571,862,66.24%,41.65%,1
新北市,板橋區,1170,520,294,814,34,848,1622,52.28%,32.06%,1
新北市,板橋區,1171,496,206,702,24,726,1205,60.25%,41.16%,1
新北市,板橋區,1172,575,305,880,41,921,1787,51.54%,32.18%,1
新北市,板橋區,1173,565,331,896,28,924,1610,57.39%,35.09%,1
新北市,板橋區,1174,803,483,1286,32,1318,2216,59.48%,36.24%,1
新北市,板橋區,1175,759,467,1226,44,1270,2294,55.36%,33.09%,1
新北市,板橋區,1176,744,347,1091,50,1141,2090,54.59%,35.6%,1
新北市,板橋區,1177,437,221,658,17,675,1356,49.78%,32.23%,1
新北市,板橋區,1178,402,213,615,29,644,1067,60.36%,37.68%,1
新北市,板橋區,1179,481,245,726,28,754,1319,57.16%,36.47%,1
新北市,板橋區,1180,476,240,716,31,747,1316,56.76%,36.17%,1
新北市,板橋區,1181,427,186,613,40,653,1195,54.64%,35.73%,1
新北市,板橋區,1182,312,174,486,15,501,857,58.46%,36.41%,1
新北市,板橋區,1183,473,257,730,44,774,1417,54.62%,33.38%,1
新北市,板橋區,1184,549,302,851,60,911,1560,58.4%,35.19%,1
新北市,板橋區,1185,599,350,949,59,1008,1747,57.7%,34.29%,1
新北市,板橋區,1186,485,237,722,40,762,1176,64.8%,41.24%,1
新北市,板橋區,1187,397,238,635,19,654,1101,59.4%,36.06%,1
新北市,板橋區,1188,555,287,842,21,863,1458,59.19%,38.07%,1
新北市,板橋區,1189,533,264,797,34,831,1630,50.98%,32.7%,1
新北市,板橋區,1190,537,285,822,66,888,1611,55.12%,33.33%,1
新北市,板橋區,1191,407,197,604,27,631,1139,55.4%,35.73%,1
新北市,板橋區,1192,406,202,608,21,629,1120,56.16%,36.25%,1
新北市,板橋區,1193,391,197,588,66,654,1022,63.99%,38.26%,1
新北市,板橋區,1194,381,210,591,53,644,1049,61.39%,36.32%,1
新北市,板橋區,1195,385,178,563,19,582,1007,57.8%,38.23%,1
新北市,板橋區,1196,521,242,763,31,794,1393,57%,37.4%,1
新北市,板橋區,1197,100,57,157,42,199,474,41.98%,21.1%,1
新北市,板橋區,1198,162,116,278,24,302,500,60.4%,32.4%,1
新北市,板橋區,1199,417,233,650,34,684,1177,58.11%,35.43%,1
新北市,板橋區,1200,466,198,664,30,694,1186,58.52%,39.29%,1
新北市,板橋區,1201,435,236,671,35,706,1139,61.98%,38.19%,1
新北市,板橋區,1202,634,297,931,38,969,1750,55.37%,36.23%,1
新北市,板橋區,1203,787,387,1174,33,1207,3451,34.98%,22.8%,1
新北市,板橋區,1204,569,263,832,46,878,1620,54.2%,35.12%,1
新北市,板橋區,1205,300,156,456,17,473,903,52.38%,33.22%,1
新北市,板橋區,1206,459,232,691,31,722,1232,58.6%,37.26%,1
新北市,板橋區,1207,311,178,489,15,504,975,51.69%,31.9%,1
新北市,板橋區,1208,471,187,658,33,691,1224,56.45%,38.48%,1
新北市,板橋區,1209,484,229,713,32,745,1291,57.71%,37.49%,1
新北市,板橋區,1210,669,322,991,40,1031,1828,56.4%,36.6%,1
新北市,板橋區,1211,537,316,853,34,887,1725,51.42%,31.13%,1
新北市,板橋區,1212,346,193,539,17,556,1085,51.24%,31.89%,1
新北市,板橋區,1213,761,421,1182,52,1234,2357,52.35%,32.29%,1
新北市,板橋區,1214,525,89,614,28,642,1560,41.15%,33.65%,1
新北市,板橋區,1215,623,333,956,32,988,2201,44.89%,28.31%,1
新北市,板橋區,1216,569,275,844,28,872,1626,53.63%,34.99%,1
新北市,板橋區,1217,542,257,799,24,823,1786,46.08%,30.35%,1
新北市,板橋區,1218,625,305,930,36,966,1763,54.79%,35.45%,1
新北市,板橋區,1219,491,311,802,24,826,1744,47.36%,28.15%,1
新北市,板橋區,1220,563,291,854,38,892,1645,54.22%,34.22%,1
新北市,板橋區,1221,604,315,919,18,937,1861,50.35%,32.46%,1
新北市,板橋區,1222,496,251,747,33,780,1596,48.87%,31.08%,1
新北市,板橋區,1223,627,335,962,50,1012,1871,54.09%,33.51%,1
新北市,板橋區,1224,673,342,1015,45,1060,1938,54.7%,34.73%,1
新北市,板橋區,1225,641,340,981,30,1011,1827,55.34%,35.08%,1
新北市,板橋區,1226,471,235,706,17,723,1359,53.2%,34.66%,1
新北市,板橋區,1227,571,287,858,36,894,1613,55.42%,35.4%,1
新北市,板橋區,1228,690,267,957,34,991,1566,63.28%,44.06%,1
新北市,板橋區,1229,602,327,929,31,960,1552,61.86%,38.79%,1
新北市,板橋區,1230,627,360,987,20,1007,1885,53.42%,33.26%,1
新北市,板橋區,1231,611,362,973,34,1007,1893,53.2%,32.28%,1
新北市,三重區,0659,479,302,781,29,810,1509,53.68%,31.74%,1
新北市,三重區,0660,572,304,876,42,918,1591,57.7%,35.95%,1
新北市,三重區,0661,568,335,903,58,961,1653,58.14%,34.36%,1
新北市,三重區,0662,516,266,782,50,832,1392,59.77%,37.07%,1
新北市,三重區,0663,558,287,845,40,885,1451,60.99%,38.46%,1
新北市,三重區,0664,477,250,727,49,776,1329,58.39%,35.89%,1
新北市,三重區,0665,513,297,810,34,844,1459,57.85%,35.16%,1
新北市,三重區,0666,381,211,592,45,637,1024,62.21%,37.21%,1
新北市,三重區,0667,397,206,603,34,637,1066,59.76%,37.24%,1
新北市,三重區,0668,341,186,527,42,569,856,66.47%,39.84%,1
新北市,三重區,0669,253,154,407,30,437,764,57.2%,33.12%,1
新北市,三重區,0670,315,177,492,28,520,821,63.34%,38.37%,1
新北市,三重區,0671,579,370,949,48,997,1887,52.84%,30.68%,1
新北市,三重區,0672,540,315,855,33,888,1646,53.95%,32.81%,1
新北市,三重區,0673,135,80,215,13,228,358,63.69%,37.71%,1
新北市,三重區,0674,366,219,585,39,624,1039,60.06%,35.23%,1
新北市,三重區,0675,388,265,653,26,679,1114,60.95%,34.83%,1
新北市,三重區,0676,568,345,913,31,944,1588,59.45%,35.77%,1
新北市,三重區,0677,590,291,881,28,909,1702,53.41%,34.67%,1
新北市,三重區,0678,573,278,851,40,891,1288,69.18%,44.49%,1
新北市,三重區,0679,608,339,947,37,984,1629,60.41%,37.32%,1
新北市,三重區,0680,652,344,996,48,1044,1861,56.1%,35.03%,1
新北市,三重區,0681,581,390,971,34,1005,1727,58.19%,33.64%,1
新北市,三重區,0682,730,245,975,40,1015,1813,55.98%,40.26%,1
新北市,三重區,0683,560,286,846,46,892,1595,55.92%,35.11%,1
新北市,三重區,0684,555,296,851,45,896,1513,59.22%,36.68%,1
新北市,三重區,0685,483,308,791,34,825,4433,18.61%,10.9%,1
新北市,三重區,0686,490,227,717,32,749,1283,58.38%,38.19%,1
新北市,三重區,0687,546,286,832,41,873,1430,61.05%,38.18%,1
新北市,三重區,0688,509,280,789,24,813,1357,59.91%,37.51%,1
新北市,三重區,0689,357,193,550,24,574,963,59.61%,37.07%,1
新北市,三重區,0690,293,200,493,33,526,883,59.57%,33.18%,1
新北市,三重區,0691,544,259,803,54,857,1494,57.36%,36.41%,1
新北市,三重區,0692,569,310,879,59,938,1616,58.04%,35.21%,1
新北市,三重區,0693,455,279,734,28,762,1329,57.34%,34.24%,1
新北市,三重區,0694,483,287,770,34,804,1289,62.37%,37.47%,1
新北市,三重區,0695,496,268,764,38,802,1380,58.12%,35.94%,1
新北市,三重區,0696,574,359,933,31,964,1668,57.79%,34.41%,1
新北市,三重區,0697,475,251,726,50,776,1226,63.3%,38.74%,1
新北市,三重區,0698,531,289,820,33,853,1421,60.03%,37.37%,1
新北市,三重區,0699,515,265,780,34,814,1364,59.68%,37.76%,1
新北市,三重區,0700,452,238,690,44,734,1232,59.58%,36.69%,1
新北市,三重區,0701,445,295,740,42,782,1248,62.66%,35.66%,1
新北市,三重區,0702,445,388,833,45,878,1256,69.9%,35.43%,1
新北市,三重區,0703,573,331,904,29,933,1506,61.95%,38.05%,1
新北市,三重區,0704,613,351,964,38,1002,1669,60.04%,36.73%,1
新北市,三重區,0705,479,229,708,51,759,1308,58.03%,36.62%,1
新北市,三重區,0706,535,270,805,28,833,1263,65.95%,42.36%,1
新北市,三重區,0707,486,290,776,53,829,1471,56.36%,33.04%,1
新北市,三重區,0708,526,297,823,52,875,1447,60.47%,36.35%,1
新北市,三重區,0709,462,327,789,45,834,1693,49.26%,27.29%,1
新北市,三重區,0710,644,416,1060,35,1095,2015,54.34%,31.96%,1
新北市,三重區,0711,627,278,905,53,958,1812,52.87%,34.6%,1
新北市,三重區,0712,479,301,780,26,806,1509,53.41%,31.74%,1
新北市,三重區,0713,490,289,779,40,819,1439,56.91%,34.05%,1
新北市,三重區,0714,500,286,786,42,828,1437,57.62%,34.79%,1
新北市,三重區,0715,506,357,863,57,920,1697,54.21%,29.82%,1
新北市,三重區,0716,583,320,903,26,929,1793,51.81%,32.52%,1
新北市,三重區,0717,603,347,950,22,972,1603,60.64%,37.62%,1
新北市,三重區,0718,401,218,619,16,635,1166,54.46%,34.39%,1
新北市,三重區,0719,410,225,635,31,666,1126,59.15%,36.41%,1
新北市,三重區,0720,408,206,614,38,652,1291,50.5%,31.6%,1
新北市,三重區,0721,518,328,846,58,904,1597,56.61%,32.44%,1
新北市,三重區,0722,392,222,614,51,665,1081,61.52%,36.26%,1
新北市,三重區,0723,354,200,554,34,588,911,64.54%,38.86%,1
新北市,三重區,0724,518,312,830,30,860,1719,50.03%,30.13%,1
新北市,三重區,0725,436,242,678,48,726,1289,56.32%,33.82%,1
新北市,三重區,0726,501,247,748,56,804,1318,61%,38.01%,1
新北市,三重區,0727,592,322,914,47,961,1822,52.74%,32.49%,1
新北市,三重區,0728,419,209,628,69,697,1185,58.82%,35.36%,1
新北市,三重區,0729,419,249,668,54,722,1369,52.74%,30.61%,1
新北市,三重區,0730,535,279,814,52,866,1507,57.47%,35.5%,1
新北市,三重區,0731,331,179,510,45,555,926,59.94%,35.75%,1
新北市,三重區,0732,331,164,495,16,511,950,53.79%,34.84%,1
新北市,三重區,0733,520,322,842,51,893,1678,53.22%,30.99%,1
新北市,三重區,0734,366,210,576,62,638,1117,57.12%,32.77%,1
新北市,三重區,0735,430,230,660,44,704,1318,53.41%,32.63%,1
新北市,三重區,0736,463,305,768,34,802,1388,57.78%,33.36%,1
新北市,三重區,0737,331,227,558,42,600,1026,58.48%,32.26%,1
新北市,三重區,0738,392,243,635,45,680,1096,62.04%,35.77%,1
新北市,三重區,0739,357,188,545,28,573,967,59.26%,36.92%,1
新北市,三重區,0740,595,355,950,40,990,1871,52.91%,31.8%,1
新北市,三重區,0741,554,322,876,61,937,1663,56.34%,33.31%,1
新北市,三重區,0742,449,210,659,25,684,1208,56.62%,37.17%,1
新北市,三重區,0743,417,288,705,39,744,1398,53.22%,29.83%,1
新北市,三重區,0744,363,209,572,19,591,1078,54.82%,33.67%,1
新北市,三重區,0745,383,189,572,41,613,1102,55.63%,34.75%,1
新北市,三重區,0746,415,296,711,56,767,1393,55.06%,29.79%,1
新北市,三重區,0747,448,250,698,45,743,1251,59.39%,35.81%,1
新北市,三重區,0748,500,252,752,38,790,1234,64.02%,40.52%,1
新北市,三重區,0749,583,337,920,39,959,1661,57.74%,35.1%,1
新北市,三重區,0750,565,301,866,45,911,1590,57.3%,35.53%,1
新北市,三重區,0751,426,241,667,39,706,1182,59.73%,36.04%,1
新北市,三重區,0752,493,277,770,48,818,1369,59.75%,36.01%,1
新北市,三重區,0753,456,257,713,45,758,1222,62.03%,37.32%,1
新北市,三重區,0754,483,242,725,64,789,1304,60.51%,37.04%,1
新北市,三重區,0755,363,177,540,31,571,1054,54.17%,34.44%,1
新北市,三重區,0756,565,297,862,63,925,1635,56.57%,34.56%,1
新北市,三重區,0757,583,315,898,39,937,1779,52.67%,32.77%,1
新北市,三重區,0758,555,327,882,53,935,1633,57.26%,33.99%,1
新北市,三重區,0759,403,216,619,27,646,1107,58.36%,36.4%,1
新北市,三重區,0760,414,198,612,34,646,1021,63.27%,40.55%,1
新北市,三重區,0761,502,286,788,67,855,1649,51.85%,30.44%,1
新北市,三重區,0762,313,155,468,30,498,874,56.98%,35.81%,1
新北市,三重區,0763,484,269,753,68,821,1402,58.56%,34.52%,1
新北市,三重區,0764,539,280,819,54,873,1713,50.96%,31.47%,1
新北市,三重區,0765,301,165,466,25,491,973,50.46%,30.94%,1
新北市,三重區,0766,369,211,580,36,616,1038,59.34%,35.55%,1
新北市,三重區,0767,556,302,858,91,949,1833,51.77%,30.33%,1
新北市,三重區,0768,255,182,437,28,465,817,56.92%,31.21%,1
新北市,三重區,0769,504,276,780,45,825,1387,59.48%,36.34%,1
新北市,三重區,0770,292,168,460,26,486,784,61.99%,37.24%,1
新北市,三重區,0771,363,200,563,35,598,1096,54.56%,33.12%,1
新北市,三重區,0772,409,225,634,54,688,1163,59.16%,35.17%,1
新北市,三重區,0773,607,331,938,46,984,1868,52.68%,32.49%,1
新北市,三重區,0774,379,187,566,50,616,1117,55.15%,33.93%,1
新北市,三重區,0775,305,164,469,28,497,934,53.21%,32.66%,1
新北市,三重區,0776,448,252,700,45,745,1412,52.76%,31.73%,1
新北市,三重區,0777,418,226,644,33,677,1062,63.75%,39.36%,1
新北市,三重區,0778,312,148,460,51,511,891,57.35%,35.02%,1
新北市,三重區,0779,370,209,579,69,648,936,69.23%,39.53%,1
新北市,三重區,0780,383,168,551,52,603,1085,55.58%,35.3%,1
新北市,三重區,0781,307,214,521,22,543,1065,50.99%,28.83%,1
新北市,三重區,0782,485,272,757,45,802,1398,57.37%,34.69%,1
新北市,三重區,0783,570,273,843,35,878,1550,56.65%,36.77%,1
新北市,三重區,0784,554,300,854,56,910,1674,54.36%,33.09%,1
新北市,三重區,0785,549,212,761,50,811,1215,66.75%,45.19%,1
新北市,三重區,0786,529,309,838,47,885,1606,55.11%,32.94%,1
新北市,三重區,0787,399,230,629,41,670,1182,56.68%,33.76%,1
新北市,三重區,0788,421,252,673,60,733,1238,59.21%,34.01%,1
新北市,三重區,0789,451,293,744,54,798,1342,59.46%,33.61%,1
新北市,三重區,0790,500,281,781,41,822,1408,58.38%,35.51%,1
新北市,三重區,0791,596,329,925,70,995,1770,56.21%,33.67%,1
新北市,三重區,0792,299,204,503,49,552,940,58.72%,31.81%,1
新北市,三重區,0793,329,193,522,22,544,975,55.79%,33.74%,1
新北市,三重區,0794,489,283,772,33,805,1507,53.42%,32.45%,1
新北市,三重區,0795,482,280,762,51,813,1419,57.29%,33.97%,1
新北市,三重區,0796,447,229,676,42,718,1257,57.12%,35.56%,1
新北市,三重區,0797,568,302,870,46,916,1619,56.58%,35.08%,1
新北市,三重區,0798,610,287,897,52,949,1745,54.38%,34.96%,1
新北市,三重區,0799,509,290,799,59,858,1519,56.48%,33.51%,1
新北市,三重區,0800,543,294,837,52,889,1682,52.85%,32.28%,1
新北市,三重區,0801,618,332,950,50,1000,1697,58.93%,36.42%,1
新北市,三重區,0802,353,189,542,38,580,1073,54.05%,32.9%,1
新北市,三重區,0803,322,158,480,30,510,924,55.19%,34.85%,1
新北市,三重區,0804,519,249,768,38,806,1613,49.97%,32.18%,1
新北市,三重區,0805,358,166,524,28,552,1034,53.38%,34.62%,1
新北市,三重區,0806,412,198,610,45,655,1118,58.59%,36.85%,1
新北市,三重區,0807,451,231,682,49,731,1269,57.6%,35.54%,1
新北市,三重區,0808,344,171,515,40,555,990,56.06%,34.75%,1
新北市,三重區,0809,491,228,719,45,764,1336,57.19%,36.75%,1
新北市,三重區,0810,584,285,869,37,906,1601,56.59%,36.48%,1
新北市,三重區,0811,622,296,918,43,961,1581,60.78%,39.34%,1
新北市,三重區,0812,474,264,738,42,780,1345,57.99%,35.24%,1
新北市,三重區,0813,457,254,711,41,752,1226,61.34%,37.28%,1
新北市,三重區,0814,524,274,798,67,865,1650,52.42%,31.76%,1
新北市,三重區,0815,413,209,622,36,658,1140,57.72%,36.23%,1
新北市,三重區,0816,533,279,812,40,852,1639,51.98%,32.52%,1
新北市,三重區,0817,600,307,907,47,954,1699,56.15%,35.31%,1
新北市,三重區,0818,611,331,942,52,994,1501,66.22%,40.71%,1
新北市,三重區,0819,550,285,835,35,870,1538,56.57%,35.76%,1
新北市,三重區,0820,503,287,790,57,847,1540,55%,32.66%,1
新北市,三重區,0821,454,220,674,43,717,1276,56.19%,35.58%,1
新北市,三重區,0822,497,278,775,52,827,1539,53.74%,32.29%,1
新北市,三重區,0823,422,253,675,29,704,1170,60.17%,36.07%,1
新北市,三重區,0824,367,238,605,33,638,1120,56.96%,32.77%,1
新北市,三重區,0825,605,357,962,51,1013,1789,56.62%,33.82%,1
新北市,三重區,0826,360,400,760,55,815,1520,53.62%,23.68%,1
新北市,三重區,0827,614,346,960,57,1017,1821,55.85%,33.72%,1
新北市,三重區,0828,453,292,745,54,799,1407,56.79%,32.2%,1
新北市,三重區,0829,505,279,784,48,832,1491,55.8%,33.87%,1
新北市,三重區,0830,503,282,785,48,833,1381,60.32%,36.42%,1
新北市,三重區,0831,430,238,668,45,713,1222,58.35%,35.19%,1
新北市,三重區,0832,638,356,994,41,1035,1938,53.41%,32.92%,1
新北市,三重區,0833,600,285,885,31,916,1639,55.89%,36.61%,1
新北市,三重區,0834,534,319,853,59,912,1614,56.51%,33.09%,1
新北市,三重區,0835,589,305,894,47,941,1709,55.06%,34.46%,1
新北市,三重區,0836,586,281,867,60,927,1753,52.88%,33.43%,1
新北市,三重區,0837,494,274,768,52,820,1398,58.66%,35.34%,1
新北市,三重區,0838,549,333,882,46,928,1706,54.4%,32.18%,1
新北市,三重區,0839,558,320,878,47,925,1614,57.31%,34.57%,1
新北市,三重區,0840,540,310,850,60,910,1591,57.2%,33.94%,1
新北市,三重區,0841,558,325,883,41,924,1627,56.79%,34.3%,1
新北市,三重區,0842,515,288,803,65,868,1505,57.67%,34.22%,1
新北市,三重區,0843,456,263,719,42,761,1331,57.18%,34.26%,1
新北市,三重區,0844,515,286,801,41,842,1678,50.18%,30.69%,1
新北市,三重區,0845,495,318,813,34,847,1498,56.54%,33.04%,1
新北市,三重區,0846,632,384,1016,43,1059,1800,58.83%,35.11%,1
新北市,三重區,0847,514,295,809,34,843,1703,49.5%,30.18%,1
新北市,三重區,0848,605,342,947,40,987,1975,49.97%,30.63%,1
新北市,三重區,0849,632,313,945,38,983,1894,51.9%,33.37%,1
新北市,三重區,0850,503,282,785,38,823,1405,58.58%,35.8%,1
新北市,三重區,0851,468,255,723,29,752,1293,58.16%,36.19%,1
新北市,三重區,0852,422,273,695,32,727,1259,57.74%,33.52%,1
新北市,三重區,0853,440,226,666,45,711,1144,62.15%,38.46%,1
新北市,三重區,0854,448,269,717,48,765,1254,61%,35.73%,1
新北市,三重區,0855,452,264,716,35,751,1313,57.2%,34.42%,1
新北市,三重區,0856,491,326,817,56,873,1594,54.77%,30.8%,1
新北市,三重區,0857,601,317,918,51,969,1775,54.59%,33.86%,1
新北市,三重區,0858,524,259,783,66,849,1516,56%,34.56%,1
新北市,三重區,0859,506,270,776,58,834,1315,63.42%,38.48%,1
新北市,三重區,0860,295,178,473,48,521,843,61.8%,34.99%,1
新北市,三重區,0861,380,187,567,42,609,1160,52.5%,32.76%,1
新北市,三重區,0862,408,173,581,39,620,1052,58.94%,38.78%,1
新北市,三重區,0863,406,225,631,32,663,1054,62.9%,38.52%,1
新北市,三重區,0864,359,197,556,43,599,997,60.08%,36.01%,1
新北市,三重區,0865,304,178,482,32,514,936,54.91%,32.48%,1
新北市,三重區,0866,565,293,858,53,911,1658,54.95%,34.08%,1
新北市,三重區,0867,495,284,779,41,820,1496,54.81%,33.09%,1
新北市,三重區,0868,405,223,628,31,659,1064,61.94%,38.06%,1
新北市,三重區,0869,450,216,666,38,704,1152,61.11%,39.06%,1
新北市,三重區,0870,495,274,769,44,813,1532,53.07%,32.31%,1
新北市,三重區,0871,439,201,640,31,671,1338,50.15%,32.81%,1
新北市,三重區,0872,457,249,706,46,752,1303,57.71%,35.07%,1
新北市,三重區,0873,505,258,763,54,817,1369,59.68%,36.89%,1
新北市,三重區,0874,525,263,788,46,834,1491,55.94%,35.21%,1
新北市,三重區,0875,585,305,890,58,948,1821,52.06%,32.13%,1
新北市,三重區,0876,616,309,925,39,964,1906,50.58%,32.32%,1
新北市,三重區,0877,656,350,1006,36,1042,1842,56.57%,35.61%,1
新北市,三重區,0878,289,152,441,35,476,878,54.21%,32.92%,1
新北市,三重區,0879,360,218,578,42,620,963,64.38%,37.38%,1
新北市,三重區,0880,425,246,671,26,697,1381,50.47%,30.77%,1
新北市,三重區,0881,494,279,773,67,840,1681,49.97%,29.39%,1
新北市,三重區,0882,479,302,781,34,815,1548,52.65%,30.94%,1
新北市,三重區,0883,505,346,851,43,894,1542,57.98%,32.75%,1
新北市,三重區,0884,510,311,821,49,870,1557,55.88%,32.76%,1
新北市,三重區,0885,552,311,863,39,902,1661,54.3%,33.23%,1
新北市,三重區,0886,696,373,1069,18,1087,2024,53.71%,34.39%,1
新北市,三重區,0887,470,289,759,41,800,1588,50.38%,29.6%,1
新北市,三重區,0888,547,303,850,69,919,1706,53.87%,32.06%,1
新北市,三重區,0889,485,268,753,36,789,1341,58.84%,36.17%,1
新北市,三重區,0890,371,170,541,40,581,1025,56.68%,36.2%,1
新北市,三重區,0891,465,254,719,43,762,1339,56.91%,34.73%,1
新北市,三重區,0892,585,294,879,69,948,1725,54.96%,33.91%,1
新北市,三重區,0893,582,345,927,65,992,1826,54.33%,31.87%,1
新北市,中和區,1232,506,294,800,44,844,1630,51.78%,31.04%,1
新北市,中和區,1233,607,340,947,44,991,1775,55.83%,34.2%,1
新北市,中和區,1234,603,314,917,23,940,1844,50.98%,32.7%,1
新北市,中和區,1235,398,229,627,15,642,1019,63%,39.06%,1
新北市,中和區,1236,461,208,669,23,692,1138,60.81%,40.51%,1
新北市,中和區,1237,638,300,938,34,972,1878,51.76%,33.97%,1
新北市,中和區,1238,825,273,1098,33,1131,1980,57.12%,41.67%,1
新北市,中和區,1239,652,333,985,44,1029,1844,55.8%,35.36%,1
新北市,中和區,1240,734,395,1129,14,1143,2085,54.82%,35.2%,1
新北市,中和區,1241,561,236,797,36,833,1498,55.61%,37.45%,1
新北市,中和區,1242,605,333,938,28,966,1761,54.86%,34.36%,1
新北市,中和區,1243,418,240,658,28,686,1254,54.7%,33.33%,1
新北市,中和區,1244,505,259,764,27,791,1343,58.9%,37.6%,1
新北市,中和區,1245,609,365,974,26,1000,1789,55.9%,34.04%,1
新北市,中和區,1246,658,428,1086,31,1117,2000,55.85%,32.9%,1
新北市,中和區,1247,557,382,939,37,976,1953,49.97%,28.52%,1
新北市,中和區,1248,584,331,915,47,962,1712,56.19%,34.11%,1
新北市,中和區,1249,615,254,869,41,910,1582,57.52%,38.87%,1
新北市,中和區,1250,615,306,921,47,968,1742,55.57%,35.3%,1
新北市,中和區,1251,578,304,882,42,924,1493,61.89%,38.71%,1
新北市,中和區,1252,451,234,685,27,712,1352,52.66%,33.36%,1
新北市,中和區,1253,505,208,713,27,740,1244,59.49%,40.59%,1
新北市,中和區,1254,511,255,766,47,813,1394,58.32%,36.66%,1
新北市,中和區,1255,527,326,853,24,877,1917,45.75%,27.49%,1
新北市,中和區,1256,601,315,916,48,964,1830,52.68%,32.84%,1
新北市,中和區,1257,409,226,635,28,663,1124,58.99%,36.39%,1
新北市,中和區,1258,448,245,693,34,727,1412,51.49%,31.73%,1
新北市,中和區,1259,473,243,716,36,752,1356,55.46%,34.88%,1
新北市,中和區,1260,496,236,732,19,751,1425,52.7%,34.81%,1
新北市,中和區,1261,485,241,726,34,760,1259,60.37%,38.52%,1
新北市,中和區,1262,454,241,695,41,736,1256,58.6%,36.15%,1
新北市,中和區,1263,526,250,776,25,801,1423,56.29%,36.96%,1
新北市,中和區,1264,459,228,687,35,722,1221,59.13%,37.59%,1
新北市,中和區,1265,574,333,907,43,950,1858,51.13%,30.89%,1
新北市,中和區,1266,581,338,919,33,952,1804,52.77%,32.21%,1
新北市,中和區,1267,590,353,943,23,966,1669,57.88%,35.35%,1
新北市,中和區,1268,546,267,813,26,839,1485,56.5%,36.77%,1
新北市,中和區,1269,389,189,578,32,610,1005,60.7%,38.71%,1
新北市,中和區,1270,437,267,704,41,745,1175,63.4%,37.19%,1
新北市,中和區,1271,441,223,664,28,692,1171,59.09%,37.66%,1
新北市,中和區,1272,568,286,854,36,890,1746,50.97%,32.53%,1
新北市,中和區,1273,479,273,752,24,776,1555,49.9%,30.8%,1
新北市,中和區,1274,385,209,594,40,634,1112,57.01%,34.62%,1
新北市,中和區,1275,658,364,1022,38,1060,1780,59.55%,36.97%,1
新北市,中和區,1276,664,375,1039,23,1062,1918,55.37%,34.62%,1
新北市,中和區,1277,479,259,738,27,765,1689,45.29%,28.36%,1
新北市,中和區,1278,629,360,989,22,1011,1781,56.77%,35.32%,1
新北市,中和區,1279,506,269,775,28,803,1419,56.59%,35.66%,1
新北市,中和區,1280,469,236,705,27,732,1344,54.46%,34.9%,1
新北市,中和區,1281,709,369,1078,49,1127,1804,62.47%,39.3%,1
新北市,中和區,1282,572,333,905,56,961,1788,53.75%,31.99%,1
新北市,中和區,1283,637,341,978,29,1007,1793,56.16%,35.53%,1
新北市,中和區,1284,485,258,743,36,779,1352,57.62%,35.87%,1
新北市,中和區,1285,649,353,1002,39,1041,1813,57.42%,35.8%,1
新北市,中和區,1286,525,268,793,21,814,1288,63.2%,40.76%,1
新北市,中和區,1287,415,229,644,41,685,1186,57.76%,34.99%,1
新北市,中和區,1288,469,199,668,13,681,1237,55.05%,37.91%,1
新北市,中和區,1289,519,246,765,35,800,1406,56.9%,36.91%,1
新北市,中和區,1290,499,272,771,36,807,1442,55.96%,34.6%,1
新北市,中和區,1291,385,230,615,30,645,1040,62.02%,37.02%,1
新北市,中和區,1292,515,233,748,36,784,1292,60.68%,39.86%,1
新北市,中和區,1293,653,304,957,37,994,1811,54.89%,36.06%,1
新北市,中和區,1294,696,309,1005,50,1055,1789,58.97%,38.9%,1
新北市,中和區,1295,378,154,532,27,559,859,65.08%,44%,1
新北市,中和區,1296,437,166,603,23,626,972,64.4%,44.96%,1
新北市,中和區,1297,497,256,753,22,775,1346,57.58%,36.92%,1
新北市,中和區,1298,385,212,597,27,624,1034,60.35%,37.23%,1
新北市,中和區,1299,512,259,771,35,806,1387,58.11%,36.91%,1
新北市,中和區,1300,750,367,1117,64,1181,2067,57.14%,36.28%,1
新北市,中和區,1301,494,285,779,26,805,1670,48.2%,29.58%,1
新北市,中和區,1302,459,177,636,27,663,1166,56.86%,39.37%,1
新北市,中和區,1303,371,175,546,28,574,963,59.61%,38.53%,1
新北市,中和區,1304,384,164,548,33,581,1070,54.3%,35.89%,1
新北市,中和區,1305,465,214,679,29,708,1319,53.68%,35.25%,1
新北市,中和區,1306,566,272,838,40,878,1438,61.06%,39.36%,1
新北市,中和區,1307,632,288,920,18,938,1808,51.88%,34.96%,1
新北市,中和區,1308,451,173,624,15,639,1191,53.65%,37.87%,1
新北市,中和區,1309,617,250,867,41,908,1632,55.64%,37.81%,1
新北市,中和區,1310,599,278,877,28,905,1765,51.27%,33.94%,1
新北市,中和區,1311,487,188,675,26,701,1168,60.02%,41.7%,1
新北市,中和區,1312,460,175,635,24,659,1176,56.04%,39.12%,1
新北市,中和區,1313,674,279,953,40,993,1565,63.45%,43.07%,1
新北市,中和區,1314,538,228,766,42,808,1578,51.2%,34.09%,1
新北市,中和區,1315,701,379,1080,29,1109,2029,54.66%,34.55%,1
新北市,中和區,1316,327,169,496,29,525,905,58.01%,36.13%,1
新北市,中和區,1317,303,116,419,24,443,839,52.8%,36.11%,1
新北市,中和區,1318,296,142,438,16,454,762,59.58%,38.85%,1
新北市,中和區,1319,536,230,766,38,804,1420,56.62%,37.75%,1
新北市,中和區,1320,453,203,656,42,698,1272,54.87%,35.61%,1
新北市,中和區,1321,674,312,986,51,1037,1976,52.48%,34.11%,1
新北市,中和區,1322,636,298,934,29,963,1779,54.13%,35.75%,1
新北市,中和區,1323,439,228,667,21,688,1454,47.32%,30.19%,1
新北市,中和區,1324,505,198,703,31,734,1374,53.42%,36.75%,1
新北市,中和區,1325,455,220,675,23,698,1369,50.99%,33.24%,1
新北市,中和區,1326,536,267,803,29,832,1501,55.43%,35.71%,1
新北市,中和區,1327,407,170,577,26,603,920,65.54%,44.24%,1
新北市,中和區,1328,439,183,622,34,656,1050,62.48%,41.81%,1
新北市,中和區,1329,128,51,179,18,197,321,61.37%,39.88%,1
新北市,中和區,1330,513,225,738,50,788,1474,53.46%,34.8%,1
新北市,中和區,1331,531,251,782,57,839,1461,57.43%,36.34%,1
新北市,中和區,1332,568,276,844,39,883,1621,54.47%,35.04%,1
新北市,中和區,1333,532,247,779,44,823,1327,62.02%,40.09%,1
新北市,中和區,1334,314,121,435,18,453,775,58.45%,40.52%,1
新北市,中和區,1335,610,335,945,23,968,1916,50.52%,31.84%,1
新北市,中和區,1336,602,303,905,54,959,1901,50.45%,31.67%,1
新北市,中和區,1337,515,254,769,30,799,4411,18.11%,11.68%,1
新北市,中和區,1338,450,200,650,30,680,1212,56.11%,37.13%,1
新北市,中和區,1339,428,205,633,14,647,1126,57.46%,38.01%,1
新北市,中和區,1340,548,257,805,24,829,1507,55.01%,36.36%,1
新北市,中和區,1341,546,288,834,19,853,1519,56.16%,35.94%,1
新北市,中和區,1342,534,283,817,27,844,1467,57.53%,36.4%,1
新北市,中和區,1343,574,269,843,45,888,1453,61.11%,39.5%,1
新北市,中和區,1344,532,264,796,30,826,1364,60.56%,39%,1
新北市,中和區,1345,472,237,709,29,738,1302,56.68%,36.25%,1
新北市,中和區,1346,491,229,720,28,748,1627,45.97%,30.18%,1
新北市,中和區,1347,530,255,785,27,812,1503,54.03%,35.26%,1
新北市,中和區,1348,517,226,743,18,761,1392,54.67%,37.14%,1
新北市,中和區,1349,409,205,614,24,638,1067,59.79%,38.33%,1
新北市,中和區,1350,561,273,834,28,862,1623,53.11%,34.57%,1
新北市,中和區,1351,435,257,692,14,706,1208,58.44%,36.01%,1
新北市,中和區,1352,588,278,866,26,892,1991,44.8%,29.53%,1
新北市,中和區,1353,596,288,884,23,907,1932,46.95%,30.85%,1
新北市,中和區,1354,385,220,605,11,616,947,65.05%,40.65%,1
新北市,中和區,1355,626,298,924,36,960,1660,57.83%,37.71%,1
新北市,中和區,1356,530,228,758,28,786,1574,49.94%,33.67%,1
新北市,中和區,1357,797,250,1047,39,1086,2136,50.84%,37.31%,1
新北市,中和區,1358,495,242,737,50,787,1462,53.83%,33.86%,1
新北市,中和區,1359,549,229,778,40,818,1548,52.84%,35.47%,1
新北市,中和區,1360,303,137,440,17,457,692,66.04%,43.79%,1
新北市,中和區,1361,485,248,733,35,768,1221,62.9%,39.72%,1
新北市,中和區,1362,477,274,751,37,788,1331,59.2%,35.84%,1
新北市,中和區,1363,413,193,606,24,630,984,64.02%,41.97%,1
新北市,中和區,1364,607,310,917,29,946,1871,50.56%,32.44%,1
新北市,中和區,1365,483,224,707,3,710,1279,55.51%,37.76%,1
新北市,中和區,1366,585,314,899,27,926,1629,56.84%,35.91%,1
新北市,中和區,1367,519,307,826,24,850,1482,57.35%,35.02%,1
新北市,中和區,1368,655,304,959,42,1001,1715,58.37%,38.19%,1
新北市,中和區,1369,753,296,1049,48,1097,1952,56.2%,38.58%,1
新北市,中和區,1370,228,152,380,23,403,686,58.75%,33.24%,1
新北市,中和區,1371,457,303,760,23,783,1577,49.65%,28.98%,1
新北市,中和區,1372,433,232,665,24,689,1158,59.5%,37.39%,1
新北市,中和區,1373,481,254,735,19,754,1195,63.1%,40.25%,1
新北市,中和區,1374,441,214,655,20,675,1054,64.04%,41.84%,1
新北市,中和區,1375,255,126,381,18,399,612,65.2%,41.67%,1
新北市,中和區,1376,632,313,945,20,965,1668,57.85%,37.89%,1
新北市,中和區,1377,443,208,651,35,686,1071,64.05%,41.36%,1
新北市,中和區,1378,521,257,778,24,802,1169,68.61%,44.57%,1
新北市,中和區,1379,505,229,734,26,760,1370,55.47%,36.86%,1
新北市,中和區,1380,608,304,912,40,952,1574,60.48%,38.63%,1
新北市,中和區,1381,987,174,1161,20,1181,2614,45.18%,37.76%,1
新北市,中和區,1382,571,282,853,22,875,1477,59.24%,38.66%,1
新北市,中和區,1383,363,210,573,38,611,1041,58.69%,34.87%,1
新北市,中和區,1384,522,252,774,49,823,1538,53.51%,33.94%,1
新北市,中和區,1385,585,278,863,31,894,1599,55.91%,36.59%,1
新北市,中和區,1386,605,283,888,39,927,1586,58.45%,38.15%,1
新北市,中和區,1387,658,345,1003,41,1044,1726,60.49%,38.12%,1
新北市,中和區,1388,680,416,1096,41,1137,1854,61.33%,36.68%,1
新北市,中和區,1389,589,273,862,38,900,1472,61.14%,40.01%,1
新北市,中和區,1390,574,263,837,37,874,1430,61.12%,40.14%,1
新北市,中和區,1391,539,309,848,44,892,1488,59.95%,36.22%,1
新北市,中和區,1392,434,251,685,26,711,1251,56.83%,34.69%,1
新北市,中和區,1393,572,259,831,32,863,1487,58.04%,38.47%,1
新北市,中和區,1394,452,240,692,52,744,1328,56.02%,34.04%,1
新北市,中和區,1395,435,237,672,26,698,1128,61.88%,38.56%,1
新北市,中和區,1396,459,184,643,25,668,1008,66.27%,45.54%,1
新北市,中和區,1397,659,342,1001,30,1031,1786,57.73%,36.9%,1
新北市,中和區,1398,751,412,1163,38,1201,2219,54.12%,33.84%,1
新北市,中和區,1399,475,215,690,31,721,1322,54.54%,35.93%,1
新北市,中和區,1400,606,265,871,12,883,1495,59.06%,40.54%,1
新北市,中和區,1401,513,237,750,41,791,1414,55.94%,36.28%,1
新北市,中和區,1402,655,275,930,50,980,1681,58.3%,38.96%,1
新北市,中和區,1403,471,267,738,44,782,1361,57.46%,34.61%,1
新北市,中和區,1404,522,256,778,31,809,1442,56.1%,36.2%,1
新北市,中和區,1405,409,319,728,24,752,1383,54.37%,29.57%,1
新北市,中和區,1406,451,213,664,30,694,1264,54.91%,35.68%,1
新北市,中和區,1407,715,321,1036,53,1089,1810,60.17%,39.5%,1
新北市,中和區,1408,508,321,829,29,858,1951,43.98%,26.04%,1
新北市,中和區,1409,549,244,793,29,822,1582,51.96%,34.7%,1
新北市,中和區,1410,742,363,1105,47,1152,1945,59.23%,38.15%,1
新北市,中和區,1411,525,248,773,41,814,1390,58.56%,37.77%,1
新北市,中和區,1412,424,232,656,17,673,1161,57.97%,36.52%,1
新北市,中和區,1413,578,185,763,27,790,1399,56.47%,41.32%,1
新北市,中和區,1414,403,188,591,21,612,1070,57.2%,37.66%,1
新北市,中和區,1415,448,201,649,25,674,1169,57.66%,38.32%,1
新北市,中和區,1416,508,223,731,39,770,1214,63.43%,41.85%,1
新北市,中和區,1417,525,262,787,39,826,1398,59.08%,37.55%,1
新北市,中和區,1418,387,209,596,19,615,1049,58.63%,36.89%,1
新北市,中和區,1419,534,259,793,38,831,1324,62.76%,40.33%,1
新北市,中和區,1420,542,303,845,25,870,1765,49.29%,30.71%,1
新北市,中和區,1421,553,304,857,41,898,1709,52.55%,32.36%,1
新北市,中和區,1422,446,210,656,40,696,1186,58.68%,37.61%,1
新北市,中和區,1423,535,229,764,27,791,1318,60.02%,40.59%,1
新北市,中和區,1424,493,323,816,26,842,1430,58.88%,34.48%,1
新北市,中和區,1425,446,252,698,32,730,1637,44.59%,27.24%,1
新北市,中和區,1426,460,251,711,37,748,1283,58.3%,35.85%,1
新北市,中和區,1427,475,249,724,37,761,1310,58.09%,36.26%,1
新北市,中和區,1428,488,248,736,32,768,1301,59.03%,37.51%,1
新北市,中和區,1429,600,311,911,36,947,1681,56.34%,35.69%,1
新北市,中和區,1430,523,270,793,24,817,1384,59.03%,37.79%,1
新北市,中和區,1431,428,232,660,26,686,1187,57.79%,36.06%,1
新北市,中和區,1432,529,272,801,6,807,1779,45.36%,29.74%,1
新北市,中和區,1433,655,290,945,31,976,1712,57.01%,38.26%,1
新北市,中和區,1434,481,276,757,39,796,1462,54.45%,32.9%,1
新北市,中和區,1435,607,340,947,23,970,1824,53.18%,33.28%,1
新北市,中和區,1436,455,287,742,36,778,1389,56.01%,32.76%,1
新北市,中和區,1437,550,275,825,30,855,1434,59.62%,38.35%,1
新北市,中和區,1438,705,308,1013,43,1056,1953,54.07%,36.1%,1
新北市,中和區,1439,679,396,1075,50,1125,2002,56.19%,33.92%,1
新北市,中和區,1440,688,289,977,29,1006,1858,54.14%,37.03%,1
新北市,中和區,1441,640,313,953,23,976,1801,54.19%,35.54%,1
新北市,中和區,1442,643,300,943,35,978,1691,57.84%,38.02%,1
新北市,中和區,1443,515,274,789,27,816,1363,59.87%,37.78%,1
新北市,中和區,1444,522,235,757,20,777,1220,63.69%,42.79%,1
新北市,中和區,1445,578,275,853,18,871,1365,63.81%,42.34%,1
新北市,中和區,1446,455,216,671,20,691,1178,58.66%,38.62%,1
新北市,中和區,1447,342,152,494,16,510,830,61.45%,41.2%,1
新北市,中和區,1448,403,198,601,29,630,1197,52.63%,33.67%,1
新北市,中和區,1449,537,225,762,44,806,1369,58.88%,39.23%,1
新北市,中和區,1450,535,244,779,25,804,1336,60.18%,40.04%,1
新北市,中和區,1451,572,257,829,37,866,1377,62.89%,41.54%,1
新北市,中和區,1452,580,267,847,36,883,1499,58.91%,38.69%,1
新北市,中和區,1453,661,312,973,33,1006,1689,59.56%,39.14%,1
新北市,中和區,1454,491,277,768,37,805,1323,60.85%,37.11%,1
新北市,中和區,1455,426,216,642,34,676,1079,62.65%,39.48%,1
新北市,中和區,1456,577,296,873,30,903,1545,58.45%,37.35%,1
新北市,中和區,1457,444,274,718,32,750,1326,56.56%,33.48%,1
新北市,中和區,1458,478,283,761,36,797,1443,55.23%,33.13%,1
新北市,中和區,1459,641,290,931,29,960,1712,56.07%,37.44%,1
新北市,中和區,1460,680,329,1009,37,1046,1916,54.59%,35.49%,1
新北市,中和區,1461,356,163,519,22,541,863,62.69%,41.25%,1
新北市,中和區,1462,479,258,737,7,744,1203,61.85%,39.82%,1
新北市,中和區,1463,525,256,781,25,806,1483,54.35%,35.4%,1
新北市,中和區,1464,578,242,820,29,849,1575,53.9%,36.7%,1
新北市,中和區,1465,496,190,686,35,721,1432,50.35%,34.64%,1
新北市,中和區,1466,526,245,771,42,813,1441,56.42%,36.5%,1
新北市,中和區,1467,486,231,717,38,755,1269,59.5%,38.3%,1
新北市,中和區,1468,533,255,788,23,811,1363,59.5%,39.1%,1
新北市,中和區,1469,453,169,622,17,639,1089,58.68%,41.6%,1
新北市,中和區,1470,391,226,617,19,636,1171,54.31%,33.39%,1
新北市,中和區,1471,473,185,658,34,692,1150,60.17%,41.13%,1
新北市,中和區,1472,472,329,801,43,844,1154,73.14%,40.9%,1
新北市,中和區,1473,479,164,643,21,664,1067,62.23%,44.89%,1
新北市,中和區,1474,544,258,802,25,827,1526,54.19%,35.65%,1
新北市,中和區,1475,544,286,830,20,850,1447,58.74%,37.6%,1
新北市,永和區,1476,540,334,874,49,923,1554,59.4%,34.75%,1
新北市,永和區,1477,422,189,611,26,637,1065,59.81%,39.62%,1
新北市,永和區,1478,357,160,517,28,545,854,63.82%,41.8%,1
新北市,永和區,1479,484,234,718,42,760,1253,60.65%,38.63%,1
新北市,永和區,1480,608,356,964,27,991,1733,57.18%,35.08%,1
新北市,永和區,1481,575,287,862,37,899,1581,56.86%,36.37%,1
新北市,永和區,1482,685,246,931,39,970,1735,55.91%,39.48%,1
新北市,永和區,1483,565,259,824,21,845,1563,54.06%,36.15%,1
新北市,永和區,1484,610,340,950,39,989,1650,59.94%,36.97%,1
新北市,永和區,1485,524,276,800,30,830,1454,57.08%,36.04%,1
新北市,永和區,1486,512,308,820,29,849,1568,54.15%,32.65%,1
新北市,永和區,1487,520,248,768,34,802,1444,55.54%,36.01%,1
新北市,永和區,1488,380,233,613,33,646,1140,56.67%,33.33%,1
新北市,永和區,1489,498,209,707,30,737,1188,62.04%,41.92%,1
新北市,永和區,1490,531,260,791,44,835,1516,55.08%,35.03%,1
新北市,永和區,1491,499,244,743,36,779,1397,55.76%,35.72%,1
新北市,永和區,1492,516,268,784,32,816,1438,56.75%,35.88%,1
新北市,永和區,1493,435,203,638,16,654,1084,60.33%,40.13%,1
新北市,永和區,1494,358,172,530,20,550,941,58.45%,38.04%,1
新北市,永和區,1495,565,289,854,22,876,1598,54.82%,35.36%,1
新北市,永和區,1496,548,300,848,25,873,2842,30.72%,19.28%,1
新北市,永和區,1497,485,280,765,28,793,1261,62.89%,38.46%,1
新北市,永和區,1498,586,308,894,35,929,1449,64.11%,40.44%,1
新北市,永和區,1499,503,355,858,28,886,1511,58.64%,33.29%,1
新北市,永和區,1500,605,295,900,27,927,1470,63.06%,41.16%,1
新北市,永和區,1501,579,300,879,32,911,1580,57.66%,36.65%,1
新北市,永和區,1502,600,276,876,28,904,1438,62.87%,41.72%,1
新北市,永和區,1503,552,255,807,20,827,1305,63.37%,42.3%,1
新北市,永和區,1504,449,194,643,20,663,1046,63.38%,42.93%,1
新北市,永和區,1505,601,306,907,20,927,1566,59.2%,38.38%,1
新北市,永和區,1506,535,303,838,29,867,1468,59.06%,36.44%,1
新北市,永和區,1507,531,288,819,37,856,1305,65.59%,40.69%,1
新北市,永和區,1508,450,256,706,25,731,1181,61.9%,38.1%,1
新北市,永和區,1509,587,341,928,35,963,1720,55.99%,34.13%,1
新北市,永和區,1510,439,242,681,23,704,1103,63.83%,39.8%,1
新北市,永和區,1511,462,326,788,172,960,1649,58.22%,28.02%,1
新北市,永和區,1512,437,305,742,28,770,1206,63.85%,36.24%,1
新北市,永和區,1513,542,350,892,27,919,1506,61.02%,35.99%,1
新北市,永和區,1514,534,287,821,32,853,1488,57.33%,35.89%,1
新北市,永和區,1515,479,283,762,44,806,1288,62.58%,37.19%,1
新北市,永和區,1516,467,261,728,28,756,1413,53.5%,33.05%,1
新北市,永和區,1517,517,225,742,35,777,1329,58.47%,38.9%,1
新北市,永和區,1518,585,287,872,15,887,1436,61.77%,40.74%,1
新北市,永和區,1519,418,210,628,35,663,1112,59.62%,37.59%,1
新北市,永和區,1520,494,221,715,32,747,1100,67.91%,44.91%,1
新北市,永和區,1521,639,290,929,29,958,1545,62.01%,41.36%,1
新北市,永和區,1522,563,248,811,10,821,1436,57.17%,39.21%,1
新北市,永和區,1523,712,338,1050,36,1086,1731,62.74%,41.13%,1
新北市,永和區,1524,670,362,1032,62,1094,1762,62.09%,38.02%,1
新北市,永和區,1525,455,265,720,29,749,1320,56.74%,34.47%,1
新北市,永和區,1526,423,214,637,15,652,1297,50.27%,32.61%,1
新北市,永和區,1527,606,359,965,40,1005,1798,55.9%,33.7%,1
新北市,永和區,1528,559,320,879,34,913,1491,61.23%,37.49%,1
新北市,永和區,1529,456,234,690,15,705,1223,57.65%,37.29%,1
新北市,永和區,1530,425,214,639,27,666,1108,60.11%,38.36%,1
新北市,永和區,1531,542,288,830,31,861,1408,61.15%,38.49%,1
新北市,永和區,1532,483,249,732,38,770,1265,60.87%,38.18%,1
新北市,永和區,1533,402,217,619,16,635,1115,56.95%,36.05%,1
新北市,永和區,1534,485,212,697,31,728,1133,64.25%,42.81%,1
新北市,永和區,1535,465,239,704,32,736,1217,60.48%,38.21%,1
新北市,永和區,1536,608,320,928,38,966,1713,56.39%,35.49%,1
新北市,永和區,1537,595,313,908,38,946,1721,54.97%,34.57%,1
新北市,永和區,1538,493,221,714,37,751,1327,56.59%,37.15%,1
新北市,永和區,1539,509,258,767,19,786,1257,62.53%,40.49%,1
新北市,永和區,1540,537,281,818,34,852,1348,63.2%,39.84%,1
新北市,永和區,1541,598,296,894,27,921,1461,63.04%,40.93%,1
新北市,永和區,1542,529,248,777,42,819,1368,59.87%,38.67%,1
新北市,永和區,1543,454,219,673,51,724,1234,58.67%,36.79%,1
新北市,永和區,1544,450,260,710,31,741,1303,56.87%,34.54%,1
新北市,永和區,1545,575,251,826,32,858,1516,56.6%,37.93%,1
新北市,永和區,1546,578,249,827,48,875,1422,61.53%,40.65%,1
新北市,永和區,1547,411,196,607,21,628,991,63.37%,41.47%,1
新北市,永和區,1548,430,191,621,21,642,1016,63.19%,42.32%,1
新北市,永和區,1549,438,228,666,27,693,1146,60.47%,38.22%,1
新北市,永和區,1550,449,170,619,16,635,1043,60.88%,43.05%,1
新北市,永和區,1551,470,262,732,18,750,1210,61.98%,38.84%,1
新北市,永和區,1552,628,305,933,25,958,1630,58.77%,38.53%,1
新北市,永和區,1553,448,208,656,21,677,1092,62%,41.03%,1
新北市,永和區,1554,708,367,1075,37,1112,1872,59.4%,37.82%,1
新北市,永和區,1555,647,333,980,28,1008,1781,56.6%,36.33%,1
新北市,永和區,1556,421,201,622,30,652,1049,62.15%,40.13%,1
新北市,永和區,1557,531,267,798,21,819,1285,63.74%,41.32%,1
新北市,永和區,1558,465,258,723,29,752,1209,62.2%,38.46%,1
新北市,永和區,1559,449,242,691,23,714,1132,63.07%,39.66%,1
新北市,永和區,1560,537,265,802,28,830,1287,64.49%,41.72%,1
新北市,永和區,1561,415,213,628,43,671,1068,62.83%,38.86%,1
新北市,永和區,1562,405,253,658,37,695,1098,63.3%,36.89%,1
新北市,永和區,1563,517,211,728,41,769,1222,62.93%,42.31%,1
新北市,永和區,1564,459,220,679,31,710,1157,61.37%,39.67%,1
新北市,永和區,1565,466,264,730,36,766,1168,65.58%,39.9%,1
新北市,永和區,1566,457,257,714,39,753,1283,58.69%,35.62%,1
新北市,永和區,1567,523,254,777,28,805,1372,58.67%,38.12%,1
新北市,永和區,1568,723,373,1096,38,1134,1876,60.45%,38.54%,1
新北市,永和區,1569,669,291,960,44,1004,1576,63.71%,42.45%,1
新北市,永和區,1570,640,332,972,30,1002,1661,60.33%,38.53%,1
新北市,永和區,1571,694,325,1019,18,1037,1808,57.36%,38.38%,1
新北市,永和區,1572,687,361,1048,41,1089,1898,57.38%,36.2%,1
新北市,永和區,1573,582,314,896,33,929,1508,61.6%,38.59%,1
新北市,永和區,1574,509,281,790,41,831,1341,61.97%,37.96%,1
新北市,永和區,1575,526,271,797,38,835,1422,58.72%,36.99%,1
新北市,永和區,1576,441,224,665,28,693,1177,58.88%,37.47%,1
新北市,永和區,1577,587,303,890,40,930,1557,59.73%,37.7%,1
新北市,永和區,1578,520,280,800,29,829,1491,55.6%,34.88%,1
新北市,永和區,1579,554,318,872,40,912,1586,57.5%,34.93%,1
新北市,永和區,1580,471,241,712,16,728,1313,55.45%,35.87%,1
新北市,永和區,1581,569,336,905,37,942,1636,57.58%,34.78%,1
新北市,永和區,1582,562,333,895,35,930,1598,58.2%,35.17%,1
新北市,永和區,1583,587,353,940,31,971,1609,60.35%,36.48%,1
新北市,永和區,1584,507,304,811,40,851,1375,61.89%,36.87%,1
新北市,永和區,1585,651,354,1005,34,1039,1648,63.05%,39.5%,1
新北市,永和區,1586,402,232,634,22,656,1077,60.91%,37.33%,1
新北市,永和區,1587,447,232,679,25,704,1157,60.85%,38.63%,1
新北市,永和區,1588,541,295,836,19,855,1339,63.85%,40.4%,1
新北市,永和區,1589,507,285,792,19,811,1306,62.1%,38.82%,1
新北市,永和區,1590,502,267,769,7,776,1236,62.78%,40.61%,1
新北市,永和區,1591,457,228,685,19,704,1133,62.14%,40.34%,1
新北市,永和區,1592,567,280,847,20,867,1425,60.84%,39.79%,1
新北市,永和區,1593,700,365,1065,52,1117,1938,57.64%,36.12%,1
新北市,永和區,1594,602,324,926,36,962,1607,59.86%,37.46%,1
新北市,永和區,1595,366,140,506,25,531,853,62.25%,42.91%,1
新北市,永和區,1596,279,118,397,31,428,768,55.73%,36.33%,1
新北市,永和區,1597,309,106,415,27,442,893,49.5%,34.6%,1
新北市,永和區,1598,288,132,420,17,437,743,58.82%,38.76%,1
新北市,永和區,1599,461,244,705,44,749,1155,64.85%,39.91%,1
新北市,永和區,1600,506,258,764,25,789,1263,62.47%,40.06%,1
新北市,永和區,1601,466,256,722,16,738,1189,62.07%,39.19%,1
新北市,永和區,1602,490,244,734,29,763,1346,56.69%,36.4%,1
新北市,永和區,1603,478,275,753,27,780,1368,57.02%,34.94%,1
新北市,永和區,1604,397,209,606,18,624,1043,59.83%,38.06%,1
新北市,永和區,1605,647,362,1009,32,1041,1709,60.91%,37.86%,1
新北市,永和區,1606,302,165,467,16,483,879,54.95%,34.36%,1
新北市,永和區,1607,331,189,520,21,541,904,59.85%,36.62%,1
新北市,永和區,1608,494,247,741,33,774,1221,63.39%,40.46%,1
新北市,永和區,1609,399,204,603,34,637,1018,62.57%,39.19%,1
新北市,永和區,1610,542,318,860,24,884,1551,57%,34.95%,1
新北市,永和區,1611,539,291,830,31,861,1428,60.29%,37.75%,1
新北市,永和區,1612,393,206,599,45,644,1044,61.69%,37.64%,1
新北市,永和區,1613,378,203,581,27,608,967,62.87%,39.09%,1
新北市,新莊區,0302,391,231,622,42,664,1123,59.13%,34.82%,1
新北市,新莊區,0303,482,260,742,36,778,1278,60.88%,37.72%,1
新北市,新莊區,0304,499,207,706,34,740,1163,63.63%,42.91%,1
新北市,新莊區,0305,474,257,731,28,759,1228,61.81%,38.6%,1
新北市,新莊區,0306,431,243,674,40,714,1211,58.96%,35.59%,1
新北市,新莊區,0307,442,225,667,34,701,1176,59.61%,37.59%,1
新北市,新莊區,0308,617,304,921,35,956,1536,62.24%,40.17%,1
新北市,新莊區,0309,566,307,873,52,925,1486,62.25%,38.09%,1
新北市,新莊區,0310,586,334,920,52,972,1513,64.24%,38.73%,1
新北市,新莊區,0311,530,312,842,49,891,1395,63.87%,37.99%,1
新北市,新莊區,0312,479,242,721,50,771,1353,56.98%,35.4%,1
新北市,新莊區,0313,562,260,822,51,873,1409,61.96%,39.89%,1
新北市,新莊區,0314,541,261,802,25,827,1478,55.95%,36.6%,1
新北市,新莊區,0315,363,183,546,29,575,921,62.43%,39.41%,1
新北市,新莊區,0316,374,204,578,31,609,971,62.72%,38.52%,1
新北市,新莊區,0317,616,299,915,51,966,1534,62.97%,40.16%,1
新北市,新莊區,0318,560,249,809,43,852,1516,56.2%,36.94%,1
新北市,新莊區,0319,246,143,389,21,410,697,58.82%,35.29%,1
新北市,新莊區,0320,452,247,699,22,721,1235,58.38%,36.6%,1
新北市,新莊區,0321,413,228,641,25,666,1138,58.52%,36.29%,1
新北市,新莊區,0322,367,193,560,15,575,1063,54.09%,34.52%,1
新北市,新莊區,0323,507,304,811,35,846,3399,24.89%,14.92%,1
新北市,新莊區,0324,568,315,883,54,937,1575,59.49%,36.06%,1
新北市,新莊區,0325,557,386,943,49,992,1615,61.42%,34.49%,1
新北市,新莊區,0326,517,285,802,46,848,1612,52.61%,32.07%,1
新北市,新莊區,0327,540,269,809,38,847,1514,55.94%,35.67%,1
新北市,新莊區,0328,441,254,695,25,720,1382,52.1%,31.91%,1
新北市,新莊區,0329,481,309,790,40,830,1475,56.27%,32.61%,1
新北市,新莊區,0330,514,314,828,19,847,1462,57.93%,35.16%,1
新北市,新莊區,0331,473,288,761,30,791,1426,55.47%,33.17%,1
新北市,新莊區,0332,458,296,754,36,790,1421,55.59%,32.23%,1
新北市,新莊區,0333,532,306,838,27,865,1536,56.32%,34.64%,1
新北市,新莊區,0334,521,372,893,27,920,1587,57.97%,32.83%,1
新北市,新莊區,0335,250,141,391,14,405,749,54.07%,33.38%,1
新北市,新莊區,0336,492,242,734,33,767,1276,60.11%,38.56%,1
新北市,新莊區,0337,453,249,702,25,727,1303,55.79%,34.77%,1
新北市,新莊區,0338,502,230,732,41,773,1259,61.4%,39.87%,1
新北市,新莊區,0339,477,263,740,41,781,1291,60.5%,36.95%,1
新北市,新莊區,0340,519,311,830,18,848,1493,56.8%,34.76%,1
新北市,新莊區,0341,534,308,842,38,880,1507,58.39%,35.43%,1
新北市,新莊區,0342,534,280,814,11,825,1456,56.66%,36.68%,1
新北市,新莊區,0343,501,283,784,21,805,1396,57.66%,35.89%,1
新北市,新莊區,0344,455,235,690,38,728,1351,53.89%,33.68%,1
新北市,新莊區,0345,491,276,767,38,805,1403,57.38%,35%,1
新北市,新莊區,0346,523,270,793,45,838,1497,55.98%,34.94%,1
新北市,新莊區,0347,479,242,721,53,774,1272,60.85%,37.66%,1
新北市,新莊區,0348,428,202,630,26,656,1269,51.69%,33.73%,1
新北市,新莊區,0349,478,263,741,57,798,1335,59.78%,35.81%,1
新北市,新莊區,0350,465,310,775,24,799,1300,61.46%,35.77%,1
新北市,新莊區,0351,492,253,745,36,781,1286,60.73%,38.26%,1
新北市,新莊區,0352,534,261,795,36,831,1255,66.22%,42.55%,1
新北市,新莊區,0353,584,259,843,56,899,1558,57.7%,37.48%,1
新北市,新莊區,0354,531,275,806,47,853,1567,54.44%,33.89%,1
新北市,新莊區,0355,619,284,903,47,950,1603,59.26%,38.62%,1
新北市,新莊區,0356,519,324,843,30,873,1538,56.76%,33.75%,1
新北市,新莊區,0357,574,352,926,41,967,1671,57.87%,34.35%,1
新北市,新莊區,0358,531,320,851,35,886,1698,52.18%,31.27%,1
新北市,新莊區,0359,552,350,902,41,943,1545,61.04%,35.73%,1
新北市,新莊區,0360,636,316,952,78,1030,1696,60.73%,37.5%,1
新北市,新莊區,0361,585,235,820,57,877,1626,53.94%,35.98%,1
新北市,新莊區,0362,395,281,676,44,720,1170,61.54%,33.76%,1
新北市,新莊區,0363,451,217,668,57,725,1236,58.66%,36.49%,1
新北市,新莊區,0364,380,182,562,40,602,1071,56.21%,35.48%,1
新北市,新莊區,0365,402,210,612,37,649,1129,57.48%,35.61%,1
新北市,新莊區,0366,610,329,939,27,966,1586,60.91%,38.46%,1
新北市,新莊區,0367,555,247,802,31,833,1597,52.16%,34.75%,1
新北市,新莊區,0368,518,250,768,59,827,1573,52.57%,32.93%,1
新北市,新莊區,0369,479,199,678,31,709,1225,57.88%,39.1%,1
新北市,新莊區,0370,446,180,626,22,648,1217,53.25%,36.65%,1
新北市,新莊區,0371,549,289,838,44,882,1571,56.14%,34.95%,1
新北市,新莊區,0372,529,291,820,41,861,1594,54.02%,33.19%,1
新北市,新莊區,0373,557,274,831,42,873,1583,55.15%,35.19%,1
新北市,新莊區,0374,510,230,740,43,783,1245,62.89%,40.96%,1
新北市,新莊區,0375,469,240,709,26,735,1203,61.1%,38.99%,1
新北市,新莊區,0376,506,260,766,26,792,1265,62.61%,40%,1
新北市,新莊區,0377,489,226,715,46,761,1255,60.64%,38.96%,1
新北市,新莊區,0378,478,250,728,28,756,1287,58.74%,37.14%,1
新北市,新莊區,0379,428,253,681,52,733,1167,62.81%,36.68%,1
新北市,新莊區,0380,463,224,687,40,727,1299,55.97%,35.64%,1
新北市,新莊區,0381,432,237,669,37,706,1207,58.49%,35.79%,1
新北市,新莊區,0382,542,264,806,25,831,1415,58.73%,38.3%,1
新北市,新莊區,0383,483,259,742,43,785,1342,58.49%,35.99%,1
新北市,新莊區,0384,452,267,719,55,774,1341,57.72%,33.71%,1
新北市,新莊區,0385,415,253,668,46,714,1247,57.26%,33.28%,1
新北市,新莊區,0386,463,179,642,15,657,984,66.77%,47.05%,1
新北市,新莊區,0387,383,232,615,33,648,1043,62.13%,36.72%,1
新北市,新莊區,0388,480,243,723,27,750,1135,66.08%,42.29%,1
新北市,新莊區,0389,411,258,669,35,704,1185,59.41%,34.68%,1
新北市,新莊區,0390,470,288,758,24,782,1346,58.1%,34.92%,1
新北市,新莊區,0391,528,239,767,52,819,1372,59.69%,38.48%,1
新北市,新莊區,0392,542,250,792,44,836,1350,61.93%,40.15%,1
新北市,新莊區,0393,445,247,692,38,730,1307,55.85%,34.05%,1
新北市,新莊區,0394,497,239,736,47,783,1353,57.87%,36.73%,1
新北市,新莊區,0395,500,120,620,47,667,1287,51.83%,38.85%,1
新北市,新莊區,0396,492,245,737,30,767,1567,48.95%,31.4%,1
新北市,新莊區,0397,616,353,969,46,1015,1709,59.39%,36.04%,1
新北市,新莊區,0398,560,265,825,32,857,1616,53.03%,34.65%,1
新北市,新莊區,0399,487,325,812,47,859,1628,52.76%,29.91%,1
新北市,新莊區,0400,451,214,665,46,711,1148,61.93%,39.29%,1
新北市,新莊區,0401,465,218,683,8,691,1201,57.54%,38.72%,1
新北市,新莊區,0402,465,233,698,33,731,1135,64.41%,40.97%,1
新北市,新莊區,0403,539,341,880,46,926,1495,61.94%,36.05%,1
新北市,新莊區,0404,568,301,869,45,914,1486,61.51%,38.22%,1
新北市,新莊區,0405,576,313,889,29,918,1483,61.9%,38.84%,1
新北市,新莊區,0406,552,275,827,33,860,1553,55.38%,35.54%,1
新北市,新莊區,0407,617,350,967,21,988,1625,60.8%,37.97%,1
新北市,新莊區,0408,798,136,934,22,956,1671,57.21%,47.76%,1
新北市,新莊區,0409,541,277,818,52,870,1389,62.63%,38.95%,1
新北市,新莊區,0410,492,227,719,29,748,1272,58.81%,38.68%,1
新北市,新莊區,0411,545,308,853,28,881,1409,62.53%,38.68%,1
新北市,新莊區,0412,521,300,821,33,854,1372,62.24%,37.97%,1
新北市,新莊區,0413,349,177,526,35,561,955,58.74%,36.54%,1
新北市,新莊區,0414,338,158,496,40,536,952,56.3%,35.5%,1
新北市,新莊區,0415,520,281,801,20,821,1412,58.14%,36.83%,1
新北市,新莊區,0416,545,245,790,37,827,1415,58.45%,38.52%,1
新北市,新莊區,0417,554,263,817,46,863,1421,60.73%,38.99%,1
新北市,新莊區,0418,515,268,783,29,812,1293,62.8%,39.83%,1
新北市,新莊區,0419,490,290,780,22,802,1475,54.37%,33.22%,1
新北市,新莊區,0420,496,277,773,48,821,1429,57.45%,34.71%,1
新北市,新莊區,0421,492,315,807,41,848,1481,57.26%,33.22%,1
新北市,新莊區,0422,566,272,838,55,893,1472,60.67%,38.45%,1
新北市,新莊區,0423,524,330,854,21,875,1474,59.36%,35.55%,1
新北市,新莊區,0424,548,316,864,17,881,1462,60.26%,37.48%,1
新北市,新莊區,0425,531,333,864,20,884,1484,59.57%,35.78%,1
新北市,新莊區,0426,541,269,810,31,841,1461,57.56%,37.03%,1
新北市,新莊區,0427,525,314,839,20,859,1444,59.49%,36.36%,1
新北市,新莊區,0428,534,301,835,20,855,1437,59.5%,37.16%,1
新北市,新莊區,0429,501,302,803,34,837,1641,51.01%,30.53%,1
新北市,新莊區,0430,534,321,855,24,879,1633,53.83%,32.7%,1
新北市,新莊區,0431,557,316,873,10,883,1531,57.67%,36.38%,1
新北市,新莊區,0432,565,306,871,34,905,1517,59.66%,37.24%,1
新北市,新莊區,0433,515,277,792,32,824,1487,55.41%,34.63%,1
新北市,新莊區,0434,553,303,856,33,889,1560,56.99%,35.45%,1
新北市,新莊區,0435,535,308,843,53,896,1584,56.57%,33.78%,1
新北市,新莊區,0436,583,278,861,23,884,1602,55.18%,36.39%,1
新北市,新莊區,0437,290,156,446,39,485,818,59.29%,35.45%,1
新北市,新莊區,0438,535,244,779,44,823,1633,50.4%,32.76%,1
新北市,新莊區,0439,587,276,863,31,894,1652,54.12%,35.53%,1
新北市,新莊區,0440,519,274,793,41,834,1498,55.67%,34.65%,1
新北市,新莊區,0441,477,253,730,39,769,1379,55.77%,34.59%,1
新北市,新莊區,0442,531,254,785,37,822,1381,59.52%,38.45%,1
新北市,新莊區,0443,566,292,858,47,905,1535,58.96%,36.87%,1
新北市,新莊區,0444,599,299,898,49,947,1492,63.47%,40.15%,1
新北市,新莊區,0445,571,296,867,50,917,1450,63.24%,39.38%,1
新北市,新莊區,0446,397,227,624,32,656,1107,59.26%,35.86%,1
新北市,新莊區,0447,426,220,646,18,664,1063,62.46%,40.08%,1
新北市,新莊區,0448,435,225,660,32,692,1143,60.54%,38.06%,1
新北市,新莊區,0449,454,253,707,48,755,1341,56.3%,33.86%,1
新北市,新莊區,0450,404,186,590,26,616,1063,57.95%,38.01%,1
新北市,新莊區,0451,424,211,635,27,662,1096,60.4%,38.69%,1
新北市,新莊區,0452,470,248,718,30,748,1309,57.14%,35.91%,1
新北市,新莊區,0453,468,236,704,29,733,1216,60.28%,38.49%,1
新北市,新莊區,0454,450,212,662,32,694,1278,54.3%,35.21%,1
新北市,新莊區,0455,457,272,729,49,778,1352,57.54%,33.8%,1
新北市,新莊區,0456,406,231,637,44,681,1298,52.47%,31.28%,1
新北市,新莊區,0457,375,196,571,39,610,1042,58.54%,35.99%,1
新北市,新莊區,0458,283,164,447,24,471,881,53.46%,32.12%,1
新北市,新莊區,0459,442,234,676,44,720,1109,64.92%,39.86%,1
新北市,新莊區,0460,448,231,679,43,722,1291,55.93%,34.7%,1
新北市,新莊區,0461,434,248,682,23,705,1293,54.52%,33.57%,1
新北市,新莊區,0462,488,269,757,32,789,1336,59.06%,36.53%,1
新北市,新莊區,0463,472,244,716,30,746,1384,53.9%,34.1%,1
新北市,新莊區,0464,426,200,626,2,628,1231,51.02%,34.61%,1
新北市,新莊區,0465,340,177,517,31,548,940,58.3%,36.17%,1
新北市,新莊區,0466,429,280,709,60,769,1369,56.17%,31.34%,1
新北市,新莊區,0467,500,219,719,50,769,1384,55.56%,36.13%,1
新北市,新莊區,0468,437,274,711,45,756,1272,59.43%,34.36%,1
新北市,新莊區,0469,399,208,607,30,637,1073,59.37%,37.19%,1
新北市,新莊區,0470,351,227,578,30,608,1058,57.47%,33.18%,1
新北市,新莊區,0471,545,304,849,18,867,1528,56.74%,35.67%,1
新北市,新莊區,0472,465,186,651,30,681,1244,54.74%,37.38%,1
新北市,新莊區,0473,509,191,700,23,723,1356,53.32%,37.54%,1
新北市,新莊區,0474,436,159,595,15,610,1164,52.41%,37.46%,1
新北市,新莊區,0475,511,282,793,47,840,1423,59.03%,35.91%,1
新北市,新莊區,0476,488,260,748,29,777,1250,62.16%,39.04%,1
新北市,新莊區,0477,413,255,668,23,691,1252,55.19%,32.99%,1
新北市,新莊區,0478,369,181,550,12,562,1022,54.99%,36.11%,1
新北市,新莊區,0479,348,187,535,35,570,959,59.44%,36.29%,1
新北市,新莊區,0480,555,373,928,32,960,1646,58.32%,33.72%,1
新北市,新莊區,0481,487,331,818,47,865,1551,55.77%,31.4%,1
新北市,新莊區,0482,566,311,877,33,910,1526,59.63%,37.09%,1
新北市,新莊區,0483,530,324,854,14,868,1518,57.18%,34.91%,1
新北市,新莊區,0484,526,343,869,32,901,1547,58.24%,34%,1
新北市,新莊區,0485,527,254,781,46,827,1505,54.95%,35.02%,1
新北市,新莊區,0486,529,258,787,41,828,1527,54.22%,34.64%,1
新北市,新莊區,0487,475,263,738,42,780,1482,52.63%,32.05%,1
新北市,新莊區,0488,514,268,782,46,828,1586,52.21%,32.41%,1
新北市,新莊區,0489,377,191,568,56,624,1065,58.59%,35.4%,1
新北市,新莊區,0490,427,209,636,40,676,1040,65%,41.06%,1
新北市,新莊區,0491,359,218,577,37,614,1090,56.33%,32.94%,1
新北市,新莊區,0492,398,218,616,30,646,1071,60.32%,37.16%,1
新北市,新莊區,0493,538,330,868,32,900,1704,52.82%,31.57%,1
新北市,新莊區,0494,515,313,828,31,859,1698,50.59%,30.33%,1
新北市,新莊區,0495,507,307,814,39,853,1362,62.63%,37.22%,1
新北市,新莊區,0496,481,301,782,28,810,1350,60%,35.63%,1
新北市,新莊區,0497,590,317,907,61,968,1689,57.31%,34.93%,1
新北市,新莊區,0498,555,324,879,58,937,1612,58.13%,34.43%,1
新北市,新莊區,0499,451,196,647,39,686,1130,60.71%,39.91%,1
新北市,新莊區,0500,426,231,657,42,699,1111,62.92%,38.34%,1
新北市,新莊區,0501,509,299,808,31,839,1539,54.52%,33.07%,1
新北市,新莊區,0502,549,318,867,24,891,1586,56.18%,34.62%,1
新北市,新莊區,0503,595,312,907,30,937,1631,57.45%,36.48%,1
新北市,新莊區,0504,419,325,744,25,769,1540,49.94%,27.21%,1
新北市,新莊區,0505,440,223,663,38,701,1388,50.5%,31.7%,1
新北市,新莊區,0506,406,236,642,76,718,1388,51.73%,29.25%,1
新北市,新莊區,0507,431,229,660,37,697,1387,50.25%,31.07%,1
新北市,新莊區,0508,402,218,620,27,647,1181,54.78%,34.04%,1
新北市,新莊區,0509,388,230,618,42,660,1135,58.15%,34.19%,1
新北市,新莊區,0510,400,244,644,32,676,1173,57.63%,34.1%,1
新北市,新莊區,0511,385,293,678,26,704,1215,57.94%,31.69%,1
新北市,新莊區,0512,531,283,814,47,861,1488,57.86%,35.69%,1
新北市,新莊區,0513,492,298,790,36,826,1444,57.2%,34.07%,1
新北市,新莊區,0514,505,279,784,27,811,1499,54.1%,33.69%,1
新北市,新莊區,0515,488,284,772,29,801,1449,55.28%,33.68%,1
新北市,新莊區,0516,559,312,871,51,922,1640,56.22%,34.09%,1
新北市,新莊區,0517,536,319,855,45,900,1648,54.61%,32.52%,1
新北市,新莊區,0518,430,243,673,49,722,1371,52.66%,31.36%,1
新北市,新莊區,0519,478,252,730,43,773,1400,55.21%,34.14%,1
新北市,新莊區,0520,487,274,761,62,823,1457,56.49%,33.42%,1
新北市,新莊區,0521,494,282,776,50,826,1502,54.99%,32.89%,1
新北市,新莊區,0522,456,275,731,56,787,1412,55.74%,32.29%,1
新北市,新莊區,0523,442,232,674,62,736,1318,55.84%,33.54%,1
新北市,新莊區,0524,500,303,803,32,835,1411,59.18%,35.44%,1
新北市,新莊區,0525,439,271,710,30,740,1262,58.64%,34.79%,1
新北市,新莊區,0526,470,245,715,29,744,1228,60.59%,38.27%,1
新北市,新莊區,0527,579,405,984,41,1025,1748,58.64%,33.12%,1
新北市,新莊區,0528,625,340,965,60,1025,1761,58.21%,35.49%,1
新北市,新莊區,0529,438,235,673,32,705,1326,53.17%,33.03%,1
新北市,新莊區,0530,442,206,648,23,671,1344,49.93%,32.89%,1
新北市,新莊區,0531,505,228,733,38,771,1355,56.9%,37.27%,1
新北市,新莊區,0532,480,241,721,39,760,1306,58.19%,36.75%,1
新北市,新莊區,0533,497,281,778,31,809,1349,59.97%,36.84%,1
新北市,新莊區,0534,461,251,712,28,740,1265,58.5%,36.44%,1
新北市,新莊區,0535,491,253,744,35,779,1282,60.76%,38.3%,1
新北市,新莊區,0536,492,224,716,28,744,1237,60.15%,39.77%,1
新北市,新莊區,0537,489,218,707,24,731,1301,56.19%,37.59%,1
新北市,新莊區,0538,459,236,695,32,727,1262,57.61%,36.37%,1
新北市,新莊區,0539,471,219,690,37,727,1270,57.24%,37.09%,1
新北市,新莊區,0540,447,250,697,38,735,1245,59.04%,35.9%,1
新北市,新莊區,0541,455,194,649,36,685,1220,56.15%,37.3%,1
新北市,新莊區,0542,398,229,627,42,669,1245,53.73%,31.97%,1
新北市,新莊區,0543,412,219,631,37,668,1212,55.12%,33.99%,1
新北市,新莊區,0544,414,223,637,47,684,1253,54.59%,33.04%,1
新北市,新莊區,0545,422,219,641,39,680,1272,53.46%,33.18%,1
新北市,新莊區,0546,480,238,718,15,733,1227,59.74%,39.12%,1
新北市,新莊區,0547,437,223,660,18,678,1126,60.21%,38.81%,1
新北市,新莊區,0548,461,248,709,21,730,1240,58.87%,37.18%,1
新北市,新莊區,0549,509,280,789,40,829,1460,56.78%,34.86%,1
新北市,新莊區,0550,374,194,568,32,600,1072,55.97%,34.89%,1
新北市,新莊區,0551,358,206,564,28,592,1127,52.53%,31.77%,1
新北市,新莊區,0552,522,237,759,21,780,1332,58.56%,39.19%,1
新北市,新莊區,0553,411,276,687,16,703,1341,52.42%,30.65%,1
新北市,新莊區,0554,328,175,503,19,522,1140,45.79%,28.77%,1
新北市,新店區,1987,564,299,863,34,897,1603,55.96%,35.18%,1
新北市,新店區,1988,700,364,1064,35,1099,1921,57.21%,36.44%,1
新北市,新店區,1989,382,192,574,24,598,1082,55.27%,35.3%,1
新北市,新店區,1990,437,257,694,28,722,1235,58.46%,35.38%,1
新北市,新店區,1991,635,264,899,19,918,1568,58.55%,40.5%,1
新北市,新店區,1992,285,152,437,29,466,771,60.44%,36.96%,1
新北市,新店區,1993,431,265,696,25,721,1256,57.4%,34.32%,1
新北市,新店區,1994,377,199,576,28,604,1008,59.92%,37.4%,1
新北市,新店區,1995,612,255,867,31,898,1515,59.27%,40.4%,1
新北市,新店區,1996,688,296,984,30,1014,1637,61.94%,42.03%,1
新北市,新店區,1997,547,333,880,23,903,1549,58.3%,35.31%,1
新北市,新店區,1998,805,414,1219,40,1259,2011,62.61%,40.03%,1
新北市,新店區,1999,568,287,855,53,908,1554,58.43%,36.55%,1
新北市,新店區,2000,607,339,946,45,991,1770,55.99%,34.29%,1
新北市,新店區,2001,490,255,745,37,782,1316,59.42%,37.23%,1
新北市,新店區,2002,434,179,613,30,643,1126,57.1%,38.54%,1
新北市,新店區,2003,521,261,782,26,808,1460,55.34%,35.68%,1
新北市,新店區,2004,607,304,911,36,947,1584,59.79%,38.32%,1
新北市,新店區,2005,533,268,801,31,832,1449,57.42%,36.78%,1
新北市,新店區,2006,640,299,939,24,963,1520,63.36%,42.11%,1
新北市,新店區,2007,716,335,1051,22,1073,1821,58.92%,39.32%,1
新北市,新店區,2008,692,401,1093,26,1119,1956,57.21%,35.38%,1
新北市,新店區,2009,619,320,939,42,981,1665,58.92%,37.18%,1
新北市,新店區,2010,612,335,947,23,970,1588,61.08%,38.54%,1
新北市,新店區,2011,508,305,813,41,854,1519,56.22%,33.44%,1
新北市,新店區,2012,460,271,731,23,754,1185,63.63%,38.82%,1
新北市,新店區,2013,424,264,688,16,704,1095,64.29%,38.72%,1
新北市,新店區,2014,447,215,662,34,696,1106,62.93%,40.42%,1
新北市,新店區,2015,236,159,395,18,413,2700,15.3%,8.74%,1
新北市,新店區,2016,416,176,592,15,607,995,61.01%,41.81%,1
新北市,新店區,2017,451,209,660,35,695,1168,59.5%,38.61%,1
新北市,新店區,2018,510,219,729,35,764,1123,68.03%,45.41%,1
新北市,新店區,2019,399,285,684,26,710,1085,65.44%,36.77%,1
新北市,新店區,2020,554,291,845,42,887,1412,62.82%,39.24%,1
新北市,新店區,2021,642,300,942,32,974,1659,58.71%,38.7%,1
新北市,新店區,2022,497,233,730,35,765,1198,63.86%,41.49%,1
新北市,新店區,2023,500,220,720,28,748,1376,54.36%,36.34%,1
新北市,新店區,2024,490,212,702,25,727,1300,55.92%,37.69%,1
新北市,新店區,2025,468,235,703,24,727,1238,58.72%,37.8%,1
新北市,新店區,2026,495,248,743,20,763,1388,54.97%,35.66%,1
新北市,新店區,2027,370,195,565,29,594,933,63.67%,39.66%,1
新北市,新店區,2028,391,174,565,19,584,908,64.32%,43.06%,1
新北市,新店區,2029,589,281,870,42,912,1582,57.65%,37.23%,1
新北市,新店區,2030,520,229,749,32,781,1247,62.63%,41.7%,1
新北市,新店區,2031,371,206,577,27,604,971,62.2%,38.21%,1
新北市,新店區,2032,453,223,676,34,710,1145,62.01%,39.56%,1
新北市,新店區,2033,546,259,805,33,838,1392,60.2%,39.22%,1
新北市,新店區,2034,615,265,880,39,919,1452,63.29%,42.36%,1
新北市,新店區,2035,531,270,801,37,838,1440,58.19%,36.88%,1
新北市,新店區,2036,630,324,954,51,1005,1786,56.27%,35.27%,1
新北市,新店區,2037,688,335,1023,39,1062,1825,58.19%,37.7%,1
新北市,新店區,2038,599,291,890,17,907,1477,61.41%,40.56%,1
新北市,新店區,2039,661,343,1004,31,1035,1750,59.14%,37.77%,1
新北市,新店區,2040,796,293,1089,32,1121,1792,62.56%,44.42%,1
新北市,新店區,2041,765,325,1090,34,1124,1979,56.8%,38.66%,1
新北市,新店區,2042,334,158,492,13,505,826,61.14%,40.44%,1
新北市,新店區,2043,797,310,1107,35,1142,1924,59.36%,41.42%,1
新北市,新店區,2044,584,261,845,26,871,1383,62.98%,42.23%,1
新北市,新店區,2045,286,132,418,24,442,830,53.25%,34.46%,1
新北市,新店區,2046,703,334,1037,34,1071,1759,60.89%,39.97%,1
新北市,新店區,2047,771,367,1138,44,1182,1957,60.4%,39.4%,1
新北市,新店區,2048,592,303,895,10,905,1481,61.11%,39.97%,1
新北市,新店區,2049,582,303,885,37,922,1552,59.41%,37.5%,1
新北市,新店區,2050,522,277,799,51,850,1467,57.94%,35.58%,1
新北市,新店區,2051,516,241,757,33,790,1371,57.62%,37.64%,1
新北市,新店區,2052,376,206,582,25,607,991,61.25%,37.94%,1
新北市,新店區,2053,467,265,732,22,754,1231,61.25%,37.94%,1
新北市,新店區,2054,616,346,962,36,998,1701,58.67%,36.21%,1
新北市,新店區,2055,628,324,952,48,1000,1707,58.58%,36.79%,1
新北市,新店區,2056,677,314,991,24,1015,1773,57.25%,38.18%,1
新北市,新店區,2057,641,319,960,33,993,1866,53.22%,34.35%,1
新北市,新店區,2058,656,343,999,36,1035,1735,59.65%,37.81%,1
新北市,新店區,2059,660,350,1010,31,1041,1632,63.79%,40.44%,1
新北市,新店區,2060,585,319,904,42,946,1591,59.46%,36.77%,1
新北市,新店區,2061,526,247,773,46,819,1495,54.78%,35.18%,1
新北市,新店區,2062,535,238,773,28,801,1511,53.01%,35.41%,1
新北市,新店區,2063,488,218,706,33,739,1260,58.65%,38.73%,1
新北市,新店區,2064,780,349,1129,39,1168,1948,59.96%,40.04%,1
新北市,新店區,2065,618,332,950,41,991,1582,62.64%,39.06%,1
新北市,新店區,2066,482,257,739,29,768,1315,58.4%,36.65%,1
新北市,新店區,2067,547,284,831,46,877,1562,56.15%,35.02%,1
新北市,新店區,2068,787,375,1162,25,1187,1982,59.89%,39.71%,1
新北市,新店區,2069,581,291,872,36,908,1518,59.82%,38.27%,1
新北市,新店區,2070,633,334,967,27,994,1735,57.29%,36.48%,1
新北市,新店區,2071,631,298,929,44,973,1716,56.7%,36.77%,1
新北市,新店區,2072,594,290,884,46,930,1580,58.86%,37.59%,1
新北市,新店區,2073,548,269,817,31,848,1358,62.44%,40.35%,1
新北市,新店區,2074,634,323,957,45,1002,1610,62.24%,39.38%,1
新北市,新店區,2075,492,262,754,20,774,1383,55.97%,35.57%,1
新北市,新店區,2076,612,301,913,31,944,1596,59.15%,38.35%,1
新北市,新店區,2077,483,211,694,34,728,1360,53.53%,35.51%,1
新北市,新店區,2078,430,174,604,14,618,1160,53.28%,37.07%,1
新北市,新店區,2079,606,195,801,7,808,1236,65.37%,49.03%,1
新北市,新店區,2080,537,237,774,24,798,1234,64.67%,43.52%,1
新北市,新店區,2081,558,316,874,44,918,1579,58.14%,35.34%,1
新北市,新店區,2082,479,203,682,28,710,1241,57.21%,38.6%,1
新北市,新店區,2083,484,229,713,20,733,1275,57.49%,37.96%,1
新北市,新店區,2084,414,200,614,32,646,1214,53.21%,34.1%,1
新北市,新店區,2085,488,255,743,51,794,1578,50.32%,30.93%,1
新北市,新店區,2086,481,270,751,36,787,1442,54.58%,33.36%,1
新北市,新店區,2087,466,236,702,64,766,1475,51.93%,31.59%,1
新北市,新店區,2088,579,307,886,45,931,1580,58.92%,36.65%,1
新北市,新店區,2089,584,275,859,26,885,1585,55.84%,36.85%,1
新北市,新店區,2090,553,294,847,45,892,1586,56.24%,34.87%,1
新北市,新店區,2091,678,345,1023,45,1068,1931,55.31%,35.11%,1
新北市,新店區,2092,443,219,662,23,685,1239,55.29%,35.75%,1
新北市,新店區,2093,700,314,1014,39,1053,1892,55.66%,37%,1
新北市,新店區,2094,545,235,780,35,815,1529,53.3%,35.64%,1
新北市,新店區,2095,544,220,764,30,794,1358,58.47%,40.06%,1
新北市,新店區,2096,643,319,962,32,994,1905,52.18%,33.75%,1
新北市,新店區,2097,655,312,967,52,1019,1885,54.06%,34.75%,1
新北市,新店區,2098,485,206,691,49,740,1345,55.02%,36.06%,1
新北市,新店區,2099,530,235,765,42,807,1387,58.18%,38.21%,1
新北市,新店區,2100,699,348,1047,36,1083,1960,55.26%,35.66%,1
新北市,新店區,2101,633,334,967,62,1029,1837,56.02%,34.46%,1
新北市,新店區,2102,617,307,924,28,952,1662,57.28%,37.12%,1
新北市,新店區,2103,622,326,948,47,995,1617,61.53%,38.47%,1
新北市,新店區,2104,635,334,969,22,991,1704,58.16%,37.27%,1
新北市,新店區,2105,631,317,948,44,992,1835,54.06%,34.39%,1
新北市,新店區,2106,691,344,1035,55,1090,2009,54.26%,34.4%,1
新北市,新店區,2107,507,266,773,39,812,1450,56%,34.97%,1
新北市,新店區,2108,616,314,930,31,961,1726,55.68%,35.69%,1
新北市,新店區,2109,600,408,1008,31,1039,1797,57.82%,33.39%,1
新北市,新店區,2110,611,320,931,40,971,1739,55.84%,35.14%,1
新北市,新店區,2111,597,228,825,30,855,1523,56.14%,39.2%,1
新北市,新店區,2112,592,296,888,21,909,1642,55.36%,36.05%,1
新北市,新店區,2113,591,332,923,20,943,1644,57.36%,35.95%,1
新北市,新店區,2114,556,278,834,30,864,1662,51.99%,33.45%,1
新北市,新店區,2115,746,396,1142,42,1184,2067,57.28%,36.09%,1
新北市,新店區,2116,544,308,852,31,883,1870,47.22%,29.09%,1
新北市,新店區,2117,685,358,1043,42,1085,1982,54.74%,34.56%,1
新北市,新店區,2118,545,277,822,37,859,1546,55.56%,35.25%,1
新北市,新店區,2119,695,315,1010,28,1038,1712,60.63%,40.6%,1
新北市,新店區,2120,562,291,853,30,883,1423,62.05%,39.49%,1
新北市,新店區,2121,648,320,968,44,1012,1666,60.74%,38.9%,1
新北市,新店區,2122,725,325,1050,40,1090,1769,61.62%,40.98%,1
新北市,新店區,2123,338,179,517,30,547,1079,50.7%,31.33%,1
新北市,新店區,2124,397,220,617,23,640,1140,56.14%,34.82%,1
新北市,新店區,2125,643,318,961,44,1005,1825,55.07%,35.23%,1
新北市,新店區,2126,436,237,673,42,715,1178,60.7%,37.01%,1
新北市,新店區,2127,499,264,763,37,800,1463,54.68%,34.11%,1
新北市,新店區,2128,430,212,642,23,665,1152,57.73%,37.33%,1
新北市,新店區,2129,619,303,922,24,946,2008,47.11%,30.83%,1
新北市,新店區,2130,644,310,954,25,979,2120,46.18%,30.38%,1
新北市,新店區,2131,460,223,683,16,699,1153,60.62%,39.9%,1
新北市,新店區,2132,529,272,801,21,822,1573,52.26%,33.63%,1
新北市,新店區,2133,612,288,900,47,947,1992,47.54%,30.72%,1
新北市,新店區,2134,519,267,786,40,826,1668,49.52%,31.12%,1
新北市,新店區,2135,540,222,762,34,796,1617,49.23%,33.4%,1
新北市,新店區,2136,673,324,997,79,1076,2013,53.45%,33.43%,1
新北市,新店區,2137,696,328,1024,20,1044,1791,58.29%,38.86%,1
新北市,新店區,2138,596,308,904,25,929,1624,57.2%,36.7%,1
新北市,新店區,2139,473,211,684,33,717,1178,60.87%,40.15%,1
新北市,新店區,2140,493,239,732,23,755,1277,59.12%,38.61%,1
新北市,新店區,2141,675,357,1032,37,1069,1879,56.89%,35.92%,1
新北市,新店區,2142,302,146,448,23,471,939,50.16%,32.16%,1
新北市,新店區,2143,319,207,526,21,547,960,56.98%,33.23%,1
新北市,新店區,2144,563,293,856,31,887,1434,61.85%,39.26%,1
新北市,新店區,2145,589,336,925,39,964,1838,52.45%,32.05%,1
新北市,新店區,2146,515,267,782,33,815,1453,56.09%,35.44%,1
新北市,新店區,2147,627,125,752,77,829,1549,53.52%,40.48%,1
新北市,新店區,2148,698,367,1065,26,1091,1860,58.66%,37.53%,1
新北市,新店區,2149,623,268,891,32,923,1743,52.95%,35.74%,1
新北市,新店區,2150,468,240,708,30,738,1122,65.78%,41.71%,1
新北市,新店區,2151,566,216,782,34,816,1468,55.59%,38.56%,1
新北市,新店區,2152,618,315,933,32,965,1763,54.74%,35.05%,1
新北市,新店區,2153,457,235,692,28,720,1344,53.57%,34%,1
新北市,新店區,2154,266,116,382,25,407,753,54.05%,35.33%,1
新北市,新店區,2155,209,121,330,9,339,602,56.31%,34.72%,1
新北市,新店區,2156,695,433,1128,48,1176,2237,52.57%,31.07%,1
新北市,新店區,2157,417,182,599,19,618,1096,56.39%,38.05%,1
新北市,新店區,2158,341,166,507,31,538,1143,47.07%,29.83%,1
新北市,新店區,2159,519,255,774,54,828,1569,52.77%,33.08%,1
新北市,新店區,2160,439,220,659,54,713,1284,55.53%,34.19%,1
新北市,新店區,2161,91,50,141,19,160,439,36.45%,20.73%,1
新北市,新店區,2162,244,164,408,28,436,750,58.13%,32.53%,1
新北市,樹林區,1614,462,234,696,47,743,1408,52.77%,32.81%,1
新北市,樹林區,1615,455,231,686,25,711,1310,54.27%,34.73%,1
新北市,樹林區,1616,483,234,717,44,761,1534,49.61%,31.49%,1
新北市,樹林區,1617,424,203,627,50,677,1211,55.9%,35.01%,1
新北市,樹林區,1618,406,213,619,38,657,1125,58.4%,36.09%,1
新北市,樹林區,1619,457,209,666,23,689,1134,60.76%,40.3%,1
新北市,樹林區,1620,510,320,830,60,890,1897,46.92%,26.88%,1
新北市,樹林區,1621,523,344,867,50,917,1716,53.44%,30.48%,1
新北市,樹林區,1622,273,163,436,23,459,736,62.36%,37.09%,1
新北市,樹林區,1623,429,251,680,15,695,1137,61.13%,37.73%,1
新北市,樹林區,1624,482,299,781,27,808,1542,52.4%,31.26%,1
新北市,樹林區,1625,482,288,770,43,813,1470,55.31%,32.79%,1
新北市,樹林區,1626,443,256,699,18,717,1456,49.24%,30.43%,1
新北市,樹林區,1627,418,210,628,22,650,1124,57.83%,37.19%,1
新北市,樹林區,1628,401,230,631,25,656,1235,53.12%,32.47%,1
新北市,樹林區,1629,416,261,677,21,698,1212,57.59%,34.32%,1
新北市,樹林區,1630,410,194,604,30,634,1223,51.84%,33.52%,1
新北市,樹林區,1631,447,230,677,56,733,1335,54.91%,33.48%,1
新北市,樹林區,1632,393,240,633,32,665,1206,55.14%,32.59%,1
新北市,樹林區,1633,422,236,658,53,711,1927,36.9%,21.9%,1
新北市,樹林區,1634,318,152,470,46,516,914,56.46%,34.79%,1
新北市,樹林區,1635,533,273,806,38,844,1456,57.97%,36.61%,1
新北市,樹林區,1636,481,245,726,44,770,1409,54.65%,34.14%,1
新北市,樹林區,1637,567,285,852,49,901,1500,60.07%,37.8%,1
新北市,樹林區,1638,519,312,831,38,869,1545,56.25%,33.59%,1
新北市,樹林區,1639,482,282,764,22,786,1483,53%,32.5%,1
新北市,樹林區,1640,541,282,823,22,845,1524,55.45%,35.5%,1
新北市,樹林區,1641,499,266,765,40,805,1431,56.25%,34.87%,1
新北市,樹林區,1642,425,199,624,32,656,1181,55.55%,35.99%,1
新北市,樹林區,1643,388,219,607,44,651,1116,58.33%,34.77%,1
新北市,樹林區,1644,344,202,546,20,566,1077,52.55%,31.94%,1
新北市,樹林區,1645,334,219,553,21,574,1103,52.04%,30.28%,1
新北市,樹林區,1646,469,267,736,35,771,1385,55.67%,33.86%,1
新北市,樹林區,1647,423,230,653,24,677,1266,53.48%,33.41%,1
新北市,樹林區,1648,374,250,624,30,654,1195,54.73%,31.3%,1
新北市,樹林區,1649,412,241,653,32,685,1254,54.63%,32.85%,1
新北市,樹林區,1650,445,251,696,34,730,1263,57.8%,35.23%,1
新北市,樹林區,1651,531,319,850,53,903,1473,61.3%,36.05%,1
新北市,樹林區,1652,328,157,485,18,503,870,57.82%,37.7%,1
新北市,樹林區,1653,520,258,778,42,820,1338,61.29%,38.86%,1
新北市,樹林區,1654,359,173,532,30,562,1010,55.64%,35.54%,1
新北市,樹林區,1655,563,370,933,45,978,1658,58.99%,33.96%,1
新北市,樹林區,1656,571,364,935,36,971,1538,63.13%,37.13%,1
新北市,樹林區,1657,542,288,830,55,885,1405,62.99%,38.58%,1
新北市,樹林區,1658,533,323,856,33,889,1587,56.02%,33.59%,1
新北市,樹林區,1659,553,308,861,28,889,1566,56.77%,35.31%,1
新北市,樹林區,1660,351,174,525,14,539,997,54.06%,35.21%,1
新北市,樹林區,1661,415,233,648,39,687,1187,57.88%,34.96%,1
新北市,樹林區,1662,353,199,552,29,581,1061,54.76%,33.27%,1
新北市,樹林區,1663,650,307,957,24,981,1701,57.67%,38.21%,1
新北市,樹林區,1664,470,219,689,36,725,1278,56.73%,36.78%,1
新北市,樹林區,1665,555,280,835,39,874,1433,60.99%,38.73%,1
新北市,樹林區,1666,503,256,759,44,803,1306,61.49%,38.51%,1
新北市,樹林區,1667,473,255,728,46,774,1268,61.04%,37.3%,1
新北市,樹林區,1668,469,280,749,28,777,1281,60.66%,36.61%,1
新北市,樹林區,1669,427,256,683,33,716,1200,59.67%,35.58%,1
新北市,樹林區,1670,524,245,769,32,801,1491,53.72%,35.14%,1
新北市,樹林區,1671,371,185,556,21,577,1066,54.13%,34.8%,1
新北市,樹林區,1672,347,170,517,42,559,877,63.74%,39.57%,1
新北市,樹林區,1673,575,255,830,47,877,1616,54.27%,35.58%,1
新北市,樹林區,1674,500,225,725,32,757,1589,47.64%,31.47%,1
新北市,樹林區,1675,505,253,758,35,793,1367,58.01%,36.94%,1
新北市,樹林區,1676,435,225,660,30,690,1144,60.31%,38.02%,1
新北市,樹林區,1677,395,160,555,19,574,1059,54.2%,37.3%,1
新北市,樹林區,1678,402,232,634,44,678,1224,55.39%,32.84%,1
新北市,樹林區,1679,345,210,555,25,580,1141,50.83%,30.24%,1
新北市,樹林區,1680,417,226,643,17,660,1396,47.28%,29.87%,1
新北市,樹林區,1681,353,252,605,32,637,1157,55.06%,30.51%,1
新北市,樹林區,1682,448,271,719,50,769,1498,51.34%,29.91%,1
新北市,樹林區,1683,492,281,773,58,831,1514,54.89%,32.5%,1
新北市,樹林區,1684,498,259,757,26,783,1546,50.65%,32.21%,1
新北市,樹林區,1685,481,273,754,30,784,1392,56.32%,34.55%,1
新北市,樹林區,1686,577,282,859,28,887,1566,56.64%,36.85%,1
新北市,樹林區,1687,545,297,842,19,861,1566,54.98%,34.8%,1
新北市,樹林區,1688,504,284,788,39,827,1517,54.52%,33.22%,1
新北市,樹林區,1689,504,285,789,28,817,1481,55.17%,34.03%,1
新北市,樹林區,1690,439,216,655,32,687,1261,54.48%,34.81%,1
新北市,樹林區,1691,389,209,598,20,618,1163,53.14%,33.45%,1
新北市,樹林區,1692,618,333,951,49,1000,1661,60.2%,37.21%,1
新北市,樹林區,1693,540,325,865,35,900,1585,56.78%,34.07%,1
新北市,樹林區,1694,411,171,582,34,616,1018,60.51%,40.37%,1
新北市,樹林區,1695,435,204,639,59,698,1247,55.97%,34.88%,1
新北市,樹林區,1696,489,213,702,53,755,1390,54.32%,35.18%,1
新北市,樹林區,1697,450,263,713,33,746,1293,57.7%,34.8%,1
新北市,樹林區,1698,424,245,669,20,689,1301,52.96%,32.59%,1
新北市,樹林區,1699,514,299,813,40,853,1606,53.11%,32%,1
新北市,樹林區,1700,426,218,644,57,701,1277,54.89%,33.36%,1
新北市,樹林區,1701,413,247,660,37,697,1219,57.18%,33.88%,1
新北市,樹林區,1702,498,244,742,30,772,1454,53.09%,34.25%,1
新北市,樹林區,1703,469,210,679,23,702,1314,53.42%,35.69%,1
新北市,樹林區,1704,409,210,619,19,638,1008,63.29%,40.58%,1
新北市,樹林區,1705,517,276,793,56,849,1574,53.94%,32.85%,1
新北市,樹林區,1706,517,256,773,23,796,1364,58.36%,37.9%,1
新北市,樹林區,1707,562,254,816,44,860,1677,51.28%,33.51%,1
新北市,樹林區,1708,511,255,766,19,785,1683,46.64%,30.36%,1
新北市,樹林區,1709,536,263,799,47,846,1452,58.26%,36.91%,1
新北市,樹林區,1710,581,329,910,17,927,1592,58.23%,36.49%,1
新北市,樹林區,1711,610,309,919,23,942,1619,58.18%,37.68%,1
新北市,樹林區,1712,668,308,976,25,1001,1642,60.96%,40.68%,1
新北市,樹林區,1713,477,270,747,14,761,1357,56.08%,35.15%,1
新北市,樹林區,1714,582,311,893,52,945,1638,57.69%,35.53%,1
新北市,樹林區,1715,528,321,849,29,878,1592,55.15%,33.17%,1
新北市,樹林區,1716,599,256,855,30,885,1521,58.19%,39.38%,1
新北市,樹林區,1717,659,343,1002,33,1035,1707,60.63%,38.61%,1
新北市,樹林區,1718,636,345,981,31,1012,1741,58.13%,36.53%,1
新北市,樹林區,1719,589,314,903,26,929,1655,56.13%,35.59%,1
新北市,樹林區,1720,575,302,877,36,913,1775,51.44%,32.39%,1
新北市,樹林區,1721,673,282,955,32,987,1781,55.42%,37.79%,1
新北市,樹林區,1722,470,257,727,31,758,1565,48.43%,30.03%,1
新北市,樹林區,1723,294,179,473,30,503,936,53.74%,31.41%,1
新北市,樹林區,1724,374,204,578,19,597,1030,57.96%,36.31%,1
新北市,鶯歌區,1725,198,93,291,9,300,515,58.25%,38.45%,1
新北市,鶯歌區,1726,351,204,555,30,585,965,60.62%,36.37%,1
新北市,鶯歌區,1727,650,357,1007,58,1065,1931,55.15%,33.66%,1
新北市,鶯歌區,1728,560,306,866,30,896,1797,49.86%,31.16%,1
新北市,鶯歌區,1729,373,190,563,37,600,1057,56.76%,35.29%,1
新北市,鶯歌區,1730,312,177,489,14,503,962,52.29%,32.43%,1
新北市,鶯歌區,1731,378,194,572,14,586,934,62.74%,40.47%,1
新北市,鶯歌區,1732,671,352,1023,35,1058,1742,60.73%,38.52%,1
新北市,鶯歌區,1733,546,301,847,29,876,1634,53.61%,33.41%,1
新北市,鶯歌區,1734,542,296,838,18,856,1676,51.07%,32.34%,1
新北市,鶯歌區,1735,679,411,1090,49,1139,2052,55.51%,33.09%,1
新北市,鶯歌區,1736,587,334,921,25,946,1977,47.85%,29.69%,1
新北市,鶯歌區,1737,669,377,1046,18,1064,1957,54.37%,34.18%,1
新北市,鶯歌區,1738,296,131,427,16,443,850,52.12%,34.82%,1
新北市,鶯歌區,1739,584,289,873,41,914,1782,51.29%,32.77%,1
新北市,鶯歌區,1740,494,270,764,37,801,1496,53.54%,33.02%,1
新北市,鶯歌區,1741,673,325,998,31,1029,2071,49.69%,32.5%,1
新北市,鶯歌區,1742,487,266,753,36,789,1753,45.01%,27.78%,1
新北市,鶯歌區,1743,601,277,878,28,906,1737,52.16%,34.6%,1
新北市,鶯歌區,1744,541,274,815,33,848,1669,50.81%,32.41%,1
新北市,鶯歌區,1745,512,296,808,42,850,1842,46.15%,27.8%,1
新北市,鶯歌區,1746,472,253,725,23,748,1454,51.44%,32.46%,1
新北市,鶯歌區,1747,300,185,485,24,509,942,54.03%,31.85%,1
新北市,鶯歌區,1748,402,252,654,49,703,1317,53.38%,30.52%,1
新北市,鶯歌區,1749,307,147,454,18,472,949,49.74%,32.35%,1
新北市,鶯歌區,1750,542,272,814,36,850,1440,59.03%,37.64%,1
新北市,鶯歌區,1751,617,324,941,50,991,1809,54.78%,34.11%,1
新北市,鶯歌區,1752,619,328,947,41,988,1758,56.2%,35.21%,1
新北市,鶯歌區,1753,565,267,832,35,867,1589,54.56%,35.56%,1
新北市,鶯歌區,1754,392,215,607,33,640,1067,59.98%,36.74%,1
新北市,鶯歌區,1755,407,212,619,27,646,1092,59.16%,37.27%,1
新北市,鶯歌區,1756,645,283,928,39,967,1730,55.9%,37.28%,1
新北市,鶯歌區,1757,498,194,692,22,714,1281,55.74%,38.88%,1
新北市,鶯歌區,1758,488,253,741,31,772,1238,62.36%,39.42%,1
新北市,鶯歌區,1759,524,293,817,52,869,1568,55.42%,33.42%,1
新北市,鶯歌區,1760,438,218,656,29,685,1271,53.89%,34.46%,1
新北市,鶯歌區,1761,351,166,517,17,534,1183,45.14%,29.67%,1
新北市,鶯歌區,1762,331,170,501,17,518,1026,50.49%,32.26%,1
新北市,鶯歌區,1763,535,298,833,31,864,1721,50.2%,31.09%,1
新北市,鶯歌區,1764,419,217,636,50,686,1317,52.09%,31.81%,1
新北市,鶯歌區,1765,373,219,592,36,628,1046,60.04%,35.66%,1
新北市,鶯歌區,1766,404,247,651,40,691,1144,60.4%,35.31%,1
新北市,鶯歌區,1767,432,218,650,50,700,1336,52.4%,32.34%,1
新北市,鶯歌區,1768,466,215,681,34,715,1479,48.34%,31.51%,1
新北市,鶯歌區,1769,549,296,845,56,901,1736,51.9%,31.62%,1
新北市,鶯歌區,1770,498,363,861,47,908,1389,65.37%,35.85%,1
新北市,鶯歌區,1771,641,323,964,65,1029,1956,52.61%,32.77%,1
新北市,鶯歌區,1772,440,282,722,42,764,1371,55.73%,32.09%,1
新北市,鶯歌區,1773,475,232,707,26,733,1810,40.5%,26.24%,1
新北市,鶯歌區,1774,92,35,127,2,129,227,56.83%,40.53%,1
新北市,三峽區,1917,118,48,166,21,187,274,68.25%,43.07%,1
新北市,三峽區,1918,213,93,306,17,323,583,55.4%,36.54%,1
新北市,三峽區,1919,521,281,802,20,822,1765,46.57%,29.52%,1
新北市,三峽區,1920,570,302,872,34,906,1714,52.86%,33.26%,1
新北市,三峽區,1921,470,219,689,22,711,1355,52.47%,34.69%,1
新北市,三峽區,1922,479,245,724,31,755,1329,56.81%,36.04%,1
新北市,三峽區,1923,348,181,529,34,563,1059,53.16%,32.86%,1
新北市,三峽區,1924,483,271,754,31,785,1364,57.55%,35.41%,1
新北市,三峽區,1925,414,208,622,24,646,1098,58.83%,37.7%,1
新北市,三峽區,1926,440,248,688,28,716,1296,55.25%,33.95%,1
新北市,三峽區,1927,390,245,635,32,667,1240,53.79%,31.45%,1
新北市,三峽區,1928,486,301,787,27,814,1531,53.17%,31.74%,1
新北市,三峽區,1929,470,236,706,18,724,1444,50.14%,32.55%,1
新北市,三峽區,1930,449,237,686,49,735,1347,54.57%,33.33%,1
新北市,三峽區,1931,500,252,752,40,792,1455,54.43%,34.36%,1
新北市,三峽區,1932,457,250,707,27,734,1556,47.17%,29.37%,1
新北市,三峽區,1933,385,217,602,23,625,1390,44.96%,27.7%,1
新北市,三峽區,1934,514,277,791,27,818,1532,53.39%,33.55%,1
新北市,三峽區,1935,433,197,630,43,673,1377,48.87%,31.45%,1
新北市,三峽區,1936,588,281,869,30,899,1731,51.94%,33.97%,1
新北市,三峽區,1937,543,305,848,17,865,1705,50.73%,31.85%,1
新北市,三峽區,1938,543,310,853,28,881,1590,55.41%,34.15%,1
新北市,三峽區,1939,612,313,925,24,949,1650,57.52%,37.09%,1
新北市,三峽區,1940,504,272,776,21,797,1441,55.31%,34.98%,1
新北市,三峽區,1941,540,258,798,17,815,1404,58.05%,38.46%,1
新北市,三峽區,1942,476,274,750,22,772,1295,59.61%,36.76%,1
新北市,三峽區,1943,441,211,652,23,675,1348,50.07%,32.72%,1
新北市,三峽區,1944,574,291,865,12,877,1579,55.54%,36.35%,1
新北市,三峽區,1945,509,238,747,22,769,1435,53.59%,35.47%,1
新北市,三峽區,1946,645,290,935,32,967,1659,58.29%,38.88%,1
新北市,三峽區,1947,581,317,898,19,917,1512,60.65%,38.43%,1
新北市,三峽區,1948,569,267,836,20,856,1463,58.51%,38.89%,1
新北市,三峽區,1949,545,291,836,21,857,1465,58.5%,37.2%,1
新北市,三峽區,1950,580,270,850,11,861,1463,58.85%,39.64%,1
新北市,三峽區,1951,551,257,808,26,834,1443,57.8%,38.18%,1
新北市,三峽區,1952,520,282,802,29,831,1634,50.86%,31.82%,1
新北市,三峽區,1953,622,298,920,31,951,1716,55.42%,36.25%,1
新北市,三峽區,1954,567,284,851,23,874,1675,52.18%,33.85%,1
新北市,三峽區,1955,475,242,717,31,748,1649,45.36%,28.81%,1
新北市,三峽區,1956,503,249,752,37,789,1489,52.99%,33.78%,1
新北市,三峽區,1957,537,303,840,29,869,1771,49.07%,30.32%,1
新北市,三峽區,1958,570,353,923,22,945,1726,54.75%,33.02%,1
新北市,三峽區,1959,456,239,695,35,730,1363,53.56%,33.46%,1
新北市,三峽區,1960,566,304,870,20,890,1624,54.8%,34.85%,1
新北市,三峽區,1961,470,262,732,28,760,1352,56.21%,34.76%,1
新北市,三峽區,1962,413,252,665,12,677,1608,42.1%,25.68%,1
新北市,三峽區,1963,481,273,754,28,782,1458,53.64%,32.99%,1
新北市,三峽區,1964,499,271,770,38,808,1641,49.24%,30.41%,1
新北市,三峽區,1965,487,245,732,73,805,1530,52.61%,31.83%,1
新北市,三峽區,1966,392,201,593,29,622,1389,44.78%,28.22%,1
新北市,三峽區,1967,397,218,615,49,664,1315,50.49%,30.19%,1
新北市,三峽區,1968,407,137,544,26,570,934,61.03%,43.58%,1
新北市,三峽區,1969,403,204,607,24,631,1270,49.69%,31.73%,1
新北市,三峽區,1970,276,141,417,42,459,929,49.41%,29.71%,1
新北市,三峽區,1971,371,161,532,12,544,1035,52.56%,35.85%,1
新北市,三峽區,1972,170,71,241,10,251,502,50%,33.86%,1
新北市,三峽區,1973,258,122,380,35,415,836,49.64%,30.86%,1
新北市,三峽區,1974,190,95,285,45,330,669,49.33%,28.4%,1
新北市,三峽區,1975,254,116,370,72,442,733,60.3%,34.65%,1
新北市,三峽區,1976,645,251,896,38,934,1560,59.87%,41.35%,1
新北市,三峽區,1977,544,264,808,41,849,1638,51.83%,33.21%,1
新北市,三峽區,1978,508,188,696,26,722,1394,51.79%,36.44%,1
新北市,三峽區,1979,257,167,424,22,446,771,57.85%,33.33%,1
新北市,三峽區,1980,456,232,688,21,709,1367,51.87%,33.36%,1
新北市,三峽區,1981,401,197,598,49,647,1241,52.14%,32.31%,1
新北市,三峽區,1982,492,238,730,21,751,1520,49.41%,32.37%,1
新北市,三峽區,1983,374,153,527,32,559,873,64.03%,42.84%,1
新北市,三峽區,1984,202,111,313,60,373,768,48.57%,26.3%,1
新北市,三峽區,1985,341,161,502,11,513,1097,46.76%,31.08%,1
新北市,三峽區,1986,372,183,555,38,593,1322,44.86%,28.14%,1
新北市,淡水區,0029,176,91,267,25,292,544,53.68%,32.35%,1
新北市,淡水區,0030,371,177,548,35,583,1044,55.84%,35.54%,1
新北市,淡水區,0031,484,208,692,45,737,1462,50.41%,33.11%,1
新北市,淡水區,0032,486,254,740,58,798,1525,52.33%,31.87%,1
新北市,淡水區,0033,320,131,451,29,480,986,48.68%,32.45%,1
新北市,淡水區,0034,304,136,440,20,460,806,57.07%,37.72%,1
新北市,淡水區,0035,419,165,584,72,656,1173,55.92%,35.72%,1
新北市,淡水區,0036,442,177,619,31,650,1343,48.4%,32.91%,1
新北市,淡水區,0037,319,193,512,13,525,1153,45.53%,27.67%,1
新北市,淡水區,0038,293,129,422,29,451,874,51.6%,33.52%,1
新北市,淡水區,0039,381,155,536,55,591,1063,55.6%,35.84%,1
新北市,淡水區,0040,455,188,643,22,665,1309,50.8%,34.76%,1
新北市,淡水區,0041,426,231,657,36,693,1290,53.72%,33.02%,1
新北市,淡水區,0042,631,304,935,20,955,1675,57.01%,37.67%,1
新北市,淡水區,0043,549,298,847,34,881,1589,55.44%,34.55%,1
新北市,淡水區,0044,571,342,913,27,940,1624,57.88%,35.16%,1
新北市,淡水區,0045,380,252,632,32,664,1241,53.51%,30.62%,1
新北市,淡水區,0046,466,215,681,34,715,1317,54.29%,35.38%,1
新北市,淡水區,0047,476,226,702,18,720,1225,58.78%,38.86%,1
新北市,淡水區,0048,463,273,736,42,778,1426,54.56%,32.47%,1
新北市,淡水區,0049,561,332,893,29,922,1610,57.27%,34.84%,1
新北市,淡水區,0050,666,407,1073,33,1106,1982,55.8%,33.6%,1
新北市,淡水區,0051,565,313,878,28,906,1924,47.09%,29.37%,1
新北市,淡水區,0052,563,324,887,26,913,1822,50.11%,30.9%,1
新北市,淡水區,0053,419,272,691,45,736,1232,59.74%,34.01%,1
新北市,淡水區,0054,593,277,870,39,909,1588,57.24%,37.34%,1
新北市,淡水區,0055,573,302,875,27,902,1784,50.56%,32.12%,1
新北市,淡水區,0056,536,338,874,54,928,1762,52.67%,30.42%,1
新北市,淡水區,0057,484,320,804,28,832,1546,53.82%,31.31%,1
新北市,淡水區,0058,601,382,983,25,1008,1897,53.14%,31.68%,1
新北市,淡水區,0059,484,287,771,27,798,1489,53.59%,32.51%,1
新北市,淡水區,0060,552,294,846,23,869,1679,51.76%,32.88%,1
新北市,淡水區,0061,515,304,819,29,848,1693,50.09%,30.42%,1
新北市,淡水區,0062,591,245,836,14,850,1674,50.78%,35.3%,1
新北市,淡水區,0063,468,246,714,13,727,1330,54.66%,35.19%,1
新北市,淡水區,0064,475,267,742,24,766,1467,52.22%,32.38%,1
新北市,淡水區,0065,654,296,950,29,979,1837,53.29%,35.6%,1
新北市,淡水區,0066,396,241,637,14,651,1924,33.84%,20.58%,1
新北市,淡水區,0067,756,395,1151,26,1177,2340,50.3%,32.31%,1
新北市,淡水區,0068,545,226,771,29,800,1704,46.95%,31.98%,1
新北市,淡水區,0069,436,254,690,31,721,1363,52.9%,31.99%,1
新北市,淡水區,0070,908,483,1391,26,1417,3068,46.19%,29.6%,1
新北市,淡水區,0071,500,234,734,34,768,1528,50.26%,32.72%,1
新北市,淡水區,0072,524,283,807,31,838,1600,52.38%,32.75%,1
新北市,淡水區,0073,678,331,1009,46,1055,1874,56.3%,36.18%,1
新北市,淡水區,0074,519,279,798,37,835,1567,53.29%,33.12%,1
新北市,淡水區,0075,398,275,673,31,704,1245,56.55%,31.97%,1
新北市,淡水區,0076,381,240,621,16,637,1211,52.6%,31.46%,1
新北市,淡水區,0077,706,383,1089,25,1114,1992,55.92%,35.44%,1
新北市,淡水區,0078,740,372,1112,20,1132,2028,55.82%,36.49%,1
新北市,淡水區,0079,517,223,740,41,781,1373,56.88%,37.65%,1
新北市,淡水區,0080,576,345,921,19,940,1732,54.27%,33.26%,1
新北市,淡水區,0081,455,285,740,29,769,1519,50.63%,29.95%,1
新北市,淡水區,0082,542,283,825,18,843,1727,48.81%,31.38%,1
新北市,淡水區,0083,477,237,714,21,735,1297,56.67%,36.78%,1
新北市,淡水區,0084,358,177,535,39,574,1066,53.85%,33.58%,1
新北市,淡水區,0085,512,237,749,37,786,1387,56.67%,36.91%,1
新北市,淡水區,0086,680,327,1007,37,1044,1909,54.69%,35.62%,1
新北市,淡水區,0087,588,336,924,33,957,1770,54.07%,33.22%,1
新北市,淡水區,0088,645,324,969,28,997,2049,48.66%,31.48%,1
新北市,淡水區,0089,554,326,880,28,908,1680,54.05%,32.98%,1
新北市,淡水區,0090,506,301,807,42,849,1433,59.25%,35.31%,1
新北市,淡水區,0091,443,267,710,24,734,1365,53.77%,32.45%,1
新北市,淡水區,0092,619,144,763,39,802,1452,55.23%,42.63%,1
新北市,淡水區,0093,616,307,923,37,960,1804,53.22%,34.15%,1
新北市,淡水區,0094,460,236,696,31,727,1322,54.99%,34.8%,1
新北市,淡水區,0095,663,393,1056,27,1083,2019,53.64%,32.84%,1
新北市,淡水區,0096,706,335,1041,31,1072,1696,63.21%,41.63%,1
新北市,淡水區,0097,558,299,857,23,880,1576,55.84%,35.41%,1
新北市,淡水區,0098,615,364,979,29,1008,1781,56.6%,34.53%,1
新北市,淡水區,0099,580,350,930,44,974,1665,58.5%,34.83%,1
新北市,淡水區,0100,688,350,1038,39,1077,2013,53.5%,34.18%,1
新北市,淡水區,0101,349,217,566,31,597,1108,53.88%,31.5%,1
新北市,淡水區,0102,461,235,696,31,727,1305,55.71%,35.33%,1
新北市,淡水區,0103,439,202,641,25,666,1199,55.55%,36.61%,1
新北市,淡水區,0104,675,364,1039,26,1065,2017,52.8%,33.47%,1
新北市,淡水區,0105,631,379,1010,35,1045,2125,49.18%,29.69%,1
新北市,淡水區,0106,385,213,598,16,614,1289,47.63%,29.87%,1
新北市,淡水區,0107,511,239,750,37,787,1319,59.67%,38.74%,1
新北市,淡水區,0108,411,186,597,22,619,1051,58.9%,39.11%,1
新北市,淡水區,0109,485,241,726,17,743,1348,55.12%,35.98%,1
新北市,淡水區,0110,378,182,560,27,587,1106,53.07%,34.18%,1
新北市,淡水區,0111,270,130,400,21,421,717,58.72%,37.66%,1
新北市,淡水區,0112,444,285,729,21,750,1385,54.15%,32.06%,1
新北市,淡水區,0113,304,175,479,28,507,841,60.29%,36.15%,1
新北市,淡水區,0114,252,117,369,17,386,665,58.05%,37.89%,1
新北市,淡水區,0115,152,90,242,12,254,419,60.62%,36.28%,1
新北市,淡水區,0116,591,283,874,27,901,1599,56.35%,36.96%,1
新北市,淡水區,0117,532,301,833,52,885,1670,52.99%,31.86%,1
新北市,淡水區,0118,592,328,920,36,956,1683,56.8%,35.18%,1
新北市,淡水區,0119,524,264,788,32,820,1577,52%,33.23%,1
新北市,淡水區,0120,528,256,784,33,817,1618,50.49%,32.63%,1
新北市,淡水區,0121,690,327,1017,33,1050,2214,47.43%,31.17%,1
新北市,淡水區,0122,608,317,925,33,958,1832,52.29%,33.19%,1
新北市,淡水區,0123,714,377,1091,33,1124,2123,52.94%,33.63%,1
新北市,淡水區,0124,915,356,1271,23,1294,2998,43.16%,30.52%,1
新北市,汐止區,2336,545,274,819,57,876,1595,54.92%,34.17%,1
新北市,汐止區,2337,448,222,670,38,708,1262,56.1%,35.5%,1
新北市,汐止區,2338,283,211,494,47,541,917,59%,30.86%,1
新北市,汐止區,2339,667,376,1043,33,1076,1929,55.78%,34.58%,1
新北市,汐止區,2340,703,440,1143,42,1185,2227,53.21%,31.57%,1
新北市,汐止區,2341,357,223,580,46,626,1143,54.77%,31.23%,1
新北市,汐止區,2342,483,257,740,25,765,1367,55.96%,35.33%,1
新北市,汐止區,2343,91,72,163,14,177,322,54.97%,28.26%,1
新北市,汐止區,2344,497,307,804,6,810,1460,55.48%,34.04%,1
新北市,汐止區,2345,528,331,859,25,884,1719,51.43%,30.72%,1
新北市,汐止區,2346,583,265,848,35,883,1661,53.16%,35.1%,1
新北市,汐止區,2347,558,309,867,34,901,1590,56.67%,35.09%,1
新北市,汐止區,2348,561,289,850,33,883,1599,55.22%,35.08%,1
新北市,汐止區,2349,604,334,938,34,972,1749,55.57%,34.53%,1
新北市,汐止區,2350,208,130,338,18,356,1809,19.68%,11.5%,1
新北市,汐止區,2351,470,284,754,26,780,1601,48.72%,29.36%,1
新北市,汐止區,2352,470,226,696,43,739,1387,53.28%,33.89%,1
新北市,汐止區,2353,564,378,942,54,996,1779,55.99%,31.7%,1
新北市,汐止區,2354,737,376,1113,44,1157,2074,55.79%,35.54%,1
新北市,汐止區,2355,684,405,1089,30,1119,2072,54.01%,33.01%,1
新北市,汐止區,2356,762,423,1185,54,1239,2120,58.44%,35.94%,1
新北市,汐止區,2357,670,375,1045,25,1070,1952,54.82%,34.32%,1
新北市,汐止區,2358,546,287,833,49,882,1654,53.33%,33.01%,1
新北市,汐止區,2359,473,254,727,39,766,1444,53.05%,32.76%,1
新北市,汐止區,2360,597,341,938,27,965,1627,59.31%,36.69%,1
新北市,汐止區,2361,574,297,871,47,918,1751,52.43%,32.78%,1
新北市,汐止區,2362,648,399,1047,34,1081,2066,52.32%,31.36%,1
新北市,汐止區,2363,545,295,840,38,878,1941,45.23%,28.08%,1
新北市,汐止區,2364,534,356,890,28,918,1906,48.16%,28.02%,1
新北市,汐止區,2365,432,240,672,46,718,1363,52.68%,31.69%,1
新北市,汐止區,2366,438,235,673,31,704,1368,51.46%,32.02%,1
新北市,汐止區,2367,369,210,579,35,614,1233,49.8%,29.93%,1
新北市,汐止區,2368,517,281,798,25,823,1554,52.96%,33.27%,1
新北市,汐止區,2369,551,343,894,33,927,1700,54.53%,32.41%,1
新北市,汐止區,2370,379,232,611,20,631,1124,56.14%,33.72%,1
新北市,汐止區,2371,643,409,1052,36,1088,1900,57.26%,33.84%,1
新北市,汐止區,2372,687,367,1054,42,1096,2050,53.46%,33.51%,1
新北市,汐止區,2373,370,259,629,41,670,1244,53.86%,29.74%,1
新北市,汐止區,2374,434,215,649,25,674,1320,51.06%,32.88%,1
新北市,汐止區,2375,509,284,793,39,832,1473,56.48%,34.56%,1
新北市,汐止區,2376,643,312,955,39,994,1802,55.16%,35.68%,1
新北市,汐止區,2377,490,230,720,22,742,1266,58.61%,38.7%,1
新北市,汐止區,2378,443,244,687,51,738,1481,49.83%,29.91%,1
新北市,汐止區,2379,448,285,733,45,778,1497,51.97%,29.93%,1
新北市,汐止區,2380,200,101,301,18,319,556,57.37%,35.97%,1
新北市,汐止區,2381,596,322,918,45,963,1913,50.34%,31.16%,1
新北市,汐止區,2382,612,369,981,35,1016,2027,50.12%,30.19%,1
新北市,汐止區,2383,566,347,913,34,947,1927,49.14%,29.37%,1
新北市,汐止區,2384,226,130,356,31,387,696,55.6%,32.47%,1
新北市,汐止區,2385,618,386,1004,51,1055,2127,49.6%,29.06%,1
新北市,汐止區,2386,467,273,740,38,778,1642,47.38%,28.44%,1
新北市,汐止區,2387,623,316,939,62,1001,1912,52.35%,32.58%,1
新北市,汐止區,2388,526,314,840,40,880,1893,46.49%,27.79%,1
新北市,汐止區,2389,443,236,679,38,717,1466,48.91%,30.22%,1
新北市,汐止區,2390,517,222,739,51,790,1538,51.37%,33.62%,1
新北市,汐止區,2391,474,285,759,25,784,1550,50.58%,30.58%,1
新北市,汐止區,2392,472,235,707,45,752,1456,51.65%,32.42%,1
新北市,汐止區,2393,265,274,539,37,576,947,60.82%,27.98%,1
新北市,汐止區,2394,314,192,506,19,525,923,56.88%,34.02%,1
新北市,汐止區,2395,638,328,966,64,1030,2043,50.42%,31.23%,1
新北市,汐止區,2396,593,312,905,63,968,2012,48.11%,29.47%,1
新北市,汐止區,2397,462,215,677,26,703,1471,47.79%,31.41%,1
新北市,汐止區,2398,496,288,784,31,815,1603,50.84%,30.94%,1
新北市,汐止區,2399,503,273,776,48,824,1530,53.86%,32.88%,1
新北市,汐止區,2400,579,275,854,33,887,1988,44.62%,29.12%,1
新北市,汐止區,2401,667,392,1059,35,1094,2198,49.77%,30.35%,1
新北市,汐止區,2402,556,279,835,29,864,1712,50.47%,32.48%,1
新北市,汐止區,2403,621,350,971,38,1009,1806,55.87%,34.39%,1
新北市,汐止區,2404,534,252,786,57,843,1576,53.49%,33.88%,1
新北市,汐止區,2405,475,258,733,31,764,1511,50.56%,31.44%,1
新北市,汐止區,2406,526,285,811,25,836,1691,49.44%,31.11%,1
新北市,汐止區,2407,572,267,839,34,873,1636,53.36%,34.96%,1
新北市,汐止區,2408,548,293,841,26,867,1676,51.73%,32.7%,1
新北市,汐止區,2409,435,209,644,19,663,1264,52.45%,34.41%,1
新北市,汐止區,2410,421,179,600,17,617,1165,52.96%,36.14%,1
新北市,汐止區,2411,557,294,851,43,894,1765,50.65%,31.56%,1
新北市,汐止區,2412,537,259,796,23,819,1815,45.12%,29.59%,1
新北市,汐止區,2413,544,289,833,53,886,1778,49.83%,30.6%,1
新北市,汐止區,2414,547,288,835,36,871,1580,55.13%,34.62%,1
新北市,汐止區,2415,481,289,770,35,805,1516,53.1%,31.73%,1
新北市,汐止區,2416,462,219,681,25,706,1425,49.54%,32.42%,1
新北市,汐止區,2417,481,244,725,39,764,1388,55.04%,34.65%,1
新北市,汐止區,2418,488,259,747,42,789,1436,54.94%,33.98%,1
新北市,汐止區,2419,482,328,810,29,839,1591,52.73%,30.3%,1
新北市,汐止區,2420,492,296,788,26,814,1639,49.66%,30.02%,1
新北市,汐止區,2421,439,250,689,14,703,1394,50.43%,31.49%,1
新北市,汐止區,2422,591,380,971,27,998,2035,49.04%,29.04%,1
新北市,汐止區,2423,641,323,964,30,994,1895,52.45%,33.83%,1
新北市,汐止區,2424,491,278,769,14,783,1374,56.99%,35.74%,1
新北市,汐止區,2425,369,238,607,19,626,1061,59%,34.78%,1
新北市,汐止區,2426,523,288,811,21,832,1312,63.41%,39.86%,1
新北市,汐止區,2427,538,285,823,30,853,1548,55.1%,34.75%,1
新北市,汐止區,2428,481,273,754,17,771,1350,57.11%,35.63%,1
新北市,汐止區,2429,487,305,792,25,817,1499,54.5%,32.49%,1
新北市,汐止區,2430,494,263,757,34,791,1366,57.91%,36.16%,1
新北市,汐止區,2431,477,247,724,42,766,1335,57.38%,35.73%,1
新北市,汐止區,2432,513,264,777,34,811,1324,61.25%,38.75%,1
新北市,汐止區,2433,488,259,747,39,786,1286,61.12%,37.95%,1
新北市,汐止區,2434,376,229,605,33,638,1155,55.24%,32.55%,1
新北市,汐止區,2435,675,339,1014,32,1046,1682,62.19%,40.13%,1
新北市,汐止區,2436,592,286,878,44,922,1494,61.71%,39.63%,1
新北市,汐止區,2437,412,236,648,60,708,1166,60.72%,35.33%,1
新北市,汐止區,2438,728,415,1143,70,1213,2184,55.54%,33.33%,1
新北市,汐止區,2439,716,357,1073,51,1124,2031,55.34%,35.25%,1
新北市,汐止區,2440,614,314,928,50,978,1759,55.6%,34.91%,1
新北市,汐止區,2441,566,305,871,33,904,1577,57.32%,35.89%,1
新北市,汐止區,2442,489,238,727,19,746,1364,54.69%,35.85%,1
新北市,汐止區,2443,520,262,782,44,826,1401,58.96%,37.12%,1
新北市,汐止區,2444,409,259,668,31,699,1173,59.59%,34.87%,1
新北市,汐止區,2445,376,197,573,10,583,993,58.71%,37.87%,1
新北市,汐止區,2446,536,285,821,23,844,1587,53.18%,33.77%,1
新北市,瑞芳區,2220,279,113,392,30,422,725,58.21%,38.48%,1
新北市,瑞芳區,2221,365,210,575,35,610,1074,56.8%,33.99%,1
新北市,瑞芳區,2222,285,124,409,21,430,825,52.12%,34.55%,1
新北市,瑞芳區,2223,408,227,635,37,672,1242,54.11%,32.85%,1
新北市,瑞芳區,2224,201,97,298,27,325,598,54.35%,33.61%,1
新北市,瑞芳區,2225,299,147,446,21,467,872,53.56%,34.29%,1
新北市,瑞芳區,2226,218,123,341,28,369,760,48.55%,28.68%,1
新北市,瑞芳區,2227,367,236,603,32,635,1330,47.74%,27.59%,1
新北市,瑞芳區,2228,490,259,749,38,787,1683,46.76%,29.11%,1
新北市,瑞芳區,2229,327,151,478,40,518,980,52.86%,33.37%,1
新北市,瑞芳區,2230,323,149,472,32,504,946,53.28%,34.14%,1
新北市,瑞芳區,2231,437,162,599,28,627,1375,45.6%,31.78%,1
新北市,瑞芳區,2232,523,270,793,30,823,1671,49.25%,31.3%,1
新北市,瑞芳區,2233,299,123,422,23,445,978,45.5%,30.57%,1
新北市,瑞芳區,2234,92,195,287,27,314,645,48.68%,14.26%,1
新北市,瑞芳區,2235,327,178,505,52,557,1089,51.15%,30.03%,1
新北市,瑞芳區,2236,75,39,114,9,123,286,43.01%,26.22%,1
新北市,瑞芳區,2237,138,81,219,20,239,461,51.84%,29.93%,1
新北市,瑞芳區,2238,83,37,120,18,138,274,50.36%,30.29%,1
新北市,瑞芳區,2239,61,26,87,9,96,155,61.94%,39.35%,1
新北市,瑞芳區,2240,264,155,419,29,448,817,54.83%,32.31%,1
新北市,瑞芳區,2241,273,158,431,39,470,884,53.17%,30.88%,1
新北市,瑞芳區,2242,377,204,581,35,616,1333,46.21%,28.28%,1
新北市,瑞芳區,2243,172,84,256,7,263,607,43.33%,28.34%,1
新北市,瑞芳區,2244,354,161,515,39,554,1045,53.01%,33.88%,1
新北市,瑞芳區,2245,227,105,332,36,368,673,54.68%,33.73%,1
新北市,瑞芳區,2246,166,79,245,11,256,618,41.42%,26.86%,1
新北市,瑞芳區,2247,412,168,580,16,596,1063,56.07%,38.76%,1
新北市,瑞芳區,2248,281,152,433,36,469,860,54.53%,32.67%,1
新北市,瑞芳區,2249,78,53,131,6,137,432,31.71%,18.06%,1
新北市,瑞芳區,2250,131,39,170,9,179,445,40.22%,29.44%,1
新北市,瑞芳區,2251,97,33,130,8,138,318,43.4%,30.5%,1
新北市,瑞芳區,2252,55,17,72,5,77,159,48.43%,34.59%,1
新北市,瑞芳區,2253,98,39,137,10,147,337,43.62%,29.08%,1
新北市,瑞芳區,2254,61,32,93,6,99,180,55%,33.89%,1
新北市,瑞芳區,2255,50,21,71,11,82,187,43.85%,26.74%,1
新北市,瑞芳區,2256,134,47,181,10,191,369,51.76%,36.31%,1
新北市,瑞芳區,2257,121,48,169,19,188,335,56.12%,36.12%,1
新北市,瑞芳區,2258,122,70,192,15,207,470,44.04%,25.96%,1
新北市,瑞芳區,2259,80,29,109,6,115,297,38.72%,26.94%,1
新北市,瑞芳區,2260,127,47,174,6,180,267,67.42%,47.57%,1
新北市,瑞芳區,2261,188,62,250,10,260,876,29.68%,21.46%,1
新北市,瑞芳區,2262,314,142,456,24,480,1241,38.68%,25.3%,1
新北市,瑞芳區,2263,328,160,488,46,534,998,53.51%,32.87%,1
新北市,瑞芳區,2264,320,146,466,37,503,948,53.06%,33.76%,1
新北市,瑞芳區,2265,362,134,496,27,523,1308,39.98%,27.68%,1
新北市,土城區,1775,490,271,761,45,806,1505,53.55%,32.56%,1
新北市,土城區,1776,462,251,713,28,741,1242,59.66%,37.2%,1
新北市,土城區,1777,462,231,693,23,716,1206,59.37%,38.31%,1
新北市,土城區,1778,494,270,764,50,814,1474,55.22%,33.51%,1
新北市,土城區,1779,495,248,743,29,772,1489,51.85%,33.24%,1
新北市,土城區,1780,545,276,821,40,861,1675,51.4%,32.54%,1
新北市,土城區,1781,478,308,786,37,823,1499,54.9%,31.89%,1
新北市,土城區,1782,497,260,757,22,779,1495,52.11%,33.24%,1
新北市,土城區,1783,470,235,705,55,760,1411,53.86%,33.31%,1
新北市,土城區,1784,459,216,675,33,708,1378,51.38%,33.31%,1
新北市,土城區,1785,388,253,641,29,670,1256,53.34%,30.89%,1
新北市,土城區,1786,480,266,746,45,791,1379,57.36%,34.81%,1
新北市,土城區,1787,476,230,706,41,747,1424,52.46%,33.43%,1
新北市,土城區,1788,482,270,752,35,787,1455,54.09%,33.13%,1
新北市,土城區,1789,465,241,706,32,738,1419,52.01%,32.77%,1
新北市,土城區,1790,517,268,785,24,809,1357,59.62%,38.1%,1
新北市,土城區,1791,498,278,776,28,804,1501,53.56%,33.18%,1
新北市,土城區,1792,433,223,656,48,704,1206,58.37%,35.9%,1
新北市,土城區,1793,443,259,702,28,730,1255,58.17%,35.3%,1
新北市,土城區,1794,628,296,924,45,969,1869,51.85%,33.6%,1
新北市,土城區,1795,383,324,707,20,727,1292,56.27%,29.64%,1
新北市,土城區,1796,444,241,685,23,708,1324,53.47%,33.53%,1
新北市,土城區,1797,381,196,577,41,618,1155,53.51%,32.99%,1
新北市,土城區,1798,399,225,624,31,655,1183,55.37%,33.73%,1
新北市,土城區,1799,314,204,518,34,552,2518,21.92%,12.47%,1
新北市,土城區,1800,410,221,631,30,661,1218,54.27%,33.66%,1
新北市,土城區,1801,429,188,617,35,652,1133,57.55%,37.86%,1
新北市,土城區,1802,317,172,489,19,508,894,56.82%,35.46%,1
新北市,土城區,1803,330,181,511,38,549,931,58.97%,35.45%,1
新北市,土城區,1804,772,308,1080,58,1138,1820,62.53%,42.42%,1
新北市,土城區,1805,482,220,702,23,725,1320,54.92%,36.52%,1
新北市,土城區,1806,421,219,640,22,662,1241,53.34%,33.92%,1
新北市,土城區,1807,465,272,737,42,779,1414,55.09%,32.89%,1
新北市,土城區,1808,453,295,748,35,783,1378,56.82%,32.87%,1
新北市,土城區,1809,480,306,786,43,829,1421,58.34%,33.78%,1
新北市,土城區,1810,474,226,700,35,735,1340,54.85%,35.37%,1
新北市,土城區,1811,414,237,651,29,680,1144,59.44%,36.19%,1
新北市,土城區,1812,441,224,665,48,713,1268,56.23%,34.78%,1
新北市,土城區,1813,428,211,639,48,687,1196,57.44%,35.79%,1
新北市,土城區,1814,471,286,757,23,780,1308,59.63%,36.01%,1
新北市,土城區,1815,448,199,647,28,675,1175,57.45%,38.13%,1
新北市,土城區,1816,430,230,660,45,705,1230,57.32%,34.96%,1
新北市,土城區,1817,472,261,733,29,762,1342,56.78%,35.17%,1
新北市,土城區,1818,433,268,701,35,736,1268,58.04%,34.15%,1
新北市,土城區,1819,469,254,723,49,772,1227,62.92%,38.22%,1
新北市,土城區,1820,492,236,728,51,779,1356,57.45%,36.28%,1
新北市,土城區,1821,539,256,795,46,841,1496,56.22%,36.03%,1
新北市,土城區,1822,486,212,698,47,745,1309,56.91%,37.13%,1
新北市,土城區,1823,431,243,674,31,705,1175,60%,36.68%,1
新北市,土城區,1824,440,227,667,41,708,1237,57.24%,35.57%,1
新北市,土城區,1825,468,225,693,32,725,1256,57.72%,37.26%,1
新北市,土城區,1826,420,226,646,22,668,1228,54.4%,34.2%,1
新北市,土城區,1827,420,204,624,50,674,1182,57.02%,35.53%,1
新北市,土城區,1828,539,307,846,28,874,1558,56.1%,34.6%,1
新北市,土城區,1829,409,240,649,21,670,1160,57.76%,35.26%,1
新北市,土城區,1830,478,268,746,26,772,1357,56.89%,35.22%,1
新北市,土城區,1831,497,267,764,44,808,1464,55.19%,33.95%,1
新北市,土城區,1832,441,222,663,29,692,1335,51.84%,33.03%,1
新北市,土城區,1833,464,239,703,50,753,1346,55.94%,34.47%,1
新北市,土城區,1834,557,321,878,25,903,1435,62.93%,38.82%,1
新北市,土城區,1835,550,315,865,38,903,1639,55.09%,33.56%,1
新北市,土城區,1836,599,353,952,35,987,1728,57.12%,34.66%,1
新北市,土城區,1837,468,285,753,8,761,1665,45.71%,28.11%,1
新北市,土城區,1838,527,252,779,38,817,1333,61.29%,39.53%,1
新北市,土城區,1839,550,349,899,36,935,1567,59.67%,35.1%,1
新北市,土城區,1840,540,279,819,46,865,1576,54.89%,34.26%,1
新北市,土城區,1841,531,275,806,28,834,1458,57.2%,36.42%,1
新北市,土城區,1842,547,278,825,46,871,1517,57.42%,36.06%,1
新北市,土城區,1843,557,300,857,25,882,1489,59.23%,37.41%,1
新北市,土城區,1844,537,314,851,19,870,1463,59.47%,36.71%,1
新北市,土城區,1845,586,300,886,18,904,1584,57.07%,36.99%,1
新北市,土城區,1846,488,273,761,30,791,1464,54.03%,33.33%,1
新北市,土城區,1847,559,301,860,38,898,1598,56.2%,34.98%,1
新北市,土城區,1848,461,304,765,36,801,1500,53.4%,30.73%,1
新北市,土城區,1849,523,292,815,31,846,1542,54.86%,33.92%,1
新北市,土城區,1850,564,348,912,46,958,1619,59.17%,34.84%,1
新北市,土城區,1851,492,268,760,34,794,1521,52.2%,32.35%,1
新北市,土城區,1852,534,374,908,19,927,1691,54.82%,31.58%,1
新北市,土城區,1853,524,330,854,36,890,1657,53.71%,31.62%,1
新北市,土城區,1854,610,400,1010,22,1032,1772,58.24%,34.42%,1
新北市,土城區,1855,517,268,785,24,809,1423,56.85%,36.33%,1
新北市,土城區,1856,480,297,777,34,811,1321,61.39%,36.34%,1
新北市,土城區,1857,528,298,826,41,867,1429,60.67%,36.95%,1
新北市,土城區,1858,489,259,748,31,779,1445,53.91%,33.84%,1
新北市,土城區,1859,578,285,863,28,891,1520,58.62%,38.03%,1
新北市,土城區,1860,436,255,691,13,704,1484,47.44%,29.38%,1
新北市,土城區,1861,447,262,709,19,728,1362,53.45%,32.82%,1
新北市,土城區,1862,446,232,678,22,700,1262,55.47%,35.34%,1
新北市,土城區,1863,477,268,745,32,777,1343,57.86%,35.52%,1
新北市,土城區,1864,378,252,630,27,657,1337,49.14%,28.27%,1
新北市,土城區,1865,360,204,564,29,593,1325,44.75%,27.17%,1
新北市,土城區,1866,440,236,676,33,709,1390,51.01%,31.65%,1
新北市,土城區,1867,496,303,799,33,832,1534,54.24%,32.33%,1
新北市,土城區,1868,470,268,738,52,790,1484,53.23%,31.67%,1
新北市,土城區,1869,440,265,705,93,798,1532,52.09%,28.72%,1
新北市,土城區,1870,538,301,839,36,875,1507,58.06%,35.7%,1
新北市,土城區,1871,558,280,838,32,870,1550,56.13%,36%,1
新北市,土城區,1872,587,255,842,28,870,1567,55.52%,37.46%,1
新北市,土城區,1873,487,264,751,33,784,1367,57.35%,35.63%,1
新北市,土城區,1874,433,223,656,35,691,1293,53.44%,33.49%,1
新北市,土城區,1875,472,285,757,33,790,1402,56.35%,33.67%,1
新北市,土城區,1876,462,267,729,32,761,1379,55.18%,33.5%,1
新北市,土城區,1877,490,256,746,35,781,1471,53.09%,33.31%,1
新北市,土城區,1878,500,223,723,24,747,1410,52.98%,35.46%,1
新北市,土城區,1879,488,309,797,37,834,1542,54.09%,31.65%,1
新北市,土城區,1880,408,239,647,36,683,1238,55.17%,32.96%,1
新北市,土城區,1881,445,219,664,37,701,1301,53.88%,34.2%,1
新北市,土城區,1882,537,281,818,24,842,1311,64.23%,40.96%,1
新北市,土城區,1883,481,263,744,18,762,1511,50.43%,31.83%,1
新北市,土城區,1884,510,265,775,41,816,1531,53.3%,33.31%,1
新北市,土城區,1885,502,319,821,45,866,1638,52.87%,30.65%,1
新北市,土城區,1886,497,257,754,33,787,1335,58.95%,37.23%,1
新北市,土城區,1887,535,244,779,29,808,1459,55.38%,36.67%,1
新北市,土城區,1888,493,289,782,21,803,1489,53.93%,33.11%,1
新北市,土城區,1889,581,351,932,27,959,1774,54.06%,32.75%,1
新北市,土城區,1890,599,344,943,37,980,1792,54.69%,33.43%,1
新北市,土城區,1891,651,392,1043,46,1089,1798,60.57%,36.21%,1
新北市,土城區,1892,453,101,554,52,606,1312,46.19%,34.53%,1
新北市,土城區,1893,427,216,643,36,679,1301,52.19%,32.82%,1
新北市,土城區,1894,399,221,620,44,664,1254,52.95%,31.82%,1
新北市,土城區,1895,414,224,638,18,656,1215,53.99%,34.07%,1
新北市,土城區,1896,494,255,749,33,782,1448,54.01%,34.12%,1
新北市,土城區,1897,444,209,653,56,709,1321,53.67%,33.61%,1
新北市,土城區,1898,370,194,564,40,604,1150,52.52%,32.17%,1
新北市,土城區,1899,411,260,671,35,706,1425,49.54%,28.84%,1
新北市,土城區,1900,505,255,760,56,816,1366,59.74%,36.97%,1
新北市,土城區,1901,444,264,708,45,753,1292,58.28%,34.37%,1
新北市,土城區,1902,474,209,683,36,719,1317,54.59%,35.99%,1
新北市,土城區,1903,490,228,718,36,754,1324,56.95%,37.01%,1
新北市,土城區,1904,383,225,608,39,647,1189,54.42%,32.21%,1
新北市,土城區,1905,437,222,659,57,716,1223,58.54%,35.73%,1
新北市,土城區,1906,499,307,806,31,837,1550,54%,32.19%,1
新北市,土城區,1907,557,329,886,38,924,1606,57.53%,34.68%,1
新北市,土城區,1908,526,289,815,29,844,1509,55.93%,34.86%,1
新北市,土城區,1909,513,279,792,40,832,1529,54.41%,33.55%,1
新北市,土城區,1910,481,244,725,49,774,1458,53.09%,32.99%,1
新北市,土城區,1911,503,298,801,46,847,1468,57.7%,34.26%,1
新北市,土城區,1912,473,300,773,26,799,1495,53.44%,31.64%,1
新北市,土城區,1913,469,236,705,46,751,1303,57.64%,35.99%,1
新北市,土城區,1914,482,266,748,28,776,1365,56.85%,35.31%,1
新北市,土城區,1915,465,302,767,53,820,1476,55.56%,31.5%,1
新北市,土城區,1916,531,289,820,26,846,1519,55.69%,34.96%,1
新北市,蘆洲區,0555,537,332,869,63,932,1600,58.25%,33.56%,1
新北市,蘆洲區,0556,542,281,823,41,864,1549,55.78%,34.99%,1
新北市,蘆洲區,0557,533,306,839,53,892,1516,58.84%,35.16%,1
新北市,蘆洲區,0558,506,224,730,45,775,1404,55.2%,36.04%,1
新北市,蘆洲區,0559,462,242,704,57,761,1381,55.1%,33.45%,1
新北市,蘆洲區,0560,527,278,805,36,841,1485,56.63%,35.49%,1
新北市,蘆洲區,0561,449,206,655,34,689,1779,38.73%,25.24%,1
新北市,蘆洲區,0562,611,318,929,35,964,1797,53.64%,34%,1
新北市,蘆洲區,0563,472,274,746,44,790,1364,57.92%,34.6%,1
新北市,蘆洲區,0564,554,324,878,46,924,1635,56.51%,33.88%,1
新北市,蘆洲區,0565,500,244,744,23,767,1567,48.95%,31.91%,1
新北市,蘆洲區,0566,520,255,775,36,811,1524,53.22%,34.12%,1
新北市,蘆洲區,0567,528,265,793,41,834,1612,51.74%,32.75%,1
新北市,蘆洲區,0568,532,312,844,34,878,1674,52.45%,31.78%,1
新北市,蘆洲區,0569,547,318,865,41,906,1838,49.29%,29.76%,1
新北市,蘆洲區,0570,510,288,798,26,824,1814,45.42%,28.11%,1
新北市,蘆洲區,0571,484,315,799,37,836,1473,56.75%,32.86%,1
新北市,蘆洲區,0572,492,257,749,44,793,1465,54.13%,33.58%,1
新北市,蘆洲區,0573,567,342,909,37,946,1652,57.26%,34.32%,1
新北市,蘆洲區,0574,539,315,854,62,916,1650,55.52%,32.67%,1
新北市,蘆洲區,0575,595,286,881,34,915,1656,55.25%,35.93%,1
新北市,蘆洲區,0576,517,267,784,36,820,1571,52.2%,32.91%,1
新北市,蘆洲區,0577,474,300,774,43,817,1523,53.64%,31.12%,1
新北市,蘆洲區,0578,497,271,768,35,803,1475,54.44%,33.69%,1
新北市,蘆洲區,0579,427,260,687,43,730,1367,53.4%,31.24%,1
新北市,蘆洲區,0580,535,296,831,32,863,1514,57%,35.34%,1
新北市,蘆洲區,0581,651,380,1031,25,1056,1791,58.96%,36.35%,1
新北市,蘆洲區,0582,646,363,1009,35,1044,1714,60.91%,37.69%,1
新北市,蘆洲區,0583,530,456,986,19,1005,1780,56.46%,29.78%,1
新北市,蘆洲區,0584,586,346,932,38,970,1713,56.63%,34.21%,1
新北市,蘆洲區,0585,636,317,953,30,983,1720,57.15%,36.98%,1
新北市,蘆洲區,0586,629,323,952,27,979,1766,55.44%,35.62%,1
新北市,蘆洲區,0587,554,299,853,35,888,1623,54.71%,34.13%,1
新北市,蘆洲區,0588,551,370,921,36,957,1740,55%,31.67%,1
新北市,蘆洲區,0589,629,345,974,43,1017,1759,57.82%,35.76%,1
新北市,蘆洲區,0590,629,358,987,47,1034,1775,58.25%,35.44%,1
新北市,蘆洲區,0591,660,391,1051,42,1093,1909,57.26%,34.57%,1
新北市,蘆洲區,0592,618,379,997,53,1050,1805,58.17%,34.24%,1
新北市,蘆洲區,0593,542,308,850,27,877,1642,53.41%,33.01%,1
新北市,蘆洲區,0594,550,323,873,43,916,1713,53.47%,32.11%,1
新北市,蘆洲區,0595,517,319,836,57,893,1746,51.15%,29.61%,1
新北市,蘆洲區,0596,538,302,840,38,878,1596,55.01%,33.71%,1
新北市,蘆洲區,0597,478,252,730,37,767,1434,53.49%,33.33%,1
新北市,蘆洲區,0598,496,282,778,34,812,1450,56%,34.21%,1
新北市,蘆洲區,0599,475,303,778,19,797,1543,51.65%,30.78%,1
新北市,蘆洲區,0600,509,289,798,29,827,1525,54.23%,33.38%,1
新北市,蘆洲區,0601,426,266,692,45,737,1419,51.94%,30.02%,1
新北市,蘆洲區,0602,438,279,717,23,740,1298,57.01%,33.74%,1
新北市,蘆洲區,0603,430,236,666,46,712,1304,54.6%,32.98%,1
新北市,蘆洲區,0604,562,370,932,35,967,1806,53.54%,31.12%,1
新北市,蘆洲區,0605,616,318,934,61,995,1910,52.09%,32.25%,1
新北市,蘆洲區,0606,540,192,732,31,763,1873,40.74%,28.83%,1
新北市,蘆洲區,0607,548,299,847,25,872,1785,48.85%,30.7%,1
新北市,蘆洲區,0608,534,306,840,49,889,1760,50.51%,30.34%,1
新北市,蘆洲區,0609,621,349,970,54,1024,1841,55.62%,33.73%,1
新北市,蘆洲區,0610,577,329,906,31,937,1855,50.51%,31.11%,1
新北市,蘆洲區,0611,435,251,686,47,733,1450,50.55%,30%,1
新北市,蘆洲區,0612,487,299,786,48,834,1585,52.62%,30.73%,1
新北市,蘆洲區,0613,478,250,728,62,790,1541,51.27%,31.02%,1
新北市,蘆洲區,0614,519,299,818,40,858,1626,52.77%,31.92%,1
新北市,蘆洲區,0615,400,281,681,39,720,1241,58.02%,32.23%,1
新北市,蘆洲區,0616,543,311,854,37,891,1634,54.53%,33.23%,1
新北市,蘆洲區,0617,550,283,833,38,871,1573,55.37%,34.97%,1
新北市,蘆洲區,0618,532,348,880,35,915,1619,56.52%,32.86%,1
新北市,蘆洲區,0619,623,332,955,65,1020,1878,54.31%,33.17%,1
新北市,蘆洲區,0620,597,311,908,60,968,1797,53.87%,33.22%,1
新北市,蘆洲區,0621,635,345,980,41,1021,1816,56.22%,34.97%,1
新北市,蘆洲區,0622,483,267,750,53,803,1344,59.75%,35.94%,1
新北市,蘆洲區,0623,544,389,933,49,982,1492,65.82%,36.46%,1
新北市,蘆洲區,0624,686,304,990,71,1061,1959,54.16%,35.02%,1
新北市,蘆洲區,0625,546,280,826,58,884,1611,54.87%,33.89%,1
新北市,蘆洲區,0626,562,307,869,36,905,1574,57.5%,35.71%,1
新北市,蘆洲區,0627,584,304,888,38,926,1653,56.02%,35.33%,1
新北市,蘆洲區,0628,653,363,1016,41,1057,3085,34.26%,21.17%,1
新北市,蘆洲區,0629,569,350,919,50,969,1812,53.48%,31.4%,1
新北市,蘆洲區,0630,436,256,692,45,737,1332,55.33%,32.73%,1
新北市,蘆洲區,0631,488,276,764,48,812,1648,49.27%,29.61%,1
新北市,蘆洲區,0632,338,351,689,26,715,1355,52.77%,24.94%,1
新北市,蘆洲區,0633,466,237,703,30,733,1371,53.46%,33.99%,1
新北市,蘆洲區,0634,382,208,590,40,630,1111,56.71%,34.38%,1
新北市,蘆洲區,0635,418,229,647,52,699,1176,59.44%,35.54%,1
新北市,蘆洲區,0636,637,328,965,36,1001,1602,62.48%,39.76%,1
新北市,蘆洲區,0637,404,246,650,44,694,1361,50.99%,29.68%,1
新北市,蘆洲區,0638,532,262,794,41,835,1530,54.58%,34.77%,1
新北市,蘆洲區,0639,314,161,475,53,528,925,57.08%,33.95%,1
新北市,蘆洲區,0640,617,342,959,43,1002,1851,54.13%,33.33%,1
新北市,蘆洲區,0641,538,301,839,40,879,1791,49.08%,30.04%,1
新北市,蘆洲區,0642,558,327,885,42,927,1853,50.03%,30.11%,1
新北市,蘆洲區,0643,516,310,826,39,865,1758,49.2%,29.35%,1
新北市,蘆洲區,0644,572,348,920,48,968,1798,53.84%,31.81%,1
新北市,蘆洲區,0645,573,300,873,33,906,1645,55.08%,34.83%,1
新北市,蘆洲區,0646,461,300,761,33,794,1612,49.26%,28.6%,1
新北市,蘆洲區,0647,519,312,831,39,870,1784,48.77%,29.09%,1
新北市,蘆洲區,0648,481,275,756,37,793,1701,46.62%,28.28%,1
新北市,蘆洲區,0649,530,268,798,30,828,1581,52.37%,33.52%,1
新北市,蘆洲區,0650,470,337,807,39,846,1534,55.15%,30.64%,1
新北市,蘆洲區,0651,544,338,882,56,938,1620,57.9%,33.58%,1
新北市,蘆洲區,0652,556,290,846,44,890,1494,59.57%,37.22%,1
新北市,蘆洲區,0653,363,270,633,30,663,1183,56.04%,30.68%,1
新北市,蘆洲區,0654,336,195,531,36,567,985,57.56%,34.11%,1
新北市,蘆洲區,0655,535,283,818,57,875,1673,52.3%,31.98%,1
新北市,蘆洲區,0656,536,353,889,59,948,1688,56.16%,31.75%,1
新北市,蘆洲區,0657,426,223,649,34,683,1249,54.68%,34.11%,1
新北市,蘆洲區,0658,460,267,727,44,771,1476,52.24%,31.17%,1
新北市,五股區,0207,459,279,738,61,799,1456,54.88%,31.52%,1
新北市,五股區,0208,490,268,758,29,787,1482,53.1%,33.06%,1
新北市,五股區,0209,413,267,680,47,727,1287,56.49%,32.09%,1
新北市,五股區,0210,355,212,567,20,587,1106,53.07%,32.1%,1
新北市,五股區,0211,420,203,623,57,680,1283,53%,32.74%,1
新北市,五股區,0212,623,330,953,30,983,1833,53.63%,33.99%,1
新北市,五股區,0213,393,232,625,32,657,1141,57.58%,34.44%,1
新北市,五股區,0214,170,91,261,25,286,463,61.77%,36.72%,1
新北市,五股區,0215,626,303,929,48,977,1786,54.7%,35.05%,1
新北市,五股區,0216,533,310,843,29,872,1660,52.53%,32.11%,1
新北市,五股區,0217,507,274,781,66,847,1534,55.22%,33.05%,1
新北市,五股區,0218,474,211,685,59,744,1285,57.9%,36.89%,1
新北市,五股區,0219,593,315,908,75,983,1832,53.66%,32.37%,1
新北市,五股區,0220,517,284,801,28,829,1542,53.76%,33.53%,1
新北市,五股區,0221,586,293,879,43,922,1897,48.6%,30.89%,1
新北市,五股區,0222,398,503,901,62,963,1964,49.03%,20.26%,1
新北市,五股區,0223,546,291,837,48,885,1779,49.75%,30.69%,1
新北市,五股區,0224,586,288,874,39,913,1735,52.62%,33.78%,1
新北市,五股區,0225,655,421,1076,35,1111,2299,48.33%,28.49%,1
新北市,五股區,0226,584,252,836,33,869,1755,49.52%,33.28%,1
新北市,五股區,0227,600,285,885,48,933,1674,55.73%,35.84%,1
新北市,五股區,0228,588,280,868,52,920,1661,55.39%,35.4%,1
新北市,五股區,0229,378,243,621,24,645,1281,50.35%,29.51%,1
新北市,五股區,0230,557,268,825,27,852,1566,54.41%,35.57%,1
新北市,五股區,0231,535,234,769,18,787,1560,50.45%,34.29%,1
新北市,五股區,0232,724,131,855,31,886,1622,54.62%,44.64%,1
新北市,五股區,0233,646,291,937,24,961,1779,54.02%,36.31%,1
新北市,五股區,0234,514,222,736,44,780,1487,52.45%,34.57%,1
新北市,五股區,0235,510,310,820,41,861,1567,54.95%,32.55%,1
新北市,五股區,0236,305,205,510,28,538,1333,40.36%,22.88%,1
新北市,五股區,0237,476,251,727,34,761,1263,60.25%,37.69%,1
新北市,五股區,0238,485,232,717,36,753,1314,57.31%,36.91%,1
新北市,五股區,0239,488,277,765,26,791,1513,52.28%,32.25%,1
新北市,五股區,0240,578,259,837,24,861,1517,56.76%,38.1%,1
新北市,五股區,0241,553,280,833,44,877,1613,54.37%,34.28%,1
新北市,五股區,0242,559,275,834,39,873,1616,54.02%,34.59%,1
新北市,五股區,0243,495,323,818,46,864,1616,53.47%,30.63%,1
新北市,五股區,0244,591,281,872,47,919,1689,54.41%,34.99%,1
新北市,五股區,0245,605,358,963,22,985,1894,52.01%,31.94%,1
新北市,五股區,0246,501,237,738,25,763,1210,63.06%,41.4%,1
新北市,五股區,0247,556,271,827,22,849,1643,51.67%,33.84%,1
新北市,五股區,0248,494,258,752,21,773,1441,53.64%,34.28%,1
新北市,五股區,0249,513,223,736,16,752,1305,57.62%,39.31%,1
新北市,五股區,0250,458,233,691,32,723,1170,61.79%,39.15%,1
新北市,五股區,0251,562,238,800,54,854,1397,61.13%,40.23%,1
新北市,五股區,0252,563,205,768,39,807,1312,61.51%,42.91%,1
新北市,五股區,0253,301,247,548,27,575,1127,51.02%,26.71%,1
新北市,五股區,0254,437,140,577,25,602,1154,52.17%,37.87%,1
新北市,泰山區,0255,199,102,301,23,324,643,50.39%,30.95%,1
新北市,泰山區,0256,75,38,113,2,115,186,61.83%,40.32%,1
新北市,泰山區,0257,498,224,722,22,744,1457,51.06%,34.18%,1
新北市,泰山區,0258,560,291,851,40,891,1594,55.9%,35.13%,1
新北市,泰山區,0259,507,265,772,30,802,1598,50.19%,31.73%,1
新北市,泰山區,0260,483,271,754,22,776,1503,51.63%,32.14%,1
新北市,泰山區,0261,477,229,706,42,748,1436,52.09%,33.22%,1
新北市,泰山區,0262,487,253,740,28,768,1384,55.49%,35.19%,1
新北市,泰山區,0263,471,204,675,29,704,1231,57.19%,38.26%,1
新北市,泰山區,0264,449,209,658,26,684,1295,52.82%,34.67%,1
新北市,泰山區,0265,557,302,859,41,900,1563,57.58%,35.64%,1
新北市,泰山區,0266,616,272,888,45,933,1610,57.95%,38.26%,1
新北市,泰山區,0267,445,199,644,31,675,1253,53.87%,35.51%,1
新北市,泰山區,0268,439,196,635,32,667,1294,51.55%,33.93%,1
新北市,泰山區,0269,474,275,749,41,790,1354,58.35%,35.01%,1
新北市,泰山區,0270,442,232,674,21,695,1259,55.2%,35.11%,1
新北市,泰山區,0271,431,260,691,23,714,1252,57.03%,34.42%,1
新北市,泰山區,0272,384,189,573,20,593,1094,54.2%,35.1%,1
新北市,泰山區,0273,576,297,873,22,895,1590,56.29%,36.23%,1
新北市,泰山區,0274,588,282,870,45,915,1634,56%,35.99%,1
新北市,泰山區,0275,464,237,701,26,727,1536,47.33%,30.21%,1
新北市,泰山區,0276,583,293,876,12,888,1534,57.89%,38.01%,1
新北市,泰山區,0277,670,261,931,24,955,1545,61.81%,43.37%,1
新北市,泰山區,0278,522,233,755,28,783,1399,55.97%,37.31%,1
新北市,泰山區,0279,459,232,691,23,714,1315,54.3%,34.9%,1
新北市,泰山區,0280,435,268,703,34,737,1201,61.37%,36.22%,1
新北市,泰山區,0281,400,228,628,38,666,1182,56.35%,33.84%,1
新北市,泰山區,0282,551,286,837,50,887,1665,53.27%,33.09%,1
新北市,泰山區,0283,635,331,966,42,1008,1855,54.34%,34.23%,1
新北市,泰山區,0284,649,326,975,56,1031,1866,55.25%,34.78%,1
新北市,泰山區,0285,650,343,993,38,1031,1935,53.28%,33.59%,1
新北市,泰山區,0286,529,275,804,15,819,1589,51.54%,33.29%,1
新北市,泰山區,0287,404,181,585,25,610,1152,52.95%,35.07%,1
新北市,泰山區,0288,359,239,598,30,628,1114,56.37%,32.23%,1
新北市,泰山區,0289,406,215,621,28,649,1040,62.4%,39.04%,1
新北市,泰山區,0290,383,190,573,29,602,1003,60.02%,38.19%,1
新北市,泰山區,0291,355,223,578,16,594,975,60.92%,36.41%,1
新北市,泰山區,0292,487,259,746,41,787,1440,54.65%,33.82%,1
新北市,泰山區,0293,528,253,781,19,800,1480,54.05%,35.68%,1
新北市,泰山區,0294,444,220,664,22,686,1211,56.65%,36.66%,1
新北市,泰山區,0295,463,219,682,22,704,1237,56.91%,37.43%,1
新北市,泰山區,0296,409,172,581,25,606,1069,56.69%,38.26%,1
新北市,泰山區,0297,623,327,950,49,999,1680,59.46%,37.08%,1
新北市,泰山區,0298,602,315,917,25,942,1651,57.06%,36.46%,1
新北市,泰山區,0299,488,237,725,23,748,1420,52.68%,34.37%,1
新北市,泰山區,0300,497,260,757,32,789,1337,59.01%,37.17%,1
新北市,泰山區,0301,585,296,881,32,913,1591,57.39%,36.77%,1
新北市,林口區,0145,414,225,639,47,686,1268,54.1%,32.65%,1
新北市,林口區,0146,342,234,576,31,607,1171,51.84%,29.21%,1
新北市,林口區,0147,433,230,663,33,696,1218,57.14%,35.55%,1
新北市,林口區,0148,570,310,880,34,914,1788,51.12%,31.88%,1
新北市,林口區,0149,501,288,789,49,838,1625,51.57%,30.83%,1
新北市,林口區,0150,421,280,701,58,759,1448,52.42%,29.07%,1
新北市,林口區,0151,446,194,640,48,688,1328,51.81%,33.58%,1
新北市,林口區,0152,447,221,668,41,709,1523,46.55%,29.35%,1
新北市,林口區,0153,435,220,655,30,685,1245,55.02%,34.94%,1
新北市,林口區,0154,523,280,803,29,832,1329,62.6%,39.35%,1
新北市,林口區,0155,539,296,835,23,858,1465,58.57%,36.79%,1
新北市,林口區,0156,479,306,785,22,807,1369,58.95%,34.99%,1
新北市,林口區,0157,486,268,754,35,789,1346,58.62%,36.11%,1
新北市,林口區,0158,403,201,604,45,649,1181,54.95%,34.12%,1
新北市,林口區,0159,543,225,768,32,800,1291,61.97%,42.06%,1
新北市,林口區,0160,418,211,629,46,675,1213,55.65%,34.46%,1
新北市,林口區,0161,468,240,708,27,735,1256,58.52%,37.26%,1
新北市,林口區,0162,381,235,616,36,652,1185,55.02%,32.15%,1
新北市,林口區,0163,485,239,724,43,767,1361,56.36%,35.64%,1
新北市,林口區,0164,585,288,873,27,900,1756,51.25%,33.31%,1
新北市,林口區,0165,565,278,843,20,863,1676,51.49%,33.71%,1
新北市,林口區,0166,587,267,854,18,872,1540,56.62%,38.12%,1
新北市,林口區,0167,529,287,816,35,851,1569,54.24%,33.72%,1
新北市,林口區,0168,557,258,815,23,838,1514,55.35%,36.79%,1
新北市,林口區,0169,399,282,681,11,692,1193,58.01%,33.45%,1
新北市,林口區,0170,596,303,899,18,917,1610,56.96%,37.02%,1
新北市,林口區,0171,468,289,757,22,779,1338,58.22%,34.98%,1
新北市,林口區,0172,439,205,644,21,665,1141,58.28%,38.48%,1
新北市,林口區,0173,459,252,711,29,740,1307,56.62%,35.12%,1
新北市,林口區,0174,492,252,744,21,765,1327,57.65%,37.08%,1
新北市,林口區,0175,468,258,726,19,745,1285,57.98%,36.42%,1
新北市,林口區,0176,478,321,799,42,841,1481,56.79%,32.28%,1
新北市,林口區,0177,532,328,860,13,873,1510,57.81%,35.23%,1
新北市,林口區,0178,592,319,911,39,950,1785,53.22%,33.17%,1
新北市,林口區,0179,592,355,947,19,966,1792,53.91%,33.04%,1
新北市,林口區,0180,548,287,835,25,860,1517,56.69%,36.12%,1
新北市,林口區,0181,579,298,877,20,897,1564,57.35%,37.02%,1
新北市,林口區,0182,605,268,873,20,893,1560,57.24%,38.78%,1
新北市,林口區,0183,494,317,811,28,839,1544,54.34%,31.99%,1
新北市,林口區,0184,532,304,836,24,860,1593,53.99%,33.4%,1
新北市,林口區,0185,492,290,782,23,805,1431,56.25%,34.38%,1
新北市,林口區,0186,505,310,815,30,845,1571,53.79%,32.15%,1
新北市,林口區,0187,499,317,816,19,835,1439,58.03%,34.68%,1
新北市,林口區,0188,518,301,819,23,842,1451,58.03%,35.7%,1
新北市,林口區,0189,497,319,816,26,842,1391,60.53%,35.73%,1
新北市,林口區,0190,521,271,792,23,815,1461,55.78%,35.66%,1
新北市,林口區,0191,552,347,899,19,918,1691,54.29%,32.64%,1
新北市,林口區,0192,564,234,798,43,841,1524,55.18%,37.01%,1
新北市,林口區,0193,530,282,812,28,840,1343,62.55%,39.46%,1
新北市,林口區,0194,528,296,824,20,844,1398,60.37%,37.77%,1
新北市,林口區,0195,506,287,793,24,817,1380,59.2%,36.67%,1
新北市,林口區,0196,465,263,728,44,772,1367,56.47%,34.02%,1
新北市,林口區,0197,475,270,745,33,778,1350,57.63%,35.19%,1
新北市,林口區,0198,428,244,672,32,704,1194,58.96%,35.85%,1
新北市,林口區,0199,450,247,697,40,737,1344,54.84%,33.48%,1
新北市,林口區,0200,413,214,627,27,654,1154,56.67%,35.79%,1
新北市,林口區,0201,445,231,676,22,698,1119,62.38%,39.77%,1
新北市,林口區,0202,301,173,474,31,505,1026,49.22%,29.34%,1
新北市,林口區,0203,389,242,631,51,682,1210,56.36%,32.15%,1
新北市,林口區,0204,296,175,471,46,517,912,56.69%,32.46%,1
新北市,林口區,0205,267,189,456,26,482,824,58.5%,32.4%,1
新北市,林口區,0206,489,282,771,63,834,1411,59.11%,34.66%,1
新北市,深坑區,2163,380,202,582,25,607,1142,53.15%,33.27%,1
新北市,深坑區,2164,412,222,634,42,676,1139,59.35%,36.17%,1
新北市,深坑區,2165,342,203,545,31,576,1065,54.08%,32.11%,1
新北市,深坑區,2166,448,236,684,37,721,1400,51.5%,32%,1
新北市,深坑區,2167,421,226,647,42,689,1330,51.8%,31.65%,1
新北市,深坑區,2168,430,237,667,29,696,1380,50.43%,31.16%,1
新北市,深坑區,2169,450,261,711,11,722,1496,48.26%,30.08%,1
新北市,深坑區,2170,548,280,828,33,861,1508,57.1%,36.34%,1
新北市,深坑區,2171,590,309,899,30,929,1624,57.2%,36.33%,1
新北市,深坑區,2172,737,389,1126,41,1167,2165,53.9%,34.04%,1
新北市,深坑區,2173,662,368,1030,31,1061,1790,59.27%,36.98%,1
新北市,深坑區,2174,266,127,393,18,411,782,52.56%,34.02%,1
新北市,深坑區,2175,431,236,667,17,684,1164,58.76%,37.03%,1
新北市,深坑區,2176,506,257,763,43,806,1344,59.97%,37.65%,1
新北市,深坑區,2177,282,146,428,25,453,739,61.3%,38.16%,1
新北市,深坑區,2178,206,115,321,20,341,556,61.33%,37.05%,1
新北市,石碇區,2179,146,84,230,13,243,391,62.15%,37.34%,1
新北市,石碇區,2180,254,117,371,32,403,789,51.08%,32.19%,1
新北市,石碇區,2181,174,76,250,26,276,662,41.69%,26.28%,1
新北市,石碇區,2182,104,45,149,12,161,310,51.94%,33.55%,1
新北市,石碇區,2183,99,43,142,8,150,280,53.57%,35.36%,1
新北市,石碇區,2184,25,8,33,5,38,93,40.86%,26.88%,1
新北市,石碇區,2185,183,97,280,27,307,683,44.95%,26.79%,1
新北市,石碇區,2186,122,79,201,8,209,323,64.71%,37.77%,1
新北市,石碇區,2187,202,77,279,12,291,726,40.08%,27.82%,1
新北市,石碇區,2188,186,105,291,24,315,591,53.3%,31.47%,1
新北市,石碇區,2189,119,57,176,15,191,282,67.73%,42.2%,1
新北市,石碇區,2190,249,122,371,11,382,788,48.48%,31.6%,1
新北市,石碇區,2191,333,184,517,33,550,943,58.32%,35.31%,1
新北市,坪林區,2192,438,190,628,42,670,1248,53.69%,35.1%,1
新北市,坪林區,2193,179,84,263,29,292,612,47.71%,29.25%,1
新北市,坪林區,2194,405,184,589,62,651,1141,57.06%,35.5%,1
新北市,坪林區,2195,109,63,172,9,181,417,43.41%,26.14%,1
新北市,坪林區,2196,215,81,296,36,332,595,55.8%,36.13%,1
新北市,坪林區,2197,98,38,136,18,154,248,62.1%,39.52%,1
新北市,坪林區,2198,118,38,156,12,168,338,49.7%,34.91%,1
新北市,坪林區,2199,125,68,193,19,212,478,44.35%,26.15%,1
新北市,坪林區,2200,99,48,147,12,159,390,40.77%,25.38%,1
新北市,坪林區,2201,143,57,200,8,208,424,49.06%,33.73%,1
新北市,三芝區,0011,98,44,142,9,151,312,48.4%,31.41%,1
新北市,三芝區,0012,453,221,674,37,711,1421,50.04%,31.88%,1
新北市,三芝區,0013,488,276,764,38,802,1557,51.51%,31.34%,1
新北市,三芝區,0014,578,312,890,51,941,1828,51.48%,31.62%,1
新北市,三芝區,0015,320,178,498,38,536,1060,50.57%,30.19%,1
新北市,三芝區,0016,219,106,325,33,358,819,43.71%,26.74%,1
新北市,三芝區,0017,454,246,700,26,726,1701,42.68%,26.69%,1
新北市,三芝區,0018,520,271,791,49,840,1740,48.28%,29.89%,1
新北市,三芝區,0019,425,233,658,25,683,1451,47.07%,29.29%,1
新北市,三芝區,0020,355,180,535,41,576,1248,46.15%,28.45%,1
新北市,三芝區,0021,202,115,317,16,333,629,52.94%,32.11%,1
新北市,三芝區,0022,159,60,219,15,234,504,46.43%,31.55%,1
新北市,三芝區,0023,221,92,313,15,328,698,46.99%,31.66%,1
新北市,三芝區,0024,632,304,936,42,978,2069,47.27%,30.55%,1
新北市,三芝區,0025,229,158,387,30,417,784,53.19%,29.21%,1
新北市,三芝區,0026,151,90,241,22,263,522,50.38%,28.93%,1
新北市,三芝區,0027,186,90,276,33,309,587,52.64%,31.69%,1
新北市,三芝區,0028,322,247,569,52,621,1189,52.23%,27.08%,1
新北市,石門區,0001,334,211,545,38,583,1121,52.01%,29.79%,1
新北市,石門區,0002,412,217,629,41,670,1389,48.24%,29.66%,1
新北市,石門區,0003,318,138,456,39,495,933,53.05%,34.08%,1
新北市,石門區,0004,389,183,572,48,620,1244,49.84%,31.27%,1
新北市,石門區,0005,285,160,445,43,488,883,55.27%,32.28%,1
新北市,石門區,0006,541,257,798,50,848,1564,54.22%,34.59%,1
新北市,石門區,0007,497,263,760,39,799,1500,53.27%,33.13%,1
新北市,石門區,0008,100,44,144,7,151,328,46.04%,30.49%,1
新北市,石門區,0009,260,107,367,35,402,651,61.75%,39.94%,1
新北市,石門區,0010,257,121,378,34,412,915,45.03%,28.09%,1
新北市,八里區,0125,450,241,691,55,746,1498,49.8%,30.04%,1
新北市,八里區,0126,559,313,872,27,899,1939,46.36%,28.83%,1
新北市,八里區,0127,541,238,779,29,808,1516,53.3%,35.69%,1
新北市,八里區,0128,567,330,897,43,940,1642,57.25%,34.53%,1
新北市,八里區,0129,544,340,884,60,944,1927,48.99%,28.23%,1
新北市,八里區,0130,418,235,653,39,692,1276,54.23%,32.76%,1
新北市,八里區,0131,518,239,757,35,792,1349,58.71%,38.4%,1
新北市,八里區,0132,512,245,757,32,789,1403,56.24%,36.49%,1
新北市,八里區,0133,552,293,845,44,889,1644,54.08%,33.58%,1
新北市,八里區,0134,632,327,959,43,1002,1853,54.07%,34.11%,1
新北市,八里區,0135,676,317,993,53,1046,1793,58.34%,37.7%,1
新北市,八里區,0136,573,282,855,30,885,1644,53.83%,34.85%,1
新北市,八里區,0137,706,218,924,42,966,1846,52.33%,38.24%,1
新北市,八里區,0138,416,263,679,43,722,1346,53.64%,30.91%,1
新北市,八里區,0139,536,295,831,43,874,1621,53.92%,33.07%,1
新北市,八里區,0140,619,279,898,47,945,2110,44.79%,29.34%,1
新北市,八里區,0141,707,249,956,53,1009,1967,51.3%,35.94%,1
新北市,八里區,0142,553,289,842,53,895,1626,55.04%,34.01%,1
新北市,八里區,0143,528,243,771,63,834,1514,55.09%,34.87%,1
新北市,八里區,0144,510,270,780,56,836,1456,57.42%,35.03%,1
新北市,平溪區,2208,130,43,173,22,195,384,50.78%,33.85%,1
新北市,平溪區,2209,68,34,102,2,104,232,44.83%,29.31%,1
新北市,平溪區,2210,86,45,131,11,142,249,57.03%,34.54%,1
新北市,平溪區,2211,157,75,232,23,255,458,55.68%,34.28%,1
新北市,平溪區,2212,78,34,112,16,128,232,55.17%,33.62%,1
新北市,平溪區,2213,177,75,252,15,267,635,42.05%,27.87%,1
新北市,平溪區,2214,155,61,216,33,249,427,58.31%,36.3%,1
新北市,平溪區,2215,252,105,357,29,386,862,44.78%,29.23%,1
新北市,平溪區,2216,42,30,72,2,74,147,50.34%,28.57%,1
新北市,平溪區,2217,105,28,133,11,144,365,39.45%,28.77%,1
新北市,平溪區,2218,43,19,62,8,70,153,45.75%,28.1%,1
新北市,平溪區,2219,82,18,100,9,109,177,61.58%,46.33%,1
新北市,雙溪區,2266,149,53,202,15,217,455,47.69%,32.75%,1
新北市,雙溪區,2267,100,39,139,10,149,286,52.1%,34.97%,1
新北市,雙溪區,2268,193,64,257,19,276,496,55.65%,38.91%,1
新北市,雙溪區,2269,117,41,158,10,168,383,43.86%,30.55%,1
新北市,雙溪區,2270,254,98,352,32,384,887,43.29%,28.64%,1
新北市,雙溪區,2271,172,79,251,29,280,652,42.94%,26.38%,1
新北市,雙溪區,2272,106,52,158,11,169,333,50.75%,31.83%,1
新北市,雙溪區,2273,200,96,296,25,321,642,50%,31.15%,1
新北市,雙溪區,2274,72,55,127,9,136,282,48.23%,25.53%,1
新北市,雙溪區,2275,169,80,249,24,273,621,43.96%,27.21%,1
新北市,雙溪區,2276,104,51,155,16,171,422,40.52%,24.64%,1
新北市,雙溪區,2277,80,34,114,22,136,369,36.86%,21.68%,1
新北市,雙溪區,2278,40,20,60,5,65,120,54.17%,33.33%,1
新北市,雙溪區,2279,80,42,122,12,134,271,49.45%,29.52%,1
新北市,雙溪區,2280,126,64,190,23,213,362,58.84%,34.81%,1
新北市,雙溪區,2281,117,50,167,26,193,371,52.02%,31.54%,1
新北市,雙溪區,2282,420,157,577,40,617,1047,58.93%,40.11%,1
新北市,貢寮區,2283,265,122,387,48,435,876,49.66%,30.25%,1
新北市,貢寮區,2284,128,70,198,21,219,433,50.58%,29.56%,1
新北市,貢寮區,2285,148,65,213,11,224,516,43.41%,28.68%,1
新北市,貢寮區,2286,84,45,129,24,153,373,41.02%,22.52%,1
新北市,貢寮區,2287,84,45,129,21,150,313,47.92%,26.84%,1
新北市,貢寮區,2288,164,67,231,10,241,485,49.69%,33.81%,1
新北市,貢寮區,2289,114,70,184,28,212,415,51.08%,27.47%,1
新北市,貢寮區,2290,235,100,335,20,355,812,43.72%,28.94%,1
新北市,貢寮區,2291,251,134,385,32,417,861,48.43%,29.15%,1
新北市,貢寮區,2292,162,81,243,33,276,676,40.83%,23.96%,1
新北市,貢寮區,2293,267,137,404,19,423,1091,38.77%,24.47%,1
新北市,貢寮區,2294,241,104,345,41,386,955,40.42%,25.24%,1
新北市,貢寮區,2295,213,103,316,6,322,769,41.87%,27.7%,1
新北市,貢寮區,2296,265,171,436,34,470,962,48.86%,27.55%,1
新北市,貢寮區,2297,143,56,199,7,206,390,52.82%,36.67%,1
新北市,貢寮區,2298,106,46,152,9,161,349,46.13%,30.37%,1
新北市,貢寮區,2299,135,52,187,26,213,508,41.93%,26.57%,1
新北市,貢寮區,2300,106,50,156,11,167,495,33.74%,21.41%,1
新北市,金山區,2301,172,67,239,23,262,481,54.47%,35.76%,1
新北市,金山區,2302,233,116,349,31,380,715,53.15%,32.59%,1
新北市,金山區,2303,147,47,194,20,214,481,44.49%,30.56%,1
新北市,金山區,2304,573,204,777,65,842,1792,46.99%,31.98%,1
新北市,金山區,2305,589,272,861,55,916,1781,51.43%,33.07%,1
新北市,金山區,2306,656,365,1021,56,1077,2010,53.58%,32.64%,1
新北市,金山區,2307,482,236,718,53,771,1572,49.05%,30.66%,1
新北市,金山區,2308,539,315,854,51,905,1777,50.93%,30.33%,1
新北市,金山區,2309,470,256,726,54,780,1631,47.82%,28.82%,1
新北市,金山區,2310,272,135,407,30,437,828,52.78%,32.85%,1
新北市,金山區,2311,299,155,454,20,474,888,53.38%,33.67%,1
新北市,金山區,2312,376,182,558,54,612,1211,50.54%,31.05%,1
新北市,金山區,2313,160,70,230,9,239,416,57.45%,38.46%,1
新北市,金山區,2314,250,117,367,32,399,682,58.5%,36.66%,1
新北市,金山區,2315,219,94,313,36,349,644,54.19%,34.01%,1
新北市,金山區,2316,275,104,379,32,411,830,49.52%,33.13%,1
新北市,金山區,2317,59,32,91,9,100,188,53.19%,31.38%,1
新北市,金山區,2318,151,83,234,29,263,469,56.08%,32.2%,1
新北市,金山區,2319,139,50,189,29,218,582,37.46%,23.88%,1
新北市,萬里區,2320,470,192,662,37,699,1286,54.35%,36.55%,1
新北市,萬里區,2321,538,279,817,44,861,1576,54.63%,34.14%,1
新北市,萬里區,2322,441,234,675,27,702,1447,48.51%,30.48%,1
新北市,萬里區,2323,447,171,618,52,670,1466,45.7%,30.49%,1
新北市,萬里區,2324,388,161,549,40,589,1369,43.02%,28.34%,1
新北市,萬里區,2325,298,135,433,44,477,1215,39.26%,24.53%,1
新北市,萬里區,2326,481,170,651,41,692,1317,52.54%,36.52%,1
新北市,萬里區,2327,531,187,718,37,755,1676,45.05%,31.68%,1
新北市,萬里區,2328,479,198,677,64,741,1550,47.81%,30.9%,1
新北市,萬里區,2329,377,167,544,43,587,945,62.12%,39.89%,1
新北市,萬里區,2330,615,282,897,62,959,1760,54.49%,34.94%,1
新北市,萬里區,2331,192,79,271,18,289,570,50.7%,33.68%,1
新北市,萬里區,2332,295,153,448,30,478,952,50.21%,30.99%,1
新北市,萬里區,2333,260,94,354,42,396,674,58.75%,38.58%,1
新北市,萬里區,2334,130,65,195,19,214,405,52.84%,32.1%,1
新北市,萬里區,2335,366,138,504,45,549,1089,50.41%,33.61%,1
新北市,烏來區,2202,645,276,921,29,950,1568,60.59%,41.14%,1
新北市,烏來區,2203,409,183,592,14,606,1198,50.58%,34.14%,1
新北市,烏來區,2204,428,163,591,14,605,1169,51.75%,36.61%,1
新北市,烏來區,2205,92,33,125,1,126,228,55.26%,40.35%,1
新北市,烏來區,2206,198,68,266,15,281,486,57.82%,40.74%,1
新北市,烏來區,2207,229,84,313,13,326,615,53.01%,37.24%,1
桃園市,桃園區,0001,485,278,763,42,805,1593,50.53%,30.45%,1
桃園市,桃園區,0002,507,317,824,32,856,1934,44.26%,26.22%,1
桃園市,桃園區,0003,573,300,873,44,917,1661,55.21%,34.5%,1
桃園市,桃園區,0004,436,225,661,17,678,1448,46.82%,30.11%,1
桃園市,桃園區,0005,586,333,919,34,953,1974,48.28%,29.69%,1
桃園市,桃園區,0006,542,267,809,56,865,1882,45.96%,28.8%,1
桃園市,桃園區,0007,521,334,855,24,879,1800,48.83%,28.94%,1
桃園市,桃園區,0008,531,305,836,39,875,1598,54.76%,33.23%,1
桃園市,桃園區,0009,460,253,713,60,773,1626,47.54%,28.29%,1
桃園市,桃園區,0010,493,263,756,42,798,1590,50.19%,31.01%,1
桃園市,桃園區,0011,507,285,792,36,828,1637,50.58%,30.97%,1
桃園市,桃園區,0012,583,285,868,51,919,1943,47.3%,30.01%,1
桃園市,桃園區,0013,457,285,742,39,781,1482,52.7%,30.84%,1
桃園市,桃園區,0014,487,261,748,36,784,1423,55.09%,34.22%,1
桃園市,桃園區,0015,487,321,808,29,837,1509,55.47%,32.27%,1
桃園市,桃園區,0016,567,269,836,16,852,1567,54.37%,36.18%,1
桃園市,桃園區,0017,466,211,677,32,709,1305,54.33%,35.71%,1
桃園市,桃園區,0018,437,234,671,28,699,1416,49.36%,30.86%,1
桃園市,桃園區,0019,490,300,790,18,808,1439,56.15%,34.05%,1
桃園市,桃園區,0020,270,476,746,39,785,1399,56.11%,19.3%,1
桃園市,桃園區,0021,519,309,828,33,861,1540,55.91%,33.7%,1
桃園市,桃園區,0022,525,262,787,20,807,1638,49.27%,32.05%,1
桃園市,桃園區,0023,431,209,640,24,664,1228,54.07%,35.1%,1
桃園市,桃園區,0024,524,262,786,44,830,1649,50.33%,31.78%,1
桃園市,桃園區,0025,547,255,802,34,836,1601,52.22%,34.17%,1
桃園市,桃園區,0026,445,259,704,53,757,1477,51.25%,30.13%,1
桃園市,桃園區,0027,543,245,788,32,820,1503,54.56%,36.13%,1
桃園市,桃園區,0028,482,264,746,50,796,1375,57.89%,35.05%,1
桃園市,桃園區,0029,617,305,922,29,951,1743,54.56%,35.4%,1
桃園市,桃園區,0030,578,305,883,32,915,1862,49.14%,31.04%,1
桃園市,桃園區,0031,575,302,877,32,909,1728,52.6%,33.28%,1
桃園市,桃園區,0032,214,136,350,14,364,690,52.75%,31.01%,1
桃園市,桃園區,0033,309,176,485,31,516,852,60.56%,36.27%,1
桃園市,桃園區,0034,478,268,746,42,788,1353,58.24%,35.33%,1
桃園市,桃園區,0035,448,218,666,17,683,1698,40.22%,26.38%,1
桃園市,桃園區,0036,437,259,696,44,740,1452,50.96%,30.1%,1
桃園市,桃園區,0037,555,281,836,47,883,1681,52.53%,33.02%,1
桃園市,桃園區,0038,521,279,800,44,844,1669,50.57%,31.22%,1
桃園市,桃園區,0039,560,296,856,24,880,1530,57.52%,36.6%,1
桃園市,桃園區,0040,522,308,830,36,866,1582,54.74%,33%,1
桃園市,桃園區,0041,498,237,735,28,763,1587,48.08%,31.38%,1
桃園市,桃園區,0042,484,275,759,40,799,1451,55.07%,33.36%,1
桃園市,桃園區,0043,438,269,707,32,739,1582,46.71%,27.69%,1
桃園市,桃園區,0044,360,199,559,29,588,1028,57.2%,35.02%,1
桃園市,桃園區,0045,609,318,927,39,966,1934,49.95%,31.49%,1
桃園市,桃園區,0046,351,174,525,34,559,1016,55.02%,34.55%,1
桃園市,桃園區,0047,370,190,560,24,584,1079,54.12%,34.29%,1
桃園市,桃園區,0048,583,308,891,16,907,1837,49.37%,31.74%,1
桃園市,桃園區,0049,486,226,712,42,754,1390,54.24%,34.96%,1
桃園市,桃園區,0050,513,261,774,21,795,1489,53.39%,34.45%,1
桃園市,桃園區,0051,622,402,1024,14,1038,1821,57%,34.16%,1
桃園市,桃園區,0052,489,265,754,17,771,1563,49.33%,31.29%,1
桃園市,桃園區,0053,564,325,889,25,914,1697,53.86%,33.24%,1
桃園市,桃園區,0054,595,313,908,32,940,1740,54.02%,34.2%,1
桃園市,桃園區,0055,551,283,834,27,861,1626,52.95%,33.89%,1
桃園市,桃園區,0056,395,284,679,16,695,1239,56.09%,31.88%,1
桃園市,桃園區,0057,511,346,857,28,885,1766,50.11%,28.94%,1
桃園市,桃園區,0058,541,265,806,31,837,1555,53.83%,34.79%,1
桃園市,桃園區,0059,602,340,942,27,969,1831,52.92%,32.88%,1
桃園市,桃園區,0060,437,203,640,29,669,1115,60%,39.19%,1
桃園市,桃園區,0061,524,306,830,33,863,1562,55.25%,33.55%,1
桃園市,桃園區,0062,603,273,876,22,898,1744,51.49%,34.58%,1
桃園市,桃園區,0063,517,331,848,23,871,1838,47.39%,28.13%,1
桃園市,桃園區,0064,635,352,987,42,1029,1889,54.47%,33.62%,1
桃園市,桃園區,0065,560,322,882,46,928,1985,46.75%,28.21%,1
桃園市,桃園區,0066,551,289,840,34,874,1524,57.35%,36.15%,1
桃園市,桃園區,0067,545,301,846,27,873,1425,61.26%,38.25%,1
桃園市,桃園區,0068,578,317,895,31,926,1606,57.66%,35.99%,1
桃園市,桃園區,0069,773,370,1143,23,1166,2056,56.71%,37.6%,1
桃園市,桃園區,0070,704,380,1084,26,1110,2010,55.22%,35.02%,1
桃園市,桃園區,0071,713,363,1076,33,1109,2245,49.4%,31.76%,1
桃園市,桃園區,0072,479,333,812,32,844,1590,53.08%,30.13%,1
桃園市,桃園區,0073,597,298,895,19,914,1536,59.51%,38.87%,1
桃園市,桃園區,0074,591,319,910,35,945,1949,48.49%,30.32%,1
桃園市,桃園區,0075,604,334,938,35,973,1965,49.52%,30.74%,1
桃園市,桃園區,0076,685,366,1051,37,1088,2414,45.07%,28.38%,1
桃園市,桃園區,0077,643,318,961,31,992,1942,51.08%,33.11%,1
桃園市,桃園區,0078,699,360,1059,48,1107,2156,51.35%,32.42%,1
桃園市,桃園區,0079,476,276,752,42,794,1404,56.55%,33.9%,1
桃園市,桃園區,0080,469,242,711,20,731,1194,61.22%,39.28%,1
桃園市,桃園區,0081,498,281,779,56,835,1449,57.63%,34.37%,1
桃園市,桃園區,0082,536,288,824,50,874,1803,48.47%,29.73%,1
桃園市,桃園區,0083,584,284,868,36,904,1692,53.43%,34.52%,1
桃園市,桃園區,0084,645,333,978,28,1006,1913,52.59%,33.72%,1
桃園市,桃園區,0085,609,309,918,36,954,1815,52.56%,33.55%,1
桃園市,桃園區,0086,346,205,551,38,589,1173,50.21%,29.5%,1
桃園市,桃園區,0087,387,185,572,21,593,1162,51.03%,33.3%,1
桃園市,桃園區,0088,343,158,501,52,553,1194,46.31%,28.73%,1
桃園市,桃園區,0089,558,301,859,41,900,1695,53.1%,32.92%,1
桃園市,桃園區,0090,571,305,876,24,900,1797,50.08%,31.78%,1
桃園市,桃園區,0091,554,245,799,21,820,1592,51.51%,34.8%,1
桃園市,桃園區,0092,584,276,860,42,902,1780,50.67%,32.81%,1
桃園市,桃園區,0093,544,303,847,28,875,1904,45.96%,28.57%,1
桃園市,桃園區,0094,636,331,967,30,997,2021,49.33%,31.47%,1
桃園市,桃園區,0095,547,230,777,25,802,1545,51.91%,35.4%,1
桃園市,桃園區,0096,506,245,751,28,779,1617,48.18%,31.29%,1
桃園市,桃園區,0097,551,275,826,15,841,1683,49.97%,32.74%,1
桃園市,桃園區,0098,657,304,961,43,1004,1834,54.74%,35.82%,1
桃園市,桃園區,0099,613,341,954,29,983,2055,47.83%,29.83%,1
桃園市,桃園區,0100,597,283,880,14,894,1828,48.91%,32.66%,1
桃園市,桃園區,0101,584,306,890,28,918,1873,49.01%,31.18%,1
桃園市,桃園區,0102,499,233,732,25,757,3687,20.53%,13.53%,1
桃園市,桃園區,0103,621,253,874,36,910,1850,49.19%,33.57%,1
桃園市,桃園區,0104,586,307,893,28,921,1827,50.41%,32.07%,1
桃園市,桃園區,0105,462,205,667,29,696,1149,60.57%,40.21%,1
桃園市,桃園區,0106,374,209,583,41,624,1061,58.81%,35.25%,1
桃園市,桃園區,0107,528,309,837,31,868,1831,47.41%,28.84%,1
桃園市,桃園區,0108,682,350,1032,37,1069,2168,49.31%,31.46%,1
桃園市,桃園區,0109,587,325,912,13,925,1874,49.36%,31.32%,1
桃園市,桃園區,0110,436,250,686,19,705,1524,46.26%,28.61%,1
桃園市,桃園區,0111,500,292,792,17,809,1528,52.95%,32.72%,1
桃園市,桃園區,0112,492,277,769,28,797,1489,53.53%,33.04%,1
桃園市,桃園區,0113,406,229,635,46,681,1308,52.06%,31.04%,1
桃園市,桃園區,0114,515,257,772,38,810,1583,51.17%,32.53%,1
桃園市,桃園區,0115,540,304,844,37,881,1618,54.45%,33.37%,1
桃園市,桃園區,0116,628,384,1012,48,1060,2127,49.84%,29.53%,1
桃園市,桃園區,0117,625,339,964,20,984,2033,48.4%,30.74%,1
桃園市,桃園區,0118,698,338,1036,30,1066,2098,50.81%,33.27%,1
桃園市,桃園區,0119,751,358,1109,40,1149,2126,54.05%,35.32%,1
桃園市,桃園區,0120,624,284,908,41,949,1917,49.5%,32.55%,1
桃園市,桃園區,0121,608,346,954,28,982,1997,49.17%,30.45%,1
桃園市,桃園區,0122,649,357,1006,25,1031,1929,53.45%,33.64%,1
桃園市,桃園區,0123,424,405,829,30,859,1691,50.8%,25.07%,1
桃園市,桃園區,0124,608,336,944,18,962,1900,50.63%,32%,1
桃園市,桃園區,0125,576,315,891,45,936,1761,53.15%,32.71%,1
桃園市,桃園區,0126,623,335,958,18,976,1922,50.78%,32.41%,1
桃園市,桃園區,0127,645,302,947,47,994,1995,49.82%,32.33%,1
桃園市,桃園區,0128,379,186,565,25,590,1063,55.5%,35.65%,1
桃園市,桃園區,0129,463,239,702,29,731,1412,51.77%,32.79%,1
桃園市,桃園區,0130,572,357,929,15,944,1746,54.07%,32.76%,1
桃園市,桃園區,0131,471,301,772,39,811,1689,48.02%,27.89%,1
桃園市,桃園區,0132,447,229,676,19,695,1542,45.07%,28.99%,1
桃園市,桃園區,0133,467,221,688,34,722,1437,50.24%,32.5%,1
桃園市,桃園區,0134,540,305,845,25,870,1679,51.82%,32.16%,1
桃園市,桃園區,0135,556,285,841,34,875,1886,46.39%,29.48%,1
桃園市,桃園區,0136,532,308,840,49,889,1657,53.65%,32.11%,1
桃園市,桃園區,0137,453,264,717,18,735,1349,54.48%,33.58%,1
桃園市,桃園區,0138,592,326,918,21,939,1805,52.02%,32.8%,1
桃園市,桃園區,0139,570,316,886,50,936,1846,50.7%,30.88%,1
桃園市,桃園區,0140,509,245,754,26,780,1644,47.45%,30.96%,1
桃園市,桃園區,0141,494,280,774,29,803,1674,47.97%,29.51%,1
桃園市,桃園區,0142,556,298,854,29,883,1737,50.83%,32.01%,1
桃園市,桃園區,0143,533,274,807,35,842,1566,53.77%,34.04%,1
桃園市,桃園區,0144,499,279,778,34,812,1517,53.53%,32.89%,1
桃園市,桃園區,0145,471,254,725,26,751,1619,46.39%,29.09%,1
桃園市,桃園區,0146,558,307,865,34,899,1774,50.68%,31.45%,1
桃園市,桃園區,0147,568,276,844,24,868,1666,52.1%,34.09%,1
桃園市,桃園區,0148,508,278,786,13,799,1528,52.29%,33.25%,1
桃園市,桃園區,0149,525,300,825,33,858,1709,50.2%,30.72%,1
桃園市,桃園區,0150,512,344,856,15,871,1719,50.67%,29.78%,1
桃園市,桃園區,0151,468,231,699,36,735,1569,46.85%,29.83%,1
桃園市,桃園區,0152,498,228,726,50,776,1505,51.56%,33.09%,1
桃園市,桃園區,0153,488,241,729,34,763,1496,51%,32.62%,1
桃園市,桃園區,0154,509,272,781,22,803,1505,53.36%,33.82%,1
桃園市,桃園區,0155,560,328,888,24,912,1807,50.47%,30.99%,1
桃園市,桃園區,0156,615,315,930,34,964,1857,51.91%,33.12%,1
桃園市,桃園區,0157,566,274,840,54,894,1589,56.26%,35.62%,1
桃園市,桃園區,0158,660,370,1030,31,1061,2088,50.81%,31.61%,1
桃園市,桃園區,0159,595,325,920,32,952,1893,50.29%,31.43%,1
桃園市,桃園區,0160,394,186,580,24,604,1303,46.35%,30.24%,1
桃園市,桃園區,0161,463,261,724,34,758,1416,53.53%,32.7%,1
桃園市,桃園區,0162,419,226,645,23,668,1351,49.44%,31.01%,1
桃園市,桃園區,0163,511,284,795,22,817,1659,49.25%,30.8%,1
桃園市,桃園區,0164,683,311,994,20,1014,2103,48.22%,32.48%,1
桃園市,桃園區,0165,612,333,945,20,965,1943,49.67%,31.5%,1
桃園市,桃園區,0166,612,333,945,33,978,1927,50.75%,31.76%,1
桃園市,桃園區,0167,564,283,847,32,879,1929,45.57%,29.24%,1
桃園市,桃園區,0168,771,436,1207,28,1235,2204,56.03%,34.98%,1
桃園市,桃園區,0169,535,379,914,18,932,2033,45.84%,26.32%,1
桃園市,桃園區,0170,570,256,826,17,843,1656,50.91%,34.42%,1
桃園市,桃園區,0171,529,295,824,44,868,1712,50.7%,30.9%,1
桃園市,桃園區,0172,538,310,848,29,877,1738,50.46%,30.96%,1
桃園市,桃園區,0173,617,284,901,13,914,1432,63.83%,43.09%,1
桃園市,桃園區,0174,496,292,788,32,820,1421,57.71%,34.9%,1
桃園市,桃園區,0175,446,247,693,10,703,1344,52.31%,33.18%,1
桃園市,桃園區,0176,592,292,884,18,902,1942,46.45%,30.48%,1
桃園市,桃園區,0177,661,325,986,23,1009,2001,50.42%,33.03%,1
桃園市,桃園區,0178,564,305,869,20,889,1941,45.8%,29.06%,1
桃園市,桃園區,0179,563,335,898,28,926,1702,54.41%,33.08%,1
桃園市,桃園區,0180,504,289,793,26,819,1589,51.54%,31.72%,1
桃園市,桃園區,0181,528,243,771,25,796,1544,51.55%,34.2%,1
桃園市,桃園區,0182,531,259,790,32,822,1860,44.19%,28.55%,1
桃園市,桃園區,0183,537,288,825,44,869,1726,50.35%,31.11%,1
桃園市,桃園區,0184,533,305,838,31,869,1798,48.33%,29.64%,1
桃園市,桃園區,0185,602,350,952,35,987,1925,51.27%,31.27%,1
桃園市,桃園區,0186,598,352,950,32,982,1945,50.49%,30.75%,1
桃園市,桃園區,0187,495,303,798,36,834,1764,47.28%,28.06%,1
桃園市,桃園區,0188,688,293,981,50,1031,1899,54.29%,36.23%,1
桃園市,桃園區,0189,462,255,717,15,732,1415,51.73%,32.65%,1
桃園市,桃園區,0190,546,285,831,22,853,1790,47.65%,30.5%,1
桃園市,桃園區,0191,485,295,780,19,799,1693,47.19%,28.65%,1
桃園市,桃園區,0192,591,319,910,39,949,1916,49.53%,30.85%,1
桃園市,桃園區,0193,429,237,666,17,683,1434,47.63%,29.92%,1
桃園市,桃園區,0194,522,298,820,32,852,1494,57.03%,34.94%,1
桃園市,桃園區,0195,444,230,674,49,723,1311,55.15%,33.87%,1
桃園市,桃園區,0196,492,258,750,40,790,1476,53.52%,33.33%,1
桃園市,桃園區,0197,491,319,810,23,833,1484,56.13%,33.09%,1
桃園市,桃園區,0198,481,268,749,24,773,1514,51.06%,31.77%,1
桃園市,桃園區,0199,509,215,724,28,752,1446,52.01%,35.2%,1
桃園市,桃園區,0200,507,251,758,24,782,1573,49.71%,32.23%,1
桃園市,桃園區,0201,458,236,694,25,719,1564,45.97%,29.28%,1
桃園市,桃園區,0202,353,193,546,30,576,1015,56.75%,34.78%,1
桃園市,桃園區,0203,305,164,469,22,491,955,51.41%,31.94%,1
桃園市,桃園區,0204,640,232,872,29,901,1796,50.17%,35.63%,1
桃園市,桃園區,0205,574,322,896,16,912,1878,48.56%,30.56%,1
桃園市,桃園區,0206,554,271,825,27,852,1729,49.28%,32.04%,1
桃園市,桃園區,0207,556,265,821,17,838,1843,45.47%,30.17%,1
桃園市,桃園區,0208,496,269,765,19,784,1817,43.15%,27.3%,1
桃園市,桃園區,0209,366,167,533,21,554,979,56.59%,37.39%,1
桃園市,桃園區,0210,445,264,709,15,724,1363,53.12%,32.65%,1
桃園市,桃園區,0211,521,255,776,18,794,1546,51.36%,33.7%,1
桃園市,桃園區,0212,414,224,638,24,662,1308,50.61%,31.65%,1
桃園市,桃園區,0213,679,348,1027,44,1071,2164,49.49%,31.38%,1
桃園市,桃園區,0214,603,332,935,40,975,2020,48.27%,29.85%,1
桃園市,桃園區,0215,556,278,834,27,861,1924,44.75%,28.9%,1
桃園市,桃園區,0216,281,579,860,37,897,2088,42.96%,13.46%,1
桃園市,中壢區,0591,484,267,751,18,769,1401,54.89%,34.55%,1
桃園市,中壢區,0592,564,300,864,34,898,1798,49.94%,31.37%,1
桃園市,中壢區,0593,483,263,746,32,778,1642,47.38%,29.42%,1
桃園市,中壢區,0594,615,268,883,23,906,1670,54.25%,36.83%,1
桃園市,中壢區,0595,535,256,791,18,809,1456,55.56%,36.74%,1
桃園市,中壢區,0596,604,291,895,23,918,1531,59.96%,39.45%,1
桃園市,中壢區,0597,620,287,907,25,932,1623,57.42%,38.2%,1
桃園市,中壢區,0598,628,238,866,26,892,1953,45.67%,32.16%,1
桃園市,中壢區,0599,446,200,646,17,663,1155,57.4%,38.61%,1
桃園市,中壢區,0600,577,234,811,23,834,1800,46.33%,32.06%,1
桃園市,中壢區,0601,573,263,836,14,850,1757,48.38%,32.61%,1
桃園市,中壢區,0602,534,193,727,30,757,1281,59.09%,41.69%,1
桃園市,中壢區,0603,557,254,811,19,830,1462,56.77%,38.1%,1
桃園市,中壢區,0604,693,92,785,31,816,1560,52.31%,44.42%,1
桃園市,中壢區,0605,651,257,908,25,933,1602,58.24%,40.64%,1
桃園市,中壢區,0606,456,163,619,28,647,1006,64.31%,45.33%,1
桃園市,中壢區,0607,572,247,819,18,837,1474,56.78%,38.81%,1
桃園市,中壢區,0608,610,227,837,51,888,1627,54.58%,37.49%,1
桃園市,中壢區,0609,578,249,827,32,859,1519,56.55%,38.05%,1
桃園市,中壢區,0610,578,221,799,50,849,1526,55.64%,37.88%,1
桃園市,中壢區,0611,570,239,809,64,873,1618,53.96%,35.23%,1
桃園市,中壢區,0612,565,307,872,34,906,1554,58.3%,36.36%,1
桃園市,中壢區,0613,664,217,881,43,924,1706,54.16%,38.92%,1
桃園市,中壢區,0614,699,306,1005,31,1036,1818,56.99%,38.45%,1
桃園市,中壢區,0615,681,290,971,27,998,1991,50.13%,34.2%,1
桃園市,中壢區,0616,591,241,832,30,862,1609,53.57%,36.73%,1
桃園市,中壢區,0617,470,155,625,33,658,1329,49.51%,35.36%,1
桃園市,中壢區,0618,518,218,736,59,795,1587,50.09%,32.64%,1
桃園市,中壢區,0619,685,300,985,14,999,1955,51.1%,35.04%,1
桃園市,中壢區,0620,582,259,841,49,890,1711,52.02%,34.02%,1
桃園市,中壢區,0621,598,254,852,28,880,1712,51.4%,34.93%,1
桃園市,中壢區,0622,558,236,794,42,836,1448,57.73%,38.54%,1
桃園市,中壢區,0623,527,621,1148,37,1185,1605,73.83%,32.83%,1
桃園市,中壢區,0624,541,232,773,8,781,1633,47.83%,33.13%,1
桃園市,中壢區,0625,664,316,980,39,1019,1795,56.77%,36.99%,1
桃園市,中壢區,0626,639,264,903,15,918,1689,54.35%,37.83%,1
桃園市,中壢區,0627,450,204,654,19,673,1201,56.04%,37.47%,1
桃園市,中壢區,0628,468,239,707,18,725,1353,53.58%,34.59%,1
桃園市,中壢區,0629,536,249,785,13,798,1587,50.28%,33.77%,1
桃園市,中壢區,0630,697,291,988,34,1022,1883,54.28%,37.02%,1
桃園市,中壢區,0631,491,243,734,16,750,1448,51.8%,33.91%,1
桃園市,中壢區,0632,624,300,924,28,952,1810,52.6%,34.48%,1
桃園市,中壢區,0633,627,311,938,44,982,1916,51.25%,32.72%,1
桃園市,中壢區,0634,494,168,662,19,681,1177,57.86%,41.97%,1
桃園市,中壢區,0635,567,241,808,35,843,1410,59.79%,40.21%,1
桃園市,中壢區,0636,478,228,706,17,723,1368,52.85%,34.94%,1
桃園市,中壢區,0637,581,252,833,28,861,1424,60.46%,40.8%,1
桃園市,中壢區,0638,562,297,859,21,880,1573,55.94%,35.73%,1
桃園市,中壢區,0639,437,204,641,20,661,1152,57.38%,37.93%,1
桃園市,中壢區,0640,436,219,655,17,672,1178,57.05%,37.01%,1
桃園市,中壢區,0641,692,321,1013,31,1044,1966,53.1%,35.2%,1
桃園市,中壢區,0642,458,236,694,24,718,3474,20.67%,13.18%,1
桃園市,中壢區,0643,725,372,1097,37,1134,2099,54.03%,34.54%,1
桃園市,中壢區,0644,415,213,628,36,664,1178,56.37%,35.23%,1
桃園市,中壢區,0645,528,286,814,41,855,1397,61.2%,37.8%,1
桃園市,中壢區,0646,564,325,889,39,928,1669,55.6%,33.79%,1
桃園市,中壢區,0647,750,322,1072,39,1111,2087,53.23%,35.94%,1
桃園市,中壢區,0648,636,311,947,26,973,1900,51.21%,33.47%,1
桃園市,中壢區,0649,473,235,708,17,725,1640,44.21%,28.84%,1
桃園市,中壢區,0650,406,174,580,23,603,994,60.66%,40.85%,1
桃園市,中壢區,0651,502,192,694,34,728,1131,64.37%,44.39%,1
桃園市,中壢區,0652,614,314,928,28,956,1625,58.83%,37.78%,1
桃園市,中壢區,0653,546,285,831,28,859,1384,62.07%,39.45%,1
桃園市,中壢區,0654,568,249,817,41,858,1588,54.03%,35.77%,1
桃園市,中壢區,0655,534,201,735,50,785,1445,54.33%,36.96%,1
桃園市,中壢區,0656,559,221,780,34,814,1743,46.7%,32.07%,1
桃園市,中壢區,0657,574,263,837,15,852,1812,47.02%,31.68%,1
桃園市,中壢區,0658,510,247,757,32,789,1546,51.03%,32.99%,1
桃園市,中壢區,0659,466,160,626,34,660,1290,51.16%,36.12%,1
桃園市,中壢區,0660,728,254,982,65,1047,2145,48.81%,33.94%,1
桃園市,中壢區,0661,436,257,693,25,718,1451,49.48%,30.05%,1
桃園市,中壢區,0662,541,210,751,27,778,1489,52.25%,36.33%,1
桃園市,中壢區,0663,302,136,438,24,462,827,55.86%,36.52%,1
桃園市,中壢區,0664,511,209,720,27,747,1442,51.8%,35.44%,1
桃園市,中壢區,0665,591,278,869,24,893,1842,48.48%,32.08%,1
桃園市,中壢區,0666,492,222,714,25,739,1520,48.62%,32.37%,1
桃園市,中壢區,0667,534,247,781,37,818,1764,46.37%,30.27%,1
桃園市,中壢區,0668,592,224,816,12,828,1488,55.65%,39.78%,1
桃園市,中壢區,0669,555,266,821,29,850,1593,53.36%,34.84%,1
桃園市,中壢區,0670,531,256,787,16,803,1505,53.36%,35.28%,1
桃園市,中壢區,0671,604,245,849,22,871,1661,52.44%,36.36%,1
桃園市,中壢區,0672,542,247,789,26,815,1492,54.62%,36.33%,1
桃園市,中壢區,0673,376,214,590,30,620,1249,49.64%,30.1%,1
桃園市,中壢區,0674,466,214,680,23,703,1257,55.93%,37.07%,1
桃園市,中壢區,0675,446,374,820,45,865,1659,52.14%,26.88%,1
桃園市,中壢區,0676,631,344,975,16,991,1815,54.6%,34.77%,1
桃園市,中壢區,0677,568,275,843,25,868,1702,51%,33.37%,1
桃園市,中壢區,0678,526,276,802,24,826,1541,53.6%,34.13%,1
桃園市,中壢區,0679,572,222,794,25,819,1659,49.37%,34.48%,1
桃園市,中壢區,0680,673,240,913,56,969,1874,51.71%,35.91%,1
桃園市,中壢區,0681,604,177,781,21,802,1603,50.03%,37.68%,1
桃園市,中壢區,0682,575,270,845,36,881,1735,50.78%,33.14%,1
桃園市,中壢區,0683,595,298,893,18,911,1815,50.19%,32.78%,1
桃園市,中壢區,0684,601,315,916,17,933,1873,49.81%,32.09%,1
桃園市,中壢區,0685,669,254,923,48,971,1739,55.84%,38.47%,1
桃園市,中壢區,0686,555,257,812,32,844,1709,49.39%,32.48%,1
桃園市,中壢區,0687,624,261,885,27,912,1655,55.11%,37.7%,1
桃園市,中壢區,0688,631,229,860,34,894,1664,53.73%,37.92%,1
桃園市,中壢區,0689,382,144,526,18,544,1087,50.05%,35.14%,1
桃園市,中壢區,0690,384,180,564,40,604,1065,56.71%,36.06%,1
桃園市,中壢區,0691,643,301,944,49,993,1844,53.85%,34.87%,1
桃園市,中壢區,0692,375,185,560,28,588,1220,48.2%,30.74%,1
桃園市,中壢區,0693,398,235,633,25,658,1219,53.98%,32.65%,1
桃園市,中壢區,0694,445,215,660,37,697,1260,55.32%,35.32%,1
桃園市,中壢區,0695,616,274,890,38,928,1594,58.22%,38.64%,1
桃園市,中壢區,0696,559,320,879,62,941,1733,54.3%,32.26%,1
桃園市,中壢區,0697,676,330,1006,41,1047,1979,52.91%,34.16%,1
桃園市,中壢區,0698,577,297,874,18,892,1621,55.03%,35.6%,1
桃園市,中壢區,0699,521,244,765,23,788,1391,56.65%,37.46%,1
桃園市,中壢區,0700,548,277,825,24,849,1531,55.45%,35.79%,1
桃園市,中壢區,0701,640,267,907,29,936,1943,48.17%,32.94%,1
桃園市,中壢區,0702,460,235,695,23,718,1363,52.68%,33.75%,1
桃園市,中壢區,0703,649,300,949,37,986,2172,45.4%,29.88%,1
桃園市,中壢區,0704,609,243,852,27,879,1798,48.89%,33.87%,1
桃園市,中壢區,0705,572,248,820,12,832,1671,49.79%,34.23%,1
桃園市,中壢區,0706,644,318,962,27,989,1969,50.23%,32.71%,1
桃園市,中壢區,0707,648,307,955,28,983,1563,62.89%,41.46%,1
桃園市,中壢區,0708,640,316,956,24,980,1762,55.62%,36.32%,1
桃園市,中壢區,0709,552,242,794,31,825,1923,42.9%,28.71%,1
桃園市,中壢區,0710,587,276,863,38,901,1572,57.32%,37.34%,1
桃園市,中壢區,0711,684,316,1000,21,1021,1850,55.19%,36.97%,1
桃園市,中壢區,0712,523,259,782,37,819,1583,51.74%,33.04%,1
桃園市,中壢區,0713,577,296,873,31,904,1735,52.1%,33.26%,1
桃園市,中壢區,0714,406,262,668,21,689,1292,53.33%,31.42%,1
桃園市,中壢區,0715,448,224,672,22,694,1265,54.86%,35.42%,1
桃園市,中壢區,0716,585,327,912,28,940,1798,52.28%,32.54%,1
桃園市,中壢區,0717,673,328,1001,41,1042,1822,57.19%,36.94%,1
桃園市,中壢區,0718,568,283,851,17,868,1613,53.81%,35.21%,1
桃園市,中壢區,0719,448,285,733,25,758,1405,53.95%,31.89%,1
桃園市,中壢區,0720,597,323,920,57,977,1730,56.47%,34.51%,1
桃園市,中壢區,0721,551,282,833,22,855,1384,61.78%,39.81%,1
桃園市,中壢區,0722,403,212,615,20,635,1122,56.6%,35.92%,1
桃園市,中壢區,0723,376,195,571,31,602,992,60.69%,37.9%,1
桃園市,中壢區,0724,590,335,925,27,952,1820,52.31%,32.42%,1
桃園市,中壢區,0725,634,273,907,31,938,1847,50.79%,34.33%,1
桃園市,中壢區,0726,515,205,720,34,754,1302,57.91%,39.55%,1
桃園市,中壢區,0727,462,203,665,33,698,1203,58.02%,38.4%,1
桃園市,中壢區,0728,519,239,758,31,789,1226,64.36%,42.33%,1
桃園市,中壢區,0729,507,199,706,30,736,1234,59.64%,41.09%,1
桃園市,中壢區,0730,687,281,968,43,1011,2023,49.98%,33.96%,1
桃園市,中壢區,0731,500,220,720,28,748,1555,48.1%,32.15%,1
桃園市,中壢區,0732,645,303,948,33,981,1951,50.28%,33.06%,1
桃園市,中壢區,0733,481,261,742,31,773,1383,55.89%,34.78%,1
桃園市,中壢區,0734,485,186,671,33,704,1164,60.48%,41.67%,1
桃園市,中壢區,0735,559,235,794,23,817,1482,55.13%,37.72%,1
桃園市,中壢區,0736,654,255,909,42,951,1770,53.73%,36.95%,1
桃園市,中壢區,0737,625,312,937,52,989,1703,58.07%,36.7%,1
桃園市,中壢區,0738,651,281,932,46,978,1841,53.12%,35.36%,1
桃園市,中壢區,0739,657,386,1043,30,1073,1941,55.28%,33.85%,1
桃園市,中壢區,0740,730,365,1095,32,1127,2029,55.54%,35.98%,1
桃園市,中壢區,0741,647,271,918,23,941,1636,57.52%,39.55%,1
桃園市,中壢區,0742,573,264,837,37,874,1528,57.2%,37.5%,1
桃園市,中壢區,0743,667,386,1053,47,1100,2289,48.06%,29.14%,1
桃園市,中壢區,0744,606,364,970,25,995,2020,49.26%,30%,1
桃園市,中壢區,0745,708,335,1043,38,1081,2027,53.33%,34.93%,1
桃園市,中壢區,0746,528,286,814,18,832,1883,44.18%,28.04%,1
桃園市,中壢區,0747,661,329,990,34,1024,2080,49.23%,31.78%,1
桃園市,中壢區,0748,207,125,332,10,342,646,52.94%,32.04%,1
桃園市,中壢區,0749,743,324,1067,38,1105,1780,62.08%,41.74%,1
桃園市,中壢區,0750,568,209,777,16,793,1372,57.8%,41.4%,1
桃園市,中壢區,0751,640,299,939,28,967,1668,57.97%,38.37%,1
桃園市,中壢區,0752,632,342,974,19,993,1987,49.97%,31.81%,1
桃園市,中壢區,0753,529,278,807,18,825,1520,54.28%,34.8%,1
桃園市,中壢區,0754,292,150,442,24,466,852,54.69%,34.27%,1
桃園市,中壢區,0755,394,245,639,29,668,1209,55.25%,32.59%,1
桃園市,中壢區,0756,503,261,764,45,809,1481,54.63%,33.96%,1
桃園市,中壢區,0757,483,244,727,23,750,1564,47.95%,30.88%,1
桃園市,中壢區,0758,681,341,1022,46,1068,1957,54.57%,34.8%,1
桃園市,中壢區,0759,450,237,687,38,725,1223,59.28%,36.79%,1
桃園市,中壢區,0760,468,225,693,28,721,1182,61%,39.59%,1
桃園市,中壢區,0761,394,203,597,34,631,1066,59.19%,36.96%,1
桃園市,中壢區,0762,645,301,946,34,980,1701,57.61%,37.92%,1
桃園市,中壢區,0763,319,158,477,29,506,943,53.66%,33.83%,1
桃園市,中壢區,0764,278,143,421,23,444,731,60.74%,38.03%,1
桃園市,中壢區,0765,297,151,448,43,491,851,57.7%,34.9%,1
桃園市,中壢區,0766,338,191,529,32,561,1011,55.49%,33.43%,1
桃園市,中壢區,0767,585,273,858,26,884,1532,57.7%,38.19%,1
桃園市,中壢區,0768,360,173,533,29,562,1028,54.67%,35.02%,1
桃園市,中壢區,0769,453,208,661,25,686,1157,59.29%,39.15%,1
桃園市,中壢區,0770,514,297,811,36,847,1591,53.24%,32.31%,1
桃園市,中壢區,0771,665,321,986,44,1030,2156,47.77%,30.84%,1
桃園市,中壢區,0772,459,225,684,24,708,1479,47.87%,31.03%,1
桃園市,中壢區,0773,605,313,918,27,945,1780,53.09%,33.99%,1
桃園市,中壢區,0774,571,281,852,44,896,1651,54.27%,34.59%,1
桃園市,中壢區,0775,663,323,986,26,1012,1870,54.12%,35.45%,1
桃園市,中壢區,0776,575,290,865,12,877,1913,45.84%,30.06%,1
桃園市,中壢區,0777,531,212,743,30,773,1609,48.04%,33%,1
桃園市,中壢區,0778,492,251,743,30,773,1539,50.23%,31.97%,1
桃園市,中壢區,0779,488,250,738,26,764,1426,53.58%,34.22%,1
桃園市,中壢區,0780,522,245,767,26,793,1618,49.01%,32.26%,1
桃園市,中壢區,0781,519,235,754,31,785,1441,54.48%,36.02%,1
桃園市,中壢區,0782,538,276,814,31,845,1528,55.3%,35.21%,1
桃園市,中壢區,0783,574,285,859,52,911,1683,54.13%,34.11%,1
桃園市,中壢區,0784,684,335,1019,55,1074,1945,55.22%,35.17%,1
桃園市,中壢區,0785,523,252,775,40,815,1534,53.13%,34.09%,1
桃園市,中壢區,0786,580,291,871,41,912,1810,50.39%,32.04%,1
桃園市,中壢區,0787,338,174,512,50,562,1097,51.23%,30.81%,1
桃園市,中壢區,0788,572,337,909,28,937,1917,48.88%,29.84%,1
桃園市,中壢區,0789,548,378,926,33,959,1858,51.61%,29.49%,1
桃園市,中壢區,0790,481,360,841,38,879,1576,55.77%,30.52%,1
桃園市,中壢區,0791,558,200,758,35,793,1478,53.65%,37.75%,1
桃園市,中壢區,0792,524,291,815,25,840,1589,52.86%,32.98%,1
桃園市,中壢區,0793,696,361,1057,63,1120,2037,54.98%,34.17%,1
桃園市,中壢區,0794,446,210,656,34,690,1158,59.59%,38.51%,1
桃園市,中壢區,0795,715,331,1046,43,1089,1967,55.36%,36.35%,1
桃園市,中壢區,0796,605,274,879,47,926,1830,50.6%,33.06%,1
桃園市,中壢區,0797,682,287,969,37,1006,1856,54.2%,36.75%,1
桃園市,中壢區,0798,637,344,981,65,1046,2068,50.58%,30.8%,1
桃園市,中壢區,0799,555,305,860,34,894,2152,41.54%,25.79%,1
桃園市,中壢區,0800,604,349,953,37,990,2158,45.88%,27.99%,1
桃園市,大溪區,0522,508,283,791,46,837,1477,56.67%,34.39%,1
桃園市,大溪區,0523,358,183,541,20,561,1006,55.77%,35.59%,1
桃園市,大溪區,0524,533,232,765,49,814,1553,52.41%,34.32%,1
桃園市,大溪區,0525,513,305,818,54,872,1597,54.6%,32.12%,1
桃園市,大溪區,0526,470,221,691,36,727,1358,53.53%,34.61%,1
桃園市,大溪區,0527,497,240,737,26,763,1585,48.14%,31.36%,1
桃園市,大溪區,0528,510,281,791,46,837,1612,51.92%,31.64%,1
桃園市,大溪區,0529,476,221,697,33,730,1555,46.95%,30.61%,1
桃園市,大溪區,0530,486,251,737,38,775,1282,60.45%,37.91%,1
桃園市,大溪區,0531,470,220,690,42,732,1392,52.59%,33.76%,1
桃園市,大溪區,0532,461,227,688,36,724,1422,50.91%,32.42%,1
桃園市,大溪區,0533,497,241,738,53,791,1448,54.63%,34.32%,1
桃園市,大溪區,0534,477,257,734,44,778,1269,61.31%,37.59%,1
桃園市,大溪區,0535,351,183,534,56,590,977,60.39%,35.93%,1
桃園市,大溪區,0536,474,248,722,49,771,1359,56.73%,34.88%,1
桃園市,大溪區,0537,405,238,643,51,694,1135,61.15%,35.68%,1
桃園市,大溪區,0538,190,121,311,41,352,660,53.33%,28.79%,1
桃園市,大溪區,0539,294,191,485,48,533,1056,50.47%,27.84%,1
桃園市,大溪區,0540,409,198,607,46,653,1263,51.7%,32.38%,1
桃園市,大溪區,0541,244,122,366,36,402,717,56.07%,34.03%,1
桃園市,大溪區,0542,356,172,528,33,561,1299,43.19%,27.41%,1
桃園市,大溪區,0543,334,159,493,50,543,976,55.64%,34.22%,1
桃園市,大溪區,0544,335,145,480,30,510,938,54.37%,35.71%,1
桃園市,大溪區,0545,278,126,404,28,432,832,51.92%,33.41%,1
桃園市,大溪區,0546,266,114,380,23,403,866,46.54%,30.72%,1
桃園市,大溪區,0547,189,125,314,32,346,694,49.86%,27.23%,1
桃園市,大溪區,0548,438,230,668,41,709,1410,50.28%,31.06%,1
桃園市,大溪區,0549,456,158,614,37,651,1303,49.96%,35%,1
桃園市,大溪區,0550,361,201,562,28,590,1125,52.44%,32.09%,1
桃園市,大溪區,0551,404,216,620,23,643,1170,54.96%,34.53%,1
桃園市,大溪區,0552,475,265,740,24,764,1308,58.41%,36.31%,1
桃園市,大溪區,0553,372,197,569,50,619,1094,56.58%,34%,1
桃園市,大溪區,0554,810,300,1110,40,1150,2153,53.41%,37.62%,1
桃園市,大溪區,0555,600,49,649,29,678,1173,57.8%,51.15%,1
桃園市,大溪區,0556,486,202,688,20,708,1369,51.72%,35.5%,1
桃園市,大溪區,0557,516,185,701,43,744,1446,51.45%,35.68%,1
桃園市,大溪區,0558,438,145,583,40,623,1406,44.31%,31.15%,1
桃園市,大溪區,0559,590,240,830,30,860,1592,54.02%,37.06%,1
桃園市,大溪區,0560,571,244,815,40,855,1497,57.11%,38.14%,1
桃園市,大溪區,0561,562,276,838,52,890,1559,57.09%,36.05%,1
桃園市,大溪區,0562,593,256,849,18,867,1684,51.48%,35.21%,1
桃園市,大溪區,0563,705,340,1045,45,1090,1959,55.64%,35.99%,1
桃園市,大溪區,0564,539,212,751,32,783,1369,57.2%,39.37%,1
桃園市,大溪區,0565,529,237,766,41,807,1431,56.39%,36.97%,1
桃園市,大溪區,0566,468,202,670,22,692,1657,41.76%,28.24%,1
桃園市,大溪區,0567,408,196,604,22,626,1387,45.13%,29.42%,1
桃園市,大溪區,0568,382,172,554,23,577,1085,53.18%,35.21%,1
桃園市,大溪區,0569,553,222,775,26,801,1403,57.09%,39.42%,1
桃園市,大溪區,0570,464,248,712,72,784,1511,51.89%,30.71%,1
桃園市,大溪區,0571,487,259,746,55,801,1719,46.6%,28.33%,1
桃園市,大溪區,0572,483,244,727,67,794,1717,46.24%,28.13%,1
桃園市,大溪區,0573,403,182,585,61,646,1207,53.52%,33.39%,1
桃園市,大溪區,0574,439,185,624,51,675,1188,56.82%,36.95%,1
桃園市,大溪區,0575,505,232,737,20,757,1514,50%,33.36%,1
桃園市,大溪區,0576,580,240,820,40,860,1529,56.25%,37.93%,1
桃園市,大溪區,0577,511,203,714,30,744,1260,59.05%,40.56%,1
桃園市,大溪區,0578,342,127,469,20,489,831,58.84%,41.16%,1
桃園市,大溪區,0579,509,233,742,39,781,1407,55.51%,36.18%,1
桃園市,大溪區,0580,507,203,710,49,759,1494,50.8%,33.94%,1
桃園市,楊梅區,0926,468,200,668,41,709,1269,55.87%,36.88%,1
桃園市,楊梅區,0927,543,190,733,40,773,1246,62.04%,43.58%,1
桃園市,楊梅區,0928,571,207,778,40,818,1408,58.1%,40.55%,1
桃園市,楊梅區,0929,553,230,783,34,817,1434,56.97%,38.56%,1
桃園市,楊梅區,0930,549,201,750,43,793,1515,52.34%,36.24%,1
桃園市,楊梅區,0931,570,204,774,44,818,1657,49.37%,34.4%,1
桃園市,楊梅區,0932,470,164,634,22,656,1137,57.7%,41.34%,1
桃園市,楊梅區,0933,761,325,1086,25,1111,2211,50.25%,34.42%,1
桃園市,楊梅區,0934,685,302,987,27,1014,2008,50.5%,34.11%,1
桃園市,楊梅區,0935,671,304,975,28,1003,1911,52.49%,35.11%,1
桃園市,楊梅區,0936,539,239,778,39,817,1449,56.38%,37.2%,1
桃園市,楊梅區,0937,563,262,825,43,868,1877,46.24%,29.99%,1
桃園市,楊梅區,0938,679,250,929,22,951,1988,47.84%,34.15%,1
桃園市,楊梅區,0939,702,324,1026,26,1052,1931,54.48%,36.35%,1
桃園市,楊梅區,0940,652,274,926,31,957,1938,49.38%,33.64%,1
桃園市,楊梅區,0941,611,247,858,25,883,1677,52.65%,36.43%,1
桃園市,楊梅區,0942,603,299,902,20,922,1848,49.89%,32.63%,1
桃園市,楊梅區,0943,647,309,956,17,973,1882,51.7%,34.38%,1
桃園市,楊梅區,0944,426,198,624,10,634,1541,41.14%,27.64%,1
桃園市,楊梅區,0945,650,288,938,22,960,1938,49.54%,33.54%,1
桃園市,楊梅區,0946,498,200,698,26,724,1562,46.35%,31.88%,1
桃園市,楊梅區,0947,719,421,1140,40,1180,2125,55.53%,33.84%,1
桃園市,楊梅區,0948,597,254,851,37,888,1516,58.58%,39.38%,1
桃園市,楊梅區,0949,641,229,870,19,889,1807,49.2%,35.47%,1
桃園市,楊梅區,0950,672,310,982,21,1003,2101,47.74%,31.98%,1
桃園市,楊梅區,0951,706,351,1057,31,1088,2054,52.97%,34.37%,1
桃園市,楊梅區,0952,712,294,1006,21,1027,2226,46.14%,31.99%,1
桃園市,楊梅區,0953,530,230,760,11,771,1405,54.88%,37.72%,1
桃園市,楊梅區,0954,574,279,853,28,881,1843,47.8%,31.14%,1
桃園市,楊梅區,0955,683,312,995,33,1028,2324,44.23%,29.39%,1
桃園市,楊梅區,0956,611,273,884,19,903,1713,52.71%,35.67%,1
桃園市,楊梅區,0957,694,222,916,29,945,1587,59.55%,43.73%,1
桃園市,楊梅區,0958,543,259,802,23,825,1416,58.26%,38.35%,1
桃園市,楊梅區,0959,604,250,854,18,872,1591,54.81%,37.96%,1
桃園市,楊梅區,0960,702,266,968,31,999,1943,51.42%,36.13%,1
桃園市,楊梅區,0961,649,273,922,27,949,1762,53.86%,36.83%,1
桃園市,楊梅區,0962,400,170,570,21,591,1083,54.57%,36.93%,1
桃園市,楊梅區,0963,728,284,1012,39,1051,2027,51.85%,35.92%,1
桃園市,楊梅區,0964,484,205,689,46,735,1274,57.69%,37.99%,1
桃園市,楊梅區,0965,568,195,763,26,789,1359,58.06%,41.8%,1
桃園市,楊梅區,0966,573,265,838,32,870,2444,35.6%,23.45%,1
桃園市,楊梅區,0967,702,304,1006,29,1035,2298,45.04%,30.55%,1
桃園市,楊梅區,0968,757,322,1079,16,1095,2222,49.28%,34.07%,1
桃園市,楊梅區,0969,584,241,825,41,866,1610,53.79%,36.27%,1
桃園市,楊梅區,0970,588,251,839,31,870,1627,53.47%,36.14%,1
桃園市,楊梅區,0971,613,213,826,37,863,1589,54.31%,38.58%,1
桃園市,楊梅區,0972,620,276,896,43,939,1758,53.41%,35.27%,1
桃園市,楊梅區,0973,528,209,737,41,778,1776,43.81%,29.73%,1
桃園市,楊梅區,0974,310,153,463,21,484,1000,48.4%,31%,1
桃園市,楊梅區,0975,669,304,973,61,1034,2290,45.15%,29.21%,1
桃園市,楊梅區,0976,526,241,767,48,815,1551,52.55%,33.91%,1
桃園市,楊梅區,0977,617,267,884,49,933,1861,50.13%,33.15%,1
桃園市,楊梅區,0978,323,165,488,52,540,1141,47.33%,28.31%,1
桃園市,楊梅區,0979,609,216,825,38,863,1785,48.35%,34.12%,1
桃園市,楊梅區,0980,534,221,755,45,800,1498,53.4%,35.65%,1
桃園市,楊梅區,0981,389,186,575,50,625,1187,52.65%,32.77%,1
桃園市,楊梅區,0982,471,199,670,40,710,1270,55.91%,37.09%,1
桃園市,楊梅區,0983,504,211,715,30,745,1424,52.32%,35.39%,1
桃園市,楊梅區,0984,418,311,729,16,745,1273,58.52%,32.84%,1
桃園市,楊梅區,0985,469,225,694,25,719,1534,46.87%,30.57%,1
桃園市,楊梅區,0986,496,298,794,54,848,1783,47.56%,27.82%,1
桃園市,楊梅區,0987,579,220,799,21,820,1709,47.98%,33.88%,1
桃園市,楊梅區,0988,589,261,850,37,887,1920,46.2%,30.68%,1
桃園市,楊梅區,0989,429,186,615,30,645,1194,54.02%,35.93%,1
桃園市,楊梅區,0990,500,232,732,21,753,1408,53.48%,35.51%,1
桃園市,楊梅區,0991,535,218,753,31,784,1737,45.14%,30.8%,1
桃園市,楊梅區,0992,680,250,930,24,954,1920,49.69%,35.42%,1
桃園市,楊梅區,0993,424,129,553,37,590,1234,47.81%,34.36%,1
桃園市,楊梅區,0994,529,254,783,47,830,1491,55.67%,35.48%,1
桃園市,楊梅區,0995,644,274,918,28,946,2020,46.83%,31.88%,1
桃園市,楊梅區,0996,560,283,843,25,868,1863,46.59%,30.06%,1
桃園市,楊梅區,0997,617,256,873,42,915,1692,54.08%,36.47%,1
桃園市,楊梅區,0998,591,266,857,30,887,1686,52.61%,35.05%,1
桃園市,楊梅區,0999,564,265,829,58,887,1626,54.55%,34.69%,1
桃園市,楊梅區,1000,582,248,830,16,846,1557,54.34%,37.38%,1
桃園市,楊梅區,1001,631,261,892,36,928,1603,57.89%,39.36%,1
桃園市,楊梅區,1002,602,283,885,46,931,1889,49.29%,31.87%,1
桃園市,楊梅區,1003,582,207,789,28,817,1448,56.42%,40.19%,1
桃園市,楊梅區,1004,505,224,729,39,768,1351,56.85%,37.38%,1
桃園市,楊梅區,1005,499,216,715,42,757,1313,57.65%,38%,1
桃園市,楊梅區,1006,578,263,841,39,880,1689,52.1%,34.22%,1
桃園市,楊梅區,1007,679,275,954,23,977,2063,47.36%,32.91%,1
桃園市,蘆竹區,0396,458,200,658,59,717,1358,52.8%,33.73%,1
桃園市,蘆竹區,0397,508,224,732,55,787,1538,51.17%,33.03%,1
桃園市,蘆竹區,0398,615,239,854,44,898,2118,42.4%,29.04%,1
桃園市,蘆竹區,0399,615,274,889,52,941,1673,56.25%,36.76%,1
桃園市,蘆竹區,0400,539,268,807,18,825,1500,55%,35.93%,1
桃園市,蘆竹區,0401,613,262,875,24,899,1699,52.91%,36.08%,1
桃園市,蘆竹區,0402,756,358,1114,34,1148,2250,51.02%,33.6%,1
桃園市,蘆竹區,0403,680,360,1040,17,1057,2354,44.9%,28.89%,1
桃園市,蘆竹區,0404,478,213,691,25,716,1446,49.52%,33.06%,1
桃園市,蘆竹區,0405,491,240,731,49,780,1623,48.06%,30.25%,1
桃園市,蘆竹區,0406,552,288,840,21,861,1747,49.28%,31.6%,1
桃園市,蘆竹區,0407,662,330,992,36,1028,1988,51.71%,33.3%,1
桃園市,蘆竹區,0408,509,226,735,26,761,1437,52.96%,35.42%,1
桃園市,蘆竹區,0409,571,253,824,37,861,1532,56.2%,37.27%,1
桃園市,蘆竹區,0410,462,242,704,37,741,1447,51.21%,31.93%,1
桃園市,蘆竹區,0411,729,354,1083,37,1120,2189,51.16%,33.3%,1
桃園市,蘆竹區,0412,812,334,1146,33,1179,2498,47.2%,32.51%,1
桃園市,蘆竹區,0413,465,233,698,24,722,1322,54.61%,35.17%,1
桃園市,蘆竹區,0414,530,269,799,47,846,1991,42.49%,26.62%,1
桃園市,蘆竹區,0415,615,320,935,53,988,2097,47.11%,29.33%,1
桃園市,蘆竹區,0416,532,290,822,29,851,1558,54.62%,34.15%,1
桃園市,蘆竹區,0417,611,352,963,25,988,1891,52.25%,32.31%,1
桃園市,蘆竹區,0418,488,257,745,28,773,1590,48.62%,30.69%,1
桃園市,蘆竹區,0419,712,324,1036,46,1082,2404,45.01%,29.62%,1
桃園市,蘆竹區,0420,818,396,1214,30,1244,2522,49.33%,32.43%,1
桃園市,蘆竹區,0421,548,275,823,21,844,1633,51.68%,33.56%,1
桃園市,蘆竹區,0422,568,291,859,30,889,1715,51.84%,33.12%,1
桃園市,蘆竹區,0423,660,357,1017,19,1036,2215,46.77%,29.8%,1
桃園市,蘆竹區,0424,634,319,953,28,981,2029,48.35%,31.25%,1
桃園市,蘆竹區,0425,524,283,807,25,832,1731,48.06%,30.27%,1
桃園市,蘆竹區,0426,611,290,901,23,924,1820,50.77%,33.57%,1
桃園市,蘆竹區,0427,565,285,850,32,882,1633,54.01%,34.6%,1
桃園市,蘆竹區,0428,530,259,789,21,810,1668,48.56%,31.77%,1
桃園市,蘆竹區,0429,526,279,805,16,821,1493,54.99%,35.23%,1
桃園市,蘆竹區,0430,651,292,943,32,975,1864,52.31%,34.92%,1
桃園市,蘆竹區,0431,536,301,837,23,860,1703,50.5%,31.47%,1
桃園市,蘆竹區,0432,621,333,954,29,983,1893,51.93%,32.81%,1
桃園市,蘆竹區,0433,671,366,1037,22,1059,1922,55.1%,34.91%,1
桃園市,蘆竹區,0434,531,213,744,14,758,1393,54.41%,38.12%,1
桃園市,蘆竹區,0435,493,228,721,18,739,1338,55.23%,36.85%,1
桃園市,蘆竹區,0436,569,272,841,15,856,1688,50.71%,33.71%,1
桃園市,蘆竹區,0437,478,241,719,34,753,1462,51.5%,32.69%,1
桃園市,蘆竹區,0438,435,191,626,23,649,1232,52.68%,35.31%,1
桃園市,蘆竹區,0439,410,211,621,27,648,1356,47.79%,30.24%,1
桃園市,蘆竹區,0440,467,228,695,26,721,1181,61.05%,39.54%,1
桃園市,蘆竹區,0441,403,186,589,18,607,1199,50.63%,33.61%,1
桃園市,蘆竹區,0442,586,298,884,17,901,1710,52.69%,34.27%,1
桃園市,蘆竹區,0443,446,239,685,24,709,1423,49.82%,31.34%,1
桃園市,蘆竹區,0444,490,309,799,20,819,1522,53.81%,32.19%,1
桃園市,蘆竹區,0445,559,184,743,25,768,1639,46.86%,34.11%,1
桃園市,蘆竹區,0446,672,324,996,32,1028,2055,50.02%,32.7%,1
桃園市,蘆竹區,0447,657,407,1064,33,1097,2178,50.37%,30.17%,1
桃園市,蘆竹區,0448,557,331,888,38,926,1709,54.18%,32.59%,1
桃園市,蘆竹區,0449,581,304,885,35,920,1667,55.19%,34.85%,1
桃園市,蘆竹區,0450,602,329,931,13,944,1745,54.1%,34.5%,1
桃園市,蘆竹區,0451,678,371,1049,29,1078,1967,54.8%,34.47%,1
桃園市,蘆竹區,0452,670,323,993,21,1014,1802,56.27%,37.18%,1
桃園市,蘆竹區,0453,873,428,1301,28,1329,2727,48.73%,32.01%,1
桃園市,蘆竹區,0454,549,317,866,25,891,1868,47.7%,29.39%,1
桃園市,蘆竹區,0455,490,262,752,30,782,1537,50.88%,31.88%,1
桃園市,蘆竹區,0456,517,306,823,26,849,1616,52.54%,31.99%,1
桃園市,蘆竹區,0457,573,262,835,25,860,1483,57.99%,38.64%,1
桃園市,蘆竹區,0458,554,254,808,39,847,1689,50.15%,32.8%,1
桃園市,蘆竹區,0459,379,169,548,19,567,1318,43.02%,28.76%,1
桃園市,蘆竹區,0460,507,208,715,56,771,1203,64.09%,42.14%,1
桃園市,蘆竹區,0461,553,270,823,22,845,1771,47.71%,31.23%,1
桃園市,蘆竹區,0462,574,259,833,32,865,1832,47.22%,31.33%,1
桃園市,蘆竹區,0463,564,262,826,63,889,1763,50.43%,31.99%,1
桃園市,蘆竹區,0464,415,235,650,24,674,1497,45.02%,27.72%,1
桃園市,蘆竹區,0465,604,287,891,102,993,1671,59.43%,36.15%,1
桃園市,蘆竹區,0466,337,155,492,45,537,929,57.8%,36.28%,1
桃園市,蘆竹區,0467,567,259,826,45,871,1559,55.87%,36.37%,1
桃園市,蘆竹區,0468,541,243,784,29,813,1497,54.31%,36.14%,1
桃園市,蘆竹區,0469,606,264,870,42,912,1441,63.29%,42.05%,1
桃園市,蘆竹區,0470,479,222,701,51,752,1465,51.33%,32.7%,1
桃園市,蘆竹區,0471,336,165,501,32,533,1029,51.8%,32.65%,1
桃園市,大園區,0472,452,222,674,28,702,1538,45.64%,29.39%,1
桃園市,大園區,0473,441,204,645,18,663,1616,41.03%,27.29%,1
桃園市,大園區,0474,517,257,774,40,814,1437,56.65%,35.98%,1
桃園市,大園區,0475,579,256,835,25,860,1554,55.34%,37.26%,1
桃園市,大園區,0476,377,230,607,29,636,1237,51.41%,30.48%,1
桃園市,大園區,0477,455,210,665,36,701,1347,52.04%,33.78%,1
桃園市,大園區,0478,396,235,631,26,657,1261,52.1%,31.4%,1
桃園市,大園區,0479,393,203,596,42,638,1256,50.8%,31.29%,1
桃園市,大園區,0480,436,198,634,19,653,1370,47.66%,31.82%,1
桃園市,大園區,0481,477,237,714,33,747,1610,46.4%,29.63%,1
桃園市,大園區,0482,462,211,673,41,714,1419,50.32%,32.56%,1
桃園市,大園區,0483,433,197,630,27,657,1588,41.37%,27.27%,1
桃園市,大園區,0484,507,270,777,41,818,1612,50.74%,31.45%,1
桃園市,大園區,0485,440,238,678,40,718,1440,49.86%,30.56%,1
桃園市,大園區,0486,399,224,623,27,650,1326,49.02%,30.09%,1
桃園市,大園區,0487,551,232,783,39,822,1455,56.49%,37.87%,1
桃園市,大園區,0488,518,271,789,51,840,1562,53.78%,33.16%,1
桃園市,大園區,0489,451,249,700,29,729,1284,56.78%,35.12%,1
桃園市,大園區,0490,415,263,678,15,693,1454,47.66%,28.54%,1
桃園市,大園區,0491,469,275,744,15,759,1490,50.94%,31.48%,1
桃園市,大園區,0492,510,239,749,25,774,1617,47.87%,31.54%,1
桃園市,大園區,0493,537,271,808,27,835,1594,52.38%,33.69%,1
桃園市,大園區,0494,566,239,805,42,847,1650,51.33%,34.3%,1
桃園市,大園區,0495,449,244,693,21,714,1467,48.67%,30.61%,1
桃園市,大園區,0496,498,243,741,25,766,1494,51.27%,33.33%,1
桃園市,大園區,0497,505,243,748,35,783,1538,50.91%,32.83%,1
桃園市,大園區,0498,472,219,691,26,717,1397,51.32%,33.79%,1
桃園市,大園區,0499,516,244,760,22,782,1637,47.77%,31.52%,1
桃園市,大園區,0500,464,206,670,33,703,1452,48.42%,31.96%,1
桃園市,大園區,0501,582,254,836,34,870,1414,61.53%,41.16%,1
桃園市,大園區,0502,596,256,852,22,874,1670,52.34%,35.69%,1
桃園市,大園區,0503,549,251,800,4,804,1701,47.27%,32.28%,1
桃園市,大園區,0504,545,238,783,20,803,1813,44.29%,30.06%,1
桃園市,大園區,0505,532,268,800,19,819,1687,48.55%,31.54%,1
桃園市,大園區,0506,562,274,836,6,842,1650,51.03%,34.06%,1
桃園市,大園區,0507,551,301,852,32,884,1556,56.81%,35.41%,1
桃園市,大園區,0508,532,275,807,17,824,1844,44.69%,28.85%,1
桃園市,大園區,0509,402,203,605,48,653,1336,48.88%,30.09%,1
桃園市,大園區,0510,577,171,748,39,787,1414,55.66%,40.81%,1
桃園市,大園區,0511,481,229,710,38,748,1238,60.42%,38.85%,1
桃園市,大園區,0512,495,211,706,34,740,1227,60.31%,40.34%,1
桃園市,大園區,0513,376,218,594,21,615,1199,51.29%,31.36%,1
桃園市,大園區,0514,410,199,609,26,635,1349,47.07%,30.39%,1
桃園市,大園區,0515,352,197,549,31,580,1120,51.79%,31.43%,1
桃園市,大園區,0516,369,182,551,22,573,1080,53.06%,34.17%,1
桃園市,大園區,0517,416,203,619,39,658,1341,49.07%,31.02%,1
桃園市,大園區,0518,461,225,686,27,713,1345,53.01%,34.28%,1
桃園市,大園區,0519,454,228,682,23,705,1565,45.05%,29.01%,1
桃園市,大園區,0520,423,212,635,23,658,1519,43.32%,27.85%,1
桃園市,大園區,0521,654,283,937,50,987,2130,46.34%,30.7%,1
桃園市,龜山區,0217,342,128,470,21,491,874,56.18%,39.13%,1
桃園市,龜山區,0218,767,253,1020,51,1071,2014,53.18%,38.08%,1
桃園市,龜山區,0219,658,372,1030,26,1056,2145,49.23%,30.68%,1
桃園市,龜山區,0220,698,207,905,42,947,1744,54.3%,40.02%,1
桃園市,龜山區,0221,753,232,985,40,1025,1885,54.38%,39.95%,1
桃園市,龜山區,0222,495,214,709,45,754,1546,48.77%,32.02%,1
桃園市,龜山區,0223,516,282,798,41,839,1684,49.82%,30.64%,1
桃園市,龜山區,0224,454,216,670,30,700,1477,47.39%,30.74%,1
桃園市,龜山區,0225,591,225,816,41,857,1528,56.09%,38.68%,1
桃園市,龜山區,0226,181,98,279,14,293,1428,20.52%,12.68%,1
桃園市,龜山區,0227,548,257,805,31,836,1525,54.82%,35.93%,1
桃園市,龜山區,0228,391,197,588,23,611,1041,58.69%,37.56%,1
桃園市,龜山區,0229,436,260,696,21,717,1404,51.07%,31.05%,1
桃園市,龜山區,0230,539,239,778,38,816,1478,55.21%,36.47%,1
桃園市,龜山區,0231,750,326,1076,46,1122,2178,51.52%,34.44%,1
桃園市,龜山區,0232,560,281,841,60,901,1672,53.89%,33.49%,1
桃園市,龜山區,0233,446,209,655,27,682,1376,49.56%,32.41%,1
桃園市,龜山區,0234,470,258,728,27,755,1480,51.01%,31.76%,1
桃園市,龜山區,0235,450,206,656,35,691,1258,54.93%,35.77%,1
桃園市,龜山區,0236,495,241,736,21,757,1464,51.71%,33.81%,1
桃園市,龜山區,0237,570,320,890,51,941,1844,51.03%,30.91%,1
桃園市,龜山區,0238,362,234,596,15,611,1169,52.27%,30.97%,1
桃園市,龜山區,0239,487,242,729,32,761,1921,39.61%,25.35%,1
桃園市,龜山區,0240,518,266,784,25,809,1694,47.76%,30.58%,1
桃園市,龜山區,0241,598,344,942,46,988,1771,55.79%,33.77%,1
桃園市,龜山區,0242,494,243,737,49,786,1665,47.21%,29.67%,1
桃園市,龜山區,0243,442,255,697,49,746,1439,51.84%,30.72%,1
桃園市,龜山區,0244,521,223,744,48,792,1728,45.83%,30.15%,1
桃園市,龜山區,0245,611,295,906,30,936,1788,52.35%,34.17%,1
桃園市,龜山區,0246,440,232,672,35,707,1465,48.26%,30.03%,1
桃園市,龜山區,0247,427,229,656,39,695,1659,41.89%,25.74%,1
桃園市,龜山區,0248,455,260,715,33,748,1693,44.18%,26.88%,1
桃園市,龜山區,0249,440,251,691,17,708,1818,38.94%,24.2%,1
桃園市,龜山區,0250,540,303,843,50,893,1752,50.97%,30.82%,1
桃園市,龜山區,0251,576,338,914,23,937,1818,51.54%,31.68%,1
桃園市,龜山區,0252,480,263,743,20,763,1499,50.9%,32.02%,1
桃園市,龜山區,0253,587,360,947,34,981,1916,51.2%,30.64%,1
桃園市,龜山區,0254,581,316,897,28,925,1804,51.27%,32.21%,1
桃園市,龜山區,0255,630,370,1000,23,1023,2127,48.1%,29.62%,1
桃園市,龜山區,0256,313,181,494,42,536,1005,53.33%,31.14%,1
桃園市,龜山區,0257,470,273,743,44,787,1449,54.31%,32.44%,1
桃園市,龜山區,0258,405,270,675,53,728,1498,48.6%,27.04%,1
桃園市,龜山區,0259,631,285,916,40,956,2149,44.49%,29.36%,1
桃園市,龜山區,0260,432,248,680,37,717,1771,40.49%,24.39%,1
桃園市,龜山區,0261,288,145,433,19,452,841,53.75%,34.24%,1
桃園市,龜山區,0262,664,334,998,48,1046,2284,45.8%,29.07%,1
桃園市,龜山區,0263,420,205,625,31,656,1228,53.42%,34.2%,1
桃園市,龜山區,0264,629,283,912,30,942,1979,47.6%,31.78%,1
桃園市,龜山區,0265,420,200,620,34,654,1378,47.46%,30.48%,1
桃園市,龜山區,0266,329,173,502,34,536,1061,50.52%,31.01%,1
桃園市,龜山區,0267,587,289,876,45,921,1917,48.04%,30.62%,1
桃園市,龜山區,0268,579,294,873,30,903,1540,58.64%,37.6%,1
桃園市,龜山區,0269,508,244,752,26,778,1433,54.29%,35.45%,1
桃園市,龜山區,0270,458,262,720,24,744,1455,51.13%,31.48%,1
桃園市,龜山區,0271,778,393,1171,54,1225,2280,53.73%,34.12%,1
桃園市,龜山區,0272,520,303,823,35,858,1668,51.44%,31.18%,1
桃園市,龜山區,0273,572,328,900,31,931,1885,49.39%,30.34%,1
桃園市,龜山區,0274,500,393,893,8,901,1849,48.73%,27.04%,1
桃園市,龜山區,0275,489,444,933,14,947,1704,55.58%,28.7%,1
桃園市,龜山區,0276,374,208,582,35,617,1156,53.37%,32.35%,1
桃園市,龜山區,0277,546,308,854,43,897,2114,42.43%,25.83%,1
桃園市,龜山區,0278,493,313,806,28,834,1943,42.92%,25.37%,1
桃園市,龜山區,0279,502,316,818,19,837,1800,46.5%,27.89%,1
桃園市,龜山區,0280,554,384,938,37,975,2020,48.27%,27.43%,1
桃園市,龜山區,0281,449,260,709,24,733,1319,55.57%,34.04%,1
桃園市,龜山區,0282,736,413,1149,40,1189,2229,53.34%,33.02%,1
桃園市,龜山區,0283,578,333,911,26,937,1992,47.04%,29.02%,1
桃園市,龜山區,0284,662,341,1003,36,1039,2237,46.45%,29.59%,1
桃園市,龜山區,0285,614,378,992,32,1024,2133,48.01%,28.79%,1
桃園市,龜山區,0286,656,415,1071,37,1108,2187,50.66%,30%,1
桃園市,龜山區,0287,596,326,922,32,954,1959,48.7%,30.42%,1
桃園市,龜山區,0288,529,331,860,30,890,1910,46.6%,27.7%,1
桃園市,龜山區,0289,630,297,927,55,982,1840,53.37%,34.24%,1
桃園市,龜山區,0290,758,346,1104,24,1128,2266,49.78%,33.45%,1
桃園市,龜山區,0291,698,350,1048,25,1073,2387,44.95%,29.24%,1
桃園市,龜山區,0292,517,278,795,18,813,1692,48.05%,30.56%,1
桃園市,龜山區,0293,269,182,451,15,466,904,51.55%,29.76%,1
桃園市,龜山區,0294,504,257,761,25,786,1469,53.51%,34.31%,1
桃園市,八德區,0295,530,253,783,51,834,1761,47.36%,30.1%,1
桃園市,八德區,0296,466,250,716,18,734,1804,40.69%,25.83%,1
桃園市,八德區,0297,325,167,492,19,511,1813,28.19%,17.93%,1
桃園市,八德區,0298,519,283,802,25,827,1784,46.36%,29.09%,1
桃園市,八德區,0299,646,286,932,22,954,2257,42.27%,28.62%,1
桃園市,八德區,0300,533,237,770,25,795,1857,42.81%,28.7%,1
桃園市,八德區,0301,667,297,964,34,998,2261,44.14%,29.5%,1
桃園市,八德區,0302,629,317,946,41,987,1903,51.87%,33.05%,1
桃園市,八德區,0303,647,283,930,48,978,1955,50.03%,33.09%,1
桃園市,八德區,0304,483,241,724,17,741,1665,44.5%,29.01%,1
桃園市,八德區,0305,470,271,741,32,773,1431,54.02%,32.84%,1
桃園市,八德區,0306,486,186,672,29,701,1263,55.5%,38.48%,1
桃園市,八德區,0307,566,267,833,35,868,1583,54.83%,35.75%,1
桃園市,八德區,0308,427,228,655,29,684,1246,54.9%,34.27%,1
桃園市,八德區,0309,471,222,693,30,723,1356,53.32%,34.73%,1
桃園市,八德區,0310,579,268,847,57,904,1630,55.46%,35.52%,1
桃園市,八德區,0311,552,233,785,25,810,1586,51.07%,34.8%,1
桃園市,八德區,0312,566,253,819,57,876,1649,53.12%,34.32%,1
桃園市,八德區,0313,573,262,835,62,897,1910,46.96%,30%,1
桃園市,八德區,0314,580,243,823,70,893,1612,55.4%,35.98%,1
桃園市,八德區,0315,591,230,821,36,857,1640,52.26%,36.04%,1
桃園市,八德區,0316,413,224,637,38,675,1303,51.8%,31.7%,1
桃園市,八德區,0317,488,273,761,46,807,1413,57.11%,34.54%,1
桃園市,八德區,0318,570,270,840,34,874,1711,51.08%,33.31%,1
桃園市,八德區,0319,549,233,782,55,837,1562,53.59%,35.15%,1
桃園市,八德區,0320,606,276,882,1,883,1735,50.89%,34.93%,1
桃園市,八德區,0321,564,260,824,24,848,1658,51.15%,34.02%,1
桃園市,八德區,0322,401,179,580,34,614,1022,60.08%,39.24%,1
桃園市,八德區,0323,502,230,732,39,771,1673,46.08%,30.01%,1
桃園市,八德區,0324,576,251,827,33,860,1741,49.4%,33.08%,1
桃園市,八德區,0325,691,325,1016,51,1067,2110,50.57%,32.75%,1
桃園市,八德區,0326,434,152,586,28,614,1145,53.62%,37.9%,1
桃園市,八德區,0327,435,151,586,36,622,1010,61.58%,43.07%,1
桃園市,八德區,0328,527,271,798,26,824,1848,44.59%,28.52%,1
桃園市,八德區,0329,492,212,704,27,731,1334,54.8%,36.88%,1
桃園市,八德區,0330,382,195,577,19,596,1349,44.18%,28.32%,1
桃園市,八德區,0331,473,251,724,38,762,1341,56.82%,35.27%,1
桃園市,八德區,0332,460,179,639,42,681,1178,57.81%,39.05%,1
桃園市,八德區,0333,466,245,711,37,748,1374,54.44%,33.92%,1
桃園市,八德區,0334,434,253,687,53,740,1462,50.62%,29.69%,1
桃園市,八德區,0335,557,257,814,52,866,1943,44.57%,28.67%,1
桃園市,八德區,0336,452,252,704,59,763,1928,39.57%,23.44%,1
桃園市,八德區,0337,447,220,667,22,689,1403,49.11%,31.86%,1
桃園市,八德區,0338,499,257,756,49,805,1672,48.15%,29.84%,1
桃園市,八德區,0339,569,300,869,36,905,1947,46.48%,29.22%,1
桃園市,八德區,0340,416,205,621,37,658,1200,54.83%,34.67%,1
桃園市,八德區,0341,565,288,853,45,898,1895,47.39%,29.82%,1
桃園市,八德區,0342,577,295,872,43,915,1988,46.03%,29.02%,1
桃園市,八德區,0343,664,334,998,44,1042,2006,51.94%,33.1%,1
桃園市,八德區,0344,604,311,915,5,920,2061,44.64%,29.31%,1
桃園市,八德區,0345,613,312,925,56,981,2108,46.54%,29.08%,1
桃園市,八德區,0346,577,270,847,42,889,1862,47.74%,30.99%,1
桃園市,八德區,0347,503,184,687,23,710,1681,42.24%,29.92%,1
桃園市,八德區,0348,468,207,675,49,724,1317,54.97%,35.54%,1
桃園市,八德區,0349,709,420,1129,37,1166,2093,55.71%,33.87%,1
桃園市,八德區,0350,539,268,807,47,854,1499,56.97%,35.96%,1
桃園市,八德區,0351,582,263,845,64,909,1782,51.01%,32.66%,1
桃園市,八德區,0352,593,296,889,21,910,1763,51.62%,33.64%,1
桃園市,八德區,0353,411,216,627,46,673,1226,54.89%,33.52%,1
桃園市,八德區,0354,452,255,707,19,726,1311,55.38%,34.48%,1
桃園市,八德區,0355,411,223,634,31,665,1170,56.84%,35.13%,1
桃園市,八德區,0356,494,202,696,30,726,1313,55.29%,37.62%,1
桃園市,八德區,0357,403,217,620,21,641,1186,54.05%,33.98%,1
桃園市,八德區,0358,447,246,693,29,722,1481,48.75%,30.18%,1
桃園市,八德區,0359,633,342,975,50,1025,1998,51.3%,31.68%,1
桃園市,八德區,0360,325,163,488,27,515,916,56.22%,35.48%,1
桃園市,八德區,0361,606,294,900,28,928,1943,47.76%,31.19%,1
桃園市,八德區,0362,676,302,978,38,1016,2076,48.94%,32.56%,1
桃園市,八德區,0363,479,204,683,54,737,1363,54.07%,35.14%,1
桃園市,八德區,0364,520,222,742,47,789,1491,52.92%,34.88%,1
桃園市,八德區,0365,487,222,709,53,762,1474,51.7%,33.04%,1
桃園市,八德區,0366,132,32,164,11,175,718,24.37%,18.38%,1
桃園市,八德區,0367,453,235,688,42,730,1386,52.67%,32.68%,1
桃園市,八德區,0368,504,215,719,53,772,1487,51.92%,33.89%,1
桃園市,八德區,0369,550,203,753,60,813,1552,52.38%,35.44%,1
桃園市,八德區,0370,422,154,576,38,614,1255,48.92%,33.63%,1
桃園市,八德區,0371,525,281,806,36,842,1505,55.95%,34.88%,1
桃園市,八德區,0372,461,212,673,30,703,1436,48.96%,32.1%,1
桃園市,八德區,0373,426,398,824,58,882,1618,54.51%,26.33%,1
桃園市,八德區,0374,590,221,811,43,854,1685,50.68%,35.01%,1
桃園市,八德區,0375,539,272,811,37,848,1835,46.21%,29.37%,1
桃園市,八德區,0376,622,293,915,39,954,1881,50.72%,33.07%,1
桃園市,八德區,0377,582,248,830,35,865,1766,48.98%,32.96%,1
桃園市,八德區,0378,587,270,857,69,926,1817,50.96%,32.31%,1
桃園市,八德區,0379,778,335,1113,20,1133,2198,51.55%,35.4%,1
桃園市,八德區,0380,592,304,896,30,926,1732,53.46%,34.18%,1
桃園市,八德區,0381,669,393,1062,13,1075,2089,51.46%,32.02%,1
桃園市,八德區,0382,466,223,689,32,721,1257,57.36%,37.07%,1
桃園市,八德區,0383,416,204,620,34,654,1267,51.62%,32.83%,1
桃園市,八德區,0384,501,259,760,17,777,1427,54.45%,35.11%,1
桃園市,八德區,0385,626,305,931,45,976,1685,57.92%,37.15%,1
桃園市,八德區,0386,607,295,902,44,946,1748,54.12%,34.73%,1
桃園市,八德區,0387,793,297,1090,45,1135,1650,68.79%,48.06%,1
桃園市,八德區,0388,495,273,768,37,805,1478,54.47%,33.49%,1
桃園市,八德區,0389,594,244,838,31,869,1607,54.08%,36.96%,1
桃園市,八德區,0390,640,339,979,49,1028,1841,55.84%,34.76%,1
桃園市,八德區,0391,671,342,1013,36,1049,2082,50.38%,32.23%,1
桃園市,八德區,0392,587,286,873,42,915,1959,46.71%,29.96%,1
桃園市,八德區,0393,666,424,1090,46,1136,2209,51.43%,30.15%,1
桃園市,八德區,0394,618,308,926,38,964,1864,51.72%,33.15%,1
桃園市,八德區,0395,600,357,957,40,997,2000,49.85%,30%,1
桃園市,龍潭區,1008,534,218,752,27,779,1482,52.56%,36.03%,1
桃園市,龍潭區,1009,520,231,751,22,773,1528,50.59%,34.03%,1
桃園市,龍潭區,1010,540,237,777,29,806,1503,53.63%,35.93%,1
桃園市,龍潭區,1011,523,230,753,41,794,1568,50.64%,33.35%,1
桃園市,龍潭區,1012,423,171,594,39,633,1216,52.06%,34.79%,1
桃園市,龍潭區,1013,628,271,899,50,949,2088,45.45%,30.08%,1
桃園市,龍潭區,1014,737,328,1065,49,1114,1987,56.06%,37.09%,1
桃園市,龍潭區,1015,622,281,903,37,940,1586,59.27%,39.22%,1
桃園市,龍潭區,1016,400,206,606,29,635,1221,52.01%,32.76%,1
桃園市,龍潭區,1017,453,176,629,23,652,1134,57.5%,39.95%,1
桃園市,龍潭區,1018,690,285,975,38,1013,2081,48.68%,33.16%,1
桃園市,龍潭區,1019,633,263,896,31,927,1925,48.16%,32.88%,1
桃園市,龍潭區,1020,781,329,1110,25,1135,2095,54.18%,37.28%,1
桃園市,龍潭區,1021,800,325,1125,30,1155,2040,56.62%,39.22%,1
桃園市,龍潭區,1022,562,263,825,48,873,1790,48.77%,31.4%,1
桃園市,龍潭區,1023,547,412,959,59,1018,1872,54.38%,29.22%,1
桃園市,龍潭區,1024,643,277,920,56,976,1726,56.55%,37.25%,1
桃園市,龍潭區,1025,677,260,937,44,981,1792,54.74%,37.78%,1
桃園市,龍潭區,1026,526,222,748,26,774,1398,55.36%,37.63%,1
桃園市,龍潭區,1027,456,199,655,23,678,1345,50.41%,33.9%,1
桃園市,龍潭區,1028,511,227,738,33,771,1409,54.72%,36.27%,1
桃園市,龍潭區,1029,418,233,651,22,673,1362,49.41%,30.69%,1
桃園市,龍潭區,1030,600,296,896,41,937,1650,56.79%,36.36%,1
桃園市,龍潭區,1031,583,212,795,36,831,1597,52.04%,36.51%,1
桃園市,龍潭區,1032,513,208,721,29,750,1410,53.19%,36.38%,1
桃園市,龍潭區,1033,482,198,680,30,710,1275,55.69%,37.8%,1
桃園市,龍潭區,1034,723,353,1076,43,1119,1909,58.62%,37.87%,1
桃園市,龍潭區,1035,768,320,1088,27,1115,2024,55.09%,37.94%,1
桃園市,龍潭區,1036,725,317,1042,36,1078,2002,53.85%,36.21%,1
桃園市,龍潭區,1037,664,321,985,30,1015,1786,56.83%,37.18%,1
桃園市,龍潭區,1038,637,282,919,18,937,1756,53.36%,36.28%,1
桃園市,龍潭區,1039,734,278,1012,14,1026,1830,56.07%,40.11%,1
桃園市,龍潭區,1040,691,290,981,25,1006,1697,59.28%,40.72%,1
桃園市,龍潭區,1041,608,229,837,26,863,1519,56.81%,40.03%,1
桃園市,龍潭區,1042,629,249,878,40,918,1805,50.86%,34.85%,1
桃園市,龍潭區,1043,587,198,785,25,810,1792,45.2%,32.76%,1
桃園市,龍潭區,1044,613,219,832,49,881,1500,58.73%,40.87%,1
桃園市,龍潭區,1045,489,211,700,18,718,1427,50.32%,34.27%,1
桃園市,龍潭區,1046,432,182,614,43,657,1444,45.5%,29.92%,1
桃園市,龍潭區,1047,467,172,639,32,671,1321,50.79%,35.35%,1
桃園市,龍潭區,1048,491,204,695,28,723,1215,59.51%,40.41%,1
桃園市,龍潭區,1049,484,171,655,36,691,1297,53.28%,37.32%,1
桃園市,龍潭區,1050,461,215,676,20,696,1407,49.47%,32.76%,1
桃園市,龍潭區,1051,505,234,739,36,775,1564,49.55%,32.29%,1
桃園市,龍潭區,1052,470,193,663,38,701,1317,53.23%,35.69%,1
桃園市,龍潭區,1053,354,125,479,29,508,1023,49.66%,34.6%,1
桃園市,龍潭區,1054,668,259,927,29,956,1721,55.55%,38.81%,1
桃園市,龍潭區,1055,700,236,936,34,970,1764,54.99%,39.68%,1
桃園市,龍潭區,1056,543,228,771,53,824,1499,54.97%,36.22%,1
桃園市,龍潭區,1057,698,275,973,59,1032,2151,47.98%,32.45%,1
桃園市,龍潭區,1058,606,240,846,22,868,1524,56.96%,39.76%,1
桃園市,龍潭區,1059,588,271,859,17,876,1456,60.16%,40.38%,1
桃園市,龍潭區,1060,823,221,1044,24,1068,1847,57.82%,44.56%,1
桃園市,龍潭區,1061,853,281,1134,19,1153,1899,60.72%,44.92%,1
桃園市,龍潭區,1062,668,245,913,27,940,1725,54.49%,38.72%,1
桃園市,龍潭區,1063,700,270,970,42,1012,1665,60.78%,42.04%,1
桃園市,龍潭區,1064,550,250,800,26,826,1649,50.09%,33.35%,1
桃園市,龍潭區,1065,501,211,712,33,745,1539,48.41%,32.55%,1
桃園市,龍潭區,1066,611,264,875,37,912,1541,59.18%,39.65%,1
桃園市,龍潭區,1067,492,233,725,27,752,1375,54.69%,35.78%,1
桃園市,龍潭區,1068,508,251,759,25,784,1453,53.96%,34.96%,1
桃園市,龍潭區,1069,395,182,577,37,614,1074,57.17%,36.78%,1
桃園市,龍潭區,1070,509,235,744,14,758,1299,58.35%,39.18%,1
桃園市,龍潭區,1071,228,103,331,15,346,678,51.03%,33.63%,1
桃園市,平鎮區,0801,459,230,689,43,732,1487,49.23%,30.87%,1
桃園市,平鎮區,0802,513,220,733,30,763,1453,52.51%,35.31%,1
桃園市,平鎮區,0803,534,235,769,34,803,1491,53.86%,35.81%,1
桃園市,平鎮區,0804,439,222,661,43,704,1346,52.3%,32.62%,1
桃園市,平鎮區,0805,557,256,813,26,839,1660,50.54%,33.55%,1
桃園市,平鎮區,0806,653,241,894,32,926,1921,48.2%,33.99%,1
桃園市,平鎮區,0807,817,215,1032,24,1056,1974,53.5%,41.39%,1
桃園市,平鎮區,0808,619,284,903,33,936,1867,50.13%,33.15%,1
桃園市,平鎮區,0809,638,266,904,21,925,1786,51.79%,35.72%,1
桃園市,平鎮區,0810,468,199,667,20,687,1634,42.04%,28.64%,1
桃園市,平鎮區,0811,426,165,591,19,610,1080,56.48%,39.44%,1
桃園市,平鎮區,0812,504,254,758,30,788,1514,52.05%,33.29%,1
桃園市,平鎮區,0813,578,264,842,46,888,1918,46.3%,30.14%,1
桃園市,平鎮區,0814,425,176,601,54,655,1182,55.41%,35.96%,1
桃園市,平鎮區,0815,520,254,774,30,804,1667,48.23%,31.19%,1
桃園市,平鎮區,0816,515,230,745,21,766,1640,46.71%,31.4%,1
桃園市,平鎮區,0817,538,264,802,29,831,1603,51.84%,33.56%,1
桃園市,平鎮區,0818,601,264,865,13,878,1556,56.43%,38.62%,1
桃園市,平鎮區,0819,583,247,830,36,866,1697,51.03%,34.35%,1
桃園市,平鎮區,0820,403,163,566,18,584,1130,51.68%,35.66%,1
桃園市,平鎮區,0821,445,178,623,33,656,1196,54.85%,37.21%,1
桃園市,平鎮區,0822,584,270,854,35,889,1685,52.76%,34.66%,1
桃園市,平鎮區,0823,620,205,825,34,859,1532,56.07%,40.47%,1
桃園市,平鎮區,0824,592,215,807,22,829,1564,53.01%,37.85%,1
桃園市,平鎮區,0825,880,18,898,31,929,1824,50.93%,48.25%,1
桃園市,平鎮區,0826,654,270,924,22,946,1912,49.48%,34.21%,1
桃園市,平鎮區,0827,377,151,528,35,563,1048,53.72%,35.97%,1
桃園市,平鎮區,0828,497,179,676,35,711,1259,56.47%,39.48%,1
桃園市,平鎮區,0829,407,137,544,21,565,1061,53.25%,38.36%,1
桃園市,平鎮區,0830,465,154,619,23,642,1072,59.89%,43.38%,1
桃園市,平鎮區,0831,637,244,881,47,928,1788,51.9%,35.63%,1
桃園市,平鎮區,0832,539,236,775,23,798,1510,52.85%,35.7%,1
桃園市,平鎮區,0833,504,208,712,28,740,1403,52.74%,35.92%,1
桃園市,平鎮區,0834,500,230,730,36,766,1407,54.44%,35.54%,1
桃園市,平鎮區,0835,680,284,964,52,1016,1901,53.45%,35.77%,1
桃園市,平鎮區,0836,642,278,920,17,937,1994,46.99%,32.2%,1
桃園市,平鎮區,0837,586,281,867,27,894,1730,51.68%,33.87%,1
桃園市,平鎮區,0838,656,328,984,26,1010,1905,53.02%,34.44%,1
桃園市,平鎮區,0839,621,304,925,19,944,1723,54.79%,36.04%,1
桃園市,平鎮區,0840,492,206,698,34,732,1307,56.01%,37.64%,1
桃園市,平鎮區,0841,466,242,708,38,746,1337,55.8%,34.85%,1
桃園市,平鎮區,0842,407,208,615,21,636,980,64.9%,41.53%,1
桃園市,平鎮區,0843,591,309,900,35,935,1818,51.43%,32.51%,1
桃園市,平鎮區,0844,513,258,771,34,805,1463,55.02%,35.06%,1
桃園市,平鎮區,0845,484,212,696,19,715,1213,58.94%,39.9%,1
桃園市,平鎮區,0846,411,192,603,35,638,1085,58.8%,37.88%,1
桃園市,平鎮區,0847,523,186,709,26,735,1458,50.41%,35.87%,1
桃園市,平鎮區,0848,528,224,752,29,781,1408,55.47%,37.5%,1
桃園市,平鎮區,0849,481,212,693,29,722,1396,51.72%,34.46%,1
桃園市,平鎮區,0850,418,237,655,16,671,1044,64.27%,40.04%,1
桃園市,平鎮區,0851,411,203,614,16,630,1124,56.05%,36.57%,1
桃園市,平鎮區,0852,545,271,816,14,830,1517,54.71%,35.93%,1
桃園市,平鎮區,0853,520,292,812,19,831,1571,52.9%,33.1%,1
桃園市,平鎮區,0854,666,313,979,23,1002,1752,57.19%,38.01%,1
桃園市,平鎮區,0855,576,263,839,28,867,1434,60.46%,40.17%,1
桃園市,平鎮區,0856,635,322,957,28,985,1710,57.6%,37.13%,1
桃園市,平鎮區,0857,684,157,841,32,873,1555,56.14%,43.99%,1
桃園市,平鎮區,0858,645,320,965,30,995,2051,48.51%,31.45%,1
桃園市,平鎮區,0859,493,276,769,21,790,1477,53.49%,33.38%,1
桃園市,平鎮區,0860,564,248,812,16,828,1501,55.16%,37.57%,1
桃園市,平鎮區,0861,498,249,747,35,782,1405,55.66%,35.44%,1
桃園市,平鎮區,0862,577,261,838,42,880,1656,53.14%,34.84%,1
桃園市,平鎮區,0863,586,302,888,21,909,1921,47.32%,30.5%,1
桃園市,平鎮區,0864,565,252,817,25,842,1717,49.04%,32.91%,1
桃園市,平鎮區,0865,439,245,684,42,726,1319,55.04%,33.28%,1
桃園市,平鎮區,0866,560,289,849,41,890,1745,51%,32.09%,1
桃園市,平鎮區,0867,611,280,891,53,944,1721,54.85%,35.5%,1
桃園市,平鎮區,0868,427,213,640,28,668,1206,55.39%,35.41%,1
桃園市,平鎮區,0869,493,268,761,21,782,1202,65.06%,41.01%,1
桃園市,平鎮區,0870,461,202,663,42,705,1208,58.36%,38.16%,1
桃園市,平鎮區,0871,515,232,747,22,769,1267,60.69%,40.65%,1
桃園市,平鎮區,0872,385,205,590,24,614,1094,56.12%,35.19%,1
桃園市,平鎮區,0873,528,256,784,40,824,1394,59.11%,37.88%,1
桃園市,平鎮區,0874,468,251,719,15,734,1215,60.41%,38.52%,1
桃園市,平鎮區,0875,391,171,562,27,589,1010,58.32%,38.71%,1
桃園市,平鎮區,0876,575,125,700,23,723,1261,57.34%,45.6%,1
桃園市,平鎮區,0877,540,211,751,22,773,1314,58.83%,41.1%,1
桃園市,平鎮區,0878,280,122,402,20,422,722,58.45%,38.78%,1
桃園市,平鎮區,0879,293,144,437,16,453,839,53.99%,34.92%,1
桃園市,平鎮區,0880,535,230,765,15,780,1399,55.75%,38.24%,1
桃園市,平鎮區,0881,629,331,960,30,990,1968,50.3%,31.96%,1
桃園市,平鎮區,0882,594,281,875,22,897,1672,53.65%,35.53%,1
桃園市,平鎮區,0883,448,187,635,15,650,2213,29.37%,20.24%,1
桃園市,平鎮區,0884,377,201,578,15,593,949,62.49%,39.73%,1
桃園市,平鎮區,0885,596,338,934,32,966,1621,59.59%,36.77%,1
桃園市,平鎮區,0886,534,273,807,24,831,1643,50.58%,32.5%,1
桃園市,平鎮區,0887,658,321,979,32,1011,1844,54.83%,35.68%,1
桃園市,平鎮區,0888,597,314,911,36,947,1752,54.05%,34.08%,1
桃園市,平鎮區,0889,497,249,746,42,788,1577,49.97%,31.52%,1
桃園市,平鎮區,0890,536,275,811,30,841,1517,55.44%,35.33%,1
桃園市,平鎮區,0891,385,201,586,27,613,1039,59%,37.05%,1
桃園市,平鎮區,0892,513,240,753,24,777,1318,58.95%,38.92%,1
桃園市,平鎮區,0893,268,577,845,25,870,1636,53.18%,16.38%,1
桃園市,平鎮區,0894,469,251,720,25,745,1316,56.61%,35.64%,1
桃園市,平鎮區,0895,501,307,808,20,828,1474,56.17%,33.99%,1
桃園市,平鎮區,0896,472,206,678,37,715,1480,48.31%,31.89%,1
桃園市,平鎮區,0897,504,187,691,17,708,1330,53.23%,37.89%,1
桃園市,平鎮區,0898,443,210,653,29,682,1228,55.54%,36.07%,1
桃園市,平鎮區,0899,503,267,770,40,810,1377,58.82%,36.53%,1
桃園市,平鎮區,0900,477,228,705,26,731,1198,61.02%,39.82%,1
桃園市,平鎮區,0901,495,222,717,33,750,1231,60.93%,40.21%,1
桃園市,平鎮區,0902,451,225,676,39,715,1243,57.52%,36.28%,1
桃園市,平鎮區,0903,576,230,806,34,840,1590,52.83%,36.23%,1
桃園市,平鎮區,0904,495,211,706,31,737,1366,53.95%,36.24%,1
桃園市,平鎮區,0905,479,202,681,37,718,1332,53.9%,35.96%,1
桃園市,平鎮區,0906,388,183,571,26,597,1201,49.71%,32.31%,1
桃園市,平鎮區,0907,540,229,769,19,788,1668,47.24%,32.37%,1
桃園市,平鎮區,0908,476,183,659,43,702,1351,51.96%,35.23%,1
桃園市,平鎮區,0909,478,211,689,22,711,1460,48.7%,32.74%,1
桃園市,平鎮區,0910,632,263,895,24,919,1841,49.92%,34.33%,1
桃園市,平鎮區,0911,511,199,710,11,721,1475,48.88%,34.64%,1
桃園市,平鎮區,0912,399,140,539,20,559,1011,55.29%,39.47%,1
桃園市,平鎮區,0913,336,155,491,29,520,1052,49.43%,31.94%,1
桃園市,平鎮區,0914,454,212,666,40,706,1154,61.18%,39.34%,1
桃園市,平鎮區,0915,560,234,794,30,824,1645,50.09%,34.04%,1
桃園市,平鎮區,0916,498,228,726,47,773,1539,50.23%,32.36%,1
桃園市,平鎮區,0917,489,214,703,47,750,1385,54.15%,35.31%,1
桃園市,平鎮區,0918,502,218,720,24,744,1395,53.33%,35.99%,1
桃園市,平鎮區,0919,611,213,824,40,864,1711,50.5%,35.71%,1
桃園市,平鎮區,0920,570,228,798,36,834,1631,51.13%,34.95%,1
桃園市,平鎮區,0921,399,206,605,18,623,1110,56.13%,35.95%,1
桃園市,平鎮區,0922,770,262,1032,30,1062,1931,55%,39.88%,1
桃園市,平鎮區,0923,391,198,589,31,620,1127,55.01%,34.69%,1
桃園市,平鎮區,0924,633,108,741,45,786,1414,55.59%,44.77%,1
桃園市,平鎮區,0925,604,223,827,28,855,1609,53.14%,37.54%,1
桃園市,新屋區,1072,552,216,768,13,781,1306,59.8%,42.27%,1
桃園市,新屋區,1073,623,200,823,37,860,1556,55.27%,40.04%,1
桃園市,新屋區,1074,751,317,1068,52,1120,1849,60.57%,40.62%,1
桃園市,新屋區,1075,782,399,1181,52,1233,2096,58.83%,37.31%,1
桃園市,新屋區,1076,513,234,747,50,797,1517,52.54%,33.82%,1
桃園市,新屋區,1077,760,372,1132,54,1186,2095,56.61%,36.28%,1
桃園市,新屋區,1078,586,263,849,38,887,1856,47.79%,31.57%,1
桃園市,新屋區,1079,723,317,1040,59,1099,1986,55.34%,36.4%,1
桃園市,新屋區,1080,457,206,663,45,708,1425,49.68%,32.07%,1
桃園市,新屋區,1081,456,197,653,39,692,1385,49.96%,32.92%,1
桃園市,新屋區,1082,479,266,745,36,781,1271,61.45%,37.69%,1
桃園市,新屋區,1083,452,204,656,25,681,1271,53.58%,35.56%,1
桃園市,新屋區,1084,453,219,672,33,705,1234,57.13%,36.71%,1
桃園市,新屋區,1085,363,202,565,42,607,1085,55.94%,33.46%,1
桃園市,新屋區,1086,794,319,1113,30,1143,1992,57.38%,39.86%,1
桃園市,新屋區,1087,770,364,1134,61,1195,2032,58.81%,37.89%,1
桃園市,新屋區,1088,453,189,642,66,708,1291,54.84%,35.09%,1
桃園市,新屋區,1089,467,224,691,32,723,1401,51.61%,33.33%,1
桃園市,新屋區,1090,441,172,613,34,647,1106,58.5%,39.87%,1
桃園市,新屋區,1091,349,152,501,13,514,908,56.61%,38.44%,1
桃園市,新屋區,1092,259,121,380,28,408,663,61.54%,39.06%,1
桃園市,新屋區,1093,384,164,548,35,583,1088,53.58%,35.29%,1
桃園市,新屋區,1094,441,180,621,49,670,1050,63.81%,42%,1
桃園市,新屋區,1095,354,149,503,24,527,896,58.82%,39.51%,1
桃園市,新屋區,1096,513,234,747,73,820,1369,59.9%,37.47%,1
桃園市,新屋區,1097,300,164,464,33,497,995,49.95%,30.15%,1
桃園市,新屋區,1098,295,118,413,22,435,741,58.7%,39.81%,1
桃園市,新屋區,1099,373,169,542,40,582,943,61.72%,39.55%,1
桃園市,新屋區,1100,616,230,846,58,904,1714,52.74%,35.94%,1
桃園市,新屋區,1101,493,213,706,25,731,1340,54.55%,36.79%,1
桃園市,觀音區,1102,427,192,619,38,657,1371,47.92%,31.15%,1
桃園市,觀音區,1103,393,166,559,25,584,1362,42.88%,28.85%,1
桃園市,觀音區,1104,297,193,490,43,533,997,53.46%,29.79%,1
桃園市,觀音區,1105,464,192,656,32,688,1407,48.9%,32.98%,1
桃園市,觀音區,1106,577,295,872,29,901,1692,53.25%,34.1%,1
桃園市,觀音區,1107,475,173,648,21,669,1279,52.31%,37.14%,1
桃園市,觀音區,1108,292,121,413,10,423,791,53.48%,36.92%,1
桃園市,觀音區,1109,363,125,488,19,507,892,56.84%,40.7%,1
桃園市,觀音區,1110,346,160,506,27,533,886,60.16%,39.05%,1
桃園市,觀音區,1111,259,114,373,22,395,712,55.48%,36.38%,1
桃園市,觀音區,1112,505,234,739,76,815,1609,50.65%,31.39%,1
桃園市,觀音區,1113,461,212,673,33,706,1274,55.42%,36.19%,1
桃園市,觀音區,1114,393,186,579,23,602,1351,44.56%,29.09%,1
桃園市,觀音區,1115,461,235,696,32,728,1262,57.69%,36.53%,1
桃園市,觀音區,1116,444,231,675,32,707,1242,56.92%,35.75%,1
桃園市,觀音區,1117,470,269,739,36,775,1461,53.05%,32.17%,1
桃園市,觀音區,1118,539,276,815,32,847,1613,52.51%,33.42%,1
桃園市,觀音區,1119,516,233,749,41,790,1479,53.41%,34.89%,1
桃園市,觀音區,1120,480,236,716,31,747,1552,48.13%,30.93%,1
桃園市,觀音區,1121,505,263,768,21,789,1517,52.01%,33.29%,1
桃園市,觀音區,1122,527,271,798,38,836,1691,49.44%,31.16%,1
桃園市,觀音區,1123,427,210,637,12,649,1157,56.09%,36.91%,1
桃園市,觀音區,1124,496,219,715,32,747,1455,51.34%,34.09%,1
桃園市,觀音區,1125,390,194,584,26,610,1150,53.04%,33.91%,1
桃園市,觀音區,1126,400,195,595,32,627,1112,56.38%,35.97%,1
桃園市,觀音區,1127,399,209,608,17,625,1251,49.96%,31.89%,1
桃園市,觀音區,1128,489,248,737,57,794,1446,54.91%,33.82%,1
桃園市,觀音區,1129,480,246,726,65,791,1493,52.98%,32.15%,1
桃園市,觀音區,1130,456,213,669,39,708,1339,52.88%,34.06%,1
桃園市,觀音區,1131,443,196,639,29,668,1137,58.75%,38.96%,1
桃園市,觀音區,1132,340,161,501,29,530,1043,50.81%,32.6%,1
桃園市,觀音區,1133,286,152,438,23,461,993,46.42%,28.8%,1
桃園市,觀音區,1134,316,167,483,21,504,975,51.69%,32.41%,1
桃園市,觀音區,1135,562,304,866,35,901,2029,44.41%,27.7%,1
桃園市,觀音區,1136,621,298,919,38,957,1765,54.22%,35.18%,1
桃園市,觀音區,1137,620,274,894,33,927,1809,51.24%,34.27%,1
桃園市,觀音區,1138,599,276,875,28,903,1869,48.31%,32.05%,1
桃園市,觀音區,1139,540,228,768,45,813,1870,43.48%,28.88%,1
桃園市,觀音區,1140,439,235,674,23,697,1932,36.08%,22.72%,1
桃園市,觀音區,1141,275,139,414,7,421,899,46.83%,30.59%,1
桃園市,觀音區,1142,288,129,417,13,430,985,43.65%,29.24%,1
桃園市,復興區,0581,820,238,1058,70,1128,1991,56.65%,41.19%,1
桃園市,復興區,0582,593,175,768,35,803,1392,57.69%,42.6%,1
桃園市,復興區,0583,257,70,327,7,334,564,59.22%,45.57%,1
桃園市,復興區,0584,305,107,412,16,428,716,59.78%,42.6%,1
桃園市,復興區,0585,445,164,609,40,649,1016,63.88%,43.8%,1
桃園市,復興區,0586,204,92,296,14,310,669,46.34%,30.49%,1
桃園市,復興區,0587,297,83,380,13,393,760,51.71%,39.08%,1
桃園市,復興區,0588,328,92,420,16,436,751,58.06%,43.68%,1
桃園市,復興區,0589,298,83,381,15,396,683,57.98%,43.63%,1
桃園市,復興區,0590,594,105,699,17,716,1224,58.5%,48.53%,1
臺中市,中區,1070,653,316,969,60,1029,1652,62.29%,39.53%,1
臺中市,中區,1071,537,280,817,32,849,1531,55.45%,35.08%,1
臺中市,中區,1072,576,223,799,21,820,1431,57.3%,40.25%,1
臺中市,中區,1073,401,182,583,34,617,1060,58.21%,37.83%,1
臺中市,中區,1074,338,179,517,33,550,982,56.01%,34.42%,1
臺中市,中區,1075,439,115,554,37,591,1191,49.62%,36.86%,1
臺中市,中區,1076,309,152,461,33,494,855,57.78%,36.14%,1
臺中市,中區,1077,376,151,527,20,547,1135,48.19%,33.13%,1
臺中市,中區,1078,310,112,422,14,436,705,61.84%,43.97%,1
臺中市,中區,1079,431,169,600,21,621,1009,61.55%,42.72%,1
臺中市,中區,1080,455,226,681,49,730,1304,55.98%,34.89%,1
臺中市,中區,1081,636,268,904,29,933,1841,50.68%,34.55%,1
臺中市,東區,1148,283,152,435,18,453,1138,39.81%,24.87%,1
臺中市,東區,1149,386,182,568,19,587,984,59.65%,39.23%,1
臺中市,東區,1150,341,152,493,29,522,877,59.52%,38.88%,1
臺中市,東區,1151,426,225,651,31,682,1070,63.74%,39.81%,1
臺中市,東區,1152,422,232,654,33,687,1106,62.12%,38.16%,1
臺中市,東區,1153,360,187,547,36,583,953,61.18%,37.78%,1
臺中市,東區,1154,515,208,723,23,746,1195,62.43%,43.1%,1
臺中市,東區,1155,505,205,710,16,726,1251,58.03%,40.37%,1
臺中市,東區,1156,453,232,685,35,720,1190,60.5%,38.07%,1
臺中市,東區,1157,507,254,761,33,794,1394,56.96%,36.37%,1
臺中市,東區,1158,568,280,848,49,897,1443,62.16%,39.36%,1
臺中市,東區,1159,316,127,443,28,471,762,61.81%,41.47%,1
臺中市,東區,1160,488,220,708,36,744,1140,65.26%,42.81%,1
臺中市,東區,1161,469,242,711,47,758,1211,62.59%,38.73%,1
臺中市,東區,1162,311,149,460,20,480,755,63.58%,41.19%,1
臺中市,東區,1163,543,257,800,50,850,1491,57.01%,36.42%,1
臺中市,東區,1164,373,181,554,27,581,1000,58.1%,37.3%,1
臺中市,東區,1165,418,230,648,41,689,1114,61.85%,37.52%,1
臺中市,東區,1166,423,195,618,27,645,1101,58.58%,38.42%,1
臺中市,東區,1167,508,208,716,45,761,1169,65.1%,43.46%,1
臺中市,東區,1168,537,236,773,41,814,1283,63.45%,41.86%,1
臺中市,東區,1169,483,229,712,27,739,1168,63.27%,41.35%,1
臺中市,東區,1170,500,268,768,28,796,1386,57.43%,36.08%,1
臺中市,東區,1171,563,325,888,39,927,1557,59.54%,36.16%,1
臺中市,東區,1172,509,269,778,44,822,1380,59.57%,36.88%,1
臺中市,東區,1173,675,307,982,30,1012,1674,60.45%,40.32%,1
臺中市,東區,1174,691,285,976,23,999,1604,62.28%,43.08%,1
臺中市,東區,1175,690,359,1049,47,1096,1815,60.39%,38.02%,1
臺中市,東區,1176,645,289,934,35,969,1700,57%,37.94%,1
臺中市,東區,1177,622,268,890,26,916,1592,57.54%,39.07%,1
臺中市,東區,1178,665,311,976,41,1017,1850,54.97%,35.95%,1
臺中市,東區,1179,519,210,729,36,765,1252,61.1%,41.45%,1
臺中市,東區,1180,480,279,759,37,796,1250,63.68%,38.4%,1
臺中市,東區,1181,503,235,738,25,763,1241,61.48%,40.53%,1
臺中市,東區,1182,420,248,668,42,710,1318,53.87%,31.87%,1
臺中市,東區,1183,484,210,694,47,741,1288,57.53%,37.58%,1
臺中市,東區,1184,588,274,862,48,910,1442,63.11%,40.78%,1
臺中市,東區,1185,485,215,700,33,733,1202,60.98%,40.35%,1
臺中市,東區,1186,597,218,815,45,860,1452,59.23%,41.12%,1
臺中市,東區,1187,530,272,802,26,828,1480,55.95%,35.81%,1
臺中市,東區,1188,706,250,956,39,995,1736,57.32%,40.67%,1
臺中市,東區,1189,312,151,463,32,495,867,57.09%,35.99%,1
臺中市,東區,1190,644,215,859,45,904,1693,53.4%,38.04%,1
臺中市,東區,1191,637,268,905,42,947,1538,61.57%,41.42%,1
臺中市,東區,1192,606,338,944,61,1005,1593,63.09%,38.04%,1
臺中市,東區,1193,534,256,790,20,810,1481,54.69%,36.06%,1
臺中市,東區,1194,572,285,857,28,885,1414,62.59%,40.45%,1
臺中市,東區,1195,492,246,738,23,761,1297,58.67%,37.93%,1
臺中市,東區,1196,545,249,794,43,837,1394,60.04%,39.1%,1
臺中市,南區,1197,382,174,556,21,577,937,61.58%,40.77%,1
臺中市,南區,1198,408,213,621,34,655,1001,65.43%,40.76%,1
臺中市,南區,1199,539,248,787,39,826,1249,66.13%,43.15%,1
臺中市,南區,1200,548,237,785,37,822,1202,68.39%,45.59%,1
臺中市,南區,1201,428,235,663,55,718,1130,63.54%,37.88%,1
臺中市,南區,1202,510,240,750,36,786,1239,63.44%,41.16%,1
臺中市,南區,1203,460,235,695,36,731,1238,59.05%,37.16%,1
臺中市,南區,1204,510,247,757,41,798,1272,62.74%,40.09%,1
臺中市,南區,1205,500,242,742,40,782,1273,61.43%,39.28%,1
臺中市,南區,1206,497,257,754,54,808,1317,61.35%,37.74%,1
臺中市,南區,1207,502,255,757,31,788,1160,67.93%,43.28%,1
臺中市,南區,1208,477,237,714,85,799,1205,66.31%,39.59%,1
臺中市,南區,1209,387,253,640,48,688,1111,61.93%,34.83%,1
臺中市,南區,1210,570,322,892,38,930,1407,66.1%,40.51%,1
臺中市,南區,1211,565,260,825,29,854,1419,60.18%,39.82%,1
臺中市,南區,1212,484,221,705,34,739,1157,63.87%,41.83%,1
臺中市,南區,1213,528,279,807,34,841,1415,59.43%,37.31%,1
臺中市,南區,1214,561,255,816,35,851,1289,66.02%,43.52%,1
臺中市,南區,1215,565,271,836,39,875,1454,60.18%,38.86%,1
臺中市,南區,1216,568,272,840,35,875,1491,58.69%,38.1%,1
臺中市,南區,1217,544,253,797,35,832,1394,59.68%,39.02%,1
臺中市,南區,1218,546,280,826,38,864,1430,60.42%,38.18%,1
臺中市,南區,1219,527,255,782,62,844,1342,62.89%,39.27%,1
臺中市,南區,1220,570,264,834,50,884,1304,67.79%,43.71%,1
臺中市,南區,1221,477,267,744,29,773,1190,64.96%,40.08%,1
臺中市,南區,1222,511,209,720,41,761,1273,59.78%,40.14%,1
臺中市,南區,1223,586,281,867,39,906,1387,65.32%,42.25%,1
臺中市,南區,1224,522,260,782,39,821,1356,60.55%,38.5%,1
臺中市,南區,1225,530,253,783,45,828,1304,63.5%,40.64%,1
臺中市,南區,1226,521,276,797,23,820,1256,65.29%,41.48%,1
臺中市,南區,1227,532,308,840,30,870,1364,63.78%,39%,1
臺中市,南區,1228,529,270,799,54,853,1361,62.67%,38.87%,1
臺中市,南區,1229,578,273,851,23,874,1407,62.12%,41.08%,1
臺中市,南區,1230,543,218,761,39,800,1308,61.16%,41.51%,1
臺中市,南區,1231,466,250,716,28,744,1250,59.52%,37.28%,1
臺中市,南區,1232,480,238,718,23,741,1284,57.71%,37.38%,1
臺中市,南區,1233,466,264,730,34,764,1175,65.02%,39.66%,1
臺中市,南區,1234,525,217,742,28,770,1158,66.49%,45.34%,1
臺中市,南區,1235,443,229,672,47,719,1168,61.56%,37.93%,1
臺中市,南區,1236,664,330,994,43,1037,1626,63.78%,40.84%,1
臺中市,南區,1237,581,299,880,25,905,2115,42.79%,27.47%,1
臺中市,南區,1238,669,310,979,33,1012,1805,56.07%,37.06%,1
臺中市,南區,1239,630,298,928,19,947,1695,55.87%,37.17%,1
臺中市,南區,1240,636,375,1011,35,1046,1643,63.66%,38.71%,1
臺中市,南區,1241,636,215,851,37,888,1423,62.4%,44.69%,1
臺中市,南區,1242,597,302,899,37,936,1542,60.7%,38.72%,1
臺中市,南區,1243,580,329,909,21,930,1533,60.67%,37.83%,1
臺中市,南區,1244,616,324,940,46,986,1531,64.4%,40.24%,1
臺中市,南區,1245,560,225,785,23,808,1392,58.05%,40.23%,1
臺中市,南區,1246,580,310,890,30,920,1592,57.79%,36.43%,1
臺中市,南區,1247,556,304,860,39,899,1431,62.82%,38.85%,1
臺中市,南區,1248,621,336,957,27,984,1799,54.7%,34.52%,1
臺中市,南區,1249,722,333,1055,36,1091,1708,63.88%,42.27%,1
臺中市,南區,1250,627,323,950,43,993,1700,58.41%,36.88%,1
臺中市,南區,1251,781,297,1078,21,1099,1751,62.76%,44.6%,1
臺中市,南區,1252,763,448,1211,60,1271,2109,60.27%,36.18%,1
臺中市,南區,1253,633,334,967,42,1009,1697,59.46%,37.3%,1
臺中市,南區,1254,524,305,829,41,870,1456,59.75%,35.99%,1
臺中市,南區,1255,741,366,1107,46,1153,1726,66.8%,42.93%,1
臺中市,南區,1256,691,352,1043,41,1084,1723,62.91%,40.1%,1
臺中市,南區,1257,638,302,940,32,972,1569,61.95%,40.66%,1
臺中市,南區,1258,506,260,766,39,805,1274,63.19%,39.72%,1
臺中市,南區,1259,622,275,897,27,924,1390,66.47%,44.75%,1
臺中市,南區,1260,517,314,831,20,851,1295,65.71%,39.92%,1
臺中市,南區,1261,542,222,764,40,804,1312,61.28%,41.31%,1
臺中市,南區,1262,602,275,877,30,907,1417,64.01%,42.48%,1
臺中市,南區,1263,549,277,826,31,857,1230,69.67%,44.63%,1
臺中市,南區,1264,504,261,765,28,793,1308,60.63%,38.53%,1
臺中市,南區,1265,547,287,834,53,887,1467,60.46%,37.29%,1
臺中市,南區,1266,536,293,829,29,858,1399,61.33%,38.31%,1
臺中市,南區,1267,486,216,702,32,734,1207,60.81%,40.27%,1
臺中市,南區,1268,494,277,771,32,803,1317,60.97%,37.51%,1
臺中市,南區,1269,565,326,891,26,917,1563,58.67%,36.15%,1
臺中市,南區,1270,484,256,740,30,770,1221,63.06%,39.64%,1
臺中市,西區,1082,342,144,486,24,510,1400,36.43%,24.43%,1
臺中市,西區,1083,358,192,550,11,561,861,65.16%,41.58%,1
臺中市,西區,1084,560,262,822,32,854,1416,60.31%,39.55%,1
臺中市,西區,1085,396,212,608,35,643,1020,63.04%,38.82%,1
臺中市,西區,1086,325,172,497,17,514,778,66.07%,41.77%,1
臺中市,西區,1087,559,257,816,32,848,1465,57.88%,38.16%,1
臺中市,西區,1088,415,189,604,15,619,1017,60.87%,40.81%,1
臺中市,西區,1089,323,192,515,17,532,868,61.29%,37.21%,1
臺中市,西區,1090,509,270,779,34,813,1251,64.99%,40.69%,1
臺中市,西區,1091,429,238,667,22,689,1044,66%,41.09%,1
臺中市,西區,1092,529,309,838,36,874,1487,58.78%,35.57%,1
臺中市,西區,1093,577,324,901,34,935,1573,59.44%,36.68%,1
臺中市,西區,1094,652,358,1010,40,1050,1731,60.66%,37.67%,1
臺中市,西區,1095,493,221,714,31,745,1209,61.62%,40.78%,1
臺中市,西區,1096,573,297,870,30,900,1564,57.54%,36.64%,1
臺中市,西區,1097,451,256,707,28,735,1175,62.55%,38.38%,1
臺中市,西區,1098,540,314,854,20,874,1505,58.07%,35.88%,1
臺中市,西區,1099,530,309,839,29,868,1418,61.21%,37.38%,1
臺中市,西區,1100,474,218,692,16,708,1497,47.29%,31.66%,1
臺中市,西區,1101,510,249,759,21,780,1260,61.9%,40.48%,1
臺中市,西區,1102,516,294,810,45,855,1399,61.12%,36.88%,1
臺中市,西區,1103,510,250,760,42,802,1447,55.43%,35.25%,1
臺中市,西區,1104,618,320,938,45,983,1683,58.41%,36.72%,1
臺中市,西區,1105,614,323,937,26,963,1585,60.76%,38.74%,1
臺中市,西區,1106,577,376,953,28,981,1557,63.01%,37.06%,1
臺中市,西區,1107,592,277,869,40,909,1663,54.66%,35.6%,1
臺中市,西區,1108,644,442,1086,36,1122,1921,58.41%,33.52%,1
臺中市,西區,1109,630,391,1021,36,1057,1952,54.15%,32.27%,1
臺中市,西區,1110,570,330,900,35,935,1708,54.74%,33.37%,1
臺中市,西區,1111,452,254,706,19,725,1131,64.1%,39.96%,1
臺中市,西區,1112,671,361,1032,25,1057,1916,55.17%,35.02%,1
臺中市,西區,1113,519,251,770,17,787,1275,61.73%,40.71%,1
臺中市,西區,1114,627,298,925,42,967,1822,53.07%,34.41%,1
臺中市,西區,1115,499,271,770,36,806,1374,58.66%,36.32%,1
臺中市,西區,1116,430,186,616,33,649,1129,57.48%,38.09%,1
臺中市,西區,1117,421,222,643,36,679,1201,56.54%,35.05%,1
臺中市,西區,1118,569,298,867,45,912,1639,55.64%,34.72%,1
臺中市,西區,1119,673,376,1049,41,1090,1863,58.51%,36.12%,1
臺中市,西區,1120,554,237,791,34,825,1287,64.1%,43.05%,1
臺中市,西區,1121,569,300,869,51,920,1504,61.17%,37.83%,1
臺中市,西區,1122,488,261,749,21,770,1308,58.87%,37.31%,1
臺中市,西區,1123,520,280,800,47,847,1433,59.11%,36.29%,1
臺中市,西區,1124,527,266,793,32,825,1450,56.9%,36.34%,1
臺中市,西區,1125,569,314,883,36,919,1465,62.73%,38.84%,1
臺中市,西區,1126,632,324,956,36,992,1818,54.57%,34.76%,1
臺中市,西區,1127,651,357,1008,34,1042,1782,58.47%,36.53%,1
臺中市,西區,1128,543,317,860,34,894,1428,62.61%,38.03%,1
臺中市,西區,1129,478,229,707,20,727,1366,53.22%,34.99%,1
臺中市,西區,1130,528,295,823,34,857,1498,57.21%,35.25%,1
臺中市,西區,1131,522,284,806,28,834,1350,61.78%,38.67%,1
臺中市,西區,1132,525,274,799,21,820,1339,61.24%,39.21%,1
臺中市,西區,1133,623,309,932,28,960,1613,59.52%,38.62%,1
臺中市,西區,1134,510,307,817,39,856,1454,58.87%,35.08%,1
臺中市,西區,1135,600,353,953,29,982,1597,61.49%,37.57%,1
臺中市,西區,1136,532,322,854,45,899,1411,63.71%,37.7%,1
臺中市,西區,1137,545,306,851,48,899,1493,60.21%,36.5%,1
臺中市,西區,1138,648,295,943,39,982,1600,61.38%,40.5%,1
臺中市,西區,1139,588,345,933,44,977,1710,57.13%,34.39%,1
臺中市,西區,1140,435,227,662,19,681,1139,59.79%,38.19%,1
臺中市,西區,1141,444,222,666,21,687,1105,62.17%,40.18%,1
臺中市,西區,1142,543,286,829,37,866,1498,57.81%,36.25%,1
臺中市,西區,1143,645,306,951,40,991,1921,51.59%,33.58%,1
臺中市,西區,1144,499,245,744,42,786,1340,58.66%,37.24%,1
臺中市,西區,1145,615,317,932,39,971,1536,63.22%,40.04%,1
臺中市,西區,1146,484,272,756,46,802,1361,58.93%,35.56%,1
臺中市,西區,1147,579,295,874,24,898,1430,62.8%,40.49%,1
臺中市,北區,0983,526,242,768,27,795,1437,55.32%,36.6%,1
臺中市,北區,0984,586,274,860,52,912,1708,53.4%,34.31%,1
臺中市,北區,0985,483,36,519,39,558,1051,53.09%,45.96%,1
臺中市,北區,0986,386,175,561,29,590,996,59.24%,38.76%,1
臺中市,北區,0987,629,220,849,30,879,1504,58.44%,41.82%,1
臺中市,北區,0988,363,204,567,41,608,975,62.36%,37.23%,1
臺中市,北區,0989,323,180,503,28,531,886,59.93%,36.46%,1
臺中市,北區,0990,363,215,578,33,611,1276,47.88%,28.45%,1
臺中市,北區,0991,319,174,493,24,517,938,55.12%,34.01%,1
臺中市,北區,0992,494,253,747,32,779,1404,55.48%,35.19%,1
臺中市,北區,0993,369,186,555,16,571,996,57.33%,37.05%,1
臺中市,北區,0994,297,167,464,40,504,869,58%,34.18%,1
臺中市,北區,0995,286,150,436,17,453,704,64.35%,40.63%,1
臺中市,北區,0996,355,159,514,21,535,979,54.65%,36.26%,1
臺中市,北區,0997,276,124,400,14,414,773,53.56%,35.71%,1
臺中市,北區,0998,314,143,457,14,471,759,62.06%,41.37%,1
臺中市,北區,0999,605,197,802,40,842,1438,58.55%,42.07%,1
臺中市,北區,1000,456,169,625,26,651,1212,53.71%,37.62%,1
臺中市,北區,1001,643,323,966,37,1003,1731,57.94%,37.15%,1
臺中市,北區,1002,647,250,897,25,922,1445,63.81%,44.78%,1
臺中市,北區,1003,676,347,1023,35,1058,1855,57.04%,36.44%,1
臺中市,北區,1004,597,259,856,31,887,1728,51.33%,34.55%,1
臺中市,北區,1005,619,317,936,37,973,1878,51.81%,32.96%,1
臺中市,北區,1006,612,272,884,60,944,1793,52.65%,34.13%,1
臺中市,北區,1007,589,267,856,53,909,1555,58.46%,37.88%,1
臺中市,北區,1008,553,298,851,34,885,1761,50.26%,31.4%,1
臺中市,北區,1009,610,236,846,34,880,1579,55.73%,38.63%,1
臺中市,北區,1010,785,361,1146,54,1200,2192,54.74%,35.81%,1
臺中市,北區,1011,582,318,900,40,940,1560,60.26%,37.31%,1
臺中市,北區,1012,554,268,822,32,854,1476,57.86%,37.53%,1
臺中市,北區,1013,411,192,603,23,626,1006,62.23%,40.85%,1
臺中市,北區,1014,547,239,786,32,818,1403,58.3%,38.99%,1
臺中市,北區,1015,526,236,762,12,774,1446,53.53%,36.38%,1
臺中市,北區,1016,528,272,800,24,824,1460,56.44%,36.16%,1
臺中市,北區,1017,465,252,717,24,741,1233,60.1%,37.71%,1
臺中市,北區,1018,427,231,658,21,679,1027,66.11%,41.58%,1
臺中市,北區,1019,453,242,695,11,706,1207,58.49%,37.53%,1
臺中市,北區,1020,453,240,693,28,721,1167,61.78%,38.82%,1
臺中市,北區,1021,419,226,645,25,670,1150,58.26%,36.43%,1
臺中市,北區,1022,390,203,593,36,629,1061,59.28%,36.76%,1
臺中市,北區,1023,388,214,602,18,620,1005,61.69%,38.61%,1
臺中市,北區,1024,433,265,698,25,723,1250,57.84%,34.64%,1
臺中市,北區,1025,561,286,847,33,880,1448,60.77%,38.74%,1
臺中市,北區,1026,508,281,789,39,828,1379,60.04%,36.84%,1
臺中市,北區,1027,591,328,919,45,964,1652,58.35%,35.77%,1
臺中市,北區,1028,619,365,984,31,1015,1867,54.37%,33.15%,1
臺中市,北區,1029,389,190,579,14,593,2078,28.54%,18.72%,1
臺中市,北區,1030,667,267,934,28,962,1562,61.59%,42.7%,1
臺中市,北區,1031,541,269,810,22,832,1430,58.18%,37.83%,1
臺中市,北區,1032,777,376,1153,32,1185,2018,58.72%,38.5%,1
臺中市,北區,1033,574,273,847,25,872,1710,50.99%,33.57%,1
臺中市,北區,1034,549,226,775,28,803,1432,56.08%,38.34%,1
臺中市,北區,1035,465,211,676,33,709,1157,61.28%,40.19%,1
臺中市,北區,1036,457,233,690,21,711,1188,59.85%,38.47%,1
臺中市,北區,1037,535,250,785,26,811,1419,57.15%,37.7%,1
臺中市,北區,1038,591,298,889,16,905,1653,54.75%,35.75%,1
臺中市,北區,1039,436,258,694,35,729,1233,59.12%,35.36%,1
臺中市,北區,1040,444,265,709,23,732,1243,58.89%,35.72%,1
臺中市,北區,1041,425,213,638,15,653,1219,53.57%,34.86%,1
臺中市,北區,1042,481,244,725,36,761,1272,59.83%,37.81%,1
臺中市,北區,1043,484,273,757,13,770,1285,59.92%,37.67%,1
臺中市,北區,1044,653,360,1013,34,1047,1780,58.82%,36.69%,1
臺中市,北區,1045,502,252,754,28,782,1461,53.52%,34.36%,1
臺中市,北區,1046,552,217,769,30,799,1310,60.99%,42.14%,1
臺中市,北區,1047,570,331,901,25,926,1669,55.48%,34.15%,1
臺中市,北區,1048,714,380,1094,30,1124,1932,58.18%,36.96%,1
臺中市,北區,1049,621,307,928,28,956,1682,56.84%,36.92%,1
臺中市,北區,1050,645,365,1010,17,1027,1891,54.31%,34.11%,1
臺中市,北區,1051,663,343,1006,57,1063,1882,56.48%,35.23%,1
臺中市,北區,1052,442,207,649,25,674,1159,58.15%,38.14%,1
臺中市,北區,1053,600,272,872,36,908,1553,58.47%,38.63%,1
臺中市,北區,1054,528,321,849,34,883,1607,54.95%,32.86%,1
臺中市,北區,1055,607,352,959,34,993,1773,56.01%,34.24%,1
臺中市,北區,1056,554,286,840,34,874,1524,57.35%,36.35%,1
臺中市,北區,1057,664,308,972,38,1010,1613,62.62%,41.17%,1
臺中市,北區,1058,719,350,1069,39,1108,1877,59.03%,38.31%,1
臺中市,北區,1059,655,335,990,41,1031,1792,57.53%,36.55%,1
臺中市,北區,1060,555,247,802,32,834,1392,59.91%,39.87%,1
臺中市,北區,1061,477,238,715,25,740,1297,57.05%,36.78%,1
臺中市,北區,1062,596,330,926,30,956,1556,61.44%,38.3%,1
臺中市,北區,1063,531,285,816,24,840,1497,56.11%,35.47%,1
臺中市,北區,1064,579,259,838,31,869,1550,56.06%,37.35%,1
臺中市,北區,1065,491,281,772,26,798,1434,55.65%,34.24%,1
臺中市,北區,1066,616,373,989,56,1045,1793,58.28%,34.36%,1
臺中市,北區,1067,649,376,1025,29,1054,1866,56.48%,34.78%,1
臺中市,北區,1068,521,246,767,38,805,1346,59.81%,38.71%,1
臺中市,北區,1069,488,236,724,22,746,1267,58.88%,38.52%,1
臺中市,西屯區,0625,648,298,946,31,977,1638,59.65%,39.56%,1
臺中市,西屯區,0626,442,284,726,23,749,1335,56.1%,33.11%,1
臺中市,西屯區,0627,682,340,1022,28,1050,1776,59.12%,38.4%,1
臺中市,西屯區,0628,477,281,758,34,792,1351,58.62%,35.31%,1
臺中市,西屯區,0629,507,282,789,30,819,1338,61.21%,37.89%,1
臺中市,西屯區,0630,683,176,859,44,903,1582,57.08%,43.17%,1
臺中市,西屯區,0631,636,259,895,33,928,1710,54.27%,37.19%,1
臺中市,西屯區,0632,535,277,812,34,846,1595,53.04%,33.54%,1
臺中市,西屯區,0633,619,256,875,45,920,1585,58.04%,39.05%,1
臺中市,西屯區,0634,637,303,940,45,985,1749,56.32%,36.42%,1
臺中市,西屯區,0635,729,329,1058,33,1091,1877,58.12%,38.84%,1
臺中市,西屯區,0636,577,322,899,26,925,1697,54.51%,34%,1
臺中市,西屯區,0637,584,291,875,36,911,1480,61.55%,39.46%,1
臺中市,西屯區,0638,594,327,921,52,973,1483,65.61%,40.05%,1
臺中市,西屯區,0639,576,301,877,27,904,2484,36.39%,23.19%,1
臺中市,西屯區,0640,376,130,506,24,530,781,67.86%,48.14%,1
臺中市,西屯區,0641,569,293,862,36,898,1477,60.8%,38.52%,1
臺中市,西屯區,0642,649,322,971,30,1001,1784,56.11%,36.38%,1
臺中市,西屯區,0643,641,293,934,27,961,1686,57%,38.02%,1
臺中市,西屯區,0644,605,328,933,27,960,1692,56.74%,35.76%,1
臺中市,西屯區,0645,591,281,872,33,905,1659,54.55%,35.62%,1
臺中市,西屯區,0646,611,321,932,48,980,1648,59.47%,37.08%,1
臺中市,西屯區,0647,579,334,913,29,942,1536,61.33%,37.7%,1
臺中市,西屯區,0648,616,330,946,32,978,1666,58.7%,36.97%,1
臺中市,西屯區,0649,510,308,818,32,850,1428,59.52%,35.71%,1
臺中市,西屯區,0650,632,316,948,37,985,1810,54.42%,34.92%,1
臺中市,西屯區,0651,577,298,875,19,894,1574,56.8%,36.66%,1
臺中市,西屯區,0652,630,302,932,21,953,1650,57.76%,38.18%,1
臺中市,西屯區,0653,569,348,917,58,975,1681,58%,33.85%,1
臺中市,西屯區,0654,567,326,893,39,932,1656,56.28%,34.24%,1
臺中市,西屯區,0655,528,200,728,36,764,1243,61.46%,42.48%,1
臺中市,西屯區,0656,600,301,901,39,940,1471,63.9%,40.79%,1
臺中市,西屯區,0657,552,314,866,25,891,1431,62.26%,38.57%,1
臺中市,西屯區,0658,634,311,945,35,980,1714,57.18%,36.99%,1
臺中市,西屯區,0659,560,238,798,28,826,1424,58.01%,39.33%,1
臺中市,西屯區,0660,458,208,666,31,697,1176,59.27%,38.95%,1
臺中市,西屯區,0661,545,290,835,41,876,1456,60.16%,37.43%,1
臺中市,西屯區,0662,567,306,873,36,909,1451,62.65%,39.08%,1
臺中市,西屯區,0663,468,219,687,14,701,1063,65.95%,44.03%,1
臺中市,西屯區,0664,530,229,759,39,798,1357,58.81%,39.06%,1
臺中市,西屯區,0665,589,200,789,56,845,1355,62.36%,43.47%,1
臺中市,西屯區,0666,603,217,820,36,856,1384,61.85%,43.57%,1
臺中市,西屯區,0667,629,302,931,39,970,1613,60.14%,39%,1
臺中市,西屯區,0668,590,279,869,42,911,1562,58.32%,37.77%,1
臺中市,西屯區,0669,503,265,768,37,805,1219,66.04%,41.26%,1
臺中市,西屯區,0670,433,273,706,36,742,1235,60.08%,35.06%,1
臺中市,西屯區,0671,413,233,646,38,684,1131,60.48%,36.52%,1
臺中市,西屯區,0672,601,306,907,25,932,1494,62.38%,40.23%,1
臺中市,西屯區,0673,485,286,771,17,788,1325,59.47%,36.6%,1
臺中市,西屯區,0674,499,287,786,43,829,1386,59.81%,36%,1
臺中市,西屯區,0675,668,368,1036,37,1073,1816,59.09%,36.78%,1
臺中市,西屯區,0676,603,324,927,28,955,1734,55.07%,34.78%,1
臺中市,西屯區,0677,657,375,1032,40,1072,1777,60.33%,36.97%,1
臺中市,西屯區,0678,604,357,961,43,1004,1818,55.23%,33.22%,1
臺中市,西屯區,0679,598,317,915,54,969,1699,57.03%,35.2%,1
臺中市,西屯區,0680,581,302,883,30,913,1715,53.24%,33.88%,1
臺中市,西屯區,0681,530,339,869,34,903,1654,54.59%,32.04%,1
臺中市,西屯區,0682,596,304,900,18,918,1636,56.11%,36.43%,1
臺中市,西屯區,0683,459,255,714,24,738,1298,56.86%,35.36%,1
臺中市,西屯區,0684,531,277,808,37,845,1391,60.75%,38.17%,1
臺中市,西屯區,0685,695,376,1071,29,1100,1853,59.36%,37.51%,1
臺中市,西屯區,0686,658,313,971,41,1012,1820,55.6%,36.15%,1
臺中市,西屯區,0687,677,336,1013,46,1059,1809,58.54%,37.42%,1
臺中市,西屯區,0688,533,274,807,34,841,1352,62.2%,39.42%,1
臺中市,西屯區,0689,558,294,852,40,892,1521,58.65%,36.69%,1
臺中市,西屯區,0690,598,287,885,27,912,1486,61.37%,40.24%,1
臺中市,西屯區,0691,635,309,944,42,986,1674,58.9%,37.93%,1
臺中市,西屯區,0692,615,343,958,51,1009,1610,62.67%,38.2%,1
臺中市,西屯區,0693,632,319,951,37,988,1695,58.29%,37.29%,1
臺中市,西屯區,0694,571,334,905,37,942,1684,55.94%,33.91%,1
臺中市,西屯區,0695,505,229,734,23,757,1221,62%,41.36%,1
臺中市,西屯區,0696,567,244,811,43,854,1252,68.21%,45.29%,1
臺中市,西屯區,0697,526,261,787,29,816,1301,62.72%,40.43%,1
臺中市,西屯區,0698,492,144,636,37,673,1049,64.16%,46.9%,1
臺中市,西屯區,0699,502,149,651,32,683,1113,61.37%,45.1%,1
臺中市,西屯區,0700,587,225,812,34,846,1557,54.34%,37.7%,1
臺中市,西屯區,0701,611,269,880,35,915,1640,55.79%,37.26%,1
臺中市,西屯區,0702,617,256,873,61,934,1402,66.62%,44.01%,1
臺中市,西屯區,0703,595,260,855,45,900,1717,52.42%,34.65%,1
臺中市,西屯區,0704,623,291,914,43,957,1688,56.69%,36.91%,1
臺中市,西屯區,0705,433,207,640,84,724,1168,61.99%,37.07%,1
臺中市,西屯區,0706,632,273,905,45,950,1729,54.95%,36.55%,1
臺中市,西屯區,0707,713,342,1055,27,1082,2007,53.91%,35.53%,1
臺中市,西屯區,0708,492,259,751,55,806,1296,62.19%,37.96%,1
臺中市,西屯區,0709,367,170,537,19,556,1068,52.06%,34.36%,1
臺中市,西屯區,0710,698,278,976,57,1033,1707,60.52%,40.89%,1
臺中市,西屯區,0711,613,323,936,31,967,1636,59.11%,37.47%,1
臺中市,西屯區,0712,581,184,765,34,799,1761,45.37%,32.99%,1
臺中市,西屯區,0713,470,284,754,36,790,1314,60.12%,35.77%,1
臺中市,西屯區,0714,493,270,763,32,795,1233,64.48%,39.98%,1
臺中市,西屯區,0715,564,251,815,43,858,1549,55.39%,36.41%,1
臺中市,西屯區,0716,589,277,866,32,898,1639,54.79%,35.94%,1
臺中市,西屯區,0717,570,210,780,35,815,1486,54.85%,38.36%,1
臺中市,西屯區,0718,607,350,957,29,986,1806,54.6%,33.61%,1
臺中市,西屯區,0719,500,273,773,21,794,1451,54.72%,34.46%,1
臺中市,西屯區,0720,540,222,762,21,783,1302,60.14%,41.47%,1
臺中市,西屯區,0721,521,283,804,34,838,1353,61.94%,38.51%,1
臺中市,西屯區,0722,808,409,1217,43,1260,2162,58.28%,37.37%,1
臺中市,西屯區,0723,530,301,831,26,857,1520,56.38%,34.87%,1
臺中市,西屯區,0724,726,321,1047,30,1077,1935,55.66%,37.52%,1
臺中市,西屯區,0725,658,361,1019,32,1051,1847,56.9%,35.63%,1
臺中市,西屯區,0726,623,366,989,27,1016,1738,58.46%,35.85%,1
臺中市,西屯區,0727,650,324,974,34,1008,1640,61.46%,39.63%,1
臺中市,西屯區,0728,668,399,1067,37,1104,1908,57.86%,35.01%,1
臺中市,西屯區,0729,512,278,790,27,817,1402,58.27%,36.52%,1
臺中市,西屯區,0730,512,279,791,30,821,1515,54.19%,33.8%,1
臺中市,西屯區,0731,500,229,729,31,760,1541,49.32%,32.45%,1
臺中市,西屯區,0732,503,309,812,23,835,1502,55.59%,33.49%,1
臺中市,西屯區,0733,552,316,868,46,914,1526,59.9%,36.17%,1
臺中市,西屯區,0734,521,306,827,47,874,1425,61.33%,36.56%,1
臺中市,西屯區,0735,534,273,807,23,830,1334,62.22%,40.03%,1
臺中市,西屯區,0736,653,333,986,27,1013,1649,61.43%,39.6%,1
臺中市,西屯區,0737,596,306,902,29,931,1566,59.45%,38.06%,1
臺中市,西屯區,0738,646,316,962,31,993,1629,60.96%,39.66%,1
臺中市,西屯區,0739,595,324,919,37,956,1628,58.72%,36.55%,1
臺中市,西屯區,0740,554,313,867,24,891,1442,61.79%,38.42%,1
臺中市,西屯區,0741,413,226,639,30,669,1206,55.47%,34.25%,1
臺中市,西屯區,0742,445,206,651,37,688,1086,63.35%,40.98%,1
臺中市,西屯區,0743,456,195,651,36,687,1088,63.14%,41.91%,1
臺中市,西屯區,0744,421,241,662,28,690,1140,60.53%,36.93%,1
臺中市,南屯區,0745,614,172,786,36,822,1321,62.23%,46.48%,1
臺中市,南屯區,0746,508,304,812,35,847,1346,62.93%,37.74%,1
臺中市,南屯區,0747,591,275,866,19,885,1428,61.97%,41.39%,1
臺中市,南屯區,0748,558,268,826,25,851,1442,59.02%,38.7%,1
臺中市,南屯區,0749,602,282,884,24,908,1408,64.49%,42.76%,1
臺中市,南屯區,0750,572,277,849,15,864,1404,61.54%,40.74%,1
臺中市,南屯區,0751,565,272,837,29,866,1354,63.96%,41.73%,1
臺中市,南屯區,0752,523,278,801,40,841,1332,63.14%,39.26%,1
臺中市,南屯區,0753,435,438,873,29,902,1463,61.65%,29.73%,1
臺中市,南屯區,0754,521,302,823,35,858,1413,60.72%,36.87%,1
臺中市,南屯區,0755,493,280,773,27,800,1218,65.68%,40.48%,1
臺中市,南屯區,0756,529,250,779,26,805,1308,61.54%,40.44%,1
臺中市,南屯區,0757,615,321,936,25,961,1527,62.93%,40.28%,1
臺中市,南屯區,0758,501,284,785,31,816,1294,63.06%,38.72%,1
臺中市,南屯區,0759,514,260,774,42,816,1516,53.83%,33.91%,1
臺中市,南屯區,0760,581,321,902,49,951,1529,62.2%,38%,1
臺中市,南屯區,0761,564,270,834,36,870,1397,62.28%,40.37%,1
臺中市,南屯區,0762,550,223,773,24,797,1406,56.69%,39.12%,1
臺中市,南屯區,0763,564,250,814,31,845,1497,56.45%,37.68%,1
臺中市,南屯區,0764,538,241,779,46,825,1424,57.94%,37.78%,1
臺中市,南屯區,0765,469,266,735,38,773,1488,51.95%,31.52%,1
臺中市,南屯區,0766,245,130,375,33,408,608,67.11%,40.3%,1
臺中市,南屯區,0767,329,155,484,52,536,813,65.93%,40.47%,1
臺中市,南屯區,0768,476,215,691,48,739,1190,62.1%,40%,1
臺中市,南屯區,0769,482,182,664,21,685,1174,58.35%,41.06%,1
臺中市,南屯區,0770,496,223,719,12,731,1224,59.72%,40.52%,1
臺中市,南屯區,0771,512,204,716,36,752,1466,51.3%,34.92%,1
臺中市,南屯區,0772,403,146,549,24,573,1333,42.99%,30.23%,1
臺中市,南屯區,0773,336,157,493,28,521,814,64%,41.28%,1
臺中市,南屯區,0774,549,207,756,42,798,1436,55.57%,38.23%,1
臺中市,南屯區,0775,566,316,882,28,910,1515,60.07%,37.36%,1
臺中市,南屯區,0776,508,253,761,39,800,1545,51.78%,32.88%,1
臺中市,南屯區,0777,531,264,795,25,820,1383,59.29%,38.39%,1
臺中市,南屯區,0778,577,266,843,23,866,1433,60.43%,40.27%,1
臺中市,南屯區,0779,383,217,600,27,627,1134,55.29%,33.77%,1
臺中市,南屯區,0780,481,249,730,32,762,1216,62.66%,39.56%,1
臺中市,南屯區,0781,451,227,678,57,735,1271,57.83%,35.48%,1
臺中市,南屯區,0782,429,225,654,20,674,1203,56.03%,35.66%,1
臺中市,南屯區,0783,492,234,726,24,750,1268,59.15%,38.8%,1
臺中市,南屯區,0784,580,227,807,29,836,1390,60.14%,41.73%,1
臺中市,南屯區,0785,527,247,774,43,817,1397,58.48%,37.72%,1
臺中市,南屯區,0786,571,297,868,56,924,1607,57.5%,35.53%,1
臺中市,南屯區,0787,633,289,922,31,953,1582,60.24%,40.01%,1
臺中市,南屯區,0788,658,276,934,36,970,1611,60.21%,40.84%,1
臺中市,南屯區,0789,519,291,810,28,838,1322,63.39%,39.26%,1
臺中市,南屯區,0790,590,242,832,26,858,1321,64.95%,44.66%,1
臺中市,南屯區,0791,563,257,820,32,852,1360,62.65%,41.4%,1
臺中市,南屯區,0792,520,307,827,21,848,1361,62.31%,38.21%,1
臺中市,南屯區,0793,494,275,769,25,794,1257,63.17%,39.3%,1
臺中市,南屯區,0794,515,255,770,16,786,1207,65.12%,42.67%,1
臺中市,南屯區,0795,507,288,795,26,821,1282,64.04%,39.55%,1
臺中市,南屯區,0796,517,272,789,29,818,1248,65.54%,41.43%,1
臺中市,南屯區,0797,522,294,816,34,850,1304,65.18%,40.03%,1
臺中市,南屯區,0798,471,254,725,20,745,1214,61.37%,38.8%,1
臺中市,南屯區,0799,427,255,682,29,711,1102,64.52%,38.75%,1
臺中市,南屯區,0800,688,325,1013,87,1100,1630,67.48%,42.21%,1
臺中市,南屯區,0801,496,308,804,28,832,1333,62.42%,37.21%,1
臺中市,南屯區,0802,412,355,767,23,790,1292,61.15%,31.89%,1
臺中市,南屯區,0803,490,271,761,25,786,1272,61.79%,38.52%,1
臺中市,南屯區,0804,538,251,789,15,804,1345,59.78%,40%,1
臺中市,南屯區,0805,444,214,658,34,692,981,70.54%,45.26%,1
臺中市,南屯區,0806,448,211,659,44,703,1097,64.08%,40.84%,1
臺中市,南屯區,0807,448,185,633,16,649,991,65.49%,45.21%,1
臺中市,南屯區,0808,476,223,699,21,720,1170,61.54%,40.68%,1
臺中市,南屯區,0809,462,274,736,17,753,1171,64.3%,39.45%,1
臺中市,南屯區,0810,485,277,762,45,807,1349,59.82%,35.95%,1
臺中市,南屯區,0811,545,303,848,21,869,1368,63.52%,39.84%,1
臺中市,南屯區,0812,525,270,795,27,822,1263,65.08%,41.57%,1
臺中市,南屯區,0813,603,331,934,33,967,1547,62.51%,38.98%,1
臺中市,南屯區,0814,609,337,946,39,985,1649,59.73%,36.93%,1
臺中市,南屯區,0815,601,312,913,13,926,1629,56.84%,36.89%,1
臺中市,南屯區,0816,503,320,823,33,856,1580,54.18%,31.84%,1
臺中市,南屯區,0817,607,313,920,22,942,1444,65.24%,42.04%,1
臺中市,南屯區,0818,557,267,824,21,845,1413,59.8%,39.42%,1
臺中市,南屯區,0819,540,244,784,28,812,1377,58.97%,39.22%,1
臺中市,南屯區,0820,547,367,914,23,937,1527,61.36%,35.82%,1
臺中市,南屯區,0821,542,272,814,29,843,1335,63.15%,40.6%,1
臺中市,南屯區,0822,653,366,1019,21,1040,1544,67.36%,42.29%,1
臺中市,南屯區,0823,615,332,947,25,972,1482,65.59%,41.5%,1
臺中市,南屯區,0824,609,281,890,42,932,1488,62.63%,40.93%,1
臺中市,南屯區,0825,510,273,783,29,812,1538,52.8%,33.16%,1
臺中市,南屯區,0826,674,337,1011,49,1060,1674,63.32%,40.26%,1
臺中市,南屯區,0827,529,303,832,31,863,1996,43.24%,26.5%,1
臺中市,南屯區,0828,598,281,879,40,919,1514,60.7%,39.5%,1
臺中市,南屯區,0829,525,225,750,33,783,1217,64.34%,43.14%,1
臺中市,南屯區,0830,507,270,777,29,806,1347,59.84%,37.64%,1
臺中市,南屯區,0831,472,207,679,24,703,1109,63.39%,42.56%,1
臺中市,南屯區,0832,564,315,879,26,905,1546,58.54%,36.48%,1
臺中市,南屯區,0833,583,286,869,36,905,1408,64.28%,41.41%,1
臺中市,南屯區,0834,439,158,597,23,620,1057,58.66%,41.53%,1
臺中市,南屯區,0835,431,223,654,42,696,1133,61.43%,38.04%,1
臺中市,南屯區,0836,501,261,762,28,790,1278,61.82%,39.2%,1
臺中市,南屯區,0837,496,225,721,35,756,1144,66.08%,43.36%,1
臺中市,南屯區,0838,425,246,671,34,705,1140,61.84%,37.28%,1
臺中市,南屯區,0839,426,295,721,26,747,1171,63.79%,36.38%,1
臺中市,南屯區,0840,523,284,807,33,840,1303,64.47%,40.14%,1
臺中市,南屯區,0841,502,272,774,33,807,1402,57.56%,35.81%,1
臺中市,南屯區,0842,601,272,873,40,913,1571,58.12%,38.26%,1
臺中市,南屯區,0843,475,241,716,22,738,1139,64.79%,41.7%,1
臺中市,南屯區,0844,506,249,755,31,786,1216,64.64%,41.61%,1
臺中市,南屯區,0845,493,220,713,28,741,1162,63.77%,42.43%,1
臺中市,北屯區,0846,660,345,1005,39,1044,1670,62.51%,39.52%,1
臺中市,北屯區,0847,626,286,912,42,954,1706,55.92%,36.69%,1
臺中市,北屯區,0848,550,259,809,56,865,1507,57.4%,36.5%,1
臺中市,北屯區,0849,608,340,948,40,988,1652,59.81%,36.8%,1
臺中市,北屯區,0850,419,187,606,19,625,1107,56.46%,37.85%,1
臺中市,北屯區,0851,772,337,1109,57,1166,2151,54.21%,35.89%,1
臺中市,北屯區,0852,667,293,960,26,986,1612,61.17%,41.38%,1
臺中市,北屯區,0853,648,314,962,36,998,1743,57.26%,37.18%,1
臺中市,北屯區,0854,710,373,1083,27,1110,2099,52.88%,33.83%,1
臺中市,北屯區,0855,619,283,902,31,933,1595,58.5%,38.81%,1
臺中市,北屯區,0856,744,333,1077,39,1116,1923,58.03%,38.69%,1
臺中市,北屯區,0857,618,245,863,45,908,1641,55.33%,37.66%,1
臺中市,北屯區,0858,499,239,738,24,762,1157,65.86%,43.13%,1
臺中市,北屯區,0859,420,215,635,30,665,1041,63.88%,40.35%,1
臺中市,北屯區,0860,559,262,821,25,846,1563,54.13%,35.76%,1
臺中市,北屯區,0861,583,227,810,38,848,1559,54.39%,37.4%,1
臺中市,北屯區,0862,540,186,726,14,740,1411,52.45%,38.27%,1
臺中市,北屯區,0863,667,339,1006,37,1043,1761,59.23%,37.88%,1
臺中市,北屯區,0864,552,260,812,49,861,1361,63.26%,40.56%,1
臺中市,北屯區,0865,721,304,1025,41,1066,1852,57.56%,38.93%,1
臺中市,北屯區,0866,759,352,1111,32,1143,1928,59.28%,39.37%,1
臺中市,北屯區,0867,645,288,933,33,966,1492,64.75%,43.23%,1
臺中市,北屯區,0868,718,335,1053,52,1105,1998,55.31%,35.94%,1
臺中市,北屯區,0869,558,237,795,30,825,1272,64.86%,43.87%,1
臺中市,北屯區,0870,541,270,811,30,841,1317,63.86%,41.08%,1
臺中市,北屯區,0871,469,196,665,58,723,1327,54.48%,35.34%,1
臺中市,北屯區,0872,464,214,678,27,705,1280,55.08%,36.25%,1
臺中市,北屯區,0873,648,300,948,43,991,1865,53.14%,34.75%,1
臺中市,北屯區,0874,532,223,755,35,790,1230,64.23%,43.25%,1
臺中市,北屯區,0875,486,234,720,32,752,1356,55.46%,35.84%,1
臺中市,北屯區,0876,655,291,946,45,991,1732,57.22%,37.82%,1
臺中市,北屯區,0877,605,321,926,38,964,1586,60.78%,38.15%,1
臺中市,北屯區,0878,528,270,798,20,818,1441,56.77%,36.64%,1
臺中市,北屯區,0879,691,361,1052,66,1118,2045,54.67%,33.79%,1
臺中市,北屯區,0880,648,312,960,45,1005,1914,52.51%,33.86%,1
臺中市,北屯區,0881,779,297,1076,29,1105,1918,57.61%,40.62%,1
臺中市,北屯區,0882,731,326,1057,27,1084,2079,52.14%,35.16%,1
臺中市,北屯區,0883,749,371,1120,30,1150,2040,56.37%,36.72%,1
臺中市,北屯區,0884,636,330,966,43,1009,2027,49.78%,31.38%,1
臺中市,北屯區,0885,521,231,752,45,797,1402,56.85%,37.16%,1
臺中市,北屯區,0886,678,366,1044,42,1086,1826,59.47%,37.13%,1
臺中市,北屯區,0887,722,339,1061,36,1097,2162,50.74%,33.4%,1
臺中市,北屯區,0888,703,395,1098,24,1122,2332,48.11%,30.15%,1
臺中市,北屯區,0889,398,146,544,38,582,985,59.09%,40.41%,1
臺中市,北屯區,0890,738,296,1034,32,1066,2037,52.33%,36.23%,1
臺中市,北屯區,0891,409,164,573,40,613,1032,59.4%,39.63%,1
臺中市,北屯區,0892,401,197,598,27,625,1062,58.85%,37.76%,1
臺中市,北屯區,0893,359,137,496,29,525,909,57.76%,39.49%,1
臺中市,北屯區,0894,551,312,863,39,902,1445,62.42%,38.13%,1
臺中市,北屯區,0895,654,292,946,39,985,1842,53.47%,35.5%,1
臺中市,北屯區,0896,466,230,696,25,721,1187,60.74%,39.26%,1
臺中市,北屯區,0897,589,258,847,28,875,1456,60.1%,40.45%,1
臺中市,北屯區,0898,600,443,1043,14,1057,1866,56.65%,32.15%,1
臺中市,北屯區,0899,584,279,863,41,904,1667,54.23%,35.03%,1
臺中市,北屯區,0900,653,327,980,20,1000,1683,59.42%,38.8%,1
臺中市,北屯區,0901,615,285,900,29,929,1642,56.58%,37.45%,1
臺中市,北屯區,0902,615,268,883,19,902,1475,61.15%,41.69%,1
臺中市,北屯區,0903,618,285,903,18,921,1644,56.02%,37.59%,1
臺中市,北屯區,0904,625,323,948,29,977,1603,60.95%,38.99%,1
臺中市,北屯區,0905,757,354,1111,51,1162,1949,59.62%,38.84%,1
臺中市,北屯區,0906,741,362,1103,37,1140,1790,63.69%,41.4%,1
臺中市,北屯區,0907,515,312,827,30,857,1440,59.51%,35.76%,1
臺中市,北屯區,0908,632,325,957,36,993,1601,62.02%,39.48%,1
臺中市,北屯區,0909,600,233,833,37,870,1527,56.97%,39.29%,1
臺中市,北屯區,0910,561,297,858,37,895,1675,53.43%,33.49%,1
臺中市,北屯區,0911,553,215,768,40,808,1579,51.17%,35.02%,1
臺中市,北屯區,0912,574,259,833,47,880,1524,57.74%,37.66%,1
臺中市,北屯區,0913,610,289,899,29,928,1677,55.34%,36.37%,1
臺中市,北屯區,0914,582,297,879,27,906,1599,56.66%,36.4%,1
臺中市,北屯區,0915,531,310,841,47,888,1458,60.91%,36.42%,1
臺中市,北屯區,0916,605,327,932,27,959,1571,61.04%,38.51%,1
臺中市,北屯區,0917,598,309,907,39,946,1579,59.91%,37.87%,1
臺中市,北屯區,0918,692,362,1054,37,1091,1849,59%,37.43%,1
臺中市,北屯區,0919,624,322,946,25,971,1682,57.73%,37.1%,1
臺中市,北屯區,0920,644,303,947,24,971,1760,55.17%,36.59%,1
臺中市,北屯區,0921,630,323,953,41,994,1699,58.51%,37.08%,1
臺中市,北屯區,0922,652,323,975,49,1024,1626,62.98%,40.1%,1
臺中市,北屯區,0923,573,330,903,7,910,1491,61.03%,38.43%,1
臺中市,北屯區,0924,598,314,912,34,946,1640,57.68%,36.46%,1
臺中市,北屯區,0925,715,371,1086,47,1133,2052,55.21%,34.84%,1
臺中市,北屯區,0926,697,311,1008,33,1041,1875,55.52%,37.17%,1
臺中市,北屯區,0927,593,267,860,25,885,1559,56.77%,38.04%,1
臺中市,北屯區,0928,565,288,853,29,882,1480,59.59%,38.18%,1
臺中市,北屯區,0929,544,258,802,39,841,1397,60.2%,38.94%,1
臺中市,北屯區,0930,692,363,1055,47,1102,1889,58.34%,36.63%,1
臺中市,北屯區,0931,610,316,926,44,970,1728,56.13%,35.3%,1
臺中市,北屯區,0932,577,280,857,35,892,1592,56.03%,36.24%,1
臺中市,北屯區,0933,577,299,876,46,922,1656,55.68%,34.84%,1
臺中市,北屯區,0934,545,255,800,34,834,1524,54.72%,35.76%,1
臺中市,北屯區,0935,570,297,867,17,884,1502,58.85%,37.95%,1
臺中市,北屯區,0936,655,309,964,31,995,1772,56.15%,36.96%,1
臺中市,北屯區,0937,546,286,832,42,874,1461,59.82%,37.37%,1
臺中市,北屯區,0938,595,291,886,34,920,1769,52.01%,33.63%,1
臺中市,北屯區,0939,666,415,1081,48,1129,1894,59.61%,35.16%,1
臺中市,北屯區,0940,698,343,1041,36,1077,2033,52.98%,34.33%,1
臺中市,北屯區,0941,686,341,1027,41,1068,1947,54.85%,35.23%,1
臺中市,北屯區,0942,785,440,1225,38,1263,2188,57.72%,35.88%,1
臺中市,北屯區,0943,634,338,972,37,1009,1661,60.75%,38.17%,1
臺中市,北屯區,0944,627,309,936,37,973,1667,58.37%,37.61%,1
臺中市,北屯區,0945,637,315,952,31,983,1728,56.89%,36.86%,1
臺中市,北屯區,0946,617,309,926,20,946,1688,56.04%,36.55%,1
臺中市,北屯區,0947,528,296,824,25,849,1475,57.56%,35.8%,1
臺中市,北屯區,0948,676,365,1041,24,1065,1681,63.36%,40.21%,1
臺中市,北屯區,0949,808,404,1212,26,1238,2078,59.58%,38.88%,1
臺中市,北屯區,0950,755,370,1125,39,1164,2059,56.53%,36.67%,1
臺中市,北屯區,0951,655,372,1027,34,1061,1792,59.21%,36.55%,1
臺中市,北屯區,0952,678,352,1030,28,1058,2974,35.57%,22.8%,1
臺中市,北屯區,0953,432,173,605,27,632,1072,58.96%,40.3%,1
臺中市,北屯區,0954,845,387,1232,44,1276,2099,60.79%,40.26%,1
臺中市,北屯區,0955,745,389,1134,44,1178,1823,64.62%,40.87%,1
臺中市,北屯區,0956,825,354,1179,64,1243,2022,61.47%,40.8%,1
臺中市,北屯區,0957,746,370,1116,36,1152,1992,57.83%,37.45%,1
臺中市,北屯區,0958,633,309,942,46,988,1585,62.33%,39.94%,1
臺中市,北屯區,0959,610,322,932,30,962,1565,61.47%,38.98%,1
臺中市,北屯區,0960,652,257,909,43,952,1780,53.48%,36.63%,1
臺中市,北屯區,0961,745,366,1111,51,1162,1874,62.01%,39.75%,1
臺中市,北屯區,0962,759,286,1045,33,1078,1755,61.42%,43.25%,1
臺中市,北屯區,0963,664,336,1000,18,1018,1497,68%,44.36%,1
臺中市,北屯區,0964,636,300,936,48,984,1567,62.8%,40.59%,1
臺中市,北屯區,0965,643,246,889,26,915,1624,56.34%,39.59%,1
臺中市,北屯區,0966,664,298,962,32,994,1614,61.59%,41.14%,1
臺中市,北屯區,0967,595,289,884,31,915,1595,57.37%,37.3%,1
臺中市,北屯區,0968,671,240,911,44,955,1782,53.59%,37.65%,1
臺中市,北屯區,0969,465,215,680,27,707,1357,52.1%,34.27%,1
臺中市,北屯區,0970,422,170,592,34,626,1071,58.45%,39.4%,1
臺中市,北屯區,0971,515,218,733,39,772,1372,56.27%,37.54%,1
臺中市,北屯區,0972,584,230,814,40,854,1415,60.35%,41.27%,1
臺中市,北屯區,0973,691,355,1046,46,1092,1789,61.04%,38.62%,1
臺中市,北屯區,0974,825,312,1137,53,1190,1907,62.4%,43.26%,1
臺中市,北屯區,0975,807,348,1155,38,1193,2008,59.41%,40.19%,1
臺中市,北屯區,0976,604,238,842,44,886,1541,57.5%,39.2%,1
臺中市,北屯區,0977,699,278,977,33,1010,1669,60.52%,41.88%,1
臺中市,北屯區,0978,660,299,959,33,992,1685,58.87%,39.17%,1
臺中市,北屯區,0979,692,312,1004,59,1063,1785,59.55%,38.77%,1
臺中市,北屯區,0980,676,266,942,43,985,1596,61.72%,42.36%,1
臺中市,北屯區,0981,657,344,1001,45,1046,1731,60.43%,37.95%,1
臺中市,北屯區,0982,558,240,798,53,851,1496,56.89%,37.3%,1
臺中市,豐原區,0394,369,162,531,32,563,983,57.27%,37.54%,1
臺中市,豐原區,0395,548,242,790,34,824,1309,62.95%,41.86%,1
臺中市,豐原區,0396,441,224,665,30,695,1116,62.28%,39.52%,1
臺中市,豐原區,0397,394,178,572,39,611,945,64.66%,41.69%,1
臺中市,豐原區,0398,309,195,504,51,555,850,65.29%,36.35%,1
臺中市,豐原區,0399,309,166,475,23,498,760,65.53%,40.66%,1
臺中市,豐原區,0400,645,264,909,10,919,1617,56.83%,39.89%,1
臺中市,豐原區,0401,591,250,841,48,889,1677,53.01%,35.24%,1
臺中市,豐原區,0402,736,345,1081,48,1129,1771,63.75%,41.56%,1
臺中市,豐原區,0403,447,175,622,50,672,1145,58.69%,39.04%,1
臺中市,豐原區,0404,498,255,753,39,792,1362,58.15%,36.56%,1
臺中市,豐原區,0405,578,235,813,32,845,1389,60.84%,41.61%,1
臺中市,豐原區,0406,620,271,891,49,940,1530,61.44%,40.52%,1
臺中市,豐原區,0407,547,267,814,70,884,1471,60.1%,37.19%,1
臺中市,豐原區,0408,571,239,810,62,872,1410,61.84%,40.5%,1
臺中市,豐原區,0409,448,190,638,34,672,1162,57.83%,38.55%,1
臺中市,豐原區,0410,660,270,930,27,957,1656,57.79%,39.86%,1
臺中市,豐原區,0411,706,296,1002,41,1043,1838,56.75%,38.41%,1
臺中市,豐原區,0412,612,280,892,66,958,1666,57.5%,36.73%,1
臺中市,豐原區,0413,690,316,1006,87,1093,1821,60.02%,37.89%,1
臺中市,豐原區,0414,812,342,1154,64,1218,1821,66.89%,44.59%,1
臺中市,豐原區,0415,596,309,905,38,943,1647,57.26%,36.19%,1
臺中市,豐原區,0416,525,271,796,51,847,1256,67.44%,41.8%,1
臺中市,豐原區,0417,657,284,941,46,987,1552,63.6%,42.33%,1
臺中市,豐原區,0418,689,322,1011,48,1059,1793,59.06%,38.43%,1
臺中市,豐原區,0419,353,150,503,41,544,759,71.67%,46.51%,1
臺中市,豐原區,0420,268,133,401,24,425,642,66.2%,41.74%,1
臺中市,豐原區,0421,628,287,915,34,949,1528,62.11%,41.1%,1
臺中市,豐原區,0422,768,308,1076,65,1141,1788,63.81%,42.95%,1
臺中市,豐原區,0423,711,322,1033,54,1087,1663,65.36%,42.75%,1
臺中市,豐原區,0424,591,241,832,44,876,1260,69.52%,46.9%,1
臺中市,豐原區,0425,347,156,503,33,536,902,59.42%,38.47%,1
臺中市,豐原區,0426,547,181,728,32,760,1357,56.01%,40.31%,1
臺中市,豐原區,0427,658,291,949,35,984,1592,61.81%,41.33%,1
臺中市,豐原區,0428,748,309,1057,47,1104,1873,58.94%,39.94%,1
臺中市,豐原區,0429,707,335,1042,58,1100,1867,58.92%,37.87%,1
臺中市,豐原區,0430,698,298,996,60,1056,1823,57.93%,38.29%,1
臺中市,豐原區,0431,703,292,995,51,1046,1962,53.31%,35.83%,1
臺中市,豐原區,0432,919,449,1368,52,1420,2313,61.39%,39.73%,1
臺中市,豐原區,0433,627,264,891,50,941,1510,62.32%,41.52%,1
臺中市,豐原區,0434,740,317,1057,43,1100,1824,60.31%,40.57%,1
臺中市,豐原區,0435,543,242,785,42,827,1363,60.67%,39.84%,1
臺中市,豐原區,0436,646,288,934,43,977,1535,63.65%,42.08%,1
臺中市,豐原區,0437,573,304,877,40,917,1457,62.94%,39.33%,1
臺中市,豐原區,0438,479,227,706,29,735,1184,62.08%,40.46%,1
臺中市,豐原區,0439,706,370,1076,48,1124,2299,48.89%,30.71%,1
臺中市,豐原區,0440,720,351,1071,81,1152,1940,59.38%,37.11%,1
臺中市,豐原區,0441,763,374,1137,43,1180,2067,57.09%,36.91%,1
臺中市,豐原區,0442,747,340,1087,66,1153,2038,56.58%,36.65%,1
臺中市,豐原區,0443,545,482,1027,38,1065,1835,58.04%,29.7%,1
臺中市,豐原區,0444,741,340,1081,65,1146,1979,57.91%,37.44%,1
臺中市,豐原區,0445,735,330,1065,77,1142,2014,56.7%,36.49%,1
臺中市,豐原區,0446,856,388,1244,83,1327,2257,58.79%,37.93%,1
臺中市,豐原區,0447,577,271,848,46,894,1406,63.58%,41.04%,1
臺中市,豐原區,0448,553,279,832,37,869,1418,61.28%,39%,1
臺中市,豐原區,0449,767,316,1083,41,1124,1772,63.43%,43.28%,1
臺中市,豐原區,0450,518,245,763,20,783,1202,65.14%,43.09%,1
臺中市,豐原區,0451,601,272,873,25,898,1447,62.06%,41.53%,1
臺中市,豐原區,0452,722,304,1026,60,1086,1758,61.77%,41.07%,1
臺中市,豐原區,0453,652,308,960,44,1004,1546,64.94%,42.17%,1
臺中市,豐原區,0454,784,314,1098,36,1134,1815,62.48%,43.2%,1
臺中市,豐原區,0455,732,389,1121,45,1166,1932,60.35%,37.89%,1
臺中市,豐原區,0456,754,349,1103,40,1143,1770,64.58%,42.6%,1
臺中市,豐原區,0457,598,244,842,24,866,1560,55.51%,38.33%,1
臺中市,豐原區,0458,697,323,1020,46,1066,1810,58.9%,38.51%,1
臺中市,豐原區,0459,677,345,1022,33,1055,1653,63.82%,40.96%,1
臺中市,豐原區,0460,579,239,818,47,865,1444,59.9%,40.1%,1
臺中市,豐原區,0461,532,281,813,28,841,1318,63.81%,40.36%,1
臺中市,豐原區,0462,551,340,891,65,956,1566,61.05%,35.19%,1
臺中市,豐原區,0463,615,359,974,46,1020,1748,58.35%,35.18%,1
臺中市,豐原區,0464,603,299,902,59,961,1772,54.23%,34.03%,1
臺中市,豐原區,0465,691,270,961,51,1012,1721,58.8%,40.15%,1
臺中市,豐原區,0466,745,173,918,33,951,1578,60.27%,47.21%,1
臺中市,豐原區,0467,677,357,1034,57,1091,1859,58.69%,36.42%,1
臺中市,豐原區,0468,575,277,852,32,884,1479,59.77%,38.88%,1
臺中市,豐原區,0469,753,329,1082,47,1129,1889,59.77%,39.86%,1
臺中市,豐原區,0470,681,319,1000,40,1040,1803,57.68%,37.77%,1
臺中市,豐原區,0471,514,273,787,40,827,1421,58.2%,36.17%,1
臺中市,豐原區,0472,638,316,954,52,1006,1585,63.47%,40.25%,1
臺中市,豐原區,0473,759,310,1069,50,1119,1774,63.08%,42.78%,1
臺中市,豐原區,0474,827,368,1195,68,1263,2132,59.24%,38.79%,1
臺中市,豐原區,0475,624,241,865,39,904,1515,59.67%,41.19%,1
臺中市,豐原區,0476,532,212,744,19,763,1359,56.14%,39.15%,1
臺中市,豐原區,0477,362,207,569,34,603,948,63.61%,38.19%,1
臺中市,豐原區,0478,438,234,672,40,712,1134,62.79%,38.62%,1
臺中市,豐原區,0479,472,217,689,62,751,1114,67.41%,42.37%,1
臺中市,豐原區,0480,415,192,607,37,644,1050,61.33%,39.52%,1
臺中市,豐原區,0481,484,252,736,39,775,1182,65.57%,40.95%,1
臺中市,東勢區,1513,460,204,664,58,722,1299,55.58%,35.41%,1
臺中市,東勢區,1514,394,151,545,48,593,1007,58.89%,39.13%,1
臺中市,東勢區,1515,306,126,432,48,480,859,55.88%,35.62%,1
臺中市,東勢區,1516,444,154,598,42,640,991,64.58%,44.8%,1
臺中市,東勢區,1517,304,129,433,26,459,863,53.19%,35.23%,1
臺中市,東勢區,1518,617,239,856,74,930,1628,57.13%,37.9%,1
臺中市,東勢區,1519,464,214,678,49,727,1335,54.46%,34.76%,1
臺中市,東勢區,1520,481,193,674,34,708,1092,64.84%,44.05%,1
臺中市,東勢區,1521,478,157,635,43,678,1050,64.57%,45.52%,1
臺中市,東勢區,1522,584,203,787,37,824,1431,57.58%,40.81%,1
臺中市,東勢區,1523,583,197,780,55,835,1372,60.86%,42.49%,1
臺中市,東勢區,1524,579,230,809,29,838,1412,59.35%,41.01%,1
臺中市,東勢區,1525,366,109,475,45,520,878,59.23%,41.69%,1
臺中市,東勢區,1526,522,188,710,57,767,1475,52%,35.39%,1
臺中市,東勢區,1527,350,110,460,16,476,872,54.59%,40.14%,1
臺中市,東勢區,1528,381,136,517,52,569,1006,56.56%,37.87%,1
臺中市,東勢區,1529,478,193,671,27,698,1222,57.12%,39.12%,1
臺中市,東勢區,1530,569,204,773,37,810,1228,65.96%,46.34%,1
臺中市,東勢區,1531,486,154,640,25,665,1036,64.19%,46.91%,1
臺中市,東勢區,1532,443,171,614,22,636,977,65.1%,45.34%,1
臺中市,東勢區,1533,550,205,755,36,791,1395,56.7%,39.43%,1
臺中市,東勢區,1534,512,181,693,50,743,1169,63.56%,43.8%,1
臺中市,東勢區,1535,459,143,602,42,644,1027,62.71%,44.69%,1
臺中市,東勢區,1536,433,139,572,34,606,984,61.59%,44%,1
臺中市,東勢區,1537,421,138,559,27,586,866,67.67%,48.61%,1
臺中市,東勢區,1538,443,144,587,54,641,1031,62.17%,42.97%,1
臺中市,東勢區,1539,409,132,541,37,578,865,66.82%,47.28%,1
臺中市,東勢區,1540,617,204,821,39,860,1357,63.38%,45.47%,1
臺中市,東勢區,1541,306,124,430,23,453,736,61.55%,41.58%,1
臺中市,東勢區,1542,554,190,744,37,781,1314,59.44%,42.16%,1
臺中市,東勢區,1543,612,255,867,56,923,1677,55.04%,36.49%,1
臺中市,東勢區,1544,408,155,563,22,585,950,61.58%,42.95%,1
臺中市,東勢區,1545,440,168,608,23,631,1007,62.66%,43.69%,1
臺中市,東勢區,1546,430,184,614,30,644,1214,53.05%,35.42%,1
臺中市,東勢區,1547,363,116,479,41,520,907,57.33%,40.02%,1
臺中市,東勢區,1548,290,160,450,47,497,902,55.1%,32.15%,1
臺中市,東勢區,1549,230,90,320,13,333,720,46.25%,31.94%,1
臺中市,東勢區,1550,222,88,310,11,321,666,48.2%,33.33%,1
臺中市,東勢區,1551,492,208,700,49,749,1361,55.03%,36.15%,1
臺中市,大甲區,0001,532,224,756,60,816,1356,60.18%,39.23%,1
臺中市,大甲區,0002,434,199,633,33,666,1059,62.89%,40.98%,1
臺中市,大甲區,0003,274,147,421,23,444,694,63.98%,39.48%,1
臺中市,大甲區,0004,352,173,525,14,539,874,61.67%,40.27%,1
臺中市,大甲區,0005,285,128,413,16,429,763,56.23%,37.35%,1
臺中市,大甲區,0006,358,166,524,28,552,856,64.49%,41.82%,1
臺中市,大甲區,0007,510,201,711,33,744,1249,59.57%,40.83%,1
臺中市,大甲區,0008,359,147,506,27,533,922,57.81%,38.94%,1
臺中市,大甲區,0009,458,221,679,32,711,1189,59.8%,38.52%,1
臺中市,大甲區,0010,439,192,631,47,678,1065,63.66%,41.22%,1
臺中市,大甲區,0011,545,209,754,54,808,1252,64.54%,43.53%,1
臺中市,大甲區,0012,396,185,581,46,627,1057,59.32%,37.46%,1
臺中市,大甲區,0013,433,162,595,32,627,1031,60.81%,42%,1
臺中市,大甲區,0014,446,195,641,25,666,1060,62.83%,42.08%,1
臺中市,大甲區,0015,505,223,728,40,768,1311,58.58%,38.52%,1
臺中市,大甲區,0016,561,224,785,35,820,1424,57.58%,39.4%,1
臺中市,大甲區,0017,639,292,931,50,981,1670,58.74%,38.26%,1
臺中市,大甲區,0018,333,126,459,28,487,812,59.98%,41.01%,1
臺中市,大甲區,0019,395,140,535,29,564,863,65.35%,45.77%,1
臺中市,大甲區,0020,648,268,916,35,951,1598,59.51%,40.55%,1
臺中市,大甲區,0021,638,230,868,33,901,1588,56.74%,40.18%,1
臺中市,大甲區,0022,446,216,662,50,712,1197,59.48%,37.26%,1
臺中市,大甲區,0023,253,179,432,56,488,1106,44.12%,22.88%,1
臺中市,大甲區,0024,364,168,532,38,570,903,63.12%,40.31%,1
臺中市,大甲區,0025,364,142,506,34,540,869,62.14%,41.89%,1
臺中市,大甲區,0026,547,242,789,29,818,1350,60.59%,40.52%,1
臺中市,大甲區,0027,435,180,615,75,690,1144,60.31%,38.02%,1
臺中市,大甲區,0028,526,189,715,31,746,1208,61.75%,43.54%,1
臺中市,大甲區,0029,586,315,901,38,939,1567,59.92%,37.4%,1
臺中市,大甲區,0030,570,207,777,28,805,1246,64.61%,45.75%,1
臺中市,大甲區,0031,321,129,450,21,471,767,61.41%,41.85%,1
臺中市,大甲區,0032,326,137,463,24,487,790,61.65%,41.27%,1
臺中市,大甲區,0033,424,145,569,40,609,972,62.65%,43.62%,1
臺中市,大甲區,0034,501,227,728,35,763,1388,54.97%,36.1%,1
臺中市,大甲區,0035,468,226,694,25,719,1331,54.02%,35.16%,1
臺中市,大甲區,0036,494,203,697,31,728,1167,62.38%,42.33%,1
臺中市,大甲區,0037,800,310,1110,30,1140,1934,58.95%,41.37%,1
臺中市,大甲區,0038,419,202,621,40,661,1263,52.34%,33.17%,1
臺中市,大甲區,0039,558,216,774,32,806,1390,57.99%,40.14%,1
臺中市,大甲區,0040,407,171,578,32,610,1186,51.43%,34.32%,1
臺中市,大甲區,0041,544,228,772,30,802,1397,57.41%,38.94%,1
臺中市,大甲區,0042,382,157,539,21,560,1173,47.74%,32.57%,1
臺中市,大甲區,0043,482,228,710,63,773,1398,55.29%,34.48%,1
臺中市,大甲區,0044,395,207,602,39,641,1228,52.2%,32.17%,1
臺中市,大甲區,0045,443,208,651,31,682,1258,54.21%,35.21%,1
臺中市,大甲區,0046,497,241,738,42,780,1435,54.36%,34.63%,1
臺中市,大甲區,0047,542,265,807,38,845,1532,55.16%,35.38%,1
臺中市,大甲區,0048,238,113,351,31,382,652,58.59%,36.5%,1
臺中市,大甲區,0049,267,146,413,32,445,870,51.15%,30.69%,1
臺中市,大甲區,0050,313,137,450,29,479,891,53.76%,35.13%,1
臺中市,大甲區,0051,318,119,437,31,468,784,59.69%,40.56%,1
臺中市,大甲區,0052,486,190,676,73,749,1368,54.75%,35.53%,1
臺中市,大甲區,0053,355,193,548,55,603,1126,53.55%,31.53%,1
臺中市,大甲區,0054,440,244,684,53,737,1486,49.6%,29.61%,1
臺中市,清水區,0091,367,192,559,29,588,1076,54.65%,34.11%,1
臺中市,清水區,0092,392,188,580,45,625,953,65.58%,41.13%,1
臺中市,清水區,0093,344,184,528,46,574,914,62.8%,37.64%,1
臺中市,清水區,0094,476,208,684,46,730,1143,63.87%,41.64%,1
臺中市,清水區,0095,255,146,401,24,425,680,62.5%,37.5%,1
臺中市,清水區,0096,371,159,530,35,565,904,62.5%,41.04%,1
臺中市,清水區,0097,361,179,540,42,582,893,65.17%,40.43%,1
臺中市,清水區,0098,590,289,879,39,918,1577,58.21%,37.41%,1
臺中市,清水區,0099,275,110,385,31,416,690,60.29%,39.86%,1
臺中市,清水區,0100,198,33,231,19,250,403,62.03%,49.13%,1
臺中市,清水區,0101,533,268,801,52,853,1413,60.37%,37.72%,1
臺中市,清水區,0102,279,146,425,35,460,777,59.2%,35.91%,1
臺中市,清水區,0103,545,221,766,36,802,1313,61.08%,41.51%,1
臺中市,清水區,0104,589,256,845,48,893,1439,62.06%,40.93%,1
臺中市,清水區,0105,461,217,678,23,701,1265,55.42%,36.44%,1
臺中市,清水區,0106,532,234,766,34,800,1277,62.65%,41.66%,1
臺中市,清水區,0107,526,213,739,35,774,1276,60.66%,41.22%,1
臺中市,清水區,0108,558,277,835,25,860,1376,62.5%,40.55%,1
臺中市,清水區,0109,539,264,803,19,822,1291,63.67%,41.75%,1
臺中市,清水區,0110,590,291,881,43,924,1510,61.19%,39.07%,1
臺中市,清水區,0111,577,267,844,61,905,1524,59.38%,37.86%,1
臺中市,清水區,0112,520,248,768,34,802,1474,54.41%,35.28%,1
臺中市,清水區,0113,582,230,812,46,858,1507,56.93%,38.62%,1
臺中市,清水區,0114,545,260,805,56,861,1321,65.18%,41.26%,1
臺中市,清水區,0115,408,168,576,36,612,1157,52.9%,35.26%,1
臺中市,清水區,0116,437,262,699,40,739,1255,58.88%,34.82%,1
臺中市,清水區,0117,335,150,485,24,509,881,57.78%,38.02%,1
臺中市,清水區,0118,420,201,621,45,666,1083,61.5%,38.78%,1
臺中市,清水區,0119,384,174,558,31,589,951,61.93%,40.38%,1
臺中市,清水區,0120,499,247,746,41,787,1424,55.27%,35.04%,1
臺中市,清水區,0121,416,205,621,57,678,1233,54.99%,33.74%,1
臺中市,清水區,0122,374,214,588,47,635,1288,49.3%,29.04%,1
臺中市,清水區,0123,462,216,678,43,721,1200,60.08%,38.5%,1
臺中市,清水區,0124,723,209,932,36,968,1609,60.16%,44.93%,1
臺中市,清水區,0125,471,237,708,16,724,1136,63.73%,41.46%,1
臺中市,清水區,0126,479,188,667,73,740,1302,56.84%,36.79%,1
臺中市,清水區,0127,485,217,702,80,782,1373,56.96%,35.32%,1
臺中市,清水區,0128,390,203,593,63,656,1257,52.19%,31.03%,1
臺中市,清水區,0129,394,187,581,47,628,1184,53.04%,33.28%,1
臺中市,清水區,0130,497,192,689,59,748,1322,56.58%,37.59%,1
臺中市,清水區,0131,395,198,593,48,641,1193,53.73%,33.11%,1
臺中市,清水區,0132,327,157,484,66,550,927,59.33%,35.28%,1
臺中市,清水區,0133,402,216,618,50,668,1073,62.26%,37.47%,1
臺中市,清水區,0134,457,217,674,55,729,1163,62.68%,39.29%,1
臺中市,清水區,0135,289,138,427,51,478,855,55.91%,33.8%,1
臺中市,清水區,0136,317,140,457,43,500,902,55.43%,35.14%,1
臺中市,清水區,0137,505,268,773,47,820,1415,57.95%,35.69%,1
臺中市,清水區,0138,370,179,549,37,586,1066,54.97%,34.71%,1
臺中市,清水區,0139,495,239,734,57,791,1391,56.87%,35.59%,1
臺中市,清水區,0140,533,198,731,33,764,1449,52.73%,36.78%,1
臺中市,清水區,0141,545,238,783,52,835,1377,60.64%,39.58%,1
臺中市,清水區,0142,545,263,808,42,850,1423,59.73%,38.3%,1
臺中市,清水區,0143,615,281,896,45,941,1624,57.94%,37.87%,1
臺中市,清水區,0144,457,232,689,61,750,1358,55.23%,33.65%,1
臺中市,清水區,0145,546,248,794,62,856,1464,58.47%,37.3%,1
臺中市,清水區,0146,447,244,691,52,743,1211,61.35%,36.91%,1
臺中市,清水區,0147,550,214,764,26,790,1456,54.26%,37.77%,1
臺中市,清水區,0148,503,168,671,58,729,1162,62.74%,43.29%,1
臺中市,清水區,0149,625,201,826,43,869,1368,63.52%,45.69%,1
臺中市,沙鹿區,0186,459,251,710,36,746,1380,54.06%,33.26%,1
臺中市,沙鹿區,0187,338,146,484,38,522,852,61.27%,39.67%,1
臺中市,沙鹿區,0188,500,198,698,33,731,1176,62.16%,42.52%,1
臺中市,沙鹿區,0189,377,220,597,48,645,958,67.33%,39.35%,1
臺中市,沙鹿區,0190,228,85,313,22,335,488,68.65%,46.72%,1
臺中市,沙鹿區,0191,405,247,652,41,693,1177,58.88%,34.41%,1
臺中市,沙鹿區,0192,478,218,696,47,743,1285,57.82%,37.2%,1
臺中市,沙鹿區,0193,597,288,885,61,946,1736,54.49%,34.39%,1
臺中市,沙鹿區,0194,628,308,936,55,991,1628,60.87%,38.57%,1
臺中市,沙鹿區,0195,513,253,766,32,798,1469,54.32%,34.92%,1
臺中市,沙鹿區,0196,564,265,829,44,873,1423,61.35%,39.63%,1
臺中市,沙鹿區,0197,565,228,793,70,863,1444,59.76%,39.13%,1
臺中市,沙鹿區,0198,546,265,811,51,862,1469,58.68%,37.17%,1
臺中市,沙鹿區,0199,684,370,1054,49,1103,1902,57.99%,35.96%,1
臺中市,沙鹿區,0200,640,325,965,28,993,1675,59.28%,38.21%,1
臺中市,沙鹿區,0201,393,195,588,49,637,1098,58.01%,35.79%,1
臺中市,沙鹿區,0202,598,294,892,48,940,1539,61.08%,38.86%,1
臺中市,沙鹿區,0203,540,250,790,21,811,1329,61.02%,40.63%,1
臺中市,沙鹿區,0204,461,214,675,39,714,1255,56.89%,36.73%,1
臺中市,沙鹿區,0205,570,289,859,50,909,1507,60.32%,37.82%,1
臺中市,沙鹿區,0206,555,258,813,55,868,1463,59.33%,37.94%,1
臺中市,沙鹿區,0207,456,192,648,61,709,1279,55.43%,35.65%,1
臺中市,沙鹿區,0208,356,162,518,29,547,1024,53.42%,34.77%,1
臺中市,沙鹿區,0209,497,209,706,52,758,1388,54.61%,35.81%,1
臺中市,沙鹿區,0210,414,209,623,26,649,1074,60.43%,38.55%,1
臺中市,沙鹿區,0211,325,203,528,26,554,1072,51.68%,30.32%,1
臺中市,沙鹿區,0212,460,187,647,42,689,1107,62.24%,41.55%,1
臺中市,沙鹿區,0213,658,290,948,44,992,1947,50.95%,33.8%,1
臺中市,沙鹿區,0214,600,271,871,45,916,1682,54.46%,35.67%,1
臺中市,沙鹿區,0215,516,403,919,38,957,1633,58.6%,31.6%,1
臺中市,沙鹿區,0216,559,226,785,42,827,1533,53.95%,36.46%,1
臺中市,沙鹿區,0217,547,226,773,29,802,1605,49.97%,34.08%,1
臺中市,沙鹿區,0218,602,268,870,31,901,1694,53.19%,35.54%,1
臺中市,沙鹿區,0219,550,275,825,52,877,1628,53.87%,33.78%,1
臺中市,沙鹿區,0220,644,308,952,21,973,1665,58.44%,38.68%,1
臺中市,沙鹿區,0221,588,292,880,30,910,1651,55.12%,35.61%,1
臺中市,沙鹿區,0222,506,176,682,20,702,1108,63.36%,45.67%,1
臺中市,沙鹿區,0223,485,194,679,26,705,1142,61.73%,42.47%,1
臺中市,沙鹿區,0224,403,170,573,32,605,1039,58.23%,38.79%,1
臺中市,沙鹿區,0225,666,306,972,44,1016,1840,55.22%,36.2%,1
臺中市,沙鹿區,0226,682,317,999,40,1039,1872,55.5%,36.43%,1
臺中市,沙鹿區,0227,535,264,799,38,837,1558,53.72%,34.34%,1
臺中市,沙鹿區,0228,607,266,873,33,906,1739,52.1%,34.91%,1
臺中市,沙鹿區,0229,537,270,807,37,844,1672,50.48%,32.12%,1
臺中市,沙鹿區,0230,633,250,883,28,911,1634,55.75%,38.74%,1
臺中市,沙鹿區,0231,540,243,783,46,829,1616,51.3%,33.42%,1
臺中市,沙鹿區,0232,588,293,881,29,910,1593,57.12%,36.91%,1
臺中市,沙鹿區,0233,373,144,517,23,540,981,55.05%,38.02%,1
臺中市,沙鹿區,0234,720,283,1003,43,1046,1740,60.11%,41.38%,1
臺中市,沙鹿區,0235,496,226,722,45,767,1247,61.51%,39.78%,1
臺中市,沙鹿區,0236,457,155,612,18,630,1047,60.17%,43.65%,1
臺中市,沙鹿區,0237,414,185,599,65,664,1119,59.34%,37%,1
臺中市,沙鹿區,0238,396,162,558,14,572,1025,55.8%,38.63%,1
臺中市,梧棲區,0150,551,276,827,52,879,1541,57.04%,35.76%,1
臺中市,梧棲區,0151,570,274,844,42,886,1581,56.04%,36.05%,1
臺中市,梧棲區,0152,387,211,598,43,641,1083,59.19%,35.73%,1
臺中市,梧棲區,0153,340,162,502,27,529,876,60.39%,38.81%,1
臺中市,梧棲區,0154,380,188,568,47,615,1043,58.96%,36.43%,1
臺中市,梧棲區,0155,512,237,749,35,784,1502,52.2%,34.09%,1
臺中市,梧棲區,0156,515,248,763,45,808,1384,58.38%,37.21%,1
臺中市,梧棲區,0157,212,109,321,30,351,517,67.89%,41.01%,1
臺中市,梧棲區,0158,481,207,688,62,750,1169,64.16%,41.15%,1
臺中市,梧棲區,0159,314,183,497,27,524,863,60.72%,36.38%,1
臺中市,梧棲區,0160,424,196,620,24,644,1277,50.43%,33.2%,1
臺中市,梧棲區,0161,613,299,912,35,947,1742,54.36%,35.19%,1
臺中市,梧棲區,0162,461,280,741,51,792,1342,59.02%,34.35%,1
臺中市,梧棲區,0163,649,334,983,47,1030,1767,58.29%,36.73%,1
臺中市,梧棲區,0164,478,257,735,51,786,1542,50.97%,31%,1
臺中市,梧棲區,0165,535,329,864,33,897,1636,54.83%,32.7%,1
臺中市,梧棲區,0166,617,342,959,1,960,1796,53.45%,34.35%,1
臺中市,梧棲區,0167,484,263,747,56,803,1450,55.38%,33.38%,1
臺中市,梧棲區,0168,528,247,775,80,855,1548,55.23%,34.11%,1
臺中市,梧棲區,0169,520,256,776,31,807,1366,59.08%,38.07%,1
臺中市,梧棲區,0170,407,188,595,27,622,955,65.13%,42.62%,1
臺中市,梧棲區,0171,489,181,670,48,718,1305,55.02%,37.47%,1
臺中市,梧棲區,0172,470,235,705,32,737,1239,59.48%,37.93%,1
臺中市,梧棲區,0173,455,170,625,44,669,1079,62%,42.17%,1
臺中市,梧棲區,0174,442,210,652,36,688,1220,56.39%,36.23%,1
臺中市,梧棲區,0175,603,273,876,59,935,1544,60.56%,39.05%,1
臺中市,梧棲區,0176,541,303,844,39,883,1460,60.48%,37.05%,1
臺中市,梧棲區,0177,492,245,737,53,790,1292,61.15%,38.08%,1
臺中市,梧棲區,0178,474,228,702,39,741,1300,57%,36.46%,1
臺中市,梧棲區,0179,538,267,805,34,839,1555,53.95%,34.6%,1
臺中市,梧棲區,0180,366,175,541,38,579,1031,56.16%,35.5%,1
臺中市,梧棲區,0181,443,265,708,57,765,1277,59.91%,34.69%,1
臺中市,梧棲區,0182,353,197,550,32,582,1037,56.12%,34.04%,1
臺中市,梧棲區,0183,445,218,663,52,715,1187,60.24%,37.49%,1
臺中市,梧棲區,0184,498,223,721,54,775,1399,55.4%,35.6%,1
臺中市,梧棲區,0185,424,192,616,31,647,1135,57%,37.36%,1
臺中市,后里區,0357,354,143,497,47,544,852,63.85%,41.55%,1
臺中市,后里區,0358,420,185,605,45,650,1135,57.27%,37%,1
臺中市,后里區,0359,383,160,543,40,583,1079,54.03%,35.5%,1
臺中市,后里區,0360,589,271,860,55,915,1539,59.45%,38.27%,1
臺中市,后里區,0361,560,314,874,53,927,1591,58.27%,35.2%,1
臺中市,后里區,0362,474,215,689,28,717,1376,52.11%,34.45%,1
臺中市,后里區,0363,500,220,720,21,741,1298,57.09%,38.52%,1
臺中市,后里區,0364,541,245,786,64,850,1428,59.52%,37.89%,1
臺中市,后里區,0365,499,244,743,41,784,1178,66.55%,42.36%,1
臺中市,后里區,0366,418,200,618,39,657,1095,60%,38.17%,1
臺中市,后里區,0367,347,175,522,29,551,963,57.22%,36.03%,1
臺中市,后里區,0368,429,210,639,36,675,1163,58.04%,36.89%,1
臺中市,后里區,0369,401,187,588,32,620,1018,60.9%,39.39%,1
臺中市,后里區,0370,366,161,527,27,554,854,64.87%,42.86%,1
臺中市,后里區,0371,529,242,771,45,816,1485,54.95%,35.62%,1
臺中市,后里區,0372,578,243,821,41,862,1355,63.62%,42.66%,1
臺中市,后里區,0373,284,152,436,32,468,840,55.71%,33.81%,1
臺中市,后里區,0374,463,185,648,38,686,1146,59.86%,40.4%,1
臺中市,后里區,0375,670,299,969,57,1026,1669,61.47%,40.14%,1
臺中市,后里區,0376,656,321,977,63,1040,1673,62.16%,39.21%,1
臺中市,后里區,0377,559,281,840,32,872,1493,58.41%,37.44%,1
臺中市,后里區,0378,411,196,607,50,657,1052,62.45%,39.07%,1
臺中市,后里區,0379,324,166,490,18,508,909,55.89%,35.64%,1
臺中市,后里區,0380,427,187,614,58,672,1091,61.59%,39.14%,1
臺中市,后里區,0381,513,241,754,76,830,1342,61.85%,38.23%,1
臺中市,后里區,0382,394,207,601,46,647,1138,56.85%,34.62%,1
臺中市,后里區,0383,377,184,561,30,591,977,60.49%,38.59%,1
臺中市,后里區,0384,529,207,736,37,773,1584,48.8%,33.4%,1
臺中市,后里區,0385,340,159,499,29,528,915,57.7%,37.16%,1
臺中市,后里區,0386,466,222,688,54,742,1225,60.57%,38.04%,1
臺中市,后里區,0387,581,261,842,28,870,1552,56.06%,37.44%,1
臺中市,后里區,0388,604,260,864,22,886,1600,55.38%,37.75%,1
臺中市,后里區,0389,341,160,501,26,527,942,55.94%,36.2%,1
臺中市,后里區,0390,336,162,498,30,528,943,55.99%,35.63%,1
臺中市,后里區,0391,370,160,530,32,562,1055,53.27%,35.07%,1
臺中市,后里區,0392,406,174,580,53,633,1067,59.33%,38.05%,1
臺中市,后里區,0393,477,202,679,37,716,1340,53.43%,35.6%,1
臺中市,神岡區,0482,672,309,981,44,1025,1684,60.87%,39.9%,1
臺中市,神岡區,0483,627,259,886,40,926,1559,59.4%,40.22%,1
臺中市,神岡區,0484,427,186,613,31,644,1095,58.81%,39%,1
臺中市,神岡區,0485,455,215,670,39,709,1044,67.91%,43.58%,1
臺中市,神岡區,0486,583,228,811,46,857,1310,65.42%,44.5%,1
臺中市,神岡區,0487,519,257,776,52,828,1294,63.99%,40.11%,1
臺中市,神岡區,0488,446,203,649,48,697,1143,60.98%,39.02%,1
臺中市,神岡區,0489,416,179,595,43,638,1022,62.43%,40.7%,1
臺中市,神岡區,0490,457,227,684,42,726,1269,57.21%,36.01%,1
臺中市,神岡區,0491,379,138,517,25,542,1085,49.95%,34.93%,1
臺中市,神岡區,0492,374,187,561,35,596,942,63.27%,39.7%,1
臺中市,神岡區,0493,420,227,647,36,683,1154,59.19%,36.4%,1
臺中市,神岡區,0494,512,224,736,57,793,1390,57.05%,36.83%,1
臺中市,神岡區,0495,564,244,808,61,869,1372,63.34%,41.11%,1
臺中市,神岡區,0496,465,241,706,32,738,1328,55.57%,35.02%,1
臺中市,神岡區,0497,399,181,580,25,605,1038,58.29%,38.44%,1
臺中市,神岡區,0498,557,238,795,33,828,1452,57.02%,38.36%,1
臺中市,神岡區,0499,635,287,922,41,963,1551,62.09%,40.94%,1
臺中市,神岡區,0500,543,266,809,57,866,1567,55.26%,34.65%,1
臺中市,神岡區,0501,556,263,819,25,844,1449,58.25%,38.37%,1
臺中市,神岡區,0502,463,180,643,22,665,1246,53.37%,37.16%,1
臺中市,神岡區,0503,570,243,813,41,854,1431,59.68%,39.83%,1
臺中市,神岡區,0504,462,217,679,56,735,1163,63.2%,39.72%,1
臺中市,神岡區,0505,576,285,861,47,908,1402,64.76%,41.08%,1
臺中市,神岡區,0506,505,240,745,28,773,1271,60.82%,39.73%,1
臺中市,神岡區,0507,479,216,695,52,747,1198,62.35%,39.98%,1
臺中市,神岡區,0508,559,216,775,39,814,1312,62.04%,42.61%,1
臺中市,神岡區,0509,595,263,858,60,918,1590,57.74%,37.42%,1
臺中市,神岡區,0510,491,214,705,36,741,1324,55.97%,37.08%,1
臺中市,神岡區,0511,495,256,751,43,794,1415,56.11%,34.98%,1
臺中市,神岡區,0512,669,270,939,21,960,1483,64.73%,45.11%,1
臺中市,神岡區,0513,538,204,742,28,770,1402,54.92%,38.37%,1
臺中市,神岡區,0514,460,229,689,28,717,1275,56.24%,36.08%,1
臺中市,神岡區,0515,462,201,663,44,707,1288,54.89%,35.87%,1
臺中市,神岡區,0516,391,166,557,61,618,1080,57.22%,36.2%,1
臺中市,神岡區,0517,513,231,744,21,765,1344,56.92%,38.17%,1
臺中市,神岡區,0518,412,226,638,32,670,1061,63.15%,38.83%,1
臺中市,神岡區,0519,458,249,707,43,750,1176,63.78%,38.95%,1
臺中市,神岡區,0520,499,233,732,49,781,1244,62.78%,40.11%,1
臺中市,神岡區,0521,581,231,812,44,856,1318,64.95%,44.08%,1
臺中市,神岡區,0522,561,230,791,51,842,1471,57.24%,38.14%,1
臺中市,神岡區,0523,559,255,814,62,876,1323,66.21%,42.25%,1
臺中市,潭子區,0570,536,226,762,44,806,1306,61.72%,41.04%,1
臺中市,潭子區,0571,431,229,660,39,699,1128,61.97%,38.21%,1
臺中市,潭子區,0572,457,247,704,43,747,1159,64.45%,39.43%,1
臺中市,潭子區,0573,635,300,935,61,996,1630,61.1%,38.96%,1
臺中市,潭子區,0574,605,249,854,38,892,1532,58.22%,39.49%,1
臺中市,潭子區,0575,593,277,870,26,896,1677,53.43%,35.36%,1
臺中市,潭子區,0576,598,274,872,43,915,1744,52.47%,34.29%,1
臺中市,潭子區,0577,661,337,998,42,1040,1795,57.94%,36.82%,1
臺中市,潭子區,0578,452,192,644,39,683,1171,58.33%,38.6%,1
臺中市,潭子區,0579,546,245,791,27,818,1427,57.32%,38.26%,1
臺中市,潭子區,0580,674,292,966,45,1011,1709,59.16%,39.44%,1
臺中市,潭子區,0581,656,300,956,36,992,1723,57.57%,38.07%,1
臺中市,潭子區,0582,653,284,937,44,981,1782,55.05%,36.64%,1
臺中市,潭子區,0583,509,229,738,30,768,1407,54.58%,36.18%,1
臺中市,潭子區,0584,685,343,1028,28,1056,1771,59.63%,38.68%,1
臺中市,潭子區,0585,743,291,1034,54,1088,1795,60.61%,41.39%,1
臺中市,潭子區,0586,677,285,962,44,1006,1612,62.41%,42%,1
臺中市,潭子區,0587,710,331,1041,36,1077,1894,56.86%,37.49%,1
臺中市,潭子區,0588,611,327,938,32,970,1689,57.43%,36.18%,1
臺中市,潭子區,0589,553,256,809,27,836,1525,54.82%,36.26%,1
臺中市,潭子區,0590,614,282,896,33,929,1622,57.27%,37.85%,1
臺中市,潭子區,0591,474,210,684,37,721,1200,60.08%,39.5%,1
臺中市,潭子區,0592,509,222,731,17,748,1355,55.2%,37.56%,1
臺中市,潭子區,0593,640,325,965,22,987,1777,55.54%,36.02%,1
臺中市,潭子區,0594,756,299,1055,39,1094,1923,56.89%,39.31%,1
臺中市,潭子區,0595,630,248,878,42,920,1674,54.96%,37.63%,1
臺中市,潭子區,0596,608,259,867,48,915,1451,63.06%,41.9%,1
臺中市,潭子區,0597,556,280,836,41,877,1486,59.02%,37.42%,1
臺中市,潭子區,0598,589,281,870,42,912,1511,60.36%,38.98%,1
臺中市,潭子區,0599,655,302,957,42,999,1666,59.96%,39.32%,1
臺中市,潭子區,0600,649,303,952,39,991,1750,56.63%,37.09%,1
臺中市,潭子區,0601,562,232,794,25,819,1437,56.99%,39.11%,1
臺中市,潭子區,0602,668,287,955,32,987,1735,56.89%,38.5%,1
臺中市,潭子區,0603,622,265,887,29,916,1612,56.82%,38.59%,1
臺中市,潭子區,0604,452,232,684,21,705,1143,61.68%,39.55%,1
臺中市,潭子區,0605,801,338,1139,32,1171,2096,55.87%,38.22%,1
臺中市,潭子區,0606,613,291,904,39,943,1549,60.88%,39.57%,1
臺中市,潭子區,0607,642,278,920,35,955,1573,60.71%,40.81%,1
臺中市,潭子區,0608,616,238,854,25,879,1585,55.46%,38.86%,1
臺中市,潭子區,0609,581,245,826,30,856,1572,54.45%,36.96%,1
臺中市,潭子區,0610,714,309,1023,36,1059,1738,60.93%,41.08%,1
臺中市,潭子區,0611,684,315,999,52,1051,1883,55.82%,36.33%,1
臺中市,潭子區,0612,593,257,850,25,875,1401,62.46%,42.33%,1
臺中市,潭子區,0613,559,238,797,39,836,1352,61.83%,41.35%,1
臺中市,潭子區,0614,827,347,1174,67,1241,2085,59.52%,39.66%,1
臺中市,潭子區,0615,811,369,1180,62,1242,2047,60.67%,39.62%,1
臺中市,潭子區,0616,610,301,911,27,938,1673,56.07%,36.46%,1
臺中市,潭子區,0617,682,367,1049,68,1117,1874,59.61%,36.39%,1
臺中市,潭子區,0618,393,204,597,42,639,1051,60.8%,37.39%,1
臺中市,潭子區,0619,573,303,876,22,898,1674,53.64%,34.23%,1
臺中市,潭子區,0620,692,329,1021,62,1083,1831,59.15%,37.79%,1
臺中市,潭子區,0621,713,344,1057,56,1113,2003,55.57%,35.6%,1
臺中市,潭子區,0622,631,255,886,33,919,1535,59.87%,41.11%,1
臺中市,潭子區,0623,781,305,1086,91,1177,2286,51.49%,34.16%,1
臺中市,潭子區,0624,673,271,944,52,996,1861,53.52%,36.16%,1
臺中市,大雅區,0524,777,347,1124,47,1171,2027,57.77%,38.33%,1
臺中市,大雅區,0525,669,331,1000,47,1047,1967,53.23%,34.01%,1
臺中市,大雅區,0526,704,304,1008,38,1046,1912,54.71%,36.82%,1
臺中市,大雅區,0527,613,299,912,32,944,1537,61.42%,39.88%,1
臺中市,大雅區,0528,597,269,866,32,898,1439,62.4%,41.49%,1
臺中市,大雅區,0529,529,280,809,30,839,1402,59.84%,37.73%,1
臺中市,大雅區,0530,686,381,1067,51,1118,2013,55.54%,34.08%,1
臺中市,大雅區,0531,734,351,1085,42,1127,1917,58.79%,38.29%,1
臺中市,大雅區,0532,708,370,1078,49,1127,2011,56.04%,35.21%,1
臺中市,大雅區,0533,774,302,1076,40,1116,1887,59.14%,41.02%,1
臺中市,大雅區,0534,582,280,862,44,906,1480,61.22%,39.32%,1
臺中市,大雅區,0535,691,314,1005,46,1051,1816,57.87%,38.05%,1
臺中市,大雅區,0536,628,313,941,53,994,1898,52.37%,33.09%,1
臺中市,大雅區,0537,775,314,1089,60,1149,2008,57.22%,38.6%,1
臺中市,大雅區,0538,770,346,1116,40,1156,1976,58.5%,38.97%,1
臺中市,大雅區,0539,639,313,952,29,981,1673,58.64%,38.19%,1
臺中市,大雅區,0540,571,280,851,33,884,1409,62.74%,40.53%,1
臺中市,大雅區,0541,544,271,815,17,832,1382,60.2%,39.36%,1
臺中市,大雅區,0542,637,249,886,48,934,1635,57.13%,38.96%,1
臺中市,大雅區,0543,623,276,899,44,943,1565,60.26%,39.81%,1
臺中市,大雅區,0544,589,226,815,32,847,1528,55.43%,38.55%,1
臺中市,大雅區,0545,727,313,1040,37,1077,1963,54.87%,37.04%,1
臺中市,大雅區,0546,744,342,1086,21,1107,2073,53.4%,35.89%,1
臺中市,大雅區,0547,716,327,1043,56,1099,1984,55.39%,36.09%,1
臺中市,大雅區,0548,617,280,897,35,932,1688,55.21%,36.55%,1
臺中市,大雅區,0549,545,238,783,29,812,1387,58.54%,39.29%,1
臺中市,大雅區,0550,670,297,967,71,1038,1701,61.02%,39.39%,1
臺中市,大雅區,0551,635,275,910,65,975,1721,56.65%,36.9%,1
臺中市,大雅區,0552,628,246,874,36,910,1879,48.43%,33.42%,1
臺中市,大雅區,0553,687,293,980,36,1016,1568,64.8%,43.81%,1
臺中市,大雅區,0554,631,358,989,53,1042,1761,59.17%,35.83%,1
臺中市,大雅區,0555,697,303,1000,73,1073,1752,61.24%,39.78%,1
臺中市,大雅區,0556,496,242,738,32,770,1264,60.92%,39.24%,1
臺中市,大雅區,0557,554,223,777,39,816,1302,62.67%,42.55%,1
臺中市,大雅區,0558,541,247,788,43,831,1449,57.35%,37.34%,1
臺中市,大雅區,0559,645,299,944,59,1003,1621,61.88%,39.79%,1
臺中市,大雅區,0560,637,240,877,58,935,1647,56.77%,38.68%,1
臺中市,大雅區,0561,537,259,796,28,824,1441,57.18%,37.27%,1
臺中市,大雅區,0562,555,258,813,26,839,1460,57.47%,38.01%,1
臺中市,大雅區,0563,740,335,1075,51,1126,1832,61.46%,40.39%,1
臺中市,大雅區,0564,547,261,808,54,862,1371,62.87%,39.9%,1
臺中市,大雅區,0565,515,235,750,16,766,1418,54.02%,36.32%,1
臺中市,大雅區,0566,596,272,868,35,903,1473,61.3%,40.46%,1
臺中市,大雅區,0567,511,236,747,43,790,1335,59.18%,38.28%,1
臺中市,大雅區,0568,726,216,942,55,997,1733,57.53%,41.89%,1
臺中市,大雅區,0569,651,259,910,49,959,1884,50.9%,34.55%,1
臺中市,新社區,1562,413,153,566,25,591,1011,58.46%,40.85%,1
臺中市,新社區,1563,612,82,694,24,718,1195,60.08%,51.21%,1
臺中市,新社區,1564,455,184,639,31,670,1053,63.63%,43.21%,1
臺中市,新社區,1565,299,129,428,22,450,961,46.83%,31.11%,1
臺中市,新社區,1566,352,119,471,13,484,919,52.67%,38.3%,1
臺中市,新社區,1567,597,192,789,51,840,1367,61.45%,43.67%,1
臺中市,新社區,1568,353,149,502,31,533,1010,52.77%,34.95%,1
臺中市,新社區,1569,347,176,523,59,582,1169,49.79%,29.68%,1
臺中市,新社區,1570,366,159,525,42,567,989,57.33%,37.01%,1
臺中市,新社區,1571,352,133,485,25,510,894,57.05%,39.37%,1
臺中市,新社區,1572,419,131,550,28,578,1033,55.95%,40.56%,1
臺中市,新社區,1573,307,142,449,33,482,1058,45.56%,29.02%,1
臺中市,新社區,1574,297,125,422,15,437,845,51.72%,35.15%,1
臺中市,新社區,1575,272,94,366,24,390,576,67.71%,47.22%,1
臺中市,新社區,1576,418,172,590,40,630,1229,51.26%,34.01%,1
臺中市,新社區,1577,263,154,417,17,434,890,48.76%,29.55%,1
臺中市,新社區,1578,271,131,402,20,422,781,54.03%,34.7%,1
臺中市,新社區,1579,450,184,634,47,681,1244,54.74%,36.17%,1
臺中市,新社區,1580,49,20,69,12,81,213,38.03%,23%,1
臺中市,新社區,1581,202,93,295,29,324,676,47.93%,29.88%,1
臺中市,新社區,1582,203,56,259,23,282,585,48.21%,34.7%,1
臺中市,新社區,1583,386,114,500,36,536,938,57.14%,41.15%,1
臺中市,新社區,1584,78,25,103,8,111,224,49.55%,34.82%,1
臺中市,石岡區,1552,484,207,691,39,730,1244,58.68%,38.91%,1
臺中市,石岡區,1553,568,237,805,53,858,1539,55.75%,36.91%,1
臺中市,石岡區,1554,461,204,665,52,717,1202,59.65%,38.35%,1
臺中市,石岡區,1555,434,195,629,68,697,1272,54.8%,34.12%,1
臺中市,石岡區,1556,252,105,357,34,391,652,59.97%,38.65%,1
臺中市,石岡區,1557,592,280,872,81,953,1457,65.41%,40.63%,1
臺中市,石岡區,1558,666,310,976,69,1045,1836,56.92%,36.27%,1
臺中市,石岡區,1559,389,153,542,43,585,1001,58.44%,38.86%,1
臺中市,石岡區,1560,577,267,844,51,895,1448,61.81%,39.85%,1
臺中市,石岡區,1561,501,224,725,41,766,1229,62.33%,40.76%,1
臺中市,外埔區,0071,372,181,553,47,600,1059,56.66%,35.13%,1
臺中市,外埔區,0072,410,177,587,22,609,1013,60.12%,40.47%,1
臺中市,外埔區,0073,478,191,669,49,718,1150,62.43%,41.57%,1
臺中市,外埔區,0074,817,317,1134,47,1181,1855,63.67%,44.04%,1
臺中市,外埔區,0075,547,220,767,35,802,1327,60.44%,41.22%,1
臺中市,外埔區,0076,512,322,834,52,886,1453,60.98%,35.24%,1
臺中市,外埔區,0077,639,237,876,62,938,1653,56.75%,38.66%,1
臺中市,外埔區,0078,612,233,845,32,877,1615,54.3%,37.89%,1
臺中市,外埔區,0079,555,234,789,27,816,1470,55.51%,37.76%,1
臺中市,外埔區,0080,630,261,891,50,941,1559,60.36%,40.41%,1
臺中市,外埔區,0081,709,297,1006,65,1071,1902,56.31%,37.28%,1
臺中市,外埔區,0082,498,201,699,34,733,1138,64.41%,43.76%,1
臺中市,外埔區,0083,457,172,629,53,682,1065,64.04%,42.91%,1
臺中市,外埔區,0084,524,229,753,29,782,1243,62.91%,42.16%,1
臺中市,外埔區,0085,314,173,487,43,530,962,55.09%,32.64%,1
臺中市,外埔區,0086,424,196,620,41,661,1169,56.54%,36.27%,1
臺中市,外埔區,0087,553,211,764,34,798,1216,65.63%,45.48%,1
臺中市,外埔區,0088,548,192,740,51,791,1391,56.87%,39.4%,1
臺中市,外埔區,0089,613,240,853,62,915,1616,56.62%,37.93%,1
臺中市,外埔區,0090,374,177,551,43,594,1203,49.38%,31.09%,1
臺中市,大安區,0055,368,150,518,52,570,1068,53.37%,34.46%,1
臺中市,大安區,0056,390,180,570,47,617,1050,58.76%,37.14%,1
臺中市,大安區,0057,469,226,695,58,753,1246,60.43%,37.64%,1
臺中市,大安區,0058,527,204,731,55,786,1397,56.26%,37.72%,1
臺中市,大安區,0059,496,216,712,54,766,1227,62.43%,40.42%,1
臺中市,大安區,0060,445,191,636,60,696,1170,59.49%,38.03%,1
臺中市,大安區,0061,375,176,551,45,596,914,65.21%,41.03%,1
臺中市,大安區,0062,196,117,313,34,347,667,52.02%,29.39%,1
臺中市,大安區,0063,296,136,432,54,486,890,54.61%,33.26%,1
臺中市,大安區,0064,487,193,680,56,736,1289,57.1%,37.78%,1
臺中市,大安區,0065,151,70,221,21,242,455,53.19%,33.19%,1
臺中市,大安區,0066,402,161,563,36,599,1028,58.27%,39.11%,1
臺中市,大安區,0067,563,244,807,64,871,1446,60.24%,38.93%,1
臺中市,大安區,0068,304,113,417,28,445,688,64.68%,44.19%,1
臺中市,大安區,0069,432,172,604,44,648,1062,61.02%,40.68%,1
臺中市,大安區,0070,372,204,576,40,616,923,66.74%,40.3%,1
臺中市,烏日區,0317,584,306,890,37,927,1480,62.64%,39.46%,1
臺中市,烏日區,0318,720,358,1078,56,1134,1841,61.6%,39.11%,1
臺中市,烏日區,0319,644,321,965,42,1007,1751,57.51%,36.78%,1
臺中市,烏日區,0320,612,285,897,60,957,1547,61.86%,39.56%,1
臺中市,烏日區,0321,739,307,1046,28,1074,1836,58.5%,40.25%,1
臺中市,烏日區,0322,489,268,757,75,832,1239,67.15%,39.47%,1
臺中市,烏日區,0323,468,224,692,51,743,1295,57.37%,36.14%,1
臺中市,烏日區,0324,442,238,680,38,718,1263,56.85%,35%,1
臺中市,烏日區,0325,547,337,884,32,916,1622,56.47%,33.72%,1
臺中市,烏日區,0326,668,304,972,58,1030,1822,56.53%,36.66%,1
臺中市,烏日區,0327,688,365,1053,49,1102,1966,56.05%,34.99%,1
臺中市,烏日區,0328,636,282,918,33,951,1615,58.89%,39.38%,1
臺中市,烏日區,0329,478,250,728,21,749,1232,60.8%,38.8%,1
臺中市,烏日區,0330,496,218,714,34,748,1347,55.53%,36.82%,1
臺中市,烏日區,0331,420,184,604,23,627,1165,53.82%,36.05%,1
臺中市,烏日區,0332,682,294,976,35,1011,1664,60.76%,40.99%,1
臺中市,烏日區,0333,499,230,729,39,768,1230,62.44%,40.57%,1
臺中市,烏日區,0334,656,286,942,56,998,1574,63.41%,41.68%,1
臺中市,烏日區,0335,621,276,897,25,922,1452,63.5%,42.77%,1
臺中市,烏日區,0336,711,282,993,35,1028,1879,54.71%,37.84%,1
臺中市,烏日區,0337,620,277,897,35,932,1601,58.21%,38.73%,1
臺中市,烏日區,0338,634,297,931,26,957,1546,61.9%,41.01%,1
臺中市,烏日區,0339,697,279,976,38,1014,1866,54.34%,37.35%,1
臺中市,烏日區,0340,767,347,1114,43,1157,1938,59.7%,39.58%,1
臺中市,烏日區,0341,650,324,974,37,1011,1759,57.48%,36.95%,1
臺中市,烏日區,0342,735,358,1093,59,1152,2061,55.9%,35.66%,1
臺中市,烏日區,0343,681,290,971,32,1003,1691,59.31%,40.27%,1
臺中市,烏日區,0344,451,199,650,32,682,1039,65.64%,43.41%,1
臺中市,烏日區,0345,525,208,733,33,766,1221,62.74%,43%,1
臺中市,烏日區,0346,634,324,958,52,1010,1650,61.21%,38.42%,1
臺中市,烏日區,0347,354,175,529,33,562,937,59.98%,37.78%,1
臺中市,烏日區,0348,461,239,700,29,729,1220,59.75%,37.79%,1
臺中市,烏日區,0349,734,324,1058,92,1150,2139,53.76%,34.32%,1
臺中市,烏日區,0350,677,170,847,44,891,1371,64.99%,49.38%,1
臺中市,烏日區,0351,483,221,704,46,750,1277,58.73%,37.82%,1
臺中市,烏日區,0352,594,308,902,48,950,1708,55.62%,34.78%,1
臺中市,烏日區,0353,779,312,1091,55,1146,2048,55.96%,38.04%,1
臺中市,烏日區,0354,558,301,859,55,914,1632,56%,34.19%,1
臺中市,烏日區,0355,517,235,752,57,809,1327,60.96%,38.96%,1
臺中市,烏日區,0356,300,148,448,39,487,854,57.03%,35.13%,1
臺中市,大肚區,0284,535,222,757,52,809,1415,57.17%,37.81%,1
臺中市,大肚區,0285,472,233,705,43,748,1392,53.74%,33.91%,1
臺中市,大肚區,0286,605,265,870,52,922,1520,60.66%,39.8%,1
臺中市,大肚區,0287,371,166,537,47,584,862,67.75%,43.04%,1
臺中市,大肚區,0288,532,201,733,47,780,1256,62.1%,42.36%,1
臺中市,大肚區,0289,486,213,699,49,748,1292,57.89%,37.62%,1
臺中市,大肚區,0290,401,179,580,39,619,1010,61.29%,39.7%,1
臺中市,大肚區,0291,576,274,850,68,918,1485,61.82%,38.79%,1
臺中市,大肚區,0292,514,201,715,53,768,1190,64.54%,43.19%,1
臺中市,大肚區,0293,461,225,686,60,746,1250,59.68%,36.88%,1
臺中市,大肚區,0294,499,220,719,61,780,1310,59.54%,38.09%,1
臺中市,大肚區,0295,466,217,683,55,738,1294,57.03%,36.01%,1
臺中市,大肚區,0296,745,304,1049,49,1098,1734,63.32%,42.96%,1
臺中市,大肚區,0297,484,220,704,50,754,1316,57.29%,36.78%,1
臺中市,大肚區,0298,299,179,478,32,510,854,59.72%,35.01%,1
臺中市,大肚區,0299,516,268,784,36,820,1273,64.41%,40.53%,1
臺中市,大肚區,0300,361,143,504,33,537,851,63.1%,42.42%,1
臺中市,大肚區,0301,633,239,872,41,913,1629,56.05%,38.86%,1
臺中市,大肚區,0302,625,266,891,73,964,1709,56.41%,36.57%,1
臺中市,大肚區,0303,338,147,485,38,523,953,54.88%,35.47%,1
臺中市,大肚區,0304,548,226,774,38,812,1336,60.78%,41.02%,1
臺中市,大肚區,0305,710,371,1081,64,1145,2113,54.19%,33.6%,1
臺中市,大肚區,0306,651,299,950,73,1023,1730,59.13%,37.63%,1
臺中市,大肚區,0307,634,297,931,23,954,1692,56.38%,37.47%,1
臺中市,大肚區,0308,639,328,967,47,1014,1747,58.04%,36.58%,1
臺中市,大肚區,0309,634,269,903,58,961,1672,57.48%,37.92%,1
臺中市,大肚區,0310,594,289,883,40,923,1675,55.1%,35.46%,1
臺中市,大肚區,0311,654,265,919,43,962,1673,57.5%,39.09%,1
臺中市,大肚區,0312,649,297,946,35,981,1636,59.96%,39.67%,1
臺中市,大肚區,0313,627,269,896,63,959,1753,54.71%,35.77%,1
臺中市,大肚區,0314,483,214,697,23,720,1343,53.61%,35.96%,1
臺中市,大肚區,0315,682,301,983,49,1032,1822,56.64%,37.43%,1
臺中市,大肚區,0316,694,256,950,82,1032,1670,61.8%,41.56%,1
臺中市,龍井區,0239,589,401,990,64,1054,1758,59.95%,33.5%,1
臺中市,龍井區,0240,502,191,693,40,733,1275,57.49%,39.37%,1
臺中市,龍井區,0241,462,206,668,29,697,1379,50.54%,33.5%,1
臺中市,龍井區,0242,696,23,719,34,753,1403,53.67%,49.61%,1
臺中市,龍井區,0243,371,167,538,34,572,974,58.73%,38.09%,1
臺中市,龍井區,0244,366,181,547,33,580,901,64.37%,40.62%,1
臺中市,龍井區,0245,614,314,928,66,994,1779,55.87%,34.51%,1
臺中市,龍井區,0246,580,331,911,47,958,1609,59.54%,36.05%,1
臺中市,龍井區,0247,373,154,527,21,548,1038,52.79%,35.93%,1
臺中市,龍井區,0248,509,236,745,61,806,1328,60.69%,38.33%,1
臺中市,龍井區,0249,360,176,536,36,572,921,62.11%,39.09%,1
臺中市,龍井區,0250,535,255,790,55,845,1609,52.52%,33.25%,1
臺中市,龍井區,0251,388,192,580,33,613,1227,49.96%,31.62%,1
臺中市,龍井區,0252,473,192,665,64,729,1278,57.04%,37.01%,1
臺中市,龍井區,0253,263,147,410,16,426,914,46.61%,28.77%,1
臺中市,龍井區,0254,523,261,784,37,821,1678,48.93%,31.17%,1
臺中市,龍井區,0255,394,211,605,34,639,1233,51.82%,31.95%,1
臺中市,龍井區,0256,548,260,808,52,860,1520,56.58%,36.05%,1
臺中市,龍井區,0257,674,282,956,47,1003,1905,52.65%,35.38%,1
臺中市,龍井區,0258,741,115,856,56,912,1520,60%,48.75%,1
臺中市,龍井區,0259,496,197,693,57,750,1385,54.15%,35.81%,1
臺中市,龍井區,0260,411,232,643,32,675,1212,55.69%,33.91%,1
臺中市,龍井區,0261,567,237,804,23,827,1432,57.75%,39.59%,1
臺中市,龍井區,0262,615,258,873,34,907,1663,54.54%,36.98%,1
臺中市,龍井區,0263,498,231,729,36,765,1422,53.8%,35.02%,1
臺中市,龍井區,0264,520,200,720,96,816,1616,50.5%,32.18%,1
臺中市,龍井區,0265,554,244,798,50,848,1422,59.63%,38.96%,1
臺中市,龍井區,0266,461,210,671,26,697,1165,59.83%,39.57%,1
臺中市,龍井區,0267,571,317,888,12,900,1624,55.42%,35.16%,1
臺中市,龍井區,0268,612,260,872,37,909,1613,56.35%,37.94%,1
臺中市,龍井區,0269,399,163,562,31,593,943,62.88%,42.31%,1
臺中市,龍井區,0270,566,239,805,61,866,1595,54.29%,35.49%,1
臺中市,龍井區,0271,574,265,839,50,889,1508,58.95%,38.06%,1
臺中市,龍井區,0272,528,255,783,27,810,1479,54.77%,35.7%,1
臺中市,龍井區,0273,585,266,851,31,882,1509,58.45%,38.77%,1
臺中市,龍井區,0274,662,277,939,45,984,1582,62.2%,41.85%,1
臺中市,龍井區,0275,641,299,940,40,980,1725,56.81%,37.16%,1
臺中市,龍井區,0276,649,253,902,37,939,1616,58.11%,40.16%,1
臺中市,龍井區,0277,645,313,958,36,994,1657,59.99%,38.93%,1
臺中市,龍井區,0278,620,378,998,33,1031,1774,58.12%,34.95%,1
臺中市,龍井區,0279,621,368,989,46,1035,1701,60.85%,36.51%,1
臺中市,龍井區,0280,412,221,633,32,665,1121,59.32%,36.75%,1
臺中市,龍井區,0281,395,198,593,28,621,987,62.92%,40.02%,1
臺中市,龍井區,0282,443,231,674,38,712,1206,59.04%,36.73%,1
臺中市,龍井區,0283,549,266,815,33,848,1378,61.54%,39.84%,1
臺中市,霧峰區,1470,490,225,715,35,750,1205,62.24%,40.66%,1
臺中市,霧峰區,1471,608,288,896,36,932,1620,57.53%,37.53%,1
臺中市,霧峰區,1472,610,300,910,59,969,1559,62.16%,39.13%,1
臺中市,霧峰區,1473,633,269,902,53,955,1660,57.53%,38.13%,1
臺中市,霧峰區,1474,646,297,943,45,988,1602,61.67%,40.32%,1
臺中市,霧峰區,1475,494,206,700,36,736,1325,55.55%,37.28%,1
臺中市,霧峰區,1476,618,224,842,51,893,1515,58.94%,40.79%,1
臺中市,霧峰區,1477,569,255,824,56,880,1561,56.37%,36.45%,1
臺中市,霧峰區,1478,629,253,882,40,922,1691,54.52%,37.2%,1
臺中市,霧峰區,1479,555,264,819,40,859,1486,57.81%,37.35%,1
臺中市,霧峰區,1480,418,169,587,30,617,975,63.28%,42.87%,1
臺中市,霧峰區,1481,596,214,810,37,847,1358,62.37%,43.89%,1
臺中市,霧峰區,1482,506,228,734,27,761,1141,66.7%,44.35%,1
臺中市,霧峰區,1483,394,91,485,32,517,855,60.47%,46.08%,1
臺中市,霧峰區,1484,474,201,675,46,721,1202,59.98%,39.43%,1
臺中市,霧峰區,1485,397,176,573,41,614,1078,56.96%,36.83%,1
臺中市,霧峰區,1486,564,282,846,55,901,1456,61.88%,38.74%,1
臺中市,霧峰區,1487,627,297,924,38,962,1573,61.16%,39.86%,1
臺中市,霧峰區,1488,646,255,901,42,943,1591,59.27%,40.6%,1
臺中市,霧峰區,1489,528,213,741,42,783,1214,64.5%,43.49%,1
臺中市,霧峰區,1490,463,225,688,42,730,1267,57.62%,36.54%,1
臺中市,霧峰區,1491,487,229,716,46,762,1277,59.67%,38.14%,1
臺中市,霧峰區,1492,515,237,752,38,790,1366,57.83%,37.7%,1
臺中市,霧峰區,1493,430,217,647,42,689,994,69.32%,43.26%,1
臺中市,霧峰區,1494,348,181,529,21,550,863,63.73%,40.32%,1
臺中市,霧峰區,1495,464,224,688,45,733,1274,57.54%,36.42%,1
臺中市,霧峰區,1496,420,212,632,53,685,1162,58.95%,36.14%,1
臺中市,霧峰區,1497,495,212,707,70,777,1252,62.06%,39.54%,1
臺中市,霧峰區,1498,512,231,743,45,788,1322,59.61%,38.73%,1
臺中市,霧峰區,1499,442,222,664,48,712,1116,63.8%,39.61%,1
臺中市,霧峰區,1500,433,246,679,55,734,1156,63.49%,37.46%,1
臺中市,霧峰區,1501,527,170,697,36,733,1147,63.91%,45.95%,1
臺中市,霧峰區,1502,407,179,586,44,630,928,67.89%,43.86%,1
臺中市,霧峰區,1503,486,209,695,38,733,1296,56.56%,37.5%,1
臺中市,霧峰區,1504,416,232,648,69,717,1314,54.57%,31.66%,1
臺中市,霧峰區,1505,636,109,745,70,815,1328,61.37%,47.89%,1
臺中市,霧峰區,1506,355,102,457,135,592,989,59.86%,35.89%,1
臺中市,霧峰區,1507,440,189,629,58,687,1088,63.14%,40.44%,1
臺中市,霧峰區,1508,595,219,814,85,899,1363,65.96%,43.65%,1
臺中市,霧峰區,1509,650,272,922,43,965,1573,61.35%,41.32%,1
臺中市,霧峰區,1510,430,186,616,44,660,1117,59.09%,38.5%,1
臺中市,霧峰區,1511,581,230,811,60,871,1342,64.9%,43.29%,1
臺中市,霧峰區,1512,419,197,616,69,685,1024,66.89%,40.92%,1
臺中市,太平區,1271,640,312,952,46,998,1821,54.81%,35.15%,1
臺中市,太平區,1272,585,266,851,35,886,1680,52.74%,34.82%,1
臺中市,太平區,1273,734,334,1068,63,1131,1947,58.09%,37.7%,1
臺中市,太平區,1274,799,299,1098,46,1144,1910,59.9%,41.83%,1
臺中市,太平區,1275,660,323,983,31,1014,1894,53.54%,34.85%,1
臺中市,太平區,1276,698,336,1034,45,1079,1953,55.25%,35.74%,1
臺中市,太平區,1277,711,308,1019,43,1062,1846,57.53%,38.52%,1
臺中市,太平區,1278,619,238,857,27,884,1493,59.21%,41.46%,1
臺中市,太平區,1279,613,250,863,33,896,1605,55.83%,38.19%,1
臺中市,太平區,1280,690,263,953,34,987,1619,60.96%,42.62%,1
臺中市,太平區,1281,744,315,1059,55,1114,2011,55.4%,37%,1
臺中市,太平區,1282,753,345,1098,25,1123,2056,54.62%,36.62%,1
臺中市,太平區,1283,658,317,975,51,1026,1876,54.69%,35.07%,1
臺中市,太平區,1284,666,276,942,48,990,1815,54.55%,36.69%,1
臺中市,太平區,1285,477,220,697,29,726,1281,56.67%,37.24%,1
臺中市,太平區,1286,418,196,614,36,650,1004,64.74%,41.63%,1
臺中市,太平區,1287,733,329,1062,59,1121,1886,59.44%,38.87%,1
臺中市,太平區,1288,568,229,797,67,864,1431,60.38%,39.69%,1
臺中市,太平區,1289,666,344,1010,52,1062,1930,55.03%,34.51%,1
臺中市,太平區,1290,718,367,1085,44,1129,2164,52.17%,33.18%,1
臺中市,太平區,1291,761,313,1074,42,1116,2048,54.49%,37.16%,1
臺中市,太平區,1292,736,97,833,51,884,2035,43.44%,36.17%,1
臺中市,太平區,1293,585,294,879,57,936,1685,55.55%,34.72%,1
臺中市,太平區,1294,692,331,1023,61,1084,2185,49.61%,31.67%,1
臺中市,太平區,1295,429,188,617,30,647,1176,55.02%,36.48%,1
臺中市,太平區,1296,578,274,852,25,877,1597,54.92%,36.19%,1
臺中市,太平區,1297,470,219,689,63,752,1378,54.57%,34.11%,1
臺中市,太平區,1298,580,258,838,29,867,1546,56.08%,37.52%,1
臺中市,太平區,1299,600,318,918,43,961,1890,50.85%,31.75%,1
臺中市,太平區,1300,398,162,560,37,597,1053,56.7%,37.8%,1
臺中市,太平區,1301,629,265,894,63,957,1582,60.49%,39.76%,1
臺中市,太平區,1302,689,273,962,40,1002,1699,58.98%,40.55%,1
臺中市,太平區,1303,505,300,805,46,851,1493,57%,33.82%,1
臺中市,太平區,1304,409,183,592,43,635,1063,59.74%,38.48%,1
臺中市,太平區,1305,474,171,645,37,682,1117,61.06%,42.44%,1
臺中市,太平區,1306,437,179,616,38,654,1084,60.33%,40.31%,1
臺中市,太平區,1307,581,313,894,33,927,1776,52.2%,32.71%,1
臺中市,太平區,1308,628,266,894,45,939,1729,54.31%,36.32%,1
臺中市,太平區,1309,566,228,794,47,841,1658,50.72%,34.14%,1
臺中市,太平區,1310,748,294,1042,40,1082,2010,53.83%,37.21%,1
臺中市,太平區,1311,601,288,889,47,936,1752,53.42%,34.3%,1
臺中市,太平區,1312,676,271,947,53,1000,1654,60.46%,40.87%,1
臺中市,太平區,1313,525,246,771,24,795,1951,40.75%,26.91%,1
臺中市,太平區,1314,793,415,1208,62,1270,2170,58.53%,36.54%,1
臺中市,太平區,1315,803,501,1304,61,1365,2231,61.18%,35.99%,1
臺中市,太平區,1316,644,270,914,40,954,1623,58.78%,39.68%,1
臺中市,太平區,1317,546,215,761,27,788,1548,50.9%,35.27%,1
臺中市,太平區,1318,519,225,744,52,796,1442,55.2%,35.99%,1
臺中市,太平區,1319,507,218,725,27,752,1501,50.1%,33.78%,1
臺中市,太平區,1320,651,333,984,28,1012,2025,49.98%,32.15%,1
臺中市,太平區,1321,671,306,977,38,1015,1885,53.85%,35.6%,1
臺中市,太平區,1322,686,338,1024,41,1065,2155,49.42%,31.83%,1
臺中市,太平區,1323,600,294,894,31,925,1775,52.11%,33.8%,1
臺中市,太平區,1324,607,273,880,62,942,2021,46.61%,30.03%,1
臺中市,太平區,1325,792,345,1137,64,1201,2075,57.88%,38.17%,1
臺中市,太平區,1326,567,295,862,40,902,1723,52.35%,32.91%,1
臺中市,太平區,1327,767,346,1113,31,1144,2049,55.83%,37.43%,1
臺中市,太平區,1328,526,232,758,22,780,1415,55.12%,37.17%,1
臺中市,太平區,1329,686,303,989,21,1010,1778,56.81%,38.58%,1
臺中市,太平區,1330,581,285,866,41,907,1706,53.17%,34.06%,1
臺中市,太平區,1331,743,364,1107,31,1138,2090,54.45%,35.55%,1
臺中市,太平區,1332,686,323,1009,36,1045,2093,49.93%,32.78%,1
臺中市,太平區,1333,578,234,812,30,842,1688,49.88%,34.24%,1
臺中市,太平區,1334,484,249,733,20,753,1488,50.6%,32.53%,1
臺中市,太平區,1335,639,305,944,37,981,1667,58.85%,38.33%,1
臺中市,太平區,1336,612,253,865,46,911,1793,50.81%,34.13%,1
臺中市,太平區,1337,703,358,1061,27,1088,1903,57.17%,36.94%,1
臺中市,太平區,1338,729,259,988,42,1030,1834,56.16%,39.75%,1
臺中市,太平區,1339,570,237,807,36,843,1526,55.24%,37.35%,1
臺中市,太平區,1340,594,321,915,16,931,1483,62.78%,40.05%,1
臺中市,太平區,1341,621,319,940,25,965,1694,56.97%,36.66%,1
臺中市,太平區,1342,662,301,963,20,983,1952,50.36%,33.91%,1
臺中市,太平區,1343,717,343,1060,38,1098,1995,55.04%,35.94%,1
臺中市,太平區,1344,491,250,741,21,762,1311,58.12%,37.45%,1
臺中市,太平區,1345,614,374,988,30,1018,1537,66.23%,39.95%,1
臺中市,太平區,1346,641,291,932,52,984,1974,49.85%,32.47%,1
臺中市,太平區,1347,648,354,1002,39,1041,1828,56.95%,35.45%,1
臺中市,太平區,1348,696,375,1071,26,1097,2191,50.07%,31.77%,1
臺中市,太平區,1349,689,238,927,56,983,1825,53.86%,37.75%,1
臺中市,太平區,1350,568,241,809,12,821,1559,52.66%,36.43%,1
臺中市,太平區,1351,457,191,648,46,694,1225,56.65%,37.31%,1
臺中市,太平區,1352,629,257,886,53,939,1678,55.96%,37.49%,1
臺中市,太平區,1353,492,243,735,67,802,1501,53.43%,32.78%,1
臺中市,太平區,1354,623,261,884,38,922,1450,63.59%,42.97%,1
臺中市,太平區,1355,732,338,1070,56,1126,2126,52.96%,34.43%,1
臺中市,太平區,1356,307,103,410,40,450,699,64.38%,43.92%,1
臺中市,太平區,1357,457,261,718,36,754,1428,52.8%,32%,1
臺中市,太平區,1358,593,326,919,57,976,1666,58.58%,35.59%,1
臺中市,太平區,1359,482,218,700,25,725,1241,58.42%,38.84%,1
臺中市,太平區,1360,485,235,720,62,782,1266,61.77%,38.31%,1
臺中市,太平區,1361,481,155,636,34,670,1166,57.46%,41.25%,1
臺中市,太平區,1362,688,304,992,57,1049,1790,58.6%,38.44%,1
臺中市,太平區,1363,555,223,778,37,815,1754,46.47%,31.64%,1
臺中市,大里區,1364,584,239,823,28,851,1614,52.73%,36.18%,1
臺中市,大里區,1365,545,265,810,24,834,1599,52.16%,34.08%,1
臺中市,大里區,1366,550,282,832,44,876,1715,51.08%,32.07%,1
臺中市,大里區,1367,517,205,722,27,749,1264,59.26%,40.9%,1
臺中市,大里區,1368,476,258,734,25,759,1416,53.6%,33.62%,1
臺中市,大里區,1369,429,200,629,31,660,1188,55.56%,36.11%,1
臺中市,大里區,1370,493,222,715,40,755,1359,55.56%,36.28%,1
臺中市,大里區,1371,535,259,794,53,847,1457,58.13%,36.72%,1
臺中市,大里區,1372,531,251,782,52,834,1403,59.44%,37.85%,1
臺中市,大里區,1373,635,289,924,38,962,1697,56.69%,37.42%,1
臺中市,大里區,1374,697,325,1022,63,1085,1811,59.91%,38.49%,1
臺中市,大里區,1375,649,199,848,44,892,1830,48.74%,35.46%,1
臺中市,大里區,1376,633,297,930,46,976,2228,43.81%,28.41%,1
臺中市,大里區,1377,728,309,1037,42,1079,1997,54.03%,36.45%,1
臺中市,大里區,1378,853,423,1276,26,1302,2033,64.04%,41.96%,1
臺中市,大里區,1379,722,381,1103,15,1118,1835,60.93%,39.35%,1
臺中市,大里區,1380,468,240,708,32,740,1268,58.36%,36.91%,1
臺中市,大里區,1381,640,274,914,39,953,1645,57.93%,38.91%,1
臺中市,大里區,1382,655,289,944,17,961,1561,61.56%,41.96%,1
臺中市,大里區,1383,569,259,828,25,853,1301,65.56%,43.74%,1
臺中市,大里區,1384,503,250,753,43,796,1621,49.11%,31.03%,1
臺中市,大里區,1385,640,287,927,47,974,1797,54.2%,35.61%,1
臺中市,大里區,1386,463,205,668,19,687,1230,55.85%,37.64%,1
臺中市,大里區,1387,569,211,780,36,816,1488,54.84%,38.24%,1
臺中市,大里區,1388,498,262,760,46,806,1459,55.24%,34.13%,1
臺中市,大里區,1389,622,287,909,34,943,1647,57.26%,37.77%,1
臺中市,大里區,1390,447,210,657,36,693,1100,63%,40.64%,1
臺中市,大里區,1391,536,238,774,40,814,1410,57.73%,38.01%,1
臺中市,大里區,1392,660,258,918,39,957,1807,52.96%,36.52%,1
臺中市,大里區,1393,485,243,728,31,759,1331,57.02%,36.44%,1
臺中市,大里區,1394,636,312,948,24,972,1801,53.97%,35.31%,1
臺中市,大里區,1395,637,311,948,31,979,1909,51.28%,33.37%,1
臺中市,大里區,1396,564,279,843,31,874,1699,51.44%,33.2%,1
臺中市,大里區,1397,631,273,904,33,937,1627,57.59%,38.78%,1
臺中市,大里區,1398,664,340,1004,43,1047,1912,54.76%,34.73%,1
臺中市,大里區,1399,638,259,897,48,945,1753,53.91%,36.39%,1
臺中市,大里區,1400,635,244,879,20,899,1602,56.12%,39.64%,1
臺中市,大里區,1401,395,218,613,41,654,1144,57.17%,34.53%,1
臺中市,大里區,1402,645,275,920,60,980,1655,59.21%,38.97%,1
臺中市,大里區,1403,506,273,779,28,807,1438,56.12%,35.19%,1
臺中市,大里區,1404,363,199,562,35,597,1000,59.7%,36.3%,1
臺中市,大里區,1405,619,298,917,45,962,1711,56.22%,36.18%,1
臺中市,大里區,1406,649,285,934,12,946,1698,55.71%,38.22%,1
臺中市,大里區,1407,694,313,1007,62,1069,1914,55.85%,36.26%,1
臺中市,大里區,1408,534,284,818,39,857,1465,58.5%,36.45%,1
臺中市,大里區,1409,597,255,852,52,904,1581,57.18%,37.76%,1
臺中市,大里區,1410,602,278,880,45,925,1509,61.3%,39.89%,1
臺中市,大里區,1411,594,242,836,24,860,1570,54.78%,37.83%,1
臺中市,大里區,1412,501,298,799,31,830,1425,58.25%,35.16%,1
臺中市,大里區,1413,522,257,779,45,824,1384,59.54%,37.72%,1
臺中市,大里區,1414,393,185,578,31,609,1204,50.58%,32.64%,1
臺中市,大里區,1415,607,258,865,36,901,1761,51.16%,34.47%,1
臺中市,大里區,1416,491,205,696,27,723,1473,49.08%,33.33%,1
臺中市,大里區,1417,647,267,914,40,954,1675,56.96%,38.63%,1
臺中市,大里區,1418,683,278,961,33,994,1755,56.64%,38.92%,1
臺中市,大里區,1419,624,275,899,56,955,1593,59.95%,39.17%,1
臺中市,大里區,1420,639,307,946,55,1001,1799,55.64%,35.52%,1
臺中市,大里區,1421,581,277,858,55,913,1606,56.85%,36.18%,1
臺中市,大里區,1422,652,340,992,33,1025,1875,54.67%,34.77%,1
臺中市,大里區,1423,617,304,921,40,961,1670,57.54%,36.95%,1
臺中市,大里區,1424,675,325,1000,48,1048,1898,55.22%,35.56%,1
臺中市,大里區,1425,597,284,881,31,912,1679,54.32%,35.56%,1
臺中市,大里區,1426,481,228,709,46,755,1373,54.99%,35.03%,1
臺中市,大里區,1427,510,211,721,30,751,1299,57.81%,39.26%,1
臺中市,大里區,1428,525,257,782,30,812,1430,56.78%,36.71%,1
臺中市,大里區,1429,755,352,1107,37,1144,1805,63.38%,41.83%,1
臺中市,大里區,1430,743,415,1158,23,1181,1806,65.39%,41.14%,1
臺中市,大里區,1431,804,359,1163,29,1192,1826,65.28%,44.03%,1
臺中市,大里區,1432,801,353,1154,25,1179,1805,65.32%,44.38%,1
臺中市,大里區,1433,751,374,1125,28,1153,1907,60.46%,39.38%,1
臺中市,大里區,1434,477,198,675,22,697,1103,63.19%,43.25%,1
臺中市,大里區,1435,543,211,754,35,789,1419,55.6%,38.27%,1
臺中市,大里區,1436,598,179,777,45,822,1434,57.32%,41.7%,1
臺中市,大里區,1437,655,290,945,27,972,1875,51.84%,34.93%,1
臺中市,大里區,1438,668,335,1003,37,1040,1862,55.85%,35.88%,1
臺中市,大里區,1439,673,307,980,34,1014,1850,54.81%,36.38%,1
臺中市,大里區,1440,606,285,891,39,930,1622,57.34%,37.36%,1
臺中市,大里區,1441,683,296,979,44,1023,1638,62.45%,41.7%,1
臺中市,大里區,1442,681,289,970,53,1023,1633,62.65%,41.7%,1
臺中市,大里區,1443,604,329,933,29,962,1662,57.88%,36.34%,1
臺中市,大里區,1444,699,414,1113,21,1134,1917,59.15%,36.46%,1
臺中市,大里區,1445,576,269,845,58,903,1701,53.09%,33.86%,1
臺中市,大里區,1446,540,268,808,35,843,1549,54.42%,34.86%,1
臺中市,大里區,1447,658,264,922,24,946,1567,60.37%,41.99%,1
臺中市,大里區,1448,614,278,892,34,926,1614,57.37%,38.04%,1
臺中市,大里區,1449,703,308,1011,58,1069,1811,59.03%,38.82%,1
臺中市,大里區,1450,490,245,735,29,764,1336,57.19%,36.68%,1
臺中市,大里區,1451,672,264,936,41,977,1759,55.54%,38.2%,1
臺中市,大里區,1452,614,295,909,41,950,1783,53.28%,34.44%,1
臺中市,大里區,1453,597,258,855,31,886,1736,51.04%,34.39%,1
臺中市,大里區,1454,741,297,1038,35,1073,1874,57.26%,39.54%,1
臺中市,大里區,1455,717,330,1047,41,1088,1889,57.6%,37.96%,1
臺中市,大里區,1456,767,272,1039,52,1091,1947,56.03%,39.39%,1
臺中市,大里區,1457,776,329,1105,28,1133,1938,58.46%,40.04%,1
臺中市,大里區,1458,656,309,965,60,1025,1836,55.83%,35.73%,1
臺中市,大里區,1459,720,292,1012,47,1059,1913,55.36%,37.64%,1
臺中市,大里區,1460,670,284,954,67,1021,1913,53.37%,35.02%,1
臺中市,大里區,1461,717,255,972,36,1008,1937,52.04%,37.02%,1
臺中市,大里區,1462,578,228,806,17,823,1508,54.58%,38.33%,1
臺中市,大里區,1463,547,235,782,33,815,1340,60.82%,40.82%,1
臺中市,大里區,1464,649,284,933,34,967,1656,58.39%,39.19%,1
臺中市,大里區,1465,488,203,691,26,717,1290,55.58%,37.83%,1
臺中市,大里區,1466,604,284,888,31,919,1655,55.53%,36.5%,1
臺中市,大里區,1467,426,202,628,17,645,1260,51.19%,33.81%,1
臺中市,大里區,1468,76,53,129,23,152,1247,12.19%,6.09%,1
臺中市,大里區,1469,563,264,827,42,869,1548,56.14%,36.37%,1
臺中市,和平區,1585,395,184,579,39,618,956,64.64%,41.32%,1
臺中市,和平區,1586,432,153,585,43,628,963,65.21%,44.86%,1
臺中市,和平區,1587,167,91,258,14,272,456,59.65%,36.62%,1
臺中市,和平區,1588,484,141,625,37,662,1011,65.48%,47.87%,1
臺中市,和平區,1589,271,89,360,23,383,636,60.22%,42.61%,1
臺中市,和平區,1590,101,32,133,4,137,270,50.74%,37.41%,1
臺中市,和平區,1591,258,69,327,30,357,460,77.61%,56.09%,1
臺中市,和平區,1592,163,68,231,11,242,321,75.39%,50.78%,1
臺中市,和平區,1593,337,150,487,27,514,783,65.64%,43.04%,1
臺中市,和平區,1594,137,60,197,16,213,336,63.39%,40.77%,1
臺中市,和平區,1595,219,88,307,9,316,451,70.07%,48.56%,1
臺中市,和平區,1596,163,46,209,11,220,366,60.11%,44.54%,1
臺中市,和平區,1597,288,75,363,12,375,771,48.64%,37.35%,1
臺中市,和平區,1598,231,70,301,20,321,574,55.92%,40.24%,1
臺中市,和平區,1599,124,38,162,9,171,274,62.41%,45.26%,1
臺中市,和平區,1600,56,27,83,5,88,157,56.05%,35.67%,1
臺中市,和平區,1601,309,88,397,17,414,713,58.06%,43.34%,1
臺南市,新營區,0116,520,238,758,40,798,1693,47.14%,30.71%,1
臺南市,新營區,0117,553,262,815,58,873,1561,55.93%,35.43%,1
臺南市,新營區,0118,536,231,767,42,809,1487,54.4%,36.05%,1
臺南市,新營區,0119,451,180,631,25,656,1232,53.25%,36.61%,1
臺南市,新營區,0120,351,172,523,29,552,1067,51.73%,32.9%,1
臺南市,新營區,0121,436,212,648,33,681,1419,47.99%,30.73%,1
臺南市,新營區,0122,555,239,794,30,824,1466,56.21%,37.86%,1
臺南市,新營區,0123,335,185,520,52,572,932,61.37%,35.94%,1
臺南市,新營區,0124,358,162,520,25,545,1099,49.59%,32.58%,1
臺南市,新營區,0125,254,98,352,23,375,757,49.54%,33.55%,1
臺南市,新營區,0126,323,168,491,24,515,888,58%,36.37%,1
臺南市,新營區,0127,371,194,565,20,585,1115,52.47%,33.27%,1
臺南市,新營區,0128,316,134,450,16,466,937,49.73%,33.72%,1
臺南市,新營區,0129,530,123,653,40,693,1387,49.96%,38.21%,1
臺南市,新營區,0130,505,214,719,46,765,1526,50.13%,33.09%,1
臺南市,新營區,0131,473,234,707,28,735,1301,56.5%,36.36%,1
臺南市,新營區,0132,569,267,836,35,871,1538,56.63%,37%,1
臺南市,新營區,0133,574,268,842,18,860,1584,54.29%,36.24%,1
臺南市,新營區,0134,547,314,861,32,893,1583,56.41%,34.55%,1
臺南市,新營區,0135,521,299,820,21,841,1530,54.97%,34.05%,1
臺南市,新營區,0136,439,234,673,33,706,1193,59.18%,36.8%,1
臺南市,新營區,0137,355,205,560,22,582,1439,40.44%,24.67%,1
臺南市,新營區,0138,538,234,772,37,809,1438,56.26%,37.41%,1
臺南市,新營區,0139,128,65,193,17,210,359,58.5%,35.65%,1
臺南市,新營區,0140,332,184,516,23,539,1233,43.71%,26.93%,1
臺南市,新營區,0141,367,143,510,24,534,1227,43.52%,29.91%,1
臺南市,新營區,0142,413,178,591,23,614,1320,46.52%,31.29%,1
臺南市,新營區,0143,529,284,813,31,844,1930,43.73%,27.41%,1
臺南市,新營區,0144,503,249,752,42,794,1501,52.9%,33.51%,1
臺南市,新營區,0145,465,228,693,33,726,1475,49.22%,31.53%,1
臺南市,新營區,0146,588,302,890,47,937,1753,53.45%,33.54%,1
臺南市,新營區,0147,550,287,837,34,871,1748,49.83%,31.46%,1
臺南市,新營區,0148,553,314,867,36,903,1741,51.87%,31.76%,1
臺南市,新營區,0149,436,252,688,23,711,1433,49.62%,30.43%,1
臺南市,新營區,0150,533,257,790,44,834,1595,52.29%,33.42%,1
臺南市,新營區,0151,310,131,441,22,463,959,48.28%,32.33%,1
臺南市,新營區,0152,558,286,844,69,913,1865,48.95%,29.92%,1
臺南市,新營區,0153,473,241,714,74,788,1678,46.96%,28.19%,1
臺南市,新營區,0154,405,167,572,53,625,1373,45.52%,29.5%,1
臺南市,新營區,0155,353,199,552,26,578,1431,40.39%,24.67%,1
臺南市,新營區,0156,70,41,111,5,116,291,39.86%,24.05%,1
臺南市,新營區,0157,542,294,836,52,888,1749,50.77%,30.99%,1
臺南市,新營區,0158,562,259,821,47,868,1862,46.62%,30.18%,1
臺南市,新營區,0159,613,302,915,67,982,1821,53.93%,33.66%,1
臺南市,新營區,0160,577,248,825,42,867,1845,46.99%,31.27%,1
臺南市,新營區,0161,157,48,205,11,216,542,39.85%,28.97%,1
臺南市,新營區,0162,97,47,144,10,154,402,38.31%,24.13%,1
臺南市,新營區,0163,245,109,354,57,411,703,58.46%,34.85%,1
臺南市,新營區,0164,259,141,400,34,434,941,46.12%,27.52%,1
臺南市,鹽水區,0085,371,138,509,55,564,1037,54.39%,35.78%,1
臺南市,鹽水區,0086,161,82,243,14,257,480,53.54%,33.54%,1
臺南市,鹽水區,0087,239,118,357,24,381,636,59.91%,37.58%,1
臺南市,鹽水區,0088,121,54,175,6,181,321,56.39%,37.69%,1
臺南市,鹽水區,0089,199,83,282,16,298,497,59.96%,40.04%,1
臺南市,鹽水區,0090,286,148,434,12,446,759,58.76%,37.68%,1
臺南市,鹽水區,0091,110,46,156,11,167,341,48.97%,32.26%,1
臺南市,鹽水區,0092,180,87,267,15,282,507,55.62%,35.5%,1
臺南市,鹽水區,0093,263,119,382,17,399,863,46.23%,30.48%,1
臺南市,鹽水區,0094,430,201,631,26,657,1373,47.85%,31.32%,1
臺南市,鹽水區,0095,469,222,691,59,750,1507,49.77%,31.12%,1
臺南市,鹽水區,0096,460,218,678,53,731,1374,53.2%,33.48%,1
臺南市,鹽水區,0097,374,189,563,37,600,1244,48.23%,30.06%,1
臺南市,鹽水區,0098,396,128,524,15,539,1022,52.74%,38.75%,1
臺南市,鹽水區,0099,212,105,317,41,358,921,38.87%,23.02%,1
臺南市,鹽水區,0100,272,155,427,32,459,847,54.19%,32.11%,1
臺南市,鹽水區,0101,159,81,240,13,253,736,34.38%,21.6%,1
臺南市,鹽水區,0102,254,122,376,20,396,761,52.04%,33.38%,1
臺南市,鹽水區,0103,88,41,129,13,142,285,49.82%,30.88%,1
臺南市,鹽水區,0104,129,68,197,30,227,493,46.04%,26.17%,1
臺南市,鹽水區,0105,169,70,239,15,254,621,40.9%,27.21%,1
臺南市,鹽水區,0106,104,37,141,12,153,392,39.03%,26.53%,1
臺南市,鹽水區,0107,288,133,421,27,448,925,48.43%,31.14%,1
臺南市,鹽水區,0108,203,90,293,36,329,728,45.19%,27.88%,1
臺南市,鹽水區,0109,50,22,72,13,85,214,39.72%,23.36%,1
臺南市,鹽水區,0110,132,41,173,6,179,387,46.25%,34.11%,1
臺南市,鹽水區,0111,96,47,143,14,157,301,52.16%,31.89%,1
臺南市,鹽水區,0112,174,103,277,33,310,755,41.06%,23.05%,1
臺南市,鹽水區,0113,103,40,143,13,156,365,42.74%,28.22%,1
臺南市,鹽水區,0114,271,142,413,35,448,935,47.91%,28.98%,1
臺南市,鹽水區,0115,147,57,204,32,236,494,47.77%,29.76%,1
臺南市,白河區,0030,409,182,591,50,641,1176,54.51%,34.78%,1
臺南市,白河區,0031,181,85,266,16,282,546,51.65%,33.15%,1
臺南市,白河區,0032,303,155,458,19,477,859,55.53%,35.27%,1
臺南市,白河區,0033,344,154,498,37,535,946,56.55%,36.36%,1
臺南市,白河區,0034,368,181,549,34,583,1116,52.24%,32.97%,1
臺南市,白河區,0035,398,156,554,29,583,1397,41.73%,28.49%,1
臺南市,白河區,0036,199,107,306,19,325,756,42.99%,26.32%,1
臺南市,白河區,0037,265,120,385,43,428,871,49.14%,30.42%,1
臺南市,白河區,0038,308,118,426,26,452,897,50.39%,34.34%,1
臺南市,白河區,0039,175,81,256,33,289,784,36.86%,22.32%,1
臺南市,白河區,0040,148,87,235,15,250,572,43.71%,25.87%,1
臺南市,白河區,0041,104,46,150,10,160,457,35.01%,22.76%,1
臺南市,白河區,0042,172,55,227,13,240,600,40%,28.67%,1
臺南市,白河區,0043,71,40,111,5,116,375,30.93%,18.93%,1
臺南市,白河區,0044,94,51,145,10,155,508,30.51%,18.5%,1
臺南市,白河區,0045,128,68,196,15,211,631,33.44%,20.29%,1
臺南市,白河區,0046,77,32,109,14,123,391,31.46%,19.69%,1
臺南市,白河區,0047,241,60,301,25,326,799,40.8%,30.16%,1
臺南市,白河區,0048,120,47,167,17,184,506,36.36%,23.72%,1
臺南市,白河區,0049,224,111,335,38,373,832,44.83%,26.92%,1
臺南市,白河區,0050,366,172,538,23,561,1179,47.58%,31.04%,1
臺南市,白河區,0051,165,91,256,20,276,744,37.1%,22.18%,1
臺南市,白河區,0052,163,81,244,25,269,699,38.48%,23.32%,1
臺南市,白河區,0053,170,61,231,8,239,633,37.76%,26.86%,1
臺南市,白河區,0054,279,127,406,60,466,859,54.25%,32.48%,1
臺南市,白河區,0055,236,114,350,44,394,884,44.57%,26.7%,1
臺南市,白河區,0056,141,66,207,12,219,740,29.59%,19.05%,1
臺南市,白河區,0057,370,169,539,36,575,1334,43.1%,27.74%,1
臺南市,白河區,0058,215,98,313,43,356,723,49.24%,29.74%,1
臺南市,白河區,0059,235,99,334,55,389,682,57.04%,34.46%,1
臺南市,白河區,0060,243,143,386,55,441,855,51.58%,28.42%,1
臺南市,白河區,0061,140,66,206,24,230,543,42.36%,25.78%,1
臺南市,柳營區,0165,372,173,545,34,579,1166,49.66%,31.9%,1
臺南市,柳營區,0166,235,104,339,12,351,625,56.16%,37.6%,1
臺南市,柳營區,0167,236,91,327,26,353,738,47.83%,31.98%,1
臺南市,柳營區,0168,351,137,488,12,500,834,59.95%,42.09%,1
臺南市,柳營區,0169,362,151,513,29,542,1104,49.09%,32.79%,1
臺南市,柳營區,0170,333,134,467,18,485,1015,47.78%,32.81%,1
臺南市,柳營區,0171,637,246,883,72,955,1720,55.52%,37.03%,1
臺南市,柳營區,0172,404,198,602,62,664,1391,47.74%,29.04%,1
臺南市,柳營區,0173,137,65,202,5,207,425,48.71%,32.24%,1
臺南市,柳營區,0174,89,36,125,11,136,318,42.77%,27.99%,1
臺南市,柳營區,0175,225,118,343,32,375,753,49.8%,29.88%,1
臺南市,柳營區,0176,216,89,305,39,344,730,47.12%,29.59%,1
臺南市,柳營區,0177,242,99,341,28,369,725,50.9%,33.38%,1
臺南市,柳營區,0178,277,125,402,24,426,787,54.13%,35.2%,1
臺南市,柳營區,0179,105,50,155,17,172,297,57.91%,35.35%,1
臺南市,柳營區,0180,239,100,339,37,376,673,55.87%,35.51%,1
臺南市,柳營區,0181,226,98,324,43,367,640,57.34%,35.31%,1
臺南市,柳營區,0182,156,103,259,30,289,660,43.79%,23.64%,1
臺南市,柳營區,0183,377,134,511,47,558,1212,46.04%,31.11%,1
臺南市,柳營區,0184,60,21,81,9,90,202,44.55%,29.7%,1
臺南市,柳營區,0185,326,130,456,60,516,1049,49.19%,31.08%,1
臺南市,柳營區,0186,45,31,76,1,77,158,48.73%,28.48%,1
臺南市,柳營區,0187,268,135,403,61,464,921,50.38%,29.1%,1
臺南市,柳營區,0188,155,59,214,21,235,504,46.63%,30.75%,1
臺南市,柳營區,0189,46,16,62,3,65,157,41.4%,29.3%,1
臺南市,後壁區,0001,266,115,381,45,426,743,57.34%,35.8%,1
臺南市,後壁區,0002,315,123,438,21,459,898,51.11%,35.08%,1
臺南市,後壁區,0003,238,110,348,38,386,786,49.11%,30.28%,1
臺南市,後壁區,0004,178,67,245,33,278,534,52.06%,33.33%,1
臺南市,後壁區,0005,318,161,479,53,532,1034,51.45%,30.75%,1
臺南市,後壁區,0006,44,46,90,16,106,232,45.69%,18.97%,1
臺南市,後壁區,0007,140,61,201,34,235,479,49.06%,29.23%,1
臺南市,後壁區,0008,260,118,378,27,405,837,48.39%,31.06%,1
臺南市,後壁區,0009,269,150,419,39,458,1085,42.21%,24.79%,1
臺南市,後壁區,0010,282,134,416,17,433,1157,37.42%,24.37%,1
臺南市,後壁區,0011,251,90,341,45,386,755,51.13%,33.25%,1
臺南市,後壁區,0012,139,92,231,25,256,458,55.9%,30.35%,1
臺南市,後壁區,0013,115,40,155,24,179,371,48.25%,31%,1
臺南市,後壁區,0014,210,93,303,30,333,676,49.26%,31.07%,1
臺南市,後壁區,0015,119,46,165,25,190,428,44.39%,27.8%,1
臺南市,後壁區,0016,173,52,225,18,243,547,44.42%,31.63%,1
臺南市,後壁區,0017,151,53,204,31,235,455,51.65%,33.19%,1
臺南市,後壁區,0018,287,104,391,44,435,984,44.21%,29.17%,1
臺南市,後壁區,0019,132,69,201,24,225,483,46.58%,27.33%,1
臺南市,後壁區,0020,152,53,205,22,227,536,42.35%,28.36%,1
臺南市,後壁區,0021,237,96,333,11,344,958,35.91%,24.74%,1
臺南市,後壁區,0022,170,52,222,34,256,441,58.05%,38.55%,1
臺南市,後壁區,0023,226,107,333,44,377,677,55.69%,33.38%,1
臺南市,後壁區,0024,390,118,508,35,543,996,54.52%,39.16%,1
臺南市,後壁區,0025,388,164,552,26,578,1255,46.06%,30.92%,1
臺南市,後壁區,0026,196,90,286,15,301,678,44.4%,28.91%,1
臺南市,後壁區,0027,162,66,228,13,241,553,43.58%,29.29%,1
臺南市,後壁區,0028,154,65,219,19,238,616,38.64%,25%,1
臺南市,後壁區,0029,388,160,548,39,587,1189,49.37%,32.63%,1
臺南市,東山區,0062,412,160,572,38,610,1401,43.54%,29.41%,1
臺南市,東山區,0063,351,137,488,22,510,1185,43.04%,29.62%,1
臺南市,東山區,0064,319,165,484,50,534,1303,40.98%,24.48%,1
臺南市,東山區,0065,183,86,269,28,297,732,40.57%,25%,1
臺南市,東山區,0066,180,77,257,29,286,721,39.67%,24.97%,1
臺南市,東山區,0067,229,134,363,46,409,1104,37.05%,20.74%,1
臺南市,東山區,0068,277,104,381,24,405,943,42.95%,29.37%,1
臺南市,東山區,0069,127,45,172,1,173,653,26.49%,19.45%,1
臺南市,東山區,0070,181,76,257,39,296,596,49.66%,30.37%,1
臺南市,東山區,0071,239,119,358,41,399,878,45.44%,27.22%,1
臺南市,東山區,0072,197,93,290,36,326,771,42.28%,25.55%,1
臺南市,東山區,0073,123,69,192,20,212,483,43.89%,25.47%,1
臺南市,東山區,0074,196,92,288,34,322,640,50.31%,30.63%,1
臺南市,東山區,0075,70,29,99,7,106,425,24.94%,16.47%,1
臺南市,東山區,0076,109,31,140,11,151,394,38.32%,27.66%,1
臺南市,東山區,0077,127,46,173,19,192,373,51.47%,34.05%,1
臺南市,東山區,0078,358,98,456,36,492,1257,39.14%,28.48%,1
臺南市,東山區,0079,194,68,262,9,271,887,30.55%,21.87%,1
臺南市,東山區,0080,142,49,191,12,203,658,30.85%,21.58%,1
臺南市,東山區,0081,229,91,320,24,344,1101,31.24%,20.8%,1
臺南市,東山區,0082,231,89,320,15,335,1057,31.69%,21.85%,1
臺南市,東山區,0083,204,76,280,30,310,639,48.51%,31.92%,1
臺南市,東山區,0084,75,33,108,9,117,270,43.33%,27.78%,1
臺南市,麻豆區,0381,416,175,591,43,634,1205,52.61%,34.52%,1
臺南市,麻豆區,0382,217,134,351,19,370,660,56.06%,32.88%,1
臺南市,麻豆區,0383,190,89,279,16,295,523,56.41%,36.33%,1
臺南市,麻豆區,0384,488,296,784,23,807,1597,50.53%,30.56%,1
臺南市,麻豆區,0385,429,232,661,41,702,1262,55.63%,33.99%,1
臺南市,麻豆區,0386,466,262,728,32,760,1325,57.36%,35.17%,1
臺南市,麻豆區,0387,427,254,681,26,707,1384,51.08%,30.85%,1
臺南市,麻豆區,0388,380,204,584,19,603,1121,53.79%,33.9%,1
臺南市,麻豆區,0389,325,170,495,8,503,1021,49.27%,31.83%,1
臺南市,麻豆區,0390,306,153,459,18,477,954,50%,32.08%,1
臺南市,麻豆區,0391,450,224,674,25,699,1513,46.2%,29.74%,1
臺南市,麻豆區,0392,499,252,751,37,788,1726,45.65%,28.91%,1
臺南市,麻豆區,0393,593,284,877,35,912,1804,50.55%,32.87%,1
臺南市,麻豆區,0394,351,166,517,26,543,1106,49.1%,31.74%,1
臺南市,麻豆區,0395,488,269,757,33,790,1503,52.56%,32.47%,1
臺南市,麻豆區,0396,417,197,614,48,662,1302,50.84%,32.03%,1
臺南市,麻豆區,0397,201,109,310,14,324,645,50.23%,31.16%,1
臺南市,麻豆區,0398,291,118,409,29,438,777,56.37%,37.45%,1
臺南市,麻豆區,0399,502,241,743,40,783,1612,48.57%,31.14%,1
臺南市,麻豆區,0400,217,103,320,17,337,718,46.94%,30.22%,1
臺南市,麻豆區,0401,511,216,727,23,750,1656,45.29%,30.86%,1
臺南市,麻豆區,0402,398,226,624,47,671,1355,49.52%,29.37%,1
臺南市,麻豆區,0403,257,136,393,19,412,977,42.17%,26.31%,1
臺南市,麻豆區,0404,297,157,454,26,480,1012,47.43%,29.35%,1
臺南市,麻豆區,0405,205,127,332,18,350,626,55.91%,32.75%,1
臺南市,麻豆區,0406,105,48,153,6,159,467,34.05%,22.48%,1
臺南市,麻豆區,0407,396,175,571,24,595,1260,47.22%,31.43%,1
臺南市,麻豆區,0408,393,160,553,46,599,1111,53.92%,35.37%,1
臺南市,麻豆區,0409,162,117,279,19,298,550,54.18%,29.45%,1
臺南市,麻豆區,0410,246,133,379,46,425,798,53.26%,30.83%,1
臺南市,麻豆區,0411,304,141,445,63,508,852,59.62%,35.68%,1
臺南市,麻豆區,0412,226,118,344,9,353,830,42.53%,27.23%,1
臺南市,麻豆區,0413,246,144,390,22,412,941,43.78%,26.14%,1
臺南市,麻豆區,0414,411,197,608,22,630,1158,54.4%,35.49%,1
臺南市,麻豆區,0415,196,87,283,9,292,612,47.71%,32.03%,1
臺南市,下營區,0343,493,177,670,38,708,1558,45.44%,31.64%,1
臺南市,下營區,0344,290,156,446,27,473,1112,42.54%,26.08%,1
臺南市,下營區,0345,266,112,378,50,428,893,47.93%,29.79%,1
臺南市,下營區,0346,499,180,679,39,718,1623,44.24%,30.75%,1
臺南市,下營區,0347,499,227,726,63,789,1568,50.32%,31.82%,1
臺南市,下營區,0348,366,124,490,20,510,985,51.78%,37.16%,1
臺南市,下營區,0349,311,123,434,12,446,953,46.8%,32.63%,1
臺南市,下營區,0350,345,143,488,17,505,1031,48.98%,33.46%,1
臺南市,下營區,0351,398,172,570,37,607,1077,56.36%,36.95%,1
臺南市,下營區,0352,173,93,266,30,296,703,42.11%,24.61%,1
臺南市,下營區,0353,250,106,356,18,374,854,43.79%,29.27%,1
臺南市,下營區,0354,380,168,548,53,601,1164,51.63%,32.65%,1
臺南市,下營區,0355,329,143,472,23,495,1091,45.37%,30.16%,1
臺南市,下營區,0356,324,131,455,36,491,959,51.2%,33.79%,1
臺南市,下營區,0357,293,137,430,19,449,935,48.02%,31.34%,1
臺南市,下營區,0358,303,132,435,33,468,893,52.41%,33.93%,1
臺南市,下營區,0359,465,157,622,66,688,1293,53.21%,35.96%,1
臺南市,下營區,0360,362,181,543,83,626,1185,52.83%,30.55%,1
臺南市,下營區,0361,292,115,407,19,426,1070,39.81%,27.29%,1
臺南市,六甲區,0362,289,143,432,38,470,819,57.39%,35.29%,1
臺南市,六甲區,0363,222,100,322,14,336,645,52.09%,34.42%,1
臺南市,六甲區,0364,406,240,646,33,679,1444,47.02%,28.12%,1
臺南市,六甲區,0365,407,223,630,50,680,1554,43.76%,26.19%,1
臺南市,六甲區,0366,308,186,494,38,532,1171,45.43%,26.3%,1
臺南市,六甲區,0367,396,210,606,48,654,1351,48.41%,29.31%,1
臺南市,六甲區,0368,275,137,412,57,469,1010,46.44%,27.23%,1
臺南市,六甲區,0369,251,144,395,47,442,919,48.1%,27.31%,1
臺南市,六甲區,0370,399,214,613,54,667,1369,48.72%,29.15%,1
臺南市,六甲區,0371,317,161,478,39,517,976,52.97%,32.48%,1
臺南市,六甲區,0372,337,64,401,51,452,1015,44.53%,33.2%,1
臺南市,六甲區,0373,342,168,510,34,544,1176,46.26%,29.08%,1
臺南市,六甲區,0374,307,142,449,38,487,939,51.86%,32.69%,1
臺南市,六甲區,0375,227,116,343,32,375,712,52.67%,31.88%,1
臺南市,六甲區,0376,287,150,437,27,464,881,52.67%,32.58%,1
臺南市,六甲區,0377,421,216,637,57,694,1184,58.61%,35.56%,1
臺南市,六甲區,0378,252,93,345,22,367,599,61.27%,42.07%,1
臺南市,六甲區,0379,165,66,231,8,239,759,31.49%,21.74%,1
臺南市,六甲區,0380,151,77,228,23,251,621,40.42%,24.32%,1
臺南市,官田區,0416,361,144,505,13,518,1104,46.92%,32.7%,1
臺南市,官田區,0417,292,144,436,37,473,965,49.02%,30.26%,1
臺南市,官田區,0418,472,217,689,32,721,1402,51.43%,33.67%,1
臺南市,官田區,0419,558,211,769,141,910,1653,55.05%,33.76%,1
臺南市,官田區,0420,266,151,417,36,453,966,46.89%,27.54%,1
臺南市,官田區,0421,81,35,116,10,126,284,44.37%,28.52%,1
臺南市,官田區,0422,80,48,128,5,133,402,33.08%,19.9%,1
臺南市,官田區,0423,336,157,493,17,510,982,51.93%,34.22%,1
臺南市,官田區,0424,298,124,422,28,450,975,46.15%,30.56%,1
臺南市,官田區,0425,242,134,376,23,399,802,49.75%,30.17%,1
臺南市,官田區,0426,409,183,592,28,620,1118,55.46%,36.58%,1
臺南市,官田區,0427,460,253,713,26,739,1455,50.79%,31.62%,1
臺南市,官田區,0428,399,183,582,29,611,1208,50.58%,33.03%,1
臺南市,官田區,0429,396,187,583,65,648,1293,50.12%,30.63%,1
臺南市,官田區,0430,160,83,243,20,263,607,43.33%,26.36%,1
臺南市,官田區,0431,162,72,234,14,248,501,49.5%,32.34%,1
臺南市,官田區,0432,239,129,368,40,408,728,56.04%,32.83%,1
臺南市,官田區,0433,282,143,425,15,440,842,52.26%,33.49%,1
臺南市,官田區,0434,166,81,247,32,279,515,54.17%,32.23%,1
臺南市,官田區,0435,255,107,362,21,383,873,43.87%,29.21%,1
臺南市,大內區,0436,230,79,309,26,335,759,44.14%,30.3%,1
臺南市,大內區,0437,64,21,85,4,89,262,33.97%,24.43%,1
臺南市,大內區,0438,171,80,251,12,263,646,40.71%,26.47%,1
臺南市,大內區,0439,404,174,578,35,613,1473,41.62%,27.43%,1
臺南市,大內區,0440,345,104,449,52,501,915,54.75%,37.7%,1
臺南市,大內區,0441,266,133,399,41,440,779,56.48%,34.15%,1
臺南市,大內區,0442,213,135,348,45,393,637,61.7%,33.44%,1
臺南市,大內區,0443,320,141,461,22,483,993,48.64%,32.23%,1
臺南市,大內區,0444,302,85,387,30,417,766,54.44%,39.43%,1
臺南市,大內區,0445,308,97,405,38,443,841,52.68%,36.62%,1
臺南市,大內區,0446,201,62,263,29,292,583,50.09%,34.48%,1
臺南市,佳里區,0282,499,231,730,52,782,1391,56.22%,35.87%,1
臺南市,佳里區,0283,309,158,467,28,495,829,59.71%,37.27%,1
臺南市,佳里區,0284,462,188,650,38,688,1401,49.11%,32.98%,1
臺南市,佳里區,0285,451,197,648,17,665,1452,45.8%,31.06%,1
臺南市,佳里區,0286,498,184,682,39,721,1382,52.17%,36.03%,1
臺南市,佳里區,0287,505,221,726,53,779,1463,53.25%,34.52%,1
臺南市,佳里區,0288,431,169,600,45,645,1280,50.39%,33.67%,1
臺南市,佳里區,0289,509,244,753,60,813,1486,54.71%,34.25%,1
臺南市,佳里區,0290,475,252,727,43,770,1378,55.88%,34.47%,1
臺南市,佳里區,0291,552,237,789,50,839,1505,55.75%,36.68%,1
臺南市,佳里區,0292,652,262,914,56,970,1860,52.15%,35.05%,1
臺南市,佳里區,0293,402,180,582,51,633,1134,55.82%,35.45%,1
臺南市,佳里區,0294,492,241,733,31,764,1426,53.58%,34.5%,1
臺南市,佳里區,0295,600,306,906,37,943,1779,53.01%,33.73%,1
臺南市,佳里區,0296,665,317,982,42,1024,1906,53.73%,34.89%,1
臺南市,佳里區,0297,459,232,691,33,724,1425,50.81%,32.21%,1
臺南市,佳里區,0298,433,194,627,32,659,1255,52.51%,34.5%,1
臺南市,佳里區,0299,480,222,702,58,760,1524,49.87%,31.5%,1
臺南市,佳里區,0300,524,285,809,30,839,1631,51.44%,32.13%,1
臺南市,佳里區,0301,600,235,835,36,871,1546,56.34%,38.81%,1
臺南市,佳里區,0302,472,201,673,39,712,1187,59.98%,39.76%,1
臺南市,佳里區,0303,464,233,697,41,738,1381,53.44%,33.6%,1
臺南市,佳里區,0304,451,207,658,31,689,1364,50.51%,33.06%,1
臺南市,佳里區,0305,481,209,690,16,706,1314,53.73%,36.61%,1
臺南市,佳里區,0306,428,189,617,36,653,1164,56.1%,36.77%,1
臺南市,佳里區,0307,344,137,481,37,518,961,53.9%,35.8%,1
臺南市,佳里區,0308,417,179,596,45,641,1218,52.63%,34.24%,1
臺南市,佳里區,0309,341,148,489,26,515,919,56.04%,37.11%,1
臺南市,佳里區,0310,230,102,332,28,360,689,52.25%,33.38%,1
臺南市,佳里區,0311,113,60,173,13,186,383,48.56%,29.5%,1
臺南市,佳里區,0312,497,182,679,46,725,1507,48.11%,32.98%,1
臺南市,佳里區,0313,224,94,318,28,346,702,49.29%,31.91%,1
臺南市,佳里區,0314,354,120,474,32,506,907,55.79%,39.03%,1
臺南市,佳里區,0315,473,156,629,37,666,937,71.08%,50.48%,1
臺南市,佳里區,0316,328,171,499,56,555,1030,53.88%,31.84%,1
臺南市,佳里區,0317,326,150,476,40,516,981,52.6%,33.23%,1
臺南市,佳里區,0318,274,96,370,22,392,787,49.81%,34.82%,1
臺南市,佳里區,0319,548,179,727,54,781,1513,51.62%,36.22%,1
臺南市,佳里區,0320,223,91,314,17,331,714,46.36%,31.23%,1
臺南市,佳里區,0321,214,117,331,42,373,745,50.07%,28.72%,1
臺南市,佳里區,0322,276,152,428,32,460,951,48.37%,29.02%,1
臺南市,學甲區,0208,306,153,459,32,491,862,56.96%,35.5%,1
臺南市,學甲區,0209,234,112,346,9,355,611,58.1%,38.3%,1
臺南市,學甲區,0210,305,161,466,19,485,936,51.82%,32.59%,1
臺南市,學甲區,0211,328,166,494,28,522,1066,48.97%,30.77%,1
臺南市,學甲區,0212,306,164,470,16,486,869,55.93%,35.21%,1
臺南市,學甲區,0213,218,96,314,26,340,635,53.54%,34.33%,1
臺南市,學甲區,0214,261,116,377,9,386,822,46.96%,31.75%,1
臺南市,學甲區,0215,143,44,187,11,198,443,44.7%,32.28%,1
臺南市,學甲區,0216,475,199,674,35,709,1370,51.75%,34.67%,1
臺南市,學甲區,0217,405,172,577,37,614,1117,54.97%,36.26%,1
臺南市,學甲區,0218,439,196,635,51,686,1365,50.26%,32.16%,1
臺南市,學甲區,0219,474,196,670,47,717,1489,48.15%,31.83%,1
臺南市,學甲區,0220,170,70,240,30,270,627,43.06%,27.11%,1
臺南市,學甲區,0221,343,172,515,19,534,1052,50.76%,32.6%,1
臺南市,學甲區,0222,404,160,564,16,580,1183,49.03%,34.15%,1
臺南市,學甲區,0223,294,119,413,14,427,979,43.62%,30.03%,1
臺南市,學甲區,0224,327,173,500,59,559,1241,45.04%,26.35%,1
臺南市,學甲區,0225,236,84,320,20,340,843,40.33%,28%,1
臺南市,學甲區,0226,195,62,257,28,285,580,49.14%,33.62%,1
臺南市,學甲區,0227,227,88,315,17,332,832,39.9%,27.28%,1
臺南市,學甲區,0228,101,48,149,5,154,406,37.93%,24.88%,1
臺南市,學甲區,0229,284,120,404,25,429,818,52.44%,34.72%,1
臺南市,學甲區,0230,273,131,404,14,418,1052,39.73%,25.95%,1
臺南市,學甲區,0231,157,88,245,10,255,578,44.12%,27.16%,1
臺南市,學甲區,0232,122,48,170,12,182,430,42.33%,28.37%,1
臺南市,學甲區,0233,130,36,166,11,177,361,49.03%,36.01%,1
臺南市,西港區,0323,327,136,463,11,474,933,50.8%,35.05%,1
臺南市,西港區,0324,276,175,451,24,475,901,52.72%,30.63%,1
臺南市,西港區,0325,418,187,605,27,632,1314,48.1%,31.81%,1
臺南市,西港區,0326,436,207,643,49,692,1349,51.3%,32.32%,1
臺南市,西港區,0327,381,155,536,31,567,1014,55.92%,37.57%,1
臺南市,西港區,0328,507,244,751,25,776,1900,40.84%,26.68%,1
臺南市,西港區,0329,462,248,710,45,755,1663,45.4%,27.78%,1
臺南市,西港區,0330,210,101,311,13,324,738,43.9%,28.46%,1
臺南市,西港區,0331,410,201,611,42,653,1211,53.92%,33.86%,1
臺南市,西港區,0332,113,61,174,17,191,382,50%,29.58%,1
臺南市,西港區,0333,252,112,364,24,388,786,49.36%,32.06%,1
臺南市,西港區,0334,277,115,392,10,402,838,47.97%,33.05%,1
臺南市,西港區,0335,380,206,586,37,623,1449,43%,26.22%,1
臺南市,西港區,0336,393,196,589,36,625,1479,42.26%,26.57%,1
臺南市,西港區,0337,289,103,392,40,432,763,56.62%,37.88%,1
臺南市,西港區,0338,380,177,557,22,579,1297,44.64%,29.3%,1
臺南市,西港區,0339,438,210,648,31,679,1393,48.74%,31.44%,1
臺南市,西港區,0340,267,121,388,16,404,958,42.17%,27.87%,1
臺南市,西港區,0341,137,66,203,18,221,391,56.52%,35.04%,1
臺南市,西港區,0342,272,117,389,34,423,805,52.55%,33.79%,1
臺南市,七股區,0258,168,82,250,10,260,534,48.69%,31.46%,1
臺南市,七股區,0259,208,80,288,9,297,508,58.46%,40.94%,1
臺南市,七股區,0260,186,80,266,3,269,665,40.45%,27.97%,1
臺南市,七股區,0261,273,97,370,18,388,834,46.52%,32.73%,1
臺南市,七股區,0262,311,75,386,16,402,810,49.63%,38.4%,1
臺南市,七股區,0263,164,33,197,8,205,480,42.71%,34.17%,1
臺南市,七股區,0264,133,37,170,15,185,445,41.57%,29.89%,1
臺南市,七股區,0265,153,55,208,10,218,680,32.06%,22.5%,1
臺南市,七股區,0266,270,85,355,20,375,838,44.75%,32.22%,1
臺南市,七股區,0267,254,74,328,18,346,780,44.36%,32.56%,1
臺南市,七股區,0268,130,62,192,8,200,350,57.14%,37.14%,1
臺南市,七股區,0269,334,152,486,46,532,907,58.65%,36.82%,1
臺南市,七股區,0270,258,80,338,18,356,780,45.64%,33.08%,1
臺南市,七股區,0271,491,218,709,55,764,1658,46.08%,29.61%,1
臺南市,七股區,0272,352,104,456,18,474,913,51.92%,38.55%,1
臺南市,七股區,0273,368,176,544,57,601,1202,50%,30.62%,1
臺南市,七股區,0274,189,82,271,12,283,696,40.66%,27.16%,1
臺南市,七股區,0275,211,102,313,23,336,647,51.93%,32.61%,1
臺南市,七股區,0276,265,96,361,27,388,622,62.38%,42.6%,1
臺南市,七股區,0277,482,158,640,46,686,1175,58.38%,41.02%,1
臺南市,七股區,0278,193,121,314,19,333,698,47.71%,27.65%,1
臺南市,七股區,0279,354,123,477,38,515,983,52.39%,36.01%,1
臺南市,七股區,0280,454,150,604,32,636,1366,46.56%,33.24%,1
臺南市,七股區,0281,391,183,574,39,613,1379,44.45%,28.35%,1
臺南市,將軍區,0234,423,187,610,41,651,1110,58.65%,38.11%,1
臺南市,將軍區,0235,474,205,679,28,707,1418,49.86%,33.43%,1
臺南市,將軍區,0236,341,128,469,27,496,969,51.19%,35.19%,1
臺南市,將軍區,0237,199,89,288,29,317,519,61.08%,38.34%,1
臺南市,將軍區,0238,384,161,545,13,558,1106,50.45%,34.72%,1
臺南市,將軍區,0239,168,83,251,23,274,542,50.55%,31%,1
臺南市,將軍區,0240,97,33,130,5,135,315,42.86%,30.79%,1
臺南市,將軍區,0241,188,78,266,15,281,584,48.12%,32.19%,1
臺南市,將軍區,0242,120,58,178,9,187,398,46.98%,30.15%,1
臺南市,將軍區,0243,167,78,245,22,267,608,43.91%,27.47%,1
臺南市,將軍區,0244,144,69,213,17,230,442,52.04%,32.58%,1
臺南市,將軍區,0245,185,70,255,10,265,650,40.77%,28.46%,1
臺南市,將軍區,0246,166,46,212,14,226,573,39.44%,28.97%,1
臺南市,將軍區,0247,202,66,268,10,278,617,45.06%,32.74%,1
臺南市,將軍區,0248,206,66,272,23,295,573,51.48%,35.95%,1
臺南市,將軍區,0249,157,49,206,17,223,434,51.38%,36.18%,1
臺南市,將軍區,0250,261,92,353,17,370,849,43.58%,30.74%,1
臺南市,將軍區,0251,180,70,250,18,268,645,41.55%,27.91%,1
臺南市,將軍區,0252,228,60,288,25,313,690,45.36%,33.04%,1
臺南市,將軍區,0253,185,43,228,17,245,663,36.95%,27.9%,1
臺南市,將軍區,0254,411,126,537,22,559,1175,47.57%,34.98%,1
臺南市,將軍區,0255,235,82,317,26,343,837,40.98%,28.08%,1
臺南市,將軍區,0256,350,147,497,60,557,1061,52.5%,32.99%,1
臺南市,將軍區,0257,311,93,404,17,421,976,43.14%,31.86%,1
臺南市,北門區,0190,156,80,236,8,244,484,50.41%,32.23%,1
臺南市,北門區,0191,113,38,151,15,166,401,41.4%,28.18%,1
臺南市,北門區,0192,153,42,195,7,202,456,44.3%,33.55%,1
臺南市,北門區,0193,139,64,203,11,214,382,56.02%,36.39%,1
臺南市,北門區,0194,122,51,173,12,185,356,51.97%,34.27%,1
臺南市,北門區,0195,121,44,165,3,168,389,43.19%,31.11%,1
臺南市,北門區,0196,247,68,315,10,325,742,43.8%,33.29%,1
臺南市,北門區,0197,197,61,258,13,271,599,45.24%,32.89%,1
臺南市,北門區,0198,167,58,225,25,250,594,42.09%,28.11%,1
臺南市,北門區,0199,175,60,235,13,248,572,43.36%,30.59%,1
臺南市,北門區,0200,68,37,105,5,110,318,34.59%,21.38%,1
臺南市,北門區,0201,117,50,167,12,179,473,37.84%,24.74%,1
臺南市,北門區,0202,241,101,342,12,354,954,37.11%,25.26%,1
臺南市,北門區,0203,260,109,369,33,402,737,54.55%,35.28%,1
臺南市,北門區,0204,148,77,225,11,236,679,34.76%,21.8%,1
臺南市,北門區,0205,124,58,182,24,206,521,39.54%,23.8%,1
臺南市,北門區,0206,166,54,220,22,242,632,38.29%,26.27%,1
臺南市,北門區,0207,163,84,247,9,256,636,40.25%,25.63%,1
臺南市,新化區,0581,317,108,425,30,455,746,60.99%,42.49%,1
臺南市,新化區,0582,413,206,619,35,654,1102,59.35%,37.48%,1
臺南市,新化區,0583,152,59,211,8,219,370,59.19%,41.08%,1
臺南市,新化區,0584,355,180,535,32,567,947,59.87%,37.49%,1
臺南市,新化區,0585,430,155,585,29,614,1154,53.21%,37.26%,1
臺南市,新化區,0586,351,210,561,46,607,1082,56.1%,32.44%,1
臺南市,新化區,0587,408,171,579,32,611,1075,56.84%,37.95%,1
臺南市,新化區,0588,236,92,328,12,340,640,53.13%,36.88%,1
臺南市,新化區,0589,145,62,207,14,221,410,53.9%,35.37%,1
臺南市,新化區,0590,192,71,263,19,282,533,52.91%,36.02%,1
臺南市,新化區,0591,325,151,476,12,488,836,58.37%,38.88%,1
臺南市,新化區,0592,287,122,409,14,423,978,43.25%,29.35%,1
臺南市,新化區,0593,473,259,732,35,767,1348,56.9%,35.09%,1
臺南市,新化區,0594,332,169,501,36,537,1015,52.91%,32.71%,1
臺南市,新化區,0595,410,165,575,23,598,1228,48.7%,33.39%,1
臺南市,新化區,0596,288,137,425,31,456,789,57.79%,36.5%,1
臺南市,新化區,0597,376,168,544,15,559,1022,54.7%,36.79%,1
臺南市,新化區,0598,396,129,525,17,542,1021,53.09%,38.79%,1
臺南市,新化區,0599,461,222,683,31,714,1229,58.1%,37.51%,1
臺南市,新化區,0600,399,189,588,14,602,1153,52.21%,34.61%,1
臺南市,新化區,0601,297,131,428,23,451,1012,44.57%,29.35%,1
臺南市,新化區,0602,515,261,776,35,811,1458,55.62%,35.32%,1
臺南市,新化區,0603,632,265,897,29,926,1645,56.29%,38.42%,1
臺南市,新化區,0604,386,182,568,25,593,1016,58.37%,37.99%,1
臺南市,新化區,0605,198,91,289,11,300,559,53.67%,35.42%,1
臺南市,新化區,0606,456,200,656,23,679,1222,55.56%,37.32%,1
臺南市,新化區,0607,567,319,886,35,921,1562,58.96%,36.3%,1
臺南市,新化區,0608,290,159,449,30,479,994,48.19%,29.18%,1
臺南市,新化區,0609,369,137,506,61,567,1013,55.97%,36.43%,1
臺南市,新化區,0610,464,187,651,30,681,1197,56.89%,38.76%,1
臺南市,新化區,0611,352,130,482,36,518,1021,50.73%,34.48%,1
臺南市,新化區,0612,467,161,628,26,654,1428,45.8%,32.7%,1
臺南市,新化區,0613,136,61,197,22,219,456,48.03%,29.82%,1
臺南市,新化區,0614,401,162,563,32,595,1037,57.38%,38.67%,1
臺南市,新化區,0615,434,152,586,32,618,1097,56.34%,39.56%,1
臺南市,新化區,0616,335,139,474,29,503,902,55.76%,37.14%,1
臺南市,新化區,0617,322,134,456,60,516,999,51.65%,32.23%,1
臺南市,善化區,0492,356,175,531,10,541,1132,47.79%,31.45%,1
臺南市,善化區,0493,597,287,884,39,923,1845,50.03%,32.36%,1
臺南市,善化區,0494,680,334,1014,40,1054,2090,50.43%,32.54%,1
臺南市,善化區,0495,574,263,837,42,879,1582,55.56%,36.28%,1
臺南市,善化區,0496,655,363,1018,40,1058,1901,55.65%,34.46%,1
臺南市,善化區,0497,608,312,920,39,959,1818,52.75%,33.44%,1
臺南市,善化區,0498,564,251,815,41,856,1639,52.23%,34.41%,1
臺南市,善化區,0499,363,204,567,30,597,1061,56.27%,34.21%,1
臺南市,善化區,0500,669,287,956,56,1012,1786,56.66%,37.46%,1
臺南市,善化區,0501,443,161,604,28,632,1147,55.1%,38.62%,1
臺南市,善化區,0502,515,241,756,34,790,1581,49.97%,32.57%,1
臺南市,善化區,0503,411,215,626,41,667,1240,53.79%,33.15%,1
臺南市,善化區,0504,571,234,805,23,828,1743,47.5%,32.76%,1
臺南市,善化區,0505,448,248,696,24,720,1246,57.78%,35.96%,1
臺南市,善化區,0506,310,169,479,21,500,961,52.03%,32.26%,1
臺南市,善化區,0507,304,141,445,9,454,938,48.4%,32.41%,1
臺南市,善化區,0508,266,121,387,18,405,722,56.09%,36.84%,1
臺南市,善化區,0509,365,146,511,27,538,1062,50.66%,34.37%,1
臺南市,善化區,0510,584,251,835,56,891,1715,51.95%,34.05%,1
臺南市,善化區,0511,360,156,516,42,558,1120,49.82%,32.14%,1
臺南市,善化區,0512,288,131,419,21,440,865,50.87%,33.29%,1
臺南市,善化區,0513,481,294,775,46,821,1574,52.16%,30.56%,1
臺南市,善化區,0514,436,221,657,42,699,1535,45.54%,28.4%,1
臺南市,善化區,0515,362,181,543,47,590,1106,53.35%,32.73%,1
臺南市,善化區,0516,482,207,689,34,723,1402,51.57%,34.38%,1
臺南市,善化區,0517,570,260,830,46,876,1458,60.08%,39.09%,1
臺南市,善化區,0518,393,230,623,25,648,1380,46.96%,28.48%,1
臺南市,善化區,0519,387,251,638,5,643,1232,52.19%,31.41%,1
臺南市,善化區,0520,341,235,576,7,583,1069,54.54%,31.9%,1
臺南市,新市區,0545,309,155,464,22,486,960,50.63%,32.19%,1
臺南市,新市區,0546,424,207,631,28,659,1118,58.94%,37.92%,1
臺南市,新市區,0547,271,136,407,10,417,850,49.06%,31.88%,1
臺南市,新市區,0548,433,201,634,27,661,1241,53.26%,34.89%,1
臺南市,新市區,0549,470,210,680,24,704,1297,54.28%,36.24%,1
臺南市,新市區,0550,368,156,524,22,546,962,56.76%,38.25%,1
臺南市,新市區,0551,456,218,674,27,701,1237,56.67%,36.86%,1
臺南市,新市區,0552,450,238,688,31,719,1326,54.22%,33.94%,1
臺南市,新市區,0553,460,203,663,37,700,1211,57.8%,37.99%,1
臺南市,新市區,0554,437,208,645,25,670,1305,51.34%,33.49%,1
臺南市,新市區,0555,266,85,351,26,377,688,54.8%,38.66%,1
臺南市,新市區,0556,341,154,495,21,516,911,56.64%,37.43%,1
臺南市,新市區,0557,475,239,714,27,741,1525,48.59%,31.15%,1
臺南市,新市區,0558,319,157,476,6,482,1091,44.18%,29.24%,1
臺南市,新市區,0559,387,171,558,10,568,1122,50.62%,34.49%,1
臺南市,新市區,0560,363,146,509,21,530,1049,50.52%,34.6%,1
臺南市,新市區,0561,488,242,730,14,744,1564,47.57%,31.2%,1
臺南市,新市區,0562,530,246,776,36,812,1515,53.6%,34.98%,1
臺南市,新市區,0563,502,217,719,19,738,1378,53.56%,36.43%,1
臺南市,新市區,0564,333,151,484,33,517,827,62.52%,40.27%,1
臺南市,新市區,0565,411,158,569,48,617,960,64.27%,42.81%,1
臺南市,新市區,0566,347,126,473,27,500,951,52.58%,36.49%,1
臺南市,新市區,0567,450,207,657,39,696,1264,55.06%,35.6%,1
臺南市,新市區,0568,395,219,614,23,637,1173,54.31%,33.67%,1
臺南市,新市區,0569,252,136,388,10,398,684,58.19%,36.84%,1
臺南市,新市區,0570,444,175,619,34,653,1055,61.9%,42.09%,1
臺南市,新市區,0571,443,223,666,26,692,1122,61.68%,39.48%,1
臺南市,安定區,0521,536,197,733,46,779,1251,62.27%,42.85%,1
臺南市,安定區,0522,331,142,473,37,510,899,56.73%,36.82%,1
臺南市,安定區,0523,406,166,572,40,612,1106,55.33%,36.71%,1
臺南市,安定區,0524,380,128,508,26,534,948,56.33%,40.08%,1
臺南市,安定區,0525,463,221,684,33,717,1442,49.72%,32.11%,1
臺南市,安定區,0526,494,196,690,41,731,1385,52.78%,35.67%,1
臺南市,安定區,0527,335,100,435,24,459,801,57.3%,41.82%,1
臺南市,安定區,0528,212,113,325,20,345,736,46.88%,28.8%,1
臺南市,安定區,0529,271,118,389,19,408,781,52.24%,34.7%,1
臺南市,安定區,0530,288,135,423,17,440,795,55.35%,36.23%,1
臺南市,安定區,0531,335,141,476,35,511,862,59.28%,38.86%,1
臺南市,安定區,0532,508,200,708,26,734,1487,49.36%,34.16%,1
臺南市,安定區,0533,487,213,700,32,732,1385,52.85%,35.16%,1
臺南市,安定區,0534,504,221,725,23,748,1518,49.28%,33.2%,1
臺南市,安定區,0535,429,179,608,35,643,1094,58.78%,39.21%,1
臺南市,安定區,0536,590,239,829,63,892,1590,56.1%,37.11%,1
臺南市,安定區,0537,297,115,412,17,429,754,56.9%,39.39%,1
臺南市,安定區,0538,252,131,383,26,409,716,57.12%,35.2%,1
臺南市,安定區,0539,517,266,783,33,816,1492,54.69%,34.65%,1
臺南市,安定區,0540,337,152,489,32,521,943,55.25%,35.74%,1
臺南市,安定區,0541,427,185,612,30,642,1157,55.49%,36.91%,1
臺南市,安定區,0542,498,228,726,44,770,1384,55.64%,35.98%,1
臺南市,安定區,0543,326,172,498,34,532,967,55.02%,33.71%,1
臺南市,安定區,0544,234,110,344,15,359,611,58.76%,38.3%,1
臺南市,山上區,0572,219,108,327,39,366,855,42.81%,25.61%,1
臺南市,山上區,0573,221,96,317,22,339,836,40.55%,26.44%,1
臺南市,山上區,0574,234,119,353,29,382,753,50.73%,31.08%,1
臺南市,山上區,0575,261,96,357,21,378,788,47.97%,33.12%,1
臺南市,山上區,0576,319,153,472,25,497,984,50.51%,32.42%,1
臺南市,山上區,0577,288,148,436,7,443,972,45.58%,29.63%,1
臺南市,山上區,0578,126,51,177,3,180,553,32.55%,22.78%,1
臺南市,山上區,0579,108,49,157,7,164,378,43.39%,28.57%,1
臺南市,山上區,0580,119,54,173,12,185,392,47.19%,30.36%,1
臺南市,玉井區,0466,425,165,590,27,617,1242,49.68%,34.22%,1
臺南市,玉井區,0467,427,157,584,26,610,1141,53.46%,37.42%,1
臺南市,玉井區,0468,235,98,333,16,349,698,50%,33.67%,1
臺南市,玉井區,0469,285,128,413,23,436,849,51.35%,33.57%,1
臺南市,玉井區,0470,351,131,482,30,512,949,53.95%,36.99%,1
臺南市,玉井區,0471,198,89,287,31,318,618,51.46%,32.04%,1
臺南市,玉井區,0472,197,60,257,8,265,594,44.61%,33.16%,1
臺南市,玉井區,0473,271,110,381,22,403,927,43.47%,29.23%,1
臺南市,玉井區,0474,177,69,246,28,274,512,53.52%,34.57%,1
臺南市,玉井區,0475,165,55,220,25,245,509,48.13%,32.42%,1
臺南市,玉井區,0476,204,60,264,20,284,496,57.26%,41.13%,1
臺南市,玉井區,0477,256,94,350,16,366,759,48.22%,33.73%,1
臺南市,玉井區,0478,188,72,260,9,269,669,40.21%,28.1%,1
臺南市,玉井區,0479,257,87,344,39,383,787,48.67%,32.66%,1
臺南市,玉井區,0480,215,67,282,22,304,620,49.03%,34.68%,1
臺南市,玉井區,0481,426,32,458,46,504,987,51.06%,43.16%,1
臺南市,楠西區,0447,317,119,436,40,476,978,48.67%,32.41%,1
臺南市,楠西區,0448,313,123,436,39,475,870,54.6%,35.98%,1
臺南市,楠西區,0449,287,109,396,13,409,1160,35.26%,24.74%,1
臺南市,楠西區,0450,217,76,293,19,312,699,44.64%,31.04%,1
臺南市,楠西區,0451,288,97,385,11,396,990,40%,29.09%,1
臺南市,楠西區,0452,299,102,401,23,424,928,45.69%,32.22%,1
臺南市,楠西區,0453,243,72,315,26,341,660,51.67%,36.82%,1
臺南市,楠西區,0454,365,158,523,62,585,1187,49.28%,30.75%,1
臺南市,楠西區,0455,322,142,464,32,496,1056,46.97%,30.49%,1
臺南市,南化區,0456,228,107,335,37,372,690,53.91%,33.04%,1
臺南市,南化區,0457,226,126,352,35,387,695,55.68%,32.52%,1
臺南市,南化區,0458,223,105,328,35,363,806,45.04%,27.67%,1
臺南市,南化區,0459,173,64,237,35,272,654,41.59%,26.45%,1
臺南市,南化區,0460,178,76,254,31,285,783,36.4%,22.73%,1
臺南市,南化區,0461,145,51,196,12,208,425,48.94%,34.12%,1
臺南市,南化區,0462,186,68,254,22,276,559,49.37%,33.27%,1
臺南市,南化區,0463,357,154,511,21,532,1189,44.74%,30.03%,1
臺南市,南化區,0464,379,147,526,24,550,1044,52.68%,36.3%,1
臺南市,南化區,0465,341,122,463,26,489,941,51.97%,36.24%,1
臺南市,左鎮區,0482,127,48,175,17,192,392,48.98%,32.4%,1
臺南市,左鎮區,0483,256,65,321,24,345,644,53.57%,39.75%,1
臺南市,左鎮區,0484,133,58,191,8,199,468,42.52%,28.42%,1
臺南市,左鎮區,0485,230,91,321,15,336,753,44.62%,30.54%,1
臺南市,左鎮區,0486,107,42,149,13,162,345,46.96%,31.01%,1
臺南市,左鎮區,0487,117,45,162,12,174,393,44.27%,29.77%,1
臺南市,左鎮區,0488,168,41,209,17,226,420,53.81%,40%,1
臺南市,左鎮區,0489,87,34,121,11,132,313,42.17%,27.8%,1
臺南市,左鎮區,0490,59,15,74,3,77,186,41.4%,31.72%,1
臺南市,左鎮區,0491,145,53,198,33,231,504,45.83%,28.77%,1
臺南市,仁德區,1188,465,225,690,39,729,1318,55.31%,35.28%,1
臺南市,仁德區,1189,490,237,727,43,770,1406,54.77%,34.85%,1
臺南市,仁德區,1190,506,208,714,56,770,1465,52.56%,34.54%,1
臺南市,仁德區,1191,452,220,672,48,720,1192,60.4%,37.92%,1
臺南市,仁德區,1192,521,267,788,42,830,1429,58.08%,36.46%,1
臺南市,仁德區,1193,424,230,654,72,726,1320,55%,32.12%,1
臺南市,仁德區,1194,567,234,801,36,837,1373,60.96%,41.3%,1
臺南市,仁德區,1195,513,221,734,36,770,1330,57.89%,38.57%,1
臺南市,仁德區,1196,642,280,922,28,950,1687,56.31%,38.06%,1
臺南市,仁德區,1197,466,247,713,47,760,1491,50.97%,31.25%,1
臺南市,仁德區,1198,362,163,525,22,547,1151,47.52%,31.45%,1
臺南市,仁德區,1199,499,218,717,14,731,1407,51.95%,35.47%,1
臺南市,仁德區,1200,583,229,812,26,838,1465,57.2%,39.8%,1
臺南市,仁德區,1201,509,225,734,24,758,1335,56.78%,38.13%,1
臺南市,仁德區,1202,497,243,740,49,789,1490,52.95%,33.36%,1
臺南市,仁德區,1203,569,251,820,32,852,1453,58.64%,39.16%,1
臺南市,仁德區,1204,340,151,491,26,517,990,52.22%,34.34%,1
臺南市,仁德區,1205,613,245,858,30,888,1573,56.45%,38.97%,1
臺南市,仁德區,1206,373,163,536,32,568,1031,55.09%,36.18%,1
臺南市,仁德區,1207,408,213,621,22,643,1194,53.85%,34.17%,1
臺南市,仁德區,1208,444,180,624,41,665,1268,52.44%,35.02%,1
臺南市,仁德區,1209,322,171,493,38,531,929,57.16%,34.66%,1
臺南市,仁德區,1210,389,168,557,11,568,1145,49.61%,33.97%,1
臺南市,仁德區,1211,483,232,715,28,743,1413,52.58%,34.18%,1
臺南市,仁德區,1212,527,212,739,49,788,1465,53.79%,35.97%,1
臺南市,仁德區,1213,514,237,751,45,796,1390,57.27%,36.98%,1
臺南市,仁德區,1214,483,234,717,52,769,1396,55.09%,34.6%,1
臺南市,仁德區,1215,616,333,949,49,998,1906,52.36%,32.32%,1
臺南市,仁德區,1216,520,237,757,19,776,1546,50.19%,33.64%,1
臺南市,仁德區,1217,459,224,683,27,710,1546,45.92%,29.69%,1
臺南市,仁德區,1218,482,237,719,33,752,1399,53.75%,34.45%,1
臺南市,仁德區,1219,578,291,869,61,930,1748,53.2%,33.07%,1
臺南市,仁德區,1220,418,201,619,25,644,1140,56.49%,36.67%,1
臺南市,仁德區,1221,458,200,658,35,693,1277,54.27%,35.87%,1
臺南市,仁德區,1222,444,184,628,31,659,1019,64.67%,43.57%,1
臺南市,仁德區,1223,509,214,723,20,743,1414,52.55%,36%,1
臺南市,仁德區,1224,465,189,654,20,674,1349,49.96%,34.47%,1
臺南市,仁德區,1225,517,222,739,23,762,1471,51.8%,35.15%,1
臺南市,仁德區,1226,501,206,707,16,723,1324,54.61%,37.84%,1
臺南市,仁德區,1227,462,146,608,41,649,1310,49.54%,35.27%,1
臺南市,仁德區,1228,203,90,293,21,314,554,56.68%,36.64%,1
臺南市,仁德區,1229,552,155,707,42,749,1395,53.69%,39.57%,1
臺南市,仁德區,1230,475,168,643,14,657,1264,51.98%,37.58%,1
臺南市,仁德區,1231,435,161,596,63,659,1180,55.85%,36.86%,1
臺南市,仁德區,1232,319,137,456,21,477,928,51.4%,34.38%,1
臺南市,仁德區,1233,339,140,479,15,494,965,51.19%,35.13%,1
臺南市,仁德區,1234,397,176,573,25,598,1119,53.44%,35.48%,1
臺南市,仁德區,1235,447,173,620,40,660,1206,54.73%,37.06%,1
臺南市,仁德區,1236,509,206,715,44,759,1466,51.77%,34.72%,1
臺南市,歸仁區,1237,531,244,775,41,816,1560,52.31%,34.04%,1
臺南市,歸仁區,1238,550,260,810,34,844,1383,61.03%,39.77%,1
臺南市,歸仁區,1239,512,267,779,24,803,1491,53.86%,34.34%,1
臺南市,歸仁區,1240,492,233,725,36,761,1482,51.35%,33.2%,1
臺南市,歸仁區,1241,473,254,727,22,749,1330,56.32%,35.56%,1
臺南市,歸仁區,1242,487,272,759,32,791,1399,56.54%,34.81%,1
臺南市,歸仁區,1243,479,225,704,30,734,1416,51.84%,33.83%,1
臺南市,歸仁區,1244,361,203,564,35,599,1336,44.84%,27.02%,1
臺南市,歸仁區,1245,385,169,554,43,597,1183,50.46%,32.54%,1
臺南市,歸仁區,1246,422,192,614,21,635,1237,51.33%,34.11%,1
臺南市,歸仁區,1247,398,197,595,39,634,1133,55.96%,35.13%,1
臺南市,歸仁區,1248,380,187,567,33,600,1149,52.22%,33.07%,1
臺南市,歸仁區,1249,398,185,583,6,589,1105,53.3%,36.02%,1
臺南市,歸仁區,1250,378,188,566,46,612,1099,55.69%,34.39%,1
臺南市,歸仁區,1251,413,181,594,44,638,1082,58.96%,38.17%,1
臺南市,歸仁區,1252,593,256,849,29,878,1519,57.8%,39.04%,1
臺南市,歸仁區,1253,550,264,814,29,843,1467,57.46%,37.49%,1
臺南市,歸仁區,1254,374,174,548,30,578,1090,53.03%,34.31%,1
臺南市,歸仁區,1255,397,178,575,19,594,1131,52.52%,35.1%,1
臺南市,歸仁區,1256,386,178,564,25,589,1080,54.54%,35.74%,1
臺南市,歸仁區,1257,367,159,526,20,546,1121,48.71%,32.74%,1
臺南市,歸仁區,1258,454,237,691,35,726,1336,54.34%,33.98%,1
臺南市,歸仁區,1259,372,191,563,54,617,1128,54.7%,32.98%,1
臺南市,歸仁區,1260,376,167,543,26,569,1055,53.93%,35.64%,1
臺南市,歸仁區,1261,401,162,563,31,594,1102,53.9%,36.39%,1
臺南市,歸仁區,1262,272,197,469,29,498,1068,46.63%,25.47%,1
臺南市,歸仁區,1263,380,176,556,44,600,1033,58.08%,36.79%,1
臺南市,歸仁區,1264,508,227,735,12,747,1772,42.16%,28.67%,1
臺南市,歸仁區,1265,488,247,735,46,781,1399,55.83%,34.88%,1
臺南市,歸仁區,1266,536,257,793,28,821,1544,53.17%,34.72%,1
臺南市,歸仁區,1267,196,101,297,15,312,684,45.61%,28.65%,1
臺南市,歸仁區,1268,309,167,476,26,502,839,59.83%,36.83%,1
臺南市,歸仁區,1269,370,203,573,40,613,1014,60.45%,36.49%,1
臺南市,歸仁區,1270,471,211,682,24,706,1906,37.04%,24.71%,1
臺南市,歸仁區,1271,470,215,685,33,718,1245,57.67%,37.75%,1
臺南市,歸仁區,1272,363,175,538,22,560,1048,53.44%,34.64%,1
臺南市,歸仁區,1273,425,179,604,24,628,1175,53.45%,36.17%,1
臺南市,歸仁區,1274,441,241,682,31,713,1411,50.53%,31.25%,1
臺南市,歸仁區,1275,545,283,828,29,857,1514,56.61%,36%,1
臺南市,歸仁區,1276,561,287,848,57,905,1678,53.93%,33.43%,1
臺南市,歸仁區,1277,337,173,510,33,543,949,57.22%,35.51%,1
臺南市,歸仁區,1278,418,155,573,42,615,1009,60.95%,41.43%,1
臺南市,歸仁區,1279,408,206,614,3,617,984,62.7%,41.46%,1
臺南市,歸仁區,1280,319,116,435,22,457,756,60.45%,42.2%,1
臺南市,歸仁區,1281,571,265,836,47,883,1478,59.74%,38.63%,1
臺南市,歸仁區,1282,542,273,815,57,872,1467,59.44%,36.95%,1
臺南市,關廟區,1283,358,162,520,14,534,982,54.38%,36.46%,1
臺南市,關廟區,1284,467,190,657,42,699,1156,60.47%,40.4%,1
臺南市,關廟區,1285,330,153,483,20,503,1006,50%,32.8%,1
臺南市,關廟區,1286,404,197,601,37,638,1043,61.17%,38.73%,1
臺南市,關廟區,1287,351,187,538,53,591,1012,58.4%,34.68%,1
臺南市,關廟區,1288,309,161,470,21,491,1013,48.47%,30.5%,1
臺南市,關廟區,1289,423,194,617,35,652,1294,50.39%,32.69%,1
臺南市,關廟區,1290,419,198,617,35,652,1264,51.58%,33.15%,1
臺南市,關廟區,1291,419,173,592,40,632,1166,54.2%,35.93%,1
臺南市,關廟區,1292,341,176,517,23,540,1018,53.05%,33.5%,1
臺南市,關廟區,1293,215,94,309,34,343,733,46.79%,29.33%,1
臺南市,關廟區,1294,404,217,621,32,653,1093,59.74%,36.96%,1
臺南市,關廟區,1295,427,175,602,16,618,1081,57.17%,39.5%,1
臺南市,關廟區,1296,362,185,547,34,581,978,59.41%,37.01%,1
臺南市,關廟區,1297,319,181,500,45,545,1116,48.84%,28.58%,1
臺南市,關廟區,1298,342,137,479,44,523,972,53.81%,35.19%,1
臺南市,關廟區,1299,348,193,541,59,600,1045,57.42%,33.3%,1
臺南市,關廟區,1300,319,136,455,34,489,872,56.08%,36.58%,1
臺南市,關廟區,1301,352,196,548,42,590,1007,58.59%,34.96%,1
臺南市,關廟區,1302,296,132,428,33,461,763,60.42%,38.79%,1
臺南市,關廟區,1303,208,91,299,35,334,630,53.02%,33.02%,1
臺南市,關廟區,1304,364,157,521,40,561,959,58.5%,37.96%,1
臺南市,關廟區,1305,420,155,575,24,599,1123,53.34%,37.4%,1
臺南市,關廟區,1306,305,122,427,39,466,804,57.96%,37.94%,1
臺南市,關廟區,1307,269,116,385,15,400,720,55.56%,37.36%,1
臺南市,關廟區,1308,269,101,370,19,389,843,46.14%,31.91%,1
臺南市,關廟區,1309,111,58,169,14,183,358,51.12%,31.01%,1
臺南市,關廟區,1310,274,107,381,50,431,797,54.08%,34.38%,1
臺南市,關廟區,1311,228,86,314,15,329,709,46.4%,32.16%,1
臺南市,關廟區,1312,317,112,429,15,444,904,49.12%,35.07%,1
臺南市,關廟區,1313,344,156,500,27,527,963,54.72%,35.72%,1
臺南市,關廟區,1314,177,103,280,13,293,489,59.92%,36.2%,1
臺南市,龍崎區,1315,353,161,514,47,561,1047,53.58%,33.72%,1
臺南市,龍崎區,1316,218,77,295,21,316,630,50.16%,34.6%,1
臺南市,龍崎區,1317,38,14,52,7,59,141,41.84%,26.95%,1
臺南市,龍崎區,1318,121,53,174,10,184,367,50.14%,32.97%,1
臺南市,龍崎區,1319,125,41,166,19,185,337,54.9%,37.09%,1
臺南市,龍崎區,1320,96,42,138,6,144,318,45.28%,30.19%,1
臺南市,龍崎區,1321,152,38,190,24,214,427,50.12%,35.6%,1
臺南市,龍崎區,1322,143,48,191,12,203,446,45.52%,32.06%,1
臺南市,永康區,0708,463,263,726,39,765,1398,54.72%,33.12%,1
臺南市,永康區,0709,454,206,660,25,685,1478,46.35%,30.72%,1
臺南市,永康區,0710,464,246,710,14,724,1442,50.21%,32.18%,1
臺南市,永康區,0711,440,209,649,21,670,1353,49.52%,32.52%,1
臺南市,永康區,0712,423,181,604,20,624,1160,53.79%,36.47%,1
臺南市,永康區,0713,410,203,613,17,630,1122,56.15%,36.54%,1
臺南市,永康區,0714,416,170,586,6,592,1165,50.82%,35.71%,1
臺南市,永康區,0715,432,221,653,15,668,1317,50.72%,32.8%,1
臺南市,永康區,0716,487,195,682,23,705,1376,51.24%,35.39%,1
臺南市,永康區,0717,457,252,709,22,731,1361,53.71%,33.58%,1
臺南市,永康區,0718,494,291,785,18,803,1374,58.44%,35.95%,1
臺南市,永康區,0719,531,284,815,34,849,1709,49.68%,31.07%,1
臺南市,永康區,0720,532,264,796,33,829,1717,48.28%,30.98%,1
臺南市,永康區,0721,550,276,826,23,849,1759,48.27%,31.27%,1
臺南市,永康區,0722,558,268,826,19,845,1636,51.65%,34.11%,1
臺南市,永康區,0723,500,230,730,32,762,1442,52.84%,34.67%,1
臺南市,永康區,0724,509,250,759,20,779,1545,50.42%,32.94%,1
臺南市,永康區,0725,576,198,774,29,803,1565,51.31%,36.81%,1
臺南市,永康區,0726,533,269,802,19,821,1684,48.75%,31.65%,1
臺南市,永康區,0727,522,230,752,25,777,1548,50.19%,33.72%,1
臺南市,永康區,0728,508,249,757,18,775,1389,55.8%,36.57%,1
臺南市,永康區,0729,475,230,705,30,735,1369,53.69%,34.7%,1
臺南市,永康區,0730,539,195,734,42,776,1415,54.84%,38.09%,1
臺南市,永康區,0731,406,223,629,9,638,1386,46.03%,29.29%,1
臺南市,永康區,0732,290,135,425,7,432,1747,24.73%,16.6%,1
臺南市,永康區,0733,485,259,744,26,770,1485,51.85%,32.66%,1
臺南市,永康區,0734,574,282,856,36,892,1747,51.06%,32.86%,1
臺南市,永康區,0735,519,260,779,24,803,1744,46.04%,29.76%,1
臺南市,永康區,0736,589,261,850,28,878,1797,48.86%,32.78%,1
臺南市,永康區,0737,650,290,940,41,981,1800,54.5%,36.11%,1
臺南市,永康區,0738,602,225,827,16,843,1720,49.01%,35%,1
臺南市,永康區,0739,610,289,899,19,918,1708,53.75%,35.71%,1
臺南市,永康區,0740,582,263,845,19,864,1519,56.88%,38.31%,1
臺南市,永康區,0741,563,239,802,46,848,1497,56.65%,37.61%,1
臺南市,永康區,0742,587,238,825,22,847,1509,56.13%,38.9%,1
臺南市,永康區,0743,627,259,886,31,917,1542,59.47%,40.66%,1
臺南市,永康區,0744,520,304,824,21,845,1536,55.01%,33.85%,1
臺南市,永康區,0745,515,284,799,24,823,1531,53.76%,33.64%,1
臺南市,永康區,0746,496,246,742,23,765,1327,57.65%,37.38%,1
臺南市,永康區,0747,496,261,757,18,775,1456,53.23%,34.07%,1
臺南市,永康區,0748,479,295,774,14,788,1396,56.45%,34.31%,1
臺南市,永康區,0749,527,289,816,33,849,1636,51.89%,32.21%,1
臺南市,永康區,0750,527,310,837,27,864,1592,54.27%,33.1%,1
臺南市,永康區,0751,545,401,946,10,956,2017,47.4%,27.02%,1
臺南市,永康區,0752,248,115,363,10,373,672,55.51%,36.9%,1
臺南市,永康區,0753,526,243,769,20,789,1611,48.98%,32.65%,1
臺南市,永康區,0754,481,286,767,28,795,1502,52.93%,32.02%,1
臺南市,永康區,0755,484,257,741,11,752,1660,45.3%,29.16%,1
臺南市,永康區,0756,423,255,678,19,697,1561,44.65%,27.1%,1
臺南市,永康區,0757,491,295,786,16,802,1590,50.44%,30.88%,1
臺南市,永康區,0758,308,178,486,12,498,924,53.9%,33.33%,1
臺南市,永康區,0759,355,176,531,19,550,938,58.64%,37.85%,1
臺南市,永康區,0760,355,168,523,28,551,957,57.58%,37.1%,1
臺南市,永康區,0761,156,93,249,29,278,496,56.05%,31.45%,1
臺南市,永康區,0762,571,300,871,39,910,1717,53%,33.26%,1
臺南市,永康區,0763,497,253,750,31,781,1615,48.36%,30.77%,1
臺南市,永康區,0764,545,237,782,12,794,1554,51.09%,35.07%,1
臺南市,永康區,0765,425,175,600,20,620,1196,51.84%,35.54%,1
臺南市,永康區,0766,425,227,652,20,672,1274,52.75%,33.36%,1
臺南市,永康區,0767,422,207,629,18,647,1215,53.25%,34.73%,1
臺南市,永康區,0768,505,255,760,11,771,1457,52.92%,34.66%,1
臺南市,永康區,0769,537,245,782,14,796,1451,54.86%,37.01%,1
臺南市,永康區,0770,458,207,665,26,691,1423,48.56%,32.19%,1
臺南市,永康區,0771,522,222,744,26,770,1394,55.24%,37.45%,1
臺南市,永康區,0772,323,168,491,25,516,890,57.98%,36.29%,1
臺南市,永康區,0773,419,171,590,27,617,1018,60.61%,41.16%,1
臺南市,永康區,0774,132,66,198,17,215,368,58.42%,35.87%,1
臺南市,永康區,0775,482,219,701,30,731,1208,60.51%,39.9%,1
臺南市,永康區,0776,351,225,576,18,594,1187,50.04%,29.57%,1
臺南市,永康區,0777,448,239,687,16,703,1381,50.91%,32.44%,1
臺南市,永康區,0778,473,234,707,36,743,1405,52.88%,33.67%,1
臺南市,永康區,0779,444,236,680,48,728,1445,50.38%,30.73%,1
臺南市,永康區,0780,544,274,818,33,851,1687,50.44%,32.25%,1
臺南市,永康區,0781,466,230,696,32,728,1535,47.43%,30.36%,1
臺南市,永康區,0782,546,261,807,30,837,1542,54.28%,35.41%,1
臺南市,永康區,0783,540,265,805,22,827,1618,51.11%,33.37%,1
臺南市,永康區,0784,469,249,718,21,739,1338,55.23%,35.05%,1
臺南市,永康區,0785,468,237,705,38,743,1285,57.82%,36.42%,1
臺南市,永康區,0786,419,216,635,23,658,1240,53.06%,33.79%,1
臺南市,永康區,0787,444,199,643,32,675,1343,50.26%,33.06%,1
臺南市,永康區,0788,506,236,742,24,766,1327,57.72%,38.13%,1
臺南市,永康區,0789,509,285,794,24,818,1565,52.27%,32.52%,1
臺南市,永康區,0790,541,230,771,55,826,1476,55.96%,36.65%,1
臺南市,永康區,0791,488,266,754,23,777,1476,52.64%,33.06%,1
臺南市,永康區,0792,539,281,820,27,847,1463,57.89%,36.84%,1
臺南市,永康區,0793,362,169,531,44,575,983,58.49%,36.83%,1
臺南市,永康區,0794,436,187,623,30,653,1116,58.51%,39.07%,1
臺南市,永康區,0795,366,179,545,50,595,1117,53.27%,32.77%,1
臺南市,永康區,0796,336,167,503,32,535,1069,50.05%,31.43%,1
臺南市,永康區,0797,452,225,677,24,701,1180,59.41%,38.31%,1
臺南市,永康區,0798,428,177,605,51,656,1176,55.78%,36.39%,1
臺南市,永康區,0799,357,222,579,32,611,1158,52.76%,30.83%,1
臺南市,永康區,0800,441,224,665,47,712,1208,58.94%,36.51%,1
臺南市,永康區,0801,510,248,758,52,810,1501,53.96%,33.98%,1
臺南市,永康區,0802,490,231,721,23,744,1298,57.32%,37.75%,1
臺南市,永康區,0803,514,289,803,17,820,1542,53.18%,33.33%,1
臺南市,永康區,0804,545,287,832,28,860,1537,55.95%,35.46%,1
臺南市,永康區,0805,509,278,787,40,827,1359,60.85%,37.45%,1
臺南市,永康區,0806,361,176,537,23,560,1139,49.17%,31.69%,1
臺南市,永康區,0807,364,192,556,24,580,1158,50.09%,31.43%,1
臺南市,永康區,0808,481,266,747,39,786,1538,51.11%,31.27%,1
臺南市,永康區,0809,400,187,587,13,600,1166,51.46%,34.31%,1
臺南市,永康區,0810,414,214,628,25,653,1228,53.18%,33.71%,1
臺南市,永康區,0811,416,247,663,23,686,1200,57.17%,34.67%,1
臺南市,永康區,0812,411,213,624,17,641,1131,56.68%,36.34%,1
臺南市,永康區,0813,394,218,612,17,629,1147,54.84%,34.35%,1
臺南市,永康區,0814,474,223,697,39,736,1442,51.04%,32.87%,1
臺南市,永康區,0815,446,221,667,24,691,1325,52.15%,33.66%,1
臺南市,永康區,0816,405,175,580,22,602,1260,47.78%,32.14%,1
臺南市,永康區,0817,540,236,776,25,801,1631,49.11%,33.11%,1
臺南市,永康區,0818,509,236,745,24,769,1549,49.64%,32.86%,1
臺南市,永康區,0819,566,261,827,17,844,1666,50.66%,33.97%,1
臺南市,永康區,0820,335,129,464,34,498,1012,49.21%,33.1%,1
臺南市,永康區,0821,327,125,452,15,467,976,47.85%,33.5%,1
臺南市,永康區,0822,201,84,285,12,297,531,55.93%,37.85%,1
臺南市,永康區,0823,331,146,477,23,500,859,58.21%,38.53%,1
臺南市,永康區,0824,292,152,444,23,467,937,49.84%,31.16%,1
臺南市,永康區,0825,469,202,671,35,706,1307,54.02%,35.88%,1
臺南市,永康區,0826,496,207,703,16,719,1482,48.52%,33.47%,1
臺南市,永康區,0827,417,189,606,25,631,1341,47.05%,31.1%,1
臺南市,永康區,0828,435,229,664,34,698,1376,50.73%,31.61%,1
臺南市,永康區,0829,445,222,667,23,690,1390,49.64%,32.01%,1
臺南市,永康區,0830,535,268,803,32,835,1534,54.43%,34.88%,1
臺南市,永康區,0831,564,230,794,15,809,1460,55.41%,38.63%,1
臺南市,永康區,0832,481,219,700,13,713,1383,51.55%,34.78%,1
臺南市,永康區,0833,459,186,645,29,674,1299,51.89%,35.33%,1
臺南市,永康區,0834,452,236,688,14,702,1264,55.54%,35.76%,1
臺南市,永康區,0835,477,273,750,22,772,1355,56.97%,35.2%,1
臺南市,永康區,0836,491,204,695,23,718,1414,50.78%,34.72%,1
臺南市,永康區,0837,403,208,611,18,629,1109,56.72%,36.34%,1
臺南市,永康區,0838,408,153,561,29,590,1151,51.26%,35.45%,1
臺南市,永康區,0839,438,199,637,26,663,1026,64.62%,42.69%,1
臺南市,永康區,0840,431,147,578,18,596,1071,55.65%,40.24%,1
臺南市,永康區,0841,556,268,824,53,877,1387,63.23%,40.09%,1
臺南市,永康區,0842,519,271,790,25,815,1377,59.19%,37.69%,1
臺南市,永康區,0843,612,260,872,44,916,1687,54.3%,36.28%,1
臺南市,永康區,0844,545,275,820,29,849,1700,49.94%,32.06%,1
臺南市,永康區,0845,518,274,792,19,811,1444,56.16%,35.87%,1
臺南市,永康區,0846,511,229,740,26,766,1485,51.58%,34.41%,1
臺南市,永康區,0847,558,249,807,26,833,1717,48.51%,32.5%,1
臺南市,永康區,0848,487,275,762,36,798,1701,46.91%,28.63%,1
臺南市,永康區,0849,464,226,690,22,712,1382,51.52%,33.57%,1
臺南市,東區,1095,691,344,1035,41,1076,2681,40.13%,25.77%,1
臺南市,東區,1096,645,309,954,30,984,1811,54.33%,35.62%,1
臺南市,東區,1097,600,288,888,50,938,1491,62.91%,40.24%,1
臺南市,東區,1098,458,277,735,21,756,1378,54.86%,33.24%,1
臺南市,東區,1099,557,312,869,32,901,1552,58.05%,35.89%,1
臺南市,東區,1100,523,245,768,13,781,1326,58.9%,39.44%,1
臺南市,東區,1101,560,306,866,32,898,1594,56.34%,35.13%,1
臺南市,東區,1102,580,339,919,29,948,1639,57.84%,35.39%,1
臺南市,東區,1103,601,308,909,37,946,1724,54.87%,34.86%,1
臺南市,東區,1104,586,280,866,44,910,1629,55.86%,35.97%,1
臺南市,東區,1105,483,278,761,32,793,1399,56.68%,34.52%,1
臺南市,東區,1106,556,282,838,25,863,1534,56.26%,36.25%,1
臺南市,東區,1107,579,323,902,31,933,1656,56.34%,34.96%,1
臺南市,東區,1108,481,213,694,36,730,1322,55.22%,36.38%,1
臺南市,東區,1109,563,311,874,26,900,1620,55.56%,34.75%,1
臺南市,東區,1110,540,259,799,22,821,1331,61.68%,40.57%,1
臺南市,東區,1111,412,168,580,25,605,1039,58.23%,39.65%,1
臺南市,東區,1112,458,174,632,25,657,1257,52.27%,36.44%,1
臺南市,東區,1113,686,326,1012,63,1075,2067,52.01%,33.19%,1
臺南市,東區,1114,821,322,1143,29,1172,2153,54.44%,38.13%,1
臺南市,東區,1115,856,366,1222,28,1250,2363,52.9%,36.23%,1
臺南市,東區,1116,513,235,748,37,785,1427,55.01%,35.95%,1
臺南市,東區,1117,629,279,908,25,933,1555,60%,40.45%,1
臺南市,東區,1118,644,284,928,41,969,2115,45.82%,30.45%,1
臺南市,東區,1119,737,376,1113,47,1160,2340,49.57%,31.5%,1
臺南市,東區,1120,827,449,1276,34,1310,2474,52.95%,33.43%,1
臺南市,東區,1121,859,352,1211,34,1245,2391,52.07%,35.93%,1
臺南市,東區,1122,596,313,909,33,942,1673,56.31%,35.62%,1
臺南市,東區,1123,559,304,863,22,885,1594,55.52%,35.07%,1
臺南市,東區,1124,573,288,861,59,920,1607,57.25%,35.66%,1
臺南市,東區,1125,789,410,1199,22,1221,2087,58.51%,37.81%,1
臺南市,東區,1126,858,468,1326,30,1356,2369,57.24%,36.22%,1
臺南市,東區,1127,607,272,879,38,917,1696,54.07%,35.79%,1
臺南市,東區,1128,583,307,890,24,914,1612,56.7%,36.17%,1
臺南市,東區,1129,549,312,861,36,897,1708,52.52%,32.14%,1
臺南市,東區,1130,531,299,830,31,861,1560,55.19%,34.04%,1
臺南市,東區,1131,607,344,951,41,992,1854,53.51%,32.74%,1
臺南市,東區,1132,747,369,1116,31,1147,2278,50.35%,32.79%,1
臺南市,東區,1133,714,360,1074,38,1112,2093,53.13%,34.11%,1
臺南市,東區,1134,815,436,1251,30,1281,2242,57.14%,36.35%,1
臺南市,東區,1135,437,226,663,34,697,1152,60.5%,37.93%,1
臺南市,東區,1136,516,268,784,14,798,1318,60.55%,39.15%,1
臺南市,東區,1137,802,411,1213,35,1248,2200,56.73%,36.45%,1
臺南市,東區,1138,739,395,1134,15,1149,1960,58.62%,37.7%,1
臺南市,東區,1139,553,239,792,41,833,1489,55.94%,37.14%,1
臺南市,東區,1140,490,264,754,43,797,1443,55.23%,33.96%,1
臺南市,東區,1141,532,345,877,33,910,1498,60.75%,35.51%,1
臺南市,東區,1142,578,316,894,22,916,1622,56.47%,35.64%,1
臺南市,東區,1143,614,328,942,32,974,1738,56.04%,35.33%,1
臺南市,東區,1144,467,293,760,40,800,1501,53.3%,31.11%,1
臺南市,東區,1145,549,248,797,41,838,1482,56.55%,37.04%,1
臺南市,東區,1146,567,313,880,37,917,1829,50.14%,31%,1
臺南市,東區,1147,579,342,921,46,967,1764,54.82%,32.82%,1
臺南市,東區,1148,536,270,806,27,833,1427,58.37%,37.56%,1
臺南市,東區,1149,467,263,730,43,773,1427,54.17%,32.73%,1
臺南市,東區,1150,514,246,760,24,784,1388,56.48%,37.03%,1
臺南市,東區,1151,394,282,676,23,699,1131,61.8%,34.84%,1
臺南市,東區,1152,348,173,521,31,552,1000,55.2%,34.8%,1
臺南市,東區,1153,368,166,534,21,555,996,55.72%,36.95%,1
臺南市,東區,1154,338,130,468,31,499,935,53.37%,36.15%,1
臺南市,東區,1155,330,186,516,32,548,947,57.87%,34.85%,1
臺南市,東區,1156,361,226,587,7,594,1090,54.5%,33.12%,1
臺南市,東區,1157,315,139,454,24,478,896,53.35%,35.16%,1
臺南市,東區,1158,551,294,845,30,875,1589,55.07%,34.68%,1
臺南市,東區,1159,560,265,825,28,853,1497,56.98%,37.41%,1
臺南市,東區,1160,479,219,698,31,729,1386,52.6%,34.56%,1
臺南市,東區,1161,405,209,614,14,628,1101,57.04%,36.78%,1
臺南市,東區,1162,508,236,744,33,777,1332,58.33%,38.14%,1
臺南市,東區,1163,452,209,661,18,679,1185,57.3%,38.14%,1
臺南市,東區,1164,511,212,723,25,748,1262,59.27%,40.49%,1
臺南市,東區,1165,530,229,759,37,796,1517,52.47%,34.94%,1
臺南市,東區,1166,439,234,673,43,716,1287,55.63%,34.11%,1
臺南市,東區,1167,590,297,887,41,928,1657,56%,35.61%,1
臺南市,東區,1168,787,374,1161,63,1224,2238,54.69%,35.17%,1
臺南市,東區,1169,755,396,1151,41,1192,2246,53.07%,33.62%,1
臺南市,東區,1170,739,392,1131,41,1172,2191,53.49%,33.73%,1
臺南市,東區,1171,669,403,1072,37,1109,2063,53.76%,32.43%,1
臺南市,東區,1172,810,395,1205,51,1256,2177,57.69%,37.21%,1
臺南市,東區,1173,727,315,1042,44,1086,1863,58.29%,39.02%,1
臺南市,東區,1174,794,400,1194,32,1226,2185,56.11%,36.34%,1
臺南市,東區,1175,550,255,805,37,842,1721,48.93%,31.96%,1
臺南市,東區,1176,534,265,799,64,863,1556,55.46%,34.32%,1
臺南市,東區,1177,590,303,893,28,921,1602,57.49%,36.83%,1
臺南市,東區,1178,544,219,763,47,810,1523,53.18%,35.72%,1
臺南市,東區,1179,439,248,687,34,721,1382,52.17%,31.77%,1
臺南市,東區,1180,531,256,787,23,810,1486,54.51%,35.73%,1
臺南市,東區,1181,561,276,837,36,873,1560,55.96%,35.96%,1
臺南市,東區,1182,524,271,795,47,842,1684,50%,31.12%,1
臺南市,東區,1183,570,320,890,25,915,1653,55.35%,34.48%,1
臺南市,東區,1184,491,364,855,15,870,1554,55.98%,31.6%,1
臺南市,東區,1185,495,288,783,25,808,1408,57.39%,35.16%,1
臺南市,東區,1186,802,394,1196,30,1226,2084,58.83%,38.48%,1
臺南市,東區,1187,610,397,1007,34,1041,1896,54.91%,32.17%,1
臺南市,南區,1015,442,237,679,31,710,1221,58.15%,36.2%,1
臺南市,南區,1016,676,294,970,45,1015,2171,46.75%,31.14%,1
臺南市,南區,1017,433,218,651,20,671,1150,58.35%,37.65%,1
臺南市,南區,1018,447,190,637,25,662,1122,59%,39.84%,1
臺南市,南區,1019,478,210,688,30,718,1444,49.72%,33.1%,1
臺南市,南區,1020,550,290,840,44,884,1765,50.08%,31.16%,1
臺南市,南區,1021,494,235,729,38,767,1298,59.09%,38.06%,1
臺南市,南區,1022,564,217,781,23,804,1458,55.14%,38.68%,1
臺南市,南區,1023,661,302,963,16,979,1940,50.46%,34.07%,1
臺南市,南區,1024,556,266,822,40,862,1637,52.66%,33.96%,1
臺南市,南區,1025,247,149,396,8,404,871,46.38%,28.36%,1
臺南市,南區,1026,208,123,331,7,338,589,57.39%,35.31%,1
臺南市,南區,1027,331,170,501,32,533,801,66.54%,41.32%,1
臺南市,南區,1028,397,151,548,28,576,990,58.18%,40.1%,1
臺南市,南區,1029,498,220,718,23,741,1222,60.64%,40.75%,1
臺南市,南區,1030,382,171,553,46,599,997,60.08%,38.31%,1
臺南市,南區,1031,400,198,598,30,628,1204,52.16%,33.22%,1
臺南市,南區,1032,469,260,729,26,755,1570,48.09%,29.87%,1
臺南市,南區,1033,408,246,654,26,680,1222,55.65%,33.39%,1
臺南市,南區,1034,341,181,522,19,541,1076,50.28%,31.69%,1
臺南市,南區,1035,418,206,624,18,642,1127,56.97%,37.09%,1
臺南市,南區,1036,429,178,607,40,647,1135,57%,37.8%,1
臺南市,南區,1037,436,208,644,29,673,1263,53.29%,34.52%,1
臺南市,南區,1038,351,163,514,17,531,1014,52.37%,34.62%,1
臺南市,南區,1039,561,245,806,35,841,1491,56.41%,37.63%,1
臺南市,南區,1040,621,328,949,29,978,1815,53.88%,34.21%,1
臺南市,南區,1041,461,264,725,12,737,1398,52.72%,32.98%,1
臺南市,南區,1042,610,281,891,26,917,2107,43.52%,28.95%,1
臺南市,南區,1043,645,268,913,26,939,1587,59.17%,40.64%,1
臺南市,南區,1044,563,285,848,30,878,1626,54%,34.62%,1
臺南市,南區,1045,578,274,852,29,881,1761,50.03%,32.82%,1
臺南市,南區,1046,577,264,841,35,876,1630,53.74%,35.4%,1
臺南市,南區,1047,538,253,791,42,833,1542,54.02%,34.89%,1
臺南市,南區,1048,486,243,729,56,785,1464,53.62%,33.2%,1
臺南市,南區,1049,608,259,867,50,917,1727,53.1%,35.21%,1
臺南市,南區,1050,419,214,633,30,663,1085,61.11%,38.62%,1
臺南市,南區,1051,349,144,493,18,511,939,54.42%,37.17%,1
臺南市,南區,1052,446,203,649,35,684,1419,48.2%,31.43%,1
臺南市,南區,1053,416,217,633,40,673,1333,50.49%,31.21%,1
臺南市,南區,1054,466,252,718,26,744,1465,50.78%,31.81%,1
臺南市,南區,1055,402,192,594,19,613,1099,55.78%,36.58%,1
臺南市,南區,1056,390,170,560,18,578,1133,51.02%,34.42%,1
臺南市,南區,1057,481,191,672,49,721,1375,52.44%,34.98%,1
臺南市,南區,1058,529,275,804,33,837,1781,47%,29.7%,1
臺南市,南區,1059,587,263,850,27,877,1542,56.87%,38.07%,1
臺南市,南區,1060,489,222,711,26,737,1486,49.6%,32.91%,1
臺南市,南區,1061,604,257,861,51,912,1640,55.61%,36.83%,1
臺南市,南區,1062,519,226,745,26,771,1701,45.33%,30.51%,1
臺南市,南區,1063,519,211,730,41,771,1541,50.03%,33.68%,1
臺南市,南區,1064,667,302,969,58,1027,2027,50.67%,32.91%,1
臺南市,南區,1065,680,322,1002,41,1043,1774,58.79%,38.33%,1
臺南市,南區,1066,534,265,799,44,843,1613,52.26%,33.11%,1
臺南市,南區,1067,577,268,845,19,864,1707,50.62%,33.8%,1
臺南市,南區,1068,386,187,573,26,599,1657,36.15%,23.3%,1
臺南市,南區,1069,397,168,565,20,585,1077,54.32%,36.86%,1
臺南市,南區,1070,418,194,612,25,637,1185,53.76%,35.27%,1
臺南市,南區,1071,416,219,635,27,662,1249,53%,33.31%,1
臺南市,南區,1072,632,250,882,23,905,1985,45.59%,31.84%,1
臺南市,南區,1073,587,297,884,35,919,2017,45.56%,29.1%,1
臺南市,南區,1074,545,263,808,39,847,1717,49.33%,31.74%,1
臺南市,南區,1075,355,145,500,24,524,929,56.4%,38.21%,1
臺南市,南區,1076,232,140,372,23,395,695,56.83%,33.38%,1
臺南市,南區,1077,349,139,488,14,502,997,50.35%,35.01%,1
臺南市,南區,1078,283,107,390,10,400,784,51.02%,36.1%,1
臺南市,南區,1079,452,159,611,41,652,1119,58.27%,40.39%,1
臺南市,南區,1080,344,142,486,21,507,1054,48.1%,32.64%,1
臺南市,南區,1081,385,209,594,51,645,1245,51.81%,30.92%,1
臺南市,南區,1082,616,323,939,43,982,2064,47.58%,29.84%,1
臺南市,南區,1083,560,284,844,21,865,2056,42.07%,27.24%,1
臺南市,南區,1084,464,201,665,13,678,1373,49.38%,33.79%,1
臺南市,南區,1085,341,151,492,26,518,1002,51.7%,34.03%,1
臺南市,南區,1086,274,137,411,39,450,760,59.21%,36.05%,1
臺南市,南區,1087,363,180,543,37,580,1031,56.26%,35.21%,1
臺南市,南區,1088,253,125,378,35,413,744,55.51%,34.01%,1
臺南市,南區,1089,413,200,613,36,649,1186,54.72%,34.82%,1
臺南市,南區,1090,493,220,713,33,746,1358,54.93%,36.3%,1
臺南市,南區,1091,293,129,422,16,438,897,48.83%,32.66%,1
臺南市,南區,1092,445,195,640,27,667,1265,52.73%,35.18%,1
臺南市,南區,1093,371,163,534,22,556,1093,50.87%,33.94%,1
臺南市,南區,1094,384,181,565,18,583,1016,57.38%,37.8%,1
臺南市,北區,0850,585,282,867,44,911,1793,50.81%,32.63%,1
臺南市,北區,0851,592,235,827,38,865,1708,50.64%,34.66%,1
臺南市,北區,0852,311,197,508,7,515,997,51.65%,31.19%,1
臺南市,北區,0853,374,262,636,18,654,1452,45.04%,25.76%,1
臺南市,北區,0854,432,238,670,20,690,1351,51.07%,31.98%,1
臺南市,北區,0855,532,269,801,33,834,1323,63.04%,40.21%,1
臺南市,北區,0856,441,163,604,29,633,1073,58.99%,41.1%,1
臺南市,北區,0857,446,200,646,24,670,1138,58.88%,39.19%,1
臺南市,北區,0858,444,173,617,25,642,1189,53.99%,37.34%,1
臺南市,北區,0859,475,263,738,32,770,1262,61.01%,37.64%,1
臺南市,北區,0860,385,207,592,19,611,1017,60.08%,37.86%,1
臺南市,北區,0861,304,155,459,16,475,847,56.08%,35.89%,1
臺南市,北區,0862,422,173,595,30,625,1076,58.09%,39.22%,1
臺南市,北區,0863,365,191,556,14,570,954,59.75%,38.26%,1
臺南市,北區,0864,462,191,653,48,701,1300,53.92%,35.54%,1
臺南市,北區,0865,514,192,706,29,735,1390,52.88%,36.98%,1
臺南市,北區,0866,501,206,707,36,743,1318,56.37%,38.01%,1
臺南市,北區,0867,354,165,519,11,530,974,54.41%,36.34%,1
臺南市,北區,0868,350,174,524,21,545,990,55.05%,35.35%,1
臺南市,北區,0869,375,233,608,19,627,1016,61.71%,36.91%,1
臺南市,北區,0870,391,174,565,27,592,1053,56.22%,37.13%,1
臺南市,北區,0871,495,226,721,46,767,1466,52.32%,33.77%,1
臺南市,北區,0872,559,255,814,42,856,1535,55.77%,36.42%,1
臺南市,北區,0873,559,117,676,36,712,1544,46.11%,36.2%,1
臺南市,北區,0874,663,291,954,39,993,1760,56.42%,37.67%,1
臺南市,北區,0875,491,219,710,31,741,1372,54.01%,35.79%,1
臺南市,北區,0876,393,166,559,27,586,1002,58.48%,39.22%,1
臺南市,北區,0877,452,194,646,40,686,1171,58.58%,38.6%,1
臺南市,北區,0878,423,195,618,23,641,1285,49.88%,32.92%,1
臺南市,北區,0879,384,130,514,34,548,1036,52.9%,37.07%,1
臺南市,北區,0880,494,222,716,33,749,1392,53.81%,35.49%,1
臺南市,北區,0881,453,154,607,36,643,1147,56.06%,39.49%,1
臺南市,北區,0882,497,197,694,30,724,1526,47.44%,32.57%,1
臺南市,北區,0883,559,270,829,24,853,1559,54.71%,35.86%,1
臺南市,北區,0884,313,141,454,58,512,892,57.4%,35.09%,1
臺南市,北區,0885,304,155,459,28,487,937,51.97%,32.44%,1
臺南市,北區,0886,523,268,791,43,834,1449,57.56%,36.09%,1
臺南市,北區,0887,415,192,607,20,627,1160,54.05%,35.78%,1
臺南市,北區,0888,368,203,571,32,603,1567,38.48%,23.48%,1
臺南市,北區,0889,481,217,698,30,728,1346,54.09%,35.74%,1
臺南市,北區,0890,469,224,693,15,708,1451,48.79%,32.32%,1
臺南市,北區,0891,526,261,787,24,811,1522,53.29%,34.56%,1
臺南市,北區,0892,460,196,656,20,676,1278,52.9%,35.99%,1
臺南市,北區,0893,382,186,568,39,607,1164,52.15%,32.82%,1
臺南市,北區,0894,365,191,556,9,565,1091,51.79%,33.46%,1
臺南市,北區,0895,362,152,514,25,539,993,54.28%,36.46%,1
臺南市,北區,0896,377,145,522,18,540,1119,48.26%,33.69%,1
臺南市,北區,0897,575,304,879,52,931,1685,55.25%,34.12%,1
臺南市,北區,0898,464,263,727,17,744,1368,54.39%,33.92%,1
臺南市,北區,0899,475,248,723,33,756,1389,54.43%,34.2%,1
臺南市,北區,0900,540,294,834,20,854,1469,58.13%,36.76%,1
臺南市,北區,0901,600,323,923,32,955,1655,57.7%,36.25%,1
臺南市,北區,0902,450,248,698,18,716,1261,56.78%,35.69%,1
臺南市,北區,0903,523,258,781,15,796,1490,53.42%,35.1%,1
臺南市,北區,0904,531,278,809,23,832,1436,57.94%,36.98%,1
臺南市,北區,0905,513,231,744,49,793,1340,59.18%,38.28%,1
臺南市,北區,0906,485,293,778,29,807,1464,55.12%,33.13%,1
臺南市,北區,0907,550,307,857,18,875,1513,57.83%,36.35%,1
臺南市,北區,0908,584,364,948,20,968,1709,56.64%,34.17%,1
臺南市,北區,0909,544,336,880,30,910,1517,59.99%,35.86%,1
臺南市,北區,0910,528,302,830,17,847,1598,53%,33.04%,1
臺南市,北區,0911,427,283,710,34,744,1399,53.18%,30.52%,1
臺南市,北區,0912,429,191,620,48,668,1214,55.02%,35.34%,1
臺南市,北區,0913,353,235,588,16,604,1064,56.77%,33.18%,1
臺南市,北區,0914,418,256,674,30,704,1148,61.32%,36.41%,1
臺南市,北區,0915,518,254,772,30,802,1391,57.66%,37.24%,1
臺南市,北區,0916,588,290,878,27,905,1584,57.13%,37.12%,1
臺南市,北區,0917,573,297,870,23,893,1595,55.99%,35.92%,1
臺南市,北區,0918,500,237,737,26,763,1397,54.62%,35.79%,1
臺南市,北區,0919,541,322,863,29,892,1662,53.67%,32.55%,1
臺南市,北區,0920,522,308,830,20,850,1634,52.02%,31.95%,1
臺南市,北區,0921,686,295,981,36,1017,1793,56.72%,38.26%,1
臺南市,北區,0922,669,347,1016,45,1061,1872,56.68%,35.74%,1
臺南市,北區,0923,654,329,983,36,1019,1874,54.38%,34.9%,1
臺南市,北區,0924,609,259,868,51,919,1760,52.22%,34.6%,1
臺南市,北區,0925,567,288,855,51,906,1753,51.68%,32.34%,1
臺南市,北區,0926,435,246,681,17,698,1502,46.47%,28.96%,1
臺南市,北區,0927,506,268,774,26,800,1470,54.42%,34.42%,1
臺南市,北區,0928,458,208,666,43,709,1319,53.75%,34.72%,1
臺南市,北區,0929,701,321,1022,34,1056,1876,56.29%,37.37%,1
臺南市,北區,0930,585,313,898,14,912,1720,53.02%,34.01%,1
臺南市,安南區,0618,863,459,1322,33,1355,2549,53.16%,33.86%,1
臺南市,安南區,0619,806,367,1173,49,1222,2321,52.65%,34.73%,1
臺南市,安南區,0620,768,383,1151,43,1194,2156,55.38%,35.62%,1
臺南市,安南區,0621,640,280,920,55,975,1662,58.66%,38.51%,1
臺南市,安南區,0622,614,228,842,62,904,1512,59.79%,40.61%,1
臺南市,安南區,0623,552,232,784,42,826,1625,50.83%,33.97%,1
臺南市,安南區,0624,680,320,1000,39,1039,2143,48.48%,31.73%,1
臺南市,安南區,0625,863,412,1275,53,1328,2457,54.05%,35.12%,1
臺南市,安南區,0626,744,395,1139,64,1203,2148,56.01%,34.64%,1
臺南市,安南區,0627,766,403,1169,58,1227,2364,51.9%,32.4%,1
臺南市,安南區,0628,568,324,892,33,925,1868,49.52%,30.41%,1
臺南市,安南區,0629,670,340,1010,42,1052,1797,58.54%,37.28%,1
臺南市,安南區,0630,818,342,1160,52,1212,2268,53.44%,36.07%,1
臺南市,安南區,0631,697,329,1026,41,1067,2291,46.57%,30.42%,1
臺南市,安南區,0632,769,340,1109,39,1148,2255,50.91%,34.1%,1
臺南市,安南區,0633,582,325,907,42,949,1940,48.92%,30%,1
臺南市,安南區,0634,728,364,1092,33,1125,2013,55.89%,36.16%,1
臺南市,安南區,0635,689,309,998,38,1036,2024,51.19%,34.04%,1
臺南市,安南區,0636,599,342,941,49,990,1613,61.38%,37.14%,1
臺南市,安南區,0637,408,185,593,33,626,1178,53.14%,34.63%,1
臺南市,安南區,0638,753,334,1087,65,1152,2143,53.76%,35.14%,1
臺南市,安南區,0639,575,341,916,51,967,1721,56.19%,33.41%,1
臺南市,安南區,0640,649,314,963,49,1012,1773,57.08%,36.6%,1
臺南市,安南區,0641,518,252,770,15,785,1428,54.97%,36.27%,1
臺南市,安南區,0642,578,281,859,34,893,1626,54.92%,35.55%,1
臺南市,安南區,0643,448,252,700,35,735,1358,54.12%,32.99%,1
臺南市,安南區,0644,567,260,827,27,854,1447,59.02%,39.18%,1
臺南市,安南區,0645,464,241,705,69,774,1358,57%,34.17%,1
臺南市,安南區,0646,698,324,1022,43,1065,2116,50.33%,32.99%,1
臺南市,安南區,0647,758,349,1107,33,1140,2321,49.12%,32.66%,1
臺南市,安南區,0648,721,322,1043,35,1078,2117,50.92%,34.06%,1
臺南市,安南區,0649,589,310,899,64,963,1927,49.97%,30.57%,1
臺南市,安南區,0650,709,365,1074,73,1147,2242,51.16%,31.62%,1
臺南市,安南區,0651,765,341,1106,49,1155,2334,49.49%,32.78%,1
臺南市,安南區,0652,650,296,946,47,993,1822,54.5%,35.68%,1
臺南市,安南區,0653,652,314,966,55,1021,1813,56.32%,35.96%,1
臺南市,安南區,0654,733,378,1111,58,1169,2188,53.43%,33.5%,1
臺南市,安南區,0655,785,336,1121,55,1176,2399,49.02%,32.72%,1
臺南市,安南區,0656,681,326,1007,61,1068,2247,47.53%,30.31%,1
臺南市,安南區,0657,444,234,678,49,727,1165,62.4%,38.11%,1
臺南市,安南區,0658,502,242,744,41,785,1539,51.01%,32.62%,1
臺南市,安南區,0659,668,302,970,70,1040,1835,56.68%,36.4%,1
臺南市,安南區,0660,614,305,919,61,980,1797,54.54%,34.17%,1
臺南市,安南區,0661,649,374,1023,69,1092,2223,49.12%,29.19%,1
臺南市,安南區,0662,368,196,564,60,624,977,63.87%,37.67%,1
臺南市,安南區,0663,502,249,751,18,769,1642,46.83%,30.57%,1
臺南市,安南區,0664,574,309,883,58,941,1697,55.45%,33.82%,1
臺南市,安南區,0665,627,295,922,45,967,1966,49.19%,31.89%,1
臺南市,安南區,0666,431,219,650,53,703,1319,53.3%,32.68%,1
臺南市,安南區,0667,580,310,890,45,935,1909,48.98%,30.38%,1
臺南市,安南區,0668,614,287,901,46,947,1763,53.72%,34.83%,1
臺南市,安南區,0669,308,161,469,50,519,965,53.78%,31.92%,1
臺南市,安南區,0670,358,311,669,46,715,1547,46.22%,23.14%,1
臺南市,安南區,0671,577,288,865,47,912,1784,51.12%,32.34%,1
臺南市,安南區,0672,686,307,993,40,1033,2145,48.16%,31.98%,1
臺南市,安南區,0673,869,410,1279,32,1311,2443,53.66%,35.57%,1
臺南市,安南區,0674,796,320,1116,20,1136,2565,44.29%,31.03%,1
臺南市,安南區,0675,835,397,1232,59,1291,2480,52.06%,33.67%,1
臺南市,安南區,0676,643,354,997,62,1059,2349,45.08%,27.37%,1
臺南市,安南區,0677,730,376,1106,58,1164,2168,53.69%,33.67%,1
臺南市,安南區,0678,575,245,820,35,855,1630,52.45%,35.28%,1
臺南市,安南區,0679,547,218,765,43,808,1675,48.24%,32.66%,1
臺南市,安南區,0680,665,303,968,51,1019,1627,62.63%,40.87%,1
臺南市,安南區,0681,572,215,787,38,825,1493,55.26%,38.31%,1
臺南市,安南區,0682,519,228,747,42,789,1397,56.48%,37.15%,1
臺南市,安南區,0683,494,222,716,40,756,1416,53.39%,34.89%,1
臺南市,安南區,0684,516,251,767,18,785,1460,53.77%,35.34%,1
臺南市,安南區,0685,665,304,969,48,1017,2222,45.77%,29.93%,1
臺南市,安南區,0686,690,340,1030,68,1098,2070,53.04%,33.33%,1
臺南市,安南區,0687,626,310,936,30,966,1739,55.55%,36%,1
臺南市,安南區,0688,626,268,894,45,939,1830,51.31%,34.21%,1
臺南市,安南區,0689,680,331,1011,48,1059,1803,58.74%,37.71%,1
臺南市,安南區,0690,646,342,988,32,1020,1800,56.67%,35.89%,1
臺南市,安南區,0691,529,286,815,36,851,1815,46.89%,29.15%,1
臺南市,安南區,0692,614,267,881,33,914,1846,49.51%,33.26%,1
臺南市,安南區,0693,358,170,528,29,557,905,61.55%,39.56%,1
臺南市,安南區,0694,408,222,630,34,664,1073,61.88%,38.02%,1
臺南市,安南區,0695,593,263,856,61,917,1579,58.07%,37.56%,1
臺南市,安南區,0696,615,284,899,76,975,1876,51.97%,32.78%,1
臺南市,安南區,0697,378,206,584,39,623,1194,52.18%,31.66%,1
臺南市,安南區,0698,408,186,594,31,625,1475,42.37%,27.66%,1
臺南市,安南區,0699,492,200,692,16,708,1380,51.3%,35.65%,1
臺南市,安南區,0700,445,273,718,27,745,1462,50.96%,30.44%,1
臺南市,安南區,0701,426,159,585,33,618,1044,59.2%,40.8%,1
臺南市,安南區,0702,232,113,345,50,395,603,65.51%,38.47%,1
臺南市,安南區,0703,246,123,369,30,399,690,57.83%,35.65%,1
臺南市,安南區,0704,449,232,681,42,723,1447,49.97%,31.03%,1
臺南市,安南區,0705,398,166,564,35,599,910,65.82%,43.74%,1
臺南市,安南區,0706,591,270,861,43,904,1850,48.86%,31.95%,1
臺南市,安南區,0707,568,288,856,33,889,1501,59.23%,37.84%,1
臺南市,安平區,0983,641,290,931,43,974,1753,55.56%,36.57%,1
臺南市,安平區,0984,607,324,931,29,960,1859,51.64%,32.65%,1
臺南市,安平區,0985,517,271,788,23,811,1382,58.68%,37.41%,1
臺南市,安平區,0986,872,388,1260,31,1291,2547,50.69%,34.24%,1
臺南市,安平區,0987,788,430,1218,38,1256,2407,52.18%,32.74%,1
臺南市,安平區,0988,593,352,945,27,972,2070,46.96%,28.65%,1
臺南市,安平區,0989,727,395,1122,16,1138,2132,53.38%,34.1%,1
臺南市,安平區,0990,522,273,795,11,806,1450,55.59%,36%,1
臺南市,安平區,0991,508,294,802,17,819,1605,51.03%,31.65%,1
臺南市,安平區,0992,602,316,918,28,946,1755,53.9%,34.3%,1
臺南市,安平區,0993,522,271,793,27,820,1728,47.45%,30.21%,1
臺南市,安平區,0994,459,278,737,20,757,1754,43.16%,26.17%,1
臺南市,安平區,0995,543,294,837,35,872,1686,51.72%,32.21%,1
臺南市,安平區,0996,669,302,971,28,999,1843,54.21%,36.3%,1
臺南市,安平區,0997,566,296,862,26,888,1565,56.74%,36.17%,1
臺南市,安平區,0998,471,235,706,10,716,1288,55.59%,36.57%,1
臺南市,安平區,0999,518,292,810,11,821,1653,49.67%,31.34%,1
臺南市,安平區,1000,562,272,834,7,841,1697,49.56%,33.12%,1
臺南市,安平區,1001,649,342,991,27,1018,2154,47.26%,30.13%,1
臺南市,安平區,1002,678,324,1002,30,1032,2107,48.98%,32.18%,1
臺南市,安平區,1003,582,318,900,27,927,1675,55.34%,34.75%,1
臺南市,安平區,1004,616,375,991,35,1026,1979,51.84%,31.13%,1
臺南市,安平區,1005,483,294,777,22,799,1602,49.88%,30.15%,1
臺南市,安平區,1006,505,284,789,17,806,1586,50.82%,31.84%,1
臺南市,安平區,1007,148,60,208,4,212,438,48.4%,33.79%,1
臺南市,安平區,1008,553,317,870,33,903,1780,50.73%,31.07%,1
臺南市,安平區,1009,498,289,787,29,816,1623,50.28%,30.68%,1
臺南市,安平區,1010,705,313,1018,51,1069,2157,49.56%,32.68%,1
臺南市,安平區,1011,445,201,646,30,676,1286,52.57%,34.6%,1
臺南市,安平區,1012,507,246,753,36,789,1492,52.88%,33.98%,1
臺南市,安平區,1013,440,187,627,13,640,1325,48.3%,33.21%,1
臺南市,安平區,1014,651,286,937,54,991,2001,49.53%,32.53%,1
臺南市,中西區,0931,338,359,697,43,740,1332,55.56%,25.38%,1
臺南市,中西區,0932,479,207,686,41,727,1246,58.35%,38.44%,1
臺南市,中西區,0933,451,183,634,44,678,1276,53.13%,35.34%,1
臺南市,中西區,0934,563,312,875,32,907,1583,57.3%,35.57%,1
臺南市,中西區,0935,503,307,810,28,838,1464,57.24%,34.36%,1
臺南市,中西區,0936,393,245,638,17,655,1234,53.08%,31.85%,1
臺南市,中西區,0937,394,372,766,24,790,1368,57.75%,28.8%,1
臺南市,中西區,0938,431,210,641,26,667,1322,50.45%,32.6%,1
臺南市,中西區,0939,386,231,617,28,645,1216,53.04%,31.74%,1
臺南市,中西區,0940,446,234,680,23,703,1289,54.54%,34.6%,1
臺南市,中西區,0941,481,202,683,22,705,1237,56.99%,38.88%,1
臺南市,中西區,0942,372,197,569,26,595,1189,50.04%,31.29%,1
臺南市,中西區,0943,427,224,651,37,688,1201,57.29%,35.55%,1
臺南市,中西區,0944,420,182,602,37,639,1065,60%,39.44%,1
臺南市,中西區,0945,416,180,596,26,622,1055,58.96%,39.43%,1
臺南市,中西區,0946,442,251,693,24,717,1170,61.28%,37.78%,1
臺南市,中西區,0947,538,239,777,24,801,1280,62.58%,42.03%,1
臺南市,中西區,0948,415,246,661,35,696,1223,56.91%,33.93%,1
臺南市,中西區,0949,489,227,716,41,757,1292,58.59%,37.85%,1
臺南市,中西區,0950,369,208,577,13,590,993,59.42%,37.16%,1
臺南市,中西區,0951,518,307,825,33,858,1541,55.68%,33.61%,1
臺南市,中西區,0952,609,345,954,43,997,1652,60.35%,36.86%,1
臺南市,中西區,0953,441,226,667,22,689,1212,56.85%,36.39%,1
臺南市,中西區,0954,591,293,884,41,925,1621,57.06%,36.46%,1
臺南市,中西區,0955,566,348,914,31,945,1660,56.93%,34.1%,1
臺南市,中西區,0956,563,276,839,31,870,1595,54.55%,35.3%,1
臺南市,中西區,0957,495,240,735,35,770,1436,53.62%,34.47%,1
臺南市,中西區,0958,460,220,680,44,724,1265,57.23%,36.36%,1
臺南市,中西區,0959,350,156,506,27,533,856,62.27%,40.89%,1
臺南市,中西區,0960,417,181,598,29,627,1168,53.68%,35.7%,1
臺南市,中西區,0961,411,227,638,32,670,1134,59.08%,36.24%,1
臺南市,中西區,0962,393,201,594,32,626,995,62.91%,39.5%,1
臺南市,中西區,0963,552,234,786,28,814,1313,62%,42.04%,1
臺南市,中西區,0964,472,256,728,30,758,1265,59.92%,37.31%,1
臺南市,中西區,0965,399,222,621,31,652,1215,53.66%,32.84%,1
臺南市,中西區,0966,444,225,669,25,694,1248,55.61%,35.58%,1
臺南市,中西區,0967,222,139,361,22,383,687,55.75%,32.31%,1
臺南市,中西區,0968,402,190,592,49,641,1139,56.28%,35.29%,1
臺南市,中西區,0969,371,169,540,27,567,971,58.39%,38.21%,1
臺南市,中西區,0970,353,158,511,42,553,1254,44.1%,28.15%,1
臺南市,中西區,0971,388,164,552,28,580,979,59.24%,39.63%,1
臺南市,中西區,0972,590,281,871,41,912,1745,52.26%,33.81%,1
臺南市,中西區,0973,366,193,559,32,591,1074,55.03%,34.08%,1
臺南市,中西區,0974,516,182,698,28,726,1436,50.56%,35.93%,1
臺南市,中西區,0975,287,177,464,37,501,865,57.92%,33.18%,1
臺南市,中西區,0976,420,194,614,25,639,1164,54.9%,36.08%,1
臺南市,中西區,0977,410,217,627,31,658,1285,51.21%,31.91%,1
臺南市,中西區,0978,375,186,561,33,594,1078,55.1%,34.79%,1
臺南市,中西區,0979,555,220,775,43,818,1704,48%,32.57%,1
臺南市,中西區,0980,502,215,717,43,760,1296,58.64%,38.73%,1
臺南市,中西區,0981,387,215,602,35,637,1128,56.47%,34.31%,1
臺南市,中西區,0982,435,234,669,20,689,1245,55.34%,34.94%,1
高雄市,鹽埕區,0845,526,273,799,38,837,1304,64.19%,40.34%,1
高雄市,鹽埕區,0846,163,61,224,7,231,357,64.71%,45.66%,1
高雄市,鹽埕區,0847,263,134,397,15,412,651,63.29%,40.4%,1
高雄市,鹽埕區,0848,477,211,688,21,709,1322,53.63%,36.08%,1
高雄市,鹽埕區,0849,419,210,629,18,647,1056,61.27%,39.68%,1
高雄市,鹽埕區,0850,369,198,567,17,584,904,64.6%,40.82%,1
高雄市,鹽埕區,0851,456,195,651,24,675,1130,59.73%,40.35%,1
高雄市,鹽埕區,0852,367,151,518,19,537,840,63.93%,43.69%,1
高雄市,鹽埕區,0853,272,151,423,18,441,616,71.59%,44.16%,1
高雄市,鹽埕區,0854,466,266,732,27,759,1397,54.33%,33.36%,1
高雄市,鹽埕區,0855,290,165,455,11,466,766,60.84%,37.86%,1
高雄市,鹽埕區,0856,317,167,484,27,511,839,60.91%,37.78%,1
高雄市,鹽埕區,0857,343,159,502,12,514,805,63.85%,42.61%,1
高雄市,鹽埕區,0858,285,138,423,12,435,750,58%,38%,1
高雄市,鹽埕區,0859,371,192,563,21,584,986,59.23%,37.63%,1
高雄市,鹽埕區,0860,420,176,596,7,603,1068,56.46%,39.33%,1
高雄市,鹽埕區,0861,388,218,606,22,628,1060,59.25%,36.6%,1
高雄市,鹽埕區,0862,281,154,435,29,464,805,57.64%,34.91%,1
高雄市,鹽埕區,0863,376,191,567,19,586,1073,54.61%,35.04%,1
高雄市,鹽埕區,0864,313,162,475,24,499,921,54.18%,33.98%,1
高雄市,鹽埕區,0865,449,200,649,27,676,1171,57.73%,38.34%,1
高雄市,鹽埕區,0866,215,136,351,9,360,594,60.61%,36.2%,1
高雄市,鹽埕區,0867,252,116,368,14,382,592,64.53%,42.57%,1
高雄市,鹽埕區,0868,213,109,322,19,341,610,55.9%,34.92%,1
高雄市,鼓山區,0768,373,155,528,15,543,959,56.62%,38.89%,1
高雄市,鼓山區,0769,443,199,642,29,671,1000,67.1%,44.3%,1
高雄市,鼓山區,0770,403,142,545,16,561,910,61.65%,44.29%,1
高雄市,鼓山區,0771,497,188,685,33,718,1085,66.18%,45.81%,1
高雄市,鼓山區,0772,534,197,731,27,758,1484,51.08%,35.98%,1
高雄市,鼓山區,0773,609,226,835,22,857,1393,61.52%,43.72%,1
高雄市,鼓山區,0774,573,152,725,36,761,1270,59.92%,45.12%,1
高雄市,鼓山區,0775,440,188,628,23,651,1055,61.71%,41.71%,1
高雄市,鼓山區,0776,476,208,684,21,705,1172,60.15%,40.61%,1
高雄市,鼓山區,0777,526,215,741,27,768,1175,65.36%,44.77%,1
高雄市,鼓山區,0778,553,227,780,36,816,1274,64.05%,43.41%,1
高雄市,鼓山區,0779,397,170,567,23,590,1085,54.38%,36.59%,1
高雄市,鼓山區,0780,575,254,829,36,865,1470,58.84%,39.12%,1
高雄市,鼓山區,0781,413,212,625,25,650,974,66.74%,42.4%,1
高雄市,鼓山區,0782,526,134,660,46,706,1275,55.37%,41.25%,1
高雄市,鼓山區,0783,478,224,702,40,742,1206,61.53%,39.64%,1
高雄市,鼓山區,0784,521,227,748,18,766,1238,61.87%,42.08%,1
高雄市,鼓山區,0785,382,101,483,16,499,721,69.21%,52.98%,1
高雄市,鼓山區,0786,472,208,680,26,706,1220,57.87%,38.69%,1
高雄市,鼓山區,0787,691,304,995,42,1037,1966,52.75%,35.15%,1
高雄市,鼓山區,0788,671,277,948,45,993,1722,57.67%,38.97%,1
高雄市,鼓山區,0789,650,300,950,36,986,1720,57.33%,37.79%,1
高雄市,鼓山區,0790,553,230,783,53,836,1287,64.96%,42.97%,1
高雄市,鼓山區,0791,421,201,622,16,638,1369,46.6%,30.75%,1
高雄市,鼓山區,0792,536,227,763,26,789,1222,64.57%,43.86%,1
高雄市,鼓山區,0793,722,301,1023,35,1058,1770,59.77%,40.79%,1
高雄市,鼓山區,0794,699,351,1050,35,1085,1860,58.33%,37.58%,1
高雄市,鼓山區,0795,718,339,1057,28,1085,1857,58.43%,38.66%,1
高雄市,鼓山區,0796,728,367,1095,26,1121,1841,60.89%,39.54%,1
高雄市,鼓山區,0797,727,378,1105,33,1138,1830,62.19%,39.73%,1
高雄市,鼓山區,0798,708,352,1060,28,1088,1809,60.14%,39.14%,1
高雄市,鼓山區,0799,754,383,1137,35,1172,1894,61.88%,39.81%,1
高雄市,鼓山區,0800,766,376,1142,22,1164,1882,61.85%,40.7%,1
高雄市,鼓山區,0801,774,409,1183,34,1217,1894,64.26%,40.87%,1
高雄市,鼓山區,0802,692,287,979,33,1012,1745,57.99%,39.66%,1
高雄市,鼓山區,0803,689,375,1064,14,1078,1887,57.13%,36.51%,1
高雄市,鼓山區,0804,794,413,1207,31,1238,1891,65.47%,41.99%,1
高雄市,鼓山區,0805,766,386,1152,28,1180,1903,62.01%,40.25%,1
高雄市,鼓山區,0806,752,449,1201,21,1222,1998,61.16%,37.64%,1
高雄市,鼓山區,0807,779,376,1155,28,1183,1912,61.87%,40.74%,1
高雄市,鼓山區,0808,772,395,1167,38,1205,1923,62.66%,40.15%,1
高雄市,鼓山區,0809,754,411,1165,22,1187,1888,62.87%,39.94%,1
高雄市,鼓山區,0810,783,367,1150,20,1170,1873,62.47%,41.8%,1
高雄市,鼓山區,0811,989,312,1301,23,1324,1959,67.59%,50.48%,1
高雄市,鼓山區,0812,817,392,1209,33,1242,1897,65.47%,43.07%,1
高雄市,鼓山區,0813,927,485,1412,30,1442,2362,61.05%,39.25%,1
高雄市,鼓山區,0814,776,345,1121,35,1156,1850,62.49%,41.95%,1
高雄市,鼓山區,0815,784,405,1189,21,1210,1928,62.76%,40.66%,1
高雄市,鼓山區,0816,759,347,1106,19,1125,1937,58.08%,39.18%,1
高雄市,鼓山區,0817,862,377,1239,38,1277,2123,60.15%,40.6%,1
高雄市,鼓山區,0818,802,402,1204,14,1218,1861,65.45%,43.1%,1
高雄市,鼓山區,0819,751,360,1111,25,1136,1892,60.04%,39.69%,1
高雄市,鼓山區,0820,813,458,1271,32,1303,2147,60.69%,37.87%,1
高雄市,鼓山區,0821,802,362,1164,25,1189,1897,62.68%,42.28%,1
高雄市,鼓山區,0822,805,397,1202,29,1231,2041,60.31%,39.44%,1
高雄市,鼓山區,0823,532,226,758,36,794,1309,60.66%,40.64%,1
高雄市,鼓山區,0824,756,352,1108,33,1141,1867,61.11%,40.49%,1
高雄市,鼓山區,0825,524,239,763,21,784,1152,68.06%,45.49%,1
高雄市,鼓山區,0826,599,269,868,43,911,1404,64.89%,42.66%,1
高雄市,鼓山區,0827,405,151,556,21,577,1210,47.69%,33.47%,1
高雄市,鼓山區,0828,476,207,683,28,711,1135,62.64%,41.94%,1
高雄市,鼓山區,0829,457,182,639,44,683,1831,37.3%,24.96%,1
高雄市,鼓山區,0830,544,101,645,37,682,1288,52.95%,42.24%,1
高雄市,鼓山區,0831,506,192,698,19,717,1241,57.78%,40.77%,1
高雄市,鼓山區,0832,536,263,799,29,828,1342,61.7%,39.94%,1
高雄市,鼓山區,0833,644,180,824,72,896,1422,63.01%,45.29%,1
高雄市,鼓山區,0834,627,246,873,55,928,1453,63.87%,43.15%,1
高雄市,鼓山區,0835,272,114,386,21,407,616,66.07%,44.16%,1
高雄市,鼓山區,0836,347,136,483,34,517,834,61.99%,41.61%,1
高雄市,鼓山區,0837,401,158,559,21,580,969,59.86%,41.38%,1
高雄市,鼓山區,0838,418,159,577,26,603,978,61.66%,42.74%,1
高雄市,鼓山區,0839,310,161,471,34,505,760,66.45%,40.79%,1
高雄市,鼓山區,0840,518,198,716,44,760,1248,60.9%,41.51%,1
高雄市,鼓山區,0841,441,192,633,21,654,1143,57.22%,38.58%,1
高雄市,鼓山區,0842,486,216,702,39,741,1358,54.57%,35.79%,1
高雄市,鼓山區,0843,388,159,547,15,562,1036,54.25%,37.45%,1
高雄市,鼓山區,0844,223,113,336,11,347,580,59.83%,38.45%,1
高雄市,左營區,0534,626,253,879,39,918,2604,35.25%,24.04%,1
高雄市,左營區,0535,426,183,609,38,647,1037,62.39%,41.08%,1
高雄市,左營區,0536,233,97,330,31,361,542,66.61%,42.99%,1
高雄市,左營區,0537,269,98,367,32,399,635,62.83%,42.36%,1
高雄市,左營區,0538,184,77,261,14,275,518,53.09%,35.52%,1
高雄市,左營區,0539,351,122,473,34,507,813,62.36%,43.17%,1
高雄市,左營區,0540,349,144,493,62,555,889,62.43%,39.26%,1
高雄市,左營區,0541,283,133,416,55,471,731,64.43%,38.71%,1
高雄市,左營區,0542,605,227,832,41,873,1592,54.84%,38%,1
高雄市,左營區,0543,665,337,1002,40,1042,1709,60.97%,38.91%,1
高雄市,左營區,0544,691,189,880,46,926,1588,58.31%,43.51%,1
高雄市,左營區,0545,167,38,205,7,212,358,59.22%,46.65%,1
高雄市,左營區,0546,371,74,445,12,457,666,68.62%,55.71%,1
高雄市,左營區,0547,729,265,994,44,1038,1748,59.38%,41.7%,1
高雄市,左營區,0548,526,199,725,42,767,1196,64.13%,43.98%,1
高雄市,左營區,0549,558,216,774,29,803,1240,64.76%,45%,1
高雄市,左營區,0550,690,150,840,30,870,1402,62.05%,49.22%,1
高雄市,左營區,0551,604,125,729,22,751,1173,64.02%,51.49%,1
高雄市,左營區,0552,344,106,450,12,462,641,72.07%,53.67%,1
高雄市,左營區,0553,386,170,556,29,585,951,61.51%,40.59%,1
高雄市,左營區,0554,280,139,419,25,444,732,60.66%,38.25%,1
高雄市,左營區,0555,135,51,186,11,197,339,58.11%,39.82%,1
高雄市,左營區,0556,229,89,318,12,330,519,63.58%,44.12%,1
高雄市,左營區,0557,203,107,310,32,342,514,66.54%,39.49%,1
高雄市,左營區,0558,330,104,434,38,472,720,65.56%,45.83%,1
高雄市,左營區,0559,179,69,248,21,269,411,65.45%,43.55%,1
高雄市,左營區,0560,116,254,370,30,400,603,66.33%,19.24%,1
高雄市,左營區,0561,393,141,534,38,572,904,63.27%,43.47%,1
高雄市,左營區,0562,527,179,706,21,727,1318,55.16%,39.98%,1
高雄市,左營區,0563,348,169,517,30,547,966,56.63%,36.02%,1
高雄市,左營區,0564,595,229,824,31,855,1440,59.38%,41.32%,1
高雄市,左營區,0565,836,241,1077,32,1109,1990,55.73%,42.01%,1
高雄市,左營區,0566,538,145,683,27,710,1090,65.14%,49.36%,1
高雄市,左營區,0567,607,153,760,42,802,1272,63.05%,47.72%,1
高雄市,左營區,0568,667,318,985,22,1007,1558,64.63%,42.81%,1
高雄市,左營區,0569,628,324,952,15,967,1501,64.42%,41.84%,1
高雄市,左營區,0570,171,71,242,7,249,360,69.17%,47.5%,1
高雄市,左營區,0571,618,127,745,45,790,1335,59.18%,46.29%,1
高雄市,左營區,0572,612,181,793,20,813,1359,59.82%,45.03%,1
高雄市,左營區,0573,664,243,907,33,940,1487,63.21%,44.65%,1
高雄市,左營區,0574,727,187,914,56,970,1637,59.25%,44.41%,1
高雄市,左營區,0575,681,291,972,25,997,1553,64.2%,43.85%,1
高雄市,左營區,0576,635,350,985,34,1019,1564,65.15%,40.6%,1
高雄市,左營區,0577,771,370,1141,33,1174,1788,65.66%,43.12%,1
高雄市,左營區,0578,802,395,1197,54,1251,2028,61.69%,39.55%,1
高雄市,左營區,0579,793,412,1205,46,1251,2037,61.41%,38.93%,1
高雄市,左營區,0580,865,402,1267,28,1295,2101,61.64%,41.17%,1
高雄市,左營區,0581,844,388,1232,42,1274,2018,63.13%,41.82%,1
高雄市,左營區,0582,816,455,1271,38,1309,1925,68%,42.39%,1
高雄市,左營區,0583,770,377,1147,31,1178,1989,59.23%,38.71%,1
高雄市,左營區,0584,673,279,952,25,977,1780,54.89%,37.81%,1
高雄市,左營區,0585,721,342,1063,19,1082,1778,60.85%,40.55%,1
高雄市,左營區,0586,599,305,904,19,923,1496,61.7%,40.04%,1
高雄市,左營區,0587,620,314,934,32,966,1538,62.81%,40.31%,1
高雄市,左營區,0588,819,425,1244,30,1274,2058,61.9%,39.8%,1
高雄市,左營區,0589,803,406,1209,30,1239,1992,62.2%,40.31%,1
高雄市,左營區,0590,800,451,1251,32,1283,2058,62.34%,38.87%,1
高雄市,左營區,0591,824,430,1254,29,1283,2090,61.39%,39.43%,1
高雄市,左營區,0592,831,442,1273,39,1312,2157,60.83%,38.53%,1
高雄市,左營區,0593,869,418,1287,27,1314,2096,62.69%,41.46%,1
高雄市,左營區,0594,849,424,1273,45,1318,2101,62.73%,40.41%,1
高雄市,左營區,0595,655,310,965,40,1005,1649,60.95%,39.72%,1
高雄市,左營區,0596,615,267,882,37,919,1516,60.62%,40.57%,1
高雄市,左營區,0597,734,307,1041,37,1078,1678,64.24%,43.74%,1
高雄市,左營區,0598,759,350,1109,36,1145,1898,60.33%,39.99%,1
高雄市,左營區,0599,782,329,1111,30,1141,1837,62.11%,42.57%,1
高雄市,左營區,0600,749,334,1083,34,1117,1922,58.12%,38.97%,1
高雄市,左營區,0601,739,360,1099,32,1131,1785,63.36%,41.4%,1
高雄市,左營區,0602,770,334,1104,26,1130,1886,59.92%,40.83%,1
高雄市,左營區,0603,770,385,1155,29,1184,1895,62.48%,40.63%,1
高雄市,左營區,0604,769,329,1098,28,1126,1831,61.5%,42%,1
高雄市,左營區,0605,874,347,1221,40,1261,2050,61.51%,42.63%,1
高雄市,左營區,0606,978,494,1472,33,1505,2251,66.86%,43.45%,1
高雄市,左營區,0607,918,457,1375,17,1392,2126,65.48%,43.18%,1
高雄市,左營區,0608,783,337,1120,20,1140,1928,59.13%,40.61%,1
高雄市,左營區,0609,821,430,1251,29,1280,2166,59.1%,37.9%,1
高雄市,左營區,0610,841,341,1182,32,1214,2031,59.77%,41.41%,1
高雄市,左營區,0611,845,368,1213,23,1236,1987,62.2%,42.53%,1
高雄市,左營區,0612,946,408,1354,24,1378,2166,63.62%,43.67%,1
高雄市,左營區,0613,741,381,1122,42,1164,1856,62.72%,39.92%,1
高雄市,左營區,0614,951,463,1414,27,1441,2289,62.95%,41.55%,1
高雄市,左營區,0615,827,350,1177,32,1209,1973,61.28%,41.92%,1
高雄市,左營區,0616,762,334,1096,32,1128,1818,62.05%,41.91%,1
高雄市,左營區,0617,610,323,933,12,945,1565,60.38%,38.98%,1
高雄市,左營區,0618,724,312,1036,28,1064,1608,66.17%,45.02%,1
高雄市,左營區,0619,753,379,1132,33,1165,1812,64.29%,41.56%,1
高雄市,左營區,0620,726,316,1042,20,1062,1821,58.32%,39.87%,1
高雄市,左營區,0621,786,368,1154,29,1183,1907,62.03%,41.22%,1
高雄市,左營區,0622,765,310,1075,23,1098,1812,60.6%,42.22%,1
高雄市,左營區,0623,806,347,1153,24,1177,1833,64.21%,43.97%,1
高雄市,左營區,0624,751,371,1122,33,1155,1850,62.43%,40.59%,1
高雄市,左營區,0625,695,316,1011,28,1039,1738,59.78%,39.99%,1
高雄市,左營區,0626,827,366,1193,30,1223,1864,65.61%,44.37%,1
高雄市,左營區,0627,811,366,1177,26,1203,1887,63.75%,42.98%,1
高雄市,左營區,0628,731,319,1050,27,1077,1870,57.59%,39.09%,1
高雄市,左營區,0629,771,348,1119,25,1144,1866,61.31%,41.32%,1
高雄市,左營區,0630,757,347,1104,15,1119,1862,60.1%,40.66%,1
高雄市,左營區,0631,767,349,1116,19,1135,1816,62.5%,42.24%,1
高雄市,左營區,0632,931,214,1145,29,1174,1833,64.05%,50.79%,1
高雄市,左營區,0633,711,324,1035,29,1064,1676,63.48%,42.42%,1
高雄市,左營區,0634,793,311,1104,36,1140,1843,61.86%,43.03%,1
高雄市,左營區,0635,793,370,1163,20,1183,1872,63.19%,42.36%,1
高雄市,左營區,0636,959,367,1326,27,1353,2259,59.89%,42.45%,1
高雄市,楠梓區,0435,593,225,818,22,840,1309,64.17%,45.3%,1
高雄市,楠梓區,0436,565,278,843,28,871,1408,61.86%,40.13%,1
高雄市,楠梓區,0437,759,319,1078,43,1121,1851,60.56%,41%,1
高雄市,楠梓區,0438,644,300,944,33,977,1578,61.91%,40.81%,1
高雄市,楠梓區,0439,596,326,922,25,947,1715,55.22%,34.75%,1
高雄市,楠梓區,0440,606,298,904,17,921,1611,57.17%,37.62%,1
高雄市,楠梓區,0441,763,322,1085,30,1115,2024,55.09%,37.7%,1
高雄市,楠梓區,0442,668,338,1006,19,1025,1890,54.23%,35.34%,1
高雄市,楠梓區,0443,599,312,911,19,930,1762,52.78%,34%,1
高雄市,楠梓區,0444,695,337,1032,30,1062,1888,56.25%,36.81%,1
高雄市,楠梓區,0445,691,320,1011,37,1048,1822,57.52%,37.93%,1
高雄市,楠梓區,0446,675,348,1023,23,1046,1846,56.66%,36.57%,1
高雄市,楠梓區,0447,517,234,751,46,797,1268,62.85%,40.77%,1
高雄市,楠梓區,0448,524,255,779,32,811,1240,65.4%,42.26%,1
高雄市,楠梓區,0449,669,207,876,18,894,1432,62.43%,46.72%,1
高雄市,楠梓區,0450,549,335,884,40,924,1490,62.01%,36.85%,1
高雄市,楠梓區,0451,651,251,902,26,928,1464,63.39%,44.47%,1
高雄市,楠梓區,0452,532,238,770,50,820,1435,57.14%,37.07%,1
高雄市,楠梓區,0453,602,262,864,36,900,1602,56.18%,37.58%,1
高雄市,楠梓區,0454,577,263,840,32,872,1500,58.13%,38.47%,1
高雄市,楠梓區,0455,592,263,855,47,902,1591,56.69%,37.21%,1
高雄市,楠梓區,0456,431,206,637,29,666,1669,39.9%,25.82%,1
高雄市,楠梓區,0457,593,287,880,26,906,1469,61.67%,40.37%,1
高雄市,楠梓區,0458,570,274,844,55,899,1559,57.67%,36.56%,1
高雄市,楠梓區,0459,586,300,886,57,943,1638,57.57%,35.78%,1
高雄市,楠梓區,0460,777,352,1129,56,1185,1960,60.46%,39.64%,1
高雄市,楠梓區,0461,707,385,1092,60,1152,1912,60.25%,36.98%,1
高雄市,楠梓區,0462,641,238,879,30,909,1559,58.31%,41.12%,1
高雄市,楠梓區,0463,524,257,781,31,812,1423,57.06%,36.82%,1
高雄市,楠梓區,0464,660,315,975,24,999,1696,58.9%,38.92%,1
高雄市,楠梓區,0465,562,250,812,73,885,1493,59.28%,37.64%,1
高雄市,楠梓區,0466,599,276,875,55,930,1527,60.9%,39.23%,1
高雄市,楠梓區,0467,411,204,615,40,655,1020,64.22%,40.29%,1
高雄市,楠梓區,0468,443,221,664,68,732,1197,61.15%,37.01%,1
高雄市,楠梓區,0469,534,276,810,40,850,1528,55.63%,34.95%,1
高雄市,楠梓區,0470,670,278,948,48,996,1918,51.93%,34.93%,1
高雄市,楠梓區,0471,575,253,828,47,875,1458,60.01%,39.44%,1
高雄市,楠梓區,0472,750,320,1070,44,1114,1790,62.23%,41.9%,1
高雄市,楠梓區,0473,769,329,1098,52,1150,1845,62.33%,41.68%,1
高雄市,楠梓區,0474,799,395,1194,52,1246,2037,61.17%,39.22%,1
高雄市,楠梓區,0475,737,335,1072,36,1108,1964,56.42%,37.53%,1
高雄市,楠梓區,0476,776,364,1140,28,1168,2006,58.23%,38.68%,1
高雄市,楠梓區,0477,726,347,1073,38,1111,1951,56.95%,37.21%,1
高雄市,楠梓區,0478,709,353,1062,49,1111,1951,56.95%,36.34%,1
高雄市,楠梓區,0479,823,350,1173,36,1209,2008,60.21%,40.99%,1
高雄市,楠梓區,0480,789,304,1093,57,1150,1923,59.8%,41.03%,1
高雄市,楠梓區,0481,759,359,1118,34,1152,1921,59.97%,39.51%,1
高雄市,楠梓區,0482,399,152,551,27,578,832,69.47%,47.96%,1
高雄市,楠梓區,0483,454,205,659,31,690,1156,59.69%,39.27%,1
高雄市,楠梓區,0484,460,220,680,43,723,1125,64.27%,40.89%,1
高雄市,楠梓區,0485,346,203,549,40,589,1060,55.57%,32.64%,1
高雄市,楠梓區,0486,634,252,886,43,929,1502,61.85%,42.21%,1
高雄市,楠梓區,0487,556,244,800,58,858,1404,61.11%,39.6%,1
高雄市,楠梓區,0488,529,252,781,48,829,1552,53.41%,34.09%,1
高雄市,楠梓區,0489,550,252,802,35,837,1460,57.33%,37.67%,1
高雄市,楠梓區,0490,525,168,693,37,730,1315,55.51%,39.92%,1
高雄市,楠梓區,0491,442,194,636,35,671,1062,63.18%,41.62%,1
高雄市,楠梓區,0492,435,88,523,40,563,1078,52.23%,40.35%,1
高雄市,楠梓區,0493,408,157,565,50,615,914,67.29%,44.64%,1
高雄市,楠梓區,0494,483,190,673,40,713,1064,67.01%,45.39%,1
高雄市,楠梓區,0495,758,305,1063,38,1101,1705,64.57%,44.46%,1
高雄市,楠梓區,0496,751,271,1022,29,1051,1728,60.82%,43.46%,1
高雄市,楠梓區,0497,792,334,1126,34,1160,1917,60.51%,41.31%,1
高雄市,楠梓區,0498,620,183,803,35,838,1439,58.23%,43.09%,1
高雄市,楠梓區,0499,555,120,675,44,719,1287,55.87%,43.12%,1
高雄市,楠梓區,0500,671,262,933,37,970,1504,64.49%,44.61%,1
高雄市,楠梓區,0501,638,261,899,31,930,1405,66.19%,45.41%,1
高雄市,楠梓區,0502,532,220,752,42,794,1287,61.69%,41.34%,1
高雄市,楠梓區,0503,543,236,779,27,806,1295,62.24%,41.93%,1
高雄市,楠梓區,0504,622,279,901,31,932,1483,62.85%,41.94%,1
高雄市,楠梓區,0505,758,314,1072,28,1100,1649,66.71%,45.97%,1
高雄市,楠梓區,0506,404,211,615,34,649,998,65.03%,40.48%,1
高雄市,楠梓區,0507,434,189,623,35,658,1025,64.2%,42.34%,1
高雄市,楠梓區,0508,749,315,1064,44,1108,1671,66.31%,44.82%,1
高雄市,楠梓區,0509,652,252,904,52,956,1453,65.79%,44.87%,1
高雄市,楠梓區,0510,685,292,977,48,1025,1673,61.27%,40.94%,1
高雄市,楠梓區,0511,675,277,952,39,991,1653,59.95%,40.83%,1
高雄市,楠梓區,0512,421,195,616,26,642,1034,62.09%,40.72%,1
高雄市,楠梓區,0513,492,254,746,31,777,1127,68.94%,43.66%,1
高雄市,楠梓區,0514,602,284,886,34,920,1575,58.41%,38.22%,1
高雄市,楠梓區,0515,552,380,932,33,965,1559,61.9%,35.41%,1
高雄市,楠梓區,0516,545,240,785,24,809,1378,58.71%,39.55%,1
高雄市,楠梓區,0517,736,287,1023,26,1049,1714,61.2%,42.94%,1
高雄市,楠梓區,0518,722,283,1005,48,1053,1721,61.19%,41.95%,1
高雄市,楠梓區,0519,692,265,957,36,993,1628,61%,42.51%,1
高雄市,楠梓區,0520,715,311,1026,46,1072,1590,67.42%,44.97%,1
高雄市,楠梓區,0521,684,263,947,51,998,1628,61.3%,42.01%,1
高雄市,楠梓區,0522,768,333,1101,37,1138,1739,65.44%,44.16%,1
高雄市,楠梓區,0523,716,308,1024,39,1063,1642,64.74%,43.61%,1
高雄市,楠梓區,0524,659,293,952,42,994,1766,56.29%,37.32%,1
高雄市,楠梓區,0525,576,252,828,28,856,1482,57.76%,38.87%,1
高雄市,楠梓區,0526,648,258,906,18,924,1749,52.83%,37.05%,1
高雄市,楠梓區,0527,617,322,939,27,966,1591,60.72%,38.78%,1
高雄市,楠梓區,0528,662,319,981,21,1002,1545,64.85%,42.85%,1
高雄市,楠梓區,0529,723,331,1054,21,1075,1651,65.11%,43.79%,1
高雄市,楠梓區,0530,682,321,1003,37,1040,1646,63.18%,41.43%,1
高雄市,楠梓區,0531,730,191,921,51,972,1496,64.97%,48.8%,1
高雄市,楠梓區,0532,575,221,796,55,851,1403,60.66%,40.98%,1
高雄市,楠梓區,0533,582,328,910,27,937,1624,57.7%,35.84%,1
高雄市,三民區,0887,730,338,1068,48,1116,1893,58.95%,38.56%,1
高雄市,三民區,0888,734,294,1028,58,1086,1982,54.79%,37.03%,1
高雄市,三民區,0889,644,293,937,39,976,1661,58.76%,38.77%,1
高雄市,三民區,0890,686,384,1070,17,1087,1894,57.39%,36.22%,1
高雄市,三民區,0891,696,328,1024,31,1055,1839,57.37%,37.85%,1
高雄市,三民區,0892,747,362,1109,42,1151,2014,57.15%,37.09%,1
高雄市,三民區,0893,779,305,1084,59,1143,1897,60.25%,41.06%,1
高雄市,三民區,0894,694,367,1061,34,1095,2016,54.32%,34.42%,1
高雄市,三民區,0895,735,316,1051,26,1077,1924,55.98%,38.2%,1
高雄市,三民區,0896,701,300,1001,35,1036,1749,59.23%,40.08%,1
高雄市,三民區,0897,817,357,1174,38,1212,1845,65.69%,44.28%,1
高雄市,三民區,0898,668,307,975,26,1001,1724,58.06%,38.75%,1
高雄市,三民區,0899,741,348,1089,26,1115,1889,59.03%,39.23%,1
高雄市,三民區,0900,611,316,927,24,951,1622,58.63%,37.67%,1
高雄市,三民區,0901,742,387,1129,33,1162,1870,62.14%,39.68%,1
高雄市,三民區,0902,632,302,934,38,972,1523,63.82%,41.5%,1
高雄市,三民區,0903,741,339,1080,34,1114,2006,55.53%,36.94%,1
高雄市,三民區,0904,807,470,1277,37,1314,2076,63.29%,38.87%,1
高雄市,三民區,0905,758,426,1184,11,1195,2073,57.65%,36.57%,1
高雄市,三民區,0906,810,371,1181,33,1214,2045,59.36%,39.61%,1
高雄市,三民區,0907,698,342,1040,37,1077,2070,52.03%,33.72%,1
高雄市,三民區,0908,753,363,1116,30,1146,2035,56.31%,37%,1
高雄市,三民區,0909,773,488,1261,37,1298,2075,62.55%,37.25%,1
高雄市,三民區,0910,825,390,1215,21,1236,2053,60.2%,40.19%,1
高雄市,三民區,0911,839,442,1281,21,1302,2063,63.11%,40.67%,1
高雄市,三民區,0912,899,414,1313,29,1342,2143,62.62%,41.95%,1
高雄市,三民區,0913,714,346,1060,46,1106,1746,63.34%,40.89%,1
高雄市,三民區,0914,623,289,912,29,941,1735,54.24%,35.91%,1
高雄市,三民區,0915,582,311,893,37,930,1655,56.19%,35.17%,1
高雄市,三民區,0916,590,315,905,41,946,1583,59.76%,37.27%,1
高雄市,三民區,0917,651,353,1004,26,1030,1800,57.22%,36.17%,1
高雄市,三民區,0918,740,305,1045,18,1063,1730,61.45%,42.77%,1
高雄市,三民區,0919,701,305,1006,19,1025,1715,59.77%,40.87%,1
高雄市,三民區,0920,666,324,990,33,1023,1691,60.5%,39.38%,1
高雄市,三民區,0921,827,260,1087,27,1114,1865,59.73%,44.34%,1
高雄市,三民區,0922,468,215,683,22,705,1073,65.7%,43.62%,1
高雄市,三民區,0923,440,175,615,34,649,917,70.77%,47.98%,1
高雄市,三民區,0924,679,283,962,30,992,1647,60.23%,41.23%,1
高雄市,三民區,0925,647,320,967,44,1011,1654,61.12%,39.12%,1
高雄市,三民區,0926,681,307,988,42,1030,1639,62.84%,41.55%,1
高雄市,三民區,0927,720,367,1087,27,1114,1833,60.77%,39.28%,1
高雄市,三民區,0928,560,308,868,25,893,1362,65.57%,41.12%,1
高雄市,三民區,0929,644,305,949,42,991,1557,63.65%,41.36%,1
高雄市,三民區,0930,649,83,732,16,748,1482,50.47%,43.79%,1
高雄市,三民區,0931,645,325,970,25,995,1563,63.66%,41.27%,1
高雄市,三民區,0932,594,317,911,30,941,1497,62.86%,39.68%,1
高雄市,三民區,0933,637,338,975,22,997,1523,65.46%,41.83%,1
高雄市,三民區,0934,584,267,851,19,870,1293,67.29%,45.17%,1
高雄市,三民區,0935,663,365,1028,28,1056,1662,63.54%,39.89%,1
高雄市,三民區,0936,588,262,850,24,874,1441,60.65%,40.8%,1
高雄市,三民區,0937,611,273,884,23,907,1326,68.4%,46.08%,1
高雄市,三民區,0938,654,303,957,24,981,1476,66.46%,44.31%,1
高雄市,三民區,0939,722,354,1076,23,1099,1968,55.84%,36.69%,1
高雄市,三民區,0940,599,293,892,17,909,1618,56.18%,37.02%,1
高雄市,三民區,0941,672,396,1068,30,1098,1873,58.62%,35.88%,1
高雄市,三民區,0942,585,288,873,32,905,1487,60.86%,39.34%,1
高雄市,三民區,0943,658,308,966,20,986,1640,60.12%,40.12%,1
高雄市,三民區,0944,728,343,1071,21,1092,1889,57.81%,38.54%,1
高雄市,三民區,0945,749,357,1106,24,1130,1969,57.39%,38.04%,1
高雄市,三民區,0946,596,292,888,40,928,1466,63.3%,40.65%,1
高雄市,三民區,0947,921,301,1222,34,1256,1697,74.01%,54.27%,1
高雄市,三民區,0948,700,291,991,35,1026,1663,61.7%,42.09%,1
高雄市,三民區,0949,619,334,953,31,984,1649,59.67%,37.54%,1
高雄市,三民區,0950,610,268,878,24,902,1486,60.7%,41.05%,1
高雄市,三民區,0951,557,291,848,21,869,1495,58.13%,37.26%,1
高雄市,三民區,0952,675,317,992,17,1009,1548,65.18%,43.6%,1
高雄市,三民區,0953,584,293,877,25,902,1493,60.42%,39.12%,1
高雄市,三民區,0954,624,288,912,12,924,1445,63.94%,43.18%,1
高雄市,三民區,0955,587,304,891,21,912,1529,59.65%,38.39%,1
高雄市,三民區,0956,613,282,895,22,917,1506,60.89%,40.7%,1
高雄市,三民區,0957,636,318,954,32,986,1549,63.65%,41.06%,1
高雄市,三民區,0958,642,351,993,38,1031,1620,63.64%,39.63%,1
高雄市,三民區,0959,649,308,957,39,996,1550,64.26%,41.87%,1
高雄市,三民區,0960,621,291,912,35,947,1488,63.64%,41.73%,1
高雄市,三民區,0961,527,282,809,34,843,1335,63.15%,39.48%,1
高雄市,三民區,0962,573,223,796,26,822,1332,61.71%,43.02%,1
高雄市,三民區,0963,700,342,1042,47,1089,1764,61.73%,39.68%,1
高雄市,三民區,0964,728,339,1067,28,1095,1811,60.46%,40.2%,1
高雄市,三民區,0965,692,359,1051,34,1085,1693,64.09%,40.87%,1
高雄市,三民區,0966,722,335,1057,49,1106,1684,65.68%,42.87%,1
高雄市,三民區,0967,586,263,849,33,882,1464,60.25%,40.03%,1
高雄市,三民區,0968,727,375,1102,26,1128,1719,65.62%,42.29%,1
高雄市,三民區,0969,685,352,1037,19,1056,1749,60.38%,39.17%,1
高雄市,三民區,0970,712,365,1077,21,1098,1908,57.55%,37.32%,1
高雄市,三民區,0971,638,291,929,47,976,1573,62.05%,40.56%,1
高雄市,三民區,0972,636,292,928,26,954,1628,58.6%,39.07%,1
高雄市,三民區,0973,508,236,744,34,778,1377,56.5%,36.89%,1
高雄市,三民區,0974,644,308,952,20,972,1530,63.53%,42.09%,1
高雄市,三民區,0975,489,210,699,32,731,1188,61.53%,41.16%,1
高雄市,三民區,0976,598,258,856,21,877,2791,31.42%,21.43%,1
高雄市,三民區,0977,619,335,954,40,994,1840,54.02%,33.64%,1
高雄市,三民區,0978,660,337,997,48,1045,1671,62.54%,39.5%,1
高雄市,三民區,0979,633,326,959,26,985,1624,60.65%,38.98%,1
高雄市,三民區,0980,678,359,1037,27,1064,1555,68.42%,43.6%,1
高雄市,三民區,0981,646,311,957,20,977,1489,65.61%,43.38%,1
高雄市,三民區,0982,675,331,1006,34,1040,1662,62.58%,40.61%,1
高雄市,三民區,0983,662,292,954,20,974,1639,59.43%,40.39%,1
高雄市,三民區,0984,739,326,1065,40,1105,1872,59.03%,39.48%,1
高雄市,三民區,0985,745,363,1108,35,1143,1968,58.08%,37.86%,1
高雄市,三民區,0986,536,200,736,50,786,1471,53.43%,36.44%,1
高雄市,三民區,0987,604,259,863,36,899,1534,58.6%,39.37%,1
高雄市,三民區,0988,605,262,867,52,919,1659,55.39%,36.47%,1
高雄市,三民區,0989,652,279,931,28,959,1815,52.84%,35.92%,1
高雄市,三民區,0990,660,336,996,29,1025,1808,56.69%,36.5%,1
高雄市,三民區,0991,461,204,665,29,694,1224,56.7%,37.66%,1
高雄市,三民區,0992,555,254,809,21,830,1406,59.03%,39.47%,1
高雄市,三民區,0993,380,166,546,27,573,945,60.63%,40.21%,1
高雄市,三民區,0994,419,183,602,23,625,944,66.21%,44.39%,1
高雄市,三民區,0995,647,315,962,61,1023,1669,61.29%,38.77%,1
高雄市,三民區,0996,651,255,906,39,945,1473,64.15%,44.2%,1
高雄市,三民區,0997,599,328,927,30,957,1876,51.01%,31.93%,1
高雄市,三民區,0998,459,200,659,18,677,1682,40.25%,27.29%,1
高雄市,三民區,0999,595,363,958,15,973,1791,54.33%,33.22%,1
高雄市,三民區,1000,715,352,1067,35,1102,1808,60.95%,39.55%,1
高雄市,三民區,1001,667,320,987,29,1016,1798,56.51%,37.1%,1
高雄市,三民區,1002,746,430,1176,28,1204,2030,59.31%,36.75%,1
高雄市,三民區,1003,768,396,1164,18,1182,2034,58.11%,37.76%,1
高雄市,三民區,1004,781,379,1160,23,1183,1998,59.21%,39.09%,1
高雄市,三民區,1005,727,330,1057,27,1084,1914,56.64%,37.98%,1
高雄市,三民區,1006,664,449,1113,30,1143,1965,58.17%,33.79%,1
高雄市,三民區,1007,679,376,1055,46,1101,1885,58.41%,36.02%,1
高雄市,三民區,1008,532,242,774,11,785,1220,64.34%,43.61%,1
高雄市,三民區,1009,444,169,613,36,649,1057,61.4%,42.01%,1
高雄市,三民區,1010,473,236,709,22,731,1434,50.98%,32.98%,1
高雄市,三民區,1011,494,199,693,35,728,1350,53.93%,36.59%,1
高雄市,三民區,1012,351,127,478,13,491,872,56.31%,40.25%,1
高雄市,三民區,1013,352,167,519,19,538,954,56.39%,36.9%,1
高雄市,三民區,1014,799,328,1127,16,1143,1689,67.67%,47.31%,1
高雄市,三民區,1015,560,263,823,13,836,1390,60.14%,40.29%,1
高雄市,三民區,1016,540,265,805,29,834,1336,62.43%,40.42%,1
高雄市,三民區,1017,620,316,936,31,967,1437,67.29%,43.15%,1
高雄市,三民區,1018,589,284,873,23,896,1452,61.71%,40.56%,1
高雄市,三民區,1019,585,318,903,41,944,1513,62.39%,38.66%,1
高雄市,三民區,1020,623,297,920,53,973,1467,66.33%,42.47%,1
高雄市,三民區,1021,627,271,898,52,950,1381,68.79%,45.4%,1
高雄市,三民區,1022,444,203,647,41,688,1117,61.59%,39.75%,1
高雄市,三民區,1023,557,295,852,21,873,1327,65.79%,41.97%,1
高雄市,三民區,1024,547,275,822,26,848,1304,65.03%,41.95%,1
高雄市,三民區,1025,570,270,840,26,866,1483,58.4%,38.44%,1
高雄市,三民區,1026,640,286,926,21,947,1473,64.29%,43.45%,1
高雄市,三民區,1027,365,202,567,32,599,980,61.12%,37.24%,1
高雄市,三民區,1028,612,251,863,23,886,1409,62.88%,43.44%,1
高雄市,三民區,1029,518,240,758,18,776,1230,63.09%,42.11%,1
高雄市,三民區,1030,453,214,667,20,687,1024,67.09%,44.24%,1
高雄市,三民區,1031,456,221,677,36,713,1130,63.1%,40.35%,1
高雄市,三民區,1032,670,341,1011,27,1038,1889,54.95%,35.47%,1
高雄市,三民區,1033,626,234,860,22,882,1427,61.81%,43.87%,1
高雄市,三民區,1034,397,117,514,23,537,791,67.89%,50.19%,1
高雄市,三民區,1035,535,209,744,32,776,1079,71.92%,49.58%,1
高雄市,三民區,1036,603,271,874,34,908,1492,60.86%,40.42%,1
高雄市,三民區,1037,426,209,635,31,666,1020,65.29%,41.76%,1
高雄市,三民區,1038,423,221,644,8,652,1001,65.13%,42.26%,1
高雄市,三民區,1039,691,288,979,26,1005,1581,63.57%,43.71%,1
高雄市,三民區,1040,596,274,870,28,898,1471,61.05%,40.52%,1
高雄市,三民區,1041,514,229,743,15,758,1151,65.86%,44.66%,1
高雄市,三民區,1042,593,250,843,32,875,1334,65.59%,44.45%,1
高雄市,三民區,1043,545,213,758,25,783,1275,61.41%,42.75%,1
高雄市,三民區,1044,498,262,760,25,785,1688,46.5%,29.5%,1
高雄市,三民區,1045,502,234,736,24,760,1214,62.6%,41.35%,1
高雄市,三民區,1046,489,257,746,25,771,1149,67.1%,42.56%,1
高雄市,三民區,1047,659,310,969,62,1031,1667,61.85%,39.53%,1
高雄市,三民區,1048,652,335,987,25,1012,1786,56.66%,36.51%,1
高雄市,三民區,1049,373,171,544,16,560,896,62.5%,41.63%,1
高雄市,三民區,1050,396,162,558,26,584,925,63.14%,42.81%,1
高雄市,三民區,1051,299,146,445,29,474,684,69.3%,43.71%,1
高雄市,三民區,1052,410,212,622,35,657,981,66.97%,41.79%,1
高雄市,三民區,1053,517,216,733,40,773,1383,55.89%,37.38%,1
高雄市,三民區,1054,564,263,827,24,851,1382,61.58%,40.81%,1
高雄市,三民區,1055,316,143,459,25,484,808,59.9%,39.11%,1
高雄市,三民區,1056,449,253,702,32,734,1197,61.32%,37.51%,1
高雄市,三民區,1057,641,195,836,28,864,1344,64.29%,47.69%,1
高雄市,三民區,1058,562,262,824,44,868,1344,64.58%,41.82%,1
高雄市,三民區,1059,572,262,834,18,852,1359,62.69%,42.09%,1
高雄市,三民區,1060,434,219,653,37,690,1073,64.31%,40.45%,1
高雄市,三民區,1061,432,219,651,32,683,1186,57.59%,36.42%,1
高雄市,三民區,1062,662,324,986,47,1033,1749,59.06%,37.85%,1
高雄市,三民區,1063,399,147,546,11,557,877,63.51%,45.5%,1
高雄市,三民區,1064,627,255,882,47,929,1402,66.26%,44.72%,1
高雄市,三民區,1065,341,160,501,22,523,769,68.01%,44.34%,1
高雄市,三民區,1066,514,230,744,33,777,1207,64.37%,42.58%,1
高雄市,三民區,1067,469,214,683,31,714,1270,56.22%,36.93%,1
高雄市,三民區,1068,479,241,720,33,753,1248,60.34%,38.38%,1
高雄市,三民區,1069,524,232,756,36,792,1263,62.71%,41.49%,1
高雄市,三民區,1070,490,186,676,32,708,1101,64.31%,44.5%,1
高雄市,三民區,1071,497,229,726,18,744,1116,66.67%,44.53%,1
高雄市,三民區,1072,498,211,709,26,735,1152,63.8%,43.23%,1
高雄市,三民區,1073,443,206,649,26,675,1057,63.86%,41.91%,1
高雄市,三民區,1074,393,160,553,26,579,971,59.63%,40.47%,1
高雄市,三民區,1075,434,193,627,15,642,1062,60.45%,40.87%,1
高雄市,新興區,1098,323,161,484,23,507,828,61.23%,39.01%,1
高雄市,新興區,1099,410,197,607,32,639,963,66.36%,42.58%,1
高雄市,新興區,1100,394,210,604,20,624,1075,58.05%,36.65%,1
高雄市,新興區,1101,564,321,885,15,900,1488,60.48%,37.9%,1
高雄市,新興區,1102,448,313,761,24,785,1438,54.59%,31.15%,1
高雄市,新興區,1103,402,225,627,24,651,1049,62.06%,38.32%,1
高雄市,新興區,1104,588,283,871,52,923,1378,66.98%,42.67%,1
高雄市,新興區,1105,300,123,423,24,447,666,67.12%,45.05%,1
高雄市,新興區,1106,370,233,603,9,612,981,62.39%,37.72%,1
高雄市,新興區,1107,405,188,593,26,619,933,66.35%,43.41%,1
高雄市,新興區,1108,410,166,576,13,589,987,59.68%,41.54%,1
高雄市,新興區,1109,422,189,611,21,632,988,63.97%,42.71%,1
高雄市,新興區,1110,324,147,471,24,495,735,67.35%,44.08%,1
高雄市,新興區,1111,522,261,783,28,811,1317,61.58%,39.64%,1
高雄市,新興區,1112,315,160,475,12,487,800,60.88%,39.38%,1
高雄市,新興區,1113,423,184,607,23,630,968,65.08%,43.7%,1
高雄市,新興區,1114,406,152,558,15,573,913,62.76%,44.47%,1
高雄市,新興區,1115,559,329,888,19,907,1389,65.3%,40.24%,1
高雄市,新興區,1116,512,296,808,27,835,1228,68%,41.69%,1
高雄市,新興區,1117,508,245,753,25,778,1211,64.24%,41.95%,1
高雄市,新興區,1118,486,201,687,18,705,1101,64.03%,44.14%,1
高雄市,新興區,1119,312,152,464,23,487,752,64.76%,41.49%,1
高雄市,新興區,1120,393,202,595,27,622,873,71.25%,45.02%,1
高雄市,新興區,1121,672,325,997,24,1021,1609,63.46%,41.77%,1
高雄市,新興區,1122,710,368,1078,31,1109,1736,63.88%,40.9%,1
高雄市,新興區,1123,514,231,745,14,759,1258,60.33%,40.86%,1
高雄市,新興區,1124,457,216,673,23,696,1105,62.99%,41.36%,1
高雄市,新興區,1125,334,171,505,34,539,851,63.34%,39.25%,1
高雄市,新興區,1126,422,202,624,26,650,1011,64.29%,41.74%,1
高雄市,新興區,1127,402,190,592,39,631,888,71.06%,45.27%,1
高雄市,新興區,1128,408,200,608,20,628,1005,62.49%,40.6%,1
高雄市,新興區,1129,412,219,631,14,645,1375,46.91%,29.96%,1
高雄市,新興區,1130,526,299,825,29,854,1388,61.53%,37.9%,1
高雄市,新興區,1131,292,130,422,22,444,719,61.75%,40.61%,1
高雄市,新興區,1132,368,205,573,38,611,1077,56.73%,34.17%,1
高雄市,新興區,1133,313,144,457,17,474,875,54.17%,35.77%,1
高雄市,新興區,1134,380,158,538,15,553,936,59.08%,40.6%,1
高雄市,新興區,1135,384,157,541,30,571,944,60.49%,40.68%,1
高雄市,新興區,1136,317,149,466,18,484,833,58.1%,38.06%,1
高雄市,新興區,1137,305,143,448,11,459,708,64.83%,43.08%,1
高雄市,新興區,1138,285,144,429,12,441,741,59.51%,38.46%,1
高雄市,新興區,1139,485,217,702,17,719,1235,58.22%,39.27%,1
高雄市,前金區,1076,277,122,399,22,421,673,62.56%,41.16%,1
高雄市,前金區,1077,423,208,631,22,653,1022,63.89%,41.39%,1
高雄市,前金區,1078,544,224,768,28,796,1324,60.12%,41.09%,1
高雄市,前金區,1079,327,169,496,25,521,839,62.1%,38.97%,1
高雄市,前金區,1080,381,191,572,26,598,975,61.33%,39.08%,1
高雄市,前金區,1081,708,325,1033,46,1079,1806,59.75%,39.2%,1
高雄市,前金區,1082,719,323,1042,35,1077,1781,60.47%,40.37%,1
高雄市,前金區,1083,300,135,435,21,456,717,63.6%,41.84%,1
高雄市,前金區,1084,453,204,657,6,663,1097,60.44%,41.29%,1
高雄市,前金區,1085,646,314,960,25,985,1633,60.32%,39.56%,1
高雄市,前金區,1086,332,173,505,14,519,759,68.38%,43.74%,1
高雄市,前金區,1087,403,202,605,25,630,948,66.46%,42.51%,1
高雄市,前金區,1088,369,164,533,37,570,1009,56.49%,36.57%,1
高雄市,前金區,1089,395,174,569,25,594,945,62.86%,41.8%,1
高雄市,前金區,1090,319,164,483,14,497,772,64.38%,41.32%,1
高雄市,前金區,1091,316,159,475,16,491,757,64.86%,41.74%,1
高雄市,前金區,1092,453,198,651,31,682,1047,65.14%,43.27%,1
高雄市,前金區,1093,419,190,609,23,632,985,64.16%,42.54%,1
高雄市,前金區,1094,643,307,950,16,966,1674,57.71%,38.41%,1
高雄市,前金區,1095,434,198,632,26,658,1088,60.48%,39.89%,1
高雄市,前金區,1096,376,186,562,47,609,893,68.2%,42.11%,1
高雄市,前金區,1097,474,217,691,23,714,1184,60.3%,40.03%,1
高雄市,苓雅區,1140,291,156,447,15,462,718,64.35%,40.53%,1
高雄市,苓雅區,1141,601,247,848,31,879,1492,58.91%,40.28%,1
高雄市,苓雅區,1142,513,222,735,31,766,1210,63.31%,42.4%,1
高雄市,苓雅區,1143,622,267,889,29,918,1617,56.77%,38.47%,1
高雄市,苓雅區,1144,583,273,856,46,902,1428,63.17%,40.83%,1
高雄市,苓雅區,1145,547,243,790,31,821,1444,56.86%,37.88%,1
高雄市,苓雅區,1146,569,266,835,34,869,1452,59.85%,39.19%,1
高雄市,苓雅區,1147,252,95,347,14,361,554,65.16%,45.49%,1
高雄市,苓雅區,1148,373,180,553,13,566,950,59.58%,39.26%,1
高雄市,苓雅區,1149,404,159,563,18,581,978,59.41%,41.31%,1
高雄市,苓雅區,1150,627,287,914,20,934,1673,55.83%,37.48%,1
高雄市,苓雅區,1151,699,411,1110,38,1148,2045,56.14%,34.18%,1
高雄市,苓雅區,1152,406,161,567,39,606,939,64.54%,43.24%,1
高雄市,苓雅區,1153,459,243,702,20,722,1284,56.23%,35.75%,1
高雄市,苓雅區,1154,392,164,556,18,574,908,63.22%,43.17%,1
高雄市,苓雅區,1155,312,164,476,13,489,838,58.35%,37.23%,1
高雄市,苓雅區,1156,532,242,774,22,796,1267,62.83%,41.99%,1
高雄市,苓雅區,1157,467,180,647,26,673,994,67.71%,46.98%,1
高雄市,苓雅區,1158,336,137,473,16,489,774,63.18%,43.41%,1
高雄市,苓雅區,1159,457,218,675,24,699,1121,62.36%,40.77%,1
高雄市,苓雅區,1160,564,313,877,27,904,1474,61.33%,38.26%,1
高雄市,苓雅區,1161,623,272,895,67,962,1525,63.08%,40.85%,1
高雄市,苓雅區,1162,489,215,704,25,729,1147,63.56%,42.63%,1
高雄市,苓雅區,1163,410,238,648,30,678,1014,66.86%,40.43%,1
高雄市,苓雅區,1164,579,304,883,37,920,1496,61.5%,38.7%,1
高雄市,苓雅區,1165,643,278,921,40,961,1499,64.11%,42.9%,1
高雄市,苓雅區,1166,482,228,710,29,739,1138,64.94%,42.36%,1
高雄市,苓雅區,1167,397,169,566,21,587,839,69.96%,47.32%,1
高雄市,苓雅區,1168,501,230,731,25,756,2088,36.21%,23.99%,1
高雄市,苓雅區,1169,659,347,1006,25,1031,1648,62.56%,39.99%,1
高雄市,苓雅區,1170,645,276,921,35,956,1623,58.9%,39.74%,1
高雄市,苓雅區,1171,818,419,1237,35,1272,1932,65.84%,42.34%,1
高雄市,苓雅區,1172,529,241,770,18,788,1127,69.92%,46.94%,1
高雄市,苓雅區,1173,551,258,809,16,825,1156,71.37%,47.66%,1
高雄市,苓雅區,1174,652,287,939,24,963,1465,65.73%,44.51%,1
高雄市,苓雅區,1175,285,101,386,22,408,690,59.13%,41.3%,1
高雄市,苓雅區,1176,540,222,762,42,804,1283,62.67%,42.09%,1
高雄市,苓雅區,1177,578,258,836,45,881,1432,61.52%,40.36%,1
高雄市,苓雅區,1178,573,233,806,18,824,1313,62.76%,43.64%,1
高雄市,苓雅區,1179,617,288,905,26,931,1579,58.96%,39.08%,1
高雄市,苓雅區,1180,577,268,845,38,883,1385,63.75%,41.66%,1
高雄市,苓雅區,1181,632,261,893,30,923,1449,63.7%,43.62%,1
高雄市,苓雅區,1182,753,383,1136,33,1169,1834,63.74%,41.06%,1
高雄市,苓雅區,1183,623,275,898,28,926,1436,64.48%,43.38%,1
高雄市,苓雅區,1184,632,273,905,28,933,1431,65.2%,44.16%,1
高雄市,苓雅區,1185,537,267,804,24,828,1248,66.35%,43.03%,1
高雄市,苓雅區,1186,592,311,903,39,942,1470,64.08%,40.27%,1
高雄市,苓雅區,1187,683,300,983,41,1024,1540,66.49%,44.35%,1
高雄市,苓雅區,1188,602,283,885,19,904,1374,65.79%,43.81%,1
高雄市,苓雅區,1189,367,185,552,15,567,839,67.58%,43.74%,1
高雄市,苓雅區,1190,442,241,683,16,699,1022,68.4%,43.25%,1
高雄市,苓雅區,1191,487,195,682,17,699,1062,65.82%,45.86%,1
高雄市,苓雅區,1192,430,243,673,21,694,1078,64.38%,39.89%,1
高雄市,苓雅區,1193,511,217,728,17,745,1117,66.7%,45.75%,1
高雄市,苓雅區,1194,671,270,941,42,983,1516,64.84%,44.26%,1
高雄市,苓雅區,1195,556,274,830,68,898,1440,62.36%,38.61%,1
高雄市,苓雅區,1196,342,172,514,22,536,839,63.89%,40.76%,1
高雄市,苓雅區,1197,384,139,523,15,538,888,60.59%,43.24%,1
高雄市,苓雅區,1198,459,247,706,25,731,1101,66.39%,41.69%,1
高雄市,苓雅區,1199,464,229,693,30,723,1004,72.01%,46.22%,1
高雄市,苓雅區,1200,613,254,867,32,899,1427,63%,42.96%,1
高雄市,苓雅區,1201,485,225,710,28,738,1168,63.18%,41.52%,1
高雄市,苓雅區,1202,492,266,758,41,799,1184,67.48%,41.55%,1
高雄市,苓雅區,1203,415,202,617,19,636,974,65.3%,42.61%,1
高雄市,苓雅區,1204,331,146,477,12,489,849,57.6%,38.99%,1
高雄市,苓雅區,1205,783,326,1109,28,1137,1821,62.44%,43%,1
高雄市,苓雅區,1206,537,263,800,33,833,1306,63.78%,41.12%,1
高雄市,苓雅區,1207,510,248,758,14,772,1185,65.15%,43.04%,1
高雄市,苓雅區,1208,558,283,841,26,867,1415,61.27%,39.43%,1
高雄市,苓雅區,1209,421,209,630,22,652,962,67.78%,43.76%,1
高雄市,苓雅區,1210,388,184,572,29,601,964,62.34%,40.25%,1
高雄市,苓雅區,1211,629,305,934,17,951,1524,62.4%,41.27%,1
高雄市,苓雅區,1212,609,292,901,27,928,1455,63.78%,41.86%,1
高雄市,苓雅區,1213,506,207,713,20,733,1272,57.63%,39.78%,1
高雄市,苓雅區,1214,493,249,742,19,761,1256,60.59%,39.25%,1
高雄市,苓雅區,1215,523,192,715,23,738,1203,61.35%,43.47%,1
高雄市,苓雅區,1216,489,180,669,25,694,1062,65.35%,46.05%,1
高雄市,苓雅區,1217,366,168,534,43,577,850,67.88%,43.06%,1
高雄市,苓雅區,1218,422,224,646,51,697,1010,69.01%,41.78%,1
高雄市,苓雅區,1219,444,204,648,24,672,1118,60.11%,39.71%,1
高雄市,苓雅區,1220,406,179,585,30,615,937,65.64%,43.33%,1
高雄市,苓雅區,1221,586,245,831,20,851,1493,57%,39.25%,1
高雄市,苓雅區,1222,493,250,743,25,768,1183,64.92%,41.67%,1
高雄市,苓雅區,1223,514,231,745,23,768,1318,58.27%,39%,1
高雄市,苓雅區,1224,555,250,805,35,840,1362,61.67%,40.75%,1
高雄市,苓雅區,1225,448,206,654,36,690,1102,62.61%,40.65%,1
高雄市,苓雅區,1226,600,277,877,24,901,1481,60.84%,40.51%,1
高雄市,苓雅區,1227,387,163,550,29,579,878,65.95%,44.08%,1
高雄市,苓雅區,1228,371,147,518,15,533,908,58.7%,40.86%,1
高雄市,苓雅區,1229,457,215,672,23,695,1056,65.81%,43.28%,1
高雄市,苓雅區,1230,454,181,635,22,657,1091,60.22%,41.61%,1
高雄市,苓雅區,1231,414,198,612,21,633,976,64.86%,42.42%,1
高雄市,苓雅區,1232,462,236,698,25,723,1063,68.02%,43.46%,1
高雄市,苓雅區,1233,610,286,896,42,938,1484,63.21%,41.11%,1
高雄市,苓雅區,1234,522,270,792,26,818,1290,63.41%,40.47%,1
高雄市,苓雅區,1235,704,334,1038,44,1082,1740,62.18%,40.46%,1
高雄市,苓雅區,1236,659,283,942,30,972,1594,60.98%,41.34%,1
高雄市,苓雅區,1237,650,309,959,27,986,1648,59.83%,39.44%,1
高雄市,苓雅區,1238,556,226,782,29,811,1236,65.61%,44.98%,1
高雄市,苓雅區,1239,504,234,738,28,766,1211,63.25%,41.62%,1
高雄市,苓雅區,1240,572,214,786,19,805,1283,62.74%,44.58%,1
高雄市,苓雅區,1241,769,340,1109,49,1158,1804,64.19%,42.63%,1
高雄市,苓雅區,1242,718,327,1045,42,1087,1718,63.27%,41.79%,1
高雄市,苓雅區,1243,534,255,789,33,822,1297,63.38%,41.17%,1
高雄市,苓雅區,1244,580,266,846,51,897,1449,61.9%,40.03%,1
高雄市,苓雅區,1245,537,245,782,16,798,1307,61.06%,41.09%,1
高雄市,苓雅區,1246,508,221,729,29,758,1184,64.02%,42.91%,1
高雄市,苓雅區,1247,539,269,808,34,842,1250,67.36%,43.12%,1
高雄市,苓雅區,1248,489,230,719,28,747,1248,59.86%,39.18%,1
高雄市,苓雅區,1249,570,223,793,24,817,1283,63.68%,44.43%,1
高雄市,苓雅區,1250,540,196,736,22,758,1121,67.62%,48.17%,1
高雄市,苓雅區,1251,537,245,782,23,805,1258,63.99%,42.69%,1
高雄市,苓雅區,1252,574,246,820,15,835,1339,62.36%,42.87%,1
高雄市,苓雅區,1253,781,350,1131,50,1181,1986,59.47%,39.33%,1
高雄市,苓雅區,1254,466,161,627,20,647,1028,62.94%,45.33%,1
高雄市,苓雅區,1255,383,207,590,19,609,948,64.24%,40.4%,1
高雄市,前鎮區,1484,649,277,926,76,1002,1809,55.39%,35.88%,1
高雄市,前鎮區,1485,676,289,965,46,1011,1835,55.1%,36.84%,1
高雄市,前鎮區,1486,530,268,798,47,845,1890,44.71%,28.04%,1
高雄市,前鎮區,1487,659,328,987,49,1036,2013,51.47%,32.74%,1
高雄市,前鎮區,1488,618,300,918,45,963,1776,54.22%,34.8%,1
高雄市,前鎮區,1489,500,278,778,49,827,1705,48.5%,29.33%,1
高雄市,前鎮區,1490,251,122,373,48,421,672,62.65%,37.35%,1
高雄市,前鎮區,1491,559,264,823,49,872,1726,50.52%,32.39%,1
高雄市,前鎮區,1492,614,302,916,24,940,1597,58.86%,38.45%,1
高雄市,前鎮區,1493,640,315,955,51,1006,1690,59.53%,37.87%,1
高雄市,前鎮區,1494,468,178,646,50,696,1080,64.44%,43.33%,1
高雄市,前鎮區,1495,500,224,724,48,772,1159,66.61%,43.14%,1
高雄市,前鎮區,1496,522,200,722,46,768,1314,58.45%,39.73%,1
高雄市,前鎮區,1497,386,165,551,23,574,896,64.06%,43.08%,1
高雄市,前鎮區,1498,395,175,570,34,604,1002,60.28%,39.42%,1
高雄市,前鎮區,1499,724,317,1041,63,1104,2765,39.93%,26.18%,1
高雄市,前鎮區,1500,258,95,353,35,388,600,64.67%,43%,1
高雄市,前鎮區,1501,409,159,568,30,598,1466,40.79%,27.9%,1
高雄市,前鎮區,1502,602,236,838,39,877,1449,60.52%,41.55%,1
高雄市,前鎮區,1503,388,146,534,34,568,991,57.32%,39.15%,1
高雄市,前鎮區,1504,531,194,725,45,770,1248,61.7%,42.55%,1
高雄市,前鎮區,1505,449,185,634,59,693,1066,65.01%,42.12%,1
高雄市,前鎮區,1506,288,109,397,27,424,706,60.06%,40.79%,1
高雄市,前鎮區,1507,277,114,391,23,414,713,58.06%,38.85%,1
高雄市,前鎮區,1508,454,281,735,38,773,1344,57.51%,33.78%,1
高雄市,前鎮區,1509,351,160,511,32,543,856,63.43%,41%,1
高雄市,前鎮區,1510,336,155,491,21,512,873,58.65%,38.49%,1
高雄市,前鎮區,1511,444,179,623,30,653,1114,58.62%,39.86%,1
高雄市,前鎮區,1512,420,189,609,15,624,1112,56.12%,37.77%,1
高雄市,前鎮區,1513,390,187,577,43,620,1044,59.39%,37.36%,1
高雄市,前鎮區,1514,326,174,500,28,528,940,56.17%,34.68%,1
高雄市,前鎮區,1515,467,218,685,40,725,1342,54.02%,34.8%,1
高雄市,前鎮區,1516,592,295,887,46,933,1402,66.55%,42.23%,1
高雄市,前鎮區,1517,506,283,789,30,819,1320,62.05%,38.33%,1
高雄市,前鎮區,1518,388,164,552,27,579,958,60.44%,40.5%,1
高雄市,前鎮區,1519,594,255,849,32,881,1276,69.04%,46.55%,1
高雄市,前鎮區,1520,619,260,879,40,919,1459,62.99%,42.43%,1
高雄市,前鎮區,1521,281,105,386,23,409,761,53.75%,36.93%,1
高雄市,前鎮區,1522,420,194,614,18,632,1093,57.82%,38.43%,1
高雄市,前鎮區,1523,715,217,932,35,967,1521,63.58%,47.01%,1
高雄市,前鎮區,1524,706,232,938,39,977,1557,62.75%,45.34%,1
高雄市,前鎮區,1525,685,283,968,23,991,1821,54.42%,37.62%,1
高雄市,前鎮區,1526,568,150,718,19,737,1066,69.14%,53.28%,1
高雄市,前鎮區,1527,496,168,664,17,681,1046,65.11%,47.42%,1
高雄市,前鎮區,1528,645,321,966,47,1013,1709,59.27%,37.74%,1
高雄市,前鎮區,1529,713,302,1015,49,1064,1723,61.75%,41.38%,1
高雄市,前鎮區,1530,508,265,773,21,794,1202,66.06%,42.26%,1
高雄市,前鎮區,1531,572,274,846,34,880,1279,68.8%,44.72%,1
高雄市,前鎮區,1532,638,313,951,29,980,1513,64.77%,42.17%,1
高雄市,前鎮區,1533,506,234,740,21,761,1260,60.4%,40.16%,1
高雄市,前鎮區,1534,493,231,724,40,764,1139,67.08%,43.28%,1
高雄市,前鎮區,1535,495,238,733,34,767,1140,67.28%,43.42%,1
高雄市,前鎮區,1536,605,281,886,44,930,1462,63.61%,41.38%,1
高雄市,前鎮區,1537,574,253,827,26,853,1359,62.77%,42.24%,1
高雄市,前鎮區,1538,715,321,1036,54,1090,2037,53.51%,35.1%,1
高雄市,前鎮區,1539,534,257,791,31,822,1410,58.3%,37.87%,1
高雄市,前鎮區,1540,512,236,748,23,771,1307,58.99%,39.17%,1
高雄市,前鎮區,1541,560,265,825,56,881,1512,58.27%,37.04%,1
高雄市,前鎮區,1542,564,300,864,52,916,1491,61.44%,37.83%,1
高雄市,前鎮區,1543,665,254,919,38,957,1621,59.04%,41.02%,1
高雄市,前鎮區,1544,546,240,786,32,818,1522,53.75%,35.87%,1
高雄市,前鎮區,1545,617,307,924,45,969,1593,60.83%,38.73%,1
高雄市,前鎮區,1546,770,353,1123,48,1171,1885,62.12%,40.85%,1
高雄市,前鎮區,1547,724,376,1100,66,1166,1870,62.35%,38.72%,1
高雄市,前鎮區,1548,572,258,830,31,861,1388,62.03%,41.21%,1
高雄市,前鎮區,1549,552,253,805,38,843,1348,62.54%,40.95%,1
高雄市,前鎮區,1550,528,189,717,61,778,1341,58.02%,39.37%,1
高雄市,前鎮區,1551,597,268,865,29,894,1364,65.54%,43.77%,1
高雄市,前鎮區,1552,546,253,799,41,840,1367,61.45%,39.94%,1
高雄市,前鎮區,1553,526,234,760,41,801,1326,60.41%,39.67%,1
高雄市,前鎮區,1554,435,173,608,30,638,1059,60.25%,41.08%,1
高雄市,前鎮區,1555,458,227,685,16,701,1119,62.65%,40.93%,1
高雄市,前鎮區,1556,564,312,876,32,908,1565,58.02%,36.04%,1
高雄市,前鎮區,1557,638,253,891,37,928,1549,59.91%,41.19%,1
高雄市,前鎮區,1558,718,362,1080,20,1100,1691,65.05%,42.46%,1
高雄市,前鎮區,1559,711,350,1061,16,1077,1837,58.63%,38.7%,1
高雄市,前鎮區,1560,493,203,696,16,712,1092,65.2%,45.15%,1
高雄市,前鎮區,1561,470,203,673,37,710,1126,63.06%,41.74%,1
高雄市,前鎮區,1562,452,213,665,48,713,1215,58.68%,37.2%,1
高雄市,前鎮區,1563,586,292,878,21,899,1443,62.3%,40.61%,1
高雄市,前鎮區,1564,669,315,984,19,1003,1448,69.27%,46.2%,1
高雄市,前鎮區,1565,656,317,973,43,1016,1648,61.65%,39.81%,1
高雄市,前鎮區,1566,593,284,877,39,916,1603,57.14%,36.99%,1
高雄市,前鎮區,1567,551,262,813,22,835,1596,52.32%,34.52%,1
高雄市,前鎮區,1568,564,215,779,33,812,1450,56%,38.9%,1
高雄市,前鎮區,1569,556,263,819,42,861,1510,57.02%,36.82%,1
高雄市,前鎮區,1570,690,314,1004,43,1047,1647,63.57%,41.89%,1
高雄市,前鎮區,1571,552,206,758,35,793,1342,59.09%,41.13%,1
高雄市,前鎮區,1572,536,228,764,28,792,1384,57.23%,38.73%,1
高雄市,前鎮區,1573,601,231,832,39,871,1479,58.89%,40.64%,1
高雄市,前鎮區,1574,645,273,918,20,938,1546,60.67%,41.72%,1
高雄市,前鎮區,1575,598,349,947,30,977,1595,61.25%,37.49%,1
高雄市,前鎮區,1576,507,206,713,38,751,1201,62.53%,42.21%,1
高雄市,前鎮區,1577,448,141,589,33,622,1082,57.49%,41.4%,1
高雄市,前鎮區,1578,384,156,540,33,573,996,57.53%,38.55%,1
高雄市,前鎮區,1579,410,159,569,25,594,932,63.73%,43.99%,1
高雄市,前鎮區,1580,453,207,660,38,698,1146,60.91%,39.53%,1
高雄市,前鎮區,1581,461,199,660,22,682,1096,62.23%,42.06%,1
高雄市,前鎮區,1582,582,285,867,15,882,1332,66.22%,43.69%,1
高雄市,前鎮區,1583,467,233,700,21,721,1175,61.36%,39.74%,1
高雄市,前鎮區,1584,389,172,561,45,606,986,61.46%,39.45%,1
高雄市,前鎮區,1585,542,235,777,49,826,1316,62.77%,41.19%,1
高雄市,前鎮區,1586,532,275,807,46,853,1559,54.71%,34.12%,1
高雄市,前鎮區,1587,671,293,964,40,1004,1622,61.9%,41.37%,1
高雄市,前鎮區,1588,516,212,728,26,754,1310,57.56%,39.39%,1
高雄市,前鎮區,1589,571,224,795,36,831,1299,63.97%,43.96%,1
高雄市,前鎮區,1590,542,225,767,36,803,1191,67.42%,45.51%,1
高雄市,前鎮區,1591,566,217,783,24,807,1375,58.69%,41.16%,1
高雄市,前鎮區,1592,566,218,784,28,812,1338,60.69%,42.3%,1
高雄市,前鎮區,1593,445,226,671,24,695,1175,59.15%,37.87%,1
高雄市,前鎮區,1594,520,252,772,18,790,1357,58.22%,38.32%,1
高雄市,前鎮區,1595,508,237,745,49,794,1187,66.89%,42.8%,1
高雄市,前鎮區,1596,504,180,684,30,714,1164,61.34%,43.3%,1
高雄市,前鎮區,1597,510,224,734,48,782,1219,64.15%,41.84%,1
高雄市,前鎮區,1598,564,251,815,14,829,1428,58.05%,39.5%,1
高雄市,前鎮區,1599,557,282,839,53,892,1495,59.67%,37.26%,1
高雄市,前鎮區,1600,584,357,941,32,973,1531,63.55%,38.15%,1
高雄市,前鎮區,1601,587,278,865,37,902,1509,59.77%,38.9%,1
高雄市,前鎮區,1602,622,265,887,44,931,1591,58.52%,39.09%,1
高雄市,旗津區,0869,489,217,706,49,755,1177,64.15%,41.55%,1
高雄市,旗津區,0870,439,149,588,31,619,1109,55.82%,39.59%,1
高雄市,旗津區,0871,543,271,814,17,831,1642,50.61%,33.07%,1
高雄市,旗津區,0872,436,174,610,65,675,1209,55.83%,36.06%,1
高雄市,旗津區,0873,395,170,565,29,594,1112,53.42%,35.52%,1
高雄市,旗津區,0874,605,232,837,42,879,1483,59.27%,40.8%,1
高雄市,旗津區,0875,507,197,704,28,732,1460,50.14%,34.73%,1
高雄市,旗津區,0876,611,306,917,81,998,1572,63.49%,38.87%,1
高雄市,旗津區,0877,493,181,674,32,706,1384,51.01%,35.62%,1
高雄市,旗津區,0878,510,205,715,12,727,1390,52.3%,36.69%,1
高雄市,旗津區,0879,410,190,600,30,630,1239,50.85%,33.09%,1
高雄市,旗津區,0880,760,321,1081,56,1137,2045,55.6%,37.16%,1
高雄市,旗津區,0881,328,127,455,24,479,893,53.64%,36.73%,1
高雄市,旗津區,0882,635,302,937,57,994,1866,53.27%,34.03%,1
高雄市,旗津區,0883,608,251,859,24,883,1874,47.12%,32.44%,1
高雄市,旗津區,0884,306,119,425,39,464,893,51.96%,34.27%,1
高雄市,旗津區,0885,477,237,714,25,739,1215,60.82%,39.26%,1
高雄市,旗津區,0886,461,205,666,22,688,1297,53.05%,35.54%,1
高雄市,小港區,1603,485,221,706,22,728,1108,65.7%,43.77%,1
高雄市,小港區,1604,506,186,692,46,738,1171,63.02%,43.21%,1
高雄市,小港區,1605,600,361,961,22,983,1557,63.13%,38.54%,1
高雄市,小港區,1606,613,284,897,24,921,1668,55.22%,36.75%,1
高雄市,小港區,1607,557,193,750,27,777,1183,65.68%,47.08%,1
高雄市,小港區,1608,553,243,796,34,830,1372,60.5%,40.31%,1
高雄市,小港區,1609,712,312,1024,48,1072,1737,61.72%,40.99%,1
高雄市,小港區,1610,484,277,761,42,803,1586,50.63%,30.52%,1
高雄市,小港區,1611,597,224,821,35,856,1558,54.94%,38.32%,1
高雄市,小港區,1612,586,243,829,33,862,1284,67.13%,45.64%,1
高雄市,小港區,1613,514,229,743,38,781,1249,62.53%,41.15%,1
高雄市,小港區,1614,747,346,1093,44,1137,2400,47.38%,31.13%,1
高雄市,小港區,1615,541,208,749,25,774,1181,65.54%,45.81%,1
高雄市,小港區,1616,472,180,652,27,679,1079,62.93%,43.74%,1
高雄市,小港區,1617,483,286,769,25,794,1335,59.48%,36.18%,1
高雄市,小港區,1618,491,230,721,47,768,1241,61.89%,39.56%,1
高雄市,小港區,1619,572,265,837,46,883,1513,58.36%,37.81%,1
高雄市,小港區,1620,561,256,817,36,853,1349,63.23%,41.59%,1
高雄市,小港區,1621,565,266,831,37,868,1483,58.53%,38.1%,1
高雄市,小港區,1622,580,277,857,21,878,1451,60.51%,39.97%,1
高雄市,小港區,1623,465,219,684,19,703,1241,56.65%,37.47%,1
高雄市,小港區,1624,551,257,808,42,850,1262,67.35%,43.66%,1
高雄市,小港區,1625,765,303,1068,42,1110,1813,61.22%,42.2%,1
高雄市,小港區,1626,688,303,991,27,1018,1877,54.24%,36.65%,1
高雄市,小港區,1627,533,271,804,17,821,1391,59.02%,38.32%,1
高雄市,小港區,1628,517,384,901,21,922,1453,63.45%,35.58%,1
高雄市,小港區,1629,552,244,796,22,818,1374,59.53%,40.17%,1
高雄市,小港區,1630,553,231,784,25,809,1348,60.01%,41.02%,1
高雄市,小港區,1631,562,246,808,33,841,1334,63.04%,42.13%,1
高雄市,小港區,1632,542,292,834,19,853,1433,59.53%,37.82%,1
高雄市,小港區,1633,524,267,791,23,814,1448,56.22%,36.19%,1
高雄市,小港區,1634,606,306,912,51,963,1488,64.72%,40.73%,1
高雄市,小港區,1635,535,228,763,36,799,1278,62.52%,41.86%,1
高雄市,小港區,1636,561,313,874,30,904,1306,69.22%,42.96%,1
高雄市,小港區,1637,636,301,937,53,990,1625,60.92%,39.14%,1
高雄市,小港區,1638,683,324,1007,45,1052,1640,64.15%,41.65%,1
高雄市,小港區,1639,604,248,852,38,890,1506,59.1%,40.11%,1
高雄市,小港區,1640,531,236,767,41,808,1438,56.19%,36.93%,1
高雄市,小港區,1641,519,188,707,40,747,1105,67.6%,46.97%,1
高雄市,小港區,1642,474,185,659,14,673,1167,57.67%,40.62%,1
高雄市,小港區,1643,610,258,868,27,895,1420,63.03%,42.96%,1
高雄市,小港區,1644,567,299,866,45,911,1380,66.01%,41.09%,1
高雄市,小港區,1645,507,210,717,23,740,1239,59.73%,40.92%,1
高雄市,小港區,1646,640,293,933,42,975,1563,62.38%,40.95%,1
高雄市,小港區,1647,655,296,951,41,992,1644,60.34%,39.84%,1
高雄市,小港區,1648,756,297,1053,54,1107,1895,58.42%,39.89%,1
高雄市,小港區,1649,657,295,952,61,1013,1748,57.95%,37.59%,1
高雄市,小港區,1650,625,296,921,54,975,1579,61.75%,39.58%,1
高雄市,小港區,1651,808,366,1174,26,1200,2135,56.21%,37.85%,1
高雄市,小港區,1652,685,300,985,40,1025,1728,59.32%,39.64%,1
高雄市,小港區,1653,722,343,1065,48,1113,2022,55.04%,35.71%,1
高雄市,小港區,1654,495,183,678,19,697,1329,52.45%,37.25%,1
高雄市,小港區,1655,563,219,782,21,803,1320,60.83%,42.65%,1
高雄市,小港區,1656,520,218,738,50,788,1267,62.19%,41.04%,1
高雄市,小港區,1657,544,239,783,47,830,1298,63.94%,41.91%,1
高雄市,小港區,1658,548,271,819,13,832,1289,64.55%,42.51%,1
高雄市,小港區,1659,660,280,940,31,971,1534,63.3%,43.02%,1
高雄市,小港區,1660,642,255,897,25,922,1494,61.71%,42.97%,1
高雄市,小港區,1661,584,219,803,52,855,1377,62.09%,42.41%,1
高雄市,小港區,1662,570,267,837,33,870,1344,64.73%,42.41%,1
高雄市,小港區,1663,596,265,861,42,903,1508,59.88%,39.52%,1
高雄市,小港區,1664,527,249,776,21,797,1400,56.93%,37.64%,1
高雄市,小港區,1665,597,262,859,42,901,1457,61.84%,40.97%,1
高雄市,小港區,1666,545,214,759,28,787,1392,56.54%,39.15%,1
高雄市,小港區,1667,729,340,1069,41,1110,1983,55.98%,36.76%,1
高雄市,小港區,1668,485,224,709,15,724,1204,60.13%,40.28%,1
高雄市,小港區,1669,691,49,740,27,767,1300,59%,53.15%,1
高雄市,小港區,1670,786,318,1104,61,1165,1857,62.74%,42.33%,1
高雄市,小港區,1671,610,272,882,29,911,1566,58.17%,38.95%,1
高雄市,小港區,1672,678,165,843,43,886,1343,65.97%,50.48%,1
高雄市,小港區,1673,535,227,762,58,820,1236,66.34%,43.28%,1
高雄市,小港區,1674,666,285,951,53,1004,1564,64.19%,42.58%,1
高雄市,小港區,1675,570,397,967,26,993,1484,66.91%,38.41%,1
高雄市,小港區,1676,608,268,876,17,893,1477,60.46%,41.16%,1
高雄市,小港區,1677,561,333,894,34,928,1482,62.62%,37.85%,1
高雄市,小港區,1678,633,291,924,26,950,1708,55.62%,37.06%,1
高雄市,小港區,1679,590,337,927,49,976,1867,52.28%,31.6%,1
高雄市,小港區,1680,645,300,945,31,976,1709,57.11%,37.74%,1
高雄市,小港區,1681,517,222,739,47,786,1425,55.16%,36.28%,1
高雄市,小港區,1682,565,238,803,38,841,1696,49.59%,33.31%,1
高雄市,小港區,1683,498,253,751,36,787,1522,51.71%,32.72%,1
高雄市,小港區,1684,582,255,837,67,904,1531,59.05%,38.01%,1
高雄市,小港區,1685,811,355,1166,73,1239,2215,55.94%,36.61%,1
高雄市,小港區,1686,645,248,893,25,918,1515,60.59%,42.57%,1
高雄市,小港區,1687,572,268,840,24,864,1535,56.29%,37.26%,1
高雄市,小港區,1688,484,222,706,25,731,1276,57.29%,37.93%,1
高雄市,小港區,1689,512,108,620,39,659,1217,54.15%,42.07%,1
高雄市,小港區,1690,574,243,817,58,875,1707,51.26%,33.63%,1
高雄市,小港區,1691,681,293,974,61,1035,1920,53.91%,35.47%,1
高雄市,鳳山區,1256,463,232,695,27,722,1080,66.85%,42.87%,1
高雄市,鳳山區,1257,341,151,492,30,522,819,63.74%,41.64%,1
高雄市,鳳山區,1258,365,134,499,36,535,851,62.87%,42.89%,1
高雄市,鳳山區,1259,433,232,665,18,683,1075,63.53%,40.28%,1
高雄市,鳳山區,1260,537,216,753,28,781,1223,63.86%,43.91%,1
高雄市,鳳山區,1261,511,219,730,23,753,1207,62.39%,42.34%,1
高雄市,鳳山區,1262,494,232,726,24,750,1339,56.01%,36.89%,1
高雄市,鳳山區,1263,418,211,629,19,648,1188,54.55%,35.19%,1
高雄市,鳳山區,1264,412,214,626,21,647,1055,61.33%,39.05%,1
高雄市,鳳山區,1265,454,169,623,32,655,1109,59.06%,40.94%,1
高雄市,鳳山區,1266,355,144,499,18,517,756,68.39%,46.96%,1
高雄市,鳳山區,1267,454,203,657,31,688,1182,58.21%,38.41%,1
高雄市,鳳山區,1268,600,261,861,42,903,1496,60.36%,40.11%,1
高雄市,鳳山區,1269,675,347,1022,33,1055,2094,50.38%,32.23%,1
高雄市,鳳山區,1270,662,292,954,21,975,1672,58.31%,39.59%,1
高雄市,鳳山區,1271,643,319,962,16,978,1761,55.54%,36.51%,1
高雄市,鳳山區,1272,579,260,839,38,877,1450,60.48%,39.93%,1
高雄市,鳳山區,1273,502,241,743,21,764,1455,52.51%,34.5%,1
高雄市,鳳山區,1274,507,206,713,29,742,1234,60.13%,41.09%,1
高雄市,鳳山區,1275,679,358,1037,45,1082,1713,63.16%,39.64%,1
高雄市,鳳山區,1276,674,262,936,34,970,1698,57.13%,39.69%,1
高雄市,鳳山區,1277,492,256,748,30,778,1247,62.39%,39.45%,1
高雄市,鳳山區,1278,441,216,657,21,678,1087,62.37%,40.57%,1
高雄市,鳳山區,1279,497,227,724,23,747,1199,62.3%,41.45%,1
高雄市,鳳山區,1280,642,227,869,34,903,1559,57.92%,41.18%,1
高雄市,鳳山區,1281,521,251,772,27,799,1233,64.8%,42.25%,1
高雄市,鳳山區,1282,516,254,770,27,797,1277,62.41%,40.41%,1
高雄市,鳳山區,1283,636,246,882,13,895,1481,60.43%,42.94%,1
高雄市,鳳山區,1284,509,239,748,14,762,1154,66.03%,44.11%,1
高雄市,鳳山區,1285,612,104,716,15,731,1475,49.56%,41.49%,1
高雄市,鳳山區,1286,477,205,682,16,698,1247,55.97%,38.25%,1
高雄市,鳳山區,1287,580,250,830,32,862,1538,56.05%,37.71%,1
高雄市,鳳山區,1288,436,203,639,20,659,1097,60.07%,39.74%,1
高雄市,鳳山區,1289,442,213,655,18,673,1221,55.12%,36.2%,1
高雄市,鳳山區,1290,461,246,707,25,732,1075,68.09%,42.88%,1
高雄市,鳳山區,1291,727,318,1045,32,1077,1751,61.51%,41.52%,1
高雄市,鳳山區,1292,721,336,1057,28,1085,1758,61.72%,41.01%,1
高雄市,鳳山區,1293,705,294,999,45,1044,1749,59.69%,40.31%,1
高雄市,鳳山區,1294,680,246,926,13,939,1746,53.78%,38.95%,1
高雄市,鳳山區,1295,673,300,973,31,1004,1712,58.64%,39.31%,1
高雄市,鳳山區,1296,499,245,744,22,766,1247,61.43%,40.02%,1
高雄市,鳳山區,1297,558,270,828,42,870,1409,61.75%,39.6%,1
高雄市,鳳山區,1298,508,283,791,23,814,1347,60.43%,37.71%,1
高雄市,鳳山區,1299,699,316,1015,19,1034,1771,58.39%,39.47%,1
高雄市,鳳山區,1300,589,313,902,10,912,1537,59.34%,38.32%,1
高雄市,鳳山區,1301,667,295,962,23,985,1605,61.37%,41.56%,1
高雄市,鳳山區,1302,588,228,816,24,840,1375,61.09%,42.76%,1
高雄市,鳳山區,1303,582,266,848,34,882,1393,63.32%,41.78%,1
高雄市,鳳山區,1304,570,304,874,17,891,1584,56.25%,35.98%,1
高雄市,鳳山區,1305,244,130,374,15,389,618,62.94%,39.48%,1
高雄市,鳳山區,1306,192,77,269,8,277,423,65.48%,45.39%,1
高雄市,鳳山區,1307,545,224,769,33,802,1312,61.13%,41.54%,1
高雄市,鳳山區,1308,296,159,455,22,477,769,62.03%,38.49%,1
高雄市,鳳山區,1309,520,264,784,18,802,1213,66.12%,42.87%,1
高雄市,鳳山區,1310,549,187,736,14,750,1107,67.75%,49.59%,1
高雄市,鳳山區,1311,507,217,724,22,746,1188,62.79%,42.68%,1
高雄市,鳳山區,1312,475,254,729,26,755,1183,63.82%,40.15%,1
高雄市,鳳山區,1313,507,251,758,28,786,1264,62.18%,40.11%,1
高雄市,鳳山區,1314,396,141,537,20,557,882,63.15%,44.9%,1
高雄市,鳳山區,1315,469,213,682,26,708,1007,70.31%,46.57%,1
高雄市,鳳山區,1316,364,139,503,37,540,853,63.31%,42.67%,1
高雄市,鳳山區,1317,294,151,445,34,479,1660,28.86%,17.71%,1
高雄市,鳳山區,1318,471,211,682,25,707,1124,62.9%,41.9%,1
高雄市,鳳山區,1319,449,212,661,38,699,1112,62.86%,40.38%,1
高雄市,鳳山區,1320,464,193,657,25,682,1182,57.7%,39.26%,1
高雄市,鳳山區,1321,402,198,600,30,630,875,72%,45.94%,1
高雄市,鳳山區,1322,403,226,629,26,655,1040,62.98%,38.75%,1
高雄市,鳳山區,1323,466,242,708,16,724,1094,66.18%,42.6%,1
高雄市,鳳山區,1324,492,241,733,32,765,1217,62.86%,40.43%,1
高雄市,鳳山區,1325,429,214,643,22,665,974,68.28%,44.05%,1
高雄市,鳳山區,1326,407,196,603,18,621,987,62.92%,41.24%,1
高雄市,鳳山區,1327,554,235,789,13,802,1210,66.28%,45.79%,1
高雄市,鳳山區,1328,531,282,813,28,841,1391,60.46%,38.17%,1
高雄市,鳳山區,1329,415,222,637,18,655,1241,52.78%,33.44%,1
高雄市,鳳山區,1330,423,207,630,26,656,1000,65.6%,42.3%,1
高雄市,鳳山區,1331,470,200,670,16,686,1092,62.82%,43.04%,1
高雄市,鳳山區,1332,566,237,803,31,834,1308,63.76%,43.27%,1
高雄市,鳳山區,1333,451,170,621,28,649,1031,62.95%,43.74%,1
高雄市,鳳山區,1334,483,240,723,41,764,1159,65.92%,41.67%,1
高雄市,鳳山區,1335,462,182,644,31,675,1127,59.89%,40.99%,1
高雄市,鳳山區,1336,533,239,772,25,797,1109,71.87%,48.06%,1
高雄市,鳳山區,1337,841,328,1169,29,1198,1879,63.76%,44.76%,1
高雄市,鳳山區,1338,803,357,1160,33,1193,1803,66.17%,44.54%,1
高雄市,鳳山區,1339,762,310,1072,54,1126,2045,55.06%,37.26%,1
高雄市,鳳山區,1340,577,214,791,27,818,1432,57.12%,40.29%,1
高雄市,鳳山區,1341,457,148,605,22,627,1033,60.7%,44.24%,1
高雄市,鳳山區,1342,561,198,759,43,802,1253,64.01%,44.77%,1
高雄市,鳳山區,1343,501,232,733,18,751,1217,61.71%,41.17%,1
高雄市,鳳山區,1344,576,216,792,34,826,1267,65.19%,45.46%,1
高雄市,鳳山區,1345,511,211,722,32,754,1251,60.27%,40.85%,1
高雄市,鳳山區,1346,658,266,924,43,967,1563,61.87%,42.1%,1
高雄市,鳳山區,1347,784,344,1128,35,1163,1888,61.6%,41.53%,1
高雄市,鳳山區,1348,549,265,814,22,836,1368,61.11%,40.13%,1
高雄市,鳳山區,1349,572,277,849,35,884,1588,55.67%,36.02%,1
高雄市,鳳山區,1350,597,172,769,33,802,1255,63.9%,47.57%,1
高雄市,鳳山區,1351,515,215,730,36,766,1264,60.6%,40.74%,1
高雄市,鳳山區,1352,537,219,756,36,792,1291,61.35%,41.6%,1
高雄市,鳳山區,1353,546,188,734,17,751,1224,61.36%,44.61%,1
高雄市,鳳山區,1354,547,196,743,18,761,1296,58.72%,42.21%,1
高雄市,鳳山區,1355,366,162,528,30,558,826,67.55%,44.31%,1
高雄市,鳳山區,1356,550,180,730,26,756,1229,61.51%,44.75%,1
高雄市,鳳山區,1357,602,269,871,27,898,1467,61.21%,41.04%,1
高雄市,鳳山區,1358,510,211,721,30,751,1218,61.66%,41.87%,1
高雄市,鳳山區,1359,864,353,1217,34,1251,2173,57.57%,39.76%,1
高雄市,鳳山區,1360,930,355,1285,38,1323,2255,58.67%,41.24%,1
高雄市,鳳山區,1361,681,276,957,26,983,1556,63.17%,43.77%,1
高雄市,鳳山區,1362,586,257,843,21,864,1521,56.8%,38.53%,1
高雄市,鳳山區,1363,537,192,729,26,755,1407,53.66%,38.17%,1
高雄市,鳳山區,1364,640,260,900,38,938,1542,60.83%,41.5%,1
高雄市,鳳山區,1365,577,231,808,14,822,1502,54.73%,38.42%,1
高雄市,鳳山區,1366,551,239,790,32,822,1320,62.27%,41.74%,1
高雄市,鳳山區,1367,662,143,805,34,839,1507,55.67%,43.93%,1
高雄市,鳳山區,1368,627,169,796,34,830,1284,64.64%,48.83%,1
高雄市,鳳山區,1369,553,244,797,23,820,1441,56.9%,38.38%,1
高雄市,鳳山區,1370,654,223,877,49,926,1485,62.36%,44.04%,1
高雄市,鳳山區,1371,512,182,694,38,732,1205,60.75%,42.49%,1
高雄市,鳳山區,1372,511,205,716,19,735,1284,57.24%,39.8%,1
高雄市,鳳山區,1373,541,263,804,35,839,1326,63.27%,40.8%,1
高雄市,鳳山區,1374,465,201,666,20,686,1096,62.59%,42.43%,1
高雄市,鳳山區,1375,503,231,734,35,769,1182,65.06%,42.55%,1
高雄市,鳳山區,1376,473,193,666,38,704,1017,69.22%,46.51%,1
高雄市,鳳山區,1377,465,225,690,35,725,1198,60.52%,38.81%,1
高雄市,鳳山區,1378,476,234,710,24,734,1281,57.3%,37.16%,1
高雄市,鳳山區,1379,566,292,858,27,885,1358,65.17%,41.68%,1
高雄市,鳳山區,1380,536,270,806,22,828,1226,67.54%,43.72%,1
高雄市,鳳山區,1381,482,214,696,24,720,1098,65.57%,43.9%,1
高雄市,鳳山區,1382,493,234,727,27,754,1200,62.83%,41.08%,1
高雄市,鳳山區,1383,373,190,563,30,593,942,62.95%,39.6%,1
高雄市,鳳山區,1384,510,200,710,25,735,1206,60.95%,42.29%,1
高雄市,鳳山區,1385,482,213,695,20,715,1159,61.69%,41.59%,1
高雄市,鳳山區,1386,584,279,863,25,888,1401,63.38%,41.68%,1
高雄市,鳳山區,1387,599,266,865,15,880,1525,57.7%,39.28%,1
高雄市,鳳山區,1388,541,240,781,26,807,1345,60%,40.22%,1
高雄市,鳳山區,1389,530,121,651,23,674,1180,57.12%,44.92%,1
高雄市,鳳山區,1390,446,181,627,17,644,1106,58.23%,40.33%,1
高雄市,鳳山區,1391,604,284,888,41,929,1442,64.42%,41.89%,1
高雄市,鳳山區,1392,565,262,827,33,860,1376,62.5%,41.06%,1
高雄市,鳳山區,1393,533,224,757,19,776,1243,62.43%,42.88%,1
高雄市,鳳山區,1394,561,267,828,19,847,1361,62.23%,41.22%,1
高雄市,鳳山區,1395,569,304,873,18,891,1416,62.92%,40.18%,1
高雄市,鳳山區,1396,638,348,986,25,1011,1536,65.82%,41.54%,1
高雄市,鳳山區,1397,532,240,772,20,792,1388,57.06%,38.33%,1
高雄市,鳳山區,1398,533,203,736,43,779,1241,62.77%,42.95%,1
高雄市,鳳山區,1399,586,276,862,22,884,1394,63.41%,42.04%,1
高雄市,鳳山區,1400,535,248,783,11,794,1188,66.84%,45.03%,1
高雄市,鳳山區,1401,511,206,717,17,734,1112,66.01%,45.95%,1
高雄市,鳳山區,1402,532,257,789,11,800,1198,66.78%,44.41%,1
高雄市,鳳山區,1403,551,296,847,15,862,1475,58.44%,37.36%,1
高雄市,鳳山區,1404,492,188,680,26,706,1216,58.06%,40.46%,1
高雄市,鳳山區,1405,500,230,730,27,757,1318,57.44%,37.94%,1
高雄市,鳳山區,1406,573,272,845,30,875,1465,59.73%,39.11%,1
高雄市,鳳山區,1407,491,218,709,21,730,1314,55.56%,37.37%,1
高雄市,鳳山區,1408,592,261,853,16,869,1649,52.7%,35.9%,1
高雄市,鳳山區,1409,590,254,844,77,921,1601,57.53%,36.85%,1
高雄市,鳳山區,1410,436,228,664,22,686,1155,59.39%,37.75%,1
高雄市,鳳山區,1411,419,182,601,51,652,1050,62.1%,39.9%,1
高雄市,鳳山區,1412,543,226,769,24,793,1417,55.96%,38.32%,1
高雄市,鳳山區,1413,618,244,862,37,899,1525,58.95%,40.52%,1
高雄市,鳳山區,1414,638,263,901,30,931,1514,61.49%,42.14%,1
高雄市,鳳山區,1415,456,230,686,29,715,1190,60.08%,38.32%,1
高雄市,鳳山區,1416,505,229,734,19,753,1325,56.83%,38.11%,1
高雄市,鳳山區,1417,455,172,627,39,666,1049,63.49%,43.37%,1
高雄市,鳳山區,1418,468,177,645,14,659,1026,64.23%,45.61%,1
高雄市,鳳山區,1419,471,222,693,37,730,1152,63.37%,40.89%,1
高雄市,鳳山區,1420,367,308,675,20,695,1254,55.42%,29.27%,1
高雄市,鳳山區,1421,647,261,908,23,931,1688,55.15%,38.33%,1
高雄市,鳳山區,1422,696,249,945,36,981,1657,59.2%,42%,1
高雄市,鳳山區,1423,616,276,892,35,927,1729,53.61%,35.63%,1
高雄市,鳳山區,1424,669,309,978,14,992,1628,60.93%,41.09%,1
高雄市,鳳山區,1425,686,285,971,12,983,1891,51.98%,36.28%,1
高雄市,鳳山區,1426,709,265,974,23,997,1594,62.55%,44.48%,1
高雄市,鳳山區,1427,617,246,863,10,873,1342,65.05%,45.98%,1
高雄市,鳳山區,1428,643,281,924,26,950,1448,65.61%,44.41%,1
高雄市,鳳山區,1429,575,272,847,35,882,1405,62.78%,40.93%,1
高雄市,鳳山區,1430,525,164,689,37,726,1097,66.18%,47.86%,1
高雄市,鳳山區,1431,536,245,781,42,823,1248,65.95%,42.95%,1
高雄市,鳳山區,1432,514,220,734,31,765,1225,62.45%,41.96%,1
高雄市,鳳山區,1433,533,207,740,17,757,1214,62.36%,43.9%,1
高雄市,鳳山區,1434,860,344,1204,52,1256,2032,61.81%,42.32%,1
高雄市,鳳山區,1435,812,299,1111,45,1156,1927,59.99%,42.14%,1
高雄市,鳳山區,1436,810,345,1155,41,1196,2097,57.03%,38.63%,1
高雄市,鳳山區,1437,405,149,554,24,578,968,59.71%,41.84%,1
高雄市,鳳山區,1438,449,208,657,36,693,1200,57.75%,37.42%,1
高雄市,鳳山區,1439,434,207,641,35,676,1101,61.4%,39.42%,1
高雄市,鳳山區,1440,527,220,747,30,777,1369,56.76%,38.5%,1
高雄市,鳳山區,1441,633,262,895,40,935,1542,60.64%,41.05%,1
高雄市,鳳山區,1442,709,260,969,39,1008,1536,65.63%,46.16%,1
高雄市,鳳山區,1443,517,256,773,18,791,1382,57.24%,37.41%,1
高雄市,鳳山區,1444,580,263,843,51,894,1452,61.57%,39.94%,1
高雄市,鳳山區,1445,428,182,610,33,643,1058,60.78%,40.45%,1
高雄市,鳳山區,1446,436,172,608,28,636,976,65.16%,44.67%,1
高雄市,鳳山區,1447,573,241,814,20,834,1545,53.98%,37.09%,1
高雄市,鳳山區,1448,445,211,656,26,682,1143,59.67%,38.93%,1
高雄市,鳳山區,1449,251,113,364,11,375,1301,28.82%,19.29%,1
高雄市,鳳山區,1450,477,198,675,30,705,1250,56.4%,38.16%,1
高雄市,鳳山區,1451,472,216,688,31,719,1208,59.52%,39.07%,1
高雄市,鳳山區,1452,499,195,694,49,743,1202,61.81%,41.51%,1
高雄市,鳳山區,1453,538,288,826,44,870,1499,58.04%,35.89%,1
高雄市,鳳山區,1454,549,294,843,18,861,1522,56.57%,36.07%,1
高雄市,鳳山區,1455,477,231,708,32,740,1125,65.78%,42.4%,1
高雄市,鳳山區,1456,545,240,785,19,804,1307,61.51%,41.7%,1
高雄市,鳳山區,1457,570,268,838,36,874,1405,62.21%,40.57%,1
高雄市,鳳山區,1458,517,220,737,35,772,1252,61.66%,41.29%,1
高雄市,鳳山區,1459,571,236,807,15,822,1291,63.67%,44.23%,1
高雄市,鳳山區,1460,399,169,568,39,607,938,64.71%,42.54%,1
高雄市,鳳山區,1461,739,309,1048,29,1077,1783,60.4%,41.45%,1
高雄市,鳳山區,1462,474,211,685,24,709,1105,64.16%,42.9%,1
高雄市,鳳山區,1463,561,227,788,48,836,1392,60.06%,40.3%,1
高雄市,鳳山區,1464,577,227,804,31,835,1244,67.12%,46.38%,1
高雄市,鳳山區,1465,434,211,645,30,675,1154,58.49%,37.61%,1
高雄市,鳳山區,1466,471,231,702,33,735,1153,63.75%,40.85%,1
高雄市,鳳山區,1467,448,175,623,17,640,1148,55.75%,39.02%,1
高雄市,鳳山區,1468,560,212,772,55,827,1432,57.75%,39.11%,1
高雄市,鳳山區,1469,415,221,636,20,656,1429,45.91%,29.04%,1
高雄市,鳳山區,1470,584,240,824,26,850,1479,57.47%,39.49%,1
高雄市,鳳山區,1471,472,231,703,14,717,1026,69.88%,46%,1
高雄市,鳳山區,1472,451,184,635,49,684,993,68.88%,45.42%,1
高雄市,鳳山區,1473,419,162,581,38,619,947,65.36%,44.24%,1
高雄市,鳳山區,1474,437,179,616,33,649,1042,62.28%,41.94%,1
高雄市,鳳山區,1475,452,185,637,34,671,1098,61.11%,41.17%,1
高雄市,鳳山區,1476,461,214,675,13,688,1284,53.58%,35.9%,1
高雄市,鳳山區,1477,451,225,676,30,706,1242,56.84%,36.31%,1
高雄市,鳳山區,1478,443,214,657,43,700,1093,64.04%,40.53%,1
高雄市,鳳山區,1479,506,242,748,35,783,1353,57.87%,37.4%,1
高雄市,鳳山區,1480,529,231,760,15,775,1353,57.28%,39.1%,1
高雄市,鳳山區,1481,535,239,774,30,804,1309,61.42%,40.87%,1
高雄市,鳳山區,1482,605,327,932,47,979,1627,60.17%,37.19%,1
高雄市,鳳山區,1483,566,243,809,45,854,1372,62.24%,41.25%,1
高雄市,林園區,1773,508,221,729,46,775,1262,61.41%,40.25%,1
高雄市,林園區,1774,544,261,805,50,855,1562,54.74%,34.83%,1
高雄市,林園區,1775,430,188,618,24,642,1078,59.55%,39.89%,1
高雄市,林園區,1776,394,193,587,42,629,979,64.25%,40.25%,1
高雄市,林園區,1777,467,90,557,34,591,1195,49.46%,39.08%,1
高雄市,林園區,1778,506,209,715,43,758,1380,54.93%,36.67%,1
高雄市,林園區,1779,570,115,685,47,732,1280,57.19%,44.53%,1
高雄市,林園區,1780,467,212,679,26,705,1269,55.56%,36.8%,1
高雄市,林園區,1781,456,232,688,20,708,1568,45.15%,29.08%,1
高雄市,林園區,1782,450,244,694,43,737,1226,60.11%,36.7%,1
高雄市,林園區,1783,560,229,789,35,824,1480,55.68%,37.84%,1
高雄市,林園區,1784,586,232,818,45,863,1459,59.15%,40.16%,1
高雄市,林園區,1785,606,261,867,37,904,1593,56.75%,38.04%,1
高雄市,林園區,1786,320,150,470,78,548,895,61.23%,35.75%,1
高雄市,林園區,1787,400,158,558,20,578,1110,52.07%,36.04%,1
高雄市,林園區,1788,461,226,687,45,732,1348,54.3%,34.2%,1
高雄市,林園區,1789,348,159,507,43,550,912,60.31%,38.16%,1
高雄市,林園區,1790,366,298,664,40,704,1085,64.88%,33.73%,1
高雄市,林園區,1791,382,153,535,25,560,955,58.64%,40%,1
高雄市,林園區,1792,379,136,515,39,554,879,63.03%,43.12%,1
高雄市,林園區,1793,395,190,585,65,650,1103,58.93%,35.81%,1
高雄市,林園區,1794,452,186,638,48,686,1054,65.09%,42.88%,1
高雄市,林園區,1795,446,205,651,18,669,1292,51.78%,34.52%,1
高雄市,林園區,1796,557,264,821,17,838,1683,49.79%,33.1%,1
高雄市,林園區,1797,246,84,330,24,354,607,58.32%,40.53%,1
高雄市,林園區,1798,384,157,541,55,596,1012,58.89%,37.94%,1
高雄市,林園區,1799,402,186,588,31,619,1046,59.18%,38.43%,1
高雄市,林園區,1800,314,115,429,20,449,914,49.12%,34.35%,1
高雄市,林園區,1801,542,263,805,32,837,1405,59.57%,38.58%,1
高雄市,林園區,1802,503,258,761,37,798,1299,61.43%,38.72%,1
高雄市,林園區,1803,69,190,259,27,286,1170,24.44%,5.9%,1
高雄市,林園區,1804,398,219,617,21,638,1299,49.11%,30.64%,1
高雄市,林園區,1805,395,181,576,23,599,1031,58.1%,38.31%,1
高雄市,林園區,1806,328,123,451,22,473,849,55.71%,38.63%,1
高雄市,林園區,1807,304,139,443,50,493,838,58.83%,36.28%,1
高雄市,林園區,1808,376,173,549,16,565,938,60.23%,40.09%,1
高雄市,林園區,1809,411,149,560,19,579,1051,55.09%,39.11%,1
高雄市,林園區,1810,308,145,453,31,484,786,61.58%,39.19%,1
高雄市,林園區,1811,371,144,515,48,563,894,62.98%,41.5%,1
高雄市,林園區,1812,229,99,328,14,342,749,45.66%,30.57%,1
高雄市,林園區,1813,606,268,874,25,899,1485,60.54%,40.81%,1
高雄市,林園區,1814,600,261,861,55,916,1478,61.98%,40.6%,1
高雄市,林園區,1815,521,295,816,38,854,1345,63.49%,38.74%,1
高雄市,林園區,1816,364,184,548,31,579,1038,55.78%,35.07%,1
高雄市,林園區,1817,461,218,679,22,701,1203,58.27%,38.32%,1
高雄市,林園區,1818,348,296,644,18,662,1138,58.17%,30.58%,1
高雄市,林園區,1819,385,128,513,17,530,1025,51.71%,37.56%,1
高雄市,林園區,1820,507,219,726,62,788,1341,58.76%,37.81%,1
高雄市,林園區,1821,404,173,577,16,593,1218,48.69%,33.17%,1
高雄市,林園區,1822,405,140,545,12,557,1147,48.56%,35.31%,1
高雄市,林園區,1823,419,143,562,32,594,1176,50.51%,35.63%,1
高雄市,大寮區,1692,253,121,374,18,392,727,53.92%,34.8%,1
高雄市,大寮區,1693,238,121,359,13,372,718,51.81%,33.15%,1
高雄市,大寮區,1694,494,199,693,38,731,1340,54.55%,36.87%,1
高雄市,大寮區,1695,498,226,724,32,756,1575,48%,31.62%,1
高雄市,大寮區,1696,174,75,249,16,265,444,59.68%,39.19%,1
高雄市,大寮區,1697,833,188,1021,188,1209,2374,50.93%,35.09%,1
高雄市,大寮區,1698,478,211,689,54,743,1291,57.55%,37.03%,1
高雄市,大寮區,1699,534,221,755,66,821,1400,58.64%,38.14%,1
高雄市,大寮區,1700,533,230,763,27,790,1390,56.83%,38.35%,1
高雄市,大寮區,1701,495,225,720,65,785,1401,56.03%,35.33%,1
高雄市,大寮區,1702,425,175,600,37,637,1199,53.13%,35.45%,1
高雄市,大寮區,1703,402,209,611,23,634,1210,52.4%,33.22%,1
高雄市,大寮區,1704,439,198,637,38,675,1195,56.49%,36.74%,1
高雄市,大寮區,1705,450,218,668,23,691,1166,59.26%,38.59%,1
高雄市,大寮區,1706,536,224,760,27,787,1353,58.17%,39.62%,1
高雄市,大寮區,1707,402,197,599,50,649,1052,61.69%,38.21%,1
高雄市,大寮區,1708,347,159,506,21,527,1024,51.46%,33.89%,1
高雄市,大寮區,1709,516,183,699,20,719,1189,60.47%,43.4%,1
高雄市,大寮區,1710,613,252,865,51,916,1512,60.58%,40.54%,1
高雄市,大寮區,1711,583,247,830,53,883,1633,54.07%,35.7%,1
高雄市,大寮區,1712,532,205,737,39,776,1214,63.92%,43.82%,1
高雄市,大寮區,1713,561,233,794,48,842,1258,66.93%,44.59%,1
高雄市,大寮區,1714,602,235,837,23,860,1323,65%,45.5%,1
高雄市,大寮區,1715,550,205,755,27,782,1253,62.41%,43.89%,1
高雄市,大寮區,1716,437,177,614,47,661,1035,63.86%,42.22%,1
高雄市,大寮區,1717,460,168,628,25,653,1106,59.04%,41.59%,1
高雄市,大寮區,1718,483,182,665,24,689,1195,57.66%,40.42%,1
高雄市,大寮區,1719,469,185,654,20,674,1051,64.13%,44.62%,1
高雄市,大寮區,1720,543,252,795,65,860,1425,60.35%,38.11%,1
高雄市,大寮區,1721,616,259,875,43,918,1635,56.15%,37.68%,1
高雄市,大寮區,1722,551,223,774,40,814,1359,59.9%,40.54%,1
高雄市,大寮區,1723,552,216,768,47,815,1361,59.88%,40.56%,1
高雄市,大寮區,1724,642,269,911,29,940,1629,57.7%,39.41%,1
高雄市,大寮區,1725,648,209,857,32,889,1518,58.56%,42.69%,1
高雄市,大寮區,1726,626,227,853,41,894,1620,55.19%,38.64%,1
高雄市,大寮區,1727,636,253,889,16,905,1648,54.92%,38.59%,1
高雄市,大寮區,1728,562,231,793,40,833,1385,60.14%,40.58%,1
高雄市,大寮區,1729,540,239,779,26,805,1435,56.1%,37.63%,1
高雄市,大寮區,1730,430,163,593,23,616,1046,58.89%,41.11%,1
高雄市,大寮區,1731,291,112,403,26,429,789,54.37%,36.88%,1
高雄市,大寮區,1732,310,162,472,21,493,909,54.24%,34.1%,1
高雄市,大寮區,1733,268,146,414,28,442,733,60.3%,36.56%,1
高雄市,大寮區,1734,564,272,836,45,881,1553,56.73%,36.32%,1
高雄市,大寮區,1735,346,155,501,27,528,922,57.27%,37.53%,1
高雄市,大寮區,1736,403,152,555,41,596,1012,58.89%,39.82%,1
高雄市,大寮區,1737,365,153,518,32,550,968,56.82%,37.71%,1
高雄市,大寮區,1738,454,155,609,19,628,1021,61.51%,44.47%,1
高雄市,大寮區,1739,520,195,715,57,772,1554,49.68%,33.46%,1
高雄市,大寮區,1740,458,200,658,41,699,1120,62.41%,40.89%,1
高雄市,大寮區,1741,505,225,730,31,761,1225,62.12%,41.22%,1
高雄市,大寮區,1742,353,143,496,19,515,1320,39.02%,26.74%,1
高雄市,大寮區,1743,480,243,723,43,766,1317,58.16%,36.45%,1
高雄市,大寮區,1744,404,209,613,21,634,1119,56.66%,36.1%,1
高雄市,大寮區,1745,480,219,699,31,730,1190,61.34%,40.34%,1
高雄市,大寮區,1746,511,221,732,27,759,1229,61.76%,41.58%,1
高雄市,大寮區,1747,523,206,729,28,757,1178,64.26%,44.4%,1
高雄市,大寮區,1748,515,253,768,30,798,1272,62.74%,40.49%,1
高雄市,大寮區,1749,542,240,782,27,809,1413,57.25%,38.36%,1
高雄市,大寮區,1750,514,183,697,44,741,1185,62.53%,43.38%,1
高雄市,大寮區,1751,247,77,324,6,330,553,59.67%,44.67%,1
高雄市,大寮區,1752,397,183,580,51,631,1121,56.29%,35.41%,1
高雄市,大寮區,1753,460,235,695,35,730,1227,59.49%,37.49%,1
高雄市,大寮區,1754,467,217,684,37,721,1058,68.15%,44.14%,1
高雄市,大寮區,1755,459,218,677,19,696,1209,57.57%,37.97%,1
高雄市,大寮區,1756,475,187,662,21,683,1100,62.09%,43.18%,1
高雄市,大寮區,1757,419,192,611,20,631,1122,56.24%,37.34%,1
高雄市,大寮區,1758,422,181,603,43,646,983,65.72%,42.93%,1
高雄市,大寮區,1759,476,155,631,13,644,1192,54.03%,39.93%,1
高雄市,大寮區,1760,320,120,440,22,462,719,64.26%,44.51%,1
高雄市,大寮區,1761,335,161,496,29,525,829,63.33%,40.41%,1
高雄市,大寮區,1762,383,118,501,32,533,771,69.13%,49.68%,1
高雄市,大寮區,1763,451,202,653,33,686,1075,63.81%,41.95%,1
高雄市,大寮區,1764,532,199,731,68,799,1280,62.42%,41.56%,1
高雄市,大寮區,1765,460,192,652,49,701,1179,59.46%,39.02%,1
高雄市,大寮區,1766,474,199,673,27,700,1210,57.85%,39.17%,1
高雄市,大寮區,1767,91,24,115,5,120,189,63.49%,48.15%,1
高雄市,大寮區,1768,517,197,714,42,756,1228,61.56%,42.1%,1
高雄市,大寮區,1769,498,165,663,26,689,1170,58.89%,42.56%,1
高雄市,大寮區,1770,623,228,851,31,882,1416,62.29%,44%,1
高雄市,大寮區,1771,619,265,884,23,907,1482,61.2%,41.77%,1
高雄市,大寮區,1772,553,233,786,37,823,1478,55.68%,37.42%,1
高雄市,大樹區,0736,515,252,767,29,796,1386,57.43%,37.16%,1
高雄市,大樹區,0737,613,220,833,31,864,1315,65.7%,46.62%,1
高雄市,大樹區,0738,930,371,1301,50,1351,2461,54.9%,37.79%,1
高雄市,大樹區,0739,503,203,706,33,739,1274,58.01%,39.48%,1
高雄市,大樹區,0740,468,199,667,41,708,1265,55.97%,37%,1
高雄市,大樹區,0741,570,230,800,51,851,1504,56.58%,37.9%,1
高雄市,大樹區,0742,371,190,561,17,578,1049,55.1%,35.37%,1
高雄市,大樹區,0743,562,275,837,43,880,1573,55.94%,35.73%,1
高雄市,大樹區,0744,389,163,552,25,577,1121,51.47%,34.7%,1
高雄市,大樹區,0745,535,178,713,33,746,1207,61.81%,44.32%,1
高雄市,大樹區,0746,445,128,573,22,595,1134,52.47%,39.24%,1
高雄市,大樹區,0747,463,204,667,36,703,1124,62.54%,41.19%,1
高雄市,大樹區,0748,450,203,653,73,726,1259,57.66%,35.74%,1
高雄市,大樹區,0749,410,233,643,53,696,1105,62.99%,37.1%,1
高雄市,大樹區,0750,403,205,608,44,652,1128,57.8%,35.73%,1
高雄市,大樹區,0751,357,168,525,78,603,1079,55.89%,33.09%,1
高雄市,大樹區,0752,357,142,499,43,542,1025,52.88%,34.83%,1
高雄市,大樹區,0753,323,161,484,47,531,950,55.89%,34%,1
高雄市,大樹區,0754,495,236,731,83,814,1433,56.8%,34.54%,1
高雄市,大樹區,0755,284,129,413,17,430,794,54.16%,35.77%,1
高雄市,大樹區,0756,247,111,358,9,367,781,46.99%,31.63%,1
高雄市,大樹區,0757,449,189,638,23,661,1318,50.15%,34.07%,1
高雄市,大樹區,0758,259,117,376,41,417,736,56.66%,35.19%,1
高雄市,大樹區,0759,328,180,508,11,519,1047,49.57%,31.33%,1
高雄市,大樹區,0760,533,164,697,53,750,1271,59.01%,41.94%,1
高雄市,大樹區,0761,410,90,500,21,521,1186,43.93%,34.57%,1
高雄市,大樹區,0762,391,149,540,46,586,1007,58.19%,38.83%,1
高雄市,大樹區,0763,336,147,483,37,520,859,60.54%,39.12%,1
高雄市,大樹區,0764,262,106,368,14,382,735,51.97%,35.65%,1
高雄市,大樹區,0765,413,178,591,58,649,1046,62.05%,39.48%,1
高雄市,大樹區,0766,517,102,619,33,652,880,74.09%,58.75%,1
高雄市,大樹區,0767,295,81,376,21,397,720,55.14%,40.97%,1
高雄市,大社區,0637,346,143,489,54,543,950,57.16%,36.42%,1
高雄市,大社區,0638,491,219,710,17,727,1306,55.67%,37.6%,1
高雄市,大社區,0639,566,263,829,24,853,1856,45.96%,30.5%,1
高雄市,大社區,0640,411,201,612,33,645,986,65.42%,41.68%,1
高雄市,大社區,0641,359,184,543,30,573,1116,51.34%,32.17%,1
高雄市,大社區,0642,501,280,781,34,815,1253,65.04%,39.98%,1
高雄市,大社區,0643,558,383,941,39,980,1613,60.76%,34.59%,1
高雄市,大社區,0644,498,257,755,30,785,1455,53.95%,34.23%,1
高雄市,大社區,0645,675,327,1002,38,1040,1674,62.13%,40.32%,1
高雄市,大社區,0646,416,169,585,37,622,1004,61.95%,41.43%,1
高雄市,大社區,0647,367,146,513,28,541,879,61.55%,41.75%,1
高雄市,大社區,0648,293,159,452,0,452,778,58.1%,37.66%,1
高雄市,大社區,0649,428,215,643,37,680,1110,61.26%,38.56%,1
高雄市,大社區,0650,486,276,762,5,767,1432,53.56%,33.94%,1
高雄市,大社區,0651,605,280,885,29,914,1466,62.35%,41.27%,1
高雄市,大社區,0652,564,297,861,49,910,1383,65.8%,40.78%,1
高雄市,大社區,0653,618,307,925,67,992,1645,60.3%,37.57%,1
高雄市,大社區,0654,467,283,750,32,782,1555,50.29%,30.03%,1
高雄市,大社區,0655,628,354,982,46,1028,1750,58.74%,35.89%,1
高雄市,大社區,0656,408,217,625,42,667,1111,60.04%,36.72%,1
高雄市,大社區,0657,431,211,642,48,690,1133,60.9%,38.04%,1
高雄市,大社區,0658,347,174,521,35,556,912,60.96%,38.05%,1
高雄市,大社區,0659,236,118,354,14,368,745,49.4%,31.68%,1
高雄市,大社區,0660,361,193,554,21,575,934,61.56%,38.65%,1
高雄市,仁武區,0661,844,324,1168,27,1195,1777,67.25%,47.5%,1
高雄市,仁武區,0662,942,417,1359,46,1405,2273,61.81%,41.44%,1
高雄市,仁武區,0663,611,274,885,40,925,1384,66.84%,44.15%,1
高雄市,仁武區,0664,456,208,664,33,697,1170,59.57%,38.97%,1
高雄市,仁武區,0665,533,253,786,36,822,1216,67.6%,43.83%,1
高雄市,仁武區,0666,641,266,907,11,918,1598,57.45%,40.11%,1
高雄市,仁武區,0667,949,376,1325,15,1340,2143,62.53%,44.28%,1
高雄市,仁武區,0668,496,219,715,33,748,1300,57.54%,38.15%,1
高雄市,仁武區,0669,540,243,783,43,826,1338,61.73%,40.36%,1
高雄市,仁武區,0670,447,221,668,20,688,1217,56.53%,36.73%,1
高雄市,仁武區,0671,424,163,587,36,623,1202,51.83%,35.27%,1
高雄市,仁武區,0672,508,243,751,35,786,1404,55.98%,36.18%,1
高雄市,仁武區,0673,315,137,452,29,481,830,57.95%,37.95%,1
高雄市,仁武區,0674,585,219,804,32,836,1802,46.39%,32.46%,1
高雄市,仁武區,0675,668,310,978,41,1019,1877,54.29%,35.59%,1
高雄市,仁武區,0676,566,267,833,26,859,1738,49.42%,32.57%,1
高雄市,仁武區,0677,591,281,872,35,907,1549,58.55%,38.15%,1
高雄市,仁武區,0678,629,280,909,38,947,1579,59.97%,39.84%,1
高雄市,仁武區,0679,573,208,781,32,813,1406,57.82%,40.75%,1
高雄市,仁武區,0680,612,250,862,24,886,1461,60.64%,41.89%,1
高雄市,仁武區,0681,545,251,796,25,821,1311,62.62%,41.57%,1
高雄市,仁武區,0682,555,232,787,18,805,1373,58.63%,40.42%,1
高雄市,仁武區,0683,376,203,579,20,599,1035,57.87%,36.33%,1
高雄市,仁武區,0684,470,205,675,18,693,1181,58.68%,39.8%,1
高雄市,仁武區,0685,605,307,912,35,947,1670,56.71%,36.23%,1
高雄市,仁武區,0686,626,270,896,14,910,1576,57.74%,39.72%,1
高雄市,仁武區,0687,667,284,951,32,983,1576,62.37%,42.32%,1
高雄市,仁武區,0688,839,337,1176,25,1201,1915,62.72%,43.81%,1
高雄市,仁武區,0689,703,282,985,25,1010,1758,57.45%,39.99%,1
高雄市,仁武區,0690,833,321,1154,42,1196,1892,63.21%,44.03%,1
高雄市,仁武區,0691,808,369,1177,51,1228,2025,60.64%,39.9%,1
高雄市,仁武區,0692,837,388,1225,32,1257,2014,62.41%,41.56%,1
高雄市,仁武區,0693,662,300,962,33,995,1473,67.55%,44.94%,1
高雄市,仁武區,0694,395,172,567,22,589,979,60.16%,40.35%,1
高雄市,仁武區,0695,422,145,567,18,585,944,61.97%,44.7%,1
高雄市,仁武區,0696,472,188,660,51,711,1153,61.67%,40.94%,1
高雄市,仁武區,0697,507,223,730,31,761,1328,57.3%,38.18%,1
高雄市,仁武區,0698,661,292,953,48,1001,1657,60.41%,39.89%,1
高雄市,仁武區,0699,557,244,801,32,833,1545,53.92%,36.05%,1
高雄市,仁武區,0700,612,239,851,40,891,1417,62.88%,43.19%,1
高雄市,仁武區,0701,708,302,1010,26,1036,1602,64.67%,44.19%,1
高雄市,仁武區,0702,827,313,1140,48,1188,1823,65.17%,45.36%,1
高雄市,仁武區,0703,730,356,1086,35,1121,1914,58.57%,38.14%,1
高雄市,仁武區,0704,823,339,1162,39,1201,1992,60.29%,41.32%,1
高雄市,仁武區,0705,739,315,1054,20,1074,2045,52.52%,36.14%,1
高雄市,仁武區,0706,804,388,1192,35,1227,1982,61.91%,40.57%,1
高雄市,仁武區,0707,814,346,1160,28,1188,2167,54.82%,37.56%,1
高雄市,鳥松區,0708,641,312,953,47,1000,1678,59.59%,38.2%,1
高雄市,鳥松區,0709,607,260,867,69,936,1682,55.65%,36.09%,1
高雄市,鳥松區,0710,505,257,762,33,795,1225,64.9%,41.22%,1
高雄市,鳥松區,0711,463,238,701,34,735,1322,55.6%,35.02%,1
高雄市,鳥松區,0712,494,225,719,21,740,1215,60.91%,40.66%,1
高雄市,鳥松區,0713,661,322,983,27,1010,1779,56.77%,37.16%,1
高雄市,鳥松區,0714,369,361,730,16,746,1129,66.08%,32.68%,1
高雄市,鳥松區,0715,574,255,829,40,869,1374,63.25%,41.78%,1
高雄市,鳥松區,0716,417,217,634,36,670,1089,61.52%,38.29%,1
高雄市,鳥松區,0717,961,361,1322,49,1371,2219,61.78%,43.31%,1
高雄市,鳥松區,0718,655,309,964,25,989,1634,60.53%,40.09%,1
高雄市,鳥松區,0719,661,283,944,50,994,1553,64.01%,42.56%,1
高雄市,鳥松區,0720,641,321,962,39,1001,1572,63.68%,40.78%,1
高雄市,鳥松區,0721,669,370,1039,33,1072,1688,63.51%,39.63%,1
高雄市,鳥松區,0722,666,345,1011,28,1039,1626,63.9%,40.96%,1
高雄市,鳥松區,0723,692,380,1072,49,1121,1744,64.28%,39.68%,1
高雄市,鳥松區,0724,490,179,669,33,702,1230,57.07%,39.84%,1
高雄市,鳥松區,0725,482,243,725,54,779,1201,64.86%,40.13%,1
高雄市,鳥松區,0726,523,187,710,29,739,1117,66.16%,46.82%,1
高雄市,鳥松區,0727,542,176,718,39,757,1255,60.32%,43.19%,1
高雄市,鳥松區,0728,541,244,785,1,786,1432,54.89%,37.78%,1
高雄市,鳥松區,0729,533,199,732,22,754,1370,55.04%,38.91%,1
高雄市,鳥松區,0730,572,229,801,54,855,1364,62.68%,41.94%,1
高雄市,鳥松區,0731,481,162,643,40,683,1041,65.61%,46.21%,1
高雄市,鳥松區,0732,344,138,482,30,512,702,72.93%,49%,1
高雄市,鳥松區,0733,476,226,702,43,745,1212,61.47%,39.27%,1
高雄市,鳥松區,0734,518,198,716,39,755,1289,58.57%,40.19%,1
高雄市,鳥松區,0735,608,303,911,31,942,1449,65.01%,41.96%,1
高雄市,岡山區,0261,603,264,867,27,894,1345,66.47%,44.83%,1
高雄市,岡山區,0262,344,156,500,13,513,1045,49.09%,32.92%,1
高雄市,岡山區,0263,435,184,619,26,645,1051,61.37%,41.39%,1
高雄市,岡山區,0264,376,188,564,12,576,917,62.81%,41%,1
高雄市,岡山區,0265,396,206,602,18,620,934,66.38%,42.4%,1
高雄市,岡山區,0266,502,161,663,31,694,1097,63.26%,45.76%,1
高雄市,岡山區,0267,668,116,784,23,807,1208,66.8%,55.3%,1
高雄市,岡山區,0268,524,211,735,41,776,1159,66.95%,45.21%,1
高雄市,岡山區,0269,405,191,596,30,626,1018,61.49%,39.78%,1
高雄市,岡山區,0270,491,212,703,25,728,1316,55.32%,37.31%,1
高雄市,岡山區,0271,542,233,775,31,806,1345,59.93%,40.3%,1
高雄市,岡山區,0272,544,229,773,36,809,1295,62.47%,42.01%,1
高雄市,岡山區,0273,568,252,820,28,848,1425,59.51%,39.86%,1
高雄市,岡山區,0274,542,226,768,24,792,1328,59.64%,40.81%,1
高雄市,岡山區,0275,600,245,845,14,859,1382,62.16%,43.42%,1
高雄市,岡山區,0276,597,241,838,15,853,1381,61.77%,43.23%,1
高雄市,岡山區,0277,507,229,736,44,780,1282,60.84%,39.55%,1
高雄市,岡山區,0278,494,217,711,20,731,1240,58.95%,39.84%,1
高雄市,岡山區,0279,535,240,775,32,807,1327,60.81%,40.32%,1
高雄市,岡山區,0280,598,333,931,35,966,1736,55.65%,34.45%,1
高雄市,岡山區,0281,622,286,908,42,950,1566,60.66%,39.72%,1
高雄市,岡山區,0282,625,276,901,33,934,1779,52.5%,35.13%,1
高雄市,岡山區,0283,638,271,909,56,965,1593,60.58%,40.05%,1
高雄市,岡山區,0284,618,266,884,45,929,1480,62.77%,41.76%,1
高雄市,岡山區,0285,598,208,806,30,836,1364,61.29%,43.84%,1
高雄市,岡山區,0286,602,241,843,29,872,1410,61.84%,42.7%,1
高雄市,岡山區,0287,566,196,762,31,793,1148,69.08%,49.3%,1
高雄市,岡山區,0288,257,126,383,35,418,625,66.88%,41.12%,1
高雄市,岡山區,0289,390,186,576,27,603,969,62.23%,40.25%,1
高雄市,岡山區,0290,380,164,544,14,558,861,64.81%,44.13%,1
高雄市,岡山區,0291,316,136,452,19,471,823,57.23%,38.4%,1
高雄市,岡山區,0292,394,165,559,44,603,889,67.83%,44.32%,1
高雄市,岡山區,0293,517,220,737,41,778,1283,60.64%,40.3%,1
高雄市,岡山區,0294,597,246,843,29,872,1512,57.67%,39.48%,1
高雄市,岡山區,0295,431,205,636,36,672,983,68.36%,43.85%,1
高雄市,岡山區,0296,503,221,724,36,760,1262,60.22%,39.86%,1
高雄市,岡山區,0297,458,199,657,31,688,1096,62.77%,41.79%,1
高雄市,岡山區,0298,421,200,621,28,649,1066,60.88%,39.49%,1
高雄市,岡山區,0299,447,193,640,29,669,1188,56.31%,37.63%,1
高雄市,岡山區,0300,571,261,832,29,861,1360,63.31%,41.99%,1
高雄市,岡山區,0301,603,254,857,27,884,1363,64.86%,44.24%,1
高雄市,岡山區,0302,575,255,830,47,877,1352,64.87%,42.53%,1
高雄市,岡山區,0303,594,239,833,40,873,1460,59.79%,40.68%,1
高雄市,岡山區,0304,496,260,756,32,788,1272,61.95%,38.99%,1
高雄市,岡山區,0305,459,218,677,22,699,1080,64.72%,42.5%,1
高雄市,岡山區,0306,497,236,733,48,781,1255,62.23%,39.6%,1
高雄市,岡山區,0307,430,159,589,40,629,938,67.06%,45.84%,1
高雄市,岡山區,0308,553,205,758,36,794,1237,64.19%,44.7%,1
高雄市,岡山區,0309,570,208,778,23,801,1413,56.69%,40.34%,1
高雄市,岡山區,0310,326,142,468,11,479,765,62.61%,42.61%,1
高雄市,岡山區,0311,473,204,677,18,695,1043,66.63%,45.35%,1
高雄市,岡山區,0312,354,113,467,40,507,844,60.07%,41.94%,1
高雄市,岡山區,0313,488,218,706,29,735,993,74.02%,49.14%,1
高雄市,岡山區,0314,423,199,622,51,673,1038,64.84%,40.75%,1
高雄市,岡山區,0315,428,179,607,57,664,1070,62.06%,40%,1
高雄市,岡山區,0316,457,192,649,49,698,1023,68.23%,44.67%,1
高雄市,岡山區,0317,561,231,792,28,820,1349,60.79%,41.59%,1
高雄市,岡山區,0318,644,115,759,44,803,1452,55.3%,44.35%,1
高雄市,岡山區,0319,117,73,190,16,206,301,68.44%,38.87%,1
高雄市,岡山區,0320,309,142,451,66,517,756,68.39%,40.87%,1
高雄市,岡山區,0321,272,123,395,11,406,733,55.39%,37.11%,1
高雄市,岡山區,0322,381,159,540,60,600,854,70.26%,44.61%,1
高雄市,岡山區,0323,306,123,429,20,449,866,51.85%,35.33%,1
高雄市,岡山區,0324,389,151,540,32,572,978,58.49%,39.78%,1
高雄市,岡山區,0325,601,195,796,26,822,1336,61.53%,44.99%,1
高雄市,岡山區,0326,612,160,772,11,783,1218,64.29%,50.25%,1
高雄市,岡山區,0327,158,92,250,8,258,341,75.66%,46.33%,1
高雄市,岡山區,0328,560,129,689,26,715,955,74.87%,58.64%,1
高雄市,岡山區,0329,513,125,638,17,655,940,69.68%,54.57%,1
高雄市,岡山區,0330,390,164,554,22,576,851,67.69%,45.83%,1
高雄市,岡山區,0331,387,138,525,13,538,762,70.6%,50.79%,1
高雄市,岡山區,0332,158,77,235,6,241,318,75.79%,49.69%,1
高雄市,橋頭區,0404,411,215,626,52,678,1005,67.46%,40.9%,1
高雄市,橋頭區,0405,435,212,647,38,685,1073,63.84%,40.54%,1
高雄市,橋頭區,0406,500,217,717,22,739,1129,65.46%,44.29%,1
高雄市,橋頭區,0407,514,241,755,48,803,1244,64.55%,41.32%,1
高雄市,橋頭區,0408,441,200,641,23,664,1091,60.86%,40.42%,1
高雄市,橋頭區,0409,599,247,846,37,883,1329,66.44%,45.07%,1
高雄市,橋頭區,0410,471,220,691,26,717,1140,62.89%,41.32%,1
高雄市,橋頭區,0411,484,225,709,61,770,1220,63.11%,39.67%,1
高雄市,橋頭區,0412,465,211,676,39,715,1047,68.29%,44.41%,1
高雄市,橋頭區,0413,490,246,736,64,800,1315,60.84%,37.26%,1
高雄市,橋頭區,0414,290,122,412,23,435,691,62.95%,41.97%,1
高雄市,橋頭區,0415,330,117,447,40,487,720,67.64%,45.83%,1
高雄市,橋頭區,0416,474,215,689,57,746,1192,62.58%,39.77%,1
高雄市,橋頭區,0417,561,253,814,39,853,1318,64.72%,42.56%,1
高雄市,橋頭區,0418,330,136,466,32,498,761,65.44%,43.36%,1
高雄市,橋頭區,0419,410,177,587,19,606,973,62.28%,42.14%,1
高雄市,橋頭區,0420,211,128,339,27,366,587,62.35%,35.95%,1
高雄市,橋頭區,0421,341,159,500,33,533,812,65.64%,42%,1
高雄市,橋頭區,0422,136,81,217,6,223,343,65.01%,39.65%,1
高雄市,橋頭區,0423,518,285,803,18,821,1266,64.85%,40.92%,1
高雄市,橋頭區,0424,500,184,684,64,748,1128,66.31%,44.33%,1
高雄市,橋頭區,0425,394,150,544,26,570,884,64.48%,44.57%,1
高雄市,橋頭區,0426,459,198,657,38,695,1187,58.55%,38.67%,1
高雄市,橋頭區,0427,566,185,751,32,783,1259,62.19%,44.96%,1
高雄市,橋頭區,0428,615,105,720,39,759,1361,55.77%,45.19%,1
高雄市,橋頭區,0429,279,96,375,17,392,671,58.42%,41.58%,1
高雄市,橋頭區,0430,512,229,741,42,783,1215,64.44%,42.14%,1
高雄市,橋頭區,0431,551,222,773,42,815,1255,64.94%,43.9%,1
高雄市,橋頭區,0432,515,248,763,26,789,1219,64.73%,42.25%,1
高雄市,橋頭區,0433,552,252,804,26,830,1372,60.5%,40.23%,1
高雄市,橋頭區,0434,342,135,477,10,487,758,64.25%,45.12%,1
高雄市,燕巢區,0333,429,166,595,63,658,1152,57.12%,37.24%,1
高雄市,燕巢區,0334,461,191,652,20,672,1120,60%,41.16%,1
高雄市,燕巢區,0335,433,181,614,38,652,974,66.94%,44.46%,1
高雄市,燕巢區,0336,405,167,572,16,588,1019,57.7%,39.74%,1
高雄市,燕巢區,0337,403,169,572,39,611,1058,57.75%,38.09%,1
高雄市,燕巢區,0338,346,146,492,30,522,1017,51.33%,34.02%,1
高雄市,燕巢區,0339,34,8,42,4,46,259,17.76%,13.13%,1
高雄市,燕巢區,0340,427,151,578,40,618,926,66.74%,46.11%,1
高雄市,燕巢區,0341,235,96,331,13,344,624,55.13%,37.66%,1
高雄市,燕巢區,0342,512,184,696,30,726,1102,65.88%,46.46%,1
高雄市,燕巢區,0343,392,158,550,31,581,1072,54.2%,36.57%,1
高雄市,燕巢區,0344,476,262,738,58,796,1361,58.49%,34.97%,1
高雄市,燕巢區,0345,190,72,262,27,289,472,61.23%,40.25%,1
高雄市,燕巢區,0346,417,197,614,31,645,1197,53.88%,34.84%,1
高雄市,燕巢區,0347,468,217,685,54,739,1134,65.17%,41.27%,1
高雄市,燕巢區,0348,438,190,628,34,662,1148,57.67%,38.15%,1
高雄市,燕巢區,0349,427,172,599,57,656,1207,54.35%,35.38%,1
高雄市,燕巢區,0350,590,274,864,37,901,1402,64.27%,42.08%,1
高雄市,燕巢區,0351,377,196,573,37,610,1000,61%,37.7%,1
高雄市,燕巢區,0352,422,218,640,47,687,1110,61.89%,38.02%,1
高雄市,燕巢區,0353,484,226,710,37,747,1291,57.86%,37.49%,1
高雄市,燕巢區,0354,313,128,441,48,489,797,61.36%,39.27%,1
高雄市,燕巢區,0355,389,149,538,38,576,1098,52.46%,35.43%,1
高雄市,燕巢區,0356,482,218,700,51,751,1393,53.91%,34.6%,1
高雄市,燕巢區,0357,368,116,484,27,511,1079,47.36%,34.11%,1
高雄市,田寮區,0237,109,50,159,6,165,369,44.72%,29.54%,1
高雄市,田寮區,0238,180,88,268,17,285,656,43.45%,27.44%,1
高雄市,田寮區,0239,78,43,121,9,130,406,32.02%,19.21%,1
高雄市,田寮區,0240,125,53,178,19,197,380,51.84%,32.89%,1
高雄市,田寮區,0241,147,56,203,15,218,379,57.52%,38.79%,1
高雄市,田寮區,0242,239,75,314,46,360,625,57.6%,38.24%,1
高雄市,田寮區,0243,308,156,464,18,482,946,50.95%,32.56%,1
高雄市,田寮區,0244,253,97,350,34,384,794,48.36%,31.86%,1
高雄市,田寮區,0245,113,33,146,23,169,382,44.24%,29.58%,1
高雄市,田寮區,0246,107,59,166,39,205,513,39.96%,20.86%,1
高雄市,田寮區,0247,224,86,310,17,327,601,54.41%,37.27%,1
高雄市,田寮區,0248,237,99,336,38,374,620,60.32%,38.23%,1
高雄市,阿蓮區,0216,403,210,613,32,645,1299,49.65%,31.02%,1
高雄市,阿蓮區,0217,450,159,609,26,635,1107,57.36%,40.65%,1
高雄市,阿蓮區,0218,350,126,476,8,484,898,53.9%,38.98%,1
高雄市,阿蓮區,0219,444,194,638,56,694,1259,55.12%,35.27%,1
高雄市,阿蓮區,0220,546,271,817,33,850,1579,53.83%,34.58%,1
高雄市,阿蓮區,0221,219,100,319,10,329,564,58.33%,38.83%,1
高雄市,阿蓮區,0222,301,151,452,44,496,768,64.58%,39.19%,1
高雄市,阿蓮區,0223,416,187,603,34,637,1092,58.33%,38.1%,1
高雄市,阿蓮區,0224,412,174,586,44,630,1099,57.32%,37.49%,1
高雄市,阿蓮區,0225,430,193,623,18,641,1134,56.53%,37.92%,1
高雄市,阿蓮區,0226,517,279,796,22,818,1561,52.4%,33.12%,1
高雄市,阿蓮區,0227,642,202,844,61,905,1533,59.03%,41.88%,1
高雄市,阿蓮區,0228,361,187,548,29,577,1116,51.7%,32.35%,1
高雄市,阿蓮區,0229,403,177,580,19,599,1054,56.83%,38.24%,1
高雄市,阿蓮區,0230,461,201,662,31,693,1260,55%,36.59%,1
高雄市,阿蓮區,0231,505,241,746,53,799,1504,53.13%,33.58%,1
高雄市,阿蓮區,0232,276,139,415,15,430,848,50.71%,32.55%,1
高雄市,阿蓮區,0233,322,115,437,20,457,823,55.53%,39.13%,1
高雄市,阿蓮區,0234,428,145,573,29,602,1021,58.96%,41.92%,1
高雄市,阿蓮區,0235,554,282,836,43,879,1715,51.25%,32.3%,1
高雄市,阿蓮區,0236,473,193,666,40,706,1300,54.31%,36.38%,1
高雄市,路竹區,0175,376,162,538,26,564,1026,54.97%,36.65%,1
高雄市,路竹區,0176,391,192,583,51,634,1069,59.31%,36.58%,1
高雄市,路竹區,0177,431,203,634,57,691,1127,61.31%,38.24%,1
高雄市,路竹區,0178,476,171,647,35,682,1179,57.85%,40.37%,1
高雄市,路竹區,0179,448,201,649,53,702,1237,56.75%,36.22%,1
高雄市,路竹區,0180,410,208,618,40,658,1096,60.04%,37.41%,1
高雄市,路竹區,0181,555,208,763,49,812,1272,63.84%,43.63%,1
高雄市,路竹區,0182,469,200,669,35,704,1182,59.56%,39.68%,1
高雄市,路竹區,0183,434,186,620,36,656,1127,58.21%,38.51%,1
高雄市,路竹區,0184,372,169,541,35,576,956,60.25%,38.91%,1
高雄市,路竹區,0185,406,218,624,44,668,1132,59.01%,35.87%,1
高雄市,路竹區,0186,405,190,595,63,658,1025,64.2%,39.51%,1
高雄市,路竹區,0187,367,182,549,23,572,1007,56.8%,36.44%,1
高雄市,路竹區,0188,461,205,666,34,700,1301,53.8%,35.43%,1
高雄市,路竹區,0189,364,137,501,29,530,885,59.89%,41.13%,1
高雄市,路竹區,0190,271,140,411,16,427,837,51.02%,32.38%,1
高雄市,路竹區,0191,354,184,538,29,567,930,60.97%,38.06%,1
高雄市,路竹區,0192,266,123,389,32,421,781,53.91%,34.06%,1
高雄市,路竹區,0193,389,182,571,43,614,1023,60.02%,38.03%,1
高雄市,路竹區,0194,784,233,1017,48,1065,1763,60.41%,44.47%,1
高雄市,路竹區,0195,616,286,902,42,944,1637,57.67%,37.63%,1
高雄市,路竹區,0196,421,178,599,36,635,1070,59.35%,39.35%,1
高雄市,路竹區,0197,477,208,685,42,727,1177,61.77%,40.53%,1
高雄市,路竹區,0198,371,192,563,37,600,1007,59.58%,36.84%,1
高雄市,路竹區,0199,376,194,570,31,601,1026,58.58%,36.65%,1
高雄市,路竹區,0200,380,182,562,39,601,1017,59.1%,37.36%,1
高雄市,路竹區,0201,446,256,702,36,738,1264,58.39%,35.28%,1
高雄市,路竹區,0202,442,193,635,39,674,1089,61.89%,40.59%,1
高雄市,路竹區,0203,326,147,473,28,501,851,58.87%,38.31%,1
高雄市,路竹區,0204,412,188,600,40,640,1011,63.3%,40.75%,1
高雄市,路竹區,0205,404,186,590,26,616,937,65.74%,43.12%,1
高雄市,路竹區,0206,293,114,407,20,427,820,52.07%,35.73%,1
高雄市,路竹區,0207,363,210,573,23,596,910,65.49%,39.89%,1
高雄市,路竹區,0208,301,150,451,43,494,867,56.98%,34.72%,1
高雄市,路竹區,0209,380,161,541,26,567,937,60.51%,40.55%,1
高雄市,路竹區,0210,336,174,510,22,532,900,59.11%,37.33%,1
高雄市,路竹區,0211,377,149,526,34,560,900,62.22%,41.89%,1
高雄市,路竹區,0212,388,154,542,27,569,918,61.98%,42.27%,1
高雄市,路竹區,0213,363,170,533,34,567,870,65.17%,41.72%,1
高雄市,路竹區,0214,471,237,708,20,728,1150,63.3%,40.96%,1
高雄市,路竹區,0215,691,255,946,42,988,1537,64.28%,44.96%,1
高雄市,湖內區,0151,435,145,580,39,619,1112,55.67%,39.12%,1
高雄市,湖內區,0152,385,163,548,45,593,1017,58.31%,37.86%,1
高雄市,湖內區,0153,270,152,422,14,436,796,54.77%,33.92%,1
高雄市,湖內區,0154,452,204,656,22,678,1079,62.84%,41.89%,1
高雄市,湖內區,0155,433,210,643,23,666,1115,59.73%,38.83%,1
高雄市,湖內區,0156,469,205,674,37,711,1311,54.23%,35.77%,1
高雄市,湖內區,0157,493,191,684,24,708,1319,53.68%,37.38%,1
高雄市,湖內區,0158,513,230,743,47,790,1244,63.5%,41.24%,1
高雄市,湖內區,0159,520,224,744,34,778,1227,63.41%,42.38%,1
高雄市,湖內區,0160,468,193,661,45,706,1163,60.71%,40.24%,1
高雄市,湖內區,0161,399,169,568,29,597,981,60.86%,40.67%,1
高雄市,湖內區,0162,289,131,420,15,435,780,55.77%,37.05%,1
高雄市,湖內區,0163,333,119,452,35,487,832,58.53%,40.02%,1
高雄市,湖內區,0164,421,195,616,26,642,1017,63.13%,41.4%,1
高雄市,湖內區,0165,410,196,606,17,623,1051,59.28%,39.01%,1
高雄市,湖內區,0166,370,146,516,23,539,941,57.28%,39.32%,1
高雄市,湖內區,0167,329,125,454,36,490,863,56.78%,38.12%,1
高雄市,湖內區,0168,381,215,596,35,631,1160,54.4%,32.84%,1
高雄市,湖內區,0169,321,148,469,26,495,1090,45.41%,29.45%,1
高雄市,湖內區,0170,397,207,604,50,654,1122,58.29%,35.38%,1
高雄市,湖內區,0171,374,170,544,19,563,1123,50.13%,33.3%,1
高雄市,湖內區,0172,262,96,358,32,390,684,57.02%,38.3%,1
高雄市,湖內區,0173,429,187,616,20,636,1249,50.92%,34.35%,1
高雄市,湖內區,0174,483,209,692,30,722,1453,49.69%,33.24%,1
高雄市,茄萣區,0130,341,143,484,17,501,976,51.33%,34.94%,1
高雄市,茄萣區,0131,304,131,435,53,488,887,55.02%,34.27%,1
高雄市,茄萣區,0132,640,233,873,38,911,1710,53.27%,37.43%,1
高雄市,茄萣區,0133,398,182,580,35,615,1280,48.05%,31.09%,1
高雄市,茄萣區,0134,543,230,773,25,798,1314,60.73%,41.32%,1
高雄市,茄萣區,0135,493,207,700,31,731,1157,63.18%,42.61%,1
高雄市,茄萣區,0136,650,274,924,68,992,1785,55.57%,36.41%,1
高雄市,茄萣區,0137,318,134,452,38,490,838,58.47%,37.95%,1
高雄市,茄萣區,0138,554,220,774,50,824,1249,65.97%,44.36%,1
高雄市,茄萣區,0139,405,170,575,44,619,1116,55.47%,36.29%,1
高雄市,茄萣區,0140,324,167,491,35,526,978,53.78%,33.13%,1
高雄市,茄萣區,0141,393,131,524,27,551,1125,48.98%,34.93%,1
高雄市,茄萣區,0142,389,187,576,49,625,1139,54.87%,34.15%,1
高雄市,茄萣區,0143,486,215,701,75,776,1363,56.93%,35.66%,1
高雄市,茄萣區,0144,641,258,899,64,963,1598,60.26%,40.11%,1
高雄市,茄萣區,0145,391,166,557,40,597,1111,53.74%,35.19%,1
高雄市,茄萣區,0146,305,117,422,23,445,925,48.11%,32.97%,1
高雄市,茄萣區,0147,409,174,583,43,626,1148,54.53%,35.63%,1
高雄市,茄萣區,0148,516,158,674,29,703,1353,51.96%,38.14%,1
高雄市,茄萣區,0149,495,199,694,41,735,1331,55.22%,37.19%,1
高雄市,茄萣區,0150,598,262,860,45,905,1829,49.48%,32.7%,1
高雄市,永安區,0249,355,124,479,26,505,756,66.8%,46.96%,1
高雄市,永安區,0250,333,152,485,40,525,818,64.18%,40.71%,1
高雄市,永安區,0251,415,160,575,26,601,866,69.4%,47.92%,1
高雄市,永安區,0252,400,164,564,50,614,951,64.56%,42.06%,1
高雄市,永安區,0253,416,173,589,49,638,992,64.31%,41.94%,1
高雄市,永安區,0254,207,116,323,17,340,682,49.85%,30.35%,1
高雄市,永安區,0255,276,115,391,16,407,665,61.2%,41.5%,1
高雄市,永安區,0256,106,96,202,10,212,371,57.14%,28.57%,1
高雄市,永安區,0257,476,222,698,40,738,1114,66.25%,42.73%,1
高雄市,永安區,0258,622,236,858,30,888,1418,62.62%,43.86%,1
高雄市,永安區,0259,654,256,910,62,972,1477,65.81%,44.28%,1
高雄市,永安區,0260,764,370,1134,59,1193,1891,63.09%,40.4%,1
高雄市,彌陀區,0358,495,224,719,37,756,1246,60.67%,39.73%,1
高雄市,彌陀區,0359,374,158,532,24,556,885,62.82%,42.26%,1
高雄市,彌陀區,0360,435,178,613,44,657,955,68.8%,45.55%,1
高雄市,彌陀區,0361,182,112,294,27,321,534,60.11%,34.08%,1
高雄市,彌陀區,0362,314,109,423,31,454,738,61.52%,42.55%,1
高雄市,彌陀區,0363,415,143,558,28,586,855,68.54%,48.54%,1
高雄市,彌陀區,0364,388,154,542,27,569,877,64.88%,44.24%,1
高雄市,彌陀區,0365,345,119,464,49,513,781,65.69%,44.17%,1
高雄市,彌陀區,0366,325,141,466,31,497,808,61.51%,40.22%,1
高雄市,彌陀區,0367,320,131,451,19,470,904,51.99%,35.4%,1
高雄市,彌陀區,0368,314,146,460,44,504,825,61.09%,38.06%,1
高雄市,彌陀區,0369,354,140,494,40,534,941,56.75%,37.62%,1
高雄市,彌陀區,0370,386,184,570,32,602,1013,59.43%,38.1%,1
高雄市,彌陀區,0371,444,181,625,47,672,1024,65.63%,43.36%,1
高雄市,彌陀區,0372,250,111,361,13,374,861,43.44%,29.04%,1
高雄市,彌陀區,0373,479,203,682,53,735,1163,63.2%,41.19%,1
高雄市,彌陀區,0374,598,175,773,36,809,1216,66.53%,49.18%,1
高雄市,彌陀區,0375,439,140,579,49,628,861,72.94%,50.99%,1
高雄市,梓官區,0376,505,141,646,39,685,1061,64.56%,47.6%,1
高雄市,梓官區,0377,429,178,607,33,640,1063,60.21%,40.36%,1
高雄市,梓官區,0378,393,179,572,33,605,969,62.44%,40.56%,1
高雄市,梓官區,0379,368,159,527,26,553,1078,51.3%,34.14%,1
高雄市,梓官區,0380,331,157,488,39,527,838,62.89%,39.5%,1
高雄市,梓官區,0381,282,111,393,18,411,611,67.27%,46.15%,1
高雄市,梓官區,0382,344,141,485,18,503,782,64.32%,43.99%,1
高雄市,梓官區,0383,630,263,893,52,945,1451,65.13%,43.42%,1
高雄市,梓官區,0384,458,200,658,19,677,1144,59.18%,40.03%,1
高雄市,梓官區,0385,391,137,528,15,543,975,55.69%,40.1%,1
高雄市,梓官區,0386,553,218,771,31,802,1317,60.9%,41.99%,1
高雄市,梓官區,0387,504,214,718,51,769,1218,63.14%,41.38%,1
高雄市,梓官區,0388,440,184,624,35,659,1073,61.42%,41.01%,1
高雄市,梓官區,0389,435,157,592,25,617,1112,55.49%,39.12%,1
高雄市,梓官區,0390,280,112,392,21,413,715,57.76%,39.16%,1
高雄市,梓官區,0391,539,191,730,26,756,1311,57.67%,41.11%,1
高雄市,梓官區,0392,390,159,549,23,572,939,60.92%,41.53%,1
高雄市,梓官區,0393,359,127,486,35,521,824,63.23%,43.57%,1
高雄市,梓官區,0394,506,155,661,50,711,1052,67.59%,48.1%,1
高雄市,梓官區,0395,448,157,605,51,656,1020,64.31%,43.92%,1
高雄市,梓官區,0396,511,202,713,25,738,1260,58.57%,40.56%,1
高雄市,梓官區,0397,646,228,874,17,891,1595,55.86%,40.5%,1
高雄市,梓官區,0398,356,123,479,26,505,829,60.92%,42.94%,1
高雄市,梓官區,0399,641,224,865,24,889,1532,58.03%,41.84%,1
高雄市,梓官區,0400,549,205,754,35,789,1195,66.03%,45.94%,1
高雄市,梓官區,0401,488,168,656,52,708,1143,61.94%,42.69%,1
高雄市,梓官區,0402,508,192,700,42,742,1186,62.56%,42.83%,1
高雄市,梓官區,0403,624,230,854,21,875,1732,50.52%,36.03%,1
高雄市,旗山區,0060,410,190,600,39,639,1060,60.28%,38.68%,1
高雄市,旗山區,0061,419,149,568,29,597,1125,53.07%,37.24%,1
高雄市,旗山區,0062,456,202,658,22,680,1100,61.82%,41.45%,1
高雄市,旗山區,0063,533,213,746,21,767,1238,61.95%,43.05%,1
高雄市,旗山區,0064,374,142,516,23,539,933,57.77%,40.09%,1
高雄市,旗山區,0065,255,123,378,15,393,727,54.06%,35.08%,1
高雄市,旗山區,0066,412,162,574,36,610,1071,56.96%,38.47%,1
高雄市,旗山區,0067,259,118,377,26,403,744,54.17%,34.81%,1
高雄市,旗山區,0068,377,173,550,26,576,1100,52.36%,34.27%,1
高雄市,旗山區,0069,144,44,188,11,199,369,53.93%,39.02%,1
高雄市,旗山區,0070,310,109,419,6,425,888,47.86%,34.91%,1
高雄市,旗山區,0071,164,64,228,18,246,510,48.24%,32.16%,1
高雄市,旗山區,0072,422,148,570,79,649,1042,62.28%,40.5%,1
高雄市,旗山區,0073,295,104,399,40,439,791,55.5%,37.29%,1
高雄市,旗山區,0074,342,178,520,50,570,939,60.7%,36.42%,1
高雄市,旗山區,0075,422,176,598,37,635,1218,52.13%,34.65%,1
高雄市,旗山區,0076,58,26,84,15,99,178,55.62%,32.58%,1
高雄市,旗山區,0077,391,151,542,48,590,946,62.37%,41.33%,1
高雄市,旗山區,0078,372,184,556,28,584,1025,56.98%,36.29%,1
高雄市,旗山區,0079,428,168,596,104,700,1040,67.31%,41.15%,1
高雄市,旗山區,0080,377,166,543,44,587,900,65.22%,41.89%,1
高雄市,旗山區,0081,233,103,336,22,358,663,54%,35.14%,1
高雄市,旗山區,0082,340,173,513,30,543,954,56.92%,35.64%,1
高雄市,旗山區,0083,415,163,578,25,603,1060,56.89%,39.15%,1
高雄市,旗山區,0084,430,205,635,42,677,1110,60.99%,38.74%,1
高雄市,旗山區,0085,366,219,585,46,631,1062,59.42%,34.46%,1
高雄市,旗山區,0086,451,186,637,29,666,1151,57.86%,39.18%,1
高雄市,旗山區,0087,109,42,151,15,166,266,62.41%,40.98%,1
高雄市,旗山區,0088,249,112,361,29,390,633,61.61%,39.34%,1
高雄市,旗山區,0089,446,190,636,29,665,1307,50.88%,34.12%,1
高雄市,旗山區,0090,251,138,389,46,435,754,57.69%,33.29%,1
高雄市,旗山區,0091,435,222,657,92,749,1296,57.79%,33.56%,1
高雄市,旗山區,0092,250,121,371,17,388,839,46.25%,29.8%,1
高雄市,旗山區,0093,501,225,726,44,770,1329,57.94%,37.7%,1
高雄市,旗山區,0094,254,103,357,16,373,628,59.39%,40.45%,1
高雄市,美濃區,0095,443,177,620,75,695,1175,59.15%,37.7%,1
高雄市,美濃區,0096,509,201,710,24,734,1438,51.04%,35.4%,1
高雄市,美濃區,0097,359,118,477,36,513,989,51.87%,36.3%,1
高雄市,美濃區,0098,564,107,671,51,722,1427,50.6%,39.52%,1
高雄市,美濃區,0099,474,205,679,60,739,1309,56.46%,36.21%,1
高雄市,美濃區,0100,507,203,710,55,765,1263,60.57%,40.14%,1
高雄市,美濃區,0101,426,141,567,41,608,997,60.98%,42.73%,1
高雄市,美濃區,0102,448,155,603,46,649,1064,61%,42.11%,1
高雄市,美濃區,0103,544,220,764,75,839,1498,56.01%,36.32%,1
高雄市,美濃區,0104,428,167,595,63,658,1119,58.8%,38.25%,1
高雄市,美濃區,0105,424,127,551,56,607,1031,58.87%,41.13%,1
高雄市,美濃區,0106,497,201,698,69,767,1437,53.38%,34.59%,1
高雄市,美濃區,0107,408,152,560,47,607,1071,56.68%,38.1%,1
高雄市,美濃區,0108,285,89,374,20,394,687,57.35%,41.48%,1
高雄市,美濃區,0109,247,95,342,23,365,775,47.1%,31.87%,1
高雄市,美濃區,0110,494,159,653,45,698,1353,51.59%,36.51%,1
高雄市,美濃區,0111,421,159,580,28,608,1191,51.05%,35.35%,1
高雄市,美濃區,0112,313,119,432,29,461,906,50.88%,34.55%,1
高雄市,美濃區,0113,493,169,662,33,695,1178,59%,41.85%,1
高雄市,美濃區,0114,446,160,606,33,639,1252,51.04%,35.62%,1
高雄市,美濃區,0115,641,202,843,44,887,1549,57.26%,41.38%,1
高雄市,美濃區,0116,415,135,550,26,576,1088,52.94%,38.14%,1
高雄市,美濃區,0117,443,150,593,44,637,1116,57.08%,39.7%,1
高雄市,美濃區,0118,365,144,509,19,528,977,54.04%,37.36%,1
高雄市,美濃區,0119,314,138,452,60,512,816,62.75%,38.48%,1
高雄市,美濃區,0120,313,101,414,32,446,955,46.7%,32.77%,1
高雄市,美濃區,0121,351,134,485,68,553,943,58.64%,37.22%,1
高雄市,美濃區,0122,520,171,691,49,740,1371,53.98%,37.93%,1
高雄市,美濃區,0123,309,33,342,163,505,919,54.95%,33.62%,1
高雄市,美濃區,0124,362,160,522,45,567,915,61.97%,39.56%,1
高雄市,美濃區,0125,280,108,388,69,457,828,55.19%,33.82%,1
高雄市,美濃區,0126,179,96,275,45,320,674,47.48%,26.56%,1
高雄市,六龜區,0020,266,110,376,31,407,760,53.55%,35%,1
高雄市,六龜區,0021,188,85,273,36,309,666,46.4%,28.23%,1
高雄市,六龜區,0022,273,98,371,42,413,704,58.66%,38.78%,1
高雄市,六龜區,0023,325,138,463,51,514,1003,51.25%,32.4%,1
高雄市,六龜區,0024,416,161,577,87,664,1382,48.05%,30.1%,1
高雄市,六龜區,0025,259,110,369,48,417,986,42.29%,26.27%,1
高雄市,六龜區,0026,323,169,492,48,540,1046,51.63%,30.88%,1
高雄市,六龜區,0027,250,104,354,29,383,812,47.17%,30.79%,1
高雄市,六龜區,0028,424,177,601,63,664,1431,46.4%,29.63%,1
高雄市,六龜區,0029,334,93,427,61,488,912,53.51%,36.62%,1
高雄市,六龜區,0030,383,183,566,43,609,1472,41.37%,26.02%,1
高雄市,六龜區,0031,94,36,130,15,145,327,44.34%,28.75%,1
高雄市,甲仙區,0013,132,51,183,9,192,472,40.68%,27.97%,1
高雄市,甲仙區,0014,381,132,513,49,562,882,63.72%,43.2%,1
高雄市,甲仙區,0015,246,84,330,31,361,668,54.04%,36.83%,1
高雄市,甲仙區,0016,472,230,702,93,795,1581,50.28%,29.85%,1
高雄市,甲仙區,0017,162,86,248,14,262,673,38.93%,24.07%,1
高雄市,甲仙區,0018,181,71,252,44,296,607,48.76%,29.82%,1
高雄市,甲仙區,0019,166,82,248,28,276,534,51.69%,31.09%,1
高雄市,杉林區,0032,185,85,270,48,318,640,49.69%,28.91%,1
高雄市,杉林區,0033,229,84,313,27,340,696,48.85%,32.9%,1
高雄市,杉林區,0034,333,129,462,30,492,1284,38.32%,25.93%,1
高雄市,杉林區,0035,312,123,435,26,461,1027,44.89%,30.38%,1
高雄市,杉林區,0036,171,52,223,22,245,482,50.83%,35.48%,1
高雄市,杉林區,0037,570,256,826,85,911,1627,55.99%,35.03%,1
高雄市,杉林區,0038,533,194,727,33,760,1630,46.63%,32.7%,1
高雄市,杉林區,0039,254,125,379,20,399,973,41.01%,26.1%,1
高雄市,杉林區,0040,309,116,425,14,439,987,44.48%,31.31%,1
高雄市,杉林區,0041,440,159,599,67,666,1261,52.82%,34.89%,1
高雄市,內門區,0042,328,112,440,45,485,969,50.05%,33.85%,1
高雄市,內門區,0043,208,85,293,16,309,652,47.39%,31.9%,1
高雄市,內門區,0044,329,136,465,51,516,961,53.69%,34.24%,1
高雄市,內門區,0045,166,42,208,8,216,426,50.7%,38.97%,1
高雄市,內門區,0046,138,39,177,11,188,398,47.24%,34.67%,1
高雄市,內門區,0047,153,75,228,12,240,508,47.24%,30.12%,1
高雄市,內門區,0048,398,147,545,35,580,980,59.18%,40.61%,1
高雄市,內門區,0049,362,144,506,34,540,1225,44.08%,29.55%,1
高雄市,內門區,0050,581,285,866,107,973,1722,56.5%,33.74%,1
高雄市,內門區,0051,170,81,251,24,275,560,49.11%,30.36%,1
高雄市,內門區,0052,255,96,351,13,364,801,45.44%,31.84%,1
高雄市,內門區,0053,145,65,210,12,222,423,52.48%,34.28%,1
高雄市,內門區,0054,156,63,219,20,239,497,48.09%,31.39%,1
高雄市,內門區,0055,244,88,332,12,344,677,50.81%,36.04%,1
高雄市,內門區,0056,191,58,249,6,255,593,43%,32.21%,1
高雄市,內門區,0057,210,56,266,23,289,597,48.41%,35.18%,1
高雄市,內門區,0058,114,37,151,3,154,343,44.9%,33.24%,1
高雄市,內門區,0059,232,108,340,29,369,670,55.07%,34.63%,1
高雄市,茂林區,0127,235,97,332,24,356,507,70.22%,46.35%,1
高雄市,茂林區,0128,208,66,274,13,287,382,75.13%,54.45%,1
高雄市,茂林區,0129,369,100,469,16,485,726,66.8%,50.83%,1
高雄市,桃源區,0001,80,44,124,0,124,264,46.97%,30.3%,1
高雄市,桃源區,0002,120,46,166,6,172,233,73.82%,51.5%,1
高雄市,桃源區,0003,144,36,180,6,186,279,66.67%,51.61%,1
高雄市,桃源區,0004,128,34,162,2,164,223,73.54%,57.4%,1
高雄市,桃源區,0005,368,110,478,12,490,783,62.58%,47%,1
高雄市,桃源區,0006,299,96,395,5,400,632,63.29%,47.31%,1
高雄市,桃源區,0007,301,113,414,6,420,612,68.63%,49.18%,1
高雄市,桃源區,0008,175,68,243,24,267,472,56.57%,37.08%,1
高雄市,那瑪夏區,0009,346,129,475,31,506,741,68.29%,46.69%,1
高雄市,那瑪夏區,0010,291,104,395,32,427,585,72.99%,49.74%,1
高雄市,那瑪夏區,0011,371,82,453,21,474,609,77.83%,60.92%,1
高雄市,那瑪夏區,0012,303,43,346,9,355,489,72.6%,61.96%,1
新竹縣,竹北市,0001,565,266,831,23,854,1319,64.75%,42.84%,1
新竹縣,竹北市,0002,522,265,787,18,805,1321,60.94%,39.52%,1
新竹縣,竹北市,0003,527,257,784,21,805,1272,63.29%,41.43%,1
新竹縣,竹北市,0004,536,289,825,25,850,1467,57.94%,36.54%,1
新竹縣,竹北市,0005,438,264,702,11,713,1226,58.16%,35.73%,1
新竹縣,竹北市,0006,527,275,802,11,813,1412,57.58%,37.32%,1
新竹縣,竹北市,0007,538,331,869,14,883,1400,63.07%,38.43%,1
新竹縣,竹北市,0008,530,319,849,29,878,1415,62.05%,37.46%,1
新竹縣,竹北市,0009,478,309,787,16,803,1361,59%,35.12%,1
新竹縣,竹北市,0010,483,346,829,8,837,1515,55.25%,31.88%,1
新竹縣,竹北市,0011,521,359,880,18,898,1495,60.07%,34.85%,1
新竹縣,竹北市,0012,502,329,831,9,840,1417,59.28%,35.43%,1
新竹縣,竹北市,0013,484,381,865,21,886,1548,57.24%,31.27%,1
新竹縣,竹北市,0014,438,346,784,12,796,1434,55.51%,30.54%,1
新竹縣,竹北市,0015,506,287,793,24,817,1385,58.99%,36.53%,1
新竹縣,竹北市,0016,494,282,776,18,794,1247,63.67%,39.62%,1
新竹縣,竹北市,0017,484,294,778,20,798,1373,58.12%,35.25%,1
新竹縣,竹北市,0018,512,336,848,12,860,1345,63.94%,38.07%,1
新竹縣,竹北市,0019,452,186,638,36,674,1165,57.85%,38.8%,1
新竹縣,竹北市,0020,440,292,732,25,757,1164,65.03%,37.8%,1
新竹縣,竹北市,0021,474,265,739,18,757,1212,62.46%,39.11%,1
新竹縣,竹北市,0022,516,222,738,24,762,1507,50.56%,34.24%,1
新竹縣,竹北市,0023,582,223,805,33,838,1576,53.17%,36.93%,1
新竹縣,竹北市,0024,516,293,809,21,830,1464,56.69%,35.25%,1
新竹縣,竹北市,0025,485,312,797,20,817,1428,57.21%,33.96%,1
新竹縣,竹北市,0026,370,349,719,12,731,1442,50.69%,25.66%,1
新竹縣,竹北市,0027,533,276,809,38,847,1415,59.86%,37.67%,1
新竹縣,竹北市,0028,522,322,844,13,857,1666,51.44%,31.33%,1
新竹縣,竹北市,0029,552,368,920,21,941,1751,53.74%,31.52%,1
新竹縣,竹北市,0030,456,271,727,16,743,1196,62.12%,38.13%,1
新竹縣,竹北市,0031,490,234,724,19,743,1235,60.16%,39.68%,1
新竹縣,竹北市,0032,448,228,676,10,686,1204,56.98%,37.21%,1
新竹縣,竹北市,0033,524,258,782,21,803,1308,61.39%,40.06%,1
新竹縣,竹北市,0034,446,256,702,16,718,1233,58.23%,36.17%,1
新竹縣,竹北市,0035,454,209,663,15,678,1129,60.05%,40.21%,1
新竹縣,竹北市,0036,440,207,647,15,662,1069,61.93%,41.16%,1
新竹縣,竹北市,0037,480,214,694,20,714,1114,64.09%,43.09%,1
新竹縣,竹北市,0038,438,235,673,18,691,1103,62.65%,39.71%,1
新竹縣,竹北市,0039,396,245,641,28,669,1029,65.01%,38.48%,1
新竹縣,竹北市,0040,473,238,711,19,730,1133,64.43%,41.75%,1
新竹縣,竹北市,0041,480,264,744,13,757,1301,58.19%,36.89%,1
新竹縣,竹北市,0042,629,388,1017,23,1040,1798,57.84%,34.98%,1
新竹縣,竹北市,0043,547,287,834,18,852,1427,59.71%,38.33%,1
新竹縣,竹北市,0044,629,268,897,19,916,1462,62.65%,43.02%,1
新竹縣,竹北市,0045,553,273,826,27,853,1342,63.56%,41.21%,1
新竹縣,竹北市,0046,565,321,886,11,897,1480,60.61%,38.18%,1
新竹縣,竹北市,0047,585,328,913,18,931,1645,56.6%,35.56%,1
新竹縣,竹北市,0048,525,268,793,14,807,1256,64.25%,41.8%,1
新竹縣,竹北市,0049,457,245,702,22,724,1181,61.3%,38.7%,1
新竹縣,竹北市,0050,553,283,836,25,861,1329,64.79%,41.61%,1
新竹縣,竹北市,0051,540,237,777,17,794,1228,64.66%,43.97%,1
新竹縣,竹北市,0052,540,305,845,31,876,1552,56.44%,34.79%,1
新竹縣,竹北市,0053,582,286,868,27,895,1480,60.47%,39.32%,1
新竹縣,竹北市,0054,527,286,813,17,830,1487,55.82%,35.44%,1
新竹縣,竹北市,0055,505,275,780,29,809,1470,55.03%,34.35%,1
新竹縣,竹北市,0056,544,224,768,22,790,1477,53.49%,36.83%,1
新竹縣,竹北市,0057,635,319,954,33,987,1611,61.27%,39.42%,1
新竹縣,竹北市,0058,607,269,876,35,911,1555,58.59%,39.04%,1
新竹縣,竹北市,0059,511,258,769,33,802,1468,54.63%,34.81%,1
新竹縣,竹北市,0060,596,281,877,22,899,1509,59.58%,39.5%,1
新竹縣,竹北市,0061,588,273,861,29,890,1602,55.56%,36.7%,1
新竹縣,竹北市,0062,586,258,844,25,869,1448,60.01%,40.47%,1
新竹縣,竹北市,0063,538,244,782,17,799,1318,60.62%,40.82%,1
新竹縣,竹北市,0064,638,341,979,26,1005,1634,61.51%,39.05%,1
新竹縣,竹北市,0065,528,206,734,39,773,1345,57.47%,39.26%,1
新竹縣,竹北市,0066,431,189,620,17,637,958,66.49%,44.99%,1
新竹縣,竹北市,0067,473,205,678,27,705,1112,63.4%,42.54%,1
新竹縣,竹北市,0068,457,180,637,35,672,1134,59.26%,40.3%,1
新竹縣,竹北市,0069,577,257,834,30,864,1483,58.26%,38.91%,1
新竹縣,竹北市,0070,482,236,718,34,752,1332,56.46%,36.19%,1
新竹縣,竹北市,0071,520,219,739,25,764,1482,51.55%,35.09%,1
新竹縣,竹北市,0072,392,218,610,12,622,1449,42.93%,27.05%,1
新竹縣,竹北市,0073,506,201,707,14,721,1319,54.66%,38.36%,1
新竹縣,竹北市,0074,493,212,705,23,728,1332,54.65%,37.01%,1
新竹縣,竹北市,0075,476,259,735,20,755,1412,53.47%,33.71%,1
新竹縣,竹北市,0076,607,260,867,24,891,1640,54.33%,37.01%,1
新竹縣,竹北市,0077,491,244,735,28,763,1323,57.67%,37.11%,1
新竹縣,竹北市,0078,538,273,811,42,853,1428,59.73%,37.68%,1
新竹縣,竹北市,0079,593,277,870,29,899,1533,58.64%,38.68%,1
新竹縣,竹北市,0080,475,243,718,16,734,1346,54.53%,35.29%,1
新竹縣,竹北市,0081,467,168,635,34,669,1219,54.88%,38.31%,1
新竹縣,竹北市,0082,580,281,861,37,898,1466,61.26%,39.56%,1
新竹縣,竹北市,0083,388,219,607,26,633,1147,55.19%,33.83%,1
新竹縣,竹北市,0084,481,234,715,37,752,1529,49.18%,31.46%,1
新竹縣,竹北市,0085,587,258,845,36,881,1522,57.88%,38.57%,1
新竹縣,竹北市,0086,552,241,793,38,831,1383,60.09%,39.91%,1
新竹縣,竹北市,0087,586,295,881,35,916,1569,58.38%,37.35%,1
新竹縣,竹北市,0088,551,245,796,20,816,1506,54.18%,36.59%,1
新竹縣,竹北市,0089,355,137,492,16,508,877,57.92%,40.48%,1
新竹縣,竹北市,0090,387,211,598,30,628,1074,58.47%,36.03%,1
新竹縣,竹北市,0091,459,217,676,32,708,1089,65.01%,42.15%,1
新竹縣,竹北市,0092,513,249,762,31,793,1336,59.36%,38.4%,1
新竹縣,竹北市,0093,387,188,575,28,603,1058,56.99%,36.58%,1
新竹縣,竹北市,0094,401,195,596,34,630,937,67.24%,42.8%,1
新竹縣,竹北市,0095,461,204,665,25,690,1206,57.21%,38.23%,1
新竹縣,竹北市,0096,468,212,680,36,716,1205,59.42%,38.84%,1
新竹縣,竹北市,0097,644,328,972,59,1031,1718,60.01%,37.49%,1
新竹縣,竹北市,0098,352,148,500,27,527,917,57.47%,38.39%,1
新竹縣,竹北市,0099,257,132,389,13,402,668,60.18%,38.47%,1
新竹縣,竹北市,0100,301,149,450,26,476,824,57.77%,36.53%,1
新竹縣,竹北市,0101,312,105,417,51,468,782,59.85%,39.9%,1
新竹縣,竹北市,0102,386,153,539,48,587,977,60.08%,39.51%,1
新竹縣,竹北市,0103,344,143,487,21,508,937,54.22%,36.71%,1
新竹縣,竹東鎮,0104,104,38,142,12,154,309,49.84%,33.66%,1
新竹縣,竹東鎮,0105,139,59,198,20,218,416,52.4%,33.41%,1
新竹縣,竹東鎮,0106,132,66,198,6,204,386,52.85%,34.2%,1
新竹縣,竹東鎮,0107,331,136,467,27,494,950,52%,34.84%,1
新竹縣,竹東鎮,0108,490,179,669,11,680,1275,53.33%,38.43%,1
新竹縣,竹東鎮,0109,445,177,622,34,656,1213,54.08%,36.69%,1
新竹縣,竹東鎮,0110,593,254,847,28,875,1548,56.52%,38.31%,1
新竹縣,竹東鎮,0111,429,183,612,29,641,1246,51.44%,34.43%,1
新竹縣,竹東鎮,0112,382,179,561,20,581,1252,46.41%,30.51%,1
新竹縣,竹東鎮,0113,527,164,691,32,723,1359,53.2%,38.78%,1
新竹縣,竹東鎮,0114,439,208,647,32,679,1255,54.1%,34.98%,1
新竹縣,竹東鎮,0115,534,196,730,24,754,1304,57.82%,40.95%,1
新竹縣,竹東鎮,0116,488,212,700,28,728,1292,56.35%,37.77%,1
新竹縣,竹東鎮,0117,416,147,563,21,584,1111,52.57%,37.44%,1
新竹縣,竹東鎮,0118,345,146,491,39,530,880,60.23%,39.2%,1
新竹縣,竹東鎮,0119,273,104,377,17,394,670,58.81%,40.75%,1
新竹縣,竹東鎮,0120,487,215,702,24,726,1244,58.36%,39.15%,1
新竹縣,竹東鎮,0121,419,149,568,42,610,1126,54.17%,37.21%,1
新竹縣,竹東鎮,0122,399,158,557,34,591,1073,55.08%,37.19%,1
新竹縣,竹東鎮,0123,475,199,674,23,697,1215,57.37%,39.09%,1
新竹縣,竹東鎮,0124,456,188,644,16,660,1155,57.14%,39.48%,1
新竹縣,竹東鎮,0125,321,145,466,24,490,852,57.51%,37.68%,1
新竹縣,竹東鎮,0126,348,154,502,25,527,875,60.23%,39.77%,1
新竹縣,竹東鎮,0127,452,178,630,23,653,1070,61.03%,42.24%,1
新竹縣,竹東鎮,0128,265,101,366,23,389,704,55.26%,37.64%,1
新竹縣,竹東鎮,0129,271,94,365,17,382,951,40.17%,28.5%,1
新竹縣,竹東鎮,0130,379,178,557,14,571,984,58.03%,38.52%,1
新竹縣,竹東鎮,0131,349,139,488,18,506,1113,45.46%,31.36%,1
新竹縣,竹東鎮,0132,259,83,342,14,356,595,59.83%,43.53%,1
新竹縣,竹東鎮,0133,303,126,429,41,470,762,61.68%,39.76%,1
新竹縣,竹東鎮,0134,278,135,413,12,425,763,55.7%,36.44%,1
新竹縣,竹東鎮,0135,334,86,420,10,430,813,52.89%,41.08%,1
新竹縣,竹東鎮,0136,455,152,607,31,638,1310,48.7%,34.73%,1
新竹縣,竹東鎮,0137,496,175,671,34,705,1434,49.16%,34.59%,1
新竹縣,竹東鎮,0138,434,188,622,23,645,1131,57.03%,38.37%,1
新竹縣,竹東鎮,0139,359,154,513,19,532,967,55.02%,37.13%,1
新竹縣,竹東鎮,0140,419,164,583,30,613,1196,51.25%,35.03%,1
新竹縣,竹東鎮,0141,444,189,633,23,656,1154,56.85%,38.47%,1
新竹縣,竹東鎮,0142,282,134,416,24,440,715,61.54%,39.44%,1
新竹縣,竹東鎮,0143,274,120,394,17,411,685,60%,40%,1
新竹縣,竹東鎮,0144,486,206,692,26,718,1352,53.11%,35.95%,1
新竹縣,竹東鎮,0145,557,215,772,33,805,1407,57.21%,39.59%,1
新竹縣,竹東鎮,0146,553,181,734,19,753,1362,55.29%,40.6%,1
新竹縣,竹東鎮,0147,526,214,740,31,771,1330,57.97%,39.55%,1
新竹縣,竹東鎮,0148,521,226,747,33,780,1441,54.13%,36.16%,1
新竹縣,竹東鎮,0149,424,215,639,15,654,1248,52.4%,33.97%,1
新竹縣,竹東鎮,0150,378,186,564,9,573,1263,45.37%,29.93%,1
新竹縣,竹東鎮,0151,424,180,604,18,622,1232,50.49%,34.42%,1
新竹縣,竹東鎮,0152,367,155,522,19,541,1143,47.33%,32.11%,1
新竹縣,竹東鎮,0153,572,248,820,24,844,1529,55.2%,37.41%,1
新竹縣,竹東鎮,0154,414,183,597,32,629,1140,55.18%,36.32%,1
新竹縣,竹東鎮,0155,249,91,340,25,365,570,64.04%,43.68%,1
新竹縣,竹東鎮,0156,459,195,654,17,671,1345,49.89%,34.13%,1
新竹縣,竹東鎮,0157,455,253,708,33,741,1381,53.66%,32.95%,1
新竹縣,竹東鎮,0158,483,259,742,20,762,1379,55.26%,35.03%,1
新竹縣,竹東鎮,0159,401,176,577,25,602,1033,58.28%,38.82%,1
新竹縣,竹東鎮,0160,393,173,566,22,588,1066,55.16%,36.87%,1
新竹縣,竹東鎮,0161,383,144,527,29,556,938,59.28%,40.83%,1
新竹縣,竹東鎮,0162,402,157,559,30,589,952,61.87%,42.23%,1
新竹縣,竹東鎮,0163,564,284,848,27,875,1468,59.6%,38.42%,1
新竹縣,竹東鎮,0164,550,418,968,17,985,1915,51.44%,28.72%,1
新竹縣,竹東鎮,0165,444,177,621,26,647,1220,53.03%,36.39%,1
新竹縣,竹東鎮,0166,364,154,518,16,534,1166,45.8%,31.22%,1
新竹縣,竹東鎮,0167,500,211,711,22,733,1492,49.13%,33.51%,1
新竹縣,竹東鎮,0168,440,198,638,30,668,1245,53.65%,35.34%,1
新竹縣,竹東鎮,0169,391,203,594,30,624,1083,57.62%,36.1%,1
新竹縣,竹東鎮,0170,387,197,584,23,607,1102,55.08%,35.12%,1
新竹縣,竹東鎮,0171,408,190,598,17,615,1068,57.58%,38.2%,1
新竹縣,竹東鎮,0172,411,201,612,16,628,1097,57.25%,37.47%,1
新竹縣,竹東鎮,0173,375,136,511,17,528,962,54.89%,38.98%,1
新竹縣,竹東鎮,0174,358,158,516,18,534,909,58.75%,39.38%,1
新竹縣,竹東鎮,0175,206,76,282,21,303,603,50.25%,34.16%,1
新竹縣,新埔鎮,0176,410,151,561,28,589,983,59.92%,41.71%,1
新竹縣,新埔鎮,0177,227,115,342,27,369,597,61.81%,38.02%,1
新竹縣,新埔鎮,0178,405,171,576,28,604,1070,56.45%,37.85%,1
新竹縣,新埔鎮,0179,378,125,503,26,529,935,56.58%,40.43%,1
新竹縣,新埔鎮,0180,290,120,410,28,438,753,58.17%,38.51%,1
新竹縣,新埔鎮,0181,377,153,530,21,551,838,65.75%,44.99%,1
新竹縣,新埔鎮,0182,351,144,495,34,529,924,57.25%,37.99%,1
新竹縣,新埔鎮,0183,304,139,443,19,462,905,51.05%,33.59%,1
新竹縣,新埔鎮,0184,395,124,519,20,539,948,56.86%,41.67%,1
新竹縣,新埔鎮,0185,403,148,551,41,592,1017,58.21%,39.63%,1
新竹縣,新埔鎮,0186,470,215,685,35,720,1176,61.22%,39.97%,1
新竹縣,新埔鎮,0187,478,187,665,33,698,1122,62.21%,42.6%,1
新竹縣,新埔鎮,0188,320,163,483,9,492,1022,48.14%,31.31%,1
新竹縣,新埔鎮,0189,456,223,679,34,713,1429,49.9%,31.91%,1
新竹縣,新埔鎮,0190,201,74,275,30,305,451,67.63%,44.57%,1
新竹縣,新埔鎮,0191,262,134,396,18,414,724,57.18%,36.19%,1
新竹縣,新埔鎮,0192,263,103,366,29,395,617,64.02%,42.63%,1
新竹縣,新埔鎮,0193,418,211,629,51,680,1144,59.44%,36.54%,1
新竹縣,新埔鎮,0194,435,185,620,39,659,1139,57.86%,38.19%,1
新竹縣,新埔鎮,0195,353,121,474,12,486,861,56.45%,41%,1
新竹縣,新埔鎮,0196,370,167,537,25,562,1093,51.42%,33.85%,1
新竹縣,新埔鎮,0197,341,135,476,28,504,978,51.53%,34.87%,1
新竹縣,新埔鎮,0198,357,146,503,21,524,1040,50.38%,34.33%,1
新竹縣,新埔鎮,0199,422,173,595,26,621,1160,53.53%,36.38%,1
新竹縣,新埔鎮,0200,374,180,554,26,580,950,61.05%,39.37%,1
新竹縣,新埔鎮,0201,353,121,474,25,499,882,56.58%,40.02%,1
新竹縣,新埔鎮,0202,479,222,701,38,739,1281,57.69%,37.39%,1
新竹縣,新埔鎮,0203,396,214,610,40,650,1212,53.63%,32.67%,1
新竹縣,新埔鎮,0204,338,108,446,37,483,1013,47.68%,33.37%,1
新竹縣,新埔鎮,0205,259,109,368,35,403,630,63.97%,41.11%,1
新竹縣,關西鎮,0206,234,65,299,9,308,480,64.17%,48.75%,1
新竹縣,關西鎮,0207,365,154,519,21,540,903,59.8%,40.42%,1
新竹縣,關西鎮,0208,407,158,565,29,594,1020,58.24%,39.9%,1
新竹縣,關西鎮,0209,294,110,404,14,418,705,59.29%,41.7%,1
新竹縣,關西鎮,0210,403,154,557,26,583,1056,55.21%,38.16%,1
新竹縣,關西鎮,0211,443,223,666,37,703,1275,55.14%,34.75%,1
新竹縣,關西鎮,0212,497,223,720,40,760,1287,59.05%,38.62%,1
新竹縣,關西鎮,0213,318,116,434,32,466,771,60.44%,41.25%,1
新竹縣,關西鎮,0214,378,151,529,41,570,1046,54.49%,36.14%,1
新竹縣,關西鎮,0215,428,139,567,38,605,1030,58.74%,41.55%,1
新竹縣,關西鎮,0216,463,203,666,26,692,1208,57.28%,38.33%,1
新竹縣,關西鎮,0217,384,156,540,9,549,1095,50.14%,35.07%,1
新竹縣,關西鎮,0218,457,220,677,38,715,1350,52.96%,33.85%,1
新竹縣,關西鎮,0219,370,137,507,30,537,846,63.48%,43.74%,1
新竹縣,關西鎮,0220,505,197,702,45,747,1362,54.85%,37.08%,1
新竹縣,關西鎮,0221,348,111,459,20,479,903,53.05%,38.54%,1
新竹縣,關西鎮,0222,180,70,250,19,269,551,48.82%,32.67%,1
新竹縣,關西鎮,0223,123,57,180,11,191,461,41.43%,26.68%,1
新竹縣,關西鎮,0224,231,66,297,22,319,572,55.77%,40.38%,1
新竹縣,關西鎮,0225,356,129,485,26,511,943,54.19%,37.75%,1
新竹縣,關西鎮,0226,305,135,440,34,474,808,58.66%,37.75%,1
新竹縣,關西鎮,0227,411,150,561,23,584,923,63.27%,44.53%,1
新竹縣,關西鎮,0228,373,144,517,21,538,903,59.58%,41.31%,1
新竹縣,關西鎮,0229,391,140,531,40,571,977,58.44%,40.02%,1
新竹縣,關西鎮,0230,348,140,488,30,518,824,62.86%,42.23%,1
新竹縣,關西鎮,0231,250,98,348,14,362,559,64.76%,44.72%,1
新竹縣,關西鎮,0232,356,156,512,22,534,854,62.53%,41.69%,1
新竹縣,湖口鄉,0233,440,237,677,40,717,1393,51.47%,31.59%,1
新竹縣,湖口鄉,0234,592,247,839,34,873,1505,58.01%,39.34%,1
新竹縣,湖口鄉,0235,512,234,746,18,764,1188,64.31%,43.1%,1
新竹縣,湖口鄉,0236,526,174,700,27,727,1267,57.38%,41.52%,1
新竹縣,湖口鄉,0237,658,266,924,33,957,1668,57.37%,39.45%,1
新竹縣,湖口鄉,0238,650,302,952,46,998,1719,58.06%,37.81%,1
新竹縣,湖口鄉,0239,501,191,692,34,726,1162,62.48%,43.12%,1
新竹縣,湖口鄉,0240,611,278,889,51,940,1833,51.28%,33.33%,1
新竹縣,湖口鄉,0241,555,254,809,23,832,1444,57.62%,38.43%,1
新竹縣,湖口鄉,0242,566,222,788,47,835,1347,61.99%,42.02%,1
新竹縣,湖口鄉,0243,497,209,706,16,722,1202,60.07%,41.35%,1
新竹縣,湖口鄉,0244,356,139,495,21,516,851,60.63%,41.83%,1
新竹縣,湖口鄉,0245,505,233,738,33,771,1272,60.61%,39.7%,1
新竹縣,湖口鄉,0246,514,193,707,26,733,1275,57.49%,40.31%,1
新竹縣,湖口鄉,0247,751,94,845,34,879,1560,56.35%,48.14%,1
新竹縣,湖口鄉,0248,482,202,684,53,737,1147,64.25%,42.02%,1
新竹縣,湖口鄉,0249,689,240,929,32,961,1729,55.58%,39.85%,1
新竹縣,湖口鄉,0250,513,217,730,26,756,1402,53.92%,36.59%,1
新竹縣,湖口鄉,0251,453,228,681,24,705,1183,59.59%,38.29%,1
新竹縣,湖口鄉,0252,538,201,739,33,772,1282,60.22%,41.97%,1
新竹縣,湖口鄉,0253,520,255,775,27,802,1335,60.07%,38.95%,1
新竹縣,湖口鄉,0254,624,284,908,26,934,1493,62.56%,41.8%,1
新竹縣,湖口鄉,0255,708,344,1052,21,1073,1877,57.17%,37.72%,1
新竹縣,湖口鄉,0256,466,170,636,35,671,1082,62.01%,43.07%,1
新竹縣,湖口鄉,0257,466,187,653,34,687,1115,61.61%,41.79%,1
新竹縣,湖口鄉,0258,389,200,589,28,617,1193,51.72%,32.61%,1
新竹縣,湖口鄉,0259,710,299,1009,34,1043,1947,53.57%,36.47%,1
新竹縣,湖口鄉,0260,450,197,647,32,679,1125,60.36%,40%,1
新竹縣,湖口鄉,0261,416,160,576,38,614,1050,58.48%,39.62%,1
新竹縣,湖口鄉,0262,658,331,989,18,1007,1733,58.11%,37.97%,1
新竹縣,湖口鄉,0263,491,234,725,33,758,1284,59.03%,38.24%,1
新竹縣,湖口鄉,0264,450,161,611,21,632,1062,59.51%,42.37%,1
新竹縣,湖口鄉,0265,579,236,815,53,868,1547,56.11%,37.43%,1
新竹縣,湖口鄉,0266,536,208,744,30,774,1494,51.81%,35.88%,1
新竹縣,湖口鄉,0267,554,217,771,21,792,1634,48.47%,33.9%,1
新竹縣,湖口鄉,0268,461,212,673,16,689,1444,47.71%,31.93%,1
新竹縣,湖口鄉,0269,472,208,680,19,699,1324,52.79%,35.65%,1
新竹縣,湖口鄉,0270,409,165,574,27,601,1058,56.81%,38.66%,1
新竹縣,湖口鄉,0271,334,175,509,20,529,1220,43.36%,27.38%,1
新竹縣,湖口鄉,0272,488,235,723,26,749,1333,56.19%,36.61%,1
新竹縣,湖口鄉,0273,509,216,725,42,767,1461,52.5%,34.84%,1
新竹縣,湖口鄉,0274,550,230,780,20,800,1429,55.98%,38.49%,1
新竹縣,湖口鄉,0275,487,215,702,14,716,1506,47.54%,32.34%,1
新竹縣,湖口鄉,0276,458,174,632,38,670,1103,60.74%,41.52%,1
新竹縣,湖口鄉,0277,490,222,712,29,741,1495,49.57%,32.78%,1
新竹縣,湖口鄉,0278,293,113,406,27,433,752,57.58%,38.96%,1
新竹縣,湖口鄉,0279,346,183,529,19,548,986,55.58%,35.09%,1
新竹縣,新豐鄉,0280,383,167,550,29,579,1080,53.61%,35.46%,1
新竹縣,新豐鄉,0281,289,155,444,24,468,887,52.76%,32.58%,1
新竹縣,新豐鄉,0282,350,161,511,27,538,954,56.39%,36.69%,1
新竹縣,新豐鄉,0283,403,146,549,29,578,1003,57.63%,40.18%,1
新竹縣,新豐鄉,0284,402,184,586,18,604,1106,54.61%,36.35%,1
新竹縣,新豐鄉,0285,439,192,631,24,655,1123,58.33%,39.09%,1
新竹縣,新豐鄉,0286,318,158,476,40,516,891,57.91%,35.69%,1
新竹縣,新豐鄉,0287,278,136,414,26,440,874,50.34%,31.81%,1
新竹縣,新豐鄉,0288,294,159,453,23,476,824,57.77%,35.68%,1
新竹縣,新豐鄉,0289,338,125,463,26,489,975,50.15%,34.67%,1
新竹縣,新豐鄉,0290,325,154,479,30,509,847,60.09%,38.37%,1
新竹縣,新豐鄉,0291,550,232,782,52,834,1477,56.47%,37.24%,1
新竹縣,新豐鄉,0292,409,221,630,41,671,1266,53%,32.31%,1
新竹縣,新豐鄉,0293,380,137,517,44,561,1029,54.52%,36.93%,1
新竹縣,新豐鄉,0294,392,152,544,31,575,1063,54.09%,36.88%,1
新竹縣,新豐鄉,0295,407,159,566,17,583,1055,55.26%,38.58%,1
新竹縣,新豐鄉,0296,560,231,791,19,810,1445,56.06%,38.75%,1
新竹縣,新豐鄉,0297,581,264,845,22,867,1413,61.36%,41.12%,1
新竹縣,新豐鄉,0298,412,192,604,18,622,971,64.06%,42.43%,1
新竹縣,新豐鄉,0299,444,204,648,24,672,1135,59.21%,39.12%,1
新竹縣,新豐鄉,0300,463,194,657,26,683,1269,53.82%,36.49%,1
新竹縣,新豐鄉,0301,482,207,689,23,712,1257,56.64%,38.35%,1
新竹縣,新豐鄉,0302,653,285,938,30,968,1662,58.24%,39.29%,1
新竹縣,新豐鄉,0303,543,224,767,22,789,1486,53.1%,36.54%,1
新竹縣,新豐鄉,0304,447,187,634,37,671,1067,62.89%,41.89%,1
新竹縣,新豐鄉,0305,548,207,755,33,788,1302,60.52%,42.09%,1
新竹縣,新豐鄉,0306,548,215,763,26,789,1410,55.96%,38.87%,1
新竹縣,新豐鄉,0307,461,210,671,24,695,1267,54.85%,36.39%,1
新竹縣,新豐鄉,0308,423,178,601,28,629,1258,50%,33.62%,1
新竹縣,新豐鄉,0309,414,200,614,12,626,1217,51.44%,34.02%,1
新竹縣,新豐鄉,0310,578,202,780,24,804,1456,55.22%,39.7%,1
新竹縣,新豐鄉,0311,461,200,661,18,679,1157,58.69%,39.84%,1
新竹縣,新豐鄉,0312,405,151,556,24,580,1089,53.26%,37.19%,1
新竹縣,新豐鄉,0313,476,182,658,10,668,1160,57.59%,41.03%,1
新竹縣,新豐鄉,0314,427,171,598,15,613,976,62.81%,43.75%,1
新竹縣,新豐鄉,0315,537,244,781,34,815,1443,56.48%,37.21%,1
新竹縣,新豐鄉,0316,435,177,612,24,636,1247,51%,34.88%,1
新竹縣,新豐鄉,0317,553,226,779,12,791,1411,56.06%,39.19%,1
新竹縣,新豐鄉,0318,518,192,710,28,738,1238,59.61%,41.84%,1
新竹縣,芎林鄉,0319,162,78,240,6,246,417,58.99%,38.85%,1
新竹縣,芎林鄉,0320,206,157,363,17,380,534,71.16%,38.58%,1
新竹縣,芎林鄉,0321,376,162,538,28,566,963,58.77%,39.04%,1
新竹縣,芎林鄉,0322,172,79,251,22,273,418,65.31%,41.15%,1
新竹縣,芎林鄉,0323,513,185,698,30,728,1312,55.49%,39.1%,1
新竹縣,芎林鄉,0324,467,191,658,26,684,1354,50.52%,34.49%,1
新竹縣,芎林鄉,0325,302,144,446,31,477,785,60.76%,38.47%,1
新竹縣,芎林鄉,0326,334,111,445,46,491,797,61.61%,41.91%,1
新竹縣,芎林鄉,0327,269,115,384,17,401,623,64.37%,43.18%,1
新竹縣,芎林鄉,0328,309,123,432,22,454,759,59.82%,40.71%,1
新竹縣,芎林鄉,0329,417,199,616,34,650,1272,51.1%,32.78%,1
新竹縣,芎林鄉,0330,473,178,651,24,675,1129,59.79%,41.9%,1
新竹縣,芎林鄉,0331,293,126,419,25,444,713,62.27%,41.09%,1
新竹縣,芎林鄉,0332,355,145,500,22,522,839,62.22%,42.31%,1
新竹縣,芎林鄉,0333,537,182,719,24,743,1123,66.16%,47.82%,1
新竹縣,芎林鄉,0334,404,171,575,18,593,981,60.45%,41.18%,1
新竹縣,芎林鄉,0335,397,223,620,37,657,1078,60.95%,36.83%,1
新竹縣,芎林鄉,0336,382,191,573,23,596,1094,54.48%,34.92%,1
新竹縣,芎林鄉,0337,432,183,615,41,656,1102,59.53%,39.2%,1
新竹縣,橫山鄉,0338,490,208,698,53,751,1231,61.01%,39.81%,1
新竹縣,橫山鄉,0339,466,100,566,43,609,1041,58.5%,44.76%,1
新竹縣,橫山鄉,0340,472,187,659,27,686,1132,60.6%,41.7%,1
新竹縣,橫山鄉,0341,364,150,514,25,539,859,62.75%,42.37%,1
新竹縣,橫山鄉,0342,74,32,106,15,121,204,59.31%,36.27%,1
新竹縣,橫山鄉,0343,73,25,98,4,102,222,45.95%,32.88%,1
新竹縣,橫山鄉,0344,128,67,195,24,219,338,64.79%,37.87%,1
新竹縣,橫山鄉,0345,339,131,470,25,495,916,54.04%,37.01%,1
新竹縣,橫山鄉,0346,178,53,231,11,242,573,42.23%,31.06%,1
新竹縣,橫山鄉,0347,117,64,181,9,190,275,69.09%,42.55%,1
新竹縣,橫山鄉,0348,160,53,213,16,229,463,49.46%,34.56%,1
新竹縣,橫山鄉,0349,293,110,403,37,440,690,63.77%,42.46%,1
新竹縣,橫山鄉,0350,107,36,143,8,151,288,52.43%,37.15%,1
新竹縣,橫山鄉,0351,301,109,410,32,442,685,64.53%,43.94%,1
新竹縣,橫山鄉,0352,361,143,504,33,537,868,61.87%,41.59%,1
新竹縣,橫山鄉,0353,666,239,905,64,969,1561,62.08%,42.66%,1
新竹縣,北埔鄉,0354,404,183,587,18,605,1158,52.25%,34.89%,1
新竹縣,北埔鄉,0355,464,225,689,54,743,1238,60.02%,37.48%,1
新竹縣,北埔鄉,0356,226,102,328,14,342,580,58.97%,38.97%,1
新竹縣,北埔鄉,0357,372,153,525,24,549,931,58.97%,39.96%,1
新竹縣,北埔鄉,0358,639,248,887,49,936,1653,56.62%,38.66%,1
新竹縣,北埔鄉,0359,327,131,458,26,484,845,57.28%,38.7%,1
新竹縣,北埔鄉,0360,170,48,218,5,223,384,58.07%,44.27%,1
新竹縣,北埔鄉,0361,297,121,418,12,430,763,56.36%,38.93%,1
新竹縣,北埔鄉,0362,109,65,174,11,185,333,55.56%,32.73%,1
新竹縣,北埔鄉,0363,124,32,156,5,161,295,54.58%,42.03%,1
新竹縣,寶山鄉,0364,416,214,630,44,674,1158,58.2%,35.92%,1
新竹縣,寶山鄉,0365,501,300,801,18,819,1437,56.99%,34.86%,1
新竹縣,寶山鄉,0366,546,258,804,31,835,1470,56.8%,37.14%,1
新竹縣,寶山鄉,0367,445,230,675,37,712,1170,60.85%,38.03%,1
新竹縣,寶山鄉,0368,715,305,1020,84,1104,1900,58.11%,37.63%,1
新竹縣,寶山鄉,0369,358,167,525,19,544,1056,51.52%,33.9%,1
新竹縣,寶山鄉,0370,501,207,708,50,758,1205,62.9%,41.58%,1
新竹縣,寶山鄉,0371,312,92,404,33,437,766,57.05%,40.73%,1
新竹縣,寶山鄉,0372,345,139,484,35,519,846,61.35%,40.78%,1
新竹縣,寶山鄉,0373,317,146,463,29,492,804,61.19%,39.43%,1
新竹縣,寶山鄉,0374,248,110,358,13,371,607,61.12%,40.86%,1
新竹縣,寶山鄉,0375,225,124,349,15,364,554,65.7%,40.61%,1
新竹縣,峨眉鄉,0376,394,138,532,44,576,879,65.53%,44.82%,1
新竹縣,峨眉鄉,0377,283,116,399,34,433,683,63.4%,41.43%,1
新竹縣,峨眉鄉,0378,251,91,342,25,367,604,60.76%,41.56%,1
新竹縣,峨眉鄉,0379,137,47,184,15,199,339,58.7%,40.41%,1
新竹縣,峨眉鄉,0380,90,29,119,6,125,276,45.29%,32.61%,1
新竹縣,峨眉鄉,0381,593,214,807,51,858,1406,61.02%,42.18%,1
新竹縣,峨眉鄉,0382,211,58,269,20,289,462,62.55%,45.67%,1
新竹縣,峨眉鄉,0383,139,76,215,13,228,419,54.42%,33.17%,1
新竹縣,尖石鄉,0384,180,56,236,5,241,474,50.84%,37.97%,1
新竹縣,尖石鄉,0385,153,49,202,7,209,357,58.54%,42.86%,1
新竹縣,尖石鄉,0386,75,24,99,12,111,225,49.33%,33.33%,1
新竹縣,尖石鄉,0387,176,48,224,5,229,374,61.23%,47.06%,1
新竹縣,尖石鄉,0388,329,93,422,17,439,773,56.79%,42.56%,1
新竹縣,尖石鄉,0389,295,45,340,13,353,490,72.04%,60.2%,1
新竹縣,尖石鄉,0390,206,61,267,5,272,531,51.22%,38.79%,1
新竹縣,尖石鄉,0391,321,74,395,13,408,660,61.82%,48.64%,1
新竹縣,尖石鄉,0392,332,82,414,17,431,613,70.31%,54.16%,1
新竹縣,尖石鄉,0393,215,107,322,5,327,593,55.14%,36.26%,1
新竹縣,尖石鄉,0394,242,83,325,14,339,575,58.96%,42.09%,1
新竹縣,尖石鄉,0395,61,20,81,3,84,126,66.67%,48.41%,1
新竹縣,尖石鄉,0396,237,41,278,4,282,499,56.51%,47.49%,1
新竹縣,尖石鄉,0397,255,95,350,17,367,785,46.75%,32.48%,1
新竹縣,尖石鄉,0398,129,60,189,13,202,289,69.9%,44.64%,1
新竹縣,五峰鄉,0399,331,83,414,14,428,672,63.69%,49.26%,1
新竹縣,五峰鄉,0400,247,99,346,17,363,713,50.91%,34.64%,1
新竹縣,五峰鄉,0401,197,73,270,2,272,594,45.79%,33.16%,1
新竹縣,五峰鄉,0402,337,113,450,28,478,896,53.35%,37.61%,1
新竹縣,五峰鄉,0403,308,96,404,8,412,727,56.67%,42.37%,1
新竹縣,五峰鄉,0404,164,68,232,5,237,395,60%,41.52%,1
苗栗縣,苗栗市,0001,435,166,601,29,630,1087,57.96%,40.02%,1
苗栗縣,苗栗市,0002,386,160,546,23,569,1018,55.89%,37.92%,1
苗栗縣,苗栗市,0003,452,170,622,19,641,1156,55.45%,39.1%,1
苗栗縣,苗栗市,0004,444,155,599,31,630,1118,56.35%,39.71%,1
苗栗縣,苗栗市,0005,416,178,594,43,637,1084,58.76%,38.38%,1
苗栗縣,苗栗市,0006,485,199,684,37,721,1203,59.93%,40.32%,1
苗栗縣,苗栗市,0007,545,191,736,46,782,1306,59.88%,41.73%,1
苗栗縣,苗栗市,0008,486,185,671,39,710,1193,59.51%,40.74%,1
苗栗縣,苗栗市,0009,443,183,626,33,659,1115,59.1%,39.73%,1
苗栗縣,苗栗市,0010,475,177,652,36,688,1119,61.48%,42.45%,1
苗栗縣,苗栗市,0011,473,201,674,22,696,1132,61.48%,41.78%,1
苗栗縣,苗栗市,0012,529,189,718,29,747,1289,57.95%,41.04%,1
苗栗縣,苗栗市,0013,506,221,727,31,758,1264,59.97%,40.03%,1
苗栗縣,苗栗市,0014,366,108,474,20,494,870,56.78%,42.07%,1
苗栗縣,苗栗市,0015,337,133,470,44,514,1008,50.99%,33.43%,1
苗栗縣,苗栗市,0016,379,156,535,37,572,1078,53.06%,35.16%,1
苗栗縣,苗栗市,0017,447,179,626,29,655,1077,60.82%,41.5%,1
苗栗縣,苗栗市,0018,360,145,505,15,520,880,59.09%,40.91%,1
苗栗縣,苗栗市,0019,339,124,463,40,503,894,56.26%,37.92%,1
苗栗縣,苗栗市,0020,216,69,285,20,305,522,58.43%,41.38%,1
苗栗縣,苗栗市,0021,549,273,822,51,873,1376,63.44%,39.9%,1
苗栗縣,苗栗市,0022,521,216,737,32,769,1391,55.28%,37.46%,1
苗栗縣,苗栗市,0023,446,172,618,35,653,1081,60.41%,41.26%,1
苗栗縣,苗栗市,0024,474,206,680,31,711,1272,55.9%,37.26%,1
苗栗縣,苗栗市,0025,478,189,667,38,705,1112,63.4%,42.99%,1
苗栗縣,苗栗市,0026,379,149,528,19,547,813,67.28%,46.62%,1
苗栗縣,苗栗市,0027,297,124,421,17,438,767,57.11%,38.72%,1
苗栗縣,苗栗市,0028,382,179,561,19,580,1010,57.43%,37.82%,1
苗栗縣,苗栗市,0029,462,181,643,25,668,1182,56.51%,39.09%,1
苗栗縣,苗栗市,0030,386,152,538,18,556,965,57.62%,40%,1
苗栗縣,苗栗市,0031,238,114,352,13,365,607,60.13%,39.21%,1
苗栗縣,苗栗市,0032,410,181,591,24,615,990,62.12%,41.41%,1
苗栗縣,苗栗市,0033,425,165,590,79,669,1230,54.39%,34.55%,1
苗栗縣,苗栗市,0034,544,219,763,33,796,1372,58.02%,39.65%,1
苗栗縣,苗栗市,0035,474,212,686,26,712,1213,58.7%,39.08%,1
苗栗縣,苗栗市,0036,491,208,699,26,725,1272,57%,38.6%,1
苗栗縣,苗栗市,0037,562,170,732,18,750,1221,61.43%,46.03%,1
苗栗縣,苗栗市,0038,419,191,610,38,648,1104,58.7%,37.95%,1
苗栗縣,苗栗市,0039,438,181,619,10,629,1171,53.71%,37.4%,1
苗栗縣,苗栗市,0040,530,207,737,45,782,1392,56.18%,38.07%,1
苗栗縣,苗栗市,0041,550,221,771,25,796,1356,58.7%,40.56%,1
苗栗縣,苗栗市,0042,543,237,780,27,807,1387,58.18%,39.15%,1
苗栗縣,苗栗市,0043,451,199,650,25,675,1206,55.97%,37.4%,1
苗栗縣,苗栗市,0044,439,179,618,23,641,1004,63.84%,43.73%,1
苗栗縣,苗栗市,0045,462,197,659,19,678,1202,56.41%,38.44%,1
苗栗縣,苗栗市,0046,430,183,613,28,641,1052,60.93%,40.87%,1
苗栗縣,苗栗市,0047,385,133,518,21,539,873,61.74%,44.1%,1
苗栗縣,苗栗市,0048,448,166,614,39,653,975,66.97%,45.95%,1
苗栗縣,苗栗市,0049,447,148,595,48,643,1003,64.11%,44.57%,1
苗栗縣,苗栗市,0050,389,103,492,17,509,1000,50.9%,38.9%,1
苗栗縣,苗栗市,0051,393,176,569,22,591,1047,56.45%,37.54%,1
苗栗縣,苗栗市,0052,428,173,601,28,629,1025,61.37%,41.76%,1
苗栗縣,苗栗市,0053,429,166,595,15,610,1130,53.98%,37.96%,1
苗栗縣,苗栗市,0054,429,204,633,20,653,1146,56.98%,37.43%,1
苗栗縣,苗栗市,0055,561,241,802,33,835,1432,58.31%,39.18%,1
苗栗縣,苗栗市,0056,514,176,690,22,712,1492,47.72%,34.45%,1
苗栗縣,苗栗市,0057,477,196,673,18,691,1125,61.42%,42.4%,1
苗栗縣,苗栗市,0058,476,201,677,18,695,1241,56%,38.36%,1
苗栗縣,苗栗市,0059,517,228,745,24,769,1278,60.17%,40.45%,1
苗栗縣,苗栗市,0060,528,178,706,20,726,1293,56.15%,40.84%,1
苗栗縣,苗栗市,0061,470,222,692,23,715,1342,53.28%,35.02%,1
苗栗縣,苗栗市,0062,311,138,449,26,475,857,55.43%,36.29%,1
苗栗縣,苗栗市,0063,454,158,612,35,647,1180,54.83%,38.47%,1
苗栗縣,苗栗市,0064,426,195,621,15,636,1072,59.33%,39.74%,1
苗栗縣,苗栗市,0065,358,129,487,19,506,912,55.48%,39.25%,1
苗栗縣,苗栗市,0066,295,112,407,19,426,796,53.52%,37.06%,1
苗栗縣,苗栗市,0067,277,148,425,15,440,869,50.63%,31.88%,1
苗栗縣,苑裡鎮,0183,344,151,495,29,524,873,60.02%,39.4%,1
苗栗縣,苑裡鎮,0184,535,218,753,27,780,1346,57.95%,39.75%,1
苗栗縣,苑裡鎮,0185,415,182,597,35,632,951,66.46%,43.64%,1
苗栗縣,苑裡鎮,0186,261,75,336,20,356,615,57.89%,42.44%,1
苗栗縣,苑裡鎮,0187,382,135,517,33,550,878,62.64%,43.51%,1
苗栗縣,苑裡鎮,0188,313,143,456,19,475,767,61.93%,40.81%,1
苗栗縣,苑裡鎮,0189,309,110,419,29,448,776,57.73%,39.82%,1
苗栗縣,苑裡鎮,0190,446,177,623,48,671,1231,54.51%,36.23%,1
苗栗縣,苑裡鎮,0191,452,209,661,29,690,1145,60.26%,39.48%,1
苗栗縣,苑裡鎮,0192,321,135,456,25,481,850,56.59%,37.76%,1
苗栗縣,苑裡鎮,0193,384,162,546,41,587,1052,55.8%,36.5%,1
苗栗縣,苑裡鎮,0194,418,187,605,34,639,1114,57.36%,37.52%,1
苗栗縣,苑裡鎮,0195,416,216,632,45,677,1136,59.6%,36.62%,1
苗栗縣,苑裡鎮,0196,449,193,642,37,679,1194,56.87%,37.6%,1
苗栗縣,苑裡鎮,0197,623,247,870,36,906,1579,57.38%,39.46%,1
苗栗縣,苑裡鎮,0198,459,219,678,35,713,1149,62.05%,39.95%,1
苗栗縣,苑裡鎮,0199,395,209,604,39,643,1057,60.83%,37.37%,1
苗栗縣,苑裡鎮,0200,378,164,542,24,566,1101,51.41%,34.33%,1
苗栗縣,苑裡鎮,0201,282,145,427,29,456,912,50%,30.92%,1
苗栗縣,苑裡鎮,0202,228,107,335,33,368,652,56.44%,34.97%,1
苗栗縣,苑裡鎮,0203,497,225,722,58,780,1348,57.86%,36.87%,1
苗栗縣,苑裡鎮,0204,254,114,368,16,384,733,52.39%,34.65%,1
苗栗縣,苑裡鎮,0205,235,95,330,14,344,662,51.96%,35.5%,1
苗栗縣,苑裡鎮,0206,331,159,490,30,520,893,58.23%,37.07%,1
苗栗縣,苑裡鎮,0207,371,147,518,31,549,910,60.33%,40.77%,1
苗栗縣,苑裡鎮,0208,448,211,659,48,707,1270,55.67%,35.28%,1
苗栗縣,苑裡鎮,0209,185,85,270,22,292,545,53.58%,33.94%,1
苗栗縣,苑裡鎮,0210,358,110,468,35,503,792,63.51%,45.2%,1
苗栗縣,苑裡鎮,0211,266,131,397,20,417,726,57.44%,36.64%,1
苗栗縣,苑裡鎮,0212,251,109,360,10,370,827,44.74%,30.35%,1
苗栗縣,苑裡鎮,0213,311,128,439,31,470,782,60.1%,39.77%,1
苗栗縣,苑裡鎮,0214,291,115,406,29,435,788,55.2%,36.93%,1
苗栗縣,苑裡鎮,0215,276,155,431,35,466,846,55.08%,32.62%,1
苗栗縣,苑裡鎮,0216,322,145,467,38,505,828,60.99%,38.89%,1
苗栗縣,苑裡鎮,0217,362,149,511,39,550,943,58.32%,38.39%,1
苗栗縣,苑裡鎮,0218,426,191,617,24,641,1082,59.24%,39.37%,1
苗栗縣,苑裡鎮,0219,488,220,708,41,749,1234,60.7%,39.55%,1
苗栗縣,苑裡鎮,0220,511,228,739,48,787,1434,54.88%,35.63%,1
苗栗縣,苑裡鎮,0221,396,146,542,29,571,987,57.85%,40.12%,1
苗栗縣,苑裡鎮,0222,357,176,533,31,564,882,63.95%,40.48%,1
苗栗縣,通霄鎮,0149,401,222,623,49,672,1142,58.84%,35.11%,1
苗栗縣,通霄鎮,0150,370,168,538,39,577,884,65.27%,41.86%,1
苗栗縣,通霄鎮,0151,416,150,566,40,606,1068,56.74%,38.95%,1
苗栗縣,通霄鎮,0152,443,177,620,31,651,1009,64.52%,43.9%,1
苗栗縣,通霄鎮,0153,397,151,548,15,563,859,65.54%,46.22%,1
苗栗縣,通霄鎮,0154,397,190,587,22,609,1040,58.56%,38.17%,1
苗栗縣,通霄鎮,0155,341,138,479,18,497,1008,49.31%,33.83%,1
苗栗縣,通霄鎮,0156,273,104,377,31,408,686,59.48%,39.8%,1
苗栗縣,通霄鎮,0157,363,137,500,20,520,761,68.33%,47.7%,1
苗栗縣,通霄鎮,0158,299,106,405,12,417,790,52.78%,37.85%,1
苗栗縣,通霄鎮,0159,359,151,510,24,534,966,55.28%,37.16%,1
苗栗縣,通霄鎮,0160,353,118,471,34,505,972,51.95%,36.32%,1
苗栗縣,通霄鎮,0161,311,108,419,25,444,771,57.59%,40.34%,1
苗栗縣,通霄鎮,0162,222,117,339,27,366,758,48.28%,29.29%,1
苗栗縣,通霄鎮,0163,374,183,557,28,585,1078,54.27%,34.69%,1
苗栗縣,通霄鎮,0164,124,54,178,21,199,459,43.36%,27.02%,1
苗栗縣,通霄鎮,0165,301,118,419,30,449,894,50.22%,33.67%,1
苗栗縣,通霄鎮,0166,99,49,148,11,159,402,39.55%,24.63%,1
苗栗縣,通霄鎮,0167,290,122,412,22,434,802,54.11%,36.16%,1
苗栗縣,通霄鎮,0168,225,118,343,17,360,684,52.63%,32.89%,1
苗栗縣,通霄鎮,0169,296,120,416,29,445,943,47.19%,31.39%,1
苗栗縣,通霄鎮,0170,313,132,445,35,480,790,60.76%,39.62%,1
苗栗縣,通霄鎮,0171,212,76,288,8,296,673,43.98%,31.5%,1
苗栗縣,通霄鎮,0172,440,163,603,49,652,1232,52.92%,35.71%,1
苗栗縣,通霄鎮,0173,501,200,701,57,758,1286,58.94%,38.96%,1
苗栗縣,通霄鎮,0174,255,108,363,25,388,649,59.78%,39.29%,1
苗栗縣,通霄鎮,0175,239,121,360,28,388,769,50.46%,31.08%,1
苗栗縣,通霄鎮,0176,389,197,586,60,646,1148,56.27%,33.89%,1
苗栗縣,通霄鎮,0177,355,174,529,46,575,1138,50.53%,31.2%,1
苗栗縣,通霄鎮,0178,383,159,542,49,591,1121,52.72%,34.17%,1
苗栗縣,通霄鎮,0179,262,144,406,21,427,769,55.53%,34.07%,1
苗栗縣,通霄鎮,0180,199,100,299,12,311,616,50.49%,32.31%,1
苗栗縣,通霄鎮,0181,269,132,401,39,440,799,55.07%,33.67%,1
苗栗縣,通霄鎮,0182,247,118,365,21,386,743,51.95%,33.24%,1
苗栗縣,竹南鎮,0270,415,232,647,9,656,1086,60.41%,38.21%,1
苗栗縣,竹南鎮,0271,330,133,463,28,491,826,59.44%,39.95%,1
苗栗縣,竹南鎮,0272,336,195,531,30,561,1051,53.38%,31.97%,1
苗栗縣,竹南鎮,0273,506,193,699,32,731,1235,59.19%,40.97%,1
苗栗縣,竹南鎮,0274,382,185,567,51,618,1016,60.83%,37.6%,1
苗栗縣,竹南鎮,0275,509,257,766,30,796,1472,54.08%,34.58%,1
苗栗縣,竹南鎮,0276,432,203,635,16,651,1301,50.04%,33.21%,1
苗栗縣,竹南鎮,0277,510,253,763,23,786,1544,50.91%,33.03%,1
苗栗縣,竹南鎮,0278,545,260,805,25,830,1512,54.89%,36.04%,1
苗栗縣,竹南鎮,0279,507,237,744,35,779,1463,53.25%,34.65%,1
苗栗縣,竹南鎮,0280,356,196,552,17,569,1073,53.03%,33.18%,1
苗栗縣,竹南鎮,0281,551,256,807,22,829,1453,57.05%,37.92%,1
苗栗縣,竹南鎮,0282,516,225,741,15,756,1245,60.72%,41.45%,1
苗栗縣,竹南鎮,0283,614,248,862,25,887,1487,59.65%,41.29%,1
苗栗縣,竹南鎮,0284,410,164,574,29,603,1018,59.23%,40.28%,1
苗栗縣,竹南鎮,0285,422,213,635,23,658,1105,59.55%,38.19%,1
苗栗縣,竹南鎮,0286,459,216,675,29,704,1322,53.25%,34.72%,1
苗栗縣,竹南鎮,0287,471,177,648,18,666,1140,58.42%,41.32%,1
苗栗縣,竹南鎮,0288,436,189,625,30,655,1067,61.39%,40.86%,1
苗栗縣,竹南鎮,0289,480,201,681,33,714,1136,62.85%,42.25%,1
苗栗縣,竹南鎮,0290,446,187,633,20,653,1253,52.11%,35.59%,1
苗栗縣,竹南鎮,0291,330,152,482,31,513,963,53.27%,34.27%,1
苗栗縣,竹南鎮,0292,350,184,534,23,557,1021,54.55%,34.28%,1
苗栗縣,竹南鎮,0293,453,214,667,31,698,1154,60.49%,39.25%,1
苗栗縣,竹南鎮,0294,380,193,573,26,599,1042,57.49%,36.47%,1
苗栗縣,竹南鎮,0295,514,195,709,36,745,1293,57.62%,39.75%,1
苗栗縣,竹南鎮,0296,350,125,475,13,488,816,59.8%,42.89%,1
苗栗縣,竹南鎮,0297,352,180,532,31,563,989,56.93%,35.59%,1
苗栗縣,竹南鎮,0298,479,163,642,37,679,1122,60.52%,42.69%,1
苗栗縣,竹南鎮,0299,330,179,509,17,526,1111,47.34%,29.7%,1
苗栗縣,竹南鎮,0300,431,153,584,33,617,1036,59.56%,41.6%,1
苗栗縣,竹南鎮,0301,403,139,542,18,560,1112,50.36%,36.24%,1
苗栗縣,竹南鎮,0302,492,196,688,15,703,1348,52.15%,36.5%,1
苗栗縣,竹南鎮,0303,418,219,637,21,658,1114,59.07%,37.52%,1
苗栗縣,竹南鎮,0304,437,195,632,42,674,1119,60.23%,39.05%,1
苗栗縣,竹南鎮,0305,356,118,474,24,498,878,56.72%,40.55%,1
苗栗縣,竹南鎮,0306,433,184,617,37,654,1059,61.76%,40.89%,1
苗栗縣,竹南鎮,0307,338,168,506,19,525,869,60.41%,38.9%,1
苗栗縣,竹南鎮,0308,295,135,430,20,450,800,56.25%,36.88%,1
苗栗縣,竹南鎮,0309,470,213,683,28,711,1165,61.03%,40.34%,1
苗栗縣,竹南鎮,0310,303,138,441,21,462,791,58.41%,38.31%,1
苗栗縣,竹南鎮,0311,265,102,367,23,390,677,57.61%,39.14%,1
苗栗縣,竹南鎮,0312,327,151,478,43,521,797,65.37%,41.03%,1
苗栗縣,竹南鎮,0313,470,175,645,18,663,1191,55.67%,39.46%,1
苗栗縣,竹南鎮,0314,359,172,531,16,547,1027,53.26%,34.96%,1
苗栗縣,竹南鎮,0315,552,210,762,27,789,1341,58.84%,41.16%,1
苗栗縣,竹南鎮,0316,474,197,671,33,704,1378,51.09%,34.4%,1
苗栗縣,竹南鎮,0317,461,204,665,17,682,1216,56.09%,37.91%,1
苗栗縣,竹南鎮,0318,600,216,816,31,847,1570,53.95%,38.22%,1
苗栗縣,竹南鎮,0319,233,84,317,23,340,538,63.2%,43.31%,1
苗栗縣,竹南鎮,0320,424,136,560,26,586,1166,50.26%,36.36%,1
苗栗縣,竹南鎮,0321,502,261,763,17,780,1488,52.42%,33.74%,1
苗栗縣,竹南鎮,0322,517,197,714,18,732,1449,50.52%,35.68%,1
苗栗縣,竹南鎮,0323,437,184,621,43,664,1182,56.18%,36.97%,1
苗栗縣,竹南鎮,0324,391,209,600,72,672,1175,57.19%,33.28%,1
苗栗縣,竹南鎮,0325,374,153,527,44,571,983,58.09%,38.05%,1
苗栗縣,竹南鎮,0326,201,89,290,19,309,492,62.8%,40.85%,1
苗栗縣,竹南鎮,0327,398,196,594,29,623,1074,58.01%,37.06%,1
苗栗縣,竹南鎮,0328,303,140,443,31,474,852,55.63%,35.56%,1
苗栗縣,竹南鎮,0329,464,204,668,24,692,1297,53.35%,35.77%,1
苗栗縣,竹南鎮,0330,358,168,526,33,559,1028,54.38%,34.82%,1
苗栗縣,頭份市,0331,328,130,458,40,498,915,54.43%,35.85%,1
苗栗縣,頭份市,0332,521,178,699,37,736,1292,56.97%,40.33%,1
苗栗縣,頭份市,0333,375,156,531,21,552,928,59.48%,40.41%,1
苗栗縣,頭份市,0334,315,117,432,16,448,835,53.65%,37.72%,1
苗栗縣,頭份市,0335,407,159,566,23,589,1070,55.05%,38.04%,1
苗栗縣,頭份市,0336,311,141,452,9,461,879,52.45%,35.38%,1
苗栗縣,頭份市,0337,346,174,520,21,541,1039,52.07%,33.3%,1
苗栗縣,頭份市,0338,465,171,636,25,661,1129,58.55%,41.19%,1
苗栗縣,頭份市,0339,379,156,535,37,572,1041,54.95%,36.41%,1
苗栗縣,頭份市,0340,566,198,764,33,797,1546,51.55%,36.61%,1
苗栗縣,頭份市,0341,400,154,554,34,588,935,62.89%,42.78%,1
苗栗縣,頭份市,0342,383,212,595,24,619,1180,52.46%,32.46%,1
苗栗縣,頭份市,0343,542,204,746,31,777,1499,51.83%,36.16%,1
苗栗縣,頭份市,0344,257,142,399,8,407,747,54.48%,34.4%,1
苗栗縣,頭份市,0345,532,205,737,39,776,1406,55.19%,37.84%,1
苗栗縣,頭份市,0346,458,168,626,47,673,1193,56.41%,38.39%,1
苗栗縣,頭份市,0347,376,156,532,26,558,948,58.86%,39.66%,1
苗栗縣,頭份市,0348,330,123,453,14,467,869,53.74%,37.97%,1
苗栗縣,頭份市,0349,434,209,643,23,666,1142,58.32%,38%,1
苗栗縣,頭份市,0350,484,220,704,12,716,1286,55.68%,37.64%,1
苗栗縣,頭份市,0351,351,162,513,28,541,903,59.91%,38.87%,1
苗栗縣,頭份市,0352,510,193,703,31,734,1186,61.89%,43%,1
苗栗縣,頭份市,0353,425,165,590,13,603,1016,59.35%,41.83%,1
苗栗縣,頭份市,0354,368,167,535,25,560,985,56.85%,37.36%,1
苗栗縣,頭份市,0355,392,153,545,19,564,1037,54.39%,37.8%,1
苗栗縣,頭份市,0356,300,137,437,27,464,947,49%,31.68%,1
苗栗縣,頭份市,0357,360,143,503,18,521,890,58.54%,40.45%,1
苗栗縣,頭份市,0358,254,137,391,21,412,646,63.78%,39.32%,1
苗栗縣,頭份市,0359,362,183,545,38,583,975,59.79%,37.13%,1
苗栗縣,頭份市,0360,260,127,387,11,398,1015,39.21%,25.62%,1
苗栗縣,頭份市,0361,584,236,820,45,865,1399,61.83%,41.74%,1
苗栗縣,頭份市,0362,455,193,648,40,688,1143,60.19%,39.81%,1
苗栗縣,頭份市,0363,466,160,626,46,672,1030,65.24%,45.24%,1
苗栗縣,頭份市,0364,511,234,745,30,775,1338,57.92%,38.19%,1
苗栗縣,頭份市,0365,553,226,779,20,799,1450,55.1%,38.14%,1
苗栗縣,頭份市,0366,422,177,599,10,609,1042,58.45%,40.5%,1
苗栗縣,頭份市,0367,531,242,773,23,796,1326,60.03%,40.05%,1
苗栗縣,頭份市,0368,547,225,772,30,802,1270,63.15%,43.07%,1
苗栗縣,頭份市,0369,489,220,709,22,731,1288,56.75%,37.97%,1
苗栗縣,頭份市,0370,536,201,737,22,759,1243,61.06%,43.12%,1
苗栗縣,頭份市,0371,541,194,735,21,756,1280,59.06%,42.27%,1
苗栗縣,頭份市,0372,612,263,875,32,907,1618,56.06%,37.82%,1
苗栗縣,頭份市,0373,640,267,907,39,946,1759,53.78%,36.38%,1
苗栗縣,頭份市,0374,524,209,733,22,755,1264,59.73%,41.46%,1
苗栗縣,頭份市,0375,514,232,746,22,768,1326,57.92%,38.76%,1
苗栗縣,頭份市,0376,623,253,876,22,898,1551,57.9%,40.17%,1
苗栗縣,頭份市,0377,542,248,790,29,819,1574,52.03%,34.43%,1
苗栗縣,頭份市,0378,474,226,700,31,731,1262,57.92%,37.56%,1
苗栗縣,頭份市,0379,445,212,657,32,689,1171,58.84%,38%,1
苗栗縣,頭份市,0380,469,211,680,18,698,1074,64.99%,43.67%,1
苗栗縣,頭份市,0381,487,181,668,26,694,1141,60.82%,42.68%,1
苗栗縣,頭份市,0382,491,216,707,29,736,1259,58.46%,39%,1
苗栗縣,頭份市,0383,453,190,643,18,661,1186,55.73%,38.2%,1
苗栗縣,頭份市,0384,412,144,556,29,585,1121,52.19%,36.75%,1
苗栗縣,頭份市,0385,325,137,462,25,487,847,57.5%,38.37%,1
苗栗縣,頭份市,0386,388,189,577,22,599,993,60.32%,39.07%,1
苗栗縣,頭份市,0387,385,173,558,22,580,1055,54.98%,36.49%,1
苗栗縣,頭份市,0388,582,226,808,32,840,1655,50.76%,35.17%,1
苗栗縣,頭份市,0389,680,268,948,42,990,1799,55.03%,37.8%,1
苗栗縣,頭份市,0390,452,179,631,32,663,1141,58.11%,39.61%,1
苗栗縣,頭份市,0391,499,244,743,41,784,1431,54.79%,34.87%,1
苗栗縣,頭份市,0392,462,197,659,21,680,1412,48.16%,32.72%,1
苗栗縣,頭份市,0393,390,151,541,25,566,1074,52.7%,36.31%,1
苗栗縣,頭份市,0394,593,118,711,32,743,1245,59.68%,47.63%,1
苗栗縣,頭份市,0395,490,259,749,53,802,1344,59.67%,36.46%,1
苗栗縣,頭份市,0396,568,234,802,41,843,1363,61.85%,41.67%,1
苗栗縣,頭份市,0397,385,154,539,33,572,898,63.7%,42.87%,1
苗栗縣,頭份市,0398,455,223,678,42,720,1182,60.91%,38.49%,1
苗栗縣,頭份市,0399,558,192,750,32,782,1413,55.34%,39.49%,1
苗栗縣,頭份市,0400,396,187,583,33,616,991,62.16%,39.96%,1
苗栗縣,頭份市,0401,451,208,659,37,696,1180,58.98%,38.22%,1
苗栗縣,後龍鎮,0223,208,106,314,31,345,590,58.47%,35.25%,1
苗栗縣,後龍鎮,0224,349,175,524,43,567,883,64.21%,39.52%,1
苗栗縣,後龍鎮,0225,301,165,466,30,496,793,62.55%,37.96%,1
苗栗縣,後龍鎮,0226,292,135,427,15,442,732,60.38%,39.89%,1
苗栗縣,後龍鎮,0227,233,115,348,16,364,592,61.49%,39.36%,1
苗栗縣,後龍鎮,0228,411,222,633,33,666,1113,59.84%,36.93%,1
苗栗縣,後龍鎮,0229,429,219,648,29,677,1195,56.65%,35.9%,1
苗栗縣,後龍鎮,0230,418,180,598,31,629,997,63.09%,41.93%,1
苗栗縣,後龍鎮,0231,300,151,451,15,466,913,51.04%,32.86%,1
苗栗縣,後龍鎮,0232,196,112,308,30,338,641,52.73%,30.58%,1
苗栗縣,後龍鎮,0233,272,151,423,28,451,848,53.18%,32.08%,1
苗栗縣,後龍鎮,0234,447,199,646,58,704,1264,55.7%,35.36%,1
苗栗縣,後龍鎮,0235,311,151,462,40,502,965,52.02%,32.23%,1
苗栗縣,後龍鎮,0236,589,207,796,56,852,1216,70.07%,48.44%,1
苗栗縣,後龍鎮,0237,357,145,502,31,533,977,54.55%,36.54%,1
苗栗縣,後龍鎮,0238,299,144,443,34,477,943,50.58%,31.71%,1
苗栗縣,後龍鎮,0239,329,148,477,44,521,910,57.25%,36.15%,1
苗栗縣,後龍鎮,0240,319,122,441,33,474,851,55.7%,37.49%,1
苗栗縣,後龍鎮,0241,278,167,445,20,465,725,64.14%,38.34%,1
苗栗縣,後龍鎮,0242,225,141,366,24,390,650,60%,34.62%,1
苗栗縣,後龍鎮,0243,219,115,334,35,369,706,52.27%,31.02%,1
苗栗縣,後龍鎮,0244,272,138,410,28,438,748,58.56%,36.36%,1
苗栗縣,後龍鎮,0245,227,126,353,24,377,801,47.07%,28.34%,1
苗栗縣,後龍鎮,0246,435,156,591,32,623,1107,56.28%,39.3%,1
苗栗縣,後龍鎮,0247,416,187,603,52,655,1197,54.72%,34.75%,1
苗栗縣,後龍鎮,0248,336,157,493,37,530,1036,51.16%,32.43%,1
苗栗縣,後龍鎮,0249,267,134,401,28,429,913,46.99%,29.24%,1
苗栗縣,後龍鎮,0250,285,115,400,40,440,719,61.2%,39.64%,1
苗栗縣,後龍鎮,0251,409,142,551,48,599,1037,57.76%,39.44%,1
苗栗縣,後龍鎮,0252,175,113,288,19,307,601,51.08%,29.12%,1
苗栗縣,後龍鎮,0253,356,193,549,35,584,1269,46.02%,28.05%,1
苗栗縣,後龍鎮,0254,232,107,339,29,368,735,50.07%,31.56%,1
苗栗縣,後龍鎮,0255,95,41,136,12,148,422,35.07%,22.51%,1
苗栗縣,後龍鎮,0256,230,111,341,23,364,625,58.24%,36.8%,1
苗栗縣,後龍鎮,0257,390,144,534,40,574,1234,46.52%,31.6%,1
苗栗縣,卓蘭鎮,0442,400,157,557,29,586,961,60.98%,41.62%,1
苗栗縣,卓蘭鎮,0443,366,178,544,32,576,1017,56.64%,35.99%,1
苗栗縣,卓蘭鎮,0444,420,230,650,54,704,1095,64.29%,38.36%,1
苗栗縣,卓蘭鎮,0445,319,122,441,19,460,745,61.74%,42.82%,1
苗栗縣,卓蘭鎮,0446,269,132,401,31,432,783,55.17%,34.36%,1
苗栗縣,卓蘭鎮,0447,256,103,359,16,375,745,50.34%,34.36%,1
苗栗縣,卓蘭鎮,0448,332,139,471,32,503,999,50.35%,33.23%,1
苗栗縣,卓蘭鎮,0449,275,111,386,32,418,671,62.3%,40.98%,1
苗栗縣,卓蘭鎮,0450,306,129,435,48,483,734,65.8%,41.69%,1
苗栗縣,卓蘭鎮,0451,353,149,502,38,540,865,62.43%,40.81%,1
苗栗縣,卓蘭鎮,0452,358,138,496,31,527,828,63.65%,43.24%,1
苗栗縣,卓蘭鎮,0453,145,68,213,30,243,386,62.95%,37.56%,1
苗栗縣,卓蘭鎮,0454,279,135,414,30,444,688,64.53%,40.55%,1
苗栗縣,卓蘭鎮,0455,317,150,467,26,493,792,62.25%,40.03%,1
苗栗縣,卓蘭鎮,0456,273,134,407,26,433,729,59.4%,37.45%,1
苗栗縣,卓蘭鎮,0457,335,166,501,31,532,1093,48.67%,30.65%,1
苗栗縣,卓蘭鎮,0458,243,105,348,17,365,615,59.35%,39.51%,1
苗栗縣,卓蘭鎮,0459,35,10,45,1,46,86,53.49%,40.7%,1
苗栗縣,卓蘭鎮,0460,356,158,514,6,520,940,55.32%,37.87%,1
苗栗縣,大湖鄉,0420,264,119,383,23,406,744,54.57%,35.48%,1
苗栗縣,大湖鄉,0421,347,118,465,22,487,881,55.28%,39.39%,1
苗栗縣,大湖鄉,0422,237,83,320,20,340,596,57.05%,39.77%,1
苗栗縣,大湖鄉,0423,414,188,602,53,655,1260,51.98%,32.86%,1
苗栗縣,大湖鄉,0424,312,119,431,26,457,867,52.71%,35.99%,1
苗栗縣,大湖鄉,0425,368,134,502,18,520,923,56.34%,39.87%,1
苗栗縣,大湖鄉,0426,476,193,669,67,736,1395,52.76%,34.12%,1
苗栗縣,大湖鄉,0427,137,61,198,14,212,561,37.79%,24.42%,1
苗栗縣,大湖鄉,0428,253,96,349,22,371,638,58.15%,39.66%,1
苗栗縣,大湖鄉,0429,257,108,365,35,400,754,53.05%,34.08%,1
苗栗縣,大湖鄉,0430,170,71,241,12,253,501,50.5%,33.93%,1
苗栗縣,大湖鄉,0431,211,121,332,28,360,652,55.21%,32.36%,1
苗栗縣,大湖鄉,0432,257,131,388,27,415,843,49.23%,30.49%,1
苗栗縣,大湖鄉,0433,366,174,540,40,580,1020,56.86%,35.88%,1
苗栗縣,大湖鄉,0434,385,156,541,38,579,1018,56.88%,37.82%,1
苗栗縣,公館鄉,0068,337,148,485,38,523,789,66.29%,42.71%,1
苗栗縣,公館鄉,0069,347,162,509,16,525,792,66.29%,43.81%,1
苗栗縣,公館鄉,0070,472,188,660,59,719,1117,64.37%,42.26%,1
苗栗縣,公館鄉,0071,518,233,751,40,791,1255,63.03%,41.27%,1
苗栗縣,公館鄉,0072,448,191,639,43,682,1141,59.77%,39.26%,1
苗栗縣,公館鄉,0073,427,240,667,20,687,1172,58.62%,36.43%,1
苗栗縣,公館鄉,0074,455,216,671,26,697,1100,63.36%,41.36%,1
苗栗縣,公館鄉,0075,423,191,614,37,651,1232,52.84%,34.33%,1
苗栗縣,公館鄉,0076,390,138,528,45,573,1081,53.01%,36.08%,1
苗栗縣,公館鄉,0077,539,176,715,63,778,1250,62.24%,43.12%,1
苗栗縣,公館鄉,0078,408,177,585,46,631,1081,58.37%,37.74%,1
苗栗縣,公館鄉,0079,338,167,505,48,553,964,57.37%,35.06%,1
苗栗縣,公館鄉,0080,410,168,578,56,634,1038,61.08%,39.5%,1
苗栗縣,公館鄉,0081,146,67,213,14,227,360,63.06%,40.56%,1
苗栗縣,公館鄉,0082,325,138,463,35,498,865,57.57%,37.57%,1
苗栗縣,公館鄉,0083,390,213,603,49,652,1166,55.92%,33.45%,1
苗栗縣,公館鄉,0084,301,114,415,16,431,719,59.94%,41.86%,1
苗栗縣,公館鄉,0085,271,127,398,37,435,788,55.2%,34.39%,1
苗栗縣,公館鄉,0086,116,65,181,21,202,303,66.67%,38.28%,1
苗栗縣,公館鄉,0087,525,263,788,8,796,1322,60.21%,39.71%,1
苗栗縣,公館鄉,0088,341,145,486,49,535,933,57.34%,36.55%,1
苗栗縣,公館鄉,0089,513,223,736,54,790,1455,54.3%,35.26%,1
苗栗縣,公館鄉,0090,641,292,933,66,999,1615,61.86%,39.69%,1
苗栗縣,公館鄉,0091,545,197,742,58,800,1451,55.13%,37.56%,1
苗栗縣,公館鄉,0092,555,265,820,62,882,1462,60.33%,37.96%,1
苗栗縣,公館鄉,0093,452,217,669,68,737,1317,55.96%,34.32%,1
苗栗縣,公館鄉,0094,84,42,126,6,132,221,59.73%,38.01%,1
苗栗縣,公館鄉,0095,125,41,166,9,175,329,53.19%,37.99%,1
苗栗縣,銅鑼鄉,0108,373,144,517,31,548,887,61.78%,42.05%,1
苗栗縣,銅鑼鄉,0109,423,171,594,37,631,1052,59.98%,40.21%,1
苗栗縣,銅鑼鄉,0110,588,201,789,34,823,1347,61.1%,43.65%,1
苗栗縣,銅鑼鄉,0111,445,193,638,35,673,1177,57.18%,37.81%,1
苗栗縣,銅鑼鄉,0112,444,204,648,35,683,1268,53.86%,35.02%,1
苗栗縣,銅鑼鄉,0113,358,188,546,36,582,1185,49.11%,30.21%,1
苗栗縣,銅鑼鄉,0114,413,142,555,45,600,1029,58.31%,40.14%,1
苗栗縣,銅鑼鄉,0115,375,120,495,30,525,905,58.01%,41.44%,1
苗栗縣,銅鑼鄉,0116,316,127,443,25,468,750,62.4%,42.13%,1
苗栗縣,銅鑼鄉,0117,393,136,529,30,559,1080,51.76%,36.39%,1
苗栗縣,銅鑼鄉,0118,377,173,550,56,606,1108,54.69%,34.03%,1
苗栗縣,銅鑼鄉,0119,292,140,432,25,457,862,53.02%,33.87%,1
苗栗縣,銅鑼鄉,0120,403,202,605,43,648,1216,53.29%,33.14%,1
苗栗縣,銅鑼鄉,0121,204,74,278,25,303,588,51.53%,34.69%,1
苗栗縣,銅鑼鄉,0122,137,63,200,35,235,429,54.78%,31.93%,1
苗栗縣,銅鑼鄉,0123,208,85,293,24,317,541,58.6%,38.45%,1
苗栗縣,南庄鄉,0411,402,192,594,49,643,1155,55.67%,34.81%,1
苗栗縣,南庄鄉,0412,206,137,343,30,373,650,57.38%,31.69%,1
苗栗縣,南庄鄉,0413,463,190,653,46,699,1353,51.66%,34.22%,1
苗栗縣,南庄鄉,0414,223,94,317,38,355,813,43.67%,27.43%,1
苗栗縣,南庄鄉,0415,255,83,338,24,362,837,43.25%,30.47%,1
苗栗縣,南庄鄉,0416,382,172,554,23,577,1093,52.79%,34.95%,1
苗栗縣,南庄鄉,0417,374,167,541,36,577,1048,55.06%,35.69%,1
苗栗縣,南庄鄉,0418,294,116,410,38,448,872,51.38%,33.72%,1
苗栗縣,南庄鄉,0419,201,102,303,13,316,963,32.81%,20.87%,1
苗栗縣,頭屋鄉,0096,638,205,843,52,895,1335,67.04%,47.79%,1
苗栗縣,頭屋鄉,0097,560,206,766,63,829,1168,70.98%,47.95%,1
苗栗縣,頭屋鄉,0098,360,134,494,25,519,792,65.53%,45.45%,1
苗栗縣,頭屋鄉,0099,433,201,634,24,658,918,71.68%,47.17%,1
苗栗縣,頭屋鄉,0100,333,104,437,28,465,725,64.14%,45.93%,1
苗栗縣,頭屋鄉,0101,381,151,532,23,555,899,61.74%,42.38%,1
苗栗縣,頭屋鄉,0102,140,38,178,5,183,369,49.59%,37.94%,1
苗栗縣,頭屋鄉,0103,334,151,485,19,504,844,59.72%,39.57%,1
苗栗縣,頭屋鄉,0104,388,189,577,31,608,1007,60.38%,38.53%,1
苗栗縣,頭屋鄉,0105,440,41,481,22,503,794,63.35%,55.42%,1
苗栗縣,頭屋鄉,0106,104,40,144,13,157,211,74.41%,49.29%,1
苗栗縣,頭屋鄉,0107,157,62,219,20,239,328,72.87%,47.87%,1
苗栗縣,三義鄉,0124,353,131,484,40,524,853,61.43%,41.38%,1
苗栗縣,三義鄉,0125,460,131,591,21,612,983,62.26%,46.8%,1
苗栗縣,三義鄉,0126,419,188,607,41,648,1080,60%,38.8%,1
苗栗縣,三義鄉,0127,456,175,631,18,649,1216,53.37%,37.5%,1
苗栗縣,三義鄉,0128,407,165,572,33,605,1017,59.49%,40.02%,1
苗栗縣,三義鄉,0129,454,158,612,20,632,1180,53.56%,38.47%,1
苗栗縣,三義鄉,0130,503,162,665,19,684,1198,57.1%,41.99%,1
苗栗縣,三義鄉,0131,160,64,224,16,240,417,57.55%,38.37%,1
苗栗縣,三義鄉,0132,362,145,507,18,525,991,52.98%,36.53%,1
苗栗縣,三義鄉,0133,349,124,473,19,492,834,58.99%,41.85%,1
苗栗縣,三義鄉,0134,238,111,349,18,367,622,59%,38.26%,1
苗栗縣,三義鄉,0135,279,135,414,47,461,749,61.55%,37.25%,1
苗栗縣,三義鄉,0136,314,110,424,36,460,692,66.47%,45.38%,1
苗栗縣,三義鄉,0137,368,140,508,27,535,759,70.49%,48.48%,1
苗栗縣,三義鄉,0138,209,105,314,22,336,629,53.42%,33.23%,1
苗栗縣,三義鄉,0139,223,139,362,23,385,669,57.55%,33.33%,1
苗栗縣,西湖鄉,0140,227,91,318,22,340,601,56.57%,37.77%,1
苗栗縣,西湖鄉,0141,224,98,322,19,341,566,60.25%,39.58%,1
苗栗縣,西湖鄉,0142,325,130,455,36,491,843,58.24%,38.55%,1
苗栗縣,西湖鄉,0143,220,103,323,21,344,648,53.09%,33.95%,1
苗栗縣,西湖鄉,0144,306,145,451,24,475,936,50.75%,32.69%,1
苗栗縣,西湖鄉,0145,153,77,230,18,248,461,53.8%,33.19%,1
苗栗縣,西湖鄉,0146,193,86,279,19,298,515,57.86%,37.48%,1
苗栗縣,西湖鄉,0147,431,146,577,38,615,1141,53.9%,37.77%,1
苗栗縣,西湖鄉,0148,262,107,369,27,396,671,59.02%,39.05%,1
苗栗縣,造橋鄉,0258,517,211,728,42,770,1171,65.76%,44.15%,1
苗栗縣,造橋鄉,0259,384,122,506,23,529,889,59.51%,43.19%,1
苗栗縣,造橋鄉,0260,163,62,225,14,239,479,49.9%,34.03%,1
苗栗縣,造橋鄉,0261,427,155,582,22,604,1024,58.98%,41.7%,1
苗栗縣,造橋鄉,0262,413,201,614,44,658,1214,54.2%,34.02%,1
苗栗縣,造橋鄉,0263,364,166,530,31,561,1071,52.38%,33.99%,1
苗栗縣,造橋鄉,0264,395,170,565,43,608,1157,52.55%,34.14%,1
苗栗縣,造橋鄉,0265,192,85,277,25,302,512,58.98%,37.5%,1
苗栗縣,造橋鄉,0266,193,100,293,16,309,491,62.93%,39.31%,1
苗栗縣,造橋鄉,0267,495,216,711,56,767,1272,60.3%,38.92%,1
苗栗縣,造橋鄉,0268,289,128,417,35,452,785,57.58%,36.82%,1
苗栗縣,造橋鄉,0269,393,175,568,69,637,962,66.22%,40.85%,1
苗栗縣,三灣鄉,0402,397,167,564,30,594,996,59.64%,39.86%,1
苗栗縣,三灣鄉,0403,463,184,647,40,687,1205,57.01%,38.42%,1
苗栗縣,三灣鄉,0404,250,106,356,33,389,635,61.26%,39.37%,1
苗栗縣,三灣鄉,0405,328,143,471,25,496,862,57.54%,38.05%,1
苗栗縣,三灣鄉,0406,75,30,105,13,118,238,49.58%,31.51%,1
苗栗縣,三灣鄉,0407,182,89,271,23,294,541,54.34%,33.64%,1
苗栗縣,三灣鄉,0408,192,83,275,24,299,578,51.73%,33.22%,1
苗栗縣,三灣鄉,0409,180,70,250,29,279,405,68.89%,44.44%,1
苗栗縣,三灣鄉,0410,148,55,203,21,224,392,57.14%,37.76%,1
苗栗縣,獅潭鄉,0435,90,34,124,6,130,328,39.63%,27.44%,1
苗栗縣,獅潭鄉,0436,160,65,225,27,252,565,44.6%,28.32%,1
苗栗縣,獅潭鄉,0437,367,114,481,43,524,911,57.52%,40.29%,1
苗栗縣,獅潭鄉,0438,175,68,243,27,270,568,47.54%,30.81%,1
苗栗縣,獅潭鄉,0439,230,85,315,26,341,580,58.79%,39.66%,1
苗栗縣,獅潭鄉,0440,129,35,164,7,171,333,51.35%,38.74%,1
苗栗縣,獅潭鄉,0441,251,85,336,18,354,683,51.83%,36.75%,1
苗栗縣,泰安鄉,0461,88,54,142,7,149,325,45.85%,27.08%,1
苗栗縣,泰安鄉,0462,183,88,271,15,286,484,59.09%,37.81%,1
苗栗縣,泰安鄉,0463,335,124,459,27,486,666,72.97%,50.3%,1
苗栗縣,泰安鄉,0464,272,93,365,24,389,574,67.77%,47.39%,1
苗栗縣,泰安鄉,0465,129,41,170,7,177,333,53.15%,38.74%,1
苗栗縣,泰安鄉,0466,251,81,332,16,348,495,70.3%,50.71%,1
苗栗縣,泰安鄉,0467,257,129,386,15,401,544,73.71%,47.24%,1
苗栗縣,泰安鄉,0468,221,83,304,13,317,500,63.4%,44.2%,1
苗栗縣,泰安鄉,0469,350,113,463,17,480,670,71.64%,52.24%,1
苗栗縣,泰安鄉,0470,314,119,433,5,438,589,74.36%,53.31%,1
彰化縣,彰化市,0001,358,162,520,17,537,871,61.65%,41.1%,1
彰化縣,彰化市,0002,229,106,335,30,365,751,48.6%,30.49%,1
彰化縣,彰化市,0003,384,201,585,25,610,923,66.09%,41.6%,1
彰化縣,彰化市,0004,300,153,453,31,484,779,62.13%,38.51%,1
彰化縣,彰化市,0005,306,156,462,18,480,779,61.62%,39.28%,1
彰化縣,彰化市,0006,293,126,419,17,436,720,60.56%,40.69%,1
彰化縣,彰化市,0007,278,145,423,24,447,749,59.68%,37.12%,1
彰化縣,彰化市,0008,330,139,469,30,499,767,65.06%,43.02%,1
彰化縣,彰化市,0009,430,195,625,37,662,1047,63.23%,41.07%,1
彰化縣,彰化市,0010,373,188,561,27,588,1027,57.25%,36.32%,1
彰化縣,彰化市,0011,470,212,682,34,716,1249,57.33%,37.63%,1
彰化縣,彰化市,0012,458,200,658,21,679,1136,59.77%,40.32%,1
彰化縣,彰化市,0013,510,192,702,25,727,1169,62.19%,43.63%,1
彰化縣,彰化市,0014,318,155,473,16,489,766,63.84%,41.51%,1
彰化縣,彰化市,0015,282,95,377,16,393,643,61.12%,43.86%,1
彰化縣,彰化市,0016,502,211,713,32,745,1251,59.55%,40.13%,1
彰化縣,彰化市,0017,324,158,482,27,509,1301,39.12%,24.9%,1
彰化縣,彰化市,0018,501,248,749,23,772,1280,60.31%,39.14%,1
彰化縣,彰化市,0019,512,203,715,19,734,1179,62.26%,43.43%,1
彰化縣,彰化市,0020,462,210,672,17,689,1168,58.99%,39.55%,1
彰化縣,彰化市,0021,510,179,689,31,720,1218,59.11%,41.87%,1
彰化縣,彰化市,0022,581,274,855,25,880,1351,65.14%,43.01%,1
彰化縣,彰化市,0023,452,258,710,18,728,1204,60.47%,37.54%,1
彰化縣,彰化市,0024,482,223,705,14,719,1189,60.47%,40.54%,1
彰化縣,彰化市,0025,457,211,668,32,700,1207,58%,37.86%,1
彰化縣,彰化市,0026,479,187,666,31,697,1161,60.03%,41.26%,1
彰化縣,彰化市,0027,420,222,642,28,670,1166,57.46%,36.02%,1
彰化縣,彰化市,0028,544,270,814,19,833,1362,61.16%,39.94%,1
彰化縣,彰化市,0029,465,266,731,38,769,1236,62.22%,37.62%,1
彰化縣,彰化市,0030,414,194,608,30,638,1065,59.91%,38.87%,1
彰化縣,彰化市,0031,450,229,679,32,711,1199,59.3%,37.53%,1
彰化縣,彰化市,0032,464,260,724,11,735,1233,59.61%,37.63%,1
彰化縣,彰化市,0033,462,232,694,20,714,1245,57.35%,37.11%,1
彰化縣,彰化市,0034,475,222,697,22,719,1153,62.36%,41.2%,1
彰化縣,彰化市,0035,390,186,576,18,594,1045,56.84%,37.32%,1
彰化縣,彰化市,0036,418,220,638,12,650,1097,59.25%,38.1%,1
彰化縣,彰化市,0037,457,216,673,24,697,1190,58.57%,38.4%,1
彰化縣,彰化市,0038,447,233,680,13,693,1106,62.66%,40.42%,1
彰化縣,彰化市,0039,453,186,639,24,663,1097,60.44%,41.29%,1
彰化縣,彰化市,0040,402,211,613,30,643,1048,61.35%,38.36%,1
彰化縣,彰化市,0041,403,192,595,23,618,980,63.06%,41.12%,1
彰化縣,彰化市,0042,298,135,433,15,448,707,63.37%,42.15%,1
彰化縣,彰化市,0043,304,163,467,22,489,809,60.44%,37.58%,1
彰化縣,彰化市,0044,386,208,594,39,633,1008,62.8%,38.29%,1
彰化縣,彰化市,0045,328,161,489,29,518,901,57.49%,36.4%,1
彰化縣,彰化市,0046,358,171,529,22,551,951,57.94%,37.64%,1
彰化縣,彰化市,0047,407,216,623,25,648,1076,60.22%,37.83%,1
彰化縣,彰化市,0048,382,174,556,19,575,1022,56.26%,37.38%,1
彰化縣,彰化市,0049,357,170,527,23,550,894,61.52%,39.93%,1
彰化縣,彰化市,0050,400,203,603,29,632,1016,62.2%,39.37%,1
彰化縣,彰化市,0051,305,167,472,27,499,771,64.72%,39.56%,1
彰化縣,彰化市,0052,345,171,516,19,535,868,61.64%,39.75%,1
彰化縣,彰化市,0053,453,205,658,31,689,1135,60.7%,39.91%,1
彰化縣,彰化市,0054,338,182,520,43,563,910,61.87%,37.14%,1
彰化縣,彰化市,0055,406,215,621,17,638,1004,63.55%,40.44%,1
彰化縣,彰化市,0056,434,208,642,31,673,1077,62.49%,40.3%,1
彰化縣,彰化市,0057,543,250,793,34,827,1258,65.74%,43.16%,1
彰化縣,彰化市,0058,447,189,636,21,657,1025,64.1%,43.61%,1
彰化縣,彰化市,0059,495,230,725,26,751,1177,63.81%,42.06%,1
彰化縣,彰化市,0060,469,238,707,19,726,1262,57.53%,37.16%,1
彰化縣,彰化市,0061,603,110,713,42,755,1209,62.45%,49.88%,1
彰化縣,彰化市,0062,424,204,628,33,661,1041,63.5%,40.73%,1
彰化縣,彰化市,0063,472,180,652,24,676,1075,62.88%,43.91%,1
彰化縣,彰化市,0064,399,170,569,23,592,1029,57.53%,38.78%,1
彰化縣,彰化市,0065,444,212,656,48,704,1203,58.52%,36.91%,1
彰化縣,彰化市,0066,416,152,568,23,591,1014,58.28%,41.03%,1
彰化縣,彰化市,0067,438,188,626,22,648,1069,60.62%,40.97%,1
彰化縣,彰化市,0068,357,155,512,15,527,969,54.39%,36.84%,1
彰化縣,彰化市,0069,414,173,587,10,597,1105,54.03%,37.47%,1
彰化縣,彰化市,0070,430,174,604,30,634,981,64.63%,43.83%,1
彰化縣,彰化市,0071,436,230,666,34,700,1095,63.93%,39.82%,1
彰化縣,彰化市,0072,458,202,660,23,683,1087,62.83%,42.13%,1
彰化縣,彰化市,0073,391,226,617,23,640,1050,60.95%,37.24%,1
彰化縣,彰化市,0074,484,255,739,36,775,1252,61.9%,38.66%,1
彰化縣,彰化市,0075,412,202,614,20,634,1113,56.96%,37.02%,1
彰化縣,彰化市,0076,408,199,607,28,635,1009,62.93%,40.44%,1
彰化縣,彰化市,0077,383,173,556,25,581,999,58.16%,38.34%,1
彰化縣,彰化市,0078,391,183,574,15,589,997,59.08%,39.22%,1
彰化縣,彰化市,0079,467,253,720,27,747,1145,65.24%,40.79%,1
彰化縣,彰化市,0080,487,230,717,27,744,1227,60.64%,39.69%,1
彰化縣,彰化市,0081,484,247,731,23,754,1208,62.42%,40.07%,1
彰化縣,彰化市,0082,635,279,914,16,930,1598,58.2%,39.74%,1
彰化縣,彰化市,0083,366,162,528,23,551,890,61.91%,41.12%,1
彰化縣,彰化市,0084,449,225,674,34,708,1104,64.13%,40.67%,1
彰化縣,彰化市,0085,416,200,616,21,637,1097,58.07%,37.92%,1
彰化縣,彰化市,0086,326,124,450,26,476,799,59.57%,40.8%,1
彰化縣,彰化市,0087,439,164,603,28,631,1000,63.1%,43.9%,1
彰化縣,彰化市,0088,470,162,632,51,683,1153,59.24%,40.76%,1
彰化縣,彰化市,0089,403,159,562,44,606,977,62.03%,41.25%,1
彰化縣,彰化市,0090,433,237,670,30,700,1201,58.28%,36.05%,1
彰化縣,彰化市,0091,404,221,625,41,666,1057,63.01%,38.22%,1
彰化縣,彰化市,0092,470,207,677,54,731,1238,59.05%,37.96%,1
彰化縣,彰化市,0093,498,221,719,28,747,1210,61.74%,41.16%,1
彰化縣,彰化市,0094,441,166,607,32,639,1026,62.28%,42.98%,1
彰化縣,彰化市,0095,445,217,662,31,693,1061,65.32%,41.94%,1
彰化縣,彰化市,0096,462,222,684,41,725,1213,59.77%,38.09%,1
彰化縣,彰化市,0097,489,265,754,27,781,1264,61.79%,38.69%,1
彰化縣,彰化市,0098,294,156,450,16,466,691,67.44%,42.55%,1
彰化縣,彰化市,0099,361,179,540,36,576,893,64.5%,40.43%,1
彰化縣,彰化市,0100,293,131,424,36,460,733,62.76%,39.97%,1
彰化縣,彰化市,0101,294,126,420,26,446,692,64.45%,42.49%,1
彰化縣,彰化市,0102,270,146,416,27,443,728,60.85%,37.09%,1
彰化縣,彰化市,0103,340,141,481,24,505,773,65.33%,43.98%,1
彰化縣,彰化市,0104,368,152,520,13,533,975,54.67%,37.74%,1
彰化縣,彰化市,0105,383,150,533,31,564,908,62.11%,42.18%,1
彰化縣,彰化市,0106,486,198,684,13,697,1156,60.29%,42.04%,1
彰化縣,彰化市,0107,485,250,735,25,760,1235,61.54%,39.27%,1
彰化縣,彰化市,0108,527,230,757,27,784,1376,56.98%,38.3%,1
彰化縣,彰化市,0109,513,267,780,17,797,1389,57.38%,36.93%,1
彰化縣,彰化市,0110,357,167,524,35,559,846,66.08%,42.2%,1
彰化縣,彰化市,0111,393,141,534,23,557,859,64.84%,45.75%,1
彰化縣,彰化市,0112,296,175,471,14,485,781,62.1%,37.9%,1
彰化縣,彰化市,0113,341,160,501,24,525,875,60%,38.97%,1
彰化縣,彰化市,0114,321,147,468,18,486,816,59.56%,39.34%,1
彰化縣,彰化市,0115,289,127,416,26,442,687,64.34%,42.07%,1
彰化縣,彰化市,0116,318,136,454,17,471,727,64.79%,43.74%,1
彰化縣,彰化市,0117,288,132,420,13,433,662,65.41%,43.5%,1
彰化縣,彰化市,0118,279,115,394,12,406,633,64.14%,44.08%,1
彰化縣,彰化市,0119,403,166,569,24,593,906,65.45%,44.48%,1
彰化縣,彰化市,0120,340,131,471,24,495,853,58.03%,39.86%,1
彰化縣,彰化市,0121,433,198,631,19,650,1027,63.29%,42.16%,1
彰化縣,彰化市,0122,440,168,608,25,633,993,63.75%,44.31%,1
彰化縣,彰化市,0123,356,140,496,29,525,848,61.91%,41.98%,1
彰化縣,彰化市,0124,471,221,692,15,707,1118,63.24%,42.13%,1
彰化縣,彰化市,0125,505,237,742,35,777,1263,61.52%,39.98%,1
彰化縣,彰化市,0126,555,219,774,31,805,1268,63.49%,43.77%,1
彰化縣,彰化市,0127,541,200,741,29,770,1258,61.21%,43%,1
彰化縣,彰化市,0128,529,217,746,11,757,1212,62.46%,43.65%,1
彰化縣,彰化市,0129,376,161,537,36,573,924,62.01%,40.69%,1
彰化縣,彰化市,0130,395,188,583,18,601,939,64%,42.07%,1
彰化縣,彰化市,0131,421,173,594,43,637,953,66.84%,44.18%,1
彰化縣,彰化市,0132,441,189,630,19,649,981,66.16%,44.95%,1
彰化縣,彰化市,0133,529,223,752,44,796,1249,63.73%,42.35%,1
彰化縣,彰化市,0134,350,141,491,24,515,817,63.04%,42.84%,1
彰化縣,彰化市,0135,341,159,500,39,539,872,61.81%,39.11%,1
彰化縣,彰化市,0136,262,127,389,20,409,689,59.36%,38.03%,1
彰化縣,彰化市,0137,508,201,709,20,729,1156,63.06%,43.94%,1
彰化縣,彰化市,0138,487,235,722,21,743,1291,57.55%,37.72%,1
彰化縣,彰化市,0139,452,187,639,26,665,1139,58.38%,39.68%,1
彰化縣,彰化市,0140,445,221,666,28,694,1125,61.69%,39.56%,1
彰化縣,彰化市,0141,474,213,687,39,726,1258,57.71%,37.68%,1
彰化縣,彰化市,0142,458,185,643,25,668,1123,59.48%,40.78%,1
彰化縣,彰化市,0143,484,190,674,29,703,1175,59.83%,41.19%,1
彰化縣,彰化市,0144,365,186,551,20,571,862,66.24%,42.34%,1
彰化縣,彰化市,0145,336,172,508,21,529,872,60.67%,38.53%,1
彰化縣,彰化市,0146,402,164,566,15,581,897,64.77%,44.82%,1
彰化縣,彰化市,0147,387,166,553,25,578,1003,57.63%,38.58%,1
彰化縣,彰化市,0148,374,156,530,17,547,915,59.78%,40.87%,1
彰化縣,彰化市,0149,433,200,633,35,668,1158,57.69%,37.39%,1
彰化縣,彰化市,0150,450,203,653,32,685,1084,63.19%,41.51%,1
彰化縣,彰化市,0151,516,229,745,38,783,1372,57.07%,37.61%,1
彰化縣,彰化市,0152,458,172,630,35,665,1113,59.75%,41.15%,1
彰化縣,彰化市,0153,342,139,481,25,506,800,63.25%,42.75%,1
彰化縣,彰化市,0154,361,155,516,21,537,885,60.68%,40.79%,1
彰化縣,彰化市,0155,429,178,607,25,632,1000,63.2%,42.9%,1
彰化縣,彰化市,0156,426,201,627,29,656,1159,56.6%,36.76%,1
彰化縣,彰化市,0157,411,204,615,26,641,1123,57.08%,36.6%,1
彰化縣,彰化市,0158,374,180,554,47,601,907,66.26%,41.23%,1
彰化縣,彰化市,0159,376,152,528,38,566,989,57.23%,38.02%,1
彰化縣,彰化市,0160,432,165,597,43,640,1012,63.24%,42.69%,1
彰化縣,彰化市,0161,400,150,550,21,571,1033,55.28%,38.72%,1
彰化縣,彰化市,0162,458,202,660,29,689,1116,61.74%,41.04%,1
彰化縣,彰化市,0163,479,210,689,26,715,1154,61.96%,41.51%,1
彰化縣,彰化市,0164,449,191,640,23,663,1064,62.31%,42.2%,1
彰化縣,彰化市,0165,338,137,475,36,511,770,66.36%,43.9%,1
彰化縣,彰化市,0166,336,188,524,33,557,889,62.65%,37.8%,1
彰化縣,彰化市,0167,336,124,460,42,502,786,63.87%,42.75%,1
彰化縣,彰化市,0168,394,177,571,49,620,1120,55.36%,35.18%,1
彰化縣,彰化市,0169,486,182,668,29,697,1269,54.93%,38.3%,1
彰化縣,彰化市,0170,490,186,676,32,708,1159,61.09%,42.28%,1
彰化縣,彰化市,0171,466,210,676,49,725,1184,61.23%,39.36%,1
彰化縣,彰化市,0172,424,174,598,36,634,1089,58.22%,38.93%,1
彰化縣,彰化市,0173,401,169,570,35,605,968,62.5%,41.43%,1
彰化縣,彰化市,0174,376,149,525,23,548,930,58.92%,40.43%,1
彰化縣,彰化市,0175,406,180,586,21,607,973,62.38%,41.73%,1
彰化縣,彰化市,0176,389,255,644,14,658,1184,55.57%,32.85%,1
彰化縣,彰化市,0177,416,170,586,38,624,1002,62.28%,41.52%,1
彰化縣,彰化市,0178,448,178,626,21,647,1148,56.36%,39.02%,1
彰化縣,彰化市,0179,437,183,620,26,646,1112,58.09%,39.3%,1
彰化縣,彰化市,0180,418,170,588,38,626,907,69.02%,46.09%,1
彰化縣,彰化市,0181,438,194,632,45,677,1112,60.88%,39.39%,1
彰化縣,彰化市,0182,290,133,423,31,454,823,55.16%,35.24%,1
彰化縣,彰化市,0183,478,228,706,52,758,1276,59.4%,37.46%,1
彰化縣,彰化市,0184,477,171,648,22,670,1161,57.71%,41.09%,1
彰化縣,鹿港鎮,0243,364,323,687,31,718,1140,62.98%,31.93%,1
彰化縣,鹿港鎮,0244,184,102,286,20,306,511,59.88%,36.01%,1
彰化縣,鹿港鎮,0245,292,132,424,15,439,857,51.23%,34.07%,1
彰化縣,鹿港鎮,0246,411,163,574,36,610,946,64.48%,43.45%,1
彰化縣,鹿港鎮,0247,339,195,534,31,565,945,59.79%,35.87%,1
彰化縣,鹿港鎮,0248,446,185,631,27,658,1097,59.98%,40.66%,1
彰化縣,鹿港鎮,0249,479,239,718,23,741,1479,50.1%,32.39%,1
彰化縣,鹿港鎮,0250,571,252,823,35,858,1425,60.21%,40.07%,1
彰化縣,鹿港鎮,0251,330,166,496,58,554,880,62.95%,37.5%,1
彰化縣,鹿港鎮,0252,445,187,632,43,675,1183,57.06%,37.62%,1
彰化縣,鹿港鎮,0253,412,186,598,48,646,1047,61.7%,39.35%,1
彰化縣,鹿港鎮,0254,425,177,602,26,628,1097,57.25%,38.74%,1
彰化縣,鹿港鎮,0255,401,149,550,43,593,1030,57.57%,38.93%,1
彰化縣,鹿港鎮,0256,441,200,641,35,676,1161,58.23%,37.98%,1
彰化縣,鹿港鎮,0257,248,58,306,38,344,540,63.7%,45.93%,1
彰化縣,鹿港鎮,0258,410,201,611,32,643,1135,56.65%,36.12%,1
彰化縣,鹿港鎮,0259,460,165,625,46,671,1155,58.1%,39.83%,1
彰化縣,鹿港鎮,0260,453,215,668,31,699,1127,62.02%,40.2%,1
彰化縣,鹿港鎮,0261,410,182,592,34,626,1045,59.9%,39.23%,1
彰化縣,鹿港鎮,0262,431,186,617,49,666,1127,59.09%,38.24%,1
彰化縣,鹿港鎮,0263,561,169,730,35,765,1178,64.94%,47.62%,1
彰化縣,鹿港鎮,0264,112,52,164,5,169,284,59.51%,39.44%,1
彰化縣,鹿港鎮,0265,227,103,330,20,350,584,59.93%,38.87%,1
彰化縣,鹿港鎮,0266,302,112,414,22,436,659,66.16%,45.83%,1
彰化縣,鹿港鎮,0267,363,172,535,20,555,915,60.66%,39.67%,1
彰化縣,鹿港鎮,0268,463,192,655,28,683,1079,63.3%,42.91%,1
彰化縣,鹿港鎮,0269,482,212,694,39,733,1129,64.92%,42.69%,1
彰化縣,鹿港鎮,0270,475,198,673,35,708,1273,55.62%,37.31%,1
彰化縣,鹿港鎮,0271,253,99,352,29,381,706,53.97%,35.84%,1
彰化縣,鹿港鎮,0272,370,190,560,73,633,1137,55.67%,32.54%,1
彰化縣,鹿港鎮,0273,429,205,634,29,663,1195,55.48%,35.9%,1
彰化縣,鹿港鎮,0274,457,165,622,41,663,1225,54.12%,37.31%,1
彰化縣,鹿港鎮,0275,417,177,594,36,630,957,65.83%,43.57%,1
彰化縣,鹿港鎮,0276,278,92,370,43,413,758,54.49%,36.68%,1
彰化縣,鹿港鎮,0277,286,117,403,38,441,723,61%,39.56%,1
彰化縣,鹿港鎮,0278,372,161,533,23,556,984,56.5%,37.8%,1
彰化縣,鹿港鎮,0279,459,153,612,36,648,1018,63.65%,45.09%,1
彰化縣,鹿港鎮,0280,430,185,615,31,646,1165,55.45%,36.91%,1
彰化縣,鹿港鎮,0281,501,74,575,40,615,1161,52.97%,43.15%,1
彰化縣,鹿港鎮,0282,362,172,534,31,565,1020,55.39%,35.49%,1
彰化縣,鹿港鎮,0283,425,145,570,45,615,1068,57.58%,39.79%,1
彰化縣,鹿港鎮,0284,476,150,626,36,662,1024,64.65%,46.48%,1
彰化縣,鹿港鎮,0285,399,152,551,57,608,974,62.42%,40.97%,1
彰化縣,鹿港鎮,0286,524,238,762,58,820,1505,54.49%,34.82%,1
彰化縣,鹿港鎮,0287,375,202,577,30,607,1092,55.59%,34.34%,1
彰化縣,鹿港鎮,0288,478,207,685,57,742,1223,60.67%,39.08%,1
彰化縣,鹿港鎮,0289,550,207,757,21,778,1572,49.49%,34.99%,1
彰化縣,鹿港鎮,0290,420,162,582,40,622,1003,62.01%,41.87%,1
彰化縣,鹿港鎮,0291,389,147,536,27,563,933,60.34%,41.69%,1
彰化縣,鹿港鎮,0292,444,170,614,49,663,1093,60.66%,40.62%,1
彰化縣,鹿港鎮,0293,366,139,505,12,517,907,57%,40.35%,1
彰化縣,鹿港鎮,0294,442,203,645,28,673,1219,55.21%,36.26%,1
彰化縣,鹿港鎮,0295,615,242,857,43,900,1397,64.42%,44.02%,1
彰化縣,鹿港鎮,0296,186,492,678,27,705,1229,57.36%,15.13%,1
彰化縣,鹿港鎮,0297,579,193,772,25,797,1444,55.19%,40.1%,1
彰化縣,鹿港鎮,0298,489,203,692,42,734,1227,59.82%,39.85%,1
彰化縣,鹿港鎮,0299,448,228,676,40,716,1187,60.32%,37.74%,1
彰化縣,鹿港鎮,0300,506,190,696,18,714,1296,55.09%,39.04%,1
彰化縣,鹿港鎮,0301,482,229,711,43,754,1451,51.96%,33.22%,1
彰化縣,鹿港鎮,0302,457,225,682,48,730,1299,56.2%,35.18%,1
彰化縣,鹿港鎮,0303,550,225,775,30,805,1298,62.02%,42.37%,1
彰化縣,鹿港鎮,0304,569,242,811,32,843,1458,57.82%,39.03%,1
彰化縣,鹿港鎮,0305,459,201,660,33,693,1138,60.9%,40.33%,1
彰化縣,鹿港鎮,0306,456,186,642,30,672,1170,57.44%,38.97%,1
彰化縣,鹿港鎮,0307,515,198,713,34,747,1221,61.18%,42.18%,1
彰化縣,和美鎮,0373,475,235,710,32,742,1341,55.33%,35.42%,1
彰化縣,和美鎮,0374,507,227,734,38,772,1480,52.16%,34.26%,1
彰化縣,和美鎮,0375,562,267,829,35,864,1529,56.51%,36.76%,1
彰化縣,和美鎮,0376,605,257,862,18,880,1711,51.43%,35.36%,1
彰化縣,和美鎮,0377,388,206,594,24,618,1057,58.47%,36.71%,1
彰化縣,和美鎮,0378,370,216,586,29,615,1032,59.59%,35.85%,1
彰化縣,和美鎮,0379,404,195,599,24,623,1015,61.38%,39.8%,1
彰化縣,和美鎮,0380,487,220,707,26,733,1209,60.63%,40.28%,1
彰化縣,和美鎮,0381,149,95,244,8,252,430,58.6%,34.65%,1
彰化縣,和美鎮,0382,299,166,465,18,483,856,56.43%,34.93%,1
彰化縣,和美鎮,0383,404,155,559,22,581,966,60.14%,41.82%,1
彰化縣,和美鎮,0384,381,183,564,20,584,1059,55.15%,35.98%,1
彰化縣,和美鎮,0385,416,206,622,27,649,1117,58.1%,37.24%,1
彰化縣,和美鎮,0386,380,185,565,28,593,1066,55.63%,35.65%,1
彰化縣,和美鎮,0387,443,208,651,33,684,1252,54.63%,35.38%,1
彰化縣,和美鎮,0388,535,242,777,29,806,1528,52.75%,35.01%,1
彰化縣,和美鎮,0389,250,217,467,26,493,826,59.69%,30.27%,1
彰化縣,和美鎮,0390,324,140,464,22,486,854,56.91%,37.94%,1
彰化縣,和美鎮,0391,470,237,707,35,742,1387,53.5%,33.89%,1
彰化縣,和美鎮,0392,342,125,467,16,483,765,63.14%,44.71%,1
彰化縣,和美鎮,0393,526,190,716,37,753,1438,52.36%,36.58%,1
彰化縣,和美鎮,0394,553,232,785,46,831,1396,59.53%,39.61%,1
彰化縣,和美鎮,0395,257,111,368,16,384,658,58.36%,39.06%,1
彰化縣,和美鎮,0396,349,148,497,19,516,809,63.78%,43.14%,1
彰化縣,和美鎮,0397,373,136,509,8,517,932,55.47%,40.02%,1
彰化縣,和美鎮,0398,340,129,469,20,489,888,55.07%,38.29%,1
彰化縣,和美鎮,0399,473,192,665,31,696,1144,60.84%,41.35%,1
彰化縣,和美鎮,0400,404,174,578,34,612,1077,56.82%,37.51%,1
彰化縣,和美鎮,0401,440,227,667,46,713,1349,52.85%,32.62%,1
彰化縣,和美鎮,0402,474,225,699,25,724,1155,62.68%,41.04%,1
彰化縣,和美鎮,0403,464,209,673,25,698,1253,55.71%,37.03%,1
彰化縣,和美鎮,0404,487,184,671,22,693,1252,55.35%,38.9%,1
彰化縣,和美鎮,0405,513,259,772,27,799,1474,54.21%,34.8%,1
彰化縣,和美鎮,0406,470,224,694,27,721,1396,51.65%,33.67%,1
彰化縣,和美鎮,0407,483,229,712,23,735,1348,54.53%,35.83%,1
彰化縣,和美鎮,0408,459,141,600,21,621,999,62.16%,45.95%,1
彰化縣,和美鎮,0409,353,171,524,26,550,911,60.37%,38.75%,1
彰化縣,和美鎮,0410,410,175,585,13,598,1005,59.5%,40.8%,1
彰化縣,和美鎮,0411,383,153,536,28,564,967,58.32%,39.61%,1
彰化縣,和美鎮,0412,526,220,746,22,768,1308,58.72%,40.21%,1
彰化縣,和美鎮,0413,501,219,720,30,750,1324,56.65%,37.84%,1
彰化縣,和美鎮,0414,408,207,615,44,659,1102,59.8%,37.02%,1
彰化縣,和美鎮,0415,410,186,596,30,626,1124,55.69%,36.48%,1
彰化縣,和美鎮,0416,460,196,656,46,702,1211,57.97%,37.99%,1
彰化縣,和美鎮,0417,409,156,565,35,600,884,67.87%,46.27%,1
彰化縣,和美鎮,0418,414,188,602,48,650,1119,58.09%,37%,1
彰化縣,和美鎮,0419,473,239,712,31,743,1300,57.15%,36.38%,1
彰化縣,和美鎮,0420,382,194,576,30,606,1104,54.89%,34.6%,1
彰化縣,和美鎮,0421,496,207,703,42,745,1213,61.42%,40.89%,1
彰化縣,和美鎮,0422,380,179,559,24,583,1127,51.73%,33.72%,1
彰化縣,和美鎮,0423,340,162,502,25,527,919,57.34%,37%,1
彰化縣,和美鎮,0424,384,176,560,35,595,987,60.28%,38.91%,1
彰化縣,和美鎮,0425,389,170,559,35,594,958,62%,40.61%,1
彰化縣,和美鎮,0426,543,222,765,28,793,1362,58.22%,39.87%,1
彰化縣,和美鎮,0427,541,247,788,25,813,1461,55.65%,37.03%,1
彰化縣,和美鎮,0428,546,257,803,23,826,1405,58.79%,38.86%,1
彰化縣,和美鎮,0429,333,160,493,28,521,860,60.58%,38.72%,1
彰化縣,和美鎮,0430,351,118,469,21,490,875,56%,40.11%,1
彰化縣,和美鎮,0431,323,156,479,30,509,871,58.44%,37.08%,1
彰化縣,和美鎮,0432,340,175,515,36,551,883,62.4%,38.51%,1
彰化縣,和美鎮,0433,421,223,644,45,689,1224,56.29%,34.4%,1
彰化縣,和美鎮,0434,379,192,571,31,602,1075,56%,35.26%,1
彰化縣,和美鎮,0435,333,180,513,28,541,956,56.59%,34.83%,1
彰化縣,和美鎮,0436,367,177,544,42,586,1037,56.51%,35.39%,1
彰化縣,和美鎮,0437,394,160,554,21,575,1011,56.87%,38.97%,1
彰化縣,和美鎮,0438,346,204,550,39,589,1023,57.58%,33.82%,1
彰化縣,和美鎮,0439,255,111,366,27,393,719,54.66%,35.47%,1
彰化縣,和美鎮,0440,325,161,486,32,518,913,56.74%,35.6%,1
彰化縣,線西鄉,0469,427,187,614,15,629,1071,58.73%,39.87%,1
彰化縣,線西鄉,0470,470,202,672,27,699,1166,59.95%,40.31%,1
彰化縣,線西鄉,0471,486,197,683,72,755,1269,59.5%,38.3%,1
彰化縣,線西鄉,0472,432,179,611,39,650,1138,57.12%,37.96%,1
彰化縣,線西鄉,0473,464,195,659,64,723,1128,64.1%,41.13%,1
彰化縣,線西鄉,0474,468,242,710,63,773,1275,60.63%,36.71%,1
彰化縣,線西鄉,0475,449,213,662,47,709,1187,59.73%,37.83%,1
彰化縣,線西鄉,0476,405,160,565,39,604,991,60.95%,40.87%,1
彰化縣,線西鄉,0477,362,156,518,48,566,938,60.34%,38.59%,1
彰化縣,線西鄉,0478,451,182,633,48,681,1276,53.37%,35.34%,1
彰化縣,線西鄉,0479,487,224,711,50,761,1285,59.22%,37.9%,1
彰化縣,線西鄉,0480,601,226,827,51,878,1341,65.47%,44.82%,1
彰化縣,伸港鄉,0441,386,184,570,37,607,1182,51.35%,32.66%,1
彰化縣,伸港鄉,0442,485,201,686,34,720,1166,61.75%,41.6%,1
彰化縣,伸港鄉,0443,369,160,529,29,558,966,57.76%,38.2%,1
彰化縣,伸港鄉,0444,323,143,466,27,493,873,56.47%,37%,1
彰化縣,伸港鄉,0445,320,140,460,30,490,812,60.34%,39.41%,1
彰化縣,伸港鄉,0446,308,156,464,28,492,875,56.23%,35.2%,1
彰化縣,伸港鄉,0447,312,161,473,38,511,904,56.53%,34.51%,1
彰化縣,伸港鄉,0448,360,165,525,35,560,1008,55.56%,35.71%,1
彰化縣,伸港鄉,0449,450,193,643,38,681,1154,59.01%,38.99%,1
彰化縣,伸港鄉,0450,483,235,718,65,783,1486,52.69%,32.5%,1
彰化縣,伸港鄉,0451,410,160,570,40,610,1095,55.71%,37.44%,1
彰化縣,伸港鄉,0452,367,174,541,17,558,1087,51.33%,33.76%,1
彰化縣,伸港鄉,0453,404,187,591,55,646,1085,59.54%,37.24%,1
彰化縣,伸港鄉,0454,364,148,512,31,543,908,59.8%,40.09%,1
彰化縣,伸港鄉,0455,529,201,730,12,742,1264,58.7%,41.85%,1
彰化縣,伸港鄉,0456,317,123,440,38,478,854,55.97%,37.12%,1
彰化縣,伸港鄉,0457,276,129,405,25,430,846,50.83%,32.62%,1
彰化縣,伸港鄉,0458,325,198,523,88,611,1143,53.46%,28.43%,1
彰化縣,伸港鄉,0459,496,236,732,28,760,1357,56.01%,36.55%,1
彰化縣,伸港鄉,0460,449,249,698,40,738,1349,54.71%,33.28%,1
彰化縣,伸港鄉,0461,431,196,627,49,676,1154,58.58%,37.35%,1
彰化縣,伸港鄉,0462,431,237,668,29,697,1279,54.5%,33.7%,1
彰化縣,伸港鄉,0463,502,233,735,43,778,1317,59.07%,38.12%,1
彰化縣,伸港鄉,0464,396,180,576,31,607,990,61.31%,40%,1
彰化縣,伸港鄉,0465,324,162,486,20,506,852,59.39%,38.03%,1
彰化縣,伸港鄉,0466,450,209,659,17,676,1178,57.39%,38.2%,1
彰化縣,伸港鄉,0467,386,173,559,59,618,1088,56.8%,35.48%,1
彰化縣,伸港鄉,0468,406,199,605,45,650,1135,57.27%,35.77%,1
彰化縣,福興鄉,0308,421,271,692,44,736,1363,54%,30.89%,1
彰化縣,福興鄉,0309,322,131,453,19,472,821,57.49%,39.22%,1
彰化縣,福興鄉,0310,436,180,616,51,667,1256,53.11%,34.71%,1
彰化縣,福興鄉,0311,393,179,572,68,640,1166,54.89%,33.7%,1
彰化縣,福興鄉,0312,518,204,722,45,767,1464,52.39%,35.38%,1
彰化縣,福興鄉,0313,415,206,621,39,660,1251,52.76%,33.17%,1
彰化縣,福興鄉,0314,501,231,732,44,776,1465,52.97%,34.2%,1
彰化縣,福興鄉,0315,323,129,452,23,475,960,49.48%,33.65%,1
彰化縣,福興鄉,0316,458,213,671,47,718,1323,54.27%,34.62%,1
彰化縣,福興鄉,0317,491,218,709,43,752,1365,55.09%,35.97%,1
彰化縣,福興鄉,0318,454,190,644,35,679,1458,46.57%,31.14%,1
彰化縣,福興鄉,0319,544,218,762,43,805,1492,53.95%,36.46%,1
彰化縣,福興鄉,0320,333,131,464,28,492,888,55.41%,37.5%,1
彰化縣,福興鄉,0321,435,163,598,27,625,1054,59.3%,41.27%,1
彰化縣,福興鄉,0322,366,120,486,37,523,1043,50.14%,35.09%,1
彰化縣,福興鄉,0323,492,198,690,52,742,1340,55.37%,36.72%,1
彰化縣,福興鄉,0324,356,184,540,35,575,1085,53%,32.81%,1
彰化縣,福興鄉,0325,496,212,708,28,736,1392,52.87%,35.63%,1
彰化縣,福興鄉,0326,529,194,723,52,775,1316,58.89%,40.2%,1
彰化縣,福興鄉,0327,522,210,732,29,761,1255,60.64%,41.59%,1
彰化縣,福興鄉,0328,468,183,651,25,676,1101,61.4%,42.51%,1
彰化縣,福興鄉,0329,456,146,602,56,658,1167,56.38%,39.07%,1
彰化縣,福興鄉,0330,492,230,722,22,744,1393,53.41%,35.32%,1
彰化縣,福興鄉,0331,483,181,664,32,696,1216,57.24%,39.72%,1
彰化縣,福興鄉,0332,391,144,535,33,568,1063,53.43%,36.78%,1
彰化縣,福興鄉,0333,453,201,654,54,708,1306,54.21%,34.69%,1
彰化縣,福興鄉,0334,385,160,545,49,594,1287,46.15%,29.91%,1
彰化縣,福興鄉,0335,396,138,534,24,558,994,56.14%,39.84%,1
彰化縣,福興鄉,0336,509,171,680,60,740,1311,56.45%,38.83%,1
彰化縣,福興鄉,0337,392,138,530,28,558,926,60.26%,42.33%,1
彰化縣,福興鄉,0338,325,163,488,28,516,995,51.86%,32.66%,1
彰化縣,福興鄉,0339,443,176,619,55,674,1079,62.47%,41.06%,1
彰化縣,福興鄉,0340,432,126,558,48,606,1150,52.7%,37.57%,1
彰化縣,秀水鄉,0341,435,169,604,60,664,1066,62.29%,40.81%,1
彰化縣,秀水鄉,0342,259,107,366,31,397,620,64.03%,41.77%,1
彰化縣,秀水鄉,0343,293,146,439,19,458,876,52.28%,33.45%,1
彰化縣,秀水鄉,0344,485,221,706,29,735,1196,61.45%,40.55%,1
彰化縣,秀水鄉,0345,539,213,752,37,789,1369,57.63%,39.37%,1
彰化縣,秀水鄉,0346,508,210,718,39,757,1273,59.47%,39.91%,1
彰化縣,秀水鄉,0347,545,221,766,40,806,1433,56.25%,38.03%,1
彰化縣,秀水鄉,0348,375,176,551,23,574,967,59.36%,38.78%,1
彰化縣,秀水鄉,0349,376,162,538,15,553,921,60.04%,40.83%,1
彰化縣,秀水鄉,0350,298,118,416,19,435,689,63.13%,43.25%,1
彰化縣,秀水鄉,0351,263,122,385,36,421,688,61.19%,38.23%,1
彰化縣,秀水鄉,0352,494,249,743,38,781,1252,62.38%,39.46%,1
彰化縣,秀水鄉,0353,464,212,676,43,719,1281,56.13%,36.22%,1
彰化縣,秀水鄉,0354,283,127,410,19,429,754,56.9%,37.53%,1
彰化縣,秀水鄉,0355,379,174,553,33,586,1024,57.23%,37.01%,1
彰化縣,秀水鄉,0356,535,230,765,25,790,1433,55.13%,37.33%,1
彰化縣,秀水鄉,0357,562,272,834,46,880,1366,64.42%,41.14%,1
彰化縣,秀水鄉,0358,343,163,506,40,546,895,61.01%,38.32%,1
彰化縣,秀水鄉,0359,439,255,694,44,738,1386,53.25%,31.67%,1
彰化縣,秀水鄉,0360,352,138,490,54,544,896,60.71%,39.29%,1
彰化縣,秀水鄉,0361,349,149,498,39,537,804,66.79%,43.41%,1
彰化縣,秀水鄉,0362,360,145,505,19,524,827,63.36%,43.53%,1
彰化縣,秀水鄉,0363,389,172,561,32,593,996,59.54%,39.06%,1
彰化縣,秀水鄉,0364,381,197,578,41,619,931,66.49%,40.92%,1
彰化縣,秀水鄉,0365,261,129,390,21,411,715,57.48%,36.5%,1
彰化縣,秀水鄉,0366,517,215,732,36,768,1229,62.49%,42.07%,1
彰化縣,秀水鄉,0367,308,125,433,28,461,890,51.8%,34.61%,1
彰化縣,秀水鄉,0368,308,169,477,32,509,811,62.76%,37.98%,1
彰化縣,秀水鄉,0369,317,142,459,31,490,786,62.34%,40.33%,1
彰化縣,秀水鄉,0370,374,148,522,21,543,931,58.32%,40.17%,1
彰化縣,秀水鄉,0371,533,195,728,45,773,1265,61.11%,42.13%,1
彰化縣,秀水鄉,0372,326,111,437,28,465,824,56.43%,39.56%,1
彰化縣,花壇鄉,0185,375,150,525,29,554,901,61.49%,41.62%,1
彰化縣,花壇鄉,0186,436,200,636,25,661,1042,63.44%,41.84%,1
彰化縣,花壇鄉,0187,486,242,728,10,738,1314,56.16%,36.99%,1
彰化縣,花壇鄉,0188,360,121,481,25,506,808,62.62%,44.55%,1
彰化縣,花壇鄉,0189,399,169,568,22,590,1019,57.9%,39.16%,1
彰化縣,花壇鄉,0190,489,190,679,33,712,1144,62.24%,42.74%,1
彰化縣,花壇鄉,0191,518,173,691,57,748,1240,60.32%,41.77%,1
彰化縣,花壇鄉,0192,660,191,851,28,879,1425,61.68%,46.32%,1
彰化縣,花壇鄉,0193,494,180,674,35,709,1095,64.75%,45.11%,1
彰化縣,花壇鄉,0194,373,145,518,28,546,910,60%,40.99%,1
彰化縣,花壇鄉,0195,435,153,588,18,606,982,61.71%,44.3%,1
彰化縣,花壇鄉,0196,390,213,603,16,619,1070,57.85%,36.45%,1
彰化縣,花壇鄉,0197,248,139,387,17,404,700,57.71%,35.43%,1
彰化縣,花壇鄉,0198,325,143,468,37,505,764,66.1%,42.54%,1
彰化縣,花壇鄉,0199,407,170,577,27,604,953,63.38%,42.71%,1
彰化縣,花壇鄉,0200,378,159,537,20,557,974,57.19%,38.81%,1
彰化縣,花壇鄉,0201,418,189,607,40,647,1111,58.24%,37.62%,1
彰化縣,花壇鄉,0202,469,161,630,45,675,1101,61.31%,42.6%,1
彰化縣,花壇鄉,0203,435,161,596,23,619,1110,55.77%,39.19%,1
彰化縣,花壇鄉,0204,475,226,701,33,734,1262,58.16%,37.64%,1
彰化縣,花壇鄉,0205,394,234,628,25,653,1103,59.2%,35.72%,1
彰化縣,花壇鄉,0206,468,209,677,34,711,1347,52.78%,34.74%,1
彰化縣,花壇鄉,0207,427,183,610,28,638,1169,54.58%,36.53%,1
彰化縣,花壇鄉,0208,532,209,741,30,771,1274,60.52%,41.76%,1
彰化縣,花壇鄉,0209,571,203,774,19,793,1280,61.95%,44.61%,1
彰化縣,花壇鄉,0210,530,175,705,25,730,1244,58.68%,42.6%,1
彰化縣,花壇鄉,0211,452,194,646,39,685,1159,59.1%,39%,1
彰化縣,花壇鄉,0212,441,193,634,23,657,1042,63.05%,42.32%,1
彰化縣,花壇鄉,0213,432,172,604,25,629,1111,56.62%,38.88%,1
彰化縣,花壇鄉,0214,387,149,536,35,571,893,63.94%,43.34%,1
彰化縣,花壇鄉,0215,390,149,539,28,567,953,59.5%,40.92%,1
彰化縣,花壇鄉,0216,364,170,534,27,561,987,56.84%,36.88%,1
彰化縣,花壇鄉,0217,414,169,583,27,610,925,65.95%,44.76%,1
彰化縣,花壇鄉,0218,410,132,542,27,569,951,59.83%,43.11%,1
彰化縣,花壇鄉,0219,370,159,529,20,549,955,57.49%,38.74%,1
彰化縣,花壇鄉,0220,370,148,518,24,542,895,60.56%,41.34%,1
彰化縣,花壇鄉,0221,290,115,405,20,425,711,59.77%,40.79%,1
彰化縣,芬園鄉,0222,373,141,514,24,538,958,56.16%,38.94%,1
彰化縣,芬園鄉,0223,299,119,418,39,457,794,57.56%,37.66%,1
彰化縣,芬園鄉,0224,460,220,680,67,747,1415,52.79%,32.51%,1
彰化縣,芬園鄉,0225,341,149,490,28,518,927,55.88%,36.79%,1
彰化縣,芬園鄉,0226,337,107,444,30,474,831,57.04%,40.55%,1
彰化縣,芬園鄉,0227,216,106,322,17,339,570,59.47%,37.89%,1
彰化縣,芬園鄉,0228,426,205,631,25,656,1227,53.46%,34.72%,1
彰化縣,芬園鄉,0229,463,177,640,43,683,1238,55.17%,37.4%,1
彰化縣,芬園鄉,0230,507,229,736,51,787,1362,57.78%,37.22%,1
彰化縣,芬園鄉,0231,403,141,544,45,589,989,59.56%,40.75%,1
彰化縣,芬園鄉,0232,474,161,635,35,670,1054,63.57%,44.97%,1
彰化縣,芬園鄉,0233,270,102,372,29,401,607,66.06%,44.48%,1
彰化縣,芬園鄉,0234,366,136,502,34,536,882,60.77%,41.5%,1
彰化縣,芬園鄉,0235,382,145,527,32,559,1143,48.91%,33.42%,1
彰化縣,芬園鄉,0236,230,85,315,22,337,661,50.98%,34.8%,1
彰化縣,芬園鄉,0237,312,114,426,3,429,838,51.19%,37.23%,1
彰化縣,芬園鄉,0238,276,138,414,31,445,847,52.54%,32.59%,1
彰化縣,芬園鄉,0239,388,163,551,41,592,987,59.98%,39.31%,1
彰化縣,芬園鄉,0240,410,183,593,50,643,1217,52.83%,33.69%,1
彰化縣,芬園鄉,0241,274,119,393,51,444,865,51.33%,31.68%,1
彰化縣,芬園鄉,0242,315,162,477,37,514,996,51.61%,31.63%,1
彰化縣,員林市,0481,418,133,551,16,567,1087,52.16%,38.45%,1
彰化縣,員林市,0482,480,207,687,26,713,1353,52.7%,35.48%,1
彰化縣,員林市,0483,453,212,665,37,702,1313,53.47%,34.5%,1
彰化縣,員林市,0484,421,182,603,31,634,1328,47.74%,31.7%,1
彰化縣,員林市,0485,396,183,579,21,600,1055,56.87%,37.54%,1
彰化縣,員林市,0486,354,150,504,29,533,959,55.58%,36.91%,1
彰化縣,員林市,0487,300,122,422,29,451,772,58.42%,38.86%,1
彰化縣,員林市,0488,151,325,476,34,510,831,61.37%,18.17%,1
彰化縣,員林市,0489,256,119,375,12,387,854,45.32%,29.98%,1
彰化縣,員林市,0490,382,138,520,21,541,1190,45.46%,32.1%,1
彰化縣,員林市,0491,265,116,381,20,401,726,55.23%,36.5%,1
彰化縣,員林市,0492,405,202,607,24,631,1124,56.14%,36.03%,1
彰化縣,員林市,0493,279,145,424,23,447,860,51.98%,32.44%,1
彰化縣,員林市,0494,462,194,656,29,685,1122,61.05%,41.18%,1
彰化縣,員林市,0495,421,186,607,31,638,1075,59.35%,39.16%,1
彰化縣,員林市,0496,368,151,519,31,550,993,55.39%,37.06%,1
彰化縣,員林市,0497,368,137,505,23,528,967,54.6%,38.06%,1
彰化縣,員林市,0498,379,172,551,30,581,1008,57.64%,37.6%,1
彰化縣,員林市,0499,296,135,431,27,458,804,56.97%,36.82%,1
彰化縣,員林市,0500,309,152,461,24,485,867,55.94%,35.64%,1
彰化縣,員林市,0501,332,136,468,15,483,885,54.58%,37.51%,1
彰化縣,員林市,0502,328,170,498,15,513,1097,46.76%,29.9%,1
彰化縣,員林市,0503,467,191,658,20,678,1255,54.02%,37.21%,1
彰化縣,員林市,0504,401,187,588,31,619,1063,58.23%,37.72%,1
彰化縣,員林市,0505,318,181,499,18,517,925,55.89%,34.38%,1
彰化縣,員林市,0506,393,141,534,25,559,947,59.03%,41.5%,1
彰化縣,員林市,0507,375,154,529,18,547,916,59.72%,40.94%,1
彰化縣,員林市,0508,315,155,470,11,481,862,55.8%,36.54%,1
彰化縣,員林市,0509,384,168,552,16,568,987,57.55%,38.91%,1
彰化縣,員林市,0510,412,155,567,32,599,1085,55.21%,37.97%,1
彰化縣,員林市,0511,418,197,615,19,634,1110,57.12%,37.66%,1
彰化縣,員林市,0512,389,175,564,25,589,1095,53.79%,35.53%,1
彰化縣,員林市,0513,516,242,758,27,785,1278,61.42%,40.38%,1
彰化縣,員林市,0514,439,187,626,29,655,1109,59.06%,39.59%,1
彰化縣,員林市,0515,406,166,572,33,605,1055,57.35%,38.48%,1
彰化縣,員林市,0516,329,155,484,27,511,876,58.33%,37.56%,1
彰化縣,員林市,0517,370,165,535,20,555,1115,49.78%,33.18%,1
彰化縣,員林市,0518,479,198,677,12,689,1186,58.09%,40.39%,1
彰化縣,員林市,0519,401,163,564,38,602,995,60.5%,40.3%,1
彰化縣,員林市,0520,378,148,526,16,542,999,54.25%,37.84%,1
彰化縣,員林市,0521,454,196,650,17,667,1201,55.54%,37.8%,1
彰化縣,員林市,0522,512,221,733,18,751,1342,55.96%,38.15%,1
彰化縣,員林市,0523,402,174,576,28,604,1086,55.62%,37.02%,1
彰化縣,員林市,0524,300,131,431,27,458,854,53.63%,35.13%,1
彰化縣,員林市,0525,424,156,580,26,606,1064,56.95%,39.85%,1
彰化縣,員林市,0526,359,170,529,6,535,879,60.86%,40.84%,1
彰化縣,員林市,0527,384,160,544,19,563,827,68.08%,46.43%,1
彰化縣,員林市,0528,335,148,483,7,490,867,56.52%,38.64%,1
彰化縣,員林市,0529,469,191,660,20,680,1201,56.62%,39.05%,1
彰化縣,員林市,0530,439,183,622,22,644,1106,58.23%,39.69%,1
彰化縣,員林市,0531,327,162,489,20,509,845,60.24%,38.7%,1
彰化縣,員林市,0532,337,174,511,15,526,894,58.84%,37.7%,1
彰化縣,員林市,0533,337,147,484,17,501,849,59.01%,39.69%,1
彰化縣,員林市,0534,302,148,450,23,473,747,63.32%,40.43%,1
彰化縣,員林市,0535,342,182,524,28,552,884,62.44%,38.69%,1
彰化縣,員林市,0536,313,132,445,24,469,900,52.11%,34.78%,1
彰化縣,員林市,0537,487,145,632,18,650,1040,62.5%,46.83%,1
彰化縣,員林市,0538,311,152,463,14,477,831,57.4%,37.42%,1
彰化縣,員林市,0539,244,122,366,27,393,591,66.5%,41.29%,1
彰化縣,員林市,0540,479,223,702,19,721,1330,54.21%,36.02%,1
彰化縣,員林市,0541,479,231,710,23,733,1295,56.6%,36.99%,1
彰化縣,員林市,0542,449,232,681,36,717,1283,55.88%,35%,1
彰化縣,員林市,0543,396,161,557,16,573,943,60.76%,41.99%,1
彰化縣,員林市,0544,575,255,830,34,864,1388,62.25%,41.43%,1
彰化縣,員林市,0545,450,224,674,19,693,1176,58.93%,38.27%,1
彰化縣,員林市,0546,311,135,446,7,453,867,52.25%,35.87%,1
彰化縣,員林市,0547,382,222,604,22,626,1121,55.84%,34.08%,1
彰化縣,員林市,0548,417,199,616,16,632,1190,53.11%,35.04%,1
彰化縣,員林市,0549,390,157,547,20,567,945,60%,41.27%,1
彰化縣,員林市,0550,372,156,528,21,549,906,60.6%,41.06%,1
彰化縣,員林市,0551,375,198,573,23,596,978,60.94%,38.34%,1
彰化縣,員林市,0552,370,157,527,33,560,949,59.01%,38.99%,1
彰化縣,員林市,0553,386,162,548,24,572,949,60.27%,40.67%,1
彰化縣,員林市,0554,391,162,553,20,573,1006,56.96%,38.87%,1
彰化縣,員林市,0555,328,175,503,25,528,889,59.39%,36.9%,1
彰化縣,員林市,0556,378,179,557,14,571,923,61.86%,40.95%,1
彰化縣,員林市,0557,487,236,723,29,752,1209,62.2%,40.28%,1
彰化縣,員林市,0558,433,193,626,23,649,1075,60.37%,40.28%,1
彰化縣,員林市,0559,532,265,797,26,823,1342,61.33%,39.64%,1
彰化縣,員林市,0560,421,250,671,21,692,1039,66.6%,40.52%,1
彰化縣,員林市,0561,415,161,576,57,633,1131,55.97%,36.69%,1
彰化縣,員林市,0562,448,233,681,27,708,1356,52.21%,33.04%,1
彰化縣,員林市,0563,482,251,733,41,774,1370,56.5%,35.18%,1
彰化縣,員林市,0564,384,225,609,25,634,1090,58.17%,35.23%,1
彰化縣,員林市,0565,329,190,519,15,534,821,65.04%,40.07%,1
彰化縣,員林市,0566,372,150,522,21,543,910,59.67%,40.88%,1
彰化縣,員林市,0567,460,203,663,21,684,1203,56.86%,38.24%,1
彰化縣,員林市,0568,474,276,750,24,774,1378,56.17%,34.4%,1
彰化縣,員林市,0569,523,215,738,32,770,1352,56.95%,38.68%,1
彰化縣,員林市,0570,436,206,642,19,661,1060,62.36%,41.13%,1
彰化縣,員林市,0571,481,207,688,37,725,1317,55.05%,36.52%,1
彰化縣,員林市,0572,399,192,591,26,617,1120,55.09%,35.63%,1
彰化縣,員林市,0573,390,127,517,38,555,1025,54.15%,38.05%,1
彰化縣,員林市,0574,424,168,592,36,628,1097,57.25%,38.65%,1
彰化縣,員林市,0575,331,171,502,29,531,859,61.82%,38.53%,1
彰化縣,員林市,0576,305,144,449,19,468,837,55.91%,36.44%,1
彰化縣,員林市,0577,463,197,660,25,685,1090,62.84%,42.48%,1
彰化縣,員林市,0578,401,179,580,38,618,1073,57.6%,37.37%,1
彰化縣,溪湖鎮,0640,460,195,655,25,680,1221,55.69%,37.67%,1
彰化縣,溪湖鎮,0641,258,124,382,27,409,638,64.11%,40.44%,1
彰化縣,溪湖鎮,0642,309,146,455,32,487,817,59.61%,37.82%,1
彰化縣,溪湖鎮,0643,422,141,563,23,586,968,60.54%,43.6%,1
彰化縣,溪湖鎮,0644,197,92,289,6,295,448,65.85%,43.97%,1
彰化縣,溪湖鎮,0645,434,158,592,21,613,1123,54.59%,38.65%,1
彰化縣,溪湖鎮,0646,428,197,625,36,661,1166,56.69%,36.71%,1
彰化縣,溪湖鎮,0647,431,180,611,27,638,1151,55.43%,37.45%,1
彰化縣,溪湖鎮,0648,492,207,699,22,721,1249,57.73%,39.39%,1
彰化縣,溪湖鎮,0649,471,177,648,34,682,1146,59.51%,41.1%,1
彰化縣,溪湖鎮,0650,473,169,642,53,695,1199,57.96%,39.45%,1
彰化縣,溪湖鎮,0651,337,156,493,28,521,895,58.21%,37.65%,1
彰化縣,溪湖鎮,0652,425,150,575,16,591,964,61.31%,44.09%,1
彰化縣,溪湖鎮,0653,311,164,475,26,501,851,58.87%,36.55%,1
彰化縣,溪湖鎮,0654,422,164,586,31,617,1072,57.56%,39.37%,1
彰化縣,溪湖鎮,0655,438,188,626,40,666,1113,59.84%,39.35%,1
彰化縣,溪湖鎮,0656,416,207,623,31,654,1090,60%,38.17%,1
彰化縣,溪湖鎮,0657,496,186,682,36,718,1193,60.18%,41.58%,1
彰化縣,溪湖鎮,0658,430,133,563,33,596,952,62.61%,45.17%,1
彰化縣,溪湖鎮,0659,444,195,639,41,680,1172,58.02%,37.88%,1
彰化縣,溪湖鎮,0660,371,189,560,32,592,1027,57.64%,36.12%,1
彰化縣,溪湖鎮,0661,507,215,722,24,746,1188,62.79%,42.68%,1
彰化縣,溪湖鎮,0662,492,226,718,36,754,1403,53.74%,35.07%,1
彰化縣,溪湖鎮,0663,438,236,674,49,723,1397,51.75%,31.35%,1
彰化縣,溪湖鎮,0664,601,282,883,51,934,1636,57.09%,36.74%,1
彰化縣,溪湖鎮,0665,528,101,629,44,673,1298,51.85%,40.68%,1
彰化縣,溪湖鎮,0666,482,181,663,42,705,1214,58.07%,39.7%,1
彰化縣,溪湖鎮,0667,522,228,750,26,776,1297,59.83%,40.25%,1
彰化縣,溪湖鎮,0668,411,171,582,23,605,968,62.5%,42.46%,1
彰化縣,溪湖鎮,0669,327,146,473,33,506,839,60.31%,38.97%,1
彰化縣,溪湖鎮,0670,355,154,509,41,550,907,60.64%,39.14%,1
彰化縣,溪湖鎮,0671,325,127,452,19,471,898,52.45%,36.19%,1
彰化縣,溪湖鎮,0672,296,129,425,24,449,650,69.08%,45.54%,1
彰化縣,溪湖鎮,0673,171,504,675,62,737,1279,57.62%,13.37%,1
彰化縣,溪湖鎮,0674,325,116,441,24,465,730,63.7%,44.52%,1
彰化縣,溪湖鎮,0675,550,222,772,53,825,1407,58.64%,39.09%,1
彰化縣,溪湖鎮,0676,412,183,595,45,640,1273,50.27%,32.36%,1
彰化縣,溪湖鎮,0677,351,165,516,30,546,988,55.26%,35.53%,1
彰化縣,溪湖鎮,0678,301,147,448,33,481,754,63.79%,39.92%,1
彰化縣,溪湖鎮,0679,324,157,481,46,527,1052,50.1%,30.8%,1
彰化縣,溪湖鎮,0680,400,187,587,32,619,1149,53.87%,34.81%,1
彰化縣,溪湖鎮,0681,542,267,809,68,877,1365,64.25%,39.71%,1
彰化縣,田中鎮,0742,308,134,442,39,481,854,56.32%,36.07%,1
彰化縣,田中鎮,0743,139,327,466,26,492,963,51.09%,14.43%,1
彰化縣,田中鎮,0744,31,9,40,5,45,175,25.71%,17.71%,1
彰化縣,田中鎮,0745,275,102,377,19,396,739,53.59%,37.21%,1
彰化縣,田中鎮,0746,323,109,432,15,447,826,54.12%,39.1%,1
彰化縣,田中鎮,0747,306,116,422,30,452,741,61%,41.3%,1
彰化縣,田中鎮,0748,160,70,230,9,239,506,47.23%,31.62%,1
彰化縣,田中鎮,0749,316,152,468,54,522,1001,52.15%,31.57%,1
彰化縣,田中鎮,0750,517,181,698,45,743,1281,58%,40.36%,1
彰化縣,田中鎮,0751,404,168,572,26,598,1035,57.78%,39.03%,1
彰化縣,田中鎮,0752,529,219,748,33,781,1327,58.85%,39.86%,1
彰化縣,田中鎮,0753,366,136,502,21,523,844,61.97%,43.36%,1
彰化縣,田中鎮,0754,357,146,503,25,528,913,57.83%,39.1%,1
彰化縣,田中鎮,0755,282,98,380,26,406,613,66.23%,46%,1
彰化縣,田中鎮,0756,552,219,771,52,823,1382,59.55%,39.94%,1
彰化縣,田中鎮,0757,454,181,635,37,672,1034,64.99%,43.91%,1
彰化縣,田中鎮,0758,433,162,595,22,617,935,65.99%,46.31%,1
彰化縣,田中鎮,0759,501,209,710,37,747,1301,57.42%,38.51%,1
彰化縣,田中鎮,0760,463,177,640,22,662,1100,60.18%,42.09%,1
彰化縣,田中鎮,0761,430,187,617,36,653,1071,60.97%,40.15%,1
彰化縣,田中鎮,0762,520,167,687,35,722,1163,62.08%,44.71%,1
彰化縣,田中鎮,0763,369,138,507,28,535,809,66.13%,45.61%,1
彰化縣,田中鎮,0764,475,213,688,28,716,1155,61.99%,41.13%,1
彰化縣,田中鎮,0765,477,205,682,49,731,1270,57.56%,37.56%,1
彰化縣,田中鎮,0766,310,150,460,30,490,870,56.32%,35.63%,1
彰化縣,田中鎮,0767,274,117,391,38,429,736,58.29%,37.23%,1
彰化縣,田中鎮,0768,478,189,667,34,701,1335,52.51%,35.81%,1
彰化縣,田中鎮,0769,312,162,474,28,502,876,57.31%,35.62%,1
彰化縣,田中鎮,0770,295,167,462,35,497,898,55.35%,32.85%,1
彰化縣,田中鎮,0771,525,217,742,19,761,1298,58.63%,40.45%,1
彰化縣,田中鎮,0772,536,243,779,40,819,1451,56.44%,36.94%,1
彰化縣,田中鎮,0773,550,256,806,34,840,1475,56.95%,37.29%,1
彰化縣,田中鎮,0774,252,112,364,37,401,766,52.35%,32.9%,1
彰化縣,田中鎮,0775,321,104,425,19,444,810,54.81%,39.63%,1
彰化縣,田中鎮,0776,322,208,530,43,573,953,60.13%,33.79%,1
彰化縣,田中鎮,0777,375,142,517,40,557,885,62.94%,42.37%,1
彰化縣,大村鄉,0579,581,274,855,52,907,1426,63.6%,40.74%,1
彰化縣,大村鄉,0580,697,315,1012,48,1060,1726,61.41%,40.38%,1
彰化縣,大村鄉,0581,340,136,476,35,511,797,64.12%,42.66%,1
彰化縣,大村鄉,0582,296,126,422,24,446,745,59.87%,39.73%,1
彰化縣,大村鄉,0583,483,143,626,59,685,1125,60.89%,42.93%,1
彰化縣,大村鄉,0584,548,260,808,56,864,1486,58.14%,36.88%,1
彰化縣,大村鄉,0585,534,242,776,58,834,1426,58.49%,37.45%,1
彰化縣,大村鄉,0586,345,145,490,34,524,824,63.59%,41.87%,1
彰化縣,大村鄉,0587,407,185,592,32,624,1177,53.02%,34.58%,1
彰化縣,大村鄉,0588,560,273,833,49,882,1478,59.68%,37.89%,1
彰化縣,大村鄉,0589,276,132,408,16,424,779,54.43%,35.43%,1
彰化縣,大村鄉,0590,321,152,473,35,508,812,62.56%,39.53%,1
彰化縣,大村鄉,0591,419,185,604,43,647,1161,55.73%,36.09%,1
彰化縣,大村鄉,0592,441,197,638,29,667,1238,53.88%,35.62%,1
彰化縣,大村鄉,0593,484,201,685,43,728,1259,57.82%,38.44%,1
彰化縣,大村鄉,0594,521,250,771,50,821,1412,58.14%,36.9%,1
彰化縣,大村鄉,0595,530,249,779,24,803,1401,57.32%,37.83%,1
彰化縣,大村鄉,0596,537,252,789,54,843,1395,60.43%,38.49%,1
彰化縣,大村鄉,0597,374,189,563,35,598,996,60.04%,37.55%,1
彰化縣,大村鄉,0598,402,177,579,34,613,1047,58.55%,38.4%,1
彰化縣,大村鄉,0599,398,154,552,32,584,985,59.29%,40.41%,1
彰化縣,大村鄉,0600,431,187,618,42,660,1054,62.62%,40.89%,1
彰化縣,大村鄉,0601,491,189,680,31,711,1200,59.25%,40.92%,1
彰化縣,大村鄉,0602,383,186,569,49,618,1003,61.62%,38.19%,1
彰化縣,大村鄉,0603,353,187,540,35,575,1046,54.97%,33.75%,1
彰化縣,大村鄉,0604,455,222,677,38,715,1189,60.13%,38.27%,1
彰化縣,大村鄉,0605,484,196,680,32,712,1305,54.56%,37.09%,1
彰化縣,埔鹽鄉,0682,417,147,564,31,595,958,62.11%,43.53%,1
彰化縣,埔鹽鄉,0683,341,125,466,23,489,754,64.85%,45.23%,1
彰化縣,埔鹽鄉,0684,318,159,477,25,502,757,66.31%,42.01%,1
彰化縣,埔鹽鄉,0685,323,149,472,33,505,806,62.66%,40.07%,1
彰化縣,埔鹽鄉,0686,554,173,727,37,764,1280,59.69%,43.28%,1
彰化縣,埔鹽鄉,0687,357,156,513,39,552,928,59.48%,38.47%,1
彰化縣,埔鹽鄉,0688,391,162,553,40,593,895,66.26%,43.69%,1
彰化縣,埔鹽鄉,0689,350,132,482,41,523,815,64.17%,42.94%,1
彰化縣,埔鹽鄉,0690,356,172,528,32,560,957,58.52%,37.2%,1
彰化縣,埔鹽鄉,0691,538,191,729,67,796,1338,59.49%,40.21%,1
彰化縣,埔鹽鄉,0692,404,179,583,55,638,1106,57.69%,36.53%,1
彰化縣,埔鹽鄉,0693,333,127,460,20,480,690,69.57%,48.26%,1
彰化縣,埔鹽鄉,0694,471,192,663,41,704,1230,57.24%,38.29%,1
彰化縣,埔鹽鄉,0695,322,158,480,27,507,847,59.86%,38.02%,1
彰化縣,埔鹽鄉,0696,428,115,543,19,562,897,62.65%,47.71%,1
彰化縣,埔鹽鄉,0697,336,154,490,41,531,882,60.2%,38.1%,1
彰化縣,埔鹽鄉,0698,505,173,678,39,717,1180,60.76%,42.8%,1
彰化縣,埔鹽鄉,0699,462,191,653,53,706,1215,58.11%,38.02%,1
彰化縣,埔鹽鄉,0700,196,66,262,20,282,422,66.82%,46.45%,1
彰化縣,埔鹽鄉,0701,440,132,572,46,618,1106,55.88%,39.78%,1
彰化縣,埔鹽鄉,0702,395,115,510,52,562,874,64.3%,45.19%,1
彰化縣,埔鹽鄉,0703,510,236,746,112,858,1445,59.38%,35.29%,1
彰化縣,埔鹽鄉,0704,354,147,501,48,549,875,62.74%,40.46%,1
彰化縣,埔鹽鄉,0705,298,114,412,35,447,837,53.41%,35.6%,1
彰化縣,埔鹽鄉,0706,294,88,382,31,413,685,60.29%,42.92%,1
彰化縣,埔鹽鄉,0707,306,136,442,31,473,733,64.53%,41.75%,1
彰化縣,埔鹽鄉,0708,340,122,462,40,502,798,62.91%,42.61%,1
彰化縣,埔鹽鄉,0709,548,187,735,60,795,1381,57.57%,39.68%,1
彰化縣,埔鹽鄉,0710,497,181,678,42,720,1335,53.93%,37.23%,1
彰化縣,埔心鄉,0711,452,210,662,51,713,1139,62.6%,39.68%,1
彰化縣,埔心鄉,0712,466,208,674,43,717,1217,58.92%,38.29%,1
彰化縣,埔心鄉,0713,493,260,753,20,773,1248,61.94%,39.5%,1
彰化縣,埔心鄉,0714,502,246,748,59,807,1248,64.66%,40.22%,1
彰化縣,埔心鄉,0715,383,153,536,30,566,916,61.79%,41.81%,1
彰化縣,埔心鄉,0716,252,134,386,23,409,625,65.44%,40.32%,1
彰化縣,埔心鄉,0717,454,224,678,57,735,1271,57.83%,35.72%,1
彰化縣,埔心鄉,0718,287,89,376,20,396,608,65.13%,47.2%,1
彰化縣,埔心鄉,0719,478,167,645,56,701,1132,61.93%,42.23%,1
彰化縣,埔心鄉,0720,428,169,597,44,641,1027,62.41%,41.67%,1
彰化縣,埔心鄉,0721,382,172,554,36,590,926,63.71%,41.25%,1
彰化縣,埔心鄉,0722,300,140,440,42,482,778,61.95%,38.56%,1
彰化縣,埔心鄉,0723,295,115,410,23,433,660,65.61%,44.7%,1
彰化縣,埔心鄉,0724,539,234,773,43,816,1330,61.35%,40.53%,1
彰化縣,埔心鄉,0725,381,208,589,19,608,991,61.35%,38.45%,1
彰化縣,埔心鄉,0726,408,177,585,27,612,985,62.13%,41.42%,1
彰化縣,埔心鄉,0727,366,193,559,36,595,1034,57.54%,35.4%,1
彰化縣,埔心鄉,0728,253,110,363,37,400,612,65.36%,41.34%,1
彰化縣,埔心鄉,0729,517,228,745,44,789,1236,63.83%,41.83%,1
彰化縣,埔心鄉,0730,337,125,462,32,494,775,63.74%,43.48%,1
彰化縣,埔心鄉,0731,316,157,473,25,498,738,67.48%,42.82%,1
彰化縣,埔心鄉,0732,407,203,610,29,639,1036,61.68%,39.29%,1
彰化縣,埔心鄉,0733,341,187,528,38,566,975,58.05%,34.97%,1
彰化縣,埔心鄉,0734,341,147,488,36,524,885,59.21%,38.53%,1
彰化縣,埔心鄉,0735,372,180,552,41,593,939,63.15%,39.62%,1
彰化縣,埔心鄉,0736,299,97,396,23,419,689,60.81%,43.4%,1
彰化縣,埔心鄉,0737,271,101,372,28,400,659,60.7%,41.12%,1
彰化縣,埔心鄉,0738,337,146,483,30,513,910,56.37%,37.03%,1
彰化縣,埔心鄉,0739,581,264,845,48,893,1352,66.05%,42.97%,1
彰化縣,埔心鄉,0740,286,138,424,20,444,759,58.5%,37.68%,1
彰化縣,埔心鄉,0741,356,165,521,47,568,942,60.3%,37.79%,1
彰化縣,永靖鄉,0606,438,183,621,44,665,1255,52.99%,34.9%,1
彰化縣,永靖鄉,0607,352,153,505,42,547,889,61.53%,39.6%,1
彰化縣,永靖鄉,0608,376,183,559,23,582,1026,56.73%,36.65%,1
彰化縣,永靖鄉,0609,303,116,419,33,452,724,62.43%,41.85%,1
彰化縣,永靖鄉,0610,349,165,514,37,551,924,59.63%,37.77%,1
彰化縣,永靖鄉,0611,271,121,392,26,418,659,63.43%,41.12%,1
彰化縣,永靖鄉,0612,260,144,404,30,434,734,59.13%,35.42%,1
彰化縣,永靖鄉,0613,238,119,357,18,375,758,49.47%,31.4%,1
彰化縣,永靖鄉,0614,366,150,516,35,551,848,64.98%,43.16%,1
彰化縣,永靖鄉,0615,480,219,699,54,753,1404,53.63%,34.19%,1
彰化縣,永靖鄉,0616,355,167,522,28,550,792,69.44%,44.82%,1
彰化縣,永靖鄉,0617,275,152,427,23,450,695,64.75%,39.57%,1
彰化縣,永靖鄉,0618,342,147,489,20,509,821,62%,41.66%,1
彰化縣,永靖鄉,0619,440,187,627,46,673,1064,63.25%,41.35%,1
彰化縣,永靖鄉,0620,307,146,453,31,484,840,57.62%,36.55%,1
彰化縣,永靖鄉,0621,412,225,637,28,665,1079,61.63%,38.18%,1
彰化縣,永靖鄉,0622,416,207,623,31,654,1048,62.4%,39.69%,1
彰化縣,永靖鄉,0623,418,162,580,43,623,960,64.9%,43.54%,1
彰化縣,永靖鄉,0624,314,166,480,16,496,798,62.16%,39.35%,1
彰化縣,永靖鄉,0625,349,139,488,31,519,796,65.2%,43.84%,1
彰化縣,永靖鄉,0626,257,100,357,29,386,662,58.31%,38.82%,1
彰化縣,永靖鄉,0627,404,173,577,30,607,1040,58.37%,38.85%,1
彰化縣,永靖鄉,0628,390,162,552,40,592,1025,57.76%,38.05%,1
彰化縣,永靖鄉,0629,598,233,831,44,875,1357,64.48%,44.07%,1
彰化縣,永靖鄉,0630,474,220,694,47,741,1236,59.95%,38.35%,1
彰化縣,永靖鄉,0631,346,140,486,38,524,871,60.16%,39.72%,1
彰化縣,永靖鄉,0632,245,112,357,28,385,706,54.53%,34.7%,1
彰化縣,永靖鄉,0633,321,144,465,34,499,770,64.81%,41.69%,1
彰化縣,永靖鄉,0634,297,124,421,17,438,669,65.47%,44.39%,1
彰化縣,永靖鄉,0635,335,136,471,35,506,862,58.7%,38.86%,1
彰化縣,永靖鄉,0636,330,126,456,23,479,847,56.55%,38.96%,1
彰化縣,永靖鄉,0637,267,122,389,41,430,668,64.37%,39.97%,1
彰化縣,永靖鄉,0638,387,156,543,26,569,1073,53.03%,36.07%,1
彰化縣,永靖鄉,0639,464,190,654,41,695,1339,51.9%,34.65%,1
彰化縣,社頭鄉,0778,289,149,438,30,468,791,59.17%,36.54%,1
彰化縣,社頭鄉,0779,367,168,535,27,562,984,57.11%,37.3%,1
彰化縣,社頭鄉,0780,356,165,521,17,538,990,54.34%,35.96%,1
彰化縣,社頭鄉,0781,440,166,606,25,631,1016,62.11%,43.31%,1
彰化縣,社頭鄉,0782,632,3,635,24,659,1091,60.4%,57.93%,1
彰化縣,社頭鄉,0783,470,228,698,45,743,1236,60.11%,38.03%,1
彰化縣,社頭鄉,0784,441,202,643,21,664,1203,55.2%,36.66%,1
彰化縣,社頭鄉,0785,285,125,410,17,427,753,56.71%,37.85%,1
彰化縣,社頭鄉,0786,211,138,349,37,386,725,53.24%,29.1%,1
彰化縣,社頭鄉,0787,412,169,581,43,624,1023,61%,40.27%,1
彰化縣,社頭鄉,0788,244,123,367,15,382,562,67.97%,43.42%,1
彰化縣,社頭鄉,0789,393,174,567,24,591,1049,56.34%,37.46%,1
彰化縣,社頭鄉,0790,385,147,532,30,562,933,60.24%,41.26%,1
彰化縣,社頭鄉,0791,414,161,575,31,606,990,61.21%,41.82%,1
彰化縣,社頭鄉,0792,395,173,568,22,590,1076,54.83%,36.71%,1
彰化縣,社頭鄉,0793,304,146,450,8,458,742,61.73%,40.97%,1
彰化縣,社頭鄉,0794,273,99,372,15,387,672,57.59%,40.63%,1
彰化縣,社頭鄉,0795,438,162,600,31,631,1235,51.09%,35.47%,1
彰化縣,社頭鄉,0796,296,134,430,25,455,750,60.67%,39.47%,1
彰化縣,社頭鄉,0797,306,150,456,32,488,895,54.53%,34.19%,1
彰化縣,社頭鄉,0798,286,111,397,15,412,688,59.88%,41.57%,1
彰化縣,社頭鄉,0799,362,119,481,12,493,870,56.67%,41.61%,1
彰化縣,社頭鄉,0800,474,183,657,31,688,1140,60.35%,41.58%,1
彰化縣,社頭鄉,0801,402,144,546,38,584,985,59.29%,40.81%,1
彰化縣,社頭鄉,0802,534,200,734,56,790,1266,62.4%,42.18%,1
彰化縣,社頭鄉,0803,370,160,530,25,555,937,59.23%,39.49%,1
彰化縣,社頭鄉,0804,478,189,667,25,692,1219,56.77%,39.21%,1
彰化縣,社頭鄉,0805,445,183,628,52,680,1165,58.37%,38.2%,1
彰化縣,社頭鄉,0806,384,152,536,54,590,986,59.84%,38.95%,1
彰化縣,社頭鄉,0807,287,144,431,28,459,724,63.4%,39.64%,1
彰化縣,社頭鄉,0808,409,148,557,34,591,1015,58.23%,40.3%,1
彰化縣,社頭鄉,0809,370,174,544,28,572,1116,51.25%,33.15%,1
彰化縣,社頭鄉,0810,379,168,547,29,576,1061,54.29%,35.72%,1
彰化縣,社頭鄉,0811,387,185,572,29,601,992,60.58%,39.01%,1
彰化縣,社頭鄉,0812,398,188,586,19,605,1092,55.4%,36.45%,1
彰化縣,社頭鄉,0813,352,135,487,22,509,828,61.47%,42.51%,1
彰化縣,社頭鄉,0814,251,137,388,34,422,787,53.62%,31.89%,1
彰化縣,社頭鄉,0815,233,114,347,21,368,719,51.18%,32.41%,1
彰化縣,二水鄉,0816,383,177,560,50,610,1028,59.34%,37.26%,1
彰化縣,二水鄉,0817,284,108,392,41,433,689,62.84%,41.22%,1
彰化縣,二水鄉,0818,324,118,442,39,481,871,55.22%,37.2%,1
彰化縣,二水鄉,0819,392,131,523,49,572,953,60.02%,41.13%,1
彰化縣,二水鄉,0820,235,86,321,26,347,624,55.61%,37.66%,1
彰化縣,二水鄉,0821,280,122,402,32,434,645,67.29%,43.41%,1
彰化縣,二水鄉,0822,466,161,627,23,650,986,65.92%,47.26%,1
彰化縣,二水鄉,0823,407,167,574,50,624,943,66.17%,43.16%,1
彰化縣,二水鄉,0824,208,75,283,4,287,455,63.08%,45.71%,1
彰化縣,二水鄉,0825,391,140,531,28,559,831,67.27%,47.05%,1
彰化縣,二水鄉,0826,346,138,484,34,518,831,62.33%,41.64%,1
彰化縣,二水鄉,0827,372,164,536,30,566,1013,55.87%,36.72%,1
彰化縣,二水鄉,0828,349,126,475,30,505,796,63.44%,43.84%,1
彰化縣,二水鄉,0829,309,104,413,42,455,781,58.26%,39.56%,1
彰化縣,二水鄉,0830,240,110,350,18,368,692,53.18%,34.68%,1
彰化縣,二水鄉,0831,254,100,354,19,373,635,58.74%,40%,1
彰化縣,二水鄉,0832,210,92,302,30,332,566,58.66%,37.1%,1
彰化縣,北斗鎮,0833,352,129,481,40,521,925,56.32%,38.05%,1
彰化縣,北斗鎮,0834,357,134,491,38,529,869,60.87%,41.08%,1
彰化縣,北斗鎮,0835,386,142,528,28,556,855,65.03%,45.15%,1
彰化縣,北斗鎮,0836,454,184,638,31,669,1065,62.82%,42.63%,1
彰化縣,北斗鎮,0837,333,118,451,57,508,828,61.35%,40.22%,1
彰化縣,北斗鎮,0838,460,177,637,40,677,1124,60.23%,40.93%,1
彰化縣,北斗鎮,0839,435,208,643,28,671,1096,61.22%,39.69%,1
彰化縣,北斗鎮,0840,479,207,686,29,715,1213,58.94%,39.49%,1
彰化縣,北斗鎮,0841,431,167,598,46,644,1164,55.33%,37.03%,1
彰化縣,北斗鎮,0842,281,108,389,28,417,730,57.12%,38.49%,1
彰化縣,北斗鎮,0843,458,19,477,19,496,878,56.49%,52.16%,1
彰化縣,北斗鎮,0844,364,127,491,23,514,833,61.7%,43.7%,1
彰化縣,北斗鎮,0845,290,257,547,22,569,957,59.46%,30.3%,1
彰化縣,北斗鎮,0846,304,107,411,30,441,783,56.32%,38.83%,1
彰化縣,北斗鎮,0847,192,106,298,23,321,573,56.02%,33.51%,1
彰化縣,北斗鎮,0848,240,127,367,20,387,672,57.59%,35.71%,1
彰化縣,北斗鎮,0849,231,113,344,37,381,695,54.82%,33.24%,1
彰化縣,北斗鎮,0850,245,123,368,34,402,747,53.82%,32.8%,1
彰化縣,北斗鎮,0851,274,122,396,18,414,643,64.39%,42.61%,1
彰化縣,北斗鎮,0852,354,15,369,29,398,662,60.12%,53.47%,1
彰化縣,北斗鎮,0853,484,168,652,30,682,1085,62.86%,44.61%,1
彰化縣,北斗鎮,0854,435,190,625,44,669,1121,59.68%,38.8%,1
彰化縣,北斗鎮,0855,347,128,475,33,508,830,61.2%,41.81%,1
彰化縣,北斗鎮,0856,353,169,522,22,544,975,55.79%,36.21%,1
彰化縣,北斗鎮,0857,443,197,640,18,658,1212,54.29%,36.55%,1
彰化縣,北斗鎮,0858,522,214,736,45,781,1302,59.98%,40.09%,1
彰化縣,北斗鎮,0859,353,152,505,27,532,1077,49.4%,32.78%,1
彰化縣,北斗鎮,0860,326,138,464,43,507,917,55.29%,35.55%,1
彰化縣,北斗鎮,0861,321,123,444,26,470,825,56.97%,38.91%,1
彰化縣,北斗鎮,0862,364,139,503,48,551,937,58.8%,38.85%,1
彰化縣,二林鎮,0942,202,89,291,28,319,731,43.64%,27.63%,1
彰化縣,二林鎮,0943,393,166,559,31,590,1025,57.56%,38.34%,1
彰化縣,二林鎮,0944,292,137,429,27,456,784,58.16%,37.24%,1
彰化縣,二林鎮,0945,346,141,487,30,517,892,57.96%,38.79%,1
彰化縣,二林鎮,0946,470,216,686,37,723,1256,57.56%,37.42%,1
彰化縣,二林鎮,0947,379,152,531,44,575,1043,55.13%,36.34%,1
彰化縣,二林鎮,0948,421,199,620,29,649,1076,60.32%,39.13%,1
彰化縣,二林鎮,0949,421,175,596,39,635,1082,58.69%,38.91%,1
彰化縣,二林鎮,0950,404,335,739,38,777,1427,54.45%,28.31%,1
彰化縣,二林鎮,0951,314,153,467,59,526,1030,51.07%,30.49%,1
彰化縣,二林鎮,0952,329,172,501,45,546,1033,52.86%,31.85%,1
彰化縣,二林鎮,0953,328,172,500,42,542,977,55.48%,33.57%,1
彰化縣,二林鎮,0954,241,93,334,20,354,683,51.83%,35.29%,1
彰化縣,二林鎮,0955,419,29,448,67,515,975,52.82%,42.97%,1
彰化縣,二林鎮,0956,511,43,554,57,611,1336,45.73%,38.25%,1
彰化縣,二林鎮,0957,292,141,433,51,484,1019,47.5%,28.66%,1
彰化縣,二林鎮,0958,286,123,409,33,442,1003,44.07%,28.51%,1
彰化縣,二林鎮,0959,441,154,595,54,649,1151,56.39%,38.31%,1
彰化縣,二林鎮,0960,624,239,863,51,914,1598,57.2%,39.05%,1
彰化縣,二林鎮,0961,545,202,747,54,801,1488,53.83%,36.63%,1
彰化縣,二林鎮,0962,663,288,951,48,999,1771,56.41%,37.44%,1
彰化縣,二林鎮,0963,379,164,543,45,588,1360,43.24%,27.87%,1
彰化縣,二林鎮,0964,500,207,707,46,753,1613,46.68%,31%,1
彰化縣,二林鎮,0965,385,178,563,78,641,1228,52.2%,31.35%,1
彰化縣,二林鎮,0966,314,105,419,19,438,771,56.81%,40.73%,1
彰化縣,二林鎮,0967,347,133,480,28,508,858,59.21%,40.44%,1
彰化縣,二林鎮,0968,217,77,294,0,294,661,44.48%,32.83%,1
彰化縣,二林鎮,0969,413,164,577,60,637,1268,50.24%,32.57%,1
彰化縣,二林鎮,0970,344,150,494,37,531,1081,49.12%,31.82%,1
彰化縣,二林鎮,0971,412,155,567,27,594,1213,48.97%,33.97%,1
彰化縣,二林鎮,0972,499,202,701,40,741,1328,55.8%,37.58%,1
彰化縣,二林鎮,0973,347,136,483,51,534,1118,47.76%,31.04%,1
彰化縣,二林鎮,0974,343,150,493,41,534,1157,46.15%,29.65%,1
彰化縣,二林鎮,0975,326,122,448,33,481,972,49.49%,33.54%,1
彰化縣,二林鎮,0976,306,153,459,26,485,902,53.77%,33.92%,1
彰化縣,二林鎮,0977,571,191,762,34,796,1273,62.53%,44.85%,1
彰化縣,二林鎮,0978,392,155,547,35,582,1087,53.54%,36.06%,1
彰化縣,二林鎮,0979,395,148,543,47,590,987,59.78%,40.02%,1
彰化縣,二林鎮,0980,207,105,312,21,333,719,46.31%,28.79%,1
彰化縣,田尾鄉,0863,422,206,628,40,668,1284,52.02%,32.87%,1
彰化縣,田尾鄉,0864,473,199,672,53,725,1187,61.08%,39.85%,1
彰化縣,田尾鄉,0865,413,184,597,37,634,1033,61.37%,39.98%,1
彰化縣,田尾鄉,0866,305,94,399,24,423,696,60.78%,43.82%,1
彰化縣,田尾鄉,0867,362,150,512,27,539,872,61.81%,41.51%,1
彰化縣,田尾鄉,0868,258,100,358,19,377,680,55.44%,37.94%,1
彰化縣,田尾鄉,0869,346,184,530,29,559,875,63.89%,39.54%,1
彰化縣,田尾鄉,0870,501,226,727,39,766,1337,57.29%,37.47%,1
彰化縣,田尾鄉,0871,546,257,803,40,843,1376,61.26%,39.68%,1
彰化縣,田尾鄉,0872,494,207,701,36,737,1186,62.14%,41.65%,1
彰化縣,田尾鄉,0873,413,151,564,41,605,874,69.22%,47.25%,1
彰化縣,田尾鄉,0874,244,97,341,27,368,647,56.88%,37.71%,1
彰化縣,田尾鄉,0875,413,129,542,32,574,959,59.85%,43.07%,1
彰化縣,田尾鄉,0876,93,37,130,14,144,263,54.75%,35.36%,1
彰化縣,田尾鄉,0877,221,90,311,26,337,618,54.53%,35.76%,1
彰化縣,田尾鄉,0878,395,180,575,25,600,938,63.97%,42.11%,1
彰化縣,田尾鄉,0879,362,163,525,40,565,880,64.2%,41.14%,1
彰化縣,田尾鄉,0880,276,129,405,24,429,804,53.36%,34.33%,1
彰化縣,田尾鄉,0881,196,106,302,27,329,592,55.57%,33.11%,1
彰化縣,田尾鄉,0882,433,181,614,71,685,1079,63.48%,40.13%,1
彰化縣,田尾鄉,0883,485,251,736,42,778,1336,58.23%,36.3%,1
彰化縣,田尾鄉,0884,415,191,606,47,653,1198,54.51%,34.64%,1
彰化縣,田尾鄉,0885,216,105,321,34,355,621,57.17%,34.78%,1
彰化縣,田尾鄉,0886,265,120,385,31,416,760,54.74%,34.87%,1
彰化縣,田尾鄉,0887,422,212,634,66,700,1084,64.58%,38.93%,1
彰化縣,埤頭鄉,0888,376,157,533,77,610,1178,51.78%,31.92%,1
彰化縣,埤頭鄉,0889,458,205,663,32,695,1290,53.88%,35.5%,1
彰化縣,埤頭鄉,0890,320,179,499,37,536,973,55.09%,32.89%,1
彰化縣,埤頭鄉,0891,265,124,389,31,420,783,53.64%,33.84%,1
彰化縣,埤頭鄉,0892,274,101,375,43,418,733,57.03%,37.38%,1
彰化縣,埤頭鄉,0893,330,149,479,50,529,899,58.84%,36.71%,1
彰化縣,埤頭鄉,0894,367,132,499,46,545,965,56.48%,38.03%,1
彰化縣,埤頭鄉,0895,504,173,677,38,715,1356,52.73%,37.17%,1
彰化縣,埤頭鄉,0896,458,198,656,37,693,1265,54.78%,36.21%,1
彰化縣,埤頭鄉,0897,360,117,477,37,514,877,58.61%,41.05%,1
彰化縣,埤頭鄉,0898,241,101,342,40,382,705,54.18%,34.18%,1
彰化縣,埤頭鄉,0899,458,172,630,27,657,1062,61.86%,43.13%,1
彰化縣,埤頭鄉,0900,498,205,703,40,743,1300,57.15%,38.31%,1
彰化縣,埤頭鄉,0901,373,126,499,43,542,923,58.72%,40.41%,1
彰化縣,埤頭鄉,0902,398,147,545,28,573,1085,52.81%,36.68%,1
彰化縣,埤頭鄉,0903,17,586,603,51,654,1103,59.29%,1.54%,1
彰化縣,埤頭鄉,0904,263,105,368,18,386,735,52.52%,35.78%,1
彰化縣,埤頭鄉,0905,191,89,280,36,316,574,55.05%,33.28%,1
彰化縣,埤頭鄉,0906,268,84,352,35,387,767,50.46%,34.94%,1
彰化縣,埤頭鄉,0907,266,115,381,27,408,737,55.36%,36.09%,1
彰化縣,埤頭鄉,0908,323,155,478,43,521,1058,49.24%,30.53%,1
彰化縣,埤頭鄉,0909,252,120,372,54,426,826,51.57%,30.51%,1
彰化縣,埤頭鄉,0910,340,141,481,66,547,1082,50.55%,31.42%,1
彰化縣,埤頭鄉,0911,290,117,407,41,448,737,60.79%,39.35%,1
彰化縣,埤頭鄉,0912,246,106,352,16,368,711,51.76%,34.6%,1
彰化縣,埤頭鄉,0913,379,184,563,35,598,1043,57.33%,36.34%,1
彰化縣,埤頭鄉,0914,328,120,448,20,468,910,51.43%,36.04%,1
彰化縣,芳苑鄉,0998,213,92,305,32,337,940,35.85%,22.66%,1
彰化縣,芳苑鄉,0999,118,35,153,17,170,403,42.18%,29.28%,1
彰化縣,芳苑鄉,1000,243,106,349,30,379,756,50.13%,32.14%,1
彰化縣,芳苑鄉,1001,105,55,160,18,178,548,32.48%,19.16%,1
彰化縣,芳苑鄉,1002,348,140,488,32,520,997,52.16%,34.9%,1
彰化縣,芳苑鄉,1003,376,171,547,46,593,1300,45.62%,28.92%,1
彰化縣,芳苑鄉,1004,284,130,414,29,443,859,51.57%,33.06%,1
彰化縣,芳苑鄉,1005,252,106,358,27,385,734,52.45%,34.33%,1
彰化縣,芳苑鄉,1006,207,78,285,20,305,636,47.96%,32.55%,1
彰化縣,芳苑鄉,1007,225,114,339,45,384,808,47.52%,27.85%,1
彰化縣,芳苑鄉,1008,181,79,260,35,295,668,44.16%,27.1%,1
彰化縣,芳苑鄉,1009,228,118,346,32,378,744,50.81%,30.65%,1
彰化縣,芳苑鄉,1010,323,124,447,48,495,1026,48.25%,31.48%,1
彰化縣,芳苑鄉,1011,164,59,223,18,241,586,41.13%,27.99%,1
彰化縣,芳苑鄉,1012,200,83,283,31,314,593,52.95%,33.73%,1
彰化縣,芳苑鄉,1013,377,141,518,54,572,1071,53.41%,35.2%,1
彰化縣,芳苑鄉,1014,337,166,503,56,559,1060,52.74%,31.79%,1
彰化縣,芳苑鄉,1015,286,90,376,20,396,708,55.93%,40.4%,1
彰化縣,芳苑鄉,1016,252,77,329,38,367,735,49.93%,34.29%,1
彰化縣,芳苑鄉,1017,212,88,300,35,335,571,58.67%,37.13%,1
彰化縣,芳苑鄉,1018,228,68,296,29,325,729,44.58%,31.28%,1
彰化縣,芳苑鄉,1019,238,78,316,43,359,674,53.26%,35.31%,1
彰化縣,芳苑鄉,1020,273,133,406,27,433,846,51.18%,32.27%,1
彰化縣,芳苑鄉,1021,346,107,453,27,480,806,59.55%,42.93%,1
彰化縣,芳苑鄉,1022,135,53,188,12,200,470,42.55%,28.72%,1
彰化縣,芳苑鄉,1023,420,144,564,53,617,1124,54.89%,37.37%,1
彰化縣,芳苑鄉,1024,108,32,140,12,152,317,47.95%,34.07%,1
彰化縣,芳苑鄉,1025,323,122,445,52,497,1158,42.92%,27.89%,1
彰化縣,芳苑鄉,1026,309,121,430,30,460,967,47.57%,31.95%,1
彰化縣,芳苑鄉,1027,267,96,363,45,408,762,53.54%,35.04%,1
彰化縣,芳苑鄉,1028,310,136,446,35,481,1086,44.29%,28.55%,1
彰化縣,芳苑鄉,1029,232,109,341,27,368,747,49.26%,31.06%,1
彰化縣,芳苑鄉,1030,175,68,243,23,266,653,40.74%,26.8%,1
彰化縣,芳苑鄉,1031,356,113,469,45,514,872,58.94%,40.83%,1
彰化縣,芳苑鄉,1032,466,235,701,44,745,1235,60.32%,37.73%,1
彰化縣,芳苑鄉,1033,399,160,559,43,602,1102,54.63%,36.21%,1
彰化縣,大城鄉,0981,292,127,419,26,445,1288,34.55%,22.67%,1
彰化縣,大城鄉,0982,268,111,379,48,427,1104,38.68%,24.28%,1
彰化縣,大城鄉,0983,363,136,499,42,541,964,56.12%,37.66%,1
彰化縣,大城鄉,0984,426,138,564,45,609,1312,46.42%,32.47%,1
彰化縣,大城鄉,0985,234,87,321,45,366,853,42.91%,27.43%,1
彰化縣,大城鄉,0986,140,30,170,13,183,518,35.33%,27.03%,1
彰化縣,大城鄉,0987,160,67,227,23,250,574,43.55%,27.87%,1
彰化縣,大城鄉,0988,172,72,244,25,269,702,38.32%,24.5%,1
彰化縣,大城鄉,0989,80,25,105,14,119,376,31.65%,21.28%,1
彰化縣,大城鄉,0990,145,56,201,16,217,693,31.31%,20.92%,1
彰化縣,大城鄉,0991,241,103,344,42,386,877,44.01%,27.48%,1
彰化縣,大城鄉,0992,127,65,192,14,206,655,31.45%,19.39%,1
彰化縣,大城鄉,0993,282,99,381,29,410,1103,37.17%,25.57%,1
彰化縣,大城鄉,0994,240,132,372,45,417,1192,34.98%,20.13%,1
彰化縣,大城鄉,0995,215,123,338,23,361,917,39.37%,23.45%,1
彰化縣,大城鄉,0996,157,53,210,20,230,686,33.53%,22.89%,1
彰化縣,大城鄉,0997,182,76,258,23,281,899,31.26%,20.24%,1
彰化縣,竹塘鄉,1034,536,80,616,65,681,1168,58.3%,45.89%,1
彰化縣,竹塘鄉,1035,373,172,545,29,574,965,59.48%,38.65%,1
彰化縣,竹塘鄉,1036,376,176,552,50,602,960,62.71%,39.17%,1
彰化縣,竹塘鄉,1037,98,333,431,52,483,743,65.01%,13.19%,1
彰化縣,竹塘鄉,1038,212,94,306,36,342,751,45.54%,28.23%,1
彰化縣,竹塘鄉,1039,264,101,365,27,392,792,49.49%,33.33%,1
彰化縣,竹塘鄉,1040,233,108,341,17,358,733,48.84%,31.79%,1
彰化縣,竹塘鄉,1041,240,87,327,33,360,657,54.79%,36.53%,1
彰化縣,竹塘鄉,1042,372,154,526,38,564,1063,53.06%,35%,1
彰化縣,竹塘鄉,1043,401,164,565,74,639,1114,57.36%,36%,1
彰化縣,竹塘鄉,1044,207,102,309,35,344,506,67.98%,40.91%,1
彰化縣,竹塘鄉,1045,262,126,388,36,424,823,51.52%,31.83%,1
彰化縣,竹塘鄉,1046,202,104,306,30,336,654,51.38%,30.89%,1
彰化縣,竹塘鄉,1047,182,70,252,18,270,577,46.79%,31.54%,1
彰化縣,竹塘鄉,1048,256,109,365,46,411,772,53.24%,33.16%,1
彰化縣,竹塘鄉,1049,148,68,216,36,252,543,46.41%,27.26%,1
彰化縣,溪州鄉,0915,306,93,399,33,432,778,55.53%,39.33%,1
彰化縣,溪州鄉,0916,344,157,501,23,524,1061,49.39%,32.42%,1
彰化縣,溪州鄉,0917,251,79,330,33,363,701,51.78%,35.81%,1
彰化縣,溪州鄉,0918,383,142,525,23,548,879,62.34%,43.57%,1
彰化縣,溪州鄉,0919,294,105,399,35,434,654,66.36%,44.95%,1
彰化縣,溪州鄉,0920,351,131,482,23,505,878,57.52%,39.98%,1
彰化縣,溪州鄉,0921,412,148,560,26,586,942,62.21%,43.74%,1
彰化縣,溪州鄉,0922,317,138,455,30,485,871,55.68%,36.39%,1
彰化縣,溪州鄉,0923,399,134,533,23,556,1047,53.1%,38.11%,1
彰化縣,溪州鄉,0924,304,160,464,44,508,858,59.21%,35.43%,1
彰化縣,溪州鄉,0925,435,163,598,54,652,1409,46.27%,30.87%,1
彰化縣,溪州鄉,0926,282,121,403,18,421,792,53.16%,35.61%,1
彰化縣,溪州鄉,0927,242,104,346,40,386,714,54.06%,33.89%,1
彰化縣,溪州鄉,0928,341,157,498,42,540,1109,48.69%,30.75%,1
彰化縣,溪州鄉,0929,259,143,402,38,440,962,45.74%,26.92%,1
彰化縣,溪州鄉,0930,341,138,479,51,530,1157,45.81%,29.47%,1
彰化縣,溪州鄉,0931,323,142,465,33,498,952,52.31%,33.93%,1
彰化縣,溪州鄉,0932,288,146,434,42,476,887,53.66%,32.47%,1
彰化縣,溪州鄉,0933,223,117,340,43,383,866,44.23%,25.75%,1
彰化縣,溪州鄉,0934,264,169,433,55,488,1010,48.32%,26.14%,1
彰化縣,溪州鄉,0935,256,151,407,20,427,853,50.06%,30.01%,1
彰化縣,溪州鄉,0936,272,121,393,46,439,843,52.08%,32.27%,1
彰化縣,溪州鄉,0937,177,83,260,10,270,711,37.97%,24.89%,1
彰化縣,溪州鄉,0938,296,127,423,49,472,851,55.46%,34.78%,1
彰化縣,溪州鄉,0939,294,115,409,30,439,883,49.72%,33.3%,1
彰化縣,溪州鄉,0940,446,141,587,46,633,1247,50.76%,35.77%,1
彰化縣,溪州鄉,0941,527,248,775,56,831,1490,55.77%,35.37%,1
南投縣,南投市,0001,367,171,538,30,568,927,61.27%,39.59%,1
南投縣,南投市,0002,311,126,437,20,457,667,68.52%,46.63%,1
南投縣,南投市,0003,334,145,479,16,495,773,64.04%,43.21%,1
南投縣,南投市,0004,333,163,496,21,517,818,63.2%,40.71%,1
南投縣,南投市,0005,234,108,342,15,357,525,68%,44.57%,1
南投縣,南投市,0006,256,102,358,25,383,575,66.61%,44.52%,1
南投縣,南投市,0007,175,70,245,11,256,368,69.57%,47.55%,1
南投縣,南投市,0008,438,170,608,25,633,956,66.21%,45.82%,1
南投縣,南投市,0009,444,203,647,27,674,1245,54.14%,35.66%,1
南投縣,南投市,0010,599,251,850,13,863,1484,58.15%,40.36%,1
南投縣,南投市,0011,545,210,755,29,784,1191,65.83%,45.76%,1
南投縣,南投市,0012,607,267,874,45,919,1506,61.02%,40.31%,1
南投縣,南投市,0013,436,212,648,29,677,1070,63.27%,40.75%,1
南投縣,南投市,0014,295,114,409,19,428,670,63.88%,44.03%,1
南投縣,南投市,0015,467,193,660,41,701,1050,66.76%,44.48%,1
南投縣,南投市,0016,420,162,582,36,618,1122,55.08%,37.43%,1
南投縣,南投市,0017,352,175,527,31,558,984,56.71%,35.77%,1
南投縣,南投市,0018,456,220,676,29,705,1062,66.38%,42.94%,1
南投縣,南投市,0019,419,179,598,44,642,1053,60.97%,39.79%,1
南投縣,南投市,0020,436,234,670,32,702,1104,63.59%,39.49%,1
南投縣,南投市,0021,433,217,650,48,698,1192,58.56%,36.33%,1
南投縣,南投市,0022,377,158,535,20,555,960,57.81%,39.27%,1
南投縣,南投市,0023,375,149,524,35,559,906,61.7%,41.39%,1
南投縣,南投市,0024,408,172,580,18,598,957,62.49%,42.63%,1
南投縣,南投市,0025,448,179,627,25,652,997,65.4%,44.93%,1
南投縣,南投市,0026,429,182,611,18,629,1008,62.4%,42.56%,1
南投縣,南投市,0027,454,214,668,17,685,1164,58.85%,39%,1
南投縣,南投市,0028,227,105,332,18,350,587,59.63%,38.67%,1
南投縣,南投市,0029,260,129,389,26,415,734,56.54%,35.42%,1
南投縣,南投市,0030,277,122,399,33,432,724,59.67%,38.26%,1
南投縣,南投市,0031,431,138,569,30,599,1003,59.72%,42.97%,1
南投縣,南投市,0032,529,220,749,40,789,1356,58.19%,39.01%,1
南投縣,南投市,0033,484,229,713,38,751,1373,54.7%,35.25%,1
南投縣,南投市,0034,557,226,783,30,813,1452,55.99%,38.36%,1
南投縣,南投市,0035,156,45,201,11,212,362,58.56%,43.09%,1
南投縣,南投市,0036,157,61,218,17,235,389,60.41%,40.36%,1
南投縣,南投市,0037,537,254,791,39,830,1276,65.05%,42.08%,1
南投縣,南投市,0038,459,221,680,39,719,1089,66.02%,42.15%,1
南投縣,南投市,0039,358,193,551,42,593,921,64.39%,38.87%,1
南投縣,南投市,0040,426,178,604,14,618,892,69.28%,47.76%,1
南投縣,南投市,0041,463,194,657,28,685,1050,65.24%,44.1%,1
南投縣,南投市,0042,473,194,667,16,683,1078,63.36%,43.88%,1
南投縣,南投市,0043,458,182,640,28,668,1078,61.97%,42.49%,1
南投縣,南投市,0044,401,197,598,25,623,861,72.36%,46.57%,1
南投縣,南投市,0045,515,182,697,43,740,1221,60.61%,42.18%,1
南投縣,南投市,0046,475,179,654,14,668,1105,60.45%,42.99%,1
南投縣,南投市,0047,522,220,742,16,758,1230,61.63%,42.44%,1
南投縣,南投市,0048,448,205,653,22,675,1092,61.81%,41.03%,1
南投縣,南投市,0049,560,242,802,18,820,1286,63.76%,43.55%,1
南投縣,南投市,0050,301,135,436,22,458,655,69.92%,45.95%,1
南投縣,南投市,0051,323,134,457,15,472,719,65.65%,44.92%,1
南投縣,南投市,0052,285,133,418,26,444,720,61.67%,39.58%,1
南投縣,南投市,0053,241,85,326,16,342,509,67.19%,47.35%,1
南投縣,南投市,0054,221,48,269,14,283,492,57.52%,44.92%,1
南投縣,南投市,0055,283,78,361,13,374,616,60.71%,45.94%,1
南投縣,南投市,0056,477,127,604,21,625,1010,61.88%,47.23%,1
南投縣,南投市,0057,381,104,485,26,511,848,60.26%,44.93%,1
南投縣,南投市,0058,605,238,843,42,885,1387,63.81%,43.62%,1
南投縣,南投市,0059,517,257,774,30,804,1245,64.58%,41.53%,1
南投縣,南投市,0060,471,205,676,19,695,1199,57.96%,39.28%,1
南投縣,南投市,0061,554,209,763,38,801,1288,62.19%,43.01%,1
南投縣,南投市,0062,419,170,589,34,623,1040,59.9%,40.29%,1
南投縣,南投市,0063,432,202,634,34,668,1070,62.43%,40.37%,1
南投縣,南投市,0064,450,240,690,30,720,1299,55.43%,34.64%,1
南投縣,南投市,0065,500,196,696,28,724,1122,64.53%,44.56%,1
南投縣,南投市,0066,587,218,805,37,842,1414,59.55%,41.51%,1
南投縣,南投市,0067,454,180,634,37,671,1121,59.86%,40.5%,1
南投縣,南投市,0068,556,245,801,22,823,1434,57.39%,38.77%,1
南投縣,南投市,0069,482,263,745,28,773,1393,55.49%,34.6%,1
南投縣,南投市,0070,436,164,600,13,613,1059,57.88%,41.17%,1
南投縣,南投市,0071,511,182,693,15,708,1218,58.13%,41.95%,1
南投縣,南投市,0072,578,119,697,18,715,1293,55.3%,44.7%,1
南投縣,南投市,0073,484,169,653,17,670,1337,50.11%,36.2%,1
南投縣,南投市,0074,356,180,536,33,569,876,64.95%,40.64%,1
南投縣,南投市,0075,376,166,542,26,568,971,58.5%,38.72%,1
南投縣,南投市,0076,385,183,568,26,594,1012,58.7%,38.04%,1
南投縣,南投市,0077,383,143,526,26,552,973,56.73%,39.36%,1
南投縣,南投市,0078,454,175,629,21,650,1002,64.87%,45.31%,1
南投縣,南投市,0079,382,192,574,35,609,1024,59.47%,37.3%,1
南投縣,南投市,0080,350,163,513,80,593,1122,52.85%,31.19%,1
南投縣,南投市,0081,253,124,377,23,400,790,50.63%,32.03%,1
南投縣,南投市,0082,215,73,288,19,307,647,47.45%,33.23%,1
南投縣,南投市,0083,342,155,497,40,537,950,56.53%,36%,1
南投縣,南投市,0084,342,163,505,24,529,980,53.98%,34.9%,1
南投縣,埔里鎮,0085,346,123,469,29,498,828,60.14%,41.79%,1
南投縣,埔里鎮,0086,306,151,457,34,491,786,62.47%,38.93%,1
南投縣,埔里鎮,0087,427,143,570,38,608,1062,57.25%,40.21%,1
南投縣,埔里鎮,0088,292,225,517,36,553,1201,46.04%,24.31%,1
南投縣,埔里鎮,0089,419,212,631,34,665,1415,47%,29.61%,1
南投縣,埔里鎮,0090,497,209,706,24,730,1282,56.94%,38.77%,1
南投縣,埔里鎮,0091,352,128,480,26,506,859,58.91%,40.98%,1
南投縣,埔里鎮,0092,471,201,672,78,750,1288,58.23%,36.57%,1
南投縣,埔里鎮,0093,507,224,731,35,766,1330,57.59%,38.12%,1
南投縣,埔里鎮,0094,492,233,725,44,769,1416,54.31%,34.75%,1
南投縣,埔里鎮,0095,462,186,648,27,675,1283,52.61%,36.01%,1
南投縣,埔里鎮,0096,452,184,636,57,693,1151,60.21%,39.27%,1
南投縣,埔里鎮,0097,427,178,605,30,635,1193,53.23%,35.79%,1
南投縣,埔里鎮,0098,545,236,781,69,850,1471,57.78%,37.05%,1
南投縣,埔里鎮,0099,323,149,472,61,533,1044,51.05%,30.94%,1
南投縣,埔里鎮,0100,434,190,624,43,667,1122,59.45%,38.68%,1
南投縣,埔里鎮,0101,589,186,775,33,808,1129,71.57%,52.17%,1
南投縣,埔里鎮,0102,347,142,489,15,504,901,55.94%,38.51%,1
南投縣,埔里鎮,0103,376,128,504,40,544,997,54.56%,37.71%,1
南投縣,埔里鎮,0104,447,201,648,33,681,1209,56.33%,36.97%,1
南投縣,埔里鎮,0105,394,129,523,32,555,838,66.23%,47.02%,1
南投縣,埔里鎮,0106,399,181,580,34,614,1226,50.08%,32.54%,1
南投縣,埔里鎮,0107,523,218,741,54,795,1263,62.95%,41.41%,1
南投縣,埔里鎮,0108,427,184,611,26,637,1045,60.96%,40.86%,1
南投縣,埔里鎮,0109,458,202,660,36,696,1120,62.14%,40.89%,1
南投縣,埔里鎮,0110,472,187,659,34,693,1062,65.25%,44.44%,1
南投縣,埔里鎮,0111,391,172,563,33,596,1022,58.32%,38.26%,1
南投縣,埔里鎮,0112,391,183,574,24,598,1051,56.9%,37.2%,1
南投縣,埔里鎮,0113,417,180,597,27,624,1106,56.42%,37.7%,1
南投縣,埔里鎮,0114,434,163,597,23,620,1098,56.47%,39.53%,1
南投縣,埔里鎮,0115,433,177,610,20,630,1067,59.04%,40.58%,1
南投縣,埔里鎮,0116,267,127,394,37,431,725,59.45%,36.83%,1
南投縣,埔里鎮,0117,335,182,517,25,542,905,59.89%,37.02%,1
南投縣,埔里鎮,0118,417,180,597,50,647,1179,54.88%,35.37%,1
南投縣,埔里鎮,0119,348,111,459,37,496,944,52.54%,36.86%,1
南投縣,埔里鎮,0120,178,62,240,29,269,465,57.85%,38.28%,1
南投縣,埔里鎮,0121,415,187,602,38,640,1133,56.49%,36.63%,1
南投縣,埔里鎮,0122,382,174,556,46,602,1100,54.73%,34.73%,1
南投縣,埔里鎮,0123,456,178,634,41,675,1155,58.44%,39.48%,1
南投縣,埔里鎮,0124,428,200,628,45,673,1254,53.67%,34.13%,1
南投縣,埔里鎮,0125,554,102,656,42,698,1296,53.86%,42.75%,1
南投縣,埔里鎮,0126,429,199,628,36,664,1023,64.91%,41.94%,1
南投縣,埔里鎮,0127,348,134,482,19,501,964,51.97%,36.1%,1
南投縣,埔里鎮,0128,396,161,557,25,582,986,59.03%,40.16%,1
南投縣,埔里鎮,0129,404,180,584,32,616,1016,60.63%,39.76%,1
南投縣,埔里鎮,0130,360,133,493,41,534,898,59.47%,40.09%,1
南投縣,埔里鎮,0131,397,170,567,32,599,980,61.12%,40.51%,1
南投縣,埔里鎮,0132,397,138,535,30,565,933,60.56%,42.55%,1
南投縣,埔里鎮,0133,402,204,606,47,653,929,70.29%,43.27%,1
南投縣,埔里鎮,0134,398,170,568,25,593,1032,57.46%,38.57%,1
南投縣,埔里鎮,0135,113,36,149,8,157,315,49.84%,35.87%,1
南投縣,埔里鎮,0136,446,221,667,65,732,1363,53.71%,32.72%,1
南投縣,埔里鎮,0137,297,124,421,22,443,725,61.1%,40.97%,1
南投縣,埔里鎮,0138,300,114,414,13,427,705,60.57%,42.55%,1
南投縣,埔里鎮,0139,302,152,454,31,485,751,64.58%,40.21%,1
南投縣,埔里鎮,0140,336,167,503,31,534,932,57.3%,36.05%,1
南投縣,埔里鎮,0141,340,187,527,36,563,956,58.89%,35.56%,1
南投縣,埔里鎮,0142,143,59,202,12,214,376,56.91%,38.03%,1
南投縣,埔里鎮,0143,260,117,377,30,407,682,59.68%,38.12%,1
南投縣,埔里鎮,0144,516,88,604,42,646,990,65.25%,52.12%,1
南投縣,埔里鎮,0145,418,191,609,62,671,1324,50.68%,31.57%,1
南投縣,埔里鎮,0146,87,49,136,12,148,298,49.66%,29.19%,1
南投縣,埔里鎮,0147,361,238,599,53,652,1170,55.73%,30.85%,1
南投縣,埔里鎮,0148,241,105,346,15,361,604,59.77%,39.9%,1
南投縣,埔里鎮,0149,367,147,514,38,552,999,55.26%,36.74%,1
南投縣,埔里鎮,0150,315,138,453,17,470,923,50.92%,34.13%,1
南投縣,埔里鎮,0151,357,152,509,28,537,887,60.54%,40.25%,1
南投縣,埔里鎮,0152,351,159,510,25,535,981,54.54%,35.78%,1
南投縣,草屯鎮,0153,423,180,603,19,622,998,62.32%,42.38%,1
南投縣,草屯鎮,0154,400,209,609,19,628,1127,55.72%,35.49%,1
南投縣,草屯鎮,0155,452,320,772,14,786,1401,56.1%,32.26%,1
南投縣,草屯鎮,0156,397,205,602,29,631,1110,56.85%,35.77%,1
南投縣,草屯鎮,0157,518,204,722,45,767,1285,59.69%,40.31%,1
南投縣,草屯鎮,0158,363,151,514,26,540,936,57.69%,38.78%,1
南投縣,草屯鎮,0159,432,194,626,31,657,1141,57.58%,37.86%,1
南投縣,草屯鎮,0160,294,131,425,18,443,705,62.84%,41.7%,1
南投縣,草屯鎮,0161,476,214,690,20,710,1121,63.34%,42.46%,1
南投縣,草屯鎮,0162,400,164,564,18,582,877,66.36%,45.61%,1
南投縣,草屯鎮,0163,533,248,781,43,824,1401,58.82%,38.04%,1
南投縣,草屯鎮,0164,491,172,663,37,700,1267,55.25%,38.75%,1
南投縣,草屯鎮,0165,479,198,677,44,721,1214,59.39%,39.46%,1
南投縣,草屯鎮,0166,475,234,709,44,753,1259,59.81%,37.73%,1
南投縣,草屯鎮,0167,600,256,856,23,879,1442,60.96%,41.61%,1
南投縣,草屯鎮,0168,524,213,737,29,766,1273,60.17%,41.16%,1
南投縣,草屯鎮,0169,424,208,632,26,658,1145,57.47%,37.03%,1
南投縣,草屯鎮,0170,501,199,700,25,725,1279,56.68%,39.17%,1
南投縣,草屯鎮,0171,449,182,631,25,656,1158,56.65%,38.77%,1
南投縣,草屯鎮,0172,593,256,849,31,880,1335,65.92%,44.42%,1
南投縣,草屯鎮,0173,506,220,726,39,765,1178,64.94%,42.95%,1
南投縣,草屯鎮,0174,499,253,752,30,782,1327,58.93%,37.6%,1
南投縣,草屯鎮,0175,409,175,584,22,606,1000,60.6%,40.9%,1
南投縣,草屯鎮,0176,495,207,702,21,723,1257,57.52%,39.38%,1
南投縣,草屯鎮,0177,406,146,552,16,568,883,64.33%,45.98%,1
南投縣,草屯鎮,0178,430,166,596,28,624,1121,55.66%,38.36%,1
南投縣,草屯鎮,0179,421,175,596,26,622,1043,59.64%,40.36%,1
南投縣,草屯鎮,0180,412,183,595,10,605,979,61.8%,42.08%,1
南投縣,草屯鎮,0181,343,177,520,27,547,1048,52.19%,32.73%,1
南投縣,草屯鎮,0182,397,151,548,26,574,1009,56.89%,39.35%,1
南投縣,草屯鎮,0183,429,175,604,15,619,1138,54.39%,37.7%,1
南投縣,草屯鎮,0184,454,193,647,23,670,1197,55.97%,37.93%,1
南投縣,草屯鎮,0185,547,228,775,36,811,1364,59.46%,40.1%,1
南投縣,草屯鎮,0186,405,193,598,40,638,1059,60.25%,38.24%,1
南投縣,草屯鎮,0187,423,190,613,41,654,1108,59.03%,38.18%,1
南投縣,草屯鎮,0188,357,124,481,24,505,879,57.45%,40.61%,1
南投縣,草屯鎮,0189,391,135,526,40,566,957,59.14%,40.86%,1
南投縣,草屯鎮,0190,452,196,648,21,669,1395,47.96%,32.4%,1
南投縣,草屯鎮,0191,452,205,657,25,682,1101,61.94%,41.05%,1
南投縣,草屯鎮,0192,443,226,669,32,701,1297,54.05%,34.16%,1
南投縣,草屯鎮,0193,262,127,389,25,414,877,47.21%,29.87%,1
南投縣,草屯鎮,0194,440,204,644,37,681,1376,49.49%,31.98%,1
南投縣,草屯鎮,0195,432,172,604,50,654,1008,64.88%,42.86%,1
南投縣,草屯鎮,0196,442,196,638,39,677,1080,62.69%,40.93%,1
南投縣,草屯鎮,0197,334,183,517,42,559,1017,54.97%,32.84%,1
南投縣,草屯鎮,0198,400,176,576,36,612,961,63.68%,41.62%,1
南投縣,草屯鎮,0199,455,211,666,47,713,1160,61.47%,39.22%,1
南投縣,草屯鎮,0200,431,192,623,32,655,1121,58.43%,38.45%,1
南投縣,草屯鎮,0201,456,231,687,26,713,1243,57.36%,36.69%,1
南投縣,草屯鎮,0202,371,171,542,25,567,932,60.84%,39.81%,1
南投縣,草屯鎮,0203,548,270,818,43,861,1323,65.08%,41.42%,1
南投縣,草屯鎮,0204,555,205,760,42,802,1518,52.83%,36.56%,1
南投縣,草屯鎮,0205,380,176,556,21,577,923,62.51%,41.17%,1
南投縣,草屯鎮,0206,353,159,512,27,539,970,55.57%,36.39%,1
南投縣,草屯鎮,0207,396,192,588,20,608,1026,59.26%,38.6%,1
南投縣,草屯鎮,0208,550,240,790,45,835,1466,56.96%,37.52%,1
南投縣,草屯鎮,0209,459,190,649,31,680,1180,57.63%,38.9%,1
南投縣,草屯鎮,0210,398,192,590,20,610,1006,60.64%,39.56%,1
南投縣,草屯鎮,0211,329,145,474,31,505,1000,50.5%,32.9%,1
南投縣,草屯鎮,0212,459,207,666,27,693,1128,61.44%,40.69%,1
南投縣,草屯鎮,0213,228,115,343,9,352,623,56.5%,36.6%,1
南投縣,草屯鎮,0214,253,133,386,31,417,707,58.98%,35.79%,1
南投縣,草屯鎮,0215,284,95,379,26,405,719,56.33%,39.5%,1
南投縣,草屯鎮,0216,174,67,241,18,259,527,49.15%,33.02%,1
南投縣,草屯鎮,0217,440,226,666,42,708,1183,59.85%,37.19%,1
南投縣,草屯鎮,0218,359,152,511,28,539,869,62.03%,41.31%,1
南投縣,草屯鎮,0219,378,202,580,16,596,1132,52.65%,33.39%,1
南投縣,草屯鎮,0220,361,157,518,50,568,949,59.85%,38.04%,1
南投縣,草屯鎮,0221,379,185,564,21,585,965,60.62%,39.27%,1
南投縣,草屯鎮,0222,365,187,552,32,584,1068,54.68%,34.18%,1
南投縣,草屯鎮,0223,396,179,575,52,627,1024,61.23%,38.67%,1
南投縣,草屯鎮,0224,236,96,332,20,352,642,54.83%,36.76%,1
南投縣,草屯鎮,0225,342,159,501,38,539,1017,53%,33.63%,1
南投縣,草屯鎮,0226,418,182,600,28,628,1092,57.51%,38.28%,1
南投縣,草屯鎮,0227,426,189,615,47,662,1170,56.58%,36.41%,1
南投縣,草屯鎮,0228,417,202,619,48,667,1106,60.31%,37.7%,1
南投縣,竹山鎮,0229,480,181,661,44,705,1170,60.26%,41.03%,1
南投縣,竹山鎮,0230,353,149,502,33,535,850,62.94%,41.53%,1
南投縣,竹山鎮,0231,210,108,318,25,343,621,55.23%,33.82%,1
南投縣,竹山鎮,0232,338,146,484,22,506,905,55.91%,37.35%,1
南投縣,竹山鎮,0233,363,152,515,41,556,1099,50.59%,33.03%,1
南投縣,竹山鎮,0234,431,158,589,55,644,1214,53.05%,35.5%,1
南投縣,竹山鎮,0235,508,212,720,59,779,1287,60.53%,39.47%,1
南投縣,竹山鎮,0236,451,181,632,48,680,1191,57.09%,37.87%,1
南投縣,竹山鎮,0237,432,148,580,57,637,1118,56.98%,38.64%,1
南投縣,竹山鎮,0238,485,218,703,21,724,1278,56.65%,37.95%,1
南投縣,竹山鎮,0239,439,184,623,50,673,1153,58.37%,38.07%,1
南投縣,竹山鎮,0240,431,186,617,43,660,1243,53.1%,34.67%,1
南投縣,竹山鎮,0241,499,201,700,39,739,1308,56.5%,38.15%,1
南投縣,竹山鎮,0242,508,191,699,32,731,1358,53.83%,37.41%,1
南投縣,竹山鎮,0243,385,152,537,39,576,1044,55.17%,36.88%,1
南投縣,竹山鎮,0244,215,85,300,21,321,511,62.82%,42.07%,1
南投縣,竹山鎮,0245,260,92,352,18,370,682,54.25%,38.12%,1
南投縣,竹山鎮,0246,333,156,489,23,512,989,51.77%,33.67%,1
南投縣,竹山鎮,0247,523,200,723,53,776,1378,56.31%,37.95%,1
南投縣,竹山鎮,0248,61,47,108,6,114,217,52.53%,28.11%,1
南投縣,竹山鎮,0249,178,87,265,23,288,479,60.13%,37.16%,1
南投縣,竹山鎮,0250,139,62,201,10,211,430,49.07%,32.33%,1
南投縣,竹山鎮,0251,531,229,760,50,810,1437,56.37%,36.95%,1
南投縣,竹山鎮,0252,515,229,744,30,774,1286,60.19%,40.05%,1
南投縣,竹山鎮,0253,537,77,614,44,658,1080,60.93%,49.72%,1
南投縣,竹山鎮,0254,391,175,566,33,599,1070,55.98%,36.54%,1
南投縣,竹山鎮,0255,509,209,718,35,753,1295,58.15%,39.31%,1
南投縣,竹山鎮,0256,429,147,576,27,603,1047,57.59%,40.97%,1
南投縣,竹山鎮,0257,566,215,781,41,822,1300,63.23%,43.54%,1
南投縣,竹山鎮,0258,288,128,416,18,434,908,47.8%,31.72%,1
南投縣,竹山鎮,0259,241,134,375,46,421,821,51.28%,29.35%,1
南投縣,竹山鎮,0260,530,190,720,47,767,1320,58.11%,40.15%,1
南投縣,竹山鎮,0261,351,141,492,22,514,967,53.15%,36.3%,1
南投縣,竹山鎮,0262,201,80,281,18,299,595,50.25%,33.78%,1
南投縣,竹山鎮,0263,290,135,425,52,477,859,55.53%,33.76%,1
南投縣,竹山鎮,0264,442,169,611,35,646,1196,54.01%,36.96%,1
南投縣,竹山鎮,0265,247,96,343,27,370,649,57.01%,38.06%,1
南投縣,竹山鎮,0266,497,215,712,44,756,1341,56.38%,37.06%,1
南投縣,竹山鎮,0267,438,163,601,41,642,1222,52.54%,35.84%,1
南投縣,竹山鎮,0268,223,100,323,27,350,602,58.14%,37.04%,1
南投縣,竹山鎮,0269,225,95,320,26,346,617,56.08%,36.47%,1
南投縣,竹山鎮,0270,315,141,456,34,490,793,61.79%,39.72%,1
南投縣,竹山鎮,0271,348,156,504,20,524,922,56.83%,37.74%,1
南投縣,竹山鎮,0272,135,46,181,16,197,366,53.83%,36.89%,1
南投縣,竹山鎮,0273,175,58,233,0,233,509,45.78%,34.38%,1
南投縣,竹山鎮,0274,72,30,102,7,109,193,56.48%,37.31%,1
南投縣,竹山鎮,0275,166,69,235,17,252,406,62.07%,40.89%,1
南投縣,竹山鎮,0276,158,70,228,24,252,495,50.91%,31.92%,1
南投縣,竹山鎮,0277,78,27,105,10,115,307,37.46%,25.41%,1
南投縣,竹山鎮,0278,151,54,205,30,235,440,53.41%,34.32%,1
南投縣,竹山鎮,0279,202,73,275,39,314,577,54.42%,35.01%,1
南投縣,竹山鎮,0280,126,63,189,26,215,486,44.24%,25.93%,1
南投縣,竹山鎮,0281,93,43,136,15,151,403,37.47%,23.08%,1
南投縣,集集鎮,0282,445,172,617,34,651,1070,60.84%,41.59%,1
南投縣,集集鎮,0283,394,142,536,24,560,918,61%,42.92%,1
南投縣,集集鎮,0284,229,96,325,28,353,581,60.76%,39.41%,1
南投縣,集集鎮,0285,486,200,686,33,719,1194,60.22%,40.7%,1
南投縣,集集鎮,0286,142,66,208,17,225,488,46.11%,29.1%,1
南投縣,集集鎮,0287,206,88,294,19,313,504,62.1%,40.87%,1
南投縣,集集鎮,0288,344,155,499,64,563,910,61.87%,37.8%,1
南投縣,集集鎮,0289,247,197,444,42,486,773,62.87%,31.95%,1
南投縣,集集鎮,0290,257,126,383,20,403,709,56.84%,36.25%,1
南投縣,集集鎮,0291,352,174,526,27,553,960,57.6%,36.67%,1
南投縣,集集鎮,0292,173,86,259,18,277,503,55.07%,34.39%,1
南投縣,集集鎮,0293,128,69,197,16,213,419,50.84%,30.55%,1
南投縣,集集鎮,0294,183,77,260,13,273,582,46.91%,31.44%,1
南投縣,名間鄉,0295,492,193,685,48,733,1050,69.81%,46.86%,1
南投縣,名間鄉,0296,384,131,515,46,561,920,60.98%,41.74%,1
南投縣,名間鄉,0297,337,113,450,27,477,727,65.61%,46.35%,1
南投縣,名間鄉,0298,390,136,526,27,553,861,64.23%,45.3%,1
南投縣,名間鄉,0299,344,152,496,33,529,897,58.97%,38.35%,1
南投縣,名間鄉,0300,427,184,611,37,648,1055,61.42%,40.47%,1
南投縣,名間鄉,0301,447,206,653,29,682,1184,57.6%,37.75%,1
南投縣,名間鄉,0302,285,127,412,34,446,783,56.96%,36.4%,1
南投縣,名間鄉,0303,335,122,457,31,488,781,62.48%,42.89%,1
南投縣,名間鄉,0304,396,136,532,28,560,977,57.32%,40.53%,1
南投縣,名間鄉,0305,359,144,503,68,571,1015,56.26%,35.37%,1
南投縣,名間鄉,0306,376,155,531,29,560,914,61.27%,41.14%,1
南投縣,名間鄉,0307,392,179,571,20,591,1028,57.49%,38.13%,1
南投縣,名間鄉,0308,427,165,592,29,621,1018,61%,41.94%,1
南投縣,名間鄉,0309,518,195,713,43,756,1274,59.34%,40.66%,1
南投縣,名間鄉,0310,302,123,425,31,456,755,60.4%,40%,1
南投縣,名間鄉,0311,380,168,548,44,592,895,66.15%,42.46%,1
南投縣,名間鄉,0312,386,120,506,24,530,892,59.42%,43.27%,1
南投縣,名間鄉,0313,349,156,505,49,554,951,58.25%,36.7%,1
南投縣,名間鄉,0314,489,189,678,48,726,1261,57.57%,38.78%,1
南投縣,名間鄉,0315,281,134,415,30,445,768,57.94%,36.59%,1
南投縣,名間鄉,0316,387,160,547,36,583,962,60.6%,40.23%,1
南投縣,名間鄉,0317,352,143,495,40,535,867,61.71%,40.6%,1
南投縣,名間鄉,0318,352,169,521,46,567,930,60.97%,37.85%,1
南投縣,名間鄉,0319,241,95,336,53,389,641,60.69%,37.6%,1
南投縣,名間鄉,0320,196,73,269,15,284,530,53.58%,36.98%,1
南投縣,名間鄉,0321,351,162,513,47,560,931,60.15%,37.7%,1
南投縣,名間鄉,0322,447,182,629,43,672,1127,59.63%,39.66%,1
南投縣,名間鄉,0323,184,91,275,21,296,443,66.82%,41.53%,1
南投縣,名間鄉,0324,362,132,494,41,535,870,61.49%,41.61%,1
南投縣,名間鄉,0325,257,113,370,23,393,621,63.29%,41.38%,1
南投縣,名間鄉,0326,442,167,609,36,645,1179,54.71%,37.49%,1
南投縣,名間鄉,0327,369,144,513,46,559,881,63.45%,41.88%,1
南投縣,名間鄉,0328,398,158,556,40,596,876,68.04%,45.43%,1
南投縣,名間鄉,0329,329,106,435,41,476,783,60.79%,42.02%,1
南投縣,名間鄉,0330,288,101,389,36,425,778,54.63%,37.02%,1
南投縣,名間鄉,0331,155,353,508,33,541,983,55.04%,15.77%,1
南投縣,鹿谷鄉,0332,355,102,457,29,486,934,52.03%,38.01%,1
南投縣,鹿谷鄉,0333,362,147,509,31,540,940,57.45%,38.51%,1
南投縣,鹿谷鄉,0334,293,142,435,22,457,852,53.64%,34.39%,1
南投縣,鹿谷鄉,0335,134,70,204,12,216,451,47.89%,29.71%,1
南投縣,鹿谷鄉,0336,347,121,468,28,496,810,61.23%,42.84%,1
南投縣,鹿谷鄉,0337,475,192,667,46,713,1142,62.43%,41.59%,1
南投縣,鹿谷鄉,0338,250,103,353,21,374,766,48.83%,32.64%,1
南投縣,鹿谷鄉,0339,358,124,482,36,518,884,58.6%,40.5%,1
南投縣,鹿谷鄉,0340,269,157,426,34,460,811,56.72%,33.17%,1
南投縣,鹿谷鄉,0341,176,79,255,23,278,581,47.85%,30.29%,1
南投縣,鹿谷鄉,0342,188,79,267,29,296,578,51.21%,32.53%,1
南投縣,鹿谷鄉,0343,181,75,256,23,279,467,59.74%,38.76%,1
南投縣,鹿谷鄉,0344,249,67,316,30,346,622,55.63%,40.03%,1
南投縣,鹿谷鄉,0345,257,100,357,28,385,740,52.03%,34.73%,1
南投縣,鹿谷鄉,0346,298,96,394,39,433,767,56.45%,38.85%,1
南投縣,鹿谷鄉,0347,337,149,486,45,531,909,58.42%,37.07%,1
南投縣,鹿谷鄉,0348,252,102,354,22,376,713,52.73%,35.34%,1
南投縣,鹿谷鄉,0349,226,93,319,19,338,717,47.14%,31.52%,1
南投縣,鹿谷鄉,0350,264,111,375,31,406,794,51.13%,33.25%,1
南投縣,鹿谷鄉,0351,223,126,349,21,370,726,50.96%,30.72%,1
南投縣,鹿谷鄉,0352,198,96,294,26,320,737,43.42%,26.87%,1
南投縣,中寮鄉,0353,333,139,472,37,509,822,61.92%,40.51%,1
南投縣,中寮鄉,0354,109,37,146,9,155,253,61.26%,43.08%,1
南投縣,中寮鄉,0355,61,21,82,12,94,221,42.53%,27.6%,1
南投縣,中寮鄉,0356,108,41,149,7,156,353,44.19%,30.59%,1
南投縣,中寮鄉,0357,148,70,218,19,237,427,55.5%,34.66%,1
南投縣,中寮鄉,0358,153,60,213,17,230,406,56.65%,37.68%,1
南投縣,中寮鄉,0359,98,44,142,19,161,307,52.44%,31.92%,1
南投縣,中寮鄉,0360,284,91,375,29,404,661,61.12%,42.97%,1
南投縣,中寮鄉,0361,137,42,179,14,193,290,66.55%,47.24%,1
南投縣,中寮鄉,0362,348,187,535,39,574,973,58.99%,35.77%,1
南投縣,中寮鄉,0363,306,122,428,28,456,754,60.48%,40.58%,1
南投縣,中寮鄉,0364,240,103,343,26,369,662,55.74%,36.25%,1
南投縣,中寮鄉,0365,186,53,239,13,252,490,51.43%,37.96%,1
南投縣,中寮鄉,0366,111,50,161,15,176,335,52.54%,33.13%,1
南投縣,中寮鄉,0367,387,150,537,39,576,990,58.18%,39.09%,1
南投縣,中寮鄉,0368,214,61,275,21,296,461,64.21%,46.42%,1
南投縣,中寮鄉,0369,242,125,367,14,381,614,62.05%,39.41%,1
南投縣,中寮鄉,0370,320,138,458,56,514,895,57.43%,35.75%,1
南投縣,中寮鄉,0371,190,63,253,14,267,465,57.42%,40.86%,1
南投縣,中寮鄉,0372,234,114,348,57,405,682,59.38%,34.31%,1
南投縣,中寮鄉,0373,193,79,272,31,303,490,61.84%,39.39%,1
南投縣,中寮鄉,0374,262,93,355,41,396,643,61.59%,40.75%,1
南投縣,中寮鄉,0375,201,67,268,17,285,459,62.09%,43.79%,1
南投縣,中寮鄉,0376,179,76,255,13,268,528,50.76%,33.9%,1
南投縣,魚池鄉,0377,341,159,500,31,531,922,57.59%,36.98%,1
南投縣,魚池鄉,0378,398,192,590,58,648,1098,59.02%,36.25%,1
南投縣,魚池鄉,0379,239,121,360,27,387,720,53.75%,33.19%,1
南投縣,魚池鄉,0380,350,128,478,32,510,860,59.3%,40.7%,1
南投縣,魚池鄉,0381,169,66,235,29,264,514,51.36%,32.88%,1
南投縣,魚池鄉,0382,197,87,284,8,292,574,50.87%,34.32%,1
南投縣,魚池鄉,0383,444,190,634,42,676,1249,54.12%,35.55%,1
南投縣,魚池鄉,0384,136,50,186,8,194,293,66.21%,46.42%,1
南投縣,魚池鄉,0385,176,83,259,19,278,513,54.19%,34.31%,1
南投縣,魚池鄉,0386,57,37,94,9,103,186,55.38%,30.65%,1
南投縣,魚池鄉,0387,298,118,416,20,436,841,51.84%,35.43%,1
南投縣,魚池鄉,0388,99,54,153,17,170,270,62.96%,36.67%,1
南投縣,魚池鄉,0389,96,48,144,10,154,275,56%,34.91%,1
南投縣,魚池鄉,0390,89,34,123,8,131,282,46.45%,31.56%,1
南投縣,魚池鄉,0391,122,57,179,14,193,392,49.23%,31.12%,1
南投縣,魚池鄉,0392,206,74,280,25,305,556,54.86%,37.05%,1
南投縣,魚池鄉,0393,71,21,92,5,97,176,55.11%,40.34%,1
南投縣,魚池鄉,0394,179,79,258,18,276,578,47.75%,30.97%,1
南投縣,魚池鄉,0395,136,71,207,17,224,439,51.03%,30.98%,1
南投縣,魚池鄉,0396,342,130,472,27,499,844,59.12%,40.52%,1
南投縣,魚池鄉,0397,302,146,448,27,475,868,54.72%,34.79%,1
南投縣,魚池鄉,0398,134,46,180,11,191,405,47.16%,33.09%,1
南投縣,魚池鄉,0399,209,80,289,17,306,537,56.98%,38.92%,1
南投縣,魚池鄉,0400,124,39,163,21,184,335,54.93%,37.01%,1
南投縣,魚池鄉,0401,77,16,93,11,104,231,45.02%,33.33%,1
南投縣,國姓鄉,0402,402,152,554,47,601,964,62.34%,41.7%,1
南投縣,國姓鄉,0403,295,103,398,17,415,736,56.39%,40.08%,1
南投縣,國姓鄉,0404,325,104,429,43,472,801,58.93%,40.57%,1
南投縣,國姓鄉,0405,358,174,532,17,549,964,56.95%,37.14%,1
南投縣,國姓鄉,0406,247,109,356,31,387,686,56.41%,36.01%,1
南投縣,國姓鄉,0407,244,91,335,27,362,661,54.77%,36.91%,1
南投縣,國姓鄉,0408,264,99,363,19,382,730,52.33%,36.16%,1
南投縣,國姓鄉,0409,266,127,393,43,436,774,56.33%,34.37%,1
南投縣,國姓鄉,0410,281,124,405,19,424,706,60.06%,39.8%,1
南投縣,國姓鄉,0411,400,138,538,38,576,1012,56.92%,39.53%,1
南投縣,國姓鄉,0412,287,121,408,12,420,868,48.39%,33.06%,1
南投縣,國姓鄉,0413,419,116,535,26,561,918,61.11%,45.64%,1
南投縣,國姓鄉,0414,347,144,491,47,538,937,57.42%,37.03%,1
南投縣,國姓鄉,0415,290,122,412,38,450,815,55.21%,35.58%,1
南投縣,國姓鄉,0416,453,192,645,40,685,1134,60.41%,39.95%,1
南投縣,國姓鄉,0417,250,117,367,20,387,714,54.2%,35.01%,1
南投縣,國姓鄉,0418,418,166,584,38,622,1095,56.8%,38.17%,1
南投縣,國姓鄉,0419,150,62,212,25,237,448,52.9%,33.48%,1
南投縣,國姓鄉,0420,402,132,534,39,573,1064,53.85%,37.78%,1
南投縣,國姓鄉,0421,201,72,273,26,299,570,52.46%,35.26%,1
南投縣,水里鄉,0422,294,113,407,16,423,757,55.88%,38.84%,1
南投縣,水里鄉,0423,203,79,282,32,314,554,56.68%,36.64%,1
南投縣,水里鄉,0424,359,178,537,42,579,999,57.96%,35.94%,1
南投縣,水里鄉,0425,252,76,328,12,340,616,55.19%,40.91%,1
南投縣,水里鄉,0426,373,129,502,27,529,875,60.46%,42.63%,1
南投縣,水里鄉,0427,202,76,278,14,292,480,60.83%,42.08%,1
南投縣,水里鄉,0428,172,52,224,24,248,450,55.11%,38.22%,1
南投縣,水里鄉,0429,217,102,319,37,356,643,55.37%,33.75%,1
南投縣,水里鄉,0430,399,172,571,20,591,1004,58.86%,39.74%,1
南投縣,水里鄉,0431,264,117,381,22,403,741,54.39%,35.63%,1
南投縣,水里鄉,0432,281,180,461,10,471,802,58.73%,35.04%,1
南投縣,水里鄉,0433,417,182,599,40,639,998,64.03%,41.78%,1
南投縣,水里鄉,0434,266,131,397,45,442,800,55.25%,33.25%,1
南投縣,水里鄉,0435,251,97,348,19,367,589,62.31%,42.61%,1
南投縣,水里鄉,0436,320,107,427,41,468,887,52.76%,36.08%,1
南投縣,水里鄉,0437,438,165,603,35,638,1217,52.42%,35.99%,1
南投縣,水里鄉,0438,57,18,75,4,79,205,38.54%,27.8%,1
南投縣,水里鄉,0439,137,56,193,16,209,330,63.33%,41.52%,1
南投縣,水里鄉,0440,395,154,549,29,578,1100,52.55%,35.91%,1
南投縣,水里鄉,0441,71,26,97,7,104,275,37.82%,25.82%,1
南投縣,水里鄉,0442,81,50,131,5,136,318,42.77%,25.47%,1
南投縣,水里鄉,0443,297,108,405,41,446,818,54.52%,36.31%,1
南投縣,信義鄉,0444,493,154,647,33,680,1201,56.62%,41.05%,1
南投縣,信義鄉,0445,125,37,162,14,176,329,53.5%,37.99%,1
南投縣,信義鄉,0446,171,90,261,12,273,516,52.91%,33.14%,1
南投縣,信義鄉,0447,124,59,183,17,200,424,47.17%,29.25%,1
南投縣,信義鄉,0448,122,42,164,5,169,321,52.65%,38.01%,1
南投縣,信義鄉,0449,321,80,401,30,431,648,66.51%,49.54%,1
南投縣,信義鄉,0450,342,60,402,27,429,584,73.46%,58.56%,1
南投縣,信義鄉,0451,740,144,884,29,913,1376,66.35%,53.78%,1
南投縣,信義鄉,0452,482,127,609,20,629,979,64.25%,49.23%,1
南投縣,信義鄉,0453,289,82,371,29,400,530,75.47%,54.53%,1
南投縣,信義鄉,0454,362,123,485,28,513,961,53.38%,37.67%,1
南投縣,信義鄉,0455,190,58,248,9,257,464,55.39%,40.95%,1
南投縣,信義鄉,0456,194,92,286,22,308,517,59.57%,37.52%,1
南投縣,信義鄉,0457,57,24,81,8,89,149,59.73%,38.26%,1
南投縣,信義鄉,0458,620,112,732,32,764,1020,74.9%,60.78%,1
南投縣,信義鄉,0459,468,105,573,64,637,929,68.57%,50.38%,1
南投縣,信義鄉,0460,93,31,124,6,130,274,47.45%,33.94%,1
南投縣,信義鄉,0461,480,110,590,43,633,900,70.33%,53.33%,1
南投縣,信義鄉,0462,307,105,412,39,451,617,73.1%,49.76%,1
南投縣,信義鄉,0463,263,105,368,24,392,560,70%,46.96%,1
南投縣,仁愛鄉,0464,409,163,572,14,586,973,60.23%,42.03%,1
南投縣,仁愛鄉,0465,93,47,140,10,150,296,50.68%,31.42%,1
南投縣,仁愛鄉,0466,294,131,425,14,439,900,48.78%,32.67%,1
南投縣,仁愛鄉,0467,196,84,280,18,298,460,64.78%,42.61%,1
南投縣,仁愛鄉,0468,127,43,170,13,183,305,60%,41.64%,1
南投縣,仁愛鄉,0469,17,1,18,2,20,58,34.48%,29.31%,1
南投縣,仁愛鄉,0470,344,105,449,11,460,952,48.32%,36.13%,1
南投縣,仁愛鄉,0471,255,71,326,6,332,679,48.9%,37.56%,1
南投縣,仁愛鄉,0472,270,81,351,18,369,623,59.23%,43.34%,1
南投縣,仁愛鄉,0473,253,72,325,8,333,597,55.78%,42.38%,1
南投縣,仁愛鄉,0474,182,45,227,21,248,384,64.58%,47.4%,1
南投縣,仁愛鄉,0475,48,13,61,1,62,121,51.24%,39.67%,1
南投縣,仁愛鄉,0476,131,30,161,6,167,264,63.26%,49.62%,1
南投縣,仁愛鄉,0477,286,87,373,17,390,509,76.62%,56.19%,1
南投縣,仁愛鄉,0478,147,46,193,14,207,338,61.24%,43.49%,1
南投縣,仁愛鄉,0479,65,22,87,0,87,169,51.48%,38.46%,1
南投縣,仁愛鄉,0480,203,80,283,10,293,613,47.8%,33.12%,1
南投縣,仁愛鄉,0481,122,63,185,5,190,404,47.03%,30.2%,1
南投縣,仁愛鄉,0482,52,21,73,4,77,134,57.46%,38.81%,1
南投縣,仁愛鄉,0483,287,106,393,20,413,630,65.56%,45.56%,1
南投縣,仁愛鄉,0484,260,104,364,8,372,763,48.75%,34.08%,1
南投縣,仁愛鄉,0485,426,113,539,35,574,889,64.57%,47.92%,1
南投縣,仁愛鄉,0486,343,79,422,18,440,672,65.48%,51.04%,1
南投縣,仁愛鄉,0487,191,73,264,8,272,447,60.85%,42.73%,1
南投縣,仁愛鄉,0488,231,62,293,10,303,409,74.08%,56.48%,1
雲林縣,斗六市,0411,204,133,337,18,355,644,55.12%,31.68%,1
雲林縣,斗六市,0412,219,110,329,20,349,617,56.56%,35.49%,1
雲林縣,斗六市,0413,303,168,471,33,504,764,65.97%,39.66%,1
雲林縣,斗六市,0414,324,149,473,20,493,784,62.88%,41.33%,1
雲林縣,斗六市,0415,275,131,406,22,428,760,56.32%,36.18%,1
雲林縣,斗六市,0416,733,355,1088,51,1139,1881,60.55%,38.97%,1
雲林縣,斗六市,0417,673,285,958,47,1005,1829,54.95%,36.8%,1
雲林縣,斗六市,0418,532,238,770,26,796,1255,63.43%,42.39%,1
雲林縣,斗六市,0419,476,205,681,23,704,1090,64.59%,43.67%,1
雲林縣,斗六市,0420,453,194,647,28,675,1103,61.2%,41.07%,1
雲林縣,斗六市,0421,464,216,680,31,711,1176,60.46%,39.46%,1
雲林縣,斗六市,0422,596,250,846,27,873,1529,57.1%,38.98%,1
雲林縣,斗六市,0423,554,207,761,27,788,1335,59.03%,41.5%,1
雲林縣,斗六市,0424,692,341,1033,45,1078,1770,60.9%,39.1%,1
雲林縣,斗六市,0425,515,233,748,31,779,1308,59.56%,39.37%,1
雲林縣,斗六市,0426,796,333,1129,47,1176,2171,54.17%,36.67%,1
雲林縣,斗六市,0427,476,193,669,26,695,1193,58.26%,39.9%,1
雲林縣,斗六市,0428,661,288,949,28,977,1572,62.15%,42.05%,1
雲林縣,斗六市,0429,389,168,557,21,578,1009,57.28%,38.55%,1
雲林縣,斗六市,0430,488,228,716,33,749,1195,62.68%,40.84%,1
雲林縣,斗六市,0431,572,250,822,51,873,1415,61.7%,40.42%,1
雲林縣,斗六市,0432,452,197,649,28,677,1101,61.49%,41.05%,1
雲林縣,斗六市,0433,602,288,890,30,920,1648,55.83%,36.53%,1
雲林縣,斗六市,0434,577,229,806,30,836,1588,52.64%,36.34%,1
雲林縣,斗六市,0435,532,276,808,21,829,1392,59.55%,38.22%,1
雲林縣,斗六市,0436,441,273,714,24,738,1422,51.9%,31.01%,1
雲林縣,斗六市,0437,404,145,549,28,577,1187,48.61%,34.04%,1
雲林縣,斗六市,0438,381,191,572,27,599,1142,52.45%,33.36%,1
雲林縣,斗六市,0439,583,264,847,28,875,1421,61.58%,41.03%,1
雲林縣,斗六市,0440,475,225,700,25,725,1261,57.49%,37.67%,1
雲林縣,斗六市,0441,535,265,800,24,824,1506,54.71%,35.52%,1
雲林縣,斗六市,0442,440,253,693,32,725,1214,59.72%,36.24%,1
雲林縣,斗六市,0443,577,259,836,36,872,1362,64.02%,42.36%,1
雲林縣,斗六市,0444,397,200,597,17,614,1097,55.97%,36.19%,1
雲林縣,斗六市,0445,503,216,719,23,742,1262,58.8%,39.86%,1
雲林縣,斗六市,0446,409,201,610,26,636,1154,55.11%,35.44%,1
雲林縣,斗六市,0447,314,160,474,22,496,847,58.56%,37.07%,1
雲林縣,斗六市,0448,543,272,815,28,843,1439,58.58%,37.73%,1
雲林縣,斗六市,0449,672,351,1023,48,1071,1747,61.31%,38.47%,1
雲林縣,斗六市,0450,524,270,794,25,819,1418,57.76%,36.95%,1
雲林縣,斗六市,0451,425,171,596,32,628,1112,56.47%,38.22%,1
雲林縣,斗六市,0452,485,246,731,29,760,1302,58.37%,37.25%,1
雲林縣,斗六市,0453,289,131,420,24,444,669,66.37%,43.2%,1
雲林縣,斗六市,0454,264,144,408,27,435,752,57.85%,35.11%,1
雲林縣,斗六市,0455,528,243,771,24,795,1450,54.83%,36.41%,1
雲林縣,斗六市,0456,211,85,296,25,321,555,57.84%,38.02%,1
雲林縣,斗六市,0457,514,227,741,31,772,1470,52.52%,34.97%,1
雲林縣,斗六市,0458,386,162,548,15,563,927,60.73%,41.64%,1
雲林縣,斗六市,0459,720,346,1066,37,1103,1893,58.27%,38.03%,1
雲林縣,斗六市,0460,638,292,930,62,992,1708,58.08%,37.35%,1
雲林縣,斗六市,0461,602,264,866,42,908,1773,51.21%,33.95%,1
雲林縣,斗六市,0462,558,252,810,28,838,1412,59.35%,39.52%,1
雲林縣,斗六市,0463,571,248,819,29,848,1354,62.63%,42.17%,1
雲林縣,斗六市,0464,461,241,702,24,726,1267,57.3%,36.39%,1
雲林縣,斗六市,0465,457,222,679,21,700,1273,54.99%,35.9%,1
雲林縣,斗六市,0466,616,232,848,52,900,1748,51.49%,35.24%,1
雲林縣,斗六市,0467,491,201,692,42,734,1238,59.29%,39.66%,1
雲林縣,斗六市,0468,607,247,854,36,890,1648,54%,36.83%,1
雲林縣,斗六市,0469,608,278,886,30,916,1520,60.26%,40%,1
雲林縣,斗六市,0470,410,156,566,27,593,1087,54.55%,37.72%,1
雲林縣,斗六市,0471,702,333,1035,47,1082,1904,56.83%,36.87%,1
雲林縣,斗六市,0472,295,115,410,26,436,702,62.11%,42.02%,1
雲林縣,斗六市,0473,451,196,647,28,675,1111,60.76%,40.59%,1
雲林縣,斗六市,0474,384,161,545,26,571,1123,50.85%,34.19%,1
雲林縣,斗六市,0475,409,186,595,34,629,1146,54.89%,35.69%,1
雲林縣,斗六市,0476,599,323,922,41,963,1786,53.92%,33.54%,1
雲林縣,斗六市,0477,369,190,559,44,603,1023,58.94%,36.07%,1
雲林縣,斗六市,0478,735,360,1095,57,1152,2072,55.6%,35.47%,1
雲林縣,斗六市,0479,397,188,585,23,608,1128,53.9%,35.2%,1
雲林縣,斗南鎮,0498,480,197,677,36,713,1166,61.15%,41.17%,1
雲林縣,斗南鎮,0499,480,198,678,34,712,1135,62.73%,42.29%,1
雲林縣,斗南鎮,0500,409,175,584,21,605,975,62.05%,41.95%,1
雲林縣,斗南鎮,0501,568,272,840,37,877,1459,60.11%,38.93%,1
雲林縣,斗南鎮,0502,488,267,755,41,796,1351,58.92%,36.12%,1
雲林縣,斗南鎮,0503,488,225,713,35,748,1321,56.62%,36.94%,1
雲林縣,斗南鎮,0504,341,126,467,32,499,907,55.02%,37.6%,1
雲林縣,斗南鎮,0505,608,273,881,47,928,1473,63%,41.28%,1
雲林縣,斗南鎮,0506,495,256,751,53,804,1277,62.96%,38.76%,1
雲林縣,斗南鎮,0507,488,214,702,55,757,1333,56.79%,36.61%,1
雲林縣,斗南鎮,0508,300,111,411,21,432,777,55.6%,38.61%,1
雲林縣,斗南鎮,0509,274,165,439,31,470,877,53.59%,31.24%,1
雲林縣,斗南鎮,0510,341,108,449,44,493,899,54.84%,37.93%,1
雲林縣,斗南鎮,0511,225,78,303,31,334,688,48.55%,32.7%,1
雲林縣,斗南鎮,0512,424,60,484,31,515,1147,44.9%,36.97%,1
雲林縣,斗南鎮,0513,591,309,900,65,965,1709,56.47%,34.58%,1
雲林縣,斗南鎮,0514,426,180,606,36,642,1042,61.61%,40.88%,1
雲林縣,斗南鎮,0515,569,285,854,49,903,1631,55.36%,34.89%,1
雲林縣,斗南鎮,0516,676,296,972,57,1029,1702,60.46%,39.72%,1
雲林縣,斗南鎮,0517,638,251,889,39,928,1564,59.34%,40.79%,1
雲林縣,斗南鎮,0518,291,120,411,26,437,910,48.02%,31.98%,1
雲林縣,斗南鎮,0519,536,222,758,37,795,1276,62.3%,42.01%,1
雲林縣,斗南鎮,0520,317,109,426,19,445,897,49.61%,35.34%,1
雲林縣,斗南鎮,0521,299,130,429,26,455,803,56.66%,37.24%,1
雲林縣,斗南鎮,0522,319,138,457,49,506,866,58.43%,36.84%,1
雲林縣,斗南鎮,0523,327,134,461,42,503,852,59.04%,38.38%,1
雲林縣,斗南鎮,0524,251,111,362,25,387,671,57.68%,37.41%,1
雲林縣,斗南鎮,0525,339,175,514,23,537,981,54.74%,34.56%,1
雲林縣,斗南鎮,0526,354,167,521,24,545,1129,48.27%,31.36%,1
雲林縣,斗南鎮,0527,583,280,863,77,940,1586,59.27%,36.76%,1
雲林縣,斗南鎮,0528,503,225,728,36,764,1243,61.46%,40.47%,1
雲林縣,斗南鎮,0529,357,140,497,17,514,984,52.24%,36.28%,1
雲林縣,斗南鎮,0530,588,244,832,65,897,1507,59.52%,39.02%,1
雲林縣,虎尾鎮,0109,478,232,710,34,744,1347,55.23%,35.49%,1
雲林縣,虎尾鎮,0110,472,236,708,31,739,1258,58.74%,37.52%,1
雲林縣,虎尾鎮,0111,295,125,420,24,444,785,56.56%,37.58%,1
雲林縣,虎尾鎮,0112,283,126,409,29,438,890,49.21%,31.8%,1
雲林縣,虎尾鎮,0113,563,245,808,38,846,1413,59.87%,39.84%,1
雲林縣,虎尾鎮,0114,583,259,842,34,876,1431,61.22%,40.74%,1
雲林縣,虎尾鎮,0115,434,191,625,34,659,1224,53.84%,35.46%,1
雲林縣,虎尾鎮,0116,335,206,541,22,563,1325,42.49%,25.28%,1
雲林縣,虎尾鎮,0117,360,174,534,39,573,941,60.89%,38.26%,1
雲林縣,虎尾鎮,0118,596,264,860,23,883,1613,54.74%,36.95%,1
雲林縣,虎尾鎮,0119,557,287,844,26,870,1641,53.02%,33.94%,1
雲林縣,虎尾鎮,0120,462,219,681,31,712,1200,59.33%,38.5%,1
雲林縣,虎尾鎮,0121,473,245,718,42,760,1294,58.73%,36.55%,1
雲林縣,虎尾鎮,0122,489,228,717,12,729,1273,57.27%,38.41%,1
雲林縣,虎尾鎮,0123,511,346,857,29,886,1438,61.61%,35.54%,1
雲林縣,虎尾鎮,0124,521,241,762,24,786,1361,57.75%,38.28%,1
雲林縣,虎尾鎮,0125,583,246,829,39,868,1444,60.11%,40.37%,1
雲林縣,虎尾鎮,0126,635,273,908,30,938,1490,62.95%,42.62%,1
雲林縣,虎尾鎮,0127,510,277,787,44,831,1307,63.58%,39.02%,1
雲林縣,虎尾鎮,0128,293,177,470,18,488,967,50.47%,30.3%,1
雲林縣,虎尾鎮,0129,663,311,974,20,994,1865,53.3%,35.55%,1
雲林縣,虎尾鎮,0130,676,333,1009,33,1042,1880,55.43%,35.96%,1
雲林縣,虎尾鎮,0131,375,173,548,35,583,1099,53.05%,34.12%,1
雲林縣,虎尾鎮,0132,346,153,499,17,516,901,57.27%,38.4%,1
雲林縣,虎尾鎮,0133,389,191,580,31,611,1120,54.55%,34.73%,1
雲林縣,虎尾鎮,0134,168,79,247,5,252,545,46.24%,30.83%,1
雲林縣,虎尾鎮,0135,498,230,728,43,771,1420,54.3%,35.07%,1
雲林縣,虎尾鎮,0136,427,191,618,26,644,1248,51.6%,34.21%,1
雲林縣,虎尾鎮,0137,291,127,418,19,437,799,54.69%,36.42%,1
雲林縣,虎尾鎮,0138,264,149,413,34,447,836,53.47%,31.58%,1
雲林縣,虎尾鎮,0139,264,161,425,30,455,924,49.24%,28.57%,1
雲林縣,虎尾鎮,0140,488,215,703,24,727,1648,44.11%,29.61%,1
雲林縣,虎尾鎮,0141,474,231,705,74,779,1616,48.21%,29.33%,1
雲林縣,虎尾鎮,0142,499,244,743,44,787,1546,50.91%,32.28%,1
雲林縣,虎尾鎮,0143,466,167,633,31,664,1283,51.75%,36.32%,1
雲林縣,虎尾鎮,0144,377,169,546,26,572,1078,53.06%,34.97%,1
雲林縣,虎尾鎮,0145,425,191,616,36,652,1313,49.66%,32.37%,1
雲林縣,虎尾鎮,0146,399,203,602,32,634,1284,49.38%,31.07%,1
雲林縣,虎尾鎮,0147,464,209,673,55,728,1356,53.69%,34.22%,1
雲林縣,虎尾鎮,0148,528,243,771,51,822,1504,54.65%,35.11%,1
雲林縣,虎尾鎮,0149,357,168,525,30,555,1224,45.34%,29.17%,1
雲林縣,虎尾鎮,0150,454,212,666,45,711,1509,47.12%,30.09%,1
雲林縣,虎尾鎮,0151,184,117,301,65,366,855,42.81%,21.52%,1
雲林縣,虎尾鎮,0152,431,214,645,76,721,1549,46.55%,27.82%,1
雲林縣,虎尾鎮,0153,274,122,396,17,413,851,48.53%,32.2%,1
雲林縣,虎尾鎮,0154,421,168,589,50,639,1272,50.24%,33.1%,1
雲林縣,西螺鎮,0340,511,279,790,60,850,1590,53.46%,32.14%,1
雲林縣,西螺鎮,0341,604,293,897,58,955,1741,54.85%,34.69%,1
雲林縣,西螺鎮,0342,461,206,667,39,706,1080,65.37%,42.69%,1
雲林縣,西螺鎮,0343,444,82,526,35,561,1040,53.94%,42.69%,1
雲林縣,西螺鎮,0344,503,259,762,23,785,1346,58.32%,37.37%,1
雲林縣,西螺鎮,0345,605,247,852,45,897,1625,55.2%,37.23%,1
雲林縣,西螺鎮,0346,161,58,219,13,232,354,65.54%,45.48%,1
雲林縣,西螺鎮,0347,205,92,297,27,324,580,55.86%,35.34%,1
雲林縣,西螺鎮,0348,236,115,351,23,374,591,63.28%,39.93%,1
雲林縣,西螺鎮,0349,394,203,597,20,617,1050,58.76%,37.52%,1
雲林縣,西螺鎮,0350,456,206,662,51,713,1147,62.16%,39.76%,1
雲林縣,西螺鎮,0351,437,374,811,53,864,1602,53.93%,27.28%,1
雲林縣,西螺鎮,0352,625,114,739,39,778,1452,53.58%,43.04%,1
雲林縣,西螺鎮,0353,589,251,840,54,894,1578,56.65%,37.33%,1
雲林縣,西螺鎮,0354,457,181,638,23,661,1305,50.65%,35.02%,1
雲林縣,西螺鎮,0355,405,203,608,41,649,1327,48.91%,30.52%,1
雲林縣,西螺鎮,0356,496,252,748,61,809,1516,53.36%,32.72%,1
雲林縣,西螺鎮,0357,232,110,342,26,368,828,44.44%,28.02%,1
雲林縣,西螺鎮,0358,237,88,325,13,338,788,42.89%,30.08%,1
雲林縣,西螺鎮,0359,267,141,408,58,466,863,54%,30.94%,1
雲林縣,西螺鎮,0360,300,150,450,71,521,984,52.95%,30.49%,1
雲林縣,西螺鎮,0361,515,211,726,97,823,1514,54.36%,34.02%,1
雲林縣,西螺鎮,0362,279,132,411,57,468,870,53.79%,32.07%,1
雲林縣,西螺鎮,0363,317,162,479,43,522,971,53.76%,32.65%,1
雲林縣,西螺鎮,0364,361,192,553,54,607,1304,46.55%,27.68%,1
雲林縣,西螺鎮,0365,221,112,333,27,360,726,49.59%,30.44%,1
雲林縣,西螺鎮,0366,291,130,421,26,447,823,54.31%,35.36%,1
雲林縣,西螺鎮,0367,236,125,361,10,371,886,41.87%,26.64%,1
雲林縣,西螺鎮,0368,413,224,637,46,683,1373,49.75%,30.08%,1
雲林縣,西螺鎮,0369,342,144,486,62,548,983,55.75%,34.79%,1
雲林縣,西螺鎮,0370,346,173,519,35,554,1014,54.64%,34.12%,1
雲林縣,西螺鎮,0371,273,151,424,51,475,939,50.59%,29.07%,1
雲林縣,西螺鎮,0372,301,131,432,29,461,866,53.23%,34.76%,1
雲林縣,西螺鎮,0373,433,226,659,70,729,1486,49.06%,29.14%,1
雲林縣,土庫鎮,0080,327,148,475,39,514,809,63.54%,40.42%,1
雲林縣,土庫鎮,0081,390,271,661,30,691,896,77.12%,43.53%,1
雲林縣,土庫鎮,0082,259,120,379,26,405,687,58.95%,37.7%,1
雲林縣,土庫鎮,0083,328,129,457,18,475,702,67.66%,46.72%,1
雲林縣,土庫鎮,0084,425,190,615,26,641,1032,62.11%,41.18%,1
雲林縣,土庫鎮,0085,215,113,328,43,371,697,53.23%,30.85%,1
雲林縣,土庫鎮,0086,123,69,192,34,226,427,52.93%,28.81%,1
雲林縣,土庫鎮,0087,546,241,787,56,843,1451,58.1%,37.63%,1
雲林縣,土庫鎮,0088,512,209,721,22,743,1283,57.91%,39.91%,1
雲林縣,土庫鎮,0089,175,104,279,15,294,634,46.37%,27.6%,1
雲林縣,土庫鎮,0090,272,134,406,32,438,796,55.03%,34.17%,1
雲林縣,土庫鎮,0091,201,99,300,32,332,745,44.56%,26.98%,1
雲林縣,土庫鎮,0092,174,93,267,21,288,576,50%,30.21%,1
雲林縣,土庫鎮,0093,225,83,308,47,355,743,47.78%,30.28%,1
雲林縣,土庫鎮,0094,140,87,227,11,238,534,44.57%,26.22%,1
雲林縣,土庫鎮,0095,336,156,492,54,546,1199,45.54%,28.02%,1
雲林縣,土庫鎮,0096,336,155,491,56,547,1077,50.79%,31.2%,1
雲林縣,土庫鎮,0097,206,108,314,21,335,819,40.9%,25.15%,1
雲林縣,土庫鎮,0098,247,101,348,24,372,684,54.39%,36.11%,1
雲林縣,土庫鎮,0099,316,123,439,32,471,843,55.87%,37.49%,1
雲林縣,土庫鎮,0100,328,119,447,46,493,916,53.82%,35.81%,1
雲林縣,土庫鎮,0101,304,147,451,30,481,948,50.74%,32.07%,1
雲林縣,土庫鎮,0102,425,44,469,29,498,914,54.49%,46.5%,1
雲林縣,土庫鎮,0103,312,118,430,52,482,860,56.05%,36.28%,1
雲林縣,土庫鎮,0104,289,143,432,39,471,929,50.7%,31.11%,1
雲林縣,土庫鎮,0105,257,125,382,43,425,875,48.57%,29.37%,1
雲林縣,土庫鎮,0106,248,112,360,36,396,896,44.2%,27.68%,1
雲林縣,土庫鎮,0107,204,96,300,47,347,757,45.84%,26.95%,1
雲林縣,土庫鎮,0108,195,107,302,29,331,683,48.46%,28.55%,1
雲林縣,北港鎮,0256,267,115,382,45,427,724,58.98%,36.88%,1
雲林縣,北港鎮,0257,247,143,390,49,439,688,63.81%,35.9%,1
雲林縣,北港鎮,0258,178,59,237,31,268,452,59.29%,39.38%,1
雲林縣,北港鎮,0259,340,129,469,41,510,866,58.89%,39.26%,1
雲林縣,北港鎮,0260,115,56,171,11,182,336,54.17%,34.23%,1
雲林縣,北港鎮,0261,145,52,197,19,216,395,54.68%,36.71%,1
雲林縣,北港鎮,0262,173,48,221,18,239,376,63.56%,46.01%,1
雲林縣,北港鎮,0263,351,174,525,21,546,950,57.47%,36.95%,1
雲林縣,北港鎮,0264,210,93,303,28,331,512,64.65%,41.02%,1
雲林縣,北港鎮,0265,114,56,170,31,201,324,62.04%,35.19%,1
雲林縣,北港鎮,0266,199,81,280,24,304,546,55.68%,36.45%,1
雲林縣,北港鎮,0267,183,71,254,18,272,433,62.82%,42.26%,1
雲林縣,北港鎮,0268,272,114,386,46,432,751,57.52%,36.22%,1
雲林縣,北港鎮,0269,193,58,251,22,273,442,61.76%,43.67%,1
雲林縣,北港鎮,0270,420,209,629,40,669,1151,58.12%,36.49%,1
雲林縣,北港鎮,0271,471,212,683,36,719,1224,58.74%,38.48%,1
雲林縣,北港鎮,0272,464,185,649,31,680,1211,56.15%,38.32%,1
雲林縣,北港鎮,0273,511,199,710,41,751,1326,56.64%,38.54%,1
雲林縣,北港鎮,0274,309,145,454,29,483,744,64.92%,41.53%,1
雲林縣,北港鎮,0275,417,175,592,35,627,977,64.18%,42.68%,1
雲林縣,北港鎮,0276,343,152,495,41,536,960,55.83%,35.73%,1
雲林縣,北港鎮,0277,129,57,186,9,195,494,39.47%,26.11%,1
雲林縣,北港鎮,0278,519,228,747,43,790,1364,57.92%,38.05%,1
雲林縣,北港鎮,0279,382,218,600,58,658,1123,58.59%,34.02%,1
雲林縣,北港鎮,0280,532,258,790,34,824,1451,56.79%,36.66%,1
雲林縣,北港鎮,0281,420,237,657,38,695,1162,59.81%,36.14%,1
雲林縣,北港鎮,0282,386,176,562,32,594,1130,52.57%,34.16%,1
雲林縣,北港鎮,0283,394,176,570,34,604,1149,52.57%,34.29%,1
雲林縣,北港鎮,0284,152,70,222,18,240,533,45.03%,28.52%,1
雲林縣,北港鎮,0285,180,91,271,19,290,433,66.97%,41.57%,1
雲林縣,北港鎮,0286,140,42,182,8,190,377,50.4%,37.14%,1
雲林縣,北港鎮,0287,240,93,333,23,356,809,44%,29.67%,1
雲林縣,北港鎮,0288,428,176,604,47,651,1397,46.6%,30.64%,1
雲林縣,北港鎮,0289,318,155,473,57,530,1145,46.29%,27.77%,1
雲林縣,北港鎮,0290,194,80,274,43,317,828,38.29%,23.43%,1
雲林縣,北港鎮,0291,145,72,217,12,229,557,41.11%,26.03%,1
雲林縣,北港鎮,0292,316,157,473,35,508,1060,47.92%,29.81%,1
雲林縣,北港鎮,0293,191,68,259,28,287,577,49.74%,33.1%,1
雲林縣,北港鎮,0294,235,135,370,44,414,931,44.47%,25.24%,1
雲林縣,北港鎮,0295,350,167,517,32,549,1018,53.93%,34.38%,1
雲林縣,北港鎮,0296,403,189,592,15,607,1032,58.82%,39.05%,1
雲林縣,古坑鄉,0531,418,176,594,30,624,1126,55.42%,37.12%,1
雲林縣,古坑鄉,0532,319,161,480,47,527,994,53.02%,32.09%,1
雲林縣,古坑鄉,0533,494,266,760,61,821,1517,54.12%,32.56%,1
雲林縣,古坑鄉,0534,477,192,669,48,717,1302,55.07%,36.64%,1
雲林縣,古坑鄉,0535,582,264,846,56,902,1772,50.9%,32.84%,1
雲林縣,古坑鄉,0536,427,169,596,53,649,1122,57.84%,38.06%,1
雲林縣,古坑鄉,0537,81,25,106,4,110,304,36.18%,26.64%,1
雲林縣,古坑鄉,0538,469,150,619,64,683,1169,58.43%,40.12%,1
雲林縣,古坑鄉,0539,414,195,609,48,657,1255,52.35%,32.99%,1
雲林縣,古坑鄉,0540,405,213,618,35,653,1078,60.58%,37.57%,1
雲林縣,古坑鄉,0541,313,131,444,30,474,943,50.27%,33.19%,1
雲林縣,古坑鄉,0542,425,204,629,46,675,1300,51.92%,32.69%,1
雲林縣,古坑鄉,0543,341,119,460,37,497,964,51.56%,35.37%,1
雲林縣,古坑鄉,0544,418,159,577,41,618,1144,54.02%,36.54%,1
雲林縣,古坑鄉,0545,515,234,749,48,797,1482,53.78%,34.75%,1
雲林縣,古坑鄉,0546,265,99,364,29,393,688,57.12%,38.52%,1
雲林縣,古坑鄉,0547,331,148,479,29,508,998,50.9%,33.17%,1
雲林縣,古坑鄉,0548,425,198,623,29,652,1140,57.19%,37.28%,1
雲林縣,古坑鄉,0549,377,189,566,36,602,1102,54.63%,34.21%,1
雲林縣,古坑鄉,0550,342,145,487,20,507,956,53.03%,35.77%,1
雲林縣,古坑鄉,0551,225,133,358,27,385,695,55.4%,32.37%,1
雲林縣,古坑鄉,0552,444,139,583,35,618,1233,50.12%,36.01%,1
雲林縣,古坑鄉,0553,82,40,122,6,128,285,44.91%,28.77%,1
雲林縣,古坑鄉,0554,208,82,290,12,302,734,41.14%,28.34%,1
雲林縣,古坑鄉,0555,367,230,597,39,636,1150,55.3%,31.91%,1
雲林縣,古坑鄉,0556,182,51,233,17,250,453,55.19%,40.18%,1
雲林縣,古坑鄉,0557,185,66,251,27,278,571,48.69%,32.4%,1
雲林縣,大埤鄉,0480,272,111,383,20,403,750,53.73%,36.27%,1
雲林縣,大埤鄉,0481,241,110,351,22,373,719,51.88%,33.52%,1
雲林縣,大埤鄉,0482,242,66,308,15,323,603,53.57%,40.13%,1
雲林縣,大埤鄉,0483,332,152,484,46,530,1106,47.92%,30.02%,1
雲林縣,大埤鄉,0484,495,250,745,51,796,1495,53.24%,33.11%,1
雲林縣,大埤鄉,0485,232,102,334,25,359,600,59.83%,38.67%,1
雲林縣,大埤鄉,0486,366,183,549,45,594,1004,59.16%,36.45%,1
雲林縣,大埤鄉,0487,251,126,377,22,399,948,42.09%,26.48%,1
雲林縣,大埤鄉,0488,542,232,774,57,831,1539,54%,35.22%,1
雲林縣,大埤鄉,0489,456,214,670,38,708,1430,49.51%,31.89%,1
雲林縣,大埤鄉,0490,159,66,225,15,240,465,51.61%,34.19%,1
雲林縣,大埤鄉,0491,439,186,625,39,664,1307,50.8%,33.59%,1
雲林縣,大埤鄉,0492,156,82,238,11,249,474,52.53%,32.91%,1
雲林縣,大埤鄉,0493,428,235,663,69,732,1220,60%,35.08%,1
雲林縣,大埤鄉,0494,266,108,374,18,392,733,53.48%,36.29%,1
雲林縣,大埤鄉,0495,240,110,350,26,376,681,55.21%,35.24%,1
雲林縣,大埤鄉,0496,186,96,282,21,303,712,42.56%,26.12%,1
雲林縣,大埤鄉,0497,215,97,312,37,349,723,48.27%,29.74%,1
雲林縣,莿桐鄉,0374,547,260,807,48,855,1507,56.74%,36.3%,1
雲林縣,莿桐鄉,0375,472,205,677,32,709,1300,54.54%,36.31%,1
雲林縣,莿桐鄉,0376,555,129,684,73,757,1272,59.51%,43.63%,1
雲林縣,莿桐鄉,0377,257,155,412,47,459,861,53.31%,29.85%,1
雲林縣,莿桐鄉,0378,485,225,710,47,757,1565,48.37%,30.99%,1
雲林縣,莿桐鄉,0379,219,78,297,12,309,577,53.55%,37.95%,1
雲林縣,莿桐鄉,0380,186,96,282,25,307,636,48.27%,29.25%,1
雲林縣,莿桐鄉,0381,347,176,523,59,582,1110,52.43%,31.26%,1
雲林縣,莿桐鄉,0382,342,200,542,47,589,973,60.53%,35.15%,1
雲林縣,莿桐鄉,0383,341,190,531,46,577,985,58.58%,34.62%,1
雲林縣,莿桐鄉,0384,644,292,936,81,1017,1707,59.58%,37.73%,1
雲林縣,莿桐鄉,0385,475,217,692,40,732,1284,57.01%,36.99%,1
雲林縣,莿桐鄉,0386,478,217,695,46,741,1293,57.31%,36.97%,1
雲林縣,莿桐鄉,0387,327,138,465,45,510,900,56.67%,36.33%,1
雲林縣,莿桐鄉,0388,376,177,553,70,623,1040,59.9%,36.15%,1
雲林縣,莿桐鄉,0389,392,178,570,32,602,1165,51.67%,33.65%,1
雲林縣,莿桐鄉,0390,304,147,451,44,495,871,56.83%,34.9%,1
雲林縣,莿桐鄉,0391,358,148,506,36,542,885,61.24%,40.45%,1
雲林縣,莿桐鄉,0392,477,216,693,41,734,1489,49.29%,32.03%,1
雲林縣,莿桐鄉,0393,409,188,597,74,671,1347,49.81%,30.36%,1
雲林縣,莿桐鄉,0394,399,206,605,64,669,1150,58.17%,34.7%,1
雲林縣,莿桐鄉,0395,256,108,364,28,392,653,60.03%,39.2%,1
雲林縣,林內鄉,0396,437,176,613,43,656,1036,63.32%,42.18%,1
雲林縣,林內鄉,0397,543,257,800,39,839,1490,56.31%,36.44%,1
雲林縣,林內鄉,0398,520,226,746,57,803,1491,53.86%,34.88%,1
雲林縣,林內鄉,0399,244,84,328,30,358,671,53.35%,36.36%,1
雲林縣,林內鄉,0400,572,220,792,74,866,1436,60.31%,39.83%,1
雲林縣,林內鄉,0401,273,125,398,46,444,751,59.12%,36.35%,1
雲林縣,林內鄉,0402,191,97,288,13,301,535,56.26%,35.7%,1
雲林縣,林內鄉,0403,250,107,357,34,391,811,48.21%,30.83%,1
雲林縣,林內鄉,0404,468,237,705,65,770,1339,57.51%,34.95%,1
雲林縣,林內鄉,0405,467,189,656,52,708,1286,55.05%,36.31%,1
雲林縣,林內鄉,0406,212,118,330,29,359,646,55.57%,32.82%,1
雲林縣,林內鄉,0407,440,181,621,41,662,1158,57.17%,38%,1
雲林縣,林內鄉,0408,400,176,576,43,619,1090,56.79%,36.7%,1
雲林縣,林內鄉,0409,368,141,509,68,577,950,60.74%,38.74%,1
雲林縣,林內鄉,0410,285,160,445,42,487,861,56.56%,33.1%,1
雲林縣,二崙鄉,0317,437,217,654,33,687,1463,46.96%,29.87%,1
雲林縣,二崙鄉,0318,508,254,762,55,817,1738,47.01%,29.23%,1
雲林縣,二崙鄉,0319,179,77,256,45,301,625,48.16%,28.64%,1
雲林縣,二崙鄉,0320,310,149,459,48,507,1018,49.8%,30.45%,1
雲林縣,二崙鄉,0321,122,51,173,3,176,448,39.29%,27.23%,1
雲林縣,二崙鄉,0322,244,125,369,41,410,1048,39.12%,23.28%,1
雲林縣,二崙鄉,0323,363,203,566,68,634,1161,54.61%,31.27%,1
雲林縣,二崙鄉,0324,321,155,476,39,515,991,51.97%,32.39%,1
雲林縣,二崙鄉,0325,314,147,461,43,504,849,59.36%,36.98%,1
雲林縣,二崙鄉,0326,278,128,406,44,450,890,50.56%,31.24%,1
雲林縣,二崙鄉,0327,435,201,636,71,707,1427,49.54%,30.48%,1
雲林縣,二崙鄉,0328,311,140,451,22,473,891,53.09%,34.9%,1
雲林縣,二崙鄉,0329,206,98,304,26,330,757,43.59%,27.21%,1
雲林縣,二崙鄉,0330,440,200,640,93,733,1497,48.96%,29.39%,1
雲林縣,二崙鄉,0331,346,159,505,60,565,1171,48.25%,29.55%,1
雲林縣,二崙鄉,0332,259,102,361,38,399,686,58.16%,37.76%,1
雲林縣,二崙鄉,0333,234,85,319,68,387,864,44.79%,27.08%,1
雲林縣,二崙鄉,0334,375,178,553,63,616,1073,57.41%,34.95%,1
雲林縣,二崙鄉,0335,187,98,285,18,303,696,43.53%,26.87%,1
雲林縣,二崙鄉,0336,310,138,448,45,493,1271,38.79%,24.39%,1
雲林縣,二崙鄉,0337,267,104,371,37,408,912,44.74%,29.28%,1
雲林縣,二崙鄉,0338,246,112,358,32,390,861,45.3%,28.57%,1
雲林縣,二崙鄉,0339,277,135,412,45,457,1030,44.37%,26.89%,1
雲林縣,崙背鄉,0297,410,191,601,62,663,1176,56.38%,34.86%,1
雲林縣,崙背鄉,0298,478,205,683,50,733,1439,50.94%,33.22%,1
雲林縣,崙背鄉,0299,405,165,570,44,614,1027,59.79%,39.44%,1
雲林縣,崙背鄉,0300,485,192,677,42,719,1259,57.11%,38.52%,1
雲林縣,崙背鄉,0301,347,151,498,19,517,1058,48.87%,32.8%,1
雲林縣,崙背鄉,0302,325,118,443,24,467,998,46.79%,32.57%,1
雲林縣,崙背鄉,0303,324,134,458,26,484,968,50%,33.47%,1
雲林縣,崙背鄉,0304,348,161,509,45,554,1055,52.51%,32.99%,1
雲林縣,崙背鄉,0305,373,199,572,58,630,1315,47.91%,28.37%,1
雲林縣,崙背鄉,0306,219,97,316,28,344,1027,33.5%,21.32%,1
雲林縣,崙背鄉,0307,388,137,525,68,593,997,59.48%,38.92%,1
雲林縣,崙背鄉,0308,285,110,395,27,422,807,52.29%,35.32%,1
雲林縣,崙背鄉,0309,179,91,270,21,291,698,41.69%,25.64%,1
雲林縣,崙背鄉,0310,201,130,331,44,375,804,46.64%,25%,1
雲林縣,崙背鄉,0311,280,127,407,27,434,867,50.06%,32.3%,1
雲林縣,崙背鄉,0312,228,117,345,34,379,886,42.78%,25.73%,1
雲林縣,崙背鄉,0313,365,166,531,81,612,1476,41.46%,24.73%,1
雲林縣,崙背鄉,0314,290,91,381,30,411,1159,35.46%,25.02%,1
雲林縣,崙背鄉,0315,453,178,631,53,684,1220,56.07%,37.13%,1
雲林縣,崙背鄉,0316,256,134,390,33,423,814,51.97%,31.45%,1
雲林縣,麥寮鄉,0001,426,187,613,43,656,1497,43.82%,28.46%,1
雲林縣,麥寮鄉,0002,574,256,830,44,874,1738,50.29%,33.03%,1
雲林縣,麥寮鄉,0003,631,277,908,49,957,1921,49.82%,32.85%,1
雲林縣,麥寮鄉,0004,576,268,844,48,892,1832,48.69%,31.44%,1
雲林縣,麥寮鄉,0005,387,191,578,39,617,1340,46.04%,28.88%,1
雲林縣,麥寮鄉,0006,328,176,504,50,554,1138,48.68%,28.82%,1
雲林縣,麥寮鄉,0007,513,213,726,45,771,1551,49.71%,33.08%,1
雲林縣,麥寮鄉,0008,214,77,291,26,317,715,44.34%,29.93%,1
雲林縣,麥寮鄉,0009,379,100,479,41,520,1194,43.55%,31.74%,1
雲林縣,麥寮鄉,0010,301,154,455,34,489,1023,47.8%,29.42%,1
雲林縣,麥寮鄉,0011,407,162,569,38,607,1558,38.96%,26.12%,1
雲林縣,麥寮鄉,0012,303,165,468,20,488,1187,41.11%,25.53%,1
雲林縣,麥寮鄉,0013,276,126,402,20,422,983,42.93%,28.08%,1
雲林縣,麥寮鄉,0014,416,191,607,66,673,1363,49.38%,30.52%,1
雲林縣,麥寮鄉,0015,502,198,700,67,767,1596,48.06%,31.45%,1
雲林縣,麥寮鄉,0016,542,254,796,68,864,1469,58.82%,36.9%,1
雲林縣,麥寮鄉,0017,258,133,391,45,436,964,45.23%,26.76%,1
雲林縣,麥寮鄉,0018,285,137,422,31,453,1038,43.64%,27.46%,1
雲林縣,麥寮鄉,0019,402,172,574,47,621,1230,50.49%,32.68%,1
雲林縣,麥寮鄉,0020,425,182,607,43,650,1329,48.91%,31.98%,1
雲林縣,麥寮鄉,0021,422,143,565,43,608,1129,53.85%,37.38%,1
雲林縣,麥寮鄉,0022,420,215,635,61,696,1241,56.08%,33.84%,1
雲林縣,麥寮鄉,0023,530,218,748,56,804,1471,54.66%,36.03%,1
雲林縣,麥寮鄉,0024,392,182,574,63,637,1107,57.54%,35.41%,1
雲林縣,麥寮鄉,0025,586,250,836,66,902,1636,55.13%,35.82%,1
雲林縣,麥寮鄉,0026,563,267,830,41,871,1755,49.63%,32.08%,1
雲林縣,麥寮鄉,0027,396,191,587,43,630,1158,54.4%,34.2%,1
雲林縣,麥寮鄉,0028,319,168,487,30,517,956,54.08%,33.37%,1
雲林縣,東勢鄉,0051,319,185,504,39,543,1207,44.99%,26.43%,1
雲林縣,東勢鄉,0052,215,95,310,19,329,540,60.93%,39.81%,1
雲林縣,東勢鄉,0053,264,106,370,27,397,896,44.31%,29.46%,1
雲林縣,東勢鄉,0054,247,119,366,28,394,728,54.12%,33.93%,1
雲林縣,東勢鄉,0055,592,233,825,49,874,1533,57.01%,38.62%,1
雲林縣,東勢鄉,0056,482,191,673,46,719,1203,59.77%,40.07%,1
雲林縣,東勢鄉,0057,247,110,357,38,395,817,48.35%,30.23%,1
雲林縣,東勢鄉,0058,206,86,292,33,325,546,59.52%,37.73%,1
雲林縣,東勢鄉,0059,298,98,396,42,438,853,51.35%,34.94%,1
雲林縣,東勢鄉,0060,216,103,319,54,373,856,43.57%,25.23%,1
雲林縣,東勢鄉,0061,269,139,408,39,447,923,48.43%,29.14%,1
雲林縣,東勢鄉,0062,331,161,492,37,529,1022,51.76%,32.39%,1
雲林縣,東勢鄉,0063,153,65,218,24,242,634,38.17%,24.13%,1
雲林縣,東勢鄉,0064,121,44,165,13,178,394,45.18%,30.71%,1
雲林縣,東勢鄉,0065,265,131,396,39,435,1087,40.02%,24.38%,1
雲林縣,褒忠鄉,0066,340,140,480,40,520,923,56.34%,36.84%,1
雲林縣,褒忠鄉,0067,369,188,557,30,587,993,59.11%,37.16%,1
雲林縣,褒忠鄉,0068,246,129,375,21,396,748,52.94%,32.89%,1
雲林縣,褒忠鄉,0069,253,94,347,12,359,702,51.14%,36.04%,1
雲林縣,褒忠鄉,0070,270,97,367,18,385,752,51.2%,35.9%,1
雲林縣,褒忠鄉,0071,271,125,396,13,409,756,54.1%,35.85%,1
雲林縣,褒忠鄉,0072,167,72,239,17,256,490,52.24%,34.08%,1
雲林縣,褒忠鄉,0073,290,148,438,22,460,1034,44.49%,28.05%,1
雲林縣,褒忠鄉,0074,137,78,215,17,232,470,49.36%,29.15%,1
雲林縣,褒忠鄉,0075,215,153,368,23,391,737,53.05%,29.17%,1
雲林縣,褒忠鄉,0076,294,123,417,27,444,878,50.57%,33.49%,1
雲林縣,褒忠鄉,0077,230,112,342,48,390,778,50.13%,29.56%,1
雲林縣,褒忠鄉,0078,358,211,569,43,612,1224,50%,29.25%,1
雲林縣,褒忠鄉,0079,237,128,365,64,429,896,47.88%,26.45%,1
雲林縣,臺西鄉,0029,458,182,640,45,685,1238,55.33%,37%,1
雲林縣,臺西鄉,0030,330,148,478,36,514,1091,47.11%,30.25%,1
雲林縣,臺西鄉,0031,385,146,531,50,581,1098,52.91%,35.06%,1
雲林縣,臺西鄉,0032,309,124,433,18,451,1048,43.03%,29.48%,1
雲林縣,臺西鄉,0033,344,112,456,40,496,1025,48.39%,33.56%,1
雲林縣,臺西鄉,0034,285,109,394,38,432,850,50.82%,33.53%,1
雲林縣,臺西鄉,0035,443,142,585,51,636,1460,43.56%,30.34%,1
雲林縣,臺西鄉,0036,260,122,382,62,444,1180,37.63%,22.03%,1
雲林縣,臺西鄉,0037,159,62,221,18,239,710,33.66%,22.39%,1
雲林縣,臺西鄉,0038,189,74,263,12,275,620,44.35%,30.48%,1
雲林縣,臺西鄉,0039,118,74,192,23,215,449,47.88%,26.28%,1
雲林縣,臺西鄉,0040,174,83,257,26,283,687,41.19%,25.33%,1
雲林縣,臺西鄉,0041,367,150,517,42,559,1247,44.83%,29.43%,1
雲林縣,臺西鄉,0042,154,47,201,8,209,583,35.85%,26.42%,1
雲林縣,臺西鄉,0043,347,155,502,50,552,1042,52.98%,33.3%,1
雲林縣,臺西鄉,0044,139,66,205,15,220,472,46.61%,29.45%,1
雲林縣,臺西鄉,0045,438,160,598,21,619,1409,43.93%,31.09%,1
雲林縣,臺西鄉,0046,354,145,499,68,567,1061,53.44%,33.36%,1
雲林縣,臺西鄉,0047,300,112,412,18,430,993,43.3%,30.21%,1
雲林縣,臺西鄉,0048,306,117,423,70,493,1013,48.67%,30.21%,1
雲林縣,臺西鄉,0049,414,152,566,44,610,1233,49.47%,33.58%,1
雲林縣,臺西鄉,0050,170,79,249,15,264,616,42.86%,27.6%,1
雲林縣,元長鄉,0180,311,121,432,33,465,915,50.82%,33.99%,1
雲林縣,元長鄉,0181,419,177,596,24,620,1284,48.29%,32.63%,1
雲林縣,元長鄉,0182,354,149,503,44,547,1150,47.57%,30.78%,1
雲林縣,元長鄉,0183,211,97,308,28,336,744,45.16%,28.36%,1
雲林縣,元長鄉,0184,261,97,358,36,394,790,49.87%,33.04%,1
雲林縣,元長鄉,0185,359,150,509,54,563,1356,41.52%,26.47%,1
雲林縣,元長鄉,0186,213,111,324,37,361,739,48.85%,28.82%,1
雲林縣,元長鄉,0187,254,115,369,29,398,965,41.24%,26.32%,1
雲林縣,元長鄉,0188,297,123,420,44,464,1080,42.96%,27.5%,1
雲林縣,元長鄉,0189,247,100,347,40,387,948,40.82%,26.05%,1
雲林縣,元長鄉,0190,139,80,219,18,237,762,31.1%,18.24%,1
雲林縣,元長鄉,0191,148,108,256,14,270,582,46.39%,25.43%,1
雲林縣,元長鄉,0192,215,105,320,17,337,865,38.96%,24.86%,1
雲林縣,元長鄉,0193,60,17,77,6,83,362,22.93%,16.57%,1
雲林縣,元長鄉,0194,308,142,450,25,475,1162,40.88%,26.51%,1
雲林縣,元長鄉,0195,465,169,634,47,681,1527,44.6%,30.45%,1
雲林縣,元長鄉,0196,307,128,435,55,490,1006,48.71%,30.52%,1
雲林縣,元長鄉,0197,261,98,359,14,373,855,43.63%,30.53%,1
雲林縣,元長鄉,0198,358,148,506,53,559,1181,47.33%,30.31%,1
雲林縣,元長鄉,0199,242,90,332,27,359,864,41.55%,28.01%,1
雲林縣,元長鄉,0200,165,79,244,29,273,667,40.93%,24.74%,1
雲林縣,元長鄉,0201,219,107,326,33,359,878,40.89%,24.94%,1
雲林縣,元長鄉,0202,142,72,214,12,226,610,37.05%,23.28%,1
雲林縣,元長鄉,0203,245,105,350,49,399,837,47.67%,29.27%,1
雲林縣,元長鄉,0204,224,102,326,30,356,701,50.78%,31.95%,1
雲林縣,四湖鄉,0155,329,113,442,40,482,1082,44.55%,30.41%,1
雲林縣,四湖鄉,0156,255,82,337,37,374,676,55.33%,37.72%,1
雲林縣,四湖鄉,0157,304,113,417,16,433,862,50.23%,35.27%,1
雲林縣,四湖鄉,0158,127,55,182,12,194,477,40.67%,26.62%,1
雲林縣,四湖鄉,0159,370,144,514,28,542,952,56.93%,38.87%,1
雲林縣,四湖鄉,0160,159,75,234,14,248,650,38.15%,24.46%,1
雲林縣,四湖鄉,0161,292,118,410,25,435,969,44.89%,30.13%,1
雲林縣,四湖鄉,0162,223,113,336,39,375,925,40.54%,24.11%,1
雲林縣,四湖鄉,0163,266,110,376,25,401,914,43.87%,29.1%,1
雲林縣,四湖鄉,0164,136,70,206,39,245,759,32.28%,17.92%,1
雲林縣,四湖鄉,0165,315,123,438,34,472,1219,38.72%,25.84%,1
雲林縣,四湖鄉,0166,215,81,296,28,324,937,34.58%,22.95%,1
雲林縣,四湖鄉,0167,159,79,238,19,257,773,33.25%,20.57%,1
雲林縣,四湖鄉,0168,134,59,193,32,225,555,40.54%,24.14%,1
雲林縣,四湖鄉,0169,196,91,287,21,308,876,35.16%,22.37%,1
雲林縣,四湖鄉,0170,84,40,124,15,139,360,38.61%,23.33%,1
雲林縣,四湖鄉,0171,167,68,235,32,267,885,30.17%,18.87%,1
雲林縣,四湖鄉,0172,171,84,255,31,286,833,34.33%,20.53%,1
雲林縣,四湖鄉,0173,200,95,295,31,326,785,41.53%,25.48%,1
雲林縣,四湖鄉,0174,237,75,312,25,337,705,47.8%,33.62%,1
雲林縣,四湖鄉,0175,230,83,313,22,335,927,36.14%,24.81%,1
雲林縣,四湖鄉,0176,227,111,338,50,388,1058,36.67%,21.46%,1
雲林縣,四湖鄉,0177,260,109,369,40,409,1071,38.19%,24.28%,1
雲林縣,四湖鄉,0178,179,88,267,21,288,1022,28.18%,17.51%,1
雲林縣,四湖鄉,0179,197,81,278,36,314,711,44.16%,27.71%,1
雲林縣,口湖鄉,0205,355,198,553,48,601,1134,53%,31.31%,1
雲林縣,口湖鄉,0206,401,181,582,83,665,1225,54.29%,32.73%,1
雲林縣,口湖鄉,0207,181,67,248,29,277,647,42.81%,27.98%,1
雲林縣,口湖鄉,0208,233,108,341,21,362,709,51.06%,32.86%,1
雲林縣,口湖鄉,0209,255,126,381,55,436,900,48.44%,28.33%,1
雲林縣,口湖鄉,0210,305,152,457,52,509,1011,50.35%,30.17%,1
雲林縣,口湖鄉,0211,434,164,598,25,623,1437,43.35%,30.2%,1
雲林縣,口湖鄉,0212,197,83,280,12,292,848,34.43%,23.23%,1
雲林縣,口湖鄉,0213,345,135,480,23,503,1193,42.16%,28.92%,1
雲林縣,口湖鄉,0214,172,74,246,42,288,759,37.94%,22.66%,1
雲林縣,口湖鄉,0215,207,127,334,37,371,815,45.52%,25.4%,1
雲林縣,口湖鄉,0216,463,197,660,65,725,1460,49.66%,31.71%,1
雲林縣,口湖鄉,0217,110,70,180,10,190,556,34.17%,19.78%,1
雲林縣,口湖鄉,0218,472,193,665,49,714,1532,46.61%,30.81%,1
雲林縣,口湖鄉,0219,286,86,372,22,394,847,46.52%,33.77%,1
雲林縣,口湖鄉,0220,98,57,155,27,182,374,48.66%,26.2%,1
雲林縣,口湖鄉,0221,484,221,705,130,835,1508,55.37%,32.1%,1
雲林縣,口湖鄉,0222,379,106,485,48,533,951,56.05%,39.85%,1
雲林縣,口湖鄉,0223,326,138,464,63,527,910,57.91%,35.82%,1
雲林縣,口湖鄉,0224,328,146,474,44,518,879,58.93%,37.32%,1
雲林縣,口湖鄉,0225,374,133,507,88,595,1213,49.05%,30.83%,1
雲林縣,口湖鄉,0226,317,110,427,51,478,952,50.21%,33.3%,1
雲林縣,口湖鄉,0227,235,119,354,35,389,720,54.03%,32.64%,1
雲林縣,口湖鄉,0228,240,126,366,33,399,1006,39.66%,23.86%,1
雲林縣,口湖鄉,0229,189,43,232,11,243,607,40.03%,31.14%,1
雲林縣,水林鄉,0230,387,187,574,52,626,1355,46.2%,28.56%,1
雲林縣,水林鄉,0231,312,143,455,8,463,887,52.2%,35.17%,1
雲林縣,水林鄉,0232,448,173,621,47,668,1234,54.13%,36.3%,1
雲林縣,水林鄉,0233,231,129,360,14,374,763,49.02%,30.28%,1
雲林縣,水林鄉,0234,173,96,269,40,309,721,42.86%,23.99%,1
雲林縣,水林鄉,0235,169,58,227,15,242,647,37.4%,26.12%,1
雲林縣,水林鄉,0236,248,126,374,61,435,989,43.98%,25.08%,1
雲林縣,水林鄉,0237,219,97,316,19,335,837,40.02%,26.16%,1
雲林縣,水林鄉,0238,275,110,385,20,405,1081,37.47%,25.44%,1
雲林縣,水林鄉,0239,213,95,308,29,337,704,47.87%,30.26%,1
雲林縣,水林鄉,0240,309,133,442,59,501,1006,49.8%,30.72%,1
雲林縣,水林鄉,0241,185,70,255,10,265,651,40.71%,28.42%,1
雲林縣,水林鄉,0242,160,73,233,16,249,607,41.02%,26.36%,1
雲林縣,水林鄉,0243,248,127,375,70,445,1033,43.08%,24.01%,1
雲林縣,水林鄉,0244,141,49,190,15,205,631,32.49%,22.35%,1
雲林縣,水林鄉,0245,265,105,370,45,415,961,43.18%,27.58%,1
雲林縣,水林鄉,0246,240,122,362,63,425,951,44.69%,25.24%,1
雲林縣,水林鄉,0247,252,102,354,18,372,838,44.39%,30.07%,1
雲林縣,水林鄉,0248,328,105,433,70,503,1055,47.68%,31.09%,1
雲林縣,水林鄉,0249,112,42,154,25,179,512,34.96%,21.88%,1
雲林縣,水林鄉,0250,158,74,232,13,245,671,36.51%,23.55%,1
雲林縣,水林鄉,0251,119,64,183,39,222,693,32.03%,17.17%,1
雲林縣,水林鄉,0252,155,60,215,31,246,689,35.7%,22.5%,1
雲林縣,水林鄉,0253,315,128,443,52,495,1022,48.43%,30.82%,1
雲林縣,水林鄉,0254,354,118,472,32,504,1191,42.32%,29.72%,1
雲林縣,水林鄉,0255,275,112,387,33,420,779,53.92%,35.3%,1
嘉義縣,太保市,0001,435,201,636,45,681,1210,56.28%,35.95%,1
嘉義縣,太保市,0002,390,186,576,31,607,1076,56.41%,36.25%,1
嘉義縣,太保市,0003,151,70,221,29,250,488,51.23%,30.94%,1
嘉義縣,太保市,0004,481,219,700,55,755,1475,51.19%,32.61%,1
嘉義縣,太保市,0005,235,115,350,29,379,790,47.97%,29.75%,1
嘉義縣,太保市,0006,305,114,419,31,450,883,50.96%,34.54%,1
嘉義縣,太保市,0007,240,113,353,42,395,758,52.11%,31.66%,1
嘉義縣,太保市,0008,131,39,170,6,176,389,45.24%,33.68%,1
嘉義縣,太保市,0009,316,162,478,40,518,1101,47.05%,28.7%,1
嘉義縣,太保市,0010,354,121,475,13,488,853,57.21%,41.5%,1
嘉義縣,太保市,0011,51,35,86,6,92,224,41.07%,22.77%,1
嘉義縣,太保市,0012,202,90,292,37,329,662,49.7%,30.51%,1
嘉義縣,太保市,0013,678,263,941,32,973,1630,59.69%,41.6%,1
嘉義縣,太保市,0014,309,116,425,31,456,913,49.95%,33.84%,1
嘉義縣,太保市,0015,286,139,425,9,434,779,55.71%,36.71%,1
嘉義縣,太保市,0016,417,217,634,83,717,1278,56.1%,32.63%,1
嘉義縣,太保市,0017,264,102,366,38,404,819,49.33%,32.23%,1
嘉義縣,太保市,0018,537,255,792,20,812,1573,51.62%,34.14%,1
嘉義縣,太保市,0019,165,86,251,20,271,481,56.34%,34.3%,1
嘉義縣,太保市,0020,95,47,142,5,147,245,60%,38.78%,1
嘉義縣,太保市,0021,113,56,169,14,183,317,57.73%,35.65%,1
嘉義縣,太保市,0022,89,44,133,7,140,258,54.26%,34.5%,1
嘉義縣,太保市,0023,229,76,305,28,333,611,54.5%,37.48%,1
嘉義縣,太保市,0024,594,274,868,34,902,1526,59.11%,38.93%,1
嘉義縣,太保市,0025,421,238,659,20,679,1196,56.77%,35.2%,1
嘉義縣,太保市,0026,519,263,782,65,847,1536,55.14%,33.79%,1
嘉義縣,太保市,0027,525,250,775,52,827,1481,55.84%,35.45%,1
嘉義縣,太保市,0028,550,227,777,24,801,1450,55.24%,37.93%,1
嘉義縣,太保市,0029,307,133,440,26,466,840,55.48%,36.55%,1
嘉義縣,太保市,0030,375,191,566,21,587,989,59.35%,37.92%,1
嘉義縣,太保市,0031,566,230,796,64,860,1529,56.25%,37.02%,1
嘉義縣,太保市,0032,536,284,820,31,851,1511,56.32%,35.47%,1
嘉義縣,太保市,0033,229,95,324,31,355,697,50.93%,32.86%,1
嘉義縣,朴子市,0233,423,196,619,26,645,1183,54.52%,35.76%,1
嘉義縣,朴子市,0234,265,122,387,29,416,755,55.1%,35.1%,1
嘉義縣,朴子市,0235,452,199,651,31,682,1253,54.43%,36.07%,1
嘉義縣,朴子市,0236,410,191,601,43,644,1078,59.74%,38.03%,1
嘉義縣,朴子市,0237,419,216,635,50,685,1117,61.32%,37.51%,1
嘉義縣,朴子市,0238,155,62,217,14,231,387,59.69%,40.05%,1
嘉義縣,朴子市,0239,232,95,327,32,359,633,56.71%,36.65%,1
嘉義縣,朴子市,0240,227,121,348,23,371,650,57.08%,34.92%,1
嘉義縣,朴子市,0241,357,145,502,27,529,825,64.12%,43.27%,1
嘉義縣,朴子市,0242,296,124,420,33,453,810,55.93%,36.54%,1
嘉義縣,朴子市,0243,387,126,513,39,552,940,58.72%,41.17%,1
嘉義縣,朴子市,0244,313,139,452,40,492,905,54.36%,34.59%,1
嘉義縣,朴子市,0245,490,238,728,40,768,1605,47.85%,30.53%,1
嘉義縣,朴子市,0246,550,270,820,34,854,1479,57.74%,37.19%,1
嘉義縣,朴子市,0247,446,213,659,48,707,1218,58.05%,36.62%,1
嘉義縣,朴子市,0248,530,275,805,53,858,1496,57.35%,35.43%,1
嘉義縣,朴子市,0249,222,117,339,29,368,667,55.17%,33.28%,1
嘉義縣,朴子市,0250,167,72,239,18,257,627,40.99%,26.63%,1
嘉義縣,朴子市,0251,281,86,367,29,396,791,50.06%,35.52%,1
嘉義縣,朴子市,0252,341,153,494,79,573,1034,55.42%,32.98%,1
嘉義縣,朴子市,0253,520,280,800,28,828,1710,48.42%,30.41%,1
嘉義縣,朴子市,0254,539,236,775,46,821,1671,49.13%,32.26%,1
嘉義縣,朴子市,0255,478,190,668,43,711,1547,45.96%,30.9%,1
嘉義縣,朴子市,0256,428,189,617,18,635,1602,39.64%,26.72%,1
嘉義縣,朴子市,0257,504,217,721,20,741,1302,56.91%,38.71%,1
嘉義縣,朴子市,0258,251,93,344,37,381,740,51.49%,33.92%,1
嘉義縣,朴子市,0259,402,161,563,59,622,1054,59.01%,38.14%,1
嘉義縣,朴子市,0260,264,109,373,19,392,907,43.22%,29.11%,1
嘉義縣,朴子市,0261,197,86,283,32,315,720,43.75%,27.36%,1
嘉義縣,朴子市,0262,88,48,136,14,150,251,59.76%,35.06%,1
嘉義縣,朴子市,0263,214,89,303,40,343,767,44.72%,27.9%,1
嘉義縣,朴子市,0264,245,104,349,44,393,702,55.98%,34.9%,1
嘉義縣,朴子市,0265,337,112,449,54,503,1038,48.46%,32.47%,1
嘉義縣,朴子市,0266,301,116,417,40,457,1228,37.21%,24.51%,1
嘉義縣,朴子市,0267,163,60,223,34,257,499,51.5%,32.67%,1
嘉義縣,布袋鎮,0325,223,68,291,18,309,614,50.33%,36.32%,1
嘉義縣,布袋鎮,0326,121,39,160,11,171,372,45.97%,32.53%,1
嘉義縣,布袋鎮,0327,321,133,454,56,510,914,55.8%,35.12%,1
嘉義縣,布袋鎮,0328,435,177,612,39,651,1198,54.34%,36.31%,1
嘉義縣,布袋鎮,0329,366,118,484,44,528,1113,47.44%,32.88%,1
嘉義縣,布袋鎮,0330,343,158,501,32,533,992,53.73%,34.58%,1
嘉義縣,布袋鎮,0331,250,89,339,14,353,689,51.23%,36.28%,1
嘉義縣,布袋鎮,0332,294,126,420,45,465,882,52.72%,33.33%,1
嘉義縣,布袋鎮,0333,263,97,360,22,382,731,52.26%,35.98%,1
嘉義縣,布袋鎮,0334,299,112,411,19,430,779,55.2%,38.38%,1
嘉義縣,布袋鎮,0335,232,85,317,26,343,762,45.01%,30.45%,1
嘉義縣,布袋鎮,0336,345,159,504,36,540,1184,45.61%,29.14%,1
嘉義縣,布袋鎮,0337,382,130,512,64,576,1423,40.48%,26.84%,1
嘉義縣,布袋鎮,0338,369,147,516,49,565,1351,41.82%,27.31%,1
嘉義縣,布袋鎮,0339,94,31,125,4,129,275,46.91%,34.18%,1
嘉義縣,布袋鎮,0340,82,27,109,7,116,243,47.74%,33.74%,1
嘉義縣,布袋鎮,0341,258,71,329,34,363,661,54.92%,39.03%,1
嘉義縣,布袋鎮,0342,373,135,508,37,545,1145,47.6%,32.58%,1
嘉義縣,布袋鎮,0343,284,142,426,22,448,936,47.86%,30.34%,1
嘉義縣,布袋鎮,0344,275,138,413,41,454,958,47.39%,28.71%,1
嘉義縣,布袋鎮,0345,93,42,135,9,144,298,48.32%,31.21%,1
嘉義縣,布袋鎮,0346,159,63,222,33,255,428,59.58%,37.15%,1
嘉義縣,布袋鎮,0347,37,10,47,3,50,121,41.32%,30.58%,1
嘉義縣,布袋鎮,0348,37,11,48,3,51,174,29.31%,21.26%,1
嘉義縣,布袋鎮,0349,301,120,421,37,458,953,48.06%,31.58%,1
嘉義縣,布袋鎮,0350,429,211,640,54,694,1292,53.72%,33.2%,1
嘉義縣,布袋鎮,0351,427,147,574,29,603,1127,53.5%,37.89%,1
嘉義縣,布袋鎮,0352,383,178,561,35,596,1244,47.91%,30.79%,1
嘉義縣,布袋鎮,0353,357,170,527,15,542,1106,49.01%,32.28%,1
嘉義縣,大林鎮,0169,181,70,251,19,270,483,55.9%,37.47%,1
嘉義縣,大林鎮,0170,669,295,964,63,1027,1823,56.34%,36.7%,1
嘉義縣,大林鎮,0171,368,153,521,22,543,955,56.86%,38.53%,1
嘉義縣,大林鎮,0172,497,232,729,33,762,1436,53.06%,34.61%,1
嘉義縣,大林鎮,0173,461,255,716,68,784,1390,56.4%,33.17%,1
嘉義縣,大林鎮,0174,529,267,796,55,851,1512,56.28%,34.99%,1
嘉義縣,大林鎮,0175,529,286,815,57,872,1536,56.77%,34.44%,1
嘉義縣,大林鎮,0176,361,154,515,52,567,1165,48.67%,30.99%,1
嘉義縣,大林鎮,0177,638,330,968,60,1028,1730,59.42%,36.88%,1
嘉義縣,大林鎮,0178,183,71,254,22,276,602,45.85%,30.4%,1
嘉義縣,大林鎮,0179,224,97,321,38,359,716,50.14%,31.28%,1
嘉義縣,大林鎮,0180,196,65,261,17,278,625,44.48%,31.36%,1
嘉義縣,大林鎮,0181,50,21,71,3,74,193,38.34%,25.91%,1
嘉義縣,大林鎮,0182,514,195,709,61,770,1642,46.89%,31.3%,1
嘉義縣,大林鎮,0183,503,208,711,63,774,1465,52.83%,34.33%,1
嘉義縣,大林鎮,0184,258,113,371,46,417,928,44.94%,27.8%,1
嘉義縣,大林鎮,0185,97,45,142,17,159,361,44.04%,26.87%,1
嘉義縣,大林鎮,0186,296,102,398,24,422,814,51.84%,36.36%,1
嘉義縣,大林鎮,0187,509,220,729,45,774,1579,49.02%,32.24%,1
嘉義縣,大林鎮,0188,670,328,998,69,1067,2041,52.28%,32.83%,1
嘉義縣,大林鎮,0189,319,118,437,42,479,931,51.45%,34.26%,1
嘉義縣,大林鎮,0190,223,109,332,29,361,675,53.48%,33.04%,1
嘉義縣,大林鎮,0191,239,83,322,25,347,655,52.98%,36.49%,1
嘉義縣,大林鎮,0192,270,103,373,42,415,833,49.82%,32.41%,1
嘉義縣,大林鎮,0193,320,144,464,36,500,832,60.1%,38.46%,1
嘉義縣,民雄鄉,0093,462,242,704,28,732,1267,57.77%,36.46%,1
嘉義縣,民雄鄉,0094,341,145,486,39,525,1030,50.97%,33.11%,1
嘉義縣,民雄鄉,0095,607,279,886,63,949,1590,59.69%,38.18%,1
嘉義縣,民雄鄉,0096,582,254,836,27,863,1673,51.58%,34.79%,1
嘉義縣,民雄鄉,0097,609,326,935,56,991,1718,57.68%,35.45%,1
嘉義縣,民雄鄉,0098,403,175,578,43,621,1040,59.71%,38.75%,1
嘉義縣,民雄鄉,0099,377,183,560,34,594,1100,54%,34.27%,1
嘉義縣,民雄鄉,0100,506,238,744,63,807,1559,51.76%,32.46%,1
嘉義縣,民雄鄉,0101,609,298,907,46,953,1862,51.18%,32.71%,1
嘉義縣,民雄鄉,0102,494,255,749,60,809,1435,56.38%,34.43%,1
嘉義縣,民雄鄉,0103,575,259,834,85,919,1751,52.48%,32.84%,1
嘉義縣,民雄鄉,0104,348,141,489,48,537,933,57.56%,37.3%,1
嘉義縣,民雄鄉,0105,316,169,485,32,517,827,62.52%,38.21%,1
嘉義縣,民雄鄉,0106,268,128,396,30,426,843,50.53%,31.79%,1
嘉義縣,民雄鄉,0107,627,255,882,54,936,1774,52.76%,35.34%,1
嘉義縣,民雄鄉,0108,115,57,172,11,183,385,47.53%,29.87%,1
嘉義縣,民雄鄉,0109,479,252,731,41,772,1306,59.11%,36.68%,1
嘉義縣,民雄鄉,0110,205,85,290,30,320,535,59.81%,38.32%,1
嘉義縣,民雄鄉,0111,405,161,566,56,622,1055,58.96%,38.39%,1
嘉義縣,民雄鄉,0112,527,228,755,51,806,1476,54.61%,35.7%,1
嘉義縣,民雄鄉,0113,560,197,757,40,797,1583,50.35%,35.38%,1
嘉義縣,民雄鄉,0114,219,120,339,31,370,758,48.81%,28.89%,1
嘉義縣,民雄鄉,0115,461,189,650,26,676,1354,49.93%,34.05%,1
嘉義縣,民雄鄉,0116,455,186,641,66,707,1202,58.82%,37.85%,1
嘉義縣,民雄鄉,0117,418,196,614,35,649,1175,55.23%,35.57%,1
嘉義縣,民雄鄉,0118,456,236,692,36,728,1423,51.16%,32.04%,1
嘉義縣,民雄鄉,0119,580,242,822,20,842,1612,52.23%,35.98%,1
嘉義縣,民雄鄉,0120,630,296,926,27,953,1695,56.22%,37.17%,1
嘉義縣,民雄鄉,0121,560,211,771,51,822,1665,49.37%,33.63%,1
嘉義縣,民雄鄉,0122,333,126,459,44,503,1019,49.36%,32.68%,1
嘉義縣,民雄鄉,0123,459,201,660,50,710,1352,52.51%,33.95%,1
嘉義縣,民雄鄉,0124,558,289,847,56,903,1620,55.74%,34.44%,1
嘉義縣,民雄鄉,0125,297,143,440,32,472,943,50.05%,31.5%,1
嘉義縣,民雄鄉,0126,519,249,768,35,803,1720,46.69%,30.17%,1
嘉義縣,民雄鄉,0127,664,246,910,58,968,1875,51.63%,35.41%,1
嘉義縣,民雄鄉,0128,464,221,685,36,721,1305,55.25%,35.56%,1
嘉義縣,民雄鄉,0129,469,243,712,41,753,1441,52.26%,32.55%,1
嘉義縣,民雄鄉,0130,519,219,738,53,791,1413,55.98%,36.73%,1
嘉義縣,民雄鄉,0131,539,238,777,53,830,1560,53.21%,34.55%,1
嘉義縣,民雄鄉,0132,698,341,1039,81,1120,2004,55.89%,34.83%,1
嘉義縣,民雄鄉,0133,527,239,766,35,801,1354,59.16%,38.92%,1
嘉義縣,民雄鄉,0134,404,166,570,27,597,1076,55.48%,37.55%,1
嘉義縣,民雄鄉,0135,619,252,871,61,932,1629,57.21%,38%,1
嘉義縣,民雄鄉,0136,690,271,961,54,1015,1977,51.34%,34.9%,1
嘉義縣,民雄鄉,0137,431,198,629,66,695,1295,53.67%,33.28%,1
嘉義縣,溪口鄉,0194,485,202,687,77,764,1318,57.97%,36.8%,1
嘉義縣,溪口鄉,0195,261,114,375,25,400,677,59.08%,38.55%,1
嘉義縣,溪口鄉,0196,151,51,202,18,220,417,52.76%,36.21%,1
嘉義縣,溪口鄉,0197,91,46,137,21,158,273,57.88%,33.33%,1
嘉義縣,溪口鄉,0198,335,147,482,52,534,908,58.81%,36.89%,1
嘉義縣,溪口鄉,0199,101,66,167,13,180,386,46.63%,26.17%,1
嘉義縣,溪口鄉,0200,386,156,542,36,578,1039,55.63%,37.15%,1
嘉義縣,溪口鄉,0201,199,93,292,41,333,708,47.03%,28.11%,1
嘉義縣,溪口鄉,0202,330,121,451,17,468,909,51.49%,36.3%,1
嘉義縣,溪口鄉,0203,360,32,392,43,435,786,55.34%,45.8%,1
嘉義縣,溪口鄉,0204,289,91,380,24,404,807,50.06%,35.81%,1
嘉義縣,溪口鄉,0205,358,143,501,19,520,1168,44.52%,30.65%,1
嘉義縣,溪口鄉,0206,377,159,536,58,594,1052,56.46%,35.84%,1
嘉義縣,溪口鄉,0207,170,84,254,31,285,565,50.44%,30.09%,1
嘉義縣,溪口鄉,0208,147,44,191,19,210,388,54.12%,37.89%,1
嘉義縣,溪口鄉,0209,224,74,298,24,322,701,45.93%,31.95%,1
嘉義縣,溪口鄉,0210,318,112,430,31,461,1003,45.96%,31.7%,1
嘉義縣,新港鄉,0138,396,180,576,26,602,1087,55.38%,36.43%,1
嘉義縣,新港鄉,0139,494,198,692,49,741,1116,66.4%,44.27%,1
嘉義縣,新港鄉,0140,290,95,385,27,412,740,55.68%,39.19%,1
嘉義縣,新港鄉,0141,264,116,380,60,440,827,53.2%,31.92%,1
嘉義縣,新港鄉,0142,290,114,404,35,439,704,62.36%,41.19%,1
嘉義縣,新港鄉,0143,299,139,438,46,484,768,63.02%,38.93%,1
嘉義縣,新港鄉,0144,274,150,424,35,459,761,60.32%,36.01%,1
嘉義縣,新港鄉,0145,274,130,404,51,455,850,53.53%,32.24%,1
嘉義縣,新港鄉,0146,453,200,653,67,720,1327,54.26%,34.14%,1
嘉義縣,新港鄉,0147,252,128,380,43,423,756,55.95%,33.33%,1
嘉義縣,新港鄉,0148,289,113,402,63,465,816,56.99%,35.42%,1
嘉義縣,新港鄉,0149,215,111,326,25,351,667,52.62%,32.23%,1
嘉義縣,新港鄉,0150,335,141,476,40,516,942,54.78%,35.56%,1
嘉義縣,新港鄉,0151,271,117,388,56,444,918,48.37%,29.52%,1
嘉義縣,新港鄉,0152,190,69,259,18,277,554,50%,34.3%,1
嘉義縣,新港鄉,0153,303,120,423,42,465,929,50.05%,32.62%,1
嘉義縣,新港鄉,0154,107,67,174,33,207,487,42.51%,21.97%,1
嘉義縣,新港鄉,0155,172,62,234,36,270,487,55.44%,35.32%,1
嘉義縣,新港鄉,0156,255,148,403,39,442,836,52.87%,30.5%,1
嘉義縣,新港鄉,0157,272,155,427,49,476,845,56.33%,32.19%,1
嘉義縣,新港鄉,0158,288,138,426,41,467,834,56%,34.53%,1
嘉義縣,新港鄉,0159,263,125,388,37,425,753,56.44%,34.93%,1
嘉義縣,新港鄉,0160,431,207,638,61,699,1328,52.64%,32.45%,1
嘉義縣,新港鄉,0161,351,166,517,41,558,969,57.59%,36.22%,1
嘉義縣,新港鄉,0162,367,194,561,62,623,1043,59.73%,35.19%,1
嘉義縣,新港鄉,0163,549,241,790,54,844,1400,60.29%,39.21%,1
嘉義縣,新港鄉,0164,268,106,374,27,401,1017,39.43%,26.35%,1
嘉義縣,新港鄉,0165,349,154,503,50,553,1132,48.85%,30.83%,1
嘉義縣,新港鄉,0166,347,142,489,55,544,1037,52.46%,33.46%,1
嘉義縣,新港鄉,0167,216,78,294,39,333,563,59.15%,38.37%,1
嘉義縣,新港鄉,0168,314,121,435,19,454,849,53.47%,36.98%,1
嘉義縣,六腳鄉,0268,352,137,489,36,525,1165,45.06%,30.21%,1
嘉義縣,六腳鄉,0269,217,72,289,17,306,825,37.09%,26.3%,1
嘉義縣,六腳鄉,0270,251,108,359,33,392,850,46.12%,29.53%,1
嘉義縣,六腳鄉,0271,78,35,113,19,132,222,59.46%,35.14%,1
嘉義縣,六腳鄉,0272,393,161,554,52,606,1216,49.84%,32.32%,1
嘉義縣,六腳鄉,0273,313,132,445,44,489,1200,40.75%,26.08%,1
嘉義縣,六腳鄉,0274,267,103,370,49,419,877,47.78%,30.44%,1
嘉義縣,六腳鄉,0275,166,76,242,36,278,644,43.17%,25.78%,1
嘉義縣,六腳鄉,0276,144,75,219,14,233,594,39.23%,24.24%,1
嘉義縣,六腳鄉,0277,38,9,47,3,50,167,29.94%,22.75%,1
嘉義縣,六腳鄉,0278,42,29,71,3,74,204,36.27%,20.59%,1
嘉義縣,六腳鄉,0279,52,41,93,2,95,234,40.6%,22.22%,1
嘉義縣,六腳鄉,0280,86,46,132,14,146,361,40.44%,23.82%,1
嘉義縣,六腳鄉,0281,224,78,302,34,336,592,56.76%,37.84%,1
嘉義縣,六腳鄉,0282,202,82,284,32,316,619,51.05%,32.63%,1
嘉義縣,六腳鄉,0283,206,63,269,22,291,714,40.76%,28.85%,1
嘉義縣,六腳鄉,0284,372,119,491,45,536,1051,51%,35.39%,1
嘉義縣,六腳鄉,0285,329,126,455,32,487,934,52.14%,35.22%,1
嘉義縣,六腳鄉,0286,323,154,477,41,518,1044,49.62%,30.94%,1
嘉義縣,六腳鄉,0287,450,176,626,42,668,1476,45.26%,30.49%,1
嘉義縣,六腳鄉,0288,136,77,213,19,232,618,37.54%,22.01%,1
嘉義縣,六腳鄉,0289,111,28,139,23,162,478,33.89%,23.22%,1
嘉義縣,六腳鄉,0290,154,54,208,27,235,642,36.6%,23.99%,1
嘉義縣,六腳鄉,0291,191,100,291,15,306,883,34.65%,21.63%,1
嘉義縣,六腳鄉,0292,174,70,244,11,255,739,34.51%,23.55%,1
嘉義縣,六腳鄉,0293,141,60,201,17,218,554,39.35%,25.45%,1
嘉義縣,六腳鄉,0294,155,57,212,20,232,649,35.75%,23.88%,1
嘉義縣,六腳鄉,0295,175,74,249,26,275,689,39.91%,25.4%,1
嘉義縣,六腳鄉,0296,116,51,167,15,182,455,40%,25.49%,1
嘉義縣,六腳鄉,0297,25,12,37,1,38,125,30.4%,20%,1
嘉義縣,東石鄉,0298,628,256,884,55,939,1915,49.03%,32.79%,1
嘉義縣,東石鄉,0299,233,107,340,43,383,938,40.83%,24.84%,1
嘉義縣,東石鄉,0300,288,123,411,22,433,1366,31.7%,21.08%,1
嘉義縣,東石鄉,0301,501,171,672,7,679,1676,40.51%,29.89%,1
嘉義縣,東石鄉,0302,308,115,423,60,483,1151,41.96%,26.76%,1
嘉義縣,東石鄉,0303,211,82,293,30,323,716,45.11%,29.47%,1
嘉義縣,東石鄉,0304,126,28,154,5,159,387,41.09%,32.56%,1
嘉義縣,東石鄉,0305,199,63,262,11,273,864,31.6%,23.03%,1
嘉義縣,東石鄉,0306,215,79,294,22,316,910,34.73%,23.63%,1
嘉義縣,東石鄉,0307,198,88,286,12,298,760,39.21%,26.05%,1
嘉義縣,東石鄉,0308,67,18,85,4,89,166,53.61%,40.36%,1
嘉義縣,東石鄉,0309,56,14,70,10,80,212,37.74%,26.42%,1
嘉義縣,東石鄉,0310,238,86,324,26,350,993,35.25%,23.97%,1
嘉義縣,東石鄉,0311,77,30,107,13,120,306,39.22%,25.16%,1
嘉義縣,東石鄉,0312,269,101,370,41,411,1046,39.29%,25.72%,1
嘉義縣,東石鄉,0313,58,19,77,13,90,235,38.3%,24.68%,1
嘉義縣,東石鄉,0314,357,145,502,55,557,1226,45.43%,29.12%,1
嘉義縣,東石鄉,0315,229,100,329,38,367,843,43.53%,27.16%,1
嘉義縣,東石鄉,0316,203,71,274,26,300,693,43.29%,29.29%,1
嘉義縣,東石鄉,0317,282,97,379,33,412,839,49.11%,33.61%,1
嘉義縣,東石鄉,0318,107,42,149,10,159,363,43.8%,29.48%,1
嘉義縣,東石鄉,0319,79,27,106,9,115,321,35.83%,24.61%,1
嘉義縣,東石鄉,0320,388,140,528,68,596,1083,55.03%,35.83%,1
嘉義縣,東石鄉,0321,264,121,385,32,417,901,46.28%,29.3%,1
嘉義縣,東石鄉,0322,323,102,425,27,452,1216,37.17%,26.56%,1
嘉義縣,東石鄉,0323,152,68,220,32,252,418,60.29%,36.36%,1
嘉義縣,東石鄉,0324,107,48,155,7,162,371,43.67%,28.84%,1
嘉義縣,義竹鄉,0354,154,60,214,17,231,482,47.93%,31.95%,1
嘉義縣,義竹鄉,0355,84,37,121,13,134,223,60.09%,37.67%,1
嘉義縣,義竹鄉,0356,516,255,771,66,837,1529,54.74%,33.75%,1
嘉義縣,義竹鄉,0357,435,184,619,50,669,1175,56.94%,37.02%,1
嘉義縣,義竹鄉,0358,372,136,508,45,553,886,62.42%,41.99%,1
嘉義縣,義竹鄉,0359,215,100,315,20,335,743,45.09%,28.94%,1
嘉義縣,義竹鄉,0360,426,192,618,66,684,1236,55.34%,34.47%,1
嘉義縣,義竹鄉,0361,128,50,178,16,194,377,51.46%,33.95%,1
嘉義縣,義竹鄉,0362,103,33,136,19,155,338,45.86%,30.47%,1
嘉義縣,義竹鄉,0363,48,9,57,3,60,102,58.82%,47.06%,1
嘉義縣,義竹鄉,0364,241,107,348,17,365,763,47.84%,31.59%,1
嘉義縣,義竹鄉,0365,150,78,228,23,251,429,58.51%,34.97%,1
嘉義縣,義竹鄉,0366,130,66,196,19,215,427,50.35%,30.44%,1
嘉義縣,義竹鄉,0367,206,88,294,42,336,607,55.35%,33.94%,1
嘉義縣,義竹鄉,0368,463,184,647,49,696,1486,46.84%,31.16%,1
嘉義縣,義竹鄉,0369,294,124,418,66,484,835,57.96%,35.21%,1
嘉義縣,義竹鄉,0370,218,88,306,49,355,816,43.5%,26.72%,1
嘉義縣,義竹鄉,0371,223,115,338,48,386,833,46.34%,26.77%,1
嘉義縣,義竹鄉,0372,150,52,202,11,213,433,49.19%,34.64%,1
嘉義縣,義竹鄉,0373,162,71,233,12,245,558,43.91%,29.03%,1
嘉義縣,義竹鄉,0374,196,81,277,38,315,602,52.33%,32.56%,1
嘉義縣,義竹鄉,0375,45,7,52,3,55,140,39.29%,32.14%,1
嘉義縣,義竹鄉,0376,111,46,157,28,185,393,47.07%,28.24%,1
嘉義縣,義竹鄉,0377,188,76,264,26,290,585,49.57%,32.14%,1
嘉義縣,義竹鄉,0378,143,60,203,3,206,526,39.16%,27.19%,1
嘉義縣,義竹鄉,0379,55,17,72,4,76,123,61.79%,44.72%,1
嘉義縣,鹿草鄉,0034,122,86,208,36,244,522,46.74%,23.37%,1
嘉義縣,鹿草鄉,0035,173,103,276,27,303,563,53.82%,30.73%,1
嘉義縣,鹿草鄉,0036,379,195,574,75,649,1304,49.77%,29.06%,1
嘉義縣,鹿草鄉,0037,411,209,620,40,660,1312,50.3%,31.33%,1
嘉義縣,鹿草鄉,0038,98,47,145,4,149,320,46.56%,30.63%,1
嘉義縣,鹿草鄉,0039,74,31,105,5,110,418,26.32%,17.7%,1
嘉義縣,鹿草鄉,0040,281,119,400,51,451,1025,44%,27.41%,1
嘉義縣,鹿草鄉,0041,125,51,176,19,195,451,43.24%,27.72%,1
嘉義縣,鹿草鄉,0042,302,89,391,56,447,830,53.86%,36.39%,1
嘉義縣,鹿草鄉,0043,328,131,459,40,499,1050,47.52%,31.24%,1
嘉義縣,鹿草鄉,0044,234,123,357,43,400,972,41.15%,24.07%,1
嘉義縣,鹿草鄉,0045,287,125,412,33,445,962,46.26%,29.83%,1
嘉義縣,鹿草鄉,0046,95,109,204,46,250,678,36.87%,14.01%,1
嘉義縣,鹿草鄉,0047,108,20,128,10,138,262,52.67%,41.22%,1
嘉義縣,鹿草鄉,0048,242,122,364,34,398,906,43.93%,26.71%,1
嘉義縣,鹿草鄉,0049,79,25,104,6,110,306,35.95%,25.82%,1
嘉義縣,鹿草鄉,0050,371,128,499,52,551,1062,51.88%,34.93%,1
嘉義縣,鹿草鄉,0051,135,57,192,13,205,373,54.96%,36.19%,1
嘉義縣,鹿草鄉,0052,114,47,161,14,175,324,54.01%,35.19%,1
嘉義縣,鹿草鄉,0053,103,32,135,13,148,297,49.83%,34.68%,1
嘉義縣,水上鄉,0054,358,137,495,27,522,1024,50.98%,34.96%,1
嘉義縣,水上鄉,0055,372,193,565,49,614,1015,60.49%,36.65%,1
嘉義縣,水上鄉,0056,620,280,900,50,950,1932,49.17%,32.09%,1
嘉義縣,水上鄉,0057,442,216,658,30,688,1170,58.8%,37.78%,1
嘉義縣,水上鄉,0058,505,215,720,46,766,1305,58.7%,38.7%,1
嘉義縣,水上鄉,0059,403,180,583,38,621,1242,50%,32.45%,1
嘉義縣,水上鄉,0060,100,48,148,18,166,324,51.23%,30.86%,1
嘉義縣,水上鄉,0061,234,84,318,13,331,622,53.22%,37.62%,1
嘉義縣,水上鄉,0062,412,175,587,50,637,1216,52.38%,33.88%,1
嘉義縣,水上鄉,0063,386,157,543,21,564,1020,55.29%,37.84%,1
嘉義縣,水上鄉,0064,305,153,458,23,481,771,62.39%,39.56%,1
嘉義縣,水上鄉,0065,175,84,259,20,279,441,63.27%,39.68%,1
嘉義縣,水上鄉,0066,292,107,399,21,420,626,67.09%,46.65%,1
嘉義縣,水上鄉,0067,212,110,322,20,342,570,60%,37.19%,1
嘉義縣,水上鄉,0068,125,51,176,16,192,368,52.17%,33.97%,1
嘉義縣,水上鄉,0069,324,146,470,70,540,1037,52.07%,31.24%,1
嘉義縣,水上鄉,0070,369,178,547,33,580,1065,54.46%,34.65%,1
嘉義縣,水上鄉,0071,316,151,467,45,512,802,63.84%,39.4%,1
嘉義縣,水上鄉,0072,660,312,972,53,1025,1948,52.62%,33.88%,1
嘉義縣,水上鄉,0073,355,138,493,32,525,1028,51.07%,34.53%,1
嘉義縣,水上鄉,0074,244,113,357,18,375,641,58.5%,38.07%,1
嘉義縣,水上鄉,0075,168,66,234,12,246,408,60.29%,41.18%,1
嘉義縣,水上鄉,0076,295,132,427,32,459,794,57.81%,37.15%,1
嘉義縣,水上鄉,0077,159,97,256,17,273,569,47.98%,27.94%,1
嘉義縣,水上鄉,0078,289,141,430,24,454,806,56.33%,35.86%,1
嘉義縣,水上鄉,0079,349,172,521,38,559,960,58.23%,36.35%,1
嘉義縣,水上鄉,0080,707,336,1043,69,1112,2035,54.64%,34.74%,1
嘉義縣,水上鄉,0081,717,300,1017,73,1090,1987,54.86%,36.08%,1
嘉義縣,水上鄉,0082,442,187,629,22,651,1154,56.41%,38.3%,1
嘉義縣,水上鄉,0083,711,351,1062,51,1113,2208,50.41%,32.2%,1
嘉義縣,水上鄉,0084,640,250,890,58,948,2102,45.1%,30.45%,1
嘉義縣,水上鄉,0085,467,163,630,44,674,1309,51.49%,35.68%,1
嘉義縣,水上鄉,0086,601,274,875,34,909,1671,54.4%,35.97%,1
嘉義縣,水上鄉,0087,280,138,418,32,450,822,54.74%,34.06%,1
嘉義縣,水上鄉,0088,655,240,895,31,926,1772,52.26%,36.96%,1
嘉義縣,水上鄉,0089,674,290,964,59,1023,1919,53.31%,35.12%,1
嘉義縣,水上鄉,0090,196,246,442,13,455,912,49.89%,21.49%,1
嘉義縣,水上鄉,0091,368,132,500,18,518,992,52.22%,37.1%,1
嘉義縣,水上鄉,0092,370,172,542,30,572,1270,45.04%,29.13%,1
嘉義縣,中埔鄉,0380,281,134,415,27,442,1046,42.26%,26.86%,1
嘉義縣,中埔鄉,0381,543,250,793,51,844,1788,47.2%,30.37%,1
嘉義縣,中埔鄉,0382,517,258,775,35,810,1730,46.82%,29.88%,1
嘉義縣,中埔鄉,0383,513,223,736,40,776,1581,49.08%,32.45%,1
嘉義縣,中埔鄉,0384,453,200,653,27,680,1594,42.66%,28.42%,1
嘉義縣,中埔鄉,0385,609,290,899,25,924,1801,51.3%,33.81%,1
嘉義縣,中埔鄉,0386,637,246,883,40,923,1862,49.57%,34.21%,1
嘉義縣,中埔鄉,0387,529,235,764,25,789,1803,43.76%,29.34%,1
嘉義縣,中埔鄉,0388,520,218,738,35,773,1481,52.19%,35.11%,1
嘉義縣,中埔鄉,0389,464,220,684,45,729,1366,53.37%,33.97%,1
嘉義縣,中埔鄉,0390,484,199,683,37,720,1599,45.03%,30.27%,1
嘉義縣,中埔鄉,0391,435,166,601,21,622,1196,52.01%,36.37%,1
嘉義縣,中埔鄉,0392,542,238,780,51,831,1809,45.94%,29.96%,1
嘉義縣,中埔鄉,0393,309,147,456,16,472,953,49.53%,32.42%,1
嘉義縣,中埔鄉,0394,439,179,618,54,672,1441,46.63%,30.46%,1
嘉義縣,中埔鄉,0395,582,233,815,56,871,1882,46.28%,30.92%,1
嘉義縣,中埔鄉,0396,500,188,688,25,713,1470,48.5%,34.01%,1
嘉義縣,中埔鄉,0397,481,221,702,55,757,1699,44.56%,28.31%,1
嘉義縣,中埔鄉,0398,110,53,163,15,178,422,42.18%,26.07%,1
嘉義縣,中埔鄉,0399,324,145,469,47,516,1030,50.1%,31.46%,1
嘉義縣,中埔鄉,0400,293,122,415,26,441,879,50.17%,33.33%,1
嘉義縣,中埔鄉,0401,255,101,356,11,367,828,44.32%,30.8%,1
嘉義縣,中埔鄉,0402,329,145,474,31,505,881,57.32%,37.34%,1
嘉義縣,中埔鄉,0403,99,40,139,9,148,296,50%,33.45%,1
嘉義縣,中埔鄉,0404,312,131,443,36,479,979,48.93%,31.87%,1
嘉義縣,中埔鄉,0405,365,177,542,35,577,1268,45.5%,28.79%,1
嘉義縣,中埔鄉,0406,149,64,213,16,229,670,34.18%,22.24%,1
嘉義縣,中埔鄉,0407,253,134,387,44,431,754,57.16%,33.55%,1
嘉義縣,中埔鄉,0408,216,112,328,28,356,648,54.94%,33.33%,1
嘉義縣,中埔鄉,0409,179,102,281,21,302,741,40.76%,24.16%,1
嘉義縣,中埔鄉,0410,164,69,233,5,238,518,45.95%,31.66%,1
嘉義縣,中埔鄉,0411,141,78,219,25,244,482,50.62%,29.25%,1
嘉義縣,中埔鄉,0412,102,48,150,9,159,348,45.69%,29.31%,1
嘉義縣,中埔鄉,0413,101,37,138,8,146,294,49.66%,34.35%,1
嘉義縣,竹崎鄉,0414,471,230,701,35,736,1312,56.1%,35.9%,1
嘉義縣,竹崎鄉,0415,484,186,670,25,695,1210,57.44%,40%,1
嘉義縣,竹崎鄉,0416,363,150,513,41,554,991,55.9%,36.63%,1
嘉義縣,竹崎鄉,0417,487,174,661,29,690,1207,57.17%,40.35%,1
嘉義縣,竹崎鄉,0418,245,112,357,15,372,752,49.47%,32.58%,1
嘉義縣,竹崎鄉,0419,342,123,465,29,494,833,59.3%,41.06%,1
嘉義縣,竹崎鄉,0420,482,175,657,35,692,1220,56.72%,39.51%,1
嘉義縣,竹崎鄉,0421,257,118,375,9,384,616,62.34%,41.72%,1
嘉義縣,竹崎鄉,0422,367,111,478,53,531,1031,51.5%,35.6%,1
嘉義縣,竹崎鄉,0423,464,168,632,39,671,1292,51.93%,35.91%,1
嘉義縣,竹崎鄉,0424,720,325,1045,57,1102,1995,55.24%,36.09%,1
嘉義縣,竹崎鄉,0425,680,249,929,21,950,1996,47.6%,34.07%,1
嘉義縣,竹崎鄉,0426,520,212,732,31,763,1449,52.66%,35.89%,1
嘉義縣,竹崎鄉,0427,545,194,739,32,771,1420,54.3%,38.38%,1
嘉義縣,竹崎鄉,0428,594,254,848,34,882,1590,55.47%,37.36%,1
嘉義縣,竹崎鄉,0429,259,107,366,21,387,771,50.19%,33.59%,1
嘉義縣,竹崎鄉,0430,283,158,441,39,480,1014,47.34%,27.91%,1
嘉義縣,竹崎鄉,0431,96,33,129,9,138,327,42.2%,29.36%,1
嘉義縣,竹崎鄉,0432,258,87,345,18,363,687,52.84%,37.55%,1
嘉義縣,竹崎鄉,0433,222,86,308,19,327,641,51.01%,34.63%,1
嘉義縣,竹崎鄉,0434,186,70,256,8,264,474,55.7%,39.24%,1
嘉義縣,竹崎鄉,0435,124,54,178,14,192,383,50.13%,32.38%,1
嘉義縣,竹崎鄉,0436,242,103,345,34,379,619,61.23%,39.1%,1
嘉義縣,竹崎鄉,0437,63,31,94,5,99,214,46.26%,29.44%,1
嘉義縣,竹崎鄉,0438,534,239,773,53,826,1568,52.68%,34.06%,1
嘉義縣,竹崎鄉,0439,216,87,303,10,313,658,47.57%,32.83%,1
嘉義縣,竹崎鄉,0440,172,64,236,19,255,434,58.76%,39.63%,1
嘉義縣,竹崎鄉,0441,353,133,486,28,514,917,56.05%,38.5%,1
嘉義縣,竹崎鄉,0442,294,159,453,32,485,981,49.44%,29.97%,1
嘉義縣,竹崎鄉,0443,256,102,358,11,369,789,46.77%,32.45%,1
嘉義縣,竹崎鄉,0444,20,9,29,2,31,108,28.7%,18.52%,1
嘉義縣,竹崎鄉,0445,49,20,69,1,70,235,29.79%,20.85%,1
嘉義縣,竹崎鄉,0446,91,45,136,6,142,331,42.9%,27.49%,1
嘉義縣,竹崎鄉,0447,179,90,269,15,284,450,63.11%,39.78%,1
嘉義縣,竹崎鄉,0448,131,41,172,12,184,462,39.83%,28.35%,1
嘉義縣,竹崎鄉,0449,83,14,97,10,107,251,42.63%,33.07%,1
嘉義縣,梅山鄉,0211,347,178,525,27,552,1041,53.03%,33.33%,1
嘉義縣,梅山鄉,0212,493,202,695,60,755,1245,60.64%,39.6%,1
嘉義縣,梅山鄉,0213,374,171,545,28,573,917,62.49%,40.79%,1
嘉義縣,梅山鄉,0214,451,177,628,36,664,1189,55.85%,37.93%,1
嘉義縣,梅山鄉,0215,506,228,734,52,786,1388,56.63%,36.46%,1
嘉義縣,梅山鄉,0216,635,313,948,50,998,1827,54.63%,34.76%,1
嘉義縣,梅山鄉,0217,203,105,308,35,343,545,62.94%,37.25%,1
嘉義縣,梅山鄉,0218,118,44,162,21,183,407,44.96%,28.99%,1
嘉義縣,梅山鄉,0219,256,94,350,22,372,636,58.49%,40.25%,1
嘉義縣,梅山鄉,0220,217,94,311,29,340,576,59.03%,37.67%,1
嘉義縣,梅山鄉,0221,610,269,879,55,934,1674,55.79%,36.44%,1
嘉義縣,梅山鄉,0222,282,98,380,17,397,858,46.27%,32.87%,1
嘉義縣,梅山鄉,0223,215,95,310,18,328,526,62.36%,40.87%,1
嘉義縣,梅山鄉,0224,105,62,167,17,184,372,49.46%,28.23%,1
嘉義縣,梅山鄉,0225,153,68,221,33,254,506,50.2%,30.24%,1
嘉義縣,梅山鄉,0226,192,71,263,37,300,433,69.28%,44.34%,1
嘉義縣,梅山鄉,0227,115,38,153,13,166,404,41.09%,28.47%,1
嘉義縣,梅山鄉,0228,94,46,140,6,146,293,49.83%,32.08%,1
嘉義縣,梅山鄉,0229,269,129,398,50,448,712,62.92%,37.78%,1
嘉義縣,梅山鄉,0230,254,91,345,29,374,602,62.13%,42.19%,1
嘉義縣,梅山鄉,0231,169,67,236,16,252,515,48.93%,32.82%,1
嘉義縣,梅山鄉,0232,107,43,150,13,163,417,39.09%,25.66%,1
嘉義縣,番路鄉,0450,438,204,642,70,712,1174,60.65%,37.31%,1
嘉義縣,番路鄉,0451,184,76,260,20,280,449,62.36%,40.98%,1
嘉義縣,番路鄉,0452,305,123,428,33,461,753,61.22%,40.5%,1
嘉義縣,番路鄉,0453,162,62,224,39,263,551,47.73%,29.4%,1
嘉義縣,番路鄉,0454,625,310,935,71,1006,1791,56.17%,34.9%,1
嘉義縣,番路鄉,0455,343,149,492,45,537,849,63.25%,40.4%,1
嘉義縣,番路鄉,0456,340,131,471,31,502,866,57.97%,39.26%,1
嘉義縣,番路鄉,0457,317,92,409,31,440,800,55%,39.63%,1
嘉義縣,番路鄉,0458,159,77,236,21,257,444,57.88%,35.81%,1
嘉義縣,番路鄉,0459,195,55,250,13,263,635,41.42%,30.71%,1
嘉義縣,番路鄉,0460,102,36,138,12,150,319,47.02%,31.97%,1
嘉義縣,番路鄉,0461,282,73,355,23,378,642,58.88%,43.93%,1
嘉義縣,番路鄉,0462,169,42,211,20,231,509,45.38%,33.2%,1
嘉義縣,番路鄉,0463,80,15,95,0,95,162,58.64%,49.38%,1
嘉義縣,番路鄉,0464,90,25,115,6,121,212,57.08%,42.45%,1
嘉義縣,大埔鄉,0465,523,234,757,50,807,1468,54.97%,35.63%,1
嘉義縣,大埔鄉,0466,88,30,118,7,125,320,39.06%,27.5%,1
嘉義縣,大埔鄉,0467,105,59,164,11,175,304,57.57%,34.54%,1
嘉義縣,大埔鄉,0468,65,26,91,2,93,184,50.54%,35.33%,1
嘉義縣,大埔鄉,0469,105,46,151,6,157,234,67.09%,44.87%,1
嘉義縣,大埔鄉,0470,171,79,250,13,263,495,53.13%,34.55%,1
嘉義縣,大埔鄉,0471,76,30,106,6,112,199,56.28%,38.19%,1
嘉義縣,大埔鄉,0472,73,33,106,9,115,226,50.88%,32.3%,1
嘉義縣,大埔鄉,0473,251,76,327,22,349,569,61.34%,44.11%,1
嘉義縣,阿里山鄉,0474,125,51,176,6,182,371,49.06%,33.69%,1
嘉義縣,阿里山鄉,0475,61,21,82,3,85,197,43.15%,30.96%,1
嘉義縣,阿里山鄉,0476,50,19,69,4,73,152,48.03%,32.89%,1
嘉義縣,阿里山鄉,0477,55,20,75,4,79,231,34.2%,23.81%,1
嘉義縣,阿里山鄉,0478,16,3,19,2,21,72,29.17%,22.22%,1
嘉義縣,阿里山鄉,0479,86,36,122,2,124,311,39.87%,27.65%,1
嘉義縣,阿里山鄉,0480,123,36,159,5,164,306,53.59%,40.2%,1
嘉義縣,阿里山鄉,0481,294,138,432,13,445,970,45.88%,30.31%,1
嘉義縣,阿里山鄉,0482,296,126,422,32,454,827,54.9%,35.79%,1
嘉義縣,阿里山鄉,0483,87,38,125,1,126,238,52.94%,36.55%,1
嘉義縣,阿里山鄉,0484,107,44,151,6,157,479,32.78%,22.34%,1
嘉義縣,阿里山鄉,0485,86,36,122,8,130,291,44.67%,29.55%,1
嘉義縣,阿里山鄉,0486,125,27,152,8,160,246,65.04%,50.81%,1
屏東縣,屏東市,0001,76,47,123,5,128,237,54.01%,32.07%,1
屏東縣,屏東市,0002,93,59,152,14,166,294,56.46%,31.63%,1
屏東縣,屏東市,0003,181,122,303,8,311,582,53.44%,31.1%,1
屏東縣,屏東市,0004,257,140,397,22,419,713,58.77%,36.04%,1
屏東縣,屏東市,0005,185,109,294,25,319,572,55.77%,32.34%,1
屏東縣,屏東市,0006,196,79,275,7,282,455,61.98%,43.08%,1
屏東縣,屏東市,0007,90,57,147,0,147,249,59.04%,36.14%,1
屏東縣,屏東市,0008,441,179,620,27,647,1315,49.2%,33.54%,1
屏東縣,屏東市,0009,389,249,638,35,673,1373,49.02%,28.33%,1
屏東縣,屏東市,0010,268,152,420,30,450,713,63.11%,37.59%,1
屏東縣,屏東市,0011,215,122,337,32,369,573,64.4%,37.52%,1
屏東縣,屏東市,0012,123,64,187,16,203,297,68.35%,41.41%,1
屏東縣,屏東市,0013,187,78,265,16,281,409,68.7%,45.72%,1
屏東縣,屏東市,0014,91,57,148,12,160,286,55.94%,31.82%,1
屏東縣,屏東市,0015,176,72,248,8,256,421,60.81%,41.81%,1
屏東縣,屏東市,0016,202,116,318,11,329,569,57.82%,35.5%,1
屏東縣,屏東市,0017,129,105,234,15,249,459,54.25%,28.1%,1
屏東縣,屏東市,0018,260,154,414,19,433,672,64.43%,38.69%,1
屏東縣,屏東市,0019,237,162,399,24,423,668,63.32%,35.48%,1
屏東縣,屏東市,0020,166,82,248,8,256,411,62.29%,40.39%,1
屏東縣,屏東市,0021,288,130,418,25,443,768,57.68%,37.5%,1
屏東縣,屏東市,0022,267,154,421,18,439,786,55.85%,33.97%,1
屏東縣,屏東市,0023,352,148,500,29,529,890,59.44%,39.55%,1
屏東縣,屏東市,0024,516,218,734,28,762,1353,56.32%,38.14%,1
屏東縣,屏東市,0025,512,221,733,12,745,1386,53.75%,36.94%,1
屏東縣,屏東市,0026,494,244,738,22,760,1413,53.79%,34.96%,1
屏東縣,屏東市,0027,481,187,668,22,690,1272,54.25%,37.81%,1
屏東縣,屏東市,0028,452,234,686,17,703,1287,54.62%,35.12%,1
屏東縣,屏東市,0029,492,247,739,26,765,1311,58.35%,37.53%,1
屏東縣,屏東市,0030,485,126,611,17,628,1285,48.87%,37.74%,1
屏東縣,屏東市,0031,484,234,718,26,744,1297,57.36%,37.32%,1
屏東縣,屏東市,0032,497,225,722,22,744,1361,54.67%,36.52%,1
屏東縣,屏東市,0033,463,220,683,28,711,1381,51.48%,33.53%,1
屏東縣,屏東市,0034,496,217,713,34,747,1258,59.38%,39.43%,1
屏東縣,屏東市,0035,476,209,685,29,714,1259,56.71%,37.81%,1
屏東縣,屏東市,0036,386,197,583,13,596,1076,55.39%,35.87%,1
屏東縣,屏東市,0037,433,231,664,11,675,1162,58.09%,37.26%,1
屏東縣,屏東市,0038,488,249,737,19,756,1318,57.36%,37.03%,1
屏東縣,屏東市,0039,332,165,497,26,523,939,55.7%,35.36%,1
屏東縣,屏東市,0040,369,177,546,17,563,972,57.92%,37.96%,1
屏東縣,屏東市,0041,553,284,837,30,867,1535,56.48%,36.03%,1
屏東縣,屏東市,0042,472,190,662,25,687,1419,48.41%,33.26%,1
屏東縣,屏東市,0043,485,198,683,13,696,1398,49.79%,34.69%,1
屏東縣,屏東市,0044,507,210,717,30,747,1405,53.17%,36.09%,1
屏東縣,屏東市,0045,567,232,799,20,819,1486,55.11%,38.16%,1
屏東縣,屏東市,0046,375,189,564,28,592,1061,55.8%,35.34%,1
屏東縣,屏東市,0047,471,237,708,48,756,1540,49.09%,30.58%,1
屏東縣,屏東市,0048,349,193,542,10,552,1141,48.38%,30.59%,1
屏東縣,屏東市,0049,393,208,601,22,623,1247,49.96%,31.52%,1
屏東縣,屏東市,0050,453,245,698,38,736,1446,50.9%,31.33%,1
屏東縣,屏東市,0051,506,210,716,23,739,1303,56.72%,38.83%,1
屏東縣,屏東市,0052,471,196,667,22,689,1253,54.99%,37.59%,1
屏東縣,屏東市,0053,476,211,687,29,716,1315,54.45%,36.2%,1
屏東縣,屏東市,0054,435,266,701,29,730,1425,51.23%,30.53%,1
屏東縣,屏東市,0055,487,227,714,25,739,1423,51.93%,34.22%,1
屏東縣,屏東市,0056,530,227,757,34,791,1400,56.5%,37.86%,1
屏東縣,屏東市,0057,480,282,762,26,788,1359,57.98%,35.32%,1
屏東縣,屏東市,0058,528,164,692,26,718,1328,54.07%,39.76%,1
屏東縣,屏東市,0059,591,204,795,23,818,1539,53.15%,38.4%,1
屏東縣,屏東市,0060,92,47,139,4,143,391,36.57%,23.53%,1
屏東縣,屏東市,0061,72,31,103,14,117,200,58.5%,36%,1
屏東縣,屏東市,0062,96,52,148,20,168,328,51.22%,29.27%,1
屏東縣,屏東市,0063,88,29,117,3,120,231,51.95%,38.1%,1
屏東縣,屏東市,0064,325,156,481,38,519,945,54.92%,34.39%,1
屏東縣,屏東市,0065,344,176,520,46,566,1053,53.75%,32.67%,1
屏東縣,屏東市,0066,325,174,499,44,543,1043,52.06%,31.16%,1
屏東縣,屏東市,0067,354,157,511,56,567,1061,53.44%,33.36%,1
屏東縣,屏東市,0068,296,136,432,25,457,876,52.17%,33.79%,1
屏東縣,屏東市,0069,498,207,705,74,779,1468,53.07%,33.92%,1
屏東縣,屏東市,0070,477,212,689,40,729,1454,50.14%,32.81%,1
屏東縣,屏東市,0071,430,234,664,15,679,1205,56.35%,35.68%,1
屏東縣,屏東市,0072,402,234,636,29,665,1284,51.79%,31.31%,1
屏東縣,屏東市,0073,419,167,586,29,615,1219,50.45%,34.37%,1
屏東縣,屏東市,0074,563,259,822,48,870,1544,56.35%,36.46%,1
屏東縣,屏東市,0075,525,230,755,57,812,1485,54.68%,35.35%,1
屏東縣,屏東市,0076,491,218,709,43,752,1387,54.22%,35.4%,1
屏東縣,屏東市,0077,342,135,477,18,495,953,51.94%,35.89%,1
屏東縣,屏東市,0078,661,197,858,25,883,1603,55.08%,41.24%,1
屏東縣,屏東市,0079,179,94,273,25,298,535,55.7%,33.46%,1
屏東縣,屏東市,0080,399,179,578,22,600,1119,53.62%,35.66%,1
屏東縣,屏東市,0081,328,118,446,29,475,847,56.08%,38.72%,1
屏東縣,屏東市,0082,307,184,491,61,552,923,59.8%,33.26%,1
屏東縣,屏東市,0083,412,200,612,25,637,1227,51.92%,33.58%,1
屏東縣,屏東市,0084,392,163,555,24,579,1039,55.73%,37.73%,1
屏東縣,屏東市,0085,504,242,746,48,794,1485,53.47%,33.94%,1
屏東縣,屏東市,0086,304,136,440,36,476,867,54.9%,35.06%,1
屏東縣,屏東市,0087,344,144,488,32,520,918,56.64%,37.47%,1
屏東縣,屏東市,0088,213,105,318,28,346,663,52.19%,32.13%,1
屏東縣,屏東市,0089,384,185,569,18,587,1215,48.31%,31.6%,1
屏東縣,屏東市,0090,483,276,759,47,806,1628,49.51%,29.67%,1
屏東縣,屏東市,0091,418,232,650,30,680,1209,56.24%,34.57%,1
屏東縣,屏東市,0092,466,224,690,20,710,1110,63.96%,41.98%,1
屏東縣,屏東市,0093,228,96,324,9,333,684,48.68%,33.33%,1
屏東縣,屏東市,0094,410,180,590,26,616,1349,45.66%,30.39%,1
屏東縣,屏東市,0095,518,190,708,43,751,1457,51.54%,35.55%,1
屏東縣,屏東市,0096,521,244,765,31,796,1447,55.01%,36.01%,1
屏東縣,屏東市,0097,431,239,670,17,687,1354,50.74%,31.83%,1
屏東縣,屏東市,0098,564,273,837,46,883,1583,55.78%,35.63%,1
屏東縣,屏東市,0099,623,245,868,17,885,1707,51.85%,36.5%,1
屏東縣,屏東市,0100,560,219,779,25,804,1637,49.11%,34.21%,1
屏東縣,屏東市,0101,495,204,699,8,707,1459,48.46%,33.93%,1
屏東縣,屏東市,0102,661,267,928,23,951,1759,54.06%,37.58%,1
屏東縣,屏東市,0103,681,272,953,28,981,1950,50.31%,34.92%,1
屏東縣,屏東市,0104,626,263,889,32,921,1729,53.27%,36.21%,1
屏東縣,屏東市,0105,548,257,805,18,823,1592,51.7%,34.42%,1
屏東縣,屏東市,0106,517,192,709,23,732,1437,50.94%,35.98%,1
屏東縣,屏東市,0107,431,175,606,20,626,1204,51.99%,35.8%,1
屏東縣,屏東市,0108,513,198,711,22,733,1340,54.7%,38.28%,1
屏東縣,屏東市,0109,476,225,701,20,721,1322,54.54%,36.01%,1
屏東縣,屏東市,0110,510,205,715,29,744,1462,50.89%,34.88%,1
屏東縣,屏東市,0111,1093,461,1554,38,1592,3241,49.12%,33.72%,1
屏東縣,屏東市,0112,517,201,718,11,729,1477,49.36%,35%,1
屏東縣,屏東市,0113,280,106,386,15,401,821,48.84%,34.1%,1
屏東縣,屏東市,0114,328,150,478,18,496,1099,45.13%,29.85%,1
屏東縣,屏東市,0115,617,222,839,29,868,1688,51.42%,36.55%,1
屏東縣,屏東市,0116,360,205,565,36,601,1167,51.5%,30.85%,1
屏東縣,屏東市,0117,330,135,465,27,492,915,53.77%,36.07%,1
屏東縣,屏東市,0118,362,151,513,19,532,1683,31.61%,21.51%,1
屏東縣,屏東市,0119,518,228,746,17,763,1497,50.97%,34.6%,1
屏東縣,屏東市,0120,388,190,578,20,598,1129,52.97%,34.37%,1
屏東縣,屏東市,0121,473,176,649,17,666,1232,54.06%,38.39%,1
屏東縣,屏東市,0122,321,120,441,15,456,853,53.46%,37.63%,1
屏東縣,屏東市,0123,336,153,489,20,509,869,58.57%,38.67%,1
屏東縣,屏東市,0124,437,200,637,32,669,1169,57.23%,37.38%,1
屏東縣,屏東市,0125,413,162,575,21,596,1058,56.33%,39.04%,1
屏東縣,屏東市,0126,445,203,648,21,669,1344,49.78%,33.11%,1
屏東縣,屏東市,0127,466,209,675,24,699,1299,53.81%,35.87%,1
屏東縣,屏東市,0128,418,189,607,35,642,1204,53.32%,34.72%,1
屏東縣,屏東市,0129,394,178,572,28,600,1123,53.43%,35.08%,1
屏東縣,屏東市,0130,422,189,611,24,635,1318,48.18%,32.02%,1
屏東縣,屏東市,0131,341,142,483,37,520,865,60.12%,39.42%,1
屏東縣,屏東市,0132,362,165,527,14,541,1100,49.18%,32.91%,1
屏東縣,屏東市,0133,396,192,588,17,605,1215,49.79%,32.59%,1
屏東縣,屏東市,0134,516,190,706,24,730,1370,53.28%,37.66%,1
屏東縣,屏東市,0135,478,176,654,9,663,1240,53.47%,38.55%,1
屏東縣,屏東市,0136,427,220,647,19,666,1168,57.02%,36.56%,1
屏東縣,屏東市,0137,416,157,573,20,593,1079,54.96%,38.55%,1
屏東縣,屏東市,0138,480,226,706,40,746,1289,57.87%,37.24%,1
屏東縣,屏東市,0139,389,184,573,21,594,1115,53.27%,34.89%,1
屏東縣,屏東市,0140,536,270,806,36,842,1491,56.47%,35.95%,1
屏東縣,屏東市,0141,468,199,667,22,689,1411,48.83%,33.17%,1
屏東縣,屏東市,0142,598,295,893,18,911,1803,50.53%,33.17%,1
屏東縣,屏東市,0143,275,138,413,15,428,744,57.53%,36.96%,1
屏東縣,屏東市,0144,237,122,359,12,371,678,54.72%,34.96%,1
屏東縣,屏東市,0145,256,134,390,15,405,681,59.47%,37.59%,1
屏東縣,屏東市,0146,466,241,707,23,730,1535,47.56%,30.36%,1
屏東縣,屏東市,0147,351,141,492,53,545,954,57.13%,36.79%,1
屏東縣,屏東市,0148,403,195,598,19,617,1018,60.61%,39.59%,1
屏東縣,屏東市,0149,413,223,636,21,657,1154,56.93%,35.79%,1
屏東縣,潮州鎮,0150,200,91,291,14,305,504,60.52%,39.68%,1
屏東縣,潮州鎮,0151,543,248,791,29,820,1711,47.93%,31.74%,1
屏東縣,潮州鎮,0152,560,263,823,22,845,1634,51.71%,34.27%,1
屏東縣,潮州鎮,0153,475,183,658,25,683,1414,48.3%,33.59%,1
屏東縣,潮州鎮,0154,244,109,353,28,381,603,63.18%,40.46%,1
屏東縣,潮州鎮,0155,311,143,454,35,489,896,54.58%,34.71%,1
屏東縣,潮州鎮,0156,468,188,656,21,677,1285,52.68%,36.42%,1
屏東縣,潮州鎮,0157,583,253,836,33,869,1744,49.83%,33.43%,1
屏東縣,潮州鎮,0158,419,180,599,21,620,1071,57.89%,39.12%,1
屏東縣,潮州鎮,0159,480,193,673,35,708,1209,58.56%,39.7%,1
屏東縣,潮州鎮,0160,410,185,595,28,623,1159,53.75%,35.38%,1
屏東縣,潮州鎮,0161,432,203,635,29,664,1296,51.23%,33.33%,1
屏東縣,潮州鎮,0162,509,214,723,35,758,1466,51.71%,34.72%,1
屏東縣,潮州鎮,0163,433,190,623,32,655,1130,57.96%,38.32%,1
屏東縣,潮州鎮,0164,515,234,749,29,778,1439,54.07%,35.79%,1
屏東縣,潮州鎮,0165,368,121,489,37,526,897,58.64%,41.03%,1
屏東縣,潮州鎮,0166,474,197,671,31,702,1225,57.31%,38.69%,1
屏東縣,潮州鎮,0167,375,176,551,36,587,1158,50.69%,32.38%,1
屏東縣,潮州鎮,0168,124,71,195,25,220,481,45.74%,25.78%,1
屏東縣,潮州鎮,0169,355,167,522,78,600,972,61.73%,36.52%,1
屏東縣,潮州鎮,0170,501,208,709,27,736,1245,59.12%,40.24%,1
屏東縣,潮州鎮,0171,525,191,716,39,755,1415,53.36%,37.1%,1
屏東縣,潮州鎮,0172,405,182,587,13,600,1255,47.81%,32.27%,1
屏東縣,潮州鎮,0173,292,129,421,22,443,1058,41.87%,27.6%,1
屏東縣,潮州鎮,0174,413,175,588,27,615,1187,51.81%,34.79%,1
屏東縣,潮州鎮,0175,420,156,576,31,607,1083,56.05%,38.78%,1
屏東縣,潮州鎮,0176,524,228,752,25,777,1590,48.87%,32.96%,1
屏東縣,潮州鎮,0177,568,237,805,45,850,1543,55.09%,36.81%,1
屏東縣,潮州鎮,0178,536,245,781,31,812,1631,49.79%,32.86%,1
屏東縣,潮州鎮,0179,445,167,612,15,627,1159,54.1%,38.4%,1
屏東縣,潮州鎮,0180,422,181,603,19,622,1099,56.6%,38.4%,1
屏東縣,潮州鎮,0181,399,162,561,34,595,1200,49.58%,33.25%,1
屏東縣,潮州鎮,0182,479,186,665,39,704,1391,50.61%,34.44%,1
屏東縣,潮州鎮,0183,328,146,474,39,513,881,58.23%,37.23%,1
屏東縣,潮州鎮,0184,163,52,215,15,230,454,50.66%,35.9%,1
屏東縣,潮州鎮,0185,647,230,877,34,911,1658,54.95%,39.02%,1
屏東縣,潮州鎮,0186,287,109,396,26,422,822,51.34%,34.91%,1
屏東縣,潮州鎮,0187,274,143,417,15,432,948,45.57%,28.9%,1
屏東縣,潮州鎮,0188,329,150,479,27,506,1194,42.38%,27.55%,1
屏東縣,潮州鎮,0189,120,48,168,23,191,337,56.68%,35.61%,1
屏東縣,東港鎮,0190,410,151,561,31,592,981,60.35%,41.79%,1
屏東縣,東港鎮,0191,422,180,602,32,634,1070,59.25%,39.44%,1
屏東縣,東港鎮,0192,222,89,311,37,348,527,66.03%,42.13%,1
屏東縣,東港鎮,0193,162,69,231,15,246,395,62.28%,41.01%,1
屏東縣,東港鎮,0194,221,94,315,23,338,659,51.29%,33.54%,1
屏東縣,東港鎮,0195,188,76,264,24,288,513,56.14%,36.65%,1
屏東縣,東港鎮,0196,574,269,843,51,894,1732,51.62%,33.14%,1
屏東縣,東港鎮,0197,626,297,923,31,954,1779,53.63%,35.19%,1
屏東縣,東港鎮,0198,440,177,617,25,642,1270,50.55%,34.65%,1
屏東縣,東港鎮,0199,451,216,667,36,703,1327,52.98%,33.99%,1
屏東縣,東港鎮,0200,460,202,662,35,697,1242,56.12%,37.04%,1
屏東縣,東港鎮,0201,577,269,846,44,890,1607,55.38%,35.91%,1
屏東縣,東港鎮,0202,418,189,607,43,650,1305,49.81%,32.03%,1
屏東縣,東港鎮,0203,228,140,368,23,391,695,56.26%,32.81%,1
屏東縣,東港鎮,0204,423,190,613,47,660,1076,61.34%,39.31%,1
屏東縣,東港鎮,0205,188,88,276,16,292,567,51.5%,33.16%,1
屏東縣,東港鎮,0206,295,119,414,25,439,806,54.47%,36.6%,1
屏東縣,東港鎮,0207,465,182,647,41,688,1227,56.07%,37.9%,1
屏東縣,東港鎮,0208,204,85,289,38,327,599,54.59%,34.06%,1
屏東縣,東港鎮,0209,387,155,542,35,577,1354,42.61%,28.58%,1
屏東縣,東港鎮,0210,229,124,353,38,391,734,53.27%,31.2%,1
屏東縣,東港鎮,0211,389,179,568,67,635,1107,57.36%,35.14%,1
屏東縣,東港鎮,0212,382,152,534,59,593,1198,49.5%,31.89%,1
屏東縣,東港鎮,0213,517,282,799,67,866,1614,53.66%,32.03%,1
屏東縣,東港鎮,0214,253,135,388,37,425,826,51.45%,30.63%,1
屏東縣,東港鎮,0215,390,103,493,28,521,912,57.13%,42.76%,1
屏東縣,東港鎮,0216,147,50,197,26,223,432,51.62%,34.03%,1
屏東縣,東港鎮,0217,434,177,611,78,689,1204,57.23%,36.05%,1
屏東縣,東港鎮,0218,476,199,675,50,725,1304,55.6%,36.5%,1
屏東縣,東港鎮,0219,497,210,707,43,750,1317,56.95%,37.74%,1
屏東縣,東港鎮,0220,484,206,690,22,712,1387,51.33%,34.9%,1
屏東縣,東港鎮,0221,423,169,592,22,614,1310,46.87%,32.29%,1
屏東縣,東港鎮,0222,369,189,558,47,605,1228,49.27%,30.05%,1
屏東縣,東港鎮,0223,216,125,341,32,373,766,48.69%,28.2%,1
屏東縣,東港鎮,0224,281,159,440,36,476,823,57.84%,34.14%,1
屏東縣,東港鎮,0225,213,82,295,21,316,755,41.85%,28.21%,1
屏東縣,東港鎮,0226,352,207,559,62,621,1094,56.76%,32.18%,1
屏東縣,東港鎮,0227,257,99,356,18,374,753,49.67%,34.13%,1
屏東縣,恆春鎮,0228,306,120,426,24,450,902,49.89%,33.92%,1
屏東縣,恆春鎮,0229,374,146,520,33,553,969,57.07%,38.6%,1
屏東縣,恆春鎮,0230,379,214,593,40,633,1280,49.45%,29.61%,1
屏東縣,恆春鎮,0231,391,192,583,29,612,1133,54.02%,34.51%,1
屏東縣,恆春鎮,0232,410,228,638,16,654,1552,42.14%,26.42%,1
屏東縣,恆春鎮,0233,386,190,576,43,619,1485,41.68%,25.99%,1
屏東縣,恆春鎮,0234,297,158,455,25,480,896,53.57%,33.15%,1
屏東縣,恆春鎮,0235,154,77,231,19,250,531,47.08%,29%,1
屏東縣,恆春鎮,0236,152,60,212,12,224,478,46.86%,31.8%,1
屏東縣,恆春鎮,0237,311,143,454,35,489,1020,47.94%,30.49%,1
屏東縣,恆春鎮,0238,243,190,433,20,453,924,49.03%,26.3%,1
屏東縣,恆春鎮,0239,268,174,442,28,470,1079,43.56%,24.84%,1
屏東縣,恆春鎮,0240,220,80,300,25,325,775,41.94%,28.39%,1
屏東縣,恆春鎮,0241,274,121,395,49,444,813,54.61%,33.7%,1
屏東縣,恆春鎮,0242,390,100,490,39,529,1104,47.92%,35.33%,1
屏東縣,恆春鎮,0243,295,172,467,35,502,1110,45.23%,26.58%,1
屏東縣,恆春鎮,0244,163,93,256,41,297,692,42.92%,23.55%,1
屏東縣,恆春鎮,0245,135,104,239,12,251,708,35.45%,19.07%,1
屏東縣,恆春鎮,0246,473,221,694,31,725,1505,48.17%,31.43%,1
屏東縣,恆春鎮,0247,329,158,487,34,521,1111,46.89%,29.61%,1
屏東縣,恆春鎮,0248,475,200,675,34,709,1543,45.95%,30.78%,1
屏東縣,恆春鎮,0249,206,115,321,20,341,828,41.18%,24.88%,1
屏東縣,恆春鎮,0250,266,149,415,30,445,844,52.73%,31.52%,1
屏東縣,恆春鎮,0251,372,199,571,39,610,1253,48.68%,29.69%,1
屏東縣,恆春鎮,0252,332,144,476,37,513,1126,45.56%,29.48%,1
屏東縣,萬丹鄉,0253,468,192,660,37,697,1527,45.65%,30.65%,1
屏東縣,萬丹鄉,0254,359,172,531,41,572,1147,49.87%,31.3%,1
屏東縣,萬丹鄉,0255,291,152,443,36,479,949,50.47%,30.66%,1
屏東縣,萬丹鄉,0256,315,151,466,18,484,990,48.89%,31.82%,1
屏東縣,萬丹鄉,0257,350,144,494,18,512,1022,50.1%,34.25%,1
屏東縣,萬丹鄉,0258,248,83,331,40,371,545,68.07%,45.5%,1
屏東縣,萬丹鄉,0259,472,176,648,54,702,1159,60.57%,40.72%,1
屏東縣,萬丹鄉,0260,313,157,470,41,511,837,61.05%,37.4%,1
屏東縣,萬丹鄉,0261,134,55,189,11,200,392,51.02%,34.18%,1
屏東縣,萬丹鄉,0262,318,141,459,29,488,847,57.62%,37.54%,1
屏東縣,萬丹鄉,0263,392,173,565,30,595,1149,51.78%,34.12%,1
屏東縣,萬丹鄉,0264,420,171,591,25,616,1131,54.47%,37.14%,1
屏東縣,萬丹鄉,0265,406,171,577,33,610,1178,51.78%,34.47%,1
屏東縣,萬丹鄉,0266,272,134,406,21,427,711,60.06%,38.26%,1
屏東縣,萬丹鄉,0267,246,117,363,19,382,595,64.2%,41.34%,1
屏東縣,萬丹鄉,0268,531,233,764,42,806,1403,57.45%,37.85%,1
屏東縣,萬丹鄉,0269,381,166,547,20,567,1094,51.83%,34.83%,1
屏東縣,萬丹鄉,0270,433,204,637,27,664,1158,57.34%,37.39%,1
屏東縣,萬丹鄉,0271,380,180,560,40,600,963,62.31%,39.46%,1
屏東縣,萬丹鄉,0272,393,176,569,27,596,1062,56.12%,37.01%,1
屏東縣,萬丹鄉,0273,567,269,836,55,891,1684,52.91%,33.67%,1
屏東縣,萬丹鄉,0274,543,260,803,33,836,1702,49.12%,31.9%,1
屏東縣,萬丹鄉,0275,374,177,551,23,574,976,58.81%,38.32%,1
屏東縣,萬丹鄉,0276,348,156,504,56,560,1013,55.28%,34.35%,1
屏東縣,萬丹鄉,0277,243,112,355,33,388,847,45.81%,28.69%,1
屏東縣,萬丹鄉,0278,573,252,825,87,912,1570,58.09%,36.5%,1
屏東縣,萬丹鄉,0279,451,196,647,56,703,1411,49.82%,31.96%,1
屏東縣,萬丹鄉,0280,365,194,559,46,605,1046,57.84%,34.89%,1
屏東縣,萬丹鄉,0281,458,223,681,32,713,1385,51.48%,33.07%,1
屏東縣,萬丹鄉,0282,287,123,410,38,448,804,55.72%,35.7%,1
屏東縣,萬丹鄉,0283,447,213,660,45,705,1284,54.91%,34.81%,1
屏東縣,萬丹鄉,0284,451,226,677,32,709,1430,49.58%,31.54%,1
屏東縣,萬丹鄉,0285,392,170,562,40,602,960,62.71%,40.83%,1
屏東縣,萬丹鄉,0286,321,127,448,35,483,786,61.45%,40.84%,1
屏東縣,萬丹鄉,0287,399,192,591,57,648,1158,55.96%,34.46%,1
屏東縣,萬丹鄉,0288,475,193,668,44,712,1647,43.23%,28.84%,1
屏東縣,萬丹鄉,0289,512,215,727,52,779,1666,46.76%,30.73%,1
屏東縣,萬丹鄉,0290,418,173,591,37,628,1023,61.39%,40.86%,1
屏東縣,萬丹鄉,0291,479,207,686,33,719,1227,58.6%,39.04%,1
屏東縣,長治鄉,0292,364,161,525,44,569,1018,55.89%,35.76%,1
屏東縣,長治鄉,0293,579,254,833,43,876,1614,54.28%,35.87%,1
屏東縣,長治鄉,0294,703,313,1016,43,1059,1848,57.31%,38.04%,1
屏東縣,長治鄉,0295,640,240,880,50,930,1707,54.48%,37.49%,1
屏東縣,長治鄉,0296,379,162,541,13,554,972,57%,38.99%,1
屏東縣,長治鄉,0297,372,163,535,36,571,989,57.74%,37.61%,1
屏東縣,長治鄉,0298,289,131,420,25,445,735,60.54%,39.32%,1
屏東縣,長治鄉,0299,538,316,854,43,897,1813,49.48%,29.67%,1
屏東縣,長治鄉,0300,426,197,623,28,651,1073,60.67%,39.7%,1
屏東縣,長治鄉,0301,575,253,828,47,875,1654,52.9%,34.76%,1
屏東縣,長治鄉,0302,400,239,639,46,685,1205,56.85%,33.2%,1
屏東縣,長治鄉,0303,252,154,406,28,434,758,57.26%,33.25%,1
屏東縣,長治鄉,0304,510,251,761,66,827,1492,55.43%,34.18%,1
屏東縣,長治鄉,0305,351,132,483,33,516,884,58.37%,39.71%,1
屏東縣,長治鄉,0306,421,171,592,36,628,1090,57.61%,38.62%,1
屏東縣,長治鄉,0307,416,225,641,71,712,1422,50.07%,29.25%,1
屏東縣,長治鄉,0308,297,130,427,41,468,845,55.38%,35.15%,1
屏東縣,長治鄉,0309,309,147,456,80,536,925,57.95%,33.41%,1
屏東縣,長治鄉,0310,460,163,623,11,634,1138,55.71%,40.42%,1
屏東縣,長治鄉,0311,455,171,626,64,690,1242,55.56%,36.63%,1
屏東縣,長治鄉,0312,372,163,535,18,553,1159,47.71%,32.1%,1
屏東縣,長治鄉,0313,248,124,372,29,401,673,59.58%,36.85%,1
屏東縣,麟洛鄉,0314,269,159,428,22,450,788,57.11%,34.14%,1
屏東縣,麟洛鄉,0315,555,257,812,24,836,1386,60.32%,40.04%,1
屏東縣,麟洛鄉,0316,362,196,558,28,586,957,61.23%,37.83%,1
屏東縣,麟洛鄉,0317,256,160,416,36,452,731,61.83%,35.02%,1
屏東縣,麟洛鄉,0318,306,159,465,39,504,806,62.53%,37.97%,1
屏東縣,麟洛鄉,0319,414,200,614,14,628,1207,52.03%,34.3%,1
屏東縣,麟洛鄉,0320,490,277,767,53,820,1340,61.19%,36.57%,1
屏東縣,麟洛鄉,0321,461,248,709,41,750,1221,61.43%,37.76%,1
屏東縣,麟洛鄉,0322,313,155,468,15,483,851,56.76%,36.78%,1
屏東縣,麟洛鄉,0323,244,102,346,11,357,683,52.27%,35.72%,1
屏東縣,九如鄉,0324,546,237,783,59,842,1491,56.47%,36.62%,1
屏東縣,九如鄉,0325,474,228,702,38,740,1375,53.82%,34.47%,1
屏東縣,九如鄉,0326,552,242,794,50,844,1678,50.3%,32.9%,1
屏東縣,九如鄉,0327,405,213,618,67,685,1166,58.75%,34.73%,1
屏東縣,九如鄉,0328,438,90,528,40,568,1276,44.51%,34.33%,1
屏東縣,九如鄉,0329,382,166,548,38,586,1033,56.73%,36.98%,1
屏東縣,九如鄉,0330,255,114,369,28,397,577,68.8%,44.19%,1
屏東縣,九如鄉,0331,256,105,361,39,400,649,61.63%,39.45%,1
屏東縣,九如鄉,0332,696,320,1016,80,1096,1999,54.83%,34.82%,1
屏東縣,九如鄉,0333,568,296,864,52,916,1766,51.87%,32.16%,1
屏東縣,九如鄉,0334,502,267,769,66,835,1600,52.19%,31.37%,1
屏東縣,九如鄉,0335,406,229,635,49,684,1248,54.81%,32.53%,1
屏東縣,九如鄉,0336,645,285,930,112,1042,1792,58.15%,35.99%,1
屏東縣,九如鄉,0337,509,229,738,75,813,1482,54.86%,34.35%,1
屏東縣,里港鄉,0338,566,289,855,62,917,1552,59.09%,36.47%,1
屏東縣,里港鄉,0339,497,231,728,60,788,1480,53.24%,33.58%,1
屏東縣,里港鄉,0340,422,224,646,42,688,1534,44.85%,27.51%,1
屏東縣,里港鄉,0341,572,239,811,44,855,1578,54.18%,36.25%,1
屏東縣,里港鄉,0342,440,193,633,40,673,1127,59.72%,39.04%,1
屏東縣,里港鄉,0343,323,142,465,32,497,845,58.82%,38.22%,1
屏東縣,里港鄉,0344,451,192,643,42,685,1282,53.43%,35.18%,1
屏東縣,里港鄉,0345,372,162,534,36,570,981,58.1%,37.92%,1
屏東縣,里港鄉,0346,355,195,550,49,599,1031,58.1%,34.43%,1
屏東縣,里港鄉,0347,469,261,730,72,802,1423,56.36%,32.96%,1
屏東縣,里港鄉,0348,112,50,162,18,180,363,49.59%,30.85%,1
屏東縣,里港鄉,0349,374,238,612,91,703,1203,58.44%,31.09%,1
屏東縣,里港鄉,0350,383,192,575,63,638,1027,62.12%,37.29%,1
屏東縣,里港鄉,0351,453,217,670,52,722,1384,52.17%,32.73%,1
屏東縣,里港鄉,0352,499,241,740,44,784,1512,51.85%,33%,1
屏東縣,里港鄉,0353,215,78,293,15,308,522,59%,41.19%,1
屏東縣,里港鄉,0354,271,136,407,52,459,822,55.84%,32.97%,1
屏東縣,里港鄉,0355,304,163,467,62,529,1007,52.53%,30.19%,1
屏東縣,里港鄉,0356,324,156,480,57,537,956,56.17%,33.89%,1
屏東縣,里港鄉,0357,167,96,263,19,282,499,56.51%,33.47%,1
屏東縣,鹽埔鄉,0358,352,133,485,26,511,951,53.73%,37.01%,1
屏東縣,鹽埔鄉,0359,296,138,434,22,456,899,50.72%,32.93%,1
屏東縣,鹽埔鄉,0360,360,161,521,17,538,1116,48.21%,32.26%,1
屏東縣,鹽埔鄉,0361,408,189,597,32,629,1241,50.68%,32.88%,1
屏東縣,鹽埔鄉,0362,234,129,363,43,406,770,52.73%,30.39%,1
屏東縣,鹽埔鄉,0363,340,143,483,27,510,962,53.01%,35.34%,1
屏東縣,鹽埔鄉,0364,406,187,593,39,632,1041,60.71%,39%,1
屏東縣,鹽埔鄉,0365,441,213,654,55,709,1367,51.87%,32.26%,1
屏東縣,鹽埔鄉,0366,440,245,685,50,735,1465,50.17%,30.03%,1
屏東縣,鹽埔鄉,0367,247,133,380,40,420,894,46.98%,27.63%,1
屏東縣,鹽埔鄉,0368,271,139,410,3,413,958,43.11%,28.29%,1
屏東縣,鹽埔鄉,0369,291,151,442,53,495,924,53.57%,31.49%,1
屏東縣,鹽埔鄉,0370,529,209,738,24,762,1598,47.68%,33.1%,1
屏東縣,鹽埔鄉,0371,501,259,760,72,832,1550,53.68%,32.32%,1
屏東縣,鹽埔鄉,0372,380,182,562,41,603,1127,53.5%,33.72%,1
屏東縣,鹽埔鄉,0373,415,201,616,56,672,1150,58.43%,36.09%,1
屏東縣,鹽埔鄉,0374,441,204,645,38,683,1233,55.39%,35.77%,1
屏東縣,鹽埔鄉,0375,378,152,530,64,594,984,60.37%,38.41%,1
屏東縣,鹽埔鄉,0376,542,301,843,50,893,1619,55.16%,33.48%,1
屏東縣,鹽埔鄉,0377,184,103,287,21,308,553,55.7%,33.27%,1
屏東縣,高樹鄉,0378,331,164,495,60,555,883,62.85%,37.49%,1
屏東縣,高樹鄉,0379,337,145,482,16,498,1255,39.68%,26.85%,1
屏東縣,高樹鄉,0380,566,77,643,26,669,1278,52.35%,44.29%,1
屏東縣,高樹鄉,0381,237,81,318,27,345,738,46.75%,32.11%,1
屏東縣,高樹鄉,0382,166,101,267,13,280,585,47.86%,28.38%,1
屏東縣,高樹鄉,0383,328,188,516,82,598,1012,59.09%,32.41%,1
屏東縣,高樹鄉,0384,242,293,535,52,587,1148,51.13%,21.08%,1
屏東縣,高樹鄉,0385,173,102,275,29,304,591,51.44%,29.27%,1
屏東縣,高樹鄉,0386,200,116,316,51,367,786,46.69%,25.45%,1
屏東縣,高樹鄉,0387,187,77,264,22,286,649,44.07%,28.81%,1
屏東縣,高樹鄉,0388,333,144,477,47,524,1229,42.64%,27.1%,1
屏東縣,高樹鄉,0389,415,170,585,39,624,1446,43.15%,28.7%,1
屏東縣,高樹鄉,0390,205,139,344,16,360,899,40.04%,22.8%,1
屏東縣,高樹鄉,0391,284,143,427,51,478,922,51.84%,30.8%,1
屏東縣,高樹鄉,0392,344,193,537,58,595,1259,47.26%,27.32%,1
屏東縣,高樹鄉,0393,345,114,459,13,472,1056,44.7%,32.67%,1
屏東縣,高樹鄉,0394,358,208,566,50,616,1116,55.2%,32.08%,1
屏東縣,高樹鄉,0395,347,165,512,60,572,1020,56.08%,34.02%,1
屏東縣,高樹鄉,0396,327,190,517,58,575,1055,54.5%,31%,1
屏東縣,高樹鄉,0397,250,147,397,45,442,738,59.89%,33.88%,1
屏東縣,高樹鄉,0398,145,66,211,24,235,493,47.67%,29.41%,1
屏東縣,高樹鄉,0399,503,277,780,89,869,1539,56.47%,32.68%,1
屏東縣,萬巒鄉,0400,421,185,606,30,636,1239,51.33%,33.98%,1
屏東縣,萬巒鄉,0401,282,122,404,36,440,759,57.97%,37.15%,1
屏東縣,萬巒鄉,0402,350,146,496,52,548,932,58.8%,37.55%,1
屏東縣,萬巒鄉,0403,290,131,421,46,467,769,60.73%,37.71%,1
屏東縣,萬巒鄉,0404,314,138,452,55,507,920,55.11%,34.13%,1
屏東縣,萬巒鄉,0405,199,99,298,27,325,560,58.04%,35.54%,1
屏東縣,萬巒鄉,0406,375,142,517,22,539,1120,48.13%,33.48%,1
屏東縣,萬巒鄉,0407,375,134,509,23,532,1048,50.76%,35.78%,1
屏東縣,萬巒鄉,0408,439,174,613,44,657,1438,45.69%,30.53%,1
屏東縣,萬巒鄉,0409,251,138,389,27,416,834,49.88%,30.1%,1
屏東縣,萬巒鄉,0410,279,116,395,38,433,813,53.26%,34.32%,1
屏東縣,萬巒鄉,0411,412,122,534,20,554,1020,54.31%,40.39%,1
屏東縣,萬巒鄉,0412,398,161,559,40,599,1007,59.48%,39.52%,1
屏東縣,萬巒鄉,0413,471,199,670,59,729,1648,44.24%,28.58%,1
屏東縣,萬巒鄉,0414,491,211,702,41,743,1437,51.7%,34.17%,1
屏東縣,萬巒鄉,0415,390,170,560,0,560,1228,45.6%,31.76%,1
屏東縣,萬巒鄉,0416,243,84,327,32,359,597,60.13%,40.7%,1
屏東縣,萬巒鄉,0417,199,94,293,38,331,576,57.47%,34.55%,1
屏東縣,內埔鄉,0418,413,164,577,28,605,1305,46.36%,31.65%,1
屏東縣,內埔鄉,0419,423,163,586,36,622,1287,48.33%,32.87%,1
屏東縣,內埔鄉,0420,452,188,640,14,654,1387,47.15%,32.59%,1
屏東縣,內埔鄉,0421,484,208,692,37,729,1540,47.34%,31.43%,1
屏東縣,內埔鄉,0422,511,243,754,34,788,1605,49.1%,31.84%,1
屏東縣,內埔鄉,0423,427,200,627,45,672,1326,50.68%,32.2%,1
屏東縣,內埔鄉,0424,193,100,293,41,334,591,56.51%,32.66%,1
屏東縣,內埔鄉,0425,343,159,502,31,533,1123,47.46%,30.54%,1
屏東縣,內埔鄉,0426,378,141,519,18,537,1079,49.77%,35.03%,1
屏東縣,內埔鄉,0427,515,223,738,32,770,1485,51.85%,34.68%,1
屏東縣,內埔鄉,0428,499,190,689,25,714,1248,57.21%,39.98%,1
屏東縣,內埔鄉,0429,521,253,774,38,812,1569,51.75%,33.21%,1
屏東縣,內埔鄉,0430,467,211,678,38,716,1493,47.96%,31.28%,1
屏東縣,內埔鄉,0431,451,205,656,10,666,1420,46.9%,31.76%,1
屏東縣,內埔鄉,0432,456,197,653,41,694,1334,52.02%,34.18%,1
屏東縣,內埔鄉,0433,468,230,698,42,740,1519,48.72%,30.81%,1
屏東縣,內埔鄉,0434,271,115,386,35,421,784,53.7%,34.57%,1
屏東縣,內埔鄉,0435,316,144,460,46,506,888,56.98%,35.59%,1
屏東縣,內埔鄉,0436,254,87,341,10,351,747,46.99%,34%,1
屏東縣,內埔鄉,0437,352,146,498,28,526,1168,45.03%,30.14%,1
屏東縣,內埔鄉,0438,181,104,285,27,312,546,57.14%,33.15%,1
屏東縣,內埔鄉,0439,401,193,594,45,639,1278,50%,31.38%,1
屏東縣,內埔鄉,0440,406,177,583,40,623,1348,46.22%,30.12%,1
屏東縣,內埔鄉,0441,412,170,582,57,639,1550,41.23%,26.58%,1
屏東縣,內埔鄉,0442,381,144,525,53,578,947,61.03%,40.23%,1
屏東縣,內埔鄉,0443,370,151,521,42,563,1097,51.32%,33.73%,1
屏東縣,內埔鄉,0444,274,165,439,42,481,1128,42.64%,24.29%,1
屏東縣,內埔鄉,0445,310,133,443,20,463,1253,36.95%,24.74%,1
屏東縣,內埔鄉,0446,492,180,672,15,687,1525,45.05%,32.26%,1
屏東縣,內埔鄉,0447,394,209,603,43,646,1215,53.17%,32.43%,1
屏東縣,內埔鄉,0448,368,140,508,22,530,1216,43.59%,30.26%,1
屏東縣,內埔鄉,0449,418,177,595,22,617,1353,45.6%,30.89%,1
屏東縣,內埔鄉,0450,360,141,501,20,521,1026,50.78%,35.09%,1
屏東縣,內埔鄉,0451,270,103,373,33,406,862,47.1%,31.32%,1
屏東縣,內埔鄉,0452,247,127,374,30,404,921,43.87%,26.82%,1
屏東縣,內埔鄉,0453,267,146,413,29,442,854,51.76%,31.26%,1
屏東縣,內埔鄉,0454,418,121,539,25,564,1230,45.85%,33.98%,1
屏東縣,內埔鄉,0455,404,151,555,19,574,1204,47.67%,33.55%,1
屏東縣,內埔鄉,0456,392,177,569,32,601,1301,46.2%,30.13%,1
屏東縣,內埔鄉,0457,296,121,417,37,454,806,56.33%,36.72%,1
屏東縣,竹田鄉,0458,560,222,782,63,845,1503,56.22%,37.26%,1
屏東縣,竹田鄉,0459,355,174,529,28,557,899,61.96%,39.49%,1
屏東縣,竹田鄉,0460,233,169,402,49,451,716,62.99%,32.54%,1
屏東縣,竹田鄉,0461,233,124,357,26,383,581,65.92%,40.1%,1
屏東縣,竹田鄉,0462,470,203,673,66,739,1327,55.69%,35.42%,1
屏東縣,竹田鄉,0463,387,177,564,66,630,997,63.19%,38.82%,1
屏東縣,竹田鄉,0464,226,110,336,27,363,649,55.93%,34.82%,1
屏東縣,竹田鄉,0465,240,95,335,13,348,476,73.11%,50.42%,1
屏東縣,竹田鄉,0466,488,200,688,55,743,1259,59.02%,38.76%,1
屏東縣,竹田鄉,0467,414,180,594,51,645,1227,52.57%,33.74%,1
屏東縣,竹田鄉,0468,201,96,297,25,322,504,63.89%,39.88%,1
屏東縣,竹田鄉,0469,294,138,432,35,467,860,54.3%,34.19%,1
屏東縣,竹田鄉,0470,277,131,408,26,434,800,54.25%,34.63%,1
屏東縣,竹田鄉,0471,422,188,610,51,661,1134,58.29%,37.21%,1
屏東縣,竹田鄉,0472,425,296,721,44,765,1229,62.25%,34.58%,1
屏東縣,竹田鄉,0473,388,193,581,47,628,1192,52.68%,32.55%,1
屏東縣,新埤鄉,0474,570,244,814,32,846,1712,49.42%,33.29%,1
屏東縣,新埤鄉,0475,104,49,153,24,177,314,56.37%,33.12%,1
屏東縣,新埤鄉,0476,245,137,382,28,410,752,54.52%,32.58%,1
屏東縣,新埤鄉,0477,122,47,169,13,182,334,54.49%,36.53%,1
屏東縣,新埤鄉,0478,349,157,506,43,549,957,57.37%,36.47%,1
屏東縣,新埤鄉,0479,285,119,404,47,451,764,59.03%,37.3%,1
屏東縣,新埤鄉,0480,130,64,194,18,212,373,56.84%,34.85%,1
屏東縣,新埤鄉,0481,190,94,284,33,317,678,46.76%,28.02%,1
屏東縣,新埤鄉,0482,200,90,290,29,319,701,45.51%,28.53%,1
屏東縣,新埤鄉,0483,325,175,500,46,546,1323,41.27%,24.57%,1
屏東縣,新埤鄉,0484,189,88,277,35,312,541,57.67%,34.94%,1
屏東縣,新埤鄉,0485,167,68,235,33,268,584,45.89%,28.6%,1
屏東縣,枋寮鄉,0486,460,184,644,35,679,1213,55.98%,37.92%,1
屏東縣,枋寮鄉,0487,334,149,483,42,525,891,58.92%,37.49%,1
屏東縣,枋寮鄉,0488,334,113,447,49,496,970,51.13%,34.43%,1
屏東縣,枋寮鄉,0489,239,83,322,17,339,629,53.9%,38%,1
屏東縣,枋寮鄉,0490,320,146,466,31,497,840,59.17%,38.1%,1
屏東縣,枋寮鄉,0491,308,125,433,26,459,774,59.3%,39.79%,1
屏東縣,枋寮鄉,0492,474,190,664,50,714,1379,51.78%,34.37%,1
屏東縣,枋寮鄉,0493,534,266,800,40,840,1502,55.93%,35.55%,1
屏東縣,枋寮鄉,0494,417,210,627,49,676,1276,52.98%,32.68%,1
屏東縣,枋寮鄉,0495,341,133,474,48,522,964,54.15%,35.37%,1
屏東縣,枋寮鄉,0496,392,161,553,60,613,1005,61%,39%,1
屏東縣,枋寮鄉,0497,244,117,361,24,385,734,52.45%,33.24%,1
屏東縣,枋寮鄉,0498,280,104,384,34,418,725,57.66%,38.62%,1
屏東縣,枋寮鄉,0499,329,167,496,54,550,1046,52.58%,31.45%,1
屏東縣,枋寮鄉,0500,388,169,557,54,611,1067,57.26%,36.36%,1
屏東縣,枋寮鄉,0501,169,76,245,39,284,718,39.55%,23.54%,1
屏東縣,枋寮鄉,0502,260,124,384,40,424,903,46.95%,28.79%,1
屏東縣,枋寮鄉,0503,467,179,646,60,706,1387,50.9%,33.67%,1
屏東縣,枋寮鄉,0504,481,211,692,63,755,1367,55.23%,35.19%,1
屏東縣,枋寮鄉,0505,225,133,358,34,392,618,63.43%,36.41%,1
屏東縣,枋寮鄉,0506,259,104,363,28,391,959,40.77%,27.01%,1
屏東縣,枋寮鄉,0507,146,69,215,23,238,427,55.74%,34.19%,1
屏東縣,新園鄉,0508,275,153,428,44,472,820,57.56%,33.54%,1
屏東縣,新園鄉,0509,325,143,468,45,513,843,60.85%,38.55%,1
屏東縣,新園鄉,0510,308,299,607,36,643,1242,51.77%,24.8%,1
屏東縣,新園鄉,0511,484,211,695,48,743,1290,57.6%,37.52%,1
屏東縣,新園鄉,0512,372,162,534,30,564,1073,52.56%,34.67%,1
屏東縣,新園鄉,0513,388,192,580,69,649,1088,59.65%,35.66%,1
屏東縣,新園鄉,0514,284,113,397,23,420,845,49.7%,33.61%,1
屏東縣,新園鄉,0515,281,159,440,30,470,862,54.52%,32.6%,1
屏東縣,新園鄉,0516,371,177,548,39,587,1183,49.62%,31.36%,1
屏東縣,新園鄉,0517,377,174,551,59,610,1109,55%,33.99%,1
屏東縣,新園鄉,0518,315,194,509,16,525,1119,46.92%,28.15%,1
屏東縣,新園鄉,0519,348,196,544,25,569,1152,49.39%,30.21%,1
屏東縣,新園鄉,0520,380,151,531,44,575,1030,55.83%,36.89%,1
屏東縣,新園鄉,0521,359,170,529,57,586,1104,53.08%,32.52%,1
屏東縣,新園鄉,0522,410,169,579,32,611,1240,49.27%,33.06%,1
屏東縣,新園鄉,0523,280,164,444,19,463,1120,41.34%,25%,1
屏東縣,新園鄉,0524,403,162,565,59,624,1074,58.1%,37.52%,1
屏東縣,新園鄉,0525,243,126,369,33,402,849,47.35%,28.62%,1
屏東縣,新園鄉,0526,252,124,376,35,411,749,54.87%,33.64%,1
屏東縣,新園鄉,0527,433,225,658,64,722,1416,50.99%,30.58%,1
屏東縣,新園鄉,0528,332,130,462,34,496,895,55.42%,37.09%,1
屏東縣,新園鄉,0529,326,129,455,61,516,933,55.31%,34.94%,1
屏東縣,新園鄉,0530,352,144,496,26,522,972,53.7%,36.21%,1
屏東縣,新園鄉,0531,453,186,639,40,679,1454,46.7%,31.16%,1
屏東縣,新園鄉,0532,646,250,896,69,965,1653,58.38%,39.08%,1
屏東縣,新園鄉,0533,458,153,611,32,643,1270,50.63%,36.06%,1
屏東縣,新園鄉,0534,425,178,603,79,682,1123,60.73%,37.85%,1
屏東縣,新園鄉,0535,422,162,584,36,620,1198,51.75%,35.23%,1
屏東縣,崁頂鄉,0536,387,170,557,32,589,1190,49.5%,32.52%,1
屏東縣,崁頂鄉,0537,389,188,577,36,613,1044,58.72%,37.26%,1
屏東縣,崁頂鄉,0538,282,137,419,37,456,818,55.75%,34.47%,1
屏東縣,崁頂鄉,0539,380,216,596,34,630,1214,51.89%,31.3%,1
屏東縣,崁頂鄉,0540,432,179,611,32,643,1325,48.53%,32.6%,1
屏東縣,崁頂鄉,0541,480,200,680,39,719,1253,57.38%,38.31%,1
屏東縣,崁頂鄉,0542,335,160,495,33,528,1039,50.82%,32.24%,1
屏東縣,崁頂鄉,0543,247,116,363,33,396,813,48.71%,30.38%,1
屏東縣,崁頂鄉,0544,233,115,348,23,371,736,50.41%,31.66%,1
屏東縣,崁頂鄉,0545,318,183,501,31,532,934,56.96%,34.05%,1
屏東縣,崁頂鄉,0546,277,147,424,50,474,900,52.67%,30.78%,1
屏東縣,崁頂鄉,0547,355,144,499,42,541,1004,53.88%,35.36%,1
屏東縣,林邊鄉,0548,596,222,818,48,866,1458,59.4%,40.88%,1
屏東縣,林邊鄉,0549,381,148,529,32,561,891,62.96%,42.76%,1
屏東縣,林邊鄉,0550,279,111,390,31,421,695,60.58%,40.14%,1
屏東縣,林邊鄉,0551,403,163,566,42,608,1015,59.9%,39.7%,1
屏東縣,林邊鄉,0552,445,188,633,43,676,1171,57.73%,38%,1
屏東縣,林邊鄉,0553,341,162,503,40,543,1003,54.14%,34%,1
屏東縣,林邊鄉,0554,303,125,428,34,462,725,63.72%,41.79%,1
屏東縣,林邊鄉,0555,337,124,461,40,501,841,59.57%,40.07%,1
屏東縣,林邊鄉,0556,295,142,437,36,473,793,59.65%,37.2%,1
屏東縣,林邊鄉,0557,365,136,501,46,547,919,59.52%,39.72%,1
屏東縣,林邊鄉,0558,408,203,611,55,666,1283,51.91%,31.8%,1
屏東縣,林邊鄉,0559,240,119,359,35,394,783,50.32%,30.65%,1
屏東縣,林邊鄉,0560,332,142,474,35,509,1033,49.27%,32.14%,1
屏東縣,林邊鄉,0561,402,159,561,81,642,1186,54.13%,33.9%,1
屏東縣,林邊鄉,0562,246,126,372,50,422,773,54.59%,31.82%,1
屏東縣,林邊鄉,0563,372,139,511,29,540,1122,48.13%,33.16%,1
屏東縣,南州鄉,0564,296,125,421,52,473,872,54.24%,33.94%,1
屏東縣,南州鄉,0565,280,133,413,25,438,794,55.16%,35.26%,1
屏東縣,南州鄉,0566,354,160,514,47,561,962,58.32%,36.8%,1
屏東縣,南州鄉,0567,346,174,520,57,577,1033,55.86%,33.49%,1
屏東縣,南州鄉,0568,314,165,479,42,521,1007,51.74%,31.18%,1
屏東縣,南州鄉,0569,184,77,261,17,278,466,59.66%,39.48%,1
屏東縣,南州鄉,0570,275,113,388,27,415,708,58.62%,38.84%,1
屏東縣,南州鄉,0571,352,188,540,51,591,1044,56.61%,33.72%,1
屏東縣,南州鄉,0572,290,147,437,39,476,1071,44.44%,27.08%,1
屏東縣,南州鄉,0573,298,178,476,29,505,979,51.58%,30.44%,1
屏東縣,南州鄉,0574,172,71,243,31,274,543,50.46%,31.68%,1
屏東縣,佳冬鄉,0575,425,222,647,40,687,1472,46.67%,28.87%,1
屏東縣,佳冬鄉,0576,398,164,562,50,612,1360,45%,29.26%,1
屏東縣,佳冬鄉,0577,303,107,410,59,469,804,58.33%,37.69%,1
屏東縣,佳冬鄉,0578,270,159,429,57,486,925,52.54%,29.19%,1
屏東縣,佳冬鄉,0579,230,141,371,18,389,855,45.5%,26.9%,1
屏東縣,佳冬鄉,0580,289,149,438,49,487,981,49.64%,29.46%,1
屏東縣,佳冬鄉,0581,289,165,454,47,501,1007,49.75%,28.7%,1
屏東縣,佳冬鄉,0582,240,128,368,45,413,872,47.36%,27.52%,1
屏東縣,佳冬鄉,0583,333,193,526,47,573,1255,45.66%,26.53%,1
屏東縣,佳冬鄉,0584,377,134,511,55,566,995,56.88%,37.89%,1
屏東縣,佳冬鄉,0585,191,107,298,28,326,734,44.41%,26.02%,1
屏東縣,佳冬鄉,0586,300,209,509,27,536,1178,45.5%,25.47%,1
屏東縣,佳冬鄉,0587,309,167,476,53,529,1095,48.31%,28.22%,1
屏東縣,佳冬鄉,0588,438,156,594,61,655,1097,59.71%,39.93%,1
屏東縣,佳冬鄉,0589,471,153,624,45,669,1273,52.55%,37%,1
屏東縣,佳冬鄉,0590,443,178,621,36,657,1160,56.64%,38.19%,1
屏東縣,琉球鄉,0591,294,144,438,31,469,1111,42.21%,26.46%,1
屏東縣,琉球鄉,0592,292,119,411,29,440,972,45.27%,30.04%,1
屏東縣,琉球鄉,0593,451,149,600,55,655,1278,51.25%,35.29%,1
屏東縣,琉球鄉,0594,333,121,454,41,495,976,50.72%,34.12%,1
屏東縣,琉球鄉,0595,531,192,723,67,790,1658,47.65%,32.03%,1
屏東縣,琉球鄉,0596,319,106,425,24,449,1146,39.18%,27.84%,1
屏東縣,琉球鄉,0597,288,98,386,35,421,1079,39.02%,26.69%,1
屏東縣,琉球鄉,0598,423,149,572,20,592,1613,36.7%,26.22%,1
屏東縣,琉球鄉,0599,291,114,405,39,444,873,50.86%,33.33%,1
屏東縣,車城鄉,0600,163,116,279,31,310,737,42.06%,22.12%,1
屏東縣,車城鄉,0601,133,83,216,25,241,647,37.25%,20.56%,1
屏東縣,車城鄉,0602,136,72,208,22,230,491,46.84%,27.7%,1
屏東縣,車城鄉,0603,240,147,387,23,410,856,47.9%,28.04%,1
屏東縣,車城鄉,0604,174,79,253,8,261,554,47.11%,31.41%,1
屏東縣,車城鄉,0605,98,40,138,6,144,388,37.11%,25.26%,1
屏東縣,車城鄉,0606,215,118,333,40,373,922,40.46%,23.32%,1
屏東縣,車城鄉,0607,121,75,196,10,206,597,34.51%,20.27%,1
屏東縣,車城鄉,0608,134,73,207,14,221,623,35.47%,21.51%,1
屏東縣,車城鄉,0609,111,76,187,14,201,425,47.29%,26.12%,1
屏東縣,車城鄉,0610,147,55,202,14,216,428,50.47%,34.35%,1
屏東縣,車城鄉,0611,110,60,170,11,181,504,35.91%,21.83%,1
屏東縣,車城鄉,0612,119,69,188,21,209,423,49.41%,28.13%,1
屏東縣,滿州鄉,0613,434,257,691,40,731,1575,46.41%,27.56%,1
屏東縣,滿州鄉,0614,127,63,190,10,200,420,47.62%,30.24%,1
屏東縣,滿州鄉,0615,242,83,325,25,350,602,58.14%,40.2%,1
屏東縣,滿州鄉,0616,349,139,488,23,511,1302,39.25%,26.8%,1
屏東縣,滿州鄉,0617,353,187,540,7,547,1314,41.63%,26.86%,1
屏東縣,滿州鄉,0618,235,142,377,17,394,1308,30.12%,17.97%,1
屏東縣,滿州鄉,0619,88,51,139,12,151,367,41.14%,23.98%,1
屏東縣,滿州鄉,0620,95,57,152,14,166,318,52.2%,29.87%,1
屏東縣,枋山鄉,0621,243,86,329,35,364,604,60.26%,40.23%,1
屏東縣,枋山鄉,0622,193,58,251,14,265,428,61.92%,45.09%,1
屏東縣,枋山鄉,0623,373,164,537,54,591,928,63.69%,40.19%,1
屏東縣,枋山鄉,0624,321,164,485,16,501,972,51.54%,33.02%,1
屏東縣,枋山鄉,0625,292,144,436,41,477,1041,45.82%,28.05%,1
屏東縣,枋山鄉,0626,196,124,320,16,336,883,38.05%,22.2%,1
屏東縣,三地門鄉,0627,231,73,304,10,314,616,50.97%,37.5%,1
屏東縣,三地門鄉,0628,223,83,306,52,358,572,62.59%,38.99%,1
屏東縣,三地門鄉,0629,160,39,199,2,201,323,62.23%,49.54%,1
屏東縣,三地門鄉,0630,583,293,876,33,909,1448,62.78%,40.26%,1
屏東縣,三地門鄉,0631,281,106,387,9,396,726,54.55%,38.71%,1
屏東縣,三地門鄉,0632,198,100,298,8,306,554,55.23%,35.74%,1
屏東縣,三地門鄉,0633,154,75,229,6,235,346,67.92%,44.51%,1
屏東縣,三地門鄉,0634,277,58,335,5,340,458,74.24%,60.48%,1
屏東縣,三地門鄉,0635,323,135,458,16,474,692,68.5%,46.68%,1
屏東縣,三地門鄉,0636,270,124,394,58,452,638,70.85%,42.32%,1
屏東縣,霧臺鄉,0637,188,73,261,10,271,346,78.32%,54.34%,1
屏東縣,霧臺鄉,0638,371,127,498,19,517,677,76.37%,54.8%,1
屏東縣,霧臺鄉,0639,72,22,94,2,96,162,59.26%,44.44%,1
屏東縣,霧臺鄉,0640,88,25,113,4,117,189,61.9%,46.56%,1
屏東縣,霧臺鄉,0641,181,44,225,9,234,296,79.05%,61.15%,1
屏東縣,霧臺鄉,0642,293,100,393,14,407,483,84.27%,60.66%,1
屏東縣,霧臺鄉,0643,159,75,234,5,239,347,68.88%,45.82%,1
屏東縣,霧臺鄉,0644,276,82,358,12,370,450,82.22%,61.33%,1
屏東縣,瑪家鄉,0645,167,88,255,3,258,455,56.7%,36.7%,1
屏東縣,瑪家鄉,0646,379,148,527,20,547,821,66.63%,46.16%,1
屏東縣,瑪家鄉,0647,320,127,447,20,467,635,73.54%,50.39%,1
屏東縣,瑪家鄉,0648,400,103,503,23,526,695,75.68%,57.55%,1
屏東縣,瑪家鄉,0649,302,92,394,12,406,671,60.51%,45.01%,1
屏東縣,瑪家鄉,0650,473,154,627,22,649,1057,61.4%,44.75%,1
屏東縣,瑪家鄉,0651,383,140,523,23,546,900,60.67%,42.56%,1
屏東縣,瑪家鄉,0652,201,72,273,6,279,429,65.03%,46.85%,1
屏東縣,泰武鄉,0653,255,144,399,17,416,669,62.18%,38.12%,1
屏東縣,泰武鄉,0654,85,35,120,4,124,190,65.26%,44.74%,1
屏東縣,泰武鄉,0655,389,172,561,46,607,922,65.84%,42.19%,1
屏東縣,泰武鄉,0656,318,126,444,18,462,598,77.26%,53.18%,1
屏東縣,泰武鄉,0657,376,98,474,29,503,771,65.24%,48.77%,1
屏東縣,泰武鄉,0658,222,66,288,15,303,414,73.19%,53.62%,1
屏東縣,泰武鄉,0659,322,141,463,19,482,780,61.79%,41.28%,1
屏東縣,來義鄉,0660,455,116,571,53,624,917,68.05%,49.62%,1
屏東縣,來義鄉,0661,157,71,228,7,235,361,65.1%,43.49%,1
屏東縣,來義鄉,0662,106,28,134,2,136,216,62.96%,49.07%,1
屏東縣,來義鄉,0663,258,66,324,13,337,445,75.73%,57.98%,1
屏東縣,來義鄉,0664,135,39,174,9,183,280,65.36%,48.21%,1
屏東縣,來義鄉,0665,450,147,597,51,648,1097,59.07%,41.02%,1
屏東縣,來義鄉,0666,396,129,525,40,565,840,67.26%,47.14%,1
屏東縣,來義鄉,0667,290,152,442,14,456,889,51.29%,32.62%,1
屏東縣,來義鄉,0668,405,180,585,36,621,1212,51.24%,33.42%,1
屏東縣,春日鄉,0669,271,126,397,7,404,909,44.44%,29.81%,1
屏東縣,春日鄉,0670,251,105,356,10,366,663,55.2%,37.86%,1
屏東縣,春日鄉,0671,92,30,122,0,122,304,40.13%,30.26%,1
屏東縣,春日鄉,0672,292,152,444,18,462,928,49.78%,31.47%,1
屏東縣,春日鄉,0673,140,79,219,11,230,641,35.88%,21.84%,1
屏東縣,春日鄉,0674,95,60,155,4,159,478,33.26%,19.87%,1
屏東縣,獅子鄉,0675,338,72,410,12,422,751,56.19%,45.01%,1
屏東縣,獅子鄉,0676,307,119,426,31,457,776,58.89%,39.56%,1
屏東縣,獅子鄉,0677,399,90,489,15,504,711,70.89%,56.12%,1
屏東縣,獅子鄉,0678,114,58,172,16,188,243,77.37%,46.91%,1
屏東縣,獅子鄉,0679,167,57,224,6,230,325,70.77%,51.38%,1
屏東縣,獅子鄉,0680,178,84,262,1,263,476,55.25%,37.39%,1
屏東縣,獅子鄉,0681,324,76,400,15,415,602,68.94%,53.82%,1
屏東縣,獅子鄉,0682,111,59,170,7,177,346,51.16%,32.08%,1
屏東縣,牡丹鄉,0683,94,47,141,2,143,342,41.81%,27.49%,1
屏東縣,牡丹鄉,0684,419,197,616,47,663,1306,50.77%,32.08%,1
屏東縣,牡丹鄉,0685,136,60,196,4,200,693,28.86%,19.62%,1
屏東縣,牡丹鄉,0686,141,53,194,11,205,437,46.91%,32.27%,1
屏東縣,牡丹鄉,0687,143,51,194,2,196,392,50%,36.48%,1
屏東縣,牡丹鄉,0688,182,115,297,11,308,593,51.94%,30.69%,1
屏東縣,牡丹鄉,0689,96,35,131,5,136,551,24.68%,17.42%,1
宜蘭縣,宜蘭市,0001,347,174,521,15,536,982,54.58%,35.34%,1
宜蘭縣,宜蘭市,0002,472,198,670,32,702,1270,55.28%,37.17%,1
宜蘭縣,宜蘭市,0003,295,168,463,12,475,849,55.95%,34.75%,1
宜蘭縣,宜蘭市,0004,259,161,420,20,440,756,58.2%,34.26%,1
宜蘭縣,宜蘭市,0005,393,151,544,18,562,1107,50.77%,35.5%,1
宜蘭縣,宜蘭市,0006,325,143,468,29,497,893,55.66%,36.39%,1
宜蘭縣,宜蘭市,0007,312,166,478,30,508,912,55.7%,34.21%,1
宜蘭縣,宜蘭市,0008,464,243,707,47,754,1335,56.48%,34.76%,1
宜蘭縣,宜蘭市,0009,223,120,343,24,367,686,53.5%,32.51%,1
宜蘭縣,宜蘭市,0010,512,310,822,30,852,1366,62.37%,37.48%,1
宜蘭縣,宜蘭市,0011,468,294,762,15,777,1363,57.01%,34.34%,1
宜蘭縣,宜蘭市,0012,557,297,854,36,890,1540,57.79%,36.17%,1
宜蘭縣,宜蘭市,0013,451,286,737,25,762,1341,56.82%,33.63%,1
宜蘭縣,宜蘭市,0014,467,199,666,23,689,1209,56.99%,38.63%,1
宜蘭縣,宜蘭市,0015,323,166,489,30,519,900,57.67%,35.89%,1
宜蘭縣,宜蘭市,0016,325,173,498,21,519,980,52.96%,33.16%,1
宜蘭縣,宜蘭市,0017,377,250,627,28,655,1165,56.22%,32.36%,1
宜蘭縣,宜蘭市,0018,332,152,484,21,505,904,55.86%,36.73%,1
宜蘭縣,宜蘭市,0019,290,160,450,19,469,813,57.69%,35.67%,1
宜蘭縣,宜蘭市,0020,348,171,519,27,546,978,55.83%,35.58%,1
宜蘭縣,宜蘭市,0021,387,185,572,15,587,1282,45.79%,30.19%,1
宜蘭縣,宜蘭市,0022,173,91,264,10,274,465,58.92%,37.2%,1
宜蘭縣,宜蘭市,0023,261,110,371,26,397,669,59.34%,39.01%,1
宜蘭縣,宜蘭市,0024,337,163,500,26,526,923,56.99%,36.51%,1
宜蘭縣,宜蘭市,0025,339,180,519,18,537,1006,53.38%,33.7%,1
宜蘭縣,宜蘭市,0026,333,144,477,28,505,762,66.27%,43.7%,1
宜蘭縣,宜蘭市,0027,307,136,443,26,469,727,64.51%,42.23%,1
宜蘭縣,宜蘭市,0028,372,156,528,37,565,833,67.83%,44.66%,1
宜蘭縣,宜蘭市,0029,384,234,618,36,654,1143,57.22%,33.6%,1
宜蘭縣,宜蘭市,0030,351,181,532,15,547,979,55.87%,35.85%,1
宜蘭縣,宜蘭市,0031,441,203,644,41,685,1214,56.43%,36.33%,1
宜蘭縣,宜蘭市,0032,458,229,687,51,738,1283,57.52%,35.7%,1
宜蘭縣,宜蘭市,0033,339,190,529,25,554,946,58.56%,35.84%,1
宜蘭縣,宜蘭市,0034,370,187,557,30,587,1090,53.85%,33.94%,1
宜蘭縣,宜蘭市,0035,347,200,547,22,569,943,60.34%,36.8%,1
宜蘭縣,宜蘭市,0036,275,200,475,24,499,774,64.47%,35.53%,1
宜蘭縣,宜蘭市,0037,367,205,572,18,590,968,60.95%,37.91%,1
宜蘭縣,宜蘭市,0038,349,200,549,22,571,926,61.66%,37.69%,1
宜蘭縣,宜蘭市,0039,379,206,585,27,612,1019,60.06%,37.19%,1
宜蘭縣,宜蘭市,0040,362,218,580,38,618,1084,57.01%,33.39%,1
宜蘭縣,宜蘭市,0041,377,199,576,20,596,1095,54.43%,34.43%,1
宜蘭縣,宜蘭市,0042,385,214,599,25,624,1083,57.62%,35.55%,1
宜蘭縣,宜蘭市,0043,374,200,574,22,596,1108,53.79%,33.75%,1
宜蘭縣,宜蘭市,0044,309,172,481,15,496,848,58.49%,36.44%,1
宜蘭縣,宜蘭市,0045,399,188,587,22,609,1095,55.62%,36.44%,1
宜蘭縣,宜蘭市,0046,396,211,607,21,628,1110,56.58%,35.68%,1
宜蘭縣,宜蘭市,0047,407,215,622,24,646,1104,58.51%,36.87%,1
宜蘭縣,宜蘭市,0048,405,225,630,20,650,1134,57.32%,35.71%,1
宜蘭縣,宜蘭市,0049,419,219,638,23,661,1146,57.68%,36.56%,1
宜蘭縣,宜蘭市,0050,340,169,509,26,535,876,61.07%,38.81%,1
宜蘭縣,宜蘭市,0051,315,161,476,32,508,905,56.13%,34.81%,1
宜蘭縣,宜蘭市,0052,328,179,507,28,535,910,58.79%,36.04%,1
宜蘭縣,宜蘭市,0053,460,234,694,37,731,1434,50.98%,32.08%,1
宜蘭縣,宜蘭市,0054,389,207,596,43,639,1152,55.47%,33.77%,1
宜蘭縣,宜蘭市,0055,360,193,553,29,582,966,60.25%,37.27%,1
宜蘭縣,宜蘭市,0056,260,138,398,18,416,711,58.51%,36.57%,1
宜蘭縣,宜蘭市,0057,341,166,507,30,537,884,60.75%,38.57%,1
宜蘭縣,宜蘭市,0058,486,244,730,37,767,1326,57.84%,36.65%,1
宜蘭縣,宜蘭市,0059,285,164,449,27,476,909,52.37%,31.35%,1
宜蘭縣,宜蘭市,0060,306,153,459,31,490,894,54.81%,34.23%,1
宜蘭縣,宜蘭市,0061,431,190,621,19,640,1259,50.83%,34.23%,1
宜蘭縣,宜蘭市,0062,265,129,394,23,417,789,52.85%,33.59%,1
宜蘭縣,宜蘭市,0063,299,155,454,27,481,867,55.48%,34.49%,1
宜蘭縣,宜蘭市,0064,494,265,759,55,814,1454,55.98%,33.98%,1
宜蘭縣,宜蘭市,0065,496,179,675,16,691,1130,61.15%,43.89%,1
宜蘭縣,宜蘭市,0066,360,166,526,11,537,1087,49.4%,33.12%,1
宜蘭縣,宜蘭市,0067,367,166,533,47,580,938,61.83%,39.13%,1
宜蘭縣,宜蘭市,0068,500,232,732,34,766,1285,59.61%,38.91%,1
宜蘭縣,宜蘭市,0069,349,170,519,13,532,952,55.88%,36.66%,1
宜蘭縣,宜蘭市,0070,339,204,543,29,572,948,60.34%,35.76%,1
宜蘭縣,宜蘭市,0071,360,225,585,31,616,1160,53.1%,31.03%,1
宜蘭縣,宜蘭市,0072,373,178,551,53,604,1015,59.51%,36.75%,1
宜蘭縣,宜蘭市,0073,158,89,247,16,263,424,62.03%,37.26%,1
宜蘭縣,宜蘭市,0074,353,181,534,37,571,964,59.23%,36.62%,1
宜蘭縣,宜蘭市,0075,309,178,487,31,518,959,54.01%,32.22%,1
宜蘭縣,宜蘭市,0076,349,143,492,24,516,814,63.39%,42.87%,1
宜蘭縣,宜蘭市,0077,348,160,508,18,526,885,59.44%,39.32%,1
宜蘭縣,宜蘭市,0078,405,226,631,48,679,1162,58.43%,34.85%,1
宜蘭縣,羅東鎮,0079,248,128,376,32,408,689,59.22%,35.99%,1
宜蘭縣,羅東鎮,0080,266,114,380,20,400,718,55.71%,37.05%,1
宜蘭縣,羅東鎮,0081,508,251,759,61,820,1475,55.59%,34.44%,1
宜蘭縣,羅東鎮,0082,466,284,750,48,798,1466,54.43%,31.79%,1
宜蘭縣,羅東鎮,0083,376,207,583,25,608,1075,56.56%,34.98%,1
宜蘭縣,羅東鎮,0084,347,169,516,21,537,963,55.76%,36.03%,1
宜蘭縣,羅東鎮,0085,508,242,750,65,815,1511,53.94%,33.62%,1
宜蘭縣,羅東鎮,0086,398,216,614,29,643,1166,55.15%,34.13%,1
宜蘭縣,羅東鎮,0087,443,250,693,43,736,1273,57.82%,34.8%,1
宜蘭縣,羅東鎮,0088,608,289,897,18,915,1735,52.74%,35.04%,1
宜蘭縣,羅東鎮,0089,539,278,817,33,850,1487,57.16%,36.25%,1
宜蘭縣,羅東鎮,0090,302,179,481,22,503,837,60.1%,36.08%,1
宜蘭縣,羅東鎮,0091,495,248,743,49,792,1312,60.37%,37.73%,1
宜蘭縣,羅東鎮,0092,497,261,758,43,801,1502,53.33%,33.09%,1
宜蘭縣,羅東鎮,0093,383,203,586,19,605,1138,53.16%,33.66%,1
宜蘭縣,羅東鎮,0094,349,186,535,30,565,1010,55.94%,34.55%,1
宜蘭縣,羅東鎮,0095,502,243,745,51,796,1373,57.98%,36.56%,1
宜蘭縣,羅東鎮,0096,442,163,605,28,633,1089,58.13%,40.59%,1
宜蘭縣,羅東鎮,0097,464,218,682,32,714,1304,54.75%,35.58%,1
宜蘭縣,羅東鎮,0098,419,223,642,54,696,1288,54.04%,32.53%,1
宜蘭縣,羅東鎮,0099,389,218,607,35,642,1036,61.97%,37.55%,1
宜蘭縣,羅東鎮,0100,406,181,587,32,619,969,63.88%,41.9%,1
宜蘭縣,羅東鎮,0101,362,203,565,28,593,985,60.2%,36.75%,1
宜蘭縣,羅東鎮,0102,524,271,795,39,834,1420,58.73%,36.9%,1
宜蘭縣,羅東鎮,0103,527,253,780,40,820,1430,57.34%,36.85%,1
宜蘭縣,羅東鎮,0104,401,191,592,42,634,1075,58.98%,37.3%,1
宜蘭縣,羅東鎮,0105,315,187,502,29,531,879,60.41%,35.84%,1
宜蘭縣,羅東鎮,0106,284,177,461,14,475,850,55.88%,33.41%,1
宜蘭縣,羅東鎮,0107,402,235,637,27,664,1111,59.77%,36.18%,1
宜蘭縣,羅東鎮,0108,465,224,689,25,714,1139,62.69%,40.83%,1
宜蘭縣,羅東鎮,0109,433,239,672,26,698,1130,61.77%,38.32%,1
宜蘭縣,羅東鎮,0110,355,207,562,17,579,980,59.08%,36.22%,1
宜蘭縣,羅東鎮,0111,499,268,767,39,806,1431,56.32%,34.87%,1
宜蘭縣,羅東鎮,0112,395,205,600,35,635,1109,57.26%,35.62%,1
宜蘭縣,羅東鎮,0113,406,183,589,25,614,1083,56.69%,37.49%,1
宜蘭縣,羅東鎮,0114,520,254,774,43,817,1404,58.19%,37.04%,1
宜蘭縣,羅東鎮,0115,464,243,707,36,743,1288,57.69%,36.02%,1
宜蘭縣,羅東鎮,0116,328,191,519,28,547,1183,46.24%,27.73%,1
宜蘭縣,羅東鎮,0117,412,223,635,27,662,1105,59.91%,37.29%,1
宜蘭縣,羅東鎮,0118,368,206,574,32,606,987,61.4%,37.28%,1
宜蘭縣,羅東鎮,0119,299,150,449,27,476,773,61.58%,38.68%,1
宜蘭縣,羅東鎮,0120,543,300,843,26,869,1366,63.62%,39.75%,1
宜蘭縣,羅東鎮,0121,366,199,565,20,585,907,64.5%,40.35%,1
宜蘭縣,羅東鎮,0122,465,234,699,21,720,1158,62.18%,40.16%,1
宜蘭縣,羅東鎮,0123,350,189,539,30,569,977,58.24%,35.82%,1
宜蘭縣,羅東鎮,0124,325,176,501,30,531,972,54.63%,33.44%,1
宜蘭縣,羅東鎮,0125,357,196,553,29,582,977,59.57%,36.54%,1
宜蘭縣,羅東鎮,0126,527,263,790,35,825,1398,59.01%,37.7%,1
宜蘭縣,羅東鎮,0127,356,197,553,26,579,1022,56.65%,34.83%,1
宜蘭縣,羅東鎮,0128,485,178,663,32,695,1131,61.45%,42.88%,1
宜蘭縣,蘇澳鎮,0129,422,216,638,37,675,1194,56.53%,35.34%,1
宜蘭縣,蘇澳鎮,0130,412,182,594,26,620,1128,54.96%,36.52%,1
宜蘭縣,蘇澳鎮,0131,370,223,593,42,635,1042,60.94%,35.51%,1
宜蘭縣,蘇澳鎮,0132,362,202,564,22,586,997,58.78%,36.31%,1
宜蘭縣,蘇澳鎮,0133,448,238,686,52,738,1303,56.64%,34.38%,1
宜蘭縣,蘇澳鎮,0134,468,237,705,48,753,1260,59.76%,37.14%,1
宜蘭縣,蘇澳鎮,0135,395,205,600,47,647,1130,57.26%,34.96%,1
宜蘭縣,蘇澳鎮,0136,185,103,288,28,316,559,56.53%,33.09%,1
宜蘭縣,蘇澳鎮,0137,101,61,162,20,182,351,51.85%,28.77%,1
宜蘭縣,蘇澳鎮,0138,298,146,444,53,497,889,55.91%,33.52%,1
宜蘭縣,蘇澳鎮,0139,142,76,218,23,241,434,55.53%,32.72%,1
宜蘭縣,蘇澳鎮,0140,329,154,483,28,511,835,61.2%,39.4%,1
宜蘭縣,蘇澳鎮,0141,347,181,528,33,561,975,57.54%,35.59%,1
宜蘭縣,蘇澳鎮,0142,434,209,643,33,676,1135,59.56%,38.24%,1
宜蘭縣,蘇澳鎮,0143,304,181,485,29,514,788,65.23%,38.58%,1
宜蘭縣,蘇澳鎮,0144,156,82,238,20,258,469,55.01%,33.26%,1
宜蘭縣,蘇澳鎮,0145,290,126,416,28,444,811,54.75%,35.76%,1
宜蘭縣,蘇澳鎮,0146,312,148,460,20,480,867,55.36%,35.99%,1
宜蘭縣,蘇澳鎮,0147,426,189,615,27,642,1139,56.37%,37.4%,1
宜蘭縣,蘇澳鎮,0148,413,160,573,29,602,1146,52.53%,36.04%,1
宜蘭縣,蘇澳鎮,0149,397,204,601,48,649,1154,56.24%,34.4%,1
宜蘭縣,蘇澳鎮,0150,316,36,352,22,374,908,41.19%,34.8%,1
宜蘭縣,蘇澳鎮,0151,257,91,348,16,364,656,55.49%,39.18%,1
宜蘭縣,蘇澳鎮,0152,333,140,473,41,514,834,61.63%,39.93%,1
宜蘭縣,蘇澳鎮,0153,387,200,587,28,615,1025,60%,37.76%,1
宜蘭縣,蘇澳鎮,0154,156,91,247,17,264,455,58.02%,34.29%,1
宜蘭縣,蘇澳鎮,0155,194,98,292,22,314,535,58.69%,36.26%,1
宜蘭縣,蘇澳鎮,0156,213,104,317,26,343,536,63.99%,39.74%,1
宜蘭縣,蘇澳鎮,0157,168,91,259,12,271,451,60.09%,37.25%,1
宜蘭縣,蘇澳鎮,0158,204,94,298,34,332,593,55.99%,34.4%,1
宜蘭縣,蘇澳鎮,0159,163,70,233,25,258,441,58.5%,36.96%,1
宜蘭縣,蘇澳鎮,0160,350,151,501,47,548,954,57.44%,36.69%,1
宜蘭縣,蘇澳鎮,0161,329,141,470,48,518,952,54.41%,34.56%,1
宜蘭縣,蘇澳鎮,0162,310,176,486,60,546,1125,48.53%,27.56%,1
宜蘭縣,蘇澳鎮,0163,263,115,378,52,430,763,56.36%,34.47%,1
宜蘭縣,蘇澳鎮,0164,197,96,293,28,321,706,45.47%,27.9%,1
宜蘭縣,蘇澳鎮,0165,328,130,458,59,517,1068,48.41%,30.71%,1
宜蘭縣,蘇澳鎮,0166,210,126,336,52,388,666,58.26%,31.53%,1
宜蘭縣,蘇澳鎮,0167,169,94,263,65,328,574,57.14%,29.44%,1
宜蘭縣,蘇澳鎮,0168,94,66,160,5,165,351,47.01%,26.78%,1
宜蘭縣,蘇澳鎮,0169,261,104,365,40,405,717,56.49%,36.4%,1
宜蘭縣,蘇澳鎮,0170,112,30,142,12,154,373,41.29%,30.03%,1
宜蘭縣,蘇澳鎮,0171,53,27,80,14,94,223,42.15%,23.77%,1
宜蘭縣,頭城鎮,0172,69,26,95,12,107,292,36.64%,23.63%,1
宜蘭縣,頭城鎮,0173,213,112,325,44,369,688,53.63%,30.96%,1
宜蘭縣,頭城鎮,0174,252,116,368,26,394,688,57.27%,36.63%,1
宜蘭縣,頭城鎮,0175,274,131,405,73,478,879,54.38%,31.17%,1
宜蘭縣,頭城鎮,0176,124,58,182,22,204,335,60.9%,37.01%,1
宜蘭縣,頭城鎮,0177,261,110,371,22,393,624,62.98%,41.83%,1
宜蘭縣,頭城鎮,0178,211,111,322,22,344,732,46.99%,28.83%,1
宜蘭縣,頭城鎮,0179,250,139,389,30,419,892,46.97%,28.03%,1
宜蘭縣,頭城鎮,0180,183,105,288,25,313,690,45.36%,26.52%,1
宜蘭縣,頭城鎮,0181,286,135,421,31,452,842,53.68%,33.97%,1
宜蘭縣,頭城鎮,0182,241,144,385,26,411,736,55.84%,32.74%,1
宜蘭縣,頭城鎮,0183,252,134,386,17,403,788,51.14%,31.98%,1
宜蘭縣,頭城鎮,0184,167,100,267,20,287,560,51.25%,29.82%,1
宜蘭縣,頭城鎮,0185,292,110,402,23,425,712,59.69%,41.01%,1
宜蘭縣,頭城鎮,0186,215,87,302,20,322,502,64.14%,42.83%,1
宜蘭縣,頭城鎮,0187,214,118,332,27,359,569,63.09%,37.61%,1
宜蘭縣,頭城鎮,0188,236,100,336,25,361,633,57.03%,37.28%,1
宜蘭縣,頭城鎮,0189,328,166,494,44,538,1132,47.53%,28.98%,1
宜蘭縣,頭城鎮,0190,312,150,462,34,496,1035,47.92%,30.14%,1
宜蘭縣,頭城鎮,0191,323,148,471,33,504,847,59.5%,38.13%,1
宜蘭縣,頭城鎮,0192,401,230,631,29,660,1172,56.31%,34.22%,1
宜蘭縣,頭城鎮,0193,288,162,450,21,471,896,52.57%,32.14%,1
宜蘭縣,頭城鎮,0194,389,221,610,17,627,1075,58.33%,36.19%,1
宜蘭縣,頭城鎮,0195,326,177,503,46,549,931,58.97%,35.02%,1
宜蘭縣,頭城鎮,0196,372,152,524,38,562,1021,55.04%,36.43%,1
宜蘭縣,頭城鎮,0197,227,97,324,27,351,709,49.51%,32.02%,1
宜蘭縣,頭城鎮,0198,282,125,407,35,442,689,64.15%,40.93%,1
宜蘭縣,頭城鎮,0199,226,120,346,38,384,615,62.44%,36.75%,1
宜蘭縣,頭城鎮,0200,264,123,387,28,415,759,54.68%,34.78%,1
宜蘭縣,頭城鎮,0201,352,164,516,48,564,917,61.5%,38.39%,1
宜蘭縣,頭城鎮,0202,370,172,542,58,600,1045,57.42%,35.41%,1
宜蘭縣,頭城鎮,0203,412,180,592,43,635,1130,56.19%,36.46%,1
宜蘭縣,礁溪鄉,0204,358,168,526,36,562,1122,50.09%,31.91%,1
宜蘭縣,礁溪鄉,0205,161,92,253,14,267,505,52.87%,31.88%,1
宜蘭縣,礁溪鄉,0206,333,155,488,25,513,988,51.92%,33.7%,1
宜蘭縣,礁溪鄉,0207,307,187,494,26,520,971,53.55%,31.62%,1
宜蘭縣,礁溪鄉,0208,389,203,592,31,623,1246,50%,31.22%,1
宜蘭縣,礁溪鄉,0209,499,263,762,24,786,1655,47.49%,30.15%,1
宜蘭縣,礁溪鄉,0210,310,189,499,16,515,1132,45.49%,27.39%,1
宜蘭縣,礁溪鄉,0211,275,148,423,21,444,783,56.7%,35.12%,1
宜蘭縣,礁溪鄉,0212,308,166,474,26,500,928,53.88%,33.19%,1
宜蘭縣,礁溪鄉,0213,287,135,422,36,458,848,54.01%,33.84%,1
宜蘭縣,礁溪鄉,0214,258,135,393,28,421,663,63.5%,38.91%,1
宜蘭縣,礁溪鄉,0215,228,104,332,16,348,608,57.24%,37.5%,1
宜蘭縣,礁溪鄉,0216,307,141,448,26,474,833,56.9%,36.85%,1
宜蘭縣,礁溪鄉,0217,335,223,558,26,584,1233,47.36%,27.17%,1
宜蘭縣,礁溪鄉,0218,286,152,438,42,480,854,56.21%,33.49%,1
宜蘭縣,礁溪鄉,0219,183,99,282,21,303,575,52.7%,31.83%,1
宜蘭縣,礁溪鄉,0220,261,169,430,39,469,835,56.17%,31.26%,1
宜蘭縣,礁溪鄉,0221,463,242,705,43,748,1305,57.32%,35.48%,1
宜蘭縣,礁溪鄉,0222,270,152,422,39,461,830,55.54%,32.53%,1
宜蘭縣,礁溪鄉,0223,248,146,394,34,428,649,65.95%,38.21%,1
宜蘭縣,礁溪鄉,0224,277,144,421,38,459,923,49.73%,30.01%,1
宜蘭縣,礁溪鄉,0225,342,183,525,34,559,1177,47.49%,29.06%,1
宜蘭縣,礁溪鄉,0226,292,144,436,27,463,840,55.12%,34.76%,1
宜蘭縣,礁溪鄉,0227,370,199,569,30,599,1051,56.99%,35.2%,1
宜蘭縣,礁溪鄉,0228,432,223,655,30,685,1339,51.16%,32.26%,1
宜蘭縣,礁溪鄉,0229,470,202,672,35,707,1194,59.21%,39.36%,1
宜蘭縣,礁溪鄉,0230,519,237,756,34,790,1314,60.12%,39.5%,1
宜蘭縣,礁溪鄉,0231,350,241,591,31,622,1125,55.29%,31.11%,1
宜蘭縣,礁溪鄉,0232,451,222,673,51,724,1207,59.98%,37.37%,1
宜蘭縣,礁溪鄉,0233,337,170,507,42,549,979,56.08%,34.42%,1
宜蘭縣,礁溪鄉,0234,356,187,543,41,584,954,61.22%,37.32%,1
宜蘭縣,礁溪鄉,0235,147,77,224,8,232,418,55.5%,35.17%,1
宜蘭縣,壯圍鄉,0236,534,259,793,76,869,1435,60.56%,37.21%,1
宜蘭縣,壯圍鄉,0237,411,196,607,25,632,1049,60.25%,39.18%,1
宜蘭縣,壯圍鄉,0238,413,200,613,45,658,1068,61.61%,38.67%,1
宜蘭縣,壯圍鄉,0239,312,145,457,48,505,868,58.18%,35.94%,1
宜蘭縣,壯圍鄉,0240,335,177,512,31,543,967,56.15%,34.64%,1
宜蘭縣,壯圍鄉,0241,354,178,532,55,587,940,62.45%,37.66%,1
宜蘭縣,壯圍鄉,0242,318,142,460,25,485,975,49.74%,32.62%,1
宜蘭縣,壯圍鄉,0243,294,145,439,49,488,797,61.23%,36.89%,1
宜蘭縣,壯圍鄉,0244,319,127,446,27,473,808,58.54%,39.48%,1
宜蘭縣,壯圍鄉,0245,323,176,499,50,549,911,60.26%,35.46%,1
宜蘭縣,壯圍鄉,0246,202,88,290,24,314,612,51.31%,33.01%,1
宜蘭縣,壯圍鄉,0247,323,139,462,39,501,790,63.42%,40.89%,1
宜蘭縣,壯圍鄉,0248,337,158,495,34,529,878,60.25%,38.38%,1
宜蘭縣,壯圍鄉,0249,286,159,445,32,477,723,65.98%,39.56%,1
宜蘭縣,壯圍鄉,0250,266,119,385,18,403,737,54.68%,36.09%,1
宜蘭縣,壯圍鄉,0251,248,127,375,39,414,686,60.35%,36.15%,1
宜蘭縣,壯圍鄉,0252,317,161,478,8,486,895,54.3%,35.42%,1
宜蘭縣,壯圍鄉,0253,494,208,702,55,757,1237,61.2%,39.94%,1
宜蘭縣,壯圍鄉,0254,383,221,604,48,652,1134,57.5%,33.77%,1
宜蘭縣,壯圍鄉,0255,394,194,588,33,621,1107,56.1%,35.59%,1
宜蘭縣,壯圍鄉,0256,424,181,605,43,648,1057,61.31%,40.11%,1
宜蘭縣,壯圍鄉,0257,335,179,514,35,549,1051,52.24%,31.87%,1
宜蘭縣,壯圍鄉,0258,236,139,375,29,404,722,55.96%,32.69%,1
宜蘭縣,員山鄉,0259,487,254,741,24,765,1393,54.92%,34.96%,1
宜蘭縣,員山鄉,0260,275,173,448,17,465,895,51.96%,30.73%,1
宜蘭縣,員山鄉,0261,448,176,624,42,666,1231,54.1%,36.39%,1
宜蘭縣,員山鄉,0262,349,195,544,24,568,1098,51.73%,31.79%,1
宜蘭縣,員山鄉,0263,359,163,522,25,547,1031,53.06%,34.82%,1
宜蘭縣,員山鄉,0264,348,160,508,49,557,1030,54.08%,33.79%,1
宜蘭縣,員山鄉,0265,300,225,525,33,558,1168,47.77%,25.68%,1
宜蘭縣,員山鄉,0266,284,138,422,42,464,809,57.35%,35.11%,1
宜蘭縣,員山鄉,0267,257,158,415,32,447,778,57.46%,33.03%,1
宜蘭縣,員山鄉,0268,532,267,799,48,847,1465,57.82%,36.31%,1
宜蘭縣,員山鄉,0269,357,187,544,41,585,979,59.75%,36.47%,1
宜蘭縣,員山鄉,0270,315,139,454,29,483,860,56.16%,36.63%,1
宜蘭縣,員山鄉,0271,304,246,550,50,600,1205,49.79%,25.23%,1
宜蘭縣,員山鄉,0272,400,172,572,37,609,1082,56.28%,36.97%,1
宜蘭縣,員山鄉,0273,159,71,230,17,247,412,59.95%,38.59%,1
宜蘭縣,員山鄉,0274,135,60,195,11,206,403,51.12%,33.5%,1
宜蘭縣,員山鄉,0275,77,23,100,4,104,232,44.83%,33.19%,1
宜蘭縣,員山鄉,0276,312,171,483,29,512,944,54.24%,33.05%,1
宜蘭縣,員山鄉,0277,304,158,462,40,502,894,56.15%,34%,1
宜蘭縣,員山鄉,0278,526,202,728,30,758,1356,55.9%,38.79%,1
宜蘭縣,員山鄉,0279,285,140,425,34,459,780,58.85%,36.54%,1
宜蘭縣,員山鄉,0280,375,176,551,39,590,932,63.3%,40.24%,1
宜蘭縣,員山鄉,0281,174,104,278,29,307,583,52.66%,29.85%,1
宜蘭縣,員山鄉,0282,352,126,478,26,504,900,56%,39.11%,1
宜蘭縣,員山鄉,0283,262,132,394,19,413,747,55.29%,35.07%,1
宜蘭縣,員山鄉,0284,264,136,400,34,434,788,55.08%,33.5%,1
宜蘭縣,員山鄉,0285,271,157,428,40,468,884,52.94%,30.66%,1
宜蘭縣,員山鄉,0286,278,148,426,19,445,857,51.93%,32.44%,1
宜蘭縣,員山鄉,0287,319,180,499,26,525,1016,51.67%,31.4%,1
宜蘭縣,員山鄉,0288,168,116,284,24,308,690,44.64%,24.35%,1
宜蘭縣,員山鄉,0289,201,111,312,54,366,689,53.12%,29.17%,1
宜蘭縣,冬山鄉,0290,296,155,451,35,486,807,60.22%,36.68%,1
宜蘭縣,冬山鄉,0291,305,163,468,18,486,817,59.49%,37.33%,1
宜蘭縣,冬山鄉,0292,402,219,621,38,659,1156,57.01%,34.78%,1
宜蘭縣,冬山鄉,0293,310,148,458,27,485,892,54.37%,34.75%,1
宜蘭縣,冬山鄉,0294,319,181,500,29,529,897,58.97%,35.56%,1
宜蘭縣,冬山鄉,0295,524,257,781,49,830,1392,59.63%,37.64%,1
宜蘭縣,冬山鄉,0296,474,334,808,35,843,1471,57.31%,32.22%,1
宜蘭縣,冬山鄉,0297,444,214,658,30,688,1435,47.94%,30.94%,1
宜蘭縣,冬山鄉,0298,478,265,743,48,791,1519,52.07%,31.47%,1
宜蘭縣,冬山鄉,0299,531,288,819,29,848,1456,58.24%,36.47%,1
宜蘭縣,冬山鄉,0300,265,144,409,31,440,711,61.88%,37.27%,1
宜蘭縣,冬山鄉,0301,252,127,379,28,407,694,58.65%,36.31%,1
宜蘭縣,冬山鄉,0302,608,312,920,44,964,1526,63.17%,39.84%,1
宜蘭縣,冬山鄉,0303,285,184,469,23,492,884,55.66%,32.24%,1
宜蘭縣,冬山鄉,0304,423,31,454,63,517,1465,35.29%,28.87%,1
宜蘭縣,冬山鄉,0305,174,95,269,16,285,488,58.4%,35.66%,1
宜蘭縣,冬山鄉,0306,445,163,608,40,648,1218,53.2%,36.54%,1
宜蘭縣,冬山鄉,0307,429,201,630,33,663,1291,51.36%,33.23%,1
宜蘭縣,冬山鄉,0308,441,198,639,32,671,1324,50.68%,33.31%,1
宜蘭縣,冬山鄉,0309,360,175,535,40,575,1160,49.57%,31.03%,1
宜蘭縣,冬山鄉,0310,425,207,632,42,674,1246,54.09%,34.11%,1
宜蘭縣,冬山鄉,0311,577,301,878,35,913,1754,52.05%,32.9%,1
宜蘭縣,冬山鄉,0312,404,209,613,35,648,1217,53.25%,33.2%,1
宜蘭縣,冬山鄉,0313,444,245,689,32,721,1495,48.23%,29.7%,1
宜蘭縣,冬山鄉,0314,312,173,485,26,511,937,54.54%,33.3%,1
宜蘭縣,冬山鄉,0315,365,200,565,19,584,1101,53.04%,33.15%,1
宜蘭縣,冬山鄉,0316,365,185,550,35,585,1118,52.33%,32.65%,1
宜蘭縣,冬山鄉,0317,472,249,721,29,750,1301,57.65%,36.28%,1
宜蘭縣,冬山鄉,0318,406,228,634,24,658,1225,53.71%,33.14%,1
宜蘭縣,冬山鄉,0319,435,239,674,33,707,1206,58.62%,36.07%,1
宜蘭縣,冬山鄉,0320,409,216,625,26,651,1278,50.94%,32%,1
宜蘭縣,冬山鄉,0321,382,197,579,25,604,1151,52.48%,33.19%,1
宜蘭縣,冬山鄉,0322,351,151,502,40,542,1094,49.54%,32.08%,1
宜蘭縣,冬山鄉,0323,443,224,667,39,706,1247,56.62%,35.53%,1
宜蘭縣,冬山鄉,0324,410,186,596,33,629,1247,50.44%,32.88%,1
宜蘭縣,冬山鄉,0325,342,175,517,19,536,979,54.75%,34.93%,1
宜蘭縣,冬山鄉,0326,286,117,403,20,423,698,60.6%,40.97%,1
宜蘭縣,冬山鄉,0327,581,311,892,26,918,1726,53.19%,33.66%,1
宜蘭縣,冬山鄉,0328,228,124,352,20,372,782,47.57%,29.16%,1
宜蘭縣,五結鄉,0329,359,164,523,37,560,1076,52.04%,33.36%,1
宜蘭縣,五結鄉,0330,305,179,484,19,503,944,53.28%,32.31%,1
宜蘭縣,五結鄉,0331,348,128,476,17,493,836,58.97%,41.63%,1
宜蘭縣,五結鄉,0332,327,191,518,20,538,937,57.42%,34.9%,1
宜蘭縣,五結鄉,0333,420,224,644,20,664,1255,52.91%,33.47%,1
宜蘭縣,五結鄉,0334,417,232,649,36,685,1270,53.94%,32.83%,1
宜蘭縣,五結鄉,0335,269,121,390,26,416,801,51.94%,33.58%,1
宜蘭縣,五結鄉,0336,242,153,395,24,419,802,52.24%,30.17%,1
宜蘭縣,五結鄉,0337,408,207,615,37,652,1306,49.92%,31.24%,1
宜蘭縣,五結鄉,0338,395,205,600,29,629,1190,52.86%,33.19%,1
宜蘭縣,五結鄉,0339,444,251,695,19,714,1316,54.26%,33.74%,1
宜蘭縣,五結鄉,0340,364,166,530,21,551,965,57.1%,37.72%,1
宜蘭縣,五結鄉,0341,278,139,417,22,439,814,53.93%,34.15%,1
宜蘭縣,五結鄉,0342,421,203,624,27,651,1254,51.91%,33.57%,1
宜蘭縣,五結鄉,0343,402,180,582,21,603,1060,56.89%,37.92%,1
宜蘭縣,五結鄉,0344,462,253,715,24,739,1323,55.86%,34.92%,1
宜蘭縣,五結鄉,0345,410,197,607,34,641,1120,57.23%,36.61%,1
宜蘭縣,五結鄉,0346,315,152,467,14,481,893,53.86%,35.27%,1
宜蘭縣,五結鄉,0347,361,238,599,46,645,1220,52.87%,29.59%,1
宜蘭縣,五結鄉,0348,353,171,524,13,537,924,58.12%,38.2%,1
宜蘭縣,五結鄉,0349,367,174,541,26,567,933,60.77%,39.34%,1
宜蘭縣,五結鄉,0350,361,147,508,20,528,986,53.55%,36.61%,1
宜蘭縣,五結鄉,0351,260,124,384,24,408,748,54.55%,34.76%,1
宜蘭縣,五結鄉,0352,523,251,774,64,838,1550,54.06%,33.74%,1
宜蘭縣,五結鄉,0353,238,105,343,21,364,629,57.87%,37.84%,1
宜蘭縣,五結鄉,0354,283,140,423,21,444,806,55.09%,35.11%,1
宜蘭縣,五結鄉,0355,287,182,469,33,502,956,52.51%,30.02%,1
宜蘭縣,五結鄉,0356,378,157,535,33,568,1066,53.28%,35.46%,1
宜蘭縣,五結鄉,0357,468,226,694,57,751,1513,49.64%,30.93%,1
宜蘭縣,五結鄉,0358,521,268,789,41,830,1566,53%,33.27%,1
宜蘭縣,五結鄉,0359,307,149,456,40,496,894,55.48%,34.34%,1
宜蘭縣,五結鄉,0360,339,195,534,49,583,1235,47.21%,27.45%,1
宜蘭縣,五結鄉,0361,244,120,364,32,396,704,56.25%,34.66%,1
宜蘭縣,三星鄉,0362,78,31,109,10,119,215,55.35%,36.28%,1
宜蘭縣,三星鄉,0363,169,54,223,18,241,523,46.08%,32.31%,1
宜蘭縣,三星鄉,0364,223,147,370,20,390,745,52.35%,29.93%,1
宜蘭縣,三星鄉,0365,214,90,304,17,321,617,52.03%,34.68%,1
宜蘭縣,三星鄉,0366,175,80,255,12,267,497,53.72%,35.21%,1
宜蘭縣,三星鄉,0367,249,126,375,40,415,735,56.46%,33.88%,1
宜蘭縣,三星鄉,0368,215,85,300,27,327,583,56.09%,36.88%,1
宜蘭縣,三星鄉,0369,169,48,217,18,235,436,53.9%,38.76%,1
宜蘭縣,三星鄉,0370,416,202,618,34,652,1224,53.27%,33.99%,1
宜蘭縣,三星鄉,0371,381,173,554,28,582,1151,50.56%,33.1%,1
宜蘭縣,三星鄉,0372,306,151,457,22,479,870,55.06%,35.17%,1
宜蘭縣,三星鄉,0373,364,143,507,30,537,1284,41.82%,28.35%,1
宜蘭縣,三星鄉,0374,325,168,493,40,533,897,59.42%,36.23%,1
宜蘭縣,三星鄉,0375,507,224,731,44,775,1439,53.86%,35.23%,1
宜蘭縣,三星鄉,0376,453,251,704,34,738,1445,51.07%,31.35%,1
宜蘭縣,三星鄉,0377,487,220,707,37,744,1402,53.07%,34.74%,1
宜蘭縣,三星鄉,0378,406,213,619,30,649,1230,52.76%,33.01%,1
宜蘭縣,三星鄉,0379,284,112,396,36,432,774,55.81%,36.69%,1
宜蘭縣,三星鄉,0380,304,148,452,30,482,827,58.28%,36.76%,1
宜蘭縣,三星鄉,0381,247,139,386,22,408,736,55.43%,33.56%,1
宜蘭縣,三星鄉,0382,512,200,712,39,751,1421,52.85%,36.03%,1
宜蘭縣,大同鄉,0383,442,110,552,28,580,893,64.95%,49.5%,1
宜蘭縣,大同鄉,0384,347,103,450,12,462,632,73.1%,54.91%,1
宜蘭縣,大同鄉,0385,357,88,445,16,461,684,67.4%,52.19%,1
宜蘭縣,大同鄉,0386,117,49,166,11,177,264,67.05%,44.32%,1
宜蘭縣,大同鄉,0387,191,33,224,7,231,337,68.55%,56.68%,1
宜蘭縣,大同鄉,0388,271,45,316,11,327,404,80.94%,67.08%,1
宜蘭縣,大同鄉,0389,16,8,24,3,27,55,49.09%,29.09%,1
宜蘭縣,大同鄉,0390,110,36,146,10,156,199,78.39%,55.28%,1
宜蘭縣,大同鄉,0391,499,98,597,19,616,787,78.27%,63.41%,1
宜蘭縣,大同鄉,0392,422,77,499,21,520,680,76.47%,62.06%,1
宜蘭縣,南澳鄉,0393,246,35,281,5,286,444,64.41%,55.41%,1
宜蘭縣,南澳鄉,0394,462,126,588,26,614,1210,50.74%,38.18%,1
宜蘭縣,南澳鄉,0395,503,99,602,39,641,962,66.63%,52.29%,1
宜蘭縣,南澳鄉,0396,195,49,244,11,255,411,62.04%,47.45%,1
宜蘭縣,南澳鄉,0397,237,64,301,14,315,447,70.47%,53.02%,1
宜蘭縣,南澳鄉,0398,261,85,346,22,368,475,77.47%,54.95%,1
宜蘭縣,南澳鄉,0399,295,93,388,27,415,695,59.71%,42.45%,1
花蓮縣,花蓮市,0001,598,257,855,11,866,1522,56.9%,39.29%,1
花蓮縣,花蓮市,0002,448,188,636,16,652,1114,58.53%,40.22%,1
花蓮縣,花蓮市,0003,265,94,359,18,377,670,56.27%,39.55%,1
花蓮縣,花蓮市,0004,495,230,725,13,738,1397,52.83%,35.43%,1
花蓮縣,花蓮市,0005,152,76,228,11,239,470,50.85%,32.34%,1
花蓮縣,花蓮市,0006,299,105,404,32,436,838,52.03%,35.68%,1
花蓮縣,花蓮市,0007,244,62,306,14,320,721,44.38%,33.84%,1
花蓮縣,花蓮市,0008,355,143,498,35,533,918,58.06%,38.67%,1
花蓮縣,花蓮市,0009,522,263,785,27,812,1539,52.76%,33.92%,1
花蓮縣,花蓮市,0010,518,202,720,28,748,1403,53.31%,36.92%,1
花蓮縣,花蓮市,0011,396,153,549,20,569,1068,53.28%,37.08%,1
花蓮縣,花蓮市,0012,448,172,620,22,642,1167,55.01%,38.39%,1
花蓮縣,花蓮市,0013,519,201,720,34,754,1259,59.89%,41.22%,1
花蓮縣,花蓮市,0014,399,148,547,43,590,1071,55.09%,37.25%,1
花蓮縣,花蓮市,0015,358,151,509,20,529,925,57.19%,38.7%,1
花蓮縣,花蓮市,0016,465,201,666,47,713,1141,62.49%,40.75%,1
花蓮縣,花蓮市,0017,431,169,600,16,616,1163,52.97%,37.06%,1
花蓮縣,花蓮市,0018,506,219,725,22,747,1279,58.41%,39.56%,1
花蓮縣,花蓮市,0019,521,209,730,22,752,1512,49.74%,34.46%,1
花蓮縣,花蓮市,0020,226,98,324,10,334,615,54.31%,36.75%,1
花蓮縣,花蓮市,0021,224,121,345,13,358,606,59.08%,36.96%,1
花蓮縣,花蓮市,0022,200,67,267,14,281,559,50.27%,35.78%,1
花蓮縣,花蓮市,0023,167,70,237,10,247,442,55.88%,37.78%,1
花蓮縣,花蓮市,0024,392,164,556,23,579,1114,51.97%,35.19%,1
花蓮縣,花蓮市,0025,163,68,231,10,241,416,57.93%,39.18%,1
花蓮縣,花蓮市,0026,229,104,333,21,354,577,61.35%,39.69%,1
花蓮縣,花蓮市,0027,319,156,475,19,494,810,60.99%,39.38%,1
花蓮縣,花蓮市,0028,200,88,288,21,309,538,57.43%,37.17%,1
花蓮縣,花蓮市,0029,195,90,285,25,310,566,54.77%,34.45%,1
花蓮縣,花蓮市,0030,193,70,263,10,273,469,58.21%,41.15%,1
花蓮縣,花蓮市,0031,224,87,311,15,326,565,57.7%,39.65%,1
花蓮縣,花蓮市,0032,288,100,388,15,403,816,49.39%,35.29%,1
花蓮縣,花蓮市,0033,312,133,445,33,478,911,52.47%,34.25%,1
花蓮縣,花蓮市,0034,366,135,501,37,538,1029,52.28%,35.57%,1
花蓮縣,花蓮市,0035,423,167,590,26,616,1043,59.06%,40.56%,1
花蓮縣,花蓮市,0036,315,157,472,23,495,856,57.83%,36.8%,1
花蓮縣,花蓮市,0037,346,165,511,25,536,979,54.75%,35.34%,1
花蓮縣,花蓮市,0038,493,224,717,36,753,1331,56.57%,37.04%,1
花蓮縣,花蓮市,0039,466,213,679,15,694,1228,56.51%,37.95%,1
花蓮縣,花蓮市,0040,371,155,526,22,548,955,57.38%,38.85%,1
花蓮縣,花蓮市,0041,422,190,612,31,643,1268,50.71%,33.28%,1
花蓮縣,花蓮市,0042,420,185,605,39,644,1230,52.36%,34.15%,1
花蓮縣,花蓮市,0043,541,188,729,43,772,1369,56.39%,39.52%,1
花蓮縣,花蓮市,0044,450,200,650,25,675,1435,47.04%,31.36%,1
花蓮縣,花蓮市,0045,438,166,604,35,639,1164,54.9%,37.63%,1
花蓮縣,花蓮市,0046,498,206,704,38,742,1249,59.41%,39.87%,1
花蓮縣,花蓮市,0047,427,189,616,42,658,1184,55.57%,36.06%,1
花蓮縣,花蓮市,0048,530,234,764,18,782,1490,52.48%,35.57%,1
花蓮縣,花蓮市,0049,427,186,613,31,644,1022,63.01%,41.78%,1
花蓮縣,花蓮市,0050,443,161,604,33,637,1135,56.12%,39.03%,1
花蓮縣,花蓮市,0051,429,153,582,28,610,1084,56.27%,39.58%,1
花蓮縣,花蓮市,0052,316,160,476,23,499,1339,37.27%,23.6%,1
花蓮縣,花蓮市,0053,204,81,285,16,301,501,60.08%,40.72%,1
花蓮縣,花蓮市,0054,356,134,490,16,506,904,55.97%,39.38%,1
花蓮縣,花蓮市,0055,203,89,292,12,304,490,62.04%,41.43%,1
花蓮縣,花蓮市,0056,388,165,553,28,581,1192,48.74%,32.55%,1
花蓮縣,花蓮市,0057,284,132,416,19,435,869,50.06%,32.68%,1
花蓮縣,花蓮市,0058,445,210,655,22,677,1267,53.43%,35.12%,1
花蓮縣,花蓮市,0059,383,150,533,22,555,959,57.87%,39.94%,1
花蓮縣,花蓮市,0060,385,136,521,24,545,993,54.88%,38.77%,1
花蓮縣,花蓮市,0061,351,167,518,34,552,982,56.21%,35.74%,1
花蓮縣,花蓮市,0062,431,201,632,11,643,1311,49.05%,32.88%,1
花蓮縣,花蓮市,0063,483,229,712,38,750,1455,51.55%,33.2%,1
花蓮縣,花蓮市,0064,386,130,516,22,538,1151,46.74%,33.54%,1
花蓮縣,花蓮市,0065,408,183,591,20,611,1237,49.39%,32.98%,1
花蓮縣,花蓮市,0066,427,190,617,28,645,1339,48.17%,31.89%,1
花蓮縣,花蓮市,0067,282,113,395,21,416,715,58.18%,39.44%,1
花蓮縣,花蓮市,0068,364,175,539,20,559,1000,55.9%,36.4%,1
花蓮縣,花蓮市,0069,474,188,662,35,697,1410,49.43%,33.62%,1
花蓮縣,花蓮市,0070,470,207,677,20,697,1303,53.49%,36.07%,1
花蓮縣,花蓮市,0071,455,197,652,21,673,1256,53.58%,36.23%,1
花蓮縣,花蓮市,0072,437,159,596,40,636,1105,57.56%,39.55%,1
花蓮縣,花蓮市,0073,364,173,537,21,558,1089,51.24%,33.43%,1
花蓮縣,花蓮市,0074,355,151,506,26,532,1043,51.01%,34.04%,1
花蓮縣,花蓮市,0075,440,157,597,22,619,1080,57.31%,40.74%,1
花蓮縣,花蓮市,0076,377,147,524,20,544,971,56.02%,38.83%,1
花蓮縣,花蓮市,0077,382,205,587,26,613,1068,57.4%,35.77%,1
花蓮縣,花蓮市,0078,504,165,669,24,693,1379,50.25%,36.55%,1
花蓮縣,花蓮市,0079,463,215,678,36,714,1362,52.42%,33.99%,1
花蓮縣,花蓮市,0080,489,241,730,29,759,1323,57.37%,36.96%,1
花蓮縣,花蓮市,0081,442,206,648,34,682,1482,46.02%,29.82%,1
花蓮縣,鳳林鎮,0195,521,171,692,45,737,1192,61.83%,43.71%,1
花蓮縣,鳳林鎮,0196,213,94,307,18,325,639,50.86%,33.33%,1
花蓮縣,鳳林鎮,0197,267,103,370,32,402,601,66.89%,44.43%,1
花蓮縣,鳳林鎮,0198,482,200,682,47,729,1137,64.12%,42.39%,1
花蓮縣,鳳林鎮,0199,270,112,382,34,416,742,56.06%,36.39%,1
花蓮縣,鳳林鎮,0200,245,82,327,24,351,610,57.54%,40.16%,1
花蓮縣,鳳林鎮,0201,109,59,168,24,192,295,65.08%,36.95%,1
花蓮縣,鳳林鎮,0202,63,11,74,3,77,218,35.32%,28.9%,1
花蓮縣,鳳林鎮,0203,225,90,315,20,335,720,46.53%,31.25%,1
花蓮縣,鳳林鎮,0204,174,87,261,29,290,528,54.92%,32.95%,1
花蓮縣,鳳林鎮,0205,185,86,271,22,293,560,52.32%,33.04%,1
花蓮縣,鳳林鎮,0206,213,50,263,27,290,541,53.6%,39.37%,1
花蓮縣,鳳林鎮,0207,311,106,417,47,464,818,56.72%,38.02%,1
花蓮縣,鳳林鎮,0208,290,115,405,27,432,984,43.9%,29.47%,1
花蓮縣,鳳林鎮,0209,27,15,42,8,50,91,54.95%,29.67%,1
花蓮縣,玉里鎮,0254,360,153,513,31,544,1008,53.97%,35.71%,1
花蓮縣,玉里鎮,0255,405,125,530,31,561,939,59.74%,43.13%,1
花蓮縣,玉里鎮,0256,468,148,616,42,658,1256,52.39%,37.26%,1
花蓮縣,玉里鎮,0257,335,138,473,34,507,929,54.57%,36.06%,1
花蓮縣,玉里鎮,0258,358,148,506,31,537,979,54.85%,36.57%,1
花蓮縣,玉里鎮,0259,503,200,703,26,729,1244,58.6%,40.43%,1
花蓮縣,玉里鎮,0260,286,111,397,21,418,847,49.35%,33.77%,1
花蓮縣,玉里鎮,0261,237,109,346,36,382,772,49.48%,30.7%,1
花蓮縣,玉里鎮,0262,182,84,266,13,279,558,50%,32.62%,1
花蓮縣,玉里鎮,0263,185,54,239,22,261,800,32.63%,23.13%,1
花蓮縣,玉里鎮,0264,421,133,554,45,599,1286,46.58%,32.74%,1
花蓮縣,玉里鎮,0265,398,146,544,54,598,1246,47.99%,31.94%,1
花蓮縣,玉里鎮,0266,206,95,301,46,347,647,53.63%,31.84%,1
花蓮縣,玉里鎮,0267,279,87,366,25,391,990,39.49%,28.18%,1
花蓮縣,玉里鎮,0268,188,57,245,22,267,530,50.38%,35.47%,1
花蓮縣,玉里鎮,0269,296,99,395,41,436,979,44.54%,30.23%,1
花蓮縣,玉里鎮,0270,239,50,289,31,320,557,57.45%,42.91%,1
花蓮縣,玉里鎮,0271,160,30,190,21,211,434,48.62%,36.87%,1
花蓮縣,玉里鎮,0272,241,91,332,65,397,1065,37.28%,22.63%,1
花蓮縣,玉里鎮,0273,305,110,415,53,468,866,54.04%,35.22%,1
花蓮縣,玉里鎮,0274,284,94,378,24,402,769,52.28%,36.93%,1
花蓮縣,玉里鎮,0275,220,119,339,32,371,869,42.69%,25.32%,1
花蓮縣,玉里鎮,0276,306,109,415,38,453,1080,41.94%,28.33%,1
花蓮縣,新城鄉,0082,131,69,200,17,217,367,59.13%,35.69%,1
花蓮縣,新城鄉,0083,328,131,459,12,471,929,50.7%,35.31%,1
花蓮縣,新城鄉,0084,204,105,309,48,357,590,60.51%,34.58%,1
花蓮縣,新城鄉,0085,107,53,160,13,173,307,56.35%,34.85%,1
花蓮縣,新城鄉,0086,109,38,147,14,161,260,61.92%,41.92%,1
花蓮縣,新城鄉,0087,468,221,689,30,719,1283,56.04%,36.48%,1
花蓮縣,新城鄉,0088,322,123,445,17,462,885,52.2%,36.38%,1
花蓮縣,新城鄉,0089,284,138,422,28,450,770,58.44%,36.88%,1
花蓮縣,新城鄉,0090,538,171,709,31,740,1363,54.29%,39.47%,1
花蓮縣,新城鄉,0091,117,64,181,14,195,366,53.28%,31.97%,1
花蓮縣,新城鄉,0092,398,160,558,32,590,1163,50.73%,34.22%,1
花蓮縣,新城鄉,0093,593,230,823,29,852,1605,53.08%,36.95%,1
花蓮縣,新城鄉,0094,459,168,627,33,660,1194,55.28%,38.44%,1
花蓮縣,新城鄉,0095,380,150,530,26,556,979,56.79%,38.82%,1
花蓮縣,新城鄉,0096,561,235,796,30,826,1485,55.62%,37.78%,1
花蓮縣,新城鄉,0097,377,156,533,25,558,1070,52.15%,35.23%,1
花蓮縣,新城鄉,0098,513,96,609,26,635,1164,54.55%,44.07%,1
花蓮縣,新城鄉,0099,293,145,438,32,470,880,53.41%,33.3%,1
花蓮縣,新城鄉,0100,122,57,179,7,186,369,50.41%,33.06%,1
花蓮縣,吉安鄉,0115,370,169,539,20,559,1059,52.79%,34.94%,1
花蓮縣,吉安鄉,0116,365,156,521,26,547,983,55.65%,37.13%,1
花蓮縣,吉安鄉,0117,388,155,543,23,566,1031,54.9%,37.63%,1
花蓮縣,吉安鄉,0118,382,151,533,38,571,1105,51.67%,34.57%,1
花蓮縣,吉安鄉,0119,392,164,556,26,582,1107,52.57%,35.41%,1
花蓮縣,吉安鄉,0120,386,163,549,42,591,1179,50.13%,32.74%,1
花蓮縣,吉安鄉,0121,416,209,625,40,665,1453,45.77%,28.63%,1
花蓮縣,吉安鄉,0122,545,247,792,47,839,1432,58.59%,38.06%,1
花蓮縣,吉安鄉,0123,474,212,686,42,728,1320,55.15%,35.91%,1
花蓮縣,吉安鄉,0124,491,188,679,23,702,1356,51.77%,36.21%,1
花蓮縣,吉安鄉,0125,476,177,653,24,677,1295,52.28%,36.76%,1
花蓮縣,吉安鄉,0126,507,237,744,54,798,1467,54.4%,34.56%,1
花蓮縣,吉安鄉,0127,539,232,771,20,791,1515,52.21%,35.58%,1
花蓮縣,吉安鄉,0128,413,182,595,34,629,1063,59.17%,38.85%,1
花蓮縣,吉安鄉,0129,381,176,557,13,570,1284,44.39%,29.67%,1
花蓮縣,吉安鄉,0130,528,219,747,27,774,1380,56.09%,38.26%,1
花蓮縣,吉安鄉,0131,476,219,695,42,737,1297,56.82%,36.7%,1
花蓮縣,吉安鄉,0132,422,364,786,71,857,1662,51.56%,25.39%,1
花蓮縣,吉安鄉,0133,500,201,701,57,758,1563,48.5%,31.99%,1
花蓮縣,吉安鄉,0134,421,151,572,49,621,1288,48.21%,32.69%,1
花蓮縣,吉安鄉,0135,361,125,486,35,521,907,57.44%,39.8%,1
花蓮縣,吉安鄉,0136,321,131,452,22,474,917,51.69%,35.01%,1
花蓮縣,吉安鄉,0137,356,149,505,21,526,1021,51.52%,34.87%,1
花蓮縣,吉安鄉,0138,431,162,593,21,614,1033,59.44%,41.72%,1
花蓮縣,吉安鄉,0139,383,133,516,39,555,966,57.45%,39.65%,1
花蓮縣,吉安鄉,0140,422,157,579,48,627,1188,52.78%,35.52%,1
花蓮縣,吉安鄉,0141,540,217,757,16,773,1480,52.23%,36.49%,1
花蓮縣,吉安鄉,0142,465,168,633,41,674,1393,48.38%,33.38%,1
花蓮縣,吉安鄉,0143,424,160,584,27,611,1193,51.22%,35.54%,1
花蓮縣,吉安鄉,0144,495,181,676,26,702,1445,48.58%,34.26%,1
花蓮縣,吉安鄉,0145,433,208,641,72,713,1301,54.8%,33.28%,1
花蓮縣,吉安鄉,0146,444,209,653,40,693,1215,57.04%,36.54%,1
花蓮縣,吉安鄉,0147,405,176,581,30,611,1135,53.83%,35.68%,1
花蓮縣,吉安鄉,0148,494,182,676,19,695,1223,56.83%,40.39%,1
花蓮縣,吉安鄉,0149,495,175,670,29,699,1274,54.87%,38.85%,1
花蓮縣,吉安鄉,0150,423,150,573,24,597,1124,53.11%,37.63%,1
花蓮縣,吉安鄉,0151,435,194,629,21,650,1158,56.13%,37.56%,1
花蓮縣,吉安鄉,0152,448,191,639,10,649,1157,56.09%,38.72%,1
花蓮縣,吉安鄉,0153,477,186,663,30,693,1258,55.09%,37.92%,1
花蓮縣,吉安鄉,0154,445,198,643,29,672,1257,53.46%,35.4%,1
花蓮縣,吉安鄉,0155,447,173,620,28,648,1245,52.05%,35.9%,1
花蓮縣,吉安鄉,0156,453,181,634,15,649,1166,55.66%,38.85%,1
花蓮縣,吉安鄉,0157,508,178,686,28,714,1358,52.58%,37.41%,1
花蓮縣,吉安鄉,0158,496,133,629,27,656,1214,54.04%,40.86%,1
花蓮縣,吉安鄉,0159,426,168,594,25,619,1151,53.78%,37.01%,1
花蓮縣,吉安鄉,0160,428,168,596,31,627,1157,54.19%,36.99%,1
花蓮縣,吉安鄉,0161,446,180,626,28,654,1161,56.33%,38.42%,1
花蓮縣,吉安鄉,0162,511,200,711,26,737,1304,56.52%,39.19%,1
花蓮縣,吉安鄉,0163,488,196,684,40,724,1367,52.96%,35.7%,1
花蓮縣,吉安鄉,0164,459,182,641,27,668,1411,47.34%,32.53%,1
花蓮縣,吉安鄉,0165,484,170,654,27,681,1409,48.33%,34.35%,1
花蓮縣,吉安鄉,0166,378,138,516,23,539,1125,47.91%,33.6%,1
花蓮縣,吉安鄉,0167,453,170,623,49,672,1213,55.4%,37.35%,1
花蓮縣,吉安鄉,0168,443,165,608,18,626,1141,54.86%,38.83%,1
花蓮縣,吉安鄉,0169,400,126,526,24,550,1156,47.58%,34.6%,1
花蓮縣,吉安鄉,0170,392,133,525,40,565,1092,51.74%,35.9%,1
花蓮縣,吉安鄉,0171,308,127,435,33,468,1026,45.61%,30.02%,1
花蓮縣,吉安鄉,0172,305,104,409,19,428,804,53.23%,37.94%,1
花蓮縣,吉安鄉,0173,434,152,586,41,627,1132,55.39%,38.34%,1
花蓮縣,壽豐鄉,0174,382,127,509,35,544,1052,51.71%,36.31%,1
花蓮縣,壽豐鄉,0175,140,51,191,27,218,357,61.06%,39.22%,1
花蓮縣,壽豐鄉,0176,322,149,471,49,520,1022,50.88%,31.51%,1
花蓮縣,壽豐鄉,0177,377,141,518,30,548,875,62.63%,43.09%,1
花蓮縣,壽豐鄉,0178,276,120,396,30,426,691,61.65%,39.94%,1
花蓮縣,壽豐鄉,0179,246,97,343,22,365,708,51.55%,34.75%,1
花蓮縣,壽豐鄉,0180,294,140,434,41,475,894,53.13%,32.89%,1
花蓮縣,壽豐鄉,0181,270,114,384,28,412,746,55.23%,36.19%,1
花蓮縣,壽豐鄉,0182,293,132,425,23,448,881,50.85%,33.26%,1
花蓮縣,壽豐鄉,0183,290,119,409,22,431,695,62.01%,41.73%,1
花蓮縣,壽豐鄉,0184,349,128,477,38,515,816,63.11%,42.77%,1
花蓮縣,壽豐鄉,0185,266,102,368,28,396,773,51.23%,34.41%,1
花蓮縣,壽豐鄉,0186,390,164,554,35,589,1029,57.24%,37.9%,1
花蓮縣,壽豐鄉,0187,176,60,236,21,257,407,63.14%,43.24%,1
花蓮縣,壽豐鄉,0188,433,172,605,45,650,1139,57.07%,38.02%,1
花蓮縣,壽豐鄉,0189,318,223,541,30,571,996,57.33%,31.93%,1
花蓮縣,壽豐鄉,0190,139,42,181,8,189,414,45.65%,33.57%,1
花蓮縣,壽豐鄉,0191,98,44,142,14,156,270,57.78%,36.3%,1
花蓮縣,壽豐鄉,0192,317,101,418,70,488,836,58.37%,37.92%,1
花蓮縣,壽豐鄉,0193,189,94,283,27,310,507,61.14%,37.28%,1
花蓮縣,壽豐鄉,0194,214,74,288,28,316,739,42.76%,28.96%,1
花蓮縣,光復鄉,0210,497,184,681,50,731,1295,56.45%,38.38%,1
花蓮縣,光復鄉,0211,358,133,491,25,516,859,60.07%,41.68%,1
花蓮縣,光復鄉,0212,401,122,523,47,570,958,59.5%,41.86%,1
花蓮縣,光復鄉,0213,403,133,536,57,593,1011,58.65%,39.86%,1
花蓮縣,光復鄉,0214,423,143,566,40,606,1041,58.21%,40.63%,1
花蓮縣,光復鄉,0215,295,112,407,49,456,821,55.54%,35.93%,1
花蓮縣,光復鄉,0216,35,11,46,2,48,188,25.53%,18.62%,1
花蓮縣,光復鄉,0217,196,63,259,24,283,514,55.06%,38.13%,1
花蓮縣,光復鄉,0218,145,42,187,10,197,446,44.17%,32.51%,1
花蓮縣,光復鄉,0219,336,113,449,31,480,851,56.4%,39.48%,1
花蓮縣,光復鄉,0220,270,125,395,23,418,932,44.85%,28.97%,1
花蓮縣,光復鄉,0221,189,65,254,14,268,471,56.9%,40.13%,1
花蓮縣,光復鄉,0222,205,101,306,49,355,640,55.47%,32.03%,1
花蓮縣,光復鄉,0223,32,12,44,4,48,116,41.38%,27.59%,1
花蓮縣,光復鄉,0224,124,45,169,10,179,496,36.09%,25%,1
花蓮縣,光復鄉,0225,97,35,132,14,146,324,45.06%,29.94%,1
花蓮縣,光復鄉,0226,115,46,161,20,181,454,39.87%,25.33%,1
花蓮縣,豐濱鄉,0227,232,89,321,30,351,717,48.95%,32.36%,1
花蓮縣,豐濱鄉,0228,183,129,312,14,326,751,43.41%,24.37%,1
花蓮縣,豐濱鄉,0229,195,77,272,26,298,613,48.61%,31.81%,1
花蓮縣,豐濱鄉,0230,344,106,450,22,472,809,58.34%,42.52%,1
花蓮縣,豐濱鄉,0231,107,36,143,11,154,357,43.14%,29.97%,1
花蓮縣,豐濱鄉,0232,230,88,318,23,341,669,50.97%,34.38%,1
花蓮縣,豐濱鄉,0233,156,67,223,9,232,479,48.43%,32.57%,1
花蓮縣,瑞穗鄉,0241,347,95,442,31,473,813,58.18%,42.68%,1
花蓮縣,瑞穗鄉,0242,407,162,569,41,610,1091,55.91%,37.31%,1
花蓮縣,瑞穗鄉,0243,319,131,450,30,480,839,57.21%,38.02%,1
花蓮縣,瑞穗鄉,0244,381,137,518,39,557,975,57.13%,39.08%,1
花蓮縣,瑞穗鄉,0245,182,68,250,11,261,546,47.8%,33.33%,1
花蓮縣,瑞穗鄉,0246,370,151,521,50,571,1002,56.99%,36.93%,1
花蓮縣,瑞穗鄉,0247,171,72,243,33,276,593,46.54%,28.84%,1
花蓮縣,瑞穗鄉,0248,358,144,502,53,555,965,57.51%,37.1%,1
花蓮縣,瑞穗鄉,0249,332,100,432,46,478,863,55.39%,38.47%,1
花蓮縣,瑞穗鄉,0250,80,27,107,6,113,340,33.24%,23.53%,1
花蓮縣,瑞穗鄉,0251,237,95,332,22,354,764,46.34%,31.02%,1
花蓮縣,瑞穗鄉,0252,182,74,256,8,264,868,30.41%,20.97%,1
花蓮縣,瑞穗鄉,0253,179,43,222,17,239,620,38.55%,28.87%,1
花蓮縣,富里鄉,0277,119,61,180,19,199,467,42.61%,25.48%,1
花蓮縣,富里鄉,0278,259,105,364,43,407,1032,39.44%,25.1%,1
花蓮縣,富里鄉,0279,199,64,263,21,284,638,44.51%,31.19%,1
花蓮縣,富里鄉,0280,210,75,285,37,322,591,54.48%,35.53%,1
花蓮縣,富里鄉,0281,381,158,539,54,593,1087,54.55%,35.05%,1
花蓮縣,富里鄉,0282,134,70,204,20,224,431,51.97%,31.09%,1
花蓮縣,富里鄉,0283,278,125,403,33,436,893,48.82%,31.13%,1
花蓮縣,富里鄉,0284,81,46,127,22,149,361,41.27%,22.44%,1
花蓮縣,富里鄉,0285,338,171,509,39,548,1362,40.23%,24.82%,1
花蓮縣,富里鄉,0286,146,65,211,28,239,458,52.18%,31.88%,1
花蓮縣,富里鄉,0287,123,49,172,37,209,621,33.66%,19.81%,1
花蓮縣,富里鄉,0288,151,66,217,26,243,493,49.29%,30.63%,1
花蓮縣,富里鄉,0289,181,89,270,31,301,631,47.7%,28.68%,1
花蓮縣,秀林鄉,0101,310,124,434,17,451,867,52.02%,35.76%,1
花蓮縣,秀林鄉,0102,175,110,285,20,305,575,53.04%,30.43%,1
花蓮縣,秀林鄉,0103,376,163,539,27,566,1373,41.22%,27.39%,1
花蓮縣,秀林鄉,0104,556,191,747,45,792,1644,48.18%,33.82%,1
花蓮縣,秀林鄉,0105,63,23,86,4,90,162,55.56%,38.89%,1
花蓮縣,秀林鄉,0106,119,62,181,20,201,384,52.34%,30.99%,1
花蓮縣,秀林鄉,0107,422,209,631,38,669,1382,48.41%,30.54%,1
花蓮縣,秀林鄉,0108,393,180,573,31,604,1125,53.69%,34.93%,1
花蓮縣,秀林鄉,0109,206,96,302,14,316,627,50.4%,32.85%,1
花蓮縣,秀林鄉,0110,410,155,565,36,601,987,60.89%,41.54%,1
花蓮縣,秀林鄉,0111,463,189,652,51,703,1139,61.72%,40.65%,1
花蓮縣,秀林鄉,0112,472,194,666,8,674,1213,55.56%,38.91%,1
花蓮縣,秀林鄉,0113,276,131,407,19,426,754,56.5%,36.6%,1
花蓮縣,秀林鄉,0114,111,42,153,10,163,330,49.39%,33.64%,1
花蓮縣,萬榮鄉,0234,398,164,562,41,603,1072,56.25%,37.13%,1
花蓮縣,萬榮鄉,0235,222,85,307,9,316,560,56.43%,39.64%,1
花蓮縣,萬榮鄉,0236,328,127,455,30,485,773,62.74%,42.43%,1
花蓮縣,萬榮鄉,0237,227,89,316,11,327,661,49.47%,34.34%,1
花蓮縣,萬榮鄉,0238,201,68,269,11,280,442,63.35%,45.48%,1
花蓮縣,萬榮鄉,0239,259,81,340,21,361,675,53.48%,38.37%,1
花蓮縣,萬榮鄉,0240,481,210,691,55,746,1086,68.69%,44.29%,1
花蓮縣,卓溪鄉,0290,187,78,265,25,290,533,54.41%,35.08%,1
花蓮縣,卓溪鄉,0291,229,85,314,23,337,522,64.56%,43.87%,1
花蓮縣,卓溪鄉,0292,232,80,312,10,322,493,65.31%,47.06%,1
花蓮縣,卓溪鄉,0293,334,81,415,26,441,701,62.91%,47.65%,1
花蓮縣,卓溪鄉,0294,306,104,410,33,443,746,59.38%,41.02%,1
花蓮縣,卓溪鄉,0295,257,99,356,33,389,616,63.15%,41.72%,1
花蓮縣,卓溪鄉,0296,150,48,198,5,203,405,50.12%,37.04%,1
花蓮縣,卓溪鄉,0297,125,43,168,10,178,329,54.1%,37.99%,1
花蓮縣,卓溪鄉,0298,180,43,223,13,236,428,55.14%,42.06%,1
花蓮縣,卓溪鄉,0299,71,20,91,7,98,174,56.32%,40.8%,1
臺東縣,臺東市,0001,305,113,418,16,434,874,49.66%,34.9%,1
臺東縣,臺東市,0002,619,252,871,36,907,1469,61.74%,42.14%,1
臺東縣,臺東市,0003,493,197,690,14,704,1259,55.92%,39.16%,1
臺東縣,臺東市,0004,519,237,756,25,781,1399,55.83%,37.1%,1
臺東縣,臺東市,0005,565,245,810,32,842,1363,61.78%,41.45%,1
臺東縣,臺東市,0006,636,244,880,28,908,1651,55%,38.52%,1
臺東縣,臺東市,0007,649,242,891,36,927,1490,62.21%,43.56%,1
臺東縣,臺東市,0008,300,126,426,36,462,859,53.78%,34.92%,1
臺東縣,臺東市,0009,354,166,520,22,542,890,60.9%,39.78%,1
臺東縣,臺東市,0010,257,104,361,16,377,651,57.91%,39.48%,1
臺東縣,臺東市,0011,549,240,789,41,830,1650,50.3%,33.27%,1
臺東縣,臺東市,0012,294,140,434,22,456,724,62.98%,40.61%,1
臺東縣,臺東市,0013,249,115,364,18,382,632,60.44%,39.4%,1
臺東縣,臺東市,0014,313,122,435,28,463,771,60.05%,40.6%,1
臺東縣,臺東市,0015,291,119,410,17,427,798,53.51%,36.47%,1
臺東縣,臺東市,0016,484,175,659,58,717,1299,55.2%,37.26%,1
臺東縣,臺東市,0017,316,143,459,25,484,811,59.68%,38.96%,1
臺東縣,臺東市,0018,332,142,474,19,493,764,64.53%,43.46%,1
臺東縣,臺東市,0019,263,144,407,15,422,784,53.83%,33.55%,1
臺東縣,臺東市,0020,157,61,218,7,225,427,52.69%,36.77%,1
臺東縣,臺東市,0021,544,93,637,20,657,1292,50.85%,42.11%,1
臺東縣,臺東市,0022,610,255,865,12,877,1501,58.43%,40.64%,1
臺東縣,臺東市,0023,206,94,300,12,312,601,51.91%,34.28%,1
臺東縣,臺東市,0024,138,79,217,6,223,417,53.48%,33.09%,1
臺東縣,臺東市,0025,396,139,535,29,564,1001,56.34%,39.56%,1
臺東縣,臺東市,0026,645,279,924,30,954,1638,58.24%,39.38%,1
臺東縣,臺東市,0027,616,221,837,38,875,1576,55.52%,39.09%,1
臺東縣,臺東市,0028,588,275,863,38,901,1595,56.49%,36.87%,1
臺東縣,臺東市,0029,669,272,941,27,968,1734,55.82%,38.58%,1
臺東縣,臺東市,0030,573,237,810,42,852,1476,57.72%,38.82%,1
臺東縣,臺東市,0031,625,285,910,25,935,1545,60.52%,40.45%,1
臺東縣,臺東市,0032,579,183,762,35,797,1313,60.7%,44.1%,1
臺東縣,臺東市,0033,604,190,794,27,821,1338,61.36%,45.14%,1
臺東縣,臺東市,0034,613,102,715,25,740,1312,56.4%,46.72%,1
臺東縣,臺東市,0035,504,105,609,23,632,1265,49.96%,39.84%,1
臺東縣,臺東市,0036,451,205,656,25,681,1407,48.4%,32.05%,1
臺東縣,臺東市,0037,548,183,731,30,761,1552,49.03%,35.31%,1
臺東縣,臺東市,0038,540,121,661,48,709,1445,49.07%,37.37%,1
臺東縣,臺東市,0039,816,369,1185,31,1216,2098,57.96%,38.89%,1
臺東縣,臺東市,0040,546,190,736,53,789,1324,59.59%,41.24%,1
臺東縣,臺東市,0041,649,208,857,29,886,1598,55.44%,40.61%,1
臺東縣,臺東市,0042,577,216,793,14,807,1513,53.34%,38.14%,1
臺東縣,臺東市,0043,594,229,823,25,848,1679,50.51%,35.38%,1
臺東縣,臺東市,0044,505,220,725,12,737,1414,52.12%,35.71%,1
臺東縣,臺東市,0045,670,247,917,24,941,1798,52.34%,37.26%,1
臺東縣,臺東市,0046,579,227,806,45,851,1749,48.66%,33.1%,1
臺東縣,臺東市,0047,652,243,895,43,938,1709,54.89%,38.15%,1
臺東縣,臺東市,0048,599,229,828,36,864,1629,53.04%,36.77%,1
臺東縣,臺東市,0049,405,155,560,37,597,1116,53.49%,36.29%,1
臺東縣,臺東市,0050,370,182,552,24,576,1259,45.75%,29.39%,1
臺東縣,臺東市,0051,382,170,552,26,578,1232,46.92%,31.01%,1
臺東縣,臺東市,0052,511,193,704,69,773,1505,51.36%,33.95%,1
臺東縣,臺東市,0053,272,104,376,28,404,836,48.33%,32.54%,1
臺東縣,臺東市,0054,490,206,696,40,736,1294,56.88%,37.87%,1
臺東縣,臺東市,0055,488,197,685,38,723,1350,53.56%,36.15%,1
臺東縣,臺東市,0056,827,326,1153,45,1198,2162,55.41%,38.25%,1
臺東縣,臺東市,0057,655,279,934,34,968,1627,59.5%,40.26%,1
臺東縣,臺東市,0058,442,211,653,22,675,1140,59.21%,38.77%,1
臺東縣,臺東市,0059,495,212,707,29,736,1359,54.16%,36.42%,1
臺東縣,臺東市,0060,497,221,718,21,739,1329,55.61%,37.4%,1
臺東縣,臺東市,0061,367,125,492,24,516,990,52.12%,37.07%,1
臺東縣,臺東市,0062,379,169,548,43,591,1038,56.94%,36.51%,1
臺東縣,臺東市,0063,584,228,812,36,848,1597,53.1%,36.57%,1
臺東縣,臺東市,0064,453,247,700,44,744,1385,53.72%,32.71%,1
臺東縣,臺東市,0065,274,152,426,21,447,939,47.6%,29.18%,1
臺東縣,臺東市,0066,389,160,549,30,579,1258,46.03%,30.92%,1
臺東縣,臺東市,0067,433,222,655,10,665,1350,49.26%,32.07%,1
臺東縣,臺東市,0068,345,134,479,27,506,1058,47.83%,32.61%,1
臺東縣,臺東市,0069,304,110,414,15,429,895,47.93%,33.97%,1
臺東縣,成功鎮,0070,157,68,225,24,249,516,48.26%,30.43%,1
臺東縣,成功鎮,0071,418,139,557,36,593,960,61.77%,43.54%,1
臺東縣,成功鎮,0072,134,27,161,9,170,365,46.58%,36.71%,1
臺東縣,成功鎮,0073,244,65,309,36,345,747,46.18%,32.66%,1
臺東縣,成功鎮,0074,123,23,146,14,160,339,47.2%,36.28%,1
臺東縣,成功鎮,0075,321,135,456,16,472,995,47.44%,32.26%,1
臺東縣,成功鎮,0076,303,135,438,43,481,863,55.74%,35.11%,1
臺東縣,成功鎮,0077,342,123,465,42,507,931,54.46%,36.73%,1
臺東縣,成功鎮,0078,347,122,469,22,491,970,50.62%,35.77%,1
臺東縣,成功鎮,0079,479,156,635,61,696,1365,50.99%,35.09%,1
臺東縣,成功鎮,0080,500,160,660,60,720,1366,52.71%,36.6%,1
臺東縣,成功鎮,0081,184,59,243,21,264,516,51.16%,35.66%,1
臺東縣,成功鎮,0082,295,91,386,33,419,887,47.24%,33.26%,1
臺東縣,成功鎮,0083,156,50,206,13,219,488,44.88%,31.97%,1
臺東縣,成功鎮,0084,131,52,183,13,196,481,40.75%,27.23%,1
臺東縣,成功鎮,0085,116,41,157,4,161,373,43.16%,31.1%,1
臺東縣,成功鎮,0086,84,34,118,28,146,264,55.3%,31.82%,1
臺東縣,關山鎮,0087,369,146,515,22,537,909,59.08%,40.59%,1
臺東縣,關山鎮,0088,216,101,317,21,338,790,42.78%,27.34%,1
臺東縣,關山鎮,0089,345,120,465,36,501,828,60.51%,41.67%,1
臺東縣,關山鎮,0090,269,110,379,18,397,887,44.76%,30.33%,1
臺東縣,關山鎮,0091,436,161,597,24,621,1137,54.62%,38.35%,1
臺東縣,關山鎮,0092,225,104,329,23,352,732,48.09%,30.74%,1
臺東縣,關山鎮,0093,300,147,447,26,473,912,51.86%,32.89%,1
臺東縣,關山鎮,0094,212,94,306,14,320,779,41.08%,27.21%,1
臺東縣,關山鎮,0095,118,68,186,18,204,535,38.13%,22.06%,1
臺東縣,卑南鄉,0096,399,162,561,46,607,1041,58.31%,38.33%,1
臺東縣,卑南鄉,0097,405,149,554,24,578,1165,49.61%,34.76%,1
臺東縣,卑南鄉,0098,62,34,96,8,104,219,47.49%,28.31%,1
臺東縣,卑南鄉,0099,136,62,198,24,222,460,48.26%,29.57%,1
臺東縣,卑南鄉,0100,96,45,141,14,155,387,40.05%,24.81%,1
臺東縣,卑南鄉,0101,234,102,336,27,363,767,47.33%,30.51%,1
臺東縣,卑南鄉,0102,197,56,253,20,273,503,54.27%,39.17%,1
臺東縣,卑南鄉,0103,218,108,326,26,352,727,48.42%,29.99%,1
臺東縣,卑南鄉,0104,153,62,215,16,231,436,52.98%,35.09%,1
臺東縣,卑南鄉,0105,53,34,87,9,96,261,36.78%,20.31%,1
臺東縣,卑南鄉,0106,68,38,106,11,117,215,54.42%,31.63%,1
臺東縣,卑南鄉,0107,551,202,753,52,805,1442,55.83%,38.21%,1
臺東縣,卑南鄉,0108,202,52,254,10,264,527,50.09%,38.33%,1
臺東縣,卑南鄉,0109,373,165,538,44,582,1046,55.64%,35.66%,1
臺東縣,卑南鄉,0110,355,193,548,49,597,1110,53.78%,31.98%,1
臺東縣,卑南鄉,0111,404,181,585,48,633,1105,57.29%,36.56%,1
臺東縣,卑南鄉,0112,494,194,688,43,731,1167,62.64%,42.33%,1
臺東縣,卑南鄉,0113,303,137,440,35,475,968,49.07%,31.3%,1
臺東縣,卑南鄉,0114,38,20,58,3,61,159,38.36%,23.9%,1
臺東縣,卑南鄉,0115,146,52,198,22,220,488,45.08%,29.92%,1
臺東縣,卑南鄉,0116,135,56,191,13,204,347,58.79%,38.9%,1
臺東縣,卑南鄉,0117,172,49,221,16,237,436,54.36%,39.45%,1
臺東縣,鹿野鄉,0118,135,57,192,5,197,522,37.74%,25.86%,1
臺東縣,鹿野鄉,0119,201,88,289,20,309,574,53.83%,35.02%,1
臺東縣,鹿野鄉,0120,261,131,392,22,414,1055,39.24%,24.74%,1
臺東縣,鹿野鄉,0121,323,159,482,35,517,1104,46.83%,29.26%,1
臺東縣,鹿野鄉,0122,107,38,145,10,155,342,45.32%,31.29%,1
臺東縣,鹿野鄉,0123,272,109,381,42,423,895,47.26%,30.39%,1
臺東縣,鹿野鄉,0124,273,120,393,31,424,864,49.07%,31.6%,1
臺東縣,鹿野鄉,0125,177,86,263,29,292,675,43.26%,26.22%,1
臺東縣,鹿野鄉,0126,129,74,203,13,216,435,49.66%,29.66%,1
臺東縣,鹿野鄉,0127,97,70,167,19,186,470,39.57%,20.64%,1
臺東縣,池上鄉,0128,315,130,445,24,469,992,47.28%,31.75%,1
臺東縣,池上鄉,0129,338,141,479,36,515,929,55.44%,36.38%,1
臺東縣,池上鄉,0130,119,68,187,24,211,434,48.62%,27.42%,1
臺東縣,池上鄉,0131,159,108,267,40,307,703,43.67%,22.62%,1
臺東縣,池上鄉,0132,174,88,262,24,286,654,43.73%,26.61%,1
臺東縣,池上鄉,0133,74,40,114,15,129,324,39.81%,22.84%,1
臺東縣,池上鄉,0134,226,103,329,28,357,794,44.96%,28.46%,1
臺東縣,池上鄉,0135,262,109,371,43,414,856,48.36%,30.61%,1
臺東縣,池上鄉,0136,94,34,128,14,142,344,41.28%,27.33%,1
臺東縣,池上鄉,0137,110,40,150,22,172,311,55.31%,35.37%,1
臺東縣,池上鄉,0138,84,38,122,15,137,386,35.49%,21.76%,1
臺東縣,池上鄉,0139,86,41,127,24,151,435,34.71%,19.77%,1
臺東縣,東河鄉,0140,76,32,108,20,128,290,44.14%,26.21%,1
臺東縣,東河鄉,0141,248,80,328,25,353,620,56.94%,40%,1
臺東縣,東河鄉,0142,482,203,685,61,746,1196,62.37%,40.3%,1
臺東縣,東河鄉,0143,309,97,406,47,453,918,49.35%,33.66%,1
臺東縣,東河鄉,0144,188,62,250,11,261,555,47.03%,33.87%,1
臺東縣,東河鄉,0145,294,106,400,24,424,977,43.4%,30.09%,1
臺東縣,東河鄉,0146,265,94,359,24,383,1197,32%,22.14%,1
臺東縣,東河鄉,0147,134,53,187,26,213,867,24.57%,15.46%,1
臺東縣,東河鄉,0148,106,33,139,9,148,345,42.9%,30.72%,1
臺東縣,東河鄉,0149,106,50,156,14,170,408,41.67%,25.98%,1
臺東縣,東河鄉,0150,73,33,106,8,114,262,43.51%,27.86%,1
臺東縣,長濱鄉,0151,195,86,281,28,309,536,57.65%,36.38%,1
臺東縣,長濱鄉,0152,158,58,216,13,229,689,33.24%,22.93%,1
臺東縣,長濱鄉,0153,339,110,449,62,511,913,55.97%,37.13%,1
臺東縣,長濱鄉,0154,347,116,463,22,485,1268,38.25%,27.37%,1
臺東縣,長濱鄉,0155,252,90,342,28,370,725,51.03%,34.76%,1
臺東縣,長濱鄉,0156,99,52,151,9,160,532,30.08%,18.61%,1
臺東縣,長濱鄉,0157,159,80,239,40,279,660,42.27%,24.09%,1
臺東縣,長濱鄉,0158,81,26,107,6,113,336,33.63%,24.11%,1
臺東縣,長濱鄉,0159,44,12,56,8,64,195,32.82%,22.56%,1
臺東縣,長濱鄉,0160,7,2,9,4,13,25,52%,28%,1
臺東縣,長濱鄉,0161,191,59,250,23,273,605,45.12%,31.57%,1
臺東縣,太麻里鄉,0162,255,101,356,30,386,722,53.46%,35.32%,1
臺東縣,太麻里鄉,0163,209,67,276,21,297,575,51.65%,36.35%,1
臺東縣,太麻里鄉,0164,213,78,291,24,315,623,50.56%,34.19%,1
臺東縣,太麻里鄉,0165,209,70,279,24,303,622,48.71%,33.6%,1
臺東縣,太麻里鄉,0166,204,65,269,15,284,560,50.71%,36.43%,1
臺東縣,太麻里鄉,0167,431,120,551,27,578,957,60.4%,45.04%,1
臺東縣,太麻里鄉,0168,274,103,377,34,411,809,50.8%,33.87%,1
臺東縣,太麻里鄉,0169,272,123,395,22,417,673,61.96%,40.42%,1
臺東縣,太麻里鄉,0170,269,87,356,24,380,737,51.56%,36.5%,1
臺東縣,太麻里鄉,0171,169,54,223,19,242,424,57.08%,39.86%,1
臺東縣,太麻里鄉,0172,121,49,170,9,179,374,47.86%,32.35%,1
臺東縣,太麻里鄉,0173,417,115,532,19,551,829,66.47%,50.3%,1
臺東縣,太麻里鄉,0174,408,108,516,12,528,869,60.76%,46.95%,1
臺東縣,太麻里鄉,0175,98,20,118,4,122,223,54.71%,43.95%,1
臺東縣,太麻里鄉,0176,243,92,335,30,365,669,54.56%,36.32%,1
臺東縣,大武鄉,0177,278,62,340,11,351,568,61.8%,48.94%,1
臺東縣,大武鄉,0178,467,201,668,68,736,1474,49.93%,31.68%,1
臺東縣,大武鄉,0179,483,181,664,43,707,1327,53.28%,36.4%,1
臺東縣,大武鄉,0180,339,160,499,43,542,1134,47.8%,29.89%,1
臺東縣,大武鄉,0181,166,47,213,9,222,386,57.51%,43.01%,1
臺東縣,大武鄉,0182,141,61,202,18,220,377,58.36%,37.4%,1
臺東縣,綠島鄉,0183,423,190,613,18,631,1474,42.81%,28.7%,1
臺東縣,綠島鄉,0184,308,145,453,19,472,1082,43.62%,28.47%,1
臺東縣,綠島鄉,0185,247,120,367,14,381,813,46.86%,30.38%,1
臺東縣,綠島鄉,0186,70,34,104,1,105,210,50%,33.33%,1
臺東縣,海端鄉,0187,176,72,248,15,263,497,52.92%,35.41%,1
臺東縣,海端鄉,0188,240,74,314,16,330,569,58%,42.18%,1
臺東縣,海端鄉,0189,337,137,474,14,488,971,50.26%,34.71%,1
臺東縣,海端鄉,0190,275,100,375,19,394,728,54.12%,37.77%,1
臺東縣,海端鄉,0191,88,55,143,7,150,259,57.92%,33.98%,1
臺東縣,海端鄉,0192,99,44,143,5,148,254,58.27%,38.98%,1
臺東縣,延平鄉,0193,376,162,538,21,559,1014,55.13%,37.08%,1
臺東縣,延平鄉,0194,195,87,282,17,299,426,70.19%,45.77%,1
臺東縣,延平鄉,0195,158,41,199,6,205,315,65.08%,50.16%,1
臺東縣,延平鄉,0196,264,92,356,7,363,579,62.69%,45.6%,1
臺東縣,延平鄉,0197,183,80,263,12,275,596,46.14%,30.7%,1
臺東縣,金峰鄉,0198,540,161,701,23,724,1241,58.34%,43.51%,1
臺東縣,金峰鄉,0199,305,117,422,14,436,601,72.55%,50.75%,1
臺東縣,金峰鄉,0200,252,115,367,26,393,520,75.58%,48.46%,1
臺東縣,金峰鄉,0201,132,47,179,8,187,336,55.65%,39.29%,1
臺東縣,金峰鄉,0202,196,52,248,17,265,330,80.3%,59.39%,1
臺東縣,達仁鄉,0203,127,23,150,4,154,246,62.6%,51.63%,1
臺東縣,達仁鄉,0204,183,34,217,8,225,340,66.18%,53.82%,1
臺東縣,達仁鄉,0205,134,52,186,9,195,296,65.88%,45.27%,1
臺東縣,達仁鄉,0206,209,70,279,16,295,429,68.76%,48.72%,1
臺東縣,達仁鄉,0207,179,43,222,11,233,331,70.39%,54.08%,1
臺東縣,達仁鄉,0208,202,90,292,10,302,628,48.09%,32.17%,1
臺東縣,達仁鄉,0209,292,159,451,25,476,867,54.9%,33.68%,1
臺東縣,蘭嶼鄉,0210,240,135,375,20,395,943,41.89%,25.45%,1
臺東縣,蘭嶼鄉,0211,306,194,500,24,524,1238,42.33%,24.72%,1
臺東縣,蘭嶼鄉,0212,307,153,460,13,473,1240,38.15%,24.76%,1
臺東縣,蘭嶼鄉,0213,146,118,264,15,279,760,36.71%,19.21%,1
澎湖縣,馬公市,0001,151,64,215,10,225,481,46.78%,31.39%,1
澎湖縣,馬公市,0002,203,74,277,11,288,558,51.61%,36.38%,1
澎湖縣,馬公市,0003,181,57,238,26,264,533,49.53%,33.96%,1
澎湖縣,馬公市,0004,317,144,461,21,482,922,52.28%,34.38%,1
澎湖縣,馬公市,0005,374,164,538,22,560,1021,54.85%,36.63%,1
澎湖縣,馬公市,0006,253,129,382,22,404,793,50.95%,31.9%,1
澎湖縣,馬公市,0007,343,146,489,24,513,954,53.77%,35.95%,1
澎湖縣,馬公市,0008,338,145,483,21,504,1001,50.35%,33.77%,1
澎湖縣,馬公市,0009,352,161,513,23,536,1192,44.97%,29.53%,1
澎湖縣,馬公市,0010,468,152,620,40,660,1402,47.08%,33.38%,1
澎湖縣,馬公市,0011,524,183,707,22,729,1389,52.48%,37.72%,1
澎湖縣,馬公市,0012,475,197,672,26,698,1339,52.13%,35.47%,1
澎湖縣,馬公市,0013,402,156,558,29,587,1254,46.81%,32.06%,1
澎湖縣,馬公市,0014,423,146,569,32,601,1194,50.34%,35.43%,1
澎湖縣,馬公市,0015,448,184,632,41,673,1393,48.31%,32.16%,1
澎湖縣,馬公市,0016,519,216,735,17,752,1440,52.22%,36.04%,1
澎湖縣,馬公市,0017,370,185,555,43,598,1215,49.22%,30.45%,1
澎湖縣,馬公市,0018,459,137,596,37,633,1284,49.3%,35.75%,1
澎湖縣,馬公市,0019,533,179,712,34,746,1512,49.34%,35.25%,1
澎湖縣,馬公市,0020,365,166,531,37,568,1181,48.09%,30.91%,1
澎湖縣,馬公市,0021,465,186,651,27,678,1348,50.3%,34.5%,1
澎湖縣,馬公市,0022,389,313,702,15,717,1391,51.55%,27.97%,1
澎湖縣,馬公市,0023,293,642,935,8,943,2124,44.4%,13.79%,1
澎湖縣,馬公市,0024,531,186,717,26,743,1500,49.53%,35.4%,1
澎湖縣,馬公市,0025,577,179,756,24,780,1582,49.3%,36.47%,1
澎湖縣,馬公市,0026,561,216,777,22,799,1638,48.78%,34.25%,1
澎湖縣,馬公市,0027,551,233,784,33,817,1554,52.57%,35.46%,1
澎湖縣,馬公市,0028,262,106,368,16,384,980,39.18%,26.73%,1
澎湖縣,馬公市,0029,307,124,431,20,451,892,50.56%,34.42%,1
澎湖縣,馬公市,0030,218,93,311,11,322,778,41.39%,28.02%,1
澎湖縣,馬公市,0031,326,130,456,23,479,930,51.51%,35.05%,1
澎湖縣,馬公市,0032,617,223,840,23,863,1481,58.27%,41.66%,1
澎湖縣,馬公市,0033,434,155,589,16,605,1128,53.63%,38.48%,1
澎湖縣,馬公市,0034,171,42,213,16,229,415,55.18%,41.2%,1
澎湖縣,馬公市,0035,399,137,536,23,559,1120,49.91%,35.63%,1
澎湖縣,馬公市,0036,375,122,497,19,516,950,54.32%,39.47%,1
澎湖縣,馬公市,0037,190,74,264,17,281,627,44.82%,30.3%,1
澎湖縣,馬公市,0038,386,146,532,20,552,1055,52.32%,36.59%,1
澎湖縣,馬公市,0039,373,111,484,36,520,989,52.58%,37.71%,1
澎湖縣,馬公市,0040,205,93,298,33,331,591,56.01%,34.69%,1
澎湖縣,馬公市,0041,443,167,610,52,662,1387,47.73%,31.94%,1
澎湖縣,馬公市,0042,298,130,428,44,472,1079,43.74%,27.62%,1
澎湖縣,馬公市,0043,288,86,374,32,406,797,50.94%,36.14%,1
澎湖縣,馬公市,0044,302,107,409,21,430,903,47.62%,33.44%,1
澎湖縣,馬公市,0045,101,59,160,15,175,376,46.54%,26.86%,1
澎湖縣,馬公市,0046,112,69,181,14,195,371,52.56%,30.19%,1
澎湖縣,馬公市,0047,354,118,472,23,495,1173,42.2%,30.18%,1
澎湖縣,馬公市,0048,369,135,504,22,526,1389,37.87%,26.57%,1
澎湖縣,馬公市,0049,140,49,189,25,214,761,28.12%,18.4%,1
澎湖縣,馬公市,0050,116,47,163,15,178,288,61.81%,40.28%,1
澎湖縣,湖西鄉,0051,418,135,553,30,583,1120,52.05%,37.32%,1
澎湖縣,湖西鄉,0052,97,36,133,8,141,332,42.47%,29.22%,1
澎湖縣,湖西鄉,0053,71,21,92,2,94,242,38.84%,29.34%,1
澎湖縣,湖西鄉,0054,75,34,109,6,115,293,39.25%,25.6%,1
澎湖縣,湖西鄉,0055,173,73,246,30,276,666,41.44%,25.98%,1
澎湖縣,湖西鄉,0056,109,38,147,16,163,326,50%,33.44%,1
澎湖縣,湖西鄉,0057,203,79,282,16,298,732,40.71%,27.73%,1
澎湖縣,湖西鄉,0058,216,73,289,11,300,651,46.08%,33.18%,1
澎湖縣,湖西鄉,0059,235,88,323,14,337,744,45.3%,31.59%,1
澎湖縣,湖西鄉,0060,55,16,71,2,73,134,54.48%,41.04%,1
澎湖縣,湖西鄉,0061,190,91,281,17,298,794,37.53%,23.93%,1
澎湖縣,湖西鄉,0062,59,16,75,3,78,216,36.11%,27.31%,1
澎湖縣,湖西鄉,0063,139,46,185,12,197,664,29.67%,20.93%,1
澎湖縣,湖西鄉,0064,96,26,122,12,134,279,48.03%,34.41%,1
澎湖縣,湖西鄉,0065,124,27,151,3,154,296,52.03%,41.89%,1
澎湖縣,湖西鄉,0066,82,38,120,1,121,257,47.08%,31.91%,1
澎湖縣,湖西鄉,0067,20,7,27,2,29,89,32.58%,22.47%,1
澎湖縣,湖西鄉,0068,263,119,382,17,399,815,48.96%,32.27%,1
澎湖縣,湖西鄉,0069,270,113,383,15,398,975,40.82%,27.69%,1
澎湖縣,湖西鄉,0070,213,85,298,24,322,648,49.69%,32.87%,1
澎湖縣,湖西鄉,0071,263,108,371,19,390,893,43.67%,29.45%,1
澎湖縣,湖西鄉,0072,280,107,387,51,438,846,51.77%,33.1%,1
澎湖縣,湖西鄉,0073,204,80,284,8,292,729,40.05%,27.98%,1
澎湖縣,白沙鄉,0074,173,71,244,12,256,514,49.81%,33.66%,1
澎湖縣,白沙鄉,0075,227,104,331,9,340,657,51.75%,34.55%,1
澎湖縣,白沙鄉,0076,54,14,68,4,72,109,66.06%,49.54%,1
澎湖縣,白沙鄉,0077,44,22,66,3,69,156,44.23%,28.21%,1
澎湖縣,白沙鄉,0078,77,41,118,4,122,293,41.64%,26.28%,1
澎湖縣,白沙鄉,0079,46,22,68,4,72,231,31.17%,19.91%,1
澎湖縣,白沙鄉,0080,57,25,82,6,88,161,54.66%,35.4%,1
澎湖縣,白沙鄉,0081,536,221,757,33,790,1705,46.33%,31.44%,1
澎湖縣,白沙鄉,0082,90,29,119,8,127,285,44.56%,31.58%,1
澎湖縣,白沙鄉,0083,152,65,217,13,230,723,31.81%,21.02%,1
澎湖縣,白沙鄉,0084,185,76,261,25,286,774,36.95%,23.9%,1
澎湖縣,白沙鄉,0085,352,118,470,50,520,1429,36.39%,24.63%,1
澎湖縣,白沙鄉,0086,377,90,467,41,508,1084,46.86%,34.78%,1
澎湖縣,白沙鄉,0087,86,33,119,7,126,251,50.2%,34.26%,1
澎湖縣,白沙鄉,0088,50,30,80,11,91,253,35.97%,19.76%,1
澎湖縣,西嶼鄉,0089,30,20,50,1,51,283,18.02%,10.6%,1
澎湖縣,西嶼鄉,0090,71,40,111,10,121,424,28.54%,16.75%,1
澎湖縣,西嶼鄉,0091,180,76,256,36,292,826,35.35%,21.79%,1
澎湖縣,西嶼鄉,0092,67,33,100,9,109,282,38.65%,23.76%,1
澎湖縣,西嶼鄉,0093,148,88,236,28,264,661,39.94%,22.39%,1
澎湖縣,西嶼鄉,0094,15,13,28,2,30,141,21.28%,10.64%,1
澎湖縣,西嶼鄉,0095,154,40,194,8,202,635,31.81%,24.25%,1
澎湖縣,西嶼鄉,0096,60,12,72,3,75,216,34.72%,27.78%,1
澎湖縣,西嶼鄉,0097,96,28,124,15,139,572,24.3%,16.78%,1
澎湖縣,西嶼鄉,0098,330,117,447,68,515,1267,40.65%,26.05%,1
澎湖縣,西嶼鄉,0099,214,76,290,22,312,942,33.12%,22.72%,1
澎湖縣,西嶼鄉,0100,255,135,390,50,440,1133,38.83%,22.51%,1
澎湖縣,望安鄉,0101,203,105,308,23,331,734,45.1%,27.66%,1
澎湖縣,望安鄉,0102,142,38,180,10,190,454,41.85%,31.28%,1
澎湖縣,望安鄉,0103,80,29,109,4,113,300,37.67%,26.67%,1
澎湖縣,望安鄉,0104,146,63,209,29,238,471,50.53%,31%,1
澎湖縣,望安鄉,0105,169,70,239,7,246,672,36.61%,25.15%,1
澎湖縣,望安鄉,0106,230,68,298,16,314,742,42.32%,31%,1
澎湖縣,望安鄉,0107,77,30,107,4,111,264,42.05%,29.17%,1
澎湖縣,望安鄉,0108,133,76,209,5,214,476,44.96%,27.94%,1
澎湖縣,望安鄉,0109,33,27,60,2,62,208,29.81%,15.87%,1
澎湖縣,望安鄉,0110,57,29,86,5,91,307,29.64%,18.57%,1
澎湖縣,七美鄉,0111,41,18,59,7,66,248,26.61%,16.53%,1
澎湖縣,七美鄉,0112,129,61,190,14,204,581,35.11%,22.2%,1
澎湖縣,七美鄉,0113,126,83,209,19,228,641,35.57%,19.66%,1
澎湖縣,七美鄉,0114,91,27,118,3,121,382,31.68%,23.82%,1
澎湖縣,七美鄉,0115,57,27,84,2,86,351,24.5%,16.24%,1
澎湖縣,七美鄉,0116,200,109,309,13,322,1171,27.5%,17.08%,1
金門縣,金城鎮,0001,359,114,473,25,498,1396,35.67%,25.72%,1
金門縣,金城鎮,0002,510,166,676,20,696,1831,38.01%,27.85%,1
金門縣,金城鎮,0003,455,153,608,33,641,1750,36.63%,26%,1
金門縣,金城鎮,0004,496,165,661,57,718,1889,38.01%,26.26%,1
金門縣,金城鎮,0005,350,160,510,26,536,1675,32%,20.9%,1
金門縣,金城鎮,0006,583,171,754,26,780,1901,41.03%,30.67%,1
金門縣,金城鎮,0007,365,152,517,41,558,1610,34.66%,22.67%,1
金門縣,金城鎮,0008,424,153,577,29,606,1687,35.92%,25.13%,1
金門縣,金城鎮,0009,436,128,564,17,581,1594,36.45%,27.35%,1
金門縣,金城鎮,0010,417,179,596,18,614,1726,35.57%,24.16%,1
金門縣,金城鎮,0011,462,146,608,23,631,1733,36.41%,26.66%,1
金門縣,金城鎮,0012,447,160,607,18,625,1532,40.8%,29.18%,1
金門縣,金城鎮,0013,501,189,690,37,727,2079,34.97%,24.1%,1
金門縣,金城鎮,0014,457,168,625,29,654,2033,32.17%,22.48%,1
金門縣,金城鎮,0015,606,235,841,42,883,2517,35.08%,24.08%,1
金門縣,金城鎮,0016,520,167,687,39,726,2083,34.85%,24.96%,1
金門縣,金城鎮,0017,535,162,697,40,737,2140,34.44%,25%,1
金門縣,金城鎮,0018,500,183,683,29,712,2435,29.24%,20.53%,1
金門縣,金城鎮,0019,238,78,316,30,346,1353,25.57%,17.59%,1
金門縣,金城鎮,0020,374,106,480,16,496,1574,31.51%,23.76%,1
金門縣,金城鎮,0021,338,112,450,31,481,1277,37.67%,26.47%,1
金門縣,金沙鎮,0066,478,141,619,37,656,1909,34.36%,25.04%,1
金門縣,金沙鎮,0067,460,134,594,31,625,1524,41.01%,30.18%,1
金門縣,金沙鎮,0068,409,114,523,24,547,1673,32.7%,24.45%,1
金門縣,金沙鎮,0069,513,111,624,36,660,2003,32.95%,25.61%,1
金門縣,金沙鎮,0070,354,118,472,23,495,1212,40.84%,29.21%,1
金門縣,金沙鎮,0071,287,94,381,29,410,1126,36.41%,25.49%,1
金門縣,金沙鎮,0072,352,99,451,28,479,1540,31.1%,22.86%,1
金門縣,金沙鎮,0073,272,83,355,21,376,1216,30.92%,22.37%,1
金門縣,金沙鎮,0074,193,54,247,12,259,950,27.26%,20.32%,1
金門縣,金沙鎮,0075,539,127,666,35,701,1895,36.99%,28.44%,1
金門縣,金沙鎮,0076,336,96,432,32,464,1135,40.88%,29.6%,1
金門縣,金沙鎮,0077,317,100,417,21,438,1252,34.98%,25.32%,1
金門縣,金沙鎮,0078,346,96,442,21,463,1125,41.16%,30.76%,1
金門縣,金湖鎮,0049,376,142,518,22,540,1348,40.06%,27.89%,1
金門縣,金湖鎮,0050,312,142,454,30,484,1386,34.92%,22.51%,1
金門縣,金湖鎮,0051,436,133,569,36,605,1403,43.12%,31.08%,1
金門縣,金湖鎮,0052,488,154,642,33,675,1771,38.11%,27.56%,1
金門縣,金湖鎮,0053,362,162,524,34,558,1493,37.37%,24.25%,1
金門縣,金湖鎮,0054,365,129,494,40,534,1510,35.36%,24.17%,1
金門縣,金湖鎮,0055,436,133,569,40,609,1607,37.9%,27.13%,1
金門縣,金湖鎮,0056,479,151,630,37,667,2006,33.25%,23.88%,1
金門縣,金湖鎮,0057,431,186,617,26,643,1780,36.12%,24.21%,1
金門縣,金湖鎮,0058,441,179,620,15,635,1739,36.52%,25.36%,1
金門縣,金湖鎮,0059,345,111,456,23,479,1384,34.61%,24.93%,1
金門縣,金湖鎮,0060,366,138,504,24,528,1400,37.71%,26.14%,1
金門縣,金湖鎮,0061,440,129,569,16,585,1325,44.15%,33.21%,1
金門縣,金湖鎮,0062,300,97,397,19,416,1236,33.66%,24.27%,1
金門縣,金湖鎮,0063,336,116,452,31,483,1382,34.95%,24.31%,1
金門縣,金湖鎮,0064,421,125,546,14,560,1631,34.33%,25.81%,1
金門縣,金湖鎮,0065,342,106,448,45,493,1514,32.56%,22.59%,1
金門縣,金寧鄉,0022,380,121,501,40,541,1735,31.18%,21.9%,1
金門縣,金寧鄉,0023,345,116,461,25,486,1537,31.62%,22.45%,1
金門縣,金寧鄉,0024,379,187,566,28,594,1766,33.64%,21.46%,1
金門縣,金寧鄉,0025,271,88,359,16,375,1015,36.95%,26.7%,1
金門縣,金寧鄉,0026,466,123,589,33,622,1726,36.04%,27%,1
金門縣,金寧鄉,0027,391,128,519,21,540,1691,31.93%,23.12%,1
金門縣,金寧鄉,0028,321,517,838,28,866,2044,42.37%,15.7%,1
金門縣,金寧鄉,0029,536,207,743,21,764,1848,41.34%,29%,1
金門縣,金寧鄉,0030,442,146,588,25,613,1735,35.33%,25.48%,1
金門縣,金寧鄉,0031,431,164,595,32,627,1795,34.93%,24.01%,1
金門縣,金寧鄉,0032,412,133,545,36,581,1834,31.68%,22.46%,1
金門縣,金寧鄉,0033,348,134,482,28,510,1528,33.38%,22.77%,1
金門縣,金寧鄉,0034,418,127,545,23,568,1473,38.56%,28.38%,1
金門縣,金寧鄉,0035,426,147,573,28,601,1679,35.8%,25.37%,1
金門縣,金寧鄉,0036,265,661,926,7,933,1921,48.57%,13.79%,1
金門縣,金寧鄉,0037,308,148,456,12,468,1298,36.06%,23.73%,1
金門縣,金寧鄉,0038,361,113,474,32,506,1537,32.92%,23.49%,1
金門縣,烈嶼鄉,0039,527,158,685,37,722,1647,43.84%,32%,1
金門縣,烈嶼鄉,0040,454,128,582,35,617,1733,35.6%,26.2%,1
金門縣,烈嶼鄉,0041,430,147,577,30,607,1635,37.13%,26.3%,1
金門縣,烈嶼鄉,0042,313,109,422,18,440,1296,33.95%,24.15%,1
金門縣,烈嶼鄉,0043,257,75,332,23,355,1099,32.3%,23.38%,1
金門縣,烈嶼鄉,0044,339,114,453,31,484,1425,33.96%,23.79%,1
金門縣,烈嶼鄉,0045,375,126,501,24,525,1412,37.18%,26.56%,1
金門縣,烈嶼鄉,0046,368,108,476,29,505,1429,35.34%,25.75%,1
金門縣,烏坵鄉,0047,55,20,75,3,78,275,28.36%,20%,1
金門縣,烏坵鄉,0048,70,14,84,3,87,292,29.79%,23.97%,1
連江縣,南竿鄉,0001,698,273,971,43,1014,1967,51.55%,35.49%,1
連江縣,南竿鄉,0002,646,207,853,31,884,1837,48.12%,35.17%,1
連江縣,南竿鄉,0003,427,148,575,12,587,1114,52.69%,38.33%,1
連江縣,南竿鄉,0004,614,168,782,18,800,1543,51.85%,39.79%,1
連江縣,北竿鄉,0005,588,199,787,27,814,1515,53.73%,38.81%,1
連江縣,北竿鄉,0006,214,71,285,11,296,610,48.52%,35.08%,1
連江縣,莒光鄉,0007,227,108,335,15,350,698,50.14%,32.52%,1
連江縣,莒光鄉,0008,317,117,434,22,456,783,58.24%,40.49%,1
連江縣,東引鄉,0009,400,170,570,16,586,1138,51.49%,35.15%,1
基隆市,中正區,0001,165,80,245,17,262,466,56.22%,35.41%,1
基隆市,中正區,0002,353,185,538,19,557,1262,44.14%,27.97%,1
基隆市,中正區,0003,349,169,518,42,560,1171,47.82%,29.8%,1
基隆市,中正區,0004,744,319,1063,14,1077,2823,38.15%,26.35%,1
基隆市,中正區,0005,420,198,618,41,659,1474,44.71%,28.49%,1
基隆市,中正區,0006,329,179,508,48,556,1271,43.75%,25.89%,1
基隆市,中正區,0007,792,350,1142,31,1173,2707,43.33%,29.26%,1
基隆市,中正區,0008,473,212,685,64,749,1545,48.48%,30.61%,1
基隆市,中正區,0009,223,84,307,15,322,761,42.31%,29.3%,1
基隆市,中正區,0010,412,230,642,15,657,1352,48.59%,30.47%,1
基隆市,中正區,0011,459,189,648,15,663,1413,46.92%,32.48%,1
基隆市,中正區,0012,762,352,1114,33,1147,2665,43.04%,28.59%,1
基隆市,中正區,0013,397,168,565,40,605,1261,47.98%,31.48%,1
基隆市,中正區,0014,561,275,836,53,889,1753,50.71%,32%,1
基隆市,中正區,0015,286,133,419,28,447,984,45.43%,29.07%,1
基隆市,中正區,0016,410,136,546,25,571,1166,48.97%,35.16%,1
基隆市,中正區,0017,296,166,462,15,477,973,49.02%,30.42%,1
基隆市,中正區,0018,389,230,619,20,639,1694,37.72%,22.96%,1
基隆市,中正區,0019,399,203,602,35,637,1270,50.16%,31.42%,1
基隆市,中正區,0020,392,168,560,19,579,1090,53.12%,35.96%,1
基隆市,中正區,0021,298,152,450,20,470,870,54.02%,34.25%,1
基隆市,中正區,0022,345,195,540,34,574,1138,50.44%,30.32%,1
基隆市,中正區,0023,282,119,401,23,424,862,49.19%,32.71%,1
基隆市,中正區,0024,461,232,693,47,740,1341,55.18%,34.38%,1
基隆市,中正區,0025,293,149,442,38,480,859,55.88%,34.11%,1
基隆市,中正區,0026,435,211,646,29,675,1457,46.33%,29.86%,1
基隆市,中正區,0027,427,197,624,30,654,1594,41.03%,26.79%,1
基隆市,中正區,0028,270,125,395,34,429,802,53.49%,33.67%,1
基隆市,中正區,0029,410,179,589,32,621,1267,49.01%,32.36%,1
基隆市,中正區,0030,364,218,582,47,629,1175,53.53%,30.98%,1
基隆市,中正區,0031,443,202,645,39,684,1210,56.53%,36.61%,1
基隆市,中正區,0032,338,181,519,33,552,1037,53.23%,32.59%,1
基隆市,中正區,0033,408,194,602,41,643,1219,52.75%,33.47%,1
基隆市,中正區,0034,301,147,448,26,474,904,52.43%,33.3%,1
基隆市,中正區,0035,278,143,421,24,445,709,62.76%,39.21%,1
基隆市,七堵區,0219,486,189,675,41,716,1258,56.92%,38.63%,1
基隆市,七堵區,0220,456,202,658,36,694,1237,56.1%,36.86%,1
基隆市,七堵區,0221,422,229,651,17,668,1259,53.06%,33.52%,1
基隆市,七堵區,0222,368,176,544,35,579,1120,51.7%,32.86%,1
基隆市,七堵區,0223,415,192,607,26,633,1344,47.1%,30.88%,1
基隆市,七堵區,0224,402,192,594,27,621,1011,61.42%,39.76%,1
基隆市,七堵區,0225,334,162,496,11,507,925,54.81%,36.11%,1
基隆市,七堵區,0226,663,270,933,42,975,1735,56.2%,38.21%,1
基隆市,七堵區,0227,654,332,986,52,1038,1833,56.63%,35.68%,1
基隆市,七堵區,0228,345,175,520,15,535,938,57.04%,36.78%,1
基隆市,七堵區,0229,367,178,545,29,574,962,59.67%,38.15%,1
基隆市,七堵區,0230,442,217,659,19,678,1191,56.93%,37.11%,1
基隆市,七堵區,0231,397,163,560,18,578,999,57.86%,39.74%,1
基隆市,七堵區,0232,88,43,131,8,139,282,49.29%,31.21%,1
基隆市,七堵區,0233,389,216,605,35,640,1243,51.49%,31.3%,1
基隆市,七堵區,0234,374,176,550,35,585,1092,53.57%,34.25%,1
基隆市,七堵區,0235,424,221,645,26,671,1246,53.85%,34.03%,1
基隆市,七堵區,0236,542,282,824,43,867,1722,50.35%,31.48%,1
基隆市,七堵區,0237,469,220,689,25,714,1318,54.17%,35.58%,1
基隆市,七堵區,0238,324,138,462,17,479,975,49.13%,33.23%,1
基隆市,七堵區,0239,421,227,648,28,676,1285,52.61%,32.76%,1
基隆市,七堵區,0240,322,164,486,35,521,1077,48.38%,29.9%,1
基隆市,七堵區,0241,307,144,451,20,471,989,47.62%,31.04%,1
基隆市,七堵區,0242,372,199,571,27,598,1193,50.13%,31.18%,1
基隆市,七堵區,0243,424,215,639,28,667,1273,52.4%,33.31%,1
基隆市,七堵區,0244,627,283,910,46,956,1774,53.89%,35.34%,1
基隆市,七堵區,0245,572,298,870,41,911,1689,53.94%,33.87%,1
基隆市,七堵區,0246,444,215,659,36,695,1355,51.29%,32.77%,1
基隆市,七堵區,0247,440,290,730,36,766,1512,50.66%,29.1%,1
基隆市,七堵區,0248,467,242,709,21,730,1486,49.13%,31.43%,1
基隆市,七堵區,0249,564,277,841,23,864,1706,50.64%,33.06%,1
基隆市,七堵區,0250,487,243,730,31,761,1384,54.99%,35.19%,1
基隆市,七堵區,0251,414,196,610,24,634,1045,60.67%,39.62%,1
基隆市,七堵區,0252,464,248,712,23,735,1374,53.49%,33.77%,1
基隆市,七堵區,0253,157,69,226,6,232,428,54.21%,36.68%,1
基隆市,七堵區,0254,120,65,185,14,199,326,61.04%,36.81%,1
基隆市,七堵區,0255,173,64,237,14,251,351,71.51%,49.29%,1
基隆市,七堵區,0256,568,287,855,26,881,1871,47.09%,30.36%,1
基隆市,七堵區,0257,163,62,225,8,233,448,52.01%,36.38%,1
基隆市,暖暖區,0191,447,234,681,27,708,1431,49.48%,31.24%,1
基隆市,暖暖區,0192,162,75,237,7,244,456,53.51%,35.53%,1
基隆市,暖暖區,0193,227,117,344,20,364,637,57.14%,35.64%,1
基隆市,暖暖區,0194,290,131,421,22,443,735,60.27%,39.46%,1
基隆市,暖暖區,0195,358,151,509,22,531,1078,49.26%,33.21%,1
基隆市,暖暖區,0196,370,232,602,31,633,1238,51.13%,29.89%,1
基隆市,暖暖區,0197,424,238,662,12,674,1325,50.87%,32%,1
基隆市,暖暖區,0198,604,275,879,17,896,1475,60.75%,40.95%,1
基隆市,暖暖區,0199,363,193,556,18,574,1179,48.69%,30.79%,1
基隆市,暖暖區,0200,414,214,628,33,661,1110,59.55%,37.3%,1
基隆市,暖暖區,0201,446,219,665,19,684,1443,47.4%,30.91%,1
基隆市,暖暖區,0202,143,71,214,12,226,415,54.46%,34.46%,1
基隆市,暖暖區,0203,429,250,679,17,696,1378,50.51%,31.13%,1
基隆市,暖暖區,0204,522,274,796,24,820,1570,52.23%,33.25%,1
基隆市,暖暖區,0205,592,297,889,46,935,1603,58.33%,36.93%,1
基隆市,暖暖區,0206,468,230,698,31,729,1267,57.54%,36.94%,1
基隆市,暖暖區,0207,463,228,691,27,718,1359,52.83%,34.07%,1
基隆市,暖暖區,0208,393,157,550,24,574,970,59.18%,40.52%,1
基隆市,暖暖區,0209,356,167,523,13,536,1002,53.49%,35.53%,1
基隆市,暖暖區,0210,306,163,469,21,490,944,51.91%,32.42%,1
基隆市,暖暖區,0211,543,286,829,20,849,1500,56.6%,36.2%,1
基隆市,暖暖區,0212,393,187,580,20,600,1442,41.61%,27.25%,1
基隆市,暖暖區,0213,414,215,629,6,635,1165,54.51%,35.54%,1
基隆市,暖暖區,0214,536,266,802,22,824,1610,51.18%,33.29%,1
基隆市,暖暖區,0215,467,252,719,20,739,1328,55.65%,35.17%,1
基隆市,暖暖區,0216,411,211,622,7,629,1173,53.62%,35.04%,1
基隆市,暖暖區,0217,363,217,580,26,606,1019,59.47%,35.62%,1
基隆市,暖暖區,0218,490,247,737,11,748,1373,54.48%,35.69%,1
基隆市,仁愛區,0072,525,131,656,79,735,1782,41.25%,29.46%,1
基隆市,仁愛區,0073,383,191,574,22,596,1055,56.49%,36.3%,1
基隆市,仁愛區,0074,500,224,724,25,749,1558,48.07%,32.09%,1
基隆市,仁愛區,0075,628,252,880,28,908,1736,52.3%,36.18%,1
基隆市,仁愛區,0076,488,227,715,18,733,1243,58.97%,39.26%,1
基隆市,仁愛區,0077,407,193,600,27,627,1109,56.54%,36.7%,1
基隆市,仁愛區,0078,644,272,916,46,962,1684,57.13%,38.24%,1
基隆市,仁愛區,0079,308,179,487,25,512,919,55.71%,33.51%,1
基隆市,仁愛區,0080,311,188,499,14,513,991,51.77%,31.38%,1
基隆市,仁愛區,0081,315,164,479,8,487,876,55.59%,35.96%,1
基隆市,仁愛區,0082,385,198,583,30,613,1046,58.6%,36.81%,1
基隆市,仁愛區,0083,179,73,252,11,263,434,60.6%,41.24%,1
基隆市,仁愛區,0084,283,141,424,29,453,764,59.29%,37.04%,1
基隆市,仁愛區,0085,323,166,489,18,507,968,52.38%,33.37%,1
基隆市,仁愛區,0086,408,229,637,48,685,1326,51.66%,30.77%,1
基隆市,仁愛區,0087,349,188,537,38,575,1315,43.73%,26.54%,1
基隆市,仁愛區,0088,300,118,418,32,450,775,58.06%,38.71%,1
基隆市,仁愛區,0089,226,124,350,25,375,652,57.52%,34.66%,1
基隆市,仁愛區,0090,234,125,359,20,379,674,56.23%,34.72%,1
基隆市,仁愛區,0091,266,122,388,24,412,789,52.22%,33.71%,1
基隆市,仁愛區,0092,584,275,859,43,902,1715,52.59%,34.05%,1
基隆市,仁愛區,0093,285,145,430,33,463,849,54.53%,33.57%,1
基隆市,仁愛區,0094,330,140,470,23,493,875,56.34%,37.71%,1
基隆市,仁愛區,0095,272,136,408,26,434,851,51%,31.96%,1
基隆市,仁愛區,0096,271,131,402,25,427,735,58.1%,36.87%,1
基隆市,仁愛區,0097,332,164,496,42,538,1009,53.32%,32.9%,1
基隆市,仁愛區,0098,332,175,507,34,541,1082,50%,30.68%,1
基隆市,仁愛區,0099,403,223,626,39,665,1278,52.03%,31.53%,1
基隆市,仁愛區,0100,604,237,841,30,871,1519,57.34%,39.76%,1
基隆市,仁愛區,0101,359,219,578,26,604,1336,45.21%,26.87%,1
基隆市,仁愛區,0102,479,199,678,33,711,1178,60.36%,40.66%,1
基隆市,仁愛區,0103,231,125,356,23,379,708,53.53%,32.63%,1
基隆市,仁愛區,0104,227,112,339,17,356,567,62.79%,40.04%,1
基隆市,仁愛區,0105,223,152,375,42,417,751,55.53%,29.69%,1
基隆市,仁愛區,0106,194,143,337,17,354,589,60.1%,32.94%,1
基隆市,中山區,0107,279,124,403,22,425,796,53.39%,35.05%,1
基隆市,中山區,0108,420,195,615,28,643,1036,62.07%,40.54%,1
基隆市,中山區,0109,298,125,423,19,442,756,58.47%,39.42%,1
基隆市,中山區,0110,277,180,457,19,476,957,49.74%,28.94%,1
基隆市,中山區,0111,282,140,422,10,432,802,53.87%,35.16%,1
基隆市,中山區,0112,432,205,637,40,677,1263,53.6%,34.2%,1
基隆市,中山區,0113,297,136,433,15,448,778,57.58%,38.17%,1
基隆市,中山區,0114,406,201,607,54,661,1180,56.02%,34.41%,1
基隆市,中山區,0115,330,139,469,20,489,990,49.39%,33.33%,1
基隆市,中山區,0116,373,173,546,28,574,1332,43.09%,28%,1
基隆市,中山區,0117,240,139,379,27,406,848,47.88%,28.3%,1
基隆市,中山區,0118,307,123,430,23,453,922,49.13%,33.3%,1
基隆市,中山區,0119,182,78,260,13,273,459,59.48%,39.65%,1
基隆市,中山區,0120,196,73,269,22,291,574,50.7%,34.15%,1
基隆市,中山區,0121,264,158,422,33,455,877,51.88%,30.1%,1
基隆市,中山區,0122,436,251,687,23,710,1584,44.82%,27.53%,1
基隆市,中山區,0123,335,143,478,21,499,1319,37.83%,25.4%,1
基隆市,中山區,0124,629,315,944,46,990,1938,51.08%,32.46%,1
基隆市,中山區,0125,568,319,887,25,912,1877,48.59%,30.26%,1
基隆市,中山區,0126,737,346,1083,39,1122,2088,53.74%,35.3%,1
基隆市,中山區,0127,689,343,1032,21,1053,1946,54.11%,35.41%,1
基隆市,中山區,0128,488,233,721,45,766,1353,56.61%,36.07%,1
基隆市,中山區,0129,442,210,652,40,692,1317,52.54%,33.56%,1
基隆市,中山區,0130,292,187,479,17,496,870,57.01%,33.56%,1
基隆市,中山區,0131,464,239,703,18,721,1322,54.54%,35.1%,1
基隆市,中山區,0132,385,214,599,17,616,1295,47.57%,29.73%,1
基隆市,中山區,0133,300,138,438,22,460,756,60.85%,39.68%,1
基隆市,中山區,0134,477,247,724,21,745,1602,46.5%,29.78%,1
基隆市,中山區,0135,509,221,730,24,754,1568,48.09%,32.46%,1
基隆市,中山區,0136,461,249,710,27,737,1404,52.49%,32.83%,1
基隆市,中山區,0137,639,279,918,22,940,1909,49.24%,33.47%,1
基隆市,中山區,0138,473,234,707,57,764,1642,46.53%,28.81%,1
基隆市,中山區,0139,310,156,466,16,482,932,51.72%,33.26%,1
基隆市,中山區,0140,349,146,495,25,520,849,61.25%,41.11%,1
基隆市,中山區,0141,229,165,394,34,428,715,59.86%,32.03%,1
基隆市,安樂區,0142,416,204,620,47,667,1361,49.01%,30.57%,1
基隆市,安樂區,0143,409,181,590,17,607,1213,50.04%,33.72%,1
基隆市,安樂區,0144,328,121,449,18,467,1026,45.52%,31.97%,1
基隆市,安樂區,0145,404,169,573,56,629,1038,60.6%,38.92%,1
基隆市,安樂區,0146,399,80,479,38,517,897,57.64%,44.48%,1
基隆市,安樂區,0147,487,231,718,31,749,1401,53.46%,34.76%,1
基隆市,安樂區,0148,154,76,230,12,242,641,37.75%,24.02%,1
基隆市,安樂區,0149,465,247,712,38,750,1472,50.95%,31.59%,1
基隆市,安樂區,0150,162,86,248,15,263,472,55.72%,34.32%,1
基隆市,安樂區,0151,338,149,487,18,505,841,60.05%,40.19%,1
基隆市,安樂區,0152,182,104,286,25,311,571,54.47%,31.87%,1
基隆市,安樂區,0153,617,316,933,32,965,1901,50.76%,32.46%,1
基隆市,安樂區,0154,431,221,652,46,698,1349,51.74%,31.95%,1
基隆市,安樂區,0155,426,175,601,27,628,1225,51.27%,34.78%,1
基隆市,安樂區,0156,475,232,707,42,749,1351,55.44%,35.16%,1
基隆市,安樂區,0157,559,325,884,26,910,1601,56.84%,34.92%,1
基隆市,安樂區,0158,866,358,1224,36,1260,2513,50.14%,34.46%,1
基隆市,安樂區,0159,559,279,838,34,872,1613,54.06%,34.66%,1
基隆市,安樂區,0160,621,299,920,25,945,1731,54.59%,35.88%,1
基隆市,安樂區,0161,526,301,827,20,847,1424,59.48%,36.94%,1
基隆市,安樂區,0162,608,266,874,37,911,1806,50.44%,33.67%,1
基隆市,安樂區,0163,610,283,893,42,935,1679,55.69%,36.33%,1
基隆市,安樂區,0164,648,343,991,21,1012,1902,53.21%,34.07%,1
基隆市,安樂區,0165,563,451,1014,30,1044,2040,51.18%,27.6%,1
基隆市,安樂區,0166,462,208,670,35,705,1313,53.69%,35.19%,1
基隆市,安樂區,0167,407,201,608,17,625,1243,50.28%,32.74%,1
基隆市,安樂區,0168,563,319,882,22,904,1759,51.39%,32.01%,1
基隆市,安樂區,0169,261,165,426,12,438,694,63.11%,37.61%,1
基隆市,安樂區,0170,326,212,538,13,551,866,63.63%,37.64%,1
基隆市,安樂區,0171,419,236,655,25,680,1557,43.67%,26.91%,1
基隆市,安樂區,0172,459,235,694,26,720,1411,51.03%,32.53%,1
基隆市,安樂區,0173,580,293,873,19,892,1568,56.89%,36.99%,1
基隆市,安樂區,0174,458,239,697,28,725,1400,51.79%,32.71%,1
基隆市,安樂區,0175,535,252,787,8,795,1531,51.93%,34.94%,1
基隆市,安樂區,0176,545,257,802,13,815,1673,48.71%,32.58%,1
基隆市,安樂區,0177,367,168,535,27,562,1054,53.32%,34.82%,1
基隆市,安樂區,0178,527,274,801,24,825,1923,42.9%,27.41%,1
基隆市,安樂區,0179,703,315,1018,35,1053,1960,53.72%,35.87%,1
基隆市,安樂區,0180,629,305,934,46,980,1962,49.95%,32.06%,1
基隆市,安樂區,0181,715,349,1064,36,1100,2117,51.96%,33.77%,1
基隆市,安樂區,0182,550,308,858,35,893,1829,48.82%,30.07%,1
基隆市,安樂區,0183,487,233,720,19,739,1529,48.33%,31.85%,1
基隆市,安樂區,0184,610,327,937,15,952,1869,50.94%,32.64%,1
基隆市,安樂區,0185,415,210,625,9,634,1140,55.61%,36.4%,1
基隆市,安樂區,0186,511,299,810,30,840,1641,51.19%,31.14%,1
基隆市,安樂區,0187,427,208,635,29,664,1279,51.92%,33.39%,1
基隆市,安樂區,0188,352,230,582,18,600,1360,44.12%,25.88%,1
基隆市,安樂區,0189,458,281,739,27,766,1399,54.75%,32.74%,1
基隆市,安樂區,0190,405,228,633,18,651,1251,52.04%,32.37%,1
基隆市,信義區,0036,381,202,583,36,619,1096,56.48%,34.76%,1
基隆市,信義區,0037,463,253,716,24,740,1232,60.06%,37.58%,1
基隆市,信義區,0038,418,226,644,28,672,1184,56.76%,35.3%,1
基隆市,信義區,0039,452,183,635,32,667,1133,58.87%,39.89%,1
基隆市,信義區,0040,444,201,645,21,666,1188,56.06%,37.37%,1
基隆市,信義區,0041,282,124,406,21,427,725,58.9%,38.9%,1
基隆市,信義區,0042,472,218,690,34,724,1524,47.51%,30.97%,1
基隆市,信義區,0043,252,147,399,20,419,736,56.93%,34.24%,1
基隆市,信義區,0044,218,91,309,17,326,611,53.36%,35.68%,1
基隆市,信義區,0045,327,140,467,8,475,951,49.95%,34.38%,1
基隆市,信義區,0046,552,266,818,41,859,1616,53.16%,34.16%,1
基隆市,信義區,0047,519,280,799,26,825,1516,54.42%,34.23%,1
基隆市,信義區,0048,366,170,536,18,554,1049,52.81%,34.89%,1
基隆市,信義區,0049,349,196,545,17,562,1069,52.57%,32.65%,1
基隆市,信義區,0050,273,134,407,17,424,727,58.32%,37.55%,1
基隆市,信義區,0051,345,188,533,22,555,929,59.74%,37.14%,1
基隆市,信義區,0052,422,246,668,23,691,1118,61.81%,37.75%,1
基隆市,信義區,0053,467,261,728,26,754,1339,56.31%,34.88%,1
基隆市,信義區,0054,358,150,508,21,529,999,52.95%,35.84%,1
基隆市,信義區,0055,284,119,403,9,412,764,53.93%,37.17%,1
基隆市,信義區,0056,503,222,725,28,753,1555,48.42%,32.35%,1
基隆市,信義區,0057,634,347,981,20,1001,2015,49.68%,31.46%,1
基隆市,信義區,0058,465,231,696,26,722,1268,56.94%,36.67%,1
基隆市,信義區,0059,512,391,903,33,936,1569,59.66%,32.63%,1
基隆市,信義區,0060,629,306,935,25,960,1985,48.36%,31.69%,1
基隆市,信義區,0061,570,222,792,20,812,1476,55.01%,38.62%,1
基隆市,信義區,0062,527,288,815,26,841,1493,56.33%,35.3%,1
基隆市,信義區,0063,475,272,747,20,767,1249,61.41%,38.03%,1
基隆市,信義區,0064,540,236,776,14,790,1559,50.67%,34.64%,1
基隆市,信義區,0065,376,189,565,13,578,1168,49.49%,32.19%,1
基隆市,信義區,0066,543,252,795,32,827,1602,51.62%,33.9%,1
基隆市,信義區,0067,460,206,666,26,692,1485,46.6%,30.98%,1
基隆市,信義區,0068,352,152,504,23,527,1009,52.23%,34.89%,1
基隆市,信義區,0069,569,260,829,39,868,2016,43.06%,28.22%,1
基隆市,信義區,0070,520,229,749,19,768,1764,43.54%,29.48%,1
基隆市,信義區,0071,450,231,681,24,705,1295,54.44%,34.75%,1
新竹市,東區,0001,319,183,502,10,512,1512,33.86%,21.1%,1
新竹市,東區,0002,367,202,569,16,585,953,61.39%,38.51%,1
新竹市,東區,0003,261,131,392,28,420,729,57.61%,35.8%,1
新竹市,東區,0004,226,110,336,18,354,566,62.54%,39.93%,1
新竹市,東區,0005,250,110,360,18,378,640,59.06%,39.06%,1
新竹市,東區,0006,100,57,157,16,173,305,56.72%,32.79%,1
新竹市,東區,0007,230,102,332,15,347,563,61.63%,40.85%,1
新竹市,東區,0008,265,143,408,12,420,741,56.68%,35.76%,1
新竹市,東區,0009,369,232,601,15,616,1041,59.17%,35.45%,1
新竹市,東區,0010,547,302,849,23,872,1615,53.99%,33.87%,1
新竹市,東區,0011,471,244,715,33,748,1287,58.12%,36.6%,1
新竹市,東區,0012,602,273,875,23,898,1554,57.79%,38.74%,1
新竹市,東區,0013,536,273,809,16,825,1388,59.44%,38.62%,1
新竹市,東區,0014,533,285,818,26,844,1419,59.48%,37.56%,1
新竹市,東區,0015,451,273,724,33,757,1355,55.87%,33.28%,1
新竹市,東區,0016,549,267,816,27,843,1490,56.58%,36.85%,1
新竹市,東區,0017,591,315,906,15,921,1615,57.03%,36.59%,1
新竹市,東區,0018,611,321,932,30,962,1672,57.54%,36.54%,1
新竹市,東區,0019,371,237,608,19,627,1062,59.04%,34.93%,1
新竹市,東區,0020,462,262,724,29,753,1315,57.26%,35.13%,1
新竹市,東區,0021,392,188,580,19,599,1000,59.9%,39.2%,1
新竹市,東區,0022,513,252,765,34,799,1337,59.76%,38.37%,1
新竹市,東區,0023,592,344,936,20,956,1747,54.72%,33.89%,1
新竹市,東區,0024,577,366,943,16,959,1600,59.94%,36.06%,1
新竹市,東區,0025,408,220,628,28,656,1158,56.65%,35.23%,1
新竹市,東區,0026,338,183,521,21,542,828,65.46%,40.82%,1
新竹市,東區,0027,536,303,839,35,874,1573,55.56%,34.08%,1
新竹市,東區,0028,607,259,866,23,889,1550,57.35%,39.16%,1
新竹市,東區,0029,473,257,730,27,757,1317,57.48%,35.91%,1
新竹市,東區,0030,384,230,614,35,649,1040,62.4%,36.92%,1
新竹市,東區,0031,385,164,549,17,566,935,60.53%,41.18%,1
新竹市,東區,0032,377,218,595,20,615,1074,57.26%,35.1%,1
新竹市,東區,0033,425,232,657,42,699,1133,61.69%,37.51%,1
新竹市,東區,0034,476,247,723,36,759,1262,60.14%,37.72%,1
新竹市,東區,0035,441,229,670,20,690,1199,57.55%,36.78%,1
新竹市,東區,0036,484,265,749,21,770,1226,62.81%,39.48%,1
新竹市,東區,0037,543,318,861,25,886,1377,64.34%,39.43%,1
新竹市,東區,0038,398,227,625,11,636,991,64.18%,40.16%,1
新竹市,東區,0039,448,267,715,47,762,1271,59.95%,35.25%,1
新竹市,東區,0040,406,233,639,13,652,1012,64.43%,40.12%,1
新竹市,東區,0041,368,183,551,36,587,1001,58.64%,36.76%,1
新竹市,東區,0042,511,306,817,39,856,1603,53.4%,31.88%,1
新竹市,東區,0043,448,226,674,31,705,1236,57.04%,36.25%,1
新竹市,東區,0044,493,190,683,50,733,1532,47.85%,32.18%,1
新竹市,東區,0045,518,213,731,18,749,1306,57.35%,39.66%,1
新竹市,東區,0046,393,194,587,43,630,1073,58.71%,36.63%,1
新竹市,東區,0047,335,199,534,18,552,952,57.98%,35.19%,1
新竹市,東區,0048,430,189,619,26,645,1298,49.69%,33.13%,1
新竹市,東區,0049,316,126,442,9,451,778,57.97%,40.62%,1
新竹市,東區,0050,417,268,685,21,706,1195,59.08%,34.9%,1
新竹市,東區,0051,550,281,831,37,868,1569,55.32%,35.05%,1
新竹市,東區,0052,570,369,939,24,963,1533,62.82%,37.18%,1
新竹市,東區,0053,582,204,786,27,813,1336,60.85%,43.56%,1
新竹市,東區,0054,534,249,783,30,813,1367,59.47%,39.06%,1
新竹市,東區,0055,716,52,768,23,791,1289,61.37%,55.55%,1
新竹市,東區,0056,368,161,529,22,551,960,57.4%,38.33%,1
新竹市,東區,0057,334,186,520,18,538,843,63.82%,39.62%,1
新竹市,東區,0058,414,163,577,21,598,948,63.08%,43.67%,1
新竹市,東區,0059,364,135,499,23,522,915,57.05%,39.78%,1
新竹市,東區,0060,720,289,1009,40,1049,1801,58.25%,39.98%,1
新竹市,東區,0061,401,215,616,12,628,1079,58.2%,37.16%,1
新竹市,東區,0062,296,118,414,9,423,676,62.57%,43.79%,1
新竹市,東區,0063,404,236,640,37,677,1132,59.81%,35.69%,1
新竹市,東區,0064,76,70,146,6,152,251,60.56%,30.28%,1
新竹市,東區,0065,567,326,893,35,928,1620,57.28%,35%,1
新竹市,東區,0066,447,333,780,20,800,1479,54.09%,30.22%,1
新竹市,東區,0067,408,332,740,16,756,1402,53.92%,29.1%,1
新竹市,東區,0068,448,252,700,29,729,1280,56.95%,35%,1
新竹市,東區,0069,383,336,719,13,732,1228,59.61%,31.19%,1
新竹市,東區,0070,330,305,635,4,639,1157,55.23%,28.52%,1
新竹市,東區,0071,475,272,747,23,770,1354,56.87%,35.08%,1
新竹市,東區,0072,499,337,836,19,855,1334,64.09%,37.41%,1
新竹市,東區,0073,469,296,765,27,792,1234,64.18%,38.01%,1
新竹市,東區,0074,575,296,871,25,896,1398,64.09%,41.13%,1
新竹市,東區,0075,323,237,560,13,573,928,61.75%,34.81%,1
新竹市,東區,0076,531,297,828,33,861,1368,62.94%,38.82%,1
新竹市,東區,0077,436,249,685,17,702,1215,57.78%,35.88%,1
新竹市,東區,0078,393,161,554,20,574,1067,53.8%,36.83%,1
新竹市,東區,0079,336,312,648,14,662,1194,55.44%,28.14%,1
新竹市,東區,0080,336,289,625,16,641,1193,53.73%,28.16%,1
新竹市,東區,0081,469,292,761,48,809,1388,58.29%,33.79%,1
新竹市,東區,0082,480,246,726,27,753,1267,59.43%,37.88%,1
新竹市,東區,0083,468,254,722,17,739,1299,56.89%,36.03%,1
新竹市,東區,0084,445,278,723,17,740,1288,57.45%,34.55%,1
新竹市,東區,0085,405,329,734,18,752,1228,61.24%,32.98%,1
新竹市,東區,0086,382,299,681,13,694,1135,61.15%,33.66%,1
新竹市,東區,0087,432,342,774,11,785,1237,63.46%,34.92%,1
新竹市,東區,0088,398,183,581,31,612,1135,53.92%,35.07%,1
新竹市,東區,0089,410,183,593,23,616,1165,52.88%,35.19%,1
新竹市,東區,0090,397,216,613,21,634,1124,56.41%,35.32%,1
新竹市,東區,0091,427,266,693,23,716,1210,59.17%,35.29%,1
新竹市,東區,0092,471,218,689,27,716,1323,54.12%,35.6%,1
新竹市,東區,0093,454,187,641,22,663,1207,54.93%,37.61%,1
新竹市,東區,0094,416,202,618,26,644,1264,50.95%,32.91%,1
新竹市,東區,0095,400,269,669,16,685,1248,54.89%,32.05%,1
新竹市,東區,0096,532,309,841,32,873,1400,62.36%,38%,1
新竹市,東區,0097,532,327,859,26,885,1473,60.08%,36.12%,1
新竹市,東區,0098,450,289,739,32,771,1367,56.4%,32.92%,1
新竹市,東區,0099,443,270,713,16,729,1233,59.12%,35.93%,1
新竹市,東區,0100,186,92,278,8,286,507,56.41%,36.69%,1
新竹市,東區,0101,268,132,400,22,422,714,59.1%,37.54%,1
新竹市,東區,0102,323,155,478,38,516,875,58.97%,36.91%,1
新竹市,東區,0103,528,239,767,30,797,1396,57.09%,37.82%,1
新竹市,東區,0104,416,235,651,27,678,1232,55.03%,33.77%,1
新竹市,東區,0105,409,274,683,37,720,1323,54.42%,30.91%,1
新竹市,東區,0106,462,249,711,23,734,1516,48.42%,30.47%,1
新竹市,東區,0107,446,271,717,28,745,1453,51.27%,30.7%,1
新竹市,東區,0108,332,164,496,21,517,880,58.75%,37.73%,1
新竹市,東區,0109,400,161,561,22,583,1058,55.1%,37.81%,1
新竹市,東區,0110,370,203,573,27,600,1061,56.55%,34.87%,1
新竹市,東區,0111,274,115,389,32,421,710,59.3%,38.59%,1
新竹市,東區,0112,294,133,427,34,461,752,61.3%,39.1%,1
新竹市,東區,0113,206,81,287,14,301,475,63.37%,43.37%,1
新竹市,東區,0114,279,177,456,29,485,880,55.11%,31.7%,1
新竹市,東區,0115,339,213,552,23,575,989,58.14%,34.28%,1
新竹市,東區,0116,395,190,585,30,615,1059,58.07%,37.3%,1
新竹市,東區,0117,223,125,348,25,373,607,61.45%,36.74%,1
新竹市,東區,0118,292,157,449,28,477,815,58.53%,35.83%,1
新竹市,東區,0119,321,141,462,22,484,777,62.29%,41.31%,1
新竹市,東區,0120,458,226,684,27,711,1399,50.82%,32.74%,1
新竹市,東區,0121,436,223,659,27,686,1216,56.41%,35.86%,1
新竹市,東區,0122,367,162,529,32,561,1062,52.82%,34.56%,1
新竹市,東區,0123,418,193,611,12,623,1046,59.56%,39.96%,1
新竹市,東區,0124,464,227,691,17,708,1332,53.15%,34.83%,1
新竹市,東區,0125,448,285,733,35,768,1350,56.89%,33.19%,1
新竹市,東區,0126,493,247,740,16,756,1438,52.57%,34.28%,1
新竹市,東區,0127,484,236,720,35,755,1414,53.39%,34.23%,1
新竹市,東區,0128,538,310,848,18,866,1476,58.67%,36.45%,1
新竹市,東區,0129,542,238,780,41,821,1326,61.92%,40.87%,1
新竹市,東區,0130,347,231,578,24,602,927,64.94%,37.43%,1
新竹市,東區,0131,463,247,710,27,737,1273,57.89%,36.37%,1
新竹市,東區,0132,448,231,679,26,705,1315,53.61%,34.07%,1
新竹市,東區,0133,507,273,780,30,810,1413,57.32%,35.88%,1
新竹市,東區,0134,357,228,585,14,599,1064,56.3%,33.55%,1
新竹市,東區,0135,483,291,774,17,791,1244,63.59%,38.83%,1
新竹市,東區,0136,395,218,613,3,616,1160,53.1%,34.05%,1
新竹市,東區,0137,449,231,680,19,699,1398,50%,32.12%,1
新竹市,東區,0138,366,191,557,15,572,1384,41.33%,26.45%,1
新竹市,東區,0139,346,165,511,32,543,874,62.13%,39.59%,1
新竹市,北區,0140,165,95,260,9,269,477,56.39%,34.59%,1
新竹市,北區,0141,210,96,306,23,329,535,61.5%,39.25%,1
新竹市,北區,0142,258,146,404,44,448,746,60.05%,34.58%,1
新竹市,北區,0143,190,105,295,9,304,546,55.68%,34.8%,1
新竹市,北區,0144,289,130,419,23,442,711,62.17%,40.65%,1
新竹市,北區,0145,417,174,591,29,620,1143,54.24%,36.48%,1
新竹市,北區,0146,461,246,707,27,734,1370,53.58%,33.65%,1
新竹市,北區,0147,458,276,734,24,758,1390,54.53%,32.95%,1
新竹市,北區,0148,352,186,538,11,549,962,57.07%,36.59%,1
新竹市,北區,0149,437,249,686,11,697,1237,56.35%,35.33%,1
新竹市,北區,0150,492,263,755,39,794,1604,49.5%,30.67%,1
新竹市,北區,0151,263,113,376,14,390,758,51.45%,34.7%,1
新竹市,北區,0152,478,193,671,20,691,1320,52.35%,36.21%,1
新竹市,北區,0153,494,229,723,48,771,1519,50.76%,32.52%,1
新竹市,北區,0154,86,41,127,7,134,347,38.62%,24.78%,1
新竹市,北區,0155,485,205,690,34,724,1212,59.74%,40.02%,1
新竹市,北區,0156,523,263,786,31,817,1484,55.05%,35.24%,1
新竹市,北區,0157,477,263,740,53,793,1428,55.53%,33.4%,1
新竹市,北區,0158,482,159,641,22,663,1128,58.78%,42.73%,1
新竹市,北區,0159,232,114,346,12,358,638,56.11%,36.36%,1
新竹市,北區,0160,499,177,676,37,713,1222,58.35%,40.83%,1
新竹市,北區,0161,357,198,555,28,583,1076,54.18%,33.18%,1
新竹市,北區,0162,405,180,585,17,602,937,64.25%,43.22%,1
新竹市,北區,0163,491,237,728,39,767,1394,55.02%,35.22%,1
新竹市,北區,0164,522,259,781,30,811,1568,51.72%,33.29%,1
新竹市,北區,0165,406,268,674,32,706,1159,60.91%,35.03%,1
新竹市,北區,0166,74,27,101,4,105,252,41.67%,29.37%,1
新竹市,北區,0167,309,159,468,13,481,761,63.21%,40.6%,1
新竹市,北區,0168,285,157,442,31,473,788,60.03%,36.17%,1
新竹市,北區,0169,222,115,337,23,360,561,64.17%,39.57%,1
新竹市,北區,0170,499,277,776,53,829,1558,53.21%,32.03%,1
新竹市,北區,0171,444,249,693,23,716,1398,51.22%,31.76%,1
新竹市,北區,0172,347,156,503,33,536,957,56.01%,36.26%,1
新竹市,北區,0173,465,203,668,28,696,1195,58.24%,38.91%,1
新竹市,北區,0174,365,225,590,27,617,1236,49.92%,29.53%,1
新竹市,北區,0175,419,212,631,36,667,1255,53.15%,33.39%,1
新竹市,北區,0176,399,234,633,9,642,1114,57.63%,35.82%,1
新竹市,北區,0177,504,252,756,24,780,1396,55.87%,36.1%,1
新竹市,北區,0178,542,263,805,32,837,1456,57.49%,37.23%,1
新竹市,北區,0179,476,266,742,18,760,1374,55.31%,34.64%,1
新竹市,北區,0180,379,172,551,27,578,1070,54.02%,35.42%,1
新竹市,北區,0181,437,171,608,38,646,1142,56.57%,38.27%,1
新竹市,北區,0182,370,211,581,14,595,1103,53.94%,33.54%,1
新竹市,北區,0183,438,191,629,50,679,1190,57.06%,36.81%,1
新竹市,北區,0184,473,189,662,15,677,1089,62.17%,43.43%,1
新竹市,北區,0185,414,197,611,12,623,1272,48.98%,32.55%,1
新竹市,北區,0186,488,225,713,36,749,1306,57.35%,37.37%,1
新竹市,北區,0187,470,252,722,30,752,1328,56.63%,35.39%,1
新竹市,北區,0188,497,251,748,24,772,1457,52.99%,34.11%,1
新竹市,北區,0189,521,276,797,31,828,1492,55.5%,34.92%,1
新竹市,北區,0190,449,224,673,35,708,1160,61.03%,38.71%,1
新竹市,北區,0191,367,171,538,37,575,971,59.22%,37.8%,1
新竹市,北區,0192,296,150,446,10,456,1401,32.55%,21.13%,1
新竹市,北區,0193,464,283,747,29,776,1340,57.91%,34.63%,1
新竹市,北區,0194,504,290,794,29,823,1371,60.03%,36.76%,1
新竹市,北區,0195,434,256,690,20,710,1267,56.04%,34.25%,1
新竹市,北區,0196,420,226,646,32,678,1073,63.19%,39.14%,1
新竹市,北區,0197,443,219,662,17,679,1159,58.58%,38.22%,1
新竹市,北區,0198,436,278,714,19,733,1294,56.65%,33.69%,1
新竹市,北區,0199,518,258,776,28,804,1442,55.76%,35.92%,1
新竹市,北區,0200,476,256,732,20,752,1270,59.21%,37.48%,1
新竹市,北區,0201,506,234,740,29,769,1179,65.22%,42.92%,1
新竹市,北區,0202,407,173,580,20,600,949,63.22%,42.89%,1
新竹市,北區,0203,412,248,660,24,684,1163,58.81%,35.43%,1
新竹市,北區,0204,453,285,738,9,747,1334,56%,33.96%,1
新竹市,北區,0205,482,296,778,26,804,1415,56.82%,34.06%,1
新竹市,北區,0206,462,316,778,18,796,1305,61%,35.4%,1
新竹市,北區,0207,430,234,664,18,682,1200,56.83%,35.83%,1
新竹市,北區,0208,398,233,631,23,654,1106,59.13%,35.99%,1
新竹市,北區,0209,396,217,613,15,628,1044,60.15%,37.93%,1
新竹市,北區,0210,390,221,611,19,630,1061,59.38%,36.76%,1
新竹市,北區,0211,559,301,860,41,901,1518,59.35%,36.82%,1
新竹市,北區,0212,467,259,726,31,757,1220,62.05%,38.28%,1
新竹市,北區,0213,564,290,854,10,864,1475,58.58%,38.24%,1
新竹市,北區,0214,489,226,715,35,750,1373,54.62%,35.62%,1
新竹市,北區,0215,557,270,827,22,849,1450,58.55%,38.41%,1
新竹市,北區,0216,572,233,805,24,829,1423,58.26%,40.2%,1
新竹市,北區,0217,434,159,593,18,611,1059,57.7%,40.98%,1
新竹市,北區,0218,477,180,657,30,687,1130,60.8%,42.21%,1
新竹市,北區,0219,513,209,722,27,749,1208,62%,42.47%,1
新竹市,北區,0220,562,183,745,20,765,1226,62.4%,45.84%,1
新竹市,北區,0221,446,220,666,21,687,1175,58.47%,37.96%,1
新竹市,北區,0222,503,269,772,24,796,1371,58.06%,36.69%,1
新竹市,北區,0223,468,212,680,38,718,1306,54.98%,35.83%,1
新竹市,北區,0224,513,201,714,20,734,1340,54.78%,38.28%,1
新竹市,北區,0225,510,132,642,39,681,1111,61.3%,45.9%,1
新竹市,北區,0226,514,222,736,28,764,1197,63.83%,42.94%,1
新竹市,北區,0227,420,141,561,23,584,1008,57.94%,41.67%,1
新竹市,北區,0228,350,164,514,12,526,946,55.6%,37%,1
新竹市,北區,0229,297,107,404,24,428,705,60.71%,42.13%,1
新竹市,北區,0230,302,156,458,50,508,848,59.91%,35.61%,1
新竹市,北區,0231,454,224,678,21,699,1295,53.98%,35.06%,1
新竹市,北區,0232,506,224,730,32,762,1467,51.94%,34.49%,1
新竹市,北區,0233,515,237,752,27,779,1659,46.96%,31.04%,1
新竹市,北區,0234,454,206,660,27,687,1297,52.97%,35%,1
新竹市,北區,0235,502,252,754,37,791,1374,57.57%,36.54%,1
新竹市,北區,0236,535,262,797,44,841,1457,57.72%,36.72%,1
新竹市,北區,0237,432,184,616,21,637,1072,59.42%,40.3%,1
新竹市,北區,0238,462,235,697,35,732,1350,54.22%,34.22%,1
新竹市,北區,0239,387,201,588,21,609,971,62.72%,39.86%,1
新竹市,北區,0240,552,234,786,64,850,1450,58.62%,38.07%,1
新竹市,北區,0241,338,154,492,18,510,895,56.98%,37.77%,1
新竹市,北區,0242,497,217,714,28,742,1378,53.85%,36.07%,1
新竹市,北區,0243,571,218,789,49,838,1609,52.08%,35.49%,1
新竹市,北區,0244,205,114,319,28,347,594,58.42%,34.51%,1
新竹市,香山區,0245,531,223,754,30,784,1443,54.33%,36.8%,1
新竹市,香山區,0246,422,240,662,23,685,1241,55.2%,34%,1
新竹市,香山區,0247,442,198,640,21,661,1194,55.36%,37.02%,1
新竹市,香山區,0248,393,201,594,11,605,1081,55.97%,36.36%,1
新竹市,香山區,0249,312,152,464,17,481,807,59.6%,38.66%,1
新竹市,香山區,0250,609,311,920,37,957,1760,54.38%,34.6%,1
新竹市,香山區,0251,598,281,879,37,916,1635,56.02%,36.57%,1
新竹市,香山區,0252,577,259,836,31,867,1473,58.86%,39.17%,1
新竹市,香山區,0253,541,251,792,16,808,1408,57.39%,38.42%,1
新竹市,香山區,0254,453,184,637,13,650,1318,49.32%,34.37%,1
新竹市,香山區,0255,473,250,723,32,755,1337,56.47%,35.38%,1
新竹市,香山區,0256,615,328,943,19,962,1862,51.66%,33.03%,1
新竹市,香山區,0257,387,203,590,14,604,1067,56.61%,36.27%,1
新竹市,香山區,0258,315,176,491,39,530,863,61.41%,36.5%,1
新竹市,香山區,0259,468,227,695,46,741,1198,61.85%,39.07%,1
新竹市,香山區,0260,423,226,649,44,693,1138,60.9%,37.17%,1
新竹市,香山區,0261,424,190,614,35,649,957,67.82%,44.31%,1
新竹市,香山區,0262,530,223,753,51,804,1348,59.64%,39.32%,1
新竹市,香山區,0263,425,213,638,51,689,1023,67.35%,41.54%,1
新竹市,香山區,0264,408,132,540,17,557,970,57.42%,42.06%,1
新竹市,香山區,0265,505,256,761,27,788,1318,59.79%,38.32%,1
新竹市,香山區,0266,360,206,566,42,608,1088,55.88%,33.09%,1
新竹市,香山區,0267,309,135,444,17,461,903,51.05%,34.22%,1
新竹市,香山區,0268,381,184,565,32,597,1012,58.99%,37.65%,1
新竹市,香山區,0269,394,149,543,30,573,1014,56.51%,38.86%,1
新竹市,香山區,0270,492,219,711,25,736,1238,59.45%,39.74%,1
新竹市,香山區,0271,413,199,612,39,651,1182,55.08%,34.94%,1
新竹市,香山區,0272,580,222,802,52,854,1331,64.16%,43.58%,1
新竹市,香山區,0273,386,229,615,17,632,976,64.75%,39.55%,1
新竹市,香山區,0274,287,157,444,19,463,834,55.52%,34.41%,1
新竹市,香山區,0275,353,148,501,32,533,919,58%,38.41%,1
新竹市,香山區,0276,423,262,685,19,704,1188,59.26%,35.61%,1
新竹市,香山區,0277,409,198,607,32,639,1086,58.84%,37.66%,1
新竹市,香山區,0278,465,227,692,24,716,1144,62.59%,40.65%,1
新竹市,香山區,0279,437,199,636,26,662,1112,59.53%,39.3%,1
新竹市,香山區,0280,551,268,819,35,854,1476,57.86%,37.33%,1
新竹市,香山區,0281,479,235,714,22,736,1291,57.01%,37.1%,1
新竹市,香山區,0282,596,272,868,38,906,1464,61.89%,40.71%,1
新竹市,香山區,0283,569,228,797,48,845,1427,59.22%,39.87%,1
新竹市,香山區,0284,492,231,723,29,752,1336,56.29%,36.83%,1
新竹市,香山區,0285,347,179,526,33,559,1131,49.43%,30.68%,1
新竹市,香山區,0286,415,203,618,33,651,1070,60.84%,38.79%,1
新竹市,香山區,0287,346,233,579,39,618,1006,61.43%,34.39%,1
新竹市,香山區,0288,406,139,545,46,591,1223,48.32%,33.2%,1
新竹市,香山區,0289,388,203,591,36,627,1119,56.03%,34.67%,1
新竹市,香山區,0290,490,208,698,30,728,1400,52%,35%,1
新竹市,香山區,0291,498,243,741,36,777,1627,47.76%,30.61%,1
新竹市,香山區,0292,416,204,620,33,653,1289,50.66%,32.27%,1
新竹市,香山區,0293,462,220,682,33,715,1409,50.75%,32.79%,1
新竹市,香山區,0294,272,125,397,30,427,814,52.46%,33.42%,1
新竹市,香山區,0295,244,135,379,24,403,719,56.05%,33.94%,1
新竹市,香山區,0296,334,170,504,16,520,1065,48.83%,31.36%,1
新竹市,香山區,0297,271,136,407,29,436,776,56.19%,34.92%,1
新竹市,香山區,0298,319,160,479,32,511,890,57.42%,35.84%,1
新竹市,香山區,0299,294,146,440,23,463,896,51.67%,32.81%,1
嘉義市,東區,0001,381,197,578,16,594,1025,57.95%,37.17%,1
嘉義市,東區,0002,462,214,676,21,697,1276,54.62%,36.21%,1
嘉義市,東區,0003,339,143,482,20,502,974,51.54%,34.8%,1
嘉義市,東區,0004,479,227,706,18,724,1175,61.62%,40.77%,1
嘉義市,東區,0005,280,146,426,14,440,702,62.68%,39.89%,1
嘉義市,東區,0006,302,285,587,22,609,1092,55.77%,27.66%,1
嘉義市,東區,0007,317,162,479,16,495,1023,48.39%,30.99%,1
嘉義市,東區,0008,636,277,913,30,943,1816,51.93%,35.02%,1
嘉義市,東區,0009,676,362,1038,33,1071,1936,55.32%,34.92%,1
嘉義市,東區,0010,569,376,945,14,959,1698,56.48%,33.51%,1
嘉義市,東區,0011,480,243,723,12,735,1221,60.2%,39.31%,1
嘉義市,東區,0012,411,214,625,14,639,1113,57.41%,36.93%,1
嘉義市,東區,0013,536,272,808,25,833,1452,57.37%,36.91%,1
嘉義市,東區,0014,554,280,834,22,856,1395,61.36%,39.71%,1
嘉義市,東區,0015,477,257,734,32,766,1453,52.72%,32.83%,1
嘉義市,東區,0016,419,159,578,12,590,1094,53.93%,38.3%,1
嘉義市,東區,0017,545,250,795,18,813,1420,57.25%,38.38%,1
嘉義市,東區,0018,597,290,887,28,915,1552,58.96%,38.47%,1
嘉義市,東區,0019,556,299,855,36,891,1558,57.19%,35.69%,1
嘉義市,東區,0020,434,179,613,19,632,1062,59.51%,40.87%,1
嘉義市,東區,0021,442,188,630,24,654,1199,54.55%,36.86%,1
嘉義市,東區,0022,503,175,678,20,698,1236,56.47%,40.7%,1
嘉義市,東區,0023,335,155,490,13,503,890,56.52%,37.64%,1
嘉義市,東區,0024,353,159,512,25,537,880,61.02%,40.11%,1
嘉義市,東區,0025,436,222,658,18,676,1189,56.85%,36.67%,1
嘉義市,東區,0026,248,134,382,14,396,669,59.19%,37.07%,1
嘉義市,東區,0027,503,263,766,23,789,1435,54.98%,35.05%,1
嘉義市,東區,0028,522,271,793,25,818,1349,60.64%,38.7%,1
嘉義市,東區,0029,410,338,748,27,775,1455,53.26%,28.18%,1
嘉義市,東區,0030,335,175,510,24,534,915,58.36%,36.61%,1
嘉義市,東區,0031,352,188,540,15,555,952,58.3%,36.97%,1
嘉義市,東區,0032,341,170,511,21,532,941,56.54%,36.24%,1
嘉義市,東區,0033,370,208,578,17,595,1080,55.09%,34.26%,1
嘉義市,東區,0034,423,170,593,22,615,1157,53.15%,36.56%,1
嘉義市,東區,0035,402,202,604,20,624,1053,59.26%,38.18%,1
嘉義市,東區,0036,332,153,485,13,498,967,51.5%,34.33%,1
嘉義市,東區,0037,379,190,569,19,588,1091,53.9%,34.74%,1
嘉義市,東區,0038,381,170,551,32,583,961,60.67%,39.65%,1
嘉義市,東區,0039,233,116,349,13,362,863,41.95%,27%,1
嘉義市,東區,0040,389,190,579,37,616,1023,60.22%,38.03%,1
嘉義市,東區,0041,420,189,609,39,648,1078,60.11%,38.96%,1
嘉義市,東區,0042,350,165,515,9,524,938,55.86%,37.31%,1
嘉義市,東區,0043,392,183,575,19,594,1049,56.63%,37.37%,1
嘉義市,東區,0044,476,204,680,34,714,1360,52.5%,35%,1
嘉義市,東區,0045,546,234,780,39,819,1615,50.71%,33.81%,1
嘉義市,東區,0046,447,209,656,26,682,1267,53.83%,35.28%,1
嘉義市,東區,0047,513,222,735,37,772,1579,48.89%,32.49%,1
嘉義市,東區,0048,596,303,899,44,943,1831,51.5%,32.55%,1
嘉義市,東區,0049,390,157,547,20,567,977,58.03%,39.92%,1
嘉義市,東區,0050,397,215,612,24,636,1169,54.41%,33.96%,1
嘉義市,東區,0051,452,245,697,47,744,1238,60.1%,36.51%,1
嘉義市,東區,0052,482,230,712,14,726,1266,57.35%,38.07%,1
嘉義市,東區,0053,496,171,667,23,690,1429,48.29%,34.71%,1
嘉義市,東區,0054,452,245,697,13,710,1288,55.12%,35.09%,1
嘉義市,東區,0055,326,190,516,28,544,980,55.51%,33.27%,1
嘉義市,東區,0056,326,144,470,15,485,922,52.6%,35.36%,1
嘉義市,東區,0057,437,198,635,33,668,1133,58.96%,38.57%,1
嘉義市,東區,0058,459,212,671,30,701,1235,56.76%,37.17%,1
嘉義市,東區,0059,524,294,818,15,833,1525,54.62%,34.36%,1
嘉義市,東區,0060,377,215,592,22,614,1170,52.48%,32.22%,1
嘉義市,東區,0061,469,243,712,29,741,1177,62.96%,39.85%,1
嘉義市,東區,0062,465,201,666,22,688,1207,57%,38.53%,1
嘉義市,東區,0063,477,208,685,32,717,1272,56.37%,37.5%,1
嘉義市,東區,0064,418,203,621,56,677,1188,56.99%,35.19%,1
嘉義市,東區,0065,396,191,587,12,599,1172,51.11%,33.79%,1
嘉義市,東區,0066,384,199,583,20,603,1020,59.12%,37.65%,1
嘉義市,東區,0067,497,244,741,23,764,1332,57.36%,37.31%,1
嘉義市,東區,0068,414,191,605,20,625,1011,61.82%,40.95%,1
嘉義市,東區,0069,580,263,843,42,885,1682,52.62%,34.48%,1
嘉義市,東區,0070,600,232,832,33,865,1567,55.2%,38.29%,1
嘉義市,東區,0071,449,224,673,14,687,1207,56.92%,37.2%,1
嘉義市,東區,0072,424,171,595,21,616,981,62.79%,43.22%,1
嘉義市,東區,0073,493,246,739,17,756,1395,54.19%,35.34%,1
嘉義市,東區,0074,456,223,679,19,698,1434,48.68%,31.8%,1
嘉義市,東區,0075,414,218,632,15,647,1404,46.08%,29.49%,1
嘉義市,東區,0076,569,244,813,14,827,1428,57.91%,39.85%,1
嘉義市,東區,0077,537,254,791,10,801,1823,43.94%,29.46%,1
嘉義市,東區,0078,505,247,752,31,783,1570,49.87%,32.17%,1
嘉義市,東區,0079,473,218,691,27,718,1282,56.01%,36.9%,1
嘉義市,東區,0080,630,271,901,29,930,1571,59.2%,40.1%,1
嘉義市,東區,0081,519,256,775,21,796,1533,51.92%,33.86%,1
嘉義市,西區,0082,339,142,481,15,496,885,56.05%,38.31%,1
嘉義市,西區,0083,381,190,571,34,605,1109,54.55%,34.36%,1
嘉義市,西區,0084,369,162,531,21,552,1020,54.12%,36.18%,1
嘉義市,西區,0085,395,160,555,27,582,925,62.92%,42.7%,1
嘉義市,西區,0086,534,260,794,16,810,1671,48.47%,31.96%,1
嘉義市,西區,0087,483,198,681,19,700,1215,57.61%,39.75%,1
嘉義市,西區,0088,406,165,571,20,591,1036,57.05%,39.19%,1
嘉義市,西區,0089,400,184,584,21,605,1129,53.59%,35.43%,1
嘉義市,西區,0090,436,163,599,27,626,1127,55.55%,38.69%,1
嘉義市,西區,0091,551,247,798,24,822,1415,58.09%,38.94%,1
嘉義市,西區,0092,512,194,706,19,725,1366,53.07%,37.48%,1
嘉義市,西區,0093,439,175,614,33,647,1053,61.44%,41.69%,1
嘉義市,西區,0094,449,152,601,14,615,1067,57.64%,42.08%,1
嘉義市,西區,0095,505,243,748,31,779,1575,49.46%,32.06%,1
嘉義市,西區,0096,620,332,952,32,984,1865,52.76%,33.24%,1
嘉義市,西區,0097,404,198,602,31,633,1196,52.93%,33.78%,1
嘉義市,西區,0098,422,220,642,18,660,1280,51.56%,32.97%,1
嘉義市,西區,0099,566,277,843,34,877,1629,53.84%,34.75%,1
嘉義市,西區,0100,514,252,766,47,813,1393,58.36%,36.9%,1
嘉義市,西區,0101,421,206,627,30,657,1077,61%,39.09%,1
嘉義市,西區,0102,487,302,789,13,802,1694,47.34%,28.75%,1
嘉義市,西區,0103,308,171,479,47,526,841,62.54%,36.62%,1
嘉義市,西區,0104,409,189,598,4,602,1183,50.89%,34.57%,1
嘉義市,西區,0105,405,201,606,23,629,1000,62.9%,40.5%,1
嘉義市,西區,0106,466,197,663,17,680,1095,62.1%,42.56%,1
嘉義市,西區,0107,471,268,739,34,773,1256,61.54%,37.5%,1
嘉義市,西區,0108,376,157,533,30,563,962,58.52%,39.09%,1
嘉義市,西區,0109,357,194,551,12,563,865,65.09%,41.27%,1
嘉義市,西區,0110,449,233,682,39,721,1396,51.65%,32.16%,1
嘉義市,西區,0111,519,427,946,45,991,1799,55.09%,28.85%,1
嘉義市,西區,0112,524,233,757,13,770,1505,51.16%,34.82%,1
嘉義市,西區,0113,625,257,882,41,923,1698,54.36%,36.81%,1
嘉義市,西區,0114,710,292,1002,18,1020,1854,55.02%,38.3%,1
嘉義市,西區,0115,462,229,691,8,699,1537,45.48%,30.06%,1
嘉義市,西區,0116,542,257,799,26,825,1604,51.43%,33.79%,1
嘉義市,西區,0117,397,173,570,36,606,944,64.19%,42.06%,1
嘉義市,西區,0118,644,255,899,37,936,1627,57.53%,39.58%,1
嘉義市,西區,0119,437,222,659,25,684,1144,59.79%,38.2%,1
嘉義市,西區,0120,489,222,711,39,750,1362,55.07%,35.9%,1
嘉義市,西區,0121,494,244,738,22,760,1279,59.42%,38.62%,1
嘉義市,西區,0122,622,278,900,46,946,1702,55.58%,36.55%,1
嘉義市,西區,0123,512,265,777,25,802,1358,59.06%,37.7%,1
嘉義市,西區,0124,541,252,793,39,832,1360,61.18%,39.78%,1
嘉義市,西區,0125,609,253,862,37,899,1589,56.58%,38.33%,1
嘉義市,西區,0126,513,227,740,32,772,1280,60.31%,40.08%,1
嘉義市,西區,0127,401,197,598,31,629,1220,51.56%,32.87%,1
嘉義市,西區,0128,475,210,685,16,701,1172,59.81%,40.53%,1
嘉義市,西區,0129,498,218,716,37,753,1320,57.05%,37.73%,1
嘉義市,西區,0130,516,234,750,27,777,1185,65.57%,43.54%,1
嘉義市,西區,0131,494,264,758,33,791,1278,61.89%,38.65%,1
嘉義市,西區,0132,400,219,619,13,632,1394,45.34%,28.69%,1
嘉義市,西區,0133,562,285,847,42,889,1540,57.73%,36.49%,1
嘉義市,西區,0134,577,266,843,32,875,1548,56.52%,37.27%,1
嘉義市,西區,0135,346,335,681,25,706,1295,54.52%,26.72%,1
嘉義市,西區,0136,521,239,760,39,799,1318,60.62%,39.53%,1
嘉義市,西區,0137,565,267,832,31,863,1545,55.86%,36.57%,1
嘉義市,西區,0138,257,128,385,15,400,736,54.35%,34.92%,1
嘉義市,西區,0139,423,181,604,20,624,1168,53.42%,36.22%,1
嘉義市,西區,0140,344,144,488,12,500,756,66.14%,45.5%,1
嘉義市,西區,0141,374,118,492,13,505,869,58.11%,43.04%,1
嘉義市,西區,0142,364,185,549,37,586,983,59.61%,37.03%,1
嘉義市,西區,0143,339,125,464,16,480,828,57.97%,40.94%,1
嘉義市,西區,0144,646,300,946,32,978,1775,55.1%,36.39%,1
嘉義市,西區,0145,574,181,755,17,772,1419,54.4%,40.45%,1
嘉義市,西區,0146,287,132,419,22,441,779,56.61%,36.84%,1
嘉義市,西區,0147,338,114,452,10,462,855,54.04%,39.53%,1
嘉義市,西區,0148,437,200,637,36,673,1146,58.73%,38.13%,1
嘉義市,西區,0149,451,178,629,22,651,1111,58.6%,40.59%,1
嘉義市,西區,0150,340,138,478,19,497,767,64.8%,44.33%,1
嘉義市,西區,0151,272,136,408,10,418,817,51.16%,33.29%,1
嘉義市,西區,0152,284,154,438,15,453,770,58.83%,36.88%,1
嘉義市,西區,0153,325,202,527,11,538,1135,47.4%,28.63%,1
嘉義市,西區,0154,260,148,408,47,455,835,54.49%,31.14%,1
嘉義市,西區,0155,410,180,590,22,612,1182,51.78%,34.69%,1
嘉義市,西區,0156,342,132,474,25,499,944,52.86%,36.23%,1
嘉義市,西區,0157,349,166,515,21,536,997,53.76%,35.01%,1
嘉義市,西區,0158,382,210,592,19,611,1074,56.89%,35.57%,1
嘉義市,西區,0159,405,236,641,23,664,1460,45.48%,27.74%,1
嘉義市,西區,0160,495,195,690,26,716,1352,52.96%,36.61%,1
嘉義市,西區,0161,505,285,790,24,814,1499,54.3%,33.69%,1
嘉義市,西區,0162,455,208,663,47,710,1262,56.26%,36.05%,1
嘉義市,西區,0163,468,217,685,28,713,1299,54.89%,36.03%,1
嘉義市,西區,0164,635,263,898,29,927,1734,53.46%,36.62%,1
嘉義市,西區,0165,574,234,808,29,837,1674,50%,34.29%,1
嘉義市,西區,0166,508,300,808,17,825,1540,53.57%,32.99%,1
嘉義市,西區,0167,428,209,637,9,646,1056,61.17%,40.53%,1
嘉義市,西區,0168,561,260,821,44,865,1467,58.96%,38.24%,1
嘉義市,西區,0169,484,227,711,39,750,1431,52.41%,33.82%,1
嘉義市,西區,0170,512,221,733,43,776,1234,62.88%,41.49%,1
嘉義市,西區,0171,433,243,676,16,692,1266,54.66%,34.2%,1
嘉義市,西區,0172,478,222,700,14,714,1211,58.96%,39.47%,1
嘉義市,西區,0173,425,218,643,8,651,1121,58.07%,37.91%,1
嘉義市,西區,0174,392,189,581,10,591,1155,51.17%,33.94%,1
嘉義市,西區,0175,534,311,845,57,902,1546,58.34%,34.54%,1
嘉義市,西區,0176,516,209,725,20,745,1322,56.35%,39.03%,1
嘉義市,西區,0177,575,250,825,59,884,1549,57.07%,37.12%,1
