縣市,鄉鎮市區,開票所,同意票,不同意票,有效票,無效票,投票數,投票權人數,投票率,投票權人數百分比,總數
臺北市,松山區,0527,552,368,920,28,948,1583,59.89%,34.87%,1
臺北市,信義區,0644,483,306,789,26,815,2476,32.92%,19.51%,1
臺北市,大安區,1214,380,250,630,25,655,1184,55.32%,32.09%,1
臺北市,中山區,0786,461,384,845,35,880,1522,57.82%,30.29%,1
臺北市,中正區,1001,459,300,759,28,787,1308,60.17%,35.09%,1
臺北市,大同區,0919,405,304,709,48,757,1261,60.03%,32.12%,1
臺北市,萬華區,1097,397,339,736,40,776,1305,59.46%,30.42%,1
臺北市,文山區,1402,500,340,840,40,880,1539,57.18%,32.49%,1
臺北市,南港區,0455,404,281,685,24,709,1280,55.39%,31.56%,1
臺北市,內湖區,0305,498,361,859,22,881,1661,53.04%,29.98%,1
臺北市,士林區,0142,533,377,910,52,962,1695,56.76%,31.45%,1
臺北市,北投區,0001,463,282,745,55,800,1313,60.93%,35.26%,1
新北市,板橋區,0894,419,314,733,47,780,1388,56.2%,30.19%,1
新北市,三重區,0659,420,350,770,40,810,1509,53.68%,27.83%,1
新北市,中和區,1232,472,322,794,50,844,1630,51.78%,28.96%,1
新北市,永和區,1476,514,351,865,57,922,1554,59.33%,33.08%,1
新北市,新莊區,0302,359,268,627,37,664,1123,59.13%,31.97%,1
新北市,新店區,1987,516,340,856,42,898,1603,56.02%,32.19%,1
新北市,樹林區,1614,399,298,697,47,744,1408,52.84%,28.34%,1
新北市,鶯歌區,1725,162,124,286,14,300,515,58.25%,31.46%,1
新北市,三峽區,1917,95,79,174,13,187,274,68.25%,34.67%,1
新北市,淡水區,0029,143,117,260,32,292,544,53.68%,26.29%,1
新北市,汐止區,2336,490,314,804,61,865,1595,54.23%,30.72%,1
新北市,瑞芳區,2220,234,159,393,29,422,725,58.21%,32.28%,1
新北市,土城區,1775,431,314,745,59,804,1505,53.42%,28.64%,1
新北市,蘆洲區,0555,463,370,833,54,887,1600,55.44%,28.94%,1
新北市,五股區,0207,417,321,738,63,801,1456,55.01%,28.64%,1
新北市,泰山區,0255,179,123,302,23,325,643,50.54%,27.84%,1
新北市,林口區,0145,383,289,672,13,685,1268,54.02%,30.21%,1
新北市,深坑區,2163,231,342,573,34,607,1142,53.15%,20.23%,1
新北市,石碇區,2179,120,105,225,22,247,391,63.17%,30.69%,1
新北市,坪林區,2192,399,239,638,34,672,1248,53.85%,31.97%,1
新北市,三芝區,0011,88,48,136,15,151,312,48.4%,28.21%,1
新北市,石門區,0001,290,266,556,32,588,1121,52.45%,25.87%,1
新北市,八里區,0125,408,302,710,43,753,1498,50.27%,27.24%,1
新北市,平溪區,2208,121,55,176,20,196,384,51.04%,31.51%,1
新北市,雙溪區,2266,134,68,202,15,217,455,47.69%,29.45%,1
新北市,貢寮區,2283,232,166,398,41,439,876,50.11%,26.48%,1
新北市,金山區,2301,150,89,239,23,262,481,54.47%,31.19%,1
新北市,萬里區,2320,408,242,650,49,699,1286,54.35%,31.73%,1
新北市,烏來區,2202,581,331,912,34,946,1568,60.33%,37.05%,1
桃園市,桃園區,0001,457,311,768,37,805,1593,50.53%,28.69%,1
桃園市,中壢區,0591,443,277,720,24,744,1401,53.1%,31.62%,1
桃園市,大溪區,0522,455,346,801,36,837,1477,56.67%,30.81%,1
桃園市,楊梅區,0926,401,266,667,41,708,1269,55.79%,31.6%,1
桃園市,蘆竹區,0396,393,249,642,74,716,1358,52.72%,28.94%,1
桃園市,大園區,0472,393,287,680,30,710,1538,46.16%,25.55%,1
桃園市,龜山區,0217,318,145,463,24,487,874,55.72%,36.38%,1
桃園市,八德區,0295,462,313,775,57,832,1761,47.25%,26.24%,1
桃園市,龍潭區,1008,482,273,755,26,781,1482,52.7%,32.52%,1
桃園市,平鎮區,0801,375,318,693,39,732,1487,49.23%,25.22%,1
桃園市,新屋區,1072,465,296,761,21,782,1306,59.88%,35.6%,1
桃園市,觀音區,1102,366,258,624,34,658,1371,47.99%,26.7%,1
桃園市,復興區,0581,691,368,1059,70,1129,1991,56.71%,34.71%,1
臺中市,中區,1070,600,376,976,75,1051,1652,63.62%,36.32%,1
臺中市,東區,1148,268,164,432,18,450,1138,39.54%,23.55%,1
臺中市,南區,1197,348,200,548,29,577,937,61.58%,37.14%,1
臺中市,西區,1082,303,186,489,26,515,1400,36.79%,21.64%,1
臺中市,北區,0983,458,302,760,36,796,1437,55.39%,31.87%,1
臺中市,西屯區,0625,601,388,989,38,1027,1638,62.7%,36.69%,1
臺中市,南屯區,0745,465,276,741,61,802,1321,60.71%,35.2%,1
臺中市,北屯區,0846,622,388,1010,36,1046,1670,62.63%,37.25%,1
臺中市,豐原區,0394,327,202,529,34,563,983,57.27%,33.27%,1
臺中市,東勢區,1513,391,271,662,61,723,1299,55.66%,30.1%,1
臺中市,大甲區,0001,501,254,755,59,814,1356,60.03%,36.95%,1
臺中市,清水區,0091,327,224,551,36,587,1076,54.55%,30.39%,1
臺中市,沙鹿區,0186,419,294,713,37,750,1380,54.35%,30.36%,1
臺中市,梧棲區,0150,473,336,809,63,872,1541,56.59%,30.69%,1
臺中市,后里區,0357,313,184,497,50,547,852,64.2%,36.74%,1
臺中市,神岡區,0482,581,384,965,58,1023,1684,60.75%,34.5%,1
臺中市,潭子區,0570,464,292,756,48,804,1306,61.56%,35.53%,1
臺中市,大雅區,0524,640,473,1113,49,1162,2027,57.33%,31.57%,1
臺中市,新社區,1562,366,190,556,28,584,1011,57.76%,36.2%,1
臺中市,石岡區,1552,443,254,697,44,741,1244,59.57%,35.61%,1
臺中市,外埔區,0071,319,234,553,49,602,1059,56.85%,30.12%,1
臺中市,大安區,0055,322,186,508,62,570,1068,53.37%,30.15%,1
臺中市,烏日區,0317,560,331,891,39,930,1480,62.84%,37.84%,1
臺中市,大肚區,0284,437,344,781,28,809,1415,57.17%,30.88%,1
臺中市,龍井區,0239,580,407,987,72,1059,1758,60.24%,32.99%,1
臺中市,霧峰區,1470,434,280,714,36,750,1205,62.24%,36.02%,1
臺中市,太平區,1271,553,371,924,68,992,1821,54.48%,30.37%,1
臺中市,大里區,1364,533,286,819,32,851,1614,52.73%,33.02%,1
臺中市,和平區,1585,358,227,585,32,617,956,64.54%,37.45%,1
臺南市,新營區,0116,465,299,764,36,800,1693,47.25%,27.47%,1
臺南市,鹽水區,0085,337,180,517,45,562,1037,54.19%,32.5%,1
臺南市,白河區,0030,368,216,584,56,640,1176,54.42%,31.29%,1
臺南市,柳營區,0165,317,223,540,39,579,1166,49.66%,27.19%,1
臺南市,後壁區,0001,257,133,390,35,425,743,57.2%,34.59%,1
臺南市,東山區,0062,379,211,590,31,621,1401,44.33%,27.05%,1
臺南市,麻豆區,0381,364,228,592,45,637,1205,52.86%,30.21%,1
臺南市,下營區,0343,436,241,677,30,707,1558,45.38%,27.98%,1
臺南市,六甲區,0362,251,172,423,47,470,819,57.39%,30.65%,1
臺南市,官田區,0416,321,171,492,25,517,1104,46.83%,29.08%,1
臺南市,大內區,0436,180,131,311,22,333,759,43.87%,23.72%,1
臺南市,佳里區,0282,459,284,743,39,782,1391,56.22%,33%,1
臺南市,學甲區,0208,273,189,462,31,493,862,57.19%,31.67%,1
臺南市,西港區,0323,287,167,454,22,476,933,51.02%,30.76%,1
臺南市,七股區,0258,160,90,250,9,259,534,48.5%,29.96%,1
臺南市,將軍區,0234,394,216,610,39,649,1110,58.47%,35.5%,1
臺南市,北門區,0190,141,93,234,10,244,484,50.41%,29.13%,1
臺南市,新化區,0581,276,154,430,25,455,746,60.99%,37%,1
臺南市,善化區,0492,338,189,527,13,540,1132,47.7%,29.86%,1
臺南市,新市區,0545,294,169,463,21,484,960,50.42%,30.63%,1
臺南市,安定區,0521,474,242,716,63,779,1251,62.27%,37.89%,1
臺南市,山上區,0572,207,121,328,38,366,855,42.81%,24.21%,1
臺南市,玉井區,0466,363,212,575,45,620,1242,49.92%,29.23%,1
臺南市,楠西區,0447,277,149,426,50,476,978,48.67%,28.32%,1
臺南市,南化區,0456,182,144,326,47,373,690,54.06%,26.38%,1
臺南市,左鎮區,0482,114,65,179,13,192,392,48.98%,29.08%,1
臺南市,仁德區,1188,421,268,689,40,729,1318,55.31%,31.94%,1
臺南市,歸仁區,1237,485,287,772,43,815,1560,52.24%,31.09%,1
臺南市,關廟區,1283,344,175,519,15,534,982,54.38%,35.03%,1
臺南市,龍崎區,1315,316,209,525,35,560,1047,53.49%,30.18%,1
臺南市,永康區,0708,444,276,720,39,759,1398,54.29%,31.76%,1
臺南市,東區,1095,666,371,1037,40,1077,2681,40.17%,24.84%,1
臺南市,南區,1015,415,264,679,30,709,1221,58.07%,33.99%,1
臺南市,北區,0850,534,325,859,54,913,1793,50.92%,29.78%,1
臺南市,安南區,0618,808,520,1328,26,1354,2549,53.12%,31.7%,1
臺南市,安平區,0983,570,354,924,46,970,1753,55.33%,32.52%,1
臺南市,中西區,0931,414,289,703,37,740,1332,55.56%,31.08%,1
高雄市,鹽埕區,0845,497,296,793,48,841,1304,64.49%,38.11%,1
高雄市,鼓山區,0768,344,182,526,15,541,959,56.41%,35.87%,1
高雄市,左營區,0534,570,310,880,35,915,2604,35.14%,21.89%,1
高雄市,楠梓區,0435,534,280,814,25,839,1309,64.09%,40.79%,1
高雄市,三民區,0887,660,396,1056,59,1115,1893,58.9%,34.87%,1
高雄市,新興區,1098,291,186,477,24,501,828,60.51%,35.14%,1
高雄市,前金區,1076,257,152,409,13,422,673,62.7%,38.19%,1
高雄市,苓雅區,1140,300,145,445,14,459,718,63.93%,41.78%,1
高雄市,前鎮區,1484,655,339,994,68,1062,1809,58.71%,36.21%,1
高雄市,旗津區,0869,447,260,707,43,750,1177,63.72%,37.98%,1
高雄市,小港區,1603,465,235,700,21,721,1108,65.07%,41.97%,1
高雄市,鳳山區,1256,421,262,683,40,723,1080,66.94%,38.98%,1
高雄市,林園區,1773,458,278,736,39,775,1262,61.41%,36.29%,1
高雄市,大寮區,1692,226,145,371,23,394,727,54.2%,31.09%,1
高雄市,大樹區,0736,447,326,773,19,792,1386,57.14%,32.25%,1
高雄市,大社區,0637,270,217,487,53,540,950,56.84%,28.42%,1
高雄市,仁武區,0661,781,385,1166,27,1193,1777,67.14%,43.95%,1
高雄市,鳥松區,0708,612,338,950,50,1000,1678,59.59%,36.47%,1
高雄市,岡山區,0261,569,300,869,23,892,1345,66.32%,42.3%,1
高雄市,橋頭區,0404,398,228,626,54,680,1005,67.66%,39.6%,1
高雄市,燕巢區,0333,369,237,606,59,665,1152,57.73%,32.03%,1
高雄市,田寮區,0237,99,67,166,6,172,369,46.61%,26.83%,1
高雄市,阿蓮區,0216,360,253,613,30,643,1299,49.5%,27.71%,1
高雄市,路竹區,0175,343,201,544,17,561,1026,54.68%,33.43%,1
高雄市,湖內區,0151,377,200,577,39,616,1112,55.4%,33.9%,1
高雄市,茄萣區,0130,302,187,489,14,503,976,51.54%,30.94%,1
高雄市,永安區,0249,331,150,481,23,504,756,66.67%,43.78%,1
高雄市,彌陀區,0358,445,274,719,38,757,1246,60.75%,35.71%,1
高雄市,梓官區,0376,412,215,627,41,668,1061,62.96%,38.83%,1
高雄市,旗山區,0060,368,246,614,25,639,1060,60.28%,34.72%,1
高雄市,美濃區,0095,434,195,629,60,689,1175,58.64%,36.94%,1
高雄市,六龜區,0020,222,136,358,28,386,760,50.79%,29.21%,1
高雄市,甲仙區,0013,121,57,178,9,187,472,39.62%,25.64%,1
高雄市,杉林區,0032,174,113,287,32,319,640,49.84%,27.19%,1
高雄市,內門區,0042,286,162,448,36,484,969,49.95%,29.51%,1
高雄市,茂林區,0127,194,142,336,20,356,507,70.22%,38.26%,1
高雄市,桃源區,0001,67,54,121,1,122,264,46.21%,25.38%,1
高雄市,那瑪夏區,0009,319,153,472,21,493,741,66.53%,43.05%,1
新竹縣,竹北市,0001,524,310,834,19,853,1319,64.67%,39.73%,1
新竹縣,竹東鎮,0104,85,64,149,6,155,309,50.16%,27.51%,1
新竹縣,新埔鎮,0176,364,200,564,25,589,983,59.92%,37.03%,1
新竹縣,關西鎮,0206,175,120,295,13,308,480,64.17%,36.46%,1
新竹縣,湖口鄉,0233,409,279,688,36,724,1393,51.97%,29.36%,1
新竹縣,新豐鄉,0280,336,206,542,36,578,1080,53.52%,31.11%,1
新竹縣,芎林鄉,0319,140,92,232,15,247,417,59.23%,33.57%,1
新竹縣,橫山鄉,0338,403,286,689,62,751,1231,61.01%,32.74%,1
新竹縣,北埔鄉,0354,377,215,592,21,613,1158,52.94%,32.56%,1
新竹縣,寶山鄉,0364,390,248,638,47,685,1158,59.15%,33.68%,1
新竹縣,峨眉鄉,0376,341,195,536,39,575,879,65.42%,38.79%,1
新竹縣,尖石鄉,0384,156,90,246,5,251,474,52.95%,32.91%,1
新竹縣,五峰鄉,0399,287,130,417,15,432,672,64.29%,42.71%,1
苗栗縣,苗栗市,0001,381,221,602,25,627,1087,57.68%,35.05%,1
苗栗縣,苑裡鎮,0183,319,170,489,34,523,873,59.91%,36.54%,1
苗栗縣,通霄鎮,0149,384,247,631,41,672,1142,58.84%,33.63%,1
苗栗縣,竹南鎮,0270,374,261,635,22,657,1086,60.5%,34.44%,1
苗栗縣,頭份市,0331,301,149,450,48,498,915,54.43%,32.9%,1
苗栗縣,後龍鎮,0223,206,118,324,25,349,590,59.15%,34.92%,1
苗栗縣,卓蘭鎮,0442,431,114,545,39,584,961,60.77%,44.85%,1
苗栗縣,大湖鄉,0420,239,144,383,23,406,744,54.57%,32.12%,1
苗栗縣,公館鄉,0068,298,195,493,30,523,789,66.29%,37.77%,1
苗栗縣,銅鑼鄉,0108,313,201,514,34,548,887,61.78%,35.29%,1
苗栗縣,南庄鄉,0411,331,270,601,41,642,1155,55.58%,28.66%,1
苗栗縣,頭屋鄉,0096,551,284,835,59,894,1335,66.97%,41.27%,1
苗栗縣,三義鄉,0124,327,163,490,34,524,853,61.43%,38.34%,1
苗栗縣,西湖鄉,0140,167,152,319,23,342,601,56.91%,27.79%,1
苗栗縣,造橋鄉,0258,471,254,725,45,770,1171,65.76%,40.22%,1
苗栗縣,三灣鄉,0402,344,227,571,25,596,996,59.84%,34.54%,1
苗栗縣,獅潭鄉,0435,77,46,123,7,130,328,39.63%,23.48%,1
苗栗縣,泰安鄉,0461,72,70,142,7,149,325,45.85%,22.15%,1
彰化縣,彰化市,0001,315,101,416,17,433,871,49.71%,36.17%,1
彰化縣,鹿港鎮,0243,411,275,686,33,719,1140,63.07%,36.05%,1
彰化縣,和美鎮,0373,432,273,705,36,741,1341,55.26%,32.21%,1
彰化縣,線西鄉,0469,391,216,607,24,631,1071,58.92%,36.51%,1
彰化縣,伸港鄉,0441,321,239,560,49,609,1182,51.52%,27.16%,1
彰化縣,福興鄉,0308,402,326,728,39,767,1363,56.27%,29.49%,1
彰化縣,秀水鄉,0341,572,27,599,68,667,1066,62.57%,53.66%,1
彰化縣,花壇鄉,0185,356,171,527,26,553,901,61.38%,39.51%,1
彰化縣,芬園鄉,0222,345,174,519,19,538,958,56.16%,36.01%,1
彰化縣,員林市,0481,361,186,547,16,563,1087,51.79%,33.21%,1
彰化縣,溪湖鎮,0640,380,265,645,29,674,1221,55.2%,31.12%,1
彰化縣,田中鎮,0742,279,166,445,36,481,854,56.32%,32.67%,1
彰化縣,大村鄉,0579,493,361,854,53,907,1426,63.6%,34.57%,1
彰化縣,埔鹽鄉,0682,356,211,567,29,596,958,62.21%,37.16%,1
彰化縣,埔心鄉,0711,374,293,667,47,714,1139,62.69%,32.84%,1
彰化縣,永靖鄉,0606,366,249,615,49,664,1255,52.91%,29.16%,1
彰化縣,社頭鄉,0778,228,212,440,27,467,791,59.04%,28.82%,1
彰化縣,二水鄉,0816,306,238,544,65,609,1028,59.24%,29.77%,1
彰化縣,北斗鎮,0833,331,146,477,45,522,925,56.43%,35.78%,1
彰化縣,二林鎮,0942,182,111,293,31,324,731,44.32%,24.9%,1
彰化縣,田尾鄉,0863,378,248,626,45,671,1284,52.26%,29.44%,1
彰化縣,埤頭鄉,0888,340,186,526,45,571,1178,48.47%,28.86%,1
彰化縣,芳苑鄉,0998,183,117,300,37,337,940,35.85%,19.47%,1
彰化縣,大城鄉,0981,263,166,429,26,455,1288,35.33%,20.42%,1
彰化縣,竹塘鄉,1034,388,244,632,48,680,1168,58.22%,33.22%,1
彰化縣,溪州鄉,0915,264,141,405,27,432,778,55.53%,33.93%,1
南投縣,南投市,0001,343,205,548,21,569,927,61.38%,37%,1
南投縣,埔里鎮,0085,277,192,469,33,502,828,60.63%,33.45%,1
南投縣,草屯鎮,0153,385,225,610,18,628,998,62.93%,38.58%,1
南投縣,竹山鎮,0229,408,247,655,50,705,1170,60.26%,34.87%,1
南投縣,集集鎮,0282,355,266,621,30,651,1070,60.84%,33.18%,1
南投縣,名間鄉,0295,388,310,698,34,732,1050,69.71%,36.95%,1
南投縣,鹿谷鄉,0332,293,155,448,38,486,934,52.03%,31.37%,1
南投縣,中寮鄉,0353,278,183,461,44,505,822,61.44%,33.82%,1
南投縣,魚池鄉,0377,275,220,495,37,532,922,57.7%,29.83%,1
南投縣,國姓鄉,0402,333,224,557,44,601,964,62.34%,34.54%,1
南投縣,水里鄉,0422,242,151,393,30,423,757,55.88%,31.97%,1
南投縣,信義鄉,0444,445,195,640,40,680,1201,56.62%,37.05%,1
南投縣,仁愛鄉,0464,436,121,557,23,580,973,59.61%,44.81%,1
雲林縣,斗六市,0411,192,149,341,16,357,644,55.43%,29.81%,1
雲林縣,斗南鎮,0498,413,271,684,30,714,1166,61.23%,35.42%,1
雲林縣,虎尾鎮,0109,415,294,709,35,744,1347,55.23%,30.81%,1
雲林縣,西螺鎮,0340,452,335,787,58,845,1590,53.14%,28.43%,1
雲林縣,土庫鎮,0080,273,204,477,39,516,809,63.78%,33.75%,1
雲林縣,北港鎮,0256,244,139,383,45,428,724,59.12%,33.7%,1
雲林縣,古坑鄉,0531,355,244,599,30,629,1126,55.86%,31.53%,1
雲林縣,大埤鄉,0480,212,164,376,27,403,750,53.73%,28.27%,1
雲林縣,莿桐鄉,0374,475,325,800,50,850,1507,56.4%,31.52%,1
雲林縣,林內鄉,0396,393,221,614,42,656,1036,63.32%,37.93%,1
雲林縣,二崙鄉,0317,354,298,652,34,686,1463,46.89%,24.2%,1
雲林縣,崙背鄉,0297,375,235,610,52,662,1176,56.29%,31.89%,1
雲林縣,麥寮鄉,0001,351,250,601,57,658,1497,43.95%,23.45%,1
雲林縣,東勢鄉,0051,273,225,498,46,544,1207,45.07%,22.62%,1
雲林縣,褒忠鄉,0066,293,182,475,47,522,923,56.55%,31.74%,1
雲林縣,臺西鄉,0029,395,242,637,47,684,1238,55.25%,31.91%,1
雲林縣,元長鄉,0180,304,139,443,21,464,915,50.71%,33.22%,1
雲林縣,四湖鄉,0155,266,174,440,41,481,1082,44.45%,24.58%,1
雲林縣,口湖鄉,0205,309,252,561,48,609,1134,53.7%,27.25%,1
雲林縣,水林鄉,0230,326,303,629,47,676,1355,49.89%,24.06%,1
嘉義縣,太保市,0001,391,252,643,37,680,1210,56.2%,32.31%,1
嘉義縣,朴子市,0233,371,257,628,18,646,1183,54.61%,31.36%,1
嘉義縣,布袋鎮,0325,206,91,297,13,310,614,50.49%,33.55%,1
嘉義縣,大林鎮,0169,160,90,250,20,270,483,55.9%,33.13%,1
嘉義縣,民雄鄉,0093,423,270,693,39,732,1267,57.77%,33.39%,1
嘉義縣,溪口鄉,0194,457,256,713,52,765,1318,58.04%,34.67%,1
嘉義縣,新港鄉,0138,364,208,572,30,602,1087,55.38%,33.49%,1
嘉義縣,六腳鄉,0268,312,179,491,32,523,1165,44.89%,26.78%,1
嘉義縣,東石鄉,0298,569,301,870,66,936,1915,48.88%,29.71%,1
嘉義縣,義竹鄉,0354,147,65,212,21,233,482,48.34%,30.5%,1
嘉義縣,鹿草鄉,0034,127,83,210,34,244,522,46.74%,24.33%,1
嘉義縣,水上鄉,0054,320,182,502,19,521,1024,50.88%,31.25%,1
嘉義縣,中埔鄉,0380,228,196,424,18,442,1046,42.26%,21.8%,1
嘉義縣,竹崎鄉,0414,429,263,692,41,733,1312,55.87%,32.7%,1
嘉義縣,梅山鄉,0211,308,219,527,24,551,1041,52.93%,29.59%,1
嘉義縣,番路鄉,0450,398,267,665,48,713,1174,60.73%,33.9%,1
嘉義縣,大埔鄉,0465,469,291,760,48,808,1468,55.04%,31.95%,1
嘉義縣,阿里山鄉,0474,106,72,178,4,182,371,49.06%,28.57%,1
屏東縣,屏東市,0001,72,47,119,9,128,237,54.01%,30.38%,1
屏東縣,潮州鎮,0150,179,109,288,17,305,504,60.52%,35.52%,1
屏東縣,東港鎮,0190,369,190,559,34,593,981,60.45%,37.61%,1
屏東縣,恆春鎮,0228,253,177,430,20,450,902,49.89%,28.05%,1
屏東縣,萬丹鄉,0253,415,238,653,31,684,1527,44.79%,27.18%,1
屏東縣,長治鄉,0292,330,204,534,39,573,1018,56.29%,32.42%,1
屏東縣,麟洛鄉,0314,236,181,417,32,449,788,56.98%,29.95%,1
屏東縣,九如鄉,0324,462,319,781,55,836,1491,56.07%,30.99%,1
屏東縣,里港鄉,0338,533,312,845,70,915,1552,58.96%,34.34%,1
屏東縣,鹽埔鄉,0358,326,151,477,29,506,951,53.21%,34.28%,1
屏東縣,高樹鄉,0378,306,183,489,66,555,883,62.85%,34.65%,1
屏東縣,萬巒鄉,0400,269,326,595,33,628,1239,50.69%,21.71%,1
屏東縣,內埔鄉,0418,333,241,574,32,606,1305,46.44%,25.52%,1
屏東縣,竹田鄉,0458,501,290,791,54,845,1503,56.22%,33.33%,1
屏東縣,新埤鄉,0474,504,311,815,37,852,1712,49.77%,29.44%,1
屏東縣,枋寮鄉,0486,387,252,639,45,684,1213,56.39%,31.9%,1
屏東縣,新園鄉,0508,248,190,438,34,472,820,57.56%,30.24%,1
屏東縣,崁頂鄉,0536,343,212,555,35,590,1190,49.58%,28.82%,1
屏東縣,林邊鄉,0548,524,277,801,68,869,1458,59.6%,35.94%,1
屏東縣,南州鄉,0564,283,142,425,51,476,872,54.59%,32.45%,1
屏東縣,佳冬鄉,0575,376,270,646,41,687,1472,46.67%,25.54%,1
屏東縣,琉球鄉,0591,275,177,452,19,471,1111,42.39%,24.75%,1
屏東縣,車城鄉,0600,149,129,278,32,310,737,42.06%,20.22%,1
屏東縣,滿州鄉,0613,364,342,706,1,707,1575,44.89%,23.11%,1
屏東縣,枋山鄉,0621,262,72,334,32,366,604,60.6%,43.38%,1
屏東縣,三地門鄉,0627,205,104,309,9,318,616,51.62%,33.28%,1
屏東縣,霧臺鄉,0637,171,89,260,11,271,346,78.32%,49.42%,1
屏東縣,瑪家鄉,0645,143,101,244,4,248,455,54.51%,31.43%,1
屏東縣,泰武鄉,0653,270,137,407,8,415,669,62.03%,40.36%,1
屏東縣,來義鄉,0660,413,150,563,61,624,917,68.05%,45.04%,1
屏東縣,春日鄉,0669,270,120,390,8,398,909,43.78%,29.7%,1
屏東縣,獅子鄉,0675,307,104,411,12,423,751,56.32%,40.88%,1
屏東縣,牡丹鄉,0683,79,62,141,2,143,342,41.81%,23.1%,1
宜蘭縣,宜蘭市,0001,307,213,520,13,533,982,54.28%,31.26%,1
宜蘭縣,羅東鎮,0079,219,165,384,23,407,689,59.07%,31.79%,1
宜蘭縣,蘇澳鎮,0129,345,299,644,31,675,1194,56.53%,28.89%,1
宜蘭縣,頭城鎮,0172,58,37,95,12,107,292,36.64%,19.86%,1
宜蘭縣,礁溪鄉,0204,320,212,532,29,561,1122,50%,28.52%,1
宜蘭縣,壯圍鄉,0236,499,315,814,57,871,1435,60.7%,34.77%,1
宜蘭縣,員山鄉,0259,396,293,689,38,727,1393,52.19%,28.43%,1
宜蘭縣,冬山鄉,0290,258,184,442,44,486,807,60.22%,31.97%,1
宜蘭縣,五結鄉,0329,303,213,516,36,552,1076,51.3%,28.16%,1
宜蘭縣,三星鄉,0362,72,39,111,8,119,215,55.35%,33.49%,1
宜蘭縣,大同鄉,0383,409,140,549,31,580,893,64.95%,45.8%,1
宜蘭縣,南澳鄉,0393,186,96,282,4,286,444,64.41%,41.89%,1
花蓮縣,花蓮市,0001,553,298,851,17,868,1522,57.03%,36.33%,1
花蓮縣,鳳林鎮,0195,445,243,688,49,737,1192,61.83%,37.33%,1
花蓮縣,玉里鎮,0254,319,197,516,32,548,1008,54.37%,31.65%,1
花蓮縣,新城鄉,0082,110,86,196,16,212,367,57.77%,29.97%,1
花蓮縣,吉安鄉,0115,333,199,532,28,560,1059,52.88%,31.44%,1
花蓮縣,壽豐鄉,0174,327,182,509,35,544,1052,51.71%,31.08%,1
花蓮縣,光復鄉,0210,445,239,684,47,731,1295,56.45%,34.36%,1
花蓮縣,豐濱鄉,0227,193,128,321,30,351,717,48.95%,26.92%,1
花蓮縣,瑞穗鄉,0241,291,144,435,39,474,813,58.3%,35.79%,1
花蓮縣,富里鄉,0277,92,98,190,20,210,467,44.97%,19.7%,1
花蓮縣,秀林鄉,0101,236,193,429,24,453,867,52.25%,27.22%,1
花蓮縣,萬榮鄉,0234,349,206,555,49,604,1072,56.34%,32.56%,1
花蓮縣,卓溪鄉,0290,153,132,285,13,298,533,55.91%,28.71%,1
臺東縣,臺東市,0001,267,147,414,22,436,874,49.89%,30.55%,1
臺東縣,成功鎮,0070,124,104,228,30,258,516,50%,24.03%,1
臺東縣,關山鎮,0087,316,189,505,34,539,909,59.3%,34.76%,1
臺東縣,卑南鄉,0096,350,218,568,38,606,1041,58.21%,33.62%,1
臺東縣,鹿野鄉,0118,107,80,187,10,197,522,37.74%,20.5%,1
臺東縣,池上鄉,0128,262,186,448,30,478,992,48.19%,26.41%,1
臺東縣,東河鄉,0140,65,44,109,19,128,290,44.14%,22.41%,1
臺東縣,長濱鄉,0151,160,114,274,35,309,536,57.65%,29.85%,1
臺東縣,太麻里鄉,0162,225,129,354,32,386,722,53.46%,31.16%,1
臺東縣,大武鄉,0177,266,71,337,14,351,568,61.8%,46.83%,1
臺東縣,綠島鄉,0183,376,240,616,18,634,1474,43.01%,25.51%,1
臺東縣,海端鄉,0187,150,102,252,11,263,497,52.92%,30.18%,1
臺東縣,延平鄉,0193,335,191,526,34,560,1014,55.23%,33.04%,1
臺東縣,金峰鄉,0198,472,218,690,32,722,1241,58.18%,38.03%,1
臺東縣,達仁鄉,0203,117,34,151,3,154,246,62.6%,47.56%,1
臺東縣,蘭嶼鄉,0210,192,182,374,21,395,943,41.89%,20.36%,1
澎湖縣,馬公市,0001,135,81,216,10,226,481,46.99%,28.07%,1
澎湖縣,湖西鄉,0051,367,182,549,35,584,1120,52.14%,32.77%,1
澎湖縣,白沙鄉,0074,141,106,247,10,257,514,50%,27.43%,1
澎湖縣,西嶼鄉,0089,31,18,49,1,50,283,17.67%,10.95%,1
澎湖縣,望安鄉,0101,188,119,307,24,331,734,45.1%,25.61%,1
澎湖縣,七美鄉,0111,28,33,61,6,67,248,27.02%,11.29%,1
金門縣,金城鎮,0001,311,169,480,24,504,1396,36.1%,22.28%,1
金門縣,金沙鎮,0066,420,200,620,36,656,1909,34.36%,22%,1
金門縣,金湖鎮,0049,333,187,520,20,540,1348,40.06%,24.7%,1
金門縣,金寧鄉,0022,325,168,493,48,541,1735,31.18%,18.73%,1
金門縣,烈嶼鄉,0039,466,216,682,40,722,1647,43.84%,28.29%,1
金門縣,烏坵鄉,0047,49,26,75,3,78,275,28.36%,17.82%,1
連江縣,南竿鄉,0001,626,345,971,43,1014,1967,51.55%,31.83%,1
連江縣,北竿鄉,0005,514,263,777,37,814,1515,53.73%,33.93%,1
連江縣,莒光鄉,0007,203,133,336,15,351,698,50.29%,29.08%,1
連江縣,東引鄉,0009,325,225,550,28,578,1138,50.79%,28.56%,1
基隆市,中正區,0001,148,92,240,16,256,466,54.94%,31.76%,1
基隆市,七堵區,0219,480,218,698,38,736,1258,58.51%,38.16%,1
基隆市,暖暖區,0191,392,287,679,30,709,1431,49.55%,27.39%,1
基隆市,仁愛區,0072,481,280,761,76,837,1782,46.97%,26.99%,1
基隆市,中山區,0107,224,168,392,24,416,796,52.26%,28.14%,1
基隆市,安樂區,0142,390,239,629,52,681,1361,50.04%,28.66%,1
基隆市,信義區,0036,362,227,589,26,615,1096,56.11%,33.03%,1
新竹市,東區,0001,289,213,502,16,518,1512,34.26%,19.11%,1
新竹市,北區,0140,147,108,255,14,269,477,56.39%,30.82%,1
新竹市,香山區,0245,472,282,754,29,783,1443,54.26%,32.71%,1
嘉義市,東區,0001,359,214,573,20,593,1025,57.85%,35.02%,1
嘉義市,西區,0082,292,192,484,12,496,885,56.05%,32.99%,1
