縣市,鄉鎮市區,開票所,同意票,不同意票,有效票,無效票,投票數,投票權人數,投票率,投票權人數百分比,總數
臺北市,松山區,0527,552,368,920,28,948,1583,59.89%,34.87%,1
臺北市,松山區,0528,561,375,936,45,981,1691,58.01%,33.18%,1
臺北市,松山區,0529,448,313,761,32,793,1386,57.22%,32.32%,1
臺北市,松山區,0530,460,314,774,51,825,1362,60.57%,33.77%,1
臺北市,松山區,0531,485,320,805,41,846,1399,60.47%,34.67%,1
臺北市,松山區,0532,455,304,759,56,815,1324,61.56%,34.37%,1
臺北市,松山區,0533,482,320,802,28,830,1296,64.04%,37.19%,1
臺北市,松山區,0534,518,304,822,31,853,1386,61.54%,37.37%,1
臺北市,松山區,0535,527,383,910,57,967,1529,63.24%,34.47%,1
臺北市,松山區,0536,487,306,793,35,828,1416,58.47%,34.39%,1
臺北市,松山區,0537,521,335,856,51,907,1619,56.02%,32.18%,1
臺北市,松山區,0538,501,332,833,31,864,1386,62.34%,36.15%,1
臺北市,松山區,0539,469,387,856,29,885,1380,64.13%,33.99%,1
臺北市,松山區,0540,477,329,806,28,834,1357,61.46%,35.15%,1
臺北市,松山區,0541,442,350,792,21,813,1296,62.73%,34.1%,1
臺北市,松山區,0542,550,367,917,68,985,1632,60.36%,33.7%,1
臺北市,松山區,0543,490,307,797,31,828,1414,58.56%,34.65%,1
臺北市,松山區,0544,484,340,824,32,856,1404,60.97%,34.47%,1
臺北市,松山區,0545,501,301,802,51,853,1365,62.49%,36.7%,1
臺北市,松山區,0546,467,360,827,38,865,1431,60.45%,32.63%,1
臺北市,松山區,0547,494,374,868,44,912,1483,61.5%,33.31%,1
臺北市,松山區,0548,468,314,782,36,818,1293,63.26%,36.19%,1
臺北市,松山區,0549,536,233,769,37,806,1410,57.16%,38.01%,1
臺北市,松山區,0550,452,298,750,42,792,1307,60.6%,34.58%,1
臺北市,松山區,0551,457,301,758,36,794,1242,63.93%,36.8%,1
臺北市,松山區,0552,438,271,709,31,740,1192,62.08%,36.74%,1
臺北市,松山區,0553,467,297,764,39,803,1276,62.93%,36.6%,1
臺北市,松山區,0554,411,285,696,18,714,1201,59.45%,34.22%,1
臺北市,松山區,0555,451,315,766,30,796,1318,60.39%,34.22%,1
臺北市,松山區,0556,436,258,694,24,718,1157,62.06%,37.68%,1
臺北市,松山區,0557,389,281,670,15,685,1157,59.2%,33.62%,1
臺北市,松山區,0558,484,323,807,36,843,1357,62.12%,35.67%,1
臺北市,松山區,0559,401,251,652,22,674,1215,55.47%,33%,1
臺北市,松山區,0560,452,303,755,31,786,1345,58.44%,33.61%,1
臺北市,松山區,0561,414,294,708,41,749,1237,60.55%,33.47%,1
臺北市,松山區,0562,537,296,833,41,874,1393,62.74%,38.55%,1
臺北市,松山區,0563,507,335,842,26,868,1331,65.21%,38.09%,1
臺北市,松山區,0564,537,400,937,43,980,1550,63.23%,34.65%,1
臺北市,松山區,0565,480,244,724,18,742,1308,56.73%,36.7%,1
臺北市,松山區,0566,509,331,840,38,878,1490,58.93%,34.16%,1
臺北市,松山區,0567,552,308,860,38,898,1406,63.87%,39.26%,1
臺北市,松山區,0568,408,336,744,30,774,1191,64.99%,34.26%,1
臺北市,松山區,0569,373,263,636,42,678,1095,61.92%,34.06%,1
臺北市,松山區,0570,405,262,667,46,713,1198,59.52%,33.81%,1
臺北市,松山區,0571,461,253,714,35,749,1265,59.21%,36.44%,1
臺北市,松山區,0572,412,285,697,27,724,1225,59.1%,33.63%,1
臺北市,松山區,0573,618,383,1001,51,1052,1698,61.96%,36.4%,1
臺北市,松山區,0574,646,365,1011,39,1050,1819,57.72%,35.51%,1
臺北市,松山區,0575,588,420,1008,48,1056,1754,60.21%,33.52%,1
臺北市,松山區,0576,436,381,817,40,857,1361,62.97%,32.04%,1
臺北市,松山區,0577,456,266,722,22,744,1189,62.57%,38.35%,1
臺北市,松山區,0578,432,283,715,32,747,1214,61.53%,35.58%,1
臺北市,松山區,0579,451,293,744,26,770,1284,59.97%,35.12%,1
臺北市,松山區,0580,452,314,766,41,807,1297,62.22%,34.85%,1
臺北市,松山區,0581,411,339,750,31,781,1330,58.72%,30.9%,1
臺北市,松山區,0582,534,301,835,36,871,1396,62.39%,38.25%,1
臺北市,松山區,0583,534,300,834,20,854,1480,57.7%,36.08%,1
臺北市,松山區,0584,528,310,838,26,864,1419,60.89%,37.21%,1
臺北市,松山區,0585,498,322,820,30,850,1390,61.15%,35.83%,1
臺北市,松山區,0586,502,379,881,39,920,1525,60.33%,32.92%,1
臺北市,松山區,0587,532,350,882,35,917,1633,56.15%,32.58%,1
臺北市,松山區,0588,484,396,880,24,904,2677,33.77%,18.08%,1
臺北市,松山區,0589,406,323,729,42,771,1281,60.19%,31.69%,1
臺北市,松山區,0590,393,298,691,32,723,1469,49.22%,26.75%,1
臺北市,松山區,0591,516,386,902,67,969,1700,57%,30.35%,1
臺北市,松山區,0592,447,344,791,39,830,1503,55.22%,29.74%,1
臺北市,松山區,0593,421,330,751,28,779,1309,59.51%,32.16%,1
臺北市,松山區,0594,458,324,782,56,838,1376,60.9%,33.28%,1
臺北市,松山區,0595,588,361,949,33,982,1654,59.37%,35.55%,1
臺北市,松山區,0596,470,390,860,52,912,1601,56.96%,29.36%,1
臺北市,松山區,0597,497,353,850,34,884,1496,59.09%,33.22%,1
臺北市,松山區,0598,546,408,954,62,1016,1598,63.58%,34.17%,1
臺北市,松山區,0599,635,386,1021,41,1062,1751,60.65%,36.26%,1
臺北市,松山區,0600,588,350,938,36,974,1557,62.56%,37.76%,1
臺北市,松山區,0601,705,351,1056,40,1096,1686,65.01%,41.81%,1
臺北市,松山區,0602,664,334,998,49,1047,1707,61.34%,38.9%,1
臺北市,松山區,0603,737,413,1150,45,1195,1854,64.46%,39.75%,1
臺北市,松山區,0604,546,399,945,35,980,1740,56.32%,31.38%,1
臺北市,松山區,0605,477,362,839,51,890,1494,59.57%,31.93%,1
臺北市,松山區,0606,506,332,838,42,880,1453,60.56%,34.82%,1
臺北市,松山區,0607,499,341,840,39,879,1458,60.29%,34.22%,1
臺北市,松山區,0608,474,398,872,29,901,1536,58.66%,30.86%,1
臺北市,松山區,0609,520,337,857,26,883,1463,60.36%,35.54%,1
臺北市,松山區,0610,477,441,918,31,949,1790,53.02%,26.65%,1
臺北市,松山區,0611,552,426,978,42,1020,1679,60.75%,32.88%,1
臺北市,松山區,0612,508,387,895,44,939,1785,52.61%,28.46%,1
臺北市,松山區,0613,537,427,964,41,1005,1793,56.05%,29.95%,1
臺北市,松山區,0614,560,212,772,46,818,1381,59.23%,40.55%,1
臺北市,松山區,0615,424,319,743,34,777,1279,60.75%,33.15%,1
臺北市,松山區,0616,558,406,964,46,1010,1681,60.08%,33.19%,1
臺北市,松山區,0617,431,309,740,39,779,1232,63.23%,34.98%,1
臺北市,松山區,0618,510,349,859,30,889,1533,57.99%,33.27%,1
臺北市,松山區,0619,536,385,921,32,953,1540,61.88%,34.81%,1
臺北市,松山區,0620,564,403,967,26,993,1716,57.87%,32.87%,1
臺北市,松山區,0621,504,387,891,40,931,1664,55.95%,30.29%,1
臺北市,松山區,0622,434,313,747,28,775,1350,57.41%,32.15%,1
臺北市,松山區,0623,610,403,1013,36,1049,1837,57.1%,33.21%,1
臺北市,松山區,0624,464,343,807,49,856,1558,54.94%,29.78%,1
臺北市,松山區,0625,509,326,835,42,877,1420,61.76%,35.85%,1
臺北市,松山區,0626,493,320,813,34,847,1474,57.46%,33.45%,1
臺北市,松山區,0627,541,334,875,42,917,1591,57.64%,34%,1
臺北市,松山區,0628,479,476,955,48,1003,1726,58.11%,27.75%,1
臺北市,松山區,0629,761,59,820,28,848,1452,58.4%,52.41%,1
臺北市,松山區,0630,493,323,816,25,841,1482,56.75%,33.27%,1
臺北市,松山區,0631,496,345,841,39,880,1460,60.27%,33.97%,1
臺北市,松山區,0632,452,328,780,28,808,1398,57.8%,32.33%,1
臺北市,松山區,0633,509,329,838,40,878,1423,61.7%,35.77%,1
臺北市,松山區,0634,436,285,721,22,743,1226,60.6%,35.56%,1
臺北市,松山區,0635,415,249,664,39,703,1158,60.71%,35.84%,1
臺北市,松山區,0636,439,359,798,26,824,1426,57.78%,30.79%,1
臺北市,松山區,0637,420,277,697,16,713,1177,60.58%,35.68%,1
臺北市,松山區,0638,449,321,770,29,799,1363,58.62%,32.94%,1
臺北市,松山區,0639,464,273,737,35,772,1240,62.26%,37.42%,1
臺北市,松山區,0640,475,347,822,38,860,1375,62.55%,34.55%,1
臺北市,松山區,0641,432,359,791,35,826,1377,59.99%,31.37%,1
臺北市,松山區,0642,379,277,656,24,680,1225,55.51%,30.94%,1
臺北市,松山區,0643,342,288,630,25,655,1017,64.41%,33.63%,1
臺北市,信義區,0644,483,306,789,26,815,2476,32.92%,19.51%,1
臺北市,信義區,0645,542,314,856,27,883,1381,63.94%,39.25%,1
臺北市,信義區,0646,500,270,770,47,817,1294,63.14%,38.64%,1
臺北市,信義區,0647,452,322,774,33,807,1351,59.73%,33.46%,1
臺北市,信義區,0648,462,295,757,24,781,1296,60.26%,35.65%,1
臺北市,信義區,0649,479,313,792,31,823,1302,63.21%,36.79%,1
臺北市,信義區,0650,343,201,544,44,588,1025,57.37%,33.46%,1
臺北市,信義區,0651,461,292,753,33,786,1421,55.31%,32.44%,1
臺北市,信義區,0652,507,323,830,28,858,1501,57.16%,33.78%,1
臺北市,信義區,0653,450,352,802,23,825,1575,52.38%,28.57%,1
臺北市,信義區,0654,534,313,847,28,875,1516,57.72%,35.22%,1
臺北市,信義區,0655,506,314,820,21,841,1382,60.85%,36.61%,1
臺北市,信義區,0656,396,231,627,35,662,1128,58.69%,35.11%,1
臺北市,信義區,0657,492,271,763,34,797,1397,57.05%,35.22%,1
臺北市,信義區,0658,386,302,688,43,731,1161,62.96%,33.25%,1
臺北市,信義區,0659,436,328,764,40,804,1368,58.77%,31.87%,1
臺北市,信義區,0660,391,225,616,20,636,1049,60.63%,37.27%,1
臺北市,信義區,0661,454,304,758,35,793,1308,60.63%,34.71%,1
臺北市,信義區,0662,387,309,696,36,732,1154,63.43%,33.54%,1
臺北市,信義區,0663,331,311,642,21,663,1078,61.5%,30.71%,1
臺北市,信義區,0664,478,297,775,38,813,1375,59.13%,34.76%,1
臺北市,信義區,0665,513,314,827,41,868,1448,59.94%,35.43%,1
臺北市,信義區,0666,431,303,734,28,762,1250,60.96%,34.48%,1
臺北市,信義區,0667,439,366,805,24,829,1381,60.03%,31.79%,1
臺北市,信義區,0668,423,290,713,37,750,1213,61.83%,34.87%,1
臺北市,信義區,0669,475,349,824,35,859,1373,62.56%,34.6%,1
臺北市,信義區,0670,435,295,730,27,757,1226,61.75%,35.48%,1
臺北市,信義區,0671,388,281,669,17,686,1117,61.41%,34.74%,1
臺北市,信義區,0672,401,275,676,28,704,1123,62.69%,35.71%,1
臺北市,信義區,0673,412,277,689,43,732,1200,61%,34.33%,1
臺北市,信義區,0674,418,269,687,25,712,1335,53.33%,31.31%,1
臺北市,信義區,0675,446,259,705,31,736,1332,55.26%,33.48%,1
臺北市,信義區,0676,551,380,931,57,988,1648,59.95%,33.43%,1
臺北市,信義區,0677,489,347,836,54,890,1542,57.72%,31.71%,1
臺北市,信義區,0678,353,335,688,46,734,1228,59.77%,28.75%,1
臺北市,信義區,0679,556,407,963,43,1006,1731,58.12%,32.12%,1
臺北市,信義區,0680,483,337,820,23,843,1403,60.09%,34.43%,1
臺北市,信義區,0681,629,365,994,74,1068,1929,55.37%,32.61%,1
臺北市,信義區,0682,436,328,764,38,802,1300,61.69%,33.54%,1
臺北市,信義區,0683,454,318,772,26,798,1486,53.7%,30.55%,1
臺北市,信義區,0684,434,321,755,33,788,1532,51.44%,28.33%,1
臺北市,信義區,0685,516,321,837,33,870,1387,62.73%,37.2%,1
臺北市,信義區,0686,368,246,614,42,656,1195,54.9%,30.79%,1
臺北市,信義區,0687,335,250,585,29,614,1068,57.49%,31.37%,1
臺北市,信義區,0688,399,274,673,32,705,1273,55.38%,31.34%,1
臺北市,信義區,0689,466,332,798,44,842,1329,63.36%,35.06%,1
臺北市,信義區,0690,415,301,716,30,746,1311,56.9%,31.66%,1
臺北市,信義區,0691,397,273,670,37,707,1258,56.2%,31.56%,1
臺北市,信義區,0692,432,294,726,48,774,1277,60.61%,33.83%,1
臺北市,信義區,0693,442,332,774,44,818,1285,63.66%,34.4%,1
臺北市,信義區,0694,410,290,700,43,743,1161,64%,35.31%,1
臺北市,信義區,0695,403,330,733,34,767,1299,59.05%,31.02%,1
臺北市,信義區,0696,409,281,690,33,723,1243,58.17%,32.9%,1
臺北市,信義區,0697,378,275,653,43,696,1197,58.15%,31.58%,1
臺北市,信義區,0698,462,289,751,23,774,1224,63.24%,37.75%,1
臺北市,信義區,0699,368,255,623,35,658,1147,57.37%,32.08%,1
臺北市,信義區,0700,448,270,718,21,739,1045,70.72%,42.87%,1
臺北市,信義區,0701,418,271,689,26,715,1096,65.24%,38.14%,1
臺北市,信義區,0702,363,257,620,20,640,1115,57.4%,32.56%,1
臺北市,信義區,0703,371,234,605,42,647,1117,57.92%,33.21%,1
臺北市,信義區,0704,294,220,514,25,539,1019,52.89%,28.85%,1
臺北市,信義區,0705,457,303,760,37,797,1346,59.21%,33.95%,1
臺北市,信義區,0706,476,295,771,31,802,1405,57.08%,33.88%,1
臺北市,信義區,0707,440,306,746,42,788,1356,58.11%,32.45%,1
臺北市,信義區,0708,451,324,775,32,807,1250,64.56%,36.08%,1
臺北市,信義區,0709,448,299,747,32,779,1254,62.12%,35.73%,1
臺北市,信義區,0710,434,317,751,30,781,1317,59.3%,32.95%,1
臺北市,信義區,0711,468,295,763,41,804,1271,63.26%,36.82%,1
臺北市,信義區,0712,301,229,530,33,563,979,57.51%,30.75%,1
臺北市,信義區,0713,320,225,545,30,575,1025,56.1%,31.22%,1
臺北市,信義區,0714,445,290,735,37,772,1512,51.06%,29.43%,1
臺北市,信義區,0715,404,457,861,33,894,1483,60.28%,27.24%,1
臺北市,信義區,0716,457,347,804,28,832,1359,61.22%,33.63%,1
臺北市,信義區,0717,507,317,824,19,843,1387,60.78%,36.55%,1
臺北市,信義區,0718,439,331,770,36,806,1455,55.4%,30.17%,1
臺北市,信義區,0719,472,358,830,30,860,1461,58.86%,32.31%,1
臺北市,信義區,0720,494,381,875,43,918,1532,59.92%,32.25%,1
臺北市,信義區,0721,356,283,639,32,671,1043,64.33%,34.13%,1
臺北市,信義區,0722,325,203,528,30,558,875,63.77%,37.14%,1
臺北市,信義區,0723,305,217,522,23,545,927,58.79%,32.9%,1
臺北市,信義區,0724,388,247,635,52,687,1119,61.39%,34.67%,1
臺北市,信義區,0725,483,240,723,42,765,1463,52.29%,33.01%,1
臺北市,信義區,0726,449,350,799,30,829,1293,64.11%,34.73%,1
臺北市,信義區,0727,493,353,846,35,881,1553,56.73%,31.75%,1
臺北市,信義區,0728,422,351,773,20,793,1360,58.31%,31.03%,1
臺北市,信義區,0729,456,340,796,33,829,1392,59.55%,32.76%,1
臺北市,信義區,0730,454,339,793,18,811,1377,58.9%,32.97%,1
臺北市,信義區,0731,464,332,796,19,815,1377,59.19%,33.7%,1
臺北市,信義區,0732,399,258,657,32,689,1269,54.29%,31.44%,1
臺北市,信義區,0733,464,319,783,64,847,1407,60.2%,32.98%,1
臺北市,信義區,0734,389,274,663,27,690,1172,58.87%,33.19%,1
臺北市,信義區,0735,372,291,663,32,695,1182,58.8%,31.47%,1
臺北市,信義區,0736,433,282,715,46,761,1255,60.64%,34.5%,1
臺北市,信義區,0737,552,331,883,20,903,1689,53.46%,32.68%,1
臺北市,信義區,0738,510,336,846,40,886,1605,55.2%,31.78%,1
臺北市,信義區,0739,379,244,623,31,654,1143,57.22%,33.16%,1
臺北市,信義區,0740,453,303,756,36,792,1440,55%,31.46%,1
臺北市,信義區,0741,501,327,828,31,859,1495,57.46%,33.51%,1
臺北市,信義區,0742,491,385,876,46,922,1514,60.9%,32.43%,1
臺北市,信義區,0743,490,300,790,34,824,1449,56.87%,33.82%,1
臺北市,信義區,0744,469,357,826,35,861,1401,61.46%,33.48%,1
臺北市,信義區,0745,366,270,636,20,656,1181,55.55%,30.99%,1
臺北市,信義區,0746,528,334,862,23,885,1376,64.32%,38.37%,1
臺北市,信義區,0747,514,318,832,44,876,1422,61.6%,36.15%,1
臺北市,信義區,0748,453,274,727,25,752,1267,59.35%,35.75%,1
臺北市,信義區,0749,375,278,653,29,682,1220,55.9%,30.74%,1
臺北市,信義區,0750,496,295,791,33,824,1562,52.75%,31.75%,1
臺北市,信義區,0751,472,340,812,18,830,1455,57.04%,32.44%,1
臺北市,信義區,0752,521,338,859,35,894,1605,55.7%,32.46%,1
臺北市,信義區,0753,515,362,877,24,901,1626,55.41%,31.67%,1
臺北市,信義區,0754,531,374,905,36,941,1561,60.28%,34.02%,1
臺北市,信義區,0755,412,350,762,23,785,1547,50.74%,26.63%,1
臺北市,信義區,0756,434,310,744,22,766,1336,57.34%,32.49%,1
臺北市,信義區,0757,411,268,679,24,703,1314,53.5%,31.28%,1
臺北市,信義區,0758,432,269,701,29,730,1297,56.28%,33.31%,1
臺北市,信義區,0759,432,290,722,40,762,1366,55.78%,31.63%,1
臺北市,信義區,0760,468,331,799,45,844,1472,57.34%,31.79%,1
臺北市,信義區,0761,477,323,800,39,839,1450,57.86%,32.9%,1
臺北市,信義區,0762,441,300,741,33,774,1328,58.28%,33.21%,1
臺北市,信義區,0763,469,346,815,38,853,1399,60.97%,33.52%,1
臺北市,信義區,0764,480,317,797,49,846,1373,61.62%,34.96%,1
臺北市,信義區,0765,388,219,607,17,624,1099,56.78%,35.3%,1
臺北市,信義區,0766,379,303,682,56,738,1226,60.2%,30.91%,1
臺北市,信義區,0767,404,279,683,12,695,1267,54.85%,31.89%,1
臺北市,信義區,0768,548,319,867,44,911,1531,59.5%,35.79%,1
臺北市,信義區,0769,496,344,840,33,873,1438,60.71%,34.49%,1
臺北市,信義區,0770,494,388,882,30,912,1657,55.04%,29.81%,1
臺北市,信義區,0771,544,379,923,44,967,1621,59.65%,33.56%,1
臺北市,信義區,0772,523,360,883,30,913,1508,60.54%,34.68%,1
臺北市,信義區,0773,469,308,777,38,815,1334,61.09%,35.16%,1
臺北市,信義區,0774,321,246,567,32,599,1246,48.07%,25.76%,1
臺北市,信義區,0775,401,324,725,33,758,1196,63.38%,33.53%,1
臺北市,信義區,0776,419,292,711,30,741,1220,60.74%,34.34%,1
臺北市,信義區,0777,480,357,837,32,869,1538,56.5%,31.21%,1
臺北市,信義區,0778,537,352,889,54,943,1565,60.26%,34.31%,1
臺北市,信義區,0779,473,334,807,67,874,1621,53.92%,29.18%,1
臺北市,信義區,0780,484,313,797,46,843,1486,56.73%,32.57%,1
臺北市,信義區,0781,471,325,796,31,827,1507,54.88%,31.25%,1
臺北市,信義區,0782,503,363,866,37,903,1516,59.56%,33.18%,1
臺北市,信義區,0783,436,309,745,53,798,1287,62%,33.88%,1
臺北市,信義區,0784,325,208,533,35,568,1050,54.1%,30.95%,1
臺北市,信義區,0785,291,175,466,30,496,801,61.92%,36.33%,1
臺北市,大安區,1214,380,250,630,25,655,1184,55.32%,32.09%,1
臺北市,大安區,1215,385,244,629,32,661,1197,55.22%,32.16%,1
臺北市,大安區,1216,386,308,694,18,712,1221,58.31%,31.61%,1
臺北市,大安區,1217,467,248,715,29,744,1246,59.71%,37.48%,1
臺北市,大安區,1218,547,330,877,25,902,1478,61.03%,37.01%,1
臺北市,大安區,1219,403,312,715,40,755,1314,57.46%,30.67%,1
臺北市,大安區,1220,546,379,925,41,966,1594,60.6%,34.25%,1
臺北市,大安區,1221,475,345,820,37,857,1429,59.97%,33.24%,1
臺北市,大安區,1222,533,331,864,28,892,1452,61.43%,36.71%,1
臺北市,大安區,1223,496,389,885,23,908,1551,58.54%,31.98%,1
臺北市,大安區,1224,456,311,767,43,810,1335,60.67%,34.16%,1
臺北市,大安區,1225,366,278,644,23,667,1196,55.77%,30.6%,1
臺北市,大安區,1226,410,309,719,22,741,1339,55.34%,30.62%,1
臺北市,大安區,1227,458,355,813,24,837,1448,57.8%,31.63%,1
臺北市,大安區,1228,461,299,760,38,798,1373,58.12%,33.58%,1
臺北市,大安區,1229,476,318,794,47,841,1439,58.44%,33.08%,1
臺北市,大安區,1230,346,283,629,9,638,1174,54.34%,29.47%,1
臺北市,大安區,1231,360,242,602,17,619,1144,54.11%,31.47%,1
臺北市,大安區,1232,384,194,578,23,601,1119,53.71%,34.32%,1
臺北市,大安區,1233,304,181,485,16,501,1024,48.93%,29.69%,1
臺北市,大安區,1234,393,219,612,17,629,1032,60.95%,38.08%,1
臺北市,大安區,1235,503,255,758,29,787,1319,59.67%,38.13%,1
臺北市,大安區,1236,472,342,814,32,846,1369,61.8%,34.48%,1
臺北市,大安區,1237,438,322,760,34,794,1347,58.95%,32.52%,1
臺北市,大安區,1238,502,342,844,22,866,1655,52.33%,30.33%,1
臺北市,大安區,1239,484,308,792,25,817,1595,51.22%,30.34%,1
臺北市,大安區,1240,442,316,758,30,788,1429,55.14%,30.93%,1
臺北市,大安區,1241,398,296,694,15,709,1309,54.16%,30.4%,1
臺北市,大安區,1242,482,317,799,25,824,1508,54.64%,31.96%,1
臺北市,大安區,1243,370,320,690,44,734,1310,56.03%,28.24%,1
臺北市,大安區,1244,392,247,639,30,669,1233,54.26%,31.79%,1
臺北市,大安區,1245,370,291,661,34,695,1287,54%,28.75%,1
臺北市,大安區,1246,348,240,588,26,614,1147,53.53%,30.34%,1
臺北市,大安區,1247,370,277,647,30,677,1260,53.73%,29.37%,1
臺北市,大安區,1248,432,301,733,31,764,1377,55.48%,31.37%,1
臺北市,大安區,1249,385,287,672,48,720,1284,56.07%,29.98%,1
臺北市,大安區,1250,393,279,672,18,690,1314,52.51%,29.91%,1
臺北市,大安區,1251,390,264,654,29,683,1273,53.65%,30.64%,1
臺北市,大安區,1252,358,294,652,25,677,1146,59.08%,31.24%,1
臺北市,大安區,1253,454,287,741,25,766,1285,59.61%,35.33%,1
臺北市,大安區,1254,459,315,774,17,791,1297,60.99%,35.39%,1
臺北市,大安區,1255,404,253,657,30,687,1101,62.4%,36.69%,1
臺北市,大安區,1256,398,321,719,44,763,1310,58.24%,30.38%,1
臺北市,大安區,1257,460,340,800,44,844,1365,61.83%,33.7%,1
臺北市,大安區,1258,467,306,773,25,798,1372,58.16%,34.04%,1
臺北市,大安區,1259,429,284,713,19,732,1189,61.56%,36.08%,1
臺北市,大安區,1260,430,312,742,30,772,1256,61.46%,34.24%,1
臺北市,大安區,1261,402,262,664,28,692,1151,60.12%,34.93%,1
臺北市,大安區,1262,510,380,890,36,926,1501,61.69%,33.98%,1
臺北市,大安區,1263,558,347,905,22,927,1520,60.99%,36.71%,1
臺北市,大安區,1264,538,375,913,45,958,1529,62.66%,35.19%,1
臺北市,大安區,1265,545,385,930,31,961,1579,60.86%,34.52%,1
臺北市,大安區,1266,373,282,655,24,679,2619,25.93%,14.24%,1
臺北市,大安區,1267,445,290,735,23,758,1290,58.76%,34.5%,1
臺北市,大安區,1268,465,318,783,37,820,1307,62.74%,35.58%,1
臺北市,大安區,1269,491,389,880,31,911,1489,61.18%,32.98%,1
臺北市,大安區,1270,385,272,657,30,687,1097,62.63%,35.1%,1
臺北市,大安區,1271,433,320,753,28,781,1328,58.81%,32.61%,1
臺北市,大安區,1272,377,284,661,20,681,1189,57.28%,31.71%,1
臺北市,大安區,1273,445,278,723,26,749,1270,58.98%,35.04%,1
臺北市,大安區,1274,417,344,761,13,774,1349,57.38%,30.91%,1
臺北市,大安區,1275,409,302,711,19,730,1292,56.5%,31.66%,1
臺北市,大安區,1276,480,295,775,30,805,1314,61.26%,36.53%,1
臺北市,大安區,1277,411,293,704,27,731,1200,60.92%,34.25%,1
臺北市,大安區,1278,505,370,875,12,887,1558,56.93%,32.41%,1
臺北市,大安區,1279,525,350,875,28,903,1561,57.85%,33.63%,1
臺北市,大安區,1280,494,341,835,25,860,1446,59.47%,34.16%,1
臺北市,大安區,1281,502,362,864,23,887,1499,59.17%,33.49%,1
臺北市,大安區,1282,528,329,857,19,876,1467,59.71%,35.99%,1
臺北市,大安區,1283,501,316,817,29,846,1511,55.99%,33.16%,1
臺北市,大安區,1284,550,364,914,55,969,1600,60.56%,34.38%,1
臺北市,大安區,1285,534,366,900,38,938,1573,59.63%,33.95%,1
臺北市,大安區,1286,543,340,883,35,918,1467,62.58%,37.01%,1
臺北市,大安區,1287,455,312,767,36,803,1358,59.13%,33.51%,1
臺北市,大安區,1288,527,343,870,36,906,1568,57.78%,33.61%,1
臺北市,大安區,1289,456,355,811,32,843,1411,59.74%,32.32%,1
臺北市,大安區,1290,539,314,853,21,874,1554,56.24%,34.68%,1
臺北市,大安區,1291,484,312,796,29,825,1345,61.34%,35.99%,1
臺北市,大安區,1292,512,324,836,13,849,1435,59.16%,35.68%,1
臺北市,大安區,1293,577,334,911,20,931,1481,62.86%,38.96%,1
臺北市,大安區,1294,413,503,916,28,944,1451,65.06%,28.46%,1
臺北市,大安區,1295,517,364,881,50,931,1566,59.45%,33.01%,1
臺北市,大安區,1296,501,367,868,29,897,1525,58.82%,32.85%,1
臺北市,大安區,1297,447,291,738,31,769,1336,57.56%,33.46%,1
臺北市,大安區,1298,516,346,862,38,900,1483,60.69%,34.79%,1
臺北市,大安區,1299,437,284,721,21,742,1396,53.15%,31.3%,1
臺北市,大安區,1300,481,348,829,40,869,1406,61.81%,34.21%,1
臺北市,大安區,1301,505,330,835,31,866,1434,60.39%,35.22%,1
臺北市,大安區,1302,432,291,723,33,756,1288,58.7%,33.54%,1
臺北市,大安區,1303,488,310,798,36,834,1407,59.28%,34.68%,1
臺北市,大安區,1304,477,340,817,28,845,1514,55.81%,31.51%,1
臺北市,大安區,1305,476,271,747,35,782,1550,50.45%,30.71%,1
臺北市,大安區,1306,485,349,834,34,868,1490,58.26%,32.55%,1
臺北市,大安區,1307,382,321,703,25,728,1284,56.7%,29.75%,1
臺北市,大安區,1308,389,272,661,25,686,1129,60.76%,34.46%,1
臺北市,大安區,1309,400,288,688,17,705,1193,59.09%,33.53%,1
臺北市,大安區,1310,344,231,575,25,600,1057,56.76%,32.54%,1
臺北市,大安區,1311,432,334,766,30,796,1361,58.49%,31.74%,1
臺北市,大安區,1312,459,303,762,39,801,1412,56.73%,32.51%,1
臺北市,大安區,1313,370,296,666,28,694,1423,48.77%,26%,1
臺北市,大安區,1314,387,270,657,80,737,1257,58.63%,30.79%,1
臺北市,大安區,1315,398,273,671,33,704,1133,62.14%,35.13%,1
臺北市,大安區,1316,350,256,606,23,629,1077,58.4%,32.5%,1
臺北市,大安區,1317,468,287,755,33,788,1300,60.62%,36%,1
臺北市,大安區,1318,449,349,798,52,850,1319,64.44%,34.04%,1
臺北市,大安區,1319,420,284,704,52,756,1265,59.76%,33.2%,1
臺北市,大安區,1320,408,264,672,30,702,1265,55.49%,32.25%,1
臺北市,大安區,1321,385,258,643,26,669,1103,60.65%,34.9%,1
臺北市,大安區,1322,581,191,772,32,804,1341,59.96%,43.33%,1
臺北市,大安區,1323,480,310,790,35,825,1357,60.8%,35.37%,1
臺北市,大安區,1324,432,294,726,25,751,1260,59.6%,34.29%,1
臺北市,大安區,1325,421,304,725,37,762,1295,58.84%,32.51%,1
臺北市,大安區,1326,437,302,739,25,764,1399,54.61%,31.24%,1
臺北市,大安區,1327,375,249,624,33,657,1150,57.13%,32.61%,1
臺北市,大安區,1328,400,286,686,20,706,1351,52.26%,29.61%,1
臺北市,大安區,1329,425,329,754,39,793,1341,59.13%,31.69%,1
臺北市,大安區,1330,375,234,609,21,630,1129,55.8%,33.22%,1
臺北市,大安區,1331,457,280,737,25,762,1328,57.38%,34.41%,1
臺北市,大安區,1332,644,311,955,34,989,1557,63.52%,41.36%,1
臺北市,大安區,1333,555,326,881,44,925,1461,63.31%,37.99%,1
臺北市,大安區,1334,493,296,789,31,820,1589,51.6%,31.03%,1
臺北市,大安區,1335,530,267,797,36,833,1473,56.55%,35.98%,1
臺北市,大安區,1336,446,355,801,37,838,1479,56.66%,30.16%,1
臺北市,大安區,1337,311,181,492,28,520,833,62.42%,37.33%,1
臺北市,大安區,1338,333,218,551,25,576,999,57.66%,33.33%,1
臺北市,大安區,1339,597,419,1016,33,1049,1757,59.7%,33.98%,1
臺北市,大安區,1340,552,353,905,34,939,1573,59.69%,35.09%,1
臺北市,大安區,1341,560,391,951,29,980,1587,61.75%,35.29%,1
臺北市,大安區,1342,497,379,876,38,914,1496,61.1%,33.22%,1
臺北市,大安區,1343,480,357,837,33,870,1440,60.42%,33.33%,1
臺北市,大安區,1344,556,368,924,39,963,1578,61.03%,35.23%,1
臺北市,大安區,1345,411,307,718,18,736,1223,60.18%,33.61%,1
臺北市,大安區,1346,376,273,649,21,670,1119,59.87%,33.6%,1
臺北市,大安區,1347,437,314,751,18,769,1252,61.42%,34.9%,1
臺北市,大安區,1348,543,382,925,33,958,1576,60.79%,34.45%,1
臺北市,大安區,1349,484,314,798,35,833,1425,58.46%,33.96%,1
臺北市,大安區,1350,478,298,776,24,800,1450,55.17%,32.97%,1
臺北市,大安區,1351,591,200,791,31,822,1444,56.93%,40.93%,1
臺北市,大安區,1352,492,328,820,33,853,1337,63.8%,36.8%,1
臺北市,大安區,1353,462,302,764,31,795,1417,56.1%,32.6%,1
臺北市,大安區,1354,425,278,703,31,734,1250,58.72%,34%,1
臺北市,大安區,1355,388,260,648,37,685,1176,58.25%,32.99%,1
臺北市,大安區,1356,455,296,751,35,786,1257,62.53%,36.2%,1
臺北市,大安區,1357,426,297,723,34,757,1257,60.22%,33.89%,1
臺北市,大安區,1358,387,281,668,26,694,1148,60.45%,33.71%,1
臺北市,大安區,1359,456,345,801,26,827,1418,58.32%,32.16%,1
臺北市,大安區,1360,325,253,578,20,598,1028,58.17%,31.61%,1
臺北市,大安區,1361,479,367,846,25,871,1445,60.28%,33.15%,1
臺北市,大安區,1362,497,281,778,39,817,1361,60.03%,36.52%,1
臺北市,大安區,1363,506,282,788,38,826,1343,61.5%,37.68%,1
臺北市,大安區,1364,424,301,725,35,760,1267,59.98%,33.46%,1
臺北市,大安區,1365,421,312,733,25,758,1380,54.93%,30.51%,1
臺北市,大安區,1366,476,342,818,41,859,1524,56.36%,31.23%,1
臺北市,大安區,1367,521,334,855,23,878,1470,59.73%,35.44%,1
臺北市,大安區,1368,417,246,663,39,702,1318,53.26%,31.64%,1
臺北市,大安區,1369,445,315,760,26,786,1430,54.97%,31.12%,1
臺北市,大安區,1370,463,309,772,28,800,1386,57.72%,33.41%,1
臺北市,大安區,1371,482,264,746,32,778,1438,54.1%,33.52%,1
臺北市,大安區,1372,387,262,649,18,667,1270,52.52%,30.47%,1
臺北市,大安區,1373,425,311,736,44,780,1395,55.91%,30.47%,1
臺北市,大安區,1374,452,264,716,29,745,1292,57.66%,34.98%,1
臺北市,大安區,1375,398,305,703,32,735,1310,56.11%,30.38%,1
臺北市,大安區,1376,424,302,726,32,758,1319,57.47%,32.15%,1
臺北市,大安區,1377,467,310,777,24,801,1355,59.11%,34.46%,1
臺北市,大安區,1378,381,301,682,24,706,1312,53.81%,29.04%,1
臺北市,大安區,1379,445,290,735,28,763,1335,57.15%,33.33%,1
臺北市,大安區,1380,492,309,801,21,822,1489,55.2%,33.04%,1
臺北市,大安區,1381,450,299,749,27,776,1307,59.37%,34.43%,1
臺北市,大安區,1382,388,296,684,21,705,1328,53.09%,29.22%,1
臺北市,大安區,1383,409,286,695,10,705,1277,55.21%,32.03%,1
臺北市,大安區,1384,424,308,732,31,763,1314,58.07%,32.27%,1
臺北市,大安區,1385,434,308,742,31,773,1270,60.87%,34.17%,1
臺北市,大安區,1386,406,313,719,42,761,1308,58.18%,31.04%,1
臺北市,大安區,1387,393,264,657,25,682,1138,59.93%,34.53%,1
臺北市,大安區,1388,432,289,721,23,744,1333,55.81%,32.41%,1
臺北市,大安區,1389,391,263,654,40,694,1176,59.01%,33.25%,1
臺北市,大安區,1390,401,308,709,43,752,1311,57.36%,30.59%,1
臺北市,大安區,1391,425,276,701,22,723,1295,55.83%,32.82%,1
臺北市,大安區,1392,506,291,797,41,838,1421,58.97%,35.61%,1
臺北市,大安區,1393,431,319,750,30,780,1409,55.36%,30.59%,1
臺北市,大安區,1394,481,334,815,26,841,1434,58.65%,33.54%,1
臺北市,大安區,1395,416,330,746,39,785,1449,54.18%,28.71%,1
臺北市,大安區,1396,422,311,733,27,760,1284,59.19%,32.87%,1
臺北市,大安區,1397,430,275,705,15,720,1248,57.69%,34.46%,1
臺北市,大安區,1398,439,279,718,20,738,1119,65.95%,39.23%,1
臺北市,大安區,1399,320,193,513,25,538,883,60.93%,36.24%,1
臺北市,大安區,1400,189,135,324,37,361,630,57.3%,30%,1
臺北市,大安區,1401,274,183,457,29,486,814,59.71%,33.66%,1
臺北市,中山區,0786,461,384,845,35,880,1522,57.82%,30.29%,1
臺北市,中山區,0787,426,306,732,31,763,1332,57.28%,31.98%,1
臺北市,中山區,0788,442,357,799,38,837,1656,50.54%,26.69%,1
臺北市,中山區,0789,383,297,680,27,707,1367,51.72%,28.02%,1
臺北市,中山區,0790,473,382,855,39,894,1732,51.62%,27.31%,1
臺北市,中山區,0791,523,373,896,44,940,1634,57.53%,32.01%,1
臺北市,中山區,0792,505,370,875,26,901,1650,54.61%,30.61%,1
臺北市,中山區,0793,463,327,790,36,826,1392,59.34%,33.26%,1
臺北市,中山區,0794,384,315,699,27,726,1177,61.68%,32.63%,1
臺北市,中山區,0795,474,378,852,39,891,1477,60.32%,32.09%,1
臺北市,中山區,0796,315,225,540,41,581,1063,54.66%,29.63%,1
臺北市,中山區,0797,412,278,690,32,722,1296,55.71%,31.79%,1
臺北市,中山區,0798,380,301,681,30,711,1330,53.46%,28.57%,1
臺北市,中山區,0799,424,342,766,37,803,1483,54.15%,28.59%,1
臺北市,中山區,0800,456,351,807,22,829,1542,53.76%,29.57%,1
臺北市,中山區,0801,567,282,849,41,890,1710,52.05%,33.16%,1
臺北市,中山區,0802,385,273,658,22,680,1315,51.71%,29.28%,1
臺北市,中山區,0803,398,269,667,40,707,1245,56.79%,31.97%,1
臺北市,中山區,0804,386,267,653,35,688,1262,54.52%,30.59%,1
臺北市,中山區,0805,438,383,821,45,866,1518,57.05%,28.85%,1
臺北市,中山區,0806,479,367,846,38,884,1522,58.08%,31.47%,1
臺北市,中山區,0807,452,348,800,33,833,1580,52.72%,28.61%,1
臺北市,中山區,0808,474,359,833,25,858,1529,56.12%,31%,1
臺北市,中山區,0809,380,276,656,33,689,1221,56.43%,31.12%,1
臺北市,中山區,0810,384,316,700,31,731,1221,59.87%,31.45%,1
臺北市,中山區,0811,319,231,550,31,581,1139,51.01%,28.01%,1
臺北市,中山區,0812,423,326,749,59,808,1407,57.43%,30.06%,1
臺北市,中山區,0813,401,328,729,29,758,1321,57.38%,30.36%,1
臺北市,中山區,0814,453,313,766,28,794,1578,50.32%,28.71%,1
臺北市,中山區,0815,523,331,854,42,896,1739,51.52%,30.07%,1
臺北市,中山區,0816,478,347,825,33,858,1637,52.41%,29.2%,1
臺北市,中山區,0817,461,339,800,41,841,1541,54.57%,29.92%,1
臺北市,中山區,0818,394,301,695,25,720,1210,59.5%,32.56%,1
臺北市,中山區,0819,400,321,721,36,757,1331,56.87%,30.05%,1
臺北市,中山區,0820,335,283,618,37,655,1224,53.51%,27.37%,1
臺北市,中山區,0821,512,367,879,34,913,1585,57.6%,32.3%,1
臺北市,中山區,0822,518,376,894,51,945,1523,62.05%,34.01%,1
臺北市,中山區,0823,493,317,810,37,847,1368,61.92%,36.04%,1
臺北市,中山區,0824,685,307,992,41,1033,1805,57.23%,37.95%,1
臺北市,中山區,0825,565,247,812,21,833,1404,59.33%,40.24%,1
臺北市,中山區,0826,594,439,1033,35,1068,1708,62.53%,34.78%,1
臺北市,中山區,0827,501,386,887,37,924,1451,63.68%,34.53%,1
臺北市,中山區,0828,572,426,998,44,1042,1684,61.88%,33.97%,1
臺北市,中山區,0829,564,332,896,21,917,1585,57.85%,35.58%,1
臺北市,中山區,0830,466,320,786,60,846,1391,60.82%,33.5%,1
臺北市,中山區,0831,505,346,851,60,911,1375,66.25%,36.73%,1
臺北市,中山區,0832,553,326,879,18,897,1472,60.94%,37.57%,1
臺北市,中山區,0833,402,312,714,27,741,1327,55.84%,30.29%,1
臺北市,中山區,0834,490,318,808,19,827,1401,59.03%,34.98%,1
臺北市,中山區,0835,476,339,815,34,849,1423,59.66%,33.45%,1
臺北市,中山區,0836,513,399,912,25,937,1569,59.72%,32.7%,1
臺北市,中山區,0837,535,401,936,29,965,1651,58.45%,32.4%,1
臺北市,中山區,0838,518,369,887,28,915,1624,56.34%,31.9%,1
臺北市,中山區,0839,584,433,1017,36,1053,1713,61.47%,34.09%,1
臺北市,中山區,0840,588,366,954,41,995,1647,60.41%,35.7%,1
臺北市,中山區,0841,543,377,920,42,962,1762,54.6%,30.82%,1
臺北市,中山區,0842,519,308,827,34,861,1399,61.54%,37.1%,1
臺北市,中山區,0843,535,356,891,32,923,1489,61.99%,35.93%,1
臺北市,中山區,0844,456,310,766,27,793,1269,62.49%,35.93%,1
臺北市,中山區,0845,376,231,607,26,633,998,63.43%,37.68%,1
臺北市,中山區,0846,445,360,805,30,835,1472,56.73%,30.23%,1
臺北市,中山區,0847,427,360,787,47,834,1517,54.98%,28.15%,1
臺北市,中山區,0848,562,420,982,47,1029,1704,60.39%,32.98%,1
臺北市,中山區,0849,528,370,898,42,940,1603,58.64%,32.94%,1
臺北市,中山區,0850,460,291,751,48,799,1432,55.8%,32.12%,1
臺北市,中山區,0851,462,370,832,59,891,1500,59.4%,30.8%,1
臺北市,中山區,0852,469,317,786,34,820,1332,61.56%,35.21%,1
臺北市,中山區,0853,485,356,841,46,887,1450,61.17%,33.45%,1
臺北市,中山區,0854,474,373,847,34,881,1434,61.44%,33.05%,1
臺北市,中山區,0855,455,309,764,36,800,1419,56.38%,32.06%,1
臺北市,中山區,0856,393,313,706,30,736,1292,56.97%,30.42%,1
臺北市,中山區,0857,434,389,823,31,854,1526,55.96%,28.44%,1
臺北市,中山區,0858,435,326,761,36,797,1582,50.38%,27.5%,1
臺北市,中山區,0859,436,352,788,45,833,1588,52.46%,27.46%,1
臺北市,中山區,0860,465,339,804,44,848,1463,57.96%,31.78%,1
臺北市,中山區,0861,433,388,821,48,869,1533,56.69%,28.25%,1
臺北市,中山區,0862,317,228,545,26,571,944,60.49%,33.58%,1
臺北市,中山區,0863,604,445,1049,37,1086,1745,62.23%,34.61%,1
臺北市,中山區,0864,469,346,815,30,845,1679,50.33%,27.93%,1
臺北市,中山區,0865,449,334,783,37,820,3419,23.98%,13.13%,1
臺北市,中山區,0866,463,329,792,43,835,1387,60.2%,33.38%,1
臺北市,中山區,0867,584,387,971,41,1012,1672,60.53%,34.93%,1
臺北市,中山區,0868,442,302,744,36,780,1319,59.14%,33.51%,1
臺北市,中山區,0869,414,319,733,33,766,1364,56.16%,30.35%,1
臺北市,中山區,0870,441,335,776,44,820,1461,56.13%,30.18%,1
臺北市,中山區,0871,388,285,673,39,712,1173,60.7%,33.08%,1
臺北市,中山區,0872,366,255,621,36,657,1171,56.11%,31.26%,1
臺北市,中山區,0873,418,319,737,21,758,1310,57.86%,31.91%,1
臺北市,中山區,0874,483,321,804,36,840,1373,61.18%,35.18%,1
臺北市,中山區,0875,468,303,771,34,805,1290,62.4%,36.28%,1
臺北市,中山區,0876,452,334,786,36,822,1346,61.07%,33.58%,1
臺北市,中山區,0877,471,386,857,35,892,1468,60.76%,32.08%,1
臺北市,中山區,0878,409,279,688,23,711,1178,60.36%,34.72%,1
臺北市,中山區,0879,575,376,951,40,991,1654,59.92%,34.76%,1
臺北市,中山區,0880,483,336,819,42,861,1464,58.81%,32.99%,1
臺北市,中山區,0881,487,335,822,31,853,1450,58.83%,33.59%,1
臺北市,中山區,0882,463,367,830,50,880,1534,57.37%,30.18%,1
臺北市,中山區,0883,530,402,932,43,975,1703,57.25%,31.12%,1
臺北市,中山區,0884,494,466,960,50,1010,1610,62.73%,30.68%,1
臺北市,中山區,0885,470,396,866,62,928,1653,56.14%,28.43%,1
臺北市,中山區,0886,575,413,988,48,1036,1694,61.16%,33.94%,1
臺北市,中山區,0887,500,371,871,41,912,1623,56.19%,30.81%,1
臺北市,中山區,0888,504,391,895,51,946,1618,58.47%,31.15%,1
臺北市,中山區,0889,491,374,865,42,907,1583,57.3%,31.02%,1
臺北市,中山區,0890,486,435,921,62,983,1605,61.25%,30.28%,1
臺北市,中山區,0891,478,365,843,51,894,1398,63.95%,34.19%,1
臺北市,中山區,0892,523,414,937,52,989,1526,64.81%,34.27%,1
臺北市,中山區,0893,463,419,882,46,928,1555,59.68%,29.77%,1
臺北市,中山區,0894,508,356,864,29,893,1597,55.92%,31.81%,1
臺北市,中山區,0895,493,392,885,54,939,1587,59.17%,31.06%,1
臺北市,中山區,0896,507,412,919,34,953,1587,60.05%,31.95%,1
臺北市,中山區,0897,515,388,903,61,964,1546,62.35%,33.31%,1
臺北市,中山區,0898,435,275,710,43,753,1322,56.96%,32.9%,1
臺北市,中山區,0899,416,294,710,34,744,1267,58.72%,32.83%,1
臺北市,中山區,0900,384,238,622,19,641,1210,52.98%,31.74%,1
臺北市,中山區,0901,442,260,702,47,749,1295,57.84%,34.13%,1
臺北市,中山區,0902,497,350,847,43,890,1467,60.67%,33.88%,1
臺北市,中山區,0903,600,306,906,26,932,1491,62.51%,40.24%,1
臺北市,中山區,0904,593,351,944,42,986,1516,65.04%,39.12%,1
臺北市,中山區,0905,404,315,719,32,751,1384,54.26%,29.19%,1
臺北市,中山區,0906,388,301,689,39,728,1138,63.97%,34.09%,1
臺北市,中山區,0907,452,335,787,28,815,1513,53.87%,29.87%,1
臺北市,中山區,0908,535,343,878,50,928,1559,59.53%,34.32%,1
臺北市,中山區,0909,498,354,852,47,899,1429,62.91%,34.85%,1
臺北市,中山區,0910,459,309,768,21,789,1245,63.37%,36.87%,1
臺北市,中山區,0911,414,312,726,40,766,1214,63.1%,34.1%,1
臺北市,中山區,0912,441,358,799,33,832,1394,59.68%,31.64%,1
臺北市,中山區,0913,401,252,653,17,670,1336,50.15%,30.01%,1
臺北市,中山區,0914,393,272,665,35,700,1227,57.05%,32.03%,1
臺北市,中山區,0915,471,316,787,33,820,1382,59.33%,34.08%,1
臺北市,中山區,0916,456,326,782,43,825,1436,57.45%,31.75%,1
臺北市,中山區,0917,377,325,702,39,741,1405,52.74%,26.83%,1
臺北市,中山區,0918,414,287,701,28,729,1259,57.9%,32.88%,1
臺北市,中正區,1001,459,300,759,28,787,1308,60.17%,35.09%,1
臺北市,中正區,1002,400,300,700,39,739,1317,56.11%,30.37%,1
臺北市,中正區,1003,392,247,639,23,662,1069,61.93%,36.67%,1
臺北市,中正區,1004,366,239,605,33,638,1128,56.56%,32.45%,1
臺北市,中正區,1005,368,255,623,26,649,1053,61.63%,34.95%,1
臺北市,中正區,1006,368,249,617,17,634,1048,60.5%,35.11%,1
臺北市,中正區,1007,449,260,709,35,744,1297,57.36%,34.62%,1
臺北市,中正區,1008,445,251,696,21,717,1193,60.1%,37.3%,1
臺北市,中正區,1009,558,384,942,34,976,1500,65.07%,37.2%,1
臺北市,中正區,1010,424,311,735,27,762,1346,56.61%,31.5%,1
臺北市,中正區,1011,408,303,711,21,732,1283,57.05%,31.8%,1
臺北市,中正區,1012,455,333,788,42,830,1450,57.24%,31.38%,1
臺北市,中正區,1013,481,324,805,47,852,1433,59.46%,33.57%,1
臺北市,中正區,1014,460,362,822,39,861,1309,65.78%,35.14%,1
臺北市,中正區,1015,494,323,817,12,829,1386,59.81%,35.64%,1
臺北市,中正區,1016,415,283,698,31,729,1201,60.7%,34.55%,1
臺北市,中正區,1017,467,324,791,33,824,1336,61.68%,34.96%,1
臺北市,中正區,1018,446,357,803,34,837,1358,61.63%,32.84%,1
臺北市,中正區,1019,403,286,689,30,719,1177,61.09%,34.24%,1
臺北市,中正區,1020,464,290,754,25,779,1236,63.03%,37.54%,1
臺北市,中正區,1021,499,337,836,34,870,1478,58.86%,33.76%,1
臺北市,中正區,1022,488,364,852,29,881,1474,59.77%,33.11%,1
臺北市,中正區,1023,369,288,657,35,692,1172,59.04%,31.48%,1
臺北市,中正區,1024,413,321,734,40,774,1310,59.08%,31.53%,1
臺北市,中正區,1025,434,287,721,36,757,1263,59.94%,34.36%,1
臺北市,中正區,1026,402,269,671,30,701,1169,59.97%,34.39%,1
臺北市,中正區,1027,470,325,795,21,816,1391,58.66%,33.79%,1
臺北市,中正區,1028,409,254,663,22,685,1201,57.04%,34.05%,1
臺北市,中正區,1029,426,330,756,36,792,1324,59.82%,32.18%,1
臺北市,中正區,1030,379,269,648,44,692,1216,56.91%,31.17%,1
臺北市,中正區,1031,278,372,650,40,690,1183,58.33%,23.5%,1
臺北市,中正區,1032,524,342,866,60,926,1469,63.04%,35.67%,1
臺北市,中正區,1033,440,348,788,34,822,1411,58.26%,31.18%,1
臺北市,中正區,1034,456,334,790,58,848,1398,60.66%,32.62%,1
臺北市,中正區,1035,455,343,798,49,847,1479,57.27%,30.76%,1
臺北市,中正區,1036,542,341,883,33,916,1620,56.54%,33.46%,1
臺北市,中正區,1037,359,248,607,17,624,1041,59.94%,34.49%,1
臺北市,中正區,1038,348,257,605,20,625,1056,59.19%,32.95%,1
臺北市,中正區,1039,400,265,665,29,694,1063,65.29%,37.63%,1
臺北市,中正區,1040,422,292,714,33,747,1591,46.95%,26.52%,1
臺北市,中正區,1041,411,256,667,49,716,1502,47.67%,27.36%,1
臺北市,中正區,1042,405,276,681,33,714,1331,53.64%,30.43%,1
臺北市,中正區,1043,482,283,765,50,815,1441,56.56%,33.45%,1
臺北市,中正區,1044,447,314,761,35,796,1273,62.53%,35.11%,1
臺北市,中正區,1045,405,262,667,29,696,1133,61.43%,35.75%,1
臺北市,中正區,1046,388,284,672,27,699,1156,60.47%,33.56%,1
臺北市,中正區,1047,431,327,758,44,802,1377,58.24%,31.3%,1
臺北市,中正區,1048,451,286,737,44,781,1266,61.69%,35.62%,1
臺北市,中正區,1049,415,269,684,29,713,1111,64.18%,37.35%,1
臺北市,中正區,1050,376,276,652,26,678,1124,60.32%,33.45%,1
臺北市,中正區,1051,469,336,805,37,842,1373,61.33%,34.16%,1
臺北市,中正區,1052,494,318,812,27,839,1351,62.1%,36.57%,1
臺北市,中正區,1053,515,361,876,23,899,1495,60.13%,34.45%,1
臺北市,中正區,1054,541,358,899,24,923,1436,64.28%,37.67%,1
臺北市,中正區,1055,508,347,855,23,878,1516,57.92%,33.51%,1
臺北市,中正區,1056,450,329,779,29,808,1374,58.81%,32.75%,1
臺北市,中正區,1057,497,316,813,30,843,1522,55.39%,32.65%,1
臺北市,中正區,1058,496,282,778,30,808,1336,60.48%,37.13%,1
臺北市,中正區,1059,507,380,887,30,917,1551,59.12%,32.69%,1
臺北市,中正區,1060,539,364,903,52,955,1594,59.91%,33.81%,1
臺北市,中正區,1061,492,345,837,37,874,1503,58.15%,32.73%,1
臺北市,中正區,1062,563,283,846,19,865,1455,59.45%,38.69%,1
臺北市,中正區,1063,525,312,837,19,856,1439,59.49%,36.48%,1
臺北市,中正區,1064,511,327,838,37,875,1469,59.56%,34.79%,1
臺北市,中正區,1065,564,273,837,35,872,1430,60.98%,39.44%,1
臺北市,中正區,1066,524,331,855,38,893,1444,61.84%,36.29%,1
臺北市,中正區,1067,433,275,708,24,732,1254,58.37%,34.53%,1
臺北市,中正區,1068,323,220,543,33,576,932,61.8%,34.66%,1
臺北市,中正區,1069,334,273,607,36,643,1055,60.95%,31.66%,1
臺北市,中正區,1070,411,287,698,26,724,1226,59.05%,33.52%,1
臺北市,中正區,1071,425,296,721,29,750,1390,53.96%,30.58%,1
臺北市,中正區,1072,457,295,752,30,782,1336,58.53%,34.21%,1
臺北市,中正區,1073,440,286,726,34,760,1419,53.56%,31.01%,1
臺北市,中正區,1074,456,351,807,43,850,1361,62.45%,33.5%,1
臺北市,中正區,1075,508,359,867,42,909,2520,36.07%,20.16%,1
臺北市,中正區,1076,454,257,711,16,727,1224,59.4%,37.09%,1
臺北市,中正區,1077,377,288,665,4,669,1272,52.59%,29.64%,1
臺北市,中正區,1078,446,353,799,23,822,1400,58.71%,31.86%,1
臺北市,中正區,1079,423,294,717,27,744,1319,56.41%,32.07%,1
臺北市,中正區,1080,465,275,740,25,765,1232,62.09%,37.74%,1
臺北市,中正區,1081,456,319,775,32,807,1265,63.79%,36.05%,1
臺北市,中正區,1082,385,262,647,19,666,1055,63.13%,36.49%,1
臺北市,中正區,1083,330,208,538,30,568,954,59.54%,34.59%,1
臺北市,中正區,1084,377,206,583,34,617,1018,60.61%,37.03%,1
臺北市,中正區,1085,475,312,787,27,814,1431,56.88%,33.19%,1
臺北市,中正區,1086,351,291,642,36,678,1271,53.34%,27.62%,1
臺北市,中正區,1087,326,263,589,26,615,983,62.56%,33.16%,1
臺北市,中正區,1088,531,356,887,32,919,1594,57.65%,33.31%,1
臺北市,中正區,1089,552,359,911,40,951,1565,60.77%,35.27%,1
臺北市,中正區,1090,560,361,921,36,957,1650,58%,33.94%,1
臺北市,中正區,1091,484,368,852,34,886,1600,55.38%,30.25%,1
臺北市,中正區,1092,451,320,771,26,797,1391,57.3%,32.42%,1
臺北市,中正區,1093,581,391,972,35,1007,1769,56.92%,32.84%,1
臺北市,中正區,1094,476,379,855,26,881,1487,59.25%,32.01%,1
臺北市,中正區,1095,475,280,755,29,784,1291,60.73%,36.79%,1
臺北市,中正區,1096,465,288,753,25,778,1289,60.36%,36.07%,1
臺北市,大同區,0919,405,304,709,48,757,1261,60.03%,32.12%,1
臺北市,大同區,0920,460,336,796,40,836,1352,61.83%,34.02%,1
臺北市,大同區,0921,473,328,801,43,844,1462,57.73%,32.35%,1
臺北市,大同區,0922,461,341,802,66,868,1510,57.48%,30.53%,1
臺北市,大同區,0923,438,343,781,24,805,1496,53.81%,29.28%,1
臺北市,大同區,0924,384,326,710,45,755,1329,56.81%,28.89%,1
臺北市,大同區,0925,399,314,713,56,769,1307,58.84%,30.53%,1
臺北市,大同區,0926,322,276,598,36,634,1065,59.53%,30.23%,1
臺北市,大同區,0927,345,276,621,19,640,1085,58.99%,31.8%,1
臺北市,大同區,0928,332,292,624,51,675,1047,64.47%,31.71%,1
臺北市,大同區,0929,319,313,632,29,661,1215,54.4%,26.26%,1
臺北市,大同區,0930,379,295,674,24,698,1117,62.49%,33.93%,1
臺北市,大同區,0931,383,322,705,31,736,1186,62.06%,32.29%,1
臺北市,大同區,0932,399,287,686,41,727,1185,61.35%,33.67%,1
臺北市,大同區,0933,438,314,752,35,787,1359,57.91%,32.23%,1
臺北市,大同區,0934,423,298,721,24,745,1273,58.52%,33.23%,1
臺北市,大同區,0935,403,349,752,46,798,1291,61.81%,31.22%,1
臺北市,大同區,0936,387,296,683,36,719,1288,55.82%,30.05%,1
臺北市,大同區,0937,421,337,758,28,786,1245,63.13%,33.82%,1
臺北市,大同區,0938,423,329,752,38,790,1261,62.65%,33.54%,1
臺北市,大同區,0939,413,314,727,29,756,1348,56.08%,30.64%,1
臺北市,大同區,0940,509,406,915,73,988,1676,58.95%,30.37%,1
臺北市,大同區,0941,493,283,776,39,815,1311,62.17%,37.6%,1
臺北市,大同區,0942,440,320,760,41,801,1316,60.87%,33.43%,1
臺北市,大同區,0943,449,316,765,57,822,1409,58.34%,31.87%,1
臺北市,大同區,0944,462,364,826,43,869,1436,60.52%,32.17%,1
臺北市,大同區,0945,420,375,795,45,840,1408,59.66%,29.83%,1
臺北市,大同區,0946,397,305,702,33,735,1276,57.6%,31.11%,1
臺北市,大同區,0947,349,261,610,22,632,1110,56.94%,31.44%,1
臺北市,大同區,0948,402,350,752,23,775,1324,58.53%,30.36%,1
臺北市,大同區,0949,350,226,576,22,598,1016,58.86%,34.45%,1
臺北市,大同區,0950,376,239,615,31,646,1028,62.84%,36.58%,1
臺北市,大同區,0951,416,251,667,40,707,1158,61.05%,35.92%,1
臺北市,大同區,0952,399,272,671,31,702,1138,61.69%,35.06%,1
臺北市,大同區,0953,408,287,695,41,736,1214,60.63%,33.61%,1
臺北市,大同區,0954,351,261,612,28,640,1090,58.72%,32.2%,1
臺北市,大同區,0955,484,310,794,37,831,1305,63.68%,37.09%,1
臺北市,大同區,0956,377,259,636,26,662,1167,56.73%,32.31%,1
臺北市,大同區,0957,359,287,646,28,674,1148,58.71%,31.27%,1
臺北市,大同區,0958,422,299,721,31,752,1203,62.51%,35.08%,1
臺北市,大同區,0959,452,329,781,31,812,1441,56.35%,31.37%,1
臺北市,大同區,0960,446,323,769,51,820,1315,62.36%,33.92%,1
臺北市,大同區,0961,438,321,759,44,803,1393,57.65%,31.44%,1
臺北市,大同區,0962,434,304,738,32,770,1278,60.25%,33.96%,1
臺北市,大同區,0963,347,288,635,44,679,1246,54.49%,27.85%,1
臺北市,大同區,0964,375,247,622,47,669,1142,58.58%,32.84%,1
臺北市,大同區,0965,479,323,802,39,841,1336,62.95%,35.85%,1
臺北市,大同區,0966,411,376,787,48,835,1363,61.26%,30.15%,1
臺北市,大同區,0967,528,329,857,21,878,1476,59.49%,35.77%,1
臺北市,大同區,0968,444,356,800,41,841,1418,59.31%,31.31%,1
臺北市,大同區,0969,469,313,782,37,819,1460,56.1%,32.12%,1
臺北市,大同區,0970,340,267,607,41,648,1222,53.03%,27.82%,1
臺北市,大同區,0971,344,247,591,66,657,1246,52.73%,27.61%,1
臺北市,大同區,0972,430,315,745,39,784,1256,62.42%,34.24%,1
臺北市,大同區,0973,435,305,740,22,762,1289,59.12%,33.75%,1
臺北市,大同區,0974,397,322,719,28,747,1340,55.75%,29.63%,1
臺北市,大同區,0975,462,334,796,44,840,1555,54.02%,29.71%,1
臺北市,大同區,0976,485,300,785,53,838,2459,34.08%,19.72%,1
臺北市,大同區,0977,286,213,499,38,537,1108,48.47%,25.81%,1
臺北市,大同區,0978,276,175,451,35,486,867,56.06%,31.83%,1
臺北市,大同區,0979,424,377,801,39,840,1329,63.21%,31.9%,1
臺北市,大同區,0980,368,292,660,21,681,1162,58.61%,31.67%,1
臺北市,大同區,0981,439,294,733,62,795,1434,55.44%,30.61%,1
臺北市,大同區,0982,402,340,742,53,795,1351,58.85%,29.76%,1
臺北市,大同區,0983,439,318,757,76,833,1531,54.41%,28.67%,1
臺北市,大同區,0984,431,309,740,25,765,1507,50.76%,28.6%,1
臺北市,大同區,0985,458,342,800,39,839,1488,56.38%,30.78%,1
臺北市,大同區,0986,481,330,811,44,855,1384,61.78%,34.75%,1
臺北市,大同區,0987,525,287,812,42,854,1460,58.49%,35.96%,1
臺北市,大同區,0988,487,332,819,30,849,1371,61.93%,35.52%,1
臺北市,大同區,0989,443,344,787,17,804,1439,55.87%,30.79%,1
臺北市,大同區,0990,419,372,791,45,836,1376,60.76%,30.45%,1
臺北市,大同區,0991,410,317,727,49,776,1366,56.81%,30.01%,1
臺北市,大同區,0992,436,314,750,38,788,1218,64.7%,35.8%,1
臺北市,大同區,0993,417,283,700,36,736,1235,59.6%,33.77%,1
臺北市,大同區,0994,461,271,732,18,750,1364,54.99%,33.8%,1
臺北市,大同區,0995,463,378,841,48,889,1408,63.14%,32.88%,1
臺北市,大同區,0996,467,352,819,37,856,1450,59.03%,32.21%,1
臺北市,大同區,0997,470,364,834,54,888,1429,62.14%,32.89%,1
臺北市,大同區,0998,372,296,668,52,720,1170,61.54%,31.79%,1
臺北市,大同區,0999,355,339,694,44,738,1245,59.28%,28.51%,1
臺北市,大同區,1000,423,308,731,58,789,1215,64.94%,34.81%,1
臺北市,萬華區,1097,397,339,736,40,776,1305,59.46%,30.42%,1
臺北市,萬華區,1098,320,230,550,53,603,1183,50.97%,27.05%,1
臺北市,萬華區,1099,367,280,647,24,671,1176,57.06%,31.21%,1
臺北市,萬華區,1100,329,263,592,23,615,1169,52.61%,28.14%,1
臺北市,萬華區,1101,463,252,715,28,743,1457,51%,31.78%,1
臺北市,萬華區,1102,388,330,718,41,759,1563,48.56%,24.82%,1
臺北市,萬華區,1103,450,395,845,24,869,1771,49.07%,25.41%,1
臺北市,萬華區,1104,450,355,805,36,841,1615,52.07%,27.86%,1
臺北市,萬華區,1105,449,320,769,60,829,1478,56.09%,30.38%,1
臺北市,萬華區,1106,444,342,786,28,814,1462,55.68%,30.37%,1
臺北市,萬華區,1107,429,266,695,43,738,1507,48.97%,28.47%,1
臺北市,萬華區,1108,437,313,750,43,793,1347,58.87%,32.44%,1
臺北市,萬華區,1109,390,308,698,34,732,1367,53.55%,28.53%,1
臺北市,萬華區,1110,423,323,746,40,786,1277,61.55%,33.12%,1
臺北市,萬華區,1111,439,366,805,49,854,1395,61.22%,31.47%,1
臺北市,萬華區,1112,416,333,749,44,793,1450,54.69%,28.69%,1
臺北市,萬華區,1113,376,290,666,32,698,1340,52.09%,28.06%,1
臺北市,萬華區,1114,359,275,634,36,670,1242,53.95%,28.9%,1
臺北市,萬華區,1115,372,293,665,54,719,1286,55.91%,28.93%,1
臺北市,萬華區,1116,378,300,678,41,719,1324,54.31%,28.55%,1
臺北市,萬華區,1117,507,307,814,48,862,1619,53.24%,31.32%,1
臺北市,萬華區,1118,382,257,639,38,677,1352,50.07%,28.25%,1
臺北市,萬華區,1119,439,315,754,37,791,1440,54.93%,30.49%,1
臺北市,萬華區,1120,368,310,678,45,723,1194,60.55%,30.82%,1
臺北市,萬華區,1121,391,251,642,50,692,1083,63.9%,36.1%,1
臺北市,萬華區,1122,384,252,636,50,686,1237,55.46%,31.04%,1
臺北市,萬華區,1123,454,396,850,33,883,1625,54.34%,27.94%,1
臺北市,萬華區,1124,425,324,749,44,793,1324,59.89%,32.1%,1
臺北市,萬華區,1125,424,344,768,38,806,1352,59.62%,31.36%,1
臺北市,萬華區,1126,411,309,720,38,758,2630,28.82%,15.63%,1
臺北市,萬華區,1127,507,361,868,44,912,1504,60.64%,33.71%,1
臺北市,萬華區,1128,429,333,762,32,794,1425,55.72%,30.11%,1
臺北市,萬華區,1129,410,353,763,55,818,1591,51.41%,25.77%,1
臺北市,萬華區,1130,434,334,768,42,810,1474,54.95%,29.44%,1
臺北市,萬華區,1131,449,352,801,56,857,1612,53.16%,27.85%,1
臺北市,萬華區,1132,429,327,756,52,808,1447,55.84%,29.65%,1
臺北市,萬華區,1133,473,348,821,48,869,1491,58.28%,31.72%,1
臺北市,萬華區,1134,501,364,865,35,900,1500,60%,33.4%,1
臺北市,萬華區,1135,453,405,858,48,906,1582,57.27%,28.63%,1
臺北市,萬華區,1136,453,355,808,39,847,1623,52.19%,27.91%,1
臺北市,萬華區,1137,358,307,665,24,689,1228,56.11%,29.15%,1
臺北市,萬華區,1138,390,291,681,42,723,1268,57.02%,30.76%,1
臺北市,萬華區,1139,409,279,688,47,735,1207,60.89%,33.89%,1
臺北市,萬華區,1140,368,309,677,40,717,1188,60.35%,30.98%,1
臺北市,萬華區,1141,436,331,767,34,801,1474,54.34%,29.58%,1
臺北市,萬華區,1142,346,268,614,24,638,1304,48.93%,26.53%,1
臺北市,萬華區,1143,267,173,440,39,479,1082,44.27%,24.68%,1
臺北市,萬華區,1144,314,238,552,28,580,1052,55.13%,29.85%,1
臺北市,萬華區,1145,355,258,613,30,643,1135,56.65%,31.28%,1
臺北市,萬華區,1146,348,294,642,51,693,1225,56.57%,28.41%,1
臺北市,萬華區,1147,478,336,814,21,835,1583,52.75%,30.2%,1
臺北市,萬華區,1148,391,346,737,49,786,1403,56.02%,27.87%,1
臺北市,萬華區,1149,465,299,764,53,817,1406,58.11%,33.07%,1
臺北市,萬華區,1150,472,327,799,39,838,1401,59.81%,33.69%,1
臺北市,萬華區,1151,386,289,675,49,724,1188,60.94%,32.49%,1
臺北市,萬華區,1152,453,347,800,69,869,1597,54.41%,28.37%,1
臺北市,萬華區,1153,456,297,753,48,801,1290,62.09%,35.35%,1
臺北市,萬華區,1154,487,374,861,22,883,1746,50.57%,27.89%,1
臺北市,萬華區,1155,412,323,735,37,772,1595,48.4%,25.83%,1
臺北市,萬華區,1156,490,374,864,75,939,1701,55.2%,28.81%,1
臺北市,萬華區,1157,331,277,608,59,667,1339,49.81%,24.72%,1
臺北市,萬華區,1158,389,293,682,55,737,1484,49.66%,26.21%,1
臺北市,萬華區,1159,488,373,861,54,915,1604,57.04%,30.42%,1
臺北市,萬華區,1160,394,279,673,35,708,1197,59.15%,32.92%,1
臺北市,萬華區,1161,376,304,680,59,739,1347,54.86%,27.91%,1
臺北市,萬華區,1162,433,323,756,28,784,1223,64.1%,35.4%,1
臺北市,萬華區,1163,319,273,592,38,630,1036,60.81%,30.79%,1
臺北市,萬華區,1164,347,293,640,31,671,1035,64.83%,33.53%,1
臺北市,萬華區,1165,404,279,683,28,711,1141,62.31%,35.41%,1
臺北市,萬華區,1166,408,328,736,23,759,1271,59.72%,32.1%,1
臺北市,萬華區,1167,402,333,735,58,793,1328,59.71%,30.27%,1
臺北市,萬華區,1168,419,315,734,31,765,1286,59.49%,32.58%,1
臺北市,萬華區,1169,526,398,924,54,978,1679,58.25%,31.33%,1
臺北市,萬華區,1170,487,375,862,51,913,1619,56.39%,30.08%,1
臺北市,萬華區,1171,463,330,793,33,826,1625,50.83%,28.49%,1
臺北市,萬華區,1172,545,375,920,41,961,1623,59.21%,33.58%,1
臺北市,萬華區,1173,397,277,674,48,722,1280,56.41%,31.02%,1
臺北市,萬華區,1174,490,357,847,49,896,1608,55.72%,30.47%,1
臺北市,萬華區,1175,482,312,794,57,851,1453,58.57%,33.17%,1
臺北市,萬華區,1176,528,349,877,37,914,1472,62.09%,35.87%,1
臺北市,萬華區,1177,429,339,768,31,799,1373,58.19%,31.25%,1
臺北市,萬華區,1178,432,303,735,43,778,1394,55.81%,30.99%,1
臺北市,萬華區,1179,444,312,756,25,781,1427,54.73%,31.11%,1
臺北市,萬華區,1180,443,352,795,36,831,1342,61.92%,33.01%,1
臺北市,萬華區,1181,527,355,882,61,943,1569,60.1%,33.59%,1
臺北市,萬華區,1182,442,286,728,40,768,1514,50.73%,29.19%,1
臺北市,萬華區,1183,462,356,818,39,857,1720,49.83%,26.86%,1
臺北市,萬華區,1184,508,350,858,58,916,1461,62.7%,34.77%,1
臺北市,萬華區,1185,379,304,683,29,712,1264,56.33%,29.98%,1
臺北市,萬華區,1186,446,334,780,49,829,1334,62.14%,33.43%,1
臺北市,萬華區,1187,462,364,826,39,865,1446,59.82%,31.95%,1
臺北市,萬華區,1188,399,257,656,36,692,1307,52.95%,30.53%,1
臺北市,萬華區,1189,489,306,795,41,836,1420,58.87%,34.44%,1
臺北市,萬華區,1190,415,323,738,28,766,1427,53.68%,29.08%,1
臺北市,萬華區,1191,323,197,520,27,547,956,57.22%,33.79%,1
臺北市,萬華區,1192,468,275,743,51,794,1352,58.73%,34.62%,1
臺北市,萬華區,1193,486,252,738,42,780,1370,56.93%,35.47%,1
臺北市,萬華區,1194,444,248,692,44,736,1222,60.23%,36.33%,1
臺北市,萬華區,1195,541,251,792,44,836,1375,60.8%,39.35%,1
臺北市,萬華區,1196,499,326,825,41,866,1463,59.19%,34.11%,1
臺北市,萬華區,1197,466,322,788,41,829,1527,54.29%,30.52%,1
臺北市,萬華區,1198,512,262,774,38,812,1485,54.68%,34.48%,1
臺北市,萬華區,1199,664,279,943,40,983,1591,61.79%,41.73%,1
臺北市,萬華區,1200,561,310,871,38,909,1394,65.21%,40.24%,1
臺北市,萬華區,1201,525,334,859,25,884,1522,58.08%,34.49%,1
臺北市,萬華區,1202,645,328,973,29,1002,1661,60.33%,38.83%,1
臺北市,萬華區,1203,575,358,933,33,966,1561,61.88%,36.84%,1
臺北市,萬華區,1204,570,299,869,37,906,1406,64.44%,40.54%,1
臺北市,萬華區,1205,420,267,687,35,722,1498,48.2%,28.04%,1
臺北市,萬華區,1206,400,270,670,44,714,1478,48.31%,27.06%,1
臺北市,萬華區,1207,378,244,622,46,668,1170,57.09%,32.31%,1
臺北市,萬華區,1208,480,302,782,31,813,1376,59.08%,34.88%,1
臺北市,萬華區,1209,290,224,514,21,535,1093,48.95%,26.53%,1
臺北市,萬華區,1210,415,237,652,34,686,1084,63.28%,38.28%,1
臺北市,萬華區,1211,409,248,657,33,690,1119,61.66%,36.55%,1
臺北市,萬華區,1212,539,294,833,27,860,1381,62.27%,39.03%,1
臺北市,萬華區,1213,503,316,819,30,849,1396,60.82%,36.03%,1
臺北市,文山區,1402,500,340,840,40,880,1539,57.18%,32.49%,1
臺北市,文山區,1403,503,316,819,30,849,1548,54.84%,32.49%,1
臺北市,文山區,1404,509,354,863,43,906,1493,60.68%,34.09%,1
臺北市,文山區,1405,577,384,961,38,999,1648,60.62%,35.01%,1
臺北市,文山區,1406,524,347,871,29,900,1544,58.29%,33.94%,1
臺北市,文山區,1407,562,307,869,40,909,1557,58.38%,36.1%,1
臺北市,文山區,1408,490,327,817,40,857,1514,56.61%,32.36%,1
臺北市,文山區,1409,573,378,951,35,986,1540,64.03%,37.21%,1
臺北市,文山區,1410,517,360,877,29,906,1466,61.8%,35.27%,1
臺北市,文山區,1411,546,296,842,53,895,1444,61.98%,37.81%,1
臺北市,文山區,1412,520,317,837,47,884,1455,60.76%,35.74%,1
臺北市,文山區,1413,495,294,789,27,816,1440,56.67%,34.38%,1
臺北市,文山區,1414,505,343,848,35,883,1398,63.16%,36.12%,1
臺北市,文山區,1415,461,329,790,18,808,1412,57.22%,32.65%,1
臺北市,文山區,1416,487,318,805,30,835,1426,58.56%,34.15%,1
臺北市,文山區,1417,492,330,822,34,856,1437,59.57%,34.24%,1
臺北市,文山區,1418,462,309,771,39,810,1340,60.45%,34.48%,1
臺北市,文山區,1419,542,347,889,26,915,1568,58.35%,34.57%,1
臺北市,文山區,1420,516,281,797,23,820,1372,59.77%,37.61%,1
臺北市,文山區,1421,354,234,588,29,617,1046,58.99%,33.84%,1
臺北市,文山區,1422,433,296,729,43,772,1274,60.6%,33.99%,1
臺北市,文山區,1423,470,290,760,26,786,1324,59.37%,35.5%,1
臺北市,文山區,1424,574,382,956,35,991,1722,57.55%,33.33%,1
臺北市,文山區,1425,606,373,979,47,1026,1737,59.07%,34.89%,1
臺北市,文山區,1426,505,342,847,18,865,1370,63.14%,36.86%,1
臺北市,文山區,1427,509,241,750,37,787,1495,52.64%,34.05%,1
臺北市,文山區,1428,453,309,762,45,807,1328,60.77%,34.11%,1
臺北市,文山區,1429,418,257,675,29,704,1138,61.86%,36.73%,1
臺北市,文山區,1430,533,343,876,30,906,1471,61.59%,36.23%,1
臺北市,文山區,1431,426,272,698,22,720,1144,62.94%,37.24%,1
臺北市,文山區,1432,449,277,726,32,758,1176,64.46%,38.18%,1
臺北市,文山區,1433,473,275,748,31,779,1212,64.27%,39.03%,1
臺北市,文山區,1434,501,273,774,22,796,1214,65.57%,41.27%,1
臺北市,文山區,1435,372,269,641,33,674,1170,57.61%,31.79%,1
臺北市,文山區,1436,458,306,764,41,805,1308,61.54%,35.02%,1
臺北市,文山區,1437,434,274,708,34,742,1190,62.35%,36.47%,1
臺北市,文山區,1438,413,233,646,32,678,1110,61.08%,37.21%,1
臺北市,文山區,1439,508,345,853,45,898,1512,59.39%,33.6%,1
臺北市,文山區,1440,518,305,823,42,865,1387,62.36%,37.35%,1
臺北市,文山區,1441,462,312,774,37,811,1355,59.85%,34.1%,1
臺北市,文山區,1442,452,323,775,55,830,1370,60.58%,32.99%,1
臺北市,文山區,1443,492,350,842,46,888,1484,59.84%,33.15%,1
臺北市,文山區,1444,584,404,988,55,1043,1786,58.4%,32.7%,1
臺北市,文山區,1445,473,259,732,38,770,1260,61.11%,37.54%,1
臺北市,文山區,1446,462,293,755,28,783,1194,65.58%,38.69%,1
臺北市,文山區,1447,543,299,842,28,870,1444,60.25%,37.6%,1
臺北市,文山區,1448,548,316,864,40,904,1495,60.47%,36.66%,1
臺北市,文山區,1449,544,320,864,29,893,1446,61.76%,37.62%,1
臺北市,文山區,1450,491,314,805,52,857,1450,59.1%,33.86%,1
臺北市,文山區,1451,518,359,877,39,916,1486,61.64%,34.86%,1
臺北市,文山區,1452,449,298,747,26,773,1259,61.4%,35.66%,1
臺北市,文山區,1453,508,291,799,18,817,1317,62.03%,38.57%,1
臺北市,文山區,1454,461,340,801,27,828,1321,62.68%,34.9%,1
臺北市,文山區,1455,511,318,829,37,866,1475,58.71%,34.64%,1
臺北市,文山區,1456,429,279,708,28,736,1271,57.91%,33.75%,1
臺北市,文山區,1457,556,381,937,35,972,1609,60.41%,34.56%,1
臺北市,文山區,1458,516,304,820,27,847,1501,56.43%,34.38%,1
臺北市,文山區,1459,294,237,531,23,554,997,55.57%,29.49%,1
臺北市,文山區,1460,380,275,655,31,686,1052,65.21%,36.12%,1
臺北市,文山區,1461,452,283,735,28,763,1247,61.19%,36.25%,1
臺北市,文山區,1462,392,295,687,36,723,1167,61.95%,33.59%,1
臺北市,文山區,1463,468,299,767,22,789,1280,61.64%,36.56%,1
臺北市,文山區,1464,435,247,682,27,709,1153,61.49%,37.73%,1
臺北市,文山區,1465,576,345,921,39,960,1557,61.66%,36.99%,1
臺北市,文山區,1466,529,286,815,46,861,1444,59.63%,36.63%,1
臺北市,文山區,1467,566,348,914,28,942,1459,64.56%,38.79%,1
臺北市,文山區,1468,555,290,845,28,873,1357,64.33%,40.9%,1
臺北市,文山區,1469,400,274,674,24,698,1194,58.46%,33.5%,1
臺北市,文山區,1470,413,302,715,50,765,1184,64.61%,34.88%,1
臺北市,文山區,1471,412,278,690,28,718,1119,64.16%,36.82%,1
臺北市,文山區,1472,501,321,822,40,862,1350,63.85%,37.11%,1
臺北市,文山區,1473,536,285,821,27,848,1502,56.46%,35.69%,1
臺北市,文山區,1474,569,319,888,34,922,1511,61.02%,37.66%,1
臺北市,文山區,1475,541,371,912,20,932,1481,62.93%,36.53%,1
臺北市,文山區,1476,580,324,904,26,930,1477,62.97%,39.27%,1
臺北市,文山區,1477,494,282,776,29,805,1294,62.21%,38.18%,1
臺北市,文山區,1478,422,262,684,27,711,1040,68.37%,40.58%,1
臺北市,文山區,1479,515,292,807,28,835,1323,63.11%,38.93%,1
臺北市,文山區,1480,404,275,679,35,714,1153,61.93%,35.04%,1
臺北市,文山區,1481,516,342,858,30,888,1525,58.23%,33.84%,1
臺北市,文山區,1482,493,265,758,31,789,1412,55.88%,34.92%,1
臺北市,文山區,1483,487,388,875,39,914,1473,62.05%,33.06%,1
臺北市,文山區,1484,492,379,871,35,906,1486,60.97%,33.11%,1
臺北市,文山區,1485,624,354,978,40,1018,1616,63%,38.61%,1
臺北市,文山區,1486,562,332,894,50,944,1489,63.4%,37.74%,1
臺北市,文山區,1487,489,314,803,40,843,1414,59.62%,34.58%,1
臺北市,文山區,1488,557,376,933,33,966,1494,64.66%,37.28%,1
臺北市,文山區,1489,557,369,926,36,962,1547,62.18%,36.01%,1
臺北市,文山區,1490,549,380,929,39,968,1587,61%,34.59%,1
臺北市,文山區,1491,566,364,930,27,957,1515,63.17%,37.36%,1
臺北市,文山區,1492,578,378,956,36,992,1573,63.06%,36.75%,1
臺北市,文山區,1493,562,370,932,37,969,1542,62.84%,36.45%,1
臺北市,文山區,1494,455,304,759,49,808,1465,55.15%,31.06%,1
臺北市,文山區,1495,186,134,320,26,346,699,49.5%,26.61%,1
臺北市,文山區,1496,398,279,677,37,714,1372,52.04%,29.01%,1
臺北市,文山區,1497,457,279,736,39,775,1448,53.52%,31.56%,1
臺北市,文山區,1498,525,336,861,47,908,1548,58.66%,33.91%,1
臺北市,文山區,1499,498,370,868,34,902,1501,60.09%,33.18%,1
臺北市,文山區,1500,549,373,922,42,964,1560,61.79%,35.19%,1
臺北市,文山區,1501,540,339,879,33,912,1567,58.2%,34.46%,1
臺北市,文山區,1502,532,364,896,27,923,1554,59.4%,34.23%,1
臺北市,文山區,1503,549,332,881,37,918,1544,59.46%,35.56%,1
臺北市,文山區,1504,540,370,910,40,950,1528,62.17%,35.34%,1
臺北市,文山區,1505,593,345,938,28,966,1543,62.61%,38.43%,1
臺北市,文山區,1506,501,411,912,51,963,2754,34.97%,18.19%,1
臺北市,文山區,1507,488,361,849,42,891,1709,52.14%,28.55%,1
臺北市,文山區,1508,489,326,815,56,871,1515,57.49%,32.28%,1
臺北市,文山區,1509,500,326,826,37,863,1571,54.93%,31.83%,1
臺北市,文山區,1510,483,387,870,42,912,1578,57.79%,30.61%,1
臺北市,文山區,1511,478,314,792,32,824,1454,56.67%,32.87%,1
臺北市,文山區,1512,505,317,822,42,864,1436,60.17%,35.17%,1
臺北市,文山區,1513,632,211,843,40,883,1402,62.98%,45.08%,1
臺北市,文山區,1514,405,267,672,0,672,1117,60.16%,36.26%,1
臺北市,文山區,1515,356,258,614,43,657,1094,60.05%,32.54%,1
臺北市,文山區,1516,405,245,650,38,688,1070,64.3%,37.85%,1
臺北市,文山區,1517,540,279,819,31,850,1319,64.44%,40.94%,1
臺北市,文山區,1518,458,298,756,31,787,1226,64.19%,37.36%,1
臺北市,文山區,1519,473,279,752,37,789,1385,56.97%,34.15%,1
臺北市,文山區,1520,464,356,820,37,857,1416,60.52%,32.77%,1
臺北市,文山區,1521,534,346,880,27,907,1412,64.24%,37.82%,1
臺北市,文山區,1522,506,332,838,47,885,1535,57.65%,32.96%,1
臺北市,文山區,1523,615,373,988,56,1044,1654,63.12%,37.18%,1
臺北市,文山區,1524,434,267,701,29,730,1156,63.15%,37.54%,1
臺北市,文山區,1525,449,306,755,28,783,1231,63.61%,36.47%,1
臺北市,文山區,1526,444,253,697,35,732,1218,60.1%,36.45%,1
臺北市,文山區,1527,435,298,733,28,761,1176,64.71%,36.99%,1
臺北市,文山區,1528,518,326,844,8,852,1392,61.21%,37.21%,1
臺北市,文山區,1529,443,292,735,59,794,1323,60.02%,33.48%,1
臺北市,文山區,1530,422,312,734,35,769,1297,59.29%,32.54%,1
臺北市,文山區,1531,462,321,783,34,817,1296,63.04%,35.65%,1
臺北市,文山區,1532,516,379,895,47,942,1613,58.4%,31.99%,1
臺北市,文山區,1533,567,419,986,47,1033,1697,60.87%,33.41%,1
臺北市,文山區,1534,539,361,900,46,946,1579,59.91%,34.14%,1
臺北市,文山區,1535,481,321,802,45,847,1320,64.17%,36.44%,1
臺北市,文山區,1536,523,329,852,25,877,1438,60.99%,36.37%,1
臺北市,文山區,1537,458,338,796,14,810,1465,55.29%,31.26%,1
臺北市,文山區,1538,524,408,932,55,987,1646,59.96%,31.83%,1
臺北市,文山區,1539,452,303,755,39,794,1286,61.74%,35.15%,1
臺北市,文山區,1540,428,292,720,26,746,1219,61.2%,35.11%,1
臺北市,文山區,1541,354,317,671,30,701,1292,54.26%,27.4%,1
臺北市,文山區,1542,484,333,817,40,857,1489,57.56%,32.51%,1
臺北市,文山區,1543,537,409,946,40,986,1611,61.2%,33.33%,1
臺北市,文山區,1544,477,294,771,43,814,1549,52.55%,30.79%,1
臺北市,文山區,1545,555,359,914,52,966,1678,57.57%,33.08%,1
臺北市,文山區,1546,545,358,903,44,947,1660,57.05%,32.83%,1
臺北市,文山區,1547,543,355,898,22,920,1816,50.66%,29.9%,1
臺北市,文山區,1548,315,227,542,24,566,985,57.46%,31.98%,1
臺北市,文山區,1549,484,306,790,23,813,1314,61.87%,36.83%,1
臺北市,文山區,1550,397,241,638,30,668,1018,65.62%,39%,1
臺北市,文山區,1551,546,368,914,29,943,1578,59.76%,34.6%,1
臺北市,文山區,1552,483,336,819,27,846,1457,58.06%,33.15%,1
臺北市,文山區,1553,453,341,794,29,823,1326,62.07%,34.16%,1
臺北市,文山區,1554,501,329,830,29,859,1393,61.67%,35.97%,1
臺北市,文山區,1555,430,325,755,39,794,1377,57.66%,31.23%,1
臺北市,文山區,1556,470,372,842,31,873,1448,60.29%,32.46%,1
臺北市,文山區,1557,532,351,883,46,929,1447,64.2%,36.77%,1
臺北市,文山區,1558,626,461,1087,48,1135,1739,65.27%,36%,1
臺北市,文山區,1559,463,388,851,28,879,1457,60.33%,31.78%,1
臺北市,文山區,1560,427,329,756,41,797,1288,61.88%,33.15%,1
臺北市,文山區,1561,390,288,678,38,716,1301,55.03%,29.98%,1
臺北市,文山區,1562,230,208,438,41,479,865,55.38%,26.59%,1
臺北市,文山區,1563,221,189,410,32,442,789,56.02%,28.01%,1
臺北市,南港區,0455,404,281,685,24,709,1280,55.39%,31.56%,1
臺北市,南港區,0456,450,305,755,24,779,1351,57.66%,33.31%,1
臺北市,南港區,0457,435,339,774,26,800,1345,59.48%,32.34%,1
臺北市,南港區,0458,446,296,742,32,774,1679,46.1%,26.56%,1
臺北市,南港區,0459,427,389,816,42,858,1680,51.07%,25.42%,1
臺北市,南港區,0460,475,338,813,44,857,1635,52.42%,29.05%,1
臺北市,南港區,0461,480,299,779,25,804,1459,55.11%,32.9%,1
臺北市,南港區,0462,573,370,943,29,972,1706,56.98%,33.59%,1
臺北市,南港區,0463,504,358,862,39,901,1674,53.82%,30.11%,1
臺北市,南港區,0464,509,315,824,18,842,1491,56.47%,34.14%,1
臺北市,南港區,0465,378,299,677,25,702,1086,64.64%,34.81%,1
臺北市,南港區,0466,407,323,730,49,779,1202,64.81%,33.86%,1
臺北市,南港區,0467,403,291,694,37,731,1198,61.02%,33.64%,1
臺北市,南港區,0468,428,333,761,31,792,1430,55.38%,29.93%,1
臺北市,南港區,0469,428,327,755,30,785,1275,61.57%,33.57%,1
臺北市,南港區,0470,426,407,833,38,871,1344,64.81%,31.7%,1
臺北市,南港區,0471,437,338,775,24,799,1391,57.44%,31.42%,1
臺北市,南港區,0472,446,355,801,20,821,1342,61.18%,33.23%,1
臺北市,南港區,0473,400,335,735,27,762,1389,54.86%,28.8%,1
臺北市,南港區,0474,480,369,849,25,874,1426,61.29%,33.66%,1
臺北市,南港區,0475,488,305,793,22,815,1359,59.97%,35.91%,1
臺北市,南港區,0476,441,314,755,28,783,1366,57.32%,32.28%,1
臺北市,南港區,0477,485,343,828,25,853,1441,59.2%,33.66%,1
臺北市,南港區,0478,477,317,794,44,838,1529,54.81%,31.2%,1
臺北市,南港區,0479,436,398,834,37,871,1618,53.83%,26.95%,1
臺北市,南港區,0480,419,303,722,42,764,1545,49.45%,27.12%,1
臺北市,南港區,0481,518,352,870,34,904,1569,57.62%,33.01%,1
臺北市,南港區,0482,476,339,815,36,851,1661,51.23%,28.66%,1
臺北市,南港區,0483,427,329,756,39,795,1518,52.37%,28.13%,1
臺北市,南港區,0484,547,375,922,39,961,1552,61.92%,35.24%,1
臺北市,南港區,0485,507,358,865,24,889,1658,53.62%,30.58%,1
臺北市,南港區,0486,523,368,891,54,945,1608,58.77%,32.52%,1
臺北市,南港區,0487,443,338,781,31,812,1475,55.05%,30.03%,1
臺北市,南港區,0488,613,426,1039,33,1072,1722,62.25%,35.6%,1
臺北市,南港區,0489,533,343,876,31,907,1383,65.58%,38.54%,1
臺北市,南港區,0490,465,327,792,37,829,1397,59.34%,33.29%,1
臺北市,南港區,0491,468,325,793,32,825,1352,61.02%,34.62%,1
臺北市,南港區,0492,573,211,784,26,810,1344,60.27%,42.63%,1
臺北市,南港區,0493,422,321,743,25,768,1385,55.45%,30.47%,1
臺北市,南港區,0494,466,314,780,32,812,1399,58.04%,33.31%,1
臺北市,南港區,0495,409,330,739,29,768,1381,55.61%,29.62%,1
臺北市,南港區,0496,489,345,834,36,870,1548,56.2%,31.59%,1
臺北市,南港區,0497,376,283,659,24,683,1190,57.39%,31.6%,1
臺北市,南港區,0498,462,396,858,34,892,1490,59.87%,31.01%,1
臺北市,南港區,0499,389,276,665,17,682,1096,62.23%,35.49%,1
臺北市,南港區,0500,425,334,759,22,781,1238,63.09%,34.33%,1
臺北市,南港區,0501,465,310,775,21,796,1271,62.63%,36.59%,1
臺北市,南港區,0502,373,263,636,37,673,1146,58.73%,32.55%,1
臺北市,南港區,0503,400,289,689,30,719,1232,58.36%,32.47%,1
臺北市,南港區,0504,470,337,807,30,837,1649,50.76%,28.5%,1
臺北市,南港區,0505,573,383,956,38,994,1688,58.89%,33.95%,1
臺北市,南港區,0506,506,370,876,32,908,1503,60.41%,33.67%,1
臺北市,南港區,0507,516,360,876,19,895,1542,58.04%,33.46%,1
臺北市,南港區,0508,500,332,832,38,870,1463,59.47%,34.18%,1
臺北市,南港區,0509,501,220,721,43,764,1195,63.93%,41.92%,1
臺北市,南港區,0510,392,345,737,13,750,1254,59.81%,31.26%,1
臺北市,南港區,0511,447,328,775,36,811,1356,59.81%,32.96%,1
臺北市,南港區,0512,448,324,772,61,833,1363,61.12%,32.87%,1
臺北市,南港區,0513,472,330,802,30,832,1317,63.17%,35.84%,1
臺北市,南港區,0514,440,342,782,22,804,1331,60.41%,33.06%,1
臺北市,南港區,0515,513,398,911,34,945,1610,58.7%,31.86%,1
臺北市,南港區,0516,499,337,836,32,868,1542,56.29%,32.36%,1
臺北市,南港區,0517,535,361,896,48,944,1581,59.71%,33.84%,1
臺北市,南港區,0518,432,312,744,35,779,1225,63.59%,35.27%,1
臺北市,南港區,0519,324,442,766,37,803,1264,63.53%,25.63%,1
臺北市,南港區,0520,564,383,947,54,1001,1649,60.7%,34.2%,1
臺北市,南港區,0521,413,322,735,30,765,1267,60.38%,32.6%,1
臺北市,南港區,0522,460,316,776,23,799,1336,59.81%,34.43%,1
臺北市,南港區,0523,409,279,688,26,714,1162,61.45%,35.2%,1
臺北市,南港區,0524,338,265,603,26,629,1045,60.19%,32.34%,1
臺北市,南港區,0525,518,343,861,39,900,1351,66.62%,38.34%,1
臺北市,南港區,0526,482,303,785,24,809,1358,59.57%,35.49%,1
臺北市,內湖區,0305,498,361,859,22,881,1661,53.04%,29.98%,1
臺北市,內湖區,0306,491,355,846,46,892,1602,55.68%,30.65%,1
臺北市,內湖區,0307,583,372,955,58,1013,1655,61.21%,35.23%,1
臺北市,內湖區,0308,526,408,934,30,964,1582,60.94%,33.25%,1
臺北市,內湖區,0309,535,371,906,28,934,1688,55.33%,31.69%,1
臺北市,內湖區,0310,548,403,951,48,999,1737,57.51%,31.55%,1
臺北市,內湖區,0311,598,400,998,41,1039,1809,57.44%,33.06%,1
臺北市,內湖區,0312,452,313,765,21,786,1376,57.12%,32.85%,1
臺北市,內湖區,0313,615,380,995,72,1067,1747,61.08%,35.2%,1
臺北市,內湖區,0314,483,346,829,24,853,1389,61.41%,34.77%,1
臺北市,內湖區,0315,514,368,882,31,913,1454,62.79%,35.35%,1
臺北市,內湖區,0316,521,382,903,32,935,1468,63.69%,35.49%,1
臺北市,內湖區,0317,598,383,981,31,1012,1603,63.13%,37.31%,1
臺北市,內湖區,0318,584,397,981,33,1014,1795,56.49%,32.53%,1
臺北市,內湖區,0319,612,441,1053,38,1091,1737,62.81%,35.23%,1
臺北市,內湖區,0320,613,404,1017,36,1053,1744,60.38%,35.15%,1
臺北市,內湖區,0321,556,385,941,38,979,1661,58.94%,33.47%,1
臺北市,內湖區,0322,468,410,878,40,918,1577,58.21%,29.68%,1
臺北市,內湖區,0323,526,371,897,27,924,1494,61.85%,35.21%,1
臺北市,內湖區,0324,573,360,933,30,963,1626,59.23%,35.24%,1
臺北市,內湖區,0325,578,364,942,35,977,1641,59.54%,35.22%,1
臺北市,內湖區,0326,525,369,894,27,921,1554,59.27%,33.78%,1
臺北市,內湖區,0327,576,425,1001,48,1049,1728,60.71%,33.33%,1
臺北市,內湖區,0328,587,367,954,40,994,1736,57.26%,33.81%,1
臺北市,內湖區,0329,539,370,909,33,942,1461,64.48%,36.89%,1
臺北市,內湖區,0330,541,340,881,30,911,1509,60.37%,35.85%,1
臺北市,內湖區,0331,446,320,766,26,792,1358,58.32%,32.84%,1
臺北市,內湖區,0332,620,346,966,36,1002,1761,56.9%,35.21%,1
臺北市,內湖區,0333,554,379,933,26,959,1651,58.09%,33.56%,1
臺北市,內湖區,0334,591,424,1015,77,1092,1809,60.36%,32.67%,1
臺北市,內湖區,0335,617,384,1001,43,1044,1773,58.88%,34.8%,1
臺北市,內湖區,0336,629,393,1022,40,1062,1890,56.19%,33.28%,1
臺北市,內湖區,0337,627,446,1073,46,1119,1760,63.58%,35.63%,1
臺北市,內湖區,0338,581,369,950,25,975,1645,59.27%,35.32%,1
臺北市,內湖區,0339,456,359,815,20,835,1324,63.07%,34.44%,1
臺北市,內湖區,0340,407,230,637,26,663,1072,61.85%,37.97%,1
臺北市,內湖區,0341,517,314,831,34,865,1509,57.32%,34.26%,1
臺北市,內湖區,0342,584,391,975,35,1010,1715,58.89%,34.05%,1
臺北市,內湖區,0343,607,410,1017,31,1048,1774,59.08%,34.22%,1
臺北市,內湖區,0344,713,396,1109,32,1141,1796,63.53%,39.7%,1
臺北市,內湖區,0345,626,375,1001,34,1035,1784,58.02%,35.09%,1
臺北市,內湖區,0346,468,367,835,50,885,1417,62.46%,33.03%,1
臺北市,內湖區,0347,511,441,952,26,978,1699,57.56%,30.08%,1
臺北市,內湖區,0348,617,440,1057,26,1083,1719,63%,35.89%,1
臺北市,內湖區,0349,551,431,982,29,1011,1715,58.95%,32.13%,1
臺北市,內湖區,0350,475,369,844,28,872,1634,53.37%,29.07%,1
臺北市,內湖區,0351,456,321,777,44,821,1435,57.21%,31.78%,1
臺北市,內湖區,0352,513,310,823,21,844,1440,58.61%,35.63%,1
臺北市,內湖區,0353,500,374,874,28,902,1446,62.38%,34.58%,1
臺北市,內湖區,0354,521,341,862,39,901,1657,54.38%,31.44%,1
臺北市,內湖區,0355,428,306,734,47,781,1261,61.93%,33.94%,1
臺北市,內湖區,0356,124,89,213,26,239,456,52.41%,27.19%,1
臺北市,內湖區,0357,529,379,908,31,939,1433,65.53%,36.92%,1
臺北市,內湖區,0358,520,357,877,22,899,1485,60.54%,35.02%,1
臺北市,內湖區,0359,529,371,900,22,922,1590,57.99%,33.27%,1
臺北市,內湖區,0360,462,302,764,40,804,1219,65.96%,37.9%,1
臺北市,內湖區,0361,700,252,952,30,982,1732,56.7%,40.42%,1
臺北市,內湖區,0362,643,383,1026,31,1057,1727,61.2%,37.23%,1
臺北市,內湖區,0363,566,362,928,43,971,1637,59.32%,34.58%,1
臺北市,內湖區,0364,484,324,808,31,839,1453,57.74%,33.31%,1
臺北市,內湖區,0365,551,348,899,25,924,1617,57.14%,34.08%,1
臺北市,內湖區,0366,541,340,881,28,909,1604,56.67%,33.73%,1
臺北市,內湖區,0367,526,353,879,21,900,1406,64.01%,37.41%,1
臺北市,內湖區,0368,468,332,800,26,826,1353,61.05%,34.59%,1
臺北市,內湖區,0369,615,400,1015,30,1045,1724,60.61%,35.67%,1
臺北市,內湖區,0370,486,334,820,24,844,1378,61.25%,35.27%,1
臺北市,內湖區,0371,509,335,844,21,865,1403,61.65%,36.28%,1
臺北市,內湖區,0372,499,366,865,20,885,1547,57.21%,32.26%,1
臺北市,內湖區,0373,600,417,1017,30,1047,1718,60.94%,34.92%,1
臺北市,內湖區,0374,576,430,1006,37,1043,1813,57.53%,31.77%,1
臺北市,內湖區,0375,639,438,1077,37,1114,1791,62.2%,35.68%,1
臺北市,內湖區,0376,662,435,1097,35,1132,1855,61.02%,35.69%,1
臺北市,內湖區,0377,610,373,983,31,1014,1731,58.58%,35.24%,1
臺北市,內湖區,0378,561,420,981,42,1023,1593,64.22%,35.22%,1
臺北市,內湖區,0379,587,351,938,46,984,1869,52.65%,31.41%,1
臺北市,內湖區,0380,593,395,988,36,1024,1687,60.7%,35.15%,1
臺北市,內湖區,0381,538,378,916,12,928,1530,60.65%,35.16%,1
臺北市,內湖區,0382,463,299,762,39,801,1300,61.62%,35.62%,1
臺北市,內湖區,0383,514,307,821,25,846,1314,64.38%,39.12%,1
臺北市,內湖區,0384,439,314,753,18,771,1433,53.8%,30.64%,1
臺北市,內湖區,0385,431,333,764,35,799,1450,55.1%,29.72%,1
臺北市,內湖區,0386,495,390,885,39,924,1608,57.46%,30.78%,1
臺北市,內湖區,0387,450,352,802,38,840,1414,59.41%,31.82%,1
臺北市,內湖區,0388,498,359,857,33,890,1492,59.65%,33.38%,1
臺北市,內湖區,0389,501,318,819,15,834,1528,54.58%,32.79%,1
臺北市,內湖區,0390,575,376,951,33,984,1692,58.16%,33.98%,1
臺北市,內湖區,0391,511,369,880,41,921,1556,59.19%,32.84%,1
臺北市,內湖區,0392,550,352,902,22,924,1637,56.44%,33.6%,1
臺北市,內湖區,0393,521,416,937,35,972,1749,55.57%,29.79%,1
臺北市,內湖區,0394,397,263,660,24,684,1220,56.07%,32.54%,1
臺北市,內湖區,0395,500,391,891,37,928,1600,58%,31.25%,1
臺北市,內湖區,0396,469,353,822,33,855,1473,58.04%,31.84%,1
臺北市,內湖區,0397,462,352,814,44,858,1498,57.28%,30.84%,1
臺北市,內湖區,0398,486,381,867,32,899,1557,57.74%,31.21%,1
臺北市,內湖區,0399,518,334,852,35,887,1674,52.99%,30.94%,1
臺北市,內湖區,0400,596,410,1006,36,1042,1728,60.3%,34.49%,1
臺北市,內湖區,0401,313,64,377,26,403,788,51.14%,39.72%,1
臺北市,內湖區,0402,473,362,835,34,869,1542,56.36%,30.67%,1
臺北市,內湖區,0403,549,266,815,40,855,1676,51.01%,32.76%,1
臺北市,內湖區,0404,407,304,711,18,729,1360,53.6%,29.93%,1
臺北市,內湖區,0405,480,300,780,20,800,1259,63.54%,38.13%,1
臺北市,內湖區,0406,460,261,721,9,730,1301,56.11%,35.36%,1
臺北市,內湖區,0407,340,277,617,30,647,1251,51.72%,27.18%,1
臺北市,內湖區,0408,489,323,812,50,862,1502,57.39%,32.56%,1
臺北市,內湖區,0409,506,362,868,32,900,1596,56.39%,31.7%,1
臺北市,內湖區,0410,504,424,928,18,946,1649,57.37%,30.56%,1
臺北市,內湖區,0411,588,350,938,41,979,1774,55.19%,33.15%,1
臺北市,內湖區,0412,563,382,945,19,964,1746,55.21%,32.25%,1
臺北市,內湖區,0413,487,316,803,30,833,1473,56.55%,33.06%,1
臺北市,內湖區,0414,545,385,930,40,970,2824,34.35%,19.3%,1
臺北市,內湖區,0415,514,428,942,34,976,1849,52.79%,27.8%,1
臺北市,內湖區,0416,486,336,822,40,862,1530,56.34%,31.76%,1
臺北市,內湖區,0417,515,397,912,43,955,1656,57.67%,31.1%,1
臺北市,內湖區,0418,472,363,835,31,866,1457,59.44%,32.4%,1
臺北市,內湖區,0419,576,403,979,40,1019,1695,60.12%,33.98%,1
臺北市,內湖區,0420,569,391,960,25,985,1663,59.23%,34.22%,1
臺北市,內湖區,0421,544,374,918,35,953,1654,57.62%,32.89%,1
臺北市,內湖區,0422,560,398,958,30,988,1642,60.17%,34.1%,1
臺北市,內湖區,0423,553,415,968,19,987,1685,58.58%,32.82%,1
臺北市,內湖區,0424,610,404,1014,41,1055,1862,56.66%,32.76%,1
臺北市,內湖區,0425,643,448,1091,54,1145,1900,60.26%,33.84%,1
臺北市,內湖區,0426,784,307,1091,48,1139,1790,63.63%,43.8%,1
臺北市,內湖區,0427,450,335,785,33,818,1417,57.73%,31.76%,1
臺北市,內湖區,0428,553,384,937,34,971,1694,57.32%,32.64%,1
臺北市,內湖區,0429,517,350,867,55,922,1676,55.01%,30.85%,1
臺北市,內湖區,0430,537,367,904,28,932,1643,56.73%,32.68%,1
臺北市,內湖區,0431,542,359,901,35,936,1588,58.94%,34.13%,1
臺北市,內湖區,0432,563,343,906,58,964,1603,60.14%,35.12%,1
臺北市,內湖區,0433,531,399,930,27,957,1629,58.75%,32.6%,1
臺北市,內湖區,0434,587,393,980,38,1018,1646,61.85%,35.66%,1
臺北市,內湖區,0435,611,408,1019,28,1047,1883,55.6%,32.45%,1
臺北市,內湖區,0436,488,327,815,26,841,1434,58.65%,34.03%,1
臺北市,內湖區,0437,471,330,801,26,827,1418,58.32%,33.22%,1
臺北市,內湖區,0438,492,292,784,36,820,1373,59.72%,35.83%,1
臺北市,內湖區,0439,461,322,783,36,819,1349,60.71%,34.17%,1
臺北市,內湖區,0440,515,382,897,34,931,1511,61.61%,34.08%,1
臺北市,內湖區,0441,555,392,947,27,974,1563,62.32%,35.51%,1
臺北市,內湖區,0442,504,378,882,26,908,1550,58.58%,32.52%,1
臺北市,內湖區,0443,356,256,612,43,655,1157,56.61%,30.77%,1
臺北市,內湖區,0444,560,454,1014,35,1049,1768,59.33%,31.67%,1
臺北市,內湖區,0445,559,379,938,35,973,1664,58.47%,33.59%,1
臺北市,內湖區,0446,570,418,988,41,1029,1743,59.04%,32.7%,1
臺北市,內湖區,0447,517,345,862,20,882,1480,59.59%,34.93%,1
臺北市,內湖區,0448,515,421,936,49,985,1589,61.99%,32.41%,1
臺北市,內湖區,0449,443,314,757,29,786,1371,57.33%,32.31%,1
臺北市,內湖區,0450,545,408,953,30,983,1575,62.41%,34.6%,1
臺北市,內湖區,0451,475,311,786,23,809,1377,58.75%,34.5%,1
臺北市,內湖區,0452,542,395,937,36,973,1469,66.24%,36.9%,1
臺北市,內湖區,0453,555,393,948,20,968,1529,63.31%,36.3%,1
臺北市,內湖區,0454,566,403,969,36,1005,1649,60.95%,34.32%,1
臺北市,士林區,0142,533,377,910,52,962,1695,56.76%,31.45%,1
臺北市,士林區,0143,597,365,962,67,1029,1720,59.83%,34.71%,1
臺北市,士林區,0144,420,278,698,47,745,1288,57.84%,32.61%,1
臺北市,士林區,0145,531,312,843,34,877,1546,56.73%,34.35%,1
臺北市,士林區,0146,238,158,396,19,415,652,63.65%,36.5%,1
臺北市,士林區,0147,265,194,459,22,481,870,55.29%,30.46%,1
臺北市,士林區,0148,399,269,668,36,704,1137,61.92%,35.09%,1
臺北市,士林區,0149,392,238,630,35,665,1050,63.33%,37.33%,1
臺北市,士林區,0150,357,244,601,43,644,1031,62.46%,34.63%,1
臺北市,士林區,0151,380,244,624,20,644,1075,59.91%,35.35%,1
臺北市,士林區,0152,284,211,495,30,525,2175,24.14%,13.06%,1
臺北市,士林區,0153,528,375,903,47,950,1775,53.52%,29.75%,1
臺北市,士林區,0154,591,358,949,33,982,1669,58.84%,35.41%,1
臺北市,士林區,0155,549,420,969,44,1013,1665,60.84%,32.97%,1
臺北市,士林區,0156,579,397,976,49,1025,1648,62.2%,35.13%,1
臺北市,士林區,0157,470,246,716,22,738,1246,59.23%,37.72%,1
臺北市,士林區,0158,487,298,785,51,836,1419,58.91%,34.32%,1
臺北市,士林區,0159,432,287,719,56,775,1327,58.4%,32.55%,1
臺北市,士林區,0160,542,389,931,47,978,1573,62.17%,34.46%,1
臺北市,士林區,0161,507,312,819,55,874,1470,59.46%,34.49%,1
臺北市,士林區,0162,615,391,1006,39,1045,1775,58.87%,34.65%,1
臺北市,士林區,0163,579,378,957,31,988,1692,58.39%,34.22%,1
臺北市,士林區,0164,621,431,1052,51,1103,1842,59.88%,33.71%,1
臺北市,士林區,0165,429,259,688,30,718,1166,61.58%,36.79%,1
臺北市,士林區,0166,660,247,907,0,907,1687,53.76%,39.12%,1
臺北市,士林區,0167,530,365,895,43,938,1624,57.76%,32.64%,1
臺北市,士林區,0168,510,352,862,70,932,1477,63.1%,34.53%,1
臺北市,士林區,0169,435,301,736,39,775,1250,62%,34.8%,1
臺北市,士林區,0170,463,350,813,49,862,1434,60.11%,32.29%,1
臺北市,士林區,0171,507,337,844,46,890,1452,61.29%,34.92%,1
臺北市,士林區,0172,549,371,920,45,965,1533,62.95%,35.81%,1
臺北市,士林區,0173,535,354,889,45,934,1515,61.65%,35.31%,1
臺北市,士林區,0174,403,302,705,27,732,1203,60.85%,33.5%,1
臺北市,士林區,0175,518,361,879,49,928,1487,62.41%,34.84%,1
臺北市,士林區,0176,461,273,734,18,752,1252,60.06%,36.82%,1
臺北市,士林區,0177,514,336,850,47,897,1536,58.4%,33.46%,1
臺北市,士林區,0178,543,370,913,37,950,1556,61.05%,34.9%,1
臺北市,士林區,0179,508,367,875,27,902,1511,59.7%,33.62%,1
臺北市,士林區,0180,556,374,930,36,966,1572,61.45%,35.37%,1
臺北市,士林區,0181,537,381,918,50,968,1668,58.03%,32.19%,1
臺北市,士林區,0182,549,352,901,67,968,1685,57.45%,32.58%,1
臺北市,士林區,0183,507,359,866,45,911,1568,58.1%,32.33%,1
臺北市,士林區,0184,446,260,706,28,734,1327,55.31%,33.61%,1
臺北市,士林區,0185,421,301,722,35,757,1338,56.58%,31.46%,1
臺北市,士林區,0186,417,333,750,49,799,1515,52.74%,27.52%,1
臺北市,士林區,0187,490,331,821,52,873,1452,60.12%,33.75%,1
臺北市,士林區,0188,494,322,816,30,846,1448,58.43%,34.12%,1
臺北市,士林區,0189,519,358,877,41,918,1521,60.36%,34.12%,1
臺北市,士林區,0190,504,330,834,21,855,1461,58.52%,34.5%,1
臺北市,士林區,0191,434,335,769,69,838,1541,54.38%,28.16%,1
臺北市,士林區,0192,394,332,726,38,764,1611,47.42%,24.46%,1
臺北市,士林區,0193,515,308,823,53,876,1595,54.92%,32.29%,1
臺北市,士林區,0194,508,347,855,33,888,1685,52.7%,30.15%,1
臺北市,士林區,0195,541,391,932,52,984,1816,54.19%,29.79%,1
臺北市,士林區,0196,539,359,898,65,963,1687,57.08%,31.95%,1
臺北市,士林區,0197,520,368,888,49,937,1646,56.93%,31.59%,1
臺北市,士林區,0198,485,367,852,35,887,1643,53.99%,29.52%,1
臺北市,士林區,0199,578,349,927,33,960,1687,56.91%,34.26%,1
臺北市,士林區,0200,540,399,939,38,977,1655,59.03%,32.63%,1
臺北市,士林區,0201,511,419,930,29,959,1779,53.91%,28.72%,1
臺北市,士林區,0202,596,445,1041,48,1089,1855,58.71%,32.13%,1
臺北市,士林區,0203,404,340,744,46,790,1350,58.52%,29.93%,1
臺北市,士林區,0204,462,263,725,27,752,1455,51.68%,31.75%,1
臺北市,士林區,0205,382,303,685,46,731,1497,48.83%,25.52%,1
臺北市,士林區,0206,378,272,650,21,671,1398,48%,27.04%,1
臺北市,士林區,0207,547,418,965,61,1026,1747,58.73%,31.31%,1
臺北市,士林區,0208,554,235,789,46,835,1465,57%,37.82%,1
臺北市,士林區,0209,478,346,824,44,868,1530,56.73%,31.24%,1
臺北市,士林區,0210,529,401,930,48,978,1855,52.72%,28.52%,1
臺北市,士林區,0211,442,356,798,41,839,1444,58.1%,30.61%,1
臺北市,士林區,0212,473,320,793,45,838,1563,53.61%,30.26%,1
臺北市,士林區,0213,486,321,807,49,856,1482,57.76%,32.79%,1
臺北市,士林區,0214,445,365,810,63,873,1552,56.25%,28.67%,1
臺北市,士林區,0215,579,387,966,50,1016,1790,56.76%,32.35%,1
臺北市,士林區,0216,480,321,801,59,860,1628,52.83%,29.48%,1
臺北市,士林區,0217,469,276,745,53,798,1337,59.69%,35.08%,1
臺北市,士林區,0218,555,418,973,39,1012,1750,57.83%,31.71%,1
臺北市,士林區,0219,492,335,827,71,898,1668,53.84%,29.5%,1
臺北市,士林區,0220,388,237,625,50,675,1403,48.11%,27.66%,1
臺北市,士林區,0221,351,308,659,41,700,1468,47.68%,23.91%,1
臺北市,士林區,0222,394,307,701,31,732,1471,49.76%,26.78%,1
臺北市,士林區,0223,506,312,818,55,873,1666,52.4%,30.37%,1
臺北市,士林區,0224,445,339,784,51,835,1587,52.61%,28.04%,1
臺北市,士林區,0225,517,373,890,58,948,1987,47.71%,26.02%,1
臺北市,士林區,0226,408,234,642,23,665,1271,52.32%,32.1%,1
臺北市,士林區,0227,549,447,996,43,1039,1728,60.13%,31.77%,1
臺北市,士林區,0228,577,355,932,49,981,1630,60.18%,35.4%,1
臺北市,士林區,0229,537,395,932,35,967,1619,59.73%,33.17%,1
臺北市,士林區,0230,503,294,797,45,842,1425,59.09%,35.3%,1
臺北市,士林區,0231,565,402,967,41,1008,1623,62.11%,34.81%,1
臺北市,士林區,0232,544,357,901,37,938,1564,59.97%,34.78%,1
臺北市,士林區,0233,521,347,868,34,902,1376,65.55%,37.86%,1
臺北市,士林區,0234,560,351,911,29,940,1517,61.96%,36.91%,1
臺北市,士林區,0235,523,372,895,32,927,1729,53.61%,30.25%,1
臺北市,士林區,0236,589,300,889,41,930,1511,61.55%,38.98%,1
臺北市,士林區,0237,643,402,1045,35,1080,1811,59.64%,35.51%,1
臺北市,士林區,0238,501,382,883,27,910,1533,59.36%,32.68%,1
臺北市,士林區,0239,630,407,1037,37,1074,1657,64.82%,38.02%,1
臺北市,士林區,0240,491,333,824,31,855,1499,57.04%,32.76%,1
臺北市,士林區,0241,474,276,750,61,811,1402,57.85%,33.81%,1
臺北市,士林區,0242,440,342,782,48,830,1273,65.2%,34.56%,1
臺北市,士林區,0243,414,320,734,33,767,1273,60.25%,32.52%,1
臺北市,士林區,0244,437,306,743,38,781,1316,59.35%,33.21%,1
臺北市,士林區,0245,542,374,916,50,966,1659,58.23%,32.67%,1
臺北市,士林區,0246,509,443,952,40,992,1749,56.72%,29.1%,1
臺北市,士林區,0247,514,330,844,43,887,1552,57.15%,33.12%,1
臺北市,士林區,0248,539,321,860,49,909,1529,59.45%,35.25%,1
臺北市,士林區,0249,560,327,887,32,919,1644,55.9%,34.06%,1
臺北市,士林區,0250,600,368,968,46,1014,1779,57%,33.73%,1
臺北市,士林區,0251,503,381,884,35,919,1597,57.55%,31.5%,1
臺北市,士林區,0252,453,350,803,37,840,1454,57.77%,31.16%,1
臺北市,士林區,0253,489,429,918,53,971,1582,61.38%,30.91%,1
臺北市,士林區,0254,519,349,868,40,908,1518,59.82%,34.19%,1
臺北市,士林區,0255,428,357,785,29,814,1501,54.23%,28.51%,1
臺北市,士林區,0256,447,366,813,47,860,1420,60.56%,31.48%,1
臺北市,士林區,0257,474,361,835,50,885,1494,59.24%,31.73%,1
臺北市,士林區,0258,560,424,984,31,1015,1568,64.73%,35.71%,1
臺北市,士林區,0259,378,346,724,42,766,1208,63.41%,31.29%,1
臺北市,士林區,0260,585,411,996,41,1037,1826,56.79%,32.04%,1
臺北市,士林區,0261,503,399,902,36,938,1647,56.95%,30.54%,1
臺北市,士林區,0262,537,356,893,49,942,1654,56.95%,32.47%,1
臺北市,士林區,0263,509,383,892,40,932,1550,60.13%,32.84%,1
臺北市,士林區,0264,435,362,797,28,825,1298,63.56%,33.51%,1
臺北市,士林區,0265,468,320,788,34,822,1297,63.38%,36.08%,1
臺北市,士林區,0266,414,319,733,47,780,1352,57.69%,30.62%,1
臺北市,士林區,0267,491,346,837,44,881,1522,57.88%,32.26%,1
臺北市,士林區,0268,475,387,862,54,916,1602,57.18%,29.65%,1
臺北市,士林區,0269,461,339,800,44,844,1441,58.57%,31.99%,1
臺北市,士林區,0270,395,308,703,21,724,1325,54.64%,29.81%,1
臺北市,士林區,0271,500,363,863,39,902,1567,57.56%,31.91%,1
臺北市,士林區,0272,483,344,827,25,852,1518,56.13%,31.82%,1
臺北市,士林區,0273,517,393,910,39,949,1549,61.27%,33.38%,1
臺北市,士林區,0274,534,401,935,33,968,1652,58.6%,32.32%,1
臺北市,士林區,0275,582,429,1011,49,1060,1766,60.02%,32.96%,1
臺北市,士林區,0276,527,363,890,30,920,1638,56.17%,32.17%,1
臺北市,士林區,0277,535,332,867,39,906,1491,60.76%,35.88%,1
臺北市,士林區,0278,500,369,869,29,898,1521,59.04%,32.87%,1
臺北市,士林區,0279,481,316,797,47,844,1351,62.47%,35.6%,1
臺北市,士林區,0280,536,382,918,25,943,1742,54.13%,30.77%,1
臺北市,士林區,0281,379,512,891,35,926,1585,58.42%,23.91%,1
臺北市,士林區,0282,534,326,860,31,891,1521,58.58%,35.11%,1
臺北市,士林區,0283,389,352,741,24,765,1543,49.58%,25.21%,1
臺北市,士林區,0284,499,316,815,21,836,1404,59.54%,35.54%,1
臺北市,士林區,0285,474,384,858,35,893,1541,57.95%,30.76%,1
臺北市,士林區,0286,521,324,845,35,880,1584,55.56%,32.89%,1
臺北市,士林區,0287,518,351,869,42,911,1519,59.97%,34.1%,1
臺北市,士林區,0288,458,305,763,21,784,1482,52.9%,30.9%,1
臺北市,士林區,0289,389,283,672,40,712,1243,57.28%,31.3%,1
臺北市,士林區,0290,366,261,627,39,666,1156,57.61%,31.66%,1
臺北市,士林區,0291,358,275,633,51,684,1262,54.2%,28.37%,1
臺北市,士林區,0292,284,217,501,32,533,889,59.96%,31.95%,1
臺北市,士林區,0293,253,240,493,36,529,858,61.66%,29.49%,1
臺北市,士林區,0294,256,233,489,50,539,945,57.04%,27.09%,1
臺北市,士林區,0295,268,216,484,50,534,960,55.63%,27.92%,1
臺北市,士林區,0296,279,180,459,38,497,876,56.74%,31.85%,1
臺北市,士林區,0297,187,157,344,23,367,556,66.01%,33.63%,1
臺北市,士林區,0298,319,245,564,33,597,919,64.96%,34.71%,1
臺北市,士林區,0299,499,347,846,58,904,1360,66.47%,36.69%,1
臺北市,士林區,0300,464,325,789,51,840,1355,61.99%,34.24%,1
臺北市,士林區,0301,530,187,717,26,743,1252,59.35%,42.33%,1
臺北市,士林區,0302,438,276,714,29,743,1182,62.86%,37.06%,1
臺北市,士林區,0303,408,275,683,26,709,1431,49.55%,28.51%,1
臺北市,士林區,0304,395,253,648,35,683,1240,55.08%,31.85%,1
臺北市,北投區,0001,463,282,745,55,800,1313,60.93%,35.26%,1
臺北市,北投區,0002,480,360,840,33,873,1403,62.22%,34.21%,1
臺北市,北投區,0003,337,294,631,35,666,1081,61.61%,31.17%,1
臺北市,北投區,0004,393,297,690,39,729,1209,60.3%,32.51%,1
臺北市,北投區,0005,433,320,753,35,788,1326,59.43%,32.65%,1
臺北市,北投區,0006,431,297,728,41,769,1263,60.89%,34.13%,1
臺北市,北投區,0007,521,379,900,49,949,1580,60.06%,32.97%,1
臺北市,北投區,0008,546,356,902,33,935,1577,59.29%,34.62%,1
臺北市,北投區,0009,477,379,856,42,898,1483,60.55%,32.16%,1
臺北市,北投區,0010,469,327,796,34,830,1461,56.81%,32.1%,1
臺北市,北投區,0011,465,335,800,39,839,1466,57.23%,31.72%,1
臺北市,北投區,0012,575,356,931,43,974,1620,60.12%,35.49%,1
臺北市,北投區,0013,494,310,804,32,836,1543,54.18%,32.02%,1
臺北市,北投區,0014,508,289,797,36,833,1513,55.06%,33.58%,1
臺北市,北投區,0015,532,339,871,28,899,1534,58.6%,34.68%,1
臺北市,北投區,0016,594,337,931,53,984,1650,59.64%,36%,1
臺北市,北投區,0017,528,341,869,32,901,1533,58.77%,34.44%,1
臺北市,北投區,0018,554,365,919,35,954,1702,56.05%,32.55%,1
臺北市,北投區,0019,522,415,937,38,975,1721,56.65%,30.33%,1
臺北市,北投區,0020,495,428,923,44,967,1575,61.4%,31.43%,1
臺北市,北投區,0021,470,372,842,60,902,1530,58.95%,30.72%,1
臺北市,北投區,0022,568,389,957,49,1006,1728,58.22%,32.87%,1
臺北市,北投區,0023,573,360,933,47,980,1702,57.58%,33.67%,1
臺北市,北投區,0024,526,385,911,51,962,1696,56.72%,31.01%,1
臺北市,北投區,0025,471,304,775,28,803,1684,47.68%,27.97%,1
臺北市,北投區,0026,590,392,982,54,1036,1717,60.34%,34.36%,1
臺北市,北投區,0027,574,346,920,28,948,1605,59.07%,35.76%,1
臺北市,北投區,0028,589,357,946,47,993,1723,57.63%,34.18%,1
臺北市,北投區,0029,572,381,953,32,985,1597,61.68%,35.82%,1
臺北市,北投區,0030,556,388,944,31,975,1700,57.35%,32.71%,1
臺北市,北投區,0031,427,360,787,30,817,1544,52.91%,27.66%,1
臺北市,北投區,0032,500,347,847,31,878,1635,53.7%,30.58%,1
臺北市,北投區,0033,498,349,847,28,875,1495,58.53%,33.31%,1
臺北市,北投區,0034,541,371,912,44,956,1619,59.05%,33.42%,1
臺北市,北投區,0035,522,394,916,43,959,1683,56.98%,31.02%,1
臺北市,北投區,0036,499,354,853,46,899,1662,54.09%,30.02%,1
臺北市,北投區,0037,541,360,901,26,927,1850,50.11%,29.24%,1
臺北市,北投區,0038,464,391,855,23,878,1674,52.45%,27.72%,1
臺北市,北投區,0039,544,336,880,40,920,1511,60.89%,36%,1
臺北市,北投區,0040,471,313,784,14,798,1393,57.29%,33.81%,1
臺北市,北投區,0041,472,301,773,39,812,1279,63.49%,36.9%,1
臺北市,北投區,0042,372,243,615,26,641,1122,57.13%,33.16%,1
臺北市,北投區,0043,492,315,807,44,851,1238,68.74%,39.74%,1
臺北市,北投區,0044,511,347,858,64,922,1477,62.42%,34.6%,1
臺北市,北投區,0045,530,343,873,44,917,1495,61.34%,35.45%,1
臺北市,北投區,0046,552,345,897,34,931,1469,63.38%,37.58%,1
臺北市,北投區,0047,518,306,824,34,858,1462,58.69%,35.43%,1
臺北市,北投區,0048,498,323,821,37,858,1431,59.96%,34.8%,1
臺北市,北投區,0049,501,346,847,28,875,1486,58.88%,33.71%,1
臺北市,北投區,0050,514,333,847,39,886,1449,61.15%,35.47%,1
臺北市,北投區,0051,480,346,826,33,859,1456,59%,32.97%,1
臺北市,北投區,0052,411,307,718,25,743,1311,56.67%,31.35%,1
臺北市,北投區,0053,481,208,689,38,727,1356,53.61%,35.47%,1
臺北市,北投區,0054,466,298,764,27,791,1338,59.12%,34.83%,1
臺北市,北投區,0055,527,332,859,30,889,1525,58.3%,34.56%,1
臺北市,北投區,0056,486,378,864,31,895,1620,55.25%,30%,1
臺北市,北投區,0057,488,305,793,19,812,1499,54.17%,32.56%,1
臺北市,北投區,0058,546,337,883,31,914,1497,61.06%,36.47%,1
臺北市,北投區,0059,544,352,896,34,930,1624,57.27%,33.5%,1
臺北市,北投區,0060,475,316,791,52,843,1536,54.88%,30.92%,1
臺北市,北投區,0061,526,327,853,53,906,1469,61.67%,35.81%,1
臺北市,北投區,0062,496,358,854,37,891,1598,55.76%,31.04%,1
臺北市,北投區,0063,487,417,904,31,935,1690,55.33%,28.82%,1
臺北市,北投區,0064,472,373,845,67,912,1599,57.04%,29.52%,1
臺北市,北投區,0065,510,379,889,40,929,1634,56.85%,31.21%,1
臺北市,北投區,0066,453,386,839,50,889,1660,53.55%,27.29%,1
臺北市,北投區,0067,528,422,950,49,999,1900,52.58%,27.79%,1
臺北市,北投區,0068,580,405,985,42,1027,1797,57.15%,32.28%,1
臺北市,北投區,0069,554,462,1016,50,1066,1832,58.19%,30.24%,1
臺北市,北投區,0070,579,411,990,57,1047,1784,58.69%,32.46%,1
臺北市,北投區,0071,584,391,975,38,1013,1732,58.49%,33.72%,1
臺北市,北投區,0072,312,210,522,38,560,2035,27.52%,15.33%,1
臺北市,北投區,0073,479,329,808,44,852,1504,56.65%,31.85%,1
臺北市,北投區,0074,596,349,945,52,997,1683,59.24%,35.41%,1
臺北市,北投區,0075,488,367,855,54,909,1635,55.6%,29.85%,1
臺北市,北投區,0076,520,331,851,56,907,1613,56.23%,32.24%,1
臺北市,北投區,0077,406,396,802,26,828,1483,55.83%,27.38%,1
臺北市,北投區,0078,501,311,812,36,848,1500,56.53%,33.4%,1
臺北市,北投區,0079,479,354,833,42,875,1483,59%,32.3%,1
臺北市,北投區,0080,490,333,823,51,874,1544,56.61%,31.74%,1
臺北市,北投區,0081,426,319,745,33,778,1532,50.78%,27.81%,1
臺北市,北投區,0082,657,322,979,47,1026,1819,56.4%,36.12%,1
臺北市,北投區,0083,515,410,925,51,976,1863,52.39%,27.64%,1
臺北市,北投區,0084,493,423,916,18,934,1872,49.89%,26.34%,1
臺北市,北投區,0085,518,339,857,50,907,1627,55.75%,31.84%,1
臺北市,北投區,0086,523,371,894,12,906,1696,53.42%,30.84%,1
臺北市,北投區,0087,585,396,981,50,1031,1841,56%,31.78%,1
臺北市,北投區,0088,445,279,724,35,759,1324,57.33%,33.61%,1
臺北市,北投區,0089,466,334,800,28,828,1504,55.05%,30.98%,1
臺北市,北投區,0090,482,339,821,43,864,1511,57.18%,31.9%,1
臺北市,北投區,0091,536,389,925,31,956,1615,59.2%,33.19%,1
臺北市,北投區,0092,367,276,643,32,675,1270,53.15%,28.9%,1
臺北市,北投區,0093,393,329,722,29,751,1492,50.34%,26.34%,1
臺北市,北投區,0094,465,332,797,20,817,1429,57.17%,32.54%,1
臺北市,北投區,0095,471,336,807,26,833,1567,53.16%,30.06%,1
臺北市,北投區,0096,449,314,763,25,788,1388,56.77%,32.35%,1
臺北市,北投區,0097,431,311,742,21,763,1448,52.69%,29.77%,1
臺北市,北投區,0098,427,272,699,37,736,1356,54.28%,31.49%,1
臺北市,北投區,0099,439,274,713,22,735,1308,56.19%,33.56%,1
臺北市,北投區,0100,392,279,671,35,706,1165,60.6%,33.65%,1
臺北市,北投區,0101,483,311,794,44,838,1429,58.64%,33.8%,1
臺北市,北投區,0102,497,298,795,26,821,1472,55.77%,33.76%,1
臺北市,北投區,0103,521,378,899,46,945,1508,62.67%,34.55%,1
臺北市,北投區,0104,484,321,805,45,850,1480,57.43%,32.7%,1
臺北市,北投區,0105,344,260,604,30,634,1142,55.52%,30.12%,1
臺北市,北投區,0106,498,313,811,23,834,1554,53.67%,32.05%,1
臺北市,北投區,0107,561,370,931,59,990,1669,59.32%,33.61%,1
臺北市,北投區,0108,606,374,980,43,1023,1823,56.12%,33.24%,1
臺北市,北投區,0109,520,385,905,54,959,1739,55.15%,29.9%,1
臺北市,北投區,0110,551,360,911,39,950,1771,53.64%,31.11%,1
臺北市,北投區,0111,455,280,735,44,779,1468,53.07%,30.99%,1
臺北市,北投區,0112,488,320,808,22,830,1469,56.5%,33.22%,1
臺北市,北投區,0113,445,238,683,38,721,1094,65.9%,40.68%,1
臺北市,北投區,0114,429,250,679,30,709,1101,64.4%,38.96%,1
臺北市,北投區,0115,500,324,824,41,865,1422,60.83%,35.16%,1
臺北市,北投區,0116,502,248,750,32,782,1390,56.26%,36.12%,1
臺北市,北投區,0117,476,269,745,36,781,1307,59.76%,36.42%,1
臺北市,北投區,0118,404,324,728,45,773,1215,63.62%,33.25%,1
臺北市,北投區,0119,505,355,860,35,895,1642,54.51%,30.76%,1
臺北市,北投區,0120,502,333,835,30,865,1623,53.3%,30.93%,1
臺北市,北投區,0121,537,322,859,40,899,1621,55.46%,33.13%,1
臺北市,北投區,0122,415,333,748,19,767,1367,56.11%,30.36%,1
臺北市,北投區,0123,378,304,682,39,721,1309,55.08%,28.88%,1
臺北市,北投區,0124,418,346,764,33,797,1356,58.78%,30.83%,1
臺北市,北投區,0125,427,314,741,35,776,1365,56.85%,31.28%,1
臺北市,北投區,0126,459,387,846,36,882,1613,54.68%,28.46%,1
臺北市,北投區,0127,435,356,791,19,810,1590,50.94%,27.36%,1
臺北市,北投區,0128,553,369,922,47,969,1662,58.3%,33.27%,1
臺北市,北投區,0129,518,379,897,39,936,1622,57.71%,31.94%,1
臺北市,北投區,0130,539,439,978,31,1009,1820,55.44%,29.62%,1
臺北市,北投區,0131,537,364,901,48,949,1615,58.76%,33.25%,1
臺北市,北投區,0132,450,265,715,43,758,1612,47.02%,27.92%,1
臺北市,北投區,0133,511,368,879,48,927,1652,56.11%,30.93%,1
臺北市,北投區,0134,545,380,925,22,947,1666,56.84%,32.71%,1
臺北市,北投區,0135,502,365,867,39,906,1641,55.21%,30.59%,1
臺北市,北投區,0136,161,142,303,21,324,528,61.36%,30.49%,1
臺北市,北投區,0137,388,340,728,59,787,1642,47.93%,23.63%,1
臺北市,北投區,0138,258,180,438,33,471,829,56.82%,31.12%,1
臺北市,北投區,0139,210,144,354,28,382,690,55.36%,30.43%,1
臺北市,北投區,0140,325,226,551,37,588,1067,55.11%,30.46%,1
臺北市,北投區,0141,233,211,444,63,507,892,56.84%,26.12%,1
新北市,板橋區,0894,419,314,733,47,780,1388,56.2%,30.19%,1
新北市,板橋區,0895,420,299,719,42,761,1294,58.81%,32.46%,1
新北市,板橋區,0896,234,170,404,15,419,667,62.82%,35.08%,1
新北市,板橋區,0897,290,179,469,30,499,898,55.57%,32.29%,1
新北市,板橋區,0898,293,186,479,27,506,829,61.04%,35.34%,1
新北市,板橋區,0899,282,147,429,34,463,739,62.65%,38.16%,1
新北市,板橋區,0900,351,250,601,36,637,1035,61.55%,33.91%,1
新北市,板橋區,0901,465,318,783,24,807,1713,47.11%,27.15%,1
新北市,板橋區,0902,211,129,340,11,351,658,53.34%,32.07%,1
新北市,板橋區,0903,411,261,672,65,737,1312,56.17%,31.33%,1
新北市,板橋區,0904,439,310,749,35,784,1492,52.55%,29.42%,1
新北市,板橋區,0905,405,279,684,40,724,1393,51.97%,29.07%,1
新北市,板橋區,0906,513,338,851,33,884,4742,18.64%,10.82%,1
新北市,板橋區,0907,484,297,781,26,807,1439,56.08%,33.63%,1
新北市,板橋區,0908,401,273,674,53,727,1187,61.25%,33.78%,1
新北市,板橋區,0909,369,240,609,30,639,1122,56.95%,32.89%,1
新北市,板橋區,0910,479,281,760,45,805,1363,59.06%,35.14%,1
新北市,板橋區,0911,370,244,614,36,650,1093,59.47%,33.85%,1
新北市,板橋區,0912,459,306,765,31,796,1331,59.8%,34.49%,1
新北市,板橋區,0913,360,252,612,31,643,1026,62.67%,35.09%,1
新北市,板橋區,0914,431,246,677,54,731,1244,58.76%,34.65%,1
新北市,板橋區,0915,392,249,641,54,695,1268,54.81%,30.91%,1
新北市,板橋區,0916,426,268,694,22,716,1313,54.53%,32.44%,1
新北市,板橋區,0917,388,307,695,39,734,1196,61.37%,32.44%,1
新北市,板橋區,0918,438,309,747,36,783,1137,68.87%,38.52%,1
新北市,板橋區,0919,458,322,780,31,811,1269,63.91%,36.09%,1
新北市,板橋區,0920,378,281,659,36,695,1117,62.22%,33.84%,1
新北市,板橋區,0921,395,237,632,30,662,1042,63.53%,37.91%,1
新北市,板橋區,0922,460,261,721,45,766,1257,60.94%,36.6%,1
新北市,板橋區,0923,439,256,695,34,729,1216,59.95%,36.1%,1
新北市,板橋區,0924,357,258,615,43,658,1126,58.44%,31.71%,1
新北市,板橋區,0925,516,297,813,42,855,1290,66.28%,40%,1
新北市,板橋區,0926,385,245,630,17,647,1215,53.25%,31.69%,1
新北市,板橋區,0927,399,210,609,21,630,1099,57.32%,36.31%,1
新北市,板橋區,0928,534,285,819,31,850,1329,63.96%,40.18%,1
新北市,板橋區,0929,394,189,583,23,606,996,60.84%,39.56%,1
新北市,板橋區,0930,361,249,610,24,634,1047,60.55%,34.48%,1
新北市,板橋區,0931,454,282,736,37,773,1272,60.77%,35.69%,1
新北市,板橋區,0932,424,297,721,36,757,1252,60.46%,33.87%,1
新北市,板橋區,0933,426,268,694,38,732,1238,59.13%,34.41%,1
新北市,板橋區,0934,506,331,837,51,888,1389,63.93%,36.43%,1
新北市,板橋區,0935,439,285,724,35,759,1194,63.57%,36.77%,1
新北市,板橋區,0936,351,220,571,38,609,1093,55.72%,32.11%,1
新北市,板橋區,0937,405,218,623,46,669,1148,58.28%,35.28%,1
新北市,板橋區,0938,444,300,744,32,776,1268,61.2%,35.02%,1
新北市,板橋區,0939,416,257,673,45,718,1230,58.37%,33.82%,1
新北市,板橋區,0940,342,203,545,32,577,1012,57.02%,33.79%,1
新北市,板橋區,0941,296,170,466,26,492,811,60.67%,36.5%,1
新北市,板橋區,0942,437,285,722,41,763,1197,63.74%,36.51%,1
新北市,板橋區,0943,422,206,628,26,654,1142,57.27%,36.95%,1
新北市,板橋區,0944,429,263,692,30,722,1222,59.08%,35.11%,1
新北市,板橋區,0945,315,160,475,35,510,796,64.07%,39.57%,1
新北市,板橋區,0946,371,224,595,54,649,997,65.1%,37.21%,1
新北市,板橋區,0947,350,247,597,31,628,1011,62.12%,34.62%,1
新北市,板橋區,0948,407,251,658,46,704,1157,60.85%,35.18%,1
新北市,板橋區,0949,372,212,584,37,621,1040,59.71%,35.77%,1
新北市,板橋區,0950,420,270,690,23,713,1173,60.78%,35.81%,1
新北市,板橋區,0951,379,255,634,31,665,1193,55.74%,31.77%,1
新北市,板橋區,0952,460,268,728,30,758,1255,60.4%,36.65%,1
新北市,板橋區,0953,435,306,741,31,772,1306,59.11%,33.31%,1
新北市,板橋區,0954,376,240,616,15,631,1050,60.1%,35.81%,1
新北市,板橋區,0955,335,218,553,15,568,942,60.3%,35.56%,1
新北市,板橋區,0956,432,249,681,34,715,1133,63.11%,38.13%,1
新北市,板橋區,0957,408,296,704,40,744,1251,59.47%,32.61%,1
新北市,板橋區,0958,483,275,758,31,789,1293,61.02%,37.35%,1
新北市,板橋區,0959,374,255,629,31,660,1208,54.64%,30.96%,1
新北市,板橋區,0960,398,272,670,46,716,1223,58.54%,32.54%,1
新北市,板橋區,0961,333,220,553,51,604,1061,56.93%,31.39%,1
新北市,板橋區,0962,509,346,855,38,893,1515,58.94%,33.6%,1
新北市,板橋區,0963,468,250,718,37,755,1225,61.63%,38.2%,1
新北市,板橋區,0964,437,263,700,23,723,1120,64.55%,39.02%,1
新北市,板橋區,0965,421,243,664,30,694,1091,63.61%,38.59%,1
新北市,板橋區,0966,565,257,822,29,851,1385,61.44%,40.79%,1
新北市,板橋區,0967,465,285,750,46,796,1283,62.04%,36.24%,1
新北市,板橋區,0968,400,266,666,58,724,1204,60.13%,33.22%,1
新北市,板橋區,0969,465,274,739,25,764,1191,64.15%,39.04%,1
新北市,板橋區,0970,413,240,653,37,690,1078,64.01%,38.31%,1
新北市,板橋區,0971,487,275,762,44,806,1351,59.66%,36.05%,1
新北市,板橋區,0972,453,292,745,38,783,1322,59.23%,34.27%,1
新北市,板橋區,0973,312,186,498,30,528,868,60.83%,35.94%,1
新北市,板橋區,0974,428,228,656,35,691,1029,67.15%,41.59%,1
新北市,板橋區,0975,604,300,904,33,937,1602,58.49%,37.7%,1
新北市,板橋區,0976,477,308,785,40,825,1362,60.57%,35.02%,1
新北市,板橋區,0977,536,367,903,58,961,1698,56.6%,31.57%,1
新北市,板橋區,0978,497,328,825,25,850,1495,56.86%,33.24%,1
新北市,板橋區,0979,484,324,808,42,850,1522,55.85%,31.8%,1
新北市,板橋區,0980,427,278,705,51,756,1279,59.11%,33.39%,1
新北市,板橋區,0981,461,284,745,29,774,1559,49.65%,29.57%,1
新北市,板橋區,0982,459,318,777,53,830,1537,54%,29.86%,1
新北市,板橋區,0983,432,311,743,50,793,1531,51.8%,28.22%,1
新北市,板橋區,0984,520,376,896,30,926,1720,53.84%,30.23%,1
新北市,板橋區,0985,358,261,619,31,650,1165,55.79%,30.73%,1
新北市,板橋區,0986,725,395,1120,41,1161,1857,62.52%,39.04%,1
新北市,板橋區,0987,376,211,587,39,626,1078,58.07%,34.88%,1
新北市,板橋區,0988,377,261,638,17,655,1177,55.65%,32.03%,1
新北市,板橋區,0989,600,396,996,55,1051,1798,58.45%,33.37%,1
新北市,板橋區,0990,508,317,825,53,878,1455,60.34%,34.91%,1
新北市,板橋區,0991,433,285,718,53,771,1245,61.93%,34.78%,1
新北市,板橋區,0992,526,367,893,47,940,1704,55.16%,30.87%,1
新北市,板橋區,0993,532,370,902,25,927,1600,57.94%,33.25%,1
新北市,板橋區,0994,488,258,746,24,770,1409,54.65%,34.63%,1
新北市,板橋區,0995,423,281,704,39,743,1286,57.78%,32.89%,1
新北市,板橋區,0996,372,235,607,67,674,1359,49.6%,27.37%,1
新北市,板橋區,0997,354,256,610,23,633,1188,53.28%,29.8%,1
新北市,板橋區,0998,546,312,858,41,899,1627,55.26%,33.56%,1
新北市,板橋區,0999,498,335,833,26,859,1633,52.6%,30.5%,1
新北市,板橋區,1000,612,430,1042,43,1085,1814,59.81%,33.74%,1
新北市,板橋區,1001,598,404,1002,50,1052,1810,58.12%,33.04%,1
新北市,板橋區,1002,405,218,623,44,667,1133,58.87%,35.75%,1
新北市,板橋區,1003,292,203,495,18,513,841,61%,34.72%,1
新北市,板橋區,1004,389,241,630,35,665,1050,63.33%,37.05%,1
新北市,板橋區,1005,363,235,598,43,641,1130,56.73%,32.12%,1
新北市,板橋區,1006,351,269,620,40,660,1056,62.5%,33.24%,1
新北市,板橋區,1007,359,239,598,36,634,1129,56.16%,31.8%,1
新北市,板橋區,1008,581,354,935,49,984,1713,57.44%,33.92%,1
新北市,板橋區,1009,538,362,900,48,948,1622,58.45%,33.17%,1
新北市,板橋區,1010,510,350,860,37,897,1427,62.86%,35.74%,1
新北市,板橋區,1011,554,346,900,21,921,1471,62.61%,37.66%,1
新北市,板橋區,1012,399,243,642,15,657,1076,61.06%,37.08%,1
新北市,板橋區,1013,324,199,523,10,533,979,54.44%,33.09%,1
新北市,板橋區,1014,407,263,670,20,690,1079,63.95%,37.72%,1
新北市,板橋區,1015,279,174,453,23,476,828,57.49%,33.7%,1
新北市,板橋區,1016,288,187,475,46,521,820,63.54%,35.12%,1
新北市,板橋區,1017,378,218,596,32,628,989,63.5%,38.22%,1
新北市,板橋區,1018,336,230,566,37,603,1023,58.94%,32.84%,1
新北市,板橋區,1019,359,216,575,32,607,1044,58.14%,34.39%,1
新北市,板橋區,1020,335,205,540,36,576,968,59.5%,34.61%,1
新北市,板橋區,1021,423,278,701,22,723,1222,59.17%,34.62%,1
新北市,板橋區,1022,470,268,738,43,781,1385,56.39%,33.94%,1
新北市,板橋區,1023,526,318,844,48,892,1585,56.28%,33.19%,1
新北市,板橋區,1024,576,373,949,47,996,1840,54.13%,31.3%,1
新北市,板橋區,1025,681,397,1078,55,1133,1806,62.74%,37.71%,1
新北市,板橋區,1026,487,311,798,60,858,1506,56.97%,32.34%,1
新北市,板橋區,1027,474,312,786,43,829,1476,56.17%,32.11%,1
新北市,板橋區,1028,507,323,830,51,881,1500,58.73%,33.8%,1
新北市,板橋區,1029,387,266,653,52,705,1096,64.32%,35.31%,1
新北市,板橋區,1030,376,193,569,34,603,963,62.62%,39.04%,1
新北市,板橋區,1031,479,397,876,33,909,1601,56.78%,29.92%,1
新北市,板橋區,1032,524,345,869,52,921,1507,61.11%,34.77%,1
新北市,板橋區,1033,461,307,768,52,820,1315,62.36%,35.06%,1
新北市,板橋區,1034,409,259,668,22,690,1178,58.57%,34.72%,1
新北市,板橋區,1035,654,396,1050,53,1103,1822,60.54%,35.89%,1
新北市,板橋區,1036,576,374,950,52,1002,1605,62.43%,35.89%,1
新北市,板橋區,1037,548,338,886,26,912,1549,58.88%,35.38%,1
新北市,板橋區,1038,596,456,1052,29,1081,1948,55.49%,30.6%,1
新北市,板橋區,1039,649,415,1064,30,1094,1935,56.54%,33.54%,1
新北市,板橋區,1040,357,223,580,31,611,1097,55.7%,32.54%,1
新北市,板橋區,1041,381,205,586,25,611,1095,55.8%,34.79%,1
新北市,板橋區,1042,538,320,858,67,925,1678,55.13%,32.06%,1
新北市,板橋區,1043,570,348,918,47,965,1750,55.14%,32.57%,1
新北市,板橋區,1044,383,250,633,33,666,1187,56.11%,32.27%,1
新北市,板橋區,1045,389,276,665,27,692,1154,59.97%,33.71%,1
新北市,板橋區,1046,455,293,748,28,776,1262,61.49%,36.05%,1
新北市,板橋區,1047,408,278,686,41,727,1271,57.2%,32.1%,1
新北市,板橋區,1048,467,295,762,47,809,1410,57.38%,33.12%,1
新北市,板橋區,1049,526,343,869,48,917,1745,52.55%,30.14%,1
新北市,板橋區,1050,606,377,983,77,1060,1867,56.78%,32.46%,1
新北市,板橋區,1051,623,369,992,62,1054,1753,60.13%,35.54%,1
新北市,板橋區,1052,382,295,677,49,726,1204,60.3%,31.73%,1
新北市,板橋區,1053,505,340,845,42,887,1614,54.96%,31.29%,1
新北市,板橋區,1054,396,307,703,39,742,1237,59.98%,32.01%,1
新北市,板橋區,1055,448,318,766,52,818,1361,60.1%,32.92%,1
新北市,板橋區,1056,392,308,700,27,727,1243,58.49%,31.54%,1
新北市,板橋區,1057,450,320,770,30,800,1515,52.81%,29.7%,1
新北市,板橋區,1058,495,365,860,51,911,1515,60.13%,32.67%,1
新北市,板橋區,1059,311,244,555,33,588,949,61.96%,32.77%,1
新北市,板橋區,1060,630,239,869,38,907,1629,55.68%,38.67%,1
新北市,板橋區,1061,409,281,690,33,723,1238,58.4%,33.04%,1
新北市,板橋區,1062,246,137,383,15,398,901,44.17%,27.3%,1
新北市,板橋區,1063,466,353,819,43,862,1475,58.44%,31.59%,1
新北市,板橋區,1064,477,308,785,49,834,1481,56.31%,32.21%,1
新北市,板橋區,1065,557,366,923,41,964,1800,53.56%,30.94%,1
新北市,板橋區,1066,532,330,862,52,914,1630,56.07%,32.64%,1
新北市,板橋區,1067,453,304,757,26,783,1298,60.32%,34.9%,1
新北市,板橋區,1068,292,203,495,32,527,874,60.3%,33.41%,1
新北市,板橋區,1069,338,246,584,13,597,992,60.18%,34.07%,1
新北市,板橋區,1070,414,241,655,25,680,1034,65.76%,40.04%,1
新北市,板橋區,1071,496,323,819,48,867,1451,59.75%,34.18%,1
新北市,板橋區,1072,389,279,668,28,696,1130,61.59%,34.42%,1
新北市,板橋區,1073,481,335,816,33,849,1440,58.96%,33.4%,1
新北市,板橋區,1074,507,336,843,65,908,1531,59.31%,33.12%,1
新北市,板橋區,1075,477,350,827,39,866,1349,64.2%,35.36%,1
新北市,板橋區,1076,506,340,846,27,873,1593,54.8%,31.76%,1
新北市,板橋區,1077,415,247,662,23,685,1174,58.35%,35.35%,1
新北市,板橋區,1078,441,250,691,35,726,1228,59.12%,35.91%,1
新北市,板橋區,1079,422,270,692,28,720,1187,60.66%,35.55%,1
新北市,板橋區,1080,299,204,503,35,538,870,61.84%,34.37%,1
新北市,板橋區,1081,742,455,1197,32,1229,2033,60.45%,36.5%,1
新北市,板橋區,1082,442,290,732,40,772,1418,54.44%,31.17%,1
新北市,板橋區,1083,359,236,595,29,624,1075,58.05%,33.4%,1
新北市,板橋區,1084,512,298,810,33,843,1515,55.64%,33.8%,1
新北市,板橋區,1085,481,270,751,26,777,1182,65.74%,40.69%,1
新北市,板橋區,1086,594,407,1001,54,1055,1893,55.73%,31.38%,1
新北市,板橋區,1087,416,265,681,41,722,1302,55.45%,31.95%,1
新北市,板橋區,1088,416,282,698,38,736,1366,53.88%,30.45%,1
新北市,板橋區,1089,446,326,772,56,828,1318,62.82%,33.84%,1
新北市,板橋區,1090,381,266,647,45,692,1200,57.67%,31.75%,1
新北市,板橋區,1091,625,480,1105,37,1142,2028,56.31%,30.82%,1
新北市,板橋區,1092,599,359,958,68,1026,1746,58.76%,34.31%,1
新北市,板橋區,1093,573,405,978,23,1001,1954,51.23%,29.32%,1
新北市,板橋區,1094,494,300,794,38,832,1474,56.45%,33.51%,1
新北市,板橋區,1095,483,301,784,37,821,1418,57.9%,34.06%,1
新北市,板橋區,1096,562,376,938,46,984,1563,62.96%,35.96%,1
新北市,板橋區,1097,579,344,923,64,987,1780,55.45%,32.53%,1
新北市,板橋區,1098,541,385,926,40,966,1707,56.59%,31.69%,1
新北市,板橋區,1099,241,136,377,10,387,906,42.72%,26.6%,1
新北市,板橋區,1100,327,227,554,43,597,1030,57.96%,31.75%,1
新北市,板橋區,1101,366,257,623,35,658,1115,59.01%,32.83%,1
新北市,板橋區,1102,615,373,988,20,1008,1836,54.9%,33.5%,1
新北市,板橋區,1103,581,411,992,61,1053,1881,55.98%,30.89%,1
新北市,板橋區,1104,544,370,914,28,942,1688,55.81%,32.23%,1
新北市,板橋區,1105,619,383,1002,35,1037,1760,58.92%,35.17%,1
新北市,板橋區,1106,384,240,624,32,656,1044,62.84%,36.78%,1
新北市,板橋區,1107,381,250,631,28,659,1043,63.18%,36.53%,1
新北市,板橋區,1108,387,270,657,36,693,1099,63.06%,35.21%,1
新北市,板橋區,1109,389,286,675,53,728,1260,57.78%,30.87%,1
新北市,板橋區,1110,382,252,634,25,659,1131,58.27%,33.78%,1
新北市,板橋區,1111,421,272,693,28,721,1225,58.86%,34.37%,1
新北市,板橋區,1112,524,352,876,34,910,1455,62.54%,36.01%,1
新北市,板橋區,1113,427,271,698,32,730,1267,57.62%,33.7%,1
新北市,板橋區,1114,335,231,566,32,598,972,61.52%,34.47%,1
新北市,板橋區,1115,356,219,575,32,607,994,61.07%,35.81%,1
新北市,板橋區,1116,396,234,630,18,648,1111,58.33%,35.64%,1
新北市,板橋區,1117,474,261,735,45,780,1177,66.27%,40.27%,1
新北市,板橋區,1118,471,343,814,48,862,1544,55.83%,30.51%,1
新北市,板橋區,1119,316,228,544,54,598,1021,58.57%,30.95%,1
新北市,板橋區,1120,359,205,564,31,595,1040,57.21%,34.52%,1
新北市,板橋區,1121,470,338,808,25,833,1504,55.39%,31.25%,1
新北市,板橋區,1122,430,283,713,32,745,1373,54.26%,31.32%,1
新北市,板橋區,1123,405,298,703,19,722,1210,59.67%,33.47%,1
新北市,板橋區,1124,578,341,919,43,962,1809,53.18%,31.95%,1
新北市,板橋區,1125,559,322,881,51,932,1551,60.09%,36.04%,1
新北市,板橋區,1126,481,308,789,31,820,1408,58.24%,34.16%,1
新北市,板橋區,1127,468,289,757,26,783,1285,60.93%,36.42%,1
新北市,板橋區,1128,431,266,697,24,721,1102,65.43%,39.11%,1
新北市,板橋區,1129,452,269,721,29,750,1399,53.61%,32.31%,1
新北市,板橋區,1130,582,334,916,54,970,1692,57.33%,34.4%,1
新北市,板橋區,1131,587,387,974,26,1000,1625,61.54%,36.12%,1
新北市,板橋區,1132,523,389,912,57,969,1712,56.6%,30.55%,1
新北市,板橋區,1133,426,270,696,35,731,1246,58.67%,34.19%,1
新北市,板橋區,1134,520,324,844,34,878,1471,59.69%,35.35%,1
新北市,板橋區,1135,619,370,989,48,1037,1761,58.89%,35.15%,1
新北市,板橋區,1136,489,328,817,45,862,1499,57.51%,32.62%,1
新北市,板橋區,1137,449,319,768,45,813,1528,53.21%,29.38%,1
新北市,板橋區,1138,523,353,876,46,922,1536,60.03%,34.05%,1
新北市,板橋區,1139,542,331,873,35,908,1550,58.58%,34.97%,1
新北市,板橋區,1140,662,458,1120,66,1186,2050,57.85%,32.29%,1
新北市,板橋區,1141,445,292,737,40,777,1300,59.77%,34.23%,1
新北市,板橋區,1142,544,307,851,37,888,1537,57.77%,35.39%,1
新北市,板橋區,1143,438,267,705,29,734,1341,54.74%,32.66%,1
新北市,板橋區,1144,525,366,891,29,920,1606,57.29%,32.69%,1
新北市,板橋區,1145,466,269,735,40,775,1433,54.08%,32.52%,1
新北市,板橋區,1146,532,338,870,38,908,1685,53.89%,31.57%,1
新北市,板橋區,1147,457,271,728,46,774,1248,62.02%,36.62%,1
新北市,板橋區,1148,407,223,630,34,664,1172,56.66%,34.73%,1
新北市,板橋區,1149,485,313,798,36,834,1640,50.85%,29.57%,1
新北市,板橋區,1150,509,285,794,31,825,1428,57.77%,35.64%,1
新北市,板橋區,1151,466,371,837,48,885,1527,57.96%,30.52%,1
新北市,板橋區,1152,474,296,770,24,794,1350,58.81%,35.11%,1
新北市,板橋區,1153,523,323,846,52,898,1582,56.76%,33.06%,1
新北市,板橋區,1154,367,206,573,30,603,919,65.61%,39.93%,1
新北市,板橋區,1155,367,182,549,15,564,930,60.65%,39.46%,1
新北市,板橋區,1156,397,208,605,19,624,974,64.07%,40.76%,1
新北市,板橋區,1157,612,357,969,43,1012,1732,58.43%,35.33%,1
新北市,板橋區,1158,460,295,755,54,809,1438,56.26%,31.99%,1
新北市,板橋區,1159,567,364,931,45,976,1777,54.92%,31.91%,1
新北市,板橋區,1160,535,319,854,30,884,1764,50.11%,30.33%,1
新北市,板橋區,1161,440,287,727,21,748,1289,58.03%,34.13%,1
新北市,板橋區,1162,422,232,654,42,696,1182,58.88%,35.7%,1
新北市,板橋區,1163,424,249,673,32,705,1174,60.05%,36.12%,1
新北市,板橋區,1164,590,362,952,59,1011,1870,54.06%,31.55%,1
新北市,板橋區,1165,607,431,1038,43,1081,1842,58.69%,32.95%,1
新北市,板橋區,1166,377,236,613,35,648,1094,59.23%,34.46%,1
新北市,板橋區,1167,399,244,643,36,679,1228,55.29%,32.49%,1
新北市,板橋區,1168,411,232,643,33,676,998,67.74%,41.18%,1
新北市,板橋區,1169,341,210,551,24,575,862,66.71%,39.56%,1
新北市,板橋區,1170,494,325,819,40,859,1622,52.96%,30.46%,1
新北市,板橋區,1171,448,247,695,32,727,1205,60.33%,37.18%,1
新北市,板橋區,1172,490,391,881,40,921,1787,51.54%,27.42%,1
新北市,板橋區,1173,523,354,877,32,909,1610,56.46%,32.48%,1
新北市,板橋區,1174,743,544,1287,30,1317,2216,59.43%,33.53%,1
新北市,板橋區,1175,740,485,1225,45,1270,2294,55.36%,32.26%,1
新北市,板橋區,1176,657,436,1093,54,1147,2090,54.88%,31.44%,1
新北市,板橋區,1177,421,234,655,27,682,1356,50.29%,31.05%,1
新北市,板橋區,1178,388,222,610,34,644,1067,60.36%,36.36%,1
新北市,板橋區,1179,432,300,732,27,759,1319,57.54%,32.75%,1
新北市,板橋區,1180,444,274,718,26,744,1316,56.53%,33.74%,1
新北市,板橋區,1181,397,217,614,39,653,1195,54.64%,33.22%,1
新北市,板橋區,1182,265,214,479,22,501,857,58.46%,30.92%,1
新北市,板橋區,1183,428,295,723,53,776,1417,54.76%,30.2%,1
新北市,板橋區,1184,490,358,848,65,913,1560,58.53%,31.41%,1
新北市,板橋區,1185,558,388,946,65,1011,1747,57.87%,31.94%,1
新北市,板橋區,1186,431,280,711,37,748,1176,63.61%,36.65%,1
新北市,板橋區,1187,346,285,631,27,658,1101,59.76%,31.43%,1
新北市,板橋區,1188,498,341,839,28,867,1458,59.47%,34.16%,1
新北市,板橋區,1189,498,283,781,40,821,1630,50.37%,30.55%,1
新北市,板橋區,1190,512,326,838,62,900,1611,55.87%,31.78%,1
新北市,板橋區,1191,347,243,590,38,628,1139,55.14%,30.47%,1
新北市,板橋區,1192,358,257,615,18,633,1120,56.52%,31.96%,1
新北市,板橋區,1193,344,251,595,60,655,1022,64.09%,33.66%,1
新北市,板橋區,1194,362,231,593,51,644,1049,61.39%,34.51%,1
新北市,板橋區,1195,345,223,568,27,595,1007,59.09%,34.26%,1
新北市,板橋區,1196,467,297,764,28,792,1393,56.86%,33.52%,1
新北市,板橋區,1197,91,77,168,34,202,474,42.62%,19.2%,1
新北市,板橋區,1198,165,114,279,21,300,500,60%,33%,1
新北市,板橋區,1199,371,245,616,32,648,1177,55.06%,31.52%,1
新北市,板橋區,1200,424,236,660,26,686,1186,57.84%,35.75%,1
新北市,板橋區,1201,391,278,669,37,706,1139,61.98%,34.33%,1
新北市,板橋區,1202,559,368,927,44,971,1750,55.49%,31.94%,1
新北市,板橋區,1203,716,458,1174,58,1232,3451,35.7%,20.75%,1
新北市,板橋區,1204,488,317,805,56,861,1620,53.15%,30.12%,1
新北市,板橋區,1205,278,174,452,24,476,903,52.71%,30.79%,1
新北市,板橋區,1206,408,287,695,27,722,1232,58.6%,33.12%,1
新北市,板橋區,1207,293,198,491,18,509,975,52.21%,30.05%,1
新北市,板橋區,1208,414,250,664,29,693,1224,56.62%,33.82%,1
新北市,板橋區,1209,454,256,710,28,738,1291,57.16%,35.17%,1
新北市,板橋區,1210,507,391,898,38,936,1828,51.2%,27.74%,1
新北市,板橋區,1211,504,333,837,52,889,1725,51.54%,29.22%,1
新北市,板橋區,1212,309,221,530,27,557,1085,51.34%,28.48%,1
新北市,板橋區,1213,694,474,1168,54,1222,2357,51.85%,29.44%,1
新北市,板橋區,1214,465,362,827,22,849,1560,54.42%,29.81%,1
新北市,板橋區,1215,604,386,990,21,1011,2201,45.93%,27.44%,1
新北市,板橋區,1216,507,337,844,30,874,1626,53.75%,31.18%,1
新北市,板橋區,1217,693,123,816,21,837,1786,46.86%,38.8%,1
新北市,板橋區,1218,557,374,931,30,961,1763,54.51%,31.59%,1
新北市,板橋區,1219,533,348,881,22,903,1744,51.78%,30.56%,1
新北市,板橋區,1220,489,348,837,58,895,1645,54.41%,29.73%,1
新北市,板橋區,1221,547,367,914,25,939,1861,50.46%,29.39%,1
新北市,板橋區,1222,480,301,781,29,810,1596,50.75%,30.08%,1
新北市,板橋區,1223,579,389,968,46,1014,1871,54.2%,30.95%,1
新北市,板橋區,1224,621,384,1005,45,1050,1938,54.18%,32.04%,1
新北市,板橋區,1225,608,370,978,36,1014,1827,55.5%,33.28%,1
新北市,板橋區,1226,433,269,702,21,723,1359,53.2%,31.86%,1
新北市,板橋區,1227,510,343,853,41,894,1613,55.42%,31.62%,1
新北市,板橋區,1228,513,331,844,45,889,1566,56.77%,32.76%,1
新北市,板橋區,1229,544,372,916,38,954,1552,61.47%,35.05%,1
新北市,板橋區,1230,568,393,961,34,995,1885,52.79%,30.13%,1
新北市,板橋區,1231,564,375,939,49,988,1893,52.19%,29.79%,1
新北市,三重區,0659,420,350,770,40,810,1509,53.68%,27.83%,1
新北市,三重區,0660,509,367,876,46,922,1591,57.95%,31.99%,1
新北市,三重區,0661,512,389,901,61,962,1653,58.2%,30.97%,1
新北市,三重區,0662,482,290,772,57,829,1392,59.55%,34.63%,1
新北市,三重區,0663,508,317,825,57,882,1451,60.79%,35.01%,1
新北市,三重區,0664,447,289,736,47,783,1329,58.92%,33.63%,1
新北市,三重區,0665,468,352,820,23,843,1459,57.78%,32.08%,1
新北市,三重區,0666,311,261,572,47,619,1024,60.45%,30.37%,1
新北市,三重區,0667,353,253,606,41,647,1066,60.69%,33.11%,1
新北市,三重區,0668,312,220,532,37,569,856,66.47%,36.45%,1
新北市,三重區,0669,225,177,402,34,436,764,57.07%,29.45%,1
新北市,三重區,0670,277,200,477,42,519,821,63.22%,33.74%,1
新北市,三重區,0671,545,396,941,57,998,1887,52.89%,28.88%,1
新北市,三重區,0672,488,300,788,41,829,1646,50.36%,29.65%,1
新北市,三重區,0673,116,96,212,11,223,358,62.29%,32.4%,1
新北市,三重區,0674,338,248,586,39,625,1039,60.15%,32.53%,1
新北市,三重區,0675,372,277,649,30,679,1114,60.95%,33.39%,1
新北市,三重區,0676,513,400,913,35,948,1588,59.7%,32.3%,1
新北市,三重區,0677,536,344,880,31,911,1702,53.53%,31.49%,1
新北市,三重區,0678,431,314,745,42,787,1288,61.1%,33.46%,1
新北市,三重區,0679,552,390,942,40,982,1629,60.28%,33.89%,1
新北市,三重區,0680,608,385,993,56,1049,1861,56.37%,32.67%,1
新北市,三重區,0681,521,348,869,41,910,1727,52.69%,30.17%,1
新北市,三重區,0682,540,413,953,47,1000,1813,55.16%,29.78%,1
新北市,三重區,0683,542,309,851,55,906,1595,56.8%,33.98%,1
新北市,三重區,0684,497,336,833,50,883,1513,58.36%,32.85%,1
新北市,三重區,0685,419,369,788,37,825,4433,18.61%,9.45%,1
新北市,三重區,0686,443,272,715,34,749,1283,58.38%,34.53%,1
新北市,三重區,0687,511,324,835,40,875,1430,61.19%,35.73%,1
新北市,三重區,0688,465,328,793,21,814,1357,59.99%,34.27%,1
新北市,三重區,0689,331,217,548,25,573,963,59.5%,34.37%,1
新北市,三重區,0690,276,211,487,33,520,883,58.89%,31.26%,1
新北市,三重區,0691,493,297,790,65,855,1494,57.23%,33%,1
新北市,三重區,0692,533,261,794,64,858,1616,53.09%,32.98%,1
新北市,三重區,0693,416,306,722,40,762,1329,57.34%,31.3%,1
新北市,三重區,0694,471,295,766,40,806,1289,62.53%,36.54%,1
新北市,三重區,0695,442,314,756,49,805,1380,58.33%,32.03%,1
新北市,三重區,0696,544,385,929,33,962,1668,57.67%,32.61%,1
新北市,三重區,0697,430,299,729,47,776,1226,63.3%,35.07%,1
新北市,三重區,0698,495,333,828,29,857,1421,60.31%,34.83%,1
新北市,三重區,0699,461,311,772,41,813,1364,59.6%,33.8%,1
新北市,三重區,0700,406,286,692,42,734,1232,59.58%,32.95%,1
新北市,三重區,0701,418,319,737,44,781,1248,62.58%,33.49%,1
新北市,三重區,0702,411,294,705,50,755,1256,60.11%,32.72%,1
新北市,三重區,0703,492,400,892,39,931,1506,61.82%,32.67%,1
新北市,三重區,0704,543,304,847,40,887,1669,53.15%,32.53%,1
新北市,三重區,0705,427,284,711,49,760,1308,58.1%,32.65%,1
新北市,三重區,0706,491,300,791,41,832,1263,65.87%,38.88%,1
新北市,三重區,0707,461,314,775,65,840,1471,57.1%,31.34%,1
新北市,三重區,0708,488,330,818,59,877,1447,60.61%,33.72%,1
新北市,三重區,0709,435,346,781,54,835,1693,49.32%,25.69%,1
新北市,三重區,0710,607,438,1045,50,1095,2015,54.34%,30.12%,1
新北市,三重區,0711,554,335,889,65,954,1812,52.65%,30.57%,1
新北市,三重區,0712,463,327,790,29,819,1509,54.27%,30.68%,1
新北市,三重區,0713,464,344,808,38,846,1439,58.79%,32.24%,1
新北市,三重區,0714,473,317,790,36,826,1437,57.48%,32.92%,1
新北市,三重區,0715,463,406,869,53,922,1697,54.33%,27.28%,1
新北市,三重區,0716,544,356,900,37,937,1793,52.26%,30.34%,1
新北市,三重區,0717,563,364,927,34,961,1603,59.95%,35.12%,1
新北市,三重區,0718,360,260,620,16,636,1166,54.55%,30.87%,1
新北市,三重區,0719,377,251,628,39,667,1126,59.24%,33.48%,1
新北市,三重區,0720,362,256,618,36,654,1291,50.66%,28.04%,1
新北市,三重區,0721,499,371,870,56,926,1597,57.98%,31.25%,1
新北市,三重區,0722,356,254,610,55,665,1081,61.52%,32.93%,1
新北市,三重區,0723,314,242,556,34,590,911,64.76%,34.47%,1
新北市,三重區,0724,489,335,824,33,857,1719,49.85%,28.45%,1
新北市,三重區,0725,408,268,676,51,727,1289,56.4%,31.65%,1
新北市,三重區,0726,451,296,747,57,804,1318,61%,34.22%,1
新北市,三重區,0727,527,375,902,62,964,1822,52.91%,28.92%,1
新北市,三重區,0728,396,242,638,61,699,1185,58.99%,33.42%,1
新北市,三重區,0729,381,285,666,56,722,1369,52.74%,27.83%,1
新北市,三重區,0730,487,319,806,58,864,1507,57.33%,32.32%,1
新北市,三重區,0731,307,201,508,47,555,926,59.94%,33.15%,1
新北市,三重區,0732,279,217,496,19,515,950,54.21%,29.37%,1
新北市,三重區,0733,349,500,849,49,898,1678,53.52%,20.8%,1
新北市,三重區,0734,332,244,576,62,638,1117,57.12%,29.72%,1
新北市,三重區,0735,401,267,668,44,712,1318,54.02%,30.42%,1
新北市,三重區,0736,416,351,767,34,801,1388,57.71%,29.97%,1
新北市,三重區,0737,310,244,554,46,600,1026,58.48%,30.21%,1
新北市,三重區,0738,346,295,641,42,683,1096,62.32%,31.57%,1
新北市,三重區,0739,315,222,537,36,573,967,59.26%,32.57%,1
新北市,三重區,0740,563,382,945,41,986,1871,52.7%,30.09%,1
新北市,三重區,0741,517,359,876,64,940,1663,56.52%,31.09%,1
新北市,三重區,0742,412,244,656,27,683,1208,56.54%,34.11%,1
新北市,三重區,0743,405,286,691,53,744,1398,53.22%,28.97%,1
新北市,三重區,0744,352,218,570,20,590,1078,54.73%,32.65%,1
新北市,三重區,0745,345,218,563,50,613,1102,55.63%,31.31%,1
新北市,三重區,0746,394,313,707,60,767,1393,55.06%,28.28%,1
新北市,三重區,0747,406,279,685,56,741,1251,59.23%,32.45%,1
新北市,三重區,0748,445,301,746,43,789,1234,63.94%,36.06%,1
新北市,三重區,0749,492,425,917,43,960,1661,57.8%,29.62%,1
新北市,三重區,0750,530,326,856,52,908,1590,57.11%,33.33%,1
新北市,三重區,0751,369,287,656,50,706,1182,59.73%,31.22%,1
新北市,三重區,0752,420,347,767,51,818,1369,59.75%,30.68%,1
新北市,三重區,0753,434,283,717,41,758,1222,62.03%,35.52%,1
新北市,三重區,0754,421,261,682,61,743,1304,56.98%,32.29%,1
新北市,三重區,0755,314,220,534,32,566,1054,53.7%,29.79%,1
新北市,三重區,0756,504,357,861,58,919,1635,56.21%,30.83%,1
新北市,三重區,0757,524,363,887,50,937,1779,52.67%,29.45%,1
新北市,三重區,0758,503,379,882,53,935,1633,57.26%,30.8%,1
新北市,三重區,0759,354,255,609,36,645,1107,58.27%,31.98%,1
新北市,三重區,0760,358,259,617,29,646,1021,63.27%,35.06%,1
新北市,三重區,0761,438,346,784,71,855,1649,51.85%,26.56%,1
新北市,三重區,0762,266,197,463,34,497,874,56.86%,30.43%,1
新北市,三重區,0763,465,301,766,68,834,1402,59.49%,33.17%,1
新北市,三重區,0764,488,330,818,55,873,1713,50.96%,28.49%,1
新北市,三重區,0765,240,199,439,52,491,973,50.46%,24.67%,1
新北市,三重區,0766,331,248,579,38,617,1038,59.44%,31.89%,1
新北市,三重區,0767,480,359,839,102,941,1833,51.34%,26.19%,1
新北市,三重區,0768,235,202,437,28,465,817,56.92%,28.76%,1
新北市,三重區,0769,505,308,813,50,863,1387,62.22%,36.41%,1
新北市,三重區,0770,253,203,456,26,482,784,61.48%,32.27%,1
新北市,三重區,0771,329,244,573,23,596,1096,54.38%,30.02%,1
新北市,三重區,0772,372,255,627,63,690,1163,59.33%,31.99%,1
新北市,三重區,0773,537,395,932,50,982,1868,52.57%,28.75%,1
新北市,三重區,0774,344,219,563,51,614,1117,54.97%,30.8%,1
新北市,三重區,0775,281,185,466,34,500,934,53.53%,30.09%,1
新北市,三重區,0776,407,294,701,47,748,1412,52.97%,28.82%,1
新北市,三重區,0777,378,266,644,32,676,1062,63.65%,35.59%,1
新北市,三重區,0778,259,190,449,62,511,891,57.35%,29.07%,1
新北市,三重區,0779,349,232,581,64,645,936,68.91%,37.29%,1
新北市,三重區,0780,309,238,547,52,599,1085,55.21%,28.48%,1
新北市,三重區,0781,292,234,526,17,543,1065,50.99%,27.42%,1
新北市,三重區,0782,415,338,753,51,804,1398,57.51%,29.69%,1
新北市,三重區,0783,531,320,851,36,887,1550,57.23%,34.26%,1
新北市,三重區,0784,490,357,847,64,911,1674,54.42%,29.27%,1
新北市,三重區,0785,410,262,672,46,718,1215,59.09%,33.74%,1
新北市,三重區,0786,486,344,830,56,886,1606,55.17%,30.26%,1
新北市,三重區,0787,355,280,635,35,670,1182,56.68%,30.03%,1
新北市,三重區,0788,373,304,677,57,734,1238,59.29%,30.13%,1
新北市,三重區,0789,404,348,752,51,803,1342,59.84%,30.1%,1
新北市,三重區,0790,457,319,776,47,823,1408,58.45%,32.46%,1
新北市,三重區,0791,540,396,936,60,996,1770,56.27%,30.51%,1
新北市,三重區,0792,297,208,505,47,552,940,58.72%,31.6%,1
新北市,三重區,0793,296,226,522,24,546,975,56%,30.36%,1
新北市,三重區,0794,440,335,775,34,809,1507,53.68%,29.2%,1
新北市,三重區,0795,443,312,755,58,813,1419,57.29%,31.22%,1
新北市,三重區,0796,400,268,668,49,717,1257,57.04%,31.82%,1
新北市,三重區,0797,522,353,875,40,915,1619,56.52%,32.24%,1
新北市,三重區,0798,566,338,904,49,953,1745,54.61%,32.44%,1
新北市,三重區,0799,452,335,787,69,856,1519,56.35%,29.76%,1
新北市,三重區,0800,509,338,847,42,889,1682,52.85%,30.26%,1
新北市,三重區,0801,536,407,943,54,997,1697,58.75%,31.59%,1
新北市,三重區,0802,332,215,547,43,590,1073,54.99%,30.94%,1
新北市,三重區,0803,285,200,485,28,513,924,55.52%,30.84%,1
新北市,三重區,0804,434,335,769,42,811,1613,50.28%,26.91%,1
新北市,三重區,0805,307,212,519,29,548,1034,53%,29.69%,1
新北市,三重區,0806,360,243,603,47,650,1118,58.14%,32.2%,1
新北市,三重區,0807,406,279,685,47,732,1269,57.68%,31.99%,1
新北市,三重區,0808,306,202,508,49,557,990,56.26%,30.91%,1
新北市,三重區,0809,428,291,719,45,764,1336,57.19%,32.04%,1
新北市,三重區,0810,500,348,848,47,895,1601,55.9%,31.23%,1
新北市,三重區,0811,536,367,903,53,956,1581,60.47%,33.9%,1
新北市,三重區,0812,424,309,733,45,778,1345,57.84%,31.52%,1
新北市,三重區,0813,411,300,711,44,755,1226,61.58%,33.52%,1
新北市,三重區,0814,462,331,793,75,868,1650,52.61%,28%,1
新北市,三重區,0815,365,254,619,37,656,1140,57.54%,32.02%,1
新北市,三重區,0816,471,334,805,41,846,1639,51.62%,28.74%,1
新北市,三重區,0817,544,354,898,52,950,1699,55.92%,32.02%,1
新北市,三重區,0818,552,387,939,55,994,1501,66.22%,36.78%,1
新北市,三重區,0819,486,351,837,32,869,1538,56.5%,31.6%,1
新北市,三重區,0820,453,335,788,60,848,1540,55.06%,29.42%,1
新北市,三重區,0821,387,283,670,47,717,1276,56.19%,30.33%,1
新北市,三重區,0822,450,320,770,50,820,1539,53.28%,29.24%,1
新北市,三重區,0823,370,304,674,30,704,1170,60.17%,31.62%,1
新北市,三重區,0824,430,167,597,41,638,1120,56.96%,38.39%,1
新北市,三重區,0825,575,374,949,63,1012,1789,56.57%,32.14%,1
新北市,三重區,0826,395,356,751,60,811,1520,53.36%,25.99%,1
新北市,三重區,0827,554,388,942,67,1009,1821,55.41%,30.42%,1
新北市,三重區,0828,392,342,734,55,789,1407,56.08%,27.86%,1
新北市,三重區,0829,450,341,791,45,836,1491,56.07%,30.18%,1
新北市,三重區,0830,460,325,785,45,830,1381,60.1%,33.31%,1
新北市,三重區,0831,391,273,664,51,715,1222,58.51%,32%,1
新北市,三重區,0832,569,426,995,45,1040,1938,53.66%,29.36%,1
新北市,三重區,0833,517,352,869,30,899,1639,54.85%,31.54%,1
新北市,三重區,0834,487,351,838,68,906,1614,56.13%,30.17%,1
新北市,三重區,0835,514,372,886,53,939,1709,54.94%,30.08%,1
新北市,三重區,0836,556,315,871,60,931,1753,53.11%,31.72%,1
新北市,三重區,0837,429,336,765,54,819,1398,58.58%,30.69%,1
新北市,三重區,0838,480,387,867,66,933,1706,54.69%,28.14%,1
新北市,三重區,0839,506,370,876,48,924,1614,57.25%,31.35%,1
新北市,三重區,0840,535,345,880,66,946,1591,59.46%,33.63%,1
新北市,三重區,0841,519,371,890,34,924,1627,56.79%,31.9%,1
新北市,三重區,0842,473,343,816,60,876,1505,58.21%,31.43%,1
新北市,三重區,0843,414,301,715,44,759,1331,57.02%,31.1%,1
新北市,三重區,0844,489,304,793,46,839,1678,50%,29.14%,1
新北市,三重區,0845,436,372,808,39,847,1498,56.54%,29.11%,1
新北市,三重區,0846,558,441,999,58,1057,1800,58.72%,31%,1
新北市,三重區,0847,451,340,791,44,835,1703,49.03%,26.48%,1
新北市,三重區,0848,649,288,937,47,984,1975,49.82%,32.86%,1
新北市,三重區,0849,545,396,941,40,981,1894,51.8%,28.78%,1
新北市,三重區,0850,421,365,786,37,823,1405,58.58%,29.96%,1
新北市,三重區,0851,402,313,715,37,752,1293,58.16%,31.09%,1
新北市,三重區,0852,361,327,688,40,728,1259,57.82%,28.67%,1
新北市,三重區,0853,388,272,660,52,712,1144,62.24%,33.92%,1
新北市,三重區,0854,396,320,716,51,767,1254,61.16%,31.58%,1
新北市,三重區,0855,407,305,712,43,755,1313,57.5%,31%,1
新北市,三重區,0856,468,350,818,60,878,1594,55.08%,29.36%,1
新北市,三重區,0857,560,363,923,53,976,1775,54.99%,31.55%,1
新北市,三重區,0858,493,300,793,56,849,1516,56%,32.52%,1
新北市,三重區,0859,454,318,772,58,830,1315,63.12%,34.52%,1
新北市,三重區,0860,274,192,466,55,521,843,61.8%,32.5%,1
新北市,三重區,0861,323,242,565,46,611,1160,52.67%,27.84%,1
新北市,三重區,0862,376,204,580,41,621,1052,59.03%,35.74%,1
新北市,三重區,0863,346,269,615,52,667,1054,63.28%,32.83%,1
新北市,三重區,0864,293,253,546,42,588,997,58.98%,29.39%,1
新北市,三重區,0865,275,212,487,26,513,936,54.81%,29.38%,1
新北市,三重區,0866,625,236,861,55,916,1658,55.25%,37.7%,1
新北市,三重區,0867,445,315,760,57,817,1496,54.61%,29.75%,1
新北市,三重區,0868,380,253,633,30,663,1064,62.31%,35.71%,1
新北市,三重區,0869,401,258,659,45,704,1152,61.11%,34.81%,1
新北市,三重區,0870,453,330,783,42,825,1532,53.85%,29.57%,1
新北市,三重區,0871,371,271,642,30,672,1338,50.22%,27.73%,1
新北市,三重區,0872,431,276,707,46,753,1303,57.79%,33.08%,1
新北市,三重區,0873,444,318,762,58,820,1369,59.9%,32.43%,1
新北市,三重區,0874,498,299,797,41,838,1491,56.2%,33.4%,1
新北市,三重區,0875,491,392,883,65,948,1821,52.06%,26.96%,1
新北市,三重區,0876,566,372,938,33,971,1906,50.94%,29.7%,1
新北市,三重區,0877,593,407,1000,46,1046,1842,56.79%,32.19%,1
新北市,三重區,0878,251,192,443,34,477,878,54.33%,28.59%,1
新北市,三重區,0879,315,256,571,46,617,963,64.07%,32.71%,1
新北市,三重區,0880,383,265,648,25,673,1381,48.73%,27.73%,1
新北市,三重區,0881,428,365,793,54,847,1681,50.39%,25.46%,1
新北市,三重區,0882,452,327,779,34,813,1548,52.52%,29.2%,1
新北市,三重區,0883,481,371,852,42,894,1542,57.98%,31.19%,1
新北市,三重區,0884,476,324,800,50,850,1557,54.59%,30.57%,1
新北市,三重區,0885,518,343,861,40,901,1661,54.24%,31.19%,1
新北市,三重區,0886,634,428,1062,28,1090,2024,53.85%,31.32%,1
新北市,三重區,0887,427,326,753,49,802,1588,50.5%,26.89%,1
新北市,三重區,0888,535,334,869,69,938,1706,54.98%,31.36%,1
新北市,三重區,0889,419,324,743,43,786,1341,58.61%,31.25%,1
新北市,三重區,0890,317,221,538,34,572,1025,55.8%,30.93%,1
新北市,三重區,0891,414,305,719,47,766,1339,57.21%,30.92%,1
新北市,三重區,0892,545,338,883,79,962,1725,55.77%,31.59%,1
新北市,三重區,0893,539,407,946,53,999,1826,54.71%,29.52%,1
新北市,中和區,1232,472,322,794,50,844,1630,51.78%,28.96%,1
新北市,中和區,1233,568,366,934,57,991,1775,55.83%,32%,1
新北市,中和區,1234,565,337,902,35,937,1844,50.81%,30.64%,1
新北市,中和區,1235,343,275,618,20,638,1019,62.61%,33.66%,1
新北市,中和區,1236,422,249,671,25,696,1138,61.16%,37.08%,1
新北市,中和區,1237,633,304,937,34,971,1878,51.7%,33.71%,1
新北市,中和區,1238,758,331,1089,44,1133,1980,57.22%,38.28%,1
新北市,中和區,1239,625,367,992,46,1038,1844,56.29%,33.89%,1
新北市,中和區,1240,758,341,1099,27,1126,2085,54%,36.35%,1
新北市,中和區,1241,506,289,795,38,833,1498,55.61%,33.78%,1
新北市,中和區,1242,585,400,985,24,1009,1761,57.3%,33.22%,1
新北市,中和區,1243,410,263,673,30,703,1254,56.06%,32.7%,1
新北市,中和區,1244,470,294,764,26,790,1343,58.82%,35%,1
新北市,中和區,1245,580,387,967,32,999,1789,55.84%,32.42%,1
新北市,中和區,1246,621,464,1085,33,1118,2000,55.9%,31.05%,1
新北市,中和區,1247,548,392,940,38,978,1953,50.08%,28.06%,1
新北市,中和區,1248,541,367,908,53,961,1712,56.13%,31.6%,1
新北市,中和區,1249,563,306,869,46,915,1582,57.84%,35.59%,1
新北市,中和區,1250,571,337,908,52,960,1742,55.11%,32.78%,1
新北市,中和區,1251,534,344,878,46,924,1493,61.89%,35.77%,1
新北市,中和區,1252,439,265,704,34,738,1352,54.59%,32.47%,1
新北市,中和區,1253,460,248,708,30,738,1244,59.32%,36.98%,1
新北市,中和區,1254,459,304,763,50,813,1394,58.32%,32.93%,1
新北市,中和區,1255,496,354,850,27,877,1917,45.75%,25.87%,1
新北市,中和區,1256,500,420,920,38,958,1830,52.35%,27.32%,1
新北市,中和區,1257,378,255,633,29,662,1124,58.9%,33.63%,1
新北市,中和區,1258,393,294,687,42,729,1412,51.63%,27.83%,1
新北市,中和區,1259,409,303,712,39,751,1356,55.38%,30.16%,1
新北市,中和區,1260,454,281,735,23,758,1425,53.19%,31.86%,1
新北市,中和區,1261,450,274,724,35,759,1259,60.29%,35.74%,1
新北市,中和區,1262,422,274,696,42,738,1256,58.76%,33.6%,1
新北市,中和區,1263,488,283,771,32,803,1423,56.43%,34.29%,1
新北市,中和區,1264,424,270,694,23,717,1221,58.72%,34.73%,1
新北市,中和區,1265,522,384,906,38,944,1858,50.81%,28.09%,1
新北市,中和區,1266,554,360,914,36,950,1804,52.66%,30.71%,1
新北市,中和區,1267,545,389,934,31,965,1669,57.82%,32.65%,1
新北市,中和區,1268,518,282,800,36,836,1485,56.3%,34.88%,1
新北市,中和區,1269,386,202,588,24,612,1005,60.9%,38.41%,1
新北市,中和區,1270,418,284,702,50,752,1175,64%,35.57%,1
新北市,中和區,1271,401,256,657,33,690,1171,58.92%,34.24%,1
新北市,中和區,1272,532,322,854,32,886,1746,50.74%,30.47%,1
新北市,中和區,1273,463,284,747,31,778,1555,50.03%,29.77%,1
新北市,中和區,1274,345,266,611,23,634,1112,57.01%,31.03%,1
新北市,中和區,1275,607,404,1011,46,1057,1780,59.38%,34.1%,1
新北市,中和區,1276,619,405,1024,33,1057,1918,55.11%,32.27%,1
新北市,中和區,1277,458,287,745,25,770,1689,45.59%,27.12%,1
新北市,中和區,1278,625,361,986,31,1017,1781,57.1%,35.09%,1
新北市,中和區,1279,473,303,776,38,814,1419,57.36%,33.33%,1
新北市,中和區,1280,436,273,709,26,735,1344,54.69%,32.44%,1
新北市,中和區,1281,654,406,1060,58,1118,1804,61.97%,36.25%,1
新北市,中和區,1282,531,372,903,57,960,1788,53.69%,29.7%,1
新北市,中和區,1283,556,429,985,35,1020,1793,56.89%,31.01%,1
新北市,中和區,1284,451,295,746,39,785,1352,58.06%,33.36%,1
新北市,中和區,1285,587,391,978,47,1025,1813,56.54%,32.38%,1
新北市,中和區,1286,480,312,792,29,821,1288,63.74%,37.27%,1
新北市,中和區,1287,402,253,655,34,689,1186,58.09%,33.9%,1
新北市,中和區,1288,416,249,665,15,680,1237,54.97%,33.63%,1
新北市,中和區,1289,508,251,759,38,797,1406,56.69%,36.13%,1
新北市,中和區,1290,443,316,759,53,812,1442,56.31%,30.72%,1
新北市,中和區,1291,369,245,614,35,649,1040,62.4%,35.48%,1
新北市,中和區,1292,478,287,765,39,804,1292,62.23%,37%,1
新北市,中和區,1293,594,349,943,50,993,1811,54.83%,32.8%,1
新北市,中和區,1294,646,333,979,51,1030,1789,57.57%,36.11%,1
新北市,中和區,1295,338,198,536,30,566,859,65.89%,39.35%,1
新北市,中和區,1296,392,213,605,22,627,972,64.51%,40.33%,1
新北市,中和區,1297,450,289,739,38,777,1346,57.73%,33.43%,1
新北市,中和區,1298,355,238,593,26,619,1034,59.86%,34.33%,1
新北市,中和區,1299,458,310,768,36,804,1387,57.97%,33.02%,1
新北市,中和區,1300,674,440,1114,67,1181,2067,57.14%,32.61%,1
新北市,中和區,1301,446,334,780,28,808,1670,48.38%,26.71%,1
新北市,中和區,1302,390,234,624,38,662,1166,56.78%,33.45%,1
新北市,中和區,1303,349,195,544,30,574,963,59.61%,36.24%,1
新北市,中和區,1304,336,205,541,26,567,1070,52.99%,31.4%,1
新北市,中和區,1305,461,256,717,32,749,1319,56.79%,34.95%,1
新北市,中和區,1306,533,303,836,48,884,1438,61.47%,37.07%,1
新北市,中和區,1307,583,336,919,28,947,1808,52.38%,32.25%,1
新北市,中和區,1308,401,220,621,18,639,1191,53.65%,33.67%,1
新北市,中和區,1309,521,342,863,48,911,1632,55.82%,31.92%,1
新北市,中和區,1310,530,341,871,33,904,1765,51.22%,30.03%,1
新北市,中和區,1311,449,222,671,32,703,1168,60.19%,38.44%,1
新北市,中和區,1312,426,204,630,29,659,1176,56.04%,36.22%,1
新北市,中和區,1313,622,322,944,47,991,1565,63.32%,39.74%,1
新北市,中和區,1314,480,294,774,37,811,1578,51.39%,30.42%,1
新北市,中和區,1315,664,404,1068,36,1104,2029,54.41%,32.73%,1
新北市,中和區,1316,290,199,489,35,524,905,57.9%,32.04%,1
新北市,中和區,1317,263,152,415,26,441,839,52.56%,31.35%,1
新北市,中和區,1318,255,180,435,18,453,762,59.45%,33.46%,1
新北市,中和區,1319,462,301,763,43,806,1420,56.76%,32.54%,1
新北市,中和區,1320,411,242,653,47,700,1272,55.03%,32.31%,1
新北市,中和區,1321,604,383,987,59,1046,1976,52.94%,30.57%,1
新北市,中和區,1322,604,328,932,36,968,1779,54.41%,33.95%,1
新北市,中和區,1323,432,254,686,32,718,1454,49.38%,29.71%,1
新北市,中和區,1324,430,261,691,35,726,1374,52.84%,31.3%,1
新北市,中和區,1325,413,258,671,26,697,1369,50.91%,30.17%,1
新北市,中和區,1326,487,298,785,46,831,1501,55.36%,32.45%,1
新北市,中和區,1327,377,195,572,31,603,920,65.54%,40.98%,1
新北市,中和區,1328,390,233,623,31,654,1050,62.29%,37.14%,1
新北市,中和區,1329,100,77,177,20,197,321,61.37%,31.15%,1
新北市,中和區,1330,462,278,740,49,789,1474,53.53%,31.34%,1
新北市,中和區,1331,497,287,784,57,841,1461,57.56%,34.02%,1
新北市,中和區,1332,516,323,839,40,879,1621,54.23%,31.83%,1
新北市,中和區,1333,487,287,774,48,822,1327,61.94%,36.7%,1
新北市,中和區,1334,264,170,434,20,454,775,58.58%,34.06%,1
新北市,中和區,1335,549,376,925,40,965,1916,50.37%,28.65%,1
新北市,中和區,1336,566,367,933,53,986,1901,51.87%,29.77%,1
新北市,中和區,1337,481,277,758,41,799,4411,18.11%,10.9%,1
新北市,中和區,1338,381,272,653,27,680,1212,56.11%,31.44%,1
新北市,中和區,1339,403,230,633,20,653,1126,57.99%,35.79%,1
新北市,中和區,1340,506,293,799,25,824,1507,54.68%,33.58%,1
新北市,中和區,1341,515,307,822,23,845,1519,55.63%,33.9%,1
新北市,中和區,1342,494,321,815,34,849,1467,57.87%,33.67%,1
新北市,中和區,1343,543,296,839,48,887,1453,61.05%,37.37%,1
新北市,中和區,1344,493,300,793,33,826,1364,60.56%,36.14%,1
新北市,中和區,1345,430,272,702,36,738,1302,56.68%,33.03%,1
新北市,中和區,1346,464,257,721,27,748,1627,45.97%,28.52%,1
新北市,中和區,1347,497,306,803,30,833,1503,55.42%,33.07%,1
新北市,中和區,1348,470,266,736,30,766,1392,55.03%,33.76%,1
新北市,中和區,1349,370,234,604,34,638,1067,59.79%,34.68%,1
新北市,中和區,1350,500,324,824,34,858,1623,52.87%,30.81%,1
新北市,中和區,1351,402,273,675,28,703,1208,58.2%,33.28%,1
新北市,中和區,1352,570,290,860,32,892,1991,44.8%,28.63%,1
新北市,中和區,1353,555,322,877,25,902,1932,46.69%,28.73%,1
新北市,中和區,1354,372,249,621,18,639,947,67.48%,39.28%,1
新北市,中和區,1355,573,334,907,49,956,1660,57.59%,34.52%,1
新北市,中和區,1356,480,272,752,34,786,1574,49.94%,30.5%,1
新北市,中和區,1357,632,403,1035,32,1067,2136,49.95%,29.59%,1
新北市,中和區,1358,423,302,725,57,782,1462,53.49%,28.93%,1
新北市,中和區,1359,485,281,766,45,811,1548,52.39%,31.33%,1
新北市,中和區,1360,266,173,439,18,457,692,66.04%,38.44%,1
新北市,中和區,1361,451,272,723,48,771,1221,63.14%,36.94%,1
新北市,中和區,1362,464,287,751,41,792,1331,59.5%,34.86%,1
新北市,中和區,1363,374,220,594,31,625,984,63.52%,38.01%,1
新北市,中和區,1364,576,343,919,27,946,1871,50.56%,30.79%,1
新北市,中和區,1365,419,245,664,42,706,1279,55.2%,32.76%,1
新北市,中和區,1366,539,352,891,33,924,1629,56.72%,33.09%,1
新北市,中和區,1367,479,340,819,28,847,1482,57.15%,32.32%,1
新北市,中和區,1368,616,337,953,47,1000,1715,58.31%,35.92%,1
新北市,中和區,1369,679,370,1049,47,1096,1952,56.15%,34.78%,1
新北市,中和區,1370,223,159,382,22,404,686,58.89%,32.51%,1
新北市,中和區,1371,420,340,760,26,786,1577,49.84%,26.63%,1
新北市,中和區,1372,402,257,659,24,683,1158,58.98%,34.72%,1
新北市,中和區,1373,439,297,736,21,757,1195,63.35%,36.74%,1
新北市,中和區,1374,399,250,649,27,676,1054,64.14%,37.86%,1
新北市,中和區,1375,223,155,378,20,398,612,65.03%,36.44%,1
新北市,中和區,1376,558,384,942,26,968,1668,58.03%,33.45%,1
新北市,中和區,1377,392,254,646,38,684,1071,63.87%,36.6%,1
新北市,中和區,1378,476,291,767,39,806,1169,68.95%,40.72%,1
新北市,中和區,1379,445,282,727,32,759,1370,55.4%,32.48%,1
新北市,中和區,1380,557,342,899,54,953,1574,60.55%,35.39%,1
新北市,中和區,1381,699,468,1167,26,1193,2614,45.64%,26.74%,1
新北市,中和區,1382,486,372,858,27,885,1477,59.92%,32.9%,1
新北市,中和區,1383,339,226,565,46,611,1041,58.69%,32.56%,1
新北市,中和區,1384,465,323,788,39,827,1538,53.77%,30.23%,1
新北市,中和區,1385,528,327,855,44,899,1599,56.22%,33.02%,1
新北市,中和區,1386,577,312,889,54,943,1586,59.46%,36.38%,1
新北市,中和區,1387,626,395,1021,50,1071,1726,62.05%,36.27%,1
新北市,中和區,1388,597,459,1056,60,1116,1854,60.19%,32.2%,1
新北市,中和區,1389,545,312,857,43,900,1472,61.14%,37.02%,1
新北市,中和區,1390,517,320,837,37,874,1430,61.12%,36.15%,1
新北市,中和區,1391,501,349,850,35,885,1488,59.48%,33.67%,1
新北市,中和區,1392,406,273,679,28,707,1251,56.51%,32.45%,1
新北市,中和區,1393,517,303,820,43,863,1487,58.04%,34.77%,1
新北市,中和區,1394,402,295,697,46,743,1328,55.95%,30.27%,1
新北市,中和區,1395,405,258,663,34,697,1128,61.79%,35.9%,1
新北市,中和區,1396,406,227,633,35,668,1008,66.27%,40.28%,1
新北市,中和區,1397,608,382,990,39,1029,1786,57.61%,34.04%,1
新北市,中和區,1398,653,459,1112,57,1169,2219,52.68%,29.43%,1
新北市,中和區,1399,427,263,690,33,723,1322,54.69%,32.3%,1
新北市,中和區,1400,532,297,829,19,848,1495,56.72%,35.59%,1
新北市,中和區,1401,489,261,750,42,792,1414,56.01%,34.58%,1
新北市,中和區,1402,592,333,925,55,980,1681,58.3%,35.22%,1
新北市,中和區,1403,447,290,737,45,782,1361,57.46%,32.84%,1
新北市,中和區,1404,482,289,771,37,808,1442,56.03%,33.43%,1
新北市,中和區,1405,437,287,724,28,752,1383,54.37%,31.6%,1
新北市,中和區,1406,452,251,703,30,733,1264,57.99%,35.76%,1
新北市,中和區,1407,634,398,1032,64,1096,1810,60.55%,35.03%,1
新北市,中和區,1408,558,381,939,37,976,1951,50.03%,28.6%,1
新北市,中和區,1409,520,264,784,35,819,1582,51.77%,32.87%,1
新北市,中和區,1410,695,399,1094,58,1152,1945,59.23%,35.73%,1
新北市,中和區,1411,454,316,770,44,814,1390,58.56%,32.66%,1
新北市,中和區,1412,398,262,660,15,675,1161,58.14%,34.28%,1
新北市,中和區,1413,510,233,743,33,776,1399,55.47%,36.45%,1
新北市,中和區,1414,368,217,585,32,617,1070,57.66%,34.39%,1
新北市,中和區,1415,406,234,640,29,669,1169,57.23%,34.73%,1
新北市,中和區,1416,453,278,731,39,770,1214,63.43%,37.31%,1
新北市,中和區,1417,467,315,782,41,823,1398,58.87%,33.4%,1
新北市,中和區,1418,354,236,590,26,616,1049,58.72%,33.75%,1
新北市,中和區,1419,532,258,790,40,830,1324,62.69%,40.18%,1
新北市,中和區,1420,521,330,851,19,870,1765,49.29%,29.52%,1
新北市,中和區,1421,513,340,853,46,899,1709,52.6%,30.02%,1
新北市,中和區,1422,399,250,649,47,696,1186,58.68%,33.64%,1
新北市,中和區,1423,492,269,761,26,787,1318,59.71%,37.33%,1
新北市,中和區,1424,446,349,795,34,829,1430,57.97%,31.19%,1
新北市,中和區,1425,417,285,702,27,729,1637,44.53%,25.47%,1
新北市,中和區,1426,443,272,715,41,756,1283,58.92%,34.53%,1
新北市,中和區,1427,438,286,724,39,763,1310,58.24%,33.44%,1
新北市,中和區,1428,468,266,734,34,768,1301,59.03%,35.97%,1
新北市,中和區,1429,566,381,947,42,989,1681,58.83%,33.67%,1
新北市,中和區,1430,488,304,792,27,819,1384,59.18%,35.26%,1
新北市,中和區,1431,380,280,660,26,686,1187,57.79%,32.01%,1
新北市,中和區,1432,484,314,798,11,809,1779,45.47%,27.21%,1
新北市,中和區,1433,589,323,912,46,958,1712,55.96%,34.4%,1
新北市,中和區,1434,450,302,752,45,797,1462,54.51%,30.78%,1
新北市,中和區,1435,579,362,941,24,965,1824,52.91%,31.74%,1
新北市,中和區,1436,428,302,730,47,777,1389,55.94%,30.81%,1
新北市,中和區,1437,506,300,806,39,845,1434,58.93%,35.29%,1
新北市,中和區,1438,629,373,1002,55,1057,1953,54.12%,32.21%,1
新北市,中和區,1439,630,432,1062,58,1120,2002,55.94%,31.47%,1
新北市,中和區,1440,672,312,984,30,1014,1858,54.57%,36.17%,1
新北市,中和區,1441,506,342,848,30,878,1801,48.75%,28.1%,1
新北市,中和區,1442,602,331,933,47,980,1691,57.95%,35.6%,1
新北市,中和區,1443,485,292,777,36,813,1363,59.65%,35.58%,1
新北市,中和區,1444,470,276,746,28,774,1220,63.44%,38.52%,1
新北市,中和區,1445,541,297,838,32,870,1365,63.74%,39.63%,1
新北市,中和區,1446,418,251,669,23,692,1178,58.74%,35.48%,1
新北市,中和區,1447,310,172,482,28,510,830,61.45%,37.35%,1
新北市,中和區,1448,350,256,606,34,640,1197,53.47%,29.24%,1
新北市,中和區,1449,486,274,760,43,803,1369,58.66%,35.5%,1
新北市,中和區,1450,476,295,771,33,804,1336,60.18%,35.63%,1
新北市,中和區,1451,538,287,825,40,865,1377,62.82%,39.07%,1
新北市,中和區,1452,535,311,846,38,884,1499,58.97%,35.69%,1
新北市,中和區,1453,606,366,972,39,1011,1689,59.86%,35.88%,1
新北市,中和區,1454,446,317,763,35,798,1323,60.32%,33.71%,1
新北市,中和區,1455,396,266,662,19,681,1079,63.11%,36.7%,1
新北市,中和區,1456,514,352,866,43,909,1545,58.83%,33.27%,1
新北市,中和區,1457,426,279,705,37,742,1326,55.96%,32.13%,1
新北市,中和區,1458,469,292,761,35,796,1443,55.16%,32.5%,1
新北市,中和區,1459,595,330,925,36,961,1712,56.13%,34.75%,1
新北市,中和區,1460,625,384,1009,40,1049,1916,54.75%,32.62%,1
新北市,中和區,1461,324,185,509,32,541,863,62.69%,37.54%,1
新北市,中和區,1462,462,267,729,6,735,1203,61.1%,38.4%,1
新北市,中和區,1463,494,284,778,25,803,1483,54.15%,33.31%,1
新北市,中和區,1464,539,285,824,25,849,1575,53.9%,34.22%,1
新北市,中和區,1465,452,244,696,25,721,1432,50.35%,31.56%,1
新北市,中和區,1466,447,318,765,50,815,1441,56.56%,31.02%,1
新北市,中和區,1467,433,279,712,45,757,1269,59.65%,34.12%,1
新北市,中和區,1468,491,292,783,29,812,1363,59.57%,36.02%,1
新北市,中和區,1469,411,213,624,19,643,1089,59.04%,37.74%,1
新北市,中和區,1470,363,235,598,28,626,1171,53.46%,31%,1
新北市,中和區,1471,408,243,651,37,688,1150,59.83%,35.48%,1
新北市,中和區,1472,438,255,693,31,724,1154,62.74%,37.95%,1
新北市,中和區,1473,437,211,648,16,664,1067,62.23%,40.96%,1
新北市,中和區,1474,492,297,789,36,825,1526,54.06%,32.24%,1
新北市,中和區,1475,511,311,822,27,849,1447,58.67%,35.31%,1
新北市,永和區,1476,514,351,865,57,922,1554,59.33%,33.08%,1
新北市,永和區,1477,406,215,621,18,639,1065,60%,38.12%,1
新北市,永和區,1478,332,184,516,27,543,854,63.58%,38.88%,1
新北市,永和區,1479,468,256,724,35,759,1253,60.57%,37.35%,1
新北市,永和區,1480,556,402,958,35,993,1733,57.3%,32.08%,1
新北市,永和區,1481,530,328,858,39,897,1581,56.74%,33.52%,1
新北市,永和區,1482,589,325,914,45,959,1735,55.27%,33.95%,1
新北市,永和區,1483,525,296,821,25,846,1563,54.13%,33.59%,1
新北市,永和區,1484,520,362,882,61,943,1650,57.15%,31.52%,1
新北市,永和區,1485,507,290,797,33,830,1454,57.08%,34.87%,1
新北市,永和區,1486,470,327,797,40,837,1568,53.38%,29.97%,1
新北市,永和區,1487,473,284,757,30,787,1444,54.5%,32.76%,1
新北市,永和區,1488,341,259,600,47,647,1140,56.75%,29.91%,1
新北市,永和區,1489,460,245,705,32,737,1188,62.04%,38.72%,1
新北市,永和區,1490,496,311,807,47,854,1516,56.33%,32.72%,1
新北市,永和區,1491,467,270,737,40,777,1397,55.62%,33.43%,1
新北市,永和區,1492,477,307,784,36,820,1438,57.02%,33.17%,1
新北市,永和區,1493,381,244,625,29,654,1084,60.33%,35.15%,1
新北市,永和區,1494,342,196,538,18,556,941,59.09%,36.34%,1
新北市,永和區,1495,534,318,852,27,879,1598,55.01%,33.42%,1
新北市,永和區,1496,505,328,833,34,867,2842,30.51%,17.77%,1
新北市,永和區,1497,450,303,753,37,790,1261,62.65%,35.69%,1
新北市,永和區,1498,551,341,892,36,928,1449,64.04%,38.03%,1
新北市,永和區,1499,575,280,855,33,888,1511,58.77%,38.05%,1
新北市,永和區,1500,574,315,889,36,925,1470,62.93%,39.05%,1
新北市,永和區,1501,564,323,887,29,916,1580,57.97%,35.7%,1
新北市,永和區,1502,532,346,878,31,909,1438,63.21%,37%,1
新北市,永和區,1503,519,283,802,28,830,1305,63.6%,39.77%,1
新北市,永和區,1504,406,230,636,23,659,1046,63%,38.81%,1
新北市,永和區,1505,551,361,912,16,928,1566,59.26%,35.19%,1
新北市,永和區,1506,511,329,840,29,869,1468,59.2%,34.81%,1
新北市,永和區,1507,511,313,824,34,858,1305,65.75%,39.16%,1
新北市,永和區,1508,410,289,699,32,731,1181,61.9%,34.72%,1
新北市,永和區,1509,555,357,912,43,955,1720,55.52%,32.27%,1
新北市,永和區,1510,413,274,687,28,715,1103,64.82%,37.44%,1
新北市,永和區,1511,553,348,901,68,969,1649,58.76%,33.54%,1
新北市,永和區,1512,424,302,726,28,754,1206,62.52%,35.16%,1
新北市,永和區,1513,514,378,892,28,920,1506,61.09%,34.13%,1
新北市,永和區,1514,534,316,850,38,888,1488,59.68%,35.89%,1
新北市,永和區,1515,445,310,755,51,806,1288,62.58%,34.55%,1
新北市,永和區,1516,401,325,726,30,756,1413,53.5%,28.38%,1
新北市,永和區,1517,461,274,735,41,776,1329,58.39%,34.69%,1
新北市,永和區,1518,555,305,860,30,890,1436,61.98%,38.65%,1
新北市,永和區,1519,387,242,629,36,665,1112,59.8%,34.8%,1
新北市,永和區,1520,463,249,712,34,746,1100,67.82%,42.09%,1
新北市,永和區,1521,510,411,921,39,960,1545,62.14%,33.01%,1
新北市,永和區,1522,509,306,815,25,840,1436,58.5%,35.45%,1
新北市,永和區,1523,642,388,1030,55,1085,1731,62.68%,37.09%,1
新北市,永和區,1524,628,387,1015,68,1083,1762,61.46%,35.64%,1
新北市,永和區,1525,421,293,714,35,749,1320,56.74%,31.89%,1
新北市,永和區,1526,400,235,635,16,651,1297,50.19%,30.84%,1
新北市,永和區,1527,538,429,967,47,1014,1798,56.4%,29.92%,1
新北市,永和區,1528,501,366,867,42,909,1491,60.97%,33.6%,1
新北市,永和區,1529,419,260,679,24,703,1223,57.48%,34.26%,1
新北市,永和區,1530,391,255,646,12,658,1108,59.39%,35.29%,1
新北市,永和區,1531,511,322,833,30,863,1408,61.29%,36.29%,1
新北市,永和區,1532,451,276,727,46,773,1265,61.11%,35.65%,1
新北市,永和區,1533,382,232,614,20,634,1115,56.86%,34.26%,1
新北市,永和區,1534,447,245,692,36,728,1133,64.25%,39.45%,1
新北市,永和區,1535,437,256,693,47,740,1217,60.81%,35.91%,1
新北市,永和區,1536,534,388,922,44,966,1713,56.39%,31.17%,1
新北市,永和區,1537,542,361,903,46,949,1721,55.14%,31.49%,1
新北市,永和區,1538,439,274,713,41,754,1327,56.82%,33.08%,1
新北市,永和區,1539,477,295,772,18,790,1257,62.85%,37.95%,1
新北市,永和區,1540,482,329,811,43,854,1348,63.35%,35.76%,1
新北市,永和區,1541,577,316,893,37,930,1461,63.66%,39.49%,1
新北市,永和區,1542,474,303,777,42,819,1368,59.87%,34.65%,1
新北市,永和區,1543,445,238,683,41,724,1234,58.67%,36.06%,1
新北市,永和區,1544,458,271,729,37,766,1303,58.79%,35.15%,1
新北市,永和區,1545,528,309,837,23,860,1516,56.73%,34.83%,1
新北市,永和區,1546,550,276,826,50,876,1422,61.6%,38.68%,1
新北市,永和區,1547,369,211,580,22,602,991,60.75%,37.24%,1
新北市,永和區,1548,383,237,620,19,639,1016,62.89%,37.7%,1
新北市,永和區,1549,432,238,670,23,693,1146,60.47%,37.7%,1
新北市,永和區,1550,417,205,622,18,640,1043,61.36%,39.98%,1
新北市,永和區,1551,442,281,723,26,749,1210,61.9%,36.53%,1
新北市,永和區,1552,586,345,931,26,957,1630,58.71%,35.95%,1
新北市,永和區,1553,349,295,644,23,667,1092,61.08%,31.96%,1
新北市,永和區,1554,660,401,1061,48,1109,1872,59.24%,35.26%,1
新北市,永和區,1555,632,360,992,29,1021,1781,57.33%,35.49%,1
新北市,永和區,1556,387,240,627,26,653,1049,62.25%,36.89%,1
新北市,永和區,1557,480,308,788,32,820,1285,63.81%,37.35%,1
新北市,永和區,1558,435,291,726,28,754,1209,62.37%,35.98%,1
新北市,永和區,1559,420,265,685,25,710,1132,62.72%,37.1%,1
新北市,永和區,1560,474,305,779,32,811,1287,63.01%,36.83%,1
新北市,永和區,1561,375,253,628,44,672,1068,62.92%,35.11%,1
新北市,永和區,1562,380,273,653,45,698,1098,63.57%,34.61%,1
新北市,永和區,1563,462,262,724,45,769,1222,62.93%,37.81%,1
新北市,永和區,1564,446,238,684,36,720,1157,62.23%,38.55%,1
新北市,永和區,1565,404,320,724,41,765,1168,65.5%,34.59%,1
新北市,永和區,1566,417,296,713,41,754,1283,58.77%,32.5%,1
新北市,永和區,1567,441,303,744,29,773,1372,56.34%,32.14%,1
新北市,永和區,1568,671,418,1089,45,1134,1876,60.45%,35.77%,1
新北市,永和區,1569,598,347,945,59,1004,1576,63.71%,37.94%,1
新北市,永和區,1570,600,361,961,38,999,1661,60.14%,36.12%,1
新北市,永和區,1571,606,401,1007,28,1035,1808,57.25%,33.52%,1
新北市,永和區,1572,640,391,1031,59,1090,1898,57.43%,33.72%,1
新北市,永和區,1573,547,349,896,38,934,1508,61.94%,36.27%,1
新北市,永和區,1574,487,309,796,41,837,1341,62.42%,36.32%,1
新北市,永和區,1575,500,293,793,46,839,1422,59%,35.16%,1
新北市,永和區,1576,404,260,664,29,693,1177,58.88%,34.32%,1
新北市,永和區,1577,534,343,877,48,925,1557,59.41%,34.3%,1
新北市,永和區,1578,474,320,794,34,828,1491,55.53%,31.79%,1
新北市,永和區,1579,542,337,879,32,911,1586,57.44%,34.17%,1
新北市,永和區,1580,459,260,719,13,732,1313,55.75%,34.96%,1
新北市,永和區,1581,524,380,904,35,939,1636,57.4%,32.03%,1
新北市,永和區,1582,526,353,879,50,929,1598,58.14%,32.92%,1
新北市,永和區,1583,551,383,934,37,971,1609,60.35%,34.24%,1
新北市,永和區,1584,485,322,807,44,851,1375,61.89%,35.27%,1
新北市,永和區,1585,586,417,1003,35,1038,1648,62.99%,35.56%,1
新北市,永和區,1586,371,258,629,29,658,1077,61.1%,34.45%,1
新北市,永和區,1587,417,263,680,24,704,1157,60.85%,36.04%,1
新北市,永和區,1588,513,315,828,26,854,1339,63.78%,38.31%,1
新北市,永和區,1589,483,313,796,13,809,1306,61.94%,36.98%,1
新北市,永和區,1590,490,282,772,13,785,1236,63.51%,39.64%,1
新北市,永和區,1591,425,256,681,23,704,1133,62.14%,37.51%,1
新北市,永和區,1592,524,313,837,29,866,1425,60.77%,36.77%,1
新北市,永和區,1593,654,397,1051,66,1117,1938,57.64%,33.75%,1
新北市,永和區,1594,562,359,921,41,962,1607,59.86%,34.97%,1
新北市,永和區,1595,322,185,507,21,528,853,61.9%,37.75%,1
新北市,永和區,1596,255,140,395,34,429,768,55.86%,33.2%,1
新北市,永和區,1597,287,149,436,24,460,893,51.51%,32.14%,1
新北市,永和區,1598,268,140,408,29,437,743,58.82%,36.07%,1
新北市,永和區,1599,409,273,682,38,720,1155,62.34%,35.41%,1
新北市,永和區,1600,454,297,751,40,791,1263,62.63%,35.95%,1
新北市,永和區,1601,444,270,714,24,738,1189,62.07%,37.34%,1
新北市,永和區,1602,427,294,721,44,765,1346,56.84%,31.72%,1
新北市,永和區,1603,434,313,747,37,784,1368,57.31%,31.73%,1
新北市,永和區,1604,377,234,611,13,624,1043,59.83%,36.15%,1
新北市,永和區,1605,597,398,995,41,1036,1709,60.62%,34.93%,1
新北市,永和區,1606,277,192,469,16,485,879,55.18%,31.51%,1
新北市,永和區,1607,293,224,517,24,541,904,59.85%,32.41%,1
新北市,永和區,1608,478,257,735,44,779,1221,63.8%,39.15%,1
新北市,永和區,1609,361,248,609,33,642,1018,63.06%,35.46%,1
新北市,永和區,1610,499,357,856,28,884,1551,57%,32.17%,1
新北市,永和區,1611,493,329,822,42,864,1428,60.5%,34.52%,1
新北市,永和區,1612,363,239,602,46,648,1044,62.07%,34.77%,1
新北市,永和區,1613,344,231,575,34,609,967,62.98%,35.57%,1
新北市,新莊區,0302,359,268,627,37,664,1123,59.13%,31.97%,1
新北市,新莊區,0303,416,329,745,42,787,1278,61.58%,32.55%,1
新北市,新莊區,0304,432,262,694,46,740,1163,63.63%,37.15%,1
新北市,新莊區,0305,422,302,724,33,757,1228,61.64%,34.36%,1
新北市,新莊區,0306,409,261,670,45,715,1211,59.04%,33.77%,1
新北市,新莊區,0307,406,264,670,39,709,1176,60.29%,34.52%,1
新北市,新莊區,0308,537,356,893,39,932,1536,60.68%,34.96%,1
新北市,新莊區,0309,536,351,887,45,932,1486,62.72%,36.07%,1
新北市,新莊區,0310,535,380,915,58,973,1513,64.31%,35.36%,1
新北市,新莊區,0311,497,345,842,48,890,1395,63.8%,35.63%,1
新北市,新莊區,0312,423,303,726,42,768,1353,56.76%,31.26%,1
新北市,新莊區,0313,496,329,825,53,878,1409,62.31%,35.2%,1
新北市,新莊區,0314,484,316,800,25,825,1478,55.82%,32.75%,1
新北市,新莊區,0315,333,212,545,33,578,921,62.76%,36.16%,1
新北市,新莊區,0316,330,245,575,33,608,971,62.62%,33.99%,1
新北市,新莊區,0317,546,374,920,44,964,1534,62.84%,35.59%,1
新北市,新莊區,0318,504,303,807,38,845,1516,55.74%,33.25%,1
新北市,新莊區,0319,214,166,380,30,410,697,58.82%,30.7%,1
新北市,新莊區,0320,406,290,696,27,723,1235,58.54%,32.87%,1
新北市,新莊區,0321,375,253,628,31,659,1138,57.91%,32.95%,1
新北市,新莊區,0322,342,198,540,20,560,1063,52.68%,32.17%,1
新北市,新莊區,0323,444,365,809,37,846,3399,24.89%,13.06%,1
新北市,新莊區,0324,531,347,878,58,936,1575,59.43%,33.71%,1
新北市,新莊區,0325,525,426,951,56,1007,1615,62.35%,32.51%,1
新北市,新莊區,0326,466,332,798,53,851,1612,52.79%,28.91%,1
新北市,新莊區,0327,496,305,801,48,849,1514,56.08%,32.76%,1
新北市,新莊區,0328,400,283,683,40,723,1382,52.32%,28.94%,1
新北市,新莊區,0329,445,346,791,36,827,1475,56.07%,30.17%,1
新北市,新莊區,0330,465,356,821,25,846,1462,57.87%,31.81%,1
新北市,新莊區,0331,429,337,766,28,794,1426,55.68%,30.08%,1
新北市,新莊區,0332,432,322,754,37,791,1421,55.67%,30.4%,1
新北市,新莊區,0333,438,383,821,45,866,1536,56.38%,28.52%,1
新北市,新莊區,0334,500,384,884,36,920,1587,57.97%,31.51%,1
新北市,新莊區,0335,225,171,396,12,408,749,54.47%,30.04%,1
新北市,新莊區,0336,428,301,729,38,767,1276,60.11%,33.54%,1
新北市,新莊區,0337,431,275,706,29,735,1303,56.41%,33.08%,1
新北市,新莊區,0338,422,304,726,48,774,1259,61.48%,33.52%,1
新北市,新莊區,0339,437,308,745,37,782,1291,60.57%,33.85%,1
新北市,新莊區,0340,494,350,844,20,864,1493,57.87%,33.09%,1
新北市,新莊區,0341,478,358,836,42,878,1507,58.26%,31.72%,1
新北市,新莊區,0342,474,351,825,12,837,1456,57.49%,32.55%,1
新北市,新莊區,0343,468,314,782,21,803,1396,57.52%,33.52%,1
新北市,新莊區,0344,398,275,673,44,717,1351,53.07%,29.46%,1
新北市,新莊區,0345,451,296,747,53,800,1403,57.02%,32.15%,1
新北市,新莊區,0346,461,336,797,41,838,1497,55.98%,30.79%,1
新北市,新莊區,0347,449,277,726,48,774,1272,60.85%,35.3%,1
新北市,新莊區,0348,400,230,630,30,660,1269,52.01%,31.52%,1
新北市,新莊區,0349,440,306,746,51,797,1335,59.7%,32.96%,1
新北市,新莊區,0350,426,345,771,24,795,1300,61.15%,32.77%,1
新北市,新莊區,0351,440,296,736,13,749,1286,58.24%,34.21%,1
新北市,新莊區,0352,470,320,790,38,828,1255,65.98%,37.45%,1
新北市,新莊區,0353,484,349,833,60,893,1558,57.32%,31.07%,1
新北市,新莊區,0354,512,311,823,44,867,1567,55.33%,32.67%,1
新北市,新莊區,0355,559,342,901,48,949,1603,59.2%,34.87%,1
新北市,新莊區,0356,507,352,859,15,874,1538,56.83%,32.96%,1
新北市,新莊區,0357,531,405,936,30,966,1671,57.81%,31.78%,1
新北市,新莊區,0358,521,368,889,30,919,1698,54.12%,30.68%,1
新北市,新莊區,0359,521,383,904,37,941,1545,60.91%,33.72%,1
新北市,新莊區,0360,558,421,979,57,1036,1696,61.08%,32.9%,1
新北市,新莊區,0361,519,305,824,66,890,1626,54.74%,31.92%,1
新北市,新莊區,0362,301,281,582,53,635,1170,54.27%,25.73%,1
新北市,新莊區,0363,399,263,662,59,721,1236,58.33%,32.28%,1
新北市,新莊區,0364,344,216,560,43,603,1071,56.3%,32.12%,1
新北市,新莊區,0365,350,269,619,29,648,1129,57.4%,31%,1
新北市,新莊區,0366,599,364,963,26,989,1586,62.36%,37.77%,1
新北市,新莊區,0367,497,303,800,33,833,1597,52.16%,31.12%,1
新北市,新莊區,0368,449,299,748,80,828,1573,52.64%,28.54%,1
新北市,新莊區,0369,443,237,680,29,709,1225,57.88%,36.16%,1
新北市,新莊區,0370,408,214,622,28,650,1217,53.41%,33.53%,1
新北市,新莊區,0371,501,334,835,48,883,1571,56.21%,31.89%,1
新北市,新莊區,0372,468,349,817,44,861,1594,54.02%,29.36%,1
新北市,新莊區,0373,471,348,819,54,873,1583,55.15%,29.75%,1
新北市,新莊區,0374,348,292,640,43,683,1245,54.86%,27.95%,1
新北市,新莊區,0375,432,269,701,29,730,1203,60.68%,35.91%,1
新北市,新莊區,0376,462,302,764,35,799,1265,63.16%,36.52%,1
新北市,新莊區,0377,411,305,716,43,759,1255,60.48%,32.75%,1
新北市,新莊區,0378,454,269,723,33,756,1287,58.74%,35.28%,1
新北市,新莊區,0379,378,309,687,46,733,1167,62.81%,32.39%,1
新北市,新莊區,0380,420,287,707,44,751,1299,57.81%,32.33%,1
新北市,新莊區,0381,399,274,673,33,706,1207,58.49%,33.06%,1
新北市,新莊區,0382,722,76,798,33,831,1415,58.73%,51.02%,1
新北市,新莊區,0383,441,292,733,53,786,1342,58.57%,32.86%,1
新北市,新莊區,0384,822,311,1133,48,1181,1341,88.07%,61.3%,1
新北市,新莊區,0385,377,287,664,51,715,1247,57.34%,30.23%,1
新北市,新莊區,0386,433,206,639,16,655,984,66.57%,44%,1
新北市,新莊區,0387,339,259,598,43,641,1043,61.46%,32.5%,1
新北市,新莊區,0388,451,274,725,31,756,1135,66.61%,39.74%,1
新北市,新莊區,0389,390,284,674,33,707,1185,59.66%,32.91%,1
新北市,新莊區,0390,455,302,757,35,792,1346,58.84%,33.8%,1
新北市,新莊區,0391,466,295,761,57,818,1372,59.62%,33.97%,1
新北市,新莊區,0392,481,302,783,52,835,1350,61.85%,35.63%,1
新北市,新莊區,0393,400,286,686,46,732,1307,56.01%,30.6%,1
新北市,新莊區,0394,487,254,741,45,786,1353,58.09%,35.99%,1
新北市,新莊區,0395,427,296,723,44,767,1287,59.6%,33.18%,1
新北市,新莊區,0396,476,266,742,25,767,1567,48.95%,30.38%,1
新北市,新莊區,0397,578,396,974,48,1022,1709,59.8%,33.82%,1
新北市,新莊區,0398,487,344,831,30,861,1616,53.28%,30.14%,1
新北市,新莊區,0399,468,347,815,46,861,1628,52.89%,28.75%,1
新北市,新莊區,0400,406,259,665,44,709,1148,61.76%,35.37%,1
新北市,新莊區,0401,431,260,691,7,698,1201,58.12%,35.89%,1
新北市,新莊區,0402,418,280,698,36,734,1135,64.67%,36.83%,1
新北市,新莊區,0403,512,375,887,39,926,1495,61.94%,34.25%,1
新北市,新莊區,0404,484,374,858,51,909,1486,61.17%,32.57%,1
新北市,新莊區,0405,519,352,871,31,902,1483,60.82%,35%,1
新北市,新莊區,0406,493,327,820,37,857,1553,55.18%,31.75%,1
新北市,新莊區,0407,573,409,982,21,1003,1625,61.72%,35.26%,1
新北市,新莊區,0408,552,373,925,32,957,1671,57.27%,33.03%,1
新北市,新莊區,0409,487,340,827,45,872,1389,62.78%,35.06%,1
新北市,新莊區,0410,418,299,717,33,750,1272,58.96%,32.86%,1
新北市,新莊區,0411,449,369,818,32,850,1409,60.33%,31.87%,1
新北市,新莊區,0412,485,335,820,34,854,1372,62.24%,35.35%,1
新北市,新莊區,0413,334,204,538,23,561,955,58.74%,34.97%,1
新北市,新莊區,0414,302,195,497,44,541,952,56.83%,31.72%,1
新北市,新莊區,0415,478,320,798,21,819,1412,58%,33.85%,1
新北市,新莊區,0416,477,311,788,39,827,1415,58.45%,33.71%,1
新北市,新莊區,0417,508,300,808,47,855,1421,60.17%,35.75%,1
新北市,新莊區,0418,479,295,774,36,810,1293,62.65%,37.05%,1
新北市,新莊區,0419,444,328,772,33,805,1475,54.58%,30.1%,1
新北市,新莊區,0420,453,332,785,38,823,1429,57.59%,31.7%,1
新北市,新莊區,0421,465,336,801,45,846,1481,57.12%,31.4%,1
新北市,新莊區,0422,501,339,840,50,890,1472,60.46%,34.04%,1
新北市,新莊區,0423,471,372,843,28,871,1474,59.09%,31.95%,1
新北市,新莊區,0424,492,358,850,25,875,1462,59.85%,33.65%,1
新北市,新莊區,0425,513,353,866,21,887,1484,59.77%,34.57%,1
新北市,新莊區,0426,503,306,809,36,845,1461,57.84%,34.43%,1
新北市,新莊區,0427,488,339,827,31,858,1444,59.42%,33.8%,1
新北市,新莊區,0428,504,327,831,27,858,1437,59.71%,35.07%,1
新北市,新莊區,0429,467,324,791,38,829,1641,50.52%,28.46%,1
新北市,新莊區,0430,503,340,843,34,877,1633,53.7%,30.8%,1
新北市,新莊區,0431,513,352,865,18,883,1531,57.67%,33.51%,1
新北市,新莊區,0432,517,355,872,35,907,1517,59.79%,34.08%,1
新北市,新莊區,0433,470,319,789,40,829,1487,55.75%,31.61%,1
新北市,新莊區,0434,523,335,858,32,890,1560,57.05%,33.53%,1
新北市,新莊區,0435,485,371,856,39,895,1584,56.5%,30.62%,1
新北市,新莊區,0436,509,346,855,18,873,1602,54.49%,31.77%,1
新北市,新莊區,0437,269,186,455,30,485,818,59.29%,32.89%,1
新北市,新莊區,0438,482,306,788,34,822,1633,50.34%,29.52%,1
新北市,新莊區,0439,506,358,864,37,901,1652,54.54%,30.63%,1
新北市,新莊區,0440,480,311,791,35,826,1498,55.14%,32.04%,1
新北市,新莊區,0441,411,320,731,41,772,1379,55.98%,29.8%,1
新北市,新莊區,0442,464,317,781,42,823,1381,59.59%,33.6%,1
新北市,新莊區,0443,522,344,866,54,920,1535,59.93%,34.01%,1
新北市,新莊區,0444,528,367,895,48,943,1492,63.2%,35.39%,1
新北市,新莊區,0445,513,354,867,49,916,1450,63.17%,35.38%,1
新北市,新莊區,0446,367,255,622,37,659,1107,59.53%,33.15%,1
新北市,新莊區,0447,203,233,436,44,480,1063,45.16%,19.1%,1
新北市,新莊區,0448,412,250,662,34,696,1143,60.89%,36.05%,1
新北市,新莊區,0449,405,293,698,59,757,1341,56.45%,30.2%,1
新北市,新莊區,0450,368,227,595,29,624,1063,58.7%,34.62%,1
新北市,新莊區,0451,369,249,618,34,652,1096,59.49%,33.67%,1
新北市,新莊區,0452,417,301,718,33,751,1309,57.37%,31.86%,1
新北市,新莊區,0453,521,176,697,40,737,1216,60.61%,42.85%,1
新北市,新莊區,0454,379,287,666,26,692,1278,54.15%,29.66%,1
新北市,新莊區,0455,415,320,735,49,784,1352,57.99%,30.7%,1
新北市,新莊區,0456,377,256,633,46,679,1298,52.31%,29.04%,1
新北市,新莊區,0457,343,233,576,37,613,1042,58.83%,32.92%,1
新北市,新莊區,0458,249,193,442,27,469,881,53.23%,28.26%,1
新北市,新莊區,0459,363,312,675,43,718,1109,64.74%,32.73%,1
新北市,新莊區,0460,375,295,670,51,721,1291,55.85%,29.05%,1
新北市,新莊區,0461,413,269,682,23,705,1293,54.52%,31.94%,1
新北市,新莊區,0462,429,319,748,40,788,1336,58.98%,32.11%,1
新北市,新莊區,0463,425,287,712,34,746,1384,53.9%,30.71%,1
新北市,新莊區,0464,358,255,613,25,638,1231,51.83%,29.08%,1
新北市,新莊區,0465,271,223,494,30,524,940,55.74%,28.83%,1
新北市,新莊區,0466,407,292,699,69,768,1369,56.1%,29.73%,1
新北市,新莊區,0467,449,281,730,53,783,1384,56.58%,32.44%,1
新北市,新莊區,0468,414,293,707,49,756,1272,59.43%,32.55%,1
新北市,新莊區,0469,370,237,607,32,639,1073,59.55%,34.48%,1
新北市,新莊區,0470,335,238,573,30,603,1058,56.99%,31.66%,1
新北市,新莊區,0471,477,355,832,18,850,1528,55.63%,31.22%,1
新北市,新莊區,0472,389,250,639,42,681,1244,54.74%,31.27%,1
新北市,新莊區,0473,452,238,690,35,725,1356,53.47%,33.33%,1
新北市,新莊區,0474,370,219,589,19,608,1164,52.23%,31.79%,1
新北市,新莊區,0475,475,324,799,40,839,1423,58.96%,33.38%,1
新北市,新莊區,0476,440,306,746,31,777,1250,62.16%,35.2%,1
新北市,新莊區,0477,385,280,665,26,691,1252,55.19%,30.75%,1
新北市,新莊區,0478,320,222,542,17,559,1022,54.7%,31.31%,1
新北市,新莊區,0479,301,235,536,33,569,959,59.33%,31.39%,1
新北市,新莊區,0480,526,400,926,33,959,1646,58.26%,31.96%,1
新北市,新莊區,0481,454,348,802,56,858,1551,55.32%,29.27%,1
新北市,新莊區,0482,505,368,873,36,909,1526,59.57%,33.09%,1
新北市,新莊區,0483,475,374,849,22,871,1518,57.38%,31.29%,1
新北市,新莊區,0484,482,377,859,36,895,1547,57.85%,31.16%,1
新北市,新莊區,0485,489,292,781,46,827,1505,54.95%,32.49%,1
新北市,新莊區,0486,473,308,781,47,828,1527,54.22%,30.98%,1
新北市,新莊區,0487,426,316,742,38,780,1482,52.63%,28.74%,1
新北市,新莊區,0488,443,325,768,60,828,1586,52.21%,27.93%,1
新北市,新莊區,0489,330,228,558,63,621,1065,58.31%,30.99%,1
新北市,新莊區,0490,381,258,639,35,674,1040,64.81%,36.63%,1
新北市,新莊區,0491,323,246,569,41,610,1090,55.96%,29.63%,1
新北市,新莊區,0492,339,247,586,38,624,1071,58.26%,31.65%,1
新北市,新莊區,0493,489,357,846,37,883,1704,51.82%,28.7%,1
新北市,新莊區,0494,488,345,833,26,859,1698,50.59%,28.74%,1
新北市,新莊區,0495,455,348,803,48,851,1362,62.48%,33.41%,1
新北市,新莊區,0496,449,332,781,33,814,1350,60.3%,33.26%,1
新北市,新莊區,0497,541,363,904,65,969,1689,57.37%,32.03%,1
新北市,新莊區,0498,486,383,869,67,936,1612,58.06%,30.15%,1
新北市,新莊區,0499,401,248,649,38,687,1130,60.8%,35.49%,1
新北市,新莊區,0500,485,178,663,40,703,1111,63.28%,43.65%,1
新北市,新莊區,0501,456,346,802,35,837,1539,54.39%,29.63%,1
新北市,新莊區,0502,503,358,861,29,890,1586,56.12%,31.72%,1
新北市,新莊區,0503,519,376,895,38,933,1631,57.2%,31.82%,1
新北市,新莊區,0504,478,359,837,38,875,1540,56.82%,31.04%,1
新北市,新莊區,0505,377,296,673,40,713,1388,51.37%,27.16%,1
新北市,新莊區,0506,379,275,654,62,716,1388,51.59%,27.31%,1
新北市,新莊區,0507,385,271,656,47,703,1387,50.68%,27.76%,1
新北市,新莊區,0508,364,243,607,33,640,1181,54.19%,30.82%,1
新北市,新莊區,0509,341,281,622,42,664,1135,58.5%,30.04%,1
新北市,新莊區,0510,338,306,644,29,673,1173,57.37%,28.82%,1
新北市,新莊區,0511,362,309,671,33,704,1215,57.94%,29.79%,1
新北市,新莊區,0512,493,334,827,52,879,1488,59.07%,33.13%,1
新北市,新莊區,0513,437,345,782,43,825,1444,57.13%,30.26%,1
新北市,新莊區,0514,488,318,806,32,838,1499,55.9%,32.56%,1
新北市,新莊區,0515,419,346,765,26,791,1449,54.59%,28.92%,1
新北市,新莊區,0516,491,387,878,55,933,1640,56.89%,29.94%,1
新北市,新莊區,0517,490,371,861,49,910,1648,55.22%,29.73%,1
新北市,新莊區,0518,405,270,675,47,722,1371,52.66%,29.54%,1
新北市,新莊區,0519,406,325,731,42,773,1400,55.21%,29%,1
新北市,新莊區,0520,429,320,749,66,815,1457,55.94%,29.44%,1
新北市,新莊區,0521,433,340,773,52,825,1502,54.93%,28.83%,1
新北市,新莊區,0522,419,304,723,63,786,1412,55.67%,29.67%,1
新北市,新莊區,0523,393,301,694,45,739,1318,56.07%,29.82%,1
新北市,新莊區,0524,462,365,827,33,860,1411,60.95%,32.74%,1
新北市,新莊區,0525,424,292,716,20,736,1262,58.32%,33.6%,1
新北市,新莊區,0526,407,310,717,28,745,1228,60.67%,33.14%,1
新北市,新莊區,0527,548,434,982,42,1024,1748,58.58%,31.35%,1
新北市,新莊區,0528,581,386,967,60,1027,1761,58.32%,32.99%,1
新北市,新莊區,0529,397,269,666,37,703,1326,53.02%,29.94%,1
新北市,新莊區,0530,397,251,648,25,673,1344,50.07%,29.54%,1
新北市,新莊區,0531,437,291,728,38,766,1355,56.53%,32.25%,1
新北市,新莊區,0532,419,287,706,52,758,1306,58.04%,32.08%,1
新北市,新莊區,0533,470,305,775,26,801,1349,59.38%,34.84%,1
新北市,新莊區,0534,432,276,708,30,738,1265,58.34%,34.15%,1
新北市,新莊區,0535,437,300,737,43,780,1282,60.84%,34.09%,1
新北市,新莊區,0536,431,289,720,32,752,1237,60.79%,34.84%,1
新北市,新莊區,0537,413,288,701,20,721,1301,55.42%,31.74%,1
新北市,新莊區,0538,394,279,673,54,727,1262,57.61%,31.22%,1
新北市,新莊區,0539,389,293,682,42,724,1270,57.01%,30.63%,1
新北市,新莊區,0540,389,302,691,42,733,1245,58.88%,31.24%,1
新北市,新莊區,0541,374,271,645,44,689,1220,56.48%,30.66%,1
新北市,新莊區,0542,337,279,616,45,661,1245,53.09%,27.07%,1
新北市,新莊區,0543,386,233,619,44,663,1212,54.7%,31.85%,1
新北市,新莊區,0544,368,284,652,36,688,1253,54.91%,29.37%,1
新北市,新莊區,0545,362,275,637,43,680,1272,53.46%,28.46%,1
新北市,新莊區,0546,439,271,710,22,732,1227,59.66%,35.78%,1
新北市,新莊區,0547,377,275,652,25,677,1126,60.12%,33.48%,1
新北市,新莊區,0548,398,287,685,36,721,1240,58.15%,32.1%,1
新北市,新莊區,0549,465,333,798,33,831,1460,56.92%,31.85%,1
新北市,新莊區,0550,313,257,570,27,597,1072,55.69%,29.2%,1
新北市,新莊區,0551,316,250,566,29,595,1127,52.8%,28.04%,1
新北市,新莊區,0552,448,305,753,28,781,1332,58.63%,33.63%,1
新北市,新莊區,0553,388,306,694,17,711,1341,53.02%,28.93%,1
新北市,新莊區,0554,291,196,487,20,507,1140,44.47%,25.53%,1
新北市,新店區,1987,516,340,856,42,898,1603,56.02%,32.19%,1
新北市,新店區,1988,617,418,1035,45,1080,1921,56.22%,32.12%,1
新北市,新店區,1989,340,239,579,21,600,1082,55.45%,31.42%,1
新北市,新店區,1990,414,267,681,41,722,1235,58.46%,33.52%,1
新北市,新店區,1991,604,295,899,21,920,1568,58.67%,38.52%,1
新北市,新店區,1992,160,181,341,27,368,771,47.73%,20.75%,1
新北市,新店區,1993,396,299,695,28,723,1256,57.56%,31.53%,1
新北市,新店區,1994,440,127,567,37,604,1008,59.92%,43.65%,1
新北市,新店區,1995,556,296,852,42,894,1515,59.01%,36.7%,1
新北市,新店區,1996,652,328,980,41,1021,1637,62.37%,39.83%,1
新北市,新店區,1997,550,321,871,33,904,1549,58.36%,35.51%,1
新北市,新店區,1998,783,430,1213,45,1258,2011,62.56%,38.94%,1
新北市,新店區,1999,522,333,855,53,908,1554,58.43%,33.59%,1
新北市,新店區,2000,559,387,946,46,992,1770,56.05%,31.58%,1
新北市,新店區,2001,474,273,747,36,783,1316,59.5%,36.02%,1
新北市,新店區,2002,410,204,614,34,648,1126,57.55%,36.41%,1
新北市,新店區,2003,462,306,768,35,803,1460,55%,31.64%,1
新北市,新店區,2004,561,338,899,51,950,1584,59.97%,35.42%,1
新北市,新店區,2005,484,319,803,32,835,1449,57.63%,33.4%,1
新北市,新店區,2006,595,338,933,33,966,1520,63.55%,39.14%,1
新北市,新店區,2007,662,379,1041,30,1071,1821,58.81%,36.35%,1
新北市,新店區,2008,671,421,1092,31,1123,1956,57.41%,34.3%,1
新北市,新店區,2009,590,351,941,40,981,1665,58.92%,35.44%,1
新北市,新店區,2010,572,360,932,38,970,1588,61.08%,36.02%,1
新北市,新店區,2011,498,330,828,27,855,1519,56.29%,32.78%,1
新北市,新店區,2012,438,282,720,32,752,1185,63.46%,36.96%,1
新北市,新店區,2013,407,274,681,22,703,1095,64.2%,37.17%,1
新北市,新店區,2014,426,234,660,34,694,1106,62.75%,38.52%,1
新北市,新店區,2015,213,177,390,23,413,2700,15.3%,7.89%,1
新北市,新店區,2016,392,198,590,20,610,995,61.31%,39.4%,1
新北市,新店區,2017,432,219,651,39,690,1168,59.08%,36.99%,1
新北市,新店區,2018,485,239,724,40,764,1123,68.03%,43.19%,1
新北市,新店區,2019,409,268,677,30,707,1085,65.16%,37.7%,1
新北市,新店區,2020,531,308,839,45,884,1412,62.61%,37.61%,1
新北市,新店區,2021,576,376,952,29,981,1659,59.13%,34.72%,1
新北市,新店區,2022,454,264,718,47,765,1198,63.86%,37.9%,1
新北市,新店區,2023,448,263,711,38,749,1376,54.43%,32.56%,1
新北市,新店區,2024,459,243,702,26,728,1300,56%,35.31%,1
新北市,新店區,2025,431,268,699,29,728,1238,58.8%,34.81%,1
新北市,新店區,2026,469,263,732,30,762,1388,54.9%,33.79%,1
新北市,新店區,2027,339,225,564,27,591,933,63.34%,36.33%,1
新北市,新店區,2028,353,205,558,24,582,908,64.1%,38.88%,1
新北市,新店區,2029,550,316,866,49,915,1582,57.84%,34.77%,1
新北市,新店區,2030,473,272,745,36,781,1247,62.63%,37.93%,1
新北市,新店區,2031,339,227,566,39,605,971,62.31%,34.91%,1
新北市,新店區,2032,435,238,673,36,709,1145,61.92%,37.99%,1
新北市,新店區,2033,505,299,804,33,837,1392,60.13%,36.28%,1
新北市,新店區,2034,557,314,871,47,918,1452,63.22%,38.36%,1
新北市,新店區,2035,488,316,804,33,837,1440,58.13%,33.89%,1
新北市,新店區,2036,575,381,956,64,1020,1786,57.11%,32.19%,1
新北市,新店區,2037,640,383,1023,42,1065,1825,58.36%,35.07%,1
新北市,新店區,2038,553,328,881,28,909,1477,61.54%,37.44%,1
新北市,新店區,2039,619,374,993,38,1031,1750,58.91%,35.37%,1
新北市,新店區,2040,656,331,987,35,1022,1792,57.03%,36.61%,1
新北市,新店區,2041,704,381,1085,43,1128,1979,57%,35.57%,1
新北市,新店區,2042,303,185,488,18,506,826,61.26%,36.68%,1
新北市,新店區,2043,756,354,1110,34,1144,1924,59.46%,39.29%,1
新北市,新店區,2044,549,307,856,20,876,1383,63.34%,39.7%,1
新北市,新店區,2045,261,148,409,23,432,830,52.05%,31.45%,1
新北市,新店區,2046,664,369,1033,42,1075,1759,61.11%,37.75%,1
新北市,新店區,2047,720,415,1135,46,1181,1957,60.35%,36.79%,1
新北市,新店區,2048,528,353,881,22,903,1481,60.97%,35.65%,1
新北市,新店區,2049,555,311,866,51,917,1552,59.09%,35.76%,1
新北市,新店區,2050,496,292,788,62,850,1467,57.94%,33.81%,1
新北市,新店區,2051,463,293,756,44,800,1371,58.35%,33.77%,1
新北市,新店區,2052,359,224,583,23,606,991,61.15%,36.23%,1
新北市,新店區,2053,436,285,721,36,757,1231,61.49%,35.42%,1
新北市,新店區,2054,591,367,958,41,999,1701,58.73%,34.74%,1
新北市,新店區,2055,603,359,962,48,1010,1707,59.17%,35.33%,1
新北市,新店區,2056,631,360,991,30,1021,1773,57.59%,35.59%,1
新北市,新店區,2057,602,349,951,41,992,1866,53.16%,32.26%,1
新北市,新店區,2058,612,388,1000,35,1035,1735,59.65%,35.27%,1
新北市,新店區,2059,612,401,1013,37,1050,1632,64.34%,37.5%,1
新北市,新店區,2060,542,362,904,48,952,1591,59.84%,34.07%,1
新北市,新店區,2061,497,274,771,47,818,1495,54.72%,33.24%,1
新北市,新店區,2062,486,279,765,29,794,1511,52.55%,32.16%,1
新北市,新店區,2063,437,268,705,34,739,1260,58.65%,34.68%,1
新北市,新店區,2064,705,406,1111,48,1159,1948,59.5%,36.19%,1
新北市,新店區,2065,568,379,947,39,986,1582,62.33%,35.9%,1
新北市,新店區,2066,449,281,730,37,767,1315,58.33%,34.14%,1
新北市,新店區,2067,498,340,838,42,880,1562,56.34%,31.88%,1
新北市,新店區,2068,765,400,1165,23,1188,1982,59.94%,38.6%,1
新北市,新店區,2069,513,353,866,43,909,1518,59.88%,33.79%,1
新北市,新店區,2070,599,369,968,26,994,1735,57.29%,34.52%,1
新北市,新店區,2071,623,301,924,46,970,1716,56.53%,36.31%,1
新北市,新店區,2072,550,348,898,42,940,1580,59.49%,34.81%,1
新北市,新店區,2073,513,312,825,26,851,1358,62.67%,37.78%,1
新北市,新店區,2074,571,377,948,54,1002,1610,62.24%,35.47%,1
新北市,新店區,2075,443,306,749,28,777,1383,56.18%,32.03%,1
新北市,新店區,2076,588,329,917,26,943,1596,59.09%,36.84%,1
新北市,新店區,2077,429,257,686,40,726,1360,53.38%,31.54%,1
新北市,新店區,2078,386,213,599,19,618,1160,53.28%,33.28%,1
新北市,新店區,2079,577,219,796,23,819,1236,66.26%,46.68%,1
新北市,新店區,2080,521,254,775,22,797,1234,64.59%,42.22%,1
新北市,新店區,2081,509,364,873,44,917,1579,58.07%,32.24%,1
新北市,新店區,2082,451,221,672,38,710,1241,57.21%,36.34%,1
新北市,新店區,2083,434,276,710,21,731,1275,57.33%,34.04%,1
新北市,新店區,2084,378,237,615,30,645,1214,53.13%,31.14%,1
新北市,新店區,2085,426,313,739,51,790,1578,50.06%,27%,1
新北市,新店區,2086,457,294,751,48,799,1442,55.41%,31.69%,1
新北市,新店區,2087,426,231,657,57,714,1475,48.41%,28.88%,1
新北市,新店區,2088,516,363,879,34,913,1580,57.78%,32.66%,1
新北市,新店區,2089,524,338,862,27,889,1585,56.09%,33.06%,1
新北市,新店區,2090,515,339,854,45,899,1586,56.68%,32.47%,1
新北市,新店區,2091,652,381,1033,53,1086,1931,56.24%,33.76%,1
新北市,新店區,2092,419,244,663,22,685,1239,55.29%,33.82%,1
新北市,新店區,2093,652,356,1008,43,1051,1892,55.55%,34.46%,1
新北市,新店區,2094,490,291,781,35,816,1529,53.37%,32.05%,1
新北市,新店區,2095,503,264,767,28,795,1358,58.54%,37.04%,1
新北市,新店區,2096,575,392,967,29,996,1905,52.28%,30.18%,1
新北市,新店區,2097,599,376,975,44,1019,1885,54.06%,31.78%,1
新北市,新店區,2098,459,239,698,41,739,1345,54.94%,34.13%,1
新北市,新店區,2099,478,288,766,42,808,1387,58.26%,34.46%,1
新北市,新店區,2100,617,428,1045,36,1081,1960,55.15%,31.48%,1
新北市,新店區,2101,591,371,962,67,1029,1837,56.02%,32.17%,1
新北市,新店區,2102,558,358,916,33,949,1662,57.1%,33.57%,1
新北市,新店區,2103,579,371,950,45,995,1617,61.53%,35.81%,1
新北市,新店區,2104,568,392,960,32,992,1704,58.22%,33.33%,1
新北市,新店區,2105,568,373,941,51,992,1835,54.06%,30.95%,1
新北市,新店區,2106,639,390,1029,60,1089,2009,54.21%,31.81%,1
新北市,新店區,2107,473,292,765,47,812,1450,56%,32.62%,1
新北市,新店區,2108,549,374,923,40,963,1726,55.79%,31.81%,1
新北市,新店區,2109,551,386,937,40,977,1797,54.37%,30.66%,1
新北市,新店區,2110,561,375,936,32,968,1739,55.66%,32.26%,1
新北市,新店區,2111,512,320,832,26,858,1523,56.34%,33.62%,1
新北市,新店區,2112,589,308,897,19,916,1642,55.79%,35.87%,1
新北市,新店區,2113,576,341,917,23,940,1644,57.18%,35.04%,1
新北市,新店區,2114,492,337,829,29,858,1662,51.62%,29.6%,1
新北市,新店區,2115,679,468,1147,38,1185,2067,57.33%,32.85%,1
新北市,新店區,2116,482,363,845,40,885,1870,47.33%,25.78%,1
新北市,新店區,2117,650,394,1044,44,1088,1982,54.89%,32.8%,1
新北市,新店區,2118,555,293,848,30,878,1546,56.79%,35.9%,1
新北市,新店區,2119,642,354,996,39,1035,1712,60.46%,37.5%,1
新北市,新店區,2120,538,315,853,30,883,1423,62.05%,37.81%,1
新北市,新店區,2121,570,387,957,48,1005,1666,60.32%,34.21%,1
新北市,新店區,2122,665,391,1056,50,1106,1769,62.52%,37.59%,1
新北市,新店區,2123,313,208,521,26,547,1079,50.7%,29.01%,1
新北市,新店區,2124,358,259,617,24,641,1140,56.23%,31.4%,1
新北市,新店區,2125,596,358,954,51,1005,1825,55.07%,32.66%,1
新北市,新店區,2126,412,254,666,49,715,1178,60.7%,34.97%,1
新北市,新店區,2127,479,288,767,32,799,1463,54.61%,32.74%,1
新北市,新店區,2128,389,246,635,27,662,1152,57.47%,33.77%,1
新北市,新店區,2129,548,372,920,30,950,2008,47.31%,27.29%,1
新北市,新店區,2130,587,360,947,29,976,2120,46.04%,27.69%,1
新北市,新店區,2131,441,236,677,19,696,1153,60.36%,38.25%,1
新北市,新店區,2132,513,288,801,30,831,1573,52.83%,32.61%,1
新北市,新店區,2133,559,369,928,50,978,1992,49.1%,28.06%,1
新北市,新店區,2134,445,321,766,38,804,1668,48.2%,26.68%,1
新北市,新店區,2135,468,291,759,37,796,1617,49.23%,28.94%,1
新北市,新店區,2136,619,371,990,88,1078,2013,53.55%,30.75%,1
新北市,新店區,2137,611,400,1011,35,1046,1791,58.4%,34.12%,1
新北市,新店區,2138,529,367,896,34,930,1624,57.27%,32.57%,1
新北市,新店區,2139,442,242,684,33,717,1178,60.87%,37.52%,1
新北市,新店區,2140,447,285,732,23,755,1277,59.12%,35%,1
新北市,新店區,2141,613,417,1030,38,1068,1879,56.84%,32.62%,1
新北市,新店區,2142,276,164,440,29,469,939,49.95%,29.39%,1
新北市,新店區,2143,293,230,523,24,547,960,56.98%,30.52%,1
新北市,新店區,2144,532,302,834,48,882,1434,61.51%,37.1%,1
新北市,新店區,2145,564,355,919,40,959,1838,52.18%,30.69%,1
新北市,新店區,2146,463,318,781,35,816,1453,56.16%,31.87%,1
新北市,新店區,2147,326,467,793,43,836,1549,53.97%,21.05%,1
新北市,新店區,2148,655,398,1053,33,1086,1860,58.39%,35.22%,1
新北市,新店區,2149,574,311,885,37,922,1743,52.9%,32.93%,1
新北市,新店區,2150,443,262,705,33,738,1122,65.78%,39.48%,1
新北市,新店區,2151,512,273,785,33,818,1468,55.72%,34.88%,1
新北市,新店區,2152,350,583,933,40,973,1763,55.19%,19.85%,1
新北市,新店區,2153,421,267,688,28,716,1344,53.27%,31.32%,1
新北市,新店區,2154,245,139,384,24,408,753,54.18%,32.54%,1
新北市,新店區,2155,176,155,331,10,341,602,56.64%,29.24%,1
新北市,新店區,2156,639,485,1124,52,1176,2237,52.57%,28.57%,1
新北市,新店區,2157,364,225,589,26,615,1096,56.11%,33.21%,1
新北市,新店區,2158,310,190,500,37,537,1143,46.98%,27.12%,1
新北市,新店區,2159,489,302,791,51,842,1569,53.66%,31.17%,1
新北市,新店區,2160,378,275,653,65,718,1284,55.92%,29.44%,1
新北市,新店區,2161,76,75,151,10,161,439,36.67%,17.31%,1
新北市,新店區,2162,231,180,411,28,439,750,58.53%,30.8%,1
新北市,樹林區,1614,399,298,697,47,744,1408,52.84%,28.34%,1
新北市,樹林區,1615,407,269,676,26,702,1310,53.59%,31.07%,1
新北市,樹林區,1616,419,289,708,51,759,1534,49.48%,27.31%,1
新北市,樹林區,1617,386,237,623,54,677,1211,55.9%,31.87%,1
新北市,樹林區,1618,366,258,624,39,663,1125,58.93%,32.53%,1
新北市,樹林區,1619,431,229,660,26,686,1134,60.49%,38.01%,1
新北市,樹林區,1620,456,370,826,68,894,1897,47.13%,24.04%,1
新北市,樹林區,1621,483,383,866,49,915,1716,53.32%,28.15%,1
新北市,樹林區,1622,234,187,421,38,459,736,62.36%,31.79%,1
新北市,樹林區,1623,376,302,678,17,695,1137,61.13%,33.07%,1
新北市,樹林區,1624,431,340,771,34,805,1542,52.2%,27.95%,1
新北市,樹林區,1625,443,325,768,52,820,1470,55.78%,30.14%,1
新北市,樹林區,1626,415,279,694,26,720,1456,49.45%,28.5%,1
新北市,樹林區,1627,363,258,621,26,647,1124,57.56%,32.3%,1
新北市,樹林區,1628,359,276,635,23,658,1235,53.28%,29.07%,1
新北市,樹林區,1629,338,316,654,31,685,1212,56.52%,27.89%,1
新北市,樹林區,1630,357,233,590,46,636,1223,52%,29.19%,1
新北市,樹林區,1631,406,279,685,51,736,1335,55.13%,30.41%,1
新北市,樹林區,1632,353,281,634,33,667,1206,55.31%,29.27%,1
新北市,樹林區,1633,381,265,646,62,708,1927,36.74%,19.77%,1
新北市,樹林區,1634,288,198,486,37,523,914,57.22%,31.51%,1
新北市,樹林區,1635,482,316,798,44,842,1456,57.83%,33.1%,1
新北市,樹林區,1636,461,262,723,45,768,1409,54.51%,32.72%,1
新北市,樹林區,1637,532,320,852,49,901,1500,60.07%,35.47%,1
新北市,樹林區,1638,490,339,829,38,867,1545,56.12%,31.72%,1
新北市,樹林區,1639,420,340,760,27,787,1483,53.07%,28.32%,1
新北市,樹林區,1640,511,297,808,27,835,1524,54.79%,33.53%,1
新北市,樹林區,1641,462,308,770,38,808,1431,56.46%,32.29%,1
新北市,樹林區,1642,373,249,622,34,656,1181,55.55%,31.58%,1
新北市,樹林區,1643,343,264,607,45,652,1116,58.42%,30.73%,1
新北市,樹林區,1644,289,250,539,26,565,1077,52.46%,26.83%,1
新北市,樹林區,1645,295,260,555,19,574,1103,52.04%,26.75%,1
新北市,樹林區,1646,401,330,731,45,776,1385,56.03%,28.95%,1
新北市,樹林區,1647,370,276,646,30,676,1266,53.4%,29.23%,1
新北市,樹林區,1648,335,281,616,38,654,1195,54.73%,28.03%,1
新北市,樹林區,1649,347,294,641,45,686,1254,54.7%,27.67%,1
新北市,樹林區,1650,388,319,707,26,733,1263,58.04%,30.72%,1
新北市,樹林區,1651,456,380,836,65,901,1473,61.17%,30.96%,1
新北市,樹林區,1652,292,185,477,25,502,870,57.7%,33.56%,1
新北市,樹林區,1653,440,325,765,54,819,1338,61.21%,32.88%,1
新北市,樹林區,1654,316,213,529,35,564,1010,55.84%,31.29%,1
新北市,樹林區,1655,525,408,933,41,974,1658,58.75%,31.66%,1
新北市,樹林區,1656,535,381,916,54,970,1538,63.07%,34.79%,1
新北市,樹林區,1657,489,352,841,48,889,1405,63.27%,34.8%,1
新北市,樹林區,1658,489,350,839,51,890,1587,56.08%,30.81%,1
新北市,樹林區,1659,493,367,860,31,891,1566,56.9%,31.48%,1
新北市,樹林區,1660,306,216,522,15,537,997,53.86%,30.69%,1
新北市,樹林區,1661,380,256,636,51,687,1187,57.88%,32.01%,1
新北市,樹林區,1662,315,227,542,39,581,1061,54.76%,29.69%,1
新北市,樹林區,1663,578,368,946,37,983,1701,57.79%,33.98%,1
新北市,樹林區,1664,415,267,682,43,725,1278,56.73%,32.47%,1
新北市,樹林區,1665,523,305,828,41,869,1433,60.64%,36.5%,1
新北市,樹林區,1666,454,298,752,52,804,1306,61.56%,34.76%,1
新北市,樹林區,1667,443,286,729,52,781,1268,61.59%,34.94%,1
新北市,樹林區,1668,414,315,729,24,753,1281,58.78%,32.32%,1
新北市,樹林區,1669,374,303,677,40,717,1200,59.75%,31.17%,1
新北市,樹林區,1670,450,320,770,33,803,1491,53.86%,30.18%,1
新北市,樹林區,1671,331,218,549,30,579,1066,54.32%,31.05%,1
新北市,樹林區,1672,302,205,507,52,559,877,63.74%,34.44%,1
新北市,樹林區,1673,516,308,824,53,877,1616,54.27%,31.93%,1
新北市,樹林區,1674,393,310,703,45,748,1589,47.07%,24.73%,1
新北市,樹林區,1675,466,296,762,33,795,1367,58.16%,34.09%,1
新北市,樹林區,1676,396,264,660,28,688,1144,60.14%,34.62%,1
新北市,樹林區,1677,332,207,539,31,570,1059,53.82%,31.35%,1
新北市,樹林區,1678,372,249,621,57,678,1224,55.39%,30.39%,1
新北市,樹林區,1679,334,214,548,34,582,1141,51.01%,29.27%,1
新北市,樹林區,1680,389,249,638,22,660,1396,47.28%,27.87%,1
新北市,樹林區,1681,333,269,602,35,637,1157,55.06%,28.78%,1
新北市,樹林區,1682,403,310,713,64,777,1498,51.87%,26.9%,1
新北市,樹林區,1683,433,344,777,58,835,1514,55.15%,28.6%,1
新北市,樹林區,1684,442,310,752,32,784,1546,50.71%,28.59%,1
新北市,樹林區,1685,425,313,738,43,781,1392,56.11%,30.53%,1
新北市,樹林區,1686,506,348,854,34,888,1566,56.7%,32.31%,1
新北市,樹林區,1687,491,328,819,41,860,1566,54.92%,31.35%,1
新北市,樹林區,1688,454,338,792,42,834,1517,54.98%,29.93%,1
新北市,樹林區,1689,456,347,803,19,822,1481,55.5%,30.79%,1
新北市,樹林區,1690,374,278,652,28,680,1261,53.93%,29.66%,1
新北市,樹林區,1691,352,234,586,31,617,1163,53.05%,30.27%,1
新北市,樹林區,1692,547,387,934,64,998,1661,60.08%,32.93%,1
新北市,樹林區,1693,435,428,863,37,900,1585,56.78%,27.44%,1
新北市,樹林區,1694,392,194,586,32,618,1018,60.71%,38.51%,1
新北市,樹林區,1695,367,275,642,56,698,1247,55.97%,29.43%,1
新北市,樹林區,1696,428,271,699,56,755,1390,54.32%,30.79%,1
新北市,樹林區,1697,405,306,711,35,746,1293,57.7%,31.32%,1
新北市,樹林區,1698,379,281,660,32,692,1301,53.19%,29.13%,1
新北市,樹林區,1699,430,385,815,42,857,1606,53.36%,26.77%,1
新北市,樹林區,1700,378,268,646,62,708,1277,55.44%,29.6%,1
新北市,樹林區,1701,393,260,653,43,696,1219,57.1%,32.24%,1
新北市,樹林區,1702,442,294,736,34,770,1454,52.96%,30.4%,1
新北市,樹林區,1703,429,244,673,31,704,1314,53.58%,32.65%,1
新北市,樹林區,1704,378,244,622,18,640,1008,63.49%,37.5%,1
新北市,樹林區,1705,467,322,789,60,849,1574,53.94%,29.67%,1
新北市,樹林區,1706,463,298,761,33,794,1364,58.21%,33.94%,1
新北市,樹林區,1707,497,314,811,50,861,1677,51.34%,29.64%,1
新北市,樹林區,1708,464,294,758,21,779,1683,46.29%,27.57%,1
新北市,樹林區,1709,460,333,793,51,844,1452,58.13%,31.68%,1
新北市,樹林區,1710,526,369,895,25,920,1592,57.79%,33.04%,1
新北市,樹林區,1711,539,371,910,30,940,1619,58.06%,33.29%,1
新北市,樹林區,1712,631,336,967,38,1005,1642,61.21%,38.43%,1
新北市,樹林區,1713,470,276,746,16,762,1357,56.15%,34.64%,1
新北市,樹林區,1714,500,372,872,71,943,1638,57.57%,30.53%,1
新北市,樹林區,1715,461,381,842,33,875,1592,54.96%,28.96%,1
新北市,樹林區,1716,566,289,855,33,888,1521,58.38%,37.21%,1
新北市,樹林區,1717,618,373,991,42,1033,1707,60.52%,36.2%,1
新北市,樹林區,1718,587,366,953,59,1012,1741,58.13%,33.72%,1
新北市,樹林區,1719,570,327,897,32,929,1655,56.13%,34.44%,1
新北市,樹林區,1720,521,345,866,46,912,1775,51.38%,29.35%,1
新北市,樹林區,1721,674,338,1012,39,1051,1781,59.01%,37.84%,1
新北市,樹林區,1722,414,301,715,38,753,1565,48.12%,26.45%,1
新北市,樹林區,1723,247,223,470,32,502,936,53.63%,26.39%,1
新北市,樹林區,1724,334,243,577,21,598,1030,58.06%,32.43%,1
新北市,鶯歌區,1725,162,124,286,14,300,515,58.25%,31.46%,1
新北市,鶯歌區,1726,331,223,554,31,585,965,60.62%,34.3%,1
新北市,鶯歌區,1727,582,425,1007,57,1064,1931,55.1%,30.14%,1
新北市,鶯歌區,1728,497,356,853,41,894,1797,49.75%,27.66%,1
新北市,鶯歌區,1729,345,221,566,34,600,1057,56.76%,32.64%,1
新北市,鶯歌區,1730,283,202,485,20,505,962,52.49%,29.42%,1
新北市,鶯歌區,1731,347,221,568,18,586,934,62.74%,37.15%,1
新北市,鶯歌區,1732,609,405,1014,49,1063,1742,61.02%,34.96%,1
新北市,鶯歌區,1733,502,340,842,33,875,1634,53.55%,30.72%,1
新北市,鶯歌區,1734,517,320,837,31,868,1676,51.79%,30.85%,1
新北市,鶯歌區,1735,632,456,1088,53,1141,2052,55.6%,30.8%,1
新北市,鶯歌區,1736,524,396,920,27,947,1977,47.9%,26.5%,1
新北市,鶯歌區,1737,612,425,1037,24,1061,1957,54.22%,31.27%,1
新北市,鶯歌區,1738,266,160,426,16,442,850,52%,31.29%,1
新北市,鶯歌區,1739,510,369,879,34,913,1782,51.23%,28.62%,1
新北市,鶯歌區,1740,441,324,765,37,802,1496,53.61%,29.48%,1
新北市,鶯歌區,1741,586,411,997,35,1032,2071,49.83%,28.3%,1
新北市,鶯歌區,1742,427,329,756,34,790,1753,45.07%,24.36%,1
新北市,鶯歌區,1743,530,340,870,32,902,1737,51.93%,30.51%,1
新北市,鶯歌區,1744,469,330,799,47,846,1669,50.69%,28.1%,1
新北市,鶯歌區,1745,481,346,827,28,855,1842,46.42%,26.11%,1
新北市,鶯歌區,1746,411,304,715,34,749,1454,51.51%,28.27%,1
新北市,鶯歌區,1747,265,217,482,27,509,942,54.03%,28.13%,1
新北市,鶯歌區,1748,362,296,658,47,705,1317,53.53%,27.49%,1
新北市,鶯歌區,1749,289,177,466,17,483,949,50.9%,30.45%,1
新北市,鶯歌區,1750,471,327,798,44,842,1440,58.47%,32.71%,1
新北市,鶯歌區,1751,556,387,943,49,992,1809,54.84%,30.74%,1
新北市,鶯歌區,1752,538,406,944,45,989,1758,56.26%,30.6%,1
新北市,鶯歌區,1753,487,339,826,41,867,1589,54.56%,30.65%,1
新北市,鶯歌區,1754,359,240,599,39,638,1067,59.79%,33.65%,1
新北市,鶯歌區,1755,341,275,616,31,647,1092,59.25%,31.23%,1
新北市,鶯歌區,1756,571,370,941,35,976,1730,56.42%,33.01%,1
新北市,鶯歌區,1757,436,251,687,27,714,1281,55.74%,34.04%,1
新北市,鶯歌區,1758,431,309,740,34,774,1238,62.52%,34.81%,1
新北市,鶯歌區,1759,476,343,819,50,869,1568,55.42%,30.36%,1
新北市,鶯歌區,1760,400,251,651,32,683,1271,53.74%,31.47%,1
新北市,鶯歌區,1761,317,199,516,19,535,1183,45.22%,26.8%,1
新北市,鶯歌區,1762,299,197,496,24,520,1026,50.68%,29.14%,1
新北市,鶯歌區,1763,481,347,828,35,863,1721,50.15%,27.95%,1
新北市,鶯歌區,1764,367,273,640,50,690,1317,52.39%,27.87%,1
新北市,鶯歌區,1765,337,252,589,39,628,1046,60.04%,32.22%,1
新北市,鶯歌區,1766,364,286,650,39,689,1144,60.23%,31.82%,1
新北市,鶯歌區,1767,380,268,648,50,698,1336,52.25%,28.44%,1
新北市,鶯歌區,1768,376,280,656,60,716,1479,48.41%,25.42%,1
新北市,鶯歌區,1769,450,398,848,58,906,1736,52.19%,25.92%,1
新北市,鶯歌區,1770,458,200,658,56,714,1389,51.4%,32.97%,1
新北市,鶯歌區,1771,574,395,969,66,1035,1956,52.91%,29.35%,1
新北市,鶯歌區,1772,359,361,720,44,764,1371,55.73%,26.19%,1
新北市,鶯歌區,1773,419,287,706,30,736,1810,40.66%,23.15%,1
新北市,鶯歌區,1774,88,38,126,7,133,227,58.59%,38.77%,1
新北市,三峽區,1917,95,79,174,13,187,274,68.25%,34.67%,1
新北市,三峽區,1918,186,111,297,26,323,583,55.4%,31.9%,1
新北市,三峽區,1919,449,350,799,20,819,1765,46.4%,25.44%,1
新北市,三峽區,1920,521,354,875,31,906,1714,52.86%,30.4%,1
新北市,三峽區,1921,413,270,683,28,711,1355,52.47%,30.48%,1
新北市,三峽區,1922,409,307,716,39,755,1329,56.81%,30.78%,1
新北市,三峽區,1923,332,197,529,36,565,1059,53.35%,31.35%,1
新北市,三峽區,1924,434,309,743,43,786,1364,57.62%,31.82%,1
新北市,三峽區,1925,369,240,609,37,646,1098,58.83%,33.61%,1
新北市,三峽區,1926,387,287,674,45,719,1296,55.48%,29.86%,1
新北市,三峽區,1927,351,281,632,33,665,1240,53.63%,28.31%,1
新北市,三峽區,1928,438,337,775,39,814,1531,53.17%,28.61%,1
新北市,三峽區,1929,415,277,692,30,722,1444,50%,28.74%,1
新北市,三峽區,1930,375,288,663,63,726,1347,53.9%,27.84%,1
新北市,三峽區,1931,440,311,751,40,791,1455,54.36%,30.24%,1
新北市,三峽區,1932,411,301,712,29,741,1556,47.62%,26.41%,1
新北市,三峽區,1933,334,254,588,34,622,1390,44.75%,24.03%,1
新北市,三峽區,1934,477,307,784,35,819,1532,53.46%,31.14%,1
新北市,三峽區,1935,380,250,630,43,673,1377,48.87%,27.6%,1
新北市,三峽區,1936,501,361,862,37,899,1731,51.94%,28.94%,1
新北市,三峽區,1937,508,328,836,30,866,1705,50.79%,29.79%,1
新北市,三峽區,1938,480,365,845,38,883,1590,55.53%,30.19%,1
新北市,三峽區,1939,528,391,919,29,948,1650,57.45%,32%,1
新北市,三峽區,1940,467,310,777,21,798,1441,55.38%,32.41%,1
新北市,三峽區,1941,469,315,784,26,810,1404,57.69%,33.4%,1
新北市,三峽區,1942,453,295,748,24,772,1295,59.61%,34.98%,1
新北市,三峽區,1943,402,238,640,32,672,1348,49.85%,29.82%,1
新北市,三峽區,1944,528,330,858,17,875,1579,55.41%,33.44%,1
新北市,三峽區,1945,466,279,745,25,770,1435,53.66%,32.47%,1
新北市,三峽區,1946,624,312,936,33,969,1659,58.41%,37.61%,1
新北市,三峽區,1947,566,323,889,30,919,1512,60.78%,37.43%,1
新北市,三峽區,1948,527,291,818,29,847,1463,57.89%,36.02%,1
新北市,三峽區,1949,518,312,830,26,856,1465,58.43%,35.36%,1
新北市,三峽區,1950,535,308,843,21,864,1463,59.06%,36.57%,1
新北市,三峽區,1951,533,277,810,29,839,1443,58.14%,36.94%,1
新北市,三峽區,1952,463,328,791,41,832,1634,50.92%,28.34%,1
新北市,三峽區,1953,533,364,897,35,932,1716,54.31%,31.06%,1
新北市,三峽區,1954,297,343,640,30,670,1675,40%,17.73%,1
新北市,三峽區,1955,433,292,725,28,753,1649,45.66%,26.26%,1
新北市,三峽區,1956,440,308,748,41,789,1489,52.99%,29.55%,1
新北市,三峽區,1957,508,323,831,39,870,1771,49.12%,28.68%,1
新北市,三峽區,1958,508,405,913,34,947,1726,54.87%,29.43%,1
新北市,三峽區,1959,421,274,695,34,729,1363,53.48%,30.89%,1
新北市,三峽區,1960,525,336,861,33,894,1624,55.05%,32.33%,1
新北市,三峽區,1961,439,292,731,34,765,1352,56.58%,32.47%,1
新北市,三峽區,1962,393,275,668,14,682,1608,42.41%,24.44%,1
新北市,三峽區,1963,440,304,744,40,784,1458,53.77%,30.18%,1
新北市,三峽區,1964,418,350,768,39,807,1641,49.18%,25.47%,1
新北市,三峽區,1965,446,290,736,79,815,1530,53.27%,29.15%,1
新北市,三峽區,1966,374,220,594,41,635,1389,45.72%,26.93%,1
新北市,三峽區,1967,367,237,604,62,666,1315,50.65%,27.91%,1
新北市,三峽區,1968,370,177,547,24,571,934,61.13%,39.61%,1
新北市,三峽區,1969,353,247,600,33,633,1270,49.84%,27.8%,1
新北市,三峽區,1970,230,197,427,31,458,929,49.3%,24.76%,1
新北市,三峽區,1971,330,192,522,23,545,1035,52.66%,31.88%,1
新北市,三峽區,1972,137,97,234,15,249,502,49.6%,27.29%,1
新北市,三峽區,1973,251,134,385,30,415,836,49.64%,30.02%,1
新北市,三峽區,1974,167,115,282,48,330,669,49.33%,24.96%,1
新北市,三峽區,1975,212,168,380,58,438,733,59.75%,28.92%,1
新北市,三峽區,1976,857,28,885,49,934,1560,59.87%,54.94%,1
新北市,三峽區,1977,481,328,809,39,848,1638,51.77%,29.37%,1
新北市,三峽區,1978,427,267,694,33,727,1394,52.15%,30.63%,1
新北市,三峽區,1979,204,211,415,30,445,771,57.72%,26.46%,1
新北市,三峽區,1980,360,311,671,31,702,1367,51.35%,26.34%,1
新北市,三峽區,1981,334,254,588,59,647,1241,52.14%,26.91%,1
新北市,三峽區,1982,439,288,727,22,749,1520,49.28%,28.88%,1
新北市,三峽區,1983,326,207,533,26,559,873,64.03%,37.34%,1
新北市,三峽區,1984,179,124,303,70,373,768,48.57%,23.31%,1
新北市,三峽區,1985,301,201,502,24,526,1097,47.95%,27.44%,1
新北市,三峽區,1986,338,228,566,45,611,1322,46.22%,25.57%,1
新北市,淡水區,0029,143,117,260,32,292,544,53.68%,26.29%,1
新北市,淡水區,0030,297,243,540,43,583,1044,55.84%,28.45%,1
新北市,淡水區,0031,395,316,711,43,754,1462,51.57%,27.02%,1
新北市,淡水區,0032,419,317,736,62,798,1525,52.33%,27.48%,1
新北市,淡水區,0033,276,166,442,32,474,986,48.07%,27.99%,1
新北市,淡水區,0034,250,190,440,21,461,806,57.2%,31.02%,1
新北市,淡水區,0035,349,250,599,58,657,1173,56.01%,29.75%,1
新北市,淡水區,0036,380,240,620,27,647,1343,48.18%,28.29%,1
新北市,淡水區,0037,292,217,509,20,529,1153,45.88%,25.33%,1
新北市,淡水區,0038,230,190,420,30,450,874,51.49%,26.32%,1
新北市,淡水區,0039,304,222,526,64,590,1063,55.5%,28.6%,1
新北市,淡水區,0040,404,222,626,36,662,1309,50.57%,30.86%,1
新北市,淡水區,0041,387,264,651,41,692,1290,53.64%,30%,1
新北市,淡水區,0042,552,376,928,27,955,1675,57.01%,32.96%,1
新北市,淡水區,0043,502,332,834,42,876,1589,55.13%,31.59%,1
新北市,淡水區,0044,519,394,913,32,945,1624,58.19%,31.96%,1
新北市,淡水區,0045,365,265,630,34,664,1241,53.51%,29.41%,1
新北市,淡水區,0046,427,263,690,36,726,1317,55.13%,32.42%,1
新北市,淡水區,0047,471,216,687,28,715,1225,58.37%,38.45%,1
新北市,淡水區,0048,467,294,761,30,791,1426,55.47%,32.75%,1
新北市,淡水區,0049,552,353,905,31,936,1610,58.14%,34.29%,1
新北市,淡水區,0050,702,364,1066,36,1102,1982,55.6%,35.42%,1
新北市,淡水區,0051,529,347,876,31,907,1924,47.14%,27.49%,1
新北市,淡水區,0052,512,380,892,28,920,1822,50.49%,28.1%,1
新北市,淡水區,0053,290,401,691,46,737,1232,59.82%,23.54%,1
新北市,淡水區,0054,518,341,859,51,910,1588,57.3%,32.62%,1
新北市,淡水區,0055,518,350,868,34,902,1784,50.56%,29.04%,1
新北市,淡水區,0056,502,364,866,62,928,1762,52.67%,28.49%,1
新北市,淡水區,0057,465,323,788,36,824,1546,53.3%,30.08%,1
新北市,淡水區,0058,575,402,977,39,1016,1897,53.56%,30.31%,1
新北市,淡水區,0059,465,302,767,33,800,1489,53.73%,31.23%,1
新北市,淡水區,0060,527,312,839,26,865,1679,51.52%,31.39%,1
新北市,淡水區,0061,478,335,813,34,847,1693,50.03%,28.23%,1
新北市,淡水區,0062,521,306,827,17,844,1674,50.42%,31.12%,1
新北市,淡水區,0063,432,277,709,19,728,1330,54.74%,32.48%,1
新北市,淡水區,0064,455,292,747,22,769,1467,52.42%,31.02%,1
新北市,淡水區,0065,603,335,938,42,980,1837,53.35%,32.83%,1
新北市,淡水區,0066,400,234,634,17,651,1924,33.84%,20.79%,1
新北市,淡水區,0067,678,464,1142,36,1178,2340,50.34%,28.97%,1
新北市,淡水區,0068,485,283,768,35,803,1704,47.12%,28.46%,1
新北市,淡水區,0069,395,283,678,40,718,1363,52.68%,28.98%,1
新北市,淡水區,0070,784,600,1384,37,1421,3068,46.32%,25.55%,1
新北市,淡水區,0071,447,289,736,33,769,1528,50.33%,29.25%,1
新北市,淡水區,0072,448,336,784,45,829,1600,51.81%,28%,1
新北市,淡水區,0073,616,391,1007,50,1057,1874,56.4%,32.87%,1
新北市,淡水區,0074,466,319,785,50,835,1567,53.29%,29.74%,1
新北市,淡水區,0075,395,283,678,25,703,1245,56.47%,31.73%,1
新北市,淡水區,0076,348,267,615,18,633,1211,52.27%,28.74%,1
新北市,淡水區,0077,641,424,1065,45,1110,1992,55.72%,32.18%,1
新北市,淡水區,0078,679,415,1094,28,1122,2028,55.33%,33.48%,1
新北市,淡水區,0079,466,284,750,31,781,1373,56.88%,33.94%,1
新北市,淡水區,0080,534,371,905,34,939,1732,54.21%,30.83%,1
新北市,淡水區,0081,413,321,734,33,767,1519,50.49%,27.19%,1
新北市,淡水區,0082,507,320,827,21,848,1727,49.1%,29.36%,1
新北市,淡水區,0083,464,249,713,25,738,1297,56.9%,35.77%,1
新北市,淡水區,0084,298,235,533,41,574,1066,53.85%,27.95%,1
新北市,淡水區,0085,461,283,744,39,783,1387,56.45%,33.24%,1
新北市,淡水區,0086,620,381,1001,45,1046,1909,54.79%,32.48%,1
新北市,淡水區,0087,550,373,923,33,956,1770,54.01%,31.07%,1
新北市,淡水區,0088,628,388,1016,34,1050,2049,51.24%,30.65%,1
新北市,淡水區,0089,548,326,874,35,909,1680,54.11%,32.62%,1
新北市,淡水區,0090,469,337,806,42,848,1433,59.18%,32.73%,1
新北市,淡水區,0091,415,292,707,25,732,1365,53.63%,30.4%,1
新北市,淡水區,0092,457,317,774,40,814,1452,56.06%,31.47%,1
新北市,淡水區,0093,551,370,921,40,961,1804,53.27%,30.54%,1
新北市,淡水區,0094,422,270,692,40,732,1322,55.37%,31.92%,1
新北市,淡水區,0095,633,420,1053,26,1079,2019,53.44%,31.35%,1
新北市,淡水區,0096,594,365,959,42,1001,1696,59.02%,35.02%,1
新北市,淡水區,0097,519,335,854,29,883,1576,56.03%,32.93%,1
新北市,淡水區,0098,552,391,943,54,997,1781,55.98%,30.99%,1
新北市,淡水區,0099,531,382,913,54,967,1665,58.08%,31.89%,1
新北市,淡水區,0100,522,414,936,43,979,2013,48.63%,25.93%,1
新北市,淡水區,0101,329,245,574,23,597,1108,53.88%,29.69%,1
新北市,淡水區,0102,411,281,692,36,728,1305,55.79%,31.49%,1
新北市,淡水區,0103,391,250,641,20,661,1199,55.13%,32.61%,1
新北市,淡水區,0104,619,414,1033,38,1071,2017,53.1%,30.69%,1
新北市,淡水區,0105,570,441,1011,34,1045,2125,49.18%,26.82%,1
新北市,淡水區,0106,358,231,589,26,615,1289,47.71%,27.77%,1
新北市,淡水區,0107,402,346,748,39,787,1319,59.67%,30.48%,1
新北市,淡水區,0108,369,223,592,26,618,1051,58.8%,35.11%,1
新北市,淡水區,0109,435,276,711,31,742,1348,55.04%,32.27%,1
新北市,淡水區,0110,333,239,572,34,606,1106,54.79%,30.11%,1
新北市,淡水區,0111,242,149,391,29,420,717,58.58%,33.75%,1
新北市,淡水區,0112,412,316,728,23,751,1385,54.22%,29.75%,1
新北市,淡水區,0113,274,199,473,33,506,841,60.17%,32.58%,1
新北市,淡水區,0114,214,151,365,23,388,665,58.35%,32.18%,1
新北市,淡水區,0115,135,107,242,10,252,419,60.14%,32.22%,1
新北市,淡水區,0116,542,331,873,27,900,1599,56.29%,33.9%,1
新北市,淡水區,0117,487,336,823,57,880,1670,52.69%,29.16%,1
新北市,淡水區,0118,595,319,914,44,958,1683,56.92%,35.35%,1
新北市,淡水區,0119,455,314,769,41,810,1577,51.36%,28.85%,1
新北市,淡水區,0120,454,329,783,35,818,1618,50.56%,28.06%,1
新北市,淡水區,0121,650,365,1015,36,1051,2214,47.47%,29.36%,1
新北市,淡水區,0122,553,365,918,38,956,1832,52.18%,30.19%,1
新北市,淡水區,0123,659,418,1077,46,1123,2123,52.9%,31.04%,1
新北市,淡水區,0124,822,446,1268,27,1295,2998,43.2%,27.42%,1
新北市,汐止區,2336,490,314,804,61,865,1595,54.23%,30.72%,1
新北市,汐止區,2337,390,277,667,41,708,1262,56.1%,30.9%,1
新北市,汐止區,2338,279,214,493,48,541,917,59%,30.43%,1
新北市,汐止區,2339,628,404,1032,42,1074,1929,55.68%,32.56%,1
新北市,汐止區,2340,660,470,1130,60,1190,2227,53.44%,29.64%,1
新北市,汐止區,2341,344,250,594,53,647,1143,56.61%,30.1%,1
新北市,汐止區,2342,445,295,740,25,765,1367,55.96%,32.55%,1
新北市,汐止區,2343,85,77,162,15,177,322,54.97%,26.4%,1
新北市,汐止區,2344,464,330,794,12,806,1460,55.21%,31.78%,1
新北市,汐止區,2345,477,372,849,33,882,1719,51.31%,27.75%,1
新北市,汐止區,2346,524,302,826,61,887,1661,53.4%,31.55%,1
新北市,汐止區,2347,488,362,850,51,901,1590,56.67%,30.69%,1
新北市,汐止區,2348,517,327,844,35,879,1599,54.97%,32.33%,1
新北市,汐止區,2349,550,384,934,34,968,1749,55.35%,31.45%,1
新北市,汐止區,2350,197,141,338,18,356,1809,19.68%,10.89%,1
新北市,汐止區,2351,424,321,745,26,771,1601,48.16%,26.48%,1
新北市,汐止區,2352,421,265,686,52,738,1387,53.21%,30.35%,1
新北市,汐止區,2353,551,392,943,57,1000,1779,56.21%,30.97%,1
新北市,汐止區,2354,668,428,1096,50,1146,2074,55.26%,32.21%,1
新北市,汐止區,2355,632,451,1083,35,1118,2072,53.96%,30.5%,1
新北市,汐止區,2356,707,465,1172,67,1239,2120,58.44%,33.35%,1
新北市,汐止區,2357,612,434,1046,34,1080,1952,55.33%,31.35%,1
新北市,汐止區,2358,492,342,834,47,881,1654,53.26%,29.75%,1
新北市,汐止區,2359,433,292,725,42,767,1444,53.12%,29.99%,1
新北市,汐止區,2360,560,373,933,35,968,1627,59.5%,34.42%,1
新北市,汐止區,2361,536,320,856,51,907,1751,51.8%,30.61%,1
新北市,汐止區,2362,585,457,1042,41,1083,2066,52.42%,28.32%,1
新北市,汐止區,2363,483,352,835,43,878,1941,45.23%,24.88%,1
新北市,汐止區,2364,477,403,880,32,912,1906,47.85%,25.03%,1
新北市,汐止區,2365,412,254,666,52,718,1363,52.68%,30.23%,1
新北市,汐止區,2366,399,270,669,38,707,1368,51.68%,29.17%,1
新北市,汐止區,2367,330,243,573,36,609,1233,49.39%,26.76%,1
新北市,汐止區,2368,456,343,799,22,821,1554,52.83%,29.34%,1
新北市,汐止區,2369,489,350,839,39,878,1700,51.65%,28.76%,1
新北市,汐止區,2370,374,233,607,25,632,1124,56.23%,33.27%,1
新北市,汐止區,2371,611,430,1041,46,1087,1900,57.21%,32.16%,1
新北市,汐止區,2372,627,417,1044,55,1099,2050,53.61%,30.59%,1
新北市,汐止區,2373,351,270,621,47,668,1244,53.7%,28.22%,1
新北市,汐止區,2374,396,250,646,26,672,1320,50.91%,30%,1
新北市,汐止區,2375,454,330,784,49,833,1473,56.55%,30.82%,1
新北市,汐止區,2376,606,340,946,48,994,1802,55.16%,33.63%,1
新北市,汐止區,2377,445,266,711,31,742,1266,58.61%,35.15%,1
新北市,汐止區,2378,400,288,688,58,746,1481,50.37%,27.01%,1
新北市,汐止區,2379,367,346,713,64,777,1497,51.9%,24.52%,1
新北市,汐止區,2380,176,125,301,18,319,556,57.37%,31.65%,1
新北市,汐止區,2381,516,401,917,45,962,1913,50.29%,26.97%,1
新北市,汐止區,2382,548,431,979,38,1017,2027,50.17%,27.04%,1
新北市,汐止區,2383,530,383,913,33,946,1927,49.09%,27.5%,1
新北市,汐止區,2384,209,145,354,33,387,696,55.6%,30.03%,1
新北市,汐止區,2385,582,423,1005,51,1056,2127,49.65%,27.36%,1
新北市,汐止區,2386,435,301,736,41,777,1642,47.32%,26.49%,1
新北市,汐止區,2387,629,302,931,67,998,1912,52.2%,32.9%,1
新北市,汐止區,2388,468,364,832,52,884,1893,46.7%,24.72%,1
新北市,汐止區,2389,410,274,684,32,716,1466,48.84%,27.97%,1
新北市,汐止區,2390,456,291,747,45,792,1538,51.5%,29.65%,1
新北市,汐止區,2391,427,324,751,35,786,1550,50.71%,27.55%,1
新北市,汐止區,2392,411,292,703,44,747,1456,51.3%,28.23%,1
新北市,汐止區,2393,309,228,537,38,575,947,60.72%,32.63%,1
新北市,汐止區,2394,302,208,510,15,525,923,56.88%,32.72%,1
新北市,汐止區,2395,592,359,951,83,1034,2043,50.61%,28.98%,1
新北市,汐止區,2396,549,358,907,78,985,2012,48.96%,27.29%,1
新北市,汐止區,2397,422,248,670,26,696,1471,47.31%,28.69%,1
新北市,汐止區,2398,448,325,773,42,815,1603,50.84%,27.95%,1
新北市,汐止區,2399,421,349,770,54,824,1530,53.86%,27.52%,1
新北市,汐止區,2400,532,325,857,31,888,1988,44.67%,26.76%,1
新北市,汐止區,2401,610,446,1056,38,1094,2198,49.77%,27.75%,1
新北市,汐止區,2402,470,362,832,38,870,1712,50.82%,27.45%,1
新北市,汐止區,2403,595,365,960,48,1008,1806,55.81%,32.95%,1
新北市,汐止區,2404,484,305,789,53,842,1576,53.43%,30.71%,1
新北市,汐止區,2405,461,308,769,28,797,1511,52.75%,30.51%,1
新北市,汐止區,2406,481,325,806,24,830,1691,49.08%,28.44%,1
新北市,汐止區,2407,526,317,843,32,875,1636,53.48%,32.15%,1
新北市,汐止區,2408,518,322,840,32,872,1676,52.03%,30.91%,1
新北市,汐止區,2409,413,224,637,27,664,1264,52.53%,32.67%,1
新北市,汐止區,2410,376,219,595,22,617,1165,52.96%,32.27%,1
新北市,汐止區,2411,497,359,856,40,896,1765,50.76%,28.16%,1
新北市,汐止區,2412,489,297,786,31,817,1815,45.01%,26.94%,1
新北市,汐止區,2413,488,359,847,46,893,1778,50.22%,27.45%,1
新北市,汐止區,2414,406,423,829,47,876,1580,55.44%,25.7%,1
新北市,汐止區,2415,444,326,770,39,809,1516,53.36%,29.29%,1
新北市,汐止區,2416,432,256,688,40,728,1425,51.09%,30.32%,1
新北市,汐止區,2417,454,272,726,39,765,1388,55.12%,32.71%,1
新北市,汐止區,2418,444,301,745,44,789,1436,54.94%,30.92%,1
新北市,汐止區,2419,464,343,807,32,839,1591,52.73%,29.16%,1
新北市,汐止區,2420,436,349,785,29,814,1639,49.66%,26.6%,1
新北市,汐止區,2421,360,325,685,20,705,1394,50.57%,25.82%,1
新北市,汐止區,2422,566,396,962,35,997,2035,48.99%,27.81%,1
新北市,汐止區,2423,552,393,945,37,982,1895,51.82%,29.13%,1
新北市,汐止區,2424,470,287,757,30,787,1374,57.28%,34.21%,1
新北市,汐止區,2425,425,181,606,20,626,1061,59%,40.06%,1
新北市,汐止區,2426,489,310,799,30,829,1312,63.19%,37.27%,1
新北市,汐止區,2427,499,321,820,33,853,1548,55.1%,32.24%,1
新北市,汐止區,2428,424,324,748,29,777,1350,57.56%,31.41%,1
新北市,汐止區,2429,462,320,782,34,816,1499,54.44%,30.82%,1
新北市,汐止區,2430,437,317,754,37,791,1366,57.91%,31.99%,1
新北市,汐止區,2431,426,301,727,39,766,1335,57.38%,31.91%,1
新北市,汐止區,2432,489,279,768,42,810,1324,61.18%,36.93%,1
新北市,汐止區,2433,442,297,739,46,785,1286,61.04%,34.37%,1
新北市,汐止區,2434,352,243,595,42,637,1155,55.15%,30.48%,1
新北市,汐止區,2435,618,402,1020,37,1057,1682,62.84%,36.74%,1
新北市,汐止區,2436,540,336,876,46,922,1494,61.71%,36.14%,1
新北市,汐止區,2437,344,312,656,49,705,1166,60.46%,29.5%,1
新北市,汐止區,2438,649,467,1116,92,1208,2184,55.31%,29.72%,1
新北市,汐止區,2439,636,426,1062,67,1129,2031,55.59%,31.31%,1
新北市,汐止區,2440,561,359,920,59,979,1759,55.66%,31.89%,1
新北市,汐止區,2441,496,362,858,44,902,1577,57.2%,31.45%,1
新北市,汐止區,2442,444,278,722,28,750,1364,54.99%,32.55%,1
新北市,汐止區,2443,460,312,772,50,822,1401,58.67%,32.83%,1
新北市,汐止區,2444,388,277,665,34,699,1173,59.59%,33.08%,1
新北市,汐止區,2445,346,220,566,15,581,993,58.51%,34.84%,1
新北市,汐止區,2446,521,296,817,28,845,1587,53.25%,32.83%,1
新北市,瑞芳區,2220,234,159,393,29,422,725,58.21%,32.28%,1
新北市,瑞芳區,2221,342,227,569,42,611,1074,56.89%,31.84%,1
新北市,瑞芳區,2222,261,144,405,23,428,825,51.88%,31.64%,1
新北市,瑞芳區,2223,380,247,627,38,665,1242,53.54%,30.6%,1
新北市,瑞芳區,2224,161,136,297,31,328,598,54.85%,26.92%,1
新北市,瑞芳區,2225,269,164,433,33,466,872,53.44%,30.85%,1
新北市,瑞芳區,2226,189,142,331,38,369,760,48.55%,24.87%,1
新北市,瑞芳區,2227,324,260,584,45,629,1330,47.29%,24.36%,1
新北市,瑞芳區,2228,434,303,737,47,784,1683,46.58%,25.79%,1
新北市,瑞芳區,2229,285,157,442,47,489,980,49.9%,29.08%,1
新北市,瑞芳區,2230,274,190,464,39,503,946,53.17%,28.96%,1
新北市,瑞芳區,2231,420,193,613,21,634,1375,46.11%,30.55%,1
新北市,瑞芳區,2232,474,312,786,37,823,1671,49.25%,28.37%,1
新北市,瑞芳區,2233,264,158,422,24,446,978,45.6%,26.99%,1
新北市,瑞芳區,2234,167,129,296,18,314,645,48.68%,25.89%,1
新北市,瑞芳區,2235,306,195,501,62,563,1089,51.7%,28.1%,1
新北市,瑞芳區,2236,68,42,110,13,123,286,43.01%,23.78%,1
新北市,瑞芳區,2237,110,104,214,24,238,461,51.63%,23.86%,1
新北市,瑞芳區,2238,75,44,119,19,138,274,50.36%,27.37%,1
新北市,瑞芳區,2239,51,35,86,9,95,155,61.29%,32.9%,1
新北市,瑞芳區,2240,245,172,417,32,449,817,54.96%,29.99%,1
新北市,瑞芳區,2241,228,180,408,59,467,884,52.83%,25.79%,1
新北市,瑞芳區,2242,358,218,576,44,620,1333,46.51%,26.86%,1
新北市,瑞芳區,2243,134,121,255,7,262,607,43.16%,22.08%,1
新北市,瑞芳區,2244,317,201,518,38,556,1045,53.21%,30.33%,1
新北市,瑞芳區,2245,197,138,335,33,368,673,54.68%,29.27%,1
新北市,瑞芳區,2246,136,104,240,14,254,618,41.1%,22.01%,1
新北市,瑞芳區,2247,168,202,370,32,402,1063,37.82%,15.8%,1
新北市,瑞芳區,2248,233,194,427,40,467,860,54.3%,27.09%,1
新北市,瑞芳區,2249,75,60,135,5,140,432,32.41%,17.36%,1
新北市,瑞芳區,2250,105,62,167,12,179,445,40.22%,23.6%,1
新北市,瑞芳區,2251,81,48,129,9,138,318,43.4%,25.47%,1
新北市,瑞芳區,2252,49,22,71,6,77,159,48.43%,30.82%,1
新北市,瑞芳區,2253,67,66,133,14,147,337,43.62%,19.88%,1
新北市,瑞芳區,2254,58,30,88,11,99,180,55%,32.22%,1
新北市,瑞芳區,2255,47,23,70,11,81,187,43.32%,25.13%,1
新北市,瑞芳區,2256,118,61,179,11,190,369,51.49%,31.98%,1
新北市,瑞芳區,2257,100,68,168,20,188,335,56.12%,29.85%,1
新北市,瑞芳區,2258,118,75,193,14,207,470,44.04%,25.11%,1
新北市,瑞芳區,2259,70,40,110,5,115,297,38.72%,23.57%,1
新北市,瑞芳區,2260,115,59,174,7,181,267,67.79%,43.07%,1
新北市,瑞芳區,2261,158,90,248,11,259,876,29.57%,18.04%,1
新北市,瑞芳區,2262,284,174,458,26,484,1241,39%,22.88%,1
新北市,瑞芳區,2263,274,207,481,54,535,998,53.61%,27.45%,1
新北市,瑞芳區,2264,259,195,454,49,503,948,53.06%,27.32%,1
新北市,瑞芳區,2265,292,204,496,27,523,1308,39.98%,22.32%,1
新北市,土城區,1775,431,314,745,59,804,1505,53.42%,28.64%,1
新北市,土城區,1776,427,296,723,27,750,1242,60.39%,34.38%,1
新北市,土城區,1777,428,270,698,18,716,1206,59.37%,35.49%,1
新北市,土城區,1778,450,308,758,56,814,1474,55.22%,30.53%,1
新北市,土城區,1779,422,305,727,42,769,1489,51.65%,28.34%,1
新北市,土城區,1780,482,339,821,44,865,1675,51.64%,28.78%,1
新北市,土城區,1781,479,309,788,37,825,1499,55.04%,31.95%,1
新北市,土城區,1782,453,305,758,24,782,1495,52.31%,30.3%,1
新北市,土城區,1783,425,270,695,65,760,1411,53.86%,30.12%,1
新北市,土城區,1784,405,273,678,30,708,1378,51.38%,29.39%,1
新北市,土城區,1785,360,274,634,34,668,1256,53.18%,28.66%,1
新北市,土城區,1786,438,310,748,42,790,1379,57.29%,31.76%,1
新北市,土城區,1787,389,310,699,41,740,1424,51.97%,27.32%,1
新北市,土城區,1788,429,312,741,45,786,1455,54.02%,29.48%,1
新北市,土城區,1789,390,314,704,31,735,1419,51.8%,27.48%,1
新北市,土城區,1790,478,299,777,31,808,1357,59.54%,35.22%,1
新北市,土城區,1791,451,318,769,34,803,1501,53.5%,30.05%,1
新北市,土城區,1792,398,255,653,51,704,1206,58.37%,33%,1
新北市,土城區,1793,421,281,702,28,730,1255,58.17%,33.55%,1
新北市,土城區,1794,527,384,911,58,969,1869,51.85%,28.2%,1
新北市,土城區,1795,434,262,696,27,723,1292,55.96%,33.59%,1
新北市,土城區,1796,406,275,681,31,712,1324,53.78%,30.66%,1
新北市,土城區,1797,342,233,575,42,617,1155,53.42%,29.61%,1
新北市,土城區,1798,334,276,610,48,658,1183,55.62%,28.23%,1
新北市,土城區,1799,298,221,519,26,545,2518,21.64%,11.83%,1
新北市,土城區,1800,389,243,632,33,665,1218,54.6%,31.94%,1
新北市,土城區,1801,383,227,610,41,651,1133,57.46%,33.8%,1
新北市,土城區,1802,305,179,484,20,504,894,56.38%,34.12%,1
新北市,土城區,1803,313,204,517,32,549,931,58.97%,33.62%,1
新北市,土城區,1804,709,387,1096,59,1155,1820,63.46%,38.96%,1
新北市,土城區,1805,420,273,693,27,720,1320,54.55%,31.82%,1
新北市,土城區,1806,377,263,640,23,663,1241,53.42%,30.38%,1
新北市,土城區,1807,425,319,744,38,782,1414,55.3%,30.06%,1
新北市,土城區,1808,419,332,751,35,786,1378,57.04%,30.41%,1
新北市,土城區,1809,443,338,781,48,829,1421,58.34%,31.18%,1
新北市,土城區,1810,435,263,698,43,741,1340,55.3%,32.46%,1
新北市,土城區,1811,375,268,643,37,680,1144,59.44%,32.78%,1
新北市,土城區,1812,406,281,687,41,728,1268,57.41%,32.02%,1
新北市,土城區,1813,386,249,635,57,692,1196,57.86%,32.27%,1
新北市,土城區,1814,432,319,751,28,779,1308,59.56%,33.03%,1
新北市,土城區,1815,387,244,631,43,674,1175,57.36%,32.94%,1
新北市,土城區,1816,387,266,653,41,694,1230,56.42%,31.46%,1
新北市,土城區,1817,412,328,740,34,774,1342,57.68%,30.7%,1
新北市,土城區,1818,419,291,710,42,752,1268,59.31%,33.04%,1
新北市,土城區,1819,421,292,713,63,776,1227,63.24%,34.31%,1
新北市,土城區,1820,449,267,716,63,779,1356,57.45%,33.11%,1
新北市,土城區,1821,473,323,796,47,843,1496,56.35%,31.62%,1
新北市,土城區,1822,436,252,688,57,745,1309,56.91%,33.31%,1
新北市,土城區,1823,383,277,660,47,707,1175,60.17%,32.6%,1
新北市,土城區,1824,388,271,659,41,700,1237,56.59%,31.37%,1
新北市,土城區,1825,446,243,689,38,727,1256,57.88%,35.51%,1
新北市,土城區,1826,372,274,646,22,668,1228,54.4%,30.29%,1
新北市,土城區,1827,364,261,625,54,679,1182,57.45%,30.8%,1
新北市,土城區,1828,506,331,837,36,873,1558,56.03%,32.48%,1
新北市,土城區,1829,373,269,642,28,670,1160,57.76%,32.16%,1
新北市,土城區,1830,438,299,737,35,772,1357,56.89%,32.28%,1
新北市,土城區,1831,441,316,757,55,812,1464,55.46%,30.12%,1
新北市,土城區,1832,397,273,670,34,704,1335,52.73%,29.74%,1
新北市,土城區,1833,403,284,687,40,727,1346,54.01%,29.94%,1
新北市,土城區,1834,489,348,837,27,864,1435,60.21%,34.08%,1
新北市,土城區,1835,509,351,860,47,907,1639,55.34%,31.06%,1
新北市,土城區,1836,601,368,969,19,988,1728,57.18%,34.78%,1
新北市,土城區,1837,418,348,766,17,783,1665,47.03%,25.11%,1
新北市,土城區,1838,453,323,776,39,815,1333,61.14%,33.98%,1
新北市,土城區,1839,528,371,899,37,936,1567,59.73%,33.69%,1
新北市,土城區,1840,488,329,817,51,868,1576,55.08%,30.96%,1
新北市,土城區,1841,485,308,793,36,829,1458,56.86%,33.26%,1
新北市,土城區,1842,505,316,821,51,872,1517,57.48%,33.29%,1
新北市,土城區,1843,521,327,848,32,880,1489,59.1%,34.99%,1
新北市,土城區,1844,478,364,842,28,870,1463,59.47%,32.67%,1
新北市,土城區,1845,533,347,880,29,909,1584,57.39%,33.65%,1
新北市,土城區,1846,464,309,773,33,806,1464,55.05%,31.69%,1
新北市,土城區,1847,513,342,855,43,898,1598,56.2%,32.1%,1
新北市,土城區,1848,437,329,766,45,811,1500,54.07%,29.13%,1
新北市,土城區,1849,501,314,815,27,842,1542,54.6%,32.49%,1
新北市,土城區,1850,518,393,911,49,960,1619,59.3%,32%,1
新北市,土城區,1851,448,320,768,28,796,1521,52.33%,29.45%,1
新北市,土城區,1852,493,395,888,37,925,1691,54.7%,29.15%,1
新北市,土城區,1853,492,359,851,39,890,1657,53.71%,29.69%,1
新北市,土城區,1854,569,427,996,35,1031,1772,58.18%,32.11%,1
新北市,土城區,1855,576,209,785,22,807,1423,56.71%,40.48%,1
新北市,土城區,1856,468,303,771,40,811,1321,61.39%,35.43%,1
新北市,土城區,1857,499,331,830,46,876,1429,61.3%,34.92%,1
新北市,土城區,1858,435,300,735,45,780,1445,53.98%,30.1%,1
新北市,土城區,1859,566,289,855,36,891,1520,58.62%,37.24%,1
新北市,土城區,1860,405,283,688,16,704,1484,47.44%,27.29%,1
新北市,土城區,1861,408,294,702,26,728,1362,53.45%,29.96%,1
新北市,土城區,1862,414,257,671,27,698,1262,55.31%,32.81%,1
新北市,土城區,1863,458,287,745,30,775,1343,57.71%,34.1%,1
新北市,土城區,1864,359,269,628,28,656,1337,49.07%,26.85%,1
新北市,土城區,1865,349,216,565,26,591,1325,44.6%,26.34%,1
新北市,土城區,1866,397,278,675,35,710,1390,51.08%,28.56%,1
新北市,土城區,1867,456,332,788,44,832,1534,54.24%,29.73%,1
新北市,土城區,1868,438,301,739,51,790,1484,53.23%,29.51%,1
新北市,土城區,1869,487,262,749,43,792,1532,51.7%,31.79%,1
新北市,土城區,1870,476,337,813,42,855,1507,56.74%,31.59%,1
新北市,土城區,1871,523,312,835,37,872,1550,56.26%,33.74%,1
新北市,土城區,1872,527,295,822,42,864,1567,55.14%,33.63%,1
新北市,土城區,1873,453,294,747,38,785,1367,57.43%,33.14%,1
新北市,土城區,1874,368,281,649,49,698,1293,53.98%,28.46%,1
新北市,土城區,1875,424,324,748,41,789,1402,56.28%,30.24%,1
新北市,土城區,1876,414,306,720,42,762,1379,55.26%,30.02%,1
新北市,土城區,1877,458,295,753,30,783,1471,53.23%,31.14%,1
新北市,土城區,1878,440,278,718,28,746,1410,52.91%,31.21%,1
新北市,土城區,1879,463,331,794,40,834,1542,54.09%,30.03%,1
新北市,土城區,1880,361,274,635,48,683,1238,55.17%,29.16%,1
新北市,土城區,1881,408,245,653,51,704,1301,54.11%,31.36%,1
新北市,土城區,1882,493,331,824,19,843,1311,64.3%,37.6%,1
新北市,土城區,1883,401,327,728,36,764,1511,50.56%,26.54%,1
新北市,土城區,1884,447,329,776,42,818,1531,53.43%,29.2%,1
新北市,土城區,1885,472,346,818,47,865,1638,52.81%,28.82%,1
新北市,土城區,1886,446,308,754,34,788,1335,59.03%,33.41%,1
新北市,土城區,1887,470,302,772,36,808,1459,55.38%,32.21%,1
新北市,土城區,1888,448,338,786,23,809,1489,54.33%,30.09%,1
新北市,土城區,1889,720,339,1059,58,1117,1774,62.97%,40.59%,1
新北市,土城區,1890,548,398,946,37,983,1792,54.85%,30.58%,1
新北市,土城區,1891,591,342,933,60,993,1798,55.23%,32.87%,1
新北市,土城區,1892,396,259,655,55,710,1312,54.12%,30.18%,1
新北市,土城區,1893,371,264,635,46,681,1301,52.34%,28.52%,1
新北市,土城區,1894,353,266,619,46,665,1254,53.03%,28.15%,1
新北市,土城區,1895,356,276,632,25,657,1215,54.07%,29.3%,1
新北市,土城區,1896,546,226,772,27,799,1448,55.18%,37.71%,1
新北市,土城區,1897,393,266,659,57,716,1321,54.2%,29.75%,1
新北市,土城區,1898,325,228,553,51,604,1150,52.52%,28.26%,1
新北市,土城區,1899,358,301,659,47,706,1425,49.54%,25.12%,1
新北市,土城區,1900,459,304,763,53,816,1366,59.74%,33.6%,1
新北市,土城區,1901,419,295,714,39,753,1292,58.28%,32.43%,1
新北市,土城區,1902,391,289,680,41,721,1317,54.75%,29.69%,1
新北市,土城區,1903,434,277,711,40,751,1324,56.72%,32.78%,1
新北市,土城區,1904,350,246,596,47,643,1189,54.08%,29.44%,1
新北市,土城區,1905,401,270,671,44,715,1223,58.46%,32.79%,1
新北市,土城區,1906,461,338,799,38,837,1550,54%,29.74%,1
新北市,土城區,1907,509,359,868,53,921,1606,57.35%,31.69%,1
新北市,土城區,1908,465,344,809,30,839,1509,55.6%,30.82%,1
新北市,土城區,1909,466,319,785,48,833,1529,54.48%,30.48%,1
新北市,土城區,1910,418,300,718,52,770,1458,52.81%,28.67%,1
新北市,土城區,1911,435,353,788,48,836,1468,56.95%,29.63%,1
新北市,土城區,1912,449,319,768,35,803,1495,53.71%,30.03%,1
新北市,土城區,1913,421,281,702,48,750,1303,57.56%,32.31%,1
新北市,土城區,1914,429,294,723,47,770,1365,56.41%,31.43%,1
新北市,土城區,1915,442,324,766,54,820,1476,55.56%,29.95%,1
新北市,土城區,1916,490,323,813,29,842,1519,55.43%,32.26%,1
新北市,蘆洲區,0555,463,370,833,54,887,1600,55.44%,28.94%,1
新北市,蘆洲區,0556,481,339,820,46,866,1549,55.91%,31.05%,1
新北市,蘆洲區,0557,508,337,845,50,895,1516,59.04%,33.51%,1
新北市,蘆洲區,0558,458,276,734,42,776,1404,55.27%,32.62%,1
新北市,蘆洲區,0559,411,288,699,63,762,1381,55.18%,29.76%,1
新北市,蘆洲區,0560,497,310,807,35,842,1485,56.7%,33.47%,1
新北市,蘆洲區,0561,396,250,646,37,683,1779,38.39%,22.26%,1
新北市,蘆洲區,0562,555,367,922,37,959,1797,53.37%,30.88%,1
新北市,蘆洲區,0563,440,297,737,52,789,1364,57.84%,32.26%,1
新北市,蘆洲區,0564,529,345,874,44,918,1635,56.15%,32.35%,1
新北市,蘆洲區,0565,428,304,732,30,762,1567,48.63%,27.31%,1
新北市,蘆洲區,0566,476,300,776,36,812,1524,53.28%,31.23%,1
新北市,蘆洲區,0567,489,301,790,45,835,1612,51.8%,30.33%,1
新北市,蘆洲區,0568,499,343,842,27,869,1674,51.91%,29.81%,1
新北市,蘆洲區,0569,471,396,867,41,908,1838,49.4%,25.63%,1
新北市,蘆洲區,0570,486,316,802,28,830,1814,45.76%,26.79%,1
新北市,蘆洲區,0571,435,362,797,41,838,1473,56.89%,29.53%,1
新北市,蘆洲區,0572,441,316,757,38,795,1465,54.27%,30.1%,1
新北市,蘆洲區,0573,505,402,907,42,949,1652,57.45%,30.57%,1
新北市,蘆洲區,0574,485,374,859,59,918,1650,55.64%,29.39%,1
新北市,蘆洲區,0575,514,363,877,40,917,1656,55.37%,31.04%,1
新北市,蘆洲區,0576,423,366,789,35,824,1571,52.45%,26.93%,1
新北市,蘆洲區,0577,435,348,783,39,822,1523,53.97%,28.56%,1
新北市,蘆洲區,0578,470,289,759,42,801,1475,54.31%,31.86%,1
新北市,蘆洲區,0579,377,317,694,41,735,1367,53.77%,27.58%,1
新北市,蘆洲區,0580,482,338,820,42,862,1514,56.94%,31.84%,1
新北市,蘆洲區,0581,592,428,1020,37,1057,1791,59.02%,33.05%,1
新北市,蘆洲區,0582,520,494,1014,27,1041,1714,60.74%,30.34%,1
新北市,蘆洲區,0583,604,378,982,32,1014,1780,56.97%,33.93%,1
新北市,蘆洲區,0584,546,397,943,27,970,1713,56.63%,31.87%,1
新北市,蘆洲區,0585,582,377,959,27,986,1720,57.33%,33.84%,1
新北市,蘆洲區,0586,576,367,943,32,975,1766,55.21%,32.62%,1
新北市,蘆洲區,0587,522,331,853,35,888,1623,54.71%,32.16%,1
新北市,蘆洲區,0588,503,407,910,48,958,1740,55.06%,28.91%,1
新北市,蘆洲區,0589,586,390,976,44,1020,1759,57.99%,33.31%,1
新北市,蘆洲區,0590,564,410,974,57,1031,1775,58.08%,31.77%,1
新北市,蘆洲區,0591,609,449,1058,35,1093,1909,57.26%,31.9%,1
新北市,蘆洲區,0592,564,429,993,57,1050,1805,58.17%,31.25%,1
新北市,蘆洲區,0593,499,352,851,24,875,1642,53.29%,30.39%,1
新北市,蘆洲區,0594,492,377,869,48,917,1713,53.53%,28.72%,1
新北市,蘆洲區,0595,482,352,834,59,893,1746,51.15%,27.61%,1
新北市,蘆洲區,0596,497,335,832,45,877,1596,54.95%,31.14%,1
新北市,蘆洲區,0597,404,325,729,39,768,1434,53.56%,28.17%,1
新北市,蘆洲區,0598,438,336,774,37,811,1450,55.93%,30.21%,1
新北市,蘆洲區,0599,457,324,781,16,797,1543,51.65%,29.62%,1
新北市,蘆洲區,0600,441,358,799,29,828,1525,54.3%,28.92%,1
新北市,蘆洲區,0601,403,310,713,42,755,1419,53.21%,28.4%,1
新北市,蘆洲區,0602,390,316,706,34,740,1298,57.01%,30.05%,1
新北市,蘆洲區,0603,401,261,662,50,712,1304,54.6%,30.75%,1
新北市,蘆洲區,0604,539,381,920,45,965,1806,53.43%,29.84%,1
新北市,蘆洲區,0605,542,391,933,60,993,1910,51.99%,28.38%,1
新北市,蘆洲區,0606,475,339,814,34,848,1873,45.27%,25.36%,1
新北市,蘆洲區,0607,468,354,822,36,858,1785,48.07%,26.22%,1
新北市,蘆洲區,0608,501,341,842,49,891,1760,50.63%,28.47%,1
新北市,蘆洲區,0609,569,399,968,54,1022,1841,55.51%,30.91%,1
新北市,蘆洲區,0610,548,374,922,43,965,1855,52.02%,29.54%,1
新北市,蘆洲區,0611,390,293,683,52,735,1450,50.69%,26.9%,1
新北市,蘆洲區,0612,448,336,784,53,837,1585,52.81%,28.26%,1
新北市,蘆洲區,0613,416,290,706,82,788,1541,51.14%,27%,1
新北市,蘆洲區,0614,487,329,816,47,863,1626,53.08%,29.95%,1
新北市,蘆洲區,0615,352,323,675,42,717,1241,57.78%,28.36%,1
新北市,蘆洲區,0616,492,360,852,40,892,1634,54.59%,30.11%,1
新北市,蘆洲區,0617,497,331,828,46,874,1573,55.56%,31.6%,1
新北市,蘆洲區,0618,479,385,864,44,908,1619,56.08%,29.59%,1
新北市,蘆洲區,0619,559,395,954,68,1022,1878,54.42%,29.77%,1
新北市,蘆洲區,0620,535,380,915,50,965,1797,53.7%,29.77%,1
新北市,蘆洲區,0621,665,302,967,36,1003,1816,55.23%,36.62%,1
新北市,蘆洲區,0622,415,316,731,66,797,1344,59.3%,30.88%,1
新北市,蘆洲區,0623,508,337,845,42,887,1492,59.45%,34.05%,1
新北市,蘆洲區,0624,605,373,978,73,1051,1959,53.65%,30.88%,1
新北市,蘆洲區,0625,472,345,817,67,884,1611,54.87%,29.3%,1
新北市,蘆洲區,0626,500,375,875,37,912,1574,57.94%,31.77%,1
新北市,蘆洲區,0627,515,374,889,38,927,1653,56.08%,31.16%,1
新北市,蘆洲區,0628,555,455,1010,52,1062,3085,34.42%,17.99%,1
新北市,蘆洲區,0629,508,411,919,51,970,1812,53.53%,28.04%,1
新北市,蘆洲區,0630,415,277,692,43,735,1332,55.18%,31.16%,1
新北市,蘆洲區,0631,436,329,765,50,815,1648,49.45%,26.46%,1
新北市,蘆洲區,0632,397,290,687,28,715,1355,52.77%,29.3%,1
新北市,蘆洲區,0633,412,296,708,29,737,1371,53.76%,30.05%,1
新北市,蘆洲區,0634,350,247,597,43,640,1111,57.61%,31.5%,1
新北市,蘆洲區,0635,361,259,620,76,696,1176,59.18%,30.7%,1
新北市,蘆洲區,0636,469,384,853,42,895,1602,55.87%,29.28%,1
新北市,蘆洲區,0637,367,291,658,35,693,1361,50.92%,26.97%,1
新北市,蘆洲區,0638,460,320,780,52,832,1530,54.38%,30.07%,1
新北市,蘆洲區,0639,286,180,466,62,528,925,57.08%,30.92%,1
新北市,蘆洲區,0640,580,372,952,48,1000,1851,54.02%,31.33%,1
新北市,蘆洲區,0641,488,344,832,50,882,1791,49.25%,27.25%,1
新北市,蘆洲區,0642,497,378,875,51,926,1853,49.97%,26.82%,1
新北市,蘆洲區,0643,466,366,832,37,869,1758,49.43%,26.51%,1
新北市,蘆洲區,0644,504,402,906,62,968,1798,53.84%,28.03%,1
新北市,蘆洲區,0645,506,356,862,45,907,1645,55.14%,30.76%,1
新北市,蘆洲區,0646,443,323,766,30,796,1612,49.38%,27.48%,1
新北市,蘆洲區,0647,456,374,830,44,874,1784,48.99%,25.56%,1
新北市,蘆洲區,0648,445,302,747,46,793,1701,46.62%,26.16%,1
新北市,蘆洲區,0649,476,309,785,34,819,1581,51.8%,30.11%,1
新北市,蘆洲區,0650,441,363,804,41,845,1534,55.08%,28.75%,1
新北市,蘆洲區,0651,506,377,883,52,935,1620,57.72%,31.23%,1
新北市,蘆洲區,0652,504,339,843,47,890,1494,59.57%,33.73%,1
新北市,蘆洲區,0653,353,281,634,26,660,1183,55.79%,29.84%,1
新北市,蘆洲區,0654,318,219,537,36,573,985,58.17%,32.28%,1
新北市,蘆洲區,0655,509,310,819,57,876,1673,52.36%,30.42%,1
新北市,蘆洲區,0656,513,372,885,65,950,1688,56.28%,30.39%,1
新北市,蘆洲區,0657,368,279,647,36,683,1249,54.68%,29.46%,1
新北市,蘆洲區,0658,410,312,722,54,776,1476,52.57%,27.78%,1
新北市,五股區,0207,417,321,738,63,801,1456,55.01%,28.64%,1
新北市,五股區,0208,438,302,740,46,786,1482,53.04%,29.55%,1
新北市,五股區,0209,394,288,682,45,727,1287,56.49%,30.61%,1
新北市,五股區,0210,311,251,562,25,587,1106,53.07%,28.12%,1
新北市,五股區,0211,375,249,624,55,679,1283,52.92%,29.23%,1
新北市,五股區,0212,545,399,944,37,981,1833,53.52%,29.73%,1
新北市,五股區,0213,339,285,624,33,657,1141,57.58%,29.71%,1
新北市,五股區,0214,140,109,249,36,285,463,61.56%,30.24%,1
新北市,五股區,0215,556,374,930,49,979,1786,54.82%,31.13%,1
新北市,五股區,0216,438,382,820,41,861,1660,51.87%,26.39%,1
新北市,五股區,0217,462,327,789,57,846,1534,55.15%,30.12%,1
新北市,五股區,0218,437,263,700,44,744,1285,57.9%,34.01%,1
新北市,五股區,0219,551,343,894,79,973,1832,53.11%,30.08%,1
新北市,五股區,0220,460,327,787,42,829,1542,53.76%,29.83%,1
新北市,五股區,0221,503,354,857,40,897,1897,47.29%,26.52%,1
新北市,五股區,0222,537,352,889,74,963,1964,49.03%,27.34%,1
新北市,五股區,0223,472,358,830,55,885,1779,49.75%,26.53%,1
新北市,五股區,0224,503,341,844,70,914,1735,52.68%,28.99%,1
新北市,五股區,0225,620,467,1087,40,1127,2299,49.02%,26.97%,1
新北市,五股區,0226,534,291,825,44,869,1755,49.52%,30.43%,1
新北市,五股區,0227,540,334,874,46,920,1674,54.96%,32.26%,1
新北市,五股區,0228,536,335,871,50,921,1661,55.45%,32.27%,1
新北市,五股區,0229,337,266,603,35,638,1281,49.8%,26.31%,1
新北市,五股區,0230,503,309,812,39,851,1566,54.34%,32.12%,1
新北市,五股區,0231,493,270,763,27,790,1560,50.64%,31.6%,1
新北市,五股區,0232,542,309,851,35,886,1622,54.62%,33.42%,1
新北市,五股區,0233,576,357,933,31,964,1779,54.19%,32.38%,1
新北市,五股區,0234,480,261,741,44,785,1487,52.79%,32.28%,1
新北市,五股區,0235,490,333,823,37,860,1567,54.88%,31.27%,1
新北市,五股區,0236,301,210,511,27,538,1333,40.36%,22.58%,1
新北市,五股區,0237,443,282,725,37,762,1263,60.33%,35.08%,1
新北市,五股區,0238,449,268,717,46,763,1314,58.07%,34.17%,1
新北市,五股區,0239,455,304,759,32,791,1513,52.28%,30.07%,1
新北市,五股區,0240,526,304,830,32,862,1517,56.82%,34.67%,1
新北市,五股區,0241,492,326,818,57,875,1613,54.25%,30.5%,1
新北市,五股區,0242,488,337,825,49,874,1616,54.08%,30.2%,1
新北市,五股區,0243,445,364,809,58,867,1616,53.65%,27.54%,1
新北市,五股區,0244,532,333,865,54,919,1689,54.41%,31.5%,1
新北市,五股區,0245,549,403,952,32,984,1894,51.95%,28.99%,1
新北市,五股區,0246,437,286,723,40,763,1210,63.06%,36.12%,1
新北市,五股區,0247,497,327,824,29,853,1643,51.92%,30.25%,1
新北市,五股區,0248,439,304,743,28,771,1441,53.5%,30.46%,1
新北市,五股區,0249,459,272,731,22,753,1305,57.7%,35.17%,1
新北市,五股區,0250,404,281,685,38,723,1170,61.79%,34.53%,1
新北市,五股區,0251,489,298,787,67,854,1397,61.13%,35%,1
新北市,五股區,0252,505,251,756,55,811,1312,61.81%,38.49%,1
新北市,五股區,0253,381,168,549,23,572,1127,50.75%,33.81%,1
新北市,五股區,0254,390,190,580,22,602,1154,52.17%,33.8%,1
新北市,泰山區,0255,179,123,302,23,325,643,50.54%,27.84%,1
新北市,泰山區,0256,70,41,111,4,115,186,61.83%,37.63%,1
新北市,泰山區,0257,425,288,713,28,741,1457,50.86%,29.17%,1
新北市,泰山區,0258,529,312,841,50,891,1594,55.9%,33.19%,1
新北市,泰山區,0259,482,293,775,33,808,1598,50.56%,30.16%,1
新北市,泰山區,0260,429,324,753,21,774,1503,51.5%,28.54%,1
新北市,泰山區,0261,422,263,685,63,748,1436,52.09%,29.39%,1
新北市,泰山區,0262,427,297,724,44,768,1384,55.49%,30.85%,1
新北市,泰山區,0263,425,240,665,37,702,1231,57.03%,34.52%,1
新北市,泰山區,0264,410,242,652,32,684,1295,52.82%,31.66%,1
新北市,泰山區,0265,502,356,858,41,899,1563,57.52%,32.12%,1
新北市,泰山區,0266,533,352,885,48,933,1610,57.95%,33.11%,1
新北市,泰山區,0267,375,271,646,30,676,1253,53.95%,29.93%,1
新北市,泰山區,0268,388,250,638,29,667,1294,51.55%,29.98%,1
新北市,泰山區,0269,408,334,742,48,790,1354,58.35%,30.13%,1
新北市,泰山區,0270,389,276,665,31,696,1259,55.28%,30.9%,1
新北市,泰山區,0271,399,298,697,22,719,1252,57.43%,31.87%,1
新北市,泰山區,0272,353,220,573,24,597,1094,54.57%,32.27%,1
新北市,泰山區,0273,527,337,864,30,894,1590,56.23%,33.14%,1
新北市,泰山區,0274,497,369,866,49,915,1634,56%,30.42%,1
新北市,泰山區,0275,418,284,702,27,729,1536,47.46%,27.21%,1
新北市,泰山區,0276,522,337,859,24,883,1534,57.56%,34.03%,1
新北市,泰山區,0277,576,333,909,43,952,1545,61.62%,37.28%,1
新北市,泰山區,0278,449,298,747,36,783,1399,55.97%,32.09%,1
新北市,泰山區,0279,434,258,692,22,714,1315,54.3%,33%,1
新北市,泰山區,0280,415,283,698,38,736,1201,61.28%,34.55%,1
新北市,泰山區,0281,358,263,621,43,664,1182,56.18%,30.29%,1
新北市,泰山區,0282,491,337,828,58,886,1665,53.21%,29.49%,1
新北市,泰山區,0283,587,373,960,49,1009,1855,54.39%,31.64%,1
新北市,泰山區,0284,605,367,972,59,1031,1866,55.25%,32.42%,1
新北市,泰山區,0285,591,398,989,45,1034,1935,53.44%,30.54%,1
新北市,泰山區,0286,490,304,794,26,820,1589,51.6%,30.84%,1
新北市,泰山區,0287,362,239,601,27,628,1152,54.51%,31.42%,1
新北市,泰山區,0288,341,257,598,29,627,1114,56.28%,30.61%,1
新北市,泰山區,0289,388,235,623,26,649,1040,62.4%,37.31%,1
新北市,泰山區,0290,338,237,575,28,603,1003,60.12%,33.7%,1
新北市,泰山區,0291,301,271,572,23,595,975,61.03%,30.87%,1
新北市,泰山區,0292,440,299,739,48,787,1440,54.65%,30.56%,1
新北市,泰山區,0293,490,300,790,7,797,1480,53.85%,33.11%,1
新北市,泰山區,0294,409,252,661,28,689,1211,56.9%,33.77%,1
新北市,泰山區,0295,439,246,685,24,709,1237,57.32%,35.49%,1
新北市,泰山區,0296,359,221,580,27,607,1069,56.78%,33.58%,1
新北市,泰山區,0297,538,407,945,50,995,1680,59.23%,32.02%,1
新北市,泰山區,0298,533,377,910,31,941,1651,57%,32.28%,1
新北市,泰山區,0299,432,282,714,28,742,1420,52.25%,30.42%,1
新北市,泰山區,0300,427,324,751,36,787,1337,58.86%,31.94%,1
新北市,泰山區,0301,521,345,866,33,899,1591,56.51%,32.75%,1
新北市,林口區,0145,383,289,672,13,685,1268,54.02%,30.21%,1
新北市,林口區,0146,314,254,568,39,607,1171,51.84%,26.81%,1
新北市,林口區,0147,373,273,646,45,691,1218,56.73%,30.62%,1
新北市,林口區,0148,494,382,876,44,920,1788,51.45%,27.63%,1
新北市,林口區,0149,449,366,815,47,862,1625,53.05%,27.63%,1
新北市,林口區,0150,383,309,692,67,759,1448,52.42%,26.45%,1
新北市,林口區,0151,384,248,632,54,686,1328,51.66%,28.92%,1
新北市,林口區,0152,392,270,662,45,707,1523,46.42%,25.74%,1
新北市,林口區,0153,395,256,651,34,685,1245,55.02%,31.73%,1
新北市,林口區,0154,499,301,800,28,828,1329,62.3%,37.55%,1
新北市,林口區,0155,496,322,818,39,857,1465,58.5%,33.86%,1
新北市,林口區,0156,450,334,784,23,807,1369,58.95%,32.87%,1
新北市,林口區,0157,432,311,743,47,790,1346,58.69%,32.1%,1
新北市,林口區,0158,356,241,597,53,650,1181,55.04%,30.14%,1
新北市,林口區,0159,449,323,772,30,802,1291,62.12%,34.78%,1
新北市,林口區,0160,379,254,633,42,675,1213,55.65%,31.24%,1
新北市,林口區,0161,430,279,709,27,736,1256,58.6%,34.24%,1
新北市,林口區,0162,333,281,614,36,650,1185,54.85%,28.1%,1
新北市,林口區,0163,421,298,719,43,762,1361,55.99%,30.93%,1
新北市,林口區,0164,524,347,871,31,902,1756,51.37%,29.84%,1
新北市,林口區,0165,488,349,837,30,867,1676,51.73%,29.12%,1
新北市,林口區,0166,539,314,853,23,876,1540,56.88%,35%,1
新北市,林口區,0167,482,331,813,38,851,1569,54.24%,30.72%,1
新北市,林口區,0168,527,277,804,33,837,1514,55.28%,34.81%,1
新北市,林口區,0169,381,289,670,22,692,1193,58.01%,31.94%,1
新北市,林口區,0170,574,354,928,18,946,1610,58.76%,35.65%,1
新北市,林口區,0171,463,285,748,29,777,1338,58.07%,34.6%,1
新北市,林口區,0172,392,243,635,27,662,1141,58.02%,34.36%,1
新北市,林口區,0173,419,287,706,34,740,1307,56.62%,32.06%,1
新北市,林口區,0174,456,286,742,22,764,1327,57.57%,34.36%,1
新北市,林口區,0175,417,300,717,25,742,1285,57.74%,32.45%,1
新北市,林口區,0176,456,349,805,38,843,1481,56.92%,30.79%,1
新北市,林口區,0177,483,359,842,24,866,1510,57.35%,31.99%,1
新北市,林口區,0178,558,361,919,34,953,1785,53.39%,31.26%,1
新北市,林口區,0179,593,358,951,25,976,1792,54.46%,33.09%,1
新北市,林口區,0180,518,318,836,25,861,1517,56.76%,34.15%,1
新北市,林口區,0181,544,332,876,20,896,1564,57.29%,34.78%,1
新北市,林口區,0182,549,313,862,31,893,1560,57.24%,35.19%,1
新北市,林口區,0183,482,325,807,32,839,1544,54.34%,31.22%,1
新北市,林口區,0184,502,336,838,23,861,1593,54.05%,31.51%,1
新北市,林口區,0185,491,287,778,26,804,1431,56.18%,34.31%,1
新北市,林口區,0186,490,320,810,33,843,1571,53.66%,31.19%,1
新北市,林口區,0187,459,349,808,23,831,1439,57.75%,31.9%,1
新北市,林口區,0188,478,329,807,34,841,1451,57.96%,32.94%,1
新北市,林口區,0189,457,355,812,29,841,1391,60.46%,32.85%,1
新北市,林口區,0190,464,314,778,37,815,1461,55.78%,31.76%,1
新北市,林口區,0191,515,382,897,22,919,1691,54.35%,30.46%,1
新北市,林口區,0192,538,273,811,38,849,1524,55.71%,35.3%,1
新北市,林口區,0193,497,316,813,27,840,1343,62.55%,37.01%,1
新北市,林口區,0194,477,333,810,30,840,1398,60.09%,34.12%,1
新北市,林口區,0195,488,298,786,29,815,1380,59.06%,35.36%,1
新北市,林口區,0196,428,296,724,47,771,1367,56.4%,31.31%,1
新北市,林口區,0197,428,313,741,37,778,1350,57.63%,31.7%,1
新北市,林口區,0198,398,273,671,33,704,1194,58.96%,33.33%,1
新北市,林口區,0199,398,290,688,49,737,1344,54.84%,29.61%,1
新北市,林口區,0200,363,260,623,31,654,1154,56.67%,31.46%,1
新北市,林口區,0201,389,283,672,25,697,1119,62.29%,34.76%,1
新北市,林口區,0202,264,207,471,34,505,1026,49.22%,25.73%,1
新北市,林口區,0203,339,280,619,58,677,1210,55.95%,28.02%,1
新北市,林口區,0204,256,198,454,63,517,912,56.69%,28.07%,1
新北市,林口區,0205,230,221,451,32,483,824,58.62%,27.91%,1
新北市,林口區,0206,440,324,764,69,833,1411,59.04%,31.18%,1
新北市,深坑區,2163,231,342,573,34,607,1142,53.15%,20.23%,1
新北市,深坑區,2164,367,270,637,40,677,1139,59.44%,32.22%,1
新北市,深坑區,2165,303,229,532,44,576,1065,54.08%,28.45%,1
新北市,深坑區,2166,390,287,677,42,719,1400,51.36%,27.86%,1
新北市,深坑區,2167,350,289,639,49,688,1330,51.73%,26.32%,1
新北市,深坑區,2168,503,265,768,32,800,1380,57.97%,36.45%,1
新北市,深坑區,2169,411,289,700,20,720,1496,48.13%,27.47%,1
新北市,深坑區,2170,468,329,797,48,845,1508,56.03%,31.03%,1
新北市,深坑區,2171,528,356,884,48,932,1624,57.39%,32.51%,1
新北市,深坑區,2172,690,432,1122,51,1173,2165,54.18%,31.87%,1
新北市,深坑區,2173,609,406,1015,43,1058,1790,59.11%,34.02%,1
新北市,深坑區,2174,235,156,391,19,410,782,52.43%,30.05%,1
新北市,深坑區,2175,407,239,646,38,684,1164,58.76%,34.97%,1
新北市,深坑區,2176,489,271,760,45,805,1344,59.9%,36.38%,1
新北市,深坑區,2177,247,180,427,27,454,739,61.43%,33.42%,1
新北市,深坑區,2178,171,143,314,27,341,556,61.33%,30.76%,1
新北市,石碇區,2179,120,105,225,22,247,391,63.17%,30.69%,1
新北市,石碇區,2180,206,157,363,42,405,789,51.33%,26.11%,1
新北市,石碇區,2181,149,105,254,22,276,662,41.69%,22.51%,1
新北市,石碇區,2182,89,58,147,14,161,310,51.94%,28.71%,1
新北市,石碇區,2183,81,59,140,10,150,280,53.57%,28.93%,1
新北市,石碇區,2184,21,12,33,5,38,93,40.86%,22.58%,1
新北市,石碇區,2185,145,128,273,36,309,683,45.24%,21.23%,1
新北市,石碇區,2186,117,80,197,11,208,323,64.4%,36.22%,1
新北市,石碇區,2187,187,93,280,14,294,726,40.5%,25.76%,1
新北市,石碇區,2188,160,133,293,22,315,591,53.3%,27.07%,1
新北市,石碇區,2189,105,60,165,26,191,282,67.73%,37.23%,1
新北市,石碇區,2190,219,144,363,12,375,788,47.59%,27.79%,1
新北市,石碇區,2191,296,225,521,37,558,943,59.17%,31.39%,1
新北市,坪林區,2192,399,239,638,34,672,1248,53.85%,31.97%,1
新北市,坪林區,2193,154,106,260,32,292,612,47.71%,25.16%,1
新北市,坪林區,2194,376,223,599,54,653,1141,57.23%,32.95%,1
新北市,坪林區,2195,100,73,173,9,182,417,43.65%,23.98%,1
新北市,坪林區,2196,165,131,296,36,332,595,55.8%,27.73%,1
新北市,坪林區,2197,84,49,133,21,154,248,62.1%,33.87%,1
新北市,坪林區,2198,94,64,158,9,167,338,49.41%,27.81%,1
新北市,坪林區,2199,126,76,202,11,213,478,44.56%,26.36%,1
新北市,坪林區,2200,93,55,148,11,159,390,40.77%,23.85%,1
新北市,坪林區,2201,123,73,196,13,209,424,49.29%,29.01%,1
新北市,三芝區,0011,88,48,136,15,151,312,48.4%,28.21%,1
新北市,三芝區,0012,405,282,687,30,717,1421,50.46%,28.5%,1
新北市,三芝區,0013,445,316,761,41,802,1557,51.51%,28.58%,1
新北市,三芝區,0014,526,346,872,69,941,1828,51.48%,28.77%,1
新北市,三芝區,0015,280,217,497,44,541,1060,51.04%,26.42%,1
新北市,三芝區,0016,189,135,324,33,357,819,43.59%,23.08%,1
新北市,三芝區,0017,410,279,689,40,729,1701,42.86%,24.1%,1
新北市,三芝區,0018,442,345,787,53,840,1740,48.28%,25.4%,1
新北市,三芝區,0019,385,263,648,32,680,1451,46.86%,26.53%,1
新北市,三芝區,0020,328,196,524,52,576,1248,46.15%,26.28%,1
新北市,三芝區,0021,174,142,316,16,332,629,52.78%,27.66%,1
新北市,三芝區,0022,139,77,216,18,234,504,46.43%,27.58%,1
新北市,三芝區,0023,183,129,312,15,327,698,46.85%,26.22%,1
新北市,三芝區,0024,571,355,926,54,980,2069,47.37%,27.6%,1
新北市,三芝區,0025,218,169,387,32,419,784,53.44%,27.81%,1
新北市,三芝區,0026,120,123,243,23,266,522,50.96%,22.99%,1
新北市,三芝區,0027,162,99,261,47,308,587,52.47%,27.6%,1
新北市,三芝區,0028,319,266,585,39,624,1189,52.48%,26.83%,1
新北市,石門區,0001,290,266,556,32,588,1121,52.45%,25.87%,1
新北市,石門區,0002,374,263,637,37,674,1389,48.52%,26.93%,1
新北市,石門區,0003,282,149,431,57,488,933,52.3%,30.23%,1
新北市,石門區,0004,355,199,554,65,619,1244,49.76%,28.54%,1
新北市,石門區,0005,255,177,432,55,487,883,55.15%,28.88%,1
新北市,石門區,0006,441,355,796,51,847,1564,54.16%,28.2%,1
新北市,石門區,0007,446,310,756,43,799,1500,53.27%,29.73%,1
新北市,石門區,0008,73,67,140,11,151,328,46.04%,22.26%,1
新北市,石門區,0009,232,138,370,33,403,651,61.9%,35.64%,1
新北市,石門區,0010,207,168,375,36,411,915,44.92%,22.62%,1
新北市,八里區,0125,408,302,710,43,753,1498,50.27%,27.24%,1
新北市,八里區,0126,546,325,871,27,898,1939,46.31%,28.16%,1
新北市,八里區,0127,490,288,778,29,807,1516,53.23%,32.32%,1
新北市,八里區,0128,552,336,888,54,942,1642,57.37%,33.62%,1
新北市,八里區,0129,502,384,886,58,944,1927,48.99%,26.05%,1
新北市,八里區,0130,406,246,652,40,692,1276,54.23%,31.82%,1
新北市,八里區,0131,442,310,752,41,793,1349,58.78%,32.77%,1
新北市,八里區,0132,451,303,754,36,790,1403,56.31%,32.15%,1
新北市,八里區,0133,502,346,848,41,889,1644,54.08%,30.54%,1
新北市,八里區,0134,550,402,952,53,1005,1853,54.24%,29.68%,1
新北市,八里區,0135,587,409,996,53,1049,1793,58.51%,32.74%,1
新北市,八里區,0136,487,358,845,40,885,1644,53.83%,29.62%,1
新北市,八里區,0137,535,388,923,43,966,1846,52.33%,28.98%,1
新北市,八里區,0138,383,295,678,44,722,1346,53.64%,28.45%,1
新北市,八里區,0139,479,356,835,40,875,1621,53.98%,29.55%,1
新北市,八里區,0140,541,345,886,56,942,2110,44.64%,25.64%,1
新北市,八里區,0141,412,540,952,57,1009,1967,51.3%,20.95%,1
新北市,八里區,0142,477,365,842,55,897,1626,55.17%,29.34%,1
新北市,八里區,0143,417,350,767,67,834,1514,55.09%,27.54%,1
新北市,八里區,0144,432,330,762,75,837,1456,57.49%,29.67%,1
新北市,平溪區,2208,121,55,176,20,196,384,51.04%,31.51%,1
新北市,平溪區,2209,60,39,99,3,102,232,43.97%,25.86%,1
新北市,平溪區,2210,77,55,132,10,142,249,57.03%,30.92%,1
新北市,平溪區,2211,131,94,225,30,255,458,55.68%,28.6%,1
新北市,平溪區,2212,76,37,113,15,128,232,55.17%,32.76%,1
新北市,平溪區,2213,165,86,251,16,267,635,42.05%,25.98%,1
新北市,平溪區,2214,131,77,208,39,247,427,57.85%,30.68%,1
新北市,平溪區,2215,222,133,355,29,384,862,44.55%,25.75%,1
新北市,平溪區,2216,50,22,72,2,74,147,50.34%,34.01%,1
新北市,平溪區,2217,82,51,133,11,144,365,39.45%,22.47%,1
新北市,平溪區,2218,37,25,62,8,70,153,45.75%,24.18%,1
新北市,平溪區,2219,66,29,95,14,109,177,61.58%,37.29%,1
新北市,雙溪區,2266,134,68,202,15,217,455,47.69%,29.45%,1
新北市,雙溪區,2267,87,57,144,5,149,286,52.1%,30.42%,1
新北市,雙溪區,2268,154,101,255,21,276,496,55.65%,31.05%,1
新北市,雙溪區,2269,99,58,157,12,169,383,44.13%,25.85%,1
新北市,雙溪區,2270,219,140,359,25,384,887,43.29%,24.69%,1
新北市,雙溪區,2271,147,109,256,26,282,652,43.25%,22.55%,1
新北市,雙溪區,2272,89,64,153,16,169,333,50.75%,26.73%,1
新北市,雙溪區,2273,157,140,297,25,322,642,50.16%,24.45%,1
新北市,雙溪區,2274,57,70,127,11,138,282,48.94%,20.21%,1
新北市,雙溪區,2275,142,103,245,28,273,621,43.96%,22.87%,1
新北市,雙溪區,2276,90,67,157,14,171,422,40.52%,21.33%,1
新北市,雙溪區,2277,76,42,118,18,136,369,36.86%,20.6%,1
新北市,雙溪區,2278,26,35,61,4,65,120,54.17%,21.67%,1
新北市,雙溪區,2279,71,54,125,9,134,271,49.45%,26.2%,1
新北市,雙溪區,2280,98,94,192,21,213,362,58.84%,27.07%,1
新北市,雙溪區,2281,100,67,167,26,193,371,52.02%,26.95%,1
新北市,雙溪區,2282,376,207,583,35,618,1047,59.03%,35.91%,1
新北市,貢寮區,2283,232,166,398,41,439,876,50.11%,26.48%,1
新北市,貢寮區,2284,111,87,198,23,221,433,51.04%,25.64%,1
新北市,貢寮區,2285,126,82,208,19,227,516,43.99%,24.42%,1
新北市,貢寮區,2286,67,54,121,32,153,373,41.02%,17.96%,1
新北市,貢寮區,2287,72,54,126,24,150,313,47.92%,23%,1
新北市,貢寮區,2288,137,95,232,10,242,485,49.9%,28.25%,1
新北市,貢寮區,2289,98,91,189,22,211,415,50.84%,23.61%,1
新北市,貢寮區,2290,197,124,321,33,354,812,43.6%,24.26%,1
新北市,貢寮區,2291,207,167,374,43,417,861,48.43%,24.04%,1
新北市,貢寮區,2292,120,121,241,31,272,676,40.24%,17.75%,1
新北市,貢寮區,2293,232,172,404,21,425,1091,38.96%,21.26%,1
新北市,貢寮區,2294,223,119,342,49,391,955,40.94%,23.35%,1
新北市,貢寮區,2295,188,117,305,13,318,769,41.35%,24.45%,1
新北市,貢寮區,2296,219,213,432,37,469,962,48.75%,22.77%,1
新北市,貢寮區,2297,111,89,200,8,208,390,53.33%,28.46%,1
新北市,貢寮區,2298,95,61,156,5,161,349,46.13%,27.22%,1
新北市,貢寮區,2299,120,64,184,29,213,508,41.93%,23.62%,1
新北市,貢寮區,2300,94,63,157,12,169,495,34.14%,18.99%,1
新北市,金山區,2301,150,89,239,23,262,481,54.47%,31.19%,1
新北市,金山區,2302,207,140,347,33,380,715,53.15%,28.95%,1
新北市,金山區,2303,122,70,192,22,214,481,44.49%,25.36%,1
新北市,金山區,2304,496,297,793,50,843,1792,47.04%,27.68%,1
新北市,金山區,2305,511,336,847,66,913,1781,51.26%,28.69%,1
新北市,金山區,2306,550,462,1012,60,1072,2010,53.33%,27.36%,1
新北市,金山區,2307,434,279,713,58,771,1572,49.05%,27.61%,1
新北市,金山區,2308,447,400,847,63,910,1777,51.21%,25.15%,1
新北市,金山區,2309,426,288,714,59,773,1631,47.39%,26.12%,1
新北市,金山區,2310,239,169,408,28,436,828,52.66%,28.86%,1
新北市,金山區,2311,258,178,436,36,472,888,53.15%,29.05%,1
新北市,金山區,2312,350,201,551,61,612,1211,50.54%,28.9%,1
新北市,金山區,2313,126,95,221,18,239,416,57.45%,30.29%,1
新北市,金山區,2314,200,161,361,37,398,682,58.36%,29.33%,1
新北市,金山區,2315,186,130,316,33,349,644,54.19%,28.88%,1
新北市,金山區,2316,245,129,374,36,410,830,49.4%,29.52%,1
新北市,金山區,2317,43,42,85,15,100,188,53.19%,22.87%,1
新北市,金山區,2318,133,108,241,21,262,469,55.86%,28.36%,1
新北市,金山區,2319,105,79,184,34,218,582,37.46%,18.04%,1
新北市,萬里區,2320,408,242,650,49,699,1286,54.35%,31.73%,1
新北市,萬里區,2321,498,326,824,37,861,1576,54.63%,31.6%,1
新北市,萬里區,2322,403,263,666,40,706,1447,48.79%,27.85%,1
新北市,萬里區,2323,385,238,623,48,671,1466,45.77%,26.26%,1
新北市,萬里區,2324,351,202,553,36,589,1369,43.02%,25.64%,1
新北市,萬里區,2325,269,163,432,45,477,1215,39.26%,22.14%,1
新北市,萬里區,2326,407,241,648,43,691,1317,52.47%,30.9%,1
新北市,萬里區,2327,445,263,708,46,754,1676,44.99%,26.55%,1
新北市,萬里區,2328,388,273,661,78,739,1550,47.68%,25.03%,1
新北市,萬里區,2329,303,239,542,50,592,945,62.65%,32.06%,1
新北市,萬里區,2330,533,355,888,72,960,1760,54.55%,30.28%,1
新北市,萬里區,2331,166,98,264,26,290,570,50.88%,29.12%,1
新北市,萬里區,2332,251,196,447,29,476,952,50%,26.37%,1
新北市,萬里區,2333,205,144,349,47,396,674,58.75%,30.42%,1
新北市,萬里區,2334,122,76,198,16,214,405,52.84%,30.12%,1
新北市,萬里區,2335,299,219,518,32,550,1089,50.51%,27.46%,1
新北市,烏來區,2202,581,331,912,34,946,1568,60.33%,37.05%,1
新北市,烏來區,2203,363,229,592,15,607,1198,50.67%,30.3%,1
新北市,烏來區,2204,386,198,584,20,604,1169,51.67%,33.02%,1
新北市,烏來區,2205,71,53,124,3,127,228,55.7%,31.14%,1
新北市,烏來區,2206,164,110,274,8,282,486,58.02%,33.74%,1
新北市,烏來區,2207,208,97,305,18,323,615,52.52%,33.82%,1
桃園市,桃園區,0001,457,311,768,37,805,1593,50.53%,28.69%,1
桃園市,桃園區,0002,445,350,795,32,827,1934,42.76%,23.01%,1
桃園市,桃園區,0003,516,345,861,54,915,1661,55.09%,31.07%,1
桃園市,桃園區,0004,390,275,665,20,685,1448,47.31%,26.93%,1
桃園市,桃園區,0005,501,409,910,38,948,1974,48.02%,25.38%,1
桃園市,桃園區,0006,507,321,828,41,869,1882,46.17%,26.94%,1
桃園市,桃園區,0007,472,381,853,31,884,1800,49.11%,26.22%,1
桃園市,桃園區,0008,477,358,835,56,891,1598,55.76%,29.85%,1
桃園市,桃園區,0009,403,307,710,64,774,1626,47.6%,24.78%,1
桃園市,桃園區,0010,432,300,732,48,780,1590,49.06%,27.17%,1
桃園市,桃園區,0011,448,354,802,39,841,1637,51.37%,27.37%,1
桃園市,桃園區,0012,527,369,896,55,951,1943,48.94%,27.12%,1
桃園市,桃園區,0013,413,331,744,36,780,1482,52.63%,27.87%,1
桃園市,桃園區,0014,446,294,740,44,784,1423,55.09%,31.34%,1
桃園市,桃園區,0015,451,346,797,35,832,1509,55.14%,29.89%,1
桃園市,桃園區,0016,491,328,819,32,851,1567,54.31%,31.33%,1
桃園市,桃園區,0017,411,266,677,37,714,1305,54.71%,31.49%,1
桃園市,桃園區,0018,409,258,667,31,698,1416,49.29%,28.88%,1
桃園市,桃園區,0019,459,319,778,28,806,1439,56.01%,31.9%,1
桃園市,桃園區,0020,445,300,745,40,785,1399,56.11%,31.81%,1
桃園市,桃園區,0021,487,335,822,40,862,1540,55.97%,31.62%,1
桃園市,桃園區,0022,470,308,778,29,807,1638,49.27%,28.69%,1
桃園市,桃園區,0023,377,262,639,26,665,1228,54.15%,30.7%,1
桃園市,桃園區,0024,497,286,783,46,829,1649,50.27%,30.14%,1
桃園市,桃園區,0025,497,305,802,30,832,1601,51.97%,31.04%,1
桃園市,桃園區,0026,393,300,693,63,756,1477,51.18%,26.61%,1
桃園市,桃園區,0027,486,309,795,27,822,1503,54.69%,32.34%,1
桃園市,桃園區,0028,453,302,755,47,802,1375,58.33%,32.95%,1
桃園市,桃園區,0029,547,363,910,37,947,1743,54.33%,31.38%,1
桃園市,桃園區,0030,529,337,866,50,916,1862,49.19%,28.41%,1
桃園市,桃園區,0031,520,354,874,31,905,1728,52.37%,30.09%,1
桃園市,桃園區,0032,204,143,347,19,366,690,53.04%,29.57%,1
桃園市,桃園區,0033,296,196,492,24,516,852,60.56%,34.74%,1
桃園市,桃園區,0034,425,319,744,47,791,1353,58.46%,31.41%,1
桃園市,桃園區,0035,389,276,665,17,682,1698,40.16%,22.91%,1
桃園市,桃園區,0036,397,303,700,40,740,1452,50.96%,27.34%,1
桃園市,桃園區,0037,494,338,832,51,883,1681,52.53%,29.39%,1
桃園市,桃園區,0038,499,325,824,42,866,1669,51.89%,29.9%,1
桃園市,桃園區,0039,500,353,853,33,886,1530,57.91%,32.68%,1
桃園市,桃園區,0040,482,350,832,33,865,1582,54.68%,30.47%,1
桃園市,桃園區,0041,436,296,732,33,765,1587,48.2%,27.47%,1
桃園市,桃園區,0042,440,309,749,48,797,1451,54.93%,30.32%,1
桃園市,桃園區,0043,382,314,696,40,736,1582,46.52%,24.15%,1
桃園市,桃園區,0044,326,229,555,33,588,1028,57.2%,31.71%,1
桃園市,桃園區,0045,551,365,916,51,967,1934,50%,28.49%,1
桃園市,桃園區,0046,316,205,521,40,561,1016,55.22%,31.1%,1
桃園市,桃園區,0047,319,242,561,23,584,1079,54.12%,29.56%,1
桃園市,桃園區,0048,526,351,877,25,902,1837,49.1%,28.63%,1
桃園市,桃園區,0049,423,298,721,49,770,1390,55.4%,30.43%,1
桃園市,桃園區,0050,438,334,772,28,800,1489,53.73%,29.42%,1
桃園市,桃園區,0051,548,445,993,25,1018,1821,55.9%,30.09%,1
桃園市,桃園區,0052,460,291,751,18,769,1563,49.2%,29.43%,1
桃園市,桃園區,0053,521,366,887,29,916,1697,53.98%,30.7%,1
桃園市,桃園區,0054,534,371,905,35,940,1740,54.02%,30.69%,1
桃園市,桃園區,0055,500,324,824,37,861,1626,52.95%,30.75%,1
桃園市,桃園區,0056,421,276,697,18,715,1239,57.71%,33.98%,1
桃園市,桃園區,0057,513,394,907,34,941,1766,53.28%,29.05%,1
桃園市,桃園區,0058,460,337,797,41,838,1555,53.89%,29.58%,1
桃園市,桃園區,0059,567,369,936,36,972,1831,53.09%,30.97%,1
桃園市,桃園區,0060,374,268,642,28,670,1115,60.09%,33.54%,1
桃園市,桃園區,0061,486,343,829,35,864,1562,55.31%,31.11%,1
桃園市,桃園區,0062,539,322,861,32,893,1744,51.2%,30.91%,1
桃園市,桃園區,0063,467,369,836,30,866,1838,47.12%,25.41%,1
桃園市,桃園區,0064,612,380,992,44,1036,1889,54.84%,32.4%,1
桃園市,桃園區,0065,525,365,890,56,946,1985,47.66%,26.45%,1
桃園市,桃園區,0066,471,359,830,49,879,1524,57.68%,30.91%,1
桃園市,桃園區,0067,512,335,847,33,880,1425,61.75%,35.93%,1
桃園市,桃園區,0068,547,349,896,30,926,1606,57.66%,34.06%,1
桃園市,桃園區,0069,694,429,1123,24,1147,2056,55.79%,33.75%,1
桃園市,桃園區,0070,655,415,1070,37,1107,2010,55.07%,32.59%,1
桃園市,桃園區,0071,630,428,1058,50,1108,2245,49.35%,28.06%,1
桃園市,桃園區,0072,461,359,820,29,849,1590,53.4%,28.99%,1
桃園市,桃園區,0073,527,359,886,24,910,1536,59.24%,34.31%,1
桃園市,桃園區,0074,507,400,907,41,948,1949,48.64%,26.01%,1
桃園市,桃園區,0075,522,411,933,37,970,1965,49.36%,26.56%,1
桃園市,桃園區,0076,614,423,1037,42,1079,2414,44.7%,25.43%,1
桃園市,桃園區,0077,545,389,934,59,993,1942,51.13%,28.06%,1
桃園市,桃園區,0078,628,440,1068,39,1107,2156,51.35%,29.13%,1
桃園市,桃園區,0079,449,312,761,36,797,1404,56.77%,31.98%,1
桃園市,桃園區,0080,416,279,695,30,725,1194,60.72%,34.84%,1
桃園市,桃園區,0081,436,343,779,58,837,1449,57.76%,30.09%,1
桃園市,桃園區,0082,480,355,835,56,891,1803,49.42%,26.62%,1
桃園市,桃園區,0083,522,354,876,33,909,1692,53.72%,30.85%,1
桃園市,桃園區,0084,595,379,974,34,1008,1913,52.69%,31.1%,1
桃園市,桃園區,0085,504,396,900,40,940,1815,51.79%,27.77%,1
桃園市,桃園區,0086,307,244,551,42,593,1173,50.55%,26.17%,1
桃園市,桃園區,0087,349,222,571,24,595,1162,51.2%,30.03%,1
桃園市,桃園區,0088,275,235,510,44,554,1194,46.4%,23.03%,1
桃園市,桃園區,0089,512,355,867,34,901,1695,53.16%,30.21%,1
桃園市,桃園區,0090,499,386,885,22,907,1797,50.47%,27.77%,1
桃園市,桃園區,0091,519,279,798,26,824,1592,51.76%,32.6%,1
桃園市,桃園區,0092,522,331,853,49,902,1780,50.67%,29.33%,1
桃園市,桃園區,0093,508,340,848,27,875,1904,45.96%,26.68%,1
桃園市,桃園區,0094,567,409,976,25,1001,2021,49.53%,28.06%,1
桃園市,桃園區,0095,486,280,766,36,802,1545,51.91%,31.46%,1
桃園市,桃園區,0096,484,280,764,22,786,1617,48.61%,29.93%,1
桃園市,桃園區,0097,502,325,827,26,853,1683,50.68%,29.83%,1
桃園市,桃園區,0098,556,383,939,60,999,1834,54.47%,30.32%,1
桃園市,桃園區,0099,536,409,945,35,980,2055,47.69%,26.08%,1
桃園市,桃園區,0100,508,340,848,18,866,1828,47.37%,27.79%,1
桃園市,桃園區,0101,551,333,884,33,917,1873,48.96%,29.42%,1
桃園市,桃園區,0102,451,273,724,39,763,3687,20.69%,12.23%,1
桃園市,桃園區,0103,549,374,923,42,965,1850,52.16%,29.68%,1
桃園市,桃園區,0104,529,366,895,28,923,1827,50.52%,28.95%,1
桃園市,桃園區,0105,420,249,669,27,696,1149,60.57%,36.55%,1
桃園市,桃園區,0106,335,254,589,40,629,1061,59.28%,31.57%,1
桃園市,桃園區,0107,469,358,827,36,863,1831,47.13%,25.61%,1
桃園市,桃園區,0108,614,435,1049,39,1088,2168,50.18%,28.32%,1
桃園市,桃園區,0109,563,349,912,8,920,1874,49.09%,30.04%,1
桃園市,桃園區,0110,394,295,689,18,707,1524,46.39%,25.85%,1
桃園市,桃園區,0111,460,332,792,18,810,1528,53.01%,30.1%,1
桃園市,桃園區,0112,454,326,780,26,806,1489,54.13%,30.49%,1
桃園市,桃園區,0113,351,278,629,51,680,1308,51.99%,26.83%,1
桃園市,桃園區,0114,460,317,777,44,821,1583,51.86%,29.06%,1
桃園市,桃園區,0115,494,347,841,40,881,1618,54.45%,30.53%,1
桃園市,桃園區,0116,566,433,999,54,1053,2127,49.51%,26.61%,1
桃園市,桃園區,0117,571,392,963,26,989,2033,48.65%,28.09%,1
桃園市,桃園區,0118,640,397,1037,27,1064,2098,50.71%,30.51%,1
桃園市,桃園區,0119,679,418,1097,50,1147,2126,53.95%,31.94%,1
桃園市,桃園區,0120,580,331,911,35,946,1917,49.35%,30.26%,1
桃園市,桃園區,0121,547,399,946,34,980,1997,49.07%,27.39%,1
桃園市,桃園區,0122,589,380,969,37,1006,1929,52.15%,30.53%,1
桃園市,桃園區,0123,483,340,823,36,859,1691,50.8%,28.56%,1
桃園市,桃園區,0124,570,375,945,25,970,1900,51.05%,30%,1
桃園市,桃園區,0125,539,353,892,44,936,1761,53.15%,30.61%,1
桃園市,桃園區,0126,533,405,938,20,958,1922,49.84%,27.73%,1
桃園市,桃園區,0127,557,397,954,41,995,1995,49.87%,27.92%,1
桃園市,桃園區,0128,341,229,570,21,591,1063,55.6%,32.08%,1
桃園市,桃園區,0129,419,283,702,30,732,1412,51.84%,29.67%,1
桃園市,桃園區,0130,534,395,929,20,949,1746,54.35%,30.58%,1
桃園市,桃園區,0131,436,329,765,39,804,1689,47.6%,25.81%,1
桃園市,桃園區,0132,412,260,672,24,696,1542,45.14%,26.72%,1
桃園市,桃園區,0133,420,266,686,38,724,1437,50.38%,29.23%,1
桃園市,桃園區,0134,490,360,850,23,873,1679,52%,29.18%,1
桃園市,桃園區,0135,487,345,832,46,878,1886,46.55%,25.82%,1
桃園市,桃園區,0136,487,349,836,55,891,1657,53.77%,29.39%,1
桃園市,桃園區,0137,398,304,702,24,726,1349,53.82%,29.5%,1
桃園市,桃園區,0138,551,367,918,23,941,1805,52.13%,30.53%,1
桃園市,桃園區,0139,504,385,889,53,942,1846,51.03%,27.3%,1
桃園市,桃園區,0140,441,293,734,44,778,1644,47.32%,26.82%,1
桃園市,桃園區,0141,441,326,767,38,805,1674,48.09%,26.34%,1
桃園市,桃園區,0142,520,333,853,31,884,1737,50.89%,29.94%,1
桃園市,桃園區,0143,503,301,804,40,844,1566,53.9%,32.12%,1
桃園市,桃園區,0144,458,316,774,38,812,1517,53.53%,30.19%,1
桃園市,桃園區,0145,524,201,725,26,751,1619,46.39%,32.37%,1
桃園市,桃園區,0146,539,336,875,32,907,1774,51.13%,30.38%,1
桃園市,桃園區,0147,495,344,839,31,870,1666,52.22%,29.71%,1
桃園市,桃園區,0148,483,300,783,16,799,1528,52.29%,31.61%,1
桃園市,桃園區,0149,472,354,826,46,872,1709,51.02%,27.62%,1
桃園市,桃園區,0150,474,353,827,15,842,1719,48.98%,27.57%,1
桃園市,桃園區,0151,414,271,685,50,735,1569,46.85%,26.39%,1
桃園市,桃園區,0152,464,256,720,26,746,1505,49.57%,30.83%,1
桃園市,桃園區,0153,408,321,729,34,763,1496,51%,27.27%,1
桃園市,桃園區,0154,442,328,770,33,803,1505,53.36%,29.37%,1
桃園市,桃園區,0155,499,380,879,34,913,1807,50.53%,27.61%,1
桃園市,桃園區,0156,560,360,920,37,957,1857,51.53%,30.16%,1
桃園市,桃園區,0157,516,336,852,45,897,1589,56.45%,32.47%,1
桃園市,桃園區,0158,588,440,1028,32,1060,2088,50.77%,28.16%,1
桃園市,桃園區,0159,559,362,921,32,953,1893,50.34%,29.53%,1
桃園市,桃園區,0160,340,224,564,25,589,1303,45.2%,26.09%,1
桃園市,桃園區,0161,429,295,724,33,757,1416,53.46%,30.3%,1
桃園市,桃園區,0162,388,256,644,22,666,1351,49.3%,28.72%,1
桃園市,桃園區,0163,460,332,792,26,818,1659,49.31%,27.73%,1
桃園市,桃園區,0164,634,353,987,31,1018,2103,48.41%,30.15%,1
桃園市,桃園區,0165,553,382,935,27,962,1943,49.51%,28.46%,1
桃園市,桃園區,0166,556,393,949,31,980,1927,50.86%,28.85%,1
桃園市,桃園區,0167,494,354,848,46,894,1929,46.35%,25.61%,1
桃園市,桃園區,0168,703,503,1206,33,1239,2204,56.22%,31.9%,1
桃園市,桃園區,0169,530,378,908,26,934,2033,45.94%,26.07%,1
桃園市,桃園區,0170,539,281,820,24,844,1656,50.97%,32.55%,1
桃園市,桃園區,0171,481,341,822,49,871,1712,50.88%,28.1%,1
桃園市,桃園區,0172,463,387,850,30,880,1738,50.63%,26.64%,1
桃園市,桃園區,0173,530,308,838,19,857,1432,59.85%,37.01%,1
桃園市,桃園區,0174,465,366,831,34,865,1421,60.87%,32.72%,1
桃園市,桃園區,0175,395,288,683,20,703,1344,52.31%,29.39%,1
桃園市,桃園區,0176,543,341,884,21,905,1942,46.6%,27.96%,1
桃園市,桃園區,0177,597,381,978,30,1008,2001,50.37%,29.84%,1
桃園市,桃園區,0178,524,344,868,22,890,1941,45.85%,27%,1
桃園市,桃園區,0179,511,365,876,37,913,1702,53.64%,30.02%,1
桃園市,桃園區,0180,451,342,793,30,823,1589,51.79%,28.38%,1
桃園市,桃園區,0181,489,276,765,26,791,1544,51.23%,31.67%,1
桃園市,桃園區,0182,452,338,790,32,822,1860,44.19%,24.3%,1
桃園市,桃園區,0183,473,343,816,53,869,1726,50.35%,27.4%,1
桃園市,桃園區,0184,478,362,840,30,870,1798,48.39%,26.59%,1
桃園市,桃園區,0185,570,372,942,25,967,1925,50.23%,29.61%,1
桃園市,桃園區,0186,564,382,946,35,981,1945,50.44%,29%,1
桃園市,桃園區,0187,437,353,790,43,833,1764,47.22%,24.77%,1
桃園市,桃園區,0188,597,386,983,53,1036,1899,54.56%,31.44%,1
桃園市,桃園區,0189,425,272,697,28,725,1415,51.24%,30.04%,1
桃園市,桃園區,0190,484,351,835,23,858,1790,47.93%,27.04%,1
桃園市,桃園區,0191,471,330,801,22,823,1693,48.61%,27.82%,1
桃園市,桃園區,0192,546,366,912,34,946,1916,49.37%,28.5%,1
桃園市,桃園區,0193,393,267,660,25,685,1434,47.77%,27.41%,1
桃園市,桃園區,0194,459,349,808,39,847,1494,56.69%,30.72%,1
桃園市,桃園區,0195,383,293,676,47,723,1311,55.15%,29.21%,1
桃園市,桃園區,0196,436,317,753,35,788,1476,53.39%,29.54%,1
桃園市,桃園區,0197,458,335,793,39,832,1484,56.06%,30.86%,1
桃園市,桃園區,0198,457,304,761,31,792,1514,52.31%,30.18%,1
桃園市,桃園區,0199,454,260,714,45,759,1446,52.49%,31.4%,1
桃園市,桃園區,0200,412,311,723,26,749,1573,47.62%,26.19%,1
桃園市,桃園區,0201,410,290,700,28,728,1564,46.55%,26.21%,1
桃園市,桃園區,0202,329,215,544,31,575,1015,56.65%,32.41%,1
桃園市,桃園區,0203,252,213,465,26,491,955,51.41%,26.39%,1
桃園市,桃園區,0204,506,364,870,35,905,1796,50.39%,28.17%,1
桃園市,桃園區,0205,494,393,887,23,910,1878,48.46%,26.3%,1
桃園市,桃園區,0206,504,325,829,28,857,1729,49.57%,29.15%,1
桃園市,桃園區,0207,494,326,820,28,848,1843,46.01%,26.8%,1
桃園市,桃園區,0208,449,309,758,26,784,1817,43.15%,24.71%,1
桃園市,桃園區,0209,415,118,533,22,555,979,56.69%,42.39%,1
桃園市,桃園區,0210,413,296,709,19,728,1363,53.41%,30.3%,1
桃園市,桃園區,0211,445,333,778,19,797,1546,51.55%,28.78%,1
桃園市,桃園區,0212,363,274,637,24,661,1308,50.54%,27.75%,1
桃園市,桃園區,0213,613,416,1029,43,1072,2164,49.54%,28.33%,1
桃園市,桃園區,0214,540,388,928,41,969,2020,47.97%,26.73%,1
桃園市,桃園區,0215,485,345,830,29,859,1924,44.65%,25.21%,1
桃園市,桃園區,0216,547,332,879,33,912,2088,43.68%,26.2%,1
桃園市,中壢區,0591,443,277,720,24,744,1401,53.1%,31.62%,1
桃園市,中壢區,0592,508,349,857,43,900,1798,50.06%,28.25%,1
桃園市,中壢區,0593,450,299,749,30,779,1642,47.44%,27.41%,1
桃園市,中壢區,0594,531,321,852,39,891,1670,53.35%,31.8%,1
桃園市,中壢區,0595,466,304,770,37,807,1456,55.43%,32.01%,1
桃園市,中壢區,0596,584,298,882,39,921,1531,60.16%,38.15%,1
桃園市,中壢區,0597,574,329,903,27,930,1623,57.3%,35.37%,1
桃園市,中壢區,0598,561,311,872,25,897,1953,45.93%,28.73%,1
桃園市,中壢區,0599,409,230,639,25,664,1155,57.49%,35.41%,1
桃園市,中壢區,0600,528,283,811,27,838,1800,46.56%,29.33%,1
桃園市,中壢區,0601,523,305,828,22,850,1757,48.38%,29.77%,1
桃園市,中壢區,0602,480,230,710,43,753,1281,58.78%,37.47%,1
桃園市,中壢區,0603,499,309,808,24,832,1462,56.91%,34.13%,1
桃園市,中壢區,0604,471,255,726,40,766,1560,49.1%,30.19%,1
桃園市,中壢區,0605,589,333,922,19,941,1602,58.74%,36.77%,1
桃園市,中壢區,0606,406,217,623,24,647,1006,64.31%,40.36%,1
桃園市,中壢區,0607,522,287,809,30,839,1474,56.92%,35.41%,1
桃園市,中壢區,0608,530,299,829,56,885,1627,54.39%,32.58%,1
桃園市,中壢區,0609,512,315,827,32,859,1519,56.55%,33.71%,1
桃園市,中壢區,0610,484,316,800,44,844,1526,55.31%,31.72%,1
桃園市,中壢區,0611,529,298,827,46,873,1618,53.96%,32.69%,1
桃園市,中壢區,0612,584,288,872,34,906,1554,58.3%,37.58%,1
桃園市,中壢區,0613,577,296,873,50,923,1706,54.1%,33.82%,1
桃園市,中壢區,0614,617,373,990,43,1033,1818,56.82%,33.94%,1
桃園市,中壢區,0615,607,358,965,35,1000,1991,50.23%,30.49%,1
桃園市,中壢區,0616,538,299,837,28,865,1609,53.76%,33.44%,1
桃園市,中壢區,0617,410,216,626,32,658,1329,49.51%,30.85%,1
桃園市,中壢區,0618,473,264,737,58,795,1587,50.09%,29.8%,1
桃園市,中壢區,0619,596,391,987,27,1014,1955,51.87%,30.49%,1
桃園市,中壢區,0620,476,364,840,46,886,1711,51.78%,27.82%,1
桃園市,中壢區,0621,533,307,840,37,877,1712,51.23%,31.13%,1
桃園市,中壢區,0622,492,313,805,32,837,1448,57.8%,33.98%,1
桃園市,中壢區,0623,470,322,792,30,822,1605,51.21%,29.28%,1
桃園市,中壢區,0624,458,309,767,15,782,1633,47.89%,28.05%,1
桃園市,中壢區,0625,642,367,1009,51,1060,1795,59.05%,35.77%,1
桃園市,中壢區,0626,518,362,880,35,915,1689,54.17%,30.67%,1
桃園市,中壢區,0627,392,258,650,23,673,1201,56.04%,32.64%,1
桃園市,中壢區,0628,437,256,693,34,727,1353,53.73%,32.3%,1
桃園市,中壢區,0629,462,307,769,28,797,1587,50.22%,29.11%,1
桃園市,中壢區,0630,703,260,963,34,997,1883,52.95%,37.33%,1
桃園市,中壢區,0631,485,242,727,20,747,1448,51.59%,33.49%,1
桃園市,中壢區,0632,535,387,922,30,952,1810,52.6%,29.56%,1
桃園市,中壢區,0633,599,335,934,49,983,1916,51.3%,31.26%,1
桃園市,中壢區,0634,433,230,663,21,684,1177,58.11%,36.79%,1
桃園市,中壢區,0635,494,302,796,45,841,1410,59.65%,35.04%,1
桃園市,中壢區,0636,441,261,702,24,726,1368,53.07%,32.24%,1
桃園市,中壢區,0637,548,290,838,28,866,1424,60.81%,38.48%,1
桃園市,中壢區,0638,532,327,859,21,880,1573,55.94%,33.82%,1
桃園市,中壢區,0639,394,142,536,24,560,1152,48.61%,34.2%,1
桃園市,中壢區,0640,379,269,648,21,669,1178,56.79%,32.17%,1
桃園市,中壢區,0641,631,359,990,43,1033,1966,52.54%,32.1%,1
桃園市,中壢區,0642,404,281,685,34,719,3474,20.7%,11.63%,1
桃園市,中壢區,0643,654,435,1089,46,1135,2099,54.07%,31.16%,1
桃園市,中壢區,0644,379,255,634,27,661,1178,56.11%,32.17%,1
桃園市,中壢區,0645,476,337,813,42,855,1397,61.2%,34.07%,1
桃園市,中壢區,0646,477,411,888,37,925,1669,55.42%,28.58%,1
桃園市,中壢區,0647,578,401,979,43,1022,2087,48.97%,27.7%,1
桃園市,中壢區,0648,536,414,950,34,984,1900,51.79%,28.21%,1
桃園市,中壢區,0649,432,268,700,19,719,1640,43.84%,26.34%,1
桃園市,中壢區,0650,359,209,568,27,595,994,59.86%,36.12%,1
桃園市,中壢區,0651,446,246,692,36,728,1131,64.37%,39.43%,1
桃園市,中壢區,0652,559,369,928,26,954,1625,58.71%,34.4%,1
桃園市,中壢區,0653,487,334,821,40,861,1384,62.21%,35.19%,1
桃園市,中壢區,0654,508,313,821,39,860,1588,54.16%,31.99%,1
桃園市,中壢區,0655,508,257,765,28,793,1445,54.88%,35.16%,1
桃園市,中壢區,0656,464,299,763,47,810,1743,46.47%,26.62%,1
桃園市,中壢區,0657,524,312,836,25,861,1812,47.52%,28.92%,1
桃園市,中壢區,0658,437,316,753,37,790,1546,51.1%,28.27%,1
桃園市,中壢區,0659,452,201,653,33,686,1290,53.18%,35.04%,1
桃園市,中壢區,0660,608,380,988,60,1048,2145,48.86%,28.34%,1
桃園市,中壢區,0661,404,287,691,27,718,1451,49.48%,27.84%,1
桃園市,中壢區,0662,488,266,754,26,780,1489,52.38%,32.77%,1
桃園市,中壢區,0663,263,174,437,25,462,827,55.86%,31.8%,1
桃園市,中壢區,0664,423,258,681,40,721,1442,50%,29.33%,1
桃園市,中壢區,0665,544,312,856,25,881,1842,47.83%,29.53%,1
桃園市,中壢區,0666,446,262,708,35,743,1520,48.88%,29.34%,1
桃園市,中壢區,0667,470,317,787,34,821,1764,46.54%,26.64%,1
桃園市,中壢區,0668,517,297,814,11,825,1488,55.44%,34.74%,1
桃園市,中壢區,0669,501,317,818,32,850,1593,53.36%,31.45%,1
桃園市,中壢區,0670,446,329,775,28,803,1505,53.36%,29.63%,1
桃園市,中壢區,0671,515,325,840,28,868,1661,52.26%,31.01%,1
桃園市,中壢區,0672,486,320,806,28,834,1492,55.9%,32.57%,1
桃園市,中壢區,0673,330,257,587,32,619,1249,49.56%,26.42%,1
桃園市,中壢區,0674,417,264,681,22,703,1257,55.93%,33.17%,1
桃園市,中壢區,0675,489,328,817,47,864,1659,52.08%,29.48%,1
桃園市,中壢區,0676,605,363,968,23,991,1815,54.6%,33.33%,1
桃園市,中壢區,0677,487,349,836,33,869,1702,51.06%,28.61%,1
桃園市,中壢區,0678,476,315,791,23,814,1541,52.82%,30.89%,1
桃園市,中壢區,0679,550,248,798,25,823,1659,49.61%,33.15%,1
桃園市,中壢區,0680,614,302,916,47,963,1874,51.39%,32.76%,1
桃園市,中壢區,0681,550,229,779,26,805,1603,50.22%,34.31%,1
桃園市,中壢區,0682,512,330,842,38,880,1735,50.72%,29.51%,1
桃園市,中壢區,0683,555,340,895,26,921,1815,50.74%,30.58%,1
桃園市,中壢區,0684,453,469,922,29,951,1873,50.77%,24.19%,1
桃園市,中壢區,0685,590,333,923,46,969,1739,55.72%,33.93%,1
桃園市,中壢區,0686,519,294,813,39,852,1709,49.85%,30.37%,1
桃園市,中壢區,0687,540,335,875,36,911,1655,55.05%,32.63%,1
桃園市,中壢區,0688,555,300,855,35,890,1664,53.49%,33.35%,1
桃園市,中壢區,0689,344,181,525,22,547,1087,50.32%,31.65%,1
桃園市,中壢區,0690,342,192,534,47,581,1065,54.55%,32.11%,1
桃園市,中壢區,0691,609,342,951,51,1002,1844,54.34%,33.03%,1
桃園市,中壢區,0692,335,225,560,31,591,1220,48.44%,27.46%,1
桃園市,中壢區,0693,359,276,635,22,657,1219,53.9%,29.45%,1
桃園市,中壢區,0694,392,267,659,40,699,1260,55.48%,31.11%,1
桃園市,中壢區,0695,562,329,891,37,928,1594,58.22%,35.26%,1
桃園市,中壢區,0696,497,377,874,61,935,1733,53.95%,28.68%,1
桃園市,中壢區,0697,614,394,1008,40,1048,1979,52.96%,31.03%,1
桃園市,中壢區,0698,504,363,867,25,892,1621,55.03%,31.09%,1
桃園市,中壢區,0699,476,282,758,28,786,1391,56.51%,34.22%,1
桃園市,中壢區,0700,521,314,835,15,850,1531,55.52%,34.03%,1
桃園市,中壢區,0701,574,330,904,38,942,1943,48.48%,29.54%,1
桃園市,中壢區,0702,421,274,695,24,719,1363,52.75%,30.89%,1
桃園市,中壢區,0703,602,333,935,47,982,2172,45.21%,27.72%,1
桃園市,中壢區,0704,565,283,848,31,879,1798,48.89%,31.42%,1
桃園市,中壢區,0705,512,305,817,14,831,1671,49.73%,30.64%,1
桃園市,中壢區,0706,589,354,943,36,979,1969,49.72%,29.91%,1
桃園市,中壢區,0707,592,354,946,38,984,1563,62.96%,37.88%,1
桃園市,中壢區,0708,591,361,952,28,980,1762,55.62%,33.54%,1
桃園市,中壢區,0709,481,311,792,36,828,1923,43.06%,25.01%,1
桃園市,中壢區,0710,520,343,863,37,900,1572,57.25%,33.08%,1
桃園市,中壢區,0711,597,385,982,32,1014,1850,54.81%,32.27%,1
桃園市,中壢區,0712,463,314,777,43,820,1583,51.8%,29.25%,1
桃園市,中壢區,0713,512,354,866,38,904,1735,52.1%,29.51%,1
桃園市,中壢區,0714,354,302,656,31,687,1292,53.17%,27.4%,1
桃園市,中壢區,0715,423,247,670,21,691,1265,54.62%,33.44%,1
桃園市,中壢區,0716,575,288,863,26,889,1798,49.44%,31.98%,1
桃園市,中壢區,0717,570,418,988,54,1042,1822,57.19%,31.28%,1
桃園市,中壢區,0718,494,352,846,23,869,1613,53.87%,30.63%,1
桃園市,中壢區,0719,404,328,732,26,758,1405,53.95%,28.75%,1
桃園市,中壢區,0720,542,380,922,62,984,1730,56.88%,31.33%,1
桃園市,中壢區,0721,596,335,931,22,953,1384,68.86%,43.06%,1
桃園市,中壢區,0722,356,265,621,13,634,1122,56.51%,31.73%,1
桃園市,中壢區,0723,346,227,573,33,606,992,61.09%,34.88%,1
桃園市,中壢區,0724,531,492,1023,32,1055,1820,57.97%,29.18%,1
桃園市,中壢區,0725,570,322,892,35,927,1847,50.19%,30.86%,1
桃園市,中壢區,0726,475,247,722,40,762,1302,58.53%,36.48%,1
桃園市,中壢區,0727,429,238,667,33,700,1203,58.19%,35.66%,1
桃園市,中壢區,0728,476,281,757,31,788,1226,64.27%,38.83%,1
桃園市,中壢區,0729,414,284,698,37,735,1234,59.56%,33.55%,1
桃園市,中壢區,0730,526,387,913,41,954,2023,47.16%,26%,1
桃園市,中壢區,0731,398,321,719,27,746,1555,47.97%,25.59%,1
桃園市,中壢區,0732,592,351,943,38,981,1951,50.28%,30.34%,1
桃園市,中壢區,0733,478,303,781,33,814,1383,58.86%,34.56%,1
桃園市,中壢區,0734,445,226,671,34,705,1164,60.57%,38.23%,1
桃園市,中壢區,0735,523,268,791,31,822,1482,55.47%,35.29%,1
桃園市,中壢區,0736,575,340,915,31,946,1770,53.45%,32.49%,1
桃園市,中壢區,0737,583,360,943,54,997,1703,58.54%,34.23%,1
桃園市,中壢區,0738,576,345,921,49,970,1841,52.69%,31.29%,1
桃園市,中壢區,0739,627,409,1036,32,1068,1941,55.02%,32.3%,1
桃園市,中壢區,0740,670,408,1078,41,1119,2029,55.15%,33.02%,1
桃園市,中壢區,0741,588,342,930,21,951,1636,58.13%,35.94%,1
桃園市,中壢區,0742,504,336,840,33,873,1528,57.13%,32.98%,1
桃園市,中壢區,0743,612,436,1048,52,1100,2289,48.06%,26.74%,1
桃園市,中壢區,0744,547,393,940,28,968,2020,47.92%,27.08%,1
桃園市,中壢區,0745,626,419,1045,35,1080,2027,53.28%,30.88%,1
桃園市,中壢區,0746,480,340,820,18,838,1883,44.5%,25.49%,1
桃園市,中壢區,0747,581,410,991,38,1029,2080,49.47%,27.93%,1
桃園市,中壢區,0748,192,140,332,15,347,646,53.72%,29.72%,1
桃園市,中壢區,0749,811,282,1093,35,1128,1780,63.37%,45.56%,1
桃園市,中壢區,0750,488,279,767,24,791,1372,57.65%,35.57%,1
桃園市,中壢區,0751,571,372,943,23,966,1668,57.91%,34.23%,1
桃園市,中壢區,0752,582,400,982,16,998,1987,50.23%,29.29%,1
桃園市,中壢區,0753,489,317,806,21,827,1520,54.41%,32.17%,1
桃園市,中壢區,0754,261,179,440,28,468,852,54.93%,30.63%,1
桃園市,中壢區,0755,354,284,638,31,669,1209,55.33%,29.28%,1
桃園市,中壢區,0756,457,297,754,53,807,1481,54.49%,30.86%,1
桃園市,中壢區,0757,437,292,729,17,746,1564,47.7%,27.94%,1
桃園市,中壢區,0758,641,392,1033,45,1078,1957,55.08%,32.75%,1
桃園市,中壢區,0759,419,289,708,34,742,1223,60.67%,34.26%,1
桃園市,中壢區,0760,428,264,692,28,720,1182,60.91%,36.21%,1
桃園市,中壢區,0761,351,251,602,29,631,1066,59.19%,32.93%,1
桃園市,中壢區,0762,576,360,936,41,977,1701,57.44%,33.86%,1
桃園市,中壢區,0763,295,175,470,32,502,943,53.23%,31.28%,1
桃園市,中壢區,0764,252,171,423,21,444,731,60.74%,34.47%,1
桃園市,中壢區,0765,273,190,463,33,496,851,58.28%,32.08%,1
桃園市,中壢區,0766,304,231,535,26,561,1011,55.49%,30.07%,1
桃園市,中壢區,0767,486,363,849,38,887,1532,57.9%,31.72%,1
桃園市,中壢區,0768,325,207,532,29,561,1028,54.57%,31.61%,1
桃園市,中壢區,0769,405,248,653,24,677,1157,58.51%,35%,1
桃園市,中壢區,0770,451,342,793,53,846,1591,53.17%,28.35%,1
桃園市,中壢區,0771,585,395,980,48,1028,2156,47.68%,27.13%,1
桃園市,中壢區,0772,423,267,690,19,709,1479,47.94%,28.6%,1
桃園市,中壢區,0773,566,350,916,30,946,1780,53.15%,31.8%,1
桃園市,中壢區,0774,492,360,852,44,896,1651,54.27%,29.8%,1
桃園市,中壢區,0775,785,194,979,34,1013,1870,54.17%,41.98%,1
桃園市,中壢區,0776,510,343,853,25,878,1913,45.9%,26.66%,1
桃園市,中壢區,0777,464,268,732,36,768,1609,47.73%,28.84%,1
桃園市,中壢區,0778,447,301,748,25,773,1539,50.23%,29.04%,1
桃園市,中壢區,0779,435,300,735,28,763,1426,53.51%,30.5%,1
桃園市,中壢區,0780,462,301,763,27,790,1618,48.83%,28.55%,1
桃園市,中壢區,0781,448,310,758,29,787,1441,54.61%,31.09%,1
桃園市,中壢區,0782,486,328,814,28,842,1528,55.1%,31.81%,1
桃園市,中壢區,0783,493,359,852,47,899,1683,53.42%,29.29%,1
桃園市,中壢區,0784,632,386,1018,56,1074,1945,55.22%,32.49%,1
桃園市,中壢區,0785,436,333,769,44,813,1534,53%,28.42%,1
桃園市,中壢區,0786,508,352,860,44,904,1810,49.94%,28.07%,1
桃園市,中壢區,0787,320,194,514,48,562,1097,51.23%,29.17%,1
桃園市,中壢區,0788,508,394,902,30,932,1917,48.62%,26.5%,1
桃園市,中壢區,0789,496,421,917,40,957,1858,51.51%,26.7%,1
桃園市,中壢區,0790,526,310,836,46,882,1576,55.96%,33.38%,1
桃園市,中壢區,0791,474,317,791,36,827,1478,55.95%,32.07%,1
桃園市,中壢區,0792,474,349,823,17,840,1589,52.86%,29.83%,1
桃園市,中壢區,0793,633,423,1056,62,1118,2037,54.88%,31.08%,1
桃園市,中壢區,0794,409,265,674,29,703,1158,60.71%,35.32%,1
桃園市,中壢區,0795,607,409,1016,42,1058,1967,53.79%,30.86%,1
桃園市,中壢區,0796,536,349,885,43,928,1830,50.71%,29.29%,1
桃園市,中壢區,0797,599,377,976,41,1017,1856,54.8%,32.27%,1
桃園市,中壢區,0798,554,401,955,49,1004,2068,48.55%,26.79%,1
桃園市,中壢區,0799,481,372,853,41,894,2152,41.54%,22.35%,1
桃園市,中壢區,0800,563,399,962,27,989,2158,45.83%,26.09%,1
桃園市,大溪區,0522,455,346,801,36,837,1477,56.67%,30.81%,1
桃園市,大溪區,0523,325,208,533,29,562,1006,55.86%,32.31%,1
桃園市,大溪區,0524,456,303,759,54,813,1553,52.35%,29.36%,1
桃園市,大溪區,0525,448,362,810,61,871,1597,54.54%,28.05%,1
桃園市,大溪區,0526,424,270,694,35,729,1358,53.68%,31.22%,1
桃園市,大溪區,0527,452,273,725,37,762,1585,48.08%,28.52%,1
桃園市,大溪區,0528,459,338,797,39,836,1612,51.86%,28.47%,1
桃園市,大溪區,0529,416,289,705,25,730,1555,46.95%,26.75%,1
桃園市,大溪區,0530,419,319,738,36,774,1282,60.37%,32.68%,1
桃園市,大溪區,0531,419,259,678,54,732,1392,52.59%,30.1%,1
桃園市,大溪區,0532,393,284,677,44,721,1422,50.7%,27.64%,1
桃園市,大溪區,0533,423,314,737,55,792,1448,54.7%,29.21%,1
桃園市,大溪區,0534,411,318,729,49,778,1269,61.31%,32.39%,1
桃園市,大溪區,0535,330,211,541,51,592,977,60.59%,33.78%,1
桃園市,大溪區,0536,400,326,726,45,771,1359,56.73%,29.43%,1
桃園市,大溪區,0537,339,291,630,60,690,1135,60.79%,29.87%,1
桃園市,大溪區,0538,177,137,314,38,352,660,53.33%,26.82%,1
桃園市,大溪區,0539,262,222,484,48,532,1056,50.38%,24.81%,1
桃園市,大溪區,0540,381,229,610,42,652,1263,51.62%,30.17%,1
桃園市,大溪區,0541,199,170,369,31,400,717,55.79%,27.75%,1
桃園市,大溪區,0542,291,250,541,23,564,1299,43.42%,22.4%,1
桃園市,大溪區,0543,298,193,491,50,541,976,55.43%,30.53%,1
桃園市,大溪區,0544,274,198,472,36,508,938,54.16%,29.21%,1
桃園市,大溪區,0545,259,153,412,20,432,832,51.92%,31.13%,1
桃園市,大溪區,0546,206,175,381,23,404,866,46.65%,23.79%,1
桃園市,大溪區,0547,182,135,317,30,347,694,50%,26.22%,1
桃園市,大溪區,0548,395,264,659,51,710,1410,50.35%,28.01%,1
桃園市,大溪區,0549,360,244,604,48,652,1303,50.04%,27.63%,1
桃園市,大溪區,0550,316,241,557,33,590,1125,52.44%,28.09%,1
桃園市,大溪區,0551,343,274,617,27,644,1170,55.04%,29.32%,1
桃園市,大溪區,0552,436,296,732,32,764,1308,58.41%,33.33%,1
桃園市,大溪區,0553,317,256,573,36,609,1094,55.67%,28.98%,1
桃園市,大溪區,0554,690,416,1106,43,1149,2153,53.37%,32.05%,1
桃園市,大溪區,0555,459,191,650,38,688,1173,58.65%,39.13%,1
桃園市,大溪區,0556,430,251,681,21,702,1369,51.28%,31.41%,1
桃園市,大溪區,0557,443,258,701,43,744,1446,51.45%,30.64%,1
桃園市,大溪區,0558,400,193,593,38,631,1406,44.88%,28.45%,1
桃園市,大溪區,0559,531,312,843,20,863,1592,54.21%,33.35%,1
桃園市,大溪區,0560,487,330,817,40,857,1497,57.25%,32.53%,1
桃園市,大溪區,0561,484,341,825,60,885,1559,56.77%,31.05%,1
桃園市,大溪區,0562,508,328,836,29,865,1684,51.37%,30.17%,1
桃園市,大溪區,0563,648,375,1023,53,1076,1959,54.93%,33.08%,1
桃園市,大溪區,0564,481,265,746,34,780,1369,56.98%,35.14%,1
桃園市,大溪區,0565,424,327,751,53,804,1431,56.18%,29.63%,1
桃園市,大溪區,0566,417,246,663,25,688,1657,41.52%,25.17%,1
桃園市,大溪區,0567,387,217,604,22,626,1387,45.13%,27.9%,1
桃園市,大溪區,0568,340,216,556,21,577,1085,53.18%,31.34%,1
桃園市,大溪區,0569,501,260,761,28,789,1403,56.24%,35.71%,1
桃園市,大溪區,0570,422,292,714,70,784,1511,51.89%,27.93%,1
桃園市,大溪區,0571,410,323,733,69,802,1719,46.66%,23.85%,1
桃園市,大溪區,0572,423,306,729,64,793,1717,46.19%,24.64%,1
桃園市,大溪區,0573,353,227,580,70,650,1207,53.85%,29.25%,1
桃園市,大溪區,0574,417,210,627,48,675,1188,56.82%,35.1%,1
桃園市,大溪區,0575,450,283,733,21,754,1514,49.8%,29.72%,1
桃園市,大溪區,0576,539,272,811,49,860,1529,56.25%,35.25%,1
桃園市,大溪區,0577,469,245,714,30,744,1260,59.05%,37.22%,1
桃園市,大溪區,0578,302,171,473,14,487,831,58.6%,36.34%,1
桃園市,大溪區,0579,445,291,736,44,780,1407,55.44%,31.63%,1
桃園市,大溪區,0580,434,284,718,42,760,1494,50.87%,29.05%,1
桃園市,楊梅區,0926,401,266,667,41,708,1269,55.79%,31.6%,1
桃園市,楊梅區,0927,504,239,743,33,776,1246,62.28%,40.45%,1
桃園市,楊梅區,0928,508,272,780,45,825,1408,58.59%,36.08%,1
桃園市,楊梅區,0929,500,268,768,43,811,1434,56.56%,34.87%,1
桃園市,楊梅區,0930,488,257,745,45,790,1515,52.15%,32.21%,1
桃園市,楊梅區,0931,502,272,774,44,818,1657,49.37%,30.3%,1
桃園市,楊梅區,0932,416,200,616,25,641,1137,56.38%,36.59%,1
桃園市,楊梅區,0933,694,385,1079,32,1111,2211,50.25%,31.39%,1
桃園市,楊梅區,0934,609,357,966,44,1010,2008,50.3%,30.33%,1
桃園市,楊梅區,0935,623,354,977,28,1005,1911,52.59%,32.6%,1
桃園市,楊梅區,0936,489,287,776,38,814,1449,56.18%,33.75%,1
桃園市,楊梅區,0937,508,318,826,41,867,1877,46.19%,27.06%,1
桃園市,楊梅區,0938,623,313,936,21,957,1988,48.14%,31.34%,1
桃園市,楊梅區,0939,592,382,974,28,1002,1931,51.89%,30.66%,1
桃園市,楊梅區,0940,600,327,927,37,964,1938,49.74%,30.96%,1
桃園市,楊梅區,0941,565,293,858,21,879,1677,52.42%,33.69%,1
桃園市,楊梅區,0942,549,352,901,22,923,1848,49.95%,29.71%,1
桃園市,楊梅區,0943,601,355,956,23,979,1882,52.02%,31.93%,1
桃園市,楊梅區,0944,394,231,625,11,636,1541,41.27%,25.57%,1
桃園市,楊梅區,0945,575,353,928,32,960,1938,49.54%,29.67%,1
桃園市,楊梅區,0946,451,258,709,18,727,1562,46.54%,28.87%,1
桃園市,楊梅區,0947,633,464,1097,37,1134,2125,53.36%,29.79%,1
桃園市,楊梅區,0948,533,320,853,37,890,1516,58.71%,35.16%,1
桃園市,楊梅區,0949,575,324,899,18,917,1807,50.75%,31.82%,1
桃園市,楊梅區,0950,614,353,967,36,1003,2101,47.74%,29.22%,1
桃園市,楊梅區,0951,610,411,1021,42,1063,2054,51.75%,29.7%,1
桃園市,楊梅區,0952,632,367,999,29,1028,2226,46.18%,28.39%,1
桃園市,楊梅區,0953,488,269,757,14,771,1405,54.88%,34.73%,1
桃園市,楊梅區,0954,525,322,847,26,873,1843,47.37%,28.49%,1
桃園市,楊梅區,0955,593,390,983,53,1036,2324,44.58%,25.52%,1
桃園市,楊梅區,0956,570,310,880,25,905,1713,52.83%,33.27%,1
桃園市,楊梅區,0957,630,271,901,40,941,1587,59.29%,39.7%,1
桃園市,楊梅區,0958,517,276,793,29,822,1416,58.05%,36.51%,1
桃園市,楊梅區,0959,538,308,846,27,873,1591,54.87%,33.82%,1
桃園市,楊梅區,0960,600,400,1000,31,1031,1943,53.06%,30.88%,1
桃園市,楊梅區,0961,604,310,914,28,942,1762,53.46%,34.28%,1
桃園市,楊梅區,0962,373,201,574,17,591,1083,54.57%,34.44%,1
桃園市,楊梅區,0963,645,360,1005,43,1048,2027,51.7%,31.82%,1
桃園市,楊梅區,0964,438,259,697,38,735,1274,57.69%,34.38%,1
桃園市,楊梅區,0965,486,268,754,36,790,1359,58.13%,35.76%,1
桃園市,楊梅區,0966,503,328,831,37,868,2444,35.52%,20.58%,1
桃園市,楊梅區,0967,609,395,1004,28,1032,2298,44.91%,26.5%,1
桃園市,楊梅區,0968,640,432,1072,24,1096,2222,49.32%,28.8%,1
桃園市,楊梅區,0969,519,290,809,57,866,1610,53.79%,32.24%,1
桃園市,楊梅區,0970,541,284,825,46,871,1627,53.53%,33.25%,1
桃園市,楊梅區,0971,507,321,828,46,874,1589,55%,31.91%,1
桃園市,楊梅區,0972,549,344,893,41,934,1758,53.13%,31.23%,1
桃園市,楊梅區,0973,412,321,733,40,773,1776,43.52%,23.2%,1
桃園市,楊梅區,0974,236,233,469,17,486,1000,48.6%,23.6%,1
桃園市,楊梅區,0975,621,322,943,112,1055,2290,46.07%,27.12%,1
桃園市,楊梅區,0976,433,338,771,46,817,1551,52.68%,27.92%,1
桃園市,楊梅區,0977,513,378,891,46,937,1861,50.35%,27.57%,1
桃園市,楊梅區,0978,280,208,488,53,541,1141,47.41%,24.54%,1
桃園市,楊梅區,0979,515,309,824,43,867,1785,48.57%,28.85%,1
桃園市,楊梅區,0980,448,297,745,55,800,1498,53.4%,29.91%,1
桃園市,楊梅區,0981,311,258,569,51,620,1187,52.23%,26.2%,1
桃園市,楊梅區,0982,419,246,665,46,711,1270,55.98%,32.99%,1
桃園市,楊梅區,0983,434,270,704,45,749,1424,52.6%,30.48%,1
桃園市,楊梅區,0984,488,275,763,17,780,1273,61.27%,38.33%,1
桃園市,楊梅區,0985,394,298,692,36,728,1534,47.46%,25.68%,1
桃園市,楊梅區,0986,425,339,764,52,816,1783,45.77%,23.84%,1
桃園市,楊梅區,0987,509,27,536,31,567,1709,33.18%,29.78%,1
桃園市,楊梅區,0988,516,330,846,42,888,1920,46.25%,26.88%,1
桃園市,楊梅區,0989,366,256,622,30,652,1194,54.61%,30.65%,1
桃園市,楊梅區,0990,455,292,747,17,764,1408,54.26%,32.32%,1
桃園市,楊梅區,0991,555,200,755,29,784,1737,45.14%,31.95%,1
桃園市,楊梅區,0992,591,333,924,31,955,1920,49.74%,30.78%,1
桃園市,楊梅區,0993,366,252,618,35,653,1234,52.92%,29.66%,1
桃園市,楊梅區,0994,458,319,777,53,830,1491,55.67%,30.72%,1
桃園市,楊梅區,0995,552,363,915,30,945,2020,46.78%,27.33%,1
桃園市,楊梅區,0996,495,333,828,28,856,1863,45.95%,26.57%,1
桃園市,楊梅區,0997,508,360,868,48,916,1692,54.14%,30.02%,1
桃園市,楊梅區,0998,501,351,852,21,873,1686,51.78%,29.72%,1
桃園市,楊梅區,0999,497,343,840,48,888,1626,54.61%,30.57%,1
桃園市,楊梅區,1000,520,301,821,25,846,1557,54.34%,33.4%,1
桃園市,楊梅區,1001,571,317,888,41,929,1603,57.95%,35.62%,1
桃園市,楊梅區,1002,515,355,870,66,936,1889,49.55%,27.26%,1
桃園市,楊梅區,1003,470,298,768,42,810,1448,55.94%,32.46%,1
桃園市,楊梅區,1004,432,290,722,41,763,1351,56.48%,31.98%,1
桃園市,楊梅區,1005,457,269,726,42,768,1313,58.49%,34.81%,1
桃園市,楊梅區,1006,496,335,831,49,880,1689,52.1%,29.37%,1
桃園市,楊梅區,1007,571,381,952,24,976,2063,47.31%,27.68%,1
桃園市,蘆竹區,0396,393,249,642,74,716,1358,52.72%,28.94%,1
桃園市,蘆竹區,0397,440,285,725,51,776,1538,50.46%,28.61%,1
桃園市,蘆竹區,0398,532,322,854,49,903,2118,42.63%,25.12%,1
桃園市,蘆竹區,0399,536,343,879,62,941,1673,56.25%,32.04%,1
桃園市,蘆竹區,0400,482,369,851,30,881,1500,58.73%,32.13%,1
桃園市,蘆竹區,0401,546,325,871,38,909,1699,53.5%,32.14%,1
桃園市,蘆竹區,0402,696,426,1122,27,1149,2250,51.07%,30.93%,1
桃園市,蘆竹區,0403,614,424,1038,15,1053,2354,44.73%,26.08%,1
桃園市,蘆竹區,0404,391,302,693,26,719,1446,49.72%,27.04%,1
桃園市,蘆竹區,0405,445,293,738,39,777,1623,47.87%,27.42%,1
桃園市,蘆竹區,0406,509,328,837,28,865,1747,49.51%,29.14%,1
桃園市,蘆竹區,0407,600,384,984,42,1026,1988,51.61%,30.18%,1
桃園市,蘆竹區,0408,470,258,728,33,761,1437,52.96%,32.71%,1
桃園市,蘆竹區,0409,487,337,824,39,863,1532,56.33%,31.79%,1
桃園市,蘆竹區,0410,397,312,709,37,746,1447,51.55%,27.44%,1
桃園市,蘆竹區,0411,665,423,1088,39,1127,2189,51.48%,30.38%,1
桃園市,蘆竹區,0412,709,428,1137,40,1177,2498,47.12%,28.38%,1
桃園市,蘆竹區,0413,406,289,695,30,725,1322,54.84%,30.71%,1
桃園市,蘆竹區,0414,455,330,785,72,857,1991,43.04%,22.85%,1
桃園市,蘆竹區,0415,539,379,918,70,988,2097,47.11%,25.7%,1
桃園市,蘆竹區,0416,500,322,822,31,853,1558,54.75%,32.09%,1
桃園市,蘆竹區,0417,400,563,963,31,994,1891,52.56%,21.15%,1
桃園市,蘆竹區,0418,472,278,750,23,773,1590,48.62%,29.69%,1
桃園市,蘆竹區,0419,625,420,1045,39,1084,2404,45.09%,26%,1
桃園市,蘆竹區,0420,736,481,1217,32,1249,2522,49.52%,29.18%,1
桃園市,蘆竹區,0421,484,329,813,29,842,1633,51.56%,29.64%,1
桃園市,蘆竹區,0422,520,331,851,37,888,1715,51.78%,30.32%,1
桃園市,蘆竹區,0423,616,398,1014,20,1034,2215,46.68%,27.81%,1
桃園市,蘆竹區,0424,548,365,913,40,953,2029,46.97%,27.01%,1
桃園市,蘆竹區,0425,472,317,789,25,814,1731,47.02%,27.27%,1
桃園市,蘆竹區,0426,551,341,892,32,924,1820,50.77%,30.27%,1
桃園市,蘆竹區,0427,500,345,845,37,882,1633,54.01%,30.62%,1
桃園市,蘆竹區,0428,501,283,784,19,803,1668,48.14%,30.04%,1
桃園市,蘆竹區,0429,477,314,791,21,812,1493,54.39%,31.95%,1
桃園市,蘆竹區,0430,577,369,946,32,978,1864,52.47%,30.95%,1
桃園市,蘆竹區,0431,472,338,810,29,839,1703,49.27%,27.72%,1
桃園市,蘆竹區,0432,564,398,962,21,983,1893,51.93%,29.79%,1
桃園市,蘆竹區,0433,648,387,1035,27,1062,1922,55.25%,33.71%,1
桃園市,蘆竹區,0434,484,260,744,16,760,1393,54.56%,34.75%,1
桃園市,蘆竹區,0435,440,280,720,19,739,1338,55.23%,32.88%,1
桃園市,蘆竹區,0436,530,298,828,27,855,1688,50.65%,31.4%,1
桃園市,蘆竹區,0437,440,266,706,46,752,1462,51.44%,30.1%,1
桃園市,蘆竹區,0438,354,275,629,22,651,1232,52.84%,28.73%,1
桃園市,蘆竹區,0439,365,255,620,25,645,1356,47.57%,26.92%,1
桃園市,蘆竹區,0440,418,263,681,37,718,1181,60.8%,35.39%,1
桃園市,蘆竹區,0441,343,247,590,21,611,1199,50.96%,28.61%,1
桃園市,蘆竹區,0442,545,340,885,19,904,1710,52.87%,31.87%,1
桃園市,蘆竹區,0443,394,295,689,24,713,1423,50.11%,27.69%,1
桃園市,蘆竹區,0444,457,337,794,24,818,1522,53.75%,30.03%,1
桃園市,蘆竹區,0445,547,325,872,26,898,1639,54.79%,33.37%,1
桃園市,蘆竹區,0446,606,387,993,36,1029,2055,50.07%,29.49%,1
桃園市,蘆竹區,0447,611,457,1068,22,1090,2178,50.05%,28.05%,1
桃園市,蘆竹區,0448,521,374,895,23,918,1709,53.72%,30.49%,1
桃園市,蘆竹區,0449,547,329,876,42,918,1667,55.07%,32.81%,1
桃園市,蘆竹區,0450,590,339,929,16,945,1745,54.15%,33.81%,1
桃園市,蘆竹區,0451,632,411,1043,33,1076,1967,54.7%,32.13%,1
桃園市,蘆竹區,0452,640,341,981,29,1010,1802,56.05%,35.52%,1
桃園市,蘆竹區,0453,813,482,1295,29,1324,2727,48.55%,29.81%,1
桃園市,蘆竹區,0454,507,357,864,24,888,1868,47.54%,27.14%,1
桃園市,蘆竹區,0455,449,300,749,34,783,1537,50.94%,29.21%,1
桃園市,蘆竹區,0456,470,352,822,27,849,1616,52.54%,29.08%,1
桃園市,蘆竹區,0457,509,323,832,27,859,1483,57.92%,34.32%,1
桃園市,蘆竹區,0458,492,317,809,38,847,1689,50.15%,29.13%,1
桃園市,蘆竹區,0459,354,181,535,33,568,1318,43.1%,26.86%,1
桃園市,蘆竹區,0460,435,244,679,88,767,1203,63.76%,36.16%,1
桃園市,蘆竹區,0461,509,307,816,28,844,1771,47.66%,28.74%,1
桃園市,蘆竹區,0462,482,347,829,47,876,1832,47.82%,26.31%,1
桃園市,蘆竹區,0463,505,331,836,54,890,1763,50.48%,28.64%,1
桃園市,蘆竹區,0464,379,281,660,19,679,1497,45.36%,25.32%,1
桃園市,蘆竹區,0465,494,401,895,98,993,1671,59.43%,29.56%,1
桃園市,蘆竹區,0466,283,213,496,41,537,929,57.8%,30.46%,1
桃園市,蘆竹區,0467,501,325,826,54,880,1559,56.45%,32.14%,1
桃園市,蘆竹區,0468,527,265,792,21,813,1497,54.31%,35.2%,1
桃園市,蘆竹區,0469,551,316,867,45,912,1441,63.29%,38.24%,1
桃園市,蘆竹區,0470,406,300,706,45,751,1465,51.26%,27.71%,1
桃園市,蘆竹區,0471,291,215,506,29,535,1029,51.99%,28.28%,1
桃園市,大園區,0472,393,287,680,30,710,1538,46.16%,25.55%,1
桃園市,大園區,0473,362,284,646,19,665,1616,41.15%,22.4%,1
桃園市,大園區,0474,450,326,776,38,814,1437,56.65%,31.32%,1
桃園市,大園區,0475,518,312,830,31,861,1554,55.41%,33.33%,1
桃園市,大園區,0476,346,270,616,27,643,1237,51.98%,27.97%,1
桃園市,大園區,0477,382,265,647,48,695,1347,51.6%,28.36%,1
桃園市,大園區,0478,359,274,633,24,657,1261,52.1%,28.47%,1
桃園市,大園區,0479,354,258,612,26,638,1256,50.8%,28.18%,1
桃園市,大園區,0480,339,283,622,27,649,1370,47.37%,24.74%,1
桃園市,大園區,0481,382,327,709,37,746,1610,46.34%,23.73%,1
桃園市,大園區,0482,407,267,674,39,713,1419,50.25%,28.68%,1
桃園市,大園區,0483,393,236,629,32,661,1588,41.62%,24.75%,1
桃園市,大園區,0484,432,338,770,45,815,1612,50.56%,26.8%,1
桃園市,大園區,0485,382,297,679,40,719,1440,49.93%,26.53%,1
桃園市,大園區,0486,339,275,614,36,650,1326,49.02%,25.57%,1
桃園市,大園區,0487,474,299,773,48,821,1455,56.43%,32.58%,1
桃園市,大園區,0488,452,349,801,40,841,1562,53.84%,28.94%,1
桃園市,大園區,0489,412,291,703,28,731,1284,56.93%,32.09%,1
桃園市,大園區,0490,371,305,676,14,690,1454,47.46%,25.52%,1
桃園市,大園區,0491,432,306,738,21,759,1490,50.94%,28.99%,1
桃園市,大園區,0492,459,284,743,32,775,1617,47.93%,28.39%,1
桃園市,大園區,0493,465,337,802,32,834,1594,52.32%,29.17%,1
桃園市,大園區,0494,461,331,792,49,841,1650,50.97%,27.94%,1
桃園市,大園區,0495,397,307,704,15,719,1467,49.01%,27.06%,1
桃園市,大園區,0496,428,312,740,29,769,1494,51.47%,28.65%,1
桃園市,大園區,0497,431,319,750,34,784,1538,50.98%,28.02%,1
桃園市,大園區,0498,394,307,701,24,725,1397,51.9%,28.2%,1
桃園市,大園區,0499,455,309,764,23,787,1637,48.08%,27.79%,1
桃園市,大園區,0500,396,273,669,33,702,1452,48.35%,27.27%,1
桃園市,大園區,0501,515,313,828,48,876,1414,61.95%,36.42%,1
桃園市,大園區,0502,530,304,834,32,866,1670,51.86%,31.74%,1
桃園市,大園區,0503,503,301,804,16,820,1701,48.21%,29.57%,1
桃園市,大園區,0504,491,292,783,21,804,1813,44.35%,27.08%,1
桃園市,大園區,0505,457,338,795,24,819,1687,48.55%,27.09%,1
桃園市,大園區,0506,509,331,840,5,845,1650,51.21%,30.85%,1
桃園市,大園區,0507,481,359,840,44,884,1556,56.81%,30.91%,1
桃園市,大園區,0508,440,360,800,27,827,1844,44.85%,23.86%,1
桃園市,大園區,0509,353,251,604,49,653,1336,48.88%,26.42%,1
桃園市,大園區,0510,421,329,750,38,788,1414,55.73%,29.77%,1
桃園市,大園區,0511,421,302,723,35,758,1238,61.23%,34.01%,1
桃園市,大園區,0512,424,281,705,35,740,1227,60.31%,34.56%,1
桃園市,大園區,0513,319,278,597,24,621,1199,51.79%,26.61%,1
桃園市,大園區,0514,347,262,609,24,633,1349,46.92%,25.72%,1
桃園市,大園區,0515,308,240,548,31,579,1120,51.7%,27.5%,1
桃園市,大園區,0516,302,253,555,22,577,1080,53.43%,27.96%,1
桃園市,大園區,0517,379,247,626,34,660,1341,49.22%,28.26%,1
桃園市,大園區,0518,383,307,690,23,713,1345,53.01%,28.48%,1
桃園市,大園區,0519,391,281,672,34,706,1565,45.11%,24.98%,1
桃園市,大園區,0520,354,274,628,32,660,1519,43.45%,23.3%,1
桃園市,大園區,0521,547,387,934,42,976,2130,45.82%,25.68%,1
桃園市,龜山區,0217,318,145,463,24,487,874,55.72%,36.38%,1
桃園市,龜山區,0218,711,312,1023,58,1081,2014,53.67%,35.3%,1
桃園市,龜山區,0219,594,439,1033,23,1056,2145,49.23%,27.69%,1
桃園市,龜山區,0220,644,253,897,47,944,1744,54.13%,36.93%,1
桃園市,龜山區,0221,673,291,964,48,1012,1885,53.69%,35.7%,1
桃園市,龜山區,0222,459,249,708,49,757,1546,48.97%,29.69%,1
桃園市,龜山區,0223,472,318,790,49,839,1684,49.82%,28.03%,1
桃園市,龜山區,0224,381,275,656,37,693,1477,46.92%,25.8%,1
桃園市,龜山區,0225,568,262,830,45,875,1528,57.26%,37.17%,1
桃園市,龜山區,0226,156,126,282,11,293,1428,20.52%,10.92%,1
桃園市,龜山區,0227,480,312,792,43,835,1525,54.75%,31.48%,1
桃園市,龜山區,0228,339,237,576,33,609,1041,58.5%,32.56%,1
桃園市,龜山區,0229,385,303,688,31,719,1404,51.21%,27.42%,1
桃園市,龜山區,0230,497,279,776,41,817,1478,55.28%,33.63%,1
桃園市,龜山區,0231,684,400,1084,54,1138,2178,52.25%,31.4%,1
桃園市,龜山區,0232,506,333,839,62,901,1672,53.89%,30.26%,1
桃園市,龜山區,0233,379,273,652,33,685,1376,49.78%,27.54%,1
桃園市,龜山區,0234,403,320,723,32,755,1480,51.01%,27.23%,1
桃園市,龜山區,0235,387,270,657,34,691,1258,54.93%,30.76%,1
桃園市,龜山區,0236,427,305,732,32,764,1464,52.19%,29.17%,1
桃園市,龜山區,0237,487,394,881,64,945,1844,51.25%,26.41%,1
桃園市,龜山區,0238,322,269,591,22,613,1169,52.44%,27.54%,1
桃園市,龜山區,0239,424,298,722,41,763,1921,39.72%,22.07%,1
桃園市,龜山區,0240,429,349,778,32,810,1694,47.82%,25.32%,1
桃園市,龜山區,0241,647,280,927,55,982,1771,55.45%,36.53%,1
桃園市,龜山區,0242,437,302,739,45,784,1665,47.09%,26.25%,1
桃園市,龜山區,0243,385,303,688,51,739,1439,51.36%,26.75%,1
桃園市,龜山區,0244,461,276,737,54,791,1728,45.78%,26.68%,1
桃園市,龜山區,0245,525,375,900,35,935,1788,52.29%,29.36%,1
桃園市,龜山區,0246,372,296,668,36,704,1465,48.05%,25.39%,1
桃園市,龜山區,0247,367,283,650,46,696,1659,41.95%,22.12%,1
桃園市,龜山區,0248,396,315,711,35,746,1693,44.06%,23.39%,1
桃園市,龜山區,0249,386,306,692,15,707,1818,38.89%,21.23%,1
桃園市,龜山區,0250,468,384,852,43,895,1752,51.08%,26.71%,1
桃園市,龜山區,0251,523,404,927,19,946,1818,52.04%,28.77%,1
桃園市,龜山區,0252,438,311,749,18,767,1499,51.17%,29.22%,1
桃園市,龜山區,0253,545,394,939,40,979,1916,51.1%,28.44%,1
桃園市,龜山區,0254,512,389,901,25,926,1804,51.33%,28.38%,1
桃園市,龜山區,0255,594,392,986,37,1023,2127,48.1%,27.93%,1
桃園市,龜山區,0256,268,225,493,50,543,1005,54.03%,26.67%,1
桃園市,龜山區,0257,407,326,733,32,765,1449,52.8%,28.09%,1
桃園市,龜山區,0258,364,312,676,51,727,1498,48.53%,24.3%,1
桃園市,龜山區,0259,523,380,903,53,956,2149,44.49%,24.34%,1
桃園市,龜山區,0260,401,276,677,38,715,1771,40.37%,22.64%,1
桃園市,龜山區,0261,235,187,422,25,447,841,53.15%,27.94%,1
桃園市,龜山區,0262,586,407,993,53,1046,2284,45.8%,25.66%,1
桃園市,龜山區,0263,339,271,610,42,652,1228,53.09%,27.61%,1
桃園市,龜山區,0264,506,356,862,35,897,1979,45.33%,25.57%,1
桃園市,龜山區,0265,370,238,608,44,652,1378,47.31%,26.85%,1
桃園市,龜山區,0266,295,200,495,41,536,1061,50.52%,27.8%,1
桃園市,龜山區,0267,541,346,887,37,924,1917,48.2%,28.22%,1
桃園市,龜山區,0268,496,371,867,35,902,1540,58.57%,32.21%,1
桃園市,龜山區,0269,440,314,754,24,778,1433,54.29%,30.7%,1
桃園市,龜山區,0270,388,336,724,26,750,1455,51.55%,26.67%,1
桃園市,龜山區,0271,669,491,1160,59,1219,2280,53.46%,29.34%,1
桃園市,龜山區,0272,486,340,826,36,862,1668,51.68%,29.14%,1
桃園市,龜山區,0273,509,369,878,44,922,1885,48.91%,27%,1
桃園市,龜山區,0274,489,407,896,12,908,1849,49.11%,26.45%,1
桃園市,龜山區,0275,482,447,929,17,946,1704,55.52%,28.29%,1
桃園市,龜山區,0276,327,260,587,30,617,1156,53.37%,28.29%,1
桃園市,龜山區,0277,487,365,852,45,897,2114,42.43%,23.04%,1
桃園市,龜山區,0278,446,363,809,37,846,1943,43.54%,22.95%,1
桃園市,龜山區,0279,462,355,817,25,842,1800,46.78%,25.67%,1
桃園市,龜山區,0280,528,408,936,46,982,2020,48.61%,26.14%,1
桃園市,龜山區,0281,411,293,704,27,731,1319,55.42%,31.16%,1
桃園市,龜山區,0282,640,509,1149,35,1184,2229,53.12%,28.71%,1
桃園市,龜山區,0283,526,398,924,29,953,1992,47.84%,26.41%,1
桃園市,龜山區,0284,562,444,1006,50,1056,2237,47.21%,25.12%,1
桃園市,龜山區,0285,570,421,991,35,1026,2133,48.1%,26.72%,1
桃園市,龜山區,0286,608,456,1064,41,1105,2187,50.53%,27.8%,1
桃園市,龜山區,0287,501,411,912,40,952,1959,48.6%,25.57%,1
桃園市,龜山區,0288,470,403,873,19,892,1910,46.7%,24.61%,1
桃園市,龜山區,0289,578,347,925,54,979,1840,53.21%,31.41%,1
桃園市,龜山區,0290,651,446,1097,36,1133,2266,50%,28.73%,1
桃園市,龜山區,0291,643,411,1054,23,1077,2387,45.12%,26.94%,1
桃園市,龜山區,0292,482,312,794,19,813,1692,48.05%,28.49%,1
桃園市,龜山區,0293,245,205,450,16,466,904,51.55%,27.1%,1
桃園市,龜山區,0294,440,314,754,30,784,1469,53.37%,29.95%,1
桃園市,八德區,0295,462,313,775,57,832,1761,47.25%,26.24%,1
桃園市,八德區,0296,425,292,717,19,736,1804,40.8%,23.56%,1
桃園市,八德區,0297,272,220,492,14,506,1813,27.91%,15%,1
桃園市,八德區,0298,457,347,804,22,826,1784,46.3%,25.62%,1
桃園市,八德區,0299,576,346,922,24,946,2257,41.91%,25.52%,1
桃園市,八德區,0300,479,291,770,28,798,1857,42.97%,25.79%,1
桃園市,八德區,0301,574,393,967,31,998,2261,44.14%,25.39%,1
桃園市,八德區,0302,545,383,928,47,975,1903,51.23%,28.64%,1
桃園市,八德區,0303,578,332,910,72,982,1955,50.23%,29.57%,1
桃園市,八德區,0304,415,303,718,21,739,1665,44.38%,24.92%,1
桃園市,八德區,0305,409,317,726,53,779,1431,54.44%,28.58%,1
桃園市,八德區,0306,406,270,676,25,701,1263,55.5%,32.15%,1
桃園市,八德區,0307,530,313,843,45,888,1583,56.1%,33.48%,1
桃園市,八德區,0308,397,254,651,33,684,1246,54.9%,31.86%,1
桃園市,八德區,0309,421,277,698,32,730,1356,53.83%,31.05%,1
桃園市,八德區,0310,518,317,835,67,902,1630,55.34%,31.78%,1
桃園市,八德區,0311,499,283,782,33,815,1586,51.39%,31.46%,1
桃園市,八德區,0312,472,337,809,61,870,1649,52.76%,28.62%,1
桃園市,八德區,0313,477,349,826,71,897,1910,46.96%,24.97%,1
桃園市,八德區,0314,487,342,829,72,901,1612,55.89%,30.21%,1
桃園市,八德區,0315,527,290,817,41,858,1640,52.32%,32.13%,1
桃園市,八德區,0316,367,272,639,36,675,1303,51.8%,28.17%,1
桃園市,八德區,0317,429,339,768,43,811,1413,57.4%,30.36%,1
桃園市,八德區,0318,470,369,839,36,875,1711,51.14%,27.47%,1
桃園市,八德區,0319,468,311,779,62,841,1562,53.84%,29.96%,1
桃園市,八德區,0320,536,300,836,47,883,1735,50.89%,30.89%,1
桃園市,八德區,0321,485,335,820,28,848,1658,51.15%,29.25%,1
桃園市,八德區,0322,352,103,455,37,492,1022,48.14%,34.44%,1
桃園市,八德區,0323,431,298,729,40,769,1673,45.97%,25.76%,1
桃園市,八德區,0324,526,313,839,32,871,1741,50.03%,30.21%,1
桃園市,八德區,0325,613,399,1012,59,1071,2110,50.76%,29.05%,1
桃園市,八德區,0326,387,208,595,23,618,1145,53.97%,33.8%,1
桃園市,八德區,0327,386,204,590,28,618,1010,61.19%,38.22%,1
桃園市,八德區,0328,449,346,795,22,817,1848,44.21%,24.3%,1
桃園市,八德區,0329,433,265,698,29,727,1334,54.5%,32.46%,1
桃園市,八德區,0330,356,219,575,22,597,1349,44.26%,26.39%,1
桃園市,八德區,0331,399,331,730,41,771,1341,57.49%,29.75%,1
桃園市,八德區,0332,400,257,657,32,689,1178,58.49%,33.96%,1
桃園市,八德區,0333,397,312,709,41,750,1374,54.59%,28.89%,1
桃園市,八德區,0334,371,319,690,50,740,1462,50.62%,25.38%,1
桃園市,八德區,0335,494,300,794,73,867,1943,44.62%,25.42%,1
桃園市,八德區,0336,399,276,675,70,745,1928,38.64%,20.7%,1
桃園市,八德區,0337,399,286,685,17,702,1403,50.04%,28.44%,1
桃園市,八德區,0338,447,308,755,49,804,1672,48.09%,26.73%,1
桃園市,八德區,0339,469,400,869,40,909,1947,46.69%,24.09%,1
桃園市,八德區,0340,348,270,618,41,659,1200,54.92%,29%,1
桃園市,八德區,0341,497,357,854,48,902,1895,47.6%,26.23%,1
桃園市,八德區,0342,484,375,859,56,915,1988,46.03%,24.35%,1
桃園市,八德區,0343,574,412,986,65,1051,2006,52.39%,28.61%,1
桃園市,八德區,0344,526,393,919,13,932,2061,45.22%,25.52%,1
桃園市,八德區,0345,512,398,910,61,971,2108,46.06%,24.29%,1
桃園市,八德區,0346,514,334,848,48,896,1862,48.12%,27.6%,1
桃園市,八德區,0347,465,231,696,27,723,1681,43.01%,27.66%,1
桃園市,八德區,0348,376,287,663,50,713,1317,54.14%,28.55%,1
桃園市,八德區,0349,591,527,1118,48,1166,2093,55.71%,28.24%,1
桃園市,八德區,0350,461,347,808,46,854,1499,56.97%,30.75%,1
桃園市,八德區,0351,518,342,860,47,907,1782,50.9%,29.07%,1
桃園市,八德區,0352,533,352,885,18,903,1763,51.22%,30.23%,1
桃園市,八德區,0353,381,249,630,41,671,1226,54.73%,31.08%,1
桃園市,八德區,0354,410,292,702,25,727,1311,55.45%,31.27%,1
桃園市,八德區,0355,334,296,630,37,667,1170,57.01%,28.55%,1
桃園市,八德區,0356,435,267,702,28,730,1313,55.6%,33.13%,1
桃園市,八德區,0357,352,283,635,23,658,1186,55.48%,29.68%,1
桃園市,八德區,0358,404,282,686,38,724,1481,48.89%,27.28%,1
桃園市,八德區,0359,550,420,970,57,1027,1998,51.4%,27.53%,1
桃園市,八德區,0360,302,188,490,26,516,916,56.33%,32.97%,1
桃園市,八德區,0361,559,338,897,30,927,1943,47.71%,28.77%,1
桃園市,八德區,0362,591,366,957,30,987,2076,47.54%,28.47%,1
桃園市,八德區,0363,427,256,683,53,736,1363,54%,31.33%,1
桃園市,八德區,0364,462,279,741,47,788,1491,52.85%,30.99%,1
桃園市,八德區,0365,426,289,715,49,764,1474,51.83%,28.9%,1
桃園市,八德區,0366,93,67,160,14,174,718,24.23%,12.95%,1
桃園市,八德區,0367,385,302,687,44,731,1386,52.74%,27.78%,1
桃園市,八德區,0368,470,247,717,57,774,1487,52.05%,31.61%,1
桃園市,八德區,0369,502,238,740,74,814,1552,52.45%,32.35%,1
桃園市,八德區,0370,367,205,572,46,618,1255,49.24%,29.24%,1
桃園市,八德區,0371,548,251,799,46,845,1505,56.15%,36.41%,1
桃園市,八德區,0372,401,262,663,39,702,1436,48.89%,27.92%,1
桃園市,八德區,0373,441,388,829,54,883,1618,54.57%,27.26%,1
桃園市,八德區,0374,528,279,807,52,859,1685,50.98%,31.34%,1
桃園市,八德區,0375,558,249,807,46,853,1835,46.49%,30.41%,1
桃園市,八德區,0376,526,382,908,43,951,1881,50.56%,27.96%,1
桃園市,八德區,0377,502,323,825,45,870,1766,49.26%,28.43%,1
桃園市,八德區,0378,522,328,850,79,929,1817,51.13%,28.73%,1
桃園市,八德區,0379,681,426,1107,27,1134,2198,51.59%,30.98%,1
桃園市,八德區,0380,488,383,871,32,903,1732,52.14%,28.18%,1
桃園市,八德區,0381,619,444,1063,17,1080,2089,51.7%,29.63%,1
桃園市,八德區,0382,420,272,692,33,725,1257,57.68%,33.41%,1
桃園市,八德區,0383,357,266,623,34,657,1267,51.85%,28.18%,1
桃園市,八德區,0384,467,290,757,22,779,1427,54.59%,32.73%,1
桃園市,八德區,0385,575,347,922,53,975,1685,57.86%,34.12%,1
桃園市,八德區,0386,556,350,906,40,946,1748,54.12%,31.81%,1
桃園市,八德區,0387,743,336,1079,51,1130,1650,68.48%,45.03%,1
桃園市,八德區,0388,426,340,766,41,807,1478,54.6%,28.82%,1
桃園市,八德區,0389,512,309,821,45,866,1607,53.89%,31.86%,1
桃園市,八德區,0390,583,387,970,53,1023,1841,55.57%,31.67%,1
桃園市,八德區,0391,596,431,1027,41,1068,2082,51.3%,28.63%,1
桃園市,八德區,0392,530,337,867,51,918,1959,46.86%,27.05%,1
桃園市,八德區,0393,605,483,1088,49,1137,2209,51.47%,27.39%,1
桃園市,八德區,0394,582,350,932,43,975,1864,52.31%,31.22%,1
桃園市,八德區,0395,528,405,933,38,971,2000,48.55%,26.4%,1
桃園市,龍潭區,1008,482,273,755,26,781,1482,52.7%,32.52%,1
桃園市,龍潭區,1009,453,285,738,36,774,1528,50.65%,29.65%,1
桃園市,龍潭區,1010,471,307,778,31,809,1503,53.83%,31.34%,1
桃園市,龍潭區,1011,490,266,756,38,794,1568,50.64%,31.25%,1
桃園市,龍潭區,1012,383,204,587,44,631,1216,51.89%,31.5%,1
桃園市,龍潭區,1013,593,308,901,48,949,2088,45.45%,28.4%,1
桃園市,龍潭區,1014,656,390,1046,66,1112,1987,55.96%,33.01%,1
桃園市,龍潭區,1015,595,239,834,72,906,1586,57.12%,37.52%,1
桃園市,龍潭區,1016,372,240,612,23,635,1221,52.01%,30.47%,1
桃園市,龍潭區,1017,400,219,619,27,646,1134,56.97%,35.27%,1
桃園市,龍潭區,1018,602,370,972,35,1007,2081,48.39%,28.93%,1
桃園市,龍潭區,1019,594,306,900,31,931,1925,48.36%,30.86%,1
桃園市,龍潭區,1020,728,380,1108,28,1136,2095,54.22%,34.75%,1
桃園市,龍潭區,1021,799,340,1139,31,1170,2040,57.35%,39.17%,1
桃園市,龍潭區,1022,508,330,838,52,890,1790,49.72%,28.38%,1
桃園市,龍潭區,1023,565,387,952,63,1015,1872,54.22%,30.18%,1
桃園市,龍潭區,1024,621,327,948,43,991,1726,57.42%,35.98%,1
桃園市,龍潭區,1025,588,339,927,44,971,1792,54.19%,32.81%,1
桃園市,龍潭區,1026,490,266,756,25,781,1398,55.87%,35.05%,1
桃園市,龍潭區,1027,400,266,666,24,690,1345,51.3%,29.74%,1
桃園市,龍潭區,1028,447,278,725,33,758,1409,53.8%,31.72%,1
桃園市,龍潭區,1029,378,269,647,25,672,1362,49.34%,27.75%,1
桃園市,龍潭區,1030,559,350,909,28,937,1650,56.79%,33.88%,1
桃園市,龍潭區,1031,512,273,785,46,831,1597,52.04%,32.06%,1
桃園市,龍潭區,1032,433,295,728,22,750,1410,53.19%,30.71%,1
桃園市,龍潭區,1033,424,256,680,28,708,1275,55.53%,33.25%,1
桃園市,龍潭區,1034,678,397,1075,39,1114,1909,58.36%,35.52%,1
桃園市,龍潭區,1035,721,375,1096,23,1119,2024,55.29%,35.62%,1
桃園市,龍潭區,1036,689,351,1040,37,1077,2002,53.8%,34.42%,1
桃園市,龍潭區,1037,642,334,976,35,1011,1786,56.61%,35.95%,1
桃園市,龍潭區,1038,594,324,918,29,947,1756,53.93%,33.83%,1
桃園市,龍潭區,1039,657,321,978,17,995,1830,54.37%,35.9%,1
桃園市,龍潭區,1040,722,253,975,29,1004,1697,59.16%,42.55%,1
桃園市,龍潭區,1041,549,269,818,44,862,1519,56.75%,36.14%,1
桃園市,龍潭區,1042,569,311,880,39,919,1805,50.91%,31.52%,1
桃園市,龍潭區,1043,520,268,788,23,811,1792,45.26%,29.02%,1
桃園市,龍潭區,1044,549,297,846,39,885,1500,59%,36.6%,1
桃園市,龍潭區,1045,454,243,697,21,718,1427,50.32%,31.81%,1
桃園市,龍潭區,1046,392,237,629,29,658,1444,45.57%,27.15%,1
桃園市,龍潭區,1047,423,210,633,38,671,1321,50.79%,32.02%,1
桃園市,龍潭區,1048,450,242,692,29,721,1215,59.34%,37.04%,1
桃園市,龍潭區,1049,425,219,644,49,693,1297,53.43%,32.77%,1
桃園市,龍潭區,1050,457,233,690,17,707,1407,50.25%,32.48%,1
桃園市,龍潭區,1051,469,277,746,32,778,1564,49.74%,29.99%,1
桃園市,龍潭區,1052,413,249,662,39,701,1317,53.23%,31.36%,1
桃園市,龍潭區,1053,316,160,476,32,508,1023,49.66%,30.89%,1
桃園市,龍潭區,1054,619,308,927,36,963,1721,55.96%,35.97%,1
桃園市,龍潭區,1055,660,277,937,35,972,1764,55.1%,37.41%,1
桃園市,龍潭區,1056,491,289,780,44,824,1499,54.97%,32.76%,1
桃園市,龍潭區,1057,622,370,992,40,1032,2151,47.98%,28.92%,1
桃園市,龍潭區,1058,555,283,838,24,862,1524,56.56%,36.42%,1
桃園市,龍潭區,1059,552,299,851,25,876,1456,60.16%,37.91%,1
桃園市,龍潭區,1060,770,311,1081,29,1110,1847,60.1%,41.69%,1
桃園市,龍潭區,1061,798,326,1124,24,1148,1899,60.45%,42.02%,1
桃園市,龍潭區,1062,613,297,910,32,942,1725,54.61%,35.54%,1
桃園市,龍潭區,1063,649,311,960,55,1015,1665,60.96%,38.98%,1
桃園市,龍潭區,1064,481,304,785,35,820,1649,49.73%,29.17%,1
桃園市,龍潭區,1065,459,252,711,42,753,1539,48.93%,29.82%,1
桃園市,龍潭區,1066,575,274,849,35,884,1541,57.37%,37.31%,1
桃園市,龍潭區,1067,406,307,713,40,753,1375,54.76%,29.53%,1
桃園市,龍潭區,1068,440,323,763,28,791,1453,54.44%,30.28%,1
桃園市,龍潭區,1069,355,220,575,39,614,1074,57.17%,33.05%,1
桃園市,龍潭區,1070,466,269,735,25,760,1299,58.51%,35.87%,1
桃園市,龍潭區,1071,210,220,430,14,444,678,65.49%,30.97%,1
桃園市,平鎮區,0801,375,318,693,39,732,1487,49.23%,25.22%,1
桃園市,平鎮區,0802,439,284,723,42,765,1453,52.65%,30.21%,1
桃園市,平鎮區,0803,573,185,758,47,805,1491,53.99%,38.43%,1
桃園市,平鎮區,0804,375,289,664,40,704,1346,52.3%,27.86%,1
桃園市,平鎮區,0805,472,341,813,34,847,1660,51.02%,28.43%,1
桃園市,平鎮區,0806,550,345,895,42,937,1921,48.78%,28.63%,1
桃園市,平鎮區,0807,660,364,1024,45,1069,1974,54.15%,33.43%,1
桃園市,平鎮區,0808,501,390,891,44,935,1867,50.08%,26.83%,1
桃園市,平鎮區,0809,582,319,901,27,928,1786,51.96%,32.59%,1
桃園市,平鎮區,0810,389,269,658,28,686,1634,41.98%,23.81%,1
桃園市,平鎮區,0811,380,211,591,23,614,1080,56.85%,35.19%,1
桃園市,平鎮區,0812,458,305,763,36,799,1514,52.77%,30.25%,1
桃園市,平鎮區,0813,508,328,836,48,884,1918,46.09%,26.49%,1
桃園市,平鎮區,0814,347,260,607,58,665,1182,56.26%,29.36%,1
桃園市,平鎮區,0815,457,320,777,27,804,1667,48.23%,27.41%,1
桃園市,平鎮區,0816,448,186,634,31,665,1640,40.55%,27.32%,1
桃園市,平鎮區,0817,477,321,798,34,832,1603,51.9%,29.76%,1
桃園市,平鎮區,0818,529,335,864,11,875,1556,56.23%,34%,1
桃園市,平鎮區,0819,527,308,835,30,865,1697,50.97%,31.05%,1
桃園市,平鎮區,0820,356,210,566,19,585,1130,51.77%,31.5%,1
桃園市,平鎮區,0821,421,210,631,27,658,1196,55.02%,35.2%,1
桃園市,平鎮區,0822,523,338,861,29,890,1685,52.82%,31.04%,1
桃園市,平鎮區,0823,500,336,836,25,861,1532,56.2%,32.64%,1
桃園市,平鎮區,0824,491,316,807,33,840,1564,53.71%,31.39%,1
桃園市,平鎮區,0825,524,273,797,37,834,1824,45.72%,28.73%,1
桃園市,平鎮區,0826,562,362,924,20,944,1912,49.37%,29.39%,1
桃園市,平鎮區,0827,331,182,513,51,564,1048,53.82%,31.58%,1
桃園市,平鎮區,0828,444,227,671,36,707,1259,56.16%,35.27%,1
桃園市,平鎮區,0829,333,207,540,28,568,1061,53.53%,31.39%,1
桃園市,平鎮區,0830,408,211,619,24,643,1072,59.98%,38.06%,1
桃園市,平鎮區,0831,543,333,876,55,931,1788,52.07%,30.37%,1
桃園市,平鎮區,0832,468,303,771,26,797,1510,52.78%,30.99%,1
桃園市,平鎮區,0833,444,253,697,41,738,1403,52.6%,31.65%,1
桃園市,平鎮區,0834,445,284,729,38,767,1407,54.51%,31.63%,1
桃園市,平鎮區,0835,589,394,983,33,1016,1901,53.45%,30.98%,1
桃園市,平鎮區,0836,561,346,907,27,934,1994,46.84%,28.13%,1
桃園市,平鎮區,0837,518,346,864,38,902,1730,52.14%,29.94%,1
桃園市,平鎮區,0838,598,377,975,34,1009,1905,52.97%,31.39%,1
桃園市,平鎮區,0839,605,328,933,16,949,1723,55.08%,35.11%,1
桃園市,平鎮區,0840,458,240,698,36,734,1307,56.16%,35.04%,1
桃園市,平鎮區,0841,426,295,721,27,748,1337,55.95%,31.86%,1
桃園市,平鎮區,0842,363,252,615,25,640,980,65.31%,37.04%,1
桃園市,平鎮區,0843,550,345,895,39,934,1818,51.38%,30.25%,1
桃園市,平鎮區,0844,462,308,770,37,807,1463,55.16%,31.58%,1
桃園市,平鎮區,0845,439,263,702,25,727,1213,59.93%,36.19%,1
桃園市,平鎮區,0846,373,237,610,32,642,1085,59.17%,34.38%,1
桃園市,平鎮區,0847,475,244,719,4,723,1458,49.59%,32.58%,1
桃園市,平鎮區,0848,453,293,746,33,779,1408,55.33%,32.17%,1
桃園市,平鎮區,0849,427,264,691,33,724,1396,51.86%,30.59%,1
桃園市,平鎮區,0850,389,257,646,24,670,1044,64.18%,37.26%,1
桃園市,平鎮區,0851,406,210,616,16,632,1124,56.23%,36.12%,1
桃園市,平鎮區,0852,483,326,809,22,831,1517,54.78%,31.84%,1
桃園市,平鎮區,0853,487,327,814,16,830,1571,52.83%,31%,1
桃園市,平鎮區,0854,600,372,972,32,1004,1752,57.31%,34.25%,1
桃園市,平鎮區,0855,535,302,837,30,867,1434,60.46%,37.31%,1
桃園市,平鎮區,0856,578,379,957,22,979,1710,57.25%,33.8%,1
桃園市,平鎮區,0857,535,302,837,36,873,1555,56.14%,34.41%,1
桃園市,平鎮區,0858,603,366,969,25,994,2051,48.46%,29.4%,1
桃園市,平鎮區,0859,440,327,767,23,790,1477,53.49%,29.79%,1
桃園市,平鎮區,0860,494,311,805,17,822,1501,54.76%,32.91%,1
桃園市,平鎮區,0861,451,300,751,36,787,1405,56.01%,32.1%,1
桃園市,平鎮區,0862,500,326,826,50,876,1656,52.9%,30.19%,1
桃園市,平鎮區,0863,529,358,887,23,910,1921,47.37%,27.54%,1
桃園市,平鎮區,0864,498,306,804,39,843,1717,49.1%,29%,1
桃園市,平鎮區,0865,394,299,693,30,723,1319,54.81%,29.87%,1
桃園市,平鎮區,0866,499,345,844,48,892,1745,51.12%,28.6%,1
桃園市,平鎮區,0867,525,374,899,42,941,1721,54.68%,30.51%,1
桃園市,平鎮區,0868,382,272,654,19,673,1206,55.8%,31.67%,1
桃園市,平鎮區,0869,546,204,750,32,782,1202,65.06%,45.42%,1
桃園市,平鎮區,0870,407,269,676,29,705,1208,58.36%,33.69%,1
桃園市,平鎮區,0871,448,289,737,30,767,1267,60.54%,35.36%,1
桃園市,平鎮區,0872,371,215,586,27,613,1094,56.03%,33.91%,1
桃園市,平鎮區,0873,476,301,777,47,824,1394,59.11%,34.15%,1
桃園市,平鎮區,0874,426,281,707,26,733,1215,60.33%,35.06%,1
桃園市,平鎮區,0875,364,203,567,23,590,1010,58.42%,36.04%,1
桃園市,平鎮區,0876,430,269,699,28,727,1261,57.65%,34.1%,1
桃園市,平鎮區,0877,473,272,745,28,773,1314,58.83%,36%,1
桃園市,平鎮區,0878,248,142,390,32,422,722,58.45%,34.35%,1
桃園市,平鎮區,0879,273,154,427,23,450,839,53.64%,32.54%,1
桃園市,平鎮區,0880,454,292,746,31,777,1399,55.54%,32.45%,1
桃園市,平鎮區,0881,560,384,944,44,988,1968,50.2%,28.46%,1
桃園市,平鎮區,0882,526,342,868,31,899,1672,53.77%,31.46%,1
桃園市,平鎮區,0883,388,239,627,23,650,2213,29.37%,17.53%,1
桃園市,平鎮區,0884,323,244,567,26,593,949,62.49%,34.04%,1
桃園市,平鎮區,0885,546,379,925,39,964,1621,59.47%,33.68%,1
桃園市,平鎮區,0886,393,424,817,23,840,1643,51.13%,23.92%,1
桃園市,平鎮區,0887,589,388,977,36,1013,1844,54.93%,31.94%,1
桃園市,平鎮區,0888,532,372,904,38,942,1752,53.77%,30.37%,1
桃園市,平鎮區,0889,433,308,741,49,790,1577,50.1%,27.46%,1
桃園市,平鎮區,0890,446,361,807,29,836,1517,55.11%,29.4%,1
桃園市,平鎮區,0891,318,264,582,32,614,1039,59.1%,30.61%,1
桃園市,平鎮區,0892,452,294,746,31,777,1318,58.95%,34.29%,1
桃園市,平鎮區,0893,500,346,846,26,872,1636,53.3%,30.56%,1
桃園市,平鎮區,0894,421,283,704,32,736,1316,55.93%,31.99%,1
桃園市,平鎮區,0895,453,365,818,18,836,1474,56.72%,30.73%,1
桃園市,平鎮區,0896,384,281,665,44,709,1480,47.91%,25.95%,1
桃園市,平鎮區,0897,425,252,677,18,695,1330,52.26%,31.95%,1
桃園市,平鎮區,0898,388,257,645,36,681,1228,55.46%,31.6%,1
桃園市,平鎮區,0899,438,331,769,41,810,1377,58.82%,31.81%,1
桃園市,平鎮區,0900,437,267,704,27,731,1198,61.02%,36.48%,1
桃園市,平鎮區,0901,426,308,734,28,762,1231,61.9%,34.61%,1
桃園市,平鎮區,0902,404,266,670,46,716,1243,57.6%,32.5%,1
桃園市,平鎮區,0903,514,292,806,33,839,1590,52.77%,32.33%,1
桃園市,平鎮區,0904,413,289,702,37,739,1366,54.1%,30.23%,1
桃園市,平鎮區,0905,437,237,674,39,713,1332,53.53%,32.81%,1
桃園市,平鎮區,0906,335,232,567,34,601,1201,50.04%,27.89%,1
桃園市,平鎮區,0907,467,294,761,28,789,1668,47.3%,28%,1
桃園市,平鎮區,0908,423,243,666,40,706,1351,52.26%,31.31%,1
桃園市,平鎮區,0909,461,234,695,23,718,1460,49.18%,31.58%,1
桃園市,平鎮區,0910,573,333,906,29,935,1841,50.79%,31.12%,1
桃園市,平鎮區,0911,420,288,708,8,716,1475,48.54%,28.47%,1
桃園市,平鎮區,0912,333,196,529,31,560,1011,55.39%,32.94%,1
桃園市,平鎮區,0913,290,195,485,37,522,1052,49.62%,27.57%,1
桃園市,平鎮區,0914,383,286,669,38,707,1154,61.27%,33.19%,1
桃園市,平鎮區,0915,480,319,799,31,830,1645,50.46%,29.18%,1
桃園市,平鎮區,0916,422,291,713,72,785,1539,51.01%,27.42%,1
桃園市,平鎮區,0917,442,255,697,54,751,1385,54.22%,31.91%,1
桃園市,平鎮區,0918,483,235,718,29,747,1395,53.55%,34.62%,1
桃園市,平鎮區,0919,544,284,828,38,866,1711,50.61%,31.79%,1
桃園市,平鎮區,0920,521,265,786,51,837,1631,51.32%,31.94%,1
桃園市,平鎮區,0921,358,236,594,31,625,1110,56.31%,32.25%,1
桃園市,平鎮區,0922,684,346,1030,34,1064,1931,55.1%,35.42%,1
桃園市,平鎮區,0923,353,242,595,28,623,1127,55.28%,31.32%,1
桃園市,平鎮區,0924,494,246,740,44,784,1414,55.45%,34.94%,1
桃園市,平鎮區,0925,533,279,812,39,851,1609,52.89%,33.13%,1
桃園市,新屋區,1072,465,296,761,21,782,1306,59.88%,35.6%,1
桃園市,新屋區,1073,476,334,810,49,859,1556,55.21%,30.59%,1
桃園市,新屋區,1074,646,427,1073,49,1122,1849,60.68%,34.94%,1
桃園市,新屋區,1075,695,446,1141,66,1207,2096,57.59%,33.16%,1
桃園市,新屋區,1076,415,334,749,48,797,1517,52.54%,27.36%,1
桃園市,新屋區,1077,633,492,1125,60,1185,2095,56.56%,30.21%,1
桃園市,新屋區,1078,491,352,843,54,897,1856,48.33%,26.45%,1
桃園市,新屋區,1079,612,426,1038,59,1097,1986,55.24%,30.82%,1
桃園市,新屋區,1080,383,274,657,50,707,1425,49.61%,26.88%,1
桃園市,新屋區,1081,370,285,655,45,700,1385,50.54%,26.71%,1
桃園市,新屋區,1082,413,323,736,46,782,1271,61.53%,32.49%,1
桃園市,新屋區,1083,369,287,656,26,682,1271,53.66%,29.03%,1
桃園市,新屋區,1084,368,290,658,45,703,1234,56.97%,29.82%,1
桃園市,新屋區,1085,293,272,565,42,607,1085,55.94%,27%,1
桃園市,新屋區,1086,656,440,1096,37,1133,1992,56.88%,32.93%,1
桃園市,新屋區,1087,663,471,1134,61,1195,2032,58.81%,32.63%,1
桃園市,新屋區,1088,366,274,640,66,706,1291,54.69%,28.35%,1
桃園市,新屋區,1089,409,284,693,37,730,1401,52.11%,29.19%,1
桃園市,新屋區,1090,369,240,609,38,647,1106,58.5%,33.36%,1
桃園市,新屋區,1091,299,207,506,12,518,908,57.05%,32.93%,1
桃園市,新屋區,1092,231,145,376,32,408,663,61.54%,34.84%,1
桃園市,新屋區,1093,294,250,544,39,583,1088,53.58%,27.02%,1
桃園市,新屋區,1094,383,236,619,59,678,1050,64.57%,36.48%,1
桃園市,新屋區,1095,298,210,508,18,526,896,58.71%,33.26%,1
桃園市,新屋區,1096,420,325,745,73,818,1369,59.75%,30.68%,1
桃園市,新屋區,1097,238,226,464,35,499,995,50.15%,23.92%,1
桃園市,新屋區,1098,248,167,415,19,434,741,58.57%,33.47%,1
桃園市,新屋區,1099,297,228,525,57,582,943,61.72%,31.5%,1
桃園市,新屋區,1100,523,328,851,53,904,1714,52.74%,30.51%,1
桃園市,新屋區,1101,418,283,701,26,727,1340,54.25%,31.19%,1
桃園市,觀音區,1102,366,258,624,34,658,1371,47.99%,26.7%,1
桃園市,觀音區,1103,335,222,557,30,587,1362,43.1%,24.6%,1
桃園市,觀音區,1104,250,226,476,57,533,997,53.46%,25.08%,1
桃園市,觀音區,1105,382,275,657,28,685,1407,48.69%,27.15%,1
桃園市,觀音區,1106,448,418,866,39,905,1692,53.49%,26.48%,1
桃園市,觀音區,1107,411,234,645,29,674,1279,52.7%,32.13%,1
桃園市,觀音區,1108,241,163,404,17,421,791,53.22%,30.47%,1
桃園市,觀音區,1109,303,179,482,24,506,892,56.73%,33.97%,1
桃園市,觀音區,1110,296,213,509,22,531,886,59.93%,33.41%,1
桃園市,觀音區,1111,221,149,370,26,396,712,55.62%,31.04%,1
桃園市,觀音區,1112,423,295,718,95,813,1609,50.53%,26.29%,1
桃園市,觀音區,1113,385,285,670,36,706,1274,55.42%,30.22%,1
桃園市,觀音區,1114,329,255,584,21,605,1351,44.78%,24.35%,1
桃園市,觀音區,1115,409,264,673,54,727,1262,57.61%,32.41%,1
桃園市,觀音區,1116,365,296,661,46,707,1242,56.92%,29.39%,1
桃園市,觀音區,1117,433,305,738,40,778,1461,53.25%,29.64%,1
桃園市,觀音區,1118,458,351,809,38,847,1613,52.51%,28.39%,1
桃園市,觀音區,1119,408,370,778,41,819,1479,55.38%,27.59%,1
桃園市,觀音區,1120,382,315,697,49,746,1552,48.07%,24.61%,1
桃園市,觀音區,1121,445,319,764,23,787,1517,51.88%,29.33%,1
桃園市,觀音區,1122,468,316,784,52,836,1691,49.44%,27.68%,1
桃園市,觀音區,1123,460,171,631,12,643,1157,55.57%,39.76%,1
桃園市,觀音區,1124,419,293,712,39,751,1455,51.62%,28.8%,1
桃園市,觀音區,1125,341,243,584,29,613,1150,53.3%,29.65%,1
桃園市,觀音區,1126,317,267,584,42,626,1112,56.29%,28.51%,1
桃園市,觀音區,1127,336,252,588,27,615,1251,49.16%,26.86%,1
桃園市,觀音區,1128,408,313,721,62,783,1446,54.15%,28.22%,1
桃園市,觀音區,1129,409,303,712,77,789,1493,52.85%,27.39%,1
桃園市,觀音區,1130,397,257,654,54,708,1339,52.88%,29.65%,1
桃園市,觀音區,1131,393,242,635,34,669,1137,58.84%,34.56%,1
桃園市,觀音區,1132,267,226,493,35,528,1043,50.62%,25.6%,1
桃園市,觀音區,1133,251,191,442,20,462,993,46.53%,25.28%,1
桃園市,觀音區,1134,238,240,478,23,501,975,51.38%,24.41%,1
桃園市,觀音區,1135,457,406,863,43,906,2029,44.65%,22.52%,1
桃園市,觀音區,1136,531,395,926,37,963,1765,54.56%,30.08%,1
桃園市,觀音區,1137,522,360,882,44,926,1809,51.19%,28.86%,1
桃園市,觀音區,1138,535,335,870,38,908,1869,48.58%,28.62%,1
桃園市,觀音區,1139,424,343,767,45,812,1870,43.42%,22.67%,1
桃園市,觀音區,1140,354,312,666,31,697,1932,36.08%,18.32%,1
桃園市,觀音區,1141,235,180,415,8,423,899,47.05%,26.14%,1
桃園市,觀音區,1142,250,173,423,8,431,985,43.76%,25.38%,1
桃園市,復興區,0581,691,368,1059,70,1129,1991,56.71%,34.71%,1
桃園市,復興區,0582,495,244,739,61,800,1392,57.47%,35.56%,1
桃園市,復興區,0583,210,118,328,9,337,564,59.75%,37.23%,1
桃園市,復興區,0584,258,152,410,19,429,716,59.92%,36.03%,1
桃園市,復興區,0585,384,220,604,45,649,1016,63.88%,37.8%,1
桃園市,復興區,0586,180,125,305,9,314,669,46.94%,26.91%,1
桃園市,復興區,0587,251,128,379,16,395,760,51.97%,33.03%,1
桃園市,復興區,0588,258,164,422,17,439,751,58.46%,34.35%,1
桃園市,復興區,0589,250,131,381,15,396,683,57.98%,36.6%,1
桃園市,復興區,0590,535,155,690,24,714,1224,58.33%,43.71%,1
臺中市,中區,1070,600,376,976,75,1051,1652,63.62%,36.32%,1
臺中市,中區,1071,494,314,808,56,864,1531,56.43%,32.27%,1
臺中市,中區,1072,515,280,795,25,820,1431,57.3%,35.99%,1
臺中市,中區,1073,350,228,578,34,612,1060,57.74%,33.02%,1
臺中市,中區,1074,299,208,507,42,549,982,55.91%,30.45%,1
臺中市,中區,1075,393,254,647,41,688,1191,57.77%,33%,1
臺中市,中區,1076,263,191,454,40,494,855,57.78%,30.76%,1
臺中市,中區,1077,336,187,523,25,548,1135,48.28%,29.6%,1
臺中市,中區,1078,256,155,411,21,432,705,61.28%,36.31%,1
臺中市,中區,1079,365,209,574,40,614,1009,60.85%,36.17%,1
臺中市,中區,1080,403,273,676,52,728,1304,55.83%,30.9%,1
臺中市,中區,1081,554,346,900,32,932,1841,50.62%,30.09%,1
臺中市,東區,1148,268,164,432,18,450,1138,39.54%,23.55%,1
臺中市,東區,1149,347,215,562,23,585,984,59.45%,35.26%,1
臺中市,東區,1150,295,203,498,28,526,877,59.98%,33.64%,1
臺中市,東區,1151,395,250,645,41,686,1070,64.11%,36.92%,1
臺中市,東區,1152,362,287,649,40,689,1106,62.3%,32.73%,1
臺中市,東區,1153,330,210,540,44,584,953,61.28%,34.63%,1
臺中市,東區,1154,456,257,713,31,744,1195,62.26%,38.16%,1
臺中市,東區,1155,469,227,696,28,724,1251,57.87%,37.49%,1
臺中市,東區,1156,389,288,677,40,717,1190,60.25%,32.69%,1
臺中市,東區,1157,429,318,747,47,794,1394,56.96%,30.77%,1
臺中市,東區,1158,521,330,851,49,900,1443,62.37%,36.11%,1
臺中市,東區,1159,273,164,437,34,471,762,61.81%,35.83%,1
臺中市,東區,1160,451,263,714,32,746,1140,65.44%,39.56%,1
臺中市,東區,1161,416,286,702,54,756,1211,62.43%,34.35%,1
臺中市,東區,1162,288,167,455,28,483,755,63.97%,38.15%,1
臺中市,東區,1163,497,307,804,47,851,1491,57.08%,33.33%,1
臺中市,東區,1164,347,207,554,23,577,1000,57.7%,34.7%,1
臺中市,東區,1165,377,267,644,47,691,1114,62.03%,33.84%,1
臺中市,東區,1166,377,235,612,31,643,1101,58.4%,34.24%,1
臺中市,東區,1167,448,257,705,52,757,1169,64.76%,38.32%,1
臺中市,東區,1168,499,246,745,44,789,1283,61.5%,38.89%,1
臺中市,東區,1169,392,287,679,44,723,1168,61.9%,33.56%,1
臺中市,東區,1170,471,290,761,32,793,1386,57.22%,33.98%,1
臺中市,東區,1171,524,373,897,25,922,1557,59.22%,33.65%,1
臺中市,東區,1172,462,303,765,50,815,1380,59.06%,33.48%,1
臺中市,東區,1173,611,355,966,43,1009,1674,60.27%,36.5%,1
臺中市,東區,1174,564,380,944,45,989,1604,61.66%,35.16%,1
臺中市,東區,1175,631,419,1050,49,1099,1815,60.55%,34.77%,1
臺中市,東區,1176,580,354,934,37,971,1700,57.12%,34.12%,1
臺中市,東區,1177,495,386,881,35,916,1592,57.54%,31.09%,1
臺中市,東區,1178,586,362,948,53,1001,1850,54.11%,31.68%,1
臺中市,東區,1179,450,284,734,30,764,1252,61.02%,35.94%,1
臺中市,東區,1180,439,321,760,38,798,1250,63.84%,35.12%,1
臺中市,東區,1181,443,282,725,27,752,1241,60.6%,35.7%,1
臺中市,東區,1182,369,292,661,50,711,1318,53.95%,28%,1
臺中市,東區,1183,440,259,699,42,741,1288,57.53%,34.16%,1
臺中市,東區,1184,527,329,856,55,911,1442,63.18%,36.55%,1
臺中市,東區,1185,409,266,675,49,724,1202,60.23%,34.03%,1
臺中市,東區,1186,528,275,803,54,857,1452,59.02%,36.36%,1
臺中市,東區,1187,483,300,783,44,827,1480,55.88%,32.64%,1
臺中市,東區,1188,602,345,947,45,992,1736,57.14%,34.68%,1
臺中市,東區,1189,273,183,456,34,490,867,56.52%,31.49%,1
臺中市,東區,1190,594,269,863,44,907,1693,53.57%,35.09%,1
臺中市,東區,1191,565,338,903,47,950,1538,61.77%,36.74%,1
臺中市,東區,1192,531,406,937,62,999,1593,62.71%,33.33%,1
臺中市,東區,1193,482,301,783,28,811,1481,54.76%,32.55%,1
臺中市,東區,1194,505,341,846,38,884,1414,62.52%,35.71%,1
臺中市,東區,1195,427,300,727,35,762,1297,58.75%,32.92%,1
臺中市,東區,1196,488,309,797,38,835,1394,59.9%,35.01%,1
臺中市,南區,1197,348,200,548,29,577,937,61.58%,37.14%,1
臺中市,南區,1198,363,252,615,40,655,1001,65.43%,36.26%,1
臺中市,南區,1199,501,279,780,46,826,1249,66.13%,40.11%,1
臺中市,南區,1200,468,311,779,43,822,1202,68.39%,38.94%,1
臺中市,南區,1201,400,262,662,59,721,1130,63.81%,35.4%,1
臺中市,南區,1202,451,294,745,39,784,1239,63.28%,36.4%,1
臺中市,南區,1203,417,275,692,41,733,1238,59.21%,33.68%,1
臺中市,南區,1204,454,301,755,43,798,1272,62.74%,35.69%,1
臺中市,南區,1205,443,303,746,36,782,1273,61.43%,34.8%,1
臺中市,南區,1206,474,270,744,63,807,1317,61.28%,35.99%,1
臺中市,南區,1207,497,258,755,44,799,1160,68.88%,42.84%,1
臺中市,南區,1208,443,303,746,50,796,1205,66.06%,36.76%,1
臺中市,南區,1209,426,229,655,37,692,1111,62.29%,38.34%,1
臺中市,南區,1210,530,362,892,46,938,1407,66.67%,37.67%,1
臺中市,南區,1211,541,279,820,34,854,1419,60.18%,38.13%,1
臺中市,南區,1212,455,248,703,35,738,1157,63.79%,39.33%,1
臺中市,南區,1213,467,342,809,32,841,1415,59.43%,33%,1
臺中市,南區,1214,519,292,811,37,848,1289,65.79%,40.26%,1
臺中市,南區,1215,544,286,830,49,879,1454,60.45%,37.41%,1
臺中市,南區,1216,525,305,830,46,876,1491,58.75%,35.21%,1
臺中市,南區,1217,491,316,807,29,836,1394,59.97%,35.22%,1
臺中市,南區,1218,503,318,821,42,863,1430,60.35%,35.17%,1
臺中市,南區,1219,475,286,761,91,852,1342,63.49%,35.39%,1
臺中市,南區,1220,496,317,813,71,884,1304,67.79%,38.04%,1
臺中市,南區,1221,450,290,740,34,774,1190,65.04%,37.82%,1
臺中市,南區,1222,464,140,604,57,661,1273,51.92%,36.45%,1
臺中市,南區,1223,537,322,859,46,905,1387,65.25%,38.72%,1
臺中市,南區,1224,468,296,764,55,819,1356,60.4%,34.51%,1
臺中市,南區,1225,498,283,781,47,828,1304,63.5%,38.19%,1
臺中市,南區,1226,485,306,791,28,819,1256,65.21%,38.61%,1
臺中市,南區,1227,482,348,830,31,861,1364,63.12%,35.34%,1
臺中市,南區,1228,466,325,791,60,851,1361,62.53%,34.24%,1
臺中市,南區,1229,539,312,851,23,874,1407,62.12%,38.31%,1
臺中市,南區,1230,476,277,753,47,800,1308,61.16%,36.39%,1
臺中市,南區,1231,435,280,715,31,746,1250,59.68%,34.8%,1
臺中市,南區,1232,449,254,703,37,740,1284,57.63%,34.97%,1
臺中市,南區,1233,436,298,734,29,763,1175,64.94%,37.11%,1
臺中市,南區,1234,477,260,737,33,770,1158,66.49%,41.19%,1
臺中市,南區,1235,433,240,673,45,718,1168,61.47%,37.07%,1
臺中市,南區,1236,630,363,993,49,1042,1626,64.08%,38.75%,1
臺中市,南區,1237,526,329,855,29,884,2115,41.8%,24.87%,1
臺中市,南區,1238,622,362,984,29,1013,1805,56.12%,34.46%,1
臺中市,南區,1239,557,361,918,31,949,1695,55.99%,32.86%,1
臺中市,南區,1240,601,412,1013,36,1049,1643,63.85%,36.58%,1
臺中市,南區,1241,502,355,857,33,890,1423,62.54%,35.28%,1
臺中市,南區,1242,522,359,881,50,931,1542,60.38%,33.85%,1
臺中市,南區,1243,534,374,908,29,937,1533,61.12%,34.83%,1
臺中市,南區,1244,595,344,939,53,992,1531,64.79%,38.86%,1
臺中市,南區,1245,502,264,766,35,801,1392,57.54%,36.06%,1
臺中市,南區,1246,534,352,886,29,915,1592,57.47%,33.54%,1
臺中市,南區,1247,538,313,851,47,898,1431,62.75%,37.6%,1
臺中市,南區,1248,559,387,946,38,984,1799,54.7%,31.07%,1
臺中市,南區,1249,653,388,1041,49,1090,1708,63.82%,38.23%,1
臺中市,南區,1250,571,362,933,61,994,1700,58.47%,33.59%,1
臺中市,南區,1251,662,394,1056,33,1089,1751,62.19%,37.81%,1
臺中市,南區,1252,712,483,1195,73,1268,2109,60.12%,33.76%,1
臺中市,南區,1253,588,369,957,50,1007,1697,59.34%,34.65%,1
臺中市,南區,1254,489,332,821,47,868,1456,59.62%,33.59%,1
臺中市,南區,1255,697,409,1106,57,1163,1726,67.38%,40.38%,1
臺中市,南區,1256,632,410,1042,39,1081,1723,62.74%,36.68%,1
臺中市,南區,1257,597,344,941,35,976,1569,62.21%,38.05%,1
臺中市,南區,1258,466,281,747,52,799,1274,62.72%,36.58%,1
臺中市,南區,1259,574,310,884,37,921,1390,66.26%,41.29%,1
臺中市,南區,1260,502,316,818,28,846,1295,65.33%,38.76%,1
臺中市,南區,1261,621,160,781,33,814,1312,62.04%,47.33%,1
臺中市,南區,1262,561,310,871,36,907,1417,64.01%,39.59%,1
臺中市,南區,1263,493,328,821,36,857,1230,69.67%,40.08%,1
臺中市,南區,1264,473,278,751,43,794,1308,60.7%,36.16%,1
臺中市,南區,1265,502,335,837,49,886,1467,60.4%,34.22%,1
臺中市,南區,1266,500,323,823,36,859,1399,61.4%,35.74%,1
臺中市,南區,1267,448,231,679,54,733,1207,60.73%,37.12%,1
臺中市,南區,1268,436,332,768,33,801,1317,60.82%,33.11%,1
臺中市,南區,1269,516,372,888,28,916,1563,58.61%,33.01%,1
臺中市,南區,1270,469,267,736,36,772,1221,63.23%,38.41%,1
臺中市,西區,1082,303,186,489,26,515,1400,36.79%,21.64%,1
臺中市,西區,1083,345,206,551,20,571,861,66.32%,40.07%,1
臺中市,西區,1084,537,275,812,46,858,1416,60.59%,37.92%,1
臺中市,西區,1085,367,235,602,43,645,1020,63.24%,35.98%,1
臺中市,西區,1086,298,182,480,34,514,778,66.07%,38.3%,1
臺中市,西區,1087,509,295,804,45,849,1465,57.95%,34.74%,1
臺中市,西區,1088,386,214,600,19,619,1017,60.87%,37.95%,1
臺中市,西區,1089,295,215,510,21,531,868,61.18%,33.99%,1
臺中市,西區,1090,474,292,766,42,808,1251,64.59%,37.89%,1
臺中市,西區,1091,405,242,647,44,691,1044,66.19%,38.79%,1
臺中市,西區,1092,491,335,826,42,868,1487,58.37%,33.02%,1
臺中市,西區,1093,529,371,900,36,936,1573,59.5%,33.63%,1
臺中市,西區,1094,660,363,1023,36,1059,1731,61.18%,38.13%,1
臺中市,西區,1095,444,270,714,27,741,1209,61.29%,36.72%,1
臺中市,西區,1096,530,328,858,51,909,1564,58.12%,33.89%,1
臺中市,西區,1097,417,279,696,29,725,1175,61.7%,35.49%,1
臺中市,西區,1098,525,320,845,32,877,1505,58.27%,34.88%,1
臺中市,西區,1099,498,336,834,37,871,1418,61.42%,35.12%,1
臺中市,西區,1100,461,252,713,18,731,1497,48.83%,30.79%,1
臺中市,西區,1101,457,287,744,38,782,1260,62.06%,36.27%,1
臺中市,西區,1102,448,355,803,51,854,1399,61.04%,32.02%,1
臺中市,西區,1103,492,300,792,46,838,1447,57.91%,34%,1
臺中市,西區,1104,562,381,943,43,986,1683,58.59%,33.39%,1
臺中市,西區,1105,563,366,929,34,963,1585,60.76%,35.52%,1
臺中市,西區,1106,574,375,949,21,970,1557,62.3%,36.87%,1
臺中市,西區,1107,524,329,853,56,909,1663,54.66%,31.51%,1
臺中市,西區,1108,611,473,1084,40,1124,1921,58.51%,31.81%,1
臺中市,西區,1109,577,427,1004,42,1046,1952,53.59%,29.56%,1
臺中市,西區,1110,574,367,941,34,975,1708,57.08%,33.61%,1
臺中市,西區,1111,423,268,691,30,721,1131,63.75%,37.4%,1
臺中市,西區,1112,609,415,1024,40,1064,1916,55.53%,31.78%,1
臺中市,西區,1113,463,313,776,15,791,1275,62.04%,36.31%,1
臺中市,西區,1114,558,353,911,56,967,1822,53.07%,30.63%,1
臺中市,西區,1115,492,286,778,34,812,1374,59.1%,35.81%,1
臺中市,西區,1116,411,200,611,49,660,1129,58.46%,36.4%,1
臺中市,西區,1117,365,276,641,39,680,1201,56.62%,30.39%,1
臺中市,西區,1118,537,337,874,47,921,1639,56.19%,32.76%,1
臺中市,西區,1119,592,442,1034,59,1093,1863,58.67%,31.78%,1
臺中市,西區,1120,506,280,786,39,825,1287,64.1%,39.32%,1
臺中市,西區,1121,536,343,879,45,924,1504,61.44%,35.64%,1
臺中市,西區,1122,447,284,731,38,769,1308,58.79%,34.17%,1
臺中市,西區,1123,492,309,801,44,845,1433,58.97%,34.33%,1
臺中市,西區,1124,495,294,789,35,824,1450,56.83%,34.14%,1
臺中市,西區,1125,513,367,880,44,924,1465,63.07%,35.02%,1
臺中市,西區,1126,579,370,949,44,993,1818,54.62%,31.85%,1
臺中市,西區,1127,600,392,992,52,1044,1782,58.59%,33.67%,1
臺中市,西區,1128,494,362,856,39,895,1428,62.68%,34.59%,1
臺中市,西區,1129,432,266,698,33,731,1366,53.51%,31.63%,1
臺中市,西區,1130,495,338,833,31,864,1498,57.68%,33.04%,1
臺中市,西區,1131,495,306,801,33,834,1350,61.78%,36.67%,1
臺中市,西區,1132,448,304,752,27,779,1339,58.18%,33.46%,1
臺中市,西區,1133,555,367,922,40,962,1613,59.64%,34.41%,1
臺中市,西區,1134,486,338,824,33,857,1454,58.94%,33.43%,1
臺中市,西區,1135,546,402,948,32,980,1597,61.37%,34.19%,1
臺中市,西區,1136,504,350,854,44,898,1411,63.64%,35.72%,1
臺中市,西區,1137,498,349,847,51,898,1493,60.15%,33.36%,1
臺中市,西區,1138,590,350,940,43,983,1600,61.44%,36.88%,1
臺中市,西區,1139,548,381,929,49,978,1710,57.19%,32.05%,1
臺中市,西區,1140,423,235,658,23,681,1139,59.79%,37.14%,1
臺中市,西區,1141,397,254,651,29,680,1105,61.54%,35.93%,1
臺中市,西區,1142,506,319,825,41,866,1498,57.81%,33.78%,1
臺中市,西區,1143,601,341,942,47,989,1921,51.48%,31.29%,1
臺中市,西區,1144,458,288,746,41,787,1340,58.73%,34.18%,1
臺中市,西區,1145,559,371,930,41,971,1536,63.22%,36.39%,1
臺中市,西區,1146,463,305,768,46,814,1361,59.81%,34.02%,1
臺中市,西區,1147,536,342,878,29,907,1430,63.43%,37.48%,1
臺中市,北區,0983,458,302,760,36,796,1437,55.39%,31.87%,1
臺中市,北區,0984,499,352,851,70,921,1708,53.92%,29.22%,1
臺中市,北區,0985,302,225,527,30,557,1051,53%,28.73%,1
臺中市,北區,0986,337,210,547,35,582,996,58.43%,33.84%,1
臺中市,北區,0987,537,302,839,34,873,1504,58.05%,35.7%,1
臺中市,北區,0988,338,223,561,48,609,975,62.46%,34.67%,1
臺中市,北區,0989,309,194,503,28,531,886,59.93%,34.88%,1
臺中市,北區,0990,346,242,588,28,616,1276,48.28%,27.12%,1
臺中市,北區,0991,277,222,499,21,520,938,55.44%,29.53%,1
臺中市,北區,0992,446,286,732,45,777,1404,55.34%,31.77%,1
臺中市,北區,0993,330,213,543,24,567,996,56.93%,33.13%,1
臺中市,北區,0994,276,192,468,38,506,869,58.23%,31.76%,1
臺中市,北區,0995,261,166,427,22,449,704,63.78%,37.07%,1
臺中市,北區,0996,317,211,528,22,550,979,56.18%,32.38%,1
臺中市,北區,0997,246,152,398,14,412,773,53.3%,31.82%,1
臺中市,北區,0998,289,162,451,22,473,759,62.32%,38.08%,1
臺中市,北區,0999,532,266,798,49,847,1438,58.9%,37%,1
臺中市,北區,1000,334,278,612,33,645,1212,53.22%,27.56%,1
臺中市,北區,1001,603,358,961,47,1008,1731,58.23%,34.84%,1
臺中市,北區,1002,596,295,891,29,920,1445,63.67%,41.25%,1
臺中市,北區,1003,603,400,1003,54,1057,1855,56.98%,32.51%,1
臺中市,北區,1004,509,322,831,50,881,1728,50.98%,29.46%,1
臺中市,北區,1005,561,372,933,37,970,1878,51.65%,29.87%,1
臺中市,北區,1006,548,345,893,54,947,1793,52.82%,30.56%,1
臺中市,北區,1007,537,315,852,56,908,1555,58.39%,34.53%,1
臺中市,北區,1008,525,337,862,35,897,1761,50.94%,29.81%,1
臺中市,北區,1009,664,202,866,33,899,1579,56.93%,42.05%,1
臺中市,北區,1010,708,412,1120,63,1183,2192,53.97%,32.3%,1
臺中市,北區,1011,564,343,907,31,938,1560,60.13%,36.15%,1
臺中市,北區,1012,510,312,822,35,857,1476,58.06%,34.55%,1
臺中市,北區,1013,376,221,597,23,620,1006,61.63%,37.38%,1
臺中市,北區,1014,490,289,779,37,816,1403,58.16%,34.93%,1
臺中市,北區,1015,461,287,748,24,772,1446,53.39%,31.88%,1
臺中市,北區,1016,450,331,781,42,823,1460,56.37%,30.82%,1
臺中市,北區,1017,442,251,693,25,718,1233,58.23%,35.85%,1
臺中市,北區,1018,394,263,657,21,678,1027,66.02%,38.36%,1
臺中市,北區,1019,396,288,684,23,707,1207,58.57%,32.81%,1
臺中市,北區,1020,427,274,701,27,728,1167,62.38%,36.59%,1
臺中市,北區,1021,387,262,649,19,668,1150,58.09%,33.65%,1
臺中市,北區,1022,363,239,602,27,629,1061,59.28%,34.21%,1
臺中市,北區,1023,376,220,596,27,623,1005,61.99%,37.41%,1
臺中市,北區,1024,418,276,694,27,721,1250,57.68%,33.44%,1
臺中市,北區,1025,490,346,836,43,879,1448,60.7%,33.84%,1
臺中市,北區,1026,471,302,773,56,829,1379,60.12%,34.16%,1
臺中市,北區,1027,566,339,905,59,964,1652,58.35%,34.26%,1
臺中市,北區,1028,583,413,996,26,1022,1867,54.74%,31.23%,1
臺中市,北區,1029,373,202,575,18,593,2078,28.54%,17.95%,1
臺中市,北區,1030,615,304,919,33,952,1562,60.95%,39.37%,1
臺中市,北區,1031,519,285,804,23,827,1430,57.83%,36.29%,1
臺中市,北區,1032,669,434,1103,44,1147,2018,56.84%,33.15%,1
臺中市,北區,1033,541,301,842,33,875,1710,51.17%,31.64%,1
臺中市,北區,1034,469,292,761,35,796,1432,55.59%,32.75%,1
臺中市,北區,1035,457,225,682,31,713,1157,61.62%,39.5%,1
臺中市,北區,1036,430,262,692,29,721,1188,60.69%,36.2%,1
臺中市,北區,1037,500,280,780,30,810,1419,57.08%,35.24%,1
臺中市,北區,1038,547,345,892,19,911,1653,55.11%,33.09%,1
臺中市,北區,1039,407,304,711,24,735,1233,59.61%,33.01%,1
臺中市,北區,1040,423,283,706,24,730,1243,58.73%,34.03%,1
臺中市,北區,1041,412,223,635,17,652,1219,53.49%,33.8%,1
臺中市,北區,1042,435,297,732,19,751,1272,59.04%,34.2%,1
臺中市,北區,1043,448,300,748,23,771,1285,60%,34.86%,1
臺中市,北區,1044,610,408,1018,37,1055,1780,59.27%,34.27%,1
臺中市,北區,1045,459,288,747,30,777,1461,53.18%,31.42%,1
臺中市,北區,1046,478,283,761,30,791,1310,60.38%,36.49%,1
臺中市,北區,1047,532,398,930,24,954,1669,57.16%,31.88%,1
臺中市,北區,1048,676,409,1085,45,1130,1932,58.49%,34.99%,1
臺中市,北區,1049,512,391,903,28,931,1682,55.35%,30.44%,1
臺中市,北區,1050,600,397,997,38,1035,1891,54.73%,31.73%,1
臺中市,北區,1051,638,374,1012,56,1068,1882,56.75%,33.9%,1
臺中市,北區,1052,399,249,648,24,672,1159,57.98%,34.43%,1
臺中市,北區,1053,540,317,857,48,905,1553,58.27%,34.77%,1
臺中市,北區,1054,496,369,865,39,904,1607,56.25%,30.86%,1
臺中市,北區,1055,550,411,961,38,999,1773,56.35%,31.02%,1
臺中市,北區,1056,484,351,835,53,888,1524,58.27%,31.76%,1
臺中市,北區,1057,590,366,956,56,1012,1613,62.74%,36.58%,1
臺中市,北區,1058,675,383,1058,51,1109,1877,59.08%,35.96%,1
臺中市,北區,1059,602,390,992,45,1037,1792,57.87%,33.59%,1
臺中市,北區,1060,524,270,794,37,831,1392,59.7%,37.64%,1
臺中市,北區,1061,435,286,721,29,750,1297,57.83%,33.54%,1
臺中市,北區,1062,561,349,910,42,952,1556,61.18%,36.05%,1
臺中市,北區,1063,458,342,800,42,842,1497,56.25%,30.59%,1
臺中市,北區,1064,532,301,833,41,874,1550,56.39%,34.32%,1
臺中市,北區,1065,437,313,750,36,786,1434,54.81%,30.47%,1
臺中市,北區,1066,609,382,991,49,1040,1793,58%,33.97%,1
臺中市,北區,1067,597,422,1019,40,1059,1866,56.75%,31.99%,1
臺中市,北區,1068,460,312,772,34,806,1346,59.88%,34.18%,1
臺中市,北區,1069,429,258,687,46,733,1267,57.85%,33.86%,1
臺中市,西屯區,0625,601,388,989,38,1027,1638,62.7%,36.69%,1
臺中市,西屯區,0626,421,305,726,25,751,1335,56.25%,31.54%,1
臺中市,西屯區,0627,661,358,1019,29,1048,1776,59.01%,37.22%,1
臺中市,西屯區,0628,453,297,750,33,783,1351,57.96%,33.53%,1
臺中市,西屯區,0629,466,320,786,31,817,1338,61.06%,34.83%,1
臺中市,西屯區,0630,554,341,895,30,925,1582,58.47%,35.02%,1
臺中市,西屯區,0631,562,342,904,27,931,1710,54.44%,32.87%,1
臺中市,西屯區,0632,474,340,814,37,851,1595,53.35%,29.72%,1
臺中市,西屯區,0633,574,300,874,65,939,1585,59.24%,36.21%,1
臺中市,西屯區,0634,586,346,932,56,988,1749,56.49%,33.5%,1
臺中市,西屯區,0635,690,350,1040,35,1075,1877,57.27%,36.76%,1
臺中市,西屯區,0636,555,343,898,30,928,1697,54.68%,32.7%,1
臺中市,西屯區,0637,540,339,879,31,910,1480,61.49%,36.49%,1
臺中市,西屯區,0638,555,370,925,47,972,1483,65.54%,37.42%,1
臺中市,西屯區,0639,526,351,877,29,906,2484,36.47%,21.18%,1
臺中市,西屯區,0640,311,186,497,30,527,781,67.48%,39.82%,1
臺中市,西屯區,0641,549,311,860,44,904,1477,61.21%,37.17%,1
臺中市,西屯區,0642,578,377,955,45,1000,1784,56.05%,32.4%,1
臺中市,西屯區,0643,581,338,919,39,958,1686,56.82%,34.46%,1
臺中市,西屯區,0644,569,366,935,36,971,1692,57.39%,33.63%,1
臺中市,西屯區,0645,652,226,878,28,906,1659,54.61%,39.3%,1
臺中市,西屯區,0646,585,354,939,23,962,1648,58.37%,35.5%,1
臺中市,西屯區,0647,554,358,912,28,940,1536,61.2%,36.07%,1
臺中市,西屯區,0648,589,381,970,32,1002,1666,60.14%,35.35%,1
臺中市,西屯區,0649,480,335,815,49,864,1428,60.5%,33.61%,1
臺中市,西屯區,0650,568,370,938,51,989,1810,54.64%,31.38%,1
臺中市,西屯區,0651,528,338,866,23,889,1574,56.48%,33.55%,1
臺中市,西屯區,0652,579,348,927,12,939,1650,56.91%,35.09%,1
臺中市,西屯區,0653,528,366,894,79,973,1681,57.88%,31.41%,1
臺中市,西屯區,0654,528,352,880,33,913,1656,55.13%,31.88%,1
臺中市,西屯區,0655,470,252,722,45,767,1243,61.71%,37.81%,1
臺中市,西屯區,0656,547,351,898,41,939,1471,63.83%,37.19%,1
臺中市,西屯區,0657,535,329,864,32,896,1431,62.61%,37.39%,1
臺中市,西屯區,0658,579,364,943,35,978,1714,57.06%,33.78%,1
臺中市,西屯區,0659,497,308,805,42,847,1424,59.48%,34.9%,1
臺中市,西屯區,0660,410,255,665,32,697,1176,59.27%,34.86%,1
臺中市,西屯區,0661,530,326,856,32,888,1456,60.99%,36.4%,1
臺中市,西屯區,0662,546,341,887,25,912,1451,62.85%,37.63%,1
臺中市,西屯區,0663,428,244,672,27,699,1063,65.76%,40.26%,1
臺中市,西屯區,0664,398,269,667,33,700,1357,51.58%,29.33%,1
臺中市,西屯區,0665,514,277,791,54,845,1355,62.36%,37.93%,1
臺中市,西屯區,0666,551,293,844,21,865,1384,62.5%,39.81%,1
臺中市,西屯區,0667,565,369,934,36,970,1613,60.14%,35.03%,1
臺中市,西屯區,0668,520,347,867,42,909,1562,58.19%,33.29%,1
臺中市,西屯區,0669,442,322,764,44,808,1219,66.28%,36.26%,1
臺中市,西屯區,0670,423,290,713,37,750,1235,60.73%,34.25%,1
臺中市,西屯區,0671,391,244,635,42,677,1131,59.86%,34.57%,1
臺中市,西屯區,0672,564,355,919,20,939,1494,62.85%,37.75%,1
臺中市,西屯區,0673,456,303,759,32,791,1325,59.7%,34.42%,1
臺中市,西屯區,0674,452,342,794,40,834,1386,60.17%,32.61%,1
臺中市,西屯區,0675,642,389,1031,44,1075,1816,59.2%,35.35%,1
臺中市,西屯區,0676,556,362,918,35,953,1734,54.96%,32.06%,1
臺中市,西屯區,0677,592,426,1018,46,1064,1777,59.88%,33.31%,1
臺中市,西屯區,0678,556,386,942,53,995,1818,54.73%,30.58%,1
臺中市,西屯區,0679,550,365,915,54,969,1699,57.03%,32.37%,1
臺中市,西屯區,0680,527,349,876,34,910,1715,53.06%,30.73%,1
臺中市,西屯區,0681,517,354,871,36,907,1654,54.84%,31.26%,1
臺中市,西屯區,0682,523,363,886,22,908,1636,55.5%,31.97%,1
臺中市,西屯區,0683,414,304,718,27,745,1298,57.4%,31.9%,1
臺中市,西屯區,0684,486,321,807,38,845,1391,60.75%,34.94%,1
臺中市,西屯區,0685,599,453,1052,48,1100,1853,59.36%,32.33%,1
臺中市,西屯區,0686,506,373,879,48,927,1820,50.93%,27.8%,1
臺中市,西屯區,0687,614,398,1012,44,1056,1809,58.37%,33.94%,1
臺中市,西屯區,0688,496,374,870,34,904,1352,66.86%,36.69%,1
臺中市,西屯區,0689,495,350,845,50,895,1521,58.84%,32.54%,1
臺中市,西屯區,0690,561,324,885,27,912,1486,61.37%,37.75%,1
臺中市,西屯區,0691,554,386,940,51,991,1674,59.2%,33.09%,1
臺中市,西屯區,0692,561,399,960,54,1014,1610,62.98%,34.84%,1
臺中市,西屯區,0693,561,384,945,47,992,1695,58.53%,33.1%,1
臺中市,西屯區,0694,535,372,907,37,944,1684,56.06%,31.77%,1
臺中市,西屯區,0695,474,257,731,25,756,1221,61.92%,38.82%,1
臺中市,西屯區,0696,488,314,802,53,855,1252,68.29%,38.98%,1
臺中市,西屯區,0697,475,298,773,44,817,1301,62.8%,36.51%,1
臺中市,西屯區,0698,433,200,633,40,673,1049,64.16%,41.28%,1
臺中市,西屯區,0699,438,208,646,34,680,1113,61.1%,39.35%,1
臺中市,西屯區,0700,567,272,839,30,869,1557,55.81%,36.42%,1
臺中市,西屯區,0701,571,294,865,47,912,1640,55.61%,34.82%,1
臺中市,西屯區,0702,538,334,872,66,938,1402,66.9%,38.37%,1
臺中市,西屯區,0703,521,332,853,53,906,1717,52.77%,30.34%,1
臺中市,西屯區,0704,582,352,934,37,971,1688,57.52%,34.48%,1
臺中市,西屯區,0705,403,232,635,88,723,1168,61.9%,34.5%,1
臺中市,西屯區,0706,569,339,908,45,953,1729,55.12%,32.91%,1
臺中市,西屯區,0707,625,416,1041,41,1082,2007,53.91%,31.14%,1
臺中市,西屯區,0708,423,327,750,54,804,1296,62.04%,32.64%,1
臺中市,西屯區,0709,336,203,539,31,570,1068,53.37%,31.46%,1
臺中市,西屯區,0710,406,348,754,57,811,1707,47.51%,23.78%,1
臺中市,西屯區,0711,533,398,931,38,969,1636,59.23%,32.58%,1
臺中市,西屯區,0712,486,332,818,37,855,1761,48.55%,27.6%,1
臺中市,西屯區,0713,475,281,756,44,800,1314,60.88%,36.15%,1
臺中市,西屯區,0714,467,294,761,34,795,1233,64.48%,37.88%,1
臺中市,西屯區,0715,512,309,821,39,860,1549,55.52%,33.05%,1
臺中市,西屯區,0716,552,312,864,27,891,1639,54.36%,33.68%,1
臺中市,西屯區,0717,542,236,778,37,815,1486,54.85%,36.47%,1
臺中市,西屯區,0718,583,371,954,31,985,1806,54.54%,32.28%,1
臺中市,西屯區,0719,455,318,773,19,792,1451,54.58%,31.36%,1
臺中市,西屯區,0720,506,253,759,24,783,1302,60.14%,38.86%,1
臺中市,西屯區,0721,482,321,803,43,846,1353,62.53%,35.62%,1
臺中市,西屯區,0722,761,452,1213,52,1265,2162,58.51%,35.2%,1
臺中市,西屯區,0723,521,305,826,37,863,1520,56.78%,34.28%,1
臺中市,西屯區,0724,665,378,1043,42,1085,1935,56.07%,34.37%,1
臺中市,西屯區,0725,634,372,1006,43,1049,1847,56.79%,34.33%,1
臺中市,西屯區,0726,584,395,979,38,1017,1738,58.52%,33.6%,1
臺中市,西屯區,0727,610,365,975,36,1011,1640,61.65%,37.2%,1
臺中市,西屯區,0728,657,393,1050,36,1086,1908,56.92%,34.43%,1
臺中市,西屯區,0729,480,307,787,27,814,1402,58.06%,34.24%,1
臺中市,西屯區,0730,458,325,783,36,819,1515,54.06%,30.23%,1
臺中市,西屯區,0731,473,255,728,30,758,1541,49.19%,30.69%,1
臺中市,西屯區,0732,467,344,811,24,835,1502,55.59%,31.09%,1
臺中市,西屯區,0733,505,366,871,37,908,1526,59.5%,33.09%,1
臺中市,西屯區,0734,490,337,827,48,875,1425,61.4%,34.39%,1
臺中市,西屯區,0735,505,303,808,29,837,1334,62.74%,37.86%,1
臺中市,西屯區,0736,617,366,983,39,1022,1649,61.98%,37.42%,1
臺中市,西屯區,0737,513,340,853,34,887,1566,56.64%,32.76%,1
臺中市,西屯區,0738,600,360,960,38,998,1629,61.26%,36.83%,1
臺中市,西屯區,0739,694,374,1068,50,1118,1628,68.67%,42.63%,1
臺中市,西屯區,0740,515,344,859,29,888,1442,61.58%,35.71%,1
臺中市,西屯區,0741,362,266,628,45,673,1206,55.8%,30.02%,1
臺中市,西屯區,0742,415,227,642,45,687,1086,63.26%,38.21%,1
臺中市,西屯區,0743,414,230,644,42,686,1088,63.05%,38.05%,1
臺中市,西屯區,0744,401,261,662,26,688,1140,60.35%,35.18%,1
臺中市,南屯區,0745,465,276,741,61,802,1321,60.71%,35.2%,1
臺中市,南屯區,0746,487,326,813,34,847,1346,62.93%,36.18%,1
臺中市,南屯區,0747,511,337,848,36,884,1428,61.9%,35.78%,1
臺中市,南屯區,0748,514,302,816,35,851,1442,59.02%,35.64%,1
臺中市,南屯區,0749,552,326,878,30,908,1408,64.49%,39.2%,1
臺中市,南屯區,0750,524,315,839,25,864,1404,61.54%,37.32%,1
臺中市,南屯區,0751,529,305,834,31,865,1354,63.88%,39.07%,1
臺中市,南屯區,0752,481,328,809,30,839,1332,62.99%,36.11%,1
臺中市,南屯區,0753,534,356,890,38,928,1463,63.43%,36.5%,1
臺中市,南屯區,0754,464,343,807,39,846,1413,59.87%,32.84%,1
臺中市,南屯區,0755,470,293,763,31,794,1218,65.19%,38.59%,1
臺中市,南屯區,0756,488,285,773,30,803,1308,61.39%,37.31%,1
臺中市,南屯區,0757,593,330,923,48,971,1527,63.59%,38.83%,1
臺中市,南屯區,0758,459,327,786,40,826,1294,63.83%,35.47%,1
臺中市,南屯區,0759,471,313,784,32,816,1516,53.83%,31.07%,1
臺中市,南屯區,0760,547,353,900,57,957,1529,62.59%,35.78%,1
臺中市,南屯區,0761,498,318,816,49,865,1397,61.92%,35.65%,1
臺中市,南屯區,0762,495,267,762,35,797,1406,56.69%,35.21%,1
臺中市,南屯區,0763,499,302,801,40,841,1497,56.18%,33.33%,1
臺中市,南屯區,0764,463,314,777,46,823,1424,57.79%,32.51%,1
臺中市,南屯區,0765,423,307,730,48,778,1488,52.28%,28.43%,1
臺中市,南屯區,0766,209,160,369,39,408,608,67.11%,34.38%,1
臺中市,南屯區,0767,294,185,479,58,537,813,66.05%,36.16%,1
臺中市,南屯區,0768,433,269,702,35,737,1190,61.93%,36.39%,1
臺中市,南屯區,0769,429,233,662,26,688,1174,58.6%,36.54%,1
臺中市,南屯區,0770,435,277,712,14,726,1224,59.31%,35.54%,1
臺中市,南屯區,0771,460,259,719,35,754,1466,51.43%,31.38%,1
臺中市,南屯區,0772,362,198,560,16,576,1333,43.21%,27.16%,1
臺中市,南屯區,0773,315,182,497,25,522,814,64.13%,38.7%,1
臺中市,南屯區,0774,500,251,751,47,798,1436,55.57%,34.82%,1
臺中市,南屯區,0775,527,333,860,46,906,1515,59.8%,34.79%,1
臺中市,南屯區,0776,459,264,723,74,797,1545,51.59%,29.71%,1
臺中市,南屯區,0777,476,313,789,32,821,1383,59.36%,34.42%,1
臺中市,南屯區,0778,511,312,823,35,858,1433,59.87%,35.66%,1
臺中市,南屯區,0779,343,259,602,27,629,1134,55.47%,30.25%,1
臺中市,南屯區,0780,446,280,726,36,762,1216,62.66%,36.68%,1
臺中市,南屯區,0781,404,261,665,70,735,1271,57.83%,31.79%,1
臺中市,南屯區,0782,408,250,658,16,674,1203,56.03%,33.92%,1
臺中市,南屯區,0783,430,298,728,22,750,1268,59.15%,33.91%,1
臺中市,南屯區,0784,554,246,800,31,831,1390,59.78%,39.86%,1
臺中市,南屯區,0785,462,314,776,35,811,1397,58.05%,33.07%,1
臺中市,南屯區,0786,511,362,873,52,925,1607,57.56%,31.8%,1
臺中市,南屯區,0787,564,362,926,28,954,1582,60.3%,35.65%,1
臺中市,南屯區,0788,632,302,934,34,968,1611,60.09%,39.23%,1
臺中市,南屯區,0789,514,300,814,29,843,1322,63.77%,38.88%,1
臺中市,南屯區,0790,518,312,830,32,862,1321,65.25%,39.21%,1
臺中市,南屯區,0791,521,284,805,45,850,1360,62.5%,38.31%,1
臺中市,南屯區,0792,553,278,831,15,846,1361,62.16%,40.63%,1
臺中市,南屯區,0793,461,295,756,38,794,1257,63.17%,36.67%,1
臺中市,南屯區,0794,476,284,760,25,785,1207,65.04%,39.44%,1
臺中市,南屯區,0795,499,303,802,20,822,1282,64.12%,38.92%,1
臺中市,南屯區,0796,473,306,779,40,819,1248,65.63%,37.9%,1
臺中市,南屯區,0797,484,328,812,45,857,1304,65.72%,37.12%,1
臺中市,南屯區,0798,448,264,712,33,745,1214,61.37%,36.9%,1
臺中市,南屯區,0799,394,283,677,37,714,1102,64.79%,35.75%,1
臺中市,南屯區,0800,672,343,1015,41,1056,1630,64.79%,41.23%,1
臺中市,南屯區,0801,495,308,803,28,831,1333,62.34%,37.13%,1
臺中市,南屯區,0802,599,122,721,24,745,1292,57.66%,46.36%,1
臺中市,南屯區,0803,473,283,756,34,790,1272,62.11%,37.19%,1
臺中市,南屯區,0804,499,279,778,33,811,1345,60.3%,37.1%,1
臺中市,南屯區,0805,407,231,638,54,692,981,70.54%,41.49%,1
臺中市,南屯區,0806,435,223,658,46,704,1097,64.18%,39.65%,1
臺中市,南屯區,0807,418,211,629,20,649,991,65.49%,42.18%,1
臺中市,南屯區,0808,439,261,700,24,724,1170,61.88%,37.52%,1
臺中市,南屯區,0809,416,288,704,43,747,1171,63.79%,35.53%,1
臺中市,南屯區,0810,454,307,761,50,811,1349,60.12%,33.65%,1
臺中市,南屯區,0811,496,348,844,27,871,1368,63.67%,36.26%,1
臺中市,南屯區,0812,488,303,791,31,822,1263,65.08%,38.64%,1
臺中市,南屯區,0813,556,359,915,42,957,1547,61.86%,35.94%,1
臺中市,南屯區,0814,502,395,897,54,951,1649,57.67%,30.44%,1
臺中市,南屯區,0815,559,346,905,35,940,1629,57.7%,34.32%,1
臺中市,南屯區,0816,468,358,826,34,860,1580,54.43%,29.62%,1
臺中市,南屯區,0817,579,338,917,32,949,1444,65.72%,40.1%,1
臺中市,南屯區,0818,519,302,821,24,845,1413,59.8%,36.73%,1
臺中市,南屯區,0819,493,292,785,29,814,1377,59.11%,35.8%,1
臺中市,南屯區,0820,503,402,905,27,932,1527,61.03%,32.94%,1
臺中市,南屯區,0821,515,302,817,25,842,1335,63.07%,38.58%,1
臺中市,南屯區,0822,611,384,995,41,1036,1544,67.1%,39.57%,1
臺中市,南屯區,0823,567,374,941,34,975,1482,65.79%,38.26%,1
臺中市,南屯區,0824,563,320,883,47,930,1488,62.5%,37.84%,1
臺中市,南屯區,0825,462,312,774,40,814,1538,52.93%,30.04%,1
臺中市,南屯區,0826,627,379,1006,53,1059,1674,63.26%,37.46%,1
臺中市,南屯區,0827,506,322,828,36,864,1996,43.29%,25.35%,1
臺中市,南屯區,0828,578,298,876,46,922,1514,60.9%,38.18%,1
臺中市,南屯區,0829,496,245,741,44,785,1217,64.5%,40.76%,1
臺中市,南屯區,0830,468,310,778,29,807,1347,59.91%,34.74%,1
臺中市,南屯區,0831,429,246,675,23,698,1109,62.94%,38.68%,1
臺中市,南屯區,0832,527,344,871,31,902,1546,58.34%,34.09%,1
臺中市,南屯區,0833,537,322,859,48,907,1408,64.42%,38.14%,1
臺中市,南屯區,0834,294,300,594,26,620,1057,58.66%,27.81%,1
臺中市,南屯區,0835,399,250,649,46,695,1133,61.34%,35.22%,1
臺中市,南屯區,0836,454,305,759,32,791,1278,61.89%,35.52%,1
臺中市,南屯區,0837,463,263,726,30,756,1144,66.08%,40.47%,1
臺中市,南屯區,0838,394,269,663,41,704,1140,61.75%,34.56%,1
臺中市,南屯區,0839,439,275,714,31,745,1171,63.62%,37.49%,1
臺中市,南屯區,0840,503,307,810,29,839,1303,64.39%,38.6%,1
臺中市,南屯區,0841,469,297,766,39,805,1402,57.42%,33.45%,1
臺中市,南屯區,0842,552,298,850,53,903,1571,57.48%,35.14%,1
臺中市,南屯區,0843,425,286,711,28,739,1139,64.88%,37.31%,1
臺中市,南屯區,0844,475,275,750,38,788,1216,64.8%,39.06%,1
臺中市,南屯區,0845,473,244,717,30,747,1162,64.29%,40.71%,1
臺中市,北屯區,0846,622,388,1010,36,1046,1670,62.63%,37.25%,1
臺中市,北屯區,0847,583,304,887,47,934,1706,54.75%,34.17%,1
臺中市,北屯區,0848,505,289,794,12,806,1507,53.48%,33.51%,1
臺中市,北屯區,0849,553,388,941,48,989,1652,59.87%,33.47%,1
臺中市,北屯區,0850,368,238,606,18,624,1107,56.37%,33.24%,1
臺中市,北屯區,0851,723,387,1110,56,1166,2151,54.21%,33.61%,1
臺中市,北屯區,0852,627,327,954,35,989,1612,61.35%,38.9%,1
臺中市,北屯區,0853,571,392,963,35,998,1743,57.26%,32.76%,1
臺中市,北屯區,0854,645,431,1076,37,1113,2099,53.03%,30.73%,1
臺中市,北屯區,0855,600,303,903,31,934,1595,58.56%,37.62%,1
臺中市,北屯區,0856,599,384,983,39,1022,1923,53.15%,31.15%,1
臺中市,北屯區,0857,541,327,868,42,910,1641,55.45%,32.97%,1
臺中市,北屯區,0858,445,280,725,39,764,1157,66.03%,38.46%,1
臺中市,北屯區,0859,400,240,640,26,666,1041,63.98%,38.42%,1
臺中市,北屯區,0860,502,304,806,42,848,1563,54.25%,32.12%,1
臺中市,北屯區,0861,490,314,804,42,846,1559,54.27%,31.43%,1
臺中市,北屯區,0862,472,247,719,24,743,1411,52.66%,33.45%,1
臺中市,北屯區,0863,608,400,1008,35,1043,1761,59.23%,34.53%,1
臺中市,北屯區,0864,528,278,806,58,864,1361,63.48%,38.8%,1
臺中市,北屯區,0865,640,372,1012,49,1061,1852,57.29%,34.56%,1
臺中市,北屯區,0866,661,424,1085,45,1130,1928,58.61%,34.28%,1
臺中市,北屯區,0867,600,340,940,25,965,1492,64.68%,40.21%,1
臺中市,北屯區,0868,645,406,1051,54,1105,1998,55.31%,32.28%,1
臺中市,北屯區,0869,485,314,799,31,830,1272,65.25%,38.13%,1
臺中市,北屯區,0870,481,291,772,38,810,1317,61.5%,36.52%,1
臺中市,北屯區,0871,383,284,667,52,719,1327,54.18%,28.86%,1
臺中市,北屯區,0872,384,293,677,25,702,1280,54.84%,30%,1
臺中市,北屯區,0873,578,367,945,45,990,1865,53.08%,30.99%,1
臺中市,北屯區,0874,450,300,750,42,792,1230,64.39%,36.59%,1
臺中市,北屯區,0875,438,268,706,44,750,1356,55.31%,32.3%,1
臺中市,北屯區,0876,615,344,959,37,996,1732,57.51%,35.51%,1
臺中市,北屯區,0877,563,346,909,37,946,1586,59.65%,35.5%,1
臺中市,北屯區,0878,480,303,783,34,817,1441,56.7%,33.31%,1
臺中市,北屯區,0879,596,447,1043,71,1114,2045,54.47%,29.14%,1
臺中市,北屯區,0880,564,387,951,58,1009,1914,52.72%,29.47%,1
臺中市,北屯區,0881,666,384,1050,47,1097,1918,57.19%,34.72%,1
臺中市,北屯區,0882,650,404,1054,30,1084,2079,52.14%,31.27%,1
臺中市,北屯區,0883,669,431,1100,61,1161,2040,56.91%,32.79%,1
臺中市,北屯區,0884,563,390,953,56,1009,2027,49.78%,27.78%,1
臺中市,北屯區,0885,488,266,754,43,797,1402,56.85%,34.81%,1
臺中市,北屯區,0886,596,416,1012,61,1073,1826,58.76%,32.64%,1
臺中市,北屯區,0887,679,380,1059,38,1097,2162,50.74%,31.41%,1
臺中市,北屯區,0888,651,448,1099,25,1124,2332,48.2%,27.92%,1
臺中市,北屯區,0889,302,243,545,37,582,985,59.09%,30.66%,1
臺中市,北屯區,0890,642,396,1038,41,1079,2037,52.97%,31.52%,1
臺中市,北屯區,0891,344,253,597,37,634,1032,61.43%,33.33%,1
臺中市,北屯區,0892,351,239,590,34,624,1062,58.76%,33.05%,1
臺中市,北屯區,0893,304,177,481,46,527,909,57.98%,33.44%,1
臺中市,北屯區,0894,520,301,821,55,876,1445,60.62%,35.99%,1
臺中市,北屯區,0895,582,365,947,46,993,1842,53.91%,31.6%,1
臺中市,北屯區,0896,413,278,691,31,722,1187,60.83%,34.79%,1
臺中市,北屯區,0897,547,287,834,39,873,1456,59.96%,37.57%,1
臺中市,北屯區,0898,643,397,1040,48,1088,1866,58.31%,34.46%,1
臺中市,北屯區,0899,532,334,866,41,907,1667,54.41%,31.91%,1
臺中市,北屯區,0900,595,380,975,25,1000,1683,59.42%,35.35%,1
臺中市,北屯區,0901,559,338,897,28,925,1642,56.33%,34.04%,1
臺中市,北屯區,0902,544,328,872,26,898,1475,60.88%,36.88%,1
臺中市,北屯區,0903,568,328,896,24,920,1644,55.96%,34.55%,1
臺中市,北屯區,0904,596,344,940,36,976,1603,60.89%,37.18%,1
臺中市,北屯區,0905,666,439,1105,59,1164,1949,59.72%,34.17%,1
臺中市,北屯區,0906,680,417,1097,43,1140,1790,63.69%,37.99%,1
臺中市,北屯區,0907,480,345,825,33,858,1440,59.58%,33.33%,1
臺中市,北屯區,0908,578,353,931,57,988,1601,61.71%,36.1%,1
臺中市,北屯區,0909,516,304,820,46,866,1527,56.71%,33.79%,1
臺中市,北屯區,0910,625,225,850,42,892,1675,53.25%,37.31%,1
臺中市,北屯區,0911,526,241,767,42,809,1579,51.23%,33.31%,1
臺中市,北屯區,0912,498,336,834,53,887,1524,58.2%,32.68%,1
臺中市,北屯區,0913,564,321,885,42,927,1677,55.28%,33.63%,1
臺中市,北屯區,0914,558,320,878,43,921,1599,57.6%,34.9%,1
臺中市,北屯區,0915,469,375,844,44,888,1458,60.91%,32.17%,1
臺中市,北屯區,0916,633,282,915,41,956,1571,60.85%,40.29%,1
臺中市,北屯區,0917,559,345,904,42,946,1579,59.91%,35.4%,1
臺中市,北屯區,0918,661,388,1049,46,1095,1849,59.22%,35.75%,1
臺中市,北屯區,0919,586,351,937,32,969,1682,57.61%,34.84%,1
臺中市,北屯區,0920,591,343,934,38,972,1760,55.23%,33.58%,1
臺中市,北屯區,0921,555,384,939,55,994,1699,58.51%,32.67%,1
臺中市,北屯區,0922,596,381,977,46,1023,1626,62.92%,36.65%,1
臺中市,北屯區,0923,522,367,889,12,901,1491,60.43%,35.01%,1
臺中市,北屯區,0924,547,360,907,39,946,1640,57.68%,33.35%,1
臺中市,北屯區,0925,542,437,979,57,1036,2052,50.49%,26.41%,1
臺中市,北屯區,0926,644,390,1034,47,1081,1875,57.65%,34.35%,1
臺中市,北屯區,0927,528,344,872,32,904,1559,57.99%,33.87%,1
臺中市,北屯區,0928,494,350,844,42,886,1480,59.86%,33.38%,1
臺中市,北屯區,0929,446,336,782,46,828,1397,59.27%,31.93%,1
臺中市,北屯區,0930,646,405,1051,44,1095,1889,57.97%,34.2%,1
臺中市,北屯區,0931,571,363,934,38,972,1728,56.25%,33.04%,1
臺中市,北屯區,0932,519,330,849,47,896,1592,56.28%,32.6%,1
臺中市,北屯區,0933,533,355,888,43,931,1656,56.22%,32.19%,1
臺中市,北屯區,0934,477,316,793,32,825,1524,54.13%,31.3%,1
臺中市,北屯區,0935,519,331,850,32,882,1502,58.72%,34.55%,1
臺中市,北屯區,0936,625,339,964,31,995,1772,56.15%,35.27%,1
臺中市,北屯區,0937,491,338,829,47,876,1461,59.96%,33.61%,1
臺中市,北屯區,0938,549,346,895,28,923,1769,52.18%,31.03%,1
臺中市,北屯區,0939,627,459,1086,50,1136,1894,59.98%,33.1%,1
臺中市,北屯區,0940,603,423,1026,49,1075,2033,52.88%,29.66%,1
臺中市,北屯區,0941,615,404,1019,46,1065,1947,54.7%,31.59%,1
臺中市,北屯區,0942,715,493,1208,52,1260,2188,57.59%,32.68%,1
臺中市,北屯區,0943,580,361,941,66,1007,1661,60.63%,34.92%,1
臺中市,北屯區,0944,577,367,944,30,974,1667,58.43%,34.61%,1
臺中市,北屯區,0945,595,337,932,51,983,1728,56.89%,34.43%,1
臺中市,北屯區,0946,572,357,929,17,946,1688,56.04%,33.89%,1
臺中市,北屯區,0947,501,325,826,24,850,1475,57.63%,33.97%,1
臺中市,北屯區,0948,619,409,1028,33,1061,1681,63.12%,36.82%,1
臺中市,北屯區,0949,717,469,1186,49,1235,2078,59.43%,34.5%,1
臺中市,北屯區,0950,701,414,1115,50,1165,2059,56.58%,34.05%,1
臺中市,北屯區,0951,628,413,1041,34,1075,1792,59.99%,35.04%,1
臺中市,北屯區,0952,618,411,1029,30,1059,2974,35.61%,20.78%,1
臺中市,北屯區,0953,380,218,598,36,634,1072,59.14%,35.45%,1
臺中市,北屯區,0954,794,457,1251,45,1296,2099,61.74%,37.83%,1
臺中市,北屯區,0955,701,423,1124,59,1183,1823,64.89%,38.45%,1
臺中市,北屯區,0956,734,426,1160,75,1235,2022,61.08%,36.3%,1
臺中市,北屯區,0957,680,432,1112,41,1153,1992,57.88%,34.14%,1
臺中市,北屯區,0958,568,362,930,54,984,1585,62.08%,35.84%,1
臺中市,北屯區,0959,555,361,916,46,962,1565,61.47%,35.46%,1
臺中市,北屯區,0960,590,313,903,50,953,1780,53.54%,33.15%,1
臺中市,北屯區,0961,655,447,1102,56,1158,1874,61.79%,34.95%,1
臺中市,北屯區,0962,717,322,1039,43,1082,1755,61.65%,40.85%,1
臺中市,北屯區,0963,601,384,985,29,1014,1497,67.74%,40.15%,1
臺中市,北屯區,0964,590,351,941,44,985,1567,62.86%,37.65%,1
臺中市,北屯區,0965,543,329,872,49,921,1624,56.71%,33.44%,1
臺中市,北屯區,0966,602,358,960,43,1003,1614,62.14%,37.3%,1
臺中市,北屯區,0967,544,344,888,28,916,1595,57.43%,34.11%,1
臺中市,北屯區,0968,603,293,896,56,952,1782,53.42%,33.84%,1
臺中市,北屯區,0969,452,246,698,24,722,1357,53.21%,33.31%,1
臺中市,北屯區,0970,365,220,585,42,627,1071,58.54%,34.08%,1
臺中市,北屯區,0971,444,269,713,58,771,1372,56.2%,32.36%,1
臺中市,北屯區,0972,518,279,797,46,843,1415,59.58%,36.61%,1
臺中市,北屯區,0973,632,410,1042,71,1113,1789,62.21%,35.33%,1
臺中市,北屯區,0974,747,384,1131,69,1200,1907,62.93%,39.17%,1
臺中市,北屯區,0975,717,426,1143,47,1190,2008,59.26%,35.71%,1
臺中市,北屯區,0976,557,283,840,46,886,1541,57.5%,36.15%,1
臺中市,北屯區,0977,634,337,971,40,1011,1669,60.58%,37.99%,1
臺中市,北屯區,0978,599,354,953,43,996,1685,59.11%,35.55%,1
臺中市,北屯區,0979,621,371,992,68,1060,1785,59.38%,34.79%,1
臺中市,北屯區,0980,600,336,936,49,985,1596,61.72%,37.59%,1
臺中市,北屯區,0981,603,399,1002,50,1052,1731,60.77%,34.84%,1
臺中市,北屯區,0982,517,270,787,65,852,1496,56.95%,34.56%,1
臺中市,豐原區,0394,327,202,529,34,563,983,57.27%,33.27%,1
臺中市,豐原區,0395,486,289,775,50,825,1309,63.03%,37.13%,1
臺中市,豐原區,0396,401,264,665,33,698,1116,62.54%,35.93%,1
臺中市,豐原區,0397,362,215,577,37,614,945,64.97%,38.31%,1
臺中市,豐原區,0398,302,204,506,48,554,850,65.18%,35.53%,1
臺中市,豐原區,0399,281,194,475,24,499,760,65.66%,36.97%,1
臺中市,豐原區,0400,591,325,916,13,929,1617,57.45%,36.55%,1
臺中市,豐原區,0401,537,303,840,52,892,1677,53.19%,32.02%,1
臺中市,豐原區,0402,656,436,1092,47,1139,1771,64.31%,37.04%,1
臺中市,豐原區,0403,381,236,617,51,668,1145,58.34%,33.28%,1
臺中市,豐原區,0404,473,273,746,37,783,1362,57.49%,34.73%,1
臺中市,豐原區,0405,504,294,798,48,846,1389,60.91%,36.29%,1
臺中市,豐原區,0406,544,343,887,45,932,1530,60.92%,35.56%,1
臺中市,豐原區,0407,478,346,824,60,884,1471,60.1%,32.49%,1
臺中市,豐原區,0408,483,325,808,58,866,1410,61.42%,34.26%,1
臺中市,豐原區,0409,392,251,643,40,683,1162,58.78%,33.73%,1
臺中市,豐原區,0410,554,363,917,36,953,1656,57.55%,33.45%,1
臺中市,豐原區,0411,624,373,997,51,1048,1838,57.02%,33.95%,1
臺中市,豐原區,0412,550,351,901,52,953,1666,57.2%,33.01%,1
臺中市,豐原區,0413,655,362,1017,82,1099,1821,60.35%,35.97%,1
臺中市,豐原區,0414,697,462,1159,58,1217,1821,66.83%,38.28%,1
臺中市,豐原區,0415,559,352,911,34,945,1647,57.38%,33.94%,1
臺中市,豐原區,0416,483,312,795,52,847,1256,67.44%,38.46%,1
臺中市,豐原區,0417,570,387,957,48,1005,1552,64.76%,36.73%,1
臺中市,豐原區,0418,630,387,1017,46,1063,1793,59.29%,35.14%,1
臺中市,豐原區,0419,312,185,497,35,532,759,70.09%,41.11%,1
臺中市,豐原區,0420,250,152,402,23,425,642,66.2%,38.94%,1
臺中市,豐原區,0421,591,329,920,27,947,1528,61.98%,38.68%,1
臺中市,豐原區,0422,671,416,1087,56,1143,1788,63.93%,37.53%,1
臺中市,豐原區,0423,654,373,1027,63,1090,1663,65.54%,39.33%,1
臺中市,豐原區,0424,531,293,824,50,874,1260,69.37%,42.14%,1
臺中市,豐原區,0425,321,190,511,28,539,902,59.76%,35.59%,1
臺中市,豐原區,0426,465,276,741,21,762,1357,56.15%,34.27%,1
臺中市,豐原區,0427,475,366,841,42,883,1592,55.46%,29.84%,1
臺中市,豐原區,0428,701,341,1042,58,1100,1873,58.73%,37.43%,1
臺中市,豐原區,0429,627,415,1042,50,1092,1867,58.49%,33.58%,1
臺中市,豐原區,0430,636,358,994,68,1062,1823,58.26%,34.89%,1
臺中市,豐原區,0431,578,409,987,58,1045,1962,53.26%,29.46%,1
臺中市,豐原區,0432,811,539,1350,61,1411,2313,61%,35.06%,1
臺中市,豐原區,0433,556,336,892,52,944,1510,62.52%,36.82%,1
臺中市,豐原區,0434,648,393,1041,55,1096,1824,60.09%,35.53%,1
臺中市,豐原區,0435,521,289,810,33,843,1363,61.85%,38.22%,1
臺中市,豐原區,0436,567,367,934,45,979,1535,63.78%,36.94%,1
臺中市,豐原區,0437,515,351,866,46,912,1457,62.59%,35.35%,1
臺中市,豐原區,0438,422,285,707,30,737,1184,62.25%,35.64%,1
臺中市,豐原區,0439,652,432,1084,42,1126,2299,48.98%,28.36%,1
臺中市,豐原區,0440,655,440,1095,57,1152,1940,59.38%,33.76%,1
臺中市,豐原區,0441,684,459,1143,38,1181,2067,57.14%,33.09%,1
臺中市,豐原區,0442,669,407,1076,84,1160,2038,56.92%,32.83%,1
臺中市,豐原區,0443,602,427,1029,38,1067,1835,58.15%,32.81%,1
臺中市,豐原區,0444,635,437,1072,76,1148,1979,58.01%,32.09%,1
臺中市,豐原區,0445,619,450,1069,76,1145,2014,56.85%,30.73%,1
臺中市,豐原區,0446,766,476,1242,85,1327,2257,58.79%,33.94%,1
臺中市,豐原區,0447,506,330,836,57,893,1406,63.51%,35.99%,1
臺中市,豐原區,0448,500,333,833,35,868,1418,61.21%,35.26%,1
臺中市,豐原區,0449,654,412,1066,61,1127,1772,63.6%,36.91%,1
臺中市,豐原區,0450,449,293,742,37,779,1202,64.81%,37.35%,1
臺中市,豐原區,0451,573,293,866,32,898,1447,62.06%,39.6%,1
臺中市,豐原區,0452,617,383,1000,82,1082,1758,61.55%,35.1%,1
臺中市,豐原區,0453,580,367,947,49,996,1546,64.42%,37.52%,1
臺中市,豐原區,0454,679,397,1076,47,1123,1815,61.87%,37.41%,1
臺中市,豐原區,0455,648,454,1102,71,1173,1932,60.71%,33.54%,1
臺中市,豐原區,0456,665,422,1087,51,1138,1770,64.29%,37.57%,1
臺中市,豐原區,0457,549,289,838,34,872,1560,55.9%,35.19%,1
臺中市,豐原區,0458,626,397,1023,44,1067,1810,58.95%,34.59%,1
臺中市,豐原區,0459,609,404,1013,40,1053,1653,63.7%,36.84%,1
臺中市,豐原區,0460,504,301,805,58,863,1444,59.76%,34.9%,1
臺中市,豐原區,0461,478,326,804,37,841,1318,63.81%,36.27%,1
臺中市,豐原區,0462,529,366,895,63,958,1566,61.17%,33.78%,1
臺中市,豐原區,0463,596,376,972,57,1029,1748,58.87%,34.1%,1
臺中市,豐原區,0464,512,385,897,73,970,1772,54.74%,28.89%,1
臺中市,豐原區,0465,587,364,951,63,1014,1721,58.92%,34.11%,1
臺中市,豐原區,0466,560,347,907,46,953,1578,60.39%,35.49%,1
臺中市,豐原區,0467,596,429,1025,70,1095,1859,58.9%,32.06%,1
臺中市,豐原區,0468,510,330,840,45,885,1479,59.84%,34.48%,1
臺中市,豐原區,0469,664,405,1069,61,1130,1889,59.82%,35.15%,1
臺中市,豐原區,0470,575,408,983,54,1037,1803,57.52%,31.89%,1
臺中市,豐原區,0471,417,357,774,47,821,1421,57.78%,29.35%,1
臺中市,豐原區,0472,556,391,947,54,1001,1585,63.15%,35.08%,1
臺中市,豐原區,0473,657,398,1055,67,1122,1774,63.25%,37.03%,1
臺中市,豐原區,0474,762,444,1206,62,1268,2132,59.47%,35.74%,1
臺中市,豐原區,0475,550,306,856,54,910,1515,60.07%,36.3%,1
臺中市,豐原區,0476,467,263,730,36,766,1359,56.36%,34.36%,1
臺中市,豐原區,0477,337,212,549,51,600,948,63.29%,35.55%,1
臺中市,豐原區,0478,382,290,672,39,711,1134,62.7%,33.69%,1
臺中市,豐原區,0479,425,263,688,61,749,1114,67.24%,38.15%,1
臺中市,豐原區,0480,338,264,602,48,650,1050,61.9%,32.19%,1
臺中市,豐原區,0481,394,333,727,49,776,1182,65.65%,33.33%,1
臺中市,東勢區,1513,391,271,662,61,723,1299,55.66%,30.1%,1
臺中市,東勢區,1514,342,194,536,49,585,1007,58.09%,33.96%,1
臺中市,東勢區,1515,266,172,438,43,481,859,56%,30.97%,1
臺中市,東勢區,1516,428,180,608,42,650,991,65.59%,43.19%,1
臺中市,東勢區,1517,268,160,428,26,454,863,52.61%,31.05%,1
臺中市,東勢區,1518,540,312,852,78,930,1628,57.13%,33.17%,1
臺中市,東勢區,1519,419,256,675,52,727,1335,54.46%,31.39%,1
臺中市,東勢區,1520,427,242,669,39,708,1092,64.84%,39.1%,1
臺中市,東勢區,1521,429,208,637,41,678,1050,64.57%,40.86%,1
臺中市,東勢區,1522,537,250,787,40,827,1431,57.79%,37.53%,1
臺中市,東勢區,1523,537,244,781,43,824,1372,60.06%,39.14%,1
臺中市,東勢區,1524,538,275,813,29,842,1412,59.63%,38.1%,1
臺中市,東勢區,1525,311,144,455,65,520,878,59.23%,35.42%,1
臺中市,東勢區,1526,434,267,701,63,764,1475,51.8%,29.42%,1
臺中市,東勢區,1527,310,145,455,19,474,872,54.36%,35.55%,1
臺中市,東勢區,1528,331,168,499,71,570,1006,56.66%,32.9%,1
臺中市,東勢區,1529,434,234,668,27,695,1222,56.87%,35.52%,1
臺中市,東勢區,1530,513,247,760,50,810,1228,65.96%,41.78%,1
臺中市,東勢區,1531,436,186,622,42,664,1036,64.09%,42.08%,1
臺中市,東勢區,1532,413,198,611,27,638,977,65.3%,42.27%,1
臺中市,東勢區,1533,506,257,763,39,802,1395,57.49%,36.27%,1
臺中市,東勢區,1534,460,211,671,72,743,1169,63.56%,39.35%,1
臺中市,東勢區,1535,410,193,603,41,644,1027,62.71%,39.92%,1
臺中市,東勢區,1536,390,184,574,30,604,984,61.38%,39.63%,1
臺中市,東勢區,1537,377,180,557,27,584,866,67.44%,43.53%,1
臺中市,東勢區,1538,384,182,566,74,640,1031,62.08%,37.25%,1
臺中市,東勢區,1539,329,193,522,57,579,865,66.94%,38.03%,1
臺中市,東勢區,1540,573,248,821,41,862,1357,63.52%,42.23%,1
臺中市,東勢區,1541,268,152,420,30,450,736,61.14%,36.41%,1
臺中市,東勢區,1542,500,235,735,46,781,1314,59.44%,38.05%,1
臺中市,東勢區,1543,507,317,824,78,902,1677,53.79%,30.23%,1
臺中市,東勢區,1544,366,210,576,21,597,950,62.84%,38.53%,1
臺中市,東勢區,1545,371,223,594,38,632,1007,62.76%,36.84%,1
臺中市,東勢區,1546,384,215,599,48,647,1214,53.29%,31.63%,1
臺中市,東勢區,1547,277,208,485,36,521,907,57.44%,30.54%,1
臺中市,東勢區,1548,246,212,458,39,497,902,55.1%,27.27%,1
臺中市,東勢區,1549,205,116,321,10,331,720,45.97%,28.47%,1
臺中市,東勢區,1550,165,140,305,18,323,666,48.5%,24.77%,1
臺中市,東勢區,1551,437,262,699,48,747,1361,54.89%,32.11%,1
臺中市,大甲區,0001,501,254,755,59,814,1356,60.03%,36.95%,1
臺中市,大甲區,0002,388,241,629,36,665,1059,62.8%,36.64%,1
臺中市,大甲區,0003,252,163,415,30,445,694,64.12%,36.31%,1
臺中市,大甲區,0004,318,206,524,17,541,874,61.9%,36.38%,1
臺中市,大甲區,0005,244,162,406,24,430,763,56.36%,31.98%,1
臺中市,大甲區,0006,311,213,524,28,552,856,64.49%,36.33%,1
臺中市,大甲區,0007,444,292,736,33,769,1249,61.57%,35.55%,1
臺中市,大甲區,0008,308,195,503,27,530,922,57.48%,33.41%,1
臺中市,大甲區,0009,432,255,687,30,717,1189,60.3%,36.33%,1
臺中市,大甲區,0010,392,237,629,51,680,1065,63.85%,36.81%,1
臺中市,大甲區,0011,485,272,757,48,805,1252,64.3%,38.74%,1
臺中市,大甲區,0012,350,223,573,57,630,1057,59.6%,33.11%,1
臺中市,大甲區,0013,375,218,593,34,627,1031,60.81%,36.37%,1
臺中市,大甲區,0014,402,247,649,23,672,1060,63.4%,37.92%,1
臺中市,大甲區,0015,439,277,716,52,768,1311,58.58%,33.49%,1
臺中市,大甲區,0016,479,305,784,37,821,1424,57.65%,33.64%,1
臺中市,大甲區,0017,519,357,876,52,928,1670,55.57%,31.08%,1
臺中市,大甲區,0018,290,165,455,31,486,812,59.85%,35.71%,1
臺中市,大甲區,0019,347,173,520,42,562,863,65.12%,40.21%,1
臺中市,大甲區,0020,664,244,908,42,950,1598,59.45%,41.55%,1
臺中市,大甲區,0021,552,320,872,37,909,1588,57.24%,34.76%,1
臺中市,大甲區,0022,405,253,658,41,699,1197,58.4%,33.83%,1
臺中市,大甲區,0023,420,39,459,60,519,1106,46.93%,37.97%,1
臺中市,大甲區,0024,318,211,529,40,569,903,63.01%,35.22%,1
臺中市,大甲區,0025,442,76,518,32,550,869,63.29%,50.86%,1
臺中市,大甲區,0026,466,335,801,29,830,1350,61.48%,34.52%,1
臺中市,大甲區,0027,395,231,626,63,689,1144,60.23%,34.53%,1
臺中市,大甲區,0028,460,248,708,37,745,1208,61.67%,38.08%,1
臺中市,大甲區,0029,536,368,904,34,938,1567,59.86%,34.21%,1
臺中市,大甲區,0030,446,328,774,28,802,1246,64.37%,35.79%,1
臺中市,大甲區,0031,282,169,451,26,477,767,62.19%,36.77%,1
臺中市,大甲區,0032,278,182,460,26,486,790,61.52%,35.19%,1
臺中市,大甲區,0033,393,188,581,32,613,972,63.07%,40.43%,1
臺中市,大甲區,0034,449,301,750,27,777,1388,55.98%,32.35%,1
臺中市,大甲區,0035,412,282,694,26,720,1331,54.09%,30.95%,1
臺中市,大甲區,0036,466,228,694,34,728,1167,62.38%,39.93%,1
臺中市,大甲區,0037,705,438,1143,44,1187,1934,61.38%,36.45%,1
臺中市,大甲區,0038,368,254,622,39,661,1263,52.34%,29.14%,1
臺中市,大甲區,0039,446,320,766,39,805,1390,57.91%,32.09%,1
臺中市,大甲區,0040,358,227,585,28,613,1186,51.69%,30.19%,1
臺中市,大甲區,0041,453,316,769,33,802,1397,57.41%,32.43%,1
臺中市,大甲區,0042,311,234,545,16,561,1173,47.83%,26.51%,1
臺中市,大甲區,0043,414,298,712,60,772,1398,55.22%,29.61%,1
臺中市,大甲區,0044,337,261,598,42,640,1228,52.12%,27.44%,1
臺中市,大甲區,0045,383,263,646,36,682,1258,54.21%,30.45%,1
臺中市,大甲區,0046,404,334,738,44,782,1435,54.49%,28.15%,1
臺中市,大甲區,0047,460,349,809,34,843,1532,55.03%,30.03%,1
臺中市,大甲區,0048,208,143,351,31,382,652,58.59%,31.9%,1
臺中市,大甲區,0049,229,186,415,32,447,870,51.38%,26.32%,1
臺中市,大甲區,0050,276,180,456,24,480,891,53.87%,30.98%,1
臺中市,大甲區,0051,278,159,437,28,465,784,59.31%,35.46%,1
臺中市,大甲區,0052,411,270,681,72,753,1368,55.04%,30.04%,1
臺中市,大甲區,0053,316,222,538,66,604,1126,53.64%,28.06%,1
臺中市,大甲區,0054,401,280,681,57,738,1486,49.66%,26.99%,1
臺中市,清水區,0091,327,224,551,36,587,1076,54.55%,30.39%,1
臺中市,清水區,0092,364,223,587,38,625,953,65.58%,38.2%,1
臺中市,清水區,0093,304,219,523,54,577,914,63.13%,33.26%,1
臺中市,清水區,0094,441,250,691,40,731,1143,63.95%,38.58%,1
臺中市,清水區,0095,240,157,397,28,425,680,62.5%,35.29%,1
臺中市,清水區,0096,324,208,532,32,564,904,62.39%,35.84%,1
臺中市,清水區,0097,334,212,546,38,584,893,65.4%,37.4%,1
臺中市,清水區,0098,532,349,881,39,920,1577,58.34%,33.73%,1
臺中市,清水區,0099,253,133,386,30,416,690,60.29%,36.67%,1
臺中市,清水區,0100,145,89,234,16,250,403,62.03%,35.98%,1
臺中市,清水區,0101,470,311,781,55,836,1413,59.16%,33.26%,1
臺中市,清水區,0102,267,164,431,28,459,777,59.07%,34.36%,1
臺中市,清水區,0103,498,263,761,38,799,1313,60.85%,37.93%,1
臺中市,清水區,0104,512,325,837,59,896,1439,62.27%,35.58%,1
臺中市,清水區,0105,411,261,672,24,696,1265,55.02%,32.49%,1
臺中市,清水區,0106,479,282,761,39,800,1277,62.65%,37.51%,1
臺中市,清水區,0107,473,266,739,40,779,1276,61.05%,37.07%,1
臺中市,清水區,0108,502,327,829,39,868,1376,63.08%,36.48%,1
臺中市,清水區,0109,492,314,806,24,830,1291,64.29%,38.11%,1
臺中市,清水區,0110,498,375,873,48,921,1510,60.99%,32.98%,1
臺中市,清水區,0111,514,323,837,70,907,1524,59.51%,33.73%,1
臺中市,清水區,0112,440,315,755,41,796,1474,54%,29.85%,1
臺中市,清水區,0113,537,279,816,45,861,1507,57.13%,35.63%,1
臺中市,清水區,0114,482,322,804,57,861,1321,65.18%,36.49%,1
臺中市,清水區,0115,348,232,580,34,614,1157,53.07%,30.08%,1
臺中市,清水區,0116,424,302,726,35,761,1255,60.64%,33.78%,1
臺中市,清水區,0117,290,194,484,26,510,881,57.89%,32.92%,1
臺中市,清水區,0118,356,280,636,44,680,1083,62.79%,32.87%,1
臺中市,清水區,0119,329,215,544,42,586,951,61.62%,34.6%,1
臺中市,清水區,0120,446,287,733,54,787,1424,55.27%,31.32%,1
臺中市,清水區,0121,388,225,613,61,674,1233,54.66%,31.47%,1
臺中市,清水區,0122,342,249,591,44,635,1288,49.3%,26.55%,1
臺中市,清水區,0123,429,247,676,46,722,1200,60.17%,35.75%,1
臺中市,清水區,0124,633,298,931,38,969,1609,60.22%,39.34%,1
臺中市,清水區,0125,419,279,698,27,725,1136,63.82%,36.88%,1
臺中市,清水區,0126,404,270,674,64,738,1302,56.68%,31.03%,1
臺中市,清水區,0127,443,272,715,67,782,1373,56.96%,32.27%,1
臺中市,清水區,0128,327,263,590,66,656,1257,52.19%,26.01%,1
臺中市,清水區,0129,332,224,556,49,605,1184,51.1%,28.04%,1
臺中市,清水區,0130,419,278,697,52,749,1322,56.66%,31.69%,1
臺中市,清水區,0131,357,228,585,45,630,1193,52.81%,29.92%,1
臺中市,清水區,0132,286,188,474,72,546,927,58.9%,30.85%,1
臺中市,清水區,0133,388,240,628,44,672,1073,62.63%,36.16%,1
臺中市,清水區,0134,390,275,665,64,729,1163,62.68%,33.53%,1
臺中市,清水區,0135,265,175,440,38,478,855,55.91%,30.99%,1
臺中市,清水區,0136,267,188,455,49,504,902,55.88%,29.6%,1
臺中市,清水區,0137,427,346,773,43,816,1415,57.67%,30.18%,1
臺中市,清水區,0138,309,237,546,37,583,1066,54.69%,28.99%,1
臺中市,清水區,0139,438,290,728,63,791,1391,56.87%,31.49%,1
臺中市,清水區,0140,439,294,733,33,766,1449,52.86%,30.3%,1
臺中市,清水區,0141,448,338,786,50,836,1377,60.71%,32.53%,1
臺中市,清水區,0142,481,323,804,44,848,1423,59.59%,33.8%,1
臺中市,清水區,0143,567,337,904,40,944,1624,58.13%,34.91%,1
臺中市,清水區,0144,319,382,701,77,778,1358,57.29%,23.49%,1
臺中市,清水區,0145,430,355,785,70,855,1464,58.4%,29.37%,1
臺中市,清水區,0146,399,254,653,56,709,1211,58.55%,32.95%,1
臺中市,清水區,0147,466,297,763,34,797,1456,54.74%,32.01%,1
臺中市,清水區,0148,446,227,673,55,728,1162,62.65%,38.38%,1
臺中市,清水區,0149,555,261,816,63,879,1368,64.25%,40.57%,1
臺中市,沙鹿區,0186,419,294,713,37,750,1380,54.35%,30.36%,1
臺中市,沙鹿區,0187,308,178,486,35,521,852,61.15%,36.15%,1
臺中市,沙鹿區,0188,459,240,699,34,733,1176,62.33%,39.03%,1
臺中市,沙鹿區,0189,341,250,591,55,646,958,67.43%,35.59%,1
臺中市,沙鹿區,0190,206,99,305,30,335,488,68.65%,42.21%,1
臺中市,沙鹿區,0191,366,286,652,40,692,1177,58.79%,31.1%,1
臺中市,沙鹿區,0192,430,266,696,43,739,1285,57.51%,33.46%,1
臺中市,沙鹿區,0193,504,378,882,62,944,1736,54.38%,29.03%,1
臺中市,沙鹿區,0194,542,380,922,70,992,1628,60.93%,33.29%,1
臺中市,沙鹿區,0195,470,295,765,36,801,1469,54.53%,31.99%,1
臺中市,沙鹿區,0196,534,298,832,40,872,1423,61.28%,37.53%,1
臺中市,沙鹿區,0197,473,318,791,70,861,1444,59.63%,32.76%,1
臺中市,沙鹿區,0198,489,312,801,64,865,1469,58.88%,33.29%,1
臺中市,沙鹿區,0199,610,422,1032,69,1101,1902,57.89%,32.07%,1
臺中市,沙鹿區,0200,549,392,941,47,988,1675,58.99%,32.78%,1
臺中市,沙鹿區,0201,364,230,594,44,638,1098,58.11%,33.15%,1
臺中市,沙鹿區,0202,516,362,878,61,939,1539,61.01%,33.53%,1
臺中市,沙鹿區,0203,480,301,781,31,812,1329,61.1%,36.12%,1
臺中市,沙鹿區,0204,396,371,767,39,806,1255,64.22%,31.55%,1
臺中市,沙鹿區,0205,493,359,852,59,911,1507,60.45%,32.71%,1
臺中市,沙鹿區,0206,473,338,811,58,869,1463,59.4%,32.33%,1
臺中市,沙鹿區,0207,411,241,652,60,712,1279,55.67%,32.13%,1
臺中市,沙鹿區,0208,308,204,512,38,550,1024,53.71%,30.08%,1
臺中市,沙鹿區,0209,428,270,698,60,758,1388,54.61%,30.84%,1
臺中市,沙鹿區,0210,381,249,630,22,652,1074,60.71%,35.47%,1
臺中市,沙鹿區,0211,381,252,633,31,664,1072,61.94%,35.54%,1
臺中市,沙鹿區,0212,384,253,637,48,685,1107,61.88%,34.69%,1
臺中市,沙鹿區,0213,539,403,942,47,989,1947,50.8%,27.68%,1
臺中市,沙鹿區,0214,512,338,850,51,901,1682,53.57%,30.44%,1
臺中市,沙鹿區,0215,582,327,909,48,957,1633,58.6%,35.64%,1
臺中市,沙鹿區,0216,489,298,787,45,832,1533,54.27%,31.9%,1
臺中市,沙鹿區,0217,479,285,764,32,796,1605,49.6%,29.84%,1
臺中市,沙鹿區,0218,529,348,877,29,906,1694,53.48%,31.23%,1
臺中市,沙鹿區,0219,495,335,830,47,877,1628,53.87%,30.41%,1
臺中市,沙鹿區,0220,560,397,957,24,981,1665,58.92%,33.63%,1
臺中市,沙鹿區,0221,533,335,868,47,915,1651,55.42%,32.28%,1
臺中市,沙鹿區,0222,388,259,647,18,665,1108,60.02%,35.02%,1
臺中市,沙鹿區,0223,428,239,667,38,705,1142,61.73%,37.48%,1
臺中市,沙鹿區,0224,360,210,570,33,603,1039,58.04%,34.65%,1
臺中市,沙鹿區,0225,601,364,965,52,1017,1840,55.27%,32.66%,1
臺中市,沙鹿區,0226,642,359,1001,38,1039,1872,55.5%,34.29%,1
臺中市,沙鹿區,0227,477,302,779,58,837,1558,53.72%,30.62%,1
臺中市,沙鹿區,0228,525,326,851,54,905,1739,52.04%,30.19%,1
臺中市,沙鹿區,0229,496,299,795,45,840,1672,50.24%,29.67%,1
臺中市,沙鹿區,0230,551,331,882,29,911,1634,55.75%,33.72%,1
臺中市,沙鹿區,0231,490,295,785,41,826,1616,51.11%,30.32%,1
臺中市,沙鹿區,0232,517,354,871,38,909,1593,57.06%,32.45%,1
臺中市,沙鹿區,0233,340,178,518,23,541,981,55.15%,34.66%,1
臺中市,沙鹿區,0234,632,353,985,63,1048,1740,60.23%,36.32%,1
臺中市,沙鹿區,0235,452,272,724,45,769,1247,61.67%,36.25%,1
臺中市,沙鹿區,0236,396,214,610,19,629,1047,60.08%,37.82%,1
臺中市,沙鹿區,0237,348,241,589,59,648,1119,57.91%,31.1%,1
臺中市,沙鹿區,0238,319,229,548,21,569,1025,55.51%,31.12%,1
臺中市,梧棲區,0150,473,336,809,63,872,1541,56.59%,30.69%,1
臺中市,梧棲區,0151,515,325,840,45,885,1581,55.98%,32.57%,1
臺中市,梧棲區,0152,350,234,584,56,640,1083,59.1%,32.32%,1
臺中市,梧棲區,0153,303,217,520,10,530,876,60.5%,34.59%,1
臺中市,梧棲區,0154,339,244,583,38,621,1043,59.54%,32.5%,1
臺中市,梧棲區,0155,438,303,741,44,785,1502,52.26%,29.16%,1
臺中市,梧棲區,0156,455,302,757,44,801,1384,57.88%,32.88%,1
臺中市,梧棲區,0157,191,129,320,29,349,517,67.5%,36.94%,1
臺中市,梧棲區,0158,404,278,682,68,750,1169,64.16%,34.56%,1
臺中市,梧棲區,0159,263,218,481,43,524,863,60.72%,30.48%,1
臺中市,梧棲區,0160,364,242,606,38,644,1277,50.43%,28.5%,1
臺中市,梧棲區,0161,515,384,899,51,950,1742,54.54%,29.56%,1
臺中市,梧棲區,0162,377,360,737,55,792,1342,59.02%,28.09%,1
臺中市,梧棲區,0163,528,432,960,65,1025,1767,58.01%,29.88%,1
臺中市,梧棲區,0164,394,326,720,64,784,1542,50.84%,25.55%,1
臺中市,梧棲區,0165,507,357,864,33,897,1636,54.83%,30.99%,1
臺中市,梧棲區,0166,545,364,909,51,960,1796,53.45%,30.35%,1
臺中市,梧棲區,0167,441,316,757,46,803,1450,55.38%,30.41%,1
臺中市,梧棲區,0168,436,333,769,85,854,1548,55.17%,28.17%,1
臺中市,梧棲區,0169,454,311,765,43,808,1366,59.15%,33.24%,1
臺中市,梧棲區,0170,327,269,596,25,621,955,65.03%,34.24%,1
臺中市,梧棲區,0171,423,254,677,41,718,1305,55.02%,32.41%,1
臺中市,梧棲區,0172,411,289,700,34,734,1239,59.24%,33.17%,1
臺中市,梧棲區,0173,359,259,618,51,669,1079,62%,33.27%,1
臺中市,梧棲區,0174,368,289,657,34,691,1220,56.64%,30.16%,1
臺中市,梧棲區,0175,523,350,873,61,934,1544,60.49%,33.87%,1
臺中市,梧棲區,0176,464,382,846,39,885,1460,60.62%,31.78%,1
臺中市,梧棲區,0177,419,325,744,46,790,1292,61.15%,32.43%,1
臺中市,梧棲區,0178,400,290,690,51,741,1300,57%,30.77%,1
臺中市,梧棲區,0179,488,320,808,33,841,1555,54.08%,31.38%,1
臺中市,梧棲區,0180,321,222,543,34,577,1031,55.97%,31.13%,1
臺中市,梧棲區,0181,406,306,712,52,764,1277,59.83%,31.79%,1
臺中市,梧棲區,0182,308,235,543,40,583,1037,56.22%,29.7%,1
臺中市,梧棲區,0183,370,284,654,60,714,1187,60.15%,31.17%,1
臺中市,梧棲區,0184,419,307,726,49,775,1399,55.4%,29.95%,1
臺中市,梧棲區,0185,361,250,611,34,645,1135,56.83%,31.81%,1
臺中市,后里區,0357,313,184,497,50,547,852,64.2%,36.74%,1
臺中市,后里區,0358,357,237,594,56,650,1135,57.27%,31.45%,1
臺中市,后里區,0359,322,205,527,53,580,1079,53.75%,29.84%,1
臺中市,后里區,0360,518,332,850,55,905,1539,58.8%,33.66%,1
臺中市,后里區,0361,512,364,876,53,929,1591,58.39%,32.18%,1
臺中市,后里區,0362,402,276,678,39,717,1376,52.11%,29.22%,1
臺中市,后里區,0363,281,434,715,30,745,1298,57.4%,21.65%,1
臺中市,后里區,0364,452,324,776,78,854,1428,59.8%,31.65%,1
臺中市,后里區,0365,433,302,735,48,783,1178,66.47%,36.76%,1
臺中市,后里區,0366,368,251,619,37,656,1095,59.91%,33.61%,1
臺中市,后里區,0367,318,213,531,20,551,963,57.22%,33.02%,1
臺中市,后里區,0368,388,244,632,43,675,1163,58.04%,33.36%,1
臺中市,后里區,0369,339,246,585,35,620,1018,60.9%,33.3%,1
臺中市,后里區,0370,296,219,515,37,552,854,64.64%,34.66%,1
臺中市,后里區,0371,413,344,757,57,814,1485,54.81%,27.81%,1
臺中市,后里區,0372,489,331,820,43,863,1355,63.69%,36.09%,1
臺中市,后里區,0373,255,173,428,39,467,840,55.6%,30.36%,1
臺中市,后里區,0374,388,259,647,41,688,1146,60.03%,33.86%,1
臺中市,后里區,0375,565,406,971,56,1027,1669,61.53%,33.85%,1
臺中市,后里區,0376,516,450,966,78,1044,1673,62.4%,30.84%,1
臺中市,后里區,0377,494,346,840,35,875,1493,58.61%,33.09%,1
臺中市,后里區,0378,356,252,608,52,660,1052,62.74%,33.84%,1
臺中市,后里區,0379,274,203,477,28,505,909,55.56%,30.14%,1
臺中市,后里區,0380,382,227,609,64,673,1091,61.69%,35.01%,1
臺中市,后里區,0381,471,280,751,80,831,1342,61.92%,35.1%,1
臺中市,后里區,0382,343,251,594,55,649,1138,57.03%,30.14%,1
臺中市,后里區,0383,304,254,558,34,592,977,60.59%,31.12%,1
臺中市,后里區,0384,434,299,733,42,775,1584,48.93%,27.4%,1
臺中市,后里區,0385,293,199,492,39,531,915,58.03%,32.02%,1
臺中市,后里區,0386,367,312,679,64,743,1225,60.65%,29.96%,1
臺中市,后里區,0387,468,372,840,34,874,1552,56.31%,30.15%,1
臺中市,后里區,0388,523,345,868,23,891,1600,55.69%,32.69%,1
臺中市,后里區,0389,299,206,505,31,536,942,56.9%,31.74%,1
臺中市,后里區,0390,297,200,497,30,527,943,55.89%,31.5%,1
臺中市,后里區,0391,318,204,522,40,562,1055,53.27%,30.14%,1
臺中市,后里區,0392,340,244,584,48,632,1067,59.23%,31.87%,1
臺中市,后里區,0393,390,278,668,46,714,1340,53.28%,29.1%,1
臺中市,神岡區,0482,581,384,965,58,1023,1684,60.75%,34.5%,1
臺中市,神岡區,0483,548,343,891,36,927,1559,59.46%,35.15%,1
臺中市,神岡區,0484,360,240,600,44,644,1095,58.81%,32.88%,1
臺中市,神岡區,0485,390,286,676,34,710,1044,68.01%,37.36%,1
臺中市,神岡區,0486,509,308,817,40,857,1310,65.42%,38.85%,1
臺中市,神岡區,0487,477,291,768,55,823,1294,63.6%,36.86%,1
臺中市,神岡區,0488,390,257,647,49,696,1143,60.89%,34.12%,1
臺中市,神岡區,0489,375,216,591,48,639,1022,62.52%,36.69%,1
臺中市,神岡區,0490,428,258,686,41,727,1269,57.29%,33.73%,1
臺中市,神岡區,0491,337,178,515,29,544,1085,50.14%,31.06%,1
臺中市,神岡區,0492,297,272,569,30,599,942,63.59%,31.53%,1
臺中市,神岡區,0493,389,261,650,37,687,1154,59.53%,33.71%,1
臺中市,神岡區,0494,452,286,738,52,790,1390,56.83%,32.52%,1
臺中市,神岡區,0495,492,320,812,56,868,1372,63.27%,35.86%,1
臺中市,神岡區,0496,415,277,692,42,734,1328,55.27%,31.25%,1
臺中市,神岡區,0497,346,233,579,28,607,1038,58.48%,33.33%,1
臺中市,神岡區,0498,443,335,778,43,821,1452,56.54%,30.51%,1
臺中市,神岡區,0499,544,367,911,48,959,1551,61.83%,35.07%,1
臺中市,神岡區,0500,485,333,818,50,868,1567,55.39%,30.95%,1
臺中市,神岡區,0501,474,338,812,31,843,1449,58.18%,32.71%,1
臺中市,神岡區,0502,379,254,633,31,664,1246,53.29%,30.42%,1
臺中市,神岡區,0503,508,313,821,41,862,1431,60.24%,35.5%,1
臺中市,神岡區,0504,395,279,674,61,735,1163,63.2%,33.96%,1
臺中市,神岡區,0505,546,310,856,47,903,1402,64.41%,38.94%,1
臺中市,神岡區,0506,436,283,719,48,767,1271,60.35%,34.3%,1
臺中市,神岡區,0507,266,420,686,55,741,1198,61.85%,22.2%,1
臺中市,神岡區,0508,485,288,773,39,812,1312,61.89%,36.97%,1
臺中市,神岡區,0509,551,324,875,35,910,1590,57.23%,34.65%,1
臺中市,神岡區,0510,431,270,701,39,740,1324,55.89%,32.55%,1
臺中市,神岡區,0511,448,310,758,36,794,1415,56.11%,31.66%,1
臺中市,神岡區,0512,563,348,911,51,962,1483,64.87%,37.96%,1
臺中市,神岡區,0513,477,263,740,33,773,1402,55.14%,34.02%,1
臺中市,神岡區,0514,397,278,675,41,716,1275,56.16%,31.14%,1
臺中市,神岡區,0515,402,265,667,40,707,1288,54.89%,31.21%,1
臺中市,神岡區,0516,347,222,569,49,618,1080,57.22%,32.13%,1
臺中市,神岡區,0517,434,300,734,30,764,1344,56.85%,32.29%,1
臺中市,神岡區,0518,378,254,632,38,670,1061,63.15%,35.63%,1
臺中市,神岡區,0519,413,292,705,44,749,1176,63.69%,35.12%,1
臺中市,神岡區,0520,455,272,727,56,783,1244,62.94%,36.58%,1
臺中市,神岡區,0521,476,322,798,58,856,1318,64.95%,36.12%,1
臺中市,神岡區,0522,491,306,797,51,848,1471,57.65%,33.38%,1
臺中市,神岡區,0523,484,329,813,65,878,1323,66.36%,36.58%,1
臺中市,潭子區,0570,464,292,756,48,804,1306,61.56%,35.53%,1
臺中市,潭子區,0571,406,252,658,46,704,1128,62.41%,35.99%,1
臺中市,潭子區,0572,404,295,699,49,748,1159,64.54%,34.86%,1
臺中市,潭子區,0573,575,366,941,64,1005,1630,61.66%,35.28%,1
臺中市,潭子區,0574,543,309,852,32,884,1532,57.7%,35.44%,1
臺中市,潭子區,0575,524,333,857,40,897,1677,53.49%,31.25%,1
臺中市,潭子區,0576,559,339,898,37,935,1744,53.61%,32.05%,1
臺中市,潭子區,0577,574,412,986,52,1038,1795,57.83%,31.98%,1
臺中市,潭子區,0578,395,251,646,38,684,1171,58.41%,33.73%,1
臺中市,潭子區,0579,480,317,797,22,819,1427,57.39%,33.64%,1
臺中市,潭子區,0580,572,380,952,43,995,1709,58.22%,33.47%,1
臺中市,潭子區,0581,578,364,942,46,988,1723,57.34%,33.55%,1
臺中市,潭子區,0582,561,368,929,58,987,1782,55.39%,31.48%,1
臺中市,潭子區,0583,433,300,733,37,770,1407,54.73%,30.77%,1
臺中市,潭子區,0584,602,425,1027,36,1063,1771,60.02%,33.99%,1
臺中市,潭子區,0585,668,346,1014,70,1084,1795,60.39%,37.21%,1
臺中市,潭子區,0586,616,339,955,52,1007,1612,62.47%,38.21%,1
臺中市,潭子區,0587,623,408,1031,42,1073,1894,56.65%,32.89%,1
臺中市,潭子區,0588,555,373,928,43,971,1689,57.49%,32.86%,1
臺中市,潭子區,0589,499,306,805,46,851,1525,55.8%,32.72%,1
臺中市,潭子區,0590,557,331,888,37,925,1622,57.03%,34.34%,1
臺中市,潭子區,0591,392,271,663,59,722,1200,60.17%,32.67%,1
臺中市,潭子區,0592,457,267,724,22,746,1355,55.06%,33.73%,1
臺中市,潭子區,0593,611,347,958,26,984,1777,55.37%,34.38%,1
臺中市,潭子區,0594,698,366,1064,32,1096,1923,56.99%,36.3%,1
臺中市,潭子區,0595,619,260,879,47,926,1674,55.32%,36.98%,1
臺中市,潭子區,0596,534,341,875,39,914,1451,62.99%,36.8%,1
臺中市,潭子區,0597,522,312,834,51,885,1486,59.56%,35.13%,1
臺中市,潭子區,0598,519,356,875,39,914,1511,60.49%,34.35%,1
臺中市,潭子區,0599,587,371,958,45,1003,1666,60.2%,35.23%,1
臺中市,潭子區,0600,688,255,943,49,992,1750,56.69%,39.31%,1
臺中市,潭子區,0601,490,292,782,36,818,1437,56.92%,34.1%,1
臺中市,潭子區,0602,620,329,949,37,986,1735,56.83%,35.73%,1
臺中市,潭子區,0603,546,345,891,30,921,1612,57.13%,33.87%,1
臺中市,潭子區,0604,418,260,678,26,704,1143,61.59%,36.57%,1
臺中市,潭子區,0605,713,409,1122,46,1168,2096,55.73%,34.02%,1
臺中市,潭子區,0606,598,310,908,36,944,1549,60.94%,38.61%,1
臺中市,潭子區,0607,546,365,911,42,953,1573,60.58%,34.71%,1
臺中市,潭子區,0608,550,287,837,42,879,1585,55.46%,34.7%,1
臺中市,潭子區,0609,532,324,856,33,889,1572,56.55%,33.84%,1
臺中市,潭子區,0610,618,385,1003,54,1057,1738,60.82%,35.56%,1
臺中市,潭子區,0611,620,372,992,63,1055,1883,56.03%,32.93%,1
臺中市,潭子區,0612,514,341,855,30,885,1401,63.17%,36.69%,1
臺中市,潭子區,0613,472,326,798,34,832,1352,61.54%,34.91%,1
臺中市,潭子區,0614,712,440,1152,78,1230,2085,58.99%,34.15%,1
臺中市,潭子區,0615,725,441,1166,76,1242,2047,60.67%,35.42%,1
臺中市,潭子區,0616,553,328,881,30,911,1673,54.45%,33.05%,1
臺中市,潭子區,0617,608,434,1042,74,1116,1874,59.55%,32.44%,1
臺中市,潭子區,0618,349,251,600,38,638,1051,60.7%,33.21%,1
臺中市,潭子區,0619,519,351,870,28,898,1674,53.64%,31%,1
臺中市,潭子區,0620,573,434,1007,70,1077,1831,58.82%,31.29%,1
臺中市,潭子區,0621,640,416,1056,61,1117,2003,55.77%,31.95%,1
臺中市,潭子區,0622,559,311,870,40,910,1535,59.28%,36.42%,1
臺中市,潭子區,0623,702,393,1095,77,1172,2286,51.27%,30.71%,1
臺中市,潭子區,0624,593,357,950,56,1006,1861,54.06%,31.86%,1
臺中市,大雅區,0524,640,473,1113,49,1162,2027,57.33%,31.57%,1
臺中市,大雅區,0525,636,363,999,38,1037,1967,52.72%,32.33%,1
臺中市,大雅區,0526,603,404,1007,42,1049,1912,54.86%,31.54%,1
臺中市,大雅區,0527,525,377,902,42,944,1537,61.42%,34.16%,1
臺中市,大雅區,0528,553,321,874,37,911,1439,63.31%,38.43%,1
臺中市,大雅區,0529,474,315,789,48,837,1402,59.7%,33.81%,1
臺中市,大雅區,0530,619,441,1060,43,1103,2013,54.79%,30.75%,1
臺中市,大雅區,0531,623,438,1061,63,1124,1917,58.63%,32.5%,1
臺中市,大雅區,0532,625,451,1076,42,1118,2011,55.59%,31.08%,1
臺中市,大雅區,0533,730,336,1066,50,1116,1887,59.14%,38.69%,1
臺中市,大雅區,0534,517,361,878,34,912,1480,61.62%,34.93%,1
臺中市,大雅區,0535,605,397,1002,46,1048,1816,57.71%,33.31%,1
臺中市,大雅區,0536,558,369,927,60,987,1898,52%,29.4%,1
臺中市,大雅區,0537,661,425,1086,65,1151,2008,57.32%,32.92%,1
臺中市,大雅區,0538,702,407,1109,44,1153,1976,58.35%,35.53%,1
臺中市,大雅區,0539,564,394,958,25,983,1673,58.76%,33.71%,1
臺中市,大雅區,0540,522,330,852,35,887,1409,62.95%,37.05%,1
臺中市,大雅區,0541,491,325,816,16,832,1382,60.2%,35.53%,1
臺中市,大雅區,0542,524,344,868,64,932,1635,57%,32.05%,1
臺中市,大雅區,0543,557,334,891,43,934,1565,59.68%,35.59%,1
臺中市,大雅區,0544,494,321,815,39,854,1528,55.89%,32.33%,1
臺中市,大雅區,0545,639,405,1044,32,1076,1963,54.81%,32.55%,1
臺中市,大雅區,0546,685,381,1066,43,1109,2073,53.5%,33.04%,1
臺中市,大雅區,0547,665,374,1039,65,1104,1984,55.65%,33.52%,1
臺中市,大雅區,0548,532,378,910,38,948,1688,56.16%,31.52%,1
臺中市,大雅區,0549,484,298,782,29,811,1387,58.47%,34.9%,1
臺中市,大雅區,0550,595,367,962,76,1038,1701,61.02%,34.98%,1
臺中市,大雅區,0551,547,384,931,46,977,1721,56.77%,31.78%,1
臺中市,大雅區,0552,578,301,879,50,929,1879,49.44%,30.76%,1
臺中市,大雅區,0553,524,382,906,49,955,1568,60.91%,33.42%,1
臺中市,大雅區,0554,562,409,971,70,1041,1761,59.11%,31.91%,1
臺中市,大雅區,0555,601,380,981,93,1074,1752,61.3%,34.3%,1
臺中市,大雅區,0556,435,283,718,42,760,1264,60.13%,34.41%,1
臺中市,大雅區,0557,497,287,784,34,818,1302,62.83%,38.17%,1
臺中市,大雅區,0558,446,334,780,54,834,1449,57.56%,30.78%,1
臺中市,大雅區,0559,564,359,923,64,987,1621,60.89%,34.79%,1
臺中市,大雅區,0560,525,338,863,64,927,1647,56.28%,31.88%,1
臺中市,大雅區,0561,486,299,785,36,821,1441,56.97%,33.73%,1
臺中市,大雅區,0562,477,314,791,28,819,1460,56.1%,32.67%,1
臺中市,大雅區,0563,648,431,1079,48,1127,1832,61.52%,35.37%,1
臺中市,大雅區,0564,484,343,827,45,872,1371,63.6%,35.3%,1
臺中市,大雅區,0565,446,302,748,16,764,1418,53.88%,31.45%,1
臺中市,大雅區,0566,512,354,866,35,901,1473,61.17%,34.76%,1
臺中市,大雅區,0567,441,311,752,43,795,1335,59.55%,33.03%,1
臺中市,大雅區,0568,663,285,948,48,996,1733,57.47%,38.26%,1
臺中市,大雅區,0569,596,307,903,60,963,1884,51.11%,31.63%,1
臺中市,新社區,1562,366,190,556,28,584,1011,57.76%,36.2%,1
臺中市,新社區,1563,467,226,693,29,722,1195,60.42%,39.08%,1
臺中市,新社區,1564,429,222,651,20,671,1053,63.72%,40.74%,1
臺中市,新社區,1565,256,168,424,24,448,961,46.62%,26.64%,1
臺中市,新社區,1566,312,167,479,14,493,919,53.65%,33.95%,1
臺中市,新社區,1567,536,255,791,56,847,1367,61.96%,39.21%,1
臺中市,新社區,1568,327,214,541,25,566,1010,56.04%,32.38%,1
臺中市,新社區,1569,297,223,520,64,584,1169,49.96%,25.41%,1
臺中市,新社區,1570,319,210,529,39,568,989,57.43%,32.25%,1
臺中市,新社區,1571,310,177,487,26,513,894,57.38%,34.68%,1
臺中市,新社區,1572,350,196,546,22,568,1033,54.99%,33.88%,1
臺中市,新社區,1573,297,165,462,27,489,1058,46.22%,28.07%,1
臺中市,新社區,1574,259,157,416,17,433,845,51.24%,30.65%,1
臺中市,新社區,1575,254,115,369,21,390,576,67.71%,44.1%,1
臺中市,新社區,1576,353,238,591,41,632,1229,51.42%,28.72%,1
臺中市,新社區,1577,233,180,413,27,440,890,49.44%,26.18%,1
臺中市,新社區,1578,229,165,394,33,427,781,54.67%,29.32%,1
臺中市,新社區,1579,380,256,636,47,683,1244,54.9%,30.55%,1
臺中市,新社區,1580,46,27,73,9,82,213,38.5%,21.6%,1
臺中市,新社區,1581,172,128,300,26,326,676,48.22%,25.44%,1
臺中市,新社區,1582,165,100,265,16,281,585,48.03%,28.21%,1
臺中市,新社區,1583,347,145,492,50,542,938,57.78%,36.99%,1
臺中市,新社區,1584,59,45,104,7,111,224,49.55%,26.34%,1
臺中市,石岡區,1552,443,254,697,44,741,1244,59.57%,35.61%,1
臺中市,石岡區,1553,479,322,801,62,863,1539,56.08%,31.12%,1
臺中市,石岡區,1554,406,259,665,51,716,1202,59.57%,33.78%,1
臺中市,石岡區,1555,379,243,622,75,697,1272,54.8%,29.8%,1
臺中市,石岡區,1556,215,142,357,33,390,652,59.82%,32.98%,1
臺中市,石岡區,1557,533,368,901,61,962,1457,66.03%,36.58%,1
臺中市,石岡區,1558,568,408,976,72,1048,1836,57.08%,30.94%,1
臺中市,石岡區,1559,330,205,535,42,577,1001,57.64%,32.97%,1
臺中市,石岡區,1560,512,339,851,49,900,1448,62.15%,35.36%,1
臺中市,石岡區,1561,438,280,718,46,764,1229,62.16%,35.64%,1
臺中市,外埔區,0071,319,234,553,49,602,1059,56.85%,30.12%,1
臺中市,外埔區,0072,348,235,583,25,608,1013,60.02%,34.35%,1
臺中市,外埔區,0073,410,273,683,37,720,1150,62.61%,35.65%,1
臺中市,外埔區,0074,713,399,1112,64,1176,1855,63.4%,38.44%,1
臺中市,外埔區,0075,448,315,763,37,800,1327,60.29%,33.76%,1
臺中市,外埔區,0076,549,297,846,43,889,1453,61.18%,37.78%,1
臺中市,外埔區,0077,542,323,865,61,926,1653,56.02%,32.79%,1
臺中市,外埔區,0078,421,420,841,35,876,1615,54.24%,26.07%,1
臺中市,外埔區,0079,513,275,788,31,819,1470,55.71%,34.9%,1
臺中市,外埔區,0080,551,338,889,57,946,1559,60.68%,35.34%,1
臺中市,外埔區,0081,597,395,992,77,1069,1902,56.2%,31.39%,1
臺中市,外埔區,0082,458,229,687,48,735,1138,64.59%,40.25%,1
臺中市,外埔區,0083,390,241,631,52,683,1065,64.13%,36.62%,1
臺中市,外埔區,0084,467,273,740,42,782,1243,62.91%,37.57%,1
臺中市,外埔區,0085,280,207,487,43,530,962,55.09%,29.11%,1
臺中市,外埔區,0086,348,267,615,46,661,1169,56.54%,29.77%,1
臺中市,外埔區,0087,495,272,767,34,801,1216,65.87%,40.71%,1
臺中市,外埔區,0088,474,267,741,50,791,1391,56.87%,34.08%,1
臺中市,外埔區,0089,520,326,846,68,914,1616,56.56%,32.18%,1
臺中市,外埔區,0090,319,238,557,40,597,1203,49.63%,26.52%,1
臺中市,大安區,0055,322,186,508,62,570,1068,53.37%,30.15%,1
臺中市,大安區,0056,289,281,570,47,617,1050,58.76%,27.52%,1
臺中市,大安區,0057,399,305,704,57,761,1246,61.08%,32.02%,1
臺中市,大安區,0058,449,289,738,48,786,1397,56.26%,32.14%,1
臺中市,大安區,0059,402,302,704,64,768,1227,62.59%,32.76%,1
臺中市,大安區,0060,385,252,637,56,693,1170,59.23%,32.91%,1
臺中市,大安區,0061,334,203,537,58,595,914,65.1%,36.54%,1
臺中市,大安區,0062,169,148,317,30,347,667,52.02%,25.34%,1
臺中市,大安區,0063,271,166,437,49,486,890,54.61%,30.45%,1
臺中市,大安區,0064,396,278,674,62,736,1289,57.1%,30.72%,1
臺中市,大安區,0065,130,92,222,21,243,455,53.41%,28.57%,1
臺中市,大安區,0066,344,217,561,38,599,1028,58.27%,33.46%,1
臺中市,大安區,0067,501,296,797,74,871,1446,60.24%,34.65%,1
臺中市,大安區,0068,259,160,419,26,445,688,64.68%,37.65%,1
臺中市,大安區,0069,375,227,602,47,649,1062,61.11%,35.31%,1
臺中市,大安區,0070,348,224,572,31,603,923,65.33%,37.7%,1
臺中市,烏日區,0317,560,331,891,39,930,1480,62.84%,37.84%,1
臺中市,烏日區,0318,625,450,1075,72,1147,1841,62.3%,33.95%,1
臺中市,烏日區,0319,584,363,947,51,998,1751,57%,33.35%,1
臺中市,烏日區,0320,550,350,900,56,956,1547,61.8%,35.55%,1
臺中市,烏日區,0321,637,394,1031,36,1067,1836,58.12%,34.69%,1
臺中市,烏日區,0322,482,295,777,59,836,1239,67.47%,38.9%,1
臺中市,烏日區,0323,400,292,692,57,749,1295,57.84%,30.89%,1
臺中市,烏日區,0324,395,272,667,53,720,1263,57.01%,31.27%,1
臺中市,烏日區,0325,512,367,879,37,916,1622,56.47%,31.57%,1
臺中市,烏日區,0326,604,355,959,81,1040,1822,57.08%,33.15%,1
臺中市,烏日區,0327,577,460,1037,66,1103,1966,56.1%,29.35%,1
臺中市,烏日區,0328,563,350,913,39,952,1615,58.95%,34.86%,1
臺中市,烏日區,0329,448,273,721,31,752,1232,61.04%,36.36%,1
臺中市,烏日區,0330,461,254,715,31,746,1347,55.38%,34.22%,1
臺中市,烏日區,0331,347,247,594,32,626,1165,53.73%,29.79%,1
臺中市,烏日區,0332,607,351,958,48,1006,1664,60.46%,36.48%,1
臺中市,烏日區,0333,454,274,728,48,776,1230,63.09%,36.91%,1
臺中市,烏日區,0334,584,346,930,68,998,1574,63.41%,37.1%,1
臺中市,烏日區,0335,531,361,892,38,930,1452,64.05%,36.57%,1
臺中市,烏日區,0336,632,339,971,59,1030,1879,54.82%,33.63%,1
臺中市,烏日區,0337,510,367,877,51,928,1601,57.96%,31.86%,1
臺中市,烏日區,0338,586,351,937,37,974,1546,63%,37.9%,1
臺中市,烏日區,0339,462,454,916,40,956,1866,51.23%,24.76%,1
臺中市,烏日區,0340,665,418,1083,67,1150,1938,59.34%,34.31%,1
臺中市,烏日區,0341,621,357,978,43,1021,1759,58.04%,35.3%,1
臺中市,烏日區,0342,778,313,1091,62,1153,2061,55.94%,37.75%,1
臺中市,烏日區,0343,626,325,951,50,1001,1691,59.2%,37.02%,1
臺中市,烏日區,0344,387,250,637,44,681,1039,65.54%,37.25%,1
臺中市,烏日區,0345,440,272,712,47,759,1221,62.16%,36.04%,1
臺中市,烏日區,0346,542,396,938,74,1012,1650,61.33%,32.85%,1
臺中市,烏日區,0347,311,234,545,40,585,937,62.43%,33.19%,1
臺中市,烏日區,0348,388,312,700,28,728,1220,59.67%,31.8%,1
臺中市,烏日區,0349,547,485,1032,76,1108,2139,51.8%,25.57%,1
臺中市,烏日區,0350,544,304,848,48,896,1371,65.35%,39.68%,1
臺中市,烏日區,0351,415,275,690,59,749,1277,58.65%,32.5%,1
臺中市,烏日區,0352,523,373,896,63,959,1708,56.15%,30.62%,1
臺中市,烏日區,0353,666,405,1071,78,1149,2048,56.1%,32.52%,1
臺中市,烏日區,0354,501,354,855,53,908,1632,55.64%,30.7%,1
臺中市,烏日區,0355,455,296,751,59,810,1327,61.04%,34.29%,1
臺中市,烏日區,0356,266,171,437,59,496,854,58.08%,31.15%,1
臺中市,大肚區,0284,437,344,781,28,809,1415,57.17%,30.88%,1
臺中市,大肚區,0285,383,322,705,43,748,1392,53.74%,27.51%,1
臺中市,大肚區,0286,544,323,867,55,922,1520,60.66%,35.79%,1
臺中市,大肚區,0287,294,226,520,64,584,862,67.75%,34.11%,1
臺中市,大肚區,0288,469,266,735,46,781,1256,62.18%,37.34%,1
臺中市,大肚區,0289,446,260,706,42,748,1292,57.89%,34.52%,1
臺中市,大肚區,0290,346,240,586,31,617,1010,61.09%,34.26%,1
臺中市,大肚區,0291,471,379,850,68,918,1485,61.82%,31.72%,1
臺中市,大肚區,0292,437,264,701,65,766,1190,64.37%,36.72%,1
臺中市,大肚區,0293,406,272,678,66,744,1250,59.52%,32.48%,1
臺中市,大肚區,0294,426,318,744,38,782,1310,59.69%,32.52%,1
臺中市,大肚區,0295,400,295,695,40,735,1294,56.8%,30.91%,1
臺中市,大肚區,0296,619,432,1051,45,1096,1734,63.21%,35.7%,1
臺中市,大肚區,0297,416,282,698,56,754,1316,57.29%,31.61%,1
臺中市,大肚區,0298,274,195,469,41,510,854,59.72%,32.08%,1
臺中市,大肚區,0299,443,326,769,53,822,1273,64.57%,34.8%,1
臺中市,大肚區,0300,337,167,504,32,536,851,62.98%,39.6%,1
臺中市,大肚區,0301,534,351,885,32,917,1629,56.29%,32.78%,1
臺中市,大肚區,0302,498,380,878,87,965,1709,56.47%,29.14%,1
臺中市,大肚區,0303,302,188,490,32,522,953,54.77%,31.69%,1
臺中市,大肚區,0304,445,320,765,47,812,1336,60.78%,33.31%,1
臺中市,大肚區,0305,599,475,1074,71,1145,2113,54.19%,28.35%,1
臺中市,大肚區,0306,575,371,946,77,1023,1730,59.13%,33.24%,1
臺中市,大肚區,0307,547,381,928,29,957,1692,56.56%,32.33%,1
臺中市,大肚區,0308,602,362,964,51,1015,1747,58.1%,34.46%,1
臺中市,大肚區,0309,585,321,906,54,960,1672,57.42%,34.99%,1
臺中市,大肚區,0310,514,341,855,51,906,1675,54.09%,30.69%,1
臺中市,大肚區,0311,566,351,917,44,961,1673,57.44%,33.83%,1
臺中市,大肚區,0312,605,332,937,43,980,1636,59.9%,36.98%,1
臺中市,大肚區,0313,571,355,926,29,955,1753,54.48%,32.57%,1
臺中市,大肚區,0314,424,265,689,30,719,1343,53.54%,31.57%,1
臺中市,大肚區,0315,619,348,967,57,1024,1822,56.2%,33.97%,1
臺中市,大肚區,0316,622,316,938,95,1033,1670,61.86%,37.25%,1
臺中市,龍井區,0239,580,407,987,72,1059,1758,60.24%,32.99%,1
臺中市,龍井區,0240,414,278,692,46,738,1275,57.88%,32.47%,1
臺中市,龍井區,0241,396,273,669,30,699,1379,50.69%,28.72%,1
臺中市,龍井區,0242,434,272,706,43,749,1403,53.39%,30.93%,1
臺中市,龍井區,0243,324,206,530,39,569,974,58.42%,33.26%,1
臺中市,龍井區,0244,310,193,503,42,545,901,60.49%,34.41%,1
臺中市,龍井區,0245,509,429,938,60,998,1779,56.1%,28.61%,1
臺中市,龍井區,0246,516,379,895,63,958,1609,59.54%,32.07%,1
臺中市,龍井區,0247,332,198,530,23,553,1038,53.28%,31.98%,1
臺中市,龍井區,0248,444,303,747,64,811,1328,61.07%,33.43%,1
臺中市,龍井區,0249,288,238,526,47,573,921,62.21%,31.27%,1
臺中市,龍井區,0250,454,331,785,56,841,1609,52.27%,28.22%,1
臺中市,龍井區,0251,328,254,582,28,610,1227,49.71%,26.73%,1
臺中市,龍井區,0252,407,275,682,47,729,1278,57.04%,31.85%,1
臺中市,龍井區,0253,211,189,400,26,426,914,46.61%,23.09%,1
臺中市,龍井區,0254,452,336,788,38,826,1678,49.23%,26.94%,1
臺中市,龍井區,0255,383,216,599,39,638,1233,51.74%,31.06%,1
臺中市,龍井區,0256,483,312,795,69,864,1520,56.84%,31.78%,1
臺中市,龍井區,0257,596,359,955,41,996,1905,52.28%,31.29%,1
臺中市,龍井區,0258,797,71,868,45,913,1520,60.07%,52.43%,1
臺中市,龍井區,0259,265,393,658,92,750,1385,54.15%,19.13%,1
臺中市,龍井區,0260,366,270,636,43,679,1212,56.02%,30.2%,1
臺中市,龍井區,0261,507,288,795,30,825,1432,57.61%,35.41%,1
臺中市,龍井區,0262,535,330,865,43,908,1663,54.6%,32.17%,1
臺中市,龍井區,0263,429,295,724,39,763,1422,53.66%,30.17%,1
臺中市,龍井區,0264,450,306,756,62,818,1616,50.62%,27.85%,1
臺中市,龍井區,0265,485,300,785,58,843,1422,59.28%,34.11%,1
臺中市,龍井區,0266,439,229,668,28,696,1165,59.74%,37.68%,1
臺中市,龍井區,0267,530,344,874,26,900,1624,55.42%,32.64%,1
臺中市,龍井區,0268,504,348,852,55,907,1613,56.23%,31.25%,1
臺中市,龍井區,0269,365,190,555,34,589,943,62.46%,38.71%,1
臺中市,龍井區,0270,511,294,805,63,868,1595,54.42%,32.04%,1
臺中市,龍井區,0271,526,317,843,46,889,1508,58.95%,34.88%,1
臺中市,龍井區,0272,472,287,759,32,791,1479,53.48%,31.91%,1
臺中市,龍井區,0273,524,318,842,36,878,1509,58.18%,34.72%,1
臺中市,龍井區,0274,595,333,928,50,978,1582,61.82%,37.61%,1
臺中市,龍井區,0275,584,352,936,53,989,1725,57.33%,33.86%,1
臺中市,龍井區,0276,699,203,902,35,937,1616,57.98%,43.25%,1
臺中市,龍井區,0277,614,341,955,39,994,1657,59.99%,37.05%,1
臺中市,龍井區,0278,583,430,1013,43,1056,1774,59.53%,32.86%,1
臺中市,龍井區,0279,608,392,1000,37,1037,1701,60.96%,35.74%,1
臺中市,龍井區,0280,375,260,635,33,668,1121,59.59%,33.45%,1
臺中市,龍井區,0281,255,332,587,36,623,987,63.12%,25.84%,1
臺中市,龍井區,0282,410,251,661,50,711,1206,58.96%,34%,1
臺中市,龍井區,0283,514,297,811,36,847,1378,61.47%,37.3%,1
臺中市,霧峰區,1470,434,280,714,36,750,1205,62.24%,36.02%,1
臺中市,霧峰區,1471,552,327,879,44,923,1620,56.98%,34.07%,1
臺中市,霧峰區,1472,558,353,911,57,968,1559,62.09%,35.79%,1
臺中市,霧峰區,1473,554,334,888,65,953,1660,57.41%,33.37%,1
臺中市,霧峰區,1474,570,367,937,50,987,1602,61.61%,35.58%,1
臺中市,霧峰區,1475,422,275,697,39,736,1325,55.55%,31.85%,1
臺中市,霧峰區,1476,515,339,854,42,896,1515,59.14%,33.99%,1
臺中市,霧峰區,1477,486,339,825,57,882,1561,56.5%,31.13%,1
臺中市,霧峰區,1478,579,283,862,56,918,1691,54.29%,34.24%,1
臺中市,霧峰區,1479,493,311,804,82,886,1486,59.62%,33.18%,1
臺中市,霧峰區,1480,358,211,569,46,615,975,63.08%,36.72%,1
臺中市,霧峰區,1481,536,270,806,48,854,1358,62.89%,39.47%,1
臺中市,霧峰區,1482,466,288,754,24,778,1141,68.19%,40.84%,1
臺中市,霧峰區,1483,348,188,536,32,568,855,66.43%,40.7%,1
臺中市,霧峰區,1484,408,258,666,59,725,1202,60.32%,33.94%,1
臺中市,霧峰區,1485,350,217,567,40,607,1078,56.31%,32.47%,1
臺中市,霧峰區,1486,528,320,848,53,901,1456,61.88%,36.26%,1
臺中市,霧峰區,1487,556,361,917,35,952,1573,60.52%,35.35%,1
臺中市,霧峰區,1488,565,326,891,49,940,1591,59.08%,35.51%,1
臺中市,霧峰區,1489,456,275,731,53,784,1214,64.58%,37.56%,1
臺中市,霧峰區,1490,408,265,673,58,731,1267,57.7%,32.2%,1
臺中市,霧峰區,1491,433,276,709,51,760,1277,59.51%,33.91%,1
臺中市,霧峰區,1492,424,325,749,41,790,1366,57.83%,31.04%,1
臺中市,霧峰區,1493,382,259,641,48,689,994,69.32%,38.43%,1
臺中市,霧峰區,1494,312,198,510,37,547,863,63.38%,36.15%,1
臺中市,霧峰區,1495,404,285,689,47,736,1274,57.77%,31.71%,1
臺中市,霧峰區,1496,349,265,614,66,680,1162,58.52%,30.03%,1
臺中市,霧峰區,1497,451,267,718,64,782,1252,62.46%,36.02%,1
臺中市,霧峰區,1498,449,290,739,50,789,1322,59.68%,33.96%,1
臺中市,霧峰區,1499,401,257,658,54,712,1116,63.8%,35.93%,1
臺中市,霧峰區,1500,394,288,682,59,741,1156,64.1%,34.08%,1
臺中市,霧峰區,1501,449,241,690,42,732,1147,63.82%,39.15%,1
臺中市,霧峰區,1502,365,222,587,43,630,928,67.89%,39.33%,1
臺中市,霧峰區,1503,405,272,677,55,732,1296,56.48%,31.25%,1
臺中市,霧峰區,1504,373,273,646,74,720,1314,54.79%,28.39%,1
臺中市,霧峰區,1505,460,302,762,57,819,1328,61.67%,34.64%,1
臺中市,霧峰區,1506,296,241,537,52,589,989,59.56%,29.93%,1
臺中市,霧峰區,1507,379,261,640,47,687,1088,63.14%,34.83%,1
臺中市,霧峰區,1508,513,286,799,61,860,1363,63.1%,37.64%,1
臺中市,霧峰區,1509,521,376,897,67,964,1573,61.28%,33.12%,1
臺中市,霧峰區,1510,370,241,611,49,660,1117,59.09%,33.12%,1
臺中市,霧峰區,1511,506,297,803,68,871,1342,64.9%,37.7%,1
臺中市,霧峰區,1512,372,266,638,46,684,1024,66.8%,36.33%,1
臺中市,太平區,1271,553,371,924,68,992,1821,54.48%,30.37%,1
臺中市,太平區,1272,509,337,846,35,881,1680,52.44%,30.3%,1
臺中市,太平區,1273,645,420,1065,66,1131,1947,58.09%,33.13%,1
臺中市,太平區,1274,701,388,1089,65,1154,1910,60.42%,36.7%,1
臺中市,太平區,1275,615,368,983,41,1024,1894,54.07%,32.47%,1
臺中市,太平區,1276,615,400,1015,49,1064,1953,54.48%,31.49%,1
臺中市,太平區,1277,618,380,998,66,1064,1846,57.64%,33.48%,1
臺中市,太平區,1278,623,227,850,37,887,1493,59.41%,41.73%,1
臺中市,太平區,1279,535,318,853,49,902,1605,56.2%,33.33%,1
臺中市,太平區,1280,587,349,936,40,976,1619,60.28%,36.26%,1
臺中市,太平區,1281,642,404,1046,60,1106,2011,55%,31.92%,1
臺中市,太平區,1282,680,414,1094,28,1122,2056,54.57%,33.07%,1
臺中市,太平區,1283,621,369,990,42,1032,1876,55.01%,33.1%,1
臺中市,太平區,1284,593,351,944,46,990,1815,54.55%,32.67%,1
臺中市,太平區,1285,410,281,691,40,731,1281,57.06%,32.01%,1
臺中市,太平區,1286,347,256,603,49,652,1004,64.94%,34.56%,1
臺中市,太平區,1287,654,399,1053,76,1129,1886,59.86%,34.68%,1
臺中市,太平區,1288,501,308,809,50,859,1431,60.03%,35.01%,1
臺中市,太平區,1289,598,394,992,65,1057,1930,54.77%,30.98%,1
臺中市,太平區,1290,631,443,1074,50,1124,2164,51.94%,29.16%,1
臺中市,太平區,1291,671,387,1058,53,1111,2048,54.25%,32.76%,1
臺中市,太平區,1292,689,368,1057,39,1096,2035,53.86%,33.86%,1
臺中市,太平區,1293,510,347,857,65,922,1685,54.72%,30.27%,1
臺中市,太平區,1294,600,397,997,84,1081,2185,49.47%,27.46%,1
臺中市,太平區,1295,393,227,620,17,637,1176,54.17%,33.42%,1
臺中市,太平區,1296,494,339,833,33,866,1597,54.23%,30.93%,1
臺中市,太平區,1297,524,185,709,52,761,1378,55.22%,38.03%,1
臺中市,太平區,1298,510,335,845,33,878,1546,56.79%,32.99%,1
臺中市,太平區,1299,536,362,898,61,959,1890,50.74%,28.36%,1
臺中市,太平區,1300,345,221,566,31,597,1053,56.7%,32.76%,1
臺中市,太平區,1301,537,348,885,76,961,1582,60.75%,33.94%,1
臺中市,太平區,1302,610,351,961,40,1001,1699,58.92%,35.9%,1
臺中市,太平區,1303,444,315,759,57,816,1493,54.66%,29.74%,1
臺中市,太平區,1304,302,243,545,41,586,1063,55.13%,28.41%,1
臺中市,太平區,1305,408,235,643,36,679,1117,60.79%,36.53%,1
臺中市,太平區,1306,382,229,611,50,661,1084,60.98%,35.24%,1
臺中市,太平區,1307,521,379,900,42,942,1776,53.04%,29.34%,1
臺中市,太平區,1308,559,340,899,41,940,1729,54.37%,32.33%,1
臺中市,太平區,1309,483,285,768,71,839,1658,50.6%,29.13%,1
臺中市,太平區,1310,634,400,1034,45,1079,2010,53.68%,31.54%,1
臺中市,太平區,1311,550,341,891,43,934,1752,53.31%,31.39%,1
臺中市,太平區,1312,624,317,941,59,1000,1654,60.46%,37.73%,1
臺中市,太平區,1313,450,303,753,32,785,1951,40.24%,23.07%,1
臺中市,太平區,1314,703,604,1307,77,1384,2170,63.78%,32.4%,1
臺中市,太平區,1315,796,504,1300,51,1351,2231,60.56%,35.68%,1
臺中市,太平區,1316,566,351,917,37,954,1623,58.78%,34.87%,1
臺中市,太平區,1317,448,296,744,39,783,1548,50.58%,28.94%,1
臺中市,太平區,1318,464,276,740,56,796,1442,55.2%,32.18%,1
臺中市,太平區,1319,436,270,706,45,751,1501,50.03%,29.05%,1
臺中市,太平區,1320,573,392,965,43,1008,2025,49.78%,28.3%,1
臺中市,太平區,1321,582,382,964,39,1003,1885,53.21%,30.88%,1
臺中市,太平區,1322,610,380,990,52,1042,2155,48.35%,28.31%,1
臺中市,太平區,1323,512,377,889,62,951,1775,53.58%,28.85%,1
臺中市,太平區,1324,519,332,851,78,929,2021,45.97%,25.68%,1
臺中市,太平區,1325,697,442,1139,72,1211,2075,58.36%,33.59%,1
臺中市,太平區,1326,472,362,834,46,880,1723,51.07%,27.39%,1
臺中市,太平區,1327,676,424,1100,44,1144,2049,55.83%,32.99%,1
臺中市,太平區,1328,456,313,769,17,786,1415,55.55%,32.23%,1
臺中市,太平區,1329,582,391,973,41,1014,1778,57.03%,32.73%,1
臺中市,太平區,1330,497,356,853,53,906,1706,53.11%,29.13%,1
臺中市,太平區,1331,673,382,1055,51,1106,2090,52.92%,32.2%,1
臺中市,太平區,1332,596,396,992,49,1041,2093,49.74%,28.48%,1
臺中市,太平區,1333,492,306,798,31,829,1688,49.11%,29.15%,1
臺中市,太平區,1334,427,297,724,27,751,1488,50.47%,28.7%,1
臺中市,太平區,1335,584,342,926,53,979,1667,58.73%,35.03%,1
臺中市,太平區,1336,550,312,862,63,925,1793,51.59%,30.67%,1
臺中市,太平區,1337,648,413,1061,35,1096,1903,57.59%,34.05%,1
臺中市,太平區,1338,615,345,960,50,1010,1834,55.07%,33.53%,1
臺中市,太平區,1339,518,299,817,34,851,1526,55.77%,33.94%,1
臺中市,太平區,1340,537,373,910,20,930,1483,62.71%,36.21%,1
臺中市,太平區,1341,536,404,940,21,961,1694,56.73%,31.64%,1
臺中市,太平區,1342,568,370,938,34,972,1952,49.8%,29.1%,1
臺中市,太平區,1343,640,412,1052,48,1100,1995,55.14%,32.08%,1
臺中市,太平區,1344,444,293,737,26,763,1311,58.2%,33.87%,1
臺中市,太平區,1345,554,438,992,26,1018,1537,66.23%,36.04%,1
臺中市,太平區,1346,590,354,944,49,993,1974,50.3%,29.89%,1
臺中市,太平區,1347,582,424,1006,33,1039,1828,56.84%,31.84%,1
臺中市,太平區,1348,658,394,1052,45,1097,2191,50.07%,30.03%,1
臺中市,太平區,1349,588,324,912,66,978,1825,53.59%,32.22%,1
臺中市,太平區,1350,490,311,801,19,820,1559,52.6%,31.43%,1
臺中市,太平區,1351,385,243,628,58,686,1225,56%,31.43%,1
臺中市,太平區,1352,555,321,876,62,938,1678,55.9%,33.08%,1
臺中市,太平區,1353,437,283,720,73,793,1501,52.83%,29.11%,1
臺中市,太平區,1354,537,331,868,57,925,1450,63.79%,37.03%,1
臺中市,太平區,1355,627,432,1059,71,1130,2126,53.15%,29.49%,1
臺中市,太平區,1356,262,153,415,37,452,699,64.66%,37.48%,1
臺中市,太平區,1357,381,322,703,33,736,1428,51.54%,26.68%,1
臺中市,太平區,1358,531,376,907,68,975,1666,58.52%,31.87%,1
臺中市,太平區,1359,444,250,694,36,730,1241,58.82%,35.78%,1
臺中市,太平區,1360,447,272,719,45,764,1266,60.35%,35.31%,1
臺中市,太平區,1361,418,214,632,37,669,1166,57.38%,35.85%,1
臺中市,太平區,1362,576,391,967,81,1048,1790,58.55%,32.18%,1
臺中市,太平區,1363,472,295,767,37,804,1754,45.84%,26.91%,1
臺中市,大里區,1364,533,286,819,32,851,1614,52.73%,33.02%,1
臺中市,大里區,1365,489,309,798,37,835,1599,52.22%,30.58%,1
臺中市,大里區,1366,467,367,834,35,869,1715,50.67%,27.23%,1
臺中市,大里區,1367,436,286,722,27,749,1264,59.26%,34.49%,1
臺中市,大里區,1368,417,304,721,39,760,1416,53.67%,29.45%,1
臺中市,大里區,1369,374,260,634,28,662,1188,55.72%,31.48%,1
臺中市,大里區,1370,448,257,705,52,757,1359,55.7%,32.97%,1
臺中市,大里區,1371,462,340,802,49,851,1457,58.41%,31.71%,1
臺中市,大里區,1372,456,328,784,49,833,1403,59.37%,32.5%,1
臺中市,大里區,1373,539,369,908,58,966,1697,56.92%,31.76%,1
臺中市,大里區,1374,635,401,1036,72,1108,1811,61.18%,35.06%,1
臺中市,大里區,1375,596,331,927,52,979,1830,53.5%,32.57%,1
臺中市,大里區,1376,532,313,845,101,946,2228,42.46%,23.88%,1
臺中市,大里區,1377,710,440,1150,57,1207,1997,60.44%,35.55%,1
臺中市,大里區,1378,798,459,1257,43,1300,2033,63.94%,39.25%,1
臺中市,大里區,1379,626,447,1073,34,1107,1835,60.33%,34.11%,1
臺中市,大里區,1380,425,288,713,23,736,1268,58.04%,33.52%,1
臺中市,大里區,1381,549,352,901,55,956,1645,58.12%,33.37%,1
臺中市,大里區,1382,610,310,920,36,956,1561,61.24%,39.08%,1
臺中市,大里區,1383,519,288,807,41,848,1301,65.18%,39.89%,1
臺中市,大里區,1384,539,301,840,53,893,1621,55.09%,33.25%,1
臺中市,大里區,1385,548,378,926,54,980,1797,54.54%,30.5%,1
臺中市,大里區,1386,396,260,656,32,688,1230,55.93%,32.2%,1
臺中市,大里區,1387,482,280,762,47,809,1488,54.37%,32.39%,1
臺中市,大里區,1388,447,295,742,52,794,1459,54.42%,30.64%,1
臺中市,大里區,1389,574,326,900,44,944,1647,57.32%,34.85%,1
臺中市,大里區,1390,385,259,644,50,694,1100,63.09%,35%,1
臺中市,大里區,1391,467,303,770,39,809,1410,57.38%,33.12%,1
臺中市,大里區,1392,595,317,912,48,960,1807,53.13%,32.93%,1
臺中市,大里區,1393,419,299,718,45,763,1331,57.33%,31.48%,1
臺中市,大里區,1394,674,273,947,27,974,1801,54.08%,37.42%,1
臺中市,大里區,1395,591,348,939,40,979,1909,51.28%,30.96%,1
臺中市,大里區,1396,499,317,816,52,868,1699,51.09%,29.37%,1
臺中市,大里區,1397,564,329,893,46,939,1627,57.71%,34.67%,1
臺中市,大里區,1398,608,401,1009,38,1047,1912,54.76%,31.8%,1
臺中市,大里區,1399,569,324,893,48,941,1753,53.68%,32.46%,1
臺中市,大里區,1400,570,295,865,34,899,1602,56.12%,35.58%,1
臺中市,大里區,1401,354,266,620,45,665,1144,58.13%,30.94%,1
臺中市,大里區,1402,558,370,928,51,979,1655,59.15%,33.72%,1
臺中市,大里區,1403,328,447,775,35,810,1438,56.33%,22.81%,1
臺中市,大里區,1404,325,225,550,44,594,1000,59.4%,32.5%,1
臺中市,大里區,1405,545,364,909,57,966,1711,56.46%,31.85%,1
臺中市,大里區,1406,577,354,931,17,948,1698,55.83%,33.98%,1
臺中市,大里區,1407,621,400,1021,53,1074,1914,56.11%,32.45%,1
臺中市,大里區,1408,486,353,839,21,860,1465,58.7%,33.17%,1
臺中市,大里區,1409,513,334,847,60,907,1581,57.37%,32.45%,1
臺中市,大里區,1410,521,233,754,46,800,1509,53.02%,34.53%,1
臺中市,大里區,1411,510,326,836,25,861,1570,54.84%,32.48%,1
臺中市,大里區,1412,428,364,792,37,829,1425,58.18%,30.04%,1
臺中市,大里區,1413,460,316,776,47,823,1384,59.47%,33.24%,1
臺中市,大里區,1414,335,248,583,32,615,1204,51.08%,27.82%,1
臺中市,大里區,1415,510,364,874,33,907,1761,51.5%,28.96%,1
臺中市,大里區,1416,431,270,701,25,726,1473,49.29%,29.26%,1
臺中市,大里區,1417,553,351,904,47,951,1675,56.78%,33.01%,1
臺中市,大里區,1418,629,323,952,44,996,1755,56.75%,35.84%,1
臺中市,大里區,1419,543,347,890,66,956,1593,60.01%,34.09%,1
臺中市,大里區,1420,569,376,945,56,1001,1799,55.64%,31.63%,1
臺中市,大里區,1421,517,339,856,64,920,1606,57.29%,32.19%,1
臺中市,大里區,1422,602,391,993,37,1030,1875,54.93%,32.11%,1
臺中市,大里區,1423,563,350,913,46,959,1670,57.43%,33.71%,1
臺中市,大里區,1424,568,428,996,54,1050,1898,55.32%,29.93%,1
臺中市,大里區,1425,530,340,870,35,905,1679,53.9%,31.57%,1
臺中市,大里區,1426,421,293,714,45,759,1373,55.28%,30.66%,1
臺中市,大里區,1427,463,251,714,38,752,1299,57.89%,35.64%,1
臺中市,大里區,1428,480,303,783,33,816,1430,57.06%,33.57%,1
臺中市,大里區,1429,714,395,1109,37,1146,1805,63.49%,39.56%,1
臺中市,大里區,1430,691,467,1158,28,1186,1806,65.67%,38.26%,1
臺中市,大里區,1431,740,391,1131,58,1189,1826,65.12%,40.53%,1
臺中市,大里區,1432,729,423,1152,27,1179,1805,65.32%,40.39%,1
臺中市,大里區,1433,710,400,1110,41,1151,1907,60.36%,37.23%,1
臺中市,大里區,1434,455,215,670,32,702,1103,63.64%,41.25%,1
臺中市,大里區,1435,412,272,684,42,726,1419,51.16%,29.03%,1
臺中市,大里區,1436,548,235,783,40,823,1434,57.39%,38.21%,1
臺中市,大里區,1437,595,336,931,41,972,1875,51.84%,31.73%,1
臺中市,大里區,1438,597,392,989,56,1045,1862,56.12%,32.06%,1
臺中市,大里區,1439,628,355,983,31,1014,1850,54.81%,33.95%,1
臺中市,大里區,1440,543,327,870,61,931,1622,57.4%,33.48%,1
臺中市,大里區,1441,603,358,961,58,1019,1638,62.21%,36.81%,1
臺中市,大里區,1442,584,368,952,70,1022,1633,62.58%,35.76%,1
臺中市,大里區,1443,571,358,929,32,961,1662,57.82%,34.36%,1
臺中市,大里區,1444,643,451,1094,37,1131,1917,59%,33.54%,1
臺中市,大里區,1445,521,304,825,72,897,1701,52.73%,30.63%,1
臺中市,大里區,1446,479,306,785,48,833,1549,53.78%,30.92%,1
臺中市,大里區,1447,558,348,906,42,948,1567,60.5%,35.61%,1
臺中市,大里區,1448,553,345,898,12,910,1614,56.38%,34.26%,1
臺中市,大里區,1449,596,372,968,71,1039,1811,57.37%,32.91%,1
臺中市,大里區,1450,436,290,726,39,765,1336,57.26%,32.63%,1
臺中市,大里區,1451,620,312,932,37,969,1759,55.09%,35.25%,1
臺中市,大里區,1452,560,338,898,47,945,1783,53%,31.41%,1
臺中市,大里區,1453,506,336,842,45,887,1736,51.09%,29.15%,1
臺中市,大里區,1454,662,368,1030,48,1078,1874,57.52%,35.33%,1
臺中市,大里區,1455,629,365,994,81,1075,1889,56.91%,33.3%,1
臺中市,大里區,1456,669,368,1037,57,1094,1947,56.19%,34.36%,1
臺中市,大里區,1457,672,424,1096,37,1133,1938,58.46%,34.67%,1
臺中市,大里區,1458,588,379,967,62,1029,1836,56.05%,32.03%,1
臺中市,大里區,1459,628,371,999,52,1051,1913,54.94%,32.83%,1
臺中市,大里區,1460,578,378,956,69,1025,1913,53.58%,30.21%,1
臺中市,大里區,1461,619,349,968,45,1013,1937,52.3%,31.96%,1
臺中市,大里區,1462,491,311,802,33,835,1508,55.37%,32.56%,1
臺中市,大里區,1463,465,312,777,32,809,1340,60.37%,34.7%,1
臺中市,大里區,1464,569,355,924,47,971,1656,58.64%,34.36%,1
臺中市,大里區,1465,439,270,709,32,741,1290,57.44%,34.03%,1
臺中市,大里區,1466,515,359,874,43,917,1655,55.41%,31.12%,1
臺中市,大里區,1467,358,265,623,23,646,1260,51.27%,28.41%,1
臺中市,大里區,1468,425,295,720,27,747,1247,59.9%,34.08%,1
臺中市,大里區,1469,469,294,763,105,868,1548,56.07%,30.3%,1
臺中市,和平區,1585,358,227,585,32,617,956,64.54%,37.45%,1
臺中市,和平區,1586,366,214,580,47,627,963,65.11%,38.01%,1
臺中市,和平區,1587,140,120,260,14,274,456,60.09%,30.7%,1
臺中市,和平區,1588,405,214,619,44,663,1011,65.58%,40.06%,1
臺中市,和平區,1589,220,147,367,19,386,636,60.69%,34.59%,1
臺中市,和平區,1590,77,64,141,10,151,270,55.93%,28.52%,1
臺中市,和平區,1591,238,95,333,24,357,460,77.61%,51.74%,1
臺中市,和平區,1592,109,120,229,13,242,321,75.39%,33.96%,1
臺中市,和平區,1593,293,195,488,28,516,783,65.9%,37.42%,1
臺中市,和平區,1594,135,68,203,13,216,336,64.29%,40.18%,1
臺中市,和平區,1595,187,125,312,7,319,451,70.73%,41.46%,1
臺中市,和平區,1596,135,71,206,13,219,366,59.84%,36.89%,1
臺中市,和平區,1597,240,124,364,11,375,771,48.64%,31.13%,1
臺中市,和平區,1598,185,114,299,22,321,574,55.92%,32.23%,1
臺中市,和平區,1599,110,51,161,10,171,274,62.41%,40.15%,1
臺中市,和平區,1600,40,42,82,6,88,157,56.05%,25.48%,1
臺中市,和平區,1601,269,125,394,21,415,713,58.2%,37.73%,1
臺南市,新營區,0116,465,299,764,36,800,1693,47.25%,27.47%,1
臺南市,新營區,0117,519,311,830,41,871,1561,55.8%,33.25%,1
臺南市,新營區,0118,474,302,776,33,809,1487,54.4%,31.88%,1
臺南市,新營區,0119,419,213,632,27,659,1232,53.49%,34.01%,1
臺南市,新營區,0120,306,227,533,19,552,1067,51.73%,28.68%,1
臺南市,新營區,0121,389,258,647,36,683,1419,48.13%,27.41%,1
臺南市,新營區,0122,505,289,794,29,823,1466,56.14%,34.45%,1
臺南市,新營區,0123,327,206,533,41,574,932,61.59%,35.09%,1
臺南市,新營區,0124,337,189,526,14,540,1099,49.14%,30.66%,1
臺南市,新營區,0125,220,141,361,14,375,757,49.54%,29.06%,1
臺南市,新營區,0126,309,181,490,26,516,888,58.11%,34.8%,1
臺南市,新營區,0127,342,221,563,19,582,1115,52.2%,30.67%,1
臺南市,新營區,0128,287,167,454,14,468,937,49.95%,30.63%,1
臺南市,新營區,0129,389,273,662,30,692,1387,49.89%,28.05%,1
臺南市,新營區,0130,460,261,721,43,764,1526,50.07%,30.14%,1
臺南市,新營區,0131,413,295,708,26,734,1301,56.42%,31.74%,1
臺南市,新營區,0132,498,334,832,38,870,1538,56.57%,32.38%,1
臺南市,新營區,0133,494,330,824,31,855,1584,53.98%,31.19%,1
臺南市,新營區,0134,532,342,874,17,891,1583,56.29%,33.61%,1
臺南市,新營區,0135,473,338,811,29,840,1530,54.9%,30.92%,1
臺南市,新營區,0136,401,271,672,35,707,1193,59.26%,33.61%,1
臺南市,新營區,0137,324,236,560,23,583,1439,40.51%,22.52%,1
臺南市,新營區,0138,490,284,774,36,810,1438,56.33%,34.08%,1
臺南市,新營區,0139,119,73,192,18,210,359,58.5%,33.15%,1
臺南市,新營區,0140,310,204,514,26,540,1233,43.8%,25.14%,1
臺南市,新營區,0141,329,183,512,20,532,1227,43.36%,26.81%,1
臺南市,新營區,0142,350,240,590,23,613,1320,46.44%,26.52%,1
臺南市,新營區,0143,471,347,818,27,845,1930,43.78%,24.4%,1
臺南市,新營區,0144,472,287,759,35,794,1501,52.9%,31.45%,1
臺南市,新營區,0145,441,256,697,29,726,1475,49.22%,29.9%,1
臺南市,新營區,0146,641,256,897,39,936,1753,53.39%,36.57%,1
臺南市,新營區,0147,490,351,841,28,869,1748,49.71%,28.03%,1
臺南市,新營區,0148,545,322,867,37,904,1741,51.92%,31.3%,1
臺南市,新營區,0149,411,271,682,19,701,1433,48.92%,28.68%,1
臺南市,新營區,0150,476,320,796,38,834,1595,52.29%,29.84%,1
臺南市,新營區,0151,268,172,440,22,462,959,48.18%,27.95%,1
臺南市,新營區,0152,519,331,850,54,904,1865,48.47%,27.83%,1
臺南市,新營區,0153,416,305,721,68,789,1678,47.02%,24.79%,1
臺南市,新營區,0154,361,230,591,32,623,1373,45.38%,26.29%,1
臺南市,新營區,0155,342,215,557,23,580,1431,40.53%,23.9%,1
臺南市,新營區,0156,71,44,115,1,116,291,39.86%,24.4%,1
臺南市,新營區,0157,517,326,843,42,885,1749,50.6%,29.56%,1
臺南市,新營區,0158,478,339,817,46,863,1862,46.35%,25.67%,1
臺南市,新營區,0159,542,374,916,66,982,1821,53.93%,29.76%,1
臺南市,新營區,0160,505,316,821,46,867,1845,46.99%,27.37%,1
臺南市,新營區,0161,137,73,210,5,215,542,39.67%,25.28%,1
臺南市,新營區,0162,97,51,148,5,153,402,38.06%,24.13%,1
臺南市,新營區,0163,223,141,364,47,411,703,58.46%,31.72%,1
臺南市,新營區,0164,241,153,394,26,420,941,44.63%,25.61%,1
臺南市,鹽水區,0085,337,180,517,45,562,1037,54.19%,32.5%,1
臺南市,鹽水區,0086,157,85,242,14,256,480,53.33%,32.71%,1
臺南市,鹽水區,0087,224,140,364,17,381,636,59.91%,35.22%,1
臺南市,鹽水區,0088,108,60,168,12,180,321,56.07%,33.64%,1
臺南市,鹽水區,0089,184,87,271,27,298,497,59.96%,37.02%,1
臺南市,鹽水區,0090,264,166,430,16,446,759,58.76%,34.78%,1
臺南市,鹽水區,0091,106,50,156,11,167,341,48.97%,31.09%,1
臺南市,鹽水區,0092,157,108,265,18,283,507,55.82%,30.97%,1
臺南市,鹽水區,0093,222,157,379,21,400,863,46.35%,25.72%,1
臺南市,鹽水區,0094,380,263,643,19,662,1373,48.22%,27.68%,1
臺南市,鹽水區,0095,440,267,707,44,751,1507,49.83%,29.2%,1
臺南市,鹽水區,0096,421,266,687,44,731,1374,53.2%,30.64%,1
臺南市,鹽水區,0097,345,220,565,33,598,1244,48.07%,27.73%,1
臺南市,鹽水區,0098,317,186,503,35,538,1022,52.64%,31.02%,1
臺南市,鹽水區,0099,194,123,317,39,356,921,38.65%,21.06%,1
臺南市,鹽水區,0100,251,176,427,32,459,847,54.19%,29.63%,1
臺南市,鹽水區,0101,146,100,246,11,257,736,34.92%,19.84%,1
臺南市,鹽水區,0102,234,143,377,18,395,761,51.91%,30.75%,1
臺南市,鹽水區,0103,81,49,130,11,141,285,49.47%,28.42%,1
臺南市,鹽水區,0104,111,101,212,15,227,493,46.04%,22.52%,1
臺南市,鹽水區,0105,129,100,229,17,246,621,39.61%,20.77%,1
臺南市,鹽水區,0106,94,50,144,9,153,392,39.03%,23.98%,1
臺南市,鹽水區,0107,249,182,431,21,452,925,48.86%,26.92%,1
臺南市,鹽水區,0108,181,115,296,32,328,728,45.05%,24.86%,1
臺南市,鹽水區,0109,42,25,67,18,85,214,39.72%,19.63%,1
臺南市,鹽水區,0110,120,52,172,7,179,387,46.25%,31.01%,1
臺南市,鹽水區,0111,91,52,143,14,157,301,52.16%,30.23%,1
臺南市,鹽水區,0112,152,123,275,29,304,755,40.26%,20.13%,1
臺南市,鹽水區,0113,90,48,138,17,155,365,42.47%,24.66%,1
臺南市,鹽水區,0114,258,166,424,23,447,935,47.81%,27.59%,1
臺南市,鹽水區,0115,137,76,213,21,234,494,47.37%,27.73%,1
臺南市,白河區,0030,368,216,584,56,640,1176,54.42%,31.29%,1
臺南市,白河區,0031,164,106,270,11,281,546,51.47%,30.04%,1
臺南市,白河區,0032,279,182,461,16,477,859,55.53%,32.48%,1
臺南市,白河區,0033,314,194,508,30,538,946,56.87%,33.19%,1
臺南市,白河區,0034,349,210,559,25,584,1116,52.33%,31.27%,1
臺南市,白河區,0035,360,204,564,17,581,1397,41.59%,25.77%,1
臺南市,白河區,0036,162,141,303,19,322,756,42.59%,21.43%,1
臺南市,白河區,0037,261,132,393,34,427,871,49.02%,29.97%,1
臺南市,白河區,0038,249,171,420,32,452,897,50.39%,27.76%,1
臺南市,白河區,0039,152,103,255,32,287,784,36.61%,19.39%,1
臺南市,白河區,0040,126,102,228,16,244,572,42.66%,22.03%,1
臺南市,白河區,0041,97,59,156,6,162,457,35.45%,21.23%,1
臺南市,白河區,0042,145,77,222,16,238,600,39.67%,24.17%,1
臺南市,白河區,0043,61,51,112,5,117,375,31.2%,16.27%,1
臺南市,白河區,0044,86,53,139,13,152,508,29.92%,16.93%,1
臺南市,白河區,0045,117,80,197,12,209,631,33.12%,18.54%,1
臺南市,白河區,0046,70,37,107,15,122,391,31.2%,17.9%,1
臺南市,白河區,0047,212,74,286,19,305,799,38.17%,26.53%,1
臺南市,白河區,0048,109,65,174,11,185,506,36.56%,21.54%,1
臺南市,白河區,0049,215,133,348,28,376,832,45.19%,25.84%,1
臺南市,白河區,0050,310,216,526,35,561,1179,47.58%,26.29%,1
臺南市,白河區,0051,156,105,261,12,273,744,36.69%,20.97%,1
臺南市,白河區,0052,145,108,253,17,270,699,38.63%,20.74%,1
臺南市,白河區,0053,144,86,230,9,239,633,37.76%,22.75%,1
臺南市,白河區,0054,242,175,417,49,466,859,54.25%,28.17%,1
臺南市,白河區,0055,202,153,355,39,394,884,44.57%,22.85%,1
臺南市,白河區,0056,127,73,200,16,216,740,29.19%,17.16%,1
臺南市,白河區,0057,328,211,539,39,578,1334,43.33%,24.59%,1
臺南市,白河區,0058,188,118,306,49,355,723,49.1%,26%,1
臺南市,白河區,0059,222,118,340,47,387,682,56.74%,32.55%,1
臺南市,白河區,0060,228,175,403,38,441,855,51.58%,26.67%,1
臺南市,白河區,0061,126,79,205,24,229,543,42.17%,23.2%,1
臺南市,柳營區,0165,317,223,540,39,579,1166,49.66%,27.19%,1
臺南市,柳營區,0166,214,126,340,10,350,625,56%,34.24%,1
臺南市,柳營區,0167,222,116,338,16,354,738,47.97%,30.08%,1
臺南市,柳營區,0168,312,173,485,17,502,834,60.19%,37.41%,1
臺南市,柳營區,0169,329,188,517,28,545,1104,49.37%,29.8%,1
臺南市,柳營區,0170,279,190,469,14,483,1015,47.59%,27.49%,1
臺南市,柳營區,0171,561,298,859,96,955,1720,55.52%,32.62%,1
臺南市,柳營區,0172,363,226,589,73,662,1391,47.59%,26.1%,1
臺南市,柳營區,0173,133,65,198,9,207,425,48.71%,31.29%,1
臺南市,柳營區,0174,81,45,126,10,136,318,42.77%,25.47%,1
臺南市,柳營區,0175,205,145,350,28,378,753,50.2%,27.22%,1
臺南市,柳營區,0176,186,114,300,43,343,730,46.99%,25.48%,1
臺南市,柳營區,0177,228,117,345,24,369,725,50.9%,31.45%,1
臺南市,柳營區,0178,238,158,396,32,428,787,54.38%,30.24%,1
臺南市,柳營區,0179,86,69,155,17,172,297,57.91%,28.96%,1
臺南市,柳營區,0180,210,143,353,23,376,673,55.87%,31.2%,1
臺南市,柳營區,0181,205,115,320,44,364,640,56.88%,32.03%,1
臺南市,柳營區,0182,138,124,262,28,290,660,43.94%,20.91%,1
臺南市,柳營區,0183,379,143,522,35,557,1212,45.96%,31.27%,1
臺南市,柳營區,0184,52,31,83,7,90,202,44.55%,25.74%,1
臺南市,柳營區,0185,293,167,460,56,516,1049,49.19%,27.93%,1
臺南市,柳營區,0186,42,34,76,0,76,158,48.1%,26.58%,1
臺南市,柳營區,0187,240,164,404,60,464,921,50.38%,26.06%,1
臺南市,柳營區,0188,137,83,220,16,236,504,46.83%,27.18%,1
臺南市,柳營區,0189,38,25,63,3,66,157,42.04%,24.2%,1
臺南市,後壁區,0001,257,133,390,35,425,743,57.2%,34.59%,1
臺南市,後壁區,0002,272,160,432,28,460,898,51.22%,30.29%,1
臺南市,後壁區,0003,208,144,352,34,386,786,49.11%,26.46%,1
臺南市,後壁區,0004,173,83,256,22,278,534,52.06%,32.4%,1
臺南市,後壁區,0005,284,203,487,51,538,1034,52.03%,27.47%,1
臺南市,後壁區,0006,46,43,89,17,106,232,45.69%,19.83%,1
臺南市,後壁區,0007,109,95,204,32,236,479,49.27%,22.76%,1
臺南市,後壁區,0008,239,138,377,29,406,837,48.51%,28.55%,1
臺南市,後壁區,0009,240,178,418,37,455,1085,41.94%,22.12%,1
臺南市,後壁區,0010,238,171,409,23,432,1157,37.34%,20.57%,1
臺南市,後壁區,0011,219,125,344,44,388,755,51.39%,29.01%,1
臺南市,後壁區,0012,150,87,237,19,256,458,55.9%,32.75%,1
臺南市,後壁區,0013,104,51,155,23,178,371,47.98%,28.03%,1
臺南市,後壁區,0014,192,106,298,35,333,676,49.26%,28.4%,1
臺南市,後壁區,0015,111,58,169,21,190,428,44.39%,25.93%,1
臺南市,後壁區,0016,152,72,224,17,241,547,44.06%,27.79%,1
臺南市,後壁區,0017,141,64,205,28,233,455,51.21%,30.99%,1
臺南市,後壁區,0018,266,124,390,47,437,984,44.41%,27.03%,1
臺南市,後壁區,0019,121,85,206,21,227,483,47%,25.05%,1
臺南市,後壁區,0020,131,75,206,21,227,536,42.35%,24.44%,1
臺南市,後壁區,0021,175,161,336,13,349,958,36.43%,18.27%,1
臺南市,後壁區,0022,144,75,219,36,255,441,57.82%,32.65%,1
臺南市,後壁區,0023,209,123,332,45,377,677,55.69%,30.87%,1
臺南市,後壁區,0024,341,169,510,33,543,996,54.52%,34.24%,1
臺南市,後壁區,0025,361,195,556,25,581,1255,46.29%,28.76%,1
臺南市,後壁區,0026,190,99,289,12,301,678,44.4%,28.02%,1
臺南市,後壁區,0027,145,92,237,8,245,553,44.3%,26.22%,1
臺南市,後壁區,0028,146,82,228,15,243,616,39.45%,23.7%,1
臺南市,後壁區,0029,344,208,552,38,590,1189,49.62%,28.93%,1
臺南市,東山區,0062,379,211,590,31,621,1401,44.33%,27.05%,1
臺南市,東山區,0063,294,181,475,32,507,1185,42.78%,24.81%,1
臺南市,東山區,0064,291,187,478,57,535,1303,41.06%,22.33%,1
臺南市,東山區,0065,159,121,280,18,298,732,40.71%,21.72%,1
臺南市,東山區,0066,166,96,262,25,287,721,39.81%,23.02%,1
臺南市,東山區,0067,190,182,372,36,408,1104,36.96%,17.21%,1
臺南市,東山區,0068,253,131,384,23,407,943,43.16%,26.83%,1
臺南市,東山區,0069,110,65,175,1,176,653,26.95%,16.85%,1
臺南市,東山區,0070,160,95,255,39,294,596,49.33%,26.85%,1
臺南市,東山區,0071,230,132,362,38,400,878,45.56%,26.2%,1
臺南市,東山區,0072,163,117,280,45,325,771,42.15%,21.14%,1
臺南市,東山區,0073,119,75,194,17,211,483,43.69%,24.64%,1
臺南市,東山區,0074,171,107,278,38,316,640,49.38%,26.72%,1
臺南市,東山區,0075,71,34,105,2,107,425,25.18%,16.71%,1
臺南市,東山區,0076,96,44,140,11,151,394,38.32%,24.37%,1
臺南市,東山區,0077,107,64,171,21,192,373,51.47%,28.69%,1
臺南市,東山區,0078,303,161,464,27,491,1257,39.06%,24.11%,1
臺南市,東山區,0079,181,85,266,5,271,887,30.55%,20.41%,1
臺南市,東山區,0080,130,62,192,12,204,658,31%,19.76%,1
臺南市,東山區,0081,195,123,318,26,344,1101,31.24%,17.71%,1
臺南市,東山區,0082,193,118,311,15,326,1057,30.84%,18.26%,1
臺南市,東山區,0083,186,102,288,22,310,639,48.51%,29.11%,1
臺南市,東山區,0084,58,49,107,10,117,270,43.33%,21.48%,1
臺南市,麻豆區,0381,364,228,592,45,637,1205,52.86%,30.21%,1
臺南市,麻豆區,0382,200,150,350,22,372,660,56.36%,30.3%,1
臺南市,麻豆區,0383,174,110,284,12,296,523,56.6%,33.27%,1
臺南市,麻豆區,0384,439,335,774,30,804,1597,50.34%,27.49%,1
臺南市,麻豆區,0385,374,283,657,45,702,1262,55.63%,29.64%,1
臺南市,麻豆區,0386,425,287,712,46,758,1325,57.21%,32.08%,1
臺南市,麻豆區,0387,388,282,670,40,710,1384,51.3%,28.03%,1
臺南市,麻豆區,0388,288,244,532,14,546,1121,48.71%,25.69%,1
臺南市,麻豆區,0389,319,171,490,11,501,1021,49.07%,31.24%,1
臺南市,麻豆區,0390,261,190,451,22,473,954,49.58%,27.36%,1
臺南市,麻豆區,0391,416,262,678,24,702,1513,46.4%,27.5%,1
臺南市,麻豆區,0392,465,281,746,43,789,1726,45.71%,26.94%,1
臺南市,麻豆區,0393,539,336,875,46,921,1804,51.05%,29.88%,1
臺南市,麻豆區,0394,303,202,505,37,542,1106,49.01%,27.4%,1
臺南市,麻豆區,0395,451,299,750,43,793,1503,52.76%,30.01%,1
臺南市,麻豆區,0396,352,246,598,65,663,1302,50.92%,27.04%,1
臺南市,麻豆區,0397,190,125,315,12,327,645,50.7%,29.46%,1
臺南市,麻豆區,0398,251,155,406,32,438,777,56.37%,32.3%,1
臺南市,麻豆區,0399,433,301,734,48,782,1612,48.51%,26.86%,1
臺南市,麻豆區,0400,202,122,324,16,340,718,47.35%,28.13%,1
臺南市,麻豆區,0401,474,258,732,25,757,1656,45.71%,28.62%,1
臺南市,麻豆區,0402,356,255,611,60,671,1355,49.52%,26.27%,1
臺南市,麻豆區,0403,230,154,384,24,408,977,41.76%,23.54%,1
臺南市,麻豆區,0404,282,164,446,29,475,1012,46.94%,27.87%,1
臺南市,麻豆區,0405,175,157,332,20,352,626,56.23%,27.96%,1
臺南市,麻豆區,0406,97,60,157,2,159,467,34.05%,20.77%,1
臺南市,麻豆區,0407,362,200,562,34,596,1260,47.3%,28.73%,1
臺南市,麻豆區,0408,388,174,562,38,600,1111,54.01%,34.92%,1
臺南市,麻豆區,0409,155,133,288,12,300,550,54.55%,28.18%,1
臺南市,麻豆區,0410,225,165,390,38,428,798,53.63%,28.2%,1
臺南市,麻豆區,0411,277,186,463,49,512,852,60.09%,32.51%,1
臺南市,麻豆區,0412,221,107,328,22,350,830,42.17%,26.63%,1
臺南市,麻豆區,0413,239,158,397,23,420,941,44.63%,25.4%,1
臺南市,麻豆區,0414,377,224,601,31,632,1158,54.58%,32.56%,1
臺南市,麻豆區,0415,173,107,280,12,292,612,47.71%,28.27%,1
臺南市,下營區,0343,436,241,677,30,707,1558,45.38%,27.98%,1
臺南市,下營區,0344,263,167,430,42,472,1112,42.45%,23.65%,1
臺南市,下營區,0345,256,140,396,31,427,893,47.82%,28.67%,1
臺南市,下營區,0346,378,277,655,69,724,1623,44.61%,23.29%,1
臺南市,下營區,0347,421,292,713,75,788,1568,50.26%,26.85%,1
臺南市,下營區,0348,305,167,472,38,510,985,51.78%,30.96%,1
臺南市,下營區,0349,277,159,436,16,452,953,47.43%,29.07%,1
臺南市,下營區,0350,309,157,466,37,503,1031,48.79%,29.97%,1
臺南市,下營區,0351,375,195,570,37,607,1077,56.36%,34.82%,1
臺南市,下營區,0352,163,104,267,32,299,703,42.53%,23.19%,1
臺南市,下營區,0353,208,148,356,18,374,854,43.79%,24.36%,1
臺南市,下營區,0354,326,210,536,66,602,1164,51.72%,28.01%,1
臺南市,下營區,0355,286,186,472,22,494,1091,45.28%,26.21%,1
臺南市,下營區,0356,289,160,449,41,490,959,51.09%,30.14%,1
臺南市,下營區,0357,277,148,425,27,452,935,48.34%,29.63%,1
臺南市,下營區,0358,255,171,426,43,469,893,52.52%,28.56%,1
臺南市,下營區,0359,425,184,609,72,681,1293,52.67%,32.87%,1
臺南市,下營區,0360,340,201,541,87,628,1185,53%,28.69%,1
臺南市,下營區,0361,254,156,410,18,428,1070,40%,23.74%,1
臺南市,六甲區,0362,251,172,423,47,470,819,57.39%,30.65%,1
臺南市,六甲區,0363,189,124,313,21,334,645,51.78%,29.3%,1
臺南市,六甲區,0364,345,287,632,42,674,1444,46.68%,23.89%,1
臺南市,六甲區,0365,372,269,641,44,685,1554,44.08%,23.94%,1
臺南市,六甲區,0366,286,207,493,34,527,1171,45%,24.42%,1
臺南市,六甲區,0367,350,251,601,54,655,1351,48.48%,25.91%,1
臺南市,六甲區,0368,230,166,396,74,470,1010,46.53%,22.77%,1
臺南市,六甲區,0369,225,165,390,52,442,919,48.1%,24.48%,1
臺南市,六甲區,0370,360,251,611,50,661,1369,48.28%,26.3%,1
臺南市,六甲區,0371,277,188,465,52,517,976,52.97%,28.38%,1
臺南市,六甲區,0372,284,209,493,62,555,1015,54.68%,27.98%,1
臺南市,六甲區,0373,304,203,507,35,542,1176,46.09%,25.85%,1
臺南市,六甲區,0374,248,189,437,50,487,939,51.86%,26.41%,1
臺南市,六甲區,0375,187,143,330,45,375,712,52.67%,26.26%,1
臺南市,六甲區,0376,244,189,433,31,464,881,52.67%,27.7%,1
臺南市,六甲區,0377,350,293,643,46,689,1184,58.19%,29.56%,1
臺南市,六甲區,0378,208,127,335,33,368,599,61.44%,34.72%,1
臺南市,六甲區,0379,138,93,231,13,244,759,32.15%,18.18%,1
臺南市,六甲區,0380,137,89,226,25,251,621,40.42%,22.06%,1
臺南市,官田區,0416,321,171,492,25,517,1104,46.83%,29.08%,1
臺南市,官田區,0417,288,156,444,30,474,965,49.12%,29.84%,1
臺南市,官田區,0418,388,289,677,44,721,1402,51.43%,27.67%,1
臺南市,官田區,0419,490,349,839,72,911,1653,55.11%,29.64%,1
臺南市,官田區,0420,241,163,404,46,450,966,46.58%,24.95%,1
臺南市,官田區,0421,65,52,117,10,127,284,44.72%,22.89%,1
臺南市,官田區,0422,68,63,131,2,133,402,33.08%,16.92%,1
臺南市,官田區,0423,319,174,493,16,509,982,51.83%,32.48%,1
臺南市,官田區,0424,274,143,417,31,448,975,45.95%,28.1%,1
臺南市,官田區,0425,223,153,376,22,398,802,49.63%,27.81%,1
臺南市,官田區,0426,361,220,581,40,621,1118,55.55%,32.29%,1
臺南市,官田區,0427,419,292,711,31,742,1455,51%,28.8%,1
臺南市,官田區,0428,350,223,573,42,615,1208,50.91%,28.97%,1
臺南市,官田區,0429,355,229,584,62,646,1293,49.96%,27.46%,1
臺南市,官田區,0430,138,108,246,18,264,607,43.49%,22.73%,1
臺南市,官田區,0431,159,76,235,13,248,501,49.5%,31.74%,1
臺南市,官田區,0432,222,156,378,30,408,728,56.04%,30.49%,1
臺南市,官田區,0433,253,165,418,23,441,842,52.38%,30.05%,1
臺南市,官田區,0434,147,102,249,31,280,515,54.37%,28.54%,1
臺南市,官田區,0435,236,115,351,31,382,873,43.76%,27.03%,1
臺南市,大內區,0436,180,131,311,22,333,759,43.87%,23.72%,1
臺南市,大內區,0437,46,38,84,4,88,262,33.59%,17.56%,1
臺南市,大內區,0438,165,87,252,15,267,646,41.33%,25.54%,1
臺南市,大內區,0439,358,208,566,44,610,1473,41.41%,24.3%,1
臺南市,大內區,0440,291,151,442,60,502,915,54.86%,31.8%,1
臺南市,大內區,0441,245,152,397,44,441,779,56.61%,31.45%,1
臺南市,大內區,0442,197,155,352,41,393,637,61.7%,30.93%,1
臺南市,大內區,0443,287,169,456,32,488,993,49.14%,28.9%,1
臺南市,大內區,0444,237,145,382,35,417,766,54.44%,30.94%,1
臺南市,大內區,0445,276,139,415,28,443,841,52.68%,32.82%,1
臺南市,大內區,0446,190,74,264,28,292,583,50.09%,32.59%,1
臺南市,佳里區,0282,459,284,743,39,782,1391,56.22%,33%,1
臺南市,佳里區,0283,311,167,478,17,495,829,59.71%,37.52%,1
臺南市,佳里區,0284,424,216,640,45,685,1401,48.89%,30.26%,1
臺南市,佳里區,0285,400,246,646,21,667,1452,45.94%,27.55%,1
臺南市,佳里區,0286,446,258,704,48,752,1382,54.41%,32.27%,1
臺南市,佳里區,0287,448,267,715,65,780,1463,53.32%,30.62%,1
臺南市,佳里區,0288,416,201,617,29,646,1280,50.47%,32.5%,1
臺南市,佳里區,0289,468,305,773,57,830,1486,55.85%,31.49%,1
臺南市,佳里區,0290,454,267,721,50,771,1378,55.95%,32.95%,1
臺南市,佳里區,0291,518,273,791,48,839,1505,55.75%,34.42%,1
臺南市,佳里區,0292,583,344,927,49,976,1860,52.47%,31.34%,1
臺南市,佳里區,0293,376,202,578,55,633,1134,55.82%,33.16%,1
臺南市,佳里區,0294,462,273,735,28,763,1426,53.51%,32.4%,1
臺南市,佳里區,0295,536,365,901,48,949,1779,53.34%,30.13%,1
臺南市,佳里區,0296,614,390,1004,36,1040,1906,54.56%,32.21%,1
臺南市,佳里區,0297,414,284,698,26,724,1425,50.81%,29.05%,1
臺南市,佳里區,0298,380,248,628,31,659,1255,52.51%,30.28%,1
臺南市,佳里區,0299,444,261,705,56,761,1524,49.93%,29.13%,1
臺南市,佳里區,0300,496,312,808,31,839,1631,51.44%,30.41%,1
臺南市,佳里區,0301,517,327,844,26,870,1546,56.27%,33.44%,1
臺南市,佳里區,0302,417,265,682,30,712,1187,59.98%,35.13%,1
臺南市,佳里區,0303,415,286,701,34,735,1381,53.22%,30.05%,1
臺南市,佳里區,0304,418,249,667,19,686,1364,50.29%,30.65%,1
臺南市,佳里區,0305,419,261,680,25,705,1314,53.65%,31.89%,1
臺南市,佳里區,0306,378,238,616,36,652,1164,56.01%,32.47%,1
臺南市,佳里區,0307,326,158,484,34,518,961,53.9%,33.92%,1
臺南市,佳里區,0308,383,222,605,36,641,1218,52.63%,31.44%,1
臺南市,佳里區,0309,394,101,495,17,512,919,55.71%,42.87%,1
臺南市,佳里區,0310,210,121,331,35,366,689,53.12%,30.48%,1
臺南市,佳里區,0311,109,61,170,15,185,383,48.3%,28.46%,1
臺南市,佳里區,0312,454,231,685,40,725,1507,48.11%,30.13%,1
臺南市,佳里區,0313,202,123,325,21,346,702,49.29%,28.77%,1
臺南市,佳里區,0314,315,155,470,41,511,907,56.34%,34.73%,1
臺南市,佳里區,0315,317,200,517,41,558,937,59.55%,33.83%,1
臺南市,佳里區,0316,286,201,487,74,561,1030,54.47%,27.77%,1
臺南市,佳里區,0317,292,188,480,38,518,981,52.8%,29.77%,1
臺南市,佳里區,0318,251,123,374,18,392,787,49.81%,31.89%,1
臺南市,佳里區,0319,473,257,730,54,784,1513,51.82%,31.26%,1
臺南市,佳里區,0320,193,112,305,22,327,714,45.8%,27.03%,1
臺南市,佳里區,0321,214,128,342,32,374,745,50.2%,28.72%,1
臺南市,佳里區,0322,259,176,435,30,465,951,48.9%,27.23%,1
臺南市,學甲區,0208,273,189,462,31,493,862,57.19%,31.67%,1
臺南市,學甲區,0209,223,127,350,4,354,611,57.94%,36.5%,1
臺南市,學甲區,0210,297,170,467,18,485,936,51.82%,31.73%,1
臺南市,學甲區,0211,306,186,492,30,522,1066,48.97%,28.71%,1
臺南市,學甲區,0212,290,178,468,18,486,869,55.93%,33.37%,1
臺南市,學甲區,0213,198,123,321,17,338,635,53.23%,31.18%,1
臺南市,學甲區,0214,237,129,366,20,386,822,46.96%,28.83%,1
臺南市,學甲區,0215,117,68,185,13,198,443,44.7%,26.41%,1
臺南市,學甲區,0216,413,269,682,26,708,1370,51.68%,30.15%,1
臺南市,學甲區,0217,354,225,579,35,614,1117,54.97%,31.69%,1
臺南市,學甲區,0218,375,265,640,46,686,1365,50.26%,27.47%,1
臺南市,學甲區,0219,419,257,676,38,714,1489,47.95%,28.14%,1
臺南市,學甲區,0220,145,94,239,30,269,627,42.9%,23.13%,1
臺南市,學甲區,0221,304,206,510,24,534,1052,50.76%,28.9%,1
臺南市,學甲區,0222,338,221,559,19,578,1183,48.86%,28.57%,1
臺南市,學甲區,0223,259,149,408,18,426,979,43.51%,26.46%,1
臺南市,學甲區,0224,276,245,521,39,560,1241,45.12%,22.24%,1
臺南市,學甲區,0225,207,115,322,17,339,843,40.21%,24.56%,1
臺南市,學甲區,0226,161,99,260,25,285,580,49.14%,27.76%,1
臺南市,學甲區,0227,213,100,313,15,328,832,39.42%,25.6%,1
臺南市,學甲區,0228,85,61,146,8,154,406,37.93%,20.94%,1
臺南市,學甲區,0229,243,157,400,27,427,818,52.2%,29.71%,1
臺南市,學甲區,0230,246,163,409,11,420,1052,39.92%,23.38%,1
臺南市,學甲區,0231,143,99,242,15,257,578,44.46%,24.74%,1
臺南市,學甲區,0232,123,48,171,11,182,430,42.33%,28.6%,1
臺南市,學甲區,0233,117,52,169,10,179,361,49.58%,32.41%,1
臺南市,西港區,0323,287,167,454,22,476,933,51.02%,30.76%,1
臺南市,西港區,0324,249,199,448,24,472,901,52.39%,27.64%,1
臺南市,西港區,0325,364,247,611,25,636,1314,48.4%,27.7%,1
臺南市,西港區,0326,398,246,644,54,698,1349,51.74%,29.5%,1
臺南市,西港區,0327,340,189,529,38,567,1014,55.92%,33.53%,1
臺南市,西港區,0328,448,300,748,30,778,1900,40.95%,23.58%,1
臺南市,西港區,0329,431,278,709,48,757,1663,45.52%,25.92%,1
臺南市,西港區,0330,189,127,316,9,325,738,44.04%,25.61%,1
臺南市,西港區,0331,362,251,613,39,652,1211,53.84%,29.89%,1
臺南市,西港區,0332,119,57,176,15,191,382,50%,31.15%,1
臺南市,西港區,0333,240,126,366,22,388,786,49.36%,30.53%,1
臺南市,西港區,0334,253,136,389,16,405,838,48.33%,30.19%,1
臺南市,西港區,0335,341,255,596,33,629,1449,43.41%,23.53%,1
臺南市,西港區,0336,361,237,598,30,628,1479,42.46%,24.41%,1
臺南市,西港區,0337,249,141,390,42,432,763,56.62%,32.63%,1
臺南市,西港區,0338,336,221,557,29,586,1297,45.18%,25.91%,1
臺南市,西港區,0339,403,229,632,47,679,1393,48.74%,28.93%,1
臺南市,西港區,0340,243,138,381,22,403,958,42.07%,25.37%,1
臺南市,西港區,0341,119,87,206,17,223,391,57.03%,30.43%,1
臺南市,西港區,0342,235,160,395,28,423,805,52.55%,29.19%,1
臺南市,七股區,0258,160,90,250,9,259,534,48.5%,29.96%,1
臺南市,七股區,0259,200,84,284,14,298,508,58.66%,39.37%,1
臺南市,七股區,0260,179,81,260,11,271,665,40.75%,26.92%,1
臺南市,七股區,0261,250,123,373,16,389,834,46.64%,29.98%,1
臺南市,七股區,0262,280,111,391,12,403,810,49.75%,34.57%,1
臺南市,七股區,0263,146,48,194,12,206,480,42.92%,30.42%,1
臺南市,七股區,0264,117,61,178,6,184,445,41.35%,26.29%,1
臺南市,七股區,0265,141,72,213,7,220,680,32.35%,20.74%,1
臺南市,七股區,0266,254,117,371,12,383,838,45.7%,30.31%,1
臺南市,七股區,0267,230,95,325,16,341,780,43.72%,29.49%,1
臺南市,七股區,0268,112,74,186,13,199,350,56.86%,32%,1
臺南市,七股區,0269,301,185,486,43,529,907,58.32%,33.19%,1
臺南市,七股區,0270,218,116,334,23,357,780,45.77%,27.95%,1
臺南市,七股區,0271,448,270,718,42,760,1658,45.84%,27.02%,1
臺南市,七股區,0272,330,123,453,21,474,913,51.92%,36.14%,1
臺南市,七股區,0273,344,207,551,55,606,1202,50.42%,28.62%,1
臺南市,七股區,0274,175,101,276,7,283,696,40.66%,25.14%,1
臺南市,七股區,0275,182,126,308,26,334,647,51.62%,28.13%,1
臺南市,七股區,0276,251,110,361,29,390,622,62.7%,40.35%,1
臺南市,七股區,0277,426,210,636,50,686,1175,58.38%,36.26%,1
臺南市,七股區,0278,174,145,319,16,335,698,47.99%,24.93%,1
臺南市,七股區,0279,327,157,484,31,515,983,52.39%,33.27%,1
臺南市,七股區,0280,441,164,605,27,632,1366,46.27%,32.28%,1
臺南市,七股區,0281,348,232,580,31,611,1379,44.31%,25.24%,1
臺南市,將軍區,0234,394,216,610,39,649,1110,58.47%,35.5%,1
臺南市,將軍區,0235,462,230,692,22,714,1418,50.35%,32.58%,1
臺南市,將軍區,0236,341,153,494,19,513,969,52.94%,35.19%,1
臺南市,將軍區,0237,195,98,293,23,316,519,60.89%,37.57%,1
臺南市,將軍區,0238,361,183,544,18,562,1106,50.81%,32.64%,1
臺南市,將軍區,0239,141,114,255,19,274,542,50.55%,26.01%,1
臺南市,將軍區,0240,82,49,131,5,136,315,43.17%,26.03%,1
臺南市,將軍區,0241,142,91,233,18,251,584,42.98%,24.32%,1
臺南市,將軍區,0242,111,66,177,8,185,398,46.48%,27.89%,1
臺南市,將軍區,0243,153,98,251,17,268,608,44.08%,25.16%,1
臺南市,將軍區,0244,128,86,214,17,231,442,52.26%,28.96%,1
臺南市,將軍區,0245,156,100,256,7,263,650,40.46%,24%,1
臺南市,將軍區,0246,146,64,210,14,224,573,39.09%,25.48%,1
臺南市,將軍區,0247,197,77,274,7,281,617,45.54%,31.93%,1
臺南市,將軍區,0248,186,89,275,20,295,573,51.48%,32.46%,1
臺南市,將軍區,0249,148,62,210,13,223,434,51.38%,34.1%,1
臺南市,將軍區,0250,242,115,357,13,370,849,43.58%,28.5%,1
臺南市,將軍區,0251,176,76,252,15,267,645,41.4%,27.29%,1
臺南市,將軍區,0252,212,84,296,20,316,690,45.8%,30.72%,1
臺南市,將軍區,0253,168,14,182,13,195,663,29.41%,25.34%,1
臺南市,將軍區,0254,379,155,534,28,562,1175,47.83%,32.26%,1
臺南市,將軍區,0255,225,100,325,18,343,837,40.98%,26.88%,1
臺南市,將軍區,0256,62,166,228,328,556,1061,52.4%,5.84%,1
臺南市,將軍區,0257,283,122,405,14,419,976,42.93%,29%,1
臺南市,北門區,0190,141,93,234,10,244,484,50.41%,29.13%,1
臺南市,北門區,0191,94,61,155,11,166,401,41.4%,23.44%,1
臺南市,北門區,0192,142,55,197,4,201,456,44.08%,31.14%,1
臺南市,北門區,0193,122,83,205,9,214,382,56.02%,31.94%,1
臺南市,北門區,0194,121,49,170,14,184,356,51.69%,33.99%,1
臺南市,北門區,0195,112,49,161,6,167,389,42.93%,28.79%,1
臺南市,北門區,0196,210,97,307,13,320,742,43.13%,28.3%,1
臺南市,北門區,0197,180,86,266,8,274,599,45.74%,30.05%,1
臺南市,北門區,0198,155,76,231,19,250,594,42.09%,26.09%,1
臺南市,北門區,0199,145,90,235,13,248,572,43.36%,25.35%,1
臺南市,北門區,0200,62,47,109,4,113,318,35.53%,19.5%,1
臺南市,北門區,0201,90,79,169,10,179,473,37.84%,19.03%,1
臺南市,北門區,0202,214,126,340,14,354,954,37.11%,22.43%,1
臺南市,北門區,0203,233,138,371,30,401,737,54.41%,31.61%,1
臺南市,北門區,0204,148,73,221,15,236,679,34.76%,21.8%,1
臺南市,北門區,0205,112,69,181,24,205,521,39.35%,21.5%,1
臺南市,北門區,0206,152,74,226,18,244,632,38.61%,24.05%,1
臺南市,北門區,0207,159,92,251,7,258,636,40.57%,25%,1
臺南市,新化區,0581,276,154,430,25,455,746,60.99%,37%,1
臺南市,新化區,0582,395,222,617,37,654,1102,59.35%,35.84%,1
臺南市,新化區,0583,133,71,204,15,219,370,59.19%,35.95%,1
臺南市,新化區,0584,333,201,534,33,567,947,59.87%,35.16%,1
臺南市,新化區,0585,380,182,562,48,610,1154,52.86%,32.93%,1
臺南市,新化區,0586,323,221,544,63,607,1082,56.1%,29.85%,1
臺南市,新化區,0587,367,209,576,35,611,1075,56.84%,34.14%,1
臺南市,新化區,0588,213,110,323,18,341,640,53.28%,33.28%,1
臺南市,新化區,0589,130,77,207,14,221,410,53.9%,31.71%,1
臺南市,新化區,0590,175,87,262,20,282,533,52.91%,32.83%,1
臺南市,新化區,0591,297,175,472,16,488,836,58.37%,35.53%,1
臺南市,新化區,0592,257,145,402,21,423,978,43.25%,26.28%,1
臺南市,新化區,0593,446,291,737,31,768,1348,56.97%,33.09%,1
臺南市,新化區,0594,300,203,503,35,538,1015,53%,29.56%,1
臺南市,新化區,0595,381,199,580,19,599,1228,48.78%,31.03%,1
臺南市,新化區,0596,244,173,417,38,455,789,57.67%,30.93%,1
臺南市,新化區,0597,326,197,523,28,551,1022,53.91%,31.9%,1
臺南市,新化區,0598,360,156,516,25,541,1021,52.99%,35.26%,1
臺南市,新化區,0599,423,252,675,37,712,1229,57.93%,34.42%,1
臺南市,新化區,0600,354,222,576,27,603,1153,52.3%,30.7%,1
臺南市,新化區,0601,271,157,428,26,454,1012,44.86%,26.78%,1
臺南市,新化區,0602,481,281,762,48,810,1458,55.56%,32.99%,1
臺南市,新化區,0603,589,290,879,47,926,1645,56.29%,35.81%,1
臺南市,新化區,0604,323,233,556,37,593,1016,58.37%,31.79%,1
臺南市,新化區,0605,161,119,280,19,299,559,53.49%,28.8%,1
臺南市,新化區,0606,384,262,646,37,683,1222,55.89%,31.42%,1
臺南市,新化區,0607,537,347,884,38,922,1562,59.03%,34.38%,1
臺南市,新化區,0608,243,203,446,32,478,994,48.09%,24.45%,1
臺南市,新化區,0609,327,173,500,61,561,1013,55.38%,32.28%,1
臺南市,新化區,0610,403,233,636,46,682,1197,56.98%,33.67%,1
臺南市,新化區,0611,293,165,458,60,518,1021,50.73%,28.7%,1
臺南市,新化區,0612,412,206,618,39,657,1428,46.01%,28.85%,1
臺南市,新化區,0613,120,71,191,27,218,456,47.81%,26.32%,1
臺南市,新化區,0614,351,200,551,45,596,1037,57.47%,33.85%,1
臺南市,新化區,0615,306,266,572,46,618,1097,56.34%,27.89%,1
臺南市,新化區,0616,297,174,471,32,503,902,55.76%,32.93%,1
臺南市,新化區,0617,273,163,436,79,515,999,51.55%,27.33%,1
臺南市,善化區,0492,338,189,527,13,540,1132,47.7%,29.86%,1
臺南市,善化區,0493,531,340,871,49,920,1845,49.86%,28.78%,1
臺南市,善化區,0494,625,369,994,58,1052,2090,50.33%,29.9%,1
臺南市,善化區,0495,549,287,836,43,879,1582,55.56%,34.7%,1
臺南市,善化區,0496,601,406,1007,49,1056,1901,55.55%,31.61%,1
臺南市,善化區,0497,571,353,924,36,960,1818,52.81%,31.41%,1
臺南市,善化區,0498,519,281,800,58,858,1639,52.35%,31.67%,1
臺南市,善化區,0499,339,227,566,31,597,1061,56.27%,31.95%,1
臺南市,善化區,0500,618,340,958,53,1011,1786,56.61%,34.6%,1
臺南市,善化區,0501,399,192,591,35,626,1147,54.58%,34.79%,1
臺南市,善化區,0502,481,266,747,40,787,1581,49.78%,30.42%,1
臺南市,善化區,0503,367,249,616,53,669,1240,53.95%,29.6%,1
臺南市,善化區,0504,520,279,799,33,832,1743,47.73%,29.83%,1
臺南市,善化區,0505,422,263,685,34,719,1246,57.7%,33.87%,1
臺南市,善化區,0506,290,192,482,19,501,961,52.13%,30.18%,1
臺南市,善化區,0507,289,157,446,8,454,938,48.4%,30.81%,1
臺南市,善化區,0508,254,133,387,15,402,722,55.68%,35.18%,1
臺南市,善化區,0509,339,170,509,28,537,1062,50.56%,31.92%,1
臺南市,善化區,0510,513,312,825,55,880,1715,51.31%,29.91%,1
臺南市,善化區,0511,313,183,496,60,556,1120,49.64%,27.95%,1
臺南市,善化區,0512,270,147,417,23,440,865,50.87%,31.21%,1
臺南市,善化區,0513,429,344,773,45,818,1574,51.97%,27.26%,1
臺南市,善化區,0514,401,249,650,50,700,1535,45.6%,26.12%,1
臺南市,善化區,0515,306,226,532,57,589,1106,53.25%,27.67%,1
臺南市,善化區,0516,452,237,689,35,724,1402,51.64%,32.24%,1
臺南市,善化區,0517,501,323,824,52,876,1458,60.08%,34.36%,1
臺南市,善化區,0518,356,260,616,32,648,1380,46.96%,25.8%,1
臺南市,善化區,0519,373,260,633,10,643,1232,52.19%,30.28%,1
臺南市,善化區,0520,318,249,567,15,582,1069,54.44%,29.75%,1
臺南市,新市區,0545,294,169,463,21,484,960,50.42%,30.63%,1
臺南市,新市區,0546,383,250,633,27,660,1118,59.03%,34.26%,1
臺南市,新市區,0547,269,136,405,12,417,850,49.06%,31.65%,1
臺南市,新市區,0548,378,254,632,29,661,1241,53.26%,30.46%,1
臺南市,新市區,0549,418,262,680,26,706,1297,54.43%,32.23%,1
臺南市,新市區,0550,328,191,519,26,545,962,56.65%,34.1%,1
臺南市,新市區,0551,425,249,674,27,701,1237,56.67%,34.36%,1
臺南市,新市區,0552,412,271,683,36,719,1326,54.22%,31.07%,1
臺南市,新市區,0553,412,251,663,38,701,1211,57.89%,34.02%,1
臺南市,新市區,0554,404,236,640,30,670,1305,51.34%,30.96%,1
臺南市,新市區,0555,242,110,352,25,377,688,54.8%,35.17%,1
臺南市,新市區,0556,312,176,488,29,517,911,56.75%,34.25%,1
臺南市,新市區,0557,445,261,706,37,743,1525,48.72%,29.18%,1
臺南市,新市區,0558,315,158,473,8,481,1091,44.09%,28.87%,1
臺南市,新市區,0559,353,196,549,19,568,1122,50.62%,31.46%,1
臺南市,新市區,0560,317,189,506,27,533,1049,50.81%,30.22%,1
臺南市,新市區,0561,453,270,723,20,743,1564,47.51%,28.96%,1
臺南市,新市區,0562,364,414,778,34,812,1515,53.6%,24.03%,1
臺南市,新市區,0563,446,256,702,32,734,1378,53.27%,32.37%,1
臺南市,新市區,0564,313,166,479,38,517,827,62.52%,37.85%,1
臺南市,新市區,0565,367,197,564,53,617,960,64.27%,38.23%,1
臺南市,新市區,0566,306,166,472,29,501,951,52.68%,32.18%,1
臺南市,新市區,0567,312,349,661,35,696,1264,55.06%,24.68%,1
臺南市,新市區,0568,381,234,615,25,640,1173,54.56%,32.48%,1
臺南市,新市區,0569,230,152,382,17,399,684,58.33%,33.63%,1
臺南市,新市區,0570,403,219,622,31,653,1055,61.9%,38.2%,1
臺南市,新市區,0571,401,263,664,30,694,1122,61.85%,35.74%,1
臺南市,安定區,0521,474,242,716,63,779,1251,62.27%,37.89%,1
臺南市,安定區,0522,307,170,477,32,509,899,56.62%,34.15%,1
臺南市,安定區,0523,374,193,567,45,612,1106,55.33%,33.82%,1
臺南市,安定區,0524,351,159,510,24,534,948,56.33%,37.03%,1
臺南市,安定區,0525,417,266,683,38,721,1442,50%,28.92%,1
臺南市,安定區,0526,436,238,674,53,727,1385,52.49%,31.48%,1
臺南市,安定區,0527,303,134,437,22,459,801,57.3%,37.83%,1
臺南市,安定區,0528,195,133,328,17,345,736,46.88%,26.49%,1
臺南市,安定區,0529,232,147,379,29,408,781,52.24%,29.71%,1
臺南市,安定區,0530,254,170,424,20,444,795,55.85%,31.95%,1
臺南市,安定區,0531,308,171,479,31,510,862,59.16%,35.73%,1
臺南市,安定區,0532,445,266,711,30,741,1487,49.83%,29.93%,1
臺南市,安定區,0533,457,241,698,29,727,1385,52.49%,33%,1
臺南市,安定區,0534,454,273,727,22,749,1518,49.34%,29.91%,1
臺南市,安定區,0535,397,215,612,35,647,1094,59.14%,36.29%,1
臺南市,安定區,0536,541,290,831,58,889,1590,55.91%,34.03%,1
臺南市,安定區,0537,269,145,414,16,430,754,57.03%,35.68%,1
臺南市,安定區,0538,228,154,382,29,411,716,57.4%,31.84%,1
臺南市,安定區,0539,485,299,784,32,816,1492,54.69%,32.51%,1
臺南市,安定區,0540,314,189,503,24,527,943,55.89%,33.3%,1
臺南市,安定區,0541,379,237,616,29,645,1157,55.75%,32.76%,1
臺南市,安定區,0542,450,274,724,46,770,1384,55.64%,32.51%,1
臺南市,安定區,0543,281,222,503,31,534,967,55.22%,29.06%,1
臺南市,安定區,0544,207,137,344,14,358,611,58.59%,33.88%,1
臺南市,山上區,0572,207,121,328,38,366,855,42.81%,24.21%,1
臺南市,山上區,0573,178,130,308,35,343,836,41.03%,21.29%,1
臺南市,山上區,0574,206,143,349,33,382,753,50.73%,27.36%,1
臺南市,山上區,0575,236,118,354,26,380,788,48.22%,29.95%,1
臺南市,山上區,0576,286,174,460,37,497,984,50.51%,29.07%,1
臺南市,山上區,0577,246,188,434,12,446,972,45.88%,25.31%,1
臺南市,山上區,0578,112,64,176,5,181,553,32.73%,20.25%,1
臺南市,山上區,0579,97,56,153,11,164,378,43.39%,25.66%,1
臺南市,山上區,0580,109,59,168,20,188,392,47.96%,27.81%,1
臺南市,玉井區,0466,363,212,575,45,620,1242,49.92%,29.23%,1
臺南市,玉井區,0467,374,196,570,40,610,1141,53.46%,32.78%,1
臺南市,玉井區,0468,213,110,323,26,349,698,50%,30.52%,1
臺南市,玉井區,0469,259,146,405,33,438,849,51.59%,30.51%,1
臺南市,玉井區,0470,308,159,467,45,512,949,53.95%,32.46%,1
臺南市,玉井區,0471,184,108,292,26,318,618,51.46%,29.77%,1
臺南市,玉井區,0472,166,88,254,14,268,594,45.12%,27.95%,1
臺南市,玉井區,0473,232,142,374,32,406,927,43.8%,25.03%,1
臺南市,玉井區,0474,158,86,244,30,274,512,53.52%,30.86%,1
臺南市,玉井區,0475,134,89,223,22,245,509,48.13%,26.33%,1
臺南市,玉井區,0476,155,100,255,29,284,496,57.26%,31.25%,1
臺南市,玉井區,0477,212,130,342,24,366,759,48.22%,27.93%,1
臺南市,玉井區,0478,154,98,252,17,269,669,40.21%,23.02%,1
臺南市,玉井區,0479,210,130,340,52,392,787,49.81%,26.68%,1
臺南市,玉井區,0480,189,85,274,32,306,620,49.35%,30.48%,1
臺南市,玉井區,0481,272,183,455,49,504,987,51.06%,27.56%,1
臺南市,楠西區,0447,277,149,426,50,476,978,48.67%,28.32%,1
臺南市,楠西區,0448,264,172,436,39,475,870,54.6%,30.34%,1
臺南市,楠西區,0449,242,147,389,19,408,1160,35.17%,20.86%,1
臺南市,楠西區,0450,188,107,295,17,312,699,44.64%,26.9%,1
臺南市,楠西區,0451,253,126,379,20,399,990,40.3%,25.56%,1
臺南市,楠西區,0452,258,133,391,34,425,928,45.8%,27.8%,1
臺南市,楠西區,0453,200,105,305,33,338,660,51.21%,30.3%,1
臺南市,楠西區,0454,311,210,521,67,588,1187,49.54%,26.2%,1
臺南市,楠西區,0455,265,199,464,34,498,1056,47.16%,25.09%,1
臺南市,南化區,0456,182,144,326,47,373,690,54.06%,26.38%,1
臺南市,南化區,0457,192,158,350,37,387,695,55.68%,27.63%,1
臺南市,南化區,0458,181,146,327,38,365,806,45.29%,22.46%,1
臺南市,南化區,0459,142,104,246,27,273,654,41.74%,21.71%,1
臺南市,南化區,0460,150,99,249,36,285,783,36.4%,19.16%,1
臺南市,南化區,0461,129,68,197,11,208,425,48.94%,30.35%,1
臺南市,南化區,0462,152,99,251,25,276,559,49.37%,27.19%,1
臺南市,南化區,0463,306,196,502,32,534,1189,44.91%,25.74%,1
臺南市,南化區,0464,340,188,528,27,555,1044,53.16%,32.57%,1
臺南市,南化區,0465,302,158,460,31,491,941,52.18%,32.09%,1
臺南市,左鎮區,0482,114,65,179,13,192,392,48.98%,29.08%,1
臺南市,左鎮區,0483,241,82,323,22,345,644,53.57%,37.42%,1
臺南市,左鎮區,0484,122,70,192,8,200,468,42.74%,26.07%,1
臺南市,左鎮區,0485,206,109,315,18,333,753,44.22%,27.36%,1
臺南市,左鎮區,0486,94,59,153,9,162,345,46.96%,27.25%,1
臺南市,左鎮區,0487,106,59,165,11,176,393,44.78%,26.97%,1
臺南市,左鎮區,0488,149,71,220,8,228,420,54.29%,35.48%,1
臺南市,左鎮區,0489,71,46,117,12,129,313,41.21%,22.68%,1
臺南市,左鎮區,0490,47,26,73,4,77,186,41.4%,25.27%,1
臺南市,左鎮區,0491,144,64,208,23,231,504,45.83%,28.57%,1
臺南市,仁德區,1188,421,268,689,40,729,1318,55.31%,31.94%,1
臺南市,仁德區,1189,460,259,719,50,769,1406,54.69%,32.72%,1
臺南市,仁德區,1190,475,253,728,43,771,1465,52.63%,32.42%,1
臺南市,仁德區,1191,418,262,680,41,721,1192,60.49%,35.07%,1
臺南市,仁德區,1192,486,291,777,50,827,1429,57.87%,34.01%,1
臺南市,仁德區,1193,380,261,641,85,726,1320,55%,28.79%,1
臺南市,仁德區,1194,511,279,790,47,837,1373,60.96%,37.22%,1
臺南市,仁德區,1195,465,269,734,37,771,1330,57.97%,34.96%,1
臺南市,仁德區,1196,593,322,915,35,950,1687,56.31%,35.15%,1
臺南市,仁德區,1197,436,276,712,48,760,1491,50.97%,29.24%,1
臺南市,仁德區,1198,320,199,519,28,547,1151,47.52%,27.8%,1
臺南市,仁德區,1199,475,245,720,15,735,1407,52.24%,33.76%,1
臺南市,仁德區,1200,540,265,805,31,836,1465,57.06%,36.86%,1
臺南市,仁德區,1201,445,280,725,32,757,1335,56.7%,33.33%,1
臺南市,仁德區,1202,466,277,743,44,787,1490,52.82%,31.28%,1
臺南市,仁德區,1203,532,283,815,41,856,1453,58.91%,36.61%,1
臺南市,仁德區,1204,319,185,504,28,532,990,53.74%,32.22%,1
臺南市,仁德區,1205,534,317,851,37,888,1573,56.45%,33.95%,1
臺南市,仁德區,1206,331,210,541,27,568,1031,55.09%,32.1%,1
臺南市,仁德區,1207,362,255,617,27,644,1194,53.94%,30.32%,1
臺南市,仁德區,1208,397,222,619,43,662,1268,52.21%,31.31%,1
臺南市,仁德區,1209,296,206,502,29,531,929,57.16%,31.86%,1
臺南市,仁德區,1210,363,198,561,9,570,1145,49.78%,31.7%,1
臺南市,仁德區,1211,455,257,712,32,744,1413,52.65%,32.2%,1
臺南市,仁德區,1212,481,256,737,51,788,1465,53.79%,32.83%,1
臺南市,仁德區,1213,465,294,759,39,798,1390,57.41%,33.45%,1
臺南市,仁德區,1214,439,278,717,50,767,1396,54.94%,31.45%,1
臺南市,仁德區,1215,581,383,964,34,998,1906,52.36%,30.48%,1
臺南市,仁德區,1216,480,267,747,28,775,1546,50.13%,31.05%,1
臺南市,仁德區,1217,417,269,686,25,711,1546,45.99%,26.97%,1
臺南市,仁德區,1218,482,295,777,34,811,1399,57.97%,34.45%,1
臺南市,仁德區,1219,564,316,880,52,932,1748,53.32%,32.27%,1
臺南市,仁德區,1220,408,210,618,27,645,1140,56.58%,35.79%,1
臺南市,仁德區,1221,431,236,667,22,689,1277,53.95%,33.75%,1
臺南市,仁德區,1222,399,223,622,32,654,1019,64.18%,39.16%,1
臺南市,仁德區,1223,476,249,725,22,747,1414,52.83%,33.66%,1
臺南市,仁德區,1224,420,231,651,14,665,1349,49.3%,31.13%,1
臺南市,仁德區,1225,500,230,730,28,758,1471,51.53%,33.99%,1
臺南市,仁德區,1226,443,260,703,17,720,1324,54.38%,33.46%,1
臺南市,仁德區,1227,424,189,613,36,649,1310,49.54%,32.37%,1
臺南市,仁德區,1228,189,111,300,14,314,554,56.68%,34.12%,1
臺南市,仁德區,1229,491,216,707,43,750,1395,53.76%,35.2%,1
臺南市,仁德區,1230,442,198,640,20,660,1264,52.22%,34.97%,1
臺南市,仁德區,1231,422,201,623,36,659,1180,55.85%,35.76%,1
臺南市,仁德區,1232,280,169,449,25,474,928,51.08%,30.17%,1
臺南市,仁德區,1233,304,167,471,22,493,965,51.09%,31.5%,1
臺南市,仁德區,1234,387,185,572,26,598,1119,53.44%,34.58%,1
臺南市,仁德區,1235,404,218,622,38,660,1206,54.73%,33.5%,1
臺南市,仁德區,1236,475,251,726,35,761,1466,51.91%,32.4%,1
臺南市,歸仁區,1237,485,287,772,43,815,1560,52.24%,31.09%,1
臺南市,歸仁區,1238,516,308,824,20,844,1383,61.03%,37.31%,1
臺南市,歸仁區,1239,478,305,783,23,806,1491,54.06%,32.06%,1
臺南市,歸仁區,1240,455,274,729,32,761,1482,51.35%,30.7%,1
臺南市,歸仁區,1241,447,280,727,25,752,1330,56.54%,33.61%,1
臺南市,歸仁區,1242,447,309,756,33,789,1399,56.4%,31.95%,1
臺南市,歸仁區,1243,434,263,697,39,736,1416,51.98%,30.65%,1
臺南市,歸仁區,1244,334,228,562,33,595,1336,44.54%,25%,1
臺南市,歸仁區,1245,376,178,554,43,597,1183,50.46%,31.78%,1
臺南市,歸仁區,1246,387,223,610,28,638,1237,51.58%,31.29%,1
臺南市,歸仁區,1247,365,233,598,37,635,1133,56.05%,32.22%,1
臺南市,歸仁區,1248,334,232,566,35,601,1149,52.31%,29.07%,1
臺南市,歸仁區,1249,371,212,583,10,593,1105,53.67%,33.57%,1
臺南市,歸仁區,1250,349,230,579,32,611,1099,55.6%,31.76%,1
臺南市,歸仁區,1251,373,219,592,44,636,1082,58.78%,34.47%,1
臺南市,歸仁區,1252,573,275,848,28,876,1519,57.67%,37.72%,1
臺南市,歸仁區,1253,527,286,813,29,842,1467,57.4%,35.92%,1
臺南市,歸仁區,1254,332,213,545,33,578,1090,53.03%,30.46%,1
臺南市,歸仁區,1255,362,218,580,16,596,1131,52.7%,32.01%,1
臺南市,歸仁區,1256,358,208,566,23,589,1080,54.54%,33.15%,1
臺南市,歸仁區,1257,348,176,524,22,546,1121,48.71%,31.04%,1
臺南市,歸仁區,1258,403,267,670,58,728,1336,54.49%,30.16%,1
臺南市,歸仁區,1259,335,233,568,49,617,1128,54.7%,29.7%,1
臺南市,歸仁區,1260,352,196,548,18,566,1055,53.65%,33.36%,1
臺南市,歸仁區,1261,367,200,567,27,594,1102,53.9%,33.3%,1
臺南市,歸仁區,1262,370,229,599,29,628,1068,58.8%,34.64%,1
臺南市,歸仁區,1263,357,205,562,38,600,1033,58.08%,34.56%,1
臺南市,歸仁區,1264,438,289,727,19,746,1772,42.1%,24.72%,1
臺南市,歸仁區,1265,454,284,738,43,781,1399,55.83%,32.45%,1
臺南市,歸仁區,1266,520,285,805,20,825,1544,53.43%,33.68%,1
臺南市,歸仁區,1267,191,109,300,12,312,684,45.61%,27.92%,1
臺南市,歸仁區,1268,297,180,477,26,503,839,59.95%,35.4%,1
臺南市,歸仁區,1269,358,214,572,36,608,1014,59.96%,35.31%,1
臺南市,歸仁區,1270,438,252,690,19,709,1906,37.2%,22.98%,1
臺南市,歸仁區,1271,420,266,686,32,718,1245,57.67%,33.73%,1
臺南市,歸仁區,1272,367,171,538,22,560,1048,53.44%,35.02%,1
臺南市,歸仁區,1273,387,225,612,18,630,1175,53.62%,32.94%,1
臺南市,歸仁區,1274,435,274,709,6,715,1411,50.67%,30.83%,1
臺南市,歸仁區,1275,517,308,825,33,858,1514,56.67%,34.15%,1
臺南市,歸仁區,1276,515,345,860,45,905,1678,53.93%,30.69%,1
臺南市,歸仁區,1277,294,212,506,35,541,949,57.01%,30.98%,1
臺南市,歸仁區,1278,371,196,567,48,615,1009,60.95%,36.77%,1
臺南市,歸仁區,1279,345,247,592,5,597,984,60.67%,35.06%,1
臺南市,歸仁區,1280,282,148,430,27,457,756,60.45%,37.3%,1
臺南市,歸仁區,1281,518,317,835,42,877,1478,59.34%,35.05%,1
臺南市,歸仁區,1282,481,335,816,56,872,1467,59.44%,32.79%,1
臺南市,關廟區,1283,344,175,519,15,534,982,54.38%,35.03%,1
臺南市,關廟區,1284,443,225,668,31,699,1156,60.47%,38.32%,1
臺南市,關廟區,1285,313,172,485,18,503,1006,50%,31.11%,1
臺南市,關廟區,1286,374,216,590,48,638,1043,61.17%,35.86%,1
臺南市,關廟區,1287,345,206,551,39,590,1012,58.3%,34.09%,1
臺南市,關廟區,1288,304,166,470,18,488,1013,48.17%,30.01%,1
臺南市,關廟區,1289,394,239,633,20,653,1294,50.46%,30.45%,1
臺南市,關廟區,1290,377,242,619,39,658,1264,52.06%,29.83%,1
臺南市,關廟區,1291,382,220,602,29,631,1166,54.12%,32.76%,1
臺南市,關廟區,1292,216,310,526,12,538,1018,52.85%,21.22%,1
臺南市,關廟區,1293,197,110,307,35,342,733,46.66%,26.88%,1
臺南市,關廟區,1294,383,247,630,24,654,1093,59.84%,35.04%,1
臺南市,關廟區,1295,383,215,598,19,617,1081,57.08%,35.43%,1
臺南市,關廟區,1296,314,239,553,28,581,978,59.41%,32.11%,1
臺南市,關廟區,1297,316,198,514,30,544,1116,48.75%,28.32%,1
臺南市,關廟區,1298,283,205,488,33,521,972,53.6%,29.12%,1
臺南市,關廟區,1299,327,228,555,54,609,1045,58.28%,31.29%,1
臺南市,關廟區,1300,278,180,458,28,486,872,55.73%,31.88%,1
臺南市,關廟區,1301,342,207,549,43,592,1007,58.79%,33.96%,1
臺南市,關廟區,1302,264,166,430,30,460,763,60.29%,34.6%,1
臺南市,關廟區,1303,182,120,302,32,334,630,53.02%,28.89%,1
臺南市,關廟區,1304,318,201,519,47,566,959,59.02%,33.16%,1
臺南市,關廟區,1305,380,195,575,25,600,1123,53.43%,33.84%,1
臺南市,關廟區,1306,276,142,418,50,468,804,58.21%,34.33%,1
臺南市,關廟區,1307,240,139,379,21,400,720,55.56%,33.33%,1
臺南市,關廟區,1308,255,122,377,12,389,843,46.14%,30.25%,1
臺南市,關廟區,1309,101,69,170,13,183,358,51.12%,28.21%,1
臺南市,關廟區,1310,227,148,375,56,431,797,54.08%,28.48%,1
臺南市,關廟區,1311,213,102,315,15,330,709,46.54%,30.04%,1
臺南市,關廟區,1312,306,123,429,13,442,904,48.89%,33.85%,1
臺南市,關廟區,1313,310,198,508,20,528,963,54.83%,32.19%,1
臺南市,關廟區,1314,169,114,283,11,294,489,60.12%,34.56%,1
臺南市,龍崎區,1315,316,209,525,35,560,1047,53.49%,30.18%,1
臺南市,龍崎區,1316,195,109,304,12,316,630,50.16%,30.95%,1
臺南市,龍崎區,1317,38,15,53,5,58,141,41.13%,26.95%,1
臺南市,龍崎區,1318,98,70,168,16,184,367,50.14%,26.7%,1
臺南市,龍崎區,1319,116,58,174,11,185,337,54.9%,34.42%,1
臺南市,龍崎區,1320,86,53,139,5,144,318,45.28%,27.04%,1
臺南市,龍崎區,1321,135,61,196,18,214,427,50.12%,31.62%,1
臺南市,龍崎區,1322,122,64,186,14,200,446,44.84%,27.35%,1
臺南市,永康區,0708,444,276,720,39,759,1398,54.29%,31.76%,1
臺南市,永康區,0709,409,235,644,42,686,1478,46.41%,27.67%,1
臺南市,永康區,0710,428,275,703,15,718,1442,49.79%,29.68%,1
臺南市,永康區,0711,407,235,642,27,669,1353,49.45%,30.08%,1
臺南市,永康區,0712,395,214,609,14,623,1160,53.71%,34.05%,1
臺南市,永康區,0713,374,240,614,16,630,1122,56.15%,33.33%,1
臺南市,永康區,0714,368,215,583,10,593,1165,50.9%,31.59%,1
臺南市,永康區,0715,412,237,649,11,660,1317,50.11%,31.28%,1
臺南市,永康區,0716,441,247,688,22,710,1376,51.6%,32.05%,1
臺南市,永康區,0717,419,273,692,37,729,1361,53.56%,30.79%,1
臺南市,永康區,0718,469,320,789,18,807,1374,58.73%,34.13%,1
臺南市,永康區,0719,485,313,798,37,835,1709,48.86%,28.38%,1
臺南市,永康區,0720,518,282,800,34,834,1717,48.57%,30.17%,1
臺南市,永康區,0721,519,308,827,24,851,1759,48.38%,29.51%,1
臺南市,永康區,0722,514,324,838,22,860,1636,52.57%,31.42%,1
臺南市,永康區,0723,471,253,724,33,757,1442,52.5%,32.66%,1
臺南市,永康區,0724,466,290,756,22,778,1545,50.36%,30.16%,1
臺南市,永康區,0725,522,254,776,26,802,1565,51.25%,33.35%,1
臺南市,永康區,0726,485,311,796,25,821,1684,48.75%,28.8%,1
臺南市,永康區,0727,479,275,754,19,773,1548,49.94%,30.94%,1
臺南市,永康區,0728,470,281,751,24,775,1389,55.8%,33.84%,1
臺南市,永康區,0729,447,257,704,31,735,1369,53.69%,32.65%,1
臺南市,永康區,0730,479,250,729,49,778,1415,54.98%,33.85%,1
臺南市,永康區,0731,395,236,631,11,642,1386,46.32%,28.5%,1
臺南市,永康區,0732,275,153,428,9,437,1747,25.01%,15.74%,1
臺南市,永康區,0733,455,289,744,27,771,1485,51.92%,30.64%,1
臺南市,永康區,0734,563,297,860,33,893,1747,51.12%,32.23%,1
臺南市,永康區,0735,475,304,779,29,808,1744,46.33%,27.24%,1
臺南市,永康區,0736,554,280,834,43,877,1797,48.8%,30.83%,1
臺南市,永康區,0737,617,313,930,44,974,1800,54.11%,34.28%,1
臺南市,永康區,0738,549,273,822,21,843,1720,49.01%,31.92%,1
臺南市,永康區,0739,552,345,897,24,921,1708,53.92%,32.32%,1
臺南市,永康區,0740,548,318,866,12,878,1519,57.8%,36.08%,1
臺南市,永康區,0741,522,285,807,40,847,1497,56.58%,34.87%,1
臺南市,永康區,0742,507,306,813,22,835,1509,55.33%,33.6%,1
臺南市,永康區,0743,586,299,885,32,917,1542,59.47%,38%,1
臺南市,永康區,0744,500,325,825,19,844,1536,54.95%,32.55%,1
臺南市,永康區,0745,491,303,794,29,823,1531,53.76%,32.07%,1
臺南市,永康區,0746,452,287,739,28,767,1327,57.8%,34.06%,1
臺南市,永康區,0747,450,314,764,11,775,1456,53.23%,30.91%,1
臺南市,永康區,0748,440,329,769,20,789,1396,56.52%,31.52%,1
臺南市,永康區,0749,513,296,809,40,849,1636,51.89%,31.36%,1
臺南市,永康區,0750,510,322,832,31,863,1592,54.21%,32.04%,1
臺南市,永康區,0751,532,411,943,18,961,2017,47.65%,26.38%,1
臺南市,永康區,0752,229,131,360,13,373,672,55.51%,34.08%,1
臺南市,永康區,0753,480,296,776,15,791,1611,49.1%,29.8%,1
臺南市,永康區,0754,465,303,768,31,799,1502,53.2%,30.96%,1
臺南市,永康區,0755,431,301,732,19,751,1660,45.24%,25.96%,1
臺南市,永康區,0756,406,278,684,12,696,1561,44.59%,26.01%,1
臺南市,永康區,0757,465,317,782,25,807,1590,50.75%,29.25%,1
臺南市,永康區,0758,205,275,480,14,494,924,53.46%,22.19%,1
臺南市,永康區,0759,339,194,533,16,549,938,58.53%,36.14%,1
臺南市,永康區,0760,331,188,519,29,548,957,57.26%,34.59%,1
臺南市,永康區,0761,135,113,248,30,278,496,56.05%,27.22%,1
臺南市,永康區,0762,536,336,872,39,911,1717,53.06%,31.22%,1
臺南市,永康區,0763,479,281,760,26,786,1615,48.67%,29.66%,1
臺南市,永康區,0764,500,275,775,17,792,1554,50.97%,32.18%,1
臺南市,永康區,0765,366,238,604,14,618,1196,51.67%,30.6%,1
臺南市,永康區,0766,389,256,645,20,665,1274,52.2%,30.53%,1
臺南市,永康區,0767,394,248,642,16,658,1215,54.16%,32.43%,1
臺南市,永康區,0768,452,310,762,12,774,1457,53.12%,31.02%,1
臺南市,永康區,0769,502,280,782,13,795,1451,54.79%,34.6%,1
臺南市,永康區,0770,417,246,663,28,691,1423,48.56%,29.3%,1
臺南市,永康區,0771,464,277,741,31,772,1394,55.38%,33.29%,1
臺南市,永康區,0772,291,195,486,30,516,890,57.98%,32.7%,1
臺南市,永康區,0773,391,194,585,32,617,1018,60.61%,38.41%,1
臺南市,永康區,0774,120,79,199,16,215,368,58.42%,32.61%,1
臺南市,永康區,0775,411,289,700,31,731,1208,60.51%,34.02%,1
臺南市,永康區,0776,333,238,571,20,591,1187,49.79%,28.05%,1
臺南市,永康區,0777,436,252,688,13,701,1381,50.76%,31.57%,1
臺南市,永康區,0778,424,279,703,40,743,1405,52.88%,30.18%,1
臺南市,永康區,0779,395,291,686,44,730,1445,50.52%,27.34%,1
臺南市,永康區,0780,485,330,815,36,851,1687,50.44%,28.75%,1
臺南市,永康區,0781,425,290,715,14,729,1535,47.49%,27.69%,1
臺南市,永康區,0782,482,324,806,31,837,1542,54.28%,31.26%,1
臺南市,永康區,0783,503,301,804,23,827,1618,51.11%,31.09%,1
臺南市,永康區,0784,459,273,732,17,749,1338,55.98%,34.3%,1
臺南市,永康區,0785,423,291,714,30,744,1285,57.9%,32.92%,1
臺南市,永康區,0786,381,260,641,21,662,1240,53.39%,30.73%,1
臺南市,永康區,0787,391,250,641,36,677,1343,50.41%,29.11%,1
臺南市,永康區,0788,451,293,744,22,766,1327,57.72%,33.99%,1
臺南市,永康區,0789,491,302,793,24,817,1565,52.2%,31.37%,1
臺南市,永康區,0790,459,315,774,52,826,1476,55.96%,31.1%,1
臺南市,永康區,0791,454,300,754,30,784,1476,53.12%,30.76%,1
臺南市,永康區,0792,498,323,821,28,849,1463,58.03%,34.04%,1
臺南市,永康區,0793,320,223,543,32,575,983,58.49%,32.55%,1
臺南市,永康區,0794,378,245,623,34,657,1116,58.87%,33.87%,1
臺南市,永康區,0795,360,195,555,39,594,1117,53.18%,32.23%,1
臺南市,永康區,0796,317,194,511,24,535,1069,50.05%,29.65%,1
臺南市,永康區,0797,400,277,677,23,700,1180,59.32%,33.9%,1
臺南市,永康區,0798,377,227,604,49,653,1176,55.53%,32.06%,1
臺南市,永康區,0799,337,245,582,28,610,1158,52.68%,29.1%,1
臺南市,永康區,0800,417,255,672,39,711,1208,58.86%,34.52%,1
臺南市,永康區,0801,465,298,763,47,810,1501,53.96%,30.98%,1
臺南市,永康區,0802,448,277,725,20,745,1298,57.4%,34.51%,1
臺南市,永康區,0803,269,530,799,19,818,1542,53.05%,17.44%,1
臺南市,永康區,0804,515,325,840,21,861,1537,56.02%,33.51%,1
臺南市,永康區,0805,471,319,790,37,827,1359,60.85%,34.66%,1
臺南市,永康區,0806,321,214,535,24,559,1139,49.08%,28.18%,1
臺南市,永康區,0807,345,212,557,23,580,1158,50.09%,29.79%,1
臺南市,永康區,0808,439,310,749,37,786,1538,51.11%,28.54%,1
臺南市,永康區,0809,365,221,586,13,599,1166,51.37%,31.3%,1
臺南市,永康區,0810,401,240,641,17,658,1228,53.58%,32.65%,1
臺南市,永康區,0811,409,245,654,30,684,1200,57%,34.08%,1
臺南市,永康區,0812,300,300,600,42,642,1131,56.76%,26.53%,1
臺南市,永康區,0813,385,226,611,18,629,1147,54.84%,33.57%,1
臺南市,永康區,0814,421,277,698,38,736,1442,51.04%,29.2%,1
臺南市,永康區,0815,506,250,756,24,780,1325,58.87%,38.19%,1
臺南市,永康區,0816,361,213,574,25,599,1260,47.54%,28.65%,1
臺南市,永康區,0817,494,284,778,21,799,1631,48.99%,30.29%,1
臺南市,永康區,0818,443,299,742,26,768,1549,49.58%,28.6%,1
臺南市,永康區,0819,503,324,827,20,847,1666,50.84%,30.19%,1
臺南市,永康區,0820,303,161,464,34,498,1012,49.21%,29.94%,1
臺南市,永康區,0821,307,146,453,13,466,976,47.75%,31.45%,1
臺南市,永康區,0822,187,96,283,13,296,531,55.74%,35.22%,1
臺南市,永康區,0823,317,156,473,26,499,859,58.09%,36.9%,1
臺南市,永康區,0824,273,179,452,18,470,937,50.16%,29.14%,1
臺南市,永康區,0825,446,235,681,25,706,1307,54.02%,34.12%,1
臺南市,永康區,0826,470,239,709,12,721,1482,48.65%,31.71%,1
臺南市,永康區,0827,383,232,615,16,631,1341,47.05%,28.56%,1
臺南市,永康區,0828,390,284,674,29,703,1376,51.09%,28.34%,1
臺南市,永康區,0829,425,242,667,23,690,1390,49.64%,30.58%,1
臺南市,永康區,0830,486,321,807,28,835,1534,54.43%,31.68%,1
臺南市,永康區,0831,536,256,792,17,809,1460,55.41%,36.71%,1
臺南市,永康區,0832,433,266,699,10,709,1383,51.27%,31.31%,1
臺南市,永康區,0833,429,259,688,20,708,1299,54.5%,33.03%,1
臺南市,永康區,0834,437,260,697,6,703,1264,55.62%,34.57%,1
臺南市,永康區,0835,452,299,751,21,772,1355,56.97%,33.36%,1
臺南市,永康區,0836,461,230,691,27,718,1414,50.78%,32.6%,1
臺南市,永康區,0837,367,249,616,13,629,1109,56.72%,33.09%,1
臺南市,永康區,0838,373,199,572,18,590,1151,51.26%,32.41%,1
臺南市,永康區,0839,428,212,640,23,663,1026,64.62%,41.72%,1
臺南市,永康區,0840,396,168,564,18,582,1071,54.34%,36.97%,1
臺南市,永康區,0841,540,299,839,40,879,1387,63.37%,38.93%,1
臺南市,永康區,0842,480,300,780,36,816,1377,59.26%,34.86%,1
臺南市,永康區,0843,534,347,881,35,916,1687,54.3%,31.65%,1
臺南市,永康區,0844,529,298,827,22,849,1700,49.94%,31.12%,1
臺南市,永康區,0845,487,300,787,20,807,1444,55.89%,33.73%,1
臺南市,永康區,0846,477,272,749,17,766,1485,51.58%,32.12%,1
臺南市,永康區,0847,521,283,804,29,833,1717,48.51%,30.34%,1
臺南市,永康區,0848,475,297,772,27,799,1701,46.97%,27.92%,1
臺南市,永康區,0849,445,245,690,19,709,1382,51.3%,32.2%,1
臺南市,東區,1095,666,371,1037,40,1077,2681,40.17%,24.84%,1
臺南市,東區,1096,652,333,985,39,1024,1811,56.54%,36%,1
臺南市,東區,1097,553,337,890,48,938,1491,62.91%,37.09%,1
臺南市,東區,1098,447,282,729,23,752,1378,54.57%,32.44%,1
臺南市,東區,1099,551,326,877,30,907,1552,58.44%,35.5%,1
臺南市,東區,1100,467,299,766,17,783,1326,59.05%,35.22%,1
臺南市,東區,1101,549,308,857,46,903,1594,56.65%,34.44%,1
臺南市,東區,1102,568,345,913,35,948,1639,57.84%,34.66%,1
臺南市,東區,1103,560,334,894,53,947,1724,54.93%,32.48%,1
臺南市,東區,1104,568,297,865,46,911,1629,55.92%,34.87%,1
臺南市,東區,1105,471,292,763,32,795,1399,56.83%,33.67%,1
臺南市,東區,1106,525,312,837,25,862,1534,56.19%,34.22%,1
臺南市,東區,1107,559,352,911,29,940,1656,56.76%,33.76%,1
臺南市,東區,1108,454,242,696,36,732,1322,55.37%,34.34%,1
臺南市,東區,1109,635,233,868,33,901,1620,55.62%,39.2%,1
臺南市,東區,1110,514,280,794,26,820,1331,61.61%,38.62%,1
臺南市,東區,1111,385,178,563,43,606,1039,58.33%,37.05%,1
臺南市,東區,1112,420,215,635,24,659,1257,52.43%,33.41%,1
臺南市,東區,1113,655,355,1010,64,1074,2067,51.96%,31.69%,1
臺南市,東區,1114,799,356,1155,29,1184,2153,54.99%,37.11%,1
臺南市,東區,1115,784,434,1218,33,1251,2363,52.94%,33.18%,1
臺南市,東區,1116,496,251,747,39,786,1427,55.08%,34.76%,1
臺南市,東區,1117,583,316,899,34,933,1555,60%,37.49%,1
臺南市,東區,1118,590,333,923,45,968,2115,45.77%,27.9%,1
臺南市,東區,1119,689,425,1114,50,1164,2340,49.74%,29.44%,1
臺南市,東區,1120,769,514,1283,33,1316,2474,53.19%,31.08%,1
臺南市,東區,1121,794,395,1189,57,1246,2391,52.11%,33.21%,1
臺南市,東區,1122,593,332,925,28,953,1673,56.96%,35.45%,1
臺南市,東區,1123,539,313,852,33,885,1594,55.52%,33.81%,1
臺南市,東區,1124,557,318,875,45,920,1607,57.25%,34.66%,1
臺南市,東區,1125,751,445,1196,24,1220,2087,58.46%,35.98%,1
臺南市,東區,1126,820,508,1328,36,1364,2369,57.58%,34.61%,1
臺南市,東區,1127,576,290,866,51,917,1696,54.07%,33.96%,1
臺南市,東區,1128,540,337,877,35,912,1612,56.58%,33.5%,1
臺南市,東區,1129,524,335,859,37,896,1708,52.46%,30.68%,1
臺南市,東區,1130,517,307,824,37,861,1560,55.19%,33.14%,1
臺南市,東區,1131,683,272,955,40,995,1854,53.67%,36.84%,1
臺南市,東區,1132,726,398,1124,32,1156,2278,50.75%,31.87%,1
臺南市,東區,1133,683,394,1077,34,1111,2093,53.08%,32.63%,1
臺南市,東區,1134,785,459,1244,37,1281,2242,57.14%,35.01%,1
臺南市,東區,1135,430,228,658,36,694,1152,60.24%,37.33%,1
臺南市,東區,1136,486,300,786,11,797,1318,60.47%,36.87%,1
臺南市,東區,1137,763,451,1214,39,1253,2200,56.95%,34.68%,1
臺南市,東區,1138,726,392,1118,26,1144,1960,58.37%,37.04%,1
臺南市,東區,1139,507,305,812,26,838,1489,56.28%,34.05%,1
臺南市,東區,1140,450,314,764,34,798,1443,55.3%,31.19%,1
臺南市,東區,1141,503,374,877,33,910,1498,60.75%,33.58%,1
臺南市,東區,1142,556,341,897,22,919,1622,56.66%,34.28%,1
臺南市,東區,1143,583,357,940,35,975,1738,56.1%,33.54%,1
臺南市,東區,1144,447,303,750,45,795,1501,52.96%,29.78%,1
臺南市,東區,1145,502,291,793,41,834,1482,56.28%,33.87%,1
臺南市,東區,1146,527,351,878,36,914,1829,49.97%,28.81%,1
臺南市,東區,1147,570,346,916,43,959,1764,54.37%,32.31%,1
臺南市,東區,1148,488,322,810,22,832,1427,58.3%,34.2%,1
臺南市,東區,1149,433,294,727,45,772,1427,54.1%,30.34%,1
臺南市,東區,1150,466,286,752,32,784,1388,56.48%,33.57%,1
臺南市,東區,1151,375,300,675,23,698,1131,61.72%,33.16%,1
臺南市,東區,1152,321,198,519,31,550,1000,55%,32.1%,1
臺南市,東區,1153,347,184,531,24,555,996,55.72%,34.84%,1
臺南市,東區,1154,314,156,470,30,500,935,53.48%,33.58%,1
臺南市,東區,1155,294,222,516,31,547,947,57.76%,31.05%,1
臺南市,東區,1156,356,233,589,8,597,1090,54.77%,32.66%,1
臺南市,東區,1157,283,174,457,23,480,896,53.57%,31.58%,1
臺南市,東區,1158,534,316,850,26,876,1589,55.13%,33.61%,1
臺南市,東區,1159,507,320,827,25,852,1497,56.91%,33.87%,1
臺南市,東區,1160,428,265,693,38,731,1386,52.74%,30.88%,1
臺南市,東區,1161,376,233,609,16,625,1101,56.77%,34.15%,1
臺南市,東區,1162,471,276,747,29,776,1332,58.26%,35.36%,1
臺南市,東區,1163,405,245,650,31,681,1185,57.47%,34.18%,1
臺南市,東區,1164,460,260,720,28,748,1262,59.27%,36.45%,1
臺南市,東區,1165,508,249,757,40,797,1517,52.54%,33.49%,1
臺南市,東區,1166,411,255,666,50,716,1287,55.63%,31.93%,1
臺南市,東區,1167,577,318,895,36,931,1657,56.19%,34.82%,1
臺南市,東區,1168,709,427,1136,77,1213,2238,54.2%,31.68%,1
臺南市,東區,1169,681,460,1141,53,1194,2246,53.16%,30.32%,1
臺南市,東區,1170,703,425,1128,39,1167,2191,53.26%,32.09%,1
臺南市,東區,1171,649,387,1036,44,1080,2063,52.35%,31.46%,1
臺南市,東區,1172,757,446,1203,51,1254,2177,57.6%,34.77%,1
臺南市,東區,1173,675,368,1043,46,1089,1863,58.45%,36.23%,1
臺南市,東區,1174,762,438,1200,28,1228,2185,56.2%,34.87%,1
臺南市,東區,1175,541,267,808,33,841,1721,48.87%,31.44%,1
臺南市,東區,1176,498,295,793,70,863,1556,55.46%,32.01%,1
臺南市,東區,1177,519,369,888,33,921,1602,57.49%,32.4%,1
臺南市,東區,1178,526,245,771,39,810,1523,53.18%,34.54%,1
臺南市,東區,1179,424,261,685,33,718,1382,51.95%,30.68%,1
臺南市,東區,1180,480,299,779,30,809,1486,54.44%,32.3%,1
臺南市,東區,1181,531,307,838,43,881,1560,56.47%,34.04%,1
臺南市,東區,1182,503,298,801,36,837,1684,49.7%,29.87%,1
臺南市,東區,1183,539,346,885,29,914,1653,55.29%,32.61%,1
臺南市,東區,1184,498,360,858,12,870,1554,55.98%,32.05%,1
臺南市,東區,1185,486,300,786,22,808,1408,57.39%,34.52%,1
臺南市,東區,1186,754,448,1202,25,1227,2084,58.88%,36.18%,1
臺南市,東區,1187,579,423,1002,35,1037,1896,54.69%,30.54%,1
臺南市,南區,1015,415,264,679,30,709,1221,58.07%,33.99%,1
臺南市,南區,1016,632,337,969,44,1013,2171,46.66%,29.11%,1
臺南市,南區,1017,413,235,648,21,669,1150,58.17%,35.91%,1
臺南市,南區,1018,444,201,645,19,664,1122,59.18%,39.57%,1
臺南市,南區,1019,435,264,699,30,729,1444,50.48%,30.12%,1
臺南市,南區,1020,544,313,857,28,885,1765,50.14%,30.82%,1
臺南市,南區,1021,471,271,742,25,767,1298,59.09%,36.29%,1
臺南市,南區,1022,528,259,787,21,808,1458,55.42%,36.21%,1
臺南市,南區,1023,632,331,963,19,982,1940,50.62%,32.58%,1
臺南市,南區,1024,519,314,833,38,871,1637,53.21%,31.7%,1
臺南市,南區,1025,237,161,398,10,408,871,46.84%,27.21%,1
臺南市,南區,1026,179,151,330,9,339,589,57.56%,30.39%,1
臺南市,南區,1027,290,200,490,43,533,801,66.54%,36.2%,1
臺南市,南區,1028,371,173,544,32,576,990,58.18%,37.47%,1
臺南市,南區,1029,477,242,719,24,743,1222,60.8%,39.03%,1
臺南市,南區,1030,364,187,551,48,599,997,60.08%,36.51%,1
臺南市,南區,1031,367,233,600,26,626,1204,51.99%,30.48%,1
臺南市,南區,1032,451,280,731,27,758,1570,48.28%,28.73%,1
臺南市,南區,1033,387,266,653,26,679,1222,55.56%,31.67%,1
臺南市,南區,1034,314,210,524,20,544,1076,50.56%,29.18%,1
臺南市,南區,1035,389,245,634,13,647,1127,57.41%,34.52%,1
臺南市,南區,1036,397,217,614,34,648,1135,57.09%,34.98%,1
臺南市,南區,1037,423,216,639,33,672,1263,53.21%,33.49%,1
臺南市,南區,1038,321,186,507,25,532,1014,52.47%,31.66%,1
臺南市,南區,1039,520,285,805,37,842,1491,56.47%,34.88%,1
臺南市,南區,1040,579,364,943,33,976,1815,53.77%,31.9%,1
臺南市,南區,1041,432,287,719,18,737,1398,52.72%,30.9%,1
臺南市,南區,1042,549,344,893,27,920,2107,43.66%,26.06%,1
臺南市,南區,1043,621,295,916,32,948,1587,59.74%,39.13%,1
臺南市,南區,1044,643,293,936,43,979,1626,60.21%,39.54%,1
臺南市,南區,1045,514,337,851,32,883,1761,50.14%,29.19%,1
臺南市,南區,1046,537,298,835,41,876,1630,53.74%,32.94%,1
臺南市,南區,1047,494,297,791,41,832,1542,53.96%,32.04%,1
臺南市,南區,1048,453,283,736,49,785,1464,53.62%,30.94%,1
臺南市,南區,1049,562,302,864,53,917,1727,53.1%,32.54%,1
臺南市,南區,1050,405,223,628,37,665,1085,61.29%,37.33%,1
臺南市,南區,1051,314,181,495,15,510,939,54.31%,33.44%,1
臺南市,南區,1052,399,242,641,38,679,1419,47.85%,28.12%,1
臺南市,南區,1053,399,244,643,30,673,1333,50.49%,29.93%,1
臺南市,南區,1054,446,266,712,32,744,1465,50.78%,30.44%,1
臺南市,南區,1055,396,203,599,16,615,1099,55.96%,36.03%,1
臺南市,南區,1056,366,201,567,11,578,1133,51.02%,32.3%,1
臺南市,南區,1057,450,234,684,30,714,1375,51.93%,32.73%,1
臺南市,南區,1058,473,338,811,24,835,1781,46.88%,26.56%,1
臺南市,南區,1059,529,318,847,29,876,1542,56.81%,34.31%,1
臺南市,南區,1060,469,247,716,25,741,1486,49.87%,31.56%,1
臺南市,南區,1061,574,287,861,52,913,1640,55.67%,35%,1
臺南市,南區,1062,475,271,746,26,772,1701,45.39%,27.92%,1
臺南市,南區,1063,487,241,728,38,766,1541,49.71%,31.6%,1
臺南市,南區,1064,661,312,973,55,1028,2027,50.72%,32.61%,1
臺南市,南區,1065,624,369,993,49,1042,1774,58.74%,35.17%,1
臺南市,南區,1066,487,332,819,37,856,1613,53.07%,30.19%,1
臺南市,南區,1067,527,322,849,15,864,1707,50.62%,30.87%,1
臺南市,南區,1068,357,225,582,18,600,1657,36.21%,21.54%,1
臺南市,南區,1069,345,218,563,22,585,1077,54.32%,32.03%,1
臺南市,南區,1070,399,216,615,21,636,1185,53.67%,33.67%,1
臺南市,南區,1071,390,231,621,15,636,1249,50.92%,31.22%,1
臺南市,南區,1072,570,300,870,28,898,1985,45.24%,28.72%,1
臺南市,南區,1073,541,338,879,40,919,2017,45.56%,26.82%,1
臺南市,南區,1074,506,304,810,37,847,1717,49.33%,29.47%,1
臺南市,南區,1075,315,188,503,22,525,929,56.51%,33.91%,1
臺南市,南區,1076,222,156,378,17,395,695,56.83%,31.94%,1
臺南市,南區,1077,330,160,490,13,503,997,50.45%,33.1%,1
臺南市,南區,1078,257,129,386,14,400,784,51.02%,32.78%,1
臺南市,南區,1079,404,206,610,41,651,1119,58.18%,36.1%,1
臺南市,南區,1080,320,162,482,22,504,1054,47.82%,30.36%,1
臺南市,南區,1081,383,206,589,56,645,1245,51.81%,30.76%,1
臺南市,南區,1082,588,343,931,52,983,2064,47.63%,28.49%,1
臺南市,南區,1083,555,301,856,18,874,2056,42.51%,26.99%,1
臺南市,南區,1084,447,210,657,19,676,1373,49.24%,32.56%,1
臺南市,南區,1085,318,172,490,23,513,1002,51.2%,31.74%,1
臺南市,南區,1086,267,138,405,45,450,760,59.21%,35.13%,1
臺南市,南區,1087,335,205,540,39,579,1031,56.16%,32.49%,1
臺南市,南區,1088,243,142,385,29,414,744,55.65%,32.66%,1
臺南市,南區,1089,414,202,616,33,649,1186,54.72%,34.91%,1
臺南市,南區,1090,450,263,713,33,746,1358,54.93%,33.14%,1
臺南市,南區,1091,260,158,418,18,436,897,48.61%,28.99%,1
臺南市,南區,1092,415,226,641,27,668,1265,52.81%,32.81%,1
臺南市,南區,1093,341,192,533,24,557,1093,50.96%,31.2%,1
臺南市,南區,1094,360,206,566,19,585,1016,57.58%,35.43%,1
臺南市,北區,0850,534,325,859,54,913,1793,50.92%,29.78%,1
臺南市,北區,0851,525,293,818,44,862,1708,50.47%,30.74%,1
臺南市,北區,0852,282,225,507,7,514,997,51.55%,28.28%,1
臺南市,北區,0853,361,278,639,15,654,1452,45.04%,24.86%,1
臺南市,北區,0854,390,278,668,24,692,1351,51.22%,28.87%,1
臺南市,北區,0855,510,291,801,33,834,1323,63.04%,38.55%,1
臺南市,北區,0856,394,212,606,25,631,1073,58.81%,36.72%,1
臺南市,北區,0857,432,213,645,31,676,1138,59.4%,37.96%,1
臺南市,北區,0858,413,201,614,30,644,1189,54.16%,34.74%,1
臺南市,北區,0859,471,276,747,30,777,1262,61.57%,37.32%,1
臺南市,北區,0860,383,209,592,20,612,1017,60.18%,37.66%,1
臺南市,北區,0861,285,172,457,18,475,847,56.08%,33.65%,1
臺南市,北區,0862,400,192,592,33,625,1076,58.09%,37.17%,1
臺南市,北區,0863,358,195,553,17,570,954,59.75%,37.53%,1
臺南市,北區,0864,415,230,645,53,698,1300,53.69%,31.92%,1
臺南市,北區,0865,479,236,715,22,737,1390,53.02%,34.46%,1
臺南市,北區,0866,477,236,713,28,741,1318,56.22%,36.19%,1
臺南市,北區,0867,337,175,512,14,526,974,54%,34.6%,1
臺南市,北區,0868,336,192,528,20,548,990,55.35%,33.94%,1
臺南市,北區,0869,353,253,606,24,630,1016,62.01%,34.74%,1
臺南市,北區,0870,351,205,556,35,591,1053,56.13%,33.33%,1
臺南市,北區,0871,456,251,707,62,769,1466,52.46%,31.11%,1
臺南市,北區,0872,534,286,820,36,856,1535,55.77%,34.79%,1
臺南市,北區,0873,506,255,761,50,811,1544,52.53%,32.77%,1
臺南市,北區,0874,607,338,945,47,992,1760,56.36%,34.49%,1
臺南市,北區,0875,452,260,712,29,741,1372,54.01%,32.94%,1
臺南市,北區,0876,360,201,561,25,586,1002,58.48%,35.93%,1
臺南市,北區,0877,424,234,658,27,685,1171,58.5%,36.21%,1
臺南市,北區,0878,376,236,612,27,639,1285,49.73%,29.26%,1
臺南市,北區,0879,367,152,519,27,546,1036,52.7%,35.42%,1
臺南市,北區,0880,451,259,710,43,753,1392,54.09%,32.4%,1
臺南市,北區,0881,417,199,616,26,642,1147,55.97%,36.36%,1
臺南市,北區,0882,463,237,700,19,719,1526,47.12%,30.34%,1
臺南市,北區,0883,530,296,826,28,854,1559,54.78%,34%,1
臺南市,北區,0884,295,172,467,48,515,892,57.74%,33.07%,1
臺南市,北區,0885,270,197,467,20,487,937,51.97%,28.82%,1
臺南市,北區,0886,491,294,785,49,834,1449,57.56%,33.89%,1
臺南市,北區,0887,394,207,601,26,627,1160,54.05%,33.97%,1
臺南市,北區,0888,340,229,569,34,603,1567,38.48%,21.7%,1
臺南市,北區,0889,443,249,692,34,726,1346,53.94%,32.91%,1
臺南市,北區,0890,431,261,692,20,712,1451,49.07%,29.7%,1
臺南市,北區,0891,481,304,785,25,810,1522,53.22%,31.6%,1
臺南市,北區,0892,415,239,654,27,681,1278,53.29%,32.47%,1
臺南市,北區,0893,343,230,573,40,613,1164,52.66%,29.47%,1
臺南市,北區,0894,354,201,555,10,565,1091,51.79%,32.45%,1
臺南市,北區,0895,334,181,515,21,536,993,53.98%,33.64%,1
臺南市,北區,0896,349,172,521,22,543,1119,48.53%,31.19%,1
臺南市,北區,0897,556,330,886,43,929,1685,55.13%,33%,1
臺南市,北區,0898,482,252,734,12,746,1368,54.53%,35.23%,1
臺南市,北區,0899,458,262,720,36,756,1389,54.43%,32.97%,1
臺南市,北區,0900,529,304,833,21,854,1469,58.13%,36.01%,1
臺南市,北區,0901,542,371,913,42,955,1655,57.7%,32.75%,1
臺南市,北區,0902,422,277,699,20,719,1261,57.02%,33.47%,1
臺南市,北區,0903,492,286,778,19,797,1490,53.49%,33.02%,1
臺南市,北區,0904,506,303,809,23,832,1436,57.94%,35.24%,1
臺南市,北區,0905,491,259,750,44,794,1340,59.25%,36.64%,1
臺南市,北區,0906,481,294,775,33,808,1464,55.19%,32.86%,1
臺南市,北區,0907,495,356,851,25,876,1513,57.9%,32.72%,1
臺南市,北區,0908,559,388,947,26,973,1709,56.93%,32.71%,1
臺南市,北區,0909,526,352,878,31,909,1517,59.92%,34.67%,1
臺南市,北區,0910,494,331,825,18,843,1598,52.75%,30.91%,1
臺南市,北區,0911,414,296,710,35,745,1399,53.25%,29.59%,1
臺南市,北區,0912,412,222,634,34,668,1214,55.02%,33.94%,1
臺南市,北區,0913,340,247,587,18,605,1064,56.86%,31.95%,1
臺南市,北區,0914,394,277,671,34,705,1148,61.41%,34.32%,1
臺南市,北區,0915,461,312,773,25,798,1391,57.37%,33.14%,1
臺南市,北區,0916,546,322,868,36,904,1584,57.07%,34.47%,1
臺南市,北區,0917,543,325,868,23,891,1595,55.86%,34.04%,1
臺南市,北區,0918,495,247,742,19,761,1397,54.47%,35.43%,1
臺南市,北區,0919,539,321,860,34,894,1662,53.79%,32.43%,1
臺南市,北區,0920,487,336,823,26,849,1634,51.96%,29.8%,1
臺南市,北區,0921,645,344,989,30,1019,1793,56.83%,35.97%,1
臺南市,北區,0922,624,382,1006,43,1049,1872,56.04%,33.33%,1
臺南市,北區,0923,613,356,969,49,1018,1874,54.32%,32.71%,1
臺南市,北區,0924,588,280,868,49,917,1760,52.1%,33.41%,1
臺南市,北區,0925,535,323,858,48,906,1753,51.68%,30.52%,1
臺南市,北區,0926,410,265,675,25,700,1502,46.6%,27.3%,1
臺南市,北區,0927,512,266,778,20,798,1470,54.29%,34.83%,1
臺南市,北區,0928,422,253,675,33,708,1319,53.68%,31.99%,1
臺南市,北區,0929,628,394,1022,33,1055,1876,56.24%,33.48%,1
臺南市,北區,0930,574,320,894,17,911,1720,52.97%,33.37%,1
臺南市,安南區,0618,808,520,1328,26,1354,2549,53.12%,31.7%,1
臺南市,安南區,0619,783,398,1181,41,1222,2321,52.65%,33.74%,1
臺南市,安南區,0620,699,460,1159,35,1194,2156,55.38%,32.42%,1
臺南市,安南區,0621,593,334,927,48,975,1662,58.66%,35.68%,1
臺南市,安南區,0622,582,258,840,59,899,1512,59.46%,38.49%,1
臺南市,安南區,0623,488,297,785,41,826,1625,50.83%,30.03%,1
臺南市,安南區,0624,634,370,1004,31,1035,2143,48.3%,29.58%,1
臺南市,安南區,0625,847,472,1319,81,1400,2457,56.98%,34.47%,1
臺南市,安南區,0626,690,448,1138,68,1206,2148,56.15%,32.12%,1
臺南市,安南區,0627,732,434,1166,64,1230,2364,52.03%,30.96%,1
臺南市,安南區,0628,536,347,883,37,920,1868,49.25%,28.69%,1
臺南市,安南區,0629,613,389,1002,49,1051,1797,58.49%,34.11%,1
臺南市,安南區,0630,768,411,1179,51,1230,2268,54.23%,33.86%,1
臺南市,安南區,0631,666,355,1021,45,1066,2291,46.53%,29.07%,1
臺南市,安南區,0632,694,425,1119,37,1156,2255,51.26%,30.78%,1
臺南市,安南區,0633,582,327,909,41,950,1940,48.97%,30%,1
臺南市,安南區,0634,675,421,1096,33,1129,2013,56.09%,33.53%,1
臺南市,安南區,0635,620,367,987,47,1034,2024,51.09%,30.63%,1
臺南市,安南區,0636,556,367,923,66,989,1613,61.31%,34.47%,1
臺南市,安南區,0637,372,226,598,28,626,1178,53.14%,31.58%,1
臺南市,安南區,0638,675,416,1091,60,1151,2143,53.71%,31.5%,1
臺南市,安南區,0639,536,382,918,49,967,1721,56.19%,31.14%,1
臺南市,安南區,0640,607,362,969,42,1011,1773,57.02%,34.24%,1
臺南市,安南區,0641,489,281,770,13,783,1428,54.83%,34.24%,1
臺南市,安南區,0642,514,352,866,25,891,1626,54.8%,31.61%,1
臺南市,安南區,0643,418,281,699,36,735,1358,54.12%,30.78%,1
臺南市,安南區,0644,525,299,824,30,854,1447,59.02%,36.28%,1
臺南市,安南區,0645,449,267,716,58,774,1358,57%,33.06%,1
臺南市,安南區,0646,669,363,1032,32,1064,2116,50.28%,31.62%,1
臺南市,安南區,0647,733,371,1104,35,1139,2321,49.07%,31.58%,1
臺南市,安南區,0648,698,363,1061,26,1087,2117,51.35%,32.97%,1
臺南市,安南區,0649,571,350,921,42,963,1927,49.97%,29.63%,1
臺南市,安南區,0650,654,421,1075,70,1145,2242,51.07%,29.17%,1
臺南市,安南區,0651,718,387,1105,50,1155,2334,49.49%,30.76%,1
臺南市,安南區,0652,605,357,962,31,993,1822,54.5%,33.21%,1
臺南市,安南區,0653,598,380,978,56,1034,1813,57.03%,32.98%,1
臺南市,安南區,0654,678,424,1102,69,1171,2188,53.52%,30.99%,1
臺南市,安南區,0655,728,394,1122,54,1176,2399,49.02%,30.35%,1
臺南市,安南區,0656,610,402,1012,57,1069,2247,47.57%,27.15%,1
臺南市,安南區,0657,398,285,683,42,725,1165,62.23%,34.16%,1
臺南市,安南區,0658,484,266,750,35,785,1539,51.01%,31.45%,1
臺南市,安南區,0659,592,370,962,76,1038,1835,56.57%,32.26%,1
臺南市,安南區,0660,548,372,920,61,981,1797,54.59%,30.5%,1
臺南市,安南區,0661,571,463,1034,63,1097,2223,49.35%,25.69%,1
臺南市,安南區,0662,354,225,579,45,624,977,63.87%,36.23%,1
臺南市,安南區,0663,466,293,759,19,778,1642,47.38%,28.38%,1
臺南市,安南區,0664,551,341,892,47,939,1697,55.33%,32.47%,1
臺南市,安南區,0665,573,349,922,48,970,1966,49.34%,29.15%,1
臺南市,安南區,0666,401,255,656,47,703,1319,53.3%,30.4%,1
臺南市,安南區,0667,536,358,894,41,935,1909,48.98%,28.08%,1
臺南市,安南區,0668,564,340,904,43,947,1763,53.72%,31.99%,1
臺南市,安南區,0669,290,195,485,35,520,965,53.89%,30.05%,1
臺南市,安南區,0670,397,264,661,56,717,1547,46.35%,25.66%,1
臺南市,安南區,0671,552,308,860,49,909,1784,50.95%,30.94%,1
臺南市,安南區,0672,622,345,967,56,1023,2145,47.69%,29%,1
臺南市,安南區,0673,697,575,1272,38,1310,2443,53.62%,28.53%,1
臺南市,安南區,0674,696,398,1094,42,1136,2565,44.29%,27.13%,1
臺南市,安南區,0675,763,465,1228,64,1292,2480,52.1%,30.77%,1
臺南市,安南區,0676,595,394,989,69,1058,2349,45.04%,25.33%,1
臺南市,安南區,0677,690,425,1115,49,1164,2168,53.69%,31.83%,1
臺南市,安南區,0678,531,282,813,40,853,1630,52.33%,32.58%,1
臺南市,安南區,0679,487,275,762,43,805,1675,48.06%,29.07%,1
臺南市,安南區,0680,608,356,964,55,1019,1627,62.63%,37.37%,1
臺南市,安南區,0681,516,261,777,46,823,1493,55.12%,34.56%,1
臺南市,安南區,0682,504,244,748,42,790,1397,56.55%,36.08%,1
臺南市,安南區,0683,465,255,720,36,756,1416,53.39%,32.84%,1
臺南市,安南區,0684,433,309,742,27,769,1460,52.67%,29.66%,1
臺南市,安南區,0685,640,340,980,36,1016,2222,45.72%,28.8%,1
臺南市,安南區,0686,643,398,1041,57,1098,2070,53.04%,31.06%,1
臺南市,安南區,0687,569,371,940,27,967,1739,55.61%,32.72%,1
臺南市,安南區,0688,555,326,881,59,940,1830,51.37%,30.33%,1
臺南市,安南區,0689,653,347,1000,58,1058,1803,58.68%,36.22%,1
臺南市,安南區,0690,604,383,987,32,1019,1800,56.61%,33.56%,1
臺南市,安南區,0691,496,318,814,37,851,1815,46.89%,27.33%,1
臺南市,安南區,0692,544,325,869,46,915,1846,49.57%,29.47%,1
臺南市,安南區,0693,313,209,522,35,557,905,61.55%,34.59%,1
臺南市,安南區,0694,359,255,614,55,669,1073,62.35%,33.46%,1
臺南市,安南區,0695,486,361,847,69,916,1579,58.01%,30.78%,1
臺南市,安南區,0696,532,375,907,71,978,1876,52.13%,28.36%,1
臺南市,安南區,0697,345,241,586,39,625,1194,52.35%,28.89%,1
臺南市,安南區,0698,380,217,597,31,628,1475,42.58%,25.76%,1
臺南市,安南區,0699,443,229,672,35,707,1380,51.23%,32.1%,1
臺南市,安南區,0700,405,301,706,37,743,1462,50.82%,27.7%,1
臺南市,安南區,0701,385,203,588,28,616,1044,59%,36.88%,1
臺南市,安南區,0702,224,124,348,47,395,603,65.51%,37.15%,1
臺南市,安南區,0703,232,152,384,15,399,690,57.83%,33.62%,1
臺南市,安南區,0704,403,280,683,40,723,1447,49.97%,27.85%,1
臺南市,安南區,0705,358,209,567,32,599,910,65.82%,39.34%,1
臺南市,安南區,0706,516,339,855,51,906,1850,48.97%,27.89%,1
臺南市,安南區,0707,519,334,853,36,889,1501,59.23%,34.58%,1
臺南市,安平區,0983,570,354,924,46,970,1753,55.33%,32.52%,1
臺南市,安平區,0984,582,354,936,26,962,1859,51.75%,31.31%,1
臺南市,安平區,0985,491,290,781,30,811,1382,58.68%,35.53%,1
臺南市,安平區,0986,804,436,1240,35,1275,2547,50.06%,31.57%,1
臺南市,安平區,0987,759,468,1227,33,1260,2407,52.35%,31.53%,1
臺南市,安平區,0988,560,387,947,26,973,2070,47%,27.05%,1
臺南市,安平區,0989,668,450,1118,23,1141,2132,53.52%,31.33%,1
臺南市,安平區,0990,509,289,798,9,807,1450,55.66%,35.1%,1
臺南市,安平區,0991,488,312,800,20,820,1605,51.09%,30.4%,1
臺南市,安平區,0992,550,343,893,54,947,1755,53.96%,31.34%,1
臺南市,安平區,0993,499,295,794,23,817,1728,47.28%,28.88%,1
臺南市,安平區,0994,434,309,743,17,760,1754,43.33%,24.74%,1
臺南市,安平區,0995,504,330,834,38,872,1686,51.72%,29.89%,1
臺南市,安平區,0996,611,361,972,27,999,1843,54.21%,33.15%,1
臺南市,安平區,0997,520,348,868,21,889,1565,56.81%,33.23%,1
臺南市,安平區,0998,450,246,696,18,714,1288,55.43%,34.94%,1
臺南市,安平區,0999,480,327,807,13,820,1653,49.61%,29.04%,1
臺南市,安平區,1000,537,296,833,7,840,1697,49.5%,31.64%,1
臺南市,安平區,1001,611,384,995,22,1017,2154,47.21%,28.37%,1
臺南市,安平區,1002,655,345,1000,32,1032,2107,48.98%,31.09%,1
臺南市,安平區,1003,563,337,900,31,931,1675,55.58%,33.61%,1
臺南市,安平區,1004,566,423,989,39,1028,1979,51.95%,28.6%,1
臺南市,安平區,1005,479,300,779,20,799,1602,49.88%,29.9%,1
臺南市,安平區,1006,477,304,781,25,806,1586,50.82%,30.08%,1
臺南市,安平區,1007,131,71,202,9,211,438,48.17%,29.91%,1
臺南市,安平區,1008,525,347,872,28,900,1780,50.56%,29.49%,1
臺南市,安平區,1009,452,330,782,37,819,1623,50.46%,27.85%,1
臺南市,安平區,1010,664,349,1013,56,1069,2157,49.56%,30.78%,1
臺南市,安平區,1011,418,228,646,32,678,1286,52.72%,32.5%,1
臺南市,安平區,1012,470,281,751,38,789,1492,52.88%,31.5%,1
臺南市,安平區,1013,399,223,622,14,636,1325,48%,30.11%,1
臺南市,安平區,1014,630,305,935,57,992,2001,49.58%,31.48%,1
臺南市,中西區,0931,414,289,703,37,740,1332,55.56%,31.08%,1
臺南市,中西區,0932,424,264,688,40,728,1246,58.43%,34.03%,1
臺南市,中西區,0933,420,217,637,39,676,1276,52.98%,32.92%,1
臺南市,中西區,0934,516,355,871,33,904,1583,57.11%,32.6%,1
臺南市,中西區,0935,489,324,813,26,839,1464,57.31%,33.4%,1
臺南市,中西區,0936,380,260,640,15,655,1234,53.08%,30.79%,1
臺南市,中西區,0937,472,292,764,26,790,1368,57.75%,34.5%,1
臺南市,中西區,0938,407,231,638,31,669,1322,50.61%,30.79%,1
臺南市,中西區,0939,363,241,604,41,645,1216,53.04%,29.85%,1
臺南市,中西區,0940,433,242,675,35,710,1289,55.08%,33.59%,1
臺南市,中西區,0941,460,221,681,26,707,1237,57.15%,37.19%,1
臺南市,中西區,0942,334,231,565,27,592,1189,49.79%,28.09%,1
臺南市,中西區,0943,382,249,631,56,687,1201,57.2%,31.81%,1
臺南市,中西區,0944,373,225,598,40,638,1065,59.91%,35.02%,1
臺南市,中西區,0945,400,199,599,23,622,1055,58.96%,37.91%,1
臺南市,中西區,0946,398,297,695,23,718,1170,61.37%,34.02%,1
臺南市,中西區,0947,489,288,777,22,799,1280,62.42%,38.2%,1
臺南市,中西區,0948,410,255,665,31,696,1223,56.91%,33.52%,1
臺南市,中西區,0949,565,140,705,40,745,1292,57.66%,43.73%,1
臺南市,中西區,0950,348,231,579,10,589,993,59.32%,35.05%,1
臺南市,中西區,0951,474,348,822,40,862,1541,55.94%,30.76%,1
臺南市,中西區,0952,598,353,951,45,996,1652,60.29%,36.2%,1
臺南市,中西區,0953,420,251,671,19,690,1212,56.93%,34.65%,1
臺南市,中西區,0954,548,328,876,51,927,1621,57.19%,33.81%,1
臺南市,中西區,0955,532,388,920,25,945,1660,56.93%,32.05%,1
臺南市,中西區,0956,497,334,831,38,869,1595,54.48%,31.16%,1
臺南市,中西區,0957,460,281,741,29,770,1436,53.62%,32.03%,1
臺南市,中西區,0958,444,247,691,37,728,1265,57.55%,35.1%,1
臺南市,中西區,0959,345,167,512,18,530,856,61.92%,40.3%,1
臺南市,中西區,0960,371,225,596,30,626,1168,53.6%,31.76%,1
臺南市,中西區,0961,381,257,638,32,670,1134,59.08%,33.6%,1
臺南市,中西區,0962,393,203,596,31,627,995,63.02%,39.5%,1
臺南市,中西區,0963,514,276,790,26,816,1313,62.15%,39.15%,1
臺南市,中西區,0964,431,285,716,42,758,1265,59.92%,34.07%,1
臺南市,中西區,0965,375,253,628,23,651,1215,53.58%,30.86%,1
臺南市,中西區,0966,400,257,657,33,690,1248,55.29%,32.05%,1
臺南市,中西區,0967,192,170,362,19,381,687,55.46%,27.95%,1
臺南市,中西區,0968,373,219,592,49,641,1139,56.28%,32.75%,1
臺南市,中西區,0969,324,212,536,31,567,971,58.39%,33.37%,1
臺南市,中西區,0970,333,187,520,33,553,1254,44.1%,26.56%,1
臺南市,中西區,0971,351,197,548,32,580,979,59.24%,35.85%,1
臺南市,中西區,0972,515,351,866,43,909,1745,52.09%,29.51%,1
臺南市,中西區,0973,356,210,566,26,592,1074,55.12%,33.15%,1
臺南市,中西區,0974,445,251,696,32,728,1436,50.7%,30.99%,1
臺南市,中西區,0975,276,191,467,34,501,865,57.92%,31.91%,1
臺南市,中西區,0976,392,214,606,32,638,1164,54.81%,33.68%,1
臺南市,中西區,0977,395,233,628,30,658,1285,51.21%,30.74%,1
臺南市,中西區,0978,366,194,560,33,593,1078,55.01%,33.95%,1
臺南市,中西區,0979,493,275,768,41,809,1704,47.48%,28.93%,1
臺南市,中西區,0980,467,243,710,49,759,1296,58.56%,36.03%,1
臺南市,中西區,0981,363,237,600,35,635,1128,56.29%,32.18%,1
臺南市,中西區,0982,414,250,664,24,688,1245,55.26%,33.25%,1
高雄市,鹽埕區,0845,497,296,793,48,841,1304,64.49%,38.11%,1
高雄市,鹽埕區,0846,150,70,220,10,230,357,64.43%,42.02%,1
高雄市,鹽埕區,0847,250,148,398,13,411,651,63.13%,38.4%,1
高雄市,鹽埕區,0848,461,227,688,23,711,1322,53.78%,34.87%,1
高雄市,鹽埕區,0849,596,36,632,23,655,1056,62.03%,56.44%,1
高雄市,鹽埕區,0850,353,219,572,11,583,904,64.49%,39.05%,1
高雄市,鹽埕區,0851,423,233,656,22,678,1130,60%,37.43%,1
高雄市,鹽埕區,0852,354,168,522,16,538,840,64.05%,42.14%,1
高雄市,鹽埕區,0853,259,163,422,18,440,616,71.43%,42.05%,1
高雄市,鹽埕區,0854,454,274,728,29,757,1397,54.19%,32.5%,1
高雄市,鹽埕區,0855,279,181,460,7,467,766,60.97%,36.42%,1
高雄市,鹽埕區,0856,291,194,485,32,517,839,61.62%,34.68%,1
高雄市,鹽埕區,0857,308,198,506,13,519,805,64.47%,38.26%,1
高雄市,鹽埕區,0858,258,161,419,11,430,750,57.33%,34.4%,1
高雄市,鹽埕區,0859,335,234,569,19,588,986,59.63%,33.98%,1
高雄市,鹽埕區,0860,373,224,597,10,607,1068,56.84%,34.93%,1
高雄市,鹽埕區,0861,369,245,614,23,637,1060,60.09%,34.81%,1
高雄市,鹽埕區,0862,292,150,442,22,464,805,57.64%,36.27%,1
高雄市,鹽埕區,0863,357,218,575,14,589,1073,54.89%,33.27%,1
高雄市,鹽埕區,0864,287,193,480,19,499,921,54.18%,31.16%,1
高雄市,鹽埕區,0865,436,226,662,15,677,1171,57.81%,37.23%,1
高雄市,鹽埕區,0866,201,153,354,5,359,594,60.44%,33.84%,1
高雄市,鹽埕區,0867,231,132,363,17,380,592,64.19%,39.02%,1
高雄市,鹽埕區,0868,193,138,331,10,341,610,55.9%,31.64%,1
高雄市,鼓山區,0768,344,182,526,15,541,959,56.41%,35.87%,1
高雄市,鼓山區,0769,422,213,635,35,670,1000,67%,42.2%,1
高雄市,鼓山區,0770,373,174,547,16,563,910,61.87%,40.99%,1
高雄市,鼓山區,0771,468,207,675,38,713,1085,65.71%,43.13%,1
高雄市,鼓山區,0772,480,251,731,27,758,1484,51.08%,32.35%,1
高雄市,鼓山區,0773,561,277,838,20,858,1393,61.59%,40.27%,1
高雄市,鼓山區,0774,532,288,820,36,856,1270,67.4%,41.89%,1
高雄市,鼓山區,0775,393,220,613,31,644,1055,61.04%,37.25%,1
高雄市,鼓山區,0776,433,246,679,27,706,1172,60.24%,36.95%,1
高雄市,鼓山區,0777,487,252,739,34,773,1175,65.79%,41.45%,1
高雄市,鼓山區,0778,518,252,770,34,804,1274,63.11%,40.66%,1
高雄市,鼓山區,0779,372,198,570,18,588,1085,54.19%,34.29%,1
高雄市,鼓山區,0780,512,311,823,38,861,1470,58.57%,34.83%,1
高雄市,鼓山區,0781,381,253,634,20,654,974,67.15%,39.12%,1
高雄市,鼓山區,0782,458,296,754,46,800,1275,62.75%,35.92%,1
高雄市,鼓山區,0783,428,274,702,38,740,1206,61.36%,35.49%,1
高雄市,鼓山區,0784,503,243,746,26,772,1238,62.36%,40.63%,1
高雄市,鼓山區,0785,351,140,491,10,501,721,69.49%,48.68%,1
高雄市,鼓山區,0786,432,252,684,25,709,1220,58.11%,35.41%,1
高雄市,鼓山區,0787,623,382,1005,37,1042,1966,53%,31.69%,1
高雄市,鼓山區,0788,625,319,944,51,995,1722,57.78%,36.3%,1
高雄市,鼓山區,0789,590,353,943,34,977,1720,56.8%,34.3%,1
高雄市,鼓山區,0790,507,275,782,54,836,1287,64.96%,39.39%,1
高雄市,鼓山區,0791,400,223,623,13,636,1369,46.46%,29.22%,1
高雄市,鼓山區,0792,512,258,770,21,791,1222,64.73%,41.9%,1
高雄市,鼓山區,0793,629,382,1011,37,1048,1770,59.21%,35.54%,1
高雄市,鼓山區,0794,695,393,1088,21,1109,1860,59.62%,37.37%,1
高雄市,鼓山區,0795,657,395,1052,33,1085,1857,58.43%,35.38%,1
高雄市,鼓山區,0796,684,393,1077,30,1107,1841,60.13%,37.15%,1
高雄市,鼓山區,0797,679,409,1088,32,1120,1830,61.2%,37.1%,1
高雄市,鼓山區,0798,678,370,1048,42,1090,1809,60.25%,37.48%,1
高雄市,鼓山區,0799,725,410,1135,39,1174,1894,61.99%,38.28%,1
高雄市,鼓山區,0800,702,424,1126,24,1150,1882,61.11%,37.3%,1
高雄市,鼓山區,0801,730,440,1170,38,1208,1894,63.78%,38.54%,1
高雄市,鼓山區,0802,648,328,976,37,1013,1745,58.05%,37.13%,1
高雄市,鼓山區,0803,642,419,1061,15,1076,1887,57.02%,34.02%,1
高雄市,鼓山區,0804,764,445,1209,29,1238,1891,65.47%,40.4%,1
高雄市,鼓山區,0805,740,398,1138,27,1165,1903,61.22%,38.89%,1
高雄市,鼓山區,0806,738,453,1191,33,1224,1998,61.26%,36.94%,1
高雄市,鼓山區,0807,706,437,1143,33,1176,1912,61.51%,36.92%,1
高雄市,鼓山區,0808,737,424,1161,46,1207,1923,62.77%,38.33%,1
高雄市,鼓山區,0809,705,462,1167,20,1187,1888,62.87%,37.34%,1
高雄市,鼓山區,0810,717,436,1153,17,1170,1873,62.47%,38.28%,1
高雄市,鼓山區,0811,772,517,1289,22,1311,1959,66.92%,39.41%,1
高雄市,鼓山區,0812,754,445,1199,40,1239,1897,65.31%,39.75%,1
高雄市,鼓山區,0813,920,507,1427,26,1453,2362,61.52%,38.95%,1
高雄市,鼓山區,0814,729,405,1134,26,1160,1850,62.7%,39.41%,1
高雄市,鼓山區,0815,741,439,1180,29,1209,1928,62.71%,38.43%,1
高雄市,鼓山區,0816,674,410,1084,23,1107,1937,57.15%,34.8%,1
高雄市,鼓山區,0817,812,417,1229,43,1272,2123,59.92%,38.25%,1
高雄市,鼓山區,0818,717,424,1141,30,1171,1861,62.92%,38.53%,1
高雄市,鼓山區,0819,703,413,1116,23,1139,1892,60.2%,37.16%,1
高雄市,鼓山區,0820,781,495,1276,35,1311,2147,61.06%,36.38%,1
高雄市,鼓山區,0821,747,413,1160,29,1189,1897,62.68%,39.38%,1
高雄市,鼓山區,0822,737,461,1198,35,1233,2041,60.41%,36.11%,1
高雄市,鼓山區,0823,473,275,748,46,794,1309,60.66%,36.13%,1
高雄市,鼓山區,0824,701,403,1104,38,1142,1867,61.17%,37.55%,1
高雄市,鼓山區,0825,485,276,761,23,784,1152,68.06%,42.1%,1
高雄市,鼓山區,0826,581,300,881,31,912,1404,64.96%,41.38%,1
高雄市,鼓山區,0827,345,227,572,17,589,1210,48.68%,28.51%,1
高雄市,鼓山區,0828,425,250,675,35,710,1135,62.56%,37.44%,1
高雄市,鼓山區,0829,419,220,639,44,683,1831,37.3%,22.88%,1
高雄市,鼓山區,0830,486,251,737,41,778,1288,60.4%,37.73%,1
高雄市,鼓山區,0831,452,232,684,31,715,1241,57.61%,36.42%,1
高雄市,鼓山區,0832,502,296,798,28,826,1342,61.55%,37.41%,1
高雄市,鼓山區,0833,524,303,827,74,901,1422,63.36%,36.85%,1
高雄市,鼓山區,0834,544,322,866,62,928,1453,63.87%,37.44%,1
高雄市,鼓山區,0835,266,119,385,20,405,616,65.75%,43.18%,1
高雄市,鼓山區,0836,311,169,480,36,516,834,61.87%,37.29%,1
高雄市,鼓山區,0837,352,203,555,25,580,969,59.86%,36.33%,1
高雄市,鼓山區,0838,384,192,576,28,604,978,61.76%,39.26%,1
高雄市,鼓山區,0839,295,176,471,36,507,760,66.71%,38.82%,1
高雄市,鼓山區,0840,462,253,715,41,756,1248,60.58%,37.02%,1
高雄市,鼓山區,0841,403,229,632,23,655,1143,57.31%,35.26%,1
高雄市,鼓山區,0842,461,242,703,37,740,1358,54.49%,33.95%,1
高雄市,鼓山區,0843,339,203,542,20,562,1036,54.25%,32.72%,1
高雄市,鼓山區,0844,211,127,338,10,348,580,60%,36.38%,1
高雄市,左營區,0534,570,310,880,35,915,2604,35.14%,21.89%,1
高雄市,左營區,0535,397,206,603,45,648,1037,62.49%,38.28%,1
高雄市,左營區,0536,221,111,332,29,361,542,66.61%,40.77%,1
高雄市,左營區,0537,227,139,366,33,399,635,62.83%,35.75%,1
高雄市,左營區,0538,184,88,272,8,280,518,54.05%,35.52%,1
高雄市,左營區,0539,312,155,467,37,504,813,61.99%,38.38%,1
高雄市,左營區,0540,315,177,492,59,551,889,61.98%,35.43%,1
高雄市,左營區,0541,256,169,425,46,471,731,64.43%,35.02%,1
高雄市,左營區,0542,545,286,831,38,869,1592,54.59%,34.23%,1
高雄市,左營區,0543,647,369,1016,32,1048,1709,61.32%,37.86%,1
高雄市,左營區,0544,591,275,866,46,912,1588,57.43%,37.22%,1
高雄市,左營區,0545,156,44,200,10,210,358,58.66%,43.58%,1
高雄市,左營區,0546,311,133,444,13,457,666,68.62%,46.7%,1
高雄市,左營區,0547,686,319,1005,33,1038,1748,59.38%,39.24%,1
高雄市,左營區,0548,500,230,730,37,767,1196,64.13%,41.81%,1
高雄市,左營區,0549,491,276,767,37,804,1240,64.84%,39.6%,1
高雄市,左營區,0550,658,193,851,28,879,1402,62.7%,46.93%,1
高雄市,左營區,0551,554,157,711,21,732,1173,62.4%,47.23%,1
高雄市,左營區,0552,330,119,449,13,462,641,72.07%,51.48%,1
高雄市,左營區,0553,326,232,558,33,591,951,62.15%,34.28%,1
高雄市,左營區,0554,249,167,416,27,443,732,60.52%,34.02%,1
高雄市,左營區,0555,124,61,185,12,197,339,58.11%,36.58%,1
高雄市,左營區,0556,212,106,318,10,328,519,63.2%,40.85%,1
高雄市,左營區,0557,188,124,312,30,342,514,66.54%,36.58%,1
高雄市,左營區,0558,282,144,426,41,467,720,64.86%,39.17%,1
高雄市,左營區,0559,171,80,251,18,269,411,65.45%,41.61%,1
高雄市,左營區,0560,244,132,376,26,402,603,66.67%,40.46%,1
高雄市,左營區,0561,300,193,493,42,535,904,59.18%,33.19%,1
高雄市,左營區,0562,485,224,709,23,732,1318,55.54%,36.8%,1
高雄市,左營區,0563,347,178,525,22,547,966,56.63%,35.92%,1
高雄市,左營區,0564,576,258,834,21,855,1440,59.38%,40%,1
高雄市,左營區,0565,751,328,1079,31,1110,1990,55.78%,37.74%,1
高雄市,左營區,0566,508,178,686,24,710,1090,65.14%,46.61%,1
高雄市,左營區,0567,594,174,768,33,801,1272,62.97%,46.7%,1
高雄市,左營區,0568,631,358,989,17,1006,1558,64.57%,40.5%,1
高雄市,左營區,0569,599,346,945,24,969,1501,64.56%,39.91%,1
高雄市,左營區,0570,152,91,243,7,250,360,69.44%,42.22%,1
高雄市,左營區,0571,588,170,758,38,796,1335,59.63%,44.04%,1
高雄市,左營區,0572,559,232,791,27,818,1359,60.19%,41.13%,1
高雄市,左營區,0573,622,292,914,34,948,1487,63.75%,41.83%,1
高雄市,左營區,0574,756,144,900,39,939,1637,57.36%,46.18%,1
高雄市,左營區,0575,612,350,962,29,991,1553,63.81%,39.41%,1
高雄市,左營區,0576,603,375,978,39,1017,1564,65.03%,38.55%,1
高雄市,左營區,0577,738,393,1131,39,1170,1788,65.44%,41.28%,1
高雄市,左營區,0578,761,434,1195,56,1251,2028,61.69%,37.52%,1
高雄市,左營區,0579,729,476,1205,50,1255,2037,61.61%,35.79%,1
高雄市,左營區,0580,821,449,1270,36,1306,2101,62.16%,39.08%,1
高雄市,左營區,0581,809,418,1227,44,1271,2018,62.98%,40.09%,1
高雄市,左營區,0582,782,447,1229,41,1270,1925,65.97%,40.62%,1
高雄市,左營區,0583,712,426,1138,38,1176,1989,59.13%,35.8%,1
高雄市,左營區,0584,601,354,955,29,984,1780,55.28%,33.76%,1
高雄市,左營區,0585,680,408,1088,23,1111,1778,62.49%,38.25%,1
高雄市,左營區,0586,580,316,896,29,925,1496,61.83%,38.77%,1
高雄市,左營區,0587,588,359,947,25,972,1538,63.2%,38.23%,1
高雄市,左營區,0588,788,452,1240,33,1273,2058,61.86%,38.29%,1
高雄市,左營區,0589,749,451,1200,33,1233,1992,61.9%,37.6%,1
高雄市,左營區,0590,755,487,1242,42,1284,2058,62.39%,36.69%,1
高雄市,左營區,0591,774,472,1246,34,1280,2090,61.24%,37.03%,1
高雄市,左營區,0592,817,468,1285,34,1319,2157,61.15%,37.88%,1
高雄市,左營區,0593,794,490,1284,33,1317,2096,62.83%,37.88%,1
高雄市,左營區,0594,807,475,1282,43,1325,2101,63.07%,38.41%,1
高雄市,左營區,0595,602,359,961,45,1006,1649,61.01%,36.51%,1
高雄市,左營區,0596,583,295,878,41,919,1516,60.62%,38.46%,1
高雄市,左營區,0597,585,449,1034,42,1076,1678,64.12%,34.86%,1
高雄市,左營區,0598,742,402,1144,30,1174,1898,61.85%,39.09%,1
高雄市,左營區,0599,804,317,1121,30,1151,1837,62.66%,43.77%,1
高雄市,左營區,0600,724,352,1076,30,1106,1922,57.54%,37.67%,1
高雄市,左營區,0601,727,370,1097,38,1135,1785,63.59%,40.73%,1
高雄市,左營區,0602,719,395,1114,22,1136,1886,60.23%,38.12%,1
高雄市,左營區,0603,742,413,1155,32,1187,1895,62.64%,39.16%,1
高雄市,左營區,0604,753,385,1138,31,1169,1831,63.84%,41.13%,1
高雄市,左營區,0605,805,400,1205,34,1239,2050,60.44%,39.27%,1
高雄市,左營區,0606,899,562,1461,31,1492,2251,66.28%,39.94%,1
高雄市,左營區,0607,825,532,1357,39,1396,2126,65.66%,38.81%,1
高雄市,左營區,0608,704,414,1118,19,1137,1928,58.97%,36.51%,1
高雄市,左營區,0609,787,474,1261,27,1288,2166,59.46%,36.33%,1
高雄市,左營區,0610,780,396,1176,34,1210,2031,59.58%,38.4%,1
高雄市,左營區,0611,783,428,1211,24,1235,1987,62.15%,39.41%,1
高雄市,左營區,0612,895,457,1352,37,1389,2166,64.13%,41.32%,1
高雄市,左營區,0613,709,413,1122,40,1162,1856,62.61%,38.2%,1
高雄市,左營區,0614,871,541,1412,28,1440,2289,62.91%,38.05%,1
高雄市,左營區,0615,788,391,1179,36,1215,1973,61.58%,39.94%,1
高雄市,左營區,0616,696,388,1084,44,1128,1818,62.05%,38.28%,1
高雄市,左營區,0617,565,358,923,20,943,1565,60.26%,36.1%,1
高雄市,左營區,0618,682,358,1040,24,1064,1608,66.17%,42.41%,1
高雄市,左營區,0619,719,428,1147,36,1183,1812,65.29%,39.68%,1
高雄市,左營區,0620,692,364,1056,16,1072,1821,58.87%,38%,1
高雄市,左營區,0621,729,406,1135,41,1176,1907,61.67%,38.23%,1
高雄市,左營區,0622,891,274,1165,30,1195,1812,65.95%,49.17%,1
高雄市,左營區,0623,940,211,1151,26,1177,1833,64.21%,51.28%,1
高雄市,左營區,0624,678,440,1118,35,1153,1850,62.32%,36.65%,1
高雄市,左營區,0625,658,351,1009,29,1038,1738,59.72%,37.86%,1
高雄市,左營區,0626,771,422,1193,33,1226,1864,65.77%,41.36%,1
高雄市,左營區,0627,744,426,1170,27,1197,1887,63.43%,39.43%,1
高雄市,左營區,0628,694,357,1051,25,1076,1870,57.54%,37.11%,1
高雄市,左營區,0629,738,378,1116,20,1136,1866,60.88%,39.55%,1
高雄市,左營區,0630,707,397,1104,16,1120,1862,60.15%,37.97%,1
高雄市,左營區,0631,730,387,1117,24,1141,1816,62.83%,40.2%,1
高雄市,左營區,0632,766,370,1136,30,1166,1833,63.61%,41.79%,1
高雄市,左營區,0633,665,368,1033,31,1064,1676,63.48%,39.68%,1
高雄市,左營區,0634,722,385,1107,34,1141,1843,61.91%,39.18%,1
高雄市,左營區,0635,761,401,1162,21,1183,1872,63.19%,40.65%,1
高雄市,左營區,0636,892,432,1324,31,1355,2259,59.98%,39.49%,1
高雄市,楠梓區,0435,534,280,814,25,839,1309,64.09%,40.79%,1
高雄市,楠梓區,0436,533,315,848,26,874,1408,62.07%,37.86%,1
高雄市,楠梓區,0437,698,379,1077,47,1124,1851,60.72%,37.71%,1
高雄市,楠梓區,0438,600,349,949,34,983,1578,62.29%,38.02%,1
高雄市,楠梓區,0439,587,351,938,22,960,1715,55.98%,34.23%,1
高雄市,楠梓區,0440,597,301,898,13,911,1611,56.55%,37.06%,1
高雄市,楠梓區,0441,711,374,1085,29,1114,2024,55.04%,35.13%,1
高雄市,楠梓區,0442,626,377,1003,21,1024,1890,54.18%,33.12%,1
高雄市,楠梓區,0443,558,349,907,23,930,1762,52.78%,31.67%,1
高雄市,楠梓區,0444,630,384,1014,34,1048,1888,55.51%,33.37%,1
高雄市,楠梓區,0445,628,373,1001,39,1040,1822,57.08%,34.47%,1
高雄市,楠梓區,0446,646,375,1021,24,1045,1846,56.61%,34.99%,1
高雄市,楠梓區,0447,472,284,756,42,798,1268,62.93%,37.22%,1
高雄市,楠梓區,0448,496,288,784,26,810,1240,65.32%,40%,1
高雄市,楠梓區,0449,548,321,869,24,893,1432,62.36%,38.27%,1
高雄市,楠梓區,0450,512,364,876,30,906,1490,60.81%,34.36%,1
高雄市,楠梓區,0451,575,320,895,33,928,1464,63.39%,39.28%,1
高雄市,楠梓區,0452,486,294,780,41,821,1435,57.21%,33.87%,1
高雄市,楠梓區,0453,556,311,867,38,905,1602,56.49%,34.71%,1
高雄市,楠梓區,0454,539,301,840,30,870,1500,58%,35.93%,1
高雄市,楠梓區,0455,565,355,920,72,992,1591,62.35%,35.51%,1
高雄市,楠梓區,0456,361,280,641,25,666,1669,39.9%,21.63%,1
高雄市,楠梓區,0457,552,328,880,29,909,1469,61.88%,37.58%,1
高雄市,楠梓區,0458,495,354,849,52,901,1559,57.79%,31.75%,1
高雄市,楠梓區,0459,562,313,875,55,930,1638,56.78%,34.31%,1
高雄市,楠梓區,0460,754,399,1153,51,1204,1960,61.43%,38.47%,1
高雄市,楠梓區,0461,662,437,1099,58,1157,1912,60.51%,34.62%,1
高雄市,楠梓區,0462,565,325,890,23,913,1559,58.56%,36.24%,1
高雄市,楠梓區,0463,465,310,775,31,806,1423,56.64%,32.68%,1
高雄市,楠梓區,0464,550,370,920,22,942,1696,55.54%,32.43%,1
高雄市,楠梓區,0465,524,297,821,68,889,1493,59.54%,35.1%,1
高雄市,楠梓區,0466,552,325,877,52,929,1527,60.84%,36.15%,1
高雄市,楠梓區,0467,374,235,609,45,654,1020,64.12%,36.67%,1
高雄市,楠梓區,0468,412,276,688,43,731,1197,61.07%,34.42%,1
高雄市,楠梓區,0469,517,306,823,36,859,1528,56.22%,33.84%,1
高雄市,楠梓區,0470,573,369,942,57,999,1918,52.09%,29.87%,1
高雄市,楠梓區,0471,524,297,821,96,917,1458,62.89%,35.94%,1
高雄市,楠梓區,0472,692,370,1062,48,1110,1790,62.01%,38.66%,1
高雄市,楠梓區,0473,676,416,1092,60,1152,1845,62.44%,36.64%,1
高雄市,楠梓區,0474,268,428,696,43,739,2037,36.28%,13.16%,1
高雄市,楠梓區,0475,684,402,1086,31,1117,1964,56.87%,34.83%,1
高雄市,楠梓區,0476,732,410,1142,26,1168,2006,58.23%,36.49%,1
高雄市,楠梓區,0477,688,390,1078,34,1112,1951,57%,35.26%,1
高雄市,楠梓區,0478,630,399,1029,54,1083,1951,55.51%,32.29%,1
高雄市,楠梓區,0479,787,391,1178,36,1214,2008,60.46%,39.19%,1
高雄市,楠梓區,0480,723,392,1115,52,1167,1923,60.69%,37.6%,1
高雄市,楠梓區,0481,696,421,1117,34,1151,1921,59.92%,36.23%,1
高雄市,楠梓區,0482,371,190,561,23,584,832,70.19%,44.59%,1
高雄市,楠梓區,0483,439,219,658,35,693,1156,59.95%,37.98%,1
高雄市,楠梓區,0484,412,260,672,42,714,1125,63.47%,36.62%,1
高雄市,楠梓區,0485,419,237,656,31,687,1060,64.81%,39.53%,1
高雄市,楠梓區,0486,590,294,884,42,926,1502,61.65%,39.28%,1
高雄市,楠梓區,0487,520,280,800,58,858,1404,61.11%,37.04%,1
高雄市,楠梓區,0488,474,286,760,41,801,1552,51.61%,30.54%,1
高雄市,楠梓區,0489,513,290,803,36,839,1460,57.47%,35.14%,1
高雄市,楠梓區,0490,493,200,693,36,729,1315,55.44%,37.49%,1
高雄市,楠梓區,0491,419,205,624,48,672,1062,63.28%,39.45%,1
高雄市,楠梓區,0492,399,227,626,36,662,1078,61.41%,37.01%,1
高雄市,楠梓區,0493,393,175,568,47,615,914,67.29%,43%,1
高雄市,楠梓區,0494,466,201,667,39,706,1064,66.35%,43.8%,1
高雄市,楠梓區,0495,683,338,1021,32,1053,1705,61.76%,40.06%,1
高雄市,楠梓區,0496,675,354,1029,40,1069,1728,61.86%,39.06%,1
高雄市,楠梓區,0497,758,397,1155,26,1181,1917,61.61%,39.54%,1
高雄市,楠梓區,0498,572,222,794,44,838,1439,58.23%,39.75%,1
高雄市,楠梓區,0499,485,273,758,48,806,1287,62.63%,37.68%,1
高雄市,楠梓區,0500,602,331,933,38,971,1504,64.56%,40.03%,1
高雄市,楠梓區,0501,597,242,839,47,886,1405,63.06%,42.49%,1
高雄市,楠梓區,0502,472,266,738,56,794,1287,61.69%,36.67%,1
高雄市,楠梓區,0503,505,287,792,25,817,1295,63.09%,39%,1
高雄市,楠梓區,0504,533,344,877,33,910,1483,61.36%,35.94%,1
高雄市,楠梓區,0505,702,367,1069,35,1104,1649,66.95%,42.57%,1
高雄市,楠梓區,0506,377,244,621,34,655,998,65.63%,37.78%,1
高雄市,楠梓區,0507,414,226,640,36,676,1025,65.95%,40.39%,1
高雄市,楠梓區,0508,690,377,1067,42,1109,1671,66.37%,41.29%,1
高雄市,楠梓區,0509,620,282,902,54,956,1453,65.79%,42.67%,1
高雄市,楠梓區,0510,651,322,973,49,1022,1673,61.09%,38.91%,1
高雄市,楠梓區,0511,621,328,949,36,985,1653,59.59%,37.57%,1
高雄市,楠梓區,0512,382,229,611,32,643,1034,62.19%,36.94%,1
高雄市,楠梓區,0513,481,254,735,42,777,1127,68.94%,42.68%,1
高雄市,楠梓區,0514,560,332,892,34,926,1575,58.79%,35.56%,1
高雄市,楠梓區,0515,581,332,913,44,957,1559,61.39%,37.27%,1
高雄市,楠梓區,0516,492,287,779,26,805,1378,58.42%,35.7%,1
高雄市,楠梓區,0517,650,373,1023,32,1055,1714,61.55%,37.92%,1
高雄市,楠梓區,0518,688,332,1020,45,1065,1721,61.88%,39.98%,1
高雄市,楠梓區,0519,608,352,960,33,993,1628,61%,37.35%,1
高雄市,楠梓區,0520,660,361,1021,51,1072,1590,67.42%,41.51%,1
高雄市,楠梓區,0521,636,317,953,44,997,1628,61.24%,39.07%,1
高雄市,楠梓區,0522,715,389,1104,26,1130,1739,64.98%,41.12%,1
高雄市,楠梓區,0523,652,376,1028,35,1063,1642,64.74%,39.71%,1
高雄市,楠梓區,0524,608,333,941,47,988,1766,55.95%,34.43%,1
高雄市,楠梓區,0525,537,294,831,34,865,1482,58.37%,36.23%,1
高雄市,楠梓區,0526,573,327,900,23,923,1749,52.77%,32.76%,1
高雄市,楠梓區,0527,579,358,937,29,966,1591,60.72%,36.39%,1
高雄市,楠梓區,0528,598,381,979,19,998,1545,64.6%,38.71%,1
高雄市,楠梓區,0529,678,373,1051,24,1075,1651,65.11%,41.07%,1
高雄市,楠梓區,0530,651,350,1001,37,1038,1646,63.06%,39.55%,1
高雄市,楠梓區,0531,584,336,920,50,970,1496,64.84%,39.04%,1
高雄市,楠梓區,0532,548,246,794,49,843,1403,60.09%,39.06%,1
高雄市,楠梓區,0533,442,364,806,30,836,1624,51.48%,27.22%,1
高雄市,三民區,0887,660,396,1056,59,1115,1893,58.9%,34.87%,1
高雄市,三民區,0888,637,387,1024,68,1092,1982,55.1%,32.14%,1
高雄市,三民區,0889,593,330,923,54,977,1661,58.82%,35.7%,1
高雄市,三民區,0890,636,434,1070,19,1089,1894,57.5%,33.58%,1
高雄市,三民區,0891,655,371,1026,29,1055,1839,57.37%,35.62%,1
高雄市,三民區,0892,718,387,1105,46,1151,2014,57.15%,35.65%,1
高雄市,三民區,0893,701,374,1075,68,1143,1897,60.25%,36.95%,1
高雄市,三民區,0894,670,393,1063,29,1092,2016,54.17%,33.23%,1
高雄市,三民區,0895,693,383,1076,28,1104,1924,57.38%,36.02%,1
高雄市,三民區,0896,538,463,1001,39,1040,1749,59.46%,30.76%,1
高雄市,三民區,0897,705,429,1134,47,1181,1845,64.01%,38.21%,1
高雄市,三民區,0898,587,384,971,33,1004,1724,58.24%,34.05%,1
高雄市,三民區,0899,679,399,1078,34,1112,1889,58.87%,35.94%,1
高雄市,三民區,0900,598,336,934,31,965,1622,59.49%,36.87%,1
高雄市,三民區,0901,577,567,1144,12,1156,1870,61.82%,30.86%,1
高雄市,三民區,0902,574,358,932,42,974,1523,63.95%,37.69%,1
高雄市,三民區,0903,691,378,1069,46,1115,2006,55.58%,34.45%,1
高雄市,三民區,0904,759,511,1270,45,1315,2076,63.34%,36.56%,1
高雄市,三民區,0905,723,462,1185,16,1201,2073,57.94%,34.88%,1
高雄市,三民區,0906,897,294,1191,30,1221,2045,59.71%,43.86%,1
高雄市,三民區,0907,617,395,1012,45,1057,2070,51.06%,29.81%,1
高雄市,三民區,0908,682,447,1129,29,1158,2035,56.9%,33.51%,1
高雄市,三民區,0909,767,506,1273,29,1302,2075,62.75%,36.96%,1
高雄市,三民區,0910,774,419,1193,26,1219,2053,59.38%,37.7%,1
高雄市,三民區,0911,846,437,1283,24,1307,2063,63.35%,41.01%,1
高雄市,三民區,0912,825,485,1310,37,1347,2143,62.86%,38.5%,1
高雄市,三民區,0913,649,412,1061,45,1106,1746,63.34%,37.17%,1
高雄市,三民區,0914,609,331,940,14,954,1735,54.99%,35.1%,1
高雄市,三民區,0915,564,331,895,36,931,1655,56.25%,34.08%,1
高雄市,三民區,0916,534,364,898,47,945,1583,59.7%,33.73%,1
高雄市,三民區,0917,600,396,996,31,1027,1800,57.06%,33.33%,1
高雄市,三民區,0918,682,361,1043,20,1063,1730,61.45%,39.42%,1
高雄市,三民區,0919,535,463,998,22,1020,1715,59.48%,31.2%,1
高雄市,三民區,0920,626,371,997,34,1031,1691,60.97%,37.02%,1
高雄市,三民區,0921,667,416,1083,31,1114,1865,59.73%,35.76%,1
高雄市,三民區,0922,423,253,676,29,705,1073,65.7%,39.42%,1
高雄市,三民區,0923,370,236,606,41,647,917,70.56%,40.35%,1
高雄市,三民區,0924,613,345,958,31,989,1647,60.05%,37.22%,1
高雄市,三民區,0925,634,340,974,43,1017,1654,61.49%,38.33%,1
高雄市,三民區,0926,645,352,997,35,1032,1639,62.97%,39.35%,1
高雄市,三民區,0927,696,377,1073,32,1105,1833,60.28%,37.97%,1
高雄市,三民區,0928,523,357,880,34,914,1362,67.11%,38.4%,1
高雄市,三民區,0929,600,352,952,39,991,1557,63.65%,38.54%,1
高雄市,三民區,0930,591,273,864,27,891,1482,60.12%,39.88%,1
高雄市,三民區,0931,630,336,966,29,995,1563,63.66%,40.31%,1
高雄市,三民區,0932,545,376,921,27,948,1497,63.33%,36.41%,1
高雄市,三民區,0933,576,399,975,22,997,1523,65.46%,37.82%,1
高雄市,三民區,0934,531,314,845,23,868,1293,67.13%,41.07%,1
高雄市,三民區,0935,612,418,1030,29,1059,1662,63.72%,36.82%,1
高雄市,三民區,0936,553,292,845,29,874,1441,60.65%,38.38%,1
高雄市,三民區,0937,575,310,885,27,912,1326,68.78%,43.36%,1
高雄市,三民區,0938,596,353,949,33,982,1476,66.53%,40.38%,1
高雄市,三民區,0939,664,404,1068,29,1097,1968,55.74%,33.74%,1
高雄市,三民區,0940,541,342,883,25,908,1618,56.12%,33.44%,1
高雄市,三民區,0941,616,438,1054,35,1089,1873,58.14%,32.89%,1
高雄市,三民區,0942,541,321,862,44,906,1487,60.93%,36.38%,1
高雄市,三民區,0943,626,345,971,19,990,1640,60.37%,38.17%,1
高雄市,三民區,0944,685,390,1075,21,1096,1889,58.02%,36.26%,1
高雄市,三民區,0945,690,398,1088,37,1125,1969,57.14%,35.04%,1
高雄市,三民區,0946,541,304,845,41,886,1466,60.44%,36.9%,1
高雄市,三民區,0947,656,365,1021,39,1060,1697,62.46%,38.66%,1
高雄市,三民區,0948,628,371,999,31,1030,1663,61.94%,37.76%,1
高雄市,三民區,0949,566,387,953,32,985,1649,59.73%,34.32%,1
高雄市,三民區,0950,548,312,860,33,893,1486,60.09%,36.88%,1
高雄市,三民區,0951,598,302,900,18,918,1495,61.4%,40%,1
高雄市,三民區,0952,595,386,981,28,1009,1548,65.18%,38.44%,1
高雄市,三民區,0953,535,351,886,25,911,1493,61.02%,35.83%,1
高雄市,三民區,0954,568,342,910,15,925,1445,64.01%,39.31%,1
高雄市,三民區,0955,568,318,886,24,910,1529,59.52%,37.15%,1
高雄市,三民區,0956,566,331,897,19,916,1506,60.82%,37.58%,1
高雄市,三民區,0957,605,355,960,26,986,1549,63.65%,39.06%,1
高雄市,三民區,0958,642,375,1017,48,1065,1620,65.74%,39.63%,1
高雄市,三民區,0959,570,382,952,39,991,1550,63.94%,36.77%,1
高雄市,三民區,0960,589,330,919,28,947,1488,63.64%,39.58%,1
高雄市,三民區,0961,481,327,808,36,844,1335,63.22%,36.03%,1
高雄市,三民區,0962,512,281,793,29,822,1332,61.71%,38.44%,1
高雄市,三民區,0963,641,391,1032,55,1087,1764,61.62%,36.34%,1
高雄市,三民區,0964,694,372,1066,30,1096,1811,60.52%,38.32%,1
高雄市,三民區,0965,630,408,1038,48,1086,1693,64.15%,37.21%,1
高雄市,三民區,0966,683,372,1055,50,1105,1684,65.62%,40.56%,1
高雄市,三民區,0967,518,319,837,40,877,1464,59.9%,35.38%,1
高雄市,三民區,0968,674,426,1100,26,1126,1719,65.5%,39.21%,1
高雄市,三民區,0969,641,392,1033,22,1055,1749,60.32%,36.65%,1
高雄市,三民區,0970,381,697,1078,25,1103,1908,57.81%,19.97%,1
高雄市,三民區,0971,596,347,943,35,978,1573,62.17%,37.89%,1
高雄市,三民區,0972,585,340,925,26,951,1628,58.42%,35.93%,1
高雄市,三民區,0973,478,266,744,31,775,1377,56.28%,34.71%,1
高雄市,三民區,0974,607,350,957,25,982,1530,64.18%,39.67%,1
高雄市,三民區,0975,452,247,699,32,731,1188,61.53%,38.05%,1
高雄市,三民區,0976,521,322,843,30,873,2791,31.28%,18.67%,1
高雄市,三民區,0977,685,381,1066,41,1107,1840,60.16%,37.23%,1
高雄市,三民區,0978,624,377,1001,52,1053,1671,63.02%,37.34%,1
高雄市,三民區,0979,584,368,952,33,985,1624,60.65%,35.96%,1
高雄市,三民區,0980,647,387,1034,29,1063,1555,68.36%,41.61%,1
高雄市,三民區,0981,585,373,958,30,988,1489,66.35%,39.29%,1
高雄市,三民區,0982,610,396,1006,36,1042,1662,62.7%,36.7%,1
高雄市,三民區,0983,607,333,940,22,962,1639,58.69%,37.03%,1
高雄市,三民區,0984,711,354,1065,36,1101,1872,58.81%,37.98%,1
高雄市,三民區,0985,702,402,1104,41,1145,1968,58.18%,35.67%,1
高雄市,三民區,0986,497,232,729,57,786,1471,53.43%,33.79%,1
高雄市,三民區,0987,600,262,862,35,897,1534,58.47%,39.11%,1
高雄市,三民區,0988,556,306,862,56,918,1659,55.33%,33.51%,1
高雄市,三民區,0989,518,417,935,27,962,1815,53%,28.54%,1
高雄市,三民區,0990,604,368,972,38,1010,1808,55.86%,33.41%,1
高雄市,三民區,0991,412,256,668,28,696,1224,56.86%,33.66%,1
高雄市,三民區,0992,520,283,803,23,826,1406,58.75%,36.98%,1
高雄市,三民區,0993,357,196,553,25,578,945,61.16%,37.78%,1
高雄市,三民區,0994,362,239,601,22,623,944,66%,38.35%,1
高雄市,三民區,0995,581,390,971,47,1018,1669,60.99%,34.81%,1
高雄市,三民區,0996,590,320,910,35,945,1473,64.15%,40.05%,1
高雄市,三民區,0997,525,393,918,39,957,1876,51.01%,27.99%,1
高雄市,三民區,0998,420,226,646,31,677,1682,40.25%,24.97%,1
高雄市,三民區,0999,589,360,949,25,974,1791,54.38%,32.89%,1
高雄市,三民區,1000,670,394,1064,39,1103,1808,61.01%,37.06%,1
高雄市,三民區,1001,613,373,986,29,1015,1798,56.45%,34.09%,1
高雄市,三民區,1002,713,455,1168,21,1189,2030,58.57%,35.12%,1
高雄市,三民區,1003,751,428,1179,25,1204,2034,59.19%,36.92%,1
高雄市,三民區,1004,722,436,1158,26,1184,1998,59.26%,36.14%,1
高雄市,三民區,1005,670,379,1049,35,1084,1914,56.64%,35.01%,1
高雄市,三民區,1006,706,414,1120,28,1148,1965,58.42%,35.93%,1
高雄市,三民區,1007,643,386,1029,60,1089,1885,57.77%,34.11%,1
高雄市,三民區,1008,489,278,767,20,787,1220,64.51%,40.08%,1
高雄市,三民區,1009,408,201,609,42,651,1057,61.59%,38.6%,1
高雄市,三民區,1010,432,289,721,25,746,1434,52.02%,30.13%,1
高雄市,三民區,1011,440,251,691,26,717,1350,53.11%,32.59%,1
高雄市,三民區,1012,325,153,478,10,488,872,55.96%,37.27%,1
高雄市,三民區,1013,335,178,513,20,533,954,55.87%,35.12%,1
高雄市,三民區,1014,632,388,1020,24,1044,1689,61.81%,37.42%,1
高雄市,三民區,1015,490,321,811,25,836,1390,60.14%,35.25%,1
高雄市,三民區,1016,504,294,798,41,839,1336,62.8%,37.72%,1
高雄市,三民區,1017,570,362,932,34,966,1437,67.22%,39.67%,1
高雄市,三民區,1018,540,335,875,22,897,1452,61.78%,37.19%,1
高雄市,三民區,1019,558,342,900,43,943,1513,62.33%,36.88%,1
高雄市,三民區,1020,583,345,928,42,970,1467,66.12%,39.74%,1
高雄市,三民區,1021,583,324,907,51,958,1381,69.37%,42.22%,1
高雄市,三民區,1022,428,225,653,32,685,1117,61.32%,38.32%,1
高雄市,三民區,1023,509,339,848,21,869,1327,65.49%,38.36%,1
高雄市,三民區,1024,527,292,819,24,843,1304,64.65%,40.41%,1
高雄市,三民區,1025,551,299,850,24,874,1483,58.93%,37.15%,1
高雄市,三民區,1026,595,339,934,31,965,1473,65.51%,40.39%,1
高雄市,三民區,1027,347,228,575,28,603,980,61.53%,35.41%,1
高雄市,三民區,1028,587,268,855,25,880,1409,62.46%,41.66%,1
高雄市,三民區,1029,480,268,748,28,776,1230,63.09%,39.02%,1
高雄市,三民區,1030,413,244,657,24,681,1024,66.5%,40.33%,1
高雄市,三民區,1031,442,234,676,37,713,1130,63.1%,39.12%,1
高雄市,三民區,1032,637,371,1008,31,1039,1889,55%,33.72%,1
高雄市,三民區,1033,589,268,857,25,882,1427,61.81%,41.28%,1
高雄市,三民區,1034,362,156,518,15,533,791,67.38%,45.76%,1
高雄市,三民區,1035,502,238,740,35,775,1079,71.83%,46.52%,1
高雄市,三民區,1036,555,310,865,43,908,1492,60.86%,37.2%,1
高雄市,三民區,1037,409,230,639,30,669,1020,65.59%,40.1%,1
高雄市,三民區,1038,402,247,649,9,658,1001,65.73%,40.16%,1
高雄市,三民區,1039,644,335,979,27,1006,1581,63.63%,40.73%,1
高雄市,三民區,1040,539,331,870,29,899,1471,61.11%,36.64%,1
高雄市,三民區,1041,497,244,741,18,759,1151,65.94%,43.18%,1
高雄市,三民區,1042,549,288,837,36,873,1334,65.44%,41.15%,1
高雄市,三民區,1043,479,282,761,23,784,1275,61.49%,37.57%,1
高雄市,三民區,1044,476,284,760,27,787,1688,46.62%,28.2%,1
高雄市,三民區,1045,451,281,732,28,760,1214,62.6%,37.15%,1
高雄市,三民區,1046,463,283,746,26,772,1149,67.19%,40.3%,1
高雄市,三民區,1047,594,362,956,57,1013,1667,60.77%,35.63%,1
高雄市,三民區,1048,606,369,975,31,1006,1786,56.33%,33.93%,1
高雄市,三民區,1049,353,191,544,16,560,896,62.5%,39.4%,1
高雄市,三民區,1050,367,195,562,22,584,925,63.14%,39.68%,1
高雄市,三民區,1051,292,156,448,29,477,684,69.74%,42.69%,1
高雄市,三民區,1052,371,253,624,36,660,981,67.28%,37.82%,1
高雄市,三民區,1053,484,252,736,40,776,1383,56.11%,35%,1
高雄市,三民區,1054,501,321,822,34,856,1382,61.94%,36.25%,1
高雄市,三民區,1055,280,176,456,23,479,808,59.28%,34.65%,1
高雄市,三民區,1056,455,273,728,22,750,1197,62.66%,38.01%,1
高雄市,三民區,1057,520,257,777,33,810,1344,60.27%,38.69%,1
高雄市,三民區,1058,531,287,818,34,852,1344,63.39%,39.51%,1
高雄市,三民區,1059,495,334,829,21,850,1359,62.55%,36.42%,1
高雄市,三民區,1060,403,252,655,34,689,1073,64.21%,37.56%,1
高雄市,三民區,1061,415,240,655,28,683,1186,57.59%,34.99%,1
高雄市,三民區,1062,636,372,1008,51,1059,1749,60.55%,36.36%,1
高雄市,三民區,1063,361,183,544,13,557,877,63.51%,41.16%,1
高雄市,三民區,1064,598,296,894,36,930,1402,66.33%,42.65%,1
高雄市,三民區,1065,298,201,499,21,520,769,67.62%,38.75%,1
高雄市,三民區,1066,466,279,745,32,777,1207,64.37%,38.61%,1
高雄市,三民區,1067,440,230,670,35,705,1270,55.51%,34.65%,1
高雄市,三民區,1068,445,277,722,33,755,1248,60.5%,35.66%,1
高雄市,三民區,1069,481,267,748,44,792,1263,62.71%,38.08%,1
高雄市,三民區,1070,422,253,675,32,707,1101,64.21%,38.33%,1
高雄市,三民區,1071,458,262,720,21,741,1116,66.4%,41.04%,1
高雄市,三民區,1072,483,233,716,22,738,1152,64.06%,41.93%,1
高雄市,三民區,1073,427,220,647,29,676,1057,63.95%,40.4%,1
高雄市,三民區,1074,351,200,551,21,572,971,58.91%,36.15%,1
高雄市,三民區,1075,383,242,625,17,642,1062,60.45%,36.06%,1
高雄市,新興區,1098,291,186,477,24,501,828,60.51%,35.14%,1
高雄市,新興區,1099,402,203,605,34,639,963,66.36%,41.74%,1
高雄市,新興區,1100,366,238,604,19,623,1075,57.95%,34.05%,1
高雄市,新興區,1101,540,346,886,16,902,1488,60.62%,36.29%,1
高雄市,新興區,1102,490,363,853,29,882,1438,61.34%,34.08%,1
高雄市,新興區,1103,358,262,620,27,647,1049,61.68%,34.13%,1
高雄市,新興區,1104,539,333,872,55,927,1378,67.27%,39.11%,1
高雄市,新興區,1105,263,157,420,27,447,666,67.12%,39.49%,1
高雄市,新興區,1106,348,243,591,12,603,981,61.47%,35.47%,1
高雄市,新興區,1107,364,234,598,22,620,933,66.45%,39.01%,1
高雄市,新興區,1108,380,198,578,19,597,987,60.49%,38.5%,1
高雄市,新興區,1109,399,214,613,21,634,988,64.17%,40.38%,1
高雄市,新興區,1110,302,169,471,25,496,735,67.48%,41.09%,1
高雄市,新興區,1111,489,298,787,21,808,1317,61.35%,37.13%,1
高雄市,新興區,1112,293,169,462,21,483,800,60.38%,36.63%,1
高雄市,新興區,1113,411,196,607,26,633,968,65.39%,42.46%,1
高雄市,新興區,1114,395,178,573,11,584,913,63.96%,43.26%,1
高雄市,新興區,1115,547,350,897,20,917,1389,66.02%,39.38%,1
高雄市,新興區,1116,483,330,813,25,838,1228,68.24%,39.33%,1
高雄市,新興區,1117,492,256,748,29,777,1211,64.16%,40.63%,1
高雄市,新興區,1118,458,236,694,16,710,1101,64.49%,41.6%,1
高雄市,新興區,1119,308,172,480,11,491,752,65.29%,40.96%,1
高雄市,新興區,1120,386,208,594,27,621,873,71.13%,44.22%,1
高雄市,新興區,1121,602,400,1002,22,1024,1609,63.64%,37.41%,1
高雄市,新興區,1122,669,412,1081,29,1110,1736,63.94%,38.54%,1
高雄市,新興區,1123,467,271,738,18,756,1258,60.1%,37.12%,1
高雄市,新興區,1124,421,255,676,25,701,1105,63.44%,38.1%,1
高雄市,新興區,1125,331,186,517,33,550,851,64.63%,38.9%,1
高雄市,新興區,1126,379,236,615,34,649,1011,64.19%,37.49%,1
高雄市,新興區,1127,373,224,597,42,639,888,71.96%,42%,1
高雄市,新興區,1128,377,229,606,23,629,1005,62.59%,37.51%,1
高雄市,新興區,1129,410,215,625,21,646,1375,46.98%,29.82%,1
高雄市,新興區,1130,518,316,834,30,864,1388,62.25%,37.32%,1
高雄市,新興區,1131,262,158,420,24,444,719,61.75%,36.44%,1
高雄市,新興區,1132,392,227,619,42,661,1077,61.37%,36.4%,1
高雄市,新興區,1133,306,155,461,11,472,875,53.94%,34.97%,1
高雄市,新興區,1134,347,187,534,19,553,936,59.08%,37.07%,1
高雄市,新興區,1135,371,174,545,27,572,944,60.59%,39.3%,1
高雄市,新興區,1136,314,161,475,19,494,833,59.3%,37.7%,1
高雄市,新興區,1137,298,145,443,14,457,708,64.55%,42.09%,1
高雄市,新興區,1138,262,164,426,15,441,741,59.51%,35.36%,1
高雄市,新興區,1139,443,252,695,23,718,1235,58.14%,35.87%,1
高雄市,前金區,1076,257,152,409,13,422,673,62.7%,38.19%,1
高雄市,前金區,1077,372,247,619,24,643,1022,62.92%,36.4%,1
高雄市,前金區,1078,526,250,776,19,795,1324,60.05%,39.73%,1
高雄市,前金區,1079,221,175,396,28,424,839,50.54%,26.34%,1
高雄市,前金區,1080,343,125,468,33,501,975,51.38%,35.18%,1
高雄市,前金區,1081,669,363,1032,46,1078,1806,59.69%,37.04%,1
高雄市,前金區,1082,686,364,1050,30,1080,1781,60.64%,38.52%,1
高雄市,前金區,1083,274,163,437,24,461,717,64.3%,38.21%,1
高雄市,前金區,1084,409,239,648,13,661,1097,60.26%,37.28%,1
高雄市,前金區,1085,601,364,965,20,985,1633,60.32%,36.8%,1
高雄市,前金區,1086,312,189,501,18,519,759,68.38%,41.11%,1
高雄市,前金區,1087,365,227,592,34,626,948,66.03%,38.5%,1
高雄市,前金區,1088,327,210,537,31,568,1009,56.29%,32.41%,1
高雄市,前金區,1089,343,225,568,29,597,945,63.17%,36.3%,1
高雄市,前金區,1090,295,185,480,12,492,772,63.73%,38.21%,1
高雄市,前金區,1091,271,199,470,24,494,757,65.26%,35.8%,1
高雄市,前金區,1092,413,242,655,29,684,1047,65.33%,39.45%,1
高雄市,前金區,1093,379,227,606,27,633,985,64.26%,38.48%,1
高雄市,前金區,1094,600,343,943,21,964,1674,57.59%,35.84%,1
高雄市,前金區,1095,402,226,628,32,660,1088,60.66%,36.95%,1
高雄市,前金區,1096,352,213,565,44,609,893,68.2%,39.42%,1
高雄市,前金區,1097,462,259,721,17,738,1184,62.33%,39.02%,1
高雄市,苓雅區,1140,300,145,445,14,459,718,63.93%,41.78%,1
高雄市,苓雅區,1141,565,280,845,40,885,1492,59.32%,37.87%,1
高雄市,苓雅區,1142,462,269,731,33,764,1210,63.14%,38.18%,1
高雄市,苓雅區,1143,602,291,893,26,919,1617,56.83%,37.23%,1
高雄市,苓雅區,1144,552,295,847,53,900,1428,63.03%,38.66%,1
高雄市,苓雅區,1145,497,285,782,35,817,1444,56.58%,34.42%,1
高雄市,苓雅區,1146,537,281,818,51,869,1452,59.85%,36.98%,1
高雄市,苓雅區,1147,239,107,346,14,360,554,64.98%,43.14%,1
高雄市,苓雅區,1148,334,214,548,21,569,950,59.89%,35.16%,1
高雄市,苓雅區,1149,364,184,548,18,566,978,57.87%,37.22%,1
高雄市,苓雅區,1150,593,313,906,25,931,1673,55.65%,35.45%,1
高雄市,苓雅區,1151,681,417,1098,36,1134,2045,55.45%,33.3%,1
高雄市,苓雅區,1152,383,189,572,35,607,939,64.64%,40.79%,1
高雄市,苓雅區,1153,434,267,701,23,724,1284,56.39%,33.8%,1
高雄市,苓雅區,1154,377,182,559,15,574,908,63.22%,41.52%,1
高雄市,苓雅區,1155,278,197,475,16,491,838,58.59%,33.17%,1
高雄市,苓雅區,1156,469,293,762,30,792,1267,62.51%,37.02%,1
高雄市,苓雅區,1157,427,203,630,36,666,994,67%,42.96%,1
高雄市,苓雅區,1158,301,161,462,20,482,774,62.27%,38.89%,1
高雄市,苓雅區,1159,423,250,673,23,696,1121,62.09%,37.73%,1
高雄市,苓雅區,1160,526,343,869,32,901,1474,61.13%,35.69%,1
高雄市,苓雅區,1161,564,345,909,35,944,1525,61.9%,36.98%,1
高雄市,苓雅區,1162,438,264,702,23,725,1147,63.21%,38.19%,1
高雄市,苓雅區,1163,402,232,634,32,666,1014,65.68%,39.64%,1
高雄市,苓雅區,1164,537,350,887,36,923,1496,61.7%,35.9%,1
高雄市,苓雅區,1165,592,317,909,52,961,1499,64.11%,39.49%,1
高雄市,苓雅區,1166,460,245,705,32,737,1138,64.76%,40.42%,1
高雄市,苓雅區,1167,380,179,559,28,587,839,69.96%,45.29%,1
高雄市,苓雅區,1168,428,299,727,29,756,2088,36.21%,20.5%,1
高雄市,苓雅區,1169,622,380,1002,24,1026,1648,62.26%,37.74%,1
高雄市,苓雅區,1170,585,349,934,28,962,1623,59.27%,36.04%,1
高雄市,苓雅區,1171,777,436,1213,47,1260,1932,65.22%,40.22%,1
高雄市,苓雅區,1172,442,285,727,21,748,1127,66.37%,39.22%,1
高雄市,苓雅區,1173,533,276,809,17,826,1156,71.45%,46.11%,1
高雄市,苓雅區,1174,613,328,941,26,967,1465,66.01%,41.84%,1
高雄市,苓雅區,1175,265,124,389,16,405,690,58.7%,38.41%,1
高雄市,苓雅區,1176,504,245,749,49,798,1283,62.2%,39.28%,1
高雄市,苓雅區,1177,534,310,844,40,884,1432,61.73%,37.29%,1
高雄市,苓雅區,1178,539,274,813,15,828,1313,63.06%,41.05%,1
高雄市,苓雅區,1179,568,323,891,34,925,1579,58.58%,35.97%,1
高雄市,苓雅區,1180,542,295,837,43,880,1385,63.54%,39.13%,1
高雄市,苓雅區,1181,606,294,900,30,930,1449,64.18%,41.82%,1
高雄市,苓雅區,1182,700,428,1128,35,1163,1834,63.41%,38.17%,1
高雄市,苓雅區,1183,573,320,893,33,926,1436,64.48%,39.9%,1
高雄市,苓雅區,1184,579,312,891,42,933,1431,65.2%,40.46%,1
高雄市,苓雅區,1185,523,286,809,23,832,1248,66.67%,41.91%,1
高雄市,苓雅區,1186,570,340,910,34,944,1470,64.22%,38.78%,1
高雄市,苓雅區,1187,642,345,987,36,1023,1540,66.43%,41.69%,1
高雄市,苓雅區,1188,576,305,881,23,904,1374,65.79%,41.92%,1
高雄市,苓雅區,1189,349,203,552,16,568,839,67.7%,41.6%,1
高雄市,苓雅區,1190,405,268,673,20,693,1022,67.81%,39.63%,1
高雄市,苓雅區,1191,442,253,695,6,701,1062,66.01%,41.62%,1
高雄市,苓雅區,1192,400,275,675,13,688,1078,63.82%,37.11%,1
高雄市,苓雅區,1193,492,241,733,16,749,1117,67.05%,44.05%,1
高雄市,苓雅區,1194,630,310,940,40,980,1516,64.64%,41.56%,1
高雄市,苓雅區,1195,514,308,822,75,897,1440,62.29%,35.69%,1
高雄市,苓雅區,1196,311,195,506,24,530,839,63.17%,37.07%,1
高雄市,苓雅區,1197,319,204,523,17,540,888,60.81%,35.92%,1
高雄市,苓雅區,1198,448,268,716,16,732,1101,66.49%,40.69%,1
高雄市,苓雅區,1199,450,243,693,29,722,1004,71.91%,44.82%,1
高雄市,苓雅區,1200,551,323,874,28,902,1427,63.21%,38.61%,1
高雄市,苓雅區,1201,470,251,721,19,740,1168,63.36%,40.24%,1
高雄市,苓雅區,1202,481,286,767,30,797,1184,67.31%,40.63%,1
高雄市,苓雅區,1203,421,214,635,14,649,974,66.63%,43.22%,1
高雄市,苓雅區,1204,288,186,474,10,484,849,57.01%,33.92%,1
高雄市,苓雅區,1205,708,381,1089,31,1120,1821,61.5%,38.88%,1
高雄市,苓雅區,1206,494,304,798,32,830,1306,63.55%,37.83%,1
高雄市,苓雅區,1207,471,292,763,12,775,1185,65.4%,39.75%,1
高雄市,苓雅區,1208,539,303,842,29,871,1415,61.55%,38.09%,1
高雄市,苓雅區,1209,369,256,625,26,651,962,67.67%,38.36%,1
高雄市,苓雅區,1210,357,218,575,26,601,964,62.34%,37.03%,1
高雄市,苓雅區,1211,589,337,926,28,954,1524,62.6%,38.65%,1
高雄市,苓雅區,1212,550,347,897,26,923,1455,63.44%,37.8%,1
高雄市,苓雅區,1213,476,235,711,26,737,1272,57.94%,37.42%,1
高雄市,苓雅區,1214,481,266,747,18,765,1256,60.91%,38.3%,1
高雄市,苓雅區,1215,484,223,707,25,732,1203,60.85%,40.23%,1
高雄市,苓雅區,1216,436,232,668,27,695,1062,65.44%,41.05%,1
高雄市,苓雅區,1217,336,199,535,44,579,850,68.12%,39.53%,1
高雄市,苓雅區,1218,406,235,641,57,698,1010,69.11%,40.2%,1
高雄市,苓雅區,1219,402,244,646,22,668,1118,59.75%,35.96%,1
高雄市,苓雅區,1220,375,199,574,32,606,937,64.67%,40.02%,1
高雄市,苓雅區,1221,538,296,834,15,849,1493,56.87%,36.03%,1
高雄市,苓雅區,1222,435,298,733,30,763,1183,64.5%,36.77%,1
高雄市,苓雅區,1223,458,282,740,28,768,1318,58.27%,34.75%,1
高雄市,苓雅區,1224,495,308,803,34,837,1362,61.45%,36.34%,1
高雄市,苓雅區,1225,408,237,645,45,690,1102,62.61%,37.02%,1
高雄市,苓雅區,1226,533,335,868,33,901,1481,60.84%,35.99%,1
高雄市,苓雅區,1227,347,214,561,28,589,878,67.08%,39.52%,1
高雄市,苓雅區,1228,359,158,517,16,533,908,58.7%,39.54%,1
高雄市,苓雅區,1229,417,260,677,26,703,1056,66.57%,39.49%,1
高雄市,苓雅區,1230,427,210,637,20,657,1091,60.22%,39.14%,1
高雄市,苓雅區,1231,387,224,611,23,634,976,64.96%,39.65%,1
高雄市,苓雅區,1232,429,264,693,25,718,1063,67.54%,40.36%,1
高雄市,苓雅區,1233,579,333,912,34,946,1484,63.75%,39.02%,1
高雄市,苓雅區,1234,512,278,790,24,814,1290,63.1%,39.69%,1
高雄市,苓雅區,1235,664,381,1045,35,1080,1740,62.07%,38.16%,1
高雄市,苓雅區,1236,617,331,948,31,979,1594,61.42%,38.71%,1
高雄市,苓雅區,1237,567,386,953,18,971,1648,58.92%,34.41%,1
高雄市,苓雅區,1238,523,256,779,33,812,1236,65.7%,42.31%,1
高雄市,苓雅區,1239,473,274,747,19,766,1211,63.25%,39.06%,1
高雄市,苓雅區,1240,506,272,778,21,799,1283,62.28%,39.44%,1
高雄市,苓雅區,1241,730,384,1114,41,1155,1804,64.02%,40.47%,1
高雄市,苓雅區,1242,654,385,1039,36,1075,1718,62.57%,38.07%,1
高雄市,苓雅區,1243,505,284,789,35,824,1297,63.53%,38.94%,1
高雄市,苓雅區,1244,541,302,843,57,900,1449,62.11%,37.34%,1
高雄市,苓雅區,1245,511,273,784,16,800,1307,61.21%,39.1%,1
高雄市,苓雅區,1246,472,259,731,26,757,1184,63.94%,39.86%,1
高雄市,苓雅區,1247,486,316,802,38,840,1250,67.2%,38.88%,1
高雄市,苓雅區,1248,440,282,722,20,742,1248,59.46%,35.26%,1
高雄市,苓雅區,1249,520,273,793,19,812,1283,63.29%,40.53%,1
高雄市,苓雅區,1250,481,248,729,17,746,1121,66.55%,42.91%,1
高雄市,苓雅區,1251,512,261,773,24,797,1258,63.35%,40.7%,1
高雄市,苓雅區,1252,533,286,819,20,839,1339,62.66%,39.81%,1
高雄市,苓雅區,1253,720,410,1130,46,1176,1986,59.21%,36.25%,1
高雄市,苓雅區,1254,427,196,623,22,645,1028,62.74%,41.54%,1
高雄市,苓雅區,1255,438,160,598,12,610,948,64.35%,46.2%,1
高雄市,前鎮區,1484,655,339,994,68,1062,1809,58.71%,36.21%,1
高雄市,前鎮區,1485,616,327,943,48,991,1835,54.01%,33.57%,1
高雄市,前鎮區,1486,501,294,795,46,841,1890,44.5%,26.51%,1
高雄市,前鎮區,1487,583,408,991,46,1037,2013,51.52%,28.96%,1
高雄市,前鎮區,1488,560,354,914,38,952,1776,53.6%,31.53%,1
高雄市,前鎮區,1489,464,329,793,50,843,1705,49.44%,27.21%,1
高雄市,前鎮區,1490,241,135,376,45,421,672,62.65%,35.86%,1
高雄市,前鎮區,1491,521,306,827,45,872,1726,50.52%,30.19%,1
高雄市,前鎮區,1492,532,388,920,20,940,1597,58.86%,33.31%,1
高雄市,前鎮區,1493,618,337,955,50,1005,1690,59.47%,36.57%,1
高雄市,前鎮區,1494,413,221,634,51,685,1080,63.43%,38.24%,1
高雄市,前鎮區,1495,468,274,742,36,778,1159,67.13%,40.38%,1
高雄市,前鎮區,1496,472,254,726,41,767,1314,58.37%,35.92%,1
高雄市,前鎮區,1497,350,192,542,33,575,896,64.17%,39.06%,1
高雄市,前鎮區,1498,339,240,579,27,606,1002,60.48%,33.83%,1
高雄市,前鎮區,1499,679,361,1040,62,1102,2765,39.86%,24.56%,1
高雄市,前鎮區,1500,225,129,354,32,386,600,64.33%,37.5%,1
高雄市,前鎮區,1501,388,182,570,29,599,1466,40.86%,26.47%,1
高雄市,前鎮區,1502,537,295,832,39,871,1449,60.11%,37.06%,1
高雄市,前鎮區,1503,366,180,546,25,571,991,57.62%,36.93%,1
高雄市,前鎮區,1504,475,244,719,50,769,1248,61.62%,38.06%,1
高雄市,前鎮區,1505,414,232,646,54,700,1066,65.67%,38.84%,1
高雄市,前鎮區,1506,266,145,411,18,429,706,60.76%,37.68%,1
高雄市,前鎮區,1507,234,162,396,20,416,713,58.35%,32.82%,1
高雄市,前鎮區,1508,479,264,743,32,775,1344,57.66%,35.64%,1
高雄市,前鎮區,1509,328,179,507,36,543,856,63.43%,38.32%,1
高雄市,前鎮區,1510,299,189,488,23,511,873,58.53%,34.25%,1
高雄市,前鎮區,1511,409,212,621,33,654,1114,58.71%,36.71%,1
高雄市,前鎮區,1512,404,211,615,17,632,1112,56.83%,36.33%,1
高雄市,前鎮區,1513,363,225,588,31,619,1044,59.29%,34.77%,1
高雄市,前鎮區,1514,310,194,504,24,528,940,56.17%,32.98%,1
高雄市,前鎮區,1515,407,275,682,43,725,1342,54.02%,30.33%,1
高雄市,前鎮區,1516,547,348,895,39,934,1402,66.62%,39.02%,1
高雄市,前鎮區,1517,473,320,793,28,821,1320,62.2%,35.83%,1
高雄市,前鎮區,1518,333,208,541,39,580,958,60.54%,34.76%,1
高雄市,前鎮區,1519,558,303,861,20,881,1276,69.04%,43.73%,1
高雄市,前鎮區,1520,582,304,886,39,925,1459,63.4%,39.89%,1
高雄市,前鎮區,1521,250,143,393,18,411,761,54.01%,32.85%,1
高雄市,前鎮區,1522,374,248,622,19,641,1093,58.65%,34.22%,1
高雄市,前鎮區,1523,679,252,931,38,969,1521,63.71%,44.64%,1
高雄市,前鎮區,1524,661,286,947,26,973,1557,62.49%,42.45%,1
高雄市,前鎮區,1525,629,330,959,31,990,1821,54.37%,34.54%,1
高雄市,前鎮區,1526,504,197,701,36,737,1066,69.14%,47.28%,1
高雄市,前鎮區,1527,493,176,669,11,680,1046,65.01%,47.13%,1
高雄市,前鎮區,1528,597,376,973,38,1011,1709,59.16%,34.93%,1
高雄市,前鎮區,1529,654,361,1015,49,1064,1723,61.75%,37.96%,1
高雄市,前鎮區,1530,463,302,765,26,791,1202,65.81%,38.52%,1
高雄市,前鎮區,1531,524,327,851,28,879,1279,68.73%,40.97%,1
高雄市,前鎮區,1532,615,341,956,24,980,1513,64.77%,40.65%,1
高雄市,前鎮區,1533,473,275,748,21,769,1260,61.03%,37.54%,1
高雄市,前鎮區,1534,450,263,713,51,764,1139,67.08%,39.51%,1
高雄市,前鎮區,1535,469,267,736,32,768,1140,67.37%,41.14%,1
高雄市,前鎮區,1536,501,392,893,46,939,1462,64.23%,34.27%,1
高雄市,前鎮區,1537,531,288,819,34,853,1359,62.77%,39.07%,1
高雄市,前鎮區,1538,670,370,1040,51,1091,2037,53.56%,32.89%,1
高雄市,前鎮區,1539,504,299,803,19,822,1410,58.3%,35.74%,1
高雄市,前鎮區,1540,479,283,762,15,777,1307,59.45%,36.65%,1
高雄市,前鎮區,1541,514,315,829,59,888,1512,58.73%,33.99%,1
高雄市,前鎮區,1542,538,342,880,36,916,1491,61.44%,36.08%,1
高雄市,前鎮區,1543,601,311,912,43,955,1621,58.91%,37.08%,1
高雄市,前鎮區,1544,509,287,796,25,821,1522,53.94%,33.44%,1
高雄市,前鎮區,1545,553,363,916,52,968,1593,60.77%,34.71%,1
高雄市,前鎮區,1546,729,393,1122,50,1172,1885,62.18%,38.67%,1
高雄市,前鎮區,1547,702,402,1104,47,1151,1870,61.55%,37.54%,1
高雄市,前鎮區,1548,535,300,835,30,865,1388,62.32%,38.54%,1
高雄市,前鎮區,1549,518,291,809,35,844,1348,62.61%,38.43%,1
高雄市,前鎮區,1550,495,232,727,59,786,1341,58.61%,36.91%,1
高雄市,前鎮區,1551,544,315,859,31,890,1364,65.25%,39.88%,1
高雄市,前鎮區,1552,505,289,794,46,840,1367,61.45%,36.94%,1
高雄市,前鎮區,1553,489,279,768,40,808,1326,60.94%,36.88%,1
高雄市,前鎮區,1554,478,137,615,31,646,1059,61%,45.14%,1
高雄市,前鎮區,1555,522,167,689,14,703,1119,62.82%,46.65%,1
高雄市,前鎮區,1556,512,364,876,26,902,1565,57.64%,32.72%,1
高雄市,前鎮區,1557,564,320,884,44,928,1549,59.91%,36.41%,1
高雄市,前鎮區,1558,683,397,1080,21,1101,1691,65.11%,40.39%,1
高雄市,前鎮區,1559,700,381,1081,23,1104,1837,60.1%,38.11%,1
高雄市,前鎮區,1560,451,238,689,18,707,1092,64.74%,41.3%,1
高雄市,前鎮區,1561,423,254,677,38,715,1126,63.5%,37.57%,1
高雄市,前鎮區,1562,419,250,669,48,717,1215,59.01%,34.49%,1
高雄市,前鎮區,1563,537,335,872,24,896,1443,62.09%,37.21%,1
高雄市,前鎮區,1564,616,371,987,15,1002,1448,69.2%,42.54%,1
高雄市,前鎮區,1565,634,340,974,43,1017,1648,61.71%,38.47%,1
高雄市,前鎮區,1566,366,216,582,41,623,1603,38.86%,22.83%,1
高雄市,前鎮區,1567,523,281,804,32,836,1596,52.38%,32.77%,1
高雄市,前鎮區,1568,516,262,778,34,812,1450,56%,35.59%,1
高雄市,前鎮區,1569,530,266,796,61,857,1510,56.75%,35.1%,1
高雄市,前鎮區,1570,643,349,992,52,1044,1647,63.39%,39.04%,1
高雄市,前鎮區,1571,493,262,755,35,790,1342,58.87%,36.74%,1
高雄市,前鎮區,1572,494,263,757,30,787,1384,56.86%,35.69%,1
高雄市,前鎮區,1573,558,260,818,44,862,1479,58.28%,37.73%,1
高雄市,前鎮區,1574,604,315,919,22,941,1546,60.87%,39.07%,1
高雄市,前鎮區,1575,557,381,938,44,982,1595,61.57%,34.92%,1
高雄市,前鎮區,1576,467,252,719,35,754,1201,62.78%,38.88%,1
高雄市,前鎮區,1577,413,197,610,23,633,1082,58.5%,38.17%,1
高雄市,前鎮區,1578,342,202,544,26,570,996,57.23%,34.34%,1
高雄市,前鎮區,1579,284,281,565,29,594,932,63.73%,30.47%,1
高雄市,前鎮區,1580,408,264,672,33,705,1146,61.52%,35.6%,1
高雄市,前鎮區,1581,414,240,654,26,680,1096,62.04%,37.77%,1
高雄市,前鎮區,1582,535,334,869,12,881,1332,66.14%,40.17%,1
高雄市,前鎮區,1583,421,279,700,24,724,1175,61.62%,35.83%,1
高雄市,前鎮區,1584,363,204,567,39,606,986,61.46%,36.82%,1
高雄市,前鎮區,1585,487,287,774,52,826,1316,62.77%,37.01%,1
高雄市,前鎮區,1586,482,337,819,40,859,1559,55.1%,30.92%,1
高雄市,前鎮區,1587,626,330,956,47,1003,1622,61.84%,38.59%,1
高雄市,前鎮區,1588,557,225,782,25,807,1310,61.6%,42.52%,1
高雄市,前鎮區,1589,536,270,806,49,855,1299,65.82%,41.26%,1
高雄市,前鎮區,1590,522,247,769,32,801,1191,67.25%,43.83%,1
高雄市,前鎮區,1591,515,268,783,26,809,1375,58.84%,37.45%,1
高雄市,前鎮區,1592,494,291,785,33,818,1338,61.14%,36.92%,1
高雄市,前鎮區,1593,412,264,676,23,699,1175,59.49%,35.06%,1
高雄市,前鎮區,1594,473,296,769,18,787,1357,58%,34.86%,1
高雄市,前鎮區,1595,478,283,761,39,800,1187,67.4%,40.27%,1
高雄市,前鎮區,1596,457,229,686,27,713,1164,61.25%,39.26%,1
高雄市,前鎮區,1597,450,287,737,47,784,1219,64.32%,36.92%,1
高雄市,前鎮區,1598,524,281,805,19,824,1428,57.7%,36.69%,1
高雄市,前鎮區,1599,540,307,847,45,892,1495,59.67%,36.12%,1
高雄市,前鎮區,1600,574,371,945,30,975,1531,63.68%,37.49%,1
高雄市,前鎮區,1601,556,308,864,44,908,1509,60.17%,36.85%,1
高雄市,前鎮區,1602,588,301,889,46,935,1591,58.77%,36.96%,1
高雄市,旗津區,0869,447,260,707,43,750,1177,63.72%,37.98%,1
高雄市,旗津區,0870,390,185,575,33,608,1109,54.82%,35.17%,1
高雄市,旗津區,0871,502,314,816,22,838,1642,51.04%,30.57%,1
高雄市,旗津區,0872,409,205,614,59,673,1209,55.67%,33.83%,1
高雄市,旗津區,0873,359,200,559,35,594,1112,53.42%,32.28%,1
高雄市,旗津區,0874,571,272,843,44,887,1483,59.81%,38.5%,1
高雄市,旗津區,0875,463,239,702,32,734,1460,50.27%,31.71%,1
高雄市,旗津區,0876,574,331,905,96,1001,1572,63.68%,36.51%,1
高雄市,旗津區,0877,443,231,674,25,699,1384,50.51%,32.01%,1
高雄市,旗津區,0878,447,254,701,22,723,1390,52.01%,32.16%,1
高雄市,旗津區,0879,368,227,595,33,628,1239,50.69%,29.7%,1
高雄市,旗津區,0880,664,409,1073,51,1124,2045,54.96%,32.47%,1
高雄市,旗津區,0881,307,151,458,24,482,893,53.98%,34.38%,1
高雄市,旗津區,0882,585,344,929,58,987,1866,52.89%,31.35%,1
高雄市,旗津區,0883,548,304,852,29,881,1874,47.01%,29.24%,1
高雄市,旗津區,0884,257,168,425,37,462,893,51.74%,28.78%,1
高雄市,旗津區,0885,456,248,704,30,734,1215,60.41%,37.53%,1
高雄市,旗津區,0886,445,222,667,25,692,1297,53.35%,34.31%,1
高雄市,小港區,1603,465,235,700,21,721,1108,65.07%,41.97%,1
高雄市,小港區,1604,445,260,705,42,747,1171,63.79%,38%,1
高雄市,小港區,1605,546,406,952,20,972,1557,62.43%,35.07%,1
高雄市,小港區,1606,558,344,902,18,920,1668,55.16%,33.45%,1
高雄市,小港區,1607,515,242,757,20,777,1183,65.68%,43.53%,1
高雄市,小港區,1608,503,311,814,28,842,1372,61.37%,36.66%,1
高雄市,小港區,1609,644,379,1023,51,1074,1737,61.83%,37.08%,1
高雄市,小港區,1610,455,408,863,46,909,1586,57.31%,28.69%,1
高雄市,小港區,1611,530,300,830,35,865,1558,55.52%,34.02%,1
高雄市,小港區,1612,534,292,826,38,864,1284,67.29%,41.59%,1
高雄市,小港區,1613,454,288,742,36,778,1249,62.29%,36.35%,1
高雄市,小港區,1614,667,420,1087,54,1141,2400,47.54%,27.79%,1
高雄市,小港區,1615,497,251,748,24,772,1181,65.37%,42.08%,1
高雄市,小港區,1616,428,212,640,38,678,1079,62.84%,39.67%,1
高雄市,小港區,1617,438,320,758,34,792,1335,59.33%,32.81%,1
高雄市,小港區,1618,455,276,731,37,768,1241,61.89%,36.66%,1
高雄市,小港區,1619,540,309,849,35,884,1513,58.43%,35.69%,1
高雄市,小港區,1620,509,299,808,50,858,1349,63.6%,37.73%,1
高雄市,小港區,1621,528,306,834,38,872,1483,58.8%,35.6%,1
高雄市,小港區,1622,539,330,869,10,879,1451,60.58%,37.15%,1
高雄市,小港區,1623,416,259,675,22,697,1241,56.16%,33.52%,1
高雄市,小港區,1624,498,310,808,44,852,1262,67.51%,39.46%,1
高雄市,小港區,1625,669,402,1071,42,1113,1813,61.39%,36.9%,1
高雄市,小港區,1626,635,360,995,30,1025,1877,54.61%,33.83%,1
高雄市,小港區,1627,477,332,809,21,830,1391,59.67%,34.29%,1
高雄市,小港區,1628,566,330,896,25,921,1453,63.39%,38.95%,1
高雄市,小港區,1629,508,281,789,34,823,1374,59.9%,36.97%,1
高雄市,小港區,1630,511,275,786,21,807,1348,59.87%,37.91%,1
高雄市,小港區,1631,516,295,811,37,848,1334,63.57%,38.68%,1
高雄市,小港區,1632,488,343,831,23,854,1433,59.6%,34.05%,1
高雄市,小港區,1633,473,317,790,17,807,1448,55.73%,32.67%,1
高雄市,小港區,1634,571,342,913,50,963,1488,64.72%,38.37%,1
高雄市,小港區,1635,491,269,760,43,803,1278,62.83%,38.42%,1
高雄市,小港區,1636,555,329,884,28,912,1306,69.83%,42.5%,1
高雄市,小港區,1637,605,337,942,49,991,1625,60.98%,37.23%,1
高雄市,小港區,1638,600,400,1000,55,1055,1640,64.33%,36.59%,1
高雄市,小港區,1639,552,300,852,40,892,1506,59.23%,36.65%,1
高雄市,小港區,1640,508,259,767,43,810,1438,56.33%,35.33%,1
高雄市,小港區,1641,485,237,722,28,750,1105,67.87%,43.89%,1
高雄市,小港區,1642,430,221,651,18,669,1167,57.33%,36.85%,1
高雄市,小港區,1643,539,327,866,28,894,1420,62.96%,37.96%,1
高雄市,小港區,1644,507,350,857,55,912,1380,66.09%,36.74%,1
高雄市,小港區,1645,460,257,717,24,741,1239,59.81%,37.13%,1
高雄市,小港區,1646,644,291,935,41,976,1563,62.44%,41.2%,1
高雄市,小港區,1647,590,364,954,43,997,1644,60.64%,35.89%,1
高雄市,小港區,1648,705,359,1064,44,1108,1895,58.47%,37.2%,1
高雄市,小港區,1649,608,354,962,55,1017,1748,58.18%,34.78%,1
高雄市,小港區,1650,573,349,922,48,970,1579,61.43%,36.29%,1
高雄市,小港區,1651,739,432,1171,32,1203,2135,56.35%,34.61%,1
高雄市,小港區,1652,621,365,986,39,1025,1728,59.32%,35.94%,1
高雄市,小港區,1653,646,421,1067,41,1108,2022,54.8%,31.95%,1
高雄市,小港區,1654,460,211,671,24,695,1329,52.29%,34.61%,1
高雄市,小港區,1655,481,284,765,23,788,1320,59.7%,36.44%,1
高雄市,小港區,1656,452,296,748,39,787,1267,62.12%,35.67%,1
高雄市,小港區,1657,488,306,794,40,834,1298,64.25%,37.6%,1
高雄市,小港區,1658,506,307,813,20,833,1289,64.62%,39.26%,1
高雄市,小港區,1659,589,347,936,36,972,1534,63.36%,38.4%,1
高雄市,小港區,1660,574,307,881,35,916,1494,61.31%,38.42%,1
高雄市,小港區,1661,522,296,818,39,857,1377,62.24%,37.91%,1
高雄市,小港區,1662,523,311,834,28,862,1344,64.14%,38.91%,1
高雄市,小港區,1663,515,345,860,33,893,1508,59.22%,34.15%,1
高雄市,小港區,1664,501,286,787,25,812,1400,58%,35.79%,1
高雄市,小港區,1665,532,339,871,31,902,1457,61.91%,36.51%,1
高雄市,小港區,1666,482,288,770,20,790,1392,56.75%,34.63%,1
高雄市,小港區,1667,662,378,1040,73,1113,1983,56.13%,33.38%,1
高雄市,小港區,1668,432,269,701,19,720,1204,59.8%,35.88%,1
高雄市,小港區,1669,443,307,750,24,774,1300,59.54%,34.08%,1
高雄市,小港區,1670,677,423,1100,61,1161,1857,62.52%,36.46%,1
高雄市,小港區,1671,580,312,892,21,913,1566,58.3%,37.04%,1
高雄市,小港區,1672,500,336,836,46,882,1343,65.67%,37.23%,1
高雄市,小港區,1673,481,293,774,53,827,1236,66.91%,38.92%,1
高雄市,小港區,1674,593,344,937,59,996,1564,63.68%,37.92%,1
高雄市,小港區,1675,560,311,871,25,896,1484,60.38%,37.74%,1
高雄市,小港區,1676,540,338,878,19,897,1477,60.73%,36.56%,1
高雄市,小港區,1677,525,381,906,24,930,1482,62.75%,35.43%,1
高雄市,小港區,1678,589,350,939,29,968,1708,56.67%,34.48%,1
高雄市,小港區,1679,597,432,1029,49,1078,1867,57.74%,31.98%,1
高雄市,小港區,1680,548,381,929,26,955,1709,55.88%,32.07%,1
高雄市,小港區,1681,460,308,768,45,813,1425,57.05%,32.28%,1
高雄市,小港區,1682,518,292,810,32,842,1696,49.65%,30.54%,1
高雄市,小港區,1683,452,313,765,28,793,1522,52.1%,29.7%,1
高雄市,小港區,1684,508,332,840,64,904,1531,59.05%,33.18%,1
高雄市,小港區,1685,740,419,1159,75,1234,2215,55.71%,33.41%,1
高雄市,小港區,1686,555,324,879,32,911,1515,60.13%,36.63%,1
高雄市,小港區,1687,497,336,833,28,861,1535,56.09%,32.38%,1
高雄市,小港區,1688,423,290,713,18,731,1276,57.29%,33.15%,1
高雄市,小港區,1689,371,253,624,31,655,1217,53.82%,30.48%,1
高雄市,小港區,1690,526,295,821,48,869,1707,50.91%,30.81%,1
高雄市,小港區,1691,586,382,968,71,1039,1920,54.11%,30.52%,1
高雄市,鳳山區,1256,421,262,683,40,723,1080,66.94%,38.98%,1
高雄市,鳳山區,1257,331,166,497,25,522,819,63.74%,40.42%,1
高雄市,鳳山區,1258,341,167,508,32,540,851,63.45%,40.07%,1
高雄市,鳳山區,1259,390,271,661,23,684,1075,63.63%,36.28%,1
高雄市,鳳山區,1260,483,270,753,24,777,1223,63.53%,39.49%,1
高雄市,鳳山區,1261,486,239,725,30,755,1207,62.55%,40.27%,1
高雄市,鳳山區,1262,472,246,718,31,749,1339,55.94%,35.25%,1
高雄市,鳳山區,1263,373,250,623,26,649,1188,54.63%,31.4%,1
高雄市,鳳山區,1264,391,225,616,29,645,1055,61.14%,37.06%,1
高雄市,鳳山區,1265,414,202,616,38,654,1109,58.97%,37.33%,1
高雄市,鳳山區,1266,334,160,494,34,528,756,69.84%,44.18%,1
高雄市,鳳山區,1267,425,231,656,33,689,1182,58.29%,35.96%,1
高雄市,鳳山區,1268,532,332,864,39,903,1496,60.36%,35.56%,1
高雄市,鳳山區,1269,617,399,1016,39,1055,2094,50.38%,29.47%,1
高雄市,鳳山區,1270,577,338,915,28,943,1672,56.4%,34.51%,1
高雄市,鳳山區,1271,622,340,962,18,980,1761,55.65%,35.32%,1
高雄市,鳳山區,1272,541,282,823,51,874,1450,60.28%,37.31%,1
高雄市,鳳山區,1273,461,292,753,28,781,1455,53.68%,31.68%,1
高雄市,鳳山區,1274,450,260,710,32,742,1234,60.13%,36.47%,1
高雄市,鳳山區,1275,668,364,1032,44,1076,1713,62.81%,39%,1
高雄市,鳳山區,1276,606,325,931,35,966,1698,56.89%,35.69%,1
高雄市,鳳山區,1277,478,266,744,32,776,1247,62.23%,38.33%,1
高雄市,鳳山區,1278,387,273,660,20,680,1087,62.56%,35.6%,1
高雄市,鳳山區,1279,465,258,723,23,746,1199,62.22%,38.78%,1
高雄市,鳳山區,1280,616,243,859,44,903,1559,57.92%,39.51%,1
高雄市,鳳山區,1281,470,265,735,33,768,1233,62.29%,38.12%,1
高雄市,鳳山區,1282,470,230,700,29,729,1277,57.09%,36.81%,1
高雄市,鳳山區,1283,303,564,867,11,878,1481,59.28%,20.46%,1
高雄市,鳳山區,1284,452,291,743,16,759,1154,65.77%,39.17%,1
高雄市,鳳山區,1285,558,352,910,27,937,1475,63.53%,37.83%,1
高雄市,鳳山區,1286,426,238,664,26,690,1247,55.33%,34.16%,1
高雄市,鳳山區,1287,523,312,835,28,863,1538,56.11%,34.01%,1
高雄市,鳳山區,1288,409,232,641,19,660,1097,60.16%,37.28%,1
高雄市,鳳山區,1289,419,234,653,22,675,1221,55.28%,34.32%,1
高雄市,鳳山區,1290,432,260,692,41,733,1075,68.19%,40.19%,1
高雄市,鳳山區,1291,679,370,1049,29,1078,1751,61.56%,38.78%,1
高雄市,鳳山區,1292,652,411,1063,22,1085,1758,61.72%,37.09%,1
高雄市,鳳山區,1293,678,328,1006,39,1045,1749,59.75%,38.77%,1
高雄市,鳳山區,1294,630,342,972,16,988,1746,56.59%,36.08%,1
高雄市,鳳山區,1295,762,230,992,28,1020,1712,59.58%,44.51%,1
高雄市,鳳山區,1296,478,262,740,23,763,1247,61.19%,38.33%,1
高雄市,鳳山區,1297,536,398,934,36,970,1409,68.84%,38.04%,1
高雄市,鳳山區,1298,470,322,792,26,818,1347,60.73%,34.89%,1
高雄市,鳳山區,1299,636,373,1009,22,1031,1771,58.22%,35.91%,1
高雄市,鳳山區,1300,550,365,915,15,930,1537,60.51%,35.78%,1
高雄市,鳳山區,1301,621,341,962,23,985,1605,61.37%,38.69%,1
高雄市,鳳山區,1302,522,295,817,24,841,1375,61.16%,37.96%,1
高雄市,鳳山區,1303,556,293,849,35,884,1393,63.46%,39.91%,1
高雄市,鳳山區,1304,531,326,857,30,887,1584,56%,33.52%,1
高雄市,鳳山區,1305,231,137,368,19,387,618,62.62%,37.38%,1
高雄市,鳳山區,1306,180,89,269,7,276,423,65.25%,42.55%,1
高雄市,鳳山區,1307,478,275,753,48,801,1312,61.05%,36.43%,1
高雄市,鳳山區,1308,275,178,453,24,477,769,62.03%,35.76%,1
高雄市,鳳山區,1309,490,293,783,19,802,1213,66.12%,40.4%,1
高雄市,鳳山區,1310,501,226,727,24,751,1107,67.84%,45.26%,1
高雄市,鳳山區,1311,460,256,716,27,743,1188,62.54%,38.72%,1
高雄市,鳳山區,1312,443,288,731,24,755,1183,63.82%,37.45%,1
高雄市,鳳山區,1313,498,255,753,33,786,1264,62.18%,39.4%,1
高雄市,鳳山區,1314,366,175,541,17,558,882,63.27%,41.5%,1
高雄市,鳳山區,1315,425,246,671,37,708,1007,70.31%,42.2%,1
高雄市,鳳山區,1316,322,176,498,43,541,853,63.42%,37.75%,1
高雄市,鳳山區,1317,296,167,463,26,489,1660,29.46%,17.83%,1
高雄市,鳳山區,1318,435,231,666,37,703,1124,62.54%,38.7%,1
高雄市,鳳山區,1319,422,233,655,44,699,1112,62.86%,37.95%,1
高雄市,鳳山區,1320,414,243,657,28,685,1182,57.95%,35.03%,1
高雄市,鳳山區,1321,368,224,592,35,627,875,71.66%,42.06%,1
高雄市,鳳山區,1322,372,251,623,32,655,1040,62.98%,35.77%,1
高雄市,鳳山區,1323,436,271,707,15,722,1094,66%,39.85%,1
高雄市,鳳山區,1324,440,290,730,36,766,1217,62.94%,36.15%,1
高雄市,鳳山區,1325,410,230,640,25,665,974,68.28%,42.09%,1
高雄市,鳳山區,1326,364,218,582,29,611,987,61.9%,36.88%,1
高雄市,鳳山區,1327,528,261,789,13,802,1210,66.28%,43.64%,1
高雄市,鳳山區,1328,502,311,813,32,845,1391,60.75%,36.09%,1
高雄市,鳳山區,1329,394,242,636,17,653,1241,52.62%,31.75%,1
高雄市,鳳山區,1330,390,236,626,28,654,1000,65.4%,39%,1
高雄市,鳳山區,1331,446,218,664,20,684,1092,62.64%,40.84%,1
高雄市,鳳山區,1332,537,267,804,28,832,1308,63.61%,41.06%,1
高雄市,鳳山區,1333,412,200,612,38,650,1031,63.05%,39.96%,1
高雄市,鳳山區,1334,453,277,730,41,771,1159,66.52%,39.09%,1
高雄市,鳳山區,1335,429,214,643,30,673,1127,59.72%,38.07%,1
高雄市,鳳山區,1336,491,281,772,28,800,1109,72.14%,44.27%,1
高雄市,鳳山區,1337,751,405,1156,34,1190,1879,63.33%,39.97%,1
高雄市,鳳山區,1338,770,390,1160,37,1197,1803,66.39%,42.71%,1
高雄市,鳳山區,1339,730,344,1074,48,1122,2045,54.87%,35.7%,1
高雄市,鳳山區,1340,510,270,780,38,818,1432,57.12%,35.61%,1
高雄市,鳳山區,1341,403,215,618,12,630,1033,60.99%,39.01%,1
高雄市,鳳山區,1342,511,253,764,39,803,1253,64.09%,40.78%,1
高雄市,鳳山區,1343,473,258,731,19,750,1217,61.63%,38.87%,1
高雄市,鳳山區,1344,541,258,799,28,827,1267,65.27%,42.7%,1
高雄市,鳳山區,1345,474,249,723,35,758,1251,60.59%,37.89%,1
高雄市,鳳山區,1346,593,325,918,45,963,1563,61.61%,37.94%,1
高雄市,鳳山區,1347,711,415,1126,34,1160,1888,61.44%,37.66%,1
高雄市,鳳山區,1348,490,312,802,34,836,1368,61.11%,35.82%,1
高雄市,鳳山區,1349,557,307,864,31,895,1588,56.36%,35.08%,1
高雄市,鳳山區,1350,549,210,759,37,796,1255,63.43%,43.75%,1
高雄市,鳳山區,1351,477,247,724,45,769,1264,60.84%,37.74%,1
高雄市,鳳山區,1352,476,267,743,54,797,1291,61.74%,36.87%,1
高雄市,鳳山區,1353,501,237,738,14,752,1224,61.44%,40.93%,1
高雄市,鳳山區,1354,466,283,749,19,768,1296,59.26%,35.96%,1
高雄市,鳳山區,1355,351,178,529,30,559,826,67.68%,42.49%,1
高雄市,鳳山區,1356,516,213,729,26,755,1229,61.43%,41.99%,1
高雄市,鳳山區,1357,544,325,869,31,900,1467,61.35%,37.08%,1
高雄市,鳳山區,1358,480,242,722,29,751,1218,61.66%,39.41%,1
高雄市,鳳山區,1359,794,413,1207,46,1253,2173,57.66%,36.54%,1
高雄市,鳳山區,1360,876,410,1286,46,1332,2255,59.07%,38.85%,1
高雄市,鳳山區,1361,622,332,954,30,984,1556,63.24%,39.97%,1
高雄市,鳳山區,1362,552,282,834,31,865,1521,56.87%,36.29%,1
高雄市,鳳山區,1363,473,260,733,24,757,1407,53.8%,33.62%,1
高雄市,鳳山區,1364,623,279,902,39,941,1542,61.02%,40.4%,1
高雄市,鳳山區,1365,538,270,808,14,822,1502,54.73%,35.82%,1
高雄市,鳳山區,1366,525,267,792,34,826,1320,62.58%,39.77%,1
高雄市,鳳山區,1367,612,200,812,28,840,1507,55.74%,40.61%,1
高雄市,鳳山區,1368,590,210,800,31,831,1284,64.72%,45.95%,1
高雄市,鳳山區,1369,515,288,803,18,821,1441,56.97%,35.74%,1
高雄市,鳳山區,1370,642,247,889,43,932,1485,62.76%,43.23%,1
高雄市,鳳山區,1371,486,207,693,38,731,1205,60.66%,40.33%,1
高雄市,鳳山區,1372,485,239,724,20,744,1284,57.94%,37.77%,1
高雄市,鳳山區,1373,504,297,801,37,838,1326,63.2%,38.01%,1
高雄市,鳳山區,1374,418,234,652,31,683,1096,62.32%,38.14%,1
高雄市,鳳山區,1375,471,256,727,42,769,1182,65.06%,39.85%,1
高雄市,鳳山區,1376,239,426,665,38,703,1017,69.12%,23.5%,1
高雄市,鳳山區,1377,415,265,680,42,722,1198,60.27%,34.64%,1
高雄市,鳳山區,1378,444,262,706,32,738,1281,57.61%,34.66%,1
高雄市,鳳山區,1379,512,346,858,24,882,1358,64.95%,37.7%,1
高雄市,鳳山區,1380,517,286,803,30,833,1226,67.94%,42.17%,1
高雄市,鳳山區,1381,459,229,688,30,718,1098,65.39%,41.8%,1
高雄市,鳳山區,1382,456,272,728,27,755,1200,62.92%,38%,1
高雄市,鳳山區,1383,336,225,561,27,588,942,62.42%,35.67%,1
高雄市,鳳山區,1384,482,234,716,22,738,1206,61.19%,39.97%,1
高雄市,鳳山區,1385,465,276,741,22,763,1159,65.83%,40.12%,1
高雄市,鳳山區,1386,515,339,854,31,885,1401,63.17%,36.76%,1
高雄市,鳳山區,1387,532,325,857,20,877,1525,57.51%,34.89%,1
高雄市,鳳山區,1388,496,282,778,24,802,1345,59.63%,36.88%,1
高雄市,鳳山區,1389,469,276,745,26,771,1180,65.34%,39.75%,1
高雄市,鳳山區,1390,427,202,629,18,647,1106,58.5%,38.61%,1
高雄市,鳳山區,1391,572,309,881,44,925,1442,64.15%,39.67%,1
高雄市,鳳山區,1392,523,309,832,27,859,1376,62.43%,38.01%,1
高雄市,鳳山區,1393,484,265,749,24,773,1243,62.19%,38.94%,1
高雄市,鳳山區,1394,516,302,818,20,838,1361,61.57%,37.91%,1
高雄市,鳳山區,1395,553,310,863,27,890,1416,62.85%,39.05%,1
高雄市,鳳山區,1396,604,386,990,30,1020,1536,66.41%,39.32%,1
高雄市,鳳山區,1397,494,268,762,23,785,1388,56.56%,35.59%,1
高雄市,鳳山區,1398,510,239,749,47,796,1241,64.14%,41.1%,1
高雄市,鳳山區,1399,560,293,853,33,886,1394,63.56%,40.17%,1
高雄市,鳳山區,1400,496,286,782,12,794,1188,66.84%,41.75%,1
高雄市,鳳山區,1401,469,241,710,21,731,1112,65.74%,42.18%,1
高雄市,鳳山區,1402,461,297,758,28,786,1198,65.61%,38.48%,1
高雄市,鳳山區,1403,532,312,844,23,867,1475,58.78%,36.07%,1
高雄市,鳳山區,1404,442,246,688,31,719,1216,59.13%,36.35%,1
高雄市,鳳山區,1405,473,257,730,22,752,1318,57.06%,35.89%,1
高雄市,鳳山區,1406,549,304,853,27,880,1465,60.07%,37.47%,1
高雄市,鳳山區,1407,474,212,686,30,716,1314,54.49%,36.07%,1
高雄市,鳳山區,1408,525,336,861,25,886,1649,53.73%,31.84%,1
高雄市,鳳山區,1409,515,323,838,81,919,1601,57.4%,32.17%,1
高雄市,鳳山區,1410,446,233,679,22,701,1155,60.69%,38.61%,1
高雄市,鳳山區,1411,420,196,616,38,654,1050,62.29%,40%,1
高雄市,鳳山區,1412,504,262,766,23,789,1417,55.68%,35.57%,1
高雄市,鳳山區,1413,574,285,859,40,899,1525,58.95%,37.64%,1
高雄市,鳳山區,1414,599,305,904,33,937,1514,61.89%,39.56%,1
高雄市,鳳山區,1415,437,251,688,24,712,1190,59.83%,36.72%,1
高雄市,鳳山區,1416,475,264,739,20,759,1325,57.28%,35.85%,1
高雄市,鳳山區,1417,404,232,636,30,666,1049,63.49%,38.51%,1
高雄市,鳳山區,1418,407,219,626,23,649,1026,63.26%,39.67%,1
高雄市,鳳山區,1419,441,242,683,46,729,1152,63.28%,38.28%,1
高雄市,鳳山區,1420,449,232,681,15,696,1254,55.5%,35.81%,1
高雄市,鳳山區,1421,591,310,901,30,931,1688,55.15%,35.01%,1
高雄市,鳳山區,1422,667,297,964,34,998,1657,60.23%,40.25%,1
高雄市,鳳山區,1423,565,331,896,31,927,1729,53.61%,32.68%,1
高雄市,鳳山區,1424,600,369,969,27,996,1628,61.18%,36.86%,1
高雄市,鳳山區,1425,621,351,972,15,987,1891,52.19%,32.84%,1
高雄市,鳳山區,1426,606,354,960,31,991,1594,62.17%,38.02%,1
高雄市,鳳山區,1427,554,304,858,19,877,1342,65.35%,41.28%,1
高雄市,鳳山區,1428,552,368,920,26,946,1448,65.33%,38.12%,1
高雄市,鳳山區,1429,518,324,842,40,882,1405,62.78%,36.87%,1
高雄市,鳳山區,1430,469,224,693,32,725,1097,66.09%,42.75%,1
高雄市,鳳山區,1431,487,291,778,46,824,1248,66.03%,39.02%,1
高雄市,鳳山區,1432,483,251,734,30,764,1225,62.37%,39.43%,1
高雄市,鳳山區,1433,497,240,737,21,758,1214,62.44%,40.94%,1
高雄市,鳳山區,1434,785,450,1235,50,1285,2032,63.24%,38.63%,1
高雄市,鳳山區,1435,758,366,1124,39,1163,1927,60.35%,39.34%,1
高雄市,鳳山區,1436,837,429,1266,41,1307,2097,62.33%,39.91%,1
高雄市,鳳山區,1437,352,188,540,38,578,968,59.71%,36.36%,1
高雄市,鳳山區,1438,424,235,659,35,694,1200,57.83%,35.33%,1
高雄市,鳳山區,1439,401,241,642,34,676,1101,61.4%,36.42%,1
高雄市,鳳山區,1440,474,271,745,25,770,1369,56.25%,34.62%,1
高雄市,鳳山區,1441,572,325,897,42,939,1542,60.89%,37.09%,1
高雄市,鳳山區,1442,599,315,914,54,968,1536,63.02%,39%,1
高雄市,鳳山區,1443,495,288,783,22,805,1382,58.25%,35.82%,1
高雄市,鳳山區,1444,510,325,835,53,888,1452,61.16%,35.12%,1
高雄市,鳳山區,1445,380,236,616,29,645,1058,60.96%,35.92%,1
高雄市,鳳山區,1446,409,191,600,33,633,976,64.86%,41.91%,1
高雄市,鳳山區,1447,523,288,811,22,833,1545,53.92%,33.85%,1
高雄市,鳳山區,1448,419,235,654,28,682,1143,59.67%,36.66%,1
高雄市,鳳山區,1449,233,133,366,7,373,1301,28.67%,17.91%,1
高雄市,鳳山區,1450,420,251,671,28,699,1250,55.92%,33.6%,1
高雄市,鳳山區,1451,432,262,694,24,718,1208,59.44%,35.76%,1
高雄市,鳳山區,1452,455,252,707,36,743,1202,61.81%,37.85%,1
高雄市,鳳山區,1453,485,335,820,54,874,1499,58.31%,32.35%,1
高雄市,鳳山區,1454,548,291,839,22,861,1522,56.57%,36.01%,1
高雄市,鳳山區,1455,446,269,715,32,747,1125,66.4%,39.64%,1
高雄市,鳳山區,1456,396,390,786,16,802,1307,61.36%,30.3%,1
高雄市,鳳山區,1457,528,282,810,40,850,1405,60.5%,37.58%,1
高雄市,鳳山區,1458,485,257,742,41,783,1252,62.54%,38.74%,1
高雄市,鳳山區,1459,505,299,804,24,828,1291,64.14%,39.12%,1
高雄市,鳳山區,1460,376,198,574,34,608,938,64.82%,40.09%,1
高雄市,鳳山區,1461,654,394,1048,29,1077,1783,60.4%,36.68%,1
高雄市,鳳山區,1462,404,274,678,30,708,1105,64.07%,36.56%,1
高雄市,鳳山區,1463,519,266,785,49,834,1392,59.91%,37.28%,1
高雄市,鳳山區,1464,508,290,798,34,832,1244,66.88%,40.84%,1
高雄市,鳳山區,1465,434,230,664,24,688,1154,59.62%,37.61%,1
高雄市,鳳山區,1466,437,230,667,41,708,1153,61.41%,37.9%,1
高雄市,鳳山區,1467,404,214,618,19,637,1148,55.49%,35.19%,1
高雄市,鳳山區,1468,533,234,767,60,827,1432,57.75%,37.22%,1
高雄市,鳳山區,1469,407,232,639,19,658,1429,46.05%,28.48%,1
高雄市,鳳山區,1470,522,309,831,19,850,1479,57.47%,35.29%,1
高雄市,鳳山區,1471,431,219,650,20,670,1026,65.3%,42.01%,1
高雄市,鳳山區,1472,403,227,630,49,679,993,68.38%,40.58%,1
高雄市,鳳山區,1473,377,203,580,37,617,947,65.15%,39.81%,1
高雄市,鳳山區,1474,383,231,614,36,650,1042,62.38%,36.76%,1
高雄市,鳳山區,1475,411,225,636,33,669,1098,60.93%,37.43%,1
高雄市,鳳山區,1476,457,226,683,23,706,1284,54.98%,35.59%,1
高雄市,鳳山區,1477,421,251,672,39,711,1242,57.25%,33.9%,1
高雄市,鳳山區,1478,418,229,647,45,692,1093,63.31%,38.24%,1
高雄市,鳳山區,1479,452,294,746,37,783,1353,57.87%,33.41%,1
高雄市,鳳山區,1480,487,269,756,16,772,1353,57.06%,35.99%,1
高雄市,鳳山區,1481,499,273,772,31,803,1309,61.34%,38.12%,1
高雄市,鳳山區,1482,568,365,933,46,979,1627,60.17%,34.91%,1
高雄市,鳳山區,1483,522,282,804,49,853,1372,62.17%,38.05%,1
高雄市,林園區,1773,458,278,736,39,775,1262,61.41%,36.29%,1
高雄市,林園區,1774,488,313,801,56,857,1562,54.87%,31.24%,1
高雄市,林園區,1775,392,227,619,22,641,1078,59.46%,36.36%,1
高雄市,林園區,1776,355,238,593,35,628,979,64.15%,36.26%,1
高雄市,林園區,1777,387,257,644,39,683,1195,57.15%,32.38%,1
高雄市,林園區,1778,448,262,710,48,758,1380,54.93%,32.46%,1
高雄市,林園區,1779,428,256,684,48,732,1280,57.19%,33.44%,1
高雄市,林園區,1780,384,280,664,32,696,1269,54.85%,30.26%,1
高雄市,林園區,1781,445,246,691,17,708,1568,45.15%,28.38%,1
高雄市,林園區,1782,419,288,707,34,741,1226,60.44%,34.18%,1
高雄市,林園區,1783,515,265,780,45,825,1480,55.74%,34.8%,1
高雄市,林園區,1784,545,270,815,48,863,1459,59.15%,37.35%,1
高雄市,林園區,1785,511,320,831,46,877,1593,55.05%,32.08%,1
高雄市,林園區,1786,292,184,476,72,548,895,61.23%,32.63%,1
高雄市,林園區,1787,360,205,565,14,579,1110,52.16%,32.43%,1
高雄市,林園區,1788,410,277,687,44,731,1348,54.23%,30.42%,1
高雄市,林園區,1789,304,210,514,38,552,912,60.53%,33.33%,1
高雄市,林園區,1790,401,253,654,51,705,1085,64.98%,36.96%,1
高雄市,林園區,1791,346,191,537,21,558,955,58.43%,36.23%,1
高雄市,林園區,1792,332,177,509,36,545,879,62%,37.77%,1
高雄市,林園區,1793,357,241,598,49,647,1103,58.66%,32.37%,1
高雄市,林園區,1794,392,245,637,49,686,1054,65.09%,37.19%,1
高雄市,林園區,1795,399,255,654,20,674,1292,52.17%,30.88%,1
高雄市,林園區,1796,502,305,807,25,832,1683,49.44%,29.83%,1
高雄市,林園區,1797,208,121,329,24,353,607,58.15%,34.27%,1
高雄市,林園區,1798,331,211,542,53,595,1012,58.79%,32.71%,1
高雄市,林園區,1799,371,210,581,39,620,1046,59.27%,35.47%,1
高雄市,林園區,1800,263,167,430,18,448,914,49.02%,28.77%,1
高雄市,林園區,1801,483,309,792,44,836,1405,59.5%,34.38%,1
高雄市,林園區,1802,405,343,748,12,760,1299,58.51%,31.18%,1
高雄市,林園區,1803,423,236,659,32,691,1170,59.06%,36.15%,1
高雄市,林園區,1804,358,254,612,24,636,1299,48.96%,27.56%,1
高雄市,林園區,1805,369,205,574,22,596,1031,57.81%,35.79%,1
高雄市,林園區,1806,298,176,474,9,483,849,56.89%,35.1%,1
高雄市,林園區,1807,269,179,448,43,491,838,58.59%,32.1%,1
高雄市,林園區,1808,345,195,540,22,562,938,59.91%,36.78%,1
高雄市,林園區,1809,371,184,555,20,575,1051,54.71%,35.3%,1
高雄市,林園區,1810,271,190,461,25,486,786,61.83%,34.48%,1
高雄市,林園區,1811,332,187,519,43,562,894,62.86%,37.14%,1
高雄市,林園區,1812,197,119,316,22,338,749,45.13%,26.3%,1
高雄市,林園區,1813,535,337,872,29,901,1485,60.67%,36.03%,1
高雄市,林園區,1814,515,339,854,58,912,1478,61.71%,34.84%,1
高雄市,林園區,1815,490,348,838,34,872,1345,64.83%,36.43%,1
高雄市,林園區,1816,337,212,549,26,575,1038,55.39%,32.47%,1
高雄市,林園區,1817,407,281,688,13,701,1203,58.27%,33.83%,1
高雄市,林園區,1818,391,249,640,21,661,1138,58.08%,34.36%,1
高雄市,林園區,1819,343,180,523,9,532,1025,51.9%,33.46%,1
高雄市,林園區,1820,444,297,741,54,795,1341,59.28%,33.11%,1
高雄市,林園區,1821,366,211,577,17,594,1218,48.77%,30.05%,1
高雄市,林園區,1822,331,212,543,12,555,1147,48.39%,28.86%,1
高雄市,林園區,1823,376,196,572,22,594,1176,50.51%,31.97%,1
高雄市,大寮區,1692,226,145,371,23,394,727,54.2%,31.09%,1
高雄市,大寮區,1693,212,145,357,15,372,718,51.81%,29.53%,1
高雄市,大寮區,1694,462,241,703,30,733,1340,54.7%,34.48%,1
高雄市,大寮區,1695,446,282,728,28,756,1575,48%,28.32%,1
高雄市,大寮區,1696,143,102,245,18,263,444,59.23%,32.21%,1
高雄市,大寮區,1697,635,392,1027,38,1065,2374,44.86%,26.75%,1
高雄市,大寮區,1698,433,252,685,43,728,1291,56.39%,33.54%,1
高雄市,大寮區,1699,494,262,756,65,821,1400,58.64%,35.29%,1
高雄市,大寮區,1700,468,300,768,22,790,1390,56.83%,33.67%,1
高雄市,大寮區,1701,430,300,730,55,785,1401,56.03%,30.69%,1
高雄市,大寮區,1702,389,225,614,28,642,1199,53.54%,32.44%,1
高雄市,大寮區,1703,371,237,608,28,636,1210,52.56%,30.66%,1
高雄市,大寮區,1704,424,229,653,30,683,1195,57.15%,35.48%,1
高雄市,大寮區,1705,427,237,664,29,693,1166,59.43%,36.62%,1
高雄市,大寮區,1706,489,278,767,17,784,1353,57.95%,36.14%,1
高雄市,大寮區,1707,372,228,600,45,645,1052,61.31%,35.36%,1
高雄市,大寮區,1708,327,175,502,23,525,1024,51.27%,31.93%,1
高雄市,大寮區,1709,468,225,693,21,714,1189,60.05%,39.36%,1
高雄市,大寮區,1710,715,155,870,47,917,1512,60.65%,47.29%,1
高雄市,大寮區,1711,526,315,841,46,887,1633,54.32%,32.21%,1
高雄市,大寮區,1712,470,265,735,37,772,1214,63.59%,38.71%,1
高雄市,大寮區,1713,544,253,797,44,841,1258,66.85%,43.24%,1
高雄市,大寮區,1714,599,242,841,21,862,1323,65.15%,45.28%,1
高雄市,大寮區,1715,490,261,751,30,781,1253,62.33%,39.11%,1
高雄市,大寮區,1716,407,221,628,32,660,1035,63.77%,39.32%,1
高雄市,大寮區,1717,405,218,623,32,655,1106,59.22%,36.62%,1
高雄市,大寮區,1718,415,249,664,25,689,1195,57.66%,34.73%,1
高雄市,大寮區,1719,416,219,635,27,662,1051,62.99%,39.58%,1
高雄市,大寮區,1720,498,311,809,50,859,1425,60.28%,34.95%,1
高雄市,大寮區,1721,550,324,874,44,918,1635,56.15%,33.64%,1
高雄市,大寮區,1722,523,264,787,27,814,1359,59.9%,38.48%,1
高雄市,大寮區,1723,482,286,768,49,817,1361,60.03%,35.42%,1
高雄市,大寮區,1724,577,336,913,29,942,1629,57.83%,35.42%,1
高雄市,大寮區,1725,561,301,862,24,886,1518,58.37%,36.96%,1
高雄市,大寮區,1726,572,310,882,30,912,1620,56.3%,35.31%,1
高雄市,大寮區,1727,586,298,884,22,906,1648,54.98%,35.56%,1
高雄市,大寮區,1728,492,307,799,33,832,1385,60.07%,35.52%,1
高雄市,大寮區,1729,481,299,780,22,802,1435,55.89%,33.52%,1
高雄市,大寮區,1730,391,205,596,24,620,1046,59.27%,37.38%,1
高雄市,大寮區,1731,259,145,404,24,428,789,54.25%,32.83%,1
高雄市,大寮區,1732,297,172,469,23,492,909,54.13%,32.67%,1
高雄市,大寮區,1733,256,164,420,24,444,733,60.57%,34.92%,1
高雄市,大寮區,1734,518,307,825,32,857,1553,55.18%,33.35%,1
高雄市,大寮區,1735,311,195,506,21,527,922,57.16%,33.73%,1
高雄市,大寮區,1736,364,179,543,51,594,1012,58.7%,35.97%,1
高雄市,大寮區,1737,318,188,506,44,550,968,56.82%,32.85%,1
高雄市,大寮區,1738,407,207,614,20,634,1021,62.1%,39.86%,1
高雄市,大寮區,1739,480,252,732,44,776,1554,49.94%,30.89%,1
高雄市,大寮區,1740,425,226,651,39,690,1120,61.61%,37.95%,1
高雄市,大寮區,1741,454,281,735,31,766,1225,62.53%,37.06%,1
高雄市,大寮區,1742,322,176,498,17,515,1320,39.02%,24.39%,1
高雄市,大寮區,1743,476,248,724,40,764,1317,58.01%,36.14%,1
高雄市,大寮區,1744,396,219,615,25,640,1119,57.19%,35.39%,1
高雄市,大寮區,1745,454,250,704,25,729,1190,61.26%,38.15%,1
高雄市,大寮區,1746,446,276,722,36,758,1229,61.68%,36.29%,1
高雄市,大寮區,1747,479,246,725,31,756,1178,64.18%,40.66%,1
高雄市,大寮區,1748,478,280,758,39,797,1272,62.66%,37.58%,1
高雄市,大寮區,1749,526,268,794,17,811,1413,57.4%,37.23%,1
高雄市,大寮區,1750,451,260,711,30,741,1185,62.53%,38.06%,1
高雄市,大寮區,1751,225,96,321,12,333,553,60.22%,40.69%,1
高雄市,大寮區,1752,387,205,592,46,638,1121,56.91%,34.52%,1
高雄市,大寮區,1753,419,277,696,29,725,1227,59.09%,34.15%,1
高雄市,大寮區,1754,449,237,686,33,719,1058,67.96%,42.44%,1
高雄市,大寮區,1755,426,251,677,19,696,1209,57.57%,35.24%,1
高雄市,大寮區,1756,413,256,669,15,684,1100,62.18%,37.55%,1
高雄市,大寮區,1757,366,240,606,23,629,1122,56.06%,32.62%,1
高雄市,大寮區,1758,374,229,603,45,648,983,65.92%,38.05%,1
高雄市,大寮區,1759,417,217,634,12,646,1192,54.19%,34.98%,1
高雄市,大寮區,1760,294,140,434,28,462,719,64.26%,40.89%,1
高雄市,大寮區,1761,324,186,510,15,525,829,63.33%,39.08%,1
高雄市,大寮區,1762,345,156,501,32,533,771,69.13%,44.75%,1
高雄市,大寮區,1763,419,243,662,27,689,1075,64.09%,38.98%,1
高雄市,大寮區,1764,475,268,743,57,800,1280,62.5%,37.11%,1
高雄市,大寮區,1765,408,223,631,70,701,1179,59.46%,34.61%,1
高雄市,大寮區,1766,416,245,661,22,683,1210,56.45%,34.38%,1
高雄市,大寮區,1767,74,41,115,5,120,189,63.49%,39.15%,1
高雄市,大寮區,1768,486,232,718,32,750,1228,61.07%,39.58%,1
高雄市,大寮區,1769,460,189,649,27,676,1170,57.78%,39.32%,1
高雄市,大寮區,1770,574,280,854,28,882,1416,62.29%,40.54%,1
高雄市,大寮區,1771,554,319,873,29,902,1482,60.86%,37.38%,1
高雄市,大寮區,1772,515,274,789,36,825,1478,55.82%,34.84%,1
高雄市,大樹區,0736,447,326,773,19,792,1386,57.14%,32.25%,1
高雄市,大樹區,0737,553,279,832,30,862,1315,65.55%,42.05%,1
高雄市,大樹區,0738,818,507,1325,40,1365,2461,55.47%,33.24%,1
高雄市,大樹區,0739,427,281,708,31,739,1274,58.01%,33.52%,1
高雄市,大樹區,0740,434,234,668,47,715,1265,56.52%,34.31%,1
高雄市,大樹區,0741,512,298,810,45,855,1504,56.85%,34.04%,1
高雄市,大樹區,0742,330,221,551,20,571,1049,54.43%,31.46%,1
高雄市,大樹區,0743,542,296,838,42,880,1573,55.94%,34.46%,1
高雄市,大樹區,0744,363,191,554,27,581,1121,51.83%,32.38%,1
高雄市,大樹區,0745,476,233,709,34,743,1207,61.56%,39.44%,1
高雄市,大樹區,0746,397,234,631,19,650,1134,57.32%,35.01%,1
高雄市,大樹區,0747,424,255,679,22,701,1124,62.37%,37.72%,1
高雄市,大樹區,0748,407,244,651,73,724,1259,57.51%,32.33%,1
高雄市,大樹區,0749,381,255,636,58,694,1105,62.81%,34.48%,1
高雄市,大樹區,0750,364,241,605,47,652,1128,57.8%,32.27%,1
高雄市,大樹區,0751,317,216,533,74,607,1079,56.26%,29.38%,1
高雄市,大樹區,0752,307,191,498,46,544,1025,53.07%,29.95%,1
高雄市,大樹區,0753,302,185,487,46,533,950,56.11%,31.79%,1
高雄市,大樹區,0754,455,274,729,79,808,1433,56.39%,31.75%,1
高雄市,大樹區,0755,238,165,403,28,431,794,54.28%,29.97%,1
高雄市,大樹區,0756,226,137,363,11,374,781,47.89%,28.94%,1
高雄市,大樹區,0757,413,225,638,24,662,1318,50.23%,31.34%,1
高雄市,大樹區,0758,263,134,397,21,418,736,56.79%,35.73%,1
高雄市,大樹區,0759,289,208,497,21,518,1047,49.47%,27.6%,1
高雄市,大樹區,0760,391,294,685,69,754,1271,59.32%,30.76%,1
高雄市,大樹區,0761,355,239,594,26,620,1186,52.28%,29.93%,1
高雄市,大樹區,0762,347,197,544,44,588,1007,58.39%,34.46%,1
高雄市,大樹區,0763,257,229,486,35,521,859,60.65%,29.92%,1
高雄市,大樹區,0764,214,153,367,14,381,735,51.84%,29.12%,1
高雄市,大樹區,0765,387,213,600,51,651,1046,62.24%,37%,1
高雄市,大樹區,0766,476,142,618,34,652,880,74.09%,54.09%,1
高雄市,大樹區,0767,248,119,367,17,384,720,53.33%,34.44%,1
高雄市,大社區,0637,270,217,487,53,540,950,56.84%,28.42%,1
高雄市,大社區,0638,438,264,702,20,722,1306,55.28%,33.54%,1
高雄市,大社區,0639,534,295,829,24,853,1856,45.96%,28.77%,1
高雄市,大社區,0640,361,262,623,27,650,986,65.92%,36.61%,1
高雄市,大社區,0641,313,225,538,35,573,1116,51.34%,28.05%,1
高雄市,大社區,0642,485,280,765,50,815,1253,65.04%,38.71%,1
高雄市,大社區,0643,609,333,942,36,978,1613,60.63%,37.76%,1
高雄市,大社區,0644,461,295,756,28,784,1455,53.88%,31.68%,1
高雄市,大社區,0645,606,388,994,41,1035,1674,61.83%,36.2%,1
高雄市,大社區,0646,370,208,578,42,620,1004,61.75%,36.85%,1
高雄市,大社區,0647,319,199,518,24,542,879,61.66%,36.29%,1
高雄市,大社區,0648,234,196,430,19,449,778,57.71%,30.08%,1
高雄市,大社區,0649,408,234,642,37,679,1110,61.17%,36.76%,1
高雄市,大社區,0650,461,321,782,36,818,1432,57.12%,32.19%,1
高雄市,大社區,0651,527,348,875,36,911,1466,62.14%,35.95%,1
高雄市,大社區,0652,525,339,864,51,915,1383,66.16%,37.96%,1
高雄市,大社區,0653,571,381,952,24,976,1645,59.33%,34.71%,1
高雄市,大社區,0654,462,319,781,33,814,1555,52.35%,29.71%,1
高雄市,大社區,0655,567,433,1000,43,1043,1750,59.6%,32.4%,1
高雄市,大社區,0656,377,242,619,49,668,1111,60.13%,33.93%,1
高雄市,大社區,0657,390,265,655,43,698,1133,61.61%,34.42%,1
高雄市,大社區,0658,326,199,525,30,555,912,60.86%,35.75%,1
高雄市,大社區,0659,222,139,361,13,374,745,50.2%,29.8%,1
高雄市,大社區,0660,321,235,556,17,573,934,61.35%,34.37%,1
高雄市,仁武區,0661,781,385,1166,27,1193,1777,67.14%,43.95%,1
高雄市,仁武區,0662,845,514,1359,47,1406,2273,61.86%,37.18%,1
高雄市,仁武區,0663,556,320,876,49,925,1384,66.84%,40.17%,1
高雄市,仁武區,0664,418,242,660,36,696,1170,59.49%,35.73%,1
高雄市,仁武區,0665,515,269,784,37,821,1216,67.52%,42.35%,1
高雄市,仁武區,0666,570,330,900,15,915,1598,57.26%,35.67%,1
高雄市,仁武區,0667,854,480,1334,34,1368,2143,63.84%,39.85%,1
高雄市,仁武區,0668,449,272,721,36,757,1300,58.23%,34.54%,1
高雄市,仁武區,0669,474,294,768,58,826,1338,61.73%,35.43%,1
高雄市,仁武區,0670,417,255,672,17,689,1217,56.61%,34.26%,1
高雄市,仁武區,0671,380,200,580,43,623,1202,51.83%,31.61%,1
高雄市,仁武區,0672,451,303,754,37,791,1404,56.34%,32.12%,1
高雄市,仁武區,0673,284,174,458,24,482,830,58.07%,34.22%,1
高雄市,仁武區,0674,526,277,803,27,830,1802,46.06%,29.19%,1
高雄市,仁武區,0675,595,373,968,52,1020,1877,54.34%,31.7%,1
高雄市,仁武區,0676,538,295,833,23,856,1738,49.25%,30.96%,1
高雄市,仁武區,0677,523,347,870,41,911,1549,58.81%,33.76%,1
高雄市,仁武區,0678,568,341,909,42,951,1579,60.23%,35.97%,1
高雄市,仁武區,0679,500,278,778,31,809,1406,57.54%,35.56%,1
高雄市,仁武區,0680,552,304,856,28,884,1461,60.51%,37.78%,1
高雄市,仁武區,0681,511,285,796,27,823,1311,62.78%,38.98%,1
高雄市,仁武區,0682,500,284,784,19,803,1373,58.49%,36.42%,1
高雄市,仁武區,0683,349,225,574,21,595,1035,57.49%,33.72%,1
高雄市,仁武區,0684,425,251,676,17,693,1181,58.68%,35.99%,1
高雄市,仁武區,0685,574,341,915,34,949,1670,56.83%,34.37%,1
高雄市,仁武區,0686,584,303,887,28,915,1576,58.06%,37.06%,1
高雄市,仁武區,0687,580,356,936,45,981,1576,62.25%,36.8%,1
高雄市,仁武區,0688,741,417,1158,24,1182,1915,61.72%,38.69%,1
高雄市,仁武區,0689,624,366,990,30,1020,1758,58.02%,35.49%,1
高雄市,仁武區,0690,760,404,1164,33,1197,1892,63.27%,40.17%,1
高雄市,仁武區,0691,735,455,1190,41,1231,2025,60.79%,36.3%,1
高雄市,仁武區,0692,796,425,1221,35,1256,2014,62.36%,39.52%,1
高雄市,仁武區,0693,608,363,971,25,996,1473,67.62%,41.28%,1
高雄市,仁武區,0694,363,201,564,22,586,979,59.86%,37.08%,1
高雄市,仁武區,0695,399,169,568,17,585,944,61.97%,42.27%,1
高雄市,仁武區,0696,410,248,658,45,703,1153,60.97%,35.56%,1
高雄市,仁武區,0697,467,251,718,43,761,1328,57.3%,35.17%,1
高雄市,仁武區,0698,591,363,954,47,1001,1657,60.41%,35.67%,1
高雄市,仁武區,0699,491,309,800,33,833,1545,53.92%,31.78%,1
高雄市,仁武區,0700,572,299,871,30,901,1417,63.59%,40.37%,1
高雄市,仁武區,0701,624,377,1001,33,1034,1602,64.54%,38.95%,1
高雄市,仁武區,0702,749,392,1141,63,1204,1823,66.04%,41.09%,1
高雄市,仁武區,0703,697,410,1107,27,1134,1914,59.25%,36.42%,1
高雄市,仁武區,0704,736,425,1161,33,1194,1992,59.94%,36.95%,1
高雄市,仁武區,0705,691,357,1048,26,1074,2045,52.52%,33.79%,1
高雄市,仁武區,0706,744,457,1201,29,1230,1982,62.06%,37.54%,1
高雄市,仁武區,0707,738,416,1154,35,1189,2167,54.87%,34.06%,1
高雄市,鳥松區,0708,612,338,950,50,1000,1678,59.59%,36.47%,1
高雄市,鳥松區,0709,578,314,892,39,931,1682,55.35%,34.36%,1
高雄市,鳥松區,0710,474,281,755,37,792,1225,64.65%,38.69%,1
高雄市,鳥松區,0711,442,255,697,39,736,1322,55.67%,33.43%,1
高雄市,鳥松區,0712,458,257,715,24,739,1215,60.82%,37.7%,1
高雄市,鳥松區,0713,568,401,969,33,1002,1779,56.32%,31.93%,1
高雄市,鳥松區,0714,384,341,725,20,745,1129,65.99%,34.01%,1
高雄市,鳥松區,0715,543,284,827,41,868,1374,63.17%,39.52%,1
高雄市,鳥松區,0716,384,262,646,25,671,1089,61.62%,35.26%,1
高雄市,鳥松區,0717,803,518,1321,48,1369,2219,61.69%,36.19%,1
高雄市,鳥松區,0718,598,353,951,33,984,1634,60.22%,36.6%,1
高雄市,鳥松區,0719,592,349,941,53,994,1553,64.01%,38.12%,1
高雄市,鳥松區,0720,596,363,959,52,1011,1572,64.31%,37.91%,1
高雄市,鳥松區,0721,613,429,1042,32,1074,1688,63.63%,36.32%,1
高雄市,鳥松區,0722,607,394,1001,33,1034,1626,63.59%,37.33%,1
高雄市,鳥松區,0723,662,423,1085,44,1129,1744,64.74%,37.96%,1
高雄市,鳥松區,0724,436,226,662,37,699,1230,56.83%,35.45%,1
高雄市,鳥松區,0725,427,298,725,52,777,1201,64.7%,35.55%,1
高雄市,鳥松區,0726,457,252,709,31,740,1117,66.25%,40.91%,1
高雄市,鳥松區,0727,501,219,720,32,752,1255,59.92%,39.92%,1
高雄市,鳥松區,0728,489,253,742,34,776,1432,54.19%,34.15%,1
高雄市,鳥松區,0729,486,237,723,25,748,1370,54.6%,35.47%,1
高雄市,鳥松區,0730,519,293,812,44,856,1364,62.76%,38.05%,1
高雄市,鳥松區,0731,435,201,636,44,680,1041,65.32%,41.79%,1
高雄市,鳥松區,0732,322,157,479,32,511,702,72.79%,45.87%,1
高雄市,鳥松區,0733,423,286,709,36,745,1212,61.47%,34.9%,1
高雄市,鳥松區,0734,465,257,722,41,763,1289,59.19%,36.07%,1
高雄市,鳥松區,0735,563,364,927,16,943,1449,65.08%,38.85%,1
高雄市,岡山區,0261,569,300,869,23,892,1345,66.32%,42.3%,1
高雄市,岡山區,0262,315,184,499,17,516,1045,49.38%,30.14%,1
高雄市,岡山區,0263,388,233,621,24,645,1051,61.37%,36.92%,1
高雄市,岡山區,0264,322,237,559,19,578,917,63.03%,35.11%,1
高雄市,岡山區,0265,375,211,586,25,611,934,65.42%,40.15%,1
高雄市,岡山區,0266,467,194,661,32,693,1097,63.17%,42.57%,1
高雄市,岡山區,0267,534,249,783,25,808,1208,66.89%,44.21%,1
高雄市,岡山區,0268,474,264,738,42,780,1159,67.3%,40.9%,1
高雄市,岡山區,0269,375,224,599,29,628,1018,61.69%,36.84%,1
高雄市,岡山區,0270,455,253,708,22,730,1316,55.47%,34.57%,1
高雄市,岡山區,0271,497,279,776,34,810,1345,60.22%,36.95%,1
高雄市,岡山區,0272,523,250,773,36,809,1295,62.47%,40.39%,1
高雄市,岡山區,0273,509,303,812,36,848,1425,59.51%,35.72%,1
高雄市,岡山區,0274,497,269,766,28,794,1328,59.79%,37.42%,1
高雄市,岡山區,0275,581,257,838,16,854,1382,61.79%,42.04%,1
高雄市,岡山區,0276,543,295,838,13,851,1381,61.62%,39.32%,1
高雄市,岡山區,0277,465,267,732,45,777,1282,60.61%,36.27%,1
高雄市,岡山區,0278,479,233,712,17,729,1240,58.79%,38.63%,1
高雄市,岡山區,0279,504,273,777,30,807,1327,60.81%,37.98%,1
高雄市,岡山區,0280,561,372,933,37,970,1736,55.88%,32.32%,1
高雄市,岡山區,0281,585,325,910,31,941,1566,60.09%,37.36%,1
高雄市,岡山區,0282,600,342,942,30,972,1779,54.64%,33.73%,1
高雄市,岡山區,0283,573,317,890,55,945,1593,59.32%,35.97%,1
高雄市,岡山區,0284,577,302,879,50,929,1480,62.77%,38.99%,1
高雄市,岡山區,0285,548,252,800,35,835,1364,61.22%,40.18%,1
高雄市,岡山區,0286,537,293,830,40,870,1410,61.7%,38.09%,1
高雄市,岡山區,0287,499,267,766,25,791,1148,68.9%,43.47%,1
高雄市,岡山區,0288,232,157,389,29,418,625,66.88%,37.12%,1
高雄市,岡山區,0289,323,256,579,24,603,969,62.23%,33.33%,1
高雄市,岡山區,0290,356,185,541,16,557,861,64.69%,41.35%,1
高雄市,岡山區,0291,273,178,451,16,467,823,56.74%,33.17%,1
高雄市,岡山區,0292,353,211,564,38,602,889,67.72%,39.71%,1
高雄市,岡山區,0293,469,277,746,33,779,1283,60.72%,36.55%,1
高雄市,岡山區,0294,565,284,849,23,872,1512,57.67%,37.37%,1
高雄市,岡山區,0295,389,249,638,34,672,983,68.36%,39.57%,1
高雄市,岡山區,0296,460,279,739,22,761,1262,60.3%,36.45%,1
高雄市,岡山區,0297,432,224,656,33,689,1096,62.86%,39.42%,1
高雄市,岡山區,0298,391,230,621,28,649,1066,60.88%,36.68%,1
高雄市,岡山區,0299,409,236,645,22,667,1188,56.14%,34.43%,1
高雄市,岡山區,0300,551,280,831,30,861,1360,63.31%,40.51%,1
高雄市,岡山區,0301,567,287,854,29,883,1363,64.78%,41.6%,1
高雄市,岡山區,0302,541,292,833,41,874,1352,64.64%,40.01%,1
高雄市,岡山區,0303,571,270,841,28,869,1460,59.52%,39.11%,1
高雄市,岡山區,0304,451,304,755,32,787,1272,61.87%,35.46%,1
高雄市,岡山區,0305,425,239,664,34,698,1080,64.63%,39.35%,1
高雄市,岡山區,0306,445,285,730,52,782,1255,62.31%,35.46%,1
高雄市,岡山區,0307,407,197,604,25,629,938,67.06%,43.39%,1
高雄市,岡山區,0308,534,239,773,25,798,1237,64.51%,43.17%,1
高雄市,岡山區,0309,536,258,794,19,813,1413,57.54%,37.93%,1
高雄市,岡山區,0310,295,171,466,12,478,765,62.48%,38.56%,1
高雄市,岡山區,0311,417,254,671,24,695,1043,66.63%,39.98%,1
高雄市,岡山區,0312,326,157,483,25,508,844,60.19%,38.63%,1
高雄市,岡山區,0313,427,272,699,32,731,993,73.62%,43%,1
高雄市,岡山區,0314,387,234,621,52,673,1038,64.84%,37.28%,1
高雄市,岡山區,0315,381,246,627,44,671,1070,62.71%,35.61%,1
高雄市,岡山區,0316,393,254,647,50,697,1023,68.13%,38.42%,1
高雄市,岡山區,0317,497,298,795,25,820,1349,60.79%,36.84%,1
高雄市,岡山區,0318,488,287,775,35,810,1452,55.79%,33.61%,1
高雄市,岡山區,0319,107,84,191,15,206,301,68.44%,35.55%,1
高雄市,岡山區,0320,258,196,454,63,517,756,68.39%,34.13%,1
高雄市,岡山區,0321,247,146,393,10,403,733,54.98%,33.7%,1
高雄市,岡山區,0322,335,213,548,54,602,854,70.49%,39.23%,1
高雄市,岡山區,0323,267,165,432,19,451,866,52.08%,30.83%,1
高雄市,岡山區,0324,349,190,539,32,571,978,58.38%,35.69%,1
高雄市,岡山區,0325,559,229,788,31,819,1336,61.3%,41.84%,1
高雄市,岡山區,0326,575,197,772,11,783,1218,64.29%,47.21%,1
高雄市,岡山區,0327,155,98,253,5,258,341,75.66%,45.45%,1
高雄市,岡山區,0328,532,154,686,29,715,955,74.87%,55.71%,1
高雄市,岡山區,0329,472,161,633,22,655,940,69.68%,50.21%,1
高雄市,岡山區,0330,381,177,558,18,576,851,67.69%,44.77%,1
高雄市,岡山區,0331,376,149,525,17,542,762,71.13%,49.34%,1
高雄市,岡山區,0332,140,94,234,7,241,318,75.79%,44.03%,1
高雄市,橋頭區,0404,398,228,626,54,680,1005,67.66%,39.6%,1
高雄市,橋頭區,0405,392,250,642,42,684,1073,63.75%,36.53%,1
高雄市,橋頭區,0406,474,241,715,24,739,1129,65.46%,41.98%,1
高雄市,橋頭區,0407,460,286,746,57,803,1244,64.55%,36.98%,1
高雄市,橋頭區,0408,417,226,643,21,664,1091,60.86%,38.22%,1
高雄市,橋頭區,0409,556,286,842,42,884,1329,66.52%,41.84%,1
高雄市,橋頭區,0410,445,245,690,29,719,1140,63.07%,39.04%,1
高雄市,橋頭區,0411,443,261,704,64,768,1220,62.95%,36.31%,1
高雄市,橋頭區,0412,421,253,674,41,715,1047,68.29%,40.21%,1
高雄市,橋頭區,0413,453,284,737,61,798,1315,60.68%,34.45%,1
高雄市,橋頭區,0414,266,145,411,25,436,691,63.1%,38.49%,1
高雄市,橋頭區,0415,297,152,449,37,486,720,67.5%,41.25%,1
高雄市,橋頭區,0416,433,259,692,59,751,1192,63%,36.33%,1
高雄市,橋頭區,0417,488,299,787,62,849,1318,64.42%,37.03%,1
高雄市,橋頭區,0418,297,164,461,35,496,761,65.18%,39.03%,1
高雄市,橋頭區,0419,356,230,586,25,611,973,62.8%,36.59%,1
高雄市,橋頭區,0420,209,133,342,24,366,587,62.35%,35.6%,1
高雄市,橋頭區,0421,311,194,505,27,532,812,65.52%,38.3%,1
高雄市,橋頭區,0422,132,87,219,6,225,343,65.6%,38.48%,1
高雄市,橋頭區,0423,490,311,801,18,819,1266,64.69%,38.7%,1
高雄市,橋頭區,0424,566,107,673,73,746,1128,66.13%,50.18%,1
高雄市,橋頭區,0425,375,166,541,28,569,884,64.37%,42.42%,1
高雄市,橋頭區,0426,419,240,659,38,697,1187,58.72%,35.3%,1
高雄市,橋頭區,0427,526,224,750,31,781,1259,62.03%,41.78%,1
高雄市,橋頭區,0428,485,225,710,49,759,1361,55.77%,35.64%,1
高雄市,橋頭區,0429,244,133,377,16,393,671,58.57%,36.36%,1
高雄市,橋頭區,0430,452,279,731,50,781,1215,64.28%,37.2%,1
高雄市,橋頭區,0431,487,277,764,51,815,1255,64.94%,38.8%,1
高雄市,橋頭區,0432,472,275,747,40,787,1219,64.56%,38.72%,1
高雄市,橋頭區,0433,513,310,823,27,850,1372,61.95%,37.39%,1
高雄市,橋頭區,0434,328,144,472,17,489,758,64.51%,43.27%,1
高雄市,燕巢區,0333,369,237,606,59,665,1152,57.73%,32.03%,1
高雄市,燕巢區,0334,412,237,649,24,673,1120,60.09%,36.79%,1
高雄市,燕巢區,0335,385,236,621,32,653,974,67.04%,39.53%,1
高雄市,燕巢區,0336,377,206,583,10,593,1019,58.19%,37%,1
高雄市,燕巢區,0337,362,210,572,41,613,1058,57.94%,34.22%,1
高雄市,燕巢區,0338,328,165,493,31,524,1017,51.52%,32.25%,1
高雄市,燕巢區,0339,33,11,44,3,47,259,18.15%,12.74%,1
高雄市,燕巢區,0340,387,196,583,40,623,926,67.28%,41.79%,1
高雄市,燕巢區,0341,209,119,328,15,343,624,54.97%,33.49%,1
高雄市,燕巢區,0342,453,225,678,46,724,1102,65.7%,41.11%,1
高雄市,燕巢區,0343,358,188,546,36,582,1072,54.29%,33.4%,1
高雄市,燕巢區,0344,406,324,730,67,797,1361,58.56%,29.83%,1
高雄市,燕巢區,0345,163,100,263,26,289,472,61.23%,34.53%,1
高雄市,燕巢區,0346,365,235,600,45,645,1197,53.88%,30.49%,1
高雄市,燕巢區,0347,426,257,683,53,736,1134,64.9%,37.57%,1
高雄市,燕巢區,0348,408,219,627,35,662,1148,57.67%,35.54%,1
高雄市,燕巢區,0349,395,209,604,52,656,1207,54.35%,32.73%,1
高雄市,燕巢區,0350,525,337,862,36,898,1402,64.05%,37.45%,1
高雄市,燕巢區,0351,352,220,572,38,610,1000,61%,35.2%,1
高雄市,燕巢區,0352,386,253,639,40,679,1110,61.17%,34.77%,1
高雄市,燕巢區,0353,431,276,707,42,749,1291,58.02%,33.38%,1
高雄市,燕巢區,0354,269,169,438,49,487,797,61.1%,33.75%,1
高雄市,燕巢區,0355,346,194,540,37,577,1098,52.55%,31.51%,1
高雄市,燕巢區,0356,425,281,706,43,749,1393,53.77%,30.51%,1
高雄市,燕巢區,0357,325,164,489,24,513,1079,47.54%,30.12%,1
高雄市,田寮區,0237,99,67,166,6,172,369,46.61%,26.83%,1
高雄市,田寮區,0238,152,113,265,19,284,656,43.29%,23.17%,1
高雄市,田寮區,0239,67,55,122,8,130,406,32.02%,16.5%,1
高雄市,田寮區,0240,114,70,184,14,198,380,52.11%,30%,1
高雄市,田寮區,0241,116,85,201,18,219,379,57.78%,30.61%,1
高雄市,田寮區,0242,208,111,319,41,360,625,57.6%,33.28%,1
高雄市,田寮區,0243,279,180,459,25,484,946,51.16%,29.49%,1
高雄市,田寮區,0244,228,119,347,38,385,794,48.49%,28.72%,1
高雄市,田寮區,0245,103,47,150,19,169,382,44.24%,26.96%,1
高雄市,田寮區,0246,107,71,178,27,205,513,39.96%,20.86%,1
高雄市,田寮區,0247,195,114,309,17,326,601,54.24%,32.45%,1
高雄市,田寮區,0248,213,131,344,33,377,620,60.81%,34.35%,1
高雄市,阿蓮區,0216,360,253,613,30,643,1299,49.5%,27.71%,1
高雄市,阿蓮區,0217,395,216,611,26,637,1107,57.54%,35.68%,1
高雄市,阿蓮區,0218,326,142,468,17,485,898,54.01%,36.3%,1
高雄市,阿蓮區,0219,407,231,638,57,695,1259,55.2%,32.33%,1
高雄市,阿蓮區,0220,469,331,800,42,842,1579,53.32%,29.7%,1
高雄市,阿蓮區,0221,199,121,320,8,328,564,58.16%,35.28%,1
高雄市,阿蓮區,0222,257,203,460,38,498,768,64.84%,33.46%,1
高雄市,阿蓮區,0223,348,261,609,34,643,1092,58.88%,31.87%,1
高雄市,阿蓮區,0224,354,239,593,36,629,1099,57.23%,32.21%,1
高雄市,阿蓮區,0225,375,249,624,16,640,1134,56.44%,33.07%,1
高雄市,阿蓮區,0226,470,323,793,26,819,1561,52.47%,30.11%,1
高雄市,阿蓮區,0227,481,369,850,53,903,1533,58.9%,31.38%,1
高雄市,阿蓮區,0228,339,216,555,23,578,1116,51.79%,30.38%,1
高雄市,阿蓮區,0229,357,208,565,34,599,1054,56.83%,33.87%,1
高雄市,阿蓮區,0230,422,245,667,26,693,1260,55%,33.49%,1
高雄市,阿蓮區,0231,432,306,738,59,797,1504,52.99%,28.72%,1
高雄市,阿蓮區,0232,256,155,411,17,428,848,50.47%,30.19%,1
高雄市,阿蓮區,0233,278,160,438,19,457,823,55.53%,33.78%,1
高雄市,阿蓮區,0234,371,205,576,28,604,1021,59.16%,36.34%,1
高雄市,阿蓮區,0235,492,358,850,28,878,1715,51.2%,28.69%,1
高雄市,阿蓮區,0236,435,227,662,39,701,1300,53.92%,33.46%,1
高雄市,路竹區,0175,343,201,544,17,561,1026,54.68%,33.43%,1
高雄市,路竹區,0176,364,215,579,54,633,1069,59.21%,34.05%,1
高雄市,路竹區,0177,389,251,640,51,691,1127,61.31%,34.52%,1
高雄市,路竹區,0178,438,214,652,30,682,1179,57.85%,37.15%,1
高雄市,路竹區,0179,410,220,630,72,702,1237,56.75%,33.14%,1
高雄市,路竹區,0180,356,264,620,38,658,1096,60.04%,32.48%,1
高雄市,路竹區,0181,522,244,766,43,809,1272,63.6%,41.04%,1
高雄市,路竹區,0182,410,258,668,38,706,1182,59.73%,34.69%,1
高雄市,路竹區,0183,397,220,617,39,656,1127,58.21%,35.23%,1
高雄市,路竹區,0184,343,198,541,36,577,956,60.36%,35.88%,1
高雄市,路竹區,0185,361,254,615,53,668,1132,59.01%,31.89%,1
高雄市,路竹區,0186,360,237,597,61,658,1025,64.2%,35.12%,1
高雄市,路竹區,0187,318,229,547,25,572,1007,56.8%,31.58%,1
高雄市,路竹區,0188,411,249,660,42,702,1301,53.96%,31.59%,1
高雄市,路竹區,0189,303,196,499,31,530,885,59.89%,34.24%,1
高雄市,路竹區,0190,237,177,414,15,429,837,51.25%,28.32%,1
高雄市,路竹區,0191,310,222,532,35,567,930,60.97%,33.33%,1
高雄市,路竹區,0192,259,131,390,32,422,781,54.03%,33.16%,1
高雄市,路竹區,0193,342,231,573,40,613,1023,59.92%,33.43%,1
高雄市,路竹區,0194,615,398,1013,53,1066,1763,60.47%,34.88%,1
高雄市,路竹區,0195,547,352,899,47,946,1637,57.79%,33.41%,1
高雄市,路竹區,0196,378,214,592,42,634,1070,59.25%,35.33%,1
高雄市,路竹區,0197,424,268,692,37,729,1177,61.94%,36.02%,1
高雄市,路竹區,0198,341,229,570,30,600,1007,59.58%,33.86%,1
高雄市,路竹區,0199,340,224,564,38,602,1026,58.67%,33.14%,1
高雄市,路竹區,0200,349,224,573,31,604,1017,59.39%,34.32%,1
高雄市,路竹區,0201,414,298,712,30,742,1264,58.7%,32.75%,1
高雄市,路竹區,0202,400,233,633,40,673,1089,61.8%,36.73%,1
高雄市,路竹區,0203,283,186,469,32,501,851,58.87%,33.25%,1
高雄市,路竹區,0204,362,211,573,65,638,1011,63.11%,35.81%,1
高雄市,路竹區,0205,358,240,598,18,616,937,65.74%,38.21%,1
高雄市,路竹區,0206,249,171,420,12,432,820,52.68%,30.37%,1
高雄市,路竹區,0207,354,214,568,23,591,910,64.95%,38.9%,1
高雄市,路竹區,0208,255,200,455,39,494,867,56.98%,29.41%,1
高雄市,路竹區,0209,359,183,542,25,567,937,60.51%,38.31%,1
高雄市,路竹區,0210,314,200,514,20,534,900,59.33%,34.89%,1
高雄市,路竹區,0211,328,193,521,39,560,900,62.22%,36.44%,1
高雄市,路竹區,0212,328,215,543,25,568,918,61.87%,35.73%,1
高雄市,路竹區,0213,316,219,535,33,568,870,65.29%,36.32%,1
高雄市,路竹區,0214,438,264,702,24,726,1150,63.13%,38.09%,1
高雄市,路竹區,0215,616,321,937,48,985,1537,64.09%,40.08%,1
高雄市,湖內區,0151,377,200,577,39,616,1112,55.4%,33.9%,1
高雄市,湖內區,0152,344,194,538,55,593,1017,58.31%,33.82%,1
高雄市,湖內區,0153,265,157,422,12,434,796,54.52%,33.29%,1
高雄市,湖內區,0154,396,250,646,29,675,1079,62.56%,36.7%,1
高雄市,湖內區,0155,405,241,646,18,664,1115,59.55%,36.32%,1
高雄市,湖內區,0156,409,281,690,35,725,1311,55.3%,31.2%,1
高雄市,湖內區,0157,456,228,684,22,706,1319,53.53%,34.57%,1
高雄市,湖內區,0158,452,297,749,41,790,1244,63.5%,36.33%,1
高雄市,湖內區,0159,486,257,743,37,780,1227,63.57%,39.61%,1
高雄市,湖內區,0160,423,240,663,51,714,1163,61.39%,36.37%,1
高雄市,湖內區,0161,346,221,567,29,596,981,60.75%,35.27%,1
高雄市,湖內區,0162,240,185,425,17,442,780,56.67%,30.77%,1
高雄市,湖內區,0163,300,149,449,39,488,832,58.65%,36.06%,1
高雄市,湖內區,0164,374,237,611,31,642,1017,63.13%,36.77%,1
高雄市,湖內區,0165,346,252,598,27,625,1051,59.47%,32.92%,1
高雄市,湖內區,0166,332,187,519,22,541,941,57.49%,35.28%,1
高雄市,湖內區,0167,312,144,456,33,489,863,56.66%,36.15%,1
高雄市,湖內區,0168,349,251,600,32,632,1160,54.48%,30.09%,1
高雄市,湖內區,0169,290,182,472,22,494,1090,45.32%,26.61%,1
高雄市,湖內區,0170,376,241,617,38,655,1122,58.38%,33.51%,1
高雄市,湖內區,0171,328,212,540,25,565,1123,50.31%,29.21%,1
高雄市,湖內區,0172,238,129,367,24,391,684,57.16%,34.8%,1
高雄市,湖內區,0173,379,236,615,22,637,1249,51%,30.34%,1
高雄市,湖內區,0174,455,236,691,32,723,1453,49.76%,31.31%,1
高雄市,茄萣區,0130,302,187,489,14,503,976,51.54%,30.94%,1
高雄市,茄萣區,0131,283,166,449,38,487,887,54.9%,31.91%,1
高雄市,茄萣區,0132,533,351,884,35,919,1710,53.74%,31.17%,1
高雄市,茄萣區,0133,382,203,585,29,614,1280,47.97%,29.84%,1
高雄市,茄萣區,0134,489,282,771,24,795,1314,60.5%,37.21%,1
高雄市,茄萣區,0135,453,254,707,30,737,1157,63.7%,39.15%,1
高雄市,茄萣區,0136,600,326,926,65,991,1785,55.52%,33.61%,1
高雄市,茄萣區,0137,295,158,453,37,490,838,58.47%,35.2%,1
高雄市,茄萣區,0138,530,245,775,50,825,1249,66.05%,42.43%,1
高雄市,茄萣區,0139,366,201,567,47,614,1116,55.02%,32.8%,1
高雄市,茄萣區,0140,303,190,493,34,527,978,53.89%,30.98%,1
高雄市,茄萣區,0141,342,179,521,26,547,1125,48.62%,30.4%,1
高雄市,茄萣區,0142,330,242,572,53,625,1139,54.87%,28.97%,1
高雄市,茄萣區,0143,457,241,698,75,773,1363,56.71%,33.53%,1
高雄市,茄萣區,0144,562,334,896,68,964,1598,60.33%,35.17%,1
高雄市,茄萣區,0145,341,212,553,44,597,1111,53.74%,30.69%,1
高雄市,茄萣區,0146,282,145,427,19,446,925,48.22%,30.49%,1
高雄市,茄萣區,0147,368,224,592,37,629,1148,54.79%,32.06%,1
高雄市,茄萣區,0148,403,280,683,21,704,1353,52.03%,29.79%,1
高雄市,茄萣區,0149,440,257,697,43,740,1331,55.6%,33.06%,1
高雄市,茄萣區,0150,535,322,857,43,900,1829,49.21%,29.25%,1
高雄市,永安區,0249,331,150,481,23,504,756,66.67%,43.78%,1
高雄市,永安區,0250,303,187,490,35,525,818,64.18%,37.04%,1
高雄市,永安區,0251,363,214,577,24,601,866,69.4%,41.92%,1
高雄市,永安區,0252,364,204,568,48,616,951,64.77%,38.28%,1
高雄市,永安區,0253,165,425,590,48,638,992,64.31%,16.63%,1
高雄市,永安區,0254,184,140,324,15,339,682,49.71%,26.98%,1
高雄市,永安區,0255,247,139,386,21,407,665,61.2%,37.14%,1
高雄市,永安區,0256,122,82,204,8,212,371,57.14%,32.88%,1
高雄市,永安區,0257,414,277,691,47,738,1114,66.25%,37.16%,1
高雄市,永安區,0258,577,286,863,25,888,1418,62.62%,40.69%,1
高雄市,永安區,0259,598,323,921,58,979,1477,66.28%,40.49%,1
高雄市,永安區,0260,716,421,1137,56,1193,1891,63.09%,37.86%,1
高雄市,彌陀區,0358,445,274,719,38,757,1246,60.75%,35.71%,1
高雄市,彌陀區,0359,341,187,528,28,556,885,62.82%,38.53%,1
高雄市,彌陀區,0360,399,233,632,26,658,955,68.9%,41.78%,1
高雄市,彌陀區,0361,173,128,301,21,322,534,60.3%,32.4%,1
高雄市,彌陀區,0362,281,144,425,28,453,738,61.38%,38.08%,1
高雄市,彌陀區,0363,355,204,559,28,587,855,68.65%,41.52%,1
高雄市,彌陀區,0364,363,177,540,29,569,877,64.88%,41.39%,1
高雄市,彌陀區,0365,346,131,477,33,510,781,65.3%,44.3%,1
高雄市,彌陀區,0366,303,166,469,25,494,808,61.14%,37.5%,1
高雄市,彌陀區,0367,281,173,454,18,472,904,52.21%,31.08%,1
高雄市,彌陀區,0368,284,178,462,42,504,825,61.09%,34.42%,1
高雄市,彌陀區,0369,310,176,486,49,535,941,56.85%,32.94%,1
高雄市,彌陀區,0370,358,221,579,24,603,1013,59.53%,35.34%,1
高雄市,彌陀區,0371,413,226,639,36,675,1024,65.92%,40.33%,1
高雄市,彌陀區,0372,310,153,463,13,476,861,55.28%,36%,1
高雄市,彌陀區,0373,440,249,689,46,735,1163,63.2%,37.83%,1
高雄市,彌陀區,0374,526,245,771,35,806,1216,66.28%,43.26%,1
高雄市,彌陀區,0375,413,179,592,37,629,861,73.05%,47.97%,1
高雄市,梓官區,0376,412,215,627,41,668,1061,62.96%,38.83%,1
高雄市,梓官區,0377,389,213,602,36,638,1063,60.02%,36.59%,1
高雄市,梓官區,0378,377,210,587,19,606,969,62.54%,38.91%,1
高雄市,梓官區,0379,347,219,566,20,586,1078,54.36%,32.19%,1
高雄市,梓官區,0380,310,186,496,32,528,838,63.01%,36.99%,1
高雄市,梓官區,0381,258,130,388,24,412,611,67.43%,42.23%,1
高雄市,梓官區,0382,310,173,483,18,501,782,64.07%,39.64%,1
高雄市,梓官區,0383,564,346,910,42,952,1451,65.61%,38.87%,1
高雄市,梓官區,0384,436,219,655,21,676,1144,59.09%,38.11%,1
高雄市,梓官區,0385,354,180,534,12,546,975,56%,36.31%,1
高雄市,梓官區,0386,505,270,775,30,805,1317,61.12%,38.34%,1
高雄市,梓官區,0387,489,227,716,50,766,1218,62.89%,40.15%,1
高雄市,梓官區,0388,404,224,628,33,661,1073,61.6%,37.65%,1
高雄市,梓官區,0389,404,189,593,27,620,1112,55.76%,36.33%,1
高雄市,梓官區,0390,231,156,387,26,413,715,57.76%,32.31%,1
高雄市,梓官區,0391,474,255,729,30,759,1311,57.89%,36.16%,1
高雄市,梓官區,0392,344,212,556,22,578,939,61.55%,36.63%,1
高雄市,梓官區,0393,335,170,505,15,520,824,63.11%,40.66%,1
高雄市,梓官區,0394,439,228,667,44,711,1052,67.59%,41.73%,1
高雄市,梓官區,0395,428,185,613,43,656,1020,64.31%,41.96%,1
高雄市,梓官區,0396,455,246,701,32,733,1260,58.17%,36.11%,1
高雄市,梓官區,0397,596,269,865,25,890,1595,55.8%,37.37%,1
高雄市,梓官區,0398,312,179,491,22,513,829,61.88%,37.64%,1
高雄市,梓官區,0399,577,282,859,28,887,1532,57.9%,37.66%,1
高雄市,梓官區,0400,517,239,756,36,792,1195,66.28%,43.26%,1
高雄市,梓官區,0401,449,214,663,51,714,1143,62.47%,39.28%,1
高雄市,梓官區,0402,447,263,710,38,748,1186,63.07%,37.69%,1
高雄市,梓官區,0403,561,284,845,26,871,1732,50.29%,32.39%,1
高雄市,旗山區,0060,368,246,614,25,639,1060,60.28%,34.72%,1
高雄市,旗山區,0061,374,187,561,34,595,1125,52.89%,33.24%,1
高雄市,旗山區,0062,391,258,649,32,681,1100,61.91%,35.55%,1
高雄市,旗山區,0063,459,289,748,21,769,1238,62.12%,37.08%,1
高雄市,旗山區,0064,309,216,525,18,543,933,58.2%,33.12%,1
高雄市,旗山區,0065,222,200,422,17,439,727,60.39%,30.54%,1
高雄市,旗山區,0066,367,209,576,34,610,1071,56.96%,34.27%,1
高雄市,旗山區,0067,222,158,380,22,402,744,54.03%,29.84%,1
高雄市,旗山區,0068,322,220,542,38,580,1100,52.73%,29.27%,1
高雄市,旗山區,0069,124,61,185,12,197,369,53.39%,33.6%,1
高雄市,旗山區,0070,273,141,414,13,427,888,48.09%,30.74%,1
高雄市,旗山區,0071,163,75,238,9,247,510,48.43%,31.96%,1
高雄市,旗山區,0072,353,231,584,66,650,1042,62.38%,33.88%,1
高雄市,旗山區,0073,245,157,402,36,438,791,55.37%,30.97%,1
高雄市,旗山區,0074,321,191,512,56,568,939,60.49%,34.19%,1
高雄市,旗山區,0075,302,232,534,31,565,1218,46.39%,24.79%,1
高雄市,旗山區,0076,49,34,83,16,99,178,55.62%,27.53%,1
高雄市,旗山區,0077,350,204,554,36,590,946,62.37%,37%,1
高雄市,旗山區,0078,333,226,559,27,586,1025,57.17%,32.49%,1
高雄市,旗山區,0079,381,205,586,114,700,1040,67.31%,36.63%,1
高雄市,旗山區,0080,339,199,538,49,587,900,65.22%,37.67%,1
高雄市,旗山區,0081,226,113,339,20,359,663,54.15%,34.09%,1
高雄市,旗山區,0082,303,209,512,34,546,954,57.23%,31.76%,1
高雄市,旗山區,0083,370,199,569,27,596,1060,56.23%,34.91%,1
高雄市,旗山區,0084,387,242,629,48,677,1110,60.99%,34.86%,1
高雄市,旗山區,0085,337,253,590,41,631,1062,59.42%,31.73%,1
高雄市,旗山區,0086,412,228,640,28,668,1151,58.04%,35.79%,1
高雄市,旗山區,0087,80,71,151,16,167,266,62.78%,30.08%,1
高雄市,旗山區,0088,252,122,374,19,393,633,62.09%,39.81%,1
高雄市,旗山區,0089,398,237,635,36,671,1307,51.34%,30.45%,1
高雄市,旗山區,0090,227,160,387,46,433,754,57.43%,30.11%,1
高雄市,旗山區,0091,390,259,649,98,747,1296,57.64%,30.09%,1
高雄市,旗山區,0092,211,159,370,21,391,839,46.6%,25.15%,1
高雄市,旗山區,0093,424,294,718,50,768,1329,57.79%,31.9%,1
高雄市,旗山區,0094,229,125,354,19,373,628,59.39%,36.46%,1
高雄市,美濃區,0095,434,195,629,60,689,1175,58.64%,36.94%,1
高雄市,美濃區,0096,433,282,715,20,735,1438,51.11%,30.11%,1
高雄市,美濃區,0097,330,146,476,31,507,989,51.26%,33.37%,1
高雄市,美濃區,0098,527,221,748,53,801,1427,56.13%,36.93%,1
高雄市,美濃區,0099,414,271,685,58,743,1309,56.76%,31.63%,1
高雄市,美濃區,0100,448,262,710,64,774,1263,61.28%,35.47%,1
高雄市,美濃區,0101,369,193,562,48,610,997,61.18%,37.01%,1
高雄市,美濃區,0102,341,220,561,54,615,1064,57.8%,32.05%,1
高雄市,美濃區,0103,502,279,781,55,836,1498,55.81%,33.51%,1
高雄市,美濃區,0104,381,214,595,63,658,1119,58.8%,34.05%,1
高雄市,美濃區,0105,358,196,554,52,606,1031,58.78%,34.72%,1
高雄市,美濃區,0106,412,291,703,64,767,1437,53.38%,28.67%,1
高雄市,美濃區,0107,354,212,566,42,608,1071,56.77%,33.05%,1
高雄市,美濃區,0108,254,113,367,25,392,687,57.06%,36.97%,1
高雄市,美濃區,0109,220,121,341,25,366,775,47.23%,28.39%,1
高雄市,美濃區,0110,427,224,651,48,699,1353,51.66%,31.56%,1
高雄市,美濃區,0111,368,209,577,36,613,1191,51.47%,30.9%,1
高雄市,美濃區,0112,288,140,428,33,461,906,50.88%,31.79%,1
高雄市,美濃區,0113,421,245,666,28,694,1178,58.91%,35.74%,1
高雄市,美濃區,0114,369,228,597,42,639,1252,51.04%,29.47%,1
高雄市,美濃區,0115,547,312,859,36,895,1549,57.78%,35.31%,1
高雄市,美濃區,0116,375,174,549,26,575,1088,52.85%,34.47%,1
高雄市,美濃區,0117,371,228,599,38,637,1116,57.08%,33.24%,1
高雄市,美濃區,0118,317,192,509,18,527,977,53.94%,32.45%,1
高雄市,美濃區,0119,280,191,471,41,512,816,62.75%,34.31%,1
高雄市,美濃區,0120,275,148,423,26,449,955,47.02%,28.8%,1
高雄市,美濃區,0121,322,170,492,54,546,943,57.9%,34.15%,1
高雄市,美濃區,0122,440,259,699,40,739,1371,53.9%,32.09%,1
高雄市,美濃區,0123,272,189,461,53,514,919,55.93%,29.6%,1
高雄市,美濃區,0124,326,193,519,48,567,915,61.97%,35.63%,1
高雄市,美濃區,0125,236,156,392,63,455,828,54.95%,28.5%,1
高雄市,美濃區,0126,168,109,277,44,321,674,47.63%,24.93%,1
高雄市,六龜區,0020,222,136,358,28,386,760,50.79%,29.21%,1
高雄市,六龜區,0021,169,111,280,27,307,666,46.1%,25.38%,1
高雄市,六龜區,0022,230,142,372,40,412,704,58.52%,32.67%,1
高雄市,六龜區,0023,302,172,474,40,514,1003,51.25%,30.11%,1
高雄市,六龜區,0024,326,246,572,94,666,1382,48.19%,23.59%,1
高雄市,六龜區,0025,218,153,371,45,416,986,42.19%,22.11%,1
高雄市,六龜區,0026,293,208,501,37,538,1046,51.43%,28.01%,1
高雄市,六龜區,0027,211,142,353,29,382,812,47.04%,25.99%,1
高雄市,六龜區,0028,371,208,579,65,644,1431,45%,25.93%,1
高雄市,六龜區,0029,289,142,431,51,482,912,52.85%,31.69%,1
高雄市,六龜區,0030,328,238,566,43,609,1472,41.37%,22.28%,1
高雄市,六龜區,0031,78,55,133,12,145,327,44.34%,23.85%,1
高雄市,甲仙區,0013,121,57,178,9,187,472,39.62%,25.64%,1
高雄市,甲仙區,0014,348,174,522,40,562,882,63.72%,39.46%,1
高雄市,甲仙區,0015,204,133,337,19,356,668,53.29%,30.54%,1
高雄市,甲仙區,0016,438,275,713,81,794,1581,50.22%,27.7%,1
高雄市,甲仙區,0017,144,103,247,11,258,673,38.34%,21.4%,1
高雄市,甲仙區,0018,164,104,268,28,296,607,48.76%,27.02%,1
高雄市,甲仙區,0019,144,111,255,19,274,534,51.31%,26.97%,1
高雄市,杉林區,0032,174,113,287,32,319,640,49.84%,27.19%,1
高雄市,杉林區,0033,184,127,311,26,337,696,48.42%,26.44%,1
高雄市,杉林區,0034,275,182,457,35,492,1284,38.32%,21.42%,1
高雄市,杉林區,0035,246,172,418,41,459,1027,44.69%,23.95%,1
高雄市,杉林區,0036,148,83,231,16,247,482,51.24%,30.71%,1
高雄市,杉林區,0037,514,320,834,80,914,1627,56.18%,31.59%,1
高雄市,杉林區,0038,484,261,745,27,772,1630,47.36%,29.69%,1
高雄市,杉林區,0039,227,155,382,22,404,973,41.52%,23.33%,1
高雄市,杉林區,0040,266,156,422,18,440,987,44.58%,26.95%,1
高雄市,杉林區,0041,381,220,601,67,668,1261,52.97%,30.21%,1
高雄市,內門區,0042,286,162,448,36,484,969,49.95%,29.51%,1
高雄市,內門區,0043,190,101,291,15,306,652,46.93%,29.14%,1
高雄市,內門區,0044,318,148,466,48,514,961,53.49%,33.09%,1
高雄市,內門區,0045,145,60,205,10,215,426,50.47%,34.04%,1
高雄市,內門區,0046,120,58,178,9,187,398,46.98%,30.15%,1
高雄市,內門區,0047,133,96,229,12,241,508,47.44%,26.18%,1
高雄市,內門區,0048,354,185,539,42,581,980,59.29%,36.12%,1
高雄市,內門區,0049,315,192,507,32,539,1225,44%,25.71%,1
高雄市,內門區,0050,518,354,872,100,972,1722,56.45%,30.08%,1
高雄市,內門區,0051,156,93,249,26,275,560,49.11%,27.86%,1
高雄市,內門區,0052,203,145,348,14,362,801,45.19%,25.34%,1
高雄市,內門區,0053,117,92,209,11,220,423,52.01%,27.66%,1
高雄市,內門區,0054,140,78,218,19,237,497,47.69%,28.17%,1
高雄市,內門區,0055,215,112,327,18,345,677,50.96%,31.76%,1
高雄市,內門區,0056,178,68,246,7,253,593,42.66%,30.02%,1
高雄市,內門區,0057,184,85,269,22,291,597,48.74%,30.82%,1
高雄市,內門區,0058,101,51,152,0,152,343,44.31%,29.45%,1
高雄市,內門區,0059,211,129,340,31,371,670,55.37%,31.49%,1
高雄市,茂林區,0127,194,142,336,20,356,507,70.22%,38.26%,1
高雄市,茂林區,0128,192,81,273,9,282,382,73.82%,50.26%,1
高雄市,茂林區,0129,315,153,468,17,485,726,66.8%,43.39%,1
高雄市,桃源區,0001,67,54,121,1,122,264,46.21%,25.38%,1
高雄市,桃源區,0002,110,59,169,3,172,233,73.82%,47.21%,1
高雄市,桃源區,0003,114,67,181,5,186,279,66.67%,40.86%,1
高雄市,桃源區,0004,118,45,163,2,165,223,73.99%,52.91%,1
高雄市,桃源區,0005,330,150,480,10,490,783,62.58%,42.15%,1
高雄市,桃源區,0006,284,111,395,7,402,632,63.61%,44.94%,1
高雄市,桃源區,0007,254,149,403,17,420,612,68.63%,41.5%,1
高雄市,桃源區,0008,171,80,251,17,268,472,56.78%,36.23%,1
高雄市,那瑪夏區,0009,319,153,472,21,493,741,66.53%,43.05%,1
高雄市,那瑪夏區,0010,238,159,397,31,428,585,73.16%,40.68%,1
高雄市,那瑪夏區,0011,327,129,456,18,474,609,77.83%,53.69%,1
高雄市,那瑪夏區,0012,207,65,272,12,284,489,58.08%,42.33%,1
新竹縣,竹北市,0001,524,310,834,19,853,1319,64.67%,39.73%,1
新竹縣,竹北市,0002,408,376,784,21,805,1321,60.94%,30.89%,1
新竹縣,竹北市,0003,481,303,784,23,807,1272,63.44%,37.81%,1
新竹縣,竹北市,0004,523,303,826,24,850,1467,57.94%,35.65%,1
新竹縣,竹北市,0005,405,299,704,8,712,1226,58.08%,33.03%,1
新竹縣,竹北市,0006,512,288,800,12,812,1412,57.51%,36.26%,1
新竹縣,竹北市,0007,542,329,871,13,884,1400,63.14%,38.71%,1
新竹縣,竹北市,0008,515,333,848,30,878,1415,62.05%,36.4%,1
新竹縣,竹北市,0009,460,325,785,22,807,1361,59.29%,33.8%,1
新竹縣,竹北市,0010,477,344,821,17,838,1515,55.31%,31.49%,1
新竹縣,竹北市,0011,517,357,874,22,896,1495,59.93%,34.58%,1
新竹縣,竹北市,0012,469,345,814,26,840,1417,59.28%,33.1%,1
新竹縣,竹北市,0013,470,390,860,33,893,1548,57.69%,30.36%,1
新竹縣,竹北市,0014,434,345,779,19,798,1434,55.65%,30.26%,1
新竹縣,竹北市,0015,472,308,780,36,816,1385,58.92%,34.08%,1
新竹縣,竹北市,0016,481,283,764,30,794,1247,63.67%,38.57%,1
新竹縣,竹北市,0017,448,322,770,28,798,1373,58.12%,32.63%,1
新竹縣,竹北市,0018,472,372,844,15,859,1345,63.87%,35.09%,1
新竹縣,竹北市,0019,399,243,642,33,675,1165,57.94%,34.25%,1
新竹縣,竹北市,0020,426,302,728,26,754,1164,64.78%,36.6%,1
新竹縣,竹北市,0021,421,303,724,33,757,1212,62.46%,34.74%,1
新竹縣,竹北市,0022,468,271,739,32,771,1507,51.16%,31.06%,1
新竹縣,竹北市,0023,515,281,796,45,841,1576,53.36%,32.68%,1
新竹縣,竹北市,0024,473,344,817,18,835,1464,57.04%,32.31%,1
新竹縣,竹北市,0025,445,350,795,23,818,1428,57.28%,31.16%,1
新竹縣,竹北市,0026,367,345,712,15,727,1442,50.42%,25.45%,1
新竹縣,竹北市,0027,483,322,805,41,846,1415,59.79%,34.13%,1
新竹縣,竹北市,0028,493,346,839,16,855,1666,51.32%,29.59%,1
新竹縣,竹北市,0029,546,370,916,24,940,1751,53.68%,31.18%,1
新竹縣,竹北市,0030,448,276,724,18,742,1196,62.04%,37.46%,1
新竹縣,竹北市,0031,461,256,717,26,743,1235,60.16%,37.33%,1
新竹縣,竹北市,0032,412,260,672,14,686,1204,56.98%,34.22%,1
新竹縣,竹北市,0033,470,309,779,26,805,1308,61.54%,35.93%,1
新竹縣,竹北市,0034,418,279,697,19,716,1233,58.07%,33.9%,1
新竹縣,竹北市,0035,453,206,659,18,677,1129,59.96%,40.12%,1
新竹縣,竹北市,0036,414,226,640,19,659,1069,61.65%,38.73%,1
新竹縣,竹北市,0037,453,243,696,18,714,1114,64.09%,40.66%,1
新竹縣,竹北市,0038,420,252,672,22,694,1103,62.92%,38.08%,1
新竹縣,竹北市,0039,393,253,646,24,670,1029,65.11%,38.19%,1
新竹縣,竹北市,0040,457,247,704,23,727,1133,64.17%,40.34%,1
新竹縣,竹北市,0041,453,296,749,10,759,1301,58.34%,34.82%,1
新竹縣,竹北市,0042,589,426,1015,33,1048,1798,58.29%,32.76%,1
新竹縣,竹北市,0043,525,308,833,18,851,1427,59.64%,36.79%,1
新竹縣,竹北市,0044,588,303,891,19,910,1462,62.24%,40.22%,1
新竹縣,竹北市,0045,501,330,831,26,857,1342,63.86%,37.33%,1
新竹縣,竹北市,0046,516,329,845,24,869,1480,58.72%,34.86%,1
新竹縣,竹北市,0047,551,359,910,20,930,1645,56.53%,33.5%,1
新竹縣,竹北市,0048,457,322,779,22,801,1256,63.77%,36.39%,1
新竹縣,竹北市,0049,418,283,701,22,723,1181,61.22%,35.39%,1
新竹縣,竹北市,0050,503,342,845,31,876,1329,65.91%,37.85%,1
新竹縣,竹北市,0051,494,282,776,20,796,1228,64.82%,40.23%,1
新竹縣,竹北市,0052,503,346,849,27,876,1552,56.44%,32.41%,1
新竹縣,竹北市,0053,520,353,873,22,895,1480,60.47%,35.14%,1
新竹縣,竹北市,0054,459,345,804,25,829,1487,55.75%,30.87%,1
新竹縣,竹北市,0055,485,295,780,29,809,1470,55.03%,32.99%,1
新竹縣,竹北市,0056,503,265,768,22,790,1477,53.49%,34.06%,1
新竹縣,竹北市,0057,609,340,949,28,977,1611,60.65%,37.8%,1
新竹縣,竹北市,0058,563,314,877,34,911,1555,58.59%,36.21%,1
新竹縣,竹北市,0059,471,301,772,29,801,1468,54.56%,32.08%,1
新竹縣,竹北市,0060,558,304,862,37,899,1509,59.58%,36.98%,1
新竹縣,竹北市,0061,633,230,863,27,890,1602,55.56%,39.51%,1
新竹縣,竹北市,0062,571,276,847,24,871,1448,60.15%,39.43%,1
新竹縣,竹北市,0063,490,290,780,22,802,1318,60.85%,37.18%,1
新竹縣,竹北市,0064,605,365,970,39,1009,1634,61.75%,37.03%,1
新竹縣,竹北市,0065,487,148,635,46,681,1345,50.63%,36.21%,1
新竹縣,竹北市,0066,427,207,634,8,642,958,67.01%,44.57%,1
新竹縣,竹北市,0067,432,248,680,25,705,1112,63.4%,38.85%,1
新竹縣,竹北市,0068,405,229,634,38,672,1134,59.26%,35.71%,1
新竹縣,竹北市,0069,504,328,832,33,865,1483,58.33%,33.99%,1
新竹縣,竹北市,0070,442,272,714,36,750,1332,56.31%,33.18%,1
新竹縣,竹北市,0071,472,271,743,21,764,1482,51.55%,31.85%,1
新竹縣,竹北市,0072,368,234,602,21,623,1449,43%,25.4%,1
新竹縣,竹北市,0073,465,234,699,22,721,1319,54.66%,35.25%,1
新竹縣,竹北市,0074,431,271,702,28,730,1332,54.8%,32.36%,1
新竹縣,竹北市,0075,432,300,732,22,754,1412,53.4%,30.59%,1
新竹縣,竹北市,0076,544,314,858,28,886,1640,54.02%,33.17%,1
新竹縣,竹北市,0077,451,276,727,32,759,1323,57.37%,34.09%,1
新竹縣,竹北市,0078,491,314,805,48,853,1428,59.73%,34.38%,1
新竹縣,竹北市,0079,518,351,869,26,895,1533,58.38%,33.79%,1
新竹縣,竹北市,0080,429,282,711,26,737,1346,54.75%,31.87%,1
新竹縣,竹北市,0081,421,214,635,34,669,1219,54.88%,34.54%,1
新竹縣,竹北市,0082,539,309,848,50,898,1466,61.26%,36.77%,1
新竹縣,竹北市,0083,340,260,600,32,632,1147,55.1%,29.64%,1
新竹縣,竹北市,0084,431,289,720,39,759,1529,49.64%,28.19%,1
新竹縣,竹北市,0085,554,294,848,33,881,1522,57.88%,36.4%,1
新竹縣,竹北市,0086,474,312,786,45,831,1383,60.09%,34.27%,1
新竹縣,竹北市,0087,512,375,887,29,916,1569,58.38%,32.63%,1
新竹縣,竹北市,0088,516,274,790,25,815,1506,54.12%,34.26%,1
新竹縣,竹北市,0089,312,179,491,17,508,877,57.92%,35.58%,1
新竹縣,竹北市,0090,352,250,602,26,628,1074,58.47%,32.77%,1
新竹縣,竹北市,0091,429,250,679,30,709,1089,65.11%,39.39%,1
新竹縣,竹北市,0092,459,291,750,43,793,1336,59.36%,34.36%,1
新竹縣,竹北市,0093,362,211,573,34,607,1058,57.37%,34.22%,1
新竹縣,竹北市,0094,360,222,582,43,625,937,66.7%,38.42%,1
新竹縣,竹北市,0095,399,255,654,36,690,1206,57.21%,33.08%,1
新竹縣,竹北市,0096,392,296,688,33,721,1205,59.83%,32.53%,1
新竹縣,竹北市,0097,563,411,974,57,1031,1718,60.01%,32.77%,1
新竹縣,竹北市,0098,309,191,500,30,530,917,57.8%,33.7%,1
新竹縣,竹北市,0099,240,147,387,22,409,668,61.23%,35.93%,1
新竹縣,竹北市,0100,261,192,453,24,477,824,57.89%,31.67%,1
新竹縣,竹北市,0101,277,150,427,41,468,782,59.85%,35.42%,1
新竹縣,竹北市,0102,352,199,551,48,599,977,61.31%,36.03%,1
新竹縣,竹北市,0103,289,193,482,24,506,937,54%,30.84%,1
新竹縣,竹東鎮,0104,85,64,149,6,155,309,50.16%,27.51%,1
新竹縣,竹東鎮,0105,119,79,198,20,218,416,52.4%,28.61%,1
新竹縣,竹東鎮,0106,107,89,196,7,203,386,52.59%,27.72%,1
新竹縣,竹東鎮,0107,409,60,469,23,492,950,51.79%,43.05%,1
新竹縣,竹東鎮,0108,437,219,656,24,680,1275,53.33%,34.27%,1
新竹縣,竹東鎮,0109,384,245,629,28,657,1213,54.16%,31.66%,1
新竹縣,竹東鎮,0110,534,309,843,32,875,1548,56.52%,34.5%,1
新竹縣,竹東鎮,0111,395,236,631,31,662,1246,53.13%,31.7%,1
新竹縣,竹東鎮,0112,318,235,553,28,581,1252,46.41%,25.4%,1
新竹縣,竹東鎮,0113,437,259,696,27,723,1359,53.2%,32.16%,1
新竹縣,竹東鎮,0114,391,258,649,29,678,1255,54.02%,31.16%,1
新竹縣,竹東鎮,0115,446,274,720,32,752,1304,57.67%,34.2%,1
新竹縣,竹東鎮,0116,417,271,688,40,728,1292,56.35%,32.28%,1
新竹縣,竹東鎮,0117,360,204,564,20,584,1111,52.57%,32.4%,1
新竹縣,竹東鎮,0118,302,191,493,37,530,880,60.23%,34.32%,1
新竹縣,竹東鎮,0119,236,139,375,20,395,670,58.96%,35.22%,1
新竹縣,竹東鎮,0120,425,266,691,35,726,1244,58.36%,34.16%,1
新竹縣,竹東鎮,0121,346,229,575,35,610,1126,54.17%,30.73%,1
新竹縣,竹東鎮,0122,344,200,544,48,592,1073,55.17%,32.06%,1
新竹縣,竹東鎮,0123,402,263,665,31,696,1215,57.28%,33.09%,1
新竹縣,竹東鎮,0124,414,233,647,15,662,1155,57.32%,35.84%,1
新竹縣,竹東鎮,0125,271,195,466,24,490,852,57.51%,31.81%,1
新竹縣,竹東鎮,0126,331,177,508,19,527,875,60.23%,37.83%,1
新竹縣,竹東鎮,0127,424,204,628,26,654,1070,61.12%,39.63%,1
新竹縣,竹東鎮,0128,233,137,370,19,389,704,55.26%,33.1%,1
新竹縣,竹東鎮,0129,229,127,356,26,382,951,40.17%,24.08%,1
新竹縣,竹東鎮,0130,334,228,562,11,573,984,58.23%,33.94%,1
新竹縣,竹東鎮,0131,302,189,491,15,506,1113,45.46%,27.13%,1
新竹縣,竹東鎮,0132,228,108,336,20,356,595,59.83%,38.32%,1
新竹縣,竹東鎮,0133,273,164,437,33,470,762,61.68%,35.83%,1
新竹縣,竹東鎮,0134,250,158,408,18,426,763,55.83%,32.77%,1
新竹縣,竹東鎮,0135,265,150,415,17,432,813,53.14%,32.6%,1
新竹縣,竹東鎮,0136,390,218,608,30,638,1310,48.7%,29.77%,1
新竹縣,竹東鎮,0137,351,321,672,33,705,1434,49.16%,24.48%,1
新竹縣,竹東鎮,0138,396,225,621,25,646,1131,57.12%,35.01%,1
新竹縣,竹東鎮,0139,300,218,518,14,532,967,55.02%,31.02%,1
新竹縣,竹東鎮,0140,369,215,584,29,613,1196,51.25%,30.85%,1
新竹縣,竹東鎮,0141,410,228,638,19,657,1154,56.93%,35.53%,1
新竹縣,竹東鎮,0142,251,159,410,30,440,715,61.54%,35.1%,1
新竹縣,竹東鎮,0143,235,156,391,20,411,685,60%,34.31%,1
新竹縣,竹東鎮,0144,433,252,685,33,718,1352,53.11%,32.03%,1
新竹縣,竹東鎮,0145,493,266,759,47,806,1407,57.29%,35.04%,1
新竹縣,竹東鎮,0146,496,234,730,23,753,1362,55.29%,36.42%,1
新竹縣,竹東鎮,0147,510,233,743,31,774,1330,58.2%,38.35%,1
新竹縣,竹東鎮,0148,481,258,739,45,784,1441,54.41%,33.38%,1
新竹縣,竹東鎮,0149,375,258,633,20,653,1248,52.32%,30.05%,1
新竹縣,竹東鎮,0150,339,234,573,11,584,1263,46.24%,26.84%,1
新竹縣,竹東鎮,0151,351,246,597,24,621,1232,50.41%,28.49%,1
新竹縣,竹東鎮,0152,321,196,517,24,541,1143,47.33%,28.08%,1
新竹縣,竹東鎮,0153,515,305,820,24,844,1529,55.2%,33.68%,1
新竹縣,竹東鎮,0154,361,239,600,28,628,1140,55.09%,31.67%,1
新竹縣,竹東鎮,0155,208,141,349,17,366,570,64.21%,36.49%,1
新竹縣,竹東鎮,0156,412,236,648,24,672,1345,49.96%,30.63%,1
新竹縣,竹東鎮,0157,437,264,701,41,742,1381,53.73%,31.64%,1
新竹縣,竹東鎮,0158,445,292,737,28,765,1379,55.47%,32.27%,1
新竹縣,竹東鎮,0159,386,194,580,23,603,1033,58.37%,37.37%,1
新竹縣,竹東鎮,0160,357,205,562,25,587,1066,55.07%,33.49%,1
新竹縣,竹東鎮,0161,358,169,527,29,556,938,59.28%,38.17%,1
新竹縣,竹東鎮,0162,365,194,559,30,589,952,61.87%,38.34%,1
新竹縣,竹東鎮,0163,561,285,846,36,882,1468,60.08%,38.22%,1
新竹縣,竹東鎮,0164,513,450,963,21,984,1915,51.38%,26.79%,1
新竹縣,竹東鎮,0165,393,231,624,25,649,1220,53.2%,32.21%,1
新竹縣,竹東鎮,0166,319,198,517,17,534,1166,45.8%,27.36%,1
新竹縣,竹東鎮,0167,460,255,715,18,733,1492,49.13%,30.83%,1
新竹縣,竹東鎮,0168,405,233,638,31,669,1245,53.73%,32.53%,1
新竹縣,竹東鎮,0169,367,228,595,30,625,1083,57.71%,33.89%,1
新竹縣,竹東鎮,0170,322,268,590,20,610,1102,55.35%,29.22%,1
新竹縣,竹東鎮,0171,374,124,498,23,521,1068,48.78%,35.02%,1
新竹縣,竹東鎮,0172,385,222,607,19,626,1097,57.06%,35.1%,1
新竹縣,竹東鎮,0173,327,182,509,19,528,962,54.89%,33.99%,1
新竹縣,竹東鎮,0174,301,216,517,17,534,909,58.75%,33.11%,1
新竹縣,竹東鎮,0175,170,115,285,18,303,603,50.25%,28.19%,1
新竹縣,新埔鎮,0176,364,200,564,25,589,983,59.92%,37.03%,1
新竹縣,新埔鎮,0177,209,142,351,18,369,597,61.81%,35.01%,1
新竹縣,新埔鎮,0178,378,212,590,21,611,1070,57.1%,35.33%,1
新竹縣,新埔鎮,0179,365,175,540,24,564,935,60.32%,39.04%,1
新竹縣,新埔鎮,0180,255,163,418,19,437,753,58.03%,33.86%,1
新竹縣,新埔鎮,0181,321,207,528,24,552,838,65.87%,38.31%,1
新竹縣,新埔鎮,0182,294,200,494,34,528,924,57.14%,31.82%,1
新竹縣,新埔鎮,0183,248,195,443,19,462,905,51.05%,27.4%,1
新竹縣,新埔鎮,0184,342,174,516,23,539,948,56.86%,36.08%,1
新竹縣,新埔鎮,0185,347,203,550,38,588,1017,57.82%,34.12%,1
新竹縣,新埔鎮,0186,444,248,692,30,722,1176,61.39%,37.76%,1
新竹縣,新埔鎮,0187,423,243,666,32,698,1122,62.21%,37.7%,1
新竹縣,新埔鎮,0188,266,211,477,17,494,1022,48.34%,26.03%,1
新竹縣,新埔鎮,0189,393,281,674,40,714,1429,49.97%,27.5%,1
新竹縣,新埔鎮,0190,171,106,277,28,305,451,67.63%,37.92%,1
新竹縣,新埔鎮,0191,220,179,399,18,417,724,57.6%,30.39%,1
新竹縣,新埔鎮,0192,209,152,361,34,395,617,64.02%,33.87%,1
新竹縣,新埔鎮,0193,365,270,635,49,684,1144,59.79%,31.91%,1
新竹縣,新埔鎮,0194,382,242,624,35,659,1139,57.86%,33.54%,1
新竹縣,新埔鎮,0195,304,170,474,16,490,861,56.91%,35.31%,1
新竹縣,新埔鎮,0196,299,234,533,28,561,1093,51.33%,27.36%,1
新竹縣,新埔鎮,0197,294,179,473,31,504,978,51.53%,30.06%,1
新竹縣,新埔鎮,0198,320,166,486,21,507,1040,48.75%,30.77%,1
新竹縣,新埔鎮,0199,381,212,593,28,621,1160,53.53%,32.84%,1
新竹縣,新埔鎮,0200,341,213,554,26,580,950,61.05%,35.89%,1
新竹縣,新埔鎮,0201,302,175,477,24,501,882,56.8%,34.24%,1
新竹縣,新埔鎮,0202,425,276,701,41,742,1281,57.92%,33.18%,1
新竹縣,新埔鎮,0203,376,244,620,30,650,1212,53.63%,31.02%,1
新竹縣,新埔鎮,0204,311,144,455,31,486,1013,47.98%,30.7%,1
新竹縣,新埔鎮,0205,226,149,375,27,402,630,63.81%,35.87%,1
新竹縣,關西鎮,0206,175,120,295,13,308,480,64.17%,36.46%,1
新竹縣,關西鎮,0207,341,177,518,25,543,903,60.13%,37.76%,1
新竹縣,關西鎮,0208,334,227,561,33,594,1020,58.24%,32.75%,1
新竹縣,關西鎮,0209,275,129,404,11,415,705,58.87%,39.01%,1
新竹縣,關西鎮,0210,341,209,550,26,576,1056,54.55%,32.29%,1
新竹縣,關西鎮,0211,401,262,663,32,695,1275,54.51%,31.45%,1
新竹縣,關西鎮,0212,441,273,714,42,756,1287,58.74%,34.27%,1
新竹縣,關西鎮,0213,259,161,420,46,466,771,60.44%,33.59%,1
新竹縣,關西鎮,0214,325,205,530,42,572,1046,54.68%,31.07%,1
新竹縣,關西鎮,0215,374,201,575,29,604,1030,58.64%,36.31%,1
新竹縣,關西鎮,0216,410,244,654,34,688,1208,56.95%,33.94%,1
新竹縣,關西鎮,0217,357,174,531,16,547,1095,49.95%,32.6%,1
新竹縣,關西鎮,0218,409,251,660,55,715,1350,52.96%,30.3%,1
新竹縣,關西鎮,0219,335,177,512,25,537,846,63.48%,39.6%,1
新竹縣,關西鎮,0220,453,248,701,46,747,1362,54.85%,33.26%,1
新竹縣,關西鎮,0221,287,169,456,21,477,903,52.82%,31.78%,1
新竹縣,關西鎮,0222,148,104,252,19,271,551,49.18%,26.86%,1
新竹縣,關西鎮,0223,102,73,175,16,191,461,41.43%,22.13%,1
新竹縣,關西鎮,0224,185,109,294,25,319,572,55.77%,32.34%,1
新竹縣,關西鎮,0225,259,216,475,36,511,943,54.19%,27.47%,1
新竹縣,關西鎮,0226,270,167,437,36,473,808,58.54%,33.42%,1
新竹縣,關西鎮,0227,374,208,582,20,602,923,65.22%,40.52%,1
新竹縣,關西鎮,0228,313,203,516,21,537,903,59.47%,34.66%,1
新竹縣,關西鎮,0229,359,181,540,36,576,977,58.96%,36.75%,1
新竹縣,關西鎮,0230,304,179,483,34,517,824,62.74%,36.89%,1
新竹縣,關西鎮,0231,217,129,346,16,362,559,64.76%,38.82%,1
新竹縣,關西鎮,0232,303,203,506,28,534,854,62.53%,35.48%,1
新竹縣,湖口鄉,0233,409,279,688,36,724,1393,51.97%,29.36%,1
新竹縣,湖口鄉,0234,510,330,840,33,873,1505,58.01%,33.89%,1
新竹縣,湖口鄉,0235,446,289,735,33,768,1188,64.65%,37.54%,1
新竹縣,湖口鄉,0236,434,269,703,35,738,1267,58.25%,34.25%,1
新竹縣,湖口鄉,0237,568,363,931,24,955,1668,57.25%,34.05%,1
新竹縣,湖口鄉,0238,576,380,956,42,998,1719,58.06%,33.51%,1
新竹縣,湖口鄉,0239,413,276,689,33,722,1162,62.13%,35.54%,1
新竹縣,湖口鄉,0240,502,353,855,47,902,1833,49.21%,27.39%,1
新竹縣,湖口鄉,0241,496,300,796,32,828,1444,57.34%,34.35%,1
新竹縣,湖口鄉,0242,517,276,793,45,838,1347,62.21%,38.38%,1
新竹縣,湖口鄉,0243,433,270,703,17,720,1202,59.9%,36.02%,1
新竹縣,湖口鄉,0244,311,184,495,23,518,851,60.87%,36.55%,1
新竹縣,湖口鄉,0245,443,279,722,44,766,1272,60.22%,34.83%,1
新竹縣,湖口鄉,0246,453,248,701,28,729,1275,57.18%,35.53%,1
新竹縣,湖口鄉,0247,669,264,933,39,972,1560,62.31%,42.88%,1
新竹縣,湖口鄉,0248,420,261,681,56,737,1147,64.25%,36.62%,1
新竹縣,湖口鄉,0249,601,334,935,42,977,1729,56.51%,34.76%,1
新竹縣,湖口鄉,0250,448,270,718,38,756,1402,53.92%,31.95%,1
新竹縣,湖口鄉,0251,410,256,666,39,705,1183,59.59%,34.66%,1
新竹縣,湖口鄉,0252,430,303,733,29,762,1282,59.44%,33.54%,1
新竹縣,湖口鄉,0253,458,296,754,52,806,1335,60.37%,34.31%,1
新竹縣,湖口鄉,0254,554,357,911,23,934,1493,62.56%,37.11%,1
新竹縣,湖口鄉,0255,616,388,1004,15,1019,1877,54.29%,32.82%,1
新竹縣,湖口鄉,0256,406,213,619,44,663,1082,61.28%,37.52%,1
新竹縣,湖口鄉,0257,383,255,638,49,687,1115,61.61%,34.35%,1
新竹縣,湖口鄉,0258,356,236,592,36,628,1193,52.64%,29.84%,1
新竹縣,湖口鄉,0259,615,384,999,47,1046,1947,53.72%,31.59%,1
新竹縣,湖口鄉,0260,363,276,639,38,677,1125,60.18%,32.27%,1
新竹縣,湖口鄉,0261,342,224,566,43,609,1050,58%,32.57%,1
新竹縣,湖口鄉,0262,574,401,975,31,1006,1733,58.05%,33.12%,1
新竹縣,湖口鄉,0263,443,281,724,34,758,1284,59.03%,34.5%,1
新竹縣,湖口鄉,0264,398,205,603,31,634,1062,59.7%,37.48%,1
新竹縣,湖口鄉,0265,542,302,844,38,882,1547,57.01%,35.04%,1
新竹縣,湖口鄉,0266,475,254,729,26,755,1494,50.54%,31.79%,1
新竹縣,湖口鄉,0267,467,284,751,28,779,1634,47.67%,28.58%,1
新竹縣,湖口鄉,0268,387,279,666,20,686,1444,47.51%,26.8%,1
新竹縣,湖口鄉,0269,426,266,692,14,706,1324,53.32%,32.18%,1
新竹縣,湖口鄉,0270,347,226,573,28,601,1058,56.81%,32.8%,1
新竹縣,湖口鄉,0271,308,203,511,24,535,1220,43.85%,25.25%,1
新竹縣,湖口鄉,0272,432,290,722,28,750,1333,56.26%,32.41%,1
新竹縣,湖口鄉,0273,433,291,724,43,767,1461,52.5%,29.64%,1
新竹縣,湖口鄉,0274,475,299,774,29,803,1429,56.19%,33.24%,1
新竹縣,湖口鄉,0275,416,282,698,21,719,1506,47.74%,27.62%,1
新竹縣,湖口鄉,0276,421,214,635,36,671,1103,60.83%,38.17%,1
新竹縣,湖口鄉,0277,448,265,713,28,741,1495,49.57%,29.97%,1
新竹縣,湖口鄉,0278,265,143,408,27,435,752,57.85%,35.24%,1
新竹縣,湖口鄉,0279,302,225,527,21,548,986,55.58%,30.63%,1
新竹縣,新豐鄉,0280,336,206,542,36,578,1080,53.52%,31.11%,1
新竹縣,新豐鄉,0281,272,178,450,20,470,887,52.99%,30.67%,1
新竹縣,新豐鄉,0282,280,225,505,31,536,954,56.18%,29.35%,1
新竹縣,新豐鄉,0283,350,199,549,27,576,1003,57.43%,34.9%,1
新竹縣,新豐鄉,0284,340,241,581,23,604,1106,54.61%,30.74%,1
新竹縣,新豐鄉,0285,372,245,617,38,655,1123,58.33%,33.13%,1
新竹縣,新豐鄉,0286,275,212,487,41,528,891,59.26%,30.86%,1
新竹縣,新豐鄉,0287,242,179,421,18,439,874,50.23%,27.69%,1
新竹縣,新豐鄉,0288,251,200,451,22,473,824,57.4%,30.46%,1
新竹縣,新豐鄉,0289,285,173,458,31,489,975,50.15%,29.23%,1
新竹縣,新豐鄉,0290,300,188,488,30,518,847,61.16%,35.42%,1
新竹縣,新豐鄉,0291,471,320,791,45,836,1477,56.6%,31.89%,1
新竹縣,新豐鄉,0292,359,271,630,43,673,1266,53.16%,28.36%,1
新竹縣,新豐鄉,0293,313,203,516,44,560,1029,54.42%,30.42%,1
新竹縣,新豐鄉,0294,344,208,552,27,579,1063,54.47%,32.36%,1
新竹縣,新豐鄉,0295,364,237,601,14,615,1055,58.29%,34.5%,1
新竹縣,新豐鄉,0296,495,298,793,20,813,1445,56.26%,34.26%,1
新竹縣,新豐鄉,0297,517,332,849,19,868,1413,61.43%,36.59%,1
新竹縣,新豐鄉,0298,383,211,594,28,622,971,64.06%,39.44%,1
新竹縣,新豐鄉,0299,415,249,664,22,686,1135,60.44%,36.56%,1
新竹縣,新豐鄉,0300,410,236,646,35,681,1269,53.66%,32.31%,1
新竹縣,新豐鄉,0301,428,258,686,29,715,1257,56.88%,34.05%,1
新竹縣,新豐鄉,0302,595,339,934,32,966,1662,58.12%,35.8%,1
新竹縣,新豐鄉,0303,453,298,751,20,771,1486,51.88%,30.48%,1
新竹縣,新豐鄉,0304,389,248,637,33,670,1067,62.79%,36.46%,1
新竹縣,新豐鄉,0305,517,242,759,29,788,1302,60.52%,39.71%,1
新竹縣,新豐鄉,0306,483,279,762,31,793,1410,56.24%,34.26%,1
新竹縣,新豐鄉,0307,462,212,674,21,695,1267,54.85%,36.46%,1
新竹縣,新豐鄉,0308,398,211,609,23,632,1258,50.24%,31.64%,1
新竹縣,新豐鄉,0309,385,121,506,21,527,1217,43.3%,31.64%,1
新竹縣,新豐鄉,0310,490,286,776,26,802,1456,55.08%,33.65%,1
新竹縣,新豐鄉,0311,425,230,655,24,679,1157,58.69%,36.73%,1
新竹縣,新豐鄉,0312,387,170,557,21,578,1089,53.08%,35.54%,1
新竹縣,新豐鄉,0313,407,246,653,16,669,1160,57.67%,35.09%,1
新竹縣,新豐鄉,0314,406,193,599,15,614,976,62.91%,41.6%,1
新竹縣,新豐鄉,0315,478,305,783,32,815,1443,56.48%,33.13%,1
新竹縣,新豐鄉,0316,377,236,613,21,634,1247,50.84%,30.23%,1
新竹縣,新豐鄉,0317,492,278,770,24,794,1411,56.27%,34.87%,1
新竹縣,新豐鄉,0318,466,227,693,43,736,1238,59.45%,37.64%,1
新竹縣,芎林鄉,0319,140,92,232,15,247,417,59.23%,33.57%,1
新竹縣,芎林鄉,0320,206,150,356,24,380,534,71.16%,38.58%,1
新竹縣,芎林鄉,0321,331,208,539,27,566,963,58.77%,34.37%,1
新竹縣,芎林鄉,0322,154,101,255,17,272,418,65.07%,36.84%,1
新竹縣,芎林鄉,0323,443,256,699,29,728,1312,55.49%,33.77%,1
新竹縣,芎林鄉,0324,385,271,656,30,686,1354,50.66%,28.43%,1
新竹縣,芎林鄉,0325,261,190,451,26,477,785,60.76%,33.25%,1
新竹縣,芎林鄉,0326,260,160,420,69,489,797,61.36%,32.62%,1
新竹縣,芎林鄉,0327,245,136,381,21,402,623,64.53%,39.33%,1
新竹縣,芎林鄉,0328,335,104,439,15,454,759,59.82%,44.14%,1
新竹縣,芎林鄉,0329,382,222,604,45,649,1272,51.02%,30.03%,1
新竹縣,芎林鄉,0330,418,224,642,33,675,1129,59.79%,37.02%,1
新竹縣,芎林鄉,0331,279,142,421,24,445,713,62.41%,39.13%,1
新竹縣,芎林鄉,0332,321,178,499,24,523,839,62.34%,38.26%,1
新竹縣,芎林鄉,0333,466,250,716,28,744,1123,66.25%,41.5%,1
新竹縣,芎林鄉,0334,376,204,580,15,595,981,60.65%,38.33%,1
新竹縣,芎林鄉,0335,383,235,618,40,658,1078,61.04%,35.53%,1
新竹縣,芎林鄉,0336,372,202,574,23,597,1094,54.57%,34%,1
新竹縣,芎林鄉,0337,371,245,616,40,656,1102,59.53%,33.67%,1
新竹縣,橫山鄉,0338,403,286,689,62,751,1231,61.01%,32.74%,1
新竹縣,橫山鄉,0339,357,229,586,44,630,1041,60.52%,34.29%,1
新竹縣,橫山鄉,0340,362,291,653,33,686,1132,60.6%,31.98%,1
新竹縣,橫山鄉,0341,313,189,502,34,536,859,62.4%,36.44%,1
新竹縣,橫山鄉,0342,70,44,114,7,121,204,59.31%,34.31%,1
新竹縣,橫山鄉,0343,55,42,97,5,102,222,45.95%,24.77%,1
新竹縣,橫山鄉,0344,109,79,188,31,219,338,64.79%,32.25%,1
新竹縣,橫山鄉,0345,248,226,474,21,495,916,54.04%,27.07%,1
新竹縣,橫山鄉,0346,145,84,229,13,242,573,42.23%,25.31%,1
新竹縣,橫山鄉,0347,95,84,179,12,191,275,69.45%,34.55%,1
新竹縣,橫山鄉,0348,137,76,213,16,229,463,49.46%,29.59%,1
新竹縣,橫山鄉,0349,238,169,407,35,442,690,64.06%,34.49%,1
新竹縣,橫山鄉,0350,88,52,140,11,151,288,52.43%,30.56%,1
新竹縣,橫山鄉,0351,249,155,404,40,444,685,64.82%,36.35%,1
新竹縣,橫山鄉,0352,298,205,503,34,537,868,61.87%,34.33%,1
新竹縣,橫山鄉,0353,554,351,905,61,966,1561,61.88%,35.49%,1
新竹縣,北埔鄉,0354,377,215,592,21,613,1158,52.94%,32.56%,1
新竹縣,北埔鄉,0355,425,277,702,39,741,1238,59.85%,34.33%,1
新竹縣,北埔鄉,0356,180,145,325,17,342,580,58.97%,31.03%,1
新竹縣,北埔鄉,0357,322,200,522,27,549,931,58.97%,34.59%,1
新竹縣,北埔鄉,0358,552,333,885,49,934,1653,56.5%,33.39%,1
新竹縣,北埔鄉,0359,248,200,448,37,485,845,57.4%,29.35%,1
新竹縣,北埔鄉,0360,137,74,211,11,222,384,57.81%,35.68%,1
新竹縣,北埔鄉,0361,265,147,412,17,429,763,56.23%,34.73%,1
新竹縣,北埔鄉,0362,102,67,169,16,185,333,55.56%,30.63%,1
新竹縣,北埔鄉,0363,97,52,149,13,162,295,54.92%,32.88%,1
新竹縣,寶山鄉,0364,390,248,638,47,685,1158,59.15%,33.68%,1
新竹縣,寶山鄉,0365,468,367,835,22,857,1437,59.64%,32.57%,1
新竹縣,寶山鄉,0366,463,336,799,39,838,1470,57.01%,31.5%,1
新竹縣,寶山鄉,0367,399,271,670,40,710,1170,60.68%,34.1%,1
新竹縣,寶山鄉,0368,654,403,1057,47,1104,1900,58.11%,34.42%,1
新竹縣,寶山鄉,0369,324,199,523,19,542,1056,51.33%,30.68%,1
新竹縣,寶山鄉,0370,443,276,719,39,758,1205,62.9%,36.76%,1
新竹縣,寶山鄉,0371,248,161,409,32,441,766,57.57%,32.38%,1
新竹縣,寶山鄉,0372,281,207,488,31,519,846,61.35%,33.22%,1
新竹縣,寶山鄉,0373,269,190,459,34,493,804,61.32%,33.46%,1
新竹縣,寶山鄉,0374,213,148,361,13,374,607,61.61%,35.09%,1
新竹縣,寶山鄉,0375,208,146,354,10,364,554,65.7%,37.55%,1
新竹縣,峨眉鄉,0376,341,195,536,39,575,879,65.42%,38.79%,1
新竹縣,峨眉鄉,0377,255,141,396,37,433,683,63.4%,37.34%,1
新竹縣,峨眉鄉,0378,210,127,337,30,367,604,60.76%,34.77%,1
新竹縣,峨眉鄉,0379,137,56,193,6,199,339,58.7%,40.41%,1
新竹縣,峨眉鄉,0380,70,50,120,5,125,276,45.29%,25.36%,1
新竹縣,峨眉鄉,0381,542,255,797,61,858,1406,61.02%,38.55%,1
新竹縣,峨眉鄉,0382,177,90,267,22,289,462,62.55%,38.31%,1
新竹縣,峨眉鄉,0383,109,104,213,15,228,419,54.42%,26.01%,1
新竹縣,尖石鄉,0384,156,90,246,5,251,474,52.95%,32.91%,1
新竹縣,尖石鄉,0385,148,56,204,5,209,357,58.54%,41.46%,1
新竹縣,尖石鄉,0386,63,31,94,17,111,225,49.33%,28%,1
新竹縣,尖石鄉,0387,156,62,218,9,227,374,60.7%,41.71%,1
新竹縣,尖石鄉,0388,298,123,421,13,434,773,56.14%,38.55%,1
新竹縣,尖石鄉,0389,269,74,343,8,351,490,71.63%,54.9%,1
新竹縣,尖石鄉,0390,185,78,263,7,270,531,50.85%,34.84%,1
新竹縣,尖石鄉,0391,271,122,393,15,408,660,61.82%,41.06%,1
新竹縣,尖石鄉,0392,301,111,412,19,431,613,70.31%,49.1%,1
新竹縣,尖石鄉,0393,202,115,317,3,320,593,53.96%,34.06%,1
新竹縣,尖石鄉,0394,210,113,323,16,339,575,58.96%,36.52%,1
新竹縣,尖石鄉,0395,59,19,78,6,84,126,66.67%,46.83%,1
新竹縣,尖石鄉,0396,204,68,272,8,280,499,56.11%,40.88%,1
新竹縣,尖石鄉,0397,207,144,351,28,379,785,48.28%,26.37%,1
新竹縣,尖石鄉,0398,119,72,191,10,201,289,69.55%,41.18%,1
新竹縣,五峰鄉,0399,287,130,417,15,432,672,64.29%,42.71%,1
新竹縣,五峰鄉,0400,212,134,346,17,363,713,50.91%,29.73%,1
新竹縣,五峰鄉,0401,163,101,264,10,274,594,46.13%,27.44%,1
新竹縣,五峰鄉,0402,300,152,452,32,484,896,54.02%,33.48%,1
新竹縣,五峰鄉,0403,275,124,399,9,408,727,56.12%,37.83%,1
新竹縣,五峰鄉,0404,120,115,235,7,242,395,61.27%,30.38%,1
苗栗縣,苗栗市,0001,381,221,602,25,627,1087,57.68%,35.05%,1
苗栗縣,苗栗市,0002,361,182,543,28,571,1018,56.09%,35.46%,1
苗栗縣,苗栗市,0003,375,245,620,18,638,1156,55.19%,32.44%,1
苗栗縣,苗栗市,0004,385,202,587,29,616,1118,55.1%,34.44%,1
苗栗縣,苗栗市,0005,382,215,597,37,634,1084,58.49%,35.24%,1
苗栗縣,苗栗市,0006,398,278,676,41,717,1203,59.6%,33.08%,1
苗栗縣,苗栗市,0007,509,242,751,36,787,1306,60.26%,38.97%,1
苗栗縣,苗栗市,0008,425,264,689,32,721,1193,60.44%,35.62%,1
苗栗縣,苗栗市,0009,403,241,644,15,659,1115,59.1%,36.14%,1
苗栗縣,苗栗市,0010,436,212,648,38,686,1119,61.3%,38.96%,1
苗栗縣,苗栗市,0011,400,269,669,27,696,1132,61.48%,35.34%,1
苗栗縣,苗栗市,0012,457,250,707,38,745,1289,57.8%,35.45%,1
苗栗縣,苗栗市,0013,432,292,724,32,756,1264,59.81%,34.18%,1
苗栗縣,苗栗市,0014,331,142,473,22,495,870,56.9%,38.05%,1
苗栗縣,苗栗市,0015,306,178,484,29,513,1008,50.89%,30.36%,1
苗栗縣,苗栗市,0016,342,210,552,20,572,1078,53.06%,31.73%,1
苗栗縣,苗栗市,0017,386,247,633,22,655,1077,60.82%,35.84%,1
苗栗縣,苗栗市,0018,322,170,492,27,519,880,58.98%,36.59%,1
苗栗縣,苗栗市,0019,294,178,472,31,503,894,56.26%,32.89%,1
苗栗縣,苗栗市,0020,187,96,283,22,305,522,58.43%,35.82%,1
苗栗縣,苗栗市,0021,519,302,821,47,868,1376,63.08%,37.72%,1
苗栗縣,苗栗市,0022,463,276,739,31,770,1391,55.36%,33.29%,1
苗栗縣,苗栗市,0023,389,234,623,30,653,1081,60.41%,35.99%,1
苗栗縣,苗栗市,0024,424,261,685,26,711,1272,55.9%,33.33%,1
苗栗縣,苗栗市,0025,459,221,680,36,716,1112,64.39%,41.28%,1
苗栗縣,苗栗市,0026,326,200,526,21,547,813,67.28%,40.1%,1
苗栗縣,苗栗市,0027,268,152,420,18,438,767,57.11%,34.94%,1
苗栗縣,苗栗市,0028,342,219,561,17,578,1010,57.23%,33.86%,1
苗栗縣,苗栗市,0029,426,215,641,25,666,1182,56.35%,36.04%,1
苗栗縣,苗栗市,0030,350,187,537,19,556,965,57.62%,36.27%,1
苗栗縣,苗栗市,0031,224,130,354,11,365,607,60.13%,36.9%,1
苗栗縣,苗栗市,0032,370,220,590,24,614,990,62.02%,37.37%,1
苗栗縣,苗栗市,0033,379,214,593,61,654,1230,53.17%,30.81%,1
苗栗縣,苗栗市,0034,476,287,763,35,798,1372,58.16%,34.69%,1
苗栗縣,苗栗市,0035,421,253,674,39,713,1213,58.78%,34.71%,1
苗栗縣,苗栗市,0036,452,242,694,31,725,1272,57%,35.53%,1
苗栗縣,苗栗市,0037,494,229,723,28,751,1221,61.51%,40.46%,1
苗栗縣,苗栗市,0038,371,230,601,46,647,1104,58.61%,33.61%,1
苗栗縣,苗栗市,0039,374,244,618,12,630,1171,53.8%,31.94%,1
苗栗縣,苗栗市,0040,471,281,752,34,786,1392,56.47%,33.84%,1
苗栗縣,苗栗市,0041,468,297,765,31,796,1356,58.7%,34.51%,1
苗栗縣,苗栗市,0042,481,285,766,41,807,1387,58.18%,34.68%,1
苗栗縣,苗栗市,0043,409,240,649,25,674,1206,55.89%,33.91%,1
苗栗縣,苗栗市,0044,362,253,615,25,640,1004,63.75%,36.06%,1
苗栗縣,苗栗市,0045,400,256,656,19,675,1202,56.16%,33.28%,1
苗栗縣,苗栗市,0046,375,240,615,26,641,1052,60.93%,35.65%,1
苗栗縣,苗栗市,0047,334,188,522,20,542,873,62.08%,38.26%,1
苗栗縣,苗栗市,0048,407,210,617,35,652,975,66.87%,41.74%,1
苗栗縣,苗栗市,0049,409,206,615,28,643,1003,64.11%,40.78%,1
苗栗縣,苗栗市,0050,345,226,571,14,585,1000,58.5%,34.5%,1
苗栗縣,苗栗市,0051,259,197,456,34,490,1047,46.8%,24.74%,1
苗栗縣,苗栗市,0052,392,211,603,26,629,1025,61.37%,38.24%,1
苗栗縣,苗栗市,0053,333,261,594,17,611,1130,54.07%,29.47%,1
苗栗縣,苗栗市,0054,388,238,626,26,652,1146,56.89%,33.86%,1
苗栗縣,苗栗市,0055,505,301,806,26,832,1432,58.1%,35.27%,1
苗栗縣,苗栗市,0056,463,215,678,36,714,1492,47.86%,31.03%,1
苗栗縣,苗栗市,0057,424,242,666,27,693,1125,61.6%,37.69%,1
苗栗縣,苗栗市,0058,408,253,661,34,695,1241,56%,32.88%,1
苗栗縣,苗栗市,0059,476,261,737,34,771,1278,60.33%,37.25%,1
苗栗縣,苗栗市,0060,446,266,712,18,730,1293,56.46%,34.49%,1
苗栗縣,苗栗市,0061,438,253,691,25,716,1342,53.35%,32.64%,1
苗栗縣,苗栗市,0062,273,179,452,26,478,857,55.78%,31.86%,1
苗栗縣,苗栗市,0063,386,231,617,30,647,1180,54.83%,32.71%,1
苗栗縣,苗栗市,0064,361,255,616,20,636,1072,59.33%,33.68%,1
苗栗縣,苗栗市,0065,295,183,478,30,508,912,55.7%,32.35%,1
苗栗縣,苗栗市,0066,258,145,403,23,426,796,53.52%,32.41%,1
苗栗縣,苗栗市,0067,240,181,421,19,440,869,50.63%,27.62%,1
苗栗縣,苑裡鎮,0183,319,170,489,34,523,873,59.91%,36.54%,1
苗栗縣,苑裡鎮,0184,458,297,755,40,795,1346,59.06%,34.03%,1
苗栗縣,苑裡鎮,0185,384,211,595,38,633,951,66.56%,40.38%,1
苗栗縣,苑裡鎮,0186,239,105,344,13,357,615,58.05%,38.86%,1
苗栗縣,苑裡鎮,0187,338,174,512,44,556,878,63.33%,38.5%,1
苗栗縣,苑裡鎮,0188,294,152,446,27,473,767,61.67%,38.33%,1
苗栗縣,苑裡鎮,0189,262,161,423,25,448,776,57.73%,33.76%,1
苗栗縣,苑裡鎮,0190,393,211,604,65,669,1231,54.35%,31.93%,1
苗栗縣,苑裡鎮,0191,395,254,649,37,686,1145,59.91%,34.5%,1
苗栗縣,苑裡鎮,0192,281,169,450,26,476,850,56%,33.06%,1
苗栗縣,苑裡鎮,0193,333,216,549,38,587,1052,55.8%,31.65%,1
苗栗縣,苑裡鎮,0194,349,243,592,47,639,1114,57.36%,31.33%,1
苗栗縣,苑裡鎮,0195,367,262,629,49,678,1136,59.68%,32.31%,1
苗栗縣,苑裡鎮,0196,394,245,639,44,683,1194,57.2%,33%,1
苗栗縣,苑裡鎮,0197,545,313,858,53,911,1579,57.69%,34.52%,1
苗栗縣,苑裡鎮,0198,421,246,667,45,712,1149,61.97%,36.64%,1
苗栗縣,苑裡鎮,0199,360,238,598,45,643,1057,60.83%,34.06%,1
苗栗縣,苑裡鎮,0200,295,247,542,24,566,1101,51.41%,26.79%,1
苗栗縣,苑裡鎮,0201,245,167,412,35,447,912,49.01%,26.86%,1
苗栗縣,苑裡鎮,0202,202,138,340,27,367,652,56.29%,30.98%,1
苗栗縣,苑裡鎮,0203,432,303,735,45,780,1348,57.86%,32.05%,1
苗栗縣,苑裡鎮,0204,209,158,367,16,383,733,52.25%,28.51%,1
苗栗縣,苑裡鎮,0205,205,128,333,11,344,662,51.96%,30.97%,1
苗栗縣,苑裡鎮,0206,302,184,486,29,515,893,57.67%,33.82%,1
苗栗縣,苑裡鎮,0207,304,213,517,31,548,910,60.22%,33.41%,1
苗栗縣,苑裡鎮,0208,398,258,656,53,709,1270,55.83%,31.34%,1
苗栗縣,苑裡鎮,0209,166,105,271,21,292,545,53.58%,30.46%,1
苗栗縣,苑裡鎮,0210,302,159,461,42,503,792,63.51%,38.13%,1
苗栗縣,苑裡鎮,0211,224,179,403,14,417,726,57.44%,30.85%,1
苗栗縣,苑裡鎮,0212,217,138,355,16,371,827,44.86%,26.24%,1
苗栗縣,苑裡鎮,0213,255,185,440,31,471,782,60.23%,32.61%,1
苗栗縣,苑裡鎮,0214,256,152,408,28,436,788,55.33%,32.49%,1
苗栗縣,苑裡鎮,0215,246,188,434,33,467,846,55.2%,29.08%,1
苗栗縣,苑裡鎮,0216,267,197,464,41,505,828,60.99%,32.25%,1
苗栗縣,苑裡鎮,0217,301,203,504,47,551,943,58.43%,31.92%,1
苗栗縣,苑裡鎮,0218,354,258,612,30,642,1082,59.33%,32.72%,1
苗栗縣,苑裡鎮,0219,405,295,700,48,748,1234,60.62%,32.82%,1
苗栗縣,苑裡鎮,0220,420,314,734,54,788,1434,54.95%,29.29%,1
苗栗縣,苑裡鎮,0221,339,205,544,27,571,987,57.85%,34.35%,1
苗栗縣,苑裡鎮,0222,311,213,524,39,563,882,63.83%,35.26%,1
苗栗縣,通霄鎮,0149,384,247,631,41,672,1142,58.84%,33.63%,1
苗栗縣,通霄鎮,0150,345,196,541,36,577,884,65.27%,39.03%,1
苗栗縣,通霄鎮,0151,362,201,563,44,607,1068,56.84%,33.9%,1
苗栗縣,通霄鎮,0152,378,248,626,24,650,1009,64.42%,37.46%,1
苗栗縣,通霄鎮,0153,359,187,546,17,563,859,65.54%,41.79%,1
苗栗縣,通霄鎮,0154,361,226,587,22,609,1040,58.56%,34.71%,1
苗栗縣,通霄鎮,0155,301,177,478,19,497,1008,49.31%,29.86%,1
苗栗縣,通霄鎮,0156,237,145,382,26,408,686,59.48%,34.55%,1
苗栗縣,通霄鎮,0157,315,178,493,28,521,761,68.46%,41.39%,1
苗栗縣,通霄鎮,0158,266,139,405,12,417,790,52.78%,33.67%,1
苗栗縣,通霄鎮,0159,311,201,512,22,534,966,55.28%,32.19%,1
苗栗縣,通霄鎮,0160,314,158,472,33,505,972,51.95%,32.3%,1
苗栗縣,通霄鎮,0161,286,129,415,30,445,771,57.72%,37.09%,1
苗栗縣,通霄鎮,0162,191,154,345,20,365,758,48.15%,25.2%,1
苗栗縣,通霄鎮,0163,331,215,546,39,585,1078,54.27%,30.71%,1
苗栗縣,通霄鎮,0164,105,74,179,20,199,459,43.36%,22.88%,1
苗栗縣,通霄鎮,0165,255,150,405,44,449,894,50.22%,28.52%,1
苗栗縣,通霄鎮,0166,92,59,151,8,159,402,39.55%,22.89%,1
苗栗縣,通霄鎮,0167,249,162,411,24,435,802,54.24%,31.05%,1
苗栗縣,通霄鎮,0168,175,170,345,14,359,684,52.49%,25.58%,1
苗栗縣,通霄鎮,0169,281,125,406,34,440,943,46.66%,29.8%,1
苗栗縣,通霄鎮,0170,267,175,442,38,480,790,60.76%,33.8%,1
苗栗縣,通霄鎮,0171,187,101,288,9,297,673,44.13%,27.79%,1
苗栗縣,通霄鎮,0172,358,241,599,53,652,1232,52.92%,29.06%,1
苗栗縣,通霄鎮,0173,454,256,710,48,758,1286,58.94%,35.3%,1
苗栗縣,通霄鎮,0174,224,141,365,23,388,649,59.78%,34.51%,1
苗栗縣,通霄鎮,0175,220,136,356,32,388,769,50.46%,28.61%,1
苗栗縣,通霄鎮,0176,343,237,580,52,632,1148,55.05%,29.88%,1
苗栗縣,通霄鎮,0177,298,225,523,52,575,1138,50.53%,26.19%,1
苗栗縣,通霄鎮,0178,339,234,573,14,587,1121,52.36%,30.24%,1
苗栗縣,通霄鎮,0179,224,181,405,22,427,769,55.53%,29.13%,1
苗栗縣,通霄鎮,0180,157,137,294,18,312,616,50.65%,25.49%,1
苗栗縣,通霄鎮,0181,250,147,397,41,438,799,54.82%,31.29%,1
苗栗縣,通霄鎮,0182,220,145,365,20,385,743,51.82%,29.61%,1
苗栗縣,竹南鎮,0270,374,261,635,22,657,1086,60.5%,34.44%,1
苗栗縣,竹南鎮,0271,272,187,459,32,491,826,59.44%,32.93%,1
苗栗縣,竹南鎮,0272,318,210,528,32,560,1051,53.28%,30.26%,1
苗栗縣,竹南鎮,0273,465,231,696,35,731,1235,59.19%,37.65%,1
苗栗縣,竹南鎮,0274,353,209,562,57,619,1016,60.93%,34.74%,1
苗栗縣,竹南鎮,0275,475,289,764,33,797,1472,54.14%,32.27%,1
苗栗縣,竹南鎮,0276,411,218,629,22,651,1301,50.04%,31.59%,1
苗栗縣,竹南鎮,0277,460,292,752,34,786,1544,50.91%,29.79%,1
苗栗縣,竹南鎮,0278,488,318,806,24,830,1512,54.89%,32.28%,1
苗栗縣,竹南鎮,0279,469,271,740,43,783,1463,53.52%,32.06%,1
苗栗縣,竹南鎮,0280,318,219,537,21,558,1073,52%,29.64%,1
苗栗縣,竹南鎮,0281,508,317,825,22,847,1453,58.29%,34.96%,1
苗栗縣,竹南鎮,0282,478,244,722,21,743,1245,59.68%,38.39%,1
苗栗縣,竹南鎮,0283,549,313,862,27,889,1487,59.78%,36.92%,1
苗栗縣,竹南鎮,0284,354,216,570,33,603,1018,59.23%,34.77%,1
苗栗縣,竹南鎮,0285,364,265,629,29,658,1105,59.55%,32.94%,1
苗栗縣,竹南鎮,0286,404,264,668,37,705,1322,53.33%,30.56%,1
苗栗縣,竹南鎮,0287,409,233,642,18,660,1140,57.89%,35.88%,1
苗栗縣,竹南鎮,0288,408,214,622,33,655,1067,61.39%,38.24%,1
苗栗縣,竹南鎮,0289,427,254,681,35,716,1136,63.03%,37.59%,1
苗栗縣,竹南鎮,0290,392,239,631,22,653,1253,52.11%,31.28%,1
苗栗縣,竹南鎮,0291,295,184,479,35,514,963,53.37%,30.63%,1
苗栗縣,竹南鎮,0292,277,247,524,33,557,1021,54.55%,27.13%,1
苗栗縣,竹南鎮,0293,398,266,664,34,698,1154,60.49%,34.49%,1
苗栗縣,竹南鎮,0294,342,229,571,29,600,1042,57.58%,32.82%,1
苗栗縣,竹南鎮,0295,452,265,717,28,745,1293,57.62%,34.96%,1
苗栗縣,竹南鎮,0296,302,170,472,16,488,816,59.8%,37.01%,1
苗栗縣,竹南鎮,0297,305,224,529,34,563,989,56.93%,30.84%,1
苗栗縣,竹南鎮,0298,421,229,650,29,679,1122,60.52%,37.52%,1
苗栗縣,竹南鎮,0299,302,202,504,20,524,1111,47.16%,27.18%,1
苗栗縣,竹南鎮,0300,392,181,573,42,615,1036,59.36%,37.84%,1
苗栗縣,竹南鎮,0301,349,184,533,27,560,1112,50.36%,31.38%,1
苗栗縣,竹南鎮,0302,458,235,693,10,703,1348,52.15%,33.98%,1
苗栗縣,竹南鎮,0303,369,261,630,24,654,1114,58.71%,33.12%,1
苗栗縣,竹南鎮,0304,409,229,638,36,674,1119,60.23%,36.55%,1
苗栗縣,竹南鎮,0305,318,157,475,25,500,878,56.95%,36.22%,1
苗栗縣,竹南鎮,0306,383,239,622,32,654,1059,61.76%,36.17%,1
苗栗縣,竹南鎮,0307,298,199,497,27,524,869,60.3%,34.29%,1
苗栗縣,竹南鎮,0308,253,172,425,25,450,800,56.25%,31.62%,1
苗栗縣,竹南鎮,0309,433,242,675,36,711,1165,61.03%,37.17%,1
苗栗縣,竹南鎮,0310,288,146,434,29,463,791,58.53%,36.41%,1
苗栗縣,竹南鎮,0311,242,129,371,20,391,677,57.75%,35.75%,1
苗栗縣,竹南鎮,0312,282,204,486,35,521,797,65.37%,35.38%,1
苗栗縣,竹南鎮,0313,405,240,645,22,667,1191,56%,34.01%,1
苗栗縣,竹南鎮,0314,330,198,528,21,549,1027,53.46%,32.13%,1
苗栗縣,竹南鎮,0315,450,311,761,28,789,1341,58.84%,33.56%,1
苗栗縣,竹南鎮,0316,440,234,674,30,704,1378,51.09%,31.93%,1
苗栗縣,竹南鎮,0317,410,241,651,30,681,1216,56%,33.72%,1
苗栗縣,竹南鎮,0318,546,272,818,31,849,1570,54.08%,34.78%,1
苗栗縣,竹南鎮,0319,192,129,321,17,338,538,62.83%,35.69%,1
苗栗縣,竹南鎮,0320,362,201,563,23,586,1166,50.26%,31.05%,1
苗栗縣,竹南鎮,0321,445,313,758,23,781,1488,52.49%,29.91%,1
苗栗縣,竹南鎮,0322,416,290,706,25,731,1449,50.45%,28.71%,1
苗栗縣,竹南鎮,0323,389,235,624,40,664,1182,56.18%,32.91%,1
苗栗縣,竹南鎮,0324,341,275,616,54,670,1175,57.02%,29.02%,1
苗栗縣,竹南鎮,0325,318,218,536,34,570,983,57.99%,32.35%,1
苗栗縣,竹南鎮,0326,173,118,291,18,309,492,62.8%,35.16%,1
苗栗縣,竹南鎮,0327,343,236,579,44,623,1074,58.01%,31.94%,1
苗栗縣,竹南鎮,0328,248,191,439,35,474,852,55.63%,29.11%,1
苗栗縣,竹南鎮,0329,414,248,662,25,687,1297,52.97%,31.92%,1
苗栗縣,竹南鎮,0330,295,231,526,33,559,1028,54.38%,28.7%,1
苗栗縣,頭份市,0331,301,149,450,48,498,915,54.43%,32.9%,1
苗栗縣,頭份市,0332,438,241,679,57,736,1292,56.97%,33.9%,1
苗栗縣,頭份市,0333,321,206,527,26,553,928,59.59%,34.59%,1
苗栗縣,頭份市,0334,299,134,433,14,447,835,53.53%,35.81%,1
苗栗縣,頭份市,0335,357,213,570,19,589,1070,55.05%,33.36%,1
苗栗縣,頭份市,0336,279,171,450,13,463,879,52.67%,31.74%,1
苗栗縣,頭份市,0337,333,189,522,21,543,1039,52.26%,32.05%,1
苗栗縣,頭份市,0338,398,227,625,35,660,1129,58.46%,35.25%,1
苗栗縣,頭份市,0339,318,215,533,39,572,1041,54.95%,30.55%,1
苗栗縣,頭份市,0340,474,282,756,45,801,1546,51.81%,30.66%,1
苗栗縣,頭份市,0341,341,201,542,43,585,935,62.57%,36.47%,1
苗栗縣,頭份市,0342,354,229,583,36,619,1180,52.46%,30%,1
苗栗縣,頭份市,0343,459,289,748,31,779,1499,51.97%,30.62%,1
苗栗縣,頭份市,0344,243,154,397,9,406,747,54.35%,32.53%,1
苗栗縣,頭份市,0345,472,272,744,34,778,1406,55.33%,33.57%,1
苗栗縣,頭份市,0346,375,260,635,40,675,1193,56.58%,31.43%,1
苗栗縣,頭份市,0347,327,190,517,41,558,948,58.86%,34.49%,1
苗栗縣,頭份市,0348,293,165,458,17,475,869,54.66%,33.72%,1
苗栗縣,頭份市,0349,391,242,633,34,667,1142,58.41%,34.24%,1
苗栗縣,頭份市,0350,407,281,688,26,714,1286,55.52%,31.65%,1
苗栗縣,頭份市,0351,315,198,513,27,540,903,59.8%,34.88%,1
苗栗縣,頭份市,0352,439,260,699,36,735,1186,61.97%,37.02%,1
苗栗縣,頭份市,0353,382,209,591,13,604,1016,59.45%,37.6%,1
苗栗縣,頭份市,0354,330,206,536,23,559,985,56.75%,33.5%,1
苗栗縣,頭份市,0355,323,211,534,30,564,1037,54.39%,31.15%,1
苗栗縣,頭份市,0356,372,70,442,22,464,947,49%,39.28%,1
苗栗縣,頭份市,0357,313,180,493,28,521,890,58.54%,35.17%,1
苗栗縣,頭份市,0358,235,145,380,32,412,646,63.78%,36.38%,1
苗栗縣,頭份市,0359,512,18,530,49,579,975,59.38%,52.51%,1
苗栗縣,頭份市,0360,232,154,386,11,397,1015,39.11%,22.86%,1
苗栗縣,頭份市,0361,532,291,823,56,879,1399,62.83%,38.03%,1
苗栗縣,頭份市,0362,371,274,645,41,686,1143,60.02%,32.46%,1
苗栗縣,頭份市,0363,424,211,635,37,672,1030,65.24%,41.17%,1
苗栗縣,頭份市,0364,460,281,741,37,778,1338,58.15%,34.38%,1
苗栗縣,頭份市,0365,504,274,778,21,799,1450,55.1%,34.76%,1
苗栗縣,頭份市,0366,382,213,595,16,611,1042,58.64%,36.66%,1
苗栗縣,頭份市,0367,481,288,769,30,799,1326,60.26%,36.27%,1
苗栗縣,頭份市,0368,477,301,778,24,802,1270,63.15%,37.56%,1
苗栗縣,頭份市,0369,421,273,694,37,731,1288,56.75%,32.69%,1
苗栗縣,頭份市,0370,488,244,732,22,754,1243,60.66%,39.26%,1
苗栗縣,頭份市,0371,495,240,735,21,756,1280,59.06%,38.67%,1
苗栗縣,頭份市,0372,573,307,880,34,914,1618,56.49%,35.41%,1
苗栗縣,頭份市,0373,578,329,907,40,947,1759,53.84%,32.86%,1
苗栗縣,頭份市,0374,481,243,724,31,755,1264,59.73%,38.05%,1
苗栗縣,頭份市,0375,441,309,750,18,768,1326,57.92%,33.26%,1
苗栗縣,頭份市,0376,526,331,857,20,877,1551,56.54%,33.91%,1
苗栗縣,頭份市,0377,494,270,764,48,812,1574,51.59%,31.39%,1
苗栗縣,頭份市,0378,423,268,691,37,728,1262,57.69%,33.52%,1
苗栗縣,頭份市,0379,427,228,655,33,688,1171,58.75%,36.46%,1
苗栗縣,頭份市,0380,426,246,672,27,699,1074,65.08%,39.66%,1
苗栗縣,頭份市,0381,428,241,669,21,690,1141,60.47%,37.51%,1
苗栗縣,頭份市,0382,410,297,707,28,735,1259,58.38%,32.57%,1
苗栗縣,頭份市,0383,391,251,642,19,661,1186,55.73%,32.97%,1
苗栗縣,頭份市,0384,354,209,563,22,585,1121,52.19%,31.58%,1
苗栗縣,頭份市,0385,277,190,467,20,487,847,57.5%,32.7%,1
苗栗縣,頭份市,0386,333,245,578,21,599,993,60.32%,33.53%,1
苗栗縣,頭份市,0387,349,205,554,26,580,1055,54.98%,33.08%,1
苗栗縣,頭份市,0388,601,218,819,34,853,1655,51.54%,36.31%,1
苗栗縣,頭份市,0389,575,341,916,74,990,1799,55.03%,31.96%,1
苗栗縣,頭份市,0390,401,226,627,36,663,1141,58.11%,35.14%,1
苗栗縣,頭份市,0391,472,280,752,32,784,1431,54.79%,32.98%,1
苗栗縣,頭份市,0392,385,269,654,28,682,1412,48.3%,27.27%,1
苗栗縣,頭份市,0393,329,217,546,20,566,1074,52.7%,30.63%,1
苗栗縣,頭份市,0394,429,276,705,38,743,1245,59.68%,34.46%,1
苗栗縣,頭份市,0395,401,350,751,51,802,1344,59.67%,29.84%,1
苗栗縣,頭份市,0396,470,306,776,66,842,1363,61.78%,34.48%,1
苗栗縣,頭份市,0397,336,203,539,34,573,898,63.81%,37.42%,1
苗栗縣,頭份市,0398,393,260,653,62,715,1182,60.49%,33.25%,1
苗栗縣,頭份市,0399,495,262,757,26,783,1413,55.41%,35.03%,1
苗栗縣,頭份市,0400,354,247,601,15,616,991,62.16%,35.72%,1
苗栗縣,頭份市,0401,387,272,659,37,696,1180,58.98%,32.8%,1
苗栗縣,後龍鎮,0223,206,118,324,25,349,590,59.15%,34.92%,1
苗栗縣,後龍鎮,0224,312,213,525,43,568,883,64.33%,35.33%,1
苗栗縣,後龍鎮,0225,262,205,467,30,497,793,62.67%,33.04%,1
苗栗縣,後龍鎮,0226,252,169,421,21,442,732,60.38%,34.43%,1
苗栗縣,後龍鎮,0227,213,134,347,17,364,592,61.49%,35.98%,1
苗栗縣,後龍鎮,0228,355,265,620,47,667,1113,59.93%,31.9%,1
苗栗縣,後龍鎮,0229,385,262,647,30,677,1195,56.65%,32.22%,1
苗栗縣,後龍鎮,0230,368,220,588,34,622,997,62.39%,36.91%,1
苗栗縣,後龍鎮,0231,256,184,440,21,461,913,50.49%,28.04%,1
苗栗縣,後龍鎮,0232,163,143,306,34,340,641,53.04%,25.43%,1
苗栗縣,後龍鎮,0233,229,187,416,36,452,848,53.3%,27%,1
苗栗縣,後龍鎮,0234,387,249,636,65,701,1264,55.46%,30.62%,1
苗栗縣,後龍鎮,0235,265,210,475,28,503,965,52.12%,27.46%,1
苗栗縣,後龍鎮,0236,481,320,801,51,852,1216,70.07%,39.56%,1
苗栗縣,後龍鎮,0237,301,203,504,27,531,977,54.35%,30.81%,1
苗栗縣,後龍鎮,0238,285,158,443,33,476,943,50.48%,30.22%,1
苗栗縣,後龍鎮,0239,283,195,478,44,522,910,57.36%,31.1%,1
苗栗縣,後龍鎮,0240,255,185,440,34,474,851,55.7%,29.96%,1
苗栗縣,後龍鎮,0241,257,184,441,22,463,725,63.86%,35.45%,1
苗栗縣,後龍鎮,0242,214,155,369,21,390,650,60%,32.92%,1
苗栗縣,後龍鎮,0243,198,137,335,34,369,706,52.27%,28.05%,1
苗栗縣,後龍鎮,0244,220,188,408,29,437,748,58.42%,29.41%,1
苗栗縣,後龍鎮,0245,195,155,350,27,377,801,47.07%,24.34%,1
苗栗縣,後龍鎮,0246,352,230,582,43,625,1107,56.46%,31.8%,1
苗栗縣,後龍鎮,0247,335,258,593,53,646,1197,53.97%,27.99%,1
苗栗縣,後龍鎮,0248,288,192,480,48,528,1036,50.97%,27.8%,1
苗栗縣,後龍鎮,0249,229,161,390,36,426,913,46.66%,25.08%,1
苗栗縣,後龍鎮,0250,248,153,401,39,440,719,61.2%,34.49%,1
苗栗縣,後龍鎮,0251,333,212,545,54,599,1037,57.76%,32.11%,1
苗栗縣,後龍鎮,0252,166,126,292,15,307,601,51.08%,27.62%,1
苗栗縣,後龍鎮,0253,285,255,540,43,583,1269,45.94%,22.46%,1
苗栗縣,後龍鎮,0254,186,146,332,35,367,735,49.93%,25.31%,1
苗栗縣,後龍鎮,0255,69,67,136,12,148,422,35.07%,16.35%,1
苗栗縣,後龍鎮,0256,205,142,347,16,363,625,58.08%,32.8%,1
苗栗縣,後龍鎮,0257,339,202,541,33,574,1234,46.52%,27.47%,1
苗栗縣,卓蘭鎮,0442,431,114,545,39,584,961,60.77%,44.85%,1
苗栗縣,卓蘭鎮,0443,319,219,538,39,577,1017,56.74%,31.37%,1
苗栗縣,卓蘭鎮,0444,378,273,651,55,706,1095,64.47%,34.52%,1
苗栗縣,卓蘭鎮,0445,285,154,439,21,460,745,61.74%,38.26%,1
苗栗縣,卓蘭鎮,0446,240,156,396,37,433,783,55.3%,30.65%,1
苗栗縣,卓蘭鎮,0447,233,127,360,14,374,745,50.2%,31.28%,1
苗栗縣,卓蘭鎮,0448,313,173,486,26,512,999,51.25%,31.33%,1
苗栗縣,卓蘭鎮,0449,235,145,380,38,418,671,62.3%,35.02%,1
苗栗縣,卓蘭鎮,0450,232,199,431,52,483,734,65.8%,31.61%,1
苗栗縣,卓蘭鎮,0451,318,186,504,38,542,865,62.66%,36.76%,1
苗栗縣,卓蘭鎮,0452,315,171,486,41,527,828,63.65%,38.04%,1
苗栗縣,卓蘭鎮,0453,129,85,214,31,245,386,63.47%,33.42%,1
苗栗縣,卓蘭鎮,0454,229,184,413,31,444,688,64.53%,33.28%,1
苗栗縣,卓蘭鎮,0455,256,202,458,34,492,792,62.12%,32.32%,1
苗栗縣,卓蘭鎮,0456,231,174,405,26,431,729,59.12%,31.69%,1
苗栗縣,卓蘭鎮,0457,277,222,499,35,534,1093,48.86%,25.34%,1
苗栗縣,卓蘭鎮,0458,213,128,341,25,366,615,59.51%,34.63%,1
苗栗縣,卓蘭鎮,0459,33,13,46,1,47,86,54.65%,38.37%,1
苗栗縣,卓蘭鎮,0460,302,195,497,19,516,940,54.89%,32.13%,1
苗栗縣,大湖鄉,0420,239,144,383,23,406,744,54.57%,32.12%,1
苗栗縣,大湖鄉,0421,288,172,460,27,487,881,55.28%,32.69%,1
苗栗縣,大湖鄉,0422,196,118,314,26,340,596,57.05%,32.89%,1
苗栗縣,大湖鄉,0423,353,245,598,57,655,1260,51.98%,28.02%,1
苗栗縣,大湖鄉,0424,271,162,433,24,457,867,52.71%,31.26%,1
苗栗縣,大湖鄉,0425,310,179,489,31,520,923,56.34%,33.59%,1
苗栗縣,大湖鄉,0426,425,247,672,64,736,1395,52.76%,30.47%,1
苗栗縣,大湖鄉,0427,122,73,195,17,212,561,37.79%,21.75%,1
苗栗縣,大湖鄉,0428,225,123,348,24,372,638,58.31%,35.27%,1
苗栗縣,大湖鄉,0429,219,149,368,32,400,754,53.05%,29.05%,1
苗栗縣,大湖鄉,0430,141,103,244,8,252,501,50.3%,28.14%,1
苗栗縣,大湖鄉,0431,192,148,340,20,360,652,55.21%,29.45%,1
苗栗縣,大湖鄉,0432,213,174,387,28,415,843,49.23%,25.27%,1
苗栗縣,大湖鄉,0433,295,210,505,73,578,1020,56.67%,28.92%,1
苗栗縣,大湖鄉,0434,329,212,541,38,579,1018,56.88%,32.32%,1
苗栗縣,公館鄉,0068,298,195,493,30,523,789,66.29%,37.77%,1
苗栗縣,公館鄉,0069,306,195,501,24,525,792,66.29%,38.64%,1
苗栗縣,公館鄉,0070,411,255,666,51,717,1117,64.19%,36.79%,1
苗栗縣,公館鄉,0071,452,294,746,45,791,1255,63.03%,36.02%,1
苗栗縣,公館鄉,0072,373,278,651,31,682,1141,59.77%,32.69%,1
苗栗縣,公館鄉,0073,376,273,649,38,687,1172,58.62%,32.08%,1
苗栗縣,公館鄉,0074,382,278,660,37,697,1100,63.36%,34.73%,1
苗栗縣,公館鄉,0075,363,250,613,38,651,1232,52.84%,29.46%,1
苗栗縣,公館鄉,0076,319,211,530,44,574,1081,53.1%,29.51%,1
苗栗縣,公館鄉,0077,460,277,737,41,778,1250,62.24%,36.8%,1
苗栗縣,公館鄉,0078,369,232,601,30,631,1081,58.37%,34.14%,1
苗栗縣,公館鄉,0079,288,213,501,52,553,964,57.37%,29.88%,1
苗栗縣,公館鄉,0080,356,224,580,48,628,1038,60.5%,34.3%,1
苗栗縣,公館鄉,0081,122,92,214,13,227,360,63.06%,33.89%,1
苗栗縣,公館鄉,0082,278,185,463,35,498,865,57.57%,32.14%,1
苗栗縣,公館鄉,0083,371,257,628,24,652,1166,55.92%,31.82%,1
苗栗縣,公館鄉,0084,246,153,399,30,429,719,59.67%,34.21%,1
苗栗縣,公館鄉,0085,236,161,397,38,435,788,55.2%,29.95%,1
苗栗縣,公館鄉,0086,97,87,184,18,202,303,66.67%,32.01%,1
苗栗縣,公館鄉,0087,441,307,748,49,797,1322,60.29%,33.36%,1
苗栗縣,公館鄉,0088,262,228,490,44,534,933,57.23%,28.08%,1
苗栗縣,公館鄉,0089,428,300,728,62,790,1455,54.3%,29.42%,1
苗栗縣,公館鄉,0090,512,397,909,89,998,1615,61.8%,31.7%,1
苗栗縣,公館鄉,0091,466,277,743,63,806,1451,55.55%,32.12%,1
苗栗縣,公館鄉,0092,447,376,823,59,882,1462,60.33%,30.57%,1
苗栗縣,公館鄉,0093,373,323,696,41,737,1317,55.96%,28.32%,1
苗栗縣,公館鄉,0094,77,46,123,8,131,221,59.28%,34.84%,1
苗栗縣,公館鄉,0095,100,65,165,10,175,329,53.19%,30.4%,1
苗栗縣,銅鑼鄉,0108,313,201,514,34,548,887,61.78%,35.29%,1
苗栗縣,銅鑼鄉,0109,353,224,577,54,631,1052,59.98%,33.56%,1
苗栗縣,銅鑼鄉,0110,472,316,788,35,823,1347,61.1%,35.04%,1
苗栗縣,銅鑼鄉,0111,351,279,630,36,666,1177,56.58%,29.82%,1
苗栗縣,銅鑼鄉,0112,369,281,650,31,681,1268,53.71%,29.1%,1
苗栗縣,銅鑼鄉,0113,324,224,548,36,584,1185,49.28%,27.34%,1
苗栗縣,銅鑼鄉,0114,351,218,569,28,597,1029,58.02%,34.11%,1
苗栗縣,銅鑼鄉,0115,321,173,494,29,523,905,57.79%,35.47%,1
苗栗縣,銅鑼鄉,0116,267,178,445,23,468,750,62.4%,35.6%,1
苗栗縣,銅鑼鄉,0117,335,185,520,39,559,1080,51.76%,31.02%,1
苗栗縣,銅鑼鄉,0118,326,224,550,56,606,1108,54.69%,29.42%,1
苗栗縣,銅鑼鄉,0119,226,197,423,34,457,862,53.02%,26.22%,1
苗栗縣,銅鑼鄉,0120,347,272,619,27,646,1216,53.13%,28.54%,1
苗栗縣,銅鑼鄉,0121,160,118,278,25,303,588,51.53%,27.21%,1
苗栗縣,銅鑼鄉,0122,110,90,200,35,235,429,54.78%,25.64%,1
苗栗縣,銅鑼鄉,0123,160,123,283,34,317,541,58.6%,29.57%,1
苗栗縣,南庄鄉,0411,331,270,601,41,642,1155,55.58%,28.66%,1
苗栗縣,南庄鄉,0412,180,159,339,34,373,650,57.38%,27.69%,1
苗栗縣,南庄鄉,0413,402,253,655,44,699,1353,51.66%,29.71%,1
苗栗縣,南庄鄉,0414,181,145,326,29,355,813,43.67%,22.26%,1
苗栗縣,南庄鄉,0415,207,132,339,21,360,837,43.01%,24.73%,1
苗栗縣,南庄鄉,0416,333,214,547,31,578,1093,52.88%,30.47%,1
苗栗縣,南庄鄉,0417,320,211,531,44,575,1048,54.87%,30.53%,1
苗栗縣,南庄鄉,0418,244,177,421,25,446,872,51.15%,27.98%,1
苗栗縣,南庄鄉,0419,171,130,301,14,315,963,32.71%,17.76%,1
苗栗縣,頭屋鄉,0096,551,284,835,59,894,1335,66.97%,41.27%,1
苗栗縣,頭屋鄉,0097,483,271,754,75,829,1168,70.98%,41.35%,1
苗栗縣,頭屋鄉,0098,312,178,490,29,519,792,65.53%,39.39%,1
苗栗縣,頭屋鄉,0099,391,243,634,24,658,918,71.68%,42.59%,1
苗栗縣,頭屋鄉,0100,273,164,437,28,465,725,64.14%,37.66%,1
苗栗縣,頭屋鄉,0101,300,227,527,28,555,899,61.74%,33.37%,1
苗栗縣,頭屋鄉,0102,122,53,175,8,183,369,49.59%,33.06%,1
苗栗縣,頭屋鄉,0103,282,207,489,15,504,844,59.72%,33.41%,1
苗栗縣,頭屋鄉,0104,342,247,589,25,614,1007,60.97%,33.96%,1
苗栗縣,頭屋鄉,0105,289,192,481,22,503,794,63.35%,36.4%,1
苗栗縣,頭屋鄉,0106,94,49,143,14,157,211,74.41%,44.55%,1
苗栗縣,頭屋鄉,0107,133,87,220,19,239,328,72.87%,40.55%,1
苗栗縣,三義鄉,0124,327,163,490,34,524,853,61.43%,38.34%,1
苗栗縣,三義鄉,0125,401,191,592,20,612,983,62.26%,40.79%,1
苗栗縣,三義鄉,0126,351,246,597,51,648,1080,60%,32.5%,1
苗栗縣,三義鄉,0127,406,219,625,24,649,1216,53.37%,33.39%,1
苗栗縣,三義鄉,0128,356,224,580,25,605,1017,59.49%,35%,1
苗栗縣,三義鄉,0129,388,215,603,30,633,1180,53.64%,32.88%,1
苗栗縣,三義鄉,0130,422,247,669,15,684,1198,57.1%,35.23%,1
苗栗縣,三義鄉,0131,131,95,226,15,241,417,57.79%,31.41%,1
苗栗縣,三義鄉,0132,297,206,503,20,523,991,52.77%,29.97%,1
苗栗縣,三義鄉,0133,295,171,466,24,490,834,58.75%,35.37%,1
苗栗縣,三義鄉,0134,199,143,342,25,367,622,59%,31.99%,1
苗栗縣,三義鄉,0135,232,182,414,46,460,749,61.42%,30.97%,1
苗栗縣,三義鄉,0136,261,176,437,23,460,692,66.47%,37.72%,1
苗栗縣,三義鄉,0137,311,184,495,40,535,759,70.49%,40.97%,1
苗栗縣,三義鄉,0138,180,141,321,15,336,629,53.42%,28.62%,1
苗栗縣,三義鄉,0139,208,148,356,30,386,669,57.7%,31.09%,1
苗栗縣,西湖鄉,0140,167,152,319,23,342,601,56.91%,27.79%,1
苗栗縣,西湖鄉,0141,190,132,322,19,341,566,60.25%,33.57%,1
苗栗縣,西湖鄉,0142,263,187,450,26,476,843,56.47%,31.2%,1
苗栗縣,西湖鄉,0143,195,128,323,19,342,648,52.78%,30.09%,1
苗栗縣,西湖鄉,0144,255,176,431,46,477,936,50.96%,27.24%,1
苗栗縣,西湖鄉,0145,133,107,240,8,248,461,53.8%,28.85%,1
苗栗縣,西湖鄉,0146,183,98,281,17,298,515,57.86%,35.53%,1
苗栗縣,西湖鄉,0147,365,209,574,41,615,1141,53.9%,31.99%,1
苗栗縣,西湖鄉,0148,224,148,372,24,396,671,59.02%,33.38%,1
苗栗縣,造橋鄉,0258,471,254,725,45,770,1171,65.76%,40.22%,1
苗栗縣,造橋鄉,0259,305,196,501,29,530,889,59.62%,34.31%,1
苗栗縣,造橋鄉,0260,144,86,230,9,239,479,49.9%,30.06%,1
苗栗縣,造橋鄉,0261,393,180,573,31,604,1024,58.98%,38.38%,1
苗栗縣,造橋鄉,0262,337,264,601,57,658,1214,54.2%,27.76%,1
苗栗縣,造橋鄉,0263,301,221,522,39,561,1071,52.38%,28.1%,1
苗栗縣,造橋鄉,0264,345,212,557,51,608,1157,52.55%,29.82%,1
苗栗縣,造橋鄉,0265,183,100,283,19,302,512,58.98%,35.74%,1
苗栗縣,造橋鄉,0266,154,135,289,20,309,491,62.93%,31.36%,1
苗栗縣,造橋鄉,0267,415,305,720,47,767,1272,60.3%,32.63%,1
苗栗縣,造橋鄉,0268,256,169,425,27,452,785,57.58%,32.61%,1
苗栗縣,造橋鄉,0269,312,237,549,74,623,962,64.76%,32.43%,1
苗栗縣,三灣鄉,0402,344,227,571,25,596,996,59.84%,34.54%,1
苗栗縣,三灣鄉,0403,440,234,674,42,716,1205,59.42%,36.51%,1
苗栗縣,三灣鄉,0404,205,157,362,26,388,635,61.1%,32.28%,1
苗栗縣,三灣鄉,0405,296,160,456,40,496,862,57.54%,34.34%,1
苗栗縣,三灣鄉,0406,67,39,106,12,118,238,49.58%,28.15%,1
苗栗縣,三灣鄉,0407,147,129,276,18,294,541,54.34%,27.17%,1
苗栗縣,三灣鄉,0408,150,122,272,27,299,578,51.73%,25.95%,1
苗栗縣,三灣鄉,0409,155,102,257,22,279,405,68.89%,38.27%,1
苗栗縣,三灣鄉,0410,110,99,209,15,224,392,57.14%,28.06%,1
苗栗縣,獅潭鄉,0435,77,46,123,7,130,328,39.63%,23.48%,1
苗栗縣,獅潭鄉,0436,135,89,224,28,252,565,44.6%,23.89%,1
苗栗縣,獅潭鄉,0437,293,171,464,60,524,911,57.52%,32.16%,1
苗栗縣,獅潭鄉,0438,146,107,253,18,271,568,47.71%,25.7%,1
苗栗縣,獅潭鄉,0439,180,124,304,37,341,580,58.79%,31.03%,1
苗栗縣,獅潭鄉,0440,107,57,164,7,171,333,51.35%,32.13%,1
苗栗縣,獅潭鄉,0441,228,106,334,20,354,683,51.83%,33.38%,1
苗栗縣,泰安鄉,0461,72,70,142,7,149,325,45.85%,22.15%,1
苗栗縣,泰安鄉,0462,154,116,270,16,286,484,59.09%,31.82%,1
苗栗縣,泰安鄉,0463,277,168,445,43,488,666,73.27%,41.59%,1
苗栗縣,泰安鄉,0464,242,116,358,31,389,574,67.77%,42.16%,1
苗栗縣,泰安鄉,0465,108,60,168,8,176,333,52.85%,32.43%,1
苗栗縣,泰安鄉,0466,223,117,340,9,349,495,70.51%,45.05%,1
苗栗縣,泰安鄉,0467,225,153,378,22,400,544,73.53%,41.36%,1
苗栗縣,泰安鄉,0468,167,127,294,22,316,500,63.2%,33.4%,1
苗栗縣,泰安鄉,0469,318,146,464,16,480,670,71.64%,47.46%,1
苗栗縣,泰安鄉,0470,246,176,422,6,428,589,72.67%,41.77%,1
彰化縣,彰化市,0001,315,101,416,17,433,871,49.71%,36.17%,1
彰化縣,彰化市,0002,210,129,339,26,365,751,48.6%,27.96%,1
彰化縣,彰化市,0003,334,247,581,30,611,923,66.2%,36.19%,1
彰化縣,彰化市,0004,276,177,453,31,484,779,62.13%,35.43%,1
彰化縣,彰化市,0005,267,186,453,26,479,779,61.49%,34.27%,1
彰化縣,彰化市,0006,260,159,419,17,436,720,60.56%,36.11%,1
彰化縣,彰化市,0007,261,164,425,22,447,749,59.68%,34.85%,1
彰化縣,彰化市,0008,290,180,470,34,504,767,65.71%,37.81%,1
彰化縣,彰化市,0009,395,228,623,40,663,1047,63.32%,37.73%,1
彰化縣,彰化市,0010,336,216,552,37,589,1027,57.35%,32.72%,1
彰化縣,彰化市,0011,433,244,677,35,712,1249,57.01%,34.67%,1
彰化縣,彰化市,0012,442,216,658,21,679,1136,59.77%,38.91%,1
彰化縣,彰化市,0013,463,229,692,34,726,1169,62.1%,39.61%,1
彰化縣,彰化市,0014,296,174,470,18,488,766,63.71%,38.64%,1
彰化縣,彰化市,0015,276,100,376,16,392,643,60.96%,42.92%,1
彰化縣,彰化市,0016,466,253,719,28,747,1251,59.71%,37.25%,1
彰化縣,彰化市,0017,302,180,482,26,508,1301,39.05%,23.21%,1
彰化縣,彰化市,0018,471,278,749,28,777,1280,60.7%,36.8%,1
彰化縣,彰化市,0019,467,241,708,24,732,1179,62.09%,39.61%,1
彰化縣,彰化市,0020,426,232,658,31,689,1168,58.99%,36.47%,1
彰化縣,彰化市,0021,436,254,690,28,718,1218,58.95%,35.8%,1
彰化縣,彰化市,0022,551,315,866,17,883,1351,65.36%,40.78%,1
彰化縣,彰化市,0023,384,321,705,20,725,1204,60.22%,31.89%,1
彰化縣,彰化市,0024,437,255,692,23,715,1189,60.13%,36.75%,1
彰化縣,彰化市,0025,430,237,667,34,701,1207,58.08%,35.63%,1
彰化縣,彰化市,0026,424,240,664,30,694,1161,59.78%,36.52%,1
彰化縣,彰化市,0027,388,253,641,28,669,1166,57.38%,33.28%,1
彰化縣,彰化市,0028,490,317,807,28,835,1362,61.31%,35.98%,1
彰化縣,彰化市,0029,447,289,736,36,772,1236,62.46%,36.17%,1
彰化縣,彰化市,0030,373,239,612,31,643,1065,60.38%,35.02%,1
彰化縣,彰化市,0031,428,263,691,32,723,1199,60.3%,35.7%,1
彰化縣,彰化市,0032,433,293,726,16,742,1233,60.18%,35.12%,1
彰化縣,彰化市,0033,462,238,700,24,724,1245,58.15%,37.11%,1
彰化縣,彰化市,0034,430,261,691,27,718,1153,62.27%,37.29%,1
彰化縣,彰化市,0035,357,220,577,17,594,1045,56.84%,34.16%,1
彰化縣,彰化市,0036,386,253,639,11,650,1097,59.25%,35.19%,1
彰化縣,彰化市,0037,420,249,669,28,697,1190,58.57%,35.29%,1
彰化縣,彰化市,0038,418,255,673,20,693,1106,62.66%,37.79%,1
彰化縣,彰化市,0039,384,254,638,25,663,1097,60.44%,35%,1
彰化縣,彰化市,0040,354,255,609,33,642,1048,61.26%,33.78%,1
彰化縣,彰化市,0041,384,213,597,21,618,980,63.06%,39.18%,1
彰化縣,彰化市,0042,259,174,433,15,448,707,63.37%,36.63%,1
彰化縣,彰化市,0043,285,180,465,26,491,809,60.69%,35.23%,1
彰化縣,彰化市,0044,361,237,598,35,633,1008,62.8%,35.81%,1
彰化縣,彰化市,0045,292,192,484,30,514,901,57.05%,32.41%,1
彰化縣,彰化市,0046,327,204,531,20,551,951,57.94%,34.38%,1
彰化縣,彰化市,0047,381,240,621,26,647,1076,60.13%,35.41%,1
彰化縣,彰化市,0048,353,202,555,19,574,1022,56.16%,34.54%,1
彰化縣,彰化市,0049,337,185,522,28,550,894,61.52%,37.7%,1
彰化縣,彰化市,0050,389,215,604,28,632,1016,62.2%,38.29%,1
彰化縣,彰化市,0051,294,178,472,27,499,771,64.72%,38.13%,1
彰化縣,彰化市,0052,295,215,510,26,536,868,61.75%,33.99%,1
彰化縣,彰化市,0053,401,242,643,45,688,1135,60.62%,35.33%,1
彰化縣,彰化市,0054,304,280,584,38,622,910,68.35%,33.41%,1
彰化縣,彰化市,0055,368,251,619,21,640,1004,63.75%,36.65%,1
彰化縣,彰化市,0056,382,262,644,29,673,1077,62.49%,35.47%,1
彰化縣,彰化市,0057,500,294,794,35,829,1258,65.9%,39.75%,1
彰化縣,彰化市,0058,424,204,628,26,654,1025,63.8%,41.37%,1
彰化縣,彰化市,0059,445,270,715,38,753,1177,63.98%,37.81%,1
彰化縣,彰化市,0060,436,261,697,31,728,1262,57.69%,34.55%,1
彰化縣,彰化市,0061,461,249,710,44,754,1209,62.37%,38.13%,1
彰化縣,彰化市,0062,393,238,631,29,660,1041,63.4%,37.75%,1
彰化縣,彰化市,0063,445,211,656,24,680,1075,63.26%,41.4%,1
彰化縣,彰化市,0064,383,191,574,25,599,1029,58.21%,37.22%,1
彰化縣,彰化市,0065,407,261,668,37,705,1203,58.6%,33.83%,1
彰化縣,彰化市,0066,376,186,562,29,591,1014,58.28%,37.08%,1
彰化縣,彰化市,0067,395,226,621,25,646,1069,60.43%,36.95%,1
彰化縣,彰化市,0068,330,184,514,15,529,969,54.59%,34.06%,1
彰化縣,彰化市,0069,362,215,577,20,597,1105,54.03%,32.76%,1
彰化縣,彰化市,0070,376,227,603,32,635,981,64.73%,38.33%,1
彰化縣,彰化市,0071,393,268,661,39,700,1095,63.93%,35.89%,1
彰化縣,彰化市,0072,431,224,655,23,678,1087,62.37%,39.65%,1
彰化縣,彰化市,0073,346,288,634,17,651,1050,62%,32.95%,1
彰化縣,彰化市,0074,444,301,745,26,771,1252,61.58%,35.46%,1
彰化縣,彰化市,0075,387,228,615,22,637,1113,57.23%,34.77%,1
彰化縣,彰化市,0076,365,243,608,28,636,1009,63.03%,36.17%,1
彰化縣,彰化市,0077,346,213,559,28,587,999,58.76%,34.63%,1
彰化縣,彰化市,0078,333,232,565,22,587,997,58.88%,33.4%,1
彰化縣,彰化市,0079,424,297,721,22,743,1145,64.89%,37.03%,1
彰化縣,彰化市,0080,436,282,718,29,747,1227,60.88%,35.53%,1
彰化縣,彰化市,0081,434,302,736,23,759,1208,62.83%,35.93%,1
彰化縣,彰化市,0082,560,348,908,21,929,1598,58.14%,35.04%,1
彰化縣,彰化市,0083,300,208,508,41,549,890,61.69%,33.71%,1
彰化縣,彰化市,0084,406,100,506,47,553,1104,50.09%,36.78%,1
彰化縣,彰化市,0085,379,236,615,21,636,1097,57.98%,34.55%,1
彰化縣,彰化市,0086,291,146,437,32,469,799,58.7%,36.42%,1
彰化縣,彰化市,0087,381,212,593,31,624,1000,62.4%,38.1%,1
彰化縣,彰化市,0088,418,223,641,40,681,1153,59.06%,36.25%,1
彰化縣,彰化市,0089,361,204,565,45,610,977,62.44%,36.95%,1
彰化縣,彰化市,0090,407,258,665,30,695,1201,57.87%,33.89%,1
彰化縣,彰化市,0091,357,263,620,47,667,1057,63.1%,33.77%,1
彰化縣,彰化市,0092,406,276,682,49,731,1238,59.05%,32.79%,1
彰化縣,彰化市,0093,453,253,706,41,747,1210,61.74%,37.44%,1
彰化縣,彰化市,0094,389,221,610,28,638,1026,62.18%,37.91%,1
彰化縣,彰化市,0095,381,264,645,35,680,1061,64.09%,35.91%,1
彰化縣,彰化市,0096,430,257,687,38,725,1213,59.77%,35.45%,1
彰化縣,彰化市,0097,471,281,752,24,776,1264,61.39%,37.26%,1
彰化縣,彰化市,0098,279,168,447,19,466,691,67.44%,40.38%,1
彰化縣,彰化市,0099,334,202,536,40,576,893,64.5%,37.4%,1
彰化縣,彰化市,0100,279,143,422,38,460,733,62.76%,38.06%,1
彰化縣,彰化市,0101,261,159,420,27,447,692,64.6%,37.72%,1
彰化縣,彰化市,0102,233,178,411,32,443,728,60.85%,32.01%,1
彰化縣,彰化市,0103,313,166,479,27,506,773,65.46%,40.49%,1
彰化縣,彰化市,0104,324,190,514,18,532,975,54.56%,33.23%,1
彰化縣,彰化市,0105,350,184,534,27,561,908,61.78%,38.55%,1
彰化縣,彰化市,0106,453,282,735,12,747,1156,64.62%,39.19%,1
彰化縣,彰化市,0107,430,289,719,36,755,1235,61.13%,34.82%,1
彰化縣,彰化市,0108,473,272,745,40,785,1376,57.05%,34.38%,1
彰化縣,彰化市,0109,504,274,778,14,792,1389,57.02%,36.29%,1
彰化縣,彰化市,0110,324,203,527,32,559,846,66.08%,38.3%,1
彰化縣,彰化市,0111,344,193,537,21,558,859,64.96%,40.05%,1
彰化縣,彰化市,0112,258,209,467,17,484,781,61.97%,33.03%,1
彰化縣,彰化市,0113,306,194,500,24,524,875,59.89%,34.97%,1
彰化縣,彰化市,0114,287,178,465,21,486,816,59.56%,35.17%,1
彰化縣,彰化市,0115,319,101,420,27,447,687,65.07%,46.43%,1
彰化縣,彰化市,0116,287,164,451,24,475,727,65.34%,39.48%,1
彰化縣,彰化市,0117,275,136,411,20,431,662,65.11%,41.54%,1
彰化縣,彰化市,0118,260,134,394,13,407,633,64.3%,41.07%,1
彰化縣,彰化市,0119,353,210,563,31,594,906,65.56%,38.96%,1
彰化縣,彰化市,0120,305,161,466,26,492,853,57.68%,35.76%,1
彰化縣,彰化市,0121,384,235,619,31,650,1027,63.29%,37.39%,1
彰化縣,彰化市,0122,406,201,607,30,637,993,64.15%,40.89%,1
彰化縣,彰化市,0123,299,191,490,32,522,848,61.56%,35.26%,1
彰化縣,彰化市,0124,441,244,685,20,705,1118,63.06%,39.45%,1
彰化縣,彰化市,0125,482,260,742,32,774,1263,61.28%,38.16%,1
彰化縣,彰化市,0126,543,242,785,43,828,1268,65.3%,42.82%,1
彰化縣,彰化市,0127,492,243,735,34,769,1258,61.13%,39.11%,1
彰化縣,彰化市,0128,485,258,743,16,759,1212,62.62%,40.02%,1
彰化縣,彰化市,0129,336,193,529,44,573,924,62.01%,36.36%,1
彰化縣,彰化市,0130,353,226,579,22,601,939,64%,37.59%,1
彰化縣,彰化市,0131,379,237,616,32,648,953,68%,39.77%,1
彰化縣,彰化市,0132,387,241,628,20,648,981,66.06%,39.45%,1
彰化縣,彰化市,0133,463,275,738,46,784,1249,62.77%,37.07%,1
彰化縣,彰化市,0134,308,184,492,26,518,817,63.4%,37.7%,1
彰化縣,彰化市,0135,296,209,505,33,538,872,61.7%,33.94%,1
彰化縣,彰化市,0136,231,155,386,24,410,689,59.51%,33.53%,1
彰化縣,彰化市,0137,474,227,701,29,730,1156,63.15%,41%,1
彰化縣,彰化市,0138,432,288,720,24,744,1291,57.63%,33.46%,1
彰化縣,彰化市,0139,405,240,645,27,672,1139,59%,35.56%,1
彰化縣,彰化市,0140,426,242,668,34,702,1125,62.4%,37.87%,1
彰化縣,彰化市,0141,441,240,681,42,723,1258,57.47%,35.06%,1
彰化縣,彰化市,0142,403,234,637,31,668,1123,59.48%,35.89%,1
彰化縣,彰化市,0143,415,246,661,42,703,1175,59.83%,35.32%,1
彰化縣,彰化市,0144,329,220,549,22,571,862,66.24%,38.17%,1
彰化縣,彰化市,0145,279,219,498,27,525,872,60.21%,32%,1
彰化縣,彰化市,0146,370,189,559,19,578,897,64.44%,41.25%,1
彰化縣,彰化市,0147,345,211,556,24,580,1003,57.83%,34.4%,1
彰化縣,彰化市,0148,342,185,527,19,546,915,59.67%,37.38%,1
彰化縣,彰化市,0149,400,235,635,33,668,1158,57.69%,34.54%,1
彰化縣,彰化市,0150,378,274,652,33,685,1084,63.19%,34.87%,1
彰化縣,彰化市,0151,440,289,729,44,773,1372,56.34%,32.07%,1
彰化縣,彰化市,0152,430,228,658,23,681,1113,61.19%,38.63%,1
彰化縣,彰化市,0153,272,198,470,37,507,800,63.38%,34%,1
彰化縣,彰化市,0154,289,222,511,25,536,885,60.56%,32.66%,1
彰化縣,彰化市,0155,370,245,615,16,631,1000,63.1%,37%,1
彰化縣,彰化市,0156,386,243,629,23,652,1159,56.26%,33.3%,1
彰化縣,彰化市,0157,246,370,616,26,642,1123,57.17%,21.91%,1
彰化縣,彰化市,0158,334,227,561,41,602,907,66.37%,36.82%,1
彰化縣,彰化市,0159,344,186,530,34,564,989,57.03%,34.78%,1
彰化縣,彰化市,0160,354,253,607,34,641,1012,63.34%,34.98%,1
彰化縣,彰化市,0161,362,192,554,21,575,1033,55.66%,35.04%,1
彰化縣,彰化市,0162,387,263,650,32,682,1116,61.11%,34.68%,1
彰化縣,彰化市,0163,429,267,696,16,712,1154,61.7%,37.18%,1
彰化縣,彰化市,0164,379,256,635,24,659,1064,61.94%,35.62%,1
彰化縣,彰化市,0165,297,183,480,31,511,770,66.36%,38.57%,1
彰化縣,彰化市,0166,301,219,520,37,557,889,62.65%,33.86%,1
彰化縣,彰化市,0167,283,178,461,42,503,786,63.99%,36.01%,1
彰化縣,彰化市,0168,326,242,568,44,612,1120,54.64%,29.11%,1
彰化縣,彰化市,0169,422,250,672,27,699,1269,55.08%,33.25%,1
彰化縣,彰化市,0170,410,268,678,28,706,1159,60.91%,35.38%,1
彰化縣,彰化市,0171,429,251,680,46,726,1184,61.32%,36.23%,1
彰化縣,彰化市,0172,377,226,603,31,634,1089,58.22%,34.62%,1
彰化縣,彰化市,0173,347,219,566,39,605,968,62.5%,35.85%,1
彰化縣,彰化市,0174,340,186,526,23,549,930,59.03%,36.56%,1
彰化縣,彰化市,0175,358,220,578,27,605,973,62.18%,36.79%,1
彰化縣,彰化市,0176,349,241,590,31,621,1184,52.45%,29.48%,1
彰化縣,彰化市,0177,364,226,590,33,623,1002,62.18%,36.33%,1
彰化縣,彰化市,0178,406,223,629,21,650,1148,56.62%,35.37%,1
彰化縣,彰化市,0179,377,233,610,36,646,1112,58.09%,33.9%,1
彰化縣,彰化市,0180,326,264,590,39,629,907,69.35%,35.94%,1
彰化縣,彰化市,0181,388,242,630,52,682,1112,61.33%,34.89%,1
彰化縣,彰化市,0182,252,177,429,29,458,823,55.65%,30.62%,1
彰化縣,彰化市,0183,429,272,701,62,763,1276,59.8%,33.62%,1
彰化縣,彰化市,0184,418,227,645,26,671,1161,57.8%,36%,1
彰化縣,鹿港鎮,0243,411,275,686,33,719,1140,63.07%,36.05%,1
彰化縣,鹿港鎮,0244,175,113,288,18,306,511,59.88%,34.25%,1
彰化縣,鹿港鎮,0245,265,154,419,21,440,857,51.34%,30.92%,1
彰化縣,鹿港鎮,0246,359,220,579,35,614,946,64.9%,37.95%,1
彰化縣,鹿港鎮,0247,315,221,536,29,565,945,59.79%,33.33%,1
彰化縣,鹿港鎮,0248,384,244,628,31,659,1097,60.07%,35%,1
彰化縣,鹿港鎮,0249,437,289,726,23,749,1479,50.64%,29.55%,1
彰化縣,鹿港鎮,0250,480,322,802,48,850,1425,59.65%,33.68%,1
彰化縣,鹿港鎮,0251,304,191,495,63,558,880,63.41%,34.55%,1
彰化縣,鹿港鎮,0252,388,245,633,42,675,1183,57.06%,32.8%,1
彰化縣,鹿港鎮,0253,365,239,604,45,649,1047,61.99%,34.86%,1
彰化縣,鹿港鎮,0254,334,260,594,16,610,1097,55.61%,30.45%,1
彰化縣,鹿港鎮,0255,343,211,554,39,593,1030,57.57%,33.3%,1
彰化縣,鹿港鎮,0256,378,269,647,30,677,1161,58.31%,32.56%,1
彰化縣,鹿港鎮,0257,192,119,311,33,344,540,63.7%,35.56%,1
彰化縣,鹿港鎮,0258,365,250,615,31,646,1135,56.92%,32.16%,1
彰化縣,鹿港鎮,0259,399,232,631,40,671,1155,58.1%,34.55%,1
彰化縣,鹿港鎮,0260,395,274,669,30,699,1127,62.02%,35.05%,1
彰化縣,鹿港鎮,0261,361,229,590,34,624,1045,59.71%,34.55%,1
彰化縣,鹿港鎮,0262,389,223,612,54,666,1127,59.09%,34.52%,1
彰化縣,鹿港鎮,0263,467,268,735,28,763,1178,64.77%,39.64%,1
彰化縣,鹿港鎮,0264,108,56,164,5,169,284,59.51%,38.03%,1
彰化縣,鹿港鎮,0265,194,135,329,21,350,584,59.93%,33.22%,1
彰化縣,鹿港鎮,0266,274,139,413,24,437,659,66.31%,41.58%,1
彰化縣,鹿港鎮,0267,339,194,533,18,551,915,60.22%,37.05%,1
彰化縣,鹿港鎮,0268,410,239,649,29,678,1079,62.84%,38%,1
彰化縣,鹿港鎮,0269,430,257,687,46,733,1129,64.92%,38.09%,1
彰化縣,鹿港鎮,0270,416,248,664,44,708,1273,55.62%,32.68%,1
彰化縣,鹿港鎮,0271,235,120,355,27,382,706,54.11%,33.29%,1
彰化縣,鹿港鎮,0272,329,234,563,69,632,1137,55.58%,28.94%,1
彰化縣,鹿港鎮,0273,391,245,636,27,663,1195,55.48%,32.72%,1
彰化縣,鹿港鎮,0274,385,229,614,49,663,1225,54.12%,31.43%,1
彰化縣,鹿港鎮,0275,254,330,584,46,630,957,65.83%,26.54%,1
彰化縣,鹿港鎮,0276,221,134,355,46,401,758,52.9%,29.16%,1
彰化縣,鹿港鎮,0277,246,166,412,29,441,723,61%,34.02%,1
彰化縣,鹿港鎮,0278,331,197,528,30,558,984,56.71%,33.64%,1
彰化縣,鹿港鎮,0279,387,232,619,33,652,1018,64.05%,38.02%,1
彰化縣,鹿港鎮,0280,360,243,603,43,646,1165,55.45%,30.9%,1
彰化縣,鹿港鎮,0281,338,228,566,51,617,1161,53.14%,29.11%,1
彰化縣,鹿港鎮,0282,328,196,524,38,562,1020,55.1%,32.16%,1
彰化縣,鹿港鎮,0283,372,207,579,37,616,1068,57.68%,34.83%,1
彰化縣,鹿港鎮,0284,420,219,639,28,667,1024,65.14%,41.02%,1
彰化縣,鹿港鎮,0285,339,208,547,63,610,974,62.63%,34.8%,1
彰化縣,鹿港鎮,0286,469,296,765,54,819,1505,54.42%,31.16%,1
彰化縣,鹿港鎮,0287,299,263,562,44,606,1092,55.49%,27.38%,1
彰化縣,鹿港鎮,0288,413,277,690,52,742,1223,60.67%,33.77%,1
彰化縣,鹿港鎮,0289,488,274,762,23,785,1572,49.94%,31.04%,1
彰化縣,鹿港鎮,0290,340,240,580,42,622,1003,62.01%,33.9%,1
彰化縣,鹿港鎮,0291,329,210,539,24,563,933,60.34%,35.26%,1
彰化縣,鹿港鎮,0292,383,245,628,35,663,1093,60.66%,35.04%,1
彰化縣,鹿港鎮,0293,307,191,498,19,517,907,57%,33.85%,1
彰化縣,鹿港鎮,0294,433,223,656,30,686,1219,56.28%,35.52%,1
彰化縣,鹿港鎮,0295,499,344,843,41,884,1397,63.28%,35.72%,1
彰化縣,鹿港鎮,0296,436,240,676,32,708,1229,57.61%,35.48%,1
彰化縣,鹿港鎮,0297,507,267,774,24,798,1444,55.26%,35.11%,1
彰化縣,鹿港鎮,0298,439,251,690,42,732,1227,59.66%,35.78%,1
彰化縣,鹿港鎮,0299,438,238,676,44,720,1187,60.66%,36.9%,1
彰化縣,鹿港鎮,0300,440,250,690,28,718,1296,55.4%,33.95%,1
彰化縣,鹿港鎮,0301,426,283,709,50,759,1451,52.31%,29.36%,1
彰化縣,鹿港鎮,0302,424,247,671,61,732,1299,56.35%,32.64%,1
彰化縣,鹿港鎮,0303,474,307,781,27,808,1298,62.25%,36.52%,1
彰化縣,鹿港鎮,0304,520,285,805,33,838,1458,57.48%,35.67%,1
彰化縣,鹿港鎮,0305,403,244,647,45,692,1138,60.81%,35.41%,1
彰化縣,鹿港鎮,0306,362,278,640,46,686,1170,58.63%,30.94%,1
彰化縣,鹿港鎮,0307,423,288,711,35,746,1221,61.1%,34.64%,1
彰化縣,和美鎮,0373,432,273,705,36,741,1341,55.26%,32.21%,1
彰化縣,和美鎮,0374,462,262,724,48,772,1480,52.16%,31.22%,1
彰化縣,和美鎮,0375,507,312,819,40,859,1529,56.18%,33.16%,1
彰化縣,和美鎮,0376,528,330,858,23,881,1711,51.49%,30.86%,1
彰化縣,和美鎮,0377,347,250,597,23,620,1057,58.66%,32.83%,1
彰化縣,和美鎮,0378,342,246,588,33,621,1032,60.17%,33.14%,1
彰化縣,和美鎮,0379,370,229,599,29,628,1015,61.87%,36.45%,1
彰化縣,和美鎮,0380,436,267,703,32,735,1209,60.79%,36.06%,1
彰化縣,和美鎮,0381,153,90,243,9,252,430,58.6%,35.58%,1
彰化縣,和美鎮,0382,292,174,466,18,484,856,56.54%,34.11%,1
彰化縣,和美鎮,0383,376,183,559,24,583,966,60.35%,38.92%,1
彰化縣,和美鎮,0384,350,204,554,30,584,1059,55.15%,33.05%,1
彰化縣,和美鎮,0385,355,247,602,34,636,1117,56.94%,31.78%,1
彰化縣,和美鎮,0386,339,221,560,31,591,1066,55.44%,31.8%,1
彰化縣,和美鎮,0387,395,258,653,32,685,1252,54.71%,31.55%,1
彰化縣,和美鎮,0388,473,298,771,34,805,1528,52.68%,30.96%,1
彰化縣,和美鎮,0389,261,209,470,26,496,826,60.05%,31.6%,1
彰化縣,和美鎮,0390,278,188,466,20,486,854,56.91%,32.55%,1
彰化縣,和美鎮,0391,400,301,701,46,747,1387,53.86%,28.84%,1
彰化縣,和美鎮,0392,294,168,462,20,482,765,63.01%,38.43%,1
彰化縣,和美鎮,0393,451,258,709,43,752,1438,52.29%,31.36%,1
彰化縣,和美鎮,0394,490,294,784,48,832,1396,59.6%,35.1%,1
彰化縣,和美鎮,0395,222,150,372,16,388,658,58.97%,33.74%,1
彰化縣,和美鎮,0396,299,192,491,24,515,809,63.66%,36.96%,1
彰化縣,和美鎮,0397,332,178,510,9,519,932,55.69%,35.62%,1
彰化縣,和美鎮,0398,300,161,461,26,487,888,54.84%,33.78%,1
彰化縣,和美鎮,0399,411,250,661,39,700,1144,61.19%,35.93%,1
彰化縣,和美鎮,0400,354,230,584,30,614,1077,57.01%,32.87%,1
彰化縣,和美鎮,0401,398,273,671,43,714,1349,52.93%,29.5%,1
彰化縣,和美鎮,0402,401,290,691,31,722,1155,62.51%,34.72%,1
彰化縣,和美鎮,0403,436,235,671,27,698,1253,55.71%,34.8%,1
彰化縣,和美鎮,0404,407,259,666,27,693,1252,55.35%,32.51%,1
彰化縣,和美鎮,0405,434,321,755,31,786,1474,53.32%,29.44%,1
彰化縣,和美鎮,0406,415,269,684,47,731,1396,52.36%,29.73%,1
彰化縣,和美鎮,0407,436,267,703,28,731,1348,54.23%,32.34%,1
彰化縣,和美鎮,0408,334,256,590,30,620,999,62.06%,33.43%,1
彰化縣,和美鎮,0409,314,219,533,32,565,911,62.02%,34.47%,1
彰化縣,和美鎮,0410,346,236,582,16,598,1005,59.5%,34.43%,1
彰化縣,和美鎮,0411,337,194,531,35,566,967,58.53%,34.85%,1
彰化縣,和美鎮,0412,447,291,738,28,766,1308,58.56%,34.17%,1
彰化縣,和美鎮,0413,443,267,710,40,750,1324,56.65%,33.46%,1
彰化縣,和美鎮,0414,356,261,617,42,659,1102,59.8%,32.3%,1
彰化縣,和美鎮,0415,378,214,592,34,626,1124,55.69%,33.63%,1
彰化縣,和美鎮,0416,388,272,660,45,705,1211,58.22%,32.04%,1
彰化縣,和美鎮,0417,361,208,569,29,598,884,67.65%,40.84%,1
彰化縣,和美鎮,0418,303,310,613,37,650,1119,58.09%,27.08%,1
彰化縣,和美鎮,0419,302,394,696,42,738,1300,56.77%,23.23%,1
彰化縣,和美鎮,0420,339,234,573,30,603,1104,54.62%,30.71%,1
彰化縣,和美鎮,0421,440,263,703,44,747,1213,61.58%,36.27%,1
彰化縣,和美鎮,0422,416,146,562,15,577,1127,51.2%,36.91%,1
彰化縣,和美鎮,0423,282,221,503,25,528,919,57.45%,30.69%,1
彰化縣,和美鎮,0424,351,215,566,32,598,987,60.59%,35.56%,1
彰化縣,和美鎮,0425,316,248,564,28,592,958,61.8%,32.99%,1
彰化縣,和美鎮,0426,490,270,760,32,792,1362,58.15%,35.98%,1
彰化縣,和美鎮,0427,478,305,783,29,812,1461,55.58%,32.72%,1
彰化縣,和美鎮,0428,474,314,788,24,812,1405,57.79%,33.74%,1
彰化縣,和美鎮,0429,293,199,492,28,520,860,60.47%,34.07%,1
彰化縣,和美鎮,0430,297,170,467,24,491,875,56.11%,33.94%,1
彰化縣,和美鎮,0431,249,224,473,36,509,871,58.44%,28.59%,1
彰化縣,和美鎮,0432,297,214,511,40,551,883,62.4%,33.64%,1
彰化縣,和美鎮,0433,356,271,627,54,681,1224,55.64%,29.08%,1
彰化縣,和美鎮,0434,328,243,571,30,601,1075,55.91%,30.51%,1
彰化縣,和美鎮,0435,294,210,504,39,543,956,56.8%,30.75%,1
彰化縣,和美鎮,0436,304,249,553,37,590,1037,56.89%,29.32%,1
彰化縣,和美鎮,0437,338,218,556,22,578,1011,57.17%,33.43%,1
彰化縣,和美鎮,0438,309,245,554,36,590,1023,57.67%,30.21%,1
彰化縣,和美鎮,0439,209,156,365,30,395,719,54.94%,29.07%,1
彰化縣,和美鎮,0440,265,217,482,36,518,913,56.74%,29.03%,1
彰化縣,線西鄉,0469,391,216,607,24,631,1071,58.92%,36.51%,1
彰化縣,線西鄉,0470,433,233,666,35,701,1166,60.12%,37.14%,1
彰化縣,線西鄉,0471,424,293,717,38,755,1269,59.5%,33.41%,1
彰化縣,線西鄉,0472,381,226,607,44,651,1138,57.21%,33.48%,1
彰化縣,線西鄉,0473,388,281,669,53,722,1128,64.01%,34.4%,1
彰化縣,線西鄉,0474,409,285,694,78,772,1275,60.55%,32.08%,1
彰化縣,線西鄉,0475,390,271,661,48,709,1187,59.73%,32.86%,1
彰化縣,線西鄉,0476,320,226,546,59,605,991,61.05%,32.29%,1
彰化縣,線西鄉,0477,323,207,530,36,566,938,60.34%,34.43%,1
彰化縣,線西鄉,0478,376,256,632,51,683,1276,53.53%,29.47%,1
彰化縣,線西鄉,0479,420,294,714,46,760,1285,59.14%,32.68%,1
彰化縣,線西鄉,0480,496,329,825,54,879,1341,65.55%,36.99%,1
彰化縣,伸港鄉,0441,321,239,560,49,609,1182,51.52%,27.16%,1
彰化縣,伸港鄉,0442,421,264,685,35,720,1166,61.75%,36.11%,1
彰化縣,伸港鄉,0443,330,207,537,26,563,966,58.28%,34.16%,1
彰化縣,伸港鄉,0444,287,172,459,33,492,873,56.36%,32.88%,1
彰化縣,伸港鄉,0445,293,162,455,38,493,812,60.71%,36.08%,1
彰化縣,伸港鄉,0446,259,200,459,32,491,875,56.11%,29.6%,1
彰化縣,伸港鄉,0447,264,202,466,44,510,904,56.42%,29.2%,1
彰化縣,伸港鄉,0448,309,212,521,39,560,1008,55.56%,30.65%,1
彰化縣,伸港鄉,0449,381,249,630,53,683,1154,59.19%,33.02%,1
彰化縣,伸港鄉,0450,466,253,719,64,783,1486,52.69%,31.36%,1
彰化縣,伸港鄉,0451,351,223,574,36,610,1095,55.71%,32.05%,1
彰化縣,伸港鄉,0452,320,219,539,17,556,1087,51.15%,29.44%,1
彰化縣,伸港鄉,0453,359,239,598,51,649,1085,59.82%,33.09%,1
彰化縣,伸港鄉,0454,319,198,517,26,543,908,59.8%,35.13%,1
彰化縣,伸港鄉,0455,432,289,721,35,756,1264,59.81%,34.18%,1
彰化縣,伸港鄉,0456,274,162,436,42,478,854,55.97%,32.08%,1
彰化縣,伸港鄉,0457,239,156,395,35,430,846,50.83%,28.25%,1
彰化縣,伸港鄉,0458,308,223,531,80,611,1143,53.46%,26.95%,1
彰化縣,伸港鄉,0459,425,309,734,27,761,1357,56.08%,31.32%,1
彰化縣,伸港鄉,0460,390,317,707,45,752,1349,55.74%,28.91%,1
彰化縣,伸港鄉,0461,391,237,628,48,676,1154,58.58%,33.88%,1
彰化縣,伸港鄉,0462,387,277,664,31,695,1279,54.34%,30.26%,1
彰化縣,伸港鄉,0463,446,290,736,40,776,1317,58.92%,33.86%,1
彰化縣,伸港鄉,0464,347,222,569,38,607,990,61.31%,35.05%,1
彰化縣,伸港鄉,0465,308,178,486,20,506,852,59.39%,36.15%,1
彰化縣,伸港鄉,0466,393,271,664,16,680,1178,57.72%,33.36%,1
彰化縣,伸港鄉,0467,335,223,558,60,618,1088,56.8%,30.79%,1
彰化縣,伸港鄉,0468,365,240,605,45,650,1135,57.27%,32.16%,1
彰化縣,福興鄉,0308,402,326,728,39,767,1363,56.27%,29.49%,1
彰化縣,福興鄉,0309,256,190,446,23,469,821,57.13%,31.18%,1
彰化縣,福興鄉,0310,382,220,602,66,668,1256,53.18%,30.41%,1
彰化縣,福興鄉,0311,328,252,580,59,639,1166,54.8%,28.13%,1
彰化縣,福興鄉,0312,436,286,722,46,768,1464,52.46%,29.78%,1
彰化縣,福興鄉,0313,343,278,621,41,662,1251,52.92%,27.42%,1
彰化縣,福興鄉,0314,435,307,742,37,779,1465,53.17%,29.69%,1
彰化縣,福興鄉,0315,267,190,457,21,478,960,49.79%,27.81%,1
彰化縣,福興鄉,0316,422,240,662,53,715,1323,54.04%,31.9%,1
彰化縣,福興鄉,0317,464,249,713,41,754,1365,55.24%,33.99%,1
彰化縣,福興鄉,0318,408,250,658,28,686,1458,47.05%,27.98%,1
彰化縣,福興鄉,0319,479,280,759,41,800,1492,53.62%,32.1%,1
彰化縣,福興鄉,0320,316,152,468,20,488,888,54.95%,35.59%,1
彰化縣,福興鄉,0321,500,100,600,34,634,1054,60.15%,47.44%,1
彰化縣,福興鄉,0322,311,184,495,27,522,1043,50.05%,29.82%,1
彰化縣,福興鄉,0323,427,265,692,48,740,1340,55.22%,31.87%,1
彰化縣,福興鄉,0324,309,229,538,36,574,1085,52.9%,28.48%,1
彰化縣,福興鄉,0325,454,259,713,26,739,1392,53.09%,32.61%,1
彰化縣,福興鄉,0326,500,230,730,45,775,1316,58.89%,37.99%,1
彰化縣,福興鄉,0327,463,268,731,29,760,1255,60.56%,36.89%,1
彰化縣,福興鄉,0328,408,242,650,25,675,1101,61.31%,37.06%,1
彰化縣,福興鄉,0329,406,196,602,50,652,1167,55.87%,34.79%,1
彰化縣,福興鄉,0330,429,275,704,34,738,1393,52.98%,30.8%,1
彰化縣,福興鄉,0331,432,222,654,42,696,1216,57.24%,35.53%,1
彰化縣,福興鄉,0332,342,193,535,29,564,1063,53.06%,32.17%,1
彰化縣,福興鄉,0333,406,250,656,48,704,1306,53.91%,31.09%,1
彰化縣,福興鄉,0334,371,202,573,41,614,1287,47.71%,28.83%,1
彰化縣,福興鄉,0335,335,197,532,26,558,994,56.14%,33.7%,1
彰化縣,福興鄉,0336,469,221,690,50,740,1311,56.45%,35.77%,1
彰化縣,福興鄉,0337,347,187,534,24,558,926,60.26%,37.47%,1
彰化縣,福興鄉,0338,286,202,488,31,519,995,52.16%,28.74%,1
彰化縣,福興鄉,0339,414,209,623,49,672,1079,62.28%,38.37%,1
彰化縣,福興鄉,0340,376,185,561,44,605,1150,52.61%,32.7%,1
彰化縣,秀水鄉,0341,572,27,599,68,667,1066,62.57%,53.66%,1
彰化縣,秀水鄉,0342,226,143,369,28,397,620,64.03%,36.45%,1
彰化縣,秀水鄉,0343,278,171,449,9,458,876,52.28%,31.74%,1
彰化縣,秀水鄉,0344,445,261,706,29,735,1196,61.45%,37.21%,1
彰化縣,秀水鄉,0345,449,304,753,36,789,1369,57.63%,32.8%,1
彰化縣,秀水鄉,0346,434,271,705,52,757,1273,59.47%,34.09%,1
彰化縣,秀水鄉,0347,439,322,761,44,805,1433,56.18%,30.64%,1
彰化縣,秀水鄉,0348,333,215,548,26,574,967,59.36%,34.44%,1
彰化縣,秀水鄉,0349,331,206,537,15,552,921,59.93%,35.94%,1
彰化縣,秀水鄉,0350,262,146,408,27,435,689,63.13%,38.03%,1
彰化縣,秀水鄉,0351,237,152,389,32,421,688,61.19%,34.45%,1
彰化縣,秀水鄉,0352,432,308,740,42,782,1252,62.46%,34.5%,1
彰化縣,秀水鄉,0353,412,301,713,34,747,1281,58.31%,32.16%,1
彰化縣,秀水鄉,0354,242,163,405,22,427,754,56.63%,32.1%,1
彰化縣,秀水鄉,0355,348,188,536,51,587,1024,57.32%,33.98%,1
彰化縣,秀水鄉,0356,468,304,772,20,792,1433,55.27%,32.66%,1
彰化縣,秀水鄉,0357,483,349,832,49,881,1366,64.49%,35.36%,1
彰化縣,秀水鄉,0358,294,209,503,41,544,895,60.78%,32.85%,1
彰化縣,秀水鄉,0359,407,306,713,41,754,1386,54.4%,29.37%,1
彰化縣,秀水鄉,0360,312,174,486,58,544,896,60.71%,34.82%,1
彰化縣,秀水鄉,0361,309,201,510,30,540,804,67.16%,38.43%,1
彰化縣,秀水鄉,0362,316,188,504,20,524,827,63.36%,38.21%,1
彰化縣,秀水鄉,0363,339,225,564,29,593,996,59.54%,34.04%,1
彰化縣,秀水鄉,0364,323,251,574,46,620,931,66.6%,34.69%,1
彰化縣,秀水鄉,0365,229,157,386,23,409,715,57.2%,32.03%,1
彰化縣,秀水鄉,0366,441,289,730,38,768,1229,62.49%,35.88%,1
彰化縣,秀水鄉,0367,266,171,437,26,463,890,52.02%,29.89%,1
彰化縣,秀水鄉,0368,257,215,472,37,509,811,62.76%,31.69%,1
彰化縣,秀水鄉,0369,280,175,455,34,489,786,62.21%,35.62%,1
彰化縣,秀水鄉,0370,312,206,518,25,543,931,58.32%,33.51%,1
彰化縣,秀水鄉,0371,463,265,728,45,773,1265,61.11%,36.6%,1
彰化縣,秀水鄉,0372,277,142,419,43,462,824,56.07%,33.62%,1
彰化縣,花壇鄉,0185,356,171,527,26,553,901,61.38%,39.51%,1
彰化縣,花壇鄉,0186,371,250,621,34,655,1042,62.86%,35.6%,1
彰化縣,花壇鄉,0187,454,266,720,13,733,1314,55.78%,34.55%,1
彰化縣,花壇鄉,0188,319,165,484,32,516,808,63.86%,39.48%,1
彰化縣,花壇鄉,0189,373,186,559,30,589,1019,57.8%,36.6%,1
彰化縣,花壇鄉,0190,434,229,663,49,712,1144,62.24%,37.94%,1
彰化縣,花壇鄉,0191,570,120,690,55,745,1240,60.08%,45.97%,1
彰化縣,花壇鄉,0192,591,246,837,43,880,1425,61.75%,41.47%,1
彰化縣,花壇鄉,0193,452,228,680,29,709,1095,64.75%,41.28%,1
彰化縣,花壇鄉,0194,339,173,512,37,549,910,60.33%,37.25%,1
彰化縣,花壇鄉,0195,412,175,587,28,615,982,62.63%,41.96%,1
彰化縣,花壇鄉,0196,345,235,580,20,600,1070,56.07%,32.24%,1
彰化縣,花壇鄉,0197,236,149,385,17,402,700,57.43%,33.71%,1
彰化縣,花壇鄉,0198,305,173,478,28,506,764,66.23%,39.92%,1
彰化縣,花壇鄉,0199,361,214,575,32,607,953,63.69%,37.88%,1
彰化縣,花壇鄉,0200,337,202,539,18,557,974,57.19%,34.6%,1
彰化縣,花壇鄉,0201,402,199,601,46,647,1111,58.24%,36.18%,1
彰化縣,花壇鄉,0202,434,199,633,43,676,1101,61.4%,39.42%,1
彰化縣,花壇鄉,0203,368,230,598,26,624,1110,56.22%,33.15%,1
彰化縣,花壇鄉,0204,442,253,695,41,736,1262,58.32%,35.02%,1
彰化縣,花壇鄉,0205,382,250,632,21,653,1103,59.2%,34.63%,1
彰化縣,花壇鄉,0206,419,249,668,42,710,1347,52.71%,31.11%,1
彰化縣,花壇鄉,0207,378,230,608,29,637,1169,54.49%,32.34%,1
彰化縣,花壇鄉,0208,475,252,727,44,771,1274,60.52%,37.28%,1
彰化縣,花壇鄉,0209,514,246,760,29,789,1280,61.64%,40.16%,1
彰化縣,花壇鄉,0210,491,215,706,27,733,1244,58.92%,39.47%,1
彰化縣,花壇鄉,0211,265,378,643,43,686,1159,59.19%,22.86%,1
彰化縣,花壇鄉,0212,392,237,629,29,658,1042,63.15%,37.62%,1
彰化縣,花壇鄉,0213,383,218,601,29,630,1111,56.71%,34.47%,1
彰化縣,花壇鄉,0214,335,203,538,33,571,893,63.94%,37.51%,1
彰化縣,花壇鄉,0215,329,204,533,34,567,953,59.5%,34.52%,1
彰化縣,花壇鄉,0216,321,212,533,31,564,987,57.14%,32.52%,1
彰化縣,花壇鄉,0217,347,220,567,42,609,925,65.84%,37.51%,1
彰化縣,花壇鄉,0218,345,192,537,24,561,951,58.99%,36.28%,1
彰化縣,花壇鄉,0219,332,194,526,21,547,955,57.28%,34.76%,1
彰化縣,花壇鄉,0220,336,180,516,30,546,895,61.01%,37.54%,1
彰化縣,花壇鄉,0221,241,165,406,14,420,711,59.07%,33.9%,1
彰化縣,芬園鄉,0222,345,174,519,19,538,958,56.16%,36.01%,1
彰化縣,芬園鄉,0223,249,175,424,33,457,794,57.56%,31.36%,1
彰化縣,芬園鄉,0224,390,292,682,65,747,1415,52.79%,27.56%,1
彰化縣,芬園鄉,0225,336,197,533,32,565,927,60.95%,36.25%,1
彰化縣,芬園鄉,0226,278,168,446,28,474,831,57.04%,33.45%,1
彰化縣,芬園鄉,0227,193,131,324,13,337,570,59.12%,33.86%,1
彰化縣,芬園鄉,0228,354,261,615,41,656,1227,53.46%,28.85%,1
彰化縣,芬園鄉,0229,393,241,634,49,683,1238,55.17%,31.74%,1
彰化縣,芬園鄉,0230,426,294,720,67,787,1362,57.78%,31.28%,1
彰化縣,芬園鄉,0231,355,188,543,45,588,989,59.45%,35.89%,1
彰化縣,芬園鄉,0232,386,245,631,42,673,1054,63.85%,36.62%,1
彰化縣,芬園鄉,0233,250,126,376,25,401,607,66.06%,41.19%,1
彰化縣,芬園鄉,0234,298,209,507,29,536,882,60.77%,33.79%,1
彰化縣,芬園鄉,0235,342,191,533,27,560,1143,48.99%,29.92%,1
彰化縣,芬園鄉,0236,207,117,324,19,343,661,51.89%,31.32%,1
彰化縣,芬園鄉,0237,286,137,423,5,428,838,51.07%,34.13%,1
彰化縣,芬園鄉,0238,237,189,426,20,446,847,52.66%,27.98%,1
彰化縣,芬園鄉,0239,335,219,554,38,592,987,59.98%,33.94%,1
彰化縣,芬園鄉,0240,364,225,589,52,641,1217,52.67%,29.91%,1
彰化縣,芬園鄉,0241,234,159,393,56,449,865,51.91%,27.05%,1
彰化縣,芬園鄉,0242,268,210,478,38,516,996,51.81%,26.91%,1
彰化縣,員林市,0481,361,186,547,16,563,1087,51.79%,33.21%,1
彰化縣,員林市,0482,395,288,683,37,720,1353,53.22%,29.19%,1
彰化縣,員林市,0483,416,242,658,44,702,1313,53.47%,31.68%,1
彰化縣,員林市,0484,385,232,617,29,646,1328,48.64%,28.99%,1
彰化縣,員林市,0485,334,235,569,28,597,1055,56.59%,31.66%,1
彰化縣,員林市,0486,302,200,502,30,532,959,55.47%,31.49%,1
彰化縣,員林市,0487,252,169,421,31,452,772,58.55%,32.64%,1
彰化縣,員林市,0488,200,283,483,31,514,831,61.85%,24.07%,1
彰化縣,員林市,0489,215,163,378,10,388,854,45.43%,25.18%,1
彰化縣,員林市,0490,329,178,507,28,535,1190,44.96%,27.65%,1
彰化縣,員林市,0491,210,164,374,23,397,726,54.68%,28.93%,1
彰化縣,員林市,0492,343,247,590,42,632,1124,56.23%,30.52%,1
彰化縣,員林市,0493,256,169,425,31,456,860,53.02%,29.77%,1
彰化縣,員林市,0494,391,241,632,41,673,1122,59.98%,34.85%,1
彰化縣,員林市,0495,368,200,568,46,614,1075,57.12%,34.23%,1
彰化縣,員林市,0496,308,203,511,39,550,993,55.39%,31.02%,1
彰化縣,員林市,0497,302,190,492,30,522,967,53.98%,31.23%,1
彰化縣,員林市,0498,338,206,544,37,581,1008,57.64%,33.53%,1
彰化縣,員林市,0499,264,166,430,26,456,804,56.72%,32.84%,1
彰化縣,員林市,0500,272,193,465,22,487,867,56.17%,31.37%,1
彰化縣,員林市,0501,278,183,461,20,481,885,54.35%,31.41%,1
彰化縣,員林市,0502,292,218,510,17,527,1097,48.04%,26.62%,1
彰化縣,員林市,0503,370,279,649,33,682,1255,54.34%,29.48%,1
彰化縣,員林市,0504,353,232,585,33,618,1063,58.14%,33.21%,1
彰化縣,員林市,0505,303,200,503,15,518,925,56%,32.76%,1
彰化縣,員林市,0506,337,191,528,31,559,947,59.03%,35.59%,1
彰化縣,員林市,0507,331,190,521,27,548,916,59.83%,36.14%,1
彰化縣,員林市,0508,150,298,448,30,478,862,55.45%,17.4%,1
彰化縣,員林市,0509,339,208,547,17,564,987,57.14%,34.35%,1
彰化縣,員林市,0510,349,215,564,32,596,1085,54.93%,32.17%,1
彰化縣,員林市,0511,368,245,613,25,638,1110,57.48%,33.15%,1
彰化縣,員林市,0512,354,218,572,16,588,1095,53.7%,32.33%,1
彰化縣,員林市,0513,446,307,753,31,784,1278,61.35%,34.9%,1
彰化縣,員林市,0514,359,258,617,38,655,1109,59.06%,32.37%,1
彰化縣,員林市,0515,348,217,565,40,605,1055,57.35%,32.99%,1
彰化縣,員林市,0516,302,176,478,36,514,876,58.68%,34.47%,1
彰化縣,員林市,0517,325,205,530,27,557,1115,49.96%,29.15%,1
彰化縣,員林市,0518,425,243,668,21,689,1186,58.09%,35.83%,1
彰化縣,員林市,0519,356,208,564,37,601,995,60.4%,35.78%,1
彰化縣,員林市,0520,319,211,530,17,547,999,54.75%,31.93%,1
彰化縣,員林市,0521,372,263,635,25,660,1201,54.95%,30.97%,1
彰化縣,員林市,0522,446,278,724,30,754,1342,56.18%,33.23%,1
彰化縣,員林市,0523,360,221,581,22,603,1086,55.52%,33.15%,1
彰化縣,員林市,0524,259,169,428,31,459,854,53.75%,30.33%,1
彰化縣,員林市,0525,369,211,580,25,605,1064,56.86%,34.68%,1
彰化縣,員林市,0526,312,203,515,16,531,879,60.41%,35.49%,1
彰化縣,員林市,0527,312,221,533,29,562,827,67.96%,37.73%,1
彰化縣,員林市,0528,316,165,481,10,491,867,56.63%,36.45%,1
彰化縣,員林市,0529,431,225,656,23,679,1201,56.54%,35.89%,1
彰化縣,員林市,0530,409,213,622,0,622,1106,56.24%,36.98%,1
彰化縣,員林市,0531,291,180,471,35,506,845,59.88%,34.44%,1
彰化縣,員林市,0532,392,105,497,29,526,894,58.84%,43.85%,1
彰化縣,員林市,0533,290,186,476,26,502,849,59.13%,34.16%,1
彰化縣,員林市,0534,279,168,447,28,475,747,63.59%,37.35%,1
彰化縣,員林市,0535,308,208,516,32,548,884,61.99%,34.84%,1
彰化縣,員林市,0536,287,158,445,28,473,900,52.56%,31.89%,1
彰化縣,員林市,0537,323,206,529,17,546,1040,52.5%,31.06%,1
彰化縣,員林市,0538,270,190,460,15,475,831,57.16%,32.49%,1
彰化縣,員林市,0539,213,145,358,34,392,591,66.33%,36.04%,1
彰化縣,員林市,0540,402,296,698,26,724,1330,54.44%,30.23%,1
彰化縣,員林市,0541,412,295,707,30,737,1295,56.91%,31.81%,1
彰化縣,員林市,0542,409,267,676,41,717,1283,55.88%,31.88%,1
彰化縣,員林市,0543,345,207,552,21,573,943,60.76%,36.59%,1
彰化縣,員林市,0544,507,303,810,52,862,1388,62.1%,36.53%,1
彰化縣,員林市,0545,407,257,664,30,694,1176,59.01%,34.61%,1
彰化縣,員林市,0546,296,149,445,11,456,867,52.6%,34.14%,1
彰化縣,員林市,0547,320,264,584,35,619,1121,55.22%,28.55%,1
彰化縣,員林市,0548,374,236,610,23,633,1190,53.19%,31.43%,1
彰化縣,員林市,0549,353,190,543,23,566,945,59.89%,37.35%,1
彰化縣,員林市,0550,327,198,525,22,547,906,60.38%,36.09%,1
彰化縣,員林市,0551,332,230,562,38,600,978,61.35%,33.95%,1
彰化縣,員林市,0552,527,182,709,34,743,949,78.29%,55.53%,1
彰化縣,員林市,0553,335,216,551,24,575,949,60.59%,35.3%,1
彰化縣,員林市,0554,340,204,544,26,570,1006,56.66%,33.8%,1
彰化縣,員林市,0555,312,183,495,33,528,889,59.39%,35.1%,1
彰化縣,員林市,0556,337,219,556,19,575,923,62.3%,36.51%,1
彰化縣,員林市,0557,452,260,712,32,744,1209,61.54%,37.39%,1
彰化縣,員林市,0558,384,236,620,29,649,1075,60.37%,35.72%,1
彰化縣,員林市,0559,482,319,801,34,835,1342,62.22%,35.92%,1
彰化縣,員林市,0560,378,291,669,24,693,1039,66.7%,36.38%,1
彰化縣,員林市,0561,373,205,578,55,633,1131,55.97%,32.98%,1
彰化縣,員林市,0562,380,294,674,29,703,1356,51.84%,28.02%,1
彰化縣,員林市,0563,427,298,725,50,775,1370,56.57%,31.17%,1
彰化縣,員林市,0564,323,274,597,39,636,1090,58.35%,29.63%,1
彰化縣,員林市,0565,301,216,517,19,536,821,65.29%,36.66%,1
彰化縣,員林市,0566,319,203,522,22,544,910,59.78%,35.05%,1
彰化縣,員林市,0567,413,243,656,32,688,1203,57.19%,34.33%,1
彰化縣,員林市,0568,413,332,745,32,777,1378,56.39%,29.97%,1
彰化縣,員林市,0569,438,299,737,33,770,1352,56.95%,32.4%,1
彰化縣,員林市,0570,400,237,637,22,659,1060,62.17%,37.74%,1
彰化縣,員林市,0571,415,272,687,38,725,1317,55.05%,31.51%,1
彰化縣,員林市,0572,364,217,581,27,608,1120,54.29%,32.5%,1
彰化縣,員林市,0573,343,172,515,37,552,1025,53.85%,33.46%,1
彰化縣,員林市,0574,364,227,591,40,631,1097,57.52%,33.18%,1
彰化縣,員林市,0575,256,231,487,45,532,859,61.93%,29.8%,1
彰化縣,員林市,0576,269,181,450,22,472,837,56.39%,32.14%,1
彰化縣,員林市,0577,398,254,652,34,686,1090,62.94%,36.51%,1
彰化縣,員林市,0578,249,231,480,40,520,1073,48.46%,23.21%,1
彰化縣,溪湖鎮,0640,380,265,645,29,674,1221,55.2%,31.12%,1
彰化縣,溪湖鎮,0641,241,147,388,21,409,638,64.11%,37.77%,1
彰化縣,溪湖鎮,0642,274,171,445,42,487,817,59.61%,33.54%,1
彰化縣,溪湖鎮,0643,362,202,564,22,586,968,60.54%,37.4%,1
彰化縣,溪湖鎮,0644,178,106,284,11,295,448,65.85%,39.73%,1
彰化縣,溪湖鎮,0645,363,227,590,39,629,1123,56.01%,32.32%,1
彰化縣,溪湖鎮,0646,364,259,623,36,659,1166,56.52%,31.22%,1
彰化縣,溪湖鎮,0647,378,234,612,40,652,1151,56.65%,32.84%,1
彰化縣,溪湖鎮,0648,445,256,701,21,722,1249,57.81%,35.63%,1
彰化縣,溪湖鎮,0649,398,252,650,33,683,1146,59.6%,34.73%,1
彰化縣,溪湖鎮,0650,425,229,654,62,716,1199,59.72%,35.45%,1
彰化縣,溪湖鎮,0651,273,204,477,44,521,895,58.21%,30.5%,1
彰化縣,溪湖鎮,0652,350,221,571,18,589,964,61.1%,36.31%,1
彰化縣,溪湖鎮,0653,271,213,484,27,511,851,60.05%,31.84%,1
彰化縣,溪湖鎮,0654,390,197,587,28,615,1072,57.37%,36.38%,1
彰化縣,溪湖鎮,0655,399,229,628,39,667,1113,59.93%,35.85%,1
彰化縣,溪湖鎮,0656,364,257,621,34,655,1090,60.09%,33.39%,1
彰化縣,溪湖鎮,0657,402,278,680,39,719,1193,60.27%,33.7%,1
彰化縣,溪湖鎮,0658,361,196,557,41,598,952,62.82%,37.92%,1
彰化縣,溪湖鎮,0659,390,352,742,37,779,1172,66.47%,33.28%,1
彰化縣,溪湖鎮,0660,328,226,554,38,592,1027,57.64%,31.94%,1
彰化縣,溪湖鎮,0661,453,265,718,28,746,1188,62.79%,38.13%,1
彰化縣,溪湖鎮,0662,441,279,720,35,755,1403,53.81%,31.43%,1
彰化縣,溪湖鎮,0663,395,274,669,55,724,1397,51.83%,28.27%,1
彰化縣,溪湖鎮,0664,547,337,884,52,936,1636,57.21%,33.44%,1
彰化縣,溪湖鎮,0665,593,226,819,50,869,1298,66.95%,45.69%,1
彰化縣,溪湖鎮,0666,414,233,647,51,698,1214,57.5%,34.1%,1
彰化縣,溪湖鎮,0667,455,296,751,25,776,1297,59.83%,35.08%,1
彰化縣,溪湖鎮,0668,349,228,577,28,605,968,62.5%,36.05%,1
彰化縣,溪湖鎮,0669,283,186,469,37,506,839,60.31%,33.73%,1
彰化縣,溪湖鎮,0670,297,220,517,34,551,907,60.75%,32.75%,1
彰化縣,溪湖鎮,0671,287,167,454,23,477,898,53.12%,31.96%,1
彰化縣,溪湖鎮,0672,248,172,420,29,449,650,69.08%,38.15%,1
彰化縣,溪湖鎮,0673,421,262,683,54,737,1279,57.62%,32.92%,1
彰化縣,溪湖鎮,0674,292,149,441,30,471,730,64.52%,40%,1
彰化縣,溪湖鎮,0675,470,303,773,55,828,1407,58.85%,33.4%,1
彰化縣,溪湖鎮,0676,378,208,586,53,639,1273,50.2%,29.69%,1
彰化縣,溪湖鎮,0677,313,191,504,43,547,988,55.36%,31.68%,1
彰化縣,溪湖鎮,0678,273,179,452,29,481,754,63.79%,36.21%,1
彰化縣,溪湖鎮,0679,277,211,488,39,527,1052,50.1%,26.33%,1
彰化縣,溪湖鎮,0680,361,221,582,39,621,1149,54.05%,31.42%,1
彰化縣,溪湖鎮,0681,471,328,799,68,867,1365,63.52%,34.51%,1
彰化縣,田中鎮,0742,279,166,445,36,481,854,56.32%,32.67%,1
彰化縣,田中鎮,0743,289,178,467,25,492,963,51.09%,30.01%,1
彰化縣,田中鎮,0744,27,13,40,5,45,175,25.71%,15.43%,1
彰化縣,田中鎮,0745,233,148,381,15,396,739,53.59%,31.53%,1
彰化縣,田中鎮,0746,279,149,428,22,450,826,54.48%,33.78%,1
彰化縣,田中鎮,0747,288,142,430,20,450,741,60.73%,38.87%,1
彰化縣,田中鎮,0748,130,105,235,17,252,506,49.8%,25.69%,1
彰化縣,田中鎮,0749,382,191,573,47,620,1001,61.94%,38.16%,1
彰化縣,田中鎮,0750,441,253,694,49,743,1281,58%,34.43%,1
彰化縣,田中鎮,0751,356,215,571,27,598,1035,57.78%,34.4%,1
彰化縣,田中鎮,0752,501,239,740,39,779,1327,58.7%,37.75%,1
彰化縣,田中鎮,0753,311,186,497,26,523,844,61.97%,36.85%,1
彰化縣,田中鎮,0754,310,191,501,30,531,913,58.16%,33.95%,1
彰化縣,田中鎮,0755,248,129,377,29,406,613,66.23%,40.46%,1
彰化縣,田中鎮,0756,501,268,769,51,820,1382,59.33%,36.25%,1
彰化縣,田中鎮,0757,416,221,637,38,675,1034,65.28%,40.23%,1
彰化縣,田中鎮,0758,392,204,596,21,617,935,65.99%,41.93%,1
彰化縣,田中鎮,0759,446,263,709,45,754,1301,57.96%,34.28%,1
彰化縣,田中鎮,0760,371,256,627,22,649,1100,59%,33.73%,1
彰化縣,田中鎮,0761,375,246,621,33,654,1071,61.06%,35.01%,1
彰化縣,田中鎮,0762,436,238,674,45,719,1163,61.82%,37.49%,1
彰化縣,田中鎮,0763,326,191,517,21,538,809,66.5%,40.3%,1
彰化縣,田中鎮,0764,524,162,686,33,719,1155,62.25%,45.37%,1
彰化縣,田中鎮,0765,434,256,690,41,731,1270,57.56%,34.17%,1
彰化縣,田中鎮,0766,262,193,455,37,492,870,56.55%,30.11%,1
彰化縣,田中鎮,0767,259,130,389,38,427,736,58.02%,35.19%,1
彰化縣,田中鎮,0768,393,267,660,40,700,1335,52.43%,29.44%,1
彰化縣,田中鎮,0769,252,215,467,34,501,876,57.19%,28.77%,1
彰化縣,田中鎮,0770,268,193,461,40,501,898,55.79%,29.84%,1
彰化縣,田中鎮,0771,460,283,743,24,767,1298,59.09%,35.44%,1
彰化縣,田中鎮,0772,454,319,773,45,818,1451,56.37%,31.29%,1
彰化縣,田中鎮,0773,462,348,810,31,841,1475,57.02%,31.32%,1
彰化縣,田中鎮,0774,223,142,365,36,401,766,52.35%,29.11%,1
彰化縣,田中鎮,0775,250,168,418,27,445,810,54.94%,30.86%,1
彰化縣,田中鎮,0776,292,242,534,35,569,953,59.71%,30.64%,1
彰化縣,田中鎮,0777,347,179,526,38,564,885,63.73%,39.21%,1
彰化縣,大村鄉,0579,493,361,854,53,907,1426,63.6%,34.57%,1
彰化縣,大村鄉,0580,608,407,1015,62,1077,1726,62.4%,35.23%,1
彰化縣,大村鄉,0581,298,174,472,39,511,797,64.12%,37.39%,1
彰化縣,大村鄉,0582,279,153,432,13,445,745,59.73%,37.45%,1
彰化縣,大村鄉,0583,417,227,644,50,694,1125,61.69%,37.07%,1
彰化縣,大村鄉,0584,470,345,815,54,869,1486,58.48%,31.63%,1
彰化縣,大村鄉,0585,464,313,777,57,834,1426,58.49%,32.54%,1
彰化縣,大村鄉,0586,307,184,491,34,525,824,63.71%,37.26%,1
彰化縣,大村鄉,0587,358,227,585,40,625,1177,53.1%,30.42%,1
彰化縣,大村鄉,0588,484,339,823,59,882,1478,59.68%,32.75%,1
彰化縣,大村鄉,0589,238,167,405,18,423,779,54.3%,30.55%,1
彰化縣,大村鄉,0590,291,196,487,35,522,812,64.29%,35.84%,1
彰化縣,大村鄉,0591,367,232,599,41,640,1161,55.12%,31.61%,1
彰化縣,大村鄉,0592,390,263,653,22,675,1238,54.52%,31.5%,1
彰化縣,大村鄉,0593,424,262,686,42,728,1259,57.82%,33.68%,1
彰化縣,大村鄉,0594,453,326,779,42,821,1412,58.14%,32.08%,1
彰化縣,大村鄉,0595,470,305,775,36,811,1401,57.89%,33.55%,1
彰化縣,大村鄉,0596,494,315,809,39,848,1395,60.79%,35.41%,1
彰化縣,大村鄉,0597,314,247,561,36,597,996,59.94%,31.53%,1
彰化縣,大村鄉,0598,350,231,581,32,613,1047,58.55%,33.43%,1
彰化縣,大村鄉,0599,342,210,552,40,592,985,60.1%,34.72%,1
彰化縣,大村鄉,0600,367,258,625,35,660,1054,62.62%,34.82%,1
彰化縣,大村鄉,0601,428,258,686,27,713,1200,59.42%,35.67%,1
彰化縣,大村鄉,0602,333,232,565,53,618,1003,61.62%,33.2%,1
彰化縣,大村鄉,0603,508,36,544,34,578,1046,55.26%,48.57%,1
彰化縣,大村鄉,0604,372,294,666,45,711,1189,59.8%,31.29%,1
彰化縣,大村鄉,0605,383,290,673,31,704,1305,53.95%,29.35%,1
彰化縣,埔鹽鄉,0682,356,211,567,29,596,958,62.21%,37.16%,1
彰化縣,埔鹽鄉,0683,299,163,462,19,481,754,63.79%,39.66%,1
彰化縣,埔鹽鄉,0684,294,190,484,17,501,757,66.18%,38.84%,1
彰化縣,埔鹽鄉,0685,275,208,483,22,505,806,62.66%,34.12%,1
彰化縣,埔鹽鄉,0686,435,298,733,29,762,1280,59.53%,33.98%,1
彰化縣,埔鹽鄉,0687,309,211,520,30,550,928,59.27%,33.3%,1
彰化縣,埔鹽鄉,0688,313,241,554,38,592,895,66.15%,34.97%,1
彰化縣,埔鹽鄉,0689,320,162,482,46,528,815,64.79%,39.26%,1
彰化縣,埔鹽鄉,0690,318,210,528,32,560,957,58.52%,33.23%,1
彰化縣,埔鹽鄉,0691,485,256,741,56,797,1338,59.57%,36.25%,1
彰化縣,埔鹽鄉,0692,353,232,585,55,640,1106,57.87%,31.92%,1
彰化縣,埔鹽鄉,0693,300,181,481,20,501,690,72.61%,43.48%,1
彰化縣,埔鹽鄉,0694,399,262,661,0,661,1230,53.74%,32.44%,1
彰化縣,埔鹽鄉,0695,280,207,487,23,510,847,60.21%,33.06%,1
彰化縣,埔鹽鄉,0696,356,184,540,22,562,897,62.65%,39.69%,1
彰化縣,埔鹽鄉,0697,282,205,487,44,531,882,60.2%,31.97%,1
彰化縣,埔鹽鄉,0698,449,233,682,34,716,1180,60.68%,38.05%,1
彰化縣,埔鹽鄉,0699,404,251,655,50,705,1215,58.02%,33.25%,1
彰化縣,埔鹽鄉,0700,170,89,259,23,282,422,66.82%,40.28%,1
彰化縣,埔鹽鄉,0701,378,198,576,43,619,1106,55.97%,34.18%,1
彰化縣,埔鹽鄉,0702,338,183,521,46,567,874,64.87%,38.67%,1
彰化縣,埔鹽鄉,0703,466,291,757,99,856,1445,59.24%,32.25%,1
彰化縣,埔鹽鄉,0704,303,197,500,46,546,875,62.4%,34.63%,1
彰化縣,埔鹽鄉,0705,274,152,426,24,450,837,53.76%,32.74%,1
彰化縣,埔鹽鄉,0706,265,125,390,23,413,685,60.29%,38.69%,1
彰化縣,埔鹽鄉,0707,270,176,446,24,470,733,64.12%,36.83%,1
彰化縣,埔鹽鄉,0708,295,172,467,34,501,798,62.78%,36.97%,1
彰化縣,埔鹽鄉,0709,479,270,749,45,794,1381,57.49%,34.69%,1
彰化縣,埔鹽鄉,0710,409,262,671,51,722,1335,54.08%,30.64%,1
彰化縣,埔心鄉,0711,374,293,667,47,714,1139,62.69%,32.84%,1
彰化縣,埔心鄉,0712,402,285,687,42,729,1217,59.9%,33.03%,1
彰化縣,埔心鄉,0713,445,296,741,37,778,1248,62.34%,35.66%,1
彰化縣,埔心鄉,0714,442,300,742,65,807,1248,64.66%,35.42%,1
彰化縣,埔心鄉,0715,346,195,541,26,567,916,61.9%,37.77%,1
彰化縣,埔心鄉,0716,223,172,395,16,411,625,65.76%,35.68%,1
彰化縣,埔心鄉,0717,371,297,668,59,727,1271,57.2%,29.19%,1
彰化縣,埔心鄉,0718,239,132,371,26,397,608,65.3%,39.31%,1
彰化縣,埔心鄉,0719,405,269,674,57,731,1132,64.58%,35.78%,1
彰化縣,埔心鄉,0720,374,227,601,49,650,1027,63.29%,36.42%,1
彰化縣,埔心鄉,0721,328,215,543,49,592,926,63.93%,35.42%,1
彰化縣,埔心鄉,0722,241,199,440,42,482,778,61.95%,30.98%,1
彰化縣,埔心鄉,0723,261,148,409,22,431,660,65.3%,39.55%,1
彰化縣,埔心鄉,0724,439,325,764,49,813,1330,61.13%,33.01%,1
彰化縣,埔心鄉,0725,317,254,571,24,595,991,60.04%,31.99%,1
彰化縣,埔心鄉,0726,364,220,584,29,613,985,62.23%,36.95%,1
彰化縣,埔心鄉,0727,319,244,563,29,592,1034,57.25%,30.85%,1
彰化縣,埔心鄉,0728,213,153,366,36,402,612,65.69%,34.8%,1
彰化縣,埔心鄉,0729,408,329,737,53,790,1236,63.92%,33.01%,1
彰化縣,埔心鄉,0730,269,188,457,34,491,775,63.35%,34.71%,1
彰化縣,埔心鄉,0731,258,210,468,28,496,738,67.21%,34.96%,1
彰化縣,埔心鄉,0732,353,256,609,31,640,1036,61.78%,34.07%,1
彰化縣,埔心鄉,0733,325,200,525,41,566,975,58.05%,33.33%,1
彰化縣,埔心鄉,0734,291,195,486,36,522,885,58.98%,32.88%,1
彰化縣,埔心鄉,0735,300,247,547,48,595,939,63.37%,31.95%,1
彰化縣,埔心鄉,0736,250,149,399,20,419,689,60.81%,36.28%,1
彰化縣,埔心鄉,0737,242,135,377,27,404,659,61.31%,36.72%,1
彰化縣,埔心鄉,0738,287,204,491,22,513,910,56.37%,31.54%,1
彰化縣,埔心鄉,0739,494,353,847,47,894,1352,66.12%,36.54%,1
彰化縣,埔心鄉,0740,249,161,410,32,442,759,58.23%,32.81%,1
彰化縣,埔心鄉,0741,488,34,522,46,568,942,60.3%,51.8%,1
彰化縣,永靖鄉,0606,366,249,615,49,664,1255,52.91%,29.16%,1
彰化縣,永靖鄉,0607,325,180,505,43,548,889,61.64%,36.56%,1
彰化縣,永靖鄉,0608,333,228,561,21,582,1026,56.73%,32.46%,1
彰化縣,永靖鄉,0609,260,162,422,30,452,724,62.43%,35.91%,1
彰化縣,永靖鄉,0610,302,200,502,51,553,924,59.85%,32.68%,1
彰化縣,永靖鄉,0611,236,160,396,24,420,659,63.73%,35.81%,1
彰化縣,永靖鄉,0612,221,187,408,24,432,734,58.86%,30.11%,1
彰化縣,永靖鄉,0613,221,146,367,12,379,758,50%,29.16%,1
彰化縣,永靖鄉,0614,327,192,519,35,554,848,65.33%,38.56%,1
彰化縣,永靖鄉,0615,411,280,691,62,753,1404,53.63%,29.27%,1
彰化縣,永靖鄉,0616,301,216,517,31,548,792,69.19%,38.01%,1
彰化縣,永靖鄉,0617,246,185,431,19,450,695,64.75%,35.4%,1
彰化縣,永靖鄉,0618,307,185,492,17,509,821,62%,37.39%,1
彰化縣,永靖鄉,0619,346,269,615,58,673,1064,63.25%,32.52%,1
彰化縣,永靖鄉,0620,285,172,457,30,487,840,57.98%,33.93%,1
彰化縣,永靖鄉,0621,382,255,637,28,665,1079,61.63%,35.4%,1
彰化縣,永靖鄉,0622,398,229,627,28,655,1048,62.5%,37.98%,1
彰化縣,永靖鄉,0623,338,255,593,27,620,960,64.58%,35.21%,1
彰化縣,永靖鄉,0624,260,216,476,22,498,798,62.41%,32.58%,1
彰化縣,永靖鄉,0625,252,236,488,40,528,796,66.33%,31.66%,1
彰化縣,永靖鄉,0626,221,133,354,31,385,662,58.16%,33.38%,1
彰化縣,永靖鄉,0627,346,231,577,33,610,1040,58.65%,33.27%,1
彰化縣,永靖鄉,0628,315,246,561,31,592,1025,57.76%,30.73%,1
彰化縣,永靖鄉,0629,525,309,834,42,876,1357,64.55%,38.69%,1
彰化縣,永靖鄉,0630,429,280,709,45,754,1236,61%,34.71%,1
彰化縣,永靖鄉,0631,287,227,514,29,543,871,62.34%,32.95%,1
彰化縣,永靖鄉,0632,219,141,360,26,386,706,54.67%,31.02%,1
彰化縣,永靖鄉,0633,259,205,464,33,497,770,64.55%,33.64%,1
彰化縣,永靖鄉,0634,268,158,426,21,447,669,66.82%,40.06%,1
彰化縣,永靖鄉,0635,288,195,483,26,509,862,59.05%,33.41%,1
彰化縣,永靖鄉,0636,279,172,451,28,479,847,56.55%,32.94%,1
彰化縣,永靖鄉,0637,241,140,381,49,430,668,64.37%,36.08%,1
彰化縣,永靖鄉,0638,357,202,559,21,580,1073,54.05%,33.27%,1
彰化縣,永靖鄉,0639,433,235,668,28,696,1339,51.98%,32.34%,1
彰化縣,社頭鄉,0778,228,212,440,27,467,791,59.04%,28.82%,1
彰化縣,社頭鄉,0779,313,216,529,32,561,984,57.01%,31.81%,1
彰化縣,社頭鄉,0780,300,227,527,14,541,990,54.65%,30.3%,1
彰化縣,社頭鄉,0781,389,201,590,42,632,1016,62.2%,38.29%,1
彰化縣,社頭鄉,0782,355,264,619,40,659,1091,60.4%,32.54%,1
彰化縣,社頭鄉,0783,401,289,690,53,743,1236,60.11%,32.44%,1
彰化縣,社頭鄉,0784,389,255,644,23,667,1203,55.44%,32.34%,1
彰化縣,社頭鄉,0785,237,168,405,22,427,753,56.71%,31.47%,1
彰化縣,社頭鄉,0786,231,130,361,27,388,725,53.52%,31.86%,1
彰化縣,社頭鄉,0787,324,244,568,56,624,1023,61%,31.67%,1
彰化縣,社頭鄉,0788,201,161,362,21,383,562,68.15%,35.77%,1
彰化縣,社頭鄉,0789,337,228,565,27,592,1049,56.43%,32.13%,1
彰化縣,社頭鄉,0790,307,224,531,31,562,933,60.24%,32.9%,1
彰化縣,社頭鄉,0791,313,261,574,31,605,990,61.11%,31.62%,1
彰化縣,社頭鄉,0792,344,224,568,25,593,1076,55.11%,31.97%,1
彰化縣,社頭鄉,0793,264,178,442,16,458,742,61.73%,35.58%,1
彰化縣,社頭鄉,0794,227,148,375,14,389,672,57.89%,33.78%,1
彰化縣,社頭鄉,0795,377,223,600,29,629,1235,50.93%,30.53%,1
彰化縣,社頭鄉,0796,250,174,424,29,453,750,60.4%,33.33%,1
彰化縣,社頭鄉,0797,278,177,455,33,488,895,54.53%,31.06%,1
彰化縣,社頭鄉,0798,253,142,395,18,413,688,60.03%,36.77%,1
彰化縣,社頭鄉,0799,312,160,472,21,493,870,56.67%,35.86%,1
彰化縣,社頭鄉,0800,413,255,668,20,688,1140,60.35%,36.23%,1
彰化縣,社頭鄉,0801,350,199,549,33,582,985,59.09%,35.53%,1
彰化縣,社頭鄉,0802,137,602,739,49,788,1266,62.24%,10.82%,1
彰化縣,社頭鄉,0803,318,201,519,35,554,937,59.12%,33.94%,1
彰化縣,社頭鄉,0804,383,279,662,29,691,1219,56.69%,31.42%,1
彰化縣,社頭鄉,0805,490,245,735,46,781,1165,67.04%,42.06%,1
彰化縣,社頭鄉,0806,332,214,546,45,591,986,59.94%,33.67%,1
彰化縣,社頭鄉,0807,237,198,435,24,459,724,63.4%,32.73%,1
彰化縣,社頭鄉,0808,359,200,559,33,592,1015,58.33%,35.37%,1
彰化縣,社頭鄉,0809,334,211,545,26,571,1116,51.16%,29.93%,1
彰化縣,社頭鄉,0810,318,232,550,27,577,1061,54.38%,29.97%,1
彰化縣,社頭鄉,0811,325,229,554,41,595,992,59.98%,32.76%,1
彰化縣,社頭鄉,0812,348,237,585,27,612,1092,56.04%,31.87%,1
彰化縣,社頭鄉,0813,293,185,478,31,509,828,61.47%,35.39%,1
彰化縣,社頭鄉,0814,231,160,391,33,424,787,53.88%,29.35%,1
彰化縣,社頭鄉,0815,203,139,342,23,365,719,50.76%,28.23%,1
彰化縣,二水鄉,0816,306,238,544,65,609,1028,59.24%,29.77%,1
彰化縣,二水鄉,0817,225,167,392,41,433,689,62.84%,32.66%,1
彰化縣,二水鄉,0818,281,154,435,42,477,871,54.76%,32.26%,1
彰化縣,二水鄉,0819,453,86,539,34,573,953,60.13%,47.53%,1
彰化縣,二水鄉,0820,207,113,320,27,347,624,55.61%,33.17%,1
彰化縣,二水鄉,0821,244,158,402,30,432,645,66.98%,37.83%,1
彰化縣,二水鄉,0822,401,213,614,37,651,986,66.02%,40.67%,1
彰化縣,二水鄉,0823,399,181,580,44,624,943,66.17%,42.31%,1
彰化縣,二水鄉,0824,185,93,278,5,283,455,62.2%,40.66%,1
彰化縣,二水鄉,0825,500,50,550,30,580,831,69.8%,60.17%,1
彰化縣,二水鄉,0826,280,214,494,25,519,831,62.45%,33.69%,1
彰化縣,二水鄉,0827,353,197,550,27,577,1013,56.96%,34.85%,1
彰化縣,二水鄉,0828,304,169,473,32,505,796,63.44%,38.19%,1
彰化縣,二水鄉,0829,240,174,414,38,452,781,57.87%,30.73%,1
彰化縣,二水鄉,0830,212,139,351,20,371,692,53.61%,30.64%,1
彰化縣,二水鄉,0831,198,150,348,26,374,635,58.9%,31.18%,1
彰化縣,二水鄉,0832,195,115,310,24,334,566,59.01%,34.45%,1
彰化縣,北斗鎮,0833,331,146,477,45,522,925,56.43%,35.78%,1
彰化縣,北斗鎮,0834,328,165,493,39,532,869,61.22%,37.74%,1
彰化縣,北斗鎮,0835,334,190,524,29,553,855,64.68%,39.06%,1
彰化縣,北斗鎮,0836,412,224,636,39,675,1065,63.38%,38.69%,1
彰化縣,北斗鎮,0837,278,184,462,44,506,828,61.11%,33.57%,1
彰化縣,北斗鎮,0838,402,240,642,36,678,1124,60.32%,35.77%,1
彰化縣,北斗鎮,0839,379,258,637,36,673,1096,61.41%,34.58%,1
彰化縣,北斗鎮,0840,428,254,682,33,715,1213,58.94%,35.28%,1
彰化縣,北斗鎮,0841,359,234,593,53,646,1164,55.5%,30.84%,1
彰化縣,北斗鎮,0842,247,150,397,20,417,730,57.12%,33.84%,1
彰化縣,北斗鎮,0843,284,189,473,22,495,878,56.38%,32.35%,1
彰化縣,北斗鎮,0844,325,164,489,25,514,833,61.7%,39.02%,1
彰化縣,北斗鎮,0845,331,216,547,23,570,957,59.56%,34.59%,1
彰化縣,北斗鎮,0846,259,161,420,28,448,783,57.22%,33.08%,1
彰化縣,北斗鎮,0847,162,134,296,25,321,573,56.02%,28.27%,1
彰化縣,北斗鎮,0848,206,145,351,29,380,672,56.55%,30.65%,1
彰化縣,北斗鎮,0849,218,133,351,30,381,695,54.82%,31.37%,1
彰化縣,北斗鎮,0850,218,154,372,30,402,747,53.82%,29.18%,1
彰化縣,北斗鎮,0851,243,150,393,20,413,643,64.23%,37.79%,1
彰化縣,北斗鎮,0852,222,150,372,27,399,662,60.27%,33.53%,1
彰化縣,北斗鎮,0853,422,236,658,39,697,1085,64.24%,38.89%,1
彰化縣,北斗鎮,0854,435,190,625,44,669,1121,59.68%,38.8%,1
彰化縣,北斗鎮,0855,307,174,481,29,510,830,61.45%,36.99%,1
彰化縣,北斗鎮,0856,307,208,515,29,544,975,55.79%,31.49%,1
彰化縣,北斗鎮,0857,380,259,639,27,666,1212,54.95%,31.35%,1
彰化縣,北斗鎮,0858,478,260,738,43,781,1302,59.98%,36.71%,1
彰化縣,北斗鎮,0859,313,193,506,33,539,1077,50.05%,29.06%,1
彰化縣,北斗鎮,0860,279,190,469,40,509,917,55.51%,30.43%,1
彰化縣,北斗鎮,0861,257,189,446,21,467,825,56.61%,31.15%,1
彰化縣,北斗鎮,0862,321,208,529,30,559,937,59.66%,34.26%,1
彰化縣,二林鎮,0942,182,111,293,31,324,731,44.32%,24.9%,1
彰化縣,二林鎮,0943,329,220,549,40,589,1025,57.46%,32.1%,1
彰化縣,二林鎮,0944,246,187,433,22,455,784,58.04%,31.38%,1
彰化縣,二林鎮,0945,315,175,490,28,518,892,58.07%,35.31%,1
彰化縣,二林鎮,0946,423,268,691,42,733,1256,58.36%,33.68%,1
彰化縣,二林鎮,0947,314,218,532,41,573,1043,54.94%,30.11%,1
彰化縣,二林鎮,0948,349,271,620,29,649,1076,60.32%,32.43%,1
彰化縣,二林鎮,0949,353,252,605,37,642,1082,59.33%,32.62%,1
彰化縣,二林鎮,0950,640,97,737,41,778,1427,54.52%,44.85%,1
彰化縣,二林鎮,0951,290,195,485,42,527,1030,51.17%,28.16%,1
彰化縣,二林鎮,0952,280,219,499,37,536,1033,51.89%,27.11%,1
彰化縣,二林鎮,0953,289,216,505,38,543,977,55.58%,29.58%,1
彰化縣,二林鎮,0954,204,130,334,19,353,683,51.68%,29.87%,1
彰化縣,二林鎮,0955,290,159,449,63,512,975,52.51%,29.74%,1
彰化縣,二林鎮,0956,342,214,556,49,605,1336,45.28%,25.6%,1
彰化縣,二林鎮,0957,248,189,437,48,485,1019,47.6%,24.34%,1
彰化縣,二林鎮,0958,217,190,407,37,444,1003,44.27%,21.64%,1
彰化縣,二林鎮,0959,386,220,606,44,650,1151,56.47%,33.54%,1
彰化縣,二林鎮,0960,521,320,841,69,910,1598,56.95%,32.6%,1
彰化縣,二林鎮,0961,470,283,753,50,803,1488,53.97%,31.59%,1
彰化縣,二林鎮,0962,609,330,939,51,990,1771,55.9%,34.39%,1
彰化縣,二林鎮,0963,321,231,552,35,587,1360,43.16%,23.6%,1
彰化縣,二林鎮,0964,436,272,708,50,758,1613,46.99%,27.03%,1
彰化縣,二林鎮,0965,362,215,577,64,641,1228,52.2%,29.48%,1
彰化縣,二林鎮,0966,264,159,423,16,439,771,56.94%,34.24%,1
彰化縣,二林鎮,0967,302,185,487,21,508,858,59.21%,35.2%,1
彰化縣,二林鎮,0968,183,116,299,4,303,661,45.84%,27.69%,1
彰化縣,二林鎮,0969,353,230,583,56,639,1268,50.39%,27.84%,1
彰化縣,二林鎮,0970,321,187,508,22,530,1081,49.03%,29.69%,1
彰化縣,二林鎮,0971,351,216,567,27,594,1213,48.97%,28.94%,1
彰化縣,二林鎮,0972,427,284,711,29,740,1328,55.72%,32.15%,1
彰化縣,二林鎮,0973,298,181,479,55,534,1118,47.76%,26.65%,1
彰化縣,二林鎮,0974,399,196,595,40,635,1157,54.88%,34.49%,1
彰化縣,二林鎮,0975,285,164,449,30,479,972,49.28%,29.32%,1
彰化縣,二林鎮,0976,269,183,452,33,485,902,53.77%,29.82%,1
彰化縣,二林鎮,0977,489,278,767,37,804,1273,63.16%,38.41%,1
彰化縣,二林鎮,0978,329,229,558,29,587,1087,54%,30.27%,1
彰化縣,二林鎮,0979,327,198,525,64,589,987,59.68%,33.13%,1
彰化縣,二林鎮,0980,198,127,325,22,347,719,48.26%,27.54%,1
彰化縣,田尾鄉,0863,378,248,626,45,671,1284,52.26%,29.44%,1
彰化縣,田尾鄉,0864,417,259,676,51,727,1187,61.25%,35.13%,1
彰化縣,田尾鄉,0865,367,221,588,42,630,1033,60.99%,35.53%,1
彰化縣,田尾鄉,0866,280,123,403,24,427,696,61.35%,40.23%,1
彰化縣,田尾鄉,0867,333,176,509,29,538,872,61.7%,38.19%,1
彰化縣,田尾鄉,0868,213,142,355,22,377,680,55.44%,31.32%,1
彰化縣,田尾鄉,0869,313,213,526,33,559,875,63.89%,35.77%,1
彰化縣,田尾鄉,0870,439,247,686,44,730,1337,54.6%,32.83%,1
彰化縣,田尾鄉,0871,507,282,789,52,841,1376,61.12%,36.85%,1
彰化縣,田尾鄉,0872,467,233,700,37,737,1186,62.14%,39.38%,1
彰化縣,田尾鄉,0873,353,208,561,45,606,874,69.34%,40.39%,1
彰化縣,田尾鄉,0874,207,140,347,19,366,647,56.57%,31.99%,1
彰化縣,田尾鄉,0875,360,193,553,22,575,959,59.96%,37.54%,1
彰化縣,田尾鄉,0876,82,48,130,14,144,263,54.75%,31.18%,1
彰化縣,田尾鄉,0877,202,106,308,29,337,618,54.53%,32.69%,1
彰化縣,田尾鄉,0878,368,214,582,20,602,938,64.18%,39.23%,1
彰化縣,田尾鄉,0879,327,196,523,41,564,880,64.09%,37.16%,1
彰化縣,田尾鄉,0880,249,158,407,23,430,804,53.48%,30.97%,1
彰化縣,田尾鄉,0881,171,140,311,18,329,592,55.57%,28.89%,1
彰化縣,田尾鄉,0882,394,235,629,60,689,1079,63.86%,36.52%,1
彰化縣,田尾鄉,0883,407,318,725,52,777,1336,58.16%,30.46%,1
彰化縣,田尾鄉,0884,367,248,615,37,652,1198,54.42%,30.63%,1
彰化縣,田尾鄉,0885,190,130,320,35,355,621,57.17%,30.6%,1
彰化縣,田尾鄉,0886,223,172,395,19,414,760,54.47%,29.34%,1
彰化縣,田尾鄉,0887,355,280,635,66,701,1084,64.67%,32.75%,1
彰化縣,埤頭鄉,0888,340,186,526,45,571,1178,48.47%,28.86%,1
彰化縣,埤頭鄉,0889,381,265,646,38,684,1290,53.02%,29.53%,1
彰化縣,埤頭鄉,0890,258,224,482,52,534,973,54.88%,26.52%,1
彰化縣,埤頭鄉,0891,233,156,389,31,420,783,53.64%,29.76%,1
彰化縣,埤頭鄉,0892,215,162,377,41,418,733,57.03%,29.33%,1
彰化縣,埤頭鄉,0893,263,208,471,58,529,899,58.84%,29.25%,1
彰化縣,埤頭鄉,0894,277,210,487,57,544,965,56.37%,28.7%,1
彰化縣,埤頭鄉,0895,440,228,668,46,714,1356,52.65%,32.45%,1
彰化縣,埤頭鄉,0896,395,256,651,43,694,1265,54.86%,31.23%,1
彰化縣,埤頭鄉,0897,342,161,503,39,542,877,61.8%,39%,1
彰化縣,埤頭鄉,0898,211,135,346,36,382,705,54.18%,29.93%,1
彰化縣,埤頭鄉,0899,387,236,623,34,657,1062,61.86%,36.44%,1
彰化縣,埤頭鄉,0900,463,246,709,41,750,1300,57.69%,35.62%,1
彰化縣,埤頭鄉,0901,323,169,492,48,540,923,58.5%,34.99%,1
彰化縣,埤頭鄉,0902,335,193,528,43,571,1085,52.63%,30.88%,1
彰化縣,埤頭鄉,0903,357,239,596,58,654,1103,59.29%,32.37%,1
彰化縣,埤頭鄉,0904,216,150,366,22,388,735,52.79%,29.39%,1
彰化縣,埤頭鄉,0905,145,142,287,29,316,574,55.05%,25.26%,1
彰化縣,埤頭鄉,0906,219,129,348,39,387,767,50.46%,28.55%,1
彰化縣,埤頭鄉,0907,234,139,373,34,407,737,55.22%,31.75%,1
彰化縣,埤頭鄉,0908,194,191,385,53,438,1058,41.4%,18.34%,1
彰化縣,埤頭鄉,0909,219,145,364,63,427,826,51.69%,26.51%,1
彰化縣,埤頭鄉,0910,302,182,484,66,550,1082,50.83%,27.91%,1
彰化縣,埤頭鄉,0911,252,154,406,42,448,737,60.79%,34.19%,1
彰化縣,埤頭鄉,0912,207,151,358,16,374,711,52.6%,29.11%,1
彰化縣,埤頭鄉,0913,349,203,552,48,600,1043,57.53%,33.46%,1
彰化縣,埤頭鄉,0914,275,169,444,24,468,910,51.43%,30.22%,1
彰化縣,芳苑鄉,0998,183,117,300,37,337,940,35.85%,19.47%,1
彰化縣,芳苑鄉,0999,97,50,147,23,170,403,42.18%,24.07%,1
彰化縣,芳苑鄉,1000,215,135,350,30,380,756,50.26%,28.44%,1
彰化縣,芳苑鄉,1001,97,60,157,21,178,548,32.48%,17.7%,1
彰化縣,芳苑鄉,1002,294,188,482,40,522,997,52.36%,29.49%,1
彰化縣,芳苑鄉,1003,307,235,542,52,594,1300,45.69%,23.62%,1
彰化縣,芳苑鄉,1004,223,180,403,40,443,859,51.57%,25.96%,1
彰化縣,芳苑鄉,1005,220,151,371,14,385,734,52.45%,29.97%,1
彰化縣,芳苑鄉,1006,155,126,281,24,305,636,47.96%,24.37%,1
彰化縣,芳苑鄉,1007,196,138,334,49,383,808,47.4%,24.26%,1
彰化縣,芳苑鄉,1008,143,119,262,33,295,668,44.16%,21.41%,1
彰化縣,芳苑鄉,1009,184,160,344,34,378,744,50.81%,24.73%,1
彰化縣,芳苑鄉,1010,311,176,487,59,546,1026,53.22%,30.31%,1
彰化縣,芳苑鄉,1011,138,93,231,14,245,586,41.81%,23.55%,1
彰化縣,芳苑鄉,1012,161,119,280,35,315,593,53.12%,27.15%,1
彰化縣,芳苑鄉,1013,353,171,524,44,568,1071,53.03%,32.96%,1
彰化縣,芳苑鄉,1014,228,179,407,53,460,1060,43.4%,21.51%,1
彰化縣,芳苑鄉,1015,252,122,374,18,392,708,55.37%,35.59%,1
彰化縣,芳苑鄉,1016,209,120,329,36,365,735,49.66%,28.44%,1
彰化縣,芳苑鄉,1017,181,125,306,30,336,571,58.84%,31.7%,1
彰化縣,芳苑鄉,1018,193,101,294,30,324,729,44.44%,26.47%,1
彰化縣,芳苑鄉,1019,219,104,323,35,358,674,53.12%,32.49%,1
彰化縣,芳苑鄉,1020,242,169,411,24,435,846,51.42%,28.61%,1
彰化縣,芳苑鄉,1021,299,148,447,29,476,806,59.06%,37.1%,1
彰化縣,芳苑鄉,1022,118,65,183,15,198,470,42.13%,25.11%,1
彰化縣,芳苑鄉,1023,351,221,572,44,616,1124,54.8%,31.23%,1
彰化縣,芳苑鄉,1024,83,52,135,17,152,317,47.95%,26.18%,1
彰化縣,芳苑鄉,1025,272,173,445,54,499,1158,43.09%,23.49%,1
彰化縣,芳苑鄉,1026,286,148,434,29,463,967,47.88%,29.58%,1
彰化縣,芳苑鄉,1027,217,148,365,44,409,762,53.67%,28.48%,1
彰化縣,芳苑鄉,1028,248,197,445,36,481,1086,44.29%,22.84%,1
彰化縣,芳苑鄉,1029,210,128,338,30,368,747,49.26%,28.11%,1
彰化縣,芳苑鄉,1030,143,101,244,22,266,653,40.74%,21.9%,1
彰化縣,芳苑鄉,1031,306,164,470,44,514,872,58.94%,35.09%,1
彰化縣,芳苑鄉,1032,423,268,691,54,745,1235,60.32%,34.25%,1
彰化縣,芳苑鄉,1033,328,215,543,45,588,1102,53.36%,29.76%,1
彰化縣,大城鄉,0981,263,166,429,26,455,1288,35.33%,20.42%,1
彰化縣,大城鄉,0982,232,145,377,51,428,1104,38.77%,21.01%,1
彰化縣,大城鄉,0983,328,174,502,39,541,964,56.12%,34.02%,1
彰化縣,大城鄉,0984,351,202,553,55,608,1312,46.34%,26.75%,1
彰化縣,大城鄉,0985,208,114,322,44,366,853,42.91%,24.38%,1
彰化縣,大城鄉,0986,108,59,167,17,184,518,35.52%,20.85%,1
彰化縣,大城鄉,0987,136,92,228,22,250,574,43.55%,23.69%,1
彰化縣,大城鄉,0988,130,109,239,29,268,702,38.18%,18.52%,1
彰化縣,大城鄉,0989,55,54,109,10,119,376,31.65%,14.63%,1
彰化縣,大城鄉,0990,135,64,199,18,217,693,31.31%,19.48%,1
彰化縣,大城鄉,0991,206,140,346,41,387,877,44.13%,23.49%,1
彰化縣,大城鄉,0992,101,87,188,18,206,655,31.45%,15.42%,1
彰化縣,大城鄉,0993,254,140,394,31,425,1103,38.53%,23.03%,1
彰化縣,大城鄉,0994,221,169,390,27,417,1192,34.98%,18.54%,1
彰化縣,大城鄉,0995,211,128,339,22,361,917,39.37%,23.01%,1
彰化縣,大城鄉,0996,137,75,212,18,230,686,33.53%,19.97%,1
彰化縣,大城鄉,0997,164,108,272,20,292,899,32.48%,18.24%,1
彰化縣,竹塘鄉,1034,388,244,632,48,680,1168,58.22%,33.22%,1
彰化縣,竹塘鄉,1035,336,222,558,17,575,965,59.59%,34.82%,1
彰化縣,竹塘鄉,1036,339,221,560,42,602,960,62.71%,35.31%,1
彰化縣,竹塘鄉,1037,161,278,439,42,481,743,64.74%,21.67%,1
彰化縣,竹塘鄉,1038,172,135,307,36,343,751,45.67%,22.9%,1
彰化縣,竹塘鄉,1039,230,124,354,31,385,792,48.61%,29.04%,1
彰化縣,竹塘鄉,1040,196,145,341,15,356,733,48.57%,26.74%,1
彰化縣,竹塘鄉,1041,207,123,330,29,359,657,54.64%,31.51%,1
彰化縣,竹塘鄉,1042,329,202,531,40,571,1063,53.72%,30.95%,1
彰化縣,竹塘鄉,1043,328,252,580,60,640,1114,57.45%,29.44%,1
彰化縣,竹塘鄉,1044,198,119,317,22,339,506,67%,39.13%,1
彰化縣,竹塘鄉,1045,193,190,383,44,427,823,51.88%,23.45%,1
彰化縣,竹塘鄉,1046,184,130,314,23,337,654,51.53%,28.13%,1
彰化縣,竹塘鄉,1047,170,87,257,15,272,577,47.14%,29.46%,1
彰化縣,竹塘鄉,1048,205,159,364,47,411,772,53.24%,26.55%,1
彰化縣,竹塘鄉,1049,119,86,205,47,252,543,46.41%,21.92%,1
彰化縣,溪州鄉,0915,264,141,405,27,432,778,55.53%,33.93%,1
彰化縣,溪州鄉,0916,298,206,504,24,528,1061,49.76%,28.09%,1
彰化縣,溪州鄉,0917,225,118,343,24,367,701,52.35%,32.1%,1
彰化縣,溪州鄉,0918,337,181,518,30,548,879,62.34%,38.34%,1
彰化縣,溪州鄉,0919,160,243,403,29,432,654,66.06%,24.46%,1
彰化縣,溪州鄉,0920,296,188,484,21,505,878,57.52%,33.71%,1
彰化縣,溪州鄉,0921,344,210,554,28,582,942,61.78%,36.52%,1
彰化縣,溪州鄉,0922,294,165,459,25,484,871,55.57%,33.75%,1
彰化縣,溪州鄉,0923,364,170,534,23,557,1047,53.2%,34.77%,1
彰化縣,溪州鄉,0924,264,210,474,34,508,858,59.21%,30.77%,1
彰化縣,溪州鄉,0925,374,227,601,50,651,1409,46.2%,26.54%,1
彰化縣,溪州鄉,0926,266,148,414,11,425,792,53.66%,33.59%,1
彰化縣,溪州鄉,0927,210,140,350,36,386,714,54.06%,29.41%,1
彰化縣,溪州鄉,0928,292,204,496,45,541,1109,48.78%,26.33%,1
彰化縣,溪州鄉,0929,210,187,397,38,435,962,45.22%,21.83%,1
彰化縣,溪州鄉,0930,288,194,482,48,530,1157,45.81%,24.89%,1
彰化縣,溪州鄉,0931,278,182,460,38,498,952,52.31%,29.2%,1
彰化縣,溪州鄉,0932,245,192,437,40,477,887,53.78%,27.62%,1
彰化縣,溪州鄉,0933,185,164,349,36,385,866,44.46%,21.36%,1
彰化縣,溪州鄉,0934,241,198,439,49,488,1010,48.32%,23.86%,1
彰化縣,溪州鄉,0935,220,189,409,19,428,853,50.18%,25.79%,1
彰化縣,溪州鄉,0936,235,164,399,41,440,843,52.19%,27.88%,1
彰化縣,溪州鄉,0937,148,109,257,15,272,711,38.26%,20.82%,1
彰化縣,溪州鄉,0938,272,150,422,50,472,851,55.46%,31.96%,1
彰化縣,溪州鄉,0939,250,163,413,32,445,883,50.4%,28.31%,1
彰化縣,溪州鄉,0940,384,207,591,43,634,1247,50.84%,30.79%,1
彰化縣,溪州鄉,0941,446,336,782,49,831,1490,55.77%,29.93%,1
南投縣,南投市,0001,343,205,548,21,569,927,61.38%,37%,1
南投縣,南投市,0002,282,149,431,24,455,667,68.22%,42.28%,1
南投縣,南投市,0003,285,193,478,18,496,773,64.17%,36.87%,1
南投縣,南投市,0004,304,185,489,29,518,818,63.33%,37.16%,1
南投縣,南投市,0005,211,125,336,20,356,525,67.81%,40.19%,1
南投縣,南投市,0006,218,143,361,22,383,575,66.61%,37.91%,1
南投縣,南投市,0007,161,88,249,7,256,368,69.57%,43.75%,1
南投縣,南投市,0008,420,182,602,31,633,956,66.21%,43.93%,1
南投縣,南投市,0009,412,240,652,20,672,1245,53.98%,33.09%,1
南投縣,南投市,0010,527,303,830,12,842,1484,56.74%,35.51%,1
南投縣,南投市,0011,491,264,755,28,783,1191,65.74%,41.23%,1
南投縣,南投市,0012,537,339,876,44,920,1506,61.09%,35.66%,1
南投縣,南投市,0013,376,268,644,31,675,1070,63.08%,35.14%,1
南投縣,南投市,0014,265,142,407,21,428,670,63.88%,39.55%,1
南投縣,南投市,0015,418,246,664,37,701,1050,66.76%,39.81%,1
南投縣,南投市,0016,352,230,582,34,616,1122,54.9%,31.37%,1
南投縣,南投市,0017,285,244,529,29,558,984,56.71%,28.96%,1
南投縣,南投市,0018,405,273,678,31,709,1062,66.76%,38.14%,1
南投縣,南投市,0019,359,236,595,46,641,1053,60.87%,34.09%,1
南投縣,南投市,0020,373,290,663,39,702,1104,63.59%,33.79%,1
南投縣,南投市,0021,383,281,664,31,695,1192,58.31%,32.13%,1
南投縣,南投市,0022,352,179,531,20,551,960,57.4%,36.67%,1
南投縣,南投市,0023,344,179,523,35,558,906,61.59%,37.97%,1
南投縣,南投市,0024,367,201,568,30,598,957,62.49%,38.35%,1
南投縣,南投市,0025,394,230,624,31,655,997,65.7%,39.52%,1
南投縣,南投市,0026,378,222,600,30,630,1008,62.5%,37.5%,1
南投縣,南投市,0027,408,255,663,23,686,1164,58.93%,35.05%,1
南投縣,南投市,0028,197,139,336,14,350,587,59.63%,33.56%,1
南投縣,南投市,0029,216,171,387,29,416,734,56.68%,29.43%,1
南投縣,南投市,0030,238,151,389,43,432,724,59.67%,32.87%,1
南投縣,南投市,0031,376,196,572,27,599,1003,59.72%,37.49%,1
南投縣,南投市,0032,488,268,756,33,789,1356,58.19%,35.99%,1
南投縣,南投市,0033,396,318,714,40,754,1373,54.92%,28.84%,1
南投縣,南投市,0034,485,296,781,34,815,1452,56.13%,33.4%,1
南投縣,南投市,0035,130,73,203,10,213,362,58.84%,35.91%,1
南投縣,南投市,0036,114,99,213,22,235,389,60.41%,29.31%,1
南投縣,南投市,0037,450,337,787,43,830,1276,65.05%,35.27%,1
南投縣,南投市,0038,410,254,664,50,714,1089,65.56%,37.65%,1
南投縣,南投市,0039,325,224,549,44,593,921,64.39%,35.29%,1
南投縣,南投市,0040,387,219,606,14,620,892,69.51%,43.39%,1
南投縣,南投市,0041,421,245,666,29,695,1050,66.19%,40.1%,1
南投縣,南投市,0042,419,233,652,31,683,1078,63.36%,38.87%,1
南投縣,南投市,0043,411,241,652,16,668,1078,61.97%,38.13%,1
南投縣,南投市,0044,366,226,592,32,624,861,72.47%,42.51%,1
南投縣,南投市,0045,454,241,695,41,736,1221,60.28%,37.18%,1
南投縣,南投市,0046,432,215,647,23,670,1105,60.63%,39.1%,1
南投縣,南投市,0047,447,287,734,23,757,1230,61.54%,36.34%,1
南投縣,南投市,0048,424,227,651,24,675,1092,61.81%,38.83%,1
南投縣,南投市,0049,511,293,804,22,826,1286,64.23%,39.74%,1
南投縣,南投市,0050,268,161,429,28,457,655,69.77%,40.92%,1
南投縣,南投市,0051,273,180,453,18,471,719,65.51%,37.97%,1
南投縣,南投市,0052,238,187,425,17,442,720,61.39%,33.06%,1
南投縣,南投市,0053,211,115,326,16,342,509,67.19%,41.45%,1
南投縣,南投市,0054,187,81,268,15,283,492,57.52%,38.01%,1
南投縣,南投市,0055,249,113,362,13,375,616,60.88%,40.42%,1
南投縣,南投市,0056,421,189,610,28,638,1010,63.17%,41.68%,1
南投縣,南投市,0057,341,154,495,16,511,848,60.26%,40.21%,1
南投縣,南投市,0058,534,320,854,39,893,1387,64.38%,38.5%,1
南投縣,南投市,0059,499,274,773,33,806,1245,64.74%,40.08%,1
南投縣,南投市,0060,590,89,679,28,707,1199,58.97%,49.21%,1
南投縣,南投市,0061,487,266,753,42,795,1288,61.72%,37.81%,1
南投縣,南投市,0062,370,223,593,30,623,1040,59.9%,35.58%,1
南投縣,南投市,0063,375,259,634,29,663,1070,61.96%,35.05%,1
南投縣,南投市,0064,481,311,792,27,819,1299,63.05%,37.03%,1
南投縣,南投市,0065,441,239,680,32,712,1122,63.46%,39.3%,1
南投縣,南投市,0066,506,304,810,34,844,1414,59.69%,35.79%,1
南投縣,南投市,0067,403,234,637,33,670,1121,59.77%,35.95%,1
南投縣,南投市,0068,498,310,808,21,829,1434,57.81%,34.73%,1
南投縣,南投市,0069,481,253,734,39,773,1393,55.49%,34.53%,1
南投縣,南投市,0070,387,208,595,19,614,1059,57.98%,36.54%,1
南投縣,南投市,0071,434,254,688,23,711,1218,58.37%,35.63%,1
南投縣,南投市,0072,296,409,705,17,722,1293,55.84%,22.89%,1
南投縣,南投市,0073,416,238,654,22,676,1337,50.56%,31.11%,1
南投縣,南投市,0074,326,213,539,26,565,876,64.5%,37.21%,1
南投縣,南投市,0075,410,126,536,26,562,971,57.88%,42.22%,1
南投縣,南投市,0076,339,233,572,23,595,1012,58.79%,33.5%,1
南投縣,南投市,0077,333,192,525,30,555,973,57.04%,34.22%,1
南投縣,南投市,0078,397,226,623,23,646,1002,64.47%,39.62%,1
南投縣,南投市,0079,312,264,576,37,613,1024,59.86%,30.47%,1
南投縣,南投市,0080,285,222,507,87,594,1122,52.94%,25.4%,1
南投縣,南投市,0081,228,150,378,22,400,790,50.63%,28.86%,1
南投縣,南投市,0082,164,125,289,18,307,647,47.45%,25.35%,1
南投縣,南投市,0083,477,44,521,45,566,950,59.58%,50.21%,1
南投縣,南投市,0084,284,222,506,26,532,980,54.29%,28.98%,1
南投縣,埔里鎮,0085,277,192,469,33,502,828,60.63%,33.45%,1
南投縣,埔里鎮,0086,283,178,461,31,492,786,62.6%,36.01%,1
南投縣,埔里鎮,0087,370,210,580,29,609,1062,57.34%,34.84%,1
南投縣,埔里鎮,0088,416,299,715,36,751,1201,62.53%,34.64%,1
南投縣,埔里鎮,0089,464,303,767,26,793,1415,56.04%,32.79%,1
南投縣,埔里鎮,0090,415,286,701,24,725,1282,56.55%,32.37%,1
南投縣,埔里鎮,0091,313,159,472,40,512,859,59.6%,36.44%,1
南投縣,埔里鎮,0092,423,269,692,56,748,1288,58.07%,32.84%,1
南投縣,埔里鎮,0093,429,307,736,25,761,1330,57.22%,32.26%,1
南投縣,埔里鎮,0094,434,299,733,36,769,1416,54.31%,30.65%,1
南投縣,埔里鎮,0095,390,239,629,23,652,1283,50.82%,30.4%,1
南投縣,埔里鎮,0096,341,316,657,47,704,1151,61.16%,29.63%,1
南投縣,埔里鎮,0097,366,239,605,30,635,1193,53.23%,30.68%,1
南投縣,埔里鎮,0098,473,315,788,64,852,1471,57.92%,32.15%,1
南投縣,埔里鎮,0099,282,187,469,64,533,1044,51.05%,27.01%,1
南投縣,埔里鎮,0100,393,232,625,40,665,1122,59.27%,35.03%,1
南投縣,埔里鎮,0101,482,218,700,29,729,1129,64.57%,42.69%,1
南投縣,埔里鎮,0102,309,186,495,13,508,901,56.38%,34.3%,1
南投縣,埔里鎮,0103,310,190,500,44,544,997,54.56%,31.09%,1
南投縣,埔里鎮,0104,392,253,645,37,682,1209,56.41%,32.42%,1
南投縣,埔里鎮,0105,346,180,526,29,555,838,66.23%,41.29%,1
南投縣,埔里鎮,0106,357,224,581,33,614,1226,50.08%,29.12%,1
南投縣,埔里鎮,0107,454,287,741,53,794,1263,62.87%,35.95%,1
南投縣,埔里鎮,0108,380,241,621,16,637,1045,60.96%,36.36%,1
南投縣,埔里鎮,0109,415,255,670,33,703,1120,62.77%,37.05%,1
南投縣,埔里鎮,0110,398,259,657,36,693,1062,65.25%,37.48%,1
南投縣,埔里鎮,0111,343,220,563,37,600,1022,58.71%,33.56%,1
南投縣,埔里鎮,0112,363,212,575,22,597,1051,56.8%,34.54%,1
南投縣,埔里鎮,0113,354,246,600,25,625,1106,56.51%,32.01%,1
南投縣,埔里鎮,0114,374,225,599,25,624,1098,56.83%,34.06%,1
南投縣,埔里鎮,0115,369,245,614,18,632,1067,59.23%,34.58%,1
南投縣,埔里鎮,0116,180,214,394,35,429,725,59.17%,24.83%,1
南投縣,埔里鎮,0117,295,227,522,26,548,905,60.55%,32.6%,1
南投縣,埔里鎮,0118,373,238,611,30,641,1179,54.37%,31.64%,1
南投縣,埔里鎮,0119,291,186,477,20,497,944,52.65%,30.83%,1
南投縣,埔里鎮,0120,152,86,238,31,269,465,57.85%,32.69%,1
南投縣,埔里鎮,0121,363,235,598,44,642,1133,56.66%,32.04%,1
南投縣,埔里鎮,0122,350,222,572,32,604,1100,54.91%,31.82%,1
南投縣,埔里鎮,0123,417,241,658,39,697,1155,60.35%,36.1%,1
南投縣,埔里鎮,0124,482,141,623,49,672,1254,53.59%,38.44%,1
南投縣,埔里鎮,0125,403,256,659,40,699,1296,53.94%,31.1%,1
南投縣,埔里鎮,0126,399,230,629,35,664,1023,64.91%,39%,1
南投縣,埔里鎮,0127,279,206,485,17,502,964,52.07%,28.94%,1
南投縣,埔里鎮,0128,329,228,557,26,583,986,59.13%,33.37%,1
南投縣,埔里鎮,0129,341,248,589,27,616,1016,60.63%,33.56%,1
南投縣,埔里鎮,0130,311,194,505,32,537,898,59.8%,34.63%,1
南投縣,埔里鎮,0131,317,248,565,30,595,980,60.71%,32.35%,1
南投縣,埔里鎮,0132,330,207,537,31,568,933,60.88%,35.37%,1
南投縣,埔里鎮,0133,349,271,620,33,653,929,70.29%,37.57%,1
南投縣,埔里鎮,0134,340,222,562,31,593,1032,57.46%,32.95%,1
南投縣,埔里鎮,0135,93,54,147,4,151,315,47.94%,29.52%,1
南投縣,埔里鎮,0136,406,275,681,52,733,1363,53.78%,29.79%,1
南投縣,埔里鎮,0137,257,158,415,28,443,725,61.1%,35.45%,1
南投縣,埔里鎮,0138,245,161,406,21,427,705,60.57%,34.75%,1
南投縣,埔里鎮,0139,281,157,438,27,465,751,61.92%,37.42%,1
南投縣,埔里鎮,0140,398,114,512,22,534,932,57.3%,42.7%,1
南投縣,埔里鎮,0141,303,239,542,30,572,956,59.83%,31.69%,1
南投縣,埔里鎮,0142,113,92,205,11,216,376,57.45%,30.05%,1
南投縣,埔里鎮,0143,209,160,369,38,407,682,59.68%,30.65%,1
南投縣,埔里鎮,0144,470,136,606,40,646,990,65.25%,47.47%,1
南投縣,埔里鎮,0145,352,248,600,66,666,1324,50.3%,26.59%,1
南投縣,埔里鎮,0146,70,62,132,16,148,298,49.66%,23.49%,1
南投縣,埔里鎮,0147,354,231,585,72,657,1170,56.15%,30.26%,1
南投縣,埔里鎮,0148,180,163,343,18,361,604,59.77%,29.8%,1
南投縣,埔里鎮,0149,302,214,516,37,553,999,55.36%,30.23%,1
南投縣,埔里鎮,0150,273,186,459,20,479,923,51.9%,29.58%,1
南投縣,埔里鎮,0151,304,201,505,32,537,887,60.54%,34.27%,1
南投縣,埔里鎮,0152,283,231,514,22,536,981,54.64%,28.85%,1
南投縣,草屯鎮,0153,385,225,610,18,628,998,62.93%,38.58%,1
南投縣,草屯鎮,0154,355,249,604,26,630,1127,55.9%,31.5%,1
南投縣,草屯鎮,0155,446,290,736,20,756,1401,53.96%,31.83%,1
南投縣,草屯鎮,0156,357,244,601,30,631,1110,56.85%,32.16%,1
南投縣,草屯鎮,0157,420,306,726,35,761,1285,59.22%,32.68%,1
南投縣,草屯鎮,0158,334,180,514,26,540,936,57.69%,35.68%,1
南投縣,草屯鎮,0159,366,264,630,40,670,1141,58.72%,32.08%,1
南投縣,草屯鎮,0160,270,162,432,12,444,705,62.98%,38.3%,1
南投縣,草屯鎮,0161,457,239,696,17,713,1121,63.6%,40.77%,1
南投縣,草屯鎮,0162,346,213,559,21,580,877,66.13%,39.45%,1
南投縣,草屯鎮,0163,462,307,769,51,820,1401,58.53%,32.98%,1
南投縣,草屯鎮,0164,437,232,669,31,700,1267,55.25%,34.49%,1
南投縣,草屯鎮,0165,393,281,674,47,721,1214,59.39%,32.37%,1
南投縣,草屯鎮,0166,410,298,708,44,752,1259,59.73%,32.57%,1
南投縣,草屯鎮,0167,520,332,852,24,876,1442,60.75%,36.06%,1
南投縣,草屯鎮,0168,458,284,742,24,766,1273,60.17%,35.98%,1
南投縣,草屯鎮,0169,381,252,633,27,660,1145,57.64%,33.28%,1
南投縣,草屯鎮,0170,448,258,706,23,729,1279,57%,35.03%,1
南投縣,草屯鎮,0171,384,235,619,34,653,1158,56.39%,33.16%,1
南投縣,草屯鎮,0172,530,316,846,34,880,1335,65.92%,39.7%,1
南投縣,草屯鎮,0173,461,276,737,31,768,1178,65.2%,39.13%,1
南投縣,草屯鎮,0174,433,327,760,27,787,1327,59.31%,32.63%,1
南投縣,草屯鎮,0175,369,217,586,23,609,1000,60.9%,36.9%,1
南投縣,草屯鎮,0176,431,276,707,34,741,1257,58.95%,34.29%,1
南投縣,草屯鎮,0177,349,206,555,16,571,883,64.67%,39.52%,1
南投縣,草屯鎮,0178,361,236,597,24,621,1121,55.4%,32.2%,1
南投縣,草屯鎮,0179,359,235,594,27,621,1043,59.54%,34.42%,1
南投縣,草屯鎮,0180,379,212,591,12,603,979,61.59%,38.71%,1
南投縣,草屯鎮,0181,303,228,531,22,553,1048,52.77%,28.91%,1
南投縣,草屯鎮,0182,331,229,560,28,588,1009,58.28%,32.8%,1
南投縣,草屯鎮,0183,380,211,591,31,622,1138,54.66%,33.39%,1
南投縣,草屯鎮,0184,386,261,647,24,671,1197,56.06%,32.25%,1
南投縣,草屯鎮,0185,483,289,772,41,813,1364,59.6%,35.41%,1
南投縣,草屯鎮,0186,365,236,601,39,640,1059,60.43%,34.47%,1
南投縣,草屯鎮,0187,344,276,620,41,661,1108,59.66%,31.05%,1
南投縣,草屯鎮,0188,304,180,484,21,505,879,57.45%,34.58%,1
南投縣,草屯鎮,0189,351,180,531,36,567,957,59.25%,36.68%,1
南投縣,草屯鎮,0190,409,250,659,14,673,1395,48.24%,29.32%,1
南投縣,草屯鎮,0191,397,263,660,27,687,1101,62.4%,36.06%,1
南投縣,草屯鎮,0192,375,301,676,24,700,1297,53.97%,28.91%,1
南投縣,草屯鎮,0193,215,172,387,27,414,877,47.21%,24.52%,1
南投縣,草屯鎮,0194,356,323,679,33,712,1376,51.74%,25.87%,1
南投縣,草屯鎮,0195,352,251,603,41,644,1008,63.89%,34.92%,1
南投縣,草屯鎮,0196,367,261,628,40,668,1080,61.85%,33.98%,1
南投縣,草屯鎮,0197,288,234,522,46,568,1017,55.85%,28.32%,1
南投縣,草屯鎮,0198,329,256,585,27,612,961,63.68%,34.24%,1
南投縣,草屯鎮,0199,371,317,688,27,715,1160,61.64%,31.98%,1
南投縣,草屯鎮,0200,374,253,627,33,660,1121,58.88%,33.36%,1
南投縣,草屯鎮,0201,370,319,689,32,721,1243,58%,29.77%,1
南投縣,草屯鎮,0202,319,221,540,25,565,932,60.62%,34.23%,1
南投縣,草屯鎮,0203,485,327,812,48,860,1323,65%,36.66%,1
南投縣,草屯鎮,0204,469,286,755,45,800,1518,52.7%,30.9%,1
南投縣,草屯鎮,0205,324,232,556,26,582,923,63.06%,35.1%,1
南投縣,草屯鎮,0206,310,194,504,36,540,970,55.67%,31.96%,1
南投縣,草屯鎮,0207,345,241,586,27,613,1026,59.75%,33.63%,1
南投縣,草屯鎮,0208,448,335,783,47,830,1466,56.62%,30.56%,1
南投縣,草屯鎮,0209,403,239,642,38,680,1180,57.63%,34.15%,1
南投縣,草屯鎮,0210,385,224,609,16,625,1006,62.13%,38.27%,1
南投縣,草屯鎮,0211,290,189,479,26,505,1000,50.5%,29%,1
南投縣,草屯鎮,0212,386,285,671,20,691,1128,61.26%,34.22%,1
南投縣,草屯鎮,0213,209,134,343,9,352,623,56.5%,33.55%,1
南投縣,草屯鎮,0214,226,166,392,30,422,707,59.69%,31.97%,1
南投縣,草屯鎮,0215,233,148,381,24,405,719,56.33%,32.41%,1
南投縣,草屯鎮,0216,139,100,239,20,259,527,49.15%,26.38%,1
南投縣,草屯鎮,0217,410,247,657,43,700,1183,59.17%,34.66%,1
南投縣,草屯鎮,0218,408,103,511,29,540,869,62.14%,46.95%,1
南投縣,草屯鎮,0219,346,224,570,23,593,1132,52.39%,30.57%,1
南投縣,草屯鎮,0220,310,226,536,36,572,949,60.27%,32.67%,1
南投縣,草屯鎮,0221,322,246,568,19,587,965,60.83%,33.37%,1
南投縣,草屯鎮,0222,335,228,563,30,593,1068,55.52%,31.37%,1
南投縣,草屯鎮,0223,334,236,570,55,625,1024,61.04%,32.62%,1
南投縣,草屯鎮,0224,209,121,330,22,352,642,54.83%,32.55%,1
南投縣,草屯鎮,0225,300,205,505,34,539,1017,53%,29.5%,1
南投縣,草屯鎮,0226,375,230,605,25,630,1092,57.69%,34.34%,1
南投縣,草屯鎮,0227,361,252,613,49,662,1170,56.58%,30.85%,1
南投縣,草屯鎮,0228,349,278,627,43,670,1106,60.58%,31.56%,1
南投縣,竹山鎮,0229,408,247,655,50,705,1170,60.26%,34.87%,1
南投縣,竹山鎮,0230,303,191,494,41,535,850,62.94%,35.65%,1
南投縣,竹山鎮,0231,188,132,320,23,343,621,55.23%,30.27%,1
南投縣,竹山鎮,0232,284,200,484,28,512,905,56.57%,31.38%,1
南投縣,竹山鎮,0233,309,204,513,43,556,1099,50.59%,28.12%,1
南投縣,竹山鎮,0234,363,247,610,42,652,1214,53.71%,29.9%,1
南投縣,竹山鎮,0235,422,314,736,43,779,1287,60.53%,32.79%,1
南投縣,竹山鎮,0236,416,219,635,44,679,1191,57.01%,34.93%,1
南投縣,竹山鎮,0237,367,231,598,40,638,1118,57.07%,32.83%,1
南投縣,竹山鎮,0238,441,168,609,24,633,1278,49.53%,34.51%,1
南投縣,竹山鎮,0239,374,249,623,51,674,1153,58.46%,32.44%,1
南投縣,竹山鎮,0240,352,277,629,40,669,1243,53.82%,28.32%,1
南投縣,竹山鎮,0241,410,283,693,44,737,1308,56.35%,31.35%,1
南投縣,竹山鎮,0242,417,291,708,32,740,1358,54.49%,30.71%,1
南投縣,竹山鎮,0243,337,207,544,32,576,1044,55.17%,32.28%,1
南投縣,竹山鎮,0244,186,105,291,30,321,511,62.82%,36.4%,1
南投縣,竹山鎮,0245,205,161,366,6,372,682,54.55%,30.06%,1
南投縣,竹山鎮,0246,278,210,488,26,514,989,51.97%,28.11%,1
南投縣,竹山鎮,0247,429,302,731,41,772,1378,56.02%,31.13%,1
南投縣,竹山鎮,0248,58,54,112,3,115,217,53%,26.73%,1
南投縣,竹山鎮,0249,136,134,270,18,288,479,60.13%,28.39%,1
南投縣,竹山鎮,0250,122,82,204,10,214,430,49.77%,28.37%,1
南投縣,竹山鎮,0251,443,333,776,35,811,1437,56.44%,30.83%,1
南投縣,竹山鎮,0252,428,312,740,35,775,1286,60.26%,33.28%,1
南投縣,竹山鎮,0253,392,233,625,33,658,1080,60.93%,36.3%,1
南投縣,竹山鎮,0254,327,246,573,26,599,1070,55.98%,30.56%,1
南投縣,竹山鎮,0255,430,285,715,30,745,1295,57.53%,33.2%,1
南投縣,竹山鎮,0256,364,201,565,39,604,1047,57.69%,34.77%,1
南投縣,竹山鎮,0257,417,289,706,0,706,1300,54.31%,32.08%,1
南投縣,竹山鎮,0258,230,181,411,21,432,908,47.58%,25.33%,1
南投縣,竹山鎮,0259,182,193,375,46,421,821,51.28%,22.17%,1
南投縣,竹山鎮,0260,420,314,734,33,767,1320,58.11%,31.82%,1
南投縣,竹山鎮,0261,284,189,473,33,506,967,52.33%,29.37%,1
南投縣,竹山鎮,0262,155,136,291,15,306,595,51.43%,26.05%,1
南投縣,竹山鎮,0263,241,170,411,66,477,859,55.53%,28.06%,1
南投縣,竹山鎮,0264,381,235,616,35,651,1196,54.43%,31.86%,1
南投縣,竹山鎮,0265,199,143,342,29,371,649,57.16%,30.66%,1
南投縣,竹山鎮,0266,394,307,701,55,756,1341,56.38%,29.38%,1
南投縣,竹山鎮,0267,383,219,602,41,643,1222,52.62%,31.34%,1
南投縣,竹山鎮,0268,188,143,331,19,350,602,58.14%,31.23%,1
南投縣,竹山鎮,0269,169,156,325,21,346,617,56.08%,27.39%,1
南投縣,竹山鎮,0270,267,189,456,32,488,793,61.54%,33.67%,1
南投縣,竹山鎮,0271,286,224,510,13,523,922,56.72%,31.02%,1
南投縣,竹山鎮,0272,110,72,182,15,197,366,53.83%,30.05%,1
南投縣,竹山鎮,0273,101,125,226,6,232,509,45.58%,19.84%,1
南投縣,竹山鎮,0274,63,45,108,3,111,193,57.51%,32.64%,1
南投縣,竹山鎮,0275,116,123,239,13,252,406,62.07%,28.57%,1
南投縣,竹山鎮,0276,134,102,236,16,252,495,50.91%,27.07%,1
南投縣,竹山鎮,0277,66,38,104,12,116,307,37.79%,21.5%,1
南投縣,竹山鎮,0278,124,80,204,32,236,440,53.64%,28.18%,1
南投縣,竹山鎮,0279,165,122,287,27,314,577,54.42%,28.6%,1
南投縣,竹山鎮,0280,104,87,191,24,215,486,44.24%,21.4%,1
南投縣,竹山鎮,0281,77,60,137,14,151,403,37.47%,19.11%,1
南投縣,集集鎮,0282,355,266,621,30,651,1070,60.84%,33.18%,1
南投縣,集集鎮,0283,318,207,525,33,558,918,60.78%,34.64%,1
南投縣,集集鎮,0284,196,128,324,28,352,581,60.59%,33.73%,1
南投縣,集集鎮,0285,408,274,682,38,720,1194,60.3%,34.17%,1
南投縣,集集鎮,0286,120,90,210,15,225,488,46.11%,24.59%,1
南投縣,集集鎮,0287,167,123,290,25,315,504,62.5%,33.13%,1
南投縣,集集鎮,0288,300,179,479,84,563,910,61.87%,32.97%,1
南投縣,集集鎮,0289,178,272,450,36,486,773,62.87%,23.03%,1
南投縣,集集鎮,0290,225,164,389,13,402,709,56.7%,31.73%,1
南投縣,集集鎮,0291,313,216,529,27,556,960,57.92%,32.6%,1
南投縣,集集鎮,0292,151,107,258,17,275,503,54.67%,30.02%,1
南投縣,集集鎮,0293,103,88,191,21,212,419,50.6%,24.58%,1
南投縣,集集鎮,0294,156,99,255,20,275,582,47.25%,26.8%,1
南投縣,名間鄉,0295,388,310,698,34,732,1050,69.71%,36.95%,1
南投縣,名間鄉,0296,323,189,512,49,561,920,60.98%,35.11%,1
南投縣,名間鄉,0297,254,198,452,23,475,727,65.34%,34.94%,1
南投縣,名間鄉,0298,327,202,529,25,554,861,64.34%,37.98%,1
南投縣,名間鄉,0299,319,182,501,24,525,897,58.53%,35.56%,1
南投縣,名間鄉,0300,369,250,619,30,649,1055,61.52%,34.98%,1
南投縣,名間鄉,0301,402,246,648,49,697,1184,58.87%,33.95%,1
南投縣,名間鄉,0302,250,156,406,40,446,783,56.96%,31.93%,1
南投縣,名間鄉,0303,292,168,460,28,488,781,62.48%,37.39%,1
南投縣,名間鄉,0304,326,197,523,36,559,977,57.22%,33.37%,1
南投縣,名間鄉,0305,337,208,545,30,575,1015,56.65%,33.2%,1
南投縣,名間鄉,0306,321,222,543,21,564,914,61.71%,35.12%,1
南投縣,名間鄉,0307,358,210,568,26,594,1028,57.78%,34.82%,1
南投縣,名間鄉,0308,343,235,578,39,617,1018,60.61%,33.69%,1
南投縣,名間鄉,0309,420,295,715,45,760,1274,59.65%,32.97%,1
南投縣,名間鄉,0310,242,175,417,37,454,755,60.13%,32.05%,1
南投縣,名間鄉,0311,313,228,541,51,592,895,66.15%,34.97%,1
南投縣,名間鄉,0312,450,55,505,25,530,892,59.42%,50.45%,1
南投縣,名間鄉,0313,294,214,508,44,552,951,58.04%,30.91%,1
南投縣,名間鄉,0314,410,273,683,43,726,1261,57.57%,32.51%,1
南投縣,名間鄉,0315,242,170,412,31,443,768,57.68%,31.51%,1
南投縣,名間鄉,0316,318,227,545,41,586,962,60.91%,33.06%,1
南投縣,名間鄉,0317,288,197,485,50,535,867,61.71%,33.22%,1
南投縣,名間鄉,0318,318,192,510,56,566,930,60.86%,34.19%,1
南投縣,名間鄉,0319,206,141,347,42,389,641,60.69%,32.14%,1
南投縣,名間鄉,0320,152,114,266,19,285,530,53.77%,28.68%,1
南投縣,名間鄉,0321,307,199,506,52,558,931,59.94%,32.98%,1
南投縣,名間鄉,0322,346,263,609,43,652,1127,57.85%,30.7%,1
南投縣,名間鄉,0323,160,116,276,20,296,443,66.82%,36.12%,1
南投縣,名間鄉,0324,321,177,498,36,534,870,61.38%,36.9%,1
南投縣,名間鄉,0325,209,152,361,32,393,621,63.29%,33.66%,1
南投縣,名間鄉,0326,392,213,605,39,644,1179,54.62%,33.25%,1
南投縣,名間鄉,0327,335,179,514,49,563,881,63.9%,38.02%,1
南投縣,名間鄉,0328,364,189,553,43,596,876,68.04%,41.55%,1
南投縣,名間鄉,0329,273,167,440,36,476,783,60.79%,34.87%,1
南投縣,名間鄉,0330,243,152,395,30,425,778,54.63%,31.23%,1
南投縣,名間鄉,0331,306,196,502,36,538,983,54.73%,31.13%,1
南投縣,鹿谷鄉,0332,293,155,448,38,486,934,52.03%,31.37%,1
南投縣,鹿谷鄉,0333,284,219,503,36,539,940,57.34%,30.21%,1
南投縣,鹿谷鄉,0334,224,200,424,34,458,852,53.76%,26.29%,1
南投縣,鹿谷鄉,0335,114,85,199,16,215,451,47.67%,25.28%,1
南投縣,鹿谷鄉,0336,276,194,470,26,496,810,61.23%,34.07%,1
南投縣,鹿谷鄉,0337,398,263,661,52,713,1142,62.43%,34.85%,1
南投縣,鹿谷鄉,0338,200,159,359,19,378,766,49.35%,26.11%,1
南投縣,鹿谷鄉,0339,280,197,477,41,518,884,58.6%,31.67%,1
南投縣,鹿谷鄉,0340,217,200,417,43,460,811,56.72%,26.76%,1
南投縣,鹿谷鄉,0341,134,124,258,19,277,581,47.68%,23.06%,1
南投縣,鹿谷鄉,0342,160,112,272,23,295,578,51.04%,27.68%,1
南投縣,鹿谷鄉,0343,148,116,264,15,279,467,59.74%,31.69%,1
南投縣,鹿谷鄉,0344,213,105,318,28,346,622,55.63%,34.24%,1
南投縣,鹿谷鄉,0345,205,153,358,26,384,740,51.89%,27.7%,1
南投縣,鹿谷鄉,0346,241,158,399,34,433,767,56.45%,31.42%,1
南投縣,鹿谷鄉,0347,279,215,494,38,532,909,58.53%,30.69%,1
南投縣,鹿谷鄉,0348,213,142,355,21,376,713,52.73%,29.87%,1
南投縣,鹿谷鄉,0349,173,135,308,28,336,717,46.86%,24.13%,1
南投縣,鹿谷鄉,0350,222,149,371,35,406,794,51.13%,27.96%,1
南投縣,鹿谷鄉,0351,221,135,356,15,371,726,51.1%,30.44%,1
南投縣,鹿谷鄉,0352,162,132,294,29,323,737,43.83%,21.98%,1
南投縣,中寮鄉,0353,278,183,461,44,505,822,61.44%,33.82%,1
南投縣,中寮鄉,0354,98,46,144,11,155,253,61.26%,38.74%,1
南投縣,中寮鄉,0355,50,37,87,7,94,221,42.53%,22.62%,1
南投縣,中寮鄉,0356,97,56,153,5,158,353,44.76%,27.48%,1
南投縣,中寮鄉,0357,106,115,221,16,237,427,55.5%,24.82%,1
南投縣,中寮鄉,0358,120,86,206,24,230,406,56.65%,29.56%,1
南投縣,中寮鄉,0359,84,67,151,11,162,307,52.77%,27.36%,1
南投縣,中寮鄉,0360,218,157,375,29,404,661,61.12%,32.98%,1
南投縣,中寮鄉,0361,102,73,175,19,194,290,66.9%,35.17%,1
南投縣,中寮鄉,0362,297,243,540,31,571,973,58.68%,30.52%,1
南投縣,中寮鄉,0363,273,161,434,24,458,754,60.74%,36.21%,1
南投縣,中寮鄉,0364,197,156,353,16,369,662,55.74%,29.76%,1
南投縣,中寮鄉,0365,150,86,236,17,253,490,51.63%,30.61%,1
南投縣,中寮鄉,0366,101,66,167,9,176,335,52.54%,30.15%,1
南投縣,中寮鄉,0367,329,207,536,40,576,990,58.18%,33.23%,1
南投縣,中寮鄉,0368,167,110,277,21,298,461,64.64%,36.23%,1
南投縣,中寮鄉,0369,211,148,359,22,381,614,62.05%,34.36%,1
南投縣,中寮鄉,0370,255,201,456,58,514,895,57.43%,28.49%,1
南投縣,中寮鄉,0371,170,84,254,12,266,465,57.2%,36.56%,1
南投縣,中寮鄉,0372,192,163,355,50,405,682,59.38%,28.15%,1
南投縣,中寮鄉,0373,160,109,269,34,303,490,61.84%,32.65%,1
南投縣,中寮鄉,0374,219,150,369,27,396,643,61.59%,34.06%,1
南投縣,中寮鄉,0375,172,98,270,15,285,459,62.09%,37.47%,1
南投縣,中寮鄉,0376,151,100,251,17,268,528,50.76%,28.6%,1
南投縣,魚池鄉,0377,275,220,495,37,532,922,57.7%,29.83%,1
南投縣,魚池鄉,0378,343,252,595,56,651,1098,59.29%,31.24%,1
南投縣,魚池鄉,0379,174,186,360,27,387,720,53.75%,24.17%,1
南投縣,魚池鄉,0380,264,206,470,38,508,860,59.07%,30.7%,1
南投縣,魚池鄉,0381,137,96,233,30,263,514,51.17%,26.65%,1
南投縣,魚池鄉,0382,154,121,275,16,291,574,50.7%,26.83%,1
南投縣,魚池鄉,0383,369,253,622,54,676,1249,54.12%,29.54%,1
南投縣,魚池鄉,0384,88,96,184,10,194,293,66.21%,30.03%,1
南投縣,魚池鄉,0385,125,127,252,26,278,513,54.19%,24.37%,1
南投縣,魚池鄉,0386,60,37,97,6,103,186,55.38%,32.26%,1
南投縣,魚池鄉,0387,220,192,412,33,445,841,52.91%,26.16%,1
南投縣,魚池鄉,0388,81,58,139,31,170,270,62.96%,30%,1
南投縣,魚池鄉,0389,72,61,133,21,154,275,56%,26.18%,1
南投縣,魚池鄉,0390,73,50,123,8,131,282,46.45%,25.89%,1
南投縣,魚池鄉,0391,111,66,177,19,196,392,50%,28.32%,1
南投縣,魚池鄉,0392,158,118,276,29,305,556,54.86%,28.42%,1
南投縣,魚池鄉,0393,58,35,93,4,97,176,55.11%,32.95%,1
南投縣,魚池鄉,0394,138,121,259,17,276,578,47.75%,23.88%,1
南投縣,魚池鄉,0395,118,89,207,17,224,439,51.03%,26.88%,1
南投縣,魚池鄉,0396,311,160,471,26,497,844,58.89%,36.85%,1
南投縣,魚池鄉,0397,255,201,456,32,488,868,56.22%,29.38%,1
南投縣,魚池鄉,0398,110,70,180,10,190,405,46.91%,27.16%,1
南投縣,魚池鄉,0399,178,106,284,22,306,537,56.98%,33.15%,1
南投縣,魚池鄉,0400,99,72,171,13,184,335,54.93%,29.55%,1
南投縣,魚池鄉,0401,48,38,86,18,104,231,45.02%,20.78%,1
南投縣,國姓鄉,0402,333,224,557,44,601,964,62.34%,34.54%,1
南投縣,國姓鄉,0403,241,158,399,16,415,736,56.39%,32.74%,1
南投縣,國姓鄉,0404,253,188,441,35,476,801,59.43%,31.59%,1
南投縣,國姓鄉,0405,315,220,535,13,548,964,56.85%,32.68%,1
南投縣,國姓鄉,0406,209,142,351,37,388,686,56.56%,30.47%,1
南投縣,國姓鄉,0407,201,130,331,31,362,661,54.77%,30.41%,1
南投縣,國姓鄉,0408,203,149,352,30,382,730,52.33%,27.81%,1
南投縣,國姓鄉,0409,225,181,406,30,436,774,56.33%,29.07%,1
南投縣,國姓鄉,0410,204,202,406,13,419,706,59.35%,28.9%,1
南投縣,國姓鄉,0411,349,178,527,48,575,1012,56.82%,34.49%,1
南投縣,國姓鄉,0412,230,163,393,19,412,868,47.47%,26.5%,1
南投縣,國姓鄉,0413,345,187,532,25,557,918,60.68%,37.58%,1
南投縣,國姓鄉,0414,313,173,486,53,539,937,57.52%,33.4%,1
南投縣,國姓鄉,0415,242,173,415,36,451,815,55.34%,29.69%,1
南投縣,國姓鄉,0416,391,245,636,50,686,1134,60.49%,34.48%,1
南投縣,國姓鄉,0417,207,151,358,28,386,714,54.06%,28.99%,1
南投縣,國姓鄉,0418,366,187,553,42,595,1095,54.34%,33.42%,1
南投縣,國姓鄉,0419,134,83,217,20,237,448,52.9%,29.91%,1
南投縣,國姓鄉,0420,317,194,511,62,573,1064,53.85%,29.79%,1
南投縣,國姓鄉,0421,164,109,273,25,298,570,52.28%,28.77%,1
南投縣,水里鄉,0422,242,151,393,30,423,757,55.88%,31.97%,1
南投縣,水里鄉,0423,154,132,286,27,313,554,56.5%,27.8%,1
南投縣,水里鄉,0424,308,238,546,33,579,999,57.96%,30.83%,1
南投縣,水里鄉,0425,212,108,320,19,339,616,55.03%,34.42%,1
南投縣,水里鄉,0426,337,165,502,29,531,875,60.69%,38.51%,1
南投縣,水里鄉,0427,172,108,280,12,292,480,60.83%,35.83%,1
南投縣,水里鄉,0428,156,72,228,20,248,450,55.11%,34.67%,1
南投縣,水里鄉,0429,170,151,321,35,356,643,55.37%,26.44%,1
南投縣,水里鄉,0430,356,208,564,26,590,1004,58.76%,35.46%,1
南投縣,水里鄉,0431,231,147,378,29,407,741,54.93%,31.17%,1
南投縣,水里鄉,0432,269,187,456,15,471,802,58.73%,33.54%,1
南投縣,水里鄉,0433,365,237,602,38,640,998,64.13%,36.57%,1
南投縣,水里鄉,0434,220,181,401,42,443,800,55.38%,27.5%,1
南投縣,水里鄉,0435,184,167,351,17,368,589,62.48%,31.24%,1
南投縣,水里鄉,0436,264,161,425,46,471,887,53.1%,29.76%,1
南投縣,水里鄉,0437,339,257,596,40,636,1217,52.26%,27.86%,1
南投縣,水里鄉,0438,51,26,77,2,79,205,38.54%,24.88%,1
南投縣,水里鄉,0439,132,56,188,21,209,330,63.33%,40%,1
南投縣,水里鄉,0440,314,234,548,35,583,1100,53%,28.55%,1
南投縣,水里鄉,0441,70,29,99,4,103,275,37.45%,25.45%,1
南投縣,水里鄉,0442,80,55,135,1,136,318,42.77%,25.16%,1
南投縣,水里鄉,0443,254,162,416,36,452,818,55.26%,31.05%,1
南投縣,信義鄉,0444,445,195,640,40,680,1201,56.62%,37.05%,1
南投縣,信義鄉,0445,119,45,164,13,177,329,53.8%,36.17%,1
南投縣,信義鄉,0446,157,102,259,15,274,516,53.1%,30.43%,1
南投縣,信義鄉,0447,107,75,182,18,200,424,47.17%,25.24%,1
南投縣,信義鄉,0448,103,61,164,6,170,321,52.96%,32.09%,1
南投縣,信義鄉,0449,286,113,399,31,430,648,66.36%,44.14%,1
南投縣,信義鄉,0450,311,97,408,32,440,584,75.34%,53.25%,1
南投縣,信義鄉,0451,707,173,880,26,906,1376,65.84%,51.38%,1
南投縣,信義鄉,0452,455,154,609,27,636,979,64.96%,46.48%,1
南投縣,信義鄉,0453,256,114,370,30,400,530,75.47%,48.3%,1
南投縣,信義鄉,0454,319,174,493,23,516,961,53.69%,33.19%,1
南投縣,信義鄉,0455,155,90,245,12,257,464,55.39%,33.41%,1
南投縣,信義鄉,0456,163,118,281,27,308,517,59.57%,31.53%,1
南投縣,信義鄉,0457,50,34,84,5,89,149,59.73%,33.56%,1
南投縣,信義鄉,0458,578,159,737,27,764,1020,74.9%,56.67%,1
南投縣,信義鄉,0459,436,144,580,61,641,929,69%,46.93%,1
南投縣,信義鄉,0460,75,45,120,10,130,274,47.45%,27.37%,1
南投縣,信義鄉,0461,445,154,599,36,635,900,70.56%,49.44%,1
南投縣,信義鄉,0462,266,146,412,39,451,617,73.1%,43.11%,1
南投縣,信義鄉,0463,222,144,366,26,392,560,70%,39.64%,1
南投縣,仁愛鄉,0464,436,121,557,23,580,973,59.61%,44.81%,1
南投縣,仁愛鄉,0465,90,52,142,8,150,296,50.68%,30.41%,1
南投縣,仁愛鄉,0466,243,186,429,17,446,900,49.56%,27%,1
南投縣,仁愛鄉,0467,152,123,275,23,298,460,64.78%,33.04%,1
南投縣,仁愛鄉,0468,100,70,170,13,183,305,60%,32.79%,1
南投縣,仁愛鄉,0469,15,3,18,2,20,58,34.48%,25.86%,1
南投縣,仁愛鄉,0470,310,149,459,17,476,952,50%,32.56%,1
南投縣,仁愛鄉,0471,212,100,312,14,326,679,48.01%,31.22%,1
南投縣,仁愛鄉,0472,235,106,341,28,369,623,59.23%,37.72%,1
南投縣,仁愛鄉,0473,99,227,326,12,338,597,56.62%,16.58%,1
南投縣,仁愛鄉,0474,146,85,231,17,248,384,64.58%,38.02%,1
南投縣,仁愛鄉,0475,42,19,61,1,62,121,51.24%,34.71%,1
南投縣,仁愛鄉,0476,121,43,164,5,169,264,64.02%,45.83%,1
南投縣,仁愛鄉,0477,239,136,375,16,391,509,76.82%,46.95%,1
南投縣,仁愛鄉,0478,119,67,186,21,207,338,61.24%,35.21%,1
南投縣,仁愛鄉,0479,41,34,75,4,79,169,46.75%,24.26%,1
南投縣,仁愛鄉,0480,171,105,276,17,293,613,47.8%,27.9%,1
南投縣,仁愛鄉,0481,104,77,181,9,190,404,47.03%,25.74%,1
南投縣,仁愛鄉,0482,47,26,73,4,77,134,57.46%,35.07%,1
南投縣,仁愛鄉,0483,235,156,391,22,413,630,65.56%,37.3%,1
南投縣,仁愛鄉,0484,206,150,356,15,371,763,48.62%,27%,1
南投縣,仁愛鄉,0485,388,151,539,35,574,889,64.57%,43.64%,1
南投縣,仁愛鄉,0486,261,141,402,37,439,672,65.33%,38.84%,1
南投縣,仁愛鄉,0487,163,96,259,13,272,447,60.85%,36.47%,1
南投縣,仁愛鄉,0488,200,80,280,24,304,409,74.33%,48.9%,1
雲林縣,斗六市,0411,192,149,341,16,357,644,55.43%,29.81%,1
雲林縣,斗六市,0412,199,136,335,17,352,617,57.05%,32.25%,1
雲林縣,斗六市,0413,277,188,465,39,504,764,65.97%,36.26%,1
雲林縣,斗六市,0414,283,187,470,22,492,784,62.76%,36.1%,1
雲林縣,斗六市,0415,262,163,425,22,447,760,58.82%,34.47%,1
雲林縣,斗六市,0416,632,449,1081,58,1139,1881,60.55%,33.6%,1
雲林縣,斗六市,0417,604,352,956,49,1005,1829,54.95%,33.02%,1
雲林縣,斗六市,0418,488,282,770,26,796,1255,63.43%,38.88%,1
雲林縣,斗六市,0419,445,231,676,27,703,1090,64.5%,40.83%,1
雲林縣,斗六市,0420,396,240,636,39,675,1103,61.2%,35.9%,1
雲林縣,斗六市,0421,417,260,677,41,718,1176,61.05%,35.46%,1
雲林縣,斗六市,0422,527,317,844,25,869,1529,56.83%,34.47%,1
雲林縣,斗六市,0423,474,284,758,42,800,1335,59.93%,35.51%,1
雲林縣,斗六市,0424,602,396,998,42,1040,1770,58.76%,34.01%,1
雲林縣,斗六市,0425,418,306,724,20,744,1308,56.88%,31.96%,1
雲林縣,斗六市,0426,692,430,1122,45,1167,2171,53.75%,31.87%,1
雲林縣,斗六市,0427,405,276,681,28,709,1193,59.43%,33.95%,1
雲林縣,斗六市,0428,617,330,947,29,976,1572,62.09%,39.25%,1
雲林縣,斗六市,0429,363,200,563,17,580,1009,57.48%,35.98%,1
雲林縣,斗六市,0430,421,302,723,32,755,1195,63.18%,35.23%,1
雲林縣,斗六市,0431,531,300,831,46,877,1415,61.98%,37.53%,1
雲林縣,斗六市,0432,387,257,644,32,676,1101,61.4%,35.15%,1
雲林縣,斗六市,0433,569,350,919,22,941,1648,57.1%,34.53%,1
雲林縣,斗六市,0434,514,296,810,22,832,1588,52.39%,32.37%,1
雲林縣,斗六市,0435,478,319,797,30,827,1392,59.41%,34.34%,1
雲林縣,斗六市,0436,467,334,801,30,831,1422,58.44%,32.84%,1
雲林縣,斗六市,0437,346,202,548,32,580,1187,48.86%,29.15%,1
雲林縣,斗六市,0438,333,233,566,32,598,1142,52.36%,29.16%,1
雲林縣,斗六市,0439,504,342,846,33,879,1421,61.86%,35.47%,1
雲林縣,斗六市,0440,431,271,702,26,728,1261,57.73%,34.18%,1
雲林縣,斗六市,0441,469,328,797,30,827,1506,54.91%,31.14%,1
雲林縣,斗六市,0442,413,285,698,35,733,1214,60.38%,34.02%,1
雲林縣,斗六市,0443,500,319,819,47,866,1362,63.58%,36.71%,1
雲林縣,斗六市,0444,353,238,591,25,616,1097,56.15%,32.18%,1
雲林縣,斗六市,0445,462,246,708,32,740,1262,58.64%,36.61%,1
雲林縣,斗六市,0446,361,247,608,25,633,1154,54.85%,31.28%,1
雲林縣,斗六市,0447,298,184,482,26,508,847,59.98%,35.18%,1
雲林縣,斗六市,0448,475,337,812,21,833,1439,57.89%,33.01%,1
雲林縣,斗六市,0449,610,412,1022,51,1073,1747,61.42%,34.92%,1
雲林縣,斗六市,0450,473,320,793,27,820,1418,57.83%,33.36%,1
雲林縣,斗六市,0451,373,233,606,32,638,1112,57.37%,33.54%,1
雲林縣,斗六市,0452,431,298,729,29,758,1302,58.22%,33.1%,1
雲林縣,斗六市,0453,255,168,423,17,440,669,65.77%,38.12%,1
雲林縣,斗六市,0454,235,171,406,29,435,752,57.85%,31.25%,1
雲林縣,斗六市,0455,471,305,776,26,802,1450,55.31%,32.48%,1
雲林縣,斗六市,0456,189,105,294,29,323,555,58.2%,34.05%,1
雲林縣,斗六市,0457,461,283,744,28,772,1470,52.52%,31.36%,1
雲林縣,斗六市,0458,346,199,545,16,561,927,60.52%,37.32%,1
雲林縣,斗六市,0459,631,438,1069,34,1103,1893,58.27%,33.33%,1
雲林縣,斗六市,0460,556,367,923,63,986,1708,57.73%,32.55%,1
雲林縣,斗六市,0461,501,333,834,51,885,1773,49.92%,28.26%,1
雲林縣,斗六市,0462,516,288,804,34,838,1412,59.35%,36.54%,1
雲林縣,斗六市,0463,479,329,808,41,849,1354,62.7%,35.38%,1
雲林縣,斗六市,0464,431,274,705,19,724,1267,57.14%,34.02%,1
雲林縣,斗六市,0465,395,286,681,20,701,1273,55.07%,31.03%,1
雲林縣,斗六市,0466,528,334,862,49,911,1748,52.12%,30.21%,1
雲林縣,斗六市,0467,412,257,669,61,730,1238,58.97%,33.28%,1
雲林縣,斗六市,0468,517,320,837,47,884,1648,53.64%,31.37%,1
雲林縣,斗六市,0469,509,375,884,35,919,1520,60.46%,33.49%,1
雲林縣,斗六市,0470,345,225,570,29,599,1087,55.11%,31.74%,1
雲林縣,斗六市,0471,594,443,1037,52,1089,1904,57.2%,31.2%,1
雲林縣,斗六市,0472,236,165,401,36,437,702,62.25%,33.62%,1
雲林縣,斗六市,0473,395,241,636,40,676,1111,60.85%,35.55%,1
雲林縣,斗六市,0474,309,227,536,37,573,1123,51.02%,27.52%,1
雲林縣,斗六市,0475,329,255,584,44,628,1146,54.8%,28.71%,1
雲林縣,斗六市,0476,524,404,928,35,963,1786,53.92%,29.34%,1
雲林縣,斗六市,0477,324,232,556,38,594,1023,58.06%,31.67%,1
雲林縣,斗六市,0478,644,444,1088,61,1149,2072,55.45%,31.08%,1
雲林縣,斗六市,0479,352,246,598,17,615,1128,54.52%,31.21%,1
雲林縣,斗南鎮,0498,413,271,684,30,714,1166,61.23%,35.42%,1
雲林縣,斗南鎮,0499,439,254,693,25,718,1135,63.26%,38.68%,1
雲林縣,斗南鎮,0500,360,222,582,23,605,975,62.05%,36.92%,1
雲林縣,斗南鎮,0501,509,336,845,31,876,1459,60.04%,34.89%,1
雲林縣,斗南鎮,0502,436,319,755,40,795,1351,58.85%,32.27%,1
雲林縣,斗南鎮,0503,428,283,711,37,748,1321,56.62%,32.4%,1
雲林縣,斗南鎮,0504,294,181,475,25,500,907,55.13%,32.41%,1
雲林縣,斗南鎮,0505,527,350,877,52,929,1473,63.07%,35.78%,1
雲林縣,斗南鎮,0506,462,313,775,28,803,1277,62.88%,36.18%,1
雲林縣,斗南鎮,0507,413,297,710,47,757,1333,56.79%,30.98%,1
雲林縣,斗南鎮,0508,254,153,407,25,432,777,55.6%,32.69%,1
雲林縣,斗南鎮,0509,269,187,456,28,484,877,55.19%,30.67%,1
雲林縣,斗南鎮,0510,267,184,451,40,491,899,54.62%,29.7%,1
雲林縣,斗南鎮,0511,205,106,311,23,334,688,48.55%,29.8%,1
雲林縣,斗南鎮,0512,382,199,581,27,608,1147,53.01%,33.3%,1
雲林縣,斗南鎮,0513,538,402,940,60,1000,1709,58.51%,31.48%,1
雲林縣,斗南鎮,0514,391,219,610,31,641,1042,61.52%,37.52%,1
雲林縣,斗南鎮,0515,511,353,864,39,903,1631,55.36%,31.33%,1
雲林縣,斗南鎮,0516,587,391,978,63,1041,1702,61.16%,34.49%,1
雲林縣,斗南鎮,0517,535,344,879,48,927,1564,59.27%,34.21%,1
雲林縣,斗南鎮,0518,257,159,416,20,436,910,47.91%,28.24%,1
雲林縣,斗南鎮,0519,456,288,744,45,789,1276,61.83%,35.74%,1
雲林縣,斗南鎮,0520,268,170,438,8,446,897,49.72%,29.88%,1
雲林縣,斗南鎮,0521,262,162,424,27,451,803,56.16%,32.63%,1
雲林縣,斗南鎮,0522,286,181,467,39,506,866,58.43%,33.03%,1
雲林縣,斗南鎮,0523,257,206,463,40,503,852,59.04%,30.16%,1
雲林縣,斗南鎮,0524,208,150,358,28,386,671,57.53%,31%,1
雲林縣,斗南鎮,0525,315,197,512,26,538,981,54.84%,32.11%,1
雲林縣,斗南鎮,0526,310,218,528,16,544,1129,48.18%,27.46%,1
雲林縣,斗南鎮,0527,540,340,880,61,941,1586,59.33%,34.05%,1
雲林縣,斗南鎮,0528,446,274,720,48,768,1243,61.79%,35.88%,1
雲林縣,斗南鎮,0529,313,176,489,25,514,984,52.24%,31.81%,1
雲林縣,斗南鎮,0530,551,295,846,46,892,1507,59.19%,36.56%,1
雲林縣,虎尾鎮,0109,415,294,709,35,744,1347,55.23%,30.81%,1
雲林縣,虎尾鎮,0110,434,274,708,34,742,1258,58.98%,34.5%,1
雲林縣,虎尾鎮,0111,258,163,421,27,448,785,57.07%,32.87%,1
雲林縣,虎尾鎮,0112,257,144,401,37,438,890,49.21%,28.88%,1
雲林縣,虎尾鎮,0113,501,301,802,49,851,1413,60.23%,35.46%,1
雲林縣,虎尾鎮,0114,498,334,832,39,871,1431,60.87%,34.8%,1
雲林縣,虎尾鎮,0115,371,250,621,39,660,1224,53.92%,30.31%,1
雲林縣,虎尾鎮,0116,380,254,634,27,661,1325,49.89%,28.68%,1
雲林縣,虎尾鎮,0117,279,246,525,48,573,941,60.89%,29.65%,1
雲林縣,虎尾鎮,0118,526,337,863,23,886,1613,54.93%,32.61%,1
雲林縣,虎尾鎮,0119,493,345,838,34,872,1641,53.14%,30.04%,1
雲林縣,虎尾鎮,0120,418,271,689,25,714,1200,59.5%,34.83%,1
雲林縣,虎尾鎮,0121,434,279,713,47,760,1294,58.73%,33.54%,1
雲林縣,虎尾鎮,0122,427,280,707,21,728,1273,57.19%,33.54%,1
雲林縣,虎尾鎮,0123,505,348,853,33,886,1438,61.61%,35.12%,1
雲林縣,虎尾鎮,0124,474,287,761,28,789,1361,57.97%,34.83%,1
雲林縣,虎尾鎮,0125,522,311,833,38,871,1444,60.32%,36.15%,1
雲林縣,虎尾鎮,0126,528,378,906,32,938,1490,62.95%,35.44%,1
雲林縣,虎尾鎮,0127,464,332,796,39,835,1307,63.89%,35.5%,1
雲林縣,虎尾鎮,0128,254,219,473,18,491,967,50.78%,26.27%,1
雲林縣,虎尾鎮,0129,594,361,955,29,984,1865,52.76%,31.85%,1
雲林縣,虎尾鎮,0130,613,399,1012,35,1047,1880,55.69%,32.61%,1
雲林縣,虎尾鎮,0131,322,238,560,25,585,1099,53.23%,29.3%,1
雲林縣,虎尾鎮,0132,320,176,496,21,517,901,57.38%,35.52%,1
雲林縣,虎尾鎮,0133,329,253,582,30,612,1120,54.64%,29.38%,1
雲林縣,虎尾鎮,0134,112,112,224,12,236,545,43.3%,20.55%,1
雲林縣,虎尾鎮,0135,422,306,728,45,773,1420,54.44%,29.72%,1
雲林縣,虎尾鎮,0136,357,259,616,25,641,1248,51.36%,28.61%,1
雲林縣,虎尾鎮,0137,261,154,415,23,438,799,54.82%,32.67%,1
雲林縣,虎尾鎮,0138,229,173,402,45,447,836,53.47%,27.39%,1
雲林縣,虎尾鎮,0139,237,178,415,36,451,924,48.81%,25.65%,1
雲林縣,虎尾鎮,0140,431,277,708,22,730,1648,44.3%,26.15%,1
雲林縣,虎尾鎮,0141,401,297,698,80,778,1616,48.14%,24.81%,1
雲林縣,虎尾鎮,0142,435,303,738,46,784,1546,50.71%,28.14%,1
雲林縣,虎尾鎮,0143,372,269,641,29,670,1283,52.22%,28.99%,1
雲林縣,虎尾鎮,0144,316,228,544,25,569,1078,52.78%,29.31%,1
雲林縣,虎尾鎮,0145,359,256,615,40,655,1313,49.89%,27.34%,1
雲林縣,虎尾鎮,0146,327,274,601,31,632,1284,49.22%,25.47%,1
雲林縣,虎尾鎮,0147,385,282,667,61,728,1356,53.69%,28.39%,1
雲林縣,虎尾鎮,0148,461,313,774,48,822,1504,54.65%,30.65%,1
雲林縣,虎尾鎮,0149,297,231,528,29,557,1224,45.51%,24.26%,1
雲林縣,虎尾鎮,0150,403,257,660,51,711,1509,47.12%,26.71%,1
雲林縣,虎尾鎮,0151,151,160,311,55,366,855,42.81%,17.66%,1
雲林縣,虎尾鎮,0152,367,285,652,69,721,1549,46.55%,23.69%,1
雲林縣,虎尾鎮,0153,231,163,394,20,414,851,48.65%,27.14%,1
雲林縣,虎尾鎮,0154,342,244,586,53,639,1272,50.24%,26.89%,1
雲林縣,西螺鎮,0340,452,335,787,58,845,1590,53.14%,28.43%,1
雲林縣,西螺鎮,0341,517,381,898,61,959,1741,55.08%,29.7%,1
雲林縣,西螺鎮,0342,398,262,660,37,697,1080,64.54%,36.85%,1
雲林縣,西螺鎮,0343,392,228,620,53,673,1040,64.71%,37.69%,1
雲林縣,西螺鎮,0344,469,286,755,35,790,1346,58.69%,34.84%,1
雲林縣,西螺鎮,0345,550,296,846,49,895,1625,55.08%,33.85%,1
雲林縣,西螺鎮,0346,139,78,217,18,235,354,66.38%,39.27%,1
雲林縣,西螺鎮,0347,196,108,304,18,322,580,55.52%,33.79%,1
雲林縣,西螺鎮,0348,211,149,360,14,374,591,63.28%,35.7%,1
雲林縣,西螺鎮,0349,343,245,588,32,620,1050,59.05%,32.67%,1
雲林縣,西螺鎮,0350,400,265,665,42,707,1147,61.64%,34.87%,1
雲林縣,西螺鎮,0351,461,353,814,49,863,1602,53.87%,28.78%,1
雲林縣,西螺鎮,0352,434,312,746,33,779,1452,53.65%,29.89%,1
雲林縣,西螺鎮,0353,481,357,838,49,887,1578,56.21%,30.48%,1
雲林縣,西螺鎮,0354,403,236,639,33,672,1305,51.49%,30.88%,1
雲林縣,西螺鎮,0355,353,253,606,34,640,1327,48.23%,26.6%,1
雲林縣,西螺鎮,0356,419,339,758,46,804,1516,53.03%,27.64%,1
雲林縣,西螺鎮,0357,200,154,354,17,371,828,44.81%,24.15%,1
雲林縣,西螺鎮,0358,201,117,318,18,336,788,42.64%,25.51%,1
雲林縣,西螺鎮,0359,240,176,416,45,461,863,53.42%,27.81%,1
雲林縣,西螺鎮,0360,272,175,447,76,523,984,53.15%,27.64%,1
雲林縣,西螺鎮,0361,466,293,759,66,825,1514,54.49%,30.78%,1
雲林縣,西螺鎮,0362,254,177,431,40,471,870,54.14%,29.2%,1
雲林縣,西螺鎮,0363,278,193,471,51,522,971,53.76%,28.63%,1
雲林縣,西螺鎮,0364,317,240,557,50,607,1304,46.55%,24.31%,1
雲林縣,西螺鎮,0365,192,149,341,18,359,726,49.45%,26.45%,1
雲林縣,西螺鎮,0366,231,187,418,31,449,823,54.56%,28.07%,1
雲林縣,西螺鎮,0367,204,156,360,12,372,886,41.99%,23.02%,1
雲林縣,西螺鎮,0368,350,276,626,58,684,1373,49.82%,25.49%,1
雲林縣,西螺鎮,0369,290,209,499,49,548,983,55.75%,29.5%,1
雲林縣,西螺鎮,0370,300,211,511,43,554,1014,54.64%,29.59%,1
雲林縣,西螺鎮,0371,242,186,428,53,481,939,51.22%,25.77%,1
雲林縣,西螺鎮,0372,240,171,411,30,441,866,50.92%,27.71%,1
雲林縣,西螺鎮,0373,393,254,647,82,729,1486,49.06%,26.45%,1
雲林縣,土庫鎮,0080,273,204,477,39,516,809,63.78%,33.75%,1
雲林縣,土庫鎮,0081,328,187,515,24,539,896,60.16%,36.61%,1
雲林縣,土庫鎮,0082,205,170,375,31,406,687,59.1%,29.84%,1
雲林縣,土庫鎮,0083,278,173,451,24,475,702,67.66%,39.6%,1
雲林縣,土庫鎮,0084,384,228,612,31,643,1032,62.31%,37.21%,1
雲林縣,土庫鎮,0085,174,150,324,47,371,697,53.23%,24.96%,1
雲林縣,土庫鎮,0086,108,84,192,34,226,427,52.93%,25.29%,1
雲林縣,土庫鎮,0087,471,341,812,44,856,1451,58.99%,32.46%,1
雲林縣,土庫鎮,0088,424,297,721,23,744,1283,57.99%,33.05%,1
雲林縣,土庫鎮,0089,146,129,275,17,292,634,46.06%,23.03%,1
雲林縣,土庫鎮,0090,237,178,415,25,440,796,55.28%,29.77%,1
雲林縣,土庫鎮,0091,182,120,302,31,333,745,44.7%,24.43%,1
雲林縣,土庫鎮,0092,136,124,260,28,288,576,50%,23.61%,1
雲林縣,土庫鎮,0093,169,138,307,48,355,743,47.78%,22.75%,1
雲林縣,土庫鎮,0094,122,99,221,17,238,534,44.57%,22.85%,1
雲林縣,土庫鎮,0095,287,203,490,57,547,1199,45.62%,23.94%,1
雲林縣,土庫鎮,0096,275,207,482,64,546,1077,50.7%,25.53%,1
雲林縣,土庫鎮,0097,248,119,367,19,386,819,47.13%,30.28%,1
雲林縣,土庫鎮,0098,214,138,352,20,372,684,54.39%,31.29%,1
雲林縣,土庫鎮,0099,282,152,434,37,471,843,55.87%,33.45%,1
雲林縣,土庫鎮,0100,267,179,446,46,492,916,53.71%,29.15%,1
雲林縣,土庫鎮,0101,253,188,441,38,479,948,50.53%,26.69%,1
雲林縣,土庫鎮,0102,275,197,472,28,500,914,54.7%,30.09%,1
雲林縣,土庫鎮,0103,266,69,335,48,383,860,44.53%,30.93%,1
雲林縣,土庫鎮,0104,257,177,434,41,475,929,51.13%,27.66%,1
雲林縣,土庫鎮,0105,242,138,380,44,424,875,48.46%,27.66%,1
雲林縣,土庫鎮,0106,219,138,357,34,391,896,43.64%,24.44%,1
雲林縣,土庫鎮,0107,161,149,310,37,347,757,45.84%,21.27%,1
雲林縣,土庫鎮,0108,177,127,304,27,331,683,48.46%,25.92%,1
雲林縣,北港鎮,0256,244,139,383,45,428,724,59.12%,33.7%,1
雲林縣,北港鎮,0257,227,171,398,48,446,688,64.83%,32.99%,1
雲林縣,北港鎮,0258,162,79,241,27,268,452,59.29%,35.84%,1
雲林縣,北港鎮,0259,304,160,464,35,499,866,57.62%,35.1%,1
雲林縣,北港鎮,0260,118,62,180,12,192,336,57.14%,35.12%,1
雲林縣,北港鎮,0261,129,71,200,16,216,395,54.68%,32.66%,1
雲林縣,北港鎮,0262,136,84,220,19,239,376,63.56%,36.17%,1
雲林縣,北港鎮,0263,307,209,516,29,545,950,57.37%,32.32%,1
雲林縣,北港鎮,0264,204,99,303,31,334,512,65.23%,39.84%,1
雲林縣,北港鎮,0265,105,69,174,27,201,324,62.04%,32.41%,1
雲林縣,北港鎮,0266,182,98,280,25,305,546,55.86%,33.33%,1
雲林縣,北港鎮,0267,162,95,257,14,271,433,62.59%,37.41%,1
雲林縣,北港鎮,0268,232,156,388,44,432,751,57.52%,30.89%,1
雲林縣,北港鎮,0269,175,79,254,19,273,442,61.76%,39.59%,1
雲林縣,北港鎮,0270,343,276,619,49,668,1151,58.04%,29.8%,1
雲林縣,北港鎮,0271,397,282,679,39,718,1224,58.66%,32.43%,1
雲林縣,北港鎮,0272,390,247,637,34,671,1211,55.41%,32.2%,1
雲林縣,北港鎮,0273,425,275,700,57,757,1326,57.09%,32.05%,1
雲林縣,北港鎮,0274,243,215,458,25,483,744,64.92%,32.66%,1
雲林縣,北港鎮,0275,349,238,587,39,626,977,64.07%,35.72%,1
雲林縣,北港鎮,0276,310,183,493,42,535,960,55.73%,32.29%,1
雲林縣,北港鎮,0277,117,69,186,10,196,494,39.68%,23.68%,1
雲林縣,北港鎮,0278,449,304,753,37,790,1364,57.92%,32.92%,1
雲林縣,北港鎮,0279,362,250,612,50,662,1123,58.95%,32.24%,1
雲林縣,北港鎮,0280,476,312,788,38,826,1451,56.93%,32.8%,1
雲林縣,北港鎮,0281,385,269,654,44,698,1162,60.07%,33.13%,1
雲林縣,北港鎮,0282,334,223,557,35,592,1130,52.39%,29.56%,1
雲林縣,北港鎮,0283,334,236,570,37,607,1149,52.83%,29.07%,1
雲林縣,北港鎮,0284,125,98,223,17,240,533,45.03%,23.45%,1
雲林縣,北港鎮,0285,162,111,273,20,293,433,67.67%,37.41%,1
雲林縣,北港鎮,0286,130,55,185,5,190,377,50.4%,34.48%,1
雲林縣,北港鎮,0287,194,140,334,24,358,809,44.25%,23.98%,1
雲林縣,北港鎮,0288,371,234,605,49,654,1397,46.81%,26.56%,1
雲林縣,北港鎮,0289,279,190,469,61,530,1145,46.29%,24.37%,1
雲林縣,北港鎮,0290,158,110,268,50,318,828,38.41%,19.08%,1
雲林縣,北港鎮,0291,145,72,217,12,229,557,41.11%,26.03%,1
雲林縣,北港鎮,0292,287,191,478,30,508,1060,47.92%,27.08%,1
雲林縣,北港鎮,0293,164,89,253,34,287,577,49.74%,28.42%,1
雲林縣,北港鎮,0294,205,160,365,48,413,931,44.36%,22.02%,1
雲林縣,北港鎮,0295,302,216,518,35,553,1018,54.32%,29.67%,1
雲林縣,北港鎮,0296,347,238,585,19,604,1032,58.53%,33.62%,1
雲林縣,古坑鄉,0531,355,244,599,30,629,1126,55.86%,31.53%,1
雲林縣,古坑鄉,0532,287,200,487,41,528,994,53.12%,28.87%,1
雲林縣,古坑鄉,0533,443,327,770,53,823,1517,54.25%,29.2%,1
雲林縣,古坑鄉,0534,433,253,686,38,724,1302,55.61%,33.26%,1
雲林縣,古坑鄉,0535,498,352,850,54,904,1772,51.02%,28.1%,1
雲林縣,古坑鄉,0536,376,212,588,56,644,1122,57.4%,33.51%,1
雲林縣,古坑鄉,0537,62,45,107,3,110,304,36.18%,20.39%,1
雲林縣,古坑鄉,0538,388,220,608,74,682,1169,58.34%,33.19%,1
雲林縣,古坑鄉,0539,354,229,583,73,656,1255,52.27%,28.21%,1
雲林縣,古坑鄉,0540,375,243,618,35,653,1078,60.58%,34.79%,1
雲林縣,古坑鄉,0541,278,171,449,22,471,943,49.95%,29.48%,1
雲林縣,古坑鄉,0542,393,217,610,64,674,1300,51.85%,30.23%,1
雲林縣,古坑鄉,0543,304,158,462,40,502,964,52.07%,31.54%,1
雲林縣,古坑鄉,0544,364,224,588,32,620,1144,54.2%,31.82%,1
雲林縣,古坑鄉,0545,444,281,725,71,796,1482,53.71%,29.96%,1
雲林縣,古坑鄉,0546,223,143,366,26,392,688,56.98%,32.41%,1
雲林縣,古坑鄉,0547,288,190,478,34,512,998,51.3%,28.86%,1
雲林縣,古坑鄉,0548,383,240,623,31,654,1140,57.37%,33.6%,1
雲林縣,古坑鄉,0549,324,236,560,42,602,1102,54.63%,29.4%,1
雲林縣,古坑鄉,0550,302,176,478,29,507,956,53.03%,31.59%,1
雲林縣,古坑鄉,0551,189,179,368,19,387,695,55.68%,27.19%,1
雲林縣,古坑鄉,0552,369,221,590,31,621,1233,50.36%,29.93%,1
雲林縣,古坑鄉,0553,67,43,110,11,121,285,42.46%,23.51%,1
雲林縣,古坑鄉,0554,190,105,295,10,305,734,41.55%,25.89%,1
雲林縣,古坑鄉,0555,323,264,587,49,636,1150,55.3%,28.09%,1
雲林縣,古坑鄉,0556,141,95,236,14,250,453,55.19%,31.13%,1
雲林縣,古坑鄉,0557,163,96,259,19,278,571,48.69%,28.55%,1
雲林縣,大埤鄉,0480,212,164,376,27,403,750,53.73%,28.27%,1
雲林縣,大埤鄉,0481,188,163,351,22,373,719,51.88%,26.15%,1
雲林縣,大埤鄉,0482,192,118,310,13,323,603,53.57%,31.84%,1
雲林縣,大埤鄉,0483,268,214,482,51,533,1106,48.19%,24.23%,1
雲林縣,大埤鄉,0484,432,316,748,44,792,1495,52.98%,28.9%,1
雲林縣,大埤鄉,0485,187,151,338,22,360,600,60%,31.17%,1
雲林縣,大埤鄉,0486,307,244,551,43,594,1004,59.16%,30.58%,1
雲林縣,大埤鄉,0487,222,155,377,22,399,948,42.09%,23.42%,1
雲林縣,大埤鄉,0488,449,332,781,50,831,1539,54%,29.17%,1
雲林縣,大埤鄉,0489,366,287,653,44,697,1430,48.74%,25.59%,1
雲林縣,大埤鄉,0490,141,82,223,18,241,465,51.83%,30.32%,1
雲林縣,大埤鄉,0491,385,228,613,48,661,1307,50.57%,29.46%,1
雲林縣,大埤鄉,0492,145,96,241,9,250,474,52.74%,30.59%,1
雲林縣,大埤鄉,0493,408,271,679,56,735,1220,60.25%,33.44%,1
雲林縣,大埤鄉,0494,235,138,373,18,391,733,53.34%,32.06%,1
雲林縣,大埤鄉,0495,225,128,353,24,377,681,55.36%,33.04%,1
雲林縣,大埤鄉,0496,162,125,287,18,305,712,42.84%,22.75%,1
雲林縣,大埤鄉,0497,180,127,307,41,348,723,48.13%,24.9%,1
雲林縣,莿桐鄉,0374,475,325,800,50,850,1507,56.4%,31.52%,1
雲林縣,莿桐鄉,0375,414,258,672,36,708,1300,54.46%,31.85%,1
雲林縣,莿桐鄉,0376,432,247,679,77,756,1272,59.43%,33.96%,1
雲林縣,莿桐鄉,0377,240,183,423,41,464,861,53.89%,27.87%,1
雲林縣,莿桐鄉,0378,409,296,705,61,766,1565,48.95%,26.13%,1
雲林縣,莿桐鄉,0379,183,106,289,16,305,577,52.86%,31.72%,1
雲林縣,莿桐鄉,0380,170,109,279,27,306,636,48.11%,26.73%,1
雲林縣,莿桐鄉,0381,311,230,541,37,578,1110,52.07%,28.02%,1
雲林縣,莿桐鄉,0382,284,247,531,60,591,973,60.74%,29.19%,1
雲林縣,莿桐鄉,0383,281,214,495,59,554,985,56.24%,28.53%,1
雲林縣,莿桐鄉,0384,550,390,940,80,1020,1707,59.75%,32.22%,1
雲林縣,莿桐鄉,0385,409,273,682,52,734,1284,57.17%,31.85%,1
雲林縣,莿桐鄉,0386,434,265,699,43,742,1293,57.39%,33.57%,1
雲林縣,莿桐鄉,0387,282,192,474,36,510,900,56.67%,31.33%,1
雲林縣,莿桐鄉,0388,317,230,547,74,621,1040,59.71%,30.48%,1
雲林縣,莿桐鄉,0389,336,241,577,26,603,1165,51.76%,28.84%,1
雲林縣,莿桐鄉,0390,259,188,447,48,495,871,56.83%,29.74%,1
雲林縣,莿桐鄉,0391,297,189,486,56,542,885,61.24%,33.56%,1
雲林縣,莿桐鄉,0392,395,290,685,49,734,1489,49.29%,26.53%,1
雲林縣,莿桐鄉,0393,359,217,576,97,673,1347,49.96%,26.65%,1
雲林縣,莿桐鄉,0394,365,257,622,46,668,1150,58.09%,31.74%,1
雲林縣,莿桐鄉,0395,218,151,369,23,392,653,60.03%,33.38%,1
雲林縣,林內鄉,0396,393,221,614,42,656,1036,63.32%,37.93%,1
雲林縣,林內鄉,0397,472,335,807,32,839,1490,56.31%,31.68%,1
雲林縣,林內鄉,0398,474,275,749,55,804,1491,53.92%,31.79%,1
雲林縣,林內鄉,0399,208,113,321,37,358,671,53.35%,31%,1
雲林縣,林內鄉,0400,419,307,726,136,862,1436,60.03%,29.18%,1
雲林縣,林內鄉,0401,238,163,401,44,445,751,59.25%,31.69%,1
雲林縣,林內鄉,0402,174,113,287,13,300,535,56.07%,32.52%,1
雲林縣,林內鄉,0403,182,175,357,33,390,811,48.09%,22.44%,1
雲林縣,林內鄉,0404,424,282,706,64,770,1339,57.51%,31.67%,1
雲林縣,林內鄉,0405,432,230,662,51,713,1286,55.44%,33.59%,1
雲林縣,林內鄉,0406,191,141,332,27,359,646,55.57%,29.57%,1
雲林縣,林內鄉,0407,364,245,609,42,651,1158,56.22%,31.43%,1
雲林縣,林內鄉,0408,345,229,574,44,618,1090,56.7%,31.65%,1
雲林縣,林內鄉,0409,320,208,528,62,590,950,62.11%,33.68%,1
雲林縣,林內鄉,0410,249,204,453,33,486,861,56.45%,28.92%,1
雲林縣,二崙鄉,0317,354,298,652,34,686,1463,46.89%,24.2%,1
雲林縣,二崙鄉,0318,466,308,774,39,813,1738,46.78%,26.81%,1
雲林縣,二崙鄉,0319,158,108,266,36,302,625,48.32%,25.28%,1
雲林縣,二崙鄉,0320,269,200,469,36,505,1018,49.61%,26.42%,1
雲林縣,二崙鄉,0321,96,80,176,7,183,448,40.85%,21.43%,1
雲林縣,二崙鄉,0322,204,159,363,48,411,1048,39.22%,19.47%,1
雲林縣,二崙鄉,0323,312,264,576,58,634,1161,54.61%,26.87%,1
雲林縣,二崙鄉,0324,278,209,487,29,516,991,52.07%,28.05%,1
雲林縣,二崙鄉,0325,277,183,460,43,503,849,59.25%,32.63%,1
雲林縣,二崙鄉,0326,236,177,413,37,450,890,50.56%,26.52%,1
雲林縣,二崙鄉,0327,364,271,635,74,709,1427,49.68%,25.51%,1
雲林縣,二崙鄉,0328,357,100,457,18,475,891,53.31%,40.07%,1
雲林縣,二崙鄉,0329,173,131,304,26,330,757,43.59%,22.85%,1
雲林縣,二崙鄉,0330,394,241,635,98,733,1497,48.96%,26.32%,1
雲林縣,二崙鄉,0331,301,209,510,52,562,1171,47.99%,25.7%,1
雲林縣,二崙鄉,0332,215,144,359,46,405,686,59.04%,31.34%,1
雲林縣,二崙鄉,0333,192,115,307,80,387,864,44.79%,22.22%,1
雲林縣,二崙鄉,0334,318,230,548,68,616,1073,57.41%,29.64%,1
雲林縣,二崙鄉,0335,165,117,282,16,298,696,42.82%,23.71%,1
雲林縣,二崙鄉,0336,273,183,456,39,495,1271,38.95%,21.48%,1
雲林縣,二崙鄉,0337,213,160,373,37,410,912,44.96%,23.36%,1
雲林縣,二崙鄉,0338,211,157,368,29,397,861,46.11%,24.51%,1
雲林縣,二崙鄉,0339,209,186,395,45,440,1030,42.72%,20.29%,1
雲林縣,崙背鄉,0297,375,235,610,52,662,1176,56.29%,31.89%,1
雲林縣,崙背鄉,0298,414,280,694,36,730,1439,50.73%,28.77%,1
雲林縣,崙背鄉,0299,345,218,563,50,613,1027,59.69%,33.59%,1
雲林縣,崙背鄉,0300,423,250,673,41,714,1259,56.71%,33.6%,1
雲林縣,崙背鄉,0301,286,205,491,25,516,1058,48.77%,27.03%,1
雲林縣,崙背鄉,0302,276,166,442,25,467,998,46.79%,27.66%,1
雲林縣,崙背鄉,0303,295,156,451,34,485,968,50.1%,30.48%,1
雲林縣,崙背鄉,0304,308,198,506,48,554,1055,52.51%,29.19%,1
雲林縣,崙背鄉,0305,336,235,571,60,631,1315,47.98%,25.55%,1
雲林縣,崙背鄉,0306,176,144,320,25,345,1027,33.59%,17.14%,1
雲林縣,崙背鄉,0307,322,202,524,69,593,997,59.48%,32.3%,1
雲林縣,崙背鄉,0308,253,150,403,22,425,807,52.66%,31.35%,1
雲林縣,崙背鄉,0309,144,119,263,26,289,698,41.4%,20.63%,1
雲林縣,崙背鄉,0310,168,159,327,49,376,804,46.77%,20.9%,1
雲林縣,崙背鄉,0311,242,166,408,28,436,867,50.29%,27.91%,1
雲林縣,崙背鄉,0312,198,154,352,29,381,886,43%,22.35%,1
雲林縣,崙背鄉,0313,308,244,552,66,618,1476,41.87%,20.87%,1
雲林縣,崙背鄉,0314,233,150,383,28,411,1159,35.46%,20.1%,1
雲林縣,崙背鄉,0315,426,224,650,56,706,1220,57.87%,34.92%,1
雲林縣,崙背鄉,0316,231,165,396,28,424,814,52.09%,28.38%,1
雲林縣,麥寮鄉,0001,351,250,601,57,658,1497,43.95%,23.45%,1
雲林縣,麥寮鄉,0002,489,340,829,45,874,1738,50.29%,28.14%,1
雲林縣,麥寮鄉,0003,553,352,905,52,957,1921,49.82%,28.79%,1
雲林縣,麥寮鄉,0004,566,269,835,51,886,1832,48.36%,30.9%,1
雲林縣,麥寮鄉,0005,328,244,572,44,616,1340,45.97%,24.48%,1
雲林縣,麥寮鄉,0006,272,230,502,52,554,1138,48.68%,23.9%,1
雲林縣,麥寮鄉,0007,442,280,722,40,762,1551,49.13%,28.5%,1
雲林縣,麥寮鄉,0008,156,133,289,28,317,715,44.34%,21.82%,1
雲林縣,麥寮鄉,0009,270,201,471,41,512,1194,42.88%,22.61%,1
雲林縣,麥寮鄉,0010,260,188,448,40,488,1023,47.7%,25.42%,1
雲林縣,麥寮鄉,0011,337,240,577,30,607,1558,38.96%,21.63%,1
雲林縣,麥寮鄉,0012,251,214,465,20,485,1187,40.86%,21.15%,1
雲林縣,麥寮鄉,0013,250,150,400,22,422,983,42.93%,25.43%,1
雲林縣,麥寮鄉,0014,332,268,600,64,664,1363,48.72%,24.36%,1
雲林縣,麥寮鄉,0015,432,273,705,63,768,1596,48.12%,27.07%,1
雲林縣,麥寮鄉,0016,459,331,790,74,864,1469,58.82%,31.25%,1
雲林縣,麥寮鄉,0017,216,163,379,56,435,964,45.12%,22.41%,1
雲林縣,麥寮鄉,0018,274,151,425,30,455,1038,43.83%,26.4%,1
雲林縣,麥寮鄉,0019,341,281,622,0,622,1230,50.57%,27.72%,1
雲林縣,麥寮鄉,0020,343,264,607,40,647,1329,48.68%,25.81%,1
雲林縣,麥寮鄉,0021,368,187,555,54,609,1129,53.94%,32.6%,1
雲林縣,麥寮鄉,0022,383,269,652,47,699,1241,56.33%,30.86%,1
雲林縣,麥寮鄉,0023,456,304,760,46,806,1471,54.79%,31%,1
雲林縣,麥寮鄉,0024,337,240,577,59,636,1107,57.45%,30.44%,1
雲林縣,麥寮鄉,0025,540,307,847,59,906,1636,55.38%,33.01%,1
雲林縣,麥寮鄉,0026,487,328,815,41,856,1755,48.77%,27.75%,1
雲林縣,麥寮鄉,0027,406,229,635,43,678,1158,58.55%,35.06%,1
雲林縣,麥寮鄉,0028,280,202,482,34,516,956,53.97%,29.29%,1
雲林縣,東勢鄉,0051,273,225,498,46,544,1207,45.07%,22.62%,1
雲林縣,東勢鄉,0052,174,124,298,28,326,540,60.37%,32.22%,1
雲林縣,東勢鄉,0053,232,144,376,23,399,896,44.53%,25.89%,1
雲林縣,東勢鄉,0054,201,166,367,27,394,728,54.12%,27.61%,1
雲林縣,東勢鄉,0055,519,312,831,53,884,1533,57.66%,33.86%,1
雲林縣,東勢鄉,0056,421,245,666,54,720,1203,59.85%,35%,1
雲林縣,東勢鄉,0057,211,132,343,49,392,817,47.98%,25.83%,1
雲林縣,東勢鄉,0058,180,118,298,27,325,546,59.52%,32.97%,1
雲林縣,東勢鄉,0059,237,149,386,52,438,853,51.35%,27.78%,1
雲林縣,東勢鄉,0060,198,122,320,53,373,856,43.57%,23.13%,1
雲林縣,東勢鄉,0061,205,203,408,40,448,923,48.54%,22.21%,1
雲林縣,東勢鄉,0062,291,204,495,34,529,1022,51.76%,28.47%,1
雲林縣,東勢鄉,0063,129,95,224,18,242,634,38.17%,20.35%,1
雲林縣,東勢鄉,0064,102,63,165,13,178,394,45.18%,25.89%,1
雲林縣,東勢鄉,0065,240,162,402,36,438,1087,40.29%,22.08%,1
雲林縣,褒忠鄉,0066,293,182,475,47,522,923,56.55%,31.74%,1
雲林縣,褒忠鄉,0067,350,207,557,29,586,993,59.01%,35.25%,1
雲林縣,褒忠鄉,0068,207,161,368,28,396,748,52.94%,27.67%,1
雲林縣,褒忠鄉,0069,204,145,349,11,360,702,51.28%,29.06%,1
雲林縣,褒忠鄉,0070,242,130,372,16,388,752,51.6%,32.18%,1
雲林縣,褒忠鄉,0071,241,161,402,13,415,756,54.89%,31.88%,1
雲林縣,褒忠鄉,0072,153,87,240,18,258,490,52.65%,31.22%,1
雲林縣,褒忠鄉,0073,241,199,440,33,473,1034,45.74%,23.31%,1
雲林縣,褒忠鄉,0074,106,103,209,22,231,470,49.15%,22.55%,1
雲林縣,褒忠鄉,0075,190,162,352,22,374,737,50.75%,25.78%,1
雲林縣,褒忠鄉,0076,235,177,412,32,444,878,50.57%,26.77%,1
雲林縣,褒忠鄉,0077,198,140,338,52,390,778,50.13%,25.45%,1
雲林縣,褒忠鄉,0078,312,263,575,39,614,1224,50.16%,25.49%,1
雲林縣,褒忠鄉,0079,190,175,365,66,431,896,48.1%,21.21%,1
雲林縣,臺西鄉,0029,395,242,637,47,684,1238,55.25%,31.91%,1
雲林縣,臺西鄉,0030,324,160,484,35,519,1091,47.57%,29.7%,1
雲林縣,臺西鄉,0031,328,199,527,54,581,1098,52.91%,29.87%,1
雲林縣,臺西鄉,0032,276,153,429,22,451,1048,43.03%,26.34%,1
雲林縣,臺西鄉,0033,277,178,455,42,497,1025,48.49%,27.02%,1
雲林縣,臺西鄉,0034,250,145,395,37,432,850,50.82%,29.41%,1
雲林縣,臺西鄉,0035,391,201,592,53,645,1460,44.18%,26.78%,1
雲林縣,臺西鄉,0036,227,161,388,53,441,1180,37.37%,19.24%,1
雲林縣,臺西鄉,0037,118,101,219,20,239,710,33.66%,16.62%,1
雲林縣,臺西鄉,0038,165,100,265,12,277,620,44.68%,26.61%,1
雲林縣,臺西鄉,0039,105,86,191,24,215,449,47.88%,23.39%,1
雲林縣,臺西鄉,0040,135,109,244,38,282,687,41.05%,19.65%,1
雲林縣,臺西鄉,0041,317,194,511,48,559,1247,44.83%,25.42%,1
雲林縣,臺西鄉,0042,130,69,199,10,209,583,35.85%,22.3%,1
雲林縣,臺西鄉,0043,262,194,456,55,511,1042,49.04%,25.14%,1
雲林縣,臺西鄉,0044,116,89,205,15,220,472,46.61%,24.58%,1
雲林縣,臺西鄉,0045,394,198,592,19,611,1409,43.36%,27.96%,1
雲林縣,臺西鄉,0046,310,192,502,65,567,1061,53.44%,29.22%,1
雲林縣,臺西鄉,0047,245,163,408,25,433,993,43.61%,24.67%,1
雲林縣,臺西鄉,0048,250,172,422,71,493,1013,48.67%,24.68%,1
雲林縣,臺西鄉,0049,313,246,559,42,601,1233,48.74%,25.39%,1
雲林縣,臺西鄉,0050,143,99,242,22,264,616,42.86%,23.21%,1
雲林縣,元長鄉,0180,304,139,443,21,464,915,50.71%,33.22%,1
雲林縣,元長鄉,0181,380,213,593,22,615,1284,47.9%,29.6%,1
雲林縣,元長鄉,0182,296,213,509,39,548,1150,47.65%,25.74%,1
雲林縣,元長鄉,0183,190,111,301,34,335,744,45.03%,25.54%,1
雲林縣,元長鄉,0184,240,130,370,24,394,790,49.87%,30.38%,1
雲林縣,元長鄉,0185,297,215,512,54,566,1356,41.74%,21.9%,1
雲林縣,元長鄉,0186,176,146,322,37,359,739,48.58%,23.82%,1
雲林縣,元長鄉,0187,203,164,367,33,400,965,41.45%,21.04%,1
雲林縣,元長鄉,0188,223,185,408,56,464,1080,42.96%,20.65%,1
雲林縣,元長鄉,0189,199,150,349,40,389,948,41.03%,20.99%,1
雲林縣,元長鄉,0190,116,106,222,23,245,762,32.15%,15.22%,1
雲林縣,元長鄉,0191,145,109,254,19,273,582,46.91%,24.91%,1
雲林縣,元長鄉,0192,190,125,315,14,329,865,38.03%,21.97%,1
雲林縣,元長鄉,0193,54,21,75,9,84,362,23.2%,14.92%,1
雲林縣,元長鄉,0194,268,182,450,23,473,1162,40.71%,23.06%,1
雲林縣,元長鄉,0195,377,258,635,14,649,1527,42.5%,24.69%,1
雲林縣,元長鄉,0196,263,169,432,58,490,1006,48.71%,26.14%,1
雲林縣,元長鄉,0197,222,130,352,17,369,855,43.16%,25.96%,1
雲林縣,元長鄉,0198,303,206,509,50,559,1181,47.33%,25.66%,1
雲林縣,元長鄉,0199,208,123,331,28,359,864,41.55%,24.07%,1
雲林縣,元長鄉,0200,147,104,251,20,271,667,40.63%,22.04%,1
雲林縣,元長鄉,0201,205,132,337,23,360,878,41%,23.35%,1
雲林縣,元長鄉,0202,145,73,218,6,224,610,36.72%,23.77%,1
雲林縣,元長鄉,0203,221,128,349,52,401,837,47.91%,26.4%,1
雲林縣,元長鄉,0204,187,151,338,20,358,701,51.07%,26.68%,1
雲林縣,四湖鄉,0155,266,174,440,41,481,1082,44.45%,24.58%,1
雲林縣,四湖鄉,0156,194,142,336,36,372,676,55.03%,28.7%,1
雲林縣,四湖鄉,0157,259,150,409,21,430,862,49.88%,30.05%,1
雲林縣,四湖鄉,0158,109,74,183,9,192,477,40.25%,22.85%,1
雲林縣,四湖鄉,0159,309,198,507,37,544,952,57.14%,32.46%,1
雲林縣,四湖鄉,0160,129,107,236,14,250,650,38.46%,19.85%,1
雲林縣,四湖鄉,0161,241,168,409,21,430,969,44.38%,24.87%,1
雲林縣,四湖鄉,0162,179,141,320,55,375,925,40.54%,19.35%,1
雲林縣,四湖鄉,0163,182,193,375,24,399,914,43.65%,19.91%,1
雲林縣,四湖鄉,0164,120,85,205,38,243,759,32.02%,15.81%,1
雲林縣,四湖鄉,0165,235,184,419,51,470,1219,38.56%,19.28%,1
雲林縣,四湖鄉,0166,186,107,293,31,324,937,34.58%,19.85%,1
雲林縣,四湖鄉,0167,149,93,242,18,260,773,33.64%,19.28%,1
雲林縣,四湖鄉,0168,115,80,195,30,225,555,40.54%,20.72%,1
雲林縣,四湖鄉,0169,161,121,282,27,309,876,35.27%,18.38%,1
雲林縣,四湖鄉,0170,74,50,124,15,139,360,38.61%,20.56%,1
雲林縣,四湖鄉,0171,143,98,241,27,268,885,30.28%,16.16%,1
雲林縣,四湖鄉,0172,154,107,261,25,286,833,34.33%,18.49%,1
雲林縣,四湖鄉,0173,184,109,293,33,326,785,41.53%,23.44%,1
雲林縣,四湖鄉,0174,198,102,300,39,339,705,48.09%,28.09%,1
雲林縣,四湖鄉,0175,203,104,307,31,338,927,36.46%,21.9%,1
雲林縣,四湖鄉,0176,198,141,339,48,387,1058,36.58%,18.71%,1
雲林縣,四湖鄉,0177,224,143,367,42,409,1071,38.19%,20.92%,1
雲林縣,四湖鄉,0178,137,132,269,20,289,1022,28.28%,13.41%,1
雲林縣,四湖鄉,0179,160,120,280,33,313,711,44.02%,22.5%,1
雲林縣,口湖鄉,0205,309,252,561,48,609,1134,53.7%,27.25%,1
雲林縣,口湖鄉,0206,346,238,584,82,666,1225,54.37%,28.24%,1
雲林縣,口湖鄉,0207,161,87,248,28,276,647,42.66%,24.88%,1
雲林縣,口湖鄉,0208,184,152,336,21,357,709,50.35%,25.95%,1
雲林縣,口湖鄉,0209,225,145,370,63,433,900,48.11%,25%,1
雲林縣,口湖鄉,0210,252,208,460,51,511,1011,50.54%,24.93%,1
雲林縣,口湖鄉,0211,400,191,591,28,619,1437,43.08%,27.84%,1
雲林縣,口湖鄉,0212,164,116,280,12,292,848,34.43%,19.34%,1
雲林縣,口湖鄉,0213,281,183,464,26,490,1193,41.07%,23.55%,1
雲林縣,口湖鄉,0214,141,103,244,43,287,759,37.81%,18.58%,1
雲林縣,口湖鄉,0215,169,157,326,46,372,815,45.64%,20.74%,1
雲林縣,口湖鄉,0216,426,244,670,59,729,1460,49.93%,29.18%,1
雲林縣,口湖鄉,0217,108,80,188,11,199,556,35.79%,19.42%,1
雲林縣,口湖鄉,0218,395,265,660,53,713,1532,46.54%,25.78%,1
雲林縣,口湖鄉,0219,235,148,383,15,398,847,46.99%,27.74%,1
雲林縣,口湖鄉,0220,80,90,170,12,182,374,48.66%,21.39%,1
雲林縣,口湖鄉,0221,399,288,687,149,836,1508,55.44%,26.46%,1
雲林縣,口湖鄉,0222,311,168,479,55,534,951,56.15%,32.7%,1
雲林縣,口湖鄉,0223,269,192,461,65,526,910,57.8%,29.56%,1
雲林縣,口湖鄉,0224,271,210,481,36,517,879,58.82%,30.83%,1
雲林縣,口湖鄉,0225,314,189,503,91,594,1213,48.97%,25.89%,1
雲林縣,口湖鄉,0226,278,153,431,48,479,952,50.32%,29.2%,1
雲林縣,口湖鄉,0227,306,41,347,42,389,720,54.03%,42.5%,1
雲林縣,口湖鄉,0228,222,154,376,26,402,1006,39.96%,22.07%,1
雲林縣,口湖鄉,0229,163,69,232,12,244,607,40.2%,26.85%,1
雲林縣,水林鄉,0230,326,303,629,47,676,1355,49.89%,24.06%,1
雲林縣,水林鄉,0231,256,190,446,17,463,887,52.2%,28.86%,1
雲林縣,水林鄉,0232,373,264,637,34,671,1234,54.38%,30.23%,1
雲林縣,水林鄉,0233,198,160,358,16,374,763,49.02%,25.95%,1
雲林縣,水林鄉,0234,157,116,273,35,308,721,42.72%,21.78%,1
雲林縣,水林鄉,0235,100,128,228,15,243,647,37.56%,15.46%,1
雲林縣,水林鄉,0236,226,158,384,53,437,989,44.19%,22.85%,1
雲林縣,水林鄉,0237,183,128,311,23,334,837,39.9%,21.86%,1
雲林縣,水林鄉,0238,245,141,386,21,407,1081,37.65%,22.66%,1
雲林縣,水林鄉,0239,191,122,313,24,337,704,47.87%,27.13%,1
雲林縣,水林鄉,0240,272,168,440,61,501,1006,49.8%,27.04%,1
雲林縣,水林鄉,0241,147,109,256,9,265,651,40.71%,22.58%,1
雲林縣,水林鄉,0242,130,102,232,18,250,607,41.19%,21.42%,1
雲林縣,水林鄉,0243,214,163,377,59,436,1033,42.21%,20.72%,1
雲林縣,水林鄉,0244,124,69,193,13,206,631,32.65%,19.65%,1
雲林縣,水林鄉,0245,230,147,377,39,416,961,43.29%,23.93%,1
雲林縣,水林鄉,0246,223,138,361,64,425,951,44.69%,23.45%,1
雲林縣,水林鄉,0247,212,139,351,22,373,838,44.51%,25.3%,1
雲林縣,水林鄉,0248,288,148,436,67,503,1055,47.68%,27.3%,1
雲林縣,水林鄉,0249,89,67,156,22,178,512,34.77%,17.38%,1
雲林縣,水林鄉,0250,133,93,226,19,245,671,36.51%,19.82%,1
雲林縣,水林鄉,0251,111,76,187,36,223,693,32.18%,16.02%,1
雲林縣,水林鄉,0252,135,84,219,26,245,689,35.56%,19.59%,1
雲林縣,水林鄉,0253,270,171,441,56,497,1022,48.63%,26.42%,1
雲林縣,水林鄉,0254,302,165,467,37,504,1191,42.32%,25.36%,1
雲林縣,水林鄉,0255,242,154,396,30,426,779,54.69%,31.07%,1
嘉義縣,太保市,0001,391,252,643,37,680,1210,56.2%,32.31%,1
嘉義縣,太保市,0002,347,230,577,31,608,1076,56.51%,32.25%,1
嘉義縣,太保市,0003,138,89,227,23,250,488,51.23%,28.28%,1
嘉義縣,太保市,0004,420,286,706,47,753,1475,51.05%,28.47%,1
嘉義縣,太保市,0005,214,144,358,22,380,790,48.1%,27.09%,1
嘉義縣,太保市,0006,265,161,426,22,448,883,50.74%,30.01%,1
嘉義縣,太保市,0007,199,163,362,24,386,758,50.92%,26.25%,1
嘉義縣,太保市,0008,107,60,167,4,171,389,43.96%,27.51%,1
嘉義縣,太保市,0009,296,185,481,34,515,1101,46.78%,26.88%,1
嘉義縣,太保市,0010,327,147,474,10,484,853,56.74%,38.34%,1
嘉義縣,太保市,0011,46,40,86,6,92,224,41.07%,20.54%,1
嘉義縣,太保市,0012,188,108,296,33,329,662,49.7%,28.4%,1
嘉義縣,太保市,0013,626,316,942,29,971,1630,59.57%,38.4%,1
嘉義縣,太保市,0014,272,164,436,22,458,913,50.16%,29.79%,1
嘉義縣,太保市,0015,268,158,426,8,434,779,55.71%,34.4%,1
嘉義縣,太保市,0016,376,270,646,70,716,1278,56.03%,29.42%,1
嘉義縣,太保市,0017,251,130,381,24,405,819,49.45%,30.65%,1
嘉義縣,太保市,0018,448,362,810,18,828,1573,52.64%,28.48%,1
嘉義縣,太保市,0019,147,109,256,14,270,481,56.13%,30.56%,1
嘉義縣,太保市,0020,86,58,144,4,148,245,60.41%,35.1%,1
嘉義縣,太保市,0021,108,67,175,9,184,317,58.04%,34.07%,1
嘉義縣,太保市,0022,80,57,137,4,141,258,54.65%,31.01%,1
嘉義縣,太保市,0023,204,105,309,24,333,611,54.5%,33.39%,1
嘉義縣,太保市,0024,533,337,870,32,902,1526,59.11%,34.93%,1
嘉義縣,太保市,0025,363,307,670,14,684,1196,57.19%,30.35%,1
嘉義縣,太保市,0026,454,324,778,57,835,1536,54.36%,29.56%,1
嘉義縣,太保市,0027,466,318,784,44,828,1481,55.91%,31.47%,1
嘉義縣,太保市,0028,451,313,764,34,798,1450,55.03%,31.1%,1
嘉義縣,太保市,0029,295,157,452,16,468,840,55.71%,35.12%,1
嘉義縣,太保市,0030,356,215,571,12,583,989,58.95%,36%,1
嘉義縣,太保市,0031,516,303,819,41,860,1529,56.25%,33.75%,1
嘉義縣,太保市,0032,490,329,819,37,856,1511,56.65%,32.43%,1
嘉義縣,太保市,0033,212,118,330,24,354,697,50.79%,30.42%,1
嘉義縣,朴子市,0233,371,257,628,18,646,1183,54.61%,31.36%,1
嘉義縣,朴子市,0234,234,155,389,27,416,755,55.1%,30.99%,1
嘉義縣,朴子市,0235,396,257,653,29,682,1253,54.43%,31.6%,1
嘉義縣,朴子市,0236,371,234,605,47,652,1078,60.48%,34.42%,1
嘉義縣,朴子市,0237,394,254,648,37,685,1117,61.32%,35.27%,1
嘉義縣,朴子市,0238,144,76,220,12,232,387,59.95%,37.21%,1
嘉義縣,朴子市,0239,228,106,334,25,359,633,56.71%,36.02%,1
嘉義縣,朴子市,0240,217,139,356,15,371,650,57.08%,33.38%,1
嘉義縣,朴子市,0241,317,180,497,31,528,825,64%,38.42%,1
嘉義縣,朴子市,0242,287,132,419,34,453,810,55.93%,35.43%,1
嘉義縣,朴子市,0243,353,172,525,29,554,940,58.94%,37.55%,1
嘉義縣,朴子市,0244,273,182,455,36,491,905,54.25%,30.17%,1
嘉義縣,朴子市,0245,466,275,741,29,770,1605,47.98%,29.03%,1
嘉義縣,朴子市,0246,509,308,817,33,850,1479,57.47%,34.42%,1
嘉義縣,朴子市,0247,399,274,673,32,705,1218,57.88%,32.76%,1
嘉義縣,朴子市,0248,497,324,821,37,858,1496,57.35%,33.22%,1
嘉義縣,朴子市,0249,191,158,349,19,368,667,55.17%,28.64%,1
嘉義縣,朴子市,0250,154,91,245,12,257,627,40.99%,24.56%,1
嘉義縣,朴子市,0251,245,131,376,23,399,791,50.44%,30.97%,1
嘉義縣,朴子市,0252,287,213,500,73,573,1034,55.42%,27.76%,1
嘉義縣,朴子市,0253,475,354,829,23,852,1710,49.82%,27.78%,1
嘉義縣,朴子市,0254,508,277,785,37,822,1671,49.19%,30.4%,1
嘉義縣,朴子市,0255,429,256,685,27,712,1547,46.02%,27.73%,1
嘉義縣,朴子市,0256,375,255,630,38,668,1602,41.7%,23.41%,1
嘉義縣,朴子市,0257,469,247,716,26,742,1302,56.99%,36.02%,1
嘉義縣,朴子市,0258,225,131,356,25,381,740,51.49%,30.41%,1
嘉義縣,朴子市,0259,346,231,577,46,623,1054,59.11%,32.83%,1
嘉義縣,朴子市,0260,233,149,382,10,392,907,43.22%,25.69%,1
嘉義縣,朴子市,0261,178,123,301,13,314,720,43.61%,24.72%,1
嘉義縣,朴子市,0262,74,62,136,15,151,251,60.16%,29.48%,1
嘉義縣,朴子市,0263,184,118,302,41,343,767,44.72%,23.99%,1
嘉義縣,朴子市,0264,236,127,363,30,393,702,55.98%,33.62%,1
嘉義縣,朴子市,0265,322,147,469,32,501,1038,48.27%,31.02%,1
嘉義縣,朴子市,0266,273,161,434,25,459,1228,37.38%,22.23%,1
嘉義縣,朴子市,0267,140,86,226,31,257,499,51.5%,28.06%,1
嘉義縣,布袋鎮,0325,206,91,297,13,310,614,50.49%,33.55%,1
嘉義縣,布袋鎮,0326,103,58,161,10,171,372,45.97%,27.69%,1
嘉義縣,布袋鎮,0327,272,192,464,46,510,914,55.8%,29.76%,1
嘉義縣,布袋鎮,0328,384,218,602,46,648,1198,54.09%,32.05%,1
嘉義縣,布袋鎮,0329,300,174,474,54,528,1113,47.44%,26.95%,1
嘉義縣,布袋鎮,0330,317,179,496,49,545,992,54.94%,31.96%,1
嘉義縣,布袋鎮,0331,219,119,338,19,357,689,51.81%,31.79%,1
嘉義縣,布袋鎮,0332,256,161,417,46,463,882,52.49%,29.02%,1
嘉義縣,布袋鎮,0333,230,124,354,28,382,731,52.26%,31.46%,1
嘉義縣,布袋鎮,0334,264,146,410,21,431,779,55.33%,33.89%,1
嘉義縣,布袋鎮,0335,191,114,305,38,343,762,45.01%,25.07%,1
嘉義縣,布袋鎮,0336,302,197,499,36,535,1184,45.19%,25.51%,1
嘉義縣,布袋鎮,0337,366,168,534,44,578,1423,40.62%,25.72%,1
嘉義縣,布袋鎮,0338,323,194,517,49,566,1351,41.89%,23.91%,1
嘉義縣,布袋鎮,0339,91,35,126,2,128,275,46.55%,33.09%,1
嘉義縣,布袋鎮,0340,62,45,107,10,117,243,48.15%,25.51%,1
嘉義縣,布袋鎮,0341,223,107,330,33,363,661,54.92%,33.74%,1
嘉義縣,布袋鎮,0342,346,168,514,33,547,1145,47.77%,30.22%,1
嘉義縣,布袋鎮,0343,251,170,421,26,447,936,47.76%,26.82%,1
嘉義縣,布袋鎮,0344,256,166,422,32,454,958,47.39%,26.72%,1
嘉義縣,布袋鎮,0345,79,50,129,13,142,298,47.65%,26.51%,1
嘉義縣,布袋鎮,0346,144,89,233,24,257,428,60.05%,33.64%,1
嘉義縣,布袋鎮,0347,29,18,47,3,50,121,41.32%,23.97%,1
嘉義縣,布袋鎮,0348,29,16,45,6,51,174,29.31%,16.67%,1
嘉義縣,布袋鎮,0349,256,166,422,36,458,953,48.06%,26.86%,1
嘉義縣,布袋鎮,0350,399,243,642,52,694,1292,53.72%,30.88%,1
嘉義縣,布袋鎮,0351,356,217,573,33,606,1127,53.77%,31.59%,1
嘉義縣,布袋鎮,0352,349,214,563,33,596,1244,47.91%,28.05%,1
嘉義縣,布袋鎮,0353,335,196,531,15,546,1106,49.37%,30.29%,1
嘉義縣,大林鎮,0169,160,90,250,20,270,483,55.9%,33.13%,1
嘉義縣,大林鎮,0170,593,395,988,42,1030,1823,56.5%,32.53%,1
嘉義縣,大林鎮,0171,316,214,530,18,548,955,57.38%,33.09%,1
嘉義縣,大林鎮,0172,427,301,728,34,762,1436,53.06%,29.74%,1
嘉義縣,大林鎮,0173,415,315,730,51,781,1390,56.19%,29.86%,1
嘉義縣,大林鎮,0174,500,321,821,46,867,1512,57.34%,33.07%,1
嘉義縣,大林鎮,0175,501,331,832,41,873,1536,56.84%,32.62%,1
嘉義縣,大林鎮,0176,320,217,537,30,567,1165,48.67%,27.47%,1
嘉義縣,大林鎮,0177,548,428,976,51,1027,1730,59.36%,31.68%,1
嘉義縣,大林鎮,0178,163,102,265,8,273,602,45.35%,27.08%,1
嘉義縣,大林鎮,0179,179,147,326,32,358,716,50%,25%,1
嘉義縣,大林鎮,0180,150,111,261,12,273,625,43.68%,24%,1
嘉義縣,大林鎮,0181,43,28,71,4,75,193,38.86%,22.28%,1
嘉義縣,大林鎮,0182,454,254,708,60,768,1642,46.77%,27.65%,1
嘉義縣,大林鎮,0183,464,265,729,45,774,1465,52.83%,31.67%,1
嘉義縣,大林鎮,0184,238,144,382,35,417,928,44.94%,25.65%,1
嘉義縣,大林鎮,0185,80,57,137,22,159,361,44.04%,22.16%,1
嘉義縣,大林鎮,0186,287,117,404,15,419,814,51.47%,35.26%,1
嘉義縣,大林鎮,0187,439,302,741,33,774,1579,49.02%,27.8%,1
嘉義縣,大林鎮,0188,577,424,1001,65,1066,2041,52.23%,28.27%,1
嘉義縣,大林鎮,0189,276,167,443,36,479,931,51.45%,29.65%,1
嘉義縣,大林鎮,0190,209,123,332,30,362,675,53.63%,30.96%,1
嘉義縣,大林鎮,0191,214,113,327,18,345,655,52.67%,32.67%,1
嘉義縣,大林鎮,0192,241,141,382,34,416,833,49.94%,28.93%,1
嘉義縣,大林鎮,0193,281,186,467,33,500,832,60.1%,33.77%,1
嘉義縣,民雄鄉,0093,423,270,693,39,732,1267,57.77%,33.39%,1
嘉義縣,民雄鄉,0094,304,191,495,31,526,1030,51.07%,29.51%,1
嘉義縣,民雄鄉,0095,576,315,891,58,949,1590,59.69%,36.23%,1
嘉義縣,民雄鄉,0096,520,331,851,17,868,1673,51.88%,31.08%,1
嘉義縣,民雄鄉,0097,556,396,952,39,991,1718,57.68%,32.36%,1
嘉義縣,民雄鄉,0098,347,238,585,36,621,1040,59.71%,33.37%,1
嘉義縣,民雄鄉,0099,333,232,565,29,594,1100,54%,30.27%,1
嘉義縣,民雄鄉,0100,449,299,748,59,807,1559,51.76%,28.8%,1
嘉義縣,民雄鄉,0101,513,385,898,55,953,1862,51.18%,27.55%,1
嘉義縣,民雄鄉,0102,438,315,753,56,809,1435,56.38%,30.52%,1
嘉義縣,民雄鄉,0103,528,305,833,90,923,1751,52.71%,30.15%,1
嘉義縣,民雄鄉,0104,304,189,493,44,537,933,57.56%,32.58%,1
嘉義縣,民雄鄉,0105,290,199,489,28,517,827,62.52%,35.07%,1
嘉義縣,民雄鄉,0106,250,147,397,28,425,843,50.42%,29.66%,1
嘉義縣,民雄鄉,0107,567,331,898,38,936,1774,52.76%,31.96%,1
嘉義縣,民雄鄉,0108,107,64,171,11,182,385,47.27%,27.79%,1
嘉義縣,民雄鄉,0109,450,284,734,39,773,1306,59.19%,34.46%,1
嘉義縣,民雄鄉,0110,168,124,292,28,320,535,59.81%,31.4%,1
嘉義縣,民雄鄉,0111,336,245,581,41,622,1055,58.96%,31.85%,1
嘉義縣,民雄鄉,0112,488,280,768,39,807,1476,54.67%,33.06%,1
嘉義縣,民雄鄉,0113,514,256,770,29,799,1583,50.47%,32.47%,1
嘉義縣,民雄鄉,0114,188,159,347,23,370,758,48.81%,24.8%,1
嘉義縣,民雄鄉,0115,398,250,648,29,677,1354,50%,29.39%,1
嘉義縣,民雄鄉,0116,433,220,653,54,707,1202,58.82%,36.02%,1
嘉義縣,民雄鄉,0117,398,217,615,34,649,1175,55.23%,33.87%,1
嘉義縣,民雄鄉,0118,432,271,703,27,730,1423,51.3%,30.36%,1
嘉義縣,民雄鄉,0119,538,298,836,20,856,1612,53.1%,33.37%,1
嘉義縣,民雄鄉,0120,552,375,927,23,950,1695,56.05%,32.57%,1
嘉義縣,民雄鄉,0121,503,282,785,33,818,1665,49.13%,30.21%,1
嘉義縣,民雄鄉,0122,307,161,468,34,502,1019,49.26%,30.13%,1
嘉義縣,民雄鄉,0123,421,249,670,37,707,1352,52.29%,31.14%,1
嘉義縣,民雄鄉,0124,478,361,839,65,904,1620,55.8%,29.51%,1
嘉義縣,民雄鄉,0125,235,199,434,40,474,943,50.27%,24.92%,1
嘉義縣,民雄鄉,0126,456,304,760,41,801,1720,46.57%,26.51%,1
嘉義縣,民雄鄉,0127,588,311,899,60,959,1875,51.15%,31.36%,1
嘉義縣,民雄鄉,0128,409,288,697,35,732,1305,56.09%,31.34%,1
嘉義縣,民雄鄉,0129,425,286,711,43,754,1441,52.32%,29.49%,1
嘉義縣,民雄鄉,0130,485,275,760,39,799,1413,56.55%,34.32%,1
嘉義縣,民雄鄉,0131,511,281,792,46,838,1560,53.72%,32.76%,1
嘉義縣,民雄鄉,0132,656,410,1066,54,1120,2004,55.89%,32.73%,1
嘉義縣,民雄鄉,0133,467,294,761,48,809,1354,59.75%,34.49%,1
嘉義縣,民雄鄉,0134,369,208,577,20,597,1076,55.48%,34.29%,1
嘉義縣,民雄鄉,0135,560,300,860,67,927,1629,56.91%,34.38%,1
嘉義縣,民雄鄉,0136,623,351,974,41,1015,1977,51.34%,31.51%,1
嘉義縣,民雄鄉,0137,400,249,649,47,696,1295,53.75%,30.89%,1
嘉義縣,溪口鄉,0194,457,256,713,52,765,1318,58.04%,34.67%,1
嘉義縣,溪口鄉,0195,221,150,371,29,400,677,59.08%,32.64%,1
嘉義縣,溪口鄉,0196,138,72,210,12,222,417,53.24%,33.09%,1
嘉義縣,溪口鄉,0197,85,61,146,16,162,273,59.34%,31.14%,1
嘉義縣,溪口鄉,0198,314,183,497,37,534,908,58.81%,34.58%,1
嘉義縣,溪口鄉,0199,100,73,173,7,180,386,46.63%,25.91%,1
嘉義縣,溪口鄉,0200,324,212,536,42,578,1039,55.63%,31.18%,1
嘉義縣,溪口鄉,0201,187,115,302,31,333,708,47.03%,26.41%,1
嘉義縣,溪口鄉,0202,272,176,448,19,467,909,51.38%,29.92%,1
嘉義縣,溪口鄉,0203,258,144,402,33,435,786,55.34%,32.82%,1
嘉義縣,溪口鄉,0204,261,150,411,15,426,807,52.79%,32.34%,1
嘉義縣,溪口鄉,0205,337,158,495,21,516,1168,44.18%,28.85%,1
嘉義縣,溪口鄉,0206,370,185,555,39,594,1052,56.46%,35.17%,1
嘉義縣,溪口鄉,0207,159,101,260,25,285,565,50.44%,28.14%,1
嘉義縣,溪口鄉,0208,129,63,192,18,210,388,54.12%,33.25%,1
嘉義縣,溪口鄉,0209,209,100,309,17,326,701,46.5%,29.81%,1
嘉義縣,溪口鄉,0210,265,164,429,32,461,1003,45.96%,26.42%,1
嘉義縣,新港鄉,0138,364,208,572,30,602,1087,55.38%,33.49%,1
嘉義縣,新港鄉,0139,431,243,674,44,718,1116,64.34%,38.62%,1
嘉義縣,新港鄉,0140,261,133,394,19,413,740,55.81%,35.27%,1
嘉義縣,新港鄉,0141,245,149,394,46,440,827,53.2%,29.63%,1
嘉義縣,新港鄉,0142,275,133,408,31,439,704,62.36%,39.06%,1
嘉義縣,新港鄉,0143,264,182,446,39,485,768,63.15%,34.38%,1
嘉義縣,新港鄉,0144,261,164,425,35,460,761,60.45%,34.3%,1
嘉義縣,新港鄉,0145,231,176,407,46,453,850,53.29%,27.18%,1
嘉義縣,新港鄉,0146,406,249,655,56,711,1327,53.58%,30.6%,1
嘉義縣,新港鄉,0147,247,164,411,12,423,756,55.95%,32.67%,1
嘉義縣,新港鄉,0148,269,154,423,44,467,816,57.23%,32.97%,1
嘉義縣,新港鄉,0149,206,125,331,23,354,667,53.07%,30.88%,1
嘉義縣,新港鄉,0150,284,191,475,42,517,942,54.88%,30.15%,1
嘉義縣,新港鄉,0151,249,158,407,37,444,918,48.37%,27.12%,1
嘉義縣,新港鄉,0152,178,86,264,11,275,554,49.64%,32.13%,1
嘉義縣,新港鄉,0153,270,160,430,36,466,929,50.16%,29.06%,1
嘉義縣,新港鄉,0154,103,76,179,28,207,487,42.51%,21.15%,1
嘉義縣,新港鄉,0155,144,98,242,28,270,487,55.44%,29.57%,1
嘉義縣,新港鄉,0156,236,167,403,40,443,836,52.99%,28.23%,1
嘉義縣,新港鄉,0157,255,187,442,33,475,845,56.21%,30.18%,1
嘉義縣,新港鄉,0158,252,175,427,40,467,834,56%,30.22%,1
嘉義縣,新港鄉,0159,227,161,388,37,425,753,56.44%,30.15%,1
嘉義縣,新港鄉,0160,394,259,653,52,705,1328,53.09%,29.67%,1
嘉義縣,新港鄉,0161,301,220,521,37,558,969,57.59%,31.06%,1
嘉義縣,新港鄉,0162,333,247,580,44,624,1043,59.83%,31.93%,1
嘉義縣,新港鄉,0163,507,294,801,44,845,1400,60.36%,36.21%,1
嘉義縣,新港鄉,0164,258,119,377,21,398,1017,39.13%,25.37%,1
嘉義縣,新港鄉,0165,354,166,520,31,551,1132,48.67%,31.27%,1
嘉義縣,新港鄉,0166,294,206,500,44,544,1037,52.46%,28.35%,1
嘉義縣,新港鄉,0167,192,100,292,40,332,563,58.97%,34.1%,1
嘉義縣,新港鄉,0168,272,160,432,26,458,849,53.95%,32.04%,1
嘉義縣,六腳鄉,0268,312,179,491,32,523,1165,44.89%,26.78%,1
嘉義縣,六腳鄉,0269,182,107,289,15,304,825,36.85%,22.06%,1
嘉義縣,六腳鄉,0270,220,145,365,30,395,850,46.47%,25.88%,1
嘉義縣,六腳鄉,0271,73,43,116,16,132,222,59.46%,32.88%,1
嘉義縣,六腳鄉,0272,362,211,573,34,607,1216,49.92%,29.77%,1
嘉義縣,六腳鄉,0273,276,170,446,38,484,1200,40.33%,23%,1
嘉義縣,六腳鄉,0274,236,139,375,44,419,877,47.78%,26.91%,1
嘉義縣,六腳鄉,0275,163,84,247,31,278,644,43.17%,25.31%,1
嘉義縣,六腳鄉,0276,122,103,225,11,236,594,39.73%,20.54%,1
嘉義縣,六腳鄉,0277,30,18,48,2,50,167,29.94%,17.96%,1
嘉義縣,六腳鄉,0278,33,38,71,3,74,204,36.27%,16.18%,1
嘉義縣,六腳鄉,0279,49,43,92,2,94,234,40.17%,20.94%,1
嘉義縣,六腳鄉,0280,93,43,136,10,146,361,40.44%,25.76%,1
嘉義縣,六腳鄉,0281,193,109,302,35,337,592,56.93%,32.6%,1
嘉義縣,六腳鄉,0282,176,114,290,26,316,619,51.05%,28.43%,1
嘉義縣,六腳鄉,0283,164,101,265,24,289,714,40.48%,22.97%,1
嘉義縣,六腳鄉,0284,300,204,504,36,540,1051,51.38%,28.54%,1
嘉義縣,六腳鄉,0285,283,173,456,31,487,934,52.14%,30.3%,1
嘉義縣,六腳鄉,0286,277,203,480,39,519,1044,49.71%,26.53%,1
嘉義縣,六腳鄉,0287,404,231,635,36,671,1476,45.46%,27.37%,1
嘉義縣,六腳鄉,0288,129,87,216,19,235,618,38.03%,20.87%,1
嘉義縣,六腳鄉,0289,108,34,142,20,162,478,33.89%,22.59%,1
嘉義縣,六腳鄉,0290,149,64,213,22,235,642,36.6%,23.21%,1
嘉義縣,六腳鄉,0291,185,114,299,5,304,883,34.43%,20.95%,1
嘉義縣,六腳鄉,0292,159,95,254,3,257,739,34.78%,21.52%,1
嘉義縣,六腳鄉,0293,126,75,201,17,218,554,39.35%,22.74%,1
嘉義縣,六腳鄉,0294,133,80,213,19,232,649,35.75%,20.49%,1
嘉義縣,六腳鄉,0295,165,82,247,26,273,689,39.62%,23.95%,1
嘉義縣,六腳鄉,0296,95,72,167,15,182,455,40%,20.88%,1
嘉義縣,六腳鄉,0297,20,16,36,2,38,125,30.4%,16%,1
嘉義縣,東石鄉,0298,569,301,870,66,936,1915,48.88%,29.71%,1
嘉義縣,東石鄉,0299,191,146,337,44,381,938,40.62%,20.36%,1
嘉義縣,東石鄉,0300,258,148,406,26,432,1366,31.63%,18.89%,1
嘉義縣,東石鄉,0301,443,226,669,10,679,1676,40.51%,26.43%,1
嘉義縣,東石鄉,0302,279,146,425,58,483,1151,41.96%,24.24%,1
嘉義縣,東石鄉,0303,185,105,290,33,323,716,45.11%,25.84%,1
嘉義縣,東石鄉,0304,100,47,147,7,154,387,39.79%,25.84%,1
嘉義縣,東石鄉,0305,159,96,255,20,275,864,31.83%,18.4%,1
嘉義縣,東石鄉,0306,183,111,294,20,314,910,34.51%,20.11%,1
嘉義縣,東石鄉,0307,175,108,283,15,298,760,39.21%,23.03%,1
嘉義縣,東石鄉,0308,63,20,83,6,89,166,53.61%,37.95%,1
嘉義縣,東石鄉,0309,47,24,71,9,80,212,37.74%,22.17%,1
嘉義縣,東石鄉,0310,212,106,318,29,347,993,34.94%,21.35%,1
嘉義縣,東石鄉,0311,66,45,111,11,122,306,39.87%,21.57%,1
嘉義縣,東石鄉,0312,250,127,377,34,411,1046,39.29%,23.9%,1
嘉義縣,東石鄉,0313,44,34,78,12,90,235,38.3%,18.72%,1
嘉義縣,東石鄉,0314,307,184,491,67,558,1226,45.51%,25.04%,1
嘉義縣,東石鄉,0315,187,134,321,45,366,843,43.42%,22.18%,1
嘉義縣,東石鄉,0316,186,96,282,20,302,693,43.58%,26.84%,1
嘉義縣,東石鄉,0317,260,118,378,34,412,839,49.11%,30.99%,1
嘉義縣,東石鄉,0318,98,48,146,12,158,363,43.53%,27%,1
嘉義縣,東石鄉,0319,69,38,107,8,115,321,35.83%,21.5%,1
嘉義縣,東石鄉,0320,347,186,533,63,596,1083,55.03%,32.04%,1
嘉義縣,東石鄉,0321,240,137,377,41,418,901,46.39%,26.64%,1
嘉義縣,東石鄉,0322,300,126,426,29,455,1216,37.42%,24.67%,1
嘉義縣,東石鄉,0323,139,72,211,39,250,418,59.81%,33.25%,1
嘉義縣,東石鄉,0324,96,55,151,10,161,371,43.4%,25.88%,1
嘉義縣,義竹鄉,0354,147,65,212,21,233,482,48.34%,30.5%,1
嘉義縣,義竹鄉,0355,75,46,121,13,134,223,60.09%,33.63%,1
嘉義縣,義竹鄉,0356,458,311,769,69,838,1529,54.81%,29.95%,1
嘉義縣,義竹鄉,0357,360,267,627,43,670,1175,57.02%,30.64%,1
嘉義縣,義竹鄉,0358,325,187,512,40,552,886,62.3%,36.68%,1
嘉義縣,義竹鄉,0359,190,123,313,23,336,743,45.22%,25.57%,1
嘉義縣,義竹鄉,0360,364,247,611,70,681,1236,55.1%,29.45%,1
嘉義縣,義竹鄉,0361,106,74,180,14,194,377,51.46%,28.12%,1
嘉義縣,義竹鄉,0362,87,55,142,14,156,338,46.15%,25.74%,1
嘉義縣,義竹鄉,0363,40,14,54,6,60,102,58.82%,39.22%,1
嘉義縣,義竹鄉,0364,218,124,342,23,365,763,47.84%,28.57%,1
嘉義縣,義竹鄉,0365,142,90,232,20,252,429,58.74%,33.1%,1
嘉義縣,義竹鄉,0366,130,71,201,13,214,427,50.12%,30.44%,1
嘉義縣,義竹鄉,0367,186,109,295,41,336,607,55.35%,30.64%,1
嘉義縣,義竹鄉,0368,396,257,653,46,699,1486,47.04%,26.65%,1
嘉義縣,義竹鄉,0369,285,154,439,45,484,835,57.96%,34.13%,1
嘉義縣,義竹鄉,0370,189,123,312,43,355,816,43.5%,23.16%,1
嘉義縣,義竹鄉,0371,202,146,348,37,385,833,46.22%,24.25%,1
嘉義縣,義竹鄉,0372,137,62,199,14,213,433,49.19%,31.64%,1
嘉義縣,義竹鄉,0373,139,102,241,8,249,558,44.62%,24.91%,1
嘉義縣,義竹鄉,0374,175,111,286,31,317,602,52.66%,29.07%,1
嘉義縣,義竹鄉,0375,37,17,54,2,56,140,40%,26.43%,1
嘉義縣,義竹鄉,0376,105,60,165,20,185,393,47.07%,26.72%,1
嘉義縣,義竹鄉,0377,272,4,276,18,294,585,50.26%,46.5%,1
嘉義縣,義竹鄉,0378,131,68,199,4,203,526,38.59%,24.9%,1
嘉義縣,義竹鄉,0379,50,24,74,3,77,123,62.6%,40.65%,1
嘉義縣,鹿草鄉,0034,127,83,210,34,244,522,46.74%,24.33%,1
嘉義縣,鹿草鄉,0035,154,127,281,23,304,563,54%,27.35%,1
嘉義縣,鹿草鄉,0036,364,240,604,47,651,1304,49.92%,27.91%,1
嘉義縣,鹿草鄉,0037,365,266,631,29,660,1312,50.3%,27.82%,1
嘉義縣,鹿草鄉,0038,95,53,148,1,149,320,46.56%,29.69%,1
嘉義縣,鹿草鄉,0039,58,49,107,3,110,418,26.32%,13.88%,1
嘉義縣,鹿草鄉,0040,223,174,397,54,451,1025,44%,21.76%,1
嘉義縣,鹿草鄉,0041,99,73,172,23,195,451,43.24%,21.95%,1
嘉義縣,鹿草鄉,0042,257,126,383,61,444,830,53.49%,30.96%,1
嘉義縣,鹿草鄉,0043,307,148,455,44,499,1050,47.52%,29.24%,1
嘉義縣,鹿草鄉,0044,211,148,359,42,401,972,41.26%,21.71%,1
嘉義縣,鹿草鄉,0045,266,147,413,32,445,962,46.26%,27.65%,1
嘉義縣,鹿草鄉,0046,185,129,314,36,350,678,51.62%,27.29%,1
嘉義縣,鹿草鄉,0047,91,35,126,12,138,262,52.67%,34.73%,1
嘉義縣,鹿草鄉,0048,214,150,364,34,398,906,43.93%,23.62%,1
嘉義縣,鹿草鄉,0049,67,38,105,5,110,306,35.95%,21.9%,1
嘉義縣,鹿草鄉,0050,324,184,508,42,550,1062,51.79%,30.51%,1
嘉義縣,鹿草鄉,0051,118,73,191,14,205,373,54.96%,31.64%,1
嘉義縣,鹿草鄉,0052,99,65,164,11,175,324,54.01%,30.56%,1
嘉義縣,鹿草鄉,0053,89,52,141,9,150,297,50.51%,29.97%,1
嘉義縣,水上鄉,0054,320,182,502,19,521,1024,50.88%,31.25%,1
嘉義縣,水上鄉,0055,333,253,586,29,615,1015,60.59%,32.81%,1
嘉義縣,水上鄉,0056,593,317,910,40,950,1932,49.17%,30.69%,1
嘉義縣,水上鄉,0057,374,286,660,28,688,1170,58.8%,31.97%,1
嘉義縣,水上鄉,0058,450,267,717,49,766,1305,58.7%,34.48%,1
嘉義縣,水上鄉,0059,325,227,552,43,595,1242,47.91%,26.17%,1
嘉義縣,水上鄉,0060,89,60,149,17,166,324,51.23%,27.47%,1
嘉義縣,水上鄉,0061,206,111,317,14,331,622,53.22%,33.12%,1
嘉義縣,水上鄉,0062,364,225,589,52,641,1216,52.71%,29.93%,1
嘉義縣,水上鄉,0063,327,218,545,19,564,1020,55.29%,32.06%,1
嘉義縣,水上鄉,0064,274,184,458,25,483,771,62.65%,35.54%,1
嘉義縣,水上鄉,0065,162,102,264,15,279,441,63.27%,36.73%,1
嘉義縣,水上鄉,0066,266,127,393,26,419,626,66.93%,42.49%,1
嘉義縣,水上鄉,0067,192,136,328,14,342,570,60%,33.68%,1
嘉義縣,水上鄉,0068,102,76,178,14,192,368,52.17%,27.72%,1
嘉義縣,水上鄉,0069,305,179,484,56,540,1037,52.07%,29.41%,1
嘉義縣,水上鄉,0070,341,202,543,39,582,1065,54.65%,32.02%,1
嘉義縣,水上鄉,0071,281,183,464,45,509,802,63.47%,35.04%,1
嘉義縣,水上鄉,0072,605,380,985,45,1030,1948,52.87%,31.06%,1
嘉義縣,水上鄉,0073,333,163,496,35,531,1028,51.65%,32.39%,1
嘉義縣,水上鄉,0074,214,136,350,25,375,641,58.5%,33.39%,1
嘉義縣,水上鄉,0075,152,81,233,13,246,408,60.29%,37.25%,1
嘉義縣,水上鄉,0076,263,166,429,30,459,794,57.81%,33.12%,1
嘉義縣,水上鄉,0077,143,115,258,15,273,569,47.98%,25.13%,1
嘉義縣,水上鄉,0078,225,200,425,28,453,806,56.2%,27.92%,1
嘉義縣,水上鄉,0079,281,235,516,44,560,960,58.33%,29.27%,1
嘉義縣,水上鄉,0080,654,417,1071,43,1114,2035,54.74%,32.14%,1
嘉義縣,水上鄉,0081,639,395,1034,57,1091,1987,54.91%,32.16%,1
嘉義縣,水上鄉,0082,403,209,612,39,651,1154,56.41%,34.92%,1
嘉義縣,水上鄉,0083,620,449,1069,60,1129,2208,51.13%,28.08%,1
嘉義縣,水上鄉,0084,577,335,912,36,948,2102,45.1%,27.45%,1
嘉義縣,水上鄉,0085,418,206,624,50,674,1309,51.49%,31.93%,1
嘉義縣,水上鄉,0086,560,300,860,49,909,1671,54.4%,33.51%,1
嘉義縣,水上鄉,0087,245,167,412,37,449,822,54.62%,29.81%,1
嘉義縣,水上鄉,0088,603,288,891,41,932,1772,52.6%,34.03%,1
嘉義縣,水上鄉,0089,596,376,972,49,1021,1919,53.2%,31.06%,1
嘉義縣,水上鄉,0090,272,172,444,13,457,912,50.11%,29.82%,1
嘉義縣,水上鄉,0091,332,166,498,20,518,992,52.22%,33.47%,1
嘉義縣,水上鄉,0092,305,228,533,39,572,1270,45.04%,24.02%,1
嘉義縣,中埔鄉,0380,228,196,424,18,442,1046,42.26%,21.8%,1
嘉義縣,中埔鄉,0381,509,288,797,48,845,1788,47.26%,28.47%,1
嘉義縣,中埔鄉,0382,470,308,778,33,811,1730,46.88%,27.17%,1
嘉義縣,中埔鄉,0383,456,284,740,39,779,1581,49.27%,28.84%,1
嘉義縣,中埔鄉,0384,419,233,652,28,680,1594,42.66%,26.29%,1
嘉義縣,中埔鄉,0385,524,368,892,31,923,1801,51.25%,29.09%,1
嘉義縣,中埔鄉,0386,570,308,878,45,923,1862,49.57%,30.61%,1
嘉義縣,中埔鄉,0387,530,302,832,23,855,1803,47.42%,29.4%,1
嘉義縣,中埔鄉,0388,495,253,748,32,780,1481,52.67%,33.42%,1
嘉義縣,中埔鄉,0389,404,284,688,42,730,1366,53.44%,29.58%,1
嘉義縣,中埔鄉,0390,434,247,681,38,719,1599,44.97%,27.14%,1
嘉義縣,中埔鄉,0391,365,225,590,30,620,1196,51.84%,30.52%,1
嘉義縣,中埔鄉,0392,482,308,790,41,831,1809,45.94%,26.64%,1
嘉義縣,中埔鄉,0393,282,173,455,18,473,953,49.63%,29.59%,1
嘉義縣,中埔鄉,0394,384,233,617,54,671,1441,46.56%,26.65%,1
嘉義縣,中埔鄉,0395,512,309,821,50,871,1882,46.28%,27.21%,1
嘉義縣,中埔鄉,0396,432,268,700,23,723,1470,49.18%,29.39%,1
嘉義縣,中埔鄉,0397,402,306,708,50,758,1699,44.61%,23.66%,1
嘉義縣,中埔鄉,0398,86,82,168,10,178,422,42.18%,20.38%,1
嘉義縣,中埔鄉,0399,291,193,484,34,518,1030,50.29%,28.25%,1
嘉義縣,中埔鄉,0400,252,166,418,24,442,879,50.28%,28.67%,1
嘉義縣,中埔鄉,0401,216,147,363,14,377,828,45.53%,26.09%,1
嘉義縣,中埔鄉,0402,277,203,480,27,507,881,57.55%,31.44%,1
嘉義縣,中埔鄉,0403,88,52,140,8,148,296,50%,29.73%,1
嘉義縣,中埔鄉,0404,252,180,432,47,479,979,48.93%,25.74%,1
嘉義縣,中埔鄉,0405,313,229,542,35,577,1268,45.5%,24.68%,1
嘉義縣,中埔鄉,0406,134,85,219,11,230,670,34.33%,20%,1
嘉義縣,中埔鄉,0407,223,161,384,47,431,754,57.16%,29.58%,1
嘉義縣,中埔鄉,0408,207,123,330,28,358,648,55.25%,31.94%,1
嘉義縣,中埔鄉,0409,141,148,289,13,302,741,40.76%,19.03%,1
嘉義縣,中埔鄉,0410,152,85,237,6,243,518,46.91%,29.34%,1
嘉義縣,中埔鄉,0411,124,89,213,31,244,482,50.62%,25.73%,1
嘉義縣,中埔鄉,0412,80,73,153,5,158,348,45.4%,22.99%,1
嘉義縣,中埔鄉,0413,80,61,141,8,149,294,50.68%,27.21%,1
嘉義縣,竹崎鄉,0414,429,263,692,41,733,1312,55.87%,32.7%,1
嘉義縣,竹崎鄉,0415,418,263,681,15,696,1210,57.52%,34.55%,1
嘉義縣,竹崎鄉,0416,314,209,523,31,554,991,55.9%,31.69%,1
嘉義縣,竹崎鄉,0417,392,218,610,42,652,1207,54.02%,32.48%,1
嘉義縣,竹崎鄉,0418,224,137,361,11,372,752,49.47%,29.79%,1
嘉義縣,竹崎鄉,0419,295,167,462,32,494,833,59.3%,35.41%,1
嘉義縣,竹崎鄉,0420,418,230,648,45,693,1220,56.8%,34.26%,1
嘉義縣,竹崎鄉,0421,239,136,375,12,387,616,62.82%,38.8%,1
嘉義縣,竹崎鄉,0422,317,160,477,54,531,1031,51.5%,30.75%,1
嘉義縣,竹崎鄉,0423,398,246,644,27,671,1292,51.93%,30.8%,1
嘉義縣,竹崎鄉,0424,655,396,1051,52,1103,1995,55.29%,32.83%,1
嘉義縣,竹崎鄉,0425,593,323,916,35,951,1996,47.65%,29.71%,1
嘉義縣,竹崎鄉,0426,447,277,724,39,763,1449,52.66%,30.85%,1
嘉義縣,竹崎鄉,0427,467,269,736,34,770,1420,54.23%,32.89%,1
嘉義縣,竹崎鄉,0428,549,289,838,49,887,1590,55.79%,34.53%,1
嘉義縣,竹崎鄉,0429,219,142,361,30,391,771,50.71%,28.4%,1
嘉義縣,竹崎鄉,0430,269,180,449,31,480,1014,47.34%,26.53%,1
嘉義縣,竹崎鄉,0431,83,47,130,8,138,327,42.2%,25.38%,1
嘉義縣,竹崎鄉,0432,174,162,336,27,363,687,52.84%,25.33%,1
嘉義縣,竹崎鄉,0433,181,124,305,22,327,641,51.01%,28.24%,1
嘉義縣,竹崎鄉,0434,171,89,260,4,264,474,55.7%,36.08%,1
嘉義縣,竹崎鄉,0435,99,82,181,12,193,383,50.39%,25.85%,1
嘉義縣,竹崎鄉,0436,201,148,349,30,379,619,61.23%,32.47%,1
嘉義縣,竹崎鄉,0437,57,36,93,6,99,214,46.26%,26.64%,1
嘉義縣,竹崎鄉,0438,445,320,765,61,826,1568,52.68%,28.38%,1
嘉義縣,竹崎鄉,0439,175,123,298,17,315,658,47.87%,26.6%,1
嘉義縣,竹崎鄉,0440,138,94,232,23,255,434,58.76%,31.8%,1
嘉義縣,竹崎鄉,0441,309,171,480,22,502,917,54.74%,33.7%,1
嘉義縣,竹崎鄉,0442,245,196,441,40,481,981,49.03%,24.97%,1
嘉義縣,竹崎鄉,0443,231,123,354,17,371,789,47.02%,29.28%,1
嘉義縣,竹崎鄉,0444,17,9,26,2,28,108,25.93%,15.74%,1
嘉義縣,竹崎鄉,0445,48,25,73,2,75,235,31.91%,20.43%,1
嘉義縣,竹崎鄉,0446,86,51,137,5,142,331,42.9%,25.98%,1
嘉義縣,竹崎鄉,0447,163,106,269,13,282,450,62.67%,36.22%,1
嘉義縣,竹崎鄉,0448,116,52,168,20,188,462,40.69%,25.11%,1
嘉義縣,竹崎鄉,0449,68,25,93,15,108,251,43.03%,27.09%,1
嘉義縣,梅山鄉,0211,308,219,527,24,551,1041,52.93%,29.59%,1
嘉義縣,梅山鄉,0212,426,275,701,56,757,1245,60.8%,34.22%,1
嘉義縣,梅山鄉,0213,336,213,549,32,581,917,63.36%,36.64%,1
嘉義縣,梅山鄉,0214,584,40,624,41,665,1189,55.93%,49.12%,1
嘉義縣,梅山鄉,0215,442,290,732,45,777,1388,55.98%,31.84%,1
嘉義縣,梅山鄉,0216,571,383,954,43,997,1827,54.57%,31.25%,1
嘉義縣,梅山鄉,0217,184,123,307,36,343,545,62.94%,33.76%,1
嘉義縣,梅山鄉,0218,104,56,160,23,183,407,44.96%,25.55%,1
嘉義縣,梅山鄉,0219,222,135,357,17,374,636,58.81%,34.91%,1
嘉義縣,梅山鄉,0220,186,122,308,32,340,576,59.03%,32.29%,1
嘉義縣,梅山鄉,0221,549,332,881,52,933,1674,55.73%,32.8%,1
嘉義縣,梅山鄉,0222,229,155,384,11,395,858,46.04%,26.69%,1
嘉義縣,梅山鄉,0223,199,115,314,18,332,526,63.12%,37.83%,1
嘉義縣,梅山鄉,0224,87,74,161,24,185,372,49.73%,23.39%,1
嘉義縣,梅山鄉,0225,138,97,235,19,254,506,50.2%,27.27%,1
嘉義縣,梅山鄉,0226,169,101,270,38,308,433,71.13%,39.03%,1
嘉義縣,梅山鄉,0227,98,51,149,18,167,404,41.34%,24.26%,1
嘉義縣,梅山鄉,0228,65,75,140,8,148,293,50.51%,22.18%,1
嘉義縣,梅山鄉,0229,217,174,391,57,448,712,62.92%,30.48%,1
嘉義縣,梅山鄉,0230,225,116,341,32,373,602,61.96%,37.38%,1
嘉義縣,梅山鄉,0231,128,99,227,25,252,515,48.93%,24.85%,1
嘉義縣,梅山鄉,0232,102,53,155,9,164,417,39.33%,24.46%,1
嘉義縣,番路鄉,0450,398,267,665,48,713,1174,60.73%,33.9%,1
嘉義縣,番路鄉,0451,151,117,268,12,280,449,62.36%,33.63%,1
嘉義縣,番路鄉,0452,244,185,429,32,461,753,61.22%,32.4%,1
嘉義縣,番路鄉,0453,132,101,233,30,263,551,47.73%,23.96%,1
嘉義縣,番路鄉,0454,550,392,942,64,1006,1791,56.17%,30.71%,1
嘉義縣,番路鄉,0455,303,194,497,41,538,849,63.37%,35.69%,1
嘉義縣,番路鄉,0456,299,176,475,28,503,866,58.08%,34.53%,1
嘉義縣,番路鄉,0457,264,148,412,28,440,800,55%,33%,1
嘉義縣,番路鄉,0458,136,96,232,24,256,444,57.66%,30.63%,1
嘉義縣,番路鄉,0459,178,76,254,12,266,635,41.89%,28.03%,1
嘉義縣,番路鄉,0460,102,34,136,13,149,319,46.71%,31.97%,1
嘉義縣,番路鄉,0461,242,109,351,28,379,642,59.03%,37.69%,1
嘉義縣,番路鄉,0462,139,77,216,16,232,509,45.58%,27.31%,1
嘉義縣,番路鄉,0463,67,26,93,1,94,162,58.02%,41.36%,1
嘉義縣,番路鄉,0464,73,43,116,6,122,212,57.55%,34.43%,1
嘉義縣,大埔鄉,0465,469,291,760,48,808,1468,55.04%,31.95%,1
嘉義縣,大埔鄉,0466,79,43,122,4,126,320,39.38%,24.69%,1
嘉義縣,大埔鄉,0467,87,84,171,4,175,304,57.57%,28.62%,1
嘉義縣,大埔鄉,0468,60,33,93,0,93,184,50.54%,32.61%,1
嘉義縣,大埔鄉,0469,82,69,151,6,157,234,67.09%,35.04%,1
嘉義縣,大埔鄉,0470,149,105,254,10,264,495,53.33%,30.1%,1
嘉義縣,大埔鄉,0471,70,37,107,6,113,199,56.78%,35.18%,1
嘉義縣,大埔鄉,0472,63,45,108,7,115,226,50.88%,27.88%,1
嘉義縣,大埔鄉,0473,221,115,336,13,349,569,61.34%,38.84%,1
嘉義縣,阿里山鄉,0474,106,72,178,4,182,371,49.06%,28.57%,1
嘉義縣,阿里山鄉,0475,55,26,81,4,85,197,43.15%,27.92%,1
嘉義縣,阿里山鄉,0476,36,32,68,5,73,152,48.03%,23.68%,1
嘉義縣,阿里山鄉,0477,49,25,74,5,79,231,34.2%,21.21%,1
嘉義縣,阿里山鄉,0478,9,11,20,1,21,72,29.17%,12.5%,1
嘉義縣,阿里山鄉,0479,83,43,126,3,129,311,41.48%,26.69%,1
嘉義縣,阿里山鄉,0480,100,57,157,6,163,306,53.27%,32.68%,1
嘉義縣,阿里山鄉,0481,251,183,434,11,445,970,45.88%,25.88%,1
嘉義縣,阿里山鄉,0482,242,183,425,29,454,827,54.9%,29.26%,1
嘉義縣,阿里山鄉,0483,67,62,129,2,131,238,55.04%,28.15%,1
嘉義縣,阿里山鄉,0484,84,61,145,8,153,479,31.94%,17.54%,1
嘉義縣,阿里山鄉,0485,78,42,120,7,127,291,43.64%,26.8%,1
嘉義縣,阿里山鄉,0486,117,38,155,5,160,246,65.04%,47.56%,1
屏東縣,屏東市,0001,72,47,119,9,128,237,54.01%,30.38%,1
屏東縣,屏東市,0002,95,52,147,19,166,294,56.46%,32.31%,1
屏東縣,屏東市,0003,164,141,305,10,315,582,54.12%,28.18%,1
屏東縣,屏東市,0004,237,167,404,16,420,713,58.91%,33.24%,1
屏東縣,屏東市,0005,181,119,300,19,319,572,55.77%,31.64%,1
屏東縣,屏東市,0006,170,105,275,6,281,455,61.76%,37.36%,1
屏東縣,屏東市,0007,77,67,144,1,145,249,58.23%,30.92%,1
屏東縣,屏東市,0008,403,215,618,29,647,1315,49.2%,30.65%,1
屏東縣,屏東市,0009,340,292,632,37,669,1373,48.73%,24.76%,1
屏東縣,屏東市,0010,249,172,421,23,444,713,62.27%,34.92%,1
屏東縣,屏東市,0011,209,131,340,29,369,573,64.4%,36.47%,1
屏東縣,屏東市,0012,116,71,187,16,203,297,68.35%,39.06%,1
屏東縣,屏東市,0013,164,100,264,17,281,409,68.7%,40.1%,1
屏東縣,屏東市,0014,83,65,148,12,160,286,55.94%,29.02%,1
屏東縣,屏東市,0015,156,96,252,9,261,421,62%,37.05%,1
屏東縣,屏東市,0016,201,105,306,16,322,569,56.59%,35.33%,1
屏東縣,屏東市,0017,118,117,235,13,248,459,54.03%,25.71%,1
屏東縣,屏東市,0018,241,170,411,21,432,672,64.29%,35.86%,1
屏東縣,屏東市,0019,206,181,387,36,423,668,63.32%,30.84%,1
屏東縣,屏東市,0020,153,90,243,12,255,411,62.04%,37.23%,1
屏東縣,屏東市,0021,263,159,422,21,443,768,57.68%,34.24%,1
屏東縣,屏東市,0022,242,177,419,19,438,786,55.73%,30.79%,1
屏東縣,屏東市,0023,325,175,500,29,529,890,59.44%,36.52%,1
屏東縣,屏東市,0024,475,254,729,32,761,1353,56.25%,35.11%,1
屏東縣,屏東市,0025,471,240,711,27,738,1386,53.25%,33.98%,1
屏東縣,屏東市,0026,452,288,740,24,764,1413,54.07%,31.99%,1
屏東縣,屏東市,0027,470,187,657,32,689,1272,54.17%,36.95%,1
屏東縣,屏東市,0028,420,261,681,22,703,1287,54.62%,32.63%,1
屏東縣,屏東市,0029,468,263,731,32,763,1311,58.2%,35.7%,1
屏東縣,屏東市,0030,447,262,709,17,726,1285,56.5%,34.79%,1
屏東縣,屏東市,0031,442,269,711,32,743,1297,57.29%,34.08%,1
屏東縣,屏東市,0032,280,440,720,29,749,1361,55.03%,20.57%,1
屏東縣,屏東市,0033,423,252,675,38,713,1381,51.63%,30.63%,1
屏東縣,屏東市,0034,432,273,705,43,748,1258,59.46%,34.34%,1
屏東縣,屏東市,0035,434,244,678,33,711,1259,56.47%,34.47%,1
屏東縣,屏東市,0036,373,207,580,17,597,1076,55.48%,34.67%,1
屏東縣,屏東市,0037,408,253,661,14,675,1162,58.09%,35.11%,1
屏東縣,屏東市,0038,446,287,733,24,757,1318,57.44%,33.84%,1
屏東縣,屏東市,0039,261,242,503,24,527,939,56.12%,27.8%,1
屏東縣,屏東市,0040,348,196,544,19,563,972,57.92%,35.8%,1
屏東縣,屏東市,0041,512,331,843,35,878,1535,57.2%,33.36%,1
屏東縣,屏東市,0042,404,246,650,38,688,1419,48.48%,28.47%,1
屏東縣,屏東市,0043,400,277,677,18,695,1398,49.71%,28.61%,1
屏東縣,屏東市,0044,424,283,707,43,750,1405,53.38%,30.18%,1
屏東縣,屏東市,0045,485,299,784,32,816,1486,54.91%,32.64%,1
屏東縣,屏東市,0046,346,212,558,35,593,1061,55.89%,32.61%,1
屏東縣,屏東市,0047,405,293,698,58,756,1540,49.09%,26.3%,1
屏東縣,屏東市,0048,325,220,545,20,565,1141,49.52%,28.48%,1
屏東縣,屏東市,0049,335,263,598,32,630,1247,50.52%,26.86%,1
屏東縣,屏東市,0050,416,278,694,42,736,1446,50.9%,28.77%,1
屏東縣,屏東市,0051,466,254,720,23,743,1303,57.02%,35.76%,1
屏東縣,屏東市,0052,403,254,657,32,689,1253,54.99%,32.16%,1
屏東縣,屏東市,0053,426,257,683,33,716,1315,54.45%,32.4%,1
屏東縣,屏東市,0054,401,294,695,32,727,1425,51.02%,28.14%,1
屏東縣,屏東市,0055,446,269,715,27,742,1423,52.14%,31.34%,1
屏東縣,屏東市,0056,487,262,749,41,790,1400,56.43%,34.79%,1
屏東縣,屏東市,0057,450,307,757,32,789,1359,58.06%,33.11%,1
屏東縣,屏東市,0058,472,222,694,24,718,1328,54.07%,35.54%,1
屏東縣,屏東市,0059,528,262,790,26,816,1539,53.02%,34.31%,1
屏東縣,屏東市,0060,80,59,139,7,146,391,37.34%,20.46%,1
屏東縣,屏東市,0061,76,30,106,11,117,200,58.5%,38%,1
屏東縣,屏東市,0062,85,67,152,16,168,328,51.22%,25.91%,1
屏東縣,屏東市,0063,78,41,119,3,122,231,52.81%,33.77%,1
屏東縣,屏東市,0064,291,184,475,55,530,945,56.08%,30.79%,1
屏東縣,屏東市,0065,295,220,515,50,565,1053,53.66%,28.02%,1
屏東縣,屏東市,0066,296,201,497,40,537,1043,51.49%,28.38%,1
屏東縣,屏東市,0067,315,188,503,56,559,1061,52.69%,29.69%,1
屏東縣,屏東市,0068,261,180,441,18,459,876,52.4%,29.79%,1
屏東縣,屏東市,0069,426,252,678,74,752,1468,51.23%,29.02%,1
屏東縣,屏東市,0070,420,257,677,50,727,1454,50%,28.89%,1
屏東縣,屏東市,0071,378,283,661,23,684,1205,56.76%,31.37%,1
屏東縣,屏東市,0072,349,277,626,32,658,1284,51.25%,27.18%,1
屏東縣,屏東市,0073,376,211,587,28,615,1219,50.45%,30.84%,1
屏東縣,屏東市,0074,512,317,829,58,887,1544,57.45%,33.16%,1
屏東縣,屏東市,0075,467,284,751,59,810,1485,54.55%,31.45%,1
屏東縣,屏東市,0076,438,289,727,42,769,1387,55.44%,31.58%,1
屏東縣,屏東市,0077,303,167,470,22,492,953,51.63%,31.79%,1
屏東縣,屏東市,0078,503,332,835,44,879,1603,54.83%,31.38%,1
屏東縣,屏東市,0079,153,117,270,26,296,535,55.33%,28.6%,1
屏東縣,屏東市,0080,333,233,566,33,599,1119,53.53%,29.76%,1
屏東縣,屏東市,0081,301,154,455,23,478,847,56.43%,35.54%,1
屏東縣,屏東市,0082,292,206,498,54,552,923,59.8%,31.64%,1
屏東縣,屏東市,0083,370,235,605,33,638,1227,52%,30.15%,1
屏東縣,屏東市,0084,342,207,549,28,577,1039,55.53%,32.92%,1
屏東縣,屏東市,0085,437,290,727,67,794,1485,53.47%,29.43%,1
屏東縣,屏東市,0086,274,166,440,32,472,867,54.44%,31.6%,1
屏東縣,屏東市,0087,304,179,483,28,511,918,55.66%,33.12%,1
屏東縣,屏東市,0088,196,120,316,30,346,663,52.19%,29.56%,1
屏東縣,屏東市,0089,326,239,565,21,586,1215,48.23%,26.83%,1
屏東縣,屏東市,0090,445,300,745,58,803,1628,49.32%,27.33%,1
屏東縣,屏東市,0091,377,265,642,34,676,1209,55.91%,31.18%,1
屏東縣,屏東市,0092,421,270,691,20,711,1110,64.05%,37.93%,1
屏東縣,屏東市,0093,211,110,321,11,332,684,48.54%,30.85%,1
屏東縣,屏東市,0094,390,206,596,26,622,1349,46.11%,28.91%,1
屏東縣,屏東市,0095,440,262,702,43,745,1457,51.13%,30.2%,1
屏東縣,屏東市,0096,467,305,772,22,794,1447,54.87%,32.27%,1
屏東縣,屏東市,0097,386,281,667,17,684,1354,50.52%,28.51%,1
屏東縣,屏東市,0098,514,316,830,55,885,1583,55.91%,32.47%,1
屏東縣,屏東市,0099,595,271,866,18,884,1707,51.79%,34.86%,1
屏東縣,屏東市,0100,475,306,781,25,806,1637,49.24%,29.02%,1
屏東縣,屏東市,0101,452,249,701,8,709,1459,48.59%,30.98%,1
屏東縣,屏東市,0102,595,324,919,33,952,1759,54.12%,33.83%,1
屏東縣,屏東市,0103,653,337,990,41,1031,1950,52.87%,33.49%,1
屏東縣,屏東市,0104,572,324,896,29,925,1729,53.5%,33.08%,1
屏東縣,屏東市,0105,522,283,805,26,831,1592,52.2%,32.79%,1
屏東縣,屏東市,0106,445,219,664,27,691,1437,48.09%,30.97%,1
屏東縣,屏東市,0107,390,211,601,25,626,1204,51.99%,32.39%,1
屏東縣,屏東市,0108,454,255,709,30,739,1340,55.15%,33.88%,1
屏東縣,屏東市,0109,444,250,694,25,719,1322,54.39%,33.59%,1
屏東縣,屏東市,0110,457,253,710,39,749,1462,51.23%,31.26%,1
屏東縣,屏東市,0111,1018,524,1542,48,1590,3241,49.06%,31.41%,1
屏東縣,屏東市,0112,456,254,710,18,728,1477,49.29%,30.87%,1
屏東縣,屏東市,0113,236,145,381,21,402,821,48.96%,28.75%,1
屏東縣,屏東市,0114,300,178,478,23,501,1099,45.59%,27.3%,1
屏東縣,屏東市,0115,562,282,844,33,877,1688,51.95%,33.29%,1
屏東縣,屏東市,0116,349,217,566,37,603,1167,51.67%,29.91%,1
屏東縣,屏東市,0117,283,179,462,29,491,915,53.66%,30.93%,1
屏東縣,屏東市,0118,319,196,515,14,529,1683,31.43%,18.95%,1
屏東縣,屏東市,0119,466,281,747,16,763,1497,50.97%,31.13%,1
屏東縣,屏東市,0120,351,214,565,31,596,1129,52.79%,31.09%,1
屏東縣,屏東市,0121,399,242,641,27,668,1232,54.22%,32.39%,1
屏東縣,屏東市,0122,291,144,435,31,466,853,54.63%,34.11%,1
屏東縣,屏東市,0123,287,206,493,17,510,869,58.69%,33.03%,1
屏東縣,屏東市,0124,389,246,635,35,670,1169,57.31%,33.28%,1
屏東縣,屏東市,0125,377,193,570,26,596,1058,56.33%,35.63%,1
屏東縣,屏東市,0126,392,252,644,26,670,1344,49.85%,29.17%,1
屏東縣,屏東市,0127,394,284,678,25,703,1299,54.12%,30.33%,1
屏東縣,屏東市,0128,359,247,606,6,612,1204,50.83%,29.82%,1
屏東縣,屏東市,0129,359,212,571,27,598,1123,53.25%,31.97%,1
屏東縣,屏東市,0130,372,236,608,26,634,1318,48.1%,28.22%,1
屏東縣,屏東市,0131,280,199,479,35,514,865,59.42%,32.37%,1
屏東縣,屏東市,0132,313,195,508,23,531,1100,48.27%,28.45%,1
屏東縣,屏東市,0133,362,218,580,24,604,1215,49.71%,29.79%,1
屏東縣,屏東市,0134,484,224,708,21,729,1370,53.21%,35.33%,1
屏東縣,屏東市,0135,447,197,644,16,660,1240,53.23%,36.05%,1
屏東縣,屏東市,0136,392,250,642,24,666,1168,57.02%,33.56%,1
屏東縣,屏東市,0137,360,209,569,24,593,1079,54.96%,33.36%,1
屏東縣,屏東市,0138,452,267,719,28,747,1289,57.95%,35.07%,1
屏東縣,屏東市,0139,360,209,569,27,596,1115,53.45%,32.29%,1
屏東縣,屏東市,0140,441,344,785,38,823,1491,55.2%,29.58%,1
屏東縣,屏東市,0141,431,233,664,25,689,1411,48.83%,30.55%,1
屏東縣,屏東市,0142,558,335,893,21,914,1803,50.69%,30.95%,1
屏東縣,屏東市,0143,263,152,415,14,429,744,57.66%,35.35%,1
屏東縣,屏東市,0144,218,142,360,11,371,678,54.72%,32.15%,1
屏東縣,屏東市,0145,229,159,388,18,406,681,59.62%,33.63%,1
屏東縣,屏東市,0146,407,293,700,33,733,1535,47.75%,26.51%,1
屏東縣,屏東市,0147,310,179,489,50,539,954,56.5%,32.49%,1
屏東縣,屏東市,0148,386,204,590,27,617,1018,60.61%,37.92%,1
屏東縣,屏東市,0149,358,276,634,22,656,1154,56.85%,31.02%,1
屏東縣,潮州鎮,0150,179,109,288,17,305,504,60.52%,35.52%,1
屏東縣,潮州鎮,0151,512,274,786,32,818,1711,47.81%,29.92%,1
屏東縣,潮州鎮,0152,495,335,830,20,850,1634,52.02%,30.29%,1
屏東縣,潮州鎮,0153,414,237,651,28,679,1414,48.02%,29.28%,1
屏東縣,潮州鎮,0154,216,133,349,30,379,603,62.85%,35.82%,1
屏東縣,潮州鎮,0155,262,184,446,44,490,896,54.69%,29.24%,1
屏東縣,潮州鎮,0156,418,226,644,27,671,1285,52.22%,32.53%,1
屏東縣,潮州鎮,0157,722,110,832,37,869,1744,49.83%,41.4%,1
屏東縣,潮州鎮,0158,359,232,591,31,622,1071,58.08%,33.52%,1
屏東縣,潮州鎮,0159,427,248,675,39,714,1209,59.06%,35.32%,1
屏東縣,潮州鎮,0160,357,233,590,29,619,1159,53.41%,30.8%,1
屏東縣,潮州鎮,0161,368,259,627,39,666,1296,51.39%,28.4%,1
屏東縣,潮州鎮,0162,492,270,762,29,791,1466,53.96%,33.56%,1
屏東縣,潮州鎮,0163,392,231,623,31,654,1130,57.88%,34.69%,1
屏東縣,潮州鎮,0164,405,338,743,40,783,1439,54.41%,28.14%,1
屏東縣,潮州鎮,0165,294,182,476,51,527,897,58.75%,32.78%,1
屏東縣,潮州鎮,0166,430,252,682,25,707,1225,57.71%,35.1%,1
屏東縣,潮州鎮,0167,323,230,553,34,587,1158,50.69%,27.89%,1
屏東縣,潮州鎮,0168,110,87,197,23,220,481,45.74%,22.87%,1
屏東縣,潮州鎮,0169,316,196,512,37,549,972,56.48%,32.51%,1
屏東縣,潮州鎮,0170,428,274,702,36,738,1245,59.28%,34.38%,1
屏東縣,潮州鎮,0171,455,256,711,44,755,1415,53.36%,32.16%,1
屏東縣,潮州鎮,0172,373,214,587,17,604,1255,48.13%,29.72%,1
屏東縣,潮州鎮,0173,270,160,430,21,451,1058,42.63%,25.52%,1
屏東縣,潮州鎮,0174,303,283,586,28,614,1187,51.73%,25.53%,1
屏東縣,潮州鎮,0175,381,195,576,36,612,1083,56.51%,35.18%,1
屏東縣,潮州鎮,0176,471,277,748,33,781,1590,49.12%,29.62%,1
屏東縣,潮州鎮,0177,494,320,814,37,851,1543,55.15%,32.02%,1
屏東縣,潮州鎮,0178,480,299,779,34,813,1631,49.85%,29.43%,1
屏東縣,潮州鎮,0179,378,237,615,19,634,1159,54.7%,32.61%,1
屏東縣,潮州鎮,0180,365,239,604,17,621,1099,56.51%,33.21%,1
屏東縣,潮州鎮,0181,347,212,559,41,600,1200,50%,28.92%,1
屏東縣,潮州鎮,0182,415,243,658,46,704,1391,50.61%,29.83%,1
屏東縣,潮州鎮,0183,295,173,468,48,516,881,58.57%,33.48%,1
屏東縣,潮州鎮,0184,146,69,215,17,232,454,51.1%,32.16%,1
屏東縣,潮州鎮,0185,550,317,867,43,910,1658,54.89%,33.17%,1
屏東縣,潮州鎮,0186,257,152,409,17,426,822,51.82%,31.27%,1
屏東縣,潮州鎮,0187,251,162,413,22,435,948,45.89%,26.48%,1
屏東縣,潮州鎮,0188,278,186,464,39,503,1194,42.13%,23.28%,1
屏東縣,潮州鎮,0189,110,62,172,19,191,337,56.68%,32.64%,1
屏東縣,東港鎮,0190,369,190,559,34,593,981,60.45%,37.61%,1
屏東縣,東港鎮,0191,401,204,605,38,643,1070,60.09%,37.48%,1
屏東縣,東港鎮,0192,215,105,320,27,347,527,65.84%,40.8%,1
屏東縣,東港鎮,0193,137,89,226,20,246,395,62.28%,34.68%,1
屏東縣,東港鎮,0194,189,129,318,20,338,659,51.29%,28.68%,1
屏東縣,東港鎮,0195,159,105,264,23,287,513,55.95%,30.99%,1
屏東縣,東港鎮,0196,326,526,852,44,896,1732,51.73%,18.82%,1
屏東縣,東港鎮,0197,531,384,915,40,955,1779,53.68%,29.85%,1
屏東縣,東港鎮,0198,382,227,609,33,642,1270,50.55%,30.08%,1
屏東縣,東港鎮,0199,400,270,670,32,702,1327,52.9%,30.14%,1
屏東縣,東港鎮,0200,405,256,661,37,698,1242,56.2%,32.61%,1
屏東縣,東港鎮,0201,521,307,828,60,888,1607,55.26%,32.42%,1
屏東縣,東港鎮,0202,380,242,622,28,650,1305,49.81%,29.12%,1
屏東縣,東港鎮,0203,210,161,371,20,391,695,56.26%,30.22%,1
屏東縣,東港鎮,0204,366,234,600,60,660,1076,61.34%,34.01%,1
屏東縣,東港鎮,0205,171,102,273,19,292,567,51.5%,30.16%,1
屏東縣,東港鎮,0206,252,158,410,27,437,806,54.22%,31.27%,1
屏東縣,東港鎮,0207,420,226,646,41,687,1227,55.99%,34.23%,1
屏東縣,東港鎮,0208,171,105,276,51,327,599,54.59%,28.55%,1
屏東縣,東港鎮,0209,344,196,540,40,580,1354,42.84%,25.41%,1
屏東縣,東港鎮,0210,210,141,351,39,390,734,53.13%,28.61%,1
屏東縣,東港鎮,0211,325,232,557,78,635,1107,57.36%,29.36%,1
屏東縣,東港鎮,0212,350,189,539,56,595,1198,49.67%,29.22%,1
屏東縣,東港鎮,0213,444,300,744,76,820,1614,50.81%,27.51%,1
屏東縣,東港鎮,0214,221,176,397,29,426,826,51.57%,26.76%,1
屏東縣,東港鎮,0215,290,193,483,37,520,912,57.02%,31.8%,1
屏東縣,東港鎮,0216,132,64,196,28,224,432,51.85%,30.56%,1
屏東縣,東港鎮,0217,377,228,605,69,674,1204,55.98%,31.31%,1
屏東縣,東港鎮,0218,416,259,675,51,726,1304,55.67%,31.9%,1
屏東縣,東港鎮,0219,402,302,704,46,750,1317,56.95%,30.52%,1
屏東縣,東港鎮,0220,433,248,681,28,709,1387,51.12%,31.22%,1
屏東縣,東港鎮,0221,340,235,575,37,612,1310,46.72%,25.95%,1
屏東縣,東港鎮,0222,343,234,577,41,618,1228,50.33%,27.93%,1
屏東縣,東港鎮,0223,181,156,337,36,373,766,48.69%,23.63%,1
屏東縣,東港鎮,0224,239,208,447,45,492,823,59.78%,29.04%,1
屏東縣,東港鎮,0225,181,122,303,15,318,755,42.12%,23.97%,1
屏東縣,東港鎮,0226,309,248,557,71,628,1094,57.4%,28.24%,1
屏東縣,東港鎮,0227,223,126,349,26,375,753,49.8%,29.61%,1
屏東縣,恆春鎮,0228,253,177,430,20,450,902,49.89%,28.05%,1
屏東縣,恆春鎮,0229,289,233,522,32,554,969,57.17%,29.82%,1
屏東縣,恆春鎮,0230,325,272,597,36,633,1280,49.45%,25.39%,1
屏東縣,恆春鎮,0231,331,246,577,36,613,1133,54.1%,29.21%,1
屏東縣,恆春鎮,0232,362,282,644,14,658,1552,42.4%,23.32%,1
屏東縣,恆春鎮,0233,321,256,577,45,622,1485,41.89%,21.62%,1
屏東縣,恆春鎮,0234,234,215,449,32,481,896,53.68%,26.12%,1
屏東縣,恆春鎮,0235,112,117,229,21,250,531,47.08%,21.09%,1
屏東縣,恆春鎮,0236,124,94,218,8,226,478,47.28%,25.94%,1
屏東縣,恆春鎮,0237,261,183,444,45,489,1020,47.94%,25.59%,1
屏東縣,恆春鎮,0238,203,228,431,20,451,924,48.81%,21.97%,1
屏東縣,恆春鎮,0239,231,217,448,22,470,1079,43.56%,21.41%,1
屏東縣,恆春鎮,0240,190,117,307,22,329,775,42.45%,24.52%,1
屏東縣,恆春鎮,0241,233,170,403,40,443,813,54.49%,28.66%,1
屏東縣,恆春鎮,0242,308,185,493,36,529,1104,47.92%,27.9%,1
屏東縣,恆春鎮,0243,250,208,458,42,500,1110,45.05%,22.52%,1
屏東縣,恆春鎮,0244,136,121,257,40,297,692,42.92%,19.65%,1
屏東縣,恆春鎮,0245,128,111,239,12,251,708,35.45%,18.08%,1
屏東縣,恆春鎮,0246,414,281,695,32,727,1505,48.31%,27.51%,1
屏東縣,恆春鎮,0247,290,204,494,26,520,1111,46.8%,26.1%,1
屏東縣,恆春鎮,0248,397,264,661,49,710,1543,46.01%,25.73%,1
屏東縣,恆春鎮,0249,191,134,325,18,343,828,41.43%,23.07%,1
屏東縣,恆春鎮,0250,227,178,405,40,445,844,52.73%,26.9%,1
屏東縣,恆春鎮,0251,329,231,560,49,609,1253,48.6%,26.26%,1
屏東縣,恆春鎮,0252,280,194,474,39,513,1126,45.56%,24.87%,1
屏東縣,萬丹鄉,0253,415,238,653,31,684,1527,44.79%,27.18%,1
屏東縣,萬丹鄉,0254,325,199,524,47,571,1147,49.78%,28.33%,1
屏東縣,萬丹鄉,0255,278,177,455,31,486,949,51.21%,29.29%,1
屏東縣,萬丹鄉,0256,293,163,456,27,483,990,48.79%,29.6%,1
屏東縣,萬丹鄉,0257,320,166,486,18,504,1022,49.32%,31.31%,1
屏東縣,萬丹鄉,0258,218,121,339,32,371,545,68.07%,40%,1
屏東縣,萬丹鄉,0259,432,219,651,37,688,1159,59.36%,37.27%,1
屏東縣,萬丹鄉,0260,276,182,458,47,505,837,60.33%,32.97%,1
屏東縣,萬丹鄉,0261,125,53,178,15,193,392,49.23%,31.89%,1
屏東縣,萬丹鄉,0262,304,159,463,27,490,847,57.85%,35.89%,1
屏東縣,萬丹鄉,0263,335,226,561,34,595,1149,51.78%,29.16%,1
屏東縣,萬丹鄉,0264,369,215,584,34,618,1131,54.64%,32.63%,1
屏東縣,萬丹鄉,0265,352,219,571,39,610,1178,51.78%,29.88%,1
屏東縣,萬丹鄉,0266,229,180,409,19,428,711,60.2%,32.21%,1
屏東縣,萬丹鄉,0267,224,140,364,17,381,595,64.03%,37.65%,1
屏東縣,萬丹鄉,0268,468,297,765,46,811,1403,57.8%,33.36%,1
屏東縣,萬丹鄉,0269,341,203,544,24,568,1094,51.92%,31.17%,1
屏東縣,萬丹鄉,0270,380,237,617,47,664,1158,57.34%,32.82%,1
屏東縣,萬丹鄉,0271,342,213,555,48,603,963,62.62%,35.51%,1
屏東縣,萬丹鄉,0272,350,210,560,35,595,1062,56.03%,32.96%,1
屏東縣,萬丹鄉,0273,542,279,821,64,885,1684,52.55%,32.19%,1
屏東縣,萬丹鄉,0274,491,321,812,33,845,1702,49.65%,28.85%,1
屏東縣,萬丹鄉,0275,332,211,543,32,575,976,58.91%,34.02%,1
屏東縣,萬丹鄉,0276,306,197,503,56,559,1013,55.18%,30.21%,1
屏東縣,萬丹鄉,0277,149,214,363,26,389,847,45.93%,17.59%,1
屏東縣,萬丹鄉,0278,510,310,820,92,912,1570,58.09%,32.48%,1
屏東縣,萬丹鄉,0279,410,234,644,57,701,1411,49.68%,29.06%,1
屏東縣,萬丹鄉,0280,351,200,551,55,606,1046,57.93%,33.56%,1
屏東縣,萬丹鄉,0281,384,292,676,33,709,1385,51.19%,27.73%,1
屏東縣,萬丹鄉,0282,262,148,410,38,448,804,55.72%,32.59%,1
屏東縣,萬丹鄉,0283,372,278,650,55,705,1284,54.91%,28.97%,1
屏東縣,萬丹鄉,0284,421,252,673,35,708,1430,49.51%,29.44%,1
屏東縣,萬丹鄉,0285,333,227,560,42,602,960,62.71%,34.69%,1
屏東縣,萬丹鄉,0286,272,171,443,40,483,786,61.45%,34.61%,1
屏東縣,萬丹鄉,0287,364,223,587,61,648,1158,55.96%,31.43%,1
屏東縣,萬丹鄉,0288,403,260,663,58,721,1647,43.78%,24.47%,1
屏東縣,萬丹鄉,0289,439,281,720,58,778,1666,46.7%,26.35%,1
屏東縣,萬丹鄉,0290,356,221,577,51,628,1023,61.39%,34.8%,1
屏東縣,萬丹鄉,0291,463,219,682,33,715,1227,58.27%,37.73%,1
屏東縣,長治鄉,0292,330,204,534,39,573,1018,56.29%,32.42%,1
屏東縣,長治鄉,0293,520,314,834,52,886,1614,54.89%,32.22%,1
屏東縣,長治鄉,0294,604,404,1008,50,1058,1848,57.25%,32.68%,1
屏東縣,長治鄉,0295,570,336,906,55,961,1707,56.3%,33.39%,1
屏東縣,長治鄉,0296,334,194,528,24,552,972,56.79%,34.36%,1
屏東縣,長治鄉,0297,318,214,532,42,574,989,58.04%,32.15%,1
屏東縣,長治鄉,0298,244,175,419,26,445,735,60.54%,33.2%,1
屏東縣,長治鄉,0299,474,369,843,54,897,1813,49.48%,26.14%,1
屏東縣,長治鄉,0300,359,255,614,37,651,1073,60.67%,33.46%,1
屏東縣,長治鄉,0301,506,325,831,49,880,1654,53.2%,30.59%,1
屏東縣,長治鄉,0302,366,181,547,39,586,1205,48.63%,30.37%,1
屏東縣,長治鄉,0303,222,177,399,35,434,758,57.26%,29.29%,1
屏東縣,長治鄉,0304,474,292,766,61,827,1492,55.43%,31.77%,1
屏東縣,長治鄉,0305,300,181,481,34,515,884,58.26%,33.94%,1
屏東縣,長治鄉,0306,365,224,589,37,626,1090,57.43%,33.49%,1
屏東縣,長治鄉,0307,354,263,617,80,697,1422,49.02%,24.89%,1
屏東縣,長治鄉,0308,268,158,426,40,466,845,55.15%,31.72%,1
屏東縣,長治鄉,0309,296,170,466,70,536,925,57.95%,32%,1
屏東縣,長治鄉,0310,374,237,611,22,633,1138,55.62%,32.86%,1
屏東縣,長治鄉,0311,392,245,637,66,703,1242,56.6%,31.56%,1
屏東縣,長治鄉,0312,337,199,536,16,552,1159,47.63%,29.08%,1
屏東縣,長治鄉,0313,229,142,371,30,401,673,59.58%,34.03%,1
屏東縣,麟洛鄉,0314,236,181,417,32,449,788,56.98%,29.95%,1
屏東縣,麟洛鄉,0315,630,176,806,32,838,1386,60.46%,45.45%,1
屏東縣,麟洛鄉,0316,321,232,553,34,587,957,61.34%,33.54%,1
屏東縣,麟洛鄉,0317,241,179,420,32,452,731,61.83%,32.97%,1
屏東縣,麟洛鄉,0318,285,189,474,30,504,806,62.53%,35.36%,1
屏東縣,麟洛鄉,0319,358,250,608,17,625,1207,51.78%,29.66%,1
屏東縣,麟洛鄉,0320,435,314,749,68,817,1340,60.97%,32.46%,1
屏東縣,麟洛鄉,0321,529,182,711,40,751,1221,61.51%,43.33%,1
屏東縣,麟洛鄉,0322,293,170,463,23,486,851,57.11%,34.43%,1
屏東縣,麟洛鄉,0323,216,128,344,13,357,683,52.27%,31.63%,1
屏東縣,九如鄉,0324,462,319,781,55,836,1491,56.07%,30.99%,1
屏東縣,九如鄉,0325,410,288,698,42,740,1375,53.82%,29.82%,1
屏東縣,九如鄉,0326,479,314,793,56,849,1678,50.6%,28.55%,1
屏東縣,九如鄉,0327,364,253,617,68,685,1166,58.75%,31.22%,1
屏東縣,九如鄉,0328,305,136,441,40,481,1276,37.7%,23.9%,1
屏東縣,九如鄉,0329,353,196,549,36,585,1033,56.63%,34.17%,1
屏東縣,九如鄉,0330,223,130,353,44,397,577,68.8%,38.65%,1
屏東縣,九如鄉,0331,234,122,356,43,399,649,61.48%,36.06%,1
屏東縣,九如鄉,0332,618,382,1000,96,1096,1999,54.83%,30.92%,1
屏東縣,九如鄉,0333,521,334,855,65,920,1766,52.1%,29.5%,1
屏東縣,九如鄉,0334,421,329,750,89,839,1600,52.44%,26.31%,1
屏東縣,九如鄉,0335,390,245,635,50,685,1248,54.89%,31.25%,1
屏東縣,九如鄉,0336,555,367,922,117,1039,1792,57.98%,30.97%,1
屏東縣,九如鄉,0337,441,280,721,94,815,1482,54.99%,29.76%,1
屏東縣,里港鄉,0338,533,312,845,70,915,1552,58.96%,34.34%,1
屏東縣,里港鄉,0339,443,290,733,55,788,1480,53.24%,29.93%,1
屏東縣,里港鄉,0340,383,277,660,34,694,1534,45.24%,24.97%,1
屏東縣,里港鄉,0341,492,312,804,51,855,1578,54.18%,31.18%,1
屏東縣,里港鄉,0342,385,253,638,35,673,1127,59.72%,34.16%,1
屏東縣,里港鄉,0343,270,191,461,38,499,845,59.05%,31.95%,1
屏東縣,里港鄉,0344,376,254,630,47,677,1282,52.81%,29.33%,1
屏東縣,里港鄉,0345,318,208,526,44,570,981,58.1%,32.42%,1
屏東縣,里港鄉,0346,314,234,548,51,599,1031,58.1%,30.46%,1
屏東縣,里港鄉,0347,416,331,747,120,867,1423,60.93%,29.23%,1
屏東縣,里港鄉,0348,113,54,167,13,180,363,49.59%,31.13%,1
屏東縣,里港鄉,0349,363,257,620,85,705,1203,58.6%,30.17%,1
屏東縣,里港鄉,0350,331,251,582,57,639,1027,62.22%,32.23%,1
屏東縣,里港鄉,0351,391,295,686,46,732,1384,52.89%,28.25%,1
屏東縣,里港鄉,0352,453,277,730,56,786,1512,51.98%,29.96%,1
屏東縣,里港鄉,0353,201,96,297,11,308,522,59%,38.51%,1
屏東縣,里港鄉,0354,242,170,412,47,459,822,55.84%,29.44%,1
屏東縣,里港鄉,0355,261,206,467,62,529,1007,52.53%,25.92%,1
屏東縣,里港鄉,0356,296,194,490,47,537,956,56.17%,30.96%,1
屏東縣,里港鄉,0357,159,107,266,16,282,499,56.51%,31.86%,1
屏東縣,鹽埔鄉,0358,326,151,477,29,506,951,53.21%,34.28%,1
屏東縣,鹽埔鄉,0359,252,174,426,24,450,899,50.06%,28.03%,1
屏東縣,鹽埔鄉,0360,247,208,455,23,478,1116,42.83%,22.13%,1
屏東縣,鹽埔鄉,0361,354,241,595,35,630,1241,50.77%,28.53%,1
屏東縣,鹽埔鄉,0362,206,160,366,41,407,770,52.86%,26.75%,1
屏東縣,鹽埔鄉,0363,312,164,476,34,510,962,53.01%,32.43%,1
屏東縣,鹽埔鄉,0364,361,220,581,52,633,1041,60.81%,34.68%,1
屏東縣,鹽埔鄉,0365,361,295,656,56,712,1367,52.08%,26.41%,1
屏東縣,鹽埔鄉,0366,341,237,578,58,636,1465,43.41%,23.28%,1
屏東縣,鹽埔鄉,0367,208,173,381,39,420,894,46.98%,23.27%,1
屏東縣,鹽埔鄉,0368,224,185,409,5,414,958,43.22%,23.38%,1
屏東縣,鹽埔鄉,0369,272,163,435,60,495,924,53.57%,29.44%,1
屏東縣,鹽埔鄉,0370,431,296,727,40,767,1598,48%,26.97%,1
屏東縣,鹽埔鄉,0371,470,276,746,86,832,1550,53.68%,30.32%,1
屏東縣,鹽埔鄉,0372,355,198,553,51,604,1127,53.59%,31.5%,1
屏東縣,鹽埔鄉,0373,362,252,614,58,672,1150,58.43%,31.48%,1
屏東縣,鹽埔鄉,0374,367,275,642,38,680,1233,55.15%,29.76%,1
屏東縣,鹽埔鄉,0375,329,208,537,58,595,984,60.47%,33.43%,1
屏東縣,鹽埔鄉,0376,494,335,829,62,891,1619,55.03%,30.51%,1
屏東縣,鹽埔鄉,0377,172,112,284,24,308,553,55.7%,31.1%,1
屏東縣,高樹鄉,0378,306,183,489,66,555,883,62.85%,34.65%,1
屏東縣,高樹鄉,0379,360,104,464,30,494,1255,39.36%,28.69%,1
屏東縣,高樹鄉,0380,400,243,643,31,674,1278,52.74%,31.3%,1
屏東縣,高樹鄉,0381,197,126,323,25,348,738,47.15%,26.69%,1
屏東縣,高樹鄉,0382,147,119,266,12,278,585,47.52%,25.13%,1
屏東縣,高樹鄉,0383,313,202,515,80,595,1012,58.79%,30.93%,1
屏東縣,高樹鄉,0384,294,221,515,61,576,1148,50.17%,25.61%,1
屏東縣,高樹鄉,0385,144,123,267,37,304,591,51.44%,24.37%,1
屏東縣,高樹鄉,0386,204,113,317,52,369,786,46.95%,25.95%,1
屏東縣,高樹鄉,0387,165,105,270,23,293,649,45.15%,25.42%,1
屏東縣,高樹鄉,0388,289,176,465,57,522,1229,42.47%,23.52%,1
屏東縣,高樹鄉,0389,324,230,554,60,614,1446,42.46%,22.41%,1
屏東縣,高樹鄉,0390,187,165,352,12,364,899,40.49%,20.8%,1
屏東縣,高樹鄉,0391,241,186,427,47,474,922,51.41%,26.14%,1
屏東縣,高樹鄉,0392,293,239,532,64,596,1259,47.34%,23.27%,1
屏東縣,高樹鄉,0393,284,175,459,15,474,1056,44.89%,26.89%,1
屏東縣,高樹鄉,0394,263,246,509,51,560,1116,50.18%,23.57%,1
屏東縣,高樹鄉,0395,294,219,513,64,577,1020,56.57%,28.82%,1
屏東縣,高樹鄉,0396,305,210,515,61,576,1055,54.6%,28.91%,1
屏東縣,高樹鄉,0397,234,177,411,35,446,738,60.43%,31.71%,1
屏東縣,高樹鄉,0398,121,90,211,30,241,493,48.88%,24.54%,1
屏東縣,高樹鄉,0399,439,337,776,90,866,1539,56.27%,28.53%,1
屏東縣,萬巒鄉,0400,269,326,595,33,628,1239,50.69%,21.71%,1
屏東縣,萬巒鄉,0401,256,146,402,37,439,759,57.84%,33.73%,1
屏東縣,萬巒鄉,0402,324,169,493,65,558,932,59.87%,34.76%,1
屏東縣,萬巒鄉,0403,264,157,421,46,467,769,60.73%,34.33%,1
屏東縣,萬巒鄉,0404,267,181,448,54,502,920,54.57%,29.02%,1
屏東縣,萬巒鄉,0405,173,132,305,20,325,560,58.04%,30.89%,1
屏東縣,萬巒鄉,0406,313,192,505,32,537,1120,47.95%,27.95%,1
屏東縣,萬巒鄉,0407,174,332,506,25,531,1048,50.67%,16.6%,1
屏東縣,萬巒鄉,0408,368,243,611,48,659,1438,45.83%,25.59%,1
屏東縣,萬巒鄉,0409,216,162,378,37,415,834,49.76%,25.9%,1
屏東縣,萬巒鄉,0410,228,167,395,37,432,813,53.14%,28.04%,1
屏東縣,萬巒鄉,0411,276,241,517,25,542,1020,53.14%,27.06%,1
屏東縣,萬巒鄉,0412,343,237,580,40,620,1007,61.57%,34.06%,1
屏東縣,萬巒鄉,0413,407,263,670,59,729,1648,44.24%,24.7%,1
屏東縣,萬巒鄉,0414,455,257,712,33,745,1437,51.84%,31.66%,1
屏東縣,萬巒鄉,0415,349,190,539,21,560,1228,45.6%,28.42%,1
屏東縣,萬巒鄉,0416,210,122,332,28,360,597,60.3%,35.18%,1
屏東縣,萬巒鄉,0417,182,123,305,25,330,576,57.29%,31.6%,1
屏東縣,內埔鄉,0418,333,241,574,32,606,1305,46.44%,25.52%,1
屏東縣,內埔鄉,0419,375,218,593,32,625,1287,48.56%,29.14%,1
屏東縣,內埔鄉,0420,392,237,629,17,646,1387,46.58%,28.26%,1
屏東縣,內埔鄉,0421,410,281,691,37,728,1540,47.27%,26.62%,1
屏東縣,內埔鄉,0422,468,282,750,38,788,1605,49.1%,29.16%,1
屏東縣,內埔鄉,0423,463,253,716,54,770,1326,58.07%,34.92%,1
屏東縣,內埔鄉,0424,168,129,297,37,334,591,56.51%,28.43%,1
屏東縣,內埔鄉,0425,289,205,494,41,535,1123,47.64%,25.73%,1
屏東縣,內埔鄉,0426,328,187,515,19,534,1079,49.49%,30.4%,1
屏東縣,內埔鄉,0427,447,288,735,36,771,1485,51.92%,30.1%,1
屏東縣,內埔鄉,0428,431,256,687,28,715,1248,57.29%,34.54%,1
屏東縣,內埔鄉,0429,452,309,761,47,808,1569,51.5%,28.81%,1
屏東縣,內埔鄉,0430,387,282,669,44,713,1493,47.76%,25.92%,1
屏東縣,內埔鄉,0431,385,267,652,19,671,1420,47.25%,27.11%,1
屏東縣,內埔鄉,0432,386,262,648,47,695,1334,52.1%,28.94%,1
屏東縣,內埔鄉,0433,418,278,696,46,742,1519,48.85%,27.52%,1
屏東縣,內埔鄉,0434,224,115,339,44,383,784,48.85%,28.57%,1
屏東縣,內埔鄉,0435,269,195,464,44,508,888,57.21%,30.29%,1
屏東縣,內埔鄉,0436,225,117,342,11,353,747,47.26%,30.12%,1
屏東縣,內埔鄉,0437,311,184,495,26,521,1168,44.61%,26.63%,1
屏東縣,內埔鄉,0438,154,131,285,27,312,546,57.14%,28.21%,1
屏東縣,內埔鄉,0439,367,224,591,48,639,1278,50%,28.72%,1
屏東縣,內埔鄉,0440,366,201,567,50,617,1348,45.77%,27.15%,1
屏東縣,內埔鄉,0441,356,240,596,60,656,1550,42.32%,22.97%,1
屏東縣,內埔鄉,0442,347,177,524,52,576,947,60.82%,36.64%,1
屏東縣,內埔鄉,0443,182,331,513,49,562,1097,51.23%,16.59%,1
屏東縣,內埔鄉,0444,238,193,431,50,481,1128,42.64%,21.1%,1
屏東縣,內埔鄉,0445,265,169,434,31,465,1253,37.11%,21.15%,1
屏東縣,內埔鄉,0446,436,224,660,19,679,1525,44.52%,28.59%,1
屏東縣,內埔鄉,0447,344,248,592,53,645,1215,53.09%,28.31%,1
屏東縣,內埔鄉,0448,327,181,508,24,532,1216,43.75%,26.89%,1
屏東縣,內埔鄉,0449,371,227,598,20,618,1353,45.68%,27.42%,1
屏東縣,內埔鄉,0450,316,179,495,23,518,1026,50.49%,30.8%,1
屏東縣,內埔鄉,0451,234,140,374,30,404,862,46.87%,27.15%,1
屏東縣,內埔鄉,0452,241,144,385,23,408,921,44.3%,26.17%,1
屏東縣,內埔鄉,0453,259,155,414,27,441,854,51.64%,30.33%,1
屏東縣,內埔鄉,0454,359,181,540,31,571,1230,46.42%,29.19%,1
屏東縣,內埔鄉,0455,370,185,555,21,576,1204,47.84%,30.73%,1
屏東縣,內埔鄉,0456,356,212,568,33,601,1301,46.2%,27.36%,1
屏東縣,內埔鄉,0457,243,178,421,32,453,806,56.2%,30.15%,1
屏東縣,竹田鄉,0458,501,290,791,54,845,1503,56.22%,33.33%,1
屏東縣,竹田鄉,0459,344,178,522,32,554,899,61.62%,38.26%,1
屏東縣,竹田鄉,0460,260,153,413,37,450,716,62.85%,36.31%,1
屏東縣,竹田鄉,0461,212,146,358,25,383,581,65.92%,36.49%,1
屏東縣,竹田鄉,0462,407,261,668,75,743,1327,55.99%,30.67%,1
屏東縣,竹田鄉,0463,337,215,552,67,619,997,62.09%,33.8%,1
屏東縣,竹田鄉,0464,184,142,326,34,360,649,55.47%,28.35%,1
屏東縣,竹田鄉,0465,209,120,329,18,347,476,72.9%,43.91%,1
屏東縣,竹田鄉,0466,419,268,687,52,739,1259,58.7%,33.28%,1
屏東縣,竹田鄉,0467,373,225,598,46,644,1227,52.49%,30.4%,1
屏東縣,竹田鄉,0468,174,126,300,22,322,504,63.89%,34.52%,1
屏東縣,竹田鄉,0469,263,162,425,42,467,860,54.3%,30.58%,1
屏東縣,竹田鄉,0470,238,176,414,22,436,800,54.5%,29.75%,1
屏東縣,竹田鄉,0471,373,233,606,54,660,1134,58.2%,32.89%,1
屏東縣,竹田鄉,0472,374,237,611,44,655,1229,53.3%,30.43%,1
屏東縣,竹田鄉,0473,353,225,578,54,632,1192,53.02%,29.61%,1
屏東縣,新埤鄉,0474,504,311,815,37,852,1712,49.77%,29.44%,1
屏東縣,新埤鄉,0475,95,56,151,26,177,314,56.37%,30.25%,1
屏東縣,新埤鄉,0476,202,178,380,27,407,752,54.12%,26.86%,1
屏東縣,新埤鄉,0477,106,59,165,17,182,334,54.49%,31.74%,1
屏東縣,新埤鄉,0478,325,183,508,37,545,957,56.95%,33.96%,1
屏東縣,新埤鄉,0479,239,157,396,55,451,764,59.03%,31.28%,1
屏東縣,新埤鄉,0480,113,73,186,26,212,373,56.84%,30.29%,1
屏東縣,新埤鄉,0481,170,118,288,28,316,678,46.61%,25.07%,1
屏東縣,新埤鄉,0482,181,125,306,21,327,701,46.65%,25.82%,1
屏東縣,新埤鄉,0483,291,210,501,44,545,1323,41.19%,22%,1
屏東縣,新埤鄉,0484,180,103,283,29,312,541,57.67%,33.27%,1
屏東縣,新埤鄉,0485,153,87,240,30,270,584,46.23%,26.2%,1
屏東縣,枋寮鄉,0486,387,252,639,45,684,1213,56.39%,31.9%,1
屏東縣,枋寮鄉,0487,299,177,476,46,522,891,58.59%,33.56%,1
屏東縣,枋寮鄉,0488,289,159,448,47,495,970,51.03%,29.79%,1
屏東縣,枋寮鄉,0489,189,129,318,23,341,629,54.21%,30.05%,1
屏東縣,枋寮鄉,0490,277,190,467,32,499,840,59.4%,32.98%,1
屏東縣,枋寮鄉,0491,266,157,423,31,454,774,58.66%,34.37%,1
屏東縣,枋寮鄉,0492,366,302,668,51,719,1379,52.14%,26.54%,1
屏東縣,枋寮鄉,0493,486,302,788,50,838,1502,55.79%,32.36%,1
屏東縣,枋寮鄉,0494,363,248,611,56,667,1276,52.27%,28.45%,1
屏東縣,枋寮鄉,0495,300,164,464,57,521,964,54.05%,31.12%,1
屏東縣,枋寮鄉,0496,322,212,534,80,614,1005,61.09%,32.04%,1
屏東縣,枋寮鄉,0497,219,143,362,26,388,734,52.86%,29.84%,1
屏東縣,枋寮鄉,0498,253,123,376,42,418,725,57.66%,34.9%,1
屏東縣,枋寮鄉,0499,283,211,494,57,551,1046,52.68%,27.06%,1
屏東縣,枋寮鄉,0500,342,215,557,56,613,1067,57.45%,32.05%,1
屏東縣,枋寮鄉,0501,153,93,246,41,287,718,39.97%,21.31%,1
屏東縣,枋寮鄉,0502,230,159,389,41,430,903,47.62%,25.47%,1
屏東縣,枋寮鄉,0503,420,226,646,58,704,1387,50.76%,30.28%,1
屏東縣,枋寮鄉,0504,465,229,694,61,755,1367,55.23%,34.02%,1
屏東縣,枋寮鄉,0505,227,135,362,30,392,618,63.43%,36.73%,1
屏東縣,枋寮鄉,0506,211,159,370,21,391,959,40.77%,22%,1
屏東縣,枋寮鄉,0507,122,85,207,31,238,427,55.74%,28.57%,1
屏東縣,新園鄉,0508,248,190,438,34,472,820,57.56%,30.24%,1
屏東縣,新園鄉,0509,301,164,465,47,512,843,60.74%,35.71%,1
屏東縣,新園鄉,0510,346,252,598,45,643,1242,51.77%,27.86%,1
屏東縣,新園鄉,0511,420,276,696,46,742,1290,57.52%,32.56%,1
屏東縣,新園鄉,0512,333,202,535,36,571,1073,53.22%,31.03%,1
屏東縣,新園鄉,0513,279,238,517,78,595,1088,54.69%,25.64%,1
屏東縣,新園鄉,0514,247,146,393,27,420,845,49.7%,29.23%,1
屏東縣,新園鄉,0515,262,180,442,31,473,862,54.87%,30.39%,1
屏東縣,新園鄉,0516,311,222,533,56,589,1183,49.79%,26.29%,1
屏東縣,新園鄉,0517,341,211,552,59,611,1109,55.09%,30.75%,1
屏東縣,新園鄉,0518,285,222,507,20,527,1119,47.1%,25.47%,1
屏東縣,新園鄉,0519,335,201,536,35,571,1152,49.57%,29.08%,1
屏東縣,新園鄉,0520,344,183,527,47,574,1030,55.73%,33.4%,1
屏東縣,新園鄉,0521,302,220,522,66,588,1104,53.26%,27.36%,1
屏東縣,新園鄉,0522,343,226,569,31,600,1240,48.39%,27.66%,1
屏東縣,新園鄉,0523,253,197,450,21,471,1120,42.05%,22.59%,1
屏東縣,新園鄉,0524,315,245,560,64,624,1074,58.1%,29.33%,1
屏東縣,新園鄉,0525,227,145,372,29,401,849,47.23%,26.74%,1
屏東縣,新園鄉,0526,185,166,351,59,410,749,54.74%,24.7%,1
屏東縣,新園鄉,0527,391,270,661,62,723,1416,51.06%,27.61%,1
屏東縣,新園鄉,0528,278,170,448,45,493,895,55.08%,31.06%,1
屏東縣,新園鄉,0529,312,158,470,50,520,933,55.73%,33.44%,1
屏東縣,新園鄉,0530,321,170,491,31,522,972,53.7%,33.02%,1
屏東縣,新園鄉,0531,442,200,642,40,682,1454,46.91%,30.4%,1
屏東縣,新園鄉,0532,573,328,901,64,965,1653,58.38%,34.66%,1
屏東縣,新園鄉,0533,394,213,607,36,643,1270,50.63%,31.02%,1
屏東縣,新園鄉,0534,377,229,606,78,684,1123,60.91%,33.57%,1
屏東縣,新園鄉,0535,382,203,585,40,625,1198,52.17%,31.89%,1
屏東縣,崁頂鄉,0536,343,212,555,35,590,1190,49.58%,28.82%,1
屏東縣,崁頂鄉,0537,351,206,557,42,599,1044,57.38%,33.62%,1
屏東縣,崁頂鄉,0538,244,165,409,47,456,818,55.75%,29.83%,1
屏東縣,崁頂鄉,0539,368,221,589,41,630,1214,51.89%,30.31%,1
屏東縣,崁頂鄉,0540,402,223,625,25,650,1325,49.06%,30.34%,1
屏東縣,崁頂鄉,0541,419,244,663,56,719,1253,57.38%,33.44%,1
屏東縣,崁頂鄉,0542,324,167,491,37,528,1039,50.82%,31.18%,1
屏東縣,崁頂鄉,0543,199,155,354,42,396,813,48.71%,24.48%,1
屏東縣,崁頂鄉,0544,224,133,357,15,372,736,50.54%,30.43%,1
屏東縣,崁頂鄉,0545,266,225,491,39,530,934,56.75%,28.48%,1
屏東縣,崁頂鄉,0546,228,183,411,63,474,900,52.67%,25.33%,1
屏東縣,崁頂鄉,0547,294,200,494,47,541,1004,53.88%,29.28%,1
屏東縣,林邊鄉,0548,524,277,801,68,869,1458,59.6%,35.94%,1
屏東縣,林邊鄉,0549,338,169,507,25,532,891,59.71%,37.93%,1
屏東縣,林邊鄉,0550,265,130,395,27,422,695,60.72%,38.13%,1
屏東縣,林邊鄉,0551,364,213,577,32,609,1015,60%,35.86%,1
屏東縣,林邊鄉,0552,402,232,634,47,681,1171,58.16%,34.33%,1
屏東縣,林邊鄉,0553,317,182,499,43,542,1003,54.04%,31.61%,1
屏東縣,林邊鄉,0554,274,160,434,28,462,725,63.72%,37.79%,1
屏東縣,林邊鄉,0555,299,168,467,37,504,841,59.93%,35.55%,1
屏東縣,林邊鄉,0556,276,164,440,34,474,793,59.77%,34.8%,1
屏東縣,林邊鄉,0557,317,197,514,33,547,919,59.52%,34.49%,1
屏東縣,林邊鄉,0558,366,250,616,53,669,1283,52.14%,28.53%,1
屏東縣,林邊鄉,0559,206,147,353,39,392,783,50.06%,26.31%,1
屏東縣,林邊鄉,0560,298,181,479,43,522,1033,50.53%,28.85%,1
屏東縣,林邊鄉,0561,343,218,561,80,641,1186,54.05%,28.92%,1
屏東縣,林邊鄉,0562,218,156,374,49,423,773,54.72%,28.2%,1
屏東縣,林邊鄉,0563,342,165,507,29,536,1122,47.77%,30.48%,1
屏東縣,南州鄉,0564,283,142,425,51,476,872,54.59%,32.45%,1
屏東縣,南州鄉,0565,249,159,408,30,438,794,55.16%,31.36%,1
屏東縣,南州鄉,0566,305,214,519,43,562,962,58.42%,31.7%,1
屏東縣,南州鄉,0567,316,223,539,41,580,1033,56.15%,30.59%,1
屏東縣,南州鄉,0568,215,260,475,46,521,1007,51.74%,21.35%,1
屏東縣,南州鄉,0569,157,103,260,18,278,466,59.66%,33.69%,1
屏東縣,南州鄉,0570,236,156,392,25,417,708,58.9%,33.33%,1
屏東縣,南州鄉,0571,305,229,534,57,591,1044,56.61%,29.21%,1
屏東縣,南州鄉,0572,272,170,442,39,481,1071,44.91%,25.4%,1
屏東縣,南州鄉,0573,283,194,477,29,506,979,51.69%,28.91%,1
屏東縣,南州鄉,0574,158,87,245,29,274,543,50.46%,29.1%,1
屏東縣,佳冬鄉,0575,376,270,646,41,687,1472,46.67%,25.54%,1
屏東縣,佳冬鄉,0576,363,208,571,43,614,1360,45.15%,26.69%,1
屏東縣,佳冬鄉,0577,280,129,409,60,469,804,58.33%,34.83%,1
屏東縣,佳冬鄉,0578,245,174,419,67,486,925,52.54%,26.49%,1
屏東縣,佳冬鄉,0579,230,146,376,18,394,855,46.08%,26.9%,1
屏東縣,佳冬鄉,0580,272,178,450,39,489,981,49.85%,27.73%,1
屏東縣,佳冬鄉,0581,267,182,449,53,502,1007,49.85%,26.51%,1
屏東縣,佳冬鄉,0582,231,136,367,49,416,872,47.71%,26.49%,1
屏東縣,佳冬鄉,0583,306,222,528,50,578,1255,46.06%,24.38%,1
屏東縣,佳冬鄉,0584,360,154,514,60,574,995,57.69%,36.18%,1
屏東縣,佳冬鄉,0585,175,123,298,26,324,734,44.14%,23.84%,1
屏東縣,佳冬鄉,0586,293,211,504,30,534,1178,45.33%,24.87%,1
屏東縣,佳冬鄉,0587,282,195,477,52,529,1095,48.31%,25.75%,1
屏東縣,佳冬鄉,0588,386,200,586,68,654,1097,59.62%,35.19%,1
屏東縣,佳冬鄉,0589,415,197,612,51,663,1273,52.08%,32.6%,1
屏東縣,佳冬鄉,0590,396,228,624,32,656,1160,56.55%,34.14%,1
屏東縣,琉球鄉,0591,275,177,452,19,471,1111,42.39%,24.75%,1
屏東縣,琉球鄉,0592,244,158,402,36,438,972,45.06%,25.1%,1
屏東縣,琉球鄉,0593,408,214,622,39,661,1278,51.72%,31.92%,1
屏東縣,琉球鄉,0594,297,158,455,40,495,976,50.72%,30.43%,1
屏東縣,琉球鄉,0595,452,275,727,60,787,1658,47.47%,27.26%,1
屏東縣,琉球鄉,0596,280,112,392,29,421,1146,36.74%,24.43%,1
屏東縣,琉球鄉,0597,224,161,385,35,420,1079,38.92%,20.76%,1
屏東縣,琉球鄉,0598,381,211,592,25,617,1613,38.25%,23.62%,1
屏東縣,琉球鄉,0599,251,145,396,48,444,873,50.86%,28.75%,1
屏東縣,車城鄉,0600,149,129,278,32,310,737,42.06%,20.22%,1
屏東縣,車城鄉,0601,119,96,215,26,241,647,37.25%,18.39%,1
屏東縣,車城鄉,0602,124,88,212,21,233,491,47.45%,25.25%,1
屏東縣,車城鄉,0603,211,178,389,22,411,856,48.01%,24.65%,1
屏東縣,車城鄉,0604,166,87,253,8,261,554,47.11%,29.96%,1
屏東縣,車城鄉,0605,80,57,137,7,144,388,37.11%,20.62%,1
屏東縣,車城鄉,0606,174,159,333,40,373,922,40.46%,18.87%,1
屏東縣,車城鄉,0607,120,81,201,8,209,597,35.01%,20.1%,1
屏東縣,車城鄉,0608,115,92,207,15,222,623,35.63%,18.46%,1
屏東縣,車城鄉,0609,100,82,182,19,201,425,47.29%,23.53%,1
屏東縣,車城鄉,0610,132,76,208,9,217,428,50.7%,30.84%,1
屏東縣,車城鄉,0611,103,67,170,10,180,504,35.71%,20.44%,1
屏東縣,車城鄉,0612,105,77,182,25,207,423,48.94%,24.82%,1
屏東縣,滿州鄉,0613,364,342,706,1,707,1575,44.89%,23.11%,1
屏東縣,滿州鄉,0614,110,77,187,11,198,420,47.14%,26.19%,1
屏東縣,滿州鄉,0615,206,126,332,18,350,602,58.14%,34.22%,1
屏東縣,滿州鄉,0616,297,194,491,16,507,1302,38.94%,22.81%,1
屏東縣,滿州鄉,0617,336,228,564,19,583,1314,44.37%,25.57%,1
屏東縣,滿州鄉,0618,202,167,369,25,394,1308,30.12%,15.44%,1
屏東縣,滿州鄉,0619,74,64,138,13,151,367,41.14%,20.16%,1
屏東縣,滿州鄉,0620,85,70,155,11,166,318,52.2%,26.73%,1
屏東縣,枋山鄉,0621,262,72,334,32,366,604,60.6%,43.38%,1
屏東縣,枋山鄉,0622,152,92,244,21,265,428,61.92%,35.51%,1
屏東縣,枋山鄉,0623,306,218,524,54,578,928,62.28%,32.97%,1
屏東縣,枋山鄉,0624,275,208,483,19,502,972,51.65%,28.29%,1
屏東縣,枋山鄉,0625,262,176,438,41,479,1041,46.01%,25.17%,1
屏東縣,枋山鄉,0626,184,133,317,18,335,883,37.94%,20.84%,1
屏東縣,三地門鄉,0627,205,104,309,9,318,616,51.62%,33.28%,1
屏東縣,三地門鄉,0628,207,105,312,46,358,572,62.59%,36.19%,1
屏東縣,三地門鄉,0629,151,47,198,5,203,323,62.85%,46.75%,1
屏東縣,三地門鄉,0630,557,313,870,34,904,1448,62.43%,38.47%,1
屏東縣,三地門鄉,0631,271,116,387,6,393,726,54.13%,37.33%,1
屏東縣,三地門鄉,0632,176,116,292,13,305,554,55.05%,31.77%,1
屏東縣,三地門鄉,0633,136,93,229,9,238,346,68.79%,39.31%,1
屏東縣,三地門鄉,0634,247,83,330,7,337,458,73.58%,53.93%,1
屏東縣,三地門鄉,0635,323,128,451,19,470,692,67.92%,46.68%,1
屏東縣,三地門鄉,0636,246,169,415,49,464,638,72.73%,38.56%,1
屏東縣,霧臺鄉,0637,171,89,260,11,271,346,78.32%,49.42%,1
屏東縣,霧臺鄉,0638,355,141,496,23,519,677,76.66%,52.44%,1
屏東縣,霧臺鄉,0639,70,24,94,2,96,162,59.26%,43.21%,1
屏東縣,霧臺鄉,0640,84,26,110,8,118,189,62.43%,44.44%,1
屏東縣,霧臺鄉,0641,180,50,230,4,234,296,79.05%,60.81%,1
屏東縣,霧臺鄉,0642,295,102,397,10,407,483,84.27%,61.08%,1
屏東縣,霧臺鄉,0643,144,87,231,6,237,347,68.3%,41.5%,1
屏東縣,霧臺鄉,0644,274,90,364,16,380,450,84.44%,60.89%,1
屏東縣,瑪家鄉,0645,143,101,244,4,248,455,54.51%,31.43%,1
屏東縣,瑪家鄉,0646,341,189,530,19,549,821,66.87%,41.53%,1
屏東縣,瑪家鄉,0647,267,166,433,34,467,635,73.54%,42.05%,1
屏東縣,瑪家鄉,0648,374,124,498,28,526,695,75.68%,53.81%,1
屏東縣,瑪家鄉,0649,351,132,483,21,504,671,75.11%,52.31%,1
屏東縣,瑪家鄉,0650,441,192,633,24,657,1057,62.16%,41.72%,1
屏東縣,瑪家鄉,0651,326,198,524,20,544,900,60.44%,36.22%,1
屏東縣,瑪家鄉,0652,187,83,270,9,279,429,65.03%,43.59%,1
屏東縣,泰武鄉,0653,270,137,407,8,415,669,62.03%,40.36%,1
屏東縣,泰武鄉,0654,82,35,117,7,124,190,65.26%,43.16%,1
屏東縣,泰武鄉,0655,321,248,569,38,607,922,65.84%,34.82%,1
屏東縣,泰武鄉,0656,272,175,447,14,461,598,77.09%,45.48%,1
屏東縣,泰武鄉,0657,334,136,470,33,503,771,65.24%,43.32%,1
屏東縣,泰武鄉,0658,207,79,286,17,303,414,73.19%,50%,1
屏東縣,泰武鄉,0659,277,182,459,23,482,780,61.79%,35.51%,1
屏東縣,來義鄉,0660,413,150,563,61,624,917,68.05%,45.04%,1
屏東縣,來義鄉,0661,144,87,231,3,234,361,64.82%,39.89%,1
屏東縣,來義鄉,0662,101,31,132,3,135,216,62.5%,46.76%,1
屏東縣,來義鄉,0663,251,71,322,15,337,445,75.73%,56.4%,1
屏東縣,來義鄉,0664,121,53,174,8,182,280,65%,43.21%,1
屏東縣,來義鄉,0665,437,175,612,36,648,1097,59.07%,39.84%,1
屏東縣,來義鄉,0666,353,191,544,21,565,840,67.26%,42.02%,1
屏東縣,來義鄉,0667,286,160,446,10,456,889,51.29%,32.17%,1
屏東縣,來義鄉,0668,317,213,530,35,565,1212,46.62%,26.16%,1
屏東縣,春日鄉,0669,270,120,390,8,398,909,43.78%,29.7%,1
屏東縣,春日鄉,0670,243,115,358,11,369,663,55.66%,36.65%,1
屏東縣,春日鄉,0671,90,29,119,1,120,304,39.47%,29.61%,1
屏東縣,春日鄉,0672,271,182,453,15,468,928,50.43%,29.2%,1
屏東縣,春日鄉,0673,144,79,223,8,231,641,36.04%,22.46%,1
屏東縣,春日鄉,0674,77,80,157,5,162,478,33.89%,16.11%,1
屏東縣,獅子鄉,0675,307,104,411,12,423,751,56.32%,40.88%,1
屏東縣,獅子鄉,0676,301,134,435,26,461,776,59.41%,38.79%,1
屏東縣,獅子鄉,0677,377,110,487,14,501,711,70.46%,53.02%,1
屏東縣,獅子鄉,0678,102,75,177,12,189,243,77.78%,41.98%,1
屏東縣,獅子鄉,0679,155,67,222,9,231,325,71.08%,47.69%,1
屏東縣,獅子鄉,0680,151,107,258,7,265,476,55.67%,31.72%,1
屏東縣,獅子鄉,0681,319,81,400,14,414,602,68.77%,52.99%,1
屏東縣,獅子鄉,0682,102,70,172,3,175,346,50.58%,29.48%,1
屏東縣,牡丹鄉,0683,79,62,141,2,143,342,41.81%,23.1%,1
屏東縣,牡丹鄉,0684,356,272,628,34,662,1306,50.69%,27.26%,1
屏東縣,牡丹鄉,0685,120,80,200,2,202,693,29.15%,17.32%,1
屏東縣,牡丹鄉,0686,139,57,196,9,205,437,46.91%,31.81%,1
屏東縣,牡丹鄉,0687,108,82,190,6,196,392,50%,27.55%,1
屏東縣,牡丹鄉,0688,164,136,300,8,308,593,51.94%,27.66%,1
屏東縣,牡丹鄉,0689,76,55,131,5,136,551,24.68%,13.79%,1
宜蘭縣,宜蘭市,0001,307,213,520,13,533,982,54.28%,31.26%,1
宜蘭縣,宜蘭市,0002,426,246,672,30,702,1270,55.28%,33.54%,1
宜蘭縣,宜蘭市,0003,265,199,464,10,474,849,55.83%,31.21%,1
宜蘭縣,宜蘭市,0004,247,174,421,21,442,756,58.47%,32.67%,1
宜蘭縣,宜蘭市,0005,332,198,530,32,562,1107,50.77%,29.99%,1
宜蘭縣,宜蘭市,0006,287,182,469,29,498,893,55.77%,32.14%,1
宜蘭縣,宜蘭市,0007,286,192,478,28,506,912,55.48%,31.36%,1
宜蘭縣,宜蘭市,0008,438,279,717,35,752,1335,56.33%,32.81%,1
宜蘭縣,宜蘭市,0009,203,147,350,18,368,686,53.64%,29.59%,1
宜蘭縣,宜蘭市,0010,501,294,795,33,828,1366,60.61%,36.68%,1
宜蘭縣,宜蘭市,0011,428,331,759,18,777,1363,57.01%,31.4%,1
宜蘭縣,宜蘭市,0012,517,345,862,27,889,1540,57.73%,33.57%,1
宜蘭縣,宜蘭市,0013,449,300,749,14,763,1341,56.9%,33.48%,1
宜蘭縣,宜蘭市,0014,425,241,666,23,689,1209,56.99%,35.15%,1
宜蘭縣,宜蘭市,0015,278,217,495,24,519,900,57.67%,30.89%,1
宜蘭縣,宜蘭市,0016,314,186,500,19,519,980,52.96%,32.04%,1
宜蘭縣,宜蘭市,0017,343,287,630,26,656,1165,56.31%,29.44%,1
宜蘭縣,宜蘭市,0018,299,187,486,20,506,904,55.97%,33.08%,1
宜蘭縣,宜蘭市,0019,276,172,448,20,468,813,57.56%,33.95%,1
宜蘭縣,宜蘭市,0020,301,222,523,23,546,978,55.83%,30.78%,1
宜蘭縣,宜蘭市,0021,350,217,567,19,586,1282,45.71%,27.3%,1
宜蘭縣,宜蘭市,0022,160,103,263,11,274,465,58.92%,34.41%,1
宜蘭縣,宜蘭市,0023,239,130,369,27,396,669,59.19%,35.72%,1
宜蘭縣,宜蘭市,0024,309,197,506,20,526,923,56.99%,33.48%,1
宜蘭縣,宜蘭市,0025,314,209,523,13,536,1006,53.28%,31.21%,1
宜蘭縣,宜蘭市,0026,307,169,476,28,504,762,66.14%,40.29%,1
宜蘭縣,宜蘭市,0027,289,162,451,18,469,727,64.51%,39.75%,1
宜蘭縣,宜蘭市,0028,347,182,529,36,565,833,67.83%,41.66%,1
宜蘭縣,宜蘭市,0029,379,245,624,31,655,1143,57.31%,33.16%,1
宜蘭縣,宜蘭市,0030,309,227,536,12,548,979,55.98%,31.56%,1
宜蘭縣,宜蘭市,0031,388,253,641,44,685,1214,56.43%,31.96%,1
宜蘭縣,宜蘭市,0032,421,272,693,52,745,1283,58.07%,32.81%,1
宜蘭縣,宜蘭市,0033,308,219,527,27,554,946,58.56%,32.56%,1
宜蘭縣,宜蘭市,0034,304,248,552,36,588,1090,53.94%,27.89%,1
宜蘭縣,宜蘭市,0035,331,210,541,19,560,943,59.38%,35.1%,1
宜蘭縣,宜蘭市,0036,276,196,472,27,499,774,64.47%,35.66%,1
宜蘭縣,宜蘭市,0037,335,235,570,19,589,968,60.85%,34.61%,1
宜蘭縣,宜蘭市,0038,315,233,548,23,571,926,61.66%,34.02%,1
宜蘭縣,宜蘭市,0039,337,250,587,25,612,1019,60.06%,33.07%,1
宜蘭縣,宜蘭市,0040,350,232,582,35,617,1084,56.92%,32.29%,1
宜蘭縣,宜蘭市,0041,355,219,574,22,596,1095,54.43%,32.42%,1
宜蘭縣,宜蘭市,0042,328,269,597,26,623,1083,57.53%,30.29%,1
宜蘭縣,宜蘭市,0043,349,217,566,28,594,1108,53.61%,31.5%,1
宜蘭縣,宜蘭市,0044,285,194,479,17,496,848,58.49%,33.61%,1
宜蘭縣,宜蘭市,0045,347,237,584,25,609,1095,55.62%,31.69%,1
宜蘭縣,宜蘭市,0046,350,249,599,29,628,1110,56.58%,31.53%,1
宜蘭縣,宜蘭市,0047,375,239,614,32,646,1104,58.51%,33.97%,1
宜蘭縣,宜蘭市,0048,390,255,645,22,667,1134,58.82%,34.39%,1
宜蘭縣,宜蘭市,0049,365,266,631,31,662,1146,57.77%,31.85%,1
宜蘭縣,宜蘭市,0050,322,186,508,27,535,876,61.07%,36.76%,1
宜蘭縣,宜蘭市,0051,268,205,473,36,509,905,56.24%,29.61%,1
宜蘭縣,宜蘭市,0052,296,217,513,22,535,910,58.79%,32.53%,1
宜蘭縣,宜蘭市,0053,403,299,702,33,735,1434,51.26%,28.1%,1
宜蘭縣,宜蘭市,0054,357,230,587,52,639,1152,55.47%,30.99%,1
宜蘭縣,宜蘭市,0055,330,216,546,36,582,966,60.25%,34.16%,1
宜蘭縣,宜蘭市,0056,228,162,390,26,416,711,58.51%,32.07%,1
宜蘭縣,宜蘭市,0057,312,197,509,28,537,884,60.75%,35.29%,1
宜蘭縣,宜蘭市,0058,415,307,722,45,767,1326,57.84%,31.3%,1
宜蘭縣,宜蘭市,0059,260,199,459,17,476,909,52.37%,28.6%,1
宜蘭縣,宜蘭市,0060,278,186,464,26,490,894,54.81%,31.1%,1
宜蘭縣,宜蘭市,0061,359,259,618,22,640,1259,50.83%,28.51%,1
宜蘭縣,宜蘭市,0062,237,162,399,18,417,789,52.85%,30.04%,1
宜蘭縣,宜蘭市,0063,281,172,453,28,481,867,55.48%,32.41%,1
宜蘭縣,宜蘭市,0064,426,337,763,49,812,1454,55.85%,29.3%,1
宜蘭縣,宜蘭市,0065,442,233,675,16,691,1130,61.15%,39.12%,1
宜蘭縣,宜蘭市,0066,304,220,524,11,535,1087,49.22%,27.97%,1
宜蘭縣,宜蘭市,0067,311,226,537,43,580,938,61.83%,33.16%,1
宜蘭縣,宜蘭市,0068,409,280,689,29,718,1285,55.88%,31.83%,1
宜蘭縣,宜蘭市,0069,292,216,508,23,531,952,55.78%,30.67%,1
宜蘭縣,宜蘭市,0070,311,216,527,45,572,948,60.34%,32.81%,1
宜蘭縣,宜蘭市,0071,340,234,574,40,614,1160,52.93%,29.31%,1
宜蘭縣,宜蘭市,0072,325,235,560,44,604,1015,59.51%,32.02%,1
宜蘭縣,宜蘭市,0073,142,107,249,14,263,424,62.03%,33.49%,1
宜蘭縣,宜蘭市,0074,325,207,532,41,573,964,59.44%,33.71%,1
宜蘭縣,宜蘭市,0075,296,182,478,40,518,959,54.01%,30.87%,1
宜蘭縣,宜蘭市,0076,297,198,495,22,517,814,63.51%,36.49%,1
宜蘭縣,宜蘭市,0077,302,206,508,19,527,885,59.55%,34.12%,1
宜蘭縣,宜蘭市,0078,371,257,628,42,670,1162,57.66%,31.93%,1
宜蘭縣,羅東鎮,0079,219,165,384,23,407,689,59.07%,31.79%,1
宜蘭縣,羅東鎮,0080,242,140,382,18,400,718,55.71%,33.7%,1
宜蘭縣,羅東鎮,0081,456,310,766,53,819,1475,55.53%,30.92%,1
宜蘭縣,羅東鎮,0082,450,312,762,38,800,1466,54.57%,30.7%,1
宜蘭縣,羅東鎮,0083,316,263,579,27,606,1075,56.37%,29.4%,1
宜蘭縣,羅東鎮,0084,292,217,509,28,537,963,55.76%,30.32%,1
宜蘭縣,羅東鎮,0085,444,307,751,64,815,1511,53.94%,29.38%,1
宜蘭縣,羅東鎮,0086,328,284,612,30,642,1166,55.06%,28.13%,1
宜蘭縣,羅東鎮,0087,376,317,693,47,740,1273,58.13%,29.54%,1
宜蘭縣,羅東鎮,0088,553,335,888,27,915,1735,52.74%,31.87%,1
宜蘭縣,羅東鎮,0089,486,331,817,34,851,1487,57.23%,32.68%,1
宜蘭縣,羅東鎮,0090,256,218,474,29,503,837,60.1%,30.59%,1
宜蘭縣,羅東鎮,0091,449,296,745,48,793,1312,60.44%,34.22%,1
宜蘭縣,羅東鎮,0092,467,275,742,61,803,1502,53.46%,31.09%,1
宜蘭縣,羅東鎮,0093,346,232,578,24,602,1138,52.9%,30.4%,1
宜蘭縣,羅東鎮,0094,293,244,537,29,566,1010,56.04%,29.01%,1
宜蘭縣,羅東鎮,0095,472,272,744,52,796,1373,57.98%,34.38%,1
宜蘭縣,羅東鎮,0096,374,232,606,27,633,1089,58.13%,34.34%,1
宜蘭縣,羅東鎮,0097,384,285,669,42,711,1304,54.52%,29.45%,1
宜蘭縣,羅東鎮,0098,365,293,658,39,697,1288,54.11%,28.34%,1
宜蘭縣,羅東鎮,0099,334,261,595,47,642,1036,61.97%,32.24%,1
宜蘭縣,羅東鎮,0100,364,225,589,31,620,969,63.98%,37.56%,1
宜蘭縣,羅東鎮,0101,314,244,558,35,593,985,60.2%,31.88%,1
宜蘭縣,羅東鎮,0102,441,345,786,49,835,1420,58.8%,31.06%,1
宜蘭縣,羅東鎮,0103,443,331,774,46,820,1430,57.34%,30.98%,1
宜蘭縣,羅東鎮,0104,342,246,588,46,634,1075,58.98%,31.81%,1
宜蘭縣,羅東鎮,0105,290,216,506,25,531,879,60.41%,32.99%,1
宜蘭縣,羅東鎮,0106,256,208,464,11,475,850,55.88%,30.12%,1
宜蘭縣,羅東鎮,0107,365,275,640,24,664,1111,59.77%,32.85%,1
宜蘭縣,羅東鎮,0108,427,257,684,30,714,1139,62.69%,37.49%,1
宜蘭縣,羅東鎮,0109,396,267,663,35,698,1130,61.77%,35.04%,1
宜蘭縣,羅東鎮,0110,322,225,547,32,579,980,59.08%,32.86%,1
宜蘭縣,羅東鎮,0111,524,241,765,39,804,1431,56.18%,36.62%,1
宜蘭縣,羅東鎮,0112,360,250,610,25,635,1109,57.26%,32.46%,1
宜蘭縣,羅東鎮,0113,361,229,590,25,615,1083,56.79%,33.33%,1
宜蘭縣,羅東鎮,0114,462,310,772,44,816,1404,58.12%,32.91%,1
宜蘭縣,羅東鎮,0115,424,280,704,37,741,1288,57.53%,32.92%,1
宜蘭縣,羅東鎮,0116,321,199,520,27,547,1183,46.24%,27.13%,1
宜蘭縣,羅東鎮,0117,373,253,626,36,662,1105,59.91%,33.76%,1
宜蘭縣,羅東鎮,0118,334,241,575,31,606,987,61.4%,33.84%,1
宜蘭縣,羅東鎮,0119,277,165,442,32,474,773,61.32%,35.83%,1
宜蘭縣,羅東鎮,0120,448,389,837,32,869,1366,63.62%,32.8%,1
宜蘭縣,羅東鎮,0121,329,231,560,25,585,907,64.5%,36.27%,1
宜蘭縣,羅東鎮,0122,428,270,698,22,720,1158,62.18%,36.96%,1
宜蘭縣,羅東鎮,0123,306,205,511,53,564,977,57.73%,31.32%,1
宜蘭縣,羅東鎮,0124,295,202,497,35,532,972,54.73%,30.35%,1
宜蘭縣,羅東鎮,0125,341,211,552,29,581,977,59.47%,34.9%,1
宜蘭縣,羅東鎮,0126,489,293,782,44,826,1398,59.08%,34.98%,1
宜蘭縣,羅東鎮,0127,327,226,553,24,577,1022,56.46%,32%,1
宜蘭縣,羅東鎮,0128,412,252,664,32,696,1131,61.54%,36.43%,1
宜蘭縣,蘇澳鎮,0129,345,299,644,31,675,1194,56.53%,28.89%,1
宜蘭縣,蘇澳鎮,0130,337,251,588,33,621,1128,55.05%,29.88%,1
宜蘭縣,蘇澳鎮,0131,311,284,595,46,641,1042,61.52%,29.85%,1
宜蘭縣,蘇澳鎮,0132,305,254,559,28,587,997,58.88%,30.59%,1
宜蘭縣,蘇澳鎮,0133,383,298,681,58,739,1303,56.72%,29.39%,1
宜蘭縣,蘇澳鎮,0134,381,310,691,61,752,1260,59.68%,30.24%,1
宜蘭縣,蘇澳鎮,0135,330,265,595,46,641,1130,56.73%,29.2%,1
宜蘭縣,蘇澳鎮,0136,152,139,291,26,317,559,56.71%,27.19%,1
宜蘭縣,蘇澳鎮,0137,90,76,166,17,183,351,52.14%,25.64%,1
宜蘭縣,蘇澳鎮,0138,250,199,449,49,498,889,56.02%,28.12%,1
宜蘭縣,蘇澳鎮,0139,118,106,224,17,241,434,55.53%,27.19%,1
宜蘭縣,蘇澳鎮,0140,283,199,482,29,511,835,61.2%,33.89%,1
宜蘭縣,蘇澳鎮,0141,293,228,521,40,561,975,57.54%,30.05%,1
宜蘭縣,蘇澳鎮,0142,331,287,618,57,675,1135,59.47%,29.16%,1
宜蘭縣,蘇澳鎮,0143,273,204,477,37,514,788,65.23%,34.64%,1
宜蘭縣,蘇澳鎮,0144,135,105,240,19,259,469,55.22%,28.78%,1
宜蘭縣,蘇澳鎮,0145,244,176,420,24,444,811,54.75%,30.09%,1
宜蘭縣,蘇澳鎮,0146,262,201,463,14,477,867,55.02%,30.22%,1
宜蘭縣,蘇澳鎮,0147,350,258,608,35,643,1139,56.45%,30.73%,1
宜蘭縣,蘇澳鎮,0148,327,239,566,36,602,1146,52.53%,28.53%,1
宜蘭縣,蘇澳鎮,0149,332,282,614,39,653,1154,56.59%,28.77%,1
宜蘭縣,蘇澳鎮,0150,213,239,452,18,470,908,51.76%,23.46%,1
宜蘭縣,蘇澳鎮,0151,201,140,341,23,364,656,55.49%,30.64%,1
宜蘭縣,蘇澳鎮,0152,287,194,481,43,524,834,62.83%,34.41%,1
宜蘭縣,蘇澳鎮,0153,337,237,574,41,615,1025,60%,32.88%,1
宜蘭縣,蘇澳鎮,0154,140,112,252,12,264,455,58.02%,30.77%,1
宜蘭縣,蘇澳鎮,0155,181,101,282,32,314,535,58.69%,33.83%,1
宜蘭縣,蘇澳鎮,0156,173,141,314,28,342,536,63.81%,32.28%,1
宜蘭縣,蘇澳鎮,0157,145,122,267,9,276,451,61.2%,32.15%,1
宜蘭縣,蘇澳鎮,0158,172,131,303,30,333,593,56.16%,29.01%,1
宜蘭縣,蘇澳鎮,0159,130,103,233,21,254,441,57.6%,29.48%,1
宜蘭縣,蘇澳鎮,0160,288,214,502,46,548,954,57.44%,30.19%,1
宜蘭縣,蘇澳鎮,0161,271,198,469,52,521,952,54.73%,28.47%,1
宜蘭縣,蘇澳鎮,0162,304,239,543,52,595,1125,52.89%,27.02%,1
宜蘭縣,蘇澳鎮,0163,240,133,373,59,432,763,56.62%,31.45%,1
宜蘭縣,蘇澳鎮,0164,162,128,290,29,319,706,45.18%,22.95%,1
宜蘭縣,蘇澳鎮,0165,282,184,466,54,520,1068,48.69%,26.4%,1
宜蘭縣,蘇澳鎮,0166,186,160,346,42,388,666,58.26%,27.93%,1
宜蘭縣,蘇澳鎮,0167,141,124,265,64,329,574,57.32%,24.56%,1
宜蘭縣,蘇澳鎮,0168,72,87,159,6,165,351,47.01%,20.51%,1
宜蘭縣,蘇澳鎮,0169,233,132,365,40,405,717,56.49%,32.5%,1
宜蘭縣,蘇澳鎮,0170,96,40,136,19,155,373,41.55%,25.74%,1
宜蘭縣,蘇澳鎮,0171,39,46,85,10,95,223,42.6%,17.49%,1
宜蘭縣,頭城鎮,0172,58,37,95,12,107,292,36.64%,19.86%,1
宜蘭縣,頭城鎮,0173,181,159,340,30,370,688,53.78%,26.31%,1
宜蘭縣,頭城鎮,0174,200,154,354,42,396,688,57.56%,29.07%,1
宜蘭縣,頭城鎮,0175,238,174,412,39,451,879,51.31%,27.08%,1
宜蘭縣,頭城鎮,0176,93,89,182,22,204,335,60.9%,27.76%,1
宜蘭縣,頭城鎮,0177,242,126,368,24,392,624,62.82%,38.78%,1
宜蘭縣,頭城鎮,0178,193,129,322,23,345,732,47.13%,26.37%,1
宜蘭縣,頭城鎮,0179,206,180,386,33,419,892,46.97%,23.09%,1
宜蘭縣,頭城鎮,0180,164,126,290,23,313,690,45.36%,23.77%,1
宜蘭縣,頭城鎮,0181,250,172,422,30,452,842,53.68%,29.69%,1
宜蘭縣,頭城鎮,0182,211,169,380,31,411,736,55.84%,28.67%,1
宜蘭縣,頭城鎮,0183,226,162,388,15,403,788,51.14%,28.68%,1
宜蘭縣,頭城鎮,0184,136,132,268,19,287,560,51.25%,24.29%,1
宜蘭縣,頭城鎮,0185,257,146,403,22,425,712,59.69%,36.1%,1
宜蘭縣,頭城鎮,0186,177,126,303,19,322,502,64.14%,35.26%,1
宜蘭縣,頭城鎮,0187,202,128,330,28,358,569,62.92%,35.5%,1
宜蘭縣,頭城鎮,0188,212,127,339,22,361,633,57.03%,33.49%,1
宜蘭縣,頭城鎮,0189,271,223,494,44,538,1132,47.53%,23.94%,1
宜蘭縣,頭城鎮,0190,283,188,471,25,496,1035,47.92%,27.34%,1
宜蘭縣,頭城鎮,0191,282,192,474,30,504,847,59.5%,33.29%,1
宜蘭縣,頭城鎮,0192,367,260,627,37,664,1172,56.66%,31.31%,1
宜蘭縣,頭城鎮,0193,235,200,435,35,470,896,52.46%,26.23%,1
宜蘭縣,頭城鎮,0194,322,276,598,23,621,1075,57.77%,29.95%,1
宜蘭縣,頭城鎮,0195,267,233,500,46,546,931,58.65%,28.68%,1
宜蘭縣,頭城鎮,0196,349,181,530,31,561,1021,54.95%,34.18%,1
宜蘭縣,頭城鎮,0197,200,122,322,29,351,709,49.51%,28.21%,1
宜蘭縣,頭城鎮,0198,248,156,404,38,442,689,64.15%,35.99%,1
宜蘭縣,頭城鎮,0199,211,143,354,30,384,615,62.44%,34.31%,1
宜蘭縣,頭城鎮,0200,218,163,381,34,415,759,54.68%,28.72%,1
宜蘭縣,頭城鎮,0201,320,181,501,63,564,917,61.5%,34.9%,1
宜蘭縣,頭城鎮,0202,327,218,545,58,603,1045,57.7%,31.29%,1
宜蘭縣,頭城鎮,0203,343,245,588,49,637,1130,56.37%,30.35%,1
宜蘭縣,礁溪鄉,0204,320,212,532,29,561,1122,50%,28.52%,1
宜蘭縣,礁溪鄉,0205,145,103,248,19,267,505,52.87%,28.71%,1
宜蘭縣,礁溪鄉,0206,292,198,490,24,514,988,52.02%,29.55%,1
宜蘭縣,礁溪鄉,0207,291,213,504,18,522,971,53.76%,29.97%,1
宜蘭縣,礁溪鄉,0208,344,238,582,41,623,1246,50%,27.61%,1
宜蘭縣,礁溪鄉,0209,411,355,766,25,791,1655,47.79%,24.83%,1
宜蘭縣,礁溪鄉,0210,277,216,493,20,513,1132,45.32%,24.47%,1
宜蘭縣,礁溪鄉,0211,265,159,424,19,443,783,56.58%,33.84%,1
宜蘭縣,礁溪鄉,0212,287,188,475,25,500,928,53.88%,30.93%,1
宜蘭縣,礁溪鄉,0213,270,161,431,28,459,848,54.13%,31.84%,1
宜蘭縣,礁溪鄉,0214,221,169,390,32,422,663,63.65%,33.33%,1
宜蘭縣,礁溪鄉,0215,195,129,324,17,341,608,56.09%,32.07%,1
宜蘭縣,礁溪鄉,0216,289,153,442,31,473,833,56.78%,34.69%,1
宜蘭縣,礁溪鄉,0217,314,259,573,24,597,1233,48.42%,25.47%,1
宜蘭縣,礁溪鄉,0218,226,203,429,51,480,854,56.21%,26.46%,1
宜蘭縣,礁溪鄉,0219,144,138,282,23,305,575,53.04%,25.04%,1
宜蘭縣,礁溪鄉,0220,239,195,434,35,469,835,56.17%,28.62%,1
宜蘭縣,礁溪鄉,0221,386,318,704,44,748,1305,57.32%,29.58%,1
宜蘭縣,礁溪鄉,0222,233,182,415,45,460,830,55.42%,28.07%,1
宜蘭縣,礁溪鄉,0223,215,175,390,38,428,649,65.95%,33.13%,1
宜蘭縣,礁溪鄉,0224,233,194,427,37,464,923,50.27%,25.24%,1
宜蘭縣,礁溪鄉,0225,308,218,526,32,558,1177,47.41%,26.17%,1
宜蘭縣,礁溪鄉,0226,252,181,433,29,462,840,55%,30%,1
宜蘭縣,礁溪鄉,0227,331,237,568,31,599,1051,56.99%,31.49%,1
宜蘭縣,礁溪鄉,0228,380,272,652,38,690,1339,51.53%,28.38%,1
宜蘭縣,礁溪鄉,0229,405,268,673,35,708,1194,59.3%,33.92%,1
宜蘭縣,礁溪鄉,0230,455,297,752,37,789,1314,60.05%,34.63%,1
宜蘭縣,礁溪鄉,0231,307,285,592,33,625,1125,55.56%,27.29%,1
宜蘭縣,礁溪鄉,0232,359,311,670,54,724,1207,59.98%,29.74%,1
宜蘭縣,礁溪鄉,0233,280,222,502,47,549,979,56.08%,28.6%,1
宜蘭縣,礁溪鄉,0234,288,242,530,54,584,954,61.22%,30.19%,1
宜蘭縣,礁溪鄉,0235,127,91,218,14,232,418,55.5%,30.38%,1
宜蘭縣,壯圍鄉,0236,499,315,814,57,871,1435,60.7%,34.77%,1
宜蘭縣,壯圍鄉,0237,362,246,608,24,632,1049,60.25%,34.51%,1
宜蘭縣,壯圍鄉,0238,333,286,619,41,660,1068,61.8%,31.18%,1
宜蘭縣,壯圍鄉,0239,280,173,453,52,505,868,58.18%,32.26%,1
宜蘭縣,壯圍鄉,0240,304,206,510,33,543,967,56.15%,31.44%,1
宜蘭縣,壯圍鄉,0241,309,226,535,48,583,940,62.02%,32.87%,1
宜蘭縣,壯圍鄉,0242,281,175,456,28,484,975,49.64%,28.82%,1
宜蘭縣,壯圍鄉,0243,260,179,439,50,489,797,61.36%,32.62%,1
宜蘭縣,壯圍鄉,0244,270,170,440,35,475,808,58.79%,33.42%,1
宜蘭縣,壯圍鄉,0245,290,202,492,58,550,911,60.37%,31.83%,1
宜蘭縣,壯圍鄉,0246,178,113,291,26,317,612,51.8%,29.08%,1
宜蘭縣,壯圍鄉,0247,281,179,460,44,504,790,63.8%,35.57%,1
宜蘭縣,壯圍鄉,0248,277,205,482,46,528,878,60.14%,31.55%,1
宜蘭縣,壯圍鄉,0249,250,191,441,37,478,723,66.11%,34.58%,1
宜蘭縣,壯圍鄉,0250,238,137,375,25,400,737,54.27%,32.29%,1
宜蘭縣,壯圍鄉,0251,227,153,380,34,414,686,60.35%,33.09%,1
宜蘭縣,壯圍鄉,0252,286,191,477,11,488,895,54.53%,31.96%,1
宜蘭縣,壯圍鄉,0253,453,262,715,43,758,1237,61.28%,36.62%,1
宜蘭縣,壯圍鄉,0254,353,249,602,49,651,1134,57.41%,31.13%,1
宜蘭縣,壯圍鄉,0255,371,211,582,42,624,1107,56.37%,33.51%,1
宜蘭縣,壯圍鄉,0256,381,229,610,37,647,1057,61.21%,36.05%,1
宜蘭縣,壯圍鄉,0257,282,226,508,40,548,1051,52.14%,26.83%,1
宜蘭縣,壯圍鄉,0258,211,163,374,31,405,722,56.09%,29.22%,1
宜蘭縣,員山鄉,0259,396,293,689,38,727,1393,52.19%,28.43%,1
宜蘭縣,員山鄉,0260,271,170,441,24,465,895,51.96%,30.28%,1
宜蘭縣,員山鄉,0261,409,211,620,49,669,1231,54.35%,33.23%,1
宜蘭縣,員山鄉,0262,338,204,542,25,567,1098,51.64%,30.78%,1
宜蘭縣,員山鄉,0263,315,201,516,30,546,1031,52.96%,30.55%,1
宜蘭縣,員山鄉,0264,289,212,501,56,557,1030,54.08%,28.06%,1
宜蘭縣,員山鄉,0265,301,223,524,36,560,1168,47.95%,25.77%,1
宜蘭縣,員山鄉,0266,242,182,424,40,464,809,57.35%,29.91%,1
宜蘭縣,員山鄉,0267,228,185,413,36,449,778,57.71%,29.31%,1
宜蘭縣,員山鄉,0268,469,333,802,45,847,1465,57.82%,32.01%,1
宜蘭縣,員山鄉,0269,328,212,540,45,585,979,59.75%,33.5%,1
宜蘭縣,員山鄉,0270,259,193,452,31,483,860,56.16%,30.12%,1
宜蘭縣,員山鄉,0271,302,251,553,48,601,1205,49.88%,25.06%,1
宜蘭縣,員山鄉,0272,377,203,580,32,612,1082,56.56%,34.84%,1
宜蘭縣,員山鄉,0273,133,98,231,16,247,412,59.95%,32.28%,1
宜蘭縣,員山鄉,0274,114,71,185,14,199,403,49.38%,28.29%,1
宜蘭縣,員山鄉,0275,52,42,94,10,104,232,44.83%,22.41%,1
宜蘭縣,員山鄉,0276,278,207,485,28,513,944,54.34%,29.45%,1
宜蘭縣,員山鄉,0277,273,185,458,45,503,894,56.26%,30.54%,1
宜蘭縣,員山鄉,0278,462,263,725,35,760,1356,56.05%,34.07%,1
宜蘭縣,員山鄉,0279,250,175,425,34,459,780,58.85%,32.05%,1
宜蘭縣,員山鄉,0280,358,200,558,33,591,932,63.41%,38.41%,1
宜蘭縣,員山鄉,0281,159,115,274,30,304,583,52.14%,27.27%,1
宜蘭縣,員山鄉,0282,286,177,463,40,503,900,55.89%,31.78%,1
宜蘭縣,員山鄉,0283,222,170,392,22,414,747,55.42%,29.72%,1
宜蘭縣,員山鄉,0284,135,263,398,37,435,788,55.2%,17.13%,1
宜蘭縣,員山鄉,0285,223,202,425,42,467,884,52.83%,25.23%,1
宜蘭縣,員山鄉,0286,233,185,418,29,447,857,52.16%,27.19%,1
宜蘭縣,員山鄉,0287,278,229,507,17,524,1016,51.57%,27.36%,1
宜蘭縣,員山鄉,0288,150,127,277,31,308,690,44.64%,21.74%,1
宜蘭縣,員山鄉,0289,181,135,316,50,366,689,53.12%,26.27%,1
宜蘭縣,冬山鄉,0290,258,184,442,44,486,807,60.22%,31.97%,1
宜蘭縣,冬山鄉,0291,264,200,464,21,485,817,59.36%,32.31%,1
宜蘭縣,冬山鄉,0292,348,275,623,36,659,1156,57.01%,30.1%,1
宜蘭縣,冬山鄉,0293,246,204,450,36,486,892,54.48%,27.58%,1
宜蘭縣,冬山鄉,0294,298,230,528,0,528,897,58.86%,33.22%,1
宜蘭縣,冬山鄉,0295,442,372,814,29,843,1392,60.56%,31.75%,1
宜蘭縣,冬山鄉,0296,433,376,809,34,843,1471,57.31%,29.44%,1
宜蘭縣,冬山鄉,0297,383,284,667,22,689,1435,48.01%,26.69%,1
宜蘭縣,冬山鄉,0298,428,327,755,36,791,1519,52.07%,28.18%,1
宜蘭縣,冬山鄉,0299,459,345,804,35,839,1456,57.62%,31.52%,1
宜蘭縣,冬山鄉,0300,252,166,418,21,439,711,61.74%,35.44%,1
宜蘭縣,冬山鄉,0301,218,167,385,19,404,694,58.21%,31.41%,1
宜蘭縣,冬山鄉,0302,485,424,909,56,965,1526,63.24%,31.78%,1
宜蘭縣,冬山鄉,0303,249,215,464,25,489,884,55.32%,28.17%,1
宜蘭縣,冬山鄉,0304,400,65,465,54,519,1465,35.43%,27.3%,1
宜蘭縣,冬山鄉,0305,157,103,260,25,285,488,58.4%,32.17%,1
宜蘭縣,冬山鄉,0306,359,244,603,48,651,1218,53.45%,29.47%,1
宜蘭縣,冬山鄉,0307,344,274,618,45,663,1291,51.36%,26.65%,1
宜蘭縣,冬山鄉,0308,378,262,640,33,673,1324,50.83%,28.55%,1
宜蘭縣,冬山鄉,0309,234,304,538,38,576,1160,49.66%,20.17%,1
宜蘭縣,冬山鄉,0310,370,253,623,51,674,1246,54.09%,29.7%,1
宜蘭縣,冬山鄉,0311,492,381,873,41,914,1754,52.11%,28.05%,1
宜蘭縣,冬山鄉,0312,331,284,615,34,649,1217,53.33%,27.2%,1
宜蘭縣,冬山鄉,0313,377,299,676,45,721,1495,48.23%,25.22%,1
宜蘭縣,冬山鄉,0314,239,236,475,36,511,937,54.54%,25.51%,1
宜蘭縣,冬山鄉,0315,305,242,547,33,580,1101,52.68%,27.7%,1
宜蘭縣,冬山鄉,0316,325,221,546,40,586,1118,52.42%,29.07%,1
宜蘭縣,冬山鄉,0317,421,300,721,31,752,1301,57.8%,32.36%,1
宜蘭縣,冬山鄉,0318,343,288,631,25,656,1225,53.55%,28%,1
宜蘭縣,冬山鄉,0319,371,295,666,40,706,1206,58.54%,30.76%,1
宜蘭縣,冬山鄉,0320,366,252,618,33,651,1278,50.94%,28.64%,1
宜蘭縣,冬山鄉,0321,324,244,568,36,604,1151,52.48%,28.15%,1
宜蘭縣,冬山鄉,0322,321,183,504,38,542,1094,49.54%,29.34%,1
宜蘭縣,冬山鄉,0323,385,283,668,39,707,1247,56.7%,30.87%,1
宜蘭縣,冬山鄉,0324,332,260,592,40,632,1247,50.68%,26.62%,1
宜蘭縣,冬山鄉,0325,293,223,516,22,538,979,54.95%,29.93%,1
宜蘭縣,冬山鄉,0326,259,147,406,17,423,698,60.6%,37.11%,1
宜蘭縣,冬山鄉,0327,513,366,879,39,918,1726,53.19%,29.72%,1
宜蘭縣,冬山鄉,0328,197,158,355,19,374,782,47.83%,25.19%,1
宜蘭縣,五結鄉,0329,303,213,516,36,552,1076,51.3%,28.16%,1
宜蘭縣,五結鄉,0330,251,229,480,22,502,944,53.18%,26.59%,1
宜蘭縣,五結鄉,0331,286,181,467,25,492,836,58.85%,34.21%,1
宜蘭縣,五結鄉,0332,296,206,502,31,533,937,56.88%,31.59%,1
宜蘭縣,五結鄉,0333,369,263,632,31,663,1255,52.83%,29.4%,1
宜蘭縣,五結鄉,0334,373,268,641,46,687,1270,54.09%,29.37%,1
宜蘭縣,五結鄉,0335,226,163,389,26,415,801,51.81%,28.21%,1
宜蘭縣,五結鄉,0336,224,172,396,23,419,802,52.24%,27.93%,1
宜蘭縣,五結鄉,0337,366,262,628,26,654,1306,50.08%,28.02%,1
宜蘭縣,五結鄉,0338,346,249,595,32,627,1190,52.69%,29.08%,1
宜蘭縣,五結鄉,0339,397,286,683,25,708,1316,53.8%,30.17%,1
宜蘭縣,五結鄉,0340,301,223,524,26,550,965,56.99%,31.19%,1
宜蘭縣,五結鄉,0341,230,177,407,31,438,814,53.81%,28.26%,1
宜蘭縣,五結鄉,0342,358,251,609,46,655,1254,52.23%,28.55%,1
宜蘭縣,五結鄉,0343,360,223,583,22,605,1060,57.08%,33.96%,1
宜蘭縣,五結鄉,0344,404,307,711,28,739,1323,55.86%,30.54%,1
宜蘭縣,五結鄉,0345,356,244,600,40,640,1120,57.14%,31.79%,1
宜蘭縣,五結鄉,0346,269,189,458,20,478,893,53.53%,30.12%,1
宜蘭縣,五結鄉,0347,338,258,596,49,645,1220,52.87%,27.7%,1
宜蘭縣,五結鄉,0348,302,211,513,24,537,924,58.12%,32.68%,1
宜蘭縣,五結鄉,0349,324,214,538,29,567,933,60.77%,34.73%,1
宜蘭縣,五結鄉,0350,315,183,498,30,528,986,53.55%,31.95%,1
宜蘭縣,五結鄉,0351,240,140,380,28,408,748,54.55%,32.09%,1
宜蘭縣,五結鄉,0352,452,325,777,60,837,1550,54%,29.16%,1
宜蘭縣,五結鄉,0353,202,140,342,21,363,629,57.71%,32.11%,1
宜蘭縣,五結鄉,0354,200,212,412,31,443,806,54.96%,24.81%,1
宜蘭縣,五結鄉,0355,261,204,465,38,503,956,52.62%,27.3%,1
宜蘭縣,五結鄉,0356,323,164,487,32,519,1066,48.69%,30.3%,1
宜蘭縣,五結鄉,0357,383,305,688,63,751,1513,49.64%,25.31%,1
宜蘭縣,五結鄉,0358,436,346,782,47,829,1566,52.94%,27.84%,1
宜蘭縣,五結鄉,0359,244,198,442,54,496,894,55.48%,27.29%,1
宜蘭縣,五結鄉,0360,290,251,541,45,586,1235,47.45%,23.48%,1
宜蘭縣,五結鄉,0361,203,155,358,39,397,704,56.39%,28.84%,1
宜蘭縣,三星鄉,0362,72,39,111,8,119,215,55.35%,33.49%,1
宜蘭縣,三星鄉,0363,158,68,226,15,241,523,46.08%,30.21%,1
宜蘭縣,三星鄉,0364,205,158,363,27,390,745,52.35%,27.52%,1
宜蘭縣,三星鄉,0365,181,117,298,23,321,617,52.03%,29.34%,1
宜蘭縣,三星鄉,0366,161,82,243,23,266,497,53.52%,32.39%,1
宜蘭縣,三星鄉,0367,220,154,374,41,415,735,56.46%,29.93%,1
宜蘭縣,三星鄉,0368,185,119,304,23,327,583,56.09%,31.73%,1
宜蘭縣,三星鄉,0369,126,85,211,24,235,436,53.9%,28.9%,1
宜蘭縣,三星鄉,0370,370,248,618,35,653,1224,53.35%,30.23%,1
宜蘭縣,三星鄉,0371,351,202,553,24,577,1151,50.13%,30.5%,1
宜蘭縣,三星鄉,0372,266,192,458,22,480,870,55.17%,30.57%,1
宜蘭縣,三星鄉,0373,298,198,496,41,537,1284,41.82%,23.21%,1
宜蘭縣,三星鄉,0374,275,216,491,42,533,897,59.42%,30.66%,1
宜蘭縣,三星鄉,0375,445,295,740,40,780,1439,54.2%,30.92%,1
宜蘭縣,三星鄉,0376,400,292,692,44,736,1445,50.93%,27.68%,1
宜蘭縣,三星鄉,0377,400,304,704,40,744,1402,53.07%,28.53%,1
宜蘭縣,三星鄉,0378,369,253,622,27,649,1230,52.76%,30%,1
宜蘭縣,三星鄉,0379,230,160,390,42,432,774,55.81%,29.72%,1
宜蘭縣,三星鄉,0380,177,273,450,32,482,827,58.28%,21.4%,1
宜蘭縣,三星鄉,0381,225,159,384,25,409,736,55.57%,30.57%,1
宜蘭縣,三星鄉,0382,421,278,699,50,749,1421,52.71%,29.63%,1
宜蘭縣,大同鄉,0383,409,140,549,31,580,893,64.95%,45.8%,1
宜蘭縣,大同鄉,0384,310,132,442,20,462,632,73.1%,49.05%,1
宜蘭縣,大同鄉,0385,319,129,448,15,463,684,67.69%,46.64%,1
宜蘭縣,大同鄉,0386,120,45,165,12,177,264,67.05%,45.45%,1
宜蘭縣,大同鄉,0387,172,54,226,4,230,337,68.25%,51.04%,1
宜蘭縣,大同鄉,0388,267,53,320,6,326,404,80.69%,66.09%,1
宜蘭縣,大同鄉,0389,15,8,23,4,27,55,49.09%,27.27%,1
宜蘭縣,大同鄉,0390,100,48,148,8,156,199,78.39%,50.25%,1
宜蘭縣,大同鄉,0391,474,127,601,15,616,787,78.27%,60.23%,1
宜蘭縣,大同鄉,0392,362,131,493,30,523,680,76.91%,53.24%,1
宜蘭縣,南澳鄉,0393,186,96,282,4,286,444,64.41%,41.89%,1
宜蘭縣,南澳鄉,0394,414,188,602,14,616,1210,50.91%,34.21%,1
宜蘭縣,南澳鄉,0395,451,160,611,32,643,962,66.84%,46.88%,1
宜蘭縣,南澳鄉,0396,171,73,244,15,259,411,63.02%,41.61%,1
宜蘭縣,南澳鄉,0397,201,92,293,23,316,447,70.69%,44.97%,1
宜蘭縣,南澳鄉,0398,239,109,348,20,368,475,77.47%,50.32%,1
宜蘭縣,南澳鄉,0399,238,161,399,20,419,695,60.29%,34.24%,1
花蓮縣,花蓮市,0001,553,298,851,17,868,1522,57.03%,36.33%,1
花蓮縣,花蓮市,0002,426,215,641,11,652,1114,58.53%,38.24%,1
花蓮縣,花蓮市,0003,234,126,360,17,377,670,56.27%,34.93%,1
花蓮縣,花蓮市,0004,471,245,716,22,738,1397,52.83%,33.72%,1
花蓮縣,花蓮市,0005,131,94,225,14,239,470,50.85%,27.87%,1
花蓮縣,花蓮市,0006,274,143,417,20,437,838,52.15%,32.7%,1
花蓮縣,花蓮市,0007,199,103,302,18,320,721,44.38%,27.6%,1
花蓮縣,花蓮市,0008,303,198,501,33,534,918,58.17%,33.01%,1
花蓮縣,花蓮市,0009,478,303,781,31,812,1539,52.76%,31.06%,1
花蓮縣,花蓮市,0010,480,241,721,27,748,1403,53.31%,34.21%,1
花蓮縣,花蓮市,0011,344,203,547,21,568,1068,53.18%,32.21%,1
花蓮縣,花蓮市,0012,415,209,624,21,645,1167,55.27%,35.56%,1
花蓮縣,花蓮市,0013,477,242,719,37,756,1259,60.05%,37.89%,1
花蓮縣,花蓮市,0014,404,80,484,40,524,1071,48.93%,37.72%,1
花蓮縣,花蓮市,0015,330,190,520,9,529,925,57.19%,35.68%,1
花蓮縣,花蓮市,0016,431,254,685,29,714,1141,62.58%,37.77%,1
花蓮縣,花蓮市,0017,392,208,600,16,616,1163,52.97%,33.71%,1
花蓮縣,花蓮市,0018,478,237,715,32,747,1279,58.41%,37.37%,1
花蓮縣,花蓮市,0019,486,246,732,19,751,1512,49.67%,32.14%,1
花蓮縣,花蓮市,0020,210,113,323,11,334,615,54.31%,34.15%,1
花蓮縣,花蓮市,0021,221,132,353,7,360,606,59.41%,36.47%,1
花蓮縣,花蓮市,0022,169,106,275,9,284,559,50.81%,30.23%,1
花蓮縣,花蓮市,0023,143,91,234,14,248,442,56.11%,32.35%,1
花蓮縣,花蓮市,0024,342,212,554,27,581,1114,52.15%,30.7%,1
花蓮縣,花蓮市,0025,141,89,230,11,241,416,57.93%,33.89%,1
花蓮縣,花蓮市,0026,216,125,341,14,355,577,61.53%,37.44%,1
花蓮縣,花蓮市,0027,266,204,470,24,494,810,60.99%,32.84%,1
花蓮縣,花蓮市,0028,182,106,288,20,308,538,57.25%,33.83%,1
花蓮縣,花蓮市,0029,170,119,289,21,310,566,54.77%,30.04%,1
花蓮縣,花蓮市,0030,175,89,264,9,273,469,58.21%,37.31%,1
花蓮縣,花蓮市,0031,201,111,312,14,326,565,57.7%,35.58%,1
花蓮縣,花蓮市,0032,258,135,393,18,411,816,50.37%,31.62%,1
花蓮縣,花蓮市,0033,268,184,452,29,481,911,52.8%,29.42%,1
花蓮縣,花蓮市,0034,309,202,511,26,537,1029,52.19%,30.03%,1
花蓮縣,花蓮市,0035,390,196,586,31,617,1043,59.16%,37.39%,1
花蓮縣,花蓮市,0036,302,175,477,18,495,856,57.83%,35.28%,1
花蓮縣,花蓮市,0037,302,226,528,16,544,979,55.57%,30.85%,1
花蓮縣,花蓮市,0038,431,294,725,28,753,1331,56.57%,32.38%,1
花蓮縣,花蓮市,0039,402,276,678,19,697,1228,56.76%,32.74%,1
花蓮縣,花蓮市,0040,319,210,529,19,548,955,57.38%,33.4%,1
花蓮縣,花蓮市,0041,385,239,624,22,646,1268,50.95%,30.36%,1
花蓮縣,花蓮市,0042,363,240,603,41,644,1230,52.36%,29.51%,1
花蓮縣,花蓮市,0043,477,265,742,31,773,1369,56.46%,34.84%,1
花蓮縣,花蓮市,0044,409,252,661,20,681,1435,47.46%,28.5%,1
花蓮縣,花蓮市,0045,389,231,620,19,639,1164,54.9%,33.42%,1
花蓮縣,花蓮市,0046,441,270,711,30,741,1249,59.33%,35.31%,1
花蓮縣,花蓮市,0047,383,227,610,46,656,1184,55.41%,32.35%,1
花蓮縣,花蓮市,0048,467,290,757,30,787,1490,52.82%,31.34%,1
花蓮縣,花蓮市,0049,378,228,606,38,644,1022,63.01%,36.99%,1
花蓮縣,花蓮市,0050,364,237,601,37,638,1135,56.21%,32.07%,1
花蓮縣,花蓮市,0051,384,202,586,24,610,1084,56.27%,35.42%,1
花蓮縣,花蓮市,0052,288,196,484,17,501,1339,37.42%,21.51%,1
花蓮縣,花蓮市,0053,199,90,289,12,301,501,60.08%,39.72%,1
花蓮縣,花蓮市,0054,321,169,490,14,504,904,55.75%,35.51%,1
花蓮縣,花蓮市,0055,175,116,291,13,304,490,62.04%,35.71%,1
花蓮縣,花蓮市,0056,342,216,558,23,581,1192,48.74%,28.69%,1
花蓮縣,花蓮市,0057,243,172,415,20,435,869,50.06%,27.96%,1
花蓮縣,花蓮市,0058,397,246,643,34,677,1267,53.43%,31.33%,1
花蓮縣,花蓮市,0059,336,193,529,27,556,959,57.98%,35.04%,1
花蓮縣,花蓮市,0060,345,178,523,21,544,993,54.78%,34.74%,1
花蓮縣,花蓮市,0061,315,205,520,32,552,982,56.21%,32.08%,1
花蓮縣,花蓮市,0062,371,249,620,24,644,1311,49.12%,28.3%,1
花蓮縣,花蓮市,0063,424,292,716,34,750,1455,51.55%,29.14%,1
花蓮縣,花蓮市,0064,331,192,523,15,538,1151,46.74%,28.76%,1
花蓮縣,花蓮市,0065,363,228,591,21,612,1237,49.47%,29.35%,1
花蓮縣,花蓮市,0066,383,238,621,25,646,1339,48.24%,28.6%,1
花蓮縣,花蓮市,0067,238,158,396,20,416,715,58.18%,33.29%,1
花蓮縣,花蓮市,0068,311,221,532,26,558,1000,55.8%,31.1%,1
花蓮縣,花蓮市,0069,420,243,663,36,699,1410,49.57%,29.79%,1
花蓮縣,花蓮市,0070,430,244,674,19,693,1303,53.18%,33%,1
花蓮縣,花蓮市,0071,415,233,648,26,674,1256,53.66%,33.04%,1
花蓮縣,花蓮市,0072,416,187,603,33,636,1105,57.56%,37.65%,1
花蓮縣,花蓮市,0073,325,210,535,23,558,1089,51.24%,29.84%,1
花蓮縣,花蓮市,0074,315,184,499,29,528,1043,50.62%,30.2%,1
花蓮縣,花蓮市,0075,374,219,593,25,618,1080,57.22%,34.63%,1
花蓮縣,花蓮市,0076,337,193,530,19,549,971,56.54%,34.71%,1
花蓮縣,花蓮市,0077,348,244,592,21,613,1068,57.4%,32.58%,1
花蓮縣,花蓮市,0078,408,255,663,31,694,1379,50.33%,29.59%,1
花蓮縣,花蓮市,0079,418,263,681,36,717,1362,52.64%,30.69%,1
花蓮縣,花蓮市,0080,440,287,727,30,757,1323,57.22%,33.26%,1
花蓮縣,花蓮市,0081,398,253,651,30,681,1482,45.95%,26.86%,1
花蓮縣,鳳林鎮,0195,445,243,688,49,737,1192,61.83%,37.33%,1
花蓮縣,鳳林鎮,0196,196,114,310,15,325,639,50.86%,30.67%,1
花蓮縣,鳳林鎮,0197,234,137,371,30,401,601,66.72%,38.94%,1
花蓮縣,鳳林鎮,0198,420,267,687,43,730,1137,64.2%,36.94%,1
花蓮縣,鳳林鎮,0199,220,159,379,38,417,742,56.2%,29.65%,1
花蓮縣,鳳林鎮,0200,214,116,330,21,351,610,57.54%,35.08%,1
花蓮縣,鳳林鎮,0201,86,82,168,24,192,295,65.08%,29.15%,1
花蓮縣,鳳林鎮,0202,52,21,73,4,77,218,35.32%,23.85%,1
花蓮縣,鳳林鎮,0203,175,138,313,19,332,720,46.11%,24.31%,1
花蓮縣,鳳林鎮,0204,166,104,270,20,290,528,54.92%,31.44%,1
花蓮縣,鳳林鎮,0205,147,121,268,26,294,560,52.5%,26.25%,1
花蓮縣,鳳林鎮,0206,196,71,267,24,291,541,53.79%,36.23%,1
花蓮縣,鳳林鎮,0207,260,148,408,55,463,818,56.6%,31.78%,1
花蓮縣,鳳林鎮,0208,246,147,393,37,430,984,43.7%,25%,1
花蓮縣,鳳林鎮,0209,26,15,41,9,50,91,54.95%,28.57%,1
花蓮縣,玉里鎮,0254,319,197,516,32,548,1008,54.37%,31.65%,1
花蓮縣,玉里鎮,0255,343,188,531,30,561,939,59.74%,36.53%,1
花蓮縣,玉里鎮,0256,399,227,626,32,658,1256,52.39%,31.77%,1
花蓮縣,玉里鎮,0257,275,199,474,33,507,929,54.57%,29.6%,1
花蓮縣,玉里鎮,0258,283,217,500,36,536,979,54.75%,28.91%,1
花蓮縣,玉里鎮,0259,400,248,648,81,729,1244,58.6%,32.15%,1
花蓮縣,玉里鎮,0260,234,153,387,31,418,847,49.35%,27.63%,1
花蓮縣,玉里鎮,0261,211,139,350,32,382,772,49.48%,27.33%,1
花蓮縣,玉里鎮,0262,158,104,262,18,280,558,50.18%,28.32%,1
花蓮縣,玉里鎮,0263,151,98,249,12,261,800,32.63%,18.88%,1
花蓮縣,玉里鎮,0264,367,195,562,40,602,1286,46.81%,28.54%,1
花蓮縣,玉里鎮,0265,332,200,532,66,598,1246,47.99%,26.65%,1
花蓮縣,玉里鎮,0266,183,121,304,45,349,647,53.94%,28.28%,1
花蓮縣,玉里鎮,0267,270,101,371,21,392,990,39.6%,27.27%,1
花蓮縣,玉里鎮,0268,172,68,240,27,267,530,50.38%,32.45%,1
花蓮縣,玉里鎮,0269,263,131,394,34,428,979,43.72%,26.86%,1
花蓮縣,玉里鎮,0270,225,55,280,40,320,557,57.45%,40.39%,1
花蓮縣,玉里鎮,0271,131,59,190,20,210,434,48.39%,30.18%,1
花蓮縣,玉里鎮,0272,216,125,341,55,396,1065,37.18%,20.28%,1
花蓮縣,玉里鎮,0273,278,127,405,63,468,866,54.04%,32.1%,1
花蓮縣,玉里鎮,0274,246,137,383,18,401,769,52.15%,31.99%,1
花蓮縣,玉里鎮,0275,204,139,343,28,371,869,42.69%,23.48%,1
花蓮縣,玉里鎮,0276,267,157,424,27,451,1080,41.76%,24.72%,1
花蓮縣,新城鄉,0082,110,86,196,16,212,367,57.77%,29.97%,1
花蓮縣,新城鄉,0083,274,182,456,15,471,929,50.7%,29.49%,1
花蓮縣,新城鄉,0084,158,149,307,50,357,590,60.51%,26.78%,1
花蓮縣,新城鄉,0085,92,64,156,17,173,307,56.35%,29.97%,1
花蓮縣,新城鄉,0086,91,57,148,12,160,260,61.54%,35%,1
花蓮縣,新城鄉,0087,390,291,681,37,718,1283,55.96%,30.4%,1
花蓮縣,新城鄉,0088,290,148,438,23,461,885,52.09%,32.77%,1
花蓮縣,新城鄉,0089,243,186,429,20,449,770,58.31%,31.56%,1
花蓮縣,新城鄉,0090,447,255,702,39,741,1363,54.37%,32.8%,1
花蓮縣,新城鄉,0091,103,76,179,15,194,366,53.01%,28.14%,1
花蓮縣,新城鄉,0092,345,211,556,33,589,1163,50.64%,29.66%,1
花蓮縣,新城鄉,0093,512,303,815,39,854,1605,53.21%,31.9%,1
花蓮縣,新城鄉,0094,407,214,621,39,660,1194,55.28%,34.09%,1
花蓮縣,新城鄉,0095,333,198,531,25,556,979,56.79%,34.01%,1
花蓮縣,新城鄉,0096,474,320,794,35,829,1485,55.82%,31.92%,1
花蓮縣,新城鄉,0097,319,220,539,20,559,1070,52.24%,29.81%,1
花蓮縣,新城鄉,0098,356,257,613,22,635,1164,54.55%,30.58%,1
花蓮縣,新城鄉,0099,233,199,432,38,470,880,53.41%,26.48%,1
花蓮縣,新城鄉,0100,95,82,177,9,186,369,50.41%,25.75%,1
花蓮縣,吉安鄉,0115,333,199,532,28,560,1059,52.88%,31.44%,1
花蓮縣,吉安鄉,0116,304,210,514,32,546,983,55.54%,30.93%,1
花蓮縣,吉安鄉,0117,334,213,547,18,565,1031,54.8%,32.4%,1
花蓮縣,吉安鄉,0118,341,201,542,29,571,1105,51.67%,30.86%,1
花蓮縣,吉安鄉,0119,363,191,554,29,583,1107,52.66%,32.79%,1
花蓮縣,吉安鄉,0120,331,233,564,27,591,1179,50.13%,28.07%,1
花蓮縣,吉安鄉,0121,353,275,628,37,665,1453,45.77%,24.29%,1
花蓮縣,吉安鄉,0122,476,327,803,40,843,1432,58.87%,33.24%,1
花蓮縣,吉安鄉,0123,438,263,701,28,729,1320,55.23%,33.18%,1
花蓮縣,吉安鄉,0124,401,278,679,24,703,1356,51.84%,29.57%,1
花蓮縣,吉安鄉,0125,396,254,650,28,678,1295,52.36%,30.58%,1
花蓮縣,吉安鄉,0126,461,294,755,44,799,1467,54.46%,31.42%,1
花蓮縣,吉安鄉,0127,492,268,760,32,792,1515,52.28%,32.48%,1
花蓮縣,吉安鄉,0128,346,249,595,36,631,1063,59.36%,32.55%,1
花蓮縣,吉安鄉,0129,330,220,550,20,570,1284,44.39%,25.7%,1
花蓮縣,吉安鄉,0130,469,280,749,24,773,1380,56.01%,33.99%,1
花蓮縣,吉安鄉,0131,429,270,699,35,734,1297,56.59%,33.08%,1
花蓮縣,吉安鄉,0132,459,334,793,65,858,1662,51.62%,27.62%,1
花蓮縣,吉安鄉,0133,461,247,708,50,758,1563,48.5%,29.49%,1
花蓮縣,吉安鄉,0134,365,225,590,33,623,1288,48.37%,28.34%,1
花蓮縣,吉安鄉,0135,321,177,498,25,523,907,57.66%,35.39%,1
花蓮縣,吉安鄉,0136,250,202,452,22,474,917,51.69%,27.26%,1
花蓮縣,吉安鄉,0137,286,223,509,17,526,1021,51.52%,28.01%,1
花蓮縣,吉安鄉,0138,387,197,584,30,614,1033,59.44%,37.46%,1
花蓮縣,吉安鄉,0139,348,179,527,28,555,966,57.45%,36.02%,1
花蓮縣,吉安鄉,0140,373,214,587,41,628,1188,52.86%,31.4%,1
花蓮縣,吉安鄉,0141,448,300,748,27,775,1480,52.36%,30.27%,1
花蓮縣,吉安鄉,0142,391,254,645,30,675,1393,48.46%,28.07%,1
花蓮縣,吉安鄉,0143,370,219,589,29,618,1193,51.8%,31.01%,1
花蓮縣,吉安鄉,0144,429,248,677,27,704,1445,48.72%,29.69%,1
花蓮縣,吉安鄉,0145,395,268,663,57,720,1301,55.34%,30.36%,1
花蓮縣,吉安鄉,0146,355,307,662,29,691,1215,56.87%,29.22%,1
花蓮縣,吉安鄉,0147,368,216,584,27,611,1135,53.83%,32.42%,1
花蓮縣,吉安鄉,0148,434,234,668,27,695,1223,56.83%,35.49%,1
花蓮縣,吉安鄉,0149,500,267,767,33,800,1274,62.79%,39.25%,1
花蓮縣,吉安鄉,0150,342,225,567,29,596,1124,53.02%,30.43%,1
花蓮縣,吉安鄉,0151,371,255,626,24,650,1158,56.13%,32.04%,1
花蓮縣,吉安鄉,0152,380,253,633,16,649,1157,56.09%,32.84%,1
花蓮縣,吉安鄉,0153,404,264,668,27,695,1258,55.25%,32.11%,1
花蓮縣,吉安鄉,0154,382,271,653,21,674,1257,53.62%,30.39%,1
花蓮縣,吉安鄉,0155,384,246,630,22,652,1245,52.37%,30.84%,1
花蓮縣,吉安鄉,0156,388,245,633,16,649,1166,55.66%,33.28%,1
花蓮縣,吉安鄉,0157,453,227,680,33,713,1358,52.5%,33.36%,1
花蓮縣,吉安鄉,0158,409,197,606,23,629,1214,51.81%,33.69%,1
花蓮縣,吉安鄉,0159,371,227,598,22,620,1151,53.87%,32.23%,1
花蓮縣,吉安鄉,0160,383,245,628,20,648,1157,56.01%,33.1%,1
花蓮縣,吉安鄉,0161,388,244,632,23,655,1161,56.42%,33.42%,1
花蓮縣,吉安鄉,0162,435,282,717,20,737,1304,56.52%,33.36%,1
花蓮縣,吉安鄉,0163,439,252,691,32,723,1367,52.89%,32.11%,1
花蓮縣,吉安鄉,0164,396,249,645,22,667,1411,47.27%,28.07%,1
花蓮縣,吉安鄉,0165,447,206,653,31,684,1409,48.55%,31.72%,1
花蓮縣,吉安鄉,0166,323,199,522,22,544,1125,48.36%,28.71%,1
花蓮縣,吉安鄉,0167,377,249,626,43,669,1213,55.15%,31.08%,1
花蓮縣,吉安鄉,0168,392,211,603,23,626,1141,54.86%,34.36%,1
花蓮縣,吉安鄉,0169,347,186,533,17,550,1156,47.58%,30.02%,1
花蓮縣,吉安鄉,0170,335,207,542,25,567,1092,51.92%,30.68%,1
花蓮縣,吉安鄉,0171,260,178,438,30,468,1026,45.61%,25.34%,1
花蓮縣,吉安鄉,0172,256,158,414,14,428,804,53.23%,31.84%,1
花蓮縣,吉安鄉,0173,381,224,605,22,627,1132,55.39%,33.66%,1
花蓮縣,壽豐鄉,0174,327,182,509,35,544,1052,51.71%,31.08%,1
花蓮縣,壽豐鄉,0175,117,74,191,27,218,357,61.06%,32.77%,1
花蓮縣,壽豐鄉,0176,264,213,477,41,518,1022,50.68%,25.83%,1
花蓮縣,壽豐鄉,0177,313,202,515,33,548,875,62.63%,35.77%,1
花蓮縣,壽豐鄉,0178,250,148,398,27,425,691,61.51%,36.18%,1
花蓮縣,壽豐鄉,0179,230,117,347,20,367,708,51.84%,32.49%,1
花蓮縣,壽豐鄉,0180,264,168,432,43,475,894,53.13%,29.53%,1
花蓮縣,壽豐鄉,0181,226,153,379,30,409,746,54.83%,30.29%,1
花蓮縣,壽豐鄉,0182,251,202,453,25,478,881,54.26%,28.49%,1
花蓮縣,壽豐鄉,0183,257,151,408,24,432,695,62.16%,36.98%,1
花蓮縣,壽豐鄉,0184,275,210,485,35,520,816,63.73%,33.7%,1
花蓮縣,壽豐鄉,0185,229,135,364,32,396,773,51.23%,29.62%,1
花蓮縣,壽豐鄉,0186,349,190,539,50,589,1029,57.24%,33.92%,1
花蓮縣,壽豐鄉,0187,150,91,241,17,258,407,63.39%,36.86%,1
花蓮縣,壽豐鄉,0188,386,244,630,32,662,1139,58.12%,33.89%,1
花蓮縣,壽豐鄉,0189,303,245,548,26,574,996,57.63%,30.42%,1
花蓮縣,壽豐鄉,0190,117,62,179,10,189,414,45.65%,28.26%,1
花蓮縣,壽豐鄉,0191,90,60,150,7,157,270,58.15%,33.33%,1
花蓮縣,壽豐鄉,0192,259,181,440,48,488,836,58.37%,30.98%,1
花蓮縣,壽豐鄉,0193,157,124,281,29,310,507,61.14%,30.97%,1
花蓮縣,壽豐鄉,0194,185,98,283,34,317,739,42.9%,25.03%,1
花蓮縣,光復鄉,0210,445,239,684,47,731,1295,56.45%,34.36%,1
花蓮縣,光復鄉,0211,296,177,473,29,502,859,58.44%,34.46%,1
花蓮縣,光復鄉,0212,372,160,532,43,575,958,60.02%,38.83%,1
花蓮縣,光復鄉,0213,357,183,540,51,591,1011,58.46%,35.31%,1
花蓮縣,光復鄉,0214,407,154,561,45,606,1041,58.21%,39.1%,1
花蓮縣,光復鄉,0215,231,186,417,40,457,821,55.66%,28.14%,1
花蓮縣,光復鄉,0216,27,18,45,4,49,188,26.06%,14.36%,1
花蓮縣,光復鄉,0217,138,122,260,23,283,514,55.06%,26.85%,1
花蓮縣,光復鄉,0218,111,76,187,12,199,446,44.62%,24.89%,1
花蓮縣,光復鄉,0219,274,178,452,27,479,851,56.29%,32.2%,1
花蓮縣,光復鄉,0220,240,155,395,19,414,932,44.42%,25.75%,1
花蓮縣,光復鄉,0221,159,91,250,18,268,471,56.9%,33.76%,1
花蓮縣,光復鄉,0222,180,137,317,38,355,640,55.47%,28.13%,1
花蓮縣,光復鄉,0223,21,24,45,3,48,116,41.38%,18.1%,1
花蓮縣,光復鄉,0224,110,67,177,4,181,496,36.49%,22.18%,1
花蓮縣,光復鄉,0225,77,58,135,11,146,324,45.06%,23.77%,1
花蓮縣,光復鄉,0226,97,63,160,20,180,454,39.65%,21.37%,1
花蓮縣,豐濱鄉,0227,193,128,321,30,351,717,48.95%,26.92%,1
花蓮縣,豐濱鄉,0228,152,151,303,24,327,751,43.54%,20.24%,1
花蓮縣,豐濱鄉,0229,179,97,276,22,298,613,48.61%,29.2%,1
花蓮縣,豐濱鄉,0230,313,144,457,17,474,809,58.59%,38.69%,1
花蓮縣,豐濱鄉,0231,102,36,138,12,150,357,42.02%,28.57%,1
花蓮縣,豐濱鄉,0232,207,116,323,18,341,669,50.97%,30.94%,1
花蓮縣,豐濱鄉,0233,125,102,227,9,236,479,49.27%,26.1%,1
花蓮縣,瑞穗鄉,0241,291,144,435,39,474,813,58.3%,35.79%,1
花蓮縣,瑞穗鄉,0242,342,199,541,69,610,1091,55.91%,31.35%,1
花蓮縣,瑞穗鄉,0243,286,159,445,35,480,839,57.21%,34.09%,1
花蓮縣,瑞穗鄉,0244,342,178,520,37,557,975,57.13%,35.08%,1
花蓮縣,瑞穗鄉,0245,167,81,248,13,261,546,47.8%,30.59%,1
花蓮縣,瑞穗鄉,0246,318,195,513,56,569,1002,56.79%,31.74%,1
花蓮縣,瑞穗鄉,0247,123,130,253,27,280,593,47.22%,20.74%,1
花蓮縣,瑞穗鄉,0248,285,229,514,40,554,965,57.41%,29.53%,1
花蓮縣,瑞穗鄉,0249,259,178,437,41,478,863,55.39%,30.01%,1
花蓮縣,瑞穗鄉,0250,65,39,104,8,112,340,32.94%,19.12%,1
花蓮縣,瑞穗鄉,0251,208,121,329,24,353,764,46.2%,27.23%,1
花蓮縣,瑞穗鄉,0252,148,100,248,12,260,868,29.95%,17.05%,1
花蓮縣,瑞穗鄉,0253,142,73,215,24,239,620,38.55%,22.9%,1
花蓮縣,富里鄉,0277,92,98,190,20,210,467,44.97%,19.7%,1
花蓮縣,富里鄉,0278,220,153,373,33,406,1032,39.34%,21.32%,1
花蓮縣,富里鄉,0279,161,111,272,21,293,638,45.92%,25.24%,1
花蓮縣,富里鄉,0280,188,94,282,40,322,591,54.48%,31.81%,1
花蓮縣,富里鄉,0281,295,243,538,55,593,1087,54.55%,27.14%,1
花蓮縣,富里鄉,0282,117,94,211,13,224,431,51.97%,27.15%,1
花蓮縣,富里鄉,0283,236,165,401,34,435,893,48.71%,26.43%,1
花蓮縣,富里鄉,0284,78,54,132,17,149,361,41.27%,21.61%,1
花蓮縣,富里鄉,0285,262,237,499,49,548,1362,40.23%,19.24%,1
花蓮縣,富里鄉,0286,104,102,206,32,238,458,51.97%,22.71%,1
花蓮縣,富里鄉,0287,98,83,181,29,210,621,33.82%,15.78%,1
花蓮縣,富里鄉,0288,117,107,224,19,243,493,49.29%,23.73%,1
花蓮縣,富里鄉,0289,158,115,273,29,302,631,47.86%,25.04%,1
花蓮縣,秀林鄉,0101,236,193,429,24,453,867,52.25%,27.22%,1
花蓮縣,秀林鄉,0102,154,136,290,15,305,575,53.04%,26.78%,1
花蓮縣,秀林鄉,0103,314,227,541,32,573,1373,41.73%,22.87%,1
花蓮縣,秀林鄉,0104,492,258,750,43,793,1644,48.24%,29.93%,1
花蓮縣,秀林鄉,0105,47,39,86,4,90,162,55.56%,29.01%,1
花蓮縣,秀林鄉,0106,109,77,186,17,203,384,52.86%,28.39%,1
花蓮縣,秀林鄉,0107,372,267,639,37,676,1382,48.91%,26.92%,1
花蓮縣,秀林鄉,0108,338,236,574,28,602,1125,53.51%,30.04%,1
花蓮縣,秀林鄉,0109,173,128,301,18,319,627,50.88%,27.59%,1
花蓮縣,秀林鄉,0110,344,215,559,41,600,987,60.79%,34.85%,1
花蓮縣,秀林鄉,0111,387,272,659,45,704,1139,61.81%,33.98%,1
花蓮縣,秀林鄉,0112,428,223,651,14,665,1213,54.82%,35.28%,1
花蓮縣,秀林鄉,0113,230,161,391,23,414,754,54.91%,30.5%,1
花蓮縣,秀林鄉,0114,103,58,161,7,168,330,50.91%,31.21%,1
花蓮縣,萬榮鄉,0234,349,206,555,49,604,1072,56.34%,32.56%,1
花蓮縣,萬榮鄉,0235,204,109,313,6,319,560,56.96%,36.43%,1
花蓮縣,萬榮鄉,0236,279,178,457,27,484,773,62.61%,36.09%,1
花蓮縣,萬榮鄉,0237,199,122,321,10,331,661,50.08%,30.11%,1
花蓮縣,萬榮鄉,0238,164,102,266,18,284,442,64.25%,37.1%,1
花蓮縣,萬榮鄉,0239,216,131,347,14,361,675,53.48%,32%,1
花蓮縣,萬榮鄉,0240,446,248,694,52,746,1086,68.69%,41.07%,1
花蓮縣,卓溪鄉,0290,153,132,285,13,298,533,55.91%,28.71%,1
花蓮縣,卓溪鄉,0291,218,103,321,19,340,522,65.13%,41.76%,1
花蓮縣,卓溪鄉,0292,208,108,316,7,323,493,65.52%,42.19%,1
花蓮縣,卓溪鄉,0293,255,167,422,19,441,701,62.91%,36.38%,1
花蓮縣,卓溪鄉,0294,277,139,416,27,443,746,59.38%,37.13%,1
花蓮縣,卓溪鄉,0295,217,144,361,28,389,616,63.15%,35.23%,1
花蓮縣,卓溪鄉,0296,133,64,197,6,203,405,50.12%,32.84%,1
花蓮縣,卓溪鄉,0297,91,74,165,12,177,329,53.8%,27.66%,1
花蓮縣,卓溪鄉,0298,130,93,223,15,238,428,55.61%,30.37%,1
花蓮縣,卓溪鄉,0299,49,43,92,6,98,174,56.32%,28.16%,1
臺東縣,臺東市,0001,267,147,414,22,436,874,49.89%,30.55%,1
臺東縣,臺東市,0002,557,307,864,47,911,1469,62.01%,37.92%,1
臺東縣,臺東市,0003,429,249,678,28,706,1259,56.08%,34.07%,1
臺東縣,臺東市,0004,440,262,702,31,733,1399,52.39%,31.45%,1
臺東縣,臺東市,0005,518,293,811,31,842,1363,61.78%,38%,1
臺東縣,臺東市,0006,550,319,869,34,903,1651,54.69%,33.31%,1
臺東縣,臺東市,0007,536,354,890,39,929,1490,62.35%,35.97%,1
臺東縣,臺東市,0008,265,170,435,26,461,859,53.67%,30.85%,1
臺東縣,臺東市,0009,304,210,514,28,542,890,60.9%,34.16%,1
臺東縣,臺東市,0010,233,121,354,23,377,651,57.91%,35.79%,1
臺東縣,臺東市,0011,452,315,767,43,810,1650,49.09%,27.39%,1
臺東縣,臺東市,0012,249,180,429,22,451,724,62.29%,34.39%,1
臺東縣,臺東市,0013,207,149,356,26,382,632,60.44%,32.75%,1
臺東縣,臺東市,0014,274,158,432,33,465,771,60.31%,35.54%,1
臺東縣,臺東市,0015,264,150,414,15,429,798,53.76%,33.08%,1
臺東縣,臺東市,0016,408,263,671,49,720,1299,55.43%,31.41%,1
臺東縣,臺東市,0017,289,173,462,26,488,811,60.17%,35.64%,1
臺東縣,臺東市,0018,298,169,467,26,493,764,64.53%,39.01%,1
臺東縣,臺東市,0019,244,167,411,13,424,784,54.08%,31.12%,1
臺東縣,臺東市,0020,127,89,216,7,223,427,52.22%,29.74%,1
臺東縣,臺東市,0021,452,181,633,27,660,1292,51.08%,34.98%,1
臺東縣,臺東市,0022,516,344,860,16,876,1501,58.36%,34.38%,1
臺東縣,臺東市,0023,174,120,294,18,312,601,51.91%,28.95%,1
臺東縣,臺東市,0024,116,98,214,6,220,417,52.76%,27.82%,1
臺東縣,臺東市,0025,351,183,534,33,567,1001,56.64%,35.06%,1
臺東縣,臺東市,0026,591,327,918,36,954,1638,58.24%,36.08%,1
臺東縣,臺東市,0027,548,292,840,36,876,1576,55.58%,34.77%,1
臺東縣,臺東市,0028,564,292,856,41,897,1595,56.24%,35.36%,1
臺東縣,臺東市,0029,603,330,933,33,966,1734,55.71%,34.78%,1
臺東縣,臺東市,0030,497,321,818,34,852,1476,57.72%,33.67%,1
臺東縣,臺東市,0031,556,345,901,28,929,1545,60.13%,35.99%,1
臺東縣,臺東市,0032,514,247,761,33,794,1313,60.47%,39.15%,1
臺東縣,臺東市,0033,517,268,785,35,820,1338,61.29%,38.64%,1
臺東縣,臺東市,0034,455,259,714,27,741,1312,56.48%,34.68%,1
臺東縣,臺東市,0035,467,235,702,30,732,1265,57.87%,36.92%,1
臺東縣,臺東市,0036,392,264,656,27,683,1407,48.54%,27.86%,1
臺東縣,臺東市,0037,480,254,734,28,762,1552,49.1%,30.93%,1
臺東縣,臺東市,0038,455,297,752,63,815,1445,56.4%,31.49%,1
臺東縣,臺東市,0039,719,456,1175,45,1220,2098,58.15%,34.27%,1
臺東縣,臺東市,0040,508,228,736,57,793,1324,59.89%,38.37%,1
臺東縣,臺東市,0041,568,297,865,23,888,1598,55.57%,35.54%,1
臺東縣,臺東市,0042,496,300,796,19,815,1513,53.87%,32.78%,1
臺東縣,臺東市,0043,513,309,822,28,850,1679,50.63%,30.55%,1
臺東縣,臺東市,0044,473,268,741,31,772,1414,54.6%,33.45%,1
臺東縣,臺東市,0045,603,334,937,28,965,1798,53.67%,33.54%,1
臺東縣,臺東市,0046,517,288,805,47,852,1749,48.71%,29.56%,1
臺東縣,臺東市,0047,559,322,881,44,925,1709,54.13%,32.71%,1
臺東縣,臺東市,0048,533,288,821,41,862,1629,52.92%,32.72%,1
臺東縣,臺東市,0049,362,195,557,41,598,1116,53.58%,32.44%,1
臺東縣,臺東市,0050,328,230,558,24,582,1259,46.23%,26.05%,1
臺東縣,臺東市,0051,326,221,547,34,581,1232,47.16%,26.46%,1
臺東縣,臺東市,0052,466,239,705,69,774,1505,51.43%,30.96%,1
臺東縣,臺東市,0053,230,136,366,38,404,836,48.33%,27.51%,1
臺東縣,臺東市,0054,432,262,694,42,736,1294,56.88%,33.38%,1
臺東縣,臺東市,0055,429,257,686,37,723,1350,53.56%,31.78%,1
臺東縣,臺東市,0056,738,405,1143,54,1197,2162,55.37%,34.14%,1
臺東縣,臺東市,0057,573,348,921,46,967,1627,59.43%,35.22%,1
臺東縣,臺東市,0058,381,248,629,49,678,1140,59.47%,33.42%,1
臺東縣,臺東市,0059,411,290,701,36,737,1359,54.23%,30.24%,1
臺東縣,臺東市,0060,446,268,714,25,739,1329,55.61%,33.56%,1
臺東縣,臺東市,0061,324,164,488,28,516,990,52.12%,32.73%,1
臺東縣,臺東市,0062,355,200,555,43,598,1038,57.61%,34.2%,1
臺東縣,臺東市,0063,510,292,802,44,846,1597,52.97%,31.93%,1
臺東縣,臺東市,0064,411,286,697,50,747,1385,53.94%,29.68%,1
臺東縣,臺東市,0065,247,182,429,20,449,939,47.82%,26.3%,1
臺東縣,臺東市,0066,331,209,540,42,582,1258,46.26%,26.31%,1
臺東縣,臺東市,0067,397,256,653,9,662,1350,49.04%,29.41%,1
臺東縣,臺東市,0068,306,169,475,31,506,1058,47.83%,28.92%,1
臺東縣,臺東市,0069,273,133,406,21,427,895,47.71%,30.5%,1
臺東縣,成功鎮,0070,124,104,228,30,258,516,50%,24.03%,1
臺東縣,成功鎮,0071,344,206,550,36,586,960,61.04%,35.83%,1
臺東縣,成功鎮,0072,121,38,159,14,173,365,47.4%,33.15%,1
臺東縣,成功鎮,0073,220,104,324,21,345,747,46.18%,29.45%,1
臺東縣,成功鎮,0074,108,40,148,12,160,339,47.2%,31.86%,1
臺東縣,成功鎮,0075,277,172,449,26,475,995,47.74%,27.84%,1
臺東縣,成功鎮,0076,247,197,444,39,483,863,55.97%,28.62%,1
臺東縣,成功鎮,0077,255,213,468,42,510,931,54.78%,27.39%,1
臺東縣,成功鎮,0078,290,179,469,27,496,970,51.13%,29.9%,1
臺東縣,成功鎮,0079,383,263,646,58,704,1365,51.58%,28.06%,1
臺東縣,成功鎮,0080,445,229,674,49,723,1366,52.93%,32.58%,1
臺東縣,成功鎮,0081,154,83,237,27,264,516,51.16%,29.84%,1
臺東縣,成功鎮,0082,242,148,390,30,420,887,47.35%,27.28%,1
臺東縣,成功鎮,0083,109,93,202,17,219,488,44.88%,22.34%,1
臺東縣,成功鎮,0084,104,72,176,20,196,481,40.75%,21.62%,1
臺東縣,成功鎮,0085,109,47,156,10,166,373,44.5%,29.22%,1
臺東縣,成功鎮,0086,64,57,121,22,143,264,54.17%,24.24%,1
臺東縣,關山鎮,0087,316,189,505,34,539,909,59.3%,34.76%,1
臺東縣,關山鎮,0088,187,123,310,29,339,790,42.91%,23.67%,1
臺東縣,關山鎮,0089,284,187,471,30,501,828,60.51%,34.3%,1
臺東縣,關山鎮,0090,228,149,377,20,397,887,44.76%,25.7%,1
臺東縣,關山鎮,0091,348,247,595,26,621,1137,54.62%,30.61%,1
臺東縣,關山鎮,0092,202,123,325,25,350,732,47.81%,27.6%,1
臺東縣,關山鎮,0093,263,175,438,37,475,912,52.08%,28.84%,1
臺東縣,關山鎮,0094,185,120,305,15,320,779,41.08%,23.75%,1
臺東縣,關山鎮,0095,103,79,182,24,206,535,38.5%,19.25%,1
臺東縣,卑南鄉,0096,350,218,568,38,606,1041,58.21%,33.62%,1
臺東縣,卑南鄉,0097,314,239,553,36,589,1165,50.56%,26.95%,1
臺東縣,卑南鄉,0098,54,39,93,9,102,219,46.58%,24.66%,1
臺東縣,卑南鄉,0099,121,80,201,21,222,460,48.26%,26.3%,1
臺東縣,卑南鄉,0100,84,54,138,17,155,387,40.05%,21.71%,1
臺東縣,卑南鄉,0101,198,139,337,26,363,767,47.33%,25.81%,1
臺東縣,卑南鄉,0102,161,97,258,15,273,503,54.27%,32.01%,1
臺東縣,卑南鄉,0103,194,113,307,45,352,727,48.42%,26.69%,1
臺東縣,卑南鄉,0104,128,76,204,27,231,436,52.98%,29.36%,1
臺東縣,卑南鄉,0105,49,39,88,8,96,261,36.78%,18.77%,1
臺東縣,卑南鄉,0106,60,47,107,10,117,215,54.42%,27.91%,1
臺東縣,卑南鄉,0107,491,265,756,54,810,1442,56.17%,34.05%,1
臺東縣,卑南鄉,0108,199,56,255,9,264,527,50.09%,37.76%,1
臺東縣,卑南鄉,0109,342,200,542,40,582,1046,55.64%,32.7%,1
臺東縣,卑南鄉,0110,317,228,545,52,597,1110,53.78%,28.56%,1
臺東縣,卑南鄉,0111,352,236,588,47,635,1105,57.47%,31.86%,1
臺東縣,卑南鄉,0112,481,201,682,55,737,1167,63.15%,41.22%,1
臺東縣,卑南鄉,0113,247,187,434,39,473,968,48.86%,25.52%,1
臺東縣,卑南鄉,0114,32,26,58,2,60,159,37.74%,20.13%,1
臺東縣,卑南鄉,0115,122,81,203,17,220,488,45.08%,25%,1
臺東縣,卑南鄉,0116,105,86,191,13,204,347,58.79%,30.26%,1
臺東縣,卑南鄉,0117,151,71,222,16,238,436,54.59%,34.63%,1
臺東縣,鹿野鄉,0118,107,80,187,10,197,522,37.74%,20.5%,1
臺東縣,鹿野鄉,0119,163,128,291,20,311,574,54.18%,28.4%,1
臺東縣,鹿野鄉,0120,213,172,385,29,414,1055,39.24%,20.19%,1
臺東縣,鹿野鄉,0121,284,210,494,25,519,1104,47.01%,25.72%,1
臺東縣,鹿野鄉,0122,86,54,140,14,154,342,45.03%,25.15%,1
臺東縣,鹿野鄉,0123,246,149,395,28,423,895,47.26%,27.49%,1
臺東縣,鹿野鄉,0124,237,159,396,29,425,864,49.19%,27.43%,1
臺東縣,鹿野鄉,0125,154,104,258,34,292,675,43.26%,22.81%,1
臺東縣,鹿野鄉,0126,115,81,196,19,215,435,49.43%,26.44%,1
臺東縣,鹿野鄉,0127,84,80,164,24,188,470,40%,17.87%,1
臺東縣,池上鄉,0128,262,186,448,30,478,992,48.19%,26.41%,1
臺東縣,池上鄉,0129,285,192,477,41,518,929,55.76%,30.68%,1
臺東縣,池上鄉,0130,93,93,186,25,211,434,48.62%,21.43%,1
臺東縣,池上鄉,0131,150,128,278,28,306,703,43.53%,21.34%,1
臺東縣,池上鄉,0132,142,122,264,21,285,654,43.58%,21.71%,1
臺東縣,池上鄉,0133,55,59,114,15,129,324,39.81%,16.98%,1
臺東縣,池上鄉,0134,187,145,332,27,359,794,45.21%,23.55%,1
臺東縣,池上鄉,0135,220,143,363,50,413,856,48.25%,25.7%,1
臺東縣,池上鄉,0136,73,60,133,11,144,344,41.86%,21.22%,1
臺東縣,池上鄉,0137,85,64,149,24,173,311,55.63%,27.33%,1
臺東縣,池上鄉,0138,78,44,122,15,137,386,35.49%,20.21%,1
臺東縣,池上鄉,0139,74,58,132,19,151,435,34.71%,17.01%,1
臺東縣,東河鄉,0140,65,44,109,19,128,290,44.14%,22.41%,1
臺東縣,東河鄉,0141,236,100,336,23,359,620,57.9%,38.06%,1
臺東縣,東河鄉,0142,428,259,687,58,745,1196,62.29%,35.79%,1
臺東縣,東河鄉,0143,273,143,416,38,454,918,49.46%,29.74%,1
臺東縣,東河鄉,0144,160,89,249,12,261,555,47.03%,28.83%,1
臺東縣,東河鄉,0145,250,148,398,29,427,977,43.71%,25.59%,1
臺東縣,東河鄉,0146,221,159,380,15,395,1197,33%,18.46%,1
臺東縣,東河鄉,0147,110,81,191,21,212,867,24.45%,12.69%,1
臺東縣,東河鄉,0148,93,46,139,9,148,345,42.9%,26.96%,1
臺東縣,東河鄉,0149,90,67,157,14,171,408,41.91%,22.06%,1
臺東縣,東河鄉,0150,64,40,104,10,114,262,43.51%,24.43%,1
臺東縣,長濱鄉,0151,160,114,274,35,309,536,57.65%,29.85%,1
臺東縣,長濱鄉,0152,135,75,210,20,230,689,33.38%,19.59%,1
臺東縣,長濱鄉,0153,295,138,433,71,504,913,55.2%,32.31%,1
臺東縣,長濱鄉,0154,299,169,468,22,490,1268,38.64%,23.58%,1
臺東縣,長濱鄉,0155,235,108,343,28,371,725,51.17%,32.41%,1
臺東縣,長濱鄉,0156,79,75,154,6,160,532,30.08%,14.85%,1
臺東縣,長濱鄉,0157,136,107,243,36,279,660,42.27%,20.61%,1
臺東縣,長濱鄉,0158,75,38,113,8,121,336,36.01%,22.32%,1
臺東縣,長濱鄉,0159,41,15,56,8,64,195,32.82%,21.03%,1
臺東縣,長濱鄉,0160,9,2,11,2,13,25,52%,36%,1
臺東縣,長濱鄉,0161,159,90,249,26,275,605,45.45%,26.28%,1
臺東縣,太麻里鄉,0162,225,129,354,32,386,722,53.46%,31.16%,1
臺東縣,太麻里鄉,0163,192,84,276,25,301,575,52.35%,33.39%,1
臺東縣,太麻里鄉,0164,178,115,293,22,315,623,50.56%,28.57%,1
臺東縣,太麻里鄉,0165,183,95,278,24,302,622,48.55%,29.42%,1
臺東縣,太麻里鄉,0166,175,94,269,14,283,560,50.54%,31.25%,1
臺東縣,太麻里鄉,0167,399,144,543,27,570,957,59.56%,41.69%,1
臺東縣,太麻里鄉,0168,241,144,385,30,415,809,51.3%,29.79%,1
臺東縣,太麻里鄉,0169,236,156,392,25,417,673,61.96%,35.07%,1
臺東縣,太麻里鄉,0170,211,145,356,23,379,737,51.42%,28.63%,1
臺東縣,太麻里鄉,0171,154,74,228,14,242,424,57.08%,36.32%,1
臺東縣,太麻里鄉,0172,108,62,170,9,179,374,47.86%,28.88%,1
臺東縣,太麻里鄉,0173,385,152,537,11,548,829,66.1%,46.44%,1
臺東縣,太麻里鄉,0174,399,119,518,11,529,869,60.87%,45.91%,1
臺東縣,太麻里鄉,0175,80,31,111,10,121,223,54.26%,35.87%,1
臺東縣,太麻里鄉,0176,208,134,342,22,364,669,54.41%,31.09%,1
臺東縣,大武鄉,0177,266,71,337,14,351,568,61.8%,46.83%,1
臺東縣,大武鄉,0178,416,263,679,57,736,1474,49.93%,28.22%,1
臺東縣,大武鄉,0179,641,23,664,46,710,1327,53.5%,48.3%,1
臺東縣,大武鄉,0180,286,201,487,55,542,1134,47.8%,25.22%,1
臺東縣,大武鄉,0181,151,65,216,6,222,386,57.51%,39.12%,1
臺東縣,大武鄉,0182,143,59,202,20,222,377,58.89%,37.93%,1
臺東縣,綠島鄉,0183,376,240,616,18,634,1474,43.01%,25.51%,1
臺東縣,綠島鄉,0184,289,163,452,20,472,1082,43.62%,26.71%,1
臺東縣,綠島鄉,0185,220,142,362,19,381,813,46.86%,27.06%,1
臺東縣,綠島鄉,0186,60,40,100,5,105,210,50%,28.57%,1
臺東縣,海端鄉,0187,150,102,252,11,263,497,52.92%,30.18%,1
臺東縣,海端鄉,0188,183,131,314,16,330,569,58%,32.16%,1
臺東縣,海端鄉,0189,296,171,467,21,488,971,50.26%,30.48%,1
臺東縣,海端鄉,0190,224,144,368,26,394,728,54.12%,30.77%,1
臺東縣,海端鄉,0191,67,70,137,11,148,259,57.14%,25.87%,1
臺東縣,海端鄉,0192,82,62,144,4,148,254,58.27%,32.28%,1
臺東縣,延平鄉,0193,335,191,526,34,560,1014,55.23%,33.04%,1
臺東縣,延平鄉,0194,162,111,273,25,298,426,69.95%,38.03%,1
臺東縣,延平鄉,0195,151,48,199,10,209,315,66.35%,47.94%,1
臺東縣,延平鄉,0196,249,101,350,15,365,579,63.04%,43.01%,1
臺東縣,延平鄉,0197,165,97,262,13,275,596,46.14%,27.68%,1
臺東縣,金峰鄉,0198,472,218,690,32,722,1241,58.18%,38.03%,1
臺東縣,金峰鄉,0199,283,138,421,13,434,601,72.21%,47.09%,1
臺東縣,金峰鄉,0200,226,144,370,22,392,520,75.38%,43.46%,1
臺東縣,金峰鄉,0201,111,71,182,7,189,336,56.25%,33.04%,1
臺東縣,金峰鄉,0202,193,56,249,15,264,330,80%,58.48%,1
臺東縣,達仁鄉,0203,117,34,151,3,154,246,62.6%,47.56%,1
臺東縣,達仁鄉,0204,185,37,222,3,225,340,66.18%,54.41%,1
臺東縣,達仁鄉,0205,112,67,179,16,195,296,65.88%,37.84%,1
臺東縣,達仁鄉,0206,175,95,270,23,293,429,68.3%,40.79%,1
臺東縣,達仁鄉,0207,155,64,219,15,234,331,70.69%,46.83%,1
臺東縣,達仁鄉,0208,192,96,288,11,299,628,47.61%,30.57%,1
臺東縣,達仁鄉,0209,271,173,444,31,475,867,54.79%,31.26%,1
臺東縣,蘭嶼鄉,0210,192,182,374,21,395,943,41.89%,20.36%,1
臺東縣,蘭嶼鄉,0211,273,226,499,27,526,1238,42.49%,22.05%,1
臺東縣,蘭嶼鄉,0212,271,190,461,14,475,1240,38.31%,21.85%,1
臺東縣,蘭嶼鄉,0213,118,143,261,18,279,760,36.71%,15.53%,1
澎湖縣,馬公市,0001,135,81,216,10,226,481,46.99%,28.07%,1
澎湖縣,馬公市,0002,182,90,272,16,288,558,51.61%,32.62%,1
澎湖縣,馬公市,0003,175,65,240,24,264,533,49.53%,32.83%,1
澎湖縣,馬公市,0004,287,167,454,27,481,922,52.17%,31.13%,1
澎湖縣,馬公市,0005,338,192,530,28,558,1021,54.65%,33.1%,1
澎湖縣,馬公市,0006,241,135,376,30,406,793,51.2%,30.39%,1
澎湖縣,馬公市,0007,307,181,488,25,513,954,53.77%,32.18%,1
澎湖縣,馬公市,0008,309,179,488,18,506,1001,50.55%,30.87%,1
澎湖縣,馬公市,0009,316,190,506,29,535,1192,44.88%,26.51%,1
澎湖縣,馬公市,0010,424,202,626,32,658,1402,46.93%,30.24%,1
澎湖縣,馬公市,0011,473,224,697,28,725,1389,52.2%,34.05%,1
澎湖縣,馬公市,0012,426,242,668,30,698,1339,52.13%,31.81%,1
澎湖縣,馬公市,0013,282,293,575,33,608,1254,48.48%,22.49%,1
澎湖縣,馬公市,0014,364,201,565,36,601,1194,50.34%,30.49%,1
澎湖縣,馬公市,0015,420,213,633,40,673,1393,48.31%,30.15%,1
澎湖縣,馬公市,0016,476,247,723,28,751,1440,52.15%,33.06%,1
澎湖縣,馬公市,0017,332,224,556,45,601,1215,49.47%,27.33%,1
澎湖縣,馬公市,0018,389,203,592,41,633,1284,49.3%,30.3%,1
澎湖縣,馬公市,0019,479,224,703,41,744,1512,49.21%,31.68%,1
澎湖縣,馬公市,0020,331,196,527,43,570,1181,48.26%,28.03%,1
澎湖縣,馬公市,0021,425,226,651,28,679,1348,50.37%,31.53%,1
澎湖縣,馬公市,0022,444,249,693,19,712,1391,51.19%,31.92%,1
澎湖縣,馬公市,0023,334,594,928,14,942,2124,44.35%,15.73%,1
澎湖縣,馬公市,0024,461,245,706,36,742,1500,49.47%,30.73%,1
澎湖縣,馬公市,0025,540,213,753,27,780,1582,49.3%,34.13%,1
澎湖縣,馬公市,0026,476,295,771,28,799,1638,48.78%,29.06%,1
澎湖縣,馬公市,0027,504,276,780,34,814,1554,52.38%,32.43%,1
澎湖縣,馬公市,0028,224,138,362,22,384,980,39.18%,22.86%,1
澎湖縣,馬公市,0029,278,153,431,19,450,892,50.45%,31.17%,1
澎湖縣,馬公市,0030,192,115,307,14,321,778,41.26%,24.68%,1
澎湖縣,馬公市,0031,297,155,452,27,479,930,51.51%,31.94%,1
澎湖縣,馬公市,0032,573,271,844,24,868,1481,58.61%,38.69%,1
澎湖縣,馬公市,0033,409,179,588,15,603,1128,53.46%,36.26%,1
澎湖縣,馬公市,0034,141,73,214,15,229,415,55.18%,33.98%,1
澎湖縣,馬公市,0035,355,172,527,33,560,1120,50%,31.7%,1
澎湖縣,馬公市,0036,301,189,490,26,516,950,54.32%,31.68%,1
澎湖縣,馬公市,0037,168,94,262,19,281,627,44.82%,26.79%,1
澎湖縣,馬公市,0038,339,188,527,25,552,1055,52.32%,32.13%,1
澎湖縣,馬公市,0039,309,181,490,31,521,989,52.68%,31.24%,1
澎湖縣,馬公市,0040,169,132,301,29,330,591,55.84%,28.6%,1
澎湖縣,馬公市,0041,381,228,609,53,662,1387,47.73%,27.47%,1
澎湖縣,馬公市,0042,263,167,430,40,470,1079,43.56%,24.37%,1
澎湖縣,馬公市,0043,257,114,371,33,404,797,50.69%,32.25%,1
澎湖縣,馬公市,0044,276,136,412,19,431,903,47.73%,30.56%,1
澎湖縣,馬公市,0045,91,62,153,21,174,376,46.28%,24.2%,1
澎湖縣,馬公市,0046,101,84,185,10,195,371,52.56%,27.22%,1
澎湖縣,馬公市,0047,306,174,480,16,496,1173,42.28%,26.09%,1
澎湖縣,馬公市,0048,331,174,505,18,523,1389,37.65%,23.83%,1
澎湖縣,馬公市,0049,124,65,189,25,214,761,28.12%,16.29%,1
澎湖縣,馬公市,0050,104,61,165,13,178,288,61.81%,36.11%,1
澎湖縣,湖西鄉,0051,367,182,549,35,584,1120,52.14%,32.77%,1
澎湖縣,湖西鄉,0052,94,39,133,8,141,332,42.47%,28.31%,1
澎湖縣,湖西鄉,0053,66,28,94,2,96,242,39.67%,27.27%,1
澎湖縣,湖西鄉,0054,70,38,108,7,115,293,39.25%,23.89%,1
澎湖縣,湖西鄉,0055,162,88,250,27,277,666,41.59%,24.32%,1
澎湖縣,湖西鄉,0056,89,59,148,15,163,326,50%,27.3%,1
澎湖縣,湖西鄉,0057,182,109,291,11,302,732,41.26%,24.86%,1
澎湖縣,湖西鄉,0058,174,110,284,16,300,651,46.08%,26.73%,1
澎湖縣,湖西鄉,0059,208,111,319,19,338,744,45.43%,27.96%,1
澎湖縣,湖西鄉,0060,40,32,72,1,73,134,54.48%,29.85%,1
澎湖縣,湖西鄉,0061,184,98,282,17,299,794,37.66%,23.17%,1
澎湖縣,湖西鄉,0062,53,23,76,2,78,216,36.11%,24.54%,1
澎湖縣,湖西鄉,0063,123,65,188,9,197,664,29.67%,18.52%,1
澎湖縣,湖西鄉,0064,79,48,127,9,136,279,48.75%,28.32%,1
澎湖縣,湖西鄉,0065,96,56,152,2,154,296,52.03%,32.43%,1
澎湖縣,湖西鄉,0066,69,50,119,3,122,257,47.47%,26.85%,1
澎湖縣,湖西鄉,0067,15,12,27,2,29,89,32.58%,16.85%,1
澎湖縣,湖西鄉,0068,208,167,375,25,400,815,49.08%,25.52%,1
澎湖縣,湖西鄉,0069,238,139,377,20,397,975,40.72%,24.41%,1
澎湖縣,湖西鄉,0070,173,120,293,27,320,648,49.38%,26.7%,1
澎湖縣,湖西鄉,0071,227,142,369,24,393,893,44.01%,25.42%,1
澎湖縣,湖西鄉,0072,248,135,383,55,438,846,51.77%,29.31%,1
澎湖縣,湖西鄉,0073,181,105,286,10,296,729,40.6%,24.83%,1
澎湖縣,白沙鄉,0074,141,106,247,10,257,514,50%,27.43%,1
澎湖縣,白沙鄉,0075,227,101,328,12,340,657,51.75%,34.55%,1
澎湖縣,白沙鄉,0076,46,21,67,5,72,109,66.06%,42.2%,1
澎湖縣,白沙鄉,0077,39,27,66,3,69,156,44.23%,25%,1
澎湖縣,白沙鄉,0078,67,49,116,6,122,293,41.64%,22.87%,1
澎湖縣,白沙鄉,0079,45,23,68,3,71,231,30.74%,19.48%,1
澎湖縣,白沙鄉,0080,48,32,80,7,87,161,54.04%,29.81%,1
澎湖縣,白沙鄉,0081,497,256,753,37,790,1705,46.33%,29.15%,1
澎湖縣,白沙鄉,0082,76,42,118,9,127,285,44.56%,26.67%,1
澎湖縣,白沙鄉,0083,133,85,218,13,231,723,31.95%,18.4%,1
澎湖縣,白沙鄉,0084,158,106,264,21,285,774,36.82%,20.41%,1
澎湖縣,白沙鄉,0085,323,139,462,57,519,1429,36.32%,22.6%,1
澎湖縣,白沙鄉,0086,366,100,466,42,508,1084,46.86%,33.76%,1
澎湖縣,白沙鄉,0087,70,52,122,5,127,251,50.6%,27.89%,1
澎湖縣,白沙鄉,0088,48,32,80,11,91,253,35.97%,18.97%,1
澎湖縣,西嶼鄉,0089,31,18,49,1,50,283,17.67%,10.95%,1
澎湖縣,西嶼鄉,0090,58,51,109,12,121,424,28.54%,13.68%,1
澎湖縣,西嶼鄉,0091,153,102,255,37,292,826,35.35%,18.52%,1
澎湖縣,西嶼鄉,0092,58,45,103,7,110,282,39.01%,20.57%,1
澎湖縣,西嶼鄉,0093,141,95,236,29,265,661,40.09%,21.33%,1
澎湖縣,西嶼鄉,0094,17,11,28,2,30,141,21.28%,12.06%,1
澎湖縣,西嶼鄉,0095,139,57,196,7,203,635,31.97%,21.89%,1
澎湖縣,西嶼鄉,0096,56,14,70,5,75,216,34.72%,25.93%,1
澎湖縣,西嶼鄉,0097,74,45,119,20,139,572,24.3%,12.94%,1
澎湖縣,西嶼鄉,0098,299,156,455,62,517,1267,40.81%,23.6%,1
澎湖縣,西嶼鄉,0099,189,104,293,22,315,942,33.44%,20.06%,1
澎湖縣,西嶼鄉,0100,224,168,392,56,448,1133,39.54%,19.77%,1
澎湖縣,望安鄉,0101,188,119,307,24,331,734,45.1%,25.61%,1
澎湖縣,望安鄉,0102,140,39,179,11,190,454,41.85%,30.84%,1
澎湖縣,望安鄉,0103,73,33,106,6,112,300,37.33%,24.33%,1
澎湖縣,望安鄉,0104,126,79,205,34,239,471,50.74%,26.75%,1
澎湖縣,望安鄉,0105,151,87,238,8,246,672,36.61%,22.47%,1
澎湖縣,望安鄉,0106,208,83,291,23,314,742,42.32%,28.03%,1
澎湖縣,望安鄉,0107,82,25,107,4,111,264,42.05%,31.06%,1
澎湖縣,望安鄉,0108,126,88,214,4,218,476,45.8%,26.47%,1
澎湖縣,望安鄉,0109,37,23,60,2,62,208,29.81%,17.79%,1
澎湖縣,望安鄉,0110,46,40,86,5,91,307,29.64%,14.98%,1
澎湖縣,七美鄉,0111,28,33,61,6,67,248,27.02%,11.29%,1
澎湖縣,七美鄉,0112,104,79,183,21,204,581,35.11%,17.9%,1
澎湖縣,七美鄉,0113,121,78,199,29,228,641,35.57%,18.88%,1
澎湖縣,七美鄉,0114,74,42,116,4,120,382,31.41%,19.37%,1
澎湖縣,七美鄉,0115,44,44,88,3,91,351,25.93%,12.54%,1
澎湖縣,七美鄉,0116,182,120,302,20,322,1171,27.5%,15.54%,1
金門縣,金城鎮,0001,311,169,480,24,504,1396,36.1%,22.28%,1
金門縣,金城鎮,0002,434,239,673,21,694,1831,37.9%,23.7%,1
金門縣,金城鎮,0003,396,213,609,32,641,1750,36.63%,22.63%,1
金門縣,金城鎮,0004,434,228,662,56,718,1889,38.01%,22.98%,1
金門縣,金城鎮,0005,289,228,517,19,536,1675,32%,17.25%,1
金門縣,金城鎮,0006,506,242,748,33,781,1901,41.08%,26.62%,1
金門縣,金城鎮,0007,288,224,512,46,558,1610,34.66%,17.89%,1
金門縣,金城鎮,0008,385,190,575,29,604,1687,35.8%,22.82%,1
金門縣,金城鎮,0009,393,178,571,10,581,1594,36.45%,24.65%,1
金門縣,金城鎮,0010,379,209,588,24,612,1726,35.46%,21.96%,1
金門縣,金城鎮,0011,414,190,604,27,631,1733,36.41%,23.89%,1
金門縣,金城鎮,0012,392,217,609,19,628,1532,40.99%,25.59%,1
金門縣,金城鎮,0013,444,244,688,30,718,2079,34.54%,21.36%,1
金門縣,金城鎮,0014,414,218,632,23,655,2033,32.22%,20.36%,1
金門縣,金城鎮,0015,542,310,852,30,882,2517,35.04%,21.53%,1
金門縣,金城鎮,0016,455,235,690,37,727,2083,34.9%,21.84%,1
金門縣,金城鎮,0017,465,234,699,35,734,2140,34.3%,21.73%,1
金門縣,金城鎮,0018,422,257,679,37,716,2435,29.4%,17.33%,1
金門縣,金城鎮,0019,216,103,319,27,346,1353,25.57%,15.96%,1
金門縣,金城鎮,0020,300,180,480,19,499,1574,31.7%,19.06%,1
金門縣,金城鎮,0021,298,147,445,34,479,1277,37.51%,23.34%,1
金門縣,金沙鎮,0066,420,200,620,36,656,1909,34.36%,22%,1
金門縣,金沙鎮,0067,407,185,592,33,625,1524,41.01%,26.71%,1
金門縣,金沙鎮,0068,339,180,519,28,547,1673,32.7%,20.26%,1
金門縣,金沙鎮,0069,430,177,607,53,660,2003,32.95%,21.47%,1
金門縣,金沙鎮,0070,313,161,474,21,495,1212,40.84%,25.83%,1
金門縣,金沙鎮,0071,259,133,392,18,410,1126,36.41%,23%,1
金門縣,金沙鎮,0072,325,129,454,25,479,1540,31.1%,21.1%,1
金門縣,金沙鎮,0073,236,114,350,26,376,1216,30.92%,19.41%,1
金門縣,金沙鎮,0074,172,79,251,9,260,950,27.37%,18.11%,1
金門縣,金沙鎮,0075,482,185,667,34,701,1895,36.99%,25.44%,1
金門縣,金沙鎮,0076,307,135,442,22,464,1135,40.88%,27.05%,1
金門縣,金沙鎮,0077,267,147,414,24,438,1252,34.98%,21.33%,1
金門縣,金沙鎮,0078,309,141,450,13,463,1125,41.16%,27.47%,1
金門縣,金湖鎮,0049,333,187,520,20,540,1348,40.06%,24.7%,1
金門縣,金湖鎮,0050,275,186,461,29,490,1386,35.35%,19.84%,1
金門縣,金湖鎮,0051,356,213,569,36,605,1403,43.12%,25.37%,1
金門縣,金湖鎮,0052,448,198,646,28,674,1771,38.06%,25.3%,1
金門縣,金湖鎮,0053,323,201,524,33,557,1493,37.31%,21.63%,1
金門縣,金湖鎮,0054,339,149,488,49,537,1510,35.56%,22.45%,1
金門縣,金湖鎮,0055,391,180,571,38,609,1607,37.9%,24.33%,1
金門縣,金湖鎮,0056,414,206,620,45,665,2006,33.15%,20.64%,1
金門縣,金湖鎮,0057,370,245,615,27,642,1780,36.07%,20.79%,1
金門縣,金湖鎮,0058,403,211,614,21,635,1739,36.52%,23.17%,1
金門縣,金湖鎮,0059,294,166,460,19,479,1384,34.61%,21.24%,1
金門縣,金湖鎮,0060,322,178,500,27,527,1400,37.64%,23%,1
金門縣,金湖鎮,0061,370,195,565,20,585,1325,44.15%,27.92%,1
金門縣,金湖鎮,0062,241,145,386,30,416,1236,33.66%,19.5%,1
金門縣,金湖鎮,0063,295,151,446,36,482,1382,34.88%,21.35%,1
金門縣,金湖鎮,0064,394,147,541,19,560,1631,34.33%,24.16%,1
金門縣,金湖鎮,0065,295,160,455,38,493,1514,32.56%,19.48%,1
金門縣,金寧鄉,0022,325,168,493,48,541,1735,31.18%,18.73%,1
金門縣,金寧鄉,0023,297,155,452,34,486,1537,31.62%,19.32%,1
金門縣,金寧鄉,0024,334,232,566,29,595,1766,33.69%,18.91%,1
金門縣,金寧鄉,0025,230,131,361,14,375,1015,36.95%,22.66%,1
金門縣,金寧鄉,0026,397,191,588,31,619,1726,35.86%,23%,1
金門縣,金寧鄉,0027,313,197,510,28,538,1691,31.82%,18.51%,1
金門縣,金寧鄉,0028,387,449,836,30,866,2044,42.37%,18.93%,1
金門縣,金寧鄉,0029,472,257,729,35,764,1848,41.34%,25.54%,1
金門縣,金寧鄉,0030,397,193,590,22,612,1735,35.27%,22.88%,1
金門縣,金寧鄉,0031,381,221,602,25,627,1795,34.93%,21.23%,1
金門縣,金寧鄉,0032,371,171,542,40,582,1834,31.73%,20.23%,1
金門縣,金寧鄉,0033,283,204,487,25,512,1528,33.51%,18.52%,1
金門縣,金寧鄉,0034,339,198,537,31,568,1473,38.56%,23.01%,1
金門縣,金寧鄉,0035,365,210,575,26,601,1679,35.8%,21.74%,1
金門縣,金寧鄉,0036,338,569,907,26,933,1921,48.57%,17.6%,1
金門縣,金寧鄉,0037,274,178,452,16,468,1298,36.06%,21.11%,1
金門縣,金寧鄉,0038,299,171,470,36,506,1537,32.92%,19.45%,1
金門縣,烈嶼鄉,0039,466,216,682,40,722,1647,43.84%,28.29%,1
金門縣,烈嶼鄉,0040,397,192,589,28,617,1733,35.6%,22.91%,1
金門縣,烈嶼鄉,0041,383,185,568,39,607,1635,37.13%,23.43%,1
金門縣,烈嶼鄉,0042,266,158,424,16,440,1296,33.95%,20.52%,1
金門縣,烈嶼鄉,0043,210,112,322,33,355,1099,32.3%,19.11%,1
金門縣,烈嶼鄉,0044,312,140,452,32,484,1425,33.96%,21.89%,1
金門縣,烈嶼鄉,0045,344,160,504,21,525,1412,37.18%,24.36%,1
金門縣,烈嶼鄉,0046,333,130,463,42,505,1429,35.34%,23.3%,1
金門縣,烏坵鄉,0047,49,26,75,3,78,275,28.36%,17.82%,1
金門縣,烏坵鄉,0048,64,20,84,3,87,292,29.79%,21.92%,1
連江縣,南竿鄉,0001,626,345,971,43,1014,1967,51.55%,31.83%,1
連江縣,南竿鄉,0002,543,298,841,43,884,1837,48.12%,29.56%,1
連江縣,南竿鄉,0003,369,200,569,16,585,1114,52.51%,33.12%,1
連江縣,南竿鄉,0004,556,221,777,23,800,1543,51.85%,36.03%,1
連江縣,北竿鄉,0005,514,263,777,37,814,1515,53.73%,33.93%,1
連江縣,北竿鄉,0006,199,84,283,14,297,610,48.69%,32.62%,1
連江縣,莒光鄉,0007,203,133,336,15,351,698,50.29%,29.08%,1
連江縣,莒光鄉,0008,264,156,420,21,441,783,56.32%,33.72%,1
連江縣,東引鄉,0009,325,225,550,28,578,1138,50.79%,28.56%,1
基隆市,中正區,0001,148,92,240,16,256,466,54.94%,31.76%,1
基隆市,中正區,0002,293,241,534,22,556,1262,44.06%,23.22%,1
基隆市,中正區,0003,295,213,508,51,559,1171,47.74%,25.19%,1
基隆市,中正區,0004,643,419,1062,13,1075,2823,38.08%,22.78%,1
基隆市,中正區,0005,380,244,624,39,663,1474,44.98%,25.78%,1
基隆市,中正區,0006,299,206,505,50,555,1271,43.67%,23.52%,1
基隆市,中正區,0007,758,384,1142,35,1177,2707,43.48%,28%,1
基隆市,中正區,0008,446,249,695,55,750,1545,48.54%,28.87%,1
基隆市,中正區,0009,205,103,308,15,323,761,42.44%,26.94%,1
基隆市,中正區,0010,358,278,636,22,658,1352,48.67%,26.48%,1
基隆市,中正區,0011,414,232,646,19,665,1413,47.06%,29.3%,1
基隆市,中正區,0012,699,404,1103,41,1144,2665,42.93%,26.23%,1
基隆市,中正區,0013,327,226,553,47,600,1261,47.58%,25.93%,1
基隆市,中正區,0014,335,497,832,53,885,1753,50.48%,19.11%,1
基隆市,中正區,0015,255,162,417,29,446,984,45.33%,25.91%,1
基隆市,中正區,0016,363,181,544,24,568,1166,48.71%,31.13%,1
基隆市,中正區,0017,271,180,451,23,474,973,48.72%,27.85%,1
基隆市,中正區,0018,350,272,622,21,643,1694,37.96%,20.66%,1
基隆市,中正區,0019,362,258,620,21,641,1270,50.47%,28.5%,1
基隆市,中正區,0020,352,198,550,26,576,1090,52.84%,32.29%,1
基隆市,中正區,0021,274,174,448,20,468,870,53.79%,31.49%,1
基隆市,中正區,0022,313,229,542,30,572,1138,50.26%,27.5%,1
基隆市,中正區,0023,212,178,390,33,423,862,49.07%,24.59%,1
基隆市,中正區,0024,399,305,704,40,744,1341,55.48%,29.75%,1
基隆市,中正區,0025,273,163,436,33,469,859,54.6%,31.78%,1
基隆市,中正區,0026,396,250,646,27,673,1457,46.19%,27.18%,1
基隆市,中正區,0027,376,240,616,41,657,1594,41.22%,23.59%,1
基隆市,中正區,0028,225,169,394,35,429,802,53.49%,28.05%,1
基隆市,中正區,0029,379,215,594,29,623,1267,49.17%,29.91%,1
基隆市,中正區,0030,318,254,572,49,621,1175,52.85%,27.06%,1
基隆市,中正區,0031,396,248,644,38,682,1210,56.36%,32.73%,1
基隆市,中正區,0032,305,217,522,28,550,1037,53.04%,29.41%,1
基隆市,中正區,0033,384,225,609,34,643,1219,52.75%,31.5%,1
基隆市,中正區,0034,285,167,452,22,474,904,52.43%,31.53%,1
基隆市,中正區,0035,234,182,416,28,444,709,62.62%,33%,1
基隆市,七堵區,0219,480,218,698,38,736,1258,58.51%,38.16%,1
基隆市,七堵區,0220,377,286,663,32,695,1237,56.18%,30.48%,1
基隆市,七堵區,0221,388,261,649,19,668,1259,53.06%,30.82%,1
基隆市,七堵區,0222,334,211,545,34,579,1120,51.7%,29.82%,1
基隆市,七堵區,0223,392,217,609,46,655,1344,48.74%,29.17%,1
基隆市,七堵區,0224,370,219,589,32,621,1011,61.42%,36.6%,1
基隆市,七堵區,0225,301,196,497,9,506,925,54.7%,32.54%,1
基隆市,七堵區,0226,583,349,932,40,972,1735,56.02%,33.6%,1
基隆市,七堵區,0227,605,398,1003,35,1038,1833,56.63%,33.01%,1
基隆市,七堵區,0228,309,209,518,18,536,938,57.14%,32.94%,1
基隆市,七堵區,0229,332,207,539,35,574,962,59.67%,34.51%,1
基隆市,七堵區,0230,419,239,658,23,681,1191,57.18%,35.18%,1
基隆市,七堵區,0231,323,224,547,29,576,999,57.66%,32.33%,1
基隆市,七堵區,0232,62,68,130,9,139,282,49.29%,21.99%,1
基隆市,七堵區,0233,344,255,599,41,640,1243,51.49%,27.67%,1
基隆市,七堵區,0234,343,204,547,35,582,1092,53.3%,31.41%,1
基隆市,七堵區,0235,378,268,646,25,671,1246,53.85%,30.34%,1
基隆市,七堵區,0236,509,337,846,33,879,1722,51.05%,29.56%,1
基隆市,七堵區,0237,392,292,684,32,716,1318,54.32%,29.74%,1
基隆市,七堵區,0238,303,154,457,22,479,975,49.13%,31.08%,1
基隆市,七堵區,0239,373,278,651,24,675,1285,52.53%,29.03%,1
基隆市,七堵區,0240,300,181,481,40,521,1077,48.38%,27.86%,1
基隆市,七堵區,0241,283,163,446,26,472,989,47.72%,28.61%,1
基隆市,七堵區,0242,342,230,572,26,598,1193,50.13%,28.67%,1
基隆市,七堵區,0243,367,266,633,31,664,1273,52.16%,28.83%,1
基隆市,七堵區,0244,557,350,907,52,959,1774,54.06%,31.4%,1
基隆市,七堵區,0245,498,358,856,52,908,1689,53.76%,29.48%,1
基隆市,七堵區,0246,477,187,664,29,693,1355,51.14%,35.2%,1
基隆市,七堵區,0247,500,235,735,33,768,1512,50.79%,33.07%,1
基隆市,七堵區,0248,437,280,717,18,735,1486,49.46%,29.41%,1
基隆市,七堵區,0249,515,328,843,29,872,1706,51.11%,30.19%,1
基隆市,七堵區,0250,465,267,732,31,763,1384,55.13%,33.6%,1
基隆市,七堵區,0251,389,218,607,26,633,1045,60.57%,37.22%,1
基隆市,七堵區,0252,413,292,705,30,735,1374,53.49%,30.06%,1
基隆市,七堵區,0253,148,83,231,5,236,428,55.14%,34.58%,1
基隆市,七堵區,0254,105,75,180,19,199,326,61.04%,32.21%,1
基隆市,七堵區,0255,155,88,243,9,252,351,71.79%,44.16%,1
基隆市,七堵區,0256,530,353,883,18,901,1871,48.16%,28.33%,1
基隆市,七堵區,0257,134,93,227,7,234,448,52.23%,29.91%,1
基隆市,暖暖區,0191,392,287,679,30,709,1431,49.55%,27.39%,1
基隆市,暖暖區,0192,153,85,238,5,243,456,53.29%,33.55%,1
基隆市,暖暖區,0193,218,129,347,17,364,637,57.14%,34.22%,1
基隆市,暖暖區,0194,264,156,420,23,443,735,60.27%,35.92%,1
基隆市,暖暖區,0195,299,197,496,34,530,1078,49.17%,27.74%,1
基隆市,暖暖區,0196,333,254,587,33,620,1238,50.08%,26.9%,1
基隆市,暖暖區,0197,400,257,657,22,679,1325,51.25%,30.19%,1
基隆市,暖暖區,0198,466,298,764,32,796,1475,53.97%,31.59%,1
基隆市,暖暖區,0199,324,231,555,22,577,1179,48.94%,27.48%,1
基隆市,暖暖區,0200,398,236,634,25,659,1110,59.37%,35.86%,1
基隆市,暖暖區,0201,385,254,639,19,658,1443,45.6%,26.68%,1
基隆市,暖暖區,0202,114,101,215,11,226,415,54.46%,27.47%,1
基隆市,暖暖區,0203,397,281,678,16,694,1378,50.36%,28.81%,1
基隆市,暖暖區,0204,472,318,790,32,822,1570,52.36%,30.06%,1
基隆市,暖暖區,0205,565,331,896,47,943,1603,58.83%,35.25%,1
基隆市,暖暖區,0206,399,308,707,28,735,1267,58.01%,31.49%,1
基隆市,暖暖區,0207,421,269,690,28,718,1359,52.83%,30.98%,1
基隆市,暖暖區,0208,350,196,546,30,576,970,59.38%,36.08%,1
基隆市,暖暖區,0209,318,205,523,14,537,1002,53.59%,31.74%,1
基隆市,暖暖區,0210,280,184,464,25,489,944,51.8%,29.66%,1
基隆市,暖暖區,0211,505,325,830,19,849,1500,56.6%,33.67%,1
基隆市,暖暖區,0212,360,225,585,14,599,1442,41.54%,24.97%,1
基隆市,暖暖區,0213,386,233,619,13,632,1165,54.25%,33.13%,1
基隆市,暖暖區,0214,508,293,801,24,825,1610,51.24%,31.55%,1
基隆市,暖暖區,0215,436,283,719,22,741,1328,55.8%,32.83%,1
基隆市,暖暖區,0216,396,224,620,10,630,1173,53.71%,33.76%,1
基隆市,暖暖區,0217,331,248,579,27,606,1019,59.47%,32.48%,1
基隆市,暖暖區,0218,455,286,741,18,759,1373,55.28%,33.14%,1
基隆市,仁愛區,0072,481,280,761,76,837,1782,46.97%,26.99%,1
基隆市,仁愛區,0073,362,208,570,28,598,1055,56.68%,34.31%,1
基隆市,仁愛區,0074,454,278,732,19,751,1558,48.2%,29.14%,1
基隆市,仁愛區,0075,548,346,894,37,931,1736,53.63%,31.57%,1
基隆市,仁愛區,0076,427,281,708,25,733,1243,58.97%,34.35%,1
基隆市,仁愛區,0077,377,224,601,26,627,1109,56.54%,33.99%,1
基隆市,仁愛區,0078,604,330,934,36,970,1684,57.6%,35.87%,1
基隆市,仁愛區,0079,267,213,480,32,512,919,55.71%,29.05%,1
基隆市,仁愛區,0080,279,217,496,15,511,991,51.56%,28.15%,1
基隆市,仁愛區,0081,281,190,471,15,486,876,55.48%,32.08%,1
基隆市,仁愛區,0082,336,246,582,32,614,1046,58.7%,32.12%,1
基隆市,仁愛區,0083,159,87,246,17,263,434,60.6%,36.64%,1
基隆市,仁愛區,0084,259,156,415,39,454,764,59.42%,33.9%,1
基隆市,仁愛區,0085,303,181,484,19,503,968,51.96%,31.3%,1
基隆市,仁愛區,0086,365,282,647,42,689,1326,51.96%,27.53%,1
基隆市,仁愛區,0087,307,238,545,35,580,1315,44.11%,23.35%,1
基隆市,仁愛區,0088,270,158,428,22,450,775,58.06%,34.84%,1
基隆市,仁愛區,0089,193,156,349,27,376,652,57.67%,29.6%,1
基隆市,仁愛區,0090,222,137,359,20,379,674,56.23%,32.94%,1
基隆市,仁愛區,0091,292,94,386,27,413,789,52.34%,37.01%,1
基隆市,仁愛區,0092,521,332,853,51,904,1715,52.71%,30.38%,1
基隆市,仁愛區,0093,258,173,431,31,462,849,54.42%,30.39%,1
基隆市,仁愛區,0094,294,173,467,20,487,875,55.66%,33.6%,1
基隆市,仁愛區,0095,228,177,405,29,434,851,51%,26.79%,1
基隆市,仁愛區,0096,234,174,408,19,427,735,58.1%,31.84%,1
基隆市,仁愛區,0097,280,223,503,40,543,1009,53.82%,27.75%,1
基隆市,仁愛區,0098,325,179,504,37,541,1082,50%,30.04%,1
基隆市,仁愛區,0099,362,264,626,38,664,1278,51.96%,28.33%,1
基隆市,仁愛區,0100,526,310,836,40,876,1519,57.67%,34.63%,1
基隆市,仁愛區,0101,358,216,574,30,604,1336,45.21%,26.8%,1
基隆市,仁愛區,0102,420,260,680,26,706,1178,59.93%,35.65%,1
基隆市,仁愛區,0103,210,143,353,29,382,708,53.95%,29.66%,1
基隆市,仁愛區,0104,203,134,337,18,355,567,62.61%,35.8%,1
基隆市,仁愛區,0105,215,166,381,36,417,751,55.53%,28.63%,1
基隆市,仁愛區,0106,181,159,340,14,354,589,60.1%,30.73%,1
基隆市,中山區,0107,224,168,392,24,416,796,52.26%,28.14%,1
基隆市,中山區,0108,398,206,604,38,642,1036,61.97%,38.42%,1
基隆市,中山區,0109,271,152,423,19,442,756,58.47%,35.85%,1
基隆市,中山區,0110,258,201,459,18,477,957,49.84%,26.96%,1
基隆市,中山區,0111,266,165,431,9,440,802,54.86%,33.17%,1
基隆市,中山區,0112,382,257,639,37,676,1263,53.52%,30.25%,1
基隆市,中山區,0113,251,176,427,21,448,778,57.58%,32.26%,1
基隆市,中山區,0114,378,231,609,49,658,1180,55.76%,32.03%,1
基隆市,中山區,0115,302,165,467,24,491,990,49.6%,30.51%,1
基隆市,中山區,0116,339,212,551,25,576,1332,43.24%,25.45%,1
基隆市,中山區,0117,220,155,375,28,403,848,47.52%,25.94%,1
基隆市,中山區,0118,268,168,436,20,456,922,49.46%,29.07%,1
基隆市,中山區,0119,149,110,259,14,273,459,59.48%,32.46%,1
基隆市,中山區,0120,173,98,271,19,290,574,50.52%,30.14%,1
基隆市,中山區,0121,250,181,431,24,455,877,51.88%,28.51%,1
基隆市,中山區,0122,402,307,709,16,725,1584,45.77%,25.38%,1
基隆市,中山區,0123,296,184,480,19,499,1319,37.83%,22.44%,1
基隆市,中山區,0124,553,400,953,47,1000,1938,51.6%,28.53%,1
基隆市,中山區,0125,495,389,884,27,911,1877,48.53%,26.37%,1
基隆市,中山區,0126,670,425,1095,32,1127,2088,53.98%,32.09%,1
基隆市,中山區,0127,603,423,1026,30,1056,1946,54.27%,30.99%,1
基隆市,中山區,0128,446,276,722,45,767,1353,56.69%,32.96%,1
基隆市,中山區,0129,397,262,659,37,696,1317,52.85%,30.14%,1
基隆市,中山區,0130,262,215,477,20,497,870,57.13%,30.11%,1
基隆市,中山區,0131,409,290,699,27,726,1322,54.92%,30.94%,1
基隆市,中山區,0132,358,243,601,13,614,1295,47.41%,27.64%,1
基隆市,中山區,0133,269,157,426,34,460,756,60.85%,35.58%,1
基隆市,中山區,0134,431,293,724,24,748,1602,46.69%,26.9%,1
基隆市,中山區,0135,452,274,726,27,753,1568,48.02%,28.83%,1
基隆市,中山區,0136,455,258,713,23,736,1404,52.42%,32.41%,1
基隆市,中山區,0137,581,337,918,26,944,1909,49.45%,30.43%,1
基隆市,中山區,0138,432,278,710,52,762,1642,46.41%,26.31%,1
基隆市,中山區,0139,285,171,456,26,482,932,51.72%,30.58%,1
基隆市,中山區,0140,301,182,483,34,517,849,60.9%,35.45%,1
基隆市,中山區,0141,217,179,396,31,427,715,59.72%,30.35%,1
基隆市,安樂區,0142,390,239,629,52,681,1361,50.04%,28.66%,1
基隆市,安樂區,0143,354,231,585,22,607,1213,50.04%,29.18%,1
基隆市,安樂區,0144,273,172,445,23,468,1026,45.61%,26.61%,1
基隆市,安樂區,0145,379,211,590,39,629,1038,60.6%,36.51%,1
基隆市,安樂區,0146,247,223,470,50,520,897,57.97%,27.54%,1
基隆市,安樂區,0147,431,276,707,42,749,1401,53.46%,30.76%,1
基隆市,安樂區,0148,142,91,233,11,244,641,38.07%,22.15%,1
基隆市,安樂區,0149,393,328,721,30,751,1472,51.02%,26.7%,1
基隆市,安樂區,0150,143,105,248,16,264,472,55.93%,30.3%,1
基隆市,安樂區,0151,286,199,485,21,506,841,60.17%,34.01%,1
基隆市,安樂區,0152,163,132,295,15,310,571,54.29%,28.55%,1
基隆市,安樂區,0153,542,396,938,31,969,1901,50.97%,28.51%,1
基隆市,安樂區,0154,389,270,659,40,699,1349,51.82%,28.84%,1
基隆市,安樂區,0155,359,246,605,23,628,1225,51.27%,29.31%,1
基隆市,安樂區,0156,420,291,711,39,750,1351,55.51%,31.09%,1
基隆市,安樂區,0157,526,360,886,28,914,1601,57.09%,32.85%,1
基隆市,安樂區,0158,757,483,1240,31,1271,2513,50.58%,30.12%,1
基隆市,安樂區,0159,526,314,840,32,872,1613,54.06%,32.61%,1
基隆市,安樂區,0160,600,318,918,23,941,1731,54.36%,34.66%,1
基隆市,安樂區,0161,474,351,825,20,845,1424,59.34%,33.29%,1
基隆市,安樂區,0162,522,350,872,45,917,1806,50.78%,28.9%,1
基隆市,安樂區,0163,565,333,898,41,939,1679,55.93%,33.65%,1
基隆市,安樂區,0164,578,407,985,31,1016,1902,53.42%,30.39%,1
基隆市,安樂區,0165,572,440,1012,27,1039,2040,50.93%,28.04%,1
基隆市,安樂區,0166,416,253,669,41,710,1313,54.07%,31.68%,1
基隆市,安樂區,0167,256,242,498,26,524,1243,42.16%,20.6%,1
基隆市,安樂區,0168,507,378,885,19,904,1759,51.39%,28.82%,1
基隆市,安樂區,0169,235,186,421,17,438,694,63.11%,33.86%,1
基隆市,安樂區,0170,393,139,532,19,551,866,63.63%,45.38%,1
基隆市,安樂區,0171,410,259,669,17,686,1557,44.06%,26.33%,1
基隆市,安樂區,0172,413,281,694,25,719,1411,50.96%,29.27%,1
基隆市,安樂區,0173,532,344,876,16,892,1568,56.89%,33.93%,1
基隆市,安樂區,0174,440,255,695,30,725,1400,51.79%,31.43%,1
基隆市,安樂區,0175,512,271,783,10,793,1531,51.8%,33.44%,1
基隆市,安樂區,0176,464,337,801,21,822,1673,49.13%,27.73%,1
基隆市,安樂區,0177,304,223,527,35,562,1054,53.32%,28.84%,1
基隆市,安樂區,0178,490,312,802,25,827,1923,43.01%,25.48%,1
基隆市,安樂區,0179,641,378,1019,34,1053,1960,53.72%,32.7%,1
基隆市,安樂區,0180,518,296,814,138,952,1962,48.52%,26.4%,1
基隆市,安樂區,0181,630,432,1062,38,1100,2117,51.96%,29.76%,1
基隆市,安樂區,0182,461,390,851,36,887,1829,48.5%,25.21%,1
基隆市,安樂區,0183,428,290,718,22,740,1529,48.4%,27.99%,1
基隆市,安樂區,0184,555,377,932,22,954,1869,51.04%,29.7%,1
基隆市,安樂區,0185,374,248,622,15,637,1140,55.88%,32.81%,1
基隆市,安樂區,0186,445,373,818,32,850,1641,51.8%,27.12%,1
基隆市,安樂區,0187,362,267,629,35,664,1279,51.92%,28.3%,1
基隆市,安樂區,0188,395,290,685,18,703,1360,51.69%,29.04%,1
基隆市,安樂區,0189,418,317,735,31,766,1399,54.75%,29.88%,1
基隆市,安樂區,0190,375,251,626,19,645,1251,51.56%,29.98%,1
基隆市,信義區,0036,362,227,589,26,615,1096,56.11%,33.03%,1
基隆市,信義區,0037,418,287,705,34,739,1232,59.98%,33.93%,1
基隆市,信義區,0038,386,264,650,21,671,1184,56.67%,32.6%,1
基隆市,信義區,0039,417,212,629,38,667,1133,58.87%,36.8%,1
基隆市,信義區,0040,405,241,646,22,668,1188,56.23%,34.09%,1
基隆市,信義區,0041,259,145,404,23,427,725,58.9%,35.72%,1
基隆市,信義區,0042,435,260,695,29,724,1524,47.51%,28.54%,1
基隆市,信義區,0043,230,157,387,30,417,736,56.66%,31.25%,1
基隆市,信義區,0044,195,117,312,16,328,611,53.68%,31.91%,1
基隆市,信義區,0045,299,162,461,13,474,951,49.84%,31.44%,1
基隆市,信義區,0046,531,296,827,30,857,1616,53.03%,32.86%,1
基隆市,信義區,0047,466,339,805,21,826,1516,54.49%,30.74%,1
基隆市,信義區,0048,330,199,529,25,554,1049,52.81%,31.46%,1
基隆市,信義區,0049,309,228,537,24,561,1069,52.48%,28.91%,1
基隆市,信義區,0050,240,163,403,22,425,727,58.46%,33.01%,1
基隆市,信義區,0051,323,214,537,18,555,929,59.74%,34.77%,1
基隆市,信義區,0052,399,268,667,25,692,1118,61.9%,35.69%,1
基隆市,信義區,0053,438,284,722,32,754,1339,56.31%,32.71%,1
基隆市,信義區,0054,348,169,517,14,531,999,53.15%,34.83%,1
基隆市,信義區,0055,246,157,403,9,412,764,53.93%,32.2%,1
基隆市,信義區,0056,456,271,727,30,757,1555,48.68%,29.32%,1
基隆市,信義區,0057,608,369,977,23,1000,2015,49.63%,30.17%,1
基隆市,信義區,0058,441,248,689,29,718,1268,56.62%,34.78%,1
基隆市,信義區,0059,492,311,803,33,836,1569,53.28%,31.36%,1
基隆市,信義區,0060,341,587,928,32,960,1985,48.36%,17.18%,1
基隆市,信義區,0061,544,241,785,26,811,1476,54.95%,36.86%,1
基隆市,信義區,0062,484,339,823,20,843,1493,56.46%,32.42%,1
基隆市,信義區,0063,459,289,748,20,768,1249,61.49%,36.75%,1
基隆市,信義區,0064,455,305,760,23,783,1559,50.22%,29.19%,1
基隆市,信義區,0065,348,215,563,17,580,1168,49.66%,29.79%,1
基隆市,信義區,0066,514,294,808,21,829,1602,51.75%,32.08%,1
基隆市,信義區,0067,417,239,656,33,689,1485,46.4%,28.08%,1
基隆市,信義區,0068,324,180,504,22,526,1009,52.13%,32.11%,1
基隆市,信義區,0069,511,322,833,33,866,2016,42.96%,25.35%,1
基隆市,信義區,0070,464,296,760,10,770,1764,43.65%,26.3%,1
基隆市,信義區,0071,411,267,678,25,703,1295,54.29%,31.74%,1
新竹市,東區,0001,289,213,502,16,518,1512,34.26%,19.11%,1
新竹市,東區,0002,346,218,564,21,585,953,61.39%,36.31%,1
新竹市,東區,0003,266,140,406,16,422,729,57.89%,36.49%,1
新竹市,東區,0004,200,128,328,26,354,566,62.54%,35.34%,1
新竹市,東區,0005,208,158,366,17,383,640,59.84%,32.5%,1
新竹市,東區,0006,92,65,157,16,173,305,56.72%,30.16%,1
新竹市,東區,0007,214,114,328,19,347,563,61.63%,38.01%,1
新竹市,東區,0008,248,163,411,10,421,741,56.82%,33.47%,1
新竹市,東區,0009,355,245,600,13,613,1041,58.89%,34.1%,1
新竹市,東區,0010,524,318,842,30,872,1615,53.99%,32.45%,1
新竹市,東區,0011,443,272,715,32,747,1287,58.04%,34.42%,1
新竹市,東區,0012,541,326,867,31,898,1554,57.79%,34.81%,1
新竹市,東區,0013,474,335,809,16,825,1388,59.44%,34.15%,1
新竹市,東區,0014,519,306,825,26,851,1419,59.97%,36.58%,1
新竹市,東區,0015,434,289,723,34,757,1355,55.87%,32.03%,1
新竹市,東區,0016,488,323,811,33,844,1490,56.64%,32.75%,1
新竹市,東區,0017,537,359,896,25,921,1615,57.03%,33.25%,1
新竹市,東區,0018,567,381,948,23,971,1672,58.07%,33.91%,1
新竹市,東區,0019,343,256,599,27,626,1062,58.95%,32.3%,1
新竹市,東區,0020,443,285,728,25,753,1315,57.26%,33.69%,1
新竹市,東區,0021,355,203,558,37,595,1000,59.5%,35.5%,1
新竹市,東區,0022,472,294,766,33,799,1337,59.76%,35.3%,1
新竹市,東區,0023,563,365,928,23,951,1747,54.44%,32.23%,1
新竹市,東區,0024,555,383,938,20,958,1600,59.88%,34.69%,1
新竹市,東區,0025,372,248,620,36,656,1158,56.65%,32.12%,1
新竹市,東區,0026,302,212,514,27,541,828,65.34%,36.47%,1
新竹市,東區,0027,484,351,835,39,874,1573,55.56%,30.77%,1
新竹市,東區,0028,553,306,859,29,888,1550,57.29%,35.68%,1
新竹市,東區,0029,438,289,727,28,755,1317,57.33%,33.26%,1
新竹市,東區,0030,371,249,620,29,649,1040,62.4%,35.67%,1
新竹市,東區,0031,374,177,551,16,567,935,60.64%,40%,1
新竹市,東區,0032,359,235,594,22,616,1074,57.36%,33.43%,1
新竹市,東區,0033,412,257,669,30,699,1133,61.69%,36.36%,1
新竹市,東區,0034,443,287,730,40,770,1262,61.01%,35.1%,1
新竹市,東區,0035,426,237,663,27,690,1199,57.55%,35.53%,1
新竹市,東區,0036,462,273,735,34,769,1226,62.72%,37.68%,1
新竹市,東區,0037,516,338,854,31,885,1377,64.27%,37.47%,1
新竹市,東區,0038,373,246,619,17,636,991,64.18%,37.64%,1
新竹市,東區,0039,445,273,718,44,762,1271,59.95%,35.01%,1
新竹市,東區,0040,395,234,629,24,653,1012,64.53%,39.03%,1
新竹市,東區,0041,350,206,556,33,589,1001,58.84%,34.97%,1
新竹市,東區,0042,486,334,820,44,864,1603,53.9%,30.32%,1
新竹市,東區,0043,380,288,668,34,702,1236,56.8%,30.74%,1
新竹市,東區,0044,455,263,718,29,747,1532,48.76%,29.7%,1
新竹市,東區,0045,455,264,719,29,748,1306,57.27%,34.84%,1
新竹市,東區,0046,342,251,593,39,632,1073,58.9%,31.87%,1
新竹市,東區,0047,318,211,529,20,549,952,57.67%,33.4%,1
新竹市,東區,0048,400,241,641,30,671,1298,51.69%,30.82%,1
新竹市,東區,0049,272,166,438,14,452,778,58.1%,34.96%,1
新竹市,東區,0050,392,281,673,31,704,1195,58.91%,32.8%,1
新竹市,東區,0051,516,296,812,56,868,1569,55.32%,32.89%,1
新竹市,東區,0052,543,386,929,33,962,1533,62.75%,35.42%,1
新竹市,東區,0053,533,255,788,27,815,1336,61%,39.9%,1
新竹市,東區,0054,515,267,782,30,812,1367,59.4%,37.67%,1
新竹市,東區,0055,490,266,756,33,789,1289,61.21%,38.01%,1
新竹市,東區,0056,329,205,534,15,549,960,57.19%,34.27%,1
新竹市,東區,0057,329,190,519,20,539,843,63.94%,39.03%,1
新竹市,東區,0058,349,207,556,23,579,948,61.08%,36.81%,1
新竹市,東區,0059,326,167,493,29,522,915,57.05%,35.63%,1
新竹市,東區,0060,646,364,1010,35,1045,1801,58.02%,35.87%,1
新竹市,東區,0061,373,239,612,21,633,1079,58.67%,34.57%,1
新竹市,東區,0062,273,143,416,8,424,676,62.72%,40.38%,1
新竹市,東區,0063,385,246,631,46,677,1132,59.81%,34.01%,1
新竹市,東區,0064,77,68,145,7,152,251,60.56%,30.68%,1
新竹市,東區,0065,577,320,897,33,930,1620,57.41%,35.62%,1
新竹市,東區,0066,444,332,776,25,801,1479,54.16%,30.02%,1
新竹市,東區,0067,404,333,737,19,756,1402,53.92%,28.82%,1
新竹市,東區,0068,410,274,684,38,722,1280,56.41%,32.03%,1
新竹市,東區,0069,393,321,714,18,732,1228,59.61%,32%,1
新竹市,東區,0070,333,298,631,7,638,1157,55.14%,28.78%,1
新竹市,東區,0071,449,288,737,30,767,1354,56.65%,33.16%,1
新竹市,東區,0072,504,338,842,25,867,1334,64.99%,37.78%,1
新竹市,東區,0073,438,298,736,29,765,1234,61.99%,35.49%,1
新竹市,東區,0074,540,325,865,29,894,1398,63.95%,38.63%,1
新竹市,東區,0075,339,214,553,18,571,928,61.53%,36.53%,1
新竹市,東區,0076,503,329,832,25,857,1368,62.65%,36.77%,1
新竹市,東區,0077,381,289,670,20,690,1215,56.79%,31.36%,1
新竹市,東區,0078,328,226,554,21,575,1067,53.89%,30.74%,1
新竹市,東區,0079,322,320,642,19,661,1194,55.36%,26.97%,1
新竹市,東區,0080,339,287,626,17,643,1193,53.9%,28.42%,1
新竹市,東區,0081,438,318,756,53,809,1388,58.29%,31.56%,1
新竹市,東區,0082,466,256,722,31,753,1267,59.43%,36.78%,1
新竹市,東區,0083,424,294,718,21,739,1299,56.89%,32.64%,1
新竹市,東區,0084,418,298,716,25,741,1288,57.53%,32.45%,1
新竹市,東區,0085,395,338,733,17,750,1228,61.07%,32.17%,1
新竹市,東區,0086,375,309,684,10,694,1135,61.15%,33.04%,1
新竹市,東區,0087,421,345,766,21,787,1237,63.62%,34.03%,1
新竹市,東區,0088,357,229,586,31,617,1135,54.36%,31.45%,1
新竹市,東區,0089,393,198,591,26,617,1165,52.96%,33.73%,1
新竹市,東區,0090,377,232,609,24,633,1124,56.32%,33.54%,1
新竹市,東區,0091,411,276,687,25,712,1210,58.84%,33.97%,1
新竹市,東區,0092,423,260,683,34,717,1323,54.2%,31.97%,1
新竹市,東區,0093,398,234,632,33,665,1207,55.1%,32.97%,1
新竹市,東區,0094,380,241,621,26,647,1264,51.19%,30.06%,1
新竹市,東區,0095,371,298,669,17,686,1248,54.97%,29.73%,1
新竹市,東區,0096,503,336,839,27,866,1400,61.86%,35.93%,1
新竹市,東區,0097,491,370,861,24,885,1473,60.08%,33.33%,1
新竹市,東區,0098,439,298,737,29,766,1367,56.04%,32.11%,1
新竹市,東區,0099,423,288,711,18,729,1233,59.12%,34.31%,1
新竹市,東區,0100,181,96,277,11,288,507,56.8%,35.7%,1
新竹市,東區,0101,248,154,402,23,425,714,59.52%,34.73%,1
新竹市,東區,0102,300,193,493,24,517,875,59.09%,34.29%,1
新竹市,東區,0103,490,276,766,35,801,1396,57.38%,35.1%,1
新竹市,東區,0104,383,262,645,31,676,1232,54.87%,31.09%,1
新竹市,東區,0105,385,302,687,33,720,1323,54.42%,29.1%,1
新竹市,東區,0106,435,285,720,15,735,1516,48.48%,28.69%,1
新竹市,東區,0107,427,294,721,24,745,1453,51.27%,29.39%,1
新竹市,東區,0108,315,173,488,29,517,880,58.75%,35.8%,1
新竹市,東區,0109,373,200,573,21,594,1058,56.14%,35.26%,1
新竹市,東區,0110,346,230,576,24,600,1061,56.55%,32.61%,1
新竹市,東區,0111,254,135,389,34,423,710,59.58%,35.77%,1
新竹市,東區,0112,275,152,427,35,462,752,61.44%,36.57%,1
新竹市,東區,0113,168,120,288,15,303,475,63.79%,35.37%,1
新竹市,東區,0114,280,172,452,32,484,880,55%,31.82%,1
新竹市,東區,0115,320,243,563,22,585,989,59.15%,32.36%,1
新竹市,東區,0116,354,221,575,38,613,1059,57.88%,33.43%,1
新竹市,東區,0117,217,126,343,28,371,607,61.12%,35.75%,1
新竹市,東區,0118,273,170,443,35,478,815,58.65%,33.5%,1
新竹市,東區,0119,298,160,458,27,485,777,62.42%,38.35%,1
新竹市,東區,0120,402,275,677,34,711,1399,50.82%,28.73%,1
新竹市,東區,0121,394,261,655,26,681,1216,56%,32.4%,1
新竹市,東區,0122,332,198,530,30,560,1062,52.73%,31.26%,1
新竹市,東區,0123,371,235,606,19,625,1046,59.75%,35.47%,1
新竹市,東區,0124,428,270,698,13,711,1332,53.38%,32.13%,1
新竹市,東區,0125,421,313,734,37,771,1350,57.11%,31.19%,1
新竹市,東區,0126,471,267,738,18,756,1438,52.57%,32.75%,1
新竹市,東區,0127,472,253,725,29,754,1414,53.32%,33.38%,1
新竹市,東區,0128,502,336,838,29,867,1476,58.74%,34.01%,1
新竹市,東區,0129,479,298,777,40,817,1326,61.61%,36.12%,1
新竹市,東區,0130,361,219,580,21,601,927,64.83%,38.94%,1
新竹市,東區,0131,427,277,704,32,736,1273,57.82%,33.54%,1
新竹市,東區,0132,399,278,677,30,707,1315,53.76%,30.34%,1
新竹市,東區,0133,471,309,780,35,815,1413,57.68%,33.33%,1
新竹市,東區,0134,344,236,580,28,608,1064,57.14%,32.33%,1
新竹市,東區,0135,466,293,759,24,783,1244,62.94%,37.46%,1
新竹市,東區,0136,380,230,610,4,614,1160,52.93%,32.76%,1
新竹市,東區,0137,410,280,690,15,705,1398,50.43%,29.33%,1
新竹市,東區,0138,336,217,553,18,571,1384,41.26%,24.28%,1
新竹市,東區,0139,297,214,511,29,540,874,61.78%,33.98%,1
新竹市,北區,0140,147,108,255,14,269,477,56.39%,30.82%,1
新竹市,北區,0141,201,108,309,19,328,535,61.31%,37.57%,1
新竹市,北區,0142,246,162,408,40,448,746,60.05%,32.98%,1
新竹市,北區,0143,171,116,287,15,302,546,55.31%,31.32%,1
新竹市,北區,0144,236,179,415,27,442,711,62.17%,33.19%,1
新竹市,北區,0145,362,226,588,28,616,1143,53.89%,31.67%,1
新竹市,北區,0146,435,269,704,30,734,1370,53.58%,31.75%,1
新竹市,北區,0147,455,271,726,32,758,1390,54.53%,32.73%,1
新竹市,北區,0148,336,201,537,17,554,962,57.59%,34.93%,1
新竹市,北區,0149,397,278,675,18,693,1237,56.02%,32.09%,1
新竹市,北區,0150,446,300,746,52,798,1604,49.75%,27.81%,1
新竹市,北區,0151,241,123,364,24,388,758,51.19%,31.79%,1
新竹市,北區,0152,429,236,665,29,694,1320,52.58%,32.5%,1
新竹市,北區,0153,452,276,728,48,776,1519,51.09%,29.76%,1
新竹市,北區,0154,82,47,129,5,134,347,38.62%,23.63%,1
新竹市,北區,0155,427,270,697,25,722,1212,59.57%,35.23%,1
新竹市,北區,0156,479,306,785,30,815,1484,54.92%,32.28%,1
新竹市,北區,0157,434,316,750,43,793,1428,55.53%,30.39%,1
新竹市,北區,0158,426,214,640,24,664,1128,58.87%,37.77%,1
新竹市,北區,0159,199,151,350,12,362,638,56.74%,31.19%,1
新竹市,北區,0160,462,215,677,39,716,1222,58.59%,37.81%,1
新竹市,北區,0161,346,223,569,19,588,1076,54.65%,32.16%,1
新竹市,北區,0162,379,216,595,22,617,937,65.85%,40.45%,1
新竹市,北區,0163,428,297,725,47,772,1394,55.38%,30.7%,1
新竹市,北區,0164,471,328,799,20,819,1568,52.23%,30.04%,1
新竹市,北區,0165,386,283,669,38,707,1159,61%,33.3%,1
新竹市,北區,0166,58,46,104,1,105,252,41.67%,23.02%,1
新竹市,北區,0167,280,191,471,12,483,761,63.47%,36.79%,1
新竹市,北區,0168,245,202,447,26,473,788,60.03%,31.09%,1
新竹市,北區,0169,215,123,338,24,362,561,64.53%,38.32%,1
新竹市,北區,0170,450,312,762,68,830,1558,53.27%,28.88%,1
新竹市,北區,0171,390,296,686,26,712,1398,50.93%,27.9%,1
新竹市,北區,0172,308,197,505,29,534,957,55.8%,32.18%,1
新竹市,北區,0173,411,259,670,31,701,1195,58.66%,34.39%,1
新竹市,北區,0174,353,240,593,23,616,1236,49.84%,28.56%,1
新竹市,北區,0175,351,275,626,44,670,1255,53.39%,27.97%,1
新竹市,北區,0176,360,249,609,33,642,1114,57.63%,32.32%,1
新竹市,北區,0177,437,314,751,28,779,1396,55.8%,31.3%,1
新竹市,北區,0178,508,299,807,30,837,1456,57.49%,34.89%,1
新竹市,北區,0179,445,291,736,21,757,1374,55.09%,32.39%,1
新竹市,北區,0180,326,217,543,33,576,1070,53.83%,30.47%,1
新竹市,北區,0181,365,237,602,44,646,1142,56.57%,31.96%,1
新竹市,北區,0182,332,241,573,23,596,1103,54.03%,30.1%,1
新竹市,北區,0183,392,248,640,41,681,1190,57.23%,32.94%,1
新竹市,北區,0184,411,245,656,21,677,1089,62.17%,37.74%,1
新竹市,北區,0185,380,223,603,17,620,1272,48.74%,29.87%,1
新竹市,北區,0186,434,271,705,46,751,1306,57.5%,33.23%,1
新竹市,北區,0187,416,305,721,26,747,1328,56.25%,31.33%,1
新竹市,北區,0188,437,303,740,33,773,1457,53.05%,29.99%,1
新竹市,北區,0189,483,311,794,38,832,1492,55.76%,32.37%,1
新竹市,北區,0190,387,270,657,46,703,1160,60.6%,33.36%,1
新竹市,北區,0191,324,203,527,48,575,971,59.22%,33.37%,1
新竹市,北區,0192,263,170,433,21,454,1401,32.41%,18.77%,1
新竹市,北區,0193,429,316,745,29,774,1340,57.76%,32.01%,1
新竹市,北區,0194,456,340,796,24,820,1371,59.81%,33.26%,1
新竹市,北區,0195,393,290,683,27,710,1267,56.04%,31.02%,1
新竹市,北區,0196,409,250,659,20,679,1073,63.28%,38.12%,1
新竹市,北區,0197,401,254,655,24,679,1159,58.58%,34.6%,1
新竹市,北區,0198,430,282,712,21,733,1294,56.65%,33.23%,1
新竹市,北區,0199,507,273,780,23,803,1442,55.69%,35.16%,1
新竹市,北區,0200,433,295,728,22,750,1270,59.06%,34.09%,1
新竹市,北區,0201,476,278,754,19,773,1179,65.56%,40.37%,1
新竹市,北區,0202,363,210,573,27,600,949,63.22%,38.25%,1
新竹市,北區,0203,384,267,651,31,682,1163,58.64%,33.02%,1
新竹市,北區,0204,419,310,729,14,743,1334,55.7%,31.41%,1
新竹市,北區,0205,453,314,767,32,799,1415,56.47%,32.01%,1
新竹市,北區,0206,463,310,773,21,794,1305,60.84%,35.48%,1
新竹市,北區,0207,402,254,656,26,682,1200,56.83%,33.5%,1
新竹市,北區,0208,340,280,620,36,656,1106,59.31%,30.74%,1
新竹市,北區,0209,371,132,503,25,528,1044,50.57%,35.54%,1
新竹市,北區,0210,357,247,604,25,629,1061,59.28%,33.65%,1
新竹市,北區,0211,514,330,844,58,902,1518,59.42%,33.86%,1
新竹市,北區,0212,438,295,733,26,759,1220,62.21%,35.9%,1
新竹市,北區,0213,502,350,852,13,865,1475,58.64%,34.03%,1
新竹市,北區,0214,462,251,713,37,750,1373,54.62%,33.65%,1
新竹市,北區,0215,533,290,823,24,847,1450,58.41%,36.76%,1
新竹市,北區,0216,506,299,805,24,829,1423,58.26%,35.56%,1
新竹市,北區,0217,403,192,595,17,612,1059,57.79%,38.05%,1
新竹市,北區,0218,430,223,653,34,687,1130,60.8%,38.05%,1
新竹市,北區,0219,474,246,720,31,751,1208,62.17%,39.24%,1
新竹市,北區,0220,503,225,728,33,761,1226,62.07%,41.03%,1
新竹市,北區,0221,406,256,662,28,690,1175,58.72%,34.55%,1
新竹市,北區,0222,385,386,771,28,799,1371,58.28%,28.08%,1
新竹市,北區,0223,438,244,682,38,720,1306,55.13%,33.54%,1
新竹市,北區,0224,460,249,709,24,733,1340,54.7%,34.33%,1
新竹市,北區,0225,370,277,647,39,686,1111,61.75%,33.3%,1
新竹市,北區,0226,458,273,731,37,768,1197,64.16%,38.26%,1
新竹市,北區,0227,371,188,559,26,585,1008,58.04%,36.81%,1
新竹市,北區,0228,331,184,515,13,528,946,55.81%,34.99%,1
新竹市,北區,0229,253,143,396,34,430,705,60.99%,35.89%,1
新竹市,北區,0230,277,176,453,54,507,848,59.79%,32.67%,1
新竹市,北區,0231,389,276,665,34,699,1295,53.98%,30.04%,1
新竹市,北區,0232,457,279,736,28,764,1467,52.08%,31.15%,1
新竹市,北區,0233,427,318,745,35,780,1659,47.02%,25.74%,1
新竹市,北區,0234,403,254,657,27,684,1297,52.74%,31.07%,1
新竹市,北區,0235,475,272,747,44,791,1374,57.57%,34.57%,1
新竹市,北區,0236,499,299,798,45,843,1457,57.86%,34.25%,1
新竹市,北區,0237,377,229,606,27,633,1072,59.05%,35.17%,1
新竹市,北區,0238,405,287,692,36,728,1350,53.93%,30%,1
新竹市,北區,0239,341,246,587,23,610,971,62.82%,35.12%,1
新竹市,北區,0240,486,303,789,62,851,1450,58.69%,33.52%,1
新竹市,北區,0241,298,195,493,18,511,895,57.09%,33.3%,1
新竹市,北區,0242,452,280,732,25,757,1378,54.93%,32.8%,1
新竹市,北區,0243,461,322,783,64,847,1609,52.64%,28.65%,1
新竹市,北區,0244,179,135,314,33,347,594,58.42%,30.13%,1
新竹市,香山區,0245,472,282,754,29,783,1443,54.26%,32.71%,1
新竹市,香山區,0246,371,290,661,23,684,1241,55.12%,29.9%,1
新竹市,香山區,0247,371,265,636,26,662,1194,55.44%,31.07%,1
新竹市,香山區,0248,358,237,595,8,603,1081,55.78%,33.12%,1
新竹市,香山區,0249,274,188,462,18,480,807,59.48%,33.95%,1
新竹市,香山區,0250,541,371,912,46,958,1760,54.43%,30.74%,1
新竹市,香山區,0251,532,344,876,38,914,1635,55.9%,32.54%,1
新竹市,香山區,0252,516,319,835,34,869,1473,59%,35.03%,1
新竹市,香山區,0253,505,287,792,15,807,1408,57.32%,35.87%,1
新竹市,香山區,0254,397,228,625,26,651,1318,49.39%,30.12%,1
新竹市,香山區,0255,461,260,721,36,757,1337,56.62%,34.48%,1
新竹市,香山區,0256,542,387,929,26,955,1862,51.29%,29.11%,1
新竹市,香山區,0257,364,220,584,22,606,1067,56.79%,34.11%,1
新竹市,香山區,0258,306,189,495,34,529,863,61.3%,35.46%,1
新竹市,香山區,0259,425,273,698,42,740,1198,61.77%,35.48%,1
新竹市,香山區,0260,371,279,650,44,694,1138,60.98%,32.6%,1
新竹市,香山區,0261,360,224,584,43,627,957,65.52%,37.62%,1
新竹市,香山區,0262,470,283,753,46,799,1348,59.27%,34.87%,1
新竹市,香山區,0263,385,254,639,50,689,1023,67.35%,37.63%,1
新竹市,香山區,0264,357,177,534,23,557,970,57.42%,36.8%,1
新竹市,香山區,0265,441,290,731,38,769,1318,58.35%,33.46%,1
新竹市,香山區,0266,304,265,569,39,608,1088,55.88%,27.94%,1
新竹市,香山區,0267,285,168,453,16,469,903,51.94%,31.56%,1
新竹市,香山區,0268,330,238,568,29,597,1012,58.99%,32.61%,1
新竹市,香山區,0269,354,190,544,35,579,1014,57.1%,34.91%,1
新竹市,香山區,0270,438,265,703,31,734,1238,59.29%,35.38%,1
新竹市,香山區,0271,351,264,615,44,659,1182,55.75%,29.7%,1
新竹市,香山區,0272,506,296,802,52,854,1331,64.16%,38.02%,1
新竹市,香山區,0273,382,231,613,16,629,976,64.45%,39.14%,1
新竹市,香山區,0274,268,180,448,17,465,834,55.76%,32.13%,1
新竹市,香山區,0275,312,189,501,31,532,919,57.89%,33.95%,1
新竹市,香山區,0276,397,279,676,27,703,1188,59.18%,33.42%,1
新竹市,香山區,0277,365,235,600,39,639,1086,58.84%,33.61%,1
新竹市,香山區,0278,444,242,686,27,713,1144,62.33%,38.81%,1
新竹市,香山區,0279,402,229,631,37,668,1112,60.07%,36.15%,1
新竹市,香山區,0280,513,298,811,44,855,1476,57.93%,34.76%,1
新竹市,香山區,0281,451,253,704,30,734,1291,56.86%,34.93%,1
新竹市,香山區,0282,556,320,876,31,907,1464,61.95%,37.98%,1
新竹市,香山區,0283,523,278,801,48,849,1427,59.5%,36.65%,1
新竹市,香山區,0284,428,284,712,36,748,1336,55.99%,32.04%,1
新竹市,香山區,0285,306,223,529,31,560,1131,49.51%,27.06%,1
新竹市,香山區,0286,377,232,609,42,651,1070,60.84%,35.23%,1
新竹市,香山區,0287,357,219,576,43,619,1006,61.53%,35.49%,1
新竹市,香山區,0288,355,194,549,49,598,1223,48.9%,29.03%,1
新竹市,香山區,0289,384,218,602,27,629,1119,56.21%,34.32%,1
新竹市,香山區,0290,402,289,691,36,727,1400,51.93%,28.71%,1
新竹市,香山區,0291,449,290,739,38,777,1627,47.76%,27.6%,1
新竹市,香山區,0292,396,219,615,36,651,1289,50.5%,30.72%,1
新竹市,香山區,0293,406,281,687,28,715,1409,50.75%,28.81%,1
新竹市,香山區,0294,244,153,397,28,425,814,52.21%,29.98%,1
新竹市,香山區,0295,221,154,375,31,406,719,56.47%,30.74%,1
新竹市,香山區,0296,303,201,504,16,520,1065,48.83%,28.45%,1
新竹市,香山區,0297,247,159,406,32,438,776,56.44%,31.83%,1
新竹市,香山區,0298,292,192,484,28,512,890,57.53%,32.81%,1
新竹市,香山區,0299,247,198,445,23,468,896,52.23%,27.57%,1
嘉義市,東區,0001,359,214,573,20,593,1025,57.85%,35.02%,1
嘉義市,東區,0002,419,245,664,21,685,1276,53.68%,32.84%,1
嘉義市,東區,0003,301,179,480,22,502,974,51.54%,30.9%,1
嘉義市,東區,0004,423,280,703,20,723,1175,61.53%,36%,1
嘉義市,東區,0005,283,148,431,9,440,702,62.68%,40.31%,1
嘉義市,東區,0006,368,218,586,22,608,1092,55.68%,33.7%,1
嘉義市,東區,0007,294,182,476,22,498,1023,48.68%,28.74%,1
嘉義市,東區,0008,612,296,908,30,938,1816,51.65%,33.7%,1
嘉義市,東區,0009,626,401,1027,42,1069,1936,55.22%,32.33%,1
嘉義市,東區,0010,554,385,939,20,959,1698,56.48%,32.63%,1
嘉義市,東區,0011,449,277,726,13,739,1221,60.52%,36.77%,1
嘉義市,東區,0012,390,246,636,11,647,1113,58.13%,35.04%,1
嘉義市,東區,0013,486,319,805,27,832,1452,57.3%,33.47%,1
嘉義市,東區,0014,506,325,831,27,858,1395,61.51%,36.27%,1
嘉義市,東區,0015,458,288,746,24,770,1453,52.99%,31.52%,1
嘉義市,東區,0016,383,193,576,17,593,1094,54.2%,35.01%,1
嘉義市,東區,0017,515,278,793,23,816,1420,57.46%,36.27%,1
嘉義市,東區,0018,553,328,881,34,915,1552,58.96%,35.63%,1
嘉義市,東區,0019,516,342,858,33,891,1558,57.19%,33.12%,1
嘉義市,東區,0020,386,229,615,18,633,1062,59.6%,36.35%,1
嘉義市,東區,0021,404,223,627,24,651,1199,54.3%,33.69%,1
嘉義市,東區,0022,463,210,673,24,697,1236,56.39%,37.46%,1
嘉義市,東區,0023,286,194,480,22,502,890,56.4%,32.13%,1
嘉義市,東區,0024,315,186,501,35,536,880,60.91%,35.8%,1
嘉義市,東區,0025,409,250,659,18,677,1189,56.94%,34.4%,1
嘉義市,東區,0026,221,158,379,17,396,669,59.19%,33.03%,1
嘉義市,東區,0027,473,292,765,26,791,1435,55.12%,32.96%,1
嘉義市,東區,0028,491,307,798,20,818,1349,60.64%,36.4%,1
嘉義市,東區,0029,454,301,755,18,773,1455,53.13%,31.2%,1
嘉義市,東區,0030,296,215,511,23,534,915,58.36%,32.35%,1
嘉義市,東區,0031,339,199,538,17,555,952,58.3%,35.61%,1
嘉義市,東區,0032,314,194,508,24,532,941,56.54%,33.37%,1
嘉義市,東區,0033,370,210,580,17,597,1080,55.28%,34.26%,1
嘉義市,東區,0034,372,217,589,26,615,1157,53.15%,32.15%,1
嘉義市,東區,0035,389,220,609,24,633,1053,60.11%,36.94%,1
嘉義市,東區,0036,270,208,478,22,500,967,51.71%,27.92%,1
嘉義市,東區,0037,328,240,568,22,590,1091,54.08%,30.06%,1
嘉義市,東區,0038,329,227,556,26,582,961,60.56%,34.24%,1
嘉義市,東區,0039,205,138,343,17,360,863,41.71%,23.75%,1
嘉義市,東區,0040,339,244,583,31,614,1023,60.02%,33.14%,1
嘉義市,東區,0041,382,226,608,40,648,1078,60.11%,35.44%,1
嘉義市,東區,0042,306,197,503,20,523,938,55.76%,32.62%,1
嘉義市,東區,0043,331,245,576,17,593,1049,56.53%,31.55%,1
嘉義市,東區,0044,437,242,679,38,717,1360,52.72%,32.13%,1
嘉義市,東區,0045,498,274,772,48,820,1615,50.77%,30.84%,1
嘉義市,東區,0046,400,251,651,30,681,1267,53.75%,31.57%,1
嘉義市,東區,0047,467,267,734,38,772,1579,48.89%,29.58%,1
嘉義市,東區,0048,538,359,897,46,943,1831,51.5%,29.38%,1
嘉義市,東區,0049,359,183,542,24,566,977,57.93%,36.75%,1
嘉義市,東區,0050,378,239,617,22,639,1169,54.66%,32.34%,1
嘉義市,東區,0051,495,201,696,48,744,1238,60.1%,39.98%,1
嘉義市,東區,0052,439,267,706,24,730,1266,57.66%,34.68%,1
嘉義市,東區,0053,460,205,665,28,693,1429,48.5%,32.19%,1
嘉義市,東區,0054,432,273,705,22,727,1288,56.44%,33.54%,1
嘉義市,東區,0055,302,212,514,29,543,980,55.41%,30.82%,1
嘉義市,東區,0056,303,161,464,21,485,922,52.6%,32.86%,1
嘉義市,東區,0057,388,237,625,33,658,1133,58.08%,34.25%,1
嘉義市,東區,0058,408,257,665,32,697,1235,56.44%,33.04%,1
嘉義市,東區,0059,506,309,815,16,831,1525,54.49%,33.18%,1
嘉義市,東區,0060,345,246,591,22,613,1170,52.39%,29.49%,1
嘉義市,東區,0061,412,296,708,33,741,1177,62.96%,35%,1
嘉義市,東區,0062,408,246,654,34,688,1207,57%,33.8%,1
嘉義市,東區,0063,434,264,698,26,724,1272,56.92%,34.12%,1
嘉義市,東區,0064,380,236,616,59,675,1188,56.82%,31.99%,1
嘉義市,東區,0065,344,236,580,18,598,1172,51.02%,29.35%,1
嘉義市,東區,0066,327,256,583,20,603,1020,59.12%,32.06%,1
嘉義市,東區,0067,452,284,736,30,766,1332,57.51%,33.93%,1
嘉義市,東區,0068,370,231,601,24,625,1011,61.82%,36.6%,1
嘉義市,東區,0069,553,299,852,33,885,1682,52.62%,32.88%,1
嘉義市,東區,0070,527,295,822,45,867,1567,55.33%,33.63%,1
嘉義市,東區,0071,439,239,678,13,691,1207,57.25%,36.37%,1
嘉義市,東區,0072,406,196,602,12,614,981,62.59%,41.39%,1
嘉義市,東區,0073,464,263,727,28,755,1395,54.12%,33.26%,1
嘉義市,東區,0074,413,266,679,25,704,1434,49.09%,28.8%,1
嘉義市,東區,0075,409,223,632,16,648,1404,46.15%,29.13%,1
嘉義市,東區,0076,520,283,803,21,824,1428,57.7%,36.41%,1
嘉義市,東區,0077,505,278,783,17,800,1823,43.88%,27.7%,1
嘉義市,東區,0078,452,304,756,29,785,1570,50%,28.79%,1
嘉義市,東區,0079,421,247,668,27,695,1282,54.21%,32.84%,1
嘉義市,東區,0080,566,330,896,33,929,1571,59.13%,36.03%,1
嘉義市,東區,0081,482,299,781,24,805,1533,52.51%,31.44%,1
嘉義市,西區,0082,292,192,484,12,496,885,56.05%,32.99%,1
嘉義市,西區,0083,358,213,571,34,605,1109,54.55%,32.28%,1
嘉義市,西區,0084,340,187,527,28,555,1020,54.41%,33.33%,1
嘉義市,西區,0085,360,188,548,34,582,925,62.92%,38.92%,1
嘉義市,西區,0086,479,310,789,22,811,1671,48.53%,28.67%,1
嘉義市,西區,0087,439,241,680,17,697,1215,57.37%,36.13%,1
嘉義市,西區,0088,362,211,573,18,591,1036,57.05%,34.94%,1
嘉義市,西區,0089,340,244,584,18,602,1129,53.32%,30.12%,1
嘉義市,西區,0090,370,221,591,28,619,1127,54.92%,32.83%,1
嘉義市,西區,0091,506,292,798,26,824,1415,58.23%,35.76%,1
嘉義市,西區,0092,458,239,697,26,723,1366,52.93%,33.53%,1
嘉義市,西區,0093,403,212,615,32,647,1053,61.44%,38.27%,1
嘉義市,西區,0094,417,185,602,16,618,1067,57.92%,39.08%,1
嘉義市,西區,0095,480,270,750,23,773,1575,49.08%,30.48%,1
嘉義市,西區,0096,603,353,956,28,984,1865,52.76%,32.33%,1
嘉義市,西區,0097,357,246,603,30,633,1196,52.93%,29.85%,1
嘉義市,西區,0098,374,260,634,25,659,1280,51.48%,29.22%,1
嘉義市,西區,0099,522,322,844,38,882,1629,54.14%,32.04%,1
嘉義市,西區,0100,410,309,719,52,771,1393,55.35%,29.43%,1
嘉義市,西區,0101,386,243,629,31,660,1077,61.28%,35.84%,1
嘉義市,西區,0102,461,329,790,12,802,1694,47.34%,27.21%,1
嘉義市,西區,0103,282,197,479,47,526,841,62.54%,33.53%,1
嘉義市,西區,0104,362,233,595,6,601,1183,50.8%,30.6%,1
嘉義市,西區,0105,381,232,613,19,632,1000,63.2%,38.1%,1
嘉義市,西區,0106,416,248,664,16,680,1095,62.1%,37.99%,1
嘉義市,西區,0107,444,294,738,29,767,1256,61.07%,35.35%,1
嘉義市,西區,0108,318,212,530,33,563,962,58.52%,33.06%,1
嘉義市,西區,0109,330,225,555,6,561,865,64.86%,38.15%,1
嘉義市,西區,0110,403,321,724,28,752,1396,53.87%,28.87%,1
嘉義市,西區,0111,573,378,951,39,990,1799,55.03%,31.85%,1
嘉義市,西區,0112,469,284,753,18,771,1505,51.23%,31.16%,1
嘉義市,西區,0113,571,312,883,37,920,1698,54.18%,33.63%,1
嘉義市,西區,0114,619,383,1002,34,1036,1854,55.88%,33.39%,1
嘉義市,西區,0115,412,275,687,10,697,1537,45.35%,26.81%,1
嘉義市,西區,0116,503,290,793,35,828,1604,51.62%,31.36%,1
嘉義市,西區,0117,348,214,562,42,604,944,63.98%,36.86%,1
嘉義市,西區,0118,599,294,893,47,940,1627,57.78%,36.82%,1
嘉義市,西區,0119,403,255,658,26,684,1144,59.79%,35.23%,1
嘉義市,西區,0120,457,255,712,40,752,1362,55.21%,33.55%,1
嘉義市,西區,0121,445,293,738,23,761,1279,59.5%,34.79%,1
嘉義市,西區,0122,554,357,911,39,950,1702,55.82%,32.55%,1
嘉義市,西區,0123,451,319,770,33,803,1358,59.13%,33.21%,1
嘉義市,西區,0124,474,310,784,48,832,1360,61.18%,34.85%,1
嘉義市,西區,0125,547,318,865,39,904,1589,56.89%,34.42%,1
嘉義市,西區,0126,474,274,748,25,773,1280,60.39%,37.03%,1
嘉義市,西區,0127,364,240,604,21,625,1220,51.23%,29.84%,1
嘉義市,西區,0128,444,233,677,18,695,1172,59.3%,37.88%,1
嘉義市,西區,0129,453,279,732,24,756,1320,57.27%,34.32%,1
嘉義市,西區,0130,483,264,747,31,778,1185,65.65%,40.76%,1
嘉義市,西區,0131,475,291,766,26,792,1278,61.97%,37.17%,1
嘉義市,西區,0132,360,250,610,22,632,1394,45.34%,25.82%,1
嘉義市,西區,0133,511,333,844,44,888,1540,57.66%,33.18%,1
嘉義市,西區,0134,540,302,842,33,875,1548,56.52%,34.88%,1
嘉義市,西區,0135,510,167,677,27,704,1295,54.36%,39.38%,1
嘉義市,西區,0136,478,283,761,38,799,1318,60.62%,36.27%,1
嘉義市,西區,0137,513,321,834,29,863,1545,55.86%,33.2%,1
嘉義市,西區,0138,249,134,383,13,396,736,53.8%,33.83%,1
嘉義市,西區,0139,387,226,613,13,626,1168,53.6%,33.13%,1
嘉義市,西區,0140,325,159,484,16,500,756,66.14%,42.99%,1
嘉義市,西區,0141,335,154,489,14,503,869,57.88%,38.55%,1
嘉義市,西區,0142,355,207,562,24,586,983,59.61%,36.11%,1
嘉義市,西區,0143,312,150,462,16,478,828,57.73%,37.68%,1
嘉義市,西區,0144,631,311,942,37,979,1775,55.15%,35.55%,1
嘉義市,西區,0145,504,234,738,28,766,1419,53.98%,35.52%,1
嘉義市,西區,0146,275,157,432,11,443,779,56.87%,35.3%,1
嘉義市,西區,0147,289,158,447,13,460,855,53.8%,33.8%,1
嘉義市,西區,0148,401,231,632,41,673,1146,58.73%,34.99%,1
嘉義市,西區,0149,395,225,620,32,652,1111,58.69%,35.55%,1
嘉義市,西區,0150,280,176,456,40,496,767,64.67%,36.51%,1
嘉義市,西區,0151,242,161,403,17,420,817,51.41%,29.62%,1
嘉義市,西區,0152,251,177,428,24,452,770,58.7%,32.6%,1
嘉義市,西區,0153,306,216,522,14,536,1135,47.22%,26.96%,1
嘉義市,西區,0154,245,166,411,44,455,835,54.49%,29.34%,1
嘉義市,西區,0155,373,212,585,25,610,1182,51.61%,31.56%,1
嘉義市,西區,0156,316,171,487,15,502,944,53.18%,33.47%,1
嘉義市,西區,0157,313,200,513,23,536,997,53.76%,31.39%,1
嘉義市,西區,0158,359,229,588,25,613,1074,57.08%,33.43%,1
嘉義市,西區,0159,368,281,649,17,666,1460,45.62%,25.21%,1
嘉義市,西區,0160,441,260,701,25,726,1352,53.7%,32.62%,1
嘉義市,西區,0161,471,313,784,31,815,1499,54.37%,31.42%,1
嘉義市,西區,0162,434,239,673,48,721,1262,57.13%,34.39%,1
嘉義市,西區,0163,429,262,691,22,713,1299,54.89%,33.03%,1
嘉義市,西區,0164,591,307,898,28,926,1734,53.4%,34.08%,1
嘉義市,西區,0165,531,286,817,21,838,1674,50.06%,31.72%,1
嘉義市,西區,0166,490,313,803,22,825,1540,53.57%,31.82%,1
嘉義市,西區,0167,389,240,629,13,642,1056,60.8%,36.84%,1
嘉義市,西區,0168,515,304,819,46,865,1467,58.96%,35.11%,1
嘉義市,西區,0169,450,263,713,36,749,1431,52.34%,31.45%,1
嘉義市,西區,0170,455,271,726,44,770,1234,62.4%,36.87%,1
嘉義市,西區,0171,386,286,672,19,691,1266,54.58%,30.49%,1
嘉義市,西區,0172,421,272,693,18,711,1211,58.71%,34.76%,1
嘉義市,西區,0173,381,250,631,15,646,1121,57.63%,33.99%,1
嘉義市,西區,0174,361,223,584,11,595,1155,51.52%,31.26%,1
嘉義市,西區,0175,511,337,848,75,923,1546,59.7%,33.05%,1
嘉義市,西區,0176,441,262,703,35,738,1322,55.82%,33.36%,1
嘉義市,西區,0177,524,309,833,55,888,1549,57.33%,33.83%,1
