縣市,鄉鎮市區,開票所,同意票,不同意票,有效票,無效票,投票數,投票權人數,投票率,投票權人數百分比,總數
臺北市,松山區,0527,400,527,927,35,962,1583,60.77%,25.27%,1
臺北市,松山區,0528,426,508,934,53,987,1691,58.37%,25.19%,1
臺北市,松山區,0529,289,470,759,35,794,1386,57.29%,20.85%,1
臺北市,松山區,0530,348,442,790,38,828,1362,60.79%,25.55%,1
臺北市,松山區,0531,340,477,817,29,846,1399,60.47%,24.3%,1
臺北市,松山區,0532,450,434,884,34,918,1324,69.34%,33.99%,1
臺北市,松山區,0533,359,430,789,39,828,1296,63.89%,27.7%,1
臺北市,松山區,0534,372,467,839,20,859,1386,61.98%,26.84%,1
臺北市,松山區,0535,403,530,933,38,971,1529,63.51%,26.36%,1
臺北市,松山區,0536,303,497,800,30,830,1416,58.62%,21.4%,1
臺北市,松山區,0537,344,540,884,31,915,1619,56.52%,21.25%,1
臺北市,松山區,0538,365,446,811,32,843,1386,60.82%,26.33%,1
臺北市,松山區,0539,371,507,878,24,902,1380,65.36%,26.88%,1
臺北市,松山區,0540,380,430,810,31,841,1357,61.97%,28%,1
臺北市,松山區,0541,340,453,793,29,822,1296,63.43%,26.23%,1
臺北市,松山區,0542,353,590,943,43,986,1632,60.42%,21.63%,1
臺北市,松山區,0543,354,450,804,29,833,1414,58.91%,25.04%,1
臺北市,松山區,0544,364,478,842,23,865,1404,61.61%,25.93%,1
臺北市,松山區,0545,357,457,814,45,859,1365,62.93%,26.15%,1
臺北市,松山區,0546,379,460,839,31,870,1431,60.8%,26.48%,1
臺北市,松山區,0547,388,486,874,36,910,1483,61.36%,26.16%,1
臺北市,松山區,0548,341,450,791,33,824,1293,63.73%,26.37%,1
臺北市,松山區,0549,295,498,793,24,817,1410,57.94%,20.92%,1
臺北市,松山區,0550,283,487,770,30,800,1307,61.21%,21.65%,1
臺北市,松山區,0551,356,409,765,31,796,1242,64.09%,28.66%,1
臺北市,松山區,0552,303,435,738,21,759,1192,63.67%,25.42%,1
臺北市,松山區,0553,329,447,776,35,811,1276,63.56%,25.78%,1
臺北市,松山區,0554,291,398,689,18,707,1201,58.87%,24.23%,1
臺北市,松山區,0555,303,473,776,25,801,1318,60.77%,22.99%,1
臺北市,松山區,0556,299,412,711,17,728,1157,62.92%,25.84%,1
臺北市,松山區,0557,278,388,666,9,675,1157,58.34%,24.03%,1
臺北市,松山區,0558,344,465,809,26,835,1357,61.53%,25.35%,1
臺北市,松山區,0559,292,354,646,32,678,1215,55.8%,24.03%,1
臺北市,松山區,0560,284,479,763,26,789,1345,58.66%,21.12%,1
臺北市,松山區,0561,317,413,730,23,753,1237,60.87%,25.63%,1
臺北市,松山區,0562,223,618,841,34,875,1393,62.81%,16.01%,1
臺北市,松山區,0563,386,433,819,43,862,1331,64.76%,29%,1
臺北市,松山區,0564,364,580,944,26,970,1550,62.58%,23.48%,1
臺北市,松山區,0565,145,573,718,29,747,1308,57.11%,11.09%,1
臺北市,松山區,0566,187,636,823,42,865,1490,58.05%,12.55%,1
臺北市,松山區,0567,302,561,863,30,893,1406,63.51%,21.48%,1
臺北市,松山區,0568,351,400,751,21,772,1191,64.82%,29.47%,1
臺北市,松山區,0569,292,367,659,17,676,1095,61.74%,26.67%,1
臺北市,松山區,0570,312,377,689,28,717,1198,59.85%,26.04%,1
臺北市,松山區,0571,333,389,722,29,751,1265,59.37%,26.32%,1
臺北市,松山區,0572,327,371,698,26,724,1225,59.1%,26.69%,1
臺北市,松山區,0573,401,612,1013,47,1060,1698,62.43%,23.62%,1
臺北市,松山區,0574,362,648,1010,41,1051,1819,57.78%,19.9%,1
臺北市,松山區,0575,475,558,1033,30,1063,1754,60.6%,27.08%,1
臺北市,松山區,0576,403,432,835,18,853,1361,62.67%,29.61%,1
臺北市,松山區,0577,308,426,734,18,752,1189,63.25%,25.9%,1
臺北市,松山區,0578,316,403,719,30,749,1214,61.7%,26.03%,1
臺北市,松山區,0579,335,413,748,28,776,1284,60.44%,26.09%,1
臺北市,松山區,0580,353,426,779,33,812,1297,62.61%,27.22%,1
臺北市,松山區,0581,363,405,768,21,789,1330,59.32%,27.29%,1
臺北市,松山區,0582,306,511,817,44,861,1396,61.68%,21.92%,1
臺北市,松山區,0583,298,550,848,19,867,1480,58.58%,20.14%,1
臺北市,松山區,0584,337,499,836,31,867,1419,61.1%,23.75%,1
臺北市,松山區,0585,364,450,814,36,850,1390,61.15%,26.19%,1
臺北市,松山區,0586,429,459,888,33,921,1525,60.39%,28.13%,1
臺北市,松山區,0587,432,463,895,32,927,1633,56.77%,26.45%,1
臺北市,松山區,0588,427,456,883,24,907,2677,33.88%,15.95%,1
臺北市,松山區,0589,368,383,751,32,783,1281,61.12%,28.73%,1
臺北市,松山區,0590,352,343,695,29,724,1469,49.29%,23.96%,1
臺北市,松山區,0591,436,484,920,50,970,1700,57.06%,25.65%,1
臺北市,松山區,0592,365,458,823,22,845,1503,56.22%,24.28%,1
臺北市,松山區,0593,323,412,735,38,773,1309,59.05%,24.68%,1
臺北市,松山區,0594,338,450,788,52,840,1376,61.05%,24.56%,1
臺北市,松山區,0595,409,532,941,38,979,1654,59.19%,24.73%,1
臺北市,松山區,0596,430,455,885,35,920,1601,57.46%,26.86%,1
臺北市,松山區,0597,259,601,860,27,887,1496,59.29%,17.31%,1
臺北市,松山區,0598,413,553,966,50,1016,1598,63.58%,25.84%,1
臺北市,松山區,0599,415,604,1019,45,1064,1751,60.77%,23.7%,1
臺北市,松山區,0600,258,678,936,38,974,1557,62.56%,16.57%,1
臺北市,松山區,0601,317,760,1077,42,1119,1686,66.37%,18.8%,1
臺北市,松山區,0602,193,810,1003,50,1053,1707,61.69%,11.31%,1
臺北市,松山區,0603,365,795,1160,36,1196,1854,64.51%,19.69%,1
臺北市,松山區,0604,335,610,945,35,980,1740,56.32%,19.25%,1
臺北市,松山區,0605,376,471,847,43,890,1494,59.57%,25.17%,1
臺北市,松山區,0606,330,518,848,33,881,1453,60.63%,22.71%,1
臺北市,松山區,0607,345,506,851,27,878,1458,60.22%,23.66%,1
臺北市,松山區,0608,365,498,863,37,900,1536,58.59%,23.76%,1
臺北市,松山區,0609,376,492,868,25,893,1463,61.04%,25.7%,1
臺北市,松山區,0610,416,513,929,22,951,1790,53.13%,23.24%,1
臺北市,松山區,0611,460,513,973,27,1000,1679,59.56%,27.4%,1
臺北市,松山區,0612,392,500,892,41,933,1785,52.27%,21.96%,1
臺北市,松山區,0613,438,506,944,32,976,1793,54.43%,24.43%,1
臺北市,松山區,0614,313,473,786,40,826,1381,59.81%,22.66%,1
臺北市,松山區,0615,298,447,745,30,775,1279,60.59%,23.3%,1
臺北市,松山區,0616,400,572,972,50,1022,1681,60.8%,23.8%,1
臺北市,松山區,0617,320,438,758,26,784,1232,63.64%,25.97%,1
臺北市,松山區,0618,385,482,867,26,893,1533,58.25%,25.11%,1
臺北市,松山區,0619,427,493,920,38,958,1540,62.21%,27.73%,1
臺北市,松山區,0620,427,527,954,35,989,1716,57.63%,24.88%,1
臺北市,松山區,0621,427,479,906,27,933,1664,56.07%,25.66%,1
臺北市,松山區,0622,330,432,762,19,781,1350,57.85%,24.44%,1
臺北市,松山區,0623,434,584,1018,35,1053,1837,57.32%,23.63%,1
臺北市,松山區,0624,356,446,802,54,856,1558,54.94%,22.85%,1
臺北市,松山區,0625,413,448,861,27,888,1420,62.54%,29.08%,1
臺北市,松山區,0626,372,462,834,27,861,1474,58.41%,25.24%,1
臺北市,松山區,0627,405,476,881,37,918,1591,57.7%,25.46%,1
臺北市,松山區,0628,391,594,985,34,1019,1726,59.04%,22.65%,1
臺北市,松山區,0629,352,468,820,31,851,1452,58.61%,24.24%,1
臺北市,松山區,0630,380,440,820,32,852,1482,57.49%,25.64%,1
臺北市,松山區,0631,369,492,861,23,884,1460,60.55%,25.27%,1
臺北市,松山區,0632,370,424,794,28,822,1398,58.8%,26.47%,1
臺北市,松山區,0633,351,498,849,29,878,1423,61.7%,24.67%,1
臺北市,松山區,0634,302,427,729,23,752,1226,61.34%,24.63%,1
臺北市,松山區,0635,256,415,671,32,703,1158,60.71%,22.11%,1
臺北市,松山區,0636,310,495,805,20,825,1426,57.85%,21.74%,1
臺北市,松山區,0637,256,463,719,21,740,1177,62.87%,21.75%,1
臺北市,松山區,0638,390,396,786,20,806,1363,59.13%,28.61%,1
臺北市,松山區,0639,343,397,740,34,774,1240,62.42%,27.66%,1
臺北市,松山區,0640,356,403,759,39,798,1375,58.04%,25.89%,1
臺北市,松山區,0641,368,441,809,25,834,1377,60.57%,26.72%,1
臺北市,松山區,0642,293,378,671,20,691,1225,56.41%,23.92%,1
臺北市,松山區,0643,282,344,626,27,653,1017,64.21%,27.73%,1
臺北市,信義區,0644,247,547,794,24,818,2476,33.04%,9.98%,1
臺北市,信義區,0645,257,602,859,21,880,1381,63.72%,18.61%,1
臺北市,信義區,0646,255,525,780,38,818,1294,63.21%,19.71%,1
臺北市,信義區,0647,312,463,775,23,798,1351,59.07%,23.09%,1
臺北市,信義區,0648,289,463,752,29,781,1296,60.26%,22.3%,1
臺北市,信義區,0649,304,487,791,28,819,1302,62.9%,23.35%,1
臺北市,信義區,0650,223,319,542,51,593,1025,57.85%,21.76%,1
臺北市,信義區,0651,306,459,765,22,787,1421,55.38%,21.53%,1
臺北市,信義區,0652,329,505,834,26,860,1501,57.3%,21.92%,1
臺北市,信義區,0653,330,484,814,25,839,1575,53.27%,20.95%,1
臺北市,信義區,0654,296,580,876,21,897,1516,59.17%,19.53%,1
臺北市,信義區,0655,317,499,816,30,846,1382,61.22%,22.94%,1
臺北市,信義區,0656,238,385,623,36,659,1128,58.42%,21.1%,1
臺北市,信義區,0657,346,420,766,37,803,1397,57.48%,24.77%,1
臺北市,信義區,0658,342,371,713,20,733,1161,63.14%,29.46%,1
臺北市,信義區,0659,345,444,789,24,813,1368,59.43%,25.22%,1
臺北市,信義區,0660,256,369,625,17,642,1049,61.2%,24.4%,1
臺北市,信義區,0661,310,443,753,32,785,1308,60.02%,23.7%,1
臺北市,信義區,0662,306,389,695,36,731,1154,63.34%,26.52%,1
臺北市,信義區,0663,300,352,652,20,672,1078,62.34%,27.83%,1
臺北市,信義區,0664,321,454,775,35,810,1375,58.91%,23.35%,1
臺北市,信義區,0665,336,511,847,27,874,1448,60.36%,23.2%,1
臺北市,信義區,0666,295,464,759,15,774,1250,61.92%,23.6%,1
臺北市,信義區,0667,360,454,814,16,830,1381,60.1%,26.07%,1
臺北市,信義區,0668,236,417,653,28,681,1213,56.14%,19.46%,1
臺北市,信義區,0669,390,472,862,22,884,1373,64.38%,28.4%,1
臺北市,信義區,0670,285,428,713,23,736,1226,60.03%,23.25%,1
臺北市,信義區,0671,269,399,668,18,686,1117,61.41%,24.08%,1
臺北市,信義區,0672,254,416,670,43,713,1123,63.49%,22.62%,1
臺北市,信義區,0673,277,423,700,28,728,1200,60.67%,23.08%,1
臺北市,信義區,0674,267,425,692,19,711,1335,53.26%,20%,1
臺北市,信義區,0675,273,442,715,23,738,1332,55.41%,20.5%,1
臺北市,信義區,0676,399,546,945,47,992,1648,60.19%,24.21%,1
臺北市,信義區,0677,376,481,857,43,900,1542,58.37%,24.38%,1
臺北市,信義區,0678,350,341,691,46,737,1228,60.02%,28.5%,1
臺北市,信義區,0679,404,569,973,33,1006,1731,58.12%,23.34%,1
臺北市,信義區,0680,390,430,820,30,850,1403,60.58%,27.8%,1
臺北市,信義區,0681,439,599,1038,37,1075,1929,55.73%,22.76%,1
臺北市,信義區,0682,355,418,773,29,802,1300,61.69%,27.31%,1
臺北市,信義區,0683,394,403,797,23,820,1486,55.18%,26.51%,1
臺北市,信義區,0684,391,370,761,34,795,1532,51.89%,25.52%,1
臺北市,信義區,0685,399,436,835,37,872,1387,62.87%,28.77%,1
臺北市,信義區,0686,324,320,644,19,663,1195,55.48%,27.11%,1
臺北市,信義區,0687,305,286,591,31,622,1068,58.24%,28.56%,1
臺北市,信義區,0688,367,325,692,28,720,1273,56.56%,28.83%,1
臺北市,信義區,0689,416,400,816,31,847,1329,63.73%,31.3%,1
臺北市,信義區,0690,353,384,737,21,758,1311,57.82%,26.93%,1
臺北市,信義區,0691,320,348,668,36,704,1258,55.96%,25.44%,1
臺北市,信義區,0692,366,365,731,43,774,1277,60.61%,28.66%,1
臺北市,信義區,0693,343,447,790,30,820,1285,63.81%,26.69%,1
臺北市,信義區,0694,351,374,725,26,751,1161,64.69%,30.23%,1
臺北市,信義區,0695,395,348,743,41,784,1299,60.35%,30.41%,1
臺北市,信義區,0696,279,413,692,18,710,1243,57.12%,22.45%,1
臺北市,信義區,0697,290,388,678,22,700,1197,58.48%,24.23%,1
臺北市,信義區,0698,351,408,759,28,787,1224,64.3%,28.68%,1
臺北市,信義區,0699,284,347,631,34,665,1147,57.98%,24.76%,1
臺北市,信義區,0700,281,344,625,24,649,1045,62.11%,26.89%,1
臺北市,信義區,0701,285,377,662,36,698,1096,63.69%,26%,1
臺北市,信義區,0702,302,344,646,17,663,1115,59.46%,27.09%,1
臺北市,信義區,0703,292,317,609,41,650,1117,58.19%,26.14%,1
臺北市,信義區,0704,206,311,517,22,539,1019,52.89%,20.22%,1
臺北市,信義區,0705,284,488,772,31,803,1346,59.66%,21.1%,1
臺北市,信義區,0706,286,493,779,27,806,1405,57.37%,20.36%,1
臺北市,信義區,0707,307,470,777,26,803,1356,59.22%,22.64%,1
臺北市,信義區,0708,327,468,795,17,812,1250,64.96%,26.16%,1
臺北市,信義區,0709,285,462,747,28,775,1254,61.8%,22.73%,1
臺北市,信義區,0710,331,432,763,18,781,1317,59.3%,25.13%,1
臺北市,信義區,0711,314,453,767,41,808,1271,63.57%,24.7%,1
臺北市,信義區,0712,244,308,552,19,571,979,58.32%,24.92%,1
臺北市,信義區,0713,249,308,557,18,575,1025,56.1%,24.29%,1
臺北市,信義區,0714,329,418,747,28,775,1512,51.26%,21.76%,1
臺北市,信義區,0715,361,511,872,28,900,1483,60.69%,24.34%,1
臺北市,信義區,0716,368,450,818,25,843,1359,62.03%,27.08%,1
臺北市,信義區,0717,339,489,828,27,855,1387,61.64%,24.44%,1
臺北市,信義區,0718,381,422,803,16,819,1455,56.29%,26.19%,1
臺北市,信義區,0719,379,460,839,23,862,1461,59%,25.94%,1
臺北市,信義區,0720,408,481,889,31,920,1532,60.05%,26.63%,1
臺北市,信義區,0721,298,348,646,33,679,1043,65.1%,28.57%,1
臺北市,信義區,0722,277,263,540,19,559,875,63.89%,31.66%,1
臺北市,信義區,0723,232,289,521,18,539,927,58.14%,25.03%,1
臺北市,信義區,0724,290,356,646,45,691,1119,61.75%,25.92%,1
臺北市,信義區,0725,402,430,832,35,867,1463,59.26%,27.48%,1
臺北市,信義區,0726,372,425,797,45,842,1293,65.12%,28.77%,1
臺北市,信義區,0727,379,483,862,29,891,1553,57.37%,24.4%,1
臺北市,信義區,0728,379,399,778,24,802,1360,58.97%,27.87%,1
臺北市,信義區,0729,331,471,802,28,830,1392,59.63%,23.78%,1
臺北市,信義區,0730,362,431,793,21,814,1377,59.11%,26.29%,1
臺北市,信義區,0731,355,461,816,20,836,1377,60.71%,25.78%,1
臺北市,信義區,0732,309,374,683,24,707,1269,55.71%,24.35%,1
臺北市,信義區,0733,350,444,794,56,850,1407,60.41%,24.88%,1
臺北市,信義區,0734,285,367,652,34,686,1172,58.53%,24.32%,1
臺北市,信義區,0735,299,391,690,19,709,1182,59.98%,25.3%,1
臺北市,信義區,0736,320,399,719,41,760,1255,60.56%,25.5%,1
臺北市,信義區,0737,524,371,895,22,917,1689,54.29%,31.02%,1
臺北市,信義區,0738,358,529,887,22,909,1605,56.64%,22.31%,1
臺北市,信義區,0739,181,445,626,24,650,1143,56.87%,15.84%,1
臺北市,信義區,0740,296,460,756,27,783,1440,54.38%,20.56%,1
臺北市,信義區,0741,295,533,828,38,866,1495,57.93%,19.73%,1
臺北市,信義區,0742,345,538,883,41,924,1514,61.03%,22.79%,1
臺北市,信義區,0743,314,468,782,39,821,1449,56.66%,21.67%,1
臺北市,信義區,0744,369,471,840,23,863,1401,61.6%,26.34%,1
臺北市,信義區,0745,280,365,645,20,665,1181,56.31%,23.71%,1
臺北市,信義區,0746,313,536,849,26,875,1376,63.59%,22.75%,1
臺北市,信義區,0747,316,528,844,31,875,1422,61.53%,22.22%,1
臺北市,信義區,0748,222,501,723,22,745,1267,58.8%,17.52%,1
臺北市,信義區,0749,289,370,659,17,676,1220,55.41%,23.69%,1
臺北市,信義區,0750,307,504,811,31,842,1562,53.91%,19.65%,1
臺北市,信義區,0751,320,487,807,24,831,1455,57.11%,21.99%,1
臺北市,信義區,0752,362,496,858,34,892,1605,55.58%,22.55%,1
臺北市,信義區,0753,334,641,975,26,1001,1626,61.56%,20.54%,1
臺北市,信義區,0754,350,562,912,30,942,1561,60.35%,22.42%,1
臺北市,信義區,0755,308,435,743,26,769,1547,49.71%,19.91%,1
臺北市,信義區,0756,284,473,757,18,775,1336,58.01%,21.26%,1
臺北市,信義區,0757,307,390,697,35,732,1314,55.71%,23.36%,1
臺北市,信義區,0758,275,422,697,36,733,1297,56.52%,21.2%,1
臺北市,信義區,0759,298,429,727,42,769,1366,56.3%,21.82%,1
臺北市,信義區,0760,343,465,808,31,839,1472,57%,23.3%,1
臺北市,信義區,0761,295,505,800,38,838,1450,57.79%,20.34%,1
臺北市,信義區,0762,343,408,751,29,780,1328,58.73%,25.83%,1
臺北市,信義區,0763,331,494,825,30,855,1399,61.12%,23.66%,1
臺北市,信義區,0764,468,341,809,41,850,1373,61.91%,34.09%,1
臺北市,信義區,0765,260,356,616,11,627,1099,57.05%,23.66%,1
臺北市,信義區,0766,317,359,676,30,706,1226,57.59%,25.86%,1
臺北市,信義區,0767,256,415,671,23,694,1267,54.78%,20.21%,1
臺北市,信義區,0768,338,538,876,35,911,1531,59.5%,22.08%,1
臺北市,信義區,0769,330,510,840,41,881,1438,61.27%,22.95%,1
臺北市,信義區,0770,354,546,900,31,931,1657,56.19%,21.36%,1
臺北市,信義區,0771,383,552,935,39,974,1621,60.09%,23.63%,1
臺北市,信義區,0772,400,511,911,17,928,1508,61.54%,26.53%,1
臺北市,信義區,0773,344,453,797,22,819,1334,61.39%,25.79%,1
臺北市,信義區,0774,250,330,580,27,607,1246,48.72%,20.06%,1
臺北市,信義區,0775,297,446,743,26,769,1196,64.3%,24.83%,1
臺北市,信義區,0776,268,460,728,12,740,1220,60.66%,21.97%,1
臺北市,信義區,0777,325,518,843,27,870,1538,56.57%,21.13%,1
臺北市,信義區,0778,370,542,912,43,955,1565,61.02%,23.64%,1
臺北市,信義區,0779,345,496,841,46,887,1621,54.72%,21.28%,1
臺北市,信義區,0780,314,485,799,50,849,1486,57.13%,21.13%,1
臺北市,信義區,0781,348,459,807,26,833,1507,55.28%,23.09%,1
臺北市,信義區,0782,361,502,863,42,905,1516,59.7%,23.81%,1
臺北市,信義區,0783,327,434,761,41,802,1287,62.32%,25.41%,1
臺北市,信義區,0784,209,314,523,42,565,1050,53.81%,19.9%,1
臺北市,信義區,0785,155,308,463,27,490,801,61.17%,19.35%,1
臺北市,大安區,1214,270,366,636,30,666,1184,56.25%,22.8%,1
臺北市,大安區,1215,261,377,638,25,663,1197,55.39%,21.8%,1
臺北市,大安區,1216,264,443,707,12,719,1221,58.89%,21.62%,1
臺北市,大安區,1217,240,481,721,29,750,1246,60.19%,19.26%,1
臺北市,大安區,1218,378,503,881,29,910,1478,61.57%,25.58%,1
臺北市,大安區,1219,341,393,734,29,763,1314,58.07%,25.95%,1
臺北市,大安區,1220,379,548,927,36,963,1594,60.41%,23.78%,1
臺北市,大安區,1221,319,498,817,42,859,1429,60.11%,22.32%,1
臺北市,大安區,1222,316,542,858,33,891,1452,61.36%,21.76%,1
臺北市,大安區,1223,356,532,888,19,907,1551,58.48%,22.95%,1
臺北市,大安區,1224,283,500,783,34,817,1335,61.2%,21.2%,1
臺北市,大安區,1225,305,358,663,18,681,1196,56.94%,25.5%,1
臺北市,大安區,1226,353,381,734,16,750,1339,56.01%,26.36%,1
臺北市,大安區,1227,429,420,849,18,867,1448,59.88%,29.63%,1
臺北市,大安區,1228,322,460,782,25,807,1373,58.78%,23.45%,1
臺北市,大安區,1229,354,457,811,38,849,1439,59%,24.6%,1
臺北市,大安區,1230,272,360,632,9,641,1174,54.6%,23.17%,1
臺北市,大安區,1231,283,329,612,9,621,1144,54.28%,24.74%,1
臺北市,大安區,1232,203,389,592,16,608,1119,54.33%,18.14%,1
臺北市,大安區,1233,207,279,486,22,508,1024,49.61%,20.21%,1
臺北市,大安區,1234,176,432,608,22,630,1032,61.05%,17.05%,1
臺北市,大安區,1235,185,581,766,26,792,1319,60.05%,14.03%,1
臺北市,大安區,1236,288,519,807,36,843,1369,61.58%,21.04%,1
臺北市,大安區,1237,378,402,780,22,802,1347,59.54%,28.06%,1
臺北市,大安區,1238,399,444,843,27,870,1655,52.57%,24.11%,1
臺北市,大安區,1239,421,371,792,25,817,1595,51.22%,26.39%,1
臺北市,大安區,1240,331,447,778,26,804,1429,56.26%,23.16%,1
臺北市,大安區,1241,302,399,701,22,723,1309,55.23%,23.07%,1
臺北市,大安區,1242,381,442,823,21,844,1508,55.97%,25.27%,1
臺北市,大安區,1243,327,388,715,29,744,1310,56.79%,24.96%,1
臺北市,大安區,1244,299,362,661,13,674,1233,54.66%,24.25%,1
臺北市,大安區,1245,285,379,664,29,693,1287,53.85%,22.14%,1
臺北市,大安區,1246,284,329,613,18,631,1147,55.01%,24.76%,1
臺北市,大安區,1247,256,403,659,23,682,1260,54.13%,20.32%,1
臺北市,大安區,1248,320,427,747,25,772,1377,56.06%,23.24%,1
臺北市,大安區,1249,305,383,688,32,720,1284,56.07%,23.75%,1
臺北市,大安區,1250,301,381,682,15,697,1314,53.04%,22.91%,1
臺北市,大安區,1251,289,383,672,16,688,1273,54.05%,22.7%,1
臺北市,大安區,1252,303,358,661,15,676,1146,58.99%,26.44%,1
臺北市,大安區,1253,327,418,745,28,773,1285,60.16%,25.45%,1
臺北市,大安區,1254,349,424,773,29,802,1297,61.84%,26.91%,1
臺北市,大安區,1255,227,443,670,35,705,1101,64.03%,20.62%,1
臺北市,大安區,1256,257,476,733,31,764,1310,58.32%,19.62%,1
臺北市,大安區,1257,366,447,813,30,843,1365,61.76%,26.81%,1
臺北市,大安區,1258,358,418,776,25,801,1372,58.38%,26.09%,1
臺北市,大安區,1259,326,399,725,16,741,1189,62.32%,27.42%,1
臺北市,大安區,1260,321,422,743,32,775,1256,61.7%,25.56%,1
臺北市,大安區,1261,307,386,693,15,708,1151,61.51%,26.67%,1
臺北市,大安區,1262,373,534,907,30,937,1501,62.43%,24.85%,1
臺北市,大安區,1263,360,540,900,29,929,1520,61.12%,23.68%,1
臺北市,大安區,1264,402,519,921,37,958,1529,62.66%,26.29%,1
臺北市,大安區,1265,418,526,944,26,970,1579,61.43%,26.47%,1
臺北市,大安區,1266,277,362,639,30,669,2619,25.54%,10.58%,1
臺北市,大安區,1267,350,394,744,17,761,1290,58.99%,27.13%,1
臺北市,大安區,1268,371,449,820,14,834,1307,63.81%,28.39%,1
臺北市,大安區,1269,332,545,877,23,900,1489,60.44%,22.3%,1
臺北市,大安區,1270,261,402,663,21,684,1097,62.35%,23.79%,1
臺北市,大安區,1271,314,449,763,19,782,1328,58.89%,23.64%,1
臺北市,大安區,1272,295,378,673,15,688,1189,57.86%,24.81%,1
臺北市,大安區,1273,351,395,746,21,767,1270,60.39%,27.64%,1
臺北市,大安區,1274,334,427,761,22,783,1349,58.04%,24.76%,1
臺北市,大安區,1275,297,415,712,23,735,1292,56.89%,22.99%,1
臺北市,大安區,1276,315,475,790,29,819,1314,62.33%,23.97%,1
臺北市,大安區,1277,313,392,705,21,726,1200,60.5%,26.08%,1
臺北市,大安區,1278,363,501,864,43,907,1558,58.22%,23.3%,1
臺北市,大安區,1279,356,515,871,32,903,1561,57.85%,22.81%,1
臺北市,大安區,1280,323,519,842,25,867,1446,59.96%,22.34%,1
臺北市,大安區,1281,378,499,877,27,904,1499,60.31%,25.22%,1
臺北市,大安區,1282,320,523,843,26,869,1467,59.24%,21.81%,1
臺北市,大安區,1283,325,495,820,29,849,1511,56.19%,21.51%,1
臺北市,大安區,1284,354,575,929,40,969,1600,60.56%,22.13%,1
臺北市,大安區,1285,379,537,916,26,942,1573,59.89%,24.09%,1
臺北市,大安區,1286,354,538,892,21,913,1467,62.24%,24.13%,1
臺北市,大安區,1287,284,483,767,35,802,1358,59.06%,20.91%,1
臺北市,大安區,1288,351,525,876,33,909,1568,57.97%,22.39%,1
臺北市,大安區,1289,327,494,821,30,851,1411,60.31%,23.18%,1
臺北市,大安區,1290,338,521,859,22,881,1554,56.69%,21.75%,1
臺北市,大安區,1291,297,512,809,27,836,1345,62.16%,22.08%,1
臺北市,大安區,1292,271,550,821,23,844,1435,58.82%,18.89%,1
臺北市,大安區,1293,270,629,899,29,928,1481,62.66%,18.23%,1
臺北市,大安區,1294,275,625,900,22,922,1451,63.54%,18.95%,1
臺北市,大安區,1295,384,523,907,34,941,1566,60.09%,24.52%,1
臺北市,大安區,1296,359,517,876,31,907,1525,59.48%,23.54%,1
臺北市,大安區,1297,301,447,748,31,779,1336,58.31%,22.53%,1
臺北市,大安區,1298,351,515,866,38,904,1483,60.96%,23.67%,1
臺北市,大安區,1299,275,461,736,21,757,1396,54.23%,19.7%,1
臺北市,大安區,1300,366,519,885,38,923,1406,65.65%,26.03%,1
臺北市,大安區,1301,327,497,824,37,861,1434,60.04%,22.8%,1
臺北市,大安區,1302,277,467,744,16,760,1288,59.01%,21.51%,1
臺北市,大安區,1303,302,515,817,22,839,1407,59.63%,21.46%,1
臺北市,大安區,1304,350,470,820,24,844,1514,55.75%,23.12%,1
臺北市,大安區,1305,278,462,740,40,780,1550,50.32%,17.94%,1
臺北市,大安區,1306,319,544,863,36,899,1490,60.34%,21.41%,1
臺北市,大安區,1307,288,416,704,23,727,1284,56.62%,22.43%,1
臺北市,大安區,1308,254,404,658,23,681,1129,60.32%,22.5%,1
臺北市,大安區,1309,276,414,690,25,715,1193,59.93%,23.13%,1
臺北市,大安區,1310,206,373,579,24,603,1057,57.05%,19.49%,1
臺北市,大安區,1311,367,398,765,29,794,1361,58.34%,26.97%,1
臺北市,大安區,1312,328,435,763,41,804,1412,56.94%,23.23%,1
臺北市,大安區,1313,335,326,661,23,684,1423,48.07%,23.54%,1
臺北市,大安區,1314,339,361,700,38,738,1257,58.71%,26.97%,1
臺北市,大安區,1315,252,425,677,28,705,1133,62.22%,22.24%,1
臺北市,大安區,1316,302,311,613,27,640,1077,59.42%,28.04%,1
臺北市,大安區,1317,332,428,760,26,786,1300,60.46%,25.54%,1
臺北市,大安區,1318,295,460,755,50,805,1319,61.03%,22.37%,1
臺北市,大安區,1319,318,404,722,42,764,1265,60.4%,25.14%,1
臺北市,大安區,1320,290,389,679,26,705,1265,55.73%,22.92%,1
臺北市,大安區,1321,274,390,664,25,689,1103,62.47%,24.84%,1
臺北市,大安區,1322,270,521,791,26,817,1341,60.92%,20.13%,1
臺北市,大安區,1323,289,521,810,15,825,1357,60.8%,21.3%,1
臺北市,大安區,1324,302,419,721,24,745,1260,59.13%,23.97%,1
臺北市,大安區,1325,281,478,759,21,780,1295,60.23%,21.7%,1
臺北市,大安區,1326,306,446,752,19,771,1399,55.11%,21.87%,1
臺北市,大安區,1327,267,375,642,25,667,1150,58%,23.22%,1
臺北市,大安區,1328,271,422,693,24,717,1351,53.07%,20.06%,1
臺北市,大安區,1329,318,445,763,36,799,1341,59.58%,23.71%,1
臺北市,大安區,1330,214,398,612,18,630,1129,55.8%,18.95%,1
臺北市,大安區,1331,284,463,747,18,765,1328,57.61%,21.39%,1
臺北市,大安區,1332,242,715,957,29,986,1557,63.33%,15.54%,1
臺北市,大安區,1333,283,598,881,36,917,1461,62.77%,19.37%,1
臺北市,大安區,1334,247,550,797,27,824,1589,51.86%,15.54%,1
臺北市,大安區,1335,223,581,804,30,834,1473,56.62%,15.14%,1
臺北市,大安區,1336,509,304,813,33,846,1479,57.2%,34.42%,1
臺北市,大安區,1337,197,310,507,18,525,833,63.03%,23.65%,1
臺北市,大安區,1338,227,326,553,28,581,999,58.16%,22.72%,1
臺北市,大安區,1339,400,617,1017,30,1047,1757,59.59%,22.77%,1
臺北市,大安區,1340,343,575,918,27,945,1573,60.08%,21.81%,1
臺北市,大安區,1341,368,577,945,43,988,1587,62.26%,23.19%,1
臺北市,大安區,1342,369,503,872,40,912,1496,60.96%,24.67%,1
臺北市,大安區,1343,353,486,839,29,868,1440,60.28%,24.51%,1
臺北市,大安區,1344,381,541,922,38,960,1578,60.84%,24.14%,1
臺北市,大安區,1345,331,383,714,28,742,1223,60.67%,27.06%,1
臺北市,大安區,1346,293,364,657,17,674,1119,60.23%,26.18%,1
臺北市,大安區,1347,297,458,755,23,778,1252,62.14%,23.72%,1
臺北市,大安區,1348,388,531,919,28,947,1576,60.09%,24.62%,1
臺北市,大安區,1349,356,451,807,26,833,1425,58.46%,24.98%,1
臺北市,大安區,1350,324,450,774,26,800,1450,55.17%,22.34%,1
臺北市,大安區,1351,307,493,800,24,824,1444,57.06%,21.26%,1
臺北市,大安區,1352,367,465,832,24,856,1337,64.02%,27.45%,1
臺北市,大安區,1353,335,438,773,22,795,1417,56.1%,23.64%,1
臺北市,大安區,1354,295,409,704,37,741,1250,59.28%,23.6%,1
臺北市,大安區,1355,266,383,649,37,686,1176,58.33%,22.62%,1
臺北市,大安區,1356,293,454,747,36,783,1257,62.29%,23.31%,1
臺北市,大安區,1357,294,431,725,27,752,1257,59.82%,23.39%,1
臺北市,大安區,1358,298,380,678,25,703,1148,61.24%,25.96%,1
臺北市,大安區,1359,354,449,803,31,834,1418,58.82%,24.96%,1
臺北市,大安區,1360,247,336,583,21,604,1028,58.75%,24.03%,1
臺北市,大安區,1361,388,466,854,24,878,1445,60.76%,26.85%,1
臺北市,大安區,1362,283,489,772,40,812,1361,59.66%,20.79%,1
臺北市,大安區,1363,426,371,797,33,830,1343,61.8%,31.72%,1
臺北市,大安區,1364,319,409,728,35,763,1267,60.22%,25.18%,1
臺北市,大安區,1365,291,444,735,25,760,1380,55.07%,21.09%,1
臺北市,大安區,1366,335,503,838,36,874,1524,57.35%,21.98%,1
臺北市,大安區,1367,322,532,854,32,886,1470,60.27%,21.9%,1
臺北市,大安區,1368,241,441,682,39,721,1318,54.7%,18.29%,1
臺北市,大安區,1369,319,424,743,30,773,1430,54.06%,22.31%,1
臺北市,大安區,1370,314,458,772,33,805,1386,58.08%,22.66%,1
臺北市,大安區,1371,289,471,760,15,775,1438,53.89%,20.1%,1
臺北市,大安區,1372,260,400,660,15,675,1270,53.15%,20.47%,1
臺北市,大安區,1373,317,440,757,26,783,1395,56.13%,22.72%,1
臺北市,大安區,1374,267,450,717,34,751,1292,58.13%,20.67%,1
臺北市,大安區,1375,300,411,711,20,731,1310,55.8%,22.9%,1
臺北市,大安區,1376,328,407,735,20,755,1319,57.24%,24.87%,1
臺北市,大安區,1377,359,431,790,21,811,1355,59.85%,26.49%,1
臺北市,大安區,1378,283,412,695,17,712,1312,54.27%,21.57%,1
臺北市,大安區,1379,323,431,754,17,771,1335,57.75%,24.19%,1
臺北市,大安區,1380,284,488,772,23,795,1489,53.39%,19.07%,1
臺北市,大安區,1381,286,470,756,24,780,1307,59.68%,21.88%,1
臺北市,大安區,1382,276,417,693,19,712,1328,53.61%,20.78%,1
臺北市,大安區,1383,285,426,711,7,718,1277,56.23%,22.32%,1
臺北市,大安區,1384,301,432,733,30,763,1314,58.07%,22.91%,1
臺北市,大安區,1385,332,418,750,25,775,1270,61.02%,26.14%,1
臺北市,大安區,1386,317,421,738,26,764,1308,58.41%,24.24%,1
臺北市,大安區,1387,276,393,669,18,687,1138,60.37%,24.25%,1
臺北市,大安區,1388,273,449,722,24,746,1333,55.96%,20.48%,1
臺北市,大安區,1389,285,390,675,25,700,1176,59.52%,24.23%,1
臺北市,大安區,1390,323,386,709,34,743,1311,56.67%,24.64%,1
臺北市,大安區,1391,277,422,699,29,728,1295,56.22%,21.39%,1
臺北市,大安區,1392,310,501,811,29,840,1421,59.11%,21.82%,1
臺北市,大安區,1393,328,441,769,26,795,1409,56.42%,23.28%,1
臺北市,大安區,1394,307,517,824,22,846,1434,59%,21.41%,1
臺北市,大安區,1395,337,417,754,28,782,1449,53.97%,23.26%,1
臺北市,大安區,1396,337,407,744,17,761,1284,59.27%,26.25%,1
臺北市,大安區,1397,276,433,709,17,726,1248,58.17%,22.12%,1
臺北市,大安區,1398,304,412,716,23,739,1119,66.04%,27.17%,1
臺北市,大安區,1399,175,332,507,29,536,883,60.7%,19.82%,1
臺北市,大安區,1400,137,206,343,27,370,630,58.73%,21.75%,1
臺北市,大安區,1401,201,266,467,22,489,814,60.07%,24.69%,1
臺北市,中山區,0786,380,470,850,33,883,1522,58.02%,24.97%,1
臺北市,中山區,0787,372,373,745,19,764,1332,57.36%,27.93%,1
臺北市,中山區,0788,368,441,809,31,840,1656,50.72%,22.22%,1
臺北市,中山區,0789,305,355,660,52,712,1367,52.08%,22.31%,1
臺北市,中山區,0790,416,456,872,25,897,1732,51.79%,24.02%,1
臺北市,中山區,0791,417,484,901,38,939,1634,57.47%,25.52%,1
臺北市,中山區,0792,398,471,869,33,902,1650,54.67%,24.12%,1
臺北市,中山區,0793,426,394,820,18,838,1392,60.2%,30.6%,1
臺北市,中山區,0794,372,341,713,18,731,1177,62.11%,31.61%,1
臺北市,中山區,0795,437,425,862,38,900,1477,60.93%,29.59%,1
臺北市,中山區,0796,267,282,549,32,581,1063,54.66%,25.12%,1
臺北市,中山區,0797,315,377,692,27,719,1296,55.48%,24.31%,1
臺北市,中山區,0798,333,361,694,25,719,1330,54.06%,25.04%,1
臺北市,中山區,0799,420,361,781,30,811,1483,54.69%,28.32%,1
臺北市,中山區,0800,373,437,810,25,835,1542,54.15%,24.19%,1
臺北市,中山區,0801,442,402,844,35,879,1710,51.4%,25.85%,1
臺北市,中山區,0802,303,355,658,25,683,1315,51.94%,23.04%,1
臺北市,中山區,0803,320,339,659,37,696,1245,55.9%,25.7%,1
臺北市,中山區,0804,288,374,662,23,685,1262,54.28%,22.82%,1
臺北市,中山區,0805,482,387,869,33,902,1518,59.42%,31.75%,1
臺北市,中山區,0806,411,437,848,40,888,1522,58.34%,27%,1
臺北市,中山區,0807,407,392,799,39,838,1580,53.04%,25.76%,1
臺北市,中山區,0808,401,443,844,25,869,1529,56.83%,26.23%,1
臺北市,中山區,0809,305,362,667,31,698,1221,57.17%,24.98%,1
臺北市,中山區,0810,358,347,705,26,731,1221,59.87%,29.32%,1
臺北市,中山區,0811,284,287,571,17,588,1139,51.62%,24.93%,1
臺北市,中山區,0812,394,378,772,40,812,1407,57.71%,28%,1
臺北市,中山區,0813,353,384,737,26,763,1321,57.76%,26.72%,1
臺北市,中山區,0814,322,425,747,32,779,1578,49.37%,20.41%,1
臺北市,中山區,0815,385,489,874,36,910,1739,52.33%,22.14%,1
臺北市,中山區,0816,362,459,821,36,857,1637,52.35%,22.11%,1
臺北市,中山區,0817,393,413,806,38,844,1541,54.77%,25.5%,1
臺北市,中山區,0818,343,342,685,34,719,1210,59.42%,28.35%,1
臺北市,中山區,0819,363,357,720,28,748,1331,56.2%,27.27%,1
臺北市,中山區,0820,242,390,632,31,663,1224,54.17%,19.77%,1
臺北市,中山區,0821,392,493,885,35,920,1585,58.04%,24.73%,1
臺北市,中山區,0822,467,443,910,40,950,1523,62.38%,30.66%,1
臺北市,中山區,0823,406,407,813,35,848,1368,61.99%,29.68%,1
臺北市,中山區,0824,172,820,992,42,1034,1805,57.29%,9.53%,1
臺北市,中山區,0825,194,607,801,32,833,1404,59.33%,13.82%,1
臺北市,中山區,0826,462,582,1044,30,1074,1708,62.88%,27.05%,1
臺北市,中山區,0827,353,527,880,39,919,1451,63.34%,24.33%,1
臺北市,中山區,0828,452,548,1000,43,1043,1684,61.94%,26.84%,1
臺北市,中山區,0829,346,562,908,21,929,1585,58.61%,21.83%,1
臺北市,中山區,0830,375,431,806,38,844,1391,60.68%,26.96%,1
臺北市,中山區,0831,399,477,876,43,919,1375,66.84%,29.02%,1
臺北市,中山區,0832,389,486,875,20,895,1472,60.8%,26.43%,1
臺北市,中山區,0833,294,424,718,22,740,1327,55.76%,22.16%,1
臺北市,中山區,0834,292,500,792,28,820,1401,58.53%,20.84%,1
臺北市,中山區,0835,344,464,808,42,850,1423,59.73%,24.17%,1
臺北市,中山區,0836,379,534,913,26,939,1569,59.85%,24.16%,1
臺北市,中山區,0837,393,560,953,24,977,1651,59.18%,23.8%,1
臺北市,中山區,0838,423,479,902,24,926,1624,57.02%,26.05%,1
臺北市,中山區,0839,458,558,1016,43,1059,1713,61.82%,26.74%,1
臺北市,中山區,0840,403,543,946,42,988,1647,59.99%,24.47%,1
臺北市,中山區,0841,384,551,935,23,958,1762,54.37%,21.79%,1
臺北市,中山區,0842,321,513,834,34,868,1399,62.04%,22.94%,1
臺北市,中山區,0843,407,491,898,34,932,1489,62.59%,27.33%,1
臺北市,中山區,0844,289,479,768,26,794,1269,62.57%,22.77%,1
臺北市,中山區,0845,240,368,608,23,631,998,63.23%,24.05%,1
臺北市,中山區,0846,426,384,810,33,843,1472,57.27%,28.94%,1
臺北市,中山區,0847,419,376,795,41,836,1517,55.11%,27.62%,1
臺北市,中山區,0848,441,527,968,41,1009,1704,59.21%,25.88%,1
臺北市,中山區,0849,508,423,931,38,969,1603,60.45%,31.69%,1
臺北市,中山區,0850,375,376,751,48,799,1432,55.8%,26.19%,1
臺北市,中山區,0851,458,392,850,43,893,1500,59.53%,30.53%,1
臺北市,中山區,0852,412,392,804,34,838,1332,62.91%,30.93%,1
臺北市,中山區,0853,420,450,870,26,896,1450,61.79%,28.97%,1
臺北市,中山區,0854,410,440,850,35,885,1434,61.72%,28.59%,1
臺北市,中山區,0855,363,426,789,26,815,1419,57.43%,25.58%,1
臺北市,中山區,0856,359,352,711,28,739,1292,57.2%,27.79%,1
臺北市,中山區,0857,427,399,826,31,857,1526,56.16%,27.98%,1
臺北市,中山區,0858,400,369,769,28,797,1582,50.38%,25.28%,1
臺北市,中山區,0859,432,394,826,27,853,1588,53.72%,27.2%,1
臺北市,中山區,0860,403,415,818,33,851,1463,58.17%,27.55%,1
臺北市,中山區,0861,403,383,786,38,824,1533,53.75%,26.29%,1
臺北市,中山區,0862,275,248,523,30,553,944,58.58%,29.13%,1
臺北市,中山區,0863,545,528,1073,31,1104,1745,63.27%,31.23%,1
臺北市,中山區,0864,416,410,826,31,857,1679,51.04%,24.78%,1
臺北市,中山區,0865,352,445,797,45,842,3419,24.63%,10.3%,1
臺北市,中山區,0866,407,410,817,30,847,1387,61.07%,29.34%,1
臺北市,中山區,0867,492,467,959,41,1000,1672,59.81%,29.43%,1
臺北市,中山區,0868,359,373,732,49,781,1319,59.21%,27.22%,1
臺北市,中山區,0869,387,365,752,29,781,1364,57.26%,28.37%,1
臺北市,中山區,0870,408,364,772,47,819,1461,56.06%,27.93%,1
臺北市,中山區,0871,361,319,680,31,711,1173,60.61%,30.78%,1
臺北市,中山區,0872,301,324,625,33,658,1171,56.19%,25.7%,1
臺北市,中山區,0873,381,343,724,36,760,1310,58.02%,29.08%,1
臺北市,中山區,0874,378,489,867,29,896,1373,65.26%,27.53%,1
臺北市,中山區,0875,358,422,780,26,806,1290,62.48%,27.75%,1
臺北市,中山區,0876,388,411,799,33,832,1346,61.81%,28.83%,1
臺北市,中山區,0877,429,446,875,27,902,1468,61.44%,29.22%,1
臺北市,中山區,0878,336,358,694,21,715,1178,60.7%,28.52%,1
臺北市,中山區,0879,436,520,956,35,991,1654,59.92%,26.36%,1
臺北市,中山區,0880,363,468,831,33,864,1464,59.02%,24.8%,1
臺北市,中山區,0881,417,382,799,26,825,1450,56.9%,28.76%,1
臺北市,中山區,0882,403,442,845,41,886,1534,57.76%,26.27%,1
臺北市,中山區,0883,482,394,876,29,905,1703,53.14%,28.3%,1
臺北市,中山區,0884,483,447,930,39,969,1610,60.19%,30%,1
臺北市,中山區,0885,437,457,894,32,926,1653,56.02%,26.44%,1
臺北市,中山區,0886,494,511,1005,38,1043,1694,61.57%,29.16%,1
臺北市,中山區,0887,467,431,898,25,923,1623,56.87%,28.77%,1
臺北市,中山區,0888,503,419,922,32,954,1618,58.96%,31.09%,1
臺北市,中山區,0889,318,567,885,28,913,1583,57.68%,20.09%,1
臺北市,中山區,0890,483,474,957,29,986,1605,61.43%,30.09%,1
臺北市,中山區,0891,428,440,868,35,903,1398,64.59%,30.62%,1
臺北市,中山區,0892,471,481,952,38,990,1526,64.88%,30.87%,1
臺北市,中山區,0893,420,461,881,30,911,1555,58.59%,27.01%,1
臺北市,中山區,0894,403,472,875,28,903,1597,56.54%,25.23%,1
臺北市,中山區,0895,455,437,892,52,944,1587,59.48%,28.67%,1
臺北市,中山區,0896,397,532,929,31,960,1587,60.49%,25.02%,1
臺北市,中山區,0897,472,443,915,36,951,1546,61.51%,30.53%,1
臺北市,中山區,0898,312,423,735,34,769,1322,58.17%,23.6%,1
臺北市,中山區,0899,300,416,716,31,747,1267,58.96%,23.68%,1
臺北市,中山區,0900,315,365,680,23,703,1210,58.1%,26.03%,1
臺北市,中山區,0901,314,411,725,29,754,1295,58.22%,24.25%,1
臺北市,中山區,0902,300,533,833,41,874,1467,59.58%,20.45%,1
臺北市,中山區,0903,263,667,930,41,971,1491,65.12%,17.64%,1
臺北市,中山區,0904,297,641,938,47,985,1516,64.97%,19.59%,1
臺北市,中山區,0905,370,368,738,26,764,1384,55.2%,26.73%,1
臺北市,中山區,0906,350,355,705,26,731,1138,64.24%,30.76%,1
臺北市,中山區,0907,393,413,806,26,832,1513,54.99%,25.97%,1
臺北市,中山區,0908,388,502,890,48,938,1559,60.17%,24.89%,1
臺北市,中山區,0909,411,453,864,33,897,1429,62.77%,28.76%,1
臺北市,中山區,0910,337,401,738,35,773,1245,62.09%,27.07%,1
臺北市,中山區,0911,341,396,737,35,772,1214,63.59%,28.09%,1
臺北市,中山區,0912,403,410,813,22,835,1394,59.9%,28.91%,1
臺北市,中山區,0913,347,374,721,16,737,1336,55.16%,25.97%,1
臺北市,中山區,0914,318,358,676,32,708,1227,57.7%,25.92%,1
臺北市,中山區,0915,362,427,789,32,821,1382,59.41%,26.19%,1
臺北市,中山區,0916,336,458,794,36,830,1436,57.8%,23.4%,1
臺北市,中山區,0917,348,375,723,21,744,1405,52.95%,24.77%,1
臺北市,中山區,0918,267,447,714,22,736,1259,58.46%,21.21%,1
臺北市,中正區,1001,329,436,765,28,793,1308,60.63%,25.15%,1
臺北市,中正區,1002,336,366,702,44,746,1317,56.64%,25.51%,1
臺北市,中正區,1003,218,417,635,28,663,1069,62.02%,20.39%,1
臺北市,中正區,1004,251,356,607,31,638,1128,56.56%,22.25%,1
臺北市,中正區,1005,277,345,622,33,655,1053,62.2%,26.31%,1
臺北市,中正區,1006,271,344,615,10,625,1048,59.64%,25.86%,1
臺北市,中正區,1007,251,451,702,41,743,1297,57.29%,19.35%,1
臺北市,中正區,1008,285,417,702,19,721,1193,60.44%,23.89%,1
臺北市,中正區,1009,381,565,946,28,974,1500,64.93%,25.4%,1
臺北市,中正區,1010,293,443,736,30,766,1346,56.91%,21.77%,1
臺北市,中正區,1011,302,432,734,12,746,1283,58.14%,23.54%,1
臺北市,中正區,1012,345,461,806,27,833,1450,57.45%,23.79%,1
臺北市,中正區,1013,335,479,814,33,847,1433,59.11%,23.38%,1
臺北市,中正區,1014,393,446,839,27,866,1309,66.16%,30.02%,1
臺北市,中正區,1015,345,479,824,18,842,1386,60.75%,24.89%,1
臺北市,中正區,1016,315,389,704,27,731,1201,60.87%,26.23%,1
臺北市,中正區,1017,312,495,807,24,831,1336,62.2%,23.35%,1
臺北市,中正區,1018,368,450,818,31,849,1358,62.52%,27.1%,1
臺北市,中正區,1019,407,292,699,28,727,1177,61.77%,34.58%,1
臺北市,中正區,1020,319,455,774,27,801,1236,64.81%,25.81%,1
臺北市,中正區,1021,368,467,835,38,873,1478,59.07%,24.9%,1
臺北市,中正區,1022,337,525,862,26,888,1474,60.24%,22.86%,1
臺北市,中正區,1023,262,403,665,29,694,1172,59.22%,22.35%,1
臺北市,中正區,1024,308,433,741,39,780,1310,59.54%,23.51%,1
臺北市,中正區,1025,280,453,733,33,766,1263,60.65%,22.17%,1
臺北市,中正區,1026,302,377,679,26,705,1169,60.31%,25.83%,1
臺北市,中正區,1027,310,480,790,19,809,1391,58.16%,22.29%,1
臺北市,中正區,1028,316,372,688,19,707,1201,58.87%,26.31%,1
臺北市,中正區,1029,321,441,762,27,789,1324,59.59%,24.24%,1
臺北市,中正區,1030,318,362,680,32,712,1216,58.55%,26.15%,1
臺北市,中正區,1031,320,345,665,27,692,1183,58.5%,27.05%,1
臺北市,中正區,1032,403,454,857,41,898,1469,61.13%,27.43%,1
臺北市,中正區,1033,366,431,797,32,829,1411,58.75%,25.94%,1
臺北市,中正區,1034,346,438,784,65,849,1398,60.73%,24.75%,1
臺北市,中正區,1035,338,460,798,52,850,1479,57.47%,22.85%,1
臺北市,中正區,1036,371,509,880,38,918,1620,56.67%,22.9%,1
臺北市,中正區,1037,268,327,595,19,614,1041,58.98%,25.74%,1
臺北市,中正區,1038,286,316,602,17,619,1056,58.62%,27.08%,1
臺北市,中正區,1039,304,367,671,23,694,1063,65.29%,28.6%,1
臺北市,中正區,1040,290,419,709,38,747,1591,46.95%,18.23%,1
臺北市,中正區,1041,269,406,675,43,718,1502,47.8%,17.91%,1
臺北市,中正區,1042,276,403,679,41,720,1331,54.09%,20.74%,1
臺北市,中正區,1043,356,425,781,43,824,1441,57.18%,24.71%,1
臺北市,中正區,1044,328,431,759,32,791,1273,62.14%,25.77%,1
臺北市,中正區,1045,312,365,677,29,706,1133,62.31%,27.54%,1
臺北市,中正區,1046,285,384,669,33,702,1156,60.73%,24.65%,1
臺北市,中正區,1047,254,426,680,39,719,1377,52.21%,18.45%,1
臺北市,中正區,1048,241,518,759,34,793,1266,62.64%,19.04%,1
臺北市,中正區,1049,257,431,688,30,718,1111,64.63%,23.13%,1
臺北市,中正區,1050,281,378,659,13,672,1124,59.79%,25%,1
臺北市,中正區,1051,343,478,821,27,848,1373,61.76%,24.98%,1
臺北市,中正區,1052,318,503,821,20,841,1351,62.25%,23.54%,1
臺北市,中正區,1053,349,523,872,22,894,1495,59.8%,23.34%,1
臺北市,中正區,1054,422,471,893,32,925,1436,64.42%,29.39%,1
臺北市,中正區,1055,324,530,854,20,874,1516,57.65%,21.37%,1
臺北市,中正區,1056,316,474,790,24,814,1374,59.24%,23%,1
臺北市,中正區,1057,382,493,875,18,893,1522,58.67%,25.1%,1
臺北市,中正區,1058,302,379,681,24,705,1336,52.77%,22.6%,1
臺北市,中正區,1059,381,510,891,28,919,1551,59.25%,24.56%,1
臺北市,中正區,1060,404,526,930,34,964,1594,60.48%,25.35%,1
臺北市,中正區,1061,379,487,866,22,888,1503,59.08%,25.22%,1
臺北市,中正區,1062,339,504,843,20,863,1455,59.31%,23.3%,1
臺北市,中正區,1063,317,530,847,14,861,1439,59.83%,22.03%,1
臺北市,中正區,1064,363,488,851,27,878,1469,59.77%,24.71%,1
臺北市,中正區,1065,311,546,857,26,883,1430,61.75%,21.75%,1
臺北市,中正區,1066,318,549,867,27,894,1444,61.91%,22.02%,1
臺北市,中正區,1067,298,427,725,13,738,1254,58.85%,23.76%,1
臺北市,中正區,1068,252,295,547,28,575,932,61.7%,27.04%,1
臺北市,中正區,1069,301,318,619,27,646,1055,61.23%,28.53%,1
臺北市,中正區,1070,299,397,696,29,725,1226,59.14%,24.39%,1
臺北市,中正區,1071,308,396,704,40,744,1390,53.53%,22.16%,1
臺北市,中正區,1072,331,456,787,25,812,1336,60.78%,24.78%,1
臺北市,中正區,1073,320,421,741,25,766,1419,53.98%,22.55%,1
臺北市,中正區,1074,422,406,828,30,858,1361,63.04%,31.01%,1
臺北市,中正區,1075,351,528,879,33,912,2520,36.19%,13.93%,1
臺北市,中正區,1076,279,436,715,17,732,1224,59.8%,22.79%,1
臺北市,中正區,1077,331,345,676,5,681,1272,53.54%,26.02%,1
臺北市,中正區,1078,401,399,800,21,821,1400,58.64%,28.64%,1
臺北市,中正區,1079,319,419,738,15,753,1319,57.09%,24.18%,1
臺北市,中正區,1080,312,434,746,30,776,1232,62.99%,25.32%,1
臺北市,中正區,1081,318,486,804,13,817,1265,64.58%,25.14%,1
臺北市,中正區,1082,260,389,649,20,669,1055,63.41%,24.64%,1
臺北市,中正區,1083,223,336,559,12,571,954,59.85%,23.38%,1
臺北市,中正區,1084,234,373,607,26,633,1018,62.18%,22.99%,1
臺北市,中正區,1085,359,436,795,31,826,1431,57.72%,25.09%,1
臺北市,中正區,1086,313,348,661,23,684,1271,53.82%,24.63%,1
臺北市,中正區,1087,271,321,592,26,618,983,62.87%,27.57%,1
臺北市,中正區,1088,381,523,904,19,923,1594,57.9%,23.9%,1
臺北市,中正區,1089,396,529,925,24,949,1565,60.64%,25.3%,1
臺北市,中正區,1090,384,549,933,28,961,1650,58.24%,23.27%,1
臺北市,中正區,1091,382,497,879,25,904,1600,56.5%,23.88%,1
臺北市,中正區,1092,360,434,794,20,814,1391,58.52%,25.88%,1
臺北市,中正區,1093,414,563,977,25,1002,1769,56.64%,23.4%,1
臺北市,中正區,1094,408,442,850,38,888,1487,59.72%,27.44%,1
臺北市,中正區,1095,317,445,762,23,785,1291,60.81%,24.55%,1
臺北市,中正區,1096,332,424,756,32,788,1289,61.13%,25.76%,1
臺北市,大同區,0919,372,347,719,44,763,1261,60.51%,29.5%,1
臺北市,大同區,0920,416,378,794,47,841,1352,62.2%,30.77%,1
臺北市,大同區,0921,409,422,831,26,857,1462,58.62%,27.98%,1
臺北市,大同區,0922,453,381,834,45,879,1510,58.21%,30%,1
臺北市,大同區,0923,401,392,793,31,824,1496,55.08%,26.8%,1
臺北市,大同區,0924,359,361,720,37,757,1329,56.96%,27.01%,1
臺北市,大同區,0925,414,313,727,49,776,1307,59.37%,31.68%,1
臺北市,大同區,0926,352,260,612,22,634,1065,59.53%,33.05%,1
臺北市,大同區,0927,337,297,634,23,657,1085,60.55%,31.06%,1
臺北市,大同區,0928,342,293,635,39,674,1047,64.37%,32.66%,1
臺北市,大同區,0929,336,323,659,19,678,1215,55.8%,27.65%,1
臺北市,大同區,0930,397,279,676,28,704,1117,63.03%,35.54%,1
臺北市,大同區,0931,394,322,716,21,737,1186,62.14%,33.22%,1
臺北市,大同區,0932,401,299,700,38,738,1185,62.28%,33.84%,1
臺北市,大同區,0933,430,343,773,24,797,1359,58.65%,31.64%,1
臺北市,大同區,0934,347,383,730,17,747,1273,58.68%,27.26%,1
臺北市,大同區,0935,439,338,777,32,809,1291,62.66%,34%,1
臺北市,大同區,0936,348,350,698,26,724,1288,56.21%,27.02%,1
臺北市,大同區,0937,357,398,755,34,789,1245,63.37%,28.67%,1
臺北市,大同區,0938,371,394,765,30,795,1261,63.05%,29.42%,1
臺北市,大同區,0939,369,378,747,21,768,1348,56.97%,27.37%,1
臺北市,大同區,0940,524,440,964,42,1006,1676,60.02%,31.26%,1
臺北市,大同區,0941,355,420,775,36,811,1311,61.86%,27.08%,1
臺北市,大同區,0942,398,356,754,56,810,1316,61.55%,30.24%,1
臺北市,大同區,0943,404,383,787,46,833,1409,59.12%,28.67%,1
臺北市,大同區,0944,470,385,855,28,883,1436,61.49%,32.73%,1
臺北市,大同區,0945,472,356,828,35,863,1408,61.29%,33.52%,1
臺北市,大同區,0946,361,350,711,30,741,1276,58.07%,28.29%,1
臺北市,大同區,0947,301,351,652,13,665,1110,59.91%,27.12%,1
臺北市,大同區,0948,366,418,784,19,803,1324,60.65%,27.64%,1
臺北市,大同區,0949,311,266,577,23,600,1016,59.06%,30.61%,1
臺北市,大同區,0950,301,328,629,28,657,1028,63.91%,29.28%,1
臺北市,大同區,0951,318,354,672,36,708,1158,61.14%,27.46%,1
臺北市,大同區,0952,354,323,677,29,706,1138,62.04%,31.11%,1
臺北市,大同區,0953,326,373,699,31,730,1214,60.13%,26.85%,1
臺北市,大同區,0954,340,285,625,19,644,1090,59.08%,31.19%,1
臺北市,大同區,0955,416,383,799,38,837,1305,64.14%,31.88%,1
臺北市,大同區,0956,310,330,640,20,660,1167,56.56%,26.56%,1
臺北市,大同區,0957,331,318,649,30,679,1148,59.15%,28.83%,1
臺北市,大同區,0958,407,318,725,19,744,1203,61.85%,33.83%,1
臺北市,大同區,0959,408,384,792,29,821,1441,56.97%,28.31%,1
臺北市,大同區,0960,401,382,783,38,821,1315,62.43%,30.49%,1
臺北市,大同區,0961,382,399,781,30,811,1393,58.22%,27.42%,1
臺北市,大同區,0962,383,387,770,18,788,1278,61.66%,29.97%,1
臺北市,大同區,0963,402,279,681,22,703,1246,56.42%,32.26%,1
臺北市,大同區,0964,331,301,632,42,674,1142,59.02%,28.98%,1
臺北市,大同區,0965,431,370,801,34,835,1336,62.5%,32.26%,1
臺北市,大同區,0966,421,389,810,33,843,1363,61.85%,30.89%,1
臺北市,大同區,0967,426,438,864,25,889,1476,60.23%,28.86%,1
臺北市,大同區,0968,416,407,823,26,849,1418,59.87%,29.34%,1
臺北市,大同區,0969,421,398,819,28,847,1460,58.01%,28.84%,1
臺北市,大同區,0970,342,276,618,28,646,1222,52.86%,27.99%,1
臺北市,大同區,0971,358,262,620,41,661,1246,53.05%,28.73%,1
臺北市,大同區,0972,380,354,734,36,770,1256,61.31%,30.25%,1
臺北市,大同區,0973,370,357,727,38,765,1289,59.35%,28.7%,1
臺北市,大同區,0974,382,366,748,27,775,1340,57.84%,28.51%,1
臺北市,大同區,0975,425,384,809,35,844,1555,54.28%,27.33%,1
臺北市,大同區,0976,421,382,803,47,850,2459,34.57%,17.12%,1
臺北市,大同區,0977,296,208,504,45,549,1108,49.55%,26.71%,1
臺北市,大同區,0978,246,216,462,32,494,867,56.98%,28.37%,1
臺北市,大同區,0979,452,368,820,38,858,1329,64.56%,34.01%,1
臺北市,大同區,0980,379,287,666,35,701,1162,60.33%,32.62%,1
臺北市,大同區,0981,430,344,774,30,804,1434,56.07%,29.99%,1
臺北市,大同區,0982,366,402,768,37,805,1351,59.59%,27.09%,1
臺北市,大同區,0983,453,366,819,22,841,1531,54.93%,29.59%,1
臺北市,大同區,0984,398,377,775,25,800,1507,53.09%,26.41%,1
臺北市,大同區,0985,465,358,823,31,854,1488,57.39%,31.25%,1
臺北市,大同區,0986,419,382,801,54,855,1384,61.78%,30.27%,1
臺北市,大同區,0987,411,400,811,47,858,1460,58.77%,28.15%,1
臺北市,大同區,0988,391,431,822,34,856,1371,62.44%,28.52%,1
臺北市,大同區,0989,433,369,802,24,826,1439,57.4%,30.09%,1
臺北市,大同區,0990,524,284,808,32,840,1376,61.05%,38.08%,1
臺北市,大同區,0991,419,329,748,39,787,1366,57.61%,30.67%,1
臺北市,大同區,0992,403,350,753,38,791,1218,64.94%,33.09%,1
臺北市,大同區,0993,356,333,689,45,734,1235,59.43%,28.83%,1
臺北市,大同區,0994,338,393,731,26,757,1364,55.5%,24.78%,1
臺北市,大同區,0995,405,457,862,39,901,1408,63.99%,28.76%,1
臺北市,大同區,0996,374,444,818,33,851,1450,58.69%,25.79%,1
臺北市,大同區,0997,383,455,838,57,895,1429,62.63%,26.8%,1
臺北市,大同區,0998,369,320,689,32,721,1170,61.62%,31.54%,1
臺北市,大同區,0999,379,323,702,40,742,1245,59.6%,30.44%,1
臺北市,大同區,1000,414,340,754,45,799,1215,65.76%,34.07%,1
臺北市,萬華區,1097,327,426,753,37,790,1305,60.54%,25.06%,1
臺北市,萬華區,1098,245,314,559,45,604,1183,51.06%,20.71%,1
臺北市,萬華區,1099,293,349,642,25,667,1176,56.72%,24.91%,1
臺北市,萬華區,1100,290,326,616,20,636,1169,54.41%,24.81%,1
臺北市,萬華區,1101,365,370,735,19,754,1457,51.75%,25.05%,1
臺北市,萬華區,1102,307,374,681,69,750,1563,47.98%,19.64%,1
臺北市,萬華區,1103,346,467,813,22,835,1771,47.15%,19.54%,1
臺北市,萬華區,1104,388,417,805,38,843,1615,52.2%,24.02%,1
臺北市,萬華區,1105,434,367,801,35,836,1478,56.56%,29.36%,1
臺北市,萬華區,1106,337,455,792,24,816,1462,55.81%,23.05%,1
臺北市,萬華區,1107,309,395,704,34,738,1507,48.97%,20.5%,1
臺北市,萬華區,1108,355,414,769,35,804,1347,59.69%,26.35%,1
臺北市,萬華區,1109,292,404,696,35,731,1367,53.47%,21.36%,1
臺北市,萬華區,1110,406,360,766,26,792,1277,62.02%,31.79%,1
臺北市,萬華區,1111,468,368,836,28,864,1395,61.94%,33.55%,1
臺北市,萬華區,1112,411,359,770,29,799,1450,55.1%,28.34%,1
臺北市,萬華區,1113,364,311,675,26,701,1340,52.31%,27.16%,1
臺北市,萬華區,1114,330,318,648,28,676,1242,54.43%,26.57%,1
臺北市,萬華區,1115,362,315,677,35,712,1286,55.37%,28.15%,1
臺北市,萬華區,1116,402,298,700,32,732,1324,55.29%,30.36%,1
臺北市,萬華區,1117,432,389,821,41,862,1619,53.24%,26.68%,1
臺北市,萬華區,1118,351,303,654,29,683,1352,50.52%,25.96%,1
臺北市,萬華區,1119,408,358,766,39,805,1440,55.9%,28.33%,1
臺北市,萬華區,1120,336,355,691,33,724,1194,60.64%,28.14%,1
臺北市,萬華區,1121,325,334,659,37,696,1083,64.27%,30.01%,1
臺北市,萬華區,1122,358,296,654,37,691,1237,55.86%,28.94%,1
臺北市,萬華區,1123,428,428,856,35,891,1625,54.83%,26.34%,1
臺北市,萬華區,1124,361,408,769,36,805,1324,60.8%,27.27%,1
臺北市,萬華區,1125,384,399,783,25,808,1352,59.76%,28.4%,1
臺北市,萬華區,1126,377,338,715,36,751,2630,28.56%,14.33%,1
臺北市,萬華區,1127,432,455,887,31,918,1504,61.04%,28.72%,1
臺北市,萬華區,1128,399,379,778,34,812,1425,56.98%,28%,1
臺北市,萬華區,1129,451,353,804,50,854,1591,53.68%,28.35%,1
臺北市,萬華區,1130,425,344,769,48,817,1474,55.43%,28.83%,1
臺北市,萬華區,1131,416,390,806,50,856,1612,53.1%,25.81%,1
臺北市,萬華區,1132,377,402,779,40,819,1447,56.6%,26.05%,1
臺北市,萬華區,1133,403,441,844,28,872,1491,58.48%,27.03%,1
臺北市,萬華區,1134,436,419,855,32,887,1500,59.13%,29.07%,1
臺北市,萬華區,1135,426,469,895,44,939,1582,59.36%,26.93%,1
臺北市,萬華區,1136,372,448,820,38,858,1623,52.87%,22.92%,1
臺北市,萬華區,1137,345,309,654,26,680,1228,55.37%,28.09%,1
臺北市,萬華區,1138,340,351,691,40,731,1268,57.65%,26.81%,1
臺北市,萬華區,1139,351,356,707,37,744,1207,61.64%,29.08%,1
臺北市,萬華區,1140,354,338,692,23,715,1188,60.19%,29.8%,1
臺北市,萬華區,1141,406,369,775,23,798,1474,54.14%,27.54%,1
臺北市,萬華區,1142,269,353,622,26,648,1304,49.69%,20.63%,1
臺北市,萬華區,1143,255,211,466,20,486,1082,44.92%,23.57%,1
臺北市,萬華區,1144,323,243,566,26,592,1052,56.27%,30.7%,1
臺北市,萬華區,1145,340,288,628,17,645,1135,56.83%,29.96%,1
臺北市,萬華區,1146,355,307,662,41,703,1225,57.39%,28.98%,1
臺北市,萬華區,1147,394,407,801,38,839,1583,53%,24.89%,1
臺北市,萬華區,1148,409,350,759,33,792,1403,56.45%,29.15%,1
臺北市,萬華區,1149,404,380,784,37,821,1406,58.39%,28.73%,1
臺北市,萬華區,1150,380,412,792,30,822,1401,58.67%,27.12%,1
臺北市,萬華區,1151,344,347,691,29,720,1188,60.61%,28.96%,1
臺北市,萬華區,1152,512,321,833,50,883,1597,55.29%,32.06%,1
臺北市,萬華區,1153,407,350,757,42,799,1290,61.94%,31.55%,1
臺北市,萬華區,1154,447,430,877,26,903,1746,51.72%,25.6%,1
臺北市,萬華區,1155,371,368,739,36,775,1595,48.59%,23.26%,1
臺北市,萬華區,1156,475,422,897,54,951,1701,55.91%,27.92%,1
臺北市,萬華區,1157,269,347,616,51,667,1339,49.81%,20.09%,1
臺北市,萬華區,1158,348,351,699,55,754,1484,50.81%,23.45%,1
臺北市,萬華區,1159,406,454,860,52,912,1604,56.86%,25.31%,1
臺北市,萬華區,1160,360,325,685,35,720,1197,60.15%,30.08%,1
臺北市,萬華區,1161,383,310,693,51,744,1347,55.23%,28.43%,1
臺北市,萬華區,1162,322,430,752,34,786,1223,64.27%,26.33%,1
臺北市,萬華區,1163,330,298,628,23,651,1036,62.84%,31.85%,1
臺北市,萬華區,1164,337,294,631,34,665,1035,64.25%,32.56%,1
臺北市,萬華區,1165,303,374,677,33,710,1141,62.23%,26.56%,1
臺北市,萬華區,1166,354,391,745,26,771,1271,60.66%,27.85%,1
臺北市,萬華區,1167,386,385,771,53,824,1328,62.05%,29.07%,1
臺北市,萬華區,1168,384,358,742,23,765,1286,59.49%,29.86%,1
臺北市,萬華區,1169,491,442,933,59,992,1679,59.08%,29.24%,1
臺北市,萬華區,1170,449,423,872,48,920,1619,56.83%,27.73%,1
臺北市,萬華區,1171,420,381,801,29,830,1625,51.08%,25.85%,1
臺北市,萬華區,1172,491,448,939,32,971,1623,59.83%,30.25%,1
臺北市,萬華區,1173,352,336,688,32,720,1280,56.25%,27.5%,1
臺北市,萬華區,1174,409,452,861,48,909,1608,56.53%,25.44%,1
臺北市,萬華區,1175,388,416,804,51,855,1453,58.84%,26.7%,1
臺北市,萬華區,1176,409,476,885,38,923,1472,62.7%,27.79%,1
臺北市,萬華區,1177,415,359,774,31,805,1373,58.63%,30.23%,1
臺北市,萬華區,1178,337,399,736,52,788,1394,56.53%,24.18%,1
臺北市,萬華區,1179,362,400,762,21,783,1427,54.87%,25.37%,1
臺北市,萬華區,1180,391,396,787,46,833,1342,62.07%,29.14%,1
臺北市,萬華區,1181,423,478,901,39,940,1569,59.91%,26.96%,1
臺北市,萬華區,1182,389,364,753,31,784,1514,51.78%,25.69%,1
臺北市,萬華區,1183,422,421,843,26,869,1720,50.52%,24.53%,1
臺北市,萬華區,1184,456,413,869,51,920,1461,62.97%,31.21%,1
臺北市,萬華區,1185,356,339,695,25,720,1264,56.96%,28.16%,1
臺北市,萬華區,1186,404,392,796,37,833,1334,62.44%,30.28%,1
臺北市,萬華區,1187,412,419,831,25,856,1446,59.2%,28.49%,1
臺北市,萬華區,1188,321,363,684,35,719,1307,55.01%,24.56%,1
臺北市,萬華區,1189,366,418,784,52,836,1420,58.87%,25.77%,1
臺北市,萬華區,1190,394,350,744,26,770,1427,53.96%,27.61%,1
臺北市,萬華區,1191,213,305,518,25,543,956,56.8%,22.28%,1
臺北市,萬華區,1192,299,439,738,53,791,1352,58.51%,22.12%,1
臺北市,萬華區,1193,313,447,760,29,789,1370,57.59%,22.85%,1
臺北市,萬華區,1194,202,502,704,29,733,1222,59.98%,16.53%,1
臺北市,萬華區,1195,240,513,753,47,800,1375,58.18%,17.45%,1
臺北市,萬華區,1196,261,557,818,43,861,1463,58.85%,17.84%,1
臺北市,萬華區,1197,348,435,783,37,820,1527,53.7%,22.79%,1
臺北市,萬華區,1198,279,493,772,43,815,1485,54.88%,18.79%,1
臺北市,萬華區,1199,226,720,946,31,977,1591,61.41%,14.2%,1
臺北市,萬華區,1200,250,626,876,34,910,1394,65.28%,17.93%,1
臺北市,萬華區,1201,277,580,857,32,889,1522,58.41%,18.2%,1
臺北市,萬華區,1202,268,704,972,36,1008,1661,60.69%,16.13%,1
臺北市,萬華區,1203,306,617,923,36,959,1561,61.43%,19.6%,1
臺北市,萬華區,1204,299,564,863,42,905,1406,64.37%,21.27%,1
臺北市,萬華區,1205,321,377,698,27,725,1498,48.4%,21.43%,1
臺北市,萬華區,1206,310,358,668,45,713,1478,48.24%,20.97%,1
臺北市,萬華區,1207,254,363,617,43,660,1170,56.41%,21.71%,1
臺北市,萬華區,1208,357,445,802,43,845,1376,61.41%,25.94%,1
臺北市,萬華區,1209,238,372,610,17,627,1093,57.37%,21.77%,1
臺北市,萬華區,1210,285,362,647,42,689,1084,63.56%,26.29%,1
臺北市,萬華區,1211,276,388,664,45,709,1119,63.36%,24.66%,1
臺北市,萬華區,1212,315,514,829,31,860,1381,62.27%,22.81%,1
臺北市,萬華區,1213,321,471,792,28,820,1396,58.74%,22.99%,1
臺北市,文山區,1402,373,470,843,26,869,1539,56.47%,24.24%,1
臺北市,文山區,1403,345,470,815,30,845,1548,54.59%,22.29%,1
臺北市,文山區,1404,365,505,870,42,912,1493,61.09%,24.45%,1
臺北市,文山區,1405,426,536,962,41,1003,1648,60.86%,25.85%,1
臺北市,文山區,1406,344,515,859,43,902,1544,58.42%,22.28%,1
臺北市,文山區,1407,431,445,876,33,909,1557,58.38%,27.68%,1
臺北市,文山區,1408,285,529,814,39,853,1514,56.34%,18.82%,1
臺北市,文山區,1409,393,557,950,39,989,1540,64.22%,25.52%,1
臺北市,文山區,1410,353,526,879,34,913,1466,62.28%,24.08%,1
臺北市,文山區,1411,340,530,870,29,899,1444,62.26%,23.55%,1
臺北市,文山區,1412,345,494,839,48,887,1455,60.96%,23.71%,1
臺北市,文山區,1413,295,478,773,39,812,1440,56.39%,20.49%,1
臺北市,文山區,1414,344,485,829,38,867,1398,62.02%,24.61%,1
臺北市,文山區,1415,404,462,866,24,890,1412,63.03%,28.61%,1
臺北市,文山區,1416,354,442,796,45,841,1426,58.98%,24.82%,1
臺北市,文山區,1417,325,488,813,45,858,1437,59.71%,22.62%,1
臺北市,文山區,1418,280,489,769,40,809,1340,60.37%,20.9%,1
臺北市,文山區,1419,327,569,896,23,919,1568,58.61%,20.85%,1
臺北市,文山區,1420,282,510,792,20,812,1372,59.18%,20.55%,1
臺北市,文山區,1421,238,359,597,26,623,1046,59.56%,22.75%,1
臺北市,文山區,1422,290,445,735,36,771,1274,60.52%,22.76%,1
臺北市,文山區,1423,302,457,759,26,785,1324,59.29%,22.81%,1
臺北市,文山區,1424,404,563,967,29,996,1722,57.84%,23.46%,1
臺北市,文山區,1425,368,638,1006,50,1056,1737,60.79%,21.19%,1
臺北市,文山區,1426,304,546,850,21,871,1370,63.58%,22.19%,1
臺北市,文山區,1427,348,510,858,30,888,1495,59.4%,23.28%,1
臺北市,文山區,1428,311,468,779,34,813,1328,61.22%,23.42%,1
臺北市,文山區,1429,294,402,696,22,718,1138,63.09%,25.83%,1
臺北市,文山區,1430,323,581,904,28,932,1471,63.36%,21.96%,1
臺北市,文山區,1431,262,432,694,19,713,1144,62.33%,22.9%,1
臺北市,文山區,1432,262,454,716,39,755,1176,64.2%,22.28%,1
臺北市,文山區,1433,312,429,741,37,778,1212,64.19%,25.74%,1
臺北市,文山區,1434,287,453,740,31,771,1214,63.51%,23.64%,1
臺北市,文山區,1435,311,337,648,28,676,1170,57.78%,26.58%,1
臺北市,文山區,1436,332,441,773,38,811,1308,62%,25.38%,1
臺北市,文山區,1437,303,400,703,34,737,1190,61.93%,25.46%,1
臺北市,文山區,1438,232,407,639,33,672,1110,60.54%,20.9%,1
臺北市,文山區,1439,313,567,880,26,906,1512,59.92%,20.7%,1
臺北市,文山區,1440,217,598,815,49,864,1387,62.29%,15.65%,1
臺北市,文山區,1441,306,473,779,38,817,1355,60.3%,22.58%,1
臺北市,文山區,1442,330,459,789,43,832,1370,60.73%,24.09%,1
臺北市,文山區,1443,307,544,851,39,890,1484,59.97%,20.69%,1
臺北市,文山區,1444,411,601,1012,45,1057,1786,59.18%,23.01%,1
臺北市,文山區,1445,228,498,726,45,771,1260,61.19%,18.1%,1
臺北市,文山區,1446,301,458,759,28,787,1194,65.91%,25.21%,1
臺北市,文山區,1447,316,526,842,35,877,1444,60.73%,21.88%,1
臺北市,文山區,1448,281,593,874,34,908,1495,60.74%,18.8%,1
臺北市,文山區,1449,240,616,856,34,890,1446,61.55%,16.6%,1
臺北市,文山區,1450,373,441,814,42,856,1450,59.03%,25.72%,1
臺北市,文山區,1451,288,594,882,33,915,1486,61.57%,19.38%,1
臺北市,文山區,1452,272,484,756,23,779,1259,61.87%,21.6%,1
臺北市,文山區,1453,300,495,795,14,809,1317,61.43%,22.78%,1
臺北市,文山區,1454,629,468,1097,34,1131,1321,85.62%,47.62%,1
臺北市,文山區,1455,266,570,836,36,872,1475,59.12%,18.03%,1
臺北市,文山區,1456,251,466,717,27,744,1271,58.54%,19.75%,1
臺北市,文山區,1457,385,543,928,42,970,1609,60.29%,23.93%,1
臺北市,文山區,1458,294,529,823,29,852,1501,56.76%,19.59%,1
臺北市,文山區,1459,198,330,528,25,553,997,55.47%,19.86%,1
臺北市,文山區,1460,257,398,655,32,687,1052,65.3%,24.43%,1
臺北市,文山區,1461,245,489,734,34,768,1247,61.59%,19.65%,1
臺北市,文山區,1462,338,343,681,43,724,1167,62.04%,28.96%,1
臺北市,文山區,1463,279,483,762,29,791,1280,61.8%,21.8%,1
臺北市,文山區,1464,242,448,690,31,721,1153,62.53%,20.99%,1
臺北市,文山區,1465,320,594,914,41,955,1557,61.34%,20.55%,1
臺北市,文山區,1466,273,560,833,31,864,1444,59.83%,18.91%,1
臺北市,文山區,1467,323,589,912,33,945,1459,64.77%,22.14%,1
臺北市,文山區,1468,289,542,831,29,860,1357,63.38%,21.3%,1
臺北市,文山區,1469,314,454,768,33,801,1194,67.09%,26.3%,1
臺北市,文山區,1470,321,408,729,35,764,1184,64.53%,27.11%,1
臺北市,文山區,1471,286,410,696,26,722,1119,64.52%,25.56%,1
臺北市,文山區,1472,323,506,829,31,860,1350,63.7%,23.93%,1
臺北市,文山區,1473,286,542,828,35,863,1502,57.46%,19.04%,1
臺北市,文山區,1474,295,586,881,37,918,1511,60.75%,19.52%,1
臺北市,文山區,1475,322,590,912,28,940,1481,63.47%,21.74%,1
臺北市,文山區,1476,507,408,915,27,942,1477,63.78%,34.33%,1
臺北市,文山區,1477,266,510,776,33,809,1294,62.52%,20.56%,1
臺北市,文山區,1478,247,443,690,22,712,1040,68.46%,23.75%,1
臺北市,文山區,1479,348,460,808,32,840,1323,63.49%,26.3%,1
臺北市,文山區,1480,260,423,683,34,717,1153,62.19%,22.55%,1
臺北市,文山區,1481,299,574,873,28,901,1525,59.08%,19.61%,1
臺北市,文山區,1482,300,470,770,69,839,1412,59.42%,21.25%,1
臺北市,文山區,1483,349,550,899,40,939,1473,63.75%,23.69%,1
臺北市,文山區,1484,369,521,890,33,923,1486,62.11%,24.83%,1
臺北市,文山區,1485,295,674,969,46,1015,1616,62.81%,18.25%,1
臺北市,文山區,1486,318,593,911,40,951,1489,63.87%,21.36%,1
臺北市,文山區,1487,295,523,818,32,850,1414,60.11%,20.86%,1
臺北市,文山區,1488,338,592,930,36,966,1494,64.66%,22.62%,1
臺北市,文山區,1489,333,586,919,42,961,1547,62.12%,21.53%,1
臺北市,文山區,1490,368,556,924,47,971,1587,61.18%,23.19%,1
臺北市,文山區,1491,348,598,946,27,973,1515,64.22%,22.97%,1
臺北市,文山區,1492,365,584,949,41,990,1573,62.94%,23.2%,1
臺北市,文山區,1493,402,561,963,32,995,1542,64.53%,26.07%,1
臺北市,文山區,1494,310,459,769,41,810,1465,55.29%,21.16%,1
臺北市,文山區,1495,156,164,320,27,347,699,49.64%,22.32%,1
臺北市,文山區,1496,265,411,676,39,715,1372,52.11%,19.31%,1
臺北市,文山區,1497,298,415,713,40,753,1448,52%,20.58%,1
臺北市,文山區,1498,332,540,872,44,916,1548,59.17%,21.45%,1
臺北市,文山區,1499,322,545,867,34,901,1501,60.03%,21.45%,1
臺北市,文山區,1500,348,582,930,26,956,1560,61.28%,22.31%,1
臺北市,文山區,1501,269,631,900,30,930,1567,59.35%,17.17%,1
臺北市,文山區,1502,321,566,887,34,921,1554,59.27%,20.66%,1
臺北市,文山區,1503,309,566,875,42,917,1544,59.39%,20.01%,1
臺北市,文山區,1504,283,616,899,36,935,1528,61.19%,18.52%,1
臺北市,文山區,1505,277,654,931,34,965,1543,62.54%,17.95%,1
臺北市,文山區,1506,401,533,934,32,966,2754,35.08%,14.56%,1
臺北市,文山區,1507,357,490,847,45,892,1709,52.19%,20.89%,1
臺北市,文山區,1508,343,481,824,46,870,1515,57.43%,22.64%,1
臺北市,文山區,1509,306,507,813,40,853,1571,54.3%,19.48%,1
臺北市,文山區,1510,380,505,885,33,918,1578,58.17%,24.08%,1
臺北市,文山區,1511,317,469,786,39,825,1454,56.74%,21.8%,1
臺北市,文山區,1512,311,568,879,46,925,1436,64.42%,21.66%,1
臺北市,文山區,1513,349,500,849,33,882,1402,62.91%,24.89%,1
臺北市,文山區,1514,293,377,670,32,702,1117,62.85%,26.23%,1
臺北市,文山區,1515,215,395,610,42,652,1094,59.6%,19.65%,1
臺北市,文山區,1516,208,435,643,45,688,1070,64.3%,19.44%,1
臺北市,文山區,1517,281,546,827,27,854,1319,64.75%,21.3%,1
臺北市,文山區,1518,255,507,762,34,796,1226,64.93%,20.8%,1
臺北市,文山區,1519,279,381,660,37,697,1385,50.32%,20.14%,1
臺北市,文山區,1520,310,529,839,40,879,1416,62.08%,21.89%,1
臺北市,文山區,1521,324,541,865,41,906,1412,64.16%,22.95%,1
臺北市,文山區,1522,342,509,851,43,894,1535,58.24%,22.28%,1
臺北市,文山區,1523,344,666,1010,40,1050,1654,63.48%,20.8%,1
臺北市,文山區,1524,283,434,717,16,733,1156,63.41%,24.48%,1
臺北市,文山區,1525,277,474,751,32,783,1231,63.61%,22.5%,1
臺北市,文山區,1526,277,426,703,29,732,1218,60.1%,22.74%,1
臺北市,文山區,1527,262,477,739,21,760,1176,64.63%,22.28%,1
臺北市,文山區,1528,321,523,844,10,854,1392,61.35%,23.06%,1
臺北市,文山區,1529,221,426,647,42,689,1323,52.08%,16.7%,1
臺北市,文山區,1530,295,430,725,36,761,1297,58.67%,22.74%,1
臺北市,文山區,1531,316,470,786,32,818,1296,63.12%,24.38%,1
臺北市,文山區,1532,354,545,899,48,947,1613,58.71%,21.95%,1
臺北市,文山區,1533,399,600,999,36,1035,1697,60.99%,23.51%,1
臺北市,文山區,1534,327,575,902,47,949,1579,60.1%,20.71%,1
臺北市,文山區,1535,336,476,812,36,848,1320,64.24%,25.45%,1
臺北市,文山區,1536,323,526,849,24,873,1438,60.71%,22.46%,1
臺北市,文山區,1537,323,479,802,19,821,1465,56.04%,22.05%,1
臺北市,文山區,1538,380,574,954,38,992,1646,60.27%,23.09%,1
臺北市,文山區,1539,268,488,756,31,787,1286,61.2%,20.84%,1
臺北市,文山區,1540,253,465,718,35,753,1219,61.77%,20.75%,1
臺北市,文山區,1541,291,489,780,34,814,1292,63%,22.52%,1
臺北市,文山區,1542,318,495,813,45,858,1489,57.62%,21.36%,1
臺北市,文山區,1543,373,579,952,38,990,1611,61.45%,23.15%,1
臺北市,文山區,1544,300,485,785,33,818,1549,52.81%,19.37%,1
臺北市,文山區,1545,319,584,903,43,946,1678,56.38%,19.01%,1
臺北市,文山區,1546,362,561,923,31,954,1660,57.47%,21.81%,1
臺北市,文山區,1547,367,519,886,33,919,1816,50.61%,20.21%,1
臺北市,文山區,1548,231,315,546,23,569,985,57.77%,23.45%,1
臺北市,文山區,1549,248,544,792,21,813,1314,61.87%,18.87%,1
臺北市,文山區,1550,237,403,640,28,668,1018,65.62%,23.28%,1
臺北市,文山區,1551,337,583,920,55,975,1578,61.79%,21.36%,1
臺北市,文山區,1552,310,523,833,25,858,1457,58.89%,21.28%,1
臺北市,文山區,1553,299,498,797,31,828,1326,62.44%,22.55%,1
臺北市,文山區,1554,323,509,832,34,866,1393,62.17%,23.19%,1
臺北市,文山區,1555,334,440,774,28,802,1377,58.24%,24.26%,1
臺北市,文山區,1556,344,500,844,29,873,1448,60.29%,23.76%,1
臺北市,文山區,1557,319,575,894,26,920,1447,63.58%,22.05%,1
臺北市,文山區,1558,427,661,1088,47,1135,1739,65.27%,24.55%,1
臺北市,文山區,1559,315,540,855,27,882,1457,60.54%,21.62%,1
臺北市,文山區,1560,309,454,763,33,796,1288,61.8%,23.99%,1
臺北市,文山區,1561,269,407,676,45,721,1301,55.42%,20.68%,1
臺北市,文山區,1562,249,193,442,38,480,865,55.49%,28.79%,1
臺北市,文山區,1563,225,201,426,23,449,789,56.91%,28.52%,1
臺北市,南港區,0455,352,340,692,15,707,1280,55.23%,27.5%,1
臺北市,南港區,0456,349,424,773,21,794,1351,58.77%,25.83%,1
臺北市,南港區,0457,330,449,779,34,813,1345,60.45%,24.54%,1
臺北市,南港區,0458,343,392,735,31,766,1679,45.62%,20.43%,1
臺北市,南港區,0459,417,460,877,31,908,1680,54.05%,24.82%,1
臺北市,南港區,0460,379,445,824,37,861,1635,52.66%,23.18%,1
臺北市,南港區,0461,410,387,797,29,826,1459,56.61%,28.1%,1
臺北市,南港區,0462,402,571,973,28,1001,1706,58.68%,23.56%,1
臺北市,南港區,0463,355,496,851,43,894,1674,53.41%,21.21%,1
臺北市,南港區,0464,296,522,818,18,836,1491,56.07%,19.85%,1
臺北市,南港區,0465,318,364,682,24,706,1086,65.01%,29.28%,1
臺北市,南港區,0466,371,370,741,41,782,1202,65.06%,30.87%,1
臺北市,南港區,0467,354,347,701,27,728,1198,60.77%,29.55%,1
臺北市,南港區,0468,366,411,777,20,797,1430,55.73%,25.59%,1
臺北市,南港區,0469,353,400,753,38,791,1275,62.04%,27.69%,1
臺北市,南港區,0470,408,427,835,38,873,1344,64.96%,30.36%,1
臺北市,南港區,0471,338,480,818,27,845,1391,60.75%,24.3%,1
臺北市,南港區,0472,327,479,806,20,826,1342,61.55%,24.37%,1
臺北市,南港區,0473,346,387,733,35,768,1389,55.29%,24.91%,1
臺北市,南港區,0474,391,442,833,34,867,1426,60.8%,27.42%,1
臺北市,南港區,0475,223,571,794,15,809,1359,59.53%,16.41%,1
臺北市,南港區,0476,365,389,754,38,792,1366,57.98%,26.72%,1
臺北市,南港區,0477,314,532,846,21,867,1441,60.17%,21.79%,1
臺北市,南港區,0478,342,455,797,41,838,1529,54.81%,22.37%,1
臺北市,南港區,0479,408,427,835,39,874,1618,54.02%,25.22%,1
臺北市,南港區,0480,356,379,735,34,769,1545,49.77%,23.04%,1
臺北市,南港區,0481,355,505,860,42,902,1569,57.49%,22.63%,1
臺北市,南港區,0482,374,457,831,30,861,1661,51.84%,22.52%,1
臺北市,南港區,0483,329,437,766,41,807,1518,53.16%,21.67%,1
臺北市,南港區,0484,420,498,918,34,952,1552,61.34%,27.06%,1
臺北市,南港區,0485,379,495,874,28,902,1658,54.4%,22.86%,1
臺北市,南港區,0486,415,496,911,36,947,1608,58.89%,25.81%,1
臺北市,南港區,0487,348,453,801,30,831,1475,56.34%,23.59%,1
臺北市,南港區,0488,437,583,1020,44,1064,1722,61.79%,25.38%,1
臺北市,南港區,0489,357,525,882,33,915,1383,66.16%,25.81%,1
臺北市,南港區,0490,350,439,789,35,824,1397,58.98%,25.05%,1
臺北市,南港區,0491,333,467,800,33,833,1352,61.61%,24.63%,1
臺北市,南港區,0492,332,455,787,28,815,1344,60.64%,24.7%,1
臺北市,南港區,0493,370,376,746,25,771,1385,55.67%,26.71%,1
臺北市,南港區,0494,393,404,797,22,819,1399,58.54%,28.09%,1
臺北市,南港區,0495,388,365,753,29,782,1381,56.63%,28.1%,1
臺北市,南港區,0496,395,426,821,42,863,1548,55.75%,25.52%,1
臺北市,南港區,0497,320,332,652,24,676,1190,56.81%,26.89%,1
臺北市,南港區,0498,432,437,869,25,894,1490,60%,28.99%,1
臺北市,南港區,0499,312,367,679,22,701,1096,63.96%,28.47%,1
臺北市,南港區,0500,337,413,750,26,776,1238,62.68%,27.22%,1
臺北市,南港區,0501,316,462,778,26,804,1271,63.26%,24.86%,1
臺北市,南港區,0502,296,352,648,24,672,1146,58.64%,25.83%,1
臺北市,南港區,0503,334,371,705,21,726,1232,58.93%,27.11%,1
臺北市,南港區,0504,341,484,825,23,848,1649,51.43%,20.68%,1
臺北市,南港區,0505,403,566,969,26,995,1688,58.95%,23.87%,1
臺北市,南港區,0506,347,540,887,41,928,1503,61.74%,23.09%,1
臺北市,南港區,0507,390,468,858,21,879,1542,57%,25.29%,1
臺北市,南港區,0508,363,479,842,27,869,1463,59.4%,24.81%,1
臺北市,南港區,0509,279,423,702,47,749,1195,62.68%,23.35%,1
臺北市,南港區,0510,369,367,736,18,754,1254,60.13%,29.43%,1
臺北市,南港區,0511,277,490,767,44,811,1356,59.81%,20.43%,1
臺北市,南港區,0512,381,430,811,39,850,1363,62.36%,27.95%,1
臺北市,南港區,0513,330,466,796,39,835,1317,63.4%,25.06%,1
臺北市,南港區,0514,350,427,777,22,799,1331,60.03%,26.3%,1
臺北市,南港區,0515,380,524,904,41,945,1610,58.7%,23.6%,1
臺北市,南港區,0516,383,476,859,22,881,1542,57.13%,24.84%,1
臺北市,南港區,0517,416,492,908,33,941,1581,59.52%,26.31%,1
臺北市,南港區,0518,306,447,753,26,779,1225,63.59%,24.98%,1
臺北市,南港區,0519,379,387,766,37,803,1264,63.53%,29.98%,1
臺北市,南港區,0520,386,582,968,52,1020,1649,61.86%,23.41%,1
臺北市,南港區,0521,283,479,762,20,782,1267,61.72%,22.34%,1
臺北市,南港區,0522,284,490,774,26,800,1336,59.88%,21.26%,1
臺北市,南港區,0523,260,436,696,26,722,1162,62.13%,22.38%,1
臺北市,南港區,0524,258,363,621,16,637,1045,60.96%,24.69%,1
臺北市,南港區,0525,354,521,875,36,911,1351,67.43%,26.2%,1
臺北市,南港區,0526,293,473,766,35,801,1358,58.98%,21.58%,1
臺北市,內湖區,0305,410,459,869,14,883,1661,53.16%,24.68%,1
臺北市,內湖區,0306,404,457,861,44,905,1602,56.49%,25.22%,1
臺北市,內湖區,0307,436,540,976,37,1013,1655,61.21%,26.34%,1
臺北市,內湖區,0308,426,508,934,37,971,1582,61.38%,26.93%,1
臺北市,內湖區,0309,364,549,913,31,944,1688,55.92%,21.56%,1
臺北市,內湖區,0310,409,559,968,35,1003,1737,57.74%,23.55%,1
臺北市,內湖區,0311,392,644,1036,33,1069,1809,59.09%,21.67%,1
臺北市,內湖區,0312,335,430,765,27,792,1376,57.56%,24.35%,1
臺北市,內湖區,0313,363,654,1017,58,1075,1747,61.53%,20.78%,1
臺北市,內湖區,0314,357,484,841,24,865,1389,62.28%,25.7%,1
臺北市,內湖區,0315,380,500,880,27,907,1454,62.38%,26.13%,1
臺北市,內湖區,0316,414,500,914,37,951,1468,64.78%,28.2%,1
臺北市,內湖區,0317,427,553,980,37,1017,1603,63.44%,26.64%,1
臺北市,內湖區,0318,420,567,987,36,1023,1795,56.99%,23.4%,1
臺北市,內湖區,0319,434,614,1048,46,1094,1737,62.98%,24.99%,1
臺北市,內湖區,0320,457,556,1013,36,1049,1744,60.15%,26.2%,1
臺北市,內湖區,0321,405,539,944,36,980,1661,59%,24.38%,1
臺北市,內湖區,0322,402,515,917,28,945,1577,59.92%,25.49%,1
臺北市,內湖區,0323,385,534,919,18,937,1494,62.72%,25.77%,1
臺北市,內湖區,0324,415,510,925,40,965,1626,59.35%,25.52%,1
臺北市,內湖區,0325,364,555,919,58,977,1641,59.54%,22.18%,1
臺北市,內湖區,0326,381,520,901,26,927,1554,59.65%,24.52%,1
臺北市,內湖區,0327,466,558,1024,34,1058,1728,61.23%,26.97%,1
臺北市,內湖區,0328,412,572,984,37,1021,1736,58.81%,23.73%,1
臺北市,內湖區,0329,374,531,905,33,938,1461,64.2%,25.6%,1
臺北市,內湖區,0330,386,493,879,30,909,1509,60.24%,25.58%,1
臺北市,內湖區,0331,333,439,772,16,788,1358,58.03%,24.52%,1
臺北市,內湖區,0332,456,523,979,34,1013,1761,57.52%,25.89%,1
臺北市,內湖區,0333,422,528,950,25,975,1651,59.06%,25.56%,1
臺北市,內湖區,0334,447,597,1044,45,1089,1809,60.2%,24.71%,1
臺北市,內湖區,0335,438,571,1009,34,1043,1773,58.83%,24.7%,1
臺北市,內湖區,0336,421,615,1036,34,1070,1890,56.61%,22.28%,1
臺北市,內湖區,0337,445,650,1095,43,1138,1760,64.66%,25.28%,1
臺北市,內湖區,0338,345,617,962,22,984,1645,59.82%,20.97%,1
臺北市,內湖區,0339,329,486,815,25,840,1324,63.44%,24.85%,1
臺北市,內湖區,0340,208,431,639,29,668,1072,62.31%,19.4%,1
臺北市,內湖區,0341,310,535,845,14,859,1509,56.93%,20.54%,1
臺北市,內湖區,0342,468,510,978,33,1011,1715,58.95%,27.29%,1
臺北市,內湖區,0343,457,568,1025,30,1055,1774,59.47%,25.76%,1
臺北市,內湖區,0344,457,653,1110,42,1152,1796,64.14%,25.45%,1
臺北市,內湖區,0345,449,561,1010,30,1040,1784,58.3%,25.17%,1
臺北市,內湖區,0346,382,462,844,28,872,1417,61.54%,26.96%,1
臺北市,內湖區,0347,397,560,957,24,981,1699,57.74%,23.37%,1
臺北市,內湖區,0348,452,606,1058,31,1089,1719,63.35%,26.29%,1
臺北市,內湖區,0349,419,580,999,24,1023,1715,59.65%,24.43%,1
臺北市,內湖區,0350,370,479,849,22,871,1634,53.3%,22.64%,1
臺北市,內湖區,0351,369,411,780,37,817,1435,56.93%,25.71%,1
臺北市,內湖區,0352,386,436,822,22,844,1440,58.61%,26.81%,1
臺北市,內湖區,0353,353,512,865,26,891,1446,61.62%,24.41%,1
臺北市,內湖區,0354,414,460,874,36,910,1657,54.92%,24.98%,1
臺北市,內湖區,0355,344,402,746,42,788,1261,62.49%,27.28%,1
臺北市,內湖區,0356,138,85,223,16,239,456,52.41%,30.26%,1
臺北市,內湖區,0357,439,479,918,30,948,1433,66.15%,30.64%,1
臺北市,內湖區,0358,373,493,866,25,891,1485,60%,25.12%,1
臺北市,內湖區,0359,393,497,890,29,919,1590,57.8%,24.72%,1
臺北市,內湖區,0360,316,434,750,45,795,1219,65.22%,25.92%,1
臺北市,內湖區,0361,402,546,948,32,980,1732,56.58%,23.21%,1
臺北市,內湖區,0362,330,665,995,25,1020,1727,59.06%,19.11%,1
臺北市,內湖區,0363,386,551,937,39,976,1637,59.62%,23.58%,1
臺北市,內湖區,0364,303,500,803,33,836,1453,57.54%,20.85%,1
臺北市,內湖區,0365,354,555,909,17,926,1617,57.27%,21.89%,1
臺北市,內湖區,0366,349,564,913,33,946,1604,58.98%,21.76%,1
臺北市,內湖區,0367,384,507,891,19,910,1406,64.72%,27.31%,1
臺北市,內湖區,0368,403,413,816,25,841,1353,62.16%,29.79%,1
臺北市,內湖區,0369,386,640,1026,31,1057,1724,61.31%,22.39%,1
臺北市,內湖區,0370,337,477,814,32,846,1378,61.39%,24.46%,1
臺北市,內湖區,0371,336,519,855,17,872,1403,62.15%,23.95%,1
臺北市,內湖區,0372,327,531,858,28,886,1547,57.27%,21.14%,1
臺北市,內湖區,0373,474,555,1029,31,1060,1718,61.7%,27.59%,1
臺北市,內湖區,0374,464,549,1013,34,1047,1813,57.75%,25.59%,1
臺北市,內湖區,0375,467,627,1094,34,1128,1791,62.98%,26.07%,1
臺北市,內湖區,0376,469,625,1094,48,1142,1855,61.56%,25.28%,1
臺北市,內湖區,0377,306,675,981,35,1016,1731,58.69%,17.68%,1
臺北市,內湖區,0378,468,537,1005,28,1033,1593,64.85%,29.38%,1
臺北市,內湖區,0379,116,856,972,48,1020,1869,54.57%,6.21%,1
臺北市,內湖區,0380,365,607,972,45,1017,1687,60.28%,21.64%,1
臺北市,內湖區,0381,390,520,910,21,931,1530,60.85%,25.49%,1
臺北市,內湖區,0382,309,464,773,35,808,1300,62.15%,23.77%,1
臺北市,內湖區,0383,277,535,812,34,846,1314,64.38%,21.08%,1
臺北市,內湖區,0384,324,420,744,21,765,1433,53.38%,22.61%,1
臺北市,內湖區,0385,313,457,770,26,796,1450,54.9%,21.59%,1
臺北市,內湖區,0386,382,512,894,33,927,1608,57.65%,23.76%,1
臺北市,內湖區,0387,370,443,813,28,841,1414,59.48%,26.17%,1
臺北市,內湖區,0388,351,504,855,25,880,1492,58.98%,23.53%,1
臺北市,內湖區,0389,406,400,806,28,834,1528,54.58%,26.57%,1
臺北市,內湖區,0390,407,536,943,41,984,1692,58.16%,24.05%,1
臺北市,內湖區,0391,398,483,881,38,919,1556,59.06%,25.58%,1
臺北市,內湖區,0392,404,491,895,23,918,1637,56.08%,24.68%,1
臺北市,內湖區,0393,431,523,954,31,985,1749,56.32%,24.64%,1
臺北市,內湖區,0394,271,391,662,25,687,1220,56.31%,22.21%,1
臺北市,內湖區,0395,411,484,895,31,926,1600,57.88%,25.69%,1
臺北市,內湖區,0396,389,430,819,37,856,1473,58.11%,26.41%,1
臺北市,內湖區,0397,356,470,826,37,863,1498,57.61%,23.77%,1
臺北市,內湖區,0398,395,484,879,30,909,1557,58.38%,25.37%,1
臺北市,內湖區,0399,351,522,873,31,904,1674,54%,20.97%,1
臺北市,內湖區,0400,418,610,1028,25,1053,1728,60.94%,24.19%,1
臺北市,內湖區,0401,226,169,395,16,411,788,52.16%,28.68%,1
臺北市,內湖區,0402,437,396,833,37,870,1542,56.42%,28.34%,1
臺北市,內湖區,0403,392,423,815,36,851,1676,50.78%,23.39%,1
臺北市,內湖區,0404,391,315,706,22,728,1360,53.53%,28.75%,1
臺北市,內湖區,0405,293,474,767,28,795,1259,63.15%,23.27%,1
臺北市,內湖區,0406,248,465,713,12,725,1301,55.73%,19.06%,1
臺北市,內湖區,0407,336,285,621,30,651,1251,52.04%,26.86%,1
臺北市,內湖區,0408,390,445,835,35,870,1502,57.92%,25.97%,1
臺北市,內湖區,0409,352,522,874,29,903,1596,56.58%,22.06%,1
臺北市,內湖區,0410,393,514,907,33,940,1649,57%,23.83%,1
臺北市,內湖區,0411,362,578,940,39,979,1774,55.19%,20.41%,1
臺北市,內湖區,0412,405,541,946,21,967,1746,55.38%,23.2%,1
臺北市,內湖區,0413,341,473,814,22,836,1473,56.75%,23.15%,1
臺北市,內湖區,0414,418,521,939,36,975,2824,34.53%,14.8%,1
臺北市,內湖區,0415,442,508,950,28,978,1849,52.89%,23.9%,1
臺北市,內湖區,0416,399,441,840,31,871,1530,56.93%,26.08%,1
臺北市,內湖區,0417,439,503,942,29,971,1656,58.64%,26.51%,1
臺北市,內湖區,0418,404,445,849,27,876,1457,60.12%,27.73%,1
臺北市,內湖區,0419,408,591,999,29,1028,1695,60.65%,24.07%,1
臺北市,內湖區,0420,403,543,946,35,981,1663,58.99%,24.23%,1
臺北市,內湖區,0421,394,515,909,40,949,1654,57.38%,23.82%,1
臺北市,內湖區,0422,404,542,946,45,991,1642,60.35%,24.6%,1
臺北市,內湖區,0423,427,533,960,31,991,1685,58.81%,25.34%,1
臺北市,內湖區,0424,421,589,1010,41,1051,1862,56.44%,22.61%,1
臺北市,內湖區,0425,445,669,1114,22,1136,1900,59.79%,23.42%,1
臺北市,內湖區,0426,379,732,1111,33,1144,1790,63.91%,21.17%,1
臺北市,內湖區,0427,351,418,769,48,817,1417,57.66%,24.77%,1
臺北市,內湖區,0428,388,533,921,50,971,1694,57.32%,22.9%,1
臺北市,內湖區,0429,353,525,878,44,922,1676,55.01%,21.06%,1
臺北市,內湖區,0430,389,526,915,22,937,1643,57.03%,23.68%,1
臺北市,內湖區,0431,323,581,904,36,940,1588,59.19%,20.34%,1
臺北市,內湖區,0432,380,556,936,31,967,1603,60.32%,23.71%,1
臺北市,內湖區,0433,345,590,935,20,955,1629,58.62%,21.18%,1
臺北市,內湖區,0434,358,636,994,30,1024,1646,62.21%,21.75%,1
臺北市,內湖區,0435,369,638,1007,36,1043,1883,55.39%,19.6%,1
臺北市,內湖區,0436,340,465,805,27,832,1434,58.02%,23.71%,1
臺北市,內湖區,0437,316,465,781,24,805,1418,56.77%,22.28%,1
臺北市,內湖區,0438,329,460,789,40,829,1373,60.38%,23.96%,1
臺北市,內湖區,0439,308,478,786,36,822,1349,60.93%,22.83%,1
臺北市,內湖區,0440,381,514,895,40,935,1511,61.88%,25.22%,1
臺北市,內湖區,0441,405,540,945,28,973,1563,62.25%,25.91%,1
臺北市,內湖區,0442,362,502,864,32,896,1550,57.81%,23.35%,1
臺北市,內湖區,0443,317,312,629,30,659,1157,56.96%,27.4%,1
臺北市,內湖區,0444,507,525,1032,36,1068,1768,60.41%,28.68%,1
臺北市,內湖區,0445,436,520,956,29,985,1664,59.19%,26.2%,1
臺北市,內湖區,0446,453,539,992,40,1032,1743,59.21%,25.99%,1
臺北市,內湖區,0447,336,535,871,19,890,1480,60.14%,22.7%,1
臺北市,內湖區,0448,402,546,948,34,982,1589,61.8%,25.3%,1
臺北市,內湖區,0449,325,462,787,14,801,1371,58.42%,23.71%,1
臺北市,內湖區,0450,499,560,1059,25,1084,1575,68.83%,31.68%,1
臺北市,內湖區,0451,312,489,801,16,817,1377,59.33%,22.66%,1
臺北市,內湖區,0452,342,584,926,48,974,1469,66.3%,23.28%,1
臺北市,內湖區,0453,357,589,946,26,972,1529,63.57%,23.35%,1
臺北市,內湖區,0454,379,588,967,39,1006,1649,61.01%,22.98%,1
臺北市,士林區,0142,518,419,937,55,992,1695,58.53%,30.56%,1
臺北市,士林區,0143,476,503,979,55,1034,1720,60.12%,27.67%,1
臺北市,士林區,0144,321,376,697,54,751,1288,58.31%,24.92%,1
臺北市,士林區,0145,390,470,860,32,892,1546,57.7%,25.23%,1
臺北市,士林區,0146,157,239,396,17,413,652,63.34%,24.08%,1
臺北市,士林區,0147,207,266,473,22,495,870,56.9%,23.79%,1
臺北市,士林區,0148,359,334,693,25,718,1137,63.15%,31.57%,1
臺北市,士林區,0149,307,315,622,47,669,1050,63.71%,29.24%,1
臺北市,士林區,0150,278,335,613,35,648,1031,62.85%,26.96%,1
臺北市,士林區,0151,263,370,633,22,655,1075,60.93%,24.47%,1
臺北市,士林區,0152,252,254,506,27,533,2175,24.51%,11.59%,1
臺北市,士林區,0153,350,550,900,56,956,1775,53.86%,19.72%,1
臺北市,士林區,0154,351,582,933,45,978,1669,58.6%,21.03%,1
臺北市,士林區,0155,478,498,976,39,1015,1665,60.96%,28.71%,1
臺北市,士林區,0156,466,521,987,44,1031,1648,62.56%,28.28%,1
臺北市,士林區,0157,302,410,712,26,738,1246,59.23%,24.24%,1
臺北市,士林區,0158,402,388,790,35,825,1419,58.14%,28.33%,1
臺北市,士林區,0159,351,384,735,49,784,1327,59.08%,26.45%,1
臺北市,士林區,0160,459,496,955,35,990,1573,62.94%,29.18%,1
臺北市,士林區,0161,380,442,822,53,875,1470,59.52%,25.85%,1
臺北市,士林區,0162,545,462,1007,22,1029,1775,57.97%,30.7%,1
臺北市,士林區,0163,426,540,966,40,1006,1692,59.46%,25.18%,1
臺北市,士林區,0164,502,545,1047,36,1083,1842,58.79%,27.25%,1
臺北市,士林區,0165,348,339,687,34,721,1166,61.84%,29.85%,1
臺北市,士林區,0166,426,422,848,40,888,1687,52.64%,25.25%,1
臺北市,士林區,0167,435,463,898,40,938,1624,57.76%,26.79%,1
臺北市,士林區,0168,449,445,894,60,954,1477,64.59%,30.4%,1
臺北市,士林區,0169,363,384,747,36,783,1250,62.64%,29.04%,1
臺北市,士林區,0170,407,403,810,56,866,1434,60.39%,28.38%,1
臺北市,士林區,0171,417,404,821,52,873,1452,60.12%,28.72%,1
臺北市,士林區,0172,442,494,936,36,972,1533,63.41%,28.83%,1
臺北市,士林區,0173,437,461,898,38,936,1515,61.78%,28.84%,1
臺北市,士林區,0174,340,360,700,36,736,1203,61.18%,28.26%,1
臺北市,士林區,0175,427,451,878,54,932,1487,62.68%,28.72%,1
臺北市,士林區,0176,366,355,721,15,736,1252,58.79%,29.23%,1
臺北市,士林區,0177,427,441,868,32,900,1536,58.59%,27.8%,1
臺北市,士林區,0178,441,458,899,53,952,1556,61.18%,28.34%,1
臺北市,士林區,0179,459,420,879,38,917,1511,60.69%,30.38%,1
臺北市,士林區,0180,560,383,943,32,975,1572,62.02%,35.62%,1
臺北市,士林區,0181,408,508,916,46,962,1668,57.67%,24.46%,1
臺北市,士林區,0182,440,487,927,53,980,1685,58.16%,26.11%,1
臺北市,士林區,0183,338,512,850,44,894,1568,57.02%,21.56%,1
臺北市,士林區,0184,306,395,701,37,738,1327,55.61%,23.06%,1
臺北市,士林區,0185,358,357,715,45,760,1338,56.8%,26.76%,1
臺北市,士林區,0186,369,403,772,38,810,1515,53.47%,24.36%,1
臺北市,士林區,0187,426,417,843,42,885,1452,60.95%,29.34%,1
臺北市,士林區,0188,382,441,823,28,851,1448,58.77%,26.38%,1
臺北市,士林區,0189,436,474,910,29,939,1521,61.74%,28.67%,1
臺北市,士林區,0190,428,400,828,38,866,1461,59.27%,29.3%,1
臺北市,士林區,0191,442,371,813,37,850,1541,55.16%,28.68%,1
臺北市,士林區,0192,411,324,735,29,764,1611,47.42%,25.51%,1
臺北市,士林區,0193,477,405,882,35,917,1595,57.49%,29.91%,1
臺北市,士林區,0194,445,409,854,41,895,1685,53.12%,26.41%,1
臺北市,士林區,0195,466,475,941,47,988,1816,54.41%,25.66%,1
臺北市,士林區,0196,463,449,912,51,963,1687,57.08%,27.45%,1
臺北市,士林區,0197,472,420,892,36,928,1646,56.38%,28.68%,1
臺北市,士林區,0198,388,481,869,35,904,1643,55.02%,23.62%,1
臺北市,士林區,0199,366,575,941,41,982,1687,58.21%,21.7%,1
臺北市,士林區,0200,478,471,949,40,989,1655,59.76%,28.88%,1
臺北市,士林區,0201,500,444,944,18,962,1779,54.08%,28.11%,1
臺北市,士林區,0202,568,481,1049,50,1099,1855,59.25%,30.62%,1
臺北市,士林區,0203,393,365,758,39,797,1350,59.04%,29.11%,1
臺北市,士林區,0204,278,479,757,25,782,1455,53.75%,19.11%,1
臺北市,士林區,0205,397,271,668,57,725,1497,48.43%,26.52%,1
臺北市,士林區,0206,341,301,642,31,673,1398,48.14%,24.39%,1
臺北市,士林區,0207,536,471,1007,40,1047,1747,59.93%,30.68%,1
臺北市,士林區,0208,434,351,785,45,830,1465,56.66%,29.62%,1
臺北市,士林區,0209,463,344,807,36,843,1530,55.1%,30.26%,1
臺北市,士林區,0210,487,441,928,52,980,1855,52.83%,26.25%,1
臺北市,士林區,0211,437,363,800,37,837,1444,57.96%,30.26%,1
臺北市,士林區,0212,438,355,793,48,841,1563,53.81%,28.02%,1
臺北市,士林區,0213,454,370,824,40,864,1482,58.3%,30.63%,1
臺北市,士林區,0214,504,334,838,45,883,1552,56.89%,32.47%,1
臺北市,士林區,0215,510,467,977,39,1016,1790,56.76%,28.49%,1
臺北市,士林區,0216,418,391,809,56,865,1628,53.13%,25.68%,1
臺北市,士林區,0217,378,331,709,39,748,1337,55.95%,28.27%,1
臺北市,士林區,0218,482,468,950,49,999,1750,57.09%,27.54%,1
臺北市,士林區,0219,447,406,853,46,899,1668,53.9%,26.8%,1
臺北市,士林區,0220,383,251,634,44,678,1403,48.33%,27.3%,1
臺北市,士林區,0221,416,272,688,20,708,1468,48.23%,28.34%,1
臺北市,士林區,0222,453,294,747,18,765,1471,52.01%,30.8%,1
臺北市,士林區,0223,592,251,843,43,886,1666,53.18%,35.53%,1
臺北市,士林區,0224,508,305,813,23,836,1587,52.68%,32.01%,1
臺北市,士林區,0225,491,423,914,48,962,1987,48.41%,24.71%,1
臺北市,士林區,0226,200,437,637,24,661,1271,52.01%,15.74%,1
臺北市,士林區,0227,418,582,1000,49,1049,1728,60.71%,24.19%,1
臺北市,士林區,0228,419,542,961,23,984,1630,60.37%,25.71%,1
臺北市,士林區,0229,400,539,939,29,968,1619,59.79%,24.71%,1
臺北市,士林區,0230,343,469,812,30,842,1425,59.09%,24.07%,1
臺北市,士林區,0231,451,498,949,49,998,1623,61.49%,27.79%,1
臺北市,士林區,0232,397,498,895,35,930,1564,59.46%,25.38%,1
臺北市,士林區,0233,400,482,882,31,913,1376,66.35%,29.07%,1
臺北市,士林區,0234,287,631,918,24,942,1517,62.1%,18.92%,1
臺北市,士林區,0235,409,485,894,33,927,1729,53.61%,23.66%,1
臺北市,士林區,0236,379,519,898,35,933,1511,61.75%,25.08%,1
臺北市,士林區,0237,469,602,1071,26,1097,1811,60.57%,25.9%,1
臺北市,士林區,0238,407,482,889,29,918,1533,59.88%,26.55%,1
臺北市,士林區,0239,452,589,1041,39,1080,1657,65.18%,27.28%,1
臺北市,士林區,0240,370,484,854,21,875,1499,58.37%,24.68%,1
臺北市,士林區,0241,253,506,759,50,809,1402,57.7%,18.05%,1
臺北市,士林區,0242,397,402,799,33,832,1273,65.36%,31.19%,1
臺北市,士林區,0243,400,371,771,27,798,1273,62.69%,31.42%,1
臺北市,士林區,0244,356,394,750,36,786,1316,59.73%,27.05%,1
臺北市,士林區,0245,474,467,941,30,971,1659,58.53%,28.57%,1
臺北市,士林區,0246,461,511,972,30,1002,1749,57.29%,26.36%,1
臺北市,士林區,0247,425,435,860,34,894,1552,57.6%,27.38%,1
臺北市,士林區,0248,318,557,875,41,916,1529,59.91%,20.8%,1
臺北市,士林區,0249,263,633,896,33,929,1644,56.51%,16%,1
臺北市,士林區,0250,395,597,992,28,1020,1779,57.34%,22.2%,1
臺北市,士林區,0251,402,495,897,35,932,1597,58.36%,25.17%,1
臺北市,士林區,0252,377,431,808,39,847,1454,58.25%,25.93%,1
臺北市,士林區,0253,455,494,949,24,973,1582,61.5%,28.76%,1
臺北市,士林區,0254,392,494,886,26,912,1518,60.08%,25.82%,1
臺北市,士林區,0255,354,441,795,18,813,1501,54.16%,23.58%,1
臺北市,士林區,0256,365,457,822,38,860,1420,60.56%,25.7%,1
臺北市,士林區,0257,407,445,852,26,878,1494,58.77%,27.24%,1
臺北市,士林區,0258,447,501,948,44,992,1568,63.27%,28.51%,1
臺北市,士林區,0259,369,374,743,30,773,1208,63.99%,30.55%,1
臺北市,士林區,0260,432,576,1008,41,1049,1826,57.45%,23.66%,1
臺北市,士林區,0261,428,488,916,43,959,1647,58.23%,25.99%,1
臺北市,士林區,0262,420,498,918,39,957,1654,57.86%,25.39%,1
臺北市,士林區,0263,401,502,903,30,933,1550,60.19%,25.87%,1
臺北市,士林區,0264,379,419,798,28,826,1298,63.64%,29.2%,1
臺北市,士林區,0265,334,466,800,31,831,1297,64.07%,25.75%,1
臺北市,士林區,0266,344,399,743,26,769,1352,56.88%,25.44%,1
臺北市,士林區,0267,412,444,856,31,887,1522,58.28%,27.07%,1
臺北市,士林區,0268,446,432,878,52,930,1602,58.05%,27.84%,1
臺北市,士林區,0269,436,413,849,28,877,1441,60.86%,30.26%,1
臺北市,士林區,0270,328,385,713,17,730,1325,55.09%,24.75%,1
臺北市,士林區,0271,403,475,878,35,913,1567,58.26%,25.72%,1
臺北市,士林區,0272,375,468,843,25,868,1518,57.18%,24.7%,1
臺北市,士林區,0273,431,483,914,34,948,1549,61.2%,27.82%,1
臺北市,士林區,0274,415,517,932,26,958,1652,57.99%,25.12%,1
臺北市,士林區,0275,472,555,1027,32,1059,1766,59.97%,26.73%,1
臺北市,士林區,0276,383,523,906,23,929,1638,56.72%,23.38%,1
臺北市,士林區,0277,361,516,877,28,905,1491,60.7%,24.21%,1
臺北市,士林區,0278,398,464,862,26,888,1521,58.38%,26.17%,1
臺北市,士林區,0279,314,472,786,38,824,1351,60.99%,23.24%,1
臺北市,士林區,0280,401,513,914,25,939,1742,53.9%,23.02%,1
臺北市,士林區,0281,414,475,889,35,924,1585,58.3%,26.12%,1
臺北市,士林區,0282,351,522,873,32,905,1521,59.5%,23.08%,1
臺北市,士林區,0283,382,475,857,19,876,1543,56.77%,24.76%,1
臺北市,士林區,0284,342,477,819,24,843,1404,60.04%,24.36%,1
臺北市,士林區,0285,362,511,873,35,908,1541,58.92%,23.49%,1
臺北市,士林區,0286,316,526,842,38,880,1584,55.56%,19.95%,1
臺北市,士林區,0287,390,484,874,37,911,1519,59.97%,25.67%,1
臺北市,士林區,0288,327,450,777,12,789,1482,53.24%,22.06%,1
臺北市,士林區,0289,324,361,685,28,713,1243,57.36%,26.07%,1
臺北市,士林區,0290,322,312,634,32,666,1156,57.61%,27.85%,1
臺北市,士林區,0291,399,274,673,28,701,1262,55.55%,31.62%,1
臺北市,士林區,0292,250,252,502,31,533,889,59.96%,28.12%,1
臺北市,士林區,0293,271,243,514,29,543,858,63.29%,31.59%,1
臺北市,士林區,0294,286,223,509,27,536,945,56.72%,30.26%,1
臺北市,士林區,0295,223,274,497,40,537,960,55.94%,23.23%,1
臺北市,士林區,0296,193,270,463,35,498,876,56.85%,22.03%,1
臺北市,士林區,0297,169,174,343,25,368,556,66.19%,30.4%,1
臺北市,士林區,0298,248,289,537,41,578,919,62.89%,26.99%,1
臺北市,士林區,0299,465,366,831,70,901,1360,66.25%,34.19%,1
臺北市,士林區,0300,400,384,784,58,842,1355,62.14%,29.52%,1
臺北市,士林區,0301,259,461,720,24,744,1252,59.42%,20.69%,1
臺北市,士林區,0302,219,500,719,26,745,1182,63.03%,18.53%,1
臺北市,士林區,0303,303,391,694,26,720,1431,50.31%,21.17%,1
臺北市,士林區,0304,311,369,680,17,697,1240,56.21%,25.08%,1
臺北市,北投區,0001,369,401,770,42,812,1313,61.84%,28.1%,1
臺北市,北投區,0002,454,383,837,40,877,1403,62.51%,32.36%,1
臺北市,北投區,0003,337,313,650,23,673,1081,62.26%,31.17%,1
臺北市,北投區,0004,340,368,708,32,740,1209,61.21%,28.12%,1
臺北市,北投區,0005,369,394,763,28,791,1326,59.65%,27.83%,1
臺北市,北投區,0006,359,391,750,33,783,1263,62%,28.42%,1
臺北市,北投區,0007,472,467,939,35,974,1580,61.65%,29.87%,1
臺北市,北投區,0008,441,468,909,23,932,1577,59.1%,27.96%,1
臺北市,北投區,0009,414,440,854,45,899,1483,60.62%,27.92%,1
臺北市,北投區,0010,357,473,830,11,841,1461,57.56%,24.44%,1
臺北市,北投區,0011,382,410,792,43,835,1466,56.96%,26.06%,1
臺北市,北投區,0012,421,517,938,35,973,1620,60.06%,25.99%,1
臺北市,北投區,0013,345,466,811,28,839,1543,54.37%,22.36%,1
臺北市,北投區,0014,378,415,793,38,831,1513,54.92%,24.98%,1
臺北市,北投區,0015,407,471,878,29,907,1534,59.13%,26.53%,1
臺北市,北投區,0016,433,511,944,47,991,1650,60.06%,26.24%,1
臺北市,北投區,0017,370,503,873,31,904,1533,58.97%,24.14%,1
臺北市,北投區,0018,407,501,908,42,950,1702,55.82%,23.91%,1
臺北市,北投區,0019,438,510,948,33,981,1721,57%,25.45%,1
臺北市,北投區,0020,434,496,930,39,969,1575,61.52%,27.56%,1
臺北市,北投區,0021,377,482,859,46,905,1530,59.15%,24.64%,1
臺北市,北投區,0022,409,577,986,31,1017,1728,58.85%,23.67%,1
臺北市,北投區,0023,412,545,957,30,987,1702,57.99%,24.21%,1
臺北市,北投區,0024,434,497,931,40,971,1696,57.25%,25.59%,1
臺北市,北投區,0025,321,456,777,20,797,1684,47.33%,19.06%,1
臺北市,北投區,0026,447,557,1004,39,1043,1717,60.75%,26.03%,1
臺北市,北投區,0027,420,502,922,28,950,1605,59.19%,26.17%,1
臺北市,北投區,0028,408,546,954,46,1000,1723,58.04%,23.68%,1
臺北市,北投區,0029,439,516,955,31,986,1597,61.74%,27.49%,1
臺北市,北投區,0030,414,531,945,41,986,1700,58%,24.35%,1
臺北市,北投區,0031,386,408,794,23,817,1544,52.91%,25%,1
臺北市,北投區,0032,375,448,823,33,856,1635,52.35%,22.94%,1
臺北市,北投區,0033,382,487,869,17,886,1495,59.26%,25.55%,1
臺北市,北投區,0034,419,498,917,30,947,1619,58.49%,25.88%,1
臺北市,北投區,0035,426,490,916,41,957,1683,56.86%,25.31%,1
臺北市,北投區,0036,347,529,876,25,901,1662,54.21%,20.88%,1
臺北市,北投區,0037,394,517,911,15,926,1850,50.05%,21.3%,1
臺北市,北投區,0038,395,461,856,19,875,1674,52.27%,23.6%,1
臺北市,北投區,0039,344,533,877,45,922,1511,61.02%,22.77%,1
臺北市,北投區,0040,358,424,782,18,800,1393,57.43%,25.7%,1
臺北市,北投區,0041,350,427,777,30,807,1279,63.1%,27.37%,1
臺北市,北投區,0042,240,415,655,25,680,1122,60.61%,21.39%,1
臺北市,北投區,0043,330,498,828,39,867,1238,70.03%,26.66%,1
臺北市,北投區,0044,384,496,880,40,920,1477,62.29%,26%,1
臺北市,北投區,0045,366,503,869,48,917,1495,61.34%,24.48%,1
臺北市,北投區,0046,382,518,900,39,939,1469,63.92%,26%,1
臺北市,北投區,0047,357,477,834,32,866,1462,59.23%,24.42%,1
臺北市,北投區,0048,324,491,815,40,855,1431,59.75%,22.64%,1
臺北市,北投區,0049,439,407,846,30,876,1486,58.95%,29.54%,1
臺北市,北投區,0050,426,425,851,34,885,1449,61.08%,29.4%,1
臺北市,北投區,0051,392,451,843,23,866,1456,59.48%,26.92%,1
臺北市,北投區,0052,350,394,744,26,770,1311,58.73%,26.7%,1
臺北市,北投區,0053,280,409,689,40,729,1356,53.76%,20.65%,1
臺北市,北投區,0054,387,402,789,22,811,1338,60.61%,28.92%,1
臺北市,北投區,0055,387,478,865,32,897,1525,58.82%,25.38%,1
臺北市,北投區,0056,421,460,881,26,907,1620,55.99%,25.99%,1
臺北市,北投區,0057,407,403,810,14,824,1499,54.97%,27.15%,1
臺北市,北投區,0058,358,522,880,32,912,1497,60.92%,23.91%,1
臺北市,北投區,0059,396,507,903,37,940,1624,57.88%,24.38%,1
臺北市,北投區,0060,400,403,803,47,850,1536,55.34%,26.04%,1
臺北市,北投區,0061,423,429,852,50,902,1469,61.4%,28.8%,1
臺北市,北投區,0062,392,465,857,36,893,1598,55.88%,24.53%,1
臺北市,北投區,0063,440,481,921,27,948,1690,56.09%,26.04%,1
臺北市,北投區,0064,433,424,857,60,917,1599,57.35%,27.08%,1
臺北市,北投區,0065,400,503,903,38,941,1634,57.59%,24.48%,1
臺北市,北投區,0066,482,377,859,28,887,1660,53.43%,29.04%,1
臺北市,北投區,0067,442,532,974,37,1011,1900,53.21%,23.26%,1
臺北市,北投區,0068,473,534,1007,34,1041,1797,57.93%,26.32%,1
臺北市,北投區,0069,459,567,1026,44,1070,1832,58.41%,25.05%,1
臺北市,北投區,0070,462,557,1019,39,1058,1784,59.3%,25.9%,1
臺北市,北投區,0071,459,533,992,25,1017,1732,58.72%,26.5%,1
臺北市,北投區,0072,265,266,531,33,564,2035,27.71%,13.02%,1
臺北市,北投區,0073,421,393,814,45,859,1504,57.11%,27.99%,1
臺北市,北投區,0074,417,525,942,56,998,1683,59.3%,24.78%,1
臺北市,北投區,0075,405,446,851,61,912,1635,55.78%,24.77%,1
臺北市,北投區,0076,404,472,876,42,918,1613,56.91%,25.05%,1
臺北市,北投區,0077,357,410,767,23,790,1483,53.27%,24.07%,1
臺北市,北投區,0078,365,454,819,34,853,1500,56.87%,24.33%,1
臺北市,北投區,0079,398,445,843,34,877,1483,59.14%,26.84%,1
臺北市,北投區,0080,427,398,825,48,873,1544,56.54%,27.66%,1
臺北市,北投區,0081,360,356,716,62,778,1532,50.78%,23.5%,1
臺北市,北投區,0082,471,527,998,37,1035,1819,56.9%,25.89%,1
臺北市,北投區,0083,466,466,932,40,972,1863,52.17%,25.01%,1
臺北市,北投區,0084,451,496,947,20,967,1872,51.66%,24.09%,1
臺北市,北投區,0085,424,461,885,32,917,1627,56.36%,26.06%,1
臺北市,北投區,0086,457,447,904,23,927,1696,54.66%,26.95%,1
臺北市,北投區,0087,488,499,987,41,1028,1841,55.84%,26.51%,1
臺北市,北投區,0088,376,361,737,32,769,1324,58.08%,28.4%,1
臺北市,北投區,0089,401,406,807,17,824,1504,54.79%,26.66%,1
臺北市,北投區,0090,365,462,827,34,861,1511,56.98%,24.16%,1
臺北市,北投區,0091,425,503,928,34,962,1615,59.57%,26.32%,1
臺北市,北投區,0092,273,388,661,19,680,1270,53.54%,21.5%,1
臺北市,北投區,0093,369,369,738,27,765,1492,51.27%,24.73%,1
臺北市,北投區,0094,358,384,742,26,768,1429,53.74%,25.05%,1
臺北市,北投區,0095,359,457,816,20,836,1567,53.35%,22.91%,1
臺北市,北投區,0096,345,411,756,34,790,1388,56.92%,24.86%,1
臺北市,北投區,0097,365,385,750,20,770,1448,53.18%,25.21%,1
臺北市,北投區,0098,316,371,687,48,735,1356,54.2%,23.3%,1
臺北市,北投區,0099,312,384,696,41,737,1308,56.35%,23.85%,1
臺北市,北投區,0100,327,357,684,38,722,1165,61.97%,28.07%,1
臺北市,北投區,0101,360,464,824,40,864,1429,60.46%,25.19%,1
臺北市,北投區,0102,299,496,795,21,816,1472,55.43%,20.31%,1
臺北市,北投區,0103,396,519,915,38,953,1508,63.2%,26.26%,1
臺北市,北投區,0104,347,457,804,44,848,1480,57.3%,23.45%,1
臺北市,北投區,0105,286,334,620,26,646,1142,56.57%,25.04%,1
臺北市,北投區,0106,366,451,817,26,843,1554,54.25%,23.55%,1
臺北市,北投區,0107,406,534,940,66,1006,1669,60.28%,24.33%,1
臺北市,北投區,0108,403,622,1025,43,1068,1823,58.58%,22.11%,1
臺北市,北投區,0109,371,538,909,54,963,1739,55.38%,21.33%,1
臺北市,北投區,0110,407,503,910,46,956,1771,53.98%,22.98%,1
臺北市,北投區,0111,303,430,733,46,779,1468,53.07%,20.64%,1
臺北市,北投區,0112,356,445,801,23,824,1469,56.09%,24.23%,1
臺北市,北投區,0113,262,422,684,24,708,1094,64.72%,23.95%,1
臺北市,北投區,0114,190,474,664,40,704,1101,63.94%,17.26%,1
臺北市,北投區,0115,286,544,830,32,862,1422,60.62%,20.11%,1
臺北市,北投區,0116,318,420,738,46,784,1390,56.4%,22.88%,1
臺北市,北投區,0117,345,400,745,40,785,1307,60.06%,26.4%,1
臺北市,北投區,0118,338,393,731,43,774,1215,63.7%,27.82%,1
臺北市,北投區,0119,353,516,869,33,902,1642,54.93%,21.5%,1
臺北市,北投區,0120,364,473,837,37,874,1623,53.85%,22.43%,1
臺北市,北投區,0121,373,483,856,46,902,1621,55.64%,23.01%,1
臺北市,北投區,0122,370,393,763,15,778,1367,56.91%,27.07%,1
臺北市,北投區,0123,356,329,685,42,727,1309,55.54%,27.2%,1
臺北市,北投區,0124,315,459,774,23,797,1356,58.78%,23.23%,1
臺北市,北投區,0125,341,396,737,32,769,1365,56.34%,24.98%,1
臺北市,北投區,0126,455,412,867,26,893,1613,55.36%,28.21%,1
臺北市,北投區,0127,375,397,772,29,801,1590,50.38%,23.58%,1
臺北市,北投區,0128,440,485,925,46,971,1662,58.42%,26.47%,1
臺北市,北投區,0129,396,488,884,53,937,1622,57.77%,24.41%,1
臺北市,北投區,0130,459,514,973,32,1005,1820,55.22%,25.22%,1
臺北市,北投區,0131,386,522,908,43,951,1615,58.89%,23.9%,1
臺北市,北投區,0132,323,374,697,55,752,1612,46.65%,20.04%,1
臺北市,北投區,0133,423,457,880,43,923,1652,55.87%,25.61%,1
臺北市,北投區,0134,413,515,928,21,949,1666,56.96%,24.79%,1
臺北市,北投區,0135,413,460,873,33,906,1641,55.21%,25.17%,1
臺北市,北投區,0136,155,153,308,12,320,528,60.61%,29.36%,1
臺北市,北投區,0137,393,354,747,43,790,1642,48.11%,23.93%,1
臺北市,北投區,0138,226,229,455,15,470,829,56.69%,27.26%,1
臺北市,北投區,0139,152,218,370,18,388,690,56.23%,22.03%,1
臺北市,北投區,0140,287,269,556,35,591,1067,55.39%,26.9%,1
臺北市,北投區,0141,235,240,475,32,507,892,56.84%,26.35%,1
新北市,板橋區,0894,344,390,734,49,783,1388,56.41%,24.78%,1
新北市,板橋區,0895,337,379,716,50,766,1294,59.2%,26.04%,1
新北市,板橋區,0896,214,181,395,19,414,667,62.07%,32.08%,1
新北市,板橋區,0897,248,221,469,32,501,898,55.79%,27.62%,1
新北市,板橋區,0898,206,273,479,29,508,829,61.28%,24.85%,1
新北市,板橋區,0899,168,264,432,30,462,739,62.52%,22.73%,1
新北市,板橋區,0900,297,303,600,32,632,1035,61.06%,28.7%,1
新北市,板橋區,0901,372,405,777,18,795,1713,46.41%,21.72%,1
新北市,板橋區,0902,148,178,326,15,341,658,51.82%,22.49%,1
新北市,板橋區,0903,336,355,691,51,742,1312,56.55%,25.61%,1
新北市,板橋區,0904,356,394,750,35,785,1492,52.61%,23.86%,1
新北市,板橋區,0905,323,359,682,45,727,1393,52.19%,23.19%,1
新北市,板橋區,0906,387,467,854,33,887,4742,18.71%,8.16%,1
新北市,板橋區,0907,341,406,747,45,792,1439,55.04%,23.7%,1
新北市,板橋區,0908,345,338,683,38,721,1187,60.74%,29.06%,1
新北市,板橋區,0909,288,320,608,31,639,1122,56.95%,25.67%,1
新北市,板橋區,0910,396,384,780,30,810,1363,59.43%,29.05%,1
新北市,板橋區,0911,316,295,611,38,649,1093,59.38%,28.91%,1
新北市,板橋區,0912,379,382,761,34,795,1331,59.73%,28.47%,1
新北市,板橋區,0913,293,307,600,43,643,1026,62.67%,28.56%,1
新北市,板橋區,0914,305,384,689,41,730,1244,58.68%,24.52%,1
新北市,板橋區,0915,343,294,637,52,689,1268,54.34%,27.05%,1
新北市,板橋區,0916,354,317,671,37,708,1313,53.92%,26.96%,1
新北市,板橋區,0917,325,377,702,35,737,1196,61.62%,27.17%,1
新北市,板橋區,0918,299,450,749,30,779,1137,68.51%,26.3%,1
新北市,板橋區,0919,359,424,783,30,813,1269,64.07%,28.29%,1
新北市,板橋區,0920,270,402,672,37,709,1117,63.47%,24.17%,1
新北市,板橋區,0921,252,380,632,33,665,1042,63.82%,24.18%,1
新北市,板橋區,0922,372,345,717,50,767,1257,61.02%,29.59%,1
新北市,板橋區,0923,359,328,687,42,729,1216,59.95%,29.52%,1
新北市,板橋區,0924,298,308,606,55,661,1126,58.7%,26.47%,1
新北市,板橋區,0925,318,477,795,41,836,1290,64.81%,24.65%,1
新北市,板橋區,0926,276,352,628,23,651,1215,53.58%,22.72%,1
新北市,板橋區,0927,264,315,579,28,607,1099,55.23%,24.02%,1
新北市,板橋區,0928,239,569,808,37,845,1329,63.58%,17.98%,1
新北市,板橋區,0929,147,434,581,23,604,996,60.64%,14.76%,1
新北市,板橋區,0930,268,337,605,30,635,1047,60.65%,25.6%,1
新北市,板橋區,0931,322,393,715,53,768,1272,60.38%,25.31%,1
新北市,板橋區,0932,295,435,730,38,768,1252,61.34%,23.56%,1
新北市,板橋區,0933,338,356,694,40,734,1238,59.29%,27.3%,1
新北市,板橋區,0934,417,418,835,50,885,1389,63.71%,30.02%,1
新北市,板橋區,0935,354,356,710,43,753,1194,63.07%,29.65%,1
新北市,板橋區,0936,273,295,568,39,607,1093,55.54%,24.98%,1
新北市,板橋區,0937,307,303,610,52,662,1148,57.67%,26.74%,1
新北市,板橋區,0938,378,364,742,37,779,1268,61.44%,29.81%,1
新北市,板橋區,0939,374,307,681,37,718,1230,58.37%,30.41%,1
新北市,板橋區,0940,246,306,552,32,584,1012,57.71%,24.31%,1
新北市,板橋區,0941,260,198,458,34,492,811,60.67%,32.06%,1
新北市,板橋區,0942,341,371,712,51,763,1197,63.74%,28.49%,1
新北市,板橋區,0943,273,352,625,23,648,1142,56.74%,23.91%,1
新北市,板橋區,0944,291,292,583,32,615,1222,50.33%,23.81%,1
新北市,板橋區,0945,208,279,487,35,522,796,65.58%,26.13%,1
新北市,板橋區,0946,281,331,612,35,647,997,64.89%,28.18%,1
新北市,板橋區,0947,284,285,569,24,593,1011,58.65%,28.09%,1
新北市,板橋區,0948,340,314,654,48,702,1157,60.67%,29.39%,1
新北市,板橋區,0949,308,304,612,30,642,1040,61.73%,29.62%,1
新北市,板橋區,0950,288,400,688,27,715,1173,60.95%,24.55%,1
新北市,板橋區,0951,320,334,654,24,678,1193,56.83%,26.82%,1
新北市,板橋區,0952,333,414,747,20,767,1255,61.12%,26.53%,1
新北市,板橋區,0953,378,372,750,37,787,1306,60.26%,28.94%,1
新北市,板橋區,0954,319,304,623,18,641,1050,61.05%,30.38%,1
新北市,板橋區,0955,307,242,549,29,578,942,61.36%,32.59%,1
新北市,板橋區,0956,316,367,683,34,717,1133,63.28%,27.89%,1
新北市,板橋區,0957,328,382,710,26,736,1251,58.83%,26.22%,1
新北市,板橋區,0958,333,428,761,32,793,1293,61.33%,25.75%,1
新北市,板橋區,0959,325,295,620,46,666,1208,55.13%,26.9%,1
新北市,板橋區,0960,360,330,690,37,727,1223,59.44%,29.44%,1
新北市,板橋區,0961,299,277,576,29,605,1061,57.02%,28.18%,1
新北市,板橋區,0962,404,437,841,35,876,1515,57.82%,26.67%,1
新北市,板橋區,0963,311,398,709,47,756,1225,61.71%,25.39%,1
新北市,板橋區,0964,242,456,698,28,726,1120,64.82%,21.61%,1
新北市,板橋區,0965,259,406,665,28,693,1091,63.52%,23.74%,1
新北市,板橋區,0966,174,635,809,23,832,1385,60.07%,12.56%,1
新北市,板橋區,0967,353,394,747,32,779,1283,60.72%,27.51%,1
新北市,板橋區,0968,367,314,681,47,728,1204,60.47%,30.48%,1
新北市,板橋區,0969,328,395,723,35,758,1191,63.64%,27.54%,1
新北市,板橋區,0970,325,329,654,37,691,1078,64.1%,30.15%,1
新北市,板橋區,0971,349,403,752,53,805,1351,59.59%,25.83%,1
新北市,板橋區,0972,331,424,755,32,787,1322,59.53%,25.04%,1
新北市,板橋區,0973,241,255,496,35,531,868,61.18%,27.76%,1
新北市,板橋區,0974,300,343,643,48,691,1029,67.15%,29.15%,1
新北市,板橋區,0975,494,439,933,25,958,1602,59.8%,30.84%,1
新北市,板橋區,0976,401,387,788,37,825,1362,60.57%,29.44%,1
新北市,板橋區,0977,434,474,908,60,968,1698,57.01%,25.56%,1
新北市,板橋區,0978,341,481,822,32,854,1495,57.12%,22.81%,1
新北市,板橋區,0979,411,391,802,54,856,1522,56.24%,27%,1
新北市,板橋區,0980,361,351,712,46,758,1279,59.27%,28.23%,1
新北市,板橋區,0981,337,383,720,52,772,1559,49.52%,21.62%,1
新北市,板橋區,0982,378,402,780,56,836,1537,54.39%,24.59%,1
新北市,板橋區,0983,389,356,745,54,799,1531,52.19%,25.41%,1
新北市,板橋區,0984,432,481,913,27,940,1720,54.65%,25.12%,1
新北市,板橋區,0985,299,326,625,21,646,1165,55.45%,25.67%,1
新北市,板橋區,0986,462,564,1026,55,1081,1857,58.21%,24.88%,1
新北市,板橋區,0987,324,265,589,33,622,1078,57.7%,30.06%,1
新北市,板橋區,0988,352,312,664,16,680,1177,57.77%,29.91%,1
新北市,板橋區,0989,405,600,1005,37,1042,1798,57.95%,22.53%,1
新北市,板橋區,0990,412,412,824,60,884,1455,60.76%,28.32%,1
新北市,板橋區,0991,364,354,718,51,769,1245,61.77%,29.24%,1
新北市,板橋區,0992,431,454,885,62,947,1704,55.58%,25.29%,1
新北市,板橋區,0993,366,530,896,26,922,1600,57.63%,22.88%,1
新北市,板橋區,0994,368,337,705,34,739,1409,52.45%,26.12%,1
新北市,板橋區,0995,345,355,700,43,743,1286,57.78%,26.83%,1
新北市,板橋區,0996,311,304,615,58,673,1359,49.52%,22.88%,1
新北市,板橋區,0997,305,284,589,46,635,1188,53.45%,25.67%,1
新北市,板橋區,0998,496,378,874,35,909,1627,55.87%,30.49%,1
新北市,板橋區,0999,438,413,851,29,880,1633,53.89%,26.82%,1
新北市,板橋區,1000,441,579,1020,64,1084,1814,59.76%,24.31%,1
新北市,板橋區,1001,451,543,994,46,1040,1810,57.46%,24.92%,1
新北市,板橋區,1002,313,305,618,48,666,1133,58.78%,27.63%,1
新北市,板橋區,1003,265,205,470,30,500,841,59.45%,31.51%,1
新北市,板橋區,1004,317,314,631,33,664,1050,63.24%,30.19%,1
新北市,板橋區,1005,345,248,593,52,645,1130,57.08%,30.53%,1
新北市,板橋區,1006,332,294,626,35,661,1056,62.59%,31.44%,1
新北市,板橋區,1007,351,255,606,26,632,1129,55.98%,31.09%,1
新北市,板橋區,1008,440,487,927,52,979,1713,57.15%,25.69%,1
新北市,板橋區,1009,431,486,917,55,972,1622,59.93%,26.57%,1
新北市,板橋區,1010,365,482,847,56,903,1427,63.28%,25.58%,1
新北市,板橋區,1011,395,498,893,24,917,1471,62.34%,26.85%,1
新北市,板橋區,1012,343,243,586,19,605,1076,56.23%,31.88%,1
新北市,板橋區,1013,259,237,496,20,516,979,52.71%,26.46%,1
新北市,板橋區,1014,313,347,660,26,686,1079,63.58%,29.01%,1
新北市,板橋區,1015,237,198,435,36,471,828,56.88%,28.62%,1
新北市,板橋區,1016,269,209,478,41,519,820,63.29%,32.8%,1
新北市,板橋區,1017,336,254,590,22,612,989,61.88%,33.97%,1
新北市,板橋區,1018,272,271,543,54,597,1023,58.36%,26.59%,1
新北市,板橋區,1019,289,274,563,28,591,1044,56.61%,27.68%,1
新北市,板橋區,1020,262,266,528,52,580,968,59.92%,27.07%,1
新北市,板橋區,1021,361,356,717,27,744,1222,60.88%,29.54%,1
新北市,板橋區,1022,409,352,761,30,791,1385,57.11%,29.53%,1
新北市,板橋區,1023,409,430,839,44,883,1585,55.71%,25.8%,1
新北市,板橋區,1024,456,518,974,54,1028,1840,55.87%,24.78%,1
新北市,板橋區,1025,446,617,1063,62,1125,1806,62.29%,24.7%,1
新北市,板橋區,1026,433,374,807,54,861,1506,57.17%,28.75%,1
新北市,板橋區,1027,385,370,755,56,811,1476,54.95%,26.08%,1
新北市,板橋區,1028,385,451,836,50,886,1500,59.07%,25.67%,1
新北市,板橋區,1029,313,351,664,27,691,1096,63.05%,28.56%,1
新北市,板橋區,1030,277,288,565,39,604,963,62.72%,28.76%,1
新北市,板橋區,1031,448,435,883,40,923,1601,57.65%,27.98%,1
新北市,板橋區,1032,437,463,900,42,942,1507,62.51%,29%,1
新北市,板橋區,1033,394,387,781,47,828,1315,62.97%,29.96%,1
新北市,板橋區,1034,321,324,645,28,673,1178,57.13%,27.25%,1
新北市,板橋區,1035,493,558,1051,56,1107,1822,60.76%,27.06%,1
新北市,板橋區,1036,458,492,950,54,1004,1605,62.55%,28.54%,1
新北市,板橋區,1037,359,529,888,29,917,1549,59.2%,23.18%,1
新北市,板橋區,1038,485,637,1122,38,1160,1948,59.55%,24.9%,1
新北市,板橋區,1039,430,612,1042,44,1086,1935,56.12%,22.22%,1
新北市,板橋區,1040,318,258,576,31,607,1097,55.33%,28.99%,1
新北市,板橋區,1041,300,277,577,37,614,1095,56.07%,27.4%,1
新北市,板橋區,1042,431,448,879,66,945,1678,56.32%,25.69%,1
新北市,板橋區,1043,453,459,912,54,966,1750,55.2%,25.89%,1
新北市,板橋區,1044,284,328,612,51,663,1187,55.86%,23.93%,1
新北市,板橋區,1045,305,359,664,30,694,1154,60.14%,26.43%,1
新北市,板橋區,1046,403,345,748,28,776,1262,61.49%,31.93%,1
新北市,板橋區,1047,325,364,689,41,730,1271,57.44%,25.57%,1
新北市,板橋區,1048,395,358,753,59,812,1410,57.59%,28.01%,1
新北市,板橋區,1049,427,441,868,62,930,1745,53.3%,24.47%,1
新北市,板橋區,1050,522,462,984,75,1059,1867,56.72%,27.96%,1
新北市,板橋區,1051,468,519,987,60,1047,1753,59.73%,26.7%,1
新北市,板橋區,1052,337,354,691,32,723,1204,60.05%,27.99%,1
新北市,板橋區,1053,386,447,833,63,896,1614,55.51%,23.92%,1
新北市,板橋區,1054,371,345,716,32,748,1237,60.47%,29.99%,1
新北市,板橋區,1055,401,357,758,52,810,1361,59.52%,29.46%,1
新北市,板橋區,1056,376,340,716,23,739,1243,59.45%,30.25%,1
新北市,板橋區,1057,358,411,769,28,797,1515,52.61%,23.63%,1
新北市,板橋區,1058,441,423,864,50,914,1515,60.33%,29.11%,1
新北市,板橋區,1059,274,277,551,33,584,949,61.54%,28.87%,1
新北市,板橋區,1060,384,461,845,46,891,1629,54.7%,23.57%,1
新北市,板橋區,1061,380,317,697,38,735,1238,59.37%,30.69%,1
新北市,板橋區,1062,219,163,382,16,398,901,44.17%,24.31%,1
新北市,板橋區,1063,388,426,814,58,872,1475,59.12%,26.31%,1
新北市,板橋區,1064,420,370,790,46,836,1481,56.45%,28.36%,1
新北市,板橋區,1065,401,504,905,54,959,1800,53.28%,22.28%,1
新北市,板橋區,1066,459,421,880,35,915,1630,56.13%,28.16%,1
新北市,板橋區,1067,349,406,755,27,782,1298,60.25%,26.89%,1
新北市,板橋區,1068,273,232,505,26,531,874,60.76%,31.24%,1
新北市,板橋區,1069,308,261,569,14,583,992,58.77%,31.05%,1
新北市,板橋區,1070,296,351,647,30,677,1034,65.47%,28.63%,1
新北市,板橋區,1071,413,410,823,50,873,1451,60.17%,28.46%,1
新北市,板橋區,1072,347,328,675,34,709,1130,62.74%,30.71%,1
新北市,板橋區,1073,339,476,815,35,850,1440,59.03%,23.54%,1
新北市,板橋區,1074,379,464,843,65,908,1531,59.31%,24.76%,1
新北市,板橋區,1075,384,437,821,42,863,1349,63.97%,28.47%,1
新北市,板橋區,1076,438,401,839,38,877,1593,55.05%,27.5%,1
新北市,板橋區,1077,296,348,644,26,670,1174,57.07%,25.21%,1
新北市,板橋區,1078,319,346,665,47,712,1228,57.98%,25.98%,1
新北市,板橋區,1079,377,336,713,15,728,1187,61.33%,31.76%,1
新北市,板橋區,1080,247,260,507,34,541,870,62.18%,28.39%,1
新北市,板橋區,1081,446,747,1193,34,1227,2033,60.35%,21.94%,1
新北市,板橋區,1082,375,355,730,42,772,1418,54.44%,26.45%,1
新北市,板橋區,1083,305,291,596,30,626,1075,58.23%,28.37%,1
新北市,板橋區,1084,386,419,805,29,834,1515,55.05%,25.48%,1
新北市,板橋區,1085,369,368,737,36,773,1182,65.4%,31.22%,1
新北市,板橋區,1086,472,552,1024,32,1056,1893,55.78%,24.93%,1
新北市,板橋區,1087,325,355,680,51,731,1302,56.14%,24.96%,1
新北市,板橋區,1088,357,345,702,33,735,1366,53.81%,26.13%,1
新北市,板橋區,1089,358,418,776,49,825,1318,62.59%,27.16%,1
新北市,板橋區,1090,337,340,677,20,697,1200,58.08%,28.08%,1
新北市,板橋區,1091,524,585,1109,38,1147,2028,56.56%,25.84%,1
新北市,板橋區,1092,611,355,966,61,1027,1746,58.82%,34.99%,1
新北市,板橋區,1093,425,544,969,33,1002,1954,51.28%,21.75%,1
新北市,板橋區,1094,354,446,800,34,834,1474,56.58%,24.02%,1
新北市,板橋區,1095,395,377,772,41,813,1418,57.33%,27.86%,1
新北市,板橋區,1096,493,431,924,52,976,1563,62.44%,31.54%,1
新北市,板橋區,1097,468,457,925,52,977,1780,54.89%,26.29%,1
新北市,板橋區,1098,446,482,928,29,957,1707,56.06%,26.13%,1
新北市,板橋區,1099,171,188,359,18,377,906,41.61%,18.87%,1
新北市,板橋區,1100,265,288,553,42,595,1030,57.77%,25.73%,1
新北市,板橋區,1101,330,310,640,22,662,1115,59.37%,29.6%,1
新北市,板橋區,1102,415,560,975,30,1005,1836,54.74%,22.6%,1
新北市,板橋區,1103,473,532,1005,51,1056,1881,56.14%,25.15%,1
新北市,板橋區,1104,408,509,917,33,950,1688,56.28%,24.17%,1
新北市,板橋區,1105,403,609,1012,30,1042,1760,59.2%,22.9%,1
新北市,板橋區,1106,296,325,621,40,661,1044,63.31%,28.35%,1
新北市,板橋區,1107,296,335,631,32,663,1043,63.57%,28.38%,1
新北市,板橋區,1108,300,360,660,33,693,1099,63.06%,27.3%,1
新北市,板橋區,1109,351,383,734,36,770,1260,61.11%,27.86%,1
新北市,板橋區,1110,287,340,627,34,661,1131,58.44%,25.38%,1
新北市,板橋區,1111,364,323,687,39,726,1225,59.27%,29.71%,1
新北市,板橋區,1112,419,469,888,28,916,1455,62.96%,28.8%,1
新北市,板橋區,1113,374,307,681,52,733,1267,57.85%,29.52%,1
新北市,板橋區,1114,323,239,562,37,599,972,61.63%,33.23%,1
新北市,板橋區,1115,285,305,590,28,618,994,62.17%,28.67%,1
新北市,板橋區,1116,321,321,642,23,665,1111,59.86%,28.89%,1
新北市,板橋區,1117,372,365,737,45,782,1177,66.44%,31.61%,1
新北市,板橋區,1118,361,449,810,48,858,1544,55.57%,23.38%,1
新北市,板橋區,1119,263,283,546,52,598,1021,58.57%,25.76%,1
新北市,板橋區,1120,270,290,560,45,605,1040,58.17%,25.96%,1
新北市,板橋區,1121,345,454,799,31,830,1504,55.19%,22.94%,1
新北市,板橋區,1122,283,447,730,20,750,1373,54.62%,20.61%,1
新北市,板橋區,1123,285,417,702,19,721,1210,59.59%,23.55%,1
新北市,板橋區,1124,398,523,921,50,971,1809,53.68%,22%,1
新北市,板橋區,1125,360,509,869,52,921,1551,59.38%,23.21%,1
新北市,板橋區,1126,346,472,818,21,839,1408,59.59%,24.57%,1
新北市,板橋區,1127,334,415,749,26,775,1285,60.31%,25.99%,1
新北市,板橋區,1128,341,336,677,35,712,1102,64.61%,30.94%,1
新北市,板橋區,1129,301,404,705,31,736,1399,52.61%,21.52%,1
新北市,板橋區,1130,420,515,935,49,984,1692,58.16%,24.82%,1
新北市,板橋區,1131,402,557,959,29,988,1625,60.8%,24.74%,1
新北市,板橋區,1132,440,518,958,52,1010,1712,59%,25.7%,1
新北市,板橋區,1133,338,373,711,25,736,1246,59.07%,27.13%,1
新北市,板橋區,1134,416,431,847,30,877,1471,59.62%,28.28%,1
新北市,板橋區,1135,420,554,974,59,1033,1761,58.66%,23.85%,1
新北市,板橋區,1136,83,430,513,53,566,1499,37.76%,5.54%,1
新北市,板橋區,1137,343,424,767,38,805,1528,52.68%,22.45%,1
新北市,板橋區,1138,432,462,894,40,934,1536,60.81%,28.13%,1
新北市,板橋區,1139,421,476,897,29,926,1550,59.74%,27.16%,1
新北市,板橋區,1140,526,607,1133,50,1183,2050,57.71%,25.66%,1
新北市,板橋區,1141,361,382,743,38,781,1300,60.08%,27.77%,1
新北市,板橋區,1142,351,504,855,36,891,1537,57.97%,22.84%,1
新北市,板橋區,1143,350,330,680,25,705,1341,52.57%,26.1%,1
新北市,板橋區,1144,387,519,906,25,931,1606,57.97%,24.1%,1
新北市,板橋區,1145,386,366,752,33,785,1433,54.78%,26.94%,1
新北市,板橋區,1146,410,464,874,31,905,1685,53.71%,24.33%,1
新北市,板橋區,1147,338,397,735,46,781,1248,62.58%,27.08%,1
新北市,板橋區,1148,279,346,625,35,660,1172,56.31%,23.81%,1
新北市,板橋區,1149,406,409,815,23,838,1640,51.1%,24.76%,1
新北市,板橋區,1150,277,498,775,37,812,1428,56.86%,19.4%,1
新北市,板橋區,1151,369,450,819,62,881,1527,57.69%,24.17%,1
新北市,板橋區,1152,323,449,772,24,796,1350,58.96%,23.93%,1
新北市,板橋區,1153,354,520,874,35,909,1582,57.46%,22.38%,1
新北市,板橋區,1154,209,356,565,37,602,919,65.51%,22.74%,1
新北市,板橋區,1155,226,297,523,23,546,930,58.71%,24.3%,1
新北市,板橋區,1156,247,357,604,24,628,974,64.48%,25.36%,1
新北市,板橋區,1157,362,597,959,40,999,1732,57.68%,20.9%,1
新北市,板橋區,1158,334,439,773,44,817,1438,56.82%,23.23%,1
新北市,板橋區,1159,448,458,906,71,977,1777,54.98%,25.21%,1
新北市,板橋區,1160,366,465,831,56,887,1764,50.28%,20.75%,1
新北市,板橋區,1161,409,297,706,21,727,1289,56.4%,31.73%,1
新北市,板橋區,1162,359,341,700,27,727,1182,61.51%,30.37%,1
新北市,板橋區,1163,338,337,675,33,708,1174,60.31%,28.79%,1
新北市,板橋區,1164,464,497,961,52,1013,1870,54.17%,24.81%,1
新北市,板橋區,1165,460,575,1035,49,1084,1842,58.85%,24.97%,1
新北市,板橋區,1166,259,342,601,43,644,1094,58.87%,23.67%,1
新北市,板橋區,1167,296,337,633,46,679,1228,55.29%,24.1%,1
新北市,板橋區,1168,293,333,626,34,660,998,66.13%,29.36%,1
新北市,板橋區,1169,276,268,544,29,573,862,66.47%,32.02%,1
新北市,板橋區,1170,402,415,817,40,857,1622,52.84%,24.78%,1
新北市,板橋區,1171,355,322,677,50,727,1205,60.33%,29.46%,1
新北市,板橋區,1172,364,517,881,50,931,1787,52.1%,20.37%,1
新北市,板橋區,1173,342,550,892,33,925,1610,57.45%,21.24%,1
新北市,板橋區,1174,543,727,1270,42,1312,2216,59.21%,24.5%,1
新北市,板橋區,1175,516,715,1231,50,1281,2294,55.84%,22.49%,1
新北市,板橋區,1176,442,626,1068,66,1134,2090,54.26%,21.15%,1
新北市,板橋區,1177,277,385,662,27,689,1356,50.81%,20.43%,1
新北市,板橋區,1178,273,323,596,41,637,1067,59.7%,25.59%,1
新北市,板橋區,1179,374,348,722,39,761,1319,57.7%,28.35%,1
新北市,板橋區,1180,328,348,676,50,726,1316,55.17%,24.92%,1
新北市,板橋區,1181,323,289,612,43,655,1195,54.81%,27.03%,1
新北市,板橋區,1182,254,228,482,27,509,857,59.39%,29.64%,1
新北市,板橋區,1183,350,359,709,59,768,1417,54.2%,24.7%,1
新北市,板橋區,1184,424,424,848,64,912,1560,58.46%,27.18%,1
新北市,板橋區,1185,617,359,976,46,1022,1747,58.5%,35.32%,1
新北市,板橋區,1186,379,339,718,36,754,1176,64.12%,32.23%,1
新北市,板橋區,1187,327,300,627,32,659,1101,59.85%,29.7%,1
新北市,板橋區,1188,426,414,840,25,865,1458,59.33%,29.22%,1
新北市,板橋區,1189,405,404,809,29,838,1630,51.41%,24.85%,1
新北市,板橋區,1190,427,423,850,53,903,1611,56.05%,26.51%,1
新北市,板橋區,1191,321,285,606,33,639,1139,56.1%,28.18%,1
新北市,板橋區,1192,318,311,629,24,653,1120,58.3%,28.39%,1
新北市,板橋區,1193,286,329,615,49,664,1022,64.97%,27.98%,1
新北市,板橋區,1194,301,291,592,52,644,1049,61.39%,28.69%,1
新北市,板橋區,1195,232,344,576,18,594,1007,58.99%,23.04%,1
新北市,板橋區,1196,323,447,770,23,793,1393,56.93%,23.19%,1
新北市,板橋區,1197,80,90,170,32,202,474,42.62%,16.88%,1
新北市,板橋區,1198,147,129,276,26,302,500,60.4%,29.4%,1
新北市,板橋區,1199,313,337,650,30,680,1177,57.77%,26.59%,1
新北市,板橋區,1200,272,376,648,29,677,1186,57.08%,22.93%,1
新北市,板橋區,1201,329,326,655,49,704,1139,61.81%,28.88%,1
新北市,板橋區,1202,422,512,934,36,970,1750,55.43%,24.11%,1
新北市,板橋區,1203,505,677,1182,24,1206,3451,34.95%,14.63%,1
新北市,板橋區,1204,415,391,806,62,868,1620,53.58%,25.62%,1
新北市,板橋區,1205,228,209,437,22,459,903,50.83%,25.25%,1
新北市,板橋區,1206,348,352,700,21,721,1232,58.52%,28.25%,1
新北市,板橋區,1207,264,221,485,18,503,975,51.59%,27.08%,1
新北市,板橋區,1208,353,300,653,27,680,1224,55.56%,28.84%,1
新北市,板橋區,1209,339,381,720,29,749,1291,58.02%,26.26%,1
新北市,板橋區,1210,419,477,896,33,929,1828,50.82%,22.92%,1
新北市,板橋區,1211,423,427,850,44,894,1725,51.83%,24.52%,1
新北市,板橋區,1212,224,307,531,23,554,1085,51.06%,20.65%,1
新北市,板橋區,1213,542,646,1188,50,1238,2357,52.52%,23%,1
新北市,板橋區,1214,374,449,823,31,854,1560,54.74%,23.97%,1
新北市,板橋區,1215,459,532,991,27,1018,2201,46.25%,20.85%,1
新北市,板橋區,1216,407,444,851,44,895,1626,55.04%,25.03%,1
新北市,板橋區,1217,315,472,787,37,824,1786,46.14%,17.64%,1
新北市,板橋區,1218,449,468,917,43,960,1763,54.45%,25.47%,1
新北市,板橋區,1219,441,430,871,28,899,1744,51.55%,25.29%,1
新北市,板橋區,1220,423,429,852,42,894,1645,54.35%,25.71%,1
新北市,板橋區,1221,337,555,892,33,925,1861,49.7%,18.11%,1
新北市,板橋區,1222,370,411,781,30,811,1596,50.81%,23.18%,1
新北市,板橋區,1223,446,514,960,55,1015,1871,54.25%,23.84%,1
新北市,板橋區,1224,442,583,1025,49,1074,1938,55.42%,22.81%,1
新北市,板橋區,1225,434,542,976,41,1017,1827,55.67%,23.75%,1
新北市,板橋區,1226,293,404,697,26,723,1359,53.2%,21.56%,1
新北市,板橋區,1227,493,357,850,48,898,1613,55.67%,30.56%,1
新北市,板橋區,1228,412,414,826,64,890,1566,56.83%,26.31%,1
新北市,板橋區,1229,457,447,904,50,954,1552,61.47%,29.45%,1
新北市,板橋區,1230,485,492,977,26,1003,1885,53.21%,25.73%,1
新北市,板橋區,1231,483,500,983,36,1019,1893,53.83%,25.52%,1
新北市,三重區,0659,372,395,767,46,813,1509,53.88%,24.65%,1
新北市,三重區,0660,451,430,881,39,920,1591,57.83%,28.35%,1
新北市,三重區,0661,484,448,932,34,966,1653,58.44%,29.28%,1
新北市,三重區,0662,418,350,768,58,826,1392,59.34%,30.03%,1
新北市,三重區,0663,344,476,820,59,879,1451,60.58%,23.71%,1
新北市,三重區,0664,405,327,732,53,785,1329,59.07%,30.47%,1
新北市,三重區,0665,387,421,808,36,844,1459,57.85%,26.53%,1
新北市,三重區,0666,340,251,591,38,629,1024,61.43%,33.2%,1
新北市,三重區,0667,325,273,598,45,643,1066,60.32%,30.49%,1
新北市,三重區,0668,285,244,529,42,571,856,66.71%,33.29%,1
新北市,三重區,0669,226,201,427,15,442,764,57.85%,29.58%,1
新北市,三重區,0670,269,230,499,24,523,821,63.7%,32.76%,1
新北市,三重區,0671,499,449,948,43,991,1887,52.52%,26.44%,1
新北市,三重區,0672,487,361,848,24,872,1646,52.98%,29.59%,1
新北市,三重區,0673,139,89,228,10,238,358,66.48%,38.83%,1
新北市,三重區,0674,310,307,617,17,634,1039,61.02%,29.84%,1
新北市,三重區,0675,336,329,665,19,684,1114,61.4%,30.16%,1
新北市,三重區,0676,411,508,919,27,946,1588,59.57%,25.88%,1
新北市,三重區,0677,370,512,882,28,910,1702,53.47%,21.74%,1
新北市,三重區,0678,364,394,758,36,794,1288,61.65%,28.26%,1
新北市,三重區,0679,467,364,831,35,866,1629,53.16%,28.67%,1
新北市,三重區,0680,472,530,1002,50,1052,1861,56.53%,25.36%,1
新北市,三重區,0681,405,485,890,33,923,1727,53.45%,23.45%,1
新北市,三重區,0682,490,510,1000,26,1026,1813,56.59%,27.03%,1
新北市,三重區,0683,436,430,866,48,914,1595,57.3%,27.34%,1
新北市,三重區,0684,426,416,842,46,888,1513,58.69%,28.16%,1
新北市,三重區,0685,412,374,786,41,827,4433,18.66%,9.29%,1
新北市,三重區,0686,339,381,720,33,753,1283,58.69%,26.42%,1
新北市,三重區,0687,385,455,840,34,874,1430,61.12%,26.92%,1
新北市,三重區,0688,340,455,795,20,815,1357,60.06%,25.06%,1
新北市,三重區,0689,290,262,552,23,575,963,59.71%,30.11%,1
新北市,三重區,0690,262,240,502,29,531,883,60.14%,29.67%,1
新北市,三重區,0691,382,424,806,58,864,1494,57.83%,25.57%,1
新北市,三重區,0692,422,471,893,58,951,1616,58.85%,26.11%,1
新北市,三重區,0693,374,332,706,54,760,1329,57.19%,28.14%,1
新北市,三重區,0694,354,413,767,45,812,1289,62.99%,27.46%,1
新北市,三重區,0695,377,401,778,46,824,1380,59.71%,27.32%,1
新北市,三重區,0696,447,487,934,31,965,1668,57.85%,26.8%,1
新北市,三重區,0697,342,388,730,42,772,1226,62.97%,27.9%,1
新北市,三重區,0698,422,398,820,40,860,1421,60.52%,29.7%,1
新北市,三重區,0699,356,401,757,46,803,1364,58.87%,26.1%,1
新北市,三重區,0700,352,358,710,34,744,1232,60.39%,28.57%,1
新北市,三重區,0701,371,361,732,50,782,1248,62.66%,29.73%,1
新北市,三重區,0702,359,348,707,50,757,1256,60.27%,28.58%,1
新北市,三重區,0703,476,408,884,49,933,1506,61.95%,31.61%,1
新北市,三重區,0704,471,464,935,52,987,1669,59.14%,28.22%,1
新北市,三重區,0705,363,353,716,55,771,1308,58.94%,27.75%,1
新北市,三重區,0706,405,385,790,43,833,1263,65.95%,32.07%,1
新北市,三重區,0707,424,364,788,50,838,1471,56.97%,28.82%,1
新北市,三重區,0708,434,376,810,67,877,1447,60.61%,29.99%,1
新北市,三重區,0709,429,380,809,30,839,1693,49.56%,25.34%,1
新北市,三重區,0710,516,541,1057,43,1100,2015,54.59%,25.61%,1
新北市,三重區,0711,422,486,908,47,955,1812,52.7%,23.29%,1
新北市,三重區,0712,399,390,789,31,820,1509,54.34%,26.44%,1
新北市,三重區,0713,398,399,797,48,845,1439,58.72%,27.66%,1
新北市,三重區,0714,399,391,790,42,832,1437,57.9%,27.77%,1
新北市,三重區,0715,388,474,862,57,919,1697,54.15%,22.86%,1
新北市,三重區,0716,541,457,998,31,1029,1793,57.39%,30.17%,1
新北市,三重區,0717,466,481,947,25,972,1603,60.64%,29.07%,1
新北市,三重區,0718,305,311,616,26,642,1166,55.06%,26.16%,1
新北市,三重區,0719,288,356,644,23,667,1126,59.24%,25.58%,1
新北市,三重區,0720,307,314,621,34,655,1291,50.74%,23.78%,1
新北市,三重區,0721,402,449,851,56,907,1597,56.79%,25.17%,1
新北市,三重區,0722,300,324,624,41,665,1081,61.52%,27.75%,1
新北市,三重區,0723,240,316,556,34,590,911,64.76%,26.34%,1
新北市,三重區,0724,395,435,830,33,863,1719,50.2%,22.98%,1
新北市,三重區,0725,351,331,682,46,728,1289,56.48%,27.23%,1
新北市,三重區,0726,383,366,749,54,803,1318,60.93%,29.06%,1
新北市,三重區,0727,446,473,919,45,964,1822,52.91%,24.48%,1
新北市,三重區,0728,310,320,630,65,695,1185,58.65%,26.16%,1
新北市,三重區,0729,341,322,663,59,722,1369,52.74%,24.91%,1
新北市,三重區,0730,402,409,811,54,865,1507,57.4%,26.68%,1
新北市,三重區,0731,263,256,519,39,558,926,60.26%,28.4%,1
新北市,三重區,0732,292,216,508,20,528,950,55.58%,30.74%,1
新北市,三重區,0733,419,411,830,58,888,1678,52.92%,24.97%,1
新北市,三重區,0734,312,268,580,58,638,1117,57.12%,27.93%,1
新北市,三重區,0735,314,337,651,53,704,1318,53.41%,23.82%,1
新北市,三重區,0736,397,370,767,31,798,1388,57.49%,28.6%,1
新北市,三重區,0737,282,279,561,42,603,1026,58.77%,27.49%,1
新北市,三重區,0738,305,344,649,36,685,1096,62.5%,27.83%,1
新北市,三重區,0739,249,296,545,26,571,967,59.05%,25.75%,1
新北市,三重區,0740,474,479,953,40,993,1871,53.07%,25.33%,1
新北市,三重區,0741,420,473,893,49,942,1663,56.64%,25.26%,1
新北市,三重區,0742,317,335,652,26,678,1208,56.13%,26.24%,1
新北市,三重區,0743,356,364,720,29,749,1398,53.58%,25.46%,1
新北市,三重區,0744,288,287,575,16,591,1078,54.82%,26.72%,1
新北市,三重區,0745,280,283,563,45,608,1102,55.17%,25.41%,1
新北市,三重區,0746,377,351,728,41,769,1393,55.2%,27.06%,1
新北市,三重區,0747,331,362,693,49,742,1251,59.31%,26.46%,1
新北市,三重區,0748,377,368,745,44,789,1234,63.94%,30.55%,1
新北市,三重區,0749,476,431,907,55,962,1661,57.92%,28.66%,1
新北市,三重區,0750,431,437,868,44,912,1590,57.36%,27.11%,1
新北市,三重區,0751,366,296,662,42,704,1182,59.56%,30.96%,1
新北市,三重區,0752,416,366,782,36,818,1369,59.75%,30.39%,1
新北市,三重區,0753,386,333,719,40,759,1222,62.11%,31.59%,1
新北市,三重區,0754,373,304,677,66,743,1304,56.98%,28.6%,1
新北市,三重區,0755,259,269,528,35,563,1054,53.42%,24.57%,1
新北市,三重區,0756,430,437,867,53,920,1635,56.27%,26.3%,1
新北市,三重區,0757,418,466,884,58,942,1779,52.95%,23.5%,1
新北市,三重區,0758,441,433,874,62,936,1633,57.32%,27.01%,1
新北市,三重區,0759,321,287,608,34,642,1107,57.99%,29%,1
新北市,三重區,0760,344,295,639,34,673,1021,65.92%,33.69%,1
新北市,三重區,0761,411,383,794,56,850,1649,51.55%,24.92%,1
新北市,三重區,0762,253,231,484,26,510,874,58.35%,28.95%,1
新北市,三重區,0763,411,368,779,53,832,1402,59.34%,29.32%,1
新北市,三重區,0764,412,409,821,54,875,1713,51.08%,24.05%,1
新北市,三重區,0765,254,203,457,35,492,973,50.57%,26.1%,1
新北市,三重區,0766,320,267,587,34,621,1038,59.83%,30.83%,1
新北市,三重區,0767,439,452,891,54,945,1833,51.55%,23.95%,1
新北市,三重區,0768,237,205,442,30,472,817,57.77%,29.01%,1
新北市,三重區,0769,381,400,781,47,828,1387,59.7%,27.47%,1
新北市,三重區,0770,240,225,465,15,480,784,61.22%,30.61%,1
新北市,三重區,0771,319,270,589,23,612,1096,55.84%,29.11%,1
新北市,三重區,0772,330,317,647,42,689,1163,59.24%,28.37%,1
新北市,三重區,0773,472,478,950,35,985,1868,52.73%,25.27%,1
新北市,三重區,0774,287,277,564,51,615,1117,55.06%,25.69%,1
新北市,三重區,0775,229,242,471,28,499,934,53.43%,24.52%,1
新北市,三重區,0776,362,350,712,41,753,1412,53.33%,25.64%,1
新北市,三重區,0777,321,321,642,41,683,1062,64.31%,30.23%,1
新北市,三重區,0778,219,241,460,53,513,891,57.58%,24.58%,1
新北市,三重區,0779,266,307,573,73,646,936,69.02%,28.42%,1
新北市,三重區,0780,301,266,567,32,599,1085,55.21%,27.74%,1
新北市,三重區,0781,285,248,533,18,551,1065,51.74%,26.76%,1
新北市,三重區,0782,397,367,764,47,811,1398,58.01%,28.4%,1
新北市,三重區,0783,397,451,848,41,889,1550,57.35%,25.61%,1
新北市,三重區,0784,421,432,853,62,915,1674,54.66%,25.15%,1
新北市,三重區,0785,323,343,666,49,715,1215,58.85%,26.58%,1
新北市,三重區,0786,459,398,857,32,889,1606,55.35%,28.58%,1
新北市,三重區,0787,314,331,645,28,673,1182,56.94%,26.57%,1
新北市,三重區,0788,344,340,684,45,729,1238,58.89%,27.79%,1
新北市,三重區,0789,402,360,762,45,807,1342,60.13%,29.96%,1
新北市,三重區,0790,391,384,775,51,826,1408,58.66%,27.77%,1
新北市,三重區,0791,460,477,937,63,1000,1770,56.5%,25.99%,1
新北市,三重區,0792,317,206,523,32,555,940,59.04%,33.72%,1
新北市,三重區,0793,266,260,526,20,546,975,56%,27.28%,1
新北市,三重區,0794,404,363,767,39,806,1507,53.48%,26.81%,1
新北市,三重區,0795,410,356,766,47,813,1419,57.29%,28.89%,1
新北市,三重區,0796,359,320,679,39,718,1257,57.12%,28.56%,1
新北市,三重區,0797,435,448,883,39,922,1619,56.95%,26.87%,1
新北市,三重區,0798,463,456,919,59,978,1745,56.05%,26.53%,1
新北市,三重區,0799,454,364,818,45,863,1519,56.81%,29.89%,1
新北市,三重區,0800,430,419,849,40,889,1682,52.85%,25.56%,1
新北市,三重區,0801,505,450,955,51,1006,1697,59.28%,29.76%,1
新北市,三重區,0802,287,262,549,40,589,1073,54.89%,26.75%,1
新北市,三重區,0803,243,239,482,30,512,924,55.41%,26.3%,1
新北市,三重區,0804,383,398,781,32,813,1613,50.4%,23.74%,1
新北市,三重區,0805,233,200,433,41,474,1034,45.84%,22.53%,1
新北市,三重區,0806,311,302,613,45,658,1118,58.86%,27.82%,1
新北市,三重區,0807,385,302,687,43,730,1269,57.53%,30.34%,1
新北市,三重區,0808,265,263,528,28,556,990,56.16%,26.77%,1
新北市,三重區,0809,398,315,713,52,765,1336,57.26%,29.79%,1
新北市,三重區,0810,403,464,867,37,904,1601,56.46%,25.17%,1
新北市,三重區,0811,446,481,927,37,964,1581,60.97%,28.21%,1
新北市,三重區,0812,434,313,747,30,777,1345,57.77%,32.27%,1
新北市,三重區,0813,338,372,710,50,760,1226,61.99%,27.57%,1
新北市,三重區,0814,388,420,808,60,868,1650,52.61%,23.52%,1
新北市,三重區,0815,291,324,615,41,656,1140,57.54%,25.53%,1
新北市,三重區,0816,418,401,819,30,849,1639,51.8%,25.5%,1
新北市,三重區,0817,455,459,914,46,960,1699,56.5%,26.78%,1
新北市,三重區,0818,474,471,945,49,994,1501,66.22%,31.58%,1
新北市,三重區,0819,433,409,842,31,873,1538,56.76%,28.15%,1
新北市,三重區,0820,388,416,804,46,850,1540,55.19%,25.19%,1
新北市,三重區,0821,360,321,681,37,718,1276,56.27%,28.21%,1
新北市,三重區,0822,404,387,791,40,831,1539,54%,26.25%,1
新北市,三重區,0823,375,296,671,34,705,1170,60.26%,32.05%,1
新北市,三重區,0824,339,263,602,38,640,1120,57.14%,30.27%,1
新北市,三重區,0825,478,486,964,56,1020,1789,57.02%,26.72%,1
新北市,三重區,0826,396,373,769,51,820,1520,53.95%,26.05%,1
新北市,三重區,0827,522,456,978,41,1019,1821,55.96%,28.67%,1
新北市,三重區,0828,390,375,765,36,801,1407,56.93%,27.72%,1
新北市,三重區,0829,427,375,802,34,836,1491,56.07%,28.64%,1
新北市,三重區,0830,397,391,788,33,821,1381,59.45%,28.75%,1
新北市,三重區,0831,354,321,675,44,719,1222,58.84%,28.97%,1
新北市,三重區,0832,463,533,996,1,997,1938,51.44%,23.89%,1
新北市,三重區,0833,463,431,894,30,924,1639,56.38%,28.25%,1
新北市,三重區,0834,434,430,864,51,915,1614,56.69%,26.89%,1
新北市,三重區,0835,434,455,889,50,939,1709,54.94%,25.39%,1
新北市,三重區,0836,435,442,877,41,918,1753,52.37%,24.81%,1
新北市,三重區,0837,444,340,784,42,826,1398,59.08%,31.76%,1
新北市,三重區,0838,503,392,895,37,932,1706,54.63%,29.48%,1
新北市,三重區,0839,443,449,892,45,937,1614,58.05%,27.45%,1
新北市,三重區,0840,472,392,864,58,922,1591,57.95%,29.67%,1
新北市,三重區,0841,500,364,864,58,922,1627,56.67%,30.73%,1
新北市,三重區,0842,438,379,817,58,875,1505,58.14%,29.1%,1
新北市,三重區,0843,424,322,746,35,781,1331,58.68%,31.86%,1
新北市,三重區,0844,389,416,805,33,838,1678,49.94%,23.18%,1
新北市,三重區,0845,434,393,827,22,849,1498,56.68%,28.97%,1
新北市,三重區,0846,496,469,965,65,1030,1800,57.22%,27.56%,1
新北市,三重區,0847,393,419,812,30,842,1703,49.44%,23.08%,1
新北市,三重區,0848,454,494,948,38,986,1975,49.92%,22.99%,1
新北市,三重區,0849,459,491,950,38,988,1894,52.16%,24.23%,1
新北市,三重區,0850,388,398,786,41,827,1405,58.86%,27.62%,1
新北市,三重區,0851,364,365,729,26,755,1293,58.39%,28.15%,1
新北市,三重區,0852,300,393,693,41,734,1259,58.3%,23.83%,1
新北市,三重區,0853,366,306,672,40,712,1144,62.24%,31.99%,1
新北市,三重區,0854,388,335,723,46,769,1254,61.32%,30.94%,1
新北市,三重區,0855,366,362,728,28,756,1313,57.58%,27.88%,1
新北市,三重區,0856,440,369,809,61,870,1594,54.58%,27.6%,1
新北市,三重區,0857,474,484,958,28,986,1775,55.55%,26.7%,1
新北市,三重區,0858,422,380,802,58,860,1516,56.73%,27.84%,1
新北市,三重區,0859,503,357,860,67,927,1315,70.49%,38.25%,1
新北市,三重區,0860,267,213,480,40,520,843,61.68%,31.67%,1
新北市,三重區,0861,296,272,568,43,611,1160,52.67%,25.52%,1
新北市,三重區,0862,287,285,572,50,622,1052,59.13%,27.28%,1
新北市,三重區,0863,355,269,624,43,667,1054,63.28%,33.68%,1
新北市,三重區,0864,299,239,538,53,591,997,59.28%,29.99%,1
新北市,三重區,0865,275,209,484,27,511,936,54.59%,29.38%,1
新北市,三重區,0866,450,409,859,49,908,1658,54.76%,27.14%,1
新北市,三重區,0867,401,370,771,47,818,1496,54.68%,26.8%,1
新北市,三重區,0868,331,294,625,36,661,1064,62.12%,31.11%,1
新北市,三重區,0869,337,328,665,39,704,1152,61.11%,29.25%,1
新北市,三重區,0870,361,426,787,37,824,1532,53.79%,23.56%,1
新北市,三重區,0871,335,309,644,35,679,1338,50.75%,25.04%,1
新北市,三重區,0872,381,346,727,40,767,1303,58.86%,29.24%,1
新北市,三重區,0873,358,404,762,60,822,1369,60.04%,26.15%,1
新北市,三重區,0874,389,407,796,52,848,1491,56.87%,26.09%,1
新北市,三重區,0875,436,433,869,79,948,1821,52.06%,23.94%,1
新北市,三重區,0876,403,532,935,38,973,1906,51.05%,21.14%,1
新北市,三重區,0877,482,531,1013,41,1054,1842,57.22%,26.17%,1
新北市,三重區,0878,231,226,457,26,483,878,55.01%,26.31%,1
新北市,三重區,0879,314,268,582,36,618,963,64.17%,32.61%,1
新北市,三重區,0880,346,371,717,30,747,1381,54.09%,25.05%,1
新北市,三重區,0881,404,393,797,62,859,1681,51.1%,24.03%,1
新北市,三重區,0882,405,390,795,24,819,1548,52.91%,26.16%,1
新北市,三重區,0883,445,407,852,42,894,1542,57.98%,28.86%,1
新北市,三重區,0884,397,425,822,44,866,1557,55.62%,25.5%,1
新北市,三重區,0885,364,508,872,31,903,1661,54.36%,21.91%,1
新北市,三重區,0886,451,635,1086,20,1106,2024,54.64%,22.28%,1
新北市,三重區,0887,391,370,761,42,803,1588,50.57%,24.62%,1
新北市,三重區,0888,443,431,874,66,940,1706,55.1%,25.97%,1
新北市,三重區,0889,379,380,759,30,789,1341,58.84%,28.26%,1
新北市,三重區,0890,309,241,550,34,584,1025,56.98%,30.15%,1
新北市,三重區,0891,346,368,714,52,766,1339,57.21%,25.84%,1
新北市,三重區,0892,457,454,911,58,969,1725,56.17%,26.49%,1
新北市,三重區,0893,479,470,949,54,1003,1826,54.93%,26.23%,1
新北市,中和區,1232,388,431,819,32,851,1630,52.21%,23.8%,1
新北市,中和區,1233,433,526,959,39,998,1775,56.23%,24.39%,1
新北市,中和區,1234,384,541,925,28,953,1844,51.68%,20.82%,1
新北市,中和區,1235,240,378,618,30,648,1019,63.59%,23.55%,1
新北市,中和區,1236,195,473,668,24,692,1138,60.81%,17.14%,1
新北市,中和區,1237,344,607,951,34,985,1878,52.45%,18.32%,1
新北市,中和區,1238,328,767,1095,39,1134,1980,57.27%,16.57%,1
新北市,中和區,1239,469,533,1002,56,1058,1844,57.38%,25.43%,1
新北市,中和區,1240,470,658,1128,33,1161,2085,55.68%,22.54%,1
新北市,中和區,1241,289,509,798,35,833,1498,55.61%,19.29%,1
新北市,中和區,1242,387,554,941,31,972,1761,55.2%,21.98%,1
新北市,中和區,1243,332,349,681,26,707,1254,56.38%,26.48%,1
新北市,中和區,1244,262,498,760,29,789,1343,58.75%,19.51%,1
新北市,中和區,1245,325,622,947,30,977,1789,54.61%,18.17%,1
新北市,中和區,1246,424,679,1103,33,1136,2000,56.8%,21.2%,1
新北市,中和區,1247,385,569,954,25,979,1953,50.13%,19.71%,1
新北市,中和區,1248,403,521,924,37,961,1712,56.13%,23.54%,1
新北市,中和區,1249,349,548,897,23,920,1582,58.15%,22.06%,1
新北市,中和區,1250,410,518,928,36,964,1742,55.34%,23.54%,1
新北市,中和區,1251,376,522,898,30,928,1493,62.16%,25.18%,1
新北市,中和區,1252,328,371,699,41,740,1352,54.73%,24.26%,1
新北市,中和區,1253,293,412,705,33,738,1244,59.32%,23.55%,1
新北市,中和區,1254,327,446,773,52,825,1394,59.18%,23.46%,1
新北市,中和區,1255,342,502,844,31,875,1917,45.64%,17.84%,1
新北市,中和區,1256,429,502,931,41,972,1830,53.11%,23.44%,1
新北市,中和區,1257,279,347,626,39,665,1124,59.16%,24.82%,1
新北市,中和區,1258,303,385,688,40,728,1412,51.56%,21.46%,1
新北市,中和區,1259,340,396,736,27,763,1356,56.27%,25.07%,1
新北市,中和區,1260,272,447,719,33,752,1425,52.77%,19.09%,1
新北市,中和區,1261,312,397,709,50,759,1259,60.29%,24.78%,1
新北市,中和區,1262,337,355,692,46,738,1256,58.76%,26.83%,1
新北市,中和區,1263,343,439,782,30,812,1423,57.06%,24.1%,1
新北市,中和區,1264,299,386,685,35,720,1221,58.97%,24.49%,1
新北市,中和區,1265,418,500,918,48,966,1858,51.99%,22.5%,1
新北市,中和區,1266,405,506,911,38,949,1804,52.61%,22.45%,1
新北市,中和區,1267,375,562,937,34,971,1669,58.18%,22.47%,1
新北市,中和區,1268,364,444,808,34,842,1485,56.7%,24.51%,1
新北市,中和區,1269,247,331,578,32,610,1005,60.7%,24.58%,1
新北市,中和區,1270,338,381,719,40,759,1175,64.6%,28.77%,1
新北市,中和區,1271,281,381,662,32,694,1171,59.27%,24%,1
新北市,中和區,1272,346,518,864,29,893,1746,51.15%,19.82%,1
新北市,中和區,1273,342,419,761,20,781,1555,50.23%,21.99%,1
新北市,中和區,1274,275,341,616,28,644,1112,57.91%,24.73%,1
新北市,中和區,1275,410,609,1019,39,1058,1780,59.44%,23.03%,1
新北市,中和區,1276,389,642,1031,43,1074,1918,56%,20.28%,1
新北市,中和區,1277,261,486,747,23,770,1689,45.59%,15.45%,1
新北市,中和區,1278,384,600,984,30,1014,1781,56.93%,21.56%,1
新北市,中和區,1279,305,474,779,38,817,1419,57.58%,21.49%,1
新北市,中和區,1280,301,406,707,32,739,1344,54.99%,22.4%,1
新北市,中和區,1281,373,710,1083,45,1128,1804,62.53%,20.68%,1
新北市,中和區,1282,415,498,913,51,964,1788,53.91%,23.21%,1
新北市,中和區,1283,401,573,974,39,1013,1793,56.5%,22.36%,1
新北市,中和區,1284,293,446,739,45,784,1352,57.99%,21.67%,1
新北市,中和區,1285,361,632,993,37,1030,1813,56.81%,19.91%,1
新北市,中和區,1286,277,520,797,25,822,1288,63.82%,21.51%,1
新北市,中和區,1287,288,364,652,33,685,1186,57.76%,24.28%,1
新北市,中和區,1288,315,324,639,10,649,1237,52.47%,25.46%,1
新北市,中和區,1289,350,400,750,57,807,1406,57.4%,24.89%,1
新北市,中和區,1290,318,454,772,39,811,1442,56.24%,22.05%,1
新北市,中和區,1291,307,323,630,27,657,1040,63.17%,29.52%,1
新北市,中和區,1292,330,412,742,46,788,1292,60.99%,25.54%,1
新北市,中和區,1293,429,514,943,48,991,1811,54.72%,23.69%,1
新北市,中和區,1294,441,522,963,77,1040,1789,58.13%,24.65%,1
新北市,中和區,1295,158,374,532,32,564,859,65.66%,18.39%,1
新北市,中和區,1296,200,402,602,23,625,972,64.3%,20.58%,1
新北市,中和區,1297,347,397,744,34,778,1346,57.8%,25.78%,1
新北市,中和區,1298,289,316,605,23,628,1034,60.74%,27.95%,1
新北市,中和區,1299,323,444,767,38,805,1387,58.04%,23.29%,1
新北市,中和區,1300,435,669,1104,78,1182,2067,57.18%,21.04%,1
新北市,中和區,1301,375,399,774,31,805,1670,48.2%,22.46%,1
新北市,中和區,1302,251,380,631,35,666,1166,57.12%,21.53%,1
新北市,中和區,1303,224,321,545,29,574,963,59.61%,23.26%,1
新北市,中和區,1304,186,360,546,31,577,1070,53.93%,17.38%,1
新北市,中和區,1305,256,454,710,36,746,1319,56.56%,19.41%,1
新北市,中和區,1306,310,539,849,35,884,1438,61.47%,21.56%,1
新北市,中和區,1307,314,593,907,30,937,1808,51.83%,17.37%,1
新北市,中和區,1308,180,438,618,14,632,1191,53.06%,15.11%,1
新北市,中和區,1309,339,520,859,51,910,1632,55.76%,20.77%,1
新北市,中和區,1310,326,562,888,29,917,1765,51.95%,18.47%,1
新北市,中和區,1311,160,500,660,36,696,1168,59.59%,13.7%,1
新北市,中和區,1312,216,429,645,20,665,1176,56.55%,18.37%,1
新北市,中和區,1313,253,691,944,50,994,1565,63.51%,16.17%,1
新北市,中和區,1314,295,480,775,38,813,1578,51.52%,18.69%,1
新北市,中和區,1315,347,729,1076,32,1108,2029,54.61%,17.1%,1
新北市,中和區,1316,211,283,494,28,522,905,57.68%,23.31%,1
新北市,中和區,1317,160,252,412,31,443,839,52.8%,19.07%,1
新北市,中和區,1318,160,270,430,15,445,762,58.4%,21%,1
新北市,中和區,1319,271,476,747,52,799,1420,56.27%,19.08%,1
新北市,中和區,1320,245,406,651,46,697,1272,54.8%,19.26%,1
新北市,中和區,1321,359,650,1009,47,1056,1976,53.44%,18.17%,1
新北市,中和區,1322,319,618,937,33,970,1779,54.53%,17.93%,1
新北市,中和區,1323,291,396,687,39,726,1454,49.93%,20.01%,1
新北市,中和區,1324,247,449,696,34,730,1374,53.13%,17.98%,1
新北市,中和區,1325,264,401,665,33,698,1369,50.99%,19.28%,1
新北市,中和區,1326,284,493,777,51,828,1501,55.16%,18.92%,1
新北市,中和區,1327,223,332,555,48,603,920,65.54%,24.24%,1
新北市,中和區,1328,238,380,618,35,653,1050,62.19%,22.67%,1
新北市,中和區,1329,85,95,180,18,198,321,61.68%,26.48%,1
新北市,中和區,1330,306,433,739,48,787,1474,53.39%,20.76%,1
新北市,中和區,1331,304,485,789,54,843,1461,57.7%,20.81%,1
新北市,中和區,1332,326,510,836,34,870,1621,53.67%,20.11%,1
新北市,中和區,1333,276,496,772,55,827,1327,62.32%,20.8%,1
新北市,中和區,1334,199,231,430,20,450,775,58.06%,25.68%,1
新北市,中和區,1335,335,601,936,28,964,1916,50.31%,17.48%,1
新北市,中和區,1336,360,588,948,45,993,1901,52.24%,18.94%,1
新北市,中和區,1337,317,452,769,36,805,4411,18.25%,7.19%,1
新北市,中和區,1338,271,397,668,19,687,1212,56.68%,22.36%,1
新北市,中和區,1339,257,367,624,30,654,1126,58.08%,22.82%,1
新北市,中和區,1340,302,489,791,26,817,1507,54.21%,20.04%,1
新北市,中和區,1341,268,552,820,16,836,1519,55.04%,17.64%,1
新北市,中和區,1342,320,486,806,36,842,1467,57.4%,21.81%,1
新北市,中和區,1343,344,498,842,48,890,1453,61.25%,23.68%,1
新北市,中和區,1344,267,526,793,35,828,1364,60.7%,19.57%,1
新北市,中和區,1345,275,432,707,32,739,1302,56.76%,21.12%,1
新北市,中和區,1346,223,497,720,24,744,1627,45.73%,13.71%,1
新北市,中和區,1347,339,439,778,35,813,1503,54.09%,22.55%,1
新北市,中和區,1348,298,438,736,15,751,1392,53.95%,21.41%,1
新北市,中和區,1349,243,361,604,34,638,1067,59.79%,22.77%,1
新北市,中和區,1350,354,474,828,36,864,1623,53.23%,21.81%,1
新北市,中和區,1351,256,419,675,24,699,1208,57.86%,21.19%,1
新北市,中和區,1352,333,531,864,29,893,1991,44.85%,16.73%,1
新北市,中和區,1353,323,546,869,41,910,1932,47.1%,16.72%,1
新北市,中和區,1354,224,383,607,24,631,947,66.63%,23.65%,1
新北市,中和區,1355,364,555,919,44,963,1660,58.01%,21.93%,1
新北市,中和區,1356,296,457,753,39,792,1574,50.32%,18.81%,1
新北市,中和區,1357,350,691,1041,43,1084,2136,50.75%,16.39%,1
新北市,中和區,1358,299,441,740,50,790,1462,54.04%,20.45%,1
新北市,中和區,1359,318,452,770,46,816,1548,52.71%,20.54%,1
新北市,中和區,1360,172,269,441,18,459,692,66.33%,24.86%,1
新北市,中和區,1361,239,488,727,42,769,1221,62.98%,19.57%,1
新北市,中和區,1362,315,436,751,41,792,1331,59.5%,23.67%,1
新北市,中和區,1363,236,348,584,35,619,984,62.91%,23.98%,1
新北市,中和區,1364,344,570,914,35,949,1871,50.72%,18.39%,1
新北市,中和區,1365,262,419,681,43,724,1279,56.61%,20.48%,1
新北市,中和區,1366,375,510,885,42,927,1629,56.91%,23.02%,1
新北市,中和區,1367,331,485,816,31,847,1482,57.15%,22.33%,1
新北市,中和區,1368,414,546,960,41,1001,1715,58.37%,24.14%,1
新北市,中和區,1369,373,680,1053,52,1105,1952,56.61%,19.11%,1
新北市,中和區,1370,205,180,385,23,408,686,59.48%,29.88%,1
新北市,中和區,1371,370,377,747,32,779,1577,49.4%,23.46%,1
新北市,中和區,1372,295,358,653,29,682,1158,58.89%,25.47%,1
新北市,中和區,1373,315,436,751,16,767,1195,64.18%,26.36%,1
新北市,中和區,1374,243,411,654,22,676,1054,64.14%,23.06%,1
新北市,中和區,1375,167,216,383,15,398,612,65.03%,27.29%,1
新北市,中和區,1376,401,538,939,28,967,1668,57.97%,24.04%,1
新北市,中和區,1377,303,329,632,51,683,1071,63.77%,28.29%,1
新北市,中和區,1378,413,350,763,35,798,1169,68.26%,35.33%,1
新北市,中和區,1379,386,359,745,31,776,1370,56.64%,28.18%,1
新北市,中和區,1380,401,496,897,53,950,1574,60.36%,25.48%,1
新北市,中和區,1381,466,711,1177,29,1206,2614,46.14%,17.83%,1
新北市,中和區,1382,353,499,852,26,878,1477,59.44%,23.9%,1
新北市,中和區,1383,307,276,583,34,617,1041,59.27%,29.49%,1
新北市,中和區,1384,362,427,789,50,839,1538,54.55%,23.54%,1
新北市,中和區,1385,426,418,844,42,886,1599,55.41%,26.64%,1
新北市,中和區,1386,433,457,890,53,943,1586,59.46%,27.3%,1
新北市,中和區,1387,479,517,996,50,1046,1726,60.6%,27.75%,1
新北市,中和區,1388,527,554,1081,56,1137,1854,61.33%,28.43%,1
新北市,中和區,1389,481,375,856,42,898,1472,61.01%,32.68%,1
新北市,中和區,1390,378,447,825,52,877,1430,61.33%,26.43%,1
新北市,中和區,1391,390,469,859,42,901,1488,60.55%,26.21%,1
新北市,中和區,1392,358,323,681,32,713,1251,56.99%,28.62%,1
新北市,中和區,1393,365,467,832,35,867,1487,58.31%,24.55%,1
新北市,中和區,1394,339,348,687,58,745,1328,56.1%,25.53%,1
新北市,中和區,1395,316,346,662,38,700,1128,62.06%,28.01%,1
新北市,中和區,1396,257,381,638,23,661,1008,65.58%,25.5%,1
新北市,中和區,1397,486,520,1006,27,1033,1786,57.84%,27.21%,1
新北市,中和區,1398,459,701,1160,46,1206,2219,54.35%,20.68%,1
新北市,中和區,1399,319,357,676,36,712,1322,53.86%,24.13%,1
新北市,中和區,1400,401,419,820,19,839,1495,56.12%,26.82%,1
新北市,中和區,1401,348,385,733,47,780,1414,55.16%,24.61%,1
新北市,中和區,1402,666,267,933,49,982,1681,58.42%,39.62%,1
新北市,中和區,1403,353,395,748,34,782,1361,57.46%,25.94%,1
新北市,中和區,1404,344,437,781,33,814,1442,56.45%,23.86%,1
新北市,中和區,1405,341,373,714,28,742,1383,53.65%,24.66%,1
新北市,中和區,1406,243,454,697,32,729,1264,57.67%,19.22%,1
新北市,中和區,1407,448,566,1014,79,1093,1810,60.39%,24.75%,1
新北市,中和區,1408,386,508,894,54,948,1951,48.59%,19.78%,1
新北市,中和區,1409,347,427,774,36,810,1582,51.2%,21.93%,1
新北市,中和區,1410,466,627,1093,59,1152,1945,59.23%,23.96%,1
新北市,中和區,1411,254,520,774,36,810,1390,58.27%,18.27%,1
新北市,中和區,1412,297,359,656,18,674,1161,58.05%,25.58%,1
新北市,中和區,1413,189,567,756,34,790,1399,56.47%,13.51%,1
新北市,中和區,1414,308,288,596,20,616,1070,57.57%,28.79%,1
新北市,中和區,1415,306,338,644,19,663,1169,56.72%,26.18%,1
新北市,中和區,1416,308,426,734,36,770,1214,63.43%,25.37%,1
新北市,中和區,1417,321,448,769,49,818,1398,58.51%,22.96%,1
新北市,中和區,1418,256,340,596,21,617,1049,58.82%,24.4%,1
新北市,中和區,1419,343,453,796,29,825,1324,62.31%,25.91%,1
新北市,中和區,1420,375,467,842,27,869,1765,49.24%,21.25%,1
新北市,中和區,1421,349,514,863,31,894,1709,52.31%,20.42%,1
新北市,中和區,1422,302,345,647,51,698,1186,58.85%,25.46%,1
新北市,中和區,1423,349,408,757,40,797,1318,60.47%,26.48%,1
新北市,中和區,1424,370,433,803,37,840,1430,58.74%,25.87%,1
新北市,中和區,1425,350,361,711,26,737,1637,45.02%,21.38%,1
新北市,中和區,1426,324,376,700,37,737,1283,57.44%,25.25%,1
新北市,中和區,1427,338,383,721,39,760,1310,58.02%,25.8%,1
新北市,中和區,1428,338,382,720,44,764,1301,58.72%,25.98%,1
新北市,中和區,1429,454,482,936,42,978,1681,58.18%,27.01%,1
新北市,中和區,1430,361,447,808,18,826,1384,59.68%,26.08%,1
新北市,中和區,1431,326,324,650,33,683,1187,57.54%,27.46%,1
新北市,中和區,1432,350,451,801,5,806,1779,45.31%,19.67%,1
新北市,中和區,1433,352,586,938,37,975,1712,56.95%,20.56%,1
新北市,中和區,1434,312,456,768,27,795,1462,54.38%,21.34%,1
新北市,中和區,1435,322,619,941,31,972,1824,53.29%,17.65%,1
新北市,中和區,1436,310,427,737,41,778,1389,56.01%,22.32%,1
新北市,中和區,1437,293,522,815,40,855,1434,59.62%,20.43%,1
新北市,中和區,1438,361,643,1004,46,1050,1953,53.76%,18.48%,1
新北市,中和區,1439,425,639,1064,63,1127,2002,56.29%,21.23%,1
新北市,中和區,1440,329,648,977,29,1006,1858,54.14%,17.71%,1
新北市,中和區,1441,349,622,971,24,995,1801,55.25%,19.38%,1
新北市,中和區,1442,323,617,940,40,980,1691,57.95%,19.1%,1
新北市,中和區,1443,280,501,781,34,815,1363,59.79%,20.54%,1
新北市,中和區,1444,270,481,751,26,777,1220,63.69%,22.13%,1
新北市,中和區,1445,290,551,841,22,863,1365,63.22%,21.25%,1
新北市,中和區,1446,240,433,673,28,701,1178,59.51%,20.37%,1
新北市,中和區,1447,202,284,486,24,510,830,61.45%,24.34%,1
新北市,中和區,1448,256,335,591,50,641,1197,53.55%,21.39%,1
新北市,中和區,1449,293,471,764,45,809,1369,59.09%,21.4%,1
新北市,中和區,1450,301,469,770,31,801,1336,59.96%,22.53%,1
新北市,中和區,1451,283,541,824,45,869,1377,63.11%,20.55%,1
新北市,中和區,1452,332,512,844,46,890,1499,59.37%,22.15%,1
新北市,中和區,1453,390,586,976,35,1011,1689,59.86%,23.09%,1
新北市,中和區,1454,346,421,767,32,799,1323,60.39%,26.15%,1
新北市,中和區,1455,272,378,650,29,679,1079,62.93%,25.21%,1
新北市,中和區,1456,363,489,852,57,909,1545,58.83%,23.5%,1
新北市,中和區,1457,302,412,714,37,751,1326,56.64%,22.78%,1
新北市,中和區,1458,300,481,781,20,801,1443,55.51%,20.79%,1
新北市,中和區,1459,351,604,955,20,975,1712,56.95%,20.5%,1
新北市,中和區,1460,357,643,1000,53,1053,1916,54.96%,18.63%,1
新北市,中和區,1461,211,305,516,25,541,863,62.69%,24.45%,1
新北市,中和區,1462,256,482,738,12,750,1203,62.34%,21.28%,1
新北市,中和區,1463,236,551,787,22,809,1483,54.55%,15.91%,1
新北市,中和區,1464,248,559,807,38,845,1575,53.65%,15.75%,1
新北市,中和區,1465,217,468,685,42,727,1432,50.77%,15.15%,1
新北市,中和區,1466,274,489,763,51,814,1441,56.49%,19.01%,1
新北市,中和區,1467,264,461,725,38,763,1269,60.13%,20.8%,1
新北市,中和區,1468,277,505,782,33,815,1363,59.79%,20.32%,1
新北市,中和區,1469,403,408,811,27,838,1089,76.95%,37.01%,1
新北市,中和區,1470,243,358,601,28,629,1171,53.71%,20.75%,1
新北市,中和區,1471,243,400,643,28,671,1150,58.35%,21.13%,1
新北市,中和區,1472,253,443,696,31,727,1154,63%,21.92%,1
新北市,中和區,1473,218,410,628,35,663,1067,62.14%,20.43%,1
新北市,中和區,1474,293,512,805,30,835,1526,54.72%,19.2%,1
新北市,中和區,1475,331,491,822,32,854,1447,59.02%,22.87%,1
新北市,永和區,1476,334,533,867,53,920,1554,59.2%,21.49%,1
新北市,永和區,1477,224,396,620,21,641,1065,60.19%,21.03%,1
新北市,永和區,1478,197,320,517,32,549,854,64.29%,23.07%,1
新北市,永和區,1479,259,471,730,33,763,1253,60.89%,20.67%,1
新北市,永和區,1480,334,616,950,40,990,1733,57.13%,19.27%,1
新北市,永和區,1481,314,548,862,39,901,1581,56.99%,19.86%,1
新北市,永和區,1482,337,582,919,46,965,1735,55.62%,19.42%,1
新北市,永和區,1483,281,552,833,20,853,1563,54.57%,17.98%,1
新北市,永和區,1484,322,630,952,39,991,1650,60.06%,19.52%,1
新北市,永和區,1485,267,528,795,38,833,1454,57.29%,18.36%,1
新北市,永和區,1486,357,415,772,42,814,1568,51.91%,22.77%,1
新北市,永和區,1487,309,462,771,34,805,1444,55.75%,21.4%,1
新北市,永和區,1488,277,348,625,35,660,1140,57.89%,24.3%,1
新北市,永和區,1489,278,428,706,33,739,1188,62.21%,23.4%,1
新北市,永和區,1490,314,493,807,48,855,1516,56.4%,20.71%,1
新北市,永和區,1491,280,468,748,34,782,1397,55.98%,20.04%,1
新北市,永和區,1492,311,479,790,28,818,1438,56.88%,21.63%,1
新北市,永和區,1493,241,383,624,34,658,1084,60.7%,22.23%,1
新北市,永和區,1494,285,248,533,27,560,941,59.51%,30.29%,1
新北市,永和區,1495,302,534,836,42,878,1598,54.94%,18.9%,1
新北市,永和區,1496,318,542,860,29,889,2842,31.28%,11.19%,1
新北市,永和區,1497,288,466,754,40,794,1261,62.97%,22.84%,1
新北市,永和區,1498,331,569,900,30,930,1449,64.18%,22.84%,1
新北市,永和區,1499,301,554,855,37,892,1511,59.03%,19.92%,1
新北市,永和區,1500,319,573,892,38,930,1470,63.27%,21.7%,1
新北市,永和區,1501,310,576,886,33,919,1580,58.16%,19.62%,1
新北市,永和區,1502,279,576,855,40,895,1438,62.24%,19.4%,1
新北市,永和區,1503,272,533,805,27,832,1305,63.75%,20.84%,1
新北市,永和區,1504,292,406,698,17,715,1046,68.36%,27.92%,1
新北市,永和區,1505,336,555,891,20,911,1566,58.17%,21.46%,1
新北市,永和區,1506,374,484,858,28,886,1468,60.35%,25.48%,1
新北市,永和區,1507,324,520,844,27,871,1305,66.74%,24.83%,1
新北市,永和區,1508,287,425,712,27,739,1181,62.57%,24.3%,1
新北市,永和區,1509,340,576,916,40,956,1720,55.58%,19.77%,1
新北市,永和區,1510,296,383,679,31,710,1103,64.37%,26.84%,1
新北市,永和區,1511,377,557,934,38,972,1649,58.94%,22.86%,1
新北市,永和區,1512,272,457,729,31,760,1206,63.02%,22.55%,1
新北市,永和區,1513,342,522,864,38,902,1506,59.89%,22.71%,1
新北市,永和區,1514,295,512,807,46,853,1488,57.33%,19.83%,1
新北市,永和區,1515,284,476,760,44,804,1288,62.42%,22.05%,1
新北市,永和區,1516,261,477,738,31,769,1413,54.42%,18.47%,1
新北市,永和區,1517,248,491,739,40,779,1329,58.62%,18.66%,1
新北市,永和區,1518,290,569,859,36,895,1436,62.33%,20.19%,1
新北市,永和區,1519,257,378,635,33,668,1112,60.07%,23.11%,1
新北市,永和區,1520,269,452,721,24,745,1100,67.73%,24.45%,1
新北市,永和區,1521,348,566,914,45,959,1545,62.07%,22.52%,1
新北市,永和區,1522,270,518,788,33,821,1436,57.17%,18.8%,1
新北市,永和區,1523,396,638,1034,53,1087,1731,62.8%,22.88%,1
新北市,永和區,1524,447,601,1048,43,1091,1762,61.92%,25.37%,1
新北市,永和區,1525,299,406,705,45,750,1320,56.82%,22.65%,1
新北市,永和區,1526,271,373,644,15,659,1297,50.81%,20.89%,1
新北市,永和區,1527,412,559,971,40,1011,1798,56.23%,22.91%,1
新北市,永和區,1528,370,504,874,41,915,1491,61.37%,24.82%,1
新北市,永和區,1529,241,448,689,16,705,1223,57.65%,19.71%,1
新北市,永和區,1530,50,584,634,33,667,1108,60.2%,4.51%,1
新北市,永和區,1531,340,487,827,34,861,1408,61.15%,24.15%,1
新北市,永和區,1532,281,454,735,40,775,1265,61.26%,22.21%,1
新北市,永和區,1533,239,368,607,19,626,1115,56.14%,21.43%,1
新北市,永和區,1534,269,422,691,37,728,1133,64.25%,23.74%,1
新北市,永和區,1535,279,434,713,25,738,1217,60.64%,22.93%,1
新北市,永和區,1536,411,530,941,35,976,1713,56.98%,23.99%,1
新北市,永和區,1537,313,597,910,40,950,1721,55.2%,18.19%,1
新北市,永和區,1538,280,427,707,49,756,1327,56.97%,21.1%,1
新北市,永和區,1539,293,468,761,21,782,1257,62.21%,23.31%,1
新北市,永和區,1540,294,525,819,32,851,1348,63.13%,21.81%,1
新北市,永和區,1541,287,606,893,33,926,1461,63.38%,19.64%,1
新北市,永和區,1542,309,465,774,43,817,1368,59.72%,22.59%,1
新北市,永和區,1543,250,444,694,34,728,1234,59%,20.26%,1
新北市,永和區,1544,280,449,729,43,772,1303,59.25%,21.49%,1
新北市,永和區,1545,313,515,828,30,858,1516,56.6%,20.65%,1
新北市,永和區,1546,336,503,839,39,878,1422,61.74%,23.63%,1
新北市,永和區,1547,258,344,602,25,627,991,63.27%,26.03%,1
新北市,永和區,1548,231,390,621,21,642,1016,63.19%,22.74%,1
新北市,永和區,1549,221,436,657,37,694,1146,60.56%,19.28%,1
新北市,永和區,1550,226,389,615,19,634,1043,60.79%,21.67%,1
新北市,永和區,1551,275,451,726,22,748,1210,61.82%,22.73%,1
新北市,永和區,1552,343,587,930,27,957,1630,58.71%,21.04%,1
新北市,永和區,1553,171,477,648,18,666,1092,60.99%,15.66%,1
新北市,永和區,1554,404,658,1062,46,1108,1872,59.19%,21.58%,1
新北市,永和區,1555,452,535,987,29,1016,1781,57.05%,25.38%,1
新北市,永和區,1556,231,386,617,33,650,1049,61.96%,22.02%,1
新北市,永和區,1557,310,481,791,29,820,1285,63.81%,24.12%,1
新北市,永和區,1558,257,471,728,30,758,1209,62.7%,21.26%,1
新北市,永和區,1559,267,432,699,24,723,1132,63.87%,23.59%,1
新北市,永和區,1560,285,496,781,38,819,1287,63.64%,22.14%,1
新北市,永和區,1561,120,530,650,25,675,1068,63.2%,11.24%,1
新北市,永和區,1562,275,390,665,28,693,1098,63.11%,25.05%,1
新北市,永和區,1563,268,480,748,22,770,1222,63.01%,21.93%,1
新北市,永和區,1564,263,420,683,32,715,1157,61.8%,22.73%,1
新北市,永和區,1565,326,408,734,36,770,1168,65.92%,27.91%,1
新北市,永和區,1566,314,400,714,40,754,1283,58.77%,24.47%,1
新北市,永和區,1567,364,410,774,28,802,1372,58.45%,26.53%,1
新北市,永和區,1568,377,722,1099,42,1141,1876,60.82%,20.1%,1
新北市,永和區,1569,377,582,959,44,1003,1576,63.64%,23.92%,1
新北市,永和區,1570,367,600,967,34,1001,1661,60.26%,22.1%,1
新北市,永和區,1571,339,663,1002,28,1030,1808,56.97%,18.75%,1
新北市,永和區,1572,398,657,1055,43,1098,1898,57.85%,20.97%,1
新北市,永和區,1573,358,543,901,33,934,1508,61.94%,23.74%,1
新北市,永和區,1574,295,482,777,48,825,1341,61.52%,22%,1
新北市,永和區,1575,317,486,803,30,833,1422,58.58%,22.29%,1
新北市,永和區,1576,251,420,671,22,693,1177,58.88%,21.33%,1
新北市,永和區,1577,393,482,875,42,917,1557,58.9%,25.24%,1
新北市,永和區,1578,343,446,789,40,829,1491,55.6%,23%,1
新北市,永和區,1579,343,528,871,39,910,1586,57.38%,21.63%,1
新北市,永和區,1580,283,427,710,22,732,1313,55.75%,21.55%,1
新北市,永和區,1581,409,481,890,50,940,1636,57.46%,25%,1
新北市,永和區,1582,389,495,884,40,924,1598,57.82%,24.34%,1
新北市,永和區,1583,367,581,948,32,980,1609,60.91%,22.81%,1
新北市,永和區,1584,307,514,821,30,851,1375,61.89%,22.33%,1
新北市,永和區,1585,358,648,1006,32,1038,1648,62.99%,21.72%,1
新北市,永和區,1586,299,330,629,30,659,1077,61.19%,27.76%,1
新北市,永和區,1587,267,418,685,23,708,1157,61.19%,23.08%,1
新北市,永和區,1588,308,515,823,32,855,1339,63.85%,23%,1
新北市,永和區,1589,267,530,797,18,815,1306,62.4%,20.44%,1
新北市,永和區,1590,278,495,773,16,789,1236,63.83%,22.49%,1
新北市,永和區,1591,242,448,690,17,707,1133,62.4%,21.36%,1
新北市,永和區,1592,280,563,843,24,867,1425,60.84%,19.65%,1
新北市,永和區,1593,436,610,1046,89,1135,1938,58.57%,22.5%,1
新北市,永和區,1594,401,519,920,45,965,1607,60.05%,24.95%,1
新北市,永和區,1595,158,339,497,28,525,853,61.55%,18.52%,1
新北市,永和區,1596,140,245,385,42,427,768,55.6%,18.23%,1
新北市,永和區,1597,120,281,401,35,436,893,48.82%,13.44%,1
新北市,永和區,1598,122,286,408,29,437,743,58.82%,16.42%,1
新北市,永和區,1599,275,434,709,29,738,1155,63.9%,23.81%,1
新北市,永和區,1600,305,449,754,32,786,1263,62.23%,24.15%,1
新北市,永和區,1601,242,469,711,28,739,1189,62.15%,20.35%,1
新北市,永和區,1602,294,433,727,36,763,1346,56.69%,21.84%,1
新北市,永和區,1603,308,452,760,43,803,1368,58.7%,22.51%,1
新北市,永和區,1604,241,358,599,20,619,1043,59.35%,23.11%,1
新北市,永和區,1605,423,589,1012,38,1050,1709,61.44%,24.75%,1
新北市,永和區,1606,197,280,477,11,488,879,55.52%,22.41%,1
新北市,永和區,1607,212,305,517,27,544,904,60.18%,23.45%,1
新北市,永和區,1608,287,446,733,37,770,1221,63.06%,23.51%,1
新北市,永和區,1609,233,354,587,44,631,1018,61.98%,22.89%,1
新北市,永和區,1610,308,549,857,25,882,1551,56.87%,19.86%,1
新北市,永和區,1611,298,524,822,42,864,1428,60.5%,20.87%,1
新北市,永和區,1612,225,387,612,41,653,1044,62.55%,21.55%,1
新北市,永和區,1613,208,373,581,32,613,967,63.39%,21.51%,1
新北市,新莊區,0302,331,288,619,44,663,1123,59.04%,29.47%,1
新北市,新莊區,0303,367,372,739,48,787,1278,61.58%,28.72%,1
新北市,新莊區,0304,333,375,708,32,740,1163,63.63%,28.63%,1
新北市,新莊區,0305,357,377,734,23,757,1228,61.64%,29.07%,1
新北市,新莊區,0306,372,319,691,26,717,1211,59.21%,30.72%,1
新北市,新莊區,0307,374,294,668,30,698,1176,59.35%,31.8%,1
新北市,新莊區,0308,391,520,911,35,946,1536,61.59%,25.46%,1
新北市,新莊區,0309,413,485,898,39,937,1486,63.06%,27.79%,1
新北市,新莊區,0310,429,510,939,36,975,1513,64.44%,28.35%,1
新北市,新莊區,0311,406,443,849,44,893,1395,64.01%,29.1%,1
新北市,新莊區,0312,366,370,736,40,776,1353,57.35%,27.05%,1
新北市,新莊區,0313,431,406,837,41,878,1409,62.31%,30.59%,1
新北市,新莊區,0314,371,447,818,20,838,1478,56.7%,25.1%,1
新北市,新莊區,0315,272,271,543,38,581,921,63.08%,29.53%,1
新北市,新莊區,0316,302,284,586,28,614,971,63.23%,31.1%,1
新北市,新莊區,0317,387,516,903,65,968,1534,63.1%,25.23%,1
新北市,新莊區,0318,383,463,846,23,869,1516,57.32%,25.26%,1
新北市,新莊區,0319,195,189,384,27,411,697,58.97%,27.98%,1
新北市,新莊區,0320,273,421,694,29,723,1235,58.54%,22.11%,1
新北市,新莊區,0321,281,347,628,33,661,1138,58.08%,24.69%,1
新北市,新莊區,0322,256,301,557,22,579,1063,54.47%,24.08%,1
新北市,新莊區,0323,412,399,811,34,845,3399,24.86%,12.12%,1
新北市,新莊區,0324,427,470,897,38,935,1575,59.37%,27.11%,1
新北市,新莊區,0325,477,487,964,46,1010,1615,62.54%,29.54%,1
新北市,新莊區,0326,453,365,818,40,858,1612,53.23%,28.1%,1
新北市,新莊區,0327,350,435,785,53,838,1514,55.35%,23.12%,1
新北市,新莊區,0328,347,365,712,20,732,1382,52.97%,25.11%,1
新北市,新莊區,0329,378,420,798,38,836,1475,56.68%,25.63%,1
新北市,新莊區,0330,397,442,839,17,856,1462,58.55%,27.15%,1
新北市,新莊區,0331,342,422,764,30,794,1426,55.68%,23.98%,1
新北市,新莊區,0332,361,386,747,46,793,1421,55.81%,25.4%,1
新北市,新莊區,0333,369,467,836,24,860,1536,55.99%,24.02%,1
新北市,新莊區,0334,399,497,896,26,922,1587,58.1%,25.14%,1
新北市,新莊區,0335,178,213,391,13,404,749,53.94%,23.77%,1
新北市,新莊區,0336,295,428,723,47,770,1276,60.34%,23.12%,1
新北市,新莊區,0337,369,346,715,20,735,1303,56.41%,28.32%,1
新北市,新莊區,0338,371,365,736,38,774,1259,61.48%,29.47%,1
新北市,新莊區,0339,329,420,749,33,782,1291,60.57%,25.48%,1
新北市,新莊區,0340,339,481,820,29,849,1493,56.87%,22.71%,1
新北市,新莊區,0341,342,494,836,42,878,1507,58.26%,22.69%,1
新北市,新莊區,0342,350,457,807,21,828,1456,56.87%,24.04%,1
新北市,新莊區,0343,332,450,782,18,800,1396,57.31%,23.78%,1
新北市,新莊區,0344,322,334,656,53,709,1351,52.48%,23.83%,1
新北市,新莊區,0345,439,333,772,41,813,1403,57.95%,31.29%,1
新北市,新莊區,0346,389,407,796,39,835,1497,55.78%,25.99%,1
新北市,新莊區,0347,364,349,713,60,773,1272,60.77%,28.62%,1
新北市,新莊區,0348,345,299,644,25,669,1269,52.72%,27.19%,1
新北市,新莊區,0349,483,289,772,55,827,1335,61.95%,36.18%,1
新北市,新莊區,0350,311,454,765,26,791,1300,60.85%,23.92%,1
新北市,新莊區,0351,345,406,751,31,782,1286,60.81%,26.83%,1
新北市,新莊區,0352,393,403,796,34,830,1255,66.14%,31.31%,1
新北市,新莊區,0353,400,440,840,64,904,1558,58.02%,25.67%,1
新北市,新莊區,0354,394,425,819,47,866,1567,55.26%,25.14%,1
新北市,新莊區,0355,432,464,896,57,953,1603,59.45%,26.95%,1
新北市,新莊區,0356,406,453,859,26,885,1538,57.54%,26.4%,1
新北市,新莊區,0357,433,500,933,29,962,1671,57.57%,25.91%,1
新北市,新莊區,0358,444,491,935,21,956,1698,56.3%,26.15%,1
新北市,新莊區,0359,445,457,902,36,938,1545,60.71%,28.8%,1
新北市,新莊區,0360,483,484,967,67,1034,1696,60.97%,28.48%,1
新北市,新莊區,0361,443,379,822,62,884,1626,54.37%,27.24%,1
新北市,新莊區,0362,303,281,584,53,637,1170,54.44%,25.9%,1
新北市,新莊區,0363,329,348,677,52,729,1236,58.98%,26.62%,1
新北市,新莊區,0364,261,297,558,40,598,1071,55.84%,24.37%,1
新北市,新莊區,0365,327,286,613,35,648,1129,57.4%,28.96%,1
新北市,新莊區,0366,439,497,936,33,969,1586,61.1%,27.68%,1
新北市,新莊區,0367,412,375,787,43,830,1597,51.97%,25.8%,1
新北市,新莊區,0368,400,362,762,66,828,1573,52.64%,25.43%,1
新北市,新莊區,0369,370,303,673,41,714,1225,58.29%,30.2%,1
新北市,新莊區,0370,311,302,613,29,642,1217,52.75%,25.55%,1
新北市,新莊區,0371,401,443,844,45,889,1571,56.59%,25.53%,1
新北市,新莊區,0372,415,408,823,41,864,1594,54.2%,26.04%,1
新北市,新莊區,0373,409,420,829,47,876,1583,55.34%,25.84%,1
新北市,新莊區,0374,333,386,719,42,761,1245,61.12%,26.75%,1
新北市,新莊區,0375,361,330,691,28,719,1203,59.77%,30.01%,1
新北市,新莊區,0376,345,426,771,34,805,1265,63.64%,27.27%,1
新北市,新莊區,0377,321,393,714,53,767,1255,61.12%,25.58%,1
新北市,新莊區,0378,327,407,734,25,759,1287,58.97%,25.41%,1
新北市,新莊區,0379,351,353,704,29,733,1167,62.81%,30.08%,1
新北市,新莊區,0380,335,357,692,38,730,1299,56.2%,25.79%,1
新北市,新莊區,0381,302,366,668,37,705,1207,58.41%,25.02%,1
新北市,新莊區,0382,400,411,811,27,838,1415,59.22%,28.27%,1
新北市,新莊區,0383,345,394,739,50,789,1342,58.79%,25.71%,1
新北市,新莊區,0384,350,394,744,37,781,1341,58.24%,26.1%,1
新北市,新莊區,0385,304,368,672,48,720,1247,57.74%,24.38%,1
新北市,新莊區,0386,195,444,639,16,655,984,66.57%,19.82%,1
新北市,新莊區,0387,252,348,600,30,630,1043,60.4%,24.16%,1
新北市,新莊區,0388,336,397,733,25,758,1135,66.78%,29.6%,1
新北市,新莊區,0389,320,353,673,29,702,1185,59.24%,27%,1
新北市,新莊區,0390,401,372,773,17,790,1346,58.69%,29.79%,1
新北市,新莊區,0391,380,396,776,44,820,1372,59.77%,27.7%,1
新北市,新莊區,0392,375,414,789,51,840,1350,62.22%,27.78%,1
新北市,新莊區,0393,332,352,684,49,733,1307,56.08%,25.4%,1
新北市,新莊區,0394,369,364,733,52,785,1353,58.02%,27.27%,1
新北市,新莊區,0395,366,351,717,43,760,1287,59.05%,28.44%,1
新北市,新莊區,0396,371,365,736,30,766,1567,48.88%,23.68%,1
新北市,新莊區,0397,455,505,960,63,1023,1709,59.86%,26.62%,1
新北市,新莊區,0398,436,383,819,32,851,1616,52.66%,26.98%,1
新北市,新莊區,0399,457,373,830,38,868,1628,53.32%,28.07%,1
新北市,新莊區,0400,350,311,661,51,712,1148,62.02%,30.49%,1
新北市,新莊區,0401,345,348,693,9,702,1201,58.45%,28.73%,1
新北市,新莊區,0402,348,347,695,44,739,1135,65.11%,30.66%,1
新北市,新莊區,0403,413,458,871,57,928,1495,62.07%,27.63%,1
新北市,新莊區,0404,401,472,873,41,914,1486,61.51%,26.99%,1
新北市,新莊區,0405,401,498,899,29,928,1483,62.58%,27.04%,1
新北市,新莊區,0406,318,500,818,39,857,1553,55.18%,20.48%,1
新北市,新莊區,0407,413,579,992,17,1009,1625,62.09%,25.42%,1
新北市,新莊區,0408,374,561,935,21,956,1671,57.21%,22.38%,1
新北市,新莊區,0409,343,482,825,51,876,1389,63.07%,24.69%,1
新北市,新莊區,0410,317,407,724,33,757,1272,59.51%,24.92%,1
新北市,新莊區,0411,374,488,862,19,881,1409,62.53%,26.54%,1
新北市,新莊區,0412,406,413,819,23,842,1372,61.37%,29.59%,1
新北市,新莊區,0413,273,256,529,37,566,955,59.27%,28.59%,1
新北市,新莊區,0414,232,265,497,47,544,952,57.14%,24.37%,1
新北市,新莊區,0415,413,373,786,28,814,1412,57.65%,29.25%,1
新北市,新莊區,0416,383,392,775,53,828,1415,58.52%,27.07%,1
新北市,新莊區,0417,387,428,815,40,855,1421,60.17%,27.23%,1
新北市,新莊區,0418,364,407,771,40,811,1293,62.72%,28.15%,1
新北市,新莊區,0419,401,396,797,16,813,1475,55.12%,27.19%,1
新北市,新莊區,0420,399,370,769,51,820,1429,57.38%,27.92%,1
新北市,新莊區,0421,355,462,817,32,849,1481,57.33%,23.97%,1
新北市,新莊區,0422,378,467,845,46,891,1472,60.53%,25.68%,1
新北市,新莊區,0423,392,451,843,26,869,1474,58.96%,26.59%,1
新北市,新莊區,0424,387,462,849,27,876,1462,59.92%,26.47%,1
新北市,新莊區,0425,341,516,857,27,884,1484,59.57%,22.98%,1
新北市,新莊區,0426,339,468,807,36,843,1461,57.7%,23.2%,1
新北市,新莊區,0427,377,460,837,23,860,1444,59.56%,26.11%,1
新北市,新莊區,0428,388,445,833,24,857,1437,59.64%,27%,1
新北市,新莊區,0429,368,433,801,27,828,1641,50.46%,22.43%,1
新北市,新莊區,0430,388,464,852,22,874,1633,53.52%,23.76%,1
新北市,新莊區,0431,412,456,868,20,888,1531,58%,26.91%,1
新北市,新莊區,0432,450,415,865,45,910,1517,59.99%,29.66%,1
新北市,新莊區,0433,373,404,777,51,828,1487,55.68%,25.08%,1
新北市,新莊區,0434,363,494,857,38,895,1560,57.37%,23.27%,1
新北市,新莊區,0435,388,446,834,56,890,1584,56.19%,24.49%,1
新北市,新莊區,0436,368,485,853,25,878,1602,54.81%,22.97%,1
新北市,新莊區,0437,223,231,454,31,485,818,59.29%,27.26%,1
新北市,新莊區,0438,396,382,778,44,822,1633,50.34%,24.25%,1
新北市,新莊區,0439,417,435,852,38,890,1652,53.87%,25.24%,1
新北市,新莊區,0440,396,396,792,41,833,1498,55.61%,26.44%,1
新北市,新莊區,0441,367,381,748,53,801,1379,58.09%,26.61%,1
新北市,新莊區,0442,362,419,781,37,818,1381,59.23%,26.21%,1
新北市,新莊區,0443,420,450,870,41,911,1535,59.35%,27.36%,1
新北市,新莊區,0444,388,525,913,40,953,1492,63.87%,26.01%,1
新北市,新莊區,0445,408,453,861,55,916,1450,63.17%,28.14%,1
新北市,新莊區,0446,290,315,605,51,656,1107,59.26%,26.2%,1
新北市,新莊區,0447,323,345,668,31,699,1063,65.76%,30.39%,1
新北市,新莊區,0448,352,309,661,35,696,1143,60.89%,30.8%,1
新北市,新莊區,0449,355,344,699,59,758,1341,56.52%,26.47%,1
新北市,新莊區,0450,273,320,593,35,628,1063,59.08%,25.68%,1
新北市,新莊區,0451,319,321,640,37,677,1096,61.77%,29.11%,1
新北市,新莊區,0452,317,403,720,33,753,1309,57.52%,24.22%,1
新北市,新莊區,0453,377,333,710,31,741,1216,60.94%,31%,1
新北市,新莊區,0454,331,324,655,37,692,1278,54.15%,25.9%,1
新北市,新莊區,0455,404,339,743,43,786,1352,58.14%,29.88%,1
新北市,新莊區,0456,350,299,649,36,685,1298,52.77%,26.96%,1
新北市,新莊區,0457,283,303,586,26,612,1042,58.73%,27.16%,1
新北市,新莊區,0458,211,248,459,22,481,881,54.6%,23.95%,1
新北市,新莊區,0459,343,336,679,34,713,1109,64.29%,30.93%,1
新北市,新莊區,0460,334,361,695,30,725,1291,56.16%,25.87%,1
新北市,新莊區,0461,295,376,671,27,698,1293,53.98%,22.82%,1
新北市,新莊區,0462,368,386,754,37,791,1336,59.21%,27.54%,1
新北市,新莊區,0463,326,398,724,39,763,1384,55.13%,23.55%,1
新北市,新莊區,0464,255,350,605,18,623,1231,50.61%,20.71%,1
新北市,新莊區,0465,189,311,500,20,520,940,55.32%,20.11%,1
新北市,新莊區,0466,354,359,713,56,769,1369,56.17%,25.86%,1
新北市,新莊區,0467,363,366,729,53,782,1384,56.5%,26.23%,1
新北市,新莊區,0468,346,356,702,54,756,1272,59.43%,27.2%,1
新北市,新莊區,0469,282,312,594,34,628,1073,58.53%,26.28%,1
新北市,新莊區,0470,299,304,603,20,623,1058,58.88%,28.26%,1
新北市,新莊區,0471,322,500,822,19,841,1528,55.04%,21.07%,1
新北市,新莊區,0472,274,382,656,30,686,1244,55.14%,22.03%,1
新北市,新莊區,0473,330,361,691,0,691,1356,50.96%,24.34%,1
新北市,新莊區,0474,237,355,592,16,608,1164,52.23%,20.36%,1
新北市,新莊區,0475,353,441,794,46,840,1423,59.03%,24.81%,1
新北市,新莊區,0476,366,385,751,25,776,1250,62.08%,29.28%,1
新北市,新莊區,0477,334,340,674,20,694,1252,55.43%,26.68%,1
新北市,新莊區,0478,206,328,534,26,560,1022,54.79%,20.16%,1
新北市,新莊區,0479,249,276,525,44,569,959,59.33%,25.96%,1
新北市,新莊區,0480,413,493,906,46,952,1646,57.84%,25.09%,1
新北市,新莊區,0481,379,429,808,57,865,1551,55.77%,24.44%,1
新北市,新莊區,0482,433,429,862,46,908,1526,59.5%,28.37%,1
新北市,新莊區,0483,428,452,880,27,907,1518,59.75%,28.19%,1
新北市,新莊區,0484,378,482,860,42,902,1547,58.31%,24.43%,1
新北市,新莊區,0485,381,389,770,56,826,1505,54.88%,25.32%,1
新北市,新莊區,0486,368,396,764,62,826,1527,54.09%,24.1%,1
新北市,新莊區,0487,359,376,735,48,783,1482,52.83%,24.22%,1
新北市,新莊區,0488,388,402,790,51,841,1586,53.03%,24.46%,1
新北市,新莊區,0489,287,271,558,66,624,1065,58.59%,26.95%,1
新北市,新莊區,0490,278,358,636,37,673,1040,64.71%,26.73%,1
新北市,新莊區,0491,312,272,584,34,618,1090,56.7%,28.62%,1
新北市,新莊區,0492,301,292,593,42,635,1071,59.29%,28.1%,1
新北市,新莊區,0493,440,423,863,35,898,1704,52.7%,25.82%,1
新北市,新莊區,0494,397,446,843,20,863,1698,50.82%,23.38%,1
新北市,新莊區,0495,396,422,818,36,854,1362,62.7%,29.07%,1
新北市,新莊區,0496,385,399,784,36,820,1350,60.74%,28.52%,1
新北市,新莊區,0497,433,484,917,50,967,1689,57.25%,25.64%,1
新北市,新莊區,0498,427,465,892,46,938,1612,58.19%,26.49%,1
新北市,新莊區,0499,306,345,651,35,686,1130,60.71%,27.08%,1
新北市,新莊區,0500,306,353,659,42,701,1111,63.1%,27.54%,1
新北市,新莊區,0501,396,414,810,32,842,1539,54.71%,25.73%,1
新北市,新莊區,0502,445,441,886,37,923,1586,58.2%,28.06%,1
新北市,新莊區,0503,425,487,912,29,941,1631,57.69%,26.06%,1
新北市,新莊區,0504,384,448,832,35,867,1540,56.3%,24.94%,1
新北市,新莊區,0505,343,328,671,37,708,1388,51.01%,24.71%,1
新北市,新莊區,0506,339,320,659,61,720,1388,51.87%,24.42%,1
新北市,新莊區,0507,320,349,669,37,706,1387,50.9%,23.07%,1
新北市,新莊區,0508,289,307,596,38,634,1181,53.68%,24.47%,1
新北市,新莊區,0509,342,289,631,34,665,1135,58.59%,30.13%,1
新北市,新莊區,0510,327,312,639,41,680,1173,57.97%,27.88%,1
新北市,新莊區,0511,326,364,690,19,709,1215,58.35%,26.83%,1
新北市,新莊區,0512,373,454,827,42,869,1488,58.4%,25.07%,1
新北市,新莊區,0513,378,402,780,42,822,1444,56.93%,26.18%,1
新北市,新莊區,0514,374,426,800,37,837,1499,55.84%,24.95%,1
新北市,新莊區,0515,371,427,798,18,816,1449,56.31%,25.6%,1
新北市,新莊區,0516,416,467,883,44,927,1640,56.52%,25.37%,1
新北市,新莊區,0517,425,432,857,52,909,1648,55.16%,25.79%,1
新北市,新莊區,0518,359,336,695,27,722,1371,52.66%,26.19%,1
新北市,新莊區,0519,386,355,741,35,776,1400,55.43%,27.57%,1
新北市,新莊區,0520,389,394,783,39,822,1457,56.42%,26.7%,1
新北市,新莊區,0521,371,419,790,39,829,1502,55.19%,24.7%,1
新北市,新莊區,0522,343,292,635,154,789,1412,55.88%,24.29%,1
新北市,新莊區,0523,356,339,695,49,744,1318,56.45%,27.01%,1
新北市,新莊區,0524,352,453,805,35,840,1411,59.53%,24.95%,1
新北市,新莊區,0525,333,393,726,30,756,1262,59.9%,26.39%,1
新北市,新莊區,0526,310,422,732,25,757,1228,61.64%,25.24%,1
新北市,新莊區,0527,481,500,981,49,1030,1748,58.92%,27.52%,1
新北市,新莊區,0528,463,538,1001,47,1048,1761,59.51%,26.29%,1
新北市,新莊區,0529,364,306,670,41,711,1326,53.62%,27.45%,1
新北市,新莊區,0530,343,296,639,37,676,1344,50.3%,25.52%,1
新北市,新莊區,0531,265,476,741,29,770,1355,56.83%,19.56%,1
新北市,新莊區,0532,338,379,717,50,767,1306,58.73%,25.88%,1
新北市,新莊區,0533,376,390,766,37,803,1349,59.53%,27.87%,1
新北市,新莊區,0534,320,382,702,26,728,1265,57.55%,25.3%,1
新北市,新莊區,0535,338,389,727,53,780,1282,60.84%,26.37%,1
新北市,新莊區,0536,325,378,703,46,749,1237,60.55%,26.27%,1
新北市,新莊區,0537,318,467,785,34,819,1301,62.95%,24.44%,1
新北市,新莊區,0538,325,358,683,45,728,1262,57.69%,25.75%,1
新北市,新莊區,0539,312,378,690,35,725,1270,57.09%,24.57%,1
新北市,新莊區,0540,373,320,693,43,736,1245,59.12%,29.96%,1
新北市,新莊區,0541,296,344,640,48,688,1220,56.39%,24.26%,1
新北市,新莊區,0542,342,294,636,38,674,1245,54.14%,27.47%,1
新北市,新莊區,0543,319,324,643,36,679,1212,56.02%,26.32%,1
新北市,新莊區,0544,326,307,633,56,689,1253,54.99%,26.02%,1
新北市,新莊區,0545,313,324,637,40,677,1272,53.22%,24.61%,1
新北市,新莊區,0546,340,362,702,26,728,1227,59.33%,27.71%,1
新北市,新莊區,0547,336,319,655,29,684,1126,60.75%,29.84%,1
新北市,新莊區,0548,341,350,691,33,724,1240,58.39%,27.5%,1
新北市,新莊區,0549,394,421,815,20,835,1460,57.19%,26.99%,1
新北市,新莊區,0550,306,271,577,27,604,1072,56.34%,28.54%,1
新北市,新莊區,0551,289,271,560,34,594,1127,52.71%,25.64%,1
新北市,新莊區,0552,315,451,766,21,787,1332,59.08%,23.65%,1
新北市,新莊區,0553,335,347,682,24,706,1341,52.65%,24.98%,1
新北市,新莊區,0554,227,259,486,25,511,1140,44.82%,19.91%,1
新北市,新店區,1987,427,463,890,37,927,1603,57.83%,26.64%,1
新北市,新店區,1988,410,650,1060,37,1097,1921,57.11%,21.34%,1
新北市,新店區,1989,237,348,585,16,601,1082,55.55%,21.9%,1
新北市,新店區,1990,266,431,697,28,725,1235,58.7%,21.54%,1
新北市,新店區,1991,343,564,907,17,924,1568,58.93%,21.88%,1
新北市,新店區,1992,247,211,458,13,471,771,61.09%,32.04%,1
新北市,新店區,1993,311,376,687,35,722,1256,57.48%,24.76%,1
新北市,新店區,1994,228,344,572,36,608,1008,60.32%,22.62%,1
新北市,新店區,1995,245,604,849,44,893,1515,58.94%,16.17%,1
新北市,新店區,1996,319,670,989,31,1020,1637,62.31%,19.49%,1
新北市,新店區,1997,332,533,865,37,902,1549,58.23%,21.43%,1
新北市,新店區,1998,348,873,1221,43,1264,2011,62.85%,17.3%,1
新北市,新店區,1999,381,495,876,37,913,1554,58.75%,24.52%,1
新北市,新店區,2000,361,582,943,51,994,1770,56.16%,20.4%,1
新北市,新店區,2001,303,437,740,43,783,1316,59.5%,23.02%,1
新北市,新店區,2002,236,374,610,38,648,1126,57.55%,20.96%,1
新北市,新店區,2003,337,435,772,29,801,1460,54.86%,23.08%,1
新北市,新店區,2004,330,575,905,46,951,1584,60.04%,20.83%,1
新北市,新店區,2005,298,494,792,43,835,1449,57.63%,20.57%,1
新北市,新店區,2006,309,608,917,41,958,1520,63.03%,20.33%,1
新北市,新店區,2007,322,719,1041,37,1078,1821,59.2%,17.68%,1
新北市,新店區,2008,414,701,1115,29,1144,1956,58.49%,21.17%,1
新北市,新店區,2009,339,605,944,42,986,1665,59.22%,20.36%,1
新北市,新店區,2010,323,621,944,27,971,1588,61.15%,20.34%,1
新北市,新店區,2011,332,518,850,16,866,1519,57.01%,21.86%,1
新北市,新店區,2012,272,463,735,18,753,1185,63.54%,22.95%,1
新北市,新店區,2013,246,436,682,19,701,1095,64.02%,22.47%,1
新北市,新店區,2014,210,443,653,45,698,1106,63.11%,18.99%,1
新北市,新店區,2015,167,229,396,19,415,2700,15.37%,6.19%,1
新北市,新店區,2016,189,393,582,20,602,995,60.5%,18.99%,1
新北市,新店區,2017,235,407,642,31,673,1168,57.62%,20.12%,1
新北市,新店區,2018,244,495,739,24,763,1123,67.94%,21.73%,1
新北市,新店區,2019,269,410,679,30,709,1085,65.35%,24.79%,1
新北市,新店區,2020,306,554,860,34,894,1412,63.31%,21.67%,1
新北市,新店區,2021,334,605,939,39,978,1659,58.95%,20.13%,1
新北市,新店區,2022,207,522,729,42,771,1198,64.36%,17.28%,1
新北市,新店區,2023,247,468,715,28,743,1376,54%,17.95%,1
新北市,新店區,2024,228,481,709,26,735,1300,56.54%,17.54%,1
新北市,新店區,2025,224,482,706,25,731,1238,59.05%,18.09%,1
新北市,新店區,2026,236,497,733,18,751,1388,54.11%,17%,1
新北市,新店區,2027,314,251,565,31,596,933,63.88%,33.65%,1
新北市,新店區,2028,177,398,575,13,588,908,64.76%,19.49%,1
新北市,新店區,2029,299,568,867,48,915,1582,57.84%,18.9%,1
新北市,新店區,2030,233,507,740,41,781,1247,62.63%,18.68%,1
新北市,新店區,2031,190,375,565,39,604,971,62.2%,19.57%,1
新北市,新店區,2032,211,462,673,37,710,1145,62.01%,18.43%,1
新北市,新店區,2033,298,508,806,37,843,1392,60.56%,21.41%,1
新北市,新店區,2034,333,546,879,39,918,1452,63.22%,22.93%,1
新北市,新店區,2035,291,510,801,41,842,1440,58.47%,20.21%,1
新北市,新店區,2036,386,588,974,50,1024,1786,57.33%,21.61%,1
新北市,新店區,2037,666,362,1028,40,1068,1825,58.52%,36.49%,1
新北市,新店區,2038,336,566,902,18,920,1477,62.29%,22.75%,1
新北市,新店區,2039,349,648,997,35,1032,1750,58.97%,19.94%,1
新北市,新店區,2040,259,727,986,36,1022,1792,57.03%,14.45%,1
新北市,新店區,2041,323,767,1090,39,1129,1979,57.05%,16.32%,1
新北市,新店區,2042,136,354,490,16,506,826,61.26%,16.46%,1
新北市,新店區,2043,309,805,1114,32,1146,1924,59.56%,16.06%,1
新北市,新店區,2044,254,592,846,20,866,1383,62.62%,18.37%,1
新北市,新店區,2045,152,245,397,29,426,830,51.33%,18.31%,1
新北市,新店區,2046,335,706,1041,29,1070,1759,60.83%,19.04%,1
新北市,新店區,2047,345,796,1141,44,1185,1957,60.55%,17.63%,1
新北市,新店區,2048,290,597,887,23,910,1481,61.44%,19.58%,1
新北市,新店區,2049,297,563,860,54,914,1552,58.89%,19.14%,1
新北市,新店區,2050,260,533,793,57,850,1467,57.94%,17.72%,1
新北市,新店區,2051,260,515,775,34,809,1371,59.01%,18.96%,1
新北市,新店區,2052,213,372,585,24,609,991,61.45%,21.49%,1
新北市,新店區,2053,247,462,709,43,752,1231,61.09%,20.06%,1
新北市,新店區,2054,363,596,959,43,1002,1701,58.91%,21.34%,1
新北市,新店區,2055,361,614,975,34,1009,1707,59.11%,21.15%,1
新北市,新店區,2056,379,599,978,31,1009,1773,56.91%,21.38%,1
新北市,新店區,2057,359,596,955,32,987,1866,52.89%,19.24%,1
新北市,新店區,2058,348,665,1013,28,1041,1735,60%,20.06%,1
新北市,新店區,2059,355,665,1020,24,1044,1632,63.97%,21.75%,1
新北市,新店區,2060,327,572,899,46,945,1591,59.4%,20.55%,1
新北市,新店區,2061,315,459,774,46,820,1495,54.85%,21.07%,1
新北市,新店區,2062,265,509,774,21,795,1511,52.61%,17.54%,1
新北市,新店區,2063,272,429,701,40,741,1260,58.81%,21.59%,1
新北市,新店區,2064,349,775,1124,42,1166,1948,59.86%,17.92%,1
新北市,新店區,2065,257,686,943,34,977,1582,61.76%,16.25%,1
新北市,新店區,2066,306,450,756,16,772,1315,58.71%,23.27%,1
新北市,新店區,2067,339,503,842,31,873,1562,55.89%,21.7%,1
新北市,新店區,2068,337,805,1142,38,1180,1982,59.54%,17%,1
新北市,新店區,2069,310,559,869,40,909,1518,59.88%,20.42%,1
新北市,新店區,2070,325,639,964,30,994,1735,57.29%,18.73%,1
新北市,新店區,2071,289,646,935,35,970,1716,56.53%,16.84%,1
新北市,新店區,2072,309,596,905,24,929,1580,58.8%,19.56%,1
新北市,新店區,2073,287,534,821,33,854,1358,62.89%,21.13%,1
新北市,新店區,2074,364,587,951,52,1003,1610,62.3%,22.61%,1
新北市,新店區,2075,338,431,769,30,799,1383,57.77%,24.44%,1
新北市,新店區,2076,359,546,905,34,939,1596,58.83%,22.49%,1
新北市,新店區,2077,215,476,691,34,725,1360,53.31%,15.81%,1
新北市,新店區,2078,182,419,601,20,621,1160,53.53%,15.69%,1
新北市,新店區,2079,158,623,781,33,814,1236,65.86%,12.78%,1
新北市,新店區,2080,189,591,780,23,803,1234,65.07%,15.32%,1
新北市,新店區,2081,394,488,882,42,924,1579,58.52%,24.95%,1
新北市,新店區,2082,264,416,680,31,711,1241,57.29%,21.27%,1
新北市,新店區,2083,268,432,700,22,722,1275,56.63%,21.02%,1
新北市,新店區,2084,218,398,616,32,648,1214,53.38%,17.96%,1
新北市,新店區,2085,323,434,757,38,795,1578,50.38%,20.47%,1
新北市,新店區,2086,316,458,774,25,799,1442,55.41%,21.91%,1
新北市,新店區,2087,362,360,722,50,772,1475,52.34%,24.54%,1
新北市,新店區,2088,315,559,874,48,922,1580,58.35%,19.94%,1
新北市,新店區,2089,305,544,849,40,889,1585,56.09%,19.24%,1
新北市,新店區,2090,389,458,847,48,895,1586,56.43%,24.53%,1
新北市,新店區,2091,382,651,1033,45,1078,1931,55.83%,19.78%,1
新北市,新店區,2092,240,421,661,32,693,1239,55.93%,19.37%,1
新北市,新店區,2093,405,610,1015,35,1050,1892,55.5%,21.41%,1
新北市,新店區,2094,323,461,784,38,822,1529,53.76%,21.12%,1
新北市,新店區,2095,295,469,764,27,791,1358,58.25%,21.72%,1
新北市,新店區,2096,346,611,957,33,990,1905,51.97%,18.16%,1
新北市,新店區,2097,356,611,967,45,1012,1885,53.69%,18.89%,1
新北市,新店區,2098,281,412,693,43,736,1345,54.72%,20.89%,1
新北市,新店區,2099,341,424,765,44,809,1387,58.33%,24.59%,1
新北市,新店區,2100,357,683,1040,42,1082,1960,55.2%,18.21%,1
新北市,新店區,2101,392,596,988,45,1033,1837,56.23%,21.34%,1
新北市,新店區,2102,358,559,917,41,958,1662,57.64%,21.54%,1
新北市,新店區,2103,343,610,953,43,996,1617,61.6%,21.21%,1
新北市,新店區,2104,359,593,952,28,980,1704,57.51%,21.07%,1
新北市,新店區,2105,359,577,936,57,993,1835,54.11%,19.56%,1
新北市,新店區,2106,385,655,1040,49,1089,2009,54.21%,19.16%,1
新北市,新店區,2107,297,468,765,47,812,1450,56%,20.48%,1
新北市,新店區,2108,352,573,925,37,962,1726,55.74%,20.39%,1
新北市,新店區,2109,368,570,938,36,974,1797,54.2%,20.48%,1
新北市,新店區,2110,343,601,944,28,972,1739,55.89%,19.72%,1
新北市,新店區,2111,296,538,834,29,863,1523,56.66%,19.44%,1
新北市,新店區,2112,326,564,890,24,914,1642,55.66%,19.85%,1
新北市,新店區,2113,337,566,903,23,926,1644,56.33%,20.5%,1
新北市,新店區,2114,362,473,835,34,869,1662,52.29%,21.78%,1
新北市,新店區,2115,493,654,1147,33,1180,2067,57.09%,23.85%,1
新北市,新店區,2116,398,474,872,37,909,1870,48.61%,21.28%,1
新北市,新店區,2117,322,726,1048,37,1085,1982,54.74%,16.25%,1
新北市,新店區,2118,264,611,875,23,898,1546,58.09%,17.08%,1
新北市,新店區,2119,341,662,1003,34,1037,1712,60.57%,19.92%,1
新北市,新店區,2120,276,586,862,25,887,1423,62.33%,19.4%,1
新北市,新店區,2121,336,628,964,48,1012,1666,60.74%,20.17%,1
新北市,新店區,2122,265,787,1052,47,1099,1769,62.13%,14.98%,1
新北市,新店區,2123,239,276,515,32,547,1079,50.7%,22.15%,1
新北市,新店區,2124,261,340,601,30,631,1140,55.35%,22.89%,1
新北市,新店區,2125,399,573,972,32,1004,1825,55.01%,21.86%,1
新北市,新店區,2126,318,367,685,31,716,1178,60.78%,26.99%,1
新北市,新店區,2127,274,503,777,26,803,1463,54.89%,18.73%,1
新北市,新店區,2128,230,403,633,34,667,1152,57.9%,19.97%,1
新北市,新店區,2129,304,614,918,35,953,2008,47.46%,15.14%,1
新北市,新店區,2130,301,641,942,33,975,2120,45.99%,14.2%,1
新北市,新店區,2131,218,457,675,19,694,1153,60.19%,18.91%,1
新北市,新店區,2132,255,551,806,26,832,1573,52.89%,16.21%,1
新北市,新店區,2133,396,538,934,50,984,1992,49.4%,19.88%,1
新北市,新店區,2134,330,490,820,26,846,1668,50.72%,19.78%,1
新北市,新店區,2135,309,454,763,37,800,1617,49.47%,19.11%,1
新北市,新店區,2136,324,638,962,120,1082,2013,53.75%,16.1%,1
新北市,新店區,2137,382,651,1033,33,1066,1791,59.52%,21.33%,1
新北市,新店區,2138,319,580,899,35,934,1624,57.51%,19.64%,1
新北市,新店區,2139,210,483,693,22,715,1178,60.7%,17.83%,1
新北市,新店區,2140,215,518,733,19,752,1277,58.89%,16.84%,1
新北市,新店區,2141,213,833,1046,23,1069,1879,56.89%,11.34%,1
新北市,新店區,2142,267,211,478,20,498,939,53.04%,28.43%,1
新北市,新店區,2143,200,327,527,26,553,960,57.6%,20.83%,1
新北市,新店區,2144,307,562,869,18,887,1434,61.85%,21.41%,1
新北市,新店區,2145,372,544,916,53,969,1838,52.72%,20.24%,1
新北市,新店區,2146,260,524,784,32,816,1453,56.16%,17.89%,1
新北市,新店區,2147,326,467,793,43,836,1549,53.97%,21.05%,1
新北市,新店區,2148,400,646,1046,43,1089,1860,58.55%,21.51%,1
新北市,新店區,2149,355,535,890,31,921,1743,52.84%,20.37%,1
新北市,新店區,2150,252,459,711,27,738,1122,65.78%,22.46%,1
新北市,新店區,2151,305,481,786,39,825,1468,56.2%,20.78%,1
新北市,新店區,2152,335,612,947,33,980,1763,55.59%,19%,1
新北市,新店區,2153,285,407,692,33,725,1344,53.94%,21.21%,1
新北市,新店區,2154,196,185,381,31,412,753,54.71%,26.03%,1
新北市,新店區,2155,174,172,346,8,354,602,58.8%,28.9%,1
新北市,新店區,2156,487,663,1150,32,1182,2237,52.84%,21.77%,1
新北市,新店區,2157,293,298,591,24,615,1096,56.11%,26.73%,1
新北市,新店區,2158,221,292,513,25,538,1143,47.07%,19.34%,1
新北市,新店區,2159,388,396,784,42,826,1569,52.64%,24.73%,1
新北市,新店區,2160,369,315,684,39,723,1284,56.31%,28.74%,1
新北市,新店區,2161,83,72,155,10,165,439,37.59%,18.91%,1
新北市,新店區,2162,194,217,411,27,438,750,58.4%,25.87%,1
新北市,樹林區,1614,306,395,701,44,745,1408,52.91%,21.73%,1
新北市,樹林區,1615,336,349,685,29,714,1310,54.5%,25.65%,1
新北市,樹林區,1616,400,323,723,40,763,1534,49.74%,26.08%,1
新北市,樹林區,1617,299,293,592,41,633,1211,52.27%,24.69%,1
新北市,樹林區,1618,282,349,631,32,663,1125,58.93%,25.07%,1
新北市,樹林區,1619,315,341,656,31,687,1134,60.58%,27.78%,1
新北市,樹林區,1620,420,425,845,52,897,1897,47.29%,22.14%,1
新北市,樹林區,1621,453,406,859,53,912,1716,53.15%,26.4%,1
新北市,樹林區,1622,230,201,431,28,459,736,62.36%,31.25%,1
新北市,樹林區,1623,337,342,679,26,705,1137,62.01%,29.64%,1
新北市,樹林區,1624,384,399,783,29,812,1542,52.66%,24.9%,1
新北市,樹林區,1625,377,405,782,35,817,1470,55.58%,25.65%,1
新北市,樹林區,1626,334,355,689,27,716,1456,49.18%,22.94%,1
新北市,樹林區,1627,333,306,639,19,658,1124,58.54%,29.63%,1
新北市,樹林區,1628,321,315,636,23,659,1235,53.36%,25.99%,1
新北市,樹林區,1629,331,333,664,24,688,1212,56.77%,27.31%,1
新北市,樹林區,1630,315,289,604,33,637,1223,52.09%,25.76%,1
新北市,樹林區,1631,358,351,709,37,746,1335,55.88%,26.82%,1
新北市,樹林區,1632,321,315,636,28,664,1206,55.06%,26.62%,1
新北市,樹林區,1633,381,304,685,33,718,1927,37.26%,19.77%,1
新北市,樹林區,1634,221,267,488,36,524,914,57.33%,24.18%,1
新北市,樹林區,1635,370,431,801,46,847,1456,58.17%,25.41%,1
新北市,樹林區,1636,350,398,748,39,787,1409,55.86%,24.84%,1
新北市,樹林區,1637,422,434,856,50,906,1500,60.4%,28.13%,1
新北市,樹林區,1638,393,439,832,39,871,1545,56.38%,25.44%,1
新北市,樹林區,1639,342,422,764,21,785,1483,52.93%,23.06%,1
新北市,樹林區,1640,365,437,802,38,840,1524,55.12%,23.95%,1
新北市,樹林區,1641,383,399,782,26,808,1431,56.46%,26.76%,1
新北市,樹林區,1642,299,320,619,37,656,1181,55.55%,25.32%,1
新北市,樹林區,1643,322,294,616,40,656,1116,58.78%,28.85%,1
新北市,樹林區,1644,315,234,549,17,566,1077,52.55%,29.25%,1
新北市,樹林區,1645,283,279,562,13,575,1103,52.13%,25.66%,1
新北市,樹林區,1646,390,350,740,36,776,1385,56.03%,28.16%,1
新北市,樹林區,1647,309,346,655,33,688,1266,54.34%,24.41%,1
新北市,樹林區,1648,296,315,611,48,659,1195,55.15%,24.77%,1
新北市,樹林區,1649,332,313,645,41,686,1254,54.7%,26.48%,1
新北市,樹林區,1650,337,367,704,32,736,1263,58.27%,26.68%,1
新北市,樹林區,1651,484,383,867,51,918,1473,62.32%,32.86%,1
新北市,樹林區,1652,209,273,482,21,503,870,57.82%,24.02%,1
新北市,樹林區,1653,388,394,782,42,824,1338,61.58%,29%,1
新北市,樹林區,1654,264,271,535,30,565,1010,55.94%,26.14%,1
新北市,樹林區,1655,390,516,906,60,966,1658,58.26%,23.52%,1
新北市,樹林區,1656,436,490,926,43,969,1538,63%,28.35%,1
新北市,樹林區,1657,348,479,827,67,894,1405,63.63%,24.77%,1
新北市,樹林區,1658,368,488,856,35,891,1587,56.14%,23.19%,1
新北市,樹林區,1659,384,482,866,35,901,1566,57.54%,24.52%,1
新北市,樹林區,1660,200,327,527,18,545,997,54.66%,20.06%,1
新北市,樹林區,1661,304,345,649,34,683,1187,57.54%,25.61%,1
新北市,樹林區,1662,268,283,551,29,580,1061,54.67%,25.26%,1
新北市,樹林區,1663,376,566,942,40,982,1701,57.73%,22.1%,1
新北市,樹林區,1664,288,405,693,34,727,1278,56.89%,22.54%,1
新北市,樹林區,1665,377,460,837,42,879,1433,61.34%,26.31%,1
新北市,樹林區,1666,355,405,760,48,808,1306,61.87%,27.18%,1
新北市,樹林區,1667,392,334,726,51,777,1268,61.28%,30.91%,1
新北市,樹林區,1668,331,397,728,27,755,1281,58.94%,25.84%,1
新北市,樹林區,1669,352,329,681,31,712,1200,59.33%,29.33%,1
新北市,樹林區,1670,394,371,765,41,806,1491,54.06%,26.43%,1
新北市,樹林區,1671,261,304,565,26,591,1066,55.44%,24.48%,1
新北市,樹林區,1672,297,234,531,34,565,877,64.42%,33.87%,1
新北市,樹林區,1673,400,433,833,47,880,1616,54.46%,24.75%,1
新北市,樹林區,1674,375,350,725,36,761,1589,47.89%,23.6%,1
新北市,樹林區,1675,334,433,767,34,801,1367,58.6%,24.43%,1
新北市,樹林區,1676,333,317,650,39,689,1144,60.23%,29.11%,1
新北市,樹林區,1677,298,268,566,19,585,1059,55.24%,28.14%,1
新北市,樹林區,1678,319,321,640,44,684,1224,55.88%,26.06%,1
新北市,樹林區,1679,276,314,590,34,624,1141,54.69%,24.19%,1
新北市,樹林區,1680,279,343,622,25,647,1396,46.35%,19.99%,1
新北市,樹林區,1681,308,308,616,22,638,1157,55.14%,26.62%,1
新北市,樹林區,1682,393,329,722,60,782,1498,52.2%,26.23%,1
新北市,樹林區,1683,414,365,779,59,838,1514,55.35%,27.34%,1
新北市,樹林區,1684,334,416,750,42,792,1546,51.23%,21.6%,1
新北市,樹林區,1685,391,353,744,36,780,1392,56.03%,28.09%,1
新北市,樹林區,1686,376,473,849,45,894,1566,57.09%,24.01%,1
新北市,樹林區,1687,377,465,842,16,858,1566,54.79%,24.07%,1
新北市,樹林區,1688,355,422,777,53,830,1517,54.71%,23.4%,1
新北市,樹林區,1689,355,440,795,36,831,1481,56.11%,23.97%,1
新北市,樹林區,1690,313,343,656,32,688,1261,54.56%,24.82%,1
新北市,樹林區,1691,293,306,599,20,619,1163,53.22%,25.19%,1
新北市,樹林區,1692,469,477,946,57,1003,1661,60.39%,28.24%,1
新北市,樹林區,1693,412,438,850,49,899,1585,56.72%,25.99%,1
新北市,樹林區,1694,255,338,593,25,618,1018,60.71%,25.05%,1
新北市,樹林區,1695,320,331,651,49,700,1247,56.13%,25.66%,1
新北市,樹林區,1696,341,366,707,48,755,1390,54.32%,24.53%,1
新北市,樹林區,1697,333,376,709,34,743,1293,57.46%,25.75%,1
新北市,樹林區,1698,329,364,693,17,710,1301,54.57%,25.29%,1
新北市,樹林區,1699,426,393,819,37,856,1606,53.3%,26.53%,1
新北市,樹林區,1700,343,317,660,57,717,1277,56.15%,26.86%,1
新北市,樹林區,1701,346,305,651,49,700,1219,57.42%,28.38%,1
新北市,樹林區,1702,346,387,733,31,764,1454,52.54%,23.8%,1
新北市,樹林區,1703,258,412,670,35,705,1314,53.65%,19.63%,1
新北市,樹林區,1704,296,323,619,24,643,1008,63.79%,29.37%,1
新北市,樹林區,1705,402,389,791,59,850,1574,54%,25.54%,1
新北市,樹林區,1706,358,408,766,40,806,1364,59.09%,26.25%,1
新北市,樹林區,1707,381,431,812,51,863,1677,51.46%,22.72%,1
新北市,樹林區,1708,360,380,740,29,769,1683,45.69%,21.39%,1
新北市,樹林區,1709,388,421,809,38,847,1452,58.33%,26.72%,1
新北市,樹林區,1710,329,564,893,30,923,1592,57.98%,20.67%,1
新北市,樹林區,1711,352,574,926,26,952,1619,58.8%,21.74%,1
新北市,樹林區,1712,370,611,981,24,1005,1642,61.21%,22.53%,1
新北市,樹林區,1713,266,476,742,23,765,1357,56.37%,19.6%,1
新北市,樹林區,1714,432,489,921,66,987,1638,60.26%,26.37%,1
新北市,樹林區,1715,368,452,820,34,854,1592,53.64%,23.12%,1
新北市,樹林區,1716,348,505,853,31,884,1521,58.12%,22.88%,1
新北市,樹林區,1717,376,614,990,47,1037,1707,60.75%,22.03%,1
新北市,樹林區,1718,370,613,983,35,1018,1741,58.47%,21.25%,1
新北市,樹林區,1719,340,566,906,21,927,1655,56.01%,20.54%,1
新北市,樹林區,1720,368,512,880,35,915,1775,51.55%,20.73%,1
新北市,樹林區,1721,347,594,941,39,980,1781,55.03%,19.48%,1
新北市,樹林區,1722,396,332,728,40,768,1565,49.07%,25.3%,1
新北市,樹林區,1723,239,243,482,23,505,936,53.95%,25.53%,1
新北市,樹林區,1724,318,272,590,20,610,1030,59.22%,30.87%,1
新北市,鶯歌區,1725,139,142,281,15,296,515,57.48%,26.99%,1
新北市,鶯歌區,1726,303,247,550,35,585,965,60.62%,31.4%,1
新北市,鶯歌區,1727,460,553,1013,56,1069,1931,55.36%,23.82%,1
新北市,鶯歌區,1728,393,461,854,37,891,1797,49.58%,21.87%,1
新北市,鶯歌區,1729,263,311,574,31,605,1057,57.24%,24.88%,1
新北市,鶯歌區,1730,245,256,501,13,514,962,53.43%,25.47%,1
新北市,鶯歌區,1731,269,297,566,23,589,934,63.06%,28.8%,1
新北市,鶯歌區,1732,497,530,1027,47,1074,1742,61.65%,28.53%,1
新北市,鶯歌區,1733,425,423,848,39,887,1634,54.28%,26.01%,1
新北市,鶯歌區,1734,383,462,845,23,868,1676,51.79%,22.85%,1
新北市,鶯歌區,1735,542,551,1093,46,1139,2052,55.51%,26.41%,1
新北市,鶯歌區,1736,561,359,920,29,949,1977,48%,28.38%,1
新北市,鶯歌區,1737,470,567,1037,30,1067,1957,54.52%,24.02%,1
新北市,鶯歌區,1738,219,195,414,14,428,850,50.35%,25.76%,1
新北市,鶯歌區,1739,377,500,877,39,916,1782,51.4%,21.16%,1
新北市,鶯歌區,1740,348,423,771,24,795,1496,53.14%,23.26%,1
新北市,鶯歌區,1741,496,498,994,45,1039,2071,50.17%,23.95%,1
新北市,鶯歌區,1742,375,377,752,49,801,1753,45.69%,21.39%,1
新北市,鶯歌區,1743,389,481,870,30,900,1737,51.81%,22.39%,1
新北市,鶯歌區,1744,362,445,807,44,851,1669,50.99%,21.69%,1
新北市,鶯歌區,1745,392,439,831,31,862,1842,46.8%,21.28%,1
新北市,鶯歌區,1746,354,337,691,34,725,1454,49.86%,24.35%,1
新北市,鶯歌區,1747,243,253,496,16,512,942,54.35%,25.8%,1
新北市,鶯歌區,1748,324,347,671,37,708,1317,53.76%,24.6%,1
新北市,鶯歌區,1749,218,229,447,24,471,949,49.63%,22.97%,1
新北市,鶯歌區,1750,421,392,813,32,845,1440,58.68%,29.24%,1
新北市,鶯歌區,1751,430,502,932,60,992,1809,54.84%,23.77%,1
新北市,鶯歌區,1752,406,539,945,46,991,1758,56.37%,23.09%,1
新北市,鶯歌區,1753,353,481,834,33,867,1589,54.56%,22.22%,1
新北市,鶯歌區,1754,300,326,626,25,651,1067,61.01%,28.12%,1
新北市,鶯歌區,1755,283,345,628,20,648,1092,59.34%,25.92%,1
新北市,鶯歌區,1756,443,505,948,28,976,1730,56.42%,25.61%,1
新北市,鶯歌區,1757,317,369,686,31,717,1281,55.97%,24.75%,1
新北市,鶯歌區,1758,351,379,730,44,774,1238,62.52%,28.35%,1
新北市,鶯歌區,1759,377,440,817,52,869,1568,55.42%,24.04%,1
新北市,鶯歌區,1760,305,349,654,36,690,1271,54.29%,24%,1
新北市,鶯歌區,1761,264,256,520,22,542,1183,45.82%,22.32%,1
新北市,鶯歌區,1762,225,266,491,14,505,1026,49.22%,21.93%,1
新北市,鶯歌區,1763,399,427,826,43,869,1721,50.49%,23.18%,1
新北市,鶯歌區,1764,319,326,645,52,697,1317,52.92%,24.22%,1
新北市,鶯歌區,1765,289,304,593,38,631,1046,60.33%,27.63%,1
新北市,鶯歌區,1766,326,323,649,42,691,1144,60.4%,28.5%,1
新北市,鶯歌區,1767,314,348,662,40,702,1336,52.54%,23.5%,1
新北市,鶯歌區,1768,341,369,710,19,729,1479,49.29%,23.06%,1
新北市,鶯歌區,1769,386,489,875,44,919,1736,52.94%,22.24%,1
新北市,鶯歌區,1770,361,426,787,33,820,1389,59.04%,25.99%,1
新北市,鶯歌區,1771,464,526,990,64,1054,1956,53.89%,23.72%,1
新北市,鶯歌區,1772,394,337,731,30,761,1371,55.51%,28.74%,1
新北市,鶯歌區,1773,300,415,715,27,742,1810,40.99%,16.57%,1
新北市,鶯歌區,1774,55,59,114,2,116,227,51.1%,24.23%,1
新北市,三峽區,1917,96,80,176,12,188,274,68.61%,35.04%,1
新北市,三峽區,1918,138,156,294,29,323,583,55.4%,23.67%,1
新北市,三峽區,1919,361,429,790,19,809,1765,45.84%,20.45%,1
新北市,三峽區,1920,394,468,862,49,911,1714,53.15%,22.99%,1
新北市,三峽區,1921,312,374,686,24,710,1355,52.4%,23.03%,1
新北市,三峽區,1922,343,379,722,32,754,1329,56.73%,25.81%,1
新北市,三峽區,1923,273,273,546,21,567,1059,53.54%,25.78%,1
新北市,三峽區,1924,323,425,748,37,785,1364,57.55%,23.68%,1
新北市,三峽區,1925,504,103,607,39,646,1098,58.83%,45.9%,1
新北市,三峽區,1926,295,374,669,49,718,1296,55.4%,22.76%,1
新北市,三峽區,1927,310,340,650,29,679,1240,54.76%,25%,1
新北市,三峽區,1928,355,424,779,39,818,1531,53.43%,23.19%,1
新北市,三峽區,1929,307,374,681,28,709,1444,49.1%,21.26%,1
新北市,三峽區,1930,316,362,678,57,735,1347,54.57%,23.46%,1
新北市,三峽區,1931,312,426,738,49,787,1455,54.09%,21.44%,1
新北市,三峽區,1932,359,354,713,32,745,1556,47.88%,23.07%,1
新北市,三峽區,1933,313,281,594,25,619,1390,44.53%,22.52%,1
新北市,三峽區,1934,327,451,778,44,822,1532,53.66%,21.34%,1
新北市,三峽區,1935,334,299,633,42,675,1377,49.02%,24.26%,1
新北市,三峽區,1936,375,477,852,47,899,1731,51.94%,21.66%,1
新北市,三峽區,1937,394,449,843,31,874,1705,51.26%,23.11%,1
新北市,三峽區,1938,372,471,843,39,882,1590,55.47%,23.4%,1
新北市,三峽區,1939,352,565,917,33,950,1650,57.58%,21.33%,1
新北市,三峽區,1940,310,462,772,29,801,1441,55.59%,21.51%,1
新北市,三峽區,1941,314,493,807,17,824,1404,58.69%,22.36%,1
新北市,三峽區,1942,290,452,742,28,770,1295,59.46%,22.39%,1
新北市,三峽區,1943,291,351,642,30,672,1348,49.85%,21.59%,1
新北市,三峽區,1944,335,525,860,21,881,1579,55.79%,21.22%,1
新北市,三峽區,1945,294,457,751,21,772,1435,53.8%,20.49%,1
新北市,三峽區,1946,357,605,962,24,986,1659,59.43%,21.52%,1
新北市,三峽區,1947,347,547,894,30,924,1512,61.11%,22.95%,1
新北市,三峽區,1948,310,519,829,25,854,1463,58.37%,21.19%,1
新北市,三峽區,1949,301,530,831,23,854,1465,58.29%,20.55%,1
新北市,三峽區,1950,258,576,834,25,859,1463,58.71%,17.63%,1
新北市,三峽區,1951,319,501,820,28,848,1443,58.77%,22.11%,1
新北市,三峽區,1952,368,426,794,40,834,1634,51.04%,22.52%,1
新北市,三峽區,1953,416,484,900,35,935,1716,54.49%,24.24%,1
新北市,三峽區,1954,362,470,832,43,875,1675,52.24%,21.61%,1
新北市,三峽區,1955,320,394,714,41,755,1649,45.79%,19.41%,1
新北市,三峽區,1956,352,394,746,45,791,1489,53.12%,23.64%,1
新北市,三峽區,1957,338,500,838,37,875,1771,49.41%,19.09%,1
新北市,三峽區,1958,392,517,909,37,946,1726,54.81%,22.71%,1
新北市,三峽區,1959,322,369,691,49,740,1363,54.29%,23.62%,1
新北市,三峽區,1960,400,448,848,38,886,1624,54.56%,24.63%,1
新北市,三峽區,1961,379,350,729,27,756,1352,55.92%,28.03%,1
新北市,三峽區,1962,286,354,640,12,652,1608,40.55%,17.79%,1
新北市,三峽區,1963,338,400,738,44,782,1458,53.64%,23.18%,1
新北市,三峽區,1964,368,410,778,30,808,1641,49.24%,22.43%,1
新北市,三峽區,1965,359,370,729,84,813,1530,53.14%,23.46%,1
新北市,三峽區,1966,295,301,596,43,639,1389,46%,21.24%,1
新北市,三峽區,1967,310,325,635,36,671,1315,51.03%,23.57%,1
新北市,三峽區,1968,189,349,538,33,571,934,61.13%,20.24%,1
新北市,三峽區,1969,261,340,601,28,629,1270,49.53%,20.55%,1
新北市,三峽區,1970,184,244,428,33,461,929,49.62%,19.81%,1
新北市,三峽區,1971,280,254,534,16,550,1035,53.14%,27.05%,1
新北市,三峽區,1972,137,108,245,14,259,502,51.59%,27.29%,1
新北市,三峽區,1973,182,192,374,36,410,836,49.04%,21.77%,1
新北市,三峽區,1974,163,138,301,33,334,669,49.93%,24.36%,1
新北市,三峽區,1975,180,215,395,47,442,733,60.3%,24.56%,1
新北市,三峽區,1976,337,546,883,56,939,1560,60.19%,21.6%,1
新北市,三峽區,1977,348,465,813,38,851,1638,51.95%,21.25%,1
新北市,三峽區,1978,332,354,686,31,717,1394,51.43%,23.82%,1
新北市,三峽區,1979,228,199,427,22,449,771,58.24%,29.57%,1
新北市,三峽區,1980,339,365,704,22,726,1367,53.11%,24.8%,1
新北市,三峽區,1981,289,326,615,33,648,1241,52.22%,23.29%,1
新北市,三峽區,1982,355,384,739,13,752,1520,49.47%,23.36%,1
新北市,三峽區,1983,286,246,532,25,557,873,63.8%,32.76%,1
新北市,三峽區,1984,210,143,353,22,375,768,48.83%,27.34%,1
新北市,三峽區,1985,239,260,499,28,527,1097,48.04%,21.79%,1
新北市,三峽區,1986,303,246,549,47,596,1322,45.08%,22.92%,1
新北市,淡水區,0029,150,127,277,13,290,544,53.31%,27.57%,1
新北市,淡水區,0030,258,287,545,40,585,1044,56.03%,24.71%,1
新北市,淡水區,0031,308,416,724,37,761,1462,52.05%,21.07%,1
新北市,淡水區,0032,348,406,754,53,807,1525,52.92%,22.82%,1
新北市,淡水區,0033,206,244,450,27,477,986,48.38%,20.89%,1
新北市,淡水區,0034,189,241,430,31,461,806,57.2%,23.45%,1
新北市,淡水區,0035,257,364,621,42,663,1173,56.52%,21.91%,1
新北市,淡水區,0036,246,360,606,40,646,1343,48.1%,18.32%,1
新北市,淡水區,0037,266,239,505,21,526,1153,45.62%,23.07%,1
新北市,淡水區,0038,246,187,433,20,453,874,51.83%,28.15%,1
新北市,淡水區,0039,295,263,558,41,599,1063,56.35%,27.75%,1
新北市,淡水區,0040,276,365,641,32,673,1309,51.41%,21.08%,1
新北市,淡水區,0041,309,351,660,36,696,1290,53.95%,23.95%,1
新北市,淡水區,0042,350,593,943,18,961,1675,57.37%,20.9%,1
新北市,淡水區,0043,333,520,853,34,887,1589,55.82%,20.96%,1
新北市,淡水區,0044,342,571,913,30,943,1624,58.07%,21.06%,1
新北市,淡水區,0045,274,374,648,27,675,1241,54.39%,22.08%,1
新北市,淡水區,0046,302,385,687,48,735,1317,55.81%,22.93%,1
新北市,淡水區,0047,276,410,686,25,711,1225,58.04%,22.53%,1
新北市,淡水區,0048,313,449,762,37,799,1426,56.03%,21.95%,1
新北市,淡水區,0049,328,583,911,31,942,1610,58.51%,20.37%,1
新北市,淡水區,0050,629,452,1081,35,1116,1982,56.31%,31.74%,1
新北市,淡水區,0051,392,473,865,43,908,1924,47.19%,20.37%,1
新北市,淡水區,0052,381,506,887,32,919,1822,50.44%,20.91%,1
新北市,淡水區,0053,362,338,700,48,748,1232,60.71%,29.38%,1
新北市,淡水區,0054,393,453,846,69,915,1588,57.62%,24.75%,1
新北市,淡水區,0055,354,532,886,21,907,1784,50.84%,19.84%,1
新北市,淡水區,0056,406,487,893,35,928,1762,52.67%,23.04%,1
新北市,淡水區,0057,309,493,802,24,826,1546,53.43%,19.99%,1
新北市,淡水區,0058,397,599,996,34,1030,1897,54.3%,20.93%,1
新北市,淡水區,0059,290,473,763,24,787,1489,52.85%,19.48%,1
新北市,淡水區,0060,349,493,842,26,868,1679,51.7%,20.79%,1
新北市,淡水區,0061,305,510,815,38,853,1693,50.38%,18.02%,1
新北市,淡水區,0062,374,470,844,21,865,1674,51.67%,22.34%,1
新北市,淡水區,0063,293,421,714,23,737,1330,55.41%,22.03%,1
新北市,淡水區,0064,155,597,752,18,770,1467,52.49%,10.57%,1
新北市,淡水區,0065,343,603,946,33,979,1837,53.29%,18.67%,1
新北市,淡水區,0066,248,387,635,17,652,1924,33.89%,12.89%,1
新北市,淡水區,0067,459,709,1168,24,1192,2340,50.94%,19.62%,1
新北市,淡水區,0068,315,451,766,29,795,1704,46.65%,18.49%,1
新北市,淡水區,0069,282,416,698,24,722,1363,52.97%,20.69%,1
新北市,淡水區,0070,529,865,1394,32,1426,3068,46.48%,17.24%,1
新北市,淡水區,0071,326,418,744,30,774,1528,50.65%,21.34%,1
新北市,淡水區,0072,332,453,785,50,835,1600,52.19%,20.75%,1
新北市,淡水區,0073,438,572,1010,46,1056,1874,56.35%,23.37%,1
新北市,淡水區,0074,335,456,791,44,835,1567,53.29%,21.38%,1
新北市,淡水區,0075,282,391,673,27,700,1245,56.22%,22.65%,1
新北市,淡水區,0076,243,357,600,28,628,1211,51.86%,20.07%,1
新北市,淡水區,0077,427,660,1087,36,1123,1992,56.38%,21.44%,1
新北市,淡水區,0078,441,653,1094,29,1123,2028,55.37%,21.75%,1
新北市,淡水區,0079,203,530,733,47,780,1373,56.81%,14.79%,1
新北市,淡水區,0080,334,571,905,38,943,1732,54.45%,19.28%,1
新北市,淡水區,0081,300,435,735,29,764,1519,50.3%,19.75%,1
新北市,淡水區,0082,329,489,818,27,845,1727,48.93%,19.05%,1
新北市,淡水區,0083,317,381,698,36,734,1297,56.59%,24.44%,1
新北市,淡水區,0084,266,276,542,41,583,1066,54.69%,24.95%,1
新北市,淡水區,0085,349,386,735,36,771,1387,55.59%,25.16%,1
新北市,淡水區,0086,466,550,1016,34,1050,1909,55%,24.41%,1
新北市,淡水區,0087,353,561,914,41,955,1770,53.95%,19.94%,1
新北市,淡水區,0088,409,588,997,45,1042,2049,50.85%,19.96%,1
新北市,淡水區,0089,361,511,872,32,904,1680,53.81%,21.49%,1
新北市,淡水區,0090,378,444,822,32,854,1433,59.6%,26.38%,1
新北市,淡水區,0091,287,438,725,26,751,1365,55.02%,21.03%,1
新北市,淡水區,0092,312,484,796,27,823,1452,56.68%,21.49%,1
新北市,淡水區,0093,315,609,924,42,966,1804,53.55%,17.46%,1
新北市,淡水區,0094,319,394,713,29,742,1322,56.13%,24.13%,1
新北市,淡水區,0095,449,602,1051,27,1078,2019,53.39%,22.24%,1
新北市,淡水區,0096,387,589,976,22,998,1696,58.84%,22.82%,1
新北市,淡水區,0097,360,496,856,28,884,1576,56.09%,22.84%,1
新北市,淡水區,0098,394,567,961,34,995,1781,55.87%,22.12%,1
新北市,淡水區,0099,429,515,944,36,980,1665,58.86%,25.77%,1
新北市,淡水區,0100,425,607,1032,52,1084,2013,53.85%,21.11%,1
新北市,淡水區,0101,257,317,574,24,598,1108,53.97%,23.19%,1
新北市,淡水區,0102,311,372,683,46,729,1305,55.86%,23.83%,1
新北市,淡水區,0103,303,335,638,19,657,1199,54.8%,25.27%,1
新北市,淡水區,0104,388,640,1028,49,1077,2017,53.4%,19.24%,1
新北市,淡水區,0105,421,575,996,38,1034,2125,48.66%,19.81%,1
新北市,淡水區,0106,267,329,596,15,611,1289,47.4%,20.71%,1
新北市,淡水區,0107,320,430,750,39,789,1319,59.82%,24.26%,1
新北市,淡水區,0108,249,339,588,20,608,1051,57.85%,23.69%,1
新北市,淡水區,0109,348,379,727,24,751,1348,55.71%,25.82%,1
新北市,淡水區,0110,301,277,578,29,607,1106,54.88%,27.22%,1
新北市,淡水區,0111,217,185,402,23,425,717,59.27%,30.26%,1
新北市,淡水區,0112,332,377,709,27,736,1385,53.14%,23.97%,1
新北市,淡水區,0113,229,251,480,31,511,841,60.76%,27.23%,1
新北市,淡水區,0114,201,178,379,16,395,665,59.4%,30.23%,1
新北市,淡水區,0115,123,121,244,8,252,419,60.14%,29.36%,1
新北市,淡水區,0116,369,506,875,24,899,1599,56.22%,23.08%,1
新北市,淡水區,0117,356,494,850,32,882,1670,52.81%,21.32%,1
新北市,淡水區,0118,412,519,931,27,958,1683,56.92%,24.48%,1
新北市,淡水區,0119,328,449,777,33,810,1577,51.36%,20.8%,1
新北市,淡水區,0120,332,440,772,43,815,1618,50.37%,20.52%,1
新北市,淡水區,0121,414,623,1037,23,1060,2214,47.88%,18.7%,1
新北市,淡水區,0122,395,536,931,32,963,1832,52.57%,21.56%,1
新北市,淡水區,0123,453,625,1078,47,1125,2123,52.99%,21.34%,1
新北市,淡水區,0124,403,890,1293,19,1312,2998,43.76%,13.44%,1
新北市,汐止區,2336,342,487,829,43,872,1595,54.67%,21.44%,1
新北市,汐止區,2337,291,393,684,33,717,1262,56.81%,23.06%,1
新北市,汐止區,2338,269,244,513,27,540,917,58.89%,29.33%,1
新北市,汐止區,2339,400,629,1029,45,1074,1929,55.68%,20.74%,1
新北市,汐止區,2340,464,672,1136,52,1188,2227,53.35%,20.84%,1
新北市,汐止區,2341,272,336,608,37,645,1143,56.43%,23.8%,1
新北市,汐止區,2342,313,421,734,27,761,1367,55.67%,22.9%,1
新北市,汐止區,2343,85,81,166,9,175,322,54.35%,26.4%,1
新北市,汐止區,2344,354,442,796,10,806,1460,55.21%,24.25%,1
新北市,汐止區,2345,376,471,847,48,895,1719,52.07%,21.87%,1
新北市,汐止區,2346,388,460,848,35,883,1661,53.16%,23.36%,1
新北市,汐止區,2347,367,496,863,40,903,1590,56.79%,23.08%,1
新北市,汐止區,2348,400,447,847,33,880,1599,55.03%,25.02%,1
新北市,汐止區,2349,364,571,935,38,973,1749,55.63%,20.81%,1
新北市,汐止區,2350,177,162,339,21,360,1809,19.9%,9.78%,1
新北市,汐止區,2351,376,392,768,20,788,1601,49.22%,23.49%,1
新北市,汐止區,2352,326,383,709,32,741,1387,53.42%,23.5%,1
新北市,汐止區,2353,428,525,953,47,1000,1779,56.21%,24.06%,1
新北市,汐止區,2354,423,705,1128,33,1161,2074,55.98%,20.4%,1
新北市,汐止區,2355,445,636,1081,37,1118,2072,53.96%,21.48%,1
新北市,汐止區,2356,473,725,1198,52,1250,2120,58.96%,22.31%,1
新北市,汐止區,2357,432,620,1052,33,1085,1952,55.58%,22.13%,1
新北市,汐止區,2358,377,450,827,55,882,1654,53.33%,22.79%,1
新北市,汐止區,2359,339,380,719,49,768,1444,53.19%,23.48%,1
新北市,汐止區,2360,388,550,938,29,967,1627,59.43%,23.85%,1
新北市,汐止區,2361,416,417,833,56,889,1751,50.77%,23.76%,1
新北市,汐止區,2362,385,665,1050,35,1085,2066,52.52%,18.64%,1
新北市,汐止區,2363,362,496,858,31,889,1941,45.8%,18.65%,1
新北市,汐止區,2364,371,521,892,32,924,1906,48.48%,19.46%,1
新北市,汐止區,2365,326,354,680,43,723,1363,53.04%,23.92%,1
新北市,汐止區,2366,316,341,657,38,695,1368,50.8%,23.1%,1
新北市,汐止區,2367,265,353,618,32,650,1233,52.72%,21.49%,1
新北市,汐止區,2368,345,462,807,26,833,1554,53.6%,22.2%,1
新北市,汐止區,2369,379,476,855,36,891,1700,52.41%,22.29%,1
新北市,汐止區,2370,248,370,618,16,634,1124,56.41%,22.06%,1
新北市,汐止區,2371,448,607,1055,36,1091,1900,57.42%,23.58%,1
新北市,汐止區,2372,406,642,1048,51,1099,2050,53.61%,19.8%,1
新北市,汐止區,2373,303,325,628,42,670,1244,53.86%,24.36%,1
新北市,汐止區,2374,276,370,646,24,670,1320,50.76%,20.91%,1
新北市,汐止區,2375,316,492,808,31,839,1473,56.96%,21.45%,1
新北市,汐止區,2376,313,639,952,41,993,1802,55.11%,17.37%,1
新北市,汐止區,2377,247,465,712,29,741,1266,58.53%,19.51%,1
新北市,汐止區,2378,354,369,723,29,752,1481,50.78%,23.9%,1
新北市,汐止區,2379,348,385,733,49,782,1497,52.24%,23.25%,1
新北市,汐止區,2380,159,160,319,9,328,556,58.99%,28.6%,1
新北市,汐止區,2381,389,534,923,37,960,1913,50.18%,20.33%,1
新北市,汐止區,2382,409,581,990,36,1026,2027,50.62%,20.18%,1
新北市,汐止區,2383,334,575,909,39,948,1927,49.2%,17.33%,1
新北市,汐止區,2384,171,188,359,32,391,696,56.18%,24.57%,1
新北市,汐止區,2385,444,569,1013,51,1064,2127,50.02%,20.87%,1
新北市,汐止區,2386,320,417,737,46,783,1642,47.69%,19.49%,1
新北市,汐止區,2387,505,456,961,47,1008,1912,52.72%,26.41%,1
新北市,汐止區,2388,382,467,849,32,881,1893,46.54%,20.18%,1
新北市,汐止區,2389,310,376,686,35,721,1466,49.18%,21.15%,1
新北市,汐止區,2390,334,407,741,55,796,1538,51.76%,21.72%,1
新北市,汐止區,2391,323,443,766,27,793,1550,51.16%,20.84%,1
新北市,汐止區,2392,330,395,725,35,760,1456,52.2%,22.66%,1
新北市,汐止區,2393,292,261,553,22,575,947,60.72%,30.83%,1
新北市,汐止區,2394,227,294,521,17,538,923,58.29%,24.59%,1
新北市,汐止區,2395,458,520,978,55,1033,2043,50.56%,22.42%,1
新北市,汐止區,2396,456,456,912,52,964,2012,47.91%,22.66%,1
新北市,汐止區,2397,289,386,675,27,702,1471,47.72%,19.65%,1
新北市,汐止區,2398,352,437,789,34,823,1603,51.34%,21.96%,1
新北市,汐止區,2399,352,436,788,40,828,1530,54.12%,23.01%,1
新北市,汐止區,2400,392,450,842,35,877,1988,44.11%,19.72%,1
新北市,汐止區,2401,440,617,1057,41,1098,2198,49.95%,20.02%,1
新北市,汐止區,2402,343,496,839,33,872,1712,50.93%,20.04%,1
新北市,汐止區,2403,383,575,958,52,1010,1806,55.92%,21.21%,1
新北市,汐止區,2404,362,439,801,50,851,1576,54%,22.97%,1
新北市,汐止區,2405,352,434,786,25,811,1511,53.67%,23.3%,1
新北市,汐止區,2406,300,496,796,35,831,1691,49.14%,17.74%,1
新北市,汐止區,2407,312,517,829,42,871,1636,53.24%,19.07%,1
新北市,汐止區,2408,341,495,836,40,876,1676,52.27%,20.35%,1
新北市,汐止區,2409,253,386,639,22,661,1264,52.29%,20.02%,1
新北市,汐止區,2410,237,359,596,26,622,1165,53.39%,20.34%,1
新北市,汐止區,2411,385,475,860,39,899,1765,50.93%,21.81%,1
新北市,汐止區,2412,317,481,798,25,823,1815,45.34%,17.47%,1
新北市,汐止區,2413,384,455,839,54,893,1778,50.22%,21.6%,1
新北市,汐止區,2414,368,454,822,55,877,1580,55.51%,23.29%,1
新北市,汐止區,2415,373,411,784,30,814,1516,53.69%,24.6%,1
新北市,汐止區,2416,281,408,689,28,717,1425,50.32%,19.72%,1
新北市,汐止區,2417,302,435,737,31,768,1388,55.33%,21.76%,1
新北市,汐止區,2418,348,397,745,40,785,1436,54.67%,24.23%,1
新北市,汐止區,2419,332,477,809,31,840,1591,52.8%,20.87%,1
新北市,汐止區,2420,351,439,790,25,815,1639,49.73%,21.42%,1
新北市,汐止區,2421,289,399,688,19,707,1394,50.72%,20.73%,1
新北市,汐止區,2422,416,560,976,27,1003,2035,49.29%,20.44%,1
新北市,汐止區,2423,410,548,958,42,1000,1895,52.77%,21.64%,1
新北市,汐止區,2424,243,530,773,11,784,1374,57.06%,17.69%,1
新北市,汐止區,2425,212,391,603,31,634,1061,59.75%,19.98%,1
新北市,汐止區,2426,279,549,828,13,841,1312,64.1%,21.27%,1
新北市,汐止區,2427,309,529,838,27,865,1548,55.88%,19.96%,1
新北市,汐止區,2428,298,468,766,12,778,1350,57.63%,22.07%,1
新北市,汐止區,2429,338,458,796,24,820,1499,54.7%,22.55%,1
新北市,汐止區,2430,286,472,758,32,790,1366,57.83%,20.94%,1
新北市,汐止區,2431,313,419,732,34,766,1335,57.38%,23.45%,1
新北市,汐止區,2432,315,461,776,32,808,1324,61.03%,23.79%,1
新北市,汐止區,2433,292,430,722,59,781,1286,60.73%,22.71%,1
新北市,汐止區,2434,289,330,619,21,640,1155,55.41%,25.02%,1
新北市,汐止區,2435,368,622,990,34,1024,1682,60.88%,21.88%,1
新北市,汐止區,2436,323,583,906,24,930,1494,62.25%,21.62%,1
新北市,汐止區,2437,358,307,665,42,707,1166,60.63%,30.7%,1
新北市,汐止區,2438,510,645,1155,79,1234,2184,56.5%,23.35%,1
新北市,汐止區,2439,457,660,1117,49,1166,2031,57.41%,22.5%,1
新北市,汐止區,2440,402,530,932,51,983,1759,55.88%,22.85%,1
新北市,汐止區,2441,352,516,868,39,907,1577,57.51%,22.32%,1
新北市,汐止區,2442,283,439,722,23,745,1364,54.62%,20.75%,1
新北市,汐止區,2443,334,460,794,38,832,1401,59.39%,23.84%,1
新北市,汐止區,2444,293,349,642,53,695,1173,59.25%,24.98%,1
新北市,汐止區,2445,219,315,534,13,547,993,55.09%,22.05%,1
新北市,汐止區,2446,297,533,830,23,853,1587,53.75%,18.71%,1
新北市,瑞芳區,2220,186,208,394,30,424,725,58.48%,25.66%,1
新北市,瑞芳區,2221,269,307,576,41,617,1074,57.45%,25.05%,1
新北市,瑞芳區,2222,180,250,430,19,449,825,54.42%,21.82%,1
新北市,瑞芳區,2223,294,344,638,37,675,1242,54.35%,23.67%,1
新北市,瑞芳區,2224,128,182,310,19,329,598,55.02%,21.4%,1
新北市,瑞芳區,2225,186,259,445,27,472,872,54.13%,21.33%,1
新北市,瑞芳區,2226,176,182,358,21,379,760,49.87%,23.16%,1
新北市,瑞芳區,2227,258,342,600,36,636,1330,47.82%,19.4%,1
新北市,瑞芳區,2228,327,413,740,51,791,1683,47%,19.43%,1
新北市,瑞芳區,2229,222,259,481,37,518,980,52.86%,22.65%,1
新北市,瑞芳區,2230,212,258,470,38,508,946,53.7%,22.41%,1
新北市,瑞芳區,2231,266,344,610,28,638,1375,46.4%,19.35%,1
新北市,瑞芳區,2232,329,466,795,32,827,1671,49.49%,19.69%,1
新北市,瑞芳區,2233,189,234,423,25,448,978,45.81%,19.33%,1
新北市,瑞芳區,2234,132,157,289,25,314,645,48.68%,20.47%,1
新北市,瑞芳區,2235,313,228,541,28,569,1089,52.25%,28.74%,1
新北市,瑞芳區,2236,83,38,121,10,131,286,45.8%,29.02%,1
新北市,瑞芳區,2237,114,107,221,29,250,461,54.23%,24.73%,1
新北市,瑞芳區,2238,74,57,131,10,141,274,51.46%,27.01%,1
新北市,瑞芳區,2239,51,40,91,9,100,155,64.52%,32.9%,1
新北市,瑞芳區,2240,204,224,428,25,453,817,55.45%,24.97%,1
新北市,瑞芳區,2241,204,240,444,27,471,884,53.28%,23.08%,1
新北市,瑞芳區,2242,268,324,592,53,645,1333,48.39%,20.11%,1
新北市,瑞芳區,2243,97,156,253,9,262,607,43.16%,15.98%,1
新北市,瑞芳區,2244,240,288,528,34,562,1045,53.78%,22.97%,1
新北市,瑞芳區,2245,157,187,344,26,370,673,54.98%,23.33%,1
新北市,瑞芳區,2246,124,124,248,10,258,618,41.75%,20.06%,1
新北市,瑞芳區,2247,225,240,465,29,494,1063,46.47%,21.17%,1
新北市,瑞芳區,2248,193,247,440,35,475,860,55.23%,22.44%,1
新北市,瑞芳區,2249,76,68,144,4,148,432,34.26%,17.59%,1
新北市,瑞芳區,2250,88,89,177,10,187,445,42.02%,19.78%,1
新北市,瑞芳區,2251,70,72,142,6,148,318,46.54%,22.01%,1
新北市,瑞芳區,2252,27,46,73,4,77,159,48.43%,16.98%,1
新北市,瑞芳區,2253,59,79,138,11,149,337,44.21%,17.51%,1
新北市,瑞芳區,2254,42,53,95,3,98,180,54.44%,23.33%,1
新北市,瑞芳區,2255,33,40,73,9,82,187,43.85%,17.65%,1
新北市,瑞芳區,2256,91,93,184,9,193,369,52.3%,24.66%,1
新北市,瑞芳區,2257,74,99,173,16,189,335,56.42%,22.09%,1
新北市,瑞芳區,2258,96,106,202,14,216,470,45.96%,20.43%,1
新北市,瑞芳區,2259,65,53,118,3,121,297,40.74%,21.89%,1
新北市,瑞芳區,2260,78,93,171,5,176,267,65.92%,29.21%,1
新北市,瑞芳區,2261,118,133,251,7,258,876,29.45%,13.47%,1
新北市,瑞芳區,2262,190,270,460,19,479,1241,38.6%,15.31%,1
新北市,瑞芳區,2263,233,249,482,51,533,998,53.41%,23.35%,1
新北市,瑞芳區,2264,201,250,451,51,502,948,52.95%,21.2%,1
新北市,瑞芳區,2265,202,281,483,27,510,1308,38.99%,15.44%,1
新北市,土城區,1775,374,377,751,49,800,1505,53.16%,24.85%,1
新北市,土城區,1776,288,435,723,21,744,1242,59.9%,23.19%,1
新北市,土城區,1777,273,429,702,14,716,1206,59.37%,22.64%,1
新北市,土城區,1778,350,396,746,61,807,1474,54.75%,23.74%,1
新北市,土城區,1779,327,406,733,39,772,1489,51.85%,21.96%,1
新北市,土城區,1780,395,425,820,45,865,1675,51.64%,23.58%,1
新北市,土城區,1781,378,417,795,35,830,1499,55.37%,25.22%,1
新北市,土城區,1782,296,453,749,32,781,1495,52.24%,19.8%,1
新北市,土城區,1783,361,344,705,55,760,1411,53.86%,25.58%,1
新北市,土城區,1784,339,335,674,40,714,1378,51.81%,24.6%,1
新北市,土城區,1785,348,293,641,34,675,1256,53.74%,27.71%,1
新北市,土城區,1786,365,383,748,46,794,1379,57.58%,26.47%,1
新北市,土城區,1787,339,344,683,53,736,1424,51.69%,23.81%,1
新北市,土城區,1788,335,414,749,41,790,1455,54.3%,23.02%,1
新北市,土城區,1789,336,377,713,35,748,1419,52.71%,23.68%,1
新北市,土城區,1790,292,488,780,32,812,1357,59.84%,21.52%,1
新北市,土城區,1791,330,435,765,35,800,1501,53.3%,21.99%,1
新北市,土城區,1792,356,317,673,31,704,1206,58.37%,29.52%,1
新北市,土城區,1793,353,358,711,20,731,1255,58.25%,28.13%,1
新北市,土城區,1794,384,535,919,54,973,1869,52.06%,20.55%,1
新北市,土城區,1795,320,380,700,26,726,1292,56.19%,24.77%,1
新北市,土城區,1796,305,370,675,25,700,1324,52.87%,23.04%,1
新北市,土城區,1797,262,317,579,37,616,1155,53.33%,22.68%,1
新北市,土城區,1798,320,291,611,46,657,1183,55.54%,27.05%,1
新北市,土城區,1799,281,137,418,39,457,2518,18.15%,11.16%,1
新北市,土城區,1800,276,351,627,35,662,1218,54.35%,22.66%,1
新北市,土城區,1801,271,335,606,42,648,1133,57.19%,23.92%,1
新北市,土城區,1802,205,287,492,27,519,894,58.05%,22.93%,1
新北市,土城區,1803,255,262,517,35,552,931,59.29%,27.39%,1
新北市,土城區,1804,354,757,1111,45,1156,1820,63.52%,19.45%,1
新北市,土城區,1805,319,391,710,20,730,1320,55.3%,24.17%,1
新北市,土城區,1806,300,335,635,33,668,1241,53.83%,24.17%,1
新北市,土城區,1807,325,420,745,34,779,1414,55.09%,22.98%,1
新北市,土城區,1808,350,400,750,36,786,1378,57.04%,25.4%,1
新北市,土城區,1809,371,430,801,36,837,1421,58.9%,26.11%,1
新北市,土城區,1810,281,437,718,30,748,1340,55.82%,20.97%,1
新北市,土城區,1811,308,349,657,25,682,1144,59.62%,26.92%,1
新北市,土城區,1812,356,336,692,32,724,1268,57.1%,28.08%,1
新北市,土城區,1813,302,362,664,26,690,1196,57.69%,25.25%,1
新北市,土城區,1814,303,452,755,28,783,1308,59.86%,23.17%,1
新北市,土城區,1815,293,364,657,20,677,1175,57.62%,24.94%,1
新北市,土城區,1816,335,340,675,36,711,1230,57.8%,27.24%,1
新北市,土城區,1817,354,371,725,47,772,1342,57.53%,26.38%,1
新北市,土城區,1818,358,363,721,27,748,1268,58.99%,28.23%,1
新北市,土城區,1819,297,415,712,61,773,1227,63%,24.21%,1
新北市,土城區,1820,362,357,719,61,780,1356,57.52%,26.7%,1
新北市,土城區,1821,369,432,801,39,840,1496,56.15%,24.67%,1
新北市,土城區,1822,321,369,690,57,747,1309,57.07%,24.52%,1
新北市,土城區,1823,334,328,662,44,706,1175,60.09%,28.43%,1
新北市,土城區,1824,320,329,649,49,698,1237,56.43%,25.87%,1
新北市,土城區,1825,310,378,688,41,729,1256,58.04%,24.68%,1
新北市,土城區,1826,282,368,650,24,674,1228,54.89%,22.96%,1
新北市,土城區,1827,332,293,625,50,675,1182,57.11%,28.09%,1
新北市,土城區,1828,402,434,836,28,864,1558,55.46%,25.8%,1
新北市,土城區,1829,316,329,645,24,669,1160,57.67%,27.24%,1
新北市,土城區,1830,368,368,736,38,774,1357,57.04%,27.12%,1
新北市,土城區,1831,383,374,757,57,814,1464,55.6%,26.16%,1
新北市,土城區,1832,326,340,666,31,697,1335,52.21%,24.42%,1
新北市,土城區,1833,335,375,710,52,762,1346,56.61%,24.89%,1
新北市,土城區,1834,359,481,840,29,869,1435,60.56%,25.02%,1
新北市,土城區,1835,375,492,867,47,914,1639,55.77%,22.88%,1
新北市,土城區,1836,375,586,961,27,988,1728,57.18%,21.7%,1
新北市,土城區,1837,332,394,726,30,756,1665,45.41%,19.94%,1
新北市,土城區,1838,396,371,767,48,815,1333,61.14%,29.71%,1
新北市,土城區,1839,413,485,898,29,927,1567,59.16%,26.36%,1
新北市,土城區,1840,421,400,821,49,870,1576,55.2%,26.71%,1
新北市,土城區,1841,365,436,801,34,835,1458,57.27%,25.03%,1
新北市,土城區,1842,368,454,822,48,870,1517,57.35%,24.26%,1
新北市,土城區,1843,311,521,832,39,871,1489,58.5%,20.89%,1
新北市,土城區,1844,366,492,858,18,876,1463,59.88%,25.02%,1
新北市,土城區,1845,394,483,877,33,910,1584,57.45%,24.87%,1
新北市,土城區,1846,349,432,781,34,815,1464,55.67%,23.84%,1
新北市,土城區,1847,413,452,865,39,904,1598,56.57%,25.84%,1
新北市,土城區,1848,368,370,738,59,797,1500,53.13%,24.53%,1
新北市,土城區,1849,324,488,812,34,846,1542,54.86%,21.01%,1
新北市,土城區,1850,417,513,930,35,965,1619,59.6%,25.76%,1
新北市,土城區,1851,364,406,770,24,794,1521,52.2%,23.93%,1
新北市,土城區,1852,405,497,902,27,929,1691,54.94%,23.95%,1
新北市,土城區,1853,396,461,857,38,895,1657,54.01%,23.9%,1
新北市,土城區,1854,402,604,1006,29,1035,1772,58.41%,22.69%,1
新北市,土城區,1855,325,466,791,23,814,1423,57.2%,22.84%,1
新北市,土城區,1856,369,413,782,35,817,1321,61.85%,27.93%,1
新北市,土城區,1857,432,408,840,32,872,1429,61.02%,30.23%,1
新北市,土城區,1858,337,411,748,37,785,1445,54.33%,23.32%,1
新北市,土城區,1859,368,486,854,33,887,1520,58.36%,24.21%,1
新北市,土城區,1860,289,396,685,16,701,1484,47.24%,19.47%,1
新北市,土城區,1861,330,378,708,25,733,1362,53.82%,24.23%,1
新北市,土城區,1862,320,356,676,25,701,1262,55.55%,25.36%,1
新北市,土城區,1863,373,371,744,36,780,1343,58.08%,27.77%,1
新北市,土城區,1864,343,291,634,25,659,1337,49.29%,25.65%,1
新北市,土城區,1865,296,261,557,33,590,1325,44.53%,22.34%,1
新北市,土城區,1866,344,341,685,27,712,1390,51.22%,24.75%,1
新北市,土城區,1867,326,456,782,51,833,1534,54.3%,21.25%,1
新北市,土城區,1868,346,398,744,48,792,1484,53.37%,23.32%,1
新北市,土城區,1869,339,421,760,35,795,1532,51.89%,22.13%,1
新北市,土城區,1870,347,460,807,51,858,1507,56.93%,23.03%,1
新北市,土城區,1871,360,482,842,31,873,1550,56.32%,23.23%,1
新北市,土城區,1872,335,499,834,34,868,1567,55.39%,21.38%,1
新北市,土城區,1873,348,396,744,38,782,1367,57.21%,25.46%,1
新北市,土城區,1874,318,335,653,41,694,1293,53.67%,24.59%,1
新北市,土城區,1875,373,385,758,37,795,1402,56.7%,26.6%,1
新北市,土城區,1876,357,375,732,34,766,1379,55.55%,25.89%,1
新北市,土城區,1877,352,393,745,44,789,1471,53.64%,23.93%,1
新北市,土城區,1878,310,370,680,31,711,1410,50.43%,21.99%,1
新北市,土城區,1879,415,393,808,26,834,1542,54.09%,26.91%,1
新北市,土城區,1880,319,333,652,31,683,1238,55.17%,25.77%,1
新北市,土城區,1881,282,388,670,24,694,1301,53.34%,21.68%,1
新北市,土城區,1882,331,485,816,30,846,1311,64.53%,25.25%,1
新北市,土城區,1883,331,400,731,27,758,1511,50.17%,21.91%,1
新北市,土城區,1884,353,421,774,47,821,1531,53.63%,23.06%,1
新北市,土城區,1885,375,378,753,37,790,1638,48.23%,22.89%,1
新北市,土城區,1886,378,386,764,27,791,1335,59.25%,28.31%,1
新北市,土城區,1887,326,446,772,38,810,1459,55.52%,22.34%,1
新北市,土城區,1888,387,397,784,29,813,1489,54.6%,25.99%,1
新北市,土城區,1889,363,578,941,72,1013,1774,57.1%,20.46%,1
新北市,土城區,1890,390,575,965,20,985,1792,54.97%,21.76%,1
新北市,土城區,1891,381,554,935,52,987,1798,54.89%,21.19%,1
新北市,土城區,1892,355,326,681,33,714,1312,54.42%,27.06%,1
新北市,土城區,1893,330,328,658,28,686,1301,52.73%,25.37%,1
新北市,土城區,1894,315,318,633,31,664,1254,52.95%,25.12%,1
新北市,土城區,1895,326,307,633,33,666,1215,54.81%,26.83%,1
新北市,土城區,1896,339,416,755,32,787,1448,54.35%,23.41%,1
新北市,土城區,1897,337,336,673,45,718,1321,54.35%,25.51%,1
新北市,土城區,1898,292,271,563,43,606,1150,52.7%,25.39%,1
新北市,土城區,1899,355,314,669,39,708,1425,49.68%,24.91%,1
新北市,土城區,1900,384,364,748,61,809,1366,59.22%,28.11%,1
新北市,土城區,1901,325,407,732,29,761,1292,58.9%,25.15%,1
新北市,土城區,1902,334,356,690,35,725,1317,55.05%,25.36%,1
新北市,土城區,1903,300,420,720,32,752,1324,56.8%,22.66%,1
新北市,土城區,1904,309,295,604,35,639,1189,53.74%,25.99%,1
新北市,土城區,1905,349,322,671,47,718,1223,58.71%,28.54%,1
新北市,土城區,1906,390,404,794,42,836,1550,53.94%,25.16%,1
新北市,土城區,1907,435,435,870,47,917,1606,57.1%,27.09%,1
新北市,土城區,1908,381,414,795,38,833,1509,55.2%,25.25%,1
新北市,土城區,1909,374,416,790,42,832,1529,54.41%,24.46%,1
新北市,土城區,1910,358,371,729,48,777,1458,53.29%,24.55%,1
新北市,土城區,1911,439,363,802,38,840,1468,57.22%,29.9%,1
新北市,土城區,1912,338,436,774,36,810,1495,54.18%,22.61%,1
新北市,土城區,1913,372,344,716,33,749,1303,57.48%,28.55%,1
新北市,土城區,1914,351,389,740,33,773,1365,56.63%,25.71%,1
新北市,土城區,1915,357,397,754,67,821,1476,55.62%,24.19%,1
新北市,土城區,1916,344,474,818,28,846,1519,55.69%,22.65%,1
新北市,蘆洲區,0555,422,446,868,48,916,1600,57.25%,26.38%,1
新北市,蘆洲區,0556,398,419,817,52,869,1549,56.1%,25.69%,1
新北市,蘆洲區,0557,401,425,826,67,893,1516,58.91%,26.45%,1
新北市,蘆洲區,0558,363,353,716,59,775,1404,55.2%,25.85%,1
新北市,蘆洲區,0559,387,326,713,50,763,1381,55.25%,28.02%,1
新北市,蘆洲區,0560,365,443,808,32,840,1485,56.57%,24.58%,1
新北市,蘆洲區,0561,334,331,665,35,700,1779,39.35%,18.77%,1
新北市,蘆洲區,0562,337,587,924,33,957,1797,53.26%,18.75%,1
新北市,蘆洲區,0563,416,335,751,39,790,1364,57.92%,30.5%,1
新北市,蘆洲區,0564,438,437,875,52,927,1635,56.7%,26.79%,1
新北市,蘆洲區,0565,381,365,746,27,773,1567,49.33%,24.31%,1
新北市,蘆洲區,0566,391,392,783,38,821,1524,53.87%,25.66%,1
新北市,蘆洲區,0567,411,393,804,40,844,1612,52.36%,25.5%,1
新北市,蘆洲區,0568,393,462,855,26,881,1674,52.63%,23.48%,1
新北市,蘆洲區,0569,433,436,869,40,909,1838,49.46%,23.56%,1
新北市,蘆洲區,0570,406,377,783,32,815,1814,44.93%,22.38%,1
新北市,蘆洲區,0571,451,352,803,32,835,1473,56.69%,30.62%,1
新北市,蘆洲區,0572,364,397,761,32,793,1465,54.13%,24.85%,1
新北市,蘆洲區,0573,451,454,905,47,952,1652,57.63%,27.3%,1
新北市,蘆洲區,0574,499,372,871,49,920,1650,55.76%,30.24%,1
新北市,蘆洲區,0575,426,442,868,43,911,1656,55.01%,25.72%,1
新北市,蘆洲區,0576,436,353,789,41,830,1571,52.83%,27.75%,1
新北市,蘆洲區,0577,433,338,771,52,823,1523,54.04%,28.43%,1
新北市,蘆洲區,0578,385,388,773,34,807,1475,54.71%,26.1%,1
新北市,蘆洲區,0579,326,367,693,44,737,1367,53.91%,23.85%,1
新北市,蘆洲區,0580,409,414,823,42,865,1514,57.13%,27.01%,1
新北市,蘆洲區,0581,473,534,1007,47,1054,1791,58.85%,26.41%,1
新北市,蘆洲區,0582,431,565,996,41,1037,1714,60.5%,25.15%,1
新北市,蘆洲區,0583,376,613,989,28,1017,1780,57.13%,21.12%,1
新北市,蘆洲區,0584,434,502,936,36,972,1713,56.74%,25.34%,1
新北市,蘆洲區,0585,438,510,948,33,981,1720,57.03%,25.47%,1
新北市,蘆洲區,0586,443,505,948,38,986,1766,55.83%,25.08%,1
新北市,蘆洲區,0587,450,398,848,43,891,1623,54.9%,27.73%,1
新北市,蘆洲區,0588,459,430,889,83,972,1740,55.86%,26.38%,1
新北市,蘆洲區,0589,513,469,982,45,1027,1759,58.39%,29.16%,1
新北市,蘆洲區,0590,473,514,987,53,1040,1775,58.59%,26.65%,1
新北市,蘆洲區,0591,531,531,1062,34,1096,1909,57.41%,27.82%,1
新北市,蘆洲區,0592,507,495,1002,49,1051,1805,58.23%,28.09%,1
新北市,蘆洲區,0593,416,429,845,35,880,1642,53.59%,25.33%,1
新北市,蘆洲區,0594,457,432,889,40,929,1713,54.23%,26.68%,1
新北市,蘆洲區,0595,453,401,854,42,896,1746,51.32%,25.95%,1
新北市,蘆洲區,0596,433,406,839,41,880,1596,55.14%,27.13%,1
新北市,蘆洲區,0597,349,386,735,34,769,1434,53.63%,24.34%,1
新北市,蘆洲區,0598,442,338,780,30,810,1450,55.86%,30.48%,1
新北市,蘆洲區,0599,379,388,767,23,790,1543,51.2%,24.56%,1
新北市,蘆洲區,0600,414,372,786,42,828,1525,54.3%,27.15%,1
新北市,蘆洲區,0601,322,371,693,48,741,1419,52.22%,22.69%,1
新北市,蘆洲區,0602,351,348,699,43,742,1298,57.16%,27.04%,1
新北市,蘆洲區,0603,327,343,670,42,712,1304,54.6%,25.08%,1
新北市,蘆洲區,0604,442,486,928,43,971,1806,53.77%,24.47%,1
新北市,蘆洲區,0605,435,497,932,64,996,1910,52.15%,22.77%,1
新北市,蘆洲區,0606,434,387,821,44,865,1873,46.18%,23.17%,1
新北市,蘆洲區,0607,424,410,834,51,885,1785,49.58%,23.75%,1
新北市,蘆洲區,0608,437,415,852,49,901,1760,51.19%,24.83%,1
新北市,蘆洲區,0609,476,503,979,46,1025,1841,55.68%,25.86%,1
新北市,蘆洲區,0610,402,506,908,29,937,1855,50.51%,21.67%,1
新北市,蘆洲區,0611,363,322,685,53,738,1450,50.9%,25.03%,1
新北市,蘆洲區,0612,447,369,816,48,864,1585,54.51%,28.2%,1
新北市,蘆洲區,0613,425,339,764,38,802,1541,52.04%,27.58%,1
新北市,蘆洲區,0614,431,388,819,42,861,1626,52.95%,26.51%,1
新北市,蘆洲區,0615,327,347,674,47,721,1241,58.1%,26.35%,1
新北市,蘆洲區,0616,435,414,849,47,896,1634,54.83%,26.62%,1
新北市,蘆洲區,0617,392,440,832,46,878,1573,55.82%,24.92%,1
新北市,蘆洲區,0618,463,429,892,33,925,1619,57.13%,28.6%,1
新北市,蘆洲區,0619,554,415,969,58,1027,1878,54.69%,29.5%,1
新北市,蘆洲區,0620,444,468,912,60,972,1797,54.09%,24.71%,1
新北市,蘆洲區,0621,487,494,981,36,1017,1816,56%,26.82%,1
新北市,蘆洲區,0622,309,344,653,43,696,1344,51.79%,22.99%,1
新北市,蘆洲區,0623,428,400,828,55,883,1492,59.18%,28.69%,1
新北市,蘆洲區,0624,498,515,1013,49,1062,1959,54.21%,25.42%,1
新北市,蘆洲區,0625,451,372,823,60,883,1611,54.81%,28%,1
新北市,蘆洲區,0626,467,402,869,50,919,1574,58.39%,29.67%,1
新北市,蘆洲區,0627,435,443,878,53,931,1653,56.32%,26.32%,1
新北市,蘆洲區,0628,507,495,1002,51,1053,3085,34.13%,16.43%,1
新北市,蘆洲區,0629,470,450,920,56,976,1812,53.86%,25.94%,1
新北市,蘆洲區,0630,350,347,697,39,736,1332,55.26%,26.28%,1
新北市,蘆洲區,0631,371,389,760,55,815,1648,49.45%,22.51%,1
新北市,蘆洲區,0632,399,318,717,25,742,1355,54.76%,29.45%,1
新北市,蘆洲區,0633,370,331,701,34,735,1371,53.61%,26.99%,1
新北市,蘆洲區,0634,325,280,605,47,652,1111,58.69%,29.25%,1
新北市,蘆洲區,0635,347,318,665,46,711,1176,60.46%,29.51%,1
新北市,蘆洲區,0636,430,431,861,38,899,1602,56.12%,26.84%,1
新北市,蘆洲區,0637,344,318,662,34,696,1361,51.14%,25.28%,1
新北市,蘆洲區,0638,379,411,790,48,838,1530,54.77%,24.77%,1
新北市,蘆洲區,0639,267,220,487,42,529,925,57.19%,28.86%,1
新北市,蘆洲區,0640,479,480,959,57,1016,1851,54.89%,25.88%,1
新北市,蘆洲區,0641,398,443,841,35,876,1791,48.91%,22.22%,1
新北市,蘆洲區,0642,445,439,884,43,927,1853,50.03%,24.02%,1
新北市,蘆洲區,0643,342,506,848,29,877,1758,49.89%,19.45%,1
新北市,蘆洲區,0644,418,500,918,50,968,1798,53.84%,23.25%,1
新北市,蘆洲區,0645,409,457,866,43,909,1645,55.26%,24.86%,1
新北市,蘆洲區,0646,402,356,758,37,795,1612,49.32%,24.94%,1
新北市,蘆洲區,0647,454,371,825,54,879,1784,49.27%,25.45%,1
新北市,蘆洲區,0648,390,371,761,31,792,1701,46.56%,22.93%,1
新北市,蘆洲區,0649,379,408,787,36,823,1581,52.06%,23.97%,1
新北市,蘆洲區,0650,426,376,802,45,847,1534,55.22%,27.77%,1
新北市,蘆洲區,0651,494,405,899,39,938,1620,57.9%,30.49%,1
新北市,蘆洲區,0652,427,413,840,53,893,1494,59.77%,28.58%,1
新北市,蘆洲區,0653,340,297,637,29,666,1183,56.3%,28.74%,1
新北市,蘆洲區,0654,297,248,545,28,573,985,58.17%,30.15%,1
新北市,蘆洲區,0655,372,445,817,59,876,1673,52.36%,22.24%,1
新北市,蘆洲區,0656,448,440,888,67,955,1688,56.58%,26.54%,1
新北市,蘆洲區,0657,326,331,657,32,689,1249,55.16%,26.1%,1
新北市,蘆洲區,0658,258,397,655,23,678,1476,45.93%,17.48%,1
新北市,五股區,0207,409,343,752,52,804,1456,55.22%,28.09%,1
新北市,五股區,0208,397,342,739,50,789,1482,53.24%,26.79%,1
新北市,五股區,0209,424,289,713,15,728,1287,56.57%,32.94%,1
新北市,五股區,0210,382,199,581,26,607,1106,54.88%,34.54%,1
新北市,五股區,0211,351,289,640,55,695,1283,54.17%,27.36%,1
新北市,五股區,0212,509,447,956,34,990,1833,54.01%,27.77%,1
新北市,五股區,0213,311,308,619,37,656,1141,57.49%,27.26%,1
新北市,五股區,0214,142,127,269,19,288,463,62.2%,30.67%,1
新北市,五股區,0215,456,493,949,39,988,1786,55.32%,25.53%,1
新北市,五股區,0216,468,376,844,28,872,1660,52.53%,28.19%,1
新北市,五股區,0217,427,358,785,60,845,1534,55.08%,27.84%,1
新北市,五股區,0218,411,281,692,51,743,1285,57.82%,31.98%,1
新北市,五股區,0219,485,397,882,86,968,1832,52.84%,26.47%,1
新北市,五股區,0220,411,383,794,35,829,1542,53.76%,26.65%,1
新北市,五股區,0221,455,427,882,40,922,1897,48.6%,23.99%,1
新北市,五股區,0222,419,474,893,74,967,1964,49.24%,21.33%,1
新北市,五股區,0223,437,388,825,62,887,1779,49.86%,24.56%,1
新北市,五股區,0224,455,403,858,51,909,1735,52.39%,26.22%,1
新北市,五股區,0225,494,615,1109,29,1138,2299,49.5%,21.49%,1
新北市,五股區,0226,414,410,824,39,863,1755,49.17%,23.59%,1
新北市,五股區,0227,431,438,869,48,917,1674,54.78%,25.75%,1
新北市,五股區,0228,458,421,879,46,925,1661,55.69%,27.57%,1
新北市,五股區,0229,389,226,615,23,638,1281,49.8%,30.37%,1
新北市,五股區,0230,371,416,787,60,847,1566,54.09%,23.69%,1
新北市,五股區,0231,379,364,743,32,775,1560,49.68%,24.29%,1
新北市,五股區,0232,357,494,851,32,883,1622,54.44%,22.01%,1
新北市,五股區,0233,408,508,916,34,950,1779,53.4%,22.93%,1
新北市,五股區,0234,356,380,736,41,777,1487,52.25%,23.94%,1
新北市,五股區,0235,400,419,819,46,865,1567,55.2%,25.53%,1
新北市,五股區,0236,275,234,509,25,534,1333,40.06%,20.63%,1
新北市,五股區,0237,381,340,721,41,762,1263,60.33%,30.17%,1
新北市,五股區,0238,355,362,717,51,768,1314,58.45%,27.02%,1
新北市,五股區,0239,342,393,735,34,769,1513,50.83%,22.6%,1
新北市,五股區,0240,360,458,818,39,857,1517,56.49%,23.73%,1
新北市,五股區,0241,400,437,837,44,881,1613,54.62%,24.8%,1
新北市,五股區,0242,403,424,827,49,876,1616,54.21%,24.94%,1
新北市,五股區,0243,391,432,823,43,866,1616,53.59%,24.2%,1
新北市,五股區,0244,412,461,873,51,924,1689,54.71%,24.39%,1
新北市,五股區,0245,512,445,957,27,984,1894,51.95%,27.03%,1
新北市,五股區,0246,380,342,722,42,764,1210,63.14%,31.4%,1
新北市,五股區,0247,387,430,817,38,855,1643,52.04%,23.55%,1
新北市,五股區,0248,343,404,747,25,772,1441,53.57%,23.8%,1
新北市,五股區,0249,326,401,727,29,756,1305,57.93%,24.98%,1
新北市,五股區,0250,321,361,682,40,722,1170,61.71%,27.44%,1
新北市,五股區,0251,281,519,800,52,852,1397,60.99%,20.11%,1
新北市,五股區,0252,205,552,757,50,807,1312,61.51%,15.63%,1
新北市,五股區,0253,130,411,541,28,569,1127,50.49%,11.54%,1
新北市,五股區,0254,139,435,574,29,603,1154,52.25%,12.05%,1
新北市,泰山區,0255,156,160,316,12,328,643,51.01%,24.26%,1
新北市,泰山區,0256,47,63,110,6,116,186,62.37%,25.27%,1
新北市,泰山區,0257,319,399,718,38,756,1457,51.89%,21.89%,1
新北市,泰山區,0258,370,470,840,49,889,1594,55.77%,23.21%,1
新北市,泰山區,0259,304,468,772,35,807,1598,50.5%,19.02%,1
新北市,泰山區,0260,333,421,754,20,774,1503,51.5%,22.16%,1
新北市,泰山區,0261,323,393,716,34,750,1436,52.23%,22.49%,1
新北市,泰山區,0262,347,397,744,25,769,1384,55.56%,25.07%,1
新北市,泰山區,0263,305,365,670,37,707,1231,57.43%,24.78%,1
新北市,泰山區,0264,314,361,675,23,698,1295,53.9%,24.25%,1
新北市,泰山區,0265,382,482,864,38,902,1563,57.71%,24.44%,1
新北市,泰山區,0266,373,520,893,43,936,1610,58.14%,23.17%,1
新北市,泰山區,0267,322,337,659,26,685,1253,54.67%,25.7%,1
新北市,泰山區,0268,279,360,639,30,669,1294,51.7%,21.56%,1
新北市,泰山區,0269,341,415,756,37,793,1354,58.57%,25.18%,1
新北市,泰山區,0270,265,406,671,22,693,1259,55.04%,21.05%,1
新北市,泰山區,0271,328,383,711,18,729,1252,58.23%,26.2%,1
新北市,泰山區,0272,284,290,574,34,608,1094,55.58%,25.96%,1
新北市,泰山區,0273,380,486,866,30,896,1590,56.35%,23.9%,1
新北市,泰山區,0274,434,448,882,38,920,1634,56.3%,26.56%,1
新北市,泰山區,0275,303,402,705,26,731,1536,47.59%,19.73%,1
新北市,泰山區,0276,361,475,836,38,874,1534,56.98%,23.53%,1
新北市,泰山區,0277,345,571,916,35,951,1545,61.55%,22.33%,1
新北市,泰山區,0278,295,461,756,28,784,1399,56.04%,21.09%,1
新北市,泰山區,0279,308,380,688,22,710,1315,53.99%,23.42%,1
新北市,泰山區,0280,353,342,695,45,740,1201,61.62%,29.39%,1
新北市,泰山區,0281,311,306,617,49,666,1182,56.35%,26.31%,1
新北市,泰山區,0282,381,464,845,42,887,1665,53.27%,22.88%,1
新北市,泰山區,0283,458,508,966,45,1011,1855,54.5%,24.69%,1
新北市,泰山區,0284,472,523,995,43,1038,1866,55.63%,25.29%,1
新北市,泰山區,0285,442,559,1001,37,1038,1935,53.64%,22.84%,1
新北市,泰山區,0286,392,398,790,30,820,1589,51.6%,24.67%,1
新北市,泰山區,0287,260,315,575,47,622,1152,53.99%,22.57%,1
新北市,泰山區,0288,288,313,601,24,625,1114,56.1%,25.85%,1
新北市,泰山區,0289,287,340,627,23,650,1040,62.5%,27.6%,1
新北市,泰山區,0290,253,318,571,30,601,1003,59.92%,25.22%,1
新北市,泰山區,0291,301,281,582,25,607,975,62.26%,30.87%,1
新北市,泰山區,0292,368,385,753,35,788,1440,54.72%,25.56%,1
新北市,泰山區,0293,348,430,778,26,804,1480,54.32%,23.51%,1
新北市,泰山區,0294,295,362,657,26,683,1211,56.4%,24.36%,1
新北市,泰山區,0295,365,338,703,18,721,1237,58.29%,29.51%,1
新北市,泰山區,0296,269,307,576,29,605,1069,56.59%,25.16%,1
新北市,泰山區,0297,396,555,951,46,997,1680,59.35%,23.57%,1
新北市,泰山區,0298,420,508,928,25,953,1651,57.72%,25.44%,1
新北市,泰山區,0299,329,409,738,21,759,1420,53.45%,23.17%,1
新北市,泰山區,0300,358,413,771,34,805,1337,60.21%,26.78%,1
新北市,泰山區,0301,437,452,889,29,918,1591,57.7%,27.47%,1
新北市,林口區,0145,336,317,653,34,687,1268,54.18%,26.5%,1
新北市,林口區,0146,266,302,568,39,607,1171,51.84%,22.72%,1
新北市,林口區,0147,298,362,660,35,695,1218,57.06%,24.47%,1
新北市,林口區,0148,386,502,888,31,919,1788,51.4%,21.59%,1
新北市,林口區,0149,393,381,774,53,827,1625,50.89%,24.18%,1
新北市,林口區,0150,351,369,720,43,763,1448,52.69%,24.24%,1
新北市,林口區,0151,310,338,648,42,690,1328,51.96%,23.34%,1
新北市,林口區,0152,311,352,663,44,707,1523,46.42%,20.42%,1
新北市,林口區,0153,277,386,663,27,690,1245,55.42%,22.25%,1
新北市,林口區,0154,320,484,804,29,833,1329,62.68%,24.08%,1
新北市,林口區,0155,352,493,845,25,870,1465,59.39%,24.03%,1
新北市,林口區,0156,338,447,785,18,803,1369,58.66%,24.69%,1
新北市,林口區,0157,374,390,764,31,795,1346,59.06%,27.79%,1
新北市,林口區,0158,329,270,599,52,651,1181,55.12%,27.86%,1
新北市,林口區,0159,324,455,779,21,800,1291,61.97%,25.1%,1
新北市,林口區,0160,305,348,653,22,675,1213,55.65%,25.14%,1
新北市,林口區,0161,305,401,706,28,734,1256,58.44%,24.28%,1
新北市,林口區,0162,313,311,624,28,652,1185,55.02%,26.41%,1
新北市,林口區,0163,404,330,734,40,774,1361,56.87%,29.68%,1
新北市,林口區,0164,271,606,877,21,898,1756,51.14%,15.43%,1
新北市,林口區,0165,318,518,836,28,864,1676,51.55%,18.97%,1
新北市,林口區,0166,307,544,851,17,868,1540,56.36%,19.94%,1
新北市,林口區,0167,285,546,831,26,857,1569,54.62%,18.16%,1
新北市,林口區,0168,282,531,813,24,837,1514,55.28%,18.63%,1
新北市,林口區,0169,272,406,678,18,696,1193,58.34%,22.8%,1
新北市,林口區,0170,354,550,904,19,923,1610,57.33%,21.99%,1
新北市,林口區,0171,330,421,751,27,778,1338,58.15%,24.66%,1
新北市,林口區,0172,315,328,643,24,667,1141,58.46%,27.61%,1
新北市,林口區,0173,310,405,715,26,741,1307,56.69%,23.72%,1
新北市,林口區,0174,284,457,741,23,764,1327,57.57%,21.4%,1
新北市,林口區,0175,308,417,725,26,751,1285,58.44%,23.97%,1
新北市,林口區,0176,431,383,814,24,838,1481,56.58%,29.1%,1
新北市,林口區,0177,344,501,845,19,864,1510,57.22%,22.78%,1
新北市,林口區,0178,383,551,934,33,967,1785,54.17%,21.46%,1
新北市,林口區,0179,395,556,951,18,969,1792,54.07%,22.04%,1
新北市,林口區,0180,319,523,842,19,861,1517,56.76%,21.03%,1
新北市,林口區,0181,295,582,877,24,901,1564,57.61%,18.86%,1
新北市,林口區,0182,294,580,874,24,898,1560,57.56%,18.85%,1
新北市,林口區,0183,340,482,822,20,842,1544,54.53%,22.02%,1
新北市,林口區,0184,321,528,849,15,864,1593,54.24%,20.15%,1
新北市,林口區,0185,281,501,782,22,804,1431,56.18%,19.64%,1
新北市,林口區,0186,316,492,808,37,845,1571,53.79%,20.11%,1
新北市,林口區,0187,275,527,802,29,831,1439,57.75%,19.11%,1
新北市,林口區,0188,315,494,809,34,843,1451,58.1%,21.71%,1
新北市,林口區,0189,354,460,814,34,848,1391,60.96%,25.45%,1
新北市,林口區,0190,292,500,792,19,811,1461,55.51%,19.99%,1
新北市,林口區,0191,320,578,898,19,917,1691,54.23%,18.92%,1
新北市,林口區,0192,300,509,809,39,848,1524,55.64%,19.69%,1
新北市,林口區,0193,295,508,803,37,840,1343,62.55%,21.97%,1
新北市,林口區,0194,336,482,818,26,844,1398,60.37%,24.03%,1
新北市,林口區,0195,350,458,808,25,833,1380,60.36%,25.36%,1
新北市,林口區,0196,314,428,742,36,778,1367,56.91%,22.97%,1
新北市,林口區,0197,333,434,767,20,787,1350,58.3%,24.67%,1
新北市,林口區,0198,278,392,670,33,703,1194,58.88%,23.28%,1
新北市,林口區,0199,303,406,709,28,737,1344,54.84%,22.54%,1
新北市,林口區,0200,289,338,627,30,657,1154,56.93%,25.04%,1
新北市,林口區,0201,277,394,671,28,699,1119,62.47%,24.75%,1
新北市,林口區,0202,276,192,468,37,505,1026,49.22%,26.9%,1
新北市,林口區,0203,308,339,647,33,680,1210,56.2%,25.45%,1
新北市,林口區,0204,269,209,478,42,520,912,57.02%,29.5%,1
新北市,林口區,0205,234,228,462,26,488,824,59.22%,28.4%,1
新北市,林口區,0206,382,401,783,51,834,1411,59.11%,27.07%,1
新北市,深坑區,2163,268,307,575,29,604,1142,52.89%,23.47%,1
新北市,深坑區,2164,280,361,641,34,675,1139,59.26%,24.58%,1
新北市,深坑區,2165,274,249,523,58,581,1065,54.55%,25.73%,1
新北市,深坑區,2166,294,400,694,28,722,1400,51.57%,21%,1
新北市,深坑區,2167,303,377,680,36,716,1330,53.83%,22.78%,1
新北市,深坑區,2168,305,375,680,31,711,1380,51.52%,22.1%,1
新北市,深坑區,2169,329,384,713,11,724,1496,48.4%,21.99%,1
新北市,深坑區,2170,367,466,833,40,873,1508,57.89%,24.34%,1
新北市,深坑區,2171,505,382,887,45,932,1624,57.39%,31.1%,1
新北市,深坑區,2172,477,647,1124,45,1169,2165,54%,22.03%,1
新北市,深坑區,2173,419,595,1014,52,1066,1790,59.55%,23.41%,1
新北市,深坑區,2174,204,203,407,22,429,782,54.86%,26.09%,1
新北市,深坑區,2175,257,421,678,13,691,1164,59.36%,22.08%,1
新北市,深坑區,2176,303,463,766,38,804,1344,59.82%,22.54%,1
新北市,深坑區,2177,219,226,445,16,461,739,62.38%,29.63%,1
新北市,深坑區,2178,161,158,319,19,338,556,60.79%,28.96%,1
新北市,石碇區,2179,119,111,230,14,244,391,62.4%,30.43%,1
新北市,石碇區,2180,172,217,389,24,413,789,52.34%,21.8%,1
新北市,石碇區,2181,134,137,271,12,283,662,42.75%,20.24%,1
新北市,石碇區,2182,70,82,152,11,163,310,52.58%,22.58%,1
新北市,石碇區,2183,71,76,147,5,152,280,54.29%,25.36%,1
新北市,石碇區,2184,21,15,36,2,38,93,40.86%,22.58%,1
新北市,石碇區,2185,151,145,296,22,318,683,46.56%,22.11%,1
新北市,石碇區,2186,98,103,201,7,208,323,64.4%,30.34%,1
新北市,石碇區,2187,132,151,283,7,290,726,39.94%,18.18%,1
新北市,石碇區,2188,148,152,300,19,319,591,53.98%,25.04%,1
新北市,石碇區,2189,109,67,176,18,194,282,68.79%,38.65%,1
新北市,石碇區,2190,188,171,359,17,376,788,47.72%,23.86%,1
新北市,石碇區,2191,292,220,512,45,557,943,59.07%,30.97%,1
新北市,坪林區,2192,322,330,652,35,687,1248,55.05%,25.8%,1
新北市,坪林區,2193,150,133,283,14,297,612,48.53%,24.51%,1
新北市,坪林區,2194,348,267,615,41,656,1141,57.49%,30.5%,1
新北市,坪林區,2195,99,86,185,4,189,417,45.32%,23.74%,1
新北市,坪林區,2196,166,147,313,23,336,595,56.47%,27.9%,1
新北市,坪林區,2197,73,71,144,10,154,248,62.1%,29.44%,1
新北市,坪林區,2198,91,71,162,8,170,338,50.3%,26.92%,1
新北市,坪林區,2199,107,88,195,18,213,478,44.56%,22.38%,1
新北市,坪林區,2200,79,82,161,8,169,390,43.33%,20.26%,1
新北市,坪林區,2201,111,79,190,19,209,424,49.29%,26.18%,1
新北市,三芝區,0011,81,62,143,7,150,312,48.08%,25.96%,1
新北市,三芝區,0012,298,372,670,33,703,1421,49.47%,20.97%,1
新北市,三芝區,0013,330,442,772,42,814,1557,52.28%,21.19%,1
新北市,三芝區,0014,427,476,903,52,955,1828,52.24%,23.36%,1
新北市,三芝區,0015,254,262,516,28,544,1060,51.32%,23.96%,1
新北市,三芝區,0016,165,169,334,28,362,819,44.2%,20.15%,1
新北市,三芝區,0017,298,411,709,26,735,1701,43.21%,17.52%,1
新北市,三芝區,0018,357,437,794,50,844,1740,48.51%,20.52%,1
新北市,三芝區,0019,298,350,648,35,683,1451,47.07%,20.54%,1
新北市,三芝區,0020,239,293,532,42,574,1248,45.99%,19.15%,1
新北市,三芝區,0021,165,161,326,15,341,629,54.21%,26.23%,1
新北市,三芝區,0022,86,124,210,23,233,504,46.23%,17.06%,1
新北市,三芝區,0023,157,157,314,8,322,698,46.13%,22.49%,1
新北市,三芝區,0024,405,569,974,28,1002,2069,48.43%,19.57%,1
新北市,三芝區,0025,169,225,394,27,421,784,53.7%,21.56%,1
新北市,三芝區,0026,123,116,239,25,264,522,50.57%,23.56%,1
新北市,三芝區,0027,146,144,290,22,312,587,53.15%,24.87%,1
新北市,三芝區,0028,303,266,569,41,610,1189,51.3%,25.48%,1
新北市,石門區,0001,261,291,552,32,584,1121,52.1%,23.28%,1
新北市,石門區,0002,297,332,629,43,672,1389,48.38%,21.38%,1
新北市,石門區,0003,230,235,465,35,500,933,53.59%,24.65%,1
新北市,石門區,0004,269,313,582,42,624,1244,50.16%,21.62%,1
新北市,石門區,0005,225,227,452,37,489,883,55.38%,25.48%,1
新北市,石門區,0006,347,482,829,33,862,1564,55.12%,22.19%,1
新北市,石門區,0007,333,427,760,41,801,1500,53.4%,22.2%,1
新北市,石門區,0008,71,77,148,4,152,328,46.34%,21.65%,1
新北市,石門區,0009,167,222,389,16,405,651,62.21%,25.65%,1
新北市,石門區,0010,152,223,375,38,413,915,45.14%,16.61%,1
新北市,八里區,0125,320,396,716,40,756,1498,50.47%,21.36%,1
新北市,八里區,0126,363,505,868,32,900,1939,46.42%,18.72%,1
新北市,八里區,0127,329,435,764,47,811,1516,53.5%,21.7%,1
新北市,八里區,0128,396,503,899,45,944,1642,57.49%,24.12%,1
新北市,八里區,0129,441,449,890,58,948,1927,49.2%,22.89%,1
新北市,八里區,0130,306,355,661,36,697,1276,54.62%,23.98%,1
新北市,八里區,0131,371,388,759,33,792,1349,58.71%,27.5%,1
新北市,八里區,0132,351,408,759,33,792,1403,56.45%,25.02%,1
新北市,八里區,0133,433,422,855,38,893,1644,54.32%,26.34%,1
新北市,八里區,0134,464,492,956,47,1003,1853,54.13%,25.04%,1
新北市,八里區,0135,420,569,989,52,1041,1793,58.06%,23.42%,1
新北市,八里區,0136,386,453,839,44,883,1644,53.71%,23.48%,1
新北市,八里區,0137,439,487,926,43,969,1846,52.49%,23.78%,1
新北市,八里區,0138,337,365,702,24,726,1346,53.94%,25.04%,1
新北市,八里區,0139,375,460,835,39,874,1621,53.92%,23.13%,1
新北市,八里區,0140,362,529,891,51,942,2110,44.64%,17.16%,1
新北市,八里區,0141,430,529,959,50,1009,1967,51.3%,21.86%,1
新北市,八里區,0142,379,476,855,45,900,1626,55.35%,23.31%,1
新北市,八里區,0143,369,417,786,50,836,1514,55.22%,24.37%,1
新北市,八里區,0144,311,440,751,90,841,1456,57.76%,21.36%,1
新北市,平溪區,2208,103,84,187,10,197,384,51.3%,26.82%,1
新北市,平溪區,2209,51,50,101,1,102,232,43.97%,21.98%,1
新北市,平溪區,2210,72,61,133,7,140,249,56.22%,28.92%,1
新北市,平溪區,2211,140,96,236,21,257,458,56.11%,30.57%,1
新北市,平溪區,2212,63,51,114,14,128,232,55.17%,27.16%,1
新北市,平溪區,2213,121,138,259,12,271,635,42.68%,19.06%,1
新北市,平溪區,2214,113,115,228,19,247,427,57.85%,26.46%,1
新北市,平溪區,2215,187,168,355,27,382,862,44.32%,21.69%,1
新北市,平溪區,2216,41,29,70,4,74,147,50.34%,27.89%,1
新北市,平溪區,2217,63,68,131,9,140,365,38.36%,17.26%,1
新北市,平溪區,2218,27,36,63,7,70,153,45.75%,17.65%,1
新北市,平溪區,2219,44,59,103,7,110,177,62.15%,24.86%,1
新北市,雙溪區,2266,70,131,201,16,217,455,47.69%,15.38%,1
新北市,雙溪區,2267,60,81,141,7,148,286,51.75%,20.98%,1
新北市,雙溪區,2268,117,149,266,12,278,496,56.05%,23.59%,1
新北市,雙溪區,2269,79,81,160,10,170,383,44.39%,20.63%,1
新北市,雙溪區,2270,162,181,343,38,381,887,42.95%,18.26%,1
新北市,雙溪區,2271,101,155,256,23,279,652,42.79%,15.49%,1
新北市,雙溪區,2272,90,84,174,4,178,333,53.45%,27.03%,1
新北市,雙溪區,2273,131,161,292,30,322,642,50.16%,20.4%,1
新北市,雙溪區,2274,62,68,130,7,137,282,48.58%,21.99%,1
新北市,雙溪區,2275,125,129,254,17,271,621,43.64%,20.13%,1
新北市,雙溪區,2276,105,85,190,4,194,422,45.97%,24.88%,1
新北市,雙溪區,2277,89,37,126,13,139,369,37.67%,24.12%,1
新北市,雙溪區,2278,28,32,60,5,65,120,54.17%,23.33%,1
新北市,雙溪區,2279,72,60,132,7,139,271,51.29%,26.57%,1
新北市,雙溪區,2280,101,98,199,13,212,362,58.56%,27.9%,1
新北市,雙溪區,2281,92,94,186,10,196,371,52.83%,24.8%,1
新北市,雙溪區,2282,267,316,583,39,622,1047,59.41%,25.5%,1
新北市,貢寮區,2283,188,216,404,34,438,876,50%,21.46%,1
新北市,貢寮區,2284,120,85,205,18,223,433,51.5%,27.71%,1
新北市,貢寮區,2285,128,114,242,10,252,516,48.84%,24.81%,1
新北市,貢寮區,2286,83,53,136,17,153,373,41.02%,22.25%,1
新北市,貢寮區,2287,73,75,148,8,156,313,49.84%,23.32%,1
新北市,貢寮區,2288,109,130,239,9,248,485,51.13%,22.47%,1
新北市,貢寮區,2289,112,77,189,24,213,415,51.33%,26.99%,1
新北市,貢寮區,2290,196,142,338,19,357,812,43.97%,24.14%,1
新北市,貢寮區,2291,208,183,391,29,420,861,48.78%,24.16%,1
新北市,貢寮區,2292,188,103,291,21,312,676,46.15%,27.81%,1
新北市,貢寮區,2293,226,188,414,23,437,1091,40.05%,20.71%,1
新北市,貢寮區,2294,224,153,377,28,405,955,42.41%,23.46%,1
新北市,貢寮區,2295,175,146,321,9,330,769,42.91%,22.76%,1
新北市,貢寮區,2296,238,211,449,25,474,962,49.27%,24.74%,1
新北市,貢寮區,2297,102,105,207,8,215,390,55.13%,26.15%,1
新北市,貢寮區,2298,88,74,162,6,168,349,48.14%,25.21%,1
新北市,貢寮區,2299,115,84,199,11,210,508,41.34%,22.64%,1
新北市,貢寮區,2300,98,77,175,9,184,495,37.17%,19.8%,1
新北市,金山區,2301,105,145,250,12,262,481,54.47%,21.83%,1
新北市,金山區,2302,174,178,352,31,383,715,53.57%,24.34%,1
新北市,金山區,2303,95,99,194,22,216,481,44.91%,19.75%,1
新北市,金山區,2304,386,303,689,161,850,1792,47.43%,21.54%,1
新北市,金山區,2305,421,451,872,47,919,1781,51.6%,23.64%,1
新北市,金山區,2306,459,582,1041,46,1087,2010,54.08%,22.84%,1
新北市,金山區,2307,331,403,734,40,774,1572,49.24%,21.06%,1
新北市,金山區,2308,362,495,857,55,912,1777,51.32%,20.37%,1
新北市,金山區,2309,322,407,729,41,770,1631,47.21%,19.74%,1
新北市,金山區,2310,197,216,413,22,435,828,52.54%,23.79%,1
新北市,金山區,2311,228,221,449,18,467,888,52.59%,25.68%,1
新北市,金山區,2312,279,297,576,38,614,1211,50.7%,23.04%,1
新北市,金山區,2313,124,106,230,12,242,416,58.17%,29.81%,1
新北市,金山區,2314,196,168,364,36,400,682,58.65%,28.74%,1
新北市,金山區,2315,163,146,309,41,350,644,54.35%,25.31%,1
新北市,金山區,2316,168,214,382,29,411,830,49.52%,20.24%,1
新北市,金山區,2317,43,47,90,12,102,188,54.26%,22.87%,1
新北市,金山區,2318,137,107,244,16,260,469,55.44%,29.21%,1
新北市,金山區,2319,108,101,209,15,224,582,38.49%,18.56%,1
新北市,萬里區,2320,277,375,652,45,697,1286,54.2%,21.54%,1
新北市,萬里區,2321,397,416,813,47,860,1576,54.57%,25.19%,1
新北市,萬里區,2322,309,362,671,37,708,1447,48.93%,21.35%,1
新北市,萬里區,2323,286,340,626,51,677,1466,46.18%,19.51%,1
新北市,萬里區,2324,251,305,556,39,595,1369,43.46%,18.33%,1
新北市,萬里區,2325,216,228,444,33,477,1215,39.26%,17.78%,1
新北市,萬里區,2326,310,332,642,52,694,1317,52.7%,23.54%,1
新北市,萬里區,2327,332,368,700,41,741,1676,44.21%,19.81%,1
新北市,萬里區,2328,321,372,693,49,742,1550,47.87%,20.71%,1
新北市,萬里區,2329,242,310,552,40,592,945,62.65%,25.61%,1
新北市,萬里區,2330,400,518,918,47,965,1760,54.83%,22.73%,1
新北市,萬里區,2331,116,155,271,20,291,570,51.05%,20.35%,1
新北市,萬里區,2332,250,210,460,22,482,952,50.63%,26.26%,1
新北市,萬里區,2333,192,170,362,39,401,674,59.5%,28.49%,1
新北市,萬里區,2334,94,114,208,15,223,405,55.06%,23.21%,1
新北市,萬里區,2335,221,297,518,33,551,1089,50.6%,20.29%,1
新北市,烏來區,2202,381,528,909,45,954,1568,60.84%,24.3%,1
新北市,烏來區,2203,238,360,598,11,609,1198,50.83%,19.87%,1
新北市,烏來區,2204,236,331,567,22,589,1169,50.38%,20.19%,1
新北市,烏來區,2205,59,63,122,4,126,228,55.26%,25.88%,1
新北市,烏來區,2206,125,134,259,20,279,486,57.41%,25.72%,1
新北市,烏來區,2207,122,159,281,18,299,615,48.62%,19.84%,1
桃園市,桃園區,0001,352,425,777,31,808,1593,50.72%,22.1%,1
桃園市,桃園區,0002,401,433,834,20,854,1934,44.16%,20.73%,1
桃園市,桃園區,0003,403,480,883,35,918,1661,55.27%,24.26%,1
桃園市,桃園區,0004,279,380,659,20,679,1448,46.89%,19.27%,1
桃園市,桃園區,0005,461,467,928,27,955,1974,48.38%,23.35%,1
桃園市,桃園區,0006,383,458,841,36,877,1882,46.6%,20.35%,1
桃園市,桃園區,0007,374,492,866,28,894,1800,49.67%,20.78%,1
桃園市,桃園區,0008,401,436,837,35,872,1598,54.57%,25.09%,1
桃園市,桃園區,0009,366,371,737,44,781,1626,48.03%,22.51%,1
桃園市,桃園區,0010,343,421,764,36,800,1590,50.31%,21.57%,1
桃園市,桃園區,0011,368,435,803,38,841,1637,51.37%,22.48%,1
桃園市,桃園區,0012,419,486,905,46,951,1943,48.94%,21.56%,1
桃園市,桃園區,0013,362,398,760,24,784,1482,52.9%,24.43%,1
桃園市,桃園區,0014,319,440,759,24,783,1423,55.02%,22.42%,1
桃園市,桃園區,0015,345,462,807,30,837,1509,55.47%,22.86%,1
桃園市,桃園區,0016,295,529,824,26,850,1567,54.24%,18.83%,1
桃園市,桃園區,0017,290,382,672,27,699,1305,53.56%,22.22%,1
桃園市,桃園區,0018,281,381,662,38,700,1416,49.44%,19.84%,1
桃園市,桃園區,0019,358,431,789,27,816,1439,56.71%,24.88%,1
桃園市,桃園區,0020,330,426,756,31,787,1399,56.25%,23.59%,1
桃園市,桃園區,0021,360,476,836,27,863,1540,56.04%,23.38%,1
桃園市,桃園區,0022,334,434,768,37,805,1638,49.15%,20.39%,1
桃園市,桃園區,0023,270,376,646,24,670,1228,54.56%,21.99%,1
桃園市,桃園區,0024,218,578,796,37,833,1649,50.52%,13.22%,1
桃園市,桃園區,0025,369,453,822,20,842,1601,52.59%,23.05%,1
桃園市,桃園區,0026,320,402,722,48,770,1477,52.13%,21.67%,1
桃園市,桃園區,0027,358,446,804,22,826,1503,54.96%,23.82%,1
桃園市,桃園區,0028,400,368,768,38,806,1375,58.62%,29.09%,1
桃園市,桃園區,0029,457,470,927,25,952,1743,54.62%,26.22%,1
桃園市,桃園區,0030,377,502,879,32,911,1862,48.93%,20.25%,1
桃園市,桃園區,0031,305,575,880,33,913,1728,52.84%,17.65%,1
桃園市,桃園區,0032,165,188,353,18,371,690,53.77%,23.91%,1
桃園市,桃園區,0033,259,240,499,22,521,852,61.15%,30.4%,1
桃園市,桃園區,0034,350,403,753,34,787,1353,58.17%,25.87%,1
桃園市,桃園區,0035,349,313,662,27,689,1698,40.58%,20.55%,1
桃園市,桃園區,0036,350,355,705,37,742,1452,51.1%,24.1%,1
桃園市,桃園區,0037,400,405,805,77,882,1681,52.47%,23.8%,1
桃園市,桃園區,0038,402,428,830,34,864,1669,51.77%,24.09%,1
桃園市,桃園區,0039,393,457,850,30,880,1530,57.52%,25.69%,1
桃園市,桃園區,0040,371,463,834,38,872,1582,55.12%,23.45%,1
桃園市,桃園區,0041,328,409,737,32,769,1587,48.46%,20.67%,1
桃園市,桃園區,0042,350,417,767,45,812,1451,55.96%,24.12%,1
桃園市,桃園區,0043,355,352,707,18,725,1582,45.83%,22.44%,1
桃園市,桃園區,0044,321,255,576,31,607,1028,59.05%,31.23%,1
桃園市,桃園區,0045,421,501,922,51,973,1934,50.31%,21.77%,1
桃園市,桃園區,0046,235,302,537,28,565,1016,55.61%,23.13%,1
桃園市,桃園區,0047,283,292,575,20,595,1079,55.14%,26.23%,1
桃園市,桃園區,0048,361,524,885,27,912,1837,49.65%,19.65%,1
桃園市,桃園區,0049,392,365,757,37,794,1390,57.12%,28.2%,1
桃園市,桃園區,0050,331,439,770,31,801,1489,53.79%,22.23%,1
桃園市,桃園區,0051,319,682,1001,21,1022,1821,56.12%,17.52%,1
桃園市,桃園區,0052,315,432,747,17,764,1563,48.88%,20.15%,1
桃園市,桃園區,0053,375,496,871,45,916,1697,53.98%,22.1%,1
桃園市,桃園區,0054,350,558,908,33,941,1740,54.08%,20.11%,1
桃園市,桃園區,0055,364,461,825,38,863,1626,53.08%,22.39%,1
桃園市,桃園區,0056,270,421,691,15,706,1239,56.98%,21.79%,1
桃園市,桃園區,0057,366,555,921,27,948,1766,53.68%,20.72%,1
桃園市,桃園區,0058,365,439,804,37,841,1555,54.08%,23.47%,1
桃園市,桃園區,0059,375,557,932,29,961,1831,52.48%,20.48%,1
桃園市,桃園區,0060,339,324,663,9,672,1115,60.27%,30.4%,1
桃園市,桃園區,0061,393,440,833,30,863,1562,55.25%,25.16%,1
桃園市,桃園區,0062,348,523,871,27,898,1744,51.49%,19.95%,1
桃園市,桃園區,0063,369,460,829,35,864,1838,47.01%,20.08%,1
桃園市,桃園區,0064,460,524,984,42,1026,1889,54.31%,24.35%,1
桃園市,桃園區,0065,362,538,900,39,939,1985,47.3%,18.24%,1
桃園市,桃園區,0066,364,471,835,47,882,1524,57.87%,23.88%,1
桃園市,桃園區,0067,355,495,850,30,880,1425,61.75%,24.91%,1
桃園市,桃園區,0068,337,555,892,45,937,1606,58.34%,20.98%,1
桃園市,桃園區,0069,418,711,1129,26,1155,2056,56.18%,20.33%,1
桃園市,桃園區,0070,389,698,1087,27,1114,2010,55.42%,19.35%,1
桃園市,桃園區,0071,375,693,1068,45,1113,2245,49.58%,16.7%,1
桃園市,桃園區,0072,346,372,718,27,745,1590,46.86%,21.76%,1
桃園市,桃園區,0073,318,583,901,24,925,1536,60.22%,20.7%,1
桃園市,桃園區,0074,417,510,927,24,951,1949,48.79%,21.4%,1
桃園市,桃園區,0075,370,565,935,41,976,1965,49.67%,18.83%,1
桃園市,桃園區,0076,625,625,1250,48,1298,2414,53.77%,25.89%,1
桃園市,桃園區,0077,493,476,969,40,1009,1942,51.96%,25.39%,1
桃園市,桃園區,0078,472,605,1077,43,1120,2156,51.95%,21.89%,1
桃園市,桃園區,0079,350,407,757,44,801,1404,57.05%,24.93%,1
桃園市,桃園區,0080,315,390,705,27,732,1194,61.31%,26.38%,1
桃園市,桃園區,0081,395,402,797,47,844,1449,58.25%,27.26%,1
桃園市,桃園區,0082,390,449,839,48,887,1803,49.2%,21.63%,1
桃園市,桃園區,0083,392,473,865,40,905,1692,53.49%,23.17%,1
桃園市,桃園區,0084,432,526,958,50,1008,1913,52.69%,22.58%,1
桃園市,桃園區,0085,406,451,857,37,894,1815,49.26%,22.37%,1
桃園市,桃園區,0086,267,294,561,32,593,1173,50.55%,22.76%,1
桃園市,桃園區,0087,219,342,561,21,582,1162,50.09%,18.85%,1
桃園市,桃園區,0088,224,289,513,45,558,1194,46.73%,18.76%,1
桃園市,桃園區,0089,379,488,867,40,907,1695,53.51%,22.36%,1
桃園市,桃園區,0090,378,513,891,28,919,1797,51.14%,21.04%,1
桃園市,桃園區,0091,286,512,798,23,821,1592,51.57%,17.96%,1
桃園市,桃園區,0092,342,510,852,52,904,1780,50.79%,19.21%,1
桃園市,桃園區,0093,344,501,845,27,872,1904,45.8%,18.07%,1
桃園市,桃園區,0094,345,637,982,18,1000,2021,49.48%,17.07%,1
桃園市,桃園區,0095,219,533,752,44,796,1545,51.52%,14.17%,1
桃園市,桃園區,0096,270,476,746,38,784,1617,48.48%,16.7%,1
桃園市,桃園區,0097,482,348,830,30,860,1683,51.1%,28.64%,1
桃園市,桃園區,0098,380,563,943,20,963,1834,52.51%,20.72%,1
桃園市,桃園區,0099,390,559,949,31,980,2055,47.69%,18.98%,1
桃園市,桃園區,0100,361,523,884,22,906,1828,49.56%,19.75%,1
桃園市,桃園區,0101,391,516,907,15,922,1873,49.23%,20.88%,1
桃園市,桃園區,0102,313,433,746,28,774,3687,20.99%,8.49%,1
桃園市,桃園區,0103,406,572,978,29,1007,1850,54.43%,21.95%,1
桃園市,桃園區,0104,597,296,893,31,924,1827,50.57%,32.68%,1
桃園市,桃園區,0105,320,343,663,29,692,1149,60.23%,27.85%,1
桃園市,桃園區,0106,296,309,605,25,630,1061,59.38%,27.9%,1
桃園市,桃園區,0107,357,495,852,29,881,1831,48.12%,19.5%,1
桃園市,桃園區,0108,412,638,1050,34,1084,2168,50%,19%,1
桃園市,桃園區,0109,369,529,898,19,917,1874,48.93%,19.69%,1
桃園市,桃園區,0110,304,385,689,22,711,1524,46.65%,19.95%,1
桃園市,桃園區,0111,284,496,780,27,807,1528,52.81%,18.59%,1
桃園市,桃園區,0112,320,453,773,39,812,1489,54.53%,21.49%,1
桃園市,桃園區,0113,330,326,656,31,687,1308,52.52%,25.23%,1
桃園市,桃園區,0114,352,427,779,39,818,1583,51.67%,22.24%,1
桃園市,桃園區,0115,460,408,868,21,889,1618,54.94%,28.43%,1
桃園市,桃園區,0116,476,533,1009,51,1060,2127,49.84%,22.38%,1
桃園市,桃園區,0117,394,582,976,23,999,2033,49.14%,19.38%,1
桃園市,桃園區,0118,401,639,1040,25,1065,2098,50.76%,19.11%,1
桃園市,桃園區,0119,467,629,1096,47,1143,2126,53.76%,21.97%,1
桃園市,桃園區,0120,539,384,923,25,948,1917,49.45%,28.12%,1
桃園市,桃園區,0121,352,596,948,34,982,1997,49.17%,17.63%,1
桃園市,桃園區,0122,394,598,992,27,1019,1929,52.83%,20.43%,1
桃園市,桃園區,0123,351,489,840,24,864,1691,51.09%,20.76%,1
桃園市,桃園區,0124,338,602,940,29,969,1900,51%,17.79%,1
桃園市,桃園區,0125,369,524,893,42,935,1761,53.09%,20.95%,1
桃園市,桃園區,0126,385,565,950,26,976,1922,50.78%,20.03%,1
桃園市,桃園區,0127,466,499,965,36,1001,1995,50.18%,23.36%,1
桃園市,桃園區,0128,305,270,575,27,602,1063,56.63%,28.69%,1
桃園市,桃園區,0129,293,415,708,30,738,1412,52.27%,20.75%,1
桃園市,桃園區,0130,363,557,920,20,940,1746,53.84%,20.79%,1
桃園市,桃園區,0131,370,430,800,41,841,1689,49.79%,21.91%,1
桃園市,桃園區,0132,334,357,691,26,717,1542,46.5%,21.66%,1
桃園市,桃園區,0133,338,356,694,33,727,1437,50.59%,23.52%,1
桃園市,桃園區,0134,448,423,871,25,896,1679,53.37%,26.68%,1
桃園市,桃園區,0135,368,480,848,33,881,1886,46.71%,19.51%,1
桃園市,桃園區,0136,374,480,854,46,900,1657,54.32%,22.57%,1
桃園市,桃園區,0137,324,384,708,22,730,1349,54.11%,24.02%,1
桃園市,桃園區,0138,375,550,925,27,952,1805,52.74%,20.78%,1
桃園市,桃園區,0139,418,479,897,46,943,1846,51.08%,22.64%,1
桃園市,桃園區,0140,384,366,750,33,783,1644,47.63%,23.36%,1
桃園市,桃園區,0141,335,441,776,30,806,1674,48.15%,20.01%,1
桃園市,桃園區,0142,363,500,863,25,888,1737,51.12%,20.9%,1
桃園市,桃園區,0143,359,443,802,38,840,1566,53.64%,22.92%,1
桃園市,桃園區,0144,342,438,780,31,811,1517,53.46%,22.54%,1
桃園市,桃園區,0145,284,448,732,22,754,1619,46.57%,17.54%,1
桃園市,桃園區,0146,300,582,882,30,912,1774,51.41%,16.91%,1
桃園市,桃園區,0147,309,531,840,27,867,1666,52.04%,18.55%,1
桃園市,桃園區,0148,304,479,783,14,797,1528,52.16%,19.9%,1
桃園市,桃園區,0149,337,474,811,34,845,1709,49.44%,19.72%,1
桃園市,桃園區,0150,341,486,827,22,849,1719,49.39%,19.84%,1
桃園市,桃園區,0151,311,391,702,31,733,1569,46.72%,19.82%,1
桃園市,桃園區,0152,270,433,703,38,741,1505,49.24%,17.94%,1
桃園市,桃園區,0153,354,368,722,43,765,1496,51.14%,23.66%,1
桃園市,桃園區,0154,335,453,788,20,808,1505,53.69%,22.26%,1
桃園市,桃園區,0155,340,546,886,28,914,1807,50.58%,18.82%,1
桃園市,桃園區,0156,355,579,934,35,969,1857,52.18%,19.12%,1
桃園市,桃園區,0157,326,538,864,45,909,1589,57.21%,20.52%,1
桃園市,桃園區,0158,396,627,1023,36,1059,2088,50.72%,18.97%,1
桃園市,桃園區,0159,360,574,934,27,961,1893,50.77%,19.02%,1
桃園市,桃園區,0160,242,321,563,29,592,1303,45.43%,18.57%,1
桃園市,桃園區,0161,310,428,738,21,759,1416,53.6%,21.89%,1
桃園市,桃園區,0162,288,360,648,23,671,1351,49.67%,21.32%,1
桃園市,桃園區,0163,340,469,809,19,828,1659,49.91%,20.49%,1
桃園市,桃園區,0164,371,620,991,32,1023,2103,48.64%,17.64%,1
桃園市,桃園區,0165,333,606,939,25,964,1943,49.61%,17.14%,1
桃園市,桃園區,0166,399,541,940,46,986,1927,51.17%,20.71%,1
桃園市,桃園區,0167,382,471,853,34,887,1929,45.98%,19.8%,1
桃園市,桃園區,0168,485,723,1208,22,1230,2204,55.81%,22.01%,1
桃園市,桃園區,0169,402,504,906,24,930,2033,45.75%,19.77%,1
桃園市,桃園區,0170,301,524,825,15,840,1656,50.72%,18.18%,1
桃園市,桃園區,0171,352,484,836,39,875,1712,51.11%,20.56%,1
桃園市,桃園區,0172,338,501,839,43,882,1738,50.75%,19.45%,1
桃園市,桃園區,0173,335,511,846,25,871,1432,60.82%,23.39%,1
桃園市,桃園區,0174,319,467,786,36,822,1421,57.85%,22.45%,1
桃園市,桃園區,0175,289,398,687,21,708,1344,52.68%,21.5%,1
桃園市,桃園區,0176,331,550,881,26,907,1942,46.7%,17.04%,1
桃園市,桃園區,0177,390,593,983,29,1012,2001,50.57%,19.49%,1
桃園市,桃園區,0178,342,536,878,22,900,1941,46.37%,17.62%,1
桃園市,桃園區,0179,402,496,898,19,917,1702,53.88%,23.62%,1
桃園市,桃園區,0180,307,486,793,36,829,1589,52.17%,19.32%,1
桃園市,桃園區,0181,292,463,755,37,792,1544,51.3%,18.91%,1
桃園市,桃園區,0182,388,423,811,19,830,1860,44.62%,20.86%,1
桃園市,桃園區,0183,381,462,843,30,873,1726,50.58%,22.07%,1
桃園市,桃園區,0184,365,481,846,34,880,1798,48.94%,20.3%,1
桃園市,桃園區,0185,408,559,967,22,989,1925,51.38%,21.19%,1
桃園市,桃園區,0186,444,514,958,39,997,1945,51.26%,22.83%,1
桃園市,桃園區,0187,408,393,801,40,841,1764,47.68%,23.13%,1
桃園市,桃園區,0188,425,553,978,58,1036,1899,54.56%,22.38%,1
桃園市,桃園區,0189,310,416,726,12,738,1415,52.16%,21.91%,1
桃園市,桃園區,0190,302,534,836,24,860,1790,48.04%,16.87%,1
桃園市,桃園區,0191,326,480,806,21,827,1693,48.85%,19.26%,1
桃園市,桃園區,0192,455,453,908,35,943,1916,49.22%,23.75%,1
桃園市,桃園區,0193,332,348,680,23,703,1434,49.02%,23.15%,1
桃園市,桃園區,0194,374,455,829,26,855,1494,57.23%,25.03%,1
桃園市,桃園區,0195,346,336,682,43,725,1311,55.3%,26.39%,1
桃園市,桃園區,0196,378,388,766,28,794,1476,53.79%,25.61%,1
桃園市,桃園區,0197,380,429,809,22,831,1484,56%,25.61%,1
桃園市,桃園區,0198,338,419,757,34,791,1514,52.25%,22.32%,1
桃園市,桃園區,0199,349,373,722,40,762,1446,52.7%,24.14%,1
桃園市,桃園區,0200,325,437,762,20,782,1573,49.71%,20.66%,1
桃園市,桃園區,0201,298,402,700,27,727,1564,46.48%,19.05%,1
桃園市,桃園區,0202,282,267,549,27,576,1015,56.75%,27.78%,1
桃園市,桃園區,0203,236,230,466,22,488,955,51.1%,24.71%,1
桃園市,桃園區,0204,372,511,883,25,908,1796,50.56%,20.71%,1
桃園市,桃園區,0205,364,535,899,16,915,1878,48.72%,19.38%,1
桃園市,桃園區,0206,334,497,831,34,865,1729,50.03%,19.32%,1
桃園市,桃園區,0207,311,525,836,22,858,1843,46.55%,16.87%,1
桃園市,桃園區,0208,311,442,753,32,785,1817,43.2%,17.12%,1
桃園市,桃園區,0209,274,262,536,21,557,979,56.89%,27.99%,1
桃園市,桃園區,0210,283,424,707,21,728,1363,53.41%,20.76%,1
桃園市,桃園區,0211,326,456,782,14,796,1546,51.49%,21.09%,1
桃園市,桃園區,0212,289,351,640,22,662,1308,50.61%,22.09%,1
桃園市,桃園區,0213,443,584,1027,46,1073,2164,49.58%,20.47%,1
桃園市,桃園區,0214,389,553,942,30,972,2020,48.12%,19.26%,1
桃園市,桃園區,0215,333,504,837,27,864,1924,44.91%,17.31%,1
桃園市,桃園區,0216,336,542,878,28,906,2088,43.39%,16.09%,1
桃園市,中壢區,0591,267,441,708,40,748,1401,53.39%,19.06%,1
桃園市,中壢區,0592,377,491,868,32,900,1798,50.06%,20.97%,1
桃園市,中壢區,0593,303,448,751,31,782,1642,47.62%,18.45%,1
桃園市,中壢區,0594,316,539,855,38,893,1670,53.47%,18.92%,1
桃園市,中壢區,0595,348,441,789,19,808,1456,55.49%,23.9%,1
桃園市,中壢區,0596,357,514,871,38,909,1531,59.37%,23.32%,1
桃園市,中壢區,0597,301,603,904,39,943,1623,58.1%,18.55%,1
桃園市,中壢區,0598,278,589,867,29,896,1953,45.88%,14.23%,1
桃園市,中壢區,0599,240,394,634,28,662,1155,57.32%,20.78%,1
桃園市,中壢區,0600,263,552,815,32,847,1800,47.06%,14.61%,1
桃園市,中壢區,0601,274,557,831,21,852,1757,48.49%,15.59%,1
桃園市,中壢區,0602,259,464,723,43,766,1281,59.8%,20.22%,1
桃園市,中壢區,0603,313,487,800,30,830,1462,56.77%,21.41%,1
桃園市,中壢區,0604,262,471,733,47,780,1560,50%,16.79%,1
桃園市,中壢區,0605,344,544,888,52,940,1602,58.68%,21.47%,1
桃園市,中壢區,0606,216,405,621,25,646,1006,64.21%,21.47%,1
桃園市,中壢區,0607,262,551,813,24,837,1474,56.78%,17.77%,1
桃園市,中壢區,0608,187,641,828,48,876,1627,53.84%,11.49%,1
桃園市,中壢區,0609,277,547,824,35,859,1519,56.55%,18.24%,1
桃園市,中壢區,0610,229,543,772,71,843,1526,55.24%,15.01%,1
桃園市,中壢區,0611,274,536,810,63,873,1618,53.96%,16.93%,1
桃園市,中壢區,0612,249,605,854,49,903,1554,58.11%,16.02%,1
桃園市,中壢區,0613,223,641,864,62,926,1706,54.28%,13.07%,1
桃園市,中壢區,0614,324,671,995,41,1036,1818,56.99%,17.82%,1
桃園市,中壢區,0615,331,636,967,34,1001,1991,50.28%,16.62%,1
桃園市,中壢區,0616,291,533,824,37,861,1609,53.51%,18.09%,1
桃園市,中壢區,0617,145,483,628,25,653,1329,49.13%,10.91%,1
桃園市,中壢區,0618,229,519,748,48,796,1587,50.16%,14.43%,1
桃園市,中壢區,0619,288,673,961,34,995,1955,50.9%,14.73%,1
桃園市,中壢區,0620,314,544,858,31,889,1711,51.96%,18.35%,1
桃園市,中壢區,0621,696,153,849,31,880,1712,51.4%,40.65%,1
桃園市,中壢區,0622,260,537,797,39,836,1448,57.73%,17.96%,1
桃園市,中壢區,0623,253,536,789,46,835,1605,52.02%,15.76%,1
桃園市,中壢區,0624,242,514,756,15,771,1633,47.21%,14.82%,1
桃園市,中壢區,0625,456,501,957,50,1007,1795,56.1%,25.4%,1
桃園市,中壢區,0626,175,719,894,21,915,1689,54.17%,10.36%,1
桃園市,中壢區,0627,241,401,642,31,673,1201,56.04%,20.07%,1
桃園市,中壢區,0628,297,397,694,27,721,1353,53.29%,21.95%,1
桃園市,中壢區,0629,297,457,754,34,788,1587,49.65%,18.71%,1
桃園市,中壢區,0630,385,580,965,40,1005,1883,53.37%,20.45%,1
桃園市,中壢區,0631,253,468,721,24,745,1448,51.45%,17.47%,1
桃園市,中壢區,0632,360,566,926,31,957,1810,52.87%,19.89%,1
桃園市,中壢區,0633,363,565,928,56,984,1916,51.36%,18.95%,1
桃園市,中壢區,0634,249,416,665,24,689,1177,58.54%,21.16%,1
桃園市,中壢區,0635,315,498,813,31,844,1410,59.86%,22.34%,1
桃園市,中壢區,0636,318,390,708,19,727,1368,53.14%,23.25%,1
桃園市,中壢區,0637,334,491,825,31,856,1424,60.11%,23.46%,1
桃園市,中壢區,0638,313,544,857,25,882,1573,56.07%,19.9%,1
桃園市,中壢區,0639,263,374,637,23,660,1152,57.29%,22.83%,1
桃園市,中壢區,0640,288,354,642,16,658,1178,55.86%,24.45%,1
桃園市,中壢區,0641,400,626,1026,37,1063,1966,54.07%,20.35%,1
桃園市,中壢區,0642,248,445,693,23,716,3474,20.61%,7.14%,1
桃園市,中壢區,0643,393,697,1090,48,1138,2099,54.22%,18.72%,1
桃園市,中壢區,0644,225,410,635,34,669,1178,56.79%,19.1%,1
桃園市,中壢區,0645,300,511,811,46,857,1397,61.35%,21.47%,1
桃園市,中壢區,0646,363,526,889,42,931,1669,55.78%,21.75%,1
桃園市,中壢區,0647,397,578,975,36,1011,2087,48.44%,19.02%,1
桃園市,中壢區,0648,385,557,942,33,975,1900,51.32%,20.26%,1
桃園市,中壢區,0649,306,399,705,19,724,1640,44.15%,18.66%,1
桃園市,中壢區,0650,157,412,569,28,597,994,60.06%,15.79%,1
桃園市,中壢區,0651,231,467,698,32,730,1131,64.54%,20.42%,1
桃園市,中壢區,0652,357,564,921,38,959,1625,59.02%,21.97%,1
桃園市,中壢區,0653,353,481,834,26,860,1384,62.14%,25.51%,1
桃園市,中壢區,0654,300,512,812,45,857,1588,53.97%,18.89%,1
桃園市,中壢區,0655,260,490,750,36,786,1445,54.39%,17.99%,1
桃園市,中壢區,0656,286,539,825,43,868,1743,49.8%,16.41%,1
桃園市,中壢區,0657,330,551,881,29,910,1812,50.22%,18.21%,1
桃園市,中壢區,0658,272,476,748,43,791,1546,51.16%,17.59%,1
桃園市,中壢區,0659,229,422,651,42,693,1290,53.72%,17.75%,1
桃園市,中壢區,0660,300,700,1000,74,1074,2145,50.07%,13.99%,1
桃園市,中壢區,0661,228,455,683,35,718,1451,49.48%,15.71%,1
桃園市,中壢區,0662,266,478,744,36,780,1489,52.38%,17.86%,1
桃園市,中壢區,0663,152,295,447,19,466,827,56.35%,18.38%,1
桃園市,中壢區,0664,254,473,727,22,749,1442,51.94%,17.61%,1
桃園市,中壢區,0665,334,531,865,14,879,1842,47.72%,18.13%,1
桃園市,中壢區,0666,243,477,720,30,750,1520,49.34%,15.99%,1
桃園市,中壢區,0667,308,481,789,37,826,1764,46.83%,17.46%,1
桃園市,中壢區,0668,258,540,798,25,823,1488,55.31%,17.34%,1
桃園市,中壢區,0669,292,518,810,42,852,1593,53.48%,18.33%,1
桃園市,中壢區,0670,277,485,762,39,801,1505,53.22%,18.41%,1
桃園市,中壢區,0671,326,526,852,21,873,1661,52.56%,19.63%,1
桃園市,中壢區,0672,268,520,788,31,819,1492,54.89%,17.96%,1
桃園市,中壢區,0673,265,329,594,23,617,1249,49.4%,21.22%,1
桃園市,中壢區,0674,245,433,678,23,701,1257,55.77%,19.49%,1
桃園市,中壢區,0675,275,539,814,52,866,1659,52.2%,16.58%,1
桃園市,中壢區,0676,319,626,945,38,983,1815,54.16%,17.58%,1
桃園市,中壢區,0677,289,534,823,44,867,1702,50.94%,16.98%,1
桃園市,中壢區,0678,274,531,805,22,827,1541,53.67%,17.78%,1
桃園市,中壢區,0679,273,497,770,48,818,1659,49.31%,16.46%,1
桃園市,中壢區,0680,200,700,900,74,974,1874,51.97%,10.67%,1
桃園市,中壢區,0681,178,594,772,36,808,1603,50.41%,11.1%,1
桃園市,中壢區,0682,269,582,851,32,883,1735,50.89%,15.5%,1
桃園市,中壢區,0683,294,596,890,22,912,1815,50.25%,16.2%,1
桃園市,中壢區,0684,323,588,911,26,937,1873,50.03%,17.25%,1
桃園市,中壢區,0685,205,722,927,42,969,1739,55.72%,11.79%,1
桃園市,中壢區,0686,169,642,811,37,848,1709,49.62%,9.89%,1
桃園市,中壢區,0687,264,599,863,49,912,1655,55.11%,15.95%,1
桃園市,中壢區,0688,265,604,869,20,889,1664,53.43%,15.93%,1
桃園市,中壢區,0689,224,324,548,18,566,1087,52.07%,20.61%,1
桃園市,中壢區,0690,230,336,566,33,599,1065,56.24%,21.6%,1
桃園市,中壢區,0691,394,562,956,42,998,1844,54.12%,21.37%,1
桃園市,中壢區,0692,228,331,559,37,596,1220,48.85%,18.69%,1
桃園市,中壢區,0693,249,385,634,25,659,1219,54.06%,20.43%,1
桃園市,中壢區,0694,282,381,663,37,700,1260,55.56%,22.38%,1
桃園市,中壢區,0695,309,572,881,48,929,1594,58.28%,19.39%,1
桃園市,中壢區,0696,438,461,899,48,947,1733,54.65%,25.27%,1
桃園市,中壢區,0697,347,662,1009,39,1048,1979,52.96%,17.53%,1
桃園市,中壢區,0698,350,520,870,21,891,1621,54.97%,21.59%,1
桃園市,中壢區,0699,303,454,757,27,784,1391,56.36%,21.78%,1
桃園市,中壢區,0700,278,547,825,25,850,1531,55.52%,18.16%,1
桃園市,中壢區,0701,322,579,901,34,935,1943,48.12%,16.57%,1
桃園市,中壢區,0702,276,421,697,23,720,1363,52.82%,20.25%,1
桃園市,中壢區,0703,357,590,947,43,990,2172,45.58%,16.44%,1
桃園市,中壢區,0704,285,559,844,35,879,1798,48.89%,15.85%,1
桃園市,中壢區,0705,271,532,803,25,828,1671,49.55%,16.22%,1
桃園市,中壢區,0706,369,580,949,33,982,1969,49.87%,18.74%,1
桃園市,中壢區,0707,370,576,946,33,979,1563,62.64%,23.67%,1
桃園市,中壢區,0708,341,593,934,43,977,1762,55.45%,19.35%,1
桃園市,中壢區,0709,278,516,794,33,827,1923,43.01%,14.46%,1
桃園市,中壢區,0710,326,527,853,50,903,1572,57.44%,20.74%,1
桃園市,中壢區,0711,398,595,993,27,1020,1850,55.14%,21.51%,1
桃園市,中壢區,0712,309,461,770,52,822,1583,51.93%,19.52%,1
桃園市,中壢區,0713,366,508,874,33,907,1735,52.28%,21.1%,1
桃園市,中壢區,0714,274,407,681,17,698,1292,54.02%,21.21%,1
桃園市,中壢區,0715,260,406,666,18,684,1265,54.07%,20.55%,1
桃園市,中壢區,0716,408,500,908,29,937,1798,52.11%,22.69%,1
桃園市,中壢區,0717,453,560,1013,39,1052,1822,57.74%,24.86%,1
桃園市,中壢區,0718,362,477,839,23,862,1613,53.44%,22.44%,1
桃園市,中壢區,0719,339,393,732,26,758,1405,53.95%,24.13%,1
桃園市,中壢區,0720,405,536,941,46,987,1730,57.05%,23.41%,1
桃園市,中壢區,0721,322,507,829,24,853,1384,61.63%,23.27%,1
桃園市,中壢區,0722,251,371,622,18,640,1122,57.04%,22.37%,1
桃園市,中壢區,0723,256,319,575,31,606,992,61.09%,25.81%,1
桃園市,中壢區,0724,375,553,928,26,954,1820,52.42%,20.6%,1
桃園市,中壢區,0725,344,574,918,29,947,1847,51.27%,18.62%,1
桃園市,中壢區,0726,297,427,724,38,762,1302,58.53%,22.81%,1
桃園市,中壢區,0727,266,404,670,28,698,1203,58.02%,22.11%,1
桃園市,中壢區,0728,294,458,752,43,795,1226,64.85%,23.98%,1
桃園市,中壢區,0729,249,446,695,33,728,1234,59%,20.18%,1
桃園市,中壢區,0730,312,598,910,46,956,2023,47.26%,15.42%,1
桃園市,中壢區,0731,259,468,727,27,754,1555,48.49%,16.66%,1
桃園市,中壢區,0732,384,555,939,44,983,1951,50.38%,19.68%,1
桃園市,中壢區,0733,333,412,745,28,773,1383,55.89%,24.08%,1
桃園市,中壢區,0734,249,428,677,28,705,1164,60.57%,21.39%,1
桃園市,中壢區,0735,267,528,795,27,822,1482,55.47%,18.02%,1
桃園市,中壢區,0736,339,578,917,35,952,1770,53.79%,19.15%,1
桃園市,中壢區,0737,438,524,962,36,998,1703,58.6%,25.72%,1
桃園市,中壢區,0738,383,554,937,47,984,1841,53.45%,20.8%,1
桃園市,中壢區,0739,379,659,1038,28,1066,1941,54.92%,19.53%,1
桃園市,中壢區,0740,346,744,1090,27,1117,2029,55.05%,17.05%,1
桃園市,中壢區,0741,364,542,906,32,938,1636,57.33%,22.25%,1
桃園市,中壢區,0742,333,510,843,30,873,1528,57.13%,21.79%,1
桃園市,中壢區,0743,300,746,1046,57,1103,2289,48.19%,13.11%,1
桃園市,中壢區,0744,424,581,1005,28,1033,2020,51.14%,20.99%,1
桃園市,中壢區,0745,419,627,1046,42,1088,2027,53.68%,20.67%,1
桃園市,中壢區,0746,327,493,820,17,837,1883,44.45%,17.37%,1
桃園市,中壢區,0747,368,617,985,40,1025,2080,49.28%,17.69%,1
桃園市,中壢區,0748,152,185,337,15,352,646,54.49%,23.53%,1
桃園市,中壢區,0749,628,438,1066,44,1110,1780,62.36%,35.28%,1
桃園市,中壢區,0750,298,467,765,21,786,1372,57.29%,21.72%,1
桃園市,中壢區,0751,359,567,926,34,960,1668,57.55%,21.52%,1
桃園市,中壢區,0752,431,540,971,29,1000,1987,50.33%,21.69%,1
桃園市,中壢區,0753,325,455,780,33,813,1520,53.49%,21.38%,1
桃園市,中壢區,0754,219,226,445,27,472,852,55.4%,25.7%,1
桃園市,中壢區,0755,266,379,645,26,671,1209,55.5%,22%,1
桃園市,中壢區,0756,331,429,760,50,810,1481,54.69%,22.35%,1
桃園市,中壢區,0757,270,463,733,20,753,1564,48.15%,17.26%,1
桃園市,中壢區,0758,464,585,1049,32,1081,1957,55.24%,23.71%,1
桃園市,中壢區,0759,301,361,662,36,698,1223,57.07%,24.61%,1
桃園市,中壢區,0760,294,384,678,26,704,1182,59.56%,24.87%,1
桃園市,中壢區,0761,267,330,597,35,632,1066,59.29%,25.05%,1
桃園市,中壢區,0762,371,584,955,24,979,1701,57.55%,21.81%,1
桃園市,中壢區,0763,214,271,485,20,505,943,53.55%,22.69%,1
桃園市,中壢區,0764,191,239,430,14,444,731,60.74%,26.13%,1
桃園市,中壢區,0765,217,252,469,30,499,851,58.64%,25.5%,1
桃園市,中壢區,0766,293,254,547,20,567,1011,56.08%,28.98%,1
桃園市,中壢區,0767,397,473,870,30,900,1532,58.75%,25.91%,1
桃園市,中壢區,0768,251,277,528,35,563,1028,54.77%,24.42%,1
桃園市,中壢區,0769,310,329,639,38,677,1157,58.51%,26.79%,1
桃園市,中壢區,0770,361,461,822,32,854,1591,53.68%,22.69%,1
桃園市,中壢區,0771,347,638,985,43,1028,2156,47.68%,16.09%,1
桃園市,中壢區,0772,300,414,714,13,727,1479,49.15%,20.28%,1
桃園市,中壢區,0773,368,543,911,33,944,1780,53.03%,20.67%,1
桃園市,中壢區,0774,383,470,853,41,894,1651,54.15%,23.2%,1
桃園市,中壢區,0775,337,666,1003,27,1030,1870,55.08%,18.02%,1
桃園市,中壢區,0776,236,617,853,21,874,1913,45.69%,12.34%,1
桃園市,中壢區,0777,336,410,746,40,786,1609,48.85%,20.88%,1
桃園市,中壢區,0778,349,407,756,34,790,1539,51.33%,22.68%,1
桃園市,中壢區,0779,303,441,744,25,769,1426,53.93%,21.25%,1
桃園市,中壢區,0780,325,447,772,29,801,1618,49.51%,20.09%,1
桃園市,中壢區,0781,290,453,743,40,783,1441,54.34%,20.12%,1
桃園市,中壢區,0782,329,474,803,42,845,1528,55.3%,21.53%,1
桃園市,中壢區,0783,387,465,852,60,912,1683,54.19%,22.99%,1
桃園市,中壢區,0784,404,622,1026,48,1074,1945,55.22%,20.77%,1
桃園市,中壢區,0785,395,398,793,33,826,1534,53.85%,25.75%,1
桃園市,中壢區,0786,354,524,878,49,927,1810,51.22%,19.56%,1
桃園市,中壢區,0787,251,278,529,33,562,1097,51.23%,22.88%,1
桃園市,中壢區,0788,363,542,905,29,934,1917,48.72%,18.94%,1
桃園市,中壢區,0789,367,557,924,32,956,1858,51.45%,19.75%,1
桃園市,中壢區,0790,449,360,809,47,856,1576,54.31%,28.49%,1
桃園市,中壢區,0791,387,420,807,27,834,1478,56.43%,26.18%,1
桃園市,中壢區,0792,362,455,817,25,842,1589,52.99%,22.78%,1
桃園市,中壢區,0793,488,562,1050,66,1116,2037,54.79%,23.96%,1
桃園市,中壢區,0794,341,333,674,29,703,1158,60.71%,29.45%,1
桃園市,中壢區,0795,526,508,1034,48,1082,1967,55.01%,26.74%,1
桃園市,中壢區,0796,407,474,881,41,922,1830,50.38%,22.24%,1
桃園市,中壢區,0797,433,514,947,52,999,1856,53.83%,23.33%,1
桃園市,中壢區,0798,452,556,1008,50,1058,2068,51.16%,21.86%,1
桃園市,中壢區,0799,376,486,862,30,892,2152,41.45%,17.47%,1
桃園市,中壢區,0800,423,527,950,39,989,2158,45.83%,19.6%,1
桃園市,大溪區,0522,450,357,807,37,844,1477,57.14%,30.47%,1
桃園市,大溪區,0523,310,250,560,26,586,1006,58.25%,30.82%,1
桃園市,大溪區,0524,357,423,780,40,820,1553,52.8%,22.99%,1
桃園市,大溪區,0525,446,390,836,41,877,1597,54.92%,27.93%,1
桃園市,大溪區,0526,351,351,702,31,733,1358,53.98%,25.85%,1
桃園市,大溪區,0527,342,389,731,32,763,1585,48.14%,21.58%,1
桃園市,大溪區,0528,380,430,810,33,843,1612,52.3%,23.57%,1
桃園市,大溪區,0529,350,373,723,29,752,1555,48.36%,22.51%,1
桃園市,大溪區,0530,339,395,734,39,773,1282,60.3%,26.44%,1
桃園市,大溪區,0531,285,418,703,34,737,1392,52.95%,20.47%,1
桃園市,大溪區,0532,356,341,697,36,733,1422,51.55%,25.04%,1
桃園市,大溪區,0533,354,382,736,51,787,1448,54.35%,24.45%,1
桃園市,大溪區,0534,389,353,742,39,781,1269,61.54%,30.65%,1
桃園市,大溪區,0535,323,228,551,49,600,977,61.41%,33.06%,1
桃園市,大溪區,0536,430,335,765,34,799,1359,58.79%,31.64%,1
桃園市,大溪區,0537,319,331,650,44,694,1135,61.15%,28.11%,1
桃園市,大溪區,0538,202,138,340,14,354,660,53.64%,30.61%,1
桃園市,大溪區,0539,282,229,511,26,537,1056,50.85%,26.7%,1
桃園市,大溪區,0540,320,306,626,29,655,1263,51.86%,25.34%,1
桃園市,大溪區,0541,209,167,376,28,404,717,56.35%,29.15%,1
桃園市,大溪區,0542,320,266,586,13,599,1299,46.11%,24.63%,1
桃園市,大溪區,0543,288,229,517,29,546,976,55.94%,29.51%,1
桃園市,大溪區,0544,240,233,473,35,508,938,54.16%,25.59%,1
桃園市,大溪區,0545,189,216,405,31,436,832,52.4%,22.72%,1
桃園市,大溪區,0546,220,167,387,16,403,866,46.54%,25.4%,1
桃園市,大溪區,0547,180,150,330,24,354,694,51.01%,25.94%,1
桃園市,大溪區,0548,408,308,716,30,746,1410,52.91%,28.94%,1
桃園市,大溪區,0549,256,350,606,44,650,1303,49.88%,19.65%,1
桃園市,大溪區,0550,271,285,556,37,593,1125,52.71%,24.09%,1
桃園市,大溪區,0551,267,362,629,18,647,1170,55.3%,22.82%,1
桃園市,大溪區,0552,299,440,739,27,766,1308,58.56%,22.86%,1
桃園市,大溪區,0553,258,305,563,58,621,1094,56.76%,23.58%,1
桃園市,大溪區,0554,471,622,1093,56,1149,2153,53.37%,21.88%,1
桃園市,大溪區,0555,148,492,640,42,682,1173,58.14%,12.62%,1
桃園市,大溪區,0556,204,473,677,26,703,1369,51.35%,14.9%,1
桃園市,大溪區,0557,235,446,681,60,741,1446,51.24%,16.25%,1
桃園市,大溪區,0558,166,427,593,34,627,1406,44.59%,11.81%,1
桃園市,大溪區,0559,317,516,833,28,861,1592,54.08%,19.91%,1
桃園市,大溪區,0560,341,473,814,41,855,1497,57.11%,22.78%,1
桃園市,大溪區,0561,362,476,838,46,884,1559,56.7%,23.22%,1
桃園市,大溪區,0562,356,505,861,23,884,1684,52.49%,21.14%,1
桃園市,大溪區,0563,448,599,1047,39,1086,1959,55.44%,22.87%,1
桃園市,大溪區,0564,317,411,728,51,779,1369,56.9%,23.16%,1
桃園市,大溪區,0565,297,462,759,43,802,1431,56.04%,20.75%,1
桃園市,大溪區,0566,278,400,678,23,701,1657,42.31%,16.78%,1
桃園市,大溪區,0567,269,317,586,27,613,1387,44.2%,19.39%,1
桃園市,大溪區,0568,221,322,543,34,577,1085,53.18%,20.37%,1
桃園市,大溪區,0569,331,429,760,35,795,1403,56.66%,23.59%,1
桃園市,大溪區,0570,375,347,722,62,784,1511,51.89%,24.82%,1
桃園市,大溪區,0571,380,362,742,62,804,1719,46.77%,22.11%,1
桃園市,大溪區,0572,350,394,744,48,792,1717,46.13%,20.38%,1
桃園市,大溪區,0573,226,332,558,54,612,1207,50.7%,18.72%,1
桃園市,大溪區,0574,195,409,604,73,677,1188,56.99%,16.41%,1
桃園市,大溪區,0575,292,419,711,27,738,1514,48.75%,19.29%,1
桃園市,大溪區,0576,271,543,814,45,859,1529,56.18%,17.72%,1
桃園市,大溪區,0577,237,478,715,28,743,1260,58.97%,18.81%,1
桃園市,大溪區,0578,167,299,466,10,476,831,57.28%,20.1%,1
桃園市,大溪區,0579,318,436,754,33,787,1407,55.93%,22.6%,1
桃園市,大溪區,0580,343,374,717,42,759,1494,50.8%,22.96%,1
桃園市,楊梅區,0926,251,420,671,46,717,1269,56.5%,19.78%,1
桃園市,楊梅區,0927,257,463,720,53,773,1246,62.04%,20.63%,1
桃園市,楊梅區,0928,266,516,782,39,821,1408,58.31%,18.89%,1
桃園市,楊梅區,0929,299,466,765,32,797,1434,55.58%,20.85%,1
桃園市,楊梅區,0930,252,495,747,45,792,1515,52.28%,16.63%,1
桃園市,楊梅區,0931,259,506,765,43,808,1657,48.76%,15.63%,1
桃園市,楊梅區,0932,201,424,625,29,654,1137,57.52%,17.68%,1
桃園市,楊梅區,0933,345,711,1056,41,1097,2211,49.62%,15.6%,1
桃園市,楊梅區,0934,321,667,988,25,1013,2008,50.45%,15.99%,1
桃園市,楊梅區,0935,350,573,923,42,965,1911,50.5%,18.32%,1
桃園市,楊梅區,0936,322,447,769,48,817,1449,56.38%,22.22%,1
桃園市,楊梅區,0937,295,523,818,51,869,1877,46.3%,15.72%,1
桃園市,楊梅區,0938,349,570,919,38,957,1988,48.14%,17.56%,1
桃園市,楊梅區,0939,345,645,990,28,1018,1931,52.72%,17.87%,1
桃園市,楊梅區,0940,400,603,1003,28,1031,1938,53.2%,20.64%,1
桃園市,楊梅區,0941,279,578,857,24,881,1677,52.53%,16.64%,1
桃園市,楊梅區,0942,332,573,905,29,934,1848,50.54%,17.97%,1
桃園市,楊梅區,0943,338,595,933,30,963,1882,51.17%,17.96%,1
桃園市,楊梅區,0944,243,370,613,17,630,1541,40.88%,15.77%,1
桃園市,楊梅區,0945,325,584,909,42,951,1938,49.07%,16.77%,1
桃園市,楊梅區,0946,259,447,706,13,719,1562,46.03%,16.58%,1
桃園市,楊梅區,0947,423,731,1154,34,1188,2125,55.91%,19.91%,1
桃園市,楊梅區,0948,281,573,854,38,892,1516,58.84%,18.54%,1
桃園市,楊梅區,0949,290,583,873,22,895,1807,49.53%,16.05%,1
桃園市,楊梅區,0950,361,615,976,29,1005,2101,47.83%,17.18%,1
桃園市,楊梅區,0951,370,664,1034,41,1075,2054,52.34%,18.01%,1
桃園市,楊梅區,0952,354,650,1004,33,1037,2226,46.59%,15.9%,1
桃園市,楊梅區,0953,237,505,742,19,761,1405,54.16%,16.87%,1
桃園市,楊梅區,0954,304,552,856,23,879,1843,47.69%,16.49%,1
桃園市,楊梅區,0955,370,625,995,38,1033,2324,44.45%,15.92%,1
桃園市,楊梅區,0956,319,566,885,14,899,1713,52.48%,18.62%,1
桃園市,楊梅區,0957,286,589,875,47,922,1587,58.1%,18.02%,1
桃園市,楊梅區,0958,275,518,793,26,819,1416,57.84%,19.42%,1
桃園市,楊梅區,0959,304,541,845,30,875,1591,55%,19.11%,1
桃園市,楊梅區,0960,325,640,965,32,997,1943,51.31%,16.73%,1
桃園市,楊梅區,0961,342,594,936,27,963,1762,54.65%,19.41%,1
桃園市,楊梅區,0962,211,361,572,27,599,1083,55.31%,19.48%,1
桃園市,楊梅區,0963,341,654,995,54,1049,2027,51.75%,16.82%,1
桃園市,楊梅區,0964,268,416,684,47,731,1274,57.38%,21.04%,1
桃園市,楊梅區,0965,257,490,747,37,784,1359,57.69%,18.91%,1
桃園市,楊梅區,0966,329,520,849,27,876,2444,35.84%,13.46%,1
桃園市,楊梅區,0967,373,636,1009,32,1041,2298,45.3%,16.23%,1
桃園市,楊梅區,0968,356,700,1056,36,1092,2222,49.14%,16.02%,1
桃園市,楊梅區,0969,309,478,787,66,853,1610,52.98%,19.19%,1
桃園市,楊梅區,0970,287,507,794,71,865,1627,53.17%,17.64%,1
桃園市,楊梅區,0971,332,505,837,39,876,1589,55.13%,20.89%,1
桃園市,楊梅區,0972,319,558,877,58,935,1758,53.19%,18.15%,1
桃園市,楊梅區,0973,326,421,747,34,781,1776,43.98%,18.36%,1
桃園市,楊梅區,0974,221,256,477,22,499,1000,49.9%,22.1%,1
桃園市,楊梅區,0975,378,602,980,70,1050,2290,45.85%,16.51%,1
桃園市,楊梅區,0976,314,471,785,36,821,1551,52.93%,20.25%,1
桃園市,楊梅區,0977,325,576,901,44,945,1861,50.78%,17.46%,1
桃園市,楊梅區,0978,202,301,503,38,541,1141,47.41%,17.7%,1
桃園市,楊梅區,0979,338,503,841,28,869,1785,48.68%,18.94%,1
桃園市,楊梅區,0980,308,445,753,46,799,1498,53.34%,20.56%,1
桃園市,楊梅區,0981,232,355,587,40,627,1187,52.82%,19.55%,1
桃園市,楊梅區,0982,257,413,670,39,709,1270,55.83%,20.24%,1
桃園市,楊梅區,0983,302,420,722,27,749,1424,52.6%,21.21%,1
桃園市,楊梅區,0984,275,480,755,23,778,1273,61.12%,21.6%,1
桃園市,楊梅區,0985,295,385,680,31,711,1534,46.35%,19.23%,1
桃園市,楊梅區,0986,296,452,748,48,796,1783,44.64%,16.6%,1
桃園市,楊梅區,0987,314,485,799,18,817,1709,47.81%,18.37%,1
桃園市,楊梅區,0988,342,496,838,49,887,1920,46.2%,17.81%,1
桃園市,楊梅區,0989,266,373,639,20,659,1194,55.19%,22.28%,1
桃園市,楊梅區,0990,304,450,754,20,774,1408,54.97%,21.59%,1
桃園市,楊梅區,0991,270,476,746,39,785,1737,45.19%,15.54%,1
桃園市,楊梅區,0992,295,633,928,22,950,1920,49.48%,15.36%,1
桃園市,楊梅區,0993,278,349,627,29,656,1234,53.16%,22.53%,1
桃園市,楊梅區,0994,290,487,777,54,831,1491,55.73%,19.45%,1
桃園市,楊梅區,0995,353,571,924,33,957,2020,47.38%,17.48%,1
桃園市,楊梅區,0996,360,485,845,20,865,1863,46.43%,19.32%,1
桃園市,楊梅區,0997,399,494,893,39,932,1692,55.08%,23.58%,1
桃園市,楊梅區,0998,329,525,854,22,876,1686,51.96%,19.51%,1
桃園市,楊梅區,0999,327,525,852,37,889,1626,54.67%,20.11%,1
桃園市,楊梅區,1000,298,537,835,15,850,1557,54.59%,19.14%,1
桃園市,楊梅區,1001,399,501,900,32,932,1603,58.14%,24.89%,1
桃園市,楊梅區,1002,306,573,879,48,927,1889,49.07%,16.2%,1
桃園市,楊梅區,1003,268,509,777,29,806,1448,55.66%,18.51%,1
桃園市,楊梅區,1004,270,459,729,42,771,1351,57.07%,19.99%,1
桃園市,楊梅區,1005,255,473,728,40,768,1313,58.49%,19.42%,1
桃園市,楊梅區,1006,324,521,845,35,880,1689,52.1%,19.18%,1
桃園市,楊梅區,1007,327,612,939,30,969,2063,46.97%,15.85%,1
桃園市,蘆竹區,0396,384,304,688,39,727,1358,53.53%,28.28%,1
桃園市,蘆竹區,0397,397,338,735,51,786,1538,51.11%,25.81%,1
桃園市,蘆竹區,0398,398,459,857,48,905,2118,42.73%,18.79%,1
桃園市,蘆竹區,0399,447,455,902,43,945,1673,56.49%,26.72%,1
桃園市,蘆竹區,0400,336,453,789,20,809,1500,53.93%,22.4%,1
桃園市,蘆竹區,0401,380,494,874,35,909,1699,53.5%,22.37%,1
桃園市,蘆竹區,0402,438,666,1104,44,1148,2250,51.02%,19.47%,1
桃園市,蘆竹區,0403,436,576,1012,27,1039,2354,44.14%,18.52%,1
桃園市,蘆竹區,0404,334,365,699,24,723,1446,50%,23.1%,1
桃園市,蘆竹區,0405,380,352,732,42,774,1623,47.69%,23.41%,1
桃園市,蘆竹區,0406,341,482,823,28,851,1747,48.71%,19.52%,1
桃園市,蘆竹區,0407,396,565,961,59,1020,1988,51.31%,19.92%,1
桃園市,蘆竹區,0408,312,415,727,33,760,1437,52.89%,21.71%,1
桃園市,蘆竹區,0409,388,430,818,46,864,1532,56.4%,25.33%,1
桃園市,蘆竹區,0410,301,431,732,23,755,1447,52.18%,20.8%,1
桃園市,蘆竹區,0411,512,560,1072,48,1120,2189,51.16%,23.39%,1
桃園市,蘆竹區,0412,356,663,1019,55,1074,2498,42.99%,14.25%,1
桃園市,蘆竹區,0413,335,364,699,34,733,1322,55.45%,25.34%,1
桃園市,蘆竹區,0414,433,382,815,43,858,1991,43.09%,21.75%,1
桃園市,蘆竹區,0415,480,471,951,55,1006,2097,47.97%,22.89%,1
桃園市,蘆竹區,0416,329,493,822,28,850,1558,54.56%,21.12%,1
桃園市,蘆竹區,0417,602,354,956,39,995,1891,52.62%,31.84%,1
桃園市,蘆竹區,0418,305,430,735,38,773,1590,48.62%,19.18%,1
桃園市,蘆竹區,0419,430,613,1043,41,1084,2404,45.09%,17.89%,1
桃園市,蘆竹區,0420,482,725,1207,43,1250,2522,49.56%,19.11%,1
桃園市,蘆竹區,0421,353,473,826,22,848,1633,51.93%,21.62%,1
桃園市,蘆竹區,0422,351,493,844,36,880,1715,51.31%,20.47%,1
桃園市,蘆竹區,0423,458,546,1004,31,1035,2215,46.73%,20.68%,1
桃園市,蘆竹區,0424,415,537,952,30,982,2029,48.4%,20.45%,1
桃園市,蘆竹區,0425,365,445,810,34,844,1731,48.76%,21.09%,1
桃園市,蘆竹區,0426,340,554,894,32,926,1820,50.88%,18.68%,1
桃園市,蘆竹區,0427,364,479,843,46,889,1633,54.44%,22.29%,1
桃園市,蘆竹區,0428,346,398,744,29,773,1668,46.34%,20.74%,1
桃園市,蘆竹區,0429,339,451,790,27,817,1493,54.72%,22.71%,1
桃園市,蘆竹區,0430,400,539,939,45,984,1864,52.79%,21.46%,1
桃園市,蘆竹區,0431,374,443,817,30,847,1703,49.74%,21.96%,1
桃園市,蘆竹區,0432,407,499,906,37,943,1893,49.82%,21.5%,1
桃園市,蘆竹區,0433,446,567,1013,48,1061,1922,55.2%,23.2%,1
桃園市,蘆竹區,0434,300,427,727,19,746,1393,53.55%,21.54%,1
桃園市,蘆竹區,0435,296,413,709,26,735,1338,54.93%,22.12%,1
桃園市,蘆竹區,0436,321,501,822,33,855,1688,50.65%,19.02%,1
桃園市,蘆竹區,0437,357,359,716,40,756,1462,51.71%,24.42%,1
桃園市,蘆竹區,0438,295,334,629,24,653,1232,53%,23.94%,1
桃園市,蘆竹區,0439,258,341,599,22,621,1356,45.8%,19.03%,1
桃園市,蘆竹區,0440,307,369,676,27,703,1181,59.53%,25.99%,1
桃園市,蘆竹區,0441,226,361,587,23,610,1199,50.88%,18.85%,1
桃園市,蘆竹區,0442,347,542,889,23,912,1710,53.33%,20.29%,1
桃園市,蘆竹區,0443,274,405,679,36,715,1423,50.25%,19.26%,1
桃園市,蘆竹區,0444,370,418,788,27,815,1522,53.55%,24.31%,1
桃園市,蘆竹區,0445,335,517,852,29,881,1639,53.75%,20.44%,1
桃園市,蘆竹區,0446,410,583,993,42,1035,2055,50.36%,19.95%,1
桃園市,蘆竹區,0447,413,658,1071,27,1098,2178,50.41%,18.96%,1
桃園市,蘆竹區,0448,371,522,893,26,919,1709,53.77%,21.71%,1
桃園市,蘆竹區,0449,331,557,888,28,916,1667,54.95%,19.86%,1
桃園市,蘆竹區,0450,362,556,918,29,947,1745,54.27%,20.74%,1
桃園市,蘆竹區,0451,390,639,1029,47,1076,1967,54.7%,19.83%,1
桃園市,蘆竹區,0452,377,616,993,19,1012,1802,56.16%,20.92%,1
桃園市,蘆竹區,0453,495,794,1289,33,1322,2727,48.48%,18.15%,1
桃園市,蘆竹區,0454,388,471,859,27,886,1868,47.43%,20.77%,1
桃園市,蘆竹區,0455,343,410,753,29,782,1537,50.88%,22.32%,1
桃園市,蘆竹區,0456,339,483,822,27,849,1616,52.54%,20.98%,1
桃園市,蘆竹區,0457,371,474,845,28,873,1483,58.87%,25.02%,1
桃園市,蘆竹區,0458,303,492,795,54,849,1689,50.27%,17.94%,1
桃園市,蘆竹區,0459,271,274,545,24,569,1318,43.17%,20.56%,1
桃園市,蘆竹區,0460,340,359,699,72,771,1203,64.09%,28.26%,1
桃園市,蘆竹區,0461,370,449,819,23,842,1771,47.54%,20.89%,1
桃園市,蘆竹區,0462,389,415,804,76,880,1832,48.03%,21.23%,1
桃園市,蘆竹區,0463,408,419,827,63,890,1763,50.48%,23.14%,1
桃園市,蘆竹區,0464,344,321,665,17,682,1497,45.56%,22.98%,1
桃園市,蘆竹區,0465,480,426,906,86,992,1671,59.37%,28.73%,1
桃園市,蘆竹區,0466,242,242,484,54,538,929,57.91%,26.05%,1
桃園市,蘆竹區,0467,408,392,800,82,882,1559,56.57%,26.17%,1
桃園市,蘆竹區,0468,301,443,744,25,769,1497,51.37%,20.11%,1
桃園市,蘆竹區,0469,489,361,850,61,911,1441,63.22%,33.93%,1
桃園市,蘆竹區,0470,299,403,702,55,757,1465,51.67%,20.41%,1
桃園市,蘆竹區,0471,236,257,493,41,534,1029,51.9%,22.93%,1
桃園市,大園區,0472,286,381,667,45,712,1538,46.29%,18.6%,1
桃園市,大園區,0473,256,378,634,35,669,1616,41.4%,15.84%,1
桃園市,大園區,0474,359,418,777,37,814,1437,56.65%,24.98%,1
桃園市,大園區,0475,366,464,830,32,862,1554,55.47%,23.55%,1
桃園市,大園區,0476,319,303,622,28,650,1237,52.55%,25.79%,1
桃園市,大園區,0477,291,363,654,43,697,1347,51.74%,21.6%,1
桃園市,大園區,0478,306,322,628,24,652,1261,51.7%,24.27%,1
桃園市,大園區,0479,281,325,606,34,640,1256,50.96%,22.37%,1
桃園市,大園區,0480,305,318,623,29,652,1370,47.59%,22.26%,1
桃園市,大園區,0481,197,507,704,44,748,1610,46.46%,12.24%,1
桃園市,大園區,0482,308,377,685,34,719,1419,50.67%,21.71%,1
桃園市,大園區,0483,289,355,644,24,668,1588,42.07%,18.2%,1
桃園市,大園區,0484,375,405,780,34,814,1612,50.5%,23.26%,1
桃園市,大園區,0485,298,384,682,35,717,1440,49.79%,20.69%,1
桃園市,大園區,0486,277,339,616,39,655,1326,49.4%,20.89%,1
桃園市,大園區,0487,307,466,773,52,825,1455,56.7%,21.1%,1
桃園市,大園區,0488,405,402,807,36,843,1562,53.97%,25.93%,1
桃園市,大園區,0489,289,416,705,29,734,1284,57.17%,22.51%,1
桃園市,大園區,0490,281,394,675,17,692,1454,47.59%,19.33%,1
桃園市,大園區,0491,298,443,741,17,758,1490,50.87%,20%,1
桃園市,大園區,0492,377,390,767,28,795,1617,49.17%,23.31%,1
桃園市,大園區,0493,377,394,771,61,832,1594,52.2%,23.65%,1
桃園市,大園區,0494,382,409,791,46,837,1650,50.73%,23.15%,1
桃園市,大園區,0495,331,361,692,16,708,1467,48.26%,22.56%,1
桃園市,大園區,0496,313,420,733,31,764,1494,51.14%,20.95%,1
桃園市,大園區,0497,349,494,843,44,887,1538,57.67%,22.69%,1
桃園市,大園區,0498,318,370,688,27,715,1397,51.18%,22.76%,1
桃園市,大園區,0499,337,451,788,22,810,1637,49.48%,20.59%,1
桃園市,大園區,0500,320,347,667,34,701,1452,48.28%,22.04%,1
桃園市,大園區,0501,778,27,805,49,854,1414,60.4%,55.02%,1
桃園市,大園區,0502,390,428,818,48,866,1670,51.86%,23.35%,1
桃園市,大園區,0503,364,406,770,26,796,1701,46.8%,21.4%,1
桃園市,大園區,0504,354,399,753,29,782,1813,43.13%,19.53%,1
桃園市,大園區,0505,356,412,768,38,806,1687,47.78%,21.1%,1
桃園市,大園區,0506,339,499,838,17,855,1650,51.82%,20.55%,1
桃園市,大園區,0507,405,436,841,42,883,1556,56.75%,26.03%,1
桃園市,大園區,0508,358,444,802,22,824,1844,44.69%,19.41%,1
桃園市,大園區,0509,371,244,615,38,653,1336,48.88%,27.77%,1
桃園市,大園區,0510,362,394,756,38,794,1414,56.15%,25.6%,1
桃園市,大園區,0511,322,395,717,39,756,1238,61.07%,26.01%,1
桃園市,大園區,0512,319,389,708,39,747,1227,60.88%,26%,1
桃園市,大園區,0513,270,311,581,29,610,1199,50.88%,22.52%,1
桃園市,大園區,0514,281,336,617,24,641,1349,47.52%,20.83%,1
桃園市,大園區,0515,270,297,567,21,588,1120,52.5%,24.11%,1
桃園市,大園區,0516,273,285,558,24,582,1080,53.89%,25.28%,1
桃園市,大園區,0517,322,297,619,41,660,1341,49.22%,24.01%,1
桃園市,大園區,0518,321,362,683,31,714,1345,53.09%,23.87%,1
桃園市,大園區,0519,321,369,690,31,721,1565,46.07%,20.51%,1
桃園市,大園區,0520,270,372,642,17,659,1519,43.38%,17.77%,1
桃園市,大園區,0521,415,527,942,45,987,2130,46.34%,19.48%,1
桃園市,龜山區,0217,104,347,451,26,477,874,54.58%,11.9%,1
桃園市,龜山區,0218,314,667,981,57,1038,2014,51.54%,15.59%,1
桃園市,龜山區,0219,502,535,1037,19,1056,2145,49.23%,23.4%,1
桃園市,龜山區,0220,167,719,886,60,946,1744,54.24%,9.58%,1
桃園市,龜山區,0221,239,725,964,60,1024,1885,54.32%,12.68%,1
桃園市,龜山區,0222,293,381,674,48,722,1546,46.7%,18.95%,1
桃園市,龜山區,0223,375,412,787,45,832,1684,49.41%,22.27%,1
桃園市,龜山區,0224,313,369,682,12,694,1477,46.99%,21.19%,1
桃園市,龜山區,0225,250,565,815,46,861,1528,56.35%,16.36%,1
桃園市,龜山區,0226,142,138,280,13,293,1428,20.52%,9.94%,1
桃園市,龜山區,0227,392,404,796,42,838,1525,54.95%,25.7%,1
桃園市,龜山區,0228,271,312,583,30,613,1041,58.89%,26.03%,1
桃園市,龜山區,0229,353,341,694,28,722,1404,51.42%,25.14%,1
桃園市,龜山區,0230,380,399,779,39,818,1478,55.35%,25.71%,1
桃園市,龜山區,0231,447,636,1083,50,1133,2178,52.02%,20.52%,1
桃園市,龜山區,0232,439,418,857,49,906,1672,54.19%,26.26%,1
桃園市,龜山區,0233,278,376,654,29,683,1376,49.64%,20.2%,1
桃園市,龜山區,0234,322,390,712,40,752,1480,50.81%,21.76%,1
桃園市,龜山區,0235,317,350,667,26,693,1258,55.09%,25.2%,1
桃園市,龜山區,0236,310,422,732,31,763,1464,52.12%,21.17%,1
桃園市,龜山區,0237,410,483,893,52,945,1844,51.25%,22.23%,1
桃園市,龜山區,0238,248,344,592,21,613,1169,52.44%,21.21%,1
桃園市,龜山區,0239,310,443,753,33,786,1921,40.92%,16.14%,1
桃園市,龜山區,0240,373,434,807,23,830,1694,49%,22.02%,1
桃園市,龜山區,0241,442,515,957,32,989,1771,55.84%,24.96%,1
桃園市,龜山區,0242,319,430,749,40,789,1665,47.39%,19.16%,1
桃園市,龜山區,0243,346,354,700,40,740,1439,51.42%,24.04%,1
桃園市,龜山區,0244,331,438,769,40,809,1728,46.82%,19.16%,1
桃園市,龜山區,0245,402,560,962,37,999,1788,55.87%,22.48%,1
桃園市,龜山區,0246,289,394,683,33,716,1465,48.87%,19.73%,1
桃園市,龜山區,0247,281,282,563,39,602,1659,36.29%,16.94%,1
桃園市,龜山區,0248,349,359,708,35,743,1693,43.89%,20.61%,1
桃園市,龜山區,0249,333,361,694,21,715,1818,39.33%,18.32%,1
桃園市,龜山區,0250,506,366,872,36,908,1752,51.83%,28.88%,1
桃園市,龜山區,0251,479,449,928,13,941,1818,51.76%,26.35%,1
桃園市,龜山區,0252,366,362,728,22,750,1499,50.03%,24.42%,1
桃園市,龜山區,0253,457,486,943,35,978,1916,51.04%,23.85%,1
桃園市,龜山區,0254,389,487,876,37,913,1804,50.61%,21.56%,1
桃園市,龜山區,0255,467,521,988,38,1026,2127,48.24%,21.96%,1
桃園市,龜山區,0256,255,244,499,41,540,1005,53.73%,25.37%,1
桃園市,龜山區,0257,351,392,743,33,776,1449,53.55%,24.22%,1
桃園市,龜山區,0258,352,331,683,50,733,1498,48.93%,23.5%,1
桃園市,龜山區,0259,435,478,913,43,956,2149,44.49%,20.24%,1
桃園市,龜山區,0260,346,336,682,20,702,1771,39.64%,19.54%,1
桃園市,龜山區,0261,227,220,447,13,460,841,54.7%,26.99%,1
桃園市,龜山區,0262,500,502,1002,44,1046,2284,45.8%,21.89%,1
桃園市,龜山區,0263,276,324,600,54,654,1228,53.26%,22.48%,1
桃園市,龜山區,0264,392,496,888,35,923,1979,46.64%,19.81%,1
桃園市,龜山區,0265,302,342,644,25,669,1378,48.55%,21.92%,1
桃園市,龜山區,0266,272,237,509,24,533,1061,50.24%,25.64%,1
桃園市,龜山區,0267,440,449,889,34,923,1917,48.15%,22.95%,1
桃園市,龜山區,0268,374,507,881,22,903,1540,58.64%,24.29%,1
桃園市,龜山區,0269,322,434,756,30,786,1433,54.85%,22.47%,1
桃園市,龜山區,0270,338,385,723,26,749,1455,51.48%,23.23%,1
桃園市,龜山區,0271,543,639,1182,43,1225,2280,53.73%,23.82%,1
桃園市,龜山區,0272,413,418,831,34,865,1668,51.86%,24.76%,1
桃園市,龜山區,0273,425,482,907,34,941,1885,49.92%,22.55%,1
桃園市,龜山區,0274,469,409,878,29,907,1849,49.05%,25.37%,1
桃園市,龜山區,0275,465,469,934,15,949,1704,55.69%,27.29%,1
桃園市,龜山區,0276,293,307,600,28,628,1156,54.33%,25.35%,1
桃園市,龜山區,0277,403,450,853,54,907,2114,42.9%,19.06%,1
桃園市,龜山區,0278,408,425,833,31,864,1943,44.47%,21%,1
桃園市,龜山區,0279,307,466,773,21,794,1800,44.11%,17.06%,1
桃園市,龜山區,0280,418,530,948,38,986,2020,48.81%,20.69%,1
桃園市,龜山區,0281,326,375,701,29,730,1319,55.34%,24.72%,1
桃園市,龜山區,0282,546,599,1145,40,1185,2229,53.16%,24.5%,1
桃園市,龜山區,0283,413,540,953,18,971,1992,48.74%,20.73%,1
桃園市,龜山區,0284,488,529,1017,37,1054,2237,47.12%,21.81%,1
桃園市,龜山區,0285,457,556,1013,17,1030,2133,48.29%,21.43%,1
桃園市,龜山區,0286,491,572,1063,44,1107,2187,50.62%,22.45%,1
桃園市,龜山區,0287,418,506,924,33,957,1959,48.85%,21.34%,1
桃園市,龜山區,0288,390,469,859,27,886,1910,46.39%,20.42%,1
桃園市,龜山區,0289,478,441,919,65,984,1840,53.48%,25.98%,1
桃園市,龜山區,0290,506,589,1095,38,1133,2266,50%,22.33%,1
桃園市,龜山區,0291,411,637,1048,36,1084,2387,45.41%,17.22%,1
桃園市,龜山區,0292,333,437,770,21,791,1692,46.75%,19.68%,1
桃園市,龜山區,0293,218,241,459,15,474,904,52.43%,24.12%,1
桃園市,龜山區,0294,299,462,761,26,787,1469,53.57%,20.35%,1
桃園市,八德區,0295,387,412,799,39,838,1761,47.59%,21.98%,1
桃園市,八德區,0296,314,401,715,21,736,1804,40.8%,17.41%,1
桃園市,八德區,0297,214,272,486,28,514,1813,28.35%,11.8%,1
桃園市,八德區,0298,205,587,792,33,825,1784,46.24%,11.49%,1
桃園市,八德區,0299,332,569,901,35,936,2257,41.47%,14.71%,1
桃園市,八德區,0300,373,424,797,23,820,1857,44.16%,20.09%,1
桃園市,八德區,0301,414,522,936,42,978,2261,43.26%,18.31%,1
桃園市,八德區,0302,413,530,943,48,991,1903,52.08%,21.7%,1
桃園市,八德區,0303,357,566,923,57,980,1955,50.13%,18.26%,1
桃園市,八德區,0304,318,399,717,15,732,1665,43.96%,19.1%,1
桃園市,八德區,0305,390,352,742,38,780,1431,54.51%,27.25%,1
桃園市,八德區,0306,305,366,671,34,705,1263,55.82%,24.15%,1
桃園市,八德區,0307,482,442,924,45,969,1583,61.21%,30.45%,1
桃園市,八德區,0308,317,345,662,22,684,1246,54.9%,25.44%,1
桃園市,八德區,0309,276,413,689,36,725,1356,53.47%,20.35%,1
桃園市,八德區,0310,365,487,852,54,906,1630,55.58%,22.39%,1
桃園市,八德區,0311,270,506,776,29,805,1586,50.76%,17.02%,1
桃園市,八德區,0312,316,505,821,51,872,1649,52.88%,19.16%,1
桃園市,八德區,0313,303,536,839,61,900,1910,47.12%,15.86%,1
桃園市,八德區,0314,305,534,839,61,900,1612,55.83%,18.92%,1
桃園市,八德區,0315,261,556,817,37,854,1640,52.07%,15.91%,1
桃園市,八德區,0316,324,326,650,32,682,1303,52.34%,24.87%,1
桃園市,八德區,0317,338,440,778,33,811,1413,57.4%,23.92%,1
桃園市,八德區,0318,408,428,836,41,877,1711,51.26%,23.85%,1
桃園市,八德區,0319,363,446,809,35,844,1562,54.03%,23.24%,1
桃園市,八德區,0320,302,567,869,42,911,1735,52.51%,17.41%,1
桃園市,八德區,0321,343,477,820,31,851,1658,51.33%,20.69%,1
桃園市,八德區,0322,264,308,572,43,615,1022,60.18%,25.83%,1
桃園市,八德區,0323,307,440,747,40,787,1673,47.04%,18.35%,1
桃園市,八德區,0324,319,509,828,35,863,1741,49.57%,18.32%,1
桃園市,八德區,0325,437,585,1022,47,1069,2110,50.66%,20.71%,1
桃園市,八德區,0326,179,402,581,35,616,1145,53.8%,15.63%,1
桃園市,八德區,0327,177,399,576,35,611,1010,60.5%,17.52%,1
桃園市,八德區,0328,334,472,806,19,825,1848,44.64%,18.07%,1
桃園市,八德區,0329,306,392,698,36,734,1334,55.02%,22.94%,1
桃園市,八德區,0330,252,326,578,21,599,1349,44.4%,18.68%,1
桃園市,八德區,0331,344,392,736,31,767,1341,57.2%,25.65%,1
桃園市,八德區,0332,304,332,636,45,681,1178,57.81%,25.81%,1
桃園市,八德區,0333,312,407,719,32,751,1374,54.66%,22.71%,1
桃園市,八德區,0334,294,397,691,56,747,1462,51.09%,20.11%,1
桃園市,八德區,0335,387,462,849,38,887,1943,45.65%,19.92%,1
桃園市,八德區,0336,342,379,721,44,765,1928,39.68%,17.74%,1
桃園市,八德區,0337,300,377,677,24,701,1403,49.96%,21.38%,1
桃園市,八德區,0338,349,418,767,35,802,1672,47.97%,20.87%,1
桃園市,八德區,0339,399,490,889,36,925,1947,47.51%,20.49%,1
桃園市,八德區,0340,260,354,614,44,658,1200,54.83%,21.67%,1
桃園市,八德區,0341,546,415,961,41,1002,1895,52.88%,28.81%,1
桃園市,八德區,0342,411,468,879,43,922,1988,46.38%,20.67%,1
桃園市,八德區,0343,485,507,992,58,1050,2006,52.34%,24.18%,1
桃園市,八德區,0344,442,477,919,9,928,2061,45.03%,21.45%,1
桃園市,八德區,0345,439,491,930,47,977,2108,46.35%,20.83%,1
桃園市,八德區,0346,354,501,855,42,897,1862,48.17%,19.01%,1
桃園市,八德區,0347,371,449,820,26,846,1681,50.33%,22.07%,1
桃園市,八德區,0348,345,338,683,39,722,1317,54.82%,26.2%,1
桃園市,八德區,0349,533,591,1124,43,1167,2093,55.76%,25.47%,1
桃園市,八德區,0350,409,406,815,40,855,1499,57.04%,27.28%,1
桃園市,八德區,0351,357,511,868,40,908,1782,50.95%,20.03%,1
桃園市,八德區,0352,363,502,865,24,889,1763,50.43%,20.59%,1
桃園市,八德區,0353,263,361,624,43,667,1226,54.4%,21.45%,1
桃園市,八德區,0354,291,402,693,31,724,1311,55.23%,22.2%,1
桃園市,八德區,0355,285,337,622,46,668,1170,57.09%,24.36%,1
桃園市,八德區,0356,250,443,693,32,725,1313,55.22%,19.04%,1
桃園市,八德區,0357,250,374,624,26,650,1186,54.81%,21.08%,1
桃園市,八德區,0358,347,347,694,31,725,1481,48.95%,23.43%,1
桃園市,八德區,0359,412,570,982,46,1028,1998,51.45%,20.62%,1
桃園市,八德區,0360,217,284,501,19,520,916,56.77%,23.69%,1
桃園市,八德區,0361,308,573,881,46,927,1943,47.71%,15.85%,1
桃園市,八德區,0362,321,639,960,30,990,2076,47.69%,15.46%,1
桃園市,八德區,0363,299,391,690,41,731,1363,53.63%,21.94%,1
桃園市,八德區,0364,294,430,724,63,787,1491,52.78%,19.72%,1
桃園市,八德區,0365,347,370,717,46,763,1474,51.76%,23.54%,1
桃園市,八德區,0366,41,121,162,15,177,718,24.65%,5.71%,1
桃園市,八德區,0367,322,374,696,39,735,1386,53.03%,23.23%,1
桃園市,八德區,0368,202,497,699,70,769,1487,51.71%,13.58%,1
桃園市,八德區,0369,188,554,742,71,813,1552,52.38%,12.11%,1
桃園市,八德區,0370,172,387,559,58,617,1255,49.16%,13.71%,1
桃園市,八德區,0371,340,471,811,31,842,1505,55.95%,22.59%,1
桃園市,八德區,0372,309,354,663,42,705,1436,49.09%,21.52%,1
桃園市,八德區,0373,400,449,849,42,891,1618,55.07%,24.72%,1
桃園市,八德區,0374,337,478,815,43,858,1685,50.92%,20%,1
桃園市,八德區,0375,299,518,817,37,854,1835,46.54%,16.29%,1
桃園市,八德區,0376,380,521,901,48,949,1881,50.45%,20.2%,1
桃園市,八德區,0377,320,518,838,33,871,1766,49.32%,18.12%,1
桃園市,八德區,0378,333,553,886,46,932,1817,51.29%,18.33%,1
桃園市,八德區,0379,383,723,1106,26,1132,2198,51.5%,17.42%,1
桃園市,八德區,0380,353,519,872,35,907,1732,52.37%,20.38%,1
桃園市,八德區,0381,401,553,954,30,984,2089,47.1%,19.2%,1
桃園市,八德區,0382,295,378,673,31,704,1257,56.01%,23.47%,1
桃園市,八德區,0383,262,360,622,39,661,1267,52.17%,20.68%,1
桃園市,八德區,0384,305,460,765,15,780,1427,54.66%,21.37%,1
桃園市,八德區,0385,355,577,932,46,978,1685,58.04%,21.07%,1
桃園市,八德區,0386,420,490,910,36,946,1748,54.12%,24.03%,1
桃園市,八德區,0387,396,704,1100,40,1140,1650,69.09%,24%,1
桃園市,八德區,0388,359,403,762,45,807,1478,54.6%,24.29%,1
桃園市,八德區,0389,322,502,824,47,871,1607,54.2%,20.04%,1
桃園市,八德區,0390,446,529,975,48,1023,1841,55.57%,24.23%,1
桃園市,八德區,0391,455,569,1024,54,1078,2082,51.78%,21.85%,1
桃園市,八德區,0392,380,501,881,33,914,1959,46.66%,19.4%,1
桃園市,八德區,0393,491,605,1096,48,1144,2209,51.79%,22.23%,1
桃園市,八德區,0394,336,601,937,39,976,1864,52.36%,18.03%,1
桃園市,八德區,0395,360,571,931,45,976,2000,48.8%,18%,1
桃園市,龍潭區,1008,284,448,732,37,769,1482,51.89%,19.16%,1
桃園市,龍潭區,1009,336,406,742,34,776,1528,50.79%,21.99%,1
桃園市,龍潭區,1010,322,449,771,37,808,1503,53.76%,21.42%,1
桃園市,龍潭區,1011,264,487,751,43,794,1568,50.64%,16.84%,1
桃園市,龍潭區,1012,243,340,583,48,631,1216,51.89%,19.98%,1
桃園市,龍潭區,1013,244,647,891,58,949,2088,45.45%,11.69%,1
桃園市,龍潭區,1014,390,668,1058,58,1116,1987,56.17%,19.63%,1
桃園市,龍潭區,1015,393,512,905,28,933,1586,58.83%,24.78%,1
桃園市,龍潭區,1016,260,318,578,47,625,1221,51.19%,21.29%,1
桃園市,龍潭區,1017,223,385,608,43,651,1134,57.41%,19.66%,1
桃園市,龍潭區,1018,360,593,953,55,1008,2081,48.44%,17.3%,1
桃園市,龍潭區,1019,344,537,881,37,918,1925,47.69%,17.87%,1
桃園市,龍潭區,1020,297,801,1098,34,1132,2095,54.03%,14.18%,1
桃園市,龍潭區,1021,321,801,1122,39,1161,2040,56.91%,15.74%,1
桃園市,龍潭區,1022,362,482,844,40,884,1790,49.39%,20.22%,1
桃園市,龍潭區,1023,380,563,943,75,1018,1872,54.38%,20.3%,1
桃園市,龍潭區,1024,356,575,931,45,976,1726,56.55%,20.63%,1
桃園市,龍潭區,1025,365,553,918,61,979,1792,54.63%,20.37%,1
桃園市,龍潭區,1026,297,445,742,30,772,1398,55.22%,21.24%,1
桃園市,龍潭區,1027,272,386,658,27,685,1345,50.93%,20.22%,1
桃園市,龍潭區,1028,308,426,734,34,768,1409,54.51%,21.86%,1
桃園市,龍潭區,1029,286,367,653,24,677,1362,49.71%,21%,1
桃園市,龍潭區,1030,392,505,897,39,936,1650,56.73%,23.76%,1
桃園市,龍潭區,1031,343,458,801,29,830,1597,51.97%,21.48%,1
桃園市,龍潭區,1032,268,453,721,23,744,1410,52.77%,19.01%,1
桃園市,龍潭區,1033,279,395,674,38,712,1275,55.84%,21.88%,1
桃園市,龍潭區,1034,404,646,1050,68,1118,1909,58.56%,21.16%,1
桃園市,龍潭區,1035,342,728,1070,38,1108,2024,54.74%,16.9%,1
桃園市,龍潭區,1036,356,691,1047,35,1082,2002,54.05%,17.78%,1
桃園市,龍潭區,1037,339,643,982,35,1017,1786,56.94%,18.98%,1
桃園市,龍潭區,1038,320,635,955,42,997,1756,56.78%,18.22%,1
桃園市,龍潭區,1039,307,683,990,26,1016,1830,55.52%,16.78%,1
桃園市,龍潭區,1040,359,617,976,26,1002,1697,59.05%,21.15%,1
桃園市,龍潭區,1041,226,587,813,38,851,1519,56.02%,14.88%,1
桃園市,龍潭區,1042,308,557,865,42,907,1805,50.25%,17.06%,1
桃園市,龍潭區,1043,359,427,786,22,808,1792,45.09%,20.03%,1
桃園市,龍潭區,1044,265,546,811,50,861,1500,57.4%,17.67%,1
桃園市,龍潭區,1045,293,391,684,27,711,1427,49.82%,20.53%,1
桃園市,龍潭區,1046,193,423,616,42,658,1444,45.57%,13.37%,1
桃園市,龍潭區,1047,193,429,622,50,672,1321,50.87%,14.61%,1
桃園市,龍潭區,1048,264,440,704,31,735,1215,60.49%,21.73%,1
桃園市,龍潭區,1049,227,414,641,51,692,1297,53.35%,17.5%,1
桃園市,龍潭區,1050,225,459,684,16,700,1407,49.75%,15.99%,1
桃園市,龍潭區,1051,299,438,737,35,772,1564,49.36%,19.12%,1
桃園市,龍潭區,1052,243,405,648,52,700,1317,53.15%,18.45%,1
桃園市,龍潭區,1053,171,309,480,28,508,1023,49.66%,16.72%,1
桃園市,龍潭區,1054,292,610,902,43,945,1721,54.91%,16.97%,1
桃園市,龍潭區,1055,249,675,924,51,975,1764,55.27%,14.12%,1
桃園市,龍潭區,1056,307,470,777,54,831,1499,55.44%,20.48%,1
桃園市,龍潭區,1057,370,622,992,38,1030,2151,47.88%,17.2%,1
桃園市,龍潭區,1058,252,587,839,28,867,1524,56.89%,16.54%,1
桃園市,龍潭區,1059,261,591,852,25,877,1456,60.23%,17.93%,1
桃園市,龍潭區,1060,268,803,1071,42,1113,1847,60.26%,14.51%,1
桃園市,龍潭區,1061,298,826,1124,28,1152,1899,60.66%,15.69%,1
桃園市,龍潭區,1062,308,609,917,28,945,1725,54.78%,17.86%,1
桃園市,龍潭區,1063,314,646,960,55,1015,1665,60.96%,18.86%,1
桃園市,龍潭區,1064,301,515,816,23,839,1649,50.88%,18.25%,1
桃園市,龍潭區,1065,298,446,744,20,764,1539,49.64%,19.36%,1
桃園市,龍潭區,1066,351,498,849,35,884,1541,57.37%,22.78%,1
桃園市,龍潭區,1067,319,396,715,38,753,1375,54.76%,23.2%,1
桃園市,龍潭區,1068,291,466,757,27,784,1453,53.96%,20.03%,1
桃園市,龍潭區,1069,242,332,574,38,612,1074,56.98%,22.53%,1
桃園市,龍潭區,1070,236,511,747,20,767,1299,59.05%,18.17%,1
桃園市,龍潭區,1071,182,148,330,15,345,678,50.88%,26.84%,1
桃園市,平鎮區,0801,305,395,700,32,732,1487,49.23%,20.51%,1
桃園市,平鎮區,0802,271,456,727,43,770,1453,52.99%,18.65%,1
桃園市,平鎮區,0803,295,490,785,28,813,1491,54.53%,19.79%,1
桃園市,平鎮區,0804,293,372,665,44,709,1346,52.67%,21.77%,1
桃園市,平鎮區,0805,337,483,820,35,855,1660,51.51%,20.3%,1
桃園市,平鎮區,0806,312,566,878,45,923,1921,48.05%,16.24%,1
桃園市,平鎮區,0807,354,673,1027,42,1069,1974,54.15%,17.93%,1
桃園市,平鎮區,0808,349,552,901,34,935,1867,50.08%,18.69%,1
桃園市,平鎮區,0809,305,588,893,34,927,1786,51.9%,17.08%,1
桃園市,平鎮區,0810,276,383,659,30,689,1634,42.17%,16.89%,1
桃園市,平鎮區,0811,215,367,582,19,601,1080,55.65%,19.91%,1
桃園市,平鎮區,0812,323,448,771,25,796,1514,52.58%,21.33%,1
桃園市,平鎮區,0813,324,494,818,52,870,1918,45.36%,16.89%,1
桃園市,平鎮區,0814,268,342,610,50,660,1182,55.84%,22.67%,1
桃園市,平鎮區,0815,303,471,774,31,805,1667,48.29%,18.18%,1
桃園市,平鎮區,0816,281,453,734,31,765,1640,46.65%,17.13%,1
桃園市,平鎮區,0817,342,487,829,23,852,1603,53.15%,21.33%,1
桃園市,平鎮區,0818,315,536,851,23,874,1556,56.17%,20.24%,1
桃園市,平鎮區,0819,303,530,833,33,866,1697,51.03%,17.86%,1
桃園市,平鎮區,0820,227,329,556,14,570,1130,50.44%,20.09%,1
桃園市,平鎮區,0821,218,392,610,36,646,1196,54.01%,18.23%,1
桃園市,平鎮區,0822,337,537,874,29,903,1685,53.59%,20%,1
桃園市,平鎮區,0823,418,400,818,33,851,1532,55.55%,27.28%,1
桃園市,平鎮區,0824,337,454,791,38,829,1564,53.01%,21.55%,1
桃園市,平鎮區,0825,259,493,752,31,783,1824,42.93%,14.2%,1
桃園市,平鎮區,0826,308,621,929,22,951,1912,49.74%,16.11%,1
桃園市,平鎮區,0827,190,339,529,37,566,1048,54.01%,18.13%,1
桃園市,平鎮區,0828,220,450,670,40,710,1259,56.39%,17.47%,1
桃園市,平鎮區,0829,189,358,547,24,571,1061,53.82%,17.81%,1
桃園市,平鎮區,0830,223,393,616,27,643,1072,59.98%,20.8%,1
桃園市,平鎮區,0831,346,537,883,41,924,1788,51.68%,19.35%,1
桃園市,平鎮區,0832,331,431,762,33,795,1510,52.65%,21.92%,1
桃園市,平鎮區,0833,266,426,692,48,740,1403,52.74%,18.96%,1
桃園市,平鎮區,0834,280,444,724,47,771,1407,54.8%,19.9%,1
桃園市,平鎮區,0835,379,582,961,56,1017,1901,53.5%,19.94%,1
桃園市,平鎮區,0836,317,581,898,29,927,1994,46.49%,15.9%,1
桃園市,平鎮區,0837,295,587,882,22,904,1730,52.25%,17.05%,1
桃園市,平鎮區,0838,368,596,964,48,1012,1905,53.12%,19.32%,1
桃園市,平鎮區,0839,346,602,948,23,971,1723,56.36%,20.08%,1
桃園市,平鎮區,0840,296,391,687,44,731,1307,55.93%,22.65%,1
桃園市,平鎮區,0841,303,425,728,27,755,1337,56.47%,22.66%,1
桃園市,平鎮區,0842,234,381,615,28,643,980,65.61%,23.88%,1
桃園市,平鎮區,0843,356,549,905,31,936,1818,51.49%,19.58%,1
桃園市,平鎮區,0844,329,447,776,31,807,1463,55.16%,22.49%,1
桃園市,平鎮區,0845,291,398,689,27,716,1213,59.03%,23.99%,1
桃園市,平鎮區,0846,261,349,610,29,639,1085,58.89%,24.06%,1
桃園市,平鎮區,0847,245,469,714,22,736,1458,50.48%,16.8%,1
桃園市,平鎮區,0848,273,467,740,42,782,1408,55.54%,19.39%,1
桃園市,平鎮區,0849,392,297,689,31,720,1396,51.58%,28.08%,1
桃園市,平鎮區,0850,610,35,645,24,669,1044,64.08%,58.43%,1
桃園市,平鎮區,0851,219,399,618,15,633,1124,56.32%,19.48%,1
桃園市,平鎮區,0852,338,478,816,17,833,1517,54.91%,22.28%,1
桃園市,平鎮區,0853,289,523,812,21,833,1571,53.02%,18.4%,1
桃園市,平鎮區,0854,391,589,980,22,1002,1752,57.19%,22.32%,1
桃園市,平鎮區,0855,336,521,857,18,875,1434,61.02%,23.43%,1
桃園市,平鎮區,0856,375,587,962,23,985,1710,57.6%,21.93%,1
桃園市,平鎮區,0857,261,592,853,23,876,1555,56.33%,16.78%,1
桃園市,平鎮區,0858,358,609,967,27,994,2051,48.46%,17.45%,1
桃園市,平鎮區,0859,289,476,765,22,787,1477,53.28%,19.57%,1
桃園市,平鎮區,0860,333,471,804,23,827,1501,55.1%,22.19%,1
桃園市,平鎮區,0861,298,454,752,36,788,1405,56.09%,21.21%,1
桃園市,平鎮區,0862,314,527,841,43,884,1656,53.38%,18.96%,1
桃園市,平鎮區,0863,337,580,917,22,939,1921,48.88%,17.54%,1
桃園市,平鎮區,0864,310,502,812,28,840,1717,48.92%,18.05%,1
桃園市,平鎮區,0865,290,406,696,25,721,1319,54.66%,21.99%,1
桃園市,平鎮區,0866,342,513,855,42,897,1745,51.4%,19.6%,1
桃園市,平鎮區,0867,387,527,914,38,952,1721,55.32%,22.49%,1
桃園市,平鎮區,0868,247,398,645,29,674,1206,55.89%,20.48%,1
桃園市,平鎮區,0869,328,434,762,25,787,1202,65.47%,27.29%,1
桃園市,平鎮區,0870,261,417,678,28,706,1208,58.44%,21.61%,1
桃園市,平鎮區,0871,446,302,748,24,772,1267,60.93%,35.2%,1
桃園市,平鎮區,0872,208,377,585,24,609,1094,55.67%,19.01%,1
桃園市,平鎮區,0873,312,487,799,34,833,1394,59.76%,22.38%,1
桃園市,平鎮區,0874,279,443,722,16,738,1215,60.74%,22.96%,1
桃園市,平鎮區,0875,246,311,557,31,588,1010,58.22%,24.36%,1
桃園市,平鎮區,0876,300,413,713,20,733,1261,58.13%,23.79%,1
桃園市,平鎮區,0877,280,474,754,25,779,1314,59.28%,21.31%,1
桃園市,平鎮區,0878,178,216,394,31,425,722,58.86%,24.65%,1
桃園市,平鎮區,0879,213,219,432,23,455,839,54.23%,25.39%,1
桃園市,平鎮區,0880,322,427,749,31,780,1399,55.75%,23.02%,1
桃園市,平鎮區,0881,380,571,951,45,996,1968,50.61%,19.31%,1
桃園市,平鎮區,0882,303,554,857,38,895,1672,53.53%,18.12%,1
桃園市,平鎮區,0883,260,368,628,26,654,2213,29.55%,11.75%,1
桃園市,平鎮區,0884,222,349,571,20,591,949,62.28%,23.39%,1
桃園市,平鎮區,0885,326,597,923,46,969,1621,59.78%,20.11%,1
桃園市,平鎮區,0886,288,523,811,30,841,1643,51.19%,17.53%,1
桃園市,平鎮區,0887,363,622,985,27,1012,1844,54.88%,19.69%,1
桃園市,平鎮區,0888,313,600,913,34,947,1752,54.05%,17.87%,1
桃園市,平鎮區,0889,312,457,769,31,800,1577,50.73%,19.78%,1
桃園市,平鎮區,0890,233,597,830,22,852,1517,56.16%,15.36%,1
桃園市,平鎮區,0891,267,312,579,35,614,1039,59.1%,25.7%,1
桃園市,平鎮區,0892,303,441,744,35,779,1318,59.1%,22.99%,1
桃園市,平鎮區,0893,338,501,839,35,874,1636,53.42%,20.66%,1
桃園市,平鎮區,0894,260,462,722,27,749,1316,56.91%,19.76%,1
桃園市,平鎮區,0895,308,516,824,20,844,1474,57.26%,20.9%,1
桃園市,平鎮區,0896,269,419,688,32,720,1480,48.65%,18.18%,1
桃園市,平鎮區,0897,298,398,696,26,722,1330,54.29%,22.41%,1
桃園市,平鎮區,0898,246,407,653,30,683,1228,55.62%,20.03%,1
桃園市,平鎮區,0899,320,468,788,29,817,1377,59.33%,23.24%,1
桃園市,平鎮區,0900,251,446,697,29,726,1198,60.6%,20.95%,1
桃園市,平鎮區,0901,303,430,733,18,751,1231,61.01%,24.61%,1
桃園市,平鎮區,0902,315,356,671,48,719,1243,57.84%,25.34%,1
桃園市,平鎮區,0903,274,524,798,42,840,1590,52.83%,17.23%,1
桃園市,平鎮區,0904,270,435,705,34,739,1366,54.1%,19.77%,1
桃園市,平鎮區,0905,245,440,685,30,715,1332,53.68%,18.39%,1
桃園市,平鎮區,0906,208,366,574,19,593,1201,49.38%,17.32%,1
桃園市,平鎮區,0907,265,490,755,24,779,1668,46.7%,15.89%,1
桃園市,平鎮區,0908,225,427,652,54,706,1351,52.26%,16.65%,1
桃園市,平鎮區,0909,249,430,679,24,703,1460,48.15%,17.05%,1
桃園市,平鎮區,0910,357,549,906,24,930,1841,50.52%,19.39%,1
桃園市,平鎮區,0911,268,425,693,20,713,1475,48.34%,18.17%,1
桃園市,平鎮區,0912,211,334,545,15,560,1011,55.39%,20.87%,1
桃園市,平鎮區,0913,232,267,499,24,523,1052,49.71%,22.05%,1
桃園市,平鎮區,0914,317,351,668,43,711,1154,61.61%,27.47%,1
桃園市,平鎮區,0915,345,483,828,25,853,1645,51.85%,20.97%,1
桃園市,平鎮區,0916,271,468,739,37,776,1539,50.42%,17.61%,1
桃園市,平鎮區,0917,254,436,690,61,751,1385,54.22%,18.34%,1
桃園市,平鎮區,0918,254,455,709,34,743,1395,53.26%,18.21%,1
桃園市,平鎮區,0919,273,571,844,25,869,1711,50.79%,15.96%,1
桃園市,平鎮區,0920,261,537,798,37,835,1631,51.2%,16%,1
桃園市,平鎮區,0921,168,427,595,20,615,1110,55.41%,15.14%,1
桃園市,平鎮區,0922,323,700,1023,39,1062,1931,55%,16.73%,1
桃園市,平鎮區,0923,208,374,582,44,626,1127,55.55%,18.46%,1
桃園市,平鎮區,0924,216,518,734,45,779,1414,55.09%,15.28%,1
桃園市,平鎮區,0925,263,536,799,55,854,1609,53.08%,16.35%,1
桃園市,新屋區,1072,310,439,749,24,773,1306,59.19%,23.74%,1
桃園市,新屋區,1073,369,468,837,25,862,1556,55.4%,23.71%,1
桃園市,新屋區,1074,424,655,1079,46,1125,1849,60.84%,22.93%,1
桃園市,新屋區,1075,466,696,1162,62,1224,2096,58.4%,22.23%,1
桃園市,新屋區,1076,373,387,760,40,800,1517,52.74%,24.59%,1
桃園市,新屋區,1077,470,658,1128,59,1187,2095,56.66%,22.43%,1
桃園市,新屋區,1078,352,494,846,37,883,1856,47.58%,18.97%,1
桃園市,新屋區,1079,457,591,1048,59,1107,1986,55.74%,23.01%,1
桃園市,新屋區,1080,283,412,695,20,715,1425,50.18%,19.86%,1
桃園市,新屋區,1081,324,358,682,24,706,1385,50.97%,23.39%,1
桃園市,新屋區,1082,430,301,731,51,782,1271,61.53%,33.83%,1
桃園市,新屋區,1083,259,389,648,36,684,1271,53.82%,20.38%,1
桃園市,新屋區,1084,287,374,661,43,704,1234,57.05%,23.26%,1
桃園市,新屋區,1085,288,290,578,28,606,1085,55.85%,26.54%,1
桃園市,新屋區,1086,436,668,1104,38,1142,1992,57.33%,21.89%,1
桃園市,新屋區,1087,498,639,1137,56,1193,2032,58.71%,24.51%,1
桃園市,新屋區,1088,298,372,670,37,707,1291,54.76%,23.08%,1
桃園市,新屋區,1089,337,356,693,40,733,1401,52.32%,24.05%,1
桃園市,新屋區,1090,232,380,612,35,647,1106,58.5%,20.98%,1
桃園市,新屋區,1091,244,232,476,15,491,908,54.07%,26.87%,1
桃園市,新屋區,1092,169,203,372,36,408,663,61.54%,25.49%,1
桃園市,新屋區,1093,281,271,552,41,593,1088,54.5%,25.83%,1
桃園市,新屋區,1094,285,341,626,43,669,1050,63.71%,27.14%,1
桃園市,新屋區,1095,234,285,519,16,535,896,59.71%,26.12%,1
桃園市,新屋區,1096,360,420,780,46,826,1369,60.34%,26.3%,1
桃園市,新屋區,1097,211,252,463,38,501,995,50.35%,21.21%,1
桃園市,新屋區,1098,207,218,425,22,447,741,60.32%,27.94%,1
桃園市,新屋區,1099,225,321,546,36,582,943,61.72%,23.86%,1
桃園市,新屋區,1100,392,439,831,66,897,1714,52.33%,22.87%,1
桃園市,新屋區,1101,310,416,726,21,747,1340,55.75%,23.13%,1
桃園市,觀音區,1102,298,354,652,28,680,1371,49.6%,21.74%,1
桃園市,觀音區,1103,270,299,569,19,588,1362,43.17%,19.82%,1
桃園市,觀音區,1104,211,273,484,51,535,997,53.66%,21.16%,1
桃園市,觀音區,1105,307,352,659,27,686,1407,48.76%,21.82%,1
桃園市,觀音區,1106,434,441,875,27,902,1692,53.31%,25.65%,1
桃園市,觀音區,1107,274,383,657,19,676,1279,52.85%,21.42%,1
桃園市,觀音區,1108,162,238,400,15,415,791,52.47%,20.48%,1
桃園市,觀音區,1109,225,262,487,21,508,892,56.95%,25.22%,1
桃園市,觀音區,1110,234,283,517,17,534,886,60.27%,26.41%,1
桃園市,觀音區,1111,179,188,367,31,398,712,55.9%,25.14%,1
桃園市,觀音區,1112,361,391,752,65,817,1609,50.78%,22.44%,1
桃園市,觀音區,1113,304,361,665,40,705,1274,55.34%,23.86%,1
桃園市,觀音區,1114,233,344,577,41,618,1351,45.74%,17.25%,1
桃園市,觀音區,1115,301,396,697,36,733,1262,58.08%,23.85%,1
桃園市,觀音區,1116,346,313,659,49,708,1242,57%,27.86%,1
桃園市,觀音區,1117,344,388,732,45,777,1461,53.18%,23.55%,1
桃園市,觀音區,1118,363,458,821,35,856,1613,53.07%,22.5%,1
桃園市,觀音區,1119,379,392,771,26,797,1479,53.89%,25.63%,1
桃園市,觀音區,1120,382,338,720,34,754,1552,48.58%,24.61%,1
桃園市,觀音區,1121,374,410,784,29,813,1517,53.59%,24.65%,1
桃園市,觀音區,1122,365,426,791,46,837,1691,49.5%,21.58%,1
桃園市,觀音區,1123,257,362,619,27,646,1157,55.83%,22.21%,1
桃園市,觀音區,1124,299,408,707,39,746,1455,51.27%,20.55%,1
桃園市,觀音區,1125,231,369,600,11,611,1150,53.13%,20.09%,1
桃園市,觀音區,1126,262,331,593,41,634,1112,57.01%,23.56%,1
桃園市,觀音區,1127,253,361,614,18,632,1251,50.52%,20.22%,1
桃園市,觀音區,1128,341,384,725,58,783,1446,54.15%,23.58%,1
桃園市,觀音區,1129,372,373,745,49,794,1493,53.18%,24.92%,1
桃園市,觀音區,1130,323,348,671,36,707,1339,52.8%,24.12%,1
桃園市,觀音區,1131,285,350,635,31,666,1137,58.58%,25.07%,1
桃園市,觀音區,1132,211,290,501,33,534,1043,51.2%,20.23%,1
桃園市,觀音區,1133,231,223,454,14,468,993,47.13%,23.26%,1
桃園市,觀音區,1134,275,208,483,17,500,975,51.28%,28.21%,1
桃園市,觀音區,1135,478,424,902,40,942,2029,46.43%,23.56%,1
桃園市,觀音區,1136,410,525,935,41,976,1765,55.3%,23.23%,1
桃園市,觀音區,1137,393,513,906,30,936,1809,51.74%,21.72%,1
桃園市,觀音區,1138,381,491,872,37,909,1869,48.64%,20.39%,1
桃園市,觀音區,1139,384,396,780,34,814,1870,43.53%,20.53%,1
桃園市,觀音區,1140,346,313,659,40,699,1932,36.18%,17.91%,1
桃園市,觀音區,1141,210,205,415,12,427,899,47.5%,23.36%,1
桃園市,觀音區,1142,176,239,415,17,432,985,43.86%,17.87%,1
桃園市,復興區,0581,391,655,1046,70,1116,1991,56.05%,19.64%,1
桃園市,復興區,0582,253,497,750,46,796,1392,57.18%,18.18%,1
桃園市,復興區,0583,103,182,285,21,306,564,54.26%,18.26%,1
桃園市,復興區,0584,106,247,353,19,372,716,51.96%,14.8%,1
桃園市,復興區,0585,275,311,586,56,642,1016,63.19%,27.07%,1
桃園市,復興區,0586,119,161,280,8,288,669,43.05%,17.79%,1
桃園市,復興區,0587,117,235,352,14,366,760,48.16%,15.39%,1
桃園市,復興區,0588,116,262,378,24,402,751,53.53%,15.45%,1
桃園市,復興區,0589,70,164,234,9,243,683,35.58%,10.25%,1
桃園市,復興區,0590,256,383,639,31,670,1224,54.74%,20.92%,1
臺中市,中區,1070,497,483,980,65,1045,1652,63.26%,30.08%,1
臺中市,中區,1071,422,412,834,24,858,1531,56.04%,27.56%,1
臺中市,中區,1072,388,409,797,33,830,1431,58%,27.11%,1
臺中市,中區,1073,286,309,595,24,619,1060,58.4%,26.98%,1
臺中市,中區,1074,249,280,529,27,556,982,56.62%,25.36%,1
臺中市,中區,1075,339,319,658,44,702,1191,58.94%,28.46%,1
臺中市,中區,1076,235,251,486,10,496,855,58.01%,27.49%,1
臺中市,中區,1077,255,267,522,25,547,1135,48.19%,22.47%,1
臺中市,中區,1078,186,220,406,19,425,705,60.28%,26.38%,1
臺中市,中區,1079,284,345,629,14,643,1009,63.73%,28.15%,1
臺中市,中區,1080,338,335,673,58,731,1304,56.06%,25.92%,1
臺中市,中區,1081,445,482,927,22,949,1841,51.55%,24.17%,1
臺中市,東區,1148,259,193,452,23,475,1138,41.74%,22.76%,1
臺中市,東區,1149,257,302,559,19,578,984,58.74%,26.12%,1
臺中市,東區,1150,241,265,506,26,532,877,60.66%,27.48%,1
臺中市,東區,1151,336,324,660,32,692,1070,64.67%,31.4%,1
臺中市,東區,1152,333,334,667,30,697,1106,63.02%,30.11%,1
臺中市,東區,1153,304,260,564,25,589,953,61.8%,31.9%,1
臺中市,東區,1154,348,377,725,19,744,1195,62.26%,29.12%,1
臺中市,東區,1155,327,367,694,30,724,1251,57.87%,26.14%,1
臺中市,東區,1156,380,308,688,37,725,1190,60.92%,31.93%,1
臺中市,東區,1157,380,390,770,27,797,1394,57.17%,27.26%,1
臺中市,東區,1158,441,435,876,40,916,1443,63.48%,30.56%,1
臺中市,東區,1159,230,204,434,27,461,762,60.5%,30.18%,1
臺中市,東區,1160,327,372,699,44,743,1140,65.18%,28.68%,1
臺中市,東區,1161,413,327,740,34,774,1211,63.91%,34.1%,1
臺中市,東區,1162,179,283,462,21,483,755,63.97%,23.71%,1
臺中市,東區,1163,377,425,802,45,847,1491,56.81%,25.29%,1
臺中市,東區,1164,281,272,553,17,570,1000,57%,28.1%,1
臺中市,東區,1165,328,317,645,39,684,1114,61.4%,29.44%,1
臺中市,東區,1166,403,221,624,27,651,1101,59.13%,36.6%,1
臺中市,東區,1167,381,327,708,46,754,1169,64.5%,32.59%,1
臺中市,東區,1168,370,400,770,52,822,1283,64.07%,28.84%,1
臺中市,東區,1169,331,379,710,35,745,1168,63.78%,28.34%,1
臺中市,東區,1170,384,373,757,37,794,1386,57.29%,27.71%,1
臺中市,東區,1171,423,459,882,36,918,1557,58.96%,27.17%,1
臺中市,東區,1172,397,383,780,40,820,1380,59.42%,28.77%,1
臺中市,東區,1173,419,541,960,36,996,1674,59.5%,25.03%,1
臺中市,東區,1174,443,515,958,43,1001,1604,62.41%,27.62%,1
臺中市,東區,1175,476,572,1048,51,1099,1815,60.55%,26.23%,1
臺中市,東區,1176,422,497,919,44,963,1700,56.65%,24.82%,1
臺中市,東區,1177,385,492,877,38,915,1592,57.47%,24.18%,1
臺中市,東區,1178,451,538,989,42,1031,1850,55.73%,24.38%,1
臺中市,東區,1179,291,454,745,20,765,1252,61.1%,23.24%,1
臺中市,東區,1180,370,393,763,37,800,1250,64%,29.6%,1
臺中市,東區,1181,291,431,722,33,755,1241,60.84%,23.45%,1
臺中市,東區,1182,343,346,689,30,719,1318,54.55%,26.02%,1
臺中市,東區,1183,275,412,687,55,742,1288,57.61%,21.35%,1
臺中市,東區,1184,372,492,864,49,913,1442,63.31%,25.8%,1
臺中市,東區,1185,282,399,681,38,719,1202,59.82%,23.46%,1
臺中市,東區,1186,247,553,800,56,856,1452,58.95%,17.01%,1
臺中市,東區,1187,306,490,796,38,834,1480,56.35%,20.68%,1
臺中市,東區,1188,254,693,947,36,983,1736,56.62%,14.63%,1
臺中市,東區,1189,209,271,480,20,500,867,57.67%,24.11%,1
臺中市,東區,1190,298,563,861,46,907,1693,53.57%,17.6%,1
臺中市,東區,1191,425,468,893,56,949,1538,61.7%,27.63%,1
臺中市,東區,1192,447,489,936,59,995,1593,62.46%,28.06%,1
臺中市,東區,1193,333,457,790,26,816,1481,55.1%,22.48%,1
臺中市,東區,1194,367,478,845,35,880,1414,62.23%,25.95%,1
臺中市,東區,1195,409,340,749,28,777,1297,59.91%,31.53%,1
臺中市,東區,1196,396,408,804,36,840,1394,60.26%,28.41%,1
臺中市,南區,1197,287,258,545,32,577,937,61.58%,30.63%,1
臺中市,南區,1198,296,342,638,21,659,1001,65.83%,29.57%,1
臺中市,南區,1199,382,408,790,36,826,1249,66.13%,30.58%,1
臺中市,南區,1200,381,415,796,30,826,1202,68.72%,31.7%,1
臺中市,南區,1201,340,361,701,21,722,1130,63.89%,30.09%,1
臺中市,南區,1202,375,369,744,43,787,1239,63.52%,30.27%,1
臺中市,南區,1203,329,376,705,34,739,1238,59.69%,26.58%,1
臺中市,南區,1204,368,390,758,44,802,1272,63.05%,28.93%,1
臺中市,南區,1205,365,367,732,49,781,1273,61.35%,28.67%,1
臺中市,南區,1206,394,371,765,45,810,1317,61.5%,29.92%,1
臺中市,南區,1207,359,413,772,27,799,1160,68.88%,30.95%,1
臺中市,南區,1208,354,407,761,37,798,1205,66.22%,29.38%,1
臺中市,南區,1209,327,338,665,23,688,1111,61.93%,29.43%,1
臺中市,南區,1210,405,490,895,38,933,1407,66.31%,28.78%,1
臺中市,南區,1211,369,448,817,40,857,1419,60.39%,26%,1
臺中市,南區,1212,332,356,688,50,738,1157,63.79%,28.69%,1
臺中市,南區,1213,360,442,802,44,846,1415,59.79%,25.44%,1
臺中市,南區,1214,374,445,819,35,854,1289,66.25%,29.01%,1
臺中市,南區,1215,375,463,838,42,880,1454,60.52%,25.79%,1
臺中市,南區,1216,322,497,819,58,877,1491,58.82%,21.6%,1
臺中市,南區,1217,347,468,815,25,840,1394,60.26%,24.89%,1
臺中市,南區,1218,393,428,821,51,872,1430,60.98%,27.48%,1
臺中市,南區,1219,381,430,811,46,857,1342,63.86%,28.39%,1
臺中市,南區,1220,414,411,825,64,889,1304,68.17%,31.75%,1
臺中市,南區,1221,294,439,733,32,765,1190,64.29%,24.71%,1
臺中市,南區,1222,330,395,725,37,762,1273,59.86%,25.92%,1
臺中市,南區,1223,516,354,870,38,908,1387,65.47%,37.2%,1
臺中市,南區,1224,372,424,796,33,829,1356,61.14%,27.43%,1
臺中市,南區,1225,316,476,792,33,825,1304,63.27%,24.23%,1
臺中市,南區,1226,350,450,800,24,824,1256,65.61%,27.87%,1
臺中市,南區,1227,387,469,856,19,875,1364,64.15%,28.37%,1
臺中市,南區,1228,384,425,809,47,856,1361,62.89%,28.21%,1
臺中市,南區,1229,334,518,852,20,872,1407,61.98%,23.74%,1
臺中市,南區,1230,361,406,767,36,803,1308,61.39%,27.6%,1
臺中市,南區,1231,463,255,718,29,747,1250,59.76%,37.04%,1
臺中市,南區,1232,337,379,716,29,745,1284,58.02%,26.25%,1
臺中市,南區,1233,322,402,724,44,768,1175,65.36%,27.4%,1
臺中市,南區,1234,353,389,742,30,772,1158,66.67%,30.48%,1
臺中市,南區,1235,307,389,696,30,726,1168,62.16%,26.28%,1
臺中市,南區,1236,399,590,989,51,1040,1626,63.96%,24.54%,1
臺中市,南區,1237,368,500,868,28,896,2115,42.36%,17.4%,1
臺中市,南區,1238,391,585,976,36,1012,1805,56.07%,21.66%,1
臺中市,南區,1239,392,548,940,26,966,1695,56.99%,23.13%,1
臺中市,南區,1240,408,610,1018,34,1052,1643,64.03%,24.83%,1
臺中市,南區,1241,370,489,859,33,892,1423,62.68%,26%,1
臺中市,南區,1242,342,555,897,32,929,1542,60.25%,22.18%,1
臺中市,南區,1243,376,528,904,30,934,1533,60.93%,24.53%,1
臺中市,南區,1244,418,534,952,41,993,1531,64.86%,27.3%,1
臺中市,南區,1245,371,391,762,30,792,1392,56.9%,26.65%,1
臺中市,南區,1246,368,510,878,42,920,1592,57.79%,23.12%,1
臺中市,南區,1247,405,455,860,40,900,1431,62.89%,28.3%,1
臺中市,南區,1248,395,554,949,46,995,1799,55.31%,21.96%,1
臺中市,南區,1249,483,550,1033,54,1087,1708,63.64%,28.28%,1
臺中市,南區,1250,403,544,947,50,997,1700,58.65%,23.71%,1
臺中市,南區,1251,428,628,1056,36,1092,1751,62.36%,24.44%,1
臺中市,南區,1252,495,675,1170,49,1219,2109,57.8%,23.47%,1
臺中市,南區,1253,393,565,958,54,1012,1697,59.63%,23.16%,1
臺中市,南區,1254,343,494,837,31,868,1456,59.62%,23.56%,1
臺中市,南區,1255,463,639,1102,45,1147,1726,66.45%,26.83%,1
臺中市,南區,1256,435,619,1054,42,1096,1723,63.61%,25.25%,1
臺中市,南區,1257,374,552,926,49,975,1569,62.14%,23.84%,1
臺中市,南區,1258,363,423,786,17,803,1274,63.03%,28.49%,1
臺中市,南區,1259,353,549,902,22,924,1390,66.47%,25.4%,1
臺中市,南區,1260,316,516,832,22,854,1295,65.95%,24.4%,1
臺中市,南區,1261,363,407,770,38,808,1312,61.59%,27.67%,1
臺中市,南區,1262,467,411,878,28,906,1417,63.94%,32.96%,1
臺中市,南區,1263,341,494,835,21,856,1230,69.59%,27.72%,1
臺中市,南區,1264,318,427,745,50,795,1308,60.78%,24.31%,1
臺中市,南區,1265,386,446,832,50,882,1467,60.12%,26.31%,1
臺中市,南區,1266,320,501,821,40,861,1399,61.54%,22.87%,1
臺中市,南區,1267,324,371,695,41,736,1207,60.98%,26.84%,1
臺中市,南區,1268,363,426,789,32,821,1317,62.34%,27.56%,1
臺中市,南區,1269,364,520,884,36,920,1563,58.86%,23.29%,1
臺中市,南區,1270,505,230,735,37,772,1221,63.23%,41.36%,1
臺中市,西區,1082,208,282,490,27,517,1400,36.93%,14.86%,1
臺中市,西區,1083,227,320,547,18,565,861,65.62%,26.36%,1
臺中市,西區,1084,353,484,837,24,861,1416,60.81%,24.93%,1
臺中市,西區,1085,268,355,623,22,645,1020,63.24%,26.27%,1
臺中市,西區,1086,231,262,493,22,515,778,66.2%,29.69%,1
臺中市,西區,1087,342,460,802,39,841,1465,57.41%,23.34%,1
臺中市,西區,1088,255,337,592,25,617,1017,60.67%,25.07%,1
臺中市,西區,1089,228,285,513,25,538,868,61.98%,26.27%,1
臺中市,西區,1090,350,441,791,28,819,1251,65.47%,27.98%,1
臺中市,西區,1091,289,376,665,26,691,1044,66.19%,27.68%,1
臺中市,西區,1092,386,460,846,30,876,1487,58.91%,25.96%,1
臺中市,西區,1093,421,484,905,37,942,1573,59.89%,26.76%,1
臺中市,西區,1094,413,565,978,34,1012,1731,58.46%,23.86%,1
臺中市,西區,1095,344,390,734,27,761,1209,62.94%,28.45%,1
臺中市,西區,1096,371,524,895,26,921,1564,58.89%,23.72%,1
臺中市,西區,1097,325,384,709,31,740,1175,62.98%,27.66%,1
臺中市,西區,1098,368,480,848,25,873,1505,58.01%,24.45%,1
臺中市,西區,1099,397,460,857,25,882,1418,62.2%,28%,1
臺中市,西區,1100,291,413,704,2,706,1497,47.16%,19.44%,1
臺中市,西區,1101,381,364,745,29,774,1260,61.43%,30.24%,1
臺中市,西區,1102,369,467,836,26,862,1399,61.62%,26.38%,1
臺中市,西區,1103,405,408,813,30,843,1447,58.26%,27.99%,1
臺中市,西區,1104,441,520,961,37,998,1683,59.3%,26.2%,1
臺中市,西區,1105,380,546,926,37,963,1585,60.76%,23.97%,1
臺中市,西區,1106,373,572,945,18,963,1557,61.85%,23.96%,1
臺中市,西區,1107,387,491,878,35,913,1663,54.9%,23.27%,1
臺中市,西區,1108,517,582,1099,33,1132,1921,58.93%,26.91%,1
臺中市,西區,1109,443,579,1022,30,1052,1952,53.89%,22.69%,1
臺中市,西區,1110,426,531,957,34,991,1708,58.02%,24.94%,1
臺中市,西區,1111,279,429,708,29,737,1131,65.16%,24.67%,1
臺中市,西區,1112,413,608,1021,42,1063,1916,55.48%,21.56%,1
臺中市,西區,1113,378,393,771,22,793,1275,62.2%,29.65%,1
臺中市,西區,1114,368,562,930,42,972,1822,53.35%,20.2%,1
臺中市,西區,1115,336,448,784,28,812,1374,59.1%,24.45%,1
臺中市,西區,1116,304,322,626,37,663,1129,58.72%,26.93%,1
臺中市,西區,1117,328,325,653,31,684,1201,56.95%,27.31%,1
臺中市,西區,1118,390,494,884,45,929,1639,56.68%,23.79%,1
臺中市,西區,1119,528,529,1057,44,1101,1863,59.1%,28.34%,1
臺中市,西區,1120,342,477,819,18,837,1287,65.03%,26.57%,1
臺中市,西區,1121,401,496,897,39,936,1504,62.23%,26.66%,1
臺中市,西區,1122,346,398,744,26,770,1308,58.87%,26.45%,1
臺中市,西區,1123,364,413,777,72,849,1433,59.25%,25.4%,1
臺中市,西區,1124,366,442,808,30,838,1450,57.79%,25.24%,1
臺中市,西區,1125,425,465,890,42,932,1465,63.62%,29.01%,1
臺中市,西區,1126,414,548,962,45,1007,1818,55.39%,22.77%,1
臺中市,西區,1127,511,509,1020,35,1055,1782,59.2%,28.68%,1
臺中市,西區,1128,420,443,863,31,894,1428,62.61%,29.41%,1
臺中市,西區,1129,236,472,708,25,733,1366,53.66%,17.28%,1
臺中市,西區,1130,366,461,827,31,858,1498,57.28%,24.43%,1
臺中市,西區,1131,375,437,812,24,836,1350,61.93%,27.78%,1
臺中市,西區,1132,327,481,808,18,826,1339,61.69%,24.42%,1
臺中市,西區,1133,425,523,948,25,973,1613,60.32%,26.35%,1
臺中市,西區,1134,339,487,826,30,856,1454,58.87%,23.31%,1
臺中市,西區,1135,467,491,958,27,985,1597,61.68%,29.24%,1
臺中市,西區,1136,361,513,874,27,901,1411,63.86%,25.58%,1
臺中市,西區,1137,390,459,849,43,892,1493,59.75%,26.12%,1
臺中市,西區,1138,361,585,946,39,985,1600,61.56%,22.56%,1
臺中市,西區,1139,409,526,935,37,972,1710,56.84%,23.92%,1
臺中市,西區,1140,277,389,666,17,683,1139,59.96%,24.32%,1
臺中市,西區,1141,241,417,658,29,687,1105,62.17%,21.81%,1
臺中市,西區,1142,399,426,825,43,868,1498,57.94%,26.64%,1
臺中市,西區,1143,455,520,975,37,1012,1921,52.68%,23.69%,1
臺中市,西區,1144,363,405,768,27,795,1340,59.33%,27.09%,1
臺中市,西區,1145,428,499,927,26,953,1536,62.04%,27.86%,1
臺中市,西區,1146,385,390,775,39,814,1361,59.81%,28.29%,1
臺中市,西區,1147,374,509,883,24,907,1430,63.43%,26.15%,1
臺中市,北區,0983,388,383,771,30,801,1437,55.74%,27%,1
臺中市,北區,0984,418,452,870,63,933,1708,54.63%,24.47%,1
臺中市,北區,0985,258,279,537,31,568,1051,54.04%,24.55%,1
臺中市,北區,0986,289,285,574,24,598,996,60.04%,29.02%,1
臺中市,北區,0987,218,634,852,24,876,1504,58.24%,14.49%,1
臺中市,北區,0988,271,301,572,39,611,975,62.67%,27.79%,1
臺中市,北區,0989,224,279,503,27,530,886,59.82%,25.28%,1
臺中市,北區,0990,312,282,594,29,623,1276,48.82%,24.45%,1
臺中市,北區,0991,234,258,492,26,518,938,55.22%,24.95%,1
臺中市,北區,0992,352,376,728,54,782,1404,55.7%,25.07%,1
臺中市,北區,0993,232,319,551,19,570,996,57.23%,23.29%,1
臺中市,北區,0994,258,221,479,30,509,869,58.57%,29.69%,1
臺中市,北區,0995,211,234,445,13,458,704,65.06%,29.97%,1
臺中市,北區,0996,253,286,539,21,560,979,57.2%,25.84%,1
臺中市,北區,0997,186,215,401,13,414,773,53.56%,24.06%,1
臺中市,北區,0998,180,270,450,19,469,759,61.79%,23.72%,1
臺中市,北區,0999,209,596,805,40,845,1438,58.76%,14.53%,1
臺中市,北區,1000,195,428,623,24,647,1212,53.38%,16.09%,1
臺中市,北區,1001,410,567,977,36,1013,1731,58.52%,23.69%,1
臺中市,北區,1002,337,546,883,22,905,1445,62.63%,23.32%,1
臺中市,北區,1003,480,547,1027,33,1060,1855,57.14%,25.88%,1
臺中市,北區,1004,328,524,852,39,891,1728,51.56%,18.98%,1
臺中市,北區,1005,372,563,935,35,970,1878,51.65%,19.81%,1
臺中市,北區,1006,385,527,912,37,949,1793,52.93%,21.47%,1
臺中市,北區,1007,430,478,908,60,968,1555,62.25%,27.65%,1
臺中市,北區,1008,357,530,887,26,913,1761,51.85%,20.27%,1
臺中市,北區,1009,342,512,854,28,882,1579,55.86%,21.66%,1
臺中市,北區,1010,474,652,1126,61,1187,2192,54.15%,21.62%,1
臺中市,北區,1011,344,548,892,45,937,1560,60.06%,22.05%,1
臺中市,北區,1012,361,478,839,25,864,1476,58.54%,24.46%,1
臺中市,北區,1013,248,356,604,28,632,1006,62.82%,24.65%,1
臺中市,北區,1014,305,479,784,36,820,1403,58.45%,21.74%,1
臺中市,北區,1015,330,443,773,28,801,1446,55.39%,22.82%,1
臺中市,北區,1016,358,443,801,29,830,1460,56.85%,24.52%,1
臺中市,北區,1017,268,425,693,28,721,1233,58.48%,21.74%,1
臺中市,北區,1018,257,398,655,19,674,1027,65.63%,25.02%,1
臺中市,北區,1019,309,392,701,16,717,1207,59.4%,25.6%,1
臺中市,北區,1020,303,395,698,29,727,1167,62.3%,25.96%,1
臺中市,北區,1021,315,347,662,25,687,1150,59.74%,27.39%,1
臺中市,北區,1022,274,318,592,32,624,1061,58.81%,25.82%,1
臺中市,北區,1023,293,308,601,20,621,1005,61.79%,29.15%,1
臺中市,北區,1024,299,410,709,19,728,1250,58.24%,23.92%,1
臺中市,北區,1025,397,434,831,50,881,1448,60.84%,27.42%,1
臺中市,北區,1026,326,465,791,32,823,1379,59.68%,23.64%,1
臺中市,北區,1027,418,509,927,42,969,1652,58.66%,25.3%,1
臺中市,北區,1028,425,569,994,30,1024,1867,54.85%,22.76%,1
臺中市,北區,1029,236,335,571,18,589,2078,28.34%,11.36%,1
臺中市,北區,1030,333,578,911,44,955,1562,61.14%,21.32%,1
臺中市,北區,1031,326,478,804,28,832,1430,58.18%,22.8%,1
臺中市,北區,1032,454,696,1150,38,1188,2018,58.87%,22.5%,1
臺中市,北區,1033,374,491,865,25,890,1710,52.05%,21.87%,1
臺中市,北區,1034,306,468,774,28,802,1432,56.01%,21.37%,1
臺中市,北區,1035,316,373,689,27,716,1157,61.88%,27.31%,1
臺中市,北區,1036,269,423,692,25,717,1188,60.35%,22.64%,1
臺中市,北區,1037,324,470,794,23,817,1419,57.58%,22.83%,1
臺中市,北區,1038,376,516,892,27,919,1653,55.6%,22.75%,1
臺中市,北區,1039,306,394,700,32,732,1233,59.37%,24.82%,1
臺中市,北區,1040,297,408,705,21,726,1243,58.41%,23.89%,1
臺中市,北區,1041,207,422,629,20,649,1219,53.24%,16.98%,1
臺中市,北區,1042,334,400,734,33,767,1272,60.3%,26.26%,1
臺中市,北區,1043,308,438,746,22,768,1285,59.77%,23.97%,1
臺中市,北區,1044,431,596,1027,27,1054,1780,59.21%,24.21%,1
臺中市,北區,1045,382,382,764,27,791,1461,54.14%,26.15%,1
臺中市,北區,1046,359,415,774,31,805,1310,61.45%,27.4%,1
臺中市,北區,1047,399,522,921,27,948,1669,56.8%,23.91%,1
臺中市,北區,1048,445,627,1072,58,1130,1932,58.49%,23.03%,1
臺中市,北區,1049,417,506,923,29,952,1682,56.6%,24.79%,1
臺中市,北區,1050,470,551,1021,25,1046,1891,55.31%,24.85%,1
臺中市,北區,1051,466,562,1028,43,1071,1882,56.91%,24.76%,1
臺中市,北區,1052,265,381,646,24,670,1159,57.81%,22.86%,1
臺中市,北區,1053,390,469,859,41,900,1553,57.95%,25.11%,1
臺中市,北區,1054,394,480,874,32,906,1607,56.38%,24.52%,1
臺中市,北區,1055,474,512,986,30,1016,1773,57.3%,26.73%,1
臺中市,北區,1056,425,413,838,44,882,1524,57.87%,27.89%,1
臺中市,北區,1057,452,510,962,49,1011,1613,62.68%,28.02%,1
臺中市,北區,1058,447,628,1075,38,1113,1877,59.3%,23.81%,1
臺中市,北區,1059,439,571,1010,35,1045,1792,58.31%,24.5%,1
臺中市,北區,1060,339,464,803,42,845,1392,60.7%,24.35%,1
臺中市,北區,1061,332,394,726,30,756,1297,58.29%,25.6%,1
臺中市,北區,1062,381,529,910,40,950,1556,61.05%,24.49%,1
臺中市,北區,1063,350,470,820,26,846,1497,56.51%,23.38%,1
臺中市,北區,1064,374,478,852,24,876,1550,56.52%,24.13%,1
臺中市,北區,1065,367,430,797,18,815,1434,56.83%,25.59%,1
臺中市,北區,1066,405,585,990,44,1034,1793,57.67%,22.59%,1
臺中市,北區,1067,412,608,1020,39,1059,1866,56.75%,22.08%,1
臺中市,北區,1068,343,419,762,44,806,1346,59.88%,25.48%,1
臺中市,北區,1069,290,407,697,43,740,1267,58.41%,22.89%,1
臺中市,西屯區,0625,437,552,989,34,1023,1638,62.45%,26.68%,1
臺中市,西屯區,0626,353,364,717,30,747,1335,55.96%,26.44%,1
臺中市,西屯區,0627,397,625,1022,41,1063,1776,59.85%,22.35%,1
臺中市,西屯區,0628,305,455,760,32,792,1351,58.62%,22.58%,1
臺中市,西屯區,0629,317,474,791,39,830,1338,62.03%,23.69%,1
臺中市,西屯區,0630,339,577,916,24,940,1582,59.42%,21.43%,1
臺中市,西屯區,0631,299,583,882,38,920,1710,53.8%,17.49%,1
臺中市,西屯區,0632,357,466,823,42,865,1595,54.23%,22.38%,1
臺中市,西屯區,0633,282,621,903,45,948,1585,59.81%,17.79%,1
臺中市,西屯區,0634,438,526,964,43,1007,1749,57.58%,25.04%,1
臺中市,西屯區,0635,375,655,1030,46,1076,1877,57.33%,19.98%,1
臺中市,西屯區,0636,382,518,900,35,935,1697,55.1%,22.51%,1
臺中市,西屯區,0637,326,550,876,34,910,1480,61.49%,22.03%,1
臺中市,西屯區,0638,448,493,941,34,975,1483,65.75%,30.21%,1
臺中市,西屯區,0639,370,526,896,25,921,2484,37.08%,14.9%,1
臺中市,西屯區,0640,259,238,497,32,529,781,67.73%,33.16%,1
臺中市,西屯區,0641,346,517,863,37,900,1477,60.93%,23.43%,1
臺中市,西屯區,0642,384,581,965,43,1008,1784,56.5%,21.52%,1
臺中市,西屯區,0643,343,598,941,29,970,1686,57.53%,20.34%,1
臺中市,西屯區,0644,374,570,944,30,974,1692,57.57%,22.1%,1
臺中市,西屯區,0645,315,568,883,25,908,1659,54.73%,18.99%,1
臺中市,西屯區,0646,376,583,959,19,978,1648,59.34%,22.82%,1
臺中市,西屯區,0647,392,527,919,27,946,1536,61.59%,25.52%,1
臺中市,西屯區,0648,355,609,964,34,998,1666,59.9%,21.31%,1
臺中市,西屯區,0649,325,488,813,45,858,1428,60.08%,22.76%,1
臺中市,西屯區,0650,398,547,945,46,991,1810,54.75%,21.99%,1
臺中市,西屯區,0651,326,544,870,27,897,1574,56.99%,20.71%,1
臺中市,西屯區,0652,358,578,936,27,963,1650,58.36%,21.7%,1
臺中市,西屯區,0653,411,530,941,34,975,1681,58%,24.45%,1
臺中市,西屯區,0654,365,553,918,29,947,1656,57.19%,22.04%,1
臺中市,西屯區,0655,273,450,723,44,767,1243,61.71%,21.96%,1
臺中市,西屯區,0656,377,536,913,39,952,1471,64.72%,25.63%,1
臺中市,西屯區,0657,341,529,870,32,902,1431,63.03%,23.83%,1
臺中市,西屯區,0658,392,557,949,33,982,1714,57.29%,22.87%,1
臺中市,西屯區,0659,335,476,811,37,848,1424,59.55%,23.53%,1
臺中市,西屯區,0660,282,394,676,27,703,1176,59.78%,23.98%,1
臺中市,西屯區,0661,335,499,834,46,880,1456,60.44%,23.01%,1
臺中市,西屯區,0662,322,558,880,32,912,1451,62.85%,22.19%,1
臺中市,西屯區,0663,253,421,674,28,702,1063,66.04%,23.8%,1
臺中市,西屯區,0664,320,441,761,39,800,1357,58.95%,23.58%,1
臺中市,西屯區,0665,182,604,786,56,842,1355,62.14%,13.43%,1
臺中市,西屯區,0666,182,658,840,21,861,1384,62.21%,13.15%,1
臺中市,西屯區,0667,400,537,937,35,972,1613,60.26%,24.8%,1
臺中市,西屯區,0668,399,484,883,34,917,1562,58.71%,25.54%,1
臺中市,西屯區,0669,362,404,766,40,806,1219,66.12%,29.7%,1
臺中市,西屯區,0670,318,391,709,36,745,1235,60.32%,25.75%,1
臺中市,西屯區,0671,288,356,644,35,679,1131,60.04%,25.46%,1
臺中市,西屯區,0672,415,492,907,37,944,1494,63.19%,27.78%,1
臺中市,西屯區,0673,296,479,775,24,799,1325,60.3%,22.34%,1
臺中市,西屯區,0674,363,446,809,27,836,1386,60.32%,26.19%,1
臺中市,西屯區,0675,442,600,1042,40,1082,1816,59.58%,24.34%,1
臺中市,西屯區,0676,396,525,921,40,961,1734,55.42%,22.84%,1
臺中市,西屯區,0677,438,593,1031,42,1073,1777,60.38%,24.65%,1
臺中市,西屯區,0678,384,566,950,48,998,1818,54.9%,21.12%,1
臺中市,西屯區,0679,407,510,917,55,972,1699,57.21%,23.96%,1
臺中市,西屯區,0680,370,516,886,35,921,1715,53.7%,21.57%,1
臺中市,西屯區,0681,358,509,867,42,909,1654,54.96%,21.64%,1
臺中市,西屯區,0682,386,504,890,23,913,1636,55.81%,23.59%,1
臺中市,西屯區,0683,334,369,703,21,724,1298,55.78%,25.73%,1
臺中市,西屯區,0684,405,423,828,15,843,1391,60.6%,29.12%,1
臺中市,西屯區,0685,453,604,1057,45,1102,1853,59.47%,24.45%,1
臺中市,西屯區,0686,400,584,984,46,1030,1820,56.59%,21.98%,1
臺中市,西屯區,0687,452,567,1019,45,1064,1809,58.82%,24.99%,1
臺中市,西屯區,0688,346,469,815,32,847,1352,62.65%,25.59%,1
臺中市,西屯區,0689,381,487,868,31,899,1521,59.11%,25.05%,1
臺中市,西屯區,0690,379,500,879,34,913,1486,61.44%,25.5%,1
臺中市,西屯區,0691,402,553,955,35,990,1674,59.14%,24.01%,1
臺中市,西屯區,0692,398,545,943,49,992,1610,61.61%,24.72%,1
臺中市,西屯區,0693,346,573,919,38,957,1695,56.46%,20.41%,1
臺中市,西屯區,0694,335,578,913,31,944,1684,56.06%,19.89%,1
臺中市,西屯區,0695,344,383,727,33,760,1221,62.24%,28.17%,1
臺中市,西屯區,0696,408,394,802,48,850,1252,67.89%,32.59%,1
臺中市,西屯區,0697,358,416,774,41,815,1301,62.64%,27.52%,1
臺中市,西屯區,0698,155,487,642,28,670,1049,63.87%,14.78%,1
臺中市,西屯區,0699,126,512,638,43,681,1113,61.19%,11.32%,1
臺中市,西屯區,0700,296,535,831,30,861,1557,55.3%,19.01%,1
臺中市,西屯區,0701,370,514,884,34,918,1640,55.98%,22.56%,1
臺中市,西屯區,0702,413,478,891,48,939,1402,66.98%,29.46%,1
臺中市,西屯區,0703,328,521,849,64,913,1717,53.17%,19.1%,1
臺中市,西屯區,0704,343,569,912,50,962,1688,56.99%,20.32%,1
臺中市,西屯區,0705,323,375,698,26,724,1168,61.99%,27.65%,1
臺中市,西屯區,0706,367,581,948,7,955,1729,55.23%,21.23%,1
臺中市,西屯區,0707,418,630,1048,32,1080,2007,53.81%,20.83%,1
臺中市,西屯區,0708,361,382,743,58,801,1296,61.81%,27.85%,1
臺中市,西屯區,0709,272,274,546,23,569,1068,53.28%,25.47%,1
臺中市,西屯區,0710,338,508,846,66,912,1707,53.43%,19.8%,1
臺中市,西屯區,0711,358,583,941,40,981,1636,59.96%,21.88%,1
臺中市,西屯區,0712,445,426,871,33,904,1761,51.33%,25.27%,1
臺中市,西屯區,0713,323,423,746,38,784,1314,59.67%,24.58%,1
臺中市,西屯區,0714,288,467,755,39,794,1233,64.4%,23.36%,1
臺中市,西屯區,0715,362,473,835,36,871,1549,56.23%,23.37%,1
臺中市,西屯區,0716,334,532,866,30,896,1639,54.67%,20.38%,1
臺中市,西屯區,0717,271,505,776,45,821,1486,55.25%,18.24%,1
臺中市,西屯區,0718,398,561,959,27,986,1806,54.6%,22.04%,1
臺中市,西屯區,0719,307,462,769,23,792,1451,54.58%,21.16%,1
臺中市,西屯區,0720,321,443,764,21,785,1302,60.29%,24.65%,1
臺中市,西屯區,0721,372,437,809,40,849,1353,62.75%,27.49%,1
臺中市,西屯區,0722,495,738,1233,31,1264,2162,58.46%,22.9%,1
臺中市,西屯區,0723,301,524,825,42,867,1520,57.04%,19.8%,1
臺中市,西屯區,0724,382,672,1054,26,1080,1935,55.81%,19.74%,1
臺中市,西屯區,0725,385,625,1010,42,1052,1847,56.96%,20.84%,1
臺中市,西屯區,0726,409,570,979,32,1011,1738,58.17%,23.53%,1
臺中市,西屯區,0727,394,576,970,38,1008,1640,61.46%,24.02%,1
臺中市,西屯區,0728,368,695,1063,33,1096,1908,57.44%,19.29%,1
臺中市,西屯區,0729,314,474,788,29,817,1402,58.27%,22.4%,1
臺中市,西屯區,0730,303,511,814,28,842,1515,55.58%,20%,1
臺中市,西屯區,0731,278,454,732,27,759,1541,49.25%,18.04%,1
臺中市,西屯區,0732,347,451,798,42,840,1502,55.93%,23.1%,1
臺中市,西屯區,0733,422,449,871,46,917,1526,60.09%,27.65%,1
臺中市,西屯區,0734,427,437,864,41,905,1425,63.51%,29.96%,1
臺中市,西屯區,0735,346,448,794,39,833,1334,62.44%,25.94%,1
臺中市,西屯區,0736,393,582,975,36,1011,1649,61.31%,23.83%,1
臺中市,西屯區,0737,376,488,864,28,892,1566,56.96%,24.01%,1
臺中市,西屯區,0738,373,591,964,33,997,1629,61.2%,22.9%,1
臺中市,西屯區,0739,443,498,941,32,973,1628,59.77%,27.21%,1
臺中市,西屯區,0740,342,526,868,33,901,1442,62.48%,23.72%,1
臺中市,西屯區,0741,301,328,629,43,672,1206,55.72%,24.96%,1
臺中市,西屯區,0742,334,330,664,32,696,1086,64.09%,30.76%,1
臺中市,西屯區,0743,277,376,653,32,685,1088,62.96%,25.46%,1
臺中市,西屯區,0744,275,375,650,28,678,1140,59.47%,24.12%,1
臺中市,南屯區,0745,362,426,788,31,819,1321,62%,27.4%,1
臺中市,南屯區,0746,395,403,798,47,845,1346,62.78%,29.35%,1
臺中市,南屯區,0747,388,471,859,36,895,1428,62.68%,27.17%,1
臺中市,南屯區,0748,349,466,815,35,850,1442,58.95%,24.2%,1
臺中市,南屯區,0749,355,533,888,23,911,1408,64.7%,25.21%,1
臺中市,南屯區,0750,318,526,844,22,866,1404,61.68%,22.65%,1
臺中市,南屯區,0751,376,456,832,32,864,1354,63.81%,27.77%,1
臺中市,南屯區,0752,325,467,792,47,839,1332,62.99%,24.4%,1
臺中市,南屯區,0753,329,574,903,23,926,1463,63.29%,22.49%,1
臺中市,南屯區,0754,356,457,813,43,856,1413,60.58%,25.19%,1
臺中市,南屯區,0755,354,421,775,29,804,1218,66.01%,29.06%,1
臺中市,南屯區,0756,368,408,776,25,801,1308,61.24%,28.13%,1
臺中市,南屯區,0757,449,489,938,34,972,1527,63.65%,29.4%,1
臺中市,南屯區,0758,350,449,799,27,826,1294,63.83%,27.05%,1
臺中市,南屯區,0759,301,486,787,33,820,1516,54.09%,19.85%,1
臺中市,南屯區,0760,376,511,887,66,953,1529,62.33%,24.59%,1
臺中市,南屯區,0761,360,455,815,49,864,1397,61.85%,25.77%,1
臺中市,南屯區,0762,316,450,766,40,806,1406,57.33%,22.48%,1
臺中市,南屯區,0763,372,429,801,37,838,1497,55.98%,24.85%,1
臺中市,南屯區,0764,372,391,763,65,828,1424,58.15%,26.12%,1
臺中市,南屯區,0765,375,360,735,33,768,1488,51.61%,25.2%,1
臺中市,南屯區,0766,191,199,390,20,410,608,67.43%,31.41%,1
臺中市,南屯區,0767,272,231,503,37,540,813,66.42%,33.46%,1
臺中市,南屯區,0768,306,396,702,37,739,1190,62.1%,25.71%,1
臺中市,南屯區,0769,258,390,648,35,683,1174,58.18%,21.98%,1
臺中市,南屯區,0770,297,413,710,16,726,1224,59.31%,24.26%,1
臺中市,南屯區,0771,281,419,700,43,743,1466,50.68%,19.17%,1
臺中市,南屯區,0772,215,331,546,24,570,1333,42.76%,16.13%,1
臺中市,南屯區,0773,206,270,476,44,520,814,63.88%,25.31%,1
臺中市,南屯區,0774,303,443,746,48,794,1436,55.29%,21.1%,1
臺中市,南屯區,0775,365,500,865,44,909,1515,60%,24.09%,1
臺中市,南屯區,0776,327,444,771,26,797,1545,51.59%,21.17%,1
臺中市,南屯區,0777,305,476,781,38,819,1383,59.22%,22.05%,1
臺中市,南屯區,0778,364,470,834,34,868,1433,60.57%,25.4%,1
臺中市,南屯區,0779,262,334,596,31,627,1134,55.29%,23.1%,1
臺中市,南屯區,0780,274,452,726,40,766,1216,62.99%,22.53%,1
臺中市,南屯區,0781,330,367,697,44,741,1271,58.3%,25.96%,1
臺中市,南屯區,0782,279,368,647,26,673,1203,55.94%,23.19%,1
臺中市,南屯區,0783,290,420,710,37,747,1268,58.91%,22.87%,1
臺中市,南屯區,0784,340,446,786,50,836,1390,60.14%,24.46%,1
臺中市,南屯區,0785,358,426,784,35,819,1397,58.63%,25.63%,1
臺中市,南屯區,0786,401,464,865,52,917,1607,57.06%,24.95%,1
臺中市,南屯區,0787,423,495,918,40,958,1582,60.56%,26.74%,1
臺中市,南屯區,0788,356,577,933,38,971,1611,60.27%,22.1%,1
臺中市,南屯區,0789,344,468,812,29,841,1322,63.62%,26.02%,1
臺中市,南屯區,0790,347,494,841,26,867,1321,65.63%,26.27%,1
臺中市,南屯區,0791,324,473,797,39,836,1360,61.47%,23.82%,1
臺中市,南屯區,0792,315,505,820,15,835,1361,61.35%,23.14%,1
臺中市,南屯區,0793,293,465,758,32,790,1257,62.85%,23.31%,1
臺中市,南屯區,0794,282,482,764,26,790,1207,65.45%,23.36%,1
臺中市,南屯區,0795,299,507,806,18,824,1282,64.27%,23.32%,1
臺中市,南屯區,0796,317,472,789,37,826,1248,66.19%,25.4%,1
臺中市,南屯區,0797,326,507,833,23,856,1304,65.64%,25%,1
臺中市,南屯區,0798,296,423,719,27,746,1214,61.45%,24.38%,1
臺中市,南屯區,0799,220,445,665,40,705,1102,63.97%,19.96%,1
臺中市,南屯區,0800,321,690,1011,44,1055,1630,64.72%,19.69%,1
臺中市,南屯區,0801,287,512,799,34,833,1333,62.49%,21.53%,1
臺中市,南屯區,0802,295,506,801,20,821,1292,63.54%,22.83%,1
臺中市,南屯區,0803,284,481,765,28,793,1272,62.34%,22.33%,1
臺中市,南屯區,0804,306,493,799,19,818,1345,60.82%,22.75%,1
臺中市,南屯區,0805,253,416,669,24,693,981,70.64%,25.79%,1
臺中市,南屯區,0806,237,428,665,39,704,1097,64.18%,21.6%,1
臺中市,南屯區,0807,252,378,630,19,649,991,65.49%,25.43%,1
臺中市,南屯區,0808,290,413,703,25,728,1170,62.22%,24.79%,1
臺中市,南屯區,0809,304,421,725,29,754,1171,64.39%,25.96%,1
臺中市,南屯區,0810,352,420,772,40,812,1349,60.19%,26.09%,1
臺中市,南屯區,0811,373,483,856,24,880,1368,64.33%,27.27%,1
臺中市,南屯區,0812,317,470,787,34,821,1263,65%,25.1%,1
臺中市,南屯區,0813,355,570,925,39,964,1547,62.31%,22.95%,1
臺中市,南屯區,0814,397,556,953,40,993,1649,60.22%,24.08%,1
臺中市,南屯區,0815,363,550,913,30,943,1629,57.89%,22.28%,1
臺中市,南屯區,0816,367,466,833,29,862,1580,54.56%,23.23%,1
臺中市,南屯區,0817,385,535,920,28,948,1444,65.65%,26.66%,1
臺中市,南屯區,0818,352,481,833,10,843,1413,59.66%,24.91%,1
臺中市,南屯區,0819,288,485,773,27,800,1377,58.1%,20.92%,1
臺中市,南屯區,0820,418,484,902,35,937,1527,61.36%,27.37%,1
臺中市,南屯區,0821,330,485,815,29,844,1335,63.22%,24.72%,1
臺中市,南屯區,0822,535,485,1020,26,1046,1544,67.75%,34.65%,1
臺中市,南屯區,0823,452,493,945,33,978,1482,65.99%,30.5%,1
臺中市,南屯區,0824,393,491,884,46,930,1488,62.5%,26.41%,1
臺中市,南屯區,0825,339,448,787,29,816,1538,53.06%,22.04%,1
臺中市,南屯區,0826,456,566,1022,39,1061,1674,63.38%,27.24%,1
臺中市,南屯區,0827,358,489,847,19,866,1996,43.39%,17.94%,1
臺中市,南屯區,0828,363,509,872,52,924,1514,61.03%,23.98%,1
臺中市,南屯區,0829,293,456,749,40,789,1217,64.83%,24.08%,1
臺中市,南屯區,0830,344,431,775,31,806,1347,59.84%,25.54%,1
臺中市,南屯區,0831,268,410,678,27,705,1109,63.57%,24.17%,1
臺中市,南屯區,0832,358,520,878,27,905,1546,58.54%,23.16%,1
臺中市,南屯區,0833,358,516,874,32,906,1408,64.35%,25.43%,1
臺中市,南屯區,0834,264,317,581,28,609,1057,57.62%,24.98%,1
臺中市,南屯區,0835,286,371,657,38,695,1133,61.34%,25.24%,1
臺中市,南屯區,0836,329,440,769,22,791,1278,61.89%,25.74%,1
臺中市,南屯區,0837,355,378,733,28,761,1144,66.52%,31.03%,1
臺中市,南屯區,0838,316,378,694,22,716,1140,62.81%,27.72%,1
臺中市,南屯區,0839,303,409,712,31,743,1171,63.45%,25.88%,1
臺中市,南屯區,0840,327,490,817,23,840,1303,64.47%,25.1%,1
臺中市,南屯區,0841,354,434,788,25,813,1402,57.99%,25.25%,1
臺中市,南屯區,0842,348,527,875,41,916,1571,58.31%,22.15%,1
臺中市,南屯區,0843,321,382,703,33,736,1139,64.62%,28.18%,1
臺中市,南屯區,0844,331,421,752,31,783,1216,64.39%,27.22%,1
臺中市,南屯區,0845,283,424,707,36,743,1162,63.94%,24.35%,1
臺中市,北屯區,0846,398,619,1017,35,1052,1670,62.99%,23.83%,1
臺中市,北屯區,0847,357,647,1004,36,1040,1706,60.96%,20.93%,1
臺中市,北屯區,0848,391,436,827,45,872,1507,57.86%,25.95%,1
臺中市,北屯區,0849,425,542,967,32,999,1652,60.47%,25.73%,1
臺中市,北屯區,0850,227,358,585,15,600,1107,54.2%,20.51%,1
臺中市,北屯區,0851,441,675,1116,47,1163,2151,54.07%,20.5%,1
臺中市,北屯區,0852,544,424,968,21,989,1612,61.35%,33.75%,1
臺中市,北屯區,0853,399,574,973,26,999,1743,57.31%,22.89%,1
臺中市,北屯區,0854,460,620,1080,35,1115,2099,53.12%,21.92%,1
臺中市,北屯區,0855,396,512,908,19,927,1595,58.12%,24.83%,1
臺中市,北屯區,0856,401,688,1089,38,1127,1923,58.61%,20.85%,1
臺中市,北屯區,0857,328,538,866,40,906,1641,55.21%,19.99%,1
臺中市,北屯區,0858,280,471,751,18,769,1157,66.46%,24.2%,1
臺中市,北屯區,0859,251,388,639,24,663,1041,63.69%,24.11%,1
臺中市,北屯區,0860,480,345,825,25,850,1563,54.38%,30.71%,1
臺中市,北屯區,0861,375,439,814,36,850,1559,54.52%,24.05%,1
臺中市,北屯區,0862,276,448,724,13,737,1411,52.23%,19.56%,1
臺中市,北屯區,0863,398,615,1013,33,1046,1761,59.4%,22.6%,1
臺中市,北屯區,0864,354,475,829,34,863,1361,63.41%,26.01%,1
臺中市,北屯區,0865,423,589,1012,63,1075,1852,58.05%,22.84%,1
臺中市,北屯區,0866,446,653,1099,41,1140,1928,59.13%,23.13%,1
臺中市,北屯區,0867,393,555,948,26,974,1492,65.28%,26.34%,1
臺中市,北屯區,0868,445,618,1063,47,1110,1998,55.56%,22.27%,1
臺中市,北屯區,0869,350,452,802,31,833,1272,65.49%,27.52%,1
臺中市,北屯區,0870,431,359,790,31,821,1317,62.34%,32.73%,1
臺中市,北屯區,0871,337,338,675,47,722,1327,54.41%,25.4%,1
臺中市,北屯區,0872,344,346,690,21,711,1280,55.55%,26.88%,1
臺中市,北屯區,0873,387,575,962,33,995,1865,53.35%,20.75%,1
臺中市,北屯區,0874,301,455,756,33,789,1230,64.15%,24.47%,1
臺中市,北屯區,0875,295,431,726,27,753,1356,55.53%,21.76%,1
臺中市,北屯區,0876,360,591,951,45,996,1732,57.51%,20.79%,1
臺中市,北屯區,0877,381,526,907,33,940,1586,59.27%,24.02%,1
臺中市,北屯區,0878,337,453,790,28,818,1441,56.77%,23.39%,1
臺中市,北屯區,0879,471,604,1075,45,1120,2045,54.77%,23.03%,1
臺中市,北屯區,0880,436,544,980,34,1014,1914,52.98%,22.78%,1
臺中市,北屯區,0881,430,635,1065,38,1103,1918,57.51%,22.42%,1
臺中市,北屯區,0882,285,774,1059,25,1084,2079,52.14%,13.71%,1
臺中市,北屯區,0883,469,656,1125,38,1163,2040,57.01%,22.99%,1
臺中市,北屯區,0884,383,598,981,30,1011,2027,49.88%,18.89%,1
臺中市,北屯區,0885,315,449,764,32,796,1402,56.78%,22.47%,1
臺中市,北屯區,0886,442,599,1041,42,1083,1826,59.31%,24.21%,1
臺中市,北屯區,0887,416,647,1063,34,1097,2162,50.74%,19.24%,1
臺中市,北屯區,0888,451,629,1080,28,1108,2332,47.51%,19.34%,1
臺中市,北屯區,0889,231,324,555,33,588,985,59.7%,23.45%,1
臺中市,北屯區,0890,468,547,1015,37,1052,2037,51.64%,22.97%,1
臺中市,北屯區,0891,291,323,614,24,638,1032,61.82%,28.2%,1
臺中市,北屯區,0892,236,354,590,33,623,1062,58.66%,22.22%,1
臺中市,北屯區,0893,212,281,493,35,528,909,58.09%,23.32%,1
臺中市,北屯區,0894,358,485,843,42,885,1445,61.25%,24.78%,1
臺中市,北屯區,0895,403,558,961,31,992,1842,53.85%,21.88%,1
臺中市,北屯區,0896,296,396,692,30,722,1187,60.83%,24.94%,1
臺中市,北屯區,0897,394,457,851,28,879,1456,60.37%,27.06%,1
臺中市,北屯區,0898,354,681,1035,48,1083,1866,58.04%,18.97%,1
臺中市,北屯區,0899,359,535,894,23,917,1667,55.01%,21.54%,1
臺中市,北屯區,0900,326,649,975,26,1001,1683,59.48%,19.37%,1
臺中市,北屯區,0901,357,546,903,21,924,1642,56.27%,21.74%,1
臺中市,北屯區,0902,373,522,895,14,909,1475,61.63%,25.29%,1
臺中市,北屯區,0903,348,550,898,23,921,1644,56.02%,21.17%,1
臺中市,北屯區,0904,343,613,956,23,979,1603,61.07%,21.4%,1
臺中市,北屯區,0905,450,658,1108,59,1167,1949,59.88%,23.09%,1
臺中市,北屯區,0906,403,701,1104,40,1144,1790,63.91%,22.51%,1
臺中市,北屯區,0907,351,493,844,24,868,1440,60.28%,24.38%,1
臺中市,北屯區,0908,420,524,944,42,986,1601,61.59%,26.23%,1
臺中市,北屯區,0909,374,456,830,36,866,1527,56.71%,24.49%,1
臺中市,北屯區,0910,347,501,848,42,890,1675,53.13%,20.72%,1
臺中市,北屯區,0911,347,430,777,29,806,1579,51.04%,21.98%,1
臺中市,北屯區,0912,341,509,850,38,888,1524,58.27%,22.38%,1
臺中市,北屯區,0913,327,573,900,29,929,1677,55.4%,19.5%,1
臺中市,北屯區,0914,347,511,858,50,908,1599,56.79%,21.7%,1
臺中市,北屯區,0915,349,500,849,41,890,1458,61.04%,23.94%,1
臺中市,北屯區,0916,387,545,932,35,967,1571,61.55%,24.63%,1
臺中市,北屯區,0917,357,527,884,67,951,1579,60.23%,22.61%,1
臺中市,北屯區,0918,402,654,1056,41,1097,1849,59.33%,21.74%,1
臺中市,北屯區,0919,328,601,929,36,965,1682,57.37%,19.5%,1
臺中市,北屯區,0920,358,606,964,22,986,1760,56.02%,20.34%,1
臺中市,北屯區,0921,381,573,954,45,999,1699,58.8%,22.42%,1
臺中市,北屯區,0922,431,560,991,36,1027,1626,63.16%,26.51%,1
臺中市,北屯區,0923,419,483,902,12,914,1491,61.3%,28.1%,1
臺中市,北屯區,0924,413,486,899,25,924,1640,56.34%,25.18%,1
臺中市,北屯區,0925,522,653,1175,64,1239,2052,60.38%,25.44%,1
臺中市,北屯區,0926,456,634,1090,24,1114,1875,59.41%,24.32%,1
臺中市,北屯區,0927,372,511,883,30,913,1559,58.56%,23.86%,1
臺中市,北屯區,0928,363,470,833,54,887,1480,59.93%,24.53%,1
臺中市,北屯區,0929,347,460,807,36,843,1397,60.34%,24.84%,1
臺中市,北屯區,0930,480,587,1067,38,1105,1889,58.5%,25.41%,1
臺中市,北屯區,0931,442,501,943,40,983,1728,56.89%,25.58%,1
臺中市,北屯區,0932,374,476,850,55,905,1592,56.85%,23.49%,1
臺中市,北屯區,0933,395,497,892,43,935,1656,56.46%,23.85%,1
臺中市,北屯區,0934,335,454,789,35,824,1524,54.07%,21.98%,1
臺中市,北屯區,0935,382,487,869,25,894,1502,59.52%,25.43%,1
臺中市,北屯區,0936,383,583,966,27,993,1772,56.04%,21.61%,1
臺中市,北屯區,0937,364,491,855,25,880,1461,60.23%,24.91%,1
臺中市,北屯區,0938,333,569,902,16,918,1769,51.89%,18.82%,1
臺中市,北屯區,0939,449,637,1086,51,1137,1894,60.03%,23.71%,1
臺中市,北屯區,0940,437,606,1043,37,1080,2033,53.12%,21.5%,1
臺中市,北屯區,0941,408,636,1044,33,1077,1947,55.32%,20.96%,1
臺中市,北屯區,0942,524,716,1240,39,1279,2188,58.46%,23.95%,1
臺中市,北屯區,0943,395,583,978,35,1013,1661,60.99%,23.78%,1
臺中市,北屯區,0944,390,556,946,26,972,1667,58.31%,23.4%,1
臺中市,北屯區,0945,356,589,945,43,988,1728,57.18%,20.6%,1
臺中市,北屯區,0946,390,530,920,23,943,1688,55.86%,23.1%,1
臺中市,北屯區,0947,349,476,825,28,853,1475,57.83%,23.66%,1
臺中市,北屯區,0948,431,612,1043,20,1063,1681,63.24%,25.64%,1
臺中市,北屯區,0949,518,668,1186,53,1239,2078,59.62%,24.93%,1
臺中市,北屯區,0950,434,681,1115,41,1156,2059,56.14%,21.08%,1
臺中市,北屯區,0951,427,590,1017,39,1056,1792,58.93%,23.83%,1
臺中市,北屯區,0952,413,619,1032,31,1063,2974,35.74%,13.89%,1
臺中市,北屯區,0953,322,333,655,30,685,1072,63.9%,30.04%,1
臺中市,北屯區,0954,443,800,1243,32,1275,2099,60.74%,21.11%,1
臺中市,北屯區,0955,538,613,1151,45,1196,1823,65.61%,29.51%,1
臺中市,北屯區,0956,505,687,1192,60,1252,2022,61.92%,24.98%,1
臺中市,北屯區,0957,459,667,1126,32,1158,1992,58.13%,23.04%,1
臺中市,北屯區,0958,437,506,943,44,987,1585,62.27%,27.57%,1
臺中市,北屯區,0959,362,567,929,40,969,1565,61.92%,23.13%,1
臺中市,北屯區,0960,361,577,938,23,961,1780,53.99%,20.28%,1
臺中市,北屯區,0961,448,672,1120,39,1159,1874,61.85%,23.91%,1
臺中市,北屯區,0962,415,626,1041,31,1072,1755,61.08%,23.65%,1
臺中市,北屯區,0963,367,631,998,27,1025,1497,68.47%,24.52%,1
臺中市,北屯區,0964,355,572,927,48,975,1567,62.22%,22.65%,1
臺中市,北屯區,0965,320,581,901,33,934,1624,57.51%,19.7%,1
臺中市,北屯區,0966,368,588,956,38,994,1614,61.59%,22.8%,1
臺中市,北屯區,0967,312,584,896,30,926,1595,58.06%,19.56%,1
臺中市,北屯區,0968,346,566,912,48,960,1782,53.87%,19.42%,1
臺中市,北屯區,0969,258,434,692,26,718,1357,52.91%,19.01%,1
臺中市,北屯區,0970,222,372,594,37,631,1071,58.92%,20.73%,1
臺中市,北屯區,0971,298,430,728,46,774,1372,56.41%,21.72%,1
臺中市,北屯區,0972,289,506,795,51,846,1415,59.79%,20.42%,1
臺中市,北屯區,0973,429,626,1055,44,1099,1789,61.43%,23.98%,1
臺中市,北屯區,0974,515,637,1152,49,1201,1907,62.98%,27.01%,1
臺中市,北屯區,0975,436,705,1141,44,1185,2008,59.01%,21.71%,1
臺中市,北屯區,0976,329,516,845,42,887,1541,57.56%,21.35%,1
臺中市,北屯區,0977,353,615,968,37,1005,1669,60.22%,21.15%,1
臺中市,北屯區,0978,383,579,962,33,995,1685,59.05%,22.73%,1
臺中市,北屯區,0979,501,535,1036,103,1139,1785,63.81%,28.07%,1
臺中市,北屯區,0980,367,572,939,48,987,1596,61.84%,22.99%,1
臺中市,北屯區,0981,406,591,997,50,1047,1731,60.49%,23.45%,1
臺中市,北屯區,0982,333,476,809,45,854,1496,57.09%,22.26%,1
臺中市,豐原區,0394,256,288,544,25,569,983,57.88%,26.04%,1
臺中市,豐原區,0395,295,470,765,41,806,1309,61.57%,22.54%,1
臺中市,豐原區,0396,346,319,665,37,702,1116,62.9%,31%,1
臺中市,豐原區,0397,268,302,570,37,607,945,64.23%,28.36%,1
臺中市,豐原區,0398,260,260,520,38,558,850,65.65%,30.59%,1
臺中市,豐原區,0399,241,231,472,28,500,760,65.79%,31.71%,1
臺中市,豐原區,0400,451,479,930,17,947,1617,58.57%,27.89%,1
臺中市,豐原區,0401,369,499,868,35,903,1677,53.85%,22%,1
臺中市,豐原區,0402,480,624,1104,34,1138,1771,64.26%,27.1%,1
臺中市,豐原區,0403,306,327,633,39,672,1145,58.69%,26.72%,1
臺中市,豐原區,0404,321,446,767,28,795,1362,58.37%,23.57%,1
臺中市,豐原區,0405,345,472,817,38,855,1389,61.56%,24.84%,1
臺中市,豐原區,0406,366,525,891,58,949,1530,62.03%,23.92%,1
臺中市,豐原區,0407,413,417,830,55,885,1471,60.16%,28.08%,1
臺中市,豐原區,0408,388,415,803,69,872,1410,61.84%,27.52%,1
臺中市,豐原區,0409,294,351,645,39,684,1162,58.86%,25.3%,1
臺中市,豐原區,0410,453,495,948,29,977,1656,59%,27.36%,1
臺中市,豐原區,0411,445,561,1006,41,1047,1838,56.96%,24.21%,1
臺中市,豐原區,0412,468,454,922,52,974,1666,58.46%,28.09%,1
臺中市,豐原區,0413,473,572,1045,51,1096,1821,60.19%,25.97%,1
臺中市,豐原區,0414,474,684,1158,58,1216,1821,66.78%,26.03%,1
臺中市,豐原區,0415,478,448,926,33,959,1647,58.23%,29.02%,1
臺中市,豐原區,0416,397,387,784,60,844,1256,67.2%,31.61%,1
臺中市,豐原區,0417,418,570,988,39,1027,1552,66.17%,26.93%,1
臺中市,豐原區,0418,435,592,1027,36,1063,1793,59.29%,24.26%,1
臺中市,豐原區,0419,233,276,509,32,541,759,71.28%,30.7%,1
臺中市,豐原區,0420,202,201,403,26,429,642,66.82%,31.46%,1
臺中市,豐原區,0421,422,501,923,31,954,1528,62.43%,27.62%,1
臺中市,豐原區,0422,499,604,1103,42,1145,1788,64.04%,27.91%,1
臺中市,豐原區,0423,474,565,1039,59,1098,1663,66.03%,28.5%,1
臺中市,豐原區,0424,373,472,845,39,884,1260,70.16%,29.6%,1
臺中市,豐原區,0425,248,272,520,27,547,902,60.64%,27.49%,1
臺中市,豐原區,0426,247,402,649,20,669,1357,49.3%,18.2%,1
臺中市,豐原區,0427,352,595,947,41,988,1592,62.06%,22.11%,1
臺中市,豐原區,0428,470,597,1067,44,1111,1873,59.32%,25.09%,1
臺中市,豐原區,0429,454,611,1065,45,1110,1867,59.45%,24.32%,1
臺中市,豐原區,0430,468,527,995,60,1055,1823,57.87%,25.67%,1
臺中市,豐原區,0431,467,532,999,51,1050,1962,53.52%,23.8%,1
臺中市,豐原區,0432,614,748,1362,68,1430,2313,61.82%,26.55%,1
臺中市,豐原區,0433,406,500,906,35,941,1510,62.32%,26.89%,1
臺中市,豐原區,0434,441,603,1044,55,1099,1824,60.25%,24.18%,1
臺中市,豐原區,0435,332,471,803,38,841,1363,61.7%,24.36%,1
臺中市,豐原區,0436,426,507,933,41,974,1535,63.45%,27.75%,1
臺中市,豐原區,0437,455,419,874,43,917,1457,62.94%,31.23%,1
臺中市,豐原區,0438,344,366,710,27,737,1184,62.25%,29.05%,1
臺中市,豐原區,0439,476,613,1089,41,1130,2299,49.15%,20.7%,1
臺中市,豐原區,0440,566,535,1101,52,1153,1940,59.43%,29.18%,1
臺中市,豐原區,0441,559,600,1159,46,1205,2067,58.3%,27.04%,1
臺中市,豐原區,0442,475,634,1109,53,1162,2038,57.02%,23.31%,1
臺中市,豐原區,0443,484,551,1035,44,1079,1835,58.8%,26.38%,1
臺中市,豐原區,0444,493,600,1093,60,1153,1979,58.26%,24.91%,1
臺中市,豐原區,0445,449,632,1081,69,1150,2014,57.1%,22.29%,1
臺中市,豐原區,0446,541,714,1255,70,1325,2257,58.71%,23.97%,1
臺中市,豐原區,0447,382,470,852,41,893,1406,63.51%,27.17%,1
臺中市,豐原區,0448,387,444,831,37,868,1418,61.21%,27.29%,1
臺中市,豐原區,0449,463,600,1063,60,1123,1772,63.37%,26.13%,1
臺中市,豐原區,0450,342,407,749,37,786,1202,65.39%,28.45%,1
臺中市,豐原區,0451,377,494,871,35,906,1447,62.61%,26.05%,1
臺中市,豐原區,0452,439,581,1020,58,1078,1758,61.32%,24.97%,1
臺中市,豐原區,0453,410,554,964,37,1001,1546,64.75%,26.52%,1
臺中市,豐原區,0454,437,667,1104,38,1142,1815,62.92%,24.08%,1
臺中市,豐原區,0455,515,626,1141,34,1175,1932,60.82%,26.66%,1
臺中市,豐原區,0456,478,613,1091,48,1139,1770,64.35%,27.01%,1
臺中市,豐原區,0457,344,497,841,36,877,1560,56.22%,22.05%,1
臺中市,豐原區,0458,438,590,1028,47,1075,1810,59.39%,24.2%,1
臺中市,豐原區,0459,423,579,1002,36,1038,1653,62.79%,25.59%,1
臺中市,豐原區,0460,362,471,833,43,876,1444,60.66%,25.07%,1
臺中市,豐原區,0461,348,471,819,26,845,1318,64.11%,26.4%,1
臺中市,豐原區,0462,432,475,907,51,958,1566,61.17%,27.59%,1
臺中市,豐原區,0463,390,585,975,54,1029,1748,58.87%,22.31%,1
臺中市,豐原區,0464,416,487,903,67,970,1772,54.74%,23.48%,1
臺中市,豐原區,0465,431,528,959,62,1021,1721,59.33%,25.04%,1
臺中市,豐原區,0466,449,474,923,32,955,1578,60.52%,28.45%,1
臺中市,豐原區,0467,490,546,1036,61,1097,1859,59.01%,26.36%,1
臺中市,豐原區,0468,338,510,848,37,885,1479,59.84%,22.85%,1
臺中市,豐原區,0469,469,621,1090,35,1125,1889,59.56%,24.83%,1
臺中市,豐原區,0470,442,551,993,43,1036,1803,57.46%,24.51%,1
臺中市,豐原區,0471,398,391,789,44,833,1421,58.62%,28.01%,1
臺中市,豐原區,0472,484,473,957,52,1009,1585,63.66%,30.54%,1
臺中市,豐原區,0473,458,598,1056,59,1115,1774,62.85%,25.82%,1
臺中市,豐原區,0474,524,682,1206,67,1273,2132,59.71%,24.58%,1
臺中市,豐原區,0475,425,439,864,47,911,1515,60.13%,28.05%,1
臺中市,豐原區,0476,326,390,716,22,738,1359,54.3%,23.99%,1
臺中市,豐原區,0477,271,298,569,33,602,948,63.5%,28.59%,1
臺中市,豐原區,0478,310,366,676,39,715,1134,63.05%,27.34%,1
臺中市,豐原區,0479,374,327,701,49,750,1114,67.32%,33.57%,1
臺中市,豐原區,0480,309,297,606,37,643,1050,61.24%,29.43%,1
臺中市,豐原區,0481,363,353,716,59,775,1182,65.57%,30.71%,1
臺中市,東勢區,1513,276,399,675,51,726,1299,55.89%,21.25%,1
臺中市,東勢區,1514,233,316,549,37,586,1007,58.19%,23.14%,1
臺中市,東勢區,1515,196,244,440,41,481,859,56%,22.82%,1
臺中市,東勢區,1516,242,353,595,55,650,991,65.59%,24.42%,1
臺中市,東勢區,1517,200,242,442,31,473,863,54.81%,23.17%,1
臺中市,東勢區,1518,362,496,858,69,927,1628,56.94%,22.24%,1
臺中市,東勢區,1519,308,368,676,46,722,1335,54.08%,23.07%,1
臺中市,東勢區,1520,266,399,665,34,699,1092,64.01%,24.36%,1
臺中市,東勢區,1521,255,377,632,43,675,1050,64.29%,24.29%,1
臺中市,東勢區,1522,269,518,787,43,830,1431,58%,18.8%,1
臺中市,東勢區,1523,168,603,771,53,824,1372,60.06%,12.24%,1
臺中市,東勢區,1524,294,505,799,43,842,1412,59.63%,20.82%,1
臺中市,東勢區,1525,184,299,483,37,520,878,59.23%,20.96%,1
臺中市,東勢區,1526,299,437,736,40,776,1475,52.61%,20.27%,1
臺中市,東勢區,1527,159,298,457,23,480,872,55.05%,18.23%,1
臺中市,東勢區,1528,199,339,538,38,576,1006,57.26%,19.78%,1
臺中市,東勢區,1529,237,437,674,28,702,1222,57.45%,19.39%,1
臺中市,東勢區,1530,284,489,773,42,815,1228,66.37%,23.13%,1
臺中市,東勢區,1531,236,389,625,25,650,1036,62.74%,22.78%,1
臺中市,東勢區,1532,213,381,594,31,625,977,63.97%,21.8%,1
臺中市,東勢區,1533,251,521,772,32,804,1395,57.63%,17.99%,1
臺中市,東勢區,1534,268,421,689,51,740,1169,63.3%,22.93%,1
臺中市,東勢區,1535,246,349,595,48,643,1027,62.61%,23.95%,1
臺中市,東勢區,1536,198,374,572,26,598,984,60.77%,20.12%,1
臺中市,東勢區,1537,190,365,555,31,586,866,67.67%,21.94%,1
臺中市,東勢區,1538,253,361,614,27,641,1031,62.17%,24.54%,1
臺中市,東勢區,1539,188,348,536,40,576,865,66.59%,21.73%,1
臺中市,東勢區,1540,265,550,815,49,864,1357,63.67%,19.53%,1
臺中市,東勢區,1541,177,251,428,29,457,736,62.09%,24.05%,1
臺中市,東勢區,1542,308,433,741,46,787,1314,59.89%,23.44%,1
臺中市,東勢區,1543,385,464,849,79,928,1677,55.34%,22.96%,1
臺中市,東勢區,1544,225,327,552,28,580,950,61.05%,23.68%,1
臺中市,東勢區,1545,219,378,597,36,633,1007,62.86%,21.75%,1
臺中市,東勢區,1546,286,333,619,29,648,1214,53.38%,23.56%,1
臺中市,東勢區,1547,197,289,486,39,525,907,57.88%,21.72%,1
臺中市,東勢區,1548,195,269,464,35,499,902,55.32%,21.62%,1
臺中市,東勢區,1549,144,178,322,13,335,720,46.53%,20%,1
臺中市,東勢區,1550,157,173,330,14,344,666,51.65%,23.57%,1
臺中市,東勢區,1551,316,386,702,49,751,1361,55.18%,23.22%,1
臺中市,大甲區,0001,369,400,769,46,815,1356,60.1%,27.21%,1
臺中市,大甲區,0002,323,311,634,31,665,1059,62.8%,30.5%,1
臺中市,大甲區,0003,206,229,435,17,452,694,65.13%,29.68%,1
臺中市,大甲區,0004,248,265,513,21,534,874,61.1%,28.38%,1
臺中市,大甲區,0005,173,239,412,16,428,763,56.09%,22.67%,1
臺中市,大甲區,0006,239,287,526,27,553,856,64.6%,27.92%,1
臺中市,大甲區,0007,313,411,724,31,755,1249,60.45%,25.06%,1
臺中市,大甲區,0008,250,262,512,20,532,922,57.7%,27.11%,1
臺中市,大甲區,0009,309,383,692,28,720,1189,60.56%,25.99%,1
臺中市,大甲區,0010,279,358,637,47,684,1065,64.23%,26.2%,1
臺中市,大甲區,0011,269,468,737,65,802,1252,64.06%,21.49%,1
臺中市,大甲區,0012,251,347,598,31,629,1057,59.51%,23.75%,1
臺中市,大甲區,0013,258,320,578,26,604,1031,58.58%,25.02%,1
臺中市,大甲區,0014,239,392,631,40,671,1060,63.3%,22.55%,1
臺中市,大甲區,0015,286,445,731,37,768,1311,58.58%,21.82%,1
臺中市,大甲區,0016,311,477,788,38,826,1424,58.01%,21.84%,1
臺中市,大甲區,0017,398,530,928,48,976,1670,58.44%,23.83%,1
臺中市,大甲區,0018,213,249,462,31,493,812,60.71%,26.23%,1
臺中市,大甲區,0019,227,294,521,24,545,863,63.15%,26.3%,1
臺中市,大甲區,0020,384,524,908,41,949,1598,59.39%,24.03%,1
臺中市,大甲區,0021,338,539,877,38,915,1588,57.62%,21.28%,1
臺中市,大甲區,0022,280,380,660,42,702,1197,58.65%,23.39%,1
臺中市,大甲區,0023,285,282,567,65,632,1106,57.14%,25.77%,1
臺中市,大甲區,0024,257,279,536,35,571,903,63.23%,28.46%,1
臺中市,大甲區,0025,142,276,418,36,454,869,52.24%,16.34%,1
臺中市,大甲區,0026,344,432,776,31,807,1350,59.78%,25.48%,1
臺中市,大甲區,0027,297,364,661,52,713,1144,62.33%,25.96%,1
臺中市,大甲區,0028,288,416,704,39,743,1208,61.51%,23.84%,1
臺中市,大甲區,0029,382,534,916,36,952,1567,60.75%,24.38%,1
臺中市,大甲區,0030,323,437,760,25,785,1246,63%,25.92%,1
臺中市,大甲區,0031,190,244,434,38,472,767,61.54%,24.77%,1
臺中市,大甲區,0032,238,231,469,15,484,790,61.27%,30.13%,1
臺中市,大甲區,0033,248,325,573,32,605,972,62.24%,25.51%,1
臺中市,大甲區,0034,296,420,716,50,766,1388,55.19%,21.33%,1
臺中市,大甲區,0035,280,407,687,31,718,1331,53.94%,21.04%,1
臺中市,大甲區,0036,269,434,703,31,734,1167,62.9%,23.05%,1
臺中市,大甲區,0037,442,649,1091,43,1134,1934,58.63%,22.85%,1
臺中市,大甲區,0038,297,322,619,47,666,1263,52.73%,23.52%,1
臺中市,大甲區,0039,322,454,776,24,800,1390,57.55%,23.17%,1
臺中市,大甲區,0040,294,285,579,24,603,1186,50.84%,24.79%,1
臺中市,大甲區,0041,362,402,764,36,800,1397,57.27%,25.91%,1
臺中市,大甲區,0042,275,259,534,18,552,1173,47.06%,23.44%,1
臺中市,大甲區,0043,342,382,724,46,770,1398,55.08%,24.46%,1
臺中市,大甲區,0044,313,299,612,31,643,1228,52.36%,25.49%,1
臺中市,大甲區,0045,289,361,650,32,682,1258,54.21%,22.97%,1
臺中市,大甲區,0046,340,417,757,32,789,1435,54.98%,23.69%,1
臺中市,大甲區,0047,337,459,796,48,844,1532,55.09%,22%,1
臺中市,大甲區,0048,146,219,365,17,382,652,58.59%,22.39%,1
臺中市,大甲區,0049,208,209,417,33,450,870,51.72%,23.91%,1
臺中市,大甲區,0050,201,248,449,31,480,891,53.87%,22.56%,1
臺中市,大甲區,0051,200,250,450,32,482,784,61.48%,25.51%,1
臺中市,大甲區,0052,287,401,688,56,744,1368,54.39%,20.98%,1
臺中市,大甲區,0053,244,321,565,40,605,1126,53.73%,21.67%,1
臺中市,大甲區,0054,356,341,697,47,744,1486,50.07%,23.96%,1
臺中市,清水區,0091,267,302,569,26,595,1076,55.3%,24.81%,1
臺中市,清水區,0092,288,313,601,24,625,953,65.58%,30.22%,1
臺中市,清水區,0093,262,273,535,36,571,914,62.47%,28.67%,1
臺中市,清水區,0094,316,390,706,33,739,1143,64.65%,27.65%,1
臺中市,清水區,0095,192,209,401,25,426,680,62.65%,28.24%,1
臺中市,清水區,0096,250,285,535,31,566,904,62.61%,27.65%,1
臺中市,清水區,0097,268,283,551,35,586,893,65.62%,30.01%,1
臺中市,清水區,0098,411,476,887,31,918,1577,58.21%,26.06%,1
臺中市,清水區,0099,216,188,404,15,419,690,60.72%,31.3%,1
臺中市,清水區,0100,107,128,235,13,248,403,61.54%,26.55%,1
臺中市,清水區,0101,478,336,814,38,852,1413,60.3%,33.83%,1
臺中市,清水區,0102,187,242,429,36,465,777,59.85%,24.07%,1
臺中市,清水區,0103,328,454,782,23,805,1313,61.31%,24.98%,1
臺中市,清水區,0104,300,483,783,114,897,1439,62.33%,20.85%,1
臺中市,清水區,0105,341,341,682,17,699,1265,55.26%,26.96%,1
臺中市,清水區,0106,326,462,788,26,814,1277,63.74%,25.53%,1
臺中市,清水區,0107,287,455,742,42,784,1276,61.44%,22.49%,1
臺中市,清水區,0108,353,501,854,18,872,1376,63.37%,25.65%,1
臺中市,清水區,0109,344,462,806,24,830,1291,64.29%,26.65%,1
臺中市,清水區,0110,417,454,871,50,921,1510,60.99%,27.62%,1
臺中市,清水區,0111,369,496,865,48,913,1524,59.91%,24.21%,1
臺中市,清水區,0112,335,435,770,35,805,1474,54.61%,22.73%,1
臺中市,清水區,0113,353,462,815,50,865,1507,57.4%,23.42%,1
臺中市,清水區,0114,362,456,818,44,862,1321,65.25%,27.4%,1
臺中市,清水區,0115,327,265,592,27,619,1157,53.5%,28.26%,1
臺中市,清水區,0116,327,409,736,29,765,1255,60.96%,26.06%,1
臺中市,清水區,0117,236,251,487,26,513,881,58.23%,26.79%,1
臺中市,清水區,0118,282,345,627,44,671,1083,61.96%,26.04%,1
臺中市,清水區,0119,257,324,581,18,599,951,62.99%,27.02%,1
臺中市,清水區,0120,348,395,743,45,788,1424,55.34%,24.44%,1
臺中市,清水區,0121,327,314,641,35,676,1233,54.83%,26.52%,1
臺中市,清水區,0122,297,309,606,29,635,1288,49.3%,23.06%,1
臺中市,清水區,0123,314,371,685,44,729,1200,60.75%,26.17%,1
臺中市,清水區,0124,236,706,942,24,966,1609,60.04%,14.67%,1
臺中市,清水區,0125,305,412,717,15,732,1136,64.44%,26.85%,1
臺中市,清水區,0126,272,422,694,50,744,1302,57.14%,20.89%,1
臺中市,清水區,0127,326,400,726,59,785,1373,57.17%,23.74%,1
臺中市,清水區,0128,273,324,597,59,656,1257,52.19%,21.72%,1
臺中市,清水區,0129,281,309,590,37,627,1184,52.96%,23.73%,1
臺中市,清水區,0130,302,408,710,48,758,1322,57.34%,22.84%,1
臺中市,清水區,0131,208,381,589,48,637,1193,53.39%,17.44%,1
臺中市,清水區,0132,263,259,522,33,555,927,59.87%,28.37%,1
臺中市,清水區,0133,292,332,624,39,663,1073,61.79%,27.21%,1
臺中市,清水區,0134,344,338,682,46,728,1163,62.6%,29.58%,1
臺中市,清水區,0135,201,247,448,29,477,855,55.79%,23.51%,1
臺中市,清水區,0136,215,245,460,47,507,902,56.21%,23.84%,1
臺中市,清水區,0137,399,379,778,42,820,1415,57.95%,28.2%,1
臺中市,清水區,0138,288,268,556,42,598,1066,56.1%,27.02%,1
臺中市,清水區,0139,336,401,737,45,782,1391,56.22%,24.16%,1
臺中市,清水區,0140,346,387,733,32,765,1449,52.8%,23.88%,1
臺中市,清水區,0141,359,440,799,36,835,1377,60.64%,26.07%,1
臺中市,清水區,0142,329,482,811,36,847,1423,59.52%,23.12%,1
臺中市,清水區,0143,378,536,914,31,945,1624,58.19%,23.28%,1
臺中市,清水區,0144,304,391,695,65,760,1358,55.96%,22.39%,1
臺中市,清水區,0145,366,454,820,39,859,1464,58.67%,25%,1
臺中市,清水區,0146,262,412,674,59,733,1211,60.53%,21.64%,1
臺中市,清水區,0147,319,462,781,30,811,1456,55.7%,21.91%,1
臺中市,清水區,0148,275,398,673,56,729,1162,62.74%,23.67%,1
臺中市,清水區,0149,344,499,843,38,881,1368,64.4%,25.15%,1
臺中市,沙鹿區,0186,345,374,719,39,758,1380,54.93%,25%,1
臺中市,沙鹿區,0187,238,258,496,26,522,852,61.27%,27.93%,1
臺中市,沙鹿區,0188,291,414,705,32,737,1176,62.67%,24.74%,1
臺中市,沙鹿區,0189,307,299,606,42,648,958,67.64%,32.05%,1
臺中市,沙鹿區,0190,134,183,317,20,337,488,69.06%,27.46%,1
臺中市,沙鹿區,0191,293,371,664,29,693,1177,58.88%,24.89%,1
臺中市,沙鹿區,0192,303,401,704,45,749,1285,58.29%,23.58%,1
臺中市,沙鹿區,0193,393,488,881,64,945,1736,54.44%,22.64%,1
臺中市,沙鹿區,0194,428,523,951,54,1005,1628,61.73%,26.29%,1
臺中市,沙鹿區,0195,345,427,772,26,798,1469,54.32%,23.49%,1
臺中市,沙鹿區,0196,356,491,847,30,877,1423,61.63%,25.02%,1
臺中市,沙鹿區,0197,351,478,829,35,864,1444,59.83%,24.31%,1
臺中市,沙鹿區,0198,366,454,820,49,869,1469,59.16%,24.91%,1
臺中市,沙鹿區,0199,459,586,1045,61,1106,1902,58.15%,24.13%,1
臺中市,沙鹿區,0200,463,494,957,35,992,1675,59.22%,27.64%,1
臺中市,沙鹿區,0201,298,314,612,25,637,1098,58.01%,27.14%,1
臺中市,沙鹿區,0202,395,510,905,39,944,1539,61.34%,25.67%,1
臺中市,沙鹿區,0203,377,423,800,33,833,1329,62.68%,28.37%,1
臺中市,沙鹿區,0204,368,316,684,33,717,1255,57.13%,29.32%,1
臺中市,沙鹿區,0205,407,468,875,35,910,1507,60.38%,27.01%,1
臺中市,沙鹿區,0206,345,475,820,52,872,1463,59.6%,23.58%,1
臺中市,沙鹿區,0207,294,365,659,55,714,1279,55.82%,22.99%,1
臺中市,沙鹿區,0208,229,308,537,20,557,1024,54.39%,22.36%,1
臺中市,沙鹿區,0209,297,405,702,59,761,1388,54.83%,21.4%,1
臺中市,沙鹿區,0210,358,267,625,34,659,1074,61.36%,33.33%,1
臺中市,沙鹿區,0211,267,357,624,30,654,1072,61.01%,24.91%,1
臺中市,沙鹿區,0212,290,349,639,50,689,1107,62.24%,26.2%,1
臺中市,沙鹿區,0213,382,572,954,34,988,1947,50.74%,19.62%,1
臺中市,沙鹿區,0214,348,489,837,47,884,1682,52.56%,20.69%,1
臺中市,沙鹿區,0215,366,559,925,36,961,1633,58.85%,22.41%,1
臺中市,沙鹿區,0216,303,483,786,45,831,1533,54.21%,19.77%,1
臺中市,沙鹿區,0217,365,393,758,28,786,1605,48.97%,22.74%,1
臺中市,沙鹿區,0218,381,514,895,39,934,1694,55.14%,22.49%,1
臺中市,沙鹿區,0219,362,474,836,41,877,1628,53.87%,22.24%,1
臺中市,沙鹿區,0220,398,548,946,23,969,1665,58.2%,23.9%,1
臺中市,沙鹿區,0221,352,521,873,43,916,1651,55.48%,21.32%,1
臺中市,沙鹿區,0222,304,356,660,30,690,1108,62.27%,27.44%,1
臺中市,沙鹿區,0223,288,376,664,36,700,1142,61.3%,25.22%,1
臺中市,沙鹿區,0224,224,360,584,17,601,1039,57.84%,21.56%,1
臺中市,沙鹿區,0225,375,589,964,52,1016,1840,55.22%,20.38%,1
臺中市,沙鹿區,0226,376,628,1004,37,1041,1872,55.61%,20.09%,1
臺中市,沙鹿區,0227,350,432,782,57,839,1558,53.85%,22.46%,1
臺中市,沙鹿區,0228,365,510,875,35,910,1739,52.33%,20.99%,1
臺中市,沙鹿區,0229,314,487,801,54,855,1672,51.14%,18.78%,1
臺中市,沙鹿區,0230,343,528,871,38,909,1634,55.63%,20.99%,1
臺中市,沙鹿區,0231,348,456,804,27,831,1616,51.42%,21.53%,1
臺中市,沙鹿區,0232,357,513,870,42,912,1593,57.25%,22.41%,1
臺中市,沙鹿區,0233,162,355,517,25,542,981,55.25%,16.51%,1
臺中市,沙鹿區,0234,416,584,1000,45,1045,1740,60.06%,23.91%,1
臺中市,沙鹿區,0235,318,405,723,45,768,1247,61.59%,25.5%,1
臺中市,沙鹿區,0236,198,403,601,15,616,1047,58.83%,18.91%,1
臺中市,沙鹿區,0237,282,347,629,40,669,1119,59.79%,25.2%,1
臺中市,沙鹿區,0238,224,338,562,17,579,1025,56.49%,21.85%,1
臺中市,梧棲區,0150,390,442,832,43,875,1541,56.78%,25.31%,1
臺中市,梧棲區,0151,352,487,839,49,888,1581,56.17%,22.26%,1
臺中市,梧棲區,0152,303,314,617,30,647,1083,59.74%,27.98%,1
臺中市,梧棲區,0153,242,272,514,18,532,876,60.73%,27.63%,1
臺中市,梧棲區,0154,273,319,592,34,626,1043,60.02%,26.17%,1
臺中市,梧棲區,0155,339,425,764,27,791,1502,52.66%,22.57%,1
臺中市,梧棲區,0156,328,441,769,39,808,1384,58.38%,23.7%,1
臺中市,梧棲區,0157,141,183,324,28,352,517,68.09%,27.27%,1
臺中市,梧棲區,0158,342,387,729,29,758,1169,64.84%,29.26%,1
臺中市,梧棲區,0159,245,252,497,29,526,863,60.95%,28.39%,1
臺中市,梧棲區,0160,238,359,597,46,643,1277,50.35%,18.64%,1
臺中市,梧棲區,0161,406,504,910,40,950,1742,54.54%,23.31%,1
臺中市,梧棲區,0162,358,398,756,43,799,1342,59.54%,26.68%,1
臺中市,梧棲區,0163,446,508,954,72,1026,1767,58.06%,25.24%,1
臺中市,梧棲區,0164,367,387,754,38,792,1542,51.36%,23.8%,1
臺中市,梧棲區,0165,491,376,867,30,897,1636,54.83%,30.01%,1
臺中市,梧棲區,0166,423,508,931,32,963,1796,53.62%,23.55%,1
臺中市,梧棲區,0167,317,445,762,38,800,1450,55.17%,21.86%,1
臺中市,梧棲區,0168,372,424,796,64,860,1548,55.56%,24.03%,1
臺中市,梧棲區,0169,329,438,767,41,808,1366,59.15%,24.08%,1
臺中市,梧棲區,0170,290,321,611,21,632,955,66.18%,30.37%,1
臺中市,梧棲區,0171,296,388,684,33,717,1305,54.94%,22.68%,1
臺中市,梧棲區,0172,314,401,715,26,741,1239,59.81%,25.34%,1
臺中市,梧棲區,0173,252,376,628,41,669,1079,62%,23.35%,1
臺中市,梧棲區,0174,268,403,671,31,702,1220,57.54%,21.97%,1
臺中市,梧棲區,0175,416,482,898,36,934,1544,60.49%,26.94%,1
臺中市,梧棲區,0176,401,460,861,26,887,1460,60.75%,27.47%,1
臺中市,梧棲區,0177,322,441,763,35,798,1292,61.76%,24.92%,1
臺中市,梧棲區,0178,313,392,705,37,742,1300,57.08%,24.08%,1
臺中市,梧棲區,0179,357,448,805,39,844,1555,54.28%,22.96%,1
臺中市,梧棲區,0180,230,324,554,28,582,1031,56.45%,22.31%,1
臺中市,梧棲區,0181,363,382,745,28,773,1277,60.53%,28.43%,1
臺中市,梧棲區,0182,265,289,554,32,586,1037,56.51%,25.55%,1
臺中市,梧棲區,0183,300,369,669,43,712,1187,59.98%,25.27%,1
臺中市,梧棲區,0184,323,393,716,46,762,1399,54.47%,23.09%,1
臺中市,梧棲區,0185,258,356,614,34,648,1135,57.09%,22.73%,1
臺中市,后里區,0357,195,314,509,37,546,852,64.08%,22.89%,1
臺中市,后里區,0358,230,370,600,50,650,1135,57.27%,20.26%,1
臺中市,后里區,0359,289,298,587,24,611,1079,56.63%,26.78%,1
臺中市,后里區,0360,309,561,870,47,917,1539,59.58%,20.08%,1
臺中市,后里區,0361,315,562,877,52,929,1591,58.39%,19.8%,1
臺中市,后里區,0362,332,359,691,30,721,1376,52.4%,24.13%,1
臺中市,后里區,0363,291,447,738,20,758,1298,58.4%,22.42%,1
臺中市,后里區,0364,366,430,796,54,850,1428,59.52%,25.63%,1
臺中市,后里區,0365,409,337,746,43,789,1178,66.98%,34.72%,1
臺中市,后里區,0366,235,385,620,40,660,1095,60.27%,21.46%,1
臺中市,后里區,0367,232,304,536,23,559,963,58.05%,24.09%,1
臺中市,后里區,0368,261,373,634,40,674,1163,57.95%,22.44%,1
臺中市,后里區,0369,238,344,582,39,621,1018,61%,23.38%,1
臺中市,后里區,0370,221,303,524,31,555,854,64.99%,25.88%,1
臺中市,后里區,0371,320,456,776,39,815,1485,54.88%,21.55%,1
臺中市,后里區,0372,362,459,821,38,859,1355,63.39%,26.72%,1
臺中市,后里區,0373,200,235,435,34,469,840,55.83%,23.81%,1
臺中市,后里區,0374,317,341,658,33,691,1146,60.3%,27.66%,1
臺中市,后里區,0375,424,550,974,59,1033,1669,61.89%,25.4%,1
臺中市,后里區,0376,425,552,977,60,1037,1673,61.98%,25.4%,1
臺中市,后里區,0377,354,477,831,41,872,1493,58.41%,23.71%,1
臺中市,后里區,0378,279,331,610,48,658,1052,62.55%,26.52%,1
臺中市,后里區,0379,229,260,489,15,504,909,55.45%,25.19%,1
臺中市,后里區,0380,327,302,629,44,673,1091,61.69%,29.97%,1
臺中市,后里區,0381,355,459,814,20,834,1342,62.15%,26.45%,1
臺中市,后里區,0382,305,311,616,33,649,1138,57.03%,26.8%,1
臺中市,后里區,0383,231,330,561,34,595,977,60.9%,23.64%,1
臺中市,后里區,0384,328,428,756,42,798,1584,50.38%,20.71%,1
臺中市,后里區,0385,196,318,514,32,546,915,59.67%,21.42%,1
臺中市,后里區,0386,292,390,682,60,742,1225,60.57%,23.84%,1
臺中市,后里區,0387,356,496,852,38,890,1552,57.35%,22.94%,1
臺中市,后里區,0388,328,544,872,30,902,1600,56.38%,20.5%,1
臺中市,后里區,0389,234,296,530,20,550,942,58.39%,24.84%,1
臺中市,后里區,0390,250,270,520,26,546,943,57.9%,26.51%,1
臺中市,后里區,0391,233,297,530,31,561,1055,53.18%,22.09%,1
臺中市,后里區,0392,267,315,582,49,631,1067,59.14%,25.02%,1
臺中市,后里區,0393,328,361,689,29,718,1340,53.58%,24.48%,1
臺中市,神岡區,0482,431,548,979,50,1029,1684,61.1%,25.59%,1
臺中市,神岡區,0483,390,502,892,38,930,1559,59.65%,25.02%,1
臺中市,神岡區,0484,239,336,575,37,612,1095,55.89%,21.83%,1
臺中市,神岡區,0485,316,361,677,36,713,1044,68.3%,30.27%,1
臺中市,神岡區,0486,350,452,802,52,854,1310,65.19%,26.72%,1
臺中市,神岡區,0487,366,420,786,46,832,1294,64.3%,28.28%,1
臺中市,神岡區,0488,357,311,668,44,712,1143,62.29%,31.23%,1
臺中市,神岡區,0489,297,299,596,41,637,1022,62.33%,29.06%,1
臺中市,神岡區,0490,329,361,690,34,724,1269,57.05%,25.93%,1
臺中市,神岡區,0491,206,322,528,20,548,1085,50.51%,18.99%,1
臺中市,神岡區,0492,268,292,560,44,604,942,64.12%,28.45%,1
臺中市,神岡區,0493,267,398,665,31,696,1154,60.31%,23.14%,1
臺中市,神岡區,0494,367,382,749,43,792,1390,56.98%,26.4%,1
臺中市,神岡區,0495,356,451,807,61,868,1372,63.27%,25.95%,1
臺中市,神岡區,0496,290,391,681,40,721,1328,54.29%,21.84%,1
臺中市,神岡區,0497,290,290,580,28,608,1038,58.57%,27.94%,1
臺中市,神岡區,0498,346,470,816,19,835,1452,57.51%,23.83%,1
臺中市,神岡區,0499,410,497,907,48,955,1551,61.57%,26.43%,1
臺中市,神岡區,0500,366,457,823,44,867,1567,55.33%,23.36%,1
臺中市,神岡區,0501,400,420,820,25,845,1449,58.32%,27.61%,1
臺中市,神岡區,0502,334,339,673,19,692,1246,55.54%,26.81%,1
臺中市,神岡區,0503,379,441,820,51,871,1431,60.87%,26.48%,1
臺中市,神岡區,0504,367,336,703,36,739,1163,63.54%,31.56%,1
臺中市,神岡區,0505,425,443,868,46,914,1402,65.19%,30.31%,1
臺中市,神岡區,0506,351,392,743,29,772,1271,60.74%,27.62%,1
臺中市,神岡區,0507,341,355,696,53,749,1198,62.52%,28.46%,1
臺中市,神岡區,0508,349,410,759,55,814,1312,62.04%,26.6%,1
臺中市,神岡區,0509,437,443,880,44,924,1590,58.11%,27.48%,1
臺中市,神岡區,0510,283,433,716,38,754,1324,56.95%,21.37%,1
臺中市,神岡區,0511,288,476,764,38,802,1415,56.68%,20.35%,1
臺中市,神岡區,0512,448,470,918,43,961,1483,64.8%,30.21%,1
臺中市,神岡區,0513,369,385,754,34,788,1402,56.21%,26.32%,1
臺中市,神岡區,0514,274,408,682,34,716,1275,56.16%,21.49%,1
臺中市,神岡區,0515,311,359,670,39,709,1288,55.05%,24.15%,1
臺中市,神岡區,0516,278,298,576,45,621,1080,57.5%,25.74%,1
臺中市,神岡區,0517,340,399,739,24,763,1344,56.77%,25.3%,1
臺中市,神岡區,0518,269,356,625,45,670,1061,63.15%,25.35%,1
臺中市,神岡區,0519,319,407,726,28,754,1176,64.12%,27.13%,1
臺中市,神岡區,0520,374,361,735,47,782,1244,62.86%,30.06%,1
臺中市,神岡區,0521,396,417,813,44,857,1318,65.02%,30.05%,1
臺中市,神岡區,0522,348,430,778,43,821,1471,55.81%,23.66%,1
臺中市,神岡區,0523,423,406,829,50,879,1323,66.44%,31.97%,1
臺中市,潭子區,0570,359,416,775,39,814,1306,62.33%,27.49%,1
臺中市,潭子區,0571,290,374,664,30,694,1128,61.52%,25.71%,1
臺中市,潭子區,0572,302,406,708,38,746,1159,64.37%,26.06%,1
臺中市,潭子區,0573,419,535,954,49,1003,1630,61.53%,25.71%,1
臺中市,潭子區,0574,364,487,851,36,887,1532,57.9%,23.76%,1
臺中市,潭子區,0575,388,475,863,30,893,1677,53.25%,23.14%,1
臺中市,潭子區,0576,366,525,891,43,934,1744,53.56%,20.99%,1
臺中市,潭子區,0577,451,550,1001,39,1040,1795,57.94%,25.13%,1
臺中市,潭子區,0578,272,369,641,40,681,1171,58.16%,23.23%,1
臺中市,潭子區,0579,330,454,784,32,816,1427,57.18%,23.13%,1
臺中市,潭子區,0580,397,546,943,48,991,1709,57.99%,23.23%,1
臺中市,潭子區,0581,391,550,941,41,982,1723,56.99%,22.69%,1
臺中市,潭子區,0582,406,530,936,40,976,1782,54.77%,22.78%,1
臺中市,潭子區,0583,272,460,732,38,770,1407,54.73%,19.33%,1
臺中市,潭子區,0584,553,480,1033,36,1069,1771,60.36%,31.23%,1
臺中市,潭子區,0585,427,603,1030,59,1089,1795,60.67%,23.79%,1
臺中市,潭子區,0586,393,584,977,36,1013,1612,62.84%,24.38%,1
臺中市,潭子區,0587,459,587,1046,36,1082,1894,57.13%,24.23%,1
臺中市,潭子區,0588,398,550,948,36,984,1689,58.26%,23.56%,1
臺中市,潭子區,0589,332,466,798,37,835,1525,54.75%,21.77%,1
臺中市,潭子區,0590,385,508,893,40,933,1622,57.52%,23.74%,1
臺中市,潭子區,0591,301,383,684,41,725,1200,60.42%,25.08%,1
臺中市,潭子區,0592,328,397,725,14,739,1355,54.54%,24.21%,1
臺中市,潭子區,0593,400,555,955,24,979,1777,55.09%,22.51%,1
臺中市,潭子區,0594,394,666,1060,35,1095,1923,56.94%,20.49%,1
臺中市,潭子區,0595,363,519,882,49,931,1674,55.62%,21.68%,1
臺中市,潭子區,0596,394,496,890,35,925,1451,63.75%,27.15%,1
臺中市,潭子區,0597,374,493,867,37,904,1486,60.83%,25.17%,1
臺中市,潭子區,0598,386,496,882,36,918,1511,60.75%,25.55%,1
臺中市,潭子區,0599,355,598,953,45,998,1666,59.9%,21.31%,1
臺中市,潭子區,0600,394,556,950,42,992,1750,56.69%,22.51%,1
臺中市,潭子區,0601,325,458,783,37,820,1437,57.06%,22.62%,1
臺中市,潭子區,0602,418,550,968,32,1000,1735,57.64%,24.09%,1
臺中市,潭子區,0603,375,506,881,41,922,1612,57.2%,23.26%,1
臺中市,潭子區,0604,274,410,684,23,707,1143,61.85%,23.97%,1
臺中市,潭子區,0605,485,646,1131,41,1172,2096,55.92%,23.14%,1
臺中市,潭子區,0606,389,498,887,45,932,1549,60.17%,25.11%,1
臺中市,潭子區,0607,416,513,929,23,952,1573,60.52%,26.45%,1
臺中市,潭子區,0608,465,397,862,29,891,1585,56.21%,29.34%,1
臺中市,潭子區,0609,350,508,858,35,893,1572,56.81%,22.26%,1
臺中市,潭子區,0610,409,625,1034,32,1066,1738,61.33%,23.53%,1
臺中市,潭子區,0611,443,577,1020,39,1059,1883,56.24%,23.53%,1
臺中市,潭子區,0612,410,421,831,34,865,1401,61.74%,29.26%,1
臺中市,潭子區,0613,352,455,807,31,838,1352,61.98%,26.04%,1
臺中市,潭子區,0614,493,675,1168,69,1237,2085,59.33%,23.65%,1
臺中市,潭子區,0615,496,671,1167,75,1242,2047,60.67%,24.23%,1
臺中市,潭子區,0616,382,508,890,25,915,1673,54.69%,22.83%,1
臺中市,潭子區,0617,479,574,1053,63,1116,1874,59.55%,25.56%,1
臺中市,潭子區,0618,345,267,612,28,640,1051,60.89%,32.83%,1
臺中市,潭子區,0619,389,481,870,36,906,1674,54.12%,23.24%,1
臺中市,潭子區,0620,503,539,1042,45,1087,1831,59.37%,27.47%,1
臺中市,潭子區,0621,461,602,1063,51,1114,2003,55.62%,23.02%,1
臺中市,潭子區,0622,434,437,871,36,907,1535,59.09%,28.27%,1
臺中市,潭子區,0623,452,640,1092,80,1172,2286,51.27%,19.77%,1
臺中市,潭子區,0624,417,550,967,38,1005,1861,54%,22.41%,1
臺中市,大雅區,0524,450,681,1131,44,1175,2027,57.97%,22.2%,1
臺中市,大雅區,0525,428,578,1006,23,1029,1967,52.31%,21.76%,1
臺中市,大雅區,0526,427,598,1025,37,1062,1912,55.54%,22.33%,1
臺中市,大雅區,0527,349,562,911,36,947,1537,61.61%,22.71%,1
臺中市,大雅區,0528,353,498,851,49,900,1439,62.54%,24.53%,1
臺中市,大雅區,0529,355,444,799,40,839,1402,59.84%,25.32%,1
臺中市,大雅區,0530,394,671,1065,42,1107,2013,54.99%,19.57%,1
臺中市,大雅區,0531,463,603,1066,56,1122,1917,58.53%,24.15%,1
臺中市,大雅區,0532,429,653,1082,43,1125,2011,55.94%,21.33%,1
臺中市,大雅區,0533,452,620,1072,46,1118,1887,59.25%,23.95%,1
臺中市,大雅區,0534,397,479,876,37,913,1480,61.69%,26.82%,1
臺中市,大雅區,0535,425,584,1009,50,1059,1816,58.31%,23.4%,1
臺中市,大雅區,0536,397,549,946,40,986,1898,51.95%,20.92%,1
臺中市,大雅區,0537,414,689,1103,47,1150,2008,57.27%,20.62%,1
臺中市,大雅區,0538,417,697,1114,40,1154,1976,58.4%,21.1%,1
臺中市,大雅區,0539,390,564,954,35,989,1673,59.12%,23.31%,1
臺中市,大雅區,0540,375,483,858,31,889,1409,63.09%,26.61%,1
臺中市,大雅區,0541,324,477,801,28,829,1382,59.99%,23.44%,1
臺中市,大雅區,0542,398,489,887,55,942,1635,57.61%,24.34%,1
臺中市,大雅區,0543,359,523,882,48,930,1565,59.42%,22.94%,1
臺中市,大雅區,0544,351,465,816,41,857,1528,56.09%,22.97%,1
臺中市,大雅區,0545,470,575,1045,33,1078,1963,54.92%,23.94%,1
臺中市,大雅區,0546,466,594,1060,44,1104,2073,53.26%,22.48%,1
臺中市,大雅區,0547,450,618,1068,37,1105,1984,55.7%,22.68%,1
臺中市,大雅區,0548,407,504,911,47,958,1688,56.75%,24.11%,1
臺中市,大雅區,0549,337,424,761,47,808,1387,58.26%,24.3%,1
臺中市,大雅區,0550,418,569,987,52,1039,1701,61.08%,24.57%,1
臺中市,大雅區,0551,368,556,924,58,982,1721,57.06%,21.38%,1
臺中市,大雅區,0552,342,527,869,50,919,1879,48.91%,18.2%,1
臺中市,大雅區,0553,399,550,949,57,1006,1568,64.16%,25.45%,1
臺中市,大雅區,0554,455,507,962,84,1046,1761,59.4%,25.84%,1
臺中市,大雅區,0555,411,617,1028,45,1073,1752,61.24%,23.46%,1
臺中市,大雅區,0556,320,400,720,42,762,1264,60.28%,25.32%,1
臺中市,大雅區,0557,348,439,787,30,817,1302,62.75%,26.73%,1
臺中市,大雅區,0558,387,400,787,45,832,1449,57.42%,26.71%,1
臺中市,大雅區,0559,388,545,933,67,1000,1621,61.69%,23.94%,1
臺中市,大雅區,0560,348,533,881,48,929,1647,56.41%,21.13%,1
臺中市,大雅區,0561,297,489,786,35,821,1441,56.97%,20.61%,1
臺中市,大雅區,0562,380,438,818,31,849,1460,58.15%,26.03%,1
臺中市,大雅區,0563,505,572,1077,52,1129,1832,61.63%,27.57%,1
臺中市,大雅區,0564,366,457,823,48,871,1371,63.53%,26.7%,1
臺中市,大雅區,0565,317,418,735,14,749,1418,52.82%,22.36%,1
臺中市,大雅區,0566,385,485,870,51,921,1473,62.53%,26.14%,1
臺中市,大雅區,0567,331,411,742,51,793,1335,59.4%,24.79%,1
臺中市,大雅區,0568,271,662,933,63,996,1733,57.47%,15.64%,1
臺中市,大雅區,0569,250,633,883,101,984,1884,52.23%,13.27%,1
臺中市,新社區,1562,250,319,569,30,599,1011,59.25%,24.73%,1
臺中市,新社區,1563,271,411,682,35,717,1195,60%,22.68%,1
臺中市,新社區,1564,272,361,633,31,664,1053,63.06%,25.83%,1
臺中市,新社區,1565,186,233,419,28,447,961,46.51%,19.35%,1
臺中市,新社區,1566,207,285,492,13,505,919,54.95%,22.52%,1
臺中市,新社區,1567,330,456,786,59,845,1367,61.81%,24.14%,1
臺中市,新社區,1568,286,262,548,35,583,1010,57.72%,28.32%,1
臺中市,新社區,1569,334,237,571,38,609,1169,52.1%,28.57%,1
臺中市,新社區,1570,251,284,535,30,565,989,57.13%,25.38%,1
臺中市,新社區,1571,228,271,499,14,513,894,57.38%,25.5%,1
臺中市,新社區,1572,226,319,545,27,572,1033,55.37%,21.88%,1
臺中市,新社區,1573,198,269,467,23,490,1058,46.31%,18.71%,1
臺中市,新社區,1574,226,204,430,20,450,845,53.25%,26.75%,1
臺中市,新社區,1575,112,247,359,27,386,576,67.01%,19.44%,1
臺中市,新社區,1576,292,302,594,34,628,1229,51.1%,23.76%,1
臺中市,新社區,1577,247,196,443,18,461,890,51.8%,27.75%,1
臺中市,新社區,1578,176,210,386,26,412,781,52.75%,22.54%,1
臺中市,新社區,1579,250,406,656,30,686,1244,55.14%,20.1%,1
臺中市,新社區,1580,29,45,74,10,84,213,39.44%,13.62%,1
臺中市,新社區,1581,151,155,306,26,332,676,49.11%,22.34%,1
臺中市,新社區,1582,70,191,261,22,283,585,48.38%,11.97%,1
臺中市,新社區,1583,180,329,509,31,540,938,57.57%,19.19%,1
臺中市,新社區,1584,39,66,105,5,110,224,49.11%,17.41%,1
臺中市,石岡區,1552,289,412,701,33,734,1244,59%,23.23%,1
臺中市,石岡區,1553,366,477,843,34,877,1539,56.99%,23.78%,1
臺中市,石岡區,1554,314,354,668,47,715,1202,59.48%,26.12%,1
臺中市,石岡區,1555,293,346,639,58,697,1272,54.8%,23.03%,1
臺中市,石岡區,1556,155,217,372,19,391,652,59.97%,23.77%,1
臺中市,石岡區,1557,404,502,906,54,960,1457,65.89%,27.73%,1
臺中市,石岡區,1558,441,561,1002,59,1061,1836,57.79%,24.02%,1
臺中市,石岡區,1559,221,327,548,39,587,1001,58.64%,22.08%,1
臺中市,石岡區,1560,310,532,842,53,895,1448,61.81%,21.41%,1
臺中市,石岡區,1561,287,420,707,59,766,1229,62.33%,23.35%,1
臺中市,外埔區,0071,228,336,564,38,602,1059,56.85%,21.53%,1
臺中市,外埔區,0072,212,370,582,23,605,1013,59.72%,20.93%,1
臺中市,外埔區,0073,278,395,673,49,722,1150,62.78%,24.17%,1
臺中市,外埔區,0074,412,722,1134,51,1185,1855,63.88%,22.21%,1
臺中市,外埔區,0075,277,484,761,34,795,1327,59.91%,20.87%,1
臺中市,外埔區,0076,312,527,839,44,883,1453,60.77%,21.47%,1
臺中市,外埔區,0077,353,508,861,61,922,1653,55.78%,21.36%,1
臺中市,外埔區,0078,323,528,851,30,881,1615,54.55%,20%,1
臺中市,外埔區,0079,326,459,785,21,806,1470,54.83%,22.18%,1
臺中市,外埔區,0080,404,503,907,43,950,1559,60.94%,25.91%,1
臺中市,外埔區,0081,410,592,1002,72,1074,1902,56.47%,21.56%,1
臺中市,外埔區,0082,296,389,685,46,731,1138,64.24%,26.01%,1
臺中市,外埔區,0083,256,377,633,51,684,1065,64.23%,24.04%,1
臺中市,外埔區,0084,315,432,747,37,784,1243,63.07%,25.34%,1
臺中市,外埔區,0085,198,292,490,41,531,962,55.2%,20.58%,1
臺中市,外埔區,0086,334,274,608,50,658,1169,56.29%,28.57%,1
臺中市,外埔區,0087,314,430,744,55,799,1216,65.71%,25.82%,1
臺中市,外埔區,0088,330,424,754,30,784,1391,56.36%,23.72%,1
臺中市,外埔區,0089,397,470,867,53,920,1616,56.93%,24.57%,1
臺中市,外埔區,0090,281,287,568,28,596,1203,49.54%,23.36%,1
臺中市,大安區,0055,245,292,537,41,578,1068,54.12%,22.94%,1
臺中市,大安區,0056,273,298,571,43,614,1050,58.48%,26%,1
臺中市,大安區,0057,314,386,700,57,757,1246,60.75%,25.2%,1
臺中市,大安區,0058,313,437,750,40,790,1397,56.55%,22.41%,1
臺中市,大安區,0059,342,391,733,34,767,1227,62.51%,27.87%,1
臺中市,大安區,0060,313,343,656,40,696,1170,59.49%,26.75%,1
臺中市,大安區,0061,255,313,568,28,596,914,65.21%,27.9%,1
臺中市,大安區,0062,156,169,325,22,347,667,52.02%,23.39%,1
臺中市,大安區,0063,191,251,442,44,486,890,54.61%,21.46%,1
臺中市,大安區,0064,321,372,693,46,739,1289,57.33%,24.9%,1
臺中市,大安區,0065,97,128,225,21,246,455,54.07%,21.32%,1
臺中市,大安區,0066,255,300,555,38,593,1028,57.68%,24.81%,1
臺中市,大安區,0067,325,483,808,68,876,1446,60.58%,22.48%,1
臺中市,大安區,0068,180,245,425,22,447,688,64.97%,26.16%,1
臺中市,大安區,0069,266,340,606,44,650,1062,61.21%,25.05%,1
臺中市,大安區,0070,276,303,579,22,601,923,65.11%,29.9%,1
臺中市,烏日區,0317,439,459,898,46,944,1480,63.78%,29.66%,1
臺中市,烏日區,0318,482,598,1080,49,1129,1841,61.33%,26.18%,1
臺中市,烏日區,0319,422,534,956,50,1006,1751,57.45%,24.1%,1
臺中市,烏日區,0320,437,483,920,40,960,1547,62.06%,28.25%,1
臺中市,烏日區,0321,428,608,1036,40,1076,1836,58.61%,23.31%,1
臺中市,烏日區,0322,418,354,772,62,834,1239,67.31%,33.74%,1
臺中市,烏日區,0323,323,372,695,55,750,1295,57.92%,24.94%,1
臺中市,烏日區,0324,353,359,712,21,733,1263,58.04%,27.95%,1
臺中市,烏日區,0325,395,484,879,31,910,1622,56.1%,24.35%,1
臺中市,烏日區,0326,367,595,962,76,1038,1822,56.97%,20.14%,1
臺中市,烏日區,0327,412,559,971,120,1091,1966,55.49%,20.96%,1
臺中市,烏日區,0328,376,539,915,38,953,1615,59.01%,23.28%,1
臺中市,烏日區,0329,294,400,694,36,730,1232,59.25%,23.86%,1
臺中市,烏日區,0330,293,425,718,35,753,1347,55.9%,21.75%,1
臺中市,烏日區,0331,276,329,605,22,627,1165,53.82%,23.69%,1
臺中市,烏日區,0332,422,556,978,33,1011,1664,60.76%,25.36%,1
臺中市,烏日區,0333,321,426,747,37,784,1230,63.74%,26.1%,1
臺中市,烏日區,0334,422,517,939,61,1000,1574,63.53%,26.81%,1
臺中市,烏日區,0335,376,510,886,34,920,1452,63.36%,25.9%,1
臺中市,烏日區,0336,423,543,966,49,1015,1879,54.02%,22.51%,1
臺中市,烏日區,0337,398,496,894,35,929,1601,58.03%,24.86%,1
臺中市,烏日區,0338,380,531,911,51,962,1546,62.23%,24.58%,1
臺中市,烏日區,0339,411,522,933,32,965,1866,51.71%,22.03%,1
臺中市,烏日區,0340,389,717,1106,50,1156,1938,59.65%,20.07%,1
臺中市,烏日區,0341,402,590,992,50,1042,1759,59.24%,22.85%,1
臺中市,烏日區,0342,433,669,1102,58,1160,2061,56.28%,21.01%,1
臺中市,烏日區,0343,374,596,970,35,1005,1691,59.43%,22.12%,1
臺中市,烏日區,0344,335,299,634,45,679,1039,65.35%,32.24%,1
臺中市,烏日區,0345,368,360,728,30,758,1221,62.08%,30.14%,1
臺中市,烏日區,0346,422,519,941,66,1007,1650,61.03%,25.58%,1
臺中市,烏日區,0347,268,271,539,29,568,937,60.62%,28.6%,1
臺中市,烏日區,0348,320,365,685,49,734,1220,60.16%,26.23%,1
臺中市,烏日區,0349,498,563,1061,84,1145,2139,53.53%,23.28%,1
臺中市,烏日區,0350,381,460,841,52,893,1371,65.13%,27.79%,1
臺中市,烏日區,0351,304,409,713,49,762,1277,59.67%,23.81%,1
臺中市,烏日區,0352,422,493,915,42,957,1708,56.03%,24.71%,1
臺中市,烏日區,0353,590,610,1200,57,1257,2048,61.38%,28.81%,1
臺中市,烏日區,0354,406,443,849,63,912,1632,55.88%,24.88%,1
臺中市,烏日區,0355,354,418,772,38,810,1327,61.04%,26.68%,1
臺中市,烏日區,0356,179,273,452,51,503,854,58.9%,20.96%,1
臺中市,大肚區,0284,393,409,802,22,824,1415,58.23%,27.77%,1
臺中市,大肚區,0285,299,405,704,46,750,1392,53.88%,21.48%,1
臺中市,大肚區,0286,368,512,880,42,922,1520,60.66%,24.21%,1
臺中市,大肚區,0287,263,281,544,42,586,862,67.98%,30.51%,1
臺中市,大肚區,0288,298,445,743,41,784,1256,62.42%,23.73%,1
臺中市,大肚區,0289,267,438,705,46,751,1292,58.13%,20.67%,1
臺中市,大肚區,0290,268,312,580,39,619,1010,61.29%,26.53%,1
臺中市,大肚區,0291,356,500,856,63,919,1485,61.89%,23.97%,1
臺中市,大肚區,0292,289,439,728,44,772,1190,64.87%,24.29%,1
臺中市,大肚區,0293,307,392,699,47,746,1250,59.68%,24.56%,1
臺中市,大肚區,0294,291,458,749,31,780,1310,59.54%,22.21%,1
臺中市,大肚區,0295,333,362,695,43,738,1294,57.03%,25.73%,1
臺中市,大肚區,0296,436,606,1042,51,1093,1734,63.03%,25.14%,1
臺中市,大肚區,0297,306,421,727,51,778,1316,59.12%,23.25%,1
臺中市,大肚區,0298,221,253,474,40,514,854,60.19%,25.88%,1
臺中市,大肚區,0299,347,448,795,36,831,1273,65.28%,27.26%,1
臺中市,大肚區,0300,233,303,536,14,550,851,64.63%,27.38%,1
臺中市,大肚區,0301,376,526,902,27,929,1629,57.03%,23.08%,1
臺中市,大肚區,0302,411,494,905,62,967,1709,56.58%,24.05%,1
臺中市,大肚區,0303,222,282,504,24,528,953,55.4%,23.29%,1
臺中市,大肚區,0304,334,436,770,45,815,1336,61%,25%,1
臺中市,大肚區,0305,493,592,1085,65,1150,2113,54.42%,23.33%,1
臺中市,大肚區,0306,399,558,957,64,1021,1730,59.02%,23.06%,1
臺中市,大肚區,0307,374,553,927,34,961,1692,56.8%,22.1%,1
臺中市,大肚區,0308,374,589,963,49,1012,1747,57.93%,21.41%,1
臺中市,大肚區,0309,425,500,925,39,964,1672,57.66%,25.42%,1
臺中市,大肚區,0310,419,479,898,33,931,1675,55.58%,25.01%,1
臺中市,大肚區,0311,384,525,909,48,957,1673,57.2%,22.95%,1
臺中市,大肚區,0312,470,477,947,35,982,1636,60.02%,28.73%,1
臺中市,大肚區,0313,421,474,895,61,956,1753,54.54%,24.02%,1
臺中市,大肚區,0314,313,369,682,28,710,1343,52.87%,23.31%,1
臺中市,大肚區,0315,427,533,960,50,1010,1822,55.43%,23.44%,1
臺中市,大肚區,0316,366,627,993,40,1033,1670,61.86%,21.92%,1
臺中市,龍井區,0239,435,570,1005,63,1068,1758,60.75%,24.74%,1
臺中市,龍井區,0240,276,417,693,36,729,1275,57.18%,21.65%,1
臺中市,龍井區,0241,324,366,690,19,709,1379,51.41%,23.5%,1
臺中市,龍井區,0242,309,409,718,32,750,1403,53.46%,22.02%,1
臺中市,龍井區,0243,242,292,534,36,570,974,58.52%,24.85%,1
臺中市,龍井區,0244,200,305,505,35,540,901,59.93%,22.2%,1
臺中市,龍井區,0245,395,530,925,62,987,1779,55.48%,22.2%,1
臺中市,龍井區,0246,418,501,919,45,964,1609,59.91%,25.98%,1
臺中市,龍井區,0247,217,260,477,25,502,1038,48.36%,20.91%,1
臺中市,龍井區,0248,328,453,781,52,833,1328,62.73%,24.7%,1
臺中市,龍井區,0249,238,319,557,24,581,921,63.08%,25.84%,1
臺中市,龍井區,0250,346,473,819,35,854,1609,53.08%,21.5%,1
臺中市,龍井區,0251,283,315,598,20,618,1227,50.37%,23.06%,1
臺中市,龍井區,0252,304,386,690,43,733,1278,57.36%,23.79%,1
臺中市,龍井區,0253,249,189,438,19,457,914,50%,27.24%,1
臺中市,龍井區,0254,346,464,810,26,836,1678,49.82%,20.62%,1
臺中市,龍井區,0255,270,341,611,36,647,1233,52.47%,21.9%,1
臺中市,龍井區,0256,350,458,808,55,863,1520,56.78%,23.03%,1
臺中市,龍井區,0257,394,550,944,35,979,1905,51.39%,20.68%,1
臺中市,龍井區,0258,518,352,870,49,919,1520,60.46%,34.08%,1
臺中市,龍井區,0259,298,411,709,47,756,1385,54.58%,21.52%,1
臺中市,龍井區,0260,313,345,658,30,688,1212,56.77%,25.83%,1
臺中市,龍井區,0261,362,456,818,15,833,1432,58.17%,25.28%,1
臺中市,龍井區,0262,404,463,867,33,900,1663,54.12%,24.29%,1
臺中市,龍井區,0263,288,452,740,33,773,1422,54.36%,20.25%,1
臺中市,龍井區,0264,363,419,782,40,822,1616,50.87%,22.46%,1
臺中市,龍井區,0265,314,482,796,51,847,1422,59.56%,22.08%,1
臺中市,龍井區,0266,216,478,694,18,712,1165,61.12%,18.54%,1
臺中市,龍井區,0267,373,504,877,23,900,1624,55.42%,22.97%,1
臺中市,龍井區,0268,374,476,850,53,903,1613,55.98%,23.19%,1
臺中市,龍井區,0269,234,324,558,41,599,943,63.52%,24.81%,1
臺中市,龍井區,0270,338,461,799,69,868,1595,54.42%,21.19%,1
臺中市,龍井區,0271,319,513,832,57,889,1508,58.95%,21.15%,1
臺中市,龍井區,0272,344,435,779,34,813,1479,54.97%,23.26%,1
臺中市,龍井區,0273,380,462,842,38,880,1509,58.32%,25.18%,1
臺中市,龍井區,0274,402,517,919,48,967,1582,61.13%,25.41%,1
臺中市,龍井區,0275,353,577,930,49,979,1725,56.75%,20.46%,1
臺中市,龍井區,0276,313,603,916,26,942,1616,58.29%,19.37%,1
臺中市,龍井區,0277,409,555,964,29,993,1657,59.93%,24.68%,1
臺中市,龍井區,0278,389,609,998,48,1046,1774,58.96%,21.93%,1
臺中市,龍井區,0279,420,580,1000,47,1047,1701,61.55%,24.69%,1
臺中市,龍井區,0280,297,345,642,26,668,1121,59.59%,26.49%,1
臺中市,龍井區,0281,289,301,590,30,620,987,62.82%,29.28%,1
臺中市,龍井區,0282,307,347,654,37,691,1206,57.3%,25.46%,1
臺中市,龍井區,0283,313,511,824,25,849,1378,61.61%,22.71%,1
臺中市,霧峰區,1470,308,406,714,36,750,1205,62.24%,25.56%,1
臺中市,霧峰區,1471,384,500,884,50,934,1620,57.65%,23.7%,1
臺中市,霧峰區,1472,371,529,900,62,962,1559,61.71%,23.8%,1
臺中市,霧峰區,1473,376,528,904,51,955,1660,57.53%,22.65%,1
臺中市,霧峰區,1474,375,565,940,48,988,1602,61.67%,23.41%,1
臺中市,霧峰區,1475,331,369,700,36,736,1325,55.55%,24.98%,1
臺中市,霧峰區,1476,347,497,844,51,895,1515,59.08%,22.9%,1
臺中市,霧峰區,1477,337,505,842,46,888,1561,56.89%,21.59%,1
臺中市,霧峰區,1478,396,473,869,51,920,1691,54.41%,23.42%,1
臺中市,霧峰區,1479,330,484,814,53,867,1486,58.34%,22.21%,1
臺中市,霧峰區,1480,269,302,571,42,613,975,62.87%,27.59%,1
臺中市,霧峰區,1481,333,470,803,43,846,1358,62.3%,24.52%,1
臺中市,霧峰區,1482,295,440,735,34,769,1141,67.4%,25.85%,1
臺中市,霧峰區,1483,238,292,530,37,567,855,66.32%,27.84%,1
臺中市,霧峰區,1484,285,395,680,72,752,1202,62.56%,23.71%,1
臺中市,霧峰區,1485,273,302,575,40,615,1078,57.05%,25.32%,1
臺中市,霧峰區,1486,369,492,861,43,904,1456,62.09%,25.34%,1
臺中市,霧峰區,1487,384,554,938,28,966,1573,61.41%,24.41%,1
臺中市,霧峰區,1488,362,536,898,49,947,1591,59.52%,22.75%,1
臺中市,霧峰區,1489,313,435,748,38,786,1214,64.74%,25.78%,1
臺中市,霧峰區,1490,304,382,686,47,733,1267,57.85%,23.99%,1
臺中市,霧峰區,1491,325,390,715,50,765,1277,59.91%,25.45%,1
臺中市,霧峰區,1492,388,374,762,34,796,1366,58.27%,28.4%,1
臺中市,霧峰區,1493,287,351,638,52,690,994,69.42%,28.87%,1
臺中市,霧峰區,1494,213,316,529,28,557,863,64.54%,24.68%,1
臺中市,霧峰區,1495,310,388,698,36,734,1274,57.61%,24.33%,1
臺中市,霧峰區,1496,300,316,616,50,666,1162,57.31%,25.82%,1
臺中市,霧峰區,1497,314,415,729,57,786,1252,62.78%,25.08%,1
臺中市,霧峰區,1498,352,382,734,55,789,1322,59.68%,26.63%,1
臺中市,霧峰區,1499,313,356,669,43,712,1116,63.8%,28.05%,1
臺中市,霧峰區,1500,355,316,671,69,740,1156,64.01%,30.71%,1
臺中市,霧峰區,1501,296,396,692,52,744,1147,64.86%,25.81%,1
臺中市,霧峰區,1502,233,350,583,47,630,928,67.89%,25.11%,1
臺中市,霧峰區,1503,288,409,697,37,734,1296,56.64%,22.22%,1
臺中市,霧峰區,1504,351,325,676,46,722,1314,54.95%,26.71%,1
臺中市,霧峰區,1505,357,408,765,55,820,1328,61.75%,26.88%,1
臺中市,霧峰區,1506,278,277,555,46,601,989,60.77%,28.11%,1
臺中市,霧峰區,1507,262,362,624,60,684,1088,62.87%,24.08%,1
臺中市,霧峰區,1508,300,506,806,45,851,1363,62.44%,22.01%,1
臺中市,霧峰區,1509,396,520,916,50,966,1573,61.41%,25.17%,1
臺中市,霧峰區,1510,281,334,615,46,661,1117,59.18%,25.16%,1
臺中市,霧峰區,1511,362,458,820,54,874,1342,65.13%,26.97%,1
臺中市,霧峰區,1512,328,317,645,44,689,1024,67.29%,32.03%,1
臺中市,太平區,1271,422,514,936,64,1000,1821,54.91%,23.17%,1
臺中市,太平區,1272,373,469,842,40,882,1680,52.5%,22.2%,1
臺中市,太平區,1273,523,552,1075,55,1130,1947,58.04%,26.86%,1
臺中市,太平區,1274,480,603,1083,71,1154,1910,60.42%,25.13%,1
臺中市,太平區,1275,442,544,986,33,1019,1894,53.8%,23.34%,1
臺中市,太平區,1276,299,633,932,51,983,1953,50.33%,15.31%,1
臺中市,太平區,1277,445,561,1006,59,1065,1846,57.69%,24.11%,1
臺中市,太平區,1278,376,484,860,41,901,1493,60.35%,25.18%,1
臺中市,太平區,1279,373,379,752,51,803,1605,50.03%,23.24%,1
臺中市,太平區,1280,391,544,935,39,974,1619,60.16%,24.15%,1
臺中市,太平區,1281,488,564,1052,54,1106,2011,55%,24.27%,1
臺中市,太平區,1282,507,581,1088,34,1122,2056,54.57%,24.66%,1
臺中市,太平區,1283,436,540,976,57,1033,1876,55.06%,23.24%,1
臺中市,太平區,1284,365,577,942,52,994,1815,54.77%,20.11%,1
臺中市,太平區,1285,345,352,697,38,735,1281,57.38%,26.93%,1
臺中市,太平區,1286,299,318,617,37,654,1004,65.14%,29.78%,1
臺中市,太平區,1287,506,575,1081,50,1131,1886,59.97%,26.83%,1
臺中市,太平區,1288,374,432,806,59,865,1431,60.45%,26.14%,1
臺中市,太平區,1289,460,535,995,65,1060,1930,54.92%,23.83%,1
臺中市,太平區,1290,477,604,1081,44,1125,2164,51.99%,22.04%,1
臺中市,太平區,1291,400,674,1074,42,1116,2048,54.49%,19.53%,1
臺中市,太平區,1292,438,611,1049,45,1094,2035,53.76%,21.52%,1
臺中市,太平區,1293,401,484,885,51,936,1685,55.55%,23.8%,1
臺中市,太平區,1294,487,542,1029,53,1082,2185,49.52%,22.29%,1
臺中市,太平區,1295,277,349,626,29,655,1176,55.7%,23.55%,1
臺中市,太平區,1296,356,494,850,25,875,1597,54.79%,22.29%,1
臺中市,太平區,1297,286,412,698,52,750,1378,54.43%,20.75%,1
臺中市,太平區,1298,384,458,842,41,883,1546,57.12%,24.84%,1
臺中市,太平區,1299,380,528,908,53,961,1890,50.85%,20.11%,1
臺中市,太平區,1300,222,338,560,38,598,1053,56.79%,21.08%,1
臺中市,太平區,1301,385,510,895,65,960,1582,60.68%,24.34%,1
臺中市,太平區,1302,337,600,937,58,995,1699,58.56%,19.84%,1
臺中市,太平區,1303,327,442,769,47,816,1493,54.66%,21.9%,1
臺中市,太平區,1304,244,305,549,42,591,1063,55.6%,22.95%,1
臺中市,太平區,1305,247,402,649,31,680,1117,60.88%,22.11%,1
臺中市,太平區,1306,248,377,625,39,664,1084,61.25%,22.88%,1
臺中市,太平區,1307,409,515,924,40,964,1776,54.28%,23.03%,1
臺中市,太平區,1308,329,580,909,37,946,1729,54.71%,19.03%,1
臺中市,太平區,1309,314,486,800,45,845,1658,50.97%,18.94%,1
臺中市,太平區,1310,365,655,1020,57,1077,2010,53.58%,18.16%,1
臺中市,太平區,1311,320,576,896,43,939,1752,53.6%,18.26%,1
臺中市,太平區,1312,339,615,954,50,1004,1654,60.7%,20.5%,1
臺中市,太平區,1313,319,476,795,21,816,1951,41.82%,16.35%,1
臺中市,太平區,1314,543,758,1301,64,1365,2170,62.9%,25.02%,1
臺中市,太平區,1315,499,791,1290,54,1344,2231,60.24%,22.37%,1
臺中市,太平區,1316,383,542,925,33,958,1623,59.03%,23.6%,1
臺中市,太平區,1317,361,391,752,33,785,1548,50.71%,23.32%,1
臺中市,太平區,1318,346,438,784,37,821,1442,56.93%,23.99%,1
臺中市,太平區,1319,349,378,727,28,755,1501,50.3%,23.25%,1
臺中市,太平區,1320,404,565,969,34,1003,2025,49.53%,19.95%,1
臺中市,太平區,1321,377,583,960,41,1001,1885,53.1%,20%,1
臺中市,太平區,1322,446,566,1012,52,1064,2155,49.37%,20.7%,1
臺中市,太平區,1323,419,483,902,40,942,1775,53.07%,23.61%,1
臺中市,太平區,1324,346,515,861,54,915,2021,45.27%,17.12%,1
臺中市,太平區,1325,448,716,1164,50,1214,2075,58.51%,21.59%,1
臺中市,太平區,1326,337,530,867,39,906,1723,52.58%,19.56%,1
臺中市,太平區,1327,431,669,1100,45,1145,2049,55.88%,21.03%,1
臺中市,太平區,1328,292,471,763,23,786,1415,55.55%,20.64%,1
臺中市,太平區,1329,450,549,999,28,1027,1778,57.76%,25.31%,1
臺中市,太平區,1330,335,533,868,36,904,1706,52.99%,19.64%,1
臺中市,太平區,1331,415,678,1093,41,1134,2090,54.26%,19.86%,1
臺中市,太平區,1332,373,632,1005,35,1040,2093,49.69%,17.82%,1
臺中市,太平區,1333,330,462,792,29,821,1688,48.64%,19.55%,1
臺中市,太平區,1334,310,409,719,40,759,1488,51.01%,20.83%,1
臺中市,太平區,1335,331,502,833,43,876,1667,52.55%,19.86%,1
臺中市,太平區,1336,422,567,989,41,1030,1793,57.45%,23.54%,1
臺中市,太平區,1337,433,614,1047,44,1091,1903,57.33%,22.75%,1
臺中市,太平區,1338,453,530,983,43,1026,1834,55.94%,24.7%,1
臺中市,太平區,1339,354,467,821,27,848,1526,55.57%,23.2%,1
臺中市,太平區,1340,392,524,916,27,943,1483,63.59%,26.43%,1
臺中市,太平區,1341,383,551,934,25,959,1694,56.61%,22.61%,1
臺中市,太平區,1342,421,530,951,29,980,1952,50.2%,21.57%,1
臺中市,太平區,1343,454,611,1065,31,1096,1995,54.94%,22.76%,1
臺中市,太平區,1344,333,414,747,17,764,1311,58.28%,25.4%,1
臺中市,太平區,1345,426,566,992,28,1020,1537,66.36%,27.72%,1
臺中市,太平區,1346,380,581,961,39,1000,1974,50.66%,19.25%,1
臺中市,太平區,1347,431,588,1019,35,1054,1828,57.66%,23.58%,1
臺中市,太平區,1348,450,609,1059,37,1096,2191,50.02%,20.54%,1
臺中市,太平區,1349,393,514,907,71,978,1825,53.59%,21.53%,1
臺中市,太平區,1350,340,446,786,21,807,1559,51.76%,21.81%,1
臺中市,太平區,1351,286,342,628,66,694,1225,56.65%,23.35%,1
臺中市,太平區,1352,339,564,903,38,941,1678,56.08%,20.2%,1
臺中市,太平區,1353,380,395,775,34,809,1501,53.9%,25.32%,1
臺中市,太平區,1354,457,443,900,52,952,1450,65.66%,31.52%,1
臺中市,太平區,1355,437,709,1146,66,1212,2126,57.01%,20.56%,1
臺中市,太平區,1356,177,244,421,30,451,699,64.52%,25.32%,1
臺中市,太平區,1357,352,347,699,34,733,1428,51.33%,24.65%,1
臺中市,太平區,1358,437,477,914,65,979,1666,58.76%,26.23%,1
臺中市,太平區,1359,321,374,695,34,729,1241,58.74%,25.87%,1
臺中市,太平區,1360,352,370,722,61,783,1266,61.85%,27.8%,1
臺中市,太平區,1361,300,337,637,35,672,1166,57.63%,25.73%,1
臺中市,太平區,1362,493,507,1000,58,1058,1790,59.11%,27.54%,1
臺中市,太平區,1363,327,442,769,43,812,1754,46.29%,18.64%,1
臺中市,大里區,1364,336,496,832,36,868,1614,53.78%,20.82%,1
臺中市,大里區,1365,313,484,797,39,836,1599,52.28%,19.57%,1
臺中市,大里區,1366,381,455,836,37,873,1715,50.9%,22.22%,1
臺中市,大里區,1367,346,365,711,36,747,1264,59.1%,27.37%,1
臺中市,大里區,1368,318,413,731,32,763,1416,53.88%,22.46%,1
臺中市,大里區,1369,292,344,636,24,660,1188,55.56%,24.58%,1
臺中市,大里區,1370,346,380,726,35,761,1359,56%,25.46%,1
臺中市,大里區,1371,380,416,796,54,850,1457,58.34%,26.08%,1
臺中市,大里區,1372,331,467,798,39,837,1403,59.66%,23.59%,1
臺中市,大里區,1373,441,478,919,47,966,1697,56.92%,25.99%,1
臺中市,大里區,1374,471,547,1018,73,1091,1811,60.24%,26.01%,1
臺中市,大里區,1375,400,544,944,44,988,1830,53.99%,21.86%,1
臺中市,大里區,1376,426,503,929,41,970,2228,43.54%,19.12%,1
臺中市,大里區,1377,471,611,1082,51,1133,1997,56.74%,23.59%,1
臺中市,大里區,1378,473,774,1247,43,1290,2033,63.45%,23.27%,1
臺中市,大里區,1379,502,564,1066,39,1105,1835,60.22%,27.36%,1
臺中市,大里區,1380,315,404,719,24,743,1268,58.6%,24.84%,1
臺中市,大里區,1381,369,556,925,36,961,1645,58.42%,22.43%,1
臺中市,大里區,1382,402,521,923,29,952,1561,60.99%,25.75%,1
臺中市,大里區,1383,332,496,828,20,848,1301,65.18%,25.52%,1
臺中市,大里區,1384,441,400,841,54,895,1621,55.21%,27.21%,1
臺中市,大里區,1385,426,506,932,54,986,1797,54.87%,23.71%,1
臺中市,大里區,1386,296,360,656,28,684,1230,55.61%,24.07%,1
臺中市,大里區,1387,329,450,779,39,818,1488,54.97%,22.11%,1
臺中市,大里區,1388,353,408,761,45,806,1459,55.24%,24.19%,1
臺中市,大里區,1389,434,463,897,43,940,1647,57.07%,26.35%,1
臺中市,大里區,1390,416,242,658,48,706,1100,64.18%,37.82%,1
臺中市,大里區,1391,323,454,777,29,806,1410,57.16%,22.91%,1
臺中市,大里區,1392,363,556,919,45,964,1807,53.35%,20.09%,1
臺中市,大里區,1393,332,402,734,32,766,1331,57.55%,24.94%,1
臺中市,大里區,1394,390,546,936,35,971,1801,53.91%,21.65%,1
臺中市,大里區,1395,364,565,929,42,971,1909,50.86%,19.07%,1
臺中市,大里區,1396,373,464,837,34,871,1699,51.27%,21.95%,1
臺中市,大里區,1397,384,500,884,47,931,1627,57.22%,23.6%,1
臺中市,大里區,1398,403,605,1008,39,1047,1912,54.76%,21.08%,1
臺中市,大里區,1399,397,484,881,66,947,1753,54.02%,22.65%,1
臺中市,大里區,1400,365,499,864,38,902,1602,56.3%,22.78%,1
臺中市,大里區,1401,294,343,637,44,681,1144,59.53%,25.7%,1
臺中市,大里區,1402,446,493,939,37,976,1655,58.97%,26.95%,1
臺中市,大里區,1403,342,436,778,38,816,1438,56.75%,23.78%,1
臺中市,大里區,1404,283,288,571,34,605,1000,60.5%,28.3%,1
臺中市,大里區,1405,402,529,931,39,970,1711,56.69%,23.5%,1
臺中市,大里區,1406,399,495,894,18,912,1698,53.71%,23.5%,1
臺中市,大里區,1407,472,550,1022,58,1080,1914,56.43%,24.66%,1
臺中市,大里區,1408,362,458,820,36,856,1465,58.43%,24.71%,1
臺中市,大里區,1409,385,461,846,64,910,1581,57.56%,24.35%,1
臺中市,大里區,1410,366,488,854,44,898,1509,59.51%,24.25%,1
臺中市,大里區,1411,358,470,828,23,851,1570,54.2%,22.8%,1
臺中市,大里區,1412,363,425,788,41,829,1425,58.18%,25.47%,1
臺中市,大里區,1413,366,402,768,53,821,1384,59.32%,26.45%,1
臺中市,大里區,1414,295,298,593,22,615,1204,51.08%,24.5%,1
臺中市,大里區,1415,404,469,873,33,906,1761,51.45%,22.94%,1
臺中市,大里區,1416,299,398,697,27,724,1473,49.15%,20.3%,1
臺中市,大里區,1417,421,478,899,49,948,1675,56.6%,25.13%,1
臺中市,大里區,1418,406,550,956,42,998,1755,56.87%,23.13%,1
臺中市,大里區,1419,419,471,890,67,957,1593,60.08%,26.3%,1
臺中市,大里區,1420,470,485,955,53,1008,1799,56.03%,26.13%,1
臺中市,大里區,1421,422,456,878,40,918,1606,57.16%,26.28%,1
臺中市,大里區,1422,459,555,1014,29,1043,1875,55.63%,24.48%,1
臺中市,大里區,1423,391,524,915,45,960,1670,57.49%,23.41%,1
臺中市,大里區,1424,453,558,1011,53,1064,1898,56.06%,23.87%,1
臺中市,大里區,1425,387,482,869,41,910,1679,54.2%,23.05%,1
臺中市,大里區,1426,322,398,720,39,759,1373,55.28%,23.45%,1
臺中市,大里區,1427,315,389,704,50,754,1299,58.04%,24.25%,1
臺中市,大里區,1428,337,452,789,30,819,1430,57.27%,23.57%,1
臺中市,大里區,1429,466,642,1108,29,1137,1805,62.99%,25.82%,1
臺中市,大里區,1430,469,685,1154,21,1175,1806,65.06%,25.97%,1
臺中市,大里區,1431,478,675,1153,42,1195,1826,65.44%,26.18%,1
臺中市,大里區,1432,432,714,1146,38,1184,1805,65.6%,23.93%,1
臺中市,大里區,1433,464,650,1114,38,1152,1907,60.41%,24.33%,1
臺中市,大里區,1434,261,417,678,18,696,1103,63.1%,23.66%,1
臺中市,大里區,1435,301,438,739,49,788,1419,55.53%,21.21%,1
臺中市,大里區,1436,297,471,768,47,815,1434,56.83%,20.71%,1
臺中市,大里區,1437,410,538,948,29,977,1875,52.11%,21.87%,1
臺中市,大里區,1438,468,528,996,37,1033,1862,55.48%,25.13%,1
臺中市,大里區,1439,414,569,983,27,1010,1850,54.59%,22.38%,1
臺中市,大里區,1440,392,506,898,39,937,1622,57.77%,24.17%,1
臺中市,大里區,1441,384,599,983,40,1023,1638,62.45%,23.44%,1
臺中市,大里區,1442,447,537,984,50,1034,1633,63.32%,27.37%,1
臺中市,大里區,1443,418,449,867,30,897,1662,53.97%,25.15%,1
臺中市,大里區,1444,456,646,1102,34,1136,1917,59.26%,23.79%,1
臺中市,大里區,1445,401,452,853,42,895,1701,52.62%,23.57%,1
臺中市,大里區,1446,368,419,787,46,833,1549,53.78%,23.76%,1
臺中市,大里區,1447,382,517,899,49,948,1567,60.5%,24.38%,1
臺中市,大里區,1448,396,481,877,55,932,1614,57.74%,24.54%,1
臺中市,大里區,1449,450,533,983,66,1049,1811,57.92%,24.85%,1
臺中市,大里區,1450,333,392,725,38,763,1336,57.11%,24.93%,1
臺中市,大里區,1451,422,511,933,48,981,1759,55.77%,23.99%,1
臺中市,大里區,1452,395,494,889,59,948,1783,53.17%,22.15%,1
臺中市,大里區,1453,373,457,830,52,882,1736,50.81%,21.49%,1
臺中市,大里區,1454,458,575,1033,42,1075,1874,57.36%,24.44%,1
臺中市,大里區,1455,531,535,1066,20,1086,1889,57.49%,28.11%,1
臺中市,大里區,1456,475,564,1039,55,1094,1947,56.19%,24.4%,1
臺中市,大里區,1457,464,629,1093,36,1129,1938,58.26%,23.94%,1
臺中市,大里區,1458,433,532,965,60,1025,1836,55.83%,23.58%,1
臺中市,大里區,1459,438,561,999,54,1053,1913,55.04%,22.9%,1
臺中市,大里區,1460,444,536,980,60,1040,1913,54.36%,23.21%,1
臺中市,大里區,1461,593,386,979,37,1016,1937,52.45%,30.61%,1
臺中市,大里區,1462,356,439,795,38,833,1508,55.24%,23.61%,1
臺中市,大里區,1463,345,439,784,24,808,1340,60.3%,25.75%,1
臺中市,大里區,1464,383,534,917,55,972,1656,58.7%,23.13%,1
臺中市,大里區,1465,289,412,701,35,736,1290,57.05%,22.4%,1
臺中市,大里區,1466,403,504,907,27,934,1655,56.44%,24.35%,1
臺中市,大里區,1467,279,350,629,15,644,1260,51.11%,22.14%,1
臺中市,大里區,1468,330,395,725,21,746,1247,59.82%,26.46%,1
臺中市,大里區,1469,367,468,835,33,868,1548,56.07%,23.71%,1
臺中市,和平區,1585,318,261,579,38,617,956,64.54%,33.26%,1
臺中市,和平區,1586,202,399,601,27,628,963,65.21%,20.98%,1
臺中市,和平區,1587,104,159,263,11,274,456,60.09%,22.81%,1
臺中市,和平區,1588,193,418,611,45,656,1011,64.89%,19.09%,1
臺中市,和平區,1589,133,239,372,12,384,636,60.38%,20.91%,1
臺中市,和平區,1590,58,114,172,10,182,270,67.41%,21.48%,1
臺中市,和平區,1591,75,265,340,17,357,460,77.61%,16.3%,1
臺中市,和平區,1592,75,151,226,17,243,321,75.7%,23.36%,1
臺中市,和平區,1593,197,294,491,26,517,783,66.03%,25.16%,1
臺中市,和平區,1594,62,152,214,17,231,336,68.75%,18.45%,1
臺中市,和平區,1595,121,196,317,9,326,451,72.28%,26.83%,1
臺中市,和平區,1596,82,114,196,11,207,366,56.56%,22.4%,1
臺中市,和平區,1597,130,201,331,11,342,771,44.36%,16.86%,1
臺中市,和平區,1598,100,189,289,29,318,574,55.4%,17.42%,1
臺中市,和平區,1599,54,106,160,11,171,274,62.41%,19.71%,1
臺中市,和平區,1600,29,56,85,6,91,157,57.96%,18.47%,1
臺中市,和平區,1601,127,284,411,16,427,713,59.89%,17.81%,1
臺南市,新營區,0116,327,449,776,29,805,1693,47.55%,19.31%,1
臺南市,新營區,0117,379,474,853,23,876,1561,56.12%,24.28%,1
臺南市,新營區,0118,349,445,794,21,815,1487,54.81%,23.47%,1
臺南市,新營區,0119,305,341,646,14,660,1232,53.57%,24.76%,1
臺南市,新營區,0120,256,287,543,16,559,1067,52.39%,23.99%,1
臺南市,新營區,0121,355,310,665,29,694,1419,48.91%,25.02%,1
臺南市,新營區,0122,385,410,795,28,823,1466,56.14%,26.26%,1
臺南市,新營區,0123,290,269,559,23,582,932,62.45%,31.12%,1
臺南市,新營區,0124,298,225,523,23,546,1099,49.68%,27.12%,1
臺南市,新營區,0125,195,174,369,18,387,757,51.12%,25.76%,1
臺南市,新營區,0126,243,243,486,20,506,888,56.98%,27.36%,1
臺南市,新營區,0127,274,292,566,11,577,1115,51.75%,24.57%,1
臺南市,新營區,0128,248,210,458,11,469,937,50.05%,26.47%,1
臺南市,新營區,0129,345,328,673,21,694,1387,50.04%,24.87%,1
臺南市,新營區,0130,340,388,728,34,762,1526,49.93%,22.28%,1
臺南市,新營區,0131,340,379,719,15,734,1301,56.42%,26.13%,1
臺南市,新營區,0132,376,465,841,32,873,1538,56.76%,24.45%,1
臺南市,新營區,0133,359,466,825,32,857,1584,54.1%,22.66%,1
臺南市,新營區,0134,350,528,878,21,899,1583,56.79%,22.11%,1
臺南市,新營區,0135,367,451,818,24,842,1530,55.03%,23.99%,1
臺南市,新營區,0136,341,355,696,27,723,1193,60.6%,28.58%,1
臺南市,新營區,0137,322,275,597,16,613,1439,42.6%,22.38%,1
臺南市,新營區,0138,351,433,784,34,818,1438,56.88%,24.41%,1
臺南市,新營區,0139,117,82,199,11,210,359,58.5%,32.59%,1
臺南市,新營區,0140,270,253,523,20,543,1233,44.04%,21.9%,1
臺南市,新營區,0141,247,289,536,16,552,1227,44.99%,20.13%,1
臺南市,新營區,0142,302,304,606,19,625,1320,47.35%,22.88%,1
臺南市,新營區,0143,432,397,829,15,844,1930,43.73%,22.38%,1
臺南市,新營區,0144,366,401,767,36,803,1501,53.5%,24.38%,1
臺南市,新營區,0145,312,390,702,21,723,1475,49.02%,21.15%,1
臺南市,新營區,0146,448,463,911,28,939,1753,53.57%,25.56%,1
臺南市,新營區,0147,418,431,849,29,878,1748,50.23%,23.91%,1
臺南市,新營區,0148,402,470,872,24,896,1741,51.46%,23.09%,1
臺南市,新營區,0149,359,338,697,16,713,1433,49.76%,25.05%,1
臺南市,新營區,0150,399,406,805,29,834,1595,52.29%,25.02%,1
臺南市,新營區,0151,228,223,451,15,466,959,48.59%,23.77%,1
臺南市,新營區,0152,434,414,848,51,899,1865,48.2%,23.27%,1
臺南市,新營區,0153,419,345,764,27,791,1678,47.14%,24.97%,1
臺南市,新營區,0154,344,272,616,26,642,1373,46.76%,25.05%,1
臺南市,新營區,0155,340,242,582,19,601,1431,42%,23.76%,1
臺南市,新營區,0156,82,38,120,2,122,291,41.92%,28.18%,1
臺南市,新營區,0157,400,372,772,25,797,1749,45.57%,22.87%,1
臺南市,新營區,0158,423,430,853,31,884,1862,47.48%,22.72%,1
臺南市,新營區,0159,439,488,927,63,990,1821,54.37%,24.11%,1
臺南市,新營區,0160,446,398,844,22,866,1845,46.94%,24.17%,1
臺南市,新營區,0161,134,84,218,8,226,542,41.7%,24.72%,1
臺南市,新營區,0162,78,66,144,6,150,402,37.31%,19.4%,1
臺南市,新營區,0163,204,176,380,31,411,703,58.46%,29.02%,1
臺南市,新營區,0164,233,191,424,21,445,941,47.29%,24.76%,1
臺南市,鹽水區,0085,289,230,519,48,567,1037,54.68%,27.87%,1
臺南市,鹽水區,0086,135,111,246,13,259,480,53.96%,28.13%,1
臺南市,鹽水區,0087,214,154,368,16,384,636,60.38%,33.65%,1
臺南市,鹽水區,0088,101,74,175,8,183,321,57.01%,31.46%,1
臺南市,鹽水區,0089,150,129,279,21,300,497,60.36%,30.18%,1
臺南市,鹽水區,0090,240,205,445,16,461,759,60.74%,31.62%,1
臺南市,鹽水區,0091,83,74,157,10,167,341,48.97%,24.34%,1
臺南市,鹽水區,0092,142,132,274,13,287,507,56.61%,28.01%,1
臺南市,鹽水區,0093,236,157,393,21,414,863,47.97%,27.35%,1
臺南市,鹽水區,0094,337,324,661,20,681,1373,49.6%,24.54%,1
臺南市,鹽水區,0095,389,342,731,30,761,1507,50.5%,25.81%,1
臺南市,鹽水區,0096,370,327,697,38,735,1374,53.49%,26.93%,1
臺南市,鹽水區,0097,320,264,584,23,607,1244,48.79%,25.72%,1
臺南市,鹽水區,0098,270,233,503,40,543,1022,53.13%,26.42%,1
臺南市,鹽水區,0099,258,103,361,30,391,921,42.45%,28.01%,1
臺南市,鹽水區,0100,275,161,436,27,463,847,54.66%,32.47%,1
臺南市,鹽水區,0101,179,125,304,10,314,736,42.66%,24.32%,1
臺南市,鹽水區,0102,246,146,392,8,400,761,52.56%,32.33%,1
臺南市,鹽水區,0103,74,62,136,7,143,285,50.18%,25.96%,1
臺南市,鹽水區,0104,125,89,214,16,230,493,46.65%,25.35%,1
臺南市,鹽水區,0105,161,95,256,11,267,621,43%,25.93%,1
臺南市,鹽水區,0106,104,54,158,7,165,392,42.09%,26.53%,1
臺南市,鹽水區,0107,270,179,449,20,469,925,50.7%,29.19%,1
臺南市,鹽水區,0108,200,122,322,14,336,728,46.15%,27.47%,1
臺南市,鹽水區,0109,57,26,83,6,89,214,41.59%,26.64%,1
臺南市,鹽水區,0110,101,78,179,7,186,387,48.06%,26.1%,1
臺南市,鹽水區,0111,82,67,149,8,157,301,52.16%,27.24%,1
臺南市,鹽水區,0112,208,106,314,12,326,755,43.18%,27.55%,1
臺南市,鹽水區,0113,96,54,150,14,164,365,44.93%,26.3%,1
臺南市,鹽水區,0114,244,187,431,27,458,935,48.98%,26.1%,1
臺南市,鹽水區,0115,128,96,224,16,240,494,48.58%,25.91%,1
臺南市,白河區,0030,340,262,602,43,645,1176,54.85%,28.91%,1
臺南市,白河區,0031,158,121,279,7,286,546,52.38%,28.94%,1
臺南市,白河區,0032,252,203,455,21,476,859,55.41%,29.34%,1
臺南市,白河區,0033,300,213,513,27,540,946,57.08%,31.71%,1
臺南市,白河區,0034,320,242,562,31,593,1116,53.14%,28.67%,1
臺南市,白河區,0035,321,236,557,25,582,1397,41.66%,22.98%,1
臺南市,白河區,0036,160,149,309,16,325,756,42.99%,21.16%,1
臺南市,白河區,0037,223,184,407,27,434,871,49.83%,25.6%,1
臺南市,白河區,0038,236,200,436,18,454,897,50.61%,26.31%,1
臺南市,白河區,0039,172,109,281,19,300,784,38.27%,21.94%,1
臺南市,白河區,0040,164,89,253,7,260,572,45.45%,28.67%,1
臺南市,白河區,0041,89,67,156,6,162,457,35.45%,19.47%,1
臺南市,白河區,0042,138,85,223,13,236,600,39.33%,23%,1
臺南市,白河區,0043,67,53,120,3,123,375,32.8%,17.87%,1
臺南市,白河區,0044,127,49,176,3,179,508,35.24%,25%,1
臺南市,白河區,0045,125,83,208,9,217,631,34.39%,19.81%,1
臺南市,白河區,0046,62,52,114,8,122,391,31.2%,15.86%,1
臺南市,白河區,0047,196,100,296,22,318,799,39.8%,24.53%,1
臺南市,白河區,0048,80,77,157,16,173,506,34.19%,15.81%,1
臺南市,白河區,0049,266,137,403,15,418,832,50.24%,31.97%,1
臺南市,白河區,0050,320,239,559,21,580,1179,49.19%,27.14%,1
臺南市,白河區,0051,178,111,289,13,302,744,40.59%,23.92%,1
臺南市,白河區,0052,156,114,270,13,283,699,40.49%,22.32%,1
臺南市,白河區,0053,183,73,256,12,268,633,42.34%,28.91%,1
臺南市,白河區,0054,272,162,434,30,464,859,54.02%,31.66%,1
臺南市,白河區,0055,193,172,365,34,399,884,45.14%,21.83%,1
臺南市,白河區,0056,113,85,198,8,206,740,27.84%,15.27%,1
臺南市,白河區,0057,310,245,555,33,588,1334,44.08%,23.24%,1
臺南市,白河區,0058,191,133,324,39,363,723,50.21%,26.42%,1
臺南市,白河區,0059,203,148,351,43,394,682,57.77%,29.77%,1
臺南市,白河區,0060,233,179,412,33,445,855,52.05%,27.25%,1
臺南市,白河區,0061,133,79,212,21,233,543,42.91%,24.49%,1
臺南市,柳營區,0165,303,235,538,42,580,1166,49.74%,25.99%,1
臺南市,柳營區,0166,209,134,343,10,353,625,56.48%,33.44%,1
臺南市,柳營區,0167,174,145,319,28,347,738,47.02%,23.58%,1
臺南市,柳營區,0168,254,214,468,16,484,834,58.03%,30.46%,1
臺南市,柳營區,0169,308,209,517,27,544,1104,49.28%,27.9%,1
臺南市,柳營區,0170,272,218,490,9,499,1015,49.16%,26.8%,1
臺南市,柳營區,0171,427,442,869,76,945,1720,54.94%,24.83%,1
臺南市,柳營區,0172,331,297,628,38,666,1391,47.88%,23.8%,1
臺南市,柳營區,0173,102,100,202,5,207,425,48.71%,24%,1
臺南市,柳營區,0174,72,60,132,12,144,318,45.28%,22.64%,1
臺南市,柳營區,0175,204,164,368,21,389,753,51.66%,27.09%,1
臺南市,柳營區,0176,162,153,315,34,349,730,47.81%,22.19%,1
臺南市,柳營區,0177,209,140,349,19,368,725,50.76%,28.83%,1
臺南市,柳營區,0178,236,167,403,26,429,787,54.51%,29.99%,1
臺南市,柳營區,0179,81,68,149,22,171,297,57.58%,27.27%,1
臺南市,柳營區,0180,196,151,347,31,378,673,56.17%,29.12%,1
臺南市,柳營區,0181,190,145,335,39,374,640,58.44%,29.69%,1
臺南市,柳營區,0182,192,105,297,12,309,660,46.82%,29.09%,1
臺南市,柳營區,0183,306,216,522,43,565,1212,46.62%,25.25%,1
臺南市,柳營區,0184,53,35,88,5,93,202,46.04%,26.24%,1
臺南市,柳營區,0185,269,204,473,49,522,1049,49.76%,25.64%,1
臺南市,柳營區,0186,45,37,82,1,83,158,52.53%,28.48%,1
臺南市,柳營區,0187,223,201,424,40,464,921,50.38%,24.21%,1
臺南市,柳營區,0188,127,108,235,12,247,504,49.01%,25.2%,1
臺南市,柳營區,0189,41,26,67,2,69,157,43.95%,26.11%,1
臺南市,後壁區,0001,246,154,400,29,429,743,57.74%,33.11%,1
臺南市,後壁區,0002,205,241,446,10,456,898,50.78%,22.83%,1
臺南市,後壁區,0003,212,153,365,28,393,786,50%,26.97%,1
臺南市,後壁區,0004,136,98,234,42,276,534,51.69%,25.47%,1
臺南市,後壁區,0005,273,226,499,37,536,1034,51.84%,26.4%,1
臺南市,後壁區,0006,77,23,100,8,108,232,46.55%,33.19%,1
臺南市,後壁區,0007,141,87,228,14,242,479,50.52%,29.44%,1
臺南市,後壁區,0008,233,157,390,30,420,837,50.18%,27.84%,1
臺南市,後壁區,0009,342,182,524,22,546,1085,50.32%,31.52%,1
臺南市,後壁區,0010,303,184,487,9,496,1157,42.87%,26.19%,1
臺南市,後壁區,0011,185,170,355,36,391,755,51.79%,24.5%,1
臺南市,後壁區,0012,123,118,241,23,264,458,57.64%,26.86%,1
臺南市,後壁區,0013,85,88,173,13,186,371,50.13%,22.91%,1
臺南市,後壁區,0014,182,121,303,34,337,676,49.85%,26.92%,1
臺南市,後壁區,0015,104,77,181,12,193,428,45.09%,24.3%,1
臺南市,後壁區,0016,170,71,241,12,253,547,46.25%,31.08%,1
臺南市,後壁區,0017,132,80,212,24,236,455,51.87%,29.01%,1
臺南市,後壁區,0018,234,161,395,44,439,984,44.61%,23.78%,1
臺南市,後壁區,0019,140,66,206,29,235,483,48.65%,28.99%,1
臺南市,後壁區,0020,110,105,215,16,231,536,43.1%,20.52%,1
臺南市,後壁區,0021,281,136,417,11,428,958,44.68%,29.33%,1
臺南市,後壁區,0022,141,101,242,13,255,441,57.82%,31.97%,1
臺南市,後壁區,0023,216,133,349,38,387,677,57.16%,31.91%,1
臺南市,後壁區,0024,281,217,498,44,542,996,54.42%,28.21%,1
臺南市,後壁區,0025,290,257,547,25,572,1255,45.58%,23.11%,1
臺南市,後壁區,0026,177,131,308,13,321,678,47.35%,26.11%,1
臺南市,後壁區,0027,138,104,242,8,250,553,45.21%,24.95%,1
臺南市,後壁區,0028,159,89,248,11,259,616,42.05%,25.81%,1
臺南市,後壁區,0029,314,255,569,31,600,1189,50.46%,26.41%,1
臺南市,東山區,0062,298,289,587,35,622,1401,44.4%,21.27%,1
臺南市,東山區,0063,280,223,503,32,535,1185,45.15%,23.63%,1
臺南市,東山區,0064,285,211,496,42,538,1303,41.29%,21.87%,1
臺南市,東山區,0065,167,117,284,16,300,732,40.98%,22.81%,1
臺南市,東山區,0066,157,111,268,23,291,721,40.36%,21.78%,1
臺南市,東山區,0067,215,173,388,24,412,1104,37.32%,19.47%,1
臺南市,東山區,0068,237,153,390,20,410,943,43.48%,25.13%,1
臺南市,東山區,0069,82,91,173,3,176,653,26.95%,12.56%,1
臺南市,東山區,0070,158,104,262,21,283,596,47.48%,26.51%,1
臺南市,東山區,0071,241,133,374,32,406,878,46.24%,27.45%,1
臺南市,東山區,0072,208,117,325,16,341,771,44.23%,26.98%,1
臺南市,東山區,0073,95,98,193,20,213,483,44.1%,19.67%,1
臺南市,東山區,0074,174,128,302,21,323,640,50.47%,27.19%,1
臺南市,東山區,0075,60,48,108,4,112,425,26.35%,14.12%,1
臺南市,東山區,0076,87,55,142,7,149,394,37.82%,22.08%,1
臺南市,東山區,0077,109,62,171,21,192,373,51.47%,29.22%,1
臺南市,東山區,0078,214,223,437,28,465,1257,36.99%,17.02%,1
臺南市,東山區,0079,107,118,225,10,235,887,26.49%,12.06%,1
臺南市,東山區,0080,124,69,193,11,204,658,31%,18.84%,1
臺南市,東山區,0081,183,143,326,26,352,1101,31.97%,16.62%,1
臺南市,東山區,0082,158,134,292,13,305,1057,28.86%,14.95%,1
臺南市,東山區,0083,131,156,287,17,304,639,47.57%,20.5%,1
臺南市,東山區,0084,53,54,107,11,118,270,43.7%,19.63%,1
臺南市,麻豆區,0381,373,239,612,21,633,1205,52.53%,30.95%,1
臺南市,麻豆區,0382,226,129,355,18,373,660,56.52%,34.24%,1
臺南市,麻豆區,0383,191,107,298,9,307,523,58.7%,36.52%,1
臺南市,麻豆區,0384,446,347,793,35,828,1597,51.85%,27.93%,1
臺南市,麻豆區,0385,385,294,679,30,709,1262,56.18%,30.51%,1
臺南市,麻豆區,0386,408,329,737,27,764,1325,57.66%,30.79%,1
臺南市,麻豆區,0387,421,272,693,28,721,1384,52.1%,30.42%,1
臺南市,麻豆區,0388,391,200,591,13,604,1121,53.88%,34.88%,1
臺南市,麻豆區,0389,297,203,500,11,511,1021,50.05%,29.09%,1
臺南市,麻豆區,0390,279,197,476,18,494,954,51.78%,29.25%,1
臺南市,麻豆區,0391,433,272,705,25,730,1513,48.25%,28.62%,1
臺南市,麻豆區,0392,469,308,777,30,807,1726,46.76%,27.17%,1
臺南市,麻豆區,0393,504,375,879,44,923,1804,51.16%,27.94%,1
臺南市,麻豆區,0394,365,178,543,21,564,1106,50.99%,33%,1
臺南市,麻豆區,0395,473,333,806,22,828,1503,55.09%,31.47%,1
臺南市,麻豆區,0396,395,249,644,31,675,1302,51.84%,30.34%,1
臺南市,麻豆區,0397,191,144,335,10,345,645,53.49%,29.61%,1
臺南市,麻豆區,0398,272,146,418,24,442,777,56.89%,35.01%,1
臺南市,麻豆區,0399,420,316,736,57,793,1612,49.19%,26.05%,1
臺南市,麻豆區,0400,195,138,333,5,338,718,47.08%,27.16%,1
臺南市,麻豆區,0401,470,276,746,27,773,1656,46.68%,28.38%,1
臺南市,麻豆區,0402,392,243,635,40,675,1355,49.82%,28.93%,1
臺南市,麻豆區,0403,283,140,423,10,433,977,44.32%,28.97%,1
臺南市,麻豆區,0404,304,176,480,21,501,1012,49.51%,30.04%,1
臺南市,麻豆區,0405,234,120,354,15,369,626,58.95%,37.38%,1
臺南市,麻豆區,0406,121,59,180,3,183,467,39.19%,25.91%,1
臺南市,麻豆區,0407,365,238,603,18,621,1260,49.29%,28.97%,1
臺南市,麻豆區,0408,369,214,583,29,612,1111,55.09%,33.21%,1
臺南市,麻豆區,0409,210,103,313,19,332,550,60.36%,38.18%,1
臺南市,麻豆區,0410,291,121,412,21,433,798,54.26%,36.47%,1
臺南市,麻豆區,0411,295,177,472,43,515,852,60.45%,34.62%,1
臺南市,麻豆區,0412,295,138,433,5,438,830,52.77%,35.54%,1
臺南市,麻豆區,0413,247,182,429,17,446,941,47.4%,26.25%,1
臺南市,麻豆區,0414,414,201,615,28,643,1158,55.53%,35.75%,1
臺南市,麻豆區,0415,161,120,281,9,290,612,47.39%,26.31%,1
臺南市,下營區,0343,443,223,666,32,698,1558,44.8%,28.43%,1
臺南市,下營區,0344,258,205,463,23,486,1112,43.71%,23.2%,1
臺南市,下營區,0345,251,155,406,26,432,893,48.38%,28.11%,1
臺南市,下營區,0346,367,322,689,34,723,1623,44.55%,22.61%,1
臺南市,下營區,0347,396,335,731,50,781,1568,49.81%,25.26%,1
臺南市,下營區,0348,247,228,475,36,511,985,51.88%,25.08%,1
臺南市,下營區,0349,238,198,436,14,450,953,47.22%,24.97%,1
臺南市,下營區,0350,273,212,485,25,510,1031,49.47%,26.48%,1
臺南市,下營區,0351,300,263,563,48,611,1077,56.73%,27.86%,1
臺南市,下營區,0352,177,117,294,21,315,703,44.81%,25.18%,1
臺南市,下營區,0353,201,165,366,14,380,854,44.5%,23.54%,1
臺南市,下營區,0354,386,201,587,32,619,1164,53.18%,33.16%,1
臺南市,下營區,0355,298,187,485,19,504,1091,46.2%,27.31%,1
臺南市,下營區,0356,263,203,466,31,497,959,51.82%,27.42%,1
臺南市,下營區,0357,262,186,448,22,470,935,50.27%,28.02%,1
臺南市,下營區,0358,301,167,468,23,491,893,54.98%,33.71%,1
臺南市,下營區,0359,399,225,624,52,676,1293,52.28%,30.86%,1
臺南市,下營區,0360,382,202,584,53,637,1185,53.76%,32.24%,1
臺南市,下營區,0361,290,170,460,21,481,1070,44.95%,27.1%,1
臺南市,六甲區,0362,248,192,440,32,472,819,57.63%,30.28%,1
臺南市,六甲區,0363,198,144,342,11,353,645,54.73%,30.7%,1
臺南市,六甲區,0364,398,261,659,29,688,1444,47.65%,27.56%,1
臺南市,六甲區,0365,393,289,682,26,708,1554,45.56%,25.29%,1
臺南市,六甲區,0366,287,216,503,33,536,1171,45.77%,24.51%,1
臺南市,六甲區,0367,360,268,628,32,660,1351,48.85%,26.65%,1
臺南市,六甲區,0368,252,188,440,41,481,1010,47.62%,24.95%,1
臺南市,六甲區,0369,244,164,408,40,448,919,48.75%,26.55%,1
臺南市,六甲區,0370,390,259,649,39,688,1369,50.26%,28.49%,1
臺南市,六甲區,0371,281,197,478,40,518,976,53.07%,28.79%,1
臺南市,六甲區,0372,313,217,530,32,562,1015,55.37%,30.84%,1
臺南市,六甲區,0373,308,227,535,20,555,1176,47.19%,26.19%,1
臺南市,六甲區,0374,266,203,469,23,492,939,52.4%,28.33%,1
臺南市,六甲區,0375,210,140,350,31,381,712,53.51%,29.49%,1
臺南市,六甲區,0376,225,213,438,25,463,881,52.55%,25.54%,1
臺南市,六甲區,0377,337,328,665,30,695,1184,58.7%,28.46%,1
臺南市,六甲區,0378,195,163,358,20,378,599,63.11%,32.55%,1
臺南市,六甲區,0379,144,115,259,7,266,759,35.05%,18.97%,1
臺南市,六甲區,0380,133,102,235,17,252,621,40.58%,21.42%,1
臺南市,官田區,0416,271,238,509,8,517,1104,46.83%,24.55%,1
臺南市,官田區,0417,265,183,448,26,474,965,49.12%,27.46%,1
臺南市,官田區,0418,426,276,702,29,731,1402,52.14%,30.39%,1
臺南市,官田區,0419,533,313,846,67,913,1653,55.23%,32.24%,1
臺南市,官田區,0420,302,146,448,28,476,966,49.28%,31.26%,1
臺南市,官田區,0421,72,49,121,7,128,284,45.07%,25.35%,1
臺南市,官田區,0422,89,46,135,4,139,402,34.58%,22.14%,1
臺南市,官田區,0423,275,217,492,7,499,982,50.81%,28%,1
臺南市,官田區,0424,238,186,424,22,446,975,45.74%,24.41%,1
臺南市,官田區,0425,194,179,373,26,399,802,49.75%,24.19%,1
臺南市,官田區,0426,327,256,583,27,610,1118,54.56%,29.25%,1
臺南市,官田區,0427,366,344,710,24,734,1455,50.45%,25.15%,1
臺南市,官田區,0428,353,243,596,25,621,1208,51.41%,29.22%,1
臺南市,官田區,0429,451,189,640,48,688,1293,53.21%,34.88%,1
臺南市,官田區,0430,221,65,286,14,300,607,49.42%,36.41%,1
臺南市,官田區,0431,127,102,229,19,248,501,49.5%,25.35%,1
臺南市,官田區,0432,221,148,369,37,406,728,55.77%,30.36%,1
臺南市,官田區,0433,248,166,414,22,436,842,51.78%,29.45%,1
臺南市,官田區,0434,151,105,256,24,280,515,54.37%,29.32%,1
臺南市,官田區,0435,245,163,408,20,428,873,49.03%,28.06%,1
臺南市,大內區,0436,173,131,304,25,329,759,43.35%,22.79%,1
臺南市,大內區,0437,35,55,90,0,90,262,34.35%,13.36%,1
臺南市,大內區,0438,176,89,265,8,273,646,42.26%,27.24%,1
臺南市,大內區,0439,340,238,578,32,610,1473,41.41%,23.08%,1
臺南市,大內區,0440,258,211,469,35,504,915,55.08%,28.2%,1
臺南市,大內區,0441,246,179,425,32,457,779,58.66%,31.58%,1
臺南市,大內區,0442,241,140,381,15,396,637,62.17%,37.83%,1
臺南市,大內區,0443,276,185,461,35,496,993,49.95%,27.79%,1
臺南市,大內區,0444,173,219,392,20,412,766,53.79%,22.58%,1
臺南市,大內區,0445,236,183,419,33,452,841,53.75%,28.06%,1
臺南市,大內區,0446,163,107,270,24,294,583,50.43%,27.96%,1
臺南市,佳里區,0282,440,305,745,34,779,1391,56%,31.63%,1
臺南市,佳里區,0283,270,218,488,15,503,829,60.68%,32.57%,1
臺南市,佳里區,0284,366,292,658,14,672,1401,47.97%,26.12%,1
臺南市,佳里區,0285,329,315,644,17,661,1452,45.52%,22.66%,1
臺南市,佳里區,0286,378,298,676,48,724,1382,52.39%,27.35%,1
臺南市,佳里區,0287,399,354,753,38,791,1463,54.07%,27.27%,1
臺南市,佳里區,0288,361,266,627,22,649,1280,50.7%,28.2%,1
臺南市,佳里區,0289,434,328,762,41,803,1486,54.04%,29.21%,1
臺南市,佳里區,0290,412,316,728,43,771,1378,55.95%,29.9%,1
臺南市,佳里區,0291,409,399,808,35,843,1505,56.01%,27.18%,1
臺南市,佳里區,0292,511,430,941,33,974,1860,52.37%,27.47%,1
臺南市,佳里區,0293,296,297,593,40,633,1134,55.82%,26.1%,1
臺南市,佳里區,0294,408,342,750,22,772,1426,54.14%,28.61%,1
臺南市,佳里區,0295,459,440,899,44,943,1779,53.01%,25.8%,1
臺南市,佳里區,0296,470,549,1019,31,1050,1906,55.09%,24.66%,1
臺南市,佳里區,0297,383,330,713,35,748,1425,52.49%,26.88%,1
臺南市,佳里區,0298,348,286,634,28,662,1255,52.75%,27.73%,1
臺南市,佳里區,0299,352,368,720,41,761,1524,49.93%,23.1%,1
臺南市,佳里區,0300,417,390,807,26,833,1631,51.07%,25.57%,1
臺南市,佳里區,0301,432,405,837,38,875,1546,56.6%,27.94%,1
臺南市,佳里區,0302,365,314,679,30,709,1187,59.73%,30.75%,1
臺南市,佳里區,0303,381,342,723,20,743,1381,53.8%,27.59%,1
臺南市,佳里區,0304,376,304,680,19,699,1364,51.25%,27.57%,1
臺南市,佳里區,0305,356,347,703,11,714,1314,54.34%,27.09%,1
臺南市,佳里區,0306,357,269,626,33,659,1164,56.62%,30.67%,1
臺南市,佳里區,0307,283,210,493,27,520,961,54.11%,29.45%,1
臺南市,佳里區,0308,373,255,628,33,661,1218,54.27%,30.62%,1
臺南市,佳里區,0309,297,223,520,14,534,919,58.11%,32.32%,1
臺南市,佳里區,0310,200,147,347,32,379,689,55.01%,29.03%,1
臺南市,佳里區,0311,106,79,185,7,192,383,50.13%,27.68%,1
臺南市,佳里區,0312,336,343,679,44,723,1507,47.98%,22.3%,1
臺南市,佳里區,0313,193,141,334,15,349,702,49.72%,27.49%,1
臺南市,佳里區,0314,282,206,488,20,508,907,56.01%,31.09%,1
臺南市,佳里區,0315,288,248,536,25,561,937,59.87%,30.74%,1
臺南市,佳里區,0316,329,211,540,23,563,1030,54.66%,31.94%,1
臺南市,佳里區,0317,318,187,505,21,526,981,53.62%,32.42%,1
臺南市,佳里區,0318,245,144,389,13,402,787,51.08%,31.13%,1
臺南市,佳里區,0319,434,306,740,52,792,1513,52.35%,28.68%,1
臺南市,佳里區,0320,183,121,304,15,319,714,44.68%,25.63%,1
臺南市,佳里區,0321,212,138,350,27,377,745,50.6%,28.46%,1
臺南市,佳里區,0322,289,152,441,21,462,951,48.58%,30.39%,1
臺南市,學甲區,0208,246,210,456,37,493,862,57.19%,28.54%,1
臺南市,學甲區,0209,195,145,340,12,352,611,57.61%,31.91%,1
臺南市,學甲區,0210,262,203,465,22,487,936,52.03%,27.99%,1
臺南市,學甲區,0211,405,102,507,29,536,1066,50.28%,37.99%,1
臺南市,學甲區,0212,269,199,468,17,485,869,55.81%,30.96%,1
臺南市,學甲區,0213,174,144,318,16,334,635,52.6%,27.4%,1
臺南市,學甲區,0214,208,171,379,12,391,822,47.57%,25.3%,1
臺南市,學甲區,0215,102,81,183,14,197,443,44.47%,23.02%,1
臺南市,學甲區,0216,390,292,682,30,712,1370,51.97%,28.47%,1
臺南市,學甲區,0217,314,270,584,33,617,1117,55.24%,28.11%,1
臺南市,學甲區,0218,340,303,643,48,691,1365,50.62%,24.91%,1
臺南市,學甲區,0219,360,307,667,53,720,1489,48.35%,24.18%,1
臺南市,學甲區,0220,171,85,256,20,276,627,44.02%,27.27%,1
臺南市,學甲區,0221,318,198,516,15,531,1052,50.48%,30.23%,1
臺南市,學甲區,0222,272,294,566,19,585,1183,49.45%,22.99%,1
臺南市,學甲區,0223,239,177,416,20,436,979,44.54%,24.41%,1
臺南市,學甲區,0224,321,221,542,27,569,1241,45.85%,25.87%,1
臺南市,學甲區,0225,202,139,341,14,355,843,42.11%,23.96%,1
臺南市,學甲區,0226,147,111,258,25,283,580,48.79%,25.34%,1
臺南市,學甲區,0227,211,114,325,15,340,832,40.87%,25.36%,1
臺南市,學甲區,0228,103,53,156,7,163,406,40.15%,25.37%,1
臺南市,學甲區,0229,244,161,405,25,430,818,52.57%,29.83%,1
臺南市,學甲區,0230,293,135,428,15,443,1052,42.11%,27.85%,1
臺南市,學甲區,0231,161,95,256,10,266,578,46.02%,27.85%,1
臺南市,學甲區,0232,100,77,177,13,190,430,44.19%,23.26%,1
臺南市,學甲區,0233,89,78,167,7,174,361,48.2%,24.65%,1
臺南市,西港區,0323,240,212,452,20,472,933,50.59%,25.72%,1
臺南市,西港區,0324,273,197,470,19,489,901,54.27%,30.3%,1
臺南市,西港區,0325,342,285,627,28,655,1314,49.85%,26.03%,1
臺南市,西港區,0326,348,307,655,46,701,1349,51.96%,25.8%,1
臺南市,西港區,0327,306,235,541,36,577,1014,56.9%,30.18%,1
臺南市,西港區,0328,396,354,750,24,774,1900,40.74%,20.84%,1
臺南市,西港區,0329,449,323,772,36,808,1663,48.59%,27%,1
臺南市,西港區,0330,241,123,364,11,375,738,50.81%,32.66%,1
臺南市,西港區,0331,313,304,617,47,664,1211,54.83%,25.85%,1
臺南市,西港區,0332,113,61,174,20,194,382,50.79%,29.58%,1
臺南市,西港區,0333,212,142,354,21,375,786,47.71%,26.97%,1
臺南市,西港區,0334,212,181,393,22,415,838,49.52%,25.3%,1
臺南市,西港區,0335,401,232,633,29,662,1449,45.69%,27.67%,1
臺南市,西港區,0336,365,270,635,25,660,1479,44.62%,24.68%,1
臺南市,西港區,0337,239,156,395,38,433,763,56.75%,31.32%,1
臺南市,西港區,0338,358,254,612,18,630,1297,48.57%,27.6%,1
臺南市,西港區,0339,387,277,664,21,685,1393,49.17%,27.78%,1
臺南市,西港區,0340,207,165,372,25,397,958,41.44%,21.61%,1
臺南市,西港區,0341,128,90,218,7,225,391,57.54%,32.74%,1
臺南市,西港區,0342,207,193,400,30,430,805,53.42%,25.71%,1
臺南市,七股區,0258,160,101,261,10,271,534,50.75%,29.96%,1
臺南市,七股區,0259,185,102,287,8,295,508,58.07%,36.42%,1
臺南市,七股區,0260,177,96,273,4,277,665,41.65%,26.62%,1
臺南市,七股區,0261,217,141,358,20,378,834,45.32%,26.02%,1
臺南市,七股區,0262,221,132,353,13,366,810,45.19%,27.28%,1
臺南市,七股區,0263,138,59,197,11,208,480,43.33%,28.75%,1
臺南市,七股區,0264,155,65,220,12,232,445,52.13%,34.83%,1
臺南市,七股區,0265,176,83,259,7,266,680,39.12%,25.88%,1
臺南市,七股區,0266,229,130,359,16,375,838,44.75%,27.33%,1
臺南市,七股區,0267,207,109,316,17,333,780,42.69%,26.54%,1
臺南市,七股區,0268,105,82,187,10,197,350,56.29%,30%,1
臺南市,七股區,0269,290,210,500,36,536,907,59.1%,31.97%,1
臺南市,七股區,0270,192,171,363,15,378,780,48.46%,24.62%,1
臺南市,七股區,0271,388,336,724,27,751,1658,45.3%,23.4%,1
臺南市,七股區,0272,242,170,412,21,433,913,47.43%,26.51%,1
臺南市,七股區,0273,315,265,580,34,614,1202,51.08%,26.21%,1
臺南市,七股區,0274,161,108,269,7,276,696,39.66%,23.13%,1
臺南市,七股區,0275,188,128,316,24,340,647,52.55%,29.06%,1
臺南市,七股區,0276,217,146,363,36,399,622,64.15%,34.89%,1
臺南市,七股區,0277,346,288,634,46,680,1175,57.87%,29.45%,1
臺南市,七股區,0278,194,127,321,12,333,698,47.71%,27.79%,1
臺南市,七股區,0279,272,205,477,42,519,983,52.8%,27.67%,1
臺南市,七股區,0280,293,250,543,26,569,1366,41.65%,21.45%,1
臺南市,七股區,0281,330,244,574,47,621,1379,45.03%,23.93%,1
臺南市,將軍區,0234,358,244,602,37,639,1110,57.57%,32.25%,1
臺南市,將軍區,0235,398,305,703,24,727,1418,51.27%,28.07%,1
臺南市,將軍區,0236,262,208,470,16,486,969,50.15%,27.04%,1
臺南市,將軍區,0237,164,122,286,29,315,519,60.69%,31.6%,1
臺南市,將軍區,0238,248,277,525,23,548,1106,49.55%,22.42%,1
臺南市,將軍區,0239,155,102,257,16,273,542,50.37%,28.6%,1
臺南市,將軍區,0240,65,60,125,5,130,315,41.27%,20.63%,1
臺南市,將軍區,0241,138,105,243,16,259,584,44.35%,23.63%,1
臺南市,將軍區,0242,115,79,194,5,199,398,50%,28.89%,1
臺南市,將軍區,0243,167,98,265,10,275,608,45.23%,27.47%,1
臺南市,將軍區,0244,118,108,226,10,236,442,53.39%,26.7%,1
臺南市,將軍區,0245,192,85,277,10,287,650,44.15%,29.54%,1
臺南市,將軍區,0246,153,71,224,9,233,573,40.66%,26.7%,1
臺南市,將軍區,0247,158,109,267,10,277,617,44.89%,25.61%,1
臺南市,將軍區,0248,182,100,282,15,297,573,51.83%,31.76%,1
臺南市,將軍區,0249,120,90,210,14,224,434,51.61%,27.65%,1
臺南市,將軍區,0250,242,121,363,15,378,849,44.52%,28.5%,1
臺南市,將軍區,0251,129,118,247,23,270,645,41.86%,20%,1
臺南市,將軍區,0252,184,99,283,15,298,690,43.19%,26.67%,1
臺南市,將軍區,0253,135,88,223,11,234,663,35.29%,20.36%,1
臺南市,將軍區,0254,318,203,521,18,539,1175,45.87%,27.06%,1
臺南市,將軍區,0255,237,109,346,12,358,837,42.77%,28.32%,1
臺南市,將軍區,0256,331,182,513,44,557,1061,52.5%,31.2%,1
臺南市,將軍區,0257,282,135,417,11,428,976,43.85%,28.89%,1
臺南市,北門區,0190,129,97,226,9,235,484,48.55%,26.65%,1
臺南市,北門區,0191,73,90,163,7,170,401,42.39%,18.2%,1
臺南市,北門區,0192,74,100,174,5,179,456,39.25%,16.23%,1
臺南市,北門區,0193,132,69,201,15,216,382,56.54%,34.55%,1
臺南市,北門區,0194,113,64,177,14,191,356,53.65%,31.74%,1
臺南市,北門區,0195,117,58,175,4,179,389,46.02%,30.08%,1
臺南市,北門區,0196,174,145,319,3,322,742,43.4%,23.45%,1
臺南市,北門區,0197,126,124,250,14,264,599,44.07%,21.04%,1
臺南市,北門區,0198,115,126,241,10,251,594,42.26%,19.36%,1
臺南市,北門區,0199,120,116,236,17,253,572,44.23%,20.98%,1
臺南市,北門區,0200,73,40,113,2,115,318,36.16%,22.96%,1
臺南市,北門區,0201,96,80,176,7,183,473,38.69%,20.3%,1
臺南市,北門區,0202,212,117,329,15,344,954,36.06%,22.22%,1
臺南市,北門區,0203,185,189,374,25,399,737,54.14%,25.1%,1
臺南市,北門區,0204,138,112,250,8,258,679,38%,20.32%,1
臺南市,北門區,0205,120,79,199,19,218,521,41.84%,23.03%,1
臺南市,北門區,0206,164,93,257,7,264,632,41.77%,25.95%,1
臺南市,北門區,0207,143,104,247,7,254,636,39.94%,22.48%,1
臺南市,新化區,0581,197,233,430,24,454,746,60.86%,26.41%,1
臺南市,新化區,0582,332,290,622,33,655,1102,59.44%,30.13%,1
臺南市,新化區,0583,110,94,204,18,222,370,60%,29.73%,1
臺南市,新化區,0584,255,261,516,51,567,947,59.87%,26.93%,1
臺南市,新化區,0585,282,288,570,41,611,1154,52.95%,24.44%,1
臺南市,新化區,0586,301,250,551,56,607,1082,56.1%,27.82%,1
臺南市,新化區,0587,276,298,574,37,611,1075,56.84%,25.67%,1
臺南市,新化區,0588,184,146,330,10,340,640,53.13%,28.75%,1
臺南市,新化區,0589,111,96,207,14,221,410,53.9%,27.07%,1
臺南市,新化區,0590,119,135,254,28,282,533,52.91%,22.33%,1
臺南市,新化區,0591,234,228,462,17,479,836,57.3%,27.99%,1
臺南市,新化區,0592,194,216,410,15,425,978,43.46%,19.84%,1
臺南市,新化區,0593,438,290,728,27,755,1348,56.01%,32.49%,1
臺南市,新化區,0594,230,278,508,32,540,1015,53.2%,22.66%,1
臺南市,新化區,0595,293,270,563,34,597,1228,48.62%,23.86%,1
臺南市,新化區,0596,242,195,437,20,457,789,57.92%,30.67%,1
臺南市,新化區,0597,259,260,519,29,548,1022,53.62%,25.34%,1
臺南市,新化區,0598,254,267,521,16,537,1021,52.6%,24.88%,1
臺南市,新化區,0599,334,335,669,46,715,1229,58.18%,27.18%,1
臺南市,新化區,0600,280,303,583,21,604,1153,52.39%,24.28%,1
臺南市,新化區,0601,267,181,448,16,464,1012,45.85%,26.38%,1
臺南市,新化區,0602,397,371,768,43,811,1458,55.62%,27.23%,1
臺南市,新化區,0603,414,456,870,55,925,1645,56.23%,25.17%,1
臺南市,新化區,0604,285,275,560,33,593,1016,58.37%,28.05%,1
臺南市,新化區,0605,154,134,288,9,297,559,53.13%,27.55%,1
臺南市,新化區,0606,320,339,659,22,681,1222,55.73%,26.19%,1
臺南市,新化區,0607,397,387,784,37,821,1562,52.56%,25.42%,1
臺南市,新化區,0608,252,204,456,22,478,994,48.09%,25.35%,1
臺南市,新化區,0609,277,237,514,50,564,1013,55.68%,27.34%,1
臺南市,新化區,0610,345,288,633,48,681,1197,56.89%,28.82%,1
臺南市,新化區,0611,257,213,470,51,521,1021,51.03%,25.17%,1
臺南市,新化區,0612,328,280,608,47,655,1428,45.87%,22.97%,1
臺南市,新化區,0613,127,81,208,13,221,456,48.46%,27.85%,1
臺南市,新化區,0614,276,271,547,43,590,1037,56.89%,26.62%,1
臺南市,新化區,0615,293,276,569,47,616,1097,56.15%,26.71%,1
臺南市,新化區,0616,236,226,462,40,502,902,55.65%,26.16%,1
臺南市,新化區,0617,296,179,475,45,520,999,52.05%,29.63%,1
臺南市,善化區,0492,252,249,501,32,533,1132,47.08%,22.26%,1
臺南市,善化區,0493,398,467,865,88,953,1845,51.65%,21.57%,1
臺南市,善化區,0494,491,515,1006,49,1055,2090,50.48%,23.49%,1
臺南市,善化區,0495,430,397,827,53,880,1582,55.63%,27.18%,1
臺南市,善化區,0496,541,477,1018,41,1059,1901,55.71%,28.46%,1
臺南市,善化區,0497,493,421,914,55,969,1818,53.3%,27.12%,1
臺南市,善化區,0498,417,397,814,43,857,1639,52.29%,25.44%,1
臺南市,善化區,0499,304,264,568,25,593,1061,55.89%,28.65%,1
臺南市,善化區,0500,510,438,948,60,1008,1786,56.44%,28.56%,1
臺南市,善化區,0501,332,284,616,29,645,1147,56.23%,28.95%,1
臺南市,善化區,0502,390,352,742,50,792,1581,50.09%,24.67%,1
臺南市,善化區,0503,393,212,605,64,669,1240,53.95%,31.69%,1
臺南市,善化區,0504,427,294,721,27,748,1743,42.91%,24.5%,1
臺南市,善化區,0505,366,301,667,52,719,1246,57.7%,29.37%,1
臺南市,善化區,0506,251,211,462,30,492,961,51.2%,26.12%,1
臺南市,善化區,0507,240,201,441,11,452,938,48.19%,25.59%,1
臺南市,善化區,0508,243,147,390,12,402,722,55.68%,33.66%,1
臺南市,善化區,0509,315,207,522,11,533,1062,50.19%,29.66%,1
臺南市,善化區,0510,480,342,822,66,888,1715,51.78%,27.99%,1
臺南市,善化區,0511,312,203,515,39,554,1120,49.46%,27.86%,1
臺南市,善化區,0512,231,167,398,38,436,865,50.4%,26.71%,1
臺南市,善化區,0513,455,327,782,45,827,1574,52.54%,28.91%,1
臺南市,善化區,0514,376,289,665,39,704,1535,45.86%,24.5%,1
臺南市,善化區,0515,328,208,536,55,591,1106,53.44%,29.66%,1
臺南市,善化區,0516,380,289,669,41,710,1402,50.64%,27.1%,1
臺南市,善化區,0517,393,412,805,71,876,1458,60.08%,26.95%,1
臺南市,善化區,0518,320,303,623,20,643,1380,46.59%,23.19%,1
臺南市,善化區,0519,330,302,632,11,643,1232,52.19%,26.79%,1
臺南市,善化區,0520,317,253,570,13,583,1069,54.54%,29.65%,1
臺南市,新市區,0545,249,216,465,17,482,960,50.21%,25.94%,1
臺南市,新市區,0546,346,292,638,20,658,1118,58.86%,30.95%,1
臺南市,新市區,0547,198,206,404,16,420,850,49.41%,23.29%,1
臺南市,新市區,0548,323,304,627,38,665,1241,53.59%,26.03%,1
臺南市,新市區,0549,379,308,687,25,712,1297,54.9%,29.22%,1
臺南市,新市區,0550,233,291,524,22,546,962,56.76%,24.22%,1
臺南市,新市區,0551,333,335,668,35,703,1237,56.83%,26.92%,1
臺南市,新市區,0552,372,306,678,39,717,1326,54.07%,28.05%,1
臺南市,新市區,0553,578,85,663,35,698,1211,57.64%,47.73%,1
臺南市,新市區,0554,386,263,649,23,672,1305,51.49%,29.58%,1
臺南市,新市區,0555,180,171,351,27,378,688,54.94%,26.16%,1
臺南市,新市區,0556,261,232,493,25,518,911,56.86%,28.65%,1
臺南市,新市區,0557,410,313,723,26,749,1525,49.11%,26.89%,1
臺南市,新市區,0558,218,234,452,5,457,1091,41.89%,19.98%,1
臺南市,新市區,0559,301,253,554,17,571,1122,50.89%,26.83%,1
臺南市,新市區,0560,260,252,512,20,532,1049,50.71%,24.79%,1
臺南市,新市區,0561,433,294,727,19,746,1564,47.7%,27.69%,1
臺南市,新市區,0562,404,379,783,36,819,1515,54.06%,26.67%,1
臺南市,新市區,0563,388,343,731,20,751,1378,54.5%,28.16%,1
臺南市,新市區,0564,267,206,473,42,515,827,62.27%,32.29%,1
臺南市,新市區,0565,325,241,566,47,613,960,63.85%,33.85%,1
臺南市,新市區,0566,240,219,459,42,501,951,52.68%,25.24%,1
臺南市,新市區,0567,359,295,654,42,696,1264,55.06%,28.4%,1
臺南市,新市區,0568,343,264,607,22,629,1173,53.62%,29.24%,1
臺南市,新市區,0569,199,177,376,21,397,684,58.04%,29.09%,1
臺南市,新市區,0570,326,272,598,50,648,1055,61.42%,30.9%,1
臺南市,新市區,0571,359,312,671,26,697,1122,62.12%,32%,1
臺南市,安定區,0521,401,333,734,50,784,1251,62.67%,32.05%,1
臺南市,安定區,0522,278,191,469,35,504,899,56.06%,30.92%,1
臺南市,安定區,0523,320,252,572,36,608,1106,54.97%,28.93%,1
臺南市,安定區,0524,259,235,494,42,536,948,56.54%,27.32%,1
臺南市,安定區,0525,347,313,660,47,707,1442,49.03%,24.06%,1
臺南市,安定區,0526,374,291,665,38,703,1385,50.76%,27%,1
臺南市,安定區,0527,204,225,429,32,461,801,57.55%,25.47%,1
臺南市,安定區,0528,204,131,335,18,353,736,47.96%,27.72%,1
臺南市,安定區,0529,191,181,372,36,408,781,52.24%,24.46%,1
臺南市,安定區,0530,232,179,411,27,438,795,55.09%,29.18%,1
臺南市,安定區,0531,268,201,469,43,512,862,59.4%,31.09%,1
臺南市,安定區,0532,376,343,719,20,739,1487,49.7%,25.29%,1
臺南市,安定區,0533,361,339,700,25,725,1385,52.35%,26.06%,1
臺南市,安定區,0534,415,291,706,33,739,1518,48.68%,27.34%,1
臺南市,安定區,0535,309,293,602,41,643,1094,58.78%,28.24%,1
臺南市,安定區,0536,460,331,791,87,878,1590,55.22%,28.93%,1
臺南市,安定區,0537,196,201,397,34,431,754,57.16%,25.99%,1
臺南市,安定區,0538,197,184,381,33,414,716,57.82%,27.51%,1
臺南市,安定區,0539,419,348,767,46,813,1492,54.49%,28.08%,1
臺南市,安定區,0540,291,183,474,46,520,943,55.14%,30.86%,1
臺南市,安定區,0541,439,166,605,28,633,1157,54.71%,37.94%,1
臺南市,安定區,0542,398,310,708,65,773,1384,55.85%,28.76%,1
臺南市,安定區,0543,308,198,506,27,533,967,55.12%,31.85%,1
臺南市,安定區,0544,153,176,329,19,348,611,56.96%,25.04%,1
臺南市,山上區,0572,189,141,330,36,366,855,42.81%,22.11%,1
臺南市,山上區,0573,204,116,320,24,344,836,41.15%,24.4%,1
臺南市,山上區,0574,202,138,340,38,378,753,50.2%,26.83%,1
臺南市,山上區,0575,221,143,364,15,379,788,48.1%,28.05%,1
臺南市,山上區,0576,253,216,469,31,500,984,50.81%,25.71%,1
臺南市,山上區,0577,255,176,431,16,447,972,45.99%,26.23%,1
臺南市,山上區,0578,93,84,177,3,180,553,32.55%,16.82%,1
臺南市,山上區,0579,79,80,159,8,167,378,44.18%,20.9%,1
臺南市,山上區,0580,92,76,168,21,189,392,48.21%,23.47%,1
臺南市,玉井區,0466,268,328,596,22,618,1242,49.76%,21.58%,1
臺南市,玉井區,0467,234,333,567,30,597,1141,52.32%,20.51%,1
臺南市,玉井區,0468,167,161,328,20,348,698,49.86%,23.93%,1
臺南市,玉井區,0469,188,222,410,17,427,849,50.29%,22.14%,1
臺南市,玉井區,0470,194,293,487,29,516,949,54.37%,20.44%,1
臺南市,玉井區,0471,137,162,299,23,322,618,52.1%,22.17%,1
臺南市,玉井區,0472,125,139,264,12,276,594,46.46%,21.04%,1
臺南市,玉井區,0473,205,182,387,14,401,927,43.26%,22.11%,1
臺南市,玉井區,0474,122,126,248,32,280,512,54.69%,23.83%,1
臺南市,玉井區,0475,97,130,227,18,245,509,48.13%,19.06%,1
臺南市,玉井區,0476,124,123,247,25,272,496,54.84%,25%,1
臺南市,玉井區,0477,165,188,353,13,366,759,48.22%,21.74%,1
臺南市,玉井區,0478,128,128,256,8,264,669,39.46%,19.13%,1
臺南市,玉井區,0479,193,145,338,45,383,787,48.67%,24.52%,1
臺南市,玉井區,0480,148,117,265,36,301,620,48.55%,23.87%,1
臺南市,玉井區,0481,200,268,468,36,504,987,51.06%,20.26%,1
臺南市,楠西區,0447,187,262,449,28,477,978,48.77%,19.12%,1
臺南市,楠西區,0448,187,265,452,27,479,870,55.06%,21.49%,1
臺南市,楠西區,0449,186,217,403,8,411,1160,35.43%,16.03%,1
臺南市,楠西區,0450,130,148,278,23,301,699,43.06%,18.6%,1
臺南市,楠西區,0451,168,209,377,16,393,990,39.7%,16.97%,1
臺南市,楠西區,0452,191,209,400,22,422,928,45.47%,20.58%,1
臺南市,楠西區,0453,146,143,289,42,331,660,50.15%,22.12%,1
臺南市,楠西區,0454,253,293,546,45,591,1187,49.79%,21.31%,1
臺南市,楠西區,0455,202,283,485,28,513,1056,48.58%,19.13%,1
臺南市,南化區,0456,190,169,359,19,378,690,54.78%,27.54%,1
臺南市,南化區,0457,172,193,365,25,390,695,56.12%,24.75%,1
臺南市,南化區,0458,165,163,328,39,367,806,45.53%,20.47%,1
臺南市,南化區,0459,118,127,245,27,272,654,41.59%,18.04%,1
臺南市,南化區,0460,142,124,266,21,287,783,36.65%,18.14%,1
臺南市,南化區,0461,100,94,194,13,207,425,48.71%,23.53%,1
臺南市,南化區,0462,138,123,261,18,279,559,49.91%,24.69%,1
臺南市,南化區,0463,241,264,505,18,523,1189,43.99%,20.27%,1
臺南市,南化區,0464,224,293,517,25,542,1044,51.92%,21.46%,1
臺南市,南化區,0465,200,261,461,28,489,941,51.97%,21.25%,1
臺南市,左鎮區,0482,92,87,179,14,193,392,49.23%,23.47%,1
臺南市,左鎮區,0483,173,138,311,28,339,644,52.64%,26.86%,1
臺南市,左鎮區,0484,115,70,185,9,194,468,41.45%,24.57%,1
臺南市,左鎮區,0485,152,146,298,31,329,753,43.69%,20.19%,1
臺南市,左鎮區,0486,70,73,143,17,160,345,46.38%,20.29%,1
臺南市,左鎮區,0487,75,85,160,16,176,393,44.78%,19.08%,1
臺南市,左鎮區,0488,115,83,198,11,209,420,49.76%,27.38%,1
臺南市,左鎮區,0489,60,61,121,7,128,313,40.89%,19.17%,1
臺南市,左鎮區,0490,50,23,73,2,75,186,40.32%,26.88%,1
臺南市,左鎮區,0491,149,54,203,28,231,504,45.83%,29.56%,1
臺南市,仁德區,1188,427,270,697,44,741,1318,56.22%,32.4%,1
臺南市,仁德區,1189,332,388,720,52,772,1406,54.91%,23.61%,1
臺南市,仁德區,1190,418,306,724,50,774,1465,52.83%,28.53%,1
臺南市,仁德區,1191,385,296,681,45,726,1192,60.91%,32.3%,1
臺南市,仁德區,1192,417,376,793,41,834,1429,58.36%,29.18%,1
臺南市,仁德區,1193,394,274,668,56,724,1320,54.85%,29.85%,1
臺南市,仁德區,1194,412,377,789,47,836,1373,60.89%,30.01%,1
臺南市,仁德區,1195,373,375,748,34,782,1330,58.8%,28.05%,1
臺南市,仁德區,1196,444,479,923,30,953,1687,56.49%,26.32%,1
臺南市,仁德區,1197,359,346,705,60,765,1491,51.31%,24.08%,1
臺南市,仁德區,1198,287,232,519,28,547,1151,47.52%,24.93%,1
臺南市,仁德區,1199,297,420,717,18,735,1407,52.24%,21.11%,1
臺南市,仁德區,1200,408,402,810,32,842,1465,57.47%,27.85%,1
臺南市,仁德區,1201,344,388,732,31,763,1335,57.15%,25.77%,1
臺南市,仁德區,1202,361,391,752,39,791,1490,53.09%,24.23%,1
臺南市,仁德區,1203,379,432,811,44,855,1453,58.84%,26.08%,1
臺南市,仁德區,1204,207,295,502,14,516,990,52.12%,20.91%,1
臺南市,仁德區,1205,384,455,839,53,892,1573,56.71%,24.41%,1
臺南市,仁德區,1206,295,240,535,35,570,1031,55.29%,28.61%,1
臺南市,仁德區,1207,333,288,621,28,649,1194,54.36%,27.89%,1
臺南市,仁德區,1208,339,299,638,25,663,1268,52.29%,26.74%,1
臺南市,仁德區,1209,275,233,508,31,539,929,58.02%,29.6%,1
臺南市,仁德區,1210,262,286,548,15,563,1145,49.17%,22.88%,1
臺南市,仁德區,1211,391,327,718,34,752,1413,53.22%,27.67%,1
臺南市,仁德區,1212,369,368,737,50,787,1465,53.72%,25.19%,1
臺南市,仁德區,1213,425,355,780,26,806,1390,57.99%,30.58%,1
臺南市,仁德區,1214,405,341,746,37,783,1396,56.09%,29.01%,1
臺南市,仁德區,1215,473,497,970,32,1002,1906,52.57%,24.82%,1
臺南市,仁德區,1216,331,412,743,33,776,1546,50.19%,21.41%,1
臺南市,仁德區,1217,378,305,683,25,708,1546,45.8%,24.45%,1
臺南市,仁德區,1218,360,370,730,34,764,1399,54.61%,25.73%,1
臺南市,仁德區,1219,465,415,880,50,930,1748,53.2%,26.6%,1
臺南市,仁德區,1220,298,324,622,32,654,1140,57.37%,26.14%,1
臺南市,仁德區,1221,334,331,665,23,688,1277,53.88%,26.16%,1
臺南市,仁德區,1222,217,415,632,25,657,1019,64.47%,21.3%,1
臺南市,仁德區,1223,368,336,704,21,725,1414,51.27%,26.03%,1
臺南市,仁德區,1224,336,300,636,17,653,1349,48.41%,24.91%,1
臺南市,仁德區,1225,312,413,725,25,750,1471,50.99%,21.21%,1
臺南市,仁德區,1226,294,388,682,24,706,1324,53.32%,22.21%,1
臺南市,仁德區,1227,227,396,623,28,651,1310,49.69%,17.33%,1
臺南市,仁德區,1228,142,148,290,21,311,554,56.14%,25.63%,1
臺南市,仁德區,1229,182,529,711,42,753,1395,53.98%,13.05%,1
臺南市,仁德區,1230,270,381,651,11,662,1264,52.37%,21.36%,1
臺南市,仁德區,1231,306,290,596,60,656,1180,55.59%,25.93%,1
臺南市,仁德區,1232,245,204,449,17,466,928,50.22%,26.4%,1
臺南市,仁德區,1233,259,192,451,25,476,965,49.33%,26.84%,1
臺南市,仁德區,1234,302,243,545,26,571,1119,51.03%,26.99%,1
臺南市,仁德區,1235,323,292,615,39,654,1206,54.23%,26.78%,1
臺南市,仁德區,1236,407,320,727,31,758,1466,51.71%,27.76%,1
臺南市,歸仁區,1237,385,383,768,48,816,1560,52.31%,24.68%,1
臺南市,歸仁區,1238,397,408,805,33,838,1383,60.59%,28.71%,1
臺南市,歸仁區,1239,405,368,773,27,800,1491,53.66%,27.16%,1
臺南市,歸仁區,1240,390,330,720,41,761,1482,51.35%,26.32%,1
臺南市,歸仁區,1241,357,354,711,24,735,1330,55.26%,26.84%,1
臺南市,歸仁區,1242,415,349,764,28,792,1399,56.61%,29.66%,1
臺南市,歸仁區,1243,351,336,687,27,714,1416,50.42%,24.79%,1
臺南市,歸仁區,1244,316,263,579,23,602,1336,45.06%,23.65%,1
臺南市,歸仁區,1245,314,242,556,38,594,1183,50.21%,26.54%,1
臺南市,歸仁區,1246,347,269,616,20,636,1237,51.41%,28.05%,1
臺南市,歸仁區,1247,327,263,590,46,636,1133,56.13%,28.86%,1
臺南市,歸仁區,1248,304,263,567,31,598,1149,52.05%,26.46%,1
臺南市,歸仁區,1249,295,289,584,12,596,1105,53.94%,26.7%,1
臺南市,歸仁區,1250,304,281,585,25,610,1099,55.51%,27.66%,1
臺南市,歸仁區,1251,315,270,585,53,638,1082,58.96%,29.11%,1
臺南市,歸仁區,1252,380,407,787,30,817,1519,53.79%,25.02%,1
臺南市,歸仁區,1253,408,395,803,41,844,1467,57.53%,27.81%,1
臺南市,歸仁區,1254,263,292,555,27,582,1090,53.39%,24.13%,1
臺南市,歸仁區,1255,299,273,572,11,583,1131,51.55%,26.44%,1
臺南市,歸仁區,1256,272,264,536,31,567,1080,52.5%,25.19%,1
臺南市,歸仁區,1257,306,229,535,17,552,1121,49.24%,27.3%,1
臺南市,歸仁區,1258,353,331,684,41,725,1336,54.27%,26.42%,1
臺南市,歸仁區,1259,308,264,572,47,619,1128,54.88%,27.3%,1
臺南市,歸仁區,1260,318,239,557,18,575,1055,54.5%,30.14%,1
臺南市,歸仁區,1261,298,284,582,18,600,1102,54.45%,27.04%,1
臺南市,歸仁區,1262,335,249,584,16,600,1068,56.18%,31.37%,1
臺南市,歸仁區,1263,318,249,567,32,599,1033,57.99%,30.78%,1
臺南市,歸仁區,1264,368,355,723,28,751,1772,42.38%,20.77%,1
臺南市,歸仁區,1265,411,336,747,32,779,1399,55.68%,29.38%,1
臺南市,歸仁區,1266,407,409,816,32,848,1544,54.92%,26.36%,1
臺南市,歸仁區,1267,158,150,308,10,318,684,46.49%,23.1%,1
臺南市,歸仁區,1268,278,203,481,26,507,839,60.43%,33.13%,1
臺南市,歸仁區,1269,346,220,566,41,607,1014,59.86%,34.12%,1
臺南市,歸仁區,1270,370,323,693,24,717,1906,37.62%,19.41%,1
臺南市,歸仁區,1271,358,325,683,30,713,1245,57.27%,28.76%,1
臺南市,歸仁區,1272,252,286,538,19,557,1048,53.15%,24.05%,1
臺南市,歸仁區,1273,334,279,613,21,634,1175,53.96%,28.43%,1
臺南市,歸仁區,1274,376,323,699,19,718,1411,50.89%,26.65%,1
臺南市,歸仁區,1275,422,411,833,31,864,1514,57.07%,27.87%,1
臺南市,歸仁區,1276,475,399,874,35,909,1678,54.17%,28.31%,1
臺南市,歸仁區,1277,306,222,528,15,543,949,57.22%,32.24%,1
臺南市,歸仁區,1278,340,250,590,29,619,1009,61.35%,33.7%,1
臺南市,歸仁區,1279,340,268,608,5,613,984,62.3%,34.55%,1
臺南市,歸仁區,1280,235,189,424,30,454,756,60.05%,31.08%,1
臺南市,歸仁區,1281,408,431,839,45,884,1478,59.81%,27.6%,1
臺南市,歸仁區,1282,441,397,838,32,870,1467,59.3%,30.06%,1
臺南市,關廟區,1283,273,257,530,24,554,982,56.42%,27.8%,1
臺南市,關廟區,1284,360,311,671,26,697,1156,60.29%,31.14%,1
臺南市,關廟區,1285,259,223,482,24,506,1006,50.3%,25.75%,1
臺南市,關廟區,1286,333,270,603,39,642,1043,61.55%,31.93%,1
臺南市,關廟區,1287,293,247,540,45,585,1012,57.81%,28.95%,1
臺南市,關廟區,1288,253,231,484,8,492,1013,48.57%,24.98%,1
臺南市,關廟區,1289,321,298,619,38,657,1294,50.77%,24.81%,1
臺南市,關廟區,1290,337,296,633,26,659,1264,52.14%,26.66%,1
臺南市,關廟區,1291,319,271,590,32,622,1166,53.34%,27.36%,1
臺南市,關廟區,1292,278,218,496,20,516,1018,50.69%,27.31%,1
臺南市,關廟區,1293,179,144,323,23,346,733,47.2%,24.42%,1
臺南市,關廟區,1294,291,335,626,26,652,1093,59.65%,26.62%,1
臺南市,關廟區,1295,294,286,580,16,596,1081,55.13%,27.2%,1
臺南市,關廟區,1296,272,272,544,33,577,978,59%,27.81%,1
臺南市,關廟區,1297,275,256,531,16,547,1116,49.01%,24.64%,1
臺南市,關廟區,1298,210,278,488,34,522,972,53.7%,21.6%,1
臺南市,關廟區,1299,326,245,571,33,604,1045,57.8%,31.2%,1
臺南市,關廟區,1300,239,220,459,25,484,872,55.5%,27.41%,1
臺南市,關廟區,1301,331,244,575,22,597,1007,59.29%,32.87%,1
臺南市,關廟區,1302,233,195,428,35,463,763,60.68%,30.54%,1
臺南市,關廟區,1303,170,145,315,19,334,630,53.02%,26.98%,1
臺南市,關廟區,1304,321,215,536,33,569,959,59.33%,33.47%,1
臺南市,關廟區,1305,293,277,570,31,601,1123,53.52%,26.09%,1
臺南市,關廟區,1306,243,194,437,33,470,804,58.46%,30.22%,1
臺南市,關廟區,1307,195,166,361,16,377,720,52.36%,27.08%,1
臺南市,關廟區,1308,194,190,384,13,397,843,47.09%,23.01%,1
臺南市,關廟區,1309,98,76,174,8,182,358,50.84%,27.37%,1
臺南市,關廟區,1310,235,170,405,30,435,797,54.58%,29.49%,1
臺南市,關廟區,1311,161,162,323,15,338,709,47.67%,22.71%,1
臺南市,關廟區,1312,236,176,412,15,427,904,47.23%,26.11%,1
臺南市,關廟區,1313,300,217,517,15,532,963,55.24%,31.15%,1
臺南市,關廟區,1314,166,115,281,8,289,489,59.1%,33.95%,1
臺南市,龍崎區,1315,282,240,522,40,562,1047,53.68%,26.93%,1
臺南市,龍崎區,1316,165,140,305,16,321,630,50.95%,26.19%,1
臺南市,龍崎區,1317,31,26,57,3,60,141,42.55%,21.99%,1
臺南市,龍崎區,1318,91,84,175,8,183,367,49.86%,24.8%,1
臺南市,龍崎區,1319,77,91,168,13,181,337,53.71%,22.85%,1
臺南市,龍崎區,1320,75,65,140,10,150,318,47.17%,23.58%,1
臺南市,龍崎區,1321,84,114,198,18,216,427,50.59%,19.67%,1
臺南市,龍崎區,1322,94,94,188,10,198,446,44.39%,21.08%,1
臺南市,永康區,0708,363,364,727,43,770,1398,55.08%,25.97%,1
臺南市,永康區,0709,335,331,666,26,692,1478,46.82%,22.67%,1
臺南市,永康區,0710,337,371,708,20,728,1442,50.49%,23.37%,1
臺南市,永康區,0711,283,365,648,23,671,1353,49.59%,20.92%,1
臺南市,永康區,0712,297,282,579,25,604,1160,52.07%,25.6%,1
臺南市,永康區,0713,289,317,606,24,630,1122,56.15%,25.76%,1
臺南市,永康區,0714,296,282,578,16,594,1165,50.99%,25.41%,1
臺南市,永康區,0715,298,344,642,20,662,1317,50.27%,22.63%,1
臺南市,永康區,0716,345,345,690,23,713,1376,51.82%,25.07%,1
臺南市,永康區,0717,326,380,706,27,733,1361,53.86%,23.95%,1
臺南市,永康區,0718,330,435,765,37,802,1374,58.37%,24.02%,1
臺南市,永康區,0719,412,386,798,39,837,1709,48.98%,24.11%,1
臺南市,永康區,0720,370,436,806,32,838,1717,48.81%,21.55%,1
臺南市,永康區,0721,408,413,821,27,848,1759,48.21%,23.19%,1
臺南市,永康區,0722,383,464,847,26,873,1636,53.36%,23.41%,1
臺南市,永康區,0723,339,387,726,45,771,1442,53.47%,23.51%,1
臺南市,永康區,0724,300,461,761,21,782,1545,50.61%,19.42%,1
臺南市,永康區,0725,334,430,764,36,800,1565,51.12%,21.34%,1
臺南市,永康區,0726,363,443,806,13,819,1684,48.63%,21.56%,1
臺南市,永康區,0727,353,398,751,15,766,1548,49.48%,22.8%,1
臺南市,永康區,0728,402,343,745,31,776,1389,55.87%,28.94%,1
臺南市,永康區,0729,381,331,712,27,739,1369,53.98%,27.83%,1
臺南市,永康區,0730,371,356,727,57,784,1415,55.41%,26.22%,1
臺南市,永康區,0731,273,344,617,15,632,1386,45.6%,19.7%,1
臺南市,永康區,0732,215,219,434,9,443,1747,25.36%,12.31%,1
臺南市,永康區,0733,396,348,744,27,771,1485,51.92%,26.67%,1
臺南市,永康區,0734,410,431,841,54,895,1747,51.23%,23.47%,1
臺南市,永康區,0735,382,395,777,22,799,1744,45.81%,21.9%,1
臺南市,永康區,0736,432,406,838,29,867,1797,48.25%,24.04%,1
臺南市,永康區,0737,388,481,869,43,912,1800,50.67%,21.56%,1
臺南市,永康區,0738,392,436,828,20,848,1720,49.3%,22.79%,1
臺南市,永康區,0739,418,478,896,26,922,1708,53.98%,24.47%,1
臺南市,永康區,0740,415,430,845,24,869,1519,57.21%,27.32%,1
臺南市,永康區,0741,424,371,795,49,844,1497,56.38%,28.32%,1
臺南市,永康區,0742,387,423,810,23,833,1509,55.2%,25.65%,1
臺南市,永康區,0743,482,396,878,43,921,1542,59.73%,31.26%,1
臺南市,永康區,0744,361,467,828,24,852,1536,55.47%,23.5%,1
臺南市,永康區,0745,386,409,795,34,829,1531,54.15%,25.21%,1
臺南市,永康區,0746,398,353,751,24,775,1327,58.4%,29.99%,1
臺南市,永康區,0747,362,401,763,7,770,1456,52.88%,24.86%,1
臺南市,永康區,0748,359,388,747,35,782,1396,56.02%,25.72%,1
臺南市,永康區,0749,398,421,819,29,848,1636,51.83%,24.33%,1
臺南市,永康區,0750,434,390,824,35,859,1592,53.96%,27.26%,1
臺南市,永康區,0751,460,478,938,21,959,2017,47.55%,22.81%,1
臺南市,永康區,0752,206,165,371,13,384,672,57.14%,30.65%,1
臺南市,永康區,0753,388,371,759,25,784,1611,48.67%,24.08%,1
臺南市,永康區,0754,394,375,769,30,799,1502,53.2%,26.23%,1
臺南市,永康區,0755,360,369,729,17,746,1660,44.94%,21.69%,1
臺南市,永康區,0756,329,345,674,24,698,1561,44.71%,21.08%,1
臺南市,永康區,0757,381,385,766,19,785,1590,49.37%,23.96%,1
臺南市,永康區,0758,261,218,479,16,495,924,53.57%,28.25%,1
臺南市,永康區,0759,278,255,533,11,544,938,58%,29.64%,1
臺南市,永康區,0760,254,267,521,25,546,957,57.05%,26.54%,1
臺南市,永康區,0761,157,103,260,23,283,496,57.06%,31.65%,1
臺南市,永康區,0762,475,415,890,25,915,1717,53.29%,27.66%,1
臺南市,永康區,0763,410,369,779,23,802,1615,49.66%,25.39%,1
臺南市,永康區,0764,407,376,783,21,804,1554,51.74%,26.19%,1
臺南市,永康區,0765,334,268,602,18,620,1196,51.84%,27.93%,1
臺南市,永康區,0766,314,328,642,21,663,1274,52.04%,24.65%,1
臺南市,永康區,0767,329,306,635,19,654,1215,53.83%,27.08%,1
臺南市,永康區,0768,396,368,764,16,780,1457,53.53%,27.18%,1
臺南市,永康區,0769,382,382,764,18,782,1451,53.89%,26.33%,1
臺南市,永康區,0770,387,285,672,25,697,1423,48.98%,27.2%,1
臺南市,永康區,0771,398,341,739,26,765,1394,54.88%,28.55%,1
臺南市,永康區,0772,224,259,483,35,518,890,58.2%,25.17%,1
臺南市,永康區,0773,348,242,590,28,618,1018,60.71%,34.18%,1
臺南市,永康區,0774,108,96,204,11,215,368,58.42%,29.35%,1
臺南市,永康區,0775,373,323,696,27,723,1208,59.85%,30.88%,1
臺南市,永康區,0776,352,242,594,24,618,1187,52.06%,29.65%,1
臺南市,永康區,0777,239,445,684,21,705,1381,51.05%,17.31%,1
臺南市,永康區,0778,382,324,706,35,741,1405,52.74%,27.19%,1
臺南市,永康區,0779,375,312,687,46,733,1445,50.73%,25.95%,1
臺南市,永康區,0780,423,396,819,31,850,1687,50.39%,25.07%,1
臺南市,永康區,0781,412,291,703,29,732,1535,47.69%,26.84%,1
臺南市,永康區,0782,376,435,811,28,839,1542,54.41%,24.38%,1
臺南市,永康區,0783,357,447,804,28,832,1618,51.42%,22.06%,1
臺南市,永康區,0784,336,387,723,20,743,1338,55.53%,25.11%,1
臺南市,永康區,0785,413,298,711,36,747,1285,58.13%,32.14%,1
臺南市,永康區,0786,335,323,658,15,673,1240,54.27%,27.02%,1
臺南市,永康區,0787,331,315,646,35,681,1343,50.71%,24.65%,1
臺南市,永康區,0788,366,381,747,19,766,1327,57.72%,27.58%,1
臺南市,永康區,0789,385,410,795,24,819,1565,52.33%,24.6%,1
臺南市,永康區,0790,422,358,780,52,832,1476,56.37%,28.59%,1
臺南市,永康區,0791,377,381,758,26,784,1476,53.12%,25.54%,1
臺南市,永康區,0792,404,416,820,28,848,1463,57.96%,27.61%,1
臺南市,永康區,0793,288,236,524,51,575,983,58.49%,29.3%,1
臺南市,永康區,0794,337,270,607,50,657,1116,58.87%,30.2%,1
臺南市,永康區,0795,311,249,560,40,600,1117,53.72%,27.84%,1
臺南市,永康區,0796,268,248,516,24,540,1069,50.51%,25.07%,1
臺南市,永康區,0797,350,328,678,20,698,1180,59.15%,29.66%,1
臺南市,永康區,0798,344,254,598,51,649,1176,55.19%,29.25%,1
臺南市,永康區,0799,308,277,585,25,610,1158,52.68%,26.6%,1
臺南市,永康區,0800,376,310,686,34,720,1208,59.6%,31.13%,1
臺南市,永康區,0801,440,336,776,45,821,1501,54.7%,29.31%,1
臺南市,永康區,0802,364,361,725,29,754,1298,58.09%,28.04%,1
臺南市,永康區,0803,393,394,787,28,815,1542,52.85%,25.49%,1
臺南市,永康區,0804,410,424,834,30,864,1537,56.21%,26.68%,1
臺南市,永康區,0805,381,403,784,42,826,1359,60.78%,28.04%,1
臺南市,永康區,0806,300,242,542,18,560,1139,49.17%,26.34%,1
臺南市,永康區,0807,307,249,556,22,578,1158,49.91%,26.51%,1
臺南市,永康區,0808,403,343,746,41,787,1538,51.17%,26.2%,1
臺南市,永康區,0809,288,294,582,17,599,1166,51.37%,24.7%,1
臺南市,永康區,0810,385,271,656,12,668,1228,54.4%,31.35%,1
臺南市,永康區,0811,371,277,648,37,685,1200,57.08%,30.92%,1
臺南市,永康區,0812,323,297,620,21,641,1131,56.68%,28.56%,1
臺南市,永康區,0813,317,291,608,17,625,1147,54.49%,27.64%,1
臺南市,永康區,0814,384,321,705,29,734,1442,50.9%,26.63%,1
臺南市,永康區,0815,350,316,666,21,687,1325,51.85%,26.42%,1
臺南市,永康區,0816,305,282,587,26,613,1260,48.65%,24.21%,1
臺南市,永康區,0817,414,368,782,22,804,1631,49.29%,25.38%,1
臺南市,永康區,0818,356,391,747,28,775,1549,50.03%,22.98%,1
臺南市,永康區,0819,384,430,814,20,834,1666,50.06%,23.05%,1
臺南市,永康區,0820,163,299,462,37,499,1012,49.31%,16.11%,1
臺南市,永康區,0821,159,264,423,23,446,976,45.7%,16.29%,1
臺南市,永康區,0822,93,181,274,15,289,531,54.43%,17.51%,1
臺南市,永康區,0823,187,270,457,36,493,859,57.39%,21.77%,1
臺南市,永康區,0824,201,248,449,26,475,937,50.69%,21.45%,1
臺南市,永康區,0825,259,409,668,36,704,1307,53.86%,19.82%,1
臺南市,永康區,0826,304,383,687,25,712,1482,48.04%,20.51%,1
臺南市,永康區,0827,267,341,608,24,632,1341,47.13%,19.91%,1
臺南市,永康區,0828,306,369,675,28,703,1376,51.09%,22.24%,1
臺南市,永康區,0829,305,358,663,29,692,1390,49.78%,21.94%,1
臺南市,永康區,0830,345,461,806,28,834,1534,54.37%,22.49%,1
臺南市,永康區,0831,359,409,768,34,802,1460,54.93%,24.59%,1
臺南市,永康區,0832,320,377,697,12,709,1383,51.27%,23.14%,1
臺南市,永康區,0833,282,392,674,27,701,1299,53.96%,21.71%,1
臺南市,永康區,0834,317,357,674,27,701,1264,55.46%,25.08%,1
臺南市,永康區,0835,323,423,746,27,773,1355,57.05%,23.84%,1
臺南市,永康區,0836,303,383,686,22,708,1414,50.07%,21.43%,1
臺南市,永康區,0837,226,384,610,20,630,1109,56.81%,20.38%,1
臺南市,永康區,0838,230,331,561,35,596,1151,51.78%,19.98%,1
臺南市,永康區,0839,216,405,621,40,661,1026,64.42%,21.05%,1
臺南市,永康區,0840,209,303,512,20,532,1071,49.67%,19.51%,1
臺南市,永康區,0841,383,460,843,29,872,1387,62.87%,27.61%,1
臺南市,永康區,0842,390,400,790,27,817,1377,59.33%,28.32%,1
臺南市,永康區,0843,379,490,869,38,907,1687,53.76%,22.47%,1
臺南市,永康區,0844,379,431,810,37,847,1700,49.82%,22.29%,1
臺南市,永康區,0845,388,398,786,26,812,1444,56.23%,26.87%,1
臺南市,永康區,0846,349,382,731,29,760,1485,51.18%,23.5%,1
臺南市,永康區,0847,365,444,809,29,838,1717,48.81%,21.26%,1
臺南市,永康區,0848,356,409,765,43,808,1701,47.5%,20.93%,1
臺南市,永康區,0849,284,393,677,24,701,1382,50.72%,20.55%,1
臺南市,東區,1095,535,515,1050,23,1073,2681,40.02%,19.96%,1
臺南市,東區,1096,494,446,940,30,970,1811,53.56%,27.28%,1
臺南市,東區,1097,494,395,889,51,940,1491,63.04%,33.13%,1
臺南市,東區,1098,372,352,724,31,755,1378,54.79%,27%,1
臺南市,東區,1099,422,449,871,30,901,1552,58.05%,27.19%,1
臺南市,東區,1100,436,321,757,22,779,1326,58.75%,32.88%,1
臺南市,東區,1101,400,456,856,45,901,1594,56.52%,25.09%,1
臺南市,東區,1102,440,484,924,24,948,1639,57.84%,26.85%,1
臺南市,東區,1103,426,481,907,33,940,1724,54.52%,24.71%,1
臺南市,東區,1104,520,352,872,41,913,1629,56.05%,31.92%,1
臺南市,東區,1105,364,398,762,29,791,1399,56.54%,26.02%,1
臺南市,東區,1106,376,446,822,29,851,1534,55.48%,24.51%,1
臺南市,東區,1107,415,500,915,21,936,1656,56.52%,25.06%,1
臺南市,東區,1108,309,386,695,39,734,1322,55.52%,23.37%,1
臺南市,東區,1109,401,313,714,21,735,1620,45.37%,24.75%,1
臺南市,東區,1110,296,489,785,29,814,1331,61.16%,22.24%,1
臺南市,東區,1111,266,302,568,30,598,1039,57.56%,25.6%,1
臺南市,東區,1112,310,319,629,23,652,1257,51.87%,24.66%,1
臺南市,東區,1113,482,529,1011,61,1072,2067,51.86%,23.32%,1
臺南市,東區,1114,445,698,1143,31,1174,2153,54.53%,20.67%,1
臺南市,東區,1115,475,735,1210,44,1254,2363,53.07%,20.1%,1
臺南市,東區,1116,402,361,763,31,794,1427,55.64%,28.17%,1
臺南市,東區,1117,452,428,880,28,908,1555,58.39%,29.07%,1
臺南市,東區,1118,422,514,936,32,968,2115,45.77%,19.95%,1
臺南市,東區,1119,555,568,1123,44,1167,2340,49.87%,23.72%,1
臺南市,東區,1120,624,660,1284,36,1320,2474,53.35%,25.22%,1
臺南市,東區,1121,675,544,1219,26,1245,2391,52.07%,28.23%,1
臺南市,東區,1122,424,504,928,30,958,1673,57.26%,25.34%,1
臺南市,東區,1123,446,406,852,25,877,1594,55.02%,27.98%,1
臺南市,東區,1124,409,477,886,36,922,1607,57.37%,25.45%,1
臺南市,東區,1125,502,685,1187,26,1213,2087,58.12%,24.05%,1
臺南市,東區,1126,568,768,1336,25,1361,2369,57.45%,23.98%,1
臺南市,東區,1127,455,401,856,58,914,1696,53.89%,26.83%,1
臺南市,東區,1128,460,413,873,33,906,1612,56.2%,28.54%,1
臺南市,東區,1129,449,404,853,40,893,1708,52.28%,26.29%,1
臺南市,東區,1130,372,464,836,26,862,1560,55.26%,23.85%,1
臺南市,東區,1131,472,486,958,34,992,1854,53.51%,25.46%,1
臺南市,東區,1132,576,541,1117,25,1142,2278,50.13%,25.29%,1
臺南市,東區,1133,479,581,1060,38,1098,2093,52.46%,22.89%,1
臺南市,東區,1134,503,726,1229,51,1280,2242,57.09%,22.44%,1
臺南市,東區,1135,334,324,658,33,691,1152,59.98%,28.99%,1
臺南市,東區,1136,332,459,791,10,801,1318,60.77%,25.19%,1
臺南市,東區,1137,571,626,1197,40,1237,2200,56.23%,25.95%,1
臺南市,東區,1138,466,653,1119,30,1149,1960,58.62%,23.78%,1
臺南市,東區,1139,408,396,804,35,839,1489,56.35%,27.4%,1
臺南市,東區,1140,367,386,753,45,798,1443,55.3%,25.43%,1
臺南市,東區,1141,448,434,882,27,909,1498,60.68%,29.91%,1
臺南市,東區,1142,424,483,907,15,922,1622,56.84%,26.14%,1
臺南市,東區,1143,416,539,955,22,977,1738,56.21%,23.94%,1
臺南市,東區,1144,381,388,769,31,800,1501,53.3%,25.38%,1
臺南市,東區,1145,413,392,805,41,846,1482,57.09%,27.87%,1
臺南市,東區,1146,405,496,901,27,928,1829,50.74%,22.14%,1
臺南市,東區,1147,408,518,926,40,966,1764,54.76%,23.13%,1
臺南市,東區,1148,357,441,798,34,832,1427,58.3%,25.02%,1
臺南市,東區,1149,361,378,739,33,772,1427,54.1%,25.3%,1
臺南市,東區,1150,329,423,752,30,782,1388,56.34%,23.7%,1
臺南市,東區,1151,340,345,685,16,701,1131,61.98%,30.06%,1
臺南市,東區,1152,249,273,522,30,552,1000,55.2%,24.9%,1
臺南市,東區,1153,236,301,537,18,555,996,55.72%,23.69%,1
臺南市,東區,1154,252,234,486,19,505,935,54.01%,26.95%,1
臺南市,東區,1155,308,209,517,31,548,947,57.87%,32.52%,1
臺南市,東區,1156,316,268,584,10,594,1090,54.5%,28.99%,1
臺南市,東區,1157,228,223,451,34,485,896,54.13%,25.45%,1
臺南市,東區,1158,397,441,838,30,868,1589,54.63%,24.98%,1
臺南市,東區,1159,412,423,835,27,862,1497,57.58%,27.52%,1
臺南市,東區,1160,383,309,692,40,732,1386,52.81%,27.63%,1
臺南市,東區,1161,302,312,614,13,627,1101,56.95%,27.43%,1
臺南市,東區,1162,374,366,740,41,781,1332,58.63%,28.08%,1
臺南市,東區,1163,277,367,644,28,672,1185,56.71%,23.38%,1
臺南市,東區,1164,378,338,716,33,749,1262,59.35%,29.95%,1
臺南市,東區,1165,371,392,763,32,795,1517,52.41%,24.46%,1
臺南市,東區,1166,332,336,668,48,716,1287,55.63%,25.8%,1
臺南市,東區,1167,425,462,887,40,927,1657,55.94%,25.65%,1
臺南市,東區,1168,500,667,1167,69,1236,2238,55.23%,22.34%,1
臺南市,東區,1169,593,571,1164,36,1200,2246,53.43%,26.4%,1
臺南市,東區,1170,581,521,1102,33,1135,2191,51.8%,26.52%,1
臺南市,東區,1171,486,575,1061,32,1093,2063,52.98%,23.56%,1
臺南市,東區,1172,555,649,1204,58,1262,2177,57.97%,25.49%,1
臺南市,東區,1173,441,603,1044,52,1096,1863,58.83%,23.67%,1
臺南市,東區,1174,554,637,1191,25,1216,2185,55.65%,25.35%,1
臺南市,東區,1175,425,395,820,26,846,1721,49.16%,24.69%,1
臺南市,東區,1176,401,424,825,47,872,1556,56.04%,25.77%,1
臺南市,東區,1177,374,515,889,32,921,1602,57.49%,23.35%,1
臺南市,東區,1178,391,378,769,45,814,1523,53.45%,25.67%,1
臺南市,東區,1179,373,319,692,26,718,1382,51.95%,26.99%,1
臺南市,東區,1180,417,369,786,31,817,1486,54.98%,28.06%,1
臺南市,東區,1181,426,422,848,30,878,1560,56.28%,27.31%,1
臺南市,東區,1182,398,394,792,47,839,1684,49.82%,23.63%,1
臺南市,東區,1183,460,439,899,22,921,1653,55.72%,27.83%,1
臺南市,東區,1184,457,392,849,17,866,1554,55.73%,29.41%,1
臺南市,東區,1185,377,412,789,19,808,1408,57.39%,26.78%,1
臺南市,東區,1186,586,616,1202,30,1232,2084,59.12%,28.12%,1
臺南市,東區,1187,475,524,999,45,1044,1896,55.06%,25.05%,1
臺南市,南區,1015,335,331,666,40,706,1221,57.82%,27.44%,1
臺南市,南區,1016,480,503,983,34,1017,2171,46.84%,22.11%,1
臺南市,南區,1017,293,349,642,25,667,1150,58%,25.48%,1
臺南市,南區,1018,261,359,620,26,646,1122,57.58%,23.26%,1
臺南市,南區,1019,361,341,702,33,735,1444,50.9%,25%,1
臺南市,南區,1020,404,459,863,33,896,1765,50.76%,22.89%,1
臺南市,南區,1021,336,395,731,33,764,1298,58.86%,25.89%,1
臺南市,南區,1022,284,487,771,35,806,1458,55.28%,19.48%,1
臺南市,南區,1023,316,616,932,41,973,1940,50.15%,16.29%,1
臺南市,南區,1024,400,438,838,30,868,1637,53.02%,24.43%,1
臺南市,南區,1025,162,234,396,11,407,871,46.73%,18.6%,1
臺南市,南區,1026,143,174,317,21,338,589,57.39%,24.28%,1
臺南市,南區,1027,284,219,503,27,530,801,66.17%,35.46%,1
臺南市,南區,1028,290,251,541,38,579,990,58.48%,29.29%,1
臺南市,南區,1029,359,359,718,28,746,1222,61.05%,29.38%,1
臺南市,南區,1030,305,245,550,49,599,997,60.08%,30.59%,1
臺南市,南區,1031,351,264,615,27,642,1204,53.32%,29.15%,1
臺南市,南區,1032,379,337,716,33,749,1570,47.71%,24.14%,1
臺南市,南區,1033,369,294,663,25,688,1222,56.3%,30.2%,1
臺南市,南區,1034,299,240,539,17,556,1076,51.67%,27.79%,1
臺南市,南區,1035,365,253,618,13,631,1127,55.99%,32.39%,1
臺南市,南區,1036,336,282,618,29,647,1135,57%,29.6%,1
臺南市,南區,1037,331,321,652,25,677,1263,53.6%,26.21%,1
臺南市,南區,1038,236,282,518,18,536,1014,52.86%,23.27%,1
臺南市,南區,1039,471,334,805,39,844,1491,56.61%,31.59%,1
臺南市,南區,1040,476,462,938,29,967,1815,53.28%,26.23%,1
臺南市,南區,1041,406,308,714,21,735,1398,52.58%,29.04%,1
臺南市,南區,1042,455,457,912,26,938,2107,44.52%,21.59%,1
臺南市,南區,1043,482,421,903,41,944,1587,59.48%,30.37%,1
臺南市,南區,1044,447,391,838,45,883,1626,54.31%,27.49%,1
臺南市,南區,1045,460,405,865,28,893,1761,50.71%,26.12%,1
臺南市,南區,1046,483,340,823,53,876,1630,53.74%,29.63%,1
臺南市,南區,1047,454,367,821,34,855,1542,55.45%,29.44%,1
臺南市,南區,1048,397,328,725,58,783,1464,53.48%,27.12%,1
臺南市,南區,1049,505,364,869,49,918,1727,53.16%,29.24%,1
臺南市,南區,1050,378,265,643,32,675,1085,62.21%,34.84%,1
臺南市,南區,1051,267,221,488,14,502,939,53.46%,28.43%,1
臺南市,南區,1052,398,260,658,40,698,1419,49.19%,28.05%,1
臺南市,南區,1053,347,297,644,29,673,1333,50.49%,26.03%,1
臺南市,南區,1054,421,295,716,32,748,1465,51.06%,28.74%,1
臺南市,南區,1055,319,267,586,24,610,1099,55.51%,29.03%,1
臺南市,南區,1056,279,269,548,20,568,1133,50.13%,24.62%,1
臺南市,南區,1057,393,296,689,33,722,1375,52.51%,28.58%,1
臺南市,南區,1058,428,393,821,18,839,1781,47.11%,24.03%,1
臺南市,南區,1059,429,417,846,34,880,1542,57.07%,27.82%,1
臺南市,南區,1060,388,333,721,23,744,1486,50.07%,26.11%,1
臺南市,南區,1061,504,377,881,49,930,1640,56.71%,30.73%,1
臺南市,南區,1062,431,312,743,21,764,1701,44.91%,25.34%,1
臺南市,南區,1063,404,316,720,46,766,1541,49.71%,26.22%,1
臺南市,南區,1064,527,432,959,65,1024,2027,50.52%,26%,1
臺南市,南區,1065,498,503,1001,44,1045,1774,58.91%,28.07%,1
臺南市,南區,1066,450,347,797,44,841,1613,52.14%,27.9%,1
臺南市,南區,1067,479,368,847,21,868,1707,50.85%,28.06%,1
臺南市,南區,1068,318,273,591,15,606,1657,36.57%,19.19%,1
臺南市,南區,1069,303,253,556,28,584,1077,54.22%,28.13%,1
臺南市,南區,1070,302,309,611,30,641,1185,54.09%,25.49%,1
臺南市,南區,1071,342,302,644,28,672,1249,53.8%,27.38%,1
臺南市,南區,1072,425,442,867,25,892,1985,44.94%,21.41%,1
臺南市,南區,1073,518,359,877,39,916,2017,45.41%,25.68%,1
臺南市,南區,1074,455,352,807,43,850,1717,49.5%,26.5%,1
臺南市,南區,1075,272,228,500,31,531,929,57.16%,29.28%,1
臺南市,南區,1076,209,170,379,19,398,695,57.27%,30.07%,1
臺南市,南區,1077,251,229,480,14,494,997,49.55%,25.18%,1
臺南市,南區,1078,184,186,370,27,397,784,50.64%,23.47%,1
臺南市,南區,1079,342,280,622,32,654,1119,58.45%,30.56%,1
臺南市,南區,1080,355,149,504,25,529,1054,50.19%,33.68%,1
臺南市,南區,1081,402,213,615,36,651,1245,52.29%,32.29%,1
臺南市,南區,1082,559,392,951,40,991,2064,48.01%,27.08%,1
臺南市,南區,1083,469,377,846,31,877,2056,42.66%,22.81%,1
臺南市,南區,1084,394,255,649,24,673,1373,49.02%,28.7%,1
臺南市,南區,1085,310,172,482,17,499,1002,49.8%,30.94%,1
臺南市,南區,1086,277,160,437,32,469,760,61.71%,36.45%,1
臺南市,南區,1087,370,173,543,47,590,1031,57.23%,35.89%,1
臺南市,南區,1088,218,175,393,28,421,744,56.59%,29.3%,1
臺南市,南區,1089,374,251,625,30,655,1186,55.23%,31.53%,1
臺南市,南區,1090,417,301,718,33,751,1358,55.3%,30.71%,1
臺南市,南區,1091,253,161,414,30,444,897,49.5%,28.21%,1
臺南市,南區,1092,350,273,623,50,673,1265,53.2%,27.67%,1
臺南市,南區,1093,372,186,558,26,584,1093,53.43%,34.03%,1
臺南市,南區,1094,325,247,572,14,586,1016,57.68%,31.99%,1
臺南市,北區,0850,418,452,870,40,910,1793,50.75%,23.31%,1
臺南市,北區,0851,419,400,819,53,872,1708,51.05%,24.53%,1
臺南市,北區,0852,248,255,503,11,514,997,51.55%,24.87%,1
臺南市,北區,0853,319,303,622,32,654,1452,45.04%,21.97%,1
臺南市,北區,0854,327,341,668,20,688,1351,50.93%,24.2%,1
臺南市,北區,0855,391,409,800,35,835,1323,63.11%,29.55%,1
臺南市,北區,0856,307,294,601,20,621,1073,57.88%,28.61%,1
臺南市,北區,0857,356,289,645,24,669,1138,58.79%,31.28%,1
臺南市,北區,0858,298,316,614,23,637,1189,53.57%,25.06%,1
臺南市,北區,0859,341,402,743,32,775,1262,61.41%,27.02%,1
臺南市,北區,0860,257,336,593,21,614,1017,60.37%,25.27%,1
臺南市,北區,0861,211,250,461,18,479,847,56.55%,24.91%,1
臺南市,北區,0862,345,253,598,29,627,1076,58.27%,32.06%,1
臺南市,北區,0863,263,286,549,24,573,954,60.06%,27.57%,1
臺南市,北區,0864,296,357,653,46,699,1300,53.77%,22.77%,1
臺南市,北區,0865,204,489,693,40,733,1390,52.73%,14.68%,1
臺南市,北區,0866,310,402,712,33,745,1318,56.53%,23.52%,1
臺南市,北區,0867,249,263,512,10,522,974,53.59%,25.56%,1
臺南市,北區,0868,278,255,533,18,551,990,55.66%,28.08%,1
臺南市,北區,0869,292,328,620,12,632,1016,62.2%,28.74%,1
臺南市,北區,0870,281,282,563,28,591,1053,56.13%,26.69%,1
臺南市,北區,0871,384,341,725,44,769,1466,52.46%,26.19%,1
臺南市,北區,0872,369,438,807,46,853,1535,55.57%,24.04%,1
臺南市,北區,0873,410,380,790,37,827,1544,53.56%,26.55%,1
臺南市,北區,0874,434,493,927,57,984,1760,55.91%,24.66%,1
臺南市,北區,0875,411,287,698,29,727,1372,52.99%,29.96%,1
臺南市,北區,0876,252,305,557,30,587,1002,58.58%,25.15%,1
臺南市,北區,0877,354,298,652,35,687,1171,58.67%,30.23%,1
臺南市,北區,0878,209,397,606,26,632,1285,49.18%,16.26%,1
臺南市,北區,0879,162,344,506,37,543,1036,52.41%,15.64%,1
臺南市,北區,0880,286,420,706,36,742,1392,53.3%,20.55%,1
臺南市,北區,0881,334,274,608,40,648,1147,56.5%,29.12%,1
臺南市,北區,0882,347,367,714,27,741,1526,48.56%,22.74%,1
臺南市,北區,0883,445,373,818,29,847,1559,54.33%,28.54%,1
臺南市,北區,0884,226,247,473,42,515,892,57.74%,25.34%,1
臺南市,北區,0885,264,211,475,24,499,937,53.26%,28.18%,1
臺南市,北區,0886,444,346,790,53,843,1449,58.18%,30.64%,1
臺南市,北區,0887,333,260,593,29,622,1160,53.62%,28.71%,1
臺南市,北區,0888,331,252,583,24,607,1567,38.74%,21.12%,1
臺南市,北區,0889,400,299,699,31,730,1346,54.23%,29.72%,1
臺南市,北區,0890,345,350,695,17,712,1451,49.07%,23.78%,1
臺南市,北區,0891,411,350,761,31,792,1522,52.04%,27%,1
臺南市,北區,0892,322,324,646,23,669,1278,52.35%,25.2%,1
臺南市,北區,0893,329,254,583,36,619,1164,53.18%,28.26%,1
臺南市,北區,0894,296,229,525,21,546,1091,50.05%,27.13%,1
臺南市,北區,0895,300,210,510,15,525,993,52.87%,30.21%,1
臺南市,北區,0896,309,192,501,34,535,1119,47.81%,27.61%,1
臺南市,北區,0897,483,403,886,51,937,1685,55.61%,28.66%,1
臺南市,北區,0898,391,333,724,23,747,1368,54.61%,28.58%,1
臺南市,北區,0899,375,358,733,26,759,1389,54.64%,27%,1
臺南市,北區,0900,406,423,829,19,848,1469,57.73%,27.64%,1
臺南市,北區,0901,438,479,917,34,951,1655,57.46%,26.47%,1
臺南市,北區,0902,326,372,698,24,722,1261,57.26%,25.85%,1
臺南市,北區,0903,367,401,768,20,788,1490,52.89%,24.63%,1
臺南市,北區,0904,383,428,811,26,837,1436,58.29%,26.67%,1
臺南市,北區,0905,367,369,736,56,792,1340,59.1%,27.39%,1
臺南市,北區,0906,368,418,786,32,818,1464,55.87%,25.14%,1
臺南市,北區,0907,432,429,861,17,878,1513,58.03%,28.55%,1
臺南市,北區,0908,452,503,955,22,977,1709,57.17%,26.45%,1
臺南市,北區,0909,451,429,880,31,911,1517,60.05%,29.73%,1
臺南市,北區,0910,470,364,834,28,862,1598,53.94%,29.41%,1
臺南市,北區,0911,394,326,720,24,744,1399,53.18%,28.16%,1
臺南市,北區,0912,393,242,635,35,670,1214,55.19%,32.37%,1
臺南市,北區,0913,277,304,581,16,597,1064,56.11%,26.03%,1
臺南市,北區,0914,366,321,687,20,707,1148,61.59%,31.88%,1
臺南市,北區,0915,429,335,764,26,790,1391,56.79%,30.84%,1
臺南市,北區,0916,449,417,866,38,904,1584,57.07%,28.35%,1
臺南市,北區,0917,433,437,870,24,894,1595,56.05%,27.15%,1
臺南市,北區,0918,367,378,745,18,763,1397,54.62%,26.27%,1
臺南市,北區,0919,450,418,868,33,901,1662,54.21%,27.08%,1
臺南市,北區,0920,408,408,816,27,843,1634,51.59%,24.97%,1
臺南市,北區,0921,536,433,969,52,1021,1793,56.94%,29.89%,1
臺南市,北區,0922,525,489,1014,36,1050,1872,56.09%,28.04%,1
臺南市,北區,0923,515,440,955,60,1015,1874,54.16%,27.48%,1
臺南市,北區,0924,446,439,885,48,933,1760,53.01%,25.34%,1
臺南市,北區,0925,390,471,861,47,908,1753,51.8%,22.25%,1
臺南市,北區,0926,360,328,688,18,706,1502,47%,23.97%,1
臺南市,北區,0927,410,364,774,29,803,1470,54.63%,27.89%,1
臺南市,北區,0928,406,264,670,42,712,1319,53.98%,30.78%,1
臺南市,北區,0929,527,488,1015,41,1056,1876,56.29%,28.09%,1
臺南市,北區,0930,468,434,902,20,922,1720,53.6%,27.21%,1
臺南市,安南區,0618,671,649,1320,36,1356,2549,53.2%,26.32%,1
臺南市,安南區,0619,605,572,1177,44,1221,2321,52.61%,26.07%,1
臺南市,安南區,0620,608,555,1163,37,1200,2156,55.66%,28.2%,1
臺南市,安南區,0621,502,426,928,49,977,1662,58.78%,30.2%,1
臺南市,安南區,0622,426,415,841,58,899,1512,59.46%,28.17%,1
臺南市,安南區,0623,405,374,779,51,830,1625,51.08%,24.92%,1
臺南市,安南區,0624,473,465,938,56,994,2143,46.38%,22.07%,1
臺南市,安南區,0625,691,587,1278,55,1333,2457,54.25%,28.12%,1
臺南市,安南區,0626,634,513,1147,59,1206,2148,56.15%,29.52%,1
臺南市,安南區,0627,601,586,1187,49,1236,2364,52.28%,25.42%,1
臺南市,安南區,0628,435,442,877,36,913,1868,48.88%,23.29%,1
臺南市,安南區,0629,529,481,1010,39,1049,1797,58.38%,29.44%,1
臺南市,安南區,0630,602,579,1181,47,1228,2268,54.14%,26.54%,1
臺南市,安南區,0631,573,428,1001,51,1052,2291,45.92%,25.01%,1
臺南市,安南區,0632,567,534,1101,47,1148,2255,50.91%,25.14%,1
臺南市,安南區,0633,519,384,903,40,943,1940,48.61%,26.75%,1
臺南市,安南區,0634,606,481,1087,27,1114,2013,55.34%,30.1%,1
臺南市,安南區,0635,523,482,1005,41,1046,2024,51.68%,25.84%,1
臺南市,安南區,0636,479,457,936,50,986,1613,61.13%,29.7%,1
臺南市,安南區,0637,367,249,616,22,638,1178,54.16%,31.15%,1
臺南市,安南區,0638,625,479,1104,59,1163,2143,54.27%,29.16%,1
臺南市,安南區,0639,534,386,920,50,970,1721,56.36%,31.03%,1
臺南市,安南區,0640,527,450,977,37,1014,1773,57.19%,29.72%,1
臺南市,安南區,0641,421,347,768,15,783,1428,54.83%,29.48%,1
臺南市,安南區,0642,456,404,860,35,895,1626,55.04%,28.04%,1
臺南市,安南區,0643,338,372,710,26,736,1358,54.2%,24.89%,1
臺南市,安南區,0644,451,372,823,37,860,1447,59.43%,31.17%,1
臺南市,安南區,0645,373,337,710,59,769,1358,56.63%,27.47%,1
臺南市,安南區,0646,549,468,1017,39,1056,2116,49.91%,25.95%,1
臺南市,安南區,0647,570,529,1099,42,1141,2321,49.16%,24.56%,1
臺南市,安南區,0648,580,471,1051,28,1079,2117,50.97%,27.4%,1
臺南市,安南區,0649,521,380,901,60,961,1927,49.87%,27.04%,1
臺南市,安南區,0650,578,505,1083,69,1152,2242,51.38%,25.78%,1
臺南市,安南區,0651,612,511,1123,40,1163,2334,49.83%,26.22%,1
臺南市,安南區,0652,516,435,951,41,992,1822,54.45%,28.32%,1
臺南市,安南區,0653,537,427,964,63,1027,1813,56.65%,29.62%,1
臺南市,安南區,0654,545,555,1100,71,1171,2188,53.52%,24.91%,1
臺南市,安南區,0655,582,533,1115,60,1175,2399,48.98%,24.26%,1
臺南市,安南區,0656,547,477,1024,49,1073,2247,47.75%,24.34%,1
臺南市,安南區,0657,408,273,681,44,725,1165,62.23%,35.02%,1
臺南市,安南區,0658,399,346,745,36,781,1539,50.75%,25.93%,1
臺南市,安南區,0659,550,420,970,70,1040,1835,56.68%,29.97%,1
臺南市,安南區,0660,528,409,937,44,981,1797,54.59%,29.38%,1
臺南市,安南區,0661,564,465,1029,61,1090,2223,49.03%,25.37%,1
臺南市,安南區,0662,346,239,585,41,626,977,64.07%,35.41%,1
臺南市,安南區,0663,409,342,751,27,778,1642,47.38%,24.91%,1
臺南市,安南區,0664,481,429,910,32,942,1697,55.51%,28.34%,1
臺南市,安南區,0665,480,447,927,33,960,1966,48.83%,24.42%,1
臺南市,安南區,0666,366,294,660,44,704,1319,53.37%,27.75%,1
臺南市,安南區,0667,474,409,883,56,939,1909,49.19%,24.83%,1
臺南市,安南區,0668,497,406,903,49,952,1763,54%,28.19%,1
臺南市,安南區,0669,266,212,478,40,518,965,53.68%,27.56%,1
臺南市,安南區,0670,360,316,676,44,720,1547,46.54%,23.27%,1
臺南市,安南區,0671,461,418,879,31,910,1784,51.01%,25.84%,1
臺南市,安南區,0672,485,504,989,41,1030,2145,48.02%,22.61%,1
臺南市,安南區,0673,657,605,1262,55,1317,2443,53.91%,26.89%,1
臺南市,安南區,0674,561,562,1123,6,1129,2565,44.02%,21.87%,1
臺南市,安南區,0675,673,557,1230,63,1293,2480,52.14%,27.14%,1
臺南市,安南區,0676,553,459,1012,59,1071,2349,45.59%,23.54%,1
臺南市,安南區,0677,607,502,1109,57,1166,2168,53.78%,28%,1
臺南市,安南區,0678,417,396,813,39,852,1630,52.27%,25.58%,1
臺南市,安南區,0679,414,349,763,39,802,1675,47.88%,24.72%,1
臺南市,安南區,0680,499,457,956,64,1020,1627,62.69%,30.67%,1
臺南市,安南區,0681,458,331,789,39,828,1493,55.46%,30.68%,1
臺南市,安南區,0682,390,357,747,40,787,1397,56.34%,27.92%,1
臺南市,安南區,0683,415,297,712,44,756,1416,53.39%,29.31%,1
臺南市,安南區,0684,452,309,761,24,785,1460,53.77%,30.96%,1
臺南市,安南區,0685,515,469,984,27,1011,2222,45.5%,23.18%,1
臺南市,安南區,0686,550,493,1043,58,1101,2070,53.19%,26.57%,1
臺南市,安南區,0687,495,444,939,28,967,1739,55.61%,28.46%,1
臺南市,安南區,0688,513,386,899,41,940,1830,51.37%,28.03%,1
臺南市,安南區,0689,558,456,1014,46,1060,1803,58.79%,30.95%,1
臺南市,安南區,0690,532,444,976,42,1018,1800,56.56%,29.56%,1
臺南市,安南區,0691,450,364,814,42,856,1815,47.16%,24.79%,1
臺南市,安南區,0692,535,363,898,24,922,1846,49.95%,28.98%,1
臺南市,安南區,0693,322,207,529,34,563,905,62.21%,35.58%,1
臺南市,安南區,0694,331,284,615,48,663,1073,61.79%,30.85%,1
臺南市,安南區,0695,441,434,875,44,919,1579,58.2%,27.93%,1
臺南市,安南區,0696,490,420,910,72,982,1876,52.35%,26.12%,1
臺南市,安南區,0697,286,300,586,35,621,1194,52.01%,23.95%,1
臺南市,安南區,0698,315,290,605,16,621,1475,42.1%,21.36%,1
臺南市,安南區,0699,394,278,672,22,694,1380,50.29%,28.55%,1
臺南市,安南區,0700,419,301,720,25,745,1462,50.96%,28.66%,1
臺南市,安南區,0701,295,287,582,42,624,1044,59.77%,28.26%,1
臺南市,安南區,0702,186,172,358,37,395,603,65.51%,30.85%,1
臺南市,安南區,0703,209,171,380,22,402,690,58.26%,30.29%,1
臺南市,安南區,0704,368,325,693,33,726,1447,50.17%,25.43%,1
臺南市,安南區,0705,305,262,567,38,605,910,66.48%,33.52%,1
臺南市,安南區,0706,495,380,875,46,921,1850,49.78%,26.76%,1
臺南市,安南區,0707,435,411,846,37,883,1501,58.83%,28.98%,1
臺南市,安平區,0983,462,478,940,39,979,1753,55.85%,26.35%,1
臺南市,安平區,0984,448,484,932,36,968,1859,52.07%,24.1%,1
臺南市,安平區,0985,349,427,776,25,801,1382,57.96%,25.25%,1
臺南市,安平區,0986,630,602,1232,45,1277,2547,50.14%,24.73%,1
臺南市,安平區,0987,598,626,1224,36,1260,2407,52.35%,24.84%,1
臺南市,安平區,0988,444,500,944,26,970,2070,46.86%,21.45%,1
臺南市,安平區,0989,554,541,1095,29,1124,2132,52.72%,25.98%,1
臺南市,安平區,0990,388,400,788,15,803,1450,55.38%,26.76%,1
臺南市,安平區,0991,446,352,798,19,817,1605,50.9%,27.79%,1
臺南市,安平區,0992,428,482,910,38,948,1755,54.02%,24.39%,1
臺南市,安平區,0993,423,367,790,33,823,1728,47.63%,24.48%,1
臺南市,安平區,0994,367,373,740,16,756,1754,43.1%,20.92%,1
臺南市,安平區,0995,444,407,851,23,874,1686,51.84%,26.33%,1
臺南市,安平區,0996,497,467,964,34,998,1843,54.15%,26.97%,1
臺南市,安平區,0997,438,430,868,23,891,1565,56.93%,27.99%,1
臺南市,安平區,0998,349,318,667,29,696,1288,54.04%,27.1%,1
臺南市,安平區,0999,401,394,795,19,814,1653,49.24%,24.26%,1
臺南市,安平區,1000,360,460,820,25,845,1697,49.79%,21.21%,1
臺南市,安平區,1001,478,502,980,34,1014,2154,47.08%,22.19%,1
臺南市,安平區,1002,490,505,995,39,1034,2107,49.07%,23.26%,1
臺南市,安平區,1003,429,463,892,38,930,1675,55.52%,25.61%,1
臺南市,安平區,1004,491,496,987,42,1029,1979,52%,24.81%,1
臺南市,安平區,1005,428,350,778,21,799,1602,49.88%,26.72%,1
臺南市,安平區,1006,341,431,772,36,808,1586,50.95%,21.5%,1
臺南市,安平區,1007,133,85,218,9,227,438,51.83%,30.37%,1
臺南市,安平區,1008,443,406,849,57,906,1780,50.9%,24.89%,1
臺南市,安平區,1009,436,358,794,26,820,1623,50.52%,26.86%,1
臺南市,安平區,1010,548,482,1030,40,1070,2157,49.61%,25.41%,1
臺南市,安平區,1011,373,252,625,36,661,1286,51.4%,29%,1
臺南市,安平區,1012,390,342,732,62,794,1492,53.22%,26.14%,1
臺南市,安平區,1013,271,341,612,26,638,1325,48.15%,20.45%,1
臺南市,安平區,1014,458,493,951,47,998,2001,49.88%,22.89%,1
臺南市,中西區,0931,409,300,709,31,740,1332,55.56%,30.71%,1
臺南市,中西區,0932,383,311,694,29,723,1246,58.03%,30.74%,1
臺南市,中西區,0933,373,267,640,42,682,1276,53.45%,29.23%,1
臺南市,中西區,0934,443,433,876,27,903,1583,57.04%,27.98%,1
臺南市,中西區,0935,447,366,813,27,840,1464,57.38%,30.53%,1
臺南市,中西區,0936,350,290,640,19,659,1234,53.4%,28.36%,1
臺南市,中西區,0937,368,390,758,31,789,1368,57.68%,26.9%,1
臺南市,中西區,0938,376,259,635,26,661,1322,50%,28.44%,1
臺南市,中西區,0939,368,253,621,30,651,1216,53.54%,30.26%,1
臺南市,中西區,0940,388,283,671,32,703,1289,54.54%,30.1%,1
臺南市,中西區,0941,381,309,690,22,712,1237,57.56%,30.8%,1
臺南市,中西區,0942,348,229,577,26,603,1189,50.71%,29.27%,1
臺南市,中西區,0943,395,257,652,33,685,1201,57.04%,32.89%,1
臺南市,中西區,0944,327,281,608,31,639,1065,60%,30.7%,1
臺南市,中西區,0945,332,257,589,30,619,1055,58.67%,31.47%,1
臺南市,中西區,0946,373,321,694,20,714,1170,61.03%,31.88%,1
臺南市,中西區,0947,395,378,773,27,800,1280,62.5%,30.86%,1
臺南市,中西區,0948,360,313,673,25,698,1223,57.07%,29.44%,1
臺南市,中西區,0949,353,376,729,30,759,1292,58.75%,27.32%,1
臺南市,中西區,0950,285,292,577,18,595,993,59.92%,28.7%,1
臺南市,中西區,0951,425,392,817,46,863,1541,56%,27.58%,1
臺南市,中西區,0952,445,492,937,56,993,1652,60.11%,26.94%,1
臺南市,中西區,0953,349,324,673,25,698,1212,57.59%,28.8%,1
臺南市,中西區,0954,473,427,900,30,930,1621,57.37%,29.18%,1
臺南市,中西區,0955,463,442,905,39,944,1660,56.87%,27.89%,1
臺南市,中西區,0956,419,427,846,23,869,1595,54.48%,26.27%,1
臺南市,中西區,0957,406,330,736,35,771,1436,53.69%,28.27%,1
臺南市,中西區,0958,373,330,703,26,729,1265,57.63%,29.49%,1
臺南市,中西區,0959,293,204,497,33,530,856,61.92%,34.23%,1
臺南市,中西區,0960,354,259,613,24,637,1168,54.54%,30.31%,1
臺南市,中西區,0961,359,288,647,23,670,1134,59.08%,31.66%,1
臺南市,中西區,0962,333,265,598,31,629,995,63.22%,33.47%,1
臺南市,中西區,0963,336,446,782,33,815,1313,62.07%,25.59%,1
臺南市,中西區,0964,377,338,715,40,755,1265,59.68%,29.8%,1
臺南市,中西區,0965,342,284,626,26,652,1215,53.66%,28.15%,1
臺南市,中西區,0966,344,329,673,23,696,1248,55.77%,27.56%,1
臺南市,中西區,0967,218,153,371,19,390,687,56.77%,31.73%,1
臺南市,中西區,0968,363,244,607,42,649,1139,56.98%,31.87%,1
臺南市,中西區,0969,283,260,543,25,568,971,58.5%,29.15%,1
臺南市,中西區,0970,304,218,522,28,550,1254,43.86%,24.24%,1
臺南市,中西區,0971,312,240,552,26,578,979,59.04%,31.87%,1
臺南市,中西區,0972,505,362,867,45,912,1745,52.26%,28.94%,1
臺南市,中西區,0973,315,258,573,22,595,1074,55.4%,29.33%,1
臺南市,中西區,0974,363,338,701,32,733,1436,51.04%,25.28%,1
臺南市,中西區,0975,296,187,483,32,515,865,59.54%,34.22%,1
臺南市,中西區,0976,349,270,619,22,641,1164,55.07%,29.98%,1
臺南市,中西區,0977,393,265,658,22,680,1285,52.92%,30.58%,1
臺南市,中西區,0978,315,244,559,38,597,1078,55.38%,29.22%,1
臺南市,中西區,0979,439,342,781,39,820,1704,48.12%,25.76%,1
臺南市,中西區,0980,411,314,725,39,764,1296,58.95%,31.71%,1
臺南市,中西區,0981,308,290,598,33,631,1128,55.94%,27.3%,1
臺南市,中西區,0982,393,274,667,27,694,1245,55.74%,31.57%,1
高雄市,鹽埕區,0845,445,380,825,25,850,1304,65.18%,34.13%,1
高雄市,鹽埕區,0846,116,96,212,16,228,357,63.87%,32.49%,1
高雄市,鹽埕區,0847,266,138,404,22,426,651,65.44%,40.86%,1
高雄市,鹽埕區,0848,328,357,685,25,710,1322,53.71%,24.81%,1
高雄市,鹽埕區,0849,335,341,676,28,704,1056,66.67%,31.72%,1
高雄市,鹽埕區,0850,304,272,576,19,595,904,65.82%,33.63%,1
高雄市,鹽埕區,0851,341,324,665,18,683,1130,60.44%,30.18%,1
高雄市,鹽埕區,0852,253,262,515,16,531,840,63.21%,30.12%,1
高雄市,鹽埕區,0853,246,181,427,15,442,616,71.75%,39.94%,1
高雄市,鹽埕區,0854,443,309,752,32,784,1397,56.12%,31.71%,1
高雄市,鹽埕區,0855,275,194,469,12,481,766,62.79%,35.9%,1
高雄市,鹽埕區,0856,271,228,499,27,526,839,62.69%,32.3%,1
高雄市,鹽埕區,0857,286,231,517,11,528,805,65.59%,35.53%,1
高雄市,鹽埕區,0858,243,195,438,14,452,750,60.27%,32.4%,1
高雄市,鹽埕區,0859,320,247,567,26,593,986,60.14%,32.45%,1
高雄市,鹽埕區,0860,340,265,605,9,614,1068,57.49%,31.84%,1
高雄市,鹽埕區,0861,346,276,622,21,643,1060,60.66%,32.64%,1
高雄市,鹽埕區,0862,223,232,455,25,480,805,59.63%,27.7%,1
高雄市,鹽埕區,0863,345,251,596,19,615,1073,57.32%,32.15%,1
高雄市,鹽埕區,0864,278,204,482,27,509,921,55.27%,30.18%,1
高雄市,鹽埕區,0865,371,305,676,19,695,1171,59.35%,31.68%,1
高雄市,鹽埕區,0866,218,138,356,8,364,594,61.28%,36.7%,1
高雄市,鹽埕區,0867,212,168,380,14,394,592,66.55%,35.81%,1
高雄市,鹽埕區,0868,223,123,346,9,355,610,58.2%,36.56%,1
高雄市,鼓山區,0768,224,295,519,16,535,959,55.79%,23.36%,1
高雄市,鼓山區,0769,294,343,637,31,668,1000,66.8%,29.4%,1
高雄市,鼓山區,0770,195,332,527,16,543,910,59.67%,21.43%,1
高雄市,鼓山區,0771,257,435,692,29,721,1085,66.45%,23.69%,1
高雄市,鼓山區,0772,350,385,735,26,761,1484,51.28%,23.58%,1
高雄市,鼓山區,0773,347,493,840,20,860,1393,61.74%,24.91%,1
高雄市,鼓山區,0774,311,502,813,46,859,1270,67.64%,24.49%,1
高雄市,鼓山區,0775,378,246,624,24,648,1055,61.42%,35.83%,1
高雄市,鼓山區,0776,377,313,690,26,716,1172,61.09%,32.17%,1
高雄市,鼓山區,0777,410,337,747,25,772,1175,65.7%,34.89%,1
高雄市,鼓山區,0778,431,347,778,32,810,1274,63.58%,33.83%,1
高雄市,鼓山區,0779,319,236,555,36,591,1085,54.47%,29.4%,1
高雄市,鼓山區,0780,409,419,828,41,869,1470,59.12%,27.82%,1
高雄市,鼓山區,0781,331,294,625,36,661,974,67.86%,33.98%,1
高雄市,鼓山區,0782,379,377,756,53,809,1275,63.45%,29.73%,1
高雄市,鼓山區,0783,389,322,711,40,751,1206,62.27%,32.26%,1
高雄市,鼓山區,0784,350,392,742,26,768,1238,62.04%,28.27%,1
高雄市,鼓山區,0785,75,410,485,11,496,721,68.79%,10.4%,1
高雄市,鼓山區,0786,332,349,681,30,711,1220,58.28%,27.21%,1
高雄市,鼓山區,0787,542,463,1005,30,1035,1966,52.64%,27.57%,1
高雄市,鼓山區,0788,539,428,967,35,1002,1722,58.19%,31.3%,1
高雄市,鼓山區,0789,492,466,958,29,987,1720,57.38%,28.6%,1
高雄市,鼓山區,0790,429,350,779,52,831,1287,64.57%,33.33%,1
高雄市,鼓山區,0791,340,289,629,23,652,1369,47.63%,24.84%,1
高雄市,鼓山區,0792,371,398,769,23,792,1222,64.81%,30.36%,1
高雄市,鼓山區,0793,578,454,1032,29,1061,1770,59.94%,32.66%,1
高雄市,鼓山區,0794,472,584,1056,29,1085,1860,58.33%,25.38%,1
高雄市,鼓山區,0795,506,557,1063,31,1094,1857,58.91%,27.25%,1
高雄市,鼓山區,0796,473,610,1083,31,1114,1841,60.51%,25.69%,1
高雄市,鼓山區,0797,494,599,1093,40,1133,1830,61.91%,26.99%,1
高雄市,鼓山區,0798,474,572,1046,44,1090,1809,60.25%,26.2%,1
高雄市,鼓山區,0799,484,667,1151,30,1181,1894,62.35%,25.55%,1
高雄市,鼓山區,0800,454,685,1139,22,1161,1882,61.69%,24.12%,1
高雄市,鼓山區,0801,535,644,1179,34,1213,1894,64.04%,28.25%,1
高雄市,鼓山區,0802,374,615,989,26,1015,1745,58.17%,21.43%,1
高雄市,鼓山區,0803,454,598,1052,18,1070,1887,56.7%,24.06%,1
高雄市,鼓山區,0804,525,671,1196,37,1233,1891,65.2%,27.76%,1
高雄市,鼓山區,0805,490,636,1126,44,1170,1903,61.48%,25.75%,1
高雄市,鼓山區,0806,574,626,1200,23,1223,1998,61.21%,28.73%,1
高雄市,鼓山區,0807,520,651,1171,23,1194,1912,62.45%,27.2%,1
高雄市,鼓山區,0808,524,653,1177,35,1212,1923,63.03%,27.25%,1
高雄市,鼓山區,0809,510,653,1163,26,1189,1888,62.98%,27.01%,1
高雄市,鼓山區,0810,511,667,1178,17,1195,1873,63.8%,27.28%,1
高雄市,鼓山區,0811,525,768,1293,21,1314,1959,67.08%,26.8%,1
高雄市,鼓山區,0812,452,755,1207,39,1246,1897,65.68%,23.83%,1
高雄市,鼓山區,0813,559,863,1422,34,1456,2362,61.64%,23.67%,1
高雄市,鼓山區,0814,455,655,1110,46,1156,1850,62.49%,24.59%,1
高雄市,鼓山區,0815,533,674,1207,18,1225,1928,63.54%,27.65%,1
高雄市,鼓山區,0816,463,660,1123,16,1139,1937,58.8%,23.9%,1
高雄市,鼓山區,0817,497,751,1248,34,1282,2123,60.39%,23.41%,1
高雄市,鼓山區,0818,504,652,1156,24,1180,1861,63.41%,27.08%,1
高雄市,鼓山區,0819,452,651,1103,23,1126,1892,59.51%,23.89%,1
高雄市,鼓山區,0820,546,734,1280,30,1310,2147,61.02%,25.43%,1
高雄市,鼓山區,0821,499,678,1177,20,1197,1897,63.1%,26.3%,1
高雄市,鼓山區,0822,547,682,1229,22,1251,2041,61.29%,26.8%,1
高雄市,鼓山區,0823,335,421,756,37,793,1309,60.58%,25.59%,1
高雄市,鼓山區,0824,498,616,1114,38,1152,1867,61.7%,26.67%,1
高雄市,鼓山區,0825,292,470,762,28,790,1152,68.58%,25.35%,1
高雄市,鼓山區,0826,314,561,875,41,916,1404,65.24%,22.36%,1
高雄市,鼓山區,0827,358,222,580,22,602,1210,49.75%,29.59%,1
高雄市,鼓山區,0828,384,310,694,22,716,1135,63.08%,33.83%,1
高雄市,鼓山區,0829,344,302,646,43,689,1831,37.63%,18.79%,1
高雄市,鼓山區,0830,413,361,774,27,801,1288,62.19%,32.07%,1
高雄市,鼓山區,0831,336,359,695,25,720,1241,58.02%,27.07%,1
高雄市,鼓山區,0832,357,430,787,38,825,1342,61.48%,26.6%,1
高雄市,鼓山區,0833,458,417,875,44,919,1422,64.63%,32.21%,1
高雄市,鼓山區,0834,456,419,875,55,930,1453,64.01%,31.38%,1
高雄市,鼓山區,0835,187,188,375,30,405,616,65.75%,30.36%,1
高雄市,鼓山區,0836,256,227,483,33,516,834,61.87%,30.7%,1
高雄市,鼓山區,0837,301,263,564,29,593,969,61.2%,31.06%,1
高雄市,鼓山區,0838,331,236,567,37,604,978,61.76%,33.84%,1
高雄市,鼓山區,0839,311,179,490,25,515,760,67.76%,40.92%,1
高雄市,鼓山區,0840,409,312,721,34,755,1248,60.5%,32.77%,1
高雄市,鼓山區,0841,386,264,650,17,667,1143,58.36%,33.77%,1
高雄市,鼓山區,0842,415,285,700,41,741,1358,54.57%,30.56%,1
高雄市,鼓山區,0843,283,268,551,16,567,1036,54.73%,27.32%,1
高雄市,鼓山區,0844,174,149,323,17,340,580,58.62%,30%,1
高雄市,左營區,0534,380,502,882,39,921,2604,35.37%,14.59%,1
高雄市,左營區,0535,324,280,604,45,649,1037,62.58%,31.24%,1
高雄市,左營區,0536,201,149,350,14,364,542,67.16%,37.08%,1
高雄市,左營區,0537,238,154,392,15,407,635,64.09%,37.48%,1
高雄市,左營區,0538,178,107,285,18,303,518,58.49%,34.36%,1
高雄市,左營區,0539,331,168,499,21,520,813,63.96%,40.71%,1
高雄市,左營區,0540,329,201,530,38,568,889,63.89%,37.01%,1
高雄市,左營區,0541,246,183,429,42,471,731,64.43%,33.65%,1
高雄市,左營區,0542,460,384,844,31,875,1592,54.96%,28.89%,1
高雄市,左營區,0543,503,522,1025,28,1053,1709,61.61%,29.43%,1
高雄市,左營區,0544,256,598,854,57,911,1588,57.37%,16.12%,1
高雄市,左營區,0545,54,148,202,8,210,358,58.66%,15.08%,1
高雄市,左營區,0546,120,326,446,10,456,666,68.47%,18.02%,1
高雄市,左營區,0547,348,623,971,51,1022,1748,58.47%,19.91%,1
高雄市,左營區,0548,264,466,730,37,767,1196,64.13%,22.07%,1
高雄市,左營區,0549,331,435,766,41,807,1240,65.08%,26.69%,1
高雄市,左營區,0550,156,674,830,41,871,1402,62.13%,11.13%,1
高雄市,左營區,0551,110,613,723,27,750,1173,63.94%,9.38%,1
高雄市,左營區,0552,122,316,438,23,461,641,71.92%,19.03%,1
高雄市,左營區,0553,383,190,573,28,601,951,63.2%,40.27%,1
高雄市,左營區,0554,262,172,434,20,454,732,62.02%,35.79%,1
高雄市,左營區,0555,117,86,203,8,211,339,62.24%,34.51%,1
高雄市,左營區,0556,177,136,313,8,321,519,61.85%,34.1%,1
高雄市,左營區,0557,196,124,320,22,342,514,66.54%,38.13%,1
高雄市,左營區,0558,261,185,446,32,478,720,66.39%,36.25%,1
高雄市,左營區,0559,176,75,251,18,269,411,65.45%,42.82%,1
高雄市,左營區,0560,231,151,382,23,405,603,67.16%,38.31%,1
高雄市,左營區,0561,280,245,525,42,567,904,62.72%,30.97%,1
高雄市,左營區,0562,270,424,694,32,726,1318,55.08%,20.49%,1
高雄市,左營區,0563,284,263,547,13,560,966,57.97%,29.4%,1
高雄市,左營區,0564,200,592,792,29,821,1440,57.01%,13.89%,1
高雄市,左營區,0565,268,800,1068,45,1113,1990,55.93%,13.47%,1
高雄市,左營區,0566,167,480,647,33,680,1090,62.39%,15.32%,1
高雄市,左營區,0567,169,571,740,58,798,1272,62.74%,13.29%,1
高雄市,左營區,0568,341,614,955,24,979,1558,62.84%,21.89%,1
高雄市,左營區,0569,369,582,951,17,968,1501,64.49%,24.58%,1
高雄市,左營區,0570,86,159,245,7,252,360,70%,23.89%,1
高雄市,左營區,0571,114,648,762,28,790,1335,59.18%,8.54%,1
高雄市,左營區,0572,253,540,793,21,814,1359,59.9%,18.62%,1
高雄市,左營區,0573,265,615,880,51,931,1487,62.61%,17.82%,1
高雄市,左營區,0574,220,713,933,50,983,1637,60.05%,13.44%,1
高雄市,左營區,0575,409,551,960,31,991,1553,63.81%,26.34%,1
高雄市,左營區,0576,429,554,983,41,1024,1564,65.47%,27.43%,1
高雄市,左營區,0577,461,679,1140,43,1183,1788,66.16%,25.78%,1
高雄市,左營區,0578,471,733,1204,50,1254,2028,61.83%,23.22%,1
高雄市,左營區,0579,544,661,1205,55,1260,2037,61.86%,26.71%,1
高雄市,左營區,0580,520,772,1292,29,1321,2101,62.87%,24.75%,1
高雄市,左營區,0581,515,731,1246,35,1281,2018,63.48%,25.52%,1
高雄市,左營區,0582,593,601,1194,60,1254,1925,65.14%,30.81%,1
高雄市,左營區,0583,566,591,1157,31,1188,1989,59.73%,28.46%,1
高雄市,左營區,0584,504,489,993,22,1015,1780,57.02%,28.31%,1
高雄市,左營區,0585,497,576,1073,29,1102,1778,61.98%,27.95%,1
高雄市,左營區,0586,374,527,901,27,928,1496,62.03%,25%,1
高雄市,左營區,0587,375,576,951,24,975,1538,63.39%,24.38%,1
高雄市,左營區,0588,565,657,1222,49,1271,2058,61.76%,27.45%,1
高雄市,左營區,0589,581,629,1210,25,1235,1992,62%,29.17%,1
高雄市,左營區,0590,562,684,1246,43,1289,2058,62.63%,27.31%,1
高雄市,左營區,0591,573,689,1262,28,1290,2090,61.72%,27.42%,1
高雄市,左營區,0592,606,681,1287,24,1311,2157,60.78%,28.09%,1
高雄市,左營區,0593,536,771,1307,23,1330,2096,63.45%,25.57%,1
高雄市,左營區,0594,618,681,1299,47,1346,2101,64.06%,29.41%,1
高雄市,左營區,0595,498,460,958,50,1008,1649,61.13%,30.2%,1
高雄市,左營區,0596,508,366,874,38,912,1516,60.16%,33.51%,1
高雄市,左營區,0597,522,522,1044,44,1088,1678,64.84%,31.11%,1
高雄市,左營區,0598,533,613,1146,43,1189,1898,62.64%,28.08%,1
高雄市,左營區,0599,548,581,1129,35,1164,1837,63.36%,29.83%,1
高雄市,左營區,0600,492,597,1089,25,1114,1922,57.96%,25.6%,1
高雄市,左營區,0601,501,610,1111,36,1147,1785,64.26%,28.07%,1
高雄市,左營區,0602,435,679,1114,19,1133,1886,60.07%,23.06%,1
高雄市,左營區,0603,457,689,1146,40,1186,1895,62.59%,24.12%,1
高雄市,左營區,0604,475,666,1141,31,1172,1831,64.01%,25.94%,1
高雄市,左營區,0605,688,511,1199,42,1241,2050,60.54%,33.56%,1
高雄市,左營區,0606,645,834,1479,25,1504,2251,66.81%,28.65%,1
高雄市,左營區,0607,559,794,1353,22,1375,2126,64.68%,26.29%,1
高雄市,左營區,0608,483,600,1083,28,1111,1928,57.62%,25.05%,1
高雄市,左營區,0609,561,703,1264,28,1292,2166,59.65%,25.9%,1
高雄市,左營區,0610,444,735,1179,41,1220,2031,60.07%,21.86%,1
高雄市,左營區,0611,478,708,1186,46,1232,1987,62%,24.06%,1
高雄市,左營區,0612,600,772,1372,35,1407,2166,64.96%,27.7%,1
高雄市,左營區,0613,510,622,1132,34,1166,1856,62.82%,27.48%,1
高雄市,左營區,0614,692,710,1402,39,1441,2289,62.95%,30.23%,1
高雄市,左營區,0615,385,798,1183,37,1220,1973,61.83%,19.51%,1
高雄市,左營區,0616,429,649,1078,50,1128,1818,62.05%,23.6%,1
高雄市,左營區,0617,407,505,912,26,938,1565,59.94%,26.01%,1
高雄市,左營區,0618,402,631,1033,20,1053,1608,65.49%,25%,1
高雄市,左營區,0619,477,673,1150,37,1187,1812,65.51%,26.32%,1
高雄市,左營區,0620,444,605,1049,19,1068,1821,58.65%,24.38%,1
高雄市,左營區,0621,509,627,1136,52,1188,1907,62.3%,26.69%,1
高雄市,左營區,0622,406,649,1055,26,1081,1812,59.66%,22.41%,1
高雄市,左營區,0623,445,700,1145,36,1181,1833,64.43%,24.28%,1
高雄市,左營區,0624,517,604,1121,38,1159,1850,62.65%,27.95%,1
高雄市,左營區,0625,465,555,1020,33,1053,1738,60.59%,26.75%,1
高雄市,左營區,0626,478,701,1179,38,1217,1864,65.29%,25.64%,1
高雄市,左營區,0627,491,680,1171,28,1199,1887,63.54%,26.02%,1
高雄市,左營區,0628,459,598,1057,10,1067,1870,57.06%,24.55%,1
高雄市,左營區,0629,424,691,1115,23,1138,1866,60.99%,22.72%,1
高雄市,左營區,0630,455,648,1103,15,1118,1862,60.04%,24.44%,1
高雄市,左營區,0631,453,643,1096,37,1133,1816,62.39%,24.94%,1
高雄市,左營區,0632,482,653,1135,23,1158,1833,63.18%,26.3%,1
高雄市,左營區,0633,421,599,1020,40,1060,1676,63.25%,25.12%,1
高雄市,左營區,0634,619,495,1114,30,1144,1843,62.07%,33.59%,1
高雄市,左營區,0635,446,686,1132,33,1165,1872,62.23%,23.82%,1
高雄市,左營區,0636,484,815,1299,56,1355,2259,59.98%,21.43%,1
高雄市,楠梓區,0435,408,413,821,27,848,1309,64.78%,31.17%,1
高雄市,楠梓區,0436,417,421,838,23,861,1408,61.15%,29.62%,1
高雄市,楠梓區,0437,514,559,1073,40,1113,1851,60.13%,27.77%,1
高雄市,楠梓區,0438,519,441,960,27,987,1578,62.55%,32.89%,1
高雄市,楠梓區,0439,455,508,963,15,978,1715,57.03%,26.53%,1
高雄市,楠梓區,0440,417,467,884,15,899,1611,55.8%,25.88%,1
高雄市,楠梓區,0441,488,581,1069,44,1113,2024,54.99%,24.11%,1
高雄市,楠梓區,0442,453,525,978,29,1007,1890,53.28%,23.97%,1
高雄市,楠梓區,0443,359,529,888,30,918,1762,52.1%,20.37%,1
高雄市,楠梓區,0444,466,551,1017,33,1050,1888,55.61%,24.68%,1
高雄市,楠梓區,0445,484,511,995,48,1043,1822,57.24%,26.56%,1
高雄市,楠梓區,0446,444,579,1023,33,1056,1846,57.2%,24.05%,1
高雄市,楠梓區,0447,358,403,761,44,805,1268,63.49%,28.23%,1
高雄市,楠梓區,0448,360,444,804,34,838,1240,67.58%,29.03%,1
高雄市,楠梓區,0449,410,452,862,30,892,1432,62.29%,28.63%,1
高雄市,楠梓區,0450,434,443,877,35,912,1490,61.21%,29.13%,1
高雄市,楠梓區,0451,409,465,874,31,905,1464,61.82%,27.94%,1
高雄市,楠梓區,0452,374,404,778,44,822,1435,57.28%,26.06%,1
高雄市,楠梓區,0453,423,440,863,34,897,1602,55.99%,26.4%,1
高雄市,楠梓區,0454,447,387,834,41,875,1500,58.33%,29.8%,1
高雄市,楠梓區,0455,439,452,891,42,933,1591,58.64%,27.59%,1
高雄市,楠梓區,0456,351,283,634,37,671,1669,40.2%,21.03%,1
高雄市,楠梓區,0457,388,484,872,38,910,1469,61.95%,26.41%,1
高雄市,楠梓區,0458,469,384,853,46,899,1559,57.67%,30.08%,1
高雄市,楠梓區,0459,474,436,910,37,947,1638,57.81%,28.94%,1
高雄市,楠梓區,0460,561,574,1135,50,1185,1960,60.46%,28.62%,1
高雄市,楠梓區,0461,532,573,1105,65,1170,1912,61.19%,27.82%,1
高雄市,楠梓區,0462,366,507,873,41,914,1559,58.63%,23.48%,1
高雄市,楠梓區,0463,320,454,774,34,808,1423,56.78%,22.49%,1
高雄市,楠梓區,0464,571,414,985,16,1001,1696,59.02%,33.67%,1
高雄市,楠梓區,0465,550,291,841,53,894,1493,59.88%,36.84%,1
高雄市,楠梓區,0466,486,400,886,50,936,1527,61.3%,31.83%,1
高雄市,楠梓區,0467,395,240,635,29,664,1020,65.1%,38.73%,1
高雄市,楠梓區,0468,425,272,697,43,740,1197,61.82%,35.51%,1
高雄市,楠梓區,0469,518,312,830,35,865,1528,56.61%,33.9%,1
高雄市,楠梓區,0470,547,425,972,33,1005,1918,52.4%,28.52%,1
高雄市,楠梓區,0471,514,338,852,44,896,1458,61.45%,35.25%,1
高雄市,楠梓區,0472,566,510,1076,43,1119,1790,62.51%,31.62%,1
高雄市,楠梓區,0473,529,579,1108,44,1152,1845,62.44%,28.67%,1
高雄市,楠梓區,0474,478,723,1201,55,1256,2037,61.66%,23.47%,1
高雄市,楠梓區,0475,426,641,1067,45,1112,1964,56.62%,21.69%,1
高雄市,楠梓區,0476,445,687,1132,25,1157,2006,57.68%,22.18%,1
高雄市,楠梓區,0477,470,605,1075,35,1110,1951,56.89%,24.09%,1
高雄市,楠梓區,0478,451,612,1063,51,1114,1951,57.1%,23.12%,1
高雄市,楠梓區,0479,410,733,1143,56,1199,2008,59.71%,20.42%,1
高雄市,楠梓區,0480,495,642,1137,39,1176,1923,61.15%,25.74%,1
高雄市,楠梓區,0481,684,442,1126,28,1154,1921,60.07%,35.61%,1
高雄市,楠梓區,0482,194,368,562,20,582,832,69.95%,23.32%,1
高雄市,楠梓區,0483,323,359,682,18,700,1156,60.55%,27.94%,1
高雄市,楠梓區,0484,373,324,697,35,732,1125,65.07%,33.16%,1
高雄市,楠梓區,0485,334,342,676,22,698,1060,65.85%,31.51%,1
高雄市,楠梓區,0486,328,566,894,38,932,1502,62.05%,21.84%,1
高雄市,楠梓區,0487,384,430,814,44,858,1404,61.11%,27.35%,1
高雄市,楠梓區,0488,324,460,784,45,829,1552,53.41%,20.88%,1
高雄市,楠梓區,0489,376,353,729,46,775,1460,53.08%,25.75%,1
高雄市,楠梓區,0490,299,298,597,34,631,1315,47.98%,22.74%,1
高雄市,楠梓區,0491,295,341,636,39,675,1062,63.56%,27.78%,1
高雄市,楠梓區,0492,267,354,621,40,661,1078,61.32%,24.77%,1
高雄市,楠梓區,0493,313,277,590,35,625,914,68.38%,34.25%,1
高雄市,楠梓區,0494,340,337,677,41,718,1064,67.48%,31.95%,1
高雄市,楠梓區,0495,427,584,1011,50,1061,1705,62.23%,25.04%,1
高雄市,楠梓區,0496,426,584,1010,32,1042,1728,60.3%,24.65%,1
高雄市,楠梓區,0497,421,690,1111,50,1161,1917,60.56%,21.96%,1
高雄市,楠梓區,0498,370,425,795,43,838,1439,58.23%,25.71%,1
高雄市,楠梓區,0499,404,403,807,30,837,1287,65.03%,31.39%,1
高雄市,楠梓區,0500,401,525,926,43,969,1504,64.43%,26.66%,1
高雄市,楠梓區,0501,379,542,921,37,958,1405,68.19%,26.98%,1
高雄市,楠梓區,0502,362,377,739,51,790,1287,61.38%,28.13%,1
高雄市,楠梓區,0503,340,444,784,30,814,1295,62.86%,26.25%,1
高雄市,楠梓區,0504,391,520,911,32,943,1483,63.59%,26.37%,1
高雄市,楠梓區,0505,489,573,1062,43,1105,1649,67.01%,29.65%,1
高雄市,楠梓區,0506,297,319,616,41,657,998,65.83%,29.76%,1
高雄市,楠梓區,0507,279,359,638,43,681,1025,66.44%,27.22%,1
高雄市,楠梓區,0508,364,704,1068,50,1118,1671,66.91%,21.78%,1
高雄市,楠梓區,0509,427,469,896,60,956,1453,65.79%,29.39%,1
高雄市,楠梓區,0510,497,488,985,47,1032,1673,61.69%,29.71%,1
高雄市,楠梓區,0511,386,555,941,43,984,1653,59.53%,23.35%,1
高雄市,楠梓區,0512,290,319,609,34,643,1034,62.19%,28.05%,1
高雄市,楠梓區,0513,288,451,739,38,777,1127,68.94%,25.55%,1
高雄市,楠梓區,0514,452,435,887,48,935,1575,59.37%,28.7%,1
高雄市,楠梓區,0515,383,530,913,45,958,1559,61.45%,24.57%,1
高雄市,楠梓區,0516,358,417,775,32,807,1378,58.56%,25.98%,1
高雄市,楠梓區,0517,457,566,1023,47,1070,1714,62.43%,26.66%,1
高雄市,楠梓區,0518,459,559,1018,52,1070,1721,62.17%,26.67%,1
高雄市,楠梓區,0519,393,568,961,36,997,1628,61.24%,24.14%,1
高雄市,楠梓區,0520,421,598,1019,65,1084,1590,68.18%,26.48%,1
高雄市,楠梓區,0521,395,554,949,49,998,1628,61.3%,24.26%,1
高雄市,楠梓區,0522,436,665,1101,35,1136,1739,65.32%,25.07%,1
高雄市,楠梓區,0523,396,616,1012,47,1059,1642,64.49%,24.12%,1
高雄市,楠梓區,0524,370,584,954,48,1002,1766,56.74%,20.95%,1
高雄市,楠梓區,0525,307,495,802,62,864,1482,58.3%,20.72%,1
高雄市,楠梓區,0526,334,559,893,29,922,1749,52.72%,19.1%,1
高雄市,楠梓區,0527,438,506,944,24,968,1591,60.84%,27.53%,1
高雄市,楠梓區,0528,441,536,977,27,1004,1545,64.98%,28.54%,1
高雄市,楠梓區,0529,430,622,1052,26,1078,1651,65.29%,26.04%,1
高雄市,楠梓區,0530,440,570,1010,32,1042,1646,63.3%,26.73%,1
高雄市,楠梓區,0531,490,439,929,40,969,1496,64.77%,32.75%,1
高雄市,楠梓區,0532,448,348,796,51,847,1403,60.37%,31.93%,1
高雄市,楠梓區,0533,304,482,786,39,825,1624,50.8%,18.72%,1
高雄市,三民區,0887,625,446,1071,45,1116,1893,58.95%,33.02%,1
高雄市,三民區,0888,481,552,1033,59,1092,1982,55.1%,24.27%,1
高雄市,三民區,0889,415,522,937,48,985,1661,59.3%,24.98%,1
高雄市,三民區,0890,467,588,1055,19,1074,1894,56.71%,24.66%,1
高雄市,三民區,0891,466,558,1024,39,1063,1839,57.8%,25.34%,1
高雄市,三民區,0892,528,590,1118,42,1160,2014,57.6%,26.22%,1
高雄市,三民區,0893,557,514,1071,64,1135,1897,59.83%,29.36%,1
高雄市,三民區,0894,534,553,1087,32,1119,2016,55.51%,26.49%,1
高雄市,三民區,0895,708,341,1049,30,1079,1924,56.08%,36.8%,1
高雄市,三民區,0896,508,507,1015,43,1058,1749,60.49%,29.05%,1
高雄市,三民區,0897,570,560,1130,63,1193,1845,64.66%,30.89%,1
高雄市,三民區,0898,500,466,966,45,1011,1724,58.64%,29%,1
高雄市,三民區,0899,522,561,1083,36,1119,1889,59.24%,27.63%,1
高雄市,三民區,0900,505,441,946,37,983,1622,60.6%,31.13%,1
高雄市,三民區,0901,595,530,1125,32,1157,1870,61.87%,31.82%,1
高雄市,三民區,0902,482,454,936,40,976,1523,64.08%,31.65%,1
高雄市,三民區,0903,602,493,1095,42,1137,2006,56.68%,30.01%,1
高雄市,三民區,0904,508,770,1278,37,1315,2076,63.34%,24.47%,1
高雄市,三民區,0905,474,706,1180,27,1207,2073,58.22%,22.87%,1
高雄市,三民區,0906,497,681,1178,49,1227,2045,60%,24.3%,1
高雄市,三民區,0907,514,493,1007,47,1054,2070,50.92%,24.83%,1
高雄市,三民區,0908,521,695,1216,44,1260,2035,61.92%,25.6%,1
高雄市,三民區,0909,498,777,1275,31,1306,2075,62.94%,24%,1
高雄市,三民區,0910,473,737,1210,35,1245,2053,60.64%,23.04%,1
高雄市,三民區,0911,485,768,1253,56,1309,2063,63.45%,23.51%,1
高雄市,三民區,0912,522,788,1310,40,1350,2143,63%,24.36%,1
高雄市,三民區,0913,507,549,1056,52,1108,1746,63.46%,29.04%,1
高雄市,三民區,0914,473,468,941,21,962,1735,55.45%,27.26%,1
高雄市,三民區,0915,470,419,889,41,930,1655,56.19%,28.4%,1
高雄市,三民區,0916,449,464,913,37,950,1583,60.01%,28.36%,1
高雄市,三民區,0917,462,535,997,33,1030,1800,57.22%,25.67%,1
高雄市,三民區,0918,492,544,1036,23,1059,1730,61.21%,28.44%,1
高雄市,三民區,0919,483,523,1006,21,1027,1715,59.88%,28.16%,1
高雄市,三民區,0920,487,498,985,38,1023,1691,60.5%,28.8%,1
高雄市,三民區,0921,456,609,1065,60,1125,1865,60.32%,24.45%,1
高雄市,三民區,0922,345,338,683,23,706,1073,65.8%,32.15%,1
高雄市,三民區,0923,353,289,642,33,675,917,73.61%,38.5%,1
高雄市,三民區,0924,503,449,952,39,991,1647,60.17%,30.54%,1
高雄市,三民區,0925,487,495,982,39,1021,1654,61.73%,29.44%,1
高雄市,三民區,0926,464,529,993,52,1045,1639,63.76%,28.31%,1
高雄市,三民區,0927,497,591,1088,33,1121,1833,61.16%,27.11%,1
高雄市,三民區,0928,407,461,868,29,897,1362,65.86%,29.88%,1
高雄市,三民區,0929,431,523,954,44,998,1557,64.1%,27.68%,1
高雄市,三民區,0930,434,503,937,21,958,1482,64.64%,29.28%,1
高雄市,三民區,0931,458,507,965,39,1004,1563,64.24%,29.3%,1
高雄市,三民區,0932,397,503,900,43,943,1497,62.99%,26.52%,1
高雄市,三民區,0933,440,548,988,12,1000,1523,65.66%,28.89%,1
高雄市,三民區,0934,414,441,855,22,877,1293,67.83%,32.02%,1
高雄市,三民區,0935,465,549,1014,28,1042,1662,62.7%,27.98%,1
高雄市,三民區,0936,390,458,848,27,875,1441,60.72%,27.06%,1
高雄市,三民區,0937,414,473,887,25,912,1326,68.78%,31.22%,1
高雄市,三民區,0938,453,512,965,22,987,1476,66.87%,30.69%,1
高雄市,三民區,0939,526,544,1070,26,1096,1968,55.69%,26.73%,1
高雄市,三民區,0940,418,458,876,27,903,1618,55.81%,25.83%,1
高雄市,三民區,0941,473,590,1063,36,1099,1873,58.68%,25.25%,1
高雄市,三民區,0942,426,441,867,38,905,1487,60.86%,28.65%,1
高雄市,三民區,0943,541,428,969,28,997,1640,60.79%,32.99%,1
高雄市,三民區,0944,541,546,1087,26,1113,1889,58.92%,28.64%,1
高雄市,三民區,0945,529,571,1100,25,1125,1969,57.14%,26.87%,1
高雄市,三民區,0946,463,404,867,54,921,1466,62.82%,31.58%,1
高雄市,三民區,0947,512,502,1014,39,1053,1697,62.05%,30.17%,1
高雄市,三民區,0948,587,405,992,37,1029,1663,61.88%,35.3%,1
高雄市,三民區,0949,443,512,955,34,989,1649,59.98%,26.86%,1
高雄市,三民區,0950,486,384,870,57,927,1486,62.38%,32.71%,1
高雄市,三民區,0951,415,435,850,20,870,1495,58.19%,27.76%,1
高雄市,三民區,0952,460,518,978,32,1010,1548,65.25%,29.72%,1
高雄市,三民區,0953,404,472,876,26,902,1493,60.42%,27.06%,1
高雄市,三民區,0954,403,493,896,20,916,1445,63.39%,27.89%,1
高雄市,三民區,0955,400,478,878,23,901,1529,58.93%,26.16%,1
高雄市,三民區,0956,429,447,876,26,902,1506,59.89%,28.49%,1
高雄市,三民區,0957,400,555,955,29,984,1549,63.52%,25.82%,1
高雄市,三民區,0958,461,538,999,35,1034,1620,63.83%,28.46%,1
高雄市,三民區,0959,472,494,966,39,1005,1550,64.84%,30.45%,1
高雄市,三民區,0960,401,511,912,34,946,1488,63.58%,26.95%,1
高雄市,三民區,0961,387,427,814,30,844,1335,63.22%,28.99%,1
高雄市,三民區,0962,376,413,789,35,824,1332,61.86%,28.23%,1
高雄市,三民區,0963,535,520,1055,44,1099,1764,62.3%,30.33%,1
高雄市,三民區,0964,465,598,1063,28,1091,1811,60.24%,25.68%,1
高雄市,三民區,0965,478,563,1041,43,1084,1693,64.03%,28.23%,1
高雄市,三民區,0966,538,534,1072,42,1114,1684,66.15%,31.95%,1
高雄市,三民區,0967,421,437,858,23,881,1464,60.18%,28.76%,1
高雄市,三民區,0968,499,604,1103,29,1132,1719,65.85%,29.03%,1
高雄市,三民區,0969,512,531,1043,17,1060,1749,60.61%,29.27%,1
高雄市,三民區,0970,478,580,1058,36,1094,1908,57.34%,25.05%,1
高雄市,三民區,0971,398,524,922,54,976,1573,62.05%,25.3%,1
高雄市,三民區,0972,445,487,932,31,963,1628,59.15%,27.33%,1
高雄市,三民區,0973,419,325,744,32,776,1377,56.35%,30.43%,1
高雄市,三民區,0974,392,547,939,43,982,1530,64.18%,25.62%,1
高雄市,三民區,0975,345,345,690,35,725,1188,61.03%,29.04%,1
高雄市,三民區,0976,456,389,845,27,872,2791,31.24%,16.34%,1
高雄市,三民區,0977,510,569,1079,41,1120,1840,60.87%,27.72%,1
高雄市,三民區,0978,431,570,1001,48,1049,1671,62.78%,25.79%,1
高雄市,三民區,0979,473,474,947,36,983,1624,60.53%,29.13%,1
高雄市,三民區,0980,468,561,1029,33,1062,1555,68.3%,30.1%,1
高雄市,三民區,0981,462,517,979,24,1003,1489,67.36%,31.03%,1
高雄市,三民區,0982,461,558,1019,26,1045,1662,62.88%,27.74%,1
高雄市,三民區,0983,424,530,954,16,970,1639,59.18%,25.87%,1
高雄市,三民區,0984,565,499,1064,46,1110,1872,59.29%,30.18%,1
高雄市,三民區,0985,488,623,1111,34,1145,1968,58.18%,24.8%,1
高雄市,三民區,0986,401,328,729,57,786,1471,53.43%,27.26%,1
高雄市,三民區,0987,424,435,859,39,898,1534,58.54%,27.64%,1
高雄市,三民區,0988,474,406,880,47,927,1659,55.88%,28.57%,1
高雄市,三民區,0989,473,474,947,32,979,1815,53.94%,26.06%,1
高雄市,三民區,0990,469,487,956,42,998,1808,55.2%,25.94%,1
高雄市,三民區,0991,346,321,667,32,699,1224,57.11%,28.27%,1
高雄市,三民區,0992,363,427,790,26,816,1406,58.04%,25.82%,1
高雄市,三民區,0993,288,250,538,29,567,945,60%,30.48%,1
高雄市,三民區,0994,352,253,605,19,624,944,66.1%,37.29%,1
高雄市,三民區,0995,547,451,998,42,1040,1669,62.31%,32.77%,1
高雄市,三民區,0996,547,366,913,42,955,1473,64.83%,37.14%,1
高雄市,三民區,0997,426,497,923,34,957,1876,51.01%,22.71%,1
高雄市,三民區,0998,341,311,652,29,681,1682,40.49%,20.27%,1
高雄市,三民區,0999,523,443,966,20,986,1791,55.05%,29.2%,1
高雄市,三民區,1000,505,570,1075,33,1108,1808,61.28%,27.93%,1
高雄市,三民區,1001,504,485,989,26,1015,1798,56.45%,28.03%,1
高雄市,三民區,1002,509,666,1175,34,1209,2030,59.56%,25.07%,1
高雄市,三民區,1003,452,727,1179,23,1202,2034,59.1%,22.22%,1
高雄市,三民區,1004,467,697,1164,29,1193,1998,59.71%,23.37%,1
高雄市,三民區,1005,511,535,1046,34,1080,1914,56.43%,26.7%,1
高雄市,三民區,1006,554,536,1090,37,1127,1965,57.35%,28.19%,1
高雄市,三民區,1007,541,500,1041,67,1108,1885,58.78%,28.7%,1
高雄市,三民區,1008,352,430,782,20,802,1220,65.74%,28.85%,1
高雄市,三民區,1009,341,263,604,47,651,1057,61.59%,32.26%,1
高雄市,三民區,1010,410,315,725,26,751,1434,52.37%,28.59%,1
高雄市,三民區,1011,362,328,690,37,727,1350,53.85%,26.81%,1
高雄市,三民區,1012,299,186,485,18,503,872,57.68%,34.29%,1
高雄市,三民區,1013,287,237,524,19,543,954,56.92%,30.08%,1
高雄市,三民區,1014,480,431,911,16,927,1689,54.88%,28.42%,1
高雄市,三民區,1015,388,420,808,23,831,1390,59.78%,27.91%,1
高雄市,三民區,1016,408,394,802,39,841,1336,62.95%,30.54%,1
高雄市,三民區,1017,452,483,935,37,972,1437,67.64%,31.45%,1
高雄市,三民區,1018,467,415,882,22,904,1452,62.26%,32.16%,1
高雄市,三民區,1019,465,435,900,44,944,1513,62.39%,30.73%,1
高雄市,三民區,1020,537,389,926,49,975,1467,66.46%,36.61%,1
高雄市,三民區,1021,502,410,912,38,950,1381,68.79%,36.35%,1
高雄市,三民區,1022,415,255,670,33,703,1117,62.94%,37.15%,1
高雄市,三民區,1023,485,345,830,32,862,1327,64.96%,36.55%,1
高雄市,三民區,1024,425,363,788,33,821,1304,62.96%,32.59%,1
高雄市,三民區,1025,454,371,825,27,852,1483,57.45%,30.61%,1
高雄市,三民區,1026,454,431,885,60,945,1473,64.15%,30.82%,1
高雄市,三民區,1027,300,282,582,27,609,980,62.14%,30.61%,1
高雄市,三民區,1028,538,312,850,33,883,1409,62.67%,38.18%,1
高雄市,三民區,1029,398,341,739,39,778,1230,63.25%,32.36%,1
高雄市,三民區,1030,335,315,650,37,687,1024,67.09%,32.71%,1
高雄市,三民區,1031,364,322,686,29,715,1130,63.27%,32.21%,1
高雄市,三民區,1032,500,493,993,26,1019,1889,53.94%,26.47%,1
高雄市,三民區,1033,483,368,851,22,873,1427,61.18%,33.85%,1
高雄市,三民區,1034,258,247,505,16,521,791,65.87%,32.62%,1
高雄市,三民區,1035,401,319,720,50,770,1079,71.36%,37.16%,1
高雄市,三民區,1036,461,406,867,54,921,1492,61.73%,30.9%,1
高雄市,三民區,1037,340,299,639,32,671,1020,65.78%,33.33%,1
高雄市,三民區,1038,320,314,634,9,643,1001,64.24%,31.97%,1
高雄市,三民區,1039,554,431,985,28,1013,1581,64.07%,35.04%,1
高雄市,三民區,1040,458,429,887,24,911,1471,61.93%,31.14%,1
高雄市,三民區,1041,396,326,722,18,740,1151,64.29%,34.4%,1
高雄市,三民區,1042,457,377,834,41,875,1334,65.59%,34.26%,1
高雄市,三民區,1043,348,405,753,32,785,1275,61.57%,27.29%,1
高雄市,三民區,1044,399,332,731,27,758,1688,44.91%,23.64%,1
高雄市,三民區,1045,425,324,749,36,785,1214,64.66%,35.01%,1
高雄市,三民區,1046,390,354,744,25,769,1149,66.93%,33.94%,1
高雄市,三民區,1047,552,428,980,46,1026,1667,61.55%,33.11%,1
高雄市,三民區,1048,511,472,983,32,1015,1786,56.83%,28.61%,1
高雄市,三民區,1049,317,240,557,21,578,896,64.51%,35.38%,1
高雄市,三民區,1050,290,277,567,23,590,925,63.78%,31.35%,1
高雄市,三民區,1051,263,186,449,31,480,684,70.18%,38.45%,1
高雄市,三民區,1052,376,258,634,35,669,981,68.2%,38.33%,1
高雄市,三民區,1053,416,322,738,41,779,1383,56.33%,30.08%,1
高雄市,三民區,1054,429,400,829,39,868,1382,62.81%,31.04%,1
高雄市,三民區,1055,274,199,473,18,491,808,60.77%,33.91%,1
高雄市,三民區,1056,398,357,755,19,774,1197,64.66%,33.25%,1
高雄市,三民區,1057,403,385,788,29,817,1344,60.79%,29.99%,1
高雄市,三民區,1058,457,382,839,37,876,1344,65.18%,34%,1
高雄市,三民區,1059,429,407,836,12,848,1359,62.4%,31.57%,1
高雄市,三民區,1060,337,327,664,27,691,1073,64.4%,31.41%,1
高雄市,三民區,1061,325,328,653,26,679,1186,57.25%,27.4%,1
高雄市,三民區,1062,526,500,1026,35,1061,1749,60.66%,30.07%,1
高雄市,三民區,1063,318,213,531,8,539,877,61.46%,36.26%,1
高雄市,三民區,1064,507,381,888,45,933,1402,66.55%,36.16%,1
高雄市,三民區,1065,249,250,499,17,516,769,67.1%,32.38%,1
高雄市,三民區,1066,372,377,749,39,788,1207,65.29%,30.82%,1
高雄市,三民區,1067,407,287,694,25,719,1270,56.61%,32.05%,1
高雄市,三民區,1068,402,339,741,27,768,1248,61.54%,32.21%,1
高雄市,三民區,1069,381,381,762,38,800,1263,63.34%,30.17%,1
高雄市,三民區,1070,375,318,693,20,713,1101,64.76%,34.06%,1
高雄市,三民區,1071,391,336,727,23,750,1116,67.2%,35.04%,1
高雄市,三民區,1072,368,355,723,18,741,1152,64.32%,31.94%,1
高雄市,三民區,1073,398,246,644,32,676,1057,63.95%,37.65%,1
高雄市,三民區,1074,315,232,547,31,578,971,59.53%,32.44%,1
高雄市,三民區,1075,358,274,632,15,647,1062,60.92%,33.71%,1
高雄市,新興區,1098,231,256,487,14,501,828,60.51%,27.9%,1
高雄市,新興區,1099,288,329,617,27,644,963,66.87%,29.91%,1
高雄市,新興區,1100,304,308,612,21,633,1075,58.88%,28.28%,1
高雄市,新興區,1101,440,462,902,20,922,1488,61.96%,29.57%,1
高雄市,新興區,1102,387,462,849,31,880,1438,61.2%,26.91%,1
高雄市,新興區,1103,308,328,636,23,659,1049,62.82%,29.36%,1
高雄市,新興區,1104,442,437,879,48,927,1378,67.27%,32.08%,1
高雄市,新興區,1105,200,232,432,15,447,666,67.12%,30.03%,1
高雄市,新興區,1106,293,302,595,13,608,981,61.98%,29.87%,1
高雄市,新興區,1107,384,213,597,27,624,933,66.88%,41.16%,1
高雄市,新興區,1108,287,290,577,23,600,987,60.79%,29.08%,1
高雄市,新興區,1109,337,296,633,18,651,988,65.89%,34.11%,1
高雄市,新興區,1110,251,236,487,13,500,735,68.03%,34.15%,1
高雄市,新興區,1111,387,411,798,26,824,1317,62.57%,29.38%,1
高雄市,新興區,1112,239,226,465,5,470,800,58.75%,29.88%,1
高雄市,新興區,1113,344,267,611,23,634,968,65.5%,35.54%,1
高雄市,新興區,1114,268,296,564,20,584,913,63.96%,29.35%,1
高雄市,新興區,1115,455,439,894,21,915,1389,65.87%,32.76%,1
高雄市,新興區,1116,414,402,816,24,840,1228,68.4%,33.71%,1
高雄市,新興區,1117,440,300,740,30,770,1211,63.58%,36.33%,1
高雄市,新興區,1118,329,380,709,15,724,1101,65.76%,29.88%,1
高雄市,新興區,1119,250,232,482,11,493,752,65.56%,33.24%,1
高雄市,新興區,1120,309,284,593,32,625,873,71.59%,35.4%,1
高雄市,新興區,1121,496,449,945,30,975,1609,60.6%,30.83%,1
高雄市,新興區,1122,526,566,1092,30,1122,1736,64.63%,30.3%,1
高雄市,新興區,1123,321,415,736,23,759,1258,60.33%,25.52%,1
高雄市,新興區,1124,380,301,681,23,704,1105,63.71%,34.39%,1
高雄市,新興區,1125,298,235,533,16,549,851,64.51%,35.02%,1
高雄市,新興區,1126,313,298,611,28,639,1011,63.2%,30.96%,1
高雄市,新興區,1127,353,250,603,31,634,888,71.4%,39.75%,1
高雄市,新興區,1128,347,279,626,20,646,1005,64.28%,34.53%,1
高雄市,新興區,1129,305,332,637,14,651,1375,47.35%,22.18%,1
高雄市,新興區,1130,396,440,836,31,867,1388,62.46%,28.53%,1
高雄市,新興區,1131,224,192,416,33,449,719,62.45%,31.15%,1
高雄市,新興區,1132,326,298,624,45,669,1077,62.12%,30.27%,1
高雄市,新興區,1133,281,182,463,18,481,875,54.97%,32.11%,1
高雄市,新興區,1134,275,249,524,21,545,936,58.23%,29.38%,1
高雄市,新興區,1135,302,242,544,29,573,944,60.7%,31.99%,1
高雄市,新興區,1136,246,244,490,17,507,833,60.86%,29.53%,1
高雄市,新興區,1137,245,198,443,18,461,708,65.11%,34.6%,1
高雄市,新興區,1138,195,235,430,15,445,741,60.05%,26.32%,1
高雄市,新興區,1139,404,279,683,23,706,1235,57.17%,32.71%,1
高雄市,前金區,1076,263,137,400,14,414,673,61.52%,39.08%,1
高雄市,前金區,1077,283,353,636,17,653,1022,63.89%,27.69%,1
高雄市,前金區,1078,447,325,772,21,793,1324,59.89%,33.76%,1
高雄市,前金區,1079,287,215,502,21,523,839,62.34%,34.21%,1
高雄市,前金區,1080,330,250,580,33,613,975,62.87%,33.85%,1
高雄市,前金區,1081,472,570,1042,40,1082,1806,59.91%,26.14%,1
高雄市,前金區,1082,538,563,1101,21,1122,1781,63%,30.21%,1
高雄市,前金區,1083,228,223,451,18,469,717,65.41%,31.8%,1
高雄市,前金區,1084,348,322,670,10,680,1097,61.99%,31.72%,1
高雄市,前金區,1085,487,458,945,25,970,1633,59.4%,29.82%,1
高雄市,前金區,1086,267,245,512,18,530,759,69.83%,35.18%,1
高雄市,前金區,1087,292,310,602,33,635,948,66.98%,30.8%,1
高雄市,前金區,1088,296,225,521,35,556,1009,55.1%,29.34%,1
高雄市,前金區,1089,299,285,584,23,607,945,64.23%,31.64%,1
高雄市,前金區,1090,232,250,482,16,498,772,64.51%,30.05%,1
高雄市,前金區,1091,225,256,481,16,497,757,65.65%,29.72%,1
高雄市,前金區,1092,322,337,659,23,682,1047,65.14%,30.75%,1
高雄市,前金區,1093,300,312,612,22,634,985,64.37%,30.46%,1
高雄市,前金區,1094,446,515,961,16,977,1674,58.36%,26.64%,1
高雄市,前金區,1095,303,347,650,15,665,1088,61.12%,27.85%,1
高雄市,前金區,1096,304,278,582,36,618,893,69.2%,34.04%,1
高雄市,前金區,1097,336,346,682,26,708,1184,59.8%,28.38%,1
高雄市,苓雅區,1140,220,232,452,16,468,718,65.18%,30.64%,1
高雄市,苓雅區,1141,379,481,860,29,889,1492,59.58%,25.4%,1
高雄市,苓雅區,1142,377,354,731,28,759,1210,62.73%,31.16%,1
高雄市,苓雅區,1143,460,442,902,28,930,1617,57.51%,28.45%,1
高雄市,苓雅區,1144,393,478,871,37,908,1428,63.59%,27.52%,1
高雄市,苓雅區,1145,420,371,791,24,815,1444,56.44%,29.09%,1
高雄市,苓雅區,1146,398,429,827,49,876,1452,60.33%,27.41%,1
高雄市,苓雅區,1147,192,151,343,20,363,554,65.52%,34.66%,1
高雄市,苓雅區,1148,272,281,553,12,565,950,59.47%,28.63%,1
高雄市,苓雅區,1149,279,265,544,12,556,978,56.85%,28.53%,1
高雄市,苓雅區,1150,438,475,913,29,942,1673,56.31%,26.18%,1
高雄市,苓雅區,1151,476,604,1080,41,1121,2045,54.82%,23.28%,1
高雄市,苓雅區,1152,291,286,577,34,611,939,65.07%,30.99%,1
高雄市,苓雅區,1153,335,357,692,28,720,1284,56.07%,26.09%,1
高雄市,苓雅區,1154,298,261,559,24,583,908,64.21%,32.82%,1
高雄市,苓雅區,1155,252,226,478,16,494,838,58.95%,30.07%,1
高雄市,苓雅區,1156,362,414,776,19,795,1267,62.75%,28.57%,1
高雄市,苓雅區,1157,337,312,649,31,680,994,68.41%,33.9%,1
高雄市,苓雅區,1158,261,202,463,16,479,774,61.89%,33.72%,1
高雄市,苓雅區,1159,343,341,684,20,704,1121,62.8%,30.6%,1
高雄市,苓雅區,1160,472,410,882,33,915,1474,62.08%,32.02%,1
高雄市,苓雅區,1161,429,477,906,39,945,1525,61.97%,28.13%,1
高雄市,苓雅區,1162,386,314,700,34,734,1147,63.99%,33.65%,1
高雄市,苓雅區,1163,318,333,651,21,672,1014,66.27%,31.36%,1
高雄市,苓雅區,1164,499,412,911,26,937,1496,62.63%,33.36%,1
高雄市,苓雅區,1165,414,498,912,44,956,1499,63.78%,27.62%,1
高雄市,苓雅區,1166,346,363,709,23,732,1138,64.32%,30.4%,1
高雄市,苓雅區,1167,312,260,572,17,589,839,70.2%,37.19%,1
高雄市,苓雅區,1168,375,369,744,32,776,2088,37.16%,17.96%,1
高雄市,苓雅區,1169,473,542,1015,22,1037,1648,62.92%,28.7%,1
高雄市,苓雅區,1170,433,497,930,35,965,1623,59.46%,26.68%,1
高雄市,苓雅區,1171,576,655,1231,36,1267,1932,65.58%,29.81%,1
高雄市,苓雅區,1172,328,447,775,17,792,1127,70.28%,29.1%,1
高雄市,苓雅區,1173,370,430,800,18,818,1156,70.76%,32.01%,1
高雄市,苓雅區,1174,406,530,936,30,966,1465,65.94%,27.71%,1
高雄市,苓雅區,1175,228,157,385,15,400,690,57.97%,33.04%,1
高雄市,苓雅區,1176,619,114,733,52,785,1283,61.18%,48.25%,1
高雄市,苓雅區,1177,435,409,844,51,895,1432,62.5%,30.38%,1
高雄市,苓雅區,1178,395,409,804,19,823,1313,62.68%,30.08%,1
高雄市,苓雅區,1179,440,469,909,16,925,1579,58.58%,27.87%,1
高雄市,苓雅區,1180,441,402,843,50,893,1385,64.48%,31.84%,1
高雄市,苓雅區,1181,388,490,878,37,915,1449,63.15%,26.78%,1
高雄市,苓雅區,1182,468,683,1151,36,1187,1834,64.72%,25.52%,1
高雄市,苓雅區,1183,439,471,910,23,933,1436,64.97%,30.57%,1
高雄市,苓雅區,1184,378,516,894,33,927,1431,64.78%,26.42%,1
高雄市,苓雅區,1185,366,435,801,29,830,1248,66.51%,29.33%,1
高雄市,苓雅區,1186,414,516,930,23,953,1470,64.83%,28.16%,1
高雄市,苓雅區,1187,495,492,987,45,1032,1540,67.01%,32.14%,1
高雄市,苓雅區,1188,390,488,878,21,899,1374,65.43%,28.38%,1
高雄市,苓雅區,1189,232,318,550,14,564,839,67.22%,27.65%,1
高雄市,苓雅區,1190,294,389,683,29,712,1022,69.67%,28.77%,1
高雄市,苓雅區,1191,285,389,674,12,686,1062,64.6%,26.84%,1
高雄市,苓雅區,1192,326,364,690,18,708,1078,65.68%,30.24%,1
高雄市,苓雅區,1193,365,358,723,18,741,1117,66.34%,32.68%,1
高雄市,苓雅區,1194,429,540,969,37,1006,1516,66.36%,28.3%,1
高雄市,苓雅區,1195,482,365,847,57,904,1440,62.78%,33.47%,1
高雄市,苓雅區,1196,292,223,515,20,535,839,63.77%,34.8%,1
高雄市,苓雅區,1197,282,247,529,23,552,888,62.16%,31.76%,1
高雄市,苓雅區,1198,363,352,715,26,741,1101,67.3%,32.97%,1
高雄市,苓雅區,1199,323,368,691,31,722,1004,71.91%,32.17%,1
高雄市,苓雅區,1200,436,441,877,27,904,1427,63.35%,30.55%,1
高雄市,苓雅區,1201,361,368,729,12,741,1168,63.44%,30.91%,1
高雄市,苓雅區,1202,339,436,775,29,804,1184,67.91%,28.63%,1
高雄市,苓雅區,1203,272,341,613,25,638,974,65.5%,27.93%,1
高雄市,苓雅區,1204,248,240,488,10,498,849,58.66%,29.21%,1
高雄市,苓雅區,1205,503,613,1116,33,1149,1821,63.1%,27.62%,1
高雄市,苓雅區,1206,341,461,802,32,834,1306,63.86%,26.11%,1
高雄市,苓雅區,1207,357,393,750,28,778,1185,65.65%,30.13%,1
高雄市,苓雅區,1208,412,433,845,27,872,1415,61.63%,29.12%,1
高雄市,苓雅區,1209,313,310,623,30,653,962,67.88%,32.54%,1
高雄市,苓雅區,1210,290,277,567,35,602,964,62.45%,30.08%,1
高雄市,苓雅區,1211,372,542,914,38,952,1524,62.47%,24.41%,1
高雄市,苓雅區,1212,456,460,916,25,941,1455,64.67%,31.34%,1
高雄市,苓雅區,1213,374,338,712,18,730,1272,57.39%,29.4%,1
高雄市,苓雅區,1214,407,344,751,14,765,1256,60.91%,32.4%,1
高雄市,苓雅區,1215,282,419,701,17,718,1203,59.68%,23.44%,1
高雄市,苓雅區,1216,288,389,677,23,700,1062,65.91%,27.12%,1
高雄市,苓雅區,1217,311,230,541,31,572,850,67.29%,36.59%,1
高雄市,苓雅區,1218,380,340,720,47,767,1010,75.94%,37.62%,1
高雄市,苓雅區,1219,337,324,661,20,681,1118,60.91%,30.14%,1
高雄市,苓雅區,1220,284,317,601,17,618,937,65.96%,30.31%,1
高雄市,苓雅區,1221,442,392,834,23,857,1493,57.4%,29.6%,1
高雄市,苓雅區,1222,334,393,727,31,758,1183,64.07%,28.23%,1
高雄市,苓雅區,1223,381,307,688,31,719,1318,54.55%,28.91%,1
高雄市,苓雅區,1224,425,375,800,34,834,1362,61.23%,31.2%,1
高雄市,苓雅區,1225,343,295,638,47,685,1102,62.16%,31.13%,1
高雄市,苓雅區,1226,406,463,869,34,903,1481,60.97%,27.41%,1
高雄市,苓雅區,1227,294,259,553,32,585,878,66.63%,33.49%,1
高雄市,苓雅區,1228,273,250,523,11,534,908,58.81%,30.07%,1
高雄市,苓雅區,1229,318,363,681,23,704,1056,66.67%,30.11%,1
高雄市,苓雅區,1230,295,342,637,19,656,1091,60.13%,27.04%,1
高雄市,苓雅區,1231,315,309,624,20,644,976,65.98%,32.27%,1
高雄市,苓雅區,1232,377,322,699,23,722,1063,67.92%,35.47%,1
高雄市,苓雅區,1233,395,510,905,43,948,1484,63.88%,26.62%,1
高雄市,苓雅區,1234,411,387,798,24,822,1290,63.72%,31.86%,1
高雄市,苓雅區,1235,467,578,1045,42,1087,1740,62.47%,26.84%,1
高雄市,苓雅區,1236,440,507,947,36,983,1594,61.67%,27.6%,1
高雄市,苓雅區,1237,438,515,953,20,973,1648,59.04%,26.58%,1
高雄市,苓雅區,1238,346,451,797,23,820,1236,66.34%,27.99%,1
高雄市,苓雅區,1239,370,370,740,29,769,1211,63.5%,30.55%,1
高雄市,苓雅區,1240,394,384,778,19,797,1283,62.12%,30.71%,1
高雄市,苓雅區,1241,553,577,1130,47,1177,1804,65.24%,30.65%,1
高雄市,苓雅區,1242,486,551,1037,47,1084,1718,63.1%,28.29%,1
高雄市,苓雅區,1243,381,420,801,34,835,1297,64.38%,29.38%,1
高雄市,苓雅區,1244,401,471,872,29,901,1449,62.18%,27.67%,1
高雄市,苓雅區,1245,400,395,795,28,823,1307,62.97%,30.6%,1
高雄市,苓雅區,1246,370,363,733,26,759,1184,64.1%,31.25%,1
高雄市,苓雅區,1247,417,382,799,41,840,1250,67.2%,33.36%,1
高雄市,苓雅區,1248,348,377,725,22,747,1248,59.86%,27.88%,1
高雄市,苓雅區,1249,364,422,786,25,811,1283,63.21%,28.37%,1
高雄市,苓雅區,1250,380,358,738,18,756,1121,67.44%,33.9%,1
高雄市,苓雅區,1251,394,390,784,19,803,1258,63.83%,31.32%,1
高雄市,苓雅區,1252,421,415,836,21,857,1339,64%,31.44%,1
高雄市,苓雅區,1253,553,560,1113,48,1161,1986,58.46%,27.84%,1
高雄市,苓雅區,1254,296,327,623,24,647,1028,62.94%,28.79%,1
高雄市,苓雅區,1255,278,306,584,19,603,948,63.61%,29.32%,1
高雄市,前鎮區,1484,412,520,932,80,1012,1809,55.94%,22.78%,1
高雄市,前鎮區,1485,511,457,968,44,1012,1835,55.15%,27.85%,1
高雄市,前鎮區,1486,412,399,811,33,844,1890,44.66%,21.8%,1
高雄市,前鎮區,1487,555,460,1015,36,1051,2013,52.21%,27.57%,1
高雄市,前鎮區,1488,480,443,923,46,969,1776,54.56%,27.03%,1
高雄市,前鎮區,1489,460,345,805,37,842,1705,49.38%,26.98%,1
高雄市,前鎮區,1490,206,186,392,30,422,672,62.8%,30.65%,1
高雄市,前鎮區,1491,419,415,834,34,868,1726,50.29%,24.28%,1
高雄市,前鎮區,1492,519,406,925,24,949,1597,59.42%,32.5%,1
高雄市,前鎮區,1493,524,413,937,60,997,1690,58.99%,31.01%,1
高雄市,前鎮區,1494,290,355,645,45,690,1080,63.89%,26.85%,1
高雄市,前鎮區,1495,420,322,742,33,775,1159,66.87%,36.24%,1
高雄市,前鎮區,1496,436,289,725,42,767,1314,58.37%,33.18%,1
高雄市,前鎮區,1497,283,263,546,28,574,896,64.06%,31.58%,1
高雄市,前鎮區,1498,256,313,569,35,604,1002,60.28%,25.55%,1
高雄市,前鎮區,1499,540,489,1029,60,1089,2765,39.39%,19.53%,1
高雄市,前鎮區,1500,216,147,363,28,391,600,65.17%,36%,1
高雄市,前鎮區,1501,364,219,583,18,601,1466,41%,24.83%,1
高雄市,前鎮區,1502,487,348,835,39,874,1449,60.32%,33.61%,1
高雄市,前鎮區,1503,305,252,557,26,583,991,58.83%,30.78%,1
高雄市,前鎮區,1504,373,368,741,37,778,1248,62.34%,29.89%,1
高雄市,前鎮區,1505,383,252,635,48,683,1066,64.07%,35.93%,1
高雄市,前鎮區,1506,247,162,409,21,430,706,60.91%,34.99%,1
高雄市,前鎮區,1507,240,175,415,15,430,713,60.31%,33.66%,1
高雄市,前鎮區,1508,456,279,735,31,766,1344,56.99%,33.93%,1
高雄市,前鎮區,1509,291,223,514,26,540,856,63.08%,34%,1
高雄市,前鎮區,1510,290,198,488,31,519,873,59.45%,33.22%,1
高雄市,前鎮區,1511,360,258,618,36,654,1114,58.71%,32.32%,1
高雄市,前鎮區,1512,340,246,586,19,605,1112,54.41%,30.58%,1
高雄市,前鎮區,1513,315,270,585,32,617,1044,59.1%,30.17%,1
高雄市,前鎮區,1514,296,208,504,23,527,940,56.06%,31.49%,1
高雄市,前鎮區,1515,360,320,680,49,729,1342,54.32%,26.83%,1
高雄市,前鎮區,1516,446,445,891,38,929,1402,66.26%,31.81%,1
高雄市,前鎮區,1517,353,450,803,22,825,1320,62.5%,26.74%,1
高雄市,前鎮區,1518,306,256,562,21,583,958,60.86%,31.94%,1
高雄市,前鎮區,1519,361,487,848,37,885,1276,69.36%,28.29%,1
高雄市,前鎮區,1520,413,450,863,55,918,1459,62.92%,28.31%,1
高雄市,前鎮區,1521,251,159,410,25,435,761,57.16%,32.98%,1
高雄市,前鎮區,1522,352,290,642,18,660,1093,60.38%,32.2%,1
高雄市,前鎮區,1523,226,714,940,31,971,1521,63.84%,14.86%,1
高雄市,前鎮區,1524,254,687,941,28,969,1557,62.24%,16.31%,1
高雄市,前鎮區,1525,369,599,968,27,995,1821,54.64%,20.26%,1
高雄市,前鎮區,1526,176,521,697,40,737,1066,69.14%,16.51%,1
高雄市,前鎮區,1527,160,501,661,19,680,1046,65.01%,15.3%,1
高雄市,前鎮區,1528,473,507,980,40,1020,1709,59.68%,27.68%,1
高雄市,前鎮區,1529,421,607,1028,37,1065,1723,61.81%,24.43%,1
高雄市,前鎮區,1530,364,407,771,24,795,1202,66.14%,30.28%,1
高雄市,前鎮區,1531,404,448,852,26,878,1279,68.65%,31.59%,1
高雄市,前鎮區,1532,348,606,954,23,977,1513,64.57%,23%,1
高雄市,前鎮區,1533,330,432,762,23,785,1260,62.3%,26.19%,1
高雄市,前鎮區,1534,346,362,708,58,766,1139,67.25%,30.38%,1
高雄市,前鎮區,1535,333,405,738,28,766,1140,67.19%,29.21%,1
高雄市,前鎮區,1536,422,461,883,42,925,1462,63.27%,28.86%,1
高雄市,前鎮區,1537,348,482,830,26,856,1359,62.99%,25.61%,1
高雄市,前鎮區,1538,538,504,1042,52,1094,2037,53.71%,26.41%,1
高雄市,前鎮區,1539,340,463,803,10,813,1410,57.66%,24.11%,1
高雄市,前鎮區,1540,347,402,749,21,770,1307,58.91%,26.55%,1
高雄市,前鎮區,1541,425,431,856,46,902,1512,59.66%,28.11%,1
高雄市,前鎮區,1542,418,453,871,45,916,1491,61.44%,28.03%,1
高雄市,前鎮區,1543,447,481,928,36,964,1621,59.47%,27.58%,1
高雄市,前鎮區,1544,374,422,796,26,822,1522,54.01%,24.57%,1
高雄市,前鎮區,1545,489,456,945,36,981,1593,61.58%,30.7%,1
高雄市,前鎮區,1546,538,600,1138,32,1170,1885,62.07%,28.54%,1
高雄市,前鎮區,1547,487,628,1115,56,1171,1870,62.62%,26.04%,1
高雄市,前鎮區,1548,363,464,827,23,850,1388,61.24%,26.15%,1
高雄市,前鎮區,1549,356,444,800,44,844,1348,62.61%,26.41%,1
高雄市,前鎮區,1550,402,347,749,50,799,1341,59.58%,29.98%,1
高雄市,前鎮區,1551,410,460,870,28,898,1364,65.84%,30.06%,1
高雄市,前鎮區,1552,415,388,803,38,841,1367,61.52%,30.36%,1
高雄市,前鎮區,1553,442,341,783,37,820,1326,61.84%,33.33%,1
高雄市,前鎮區,1554,323,291,614,29,643,1059,60.72%,30.5%,1
高雄市,前鎮區,1555,335,350,685,25,710,1119,63.45%,29.94%,1
高雄市,前鎮區,1556,471,411,882,30,912,1565,58.27%,30.1%,1
高雄市,前鎮區,1557,413,474,887,43,930,1549,60.04%,26.66%,1
高雄市,前鎮區,1558,459,621,1080,27,1107,1691,65.46%,27.14%,1
高雄市,前鎮區,1559,458,611,1069,21,1090,1837,59.34%,24.93%,1
高雄市,前鎮區,1560,360,348,708,12,720,1092,65.93%,32.97%,1
高雄市,前鎮區,1561,342,341,683,37,720,1126,63.94%,30.37%,1
高雄市,前鎮區,1562,354,317,671,45,716,1215,58.93%,29.14%,1
高雄市,前鎮區,1563,436,449,885,19,904,1443,62.65%,30.21%,1
高雄市,前鎮區,1564,397,579,976,27,1003,1448,69.27%,27.42%,1
高雄市,前鎮區,1565,422,546,968,59,1027,1648,62.32%,25.61%,1
高雄市,前鎮區,1566,454,426,880,40,920,1603,57.39%,28.32%,1
高雄市,前鎮區,1567,400,418,818,19,837,1596,52.44%,25.06%,1
高雄市,前鎮區,1568,413,367,780,21,801,1450,55.24%,28.48%,1
高雄市,前鎮區,1569,389,418,807,57,864,1510,57.22%,25.76%,1
高雄市,前鎮區,1570,592,384,976,67,1043,1647,63.33%,35.94%,1
高雄市,前鎮區,1571,352,411,763,29,792,1342,59.02%,26.23%,1
高雄市,前鎮區,1572,386,365,751,33,784,1384,56.65%,27.89%,1
高雄市,前鎮區,1573,417,410,827,40,867,1479,58.62%,28.19%,1
高雄市,前鎮區,1574,393,523,916,37,953,1546,61.64%,25.42%,1
高雄市,前鎮區,1575,430,501,931,49,980,1595,61.44%,26.96%,1
高雄市,前鎮區,1576,338,382,720,35,755,1201,62.86%,28.14%,1
高雄市,前鎮區,1577,347,259,606,27,633,1082,58.5%,32.07%,1
高雄市,前鎮區,1578,273,283,556,22,578,996,58.03%,27.41%,1
高雄市,前鎮區,1579,327,224,551,41,592,932,63.52%,35.09%,1
高雄市,前鎮區,1580,327,334,661,36,697,1146,60.82%,28.53%,1
高雄市,前鎮區,1581,388,294,682,32,714,1096,65.15%,35.4%,1
高雄市,前鎮區,1582,382,461,843,21,864,1332,64.86%,28.68%,1
高雄市,前鎮區,1583,383,317,700,33,733,1175,62.38%,32.6%,1
高雄市,前鎮區,1584,306,268,574,33,607,986,61.56%,31.03%,1
高雄市,前鎮區,1585,406,384,790,41,831,1316,63.15%,30.85%,1
高雄市,前鎮區,1586,432,378,810,47,857,1559,54.97%,27.71%,1
高雄市,前鎮區,1587,484,484,968,46,1014,1622,62.52%,29.84%,1
高雄市,前鎮區,1588,420,352,772,34,806,1310,61.53%,32.06%,1
高雄市,前鎮區,1589,488,307,795,47,842,1299,64.82%,37.57%,1
高雄市,前鎮區,1590,362,402,764,38,802,1191,67.34%,30.39%,1
高雄市,前鎮區,1591,414,365,779,23,802,1375,58.33%,30.11%,1
高雄市,前鎮區,1592,431,370,801,26,827,1338,61.81%,32.21%,1
高雄市,前鎮區,1593,414,275,689,21,710,1175,60.43%,35.23%,1
高雄市,前鎮區,1594,385,379,764,21,785,1357,57.85%,28.37%,1
高雄市,前鎮區,1595,397,373,770,40,810,1187,68.24%,33.45%,1
高雄市,前鎮區,1596,358,318,676,37,713,1164,61.25%,30.76%,1
高雄市,前鎮區,1597,452,324,776,29,805,1219,66.04%,37.08%,1
高雄市,前鎮區,1598,365,439,804,24,828,1428,57.98%,25.56%,1
高雄市,前鎮區,1599,467,378,845,60,905,1495,60.54%,31.24%,1
高雄市,前鎮區,1600,398,522,920,45,965,1531,63.03%,26%,1
高雄市,前鎮區,1601,475,394,869,47,916,1509,60.7%,31.48%,1
高雄市,前鎮區,1602,463,439,902,42,944,1591,59.33%,29.1%,1
高雄市,旗津區,0869,430,276,706,59,765,1177,65%,36.53%,1
高雄市,旗津區,0870,327,251,578,37,615,1109,55.46%,29.49%,1
高雄市,旗津區,0871,497,342,839,21,860,1642,52.38%,30.27%,1
高雄市,旗津區,0872,354,259,613,66,679,1209,56.16%,29.28%,1
高雄市,旗津區,0873,339,216,555,30,585,1112,52.61%,30.49%,1
高雄市,旗津區,0874,415,395,810,62,872,1483,58.8%,27.98%,1
高雄市,旗津區,0875,461,217,678,29,707,1460,48.42%,31.58%,1
高雄市,旗津區,0876,572,357,929,65,994,1572,63.23%,36.39%,1
高雄市,旗津區,0877,274,366,640,37,677,1384,48.92%,19.8%,1
高雄市,旗津區,0878,326,337,663,38,701,1390,50.43%,23.45%,1
高雄市,旗津區,0879,297,287,584,38,622,1239,50.2%,23.97%,1
高雄市,旗津區,0880,602,468,1070,73,1143,2045,55.89%,29.44%,1
高雄市,旗津區,0881,299,175,474,21,495,893,55.43%,33.48%,1
高雄市,旗津區,0882,589,357,946,60,1006,1866,53.91%,31.56%,1
高雄市,旗津區,0883,562,319,881,36,917,1874,48.93%,29.99%,1
高雄市,旗津區,0884,280,169,449,22,471,893,52.74%,31.35%,1
高雄市,旗津區,0885,400,316,716,34,750,1215,61.73%,32.92%,1
高雄市,旗津區,0886,351,296,647,40,687,1297,52.97%,27.06%,1
高雄市,小港區,1603,328,380,708,30,738,1108,66.61%,29.6%,1
高雄市,小港區,1604,349,368,717,30,747,1171,63.79%,29.8%,1
高雄市,小港區,1605,471,514,985,18,1003,1557,64.42%,30.25%,1
高雄市,小港區,1606,393,511,904,22,926,1668,55.52%,23.56%,1
高雄市,小港區,1607,313,493,806,17,823,1183,69.57%,26.46%,1
高雄市,小港區,1608,351,500,851,21,872,1372,63.56%,25.58%,1
高雄市,小港區,1609,524,502,1026,55,1081,1737,62.23%,30.17%,1
高雄市,小港區,1610,483,391,874,37,911,1586,57.44%,30.45%,1
高雄市,小港區,1611,376,438,814,40,854,1558,54.81%,24.13%,1
高雄市,小港區,1612,441,378,819,40,859,1284,66.9%,34.35%,1
高雄市,小港區,1613,380,366,746,36,782,1249,62.61%,30.42%,1
高雄市,小港區,1614,552,549,1101,45,1146,2400,47.75%,23%,1
高雄市,小港區,1615,387,340,727,34,761,1181,64.44%,32.77%,1
高雄市,小港區,1616,323,315,638,31,669,1079,62%,29.94%,1
高雄市,小港區,1617,389,384,773,24,797,1335,59.7%,29.14%,1
高雄市,小港區,1618,377,363,740,36,776,1241,62.53%,30.38%,1
高雄市,小港區,1619,438,411,849,33,882,1513,58.29%,28.95%,1
高雄市,小港區,1620,411,407,818,46,864,1349,64.05%,30.47%,1
高雄市,小港區,1621,430,403,833,43,876,1483,59.07%,29%,1
高雄市,小港區,1622,428,435,863,14,877,1451,60.44%,29.5%,1
高雄市,小港區,1623,360,333,693,26,719,1241,57.94%,29.01%,1
高雄市,小港區,1624,425,377,802,49,851,1262,67.43%,33.68%,1
高雄市,小港區,1625,540,513,1053,59,1112,1813,61.33%,29.78%,1
高雄市,小港區,1626,515,483,998,27,1025,1877,54.61%,27.44%,1
高雄市,小港區,1627,422,397,819,17,836,1391,60.1%,30.34%,1
高雄市,小港區,1628,483,435,918,32,950,1453,65.38%,33.24%,1
高雄市,小港區,1629,394,416,810,25,835,1374,60.77%,28.68%,1
高雄市,小港區,1630,358,406,764,33,797,1348,59.12%,26.56%,1
高雄市,小港區,1631,372,426,798,46,844,1334,63.27%,27.89%,1
高雄市,小港區,1632,444,392,836,27,863,1433,60.22%,30.98%,1
高雄市,小港區,1633,399,379,778,28,806,1448,55.66%,27.56%,1
高雄市,小港區,1634,402,506,908,57,965,1488,64.85%,27.02%,1
高雄市,小港區,1635,387,380,767,41,808,1278,63.22%,30.28%,1
高雄市,小港區,1636,407,477,884,37,921,1306,70.52%,31.16%,1
高雄市,小港區,1637,472,471,943,45,988,1625,60.8%,29.05%,1
高雄市,小港區,1638,464,542,1006,48,1054,1640,64.27%,28.29%,1
高雄市,小港區,1639,379,477,856,34,890,1506,59.1%,25.17%,1
高雄市,小港區,1640,234,522,756,45,801,1438,55.7%,16.27%,1
高雄市,小港區,1641,242,480,722,30,752,1105,68.05%,21.9%,1
高雄市,小港區,1642,263,384,647,19,666,1167,57.07%,22.54%,1
高雄市,小港區,1643,373,510,883,24,907,1420,63.87%,26.27%,1
高雄市,小港區,1644,358,510,868,49,917,1380,66.45%,25.94%,1
高雄市,小港區,1645,331,393,724,19,743,1239,59.97%,26.72%,1
高雄市,小港區,1646,640,304,944,35,979,1563,62.64%,40.95%,1
高雄市,小港區,1647,477,475,952,45,997,1644,60.64%,29.01%,1
高雄市,小港區,1648,472,575,1047,54,1101,1895,58.1%,24.91%,1
高雄市,小港區,1649,503,459,962,46,1008,1748,57.67%,28.78%,1
高雄市,小港區,1650,447,471,918,57,975,1579,61.75%,28.31%,1
高雄市,小港區,1651,543,639,1182,30,1212,2135,56.77%,25.43%,1
高雄市,小港區,1652,462,524,986,44,1030,1728,59.61%,26.74%,1
高雄市,小港區,1653,524,544,1068,41,1109,2022,54.85%,25.91%,1
高雄市,小港區,1654,364,304,668,22,690,1329,51.92%,27.39%,1
高雄市,小港區,1655,405,363,768,20,788,1320,59.7%,30.68%,1
高雄市,小港區,1656,381,366,747,42,789,1267,62.27%,30.07%,1
高雄市,小港區,1657,378,397,775,61,836,1298,64.41%,29.12%,1
高雄市,小港區,1658,423,371,794,30,824,1289,63.93%,32.82%,1
高雄市,小港區,1659,477,459,936,28,964,1534,62.84%,31.1%,1
高雄市,小港區,1660,392,494,886,44,930,1494,62.25%,26.24%,1
高雄市,小港區,1661,403,406,809,46,855,1377,62.09%,29.27%,1
高雄市,小港區,1662,411,414,825,39,864,1344,64.29%,30.58%,1
高雄市,小港區,1663,463,402,865,36,901,1508,59.75%,30.7%,1
高雄市,小港區,1664,427,331,758,30,788,1400,56.29%,30.5%,1
高雄市,小港區,1665,395,474,869,37,906,1457,62.18%,27.11%,1
高雄市,小港區,1666,374,394,768,22,790,1392,56.75%,26.87%,1
高雄市,小港區,1667,569,514,1083,41,1124,1983,56.68%,28.69%,1
高雄市,小港區,1668,317,383,700,22,722,1204,59.97%,26.33%,1
高雄市,小港區,1669,308,422,730,32,762,1300,58.62%,23.69%,1
高雄市,小港區,1670,533,590,1123,48,1171,1857,63.06%,28.7%,1
高雄市,小港區,1671,409,486,895,28,923,1566,58.94%,26.12%,1
高雄市,小港區,1672,421,429,850,42,892,1343,66.42%,31.35%,1
高雄市,小港區,1673,421,357,778,49,827,1236,66.91%,34.06%,1
高雄市,小港區,1674,538,421,959,58,1017,1564,65.03%,34.4%,1
高雄市,小港區,1675,445,429,874,26,900,1484,60.65%,29.99%,1
高雄市,小港區,1676,425,422,847,39,886,1477,59.99%,28.77%,1
高雄市,小港區,1677,440,486,926,20,946,1482,63.83%,29.69%,1
高雄市,小港區,1678,439,438,877,38,915,1708,53.57%,25.7%,1
高雄市,小港區,1679,541,467,1008,95,1103,1867,59.08%,28.98%,1
高雄市,小港區,1680,484,433,917,24,941,1709,55.06%,28.32%,1
高雄市,小港區,1681,355,388,743,47,790,1425,55.44%,24.91%,1
高雄市,小港區,1682,420,423,843,31,874,1696,51.53%,24.76%,1
高雄市,小港區,1683,375,362,737,35,772,1522,50.72%,24.64%,1
高雄市,小港區,1684,466,399,865,40,905,1531,59.11%,30.44%,1
高雄市,小港區,1685,611,556,1167,75,1242,2215,56.07%,27.58%,1
高雄市,小港區,1686,510,383,893,28,921,1515,60.79%,33.66%,1
高雄市,小港區,1687,465,381,846,29,875,1535,57%,30.29%,1
高雄市,小港區,1688,415,308,723,19,742,1276,58.15%,32.52%,1
高雄市,小港區,1689,349,296,645,31,676,1217,55.55%,28.68%,1
高雄市,小港區,1690,468,378,846,31,877,1707,51.38%,27.42%,1
高雄市,小港區,1691,539,453,992,54,1046,1920,54.48%,28.07%,1
高雄市,鳳山區,1256,305,390,695,29,724,1080,67.04%,28.24%,1
高雄市,鳳山區,1257,234,272,506,24,530,819,64.71%,28.57%,1
高雄市,鳳山區,1258,234,267,501,45,546,851,64.16%,27.5%,1
高雄市,鳳山區,1259,308,356,664,19,683,1075,63.53%,28.65%,1
高雄市,鳳山區,1260,364,409,773,19,792,1223,64.76%,29.76%,1
高雄市,鳳山區,1261,366,359,725,26,751,1207,62.22%,30.32%,1
高雄市,鳳山區,1262,347,381,728,22,750,1339,56.01%,25.91%,1
高雄市,鳳山區,1263,300,319,619,22,641,1188,53.96%,25.25%,1
高雄市,鳳山區,1264,335,288,623,27,650,1055,61.61%,31.75%,1
高雄市,鳳山區,1265,299,310,609,44,653,1109,58.88%,26.96%,1
高雄市,鳳山區,1266,260,233,493,27,520,756,68.78%,34.39%,1
高雄市,鳳山區,1267,295,376,671,27,698,1182,59.05%,24.96%,1
高雄市,鳳山區,1268,448,406,854,51,905,1496,60.49%,29.95%,1
高雄市,鳳山區,1269,453,555,1008,42,1050,2094,50.14%,21.63%,1
高雄市,鳳山區,1270,388,500,888,28,916,1672,54.78%,23.21%,1
高雄市,鳳山區,1271,381,566,947,21,968,1761,54.97%,21.64%,1
高雄市,鳳山區,1272,407,429,836,44,880,1450,60.69%,28.07%,1
高雄市,鳳山區,1273,364,392,756,18,774,1455,53.2%,25.02%,1
高雄市,鳳山區,1274,338,379,717,37,754,1234,61.1%,27.39%,1
高雄市,鳳山區,1275,494,529,1023,49,1072,1713,62.58%,28.84%,1
高雄市,鳳山區,1276,443,486,929,27,956,1698,56.3%,26.09%,1
高雄市,鳳山區,1277,370,377,747,33,780,1247,62.55%,29.67%,1
高雄市,鳳山區,1278,320,330,650,31,681,1087,62.65%,29.44%,1
高雄市,鳳山區,1279,287,436,723,26,749,1199,62.47%,23.94%,1
高雄市,鳳山區,1280,215,635,850,49,899,1559,57.67%,13.79%,1
高雄市,鳳山區,1281,341,413,754,29,783,1233,63.5%,27.66%,1
高雄市,鳳山區,1282,363,404,767,40,807,1277,63.19%,28.43%,1
高雄市,鳳山區,1283,344,522,866,15,881,1481,59.49%,23.23%,1
高雄市,鳳山區,1284,326,421,747,21,768,1154,66.55%,28.25%,1
高雄市,鳳山區,1285,414,502,916,21,937,1475,63.53%,28.07%,1
高雄市,鳳山區,1286,312,362,674,26,700,1247,56.13%,25.02%,1
高雄市,鳳山區,1287,388,440,828,42,870,1538,56.57%,25.23%,1
高雄市,鳳山區,1288,335,303,638,27,665,1097,60.62%,30.54%,1
高雄市,鳳山區,1289,367,310,677,20,697,1221,57.08%,30.06%,1
高雄市,鳳山區,1290,303,397,700,35,735,1075,68.37%,28.19%,1
高雄市,鳳山區,1291,445,596,1041,38,1079,1751,61.62%,25.41%,1
高雄市,鳳山區,1292,456,597,1053,31,1084,1758,61.66%,25.94%,1
高雄市,鳳山區,1293,446,568,1014,38,1052,1749,60.15%,25.5%,1
高雄市,鳳山區,1294,407,578,985,20,1005,1746,57.56%,23.31%,1
高雄市,鳳山區,1295,409,559,968,35,1003,1712,58.59%,23.89%,1
高雄市,鳳山區,1296,302,428,730,28,758,1247,60.79%,24.22%,1
高雄市,鳳山區,1297,370,469,839,32,871,1409,61.82%,26.26%,1
高雄市,鳳山區,1298,328,470,798,31,829,1347,61.54%,24.35%,1
高雄市,鳳山區,1299,432,574,1006,20,1026,1771,57.93%,24.39%,1
高雄市,鳳山區,1300,394,518,912,18,930,1537,60.51%,25.63%,1
高雄市,鳳山區,1301,360,592,952,18,970,1605,60.44%,22.43%,1
高雄市,鳳山區,1302,600,187,787,21,808,1375,58.76%,43.64%,1
高雄市,鳳山區,1303,352,505,857,29,886,1393,63.6%,25.27%,1
高雄市,鳳山區,1304,375,492,867,19,886,1584,55.93%,23.67%,1
高雄市,鳳山區,1305,236,147,383,17,400,618,64.72%,38.19%,1
高雄市,鳳山區,1306,134,139,273,4,277,423,65.48%,31.68%,1
高雄市,鳳山區,1307,376,387,763,40,803,1312,61.2%,28.66%,1
高雄市,鳳山區,1308,233,227,460,19,479,769,62.29%,30.3%,1
高雄市,鳳山區,1309,320,466,786,16,802,1213,66.12%,26.38%,1
高雄市,鳳山區,1310,349,375,724,20,744,1107,67.21%,31.53%,1
高雄市,鳳山區,1311,347,374,721,28,749,1188,63.05%,29.21%,1
高雄市,鳳山區,1312,334,395,729,28,757,1183,63.99%,28.23%,1
高雄市,鳳山區,1313,378,379,757,40,797,1264,63.05%,29.91%,1
高雄市,鳳山區,1314,270,268,538,22,560,882,63.49%,30.61%,1
高雄市,鳳山區,1315,333,343,676,33,709,1007,70.41%,33.07%,1
高雄市,鳳山區,1316,293,217,510,35,545,853,63.89%,34.35%,1
高雄市,鳳山區,1317,223,224,447,34,481,1660,28.98%,13.43%,1
高雄市,鳳山區,1318,300,385,685,23,708,1124,62.99%,26.69%,1
高雄市,鳳山區,1319,331,325,656,42,698,1112,62.77%,29.77%,1
高雄市,鳳山區,1320,300,352,652,26,678,1182,57.36%,25.38%,1
高雄市,鳳山區,1321,258,335,593,34,627,875,71.66%,29.49%,1
高雄市,鳳山區,1322,307,319,626,34,660,1040,63.46%,29.52%,1
高雄市,鳳山區,1323,252,449,701,19,720,1094,65.81%,23.03%,1
高雄市,鳳山區,1324,330,395,725,39,764,1217,62.78%,27.12%,1
高雄市,鳳山區,1325,303,339,642,23,665,974,68.28%,31.11%,1
高雄市,鳳山區,1326,246,334,580,32,612,987,62.01%,24.92%,1
高雄市,鳳山區,1327,302,485,787,22,809,1210,66.86%,24.96%,1
高雄市,鳳山區,1328,395,413,808,30,838,1391,60.24%,28.4%,1
高雄市,鳳山區,1329,310,320,630,24,654,1241,52.7%,24.98%,1
高雄市,鳳山區,1330,283,345,628,24,652,1000,65.2%,28.3%,1
高雄市,鳳山區,1331,306,357,663,25,688,1092,63%,28.02%,1
高雄市,鳳山區,1332,332,470,802,28,830,1308,63.46%,25.38%,1
高雄市,鳳山區,1333,286,333,619,36,655,1031,63.53%,27.74%,1
高雄市,鳳山區,1334,313,378,691,42,733,1159,63.24%,27.01%,1
高雄市,鳳山區,1335,247,387,634,44,678,1127,60.16%,21.92%,1
高雄市,鳳山區,1336,324,435,759,34,793,1109,71.51%,29.22%,1
高雄市,鳳山區,1337,467,701,1168,31,1199,1879,63.81%,24.85%,1
高雄市,鳳山區,1338,471,690,1161,36,1197,1803,66.39%,26.12%,1
高雄市,鳳山區,1339,385,690,1075,53,1128,2045,55.16%,18.83%,1
高雄市,鳳山區,1340,343,448,791,27,818,1432,57.12%,23.95%,1
高雄市,鳳山區,1341,271,307,578,20,598,1033,57.89%,26.23%,1
高雄市,鳳山區,1342,344,399,743,57,800,1253,63.85%,27.45%,1
高雄市,鳳山區,1343,315,404,719,24,743,1217,61.05%,25.88%,1
高雄市,鳳山區,1344,285,492,777,46,823,1267,64.96%,22.49%,1
高雄市,鳳山區,1345,322,397,719,25,744,1251,59.47%,25.74%,1
高雄市,鳳山區,1346,378,544,922,39,961,1563,61.48%,24.18%,1
高雄市,鳳山區,1347,399,723,1122,46,1168,1888,61.86%,21.13%,1
高雄市,鳳山區,1348,371,430,801,35,836,1368,61.11%,27.12%,1
高雄市,鳳山區,1349,388,474,862,32,894,1588,56.3%,24.43%,1
高雄市,鳳山區,1350,174,577,751,53,804,1255,64.06%,13.86%,1
高雄市,鳳山區,1351,344,374,718,46,764,1264,60.44%,27.22%,1
高雄市,鳳山區,1352,302,448,750,52,802,1291,62.12%,23.39%,1
高雄市,鳳山區,1353,276,421,697,30,727,1224,59.4%,22.55%,1
高雄市,鳳山區,1354,281,458,739,26,765,1296,59.03%,21.68%,1
高雄市,鳳山區,1355,218,305,523,36,559,826,67.68%,26.39%,1
高雄市,鳳山區,1356,228,517,745,37,782,1229,63.63%,18.55%,1
高雄市,鳳山區,1357,301,575,876,29,905,1467,61.69%,20.52%,1
高雄市,鳳山區,1358,296,416,712,37,749,1218,61.49%,24.3%,1
高雄市,鳳山區,1359,556,650,1206,45,1251,2173,57.57%,25.59%,1
高雄市,鳳山區,1360,458,834,1292,35,1327,2255,58.85%,20.31%,1
高雄市,鳳山區,1361,422,525,947,31,978,1556,62.85%,27.12%,1
高雄市,鳳山區,1362,383,444,827,38,865,1521,56.87%,25.18%,1
高雄市,鳳山區,1363,356,383,739,26,765,1407,54.37%,25.3%,1
高雄市,鳳山區,1364,332,564,896,42,938,1542,60.83%,21.53%,1
高雄市,鳳山區,1365,327,483,810,18,828,1502,55.13%,21.77%,1
高雄市,鳳山區,1366,276,508,784,49,833,1320,63.11%,20.91%,1
高雄市,鳳山區,1367,141,668,809,30,839,1507,55.67%,9.36%,1
高雄市,鳳山區,1368,154,633,787,40,827,1284,64.41%,11.99%,1
高雄市,鳳山區,1369,327,462,789,29,818,1441,56.77%,22.69%,1
高雄市,鳳山區,1370,336,542,878,51,929,1485,62.56%,22.63%,1
高雄市,鳳山區,1371,329,367,696,37,733,1205,60.83%,27.3%,1
高雄市,鳳山區,1372,333,387,720,20,740,1284,57.63%,25.93%,1
高雄市,鳳山區,1373,378,416,794,39,833,1326,62.82%,28.51%,1
高雄市,鳳山區,1374,326,336,662,23,685,1096,62.5%,29.74%,1
高雄市,鳳山區,1375,340,386,726,47,773,1182,65.4%,28.76%,1
高雄市,鳳山區,1376,311,356,667,34,701,1017,68.93%,30.58%,1
高雄市,鳳山區,1377,348,326,674,59,733,1198,61.19%,29.05%,1
高雄市,鳳山區,1378,369,346,715,29,744,1281,58.08%,28.81%,1
高雄市,鳳山區,1379,399,464,863,22,885,1358,65.17%,29.38%,1
高雄市,鳳山區,1380,357,444,801,32,833,1226,67.94%,29.12%,1
高雄市,鳳山區,1381,349,335,684,34,718,1098,65.39%,31.79%,1
高雄市,鳳山區,1382,328,398,726,27,753,1200,62.75%,27.33%,1
高雄市,鳳山區,1383,300,212,512,26,538,942,57.11%,31.85%,1
高雄市,鳳山區,1384,325,383,708,24,732,1206,60.7%,26.95%,1
高雄市,鳳山區,1385,316,420,736,26,762,1159,65.75%,27.26%,1
高雄市,鳳山區,1386,439,418,857,28,885,1401,63.17%,31.33%,1
高雄市,鳳山區,1387,404,455,859,21,880,1525,57.7%,26.49%,1
高雄市,鳳山區,1388,407,378,785,27,812,1345,60.37%,30.26%,1
高雄市,鳳山區,1389,382,368,750,33,783,1180,66.36%,32.37%,1
高雄市,鳳山區,1390,311,316,627,20,647,1106,58.5%,28.12%,1
高雄市,鳳山區,1391,343,519,862,48,910,1442,63.11%,23.79%,1
高雄市,鳳山區,1392,358,468,826,36,862,1376,62.65%,26.02%,1
高雄市,鳳山區,1393,324,413,737,26,763,1243,61.38%,26.07%,1
高雄市,鳳山區,1394,377,438,815,15,830,1361,60.98%,27.7%,1
高雄市,鳳山區,1395,420,432,852,39,891,1416,62.92%,29.66%,1
高雄市,鳳山區,1396,460,522,982,30,1012,1536,65.89%,29.95%,1
高雄市,鳳山區,1397,381,381,762,33,795,1388,57.28%,27.45%,1
高雄市,鳳山區,1398,392,350,742,56,798,1241,64.3%,31.59%,1
高雄市,鳳山區,1399,395,459,854,33,887,1394,63.63%,28.34%,1
高雄市,鳳山區,1400,313,462,775,21,796,1188,67%,26.35%,1
高雄市,鳳山區,1401,349,326,675,25,700,1112,62.95%,31.38%,1
高雄市,鳳山區,1402,377,393,770,32,802,1198,66.94%,31.47%,1
高雄市,鳳山區,1403,374,470,844,21,865,1475,58.64%,25.36%,1
高雄市,鳳山區,1404,392,306,698,29,727,1216,59.79%,32.24%,1
高雄市,鳳山區,1405,442,297,739,26,765,1318,58.04%,33.54%,1
高雄市,鳳山區,1406,391,465,856,16,872,1465,59.52%,26.69%,1
高雄市,鳳山區,1407,410,331,741,21,762,1314,57.99%,31.2%,1
高雄市,鳳山區,1408,424,439,863,20,883,1649,53.55%,25.71%,1
高雄市,鳳山區,1409,437,419,856,69,925,1601,57.78%,27.3%,1
高雄市,鳳山區,1410,336,431,767,18,785,1155,67.97%,29.09%,1
高雄市,鳳山區,1411,318,284,602,51,653,1050,62.19%,30.29%,1
高雄市,鳳山區,1412,366,387,753,17,770,1417,54.34%,25.83%,1
高雄市,鳳山區,1413,403,444,847,50,897,1525,58.82%,26.43%,1
高雄市,鳳山區,1414,382,497,879,39,918,1514,60.63%,25.23%,1
高雄市,鳳山區,1415,362,314,676,34,710,1190,59.66%,30.42%,1
高雄市,鳳山區,1416,333,407,740,23,763,1325,57.58%,25.13%,1
高雄市,鳳山區,1417,303,330,633,34,667,1049,63.58%,28.88%,1
高雄市,鳳山區,1418,326,300,626,20,646,1026,62.96%,31.77%,1
高雄市,鳳山區,1419,320,372,692,36,728,1152,63.19%,27.78%,1
高雄市,鳳山區,1420,434,250,684,12,696,1254,55.5%,34.61%,1
高雄市,鳳山區,1421,505,394,899,27,926,1688,54.86%,29.92%,1
高雄市,鳳山區,1422,395,547,942,44,986,1657,59.51%,23.84%,1
高雄市,鳳山區,1423,408,503,911,17,928,1729,53.67%,23.6%,1
高雄市,鳳山區,1424,449,503,952,45,997,1628,61.24%,27.58%,1
高雄市,鳳山區,1425,426,540,966,12,978,1891,51.72%,22.53%,1
高雄市,鳳山區,1426,387,584,971,31,1002,1594,62.86%,24.28%,1
高雄市,鳳山區,1427,354,508,862,13,875,1342,65.2%,26.38%,1
高雄市,鳳山區,1428,425,505,930,20,950,1448,65.61%,29.35%,1
高雄市,鳳山區,1429,421,409,830,48,878,1405,62.49%,29.96%,1
高雄市,鳳山區,1430,376,303,679,44,723,1097,65.91%,34.28%,1
高雄市,鳳山區,1431,415,357,772,57,829,1248,66.43%,33.25%,1
高雄市,鳳山區,1432,376,346,722,49,771,1225,62.94%,30.69%,1
高雄市,鳳山區,1433,376,331,707,34,741,1214,61.04%,30.97%,1
高雄市,鳳山區,1434,519,666,1185,70,1255,2032,61.76%,25.54%,1
高雄市,鳳山區,1435,523,602,1125,39,1164,1927,60.4%,27.14%,1
高雄市,鳳山區,1436,576,688,1264,43,1307,2097,62.33%,27.47%,1
高雄市,鳳山區,1437,294,257,551,23,574,968,59.3%,30.37%,1
高雄市,鳳山區,1438,344,321,665,35,700,1200,58.33%,28.67%,1
高雄市,鳳山區,1439,325,310,635,48,683,1101,62.03%,29.52%,1
高雄市,鳳山區,1440,393,352,745,33,778,1369,56.83%,28.71%,1
高雄市,鳳山區,1441,453,425,878,45,923,1542,59.86%,29.38%,1
高雄市,鳳山區,1442,462,468,930,34,964,1536,62.76%,30.08%,1
高雄市,鳳山區,1443,416,378,794,18,812,1382,58.76%,30.1%,1
高雄市,鳳山區,1444,486,379,865,48,913,1452,62.88%,33.47%,1
高雄市,鳳山區,1445,284,328,612,41,653,1058,61.72%,26.84%,1
高雄市,鳳山區,1446,301,294,595,43,638,976,65.37%,30.84%,1
高雄市,鳳山區,1447,387,433,820,24,844,1545,54.63%,25.05%,1
高雄市,鳳山區,1448,348,303,651,31,682,1143,59.67%,30.45%,1
高雄市,鳳山區,1449,190,165,355,15,370,1301,28.44%,14.6%,1
高雄市,鳳山區,1450,290,341,631,29,660,1250,52.8%,23.2%,1
高雄市,鳳山區,1451,370,332,702,24,726,1208,60.1%,30.63%,1
高雄市,鳳山區,1452,340,354,694,51,745,1202,61.98%,28.29%,1
高雄市,鳳山區,1453,408,415,823,58,881,1499,58.77%,27.22%,1
高雄市,鳳山區,1454,378,434,812,35,847,1522,55.65%,24.84%,1
高雄市,鳳山區,1455,324,383,707,36,743,1125,66.04%,28.8%,1
高雄市,鳳山區,1456,372,404,776,26,802,1307,61.36%,28.46%,1
高雄市,鳳山區,1457,406,403,809,40,849,1405,60.43%,28.9%,1
高雄市,鳳山區,1458,344,375,719,41,760,1252,60.7%,27.48%,1
高雄市,鳳山區,1459,364,447,811,30,841,1291,65.14%,28.2%,1
高雄市,鳳山區,1460,288,270,558,50,608,938,64.82%,30.7%,1
高雄市,鳳山區,1461,523,516,1039,33,1072,1783,60.12%,29.33%,1
高雄市,鳳山區,1462,328,346,674,31,705,1105,63.8%,29.68%,1
高雄市,鳳山區,1463,433,350,783,62,845,1392,60.7%,31.11%,1
高雄市,鳳山區,1464,381,421,802,31,833,1244,66.96%,30.63%,1
高雄市,鳳山區,1465,342,310,652,32,684,1154,59.27%,29.64%,1
高雄市,鳳山區,1466,304,363,667,38,705,1153,61.14%,26.37%,1
高雄市,鳳山區,1467,319,295,614,14,628,1148,54.7%,27.79%,1
高雄市,鳳山區,1468,339,425,764,66,830,1432,57.96%,23.67%,1
高雄市,鳳山區,1469,400,216,616,28,644,1429,45.07%,27.99%,1
高雄市,鳳山區,1470,410,429,839,26,865,1479,58.49%,27.72%,1
高雄市,鳳山區,1471,356,284,640,28,668,1026,65.11%,34.7%,1
高雄市,鳳山區,1472,361,266,627,57,684,993,68.88%,36.35%,1
高雄市,鳳山區,1473,98,478,576,46,622,947,65.68%,10.35%,1
高雄市,鳳山區,1474,330,281,611,34,645,1042,61.9%,31.67%,1
高雄市,鳳山區,1475,363,284,647,28,675,1098,61.48%,33.06%,1
高雄市,鳳山區,1476,388,321,709,19,728,1284,56.7%,30.22%,1
高雄市,鳳山區,1477,364,307,671,34,705,1242,56.76%,29.31%,1
高雄市,鳳山區,1478,331,316,647,46,693,1093,63.4%,30.28%,1
高雄市,鳳山區,1479,414,336,750,34,784,1353,57.95%,30.6%,1
高雄市,鳳山區,1480,372,352,724,22,746,1353,55.14%,27.49%,1
高雄市,鳳山區,1481,341,436,777,39,816,1309,62.34%,26.05%,1
高雄市,鳳山區,1482,464,477,941,39,980,1627,60.23%,28.52%,1
高雄市,鳳山區,1483,425,379,804,50,854,1372,62.24%,30.98%,1
高雄市,林園區,1773,393,342,735,46,781,1262,61.89%,31.14%,1
高雄市,林園區,1774,387,420,807,46,853,1562,54.61%,24.78%,1
高雄市,林園區,1775,318,305,623,23,646,1078,59.93%,29.5%,1
高雄市,林園區,1776,280,315,595,37,632,979,64.56%,28.6%,1
高雄市,林園區,1777,354,292,646,38,684,1195,57.24%,29.62%,1
高雄市,林園區,1778,353,360,713,46,759,1380,55%,25.58%,1
高雄市,林園區,1779,320,379,699,39,738,1280,57.66%,25%,1
高雄市,林園區,1780,341,339,680,19,699,1269,55.08%,26.87%,1
高雄市,林園區,1781,338,341,679,17,696,1568,44.39%,21.56%,1
高雄市,林園區,1782,325,372,697,41,738,1226,60.2%,26.51%,1
高雄市,林園區,1783,351,424,775,48,823,1480,55.61%,23.72%,1
高雄市,林園區,1784,368,461,829,38,867,1459,59.42%,25.22%,1
高雄市,林園區,1785,459,377,836,45,881,1593,55.3%,28.81%,1
高雄市,林園區,1786,267,231,498,51,549,895,61.34%,29.83%,1
高雄市,林園區,1787,290,272,562,27,589,1110,53.06%,26.13%,1
高雄市,林園區,1788,390,324,714,26,740,1348,54.9%,28.93%,1
高雄市,林園區,1789,283,237,520,32,552,912,60.53%,31.03%,1
高雄市,林園區,1790,350,321,671,38,709,1085,65.35%,32.26%,1
高雄市,林園區,1791,277,246,523,37,560,955,58.64%,29.01%,1
高雄市,林園區,1792,291,231,522,27,549,879,62.46%,33.11%,1
高雄市,林園區,1793,360,261,621,35,656,1103,59.47%,32.64%,1
高雄市,林園區,1794,351,296,647,43,690,1054,65.46%,33.3%,1
高雄市,林園區,1795,341,326,667,18,685,1292,53.02%,26.39%,1
高雄市,林園區,1796,439,385,824,15,839,1683,49.85%,26.08%,1
高雄市,林園區,1797,152,183,335,21,356,607,58.65%,25.04%,1
高雄市,林園區,1798,293,261,554,41,595,1012,58.79%,28.95%,1
高雄市,林園區,1799,314,270,584,36,620,1046,59.27%,30.02%,1
高雄市,林園區,1800,184,239,423,21,444,914,48.58%,20.13%,1
高雄市,林園區,1801,396,408,804,39,843,1405,60%,28.19%,1
高雄市,林園區,1802,360,396,756,48,804,1299,61.89%,27.71%,1
高雄市,林園區,1803,326,334,660,28,688,1170,58.8%,27.86%,1
高雄市,林園區,1804,349,277,626,31,657,1299,50.58%,26.87%,1
高雄市,林園區,1805,277,290,567,25,592,1031,57.42%,26.87%,1
高雄市,林園區,1806,260,220,480,14,494,849,58.19%,30.62%,1
高雄市,林園區,1807,293,169,462,37,499,838,59.55%,34.96%,1
高雄市,林園區,1808,317,247,564,17,581,938,61.94%,33.8%,1
高雄市,林園區,1809,309,231,540,32,572,1051,54.42%,29.4%,1
高雄市,林園區,1810,266,186,452,32,484,786,61.58%,33.84%,1
高雄市,林園區,1811,301,212,513,64,577,894,64.54%,33.67%,1
高雄市,林園區,1812,201,133,334,14,348,749,46.46%,26.84%,1
高雄市,林園區,1813,473,414,887,38,925,1485,62.29%,31.85%,1
高雄市,林園區,1814,447,402,849,62,911,1478,61.64%,30.24%,1
高雄市,林園區,1815,376,431,807,49,856,1345,63.64%,27.96%,1
高雄市,林園區,1816,400,164,564,17,581,1038,55.97%,38.54%,1
高雄市,林園區,1817,366,306,672,29,701,1203,58.27%,30.42%,1
高雄市,林園區,1818,352,292,644,24,668,1138,58.7%,30.93%,1
高雄市,林園區,1819,246,266,512,17,529,1025,51.61%,24%,1
高雄市,林園區,1820,378,354,732,63,795,1341,59.28%,28.19%,1
高雄市,林園區,1821,311,257,568,22,590,1218,48.44%,25.53%,1
高雄市,林園區,1822,334,218,552,22,574,1147,50.04%,29.12%,1
高雄市,林園區,1823,350,228,578,20,598,1176,50.85%,29.76%,1
高雄市,大寮區,1692,243,147,390,20,410,727,56.4%,33.43%,1
高雄市,大寮區,1693,225,157,382,17,399,718,55.57%,31.34%,1
高雄市,大寮區,1694,333,351,684,32,716,1340,53.43%,24.85%,1
高雄市,大寮區,1695,343,379,722,26,748,1575,47.49%,21.78%,1
高雄市,大寮區,1696,128,119,247,17,264,444,59.46%,28.83%,1
高雄市,大寮區,1697,470,553,1023,35,1058,2374,44.57%,19.8%,1
高雄市,大寮區,1698,389,309,698,41,739,1291,57.24%,30.13%,1
高雄市,大寮區,1699,390,385,775,48,823,1400,58.79%,27.86%,1
高雄市,大寮區,1700,389,360,749,25,774,1390,55.68%,27.99%,1
高雄市,大寮區,1701,403,337,740,48,788,1401,56.25%,28.77%,1
高雄市,大寮區,1702,313,312,625,24,649,1199,54.13%,26.11%,1
高雄市,大寮區,1703,352,266,618,19,637,1210,52.64%,29.09%,1
高雄市,大寮區,1704,368,286,654,40,694,1195,58.08%,30.79%,1
高雄市,大寮區,1705,368,269,637,22,659,1166,56.52%,31.56%,1
高雄市,大寮區,1706,392,358,750,35,785,1353,58.02%,28.97%,1
高雄市,大寮區,1707,300,299,599,49,648,1052,61.6%,28.52%,1
高雄市,大寮區,1708,287,220,507,22,529,1024,51.66%,28.03%,1
高雄市,大寮區,1709,381,301,682,16,698,1189,58.7%,32.04%,1
高雄市,大寮區,1710,439,429,868,50,918,1512,60.71%,29.03%,1
高雄市,大寮區,1711,465,383,848,48,896,1633,54.87%,28.48%,1
高雄市,大寮區,1712,427,328,755,22,777,1214,64%,35.17%,1
高雄市,大寮區,1713,422,354,776,67,843,1258,67.01%,33.55%,1
高雄市,大寮區,1714,458,346,804,26,830,1323,62.74%,34.62%,1
高雄市,大寮區,1715,334,412,746,32,778,1253,62.09%,26.66%,1
高雄市,大寮區,1716,294,312,606,51,657,1035,63.48%,28.41%,1
高雄市,大寮區,1717,302,324,626,29,655,1106,59.22%,27.31%,1
高雄市,大寮區,1718,335,322,657,30,687,1195,57.49%,28.03%,1
高雄市,大寮區,1719,356,283,639,24,663,1051,63.08%,33.87%,1
高雄市,大寮區,1720,392,429,821,47,868,1425,60.91%,27.51%,1
高雄市,大寮區,1721,396,494,890,37,927,1635,56.7%,24.22%,1
高雄市,大寮區,1722,413,374,787,39,826,1359,60.78%,30.39%,1
高雄市,大寮區,1723,352,413,765,54,819,1361,60.18%,25.86%,1
高雄市,大寮區,1724,410,502,912,35,947,1629,58.13%,25.17%,1
高雄市,大寮區,1725,375,470,845,43,888,1518,58.5%,24.7%,1
高雄市,大寮區,1726,380,492,872,45,917,1620,56.6%,23.46%,1
高雄市,大寮區,1727,430,441,871,23,894,1648,54.25%,26.09%,1
高雄市,大寮區,1728,753,30,783,46,829,1385,59.86%,54.37%,1
高雄市,大寮區,1729,375,421,796,18,814,1435,56.72%,26.13%,1
高雄市,大寮區,1730,331,270,601,19,620,1046,59.27%,31.64%,1
高雄市,大寮區,1731,236,170,406,29,435,789,55.13%,29.91%,1
高雄市,大寮區,1732,244,226,470,28,498,909,54.79%,26.84%,1
高雄市,大寮區,1733,255,165,420,29,449,733,61.26%,34.79%,1
高雄市,大寮區,1734,391,409,800,57,857,1553,55.18%,25.18%,1
高雄市,大寮區,1735,254,242,496,30,526,922,57.05%,27.55%,1
高雄市,大寮區,1736,313,233,546,52,598,1012,59.09%,30.93%,1
高雄市,大寮區,1737,313,194,507,40,547,968,56.51%,32.33%,1
高雄市,大寮區,1738,331,258,589,33,622,1021,60.92%,32.42%,1
高雄市,大寮區,1739,406,345,751,39,790,1554,50.84%,26.13%,1
高雄市,大寮區,1740,330,328,658,29,687,1120,61.34%,29.46%,1
高雄市,大寮區,1741,350,377,727,34,761,1225,62.12%,28.57%,1
高雄市,大寮區,1742,219,269,488,23,511,1320,38.71%,16.59%,1
高雄市,大寮區,1743,329,397,726,39,765,1317,58.09%,24.98%,1
高雄市,大寮區,1744,277,355,632,10,642,1119,57.37%,24.75%,1
高雄市,大寮區,1745,352,343,695,28,723,1190,60.76%,29.58%,1
高雄市,大寮區,1746,320,394,714,42,756,1229,61.51%,26.04%,1
高雄市,大寮區,1747,293,430,723,30,753,1178,63.92%,24.87%,1
高雄市,大寮區,1748,336,439,775,22,797,1272,62.66%,26.42%,1
高雄市,大寮區,1749,380,401,781,20,801,1413,56.69%,26.89%,1
高雄市,大寮區,1750,318,410,728,22,750,1185,63.29%,26.84%,1
高雄市,大寮區,1751,111,211,322,6,328,553,59.31%,20.07%,1
高雄市,大寮區,1752,315,296,611,51,662,1121,59.05%,28.1%,1
高雄市,大寮區,1753,339,370,709,22,731,1227,59.58%,27.63%,1
高雄市,大寮區,1754,326,349,675,46,721,1058,68.15%,30.81%,1
高雄市,大寮區,1755,350,324,674,24,698,1209,57.73%,28.95%,1
高雄市,大寮區,1756,325,332,657,21,678,1100,61.64%,29.55%,1
高雄市,大寮區,1757,299,313,612,20,632,1122,56.33%,26.65%,1
高雄市,大寮區,1758,343,263,606,44,650,983,66.12%,34.89%,1
高雄市,大寮區,1759,339,282,621,19,640,1192,53.69%,28.44%,1
高雄市,大寮區,1760,196,211,407,23,430,719,59.81%,27.26%,1
高雄市,大寮區,1761,259,252,511,16,527,829,63.57%,31.24%,1
高雄市,大寮區,1762,231,258,489,44,533,771,69.13%,29.96%,1
高雄市,大寮區,1763,347,292,639,49,688,1075,64%,32.28%,1
高雄市,大寮區,1764,404,333,737,60,797,1280,62.27%,31.56%,1
高雄市,大寮區,1765,359,306,665,40,705,1179,59.8%,30.45%,1
高雄市,大寮區,1766,333,330,663,28,691,1210,57.11%,27.52%,1
高雄市,大寮區,1767,46,66,112,8,120,189,63.49%,24.34%,1
高雄市,大寮區,1768,256,451,707,50,757,1228,61.64%,20.85%,1
高雄市,大寮區,1769,251,393,644,39,683,1170,58.38%,21.45%,1
高雄市,大寮區,1770,284,553,837,40,877,1416,61.94%,20.06%,1
高雄市,大寮區,1771,353,523,876,36,912,1482,61.54%,23.82%,1
高雄市,大寮區,1772,273,521,794,34,828,1478,56.02%,18.47%,1
高雄市,大樹區,0736,396,374,770,30,800,1386,57.72%,28.57%,1
高雄市,大樹區,0737,398,438,836,25,861,1315,65.48%,30.27%,1
高雄市,大樹區,0738,608,694,1302,58,1360,2461,55.26%,24.71%,1
高雄市,大樹區,0739,357,366,723,21,744,1274,58.4%,28.02%,1
高雄市,大樹區,0740,327,348,675,45,720,1265,56.92%,25.85%,1
高雄市,大樹區,0741,379,430,809,43,852,1504,56.65%,25.2%,1
高雄市,大樹區,0742,285,268,553,22,575,1049,54.81%,27.17%,1
高雄市,大樹區,0743,436,428,864,13,877,1573,55.75%,27.72%,1
高雄市,大樹區,0744,341,245,586,25,611,1121,54.5%,30.42%,1
高雄市,大樹區,0745,538,222,760,41,801,1207,66.36%,44.57%,1
高雄市,大樹區,0746,342,303,645,22,667,1134,58.82%,30.16%,1
高雄市,大樹區,0747,407,293,700,27,727,1124,64.68%,36.21%,1
高雄市,大樹區,0748,373,305,678,42,720,1259,57.19%,29.63%,1
高雄市,大樹區,0749,337,317,654,44,698,1105,63.17%,30.5%,1
高雄市,大樹區,0750,341,284,625,31,656,1128,58.16%,30.23%,1
高雄市,大樹區,0751,329,235,564,46,610,1079,56.53%,30.49%,1
高雄市,大樹區,0752,304,233,537,40,577,1025,56.29%,29.66%,1
高雄市,大樹區,0753,288,219,507,30,537,950,56.53%,30.32%,1
高雄市,大樹區,0754,439,337,776,52,828,1433,57.78%,30.64%,1
高雄市,大樹區,0755,241,176,417,18,435,794,54.79%,30.35%,1
高雄市,大樹區,0756,227,149,376,19,395,781,50.58%,29.07%,1
高雄市,大樹區,0757,335,319,654,20,674,1318,51.14%,25.42%,1
高雄市,大樹區,0758,245,156,401,31,432,736,58.7%,33.29%,1
高雄市,大樹區,0759,316,203,519,15,534,1047,51%,30.18%,1
高雄市,大樹區,0760,407,305,712,48,760,1271,59.8%,32.02%,1
高雄市,大樹區,0761,310,292,602,35,637,1186,53.71%,26.14%,1
高雄市,大樹區,0762,307,272,579,37,616,1007,61.17%,30.49%,1
高雄市,大樹區,0763,290,221,511,18,529,859,61.58%,33.76%,1
高雄市,大樹區,0764,243,171,414,11,425,735,57.82%,33.06%,1
高雄市,大樹區,0765,372,246,618,40,658,1046,62.91%,35.56%,1
高雄市,大樹區,0766,148,482,630,24,654,880,74.32%,16.82%,1
高雄市,大樹區,0767,206,186,392,12,404,720,56.11%,28.61%,1
高雄市,大社區,0637,280,228,508,43,551,950,58%,29.47%,1
高雄市,大社區,0638,356,322,678,30,708,1306,54.21%,27.26%,1
高雄市,大社區,0639,358,473,831,21,852,1856,45.91%,19.29%,1
高雄市,大社區,0640,335,275,610,37,647,986,65.62%,33.98%,1
高雄市,大社區,0641,274,260,534,39,573,1116,51.34%,24.55%,1
高雄市,大社區,0642,443,338,781,36,817,1253,65.2%,35.36%,1
高雄市,大社區,0643,468,477,945,39,984,1613,61%,29.01%,1
高雄市,大社區,0644,399,360,759,24,783,1455,53.81%,27.42%,1
高雄市,大社區,0645,554,441,995,33,1028,1674,61.41%,33.09%,1
高雄市,大社區,0646,287,278,565,52,617,1004,61.45%,28.59%,1
高雄市,大社區,0647,299,224,523,23,546,879,62.12%,34.02%,1
高雄市,大社區,0648,269,176,445,15,460,778,59.13%,34.58%,1
高雄市,大社區,0649,350,309,659,29,688,1110,61.98%,31.53%,1
高雄市,大社區,0650,418,365,783,40,823,1432,57.47%,29.19%,1
高雄市,大社區,0651,457,428,885,31,916,1466,62.48%,31.17%,1
高雄市,大社區,0652,463,398,861,53,914,1383,66.09%,33.48%,1
高雄市,大社區,0653,384,469,853,41,894,1645,54.35%,23.34%,1
高雄市,大社區,0654,393,383,776,41,817,1555,52.54%,25.27%,1
高雄市,大社區,0655,527,471,998,42,1040,1750,59.43%,30.11%,1
高雄市,大社區,0656,346,285,631,41,672,1111,60.49%,31.14%,1
高雄市,大社區,0657,342,316,658,43,701,1133,61.87%,30.19%,1
高雄市,大社區,0658,258,272,530,37,567,912,62.17%,28.29%,1
高雄市,大社區,0659,215,154,369,11,380,745,51.01%,28.86%,1
高雄市,大社區,0660,287,264,551,28,579,934,61.99%,30.73%,1
高雄市,仁武區,0661,574,571,1145,46,1191,1777,67.02%,32.3%,1
高雄市,仁武區,0662,638,722,1360,55,1415,2273,62.25%,28.07%,1
高雄市,仁武區,0663,456,439,895,31,926,1384,66.91%,32.95%,1
高雄市,仁武區,0664,308,341,649,49,698,1170,59.66%,26.32%,1
高雄市,仁武區,0665,416,370,786,34,820,1216,67.43%,34.21%,1
高雄市,仁武區,0666,425,460,885,36,921,1598,57.63%,26.6%,1
高雄市,仁武區,0667,573,752,1325,40,1365,2143,63.7%,26.74%,1
高雄市,仁武區,0668,392,327,719,41,760,1300,58.46%,30.15%,1
高雄市,仁武區,0669,378,396,774,52,826,1338,61.73%,28.25%,1
高雄市,仁武區,0670,341,347,688,17,705,1217,57.93%,28.02%,1
高雄市,仁武區,0671,301,275,576,51,627,1202,52.16%,25.04%,1
高雄市,仁武區,0672,360,399,759,30,789,1404,56.2%,25.64%,1
高雄市,仁武區,0673,259,195,454,31,485,830,58.43%,31.2%,1
高雄市,仁武區,0674,422,383,805,35,840,1802,46.61%,23.42%,1
高雄市,仁武區,0675,510,485,995,36,1031,1877,54.93%,27.17%,1
高雄市,仁武區,0676,437,396,833,23,856,1738,49.25%,25.14%,1
高雄市,仁武區,0677,488,377,865,49,914,1549,59.01%,31.5%,1
高雄市,仁武區,0678,464,444,908,36,944,1579,59.78%,29.39%,1
高雄市,仁武區,0679,415,380,795,23,818,1406,58.18%,29.52%,1
高雄市,仁武區,0680,410,447,857,20,877,1461,60.03%,28.06%,1
高雄市,仁武區,0681,394,397,791,32,823,1311,62.78%,30.05%,1
高雄市,仁武區,0682,423,361,784,25,809,1373,58.92%,30.81%,1
高雄市,仁武區,0683,400,213,613,8,621,1035,60%,38.65%,1
高雄市,仁武區,0684,409,269,678,23,701,1181,59.36%,34.63%,1
高雄市,仁武區,0685,494,403,897,48,945,1670,56.59%,29.58%,1
高雄市,仁武區,0686,445,429,874,29,903,1576,57.3%,28.24%,1
高雄市,仁武區,0687,447,506,953,38,991,1576,62.88%,28.36%,1
高雄市,仁武區,0688,505,656,1161,31,1192,1915,62.25%,26.37%,1
高雄市,仁武區,0689,481,491,972,23,995,1758,56.6%,27.36%,1
高雄市,仁武區,0690,512,635,1147,41,1188,1892,62.79%,27.06%,1
高雄市,仁武區,0691,553,631,1184,48,1232,2025,60.84%,27.31%,1
高雄市,仁武區,0692,534,686,1220,43,1263,2014,62.71%,26.51%,1
高雄市,仁武區,0693,529,438,967,29,996,1473,67.62%,35.91%,1
高雄市,仁武區,0694,336,241,577,21,598,979,61.08%,34.32%,1
高雄市,仁武區,0695,280,272,552,21,573,944,60.7%,29.66%,1
高雄市,仁武區,0696,371,287,658,54,712,1153,61.75%,32.18%,1
高雄市,仁武區,0697,384,340,724,28,752,1328,56.63%,28.92%,1
高雄市,仁武區,0698,465,474,939,57,996,1657,60.11%,28.06%,1
高雄市,仁武區,0699,411,387,798,37,835,1545,54.05%,26.6%,1
高雄市,仁武區,0700,444,412,856,36,892,1417,62.95%,31.33%,1
高雄市,仁武區,0701,439,563,1002,33,1035,1602,64.61%,27.4%,1
高雄市,仁武區,0702,554,603,1157,40,1197,1823,65.66%,30.39%,1
高雄市,仁武區,0703,552,537,1089,30,1119,1914,58.46%,28.84%,1
高雄市,仁武區,0704,541,602,1143,41,1184,1992,59.44%,27.16%,1
高雄市,仁武區,0705,504,549,1053,27,1080,2045,52.81%,24.65%,1
高雄市,仁武區,0706,588,618,1206,25,1231,1982,62.11%,29.67%,1
高雄市,仁武區,0707,584,586,1170,30,1200,2167,55.38%,26.95%,1
高雄市,鳥松區,0708,451,517,968,30,998,1678,59.48%,26.88%,1
高雄市,鳥松區,0709,427,456,883,49,932,1682,55.41%,25.39%,1
高雄市,鳥松區,0710,397,359,756,40,796,1225,64.98%,32.41%,1
高雄市,鳥松區,0711,338,359,697,40,737,1322,55.75%,25.57%,1
高雄市,鳥松區,0712,340,379,719,26,745,1215,61.32%,27.98%,1
高雄市,鳥松區,0713,486,480,966,38,1004,1779,56.44%,27.32%,1
高雄市,鳥松區,0714,407,321,728,14,742,1129,65.72%,36.05%,1
高雄市,鳥松區,0715,382,456,838,33,871,1374,63.39%,27.8%,1
高雄市,鳥松區,0716,474,175,649,25,674,1089,61.89%,43.53%,1
高雄市,鳥松區,0717,596,754,1350,33,1383,2219,62.33%,26.86%,1
高雄市,鳥松區,0718,524,454,978,24,1002,1634,61.32%,32.07%,1
高雄市,鳥松區,0719,409,538,947,49,996,1553,64.13%,26.34%,1
高雄市,鳥松區,0720,440,540,980,31,1011,1572,64.31%,27.99%,1
高雄市,鳥松區,0721,508,539,1047,33,1080,1688,63.98%,30.09%,1
高雄市,鳥松區,0722,499,513,1012,22,1034,1626,63.59%,30.69%,1
高雄市,鳥松區,0723,528,571,1099,46,1145,1744,65.65%,30.28%,1
高雄市,鳥松區,0724,348,309,657,33,690,1230,56.1%,28.29%,1
高雄市,鳥松區,0725,664,73,737,41,778,1201,64.78%,55.29%,1
高雄市,鳥松區,0726,359,371,730,25,755,1117,67.59%,32.14%,1
高雄市,鳥松區,0727,370,331,701,56,757,1255,60.32%,29.48%,1
高雄市,鳥松區,0728,354,404,758,30,788,1432,55.03%,24.72%,1
高雄市,鳥松區,0729,378,350,728,34,762,1370,55.62%,27.59%,1
高雄市,鳥松區,0730,384,442,826,34,860,1364,63.05%,28.15%,1
高雄市,鳥松區,0731,323,297,620,59,679,1041,65.23%,31.03%,1
高雄市,鳥松區,0732,280,207,487,24,511,702,72.79%,39.89%,1
高雄市,鳥松區,0733,421,279,700,38,738,1212,60.89%,34.74%,1
高雄市,鳥松區,0734,342,379,721,40,761,1289,59.04%,26.53%,1
高雄市,鳥松區,0735,454,464,918,19,937,1449,64.67%,31.33%,1
高雄市,岡山區,0261,402,469,871,31,902,1345,67.06%,29.89%,1
高雄市,岡山區,0262,274,223,497,27,524,1045,50.14%,26.22%,1
高雄市,岡山區,0263,298,328,626,19,645,1051,61.37%,28.35%,1
高雄市,岡山區,0264,294,275,569,16,585,917,63.79%,32.06%,1
高雄市,岡山區,0265,295,297,592,24,616,934,65.95%,31.58%,1
高雄市,岡山區,0266,304,367,671,31,702,1097,63.99%,27.71%,1
高雄市,岡山區,0267,307,473,780,28,808,1208,66.89%,25.41%,1
高雄市,岡山區,0268,360,374,734,42,776,1159,66.95%,31.06%,1
高雄市,岡山區,0269,304,310,614,27,641,1018,62.97%,29.86%,1
高雄市,岡山區,0270,425,305,730,21,751,1316,57.07%,32.29%,1
高雄市,岡山區,0271,327,447,774,29,803,1345,59.7%,24.31%,1
高雄市,岡山區,0272,341,445,786,28,814,1295,62.86%,26.33%,1
高雄市,岡山區,0273,350,460,810,39,849,1425,59.58%,24.56%,1
高雄市,岡山區,0274,386,366,752,43,795,1328,59.86%,29.07%,1
高雄市,岡山區,0275,333,513,846,17,863,1382,62.45%,24.1%,1
高雄市,岡山區,0276,281,561,842,11,853,1381,61.77%,20.35%,1
高雄市,岡山區,0277,362,381,743,42,785,1282,61.23%,28.24%,1
高雄市,岡山區,0278,321,389,710,17,727,1240,58.63%,25.89%,1
高雄市,岡山區,0279,370,405,775,30,805,1327,60.66%,27.88%,1
高雄市,岡山區,0280,424,515,939,32,971,1736,55.93%,24.42%,1
高雄市,岡山區,0281,437,483,920,36,956,1566,61.05%,27.91%,1
高雄市,岡山區,0282,430,491,921,19,940,1779,52.84%,24.17%,1
高雄市,岡山區,0283,619,317,936,33,969,1593,60.83%,38.86%,1
高雄市,岡山區,0284,444,457,901,29,930,1480,62.84%,30%,1
高雄市,岡山區,0285,347,463,810,20,830,1364,60.85%,25.44%,1
高雄市,岡山區,0286,418,425,843,28,871,1410,61.77%,29.65%,1
高雄市,岡山區,0287,360,394,754,37,791,1148,68.9%,31.36%,1
高雄市,岡山區,0288,238,169,407,19,426,625,68.16%,38.08%,1
高雄市,岡山區,0289,267,312,579,24,603,969,62.23%,27.55%,1
高雄市,岡山區,0290,268,273,541,15,556,861,64.58%,31.13%,1
高雄市,岡山區,0291,259,217,476,19,495,823,60.15%,31.47%,1
高雄市,岡山區,0292,307,257,564,38,602,889,67.72%,34.53%,1
高雄市,岡山區,0293,346,402,748,32,780,1283,60.8%,26.97%,1
高雄市,岡山區,0294,369,465,834,32,866,1512,57.28%,24.4%,1
高雄市,岡山區,0295,297,335,632,41,673,983,68.46%,30.21%,1
高雄市,岡山區,0296,329,395,724,34,758,1262,60.06%,26.07%,1
高雄市,岡山區,0297,331,333,664,28,692,1096,63.14%,30.2%,1
高雄市,岡山區,0298,316,311,627,28,655,1066,61.44%,29.64%,1
高雄市,岡山區,0299,254,389,643,30,673,1188,56.65%,21.38%,1
高雄市,岡山區,0300,376,465,841,26,867,1360,63.75%,27.65%,1
高雄市,岡山區,0301,391,457,848,27,875,1363,64.2%,28.69%,1
高雄市,岡山區,0302,321,513,834,47,881,1352,65.16%,23.74%,1
高雄市,岡山區,0303,335,505,840,29,869,1460,59.52%,22.95%,1
高雄市,岡山區,0304,328,426,754,33,787,1272,61.87%,25.79%,1
高雄市,岡山區,0305,267,397,664,35,699,1080,64.72%,24.72%,1
高雄市,岡山區,0306,370,380,750,39,789,1255,62.87%,29.48%,1
高雄市,岡山區,0307,258,336,594,35,629,938,67.06%,27.51%,1
高雄市,岡山區,0308,313,451,764,34,798,1237,64.51%,25.3%,1
高雄市,岡山區,0309,449,362,811,19,830,1413,58.74%,31.78%,1
高雄市,岡山區,0310,279,214,493,11,504,765,65.88%,36.47%,1
高雄市,岡山區,0311,282,391,673,21,694,1043,66.54%,27.04%,1
高雄市,岡山區,0312,250,219,469,28,497,844,58.89%,29.62%,1
高雄市,岡山區,0313,324,374,698,38,736,993,74.12%,32.63%,1
高雄市,岡山區,0314,312,317,629,47,676,1038,65.13%,30.06%,1
高雄市,岡山區,0315,362,258,620,48,668,1070,62.43%,33.83%,1
高雄市,岡山區,0316,376,293,669,38,707,1023,69.11%,36.75%,1
高雄市,岡山區,0317,430,373,803,21,824,1349,61.08%,31.88%,1
高雄市,岡山區,0318,346,415,761,46,807,1452,55.58%,23.83%,1
高雄市,岡山區,0319,124,80,204,7,211,301,70.1%,41.2%,1
高雄市,岡山區,0320,288,199,487,35,522,756,69.05%,38.1%,1
高雄市,岡山區,0321,229,163,392,15,407,733,55.53%,31.24%,1
高雄市,岡山區,0322,330,221,551,56,607,854,71.08%,38.64%,1
高雄市,岡山區,0323,277,200,477,18,495,866,57.16%,31.99%,1
高雄市,岡山區,0324,247,289,536,39,575,978,58.79%,25.26%,1
高雄市,岡山區,0325,186,595,781,37,818,1336,61.23%,13.92%,1
高雄市,岡山區,0326,150,613,763,9,772,1218,63.38%,12.32%,1
高雄市,岡山區,0327,114,143,257,4,261,341,76.54%,33.43%,1
高雄市,岡山區,0328,127,552,679,36,715,955,74.87%,13.3%,1
高雄市,岡山區,0329,119,520,639,15,654,940,69.57%,12.66%,1
高雄市,岡山區,0330,232,316,548,28,576,851,67.69%,27.26%,1
高雄市,岡山區,0331,182,342,524,11,535,762,70.21%,23.88%,1
高雄市,岡山區,0332,115,121,236,6,242,318,76.1%,36.16%,1
高雄市,橋頭區,0404,361,295,656,27,683,1005,67.96%,35.92%,1
高雄市,橋頭區,0405,356,315,671,28,699,1073,65.14%,33.18%,1
高雄市,橋頭區,0406,414,323,737,21,758,1129,67.14%,36.67%,1
高雄市,橋頭區,0407,424,332,756,47,803,1244,64.55%,34.08%,1
高雄市,橋頭區,0408,373,287,660,19,679,1091,62.24%,34.19%,1
高雄市,橋頭區,0409,458,415,873,25,898,1329,67.57%,34.46%,1
高雄市,橋頭區,0410,379,315,694,30,724,1140,63.51%,33.25%,1
高雄市,橋頭區,0411,497,240,737,31,768,1220,62.95%,40.74%,1
高雄市,橋頭區,0412,378,316,694,20,714,1047,68.19%,36.1%,1
高雄市,橋頭區,0413,432,317,749,51,800,1315,60.84%,32.85%,1
高雄市,橋頭區,0414,253,155,408,23,431,691,62.37%,36.61%,1
高雄市,橋頭區,0415,314,151,465,24,489,720,67.92%,43.61%,1
高雄市,橋頭區,0416,357,350,707,39,746,1192,62.58%,29.95%,1
高雄市,橋頭區,0417,423,409,832,25,857,1318,65.02%,32.09%,1
高雄市,橋頭區,0418,206,255,461,32,493,761,64.78%,27.07%,1
高雄市,橋頭區,0419,317,262,579,25,604,973,62.08%,32.58%,1
高雄市,橋頭區,0420,183,167,350,15,365,587,62.18%,31.18%,1
高雄市,橋頭區,0421,275,233,508,30,538,812,66.26%,33.87%,1
高雄市,橋頭區,0422,114,106,220,10,230,343,67.06%,33.24%,1
高雄市,橋頭區,0423,343,462,805,27,832,1266,65.72%,27.09%,1
高雄市,橋頭區,0424,370,321,691,57,748,1128,66.31%,32.8%,1
高雄市,橋頭區,0425,243,283,526,46,572,884,64.71%,27.49%,1
高雄市,橋頭區,0426,307,349,656,43,699,1187,58.89%,25.86%,1
高雄市,橋頭區,0427,390,351,741,41,782,1259,62.11%,30.98%,1
高雄市,橋頭區,0428,376,354,730,32,762,1361,55.99%,27.63%,1
高雄市,橋頭區,0429,232,130,362,21,383,671,57.08%,34.58%,1
高雄市,橋頭區,0430,501,257,758,30,788,1215,64.86%,41.23%,1
高雄市,橋頭區,0431,451,327,778,39,817,1255,65.1%,35.94%,1
高雄市,橋頭區,0432,396,362,758,32,790,1219,64.81%,32.49%,1
高雄市,橋頭區,0433,494,329,823,24,847,1372,61.73%,36.01%,1
高雄市,橋頭區,0434,326,161,487,8,495,758,65.3%,43.01%,1
高雄市,燕巢區,0333,307,302,609,55,664,1152,57.64%,26.65%,1
高雄市,燕巢區,0334,394,272,666,20,686,1120,61.25%,35.18%,1
高雄市,燕巢區,0335,322,290,612,36,648,974,66.53%,33.06%,1
高雄市,燕巢區,0336,298,275,573,19,592,1019,58.1%,29.24%,1
高雄市,燕巢區,0337,275,294,569,42,611,1058,57.75%,25.99%,1
高雄市,燕巢區,0338,300,205,505,22,527,1017,51.82%,29.5%,1
高雄市,燕巢區,0339,13,28,41,1,42,259,16.22%,5.02%,1
高雄市,燕巢區,0340,262,318,580,39,619,926,66.85%,28.29%,1
高雄市,燕巢區,0341,189,141,330,21,351,624,56.25%,30.29%,1
高雄市,燕巢區,0342,324,377,701,24,725,1102,65.79%,29.4%,1
高雄市,燕巢區,0343,307,262,569,22,591,1072,55.13%,28.64%,1
高雄市,燕巢區,0344,389,376,765,47,812,1361,59.66%,28.58%,1
高雄市,燕巢區,0345,118,152,270,21,291,472,61.65%,25%,1
高雄市,燕巢區,0346,300,318,618,37,655,1197,54.72%,25.06%,1
高雄市,燕巢區,0347,334,343,677,61,738,1134,65.08%,29.45%,1
高雄市,燕巢區,0348,410,237,647,12,659,1148,57.4%,35.71%,1
高雄市,燕巢區,0349,267,347,614,48,662,1207,54.85%,22.12%,1
高雄市,燕巢區,0350,365,497,862,46,908,1402,64.76%,26.03%,1
高雄市,燕巢區,0351,299,277,576,41,617,1000,61.7%,29.9%,1
高雄市,燕巢區,0352,301,351,652,44,696,1110,62.7%,27.12%,1
高雄市,燕巢區,0353,326,384,710,41,751,1291,58.17%,25.25%,1
高雄市,燕巢區,0354,278,190,468,29,497,797,62.36%,34.88%,1
高雄市,燕巢區,0355,268,277,545,30,575,1098,52.37%,24.41%,1
高雄市,燕巢區,0356,341,375,716,39,755,1393,54.2%,24.48%,1
高雄市,燕巢區,0357,226,276,502,19,521,1079,48.29%,20.95%,1
高雄市,田寮區,0237,79,86,165,7,172,369,46.61%,21.41%,1
高雄市,田寮區,0238,159,121,280,20,300,656,45.73%,24.24%,1
高雄市,田寮區,0239,99,49,148,6,154,406,37.93%,24.38%,1
高雄市,田寮區,0240,112,72,184,15,199,380,52.37%,29.47%,1
高雄市,田寮區,0241,116,93,209,7,216,379,56.99%,30.61%,1
高雄市,田寮區,0242,219,115,334,30,364,625,58.24%,35.04%,1
高雄市,田寮區,0243,250,229,479,21,500,946,52.85%,26.43%,1
高雄市,田寮區,0244,187,177,364,33,397,794,50%,23.55%,1
高雄市,田寮區,0245,82,73,155,15,170,382,44.5%,21.47%,1
高雄市,田寮區,0246,119,65,184,21,205,513,39.96%,23.2%,1
高雄市,田寮區,0247,211,119,330,10,340,601,56.57%,35.11%,1
高雄市,田寮區,0248,205,145,350,29,379,620,61.13%,33.06%,1
高雄市,阿蓮區,0216,370,274,644,24,668,1299,51.42%,28.48%,1
高雄市,阿蓮區,0217,349,271,620,31,651,1107,58.81%,31.53%,1
高雄市,阿蓮區,0218,293,186,479,17,496,898,55.23%,32.63%,1
高雄市,阿蓮區,0219,364,293,657,49,706,1259,56.08%,28.91%,1
高雄市,阿蓮區,0220,283,518,801,32,833,1579,52.75%,17.92%,1
高雄市,阿蓮區,0221,167,167,334,6,340,564,60.28%,29.61%,1
高雄市,阿蓮區,0222,226,232,458,41,499,768,64.97%,29.43%,1
高雄市,阿蓮區,0223,349,267,616,37,653,1092,59.8%,31.96%,1
高雄市,阿蓮區,0224,310,290,600,36,636,1099,57.87%,28.21%,1
高雄市,阿蓮區,0225,286,356,642,23,665,1134,58.64%,25.22%,1
高雄市,阿蓮區,0226,413,394,807,24,831,1561,53.24%,26.46%,1
高雄市,阿蓮區,0227,446,378,824,83,907,1533,59.17%,29.09%,1
高雄市,阿蓮區,0228,182,380,562,22,584,1116,52.33%,16.31%,1
高雄市,阿蓮區,0229,325,259,584,22,606,1054,57.5%,30.83%,1
高雄市,阿蓮區,0230,371,294,665,28,693,1260,55%,29.44%,1
高雄市,阿蓮區,0231,359,392,751,56,807,1504,53.66%,23.87%,1
高雄市,阿蓮區,0232,247,183,430,15,445,848,52.48%,29.13%,1
高雄市,阿蓮區,0233,194,234,428,22,450,823,54.68%,23.57%,1
高雄市,阿蓮區,0234,340,254,594,11,605,1021,59.26%,33.3%,1
高雄市,阿蓮區,0235,429,456,885,48,933,1715,54.4%,25.01%,1
高雄市,阿蓮區,0236,332,341,673,31,704,1300,54.15%,25.54%,1
高雄市,路竹區,0175,290,259,549,27,576,1026,56.14%,28.27%,1
高雄市,路竹區,0176,324,271,595,43,638,1069,59.68%,30.31%,1
高雄市,路竹區,0177,316,327,643,53,696,1127,61.76%,28.04%,1
高雄市,路竹區,0178,300,328,628,49,677,1179,57.42%,25.45%,1
高雄市,路竹區,0179,349,299,648,54,702,1237,56.75%,28.21%,1
高雄市,路竹區,0180,309,314,623,38,661,1096,60.31%,28.19%,1
高雄市,路竹區,0181,399,369,768,39,807,1272,63.44%,31.37%,1
高雄市,路竹區,0182,308,356,664,37,701,1182,59.31%,26.06%,1
高雄市,路竹區,0183,304,320,624,37,661,1127,58.65%,26.97%,1
高雄市,路竹區,0184,261,285,546,33,579,956,60.56%,27.3%,1
高雄市,路竹區,0185,297,335,632,43,675,1132,59.63%,26.24%,1
高雄市,路竹區,0186,275,307,582,78,660,1025,64.39%,26.83%,1
高雄市,路竹區,0187,255,300,555,20,575,1007,57.1%,25.32%,1
高雄市,路竹區,0188,335,345,680,53,733,1301,56.34%,25.75%,1
高雄市,路竹區,0189,244,257,501,26,527,885,59.55%,27.57%,1
高雄市,路竹區,0190,185,217,402,19,421,837,50.3%,22.1%,1
高雄市,路竹區,0191,279,244,523,42,565,930,60.75%,30%,1
高雄市,路竹區,0192,199,190,389,28,417,781,53.39%,25.48%,1
高雄市,路竹區,0193,314,250,564,48,612,1023,59.82%,30.69%,1
高雄市,路竹區,0194,498,519,1017,57,1074,1763,60.92%,28.25%,1
高雄市,路竹區,0195,441,464,905,40,945,1637,57.73%,26.94%,1
高雄市,路竹區,0196,297,309,606,24,630,1070,58.88%,27.76%,1
高雄市,路竹區,0197,331,364,695,32,727,1177,61.77%,28.12%,1
高雄市,路竹區,0198,280,277,557,44,601,1007,59.68%,27.81%,1
高雄市,路竹區,0199,301,250,551,50,601,1026,58.58%,29.34%,1
高雄市,路竹區,0200,283,295,578,30,608,1017,59.78%,27.83%,1
高雄市,路竹區,0201,356,358,714,32,746,1264,59.02%,28.16%,1
高雄市,路竹區,0202,316,336,652,34,686,1089,62.99%,29.02%,1
高雄市,路竹區,0203,264,225,489,25,514,851,60.4%,31.02%,1
高雄市,路竹區,0204,323,304,627,21,648,1011,64.09%,31.95%,1
高雄市,路竹區,0205,298,293,591,29,620,937,66.17%,31.8%,1
高雄市,路竹區,0206,211,202,413,11,424,820,51.71%,25.73%,1
高雄市,路竹區,0207,283,277,560,18,578,910,63.52%,31.1%,1
高雄市,路竹區,0208,246,212,458,38,496,867,57.21%,28.37%,1
高雄市,路竹區,0209,280,254,534,33,567,937,60.51%,29.88%,1
高雄市,路竹區,0210,264,257,521,19,540,900,60%,29.33%,1
高雄市,路竹區,0211,268,257,525,40,565,900,62.78%,29.78%,1
高雄市,路竹區,0212,262,277,539,27,566,918,61.66%,28.54%,1
高雄市,路竹區,0213,252,285,537,32,569,870,65.4%,28.97%,1
高雄市,路竹區,0214,333,370,703,22,725,1150,63.04%,28.96%,1
高雄市,路竹區,0215,402,543,945,40,985,1537,64.09%,26.15%,1
高雄市,湖內區,0151,346,240,586,27,613,1112,55.13%,31.12%,1
高雄市,湖內區,0152,293,265,558,38,596,1017,58.6%,28.81%,1
高雄市,湖內區,0153,245,185,430,27,457,796,57.41%,30.78%,1
高雄市,湖內區,0154,345,306,651,18,669,1079,62%,31.97%,1
高雄市,湖內區,0155,320,321,641,29,670,1115,60.09%,28.7%,1
高雄市,湖內區,0156,380,330,710,23,733,1311,55.91%,28.99%,1
高雄市,湖內區,0157,363,321,684,24,708,1319,53.68%,27.52%,1
高雄市,湖內區,0158,378,375,753,44,797,1244,64.07%,30.39%,1
高雄市,湖內區,0159,346,402,748,40,788,1227,64.22%,28.2%,1
高雄市,湖內區,0160,314,365,679,38,717,1163,61.65%,27%,1
高雄市,湖內區,0161,282,295,577,24,601,981,61.26%,28.75%,1
高雄市,湖內區,0162,234,184,418,22,440,780,56.41%,30%,1
高雄市,湖內區,0163,224,234,458,30,488,832,58.65%,26.92%,1
高雄市,湖內區,0164,316,298,614,26,640,1017,62.93%,31.07%,1
高雄市,湖內區,0165,315,300,615,11,626,1051,59.56%,29.97%,1
高雄市,湖內區,0166,320,216,536,21,557,941,59.19%,34.01%,1
高雄市,湖內區,0167,247,214,461,38,499,863,57.82%,28.62%,1
高雄市,湖內區,0168,331,274,605,30,635,1160,54.74%,28.53%,1
高雄市,湖內區,0169,257,223,480,12,492,1090,45.14%,23.58%,1
高雄市,湖內區,0170,344,273,617,42,659,1122,58.73%,30.66%,1
高雄市,湖內區,0171,330,230,560,26,586,1123,52.18%,29.39%,1
高雄市,湖內區,0172,195,191,386,22,408,684,59.65%,28.51%,1
高雄市,湖內區,0173,278,335,613,24,637,1249,51%,22.26%,1
高雄市,湖內區,0174,330,364,694,31,725,1453,49.9%,22.71%,1
高雄市,茄萣區,0130,287,216,503,13,516,976,52.87%,29.41%,1
高雄市,茄萣區,0131,263,188,451,37,488,887,55.02%,29.65%,1
高雄市,茄萣區,0132,445,455,900,23,923,1710,53.98%,26.02%,1
高雄市,茄萣區,0133,313,274,587,27,614,1280,47.97%,24.45%,1
高雄市,茄萣區,0134,393,373,766,20,786,1314,59.82%,29.91%,1
高雄市,茄萣區,0135,378,350,728,20,748,1157,64.65%,32.67%,1
高雄市,茄萣區,0136,470,464,934,65,999,1785,55.97%,26.33%,1
高雄市,茄萣區,0137,240,204,444,48,492,838,58.71%,28.64%,1
高雄市,茄萣區,0138,404,372,776,45,821,1249,65.73%,32.35%,1
高雄市,茄萣區,0139,317,256,573,49,622,1116,55.73%,28.41%,1
高雄市,茄萣區,0140,244,243,487,33,520,978,53.17%,24.95%,1
高雄市,茄萣區,0141,289,249,538,22,560,1125,49.78%,25.69%,1
高雄市,茄萣區,0142,350,244,594,39,633,1139,55.58%,30.73%,1
高雄市,茄萣區,0143,398,322,720,58,778,1363,57.08%,29.2%,1
高雄市,茄萣區,0144,499,397,896,58,954,1598,59.7%,31.23%,1
高雄市,茄萣區,0145,275,302,577,28,605,1111,54.46%,24.75%,1
高雄市,茄萣區,0146,224,192,416,28,444,925,48%,24.22%,1
高雄市,茄萣區,0147,354,258,612,30,642,1148,55.92%,30.84%,1
高雄市,茄萣區,0148,335,337,672,29,701,1353,51.81%,24.76%,1
高雄市,茄萣區,0149,354,335,689,48,737,1331,55.37%,26.6%,1
高雄市,茄萣區,0150,434,427,861,55,916,1829,50.08%,23.73%,1
高雄市,永安區,0249,237,256,493,18,511,756,67.59%,31.35%,1
高雄市,永安區,0250,249,241,490,33,523,818,63.94%,30.44%,1
高雄市,永安區,0251,274,305,579,22,601,866,69.4%,31.64%,1
高雄市,永安區,0252,283,306,589,33,622,951,65.4%,29.76%,1
高雄市,永安區,0253,304,305,609,32,641,992,64.62%,30.65%,1
高雄市,永安區,0254,197,149,346,14,360,682,52.79%,28.89%,1
高雄市,永安區,0255,192,205,397,20,417,665,62.71%,28.87%,1
高雄市,永安區,0256,120,82,202,9,211,371,56.87%,32.35%,1
高雄市,永安區,0257,328,362,690,47,737,1114,66.16%,29.44%,1
高雄市,永安區,0258,376,483,859,29,888,1418,62.62%,26.52%,1
高雄市,永安區,0259,448,467,915,63,978,1477,66.22%,30.33%,1
高雄市,永安區,0260,566,583,1149,46,1195,1891,63.19%,29.93%,1
高雄市,彌陀區,0358,327,386,713,48,761,1246,61.08%,26.24%,1
高雄市,彌陀區,0359,230,292,522,30,552,885,62.37%,25.99%,1
高雄市,彌陀區,0360,276,324,600,51,651,955,68.17%,28.9%,1
高雄市,彌陀區,0361,153,142,295,30,325,534,60.86%,28.65%,1
高雄市,彌陀區,0362,189,249,438,22,460,738,62.33%,25.61%,1
高雄市,彌陀區,0363,251,311,562,28,590,855,69.01%,29.36%,1
高雄市,彌陀區,0364,291,260,551,30,581,877,66.25%,33.18%,1
高雄市,彌陀區,0365,253,208,461,33,494,781,63.25%,32.39%,1
高雄市,彌陀區,0366,265,236,501,14,515,808,63.74%,32.8%,1
高雄市,彌陀區,0367,234,221,455,26,481,904,53.21%,25.88%,1
高雄市,彌陀區,0368,243,230,473,37,510,825,61.82%,29.45%,1
高雄市,彌陀區,0369,270,243,513,27,540,941,57.39%,28.69%,1
高雄市,彌陀區,0370,300,280,580,27,607,1013,59.92%,29.62%,1
高雄市,彌陀區,0371,329,291,620,55,675,1024,65.92%,32.13%,1
高雄市,彌陀區,0372,194,249,443,13,456,861,52.96%,22.53%,1
高雄市,彌陀區,0373,354,332,686,49,735,1163,63.2%,30.44%,1
高雄市,彌陀區,0374,327,410,737,64,801,1216,65.87%,26.89%,1
高雄市,彌陀區,0375,321,265,586,43,629,861,73.05%,37.28%,1
高雄市,梓官區,0376,354,289,643,39,682,1061,64.28%,33.36%,1
高雄市,梓官區,0377,322,287,609,31,640,1063,60.21%,30.29%,1
高雄市,梓官區,0378,438,151,589,25,614,969,63.36%,45.2%,1
高雄市,梓官區,0379,320,243,563,18,581,1078,53.9%,29.68%,1
高雄市,梓官區,0380,292,214,506,28,534,838,63.72%,34.84%,1
高雄市,梓官區,0381,216,181,397,19,416,611,68.09%,35.35%,1
高雄市,梓官區,0382,262,221,483,18,501,782,64.07%,33.5%,1
高雄市,梓官區,0383,488,425,913,43,956,1451,65.89%,33.63%,1
高雄市,梓官區,0384,331,315,646,17,663,1144,57.95%,28.93%,1
高雄市,梓官區,0385,263,253,516,19,535,975,54.87%,26.97%,1
高雄市,梓官區,0386,421,345,766,34,800,1317,60.74%,31.97%,1
高雄市,梓官區,0387,317,400,717,50,767,1218,62.97%,26.03%,1
高雄市,梓官區,0388,313,312,625,29,654,1073,60.95%,29.17%,1
高雄市,梓官區,0389,302,291,593,18,611,1112,54.95%,27.16%,1
高雄市,梓官區,0390,222,173,395,21,416,715,58.18%,31.05%,1
高雄市,梓官區,0391,374,312,686,45,731,1311,55.76%,28.53%,1
高雄市,梓官區,0392,306,229,535,28,563,939,59.96%,32.59%,1
高雄市,梓官區,0393,222,269,491,27,518,824,62.86%,26.94%,1
高雄市,梓官區,0394,380,272,652,55,707,1052,67.21%,36.12%,1
高雄市,梓官區,0395,298,303,601,53,654,1020,64.12%,29.22%,1
高雄市,梓官區,0396,372,336,708,22,730,1260,57.94%,29.52%,1
高雄市,梓官區,0397,399,454,853,30,883,1595,55.36%,25.02%,1
高雄市,梓官區,0398,239,230,469,30,499,829,60.19%,28.83%,1
高雄市,梓官區,0399,370,464,834,19,853,1532,55.68%,24.15%,1
高雄市,梓官區,0400,355,387,742,38,780,1195,65.27%,29.71%,1
高雄市,梓官區,0401,317,358,675,42,717,1143,62.73%,27.73%,1
高雄市,梓官區,0402,386,325,711,38,749,1186,63.15%,32.55%,1
高雄市,梓官區,0403,364,475,839,38,877,1732,50.64%,21.02%,1
高雄市,旗山區,0060,291,319,610,29,639,1060,60.28%,27.45%,1
高雄市,旗山區,0061,257,303,560,35,595,1125,52.89%,22.84%,1
高雄市,旗山區,0062,297,350,647,34,681,1100,61.91%,27%,1
高雄市,旗山區,0063,354,393,747,17,764,1238,61.71%,28.59%,1
高雄市,旗山區,0064,254,293,547,19,566,933,60.66%,27.22%,1
高雄市,旗山區,0065,199,194,393,8,401,727,55.16%,27.37%,1
高雄市,旗山區,0066,325,266,591,19,610,1071,56.96%,30.35%,1
高雄市,旗山區,0067,189,185,374,23,397,744,53.36%,25.4%,1
高雄市,旗山區,0068,280,275,555,19,574,1100,52.18%,25.45%,1
高雄市,旗山區,0069,72,113,185,9,194,369,52.57%,19.51%,1
高雄市,旗山區,0070,218,181,399,20,419,888,47.18%,24.55%,1
高雄市,旗山區,0071,120,107,227,13,240,510,47.06%,23.53%,1
高雄市,旗山區,0072,317,294,611,43,654,1042,62.76%,30.42%,1
高雄市,旗山區,0073,215,213,428,21,449,791,56.76%,27.18%,1
高雄市,旗山區,0074,290,240,530,51,581,939,61.87%,30.88%,1
高雄市,旗山區,0075,320,298,618,41,659,1218,54.11%,26.27%,1
高雄市,旗山區,0076,54,37,91,13,104,178,58.43%,30.34%,1
高雄市,旗山區,0077,255,314,569,28,597,946,63.11%,26.96%,1
高雄市,旗山區,0078,318,246,564,29,593,1025,57.85%,31.02%,1
高雄市,旗山區,0079,279,329,608,28,636,1040,61.15%,26.83%,1
高雄市,旗山區,0080,275,288,563,25,588,900,65.33%,30.56%,1
高雄市,旗山區,0081,162,190,352,18,370,663,55.81%,24.43%,1
高雄市,旗山區,0082,243,264,507,38,545,954,57.13%,25.47%,1
高雄市,旗山區,0083,323,259,582,23,605,1060,57.08%,30.47%,1
高雄市,旗山區,0084,335,316,651,31,682,1110,61.44%,30.18%,1
高雄市,旗山區,0085,310,282,592,43,635,1062,59.79%,29.19%,1
高雄市,旗山區,0086,344,320,664,20,684,1151,59.43%,29.89%,1
高雄市,旗山區,0087,83,65,148,18,166,266,62.41%,31.2%,1
高雄市,旗山區,0088,172,201,373,20,393,633,62.09%,27.17%,1
高雄市,旗山區,0089,346,314,660,33,693,1307,53.02%,26.47%,1
高雄市,旗山區,0090,268,145,413,18,431,754,57.16%,35.54%,1
高雄市,旗山區,0091,515,200,715,62,777,1296,59.95%,39.74%,1
高雄市,旗山區,0092,228,175,403,13,416,839,49.58%,27.18%,1
高雄市,旗山區,0093,404,349,753,39,792,1329,59.59%,30.4%,1
高雄市,旗山區,0094,150,200,350,22,372,628,59.24%,23.89%,1
高雄市,美濃區,0095,290,347,637,57,694,1175,59.06%,24.68%,1
高雄市,美濃區,0096,320,394,714,26,740,1438,51.46%,22.25%,1
高雄市,美濃區,0097,203,292,495,22,517,989,52.28%,20.53%,1
高雄市,美濃區,0098,307,471,778,44,822,1427,57.6%,21.51%,1
高雄市,美濃區,0099,332,384,716,28,744,1309,56.84%,25.36%,1
高雄市,美濃區,0100,293,427,720,53,773,1263,61.2%,23.2%,1
高雄市,美濃區,0101,239,344,583,29,612,997,61.38%,23.97%,1
高雄市,美濃區,0102,236,350,586,32,618,1064,58.08%,22.18%,1
高雄市,美濃區,0103,287,505,792,51,843,1498,56.28%,19.16%,1
高雄市,美濃區,0104,244,354,598,63,661,1119,59.07%,21.81%,1
高雄市,美濃區,0105,215,340,555,51,606,1031,58.78%,20.85%,1
高雄市,美濃區,0106,298,418,716,63,779,1437,54.21%,20.74%,1
高雄市,美濃區,0107,260,319,579,29,608,1071,56.77%,24.28%,1
高雄市,美濃區,0108,157,220,377,16,393,687,57.21%,22.85%,1
高雄市,美濃區,0109,154,195,349,21,370,775,47.74%,19.87%,1
高雄市,美濃區,0110,307,342,649,54,703,1353,51.96%,22.69%,1
高雄市,美濃區,0111,307,284,591,30,621,1191,52.14%,25.78%,1
高雄市,美濃區,0112,215,232,447,29,476,906,52.54%,23.73%,1
高雄市,美濃區,0113,257,397,654,42,696,1178,59.08%,21.82%,1
高雄市,美濃區,0114,265,358,623,20,643,1252,51.36%,21.17%,1
高雄市,美濃區,0115,302,536,838,52,890,1549,57.46%,19.5%,1
高雄市,美濃區,0116,242,297,539,35,574,1088,52.76%,22.24%,1
高雄市,美濃區,0117,254,352,606,32,638,1116,57.17%,22.76%,1
高雄市,美濃區,0118,221,280,501,25,526,977,53.84%,22.62%,1
高雄市,美濃區,0119,222,254,476,41,517,816,63.36%,27.21%,1
高雄市,美濃區,0120,197,275,472,19,491,955,51.41%,20.63%,1
高雄市,美濃區,0121,229,283,512,42,554,943,58.75%,24.28%,1
高雄市,美濃區,0122,300,429,729,32,761,1371,55.51%,21.88%,1
高雄市,美濃區,0123,241,252,493,29,522,919,56.8%,26.22%,1
高雄市,美濃區,0124,240,304,544,20,564,915,61.64%,26.23%,1
高雄市,美濃區,0125,200,219,419,50,469,828,56.64%,24.15%,1
高雄市,美濃區,0126,149,142,291,34,325,674,48.22%,22.11%,1
高雄市,六龜區,0020,205,169,374,18,392,760,51.58%,26.97%,1
高雄市,六龜區,0021,134,145,279,29,308,666,46.25%,20.12%,1
高雄市,六龜區,0022,172,209,381,31,412,704,58.52%,24.43%,1
高雄市,六龜區,0023,228,249,477,37,514,1003,51.25%,22.73%,1
高雄市,六龜區,0024,251,327,578,90,668,1382,48.34%,18.16%,1
高雄市,六龜區,0025,168,188,356,63,419,986,42.49%,17.04%,1
高雄市,六龜區,0026,236,274,510,36,546,1046,52.2%,22.56%,1
高雄市,六龜區,0027,198,152,350,34,384,812,47.29%,24.38%,1
高雄市,六龜區,0028,229,396,625,38,663,1431,46.33%,16%,1
高雄市,六龜區,0029,188,260,448,40,488,912,53.51%,20.61%,1
高雄市,六龜區,0030,242,314,556,35,591,1472,40.15%,16.44%,1
高雄市,六龜區,0031,63,69,132,14,146,327,44.65%,19.27%,1
高雄市,甲仙區,0013,64,114,178,4,182,472,38.56%,13.56%,1
高雄市,甲仙區,0014,178,338,516,42,558,882,63.27%,20.18%,1
高雄市,甲仙區,0015,150,195,345,24,369,668,55.24%,22.46%,1
高雄市,甲仙區,0016,308,408,716,84,800,1581,50.6%,19.48%,1
高雄市,甲仙區,0017,150,79,229,7,236,673,35.07%,22.29%,1
高雄市,甲仙區,0018,126,145,271,27,298,607,49.09%,20.76%,1
高雄市,甲仙區,0019,157,111,268,14,282,534,52.81%,29.4%,1
高雄市,杉林區,0032,164,144,308,21,329,640,51.41%,25.63%,1
高雄市,杉林區,0033,145,167,312,21,333,696,47.84%,20.83%,1
高雄市,杉林區,0034,290,208,498,35,533,1284,41.51%,22.59%,1
高雄市,杉林區,0035,184,245,429,31,460,1027,44.79%,17.92%,1
高雄市,杉林區,0036,107,117,224,23,247,482,51.24%,22.2%,1
高雄市,杉林區,0037,390,452,842,69,911,1627,55.99%,23.97%,1
高雄市,杉林區,0038,328,406,734,23,757,1630,46.44%,20.12%,1
高雄市,杉林區,0039,226,176,402,15,417,973,42.86%,23.23%,1
高雄市,杉林區,0040,147,252,399,17,416,987,42.15%,14.89%,1
高雄市,杉林區,0041,313,321,634,41,675,1261,53.53%,24.82%,1
高雄市,內門區,0042,207,213,420,44,464,969,47.88%,21.36%,1
高雄市,內門區,0043,175,117,292,11,303,652,46.47%,26.84%,1
高雄市,內門區,0044,244,231,475,39,514,961,53.49%,25.39%,1
高雄市,內門區,0045,89,115,204,8,212,426,49.77%,20.89%,1
高雄市,內門區,0046,72,96,168,16,184,398,46.23%,18.09%,1
高雄市,內門區,0047,97,128,225,16,241,508,47.44%,19.09%,1
高雄市,內門區,0048,235,308,543,34,577,980,58.88%,23.98%,1
高雄市,內門區,0049,249,255,504,39,543,1225,44.33%,20.33%,1
高雄市,內門區,0050,470,414,884,80,964,1722,55.98%,27.29%,1
高雄市,內門區,0051,128,132,260,16,276,560,49.29%,22.86%,1
高雄市,內門區,0052,205,156,361,21,382,801,47.69%,25.59%,1
高雄市,內門區,0053,104,101,205,18,223,423,52.72%,24.59%,1
高雄市,內門區,0054,113,107,220,18,238,497,47.89%,22.74%,1
高雄市,內門區,0055,162,151,313,22,335,677,49.48%,23.93%,1
高雄市,內門區,0056,127,93,220,12,232,593,39.12%,21.42%,1
高雄市,內門區,0057,184,75,259,30,289,597,48.41%,30.82%,1
高雄市,內門區,0058,81,79,160,3,163,343,47.52%,23.62%,1
高雄市,內門區,0059,162,185,347,30,377,670,56.27%,24.18%,1
高雄市,茂林區,0127,102,241,343,13,356,507,70.22%,20.12%,1
高雄市,茂林區,0128,97,162,259,13,272,382,71.2%,25.39%,1
高雄市,茂林區,0129,138,335,473,21,494,726,68.04%,19.01%,1
高雄市,桃源區,0001,40,70,110,0,110,264,41.67%,15.15%,1
高雄市,桃源區,0002,52,109,161,11,172,233,73.82%,22.32%,1
高雄市,桃源區,0003,47,137,184,9,193,279,69.18%,16.85%,1
高雄市,桃源區,0004,30,82,112,5,117,223,52.47%,13.45%,1
高雄市,桃源區,0005,88,285,373,14,387,783,49.43%,11.24%,1
高雄市,桃源區,0006,90,174,264,7,271,632,42.88%,14.24%,1
高雄市,桃源區,0007,133,257,390,26,416,612,67.97%,21.73%,1
高雄市,桃源區,0008,68,175,243,17,260,472,55.08%,14.41%,1
高雄市,那瑪夏區,0009,120,225,345,15,360,741,48.58%,16.19%,1
高雄市,那瑪夏區,0010,121,258,379,43,422,585,72.14%,20.68%,1
高雄市,那瑪夏區,0011,109,322,431,39,470,609,77.18%,17.9%,1
高雄市,那瑪夏區,0012,145,127,272,11,283,489,57.87%,29.65%,1
新竹縣,竹北市,0001,321,518,839,19,858,1319,65.05%,24.34%,1
新竹縣,竹北市,0002,328,464,792,17,809,1321,61.24%,24.83%,1
新竹縣,竹北市,0003,268,503,771,29,800,1272,62.89%,21.07%,1
新竹縣,竹北市,0004,288,536,824,24,848,1467,57.81%,19.63%,1
新竹縣,竹北市,0005,290,404,694,21,715,1226,58.32%,23.65%,1
新竹縣,竹北市,0006,311,478,789,18,807,1412,57.15%,22.03%,1
新竹縣,竹北市,0007,335,540,875,11,886,1400,63.29%,23.93%,1
新竹縣,竹北市,0008,338,522,860,21,881,1415,62.26%,23.89%,1
新竹縣,竹北市,0009,309,481,790,16,806,1361,59.22%,22.7%,1
新竹縣,竹北市,0010,337,478,815,18,833,1515,54.98%,22.24%,1
新竹縣,竹北市,0011,370,500,870,27,897,1495,60%,24.75%,1
新竹縣,竹北市,0012,348,469,817,26,843,1417,59.49%,24.56%,1
新竹縣,竹北市,0013,386,484,870,19,889,1548,57.43%,24.94%,1
新竹縣,竹北市,0014,352,420,772,18,790,1434,55.09%,24.55%,1
新竹縣,竹北市,0015,279,506,785,30,815,1385,58.84%,20.14%,1
新竹縣,竹北市,0016,293,477,770,28,798,1247,63.99%,23.5%,1
新竹縣,竹北市,0017,341,437,778,21,799,1373,58.19%,24.84%,1
新竹縣,竹北市,0018,382,453,835,24,859,1345,63.87%,28.4%,1
新竹縣,竹北市,0019,232,414,646,28,674,1165,57.85%,19.91%,1
新竹縣,竹北市,0020,298,418,716,38,754,1164,64.78%,25.6%,1
新竹縣,竹北市,0021,307,420,727,30,757,1212,62.46%,25.33%,1
新竹縣,竹北市,0022,225,507,732,27,759,1507,50.36%,14.93%,1
新竹縣,竹北市,0023,242,559,801,37,838,1576,53.17%,15.36%,1
新竹縣,竹北市,0024,353,445,798,27,825,1464,56.35%,24.11%,1
新竹縣,竹北市,0025,344,459,803,17,820,1428,57.42%,24.09%,1
新竹縣,竹北市,0026,316,392,708,18,726,1442,50.35%,21.91%,1
新竹縣,竹北市,0027,474,322,796,47,843,1415,59.58%,33.5%,1
新竹縣,竹北市,0028,359,468,827,21,848,1666,50.9%,21.55%,1
新竹縣,竹北市,0029,394,518,912,31,943,1751,53.85%,22.5%,1
新竹縣,竹北市,0030,271,446,717,20,737,1196,61.62%,22.66%,1
新竹縣,竹北市,0031,252,471,723,21,744,1235,60.24%,20.4%,1
新竹縣,竹北市,0032,260,418,678,11,689,1204,57.23%,21.59%,1
新竹縣,竹北市,0033,308,470,778,25,803,1308,61.39%,23.55%,1
新竹縣,竹北市,0034,284,145,429,12,441,1233,35.77%,23.03%,1
新竹縣,竹北市,0035,231,428,659,17,676,1129,59.88%,20.46%,1
新竹縣,竹北市,0036,226,423,649,12,661,1069,61.83%,21.14%,1
新竹縣,竹北市,0037,260,414,674,37,711,1114,63.82%,23.34%,1
新竹縣,竹北市,0038,220,453,673,22,695,1103,63.01%,19.95%,1
新竹縣,竹北市,0039,231,417,648,22,670,1029,65.11%,22.45%,1
新竹縣,竹北市,0040,281,423,704,22,726,1133,64.08%,24.8%,1
新竹縣,竹北市,0041,293,443,736,21,757,1301,58.19%,22.52%,1
新竹縣,竹北市,0042,453,578,1031,25,1056,1798,58.73%,25.19%,1
新竹縣,竹北市,0043,569,253,822,31,853,1427,59.78%,39.87%,1
新竹縣,竹北市,0044,313,575,888,27,915,1462,62.59%,21.41%,1
新竹縣,竹北市,0045,310,521,831,30,861,1342,64.16%,23.1%,1
新竹縣,竹北市,0046,323,552,875,29,904,1480,61.08%,21.82%,1
新竹縣,竹北市,0047,345,566,911,18,929,1645,56.47%,20.97%,1
新竹縣,竹北市,0048,277,499,776,32,808,1256,64.33%,22.05%,1
新竹縣,竹北市,0049,267,432,699,27,726,1181,61.47%,22.61%,1
新竹縣,竹北市,0050,298,546,844,21,865,1329,65.09%,22.42%,1
新竹縣,竹北市,0051,248,528,776,22,798,1228,64.98%,20.2%,1
新竹縣,竹北市,0052,338,501,839,37,876,1552,56.44%,21.78%,1
新竹縣,竹北市,0053,347,527,874,20,894,1480,60.41%,23.45%,1
新竹縣,竹北市,0054,319,490,809,15,824,1487,55.41%,21.45%,1
新竹縣,竹北市,0055,321,460,781,32,813,1470,55.31%,21.84%,1
新竹縣,竹北市,0056,240,518,758,30,788,1477,53.35%,16.25%,1
新竹縣,竹北市,0057,342,593,935,48,983,1611,61.02%,21.23%,1
新竹縣,竹北市,0058,313,551,864,46,910,1555,58.52%,20.13%,1
新竹縣,竹北市,0059,265,494,759,38,797,1468,54.29%,18.05%,1
新竹縣,竹北市,0060,282,576,858,40,898,1509,59.51%,18.69%,1
新竹縣,竹北市,0061,322,528,850,41,891,1602,55.62%,20.1%,1
新竹縣,竹北市,0062,258,552,810,55,865,1448,59.74%,17.82%,1
新竹縣,竹北市,0063,251,503,754,48,802,1318,60.85%,19.04%,1
新竹縣,竹北市,0064,367,584,951,51,1002,1634,61.32%,22.46%,1
新竹縣,竹北市,0065,220,493,713,64,777,1345,57.77%,16.36%,1
新竹縣,竹北市,0066,220,395,615,25,640,958,66.81%,22.96%,1
新竹縣,竹北市,0067,241,434,675,29,704,1112,63.31%,21.67%,1
新竹縣,竹北市,0068,242,378,620,50,670,1134,59.08%,21.34%,1
新竹縣,竹北市,0069,285,548,833,30,863,1483,58.19%,19.22%,1
新竹縣,竹北市,0070,244,465,709,39,748,1332,56.16%,18.32%,1
新竹縣,竹北市,0071,297,448,745,24,769,1482,51.89%,20.04%,1
新竹縣,竹北市,0072,220,376,596,23,619,1449,42.72%,15.18%,1
新竹縣,竹北市,0073,242,441,683,34,717,1319,54.36%,18.35%,1
新竹縣,竹北市,0074,234,460,694,32,726,1332,54.5%,17.57%,1
新竹縣,竹北市,0075,284,451,735,23,758,1412,53.68%,20.11%,1
新竹縣,竹北市,0076,294,569,863,31,894,1640,54.51%,17.93%,1
新竹縣,竹北市,0077,264,446,710,46,756,1323,57.14%,19.95%,1
新竹縣,竹北市,0078,325,488,813,38,851,1428,59.59%,22.76%,1
新竹縣,竹北市,0079,282,574,856,46,902,1533,58.84%,18.4%,1
新竹縣,竹北市,0080,262,435,697,24,721,1346,53.57%,19.47%,1
新竹縣,竹北市,0081,257,370,627,42,669,1219,54.88%,21.08%,1
新竹縣,竹北市,0082,337,516,853,45,898,1466,61.26%,22.99%,1
新竹縣,竹北市,0083,262,347,609,26,635,1147,55.36%,22.84%,1
新竹縣,竹北市,0084,266,456,722,38,760,1529,49.71%,17.4%,1
新竹縣,竹北市,0085,319,520,839,42,881,1522,57.88%,20.96%,1
新竹縣,竹北市,0086,306,488,794,39,833,1383,60.23%,22.13%,1
新竹縣,竹北市,0087,350,529,879,34,913,1569,58.19%,22.31%,1
新竹縣,竹北市,0088,283,501,784,20,804,1506,53.39%,18.79%,1
新竹縣,竹北市,0089,211,272,483,24,507,877,57.81%,24.06%,1
新竹縣,竹北市,0090,255,339,594,37,631,1074,58.75%,23.74%,1
新竹縣,竹北市,0091,288,383,671,36,707,1089,64.92%,26.45%,1
新竹縣,竹北市,0092,354,407,761,32,793,1336,59.36%,26.5%,1
新竹縣,竹北市,0093,223,345,568,37,605,1058,57.18%,21.08%,1
新竹縣,竹北市,0094,231,360,591,37,628,937,67.02%,24.65%,1
新竹縣,竹北市,0095,308,358,666,29,695,1206,57.63%,25.54%,1
新竹縣,竹北市,0096,343,331,674,44,718,1205,59.59%,28.46%,1
新竹縣,竹北市,0097,393,574,967,63,1030,1718,59.95%,22.88%,1
新竹縣,竹北市,0098,233,271,504,30,534,917,58.23%,25.41%,1
新竹縣,竹北市,0099,191,197,388,22,410,668,61.38%,28.59%,1
新竹縣,竹北市,0100,228,219,447,24,471,824,57.16%,27.67%,1
新竹縣,竹北市,0101,190,229,419,48,467,782,59.72%,24.3%,1
新竹縣,竹北市,0102,266,293,559,46,605,977,61.92%,27.23%,1
新竹縣,竹北市,0103,233,249,482,13,495,937,52.83%,24.87%,1
新竹縣,竹東鎮,0104,54,89,143,12,155,309,50.16%,17.48%,1
新竹縣,竹東鎮,0105,73,118,191,23,214,416,51.44%,17.55%,1
新竹縣,竹東鎮,0106,70,128,198,6,204,386,52.85%,18.13%,1
新竹縣,竹東鎮,0107,170,288,458,29,487,950,51.26%,17.89%,1
新竹縣,竹東鎮,0108,214,455,669,15,684,1275,53.65%,16.78%,1
新竹縣,竹東鎮,0109,222,404,626,31,657,1213,54.16%,18.3%,1
新竹縣,竹東鎮,0110,243,589,832,34,866,1548,55.94%,15.7%,1
新竹縣,竹東鎮,0111,189,422,611,20,631,1246,50.64%,15.17%,1
新竹縣,竹東鎮,0112,195,346,541,34,575,1252,45.93%,15.58%,1
新竹縣,竹東鎮,0113,208,484,692,28,720,1359,52.98%,15.31%,1
新竹縣,竹東鎮,0114,261,388,649,27,676,1255,53.86%,20.8%,1
新竹縣,竹東鎮,0115,238,484,722,23,745,1304,57.13%,18.25%,1
新竹縣,竹東鎮,0116,240,453,693,35,728,1292,56.35%,18.58%,1
新竹縣,竹東鎮,0117,181,363,544,20,564,1111,50.77%,16.29%,1
新竹縣,竹東鎮,0118,188,298,486,37,523,880,59.43%,21.36%,1
新竹縣,竹東鎮,0119,137,236,373,22,395,670,58.96%,20.45%,1
新竹縣,竹東鎮,0120,235,459,694,33,727,1244,58.44%,18.89%,1
新竹縣,竹東鎮,0121,177,384,561,48,609,1126,54.09%,15.72%,1
新竹縣,竹東鎮,0122,191,372,563,31,594,1073,55.36%,17.8%,1
新竹縣,竹東鎮,0123,209,446,655,40,695,1215,57.2%,17.2%,1
新竹縣,竹東鎮,0124,187,463,650,12,662,1155,57.32%,16.19%,1
新竹縣,竹東鎮,0125,163,291,454,34,488,852,57.28%,19.13%,1
新竹縣,竹東鎮,0126,192,311,503,26,529,875,60.46%,21.94%,1
新竹縣,竹東鎮,0127,216,414,630,24,654,1070,61.12%,20.19%,1
新竹縣,竹東鎮,0128,154,222,376,20,396,704,56.25%,21.88%,1
新竹縣,竹東鎮,0129,108,248,356,26,382,951,40.17%,11.36%,1
新竹縣,竹東鎮,0130,171,364,535,29,564,984,57.32%,17.38%,1
新竹縣,竹東鎮,0131,173,296,469,17,486,1113,43.67%,15.54%,1
新竹縣,竹東鎮,0132,111,226,337,21,358,595,60.17%,18.66%,1
新竹縣,竹東鎮,0133,170,277,447,26,473,762,62.07%,22.31%,1
新竹縣,竹東鎮,0134,155,259,414,18,432,763,56.62%,20.31%,1
新竹縣,竹東鎮,0135,159,250,409,16,425,813,52.28%,19.56%,1
新竹縣,竹東鎮,0136,198,418,616,26,642,1310,49.01%,15.11%,1
新竹縣,竹東鎮,0137,206,465,671,35,706,1434,49.23%,14.37%,1
新竹縣,竹東鎮,0138,223,392,615,28,643,1131,56.85%,19.72%,1
新竹縣,竹東鎮,0139,170,340,510,21,531,967,54.91%,17.58%,1
新竹縣,竹東鎮,0140,187,399,586,28,614,1196,51.34%,15.64%,1
新竹縣,竹東鎮,0141,237,390,627,31,658,1154,57.02%,20.54%,1
新竹縣,竹東鎮,0142,150,260,410,30,440,715,61.54%,20.98%,1
新竹縣,竹東鎮,0143,138,250,388,12,400,685,58.39%,20.15%,1
新竹縣,竹東鎮,0144,206,486,692,29,721,1352,53.33%,15.24%,1
新竹縣,竹東鎮,0145,231,533,764,42,806,1407,57.29%,16.42%,1
新竹縣,竹東鎮,0146,236,479,715,32,747,1362,54.85%,17.33%,1
新竹縣,竹東鎮,0147,225,513,738,29,767,1330,57.67%,16.92%,1
新竹縣,竹東鎮,0148,225,514,739,41,780,1441,54.13%,15.61%,1
新竹縣,竹東鎮,0149,222,409,631,15,646,1248,51.76%,17.79%,1
新竹縣,竹東鎮,0150,229,325,554,21,575,1263,45.53%,18.13%,1
新竹縣,竹東鎮,0151,187,408,595,21,616,1232,50%,15.18%,1
新竹縣,竹東鎮,0152,164,358,522,24,546,1143,47.77%,14.35%,1
新竹縣,竹東鎮,0153,277,532,809,26,835,1529,54.61%,18.12%,1
新竹縣,竹東鎮,0154,183,416,599,30,629,1140,55.18%,16.05%,1
新竹縣,竹東鎮,0155,124,218,342,24,366,570,64.21%,21.75%,1
新竹縣,竹東鎮,0156,222,411,633,25,658,1345,48.92%,16.51%,1
新竹縣,竹東鎮,0157,253,445,698,41,739,1381,53.51%,18.32%,1
新竹縣,竹東鎮,0158,256,465,721,41,762,1379,55.26%,18.56%,1
新竹縣,竹東鎮,0159,198,364,562,45,607,1033,58.76%,19.17%,1
新竹縣,竹東鎮,0160,171,391,562,24,586,1066,54.97%,16.04%,1
新竹縣,竹東鎮,0161,184,323,507,49,556,938,59.28%,19.62%,1
新竹縣,竹東鎮,0162,192,361,553,36,589,952,61.87%,20.17%,1
新竹縣,竹東鎮,0163,270,581,851,32,883,1468,60.15%,18.39%,1
新竹縣,竹東鎮,0164,432,512,944,33,977,1915,51.02%,22.56%,1
新竹縣,竹東鎮,0165,195,416,611,30,641,1220,52.54%,15.98%,1
新竹縣,竹東鎮,0166,187,333,520,15,535,1166,45.88%,16.04%,1
新竹縣,竹東鎮,0167,228,476,704,27,731,1492,48.99%,15.28%,1
新竹縣,竹東鎮,0168,209,435,644,20,664,1245,53.33%,16.79%,1
新竹縣,竹東鎮,0169,230,366,596,28,624,1083,57.62%,21.24%,1
新竹縣,竹東鎮,0170,194,387,581,27,608,1102,55.17%,17.6%,1
新竹縣,竹東鎮,0171,215,372,587,20,607,1068,56.84%,20.13%,1
新竹縣,竹東鎮,0172,202,400,602,25,627,1097,57.16%,18.41%,1
新竹縣,竹東鎮,0173,169,322,491,14,505,962,52.49%,17.57%,1
新竹縣,竹東鎮,0174,188,313,501,22,523,909,57.54%,20.68%,1
新竹縣,竹東鎮,0175,109,173,282,20,302,603,50.08%,18.08%,1
新竹縣,新埔鎮,0176,193,377,570,21,591,983,60.12%,19.63%,1
新竹縣,新埔鎮,0177,146,202,348,23,371,597,62.14%,24.46%,1
新竹縣,新埔鎮,0178,174,406,580,20,600,1070,56.07%,16.26%,1
新竹縣,新埔鎮,0179,167,330,497,32,529,935,56.58%,17.86%,1
新竹縣,新埔鎮,0180,133,283,416,20,436,753,57.9%,17.66%,1
新竹縣,新埔鎮,0181,208,326,534,17,551,838,65.75%,24.82%,1
新竹縣,新埔鎮,0182,155,366,521,21,542,924,58.66%,16.77%,1
新竹縣,新埔鎮,0183,169,270,439,21,460,905,50.83%,18.67%,1
新竹縣,新埔鎮,0184,157,361,518,20,538,948,56.75%,16.56%,1
新竹縣,新埔鎮,0185,207,354,561,34,595,1017,58.51%,20.35%,1
新竹縣,新埔鎮,0186,224,470,694,27,721,1176,61.31%,19.05%,1
新竹縣,新埔鎮,0187,251,397,648,51,699,1122,62.3%,22.37%,1
新竹縣,新埔鎮,0188,200,263,463,17,480,1022,46.97%,19.57%,1
新竹縣,新埔鎮,0189,267,408,675,38,713,1429,49.9%,18.68%,1
新竹縣,新埔鎮,0190,130,149,279,28,307,451,68.07%,28.82%,1
新竹縣,新埔鎮,0191,181,212,393,21,414,724,57.18%,25%,1
新竹縣,新埔鎮,0192,147,218,365,32,397,617,64.34%,23.82%,1
新竹縣,新埔鎮,0193,238,405,643,37,680,1144,59.44%,20.8%,1
新竹縣,新埔鎮,0194,128,504,632,29,661,1139,58.03%,11.24%,1
新竹縣,新埔鎮,0195,174,308,482,14,496,861,57.61%,20.21%,1
新竹縣,新埔鎮,0196,189,355,544,21,565,1093,51.69%,17.29%,1
新竹縣,新埔鎮,0197,164,316,480,25,505,978,51.64%,16.77%,1
新竹縣,新埔鎮,0198,175,327,502,21,523,1040,50.29%,16.83%,1
新竹縣,新埔鎮,0199,228,377,605,17,622,1160,53.62%,19.66%,1
新竹縣,新埔鎮,0200,220,335,555,23,578,950,60.84%,23.16%,1
新竹縣,新埔鎮,0201,172,304,476,23,499,882,56.58%,19.5%,1
新竹縣,新埔鎮,0202,263,436,699,40,739,1281,57.69%,20.53%,1
新竹縣,新埔鎮,0203,230,382,612,40,652,1212,53.8%,18.98%,1
新竹縣,新埔鎮,0204,153,302,455,30,485,1013,47.88%,15.1%,1
新竹縣,新埔鎮,0205,175,204,379,24,403,630,63.97%,27.78%,1
新竹縣,關西鎮,0206,103,184,287,21,308,480,64.17%,21.46%,1
新竹縣,關西鎮,0207,177,330,507,36,543,903,60.13%,19.6%,1
新竹縣,關西鎮,0208,172,397,569,25,594,1020,58.24%,16.86%,1
新竹縣,關西鎮,0209,134,242,376,15,391,705,55.46%,19.01%,1
新竹縣,關西鎮,0210,193,373,566,19,585,1056,55.4%,18.28%,1
新竹縣,關西鎮,0211,235,432,667,35,702,1275,55.06%,18.43%,1
新竹縣,關西鎮,0212,249,467,716,46,762,1287,59.21%,19.35%,1
新竹縣,關西鎮,0213,157,290,447,21,468,771,60.7%,20.36%,1
新竹縣,關西鎮,0214,226,317,543,29,572,1046,54.68%,21.61%,1
新竹縣,關西鎮,0215,193,371,564,41,605,1030,58.74%,18.74%,1
新竹縣,關西鎮,0216,211,447,658,32,690,1208,57.12%,17.47%,1
新竹縣,關西鎮,0217,145,367,512,21,533,1095,48.68%,13.24%,1
新竹縣,關西鎮,0218,265,422,687,29,716,1350,53.04%,19.63%,1
新竹縣,關西鎮,0219,190,319,509,27,536,846,63.36%,22.46%,1
新竹縣,關西鎮,0220,241,466,707,41,748,1362,54.92%,17.69%,1
新竹縣,關西鎮,0221,160,281,441,18,459,903,50.83%,17.72%,1
新竹縣,關西鎮,0222,107,138,245,24,269,551,48.82%,19.42%,1
新竹縣,關西鎮,0223,90,96,186,8,194,461,42.08%,19.52%,1
新竹縣,關西鎮,0224,106,194,300,19,319,572,55.77%,18.53%,1
新竹縣,關西鎮,0225,155,331,486,23,509,943,53.98%,16.44%,1
新竹縣,關西鎮,0226,193,248,441,32,473,808,58.54%,23.89%,1
新竹縣,關西鎮,0227,178,378,556,26,582,923,63.06%,19.28%,1
新竹縣,關西鎮,0228,180,328,508,29,537,903,59.47%,19.93%,1
新竹縣,關西鎮,0229,205,337,542,34,576,977,58.96%,20.98%,1
新竹縣,關西鎮,0230,195,297,492,26,518,824,62.86%,23.67%,1
新竹縣,關西鎮,0231,114,227,341,23,364,559,65.12%,20.39%,1
新竹縣,關西鎮,0232,192,307,499,35,534,854,62.53%,22.48%,1
新竹縣,湖口鄉,0233,301,390,691,33,724,1393,51.97%,21.61%,1
新竹縣,湖口鄉,0234,213,616,829,44,873,1505,58.01%,14.15%,1
新竹縣,湖口鄉,0235,261,467,728,35,763,1188,64.23%,21.97%,1
新竹縣,湖口鄉,0236,245,439,684,47,731,1267,57.7%,19.34%,1
新竹縣,湖口鄉,0237,311,612,923,31,954,1668,57.19%,18.65%,1
新竹縣,湖口鄉,0238,357,591,948,49,997,1719,58%,20.77%,1
新竹縣,湖口鄉,0239,229,458,687,36,723,1162,62.22%,19.71%,1
新竹縣,湖口鄉,0240,302,596,898,41,939,1833,51.23%,16.48%,1
新竹縣,湖口鄉,0241,297,474,771,52,823,1444,56.99%,20.57%,1
新竹縣,湖口鄉,0242,283,505,788,49,837,1347,62.14%,21.01%,1
新竹縣,湖口鄉,0243,244,447,691,23,714,1202,59.4%,20.3%,1
新竹縣,湖口鄉,0244,181,312,493,23,516,851,60.63%,21.27%,1
新竹縣,湖口鄉,0245,258,479,737,37,774,1272,60.85%,20.28%,1
新竹縣,湖口鄉,0246,238,461,699,35,734,1275,57.57%,18.67%,1
新竹縣,湖口鄉,0247,359,570,929,45,974,1560,62.44%,23.01%,1
新竹縣,湖口鄉,0248,266,411,677,48,725,1147,63.21%,23.19%,1
新竹縣,湖口鄉,0249,331,621,952,34,986,1729,57.03%,19.14%,1
新竹縣,湖口鄉,0250,283,441,724,31,755,1402,53.85%,20.19%,1
新竹縣,湖口鄉,0251,243,424,667,40,707,1183,59.76%,20.54%,1
新竹縣,湖口鄉,0252,284,463,747,29,776,1282,60.53%,22.15%,1
新竹縣,湖口鄉,0253,280,493,773,32,805,1335,60.3%,20.97%,1
新竹縣,湖口鄉,0254,350,546,896,39,935,1493,62.63%,23.44%,1
新竹縣,湖口鄉,0255,323,661,984,26,1010,1877,53.81%,17.21%,1
新竹縣,湖口鄉,0256,242,393,635,37,672,1082,62.11%,22.37%,1
新竹縣,湖口鄉,0257,243,414,657,32,689,1115,61.79%,21.79%,1
新竹縣,湖口鄉,0258,216,371,587,28,615,1193,51.55%,18.11%,1
新竹縣,湖口鄉,0259,330,680,1010,39,1049,1947,53.88%,16.95%,1
新竹縣,湖口鄉,0260,235,393,628,49,677,1125,60.18%,20.89%,1
新竹縣,湖口鄉,0261,222,366,588,23,611,1050,58.19%,21.14%,1
新竹縣,湖口鄉,0262,358,614,972,32,1004,1733,57.93%,20.66%,1
新竹縣,湖口鄉,0263,238,486,724,38,762,1284,59.35%,18.54%,1
新竹縣,湖口鄉,0264,191,412,603,31,634,1062,59.7%,17.98%,1
新竹縣,湖口鄉,0265,293,540,833,50,883,1547,57.08%,18.94%,1
新竹縣,湖口鄉,0266,220,508,728,25,753,1494,50.4%,14.73%,1
新竹縣,湖口鄉,0267,237,524,761,27,788,1634,48.23%,14.5%,1
新竹縣,湖口鄉,0268,246,429,675,12,687,1444,47.58%,17.04%,1
新竹縣,湖口鄉,0269,221,446,667,29,696,1324,52.57%,16.69%,1
新竹縣,湖口鄉,0270,203,373,576,25,601,1058,56.81%,19.19%,1
新竹縣,湖口鄉,0271,198,315,513,18,531,1220,43.52%,16.23%,1
新竹縣,湖口鄉,0272,277,436,713,39,752,1333,56.41%,20.78%,1
新竹縣,湖口鄉,0273,256,470,726,41,767,1461,52.5%,17.52%,1
新竹縣,湖口鄉,0274,295,453,748,28,776,1429,54.3%,20.64%,1
新竹縣,湖口鄉,0275,236,462,698,18,716,1506,47.54%,15.67%,1
新竹縣,湖口鄉,0276,198,425,623,43,666,1103,60.38%,17.95%,1
新竹縣,湖口鄉,0277,253,453,706,36,742,1495,49.63%,16.92%,1
新竹縣,湖口鄉,0278,123,282,405,28,433,752,57.58%,16.36%,1
新竹縣,湖口鄉,0279,207,322,529,20,549,986,55.68%,20.99%,1
新竹縣,新豐鄉,0280,205,339,544,40,584,1080,54.07%,18.98%,1
新竹縣,新豐鄉,0281,183,265,448,24,472,887,53.21%,20.63%,1
新竹縣,新豐鄉,0282,222,291,513,28,541,954,56.71%,23.27%,1
新竹縣,新豐鄉,0283,215,330,545,26,571,1003,56.93%,21.44%,1
新竹縣,新豐鄉,0284,202,373,575,30,605,1106,54.7%,18.26%,1
新竹縣,新豐鄉,0285,222,411,633,28,661,1123,58.86%,19.77%,1
新竹縣,新豐鄉,0286,229,266,495,30,525,891,58.92%,25.7%,1
新竹縣,新豐鄉,0287,174,248,422,19,441,874,50.46%,19.91%,1
新竹縣,新豐鄉,0288,199,236,435,33,468,824,56.8%,24.15%,1
新竹縣,新豐鄉,0289,197,272,469,26,495,975,50.77%,20.21%,1
新竹縣,新豐鄉,0290,218,242,460,30,490,847,57.85%,25.74%,1
新竹縣,新豐鄉,0291,350,442,792,53,845,1477,57.21%,23.7%,1
新竹縣,新豐鄉,0292,318,321,639,32,671,1266,53%,25.12%,1
新竹縣,新豐鄉,0293,257,263,520,46,566,1029,55%,24.98%,1
新竹縣,新豐鄉,0294,281,270,551,21,572,1063,53.81%,26.43%,1
新竹縣,新豐鄉,0295,176,392,568,20,588,1055,55.73%,16.68%,1
新竹縣,新豐鄉,0296,259,517,776,32,808,1445,55.92%,17.92%,1
新竹縣,新豐鄉,0297,293,555,848,22,870,1413,61.57%,20.74%,1
新竹縣,新豐鄉,0298,231,366,597,26,623,971,64.16%,23.79%,1
新竹縣,新豐鄉,0299,225,438,663,20,683,1135,60.18%,19.82%,1
新竹縣,新豐鄉,0300,225,440,665,24,689,1269,54.29%,17.73%,1
新竹縣,新豐鄉,0301,260,422,682,31,713,1257,56.72%,20.68%,1
新竹縣,新豐鄉,0302,341,593,934,34,968,1662,58.24%,20.52%,1
新竹縣,新豐鄉,0303,282,479,761,26,787,1486,52.96%,18.98%,1
新竹縣,新豐鄉,0304,241,383,624,46,670,1067,62.79%,22.59%,1
新竹縣,新豐鄉,0305,163,573,736,48,784,1302,60.22%,12.52%,1
新竹縣,新豐鄉,0306,276,457,733,53,786,1410,55.74%,19.57%,1
新竹縣,新豐鄉,0307,260,391,651,45,696,1267,54.93%,20.52%,1
新竹縣,新豐鄉,0308,201,395,596,35,631,1258,50.16%,15.98%,1
新竹縣,新豐鄉,0309,215,395,610,22,632,1217,51.93%,17.67%,1
新竹縣,新豐鄉,0310,242,534,776,29,805,1456,55.29%,16.62%,1
新竹縣,新豐鄉,0311,223,436,659,22,681,1157,58.86%,19.27%,1
新竹縣,新豐鄉,0312,212,344,556,22,578,1089,53.08%,19.47%,1
新竹縣,新豐鄉,0313,207,439,646,15,661,1160,56.98%,17.84%,1
新竹縣,新豐鄉,0314,177,420,597,14,611,976,62.6%,18.14%,1
新竹縣,新豐鄉,0315,312,463,775,36,811,1443,56.2%,21.62%,1
新竹縣,新豐鄉,0316,229,410,639,23,662,1247,53.09%,18.36%,1
新竹縣,新豐鄉,0317,253,506,759,27,786,1411,55.71%,17.93%,1
新竹縣,新豐鄉,0318,213,487,700,35,735,1238,59.37%,17.21%,1
新竹縣,芎林鄉,0319,87,145,232,12,244,417,58.51%,20.86%,1
新竹縣,芎林鄉,0320,125,232,357,23,380,534,71.16%,23.41%,1
新竹縣,芎林鄉,0321,170,373,543,23,566,963,58.77%,17.65%,1
新竹縣,芎林鄉,0322,96,160,256,15,271,418,64.83%,22.97%,1
新竹縣,芎林鄉,0323,217,462,679,45,724,1312,55.18%,16.54%,1
新竹縣,芎林鄉,0324,235,403,638,42,680,1354,50.22%,17.36%,1
新竹縣,芎林鄉,0325,169,271,440,32,472,785,60.13%,21.53%,1
新竹縣,芎林鄉,0326,150,313,463,26,489,797,61.36%,18.82%,1
新竹縣,芎林鄉,0327,118,252,370,24,394,623,63.24%,18.94%,1
新竹縣,芎林鄉,0328,163,250,413,32,445,759,58.63%,21.48%,1
新竹縣,芎林鄉,0329,196,405,601,46,647,1272,50.86%,15.41%,1
新竹縣,芎林鄉,0330,191,455,646,26,672,1129,59.52%,16.92%,1
新竹縣,芎林鄉,0331,164,259,423,21,444,713,62.27%,23%,1
新竹縣,芎林鄉,0332,210,285,495,33,528,839,62.93%,25.03%,1
新竹縣,芎林鄉,0333,231,479,710,32,742,1123,66.07%,20.57%,1
新竹縣,芎林鄉,0334,195,377,572,20,592,981,60.35%,19.88%,1
新竹縣,芎林鄉,0335,250,383,633,25,658,1078,61.04%,23.19%,1
新竹縣,芎林鄉,0336,189,384,573,26,599,1094,54.75%,17.28%,1
新竹縣,芎林鄉,0337,238,383,621,35,656,1102,59.53%,21.6%,1
新竹縣,橫山鄉,0338,240,461,701,52,753,1231,61.17%,19.5%,1
新竹縣,橫山鄉,0339,192,391,583,44,627,1041,60.23%,18.44%,1
新竹縣,橫山鄉,0340,227,433,660,29,689,1132,60.87%,20.05%,1
新竹縣,橫山鄉,0341,174,317,491,36,527,859,61.35%,20.26%,1
新竹縣,橫山鄉,0342,33,70,103,15,118,204,57.84%,16.18%,1
新竹縣,橫山鄉,0343,46,48,94,8,102,222,45.95%,20.72%,1
新竹縣,橫山鄉,0344,85,112,197,22,219,338,64.79%,25.15%,1
新竹縣,橫山鄉,0345,156,314,470,23,493,916,53.82%,17.03%,1
新竹縣,橫山鄉,0346,75,150,225,14,239,573,41.71%,13.09%,1
新竹縣,橫山鄉,0347,67,117,184,8,192,275,69.82%,24.36%,1
新竹縣,橫山鄉,0348,79,145,224,8,232,463,50.11%,17.06%,1
新竹縣,橫山鄉,0349,138,266,404,39,443,690,64.2%,20%,1
新竹縣,橫山鄉,0350,64,73,137,11,148,288,51.39%,22.22%,1
新竹縣,橫山鄉,0351,142,270,412,30,442,685,64.53%,20.73%,1
新竹縣,橫山鄉,0352,162,346,508,30,538,868,61.98%,18.66%,1
新竹縣,橫山鄉,0353,301,607,908,58,966,1561,61.88%,19.28%,1
新竹縣,北埔鄉,0354,231,363,594,11,605,1158,52.25%,19.95%,1
新竹縣,北埔鄉,0355,245,448,693,49,742,1238,59.94%,19.79%,1
新竹縣,北埔鄉,0356,119,205,324,16,340,580,58.62%,20.52%,1
新竹縣,北埔鄉,0357,182,338,520,26,546,931,58.65%,19.55%,1
新竹縣,北埔鄉,0358,278,590,868,64,932,1653,56.38%,16.82%,1
新竹縣,北埔鄉,0359,173,284,457,30,487,845,57.63%,20.47%,1
新竹縣,北埔鄉,0360,89,119,208,12,220,384,57.29%,23.18%,1
新竹縣,北埔鄉,0361,165,266,431,14,445,763,58.32%,21.63%,1
新竹縣,北埔鄉,0362,76,101,177,10,187,333,56.16%,22.82%,1
新竹縣,北埔鄉,0363,72,86,158,9,167,295,56.61%,24.41%,1
新竹縣,寶山鄉,0364,255,388,643,29,672,1158,58.03%,22.02%,1
新竹縣,寶山鄉,0365,308,494,802,26,828,1437,57.62%,21.43%,1
新竹縣,寶山鄉,0366,311,486,797,41,838,1470,57.01%,21.16%,1
新竹縣,寶山鄉,0367,271,409,680,32,712,1170,60.85%,23.16%,1
新竹縣,寶山鄉,0368,384,673,1057,45,1102,1900,58%,20.21%,1
新竹縣,寶山鄉,0369,179,343,522,30,552,1056,52.27%,16.95%,1
新竹縣,寶山鄉,0370,281,424,705,52,757,1205,62.82%,23.32%,1
新竹縣,寶山鄉,0371,143,268,411,32,443,766,57.83%,18.67%,1
新竹縣,寶山鄉,0372,186,300,486,31,517,846,61.11%,21.99%,1
新竹縣,寶山鄉,0373,176,295,471,24,495,804,61.57%,21.89%,1
新竹縣,寶山鄉,0374,137,220,357,17,374,607,61.61%,22.57%,1
新竹縣,寶山鄉,0375,158,189,347,12,359,554,64.8%,28.52%,1
新竹縣,峨眉鄉,0376,194,337,531,42,573,879,65.19%,22.07%,1
新竹縣,峨眉鄉,0377,154,256,410,28,438,683,64.13%,22.55%,1
新竹縣,峨眉鄉,0378,133,210,343,25,368,604,60.93%,22.02%,1
新竹縣,峨眉鄉,0379,69,114,183,16,199,339,58.7%,20.35%,1
新竹縣,峨眉鄉,0380,77,42,119,7,126,276,45.65%,27.9%,1
新竹縣,峨眉鄉,0381,285,512,797,61,858,1406,61.02%,20.27%,1
新竹縣,峨眉鄉,0382,108,163,271,18,289,462,62.55%,23.38%,1
新竹縣,峨眉鄉,0383,88,130,218,10,228,419,54.42%,21%,1
新竹縣,尖石鄉,0384,71,137,208,7,215,474,45.36%,14.98%,1
新竹縣,尖石鄉,0385,65,124,189,4,193,357,54.06%,18.21%,1
新竹縣,尖石鄉,0386,45,57,102,11,113,225,50.22%,20%,1
新竹縣,尖石鄉,0387,61,109,170,9,179,374,47.86%,16.31%,1
新竹縣,尖石鄉,0388,115,217,332,6,338,773,43.73%,14.88%,1
新竹縣,尖石鄉,0389,88,142,230,16,246,490,50.2%,17.96%,1
新竹縣,尖石鄉,0390,72,109,181,8,189,531,35.59%,13.56%,1
新竹縣,尖石鄉,0391,106,217,323,9,332,660,50.3%,16.06%,1
新竹縣,尖石鄉,0392,131,230,361,47,408,613,66.56%,21.37%,1
新竹縣,尖石鄉,0393,128,142,270,6,276,593,46.54%,21.59%,1
新竹縣,尖石鄉,0394,109,171,280,13,293,575,50.96%,18.96%,1
新竹縣,尖石鄉,0395,47,30,77,7,84,126,66.67%,37.3%,1
新竹縣,尖石鄉,0396,81,132,213,8,221,499,44.29%,16.23%,1
新竹縣,尖石鄉,0397,116,125,241,10,251,785,31.97%,14.78%,1
新竹縣,尖石鄉,0398,87,81,168,10,178,289,61.59%,30.1%,1
新竹縣,五峰鄉,0399,97,266,363,26,389,672,57.89%,14.43%,1
新竹縣,五峰鄉,0400,112,196,308,16,324,713,45.44%,15.71%,1
新竹縣,五峰鄉,0401,93,135,228,6,234,594,39.39%,15.66%,1
新竹縣,五峰鄉,0402,161,280,441,15,456,896,50.89%,17.97%,1
新竹縣,五峰鄉,0403,107,225,332,12,344,727,47.32%,14.72%,1
新竹縣,五峰鄉,0404,64,106,170,9,179,395,45.32%,16.2%,1
苗栗縣,苗栗市,0001,200,400,600,30,630,1087,57.96%,18.4%,1
苗栗縣,苗栗市,0002,171,379,550,21,571,1018,56.09%,16.8%,1
苗栗縣,苗栗市,0003,200,420,620,29,649,1156,56.14%,17.3%,1
苗栗縣,苗栗市,0004,188,394,582,30,612,1118,54.74%,16.82%,1
苗栗縣,苗栗市,0005,187,411,598,41,639,1084,58.95%,17.25%,1
苗栗縣,苗栗市,0006,236,460,696,28,724,1203,60.18%,19.62%,1
苗栗縣,苗栗市,0007,232,513,745,34,779,1306,59.65%,17.76%,1
苗栗縣,苗栗市,0008,240,440,680,41,721,1193,60.44%,20.12%,1
苗栗縣,苗栗市,0009,185,448,633,26,659,1115,59.1%,16.59%,1
苗栗縣,苗栗市,0010,215,438,653,37,690,1119,61.66%,19.21%,1
苗栗縣,苗栗市,0011,238,429,667,31,698,1132,61.66%,21.02%,1
苗栗縣,苗栗市,0012,220,487,707,35,742,1289,57.56%,17.07%,1
苗栗縣,苗栗市,0013,221,503,724,34,758,1264,59.97%,17.48%,1
苗栗縣,苗栗市,0014,146,328,474,20,494,870,56.78%,16.78%,1
苗栗縣,苗栗市,0015,151,335,486,29,515,1008,51.09%,14.98%,1
苗栗縣,苗栗市,0016,190,360,550,22,572,1078,53.06%,17.63%,1
苗栗縣,苗栗市,0017,236,386,622,24,646,1077,59.98%,21.91%,1
苗栗縣,苗栗市,0018,170,329,499,18,517,880,58.75%,19.32%,1
苗栗縣,苗栗市,0019,181,292,473,30,503,894,56.26%,20.25%,1
苗栗縣,苗栗市,0020,113,172,285,18,303,522,58.05%,21.65%,1
苗栗縣,苗栗市,0021,307,508,815,53,868,1376,63.08%,22.31%,1
苗栗縣,苗栗市,0022,243,484,727,33,760,1391,54.64%,17.47%,1
苗栗縣,苗栗市,0023,209,401,610,40,650,1081,60.13%,19.33%,1
苗栗縣,苗栗市,0024,215,465,680,34,714,1272,56.13%,16.9%,1
苗栗縣,苗栗市,0025,238,456,694,19,713,1112,64.12%,21.4%,1
苗栗縣,苗栗市,0026,184,338,522,23,545,813,67.04%,22.63%,1
苗栗縣,苗栗市,0027,150,275,425,13,438,767,57.11%,19.56%,1
苗栗縣,苗栗市,0028,181,382,563,21,584,1010,57.82%,17.92%,1
苗栗縣,苗栗市,0029,204,444,648,21,669,1182,56.6%,17.26%,1
苗栗縣,苗栗市,0030,187,353,540,16,556,965,57.62%,19.38%,1
苗栗縣,苗栗市,0031,97,262,359,6,365,607,60.13%,15.98%,1
苗栗縣,苗栗市,0032,210,376,586,26,612,990,61.82%,21.21%,1
苗栗縣,苗栗市,0033,157,483,640,29,669,1230,54.39%,12.76%,1
苗栗縣,苗栗市,0034,257,512,769,28,797,1372,58.09%,18.73%,1
苗栗縣,苗栗市,0035,214,463,677,36,713,1213,58.78%,17.64%,1
苗栗縣,苗栗市,0036,218,476,694,31,725,1272,57%,17.14%,1
苗栗縣,苗栗市,0037,250,472,722,35,757,1221,62%,20.48%,1
苗栗縣,苗栗市,0038,205,409,614,30,644,1104,58.33%,18.57%,1
苗栗縣,苗栗市,0039,187,419,606,18,624,1171,53.29%,15.97%,1
苗栗縣,苗栗市,0040,244,507,751,36,787,1392,56.54%,17.53%,1
苗栗縣,苗栗市,0041,444,322,766,35,801,1356,59.07%,32.74%,1
苗栗縣,苗栗市,0042,270,508,778,33,811,1387,58.47%,19.47%,1
苗栗縣,苗栗市,0043,242,406,648,30,678,1206,56.22%,20.07%,1
苗栗縣,苗栗市,0044,219,395,614,26,640,1004,63.75%,21.81%,1
苗栗縣,苗栗市,0045,227,423,650,28,678,1202,56.41%,18.89%,1
苗栗縣,苗栗市,0046,203,410,613,28,641,1052,60.93%,19.3%,1
苗栗縣,苗栗市,0047,177,340,517,26,543,873,62.2%,20.27%,1
苗栗縣,苗栗市,0048,214,415,629,25,654,975,67.08%,21.95%,1
苗栗縣,苗栗市,0049,12,599,611,33,644,1003,64.21%,1.2%,1
苗栗縣,苗栗市,0050,189,376,565,17,582,1000,58.2%,18.9%,1
苗栗縣,苗栗市,0051,183,386,569,21,590,1047,56.35%,17.48%,1
苗栗縣,苗栗市,0052,181,412,593,39,632,1025,61.66%,17.66%,1
苗栗縣,苗栗市,0053,182,413,595,18,613,1130,54.25%,16.11%,1
苗栗縣,苗栗市,0054,183,456,639,15,654,1146,57.07%,15.97%,1
苗栗縣,苗栗市,0055,244,552,796,33,829,1432,57.89%,17.04%,1
苗栗縣,苗栗市,0056,206,480,686,30,716,1492,47.99%,13.81%,1
苗栗縣,苗栗市,0057,187,479,666,27,693,1125,61.6%,16.62%,1
苗栗縣,苗栗市,0058,256,410,666,30,696,1241,56.08%,20.63%,1
苗栗縣,苗栗市,0059,234,498,732,37,769,1278,60.17%,18.31%,1
苗栗縣,苗栗市,0060,201,506,707,20,727,1293,56.23%,15.55%,1
苗栗縣,苗栗市,0061,222,464,686,26,712,1342,53.06%,16.54%,1
苗栗縣,苗栗市,0062,177,280,457,27,484,857,56.48%,20.65%,1
苗栗縣,苗栗市,0063,228,388,616,31,647,1180,54.83%,19.32%,1
苗栗縣,苗栗市,0064,252,368,620,17,637,1072,59.42%,23.51%,1
苗栗縣,苗栗市,0065,169,312,481,25,506,912,55.48%,18.53%,1
苗栗縣,苗栗市,0066,145,258,403,23,426,796,53.52%,18.22%,1
苗栗縣,苗栗市,0067,151,281,432,13,445,869,51.21%,17.38%,1
苗栗縣,苑裡鎮,0183,220,270,490,34,524,873,60.02%,25.2%,1
苗栗縣,苑裡鎮,0184,331,413,744,46,790,1346,58.69%,24.59%,1
苗栗縣,苑裡鎮,0185,264,340,604,30,634,951,66.67%,27.76%,1
苗栗縣,苑裡鎮,0186,176,165,341,11,352,615,57.24%,28.62%,1
苗栗縣,苑裡鎮,0187,278,239,517,42,559,878,63.67%,31.66%,1
苗栗縣,苑裡鎮,0188,209,234,443,34,477,767,62.19%,27.25%,1
苗栗縣,苑裡鎮,0189,230,193,423,25,448,776,57.73%,29.64%,1
苗栗縣,苑裡鎮,0190,343,291,634,36,670,1231,54.43%,27.86%,1
苗栗縣,苑裡鎮,0191,292,364,656,38,694,1145,60.61%,25.5%,1
苗栗縣,苑裡鎮,0192,211,242,453,24,477,850,56.12%,24.82%,1
苗栗縣,苑裡鎮,0193,290,245,535,51,586,1052,55.7%,27.57%,1
苗栗縣,苑裡鎮,0194,284,321,605,34,639,1114,57.36%,25.49%,1
苗栗縣,苑裡鎮,0195,344,295,639,38,677,1136,59.6%,30.28%,1
苗栗縣,苑裡鎮,0196,274,366,640,43,683,1194,57.2%,22.95%,1
苗栗縣,苑裡鎮,0197,380,483,863,45,908,1579,57.5%,24.07%,1
苗栗縣,苑裡鎮,0198,324,357,681,32,713,1149,62.05%,28.2%,1
苗栗縣,苑裡鎮,0199,302,302,604,39,643,1057,60.83%,28.57%,1
苗栗縣,苑裡鎮,0200,257,304,561,24,585,1101,53.13%,23.34%,1
苗栗縣,苑裡鎮,0201,206,209,415,35,450,912,49.34%,22.59%,1
苗栗縣,苑裡鎮,0202,188,165,353,15,368,652,56.44%,28.83%,1
苗栗縣,苑裡鎮,0203,361,373,734,52,786,1348,58.31%,26.78%,1
苗栗縣,苑裡鎮,0204,219,142,361,21,382,733,52.11%,29.88%,1
苗栗縣,苑裡鎮,0205,142,195,337,9,346,662,52.27%,21.45%,1
苗栗縣,苑裡鎮,0206,220,264,484,35,519,893,58.12%,24.64%,1
苗栗縣,苑裡鎮,0207,237,274,511,36,547,910,60.11%,26.04%,1
苗栗縣,苑裡鎮,0208,313,342,655,55,710,1270,55.91%,24.65%,1
苗栗縣,苑裡鎮,0209,130,149,279,18,297,545,54.5%,23.85%,1
苗栗縣,苑裡鎮,0210,182,266,448,55,503,792,63.51%,22.98%,1
苗栗縣,苑裡鎮,0211,192,198,390,28,418,726,57.58%,26.45%,1
苗栗縣,苑裡鎮,0212,179,181,360,13,373,827,45.1%,21.64%,1
苗栗縣,苑裡鎮,0213,204,231,435,34,469,782,59.97%,26.09%,1
苗栗縣,苑裡鎮,0214,190,218,408,33,441,788,55.96%,24.11%,1
苗栗縣,苑裡鎮,0215,211,236,447,23,470,846,55.56%,24.94%,1
苗栗縣,苑裡鎮,0216,198,271,469,36,505,828,60.99%,23.91%,1
苗栗縣,苑裡鎮,0217,220,289,509,42,551,943,58.43%,23.33%,1
苗栗縣,苑裡鎮,0218,276,350,626,27,653,1082,60.35%,25.51%,1
苗栗縣,苑裡鎮,0219,346,360,706,44,750,1234,60.78%,28.04%,1
苗栗縣,苑裡鎮,0220,318,422,740,50,790,1434,55.09%,22.18%,1
苗栗縣,苑裡鎮,0221,253,288,541,35,576,987,58.36%,25.63%,1
苗栗縣,苑裡鎮,0222,290,249,539,30,569,882,64.51%,32.88%,1
苗栗縣,通霄鎮,0149,287,321,608,58,666,1142,58.32%,25.13%,1
苗栗縣,通霄鎮,0150,284,260,544,35,579,884,65.5%,32.13%,1
苗栗縣,通霄鎮,0151,229,348,577,30,607,1068,56.84%,21.44%,1
苗栗縣,通霄鎮,0152,290,296,586,23,609,1009,60.36%,28.74%,1
苗栗縣,通霄鎮,0153,222,302,524,39,563,859,65.54%,25.84%,1
苗栗縣,通霄鎮,0154,261,318,579,32,611,1040,58.75%,25.1%,1
苗栗縣,通霄鎮,0155,204,233,437,17,454,1008,45.04%,20.24%,1
苗栗縣,通霄鎮,0156,175,188,363,45,408,686,59.48%,25.51%,1
苗栗縣,通霄鎮,0157,216,253,469,42,511,761,67.15%,28.38%,1
苗栗縣,通霄鎮,0158,177,214,391,21,412,790,52.15%,22.41%,1
苗栗縣,通霄鎮,0159,217,278,495,39,534,966,55.28%,22.46%,1
苗栗縣,通霄鎮,0160,212,247,459,47,506,972,52.06%,21.81%,1
苗栗縣,通霄鎮,0161,174,222,396,38,434,771,56.29%,22.57%,1
苗栗縣,通霄鎮,0162,161,185,346,16,362,758,47.76%,21.24%,1
苗栗縣,通霄鎮,0163,221,329,550,35,585,1078,54.27%,20.5%,1
苗栗縣,通霄鎮,0164,88,100,188,15,203,459,44.23%,19.17%,1
苗栗縣,通霄鎮,0165,159,254,413,36,449,894,50.22%,17.79%,1
苗栗縣,通霄鎮,0166,59,94,153,6,159,402,39.55%,14.68%,1
苗栗縣,通霄鎮,0167,174,232,406,30,436,802,54.36%,21.7%,1
苗栗縣,通霄鎮,0168,160,188,348,17,365,684,53.36%,23.39%,1
苗栗縣,通霄鎮,0169,185,232,417,30,447,943,47.4%,19.62%,1
苗栗縣,通霄鎮,0170,203,235,438,42,480,790,60.76%,25.7%,1
苗栗縣,通霄鎮,0171,160,142,302,8,310,673,46.06%,23.77%,1
苗栗縣,通霄鎮,0172,258,342,600,58,658,1232,53.41%,20.94%,1
苗栗縣,通霄鎮,0173,313,397,710,48,758,1286,58.94%,24.34%,1
苗栗縣,通霄鎮,0174,159,193,352,32,384,649,59.17%,24.5%,1
苗栗縣,通霄鎮,0175,195,172,367,23,390,769,50.72%,25.36%,1
苗栗縣,通霄鎮,0176,244,335,579,52,631,1148,54.97%,21.25%,1
苗栗縣,通霄鎮,0177,252,278,530,46,576,1138,50.62%,22.14%,1
苗栗縣,通霄鎮,0178,280,264,544,38,582,1121,51.92%,24.98%,1
苗栗縣,通霄鎮,0179,176,230,406,24,430,769,55.92%,22.89%,1
苗栗縣,通霄鎮,0180,136,151,287,13,300,616,48.7%,22.08%,1
苗栗縣,通霄鎮,0181,182,218,400,38,438,799,54.82%,22.78%,1
苗栗縣,通霄鎮,0182,173,189,362,23,385,743,51.82%,23.28%,1
苗栗縣,竹南鎮,0270,285,337,622,28,650,1086,59.85%,26.24%,1
苗栗縣,竹南鎮,0271,170,293,463,26,489,826,59.2%,20.58%,1
苗栗縣,竹南鎮,0272,245,293,538,23,561,1051,53.38%,23.31%,1
苗栗縣,竹南鎮,0273,268,447,715,21,736,1235,59.6%,21.7%,1
苗栗縣,竹南鎮,0274,286,299,585,35,620,1016,61.02%,28.15%,1
苗栗縣,竹南鎮,0275,344,410,754,46,800,1472,54.35%,23.37%,1
苗栗縣,竹南鎮,0276,282,337,619,27,646,1301,49.65%,21.68%,1
苗栗縣,竹南鎮,0277,314,447,761,25,786,1544,50.91%,20.34%,1
苗栗縣,竹南鎮,0278,321,487,808,22,830,1512,54.89%,21.23%,1
苗栗縣,竹南鎮,0279,319,436,755,25,780,1463,53.32%,21.8%,1
苗栗縣,竹南鎮,0280,236,314,550,23,573,1073,53.4%,21.99%,1
苗栗縣,竹南鎮,0281,302,509,811,28,839,1453,57.74%,20.78%,1
苗栗縣,竹南鎮,0282,290,441,731,26,757,1245,60.8%,23.29%,1
苗栗縣,竹南鎮,0283,306,555,861,28,889,1487,59.78%,20.58%,1
苗栗縣,竹南鎮,0284,178,394,572,30,602,1018,59.14%,17.49%,1
苗栗縣,竹南鎮,0285,267,367,634,25,659,1105,59.64%,24.16%,1
苗栗縣,竹南鎮,0286,296,380,676,26,702,1322,53.1%,22.39%,1
苗栗縣,竹南鎮,0287,244,391,635,25,660,1140,57.89%,21.4%,1
苗栗縣,竹南鎮,0288,223,402,625,30,655,1067,61.39%,20.9%,1
苗栗縣,竹南鎮,0289,281,399,680,41,721,1136,63.47%,24.74%,1
苗栗縣,竹南鎮,0290,250,370,620,35,655,1253,52.27%,19.95%,1
苗栗縣,竹南鎮,0291,220,255,475,39,514,963,53.37%,22.85%,1
苗栗縣,竹南鎮,0292,255,265,520,37,557,1021,54.55%,24.98%,1
苗栗縣,竹南鎮,0293,259,404,663,30,693,1154,60.05%,22.44%,1
苗栗縣,竹南鎮,0294,251,325,576,25,601,1042,57.68%,24.09%,1
苗栗縣,竹南鎮,0295,265,456,721,25,746,1293,57.7%,20.49%,1
苗栗縣,竹南鎮,0296,186,301,487,7,494,816,60.54%,22.79%,1
苗栗縣,竹南鎮,0297,229,296,525,36,561,989,56.72%,23.15%,1
苗栗縣,竹南鎮,0298,242,402,644,35,679,1122,60.52%,21.57%,1
苗栗縣,竹南鎮,0299,198,293,491,32,523,1111,47.07%,17.82%,1
苗栗縣,竹南鎮,0300,231,356,587,31,618,1036,59.65%,22.3%,1
苗栗縣,竹南鎮,0301,191,349,540,20,560,1112,50.36%,17.18%,1
苗栗縣,竹南鎮,0302,269,419,688,17,705,1348,52.3%,19.96%,1
苗栗縣,竹南鎮,0303,321,320,641,11,652,1114,58.53%,28.82%,1
苗栗縣,竹南鎮,0304,252,381,633,41,674,1119,60.23%,22.52%,1
苗栗縣,竹南鎮,0305,163,305,468,31,499,878,56.83%,18.56%,1
苗栗縣,竹南鎮,0306,253,365,618,40,658,1059,62.13%,23.89%,1
苗栗縣,竹南鎮,0307,229,263,492,29,521,869,59.95%,26.35%,1
苗栗縣,竹南鎮,0308,179,244,423,29,452,800,56.5%,22.38%,1
苗栗縣,竹南鎮,0309,298,382,680,30,710,1165,60.94%,25.58%,1
苗栗縣,竹南鎮,0310,192,243,435,28,463,791,58.53%,24.27%,1
苗栗縣,竹南鎮,0311,155,212,367,17,384,677,56.72%,22.9%,1
苗栗縣,竹南鎮,0312,212,269,481,38,519,797,65.12%,26.6%,1
苗栗縣,竹南鎮,0313,252,388,640,19,659,1191,55.33%,21.16%,1
苗栗縣,竹南鎮,0314,222,301,523,17,540,1027,52.58%,21.62%,1
苗栗縣,竹南鎮,0315,298,452,750,44,794,1341,59.21%,22.22%,1
苗栗縣,竹南鎮,0316,277,389,666,37,703,1378,51.02%,20.1%,1
苗栗縣,竹南鎮,0317,267,389,656,29,685,1216,56.33%,21.96%,1
苗栗縣,竹南鎮,0318,322,491,813,26,839,1570,53.44%,20.51%,1
苗栗縣,竹南鎮,0319,154,158,312,23,335,538,62.27%,28.62%,1
苗栗縣,竹南鎮,0320,191,344,535,22,557,1166,47.77%,16.38%,1
苗栗縣,竹南鎮,0321,214,554,768,23,791,1488,53.16%,14.38%,1
苗栗縣,竹南鎮,0322,302,402,704,36,740,1449,51.07%,20.84%,1
苗栗縣,竹南鎮,0323,276,347,623,42,665,1182,56.26%,23.35%,1
苗栗縣,竹南鎮,0324,283,338,621,50,671,1175,57.11%,24.09%,1
苗栗縣,竹南鎮,0325,251,292,543,30,573,983,58.29%,25.53%,1
苗栗縣,竹南鎮,0326,112,181,293,16,309,492,62.8%,22.76%,1
苗栗縣,竹南鎮,0327,255,336,591,32,623,1074,58.01%,23.74%,1
苗栗縣,竹南鎮,0328,246,204,450,29,479,852,56.22%,28.87%,1
苗栗縣,竹南鎮,0329,274,401,675,27,702,1297,54.12%,21.13%,1
苗栗縣,竹南鎮,0330,221,304,525,34,559,1028,54.38%,21.5%,1
苗栗縣,頭份市,0331,195,272,467,30,497,915,54.32%,21.31%,1
苗栗縣,頭份市,0332,253,449,702,35,737,1292,57.04%,19.58%,1
苗栗縣,頭份市,0333,192,335,527,26,553,928,59.59%,20.69%,1
苗栗縣,頭份市,0334,152,270,422,12,434,835,51.98%,18.2%,1
苗栗縣,頭份市,0335,218,341,559,28,587,1070,54.86%,20.37%,1
苗栗縣,頭份市,0336,153,284,437,21,458,879,52.1%,17.41%,1
苗栗縣,頭份市,0337,212,293,505,32,537,1039,51.68%,20.4%,1
苗栗縣,頭份市,0338,230,388,618,41,659,1129,58.37%,20.37%,1
苗栗縣,頭份市,0339,215,339,554,20,574,1041,55.14%,20.65%,1
苗栗縣,頭份市,0340,221,520,741,52,793,1546,51.29%,14.29%,1
苗栗縣,頭份市,0341,199,357,556,30,586,935,62.67%,21.28%,1
苗栗縣,頭份市,0342,221,366,587,30,617,1180,52.29%,18.73%,1
苗栗縣,頭份市,0343,239,505,744,27,771,1499,51.43%,15.94%,1
苗栗縣,頭份市,0344,154,242,396,12,408,747,54.62%,20.62%,1
苗栗縣,頭份市,0345,236,504,740,28,768,1406,54.62%,16.79%,1
苗栗縣,頭份市,0346,215,410,625,48,673,1193,56.41%,18.02%,1
苗栗縣,頭份市,0347,212,314,526,32,558,948,58.86%,22.36%,1
苗栗縣,頭份市,0348,144,298,442,26,468,869,53.86%,16.57%,1
苗栗縣,頭份市,0349,212,427,639,27,666,1142,58.32%,18.56%,1
苗栗縣,頭份市,0350,263,432,695,18,713,1286,55.44%,20.45%,1
苗栗縣,頭份市,0351,172,339,511,29,540,903,59.8%,19.05%,1
苗栗縣,頭份市,0352,218,485,703,35,738,1186,62.23%,18.38%,1
苗栗縣,頭份市,0353,194,382,576,21,597,1016,58.76%,19.09%,1
苗栗縣,頭份市,0354,205,330,535,27,562,985,57.06%,20.81%,1
苗栗縣,頭份市,0355,189,350,539,27,566,1037,54.58%,18.23%,1
苗栗縣,頭份市,0356,160,284,444,20,464,947,49%,16.9%,1
苗栗縣,頭份市,0357,187,319,506,14,520,890,58.43%,21.01%,1
苗栗縣,頭份市,0358,159,226,385,24,409,646,63.31%,24.61%,1
苗栗縣,頭份市,0359,185,354,539,43,582,975,59.69%,18.97%,1
苗栗縣,頭份市,0360,154,229,383,17,400,1015,39.41%,15.17%,1
苗栗縣,頭份市,0361,314,503,817,48,865,1399,61.83%,22.44%,1
苗栗縣,頭份市,0362,237,396,633,56,689,1143,60.28%,20.73%,1
苗栗縣,頭份市,0363,222,402,624,47,671,1030,65.15%,21.55%,1
苗栗縣,頭份市,0364,247,494,741,35,776,1338,58%,18.46%,1
苗栗縣,頭份市,0365,265,501,766,17,783,1450,54%,18.28%,1
苗栗縣,頭份市,0366,199,392,591,19,610,1042,58.54%,19.1%,1
苗栗縣,頭份市,0367,252,519,771,26,797,1326,60.11%,19%,1
苗栗縣,頭份市,0368,267,508,775,28,803,1270,63.23%,21.02%,1
苗栗縣,頭份市,0369,301,407,708,22,730,1288,56.68%,23.37%,1
苗栗縣,頭份市,0370,355,346,701,37,738,1243,59.37%,28.56%,1
苗栗縣,頭份市,0371,259,474,733,22,755,1280,58.98%,20.23%,1
苗栗縣,頭份市,0372,321,551,872,40,912,1618,56.37%,19.84%,1
苗栗縣,頭份市,0373,330,590,920,31,951,1759,54.06%,18.76%,1
苗栗縣,頭份市,0374,217,502,719,35,754,1264,59.65%,17.17%,1
苗栗縣,頭份市,0375,293,460,753,15,768,1326,57.92%,22.1%,1
苗栗縣,頭份市,0376,313,564,877,25,902,1551,58.16%,20.18%,1
苗栗縣,頭份市,0377,260,517,777,34,811,1574,51.52%,16.52%,1
苗栗縣,頭份市,0378,263,425,688,43,731,1262,57.92%,20.84%,1
苗栗縣,頭份市,0379,219,435,654,36,690,1171,58.92%,18.7%,1
苗栗縣,頭份市,0380,231,435,666,30,696,1074,64.8%,21.51%,1
苗栗縣,頭份市,0381,246,416,662,31,693,1141,60.74%,21.56%,1
苗栗縣,頭份市,0382,264,443,707,25,732,1259,58.14%,20.97%,1
苗栗縣,頭份市,0383,199,425,624,30,654,1186,55.14%,16.78%,1
苗栗縣,頭份市,0384,202,363,565,19,584,1121,52.1%,18.02%,1
苗栗縣,頭份市,0385,163,309,472,13,485,847,57.26%,19.24%,1
苗栗縣,頭份市,0386,220,354,574,26,600,993,60.42%,22.16%,1
苗栗縣,頭份市,0387,200,347,547,23,570,1055,54.03%,18.96%,1
苗栗縣,頭份市,0388,260,545,805,32,837,1655,50.57%,15.71%,1
苗栗縣,頭份市,0389,336,620,956,34,990,1799,55.03%,18.68%,1
苗栗縣,頭份市,0390,218,420,638,25,663,1141,58.11%,19.11%,1
苗栗縣,頭份市,0391,283,469,752,31,783,1431,54.72%,19.78%,1
苗栗縣,頭份市,0392,248,402,650,20,670,1412,47.45%,17.56%,1
苗栗縣,頭份市,0393,202,329,531,34,565,1074,52.61%,18.81%,1
苗栗縣,頭份市,0394,262,449,711,31,742,1245,59.6%,21.04%,1
苗栗縣,頭份市,0395,325,438,763,49,812,1344,60.42%,24.18%,1
苗栗縣,頭份市,0396,288,520,808,35,843,1363,61.85%,21.13%,1
苗栗縣,頭份市,0397,171,375,546,32,578,898,64.37%,19.04%,1
苗栗縣,頭份市,0398,240,431,671,47,718,1182,60.74%,20.3%,1
苗栗縣,頭份市,0399,248,501,749,38,787,1413,55.7%,17.55%,1
苗栗縣,頭份市,0400,216,369,585,32,617,991,62.26%,21.8%,1
苗栗縣,頭份市,0401,231,421,652,44,696,1180,58.98%,19.58%,1
苗栗縣,後龍鎮,0223,141,184,325,23,348,590,58.98%,23.9%,1
苗栗縣,後龍鎮,0224,263,261,524,35,559,883,63.31%,29.78%,1
苗栗縣,後龍鎮,0225,230,248,478,27,505,793,63.68%,29%,1
苗栗縣,後龍鎮,0226,206,221,427,15,442,732,60.38%,28.14%,1
苗栗縣,後龍鎮,0227,171,167,338,30,368,592,62.16%,28.89%,1
苗栗縣,後龍鎮,0228,265,367,632,32,664,1113,59.66%,23.81%,1
苗栗縣,後龍鎮,0229,286,358,644,33,677,1195,56.65%,23.93%,1
苗栗縣,後龍鎮,0230,243,333,576,42,618,997,61.99%,24.37%,1
苗栗縣,後龍鎮,0231,211,237,448,25,473,913,51.81%,23.11%,1
苗栗縣,後龍鎮,0232,145,169,314,25,339,641,52.89%,22.62%,1
苗栗縣,後龍鎮,0233,191,229,420,32,452,848,53.3%,22.52%,1
苗栗縣,後龍鎮,0234,290,359,649,52,701,1264,55.46%,22.94%,1
苗栗縣,後龍鎮,0235,226,242,468,38,506,965,52.44%,23.42%,1
苗栗縣,後龍鎮,0236,302,495,797,54,851,1216,69.98%,24.84%,1
苗栗縣,後龍鎮,0237,223,283,506,27,533,977,54.55%,22.82%,1
苗栗縣,後龍鎮,0238,203,239,442,35,477,943,50.58%,21.53%,1
苗栗縣,後龍鎮,0239,226,260,486,40,526,910,57.8%,24.84%,1
苗栗縣,後龍鎮,0240,200,246,446,28,474,851,55.7%,23.5%,1
苗栗縣,後龍鎮,0241,206,233,439,20,459,725,63.31%,28.41%,1
苗栗縣,後龍鎮,0242,148,207,355,34,389,650,59.85%,22.77%,1
苗栗縣,後龍鎮,0243,173,171,344,24,368,706,52.12%,24.5%,1
苗栗縣,後龍鎮,0244,178,222,400,37,437,748,58.42%,23.8%,1
苗栗縣,後龍鎮,0245,170,171,341,35,376,801,46.94%,21.22%,1
苗栗縣,後龍鎮,0246,260,334,594,32,626,1107,56.55%,23.49%,1
苗栗縣,後龍鎮,0247,275,331,606,44,650,1197,54.3%,22.97%,1
苗栗縣,後龍鎮,0248,192,306,498,32,530,1036,51.16%,18.53%,1
苗栗縣,後龍鎮,0249,192,216,408,28,436,913,47.75%,21.03%,1
苗栗縣,後龍鎮,0250,209,200,409,31,440,719,61.2%,29.07%,1
苗栗縣,後龍鎮,0251,260,289,549,50,599,1037,57.76%,25.07%,1
苗栗縣,後龍鎮,0252,145,150,295,14,309,601,51.41%,24.13%,1
苗栗縣,後龍鎮,0253,266,288,554,32,586,1269,46.18%,20.96%,1
苗栗縣,後龍鎮,0254,161,193,354,25,379,735,51.56%,21.9%,1
苗栗縣,後龍鎮,0255,67,71,138,13,151,422,35.78%,15.88%,1
苗栗縣,後龍鎮,0256,147,187,334,21,355,625,56.8%,23.52%,1
苗栗縣,後龍鎮,0257,245,298,543,31,574,1234,46.52%,19.85%,1
苗栗縣,卓蘭鎮,0442,233,336,569,28,597,961,62.12%,24.25%,1
苗栗縣,卓蘭鎮,0443,255,301,556,27,583,1017,57.33%,25.07%,1
苗栗縣,卓蘭鎮,0444,304,364,668,38,706,1095,64.47%,27.76%,1
苗栗縣,卓蘭鎮,0445,187,269,456,16,472,745,63.36%,25.1%,1
苗栗縣,卓蘭鎮,0446,176,249,425,9,434,783,55.43%,22.48%,1
苗栗縣,卓蘭鎮,0447,151,219,370,17,387,745,51.95%,20.27%,1
苗栗縣,卓蘭鎮,0448,244,282,526,15,541,999,54.15%,24.42%,1
苗栗縣,卓蘭鎮,0449,167,226,393,27,420,671,62.59%,24.89%,1
苗栗縣,卓蘭鎮,0450,207,253,460,33,493,734,67.17%,28.2%,1
苗栗縣,卓蘭鎮,0451,204,309,513,28,541,865,62.54%,23.58%,1
苗栗縣,卓蘭鎮,0452,230,271,501,25,526,828,63.53%,27.78%,1
苗栗縣,卓蘭鎮,0453,102,131,233,13,246,386,63.73%,26.42%,1
苗栗縣,卓蘭鎮,0454,189,225,414,30,444,688,64.53%,27.47%,1
苗栗縣,卓蘭鎮,0455,233,246,479,15,494,792,62.37%,29.42%,1
苗栗縣,卓蘭鎮,0456,171,245,416,19,435,729,59.67%,23.46%,1
苗栗縣,卓蘭鎮,0457,249,272,521,24,545,1093,49.86%,22.78%,1
苗栗縣,卓蘭鎮,0458,141,215,356,9,365,615,59.35%,22.93%,1
苗栗縣,卓蘭鎮,0459,13,37,50,0,50,86,58.14%,15.12%,1
苗栗縣,卓蘭鎮,0460,202,315,517,10,527,940,56.06%,21.49%,1
苗栗縣,大湖鄉,0420,115,265,380,28,408,744,54.84%,15.46%,1
苗栗縣,大湖鄉,0421,156,305,461,26,487,881,55.28%,17.71%,1
苗栗縣,大湖鄉,0422,108,201,309,29,338,596,56.71%,18.12%,1
苗栗縣,大湖鄉,0423,202,399,601,52,653,1260,51.83%,16.03%,1
苗栗縣,大湖鄉,0424,130,301,431,28,459,867,52.94%,14.99%,1
苗栗縣,大湖鄉,0425,138,350,488,27,515,923,55.8%,14.95%,1
苗栗縣,大湖鄉,0426,272,419,691,45,736,1395,52.76%,19.5%,1
苗栗縣,大湖鄉,0427,80,118,198,13,211,561,37.61%,14.26%,1
苗栗縣,大湖鄉,0428,133,227,360,15,375,638,58.78%,20.85%,1
苗栗縣,大湖鄉,0429,164,224,388,24,412,754,54.64%,21.75%,1
苗栗縣,大湖鄉,0430,84,160,244,7,251,501,50.1%,16.77%,1
苗栗縣,大湖鄉,0431,131,211,342,20,362,652,55.52%,20.09%,1
苗栗縣,大湖鄉,0432,158,240,398,20,418,843,49.58%,18.74%,1
苗栗縣,大湖鄉,0433,206,344,550,32,582,1020,57.06%,20.2%,1
苗栗縣,大湖鄉,0434,207,336,543,36,579,1018,56.88%,20.33%,1
苗栗縣,公館鄉,0068,202,297,499,25,524,789,66.41%,25.6%,1
苗栗縣,公館鄉,0069,196,304,500,25,525,792,66.29%,24.75%,1
苗栗縣,公館鄉,0070,235,437,672,49,721,1117,64.55%,21.04%,1
苗栗縣,公館鄉,0071,278,481,759,29,788,1255,62.79%,22.15%,1
苗栗縣,公館鄉,0072,251,402,653,30,683,1141,59.86%,22%,1
苗栗縣,公館鄉,0073,261,387,648,39,687,1172,58.62%,22.27%,1
苗栗縣,公館鄉,0074,268,399,667,30,697,1100,63.36%,24.36%,1
苗栗縣,公館鄉,0075,212,404,616,37,653,1232,53%,17.21%,1
苗栗縣,公館鄉,0076,216,243,459,35,494,1081,45.7%,19.98%,1
苗栗縣,公館鄉,0077,256,490,746,33,779,1250,62.32%,20.48%,1
苗栗縣,公館鄉,0078,221,371,592,39,631,1081,58.37%,20.44%,1
苗栗縣,公館鄉,0079,202,308,510,45,555,964,57.57%,20.95%,1
苗栗縣,公館鄉,0080,209,371,580,50,630,1038,60.69%,20.13%,1
苗栗縣,公館鄉,0081,94,117,211,17,228,360,63.33%,26.11%,1
苗栗縣,公館鄉,0082,164,298,462,35,497,865,57.46%,18.96%,1
苗栗縣,公館鄉,0083,243,375,618,35,653,1166,56%,20.84%,1
苗栗縣,公館鄉,0084,145,260,405,27,432,719,60.08%,20.17%,1
苗栗縣,公館鄉,0085,157,247,404,34,438,788,55.58%,19.92%,1
苗栗縣,公館鄉,0086,58,122,180,23,203,303,67%,19.14%,1
苗栗縣,公館鄉,0087,297,463,760,36,796,1322,60.21%,22.47%,1
苗栗縣,公館鄉,0088,198,302,500,34,534,933,57.23%,21.22%,1
苗栗縣,公館鄉,0089,274,463,737,53,790,1455,54.3%,18.83%,1
苗栗縣,公館鄉,0090,349,599,948,54,1002,1615,62.04%,21.61%,1
苗栗縣,公館鄉,0091,266,494,760,47,807,1451,55.62%,18.33%,1
苗栗縣,公館鄉,0092,276,543,819,63,882,1462,60.33%,18.88%,1
苗栗縣,公館鄉,0093,231,450,681,56,737,1317,55.96%,17.54%,1
苗栗縣,公館鄉,0094,45,83,128,3,131,221,59.28%,20.36%,1
苗栗縣,公館鄉,0095,57,107,164,11,175,329,53.19%,17.33%,1
苗栗縣,銅鑼鄉,0108,156,365,521,27,548,887,61.78%,17.59%,1
苗栗縣,銅鑼鄉,0109,187,420,607,25,632,1052,60.08%,17.78%,1
苗栗縣,銅鑼鄉,0110,240,559,799,29,828,1347,61.47%,17.82%,1
苗栗縣,銅鑼鄉,0111,337,307,644,30,674,1177,57.26%,28.63%,1
苗栗縣,銅鑼鄉,0112,248,403,651,37,688,1268,54.26%,19.56%,1
苗栗縣,銅鑼鄉,0113,185,354,539,48,587,1185,49.54%,15.61%,1
苗栗縣,銅鑼鄉,0114,143,419,562,35,597,1029,58.02%,13.9%,1
苗栗縣,銅鑼鄉,0115,150,350,500,25,525,905,58.01%,16.57%,1
苗栗縣,銅鑼鄉,0116,160,279,439,28,467,750,62.27%,21.33%,1
苗栗縣,銅鑼鄉,0117,172,351,523,30,553,1080,51.2%,15.93%,1
苗栗縣,銅鑼鄉,0118,251,323,574,33,607,1108,54.78%,22.65%,1
苗栗縣,銅鑼鄉,0119,185,246,431,26,457,862,53.02%,21.46%,1
苗栗縣,銅鑼鄉,0120,224,381,605,41,646,1216,53.13%,18.42%,1
苗栗縣,銅鑼鄉,0121,100,182,282,22,304,588,51.7%,17.01%,1
苗栗縣,銅鑼鄉,0122,81,132,213,22,235,429,54.78%,18.88%,1
苗栗縣,銅鑼鄉,0123,100,208,308,9,317,541,58.6%,18.48%,1
苗栗縣,南庄鄉,0411,217,369,586,55,641,1155,55.5%,18.79%,1
苗栗縣,南庄鄉,0412,117,220,337,39,376,650,57.85%,18%,1
苗栗縣,南庄鄉,0413,250,397,647,53,700,1353,51.74%,18.48%,1
苗栗縣,南庄鄉,0414,126,204,330,25,355,813,43.67%,15.5%,1
苗栗縣,南庄鄉,0415,137,198,335,29,364,837,43.49%,16.37%,1
苗栗縣,南庄鄉,0416,157,371,528,45,573,1093,52.42%,14.36%,1
苗栗縣,南庄鄉,0417,231,313,544,29,573,1048,54.68%,22.04%,1
苗栗縣,南庄鄉,0418,169,257,426,22,448,872,51.38%,19.38%,1
苗栗縣,南庄鄉,0419,103,210,313,8,321,963,33.33%,10.7%,1
苗栗縣,頭屋鄉,0096,549,302,851,43,894,1335,66.97%,41.12%,1
苗栗縣,頭屋鄉,0097,273,525,798,32,830,1168,71.06%,23.37%,1
苗栗縣,頭屋鄉,0098,166,329,495,25,520,792,65.66%,20.96%,1
苗栗縣,頭屋鄉,0099,222,400,622,36,658,918,71.68%,24.18%,1
苗栗縣,頭屋鄉,0100,129,312,441,21,462,725,63.72%,17.79%,1
苗栗縣,頭屋鄉,0101,182,343,525,32,557,899,61.96%,20.24%,1
苗栗縣,頭屋鄉,0102,50,127,177,9,186,369,50.41%,13.55%,1
苗栗縣,頭屋鄉,0103,208,280,488,17,505,844,59.83%,24.64%,1
苗栗縣,頭屋鄉,0104,217,381,598,22,620,1007,61.57%,21.55%,1
苗栗縣,頭屋鄉,0105,150,328,478,23,501,794,63.1%,18.89%,1
苗栗縣,頭屋鄉,0106,54,89,143,14,157,211,74.41%,25.59%,1
苗栗縣,頭屋鄉,0107,84,141,225,14,239,328,72.87%,25.61%,1
苗栗縣,三義鄉,0124,165,329,494,30,524,853,61.43%,19.34%,1
苗栗縣,三義鄉,0125,179,416,595,21,616,983,62.67%,18.21%,1
苗栗縣,三義鄉,0126,199,408,607,41,648,1080,60%,18.43%,1
苗栗縣,三義鄉,0127,201,439,640,17,657,1216,54.03%,16.53%,1
苗栗縣,三義鄉,0128,181,395,576,28,604,1017,59.39%,17.8%,1
苗栗縣,三義鄉,0129,200,415,615,17,632,1180,53.56%,16.95%,1
苗栗縣,三義鄉,0130,227,438,665,19,684,1198,57.1%,18.95%,1
苗栗縣,三義鄉,0131,83,146,229,14,243,417,58.27%,19.9%,1
苗栗縣,三義鄉,0132,179,332,511,16,527,991,53.18%,18.06%,1
苗栗縣,三義鄉,0133,146,334,480,11,491,834,58.87%,17.51%,1
苗栗縣,三義鄉,0134,110,232,342,28,370,622,59.49%,17.68%,1
苗栗縣,三義鄉,0135,163,267,430,30,460,749,61.42%,21.76%,1
苗栗縣,三義鄉,0136,139,302,441,19,460,692,66.47%,20.09%,1
苗栗縣,三義鄉,0137,193,320,513,23,536,759,70.62%,25.43%,1
苗栗縣,三義鄉,0138,130,183,313,23,336,629,53.42%,20.67%,1
苗栗縣,三義鄉,0139,158,212,370,17,387,669,57.85%,23.62%,1
苗栗縣,西湖鄉,0140,94,216,310,24,334,601,55.57%,15.64%,1
苗栗縣,西湖鄉,0141,107,218,325,16,341,566,60.25%,18.9%,1
苗栗縣,西湖鄉,0142,163,293,456,37,493,843,58.48%,19.34%,1
苗栗縣,西湖鄉,0143,125,198,323,23,346,648,53.4%,19.29%,1
苗栗縣,西湖鄉,0144,174,288,462,15,477,936,50.96%,18.59%,1
苗栗縣,西湖鄉,0145,94,148,242,8,250,461,54.23%,20.39%,1
苗栗縣,西湖鄉,0146,105,181,286,10,296,515,57.48%,20.39%,1
苗栗縣,西湖鄉,0147,202,361,563,53,616,1141,53.99%,17.7%,1
苗栗縣,西湖鄉,0148,149,218,367,32,399,671,59.46%,22.21%,1
苗栗縣,造橋鄉,0258,257,452,709,60,769,1171,65.67%,21.95%,1
苗栗縣,造橋鄉,0259,156,341,497,32,529,889,59.51%,17.55%,1
苗栗縣,造橋鄉,0260,67,150,217,20,237,479,49.48%,13.99%,1
苗栗縣,造橋鄉,0261,207,366,573,29,602,1024,58.79%,20.21%,1
苗栗縣,造橋鄉,0262,248,353,601,55,656,1214,54.04%,20.43%,1
苗栗縣,造橋鄉,0263,185,349,534,28,562,1071,52.47%,17.27%,1
苗栗縣,造橋鄉,0264,211,340,551,58,609,1157,52.64%,18.24%,1
苗栗縣,造橋鄉,0265,103,177,280,17,297,512,58.01%,20.12%,1
苗栗縣,造橋鄉,0266,103,193,296,14,310,491,63.14%,20.98%,1
苗栗縣,造橋鄉,0267,296,429,725,42,767,1272,60.3%,23.27%,1
苗栗縣,造橋鄉,0268,175,245,420,34,454,785,57.83%,22.29%,1
苗栗縣,造橋鄉,0269,273,284,557,78,635,962,66.01%,28.38%,1
苗栗縣,三灣鄉,0402,181,386,567,30,597,996,59.94%,18.17%,1
苗栗縣,三灣鄉,0403,271,382,653,41,694,1205,57.59%,22.49%,1
苗栗縣,三灣鄉,0404,117,240,357,30,387,635,60.94%,18.43%,1
苗栗縣,三灣鄉,0405,138,327,465,32,497,862,57.66%,16.01%,1
苗栗縣,三灣鄉,0406,46,61,107,11,118,238,49.58%,19.33%,1
苗栗縣,三灣鄉,0407,115,157,272,24,296,541,54.71%,21.26%,1
苗栗縣,三灣鄉,0408,104,176,280,23,303,578,52.42%,17.99%,1
苗栗縣,三灣鄉,0409,96,164,260,19,279,405,68.89%,23.7%,1
苗栗縣,三灣鄉,0410,79,133,212,10,222,392,56.63%,20.15%,1
苗栗縣,獅潭鄉,0435,34,92,126,6,132,328,40.24%,10.37%,1
苗栗縣,獅潭鄉,0436,81,149,230,22,252,565,44.6%,14.34%,1
苗栗縣,獅潭鄉,0437,177,306,483,39,522,911,57.3%,19.43%,1
苗栗縣,獅潭鄉,0438,108,147,255,18,273,568,48.06%,19.01%,1
苗栗縣,獅潭鄉,0439,106,212,318,25,343,580,59.14%,18.28%,1
苗栗縣,獅潭鄉,0440,58,105,163,10,173,333,51.95%,17.42%,1
苗栗縣,獅潭鄉,0441,111,229,340,18,358,683,52.42%,16.25%,1
苗栗縣,泰安鄉,0461,44,104,148,11,159,325,48.92%,13.54%,1
苗栗縣,泰安鄉,0462,99,175,274,15,289,484,59.71%,20.45%,1
苗栗縣,泰安鄉,0463,160,295,455,32,487,666,73.12%,24.02%,1
苗栗縣,泰安鄉,0464,115,241,356,34,390,574,67.94%,20.03%,1
苗栗縣,泰安鄉,0465,50,120,170,6,176,333,52.85%,15.02%,1
苗栗縣,泰安鄉,0466,77,257,334,11,345,495,69.7%,15.56%,1
苗栗縣,泰安鄉,0467,175,186,361,34,395,544,72.61%,32.17%,1
苗栗縣,泰安鄉,0468,89,152,241,17,258,500,51.6%,17.8%,1
苗栗縣,泰安鄉,0469,159,284,443,37,480,670,71.64%,23.73%,1
苗栗縣,泰安鄉,0470,110,344,454,5,459,589,77.93%,18.68%,1
彰化縣,彰化市,0001,230,279,509,34,543,871,62.34%,26.41%,1
彰化縣,彰化市,0002,150,184,334,34,368,751,49%,19.97%,1
彰化縣,彰化市,0003,249,331,580,32,612,923,66.31%,26.98%,1
彰化縣,彰化市,0004,235,223,458,27,485,779,62.26%,30.17%,1
彰化縣,彰化市,0005,204,256,460,22,482,779,61.87%,26.19%,1
彰化縣,彰化市,0006,194,217,411,23,434,720,60.28%,26.94%,1
彰化縣,彰化市,0007,204,229,433,21,454,749,60.61%,27.24%,1
彰化縣,彰化市,0008,182,284,466,35,501,767,65.32%,23.73%,1
彰化縣,彰化市,0009,298,341,639,20,659,1047,62.94%,28.46%,1
彰化縣,彰化市,0010,277,301,578,21,599,1027,58.33%,26.97%,1
彰化縣,彰化市,0011,315,375,690,32,722,1249,57.81%,25.22%,1
彰化縣,彰化市,0012,271,372,643,38,681,1136,59.95%,23.86%,1
彰化縣,彰化市,0013,283,419,702,31,733,1169,62.7%,24.21%,1
彰化縣,彰化市,0014,230,240,470,16,486,766,63.45%,30.03%,1
彰化縣,彰化市,0015,168,207,375,11,386,643,60.03%,26.13%,1
彰化縣,彰化市,0016,246,456,702,47,749,1251,59.87%,19.66%,1
彰化縣,彰化市,0017,219,269,488,22,510,1301,39.2%,16.83%,1
彰化縣,彰化市,0018,330,415,745,24,769,1280,60.08%,25.78%,1
彰化縣,彰化市,0019,305,391,696,31,727,1179,61.66%,25.87%,1
彰化縣,彰化市,0020,273,389,662,31,693,1168,59.33%,23.37%,1
彰化縣,彰化市,0021,364,328,692,26,718,1218,58.95%,29.89%,1
彰化縣,彰化市,0022,359,509,868,18,886,1351,65.58%,26.57%,1
彰化縣,彰化市,0023,362,343,705,26,731,1204,60.71%,30.07%,1
彰化縣,彰化市,0024,301,406,707,17,724,1189,60.89%,25.32%,1
彰化縣,彰化市,0025,279,393,672,27,699,1207,57.91%,23.12%,1
彰化縣,彰化市,0026,284,387,671,31,702,1161,60.47%,24.46%,1
彰化縣,彰化市,0027,333,318,651,15,666,1166,57.12%,28.56%,1
彰化縣,彰化市,0028,297,498,795,43,838,1362,61.53%,21.81%,1
彰化縣,彰化市,0029,347,388,735,31,766,1236,61.97%,28.07%,1
彰化縣,彰化市,0030,283,334,617,27,644,1065,60.47%,26.57%,1
彰化縣,彰化市,0031,319,379,698,30,728,1199,60.72%,26.61%,1
彰化縣,彰化市,0032,328,392,720,26,746,1233,60.5%,26.6%,1
彰化縣,彰化市,0033,304,403,707,17,724,1245,58.15%,24.42%,1
彰化縣,彰化市,0034,317,368,685,23,708,1153,61.41%,27.49%,1
彰化縣,彰化市,0035,245,327,572,21,593,1045,56.75%,23.44%,1
彰化縣,彰化市,0036,277,352,629,15,644,1097,58.71%,25.25%,1
彰化縣,彰化市,0037,312,360,672,27,699,1190,58.74%,26.22%,1
彰化縣,彰化市,0038,309,363,672,22,694,1106,62.75%,27.94%,1
彰化縣,彰化市,0039,292,353,645,19,664,1097,60.53%,26.62%,1
彰化縣,彰化市,0040,319,298,617,31,648,1048,61.83%,30.44%,1
彰化縣,彰化市,0041,290,299,589,28,617,980,62.96%,29.59%,1
彰化縣,彰化市,0042,212,220,432,19,451,707,63.79%,29.99%,1
彰化縣,彰化市,0043,232,233,465,28,493,809,60.94%,28.68%,1
彰化縣,彰化市,0044,292,307,599,38,637,1008,63.19%,28.97%,1
彰化縣,彰化市,0045,229,255,484,34,518,901,57.49%,25.42%,1
彰化縣,彰化市,0046,232,297,529,24,553,951,58.15%,24.4%,1
彰化縣,彰化市,0047,276,344,620,31,651,1076,60.5%,25.65%,1
彰化縣,彰化市,0048,282,287,569,20,589,1022,57.63%,27.59%,1
彰化縣,彰化市,0049,253,258,511,37,548,894,61.3%,28.3%,1
彰化縣,彰化市,0050,291,323,614,23,637,1016,62.7%,28.64%,1
彰化縣,彰化市,0051,254,230,484,20,504,771,65.37%,32.94%,1
彰化縣,彰化市,0052,270,233,503,39,542,868,62.44%,31.11%,1
彰化縣,彰化市,0053,322,328,650,38,688,1135,60.62%,28.37%,1
彰化縣,彰化市,0054,303,240,543,35,578,910,63.52%,33.3%,1
彰化縣,彰化市,0055,343,283,626,20,646,1004,64.34%,34.16%,1
彰化縣,彰化市,0056,314,333,647,31,678,1077,62.95%,29.16%,1
彰化縣,彰化市,0057,334,464,798,29,827,1258,65.74%,26.55%,1
彰化縣,彰化市,0058,483,155,638,22,660,1025,64.39%,47.12%,1
彰化縣,彰化市,0059,301,412,713,35,748,1177,63.55%,25.57%,1
彰化縣,彰化市,0060,280,399,679,44,723,1262,57.29%,22.19%,1
彰化縣,彰化市,0061,293,440,733,42,775,1209,64.1%,24.23%,1
彰化縣,彰化市,0062,290,339,629,30,659,1041,63.3%,27.86%,1
彰化縣,彰化市,0063,355,289,644,34,678,1075,63.07%,33.02%,1
彰化縣,彰化市,0064,213,357,570,25,595,1029,57.82%,20.7%,1
彰化縣,彰化市,0065,307,356,663,49,712,1203,59.19%,25.52%,1
彰化縣,彰化市,0066,242,316,558,33,591,1014,58.28%,23.87%,1
彰化縣,彰化市,0067,272,347,619,28,647,1069,60.52%,25.44%,1
彰化縣,彰化市,0068,233,263,496,25,521,969,53.77%,24.05%,1
彰化縣,彰化市,0069,248,320,568,25,593,1105,53.67%,22.44%,1
彰化縣,彰化市,0070,237,366,603,31,634,981,64.63%,24.16%,1
彰化縣,彰化市,0071,302,353,655,40,695,1095,63.47%,27.58%,1
彰化縣,彰化市,0072,274,384,658,18,676,1087,62.19%,25.21%,1
彰化縣,彰化市,0073,282,279,561,85,646,1050,61.52%,26.86%,1
彰化縣,彰化市,0074,323,400,723,33,756,1252,60.38%,25.8%,1
彰化縣,彰化市,0075,296,317,613,24,637,1113,57.23%,26.59%,1
彰化縣,彰化市,0076,267,345,612,21,633,1009,62.74%,26.46%,1
彰化縣,彰化市,0077,233,319,552,29,581,999,58.16%,23.32%,1
彰化縣,彰化市,0078,246,336,582,13,595,997,59.68%,24.67%,1
彰化縣,彰化市,0079,272,443,715,31,746,1145,65.15%,23.76%,1
彰化縣,彰化市,0080,313,408,721,17,738,1227,60.15%,25.51%,1
彰化縣,彰化市,0081,309,422,731,27,758,1208,62.75%,25.58%,1
彰化縣,彰化市,0082,247,651,898,32,930,1598,58.2%,15.46%,1
彰化縣,彰化市,0083,235,289,524,28,552,890,62.02%,26.4%,1
彰化縣,彰化市,0084,309,384,693,21,714,1104,64.67%,27.99%,1
彰化縣,彰化市,0085,279,326,605,26,631,1097,57.52%,25.43%,1
彰化縣,彰化市,0086,215,235,450,27,477,799,59.7%,26.91%,1
彰化縣,彰化市,0087,236,353,589,34,623,1000,62.3%,23.6%,1
彰化縣,彰化市,0088,293,345,638,45,683,1153,59.24%,25.41%,1
彰化縣,彰化市,0089,256,303,559,44,603,977,61.72%,26.2%,1
彰化縣,彰化市,0090,338,334,672,33,705,1201,58.7%,28.14%,1
彰化縣,彰化市,0091,328,311,639,37,676,1057,63.95%,31.03%,1
彰化縣,彰化市,0092,317,377,694,39,733,1238,59.21%,25.61%,1
彰化縣,彰化市,0093,306,416,722,25,747,1210,61.74%,25.29%,1
彰化縣,彰化市,0094,249,350,599,39,638,1026,62.18%,24.27%,1
彰化縣,彰化市,0095,282,375,657,36,693,1061,65.32%,26.58%,1
彰化縣,彰化市,0096,327,366,693,34,727,1213,59.93%,26.96%,1
彰化縣,彰化市,0097,312,426,738,31,769,1264,60.84%,24.68%,1
彰化縣,彰化市,0098,249,183,432,34,466,691,67.44%,36.03%,1
彰化縣,彰化市,0099,280,265,545,35,580,893,64.95%,31.35%,1
彰化縣,彰化市,0100,216,222,438,21,459,733,62.62%,29.47%,1
彰化縣,彰化市,0101,219,203,422,28,450,692,65.03%,31.65%,1
彰化縣,彰化市,0102,202,212,414,20,434,728,59.62%,27.75%,1
彰化縣,彰化市,0103,209,269,478,26,504,773,65.2%,27.04%,1
彰化縣,彰化市,0104,223,296,519,18,537,975,55.08%,22.87%,1
彰化縣,彰化市,0105,242,294,536,25,561,908,61.78%,26.65%,1
彰化縣,彰化市,0106,339,351,690,7,697,1156,60.29%,29.33%,1
彰化縣,彰化市,0107,336,385,721,37,758,1235,61.38%,27.21%,1
彰化縣,彰化市,0108,311,432,743,37,780,1376,56.69%,22.6%,1
彰化縣,彰化市,0109,315,457,772,12,784,1389,56.44%,22.68%,1
彰化縣,彰化市,0110,245,289,534,28,562,846,66.43%,28.96%,1
彰化縣,彰化市,0111,237,301,538,25,563,859,65.54%,27.59%,1
彰化縣,彰化市,0112,207,261,468,17,485,781,62.1%,26.5%,1
彰化縣,彰化市,0113,241,257,498,26,524,875,59.89%,27.54%,1
彰化縣,彰化市,0114,240,232,472,18,490,816,60.05%,29.41%,1
彰化縣,彰化市,0115,217,199,416,26,442,687,64.34%,31.59%,1
彰化縣,彰化市,0116,206,242,448,29,477,727,65.61%,28.34%,1
彰化縣,彰化市,0117,184,232,416,14,430,662,64.95%,27.79%,1
彰化縣,彰化市,0118,180,211,391,21,412,633,65.09%,28.44%,1
彰化縣,彰化市,0119,264,308,572,18,590,906,65.12%,29.14%,1
彰化縣,彰化市,0120,224,249,473,28,501,853,58.73%,26.26%,1
彰化縣,彰化市,0121,273,336,609,36,645,1027,62.8%,26.58%,1
彰化縣,彰化市,0122,233,374,607,33,640,993,64.45%,23.46%,1
彰化縣,彰化市,0123,242,252,494,32,526,848,62.03%,28.54%,1
彰化縣,彰化市,0124,297,396,693,17,710,1118,63.51%,26.57%,1
彰化縣,彰化市,0125,304,425,729,46,775,1263,61.36%,24.07%,1
彰化縣,彰化市,0126,349,424,773,33,806,1268,63.56%,27.52%,1
彰化縣,彰化市,0127,345,388,733,37,770,1258,61.21%,27.42%,1
彰化縣,彰化市,0128,328,414,742,20,762,1212,62.87%,27.06%,1
彰化縣,彰化市,0129,236,300,536,39,575,924,62.23%,25.54%,1
彰化縣,彰化市,0130,267,306,573,29,602,939,64.11%,28.43%,1
彰化縣,彰化市,0131,302,308,610,37,647,953,67.89%,31.69%,1
彰化縣,彰化市,0132,249,375,624,25,649,981,66.16%,25.38%,1
彰化縣,彰化市,0133,291,453,744,52,796,1249,63.73%,23.3%,1
彰化縣,彰化市,0134,235,246,481,36,517,817,63.28%,28.76%,1
彰化縣,彰化市,0135,229,263,492,42,534,872,61.24%,26.26%,1
彰化縣,彰化市,0136,160,232,392,15,407,689,59.07%,23.22%,1
彰化縣,彰化市,0137,279,426,705,31,736,1156,63.67%,24.13%,1
彰化縣,彰化市,0138,288,436,724,21,745,1291,57.71%,22.31%,1
彰化縣,彰化市,0139,253,400,653,23,676,1139,59.35%,22.21%,1
彰化縣,彰化市,0140,251,409,660,41,701,1125,62.31%,22.31%,1
彰化縣,彰化市,0141,235,449,684,40,724,1258,57.55%,18.68%,1
彰化縣,彰化市,0142,282,362,644,24,668,1123,59.48%,25.11%,1
彰化縣,彰化市,0143,279,391,670,32,702,1175,59.74%,23.74%,1
彰化縣,彰化市,0144,258,291,549,24,573,862,66.47%,29.93%,1
彰化縣,彰化市,0145,244,266,510,18,528,872,60.55%,27.98%,1
彰化縣,彰化市,0146,224,340,564,17,581,897,64.77%,24.97%,1
彰化縣,彰化市,0147,236,308,544,25,569,1003,56.73%,23.53%,1
彰化縣,彰化市,0148,228,284,512,20,532,915,58.14%,24.92%,1
彰化縣,彰化市,0149,276,358,634,34,668,1158,57.69%,23.83%,1
彰化縣,彰化市,0150,285,364,649,38,687,1084,63.38%,26.29%,1
彰化縣,彰化市,0151,351,393,744,38,782,1372,57%,25.58%,1
彰化縣,彰化市,0152,297,358,655,25,680,1113,61.1%,26.68%,1
彰化縣,彰化市,0153,205,274,479,27,506,800,63.25%,25.63%,1
彰化縣,彰化市,0154,251,258,509,34,543,885,61.36%,28.36%,1
彰化縣,彰化市,0155,275,342,617,22,639,1000,63.9%,27.5%,1
彰化縣,彰化市,0156,312,329,641,26,667,1159,57.55%,26.92%,1
彰化縣,彰化市,0157,286,334,620,26,646,1123,57.52%,25.47%,1
彰化縣,彰化市,0158,271,279,550,43,593,907,65.38%,29.88%,1
彰化縣,彰化市,0159,220,312,532,41,573,989,57.94%,22.24%,1
彰化縣,彰化市,0160,273,325,598,42,640,1012,63.24%,26.98%,1
彰化縣,彰化市,0161,214,346,560,10,570,1033,55.18%,20.72%,1
彰化縣,彰化市,0162,269,287,556,27,583,1116,52.24%,24.1%,1
彰化縣,彰化市,0163,231,456,687,29,716,1154,62.05%,20.02%,1
彰化縣,彰化市,0164,259,375,634,29,663,1064,62.31%,24.34%,1
彰化縣,彰化市,0165,222,244,466,37,503,770,65.32%,28.83%,1
彰化縣,彰化市,0166,260,270,530,27,557,889,62.65%,29.25%,1
彰化縣,彰化市,0167,207,259,466,37,503,786,63.99%,26.34%,1
彰化縣,彰化市,0168,267,320,587,31,618,1120,55.18%,23.84%,1
彰化縣,彰化市,0169,289,375,664,27,691,1269,54.45%,22.77%,1
彰化縣,彰化市,0170,322,361,683,31,714,1159,61.6%,27.78%,1
彰化縣,彰化市,0171,336,347,683,43,726,1184,61.32%,28.38%,1
彰化縣,彰化市,0172,286,325,611,25,636,1089,58.4%,26.26%,1
彰化縣,彰化市,0173,262,312,574,31,605,968,62.5%,27.07%,1
彰化縣,彰化市,0174,239,295,534,15,549,930,59.03%,25.7%,1
彰化縣,彰化市,0175,255,337,592,16,608,973,62.49%,26.21%,1
彰化縣,彰化市,0176,265,340,605,18,623,1184,52.62%,22.38%,1
彰化縣,彰化市,0177,265,309,574,43,617,1002,61.58%,26.45%,1
彰化縣,彰化市,0178,264,362,626,28,654,1148,56.97%,23%,1
彰化縣,彰化市,0179,281,333,614,32,646,1112,58.09%,25.27%,1
彰化縣,彰化市,0180,243,363,606,24,630,907,69.46%,26.79%,1
彰化縣,彰化市,0181,286,357,643,40,683,1112,61.42%,25.72%,1
彰化縣,彰化市,0182,238,203,441,23,464,823,56.38%,28.92%,1
彰化縣,彰化市,0183,353,364,717,48,765,1276,59.95%,27.66%,1
彰化縣,彰化市,0184,281,361,642,27,669,1161,57.62%,24.2%,1
彰化縣,鹿港鎮,0243,380,311,691,37,728,1140,63.86%,33.33%,1
彰化縣,鹿港鎮,0244,154,136,290,19,309,511,60.47%,30.14%,1
彰化縣,鹿港鎮,0245,217,208,425,23,448,857,52.28%,25.32%,1
彰化縣,鹿港鎮,0246,273,296,569,42,611,946,64.59%,28.86%,1
彰化縣,鹿港鎮,0247,306,239,545,23,568,945,60.11%,32.38%,1
彰化縣,鹿港鎮,0248,326,309,635,26,661,1097,60.26%,29.72%,1
彰化縣,鹿港鎮,0249,350,375,725,27,752,1479,50.85%,23.66%,1
彰化縣,鹿港鎮,0250,399,395,794,61,855,1425,60%,28%,1
彰化縣,鹿港鎮,0251,298,226,524,38,562,880,63.86%,33.86%,1
彰化縣,鹿港鎮,0252,345,297,642,30,672,1183,56.8%,29.16%,1
彰化縣,鹿港鎮,0253,346,275,621,41,662,1047,63.23%,33.05%,1
彰化縣,鹿港鎮,0254,337,264,601,19,620,1097,56.52%,30.72%,1
彰化縣,鹿港鎮,0255,274,286,560,36,596,1030,57.86%,26.6%,1
彰化縣,鹿港鎮,0256,312,347,659,22,681,1161,58.66%,26.87%,1
彰化縣,鹿港鎮,0257,151,156,307,35,342,540,63.33%,27.96%,1
彰化縣,鹿港鎮,0258,302,319,621,26,647,1135,57%,26.61%,1
彰化縣,鹿港鎮,0259,287,347,634,41,675,1155,58.44%,24.85%,1
彰化縣,鹿港鎮,0260,316,357,673,28,701,1127,62.2%,28.04%,1
彰化縣,鹿港鎮,0261,310,276,586,41,627,1045,60%,29.67%,1
彰化縣,鹿港鎮,0262,310,332,642,28,670,1127,59.45%,27.51%,1
彰化縣,鹿港鎮,0263,350,375,725,37,762,1178,64.69%,29.71%,1
彰化縣,鹿港鎮,0264,85,78,163,6,169,284,59.51%,29.93%,1
彰化縣,鹿港鎮,0265,176,158,334,16,350,584,59.93%,30.14%,1
彰化縣,鹿港鎮,0266,322,102,424,15,439,659,66.62%,48.86%,1
彰化縣,鹿港鎮,0267,324,231,555,13,568,915,62.08%,35.41%,1
彰化縣,鹿港鎮,0268,352,298,650,41,691,1079,64.04%,32.62%,1
彰化縣,鹿港鎮,0269,338,353,691,43,734,1129,65.01%,29.94%,1
彰化縣,鹿港鎮,0270,280,387,667,44,711,1273,55.85%,22%,1
彰化縣,鹿港鎮,0271,168,183,351,32,383,706,54.25%,23.8%,1
彰化縣,鹿港鎮,0272,296,277,573,59,632,1137,55.58%,26.03%,1
彰化縣,鹿港鎮,0273,306,317,623,40,663,1195,55.48%,25.61%,1
彰化縣,鹿港鎮,0274,311,317,628,38,666,1225,54.37%,25.39%,1
彰化縣,鹿港鎮,0275,261,323,584,46,630,957,65.83%,27.27%,1
彰化縣,鹿港鎮,0276,181,198,379,29,408,758,53.83%,23.88%,1
彰化縣,鹿港鎮,0277,235,184,419,30,449,723,62.1%,32.5%,1
彰化縣,鹿港鎮,0278,218,318,536,20,556,984,56.5%,22.15%,1
彰化縣,鹿港鎮,0279,253,365,618,35,653,1018,64.15%,24.85%,1
彰化縣,鹿港鎮,0280,294,321,615,31,646,1165,55.45%,25.24%,1
彰化縣,鹿港鎮,0281,257,326,583,35,618,1161,53.23%,22.14%,1
彰化縣,鹿港鎮,0282,234,298,532,32,564,1020,55.29%,22.94%,1
彰化縣,鹿港鎮,0283,275,295,570,46,616,1068,57.68%,25.75%,1
彰化縣,鹿港鎮,0284,285,313,598,39,637,1024,62.21%,27.83%,1
彰化縣,鹿港鎮,0285,256,315,571,41,612,974,62.83%,26.28%,1
彰化縣,鹿港鎮,0286,322,421,743,74,817,1505,54.29%,21.4%,1
彰化縣,鹿港鎮,0287,233,338,571,36,607,1092,55.59%,21.34%,1
彰化縣,鹿港鎮,0288,275,414,689,53,742,1223,60.67%,22.49%,1
彰化縣,鹿港鎮,0289,288,460,748,34,782,1572,49.75%,18.32%,1
彰化縣,鹿港鎮,0290,237,336,573,46,619,1003,61.71%,23.63%,1
彰化縣,鹿港鎮,0291,221,317,538,21,559,933,59.91%,23.69%,1
彰化縣,鹿港鎮,0292,320,328,648,15,663,1093,60.66%,29.28%,1
彰化縣,鹿港鎮,0293,215,286,501,16,517,907,57%,23.7%,1
彰化縣,鹿港鎮,0294,261,374,635,34,669,1219,54.88%,21.41%,1
彰化縣,鹿港鎮,0295,346,498,844,45,889,1397,63.64%,24.77%,1
彰化縣,鹿港鎮,0296,240,432,672,35,707,1229,57.53%,19.53%,1
彰化縣,鹿港鎮,0297,339,446,785,20,805,1444,55.75%,23.48%,1
彰化縣,鹿港鎮,0298,296,396,692,41,733,1227,59.74%,24.12%,1
彰化縣,鹿港鎮,0299,324,363,687,29,716,1187,60.32%,27.3%,1
彰化縣,鹿港鎮,0300,372,336,708,26,734,1296,56.64%,28.7%,1
彰化縣,鹿港鎮,0301,343,378,721,38,759,1451,52.31%,23.64%,1
彰化縣,鹿港鎮,0302,362,278,640,50,690,1299,53.12%,27.87%,1
彰化縣,鹿港鎮,0303,364,402,766,41,807,1298,62.17%,28.04%,1
彰化縣,鹿港鎮,0304,374,433,807,41,848,1458,58.16%,25.65%,1
彰化縣,鹿港鎮,0305,339,325,664,33,697,1138,61.25%,29.79%,1
彰化縣,鹿港鎮,0306,314,323,637,41,678,1170,57.95%,26.84%,1
彰化縣,鹿港鎮,0307,327,384,711,35,746,1221,61.1%,26.78%,1
彰化縣,和美鎮,0373,335,371,706,38,744,1341,55.48%,24.98%,1
彰化縣,和美鎮,0374,332,403,735,39,774,1480,52.3%,22.43%,1
彰化縣,和美鎮,0375,350,500,850,28,878,1529,57.42%,22.89%,1
彰化縣,和美鎮,0376,351,492,843,27,870,1711,50.85%,20.51%,1
彰化縣,和美鎮,0377,271,320,591,26,617,1057,58.37%,25.64%,1
彰化縣,和美鎮,0378,281,318,599,20,619,1032,59.98%,27.23%,1
彰化縣,和美鎮,0379,251,325,576,33,609,1015,60%,24.73%,1
彰化縣,和美鎮,0380,211,490,701,35,736,1209,60.88%,17.45%,1
彰化縣,和美鎮,0381,107,129,236,15,251,430,58.37%,24.88%,1
彰化縣,和美鎮,0382,218,245,463,19,482,856,56.31%,25.47%,1
彰化縣,和美鎮,0383,219,342,561,25,586,966,60.66%,22.67%,1
彰化縣,和美鎮,0384,257,324,581,14,595,1059,56.19%,24.27%,1
彰化縣,和美鎮,0385,280,334,614,27,641,1117,57.39%,25.07%,1
彰化縣,和美鎮,0386,251,325,576,31,607,1066,56.94%,23.55%,1
彰化縣,和美鎮,0387,285,367,652,28,680,1252,54.31%,22.76%,1
彰化縣,和美鎮,0388,312,453,765,42,807,1528,52.81%,20.42%,1
彰化縣,和美鎮,0389,228,237,465,31,496,826,60.05%,27.6%,1
彰化縣,和美鎮,0390,198,259,457,30,487,854,57.03%,23.19%,1
彰化縣,和美鎮,0391,299,416,715,34,749,1387,54%,21.56%,1
彰化縣,和美鎮,0392,188,270,458,23,481,765,62.88%,24.58%,1
彰化縣,和美鎮,0393,292,419,711,43,754,1438,52.43%,20.31%,1
彰化縣,和美鎮,0394,322,466,788,49,837,1396,59.96%,23.07%,1
彰化縣,和美鎮,0395,156,218,374,14,388,658,58.97%,23.71%,1
彰化縣,和美鎮,0396,199,289,488,28,516,809,63.78%,24.6%,1
彰化縣,和美鎮,0397,213,270,483,15,498,932,53.43%,22.85%,1
彰化縣,和美鎮,0398,200,264,464,22,486,888,54.73%,22.52%,1
彰化縣,和美鎮,0399,295,374,669,32,701,1144,61.28%,25.79%,1
彰化縣,和美鎮,0400,229,361,590,27,617,1077,57.29%,21.26%,1
彰化縣,和美鎮,0401,326,353,679,39,718,1349,53.22%,24.17%,1
彰化縣,和美鎮,0402,306,385,691,33,724,1155,62.68%,26.49%,1
彰化縣,和美鎮,0403,302,376,678,19,697,1253,55.63%,24.1%,1
彰化縣,和美鎮,0404,270,389,659,32,691,1252,55.19%,21.57%,1
彰化縣,和美鎮,0405,346,434,780,23,803,1474,54.48%,23.47%,1
彰化縣,和美鎮,0406,332,360,692,31,723,1396,51.79%,23.78%,1
彰化縣,和美鎮,0407,305,400,705,32,737,1348,54.67%,22.63%,1
彰化縣,和美鎮,0408,260,334,594,29,623,999,62.36%,26.03%,1
彰化縣,和美鎮,0409,240,277,517,34,551,911,60.48%,26.34%,1
彰化縣,和美鎮,0410,284,289,573,20,593,1005,59%,28.26%,1
彰化縣,和美鎮,0411,232,294,526,37,563,967,58.22%,23.99%,1
彰化縣,和美鎮,0412,309,427,736,31,767,1308,58.64%,23.62%,1
彰化縣,和美鎮,0413,328,378,706,35,741,1324,55.97%,24.77%,1
彰化縣,和美鎮,0414,256,355,611,49,660,1102,59.89%,23.23%,1
彰化縣,和美鎮,0415,251,334,585,36,621,1124,55.25%,22.33%,1
彰化縣,和美鎮,0416,273,392,665,40,705,1211,58.22%,22.54%,1
彰化縣,和美鎮,0417,273,291,564,33,597,884,67.53%,30.88%,1
彰化縣,和美鎮,0418,281,321,602,50,652,1119,58.27%,25.11%,1
彰化縣,和美鎮,0419,301,399,700,40,740,1300,56.92%,23.15%,1
彰化縣,和美鎮,0420,276,294,570,33,603,1104,54.62%,25%,1
彰化縣,和美鎮,0421,318,404,722,25,747,1213,61.58%,26.22%,1
彰化縣,和美鎮,0422,268,293,561,29,590,1127,52.35%,23.78%,1
彰化縣,和美鎮,0423,216,284,500,26,526,919,57.24%,23.5%,1
彰化縣,和美鎮,0424,283,287,570,28,598,987,60.59%,28.67%,1
彰化縣,和美鎮,0425,243,328,571,21,592,958,61.8%,25.37%,1
彰化縣,和美鎮,0426,279,486,765,30,795,1362,58.37%,20.48%,1
彰化縣,和美鎮,0427,312,471,783,33,816,1461,55.85%,21.36%,1
彰化縣,和美鎮,0428,316,468,784,27,811,1405,57.72%,22.49%,1
彰化縣,和美鎮,0429,224,274,498,23,521,860,60.58%,26.05%,1
彰化縣,和美鎮,0430,178,299,477,23,500,875,57.14%,20.34%,1
彰化縣,和美鎮,0431,213,250,463,48,511,871,58.67%,24.45%,1
彰化縣,和美鎮,0432,214,314,528,26,554,883,62.74%,24.24%,1
彰化縣,和美鎮,0433,337,308,645,35,680,1224,55.56%,27.53%,1
彰化縣,和美鎮,0434,248,325,573,30,603,1075,56.09%,23.07%,1
彰化縣,和美鎮,0435,228,279,507,39,546,956,57.11%,23.85%,1
彰化縣,和美鎮,0436,259,288,547,35,582,1037,56.12%,24.98%,1
彰化縣,和美鎮,0437,253,310,563,22,585,1011,57.86%,25.02%,1
彰化縣,和美鎮,0438,261,283,544,37,581,1023,56.79%,25.51%,1
彰化縣,和美鎮,0439,201,175,376,22,398,719,55.35%,27.96%,1
彰化縣,和美鎮,0440,250,232,482,36,518,913,56.74%,27.38%,1
彰化縣,線西鄉,0469,243,360,603,23,626,1071,58.45%,22.69%,1
彰化縣,線西鄉,0470,235,447,682,28,710,1166,60.89%,20.15%,1
彰化縣,線西鄉,0471,281,427,708,49,757,1269,59.65%,22.14%,1
彰化縣,線西鄉,0472,265,354,619,35,654,1138,57.47%,23.29%,1
彰化縣,線西鄉,0473,294,363,657,65,722,1128,64.01%,26.06%,1
彰化縣,線西鄉,0474,303,421,724,53,777,1275,60.94%,23.76%,1
彰化縣,線西鄉,0475,296,379,675,33,708,1187,59.65%,24.94%,1
彰化縣,線西鄉,0476,269,293,562,44,606,991,61.15%,27.14%,1
彰化縣,線西鄉,0477,357,167,524,44,568,938,60.55%,38.06%,1
彰化縣,線西鄉,0478,286,368,654,36,690,1276,54.08%,22.41%,1
彰化縣,線西鄉,0479,310,406,716,42,758,1285,58.99%,24.12%,1
彰化縣,線西鄉,0480,329,508,837,45,882,1341,65.77%,24.53%,1
彰化縣,伸港鄉,0441,260,355,615,19,634,1182,53.64%,22%,1
彰化縣,伸港鄉,0442,295,395,690,31,721,1166,61.84%,25.3%,1
彰化縣,伸港鄉,0443,251,296,547,23,570,966,59.01%,25.98%,1
彰化縣,伸港鄉,0444,219,252,471,23,494,873,56.59%,25.09%,1
彰化縣,伸港鄉,0445,154,256,410,82,492,812,60.59%,18.97%,1
彰化縣,伸港鄉,0446,163,293,456,36,492,875,56.23%,18.63%,1
彰化縣,伸港鄉,0447,226,249,475,37,512,904,56.64%,25%,1
彰化縣,伸港鄉,0448,246,278,524,36,560,1008,55.56%,24.4%,1
彰化縣,伸港鄉,0449,241,401,642,42,684,1154,59.27%,20.88%,1
彰化縣,伸港鄉,0450,332,408,740,44,784,1486,52.76%,22.34%,1
彰化縣,伸港鄉,0451,224,347,571,39,610,1095,55.71%,20.46%,1
彰化縣,伸港鄉,0452,228,310,538,22,560,1087,51.52%,20.98%,1
彰化縣,伸港鄉,0453,274,323,597,55,652,1085,60.09%,25.25%,1
彰化縣,伸港鄉,0454,210,303,513,32,545,908,60.02%,23.13%,1
彰化縣,伸港鄉,0455,310,418,728,40,768,1264,60.76%,24.53%,1
彰化縣,伸港鄉,0456,234,209,443,35,478,854,55.97%,27.4%,1
彰化縣,伸港鄉,0457,180,231,411,19,430,846,50.83%,21.28%,1
彰化縣,伸港鄉,0458,321,242,563,54,617,1143,53.98%,28.08%,1
彰化縣,伸港鄉,0459,323,413,736,28,764,1357,56.3%,23.8%,1
彰化縣,伸港鄉,0460,288,421,709,42,751,1349,55.67%,21.35%,1
彰化縣,伸港鄉,0461,270,374,644,39,683,1154,59.19%,23.4%,1
彰化縣,伸港鄉,0462,301,373,674,25,699,1279,54.65%,23.53%,1
彰化縣,伸港鄉,0463,331,399,730,50,780,1317,59.23%,25.13%,1
彰化縣,伸港鄉,0464,274,310,584,25,609,990,61.52%,27.68%,1
彰化縣,伸港鄉,0465,215,274,489,18,507,852,59.51%,25.23%,1
彰化縣,伸港鄉,0466,274,379,653,30,683,1178,57.98%,23.26%,1
彰化縣,伸港鄉,0467,253,264,517,50,567,1088,52.11%,23.25%,1
彰化縣,伸港鄉,0468,252,350,602,50,652,1135,57.44%,22.2%,1
彰化縣,福興鄉,0308,369,335,704,39,743,1363,54.51%,27.07%,1
彰化縣,福興鄉,0309,207,240,447,25,472,821,57.49%,25.21%,1
彰化縣,福興鄉,0310,309,314,623,46,669,1256,53.26%,24.6%,1
彰化縣,福興鄉,0311,319,263,582,58,640,1166,54.89%,27.36%,1
彰化縣,福興鄉,0312,337,395,732,41,773,1464,52.8%,23.02%,1
彰化縣,福興鄉,0313,280,352,632,32,664,1251,53.08%,22.38%,1
彰化縣,福興鄉,0314,350,399,749,33,782,1465,53.38%,23.89%,1
彰化縣,福興鄉,0315,231,220,451,30,481,960,50.1%,24.06%,1
彰化縣,福興鄉,0316,336,339,675,45,720,1323,54.42%,25.4%,1
彰化縣,福興鄉,0317,658,68,726,33,759,1365,55.6%,48.21%,1
彰化縣,福興鄉,0318,321,345,666,33,699,1458,47.94%,22.02%,1
彰化縣,福興鄉,0319,380,390,770,34,804,1492,53.89%,25.47%,1
彰化縣,福興鄉,0320,229,217,446,17,463,888,52.14%,25.79%,1
彰化縣,福興鄉,0321,280,308,588,49,637,1054,60.44%,26.57%,1
彰化縣,福興鄉,0322,227,261,488,37,525,1043,50.34%,21.76%,1
彰化縣,福興鄉,0323,326,369,695,44,739,1340,55.15%,24.33%,1
彰化縣,福興鄉,0324,248,294,542,32,574,1085,52.9%,22.86%,1
彰化縣,福興鄉,0325,331,375,706,37,743,1392,53.38%,23.78%,1
彰化縣,福興鄉,0326,356,371,727,46,773,1316,58.74%,27.05%,1
彰化縣,福興鄉,0327,449,273,722,33,755,1255,60.16%,35.78%,1
彰化縣,福興鄉,0328,295,360,655,28,683,1101,62.03%,26.79%,1
彰化縣,福興鄉,0329,304,300,604,55,659,1167,56.47%,26.05%,1
彰化縣,福興鄉,0330,309,363,672,67,739,1393,53.05%,22.18%,1
彰化縣,福興鄉,0331,310,357,667,37,704,1216,57.89%,25.49%,1
彰化縣,福興鄉,0332,300,246,546,46,592,1063,55.69%,28.22%,1
彰化縣,福興鄉,0333,288,363,651,55,706,1306,54.06%,22.05%,1
彰化縣,福興鄉,0334,227,342,569,38,607,1287,47.16%,17.64%,1
彰化縣,福興鄉,0335,233,298,531,30,561,994,56.44%,23.44%,1
彰化縣,福興鄉,0336,272,402,674,70,744,1311,56.75%,20.75%,1
彰化縣,福興鄉,0337,221,310,531,29,560,926,60.48%,23.87%,1
彰化縣,福興鄉,0338,248,240,488,34,522,995,52.46%,24.92%,1
彰化縣,福興鄉,0339,302,326,628,46,674,1079,62.47%,27.99%,1
彰化縣,福興鄉,0340,249,300,549,63,612,1150,53.22%,21.65%,1
彰化縣,秀水鄉,0341,301,330,631,39,670,1066,62.85%,28.24%,1
彰化縣,秀水鄉,0342,176,192,368,29,397,620,64.03%,28.39%,1
彰化縣,秀水鄉,0343,220,226,446,11,457,876,52.17%,25.11%,1
彰化縣,秀水鄉,0344,357,351,708,29,737,1196,61.62%,29.85%,1
彰化縣,秀水鄉,0345,356,402,758,34,792,1369,57.85%,26%,1
彰化縣,秀水鄉,0346,322,393,715,43,758,1273,59.54%,25.29%,1
彰化縣,秀水鄉,0347,294,481,775,32,807,1433,56.32%,20.52%,1
彰化縣,秀水鄉,0348,229,329,558,18,576,967,59.57%,23.68%,1
彰化縣,秀水鄉,0349,228,309,537,18,555,921,60.26%,24.76%,1
彰化縣,秀水鄉,0350,201,212,413,21,434,689,62.99%,29.17%,1
彰化縣,秀水鄉,0351,174,223,397,24,421,688,61.19%,25.29%,1
彰化縣,秀水鄉,0352,360,390,750,35,785,1252,62.7%,28.75%,1
彰化縣,秀水鄉,0353,291,392,683,41,724,1281,56.52%,22.72%,1
彰化縣,秀水鄉,0354,168,247,415,23,438,754,58.09%,22.28%,1
彰化縣,秀水鄉,0355,275,295,570,25,595,1024,58.11%,26.86%,1
彰化縣,秀水鄉,0356,306,453,759,27,786,1433,54.85%,21.35%,1
彰化縣,秀水鄉,0357,378,468,846,39,885,1366,64.79%,27.67%,1
彰化縣,秀水鄉,0358,247,268,515,32,547,895,61.12%,27.6%,1
彰化縣,秀水鄉,0359,326,393,719,39,758,1386,54.69%,23.52%,1
彰化縣,秀水鄉,0360,246,253,499,46,545,896,60.83%,27.46%,1
彰化縣,秀水鄉,0361,233,275,508,28,536,804,66.67%,28.98%,1
彰化縣,秀水鄉,0362,212,284,496,25,521,827,63%,25.63%,1
彰化縣,秀水鄉,0363,256,309,565,27,592,996,59.44%,25.7%,1
彰化縣,秀水鄉,0364,263,328,591,29,620,931,66.6%,28.25%,1
彰化縣,秀水鄉,0365,184,202,386,27,413,715,57.76%,25.73%,1
彰化縣,秀水鄉,0366,319,413,732,39,771,1229,62.73%,25.96%,1
彰化縣,秀水鄉,0367,193,246,439,26,465,890,52.25%,21.69%,1
彰化縣,秀水鄉,0368,222,266,488,28,516,811,63.63%,27.37%,1
彰化縣,秀水鄉,0369,211,261,472,20,492,786,62.6%,26.84%,1
彰化縣,秀水鄉,0370,262,261,523,25,548,931,58.86%,28.14%,1
彰化縣,秀水鄉,0371,321,390,711,59,770,1265,60.87%,25.38%,1
彰化縣,秀水鄉,0372,255,194,449,27,476,824,57.77%,30.95%,1
彰化縣,花壇鄉,0185,225,280,505,42,547,901,60.71%,24.97%,1
彰化縣,花壇鄉,0186,274,346,620,31,651,1042,62.48%,26.3%,1
彰化縣,花壇鄉,0187,297,396,693,14,707,1314,53.81%,22.6%,1
彰化縣,花壇鄉,0188,208,273,481,24,505,808,62.5%,25.74%,1
彰化縣,花壇鄉,0189,268,283,551,39,590,1019,57.9%,26.3%,1
彰化縣,花壇鄉,0190,324,313,637,75,712,1144,62.24%,28.32%,1
彰化縣,花壇鄉,0191,275,407,682,60,742,1240,59.84%,22.18%,1
彰化縣,花壇鄉,0192,353,462,815,67,882,1425,61.89%,24.77%,1
彰化縣,花壇鄉,0193,291,360,651,51,702,1095,64.11%,26.58%,1
彰化縣,花壇鄉,0194,236,289,525,26,551,910,60.55%,25.93%,1
彰化縣,花壇鄉,0195,264,300,564,32,596,982,60.69%,26.88%,1
彰化縣,花壇鄉,0196,271,338,609,13,622,1070,58.13%,25.33%,1
彰化縣,花壇鄉,0197,175,190,365,20,385,700,55%,25%,1
彰化縣,花壇鄉,0198,217,261,478,30,508,764,66.49%,28.4%,1
彰化縣,花壇鄉,0199,253,314,567,40,607,953,63.69%,26.55%,1
彰化縣,花壇鄉,0200,213,325,538,19,557,974,57.19%,21.87%,1
彰化縣,花壇鄉,0201,267,337,604,44,648,1111,58.33%,24.03%,1
彰化縣,花壇鄉,0202,215,406,621,53,674,1101,61.22%,19.53%,1
彰化縣,花壇鄉,0203,228,347,575,43,618,1110,55.68%,20.54%,1
彰化縣,花壇鄉,0204,292,393,685,51,736,1262,58.32%,23.14%,1
彰化縣,花壇鄉,0205,280,350,630,21,651,1103,59.02%,25.39%,1
彰化縣,花壇鄉,0206,306,343,649,111,760,1347,56.42%,22.72%,1
彰化縣,花壇鄉,0207,246,364,610,30,640,1169,54.75%,21.04%,1
彰化縣,花壇鄉,0208,329,407,736,32,768,1274,60.28%,25.82%,1
彰化縣,花壇鄉,0209,272,485,757,38,795,1280,62.11%,21.25%,1
彰化縣,花壇鄉,0210,289,387,676,45,721,1244,57.96%,23.23%,1
彰化縣,花壇鄉,0211,370,269,639,45,684,1159,59.02%,31.92%,1
彰化縣,花壇鄉,0212,265,365,630,30,660,1042,63.34%,25.43%,1
彰化縣,花壇鄉,0213,271,321,592,35,627,1111,56.44%,24.39%,1
彰化縣,花壇鄉,0214,229,304,533,39,572,893,64.05%,25.64%,1
彰化縣,花壇鄉,0215,220,305,525,43,568,953,59.6%,23.08%,1
彰化縣,花壇鄉,0216,258,268,526,32,558,987,56.53%,26.14%,1
彰化縣,花壇鄉,0217,267,304,571,40,611,925,66.05%,28.86%,1
彰化縣,花壇鄉,0218,318,198,516,38,554,951,58.25%,33.44%,1
彰化縣,花壇鄉,0219,202,314,516,29,545,955,57.07%,21.15%,1
彰化縣,花壇鄉,0220,193,296,489,20,509,895,56.87%,21.56%,1
彰化縣,花壇鄉,0221,192,216,408,16,424,711,59.63%,27%,1
彰化縣,芬園鄉,0222,226,285,511,29,540,958,56.37%,23.59%,1
彰化縣,芬園鄉,0223,174,247,421,39,460,794,57.93%,21.91%,1
彰化縣,芬園鄉,0224,281,397,678,75,753,1415,53.22%,19.86%,1
彰化縣,芬園鄉,0225,244,301,545,28,573,927,61.81%,26.32%,1
彰化縣,芬園鄉,0226,172,266,438,36,474,831,57.04%,20.7%,1
彰化縣,芬園鄉,0227,153,166,319,15,334,570,58.6%,26.84%,1
彰化縣,芬園鄉,0228,273,353,626,40,666,1227,54.28%,22.25%,1
彰化縣,芬園鄉,0229,242,388,630,53,683,1238,55.17%,19.55%,1
彰化縣,芬園鄉,0230,310,409,719,72,791,1362,58.08%,22.76%,1
彰化縣,芬園鄉,0231,259,308,567,32,599,989,60.57%,26.19%,1
彰化縣,芬園鄉,0232,261,368,629,43,672,1054,63.76%,24.76%,1
彰化縣,芬園鄉,0233,156,213,369,33,402,607,66.23%,25.7%,1
彰化縣,芬園鄉,0234,228,282,510,26,536,882,60.77%,25.85%,1
彰化縣,芬園鄉,0235,217,310,527,36,563,1143,49.26%,18.99%,1
彰化縣,芬園鄉,0236,141,187,328,16,344,661,52.04%,21.33%,1
彰化縣,芬園鄉,0237,226,204,430,9,439,838,52.39%,26.97%,1
彰化縣,芬園鄉,0238,220,216,436,17,453,847,53.48%,25.97%,1
彰化縣,芬園鄉,0239,218,329,547,45,592,987,59.98%,22.09%,1
彰化縣,芬園鄉,0240,297,306,603,50,653,1217,53.66%,24.4%,1
彰化縣,芬園鄉,0241,200,211,411,42,453,865,52.37%,23.12%,1
彰化縣,芬園鄉,0242,263,218,481,39,520,996,52.21%,26.41%,1
彰化縣,員林市,0481,178,371,549,24,573,1087,52.71%,16.38%,1
彰化縣,員林市,0482,276,418,694,27,721,1353,53.29%,20.4%,1
彰化縣,員林市,0483,367,246,613,43,656,1313,49.96%,27.95%,1
彰化縣,員林市,0484,247,388,635,15,650,1328,48.95%,18.6%,1
彰化縣,員林市,0485,271,311,582,21,603,1055,57.16%,25.69%,1
彰化縣,員林市,0486,215,284,499,32,531,959,55.37%,22.42%,1
彰化縣,員林市,0487,193,234,427,24,451,772,58.42%,25%,1
彰化縣,員林市,0488,242,241,483,33,516,831,62.09%,29.12%,1
彰化縣,員林市,0489,193,191,384,11,395,854,46.25%,22.6%,1
彰化縣,員林市,0490,245,263,508,33,541,1190,45.46%,20.59%,1
彰化縣,員林市,0491,138,242,380,19,399,726,54.96%,19.01%,1
彰化縣,員林市,0492,277,321,598,35,633,1124,56.32%,24.64%,1
彰化縣,員林市,0493,203,221,424,35,459,860,53.37%,23.6%,1
彰化縣,員林市,0494,280,365,645,36,681,1122,60.7%,24.96%,1
彰化縣,員林市,0495,247,354,601,42,643,1075,59.81%,22.98%,1
彰化縣,員林市,0496,230,279,509,41,550,993,55.39%,23.16%,1
彰化縣,員林市,0497,229,278,507,25,532,967,55.02%,23.68%,1
彰化縣,員林市,0498,262,283,545,38,583,1008,57.84%,25.99%,1
彰化縣,員林市,0499,171,259,430,29,459,804,57.09%,21.27%,1
彰化縣,員林市,0500,195,270,465,20,485,867,55.94%,22.49%,1
彰化縣,員林市,0501,210,253,463,26,489,885,55.25%,23.73%,1
彰化縣,員林市,0502,220,316,536,14,550,1097,50.14%,20.05%,1
彰化縣,員林市,0503,296,372,668,23,691,1255,55.06%,23.59%,1
彰化縣,員林市,0504,266,323,589,29,618,1063,58.14%,25.02%,1
彰化縣,員林市,0505,408,98,506,14,520,925,56.22%,44.11%,1
彰化縣,員林市,0506,218,306,524,33,557,947,58.82%,23.02%,1
彰化縣,員林市,0507,210,318,528,23,551,916,60.15%,22.93%,1
彰化縣,員林市,0508,193,266,459,22,481,862,55.8%,22.39%,1
彰化縣,員林市,0509,242,309,551,13,564,987,57.14%,24.52%,1
彰化縣,員林市,0510,257,310,567,34,601,1085,55.39%,23.69%,1
彰化縣,員林市,0511,265,353,618,21,639,1110,57.57%,23.87%,1
彰化縣,員林市,0512,239,326,565,16,581,1095,53.06%,21.83%,1
彰化縣,員林市,0513,355,406,761,27,788,1278,61.66%,27.78%,1
彰化縣,員林市,0514,270,349,619,36,655,1109,59.06%,24.35%,1
彰化縣,員林市,0515,256,304,560,45,605,1055,57.35%,24.27%,1
彰化縣,員林市,0516,234,248,482,28,510,876,58.22%,26.71%,1
彰化縣,員林市,0517,246,288,534,25,559,1115,50.13%,22.06%,1
彰化縣,員林市,0518,291,368,659,31,690,1186,58.18%,24.54%,1
彰化縣,員林市,0519,223,356,579,25,604,995,60.7%,22.41%,1
彰化縣,員林市,0520,213,328,541,21,562,999,56.26%,21.32%,1
彰化縣,員林市,0521,234,392,626,31,657,1201,54.7%,19.48%,1
彰化縣,員林市,0522,237,390,627,23,650,1342,48.44%,17.66%,1
彰化縣,員林市,0523,248,332,580,21,601,1086,55.34%,22.84%,1
彰化縣,員林市,0524,195,243,438,20,458,854,53.63%,22.83%,1
彰化縣,員林市,0525,232,354,586,23,609,1064,57.24%,21.8%,1
彰化縣,員林市,0526,229,285,514,14,528,879,60.07%,26.05%,1
彰化縣,員林市,0527,211,327,538,23,561,827,67.84%,25.51%,1
彰化縣,員林市,0528,208,267,475,14,489,867,56.4%,23.99%,1
彰化縣,員林市,0529,243,404,647,29,676,1201,56.29%,20.23%,1
彰化縣,員林市,0530,254,366,620,45,665,1106,60.13%,22.97%,1
彰化縣,員林市,0531,218,261,479,29,508,845,60.12%,25.8%,1
彰化縣,員林市,0532,208,293,501,26,527,894,58.95%,23.27%,1
彰化縣,員林市,0533,189,286,475,28,503,849,59.25%,22.26%,1
彰化縣,員林市,0534,240,222,462,11,473,747,63.32%,32.13%,1
彰化縣,員林市,0535,234,291,525,30,555,884,62.78%,26.47%,1
彰化縣,員林市,0536,170,287,457,21,478,900,53.11%,18.89%,1
彰化縣,員林市,0537,245,286,531,26,557,1040,53.56%,23.56%,1
彰化縣,員林市,0538,224,250,474,15,489,831,58.84%,26.96%,1
彰化縣,員林市,0539,194,185,379,17,396,591,67.01%,32.83%,1
彰化縣,員林市,0540,307,381,688,27,715,1330,53.76%,23.08%,1
彰化縣,員林市,0541,285,434,719,17,736,1295,56.83%,22.01%,1
彰化縣,員林市,0542,295,388,683,34,717,1283,55.88%,22.99%,1
彰化縣,員林市,0543,218,328,546,27,573,943,60.76%,23.12%,1
彰化縣,員林市,0544,184,670,854,27,881,1388,63.47%,13.26%,1
彰化縣,員林市,0545,277,387,664,26,690,1176,58.67%,23.55%,1
彰化縣,員林市,0546,171,260,431,8,439,867,50.63%,19.72%,1
彰化縣,員林市,0547,252,340,592,31,623,1121,55.58%,22.48%,1
彰化縣,員林市,0548,233,377,610,24,634,1190,53.28%,19.58%,1
彰化縣,員林市,0549,228,310,538,27,565,945,59.79%,24.13%,1
彰化縣,員林市,0550,236,291,527,23,550,906,60.71%,26.05%,1
彰化縣,員林市,0551,263,305,568,29,597,978,61.04%,26.89%,1
彰化縣,員林市,0552,197,331,528,26,554,949,58.38%,20.76%,1
彰化縣,員林市,0553,229,319,548,21,569,949,59.96%,24.13%,1
彰化縣,員林市,0554,230,314,544,26,570,1006,56.66%,22.86%,1
彰化縣,員林市,0555,222,280,502,26,528,889,59.39%,24.97%,1
彰化縣,員林市,0556,238,322,560,15,575,923,62.3%,25.79%,1
彰化縣,員林市,0557,261,453,714,33,747,1209,61.79%,21.59%,1
彰化縣,員林市,0558,284,348,632,23,655,1075,60.93%,26.42%,1
彰化縣,員林市,0559,388,420,808,26,834,1342,62.15%,28.91%,1
彰化縣,員林市,0560,315,355,670,27,697,1039,67.08%,30.32%,1
彰化縣,員林市,0561,282,325,607,25,632,1131,55.88%,24.93%,1
彰化縣,員林市,0562,283,403,686,22,708,1356,52.21%,20.87%,1
彰化縣,員林市,0563,345,391,736,35,771,1370,56.28%,25.18%,1
彰化縣,員林市,0564,299,318,617,23,640,1090,58.72%,27.43%,1
彰化縣,員林市,0565,233,287,520,16,536,821,65.29%,28.38%,1
彰化縣,員林市,0566,199,324,523,23,546,910,60%,21.87%,1
彰化縣,員林市,0567,249,404,653,37,690,1203,57.36%,20.7%,1
彰化縣,員林市,0568,337,421,758,24,782,1378,56.75%,24.46%,1
彰化縣,員林市,0569,305,446,751,26,777,1352,57.47%,22.56%,1
彰化縣,員林市,0570,282,353,635,22,657,1060,61.98%,26.6%,1
彰化縣,員林市,0571,287,404,691,32,723,1317,54.9%,21.79%,1
彰化縣,員林市,0572,252,339,591,26,617,1120,55.09%,22.5%,1
彰化縣,員林市,0573,169,360,529,30,559,1025,54.54%,16.49%,1
彰化縣,員林市,0574,235,374,609,26,635,1097,57.89%,21.42%,1
彰化縣,員林市,0575,217,275,492,27,519,859,60.42%,25.26%,1
彰化縣,員林市,0576,192,251,443,23,466,837,55.68%,22.94%,1
彰化縣,員林市,0577,282,369,651,34,685,1090,62.84%,25.87%,1
彰化縣,員林市,0578,279,309,588,36,624,1073,58.15%,26%,1
彰化縣,溪湖鎮,0640,316,340,656,27,683,1221,55.94%,25.88%,1
彰化縣,溪湖鎮,0641,162,223,385,24,409,638,64.11%,25.39%,1
彰化縣,溪湖鎮,0642,211,258,469,21,490,817,59.98%,25.83%,1
彰化縣,溪湖鎮,0643,202,365,567,22,589,968,60.85%,20.87%,1
彰化縣,溪湖鎮,0644,117,168,285,12,297,448,66.29%,26.12%,1
彰化縣,溪湖鎮,0645,265,342,607,22,629,1123,56.01%,23.6%,1
彰化縣,溪湖鎮,0646,270,366,636,26,662,1166,56.78%,23.16%,1
彰化縣,溪湖鎮,0647,259,348,607,30,637,1151,55.34%,22.5%,1
彰化縣,溪湖鎮,0648,295,413,708,17,725,1249,58.05%,23.62%,1
彰化縣,溪湖鎮,0649,288,360,648,35,683,1146,59.6%,25.13%,1
彰化縣,溪湖鎮,0650,285,370,655,43,698,1199,58.22%,23.77%,1
彰化縣,溪湖鎮,0651,250,242,492,33,525,895,58.66%,27.93%,1
彰化縣,溪湖鎮,0652,257,311,568,20,588,964,61%,26.66%,1
彰化縣,溪湖鎮,0653,233,245,478,22,500,851,58.75%,27.38%,1
彰化縣,溪湖鎮,0654,245,341,586,21,607,1072,56.62%,22.85%,1
彰化縣,溪湖鎮,0655,261,385,646,23,669,1113,60.11%,23.45%,1
彰化縣,溪湖鎮,0656,228,402,630,27,657,1090,60.28%,20.92%,1
彰化縣,溪湖鎮,0657,284,418,702,26,728,1193,61.02%,23.81%,1
彰化縣,溪湖鎮,0658,190,360,550,41,591,952,62.08%,19.96%,1
彰化縣,溪湖鎮,0659,278,377,655,27,682,1172,58.19%,23.72%,1
彰化縣,溪湖鎮,0660,231,335,566,26,592,1027,57.64%,22.49%,1
彰化縣,溪湖鎮,0661,273,448,721,26,747,1188,62.88%,22.98%,1
彰化縣,溪湖鎮,0662,332,393,725,46,771,1403,54.95%,23.66%,1
彰化縣,溪湖鎮,0663,308,373,681,50,731,1397,52.33%,22.05%,1
彰化縣,溪湖鎮,0664,354,540,894,46,940,1636,57.46%,21.64%,1
彰化縣,溪湖鎮,0665,306,427,733,45,778,1298,59.94%,23.57%,1
彰化縣,溪湖鎮,0666,289,380,669,32,701,1214,57.74%,23.81%,1
彰化縣,溪湖鎮,0667,295,453,748,31,779,1297,60.06%,22.74%,1
彰化縣,溪湖鎮,0668,234,339,573,32,605,968,62.5%,24.17%,1
彰化縣,溪湖鎮,0669,206,273,479,30,509,839,60.67%,24.55%,1
彰化縣,溪湖鎮,0670,228,300,528,29,557,907,61.41%,25.14%,1
彰化縣,溪湖鎮,0671,215,239,454,15,469,898,52.23%,23.94%,1
彰化縣,溪湖鎮,0672,193,238,431,18,449,650,69.08%,29.69%,1
彰化縣,溪湖鎮,0673,271,415,686,54,740,1279,57.86%,21.19%,1
彰化縣,溪湖鎮,0674,211,235,446,31,477,730,65.34%,28.9%,1
彰化縣,溪湖鎮,0675,316,479,795,38,833,1407,59.2%,22.46%,1
彰化縣,溪湖鎮,0676,297,303,600,47,647,1273,50.82%,23.33%,1
彰化縣,溪湖鎮,0677,250,275,525,21,546,988,55.26%,25.3%,1
彰化縣,溪湖鎮,0678,195,247,442,39,481,754,63.79%,25.86%,1
彰化縣,溪湖鎮,0679,230,261,491,37,528,1052,50.19%,21.86%,1
彰化縣,溪湖鎮,0680,244,340,584,37,621,1149,54.05%,21.24%,1
彰化縣,溪湖鎮,0681,389,417,806,61,867,1365,63.52%,28.5%,1
彰化縣,田中鎮,0742,215,218,433,46,479,854,56.09%,25.18%,1
彰化縣,田中鎮,0743,197,265,462,30,492,963,51.09%,20.46%,1
彰化縣,田中鎮,0744,14,27,41,4,45,175,25.71%,8%,1
彰化縣,田中鎮,0745,168,207,375,23,398,739,53.86%,22.73%,1
彰化縣,田中鎮,0746,188,247,435,18,453,826,54.84%,22.76%,1
彰化縣,田中鎮,0747,183,234,417,36,453,741,61.13%,24.7%,1
彰化縣,田中鎮,0748,86,151,237,9,246,506,48.62%,17%,1
彰化縣,田中鎮,0749,82,317,399,28,427,1001,42.66%,8.19%,1
彰化縣,田中鎮,0750,322,377,699,53,752,1281,58.7%,25.14%,1
彰化縣,田中鎮,0751,254,312,566,34,600,1035,57.97%,24.54%,1
彰化縣,田中鎮,0752,336,412,748,33,781,1327,58.85%,25.32%,1
彰化縣,田中鎮,0753,247,252,499,24,523,844,61.97%,29.27%,1
彰化縣,田中鎮,0754,222,282,504,30,534,913,58.49%,24.32%,1
彰化縣,田中鎮,0755,179,204,383,22,405,613,66.07%,29.2%,1
彰化縣,田中鎮,0756,332,448,780,41,821,1382,59.41%,24.02%,1
彰化縣,田中鎮,0757,237,402,639,34,673,1034,65.09%,22.92%,1
彰化縣,田中鎮,0758,266,328,594,23,617,935,65.99%,28.45%,1
彰化縣,田中鎮,0759,317,411,728,30,758,1301,58.26%,24.37%,1
彰化縣,田中鎮,0760,273,355,628,33,661,1100,60.09%,24.82%,1
彰化縣,田中鎮,0761,272,349,621,36,657,1071,61.34%,25.4%,1
彰化縣,田中鎮,0762,312,377,689,37,726,1163,62.42%,26.83%,1
彰化縣,田中鎮,0763,219,285,504,36,540,809,66.75%,27.07%,1
彰化縣,田中鎮,0764,282,413,695,27,722,1155,62.51%,24.42%,1
彰化縣,田中鎮,0765,341,346,687,52,739,1270,58.19%,26.85%,1
彰化縣,田中鎮,0766,239,237,476,17,493,870,56.67%,27.47%,1
彰化縣,田中鎮,0767,199,205,404,20,424,736,57.61%,27.04%,1
彰化縣,田中鎮,0768,273,384,657,41,698,1335,52.28%,20.45%,1
彰化縣,田中鎮,0769,212,259,471,31,502,876,57.31%,24.2%,1
彰化縣,田中鎮,0770,221,234,455,40,495,898,55.12%,24.61%,1
彰化縣,田中鎮,0771,309,424,733,27,760,1298,58.55%,23.81%,1
彰化縣,田中鎮,0772,344,415,759,58,817,1451,56.31%,23.71%,1
彰化縣,田中鎮,0773,304,487,791,51,842,1475,57.08%,20.61%,1
彰化縣,田中鎮,0774,173,201,374,31,405,766,52.87%,22.58%,1
彰化縣,田中鎮,0775,226,183,409,33,442,810,54.57%,27.9%,1
彰化縣,田中鎮,0776,247,281,528,43,571,953,59.92%,25.92%,1
彰化縣,田中鎮,0777,248,272,520,49,569,885,64.29%,28.02%,1
彰化縣,大村鄉,0579,364,502,866,41,907,1426,63.6%,25.53%,1
彰化縣,大村鄉,0580,445,584,1029,50,1079,1726,62.51%,25.78%,1
彰化縣,大村鄉,0581,204,258,462,44,506,797,63.49%,25.6%,1
彰化縣,大村鄉,0582,212,219,431,18,449,745,60.27%,28.46%,1
彰化縣,大村鄉,0583,265,392,657,35,692,1125,61.51%,23.56%,1
彰化縣,大村鄉,0584,358,461,819,53,872,1486,58.68%,24.09%,1
彰化縣,大村鄉,0585,342,444,786,49,835,1426,58.56%,23.98%,1
彰化縣,大村鄉,0586,197,291,488,36,524,824,63.59%,23.91%,1
彰化縣,大村鄉,0587,275,326,601,27,628,1177,53.36%,23.36%,1
彰化縣,大村鄉,0588,352,465,817,65,882,1478,59.68%,23.82%,1
彰化縣,大村鄉,0589,158,249,407,20,427,779,54.81%,20.28%,1
彰化縣,大村鄉,0590,252,265,517,31,548,812,67.49%,31.03%,1
彰化縣,大村鄉,0591,267,344,611,28,639,1161,55.04%,23%,1
彰化縣,大村鄉,0592,291,369,660,25,685,1238,55.33%,23.51%,1
彰化縣,大村鄉,0593,308,382,690,40,730,1259,57.98%,24.46%,1
彰化縣,大村鄉,0594,346,446,792,32,824,1412,58.36%,24.5%,1
彰化縣,大村鄉,0595,325,466,791,22,813,1401,58.03%,23.2%,1
彰化縣,大村鄉,0596,326,462,788,47,835,1395,59.86%,23.37%,1
彰化縣,大村鄉,0597,260,310,570,35,605,996,60.74%,26.1%,1
彰化縣,大村鄉,0598,455,112,567,44,611,1047,58.36%,43.46%,1
彰化縣,大村鄉,0599,220,343,563,31,594,985,60.3%,22.34%,1
彰化縣,大村鄉,0600,296,330,626,38,664,1054,63%,28.08%,1
彰化縣,大村鄉,0601,249,434,683,29,712,1200,59.33%,20.75%,1
彰化縣,大村鄉,0602,258,320,578,41,619,1003,61.71%,25.72%,1
彰化縣,大村鄉,0603,259,297,556,22,578,1046,55.26%,24.76%,1
彰化縣,大村鄉,0604,327,359,686,31,717,1189,60.3%,27.5%,1
彰化縣,大村鄉,0605,258,414,672,44,716,1305,54.87%,19.77%,1
彰化縣,埔鹽鄉,0682,237,326,563,36,599,958,62.53%,24.74%,1
彰化縣,埔鹽鄉,0683,194,272,466,27,493,754,65.38%,25.73%,1
彰化縣,埔鹽鄉,0684,189,289,478,24,502,757,66.31%,24.97%,1
彰化縣,埔鹽鄉,0685,214,267,481,26,507,806,62.9%,26.55%,1
彰化縣,埔鹽鄉,0686,259,462,721,44,765,1280,59.77%,20.23%,1
彰化縣,埔鹽鄉,0687,215,317,532,25,557,928,60.02%,23.17%,1
彰化縣,埔鹽鄉,0688,227,326,553,39,592,895,66.15%,25.36%,1
彰化縣,埔鹽鄉,0689,186,311,497,30,527,815,64.66%,22.82%,1
彰化縣,埔鹽鄉,0690,252,285,537,23,560,957,58.52%,26.33%,1
彰化縣,埔鹽鄉,0691,318,411,729,63,792,1338,59.19%,23.77%,1
彰化縣,埔鹽鄉,0692,245,366,611,32,643,1106,58.14%,22.15%,1
彰化縣,埔鹽鄉,0693,175,231,406,21,427,690,61.88%,25.36%,1
彰化縣,埔鹽鄉,0694,257,415,672,30,702,1230,57.07%,20.89%,1
彰化縣,埔鹽鄉,0695,181,292,473,27,500,847,59.03%,21.37%,1
彰化縣,埔鹽鄉,0696,216,317,533,30,563,897,62.76%,24.08%,1
彰化縣,埔鹽鄉,0697,211,281,492,41,533,882,60.43%,23.92%,1
彰化縣,埔鹽鄉,0698,265,418,683,37,720,1180,61.02%,22.46%,1
彰化縣,埔鹽鄉,0699,285,369,654,51,705,1215,58.02%,23.46%,1
彰化縣,埔鹽鄉,0700,84,182,266,16,282,422,66.82%,19.91%,1
彰化縣,埔鹽鄉,0701,252,343,595,29,624,1106,56.42%,22.78%,1
彰化縣,埔鹽鄉,0702,222,319,541,31,572,874,65.45%,25.4%,1
彰化縣,埔鹽鄉,0703,358,445,803,63,866,1445,59.93%,24.78%,1
彰化縣,埔鹽鄉,0704,145,300,445,41,486,875,55.54%,16.57%,1
彰化縣,埔鹽鄉,0705,174,244,418,32,450,837,53.76%,20.79%,1
彰化縣,埔鹽鄉,0706,160,228,388,27,415,685,60.58%,23.36%,1
彰化縣,埔鹽鄉,0707,170,257,427,41,468,733,63.85%,23.19%,1
彰化縣,埔鹽鄉,0708,194,250,444,57,501,798,62.78%,24.31%,1
彰化縣,埔鹽鄉,0709,291,470,761,40,801,1381,58%,21.07%,1
彰化縣,埔鹽鄉,0710,271,410,681,31,712,1335,53.33%,20.3%,1
彰化縣,埔心鄉,0711,317,353,670,46,716,1139,62.86%,27.83%,1
彰化縣,埔心鄉,0712,318,355,673,43,716,1217,58.83%,26.13%,1
彰化縣,埔心鄉,0713,303,427,730,37,767,1248,61.46%,24.28%,1
彰化縣,埔心鄉,0714,369,392,761,47,808,1248,64.74%,29.57%,1
彰化縣,埔心鄉,0715,219,321,540,29,569,916,62.12%,23.91%,1
彰化縣,埔心鄉,0716,183,209,392,19,411,625,65.76%,29.28%,1
彰化縣,埔心鄉,0717,297,378,675,53,728,1271,57.28%,23.37%,1
彰化縣,埔心鄉,0718,170,195,365,26,391,608,64.31%,27.96%,1
彰化縣,埔心鄉,0719,314,364,678,58,736,1132,65.02%,27.74%,1
彰化縣,埔心鄉,0720,262,329,591,49,640,1027,62.32%,25.51%,1
彰化縣,埔心鄉,0721,257,304,561,33,594,926,64.15%,27.75%,1
彰化縣,埔心鄉,0722,200,241,441,41,482,778,61.95%,25.71%,1
彰化縣,埔心鄉,0723,184,223,407,19,426,660,64.55%,27.88%,1
彰化縣,埔心鄉,0724,324,455,779,64,843,1330,63.38%,24.36%,1
彰化縣,埔心鄉,0725,299,273,572,26,598,991,60.34%,30.17%,1
彰化縣,埔心鄉,0726,261,329,590,23,613,985,62.23%,26.5%,1
彰化縣,埔心鄉,0727,273,301,574,26,600,1034,58.03%,26.4%,1
彰化縣,埔心鄉,0728,167,200,367,33,400,612,65.36%,27.29%,1
彰化縣,埔心鄉,0729,314,421,735,54,789,1236,63.83%,25.4%,1
彰化縣,埔心鄉,0730,211,244,455,39,494,775,63.74%,27.23%,1
彰化縣,埔心鄉,0731,204,262,466,31,497,738,67.34%,27.64%,1
彰化縣,埔心鄉,0732,278,319,597,41,638,1036,61.58%,26.83%,1
彰化縣,埔心鄉,0733,250,263,513,48,561,975,57.54%,25.64%,1
彰化縣,埔心鄉,0734,226,269,495,38,533,885,60.23%,25.54%,1
彰化縣,埔心鄉,0735,266,293,559,37,596,939,63.47%,28.33%,1
彰化縣,埔心鄉,0736,191,213,404,22,426,689,61.83%,27.72%,1
彰化縣,埔心鄉,0737,184,205,389,20,409,659,62.06%,27.92%,1
彰化縣,埔心鄉,0738,224,259,483,28,511,910,56.15%,24.62%,1
彰化縣,埔心鄉,0739,399,434,833,65,898,1352,66.42%,29.51%,1
彰化縣,埔心鄉,0740,223,201,424,27,451,759,59.42%,29.38%,1
彰化縣,埔心鄉,0741,205,336,541,28,569,942,60.4%,21.76%,1
彰化縣,永靖鄉,0606,260,352,612,56,668,1255,53.23%,20.72%,1
彰化縣,永靖鄉,0607,260,256,516,34,550,889,61.87%,29.25%,1
彰化縣,永靖鄉,0608,251,304,555,29,584,1026,56.92%,24.46%,1
彰化縣,永靖鄉,0609,195,233,428,29,457,724,63.12%,26.93%,1
彰化縣,永靖鄉,0610,409,104,513,39,552,924,59.74%,44.26%,1
彰化縣,永靖鄉,0611,198,198,396,24,420,659,63.73%,30.05%,1
彰化縣,永靖鄉,0612,217,199,416,24,440,734,59.95%,29.56%,1
彰化縣,永靖鄉,0613,171,193,364,13,377,758,49.74%,22.56%,1
彰化縣,永靖鄉,0614,216,313,529,27,556,848,65.57%,25.47%,1
彰化縣,永靖鄉,0615,313,395,708,58,766,1404,54.56%,22.29%,1
彰化縣,永靖鄉,0616,233,285,518,35,553,792,69.82%,29.42%,1
彰化縣,永靖鄉,0617,207,220,427,21,448,695,64.46%,29.78%,1
彰化縣,永靖鄉,0618,215,276,491,19,510,821,62.12%,26.19%,1
彰化縣,永靖鄉,0619,248,384,632,39,671,1064,63.06%,23.31%,1
彰化縣,永靖鄉,0620,199,271,470,20,490,840,58.33%,23.69%,1
彰化縣,永靖鄉,0621,287,256,543,26,569,1079,52.73%,26.6%,1
彰化縣,永靖鄉,0622,272,361,633,22,655,1048,62.5%,25.95%,1
彰化縣,永靖鄉,0623,256,340,596,31,627,960,65.31%,26.67%,1
彰化縣,永靖鄉,0624,208,277,485,18,503,798,63.03%,26.07%,1
彰化縣,永靖鄉,0625,217,295,512,17,529,796,66.46%,27.26%,1
彰化縣,永靖鄉,0626,143,221,364,21,385,662,58.16%,21.6%,1
彰化縣,永靖鄉,0627,279,303,582,27,609,1040,58.56%,26.83%,1
彰化縣,永靖鄉,0628,241,319,560,30,590,1025,57.56%,23.51%,1
彰化縣,永靖鄉,0629,345,497,842,35,877,1357,64.63%,25.42%,1
彰化縣,永靖鄉,0630,299,407,706,47,753,1236,60.92%,24.19%,1
彰化縣,永靖鄉,0631,216,267,483,23,506,871,58.09%,24.8%,1
彰化縣,永靖鄉,0632,153,214,367,24,391,706,55.38%,21.67%,1
彰化縣,永靖鄉,0633,232,240,472,27,499,770,64.81%,30.13%,1
彰化縣,永靖鄉,0634,184,244,428,16,444,669,66.37%,27.5%,1
彰化縣,永靖鄉,0635,194,285,479,30,509,862,59.05%,22.51%,1
彰化縣,永靖鄉,0636,181,272,453,26,479,847,56.55%,21.37%,1
彰化縣,永靖鄉,0637,171,234,405,30,435,668,65.12%,25.6%,1
彰化縣,永靖鄉,0638,232,323,555,21,576,1073,53.68%,21.62%,1
彰化縣,永靖鄉,0639,349,317,666,29,695,1339,51.9%,26.06%,1
彰化縣,社頭鄉,0778,265,188,453,18,471,791,59.54%,33.5%,1
彰化縣,社頭鄉,0779,232,303,535,26,561,984,57.01%,23.58%,1
彰化縣,社頭鄉,0780,259,270,529,17,546,990,55.15%,26.16%,1
彰化縣,社頭鄉,0781,279,321,600,32,632,1016,62.2%,27.46%,1
彰化縣,社頭鄉,0782,547,85,632,27,659,1091,60.4%,50.14%,1
彰化縣,社頭鄉,0783,324,381,705,40,745,1236,60.28%,26.21%,1
彰化縣,社頭鄉,0784,305,357,662,20,682,1203,56.69%,25.35%,1
彰化縣,社頭鄉,0785,194,215,409,19,428,753,56.84%,25.76%,1
彰化縣,社頭鄉,0786,164,189,353,35,388,725,53.52%,22.62%,1
彰化縣,社頭鄉,0787,279,303,582,43,625,1023,61.09%,27.27%,1
彰化縣,社頭鄉,0788,192,172,364,21,385,562,68.51%,34.16%,1
彰化縣,社頭鄉,0789,277,287,564,35,599,1049,57.1%,26.41%,1
彰化縣,社頭鄉,0790,258,282,540,23,563,933,60.34%,27.65%,1
彰化縣,社頭鄉,0791,264,316,580,28,608,990,61.41%,26.67%,1
彰化縣,社頭鄉,0792,265,294,559,34,593,1076,55.11%,24.63%,1
彰化縣,社頭鄉,0793,197,248,445,17,462,742,62.26%,26.55%,1
彰化縣,社頭鄉,0794,159,211,370,17,387,672,57.59%,23.66%,1
彰化縣,社頭鄉,0795,266,332,598,29,627,1235,50.77%,21.54%,1
彰化縣,社頭鄉,0796,208,214,422,35,457,750,60.93%,27.73%,1
彰化縣,社頭鄉,0797,219,246,465,27,492,895,54.97%,24.47%,1
彰化縣,社頭鄉,0798,169,229,398,13,411,688,59.74%,24.56%,1
彰化縣,社頭鄉,0799,223,255,478,22,500,870,57.47%,25.63%,1
彰化縣,社頭鄉,0800,264,393,657,28,685,1140,60.09%,23.16%,1
彰化縣,社頭鄉,0801,246,304,550,33,583,985,59.19%,24.97%,1
彰化縣,社頭鄉,0802,297,467,764,30,794,1266,62.72%,23.46%,1
彰化縣,社頭鄉,0803,224,311,535,22,557,937,59.45%,23.91%,1
彰化縣,社頭鄉,0804,252,411,663,29,692,1219,56.77%,20.67%,1
彰化縣,社頭鄉,0805,336,314,650,33,683,1165,58.63%,28.84%,1
彰化縣,社頭鄉,0806,252,311,563,30,593,986,60.14%,25.56%,1
彰化縣,社頭鄉,0807,176,258,434,24,458,724,63.26%,24.31%,1
彰化縣,社頭鄉,0808,208,357,565,27,592,1015,58.33%,20.49%,1
彰化縣,社頭鄉,0809,253,298,551,21,572,1116,51.25%,22.67%,1
彰化縣,社頭鄉,0810,275,262,537,42,579,1061,54.57%,25.92%,1
彰化縣,社頭鄉,0811,250,316,566,41,607,992,61.19%,25.2%,1
彰化縣,社頭鄉,0812,244,363,607,24,631,1092,57.78%,22.34%,1
彰化縣,社頭鄉,0813,245,238,483,31,514,828,62.08%,29.59%,1
彰化縣,社頭鄉,0814,192,202,394,35,429,787,54.51%,24.4%,1
彰化縣,社頭鄉,0815,158,186,344,18,362,719,50.35%,21.97%,1
彰化縣,二水鄉,0816,316,276,592,28,620,1028,60.31%,30.74%,1
彰化縣,二水鄉,0817,183,213,396,37,433,689,62.84%,26.56%,1
彰化縣,二水鄉,0818,190,265,455,22,477,871,54.76%,21.81%,1
彰化縣,二水鄉,0819,267,269,536,37,573,953,60.13%,28.02%,1
彰化縣,二水鄉,0820,153,169,322,24,346,624,55.45%,24.52%,1
彰化縣,二水鄉,0821,192,204,396,35,431,645,66.82%,29.77%,1
彰化縣,二水鄉,0822,248,362,610,33,643,986,65.21%,25.15%,1
彰化縣,二水鄉,0823,284,300,584,46,630,943,66.81%,30.12%,1
彰化縣,二水鄉,0824,121,157,278,12,290,455,63.74%,26.59%,1
彰化縣,二水鄉,0825,251,294,545,10,555,831,66.79%,30.2%,1
彰化縣,二水鄉,0826,262,230,492,29,521,831,62.7%,31.53%,1
彰化縣,二水鄉,0827,377,205,582,23,605,1013,59.72%,37.22%,1
彰化縣,二水鄉,0828,238,222,460,47,507,796,63.69%,29.9%,1
彰化縣,二水鄉,0829,179,243,422,39,461,781,59.03%,22.92%,1
彰化縣,二水鄉,0830,174,181,355,18,373,692,53.9%,25.14%,1
彰化縣,二水鄉,0831,157,202,359,16,375,635,59.06%,24.72%,1
彰化縣,二水鄉,0832,149,160,309,24,333,566,58.83%,26.33%,1
彰化縣,北斗鎮,0833,252,246,498,31,529,925,57.19%,27.24%,1
彰化縣,北斗鎮,0834,232,263,495,34,529,869,60.87%,26.7%,1
彰化縣,北斗鎮,0835,257,270,527,27,554,855,64.8%,30.06%,1
彰化縣,北斗鎮,0836,303,347,650,25,675,1065,63.38%,28.45%,1
彰化縣,北斗鎮,0837,239,226,465,47,512,828,61.84%,28.86%,1
彰化縣,北斗鎮,0838,289,359,648,32,680,1124,60.5%,25.71%,1
彰化縣,北斗鎮,0839,284,357,641,34,675,1096,61.59%,25.91%,1
彰化縣,北斗鎮,0840,340,380,720,22,742,1213,61.17%,28.03%,1
彰化縣,北斗鎮,0841,304,300,604,42,646,1164,55.5%,26.12%,1
彰化縣,北斗鎮,0842,177,219,396,26,422,730,57.81%,24.25%,1
彰化縣,北斗鎮,0843,205,268,473,25,498,878,56.72%,23.35%,1
彰化縣,北斗鎮,0844,212,285,497,20,517,833,62.06%,25.45%,1
彰化縣,北斗鎮,0845,231,315,546,24,570,957,59.56%,24.14%,1
彰化縣,北斗鎮,0846,185,241,426,20,446,783,56.96%,23.63%,1
彰化縣,北斗鎮,0847,164,140,304,18,322,573,56.2%,28.62%,1
彰化縣,北斗鎮,0848,188,191,379,20,399,672,59.38%,27.98%,1
彰化縣,北斗鎮,0849,187,174,361,21,382,695,54.96%,26.91%,1
彰化縣,北斗鎮,0850,181,204,385,22,407,747,54.48%,24.23%,1
彰化縣,北斗鎮,0851,159,241,400,17,417,643,64.85%,24.73%,1
彰化縣,北斗鎮,0852,155,224,379,26,405,662,61.18%,23.41%,1
彰化縣,北斗鎮,0853,219,442,661,38,699,1085,64.42%,20.18%,1
彰化縣,北斗鎮,0854,272,361,633,42,675,1121,60.21%,24.26%,1
彰化縣,北斗鎮,0855,219,264,483,26,509,830,61.33%,26.39%,1
彰化縣,北斗鎮,0856,203,313,516,30,546,975,56%,20.82%,1
彰化縣,北斗鎮,0857,271,366,637,24,661,1212,54.54%,22.36%,1
彰化縣,北斗鎮,0858,346,400,746,40,786,1302,60.37%,26.57%,1
彰化縣,北斗鎮,0859,253,266,519,27,546,1077,50.7%,23.49%,1
彰化縣,北斗鎮,0860,196,266,462,45,507,917,55.29%,21.37%,1
彰化縣,北斗鎮,0861,195,250,445,29,474,825,57.45%,23.64%,1
彰化縣,北斗鎮,0862,246,283,529,36,565,937,60.3%,26.25%,1
彰化縣,二林鎮,0942,149,152,301,17,318,731,43.5%,20.38%,1
彰化縣,二林鎮,0943,228,329,557,36,593,1025,57.85%,22.24%,1
彰化縣,二林鎮,0944,176,261,437,17,454,784,57.91%,22.45%,1
彰化縣,二林鎮,0945,212,275,487,33,520,892,58.3%,23.77%,1
彰化縣,二林鎮,0946,310,364,674,50,724,1256,57.64%,24.68%,1
彰化縣,二林鎮,0947,231,319,550,30,580,1043,55.61%,22.15%,1
彰化縣,二林鎮,0948,257,360,617,34,651,1076,60.5%,23.88%,1
彰化縣,二林鎮,0949,230,367,597,43,640,1082,59.15%,21.26%,1
彰化縣,二林鎮,0950,332,411,743,37,780,1427,54.66%,23.27%,1
彰化縣,二林鎮,0951,267,229,496,29,525,1030,50.97%,25.92%,1
彰化縣,二林鎮,0952,246,250,496,47,543,1033,52.57%,23.81%,1
彰化縣,二林鎮,0953,220,305,525,13,538,977,55.07%,22.52%,1
彰化縣,二林鎮,0954,135,198,333,20,353,683,51.68%,19.77%,1
彰化縣,二林鎮,0955,198,289,487,32,519,975,53.23%,20.31%,1
彰化縣,二林鎮,0956,297,259,556,49,605,1336,45.28%,22.23%,1
彰化縣,二林鎮,0957,221,233,454,34,488,1019,47.89%,21.69%,1
彰化縣,二林鎮,0958,169,240,409,37,446,1003,44.47%,16.85%,1
彰化縣,二林鎮,0959,241,381,622,35,657,1151,57.08%,20.94%,1
彰化縣,二林鎮,0960,362,474,836,76,912,1598,57.07%,22.65%,1
彰化縣,二林鎮,0961,291,456,747,45,792,1488,53.23%,19.56%,1
彰化縣,二林鎮,0962,417,551,968,41,1009,1771,56.97%,23.55%,1
彰化縣,二林鎮,0963,239,303,542,46,588,1360,43.24%,17.57%,1
彰化縣,二林鎮,0964,291,432,723,48,771,1613,47.8%,18.04%,1
彰化縣,二林鎮,0965,244,348,592,49,641,1228,52.2%,19.87%,1
彰化縣,二林鎮,0966,155,273,428,16,444,771,57.59%,20.1%,1
彰化縣,二林鎮,0967,211,276,487,26,513,858,59.79%,24.59%,1
彰化縣,二林鎮,0968,126,178,304,1,305,661,46.14%,19.06%,1
彰化縣,二林鎮,0969,278,293,571,63,634,1268,50%,21.92%,1
彰化縣,二林鎮,0970,232,300,532,17,549,1081,50.79%,21.46%,1
彰化縣,二林鎮,0971,241,346,587,18,605,1213,49.88%,19.87%,1
彰化縣,二林鎮,0972,271,425,696,49,745,1328,56.1%,20.41%,1
彰化縣,二林鎮,0973,218,264,482,52,534,1118,47.76%,19.5%,1
彰化縣,二林鎮,0974,225,275,500,35,535,1157,46.24%,19.45%,1
彰化縣,二林鎮,0975,187,262,449,31,480,972,49.38%,19.24%,1
彰化縣,二林鎮,0976,201,262,463,31,494,902,54.77%,22.28%,1
彰化縣,二林鎮,0977,352,407,759,51,810,1273,63.63%,27.65%,1
彰化縣,二林鎮,0978,112,452,564,26,590,1087,54.28%,10.3%,1
彰化縣,二林鎮,0979,274,276,550,54,604,987,61.2%,27.76%,1
彰化縣,二林鎮,0980,173,164,337,19,356,719,49.51%,24.06%,1
彰化縣,田尾鄉,0863,284,364,648,29,677,1284,52.73%,22.12%,1
彰化縣,田尾鄉,0864,322,378,700,33,733,1187,61.75%,27.13%,1
彰化縣,田尾鄉,0865,279,334,613,33,646,1033,62.54%,27.01%,1
彰化縣,田尾鄉,0866,156,246,402,26,428,696,61.49%,22.41%,1
彰化縣,田尾鄉,0867,235,297,532,19,551,872,63.19%,26.95%,1
彰化縣,田尾鄉,0868,169,190,359,25,384,680,56.47%,24.85%,1
彰化縣,田尾鄉,0869,237,289,526,32,558,875,63.77%,27.09%,1
彰化縣,田尾鄉,0870,364,355,719,32,751,1337,56.17%,27.23%,1
彰化縣,田尾鄉,0871,294,508,802,43,845,1376,61.41%,21.37%,1
彰化縣,田尾鄉,0872,260,441,701,38,739,1186,62.31%,21.92%,1
彰化縣,田尾鄉,0873,229,345,574,36,610,874,69.79%,26.2%,1
彰化縣,田尾鄉,0874,170,182,352,19,371,647,57.34%,26.28%,1
彰化縣,田尾鄉,0875,248,304,552,21,573,959,59.75%,25.86%,1
彰化縣,田尾鄉,0876,71,67,138,9,147,263,55.89%,27%,1
彰化縣,田尾鄉,0877,166,156,322,16,338,618,54.69%,26.86%,1
彰化縣,田尾鄉,0878,256,331,587,19,606,938,64.61%,27.29%,1
彰化縣,田尾鄉,0879,243,302,545,25,570,880,64.77%,27.61%,1
彰化縣,田尾鄉,0880,196,211,407,25,432,804,53.73%,24.38%,1
彰化縣,田尾鄉,0881,184,136,320,13,333,592,56.25%,31.08%,1
彰化縣,田尾鄉,0882,261,376,637,47,684,1079,63.39%,24.19%,1
彰化縣,田尾鄉,0883,364,370,734,47,781,1336,58.46%,27.25%,1
彰化縣,田尾鄉,0884,266,356,622,30,652,1198,54.42%,22.2%,1
彰化縣,田尾鄉,0885,167,166,333,23,356,621,57.33%,26.89%,1
彰化縣,田尾鄉,0886,180,217,397,21,418,760,55%,23.68%,1
彰化縣,田尾鄉,0887,333,331,664,42,706,1084,65.13%,30.72%,1
彰化縣,埤頭鄉,0888,253,295,548,34,582,1178,49.41%,21.48%,1
彰化縣,埤頭鄉,0889,263,390,653,43,696,1290,53.95%,20.39%,1
彰化縣,埤頭鄉,0890,246,263,509,31,540,973,55.5%,25.28%,1
彰化縣,埤頭鄉,0891,192,216,408,20,428,783,54.66%,24.52%,1
彰化縣,埤頭鄉,0892,177,211,388,30,418,733,57.03%,24.15%,1
彰化縣,埤頭鄉,0893,251,238,489,36,525,899,58.4%,27.92%,1
彰化縣,埤頭鄉,0894,201,306,507,38,545,965,56.48%,20.83%,1
彰化縣,埤頭鄉,0895,251,423,674,39,713,1356,52.58%,18.51%,1
彰化縣,埤頭鄉,0896,281,367,648,47,695,1265,54.94%,22.21%,1
彰化縣,埤頭鄉,0897,206,291,497,42,539,877,61.46%,23.49%,1
彰化縣,埤頭鄉,0898,166,184,350,32,382,705,54.18%,23.55%,1
彰化縣,埤頭鄉,0899,276,356,632,28,660,1062,62.15%,25.99%,1
彰化縣,埤頭鄉,0900,284,421,705,41,746,1300,57.38%,21.85%,1
彰化縣,埤頭鄉,0901,223,279,502,44,546,923,59.15%,24.16%,1
彰化縣,埤頭鄉,0902,223,320,543,18,561,1085,51.71%,20.55%,1
彰化縣,埤頭鄉,0903,222,398,620,34,654,1103,59.29%,20.13%,1
彰化縣,埤頭鄉,0904,162,209,371,15,386,735,52.52%,22.04%,1
彰化縣,埤頭鄉,0905,141,151,292,25,317,574,55.23%,24.56%,1
彰化縣,埤頭鄉,0906,142,214,356,32,388,767,50.59%,18.51%,1
彰化縣,埤頭鄉,0907,173,214,387,27,414,737,56.17%,23.47%,1
彰化縣,埤頭鄉,0908,294,189,483,44,527,1058,49.81%,27.79%,1
彰化縣,埤頭鄉,0909,190,184,374,53,427,826,51.69%,23%,1
彰化縣,埤頭鄉,0910,246,275,521,39,560,1082,51.76%,22.74%,1
彰化縣,埤頭鄉,0911,201,213,414,35,449,737,60.92%,27.27%,1
彰化縣,埤頭鄉,0912,161,200,361,12,373,711,52.46%,22.64%,1
彰化縣,埤頭鄉,0913,296,254,550,47,597,1043,57.24%,28.38%,1
彰化縣,埤頭鄉,0914,241,234,475,17,492,910,54.07%,26.48%,1
彰化縣,芳苑鄉,0998,159,143,302,38,340,940,36.17%,16.91%,1
彰化縣,芳苑鄉,0999,88,67,155,17,172,403,42.68%,21.84%,1
彰化縣,芳苑鄉,1000,166,186,352,29,381,756,50.4%,21.96%,1
彰化縣,芳苑鄉,1001,91,71,162,17,179,548,32.66%,16.61%,1
彰化縣,芳苑鄉,1002,205,281,486,39,525,997,52.66%,20.56%,1
彰化縣,芳苑鄉,1003,285,276,561,38,599,1300,46.08%,21.92%,1
彰化縣,芳苑鄉,1004,213,201,414,29,443,859,51.57%,24.8%,1
彰化縣,芳苑鄉,1005,148,214,362,13,375,734,51.09%,20.16%,1
彰化縣,芳苑鄉,1006,160,138,298,20,318,636,50%,25.16%,1
彰化縣,芳苑鄉,1007,216,147,363,40,403,808,49.88%,26.73%,1
彰化縣,芳苑鄉,1008,142,132,274,22,296,668,44.31%,21.26%,1
彰化縣,芳苑鄉,1009,158,194,352,26,378,744,50.81%,21.24%,1
彰化縣,芳苑鄉,1010,201,235,436,56,492,1026,47.95%,19.59%,1
彰化縣,芳苑鄉,1011,115,132,247,7,254,586,43.34%,19.62%,1
彰化縣,芳苑鄉,1012,150,148,298,17,315,593,53.12%,25.3%,1
彰化縣,芳苑鄉,1013,298,230,528,49,577,1071,53.87%,27.82%,1
彰化縣,芳苑鄉,1014,245,275,520,42,562,1060,53.02%,23.11%,1
彰化縣,芳苑鄉,1015,200,163,363,16,379,708,53.53%,28.25%,1
彰化縣,芳苑鄉,1016,169,155,324,46,370,735,50.34%,22.99%,1
彰化縣,芳苑鄉,1017,170,140,310,27,337,571,59.02%,29.77%,1
彰化縣,芳苑鄉,1018,152,136,288,27,315,729,43.21%,20.85%,1
彰化縣,芳苑鄉,1019,166,146,312,46,358,674,53.12%,24.63%,1
彰化縣,芳苑鄉,1020,307,190,497,41,538,846,63.59%,36.29%,1
彰化縣,芳苑鄉,1021,249,211,460,35,495,806,61.41%,30.89%,1
彰化縣,芳苑鄉,1022,93,92,185,14,199,470,42.34%,19.79%,1
彰化縣,芳苑鄉,1023,244,334,578,36,614,1124,54.63%,21.71%,1
彰化縣,芳苑鄉,1024,61,75,136,16,152,317,47.95%,19.24%,1
彰化縣,芳苑鄉,1025,230,243,473,34,507,1158,43.78%,19.86%,1
彰化縣,芳苑鄉,1026,205,238,443,28,471,967,48.71%,21.2%,1
彰化縣,芳苑鄉,1027,156,224,380,34,414,762,54.33%,20.47%,1
彰化縣,芳苑鄉,1028,200,242,442,37,479,1086,44.11%,18.42%,1
彰化縣,芳苑鄉,1029,146,206,352,16,368,747,49.26%,19.54%,1
彰化縣,芳苑鄉,1030,119,136,255,11,266,653,40.74%,18.22%,1
彰化縣,芳苑鄉,1031,228,258,486,38,524,872,60.09%,26.15%,1
彰化縣,芳苑鄉,1032,333,380,713,32,745,1235,60.32%,26.96%,1
彰化縣,芳苑鄉,1033,263,287,550,48,598,1102,54.26%,23.87%,1
彰化縣,大城鄉,0981,193,261,454,20,474,1288,36.8%,14.98%,1
彰化縣,大城鄉,0982,208,190,398,35,433,1104,39.22%,18.84%,1
彰化縣,大城鄉,0983,214,290,504,39,543,964,56.33%,22.2%,1
彰化縣,大城鄉,0984,226,351,577,36,613,1312,46.72%,17.23%,1
彰化縣,大城鄉,0985,128,197,325,43,368,853,43.14%,15.01%,1
彰化縣,大城鄉,0986,61,107,168,17,185,518,35.71%,11.78%,1
彰化縣,大城鄉,0987,116,122,238,13,251,574,43.73%,20.21%,1
彰化縣,大城鄉,0988,117,136,253,19,272,702,38.75%,16.67%,1
彰化縣,大城鄉,0989,52,54,106,15,121,376,32.18%,13.83%,1
彰化縣,大城鄉,0990,103,99,202,19,221,693,31.89%,14.86%,1
彰化縣,大城鄉,0991,170,186,356,29,385,877,43.9%,19.38%,1
彰化縣,大城鄉,0992,97,53,150,14,164,655,25.04%,14.81%,1
彰化縣,大城鄉,0993,158,244,402,21,423,1103,38.35%,14.32%,1
彰化縣,大城鄉,0994,181,220,401,24,425,1192,35.65%,15.18%,1
彰化縣,大城鄉,0995,132,197,329,32,361,917,39.37%,14.39%,1
彰化縣,大城鄉,0996,115,107,222,10,232,686,33.82%,16.76%,1
彰化縣,大城鄉,0997,156,144,300,21,321,899,35.71%,17.35%,1
彰化縣,竹塘鄉,1034,267,352,619,58,677,1168,57.96%,22.86%,1
彰化縣,竹塘鄉,1035,232,306,538,27,565,965,58.55%,24.04%,1
彰化縣,竹塘鄉,1036,232,320,552,47,599,960,62.4%,24.17%,1
彰化縣,竹塘鄉,1037,195,245,440,45,485,743,65.28%,26.24%,1
彰化縣,竹塘鄉,1038,135,180,315,25,340,751,45.27%,17.98%,1
彰化縣,竹塘鄉,1039,166,207,373,14,387,792,48.86%,20.96%,1
彰化縣,竹塘鄉,1040,187,156,343,13,356,733,48.57%,25.51%,1
彰化縣,竹塘鄉,1041,190,155,345,18,363,657,55.25%,28.92%,1
彰化縣,竹塘鄉,1042,243,312,555,29,584,1063,54.94%,22.86%,1
彰化縣,竹塘鄉,1043,277,317,594,48,642,1114,57.63%,24.87%,1
彰化縣,竹塘鄉,1044,151,167,318,26,344,506,67.98%,29.84%,1
彰化縣,竹塘鄉,1045,181,211,392,36,428,823,52%,21.99%,1
彰化縣,竹塘鄉,1046,169,159,328,21,349,654,53.36%,25.84%,1
彰化縣,竹塘鄉,1047,123,134,257,17,274,577,47.49%,21.32%,1
彰化縣,竹塘鄉,1048,201,200,401,20,421,772,54.53%,26.04%,1
彰化縣,竹塘鄉,1049,126,111,237,21,258,543,47.51%,23.2%,1
彰化縣,溪州鄉,0915,194,209,403,34,437,778,56.17%,24.94%,1
彰化縣,溪州鄉,0916,259,249,508,21,529,1061,49.86%,24.41%,1
彰化縣,溪州鄉,0917,171,152,323,24,347,701,49.5%,24.39%,1
彰化縣,溪州鄉,0918,286,230,516,29,545,879,62%,32.54%,1
彰化縣,溪州鄉,0919,206,197,403,28,431,654,65.9%,31.5%,1
彰化縣,溪州鄉,0920,238,251,489,20,509,878,57.97%,27.11%,1
彰化縣,溪州鄉,0921,242,300,542,38,580,942,61.57%,25.69%,1
彰化縣,溪州鄉,0922,233,236,469,29,498,871,57.18%,26.75%,1
彰化縣,溪州鄉,0923,270,262,532,25,557,1047,53.2%,25.79%,1
彰化縣,溪州鄉,0924,234,250,484,28,512,858,59.67%,27.27%,1
彰化縣,溪州鄉,0925,284,323,607,55,662,1409,46.98%,20.16%,1
彰化縣,溪州鄉,0926,191,219,410,16,426,792,53.79%,24.12%,1
彰化縣,溪州鄉,0927,187,164,351,37,388,714,54.34%,26.19%,1
彰化縣,溪州鄉,0928,247,261,508,35,543,1109,48.96%,22.27%,1
彰化縣,溪州鄉,0929,220,192,412,30,442,962,45.95%,22.87%,1
彰化縣,溪州鄉,0930,239,274,513,40,553,1157,47.8%,20.66%,1
彰化縣,溪州鄉,0931,234,232,466,29,495,952,52%,24.58%,1
彰化縣,溪州鄉,0932,218,239,457,23,480,887,54.11%,24.58%,1
彰化縣,溪州鄉,0933,182,163,345,41,386,866,44.57%,21.02%,1
彰化縣,溪州鄉,0934,240,209,449,40,489,1010,48.42%,23.76%,1
彰化縣,溪州鄉,0935,200,216,416,13,429,853,50.29%,23.45%,1
彰化縣,溪州鄉,0936,208,210,418,30,448,843,53.14%,24.67%,1
彰化縣,溪州鄉,0937,170,121,291,12,303,711,42.62%,23.91%,1
彰化縣,溪州鄉,0938,225,207,432,43,475,851,55.82%,26.44%,1
彰化縣,溪州鄉,0939,260,198,458,23,481,883,54.47%,29.45%,1
彰化縣,溪州鄉,0940,246,332,578,46,624,1247,50.04%,19.73%,1
彰化縣,溪州鄉,0941,426,370,796,39,835,1490,56.04%,28.59%,1
南投縣,南投市,0001,248,292,540,23,563,927,60.73%,26.75%,1
南投縣,南投市,0002,176,255,431,24,455,667,68.22%,26.39%,1
南投縣,南投市,0003,214,261,475,25,500,773,64.68%,27.68%,1
南投縣,南投市,0004,208,285,493,29,522,818,63.81%,25.43%,1
南投縣,南投市,0005,170,181,351,11,362,525,68.95%,32.38%,1
南投縣,南投市,0006,174,196,370,16,386,575,67.13%,30.26%,1
南投縣,南投市,0007,167,76,243,12,255,368,69.29%,45.38%,1
南投縣,南投市,0008,231,362,593,40,633,956,66.21%,24.16%,1
南投縣,南投市,0009,273,385,658,19,677,1245,54.38%,21.93%,1
南投縣,南投市,0010,288,556,844,26,870,1484,58.63%,19.41%,1
南投縣,南投市,0011,281,470,751,32,783,1191,65.74%,23.59%,1
南投縣,南投市,0012,357,530,887,37,924,1506,61.35%,23.71%,1
南投縣,南投市,0013,250,396,646,33,679,1070,63.46%,23.36%,1
南投縣,南投市,0014,160,240,400,26,426,670,63.58%,23.88%,1
南投縣,南投市,0015,305,366,671,30,701,1050,66.76%,29.05%,1
南投縣,南投市,0016,189,405,594,26,620,1122,55.26%,16.84%,1
南投縣,南投市,0017,269,262,531,27,558,984,56.71%,27.34%,1
南投縣,南投市,0018,252,431,683,21,704,1062,66.29%,23.73%,1
南投縣,南投市,0019,250,362,612,35,647,1053,61.44%,23.74%,1
南投縣,南投市,0020,421,241,662,40,702,1104,63.59%,38.13%,1
南投縣,南投市,0021,304,358,662,33,695,1192,58.31%,25.5%,1
南投縣,南投市,0022,225,303,528,26,554,960,57.71%,23.44%,1
南投縣,南投市,0023,219,307,526,33,559,906,61.7%,24.17%,1
南投縣,南投市,0024,244,319,563,39,602,957,62.9%,25.5%,1
南投縣,南投市,0025,351,258,609,46,655,997,65.7%,35.21%,1
南投縣,南投市,0026,275,333,608,27,635,1008,63%,27.28%,1
南投縣,南投市,0027,275,379,654,31,685,1164,58.85%,23.63%,1
南投縣,南投市,0028,146,190,336,15,351,587,59.8%,24.87%,1
南投縣,南投市,0029,192,199,391,32,423,734,57.63%,26.16%,1
南投縣,南投市,0030,186,229,415,18,433,724,59.81%,25.69%,1
南投縣,南投市,0031,244,339,583,20,603,1003,60.12%,24.33%,1
南投縣,南投市,0032,297,464,761,34,795,1356,58.63%,21.9%,1
南投縣,南投市,0033,307,435,742,40,782,1373,56.96%,22.36%,1
南投縣,南投市,0034,317,469,786,29,815,1452,56.13%,21.83%,1
南投縣,南投市,0035,72,134,206,5,211,362,58.29%,19.89%,1
南投縣,南投市,0036,92,132,224,15,239,389,61.44%,23.65%,1
南投縣,南投市,0037,320,476,796,37,833,1276,65.28%,25.08%,1
南投縣,南投市,0038,276,417,693,23,716,1089,65.75%,25.34%,1
南投縣,南投市,0039,231,340,571,27,598,921,64.93%,25.08%,1
南投縣,南投市,0040,209,396,605,22,627,892,70.29%,23.43%,1
南投縣,南投市,0041,202,472,674,25,699,1050,66.57%,19.24%,1
南投縣,南投市,0042,226,442,668,20,688,1078,63.82%,20.96%,1
南投縣,南投市,0043,189,460,649,18,667,1078,61.87%,17.53%,1
南投縣,南投市,0044,209,393,602,22,624,861,72.47%,24.27%,1
南投縣,南投市,0045,254,434,688,46,734,1221,60.11%,20.8%,1
南投縣,南投市,0046,261,373,634,33,667,1105,60.36%,23.62%,1
南投縣,南投市,0047,279,462,741,17,758,1230,61.63%,22.68%,1
南投縣,南投市,0048,226,426,652,23,675,1092,61.81%,20.7%,1
南投縣,南投市,0049,239,568,807,18,825,1286,64.15%,18.58%,1
南投縣,南投市,0050,187,246,433,22,455,655,69.47%,28.55%,1
南投縣,南投市,0051,206,242,448,26,474,719,65.92%,28.65%,1
南投縣,南投市,0052,196,223,419,17,436,720,60.56%,27.22%,1
南投縣,南投市,0053,118,217,335,13,348,509,68.37%,23.18%,1
南投縣,南投市,0054,64,209,273,10,283,492,57.52%,13.01%,1
南投縣,南投市,0055,93,271,364,15,379,616,61.53%,15.1%,1
南投縣,南投市,0056,145,477,622,20,642,1010,63.56%,14.36%,1
南投縣,南投市,0057,119,378,497,16,513,848,60.5%,14.03%,1
南投縣,南投市,0058,403,441,844,49,893,1387,64.38%,29.06%,1
南投縣,南投市,0059,325,460,785,19,804,1245,64.58%,26.1%,1
南投縣,南投市,0060,290,378,668,25,693,1199,57.8%,24.19%,1
南投縣,南投市,0061,327,432,759,40,799,1288,62.03%,25.39%,1
南投縣,南投市,0062,260,328,588,36,624,1040,60%,25%,1
南投縣,南投市,0063,268,368,636,31,667,1070,62.34%,25.05%,1
南投縣,南投市,0064,317,470,787,34,821,1299,63.2%,24.4%,1
南投縣,南投市,0065,254,441,695,24,719,1122,64.08%,22.64%,1
南投縣,南投市,0066,357,448,805,40,845,1414,59.76%,25.25%,1
南投縣,南投市,0067,263,383,646,32,678,1121,60.48%,23.46%,1
南投縣,南投市,0068,347,462,809,20,829,1434,57.81%,24.2%,1
南投縣,南投市,0069,297,449,746,27,773,1393,55.49%,21.32%,1
南投縣,南投市,0070,270,331,601,17,618,1059,58.36%,25.5%,1
南投縣,南投市,0071,297,390,687,23,710,1218,58.29%,24.38%,1
南投縣,南投市,0072,303,369,672,16,688,1293,53.21%,23.43%,1
南投縣,南投市,0073,255,397,652,32,684,1337,51.16%,19.07%,1
南投縣,南投市,0074,244,278,522,29,551,876,62.9%,27.85%,1
南投縣,南投市,0075,259,283,542,29,571,971,58.81%,26.67%,1
南投縣,南投市,0076,266,302,568,27,595,1012,58.79%,26.28%,1
南投縣,南投市,0077,223,296,519,33,552,973,56.73%,22.92%,1
南投縣,南投市,0078,264,327,591,35,626,1002,62.48%,26.35%,1
南投縣,南投市,0079,281,310,591,24,615,1024,60.06%,27.44%,1
南投縣,南投市,0080,298,243,541,57,598,1122,53.3%,26.56%,1
南投縣,南投市,0081,175,195,370,30,400,790,50.63%,22.15%,1
南投縣,南投市,0082,148,148,296,12,308,647,47.6%,22.87%,1
南投縣,南投市,0083,228,280,508,33,541,950,56.95%,24%,1
南投縣,南投市,0084,184,321,505,17,522,980,53.27%,18.78%,1
南投縣,埔里鎮,0085,192,291,483,24,507,828,61.23%,23.19%,1
南投縣,埔里鎮,0086,187,273,460,34,494,786,62.85%,23.79%,1
南投縣,埔里鎮,0087,243,340,583,26,609,1062,57.34%,22.88%,1
南投縣,埔里鎮,0088,297,425,722,27,749,1201,62.36%,24.73%,1
南投縣,埔里鎮,0089,268,515,783,22,805,1415,56.89%,18.94%,1
南投縣,埔里鎮,0090,268,428,696,29,725,1282,56.55%,20.9%,1
南投縣,埔里鎮,0091,160,319,479,18,497,859,57.86%,18.63%,1
南投縣,埔里鎮,0092,263,441,704,41,745,1288,57.84%,20.42%,1
南投縣,埔里鎮,0093,274,463,737,21,758,1330,56.99%,20.6%,1
南投縣,埔里鎮,0094,277,452,729,43,772,1416,54.52%,19.56%,1
南投縣,埔里鎮,0095,238,385,623,26,649,1283,50.58%,18.55%,1
南投縣,埔里鎮,0096,226,426,652,50,702,1151,60.99%,19.64%,1
南投縣,埔里鎮,0097,236,374,610,25,635,1193,53.23%,19.78%,1
南投縣,埔里鎮,0098,326,483,809,39,848,1471,57.65%,22.16%,1
南投縣,埔里鎮,0099,202,306,508,32,540,1044,51.72%,19.35%,1
南投縣,埔里鎮,0100,248,377,625,47,672,1122,59.89%,22.1%,1
南投縣,埔里鎮,0101,213,485,698,33,731,1129,64.75%,18.87%,1
南投縣,埔里鎮,0102,191,306,497,14,511,901,56.71%,21.2%,1
南投縣,埔里鎮,0103,246,278,524,29,553,997,55.47%,24.67%,1
南投縣,埔里鎮,0104,245,399,644,36,680,1209,56.24%,20.26%,1
南投縣,埔里鎮,0105,206,414,620,26,646,838,77.09%,24.58%,1
南投縣,埔里鎮,0106,227,371,598,22,620,1226,50.57%,18.52%,1
南投縣,埔里鎮,0107,281,489,770,26,796,1263,63.02%,22.25%,1
南投縣,埔里鎮,0108,232,378,610,29,639,1045,61.15%,22.2%,1
南投縣,埔里鎮,0109,258,421,679,23,702,1120,62.68%,23.04%,1
南投縣,埔里鎮,0110,254,412,666,30,696,1062,65.54%,23.92%,1
南投縣,埔里鎮,0111,212,364,576,27,603,1022,59%,20.74%,1
南投縣,埔里鎮,0112,239,348,587,15,602,1051,57.28%,22.74%,1
南投縣,埔里鎮,0113,221,398,619,19,638,1106,57.69%,19.98%,1
南投縣,埔里鎮,0114,220,401,621,14,635,1098,57.83%,20.04%,1
南投縣,埔里鎮,0115,237,379,616,19,635,1067,59.51%,22.21%,1
南投縣,埔里鎮,0116,214,183,397,36,433,725,59.72%,29.52%,1
南投縣,埔里鎮,0117,205,318,523,31,554,905,61.22%,22.65%,1
南投縣,埔里鎮,0118,242,364,606,40,646,1179,54.79%,20.53%,1
南投縣,埔里鎮,0119,159,305,464,33,497,944,52.65%,16.84%,1
南投縣,埔里鎮,0120,118,129,247,23,270,465,58.06%,25.38%,1
南投縣,埔里鎮,0121,237,379,616,30,646,1133,57.02%,20.92%,1
南投縣,埔里鎮,0122,218,346,564,38,602,1100,54.73%,19.82%,1
南投縣,埔里鎮,0123,235,406,641,36,677,1155,58.61%,20.35%,1
南投縣,埔里鎮,0124,242,399,641,37,678,1254,54.07%,19.3%,1
南投縣,埔里鎮,0125,249,408,657,49,706,1296,54.48%,19.21%,1
南投縣,埔里鎮,0126,285,360,645,20,665,1023,65%,27.86%,1
南投縣,埔里鎮,0127,165,299,464,15,479,964,49.69%,17.12%,1
南投縣,埔里鎮,0128,222,332,554,28,582,986,59.03%,22.52%,1
南投縣,埔里鎮,0129,196,396,592,23,615,1016,60.53%,19.29%,1
南投縣,埔里鎮,0130,211,291,502,35,537,898,59.8%,23.5%,1
南投縣,埔里鎮,0131,231,341,572,31,603,980,61.53%,23.57%,1
南投縣,埔里鎮,0132,211,335,546,18,564,933,60.45%,22.62%,1
南投縣,埔里鎮,0133,263,361,624,28,652,929,70.18%,28.31%,1
南投縣,埔里鎮,0134,210,357,567,23,590,1032,57.17%,20.35%,1
南投縣,埔里鎮,0135,45,104,149,10,159,315,50.48%,14.29%,1
南投縣,埔里鎮,0136,283,423,706,35,741,1363,54.37%,20.76%,1
南投縣,埔里鎮,0137,157,253,410,31,441,725,60.83%,21.66%,1
南投縣,埔里鎮,0138,167,233,400,29,429,705,60.85%,23.69%,1
南投縣,埔里鎮,0139,213,252,465,22,487,751,64.85%,28.36%,1
南投縣,埔里鎮,0140,186,326,512,22,534,932,57.3%,19.96%,1
南投縣,埔里鎮,0141,205,334,539,28,567,956,59.31%,21.44%,1
南投縣,埔里鎮,0142,91,107,198,17,215,376,57.18%,24.2%,1
南投縣,埔里鎮,0143,93,289,382,26,408,682,59.82%,13.64%,1
南投縣,埔里鎮,0144,155,458,613,37,650,990,65.66%,15.66%,1
南投縣,埔里鎮,0145,251,383,634,44,678,1324,51.21%,18.96%,1
南投縣,埔里鎮,0146,75,63,138,9,147,298,49.33%,25.17%,1
南投縣,埔里鎮,0147,228,396,624,41,665,1170,56.84%,19.49%,1
南投縣,埔里鎮,0148,133,220,353,14,367,604,60.76%,22.02%,1
南投縣,埔里鎮,0149,228,304,532,26,558,999,55.86%,22.82%,1
南投縣,埔里鎮,0150,189,290,479,12,491,923,53.2%,20.48%,1
南投縣,埔里鎮,0151,190,325,515,23,538,887,60.65%,21.42%,1
南投縣,埔里鎮,0152,219,293,512,30,542,981,55.25%,22.32%,1
南投縣,草屯鎮,0153,267,336,603,19,622,998,62.32%,26.75%,1
南投縣,草屯鎮,0154,248,369,617,13,630,1127,55.9%,22.01%,1
南投縣,草屯鎮,0155,278,472,750,19,769,1401,54.89%,19.84%,1
南投縣,草屯鎮,0156,284,325,609,20,629,1110,56.67%,25.59%,1
南投縣,草屯鎮,0157,104,626,730,36,766,1285,59.61%,8.09%,1
南投縣,草屯鎮,0158,218,303,521,23,544,936,58.12%,23.29%,1
南投縣,草屯鎮,0159,266,381,647,33,680,1141,59.6%,23.31%,1
南投縣,草屯鎮,0160,179,246,425,21,446,705,63.26%,25.39%,1
南投縣,草屯鎮,0161,332,371,703,14,717,1121,63.96%,29.62%,1
南投縣,草屯鎮,0162,253,311,564,18,582,877,66.36%,28.85%,1
南投縣,草屯鎮,0163,363,431,794,29,823,1401,58.74%,25.91%,1
南投縣,草屯鎮,0164,291,388,679,26,705,1267,55.64%,22.97%,1
南投縣,草屯鎮,0165,234,443,677,45,722,1214,59.47%,19.28%,1
南投縣,草屯鎮,0166,305,410,715,38,753,1259,59.81%,24.23%,1
南投縣,草屯鎮,0167,350,503,853,24,877,1442,60.82%,24.27%,1
南投縣,草屯鎮,0168,305,427,732,31,763,1273,59.94%,23.96%,1
南投縣,草屯鎮,0169,229,393,622,26,648,1145,56.59%,20%,1
南投縣,草屯鎮,0170,244,459,703,17,720,1279,56.29%,19.08%,1
南投縣,草屯鎮,0171,231,412,643,18,661,1158,57.08%,19.95%,1
南投縣,草屯鎮,0172,269,587,856,19,875,1335,65.54%,20.15%,1
南投縣,草屯鎮,0173,283,436,719,27,746,1178,63.33%,24.02%,1
南投縣,草屯鎮,0174,296,452,748,35,783,1327,59.01%,22.31%,1
南投縣,草屯鎮,0175,222,367,589,29,618,1000,61.8%,22.2%,1
南投縣,草屯鎮,0176,248,347,595,23,618,1257,49.16%,19.73%,1
南投縣,草屯鎮,0177,300,255,555,20,575,883,65.12%,33.98%,1
南投縣,草屯鎮,0178,231,373,604,19,623,1121,55.58%,20.61%,1
南投縣,草屯鎮,0179,221,370,591,30,621,1043,59.54%,21.19%,1
南投縣,草屯鎮,0180,233,361,594,14,608,979,62.1%,23.8%,1
南投縣,草屯鎮,0181,241,290,531,21,552,1048,52.67%,23%,1
南投縣,草屯鎮,0182,223,329,552,30,582,1009,57.68%,22.1%,1
南投縣,草屯鎮,0183,229,356,585,32,617,1138,54.22%,20.12%,1
南投縣,草屯鎮,0184,256,396,652,24,676,1197,56.47%,21.39%,1
南投縣,草屯鎮,0185,270,510,780,26,806,1364,59.09%,19.79%,1
南投縣,草屯鎮,0186,207,410,617,25,642,1059,60.62%,19.55%,1
南投縣,草屯鎮,0187,275,363,638,25,663,1108,59.84%,24.82%,1
南投縣,草屯鎮,0188,309,170,479,28,507,879,57.68%,35.15%,1
南投縣,草屯鎮,0189,218,319,537,30,567,957,59.25%,22.78%,1
南投縣,草屯鎮,0190,219,390,609,21,630,1395,45.16%,15.7%,1
南投縣,草屯鎮,0191,257,399,656,30,686,1101,62.31%,23.34%,1
南投縣,草屯鎮,0192,302,372,674,30,704,1297,54.28%,23.28%,1
南投縣,草屯鎮,0193,180,224,404,19,423,877,48.23%,20.52%,1
南投縣,草屯鎮,0194,264,365,629,55,684,1376,49.71%,19.19%,1
南投縣,草屯鎮,0195,260,371,631,24,655,1008,64.98%,25.79%,1
南投縣,草屯鎮,0196,271,376,647,27,674,1080,62.41%,25.09%,1
南投縣,草屯鎮,0197,254,289,543,32,575,1017,56.54%,24.98%,1
南投縣,草屯鎮,0198,287,301,588,27,615,961,64%,29.86%,1
南投縣,草屯鎮,0199,285,392,677,35,712,1160,61.38%,24.57%,1
南投縣,草屯鎮,0200,256,398,654,15,669,1121,59.68%,22.84%,1
南投縣,草屯鎮,0201,279,414,693,30,723,1243,58.17%,22.45%,1
南投縣,草屯鎮,0202,263,304,567,12,579,932,62.12%,28.22%,1
南投縣,草屯鎮,0203,385,449,834,37,871,1323,65.84%,29.1%,1
南投縣,草屯鎮,0204,325,464,789,18,807,1518,53.16%,21.41%,1
南投縣,草屯鎮,0205,300,270,570,33,603,923,65.33%,32.5%,1
南投縣,草屯鎮,0206,253,257,510,24,534,970,55.05%,26.08%,1
南投縣,草屯鎮,0207,293,298,591,19,610,1026,59.45%,28.56%,1
南投縣,草屯鎮,0208,374,421,795,39,834,1466,56.89%,25.51%,1
南投縣,草屯鎮,0209,260,400,660,20,680,1180,57.63%,22.03%,1
南投縣,草屯鎮,0210,404,200,604,12,616,1006,61.23%,40.16%,1
南投縣,草屯鎮,0211,211,284,495,17,512,1000,51.2%,21.1%,1
南投縣,草屯鎮,0212,253,412,665,26,691,1128,61.26%,22.43%,1
南投縣,草屯鎮,0213,158,194,352,8,360,623,57.78%,25.36%,1
南投縣,草屯鎮,0214,190,193,383,40,423,707,59.83%,26.87%,1
南投縣,草屯鎮,0215,199,186,385,19,404,719,56.19%,27.68%,1
南投縣,草屯鎮,0216,110,129,239,19,258,527,48.96%,20.87%,1
南投縣,草屯鎮,0217,308,366,674,40,714,1183,60.36%,26.04%,1
南投縣,草屯鎮,0218,247,277,524,29,553,869,63.64%,28.42%,1
南投縣,草屯鎮,0219,281,298,579,17,596,1132,52.65%,24.82%,1
南投縣,草屯鎮,0220,268,278,546,28,574,949,60.48%,28.24%,1
南投縣,草屯鎮,0221,246,324,570,17,587,965,60.83%,25.49%,1
南投縣,草屯鎮,0222,268,298,566,26,592,1068,55.43%,25.09%,1
南投縣,草屯鎮,0223,273,331,604,32,636,1024,62.11%,26.66%,1
南投縣,草屯鎮,0224,136,205,341,13,354,642,55.14%,21.18%,1
南投縣,草屯鎮,0225,226,293,519,23,542,1017,53.29%,22.22%,1
南投縣,草屯鎮,0226,228,377,605,23,628,1092,57.51%,20.88%,1
南投縣,草屯鎮,0227,264,378,642,38,680,1170,58.12%,22.56%,1
南投縣,草屯鎮,0228,245,401,646,24,670,1106,60.58%,22.15%,1
南投縣,竹山鎮,0229,290,381,671,37,708,1170,60.51%,24.79%,1
南投縣,竹山鎮,0230,222,286,508,30,538,850,63.29%,26.12%,1
南投縣,竹山鎮,0231,148,173,321,22,343,621,55.23%,23.83%,1
南投縣,竹山鎮,0232,207,276,483,30,513,905,56.69%,22.87%,1
南投縣,竹山鎮,0233,215,298,513,45,558,1099,50.77%,19.56%,1
南投縣,竹山鎮,0234,216,391,607,44,651,1214,53.62%,17.79%,1
南投縣,竹山鎮,0235,323,417,740,42,782,1287,60.76%,25.1%,1
南投縣,竹山鎮,0236,274,380,654,42,696,1191,58.44%,23.01%,1
南投縣,竹山鎮,0237,263,329,592,49,641,1118,57.33%,23.52%,1
南投縣,竹山鎮,0238,269,446,715,25,740,1278,57.9%,21.05%,1
南投縣,竹山鎮,0239,262,378,640,36,676,1153,58.63%,22.72%,1
南投縣,竹山鎮,0240,277,347,624,40,664,1243,53.42%,22.28%,1
南投縣,竹山鎮,0241,302,402,704,39,743,1308,56.8%,23.09%,1
南投縣,竹山鎮,0242,285,410,695,43,738,1358,54.34%,20.99%,1
南投縣,竹山鎮,0243,257,293,550,30,580,1044,55.56%,24.62%,1
南投縣,竹山鎮,0244,130,174,304,17,321,511,62.82%,25.44%,1
南投縣,竹山鎮,0245,134,230,364,11,375,682,54.99%,19.65%,1
南投縣,竹山鎮,0246,277,244,521,24,545,989,55.11%,28.01%,1
南投縣,竹山鎮,0247,326,411,737,36,773,1378,56.1%,23.66%,1
南投縣,竹山鎮,0248,42,67,109,6,115,217,53%,19.35%,1
南投縣,竹山鎮,0249,133,137,270,22,292,479,60.96%,27.77%,1
南投縣,竹山鎮,0250,84,123,207,9,216,430,50.23%,19.53%,1
南投縣,竹山鎮,0251,316,469,785,37,822,1437,57.2%,21.99%,1
南投縣,竹山鎮,0252,291,455,746,38,784,1286,60.96%,22.63%,1
南投縣,竹山鎮,0253,358,263,621,37,658,1080,60.93%,33.15%,1
南投縣,竹山鎮,0254,239,340,579,23,602,1070,56.26%,22.34%,1
南投縣,竹山鎮,0255,272,455,727,30,757,1295,58.46%,21%,1
南投縣,竹山鎮,0256,270,313,583,24,607,1047,57.98%,25.79%,1
南投縣,竹山鎮,0257,304,402,706,32,738,1300,56.77%,23.38%,1
南投縣,竹山鎮,0258,171,242,413,21,434,908,47.8%,18.83%,1
南投縣,竹山鎮,0259,190,198,388,34,422,821,51.4%,23.14%,1
南投縣,竹山鎮,0260,324,405,729,37,766,1320,58.03%,24.55%,1
南投縣,竹山鎮,0261,238,283,521,20,541,967,55.95%,24.61%,1
南投縣,竹山鎮,0262,168,134,302,14,316,595,53.11%,28.24%,1
南投縣,竹山鎮,0263,210,236,446,34,480,859,55.88%,24.45%,1
南投縣,竹山鎮,0264,281,330,611,40,651,1196,54.43%,23.49%,1
南投縣,竹山鎮,0265,159,182,341,32,373,649,57.47%,24.5%,1
南投縣,竹山鎮,0266,333,405,738,30,768,1341,57.27%,24.83%,1
南投縣,竹山鎮,0267,286,325,611,39,650,1222,53.19%,23.4%,1
南投縣,竹山鎮,0268,151,181,332,18,350,602,58.14%,25.08%,1
南投縣,竹山鎮,0269,147,183,330,16,346,617,56.08%,23.82%,1
南投縣,竹山鎮,0270,195,263,458,38,496,793,62.55%,24.59%,1
南投縣,竹山鎮,0271,248,277,525,19,544,922,59%,26.9%,1
南投縣,竹山鎮,0272,80,99,179,17,196,366,53.55%,21.86%,1
南投縣,竹山鎮,0273,79,166,245,6,251,509,49.31%,15.52%,1
南投縣,竹山鎮,0274,32,74,106,5,111,193,57.51%,16.58%,1
南投縣,竹山鎮,0275,91,147,238,15,253,406,62.32%,22.41%,1
南投縣,竹山鎮,0276,114,121,235,19,254,495,51.31%,23.03%,1
南投縣,竹山鎮,0277,58,54,112,8,120,307,39.09%,18.89%,1
南投縣,竹山鎮,0278,92,132,224,15,239,440,54.32%,20.91%,1
南投縣,竹山鎮,0279,122,163,285,29,314,577,54.42%,21.14%,1
南投縣,竹山鎮,0280,95,92,187,27,214,486,44.03%,19.55%,1
南投縣,竹山鎮,0281,60,79,139,9,148,403,36.72%,14.89%,1
南投縣,集集鎮,0282,239,400,639,26,665,1070,62.15%,22.34%,1
南投縣,集集鎮,0283,209,330,539,23,562,918,61.22%,22.77%,1
南投縣,集集鎮,0284,142,198,340,17,357,581,61.45%,24.44%,1
南投縣,集集鎮,0285,328,359,687,32,719,1194,60.22%,27.47%,1
南投縣,集集鎮,0286,96,113,209,16,225,488,46.11%,19.67%,1
南投縣,集集鎮,0287,126,163,289,24,313,504,62.1%,25%,1
南投縣,集集鎮,0288,229,306,535,30,565,910,62.09%,25.16%,1
南投縣,集集鎮,0289,186,272,458,30,488,773,63.13%,24.06%,1
南投縣,集集鎮,0290,180,212,392,18,410,709,57.83%,25.39%,1
南投縣,集集鎮,0291,220,327,547,18,565,960,58.85%,22.92%,1
南投縣,集集鎮,0292,99,162,261,17,278,503,55.27%,19.68%,1
南投縣,集集鎮,0293,70,127,197,16,213,419,50.84%,16.71%,1
南投縣,集集鎮,0294,111,160,271,8,279,582,47.94%,19.07%,1
南投縣,名間鄉,0295,302,399,701,31,732,1050,69.71%,28.76%,1
南投縣,名間鄉,0296,237,294,531,31,562,920,61.09%,25.76%,1
南投縣,名間鄉,0297,218,231,449,29,478,727,65.75%,29.99%,1
南投縣,名間鄉,0298,235,301,536,13,549,861,63.76%,27.29%,1
南投縣,名間鄉,0299,220,279,499,28,527,897,58.75%,24.53%,1
南投縣,名間鄉,0300,282,333,615,36,651,1055,61.71%,26.73%,1
南投縣,名間鄉,0301,292,372,664,34,698,1184,58.95%,24.66%,1
南投縣,名間鄉,0302,202,224,426,20,446,783,56.96%,25.8%,1
南投縣,名間鄉,0303,193,278,471,27,498,781,63.76%,24.71%,1
南投縣,名間鄉,0304,259,272,531,33,564,977,57.73%,26.51%,1
南投縣,名間鄉,0305,244,294,538,38,576,1015,56.75%,24.04%,1
南投縣,名間鄉,0306,254,299,553,16,569,914,62.25%,27.79%,1
南投縣,名間鄉,0307,291,333,624,11,635,1028,61.77%,28.31%,1
南投縣,名間鄉,0308,285,306,591,32,623,1018,61.2%,28%,1
南投縣,名間鄉,0309,331,371,702,54,756,1274,59.34%,25.98%,1
南投縣,名間鄉,0310,226,200,426,30,456,755,60.4%,29.93%,1
南投縣,名間鄉,0311,254,301,555,37,592,895,66.15%,28.38%,1
南投縣,名間鄉,0312,174,329,503,24,527,892,59.08%,19.51%,1
南投縣,名間鄉,0313,264,249,513,41,554,951,58.25%,27.76%,1
南投縣,名間鄉,0314,328,366,694,36,730,1261,57.89%,26.01%,1
南投縣,名間鄉,0315,195,216,411,34,445,768,57.94%,25.39%,1
南投縣,名間鄉,0316,318,237,555,31,586,962,60.91%,33.06%,1
南投縣,名間鄉,0317,253,264,517,28,545,867,62.86%,29.18%,1
南投縣,名間鄉,0318,273,261,534,35,569,930,61.18%,29.35%,1
南投縣,名間鄉,0319,165,188,353,39,392,641,61.15%,25.74%,1
南投縣,名間鄉,0320,144,129,273,14,287,530,54.15%,27.17%,1
南投縣,名間鄉,0321,262,266,528,36,564,931,60.58%,28.14%,1
南投縣,名間鄉,0322,285,350,635,36,671,1127,59.54%,25.29%,1
南投縣,名間鄉,0323,150,122,272,25,297,443,67.04%,33.86%,1
南投縣,名間鄉,0324,242,265,507,31,538,870,61.84%,27.82%,1
南投縣,名間鄉,0325,174,197,371,24,395,621,63.61%,28.02%,1
南投縣,名間鄉,0326,295,334,629,28,657,1179,55.73%,25.02%,1
南投縣,名間鄉,0327,195,322,517,41,558,881,63.34%,22.13%,1
南投縣,名間鄉,0328,216,347,563,35,598,876,68.26%,24.66%,1
南投縣,名間鄉,0329,199,246,445,33,478,783,61.05%,25.42%,1
南投縣,名間鄉,0330,167,238,405,21,426,778,54.76%,21.47%,1
南投縣,名間鄉,0331,246,263,509,39,548,983,55.75%,25.03%,1
南投縣,鹿谷鄉,0332,177,290,467,17,484,934,51.82%,18.95%,1
南投縣,鹿谷鄉,0333,229,279,508,35,543,940,57.77%,24.36%,1
南投縣,鹿谷鄉,0334,183,256,439,19,458,852,53.76%,21.48%,1
南投縣,鹿谷鄉,0335,97,115,212,17,229,451,50.78%,21.51%,1
南投縣,鹿谷鄉,0336,180,290,470,27,497,810,61.36%,22.22%,1
南投縣,鹿谷鄉,0337,229,439,668,44,712,1142,62.35%,20.05%,1
南投縣,鹿谷鄉,0338,143,230,373,11,384,766,50.13%,18.67%,1
南投縣,鹿谷鄉,0339,203,288,491,32,523,884,59.16%,22.96%,1
南投縣,鹿谷鄉,0340,203,239,442,24,466,811,57.46%,25.03%,1
南投縣,鹿谷鄉,0341,106,151,257,22,279,581,48.02%,18.24%,1
南投縣,鹿谷鄉,0342,122,162,284,15,299,578,51.73%,21.11%,1
南投縣,鹿谷鄉,0343,113,150,263,16,279,467,59.74%,24.2%,1
南投縣,鹿谷鄉,0344,132,192,324,23,347,622,55.79%,21.22%,1
南投縣,鹿谷鄉,0345,171,205,376,19,395,740,53.38%,23.11%,1
南投縣,鹿谷鄉,0346,146,265,411,23,434,767,56.58%,19.04%,1
南投縣,鹿谷鄉,0347,210,292,502,32,534,909,58.75%,23.1%,1
南投縣,鹿谷鄉,0348,126,230,356,18,374,713,52.45%,17.67%,1
南投縣,鹿谷鄉,0349,118,199,317,22,339,717,47.28%,16.46%,1
南投縣,鹿谷鄉,0350,188,195,383,32,415,794,52.27%,23.68%,1
南投縣,鹿谷鄉,0351,188,181,369,20,389,726,53.58%,25.9%,1
南投縣,鹿谷鄉,0352,164,154,318,22,340,737,46.13%,22.25%,1
南投縣,中寮鄉,0353,246,241,487,21,508,822,61.8%,29.93%,1
南投縣,中寮鄉,0354,69,80,149,6,155,253,61.26%,27.27%,1
南投縣,中寮鄉,0355,37,54,91,5,96,221,43.44%,16.74%,1
南投縣,中寮鄉,0356,74,91,165,5,170,353,48.16%,20.96%,1
南投縣,中寮鄉,0357,107,111,218,19,237,427,55.5%,25.06%,1
南投縣,中寮鄉,0358,98,123,221,10,231,406,56.9%,24.14%,1
南投縣,中寮鄉,0359,54,94,148,18,166,307,54.07%,17.59%,1
南投縣,中寮鄉,0360,170,208,378,25,403,661,60.97%,25.72%,1
南投縣,中寮鄉,0361,85,97,182,11,193,290,66.55%,29.31%,1
南投縣,中寮鄉,0362,246,298,544,29,573,973,58.89%,25.28%,1
南投縣,中寮鄉,0363,186,242,428,28,456,754,60.48%,24.67%,1
南投縣,中寮鄉,0364,138,213,351,17,368,662,55.59%,20.85%,1
南投縣,中寮鄉,0365,114,118,232,11,243,490,49.59%,23.27%,1
南投縣,中寮鄉,0366,83,76,159,18,177,335,52.84%,24.78%,1
南投縣,中寮鄉,0367,184,364,548,28,576,990,58.18%,18.59%,1
南投縣,中寮鄉,0368,117,168,285,17,302,461,65.51%,25.38%,1
南投縣,中寮鄉,0369,171,194,365,20,385,614,62.7%,27.85%,1
南投縣,中寮鄉,0370,223,261,484,27,511,895,57.09%,24.92%,1
南投縣,中寮鄉,0371,114,126,240,28,268,465,57.63%,24.52%,1
南投縣,中寮鄉,0372,177,187,364,40,404,682,59.24%,25.95%,1
南投縣,中寮鄉,0373,150,130,280,23,303,490,61.84%,30.61%,1
南投縣,中寮鄉,0374,156,211,367,32,399,643,62.05%,24.26%,1
南投縣,中寮鄉,0375,129,144,273,14,287,459,62.53%,28.1%,1
南投縣,中寮鄉,0376,99,151,250,17,267,528,50.57%,18.75%,1
南投縣,魚池鄉,0377,239,269,508,29,537,922,58.24%,25.92%,1
南投縣,魚池鄉,0378,262,333,595,54,649,1098,59.11%,23.86%,1
南投縣,魚池鄉,0379,147,220,367,21,388,720,53.89%,20.42%,1
南投縣,魚池鄉,0380,188,289,477,30,507,860,58.95%,21.86%,1
南投縣,魚池鄉,0381,120,133,253,15,268,514,52.14%,23.35%,1
南投縣,魚池鄉,0382,124,158,282,11,293,574,51.05%,21.6%,1
南投縣,魚池鄉,0383,277,362,639,42,681,1249,54.52%,22.18%,1
南投縣,魚池鄉,0384,82,104,186,10,196,293,66.89%,27.99%,1
南投縣,魚池鄉,0385,113,155,268,13,281,513,54.78%,22.03%,1
南投縣,魚池鄉,0386,54,45,99,4,103,186,55.38%,29.03%,1
南投縣,魚池鄉,0387,170,262,432,22,454,841,53.98%,20.21%,1
南投縣,魚池鄉,0388,90,66,156,14,170,270,62.96%,33.33%,1
南投縣,魚池鄉,0389,66,81,147,8,155,275,56.36%,24%,1
南投縣,魚池鄉,0390,48,79,127,10,137,282,48.58%,17.02%,1
南投縣,魚池鄉,0391,94,97,191,8,199,392,50.77%,23.98%,1
南投縣,魚池鄉,0392,101,184,285,26,311,556,55.94%,18.17%,1
南投縣,魚池鄉,0393,32,59,91,8,99,176,56.25%,18.18%,1
南投縣,魚池鄉,0394,131,123,254,22,276,578,47.75%,22.66%,1
南投縣,魚池鄉,0395,86,125,211,13,224,439,51.03%,19.59%,1
南投縣,魚池鄉,0396,153,319,472,22,494,844,58.53%,18.13%,1
南投縣,魚池鄉,0397,186,259,445,29,474,868,54.61%,21.43%,1
南投縣,魚池鄉,0398,65,119,184,7,191,405,47.16%,16.05%,1
南投縣,魚池鄉,0399,130,161,291,16,307,537,57.17%,24.21%,1
南投縣,魚池鄉,0400,79,96,175,11,186,335,55.52%,23.58%,1
南投縣,魚池鄉,0401,33,61,94,10,104,231,45.02%,14.29%,1
南投縣,國姓鄉,0402,257,315,572,31,603,964,62.55%,26.66%,1
南投縣,國姓鄉,0403,163,241,404,16,420,736,57.07%,22.15%,1
南投縣,國姓鄉,0404,176,266,442,35,477,801,59.55%,21.97%,1
南投縣,國姓鄉,0405,215,333,548,13,561,964,58.2%,22.3%,1
南投縣,國姓鄉,0406,147,227,374,16,390,686,56.85%,21.43%,1
南投縣,國姓鄉,0407,137,196,333,29,362,661,54.77%,20.73%,1
南投縣,國姓鄉,0408,127,217,344,40,384,730,52.6%,17.4%,1
南投縣,國姓鄉,0409,168,233,401,36,437,774,56.46%,21.71%,1
南投縣,國姓鄉,0410,169,244,413,14,427,706,60.48%,23.94%,1
南投縣,國姓鄉,0411,206,354,560,22,582,1012,57.51%,20.36%,1
南投縣,國姓鄉,0412,171,228,399,19,418,868,48.16%,19.7%,1
南投縣,國姓鄉,0413,162,382,544,19,563,918,61.33%,17.65%,1
南投縣,國姓鄉,0414,193,311,504,34,538,937,57.42%,20.6%,1
南投縣,國姓鄉,0415,286,239,525,36,561,815,68.83%,35.09%,1
南投縣,國姓鄉,0416,247,405,652,32,684,1134,60.32%,21.78%,1
南投縣,國姓鄉,0417,155,226,381,18,399,714,55.88%,21.71%,1
南投縣,國姓鄉,0418,239,375,614,37,651,1095,59.45%,21.83%,1
南投縣,國姓鄉,0419,96,129,225,18,243,448,54.24%,21.43%,1
南投縣,國姓鄉,0420,179,352,531,44,575,1064,54.04%,16.82%,1
南投縣,國姓鄉,0421,103,179,282,19,301,570,52.81%,18.07%,1
南投縣,水里鄉,0422,152,252,404,19,423,757,55.88%,20.08%,1
南投縣,水里鄉,0423,135,153,288,26,314,554,56.68%,24.37%,1
南投縣,水里鄉,0424,256,294,550,27,577,999,57.76%,25.63%,1
南投縣,水里鄉,0425,122,197,319,13,332,616,53.9%,19.81%,1
南投縣,水里鄉,0426,188,324,512,17,529,875,60.46%,21.49%,1
南投縣,水里鄉,0427,116,179,295,6,301,480,62.71%,24.17%,1
南投縣,水里鄉,0428,107,125,232,18,250,450,55.56%,23.78%,1
南投縣,水里鄉,0429,140,176,316,40,356,643,55.37%,21.77%,1
南投縣,水里鄉,0430,229,342,571,20,591,1004,58.86%,22.81%,1
南投縣,水里鄉,0431,167,227,394,15,409,741,55.2%,22.54%,1
南投縣,水里鄉,0432,198,267,465,8,473,802,58.98%,24.69%,1
南投縣,水里鄉,0433,240,370,610,35,645,998,64.63%,24.05%,1
南投縣,水里鄉,0434,187,227,414,29,443,800,55.38%,23.38%,1
南投縣,水里鄉,0435,137,213,350,19,369,589,62.65%,23.26%,1
南投縣,水里鄉,0436,175,264,439,29,468,887,52.76%,19.73%,1
南投縣,水里鄉,0437,222,387,609,29,638,1217,52.42%,18.24%,1
南投縣,水里鄉,0438,32,43,75,4,79,205,38.54%,15.61%,1
南投縣,水里鄉,0439,71,120,191,18,209,330,63.33%,21.52%,1
南投縣,水里鄉,0440,196,367,563,24,587,1100,53.36%,17.82%,1
南投縣,水里鄉,0441,41,52,93,7,100,275,36.36%,14.91%,1
南投縣,水里鄉,0442,68,71,139,6,145,318,45.6%,21.38%,1
南投縣,水里鄉,0443,211,198,409,49,458,818,55.99%,25.79%,1
南投縣,信義鄉,0444,385,228,613,70,683,1201,56.87%,32.06%,1
南投縣,信義鄉,0445,61,109,170,7,177,329,53.8%,18.54%,1
南投縣,信義鄉,0446,120,146,266,15,281,516,54.46%,23.26%,1
南投縣,信義鄉,0447,91,99,190,16,206,424,48.58%,21.46%,1
南投縣,信義鄉,0448,75,92,167,2,169,321,52.65%,23.36%,1
南投縣,信義鄉,0449,156,227,383,16,399,648,61.57%,24.07%,1
南投縣,信義鄉,0450,125,234,359,73,432,584,73.97%,21.4%,1
南投縣,信義鄉,0451,159,248,407,17,424,1376,30.81%,11.56%,1
南投縣,信義鄉,0452,198,273,471,23,494,979,50.46%,20.22%,1
南投縣,信義鄉,0453,162,188,350,42,392,530,73.96%,30.57%,1
南投縣,信義鄉,0454,199,274,473,33,506,961,52.65%,20.71%,1
南投縣,信義鄉,0455,99,147,246,10,256,464,55.17%,21.34%,1
南投縣,信義鄉,0456,123,158,281,27,308,517,59.57%,23.79%,1
南投縣,信義鄉,0457,34,51,85,5,90,149,60.4%,22.82%,1
南投縣,信義鄉,0458,242,404,646,118,764,1020,74.9%,23.73%,1
南投縣,信義鄉,0459,181,335,516,122,638,929,68.68%,19.48%,1
南投縣,信義鄉,0460,54,68,122,6,128,274,46.72%,19.71%,1
南投縣,信義鄉,0461,152,439,591,43,634,900,70.44%,16.89%,1
南投縣,信義鄉,0462,123,299,422,29,451,617,73.1%,19.94%,1
南投縣,信義鄉,0463,116,219,335,30,365,560,65.18%,20.71%,1
南投縣,仁愛鄉,0464,368,157,525,23,548,973,56.32%,37.82%,1
南投縣,仁愛鄉,0465,61,80,141,9,150,296,50.68%,20.61%,1
南投縣,仁愛鄉,0466,310,143,453,9,462,900,51.33%,34.44%,1
南投縣,仁愛鄉,0467,80,205,285,13,298,460,64.78%,17.39%,1
南投縣,仁愛鄉,0468,70,106,176,7,183,305,60%,22.95%,1
南投縣,仁愛鄉,0469,2,17,19,1,20,58,34.48%,3.45%,1
南投縣,仁愛鄉,0470,121,399,520,3,523,952,54.94%,12.71%,1
南投縣,仁愛鄉,0471,112,187,299,4,303,679,44.62%,16.49%,1
南投縣,仁愛鄉,0472,101,225,326,43,369,623,59.23%,16.21%,1
南投縣,仁愛鄉,0473,80,138,218,6,224,597,37.52%,13.4%,1
南投縣,仁愛鄉,0474,80,149,229,20,249,384,64.84%,20.83%,1
南投縣,仁愛鄉,0475,16,44,60,2,62,121,51.24%,13.22%,1
南投縣,仁愛鄉,0476,46,116,162,2,164,264,62.12%,17.42%,1
南投縣,仁愛鄉,0477,85,276,361,19,380,509,74.66%,16.7%,1
南投縣,仁愛鄉,0478,48,140,188,19,207,338,61.24%,14.2%,1
南投縣,仁愛鄉,0479,49,41,90,2,92,169,54.44%,28.99%,1
南投縣,仁愛鄉,0480,75,196,271,22,293,613,47.8%,12.23%,1
南投縣,仁愛鄉,0481,67,114,181,9,190,404,47.03%,16.58%,1
南投縣,仁愛鄉,0482,19,56,75,3,78,134,58.21%,14.18%,1
南投縣,仁愛鄉,0483,119,241,360,44,404,630,64.13%,18.89%,1
南投縣,仁愛鄉,0484,123,218,341,17,358,763,46.92%,16.12%,1
南投縣,仁愛鄉,0485,110,433,543,35,578,889,65.02%,12.37%,1
南投縣,仁愛鄉,0486,116,287,403,37,440,672,65.48%,17.26%,1
南投縣,仁愛鄉,0487,75,184,259,15,274,447,61.3%,16.78%,1
南投縣,仁愛鄉,0488,65,234,299,6,305,409,74.57%,15.89%,1
雲林縣,斗六市,0411,185,179,364,10,374,644,58.07%,28.73%,1
雲林縣,斗六市,0412,161,171,332,23,355,617,57.54%,26.09%,1
雲林縣,斗六市,0413,221,257,478,26,504,764,65.97%,28.93%,1
雲林縣,斗六市,0414,231,243,474,20,494,784,63.01%,29.46%,1
雲林縣,斗六市,0415,216,212,428,19,447,760,58.82%,28.42%,1
雲林縣,斗六市,0416,417,672,1089,48,1137,1881,60.45%,22.17%,1
雲林縣,斗六市,0417,399,568,967,39,1006,1829,55%,21.82%,1
雲林縣,斗六市,0418,309,457,766,23,789,1255,62.87%,24.62%,1
雲林縣,斗六市,0419,271,421,692,14,706,1090,64.77%,24.86%,1
雲林縣,斗六市,0420,277,374,651,24,675,1103,61.2%,25.11%,1
雲林縣,斗六市,0421,238,449,687,24,711,1176,60.46%,20.24%,1
雲林縣,斗六市,0422,330,526,856,19,875,1529,57.23%,21.58%,1
雲林縣,斗六市,0423,306,460,766,36,802,1335,60.07%,22.92%,1
雲林縣,斗六市,0424,393,610,1003,31,1034,1770,58.42%,22.2%,1
雲林縣,斗六市,0425,324,418,742,21,763,1308,58.33%,24.77%,1
雲林縣,斗六市,0426,492,650,1142,51,1193,2171,54.95%,22.66%,1
雲林縣,斗六市,0427,293,408,701,20,721,1193,60.44%,24.56%,1
雲林縣,斗六市,0428,341,596,937,35,972,1572,61.83%,21.69%,1
雲林縣,斗六市,0429,251,305,556,21,577,1009,57.19%,24.88%,1
雲林縣,斗六市,0430,280,424,704,38,742,1195,62.09%,23.43%,1
雲林縣,斗六市,0431,351,468,819,48,867,1415,61.27%,24.81%,1
雲林縣,斗六市,0432,315,325,640,32,672,1101,61.04%,28.61%,1
雲林縣,斗六市,0433,394,521,915,31,946,1648,57.4%,23.91%,1
雲林縣,斗六市,0434,348,476,824,26,850,1588,53.53%,21.91%,1
雲林縣,斗六市,0435,323,489,812,20,832,1392,59.77%,23.2%,1
雲林縣,斗六市,0436,322,485,807,34,841,1422,59.14%,22.64%,1
雲林縣,斗六市,0437,227,349,576,25,601,1187,50.63%,19.12%,1
雲林縣,斗六市,0438,271,303,574,26,600,1142,52.54%,23.73%,1
雲林縣,斗六市,0439,318,526,844,39,883,1421,62.14%,22.38%,1
雲林縣,斗六市,0440,270,421,691,34,725,1261,57.49%,21.41%,1
雲林縣,斗六市,0441,297,492,789,26,815,1506,54.12%,19.72%,1
雲林縣,斗六市,0442,322,408,730,25,755,1214,62.19%,26.52%,1
雲林縣,斗六市,0443,342,485,827,43,870,1362,63.88%,25.11%,1
雲林縣,斗六市,0444,267,351,618,20,638,1097,58.16%,24.34%,1
雲林縣,斗六市,0445,276,443,719,27,746,1262,59.11%,21.87%,1
雲林縣,斗六市,0446,258,368,626,21,647,1154,56.07%,22.36%,1
雲林縣,斗六市,0447,195,290,485,28,513,847,60.57%,23.02%,1
雲林縣,斗六市,0448,315,491,806,33,839,1439,58.3%,21.89%,1
雲林縣,斗六市,0449,460,568,1028,35,1063,1747,60.85%,26.33%,1
雲林縣,斗六市,0450,347,443,790,32,822,1418,57.97%,24.47%,1
雲林縣,斗六市,0451,233,368,601,28,629,1112,56.56%,20.95%,1
雲林縣,斗六市,0452,298,428,726,29,755,1302,57.99%,22.89%,1
雲林縣,斗六市,0453,170,242,412,19,431,669,64.42%,25.41%,1
雲林縣,斗六市,0454,183,236,419,23,442,752,58.78%,24.34%,1
雲林縣,斗六市,0455,296,483,779,22,801,1450,55.24%,20.41%,1
雲林縣,斗六市,0456,165,144,309,16,325,555,58.56%,29.73%,1
雲林縣,斗六市,0457,296,439,735,41,776,1470,52.79%,20.14%,1
雲林縣,斗六市,0458,230,314,544,18,562,927,60.63%,24.81%,1
雲林縣,斗六市,0459,432,640,1072,40,1112,1893,58.74%,22.82%,1
雲林縣,斗六市,0460,439,503,942,52,994,1708,58.2%,25.7%,1
雲林縣,斗六市,0461,350,502,852,37,889,1773,50.14%,19.74%,1
雲林縣,斗六市,0462,301,510,811,29,840,1412,59.49%,21.32%,1
雲林縣,斗六市,0463,358,450,808,35,843,1354,62.26%,26.44%,1
雲林縣,斗六市,0464,330,379,709,33,742,1267,58.56%,26.05%,1
雲林縣,斗六市,0465,299,400,699,13,712,1273,55.93%,23.49%,1
雲林縣,斗六市,0466,368,473,841,72,913,1748,52.23%,21.05%,1
雲林縣,斗六市,0467,319,367,686,49,735,1238,59.37%,25.77%,1
雲林縣,斗六市,0468,381,475,856,34,890,1648,54%,23.12%,1
雲林縣,斗六市,0469,371,512,883,39,922,1520,60.66%,24.41%,1
雲林縣,斗六市,0470,309,275,584,21,605,1087,55.66%,28.43%,1
雲林縣,斗六市,0471,454,563,1017,68,1085,1904,56.99%,23.84%,1
雲林縣,斗六市,0472,212,198,410,29,439,702,62.54%,30.2%,1
雲林縣,斗六市,0473,297,318,615,41,656,1111,59.05%,26.73%,1
雲林縣,斗六市,0474,278,268,546,27,573,1123,51.02%,24.76%,1
雲林縣,斗六市,0475,263,335,598,33,631,1146,55.06%,22.95%,1
雲林縣,斗六市,0476,454,477,931,43,974,1786,54.54%,25.42%,1
雲林縣,斗六市,0477,288,271,559,39,598,1023,58.46%,28.15%,1
雲林縣,斗六市,0478,502,596,1098,57,1155,2072,55.74%,24.23%,1
雲林縣,斗六市,0479,354,239,593,30,623,1128,55.23%,31.38%,1
雲林縣,斗南鎮,0498,316,362,678,29,707,1166,60.63%,27.1%,1
雲林縣,斗南鎮,0499,300,394,694,22,716,1135,63.08%,26.43%,1
雲林縣,斗南鎮,0500,243,347,590,15,605,975,62.05%,24.92%,1
雲林縣,斗南鎮,0501,350,498,848,30,878,1459,60.18%,23.99%,1
雲林縣,斗南鎮,0502,342,425,767,38,805,1351,59.59%,25.31%,1
雲林縣,斗南鎮,0503,303,407,710,37,747,1321,56.55%,22.94%,1
雲林縣,斗南鎮,0504,238,236,474,29,503,907,55.46%,26.24%,1
雲林縣,斗南鎮,0505,343,526,869,54,923,1473,62.66%,23.29%,1
雲林縣,斗南鎮,0506,369,399,768,34,802,1277,62.8%,28.9%,1
雲林縣,斗南鎮,0507,362,351,713,54,767,1333,57.54%,27.16%,1
雲林縣,斗南鎮,0508,209,198,407,25,432,777,55.6%,26.9%,1
雲林縣,斗南鎮,0509,237,217,454,31,485,877,55.3%,27.02%,1
雲林縣,斗南鎮,0510,200,266,466,29,495,899,55.06%,22.25%,1
雲林縣,斗南鎮,0511,172,142,314,21,335,688,48.69%,25%,1
雲林縣,斗南鎮,0512,266,307,573,26,599,1147,52.22%,23.19%,1
雲林縣,斗南鎮,0513,360,544,904,64,968,1709,56.64%,21.06%,1
雲林縣,斗南鎮,0514,300,313,613,33,646,1042,62%,28.79%,1
雲林縣,斗南鎮,0515,441,420,861,48,909,1631,55.73%,27.04%,1
雲林縣,斗南鎮,0516,429,550,979,55,1034,1702,60.75%,25.21%,1
雲林縣,斗南鎮,0517,405,485,890,34,924,1564,59.08%,25.9%,1
雲林縣,斗南鎮,0518,198,215,413,29,442,910,48.57%,21.76%,1
雲林縣,斗南鎮,0519,329,411,740,43,783,1276,61.36%,25.78%,1
雲林縣,斗南鎮,0520,210,211,421,18,439,897,48.94%,23.41%,1
雲林縣,斗南鎮,0521,183,233,416,26,442,803,55.04%,22.79%,1
雲林縣,斗南鎮,0522,207,261,468,37,505,866,58.31%,23.9%,1
雲林縣,斗南鎮,0523,232,233,465,38,503,852,59.04%,27.23%,1
雲林縣,斗南鎮,0524,156,197,353,30,383,671,57.08%,23.25%,1
雲林縣,斗南鎮,0525,253,275,528,29,557,981,56.78%,25.79%,1
雲林縣,斗南鎮,0526,274,257,531,34,565,1129,50.04%,24.27%,1
雲林縣,斗南鎮,0527,403,474,877,72,949,1586,59.84%,25.41%,1
雲林縣,斗南鎮,0528,362,357,719,49,768,1243,61.79%,29.12%,1
雲林縣,斗南鎮,0529,215,272,487,14,501,984,50.91%,21.85%,1
雲林縣,斗南鎮,0530,417,366,783,71,854,1507,56.67%,27.67%,1
雲林縣,虎尾鎮,0109,287,426,713,31,744,1347,55.23%,21.31%,1
雲林縣,虎尾鎮,0110,313,410,723,29,752,1258,59.78%,24.88%,1
雲林縣,虎尾鎮,0111,197,236,433,17,450,785,57.32%,25.1%,1
雲林縣,虎尾鎮,0112,178,231,409,29,438,890,49.21%,20%,1
雲林縣,虎尾鎮,0113,366,446,812,27,839,1413,59.38%,25.9%,1
雲林縣,虎尾鎮,0114,374,465,839,33,872,1431,60.94%,26.14%,1
雲林縣,虎尾鎮,0115,261,360,621,41,662,1224,54.08%,21.32%,1
雲林縣,虎尾鎮,0116,223,406,629,28,657,1325,49.58%,16.83%,1
雲林縣,虎尾鎮,0117,251,281,532,40,572,941,60.79%,26.67%,1
雲林縣,虎尾鎮,0118,346,514,860,24,884,1613,54.8%,21.45%,1
雲林縣,虎尾鎮,0119,322,523,845,26,871,1641,53.08%,19.62%,1
雲林縣,虎尾鎮,0120,262,423,685,30,715,1200,59.58%,21.83%,1
雲林縣,虎尾鎮,0121,331,401,732,32,764,1294,59.04%,25.58%,1
雲林縣,虎尾鎮,0122,287,422,709,25,734,1273,57.66%,22.55%,1
雲林縣,虎尾鎮,0123,375,482,857,31,888,1438,61.75%,26.08%,1
雲林縣,虎尾鎮,0124,310,469,779,18,797,1361,58.56%,22.78%,1
雲林縣,虎尾鎮,0125,324,506,830,33,863,1444,59.76%,22.44%,1
雲林縣,虎尾鎮,0126,363,536,899,28,927,1490,62.21%,24.36%,1
雲林縣,虎尾鎮,0127,330,471,801,32,833,1307,63.73%,25.25%,1
雲林縣,虎尾鎮,0128,247,227,474,21,495,967,51.19%,25.54%,1
雲林縣,虎尾鎮,0129,397,597,994,32,1026,1865,55.01%,21.29%,1
雲林縣,虎尾鎮,0130,545,585,1130,28,1158,1880,61.6%,28.99%,1
雲林縣,虎尾鎮,0131,255,312,567,31,598,1099,54.41%,23.2%,1
雲林縣,虎尾鎮,0132,248,262,510,13,523,901,58.05%,27.52%,1
雲林縣,虎尾鎮,0133,261,335,596,26,622,1120,55.54%,23.3%,1
雲林縣,虎尾鎮,0134,89,159,248,12,260,545,47.71%,16.33%,1
雲林縣,虎尾鎮,0135,378,361,739,39,778,1420,54.79%,26.62%,1
雲林縣,虎尾鎮,0136,333,295,628,19,647,1248,51.84%,26.68%,1
雲林縣,虎尾鎮,0137,185,240,425,24,449,799,56.2%,23.15%,1
雲林縣,虎尾鎮,0138,194,217,411,38,449,836,53.71%,23.21%,1
雲林縣,虎尾鎮,0139,199,208,407,34,441,924,47.73%,21.54%,1
雲林縣,虎尾鎮,0140,301,411,712,28,740,1648,44.9%,18.26%,1
雲林縣,虎尾鎮,0141,372,346,718,66,784,1616,48.51%,23.02%,1
雲林縣,虎尾鎮,0142,366,376,742,40,782,1546,50.58%,23.67%,1
雲林縣,虎尾鎮,0143,250,396,646,31,677,1283,52.77%,19.49%,1
雲林縣,虎尾鎮,0144,291,245,536,17,553,1078,51.3%,26.99%,1
雲林縣,虎尾鎮,0145,344,288,632,30,662,1313,50.42%,26.2%,1
雲林縣,虎尾鎮,0146,306,316,622,25,647,1284,50.39%,23.83%,1
雲林縣,虎尾鎮,0147,324,357,681,47,728,1356,53.69%,23.89%,1
雲林縣,虎尾鎮,0148,336,483,819,43,862,1504,57.31%,22.34%,1
雲林縣,虎尾鎮,0149,269,279,548,26,574,1224,46.9%,21.98%,1
雲林縣,虎尾鎮,0150,312,358,670,43,713,1509,47.25%,20.68%,1
雲林縣,虎尾鎮,0151,192,147,339,33,372,855,43.51%,22.46%,1
雲林縣,虎尾鎮,0152,313,356,669,54,723,1549,46.68%,20.21%,1
雲林縣,虎尾鎮,0153,182,218,400,23,423,851,49.71%,21.39%,1
雲林縣,虎尾鎮,0154,249,339,588,51,639,1272,50.24%,19.58%,1
雲林縣,西螺鎮,0340,413,384,797,41,838,1590,52.7%,25.97%,1
雲林縣,西螺鎮,0341,498,439,937,30,967,1741,55.54%,28.6%,1
雲林縣,西螺鎮,0342,302,382,684,29,713,1080,66.02%,27.96%,1
雲林縣,西螺鎮,0343,289,329,618,34,652,1040,62.69%,27.79%,1
雲林縣,西螺鎮,0344,342,430,772,24,796,1346,59.14%,25.41%,1
雲林縣,西螺鎮,0345,388,473,861,34,895,1625,55.08%,23.88%,1
雲林縣,西螺鎮,0346,113,117,230,8,238,354,67.23%,31.92%,1
雲林縣,西螺鎮,0347,157,149,306,22,328,580,56.55%,27.07%,1
雲林縣,西螺鎮,0348,166,177,343,32,375,591,63.45%,28.09%,1
雲林縣,西螺鎮,0349,287,296,583,39,622,1050,59.24%,27.33%,1
雲林縣,西螺鎮,0350,288,390,678,38,716,1147,62.42%,25.11%,1
雲林縣,西螺鎮,0351,378,439,817,42,859,1602,53.62%,23.6%,1
雲林縣,西螺鎮,0352,367,370,737,44,781,1452,53.79%,25.28%,1
雲林縣,西螺鎮,0353,392,465,857,38,895,1578,56.72%,24.84%,1
雲林縣,西螺鎮,0354,322,348,670,14,684,1305,52.41%,24.67%,1
雲林縣,西螺鎮,0355,360,275,635,43,678,1327,51.09%,27.13%,1
雲林縣,西螺鎮,0356,396,372,768,45,813,1516,53.63%,26.12%,1
雲林縣,西螺鎮,0357,207,159,366,27,393,828,47.46%,25%,1
雲林縣,西螺鎮,0358,195,153,348,11,359,788,45.56%,24.75%,1
雲林縣,西螺鎮,0359,235,193,428,34,462,863,53.53%,27.23%,1
雲林縣,西螺鎮,0360,292,199,491,32,523,984,53.15%,29.67%,1
雲林縣,西螺鎮,0361,428,316,744,75,819,1514,54.1%,28.27%,1
雲林縣,西螺鎮,0362,217,230,447,26,473,870,54.37%,24.94%,1
雲林縣,西螺鎮,0363,311,233,544,23,567,971,58.39%,32.03%,1
雲林縣,西螺鎮,0364,309,296,605,21,626,1304,48.01%,23.7%,1
雲林縣,西螺鎮,0365,186,168,354,20,374,726,51.52%,25.62%,1
雲林縣,西螺鎮,0366,180,241,421,34,455,823,55.29%,21.87%,1
雲林縣,西螺鎮,0367,200,174,374,12,386,886,43.57%,22.57%,1
雲林縣,西螺鎮,0368,354,295,649,37,686,1373,49.96%,25.78%,1
雲林縣,西螺鎮,0369,243,255,498,45,543,983,55.24%,24.72%,1
雲林縣,西螺鎮,0370,253,266,519,36,555,1014,54.73%,24.95%,1
雲林縣,西螺鎮,0371,240,181,421,58,479,939,51.01%,25.56%,1
雲林縣,西螺鎮,0372,239,205,444,29,473,866,54.62%,27.6%,1
雲林縣,西螺鎮,0373,376,324,700,40,740,1486,49.8%,25.3%,1
雲林縣,土庫鎮,0080,238,251,489,29,518,809,64.03%,29.42%,1
雲林縣,土庫鎮,0081,204,257,461,36,497,896,55.47%,22.77%,1
雲林縣,土庫鎮,0082,197,182,379,23,402,687,58.52%,28.68%,1
雲林縣,土庫鎮,0083,181,262,443,29,472,702,67.24%,25.78%,1
雲林縣,土庫鎮,0084,248,372,620,24,644,1032,62.4%,24.03%,1
雲林縣,土庫鎮,0085,186,153,339,41,380,697,54.52%,26.69%,1
雲林縣,土庫鎮,0086,95,113,208,21,229,427,53.63%,22.25%,1
雲林縣,土庫鎮,0087,336,448,784,39,823,1451,56.72%,23.16%,1
雲林縣,土庫鎮,0088,343,376,719,15,734,1283,57.21%,26.73%,1
雲林縣,土庫鎮,0089,143,143,286,8,294,634,46.37%,22.56%,1
雲林縣,土庫鎮,0090,202,212,414,25,439,796,55.15%,25.38%,1
雲林縣,土庫鎮,0091,168,141,309,25,334,745,44.83%,22.55%,1
雲林縣,土庫鎮,0092,122,145,267,22,289,576,50.17%,21.18%,1
雲林縣,土庫鎮,0093,153,172,325,36,361,743,48.59%,20.59%,1
雲林縣,土庫鎮,0094,119,116,235,7,242,534,45.32%,22.28%,1
雲林縣,土庫鎮,0095,251,239,490,58,548,1199,45.7%,20.93%,1
雲林縣,土庫鎮,0096,241,262,503,49,552,1077,51.25%,22.38%,1
雲林縣,土庫鎮,0097,175,176,351,22,373,819,45.54%,21.37%,1
雲林縣,土庫鎮,0098,195,149,344,29,373,684,54.53%,28.51%,1
雲林縣,土庫鎮,0099,219,217,436,29,465,843,55.16%,25.98%,1
雲林縣,土庫鎮,0100,271,192,463,34,497,916,54.26%,29.59%,1
雲林縣,土庫鎮,0101,239,230,469,21,490,948,51.69%,25.21%,1
雲林縣,土庫鎮,0102,231,245,476,31,507,914,55.47%,25.27%,1
雲林縣,土庫鎮,0103,238,204,442,46,488,860,56.74%,27.67%,1
雲林縣,土庫鎮,0104,236,197,433,38,471,929,50.7%,25.4%,1
雲林縣,土庫鎮,0105,208,181,389,35,424,875,48.46%,23.77%,1
雲林縣,土庫鎮,0106,208,181,389,25,414,896,46.21%,23.21%,1
雲林縣,土庫鎮,0107,165,150,315,33,348,757,45.97%,21.8%,1
雲林縣,土庫鎮,0108,160,151,311,25,336,683,49.19%,23.43%,1
雲林縣,北港鎮,0256,218,173,391,35,426,724,58.84%,30.11%,1
雲林縣,北港鎮,0257,225,170,395,36,431,688,62.65%,32.7%,1
雲林縣,北港鎮,0258,127,113,240,29,269,452,59.51%,28.1%,1
雲林縣,北港鎮,0259,237,233,470,48,518,866,59.82%,27.37%,1
雲林縣,北港鎮,0260,91,75,166,13,179,336,53.27%,27.08%,1
雲林縣,北港鎮,0261,98,103,201,15,216,395,54.68%,24.81%,1
雲林縣,北港鎮,0262,121,105,226,15,241,376,64.1%,32.18%,1
雲林縣,北港鎮,0263,249,279,528,25,553,950,58.21%,26.21%,1
雲林縣,北港鎮,0264,149,146,295,28,323,512,63.09%,29.1%,1
雲林縣,北港鎮,0265,100,91,191,12,203,324,62.65%,30.86%,1
雲林縣,北港鎮,0266,155,141,296,14,310,546,56.78%,28.39%,1
雲林縣,北港鎮,0267,137,122,259,11,270,433,62.36%,31.64%,1
雲林縣,北港鎮,0268,179,212,391,42,433,751,57.66%,23.83%,1
雲林縣,北港鎮,0269,123,140,263,10,273,442,61.76%,27.83%,1
雲林縣,北港鎮,0270,329,301,630,43,673,1151,58.47%,28.58%,1
雲林縣,北港鎮,0271,339,356,695,33,728,1224,59.48%,27.7%,1
雲林縣,北港鎮,0272,315,335,650,40,690,1211,56.98%,26.01%,1
雲林縣,北港鎮,0273,343,370,713,50,763,1326,57.54%,25.87%,1
雲林縣,北港鎮,0274,213,240,453,27,480,744,64.52%,28.63%,1
雲林縣,北港鎮,0275,278,314,592,34,626,977,64.07%,28.45%,1
雲林縣,北港鎮,0276,313,212,525,25,550,960,57.29%,32.6%,1
雲林縣,北港鎮,0277,99,97,196,5,201,494,40.69%,20.04%,1
雲林縣,北港鎮,0278,336,425,761,31,792,1364,58.06%,24.63%,1
雲林縣,北港鎮,0279,326,304,630,46,676,1123,60.2%,29.03%,1
雲林縣,北港鎮,0280,325,469,794,32,826,1451,56.93%,22.4%,1
雲林縣,北港鎮,0281,299,355,654,43,697,1162,59.98%,25.73%,1
雲林縣,北港鎮,0282,244,305,549,42,591,1130,52.3%,21.59%,1
雲林縣,北港鎮,0283,313,262,575,32,607,1149,52.83%,27.24%,1
雲林縣,北港鎮,0284,107,117,224,21,245,533,45.97%,20.08%,1
雲林縣,北港鎮,0285,168,114,282,15,297,433,68.59%,38.8%,1
雲林縣,北港鎮,0286,93,90,183,8,191,377,50.66%,24.67%,1
雲林縣,北港鎮,0287,146,195,341,15,356,809,44%,18.05%,1
雲林縣,北港鎮,0288,354,258,612,44,656,1397,46.96%,25.34%,1
雲林縣,北港鎮,0289,276,207,483,47,530,1145,46.29%,24.1%,1
雲林縣,北港鎮,0290,158,127,285,32,317,828,38.29%,19.08%,1
雲林縣,北港鎮,0291,126,85,211,16,227,557,40.75%,22.62%,1
雲林縣,北港鎮,0292,278,193,471,31,502,1060,47.36%,26.23%,1
雲林縣,北港鎮,0293,133,130,263,23,286,577,49.57%,23.05%,1
雲林縣,北港鎮,0294,265,129,394,22,416,931,44.68%,28.46%,1
雲林縣,北港鎮,0295,267,265,532,28,560,1018,55.01%,26.23%,1
雲林縣,北港鎮,0296,293,287,580,16,596,1032,57.75%,28.39%,1
雲林縣,古坑鄉,0531,250,343,593,38,631,1126,56.04%,22.2%,1
雲林縣,古坑鄉,0532,246,240,486,42,528,994,53.12%,24.75%,1
雲林縣,古坑鄉,0533,387,412,799,44,843,1517,55.57%,25.51%,1
雲林縣,古坑鄉,0534,311,371,682,36,718,1302,55.15%,23.89%,1
雲林縣,古坑鄉,0535,405,454,859,47,906,1772,51.13%,22.86%,1
雲林縣,古坑鄉,0536,286,319,605,48,653,1122,58.2%,25.49%,1
雲林縣,古坑鄉,0537,59,54,113,3,116,304,38.16%,19.41%,1
雲林縣,古坑鄉,0538,271,352,623,61,684,1169,58.51%,23.18%,1
雲林縣,古坑鄉,0539,298,313,611,47,658,1255,52.43%,23.75%,1
雲林縣,古坑鄉,0540,261,351,612,41,653,1078,60.58%,24.21%,1
雲林縣,古坑鄉,0541,168,260,428,43,471,943,49.95%,17.82%,1
雲林縣,古坑鄉,0542,259,363,622,49,671,1300,51.62%,19.92%,1
雲林縣,古坑鄉,0543,206,270,476,28,504,964,52.28%,21.37%,1
雲林縣,古坑鄉,0544,252,333,585,41,626,1144,54.72%,22.03%,1
雲林縣,古坑鄉,0545,342,410,752,48,800,1482,53.98%,23.08%,1
雲林縣,古坑鄉,0546,200,170,370,26,396,688,57.56%,29.07%,1
雲林縣,古坑鄉,0547,214,258,472,41,513,998,51.4%,21.44%,1
雲林縣,古坑鄉,0548,279,341,620,35,655,1140,57.46%,24.47%,1
雲林縣,古坑鄉,0549,297,264,561,40,601,1102,54.54%,26.95%,1
雲林縣,古坑鄉,0550,236,255,491,23,514,956,53.77%,24.69%,1
雲林縣,古坑鄉,0551,204,169,373,22,395,695,56.83%,29.35%,1
雲林縣,古坑鄉,0552,297,314,611,22,633,1233,51.34%,24.09%,1
雲林縣,古坑鄉,0553,63,54,117,3,120,285,42.11%,22.11%,1
雲林縣,古坑鄉,0554,138,173,311,10,321,734,43.73%,18.8%,1
雲林縣,古坑鄉,0555,308,286,594,44,638,1150,55.48%,26.78%,1
雲林縣,古坑鄉,0556,118,114,232,8,240,453,52.98%,26.05%,1
雲林縣,古坑鄉,0557,118,135,253,26,279,571,48.86%,20.67%,1
雲林縣,大埤鄉,0480,210,176,386,21,407,750,54.27%,28%,1
雲林縣,大埤鄉,0481,215,154,369,17,386,719,53.69%,29.9%,1
雲林縣,大埤鄉,0482,139,163,302,20,322,603,53.4%,23.05%,1
雲林縣,大埤鄉,0483,281,215,496,39,535,1106,48.37%,25.41%,1
雲林縣,大埤鄉,0484,387,379,766,44,810,1495,54.18%,25.89%,1
雲林縣,大埤鄉,0485,151,190,341,22,363,600,60.5%,25.17%,1
雲林縣,大埤鄉,0486,272,289,561,42,603,1004,60.06%,27.09%,1
雲林縣,大埤鄉,0487,244,157,401,12,413,948,43.57%,25.74%,1
雲林縣,大埤鄉,0488,306,488,794,37,831,1539,54%,19.88%,1
雲林縣,大埤鄉,0489,324,329,653,44,697,1430,48.74%,22.66%,1
雲林縣,大埤鄉,0490,100,130,230,13,243,465,52.26%,21.51%,1
雲林縣,大埤鄉,0491,304,335,639,24,663,1307,50.73%,23.26%,1
雲林縣,大埤鄉,0492,141,90,231,16,247,474,52.11%,29.75%,1
雲林縣,大埤鄉,0493,356,312,668,66,734,1220,60.16%,29.18%,1
雲林縣,大埤鄉,0494,180,189,369,19,388,733,52.93%,24.56%,1
雲林縣,大埤鄉,0495,194,169,363,22,385,681,56.53%,28.49%,1
雲林縣,大埤鄉,0496,180,125,305,16,321,712,45.08%,25.28%,1
雲林縣,大埤鄉,0497,176,148,324,34,358,723,49.52%,24.34%,1
雲林縣,莿桐鄉,0374,400,426,826,28,854,1507,56.67%,26.54%,1
雲林縣,莿桐鄉,0375,329,357,686,33,719,1300,55.31%,25.31%,1
雲林縣,莿桐鄉,0376,382,324,706,50,756,1272,59.43%,30.03%,1
雲林縣,莿桐鄉,0377,244,185,429,37,466,861,54.12%,28.34%,1
雲林縣,莿桐鄉,0378,401,345,746,45,791,1565,50.54%,25.62%,1
雲林縣,莿桐鄉,0379,174,135,309,15,324,577,56.15%,30.16%,1
雲林縣,莿桐鄉,0380,171,120,291,20,311,636,48.9%,26.89%,1
雲林縣,莿桐鄉,0381,312,226,538,50,588,1110,52.97%,28.11%,1
雲林縣,莿桐鄉,0382,296,265,561,32,593,973,60.95%,30.42%,1
雲林縣,莿桐鄉,0383,280,242,522,40,562,985,57.06%,28.43%,1
雲林縣,莿桐鄉,0384,440,496,936,82,1018,1707,59.64%,25.78%,1
雲林縣,莿桐鄉,0385,343,328,671,63,734,1284,57.17%,26.71%,1
雲林縣,莿桐鄉,0386,351,365,716,26,742,1293,57.39%,27.15%,1
雲林縣,莿桐鄉,0387,224,251,475,35,510,900,56.67%,24.89%,1
雲林縣,莿桐鄉,0388,328,245,573,59,632,1040,60.77%,31.54%,1
雲林縣,莿桐鄉,0389,295,289,584,27,611,1165,52.45%,25.32%,1
雲林縣,莿桐鄉,0390,246,221,467,34,501,871,57.52%,28.24%,1
雲林縣,莿桐鄉,0391,220,285,505,42,547,885,61.81%,24.86%,1
雲林縣,莿桐鄉,0392,353,329,682,52,734,1489,49.29%,23.71%,1
雲林縣,莿桐鄉,0393,328,302,630,61,691,1347,51.3%,24.35%,1
雲林縣,莿桐鄉,0394,322,298,620,47,667,1150,58%,28%,1
雲林縣,莿桐鄉,0395,172,192,364,30,394,653,60.34%,26.34%,1
雲林縣,林內鄉,0396,249,359,608,49,657,1036,63.42%,24.03%,1
雲林縣,林內鄉,0397,362,435,797,42,839,1490,56.31%,24.3%,1
雲林縣,林內鄉,0398,306,454,760,44,804,1491,53.92%,20.52%,1
雲林縣,林內鄉,0399,144,178,322,42,364,671,54.25%,21.46%,1
雲林縣,林內鄉,0400,353,423,776,75,851,1436,59.26%,24.58%,1
雲林縣,林內鄉,0401,221,192,413,34,447,751,59.52%,29.43%,1
雲林縣,林內鄉,0402,129,152,281,20,301,535,56.26%,24.11%,1
雲林縣,林內鄉,0403,164,195,359,38,397,811,48.95%,20.22%,1
雲林縣,林內鄉,0404,347,364,711,59,770,1339,57.51%,25.91%,1
雲林縣,林內鄉,0405,293,364,657,51,708,1286,55.05%,22.78%,1
雲林縣,林內鄉,0406,167,156,323,34,357,646,55.26%,25.85%,1
雲林縣,林內鄉,0407,254,329,583,68,651,1158,56.22%,21.93%,1
雲林縣,林內鄉,0408,252,331,583,39,622,1090,57.06%,23.12%,1
雲林縣,林內鄉,0409,296,243,539,47,586,950,61.68%,31.16%,1
雲林縣,林內鄉,0410,221,238,459,28,487,861,56.56%,25.67%,1
雲林縣,二崙鄉,0317,362,310,672,24,696,1463,47.57%,24.74%,1
雲林縣,二崙鄉,0318,400,398,798,33,831,1738,47.81%,23.01%,1
雲林縣,二崙鄉,0319,136,120,256,46,302,625,48.32%,21.76%,1
雲林縣,二崙鄉,0320,302,197,499,29,528,1018,51.87%,29.67%,1
雲林縣,二崙鄉,0321,117,87,204,5,209,448,46.65%,26.12%,1
雲林縣,二崙鄉,0322,214,172,386,31,417,1048,39.79%,20.42%,1
雲林縣,二崙鄉,0323,299,290,589,51,640,1161,55.12%,25.75%,1
雲林縣,二崙鄉,0324,282,258,540,21,561,991,56.61%,28.46%,1
雲林縣,二崙鄉,0325,242,228,470,39,509,849,59.95%,28.5%,1
雲林縣,二崙鄉,0326,216,212,428,22,450,890,50.56%,24.27%,1
雲林縣,二崙鄉,0327,383,306,689,31,720,1427,50.46%,26.84%,1
雲林縣,二崙鄉,0328,298,173,471,15,486,891,54.55%,33.45%,1
雲林縣,二崙鄉,0329,195,150,345,13,358,757,47.29%,25.76%,1
雲林縣,二崙鄉,0330,405,285,690,49,739,1497,49.37%,27.05%,1
雲林縣,二崙鄉,0331,344,203,547,21,568,1171,48.51%,29.38%,1
雲林縣,二崙鄉,0332,197,183,380,23,403,686,58.75%,28.72%,1
雲林縣,二崙鄉,0333,195,165,360,27,387,864,44.79%,22.57%,1
雲林縣,二崙鄉,0334,276,303,579,40,619,1073,57.69%,25.72%,1
雲林縣,二崙鄉,0335,198,109,307,15,322,696,46.26%,28.45%,1
雲林縣,二崙鄉,0336,250,213,463,35,498,1271,39.18%,19.67%,1
雲林縣,二崙鄉,0337,227,165,392,23,415,912,45.5%,24.89%,1
雲林縣,二崙鄉,0338,242,156,398,19,417,861,48.43%,28.11%,1
雲林縣,二崙鄉,0339,227,199,426,35,461,1030,44.76%,22.04%,1
雲林縣,崙背鄉,0297,294,322,616,43,659,1176,56.04%,25%,1
雲林縣,崙背鄉,0298,348,366,714,45,759,1439,52.74%,24.18%,1
雲林縣,崙背鄉,0299,248,343,591,30,621,1027,60.47%,24.15%,1
雲林縣,崙背鄉,0300,280,399,679,33,712,1259,56.55%,22.24%,1
雲林縣,崙背鄉,0301,287,187,474,32,506,1058,47.83%,27.13%,1
雲林縣,崙背鄉,0302,243,210,453,20,473,998,47.39%,24.35%,1
雲林縣,崙背鄉,0303,237,219,456,23,479,968,49.48%,24.48%,1
雲林縣,崙背鄉,0304,305,226,531,28,559,1055,52.99%,28.91%,1
雲林縣,崙背鄉,0305,330,267,597,40,637,1315,48.44%,25.1%,1
雲林縣,崙背鄉,0306,154,167,321,26,347,1027,33.79%,15%,1
雲林縣,崙背鄉,0307,289,251,540,50,590,997,59.18%,28.99%,1
雲林縣,崙背鄉,0308,163,231,394,31,425,807,52.66%,20.2%,1
雲林縣,崙背鄉,0309,143,139,282,11,293,698,41.98%,20.49%,1
雲林縣,崙背鄉,0310,161,181,342,38,380,804,47.26%,20.02%,1
雲林縣,崙背鄉,0311,230,203,433,27,460,867,53.06%,26.53%,1
雲林縣,崙背鄉,0312,188,172,360,27,387,886,43.68%,21.22%,1
雲林縣,崙背鄉,0313,263,292,555,63,618,1476,41.87%,17.82%,1
雲林縣,崙背鄉,0314,193,195,388,23,411,1159,35.46%,16.65%,1
雲林縣,崙背鄉,0315,372,270,642,54,696,1220,57.05%,30.49%,1
雲林縣,崙背鄉,0316,220,193,413,21,434,814,53.32%,27.03%,1
雲林縣,麥寮鄉,0001,263,359,622,44,666,1497,44.49%,17.57%,1
雲林縣,麥寮鄉,0002,357,467,824,48,872,1738,50.17%,20.54%,1
雲林縣,麥寮鄉,0003,392,514,906,51,957,1921,49.82%,20.41%,1
雲林縣,麥寮鄉,0004,329,497,826,45,871,1832,47.54%,17.96%,1
雲林縣,麥寮鄉,0005,232,321,553,58,611,1340,45.6%,17.31%,1
雲林縣,麥寮鄉,0006,226,286,512,41,553,1138,48.59%,19.86%,1
雲林縣,麥寮鄉,0007,268,457,725,48,773,1551,49.84%,17.28%,1
雲林縣,麥寮鄉,0008,128,161,289,23,312,715,43.64%,17.9%,1
雲林縣,麥寮鄉,0009,262,247,509,20,529,1194,44.3%,21.94%,1
雲林縣,麥寮鄉,0010,202,258,460,29,489,1023,47.8%,19.75%,1
雲林縣,麥寮鄉,0011,290,302,592,35,627,1558,40.24%,18.61%,1
雲林縣,麥寮鄉,0012,218,250,468,19,487,1187,41.03%,18.37%,1
雲林縣,麥寮鄉,0013,159,236,395,25,420,983,42.73%,16.17%,1
雲林縣,麥寮鄉,0014,250,373,623,48,671,1363,49.23%,18.34%,1
雲林縣,麥寮鄉,0015,285,423,708,61,769,1596,48.18%,17.86%,1
雲林縣,麥寮鄉,0016,358,436,794,70,864,1469,58.82%,24.37%,1
雲林縣,麥寮鄉,0017,174,230,404,34,438,964,45.44%,18.05%,1
雲林縣,麥寮鄉,0018,211,205,416,36,452,1038,43.55%,20.33%,1
雲林縣,麥寮鄉,0019,234,337,571,51,622,1230,50.57%,19.02%,1
雲林縣,麥寮鄉,0020,292,312,604,43,647,1329,48.68%,21.97%,1
雲林縣,麥寮鄉,0021,210,337,547,59,606,1129,53.68%,18.6%,1
雲林縣,麥寮鄉,0022,280,348,628,67,695,1241,56%,22.56%,1
雲林縣,麥寮鄉,0023,329,403,732,79,811,1471,55.13%,22.37%,1
雲林縣,麥寮鄉,0024,286,286,572,64,636,1107,57.45%,25.84%,1
雲林縣,麥寮鄉,0025,397,449,846,54,900,1636,55.01%,24.27%,1
雲林縣,麥寮鄉,0026,375,458,833,51,884,1755,50.37%,21.37%,1
雲林縣,麥寮鄉,0027,256,366,622,26,648,1158,55.96%,22.11%,1
雲林縣,麥寮鄉,0028,241,250,491,29,520,956,54.39%,25.21%,1
雲林縣,東勢鄉,0051,271,247,518,37,555,1207,45.98%,22.45%,1
雲林縣,東勢鄉,0052,156,152,308,18,326,540,60.37%,28.89%,1
雲林縣,東勢鄉,0053,224,155,379,21,400,896,44.64%,25%,1
雲林縣,東勢鄉,0054,189,169,358,38,396,728,54.4%,25.96%,1
雲林縣,東勢鄉,0055,347,483,830,49,879,1533,57.34%,22.64%,1
雲林縣,東勢鄉,0056,333,344,677,45,722,1203,60.02%,27.68%,1
雲林縣,東勢鄉,0057,210,156,366,30,396,817,48.47%,25.7%,1
雲林縣,東勢鄉,0058,140,170,310,19,329,546,60.26%,25.64%,1
雲林縣,東勢鄉,0059,209,181,390,48,438,853,51.35%,24.5%,1
雲林縣,東勢鄉,0060,204,149,353,26,379,856,44.28%,23.83%,1
雲林縣,東勢鄉,0061,221,196,417,32,449,923,48.65%,23.94%,1
雲林縣,東勢鄉,0062,245,242,487,35,522,1022,51.08%,23.97%,1
雲林縣,東勢鄉,0063,115,119,234,13,247,634,38.96%,18.14%,1
雲林縣,東勢鄉,0064,96,71,167,15,182,394,46.19%,24.37%,1
雲林縣,東勢鄉,0065,203,205,408,33,441,1087,40.57%,18.68%,1
雲林縣,褒忠鄉,0066,223,263,486,36,522,923,56.55%,24.16%,1
雲林縣,褒忠鄉,0067,288,274,562,25,587,993,59.11%,29%,1
雲林縣,褒忠鄉,0068,178,204,382,13,395,748,52.81%,23.8%,1
雲林縣,褒忠鄉,0069,175,178,353,10,363,702,51.71%,24.93%,1
雲林縣,褒忠鄉,0070,194,203,397,12,409,752,54.39%,25.8%,1
雲林縣,褒忠鄉,0071,198,196,394,14,408,756,53.97%,26.19%,1
雲林縣,褒忠鄉,0072,109,145,254,6,260,490,53.06%,22.24%,1
雲林縣,褒忠鄉,0073,216,277,493,29,522,1034,50.48%,20.89%,1
雲林縣,褒忠鄉,0074,121,98,219,21,240,470,51.06%,25.74%,1
雲林縣,褒忠鄉,0075,212,150,362,16,378,737,51.29%,28.77%,1
雲林縣,褒忠鄉,0076,208,198,406,31,437,878,49.77%,23.69%,1
雲林縣,褒忠鄉,0077,157,204,361,29,390,778,50.13%,20.18%,1
雲林縣,褒忠鄉,0078,295,315,610,33,643,1224,52.53%,24.1%,1
雲林縣,褒忠鄉,0079,253,153,406,35,441,896,49.22%,28.24%,1
雲林縣,臺西鄉,0029,252,401,653,36,689,1238,55.65%,20.36%,1
雲林縣,臺西鄉,0030,210,280,490,26,516,1091,47.3%,19.25%,1
雲林縣,臺西鄉,0031,240,301,541,50,591,1098,53.83%,21.86%,1
雲林縣,臺西鄉,0032,185,243,428,28,456,1048,43.51%,17.65%,1
雲林縣,臺西鄉,0033,225,243,468,28,496,1025,48.39%,21.95%,1
雲林縣,臺西鄉,0034,198,209,407,25,432,850,50.82%,23.29%,1
雲林縣,臺西鄉,0035,308,309,617,32,649,1460,44.45%,21.1%,1
雲林縣,臺西鄉,0036,187,201,388,53,441,1180,37.37%,15.85%,1
雲林縣,臺西鄉,0037,112,110,222,18,240,710,33.8%,15.77%,1
雲林縣,臺西鄉,0038,140,112,252,12,264,620,42.58%,22.58%,1
雲林縣,臺西鄉,0039,115,85,200,14,214,449,47.66%,25.61%,1
雲林縣,臺西鄉,0040,128,125,253,29,282,687,41.05%,18.63%,1
雲林縣,臺西鄉,0041,285,247,532,39,571,1247,45.79%,22.85%,1
雲林縣,臺西鄉,0042,72,125,197,12,209,583,35.85%,12.35%,1
雲林縣,臺西鄉,0043,213,286,499,33,532,1042,51.06%,20.44%,1
雲林縣,臺西鄉,0044,90,114,204,16,220,472,46.61%,19.07%,1
雲林縣,臺西鄉,0045,223,344,567,33,600,1409,42.58%,15.83%,1
雲林縣,臺西鄉,0046,258,255,513,53,566,1061,53.35%,24.32%,1
雲林縣,臺西鄉,0047,189,216,405,29,434,993,43.71%,19.03%,1
雲林縣,臺西鄉,0048,226,209,435,63,498,1013,49.16%,22.31%,1
雲林縣,臺西鄉,0049,244,336,580,29,609,1233,49.39%,19.79%,1
雲林縣,臺西鄉,0050,106,135,241,23,264,616,42.86%,17.21%,1
雲林縣,元長鄉,0180,212,219,431,30,461,915,50.38%,23.17%,1
雲林縣,元長鄉,0181,290,306,596,21,617,1284,48.05%,22.59%,1
雲林縣,元長鄉,0182,289,238,527,30,557,1150,48.43%,25.13%,1
雲林縣,元長鄉,0183,170,141,311,32,343,744,46.1%,22.85%,1
雲林縣,元長鄉,0184,187,170,357,33,390,790,49.37%,23.67%,1
雲林縣,元長鄉,0185,311,272,583,45,628,1356,46.31%,22.94%,1
雲林縣,元長鄉,0186,200,134,334,26,360,739,48.71%,27.06%,1
雲林縣,元長鄉,0187,165,202,367,32,399,965,41.35%,17.1%,1
雲林縣,元長鄉,0188,243,188,431,34,465,1080,43.06%,22.5%,1
雲林縣,元長鄉,0189,202,158,360,33,393,948,41.46%,21.31%,1
雲林縣,元長鄉,0190,134,98,232,15,247,762,32.41%,17.59%,1
雲林縣,元長鄉,0191,123,133,256,19,275,582,47.25%,21.13%,1
雲林縣,元長鄉,0192,154,174,328,15,343,865,39.65%,17.8%,1
雲林縣,元長鄉,0193,52,37,89,2,91,362,25.14%,14.36%,1
雲林縣,元長鄉,0194,231,217,448,23,471,1162,40.53%,19.88%,1
雲林縣,元長鄉,0195,340,346,686,25,711,1527,46.56%,22.27%,1
雲林縣,元長鄉,0196,234,205,439,51,490,1006,48.71%,23.26%,1
雲林縣,元長鄉,0197,200,174,374,18,392,855,45.85%,23.39%,1
雲林縣,元長鄉,0198,265,235,500,59,559,1181,47.33%,22.44%,1
雲林縣,元長鄉,0199,173,154,327,23,350,864,40.51%,20.02%,1
雲林縣,元長鄉,0200,135,115,250,25,275,667,41.23%,20.24%,1
雲林縣,元長鄉,0201,196,157,353,20,373,878,42.48%,22.32%,1
雲林縣,元長鄉,0202,118,83,201,8,209,610,34.26%,19.34%,1
雲林縣,元長鄉,0203,167,196,363,37,400,837,47.79%,19.95%,1
雲林縣,元長鄉,0204,170,167,337,20,357,701,50.93%,24.25%,1
雲林縣,四湖鄉,0155,217,239,456,31,487,1082,45.01%,20.06%,1
雲林縣,四湖鄉,0156,196,169,365,16,381,676,56.36%,28.99%,1
雲林縣,四湖鄉,0157,178,242,420,16,436,862,50.58%,20.65%,1
雲林縣,四湖鄉,0158,117,64,181,17,198,477,41.51%,24.53%,1
雲林縣,四湖鄉,0159,204,257,461,72,533,952,55.99%,21.43%,1
雲林縣,四湖鄉,0160,140,117,257,5,262,650,40.31%,21.54%,1
雲林縣,四湖鄉,0161,215,209,424,12,436,969,44.99%,22.19%,1
雲林縣,四湖鄉,0162,209,142,351,26,377,925,40.76%,22.59%,1
雲林縣,四湖鄉,0163,194,195,389,20,409,914,44.75%,21.23%,1
雲林縣,四湖鄉,0164,150,95,245,15,260,759,34.26%,19.76%,1
雲林縣,四湖鄉,0165,228,229,457,33,490,1219,40.2%,18.7%,1
雲林縣,四湖鄉,0166,145,157,302,24,326,937,34.79%,15.47%,1
雲林縣,四湖鄉,0167,139,105,244,10,254,773,32.86%,17.98%,1
雲林縣,四湖鄉,0168,102,95,197,28,225,555,40.54%,18.38%,1
雲林縣,四湖鄉,0169,130,152,282,19,301,876,34.36%,14.84%,1
雲林縣,四湖鄉,0170,68,63,131,8,139,360,38.61%,18.89%,1
雲林縣,四湖鄉,0171,136,113,249,24,273,885,30.85%,15.37%,1
雲林縣,四湖鄉,0172,121,152,273,13,286,833,34.33%,14.53%,1
雲林縣,四湖鄉,0173,164,141,305,29,334,785,42.55%,20.89%,1
雲林縣,四湖鄉,0174,128,181,309,30,339,705,48.09%,18.16%,1
雲林縣,四湖鄉,0175,203,131,334,26,360,927,38.83%,21.9%,1
雲林縣,四湖鄉,0176,210,146,356,33,389,1058,36.77%,19.85%,1
雲林縣,四湖鄉,0177,226,157,383,26,409,1071,38.19%,21.1%,1
雲林縣,四湖鄉,0178,153,131,284,18,302,1022,29.55%,14.97%,1
雲林縣,四湖鄉,0179,131,150,281,23,304,711,42.76%,18.42%,1
雲林縣,口湖鄉,0205,128,272,400,47,447,1134,39.42%,11.29%,1
雲林縣,口湖鄉,0206,292,310,602,64,666,1225,54.37%,23.84%,1
雲林縣,口湖鄉,0207,109,142,251,33,284,647,43.89%,16.85%,1
雲林縣,口湖鄉,0208,196,154,350,19,369,709,52.05%,27.64%,1
雲林縣,口湖鄉,0209,228,166,394,39,433,900,48.11%,25.33%,1
雲林縣,口湖鄉,0210,269,196,465,41,506,1011,50.05%,26.61%,1
雲林縣,口湖鄉,0211,330,263,593,28,621,1437,43.22%,22.96%,1
雲林縣,口湖鄉,0212,180,107,287,7,294,848,34.67%,21.23%,1
雲林縣,口湖鄉,0213,234,242,476,28,504,1193,42.25%,19.61%,1
雲林縣,口湖鄉,0214,149,125,274,18,292,759,38.47%,19.63%,1
雲林縣,口湖鄉,0215,167,178,345,26,371,815,45.52%,20.49%,1
雲林縣,口湖鄉,0216,348,322,670,59,729,1460,49.93%,23.84%,1
雲林縣,口湖鄉,0217,136,80,216,6,222,556,39.93%,24.46%,1
雲林縣,口湖鄉,0218,340,333,673,44,717,1532,46.8%,22.19%,1
雲林縣,口湖鄉,0219,195,202,397,15,412,847,48.64%,23.02%,1
雲林縣,口湖鄉,0220,106,62,168,14,182,374,48.66%,28.34%,1
雲林縣,口湖鄉,0221,526,260,786,63,849,1508,56.3%,34.88%,1
雲林縣,口湖鄉,0222,249,244,493,40,533,951,56.05%,26.18%,1
雲林縣,口湖鄉,0223,303,175,478,55,533,910,58.57%,33.3%,1
雲林縣,口湖鄉,0224,220,264,484,32,516,879,58.7%,25.03%,1
雲林縣,口湖鄉,0225,373,191,564,45,609,1213,50.21%,30.75%,1
雲林縣,口湖鄉,0226,222,245,467,43,510,952,53.57%,23.32%,1
雲林縣,口湖鄉,0227,220,144,364,28,392,720,54.44%,30.56%,1
雲林縣,口湖鄉,0228,245,175,420,17,437,1006,43.44%,24.35%,1
雲林縣,口湖鄉,0229,139,119,258,13,271,607,44.65%,22.9%,1
雲林縣,水林鄉,0230,351,234,585,27,612,1355,45.17%,25.9%,1
雲林縣,水林鄉,0231,220,210,430,15,445,887,50.17%,24.8%,1
雲林縣,水林鄉,0232,324,327,651,36,687,1234,55.67%,26.26%,1
雲林縣,水林鄉,0233,202,165,367,15,382,763,50.07%,26.47%,1
雲林縣,水林鄉,0234,191,99,290,26,316,721,43.83%,26.49%,1
雲林縣,水林鄉,0235,133,117,250,11,261,647,40.34%,20.56%,1
雲林縣,水林鄉,0236,226,188,414,34,448,989,45.3%,22.85%,1
雲林縣,水林鄉,0237,214,131,345,16,361,837,43.13%,25.57%,1
雲林縣,水林鄉,0238,264,177,441,13,454,1081,42%,24.42%,1
雲林縣,水林鄉,0239,196,138,334,18,352,704,50%,27.84%,1
雲林縣,水林鄉,0240,269,193,462,43,505,1006,50.2%,26.74%,1
雲林縣,水林鄉,0241,132,137,269,10,279,651,42.86%,20.28%,1
雲林縣,水林鄉,0242,135,109,244,11,255,607,42.01%,22.24%,1
雲林縣,水林鄉,0243,222,180,402,36,438,1033,42.4%,21.49%,1
雲林縣,水林鄉,0244,104,98,202,12,214,631,33.91%,16.48%,1
雲林縣,水林鄉,0245,243,150,393,25,418,961,43.5%,25.29%,1
雲林縣,水林鄉,0246,231,167,398,35,433,951,45.53%,24.29%,1
雲林縣,水林鄉,0247,230,127,357,18,375,838,44.75%,27.45%,1
雲林縣,水林鄉,0248,255,201,456,49,505,1055,47.87%,24.17%,1
雲林縣,水林鄉,0249,116,72,188,11,199,512,38.87%,22.66%,1
雲林縣,水林鄉,0250,164,96,260,13,273,671,40.69%,24.44%,1
雲林縣,水林鄉,0251,139,72,211,14,225,693,32.47%,20.06%,1
雲林縣,水林鄉,0252,145,91,236,17,253,689,36.72%,21.04%,1
雲林縣,水林鄉,0253,261,200,461,42,503,1022,49.22%,25.54%,1
雲林縣,水林鄉,0254,270,231,501,30,531,1191,44.58%,22.67%,1
雲林縣,水林鄉,0255,202,189,391,38,429,779,55.07%,25.93%,1
嘉義縣,太保市,0001,307,326,633,50,683,1210,56.45%,25.37%,1
嘉義縣,太保市,0002,260,307,567,27,594,1076,55.2%,24.16%,1
嘉義縣,太保市,0003,139,100,239,15,254,488,52.05%,28.48%,1
嘉義縣,太保市,0004,411,322,733,41,774,1475,52.47%,27.86%,1
嘉義縣,太保市,0005,179,201,380,7,387,790,48.99%,22.66%,1
嘉義縣,太保市,0006,201,218,419,24,443,883,50.17%,22.76%,1
嘉義縣,太保市,0007,174,198,372,30,402,758,53.03%,22.96%,1
嘉義縣,太保市,0008,88,75,163,4,167,389,42.93%,22.62%,1
嘉義縣,太保市,0009,255,232,487,33,520,1101,47.23%,23.16%,1
嘉義縣,太保市,0010,177,254,431,11,442,853,51.82%,20.75%,1
嘉義縣,太保市,0011,53,35,88,5,93,224,41.52%,23.66%,1
嘉義縣,太保市,0012,158,144,302,20,322,662,48.64%,23.87%,1
嘉義縣,太保市,0013,388,557,945,27,972,1630,59.63%,23.8%,1
嘉義縣,太保市,0014,227,221,448,15,463,913,50.71%,24.86%,1
嘉義縣,太保市,0015,193,232,425,9,434,779,55.71%,24.78%,1
嘉義縣,太保市,0016,150,502,652,58,710,1278,55.56%,11.74%,1
嘉義縣,太保市,0017,202,191,393,20,413,819,50.43%,24.66%,1
嘉義縣,太保市,0018,368,417,785,28,813,1573,51.68%,23.39%,1
嘉義縣,太保市,0019,127,124,251,14,265,481,55.09%,26.4%,1
嘉義縣,太保市,0020,74,73,147,4,151,245,61.63%,30.2%,1
嘉義縣,太保市,0021,106,72,178,10,188,317,59.31%,33.44%,1
嘉義縣,太保市,0022,73,65,138,3,141,258,54.65%,28.29%,1
嘉義縣,太保市,0023,153,143,296,37,333,611,54.5%,25.04%,1
嘉義縣,太保市,0024,475,393,868,26,894,1526,58.58%,31.13%,1
嘉義縣,太保市,0025,341,324,665,13,678,1196,56.69%,28.51%,1
嘉義縣,太保市,0026,437,352,789,52,841,1536,54.75%,28.45%,1
嘉義縣,太保市,0027,398,391,789,41,830,1481,56.04%,26.87%,1
嘉義縣,太保市,0028,382,372,754,44,798,1450,55.03%,26.34%,1
嘉義縣,太保市,0029,233,194,427,16,443,840,52.74%,27.74%,1
嘉義縣,太保市,0030,313,230,543,14,557,989,56.32%,31.65%,1
嘉義縣,太保市,0031,424,367,791,57,848,1529,55.46%,27.73%,1
嘉義縣,太保市,0032,423,387,810,48,858,1511,56.78%,27.99%,1
嘉義縣,太保市,0033,185,138,323,30,353,697,50.65%,26.54%,1
嘉義縣,朴子市,0233,269,346,615,32,647,1183,54.69%,22.74%,1
嘉義縣,朴子市,0234,215,177,392,24,416,755,55.1%,28.48%,1
嘉義縣,朴子市,0235,297,355,652,30,682,1253,54.43%,23.7%,1
嘉義縣,朴子市,0236,280,330,610,44,654,1078,60.67%,25.97%,1
嘉義縣,朴子市,0237,347,293,640,45,685,1117,61.32%,31.07%,1
嘉義縣,朴子市,0238,124,97,221,15,236,387,60.98%,32.04%,1
嘉義縣,朴子市,0239,188,151,339,20,359,633,56.71%,29.7%,1
嘉義縣,朴子市,0240,191,155,346,21,367,650,56.46%,29.38%,1
嘉義縣,朴子市,0241,236,258,494,31,525,825,63.64%,28.61%,1
嘉義縣,朴子市,0242,218,211,429,26,455,810,56.17%,26.91%,1
嘉義縣,朴子市,0243,237,275,512,40,552,940,58.72%,25.21%,1
嘉義縣,朴子市,0244,241,225,466,29,495,905,54.7%,26.63%,1
嘉義縣,朴子市,0245,403,337,740,28,768,1605,47.85%,25.11%,1
嘉義縣,朴子市,0246,408,408,816,35,851,1479,57.54%,27.59%,1
嘉義縣,朴子市,0247,348,332,680,34,714,1218,58.62%,28.57%,1
嘉義縣,朴子市,0248,383,433,816,44,860,1496,57.49%,25.6%,1
嘉義縣,朴子市,0249,192,177,369,26,395,667,59.22%,28.79%,1
嘉義縣,朴子市,0250,119,119,238,15,253,627,40.35%,18.98%,1
嘉義縣,朴子市,0251,186,193,379,21,400,791,50.57%,23.51%,1
嘉義縣,朴子市,0252,290,236,526,47,573,1034,55.42%,28.05%,1
嘉義縣,朴子市,0253,415,396,811,25,836,1710,48.89%,24.27%,1
嘉義縣,朴子市,0254,373,414,787,35,822,1671,49.19%,22.32%,1
嘉義縣,朴子市,0255,343,325,668,42,710,1547,45.9%,22.17%,1
嘉義縣,朴子市,0256,313,312,625,43,668,1602,41.7%,19.54%,1
嘉義縣,朴子市,0257,314,403,717,23,740,1302,56.84%,24.12%,1
嘉義縣,朴子市,0258,174,176,350,28,378,740,51.08%,23.51%,1
嘉義縣,朴子市,0259,305,275,580,44,624,1054,59.2%,28.94%,1
嘉義縣,朴子市,0260,218,172,390,13,403,907,44.43%,24.04%,1
嘉義縣,朴子市,0261,203,101,304,20,324,720,45%,28.19%,1
嘉義縣,朴子市,0262,84,52,136,14,150,251,59.76%,33.47%,1
嘉義縣,朴子市,0263,180,114,294,44,338,767,44.07%,23.47%,1
嘉義縣,朴子市,0264,184,180,364,29,393,702,55.98%,26.21%,1
嘉義縣,朴子市,0265,268,190,458,45,503,1038,48.46%,25.82%,1
嘉義縣,朴子市,0266,297,173,470,19,489,1228,39.82%,24.19%,1
嘉義縣,朴子市,0267,146,93,239,18,257,499,51.5%,29.26%,1
嘉義縣,布袋鎮,0325,141,140,281,25,306,614,49.84%,22.96%,1
嘉義縣,布袋鎮,0326,78,80,158,12,170,372,45.7%,20.97%,1
嘉義縣,布袋鎮,0327,211,257,468,46,514,914,56.24%,23.09%,1
嘉義縣,布袋鎮,0328,313,279,592,54,646,1198,53.92%,26.13%,1
嘉義縣,布袋鎮,0329,244,247,491,38,529,1113,47.53%,21.92%,1
嘉義縣,布袋鎮,0330,266,245,511,40,551,992,55.54%,26.81%,1
嘉義縣,布袋鎮,0331,169,183,352,11,363,689,52.69%,24.53%,1
嘉義縣,布袋鎮,0332,218,213,431,44,475,882,53.85%,24.72%,1
嘉義縣,布袋鎮,0333,148,209,357,28,385,731,52.67%,20.25%,1
嘉義縣,布袋鎮,0334,154,254,408,24,432,779,55.46%,19.77%,1
嘉義縣,布袋鎮,0335,129,186,315,27,342,762,44.88%,16.93%,1
嘉義縣,布袋鎮,0336,297,231,528,31,559,1184,47.21%,25.08%,1
嘉義縣,布袋鎮,0337,323,226,549,33,582,1423,40.9%,22.7%,1
嘉義縣,布袋鎮,0338,319,237,556,26,582,1351,43.08%,23.61%,1
嘉義縣,布袋鎮,0339,78,59,137,3,140,275,50.91%,28.36%,1
嘉義縣,布袋鎮,0340,63,39,102,12,114,243,46.91%,25.93%,1
嘉義縣,布袋鎮,0341,187,125,312,51,363,661,54.92%,28.29%,1
嘉義縣,布袋鎮,0342,224,309,533,25,558,1145,48.73%,19.56%,1
嘉義縣,布袋鎮,0343,223,212,435,21,456,936,48.72%,23.82%,1
嘉義縣,布袋鎮,0344,222,207,429,28,457,958,47.7%,23.17%,1
嘉義縣,布袋鎮,0345,77,62,139,9,148,298,49.66%,25.84%,1
嘉義縣,布袋鎮,0346,115,118,233,21,254,428,59.35%,26.87%,1
嘉義縣,布袋鎮,0347,23,29,52,4,56,121,46.28%,19.01%,1
嘉義縣,布袋鎮,0348,28,31,59,2,61,174,35.06%,16.09%,1
嘉義縣,布袋鎮,0349,232,203,435,24,459,953,48.16%,24.34%,1
嘉義縣,布袋鎮,0350,360,300,660,38,698,1292,54.02%,27.86%,1
嘉義縣,布袋鎮,0351,267,298,565,40,605,1127,53.68%,23.69%,1
嘉義縣,布袋鎮,0352,291,313,604,18,622,1244,50%,23.39%,1
嘉義縣,布袋鎮,0353,237,265,502,21,523,1106,47.29%,21.43%,1
嘉義縣,大林鎮,0169,144,118,262,11,273,483,56.52%,29.81%,1
嘉義縣,大林鎮,0170,510,492,1002,34,1036,1823,56.83%,27.98%,1
嘉義縣,大林鎮,0171,252,278,530,17,547,955,57.28%,26.39%,1
嘉義縣,大林鎮,0172,365,362,727,34,761,1436,52.99%,25.42%,1
嘉義縣,大林鎮,0173,359,377,736,54,790,1390,56.83%,25.83%,1
嘉義縣,大林鎮,0174,412,394,806,56,862,1512,57.01%,27.25%,1
嘉義縣,大林鎮,0175,371,466,837,38,875,1536,56.97%,24.15%,1
嘉義縣,大林鎮,0176,258,297,555,33,588,1165,50.47%,22.15%,1
嘉義縣,大林鎮,0177,471,503,974,58,1032,1730,59.65%,27.23%,1
嘉義縣,大林鎮,0178,161,114,275,14,289,602,48.01%,26.74%,1
嘉義縣,大林鎮,0179,197,142,339,24,363,716,50.7%,27.51%,1
嘉義縣,大林鎮,0180,172,84,256,12,268,625,42.88%,27.52%,1
嘉義縣,大林鎮,0181,29,43,72,3,75,193,38.86%,15.03%,1
嘉義縣,大林鎮,0182,374,354,728,45,773,1642,47.08%,22.78%,1
嘉義縣,大林鎮,0183,365,364,729,44,773,1465,52.76%,24.91%,1
嘉義縣,大林鎮,0184,196,185,381,35,416,928,44.83%,21.12%,1
嘉義縣,大林鎮,0185,91,59,150,12,162,361,44.88%,25.21%,1
嘉義縣,大林鎮,0186,190,193,383,17,400,814,49.14%,23.34%,1
嘉義縣,大林鎮,0187,413,344,757,20,777,1579,49.21%,26.16%,1
嘉義縣,大林鎮,0188,492,513,1005,59,1064,2041,52.13%,24.11%,1
嘉義縣,大林鎮,0189,238,205,443,35,478,931,51.34%,25.56%,1
嘉義縣,大林鎮,0190,167,161,328,32,360,675,53.33%,24.74%,1
嘉義縣,大林鎮,0191,145,164,309,29,338,655,51.6%,22.14%,1
嘉義縣,大林鎮,0192,173,217,390,30,420,833,50.42%,20.77%,1
嘉義縣,大林鎮,0193,218,246,464,38,502,832,60.34%,26.2%,1
嘉義縣,民雄鄉,0093,339,376,715,34,749,1267,59.12%,26.76%,1
嘉義縣,民雄鄉,0094,239,264,503,26,529,1030,51.36%,23.2%,1
嘉義縣,民雄鄉,0095,423,468,891,65,956,1590,60.13%,26.6%,1
嘉義縣,民雄鄉,0096,429,419,848,24,872,1673,52.12%,25.64%,1
嘉義縣,民雄鄉,0097,509,436,945,43,988,1718,57.51%,29.63%,1
嘉義縣,民雄鄉,0098,319,261,580,42,622,1040,59.81%,30.67%,1
嘉義縣,民雄鄉,0099,275,273,548,47,595,1100,54.09%,25%,1
嘉義縣,民雄鄉,0100,446,327,773,38,811,1559,52.02%,28.61%,1
嘉義縣,民雄鄉,0101,429,459,888,63,951,1862,51.07%,23.04%,1
嘉義縣,民雄鄉,0102,390,370,760,48,808,1435,56.31%,27.18%,1
嘉義縣,民雄鄉,0103,500,343,843,82,925,1751,52.83%,28.56%,1
嘉義縣,民雄鄉,0104,247,244,491,43,534,933,57.23%,26.47%,1
嘉義縣,民雄鄉,0105,272,214,486,31,517,827,62.52%,32.89%,1
嘉義縣,民雄鄉,0106,267,153,420,22,442,843,52.43%,31.67%,1
嘉義縣,民雄鄉,0107,421,468,889,49,938,1774,52.87%,23.73%,1
嘉義縣,民雄鄉,0108,78,97,175,9,184,385,47.79%,20.26%,1
嘉義縣,民雄鄉,0109,353,386,739,36,775,1306,59.34%,27.03%,1
嘉義縣,民雄鄉,0110,169,124,293,27,320,535,59.81%,31.59%,1
嘉義縣,民雄鄉,0111,326,249,575,46,621,1055,58.86%,30.9%,1
嘉義縣,民雄鄉,0112,402,368,770,38,808,1476,54.74%,27.24%,1
嘉義縣,民雄鄉,0113,369,390,759,41,800,1583,50.54%,23.31%,1
嘉義縣,民雄鄉,0114,177,162,339,25,364,758,48.02%,23.35%,1
嘉義縣,民雄鄉,0115,333,303,636,40,676,1354,49.93%,24.59%,1
嘉義縣,民雄鄉,0116,289,368,657,41,698,1202,58.07%,24.04%,1
嘉義縣,民雄鄉,0117,292,318,610,40,650,1175,55.32%,24.85%,1
嘉義縣,民雄鄉,0118,327,362,689,38,727,1423,51.09%,22.98%,1
嘉義縣,民雄鄉,0119,357,458,815,37,852,1612,52.85%,22.15%,1
嘉義縣,民雄鄉,0120,463,454,917,25,942,1695,55.58%,27.32%,1
嘉義縣,民雄鄉,0121,399,363,762,40,802,1665,48.17%,23.96%,1
嘉義縣,民雄鄉,0122,258,205,463,40,503,1019,49.36%,25.32%,1
嘉義縣,民雄鄉,0123,327,337,664,44,708,1352,52.37%,24.19%,1
嘉義縣,民雄鄉,0124,470,388,858,48,906,1620,55.93%,29.01%,1
嘉義縣,民雄鄉,0125,228,230,458,16,474,943,50.27%,24.18%,1
嘉義縣,民雄鄉,0126,388,375,763,45,808,1720,46.98%,22.56%,1
嘉義縣,民雄鄉,0127,483,425,908,61,969,1875,51.68%,25.76%,1
嘉義縣,民雄鄉,0128,350,348,698,34,732,1305,56.09%,26.82%,1
嘉義縣,民雄鄉,0129,357,347,704,49,753,1441,52.26%,24.77%,1
嘉義縣,民雄鄉,0130,405,333,738,46,784,1413,55.48%,28.66%,1
嘉義縣,民雄鄉,0131,420,365,785,48,833,1560,53.4%,26.92%,1
嘉義縣,民雄鄉,0132,590,469,1059,62,1121,2004,55.94%,29.44%,1
嘉義縣,民雄鄉,0133,276,387,663,45,708,1354,52.29%,20.38%,1
嘉義縣,民雄鄉,0134,270,300,570,29,599,1076,55.67%,25.09%,1
嘉義縣,民雄鄉,0135,516,328,844,87,931,1629,57.15%,31.68%,1
嘉義縣,民雄鄉,0136,486,475,961,46,1007,1977,50.94%,24.58%,1
嘉義縣,民雄鄉,0137,370,284,654,52,706,1295,54.52%,28.57%,1
嘉義縣,溪口鄉,0194,387,318,705,62,767,1318,58.19%,29.36%,1
嘉義縣,溪口鄉,0195,194,177,371,29,400,677,59.08%,28.66%,1
嘉義縣,溪口鄉,0196,123,87,210,9,219,417,52.52%,29.5%,1
嘉義縣,溪口鄉,0197,86,65,151,12,163,273,59.71%,31.5%,1
嘉義縣,溪口鄉,0198,268,228,496,40,536,908,59.03%,29.52%,1
嘉義縣,溪口鄉,0199,102,69,171,9,180,386,46.63%,26.42%,1
嘉義縣,溪口鄉,0200,316,235,551,27,578,1039,55.63%,30.41%,1
嘉義縣,溪口鄉,0201,185,126,311,26,337,708,47.6%,26.13%,1
嘉義縣,溪口鄉,0202,264,198,462,12,474,909,52.15%,29.04%,1
嘉義縣,溪口鄉,0203,259,165,424,14,438,786,55.73%,32.95%,1
嘉義縣,溪口鄉,0204,211,150,361,38,399,807,49.44%,26.15%,1
嘉義縣,溪口鄉,0205,305,193,498,12,510,1168,43.66%,26.11%,1
嘉義縣,溪口鄉,0206,332,216,548,50,598,1052,56.84%,31.56%,1
嘉義縣,溪口鄉,0207,163,99,262,25,287,565,50.8%,28.85%,1
嘉義縣,溪口鄉,0208,93,104,197,20,217,388,55.93%,23.97%,1
嘉義縣,溪口鄉,0209,177,127,304,21,325,701,46.36%,25.25%,1
嘉義縣,溪口鄉,0210,251,197,448,24,472,1003,47.06%,25.02%,1
嘉義縣,新港鄉,0138,293,282,575,27,602,1087,55.38%,26.95%,1
嘉義縣,新港鄉,0139,343,356,699,44,743,1116,66.58%,30.73%,1
嘉義縣,新港鄉,0140,211,177,388,24,412,740,55.68%,28.51%,1
嘉義縣,新港鄉,0141,230,180,410,32,442,827,53.45%,27.81%,1
嘉義縣,新港鄉,0142,221,192,413,28,441,704,62.64%,31.39%,1
嘉義縣,新港鄉,0143,267,183,450,28,478,768,62.24%,34.77%,1
嘉義縣,新港鄉,0144,221,220,441,21,462,761,60.71%,29.04%,1
嘉義縣,新港鄉,0145,212,224,436,30,466,850,54.82%,24.94%,1
嘉義縣,新港鄉,0146,390,292,682,38,720,1327,54.26%,29.39%,1
嘉義縣,新港鄉,0147,234,157,391,34,425,756,56.22%,30.95%,1
嘉義縣,新港鄉,0148,249,174,423,43,466,816,57.11%,30.51%,1
嘉義縣,新港鄉,0149,204,132,336,22,358,667,53.67%,30.58%,1
嘉義縣,新港鄉,0150,310,188,498,26,524,942,55.63%,32.91%,1
嘉義縣,新港鄉,0151,215,198,413,31,444,918,48.37%,23.42%,1
嘉義縣,新港鄉,0152,156,105,261,7,268,554,48.38%,28.16%,1
嘉義縣,新港鄉,0153,314,152,466,22,488,929,52.53%,33.8%,1
嘉義縣,新港鄉,0154,125,66,191,16,207,487,42.51%,25.67%,1
嘉義縣,新港鄉,0155,129,115,244,26,270,487,55.44%,26.49%,1
嘉義縣,新港鄉,0156,283,128,411,34,445,836,53.23%,33.85%,1
嘉義縣,新港鄉,0157,278,177,455,30,485,845,57.4%,32.9%,1
嘉義縣,新港鄉,0158,294,148,442,27,469,834,56.24%,35.25%,1
嘉義縣,新港鄉,0159,246,156,402,26,428,753,56.84%,32.67%,1
嘉義縣,新港鄉,0160,393,276,669,39,708,1328,53.31%,29.59%,1
嘉義縣,新港鄉,0161,301,235,536,23,559,969,57.69%,31.06%,1
嘉義縣,新港鄉,0162,312,273,585,39,624,1043,59.83%,29.91%,1
嘉義縣,新港鄉,0163,427,372,799,44,843,1400,60.21%,30.5%,1
嘉義縣,新港鄉,0164,253,145,398,23,421,1017,41.4%,24.88%,1
嘉義縣,新港鄉,0165,309,219,528,30,558,1132,49.29%,27.3%,1
嘉義縣,新港鄉,0166,295,219,514,31,545,1037,52.56%,28.45%,1
嘉義縣,新港鄉,0167,187,117,304,29,333,563,59.15%,33.21%,1
嘉義縣,新港鄉,0168,269,166,435,18,453,849,53.36%,31.68%,1
嘉義縣,六腳鄉,0268,278,228,506,24,530,1165,45.49%,23.86%,1
嘉義縣,六腳鄉,0269,144,149,293,18,311,825,37.7%,17.45%,1
嘉義縣,六腳鄉,0270,222,147,369,26,395,850,46.47%,26.12%,1
嘉義縣,六腳鄉,0271,52,68,120,13,133,222,59.91%,23.42%,1
嘉義縣,六腳鄉,0272,316,257,573,29,602,1216,49.51%,25.99%,1
嘉義縣,六腳鄉,0273,240,205,445,40,485,1200,40.42%,20%,1
嘉義縣,六腳鄉,0274,212,173,385,32,417,877,47.55%,24.17%,1
嘉義縣,六腳鄉,0275,147,108,255,24,279,644,43.32%,22.83%,1
嘉義縣,六腳鄉,0276,117,105,222,10,232,594,39.06%,19.7%,1
嘉義縣,六腳鄉,0277,34,21,55,0,55,167,32.93%,20.36%,1
嘉義縣,六腳鄉,0278,67,19,86,0,86,204,42.16%,32.84%,1
嘉義縣,六腳鄉,0279,83,22,105,3,108,234,46.15%,35.47%,1
嘉義縣,六腳鄉,0280,87,52,139,3,142,361,39.34%,24.1%,1
嘉義縣,六腳鄉,0281,153,153,306,28,334,592,56.42%,25.84%,1
嘉義縣,六腳鄉,0282,160,129,289,29,318,619,51.37%,25.85%,1
嘉義縣,六腳鄉,0283,184,92,276,26,302,714,42.3%,25.77%,1
嘉義縣,六腳鄉,0284,273,231,504,43,547,1051,52.05%,25.98%,1
嘉義縣,六腳鄉,0285,246,193,439,49,488,934,52.25%,26.34%,1
嘉義縣,六腳鄉,0286,272,213,485,34,519,1044,49.71%,26.05%,1
嘉義縣,六腳鄉,0287,337,298,635,34,669,1476,45.33%,22.83%,1
嘉義縣,六腳鄉,0288,146,86,232,11,243,618,39.32%,23.62%,1
嘉義縣,六腳鄉,0289,79,54,133,28,161,478,33.68%,16.53%,1
嘉義縣,六腳鄉,0290,125,88,213,22,235,642,36.6%,19.47%,1
嘉義縣,六腳鄉,0291,151,145,296,11,307,883,34.77%,17.1%,1
嘉義縣,六腳鄉,0292,83,110,193,7,200,739,27.06%,11.23%,1
嘉義縣,六腳鄉,0293,123,82,205,17,222,554,40.07%,22.2%,1
嘉義縣,六腳鄉,0294,132,87,219,17,236,649,36.36%,20.34%,1
嘉義縣,六腳鄉,0295,151,123,274,18,292,689,42.38%,21.92%,1
嘉義縣,六腳鄉,0296,98,70,168,14,182,455,40%,21.54%,1
嘉義縣,六腳鄉,0297,22,15,37,2,39,125,31.2%,17.6%,1
嘉義縣,東石鄉,0298,406,393,799,81,880,1915,45.95%,21.2%,1
嘉義縣,東石鄉,0299,204,134,338,38,376,938,40.09%,21.75%,1
嘉義縣,東石鄉,0300,185,209,394,19,413,1366,30.23%,13.54%,1
嘉義縣,東石鄉,0301,306,347,653,5,658,1676,39.26%,18.26%,1
嘉義縣,東石鄉,0302,226,197,423,49,472,1151,41.01%,19.64%,1
嘉義縣,東石鄉,0303,157,112,269,54,323,716,45.11%,21.93%,1
嘉義縣,東石鄉,0304,82,58,140,12,152,387,39.28%,21.19%,1
嘉義縣,東石鄉,0305,95,133,228,13,241,864,27.89%,11%,1
嘉義縣,東石鄉,0306,170,136,306,12,318,910,34.95%,18.68%,1
嘉義縣,東石鄉,0307,160,111,271,13,284,760,37.37%,21.05%,1
嘉義縣,東石鄉,0308,46,37,83,6,89,166,53.61%,27.71%,1
嘉義縣,東石鄉,0309,32,41,73,7,80,212,37.74%,15.09%,1
嘉義縣,東石鄉,0310,165,153,318,26,344,993,34.64%,16.62%,1
嘉義縣,東石鄉,0311,55,60,115,6,121,306,39.54%,17.97%,1
嘉義縣,東石鄉,0312,175,180,355,56,411,1046,39.29%,16.73%,1
嘉義縣,東石鄉,0313,36,37,73,17,90,235,38.3%,15.32%,1
嘉義縣,東石鄉,0314,262,261,523,47,570,1226,46.49%,21.37%,1
嘉義縣,東石鄉,0315,185,158,343,32,375,843,44.48%,21.95%,1
嘉義縣,東石鄉,0316,110,185,295,17,312,693,45.02%,15.87%,1
嘉義縣,東石鄉,0317,202,179,381,34,415,839,49.46%,24.08%,1
嘉義縣,東石鄉,0318,94,75,169,10,179,363,49.31%,25.9%,1
嘉義縣,東石鄉,0319,71,49,120,5,125,321,38.94%,22.12%,1
嘉義縣,東石鄉,0320,320,235,555,46,601,1083,55.49%,29.55%,1
嘉義縣,東石鄉,0321,254,144,398,26,424,901,47.06%,28.19%,1
嘉義縣,東石鄉,0322,212,192,404,29,433,1216,35.61%,17.43%,1
嘉義縣,東石鄉,0323,145,94,239,20,259,418,61.96%,34.69%,1
嘉義縣,東石鄉,0324,120,28,148,13,161,371,43.4%,32.35%,1
嘉義縣,義竹鄉,0354,116,101,217,21,238,482,49.38%,24.07%,1
嘉義縣,義竹鄉,0355,77,48,125,10,135,223,60.54%,34.53%,1
嘉義縣,義竹鄉,0356,428,373,801,52,853,1529,55.79%,27.99%,1
嘉義縣,義竹鄉,0357,338,296,634,46,680,1175,57.87%,28.77%,1
嘉義縣,義竹鄉,0358,258,262,520,31,551,886,62.19%,29.12%,1
嘉義縣,義竹鄉,0359,174,143,317,23,340,743,45.76%,23.42%,1
嘉義縣,義竹鄉,0360,390,263,653,39,692,1236,55.99%,31.55%,1
嘉義縣,義竹鄉,0361,95,95,190,4,194,377,51.46%,25.2%,1
嘉義縣,義竹鄉,0362,73,71,144,14,158,338,46.75%,21.6%,1
嘉義縣,義竹鄉,0363,23,34,57,3,60,102,58.82%,22.55%,1
嘉義縣,義竹鄉,0364,180,159,339,20,359,763,47.05%,23.59%,1
嘉義縣,義竹鄉,0365,133,102,235,19,254,429,59.21%,31%,1
嘉義縣,義竹鄉,0366,95,108,203,14,217,427,50.82%,22.25%,1
嘉義縣,義竹鄉,0367,178,133,311,31,342,607,56.34%,29.32%,1
嘉義縣,義竹鄉,0368,361,340,701,25,726,1486,48.86%,24.29%,1
嘉義縣,義竹鄉,0369,226,224,450,30,480,835,57.49%,27.07%,1
嘉義縣,義竹鄉,0370,190,136,326,31,357,816,43.75%,23.28%,1
嘉義縣,義竹鄉,0371,199,163,362,30,392,833,47.06%,23.89%,1
嘉義縣,義竹鄉,0372,103,102,205,11,216,433,49.88%,23.79%,1
嘉義縣,義竹鄉,0373,109,144,253,4,257,558,46.06%,19.53%,1
嘉義縣,義竹鄉,0374,179,123,302,20,322,602,53.49%,29.73%,1
嘉義縣,義竹鄉,0375,37,27,64,1,65,140,46.43%,26.43%,1
嘉義縣,義竹鄉,0376,108,63,171,15,186,393,47.33%,27.48%,1
嘉義縣,義竹鄉,0377,156,126,282,18,300,585,51.28%,26.67%,1
嘉義縣,義竹鄉,0378,127,78,205,7,212,526,40.3%,24.14%,1
嘉義縣,義竹鄉,0379,59,21,80,4,84,123,68.29%,47.97%,1
嘉義縣,鹿草鄉,0034,147,79,226,22,248,522,47.51%,28.16%,1
嘉義縣,鹿草鄉,0035,193,98,291,19,310,563,55.06%,34.28%,1
嘉義縣,鹿草鄉,0036,287,312,599,54,653,1304,50.08%,22.01%,1
嘉義縣,鹿草鄉,0037,310,327,637,34,671,1312,51.14%,23.63%,1
嘉義縣,鹿草鄉,0038,82,59,141,2,143,320,44.69%,25.63%,1
嘉義縣,鹿草鄉,0039,45,60,105,5,110,418,26.32%,10.77%,1
嘉義縣,鹿草鄉,0040,259,176,435,39,474,1025,46.24%,25.27%,1
嘉義縣,鹿草鄉,0041,116,68,184,15,199,451,44.12%,25.72%,1
嘉義縣,鹿草鄉,0042,254,163,417,38,455,830,54.82%,30.6%,1
嘉義縣,鹿草鄉,0043,293,181,474,24,498,1050,47.43%,27.9%,1
嘉義縣,鹿草鄉,0044,172,206,378,29,407,972,41.87%,17.7%,1
嘉義縣,鹿草鄉,0045,236,186,422,27,449,962,46.67%,24.53%,1
嘉義縣,鹿草鄉,0046,197,130,327,29,356,678,52.51%,29.06%,1
嘉義縣,鹿草鄉,0047,88,39,127,12,139,262,53.05%,33.59%,1
嘉義縣,鹿草鄉,0048,191,169,360,35,395,906,43.6%,21.08%,1
嘉義縣,鹿草鄉,0049,59,47,106,6,112,306,36.6%,19.28%,1
嘉義縣,鹿草鄉,0050,297,229,526,36,562,1062,52.92%,27.97%,1
嘉義縣,鹿草鄉,0051,112,88,200,11,211,373,56.57%,30.03%,1
嘉義縣,鹿草鄉,0052,77,82,159,16,175,324,54.01%,23.77%,1
嘉義縣,鹿草鄉,0053,76,66,142,9,151,297,50.84%,25.59%,1
嘉義縣,水上鄉,0054,224,272,496,21,517,1024,50.49%,21.88%,1
嘉義縣,水上鄉,0055,294,285,579,36,615,1015,60.59%,28.97%,1
嘉義縣,水上鄉,0056,411,485,896,51,947,1932,49.02%,21.27%,1
嘉義縣,水上鄉,0057,338,321,659,31,690,1170,58.97%,28.89%,1
嘉義縣,水上鄉,0058,350,376,726,42,768,1305,58.85%,26.82%,1
嘉義縣,水上鄉,0059,273,312,585,38,623,1242,50.16%,21.98%,1
嘉義縣,水上鄉,0060,90,66,156,7,163,324,50.31%,27.78%,1
嘉義縣,水上鄉,0061,160,161,321,12,333,622,53.54%,25.72%,1
嘉義縣,水上鄉,0062,275,312,587,47,634,1216,52.14%,22.62%,1
嘉義縣,水上鄉,0063,228,310,538,28,566,1020,55.49%,22.35%,1
嘉義縣,水上鄉,0064,225,239,464,20,484,771,62.78%,29.18%,1
嘉義縣,水上鄉,0065,72,183,255,22,277,441,62.81%,16.33%,1
嘉義縣,水上鄉,0066,224,168,392,23,415,626,66.29%,35.78%,1
嘉義縣,水上鄉,0067,196,139,335,16,351,570,61.58%,34.39%,1
嘉義縣,水上鄉,0068,99,80,179,16,195,368,52.99%,26.9%,1
嘉義縣,水上鄉,0069,261,227,488,53,541,1037,52.17%,25.17%,1
嘉義縣,水上鄉,0070,261,277,538,44,582,1065,54.65%,24.51%,1
嘉義縣,水上鄉,0071,256,178,434,75,509,802,63.47%,31.92%,1
嘉義縣,水上鄉,0072,512,486,998,25,1023,1948,52.52%,26.28%,1
嘉義縣,水上鄉,0073,270,235,505,33,538,1028,52.33%,26.26%,1
嘉義縣,水上鄉,0074,149,197,346,26,372,641,58.03%,23.24%,1
嘉義縣,水上鄉,0075,96,135,231,16,247,408,60.54%,23.53%,1
嘉義縣,水上鄉,0076,251,181,432,29,461,794,58.06%,31.61%,1
嘉義縣,水上鄉,0077,139,118,257,21,278,569,48.86%,24.43%,1
嘉義縣,水上鄉,0078,213,220,433,21,454,806,56.33%,26.43%,1
嘉義縣,水上鄉,0079,222,312,534,21,555,960,57.81%,23.13%,1
嘉義縣,水上鄉,0080,553,512,1065,47,1112,2035,54.64%,27.17%,1
嘉義縣,水上鄉,0081,563,444,1007,67,1074,1987,54.05%,28.33%,1
嘉義縣,水上鄉,0082,323,304,627,20,647,1154,56.07%,27.99%,1
嘉義縣,水上鄉,0083,571,513,1084,47,1131,2208,51.22%,25.86%,1
嘉義縣,水上鄉,0084,440,463,903,40,943,2102,44.86%,20.93%,1
嘉義縣,水上鄉,0085,328,302,630,33,663,1309,50.65%,25.06%,1
嘉義縣,水上鄉,0086,437,424,861,46,907,1671,54.28%,26.15%,1
嘉義縣,水上鄉,0087,241,181,422,32,454,822,55.23%,29.32%,1
嘉義縣,水上鄉,0088,466,410,876,40,916,1772,51.69%,26.3%,1
嘉義縣,水上鄉,0089,518,450,968,58,1026,1919,53.47%,26.99%,1
嘉義縣,水上鄉,0090,196,202,398,21,419,912,45.94%,21.49%,1
嘉義縣,水上鄉,0091,252,237,489,24,513,992,51.71%,25.4%,1
嘉義縣,水上鄉,0092,314,227,541,40,581,1270,45.75%,24.72%,1
嘉義縣,中埔鄉,0380,204,226,430,14,444,1046,42.45%,19.5%,1
嘉義縣,中埔鄉,0381,423,364,787,59,846,1788,47.32%,23.66%,1
嘉義縣,中埔鄉,0382,415,358,773,33,806,1730,46.59%,23.99%,1
嘉義縣,中埔鄉,0383,339,394,733,48,781,1581,49.4%,21.44%,1
嘉義縣,中埔鄉,0384,312,339,651,31,682,1594,42.79%,19.57%,1
嘉義縣,中埔鄉,0385,411,471,882,36,918,1801,50.97%,22.82%,1
嘉義縣,中埔鄉,0386,444,438,882,47,929,1862,49.89%,23.85%,1
嘉義縣,中埔鄉,0387,416,409,825,31,856,1803,47.48%,23.07%,1
嘉義縣,中埔鄉,0388,339,386,725,48,773,1481,52.19%,22.89%,1
嘉義縣,中埔鄉,0389,351,337,688,42,730,1366,53.44%,25.7%,1
嘉義縣,中埔鄉,0390,328,331,659,54,713,1599,44.59%,20.51%,1
嘉義縣,中埔鄉,0391,332,246,578,33,611,1196,51.09%,27.76%,1
嘉義縣,中埔鄉,0392,417,346,763,68,831,1809,45.94%,23.05%,1
嘉義縣,中埔鄉,0393,240,226,466,12,478,953,50.16%,25.18%,1
嘉義縣,中埔鄉,0394,313,316,629,43,672,1441,46.63%,21.72%,1
嘉義縣,中埔鄉,0395,382,440,822,45,867,1882,46.07%,20.3%,1
嘉義縣,中埔鄉,0396,299,258,557,20,577,1470,39.25%,20.34%,1
嘉義縣,中埔鄉,0397,331,366,697,57,754,1699,44.38%,19.48%,1
嘉義縣,中埔鄉,0398,76,92,168,11,179,422,42.42%,18.01%,1
嘉義縣,中埔鄉,0399,262,214,476,42,518,1030,50.29%,25.44%,1
嘉義縣,中埔鄉,0400,248,163,411,27,438,879,49.83%,28.21%,1
嘉義縣,中埔鄉,0401,165,195,360,17,377,828,45.53%,19.93%,1
嘉義縣,中埔鄉,0402,217,233,450,50,500,881,56.75%,24.63%,1
嘉義縣,中埔鄉,0403,78,61,139,9,148,296,50%,26.35%,1
嘉義縣,中埔鄉,0404,214,201,415,64,479,979,48.93%,21.86%,1
嘉義縣,中埔鄉,0405,262,284,546,30,576,1268,45.43%,20.66%,1
嘉義縣,中埔鄉,0406,118,105,223,9,232,670,34.63%,17.61%,1
嘉義縣,中埔鄉,0407,217,180,397,34,431,754,57.16%,28.78%,1
嘉義縣,中埔鄉,0408,195,133,328,34,362,648,55.86%,30.09%,1
嘉義縣,中埔鄉,0409,144,146,290,15,305,741,41.16%,19.43%,1
嘉義縣,中埔鄉,0410,137,102,239,4,243,518,46.91%,26.45%,1
嘉義縣,中埔鄉,0411,101,119,220,21,241,482,50%,20.95%,1
嘉義縣,中埔鄉,0412,76,61,137,12,149,348,42.82%,21.84%,1
嘉義縣,中埔鄉,0413,68,77,145,5,150,294,51.02%,23.13%,1
嘉義縣,竹崎鄉,0414,353,344,697,31,728,1312,55.49%,26.91%,1
嘉義縣,竹崎鄉,0415,327,335,662,21,683,1210,56.45%,27.02%,1
嘉義縣,竹崎鄉,0416,274,245,519,38,557,991,56.21%,27.65%,1
嘉義縣,竹崎鄉,0417,304,306,610,35,645,1207,53.44%,25.19%,1
嘉義縣,竹崎鄉,0418,187,147,334,14,348,752,46.28%,24.87%,1
嘉義縣,竹崎鄉,0419,265,196,461,36,497,833,59.66%,31.81%,1
嘉義縣,竹崎鄉,0420,371,274,645,49,694,1220,56.89%,30.41%,1
嘉義縣,竹崎鄉,0421,187,172,359,14,373,616,60.55%,30.36%,1
嘉義縣,竹崎鄉,0422,242,245,487,45,532,1031,51.6%,23.47%,1
嘉義縣,竹崎鄉,0423,316,316,632,40,672,1292,52.01%,24.46%,1
嘉義縣,竹崎鄉,0424,483,558,1041,63,1104,1995,55.34%,24.21%,1
嘉義縣,竹崎鄉,0425,446,472,918,38,956,1996,47.9%,22.34%,1
嘉義縣,竹崎鄉,0426,327,376,703,57,760,1449,52.45%,22.57%,1
嘉義縣,竹崎鄉,0427,348,373,721,33,754,1420,53.1%,24.51%,1
嘉義縣,竹崎鄉,0428,451,410,861,41,902,1590,56.73%,28.36%,1
嘉義縣,竹崎鄉,0429,161,197,358,35,393,771,50.97%,20.88%,1
嘉義縣,竹崎鄉,0430,250,206,456,30,486,1014,47.93%,24.65%,1
嘉義縣,竹崎鄉,0431,79,49,128,3,131,327,40.06%,24.16%,1
嘉義縣,竹崎鄉,0432,159,195,354,13,367,687,53.42%,23.14%,1
嘉義縣,竹崎鄉,0433,143,156,299,20,319,641,49.77%,22.31%,1
嘉義縣,竹崎鄉,0434,111,146,257,4,261,474,55.06%,23.42%,1
嘉義縣,竹崎鄉,0435,60,116,176,19,195,383,50.91%,15.67%,1
嘉義縣,竹崎鄉,0436,162,183,345,38,383,619,61.87%,26.17%,1
嘉義縣,竹崎鄉,0437,49,44,93,9,102,214,47.66%,22.9%,1
嘉義縣,竹崎鄉,0438,362,398,760,64,824,1568,52.55%,23.09%,1
嘉義縣,竹崎鄉,0439,136,142,278,29,307,658,46.66%,20.67%,1
嘉義縣,竹崎鄉,0440,119,114,233,24,257,434,59.22%,27.42%,1
嘉義縣,竹崎鄉,0441,273,204,477,41,518,917,56.49%,29.77%,1
嘉義縣,竹崎鄉,0442,238,211,449,31,480,981,48.93%,24.26%,1
嘉義縣,竹崎鄉,0443,164,177,341,29,370,789,46.89%,20.79%,1
嘉義縣,竹崎鄉,0444,17,19,36,1,37,108,34.26%,15.74%,1
嘉義縣,竹崎鄉,0445,56,16,72,3,75,235,31.91%,23.83%,1
嘉義縣,竹崎鄉,0446,68,77,145,3,148,331,44.71%,20.54%,1
嘉義縣,竹崎鄉,0447,140,133,273,7,280,450,62.22%,31.11%,1
嘉義縣,竹崎鄉,0448,84,111,195,7,202,462,43.72%,18.18%,1
嘉義縣,竹崎鄉,0449,36,61,97,11,108,251,43.03%,14.34%,1
嘉義縣,梅山鄉,0211,293,244,537,18,555,1041,53.31%,28.15%,1
嘉義縣,梅山鄉,0212,375,316,691,65,756,1245,60.72%,30.12%,1
嘉義縣,梅山鄉,0213,255,285,540,31,571,917,62.27%,27.81%,1
嘉義縣,梅山鄉,0214,324,84,408,36,444,1189,37.34%,27.25%,1
嘉義縣,梅山鄉,0215,386,354,740,50,790,1388,56.92%,27.81%,1
嘉義縣,梅山鄉,0216,441,511,952,42,994,1827,54.41%,24.14%,1
嘉義縣,梅山鄉,0217,177,142,319,25,344,545,63.12%,32.48%,1
嘉義縣,梅山鄉,0218,107,64,171,12,183,407,44.96%,26.29%,1
嘉義縣,梅山鄉,0219,183,172,355,25,380,636,59.75%,28.77%,1
嘉義縣,梅山鄉,0220,168,143,311,29,340,576,59.03%,29.17%,1
嘉義縣,梅山鄉,0221,446,422,868,64,932,1674,55.68%,26.64%,1
嘉義縣,梅山鄉,0222,171,213,384,11,395,858,46.04%,19.93%,1
嘉義縣,梅山鄉,0223,100,205,305,27,332,526,63.12%,19.01%,1
嘉義縣,梅山鄉,0224,95,76,171,18,189,372,50.81%,25.54%,1
嘉義縣,梅山鄉,0225,121,116,237,21,258,506,50.99%,23.91%,1
嘉義縣,梅山鄉,0226,100,183,283,26,309,433,71.36%,23.09%,1
嘉義縣,梅山鄉,0227,87,70,157,16,173,404,42.82%,21.53%,1
嘉義縣,梅山鄉,0228,73,61,134,13,147,293,50.17%,24.91%,1
嘉義縣,梅山鄉,0229,146,282,428,25,453,712,63.62%,20.51%,1
嘉義縣,梅山鄉,0230,134,209,343,30,373,602,61.96%,22.26%,1
嘉義縣,梅山鄉,0231,95,138,233,18,251,515,48.74%,18.45%,1
嘉義縣,梅山鄉,0232,65,90,155,9,164,417,39.33%,15.59%,1
嘉義縣,番路鄉,0450,290,369,659,51,710,1174,60.48%,24.7%,1
嘉義縣,番路鄉,0451,132,140,272,10,282,449,62.81%,29.4%,1
嘉義縣,番路鄉,0452,201,229,430,28,458,753,60.82%,26.69%,1
嘉義縣,番路鄉,0453,118,126,244,17,261,551,47.37%,21.42%,1
嘉義縣,番路鄉,0454,467,478,945,66,1011,1791,56.45%,26.07%,1
嘉義縣,番路鄉,0455,233,263,496,44,540,849,63.6%,27.44%,1
嘉義縣,番路鄉,0456,210,255,465,43,508,866,58.66%,24.25%,1
嘉義縣,番路鄉,0457,139,273,412,28,440,800,55%,17.37%,1
嘉義縣,番路鄉,0458,184,76,260,11,271,444,61.04%,41.44%,1
嘉義縣,番路鄉,0459,105,146,251,16,267,635,42.05%,16.54%,1
嘉義縣,番路鄉,0460,63,74,137,7,144,319,45.14%,19.75%,1
嘉義縣,番路鄉,0461,124,226,350,29,379,642,59.03%,19.31%,1
嘉義縣,番路鄉,0462,101,116,217,19,236,509,46.37%,19.84%,1
嘉義縣,番路鄉,0463,26,65,91,1,92,162,56.79%,16.05%,1
嘉義縣,番路鄉,0464,45,67,112,8,120,212,56.6%,21.23%,1
嘉義縣,大埔鄉,0465,344,420,764,51,815,1468,55.52%,23.43%,1
嘉義縣,大埔鄉,0466,60,72,132,2,134,320,41.88%,18.75%,1
嘉義縣,大埔鄉,0467,93,73,166,8,174,304,57.24%,30.59%,1
嘉義縣,大埔鄉,0468,50,41,91,2,93,184,50.54%,27.17%,1
嘉義縣,大埔鄉,0469,70,81,151,6,157,234,67.09%,29.91%,1
嘉義縣,大埔鄉,0470,112,141,253,8,261,495,52.73%,22.63%,1
嘉義縣,大埔鄉,0471,45,67,112,1,113,199,56.78%,22.61%,1
嘉義縣,大埔鄉,0472,53,49,102,7,109,226,48.23%,23.45%,1
嘉義縣,大埔鄉,0473,147,181,328,19,347,569,60.98%,25.83%,1
嘉義縣,阿里山鄉,0474,66,113,179,8,187,371,50.4%,17.79%,1
嘉義縣,阿里山鄉,0475,25,58,83,3,86,197,43.65%,12.69%,1
嘉義縣,阿里山鄉,0476,29,45,74,1,75,152,49.34%,19.08%,1
嘉義縣,阿里山鄉,0477,35,40,75,3,78,231,33.77%,15.15%,1
嘉義縣,阿里山鄉,0478,10,11,21,0,21,72,29.17%,13.89%,1
嘉義縣,阿里山鄉,0479,45,86,131,3,134,311,43.09%,14.47%,1
嘉義縣,阿里山鄉,0480,44,108,152,11,163,306,53.27%,14.38%,1
嘉義縣,阿里山鄉,0481,152,286,438,13,451,970,46.49%,15.67%,1
嘉義縣,阿里山鄉,0482,110,325,435,19,454,827,54.9%,13.3%,1
嘉義縣,阿里山鄉,0483,34,91,125,1,126,238,52.94%,14.29%,1
嘉義縣,阿里山鄉,0484,29,97,126,9,135,479,28.18%,6.05%,1
嘉義縣,阿里山鄉,0485,28,73,101,7,108,291,37.11%,9.62%,1
嘉義縣,阿里山鄉,0486,61,82,143,16,159,246,64.63%,24.8%,1
屏東縣,屏東市,0001,76,51,127,2,129,237,54.43%,32.07%,1
屏東縣,屏東市,0002,104,57,161,5,166,294,56.46%,35.37%,1
屏東縣,屏東市,0003,190,136,326,4,330,582,56.7%,32.65%,1
屏東縣,屏東市,0004,212,188,400,20,420,713,58.91%,29.73%,1
屏東縣,屏東市,0005,281,26,307,14,321,572,56.12%,49.13%,1
屏東縣,屏東市,0006,113,162,275,9,284,455,62.42%,24.84%,1
屏東縣,屏東市,0007,82,60,142,3,145,249,58.23%,32.93%,1
屏東縣,屏東市,0008,337,308,645,27,672,1315,51.1%,25.63%,1
屏東縣,屏東市,0009,381,28,409,29,438,1373,31.9%,27.75%,1
屏東縣,屏東市,0010,211,216,427,23,450,713,63.11%,29.59%,1
屏東縣,屏東市,0011,202,151,353,21,374,573,65.27%,35.25%,1
屏東縣,屏東市,0012,128,65,193,8,201,297,67.68%,43.1%,1
屏東縣,屏東市,0013,149,126,275,6,281,409,68.7%,36.43%,1
屏東縣,屏東市,0014,89,64,153,7,160,286,55.94%,31.12%,1
屏東縣,屏東市,0015,147,107,254,7,261,421,62%,34.92%,1
屏東縣,屏東市,0016,201,141,342,7,349,569,61.34%,35.33%,1
屏東縣,屏東市,0017,142,104,246,9,255,459,55.56%,30.94%,1
屏東縣,屏東市,0018,228,202,430,14,444,672,66.07%,33.93%,1
屏東縣,屏東市,0019,237,165,402,26,428,668,64.07%,35.48%,1
屏東縣,屏東市,0020,129,116,245,8,253,411,61.56%,31.39%,1
屏東縣,屏東市,0021,248,182,430,15,445,768,57.94%,32.29%,1
屏東縣,屏東市,0022,206,219,425,15,440,786,55.98%,26.21%,1
屏東縣,屏東市,0023,264,247,511,23,534,890,60%,29.66%,1
屏東縣,屏東市,0024,308,426,734,30,764,1353,56.47%,22.76%,1
屏東縣,屏東市,0025,301,422,723,19,742,1386,53.54%,21.72%,1
屏東縣,屏東市,0026,285,454,739,25,764,1413,54.07%,20.17%,1
屏東縣,屏東市,0027,309,354,663,27,690,1272,54.25%,24.29%,1
屏東縣,屏東市,0028,287,405,692,23,715,1287,55.56%,22.3%,1
屏東縣,屏東市,0029,304,455,759,24,783,1311,59.73%,23.19%,1
屏東縣,屏東市,0030,329,373,702,17,719,1285,55.95%,25.6%,1
屏東縣,屏東市,0031,349,375,724,30,754,1297,58.13%,26.91%,1
屏東縣,屏東市,0032,302,434,736,18,754,1361,55.4%,22.19%,1
屏東縣,屏東市,0033,297,391,688,31,719,1381,52.06%,21.51%,1
屏東縣,屏東市,0034,334,414,748,16,764,1258,60.73%,26.55%,1
屏東縣,屏東市,0035,337,360,697,27,724,1259,57.51%,26.77%,1
屏東縣,屏東市,0036,234,339,573,24,597,1076,55.48%,21.75%,1
屏東縣,屏東市,0037,299,348,647,26,673,1162,57.92%,25.73%,1
屏東縣,屏東市,0038,331,407,738,21,759,1318,57.59%,25.11%,1
屏東縣,屏東市,0039,240,269,509,20,529,939,56.34%,25.56%,1
屏東縣,屏東市,0040,220,315,535,25,560,972,57.61%,22.63%,1
屏東縣,屏東市,0041,378,472,850,24,874,1535,56.94%,24.63%,1
屏東縣,屏東市,0042,287,376,663,31,694,1419,48.91%,20.23%,1
屏東縣,屏東市,0043,289,413,702,8,710,1398,50.79%,20.67%,1
屏東縣,屏東市,0044,353,367,720,38,758,1405,53.95%,25.12%,1
屏東縣,屏東市,0045,351,440,791,29,820,1486,55.18%,23.62%,1
屏東縣,屏東市,0046,322,250,572,25,597,1061,56.27%,30.35%,1
屏東縣,屏東市,0047,425,292,717,52,769,1540,49.94%,27.6%,1
屏東縣,屏東市,0048,350,246,596,9,605,1141,53.02%,30.67%,1
屏東縣,屏東市,0049,295,305,600,20,620,1247,49.72%,23.66%,1
屏東縣,屏東市,0050,287,419,706,30,736,1446,50.9%,19.85%,1
屏東縣,屏東市,0051,296,424,720,22,742,1303,56.95%,22.72%,1
屏東縣,屏東市,0052,281,386,667,24,691,1253,55.15%,22.43%,1
屏東縣,屏東市,0053,315,375,690,28,718,1315,54.6%,23.95%,1
屏東縣,屏東市,0054,330,366,696,30,726,1425,50.95%,23.16%,1
屏東縣,屏東市,0055,368,371,739,18,757,1423,53.2%,25.86%,1
屏東縣,屏東市,0056,334,438,772,29,801,1400,57.21%,23.86%,1
屏東縣,屏東市,0057,353,416,769,26,795,1359,58.5%,25.97%,1
屏東縣,屏東市,0058,167,526,693,23,716,1328,53.92%,12.58%,1
屏東縣,屏東市,0059,235,552,787,28,815,1539,52.96%,15.27%,1
屏東縣,屏東市,0060,71,86,157,5,162,391,41.43%,18.16%,1
屏東縣,屏東市,0061,53,60,113,4,117,200,58.5%,26.5%,1
屏東縣,屏東市,0062,93,68,161,9,170,328,51.83%,28.35%,1
屏東縣,屏東市,0063,48,74,122,0,122,231,52.81%,20.78%,1
屏東縣,屏東市,0064,265,226,491,30,521,945,55.13%,28.04%,1
屏東縣,屏東市,0065,285,257,542,26,568,1053,53.94%,27.07%,1
屏東縣,屏東市,0066,288,228,516,31,547,1043,52.44%,27.61%,1
屏東縣,屏東市,0067,336,202,538,22,560,1061,52.78%,31.67%,1
屏東縣,屏東市,0068,253,193,446,17,463,876,52.85%,28.88%,1
屏東縣,屏東市,0069,412,328,740,104,844,1468,57.49%,28.07%,1
屏東縣,屏東市,0070,380,317,697,34,731,1454,50.28%,26.13%,1
屏東縣,屏東市,0071,408,268,676,23,699,1205,58.01%,33.86%,1
屏東縣,屏東市,0072,388,280,668,22,690,1284,53.74%,30.22%,1
屏東縣,屏東市,0073,246,346,592,25,617,1219,50.62%,20.18%,1
屏東縣,屏東市,0074,418,408,826,57,883,1544,57.19%,27.07%,1
屏東縣,屏東市,0075,417,358,775,41,816,1485,54.95%,28.08%,1
屏東縣,屏東市,0076,376,366,742,33,775,1387,55.88%,27.11%,1
屏東縣,屏東市,0077,229,253,482,16,498,953,52.26%,24.03%,1
屏東縣,屏東市,0078,358,505,863,38,901,1603,56.21%,22.33%,1
屏東縣,屏東市,0079,188,111,299,14,313,535,58.5%,35.14%,1
屏東縣,屏東市,0080,305,279,584,32,616,1119,55.05%,27.26%,1
屏東縣,屏東市,0081,203,249,452,29,481,847,56.79%,23.97%,1
屏東縣,屏東市,0082,304,219,523,34,557,923,60.35%,32.94%,1
屏東縣,屏東市,0083,361,253,614,31,645,1227,52.57%,29.42%,1
屏東縣,屏東市,0084,277,262,539,36,575,1039,55.34%,26.66%,1
屏東縣,屏東市,0085,395,344,739,61,800,1485,53.87%,26.6%,1
屏東縣,屏東市,0086,234,209,443,33,476,867,54.9%,26.99%,1
屏東縣,屏東市,0087,222,279,501,22,523,918,56.97%,24.18%,1
屏東縣,屏東市,0088,192,131,323,26,349,663,52.64%,28.96%,1
屏東縣,屏東市,0089,322,251,573,13,586,1215,48.23%,26.5%,1
屏東縣,屏東市,0090,421,355,776,36,812,1628,49.88%,25.86%,1
屏東縣,屏東市,0091,301,358,659,20,679,1209,56.16%,24.9%,1
屏東縣,屏東市,0092,258,432,690,14,704,1110,63.42%,23.24%,1
屏東縣,屏東市,0093,182,142,324,10,334,684,48.83%,26.61%,1
屏東縣,屏東市,0094,348,270,618,23,641,1349,47.52%,25.8%,1
屏東縣,屏東市,0095,340,373,713,30,743,1457,51%,23.34%,1
屏東縣,屏東市,0096,322,417,739,26,765,1447,52.87%,22.25%,1
屏東縣,屏東市,0097,347,326,673,17,690,1354,50.96%,25.63%,1
屏東縣,屏東市,0098,462,402,864,37,901,1583,56.92%,29.19%,1
屏東縣,屏東市,0099,351,527,878,22,900,1707,52.72%,20.56%,1
屏東縣,屏東市,0100,314,482,796,20,816,1637,49.85%,19.18%,1
屏東縣,屏東市,0101,284,418,702,7,709,1459,48.59%,19.47%,1
屏東縣,屏東市,0102,318,597,915,32,947,1759,53.84%,18.08%,1
屏東縣,屏東市,0103,322,659,981,20,1001,1950,51.33%,16.51%,1
屏東縣,屏東市,0104,294,597,891,31,922,1729,53.33%,17%,1
屏東縣,屏東市,0105,340,464,804,23,827,1592,51.95%,21.36%,1
屏東縣,屏東市,0106,272,425,697,28,725,1437,50.45%,18.93%,1
屏東縣,屏東市,0107,252,354,606,20,626,1204,51.99%,20.93%,1
屏東縣,屏東市,0108,258,429,687,24,711,1340,53.06%,19.25%,1
屏東縣,屏東市,0109,283,414,697,21,718,1322,54.31%,21.41%,1
屏東縣,屏東市,0110,254,477,731,25,756,1462,51.71%,17.37%,1
屏東縣,屏東市,0111,535,1008,1543,49,1592,3241,49.12%,16.51%,1
屏東縣,屏東市,0112,246,464,710,19,729,1477,49.36%,16.66%,1
屏東縣,屏東市,0113,195,205,400,16,416,821,50.67%,23.75%,1
屏東縣,屏東市,0114,245,244,489,13,502,1099,45.68%,22.29%,1
屏東縣,屏東市,0115,239,584,823,49,872,1688,51.66%,14.16%,1
屏東縣,屏東市,0116,289,302,591,16,607,1167,52.01%,24.76%,1
屏東縣,屏東市,0117,210,240,450,39,489,915,53.44%,22.95%,1
屏東縣,屏東市,0118,221,286,507,25,532,1683,31.61%,13.13%,1
屏東縣,屏東市,0119,298,460,758,16,774,1497,51.7%,19.91%,1
屏東縣,屏東市,0120,288,286,574,24,598,1129,52.97%,25.51%,1
屏東縣,屏東市,0121,246,406,652,20,672,1232,54.55%,19.97%,1
屏東縣,屏東市,0122,231,231,462,11,473,853,55.45%,27.08%,1
屏東縣,屏東市,0123,220,274,494,16,510,869,58.69%,25.32%,1
屏東縣,屏東市,0124,293,352,645,27,672,1169,57.49%,25.06%,1
屏東縣,屏東市,0125,265,306,571,21,592,1058,55.95%,25.05%,1
屏東縣,屏東市,0126,259,390,649,25,674,1344,50.15%,19.27%,1
屏東縣,屏東市,0127,275,406,681,23,704,1299,54.2%,21.17%,1
屏東縣,屏東市,0128,287,309,596,25,621,1204,51.58%,23.84%,1
屏東縣,屏東市,0129,255,317,572,23,595,1123,52.98%,22.71%,1
屏東縣,屏東市,0130,321,305,626,30,656,1318,49.77%,24.36%,1
屏東縣,屏東市,0131,265,222,487,32,519,865,60%,30.64%,1
屏東縣,屏東市,0132,292,239,531,14,545,1100,49.55%,26.55%,1
屏東縣,屏東市,0133,274,301,575,24,599,1215,49.3%,22.55%,1
屏東縣,屏東市,0134,279,433,712,21,733,1370,53.5%,20.36%,1
屏東縣,屏東市,0135,288,353,641,21,662,1240,53.39%,23.23%,1
屏東縣,屏東市,0136,288,364,652,18,670,1168,57.36%,24.66%,1
屏東縣,屏東市,0137,232,351,583,16,599,1079,55.51%,21.5%,1
屏東縣,屏東市,0138,342,388,730,21,751,1289,58.26%,26.53%,1
屏東縣,屏東市,0139,270,302,572,19,591,1115,53%,24.22%,1
屏東縣,屏東市,0140,336,492,828,30,858,1491,57.55%,22.54%,1
屏東縣,屏東市,0141,276,394,670,24,694,1411,49.18%,19.56%,1
屏東縣,屏東市,0142,323,581,904,23,927,1803,51.41%,17.91%,1
屏東縣,屏東市,0143,189,230,419,18,437,744,58.74%,25.4%,1
屏東縣,屏東市,0144,165,190,355,12,367,678,54.13%,24.34%,1
屏東縣,屏東市,0145,199,199,398,16,414,681,60.79%,29.22%,1
屏東縣,屏東市,0146,391,328,719,21,740,1535,48.21%,25.47%,1
屏東縣,屏東市,0147,219,302,521,29,550,954,57.65%,22.96%,1
屏東縣,屏東市,0148,287,297,584,32,616,1018,60.51%,28.19%,1
屏東縣,屏東市,0149,298,338,636,19,655,1154,56.76%,25.82%,1
屏東縣,潮州鎮,0150,132,154,286,20,306,504,60.71%,26.19%,1
屏東縣,潮州鎮,0151,379,408,787,39,826,1711,48.28%,22.15%,1
屏東縣,潮州鎮,0152,404,439,843,24,867,1634,53.06%,24.72%,1
屏東縣,潮州鎮,0153,309,350,659,28,687,1414,48.59%,21.85%,1
屏東縣,潮州鎮,0154,200,155,355,25,380,603,63.02%,33.17%,1
屏東縣,潮州鎮,0155,282,179,461,31,492,896,54.91%,31.47%,1
屏東縣,潮州鎮,0156,293,347,640,37,677,1285,52.68%,22.8%,1
屏東縣,潮州鎮,0157,393,447,840,32,872,1744,50%,22.53%,1
屏東縣,潮州鎮,0158,275,313,588,31,619,1071,57.8%,25.68%,1
屏東縣,潮州鎮,0159,332,356,688,28,716,1209,59.22%,27.46%,1
屏東縣,潮州鎮,0160,297,308,605,24,629,1159,54.27%,25.63%,1
屏東縣,潮州鎮,0161,292,344,636,33,669,1296,51.62%,22.53%,1
屏東縣,潮州鎮,0162,354,413,767,27,794,1466,54.16%,24.15%,1
屏東縣,潮州鎮,0163,306,310,616,38,654,1130,57.88%,27.08%,1
屏東縣,潮州鎮,0164,345,404,749,34,783,1439,54.41%,23.97%,1
屏東縣,潮州鎮,0165,236,263,499,35,534,897,59.53%,26.31%,1
屏東縣,潮州鎮,0166,290,367,657,35,692,1225,56.49%,23.67%,1
屏東縣,潮州鎮,0167,331,231,562,25,587,1158,50.69%,28.58%,1
屏東縣,潮州鎮,0168,135,69,204,21,225,481,46.78%,28.07%,1
屏東縣,潮州鎮,0169,293,242,535,24,559,972,57.51%,30.14%,1
屏東縣,潮州鎮,0170,358,358,716,20,736,1245,59.12%,28.76%,1
屏東縣,潮州鎮,0171,404,329,733,30,763,1415,53.92%,28.55%,1
屏東縣,潮州鎮,0172,292,300,592,15,607,1255,48.37%,23.27%,1
屏東縣,潮州鎮,0173,259,173,432,23,455,1058,43.01%,24.48%,1
屏東縣,潮州鎮,0174,294,298,592,26,618,1187,52.06%,24.77%,1
屏東縣,潮州鎮,0175,302,281,583,32,615,1083,56.79%,27.89%,1
屏東縣,潮州鎮,0176,397,367,764,24,788,1590,49.56%,24.97%,1
屏東縣,潮州鎮,0177,370,448,818,34,852,1543,55.22%,23.98%,1
屏東縣,潮州鎮,0178,378,408,786,31,817,1631,50.09%,23.18%,1
屏東縣,潮州鎮,0179,254,348,602,26,628,1159,54.18%,21.92%,1
屏東縣,潮州鎮,0180,294,315,609,18,627,1099,57.05%,26.75%,1
屏東縣,潮州鎮,0181,276,285,561,34,595,1200,49.58%,23%,1
屏東縣,潮州鎮,0182,326,348,674,32,706,1391,50.75%,23.44%,1
屏東縣,潮州鎮,0183,200,291,491,30,521,881,59.14%,22.7%,1
屏東縣,潮州鎮,0184,95,96,191,19,210,454,46.26%,20.93%,1
屏東縣,潮州鎮,0185,439,399,838,61,899,1658,54.22%,26.48%,1
屏東縣,潮州鎮,0186,268,144,412,20,432,822,52.55%,32.6%,1
屏東縣,潮州鎮,0187,257,182,439,15,454,948,47.89%,27.11%,1
屏東縣,潮州鎮,0188,290,206,496,28,524,1194,43.89%,24.29%,1
屏東縣,潮州鎮,0189,118,59,177,14,191,337,56.68%,35.01%,1
屏東縣,東港鎮,0190,273,284,557,29,586,981,59.73%,27.83%,1
屏東縣,東港鎮,0191,344,277,621,27,648,1070,60.56%,32.15%,1
屏東縣,東港鎮,0192,174,148,322,26,348,527,66.03%,33.02%,1
屏東縣,東港鎮,0193,121,115,236,13,249,395,63.04%,30.63%,1
屏東縣,東港鎮,0194,146,168,314,25,339,659,51.44%,22.15%,1
屏東縣,東港鎮,0195,130,138,268,17,285,513,55.56%,25.34%,1
屏東縣,東港鎮,0196,443,431,874,32,906,1732,52.31%,25.58%,1
屏東縣,東港鎮,0197,451,467,918,35,953,1779,53.57%,25.35%,1
屏東縣,東港鎮,0198,315,308,623,24,647,1270,50.94%,24.8%,1
屏東縣,東港鎮,0199,365,309,674,23,697,1327,52.52%,27.51%,1
屏東縣,東港鎮,0200,354,296,650,46,696,1242,56.04%,28.5%,1
屏東縣,東港鎮,0201,434,407,841,47,888,1607,55.26%,27.01%,1
屏東縣,東港鎮,0202,349,293,642,17,659,1305,50.5%,26.74%,1
屏東縣,東港鎮,0203,183,184,367,27,394,695,56.69%,26.33%,1
屏東縣,東港鎮,0204,335,285,620,40,660,1076,61.34%,31.13%,1
屏東縣,東港鎮,0205,165,118,283,14,297,567,52.38%,29.1%,1
屏東縣,東港鎮,0206,275,175,450,22,472,806,58.56%,34.12%,1
屏東縣,東港鎮,0207,318,320,638,51,689,1227,56.15%,25.92%,1
屏東縣,東港鎮,0208,168,138,306,20,326,599,54.42%,28.05%,1
屏東縣,東港鎮,0209,302,250,552,35,587,1354,43.35%,22.3%,1
屏東縣,東港鎮,0210,212,143,355,37,392,734,53.41%,28.88%,1
屏東縣,東港鎮,0211,290,271,561,74,635,1107,57.36%,26.2%,1
屏東縣,東港鎮,0212,291,250,541,58,599,1198,50%,24.29%,1
屏東縣,東港鎮,0213,431,328,759,65,824,1614,51.05%,26.7%,1
屏東縣,東港鎮,0214,231,181,412,20,432,826,52.3%,27.97%,1
屏東縣,東港鎮,0215,245,227,472,48,520,912,57.02%,26.86%,1
屏東縣,東港鎮,0216,127,82,209,18,227,432,52.55%,29.4%,1
屏東縣,東港鎮,0217,375,255,630,65,695,1204,57.72%,31.15%,1
屏東縣,東港鎮,0218,366,330,696,37,733,1304,56.21%,28.07%,1
屏東縣,東港鎮,0219,405,332,737,23,760,1317,57.71%,30.75%,1
屏東縣,東港鎮,0220,336,351,687,22,709,1387,51.12%,24.22%,1
屏東縣,東港鎮,0221,336,278,614,20,634,1310,48.4%,25.65%,1
屏東縣,東港鎮,0222,371,228,599,30,629,1228,51.22%,30.21%,1
屏東縣,東港鎮,0223,211,135,346,27,373,766,48.69%,27.55%,1
屏東縣,東港鎮,0224,249,205,454,26,480,823,58.32%,30.26%,1
屏東縣,東港鎮,0225,163,143,306,18,324,755,42.91%,21.59%,1
屏東縣,東港鎮,0226,338,255,593,35,628,1094,57.4%,30.9%,1
屏東縣,東港鎮,0227,112,248,360,15,375,753,49.8%,14.87%,1
屏東縣,恆春鎮,0228,216,211,427,22,449,902,49.78%,23.95%,1
屏東縣,恆春鎮,0229,256,263,519,35,554,969,57.17%,26.42%,1
屏東縣,恆春鎮,0230,274,330,604,32,636,1280,49.69%,21.41%,1
屏東縣,恆春鎮,0231,274,320,594,19,613,1133,54.1%,24.18%,1
屏東縣,恆春鎮,0232,305,358,663,16,679,1552,43.75%,19.65%,1
屏東縣,恆春鎮,0233,314,292,606,30,636,1485,42.83%,21.14%,1
屏東縣,恆春鎮,0234,221,239,460,24,484,896,54.02%,24.67%,1
屏東縣,恆春鎮,0235,132,110,242,19,261,531,49.15%,24.86%,1
屏東縣,恆春鎮,0236,119,106,225,10,235,478,49.16%,24.9%,1
屏東縣,恆春鎮,0237,234,220,454,35,489,1020,47.94%,22.94%,1
屏東縣,恆春鎮,0238,229,205,434,16,450,924,48.7%,24.78%,1
屏東縣,恆春鎮,0239,225,225,450,21,471,1079,43.65%,20.85%,1
屏東縣,恆春鎮,0240,188,153,341,14,355,775,45.81%,24.26%,1
屏東縣,恆春鎮,0241,221,201,422,34,456,813,56.09%,27.18%,1
屏東縣,恆春鎮,0242,236,257,493,35,528,1104,47.83%,21.38%,1
屏東縣,恆春鎮,0243,208,245,453,42,495,1110,44.59%,18.74%,1
屏東縣,恆春鎮,0244,136,123,259,38,297,692,42.92%,19.65%,1
屏東縣,恆春鎮,0245,149,121,270,7,277,708,39.12%,21.05%,1
屏東縣,恆春鎮,0246,304,418,722,16,738,1505,49.04%,20.2%,1
屏東縣,恆春鎮,0247,237,245,482,38,520,1111,46.8%,21.33%,1
屏東縣,恆春鎮,0248,291,391,682,33,715,1543,46.34%,18.86%,1
屏東縣,恆春鎮,0249,147,178,325,15,340,828,41.06%,17.75%,1
屏東縣,恆春鎮,0250,202,218,420,24,444,844,52.61%,23.93%,1
屏東縣,恆春鎮,0251,300,295,595,33,628,1253,50.12%,23.94%,1
屏東縣,恆春鎮,0252,240,253,493,23,516,1126,45.83%,21.31%,1
屏東縣,萬丹鄉,0253,246,312,558,33,591,1527,38.7%,16.11%,1
屏東縣,萬丹鄉,0254,321,216,537,39,576,1147,50.22%,27.99%,1
屏東縣,萬丹鄉,0255,243,210,453,29,482,949,50.79%,25.61%,1
屏東縣,萬丹鄉,0256,209,247,456,24,480,990,48.48%,21.11%,1
屏東縣,萬丹鄉,0257,225,251,476,16,492,1022,48.14%,22.02%,1
屏東縣,萬丹鄉,0258,153,176,329,41,370,545,67.89%,28.07%,1
屏東縣,萬丹鄉,0259,163,374,537,38,575,1159,49.61%,14.06%,1
屏東縣,萬丹鄉,0260,258,201,459,46,505,837,60.33%,30.82%,1
屏東縣,萬丹鄉,0261,100,94,194,11,205,392,52.3%,25.51%,1
屏東縣,萬丹鄉,0262,258,218,476,24,500,847,59.03%,30.46%,1
屏東縣,萬丹鄉,0263,263,312,575,26,601,1149,52.31%,22.89%,1
屏東縣,萬丹鄉,0264,290,286,576,36,612,1131,54.11%,25.64%,1
屏東縣,萬丹鄉,0265,295,285,580,32,612,1178,51.95%,25.04%,1
屏東縣,萬丹鄉,0266,238,177,415,13,428,711,60.2%,33.47%,1
屏東縣,萬丹鄉,0267,261,100,361,15,376,595,63.19%,43.87%,1
屏東縣,萬丹鄉,0268,397,388,785,22,807,1403,57.52%,28.3%,1
屏東縣,萬丹鄉,0269,272,277,549,25,574,1094,52.47%,24.86%,1
屏東縣,萬丹鄉,0270,327,315,642,25,667,1158,57.6%,28.24%,1
屏東縣,萬丹鄉,0271,308,256,564,42,606,963,62.93%,31.98%,1
屏東縣,萬丹鄉,0272,100,401,501,42,543,1062,51.13%,9.42%,1
屏東縣,萬丹鄉,0273,433,416,849,45,894,1684,53.09%,25.71%,1
屏東縣,萬丹鄉,0274,428,397,825,19,844,1702,49.59%,25.15%,1
屏東縣,萬丹鄉,0275,337,211,548,26,574,976,58.81%,34.53%,1
屏東縣,萬丹鄉,0276,280,242,522,38,560,1013,55.28%,27.64%,1
屏東縣,萬丹鄉,0277,230,145,375,17,392,847,46.28%,27.15%,1
屏東縣,萬丹鄉,0278,441,384,825,87,912,1570,58.09%,28.09%,1
屏東縣,萬丹鄉,0279,359,312,671,41,712,1411,50.46%,25.44%,1
屏東縣,萬丹鄉,0280,317,233,550,57,607,1046,58.03%,30.31%,1
屏東縣,萬丹鄉,0281,375,311,686,27,713,1385,51.48%,27.08%,1
屏東縣,萬丹鄉,0282,234,181,415,36,451,804,56.09%,29.1%,1
屏東縣,萬丹鄉,0283,415,256,671,44,715,1284,55.69%,32.32%,1
屏東縣,萬丹鄉,0284,375,294,669,40,709,1430,49.58%,26.22%,1
屏東縣,萬丹鄉,0285,310,254,564,42,606,960,63.13%,32.29%,1
屏東縣,萬丹鄉,0286,252,201,453,31,484,786,61.58%,32.06%,1
屏東縣,萬丹鄉,0287,334,277,611,44,655,1158,56.56%,28.84%,1
屏東縣,萬丹鄉,0288,394,319,713,29,742,1647,45.05%,23.92%,1
屏東縣,萬丹鄉,0289,435,307,742,39,781,1666,46.88%,26.11%,1
屏東縣,萬丹鄉,0290,359,246,605,33,638,1023,62.37%,35.09%,1
屏東縣,萬丹鄉,0291,350,342,692,34,726,1227,59.17%,28.52%,1
屏東縣,長治鄉,0292,279,256,535,37,572,1018,56.19%,27.41%,1
屏東縣,長治鄉,0293,371,456,827,60,887,1614,54.96%,22.99%,1
屏東縣,長治鄉,0294,424,561,985,52,1037,1848,56.11%,22.94%,1
屏東縣,長治鄉,0295,364,503,867,49,916,1707,53.66%,21.32%,1
屏東縣,長治鄉,0296,249,282,531,19,550,972,56.58%,25.62%,1
屏東縣,長治鄉,0297,286,251,537,38,575,989,58.14%,28.92%,1
屏東縣,長治鄉,0298,202,200,402,43,445,735,60.54%,27.48%,1
屏東縣,長治鄉,0299,433,432,865,32,897,1813,49.48%,23.88%,1
屏東縣,長治鄉,0300,295,330,625,28,653,1073,60.86%,27.49%,1
屏東縣,長治鄉,0301,441,401,842,45,887,1654,53.63%,26.66%,1
屏東縣,長治鄉,0302,352,274,626,46,672,1205,55.77%,29.21%,1
屏東縣,長治鄉,0303,212,195,407,26,433,758,57.12%,27.97%,1
屏東縣,長治鄉,0304,407,351,758,68,826,1492,55.36%,27.28%,1
屏東縣,長治鄉,0305,203,269,472,47,519,884,58.71%,22.96%,1
屏東縣,長治鄉,0306,301,286,587,46,633,1090,58.07%,27.61%,1
屏東縣,長治鄉,0307,316,331,647,49,696,1422,48.95%,22.22%,1
屏東縣,長治鄉,0308,232,196,428,41,469,845,55.5%,27.46%,1
屏東縣,長治鄉,0309,247,247,494,45,539,925,58.27%,26.7%,1
屏東縣,長治鄉,0310,362,200,562,66,628,1138,55.18%,31.81%,1
屏東縣,長治鄉,0311,367,274,641,65,706,1242,56.84%,29.55%,1
屏東縣,長治鄉,0312,257,297,554,16,570,1159,49.18%,22.17%,1
屏東縣,長治鄉,0313,134,243,377,26,403,673,59.88%,19.91%,1
屏東縣,麟洛鄉,0314,214,210,424,25,449,788,56.98%,27.16%,1
屏東縣,麟洛鄉,0315,413,408,821,25,846,1386,61.04%,29.8%,1
屏東縣,麟洛鄉,0316,273,295,568,26,594,957,62.07%,28.53%,1
屏東縣,麟洛鄉,0317,251,180,431,23,454,731,62.11%,34.34%,1
屏東縣,麟洛鄉,0318,265,208,473,33,506,806,62.78%,32.88%,1
屏東縣,麟洛鄉,0319,370,274,644,15,659,1207,54.6%,30.65%,1
屏東縣,麟洛鄉,0320,400,393,793,35,828,1340,61.79%,29.85%,1
屏東縣,麟洛鄉,0321,432,307,739,26,765,1221,62.65%,35.38%,1
屏東縣,麟洛鄉,0322,265,234,499,5,504,851,59.22%,31.14%,1
屏東縣,麟洛鄉,0323,206,178,384,13,397,683,58.13%,30.16%,1
屏東縣,九如鄉,0324,482,325,807,33,840,1491,56.34%,32.33%,1
屏東縣,九如鄉,0325,446,270,716,36,752,1375,54.69%,32.44%,1
屏東縣,九如鄉,0326,476,368,844,34,878,1678,52.32%,28.37%,1
屏東縣,九如鄉,0327,352,281,633,54,687,1166,58.92%,30.19%,1
屏東縣,九如鄉,0328,305,257,562,27,589,1276,46.16%,23.9%,1
屏東縣,九如鄉,0329,298,273,571,33,604,1033,58.47%,28.85%,1
屏東縣,九如鄉,0330,170,197,367,30,397,577,68.8%,29.46%,1
屏東縣,九如鄉,0331,216,147,363,42,405,649,62.4%,33.28%,1
屏東縣,九如鄉,0332,742,263,1005,97,1102,1999,55.13%,37.12%,1
屏東縣,九如鄉,0333,471,415,886,37,923,1766,52.27%,26.67%,1
屏東縣,九如鄉,0334,476,330,806,44,850,1600,53.13%,29.75%,1
屏東縣,九如鄉,0335,368,284,652,34,686,1248,54.97%,29.49%,1
屏東縣,九如鄉,0336,571,411,982,61,1043,1792,58.2%,31.86%,1
屏東縣,九如鄉,0337,430,348,778,43,821,1482,55.4%,29.01%,1
屏東縣,里港鄉,0338,496,387,883,36,919,1552,59.21%,31.96%,1
屏東縣,里港鄉,0339,407,349,756,31,787,1480,53.18%,27.5%,1
屏東縣,里港鄉,0340,401,280,681,26,707,1534,46.09%,26.14%,1
屏東縣,里港鄉,0341,459,353,812,42,854,1578,54.12%,29.09%,1
屏東縣,里港鄉,0342,354,302,656,20,676,1127,59.98%,31.41%,1
屏東縣,里港鄉,0343,268,199,467,30,497,845,58.82%,31.72%,1
屏東縣,里港鄉,0344,347,297,644,37,681,1282,53.12%,27.07%,1
屏東縣,里港鄉,0345,298,248,546,27,573,981,58.41%,30.38%,1
屏東縣,里港鄉,0346,289,275,564,37,601,1031,58.29%,28.03%,1
屏東縣,里港鄉,0347,450,300,750,49,799,1423,56.15%,31.62%,1
屏東縣,里港鄉,0348,90,76,166,11,177,363,48.76%,24.79%,1
屏東縣,里港鄉,0349,397,269,666,41,707,1203,58.77%,33%,1
屏東縣,里港鄉,0350,356,258,614,31,645,1027,62.8%,34.66%,1
屏東縣,里港鄉,0351,432,273,705,37,742,1384,53.61%,31.21%,1
屏東縣,里港鄉,0352,404,373,777,49,826,1512,54.63%,26.72%,1
屏東縣,里港鄉,0353,68,216,284,25,309,522,59.2%,13.03%,1
屏東縣,里港鄉,0354,211,205,416,42,458,822,55.72%,25.67%,1
屏東縣,里港鄉,0355,276,213,489,41,530,1007,52.63%,27.41%,1
屏東縣,里港鄉,0356,302,216,518,19,537,956,56.17%,31.59%,1
屏東縣,里港鄉,0357,146,121,267,15,282,499,56.51%,29.26%,1
屏東縣,鹽埔鄉,0358,198,281,479,28,507,951,53.31%,20.82%,1
屏東縣,鹽埔鄉,0359,206,224,430,24,454,899,50.5%,22.91%,1
屏東縣,鹽埔鄉,0360,229,264,493,19,512,1116,45.88%,20.52%,1
屏東縣,鹽埔鄉,0361,287,315,602,28,630,1241,50.77%,23.13%,1
屏東縣,鹽埔鄉,0362,190,184,374,30,404,770,52.47%,24.68%,1
屏東縣,鹽埔鄉,0363,221,264,485,29,514,962,53.43%,22.97%,1
屏東縣,鹽埔鄉,0364,258,329,587,51,638,1041,61.29%,24.78%,1
屏東縣,鹽埔鄉,0365,432,256,688,34,722,1367,52.82%,31.6%,1
屏東縣,鹽埔鄉,0366,324,326,650,37,687,1465,46.89%,22.12%,1
屏東縣,鹽埔鄉,0367,233,172,405,26,431,894,48.21%,26.06%,1
屏東縣,鹽埔鄉,0368,207,217,424,5,429,958,44.78%,21.61%,1
屏東縣,鹽埔鄉,0369,240,213,453,45,498,924,53.9%,25.97%,1
屏東縣,鹽埔鄉,0370,357,357,714,30,744,1598,46.56%,22.34%,1
屏東縣,鹽埔鄉,0371,436,326,762,70,832,1550,53.68%,28.13%,1
屏東縣,鹽埔鄉,0372,269,285,554,52,606,1127,53.77%,23.87%,1
屏東縣,鹽埔鄉,0373,324,292,616,56,672,1150,58.43%,28.17%,1
屏東縣,鹽埔鄉,0374,329,306,635,49,684,1233,55.47%,26.68%,1
屏東縣,鹽埔鄉,0375,262,278,540,54,594,984,60.37%,26.63%,1
屏東縣,鹽埔鄉,0376,409,435,844,47,891,1619,55.03%,25.26%,1
屏東縣,鹽埔鄉,0377,157,140,297,17,314,553,56.78%,28.39%,1
屏東縣,高樹鄉,0378,315,214,529,28,557,883,63.08%,35.67%,1
屏東縣,高樹鄉,0379,336,189,525,17,542,1255,43.19%,26.77%,1
屏東縣,高樹鄉,0380,371,370,741,22,763,1278,59.7%,29.03%,1
屏東縣,高樹鄉,0381,225,144,369,9,378,738,51.22%,30.49%,1
屏東縣,高樹鄉,0382,171,108,279,13,292,585,49.91%,29.23%,1
屏東縣,高樹鄉,0383,347,209,556,52,608,1012,60.08%,34.29%,1
屏東縣,高樹鄉,0384,300,214,514,63,577,1148,50.26%,26.13%,1
屏東縣,高樹鄉,0385,188,132,320,19,339,591,57.36%,31.81%,1
屏東縣,高樹鄉,0386,243,113,356,26,382,786,48.6%,30.92%,1
屏東縣,高樹鄉,0387,159,142,301,13,314,649,48.38%,24.5%,1
屏東縣,高樹鄉,0388,288,203,491,53,544,1229,44.26%,23.43%,1
屏東縣,高樹鄉,0389,346,290,636,40,676,1446,46.75%,23.93%,1
屏東縣,高樹鄉,0390,250,127,377,14,391,899,43.49%,27.81%,1
屏東縣,高樹鄉,0391,231,223,454,32,486,922,52.71%,25.05%,1
屏東縣,高樹鄉,0392,342,224,566,39,605,1259,48.05%,27.16%,1
屏東縣,高樹鄉,0393,280,194,474,16,490,1056,46.4%,26.52%,1
屏東縣,高樹鄉,0394,264,302,566,56,622,1116,55.73%,23.66%,1
屏東縣,高樹鄉,0395,296,227,523,52,575,1020,56.37%,29.02%,1
屏東縣,高樹鄉,0396,308,221,529,51,580,1055,54.98%,29.19%,1
屏東縣,高樹鄉,0397,270,167,437,27,464,738,62.87%,36.59%,1
屏東縣,高樹鄉,0398,134,88,222,28,250,493,50.71%,27.18%,1
屏東縣,高樹鄉,0399,443,401,844,70,914,1539,59.39%,28.78%,1
屏東縣,萬巒鄉,0400,390,237,627,29,656,1239,52.95%,31.48%,1
屏東縣,萬巒鄉,0401,252,172,424,21,445,759,58.63%,33.2%,1
屏東縣,萬巒鄉,0402,313,210,523,37,560,932,60.09%,33.58%,1
屏東縣,萬巒鄉,0403,269,174,443,31,474,769,61.64%,34.98%,1
屏東縣,萬巒鄉,0404,257,203,460,48,508,920,55.22%,27.93%,1
屏東縣,萬巒鄉,0405,190,130,320,14,334,560,59.64%,33.93%,1
屏東縣,萬巒鄉,0406,271,261,532,23,555,1120,49.55%,24.2%,1
屏東縣,萬巒鄉,0407,272,224,496,30,526,1048,50.19%,25.95%,1
屏東縣,萬巒鄉,0408,356,302,658,34,692,1438,48.12%,24.76%,1
屏東縣,萬巒鄉,0409,218,158,376,41,417,834,50%,26.14%,1
屏東縣,萬巒鄉,0410,197,186,383,44,427,813,52.52%,24.23%,1
屏東縣,萬巒鄉,0411,335,210,545,41,586,1020,57.45%,32.84%,1
屏東縣,萬巒鄉,0412,323,218,541,48,589,1007,58.49%,32.08%,1
屏東縣,萬巒鄉,0413,384,293,677,52,729,1648,44.24%,23.3%,1
屏東縣,萬巒鄉,0414,349,335,684,51,735,1437,51.15%,24.29%,1
屏東縣,萬巒鄉,0415,307,265,572,18,590,1228,48.05%,25%,1
屏東縣,萬巒鄉,0416,187,175,362,30,392,597,65.66%,31.32%,1
屏東縣,萬巒鄉,0417,183,114,297,29,326,576,56.6%,31.77%,1
屏東縣,內埔鄉,0418,298,296,594,21,615,1305,47.13%,22.84%,1
屏東縣,內埔鄉,0419,324,285,609,21,630,1287,48.95%,25.17%,1
屏東縣,內埔鄉,0420,284,355,639,17,656,1387,47.3%,20.48%,1
屏東縣,內埔鄉,0421,400,299,699,46,745,1540,48.38%,25.97%,1
屏東縣,內埔鄉,0422,403,369,772,33,805,1605,50.16%,25.11%,1
屏東縣,內埔鄉,0423,338,293,631,48,679,1326,51.21%,25.49%,1
屏東縣,內埔鄉,0424,152,144,296,39,335,591,56.68%,25.72%,1
屏東縣,內埔鄉,0425,273,243,516,36,552,1123,49.15%,24.31%,1
屏東縣,內埔鄉,0426,265,280,545,13,558,1079,51.71%,24.56%,1
屏東縣,內埔鄉,0427,365,371,736,44,780,1485,52.53%,24.58%,1
屏東縣,內埔鄉,0428,302,374,676,43,719,1248,57.61%,24.2%,1
屏東縣,內埔鄉,0429,435,378,813,33,846,1569,53.92%,27.72%,1
屏東縣,內埔鄉,0430,343,331,674,38,712,1493,47.69%,22.97%,1
屏東縣,內埔鄉,0431,350,310,660,13,673,1420,47.39%,24.65%,1
屏東縣,內埔鄉,0432,357,303,660,39,699,1334,52.4%,26.76%,1
屏東縣,內埔鄉,0433,361,341,702,37,739,1519,48.65%,23.77%,1
屏東縣,內埔鄉,0434,211,191,402,19,421,784,53.7%,26.91%,1
屏東縣,內埔鄉,0435,261,232,493,14,507,888,57.09%,29.39%,1
屏東縣,內埔鄉,0436,196,131,327,13,340,747,45.52%,26.24%,1
屏東縣,內埔鄉,0437,288,231,519,23,542,1168,46.4%,24.66%,1
屏東縣,內埔鄉,0438,171,124,295,19,314,546,57.51%,31.32%,1
屏東縣,內埔鄉,0439,319,294,613,34,647,1278,50.63%,24.96%,1
屏東縣,內埔鄉,0440,385,231,616,31,647,1348,48%,28.56%,1
屏東縣,內埔鄉,0441,379,254,633,32,665,1550,42.9%,24.45%,1
屏東縣,內埔鄉,0442,290,254,544,36,580,947,61.25%,30.62%,1
屏東縣,內埔鄉,0443,322,208,530,39,569,1097,51.87%,29.35%,1
屏東縣,內埔鄉,0444,265,176,441,34,475,1128,42.11%,23.49%,1
屏東縣,內埔鄉,0445,254,218,472,22,494,1253,39.43%,20.27%,1
屏東縣,內埔鄉,0446,404,263,667,23,690,1525,45.25%,26.49%,1
屏東縣,內埔鄉,0447,277,318,595,49,644,1215,53%,22.8%,1
屏東縣,內埔鄉,0448,221,291,512,31,543,1216,44.65%,18.17%,1
屏東縣,內埔鄉,0449,256,351,607,25,632,1353,46.71%,18.92%,1
屏東縣,內埔鄉,0450,115,363,478,34,512,1026,49.9%,11.21%,1
屏東縣,內埔鄉,0451,202,193,395,28,423,862,49.07%,23.43%,1
屏東縣,內埔鄉,0452,218,168,386,24,410,921,44.52%,23.67%,1
屏東縣,內埔鄉,0453,199,223,422,20,442,854,51.76%,23.3%,1
屏東縣,內埔鄉,0454,292,249,541,38,579,1230,47.07%,23.74%,1
屏東縣,內埔鄉,0455,266,247,513,21,534,1204,44.35%,22.09%,1
屏東縣,內埔鄉,0456,299,273,572,22,594,1301,45.66%,22.98%,1
屏東縣,內埔鄉,0457,192,235,427,33,460,806,57.07%,23.82%,1
屏東縣,竹田鄉,0458,435,359,794,46,840,1503,55.89%,28.94%,1
屏東縣,竹田鄉,0459,281,245,526,32,558,899,62.07%,31.26%,1
屏東縣,竹田鄉,0460,229,209,438,19,457,716,63.83%,31.98%,1
屏東縣,竹田鄉,0461,205,158,363,23,386,581,66.44%,35.28%,1
屏東縣,竹田鄉,0462,376,331,707,34,741,1327,55.84%,28.33%,1
屏東縣,竹田鄉,0463,332,255,587,40,627,997,62.89%,33.3%,1
屏東縣,竹田鄉,0464,209,158,367,18,385,649,59.32%,32.2%,1
屏東縣,竹田鄉,0465,180,153,333,16,349,476,73.32%,37.82%,1
屏東縣,竹田鄉,0466,346,361,707,41,748,1259,59.41%,27.48%,1
屏東縣,竹田鄉,0467,334,278,612,33,645,1227,52.57%,27.22%,1
屏東縣,竹田鄉,0468,181,120,301,24,325,504,64.48%,35.91%,1
屏東縣,竹田鄉,0469,228,208,436,27,463,860,53.84%,26.51%,1
屏東縣,竹田鄉,0470,235,186,421,22,443,800,55.38%,29.38%,1
屏東縣,竹田鄉,0471,347,282,629,40,669,1134,58.99%,30.6%,1
屏東縣,竹田鄉,0472,344,279,623,52,675,1229,54.92%,27.99%,1
屏東縣,竹田鄉,0473,308,293,601,34,635,1192,53.27%,25.84%,1
屏東縣,新埤鄉,0474,449,364,813,37,850,1712,49.65%,26.23%,1
屏東縣,新埤鄉,0475,87,78,165,15,180,314,57.32%,27.71%,1
屏東縣,新埤鄉,0476,219,178,397,15,412,752,54.79%,29.12%,1
屏東縣,新埤鄉,0477,87,85,172,17,189,334,56.59%,26.05%,1
屏東縣,新埤鄉,0478,264,253,517,39,556,957,58.1%,27.59%,1
屏東縣,新埤鄉,0479,249,169,418,35,453,764,59.29%,32.59%,1
屏東縣,新埤鄉,0480,111,89,200,16,216,373,57.91%,29.76%,1
屏東縣,新埤鄉,0481,168,141,309,14,323,678,47.64%,24.78%,1
屏東縣,新埤鄉,0482,156,157,313,19,332,701,47.36%,22.25%,1
屏東縣,新埤鄉,0483,301,212,513,37,550,1323,41.57%,22.75%,1
屏東縣,新埤鄉,0484,141,151,292,21,313,541,57.86%,26.06%,1
屏東縣,新埤鄉,0485,113,140,253,19,272,584,46.58%,19.35%,1
屏東縣,枋寮鄉,0486,287,364,651,33,684,1213,56.39%,23.66%,1
屏東縣,枋寮鄉,0487,218,252,470,54,524,891,58.81%,24.47%,1
屏東縣,枋寮鄉,0488,263,201,464,32,496,970,51.13%,27.11%,1
屏東縣,枋寮鄉,0489,194,129,323,18,341,629,54.21%,30.84%,1
屏東縣,枋寮鄉,0490,253,222,475,23,498,840,59.29%,30.12%,1
屏東縣,枋寮鄉,0491,228,208,436,23,459,774,59.3%,29.46%,1
屏東縣,枋寮鄉,0492,385,299,684,37,721,1379,52.28%,27.92%,1
屏東縣,枋寮鄉,0493,418,415,833,27,860,1502,57.26%,27.83%,1
屏東縣,枋寮鄉,0494,320,307,627,48,675,1276,52.9%,25.08%,1
屏東縣,枋寮鄉,0495,260,225,485,36,521,964,54.05%,26.97%,1
屏東縣,枋寮鄉,0496,281,302,583,42,625,1005,62.19%,27.96%,1
屏東縣,枋寮鄉,0497,228,190,418,10,428,734,58.31%,31.06%,1
屏東縣,枋寮鄉,0498,200,196,396,28,424,725,58.48%,27.59%,1
屏東縣,枋寮鄉,0499,287,227,514,39,553,1046,52.87%,27.44%,1
屏東縣,枋寮鄉,0500,297,282,579,39,618,1067,57.92%,27.84%,1
屏東縣,枋寮鄉,0501,164,95,259,27,286,718,39.83%,22.84%,1
屏東縣,枋寮鄉,0502,179,205,384,41,425,903,47.07%,19.82%,1
屏東縣,枋寮鄉,0503,352,328,680,47,727,1387,52.42%,25.38%,1
屏東縣,枋寮鄉,0504,265,456,721,62,783,1367,57.28%,19.39%,1
屏東縣,枋寮鄉,0505,204,145,349,30,379,618,61.33%,33.01%,1
屏東縣,枋寮鄉,0506,188,180,368,23,391,959,40.77%,19.6%,1
屏東縣,枋寮鄉,0507,130,94,224,16,240,427,56.21%,30.44%,1
屏東縣,新園鄉,0508,256,183,439,32,471,820,57.44%,31.22%,1
屏東縣,新園鄉,0509,262,216,478,31,509,843,60.38%,31.08%,1
屏東縣,新園鄉,0510,332,275,607,36,643,1242,51.77%,26.73%,1
屏東縣,新園鄉,0511,350,360,710,35,745,1290,57.75%,27.13%,1
屏東縣,新園鄉,0512,280,253,533,36,569,1073,53.03%,26.1%,1
屏東縣,新園鄉,0513,321,249,570,75,645,1088,59.28%,29.5%,1
屏東縣,新園鄉,0514,213,182,395,28,423,845,50.06%,25.21%,1
屏東縣,新園鄉,0515,274,177,451,26,477,862,55.34%,31.79%,1
屏東縣,新園鄉,0516,293,248,541,48,589,1183,49.79%,24.77%,1
屏東縣,新園鄉,0517,273,276,549,62,611,1109,55.09%,24.62%,1
屏東縣,新園鄉,0518,280,246,526,16,542,1119,48.44%,25.02%,1
屏東縣,新園鄉,0519,304,245,549,23,572,1152,49.65%,26.39%,1
屏東縣,新園鄉,0520,259,288,547,28,575,1030,55.83%,25.15%,1
屏東縣,新園鄉,0521,297,245,542,45,587,1104,53.17%,26.9%,1
屏東縣,新園鄉,0522,344,268,612,26,638,1240,51.45%,27.74%,1
屏東縣,新園鄉,0523,300,198,498,11,509,1120,45.45%,26.79%,1
屏東縣,新園鄉,0524,344,234,578,46,624,1074,58.1%,32.03%,1
屏東縣,新園鄉,0525,234,146,380,22,402,849,47.35%,27.56%,1
屏東縣,新園鄉,0526,236,138,374,38,412,749,55.01%,31.51%,1
屏東縣,新園鄉,0527,406,276,682,46,728,1416,51.41%,28.67%,1
屏東縣,新園鄉,0528,257,198,455,36,491,895,54.86%,28.72%,1
屏東縣,新園鄉,0529,302,193,495,26,521,933,55.84%,32.37%,1
屏東縣,新園鄉,0530,249,252,501,22,523,972,53.81%,25.62%,1
屏東縣,新園鄉,0531,384,247,631,63,694,1454,47.73%,26.41%,1
屏東縣,新園鄉,0532,471,407,878,87,965,1653,58.38%,28.49%,1
屏東縣,新園鄉,0533,351,232,583,57,640,1270,50.39%,27.64%,1
屏東縣,新園鄉,0534,480,140,620,52,672,1123,59.84%,42.74%,1
屏東縣,新園鄉,0535,334,225,559,66,625,1198,52.17%,27.88%,1
屏東縣,崁頂鄉,0536,300,283,583,25,608,1190,51.09%,25.21%,1
屏東縣,崁頂鄉,0537,283,288,571,43,614,1044,58.81%,27.11%,1
屏東縣,崁頂鄉,0538,249,182,431,22,453,818,55.38%,30.44%,1
屏東縣,崁頂鄉,0539,309,288,597,36,633,1214,52.14%,25.45%,1
屏東縣,崁頂鄉,0540,359,295,654,21,675,1325,50.94%,27.09%,1
屏東縣,崁頂鄉,0541,344,344,688,36,724,1253,57.78%,27.45%,1
屏東縣,崁頂鄉,0542,284,215,499,39,538,1039,51.78%,27.33%,1
屏東縣,崁頂鄉,0543,213,159,372,28,400,813,49.2%,26.2%,1
屏東縣,崁頂鄉,0544,233,144,377,10,387,736,52.58%,31.66%,1
屏東縣,崁頂鄉,0545,278,230,508,30,538,934,57.6%,29.76%,1
屏東縣,崁頂鄉,0546,262,182,444,30,474,900,52.67%,29.11%,1
屏東縣,崁頂鄉,0547,286,210,496,39,535,1004,53.29%,28.49%,1
屏東縣,林邊鄉,0548,454,366,820,48,868,1458,59.53%,31.14%,1
屏東縣,林邊鄉,0549,307,197,504,23,527,891,59.15%,34.46%,1
屏東縣,林邊鄉,0550,194,209,403,23,426,695,61.29%,27.91%,1
屏東縣,林邊鄉,0551,330,239,569,39,608,1015,59.9%,32.51%,1
屏東縣,林邊鄉,0552,367,286,653,33,686,1171,58.58%,31.34%,1
屏東縣,林邊鄉,0553,296,240,536,24,560,1003,55.83%,29.51%,1
屏東縣,林邊鄉,0554,243,194,437,26,463,725,63.86%,33.52%,1
屏東縣,林邊鄉,0555,295,179,474,37,511,841,60.76%,35.08%,1
屏東縣,林邊鄉,0556,260,199,459,23,482,793,60.78%,32.79%,1
屏東縣,林邊鄉,0557,280,243,523,28,551,919,59.96%,30.47%,1
屏東縣,林邊鄉,0558,371,276,647,36,683,1283,53.23%,28.92%,1
屏東縣,林邊鄉,0559,256,109,365,25,390,783,49.81%,32.69%,1
屏東縣,林邊鄉,0560,257,215,472,32,504,1033,48.79%,24.88%,1
屏東縣,林邊鄉,0561,345,249,594,55,649,1186,54.72%,29.09%,1
屏東縣,林邊鄉,0562,231,161,392,33,425,773,54.98%,29.88%,1
屏東縣,林邊鄉,0563,314,220,534,18,552,1122,49.2%,27.99%,1
屏東縣,南州鄉,0564,235,193,428,32,460,872,52.75%,26.95%,1
屏東縣,南州鄉,0565,249,168,417,22,439,794,55.29%,31.36%,1
屏東縣,南州鄉,0566,301,231,532,31,563,962,58.52%,31.29%,1
屏東縣,南州鄉,0567,290,236,526,56,582,1033,56.34%,28.07%,1
屏東縣,南州鄉,0568,290,200,490,32,522,1007,51.84%,28.8%,1
屏東縣,南州鄉,0569,151,116,267,12,279,466,59.87%,32.4%,1
屏東縣,南州鄉,0570,152,243,395,21,416,708,58.76%,21.47%,1
屏東縣,南州鄉,0571,310,243,553,38,591,1044,56.61%,29.69%,1
屏東縣,南州鄉,0572,299,161,460,23,483,1071,45.1%,27.92%,1
屏東縣,南州鄉,0573,272,204,476,30,506,979,51.69%,27.78%,1
屏東縣,南州鄉,0574,142,114,256,24,280,543,51.57%,26.15%,1
屏東縣,佳冬鄉,0575,355,299,654,33,687,1472,46.67%,24.12%,1
屏東縣,佳冬鄉,0576,341,245,586,48,634,1360,46.62%,25.07%,1
屏東縣,佳冬鄉,0577,264,176,440,29,469,804,58.33%,32.84%,1
屏東縣,佳冬鄉,0578,253,205,458,28,486,925,52.54%,27.35%,1
屏東縣,佳冬鄉,0579,223,190,413,11,424,855,49.59%,26.08%,1
屏東縣,佳冬鄉,0580,267,200,467,27,494,981,50.36%,27.22%,1
屏東縣,佳冬鄉,0581,283,206,489,16,505,1007,50.15%,28.1%,1
屏東縣,佳冬鄉,0582,246,158,404,31,435,872,49.89%,28.21%,1
屏東縣,佳冬鄉,0583,343,214,557,24,581,1255,46.29%,27.33%,1
屏東縣,佳冬鄉,0584,317,186,503,47,550,995,55.28%,31.86%,1
屏東縣,佳冬鄉,0585,188,136,324,11,335,734,45.64%,25.61%,1
屏東縣,佳冬鄉,0586,274,246,520,27,547,1178,46.43%,23.26%,1
屏東縣,佳冬鄉,0587,330,191,521,38,559,1095,51.05%,30.14%,1
屏東縣,佳冬鄉,0588,285,304,589,61,650,1097,59.25%,25.98%,1
屏東縣,佳冬鄉,0589,364,244,608,59,667,1273,52.4%,28.59%,1
屏東縣,佳冬鄉,0590,312,306,618,40,658,1160,56.72%,26.9%,1
屏東縣,琉球鄉,0591,203,235,438,26,464,1111,41.76%,18.27%,1
屏東縣,琉球鄉,0592,155,255,410,29,439,972,45.16%,15.95%,1
屏東縣,琉球鄉,0593,226,381,607,57,664,1278,51.96%,17.68%,1
屏東縣,琉球鄉,0594,151,285,436,59,495,976,50.72%,15.47%,1
屏東縣,琉球鄉,0595,570,173,743,43,786,1658,47.41%,34.38%,1
屏東縣,琉球鄉,0596,170,244,414,28,442,1146,38.57%,14.83%,1
屏東縣,琉球鄉,0597,153,227,380,37,417,1079,38.65%,14.18%,1
屏東縣,琉球鄉,0598,208,372,580,25,605,1613,37.51%,12.9%,1
屏東縣,琉球鄉,0599,171,241,412,32,444,873,50.86%,19.59%,1
屏東縣,車城鄉,0600,165,121,286,24,310,737,42.06%,22.39%,1
屏東縣,車城鄉,0601,133,95,228,16,244,647,37.71%,20.56%,1
屏東縣,車城鄉,0602,119,111,230,13,243,491,49.49%,24.24%,1
屏東縣,車城鄉,0603,210,177,387,29,416,856,48.6%,24.53%,1
屏東縣,車城鄉,0604,166,94,260,3,263,554,47.47%,29.96%,1
屏東縣,車城鄉,0605,54,86,140,5,145,388,37.37%,13.92%,1
屏東縣,車城鄉,0606,205,180,385,14,399,922,43.28%,22.23%,1
屏東縣,車城鄉,0607,141,76,217,9,226,597,37.86%,23.62%,1
屏東縣,車城鄉,0608,127,95,222,8,230,623,36.92%,20.39%,1
屏東縣,車城鄉,0609,113,69,182,16,198,425,46.59%,26.59%,1
屏東縣,車城鄉,0610,82,124,206,15,221,428,51.64%,19.16%,1
屏東縣,車城鄉,0611,103,69,172,9,181,504,35.91%,20.44%,1
屏東縣,車城鄉,0612,108,92,200,17,217,423,51.3%,25.53%,1
屏東縣,滿州鄉,0613,347,349,696,21,717,1575,45.52%,22.03%,1
屏東縣,滿州鄉,0614,122,87,209,8,217,420,51.67%,29.05%,1
屏東縣,滿州鄉,0615,174,164,338,16,354,602,58.8%,28.9%,1
屏東縣,滿州鄉,0616,265,256,521,24,545,1302,41.86%,20.35%,1
屏東縣,滿州鄉,0617,358,243,601,22,623,1314,47.41%,27.25%,1
屏東縣,滿州鄉,0618,92,293,385,14,399,1308,30.5%,7.03%,1
屏東縣,滿州鄉,0619,76,60,136,12,148,367,40.33%,20.71%,1
屏東縣,滿州鄉,0620,82,74,156,10,166,318,52.2%,25.79%,1
屏東縣,枋山鄉,0621,157,186,343,24,367,604,60.76%,25.99%,1
屏東縣,枋山鄉,0622,125,123,248,20,268,428,62.62%,29.21%,1
屏東縣,枋山鄉,0623,272,270,542,42,584,928,62.93%,29.31%,1
屏東縣,枋山鄉,0624,289,236,525,10,535,972,55.04%,29.73%,1
屏東縣,枋山鄉,0625,284,183,467,23,490,1041,47.07%,27.28%,1
屏東縣,枋山鄉,0626,209,125,334,13,347,883,39.3%,23.67%,1
屏東縣,三地門鄉,0627,102,173,275,20,295,616,47.89%,16.56%,1
屏東縣,三地門鄉,0628,125,169,294,53,347,572,60.66%,21.85%,1
屏東縣,三地門鄉,0629,48,92,140,14,154,323,47.68%,14.86%,1
屏東縣,三地門鄉,0630,269,551,820,54,874,1448,60.36%,18.58%,1
屏東縣,三地門鄉,0631,86,159,245,7,252,726,34.71%,11.85%,1
屏東縣,三地門鄉,0632,137,129,266,23,289,554,52.17%,24.73%,1
屏東縣,三地門鄉,0633,92,88,180,13,193,346,55.78%,26.59%,1
屏東縣,三地門鄉,0634,65,117,182,5,187,458,40.83%,14.19%,1
屏東縣,三地門鄉,0635,127,265,392,21,413,692,59.68%,18.35%,1
屏東縣,三地門鄉,0636,108,329,437,34,471,638,73.82%,16.93%,1
屏東縣,霧臺鄉,0637,79,165,244,23,267,346,77.17%,22.83%,1
屏東縣,霧臺鄉,0638,75,297,372,13,385,677,56.87%,11.08%,1
屏東縣,霧臺鄉,0639,15,38,53,0,53,162,32.72%,9.26%,1
屏東縣,霧臺鄉,0640,22,70,92,4,96,189,50.79%,11.64%,1
屏東縣,霧臺鄉,0641,49,135,184,30,214,296,72.3%,16.55%,1
屏東縣,霧臺鄉,0642,118,159,277,8,285,483,59.01%,24.43%,1
屏東縣,霧臺鄉,0643,46,110,156,1,157,347,45.24%,13.26%,1
屏東縣,霧臺鄉,0644,73,134,207,19,226,450,50.22%,16.22%,1
屏東縣,瑪家鄉,0645,94,134,228,4,232,455,50.99%,20.66%,1
屏東縣,瑪家鄉,0646,159,342,501,40,541,821,65.9%,19.37%,1
屏東縣,瑪家鄉,0647,172,245,417,48,465,635,73.23%,27.09%,1
屏東縣,瑪家鄉,0648,135,356,491,30,521,695,74.96%,19.42%,1
屏東縣,瑪家鄉,0649,110,302,412,31,443,671,66.02%,16.39%,1
屏東縣,瑪家鄉,0650,172,366,538,15,553,1057,52.32%,16.27%,1
屏東縣,瑪家鄉,0651,204,292,496,24,520,900,57.78%,22.67%,1
屏東縣,瑪家鄉,0652,72,149,221,9,230,429,53.61%,16.78%,1
屏東縣,泰武鄉,0653,104,272,376,16,392,669,58.59%,15.55%,1
屏東縣,泰武鄉,0654,33,55,88,10,98,190,51.58%,17.37%,1
屏東縣,泰武鄉,0655,159,392,551,56,607,922,65.84%,17.25%,1
屏東縣,泰武鄉,0656,147,254,401,49,450,598,75.25%,24.58%,1
屏東縣,泰武鄉,0657,132,333,465,38,503,771,65.24%,17.12%,1
屏東縣,泰武鄉,0658,94,164,258,45,303,414,73.19%,22.71%,1
屏東縣,泰武鄉,0659,152,235,387,29,416,780,53.33%,19.49%,1
屏東縣,來義鄉,0660,139,386,525,85,610,917,66.52%,15.16%,1
屏東縣,來義鄉,0661,56,131,187,6,193,361,53.46%,15.51%,1
屏東縣,來義鄉,0662,25,59,84,0,84,216,38.89%,11.57%,1
屏東縣,來義鄉,0663,60,255,315,21,336,445,75.51%,13.48%,1
屏東縣,來義鄉,0664,40,126,166,16,182,280,65%,14.29%,1
屏東縣,來義鄉,0665,159,446,605,43,648,1097,59.07%,14.49%,1
屏東縣,來義鄉,0666,103,413,516,44,560,840,66.67%,12.26%,1
屏東縣,來義鄉,0667,124,312,436,18,454,889,51.07%,13.95%,1
屏東縣,來義鄉,0668,195,362,557,35,592,1212,48.84%,16.09%,1
屏東縣,春日鄉,0669,78,150,228,5,233,909,25.63%,8.58%,1
屏東縣,春日鄉,0670,102,118,220,15,235,663,35.44%,15.38%,1
屏東縣,春日鄉,0671,16,30,46,0,46,304,15.13%,5.26%,1
屏東縣,春日鄉,0672,133,236,369,16,385,928,41.49%,14.33%,1
屏東縣,春日鄉,0673,67,123,190,8,198,641,30.89%,10.45%,1
屏東縣,春日鄉,0674,42,82,124,2,126,478,26.36%,8.79%,1
屏東縣,獅子鄉,0675,87,289,376,10,386,751,51.4%,11.58%,1
屏東縣,獅子鄉,0676,116,295,411,25,436,776,56.19%,14.95%,1
屏東縣,獅子鄉,0677,55,238,293,12,305,711,42.9%,7.74%,1
屏東縣,獅子鄉,0678,62,95,157,29,186,243,76.54%,25.51%,1
屏東縣,獅子鄉,0679,59,125,184,8,192,325,59.08%,18.15%,1
屏東縣,獅子鄉,0680,56,93,149,3,152,476,31.93%,11.76%,1
屏東縣,獅子鄉,0681,84,175,259,13,272,602,45.18%,13.95%,1
屏東縣,獅子鄉,0682,39,111,150,9,159,346,45.95%,11.27%,1
屏東縣,牡丹鄉,0683,42,94,136,7,143,342,41.81%,12.28%,1
屏東縣,牡丹鄉,0684,212,419,631,32,663,1306,50.77%,16.23%,1
屏東縣,牡丹鄉,0685,51,113,164,5,169,693,24.39%,7.36%,1
屏東縣,牡丹鄉,0686,81,87,168,7,175,437,40.05%,18.54%,1
屏東縣,牡丹鄉,0687,70,121,191,9,200,392,51.02%,17.86%,1
屏東縣,牡丹鄉,0688,116,180,296,6,302,593,50.93%,19.56%,1
屏東縣,牡丹鄉,0689,52,77,129,4,133,551,24.14%,9.44%,1
宜蘭縣,宜蘭市,0001,221,300,521,17,538,982,54.79%,22.51%,1
宜蘭縣,宜蘭市,0002,295,390,685,27,712,1270,56.06%,23.23%,1
宜蘭縣,宜蘭市,0003,221,241,462,12,474,849,55.83%,26.03%,1
宜蘭縣,宜蘭市,0004,198,225,423,20,443,756,58.6%,26.19%,1
宜蘭縣,宜蘭市,0005,227,306,533,29,562,1107,50.77%,20.51%,1
宜蘭縣,宜蘭市,0006,201,272,473,26,499,893,55.88%,22.51%,1
宜蘭縣,宜蘭市,0007,231,251,482,25,507,912,55.59%,25.33%,1
宜蘭縣,宜蘭市,0008,333,389,722,43,765,1335,57.3%,24.94%,1
宜蘭縣,宜蘭市,0009,177,170,347,23,370,686,53.94%,25.8%,1
宜蘭縣,宜蘭市,0010,341,464,805,22,827,1366,60.54%,24.96%,1
宜蘭縣,宜蘭市,0011,324,425,749,29,778,1363,57.08%,23.77%,1
宜蘭縣,宜蘭市,0012,347,508,855,33,888,1540,57.66%,22.53%,1
宜蘭縣,宜蘭市,0013,284,451,735,17,752,1341,56.08%,21.18%,1
宜蘭縣,宜蘭市,0014,298,363,661,29,690,1209,57.07%,24.65%,1
宜蘭縣,宜蘭市,0015,253,240,493,23,516,900,57.33%,28.11%,1
宜蘭縣,宜蘭市,0016,207,283,490,22,512,980,52.24%,21.12%,1
宜蘭縣,宜蘭市,0017,299,329,628,26,654,1165,56.14%,25.67%,1
宜蘭縣,宜蘭市,0018,184,305,489,19,508,904,56.19%,20.35%,1
宜蘭縣,宜蘭市,0019,224,221,445,20,465,813,57.2%,27.55%,1
宜蘭縣,宜蘭市,0020,252,278,530,17,547,978,55.93%,25.77%,1
宜蘭縣,宜蘭市,0021,234,339,573,21,594,1282,46.33%,18.25%,1
宜蘭縣,宜蘭市,0022,118,143,261,13,274,465,58.92%,25.38%,1
宜蘭縣,宜蘭市,0023,160,216,376,21,397,669,59.34%,23.92%,1
宜蘭縣,宜蘭市,0024,240,267,507,21,528,923,57.2%,26%,1
宜蘭縣,宜蘭市,0025,211,305,516,26,542,1006,53.88%,20.97%,1
宜蘭縣,宜蘭市,0026,258,202,460,41,501,762,65.75%,33.86%,1
宜蘭縣,宜蘭市,0027,242,205,447,20,467,727,64.24%,33.29%,1
宜蘭縣,宜蘭市,0028,259,259,518,41,559,833,67.11%,31.09%,1
宜蘭縣,宜蘭市,0029,278,368,646,23,669,1143,58.53%,24.32%,1
宜蘭縣,宜蘭市,0030,248,287,535,13,548,979,55.98%,25.33%,1
宜蘭縣,宜蘭市,0031,328,321,649,41,690,1214,56.84%,27.02%,1
宜蘭縣,宜蘭市,0032,367,327,694,49,743,1283,57.91%,28.6%,1
宜蘭縣,宜蘭市,0033,224,304,528,29,557,946,58.88%,23.68%,1
宜蘭縣,宜蘭市,0034,217,339,556,30,586,1090,53.76%,19.91%,1
宜蘭縣,宜蘭市,0035,259,288,547,19,566,943,60.02%,27.47%,1
宜蘭縣,宜蘭市,0036,250,221,471,27,498,774,64.34%,32.3%,1
宜蘭縣,宜蘭市,0037,313,253,566,26,592,968,61.16%,32.33%,1
宜蘭縣,宜蘭市,0038,259,289,548,25,573,926,61.88%,27.97%,1
宜蘭縣,宜蘭市,0039,296,299,595,20,615,1019,60.35%,29.05%,1
宜蘭縣,宜蘭市,0040,306,276,582,34,616,1084,56.83%,28.23%,1
宜蘭縣,宜蘭市,0041,249,320,569,27,596,1095,54.43%,22.74%,1
宜蘭縣,宜蘭市,0042,264,346,610,20,630,1083,58.17%,24.38%,1
宜蘭縣,宜蘭市,0043,293,292,585,9,594,1108,53.61%,26.44%,1
宜蘭縣,宜蘭市,0044,208,273,481,13,494,848,58.25%,24.53%,1
宜蘭縣,宜蘭市,0045,248,339,587,22,609,1095,55.62%,22.65%,1
宜蘭縣,宜蘭市,0046,272,335,607,24,631,1110,56.85%,24.5%,1
宜蘭縣,宜蘭市,0047,286,325,611,36,647,1104,58.61%,25.91%,1
宜蘭縣,宜蘭市,0048,275,339,614,37,651,1134,57.41%,24.25%,1
宜蘭縣,宜蘭市,0049,267,369,636,26,662,1146,57.77%,23.3%,1
宜蘭縣,宜蘭市,0050,231,265,496,32,528,876,60.27%,26.37%,1
宜蘭縣,宜蘭市,0051,217,256,473,34,507,905,56.02%,23.98%,1
宜蘭縣,宜蘭市,0052,224,276,500,36,536,910,58.9%,24.62%,1
宜蘭縣,宜蘭市,0053,382,320,702,33,735,1434,51.26%,26.64%,1
宜蘭縣,宜蘭市,0054,313,274,587,49,636,1152,55.21%,27.17%,1
宜蘭縣,宜蘭市,0055,298,261,559,28,587,966,60.77%,30.85%,1
宜蘭縣,宜蘭市,0056,220,168,388,27,415,711,58.37%,30.94%,1
宜蘭縣,宜蘭市,0057,248,254,502,35,537,884,60.75%,28.05%,1
宜蘭縣,宜蘭市,0058,366,364,730,36,766,1326,57.77%,27.6%,1
宜蘭縣,宜蘭市,0059,212,248,460,25,485,909,53.36%,23.32%,1
宜蘭縣,宜蘭市,0060,240,241,481,11,492,894,55.03%,26.85%,1
宜蘭縣,宜蘭市,0061,280,327,607,33,640,1259,50.83%,22.24%,1
宜蘭縣,宜蘭市,0062,172,223,395,23,418,789,52.98%,21.8%,1
宜蘭縣,宜蘭市,0063,217,237,454,28,482,867,55.59%,25.03%,1
宜蘭縣,宜蘭市,0064,413,349,762,55,817,1454,56.19%,28.4%,1
宜蘭縣,宜蘭市,0065,309,366,675,19,694,1130,61.42%,27.35%,1
宜蘭縣,宜蘭市,0066,241,270,511,18,529,1087,48.67%,22.17%,1
宜蘭縣,宜蘭市,0067,298,253,551,31,582,938,62.05%,31.77%,1
宜蘭縣,宜蘭市,0068,362,335,697,26,723,1285,56.26%,28.17%,1
宜蘭縣,宜蘭市,0069,288,216,504,25,529,952,55.57%,30.25%,1
宜蘭縣,宜蘭市,0070,281,256,537,36,573,948,60.44%,29.64%,1
宜蘭縣,宜蘭市,0071,285,290,575,34,609,1160,52.5%,24.57%,1
宜蘭縣,宜蘭市,0072,294,268,562,42,604,1015,59.51%,28.97%,1
宜蘭縣,宜蘭市,0073,117,135,252,12,264,424,62.26%,27.59%,1
宜蘭縣,宜蘭市,0074,291,252,543,26,569,964,59.02%,30.19%,1
宜蘭縣,宜蘭市,0075,262,225,487,31,518,959,54.01%,27.32%,1
宜蘭縣,宜蘭市,0076,252,238,490,31,521,814,64%,30.96%,1
宜蘭縣,宜蘭市,0077,278,232,510,23,533,885,60.23%,31.41%,1
宜蘭縣,宜蘭市,0078,354,295,649,38,687,1162,59.12%,30.46%,1
宜蘭縣,羅東鎮,0079,226,171,397,11,408,689,59.22%,32.8%,1
宜蘭縣,羅東鎮,0080,219,158,377,24,401,718,55.85%,30.5%,1
宜蘭縣,羅東鎮,0081,436,359,795,26,821,1475,55.66%,29.56%,1
宜蘭縣,羅東鎮,0082,410,341,751,50,801,1466,54.64%,27.97%,1
宜蘭縣,羅東鎮,0083,268,312,580,25,605,1075,56.28%,24.93%,1
宜蘭縣,羅東鎮,0084,264,249,513,25,538,963,55.87%,27.41%,1
宜蘭縣,羅東鎮,0085,433,337,770,48,818,1511,54.14%,28.66%,1
宜蘭縣,羅東鎮,0086,315,293,608,28,636,1166,54.55%,27.02%,1
宜蘭縣,羅東鎮,0087,368,334,702,36,738,1273,57.97%,28.91%,1
宜蘭縣,羅東鎮,0088,412,473,885,31,916,1735,52.8%,23.75%,1
宜蘭縣,羅東鎮,0089,383,418,801,46,847,1487,56.96%,25.76%,1
宜蘭縣,羅東鎮,0090,239,237,476,30,506,837,60.45%,28.55%,1
宜蘭縣,羅東鎮,0091,418,336,754,36,790,1312,60.21%,31.86%,1
宜蘭縣,羅東鎮,0092,396,351,747,30,777,1502,51.73%,26.36%,1
宜蘭縣,羅東鎮,0093,289,303,592,19,611,1138,53.69%,25.4%,1
宜蘭縣,羅東鎮,0094,308,225,533,35,568,1010,56.24%,30.5%,1
宜蘭縣,羅東鎮,0095,419,325,744,54,798,1373,58.12%,30.52%,1
宜蘭縣,羅東鎮,0096,334,259,593,35,628,1089,57.67%,30.67%,1
宜蘭縣,羅東鎮,0097,315,372,687,27,714,1304,54.75%,24.16%,1
宜蘭縣,羅東鎮,0098,325,321,646,53,699,1288,54.27%,25.23%,1
宜蘭縣,羅東鎮,0099,256,345,601,41,642,1036,61.97%,24.71%,1
宜蘭縣,羅東鎮,0100,239,335,574,42,616,969,63.57%,24.66%,1
宜蘭縣,羅東鎮,0101,269,283,552,44,596,985,60.51%,27.31%,1
宜蘭縣,羅東鎮,0102,408,371,779,58,837,1420,58.94%,28.73%,1
宜蘭縣,羅東鎮,0103,372,420,792,30,822,1430,57.48%,26.01%,1
宜蘭縣,羅東鎮,0104,291,304,595,38,633,1075,58.88%,27.07%,1
宜蘭縣,羅東鎮,0105,245,259,504,28,532,879,60.52%,27.87%,1
宜蘭縣,羅東鎮,0106,241,219,460,17,477,850,56.12%,28.35%,1
宜蘭縣,羅東鎮,0107,320,314,634,32,666,1111,59.95%,28.8%,1
宜蘭縣,羅東鎮,0108,318,363,681,31,712,1139,62.51%,27.92%,1
宜蘭縣,羅東鎮,0109,320,357,677,20,697,1130,61.68%,28.32%,1
宜蘭縣,羅東鎮,0110,275,278,553,30,583,980,59.49%,28.06%,1
宜蘭縣,羅東鎮,0111,359,412,771,34,805,1431,56.25%,25.09%,1
宜蘭縣,羅東鎮,0112,296,311,607,28,635,1109,57.26%,26.69%,1
宜蘭縣,羅東鎮,0113,269,323,592,22,614,1083,56.69%,24.84%,1
宜蘭縣,羅東鎮,0114,407,384,791,27,818,1404,58.26%,28.99%,1
宜蘭縣,羅東鎮,0115,361,347,708,36,744,1288,57.76%,28.03%,1
宜蘭縣,羅東鎮,0116,266,256,522,25,547,1183,46.24%,22.49%,1
宜蘭縣,羅東鎮,0117,307,326,633,29,662,1105,59.91%,27.78%,1
宜蘭縣,羅東鎮,0118,286,298,584,23,607,987,61.5%,28.98%,1
宜蘭縣,羅東鎮,0119,228,220,448,29,477,773,61.71%,29.5%,1
宜蘭縣,羅東鎮,0120,374,463,837,32,869,1366,63.62%,27.38%,1
宜蘭縣,羅東鎮,0121,277,290,567,17,584,907,64.39%,30.54%,1
宜蘭縣,羅東鎮,0122,297,394,691,31,722,1158,62.35%,25.65%,1
宜蘭縣,羅東鎮,0123,309,243,552,21,573,977,58.65%,31.63%,1
宜蘭縣,羅東鎮,0124,275,228,503,31,534,972,54.94%,28.29%,1
宜蘭縣,羅東鎮,0125,266,286,552,32,584,977,59.77%,27.23%,1
宜蘭縣,羅東鎮,0126,378,415,793,33,826,1398,59.08%,27.04%,1
宜蘭縣,羅東鎮,0127,275,277,552,23,575,1022,56.26%,26.91%,1
宜蘭縣,羅東鎮,0128,299,372,671,33,704,1131,62.25%,26.44%,1
宜蘭縣,蘇澳鎮,0129,335,301,636,41,677,1194,56.7%,28.06%,1
宜蘭縣,蘇澳鎮,0130,326,269,595,31,626,1128,55.5%,28.9%,1
宜蘭縣,蘇澳鎮,0131,344,258,602,39,641,1042,61.52%,33.01%,1
宜蘭縣,蘇澳鎮,0132,336,234,570,20,590,997,59.18%,33.7%,1
宜蘭縣,蘇澳鎮,0133,352,359,711,36,747,1303,57.33%,27.01%,1
宜蘭縣,蘇澳鎮,0134,377,330,707,54,761,1260,60.4%,29.92%,1
宜蘭縣,蘇澳鎮,0135,346,257,603,37,640,1130,56.64%,30.62%,1
宜蘭縣,蘇澳鎮,0136,162,132,294,25,319,559,57.07%,28.98%,1
宜蘭縣,蘇澳鎮,0137,115,65,180,13,193,351,54.99%,32.76%,1
宜蘭縣,蘇澳鎮,0138,256,213,469,32,501,889,56.36%,28.8%,1
宜蘭縣,蘇澳鎮,0139,118,108,226,23,249,434,57.37%,27.19%,1
宜蘭縣,蘇澳鎮,0140,241,242,483,19,502,835,60.12%,28.86%,1
宜蘭縣,蘇澳鎮,0141,286,246,532,34,566,975,58.05%,29.33%,1
宜蘭縣,蘇澳鎮,0142,324,306,630,53,683,1135,60.18%,28.55%,1
宜蘭縣,蘇澳鎮,0143,269,215,484,28,512,788,64.97%,34.14%,1
宜蘭縣,蘇澳鎮,0144,131,116,247,15,262,469,55.86%,27.93%,1
宜蘭縣,蘇澳鎮,0145,201,215,416,26,442,811,54.5%,24.78%,1
宜蘭縣,蘇澳鎮,0146,218,249,467,20,487,867,56.17%,25.14%,1
宜蘭縣,蘇澳鎮,0147,299,316,615,32,647,1139,56.8%,26.25%,1
宜蘭縣,蘇澳鎮,0148,238,331,569,36,605,1146,52.79%,20.77%,1
宜蘭縣,蘇澳鎮,0149,284,332,616,41,657,1154,56.93%,24.61%,1
宜蘭縣,蘇澳鎮,0150,246,214,460,20,480,908,52.86%,27.09%,1
宜蘭縣,蘇澳鎮,0151,159,188,347,18,365,656,55.64%,24.24%,1
宜蘭縣,蘇澳鎮,0152,252,228,480,43,523,834,62.71%,30.22%,1
宜蘭縣,蘇澳鎮,0153,261,319,580,36,616,1025,60.1%,25.46%,1
宜蘭縣,蘇澳鎮,0154,150,108,258,10,268,455,58.9%,32.97%,1
宜蘭縣,蘇澳鎮,0155,174,119,293,20,313,535,58.5%,32.52%,1
宜蘭縣,蘇澳鎮,0156,169,164,333,18,351,536,65.49%,31.53%,1
宜蘭縣,蘇澳鎮,0157,113,150,263,14,277,451,61.42%,25.06%,1
宜蘭縣,蘇澳鎮,0158,171,133,304,30,334,593,56.32%,28.84%,1
宜蘭縣,蘇澳鎮,0159,121,124,245,12,257,441,58.28%,27.44%,1
宜蘭縣,蘇澳鎮,0160,252,274,526,23,549,954,57.55%,26.42%,1
宜蘭縣,蘇澳鎮,0161,279,216,495,29,524,952,55.04%,29.31%,1
宜蘭縣,蘇澳鎮,0162,304,241,545,47,592,1125,52.62%,27.02%,1
宜蘭縣,蘇澳鎮,0163,194,194,388,43,431,763,56.49%,25.43%,1
宜蘭縣,蘇澳鎮,0164,161,150,311,17,328,706,46.46%,22.8%,1
宜蘭縣,蘇澳鎮,0165,244,235,479,44,523,1068,48.97%,22.85%,1
宜蘭縣,蘇澳鎮,0166,197,161,358,31,389,666,58.41%,29.58%,1
宜蘭縣,蘇澳鎮,0167,192,100,292,39,331,574,57.67%,33.45%,1
宜蘭縣,蘇澳鎮,0168,71,70,141,7,148,351,42.17%,20.23%,1
宜蘭縣,蘇澳鎮,0169,208,165,373,33,406,717,56.62%,29.01%,1
宜蘭縣,蘇澳鎮,0170,96,62,158,5,163,373,43.7%,25.74%,1
宜蘭縣,蘇澳鎮,0171,60,28,88,11,99,223,44.39%,26.91%,1
宜蘭縣,頭城鎮,0172,55,48,103,9,112,292,38.36%,18.84%,1
宜蘭縣,頭城鎮,0173,175,172,347,27,374,688,54.36%,25.44%,1
宜蘭縣,頭城鎮,0174,169,200,369,27,396,688,57.56%,24.56%,1
宜蘭縣,頭城鎮,0175,231,186,417,37,454,879,51.65%,26.28%,1
宜蘭縣,頭城鎮,0176,83,101,184,21,205,335,61.19%,24.78%,1
宜蘭縣,頭城鎮,0177,190,166,356,37,393,624,62.98%,30.45%,1
宜蘭縣,頭城鎮,0178,162,158,320,25,345,732,47.13%,22.13%,1
宜蘭縣,頭城鎮,0179,178,213,391,29,420,892,47.09%,19.96%,1
宜蘭縣,頭城鎮,0180,160,132,292,22,314,690,45.51%,23.19%,1
宜蘭縣,頭城鎮,0181,222,209,431,25,456,842,54.16%,26.37%,1
宜蘭縣,頭城鎮,0182,166,220,386,26,412,736,55.98%,22.55%,1
宜蘭縣,頭城鎮,0183,190,187,377,27,404,788,51.27%,24.11%,1
宜蘭縣,頭城鎮,0184,147,127,274,15,289,560,51.61%,26.25%,1
宜蘭縣,頭城鎮,0185,194,203,397,26,423,712,59.41%,27.25%,1
宜蘭縣,頭城鎮,0186,140,160,300,22,322,502,64.14%,27.89%,1
宜蘭縣,頭城鎮,0187,160,182,342,17,359,569,63.09%,28.12%,1
宜蘭縣,頭城鎮,0188,164,177,341,21,362,633,57.19%,25.91%,1
宜蘭縣,頭城鎮,0189,279,222,501,37,538,1132,47.53%,24.65%,1
宜蘭縣,頭城鎮,0190,215,258,473,23,496,1035,47.92%,20.77%,1
宜蘭縣,頭城鎮,0191,242,239,481,24,505,847,59.62%,28.57%,1
宜蘭縣,頭城鎮,0192,292,331,623,40,663,1172,56.57%,24.91%,1
宜蘭縣,頭城鎮,0193,225,238,463,19,482,896,53.79%,25.11%,1
宜蘭縣,頭城鎮,0194,249,357,606,24,630,1075,58.6%,23.16%,1
宜蘭縣,頭城鎮,0195,236,271,507,43,550,931,59.08%,25.35%,1
宜蘭縣,頭城鎮,0196,217,295,512,50,562,1021,55.04%,21.25%,1
宜蘭縣,頭城鎮,0197,102,216,318,33,351,709,49.51%,14.39%,1
宜蘭縣,頭城鎮,0198,188,220,408,34,442,689,64.15%,27.29%,1
宜蘭縣,頭城鎮,0199,173,178,351,32,383,615,62.28%,28.13%,1
宜蘭縣,頭城鎮,0200,205,183,388,27,415,759,54.68%,27.01%,1
宜蘭縣,頭城鎮,0201,274,249,523,41,564,917,61.5%,29.88%,1
宜蘭縣,頭城鎮,0202,298,251,549,58,607,1045,58.09%,28.52%,1
宜蘭縣,頭城鎮,0203,321,279,600,35,635,1130,56.19%,28.41%,1
宜蘭縣,礁溪鄉,0204,272,262,534,29,563,1122,50.18%,24.24%,1
宜蘭縣,礁溪鄉,0205,136,112,248,24,272,505,53.86%,26.93%,1
宜蘭縣,礁溪鄉,0206,281,219,500,20,520,988,52.63%,28.44%,1
宜蘭縣,礁溪鄉,0207,257,239,496,32,528,971,54.38%,26.47%,1
宜蘭縣,礁溪鄉,0208,261,324,585,39,624,1246,50.08%,20.95%,1
宜蘭縣,礁溪鄉,0209,322,419,741,24,765,1655,46.22%,19.46%,1
宜蘭縣,礁溪鄉,0210,226,265,491,22,513,1132,45.32%,19.96%,1
宜蘭縣,礁溪鄉,0211,223,205,428,16,444,783,56.7%,28.48%,1
宜蘭縣,礁溪鄉,0212,230,242,472,27,499,928,53.77%,24.78%,1
宜蘭縣,礁溪鄉,0213,211,232,443,16,459,848,54.13%,24.88%,1
宜蘭縣,礁溪鄉,0214,238,158,396,31,427,663,64.4%,35.9%,1
宜蘭縣,礁溪鄉,0215,206,120,326,20,346,608,56.91%,33.88%,1
宜蘭縣,礁溪鄉,0216,237,210,447,31,478,833,57.38%,28.45%,1
宜蘭縣,礁溪鄉,0217,353,248,601,14,615,1233,49.88%,28.63%,1
宜蘭縣,礁溪鄉,0218,165,288,453,29,482,854,56.44%,19.32%,1
宜蘭縣,礁溪鄉,0219,164,125,289,20,309,575,53.74%,28.52%,1
宜蘭縣,礁溪鄉,0220,241,205,446,23,469,835,56.17%,28.86%,1
宜蘭縣,礁溪鄉,0221,389,333,722,34,756,1305,57.93%,29.81%,1
宜蘭縣,礁溪鄉,0222,234,190,424,38,462,830,55.66%,28.19%,1
宜蘭縣,礁溪鄉,0223,212,183,395,33,428,649,65.95%,32.67%,1
宜蘭縣,礁溪鄉,0224,242,217,459,31,490,923,53.09%,26.22%,1
宜蘭縣,礁溪鄉,0225,302,235,537,24,561,1177,47.66%,25.66%,1
宜蘭縣,礁溪鄉,0226,243,198,441,22,463,840,55.12%,28.93%,1
宜蘭縣,礁溪鄉,0227,310,256,566,29,595,1051,56.61%,29.5%,1
宜蘭縣,礁溪鄉,0228,333,319,652,25,677,1339,50.56%,24.87%,1
宜蘭縣,礁溪鄉,0229,311,368,679,33,712,1194,59.63%,26.05%,1
宜蘭縣,礁溪鄉,0230,422,329,751,39,790,1314,60.12%,32.12%,1
宜蘭縣,礁溪鄉,0231,325,278,603,21,624,1125,55.47%,28.89%,1
宜蘭縣,礁溪鄉,0232,375,301,676,46,722,1207,59.82%,31.07%,1
宜蘭縣,礁溪鄉,0233,310,207,517,32,549,979,56.08%,31.66%,1
宜蘭縣,礁溪鄉,0234,273,270,543,43,586,954,61.43%,28.62%,1
宜蘭縣,礁溪鄉,0235,116,109,225,13,238,418,56.94%,27.75%,1
宜蘭縣,壯圍鄉,0236,415,391,806,61,867,1435,60.42%,28.92%,1
宜蘭縣,壯圍鄉,0237,306,280,586,42,628,1049,59.87%,29.17%,1
宜蘭縣,壯圍鄉,0238,328,288,616,44,660,1068,61.8%,30.71%,1
宜蘭縣,壯圍鄉,0239,228,214,442,63,505,868,58.18%,26.27%,1
宜蘭縣,壯圍鄉,0240,276,252,528,13,541,967,55.95%,28.54%,1
宜蘭縣,壯圍鄉,0241,296,242,538,44,582,940,61.91%,31.49%,1
宜蘭縣,壯圍鄉,0242,252,206,458,21,479,975,49.13%,25.85%,1
宜蘭縣,壯圍鄉,0243,255,199,454,44,498,797,62.48%,31.99%,1
宜蘭縣,壯圍鄉,0244,246,180,426,41,467,808,57.8%,30.45%,1
宜蘭縣,壯圍鄉,0245,332,188,520,30,550,911,60.37%,36.44%,1
宜蘭縣,壯圍鄉,0246,155,139,294,24,318,612,51.96%,25.33%,1
宜蘭縣,壯圍鄉,0247,277,202,479,24,503,790,63.67%,35.06%,1
宜蘭縣,壯圍鄉,0248,274,221,495,34,529,878,60.25%,31.21%,1
宜蘭縣,壯圍鄉,0249,271,186,457,30,487,723,67.36%,37.48%,1
宜蘭縣,壯圍鄉,0250,200,162,362,31,393,737,53.32%,27.14%,1
宜蘭縣,壯圍鄉,0251,213,167,380,33,413,686,60.2%,31.05%,1
宜蘭縣,壯圍鄉,0252,243,248,491,7,498,895,55.64%,27.15%,1
宜蘭縣,壯圍鄉,0253,341,369,710,47,757,1237,61.2%,27.57%,1
宜蘭縣,壯圍鄉,0254,319,299,618,33,651,1134,57.41%,28.13%,1
宜蘭縣,壯圍鄉,0255,411,178,589,32,621,1107,56.1%,37.13%,1
宜蘭縣,壯圍鄉,0256,341,266,607,34,641,1057,60.64%,32.26%,1
宜蘭縣,壯圍鄉,0257,277,231,508,38,546,1051,51.95%,26.36%,1
宜蘭縣,壯圍鄉,0258,192,178,370,34,404,722,55.96%,26.59%,1
宜蘭縣,員山鄉,0259,336,365,701,25,726,1393,52.12%,24.12%,1
宜蘭縣,員山鄉,0260,224,225,449,21,470,895,52.51%,25.03%,1
宜蘭縣,員山鄉,0261,263,332,595,43,638,1231,51.83%,21.36%,1
宜蘭縣,員山鄉,0262,247,296,543,24,567,1098,51.64%,22.5%,1
宜蘭縣,員山鄉,0263,244,269,513,31,544,1031,52.76%,23.67%,1
宜蘭縣,員山鄉,0264,272,148,420,137,557,1030,54.08%,26.41%,1
宜蘭縣,員山鄉,0265,262,267,529,30,559,1168,47.86%,22.43%,1
宜蘭縣,員山鄉,0266,247,180,427,38,465,809,57.48%,30.53%,1
宜蘭縣,員山鄉,0267,213,208,421,31,452,778,58.1%,27.38%,1
宜蘭縣,員山鄉,0268,282,520,802,47,849,1465,57.95%,19.25%,1
宜蘭縣,員山鄉,0269,277,272,549,34,583,979,59.55%,28.29%,1
宜蘭縣,員山鄉,0270,229,219,448,34,482,860,56.05%,26.63%,1
宜蘭縣,員山鄉,0271,281,285,566,35,601,1205,49.88%,23.32%,1
宜蘭縣,員山鄉,0272,286,271,557,57,614,1082,56.75%,26.43%,1
宜蘭縣,員山鄉,0273,132,98,230,18,248,412,60.19%,32.04%,1
宜蘭縣,員山鄉,0274,121,80,201,10,211,403,52.36%,30.02%,1
宜蘭縣,員山鄉,0275,48,46,94,10,104,232,44.83%,20.69%,1
宜蘭縣,員山鄉,0276,257,224,481,32,513,944,54.34%,27.22%,1
宜蘭縣,員山鄉,0277,279,200,479,34,513,894,57.38%,31.21%,1
宜蘭縣,員山鄉,0278,371,338,709,52,761,1356,56.12%,27.36%,1
宜蘭縣,員山鄉,0279,237,190,427,32,459,780,58.85%,30.38%,1
宜蘭縣,員山鄉,0280,306,230,536,53,589,932,63.2%,32.83%,1
宜蘭縣,員山鄉,0281,176,114,290,21,311,583,53.34%,30.19%,1
宜蘭縣,員山鄉,0282,272,185,457,47,504,900,56%,30.22%,1
宜蘭縣,員山鄉,0283,218,177,395,14,409,747,54.75%,29.18%,1
宜蘭縣,員山鄉,0284,218,169,387,48,435,788,55.2%,27.66%,1
宜蘭縣,員山鄉,0285,229,208,437,29,466,884,52.71%,25.9%,1
宜蘭縣,員山鄉,0286,233,197,430,14,444,857,51.81%,27.19%,1
宜蘭縣,員山鄉,0287,289,230,519,23,542,1016,53.35%,28.44%,1
宜蘭縣,員山鄉,0288,168,130,298,28,326,690,47.25%,24.35%,1
宜蘭縣,員山鄉,0289,208,128,336,36,372,689,53.99%,30.19%,1
宜蘭縣,冬山鄉,0290,259,207,466,20,486,807,60.22%,32.09%,1
宜蘭縣,冬山鄉,0291,257,209,466,11,477,817,58.38%,31.46%,1
宜蘭縣,冬山鄉,0292,342,292,634,29,663,1156,57.35%,29.58%,1
宜蘭縣,冬山鄉,0293,261,205,466,18,484,892,54.26%,29.26%,1
宜蘭縣,冬山鄉,0294,277,225,502,27,529,897,58.97%,30.88%,1
宜蘭縣,冬山鄉,0295,433,372,805,33,838,1392,60.2%,31.11%,1
宜蘭縣,冬山鄉,0296,418,388,806,37,843,1471,57.31%,28.42%,1
宜蘭縣,冬山鄉,0297,314,333,647,33,680,1435,47.39%,21.88%,1
宜蘭縣,冬山鄉,0298,386,375,761,31,792,1519,52.14%,25.41%,1
宜蘭縣,冬山鄉,0299,388,432,820,26,846,1456,58.1%,26.65%,1
宜蘭縣,冬山鄉,0300,236,174,410,28,438,711,61.6%,33.19%,1
宜蘭縣,冬山鄉,0301,218,176,394,13,407,694,58.65%,31.41%,1
宜蘭縣,冬山鄉,0302,477,463,940,35,975,1526,63.89%,31.26%,1
宜蘭縣,冬山鄉,0303,287,223,510,15,525,884,59.39%,32.47%,1
宜蘭縣,冬山鄉,0304,379,295,674,45,719,1465,49.08%,25.87%,1
宜蘭縣,冬山鄉,0305,171,104,275,15,290,488,59.43%,35.04%,1
宜蘭縣,冬山鄉,0306,363,263,626,28,654,1218,53.69%,29.8%,1
宜蘭縣,冬山鄉,0307,312,320,632,31,663,1291,51.36%,24.17%,1
宜蘭縣,冬山鄉,0308,351,298,649,26,675,1324,50.98%,26.51%,1
宜蘭縣,冬山鄉,0309,250,288,538,38,576,1160,49.66%,21.55%,1
宜蘭縣,冬山鄉,0310,325,309,634,36,670,1246,53.77%,26.08%,1
宜蘭縣,冬山鄉,0311,485,389,874,43,917,1754,52.28%,27.65%,1
宜蘭縣,冬山鄉,0312,326,290,616,36,652,1217,53.57%,26.79%,1
宜蘭縣,冬山鄉,0313,374,320,694,31,725,1495,48.49%,25.02%,1
宜蘭縣,冬山鄉,0314,251,232,483,28,511,937,54.54%,26.79%,1
宜蘭縣,冬山鄉,0315,292,268,560,28,588,1101,53.41%,26.52%,1
宜蘭縣,冬山鄉,0316,284,272,556,32,588,1118,52.59%,25.4%,1
宜蘭縣,冬山鄉,0317,364,365,729,29,758,1301,58.26%,27.98%,1
宜蘭縣,冬山鄉,0318,306,341,647,26,673,1225,54.94%,24.98%,1
宜蘭縣,冬山鄉,0319,362,314,676,32,708,1206,58.71%,30.02%,1
宜蘭縣,冬山鄉,0320,352,279,631,30,661,1278,51.72%,27.54%,1
宜蘭縣,冬山鄉,0321,324,256,580,23,603,1151,52.39%,28.15%,1
宜蘭縣,冬山鄉,0322,261,242,503,40,543,1094,49.63%,23.86%,1
宜蘭縣,冬山鄉,0323,373,289,662,47,709,1247,56.86%,29.91%,1
宜蘭縣,冬山鄉,0324,295,302,597,42,639,1247,51.24%,23.66%,1
宜蘭縣,冬山鄉,0325,260,253,513,27,540,979,55.16%,26.56%,1
宜蘭縣,冬山鄉,0326,213,193,406,22,428,698,61.32%,30.52%,1
宜蘭縣,冬山鄉,0327,432,455,887,36,923,1726,53.48%,25.03%,1
宜蘭縣,冬山鄉,0328,217,150,367,17,384,782,49.1%,27.75%,1
宜蘭縣,五結鄉,0329,252,264,516,43,559,1076,51.95%,23.42%,1
宜蘭縣,五結鄉,0330,299,198,497,21,518,944,54.87%,31.67%,1
宜蘭縣,五結鄉,0331,237,228,465,18,483,836,57.78%,28.35%,1
宜蘭縣,五結鄉,0332,262,244,506,32,538,937,57.42%,27.96%,1
宜蘭縣,五結鄉,0333,328,325,653,18,671,1255,53.47%,26.14%,1
宜蘭縣,五結鄉,0334,328,318,646,41,687,1270,54.09%,25.83%,1
宜蘭縣,五結鄉,0335,193,196,389,19,408,801,50.94%,24.09%,1
宜蘭縣,五結鄉,0336,201,200,401,21,422,802,52.62%,25.06%,1
宜蘭縣,五結鄉,0337,332,300,632,20,652,1306,49.92%,25.42%,1
宜蘭縣,五結鄉,0338,274,316,590,42,632,1190,53.11%,23.03%,1
宜蘭縣,五結鄉,0339,342,351,693,19,712,1316,54.1%,25.99%,1
宜蘭縣,五結鄉,0340,245,291,536,12,548,965,56.79%,25.39%,1
宜蘭縣,五結鄉,0341,214,202,416,28,444,814,54.55%,26.29%,1
宜蘭縣,五結鄉,0342,290,327,617,40,657,1254,52.39%,23.13%,1
宜蘭縣,五結鄉,0343,278,295,573,37,610,1060,57.55%,26.23%,1
宜蘭縣,五結鄉,0344,326,384,710,36,746,1323,56.39%,24.64%,1
宜蘭縣,五結鄉,0345,321,302,623,25,648,1120,57.86%,28.66%,1
宜蘭縣,五結鄉,0346,237,229,466,20,486,893,54.42%,26.54%,1
宜蘭縣,五結鄉,0347,328,294,622,31,653,1220,53.52%,26.89%,1
宜蘭縣,五結鄉,0348,247,276,523,16,539,924,58.33%,26.73%,1
宜蘭縣,五結鄉,0349,256,279,535,28,563,933,60.34%,27.44%,1
宜蘭縣,五結鄉,0350,200,310,510,22,532,986,53.96%,20.28%,1
宜蘭縣,五結鄉,0351,199,183,382,26,408,748,54.55%,26.6%,1
宜蘭縣,五結鄉,0352,474,329,803,39,842,1550,54.32%,30.58%,1
宜蘭縣,五結鄉,0353,193,151,344,21,365,629,58.03%,30.68%,1
宜蘭縣,五結鄉,0354,182,240,422,24,446,806,55.33%,22.58%,1
宜蘭縣,五結鄉,0355,259,206,465,38,503,956,52.62%,27.09%,1
宜蘭縣,五結鄉,0356,294,250,544,24,568,1066,53.28%,27.58%,1
宜蘭縣,五結鄉,0357,403,315,718,39,757,1513,50.03%,26.64%,1
宜蘭縣,五結鄉,0358,454,341,795,35,830,1566,53%,28.99%,1
宜蘭縣,五結鄉,0359,263,193,456,48,504,894,56.38%,29.42%,1
宜蘭縣,五結鄉,0360,317,232,549,40,589,1235,47.69%,25.67%,1
宜蘭縣,五結鄉,0361,201,181,382,21,403,704,57.24%,28.55%,1
宜蘭縣,三星鄉,0362,65,40,105,11,116,215,53.95%,30.23%,1
宜蘭縣,三星鄉,0363,125,90,215,26,241,523,46.08%,23.9%,1
宜蘭縣,三星鄉,0364,212,147,359,31,390,745,52.35%,28.46%,1
宜蘭縣,三星鄉,0365,166,135,301,23,324,617,52.51%,26.9%,1
宜蘭縣,三星鄉,0366,119,122,241,27,268,497,53.92%,23.94%,1
宜蘭縣,三星鄉,0367,223,163,386,31,417,735,56.73%,30.34%,1
宜蘭縣,三星鄉,0368,183,128,311,20,331,583,56.78%,31.39%,1
宜蘭縣,三星鄉,0369,98,116,214,22,236,436,54.13%,22.48%,1
宜蘭縣,三星鄉,0370,297,310,607,41,648,1224,52.94%,24.26%,1
宜蘭縣,三星鄉,0371,280,270,550,38,588,1151,51.09%,24.33%,1
宜蘭縣,三星鄉,0372,246,220,466,22,488,870,56.09%,28.28%,1
宜蘭縣,三星鄉,0373,281,233,514,27,541,1284,42.13%,21.88%,1
宜蘭縣,三星鄉,0374,279,230,509,28,537,897,59.87%,31.1%,1
宜蘭縣,三星鄉,0375,374,366,740,41,781,1439,54.27%,25.99%,1
宜蘭縣,三星鄉,0376,353,353,706,39,745,1445,51.56%,24.43%,1
宜蘭縣,三星鄉,0377,371,345,716,27,743,1402,53%,26.46%,1
宜蘭縣,三星鄉,0378,351,268,619,35,654,1230,53.17%,28.54%,1
宜蘭縣,三星鄉,0379,220,185,405,29,434,774,56.07%,28.42%,1
宜蘭縣,三星鄉,0380,246,215,461,21,482,827,58.28%,29.75%,1
宜蘭縣,三星鄉,0381,246,153,399,17,416,736,56.52%,33.42%,1
宜蘭縣,三星鄉,0382,406,295,701,46,747,1421,52.57%,28.57%,1
宜蘭縣,大同鄉,0383,136,236,372,46,418,893,46.81%,15.23%,1
宜蘭縣,大同鄉,0384,104,308,412,46,458,632,72.47%,16.46%,1
宜蘭縣,大同鄉,0385,136,185,321,16,337,684,49.27%,19.88%,1
宜蘭縣,大同鄉,0386,81,79,160,20,180,264,68.18%,30.68%,1
宜蘭縣,大同鄉,0387,44,89,133,4,137,337,40.65%,13.06%,1
宜蘭縣,大同鄉,0388,61,98,159,10,169,404,41.83%,15.1%,1
宜蘭縣,大同鄉,0389,14,11,25,3,28,55,50.91%,25.45%,1
宜蘭縣,大同鄉,0390,49,86,135,20,155,199,77.89%,24.62%,1
宜蘭縣,大同鄉,0391,88,176,264,21,285,787,36.21%,11.18%,1
宜蘭縣,大同鄉,0392,116,219,335,58,393,680,57.79%,17.06%,1
宜蘭縣,南澳鄉,0393,72,156,228,10,238,444,53.6%,16.22%,1
宜蘭縣,南澳鄉,0394,138,466,604,19,623,1210,51.49%,11.4%,1
宜蘭縣,南澳鄉,0395,120,456,576,65,641,962,66.63%,12.47%,1
宜蘭縣,南澳鄉,0396,43,127,170,3,173,411,42.09%,10.46%,1
宜蘭縣,南澳鄉,0397,86,204,290,20,310,447,69.35%,19.24%,1
宜蘭縣,南澳鄉,0398,105,237,342,29,371,475,78.11%,22.11%,1
宜蘭縣,南澳鄉,0399,108,278,386,33,419,695,60.29%,15.54%,1
花蓮縣,花蓮市,0001,290,568,858,16,874,1522,57.42%,19.05%,1
花蓮縣,花蓮市,0002,194,437,631,20,651,1114,58.44%,17.41%,1
花蓮縣,花蓮市,0003,102,259,361,18,379,670,56.57%,15.22%,1
花蓮縣,花蓮市,0004,220,501,721,19,740,1397,52.97%,15.75%,1
花蓮縣,花蓮市,0005,90,135,225,13,238,470,50.64%,19.15%,1
花蓮縣,花蓮市,0006,122,289,411,26,437,838,52.15%,14.56%,1
花蓮縣,花蓮市,0007,62,223,285,23,308,721,42.72%,8.6%,1
花蓮縣,花蓮市,0008,206,302,508,25,533,918,58.06%,22.44%,1
花蓮縣,花蓮市,0009,241,544,785,28,813,1539,52.83%,15.66%,1
花蓮縣,花蓮市,0010,211,493,704,44,748,1403,53.31%,15.04%,1
花蓮縣,花蓮市,0011,198,352,550,17,567,1068,53.09%,18.54%,1
花蓮縣,花蓮市,0012,214,414,628,17,645,1167,55.27%,18.34%,1
花蓮縣,花蓮市,0013,204,501,705,49,754,1259,59.89%,16.2%,1
花蓮縣,花蓮市,0014,212,325,537,52,589,1071,55%,19.79%,1
花蓮縣,花蓮市,0015,183,319,502,27,529,925,57.19%,19.78%,1
花蓮縣,花蓮市,0016,200,471,671,43,714,1141,62.58%,17.53%,1
花蓮縣,花蓮市,0017,186,418,604,16,620,1163,53.31%,15.99%,1
花蓮縣,花蓮市,0018,214,493,707,37,744,1279,58.17%,16.73%,1
花蓮縣,花蓮市,0019,260,454,714,22,736,1512,48.68%,17.2%,1
花蓮縣,花蓮市,0020,123,197,320,14,334,615,54.31%,20%,1
花蓮縣,花蓮市,0021,152,205,357,12,369,606,60.89%,25.08%,1
花蓮縣,花蓮市,0022,82,193,275,16,291,559,52.06%,14.67%,1
花蓮縣,花蓮市,0023,83,157,240,9,249,442,56.33%,18.78%,1
花蓮縣,花蓮市,0024,224,334,558,27,585,1114,52.51%,20.11%,1
花蓮縣,花蓮市,0025,70,154,224,13,237,416,56.97%,16.83%,1
花蓮縣,花蓮市,0026,144,198,342,15,357,577,61.87%,24.96%,1
花蓮縣,花蓮市,0027,205,270,475,20,495,810,61.11%,25.31%,1
花蓮縣,花蓮市,0028,122,183,305,4,309,538,57.43%,22.68%,1
花蓮縣,花蓮市,0029,122,166,288,24,312,566,55.12%,21.55%,1
花蓮縣,花蓮市,0030,93,163,256,8,264,469,56.29%,19.83%,1
花蓮縣,花蓮市,0031,125,186,311,17,328,565,58.05%,22.12%,1
花蓮縣,花蓮市,0032,145,251,396,20,416,816,50.98%,17.77%,1
花蓮縣,花蓮市,0033,172,296,468,19,487,911,53.46%,18.88%,1
花蓮縣,花蓮市,0034,188,320,508,34,542,1029,52.67%,18.27%,1
花蓮縣,花蓮市,0035,226,368,594,24,618,1043,59.25%,21.67%,1
花蓮縣,花蓮市,0036,174,314,488,12,500,856,58.41%,20.33%,1
花蓮縣,花蓮市,0037,202,326,528,20,548,979,55.98%,20.63%,1
花蓮縣,花蓮市,0038,278,442,720,33,753,1331,56.57%,20.89%,1
花蓮縣,花蓮市,0039,271,412,683,24,707,1228,57.57%,22.07%,1
花蓮縣,花蓮市,0040,182,343,525,22,547,955,57.28%,19.06%,1
花蓮縣,花蓮市,0041,215,402,617,27,644,1268,50.79%,16.96%,1
花蓮縣,花蓮市,0042,216,401,617,28,645,1230,52.44%,17.56%,1
花蓮縣,花蓮市,0043,253,490,743,36,779,1369,56.9%,18.48%,1
花蓮縣,花蓮市,0044,220,429,649,22,671,1435,46.76%,15.33%,1
花蓮縣,花蓮市,0045,202,415,617,23,640,1164,54.98%,17.35%,1
花蓮縣,花蓮市,0046,251,458,709,39,748,1249,59.89%,20.1%,1
花蓮縣,花蓮市,0047,246,386,632,31,663,1184,56%,20.78%,1
花蓮縣,花蓮市,0048,287,475,762,18,780,1490,52.35%,19.26%,1
花蓮縣,花蓮市,0049,232,371,603,39,642,1022,62.82%,22.7%,1
花蓮縣,花蓮市,0050,222,382,604,36,640,1135,56.39%,19.56%,1
花蓮縣,花蓮市,0051,199,394,593,19,612,1084,56.46%,18.36%,1
花蓮縣,花蓮市,0052,175,300,475,25,500,1339,37.34%,13.07%,1
花蓮縣,花蓮市,0053,115,178,293,8,301,501,60.08%,22.95%,1
花蓮縣,花蓮市,0054,180,314,494,16,510,904,56.42%,19.91%,1
花蓮縣,花蓮市,0055,120,167,287,17,304,490,62.04%,24.49%,1
花蓮縣,花蓮市,0056,201,347,548,23,571,1192,47.9%,16.86%,1
花蓮縣,花蓮市,0057,148,266,414,22,436,869,50.17%,17.03%,1
花蓮縣,花蓮市,0058,226,422,648,31,679,1267,53.59%,17.84%,1
花蓮縣,花蓮市,0059,173,350,523,34,557,959,58.08%,18.04%,1
花蓮縣,花蓮市,0060,183,340,523,22,545,993,54.88%,18.43%,1
花蓮縣,花蓮市,0061,199,321,520,33,553,982,56.31%,20.26%,1
花蓮縣,花蓮市,0062,241,400,641,20,661,1311,50.42%,18.38%,1
花蓮縣,花蓮市,0063,284,433,717,31,748,1455,51.41%,19.52%,1
花蓮縣,花蓮市,0064,190,333,523,17,540,1151,46.92%,16.51%,1
花蓮縣,花蓮市,0065,207,391,598,20,618,1237,49.96%,16.73%,1
花蓮縣,花蓮市,0066,235,387,622,26,648,1339,48.39%,17.55%,1
花蓮縣,花蓮市,0067,129,275,404,13,417,715,58.32%,18.04%,1
花蓮縣,花蓮市,0068,187,345,532,25,557,1000,55.7%,18.7%,1
花蓮縣,花蓮市,0069,230,435,665,36,701,1410,49.72%,16.31%,1
花蓮縣,花蓮市,0070,245,432,677,18,695,1303,53.34%,18.8%,1
花蓮縣,花蓮市,0071,255,409,664,12,676,1256,53.82%,20.3%,1
花蓮縣,花蓮市,0072,205,402,607,32,639,1105,57.83%,18.55%,1
花蓮縣,花蓮市,0073,203,339,542,18,560,1089,51.42%,18.64%,1
花蓮縣,花蓮市,0074,167,339,506,30,536,1043,51.39%,16.01%,1
花蓮縣,花蓮市,0075,193,413,606,16,622,1080,57.59%,17.87%,1
花蓮縣,花蓮市,0076,155,359,514,35,549,971,56.54%,15.96%,1
花蓮縣,花蓮市,0077,216,371,587,24,611,1068,57.21%,20.22%,1
花蓮縣,花蓮市,0078,205,463,668,25,693,1379,50.25%,14.87%,1
花蓮縣,花蓮市,0079,205,486,691,30,721,1362,52.94%,15.05%,1
花蓮縣,花蓮市,0080,233,503,736,30,766,1323,57.9%,17.61%,1
花蓮縣,花蓮市,0081,250,404,654,27,681,1482,45.95%,16.87%,1
花蓮縣,鳳林鎮,0195,238,460,698,37,735,1192,61.66%,19.97%,1
花蓮縣,鳳林鎮,0196,97,213,310,17,327,639,51.17%,15.18%,1
花蓮縣,鳳林鎮,0197,133,243,376,28,404,601,67.22%,22.13%,1
花蓮縣,鳳林鎮,0198,221,473,694,38,732,1137,64.38%,19.44%,1
花蓮縣,鳳林鎮,0199,142,238,380,39,419,742,56.47%,19.14%,1
花蓮縣,鳳林鎮,0200,99,235,334,19,353,610,57.87%,16.23%,1
花蓮縣,鳳林鎮,0201,77,76,153,39,192,295,65.08%,26.1%,1
花蓮縣,鳳林鎮,0202,17,47,64,3,67,218,30.73%,7.8%,1
花蓮縣,鳳林鎮,0203,130,181,311,12,323,720,44.86%,18.06%,1
花蓮縣,鳳林鎮,0204,90,174,264,24,288,528,54.55%,17.05%,1
花蓮縣,鳳林鎮,0205,125,155,280,11,291,560,51.96%,22.32%,1
花蓮縣,鳳林鎮,0206,102,149,251,40,291,541,53.79%,18.85%,1
花蓮縣,鳳林鎮,0207,141,272,413,51,464,818,56.72%,17.24%,1
花蓮縣,鳳林鎮,0208,174,252,426,23,449,984,45.63%,17.68%,1
花蓮縣,鳳林鎮,0209,20,24,44,6,50,91,54.95%,21.98%,1
花蓮縣,玉里鎮,0254,192,323,515,35,550,1008,54.56%,19.05%,1
花蓮縣,玉里鎮,0255,171,347,518,40,558,939,59.42%,18.21%,1
花蓮縣,玉里鎮,0256,207,397,604,54,658,1256,52.39%,16.48%,1
花蓮縣,玉里鎮,0257,170,307,477,30,507,929,54.57%,18.3%,1
花蓮縣,玉里鎮,0258,175,348,523,19,542,979,55.36%,17.88%,1
花蓮縣,玉里鎮,0259,248,454,702,28,730,1244,58.68%,19.94%,1
花蓮縣,玉里鎮,0260,143,244,387,33,420,847,49.59%,16.88%,1
花蓮縣,玉里鎮,0261,138,208,346,36,382,772,49.48%,17.88%,1
花蓮縣,玉里鎮,0262,104,154,258,21,279,558,50%,18.64%,1
花蓮縣,玉里鎮,0263,67,170,237,23,260,800,32.5%,8.38%,1
花蓮縣,玉里鎮,0264,184,349,533,64,597,1286,46.42%,14.31%,1
花蓮縣,玉里鎮,0265,201,338,539,60,599,1246,48.07%,16.13%,1
花蓮縣,玉里鎮,0266,127,178,305,44,349,647,53.94%,19.63%,1
花蓮縣,玉里鎮,0267,77,152,229,16,245,990,24.75%,7.78%,1
花蓮縣,玉里鎮,0268,82,126,208,54,262,530,49.43%,15.47%,1
花蓮縣,玉里鎮,0269,135,194,329,48,377,979,38.51%,13.79%,1
花蓮縣,玉里鎮,0270,111,130,241,79,320,557,57.45%,19.93%,1
花蓮縣,玉里鎮,0271,50,112,162,16,178,434,41.01%,11.52%,1
花蓮縣,玉里鎮,0272,128,188,316,71,387,1065,36.34%,12.02%,1
花蓮縣,玉里鎮,0273,125,272,397,68,465,866,53.7%,14.43%,1
花蓮縣,玉里鎮,0274,100,192,292,49,341,769,44.34%,13%,1
花蓮縣,玉里鎮,0275,136,208,344,28,372,869,42.81%,15.65%,1
花蓮縣,玉里鎮,0276,156,249,405,44,449,1080,41.57%,14.44%,1
花蓮縣,新城鄉,0082,92,114,206,10,216,367,58.86%,25.07%,1
花蓮縣,新城鄉,0083,183,288,471,13,484,929,52.1%,19.7%,1
花蓮縣,新城鄉,0084,170,149,319,40,359,590,60.85%,28.81%,1
花蓮縣,新城鄉,0085,86,77,163,14,177,307,57.65%,28.01%,1
花蓮縣,新城鄉,0086,55,96,151,10,161,260,61.92%,21.15%,1
花蓮縣,新城鄉,0087,269,392,661,58,719,1283,56.04%,20.97%,1
花蓮縣,新城鄉,0088,153,286,439,14,453,885,51.19%,17.29%,1
花蓮縣,新城鄉,0089,131,298,429,21,450,770,58.44%,17.01%,1
花蓮縣,新城鄉,0090,230,456,686,55,741,1363,54.37%,16.87%,1
花蓮縣,新城鄉,0091,66,118,184,11,195,366,53.28%,18.03%,1
花蓮縣,新城鄉,0092,215,342,557,35,592,1163,50.9%,18.49%,1
花蓮縣,新城鄉,0093,238,572,810,34,844,1605,52.59%,14.83%,1
花蓮縣,新城鄉,0094,231,411,642,24,666,1194,55.78%,19.35%,1
花蓮縣,新城鄉,0095,174,357,531,25,556,979,56.79%,17.77%,1
花蓮縣,新城鄉,0096,273,522,795,33,828,1485,55.76%,18.38%,1
花蓮縣,新城鄉,0097,214,324,538,20,558,1070,52.15%,20%,1
花蓮縣,新城鄉,0098,184,427,611,23,634,1164,54.47%,15.81%,1
花蓮縣,新城鄉,0099,166,255,421,47,468,880,53.18%,18.86%,1
花蓮縣,新城鄉,0100,73,102,175,11,186,369,50.41%,19.78%,1
花蓮縣,吉安鄉,0115,191,345,536,24,560,1059,52.88%,18.04%,1
花蓮縣,吉安鄉,0116,158,364,522,25,547,983,55.65%,16.07%,1
花蓮縣,吉安鄉,0117,181,356,537,28,565,1031,54.8%,17.56%,1
花蓮縣,吉安鄉,0118,206,352,558,27,585,1105,52.94%,18.64%,1
花蓮縣,吉安鄉,0119,142,424,566,16,582,1107,52.57%,12.83%,1
花蓮縣,吉安鄉,0120,233,330,563,26,589,1179,49.96%,19.76%,1
花蓮縣,吉安鄉,0121,254,367,621,46,667,1453,45.91%,17.48%,1
花蓮縣,吉安鄉,0122,266,540,806,35,841,1432,58.73%,18.58%,1
花蓮縣,吉安鄉,0123,225,473,698,32,730,1320,55.3%,17.05%,1
花蓮縣,吉安鄉,0124,239,451,690,20,710,1356,52.36%,17.63%,1
花蓮縣,吉安鄉,0125,219,431,650,31,681,1295,52.59%,16.91%,1
花蓮縣,吉安鄉,0126,226,535,761,37,798,1467,54.4%,15.41%,1
花蓮縣,吉安鄉,0127,260,509,769,24,793,1515,52.34%,17.16%,1
花蓮縣,吉安鄉,0128,210,391,601,31,632,1063,59.45%,19.76%,1
花蓮縣,吉安鄉,0129,163,406,569,15,584,1284,45.48%,12.69%,1
花蓮縣,吉安鄉,0130,217,536,753,25,778,1380,56.38%,15.72%,1
花蓮縣,吉安鄉,0131,139,444,583,46,629,1297,48.5%,10.72%,1
花蓮縣,吉安鄉,0132,351,443,794,47,841,1662,50.6%,21.12%,1
花蓮縣,吉安鄉,0133,281,420,701,50,751,1563,48.05%,17.98%,1
花蓮縣,吉安鄉,0134,202,382,584,40,624,1288,48.45%,15.68%,1
花蓮縣,吉安鄉,0135,177,303,480,37,517,907,57%,19.51%,1
花蓮縣,吉安鄉,0136,148,287,435,39,474,917,51.69%,16.14%,1
花蓮縣,吉安鄉,0137,185,323,508,19,527,1021,51.62%,18.12%,1
花蓮縣,吉安鄉,0138,193,398,591,23,614,1033,59.44%,18.68%,1
花蓮縣,吉安鄉,0139,181,340,521,37,558,966,57.76%,18.74%,1
花蓮縣,吉安鄉,0140,203,383,586,41,627,1188,52.78%,17.09%,1
花蓮縣,吉安鄉,0141,321,421,742,30,772,1480,52.16%,21.69%,1
花蓮縣,吉安鄉,0142,200,445,645,31,676,1393,48.53%,14.36%,1
花蓮縣,吉安鄉,0143,203,383,586,32,618,1193,51.8%,17.02%,1
花蓮縣,吉安鄉,0144,222,463,685,23,708,1445,49%,15.36%,1
花蓮縣,吉安鄉,0145,230,408,638,80,718,1301,55.19%,17.68%,1
花蓮縣,吉安鄉,0146,254,406,660,31,691,1215,56.87%,20.91%,1
花蓮縣,吉安鄉,0147,230,356,586,24,610,1135,53.74%,20.26%,1
花蓮縣,吉安鄉,0148,199,467,666,28,694,1223,56.75%,16.27%,1
花蓮縣,吉安鄉,0149,226,457,683,19,702,1274,55.1%,17.74%,1
花蓮縣,吉安鄉,0150,206,374,580,28,608,1124,54.09%,18.33%,1
花蓮縣,吉安鄉,0151,215,413,628,21,649,1158,56.04%,18.57%,1
花蓮縣,吉安鄉,0152,215,416,631,14,645,1157,55.75%,18.58%,1
花蓮縣,吉安鄉,0153,227,453,680,20,700,1258,55.64%,18.04%,1
花蓮縣,吉安鄉,0154,262,398,660,19,679,1257,54.02%,20.84%,1
花蓮縣,吉安鄉,0155,198,428,626,26,652,1245,52.37%,15.9%,1
花蓮縣,吉安鄉,0156,249,395,644,12,656,1166,56.26%,21.36%,1
花蓮縣,吉安鄉,0157,233,448,681,37,718,1358,52.87%,17.16%,1
花蓮縣,吉安鄉,0158,195,404,599,31,630,1214,51.89%,16.06%,1
花蓮縣,吉安鄉,0159,176,404,580,40,620,1151,53.87%,15.29%,1
花蓮縣,吉安鄉,0160,245,371,616,28,644,1157,55.66%,21.18%,1
花蓮縣,吉安鄉,0161,218,406,624,31,655,1161,56.42%,18.78%,1
花蓮縣,吉安鄉,0162,241,458,699,38,737,1304,56.52%,18.48%,1
花蓮縣,吉安鄉,0163,198,484,682,37,719,1367,52.6%,14.48%,1
花蓮縣,吉安鄉,0164,213,423,636,30,666,1411,47.2%,15.1%,1
花蓮縣,吉安鄉,0165,190,448,638,28,666,1409,47.27%,13.48%,1
花蓮縣,吉安鄉,0166,207,300,507,30,537,1125,47.73%,18.4%,1
花蓮縣,吉安鄉,0167,214,397,611,59,670,1213,55.23%,17.64%,1
花蓮縣,吉安鄉,0168,199,397,596,28,624,1141,54.69%,17.44%,1
花蓮縣,吉安鄉,0169,171,347,518,26,544,1156,47.06%,14.79%,1
花蓮縣,吉安鄉,0170,177,361,538,29,567,1092,51.92%,16.21%,1
花蓮縣,吉安鄉,0171,176,263,439,29,468,1026,45.61%,17.15%,1
花蓮縣,吉安鄉,0172,131,283,414,18,432,804,53.73%,16.29%,1
花蓮縣,吉安鄉,0173,192,402,594,33,627,1132,55.39%,16.96%,1
花蓮縣,壽豐鄉,0174,185,303,488,29,517,1052,49.14%,17.59%,1
花蓮縣,壽豐鄉,0175,80,121,201,17,218,357,61.06%,22.41%,1
花蓮縣,壽豐鄉,0176,189,279,468,51,519,1022,50.78%,18.49%,1
花蓮縣,壽豐鄉,0177,209,303,512,35,547,875,62.51%,23.89%,1
花蓮縣,壽豐鄉,0178,162,235,397,26,423,691,61.22%,23.44%,1
花蓮縣,壽豐鄉,0179,132,205,337,12,349,708,49.29%,18.64%,1
花蓮縣,壽豐鄉,0180,176,259,435,39,474,894,53.02%,19.69%,1
花蓮縣,壽豐鄉,0181,148,237,385,26,411,746,55.09%,19.84%,1
花蓮縣,壽豐鄉,0182,66,273,339,33,372,881,42.22%,7.49%,1
花蓮縣,壽豐鄉,0183,151,265,416,22,438,695,63.02%,21.73%,1
花蓮縣,壽豐鄉,0184,170,276,446,70,516,816,63.24%,20.83%,1
花蓮縣,壽豐鄉,0185,142,221,363,33,396,773,51.23%,18.37%,1
花蓮縣,壽豐鄉,0186,262,293,555,32,587,1029,57.05%,25.46%,1
花蓮縣,壽豐鄉,0187,91,153,244,14,258,407,63.39%,22.36%,1
花蓮縣,壽豐鄉,0188,239,374,613,38,651,1139,57.16%,20.98%,1
花蓮縣,壽豐鄉,0189,253,287,540,33,573,996,57.53%,25.4%,1
花蓮縣,壽豐鄉,0190,75,104,179,11,190,414,45.89%,18.12%,1
花蓮縣,壽豐鄉,0191,68,81,149,8,157,270,58.15%,25.19%,1
花蓮縣,壽豐鄉,0192,155,302,457,32,489,836,58.49%,18.54%,1
花蓮縣,壽豐鄉,0193,130,163,293,18,311,507,61.34%,25.64%,1
花蓮縣,壽豐鄉,0194,117,160,277,39,316,739,42.76%,15.83%,1
花蓮縣,光復鄉,0210,266,422,688,46,734,1295,56.68%,20.54%,1
花蓮縣,光復鄉,0211,163,320,483,22,505,859,58.79%,18.98%,1
花蓮縣,光復鄉,0212,149,331,480,90,570,958,59.5%,15.55%,1
花蓮縣,光復鄉,0213,164,350,514,78,592,1011,58.56%,16.22%,1
花蓮縣,光復鄉,0214,191,354,545,57,602,1041,57.83%,18.35%,1
花蓮縣,光復鄉,0215,133,241,374,76,450,821,54.81%,16.2%,1
花蓮縣,光復鄉,0216,12,29,41,3,44,188,23.4%,6.38%,1
花蓮縣,光復鄉,0217,84,161,245,36,281,514,54.67%,16.34%,1
花蓮縣,光復鄉,0218,70,96,166,8,174,446,39.01%,15.7%,1
花蓮縣,光復鄉,0219,144,246,390,42,432,851,50.76%,16.92%,1
花蓮縣,光復鄉,0220,132,206,338,19,357,932,38.3%,14.16%,1
花蓮縣,光復鄉,0221,86,170,256,14,270,471,57.32%,18.26%,1
花蓮縣,光復鄉,0222,131,196,327,29,356,640,55.63%,20.47%,1
花蓮縣,光復鄉,0223,18,27,45,0,45,116,38.79%,15.52%,1
花蓮縣,光復鄉,0224,51,105,156,6,162,496,32.66%,10.28%,1
花蓮縣,光復鄉,0225,53,82,135,11,146,324,45.06%,16.36%,1
花蓮縣,光復鄉,0226,74,92,166,19,185,454,40.75%,16.3%,1
花蓮縣,豐濱鄉,0227,109,173,282,63,345,717,48.12%,15.2%,1
花蓮縣,豐濱鄉,0228,126,139,265,46,311,751,41.41%,16.78%,1
花蓮縣,豐濱鄉,0229,100,144,244,46,290,613,47.31%,16.31%,1
花蓮縣,豐濱鄉,0230,141,248,389,24,413,809,51.05%,17.43%,1
花蓮縣,豐濱鄉,0231,18,51,69,7,76,357,21.29%,5.04%,1
花蓮縣,豐濱鄉,0232,119,158,277,64,341,669,50.97%,17.79%,1
花蓮縣,豐濱鄉,0233,65,133,198,16,214,479,44.68%,13.57%,1
花蓮縣,瑞穗鄉,0241,153,295,448,30,478,813,58.79%,18.82%,1
花蓮縣,瑞穗鄉,0242,218,348,566,43,609,1091,55.82%,19.98%,1
花蓮縣,瑞穗鄉,0243,167,299,466,14,480,839,57.21%,19.9%,1
花蓮縣,瑞穗鄉,0244,157,347,504,53,557,975,57.13%,16.1%,1
花蓮縣,瑞穗鄉,0245,96,142,238,25,263,546,48.17%,17.58%,1
花蓮縣,瑞穗鄉,0246,220,316,536,38,574,1002,57.29%,21.96%,1
花蓮縣,瑞穗鄉,0247,82,169,251,29,280,593,47.22%,13.83%,1
花蓮縣,瑞穗鄉,0248,205,296,501,58,559,965,57.93%,21.24%,1
花蓮縣,瑞穗鄉,0249,138,276,414,62,476,863,55.16%,15.99%,1
花蓮縣,瑞穗鄉,0250,22,54,76,7,83,340,24.41%,6.47%,1
花蓮縣,瑞穗鄉,0251,103,218,321,35,356,764,46.6%,13.48%,1
花蓮縣,瑞穗鄉,0252,59,137,196,6,202,868,23.27%,6.8%,1
花蓮縣,瑞穗鄉,0253,86,108,194,7,201,620,32.42%,13.87%,1
花蓮縣,富里鄉,0277,59,126,185,16,201,467,43.04%,12.63%,1
花蓮縣,富里鄉,0278,148,221,369,45,414,1032,40.12%,14.34%,1
花蓮縣,富里鄉,0279,91,160,251,27,278,638,43.57%,14.26%,1
花蓮縣,富里鄉,0280,107,151,258,67,325,591,54.99%,18.1%,1
花蓮縣,富里鄉,0281,179,369,548,46,594,1087,54.65%,16.47%,1
花蓮縣,富里鄉,0282,81,131,212,12,224,431,51.97%,18.79%,1
花蓮縣,富里鄉,0283,160,249,409,29,438,893,49.05%,17.92%,1
花蓮縣,富里鄉,0284,62,76,138,12,150,361,41.55%,17.17%,1
花蓮縣,富里鄉,0285,224,288,512,47,559,1362,41.04%,16.45%,1
花蓮縣,富里鄉,0286,87,130,217,22,239,458,52.18%,19%,1
花蓮縣,富里鄉,0287,67,127,194,20,214,621,34.46%,10.79%,1
花蓮縣,富里鄉,0288,82,143,225,19,244,493,49.49%,16.63%,1
花蓮縣,富里鄉,0289,145,160,305,11,316,631,50.08%,22.98%,1
花蓮縣,秀林鄉,0101,143,298,441,17,458,867,52.83%,16.49%,1
花蓮縣,秀林鄉,0102,116,164,280,17,297,575,51.65%,20.17%,1
花蓮縣,秀林鄉,0103,187,339,526,38,564,1373,41.08%,13.62%,1
花蓮縣,秀林鄉,0104,269,418,687,67,754,1644,45.86%,16.36%,1
花蓮縣,秀林鄉,0105,24,59,83,6,89,162,54.94%,14.81%,1
花蓮縣,秀林鄉,0106,78,100,178,17,195,384,50.78%,20.31%,1
花蓮縣,秀林鄉,0107,234,369,603,36,639,1382,46.24%,16.93%,1
花蓮縣,秀林鄉,0108,229,291,520,29,549,1125,48.8%,20.36%,1
花蓮縣,秀林鄉,0109,139,162,301,11,312,627,49.76%,22.17%,1
花蓮縣,秀林鄉,0110,309,258,567,35,602,987,60.99%,31.31%,1
花蓮縣,秀林鄉,0111,214,414,628,72,700,1139,61.46%,18.79%,1
花蓮縣,秀林鄉,0112,210,410,620,9,629,1213,51.85%,17.31%,1
花蓮縣,秀林鄉,0113,156,211,367,25,392,754,51.99%,20.69%,1
花蓮縣,秀林鄉,0114,43,107,150,10,160,330,48.48%,13.03%,1
花蓮縣,萬榮鄉,0234,201,342,543,53,596,1072,55.6%,18.75%,1
花蓮縣,萬榮鄉,0235,108,151,259,4,263,560,46.96%,19.29%,1
花蓮縣,萬榮鄉,0236,167,292,459,16,475,773,61.45%,21.6%,1
花蓮縣,萬榮鄉,0237,102,161,263,15,278,661,42.06%,15.43%,1
花蓮縣,萬榮鄉,0238,65,159,224,13,237,442,53.62%,14.71%,1
花蓮縣,萬榮鄉,0239,95,196,291,58,349,675,51.7%,14.07%,1
花蓮縣,萬榮鄉,0240,262,383,645,92,737,1086,67.86%,24.13%,1
花蓮縣,卓溪鄉,0290,78,204,282,23,305,533,57.22%,14.63%,1
花蓮縣,卓溪鄉,0291,117,173,290,40,330,522,63.22%,22.41%,1
花蓮縣,卓溪鄉,0292,79,152,231,17,248,493,50.3%,16.02%,1
花蓮縣,卓溪鄉,0293,107,289,396,45,441,701,62.91%,15.26%,1
花蓮縣,卓溪鄉,0294,102,297,399,44,443,746,59.38%,13.67%,1
花蓮縣,卓溪鄉,0295,117,224,341,49,390,616,63.31%,18.99%,1
花蓮縣,卓溪鄉,0296,47,75,122,15,137,405,33.83%,11.6%,1
花蓮縣,卓溪鄉,0297,53,116,169,10,179,329,54.41%,16.11%,1
花蓮縣,卓溪鄉,0298,61,156,217,16,233,428,54.44%,14.25%,1
花蓮縣,卓溪鄉,0299,31,59,90,8,98,174,56.32%,17.82%,1
臺東縣,臺東市,0001,169,244,413,24,437,874,50%,19.34%,1
臺東縣,臺東市,0002,344,524,868,42,910,1469,61.95%,23.42%,1
臺東縣,臺東市,0003,241,445,686,28,714,1259,56.71%,19.14%,1
臺東縣,臺東市,0004,284,476,760,32,792,1399,56.61%,20.3%,1
臺東縣,臺東市,0005,264,558,822,21,843,1363,61.85%,19.37%,1
臺東縣,臺東市,0006,333,545,878,32,910,1651,55.12%,20.17%,1
臺東縣,臺東市,0007,363,535,898,37,935,1490,62.75%,24.36%,1
臺東縣,臺東市,0008,173,260,433,31,464,859,54.02%,20.14%,1
臺東縣,臺東市,0009,220,299,519,29,548,890,61.57%,24.72%,1
臺東縣,臺東市,0010,139,202,341,38,379,651,58.22%,21.35%,1
臺東縣,臺東市,0011,328,459,787,49,836,1650,50.67%,19.88%,1
臺東縣,臺東市,0012,178,254,432,21,453,724,62.57%,24.59%,1
臺東縣,臺東市,0013,148,209,357,25,382,632,60.44%,23.42%,1
臺東縣,臺東市,0014,175,267,442,21,463,771,60.05%,22.7%,1
臺東縣,臺東市,0015,206,204,410,13,423,798,53.01%,25.81%,1
臺東縣,臺東市,0016,280,381,661,60,721,1299,55.5%,21.56%,1
臺東縣,臺東市,0017,208,265,473,19,492,811,60.67%,25.65%,1
臺東縣,臺東市,0018,199,277,476,18,494,764,64.66%,26.05%,1
臺東縣,臺東市,0019,187,233,420,10,430,784,54.85%,23.85%,1
臺東縣,臺東市,0020,96,118,214,9,223,427,52.22%,22.48%,1
臺東縣,臺東市,0021,222,413,635,30,665,1292,51.47%,17.18%,1
臺東縣,臺東市,0022,299,550,849,23,872,1501,58.09%,19.92%,1
臺東縣,臺東市,0023,121,173,294,11,305,601,50.75%,20.13%,1
臺東縣,臺東市,0024,87,122,209,10,219,417,52.52%,20.86%,1
臺東縣,臺東市,0025,206,322,528,39,567,1001,56.64%,20.58%,1
臺東縣,臺東市,0026,289,619,908,45,953,1638,58.18%,17.64%,1
臺東縣,臺東市,0027,266,564,830,43,873,1576,55.39%,16.88%,1
臺東縣,臺東市,0028,295,568,863,53,916,1595,57.43%,18.5%,1
臺東縣,臺東市,0029,303,626,929,40,969,1734,55.88%,17.47%,1
臺東縣,臺東市,0030,284,534,818,38,856,1476,57.99%,19.24%,1
臺東縣,臺東市,0031,327,579,906,32,938,1545,60.71%,21.17%,1
臺東縣,臺東市,0032,239,489,728,41,769,1313,58.57%,18.2%,1
臺東縣,臺東市,0033,262,529,791,32,823,1338,61.51%,19.58%,1
臺東縣,臺東市,0034,237,467,704,28,732,1312,55.79%,18.06%,1
臺東縣,臺東市,0035,247,461,708,31,739,1265,58.42%,19.53%,1
臺東縣,臺東市,0036,260,366,626,58,684,1407,48.61%,18.48%,1
臺東縣,臺東市,0037,232,483,715,46,761,1552,49.03%,14.95%,1
臺東縣,臺東市,0038,263,486,749,65,814,1445,56.33%,18.2%,1
臺東縣,臺東市,0039,461,696,1157,60,1217,2098,58.01%,21.97%,1
臺東縣,臺東市,0040,254,493,747,48,795,1324,60.05%,19.18%,1
臺東縣,臺東市,0041,278,544,822,43,865,1598,54.13%,17.4%,1
臺東縣,臺東市,0042,238,552,790,23,813,1513,53.73%,15.73%,1
臺東縣,臺東市,0043,269,557,826,31,857,1679,51.04%,16.02%,1
臺東縣,臺東市,0044,291,421,712,42,754,1414,53.32%,20.58%,1
臺東縣,臺東市,0045,286,615,901,43,944,1798,52.5%,15.91%,1
臺東縣,臺東市,0046,268,497,765,59,824,1749,47.11%,15.32%,1
臺東縣,臺東市,0047,298,565,863,66,929,1709,54.36%,17.44%,1
臺東縣,臺東市,0048,291,527,818,44,862,1629,52.92%,17.86%,1
臺東縣,臺東市,0049,217,343,560,37,597,1116,53.49%,19.44%,1
臺東縣,臺東市,0050,259,311,570,30,600,1259,47.66%,20.57%,1
臺東縣,臺東市,0051,230,314,544,27,571,1232,46.35%,18.67%,1
臺東縣,臺東市,0052,250,447,697,82,779,1505,51.76%,16.61%,1
臺東縣,臺東市,0053,144,223,367,37,404,836,48.33%,17.22%,1
臺東縣,臺東市,0054,256,457,713,27,740,1294,57.19%,19.78%,1
臺東縣,臺東市,0055,230,437,667,57,724,1350,53.63%,17.04%,1
臺東縣,臺東市,0056,377,744,1121,79,1200,2162,55.5%,17.44%,1
臺東縣,臺東市,0057,352,584,936,31,967,1627,59.43%,21.63%,1
臺東縣,臺東市,0058,261,392,653,24,677,1140,59.39%,22.89%,1
臺東縣,臺東市,0059,243,457,700,28,728,1359,53.57%,17.88%,1
臺東縣,臺東市,0060,256,433,689,50,739,1329,55.61%,19.26%,1
臺東縣,臺東市,0061,214,277,491,26,517,990,52.22%,21.62%,1
臺東縣,臺東市,0062,245,327,572,24,596,1038,57.42%,23.6%,1
臺東縣,臺東市,0063,315,475,790,55,845,1597,52.91%,19.72%,1
臺東縣,臺東市,0064,285,393,678,66,744,1385,53.72%,20.58%,1
臺東縣,臺東市,0065,181,249,430,17,447,939,47.6%,19.28%,1
臺東縣,臺東市,0066,227,320,547,43,590,1258,46.9%,18.04%,1
臺東縣,臺東市,0067,261,390,651,9,660,1350,48.89%,19.33%,1
臺東縣,臺東市,0068,150,326,476,11,487,1058,46.03%,14.18%,1
臺東縣,臺東市,0069,125,234,359,29,388,895,43.35%,13.97%,1
臺東縣,成功鎮,0070,63,149,212,56,268,516,51.94%,12.21%,1
臺東縣,成功鎮,0071,184,344,528,59,587,960,61.15%,19.17%,1
臺東縣,成功鎮,0072,42,81,123,11,134,365,36.71%,11.51%,1
臺東縣,成功鎮,0073,118,176,294,51,345,747,46.18%,15.8%,1
臺東縣,成功鎮,0074,55,89,144,16,160,339,47.2%,16.22%,1
臺東縣,成功鎮,0075,173,297,470,12,482,995,48.44%,17.39%,1
臺東縣,成功鎮,0076,203,255,458,26,484,863,56.08%,23.52%,1
臺東縣,成功鎮,0077,172,308,480,30,510,931,54.78%,18.47%,1
臺東縣,成功鎮,0078,146,329,475,24,499,970,51.44%,15.05%,1
臺東縣,成功鎮,0079,200,429,629,60,689,1365,50.48%,14.65%,1
臺東縣,成功鎮,0080,190,482,672,53,725,1366,53.07%,13.91%,1
臺東縣,成功鎮,0081,77,147,224,39,263,516,50.97%,14.92%,1
臺東縣,成功鎮,0082,134,213,347,56,403,887,45.43%,15.11%,1
臺東縣,成功鎮,0083,68,107,175,45,220,488,45.08%,13.93%,1
臺東縣,成功鎮,0084,75,88,163,32,195,481,40.54%,15.59%,1
臺東縣,成功鎮,0085,21,64,85,3,88,373,23.59%,5.63%,1
臺東縣,成功鎮,0086,37,79,116,28,144,264,54.55%,14.02%,1
臺東縣,關山鎮,0087,181,338,519,23,542,909,59.63%,19.91%,1
臺東縣,關山鎮,0088,144,190,334,11,345,790,43.67%,18.23%,1
臺東縣,關山鎮,0089,173,303,476,25,501,828,60.51%,20.89%,1
臺東縣,關山鎮,0090,149,217,366,23,389,887,43.86%,16.8%,1
臺東縣,關山鎮,0091,205,394,599,28,627,1137,55.15%,18.03%,1
臺東縣,關山鎮,0092,143,189,332,22,354,732,48.36%,19.54%,1
臺東縣,關山鎮,0093,146,292,438,37,475,912,52.08%,16.01%,1
臺東縣,關山鎮,0094,128,179,307,11,318,779,40.82%,16.43%,1
臺東縣,關山鎮,0095,68,128,196,11,207,535,38.69%,12.71%,1
臺東縣,卑南鄉,0096,310,269,579,30,609,1041,58.5%,29.78%,1
臺東縣,卑南鄉,0097,205,356,561,15,576,1165,49.44%,17.6%,1
臺東縣,卑南鄉,0098,50,37,87,15,102,219,46.58%,22.83%,1
臺東縣,卑南鄉,0099,98,108,206,20,226,460,49.13%,21.3%,1
臺東縣,卑南鄉,0100,55,86,141,14,155,387,40.05%,14.21%,1
臺東縣,卑南鄉,0101,135,189,324,25,349,767,45.5%,17.6%,1
臺東縣,卑南鄉,0102,117,134,251,26,277,503,55.07%,23.26%,1
臺東縣,卑南鄉,0103,155,168,323,37,360,727,49.52%,21.32%,1
臺東縣,卑南鄉,0104,88,118,206,25,231,436,52.98%,20.18%,1
臺東縣,卑南鄉,0105,55,33,88,8,96,261,36.78%,21.07%,1
臺東縣,卑南鄉,0106,62,47,109,12,121,215,56.28%,28.84%,1
臺東縣,卑南鄉,0107,301,449,750,53,803,1442,55.69%,20.87%,1
臺東縣,卑南鄉,0108,81,172,253,11,264,527,50.09%,15.37%,1
臺東縣,卑南鄉,0109,186,355,541,42,583,1046,55.74%,17.78%,1
臺東縣,卑南鄉,0110,232,321,553,49,602,1110,54.23%,20.9%,1
臺東縣,卑南鄉,0111,230,367,597,35,632,1105,57.19%,20.81%,1
臺東縣,卑南鄉,0112,182,425,607,122,729,1167,62.47%,15.6%,1
臺東縣,卑南鄉,0113,236,222,458,23,481,968,49.69%,24.38%,1
臺東縣,卑南鄉,0114,39,27,66,2,68,159,42.77%,24.53%,1
臺東縣,卑南鄉,0115,67,136,203,17,220,488,45.08%,13.73%,1
臺東縣,卑南鄉,0116,99,90,189,14,203,347,58.5%,28.53%,1
臺東縣,卑南鄉,0117,81,143,224,15,239,436,54.82%,18.58%,1
臺東縣,鹿野鄉,0118,62,124,186,8,194,522,37.16%,11.88%,1
臺東縣,鹿野鄉,0119,125,172,297,13,310,574,54.01%,21.78%,1
臺東縣,鹿野鄉,0120,186,220,406,20,426,1055,40.38%,17.63%,1
臺東縣,鹿野鄉,0121,225,259,484,33,517,1104,46.83%,20.38%,1
臺東縣,鹿野鄉,0122,48,98,146,9,155,342,45.32%,14.04%,1
臺東縣,鹿野鄉,0123,161,235,396,31,427,895,47.71%,17.99%,1
臺東縣,鹿野鄉,0124,165,222,387,43,430,864,49.77%,19.1%,1
臺東縣,鹿野鄉,0125,125,129,254,34,288,675,42.67%,18.52%,1
臺東縣,鹿野鄉,0126,109,101,210,9,219,435,50.34%,25.06%,1
臺東縣,鹿野鄉,0127,107,83,190,6,196,470,41.7%,22.77%,1
臺東縣,池上鄉,0128,174,288,462,27,489,992,49.29%,17.54%,1
臺東縣,池上鄉,0129,214,284,498,22,520,929,55.97%,23.04%,1
臺東縣,池上鄉,0130,90,103,193,18,211,434,48.62%,20.74%,1
臺東縣,池上鄉,0131,108,178,286,21,307,703,43.67%,15.36%,1
臺東縣,池上鄉,0132,122,161,283,12,295,654,45.11%,18.65%,1
臺東縣,池上鄉,0133,44,69,113,17,130,324,40.12%,13.58%,1
臺東縣,池上鄉,0134,123,210,333,34,367,794,46.22%,15.49%,1
臺東縣,池上鄉,0135,166,225,391,25,416,856,48.6%,19.39%,1
臺東縣,池上鄉,0136,61,80,141,8,149,344,43.31%,17.73%,1
臺東縣,池上鄉,0137,75,92,167,14,181,311,58.2%,24.12%,1
臺東縣,池上鄉,0138,54,76,130,8,138,386,35.75%,13.99%,1
臺東縣,池上鄉,0139,62,75,137,15,152,435,34.94%,14.25%,1
臺東縣,東河鄉,0140,66,53,119,6,125,290,43.1%,22.76%,1
臺東縣,東河鄉,0141,156,172,328,28,356,620,57.42%,25.16%,1
臺東縣,東河鄉,0142,284,393,677,64,741,1196,61.96%,23.75%,1
臺東縣,東河鄉,0143,148,225,373,62,435,918,47.39%,16.12%,1
臺東縣,東河鄉,0144,73,146,219,38,257,555,46.31%,13.15%,1
臺東縣,東河鄉,0145,132,264,396,27,423,977,43.3%,13.51%,1
臺東縣,東河鄉,0146,127,216,343,18,361,1197,30.16%,10.61%,1
臺東縣,東河鄉,0147,66,130,196,17,213,867,24.57%,7.61%,1
臺東縣,東河鄉,0148,57,80,137,11,148,345,42.9%,16.52%,1
臺東縣,東河鄉,0149,59,94,153,20,173,408,42.4%,14.46%,1
臺東縣,東河鄉,0150,44,62,106,8,114,262,43.51%,16.79%,1
臺東縣,長濱鄉,0151,112,138,250,59,309,536,57.65%,20.9%,1
臺東縣,長濱鄉,0152,54,156,210,22,232,689,33.67%,7.84%,1
臺東縣,長濱鄉,0153,164,253,417,92,509,913,55.75%,17.96%,1
臺東縣,長濱鄉,0154,178,265,443,25,468,1268,36.91%,14.04%,1
臺東縣,長濱鄉,0155,112,178,290,50,340,725,46.9%,15.45%,1
臺東縣,長濱鄉,0156,71,72,143,6,149,532,28.01%,13.35%,1
臺東縣,長濱鄉,0157,87,137,224,55,279,660,42.27%,13.18%,1
臺東縣,長濱鄉,0158,27,80,107,5,112,336,33.33%,8.04%,1
臺東縣,長濱鄉,0159,20,32,52,12,64,195,32.82%,10.26%,1
臺東縣,長濱鄉,0160,10,3,13,0,13,25,52%,40%,1
臺東縣,長濱鄉,0161,92,144,236,32,268,605,44.3%,15.21%,1
臺東縣,太麻里鄉,0162,169,192,361,24,385,722,53.32%,23.41%,1
臺東縣,太麻里鄉,0163,96,184,280,16,296,575,51.48%,16.7%,1
臺東縣,太麻里鄉,0164,130,170,300,18,318,623,51.04%,20.87%,1
臺東縣,太麻里鄉,0165,148,129,277,33,310,622,49.84%,23.79%,1
臺東縣,太麻里鄉,0166,97,127,224,10,234,560,41.79%,17.32%,1
臺東縣,太麻里鄉,0167,153,309,462,74,536,957,56.01%,15.99%,1
臺東縣,太麻里鄉,0168,185,169,354,35,389,809,48.08%,22.87%,1
臺東縣,太麻里鄉,0169,155,237,392,24,416,673,61.81%,23.03%,1
臺東縣,太麻里鄉,0170,134,216,350,30,380,737,51.56%,18.18%,1
臺東縣,太麻里鄉,0171,88,130,218,23,241,424,56.84%,20.75%,1
臺東縣,太麻里鄉,0172,82,76,158,21,179,374,47.86%,21.93%,1
臺東縣,太麻里鄉,0173,119,173,292,26,318,829,38.36%,14.35%,1
臺東縣,太麻里鄉,0174,111,212,323,8,331,869,38.09%,12.77%,1
臺東縣,太麻里鄉,0175,23,40,63,8,71,223,31.84%,10.31%,1
臺東縣,太麻里鄉,0176,129,201,330,35,365,669,54.56%,19.28%,1
臺東縣,大武鄉,0177,100,193,293,46,339,568,59.68%,17.61%,1
臺東縣,大武鄉,0178,293,364,657,74,731,1474,49.59%,19.88%,1
臺東縣,大武鄉,0179,179,455,634,74,708,1327,53.35%,13.49%,1
臺東縣,大武鄉,0180,228,231,459,74,533,1134,47%,20.11%,1
臺東縣,大武鄉,0181,48,105,153,60,213,386,55.18%,12.44%,1
臺東縣,大武鄉,0182,67,94,161,20,181,377,48.01%,17.77%,1
臺東縣,綠島鄉,0183,203,403,606,21,627,1474,42.54%,13.77%,1
臺東縣,綠島鄉,0184,151,304,455,22,477,1082,44.09%,13.96%,1
臺東縣,綠島鄉,0185,127,236,363,18,381,813,46.86%,15.62%,1
臺東縣,綠島鄉,0186,39,62,101,1,102,210,48.57%,18.57%,1
臺東縣,海端鄉,0187,88,148,236,27,263,497,52.92%,17.71%,1
臺東縣,海端鄉,0188,85,229,314,16,330,569,58%,14.94%,1
臺東縣,海端鄉,0189,148,294,442,41,483,971,49.74%,15.24%,1
臺東縣,海端鄉,0190,114,247,361,32,393,728,53.98%,15.66%,1
臺東縣,海端鄉,0191,54,80,134,13,147,259,56.76%,20.85%,1
臺東縣,海端鄉,0192,34,86,120,15,135,254,53.15%,13.39%,1
臺東縣,延平鄉,0193,176,324,500,34,534,1014,52.66%,17.36%,1
臺東縣,延平鄉,0194,89,159,248,48,296,426,69.48%,20.89%,1
臺東縣,延平鄉,0195,57,129,186,23,209,315,66.35%,18.1%,1
臺東縣,延平鄉,0196,67,180,247,11,258,579,44.56%,11.57%,1
臺東縣,延平鄉,0197,73,185,258,18,276,596,46.31%,12.25%,1
臺東縣,金峰鄉,0198,176,390,566,41,607,1241,48.91%,14.18%,1
臺東縣,金峰鄉,0199,81,275,356,33,389,601,64.73%,13.48%,1
臺東縣,金峰鄉,0200,117,245,362,31,393,520,75.58%,22.5%,1
臺東縣,金峰鄉,0201,51,119,170,21,191,336,56.85%,15.18%,1
臺東縣,金峰鄉,0202,48,96,144,30,174,330,52.73%,14.55%,1
臺東縣,達仁鄉,0203,50,83,133,21,154,246,62.6%,20.33%,1
臺東縣,達仁鄉,0204,43,155,198,20,218,340,64.12%,12.65%,1
臺東縣,達仁鄉,0205,59,126,185,10,195,296,65.88%,19.93%,1
臺東縣,達仁鄉,0206,76,172,248,27,275,429,64.1%,17.72%,1
臺東縣,達仁鄉,0207,68,123,191,23,214,331,64.65%,20.54%,1
臺東縣,達仁鄉,0208,78,183,261,21,282,628,44.9%,12.42%,1
臺東縣,達仁鄉,0209,138,291,429,41,470,867,54.21%,15.92%,1
臺東縣,蘭嶼鄉,0210,149,214,363,24,387,943,41.04%,15.8%,1
臺東縣,蘭嶼鄉,0211,200,295,495,36,531,1238,42.89%,16.16%,1
臺東縣,蘭嶼鄉,0212,143,251,394,14,408,1240,32.9%,11.53%,1
臺東縣,蘭嶼鄉,0213,153,99,252,27,279,760,36.71%,20.13%,1
澎湖縣,馬公市,0001,77,140,217,10,227,481,47.19%,16.01%,1
澎湖縣,馬公市,0002,113,172,285,7,292,558,52.33%,20.25%,1
澎湖縣,馬公市,0003,109,133,242,21,263,533,49.34%,20.45%,1
澎湖縣,馬公市,0004,210,250,460,25,485,922,52.6%,22.78%,1
澎湖縣,馬公市,0005,257,277,534,22,556,1021,54.46%,25.17%,1
澎湖縣,馬公市,0006,151,235,386,22,408,793,51.45%,19.04%,1
澎湖縣,馬公市,0007,217,272,489,25,514,954,53.88%,22.75%,1
澎湖縣,馬公市,0008,216,288,504,14,518,1001,51.75%,21.58%,1
澎湖縣,馬公市,0009,208,296,504,29,533,1192,44.71%,17.45%,1
澎湖縣,馬公市,0010,170,453,623,41,664,1402,47.36%,12.13%,1
澎湖縣,馬公市,0011,239,461,700,28,728,1389,52.41%,17.21%,1
澎湖縣,馬公市,0012,217,442,659,41,700,1339,52.28%,16.21%,1
澎湖縣,馬公市,0013,233,330,563,28,591,1254,47.13%,18.58%,1
澎湖縣,馬公市,0014,210,354,564,37,601,1194,50.34%,17.59%,1
澎湖縣,馬公市,0015,260,379,639,33,672,1393,48.24%,18.66%,1
澎湖縣,馬公市,0016,249,487,736,21,757,1440,52.57%,17.29%,1
澎湖縣,馬公市,0017,233,344,577,22,599,1215,49.3%,19.18%,1
澎湖縣,馬公市,0018,252,348,600,33,633,1284,49.3%,19.63%,1
澎湖縣,馬公市,0019,239,491,730,23,753,1512,49.8%,15.81%,1
澎湖縣,馬公市,0020,210,317,527,44,571,1181,48.35%,17.78%,1
澎湖縣,馬公市,0021,229,418,647,33,680,1348,50.45%,16.99%,1
澎湖縣,馬公市,0022,238,454,692,28,720,1391,51.76%,17.11%,1
澎湖縣,馬公市,0023,348,574,922,25,947,2124,44.59%,16.38%,1
澎湖縣,馬公市,0024,263,454,717,36,753,1500,50.2%,17.53%,1
澎湖縣,馬公市,0025,289,469,758,24,782,1582,49.43%,18.27%,1
澎湖縣,馬公市,0026,274,509,783,20,803,1638,49.02%,16.73%,1
澎湖縣,馬公市,0027,288,497,785,29,814,1554,52.38%,18.53%,1
澎湖縣,馬公市,0028,152,219,371,13,384,980,39.18%,15.51%,1
澎湖縣,馬公市,0029,163,268,431,19,450,892,50.45%,18.27%,1
澎湖縣,馬公市,0030,111,202,313,9,322,778,41.39%,14.27%,1
澎湖縣,馬公市,0031,190,281,471,12,483,930,51.94%,20.43%,1
澎湖縣,馬公市,0032,292,549,841,25,866,1481,58.47%,19.72%,1
澎湖縣,馬公市,0033,204,386,590,14,604,1128,53.55%,18.09%,1
澎湖縣,馬公市,0034,89,124,213,8,221,415,53.25%,21.45%,1
澎湖縣,馬公市,0035,168,364,532,29,561,1120,50.09%,15%,1
澎湖縣,馬公市,0036,200,304,504,13,517,950,54.42%,21.05%,1
澎湖縣,馬公市,0037,134,143,277,11,288,627,45.93%,21.37%,1
澎湖縣,馬公市,0038,190,335,525,18,543,1055,51.47%,18.01%,1
澎湖縣,馬公市,0039,239,268,507,17,524,989,52.98%,24.17%,1
澎湖縣,馬公市,0040,143,165,308,23,331,591,56.01%,24.2%,1
澎湖縣,馬公市,0041,280,347,627,33,660,1387,47.58%,20.19%,1
澎湖縣,馬公市,0042,249,202,451,33,484,1079,44.86%,23.08%,1
澎湖縣,馬公市,0043,170,218,388,17,405,797,50.82%,21.33%,1
澎湖縣,馬公市,0044,219,228,447,10,457,903,50.61%,24.25%,1
澎湖縣,馬公市,0045,90,80,170,10,180,376,47.87%,23.94%,1
澎湖縣,馬公市,0046,73,110,183,14,197,371,53.1%,19.68%,1
澎湖縣,馬公市,0047,177,282,459,20,479,1173,40.84%,15.09%,1
澎湖縣,馬公市,0048,259,229,488,21,509,1389,36.65%,18.65%,1
澎湖縣,馬公市,0049,90,87,177,37,214,761,28.12%,11.83%,1
澎湖縣,馬公市,0050,63,99,162,14,176,288,61.11%,21.88%,1
澎湖縣,湖西鄉,0051,220,344,564,35,599,1120,53.48%,19.64%,1
澎湖縣,湖西鄉,0052,56,83,139,5,144,332,43.37%,16.87%,1
澎湖縣,湖西鄉,0053,46,54,100,4,104,242,42.98%,19.01%,1
澎湖縣,湖西鄉,0054,59,51,110,3,113,293,38.57%,20.14%,1
澎湖縣,湖西鄉,0055,122,135,257,20,277,666,41.59%,18.32%,1
澎湖縣,湖西鄉,0056,60,91,151,11,162,326,49.69%,18.4%,1
澎湖縣,湖西鄉,0057,155,153,308,13,321,732,43.85%,21.17%,1
澎湖縣,湖西鄉,0058,111,183,294,10,304,651,46.7%,17.05%,1
澎湖縣,湖西鄉,0059,130,198,328,15,343,744,46.1%,17.47%,1
澎湖縣,湖西鄉,0060,34,37,71,3,74,134,55.22%,25.37%,1
澎湖縣,湖西鄉,0061,180,135,315,13,328,794,41.31%,22.67%,1
澎湖縣,湖西鄉,0062,35,42,77,2,79,216,36.57%,16.2%,1
澎湖縣,湖西鄉,0063,62,127,189,11,200,664,30.12%,9.34%,1
澎湖縣,湖西鄉,0064,58,73,131,3,134,279,48.03%,20.79%,1
澎湖縣,湖西鄉,0065,53,96,149,1,150,296,50.68%,17.91%,1
澎湖縣,湖西鄉,0066,39,79,118,4,122,257,47.47%,15.18%,1
澎湖縣,湖西鄉,0067,8,18,26,1,27,89,30.34%,8.99%,1
澎湖縣,湖西鄉,0068,178,200,378,18,396,815,48.59%,21.84%,1
澎湖縣,湖西鄉,0069,169,225,394,14,408,975,41.85%,17.33%,1
澎湖縣,湖西鄉,0070,165,136,301,20,321,648,49.54%,25.46%,1
澎湖縣,湖西鄉,0071,192,190,382,21,403,893,45.13%,21.5%,1
澎湖縣,湖西鄉,0072,179,228,407,31,438,846,51.77%,21.16%,1
澎湖縣,湖西鄉,0073,134,139,273,11,284,729,38.96%,18.38%,1
澎湖縣,白沙鄉,0074,109,138,247,12,259,514,50.39%,21.21%,1
澎湖縣,白沙鄉,0075,144,189,333,11,344,657,52.36%,21.92%,1
澎湖縣,白沙鄉,0076,32,35,67,5,72,109,66.06%,29.36%,1
澎湖縣,白沙鄉,0077,21,43,64,3,67,156,42.95%,13.46%,1
澎湖縣,白沙鄉,0078,44,74,118,4,122,293,41.64%,15.02%,1
澎湖縣,白沙鄉,0079,26,49,75,2,77,231,33.33%,11.26%,1
澎湖縣,白沙鄉,0080,42,42,84,4,88,161,54.66%,26.09%,1
澎湖縣,白沙鄉,0081,276,473,749,36,785,1705,46.04%,16.19%,1
澎湖縣,白沙鄉,0082,56,65,121,6,127,285,44.56%,19.65%,1
澎湖縣,白沙鄉,0083,163,100,263,7,270,723,37.34%,22.54%,1
澎湖縣,白沙鄉,0084,135,142,277,15,292,774,37.73%,17.44%,1
澎湖縣,白沙鄉,0085,277,185,462,50,512,1429,35.83%,19.38%,1
澎湖縣,白沙鄉,0086,106,351,457,43,500,1084,46.13%,9.78%,1
澎湖縣,白沙鄉,0087,49,71,120,7,127,251,50.6%,19.52%,1
澎湖縣,白沙鄉,0088,46,40,86,6,92,253,36.36%,18.18%,1
澎湖縣,西嶼鄉,0089,25,25,50,0,50,283,17.67%,8.83%,1
澎湖縣,西嶼鄉,0090,64,52,116,8,124,424,29.25%,15.09%,1
澎湖縣,西嶼鄉,0091,151,114,265,26,291,826,35.23%,18.28%,1
澎湖縣,西嶼鄉,0092,39,65,104,8,112,282,39.72%,13.83%,1
澎湖縣,西嶼鄉,0093,129,117,246,33,279,661,42.21%,19.52%,1
澎湖縣,西嶼鄉,0094,31,7,38,1,39,141,27.66%,21.99%,1
澎湖縣,西嶼鄉,0095,89,100,189,9,198,635,31.18%,14.02%,1
澎湖縣,西嶼鄉,0096,33,41,74,2,76,216,35.19%,15.28%,1
澎湖縣,西嶼鄉,0097,89,52,141,15,156,572,27.27%,15.56%,1
澎湖縣,西嶼鄉,0098,260,232,492,50,542,1267,42.78%,20.52%,1
澎湖縣,西嶼鄉,0099,121,185,306,17,323,942,34.29%,12.85%,1
澎湖縣,西嶼鄉,0100,175,242,417,44,461,1133,40.69%,15.45%,1
澎湖縣,望安鄉,0101,132,179,311,23,334,734,45.5%,17.98%,1
澎湖縣,望安鄉,0102,65,118,183,7,190,454,41.85%,14.32%,1
澎湖縣,望安鄉,0103,42,56,98,7,105,300,35%,14%,1
澎湖縣,望安鄉,0104,117,102,219,21,240,471,50.96%,24.84%,1
澎湖縣,望安鄉,0105,100,123,223,13,236,672,35.12%,14.88%,1
澎湖縣,望安鄉,0106,147,131,278,23,301,742,40.57%,19.81%,1
澎湖縣,望安鄉,0107,73,35,108,4,112,264,42.42%,27.65%,1
澎湖縣,望安鄉,0108,85,117,202,4,206,476,43.28%,17.86%,1
澎湖縣,望安鄉,0109,34,26,60,5,65,208,31.25%,16.35%,1
澎湖縣,望安鄉,0110,43,47,90,4,94,307,30.62%,14.01%,1
澎湖縣,七美鄉,0111,45,20,65,3,68,248,27.42%,18.15%,1
澎湖縣,七美鄉,0112,93,99,192,12,204,581,35.11%,16.01%,1
澎湖縣,七美鄉,0113,89,112,201,27,228,641,35.57%,13.88%,1
澎湖縣,七美鄉,0114,56,62,118,4,122,382,31.94%,14.66%,1
澎湖縣,七美鄉,0115,30,57,87,5,92,351,26.21%,8.55%,1
澎湖縣,七美鄉,0116,124,172,296,20,316,1171,26.99%,10.59%,1
金門縣,金城鎮,0001,115,354,469,31,500,1396,35.82%,8.24%,1
金門縣,金城鎮,0002,156,513,669,26,695,1831,37.96%,8.52%,1
金門縣,金城鎮,0003,136,467,603,39,642,1750,36.69%,7.77%,1
金門縣,金城鎮,0004,155,528,683,34,717,1889,37.96%,8.21%,1
金門縣,金城鎮,0005,133,374,507,30,537,1675,32.06%,7.94%,1
金門縣,金城鎮,0006,133,609,742,39,781,1901,41.08%,7%,1
金門縣,金城鎮,0007,144,366,510,47,557,1610,34.6%,8.94%,1
金門縣,金城鎮,0008,129,441,570,31,601,1687,35.63%,7.65%,1
金門縣,金城鎮,0009,115,447,562,18,580,1594,36.39%,7.21%,1
金門縣,金城鎮,0010,120,466,586,23,609,1726,35.28%,6.95%,1
金門縣,金城鎮,0011,138,471,609,23,632,1733,36.47%,7.96%,1
金門縣,金城鎮,0012,121,482,603,28,631,1532,41.19%,7.9%,1
金門縣,金城鎮,0013,154,528,682,37,719,2079,34.58%,7.41%,1
金門縣,金城鎮,0014,145,478,623,29,652,2033,32.07%,7.13%,1
金門縣,金城鎮,0015,223,619,842,40,882,2517,35.04%,8.86%,1
金門縣,金城鎮,0016,157,535,692,38,730,2083,35.05%,7.54%,1
金門縣,金城鎮,0017,155,534,689,44,733,2140,34.25%,7.24%,1
金門縣,金城鎮,0018,169,526,695,25,720,2435,29.57%,6.94%,1
金門縣,金城鎮,0019,72,251,323,23,346,1353,25.57%,5.32%,1
金門縣,金城鎮,0020,102,383,485,14,499,1574,31.7%,6.48%,1
金門縣,金城鎮,0021,108,347,455,23,478,1277,37.43%,8.46%,1
金門縣,金沙鎮,0066,134,487,621,40,661,1909,34.63%,7.02%,1
金門縣,金沙鎮,0067,132,464,596,28,624,1524,40.94%,8.66%,1
金門縣,金沙鎮,0068,128,385,513,33,546,1673,32.64%,7.65%,1
金門縣,金沙鎮,0069,128,507,635,25,660,2003,32.95%,6.39%,1
金門縣,金沙鎮,0070,108,357,465,29,494,1212,40.76%,8.91%,1
金門縣,金沙鎮,0071,88,297,385,24,409,1126,36.32%,7.82%,1
金門縣,金沙鎮,0072,82,373,455,24,479,1540,31.1%,5.32%,1
金門縣,金沙鎮,0073,81,283,364,14,378,1216,31.09%,6.66%,1
金門縣,金沙鎮,0074,39,209,248,12,260,950,27.37%,4.11%,1
金門縣,金沙鎮,0075,111,552,663,38,701,1895,36.99%,5.86%,1
金門縣,金沙鎮,0076,121,313,434,30,464,1135,40.88%,10.66%,1
金門縣,金沙鎮,0077,86,322,408,27,435,1252,34.74%,6.87%,1
金門縣,金沙鎮,0078,98,340,438,24,462,1125,41.07%,8.71%,1
金門縣,金湖鎮,0049,39,359,398,142,540,1348,40.06%,2.89%,1
金門縣,金湖鎮,0050,106,361,467,19,486,1386,35.06%,7.65%,1
金門縣,金湖鎮,0051,136,437,573,32,605,1403,43.12%,9.69%,1
金門縣,金湖鎮,0052,170,473,643,29,672,1771,37.94%,9.6%,1
金門縣,金湖鎮,0053,139,383,522,39,561,1493,37.58%,9.31%,1
金門縣,金湖鎮,0054,105,405,510,28,538,1510,35.63%,6.95%,1
金門縣,金湖鎮,0055,127,471,598,26,624,1607,38.83%,7.9%,1
金門縣,金湖鎮,0056,129,511,640,32,672,2006,33.5%,6.43%,1
金門縣,金湖鎮,0057,190,423,613,30,643,1780,36.12%,10.67%,1
金門縣,金湖鎮,0058,134,476,610,25,635,1739,36.52%,7.71%,1
金門縣,金湖鎮,0059,125,327,452,27,479,1384,34.61%,9.03%,1
金門縣,金湖鎮,0060,126,372,498,29,527,1400,37.64%,9%,1
金門縣,金湖鎮,0061,159,414,573,14,587,1325,44.3%,12%,1
金門縣,金湖鎮,0062,109,282,391,21,412,1236,33.33%,8.82%,1
金門縣,金湖鎮,0063,102,344,446,34,480,1382,34.73%,7.38%,1
金門縣,金湖鎮,0064,90,455,545,15,560,1631,34.33%,5.52%,1
金門縣,金湖鎮,0065,103,358,461,33,494,1514,32.63%,6.8%,1
金門縣,金寧鄉,0022,118,368,486,55,541,1735,31.18%,6.8%,1
金門縣,金寧鄉,0023,110,339,449,36,485,1537,31.55%,7.16%,1
金門縣,金寧鄉,0024,149,404,553,43,596,1766,33.75%,8.44%,1
金門縣,金寧鄉,0025,105,252,357,18,375,1015,36.95%,10.34%,1
金門縣,金寧鄉,0026,104,463,567,38,605,1726,35.05%,6.03%,1
金門縣,金寧鄉,0027,107,396,503,34,537,1691,31.76%,6.33%,1
金門縣,金寧鄉,0028,308,537,845,21,866,2044,42.37%,15.07%,1
金門縣,金寧鄉,0029,180,560,740,24,764,1848,41.34%,9.74%,1
金門縣,金寧鄉,0030,128,466,594,18,612,1735,35.27%,7.38%,1
金門縣,金寧鄉,0031,163,436,599,28,627,1795,34.93%,9.08%,1
金門縣,金寧鄉,0032,102,445,547,35,582,1834,31.73%,5.56%,1
金門縣,金寧鄉,0033,100,389,489,23,512,1528,33.51%,6.54%,1
金門縣,金寧鄉,0034,118,426,544,24,568,1473,38.56%,8.01%,1
金門縣,金寧鄉,0035,134,439,573,26,599,1679,35.68%,7.98%,1
金門縣,金寧鄉,0036,352,556,908,25,933,1921,48.57%,18.32%,1
金門縣,金寧鄉,0037,119,335,454,13,467,1298,35.98%,9.17%,1
金門縣,金寧鄉,0038,109,374,483,22,505,1537,32.86%,7.09%,1
金門縣,烈嶼鄉,0039,103,583,686,36,722,1647,43.84%,6.25%,1
金門縣,烈嶼鄉,0040,117,464,581,36,617,1733,35.6%,6.75%,1
金門縣,烈嶼鄉,0041,113,464,577,28,605,1635,37%,6.91%,1
金門縣,烈嶼鄉,0042,90,327,417,23,440,1296,33.95%,6.94%,1
金門縣,烈嶼鄉,0043,64,272,336,20,356,1099,32.39%,5.82%,1
金門縣,烈嶼鄉,0044,101,351,452,28,480,1425,33.68%,7.09%,1
金門縣,烈嶼鄉,0045,119,386,505,20,525,1412,37.18%,8.43%,1
金門縣,烈嶼鄉,0046,83,408,491,16,507,1429,35.48%,5.81%,1
金門縣,烏坵鄉,0047,27,50,77,2,79,275,28.73%,9.82%,1
金門縣,烏坵鄉,0048,16,65,81,6,87,292,29.79%,5.48%,1
連江縣,南竿鄉,0001,192,792,984,30,1014,1967,51.55%,9.76%,1
連江縣,南竿鄉,0002,176,667,843,39,882,1837,48.01%,9.58%,1
連江縣,南竿鄉,0003,171,401,572,17,589,1114,52.87%,15.35%,1
連江縣,南竿鄉,0004,119,664,783,20,803,1543,52.04%,7.71%,1
連江縣,北竿鄉,0005,162,626,788,26,814,1515,53.73%,10.69%,1
連江縣,北竿鄉,0006,53,227,280,12,292,610,47.87%,8.69%,1
連江縣,莒光鄉,0007,77,254,331,10,341,698,48.85%,11.03%,1
連江縣,莒光鄉,0008,104,328,432,15,447,783,57.09%,13.28%,1
連江縣,東引鄉,0009,122,431,553,21,574,1138,50.44%,10.72%,1
基隆市,中正區,0001,151,105,256,11,267,466,57.3%,32.4%,1
基隆市,中正區,0002,305,248,553,20,573,1262,45.4%,24.17%,1
基隆市,中正區,0003,217,293,510,55,565,1171,48.25%,18.53%,1
基隆市,中正區,0004,445,608,1053,22,1075,2823,38.08%,15.76%,1
基隆市,中正區,0005,419,256,675,27,702,1474,47.63%,28.43%,1
基隆市,中正區,0006,250,278,528,36,564,1271,44.37%,19.67%,1
基隆市,中正區,0007,457,651,1108,65,1173,2707,43.33%,16.88%,1
基隆市,中正區,0008,271,457,728,24,752,1545,48.67%,17.54%,1
基隆市,中正區,0009,102,187,289,17,306,761,40.21%,13.4%,1
基隆市,中正區,0010,284,359,643,21,664,1352,49.11%,21.01%,1
基隆市,中正區,0011,246,412,658,13,671,1413,47.49%,17.41%,1
基隆市,中正區,0012,405,728,1133,40,1173,2665,44.02%,15.2%,1
基隆市,中正區,0013,261,298,559,34,593,1261,47.03%,20.7%,1
基隆市,中正區,0014,388,436,824,56,880,1753,50.2%,22.13%,1
基隆市,中正區,0015,169,233,402,41,443,984,45.02%,17.17%,1
基隆市,中正區,0016,216,300,516,26,542,1166,46.48%,18.52%,1
基隆市,中正區,0017,194,261,455,24,479,973,49.23%,19.94%,1
基隆市,中正區,0018,273,354,627,25,652,1694,38.49%,16.12%,1
基隆市,中正區,0019,279,332,611,31,642,1270,50.55%,21.97%,1
基隆市,中正區,0020,213,354,567,13,580,1090,53.21%,19.54%,1
基隆市,中正區,0021,182,270,452,13,465,870,53.45%,20.92%,1
基隆市,中正區,0022,222,322,544,31,575,1138,50.53%,19.51%,1
基隆市,中正區,0023,139,246,385,45,430,862,49.88%,16.13%,1
基隆市,中正區,0024,292,385,677,46,723,1341,53.91%,21.77%,1
基隆市,中正區,0025,154,275,429,31,460,859,53.55%,17.93%,1
基隆市,中正區,0026,226,425,651,25,676,1457,46.4%,15.51%,1
基隆市,中正區,0027,249,366,615,40,655,1594,41.09%,15.62%,1
基隆市,中正區,0028,186,218,404,28,432,802,53.87%,23.19%,1
基隆市,中正區,0029,239,362,601,22,623,1267,49.17%,18.86%,1
基隆市,中正區,0030,289,294,583,53,636,1175,54.13%,24.6%,1
基隆市,中正區,0031,280,369,649,32,681,1210,56.28%,23.14%,1
基隆市,中正區,0032,225,278,503,45,548,1037,52.84%,21.7%,1
基隆市,中正區,0033,261,345,606,31,637,1219,52.26%,21.41%,1
基隆市,中正區,0034,211,230,441,24,465,904,51.44%,23.34%,1
基隆市,中正區,0035,203,220,423,22,445,709,62.76%,28.63%,1
基隆市,七堵區,0219,320,349,669,49,718,1258,57.07%,25.44%,1
基隆市,七堵區,0220,272,379,651,39,690,1237,55.78%,21.99%,1
基隆市,七堵區,0221,261,373,634,19,653,1259,51.87%,20.73%,1
基隆市,七堵區,0222,273,279,552,27,579,1120,51.7%,24.38%,1
基隆市,七堵區,0223,273,338,611,33,644,1344,47.92%,20.31%,1
基隆市,七堵區,0224,264,330,594,30,624,1011,61.72%,26.11%,1
基隆市,七堵區,0225,211,261,472,14,486,925,52.54%,22.81%,1
基隆市,七堵區,0226,356,577,933,53,986,1735,56.83%,20.52%,1
基隆市,七堵區,0227,439,566,1005,38,1043,1833,56.9%,23.95%,1
基隆市,七堵區,0228,249,252,501,20,521,938,55.54%,26.55%,1
基隆市,七堵區,0229,222,306,528,47,575,962,59.77%,23.08%,1
基隆市,七堵區,0230,269,381,650,23,673,1191,56.51%,22.59%,1
基隆市,七堵區,0231,208,317,525,48,573,999,57.36%,20.82%,1
基隆市,七堵區,0232,59,76,135,5,140,282,49.65%,20.92%,1
基隆市,七堵區,0233,273,338,611,33,644,1243,51.81%,21.96%,1
基隆市,七堵區,0234,254,292,546,35,581,1092,53.21%,23.26%,1
基隆市,七堵區,0235,293,345,638,36,674,1246,54.09%,23.52%,1
基隆市,七堵區,0236,362,481,843,32,875,1722,50.81%,21.02%,1
基隆市,七堵區,0237,299,382,681,29,710,1318,53.87%,22.69%,1
基隆市,七堵區,0238,213,257,470,17,487,975,49.95%,21.85%,1
基隆市,七堵區,0239,306,347,653,24,677,1285,52.68%,23.81%,1
基隆市,七堵區,0240,259,231,490,37,527,1077,48.93%,24.05%,1
基隆市,七堵區,0241,222,235,457,25,482,989,48.74%,22.45%,1
基隆市,七堵區,0242,264,304,568,39,607,1193,50.88%,22.13%,1
基隆市,七堵區,0243,315,318,633,35,668,1273,52.47%,24.74%,1
基隆市,七堵區,0244,411,511,922,56,978,1774,55.13%,23.17%,1
基隆市,七堵區,0245,313,452,765,45,810,1689,47.96%,18.53%,1
基隆市,七堵區,0246,309,340,649,49,698,1355,51.51%,22.8%,1
基隆市,七堵區,0247,355,369,724,47,771,1512,50.99%,23.48%,1
基隆市,七堵區,0248,329,375,704,25,729,1486,49.06%,22.14%,1
基隆市,七堵區,0249,365,478,843,23,866,1706,50.76%,21.4%,1
基隆市,七堵區,0250,323,403,726,33,759,1384,54.84%,23.34%,1
基隆市,七堵區,0251,289,293,582,43,625,1045,59.81%,27.66%,1
基隆市,七堵區,0252,333,369,702,32,734,1374,53.42%,24.24%,1
基隆市,七堵區,0253,120,114,234,11,245,428,57.24%,28.04%,1
基隆市,七堵區,0254,90,93,183,16,199,326,61.04%,27.61%,1
基隆市,七堵區,0255,111,116,227,19,246,351,70.09%,31.62%,1
基隆市,七堵區,0256,354,535,889,26,915,1871,48.9%,18.92%,1
基隆市,七堵區,0257,119,103,222,6,228,448,50.89%,26.56%,1
基隆市,暖暖區,0191,290,393,683,28,711,1431,49.69%,20.27%,1
基隆市,暖暖區,0192,92,118,210,6,216,456,47.37%,20.18%,1
基隆市,暖暖區,0193,177,177,354,15,369,637,57.93%,27.79%,1
基隆市,暖暖區,0194,199,212,411,26,437,735,59.46%,27.07%,1
基隆市,暖暖區,0195,199,298,497,30,527,1078,48.89%,18.46%,1
基隆市,暖暖區,0196,246,367,613,28,641,1238,51.78%,19.87%,1
基隆市,暖暖區,0197,281,380,661,20,681,1325,51.4%,21.21%,1
基隆市,暖暖區,0198,341,428,769,34,803,1475,54.44%,23.12%,1
基隆市,暖暖區,0199,241,297,538,30,568,1179,48.18%,20.44%,1
基隆市,暖暖區,0200,270,360,630,25,655,1110,59.01%,24.32%,1
基隆市,暖暖區,0201,270,402,672,20,692,1443,47.96%,18.71%,1
基隆市,暖暖區,0202,92,113,205,21,226,415,54.46%,22.17%,1
基隆市,暖暖區,0203,316,362,678,17,695,1378,50.44%,22.93%,1
基隆市,暖暖區,0204,456,353,809,26,835,1570,53.18%,29.04%,1
基隆市,暖暖區,0205,357,537,894,38,932,1603,58.14%,22.27%,1
基隆市,暖暖區,0206,292,400,692,42,734,1267,57.93%,23.05%,1
基隆市,暖暖區,0207,266,424,690,29,719,1359,52.91%,19.57%,1
基隆市,暖暖區,0208,144,399,543,24,567,970,58.45%,14.85%,1
基隆市,暖暖區,0209,216,316,532,8,540,1002,53.89%,21.56%,1
基隆市,暖暖區,0210,221,249,470,17,487,944,51.59%,23.41%,1
基隆市,暖暖區,0211,351,475,826,27,853,1500,56.87%,23.4%,1
基隆市,暖暖區,0212,239,328,567,29,596,1442,41.33%,16.57%,1
基隆市,暖暖區,0213,255,377,632,12,644,1165,55.28%,21.89%,1
基隆市,暖暖區,0214,306,491,797,21,818,1610,50.81%,19.01%,1
基隆市,暖暖區,0215,276,437,713,17,730,1328,54.97%,20.78%,1
基隆市,暖暖區,0216,276,330,606,21,627,1173,53.45%,23.53%,1
基隆市,暖暖區,0217,245,324,569,29,598,1019,58.68%,24.04%,1
基隆市,暖暖區,0218,304,423,727,22,749,1373,54.55%,22.14%,1
基隆市,仁愛區,0072,373,411,784,57,841,1782,47.19%,20.93%,1
基隆市,仁愛區,0073,251,309,560,35,595,1055,56.4%,23.79%,1
基隆市,仁愛區,0074,296,422,718,32,750,1558,48.14%,19%,1
基隆市,仁愛區,0075,361,517,878,29,907,1736,52.25%,20.79%,1
基隆市,仁愛區,0076,298,398,696,37,733,1243,58.97%,23.97%,1
基隆市,仁愛區,0077,238,361,599,27,626,1109,56.45%,21.46%,1
基隆市,仁愛區,0078,357,595,952,27,979,1684,58.14%,21.2%,1
基隆市,仁愛區,0079,238,246,484,24,508,919,55.28%,25.9%,1
基隆市,仁愛區,0080,232,264,496,13,509,991,51.36%,23.41%,1
基隆市,仁愛區,0081,218,258,476,11,487,876,55.59%,24.89%,1
基隆市,仁愛區,0082,276,313,589,30,619,1046,59.18%,26.39%,1
基隆市,仁愛區,0083,124,123,247,16,263,434,60.6%,28.57%,1
基隆市,仁愛區,0084,203,212,415,24,439,764,57.46%,26.57%,1
基隆市,仁愛區,0085,237,248,485,15,500,968,51.65%,24.48%,1
基隆市,仁愛區,0086,341,315,656,40,696,1326,52.49%,25.72%,1
基隆市,仁愛區,0087,262,295,557,35,592,1315,45.02%,19.92%,1
基隆市,仁愛區,0088,215,204,419,34,453,775,58.45%,27.74%,1
基隆市,仁愛區,0089,289,52,341,39,380,652,58.28%,44.33%,1
基隆市,仁愛區,0090,180,177,357,22,379,674,56.23%,26.71%,1
基隆市,仁愛區,0091,187,202,389,29,418,789,52.98%,23.7%,1
基隆市,仁愛區,0092,379,481,860,46,906,1715,52.83%,22.1%,1
基隆市,仁愛區,0093,208,228,436,29,465,849,54.77%,24.5%,1
基隆市,仁愛區,0094,225,253,478,16,494,875,56.46%,25.71%,1
基隆市,仁愛區,0095,192,216,408,31,439,851,51.59%,22.56%,1
基隆市,仁愛區,0096,180,220,400,28,428,735,58.23%,24.49%,1
基隆市,仁愛區,0097,193,291,484,68,552,1009,54.71%,19.13%,1
基隆市,仁愛區,0098,239,271,510,32,542,1082,50.09%,22.09%,1
基隆市,仁愛區,0099,291,321,612,57,669,1278,52.35%,22.77%,1
基隆市,仁愛區,0100,361,510,871,39,910,1519,59.91%,23.77%,1
基隆市,仁愛區,0101,287,279,566,35,601,1336,44.99%,21.48%,1
基隆市,仁愛區,0102,301,382,683,29,712,1178,60.44%,25.55%,1
基隆市,仁愛區,0103,194,170,364,20,384,708,54.24%,27.4%,1
基隆市,仁愛區,0104,170,167,337,21,358,567,63.14%,29.98%,1
基隆市,仁愛區,0105,233,167,400,27,427,751,56.86%,31.03%,1
基隆市,仁愛區,0106,161,179,340,17,357,589,60.61%,27.33%,1
基隆市,中山區,0107,183,224,407,14,421,796,52.89%,22.99%,1
基隆市,中山區,0108,259,354,613,29,642,1036,61.97%,25%,1
基隆市,中山區,0109,230,181,411,26,437,756,57.8%,30.42%,1
基隆市,中山區,0110,230,204,434,16,450,957,47.02%,24.03%,1
基隆市,中山區,0111,198,230,428,16,444,802,55.36%,24.69%,1
基隆市,中山區,0112,289,360,649,25,674,1263,53.37%,22.88%,1
基隆市,中山區,0113,162,270,432,18,450,778,57.84%,20.82%,1
基隆市,中山區,0114,319,267,586,77,663,1180,56.19%,27.03%,1
基隆市,中山區,0115,186,273,459,25,484,990,48.89%,18.79%,1
基隆市,中山區,0116,246,297,543,19,562,1332,42.19%,18.47%,1
基隆市,中山區,0117,166,217,383,28,411,848,48.47%,19.58%,1
基隆市,中山區,0118,227,230,457,11,468,922,50.76%,24.62%,1
基隆市,中山區,0119,102,157,259,14,273,459,59.48%,22.22%,1
基隆市,中山區,0120,120,148,268,23,291,574,50.7%,20.91%,1
基隆市,中山區,0121,202,224,426,31,457,877,52.11%,23.03%,1
基隆市,中山區,0122,312,376,688,30,718,1584,45.33%,19.7%,1
基隆市,中山區,0123,211,266,477,22,499,1319,37.83%,16%,1
基隆市,中山區,0124,427,516,943,49,992,1938,51.19%,22.03%,1
基隆市,中山區,0125,380,491,871,35,906,1877,48.27%,20.25%,1
基隆市,中山區,0126,457,648,1105,19,1124,2088,53.83%,21.89%,1
基隆市,中山區,0127,402,618,1020,24,1044,1946,53.65%,20.66%,1
基隆市,中山區,0128,304,417,721,51,772,1353,57.06%,22.47%,1
基隆市,中山區,0129,264,398,662,45,707,1317,53.68%,20.05%,1
基隆市,中山區,0130,214,263,477,21,498,870,57.24%,24.6%,1
基隆市,中山區,0131,293,415,708,19,727,1322,54.99%,22.16%,1
基隆市,中山區,0132,260,329,589,19,608,1295,46.95%,20.08%,1
基隆市,中山區,0133,195,245,440,20,460,756,60.85%,25.79%,1
基隆市,中山區,0134,302,399,701,29,730,1602,45.57%,18.85%,1
基隆市,中山區,0135,321,406,727,25,752,1568,47.96%,20.47%,1
基隆市,中山區,0136,312,392,704,36,740,1404,52.71%,22.22%,1
基隆市,中山區,0137,367,519,886,22,908,1909,47.56%,19.22%,1
基隆市,中山區,0138,329,372,701,60,761,1642,46.35%,20.04%,1
基隆市,中山區,0139,218,212,430,20,450,932,48.28%,23.39%,1
基隆市,中山區,0140,239,244,483,33,516,849,60.78%,28.15%,1
基隆市,中山區,0141,188,172,360,67,427,715,59.72%,26.29%,1
基隆市,安樂區,0142,284,340,624,49,673,1361,49.45%,20.87%,1
基隆市,安樂區,0143,243,331,574,24,598,1213,49.3%,20.03%,1
基隆市,安樂區,0144,219,247,466,14,480,1026,46.78%,21.35%,1
基隆市,安樂區,0145,251,317,568,60,628,1038,60.5%,24.18%,1
基隆市,安樂區,0146,370,108,478,50,528,897,58.86%,41.25%,1
基隆市,安樂區,0147,321,370,691,55,746,1401,53.25%,22.91%,1
基隆市,安樂區,0148,125,115,240,7,247,641,38.53%,19.5%,1
基隆市,安樂區,0149,372,356,728,30,758,1472,51.49%,25.27%,1
基隆市,安樂區,0150,115,126,241,21,262,472,55.51%,24.36%,1
基隆市,安樂區,0151,243,238,481,19,500,841,59.45%,28.89%,1
基隆市,安樂區,0152,139,140,279,24,303,571,53.06%,24.34%,1
基隆市,安樂區,0153,452,471,923,27,950,1901,49.97%,23.78%,1
基隆市,安樂區,0154,317,355,672,34,706,1349,52.34%,23.5%,1
基隆市,安樂區,0155,257,342,599,28,627,1225,51.18%,20.98%,1
基隆市,安樂區,0156,301,416,717,33,750,1351,55.51%,22.28%,1
基隆市,安樂區,0157,351,532,883,28,911,1601,56.9%,21.92%,1
基隆市,安樂區,0158,356,823,1179,38,1217,2513,48.43%,14.17%,1
基隆市,安樂區,0159,341,504,845,27,872,1613,54.06%,21.14%,1
基隆市,安樂區,0160,362,555,917,34,951,1731,54.94%,20.91%,1
基隆市,安樂區,0161,346,475,821,28,849,1424,59.62%,24.3%,1
基隆市,安樂區,0162,352,546,898,40,938,1806,51.94%,19.49%,1
基隆市,安樂區,0163,362,537,899,35,934,1679,55.63%,21.56%,1
基隆市,安樂區,0164,396,594,990,30,1020,1902,53.63%,20.82%,1
基隆市,安樂區,0165,356,636,992,30,1022,2040,50.1%,17.45%,1
基隆市,安樂區,0166,316,355,671,45,716,1313,54.53%,24.07%,1
基隆市,安樂區,0167,280,331,611,28,639,1243,51.41%,22.53%,1
基隆市,安樂區,0168,341,542,883,20,903,1759,51.34%,19.39%,1
基隆市,安樂區,0169,163,260,423,15,438,694,63.11%,23.49%,1
基隆市,安樂區,0170,220,311,531,20,551,866,63.63%,25.4%,1
基隆市,安樂區,0171,277,385,662,20,682,1557,43.8%,17.79%,1
基隆市,安樂區,0172,285,424,709,16,725,1411,51.38%,20.2%,1
基隆市,安樂區,0173,343,531,874,18,892,1568,56.89%,21.88%,1
基隆市,安樂區,0174,293,417,710,25,735,1400,52.5%,20.93%,1
基隆市,安樂區,0175,236,550,786,9,795,1531,51.93%,15.41%,1
基隆市,安樂區,0176,304,491,795,22,817,1673,48.83%,18.17%,1
基隆市,安樂區,0177,218,311,529,30,559,1054,53.04%,20.68%,1
基隆市,安樂區,0178,307,501,808,18,826,1923,42.95%,15.96%,1
基隆市,安樂區,0179,443,565,1008,43,1051,1960,53.62%,22.6%,1
基隆市,安樂區,0180,386,549,935,48,983,1962,50.1%,19.67%,1
基隆市,安樂區,0181,453,623,1076,39,1115,2117,52.67%,21.4%,1
基隆市,安樂區,0182,370,492,862,26,888,1829,48.55%,20.23%,1
基隆市,安樂區,0183,318,405,723,18,741,1529,48.46%,20.8%,1
基隆市,安樂區,0184,310,617,927,30,957,1869,51.2%,16.59%,1
基隆市,安樂區,0185,226,408,634,15,649,1140,56.93%,19.82%,1
基隆市,安樂區,0186,355,466,821,31,852,1641,51.92%,21.63%,1
基隆市,安樂區,0187,288,358,646,23,669,1279,52.31%,22.52%,1
基隆市,安樂區,0188,257,426,683,25,708,1360,52.06%,18.9%,1
基隆市,安樂區,0189,325,407,732,32,764,1399,54.61%,23.23%,1
基隆市,安樂區,0190,265,353,618,25,643,1251,51.4%,21.18%,1
基隆市,信義區,0036,251,344,595,34,629,1096,57.39%,22.9%,1
基隆市,信義區,0037,279,434,713,32,745,1232,60.47%,22.65%,1
基隆市,信義區,0038,288,362,650,11,661,1184,55.83%,24.32%,1
基隆市,信義區,0039,227,395,622,43,665,1133,58.69%,20.04%,1
基隆市,信義區,0040,246,383,629,28,657,1188,55.3%,20.71%,1
基隆市,信義區,0041,182,223,405,20,425,725,58.62%,25.1%,1
基隆市,信義區,0042,283,414,697,35,732,1524,48.03%,18.57%,1
基隆市,信義區,0043,153,240,393,25,418,736,56.79%,20.79%,1
基隆市,信義區,0044,144,173,317,14,331,611,54.17%,23.57%,1
基隆市,信義區,0045,206,236,442,14,456,951,47.95%,21.66%,1
基隆市,信義區,0046,314,512,826,30,856,1616,52.97%,19.43%,1
基隆市,信義區,0047,322,483,805,22,827,1516,54.55%,21.24%,1
基隆市,信義區,0048,220,308,528,22,550,1049,52.43%,20.97%,1
基隆市,信義區,0049,218,320,538,23,561,1069,52.48%,20.39%,1
基隆市,信義區,0050,183,215,398,23,421,727,57.91%,25.17%,1
基隆市,信義區,0051,181,351,532,22,554,929,59.63%,19.48%,1
基隆市,信義區,0052,260,399,659,31,690,1118,61.72%,23.26%,1
基隆市,信義區,0053,276,446,722,29,751,1339,56.09%,20.61%,1
基隆市,信義區,0054,172,322,494,30,524,999,52.45%,17.22%,1
基隆市,信義區,0055,183,211,394,13,407,764,53.27%,23.95%,1
基隆市,信義區,0056,279,442,721,31,752,1555,48.36%,17.94%,1
基隆市,信義區,0057,337,632,969,21,990,2015,49.13%,16.72%,1
基隆市,信義區,0058,287,401,688,32,720,1268,56.78%,22.63%,1
基隆市,信義區,0059,339,461,800,37,837,1569,53.35%,21.61%,1
基隆市,信義區,0060,341,577,918,41,959,1985,48.31%,17.18%,1
基隆市,信義區,0061,262,536,798,17,815,1476,55.22%,17.75%,1
基隆市,信義區,0062,322,495,817,26,843,1493,56.46%,21.57%,1
基隆市,信義區,0063,289,455,744,18,762,1249,61.01%,23.14%,1
基隆市,信義區,0064,333,434,767,24,791,1559,50.74%,21.36%,1
基隆市,信義區,0065,220,344,564,14,578,1168,49.49%,18.84%,1
基隆市,信義區,0066,321,487,808,25,833,1602,52%,20.04%,1
基隆市,信義區,0067,276,382,658,37,695,1485,46.8%,18.59%,1
基隆市,信義區,0068,214,312,526,15,541,1009,53.62%,21.21%,1
基隆市,信義區,0069,338,506,844,32,876,2016,43.45%,16.77%,1
基隆市,信義區,0070,291,441,732,25,757,1764,42.91%,16.5%,1
基隆市,信義區,0071,307,372,679,25,704,1295,54.36%,23.71%,1
新竹市,東區,0001,202,285,487,15,502,1512,33.2%,13.36%,1
新竹市,東區,0002,216,354,570,19,589,953,61.8%,22.67%,1
新竹市,東區,0003,145,270,415,11,426,729,58.44%,19.89%,1
新竹市,東區,0004,178,165,343,12,355,566,62.72%,31.45%,1
新竹市,東區,0005,181,179,360,17,377,640,58.91%,28.28%,1
新竹市,東區,0006,93,69,162,14,176,305,57.7%,30.49%,1
新竹市,東區,0007,156,171,327,21,348,563,61.81%,27.71%,1
新竹市,東區,0008,152,250,402,17,419,741,56.55%,20.51%,1
新竹市,東區,0009,241,346,587,19,606,1041,58.21%,23.15%,1
新竹市,東區,0010,338,531,869,18,887,1615,54.92%,20.93%,1
新竹市,東區,0011,284,433,717,31,748,1287,58.12%,22.07%,1
新竹市,東區,0012,340,535,875,25,900,1554,57.92%,21.88%,1
新竹市,東區,0013,305,493,798,23,821,1388,59.15%,21.97%,1
新竹市,東區,0014,355,468,823,28,851,1419,59.97%,25.02%,1
新竹市,東區,0015,332,394,726,31,757,1355,55.87%,24.5%,1
新竹市,東區,0016,338,478,816,23,839,1490,56.31%,22.68%,1
新竹市,東區,0017,346,546,892,23,915,1615,56.66%,21.42%,1
新竹市,東區,0018,412,530,942,31,973,1672,58.19%,24.64%,1
新竹市,東區,0019,291,309,600,25,625,1062,58.85%,27.4%,1
新竹市,東區,0020,302,425,727,26,753,1315,57.26%,22.97%,1
新竹市,東區,0021,246,339,585,18,603,1000,60.3%,24.6%,1
新竹市,東區,0022,330,426,756,40,796,1337,59.54%,24.68%,1
新竹市,東區,0023,400,521,921,28,949,1747,54.32%,22.9%,1
新竹市,東區,0024,408,525,933,27,960,1600,60%,25.5%,1
新竹市,東區,0025,270,368,638,19,657,1158,56.74%,23.32%,1
新竹市,東區,0026,228,300,528,14,542,828,65.46%,27.54%,1
新竹市,東區,0027,332,514,846,30,876,1573,55.69%,21.11%,1
新竹市,東區,0028,329,529,858,38,896,1550,57.81%,21.23%,1
新竹市,東區,0029,313,418,731,27,758,1317,57.56%,23.77%,1
新竹市,東區,0030,291,329,620,27,647,1040,62.21%,27.98%,1
新竹市,東區,0031,179,356,535,21,556,935,59.47%,19.14%,1
新竹市,東區,0032,220,367,587,25,612,1074,56.98%,20.48%,1
新竹市,東區,0033,273,388,661,43,704,1133,62.14%,24.1%,1
新竹市,東區,0034,289,449,738,22,760,1262,60.22%,22.9%,1
新竹市,東區,0035,258,412,670,22,692,1199,57.71%,21.52%,1
新竹市,東區,0036,277,458,735,31,766,1226,62.48%,22.59%,1
新竹市,東區,0037,320,528,848,37,885,1377,64.27%,23.24%,1
新竹市,東區,0038,228,395,623,15,638,991,64.38%,23.01%,1
新竹市,東區,0039,346,376,722,45,767,1271,60.35%,27.22%,1
新竹市,東區,0040,221,412,633,21,654,1012,64.62%,21.84%,1
新竹市,東區,0041,257,301,558,34,592,1001,59.14%,25.67%,1
新竹市,東區,0042,371,457,828,37,865,1603,53.96%,23.14%,1
新竹市,東區,0043,308,365,673,35,708,1236,57.28%,24.92%,1
新竹市,東區,0044,317,403,720,32,752,1532,49.09%,20.69%,1
新竹市,東區,0045,309,390,699,43,742,1306,56.81%,23.66%,1
新竹市,東區,0046,264,341,605,38,643,1073,59.93%,24.6%,1
新竹市,東區,0047,252,284,536,22,558,952,58.61%,26.47%,1
新竹市,東區,0048,284,350,634,19,653,1298,50.31%,21.88%,1
新竹市,東區,0049,135,289,424,16,440,778,56.56%,17.35%,1
新竹市,東區,0050,288,398,686,24,710,1195,59.41%,24.1%,1
新竹市,東區,0051,310,508,818,50,868,1569,55.32%,19.76%,1
新竹市,東區,0052,339,597,936,28,964,1533,62.88%,22.11%,1
新竹市,東區,0053,201,572,773,42,815,1336,61%,15.04%,1
新竹市,東區,0054,184,579,763,35,798,1367,58.38%,13.46%,1
新竹市,東區,0055,226,528,754,34,788,1289,61.13%,17.53%,1
新竹市,東區,0056,193,321,514,22,536,960,55.83%,20.1%,1
新竹市,東區,0057,180,341,521,16,537,843,63.7%,21.35%,1
新竹市,東區,0058,183,356,539,34,573,948,60.44%,19.3%,1
新竹市,東區,0059,124,368,492,28,520,915,56.83%,13.55%,1
新竹市,東區,0060,276,725,1001,45,1046,1801,58.08%,15.32%,1
新竹市,東區,0061,190,407,597,30,627,1079,58.11%,17.61%,1
新竹市,東區,0062,291,114,405,16,421,676,62.28%,43.05%,1
新竹市,東區,0063,215,418,633,42,675,1132,59.63%,18.99%,1
新竹市,東區,0064,59,89,148,5,153,251,60.96%,23.51%,1
新竹市,東區,0065,317,581,898,34,932,1620,57.53%,19.57%,1
新竹市,東區,0066,325,448,773,25,798,1479,53.96%,21.97%,1
新竹市,東區,0067,331,393,724,33,757,1402,53.99%,23.61%,1
新竹市,東區,0068,256,436,692,37,729,1280,56.95%,20%,1
新竹市,東區,0069,297,417,714,17,731,1228,59.53%,24.19%,1
新竹市,東區,0070,282,337,619,11,630,1157,54.45%,24.37%,1
新竹市,東區,0071,281,464,745,24,769,1354,56.79%,20.75%,1
新竹市,東區,0072,321,536,857,25,882,1334,66.12%,24.06%,1
新竹市,東區,0073,276,431,707,42,749,1234,60.7%,22.37%,1
新竹市,東區,0074,328,530,858,35,893,1398,63.88%,23.46%,1
新竹市,東區,0075,237,318,555,17,572,928,61.64%,25.54%,1
新竹市,東區,0076,317,532,849,23,872,1368,63.74%,23.17%,1
新竹市,東區,0077,279,364,643,28,671,1215,55.23%,22.96%,1
新竹市,東區,0078,250,300,550,24,574,1067,53.8%,23.43%,1
新竹市,東區,0079,322,326,648,14,662,1194,55.44%,26.97%,1
新竹市,東區,0080,280,341,621,22,643,1193,53.9%,23.47%,1
新竹市,東區,0081,300,462,762,43,805,1388,58%,21.61%,1
新竹市,東區,0082,279,442,721,25,746,1267,58.88%,22.02%,1
新竹市,東區,0083,248,462,710,25,735,1299,56.58%,19.09%,1
新竹市,東區,0084,268,449,717,26,743,1288,57.69%,20.81%,1
新竹市,東區,0085,339,388,727,25,752,1228,61.24%,27.61%,1
新竹市,東區,0086,299,372,671,16,687,1135,60.53%,26.34%,1
新竹市,東區,0087,334,428,762,26,788,1237,63.7%,27%,1
新竹市,東區,0088,212,354,566,41,607,1135,53.48%,18.68%,1
新竹市,東區,0089,208,369,577,32,609,1165,52.27%,17.85%,1
新竹市,東區,0090,243,355,598,29,627,1124,55.78%,21.62%,1
新竹市,東區,0091,242,441,683,31,714,1210,59.01%,20%,1
新竹市,東區,0092,245,441,686,29,715,1323,54.04%,18.52%,1
新竹市,東區,0093,230,400,630,21,651,1207,53.94%,19.06%,1
新竹市,東區,0094,212,398,610,27,637,1264,50.4%,16.77%,1
新竹市,東區,0095,241,420,661,20,681,1248,54.57%,19.31%,1
新竹市,東區,0096,312,521,833,36,869,1400,62.07%,22.29%,1
新竹市,東區,0097,363,526,889,13,902,1473,61.24%,24.64%,1
新竹市,東區,0098,292,443,735,33,768,1367,56.18%,21.36%,1
新竹市,東區,0099,279,433,712,19,731,1233,59.29%,22.63%,1
新竹市,東區,0100,154,116,270,12,282,507,55.62%,30.37%,1
新竹市,東區,0101,217,185,402,22,424,714,59.38%,30.39%,1
新竹市,東區,0102,236,256,492,25,517,875,59.09%,26.97%,1
新竹市,東區,0103,351,413,764,36,800,1396,57.31%,25.14%,1
新竹市,東區,0104,295,346,641,34,675,1232,54.79%,23.94%,1
新竹市,東區,0105,364,331,695,29,724,1323,54.72%,27.51%,1
新竹市,東區,0106,300,412,712,22,734,1516,48.42%,19.79%,1
新竹市,東區,0107,297,421,718,30,748,1453,51.48%,20.44%,1
新竹市,東區,0108,234,256,490,27,517,880,58.75%,26.59%,1
新竹市,東區,0109,261,316,577,19,596,1058,56.33%,24.67%,1
新竹市,東區,0110,249,325,574,26,600,1061,56.55%,23.47%,1
新竹市,東區,0111,185,204,389,28,417,710,58.73%,26.06%,1
新竹市,東區,0112,228,211,439,25,464,752,61.7%,30.32%,1
新竹市,東區,0113,125,164,289,13,302,475,63.58%,26.32%,1
新竹市,東區,0114,229,227,456,25,481,880,54.66%,26.02%,1
新竹市,東區,0115,262,284,546,39,585,989,59.15%,26.49%,1
新竹市,東區,0116,262,328,590,31,621,1059,58.64%,24.74%,1
新竹市,東區,0117,176,173,349,22,371,607,61.12%,29%,1
新竹市,東區,0118,210,235,445,34,479,815,58.77%,25.77%,1
新竹市,東區,0119,176,280,456,23,479,777,61.65%,22.65%,1
新竹市,東區,0120,300,381,681,32,713,1399,50.96%,21.44%,1
新竹市,東區,0121,310,358,668,23,691,1216,56.83%,25.49%,1
新竹市,東區,0122,247,286,533,26,559,1062,52.64%,23.26%,1
新竹市,東區,0123,260,344,604,21,625,1046,59.75%,24.86%,1
新竹市,東區,0124,269,419,688,15,703,1332,52.78%,20.2%,1
新竹市,東區,0125,244,512,756,37,793,1350,58.74%,18.07%,1
新竹市,東區,0126,275,463,738,22,760,1438,52.85%,19.12%,1
新竹市,東區,0127,309,424,733,30,763,1414,53.96%,21.85%,1
新竹市,東區,0128,368,469,837,20,857,1476,58.06%,24.93%,1
新竹市,東區,0129,332,455,787,29,816,1326,61.54%,25.04%,1
新竹市,東區,0130,224,363,587,16,603,927,65.05%,24.16%,1
新竹市,東區,0131,336,397,733,15,748,1273,58.76%,26.39%,1
新竹市,東區,0132,262,422,684,24,708,1315,53.84%,19.92%,1
新竹市,東區,0133,290,505,795,26,821,1413,58.1%,20.52%,1
新竹市,東區,0134,212,372,584,24,608,1064,57.14%,19.92%,1
新竹市,東區,0135,304,459,763,25,788,1244,63.34%,24.44%,1
新竹市,東區,0136,231,360,591,11,602,1160,51.9%,19.91%,1
新竹市,東區,0137,266,409,675,17,692,1398,49.5%,19.03%,1
新竹市,東區,0138,218,332,550,17,567,1384,40.97%,15.75%,1
新竹市,東區,0139,220,300,520,22,542,874,62.01%,25.17%,1
新竹市,北區,0140,142,117,259,5,264,477,55.35%,29.77%,1
新竹市,北區,0141,159,153,312,12,324,535,60.56%,29.72%,1
新竹市,北區,0142,211,214,425,23,448,746,60.05%,28.28%,1
新竹市,北區,0143,148,142,290,11,301,546,55.13%,27.11%,1
新竹市,北區,0144,184,232,416,28,444,711,62.45%,25.88%,1
新竹市,北區,0145,332,255,587,25,612,1143,53.54%,29.05%,1
新竹市,北區,0146,336,368,704,36,740,1370,54.01%,24.53%,1
新竹市,北區,0147,339,404,743,23,766,1390,55.11%,24.39%,1
新竹市,北區,0148,139,302,441,15,456,962,47.4%,14.45%,1
新竹市,北區,0149,309,366,675,13,688,1237,55.62%,24.98%,1
新竹市,北區,0150,341,437,778,17,795,1604,49.56%,21.26%,1
新竹市,北區,0151,150,208,358,28,386,758,50.92%,19.79%,1
新竹市,北區,0152,272,394,666,25,691,1320,52.35%,20.61%,1
新竹市,北區,0153,325,410,735,35,770,1519,50.69%,21.4%,1
新竹市,北區,0154,60,65,125,8,133,347,38.33%,17.29%,1
新竹市,北區,0155,335,375,710,25,735,1212,60.64%,27.64%,1
新竹市,北區,0156,362,417,779,34,813,1484,54.78%,24.39%,1
新竹市,北區,0157,385,372,757,36,793,1428,55.53%,26.96%,1
新竹市,北區,0158,297,338,635,24,659,1128,58.42%,26.33%,1
新竹市,北區,0159,154,202,356,6,362,638,56.74%,24.14%,1
新竹市,北區,0160,157,511,668,45,713,1222,58.35%,12.85%,1
新竹市,北區,0161,238,318,556,28,584,1076,54.28%,22.12%,1
新竹市,北區,0162,242,335,577,22,599,937,63.93%,25.83%,1
新竹市,北區,0163,345,420,765,25,790,1394,56.67%,24.75%,1
新竹市,北區,0164,353,418,771,30,801,1568,51.08%,22.51%,1
新竹市,北區,0165,329,349,678,28,706,1159,60.91%,28.39%,1
新竹市,北區,0166,40,64,104,1,105,252,41.67%,15.87%,1
新竹市,北區,0167,200,271,471,16,487,761,63.99%,26.28%,1
新竹市,北區,0168,250,215,465,16,481,788,61.04%,31.73%,1
新竹市,北區,0169,171,162,333,25,358,561,63.81%,30.48%,1
新竹市,北區,0170,358,416,774,54,828,1558,53.15%,22.98%,1
新竹市,北區,0171,350,348,698,28,726,1398,51.93%,25.04%,1
新竹市,北區,0172,233,284,517,25,542,957,56.64%,24.35%,1
新竹市,北區,0173,280,372,652,33,685,1195,57.32%,23.43%,1
新竹市,北區,0174,289,304,593,21,614,1236,49.68%,23.38%,1
新竹市,北區,0175,290,353,643,34,677,1255,53.94%,23.11%,1
新竹市,北區,0176,293,337,630,15,645,1114,57.9%,26.3%,1
新竹市,北區,0177,343,421,764,27,791,1396,56.66%,24.57%,1
新竹市,北區,0178,382,430,812,34,846,1456,58.1%,26.24%,1
新竹市,北區,0179,295,437,732,21,753,1374,54.8%,21.47%,1
新竹市,北區,0180,252,303,555,30,585,1070,54.67%,23.55%,1
新竹市,北區,0181,255,355,610,37,647,1142,56.65%,22.33%,1
新竹市,北區,0182,264,331,595,0,595,1103,53.94%,23.93%,1
新竹市,北區,0183,327,312,639,48,687,1190,57.73%,27.48%,1
新竹市,北區,0184,259,401,660,21,681,1089,62.53%,23.78%,1
新竹市,北區,0185,267,346,613,17,630,1272,49.53%,20.99%,1
新竹市,北區,0186,286,422,708,40,748,1306,57.27%,21.9%,1
新竹市,北區,0187,325,394,719,36,755,1328,56.85%,24.47%,1
新竹市,北區,0188,332,438,770,22,792,1457,54.36%,22.79%,1
新竹市,北區,0189,339,463,802,32,834,1492,55.9%,22.72%,1
新竹市,北區,0190,288,391,679,34,713,1160,61.47%,24.83%,1
新竹市,北區,0191,247,300,547,27,574,971,59.11%,25.44%,1
新竹市,北區,0192,190,257,447,17,464,1401,33.12%,13.56%,1
新竹市,北區,0193,336,417,753,21,774,1340,57.76%,25.07%,1
新竹市,北區,0194,308,473,781,29,810,1371,59.08%,22.47%,1
新竹市,北區,0195,306,382,688,22,710,1267,56.04%,24.15%,1
新竹市,北區,0196,285,371,656,22,678,1073,63.19%,26.56%,1
新竹市,北區,0197,286,375,661,18,679,1159,58.58%,24.68%,1
新竹市,北區,0198,273,423,696,21,717,1294,55.41%,21.1%,1
新竹市,北區,0199,291,490,781,29,810,1442,56.17%,20.18%,1
新竹市,北區,0200,304,422,726,22,748,1270,58.9%,23.94%,1
新竹市,北區,0201,328,412,740,32,772,1179,65.48%,27.82%,1
新竹市,北區,0202,228,338,566,35,601,949,63.33%,24.03%,1
新竹市,北區,0203,291,365,656,27,683,1163,58.73%,25.02%,1
新竹市,北區,0204,275,441,716,25,741,1334,55.55%,20.61%,1
新竹市,北區,0205,294,476,770,33,803,1415,56.75%,20.78%,1
新竹市,北區,0206,306,471,777,21,798,1305,61.15%,23.45%,1
新竹市,北區,0207,231,425,656,27,683,1200,56.92%,19.25%,1
新竹市,北區,0208,265,361,626,17,643,1106,58.14%,23.96%,1
新竹市,北區,0209,238,370,608,20,628,1044,60.15%,22.8%,1
新竹市,北區,0210,273,325,598,32,630,1061,59.38%,25.73%,1
新竹市,北區,0211,353,497,850,53,903,1518,59.49%,23.25%,1
新竹市,北區,0212,304,417,721,36,757,1220,62.05%,24.92%,1
新竹市,北區,0213,328,525,853,10,863,1475,58.51%,22.24%,1
新竹市,北區,0214,303,421,724,30,754,1373,54.92%,22.07%,1
新竹市,北區,0215,301,518,819,18,837,1450,57.72%,20.76%,1
新竹市,北區,0216,282,523,805,25,830,1423,58.33%,19.82%,1
新竹市,北區,0217,175,418,593,8,601,1059,56.75%,16.53%,1
新竹市,北區,0218,175,480,655,30,685,1130,60.62%,15.49%,1
新竹市,北區,0219,204,521,725,28,753,1208,62.33%,16.89%,1
新竹市,北區,0220,176,565,741,23,764,1226,62.32%,14.36%,1
新竹市,北區,0221,255,391,646,27,673,1175,57.28%,21.7%,1
新竹市,北區,0222,301,474,775,22,797,1371,58.13%,21.95%,1
新竹市,北區,0223,268,413,681,41,722,1306,55.28%,20.52%,1
新竹市,北區,0224,301,412,713,18,731,1340,54.55%,22.46%,1
新竹市,北區,0225,294,353,647,45,692,1111,62.29%,26.46%,1
新竹市,北區,0226,306,431,737,38,775,1197,64.75%,25.56%,1
新竹市,北區,0227,232,328,560,22,582,1008,57.74%,23.02%,1
新竹市,北區,0228,222,291,513,15,528,946,55.81%,23.47%,1
新竹市,北區,0229,179,210,389,37,426,705,60.43%,25.39%,1
新竹市,北區,0230,247,220,467,42,509,848,60.02%,29.13%,1
新竹市,北區,0231,279,400,679,21,700,1295,54.05%,21.54%,1
新竹市,北區,0232,265,471,736,26,762,1467,51.94%,18.06%,1
新竹市,北區,0233,353,409,762,31,793,1659,47.8%,21.28%,1
新竹市,北區,0234,257,391,648,42,690,1297,53.2%,19.81%,1
新竹市,北區,0235,330,416,746,46,792,1374,57.64%,24.02%,1
新竹市,北區,0236,363,434,797,47,844,1457,57.93%,24.91%,1
新竹市,北區,0237,253,352,605,30,635,1072,59.24%,23.6%,1
新竹市,北區,0238,298,397,695,28,723,1350,53.56%,22.07%,1
新竹市,北區,0239,260,331,591,18,609,971,62.72%,26.78%,1
新竹市,北區,0240,355,458,813,39,852,1450,58.76%,24.48%,1
新竹市,北區,0241,204,294,498,17,515,895,57.54%,22.79%,1
新竹市,北區,0242,293,436,729,30,759,1378,55.08%,21.26%,1
新竹市,北區,0243,364,437,801,46,847,1609,52.64%,22.62%,1
新竹市,北區,0244,152,173,325,22,347,594,58.42%,25.59%,1
新竹市,香山區,0245,319,428,747,35,782,1443,54.19%,22.11%,1
新竹市,香山區,0246,314,349,663,25,688,1241,55.44%,25.3%,1
新竹市,香山區,0247,273,368,641,21,662,1194,55.44%,22.86%,1
新竹市,香山區,0248,243,355,598,12,610,1081,56.43%,22.48%,1
新竹市,香山區,0249,220,242,462,22,484,807,59.98%,27.26%,1
新竹市,香山區,0250,389,543,932,36,968,1760,55%,22.1%,1
新竹市,香山區,0251,336,538,874,42,916,1635,56.02%,20.55%,1
新竹市,香山區,0252,367,450,817,46,863,1473,58.59%,24.92%,1
新竹市,香山區,0253,312,473,785,20,805,1408,57.17%,22.16%,1
新竹市,香山區,0254,277,342,619,22,641,1318,48.63%,21.02%,1
新竹市,香山區,0255,310,421,731,27,758,1337,56.69%,23.19%,1
新竹市,香山區,0256,368,566,934,32,966,1862,51.88%,19.76%,1
新竹市,香山區,0257,255,333,588,17,605,1067,56.7%,23.9%,1
新竹市,香山區,0258,217,286,503,31,534,863,61.88%,25.14%,1
新竹市,香山區,0259,347,350,697,43,740,1198,61.77%,28.96%,1
新竹市,香山區,0260,322,330,652,44,696,1138,61.16%,28.3%,1
新竹市,香山區,0261,297,283,580,44,624,957,65.2%,31.03%,1
新竹市,香山區,0262,357,394,751,48,799,1348,59.27%,26.48%,1
新竹市,香山區,0263,311,333,644,46,690,1023,67.45%,30.4%,1
新竹市,香山區,0264,199,327,526,25,551,970,56.8%,20.52%,1
新竹市,香山區,0265,319,421,740,37,777,1318,58.95%,24.2%,1
新竹市,香山區,0266,261,305,566,44,610,1088,56.07%,23.99%,1
新竹市,香山區,0267,232,231,463,11,474,903,52.49%,25.69%,1
新竹市,香山區,0268,261,299,560,36,596,1012,58.89%,25.79%,1
新竹市,香山區,0269,236,312,548,29,577,1014,56.9%,23.27%,1
新竹市,香山區,0270,327,373,700,25,725,1238,58.56%,26.41%,1
新竹市,香山區,0271,299,340,639,37,676,1182,57.19%,25.3%,1
新竹市,香山區,0272,350,448,798,55,853,1331,64.09%,26.3%,1
新竹市,香山區,0273,216,392,608,24,632,976,64.75%,22.13%,1
新竹市,香山區,0274,195,252,447,15,462,834,55.4%,23.38%,1
新竹市,香山區,0275,187,321,508,25,533,919,58%,20.35%,1
新竹市,香山區,0276,260,408,668,33,701,1188,59.01%,21.89%,1
新竹市,香山區,0277,265,334,599,34,633,1086,58.29%,24.4%,1
新竹市,香山區,0278,304,383,687,33,720,1144,62.94%,26.57%,1
新竹市,香山區,0279,230,423,653,19,672,1112,60.43%,20.68%,1
新竹市,香山區,0280,351,474,825,33,858,1476,58.13%,23.78%,1
新竹市,香山區,0281,288,409,697,34,731,1291,56.62%,22.31%,1
新竹市,香山區,0282,363,512,875,30,905,1464,61.82%,24.8%,1
新竹市,香山區,0283,358,449,807,47,854,1427,59.85%,25.09%,1
新竹市,香山區,0284,341,390,731,22,753,1336,56.36%,25.52%,1
新竹市,香山區,0285,261,279,540,30,570,1131,50.4%,23.08%,1
新竹市,香山區,0286,252,357,609,45,654,1070,61.12%,23.55%,1
新竹市,香山區,0287,261,325,586,36,622,1006,61.83%,25.94%,1
新竹市,香山區,0288,211,346,557,33,590,1223,48.24%,17.25%,1
新竹市,香山區,0289,255,357,612,24,636,1119,56.84%,22.79%,1
新竹市,香山區,0290,308,367,675,30,705,1400,50.36%,22%,1
新竹市,香山區,0291,299,441,740,34,774,1627,47.57%,18.38%,1
新竹市,香山區,0292,326,306,632,17,649,1289,50.35%,25.29%,1
新竹市,香山區,0293,263,415,678,38,716,1409,50.82%,18.67%,1
新竹市,香山區,0294,224,191,415,24,439,814,53.93%,27.52%,1
新竹市,香山區,0295,177,221,398,16,414,719,57.58%,24.62%,1
新竹市,香山區,0296,205,307,512,18,530,1065,49.77%,19.25%,1
新竹市,香山區,0297,195,233,428,19,447,776,57.6%,25.13%,1
新竹市,香山區,0298,199,301,500,22,522,890,58.65%,22.36%,1
新竹市,香山區,0299,202,249,451,25,476,896,53.13%,22.54%,1
嘉義市,東區,0001,248,328,576,18,594,1025,57.95%,24.2%,1
嘉義市,東區,0002,293,394,687,15,702,1276,55.02%,22.96%,1
嘉義市,東區,0003,218,258,476,25,501,974,51.44%,22.38%,1
嘉義市,東區,0004,327,362,689,35,724,1175,61.62%,27.83%,1
嘉義市,東區,0005,202,219,421,16,437,702,62.25%,28.77%,1
嘉義市,東區,0006,278,316,594,22,616,1092,56.41%,25.46%,1
嘉義市,東區,0007,247,225,472,24,496,1023,48.48%,24.14%,1
嘉義市,東區,0008,417,481,898,42,940,1816,51.76%,22.96%,1
嘉義市,東區,0009,473,554,1027,36,1063,1936,54.91%,24.43%,1
嘉義市,東區,0010,408,533,941,25,966,1698,56.89%,24.03%,1
嘉義市,東區,0011,320,393,713,21,734,1221,60.11%,26.21%,1
嘉義市,東區,0012,299,314,613,18,631,1113,56.69%,26.86%,1
嘉義市,東區,0013,385,429,814,24,838,1452,57.71%,26.52%,1
嘉義市,東區,0014,372,458,830,25,855,1395,61.29%,26.67%,1
嘉義市,東區,0015,366,344,710,35,745,1453,51.27%,25.19%,1
嘉義市,東區,0016,255,326,581,19,600,1094,54.84%,23.31%,1
嘉義市,東區,0017,338,460,798,22,820,1420,57.75%,23.8%,1
嘉義市,東區,0018,424,464,888,28,916,1552,59.02%,27.32%,1
嘉義市,東區,0019,383,481,864,32,896,1558,57.51%,24.58%,1
嘉義市,東區,0020,279,328,607,24,631,1062,59.42%,26.27%,1
嘉義市,東區,0021,215,404,619,41,660,1199,55.05%,17.93%,1
嘉義市,東區,0022,264,398,662,26,688,1236,55.66%,21.36%,1
嘉義市,東區,0023,243,254,497,16,513,890,57.64%,27.3%,1
嘉義市,東區,0024,241,265,506,31,537,880,61.02%,27.39%,1
嘉義市,東區,0025,290,377,667,14,681,1189,57.28%,24.39%,1
嘉義市,東區,0026,194,210,404,12,416,669,62.18%,29%,1
嘉義市,東區,0027,298,462,760,33,793,1435,55.26%,20.77%,1
嘉義市,東區,0028,350,438,788,30,818,1349,60.64%,25.95%,1
嘉義市,東區,0029,343,417,760,21,781,1455,53.68%,23.57%,1
嘉義市,東區,0030,247,276,523,16,539,915,58.91%,26.99%,1
嘉義市,東區,0031,325,228,553,16,569,952,59.77%,34.14%,1
嘉義市,東區,0032,264,249,513,23,536,941,56.96%,28.06%,1
嘉義市,東區,0033,305,280,585,21,606,1080,56.11%,28.24%,1
嘉義市,東區,0034,331,276,607,15,622,1157,53.76%,28.61%,1
嘉義市,東區,0035,348,269,617,19,636,1053,60.4%,33.05%,1
嘉義市,東區,0036,268,230,498,19,517,967,53.46%,27.71%,1
嘉義市,東區,0037,294,281,575,20,595,1091,54.54%,26.95%,1
嘉義市,東區,0038,282,272,554,27,581,961,60.46%,29.34%,1
嘉義市,東區,0039,202,154,356,15,371,863,42.99%,23.41%,1
嘉義市,東區,0040,271,334,605,21,626,1023,61.19%,26.49%,1
嘉義市,東區,0041,316,291,607,42,649,1078,60.2%,29.31%,1
嘉義市,東區,0042,254,251,505,23,528,938,56.29%,27.08%,1
嘉義市,東區,0043,266,310,576,18,594,1049,56.63%,25.36%,1
嘉義市,東區,0044,382,304,686,35,721,1360,53.01%,28.09%,1
嘉義市,東區,0045,422,339,761,55,816,1615,50.53%,26.13%,1
嘉義市,東區,0046,359,299,658,21,679,1267,53.59%,28.33%,1
嘉義市,東區,0047,376,348,724,50,774,1579,49.02%,23.81%,1
嘉義市,東區,0048,409,499,908,39,947,1831,51.72%,22.34%,1
嘉義市,東區,0049,266,290,556,19,575,977,58.85%,27.23%,1
嘉義市,東區,0050,332,279,611,11,622,1169,53.21%,28.4%,1
嘉義市,東區,0051,353,329,682,57,739,1238,59.69%,28.51%,1
嘉義市,東區,0052,332,384,716,16,732,1266,57.82%,26.22%,1
嘉義市,東區,0053,325,344,669,32,701,1429,49.06%,22.74%,1
嘉義市,東區,0054,357,352,709,18,727,1288,56.44%,27.72%,1
嘉義市,東區,0055,284,247,531,20,551,980,56.22%,28.98%,1
嘉義市,東區,0056,231,243,474,20,494,922,53.58%,25.05%,1
嘉義市,東區,0057,307,329,636,30,666,1133,58.78%,27.1%,1
嘉義市,東區,0058,316,358,674,25,699,1235,56.6%,25.59%,1
嘉義市,東區,0059,371,425,796,22,818,1525,53.64%,24.33%,1
嘉義市,東區,0060,303,285,588,32,620,1170,52.99%,25.9%,1
嘉義市,東區,0061,318,382,700,45,745,1177,63.3%,27.02%,1
嘉義市,東區,0062,294,355,649,42,691,1207,57.25%,24.36%,1
嘉義市,東區,0063,308,382,690,36,726,1272,57.08%,24.21%,1
嘉義市,東區,0064,312,298,610,59,669,1188,56.31%,26.26%,1
嘉義市,東區,0065,302,291,593,20,613,1172,52.3%,25.77%,1
嘉義市,東區,0066,311,261,572,30,602,1020,59.02%,30.49%,1
嘉義市,東區,0067,372,367,739,31,770,1332,57.81%,27.93%,1
嘉義市,東區,0068,312,297,609,23,632,1011,62.51%,30.86%,1
嘉義市,東區,0069,407,441,848,41,889,1682,52.85%,24.2%,1
嘉義市,東區,0070,403,418,821,44,865,1567,55.2%,25.72%,1
嘉義市,東區,0071,313,348,661,14,675,1207,55.92%,25.93%,1
嘉義市,東區,0072,245,334,579,19,598,981,60.96%,24.97%,1
嘉義市,東區,0073,325,410,735,26,761,1395,54.55%,23.3%,1
嘉義市,東區,0074,338,345,683,15,698,1434,48.68%,23.57%,1
嘉義市,東區,0075,301,331,632,15,647,1404,46.08%,21.44%,1
嘉義市,東區,0076,378,417,795,24,819,1428,57.35%,26.47%,1
嘉義市,東區,0077,353,427,780,22,802,1823,43.99%,19.36%,1
嘉義市,東區,0078,397,365,762,25,787,1570,50.13%,25.29%,1
嘉義市,東區,0079,348,299,647,47,694,1282,54.13%,27.15%,1
嘉義市,東區,0080,408,478,886,37,923,1571,58.75%,25.97%,1
嘉義市,東區,0081,350,418,768,22,790,1533,51.53%,22.83%,1
嘉義市,西區,0082,253,225,478,16,494,885,55.82%,28.59%,1
嘉義市,西區,0083,283,297,580,25,605,1109,54.55%,25.52%,1
嘉義市,西區,0084,290,228,518,29,547,1020,53.63%,28.43%,1
嘉義市,西區,0085,272,285,557,31,588,925,63.57%,29.41%,1
嘉義市,西區,0086,470,326,796,19,815,1671,48.77%,28.13%,1
嘉義市,西區,0087,345,339,684,17,701,1215,57.7%,28.4%,1
嘉義市,西區,0088,351,223,574,19,593,1036,57.24%,33.88%,1
嘉義市,西區,0089,346,241,587,19,606,1129,53.68%,30.65%,1
嘉義市,西區,0090,324,275,599,27,626,1127,55.55%,28.75%,1
嘉義市,西區,0091,427,349,776,29,805,1415,56.89%,30.18%,1
嘉義市,西區,0092,351,362,713,20,733,1366,53.66%,25.7%,1
嘉義市,西區,0093,330,289,619,29,648,1053,61.54%,31.34%,1
嘉義市,西區,0094,309,279,588,15,603,1067,56.51%,28.96%,1
嘉義市,西區,0095,369,391,760,21,781,1575,49.59%,23.43%,1
嘉義市,西區,0096,481,486,967,26,993,1865,53.24%,25.79%,1
嘉義市,西區,0097,337,279,616,30,646,1196,54.01%,28.18%,1
嘉義市,西區,0098,348,298,646,19,665,1280,51.95%,27.19%,1
嘉義市,西區,0099,386,464,850,32,882,1629,54.14%,23.7%,1
嘉義市,西區,0100,397,365,762,46,808,1393,58%,28.5%,1
嘉義市,西區,0101,312,329,641,27,668,1077,62.02%,28.97%,1
嘉義市,西區,0102,379,395,774,30,804,1694,47.46%,22.37%,1
嘉義市,西區,0103,274,209,483,45,528,841,62.78%,32.58%,1
嘉義市,西區,0104,317,271,588,7,595,1183,50.3%,26.8%,1
嘉義市,西區,0105,284,339,623,17,640,1000,64%,28.4%,1
嘉義市,西區,0106,307,331,638,16,654,1095,59.73%,28.04%,1
嘉義市,西區,0107,350,395,745,19,764,1256,60.83%,27.87%,1
嘉義市,西區,0108,271,271,542,28,570,962,59.25%,28.17%,1
嘉義市,西區,0109,258,282,540,20,560,865,64.74%,29.83%,1
嘉義市,西區,0110,339,250,589,35,624,1396,44.7%,24.28%,1
嘉義市,西區,0111,440,508,948,39,987,1799,54.86%,24.46%,1
嘉義市,西區,0112,354,389,743,24,767,1505,50.96%,23.52%,1
嘉義市,西區,0113,424,463,887,42,929,1698,54.71%,24.97%,1
嘉義市,西區,0114,441,544,985,22,1007,1854,54.31%,23.79%,1
嘉義市,西區,0115,359,377,736,6,742,1537,48.28%,23.36%,1
嘉義市,西區,0116,391,378,769,52,821,1604,51.18%,24.38%,1
嘉義市,西區,0117,304,249,553,51,604,944,63.98%,32.2%,1
嘉義市,西區,0118,444,459,903,37,940,1627,57.78%,27.29%,1
嘉義市,西區,0119,314,350,664,26,690,1144,60.31%,27.45%,1
嘉義市,西區,0120,358,358,716,33,749,1362,54.99%,26.28%,1
嘉義市,西區,0121,397,333,730,22,752,1279,58.8%,31.04%,1
嘉義市,西區,0122,456,448,904,52,956,1702,56.17%,26.79%,1
嘉義市,西區,0123,347,425,772,33,805,1358,59.28%,25.55%,1
嘉義市,西區,0124,404,397,801,32,833,1360,61.25%,29.71%,1
嘉義市,西區,0125,439,430,869,32,901,1589,56.7%,27.63%,1
嘉義市,西區,0126,350,391,741,26,767,1280,59.92%,27.34%,1
嘉義市,西區,0127,297,298,595,27,622,1220,50.98%,24.34%,1
嘉義市,西區,0128,322,364,686,17,703,1172,59.98%,27.47%,1
嘉義市,西區,0129,359,361,720,25,745,1320,56.44%,27.2%,1
嘉義市,西區,0130,352,405,757,23,780,1185,65.82%,29.7%,1
嘉義市,西區,0131,392,377,769,29,798,1278,62.44%,30.67%,1
嘉義市,西區,0132,319,291,610,23,633,1394,45.41%,22.88%,1
嘉義市,西區,0133,400,452,852,38,890,1540,57.79%,25.97%,1
嘉義市,西區,0134,391,449,840,37,877,1548,56.65%,25.26%,1
嘉義市,西區,0135,373,324,697,14,711,1295,54.9%,28.8%,1
嘉義市,西區,0136,404,382,786,15,801,1318,60.77%,30.65%,1
嘉義市,西區,0137,432,415,847,26,873,1545,56.5%,27.96%,1
嘉義市,西區,0138,227,160,387,13,400,736,54.35%,30.84%,1
嘉義市,西區,0139,317,301,618,11,629,1168,53.85%,27.14%,1
嘉義市,西區,0140,245,226,471,22,493,756,65.21%,32.41%,1
嘉義市,西區,0141,143,330,473,18,491,869,56.5%,16.46%,1
嘉義市,西區,0142,268,299,567,21,588,983,59.82%,27.26%,1
嘉義市,西區,0143,239,230,469,22,491,828,59.3%,28.86%,1
嘉義市,西區,0144,266,676,942,35,977,1775,55.04%,14.99%,1
嘉義市,西區,0145,195,538,733,33,766,1419,53.98%,13.74%,1
嘉義市,西區,0146,260,184,444,11,455,779,58.41%,33.38%,1
嘉義市,西區,0147,227,222,449,17,466,855,54.5%,26.55%,1
嘉義市,西區,0148,330,311,641,32,673,1146,58.73%,28.8%,1
嘉義市,西區,0149,328,303,631,29,660,1111,59.41%,29.52%,1
嘉義市,西區,0150,243,233,476,21,497,767,64.8%,31.68%,1
嘉義市,西區,0151,226,188,414,12,426,817,52.14%,27.66%,1
嘉義市,西區,0152,204,225,429,25,454,770,58.96%,26.49%,1
嘉義市,西區,0153,261,280,541,20,561,1135,49.43%,23%,1
嘉義市,西區,0154,240,190,430,27,457,835,54.73%,28.74%,1
嘉義市,西區,0155,314,263,577,33,610,1182,51.61%,26.57%,1
嘉義市,西區,0156,295,174,469,21,490,944,51.91%,31.25%,1
嘉義市,西區,0157,315,223,538,19,557,997,55.87%,31.59%,1
嘉義市,西區,0158,289,301,590,18,608,1074,56.61%,26.91%,1
嘉義市,西區,0159,326,324,650,10,660,1460,45.21%,22.33%,1
嘉義市,西區,0160,396,328,724,17,741,1352,54.81%,29.29%,1
嘉義市,西區,0161,410,378,788,26,814,1499,54.3%,27.35%,1
嘉義市,西區,0162,367,299,666,55,721,1262,57.13%,29.08%,1
嘉義市,西區,0163,330,372,702,15,717,1299,55.2%,25.4%,1
嘉義市,西區,0164,447,430,877,38,915,1734,52.77%,25.78%,1
嘉義市,西區,0165,490,326,816,30,846,1674,50.54%,29.27%,1
嘉義市,西區,0166,355,438,793,24,817,1540,53.05%,23.05%,1
嘉義市,西區,0167,338,299,637,16,653,1056,61.84%,32.01%,1
嘉義市,西區,0168,434,373,807,59,866,1467,59.03%,29.58%,1
嘉義市,西區,0169,382,328,710,39,749,1431,52.34%,26.69%,1
嘉義市,西區,0170,404,336,740,37,777,1234,62.97%,32.74%,1
嘉義市,西區,0171,340,330,670,14,684,1266,54.03%,26.86%,1
嘉義市,西區,0172,338,340,678,22,700,1211,57.8%,27.91%,1
嘉義市,西區,0173,291,350,641,10,651,1121,58.07%,25.96%,1
嘉義市,西區,0174,300,295,595,19,614,1155,53.16%,25.97%,1
嘉義市,西區,0175,446,407,853,54,907,1546,58.67%,28.85%,1
嘉義市,西區,0176,361,343,704,21,725,1322,54.84%,27.31%,1
嘉義市,西區,0177,418,417,835,48,883,1549,57%,26.99%,1
