縣市,鄉鎮市區,開票所,同意票,不同意票,有效票,無效票,投票數,投票權人數,投票率,投票權人數百分比,總數
臺北市,松山區,0527,359,561,920,33,953,1583,60.2%,22.68%,1
臺北市,松山區,0528,352,579,931,51,982,1691,58.07%,20.82%,1
臺北市,松山區,0529,279,471,750,44,794,1386,57.29%,20.13%,1
臺北市,松山區,0530,292,482,774,53,827,1362,60.72%,21.44%,1
臺北市,松山區,0531,299,499,798,47,845,1399,60.4%,21.37%,1
臺北市,松山區,0532,320,446,766,48,814,1324,61.48%,24.17%,1
臺北市,松山區,0533,318,481,799,32,831,1296,64.12%,24.54%,1
臺北市,松山區,0534,296,523,819,36,855,1386,61.69%,21.36%,1
臺北市,松山區,0535,383,542,925,55,980,1529,64.09%,25.05%,1
臺北市,松山區,0536,282,507,789,34,823,1416,58.12%,19.92%,1
臺北市,松山區,0537,352,513,865,37,902,1619,55.71%,21.74%,1
臺北市,松山區,0538,315,485,800,33,833,1386,60.1%,22.73%,1
臺北市,松山區,0539,354,507,861,29,890,1380,64.49%,25.65%,1
臺北市,松山區,0540,331,460,791,37,828,1357,61.02%,24.39%,1
臺北市,松山區,0541,290,495,785,32,817,1296,63.04%,22.38%,1
臺北市,松山區,0542,349,567,916,63,979,1632,59.99%,21.38%,1
臺北市,松山區,0543,309,488,797,34,831,1414,58.77%,21.85%,1
臺北市,松山區,0544,315,510,825,34,859,1404,61.18%,22.44%,1
臺北市,松山區,0545,266,537,803,51,854,1365,62.56%,19.49%,1
臺北市,松山區,0546,327,492,819,41,860,1431,60.1%,22.85%,1
臺北市,松山區,0547,339,529,868,39,907,1483,61.16%,22.86%,1
臺北市,松山區,0548,308,477,785,33,818,1293,63.26%,23.82%,1
臺北市,松山區,0549,306,468,774,33,807,1410,57.23%,21.7%,1
臺北市,松山區,0550,264,486,750,43,793,1307,60.67%,20.2%,1
臺北市,松山區,0551,322,441,763,31,794,1242,63.93%,25.93%,1
臺北市,松山區,0552,266,448,714,25,739,1192,62%,22.32%,1
臺北市,松山區,0553,265,491,756,42,798,1276,62.54%,20.77%,1
臺北市,松山區,0554,251,441,692,20,712,1201,59.28%,20.9%,1
臺北市,松山區,0555,250,525,775,24,799,1318,60.62%,18.97%,1
臺北市,松山區,0556,256,439,695,28,723,1157,62.49%,22.13%,1
臺北市,松山區,0557,245,411,656,18,674,1157,58.25%,21.18%,1
臺北市,松山區,0558,275,535,810,30,840,1357,61.9%,20.27%,1
臺北市,松山區,0559,251,378,629,31,660,1215,54.32%,20.66%,1
臺北市,松山區,0560,294,450,744,34,778,1345,57.84%,21.86%,1
臺北市,松山區,0561,276,439,715,31,746,1237,60.31%,22.31%,1
臺北市,松山區,0562,243,595,838,37,875,1393,62.81%,17.44%,1
臺北市,松山區,0563,332,495,827,38,865,1331,64.99%,24.94%,1
臺北市,松山區,0564,369,556,925,46,971,1550,62.65%,23.81%,1
臺北市,松山區,0565,201,530,731,13,744,1308,56.88%,15.37%,1
臺北市,松山區,0566,274,567,841,37,878,1490,58.93%,18.39%,1
臺北市,松山區,0567,310,551,861,32,893,1406,63.51%,22.05%,1
臺北市,松山區,0568,293,458,751,23,774,1191,64.99%,24.6%,1
臺北市,松山區,0569,260,386,646,32,678,1095,61.92%,23.74%,1
臺北市,松山區,0570,236,441,677,42,719,1198,60.02%,19.7%,1
臺北市,松山區,0571,259,450,709,41,750,1265,59.29%,20.47%,1
臺北市,松山區,0572,251,442,693,24,717,1225,58.53%,20.49%,1
臺北市,松山區,0573,387,615,1002,53,1055,1698,62.13%,22.79%,1
臺北市,松山區,0574,668,334,1002,44,1046,1819,57.5%,36.72%,1
臺北市,松山區,0575,387,624,1011,50,1061,1754,60.49%,22.06%,1
臺北市,松山區,0576,337,477,814,34,848,1361,62.31%,24.76%,1
臺北市,松山區,0577,258,459,717,25,742,1189,62.41%,21.7%,1
臺北市,松山區,0578,282,427,709,39,748,1214,61.61%,23.23%,1
臺北市,松山區,0579,299,441,740,33,773,1284,60.2%,23.29%,1
臺北市,松山區,0580,303,463,766,41,807,1297,62.22%,23.36%,1
臺北市,松山區,0581,298,450,748,34,782,1330,58.8%,22.41%,1
臺北市,松山區,0582,305,523,828,41,869,1396,62.25%,21.85%,1
臺北市,松山區,0583,277,543,820,26,846,1480,57.16%,18.72%,1
臺北市,松山區,0584,319,510,829,34,863,1419,60.82%,22.48%,1
臺北市,松山區,0585,305,503,808,41,849,1390,61.08%,21.94%,1
臺北市,松山區,0586,362,524,886,34,920,1525,60.33%,23.74%,1
臺北市,松山區,0587,327,546,873,33,906,1633,55.48%,20.02%,1
臺北市,松山區,0588,369,505,874,24,898,2677,33.55%,13.78%,1
臺北市,松山區,0589,302,418,720,47,767,1281,59.88%,23.58%,1
臺北市,松山區,0590,270,402,672,49,721,1469,49.08%,18.38%,1
臺北市,松山區,0591,381,531,912,59,971,1700,57.12%,22.41%,1
臺北市,松山區,0592,330,460,790,40,830,1503,55.22%,21.96%,1
臺北市,松山區,0593,295,431,726,39,765,1309,58.44%,22.54%,1
臺北市,松山區,0594,280,500,780,55,835,1376,60.68%,20.35%,1
臺北市,松山區,0595,355,582,937,27,964,1654,58.28%,21.46%,1
臺北市,松山區,0596,322,537,859,56,915,1601,57.15%,20.11%,1
臺北市,松山區,0597,299,557,856,31,887,1496,59.29%,19.99%,1
臺北市,松山區,0598,372,587,959,55,1014,1598,63.45%,23.28%,1
臺北市,松山區,0599,401,620,1021,43,1064,1751,60.77%,22.9%,1
臺北市,松山區,0600,329,609,938,34,972,1557,62.43%,21.13%,1
臺北市,松山區,0601,360,720,1080,35,1115,1686,66.13%,21.35%,1
臺北市,松山區,0602,263,732,995,54,1049,1707,61.45%,15.41%,1
臺北市,松山區,0603,392,755,1147,49,1196,1854,64.51%,21.14%,1
臺北市,松山區,0604,355,586,941,36,977,1740,56.15%,20.4%,1
臺北市,松山區,0605,321,515,836,51,887,1494,59.37%,21.49%,1
臺北市,松山區,0606,296,533,829,45,874,1453,60.15%,20.37%,1
臺北市,松山區,0607,328,524,852,26,878,1458,60.22%,22.5%,1
臺北市,松山區,0608,338,537,875,27,902,1536,58.72%,22.01%,1
臺北市,松山區,0609,312,548,860,26,886,1463,60.56%,21.33%,1
臺北市,松山區,0610,389,547,936,23,959,1790,53.58%,21.73%,1
臺北市,松山區,0611,359,610,969,42,1011,1679,60.21%,21.38%,1
臺北市,松山區,0612,324,551,875,55,930,1785,52.1%,18.15%,1
臺北市,松山區,0613,390,579,969,49,1018,1793,56.78%,21.75%,1
臺北市,松山區,0614,274,496,770,51,821,1381,59.45%,19.84%,1
臺北市,松山區,0615,283,467,750,26,776,1279,60.67%,22.13%,1
臺北市,松山區,0616,354,602,956,58,1014,1681,60.32%,21.06%,1
臺北市,松山區,0617,291,448,739,40,779,1232,63.23%,23.62%,1
臺北市,松山區,0618,321,531,852,35,887,1533,57.86%,20.94%,1
臺北市,松山區,0619,370,552,922,32,954,1540,61.95%,24.03%,1
臺北市,松山區,0620,359,576,935,28,963,1716,56.12%,20.92%,1
臺北市,松山區,0621,366,513,879,35,914,1664,54.93%,22%,1
臺北市,松山區,0622,267,487,754,22,776,1350,57.48%,19.78%,1
臺北市,松山區,0623,377,634,1011,34,1045,1837,56.89%,20.52%,1
臺北市,松山區,0624,317,474,791,63,854,1558,54.81%,20.35%,1
臺北市,松山區,0625,324,503,827,49,876,1420,61.69%,22.82%,1
臺北市,松山區,0626,292,522,814,38,852,1474,57.8%,19.81%,1
臺北市,松山區,0627,346,526,872,40,912,1591,57.32%,21.75%,1
臺北市,松山區,0628,342,628,970,38,1008,1726,58.4%,19.81%,1
臺北市,松山區,0629,345,476,821,30,851,1452,58.61%,23.76%,1
臺北市,松山區,0630,319,486,805,38,843,1482,56.88%,21.52%,1
臺北市,松山區,0631,321,523,844,35,879,1460,60.21%,21.99%,1
臺北市,松山區,0632,309,459,768,41,809,1398,57.87%,22.1%,1
臺北市,松山區,0633,331,495,826,41,867,1423,60.93%,23.26%,1
臺北市,松山區,0634,254,459,713,24,737,1226,60.11%,20.72%,1
臺北市,松山區,0635,248,413,661,37,698,1158,60.28%,21.42%,1
臺北市,松山區,0636,407,388,795,28,823,1426,57.71%,28.54%,1
臺北市,松山區,0637,248,436,684,20,704,1177,59.81%,21.07%,1
臺北市,松山區,0638,322,429,751,44,795,1363,58.33%,23.62%,1
臺北市,松山區,0639,249,477,726,42,768,1240,61.94%,20.08%,1
臺北市,松山區,0640,297,524,821,34,855,1375,62.18%,21.6%,1
臺北市,松山區,0641,211,582,793,28,821,1377,59.62%,15.32%,1
臺北市,松山區,0642,257,407,664,20,684,1225,55.84%,20.98%,1
臺北市,松山區,0643,267,356,623,29,652,1017,64.11%,26.25%,1
臺北市,信義區,0644,279,506,785,23,808,2476,32.63%,11.27%,1
臺北市,信義區,0645,276,587,863,21,884,1381,64.01%,19.99%,1
臺北市,信義區,0646,247,527,774,42,816,1294,63.06%,19.09%,1
臺北市,信義區,0647,287,484,771,34,805,1351,59.59%,21.24%,1
臺北市,信義區,0648,277,473,750,23,773,1296,59.65%,21.37%,1
臺北市,信義區,0649,281,497,778,30,808,1302,62.06%,21.58%,1
臺北市,信義區,0650,194,337,531,54,585,1025,57.07%,18.93%,1
臺北市,信義區,0651,299,459,758,27,785,1421,55.24%,21.04%,1
臺北市,信義區,0652,332,491,823,32,855,1501,56.96%,22.12%,1
臺北市,信義區,0653,324,479,803,24,827,1575,52.51%,20.57%,1
臺北市,信義區,0654,314,549,863,22,885,1516,58.38%,20.71%,1
臺北市,信義區,0655,333,478,811,30,841,1382,60.85%,24.1%,1
臺北市,信義區,0656,228,396,624,37,661,1128,58.6%,20.21%,1
臺北市,信義區,0657,265,489,754,48,802,1397,57.41%,18.97%,1
臺北市,信義區,0658,253,435,688,43,731,1161,62.96%,21.79%,1
臺北市,信義區,0659,296,473,769,36,805,1368,58.85%,21.64%,1
臺北市,信義區,0660,228,390,618,21,639,1049,60.92%,21.73%,1
臺北市,信義區,0661,266,488,754,39,793,1308,60.63%,20.34%,1
臺北市,信義區,0662,275,415,690,40,730,1154,63.26%,23.83%,1
臺北市,信義區,0663,294,353,647,16,663,1078,61.5%,27.27%,1
臺北市,信義區,0664,285,497,782,29,811,1375,58.98%,20.73%,1
臺北市,信義區,0665,273,547,820,36,856,1448,59.12%,18.85%,1
臺北市,信義區,0666,265,479,744,19,763,1250,61.04%,21.2%,1
臺北市,信義區,0667,328,481,809,22,831,1381,60.17%,23.75%,1
臺北市,信義區,0668,338,458,796,30,826,1213,68.1%,27.86%,1
臺北市,信義區,0669,292,559,851,30,881,1373,64.17%,21.27%,1
臺北市,信義區,0670,268,460,728,28,756,1226,61.66%,21.86%,1
臺北市,信義區,0671,254,396,650,20,670,1117,59.98%,22.74%,1
臺北市,信義區,0672,214,462,676,31,707,1123,62.96%,19.06%,1
臺北市,信義區,0673,242,460,702,26,728,1200,60.67%,20.17%,1
臺北市,信義區,0674,268,421,689,24,713,1335,53.41%,20.07%,1
臺北市,信義區,0675,273,438,711,23,734,1332,55.11%,20.5%,1
臺北市,信義區,0676,314,612,926,60,986,1648,59.83%,19.05%,1
臺北市,信義區,0677,308,506,814,57,871,1542,56.49%,19.97%,1
臺北市,信義區,0678,259,416,675,58,733,1228,59.69%,21.09%,1
臺北市,信義區,0679,370,590,960,42,1002,1731,57.89%,21.37%,1
臺北市,信義區,0680,315,496,811,32,843,1403,60.09%,22.45%,1
臺北市,信義區,0681,353,639,992,70,1062,1929,55.05%,18.3%,1
臺北市,信義區,0682,299,473,772,34,806,1300,62%,23%,1
臺北市,信義區,0683,292,480,772,20,792,1486,53.3%,19.65%,1
臺北市,信義區,0684,300,449,749,38,787,1532,51.37%,19.58%,1
臺北市,信義區,0685,279,554,833,37,870,1387,62.73%,20.12%,1
臺北市,信義區,0686,211,410,621,40,661,1195,55.31%,17.66%,1
臺北市,信義區,0687,227,340,567,42,609,1068,57.02%,21.25%,1
臺北市,信義區,0688,241,422,663,35,698,1273,54.83%,18.93%,1
臺北市,信義區,0689,305,475,780,61,841,1329,63.28%,22.95%,1
臺北市,信義區,0690,271,423,694,39,733,1311,55.91%,20.67%,1
臺北市,信義區,0691,262,397,659,48,707,1258,56.2%,20.83%,1
臺北市,信義區,0692,292,429,721,53,774,1277,60.61%,22.87%,1
臺北市,信義區,0693,285,480,765,50,815,1285,63.42%,22.18%,1
臺北市,信義區,0694,274,424,698,41,739,1161,63.65%,23.6%,1
臺北市,信義區,0695,305,410,715,36,751,1299,57.81%,23.48%,1
臺北市,信義區,0696,255,429,684,38,722,1243,58.09%,20.51%,1
臺北市,信義區,0697,255,415,670,24,694,1197,57.98%,21.3%,1
臺北市,信義區,0698,308,456,764,21,785,1224,64.13%,25.16%,1
臺北市,信義區,0699,227,394,621,32,653,1147,56.93%,19.79%,1
臺北市,信義區,0700,224,381,605,22,627,1045,60%,21.44%,1
臺北市,信義區,0701,235,425,660,31,691,1096,63.05%,21.44%,1
臺北市,信義區,0702,240,394,634,13,647,1115,58.03%,21.52%,1
臺北市,信義區,0703,206,398,604,42,646,1117,57.83%,18.44%,1
臺北市,信義區,0704,223,293,516,22,538,1019,52.8%,21.88%,1
臺北市,信義區,0705,291,466,757,38,795,1346,59.06%,21.62%,1
臺北市,信義區,0706,275,504,779,25,804,1405,57.22%,19.57%,1
臺北市,信義區,0707,268,490,758,41,799,1356,58.92%,19.76%,1
臺北市,信義區,0708,293,481,774,32,806,1250,64.48%,23.44%,1
臺北市,信義區,0709,252,490,742,27,769,1254,61.32%,20.1%,1
臺北市,信義區,0710,287,461,748,19,767,1317,58.24%,21.79%,1
臺北市,信義區,0711,274,488,762,42,804,1271,63.26%,21.56%,1
臺北市,信義區,0712,203,326,529,33,562,979,57.41%,20.74%,1
臺北市,信義區,0713,199,345,544,30,574,1025,56%,19.41%,1
臺北市,信義區,0714,270,482,752,23,775,1512,51.26%,17.86%,1
臺北市,信義區,0715,357,505,862,33,895,1483,60.35%,24.07%,1
臺北市,信義區,0716,317,493,810,25,835,1359,61.44%,23.33%,1
臺北市,信義區,0717,302,529,831,12,843,1387,60.78%,21.77%,1
臺北市,信義區,0718,288,493,781,29,810,1455,55.67%,19.79%,1
臺北市,信義區,0719,299,533,832,31,863,1461,59.07%,20.47%,1
臺北市,信義區,0720,350,533,883,34,917,1532,59.86%,22.85%,1
臺北市,信義區,0721,261,376,637,31,668,1043,64.05%,25.02%,1
臺北市,信義區,0722,209,320,529,26,555,875,63.43%,23.89%,1
臺北市,信義區,0723,203,315,518,20,538,927,58.04%,21.9%,1
臺北市,信義區,0724,224,411,635,52,687,1119,61.39%,20.02%,1
臺北市,信義區,0725,313,503,816,55,871,1463,59.54%,21.39%,1
臺北市,信義區,0726,308,480,788,43,831,1293,64.27%,23.82%,1
臺北市,信義區,0727,328,518,846,34,880,1553,56.66%,21.12%,1
臺北市,信義區,0728,316,453,769,23,792,1360,58.24%,23.24%,1
臺北市,信義區,0729,301,495,796,39,835,1392,59.99%,21.62%,1
臺北市,信義區,0730,290,500,790,19,809,1377,58.75%,21.06%,1
臺北市,信義區,0731,298,483,781,21,802,1377,58.24%,21.64%,1
臺北市,信義區,0732,234,425,659,22,681,1269,53.66%,18.44%,1
臺北市,信義區,0733,285,491,776,68,844,1407,59.99%,20.26%,1
臺北市,信義區,0734,237,427,664,27,691,1172,58.96%,20.22%,1
臺北市,信義區,0735,249,429,678,22,700,1182,59.22%,21.07%,1
臺北市,信義區,0736,263,442,705,53,758,1255,60.4%,20.96%,1
臺北市,信義區,0737,326,552,878,31,909,1689,53.82%,19.3%,1
臺北市,信義區,0738,316,552,868,23,891,1605,55.51%,19.69%,1
臺北市,信義區,0739,205,425,630,25,655,1143,57.31%,17.94%,1
臺北市,信義區,0740,282,472,754,26,780,1440,54.17%,19.58%,1
臺北市,信義區,0741,301,519,820,38,858,1495,57.39%,20.13%,1
臺北市,信義區,0742,323,528,851,48,899,1514,59.38%,21.33%,1
臺北市,信義區,0743,282,495,777,40,817,1449,56.38%,19.46%,1
臺北市,信義區,0744,299,514,813,45,858,1401,61.24%,21.34%,1
臺北市,信義區,0745,240,398,638,20,658,1181,55.72%,20.32%,1
臺北市,信義區,0746,317,538,855,17,872,1376,63.37%,23.04%,1
臺北市,信義區,0747,274,559,833,42,875,1422,61.53%,19.27%,1
臺北市,信義區,0748,261,459,720,18,738,1267,58.25%,20.6%,1
臺北市,信義區,0749,266,387,653,20,673,1220,55.16%,21.8%,1
臺北市,信義區,0750,272,528,800,24,824,1562,52.75%,17.41%,1
臺北市,信義區,0751,320,483,803,27,830,1455,57.04%,21.99%,1
臺北市,信義區,0752,322,536,858,34,892,1605,55.58%,20.06%,1
臺北市,信義區,0753,334,652,986,32,1018,1626,62.61%,20.54%,1
臺北市,信義區,0754,361,555,916,25,941,1561,60.28%,23.13%,1
臺北市,信義區,0755,289,467,756,18,774,1547,50.03%,18.68%,1
臺北市,信義區,0756,291,455,746,22,768,1336,57.49%,21.78%,1
臺北市,信義區,0757,252,408,660,32,692,1314,52.66%,19.18%,1
臺北市,信義區,0758,261,436,697,30,727,1297,56.05%,20.12%,1
臺北市,信義區,0759,257,478,735,34,769,1366,56.3%,18.81%,1
臺北市,信義區,0760,300,494,794,51,845,1472,57.4%,20.38%,1
臺北市,信義區,0761,289,513,802,35,837,1450,57.72%,19.93%,1
臺北市,信義區,0762,269,460,729,44,773,1328,58.21%,20.26%,1
臺北市,信義區,0763,307,515,822,39,861,1399,61.54%,21.94%,1
臺北市,信義區,0764,303,498,801,48,849,1373,61.84%,22.07%,1
臺北市,信義區,0765,216,376,592,25,617,1099,56.14%,19.65%,1
臺北市,信義區,0766,260,413,673,37,710,1226,57.91%,21.21%,1
臺北市,信義區,0767,258,423,681,16,697,1267,55.01%,20.36%,1
臺北市,信義區,0768,288,571,859,41,900,1531,58.79%,18.81%,1
臺北市,信義區,0769,270,567,837,37,874,1438,60.78%,18.78%,1
臺北市,信義區,0770,344,553,897,21,918,1657,55.4%,20.76%,1
臺北市,信義區,0771,367,457,824,37,861,1621,53.12%,22.64%,1
臺北市,信義區,0772,327,554,881,24,905,1508,60.01%,21.68%,1
臺北市,信義區,0773,292,488,780,33,813,1334,60.94%,21.89%,1
臺北市,信義區,0774,200,362,562,33,595,1246,47.75%,16.05%,1
臺北市,信義區,0775,280,446,726,35,761,1196,63.63%,23.41%,1
臺北市,信義區,0776,278,437,715,24,739,1220,60.57%,22.79%,1
臺北市,信義區,0777,304,542,846,21,867,1538,56.37%,19.77%,1
臺北市,信義區,0778,321,569,890,55,945,1565,60.38%,20.51%,1
臺北市,信義區,0779,315,509,824,69,893,1621,55.09%,19.43%,1
臺北市,信義區,0780,302,495,797,44,841,1486,56.59%,20.32%,1
臺北市,信義區,0781,301,483,784,32,816,1507,54.15%,19.97%,1
臺北市,信義區,0782,317,542,859,42,901,1516,59.43%,20.91%,1
臺北市,信義區,0783,254,500,754,50,804,1287,62.47%,19.74%,1
臺北市,信義區,0784,187,334,521,40,561,1050,53.43%,17.81%,1
臺北市,信義區,0785,118,351,469,27,496,801,61.92%,14.73%,1
臺北市,大安區,1214,241,396,637,22,659,1184,55.66%,20.35%,1
臺北市,大安區,1215,234,393,627,34,661,1197,55.22%,19.55%,1
臺北市,大安區,1216,267,430,697,16,713,1221,58.39%,21.87%,1
臺北市,大安區,1217,244,480,724,22,746,1246,59.87%,19.58%,1
臺北市,大安區,1218,377,509,886,25,911,1478,61.64%,25.51%,1
臺北市,大安區,1219,317,410,727,32,759,1314,57.76%,24.12%,1
臺北市,大安區,1220,381,548,929,37,966,1594,60.6%,23.9%,1
臺北市,大安區,1221,318,514,832,24,856,1429,59.9%,22.25%,1
臺北市,大安區,1222,298,567,865,27,892,1452,61.43%,20.52%,1
臺北市,大安區,1223,380,505,885,20,905,1551,58.35%,24.5%,1
臺北市,大安區,1224,294,489,783,37,820,1335,61.42%,22.02%,1
臺北市,大安區,1225,239,395,634,27,661,1196,55.27%,19.98%,1
臺北市,大安區,1226,262,445,707,28,735,1339,54.89%,19.57%,1
臺北市,大安區,1227,346,462,808,28,836,1448,57.73%,23.9%,1
臺北市,大安區,1228,280,477,757,41,798,1373,58.12%,20.39%,1
臺北市,大安區,1229,287,507,794,47,841,1439,58.44%,19.94%,1
臺北市,大安區,1230,246,380,626,7,633,1174,53.92%,20.95%,1
臺北市,大安區,1231,223,378,601,15,616,1144,53.85%,19.49%,1
臺北市,大安區,1232,166,411,577,25,602,1119,53.8%,14.83%,1
臺北市,大安區,1233,187,293,480,21,501,1024,48.93%,18.26%,1
臺北市,大安區,1234,189,418,607,20,627,1032,60.76%,18.31%,1
臺北市,大安區,1235,222,543,765,26,791,1319,59.97%,16.83%,1
臺北市,大安區,1236,281,536,817,25,842,1369,61.5%,20.53%,1
臺北市,大安區,1237,320,445,765,38,803,1347,59.61%,23.76%,1
臺北市,大安區,1238,334,508,842,25,867,1655,52.39%,20.18%,1
臺北市,大安區,1239,284,505,789,26,815,1595,51.1%,17.81%,1
臺北市,大安區,1240,291,470,761,29,790,1429,55.28%,20.36%,1
臺北市,大安區,1241,252,431,683,24,707,1309,54.01%,19.25%,1
臺北市,大安區,1242,283,519,802,22,824,1508,54.64%,18.77%,1
臺北市,大安區,1243,286,405,691,39,730,1310,55.73%,21.83%,1
臺北市,大安區,1244,227,410,637,29,666,1233,54.01%,18.41%,1
臺北市,大安區,1245,254,406,660,38,698,1287,54.23%,19.74%,1
臺北市,大安區,1246,223,362,585,28,613,1147,53.44%,19.44%,1
臺北市,大安區,1247,244,419,663,17,680,1260,53.97%,19.37%,1
臺北市,大安區,1248,264,564,828,32,860,1377,62.45%,19.17%,1
臺北市,大安區,1249,265,391,656,61,717,1284,55.84%,20.64%,1
臺北市,大安區,1250,241,424,665,25,690,1314,52.51%,18.34%,1
臺北市,大安區,1251,249,410,659,25,684,1273,53.73%,19.56%,1
臺北市,大安區,1252,282,380,662,20,682,1146,59.51%,24.61%,1
臺北市,大安區,1253,286,463,749,20,769,1285,59.84%,22.26%,1
臺北市,大安區,1254,317,446,763,25,788,1297,60.76%,24.44%,1
臺北市,大安區,1255,252,405,657,33,690,1101,62.67%,22.89%,1
臺北市,大安區,1256,307,420,727,34,761,1310,58.09%,23.44%,1
臺北市,大安區,1257,322,510,832,39,871,1365,63.81%,23.59%,1
臺北市,大安區,1258,302,464,766,27,793,1372,57.8%,22.01%,1
臺北市,大安區,1259,289,424,713,24,737,1189,61.98%,24.31%,1
臺北市,大安區,1260,286,451,737,24,761,1256,60.59%,22.77%,1
臺北市,大安區,1261,274,400,674,32,706,1151,61.34%,23.81%,1
臺北市,大安區,1262,337,552,889,31,920,1501,61.29%,22.45%,1
臺北市,大安區,1263,318,577,895,19,914,1520,60.13%,20.92%,1
臺北市,大安區,1264,340,579,919,37,956,1529,62.52%,22.24%,1
臺北市,大安區,1265,367,565,932,33,965,1579,61.11%,23.24%,1
臺北市,大安區,1266,273,398,671,18,689,2619,26.31%,10.42%,1
臺北市,大安區,1267,294,444,738,19,757,1290,58.68%,22.79%,1
臺北市,大安區,1268,320,486,806,20,826,1307,63.2%,24.48%,1
臺北市,大安區,1269,393,501,894,23,917,1489,61.58%,26.39%,1
臺北市,大安區,1270,243,413,656,30,686,1097,62.53%,22.15%,1
臺北市,大安區,1271,308,448,756,24,780,1328,58.73%,23.19%,1
臺北市,大安區,1272,282,380,662,22,684,1189,57.53%,23.72%,1
臺北市,大安區,1273,289,449,738,20,758,1270,59.69%,22.76%,1
臺北市,大安區,1274,336,431,767,13,780,1349,57.82%,24.91%,1
臺北市,大安區,1275,305,406,711,25,736,1292,56.97%,23.61%,1
臺北市,大安區,1276,306,471,777,33,810,1314,61.64%,23.29%,1
臺北市,大安區,1277,289,409,698,35,733,1200,61.08%,24.08%,1
臺北市,大安區,1278,338,540,878,29,907,1558,58.22%,21.69%,1
臺北市,大安區,1279,340,533,873,26,899,1561,57.59%,21.78%,1
臺北市,大安區,1280,309,513,822,30,852,1446,58.92%,21.37%,1
臺北市,大安區,1281,344,524,868,28,896,1499,59.77%,22.95%,1
臺北市,大安區,1282,301,542,843,20,863,1467,58.83%,20.52%,1
臺北市,大安區,1283,301,500,801,26,827,1511,54.73%,19.92%,1
臺北市,大安區,1284,335,572,907,48,955,1600,59.69%,20.94%,1
臺北市,大安區,1285,350,550,900,36,936,1573,59.5%,22.25%,1
臺北市,大安區,1286,324,559,883,38,921,1467,62.78%,22.09%,1
臺北市,大安區,1287,259,505,764,36,800,1358,58.91%,19.07%,1
臺北市,大安區,1288,329,545,874,33,907,1568,57.84%,20.98%,1
臺北市,大安區,1289,319,497,816,33,849,1411,60.17%,22.61%,1
臺北市,大安區,1290,322,536,858,20,878,1554,56.5%,20.72%,1
臺北市,大安區,1291,300,494,794,32,826,1345,61.41%,22.3%,1
臺北市,大安區,1292,311,520,831,13,844,1435,58.82%,21.67%,1
臺北市,大安區,1293,307,605,912,20,932,1481,62.93%,20.73%,1
臺北市,大安區,1294,322,584,906,26,932,1451,64.23%,22.19%,1
臺北市,大安區,1295,323,665,988,47,1035,1566,66.09%,20.63%,1
臺北市,大安區,1296,338,536,874,24,898,1525,58.89%,22.16%,1
臺北市,大安區,1297,268,443,711,42,753,1336,56.36%,20.06%,1
臺北市,大安區,1298,293,549,842,50,892,1483,60.15%,19.76%,1
臺北市,大安區,1299,272,445,717,17,734,1396,52.58%,19.48%,1
臺北市,大安區,1300,325,497,822,46,868,1406,61.74%,23.12%,1
臺北市,大安區,1301,325,506,831,33,864,1434,60.25%,22.66%,1
臺北市,大安區,1302,364,362,726,33,759,1288,58.93%,28.26%,1
臺北市,大安區,1303,290,508,798,34,832,1407,59.13%,20.61%,1
臺北市,大安區,1304,410,393,803,31,834,1514,55.09%,27.08%,1
臺北市,大安區,1305,256,472,728,50,778,1550,50.19%,16.52%,1
臺北市,大安區,1306,287,546,833,41,874,1490,58.66%,19.26%,1
臺北市,大安區,1307,284,422,706,25,731,1284,56.93%,22.12%,1
臺北市,大安區,1308,241,419,660,24,684,1129,60.58%,21.35%,1
臺北市,大安區,1309,269,418,687,23,710,1193,59.51%,22.55%,1
臺北市,大安區,1310,201,375,576,25,601,1057,56.86%,19.02%,1
臺北市,大安區,1311,314,435,749,42,791,1361,58.12%,23.07%,1
臺北市,大安區,1312,259,490,749,48,797,1412,56.44%,18.34%,1
臺北市,大安區,1313,252,421,673,22,695,1423,48.84%,17.71%,1
臺北市,大安區,1314,272,409,681,55,736,1257,58.55%,21.64%,1
臺北市,大安區,1315,226,452,678,27,705,1133,62.22%,19.95%,1
臺北市,大安區,1316,235,371,606,24,630,1077,58.5%,21.82%,1
臺北市,大安區,1317,300,451,751,35,786,1300,60.46%,23.08%,1
臺北市,大安區,1318,278,493,771,50,821,1319,62.24%,21.08%,1
臺北市,大安區,1319,255,451,706,50,756,1265,59.76%,20.16%,1
臺北市,大安區,1320,228,435,663,31,694,1265,54.86%,18.02%,1
臺北市,大安區,1321,244,394,638,29,667,1103,60.47%,22.12%,1
臺北市,大安區,1322,275,495,770,32,802,1341,59.81%,20.51%,1
臺北市,大安區,1323,285,499,784,39,823,1357,60.65%,21%,1
臺北市,大安區,1324,284,436,720,32,752,1260,59.68%,22.54%,1
臺北市,大安區,1325,292,438,730,39,769,1295,59.38%,22.55%,1
臺北市,大安區,1326,282,444,726,29,755,1399,53.97%,20.16%,1
臺北市,大安區,1327,243,394,637,26,663,1150,57.65%,21.13%,1
臺北市,大安區,1328,267,423,690,24,714,1351,52.85%,19.76%,1
臺北市,大安區,1329,317,440,757,37,794,1341,59.21%,23.64%,1
臺北市,大安區,1330,211,398,609,21,630,1129,55.8%,18.69%,1
臺北市,大安區,1331,255,482,737,23,760,1328,57.23%,19.2%,1
臺北市,大安區,1332,296,663,959,23,982,1557,63.07%,19.01%,1
臺北市,大安區,1333,295,599,894,33,927,1461,63.45%,20.19%,1
臺北市,大安區,1334,290,512,802,23,825,1589,51.92%,18.25%,1
臺北市,大安區,1335,275,528,803,29,832,1473,56.48%,18.67%,1
臺北市,大安區,1336,343,463,806,32,838,1479,56.66%,23.19%,1
臺北市,大安區,1337,161,329,490,33,523,833,62.79%,19.33%,1
臺北市,大安區,1338,219,331,550,23,573,999,57.36%,21.92%,1
臺北市,大安區,1339,391,632,1023,22,1045,1757,59.48%,22.25%,1
臺北市,大安區,1340,321,583,904,33,937,1573,59.57%,20.41%,1
臺北市,大安區,1341,352,603,955,26,981,1587,61.81%,22.18%,1
臺北市,大安區,1342,343,525,868,46,914,1496,61.1%,22.93%,1
臺北市,大安區,1343,377,459,836,34,870,1440,60.42%,26.18%,1
臺北市,大安區,1344,354,577,931,32,963,1578,61.03%,22.43%,1
臺北市,大安區,1345,292,419,711,22,733,1223,59.93%,23.88%,1
臺北市,大安區,1346,269,278,547,21,568,1119,50.76%,24.04%,1
臺北市,大安區,1347,295,456,751,21,772,1252,61.66%,23.56%,1
臺北市,大安區,1348,374,535,909,40,949,1576,60.22%,23.73%,1
臺北市,大安區,1349,300,498,798,28,826,1425,57.96%,21.05%,1
臺北市,大安區,1350,312,462,774,23,797,1450,54.97%,21.52%,1
臺北市,大安區,1351,277,515,792,26,818,1444,56.65%,19.18%,1
臺北市,大安區,1352,341,475,816,32,848,1337,63.43%,25.5%,1
臺北市,大安區,1353,269,492,761,31,792,1417,55.89%,18.98%,1
臺北市,大安區,1354,266,431,697,33,730,1250,58.4%,21.28%,1
臺北市,大安區,1355,230,425,655,28,683,1176,58.08%,19.56%,1
臺北市,大安區,1356,279,454,733,37,770,1257,61.26%,22.2%,1
臺北市,大安區,1357,253,454,707,39,746,1257,59.35%,20.13%,1
臺北市,大安區,1358,257,398,655,29,684,1148,59.58%,22.39%,1
臺北市,大安區,1359,299,494,793,36,829,1418,58.46%,21.09%,1
臺北市,大安區,1360,217,360,577,19,596,1028,57.98%,21.11%,1
臺北市,大安區,1361,347,496,843,29,872,1445,60.35%,24.01%,1
臺北市,大安區,1362,293,483,776,38,814,1361,59.81%,21.53%,1
臺北市,大安區,1363,157,629,786,42,828,1343,61.65%,11.69%,1
臺北市,大安區,1364,283,443,726,32,758,1267,59.83%,22.34%,1
臺北市,大安區,1365,295,431,726,24,750,1380,54.35%,21.38%,1
臺北市,大安區,1366,311,519,830,39,869,1524,57.02%,20.41%,1
臺北市,大安區,1367,311,537,848,30,878,1470,59.73%,21.16%,1
臺北市,大安區,1368,243,413,656,40,696,1318,52.81%,18.44%,1
臺北市,大安區,1369,271,459,730,49,779,1430,54.48%,18.95%,1
臺北市,大安區,1370,267,499,766,34,800,1386,57.72%,19.26%,1
臺北市,大安區,1371,266,486,752,21,773,1438,53.76%,18.5%,1
臺北市,大安區,1372,228,419,647,22,669,1270,52.68%,17.95%,1
臺北市,大安區,1373,281,465,746,36,782,1395,56.06%,20.14%,1
臺北市,大安區,1374,261,458,719,24,743,1292,57.51%,20.2%,1
臺北市,大安區,1375,289,418,707,30,737,1310,56.26%,22.06%,1
臺北市,大安區,1376,277,449,726,32,758,1319,57.47%,21%,1
臺北市,大安區,1377,293,481,774,23,797,1355,58.82%,21.62%,1
臺北市,大安區,1378,269,419,688,20,708,1312,53.96%,20.5%,1
臺北市,大安區,1379,271,463,734,26,760,1335,56.93%,20.3%,1
臺北市,大安區,1380,295,473,768,26,794,1489,53.32%,19.81%,1
臺北市,大安區,1381,277,471,748,24,772,1307,59.07%,21.19%,1
臺北市,大安區,1382,265,415,680,22,702,1328,52.86%,19.95%,1
臺北市,大安區,1383,276,423,699,9,708,1277,55.44%,21.61%,1
臺北市,大安區,1384,271,457,728,34,762,1314,57.99%,20.62%,1
臺北市,大安區,1385,283,453,736,27,763,1270,60.08%,22.28%,1
臺北市,大安區,1386,302,394,696,62,758,1308,57.95%,23.09%,1
臺北市,大安區,1387,258,403,661,24,685,1138,60.19%,22.67%,1
臺北市,大安區,1388,283,432,715,29,744,1333,55.81%,21.23%,1
臺北市,大安區,1389,247,407,654,32,686,1176,58.33%,21%,1
臺北市,大安區,1390,262,445,707,37,744,1311,56.75%,19.98%,1
臺北市,大安區,1391,233,470,703,20,723,1295,55.83%,17.99%,1
臺北市,大安區,1392,265,526,791,43,834,1421,58.69%,18.65%,1
臺北市,大安區,1393,287,469,756,30,786,1409,55.78%,20.37%,1
臺北市,大安區,1394,305,512,817,26,843,1434,58.79%,21.27%,1
臺北市,大安區,1395,289,449,738,44,782,1449,53.97%,19.94%,1
臺北市,大安區,1396,282,450,732,28,760,1284,59.19%,21.96%,1
臺北市,大安區,1397,268,432,700,18,718,1248,57.53%,21.47%,1
臺北市,大安區,1398,271,442,713,23,736,1119,65.77%,24.22%,1
臺北市,大安區,1399,183,326,509,32,541,883,61.27%,20.72%,1
臺北市,大安區,1400,81,241,322,40,362,630,57.46%,12.86%,1
臺北市,大安區,1401,183,268,451,32,483,814,59.34%,22.48%,1
臺北市,中山區,0786,331,517,848,28,876,1522,57.56%,21.75%,1
臺北市,中山區,0787,275,350,625,25,650,1332,48.8%,20.65%,1
臺北市,中山區,0788,321,478,799,39,838,1656,50.6%,19.38%,1
臺北市,中山區,0789,269,402,671,37,708,1367,51.79%,19.68%,1
臺北市,中山區,0790,339,523,862,33,895,1732,51.67%,19.57%,1
臺北市,中山區,0791,351,547,898,43,941,1634,57.59%,21.48%,1
臺北市,中山區,0792,332,521,853,42,895,1650,54.24%,20.12%,1
臺北市,中山區,0793,298,491,789,35,824,1392,59.2%,21.41%,1
臺北市,中山區,0794,300,295,595,30,625,1177,53.1%,25.49%,1
臺北市,中山區,0795,350,499,849,35,884,1477,59.85%,23.7%,1
臺北市,中山區,0796,211,324,535,46,581,1063,54.66%,19.85%,1
臺北市,中山區,0797,232,441,673,33,706,1296,54.48%,17.9%,1
臺北市,中山區,0798,277,401,678,35,713,1330,53.61%,20.83%,1
臺北市,中山區,0799,287,467,754,53,807,1483,54.42%,19.35%,1
臺北市,中山區,0800,314,480,794,34,828,1542,53.7%,20.36%,1
臺北市,中山區,0801,352,483,835,47,882,1710,51.58%,20.58%,1
臺北市,中山區,0802,250,407,657,20,677,1315,51.48%,19.01%,1
臺北市,中山區,0803,240,424,664,47,711,1245,57.11%,19.28%,1
臺北市,中山區,0804,226,432,658,30,688,1262,54.52%,17.91%,1
臺北市,中山區,0805,350,476,826,53,879,1518,57.91%,23.06%,1
臺北市,中山區,0806,321,504,825,49,874,1522,57.42%,21.09%,1
臺北市,中山區,0807,301,481,782,46,828,1580,52.41%,19.05%,1
臺北市,中山區,0808,351,481,832,28,860,1529,56.25%,22.96%,1
臺北市,中山區,0809,252,389,641,36,677,1221,55.45%,20.64%,1
臺北市,中山區,0810,261,442,703,26,729,1221,59.71%,21.38%,1
臺北市,中山區,0811,206,342,548,26,574,1139,50.4%,18.09%,1
臺北市,中山區,0812,285,469,754,52,806,1407,57.29%,20.26%,1
臺北市,中山區,0813,317,414,731,28,759,1321,57.46%,24%,1
臺北市,中山區,0814,291,480,771,26,797,1578,50.51%,18.44%,1
臺北市,中山區,0815,311,542,853,40,893,1739,51.35%,17.88%,1
臺北市,中山區,0816,331,487,818,38,856,1637,52.29%,20.22%,1
臺北市,中山區,0817,317,478,795,47,842,1541,54.64%,20.57%,1
臺北市,中山區,0818,280,413,693,28,721,1210,59.59%,23.14%,1
臺北市,中山區,0819,389,415,804,35,839,1331,63.04%,29.23%,1
臺北市,中山區,0820,250,348,598,43,641,1224,52.37%,20.42%,1
臺北市,中山區,0821,293,576,869,44,913,1585,57.6%,18.49%,1
臺北市,中山區,0822,345,551,896,51,947,1523,62.18%,22.65%,1
臺北市,中山區,0823,294,509,803,39,842,1368,61.55%,21.49%,1
臺北市,中山區,0824,291,702,993,38,1031,1805,57.12%,16.12%,1
臺北市,中山區,0825,235,567,802,25,827,1404,58.9%,16.74%,1
臺北市,中山區,0826,428,624,1052,36,1088,1708,63.7%,25.06%,1
臺北市,中山區,0827,365,511,876,43,919,1451,63.34%,25.16%,1
臺北市,中山區,0828,369,591,960,34,994,1684,59.03%,21.91%,1
臺北市,中山區,0829,312,573,885,20,905,1585,57.1%,19.68%,1
臺北市,中山區,0830,294,487,781,60,841,1391,60.46%,21.14%,1
臺北市,中山區,0831,309,544,853,54,907,1375,65.96%,22.47%,1
臺北市,中山區,0832,363,501,864,17,881,1472,59.85%,24.66%,1
臺北市,中山區,0833,276,432,708,31,739,1327,55.69%,20.8%,1
臺北市,中山區,0834,345,467,812,16,828,1401,59.1%,24.63%,1
臺北市,中山區,0835,284,530,814,33,847,1423,59.52%,19.96%,1
臺北市,中山區,0836,367,534,901,26,927,1569,59.08%,23.39%,1
臺北市,中山區,0837,380,559,939,23,962,1651,58.27%,23.02%,1
臺北市,中山區,0838,382,501,883,21,904,1624,55.67%,23.52%,1
臺北市,中山區,0839,468,551,1019,36,1055,1713,61.59%,27.32%,1
臺北市,中山區,0840,364,583,947,43,990,1647,60.11%,22.1%,1
臺北市,中山區,0841,326,591,917,32,949,1762,53.86%,18.5%,1
臺北市,中山區,0842,274,551,825,36,861,1399,61.54%,19.59%,1
臺北市,中山區,0843,334,553,887,36,923,1489,61.99%,22.43%,1
臺北市,中山區,0844,290,470,760,27,787,1269,62.02%,22.85%,1
臺北市,中山區,0845,205,401,606,28,634,998,63.53%,20.54%,1
臺北市,中山區,0846,312,477,789,43,832,1472,56.52%,21.2%,1
臺北市,中山區,0847,331,452,783,45,828,1517,54.58%,21.82%,1
臺北市,中山區,0848,362,608,970,53,1023,1704,60.04%,21.24%,1
臺北市,中山區,0849,346,535,881,45,926,1603,57.77%,21.58%,1
臺北市,中山區,0850,285,455,740,56,796,1432,55.59%,19.9%,1
臺北市,中山區,0851,340,491,831,67,898,1500,59.87%,22.67%,1
臺北市,中山區,0852,296,489,785,34,819,1332,61.49%,22.22%,1
臺北市,中山區,0853,331,517,848,43,891,1450,61.45%,22.83%,1
臺北市,中山區,0854,357,485,842,38,880,1434,61.37%,24.9%,1
臺北市,中山區,0855,282,476,758,38,796,1419,56.1%,19.87%,1
臺北市,中山區,0856,263,440,703,33,736,1292,56.97%,20.36%,1
臺北市,中山區,0857,336,468,804,45,849,1526,55.64%,22.02%,1
臺北市,中山區,0858,302,455,757,42,799,1582,50.51%,19.09%,1
臺北市,中山區,0859,316,471,787,42,829,1588,52.2%,19.9%,1
臺北市,中山區,0860,294,528,822,52,874,1463,59.74%,20.1%,1
臺北市,中山區,0861,337,418,755,39,794,1533,51.79%,21.98%,1
臺北市,中山區,0862,183,307,490,42,532,944,56.36%,19.39%,1
臺北市,中山區,0863,374,657,1031,59,1090,1745,62.46%,21.43%,1
臺北市,中山區,0864,337,467,804,38,842,1679,50.15%,20.07%,1
臺北市,中山區,0865,311,471,782,41,823,3419,24.07%,9.1%,1
臺北市,中山區,0866,321,468,789,46,835,1387,60.2%,23.14%,1
臺北市,中山區,0867,369,571,940,52,992,1672,59.33%,22.07%,1
臺北市,中山區,0868,287,440,727,49,776,1319,58.83%,21.76%,1
臺北市,中山區,0869,284,446,730,42,772,1364,56.6%,20.82%,1
臺北市,中山區,0870,320,452,772,45,817,1461,55.92%,21.9%,1
臺北市,中山區,0871,262,395,657,41,698,1173,59.51%,22.34%,1
臺北市,中山區,0872,245,371,616,41,657,1171,56.11%,20.92%,1
臺北市,中山區,0873,312,404,716,28,744,1310,56.79%,23.82%,1
臺北市,中山區,0874,300,438,738,43,781,1373,56.88%,21.85%,1
臺北市,中山區,0875,303,468,771,28,799,1290,61.94%,23.49%,1
臺北市,中山區,0876,289,474,763,40,803,1346,59.66%,21.47%,1
臺北市,中山區,0877,358,479,837,53,890,1468,60.63%,24.39%,1
臺北市,中山區,0878,264,422,686,24,710,1178,60.27%,22.41%,1
臺北市,中山區,0879,368,585,953,38,991,1654,59.92%,22.25%,1
臺北市,中山區,0880,333,485,818,42,860,1464,58.74%,22.75%,1
臺北市,中山區,0881,304,476,780,39,819,1450,56.48%,20.97%,1
臺北市,中山區,0882,340,494,834,37,871,1534,56.78%,22.16%,1
臺北市,中山區,0883,364,556,920,47,967,1703,56.78%,21.37%,1
臺北市,中山區,0884,338,572,910,47,957,1610,59.44%,20.99%,1
臺北市,中山區,0885,379,566,945,52,997,1653,60.31%,22.93%,1
臺北市,中山區,0886,426,556,982,51,1033,1694,60.98%,25.15%,1
臺北市,中山區,0887,325,537,862,40,902,1623,55.58%,20.02%,1
臺北市,中山區,0888,361,540,901,43,944,1618,58.34%,22.31%,1
臺北市,中山區,0889,329,518,847,49,896,1583,56.6%,20.78%,1
臺北市,中山區,0890,390,526,916,48,964,1605,60.06%,24.3%,1
臺北市,中山區,0891,330,512,842,48,890,1398,63.66%,23.61%,1
臺北市,中山區,0892,393,547,940,51,991,1526,64.94%,25.75%,1
臺北市,中山區,0893,354,521,875,41,916,1555,58.91%,22.77%,1
臺北市,中山區,0894,327,532,859,35,894,1597,55.98%,20.48%,1
臺北市,中山區,0895,369,507,876,61,937,1587,59.04%,23.25%,1
臺北市,中山區,0896,391,536,927,37,964,1587,60.74%,24.64%,1
臺北市,中山區,0897,367,540,907,47,954,1546,61.71%,23.74%,1
臺北市,中山區,0898,244,463,707,48,755,1322,57.11%,18.46%,1
臺北市,中山區,0899,262,447,709,32,741,1267,58.48%,20.68%,1
臺北市,中山區,0900,253,414,667,20,687,1210,56.78%,20.91%,1
臺北市,中山區,0901,257,448,705,43,748,1295,57.76%,19.85%,1
臺北市,中山區,0902,325,523,848,41,889,1467,60.6%,22.15%,1
臺北市,中山區,0903,281,622,903,39,942,1491,63.18%,18.85%,1
臺北市,中山區,0904,320,625,945,44,989,1516,65.24%,21.11%,1
臺北市,中山區,0905,294,427,721,24,745,1384,53.83%,21.24%,1
臺北市,中山區,0906,316,366,682,47,729,1138,64.06%,27.77%,1
臺北市,中山區,0907,313,468,781,33,814,1513,53.8%,20.69%,1
臺北市,中山區,0908,353,527,880,47,927,1559,59.46%,22.64%,1
臺北市,中山區,0909,315,513,828,58,886,1429,62%,22.04%,1
臺北市,中山區,0910,295,449,744,27,771,1245,61.93%,23.69%,1
臺北市,中山區,0911,267,459,726,42,768,1214,63.26%,21.99%,1
臺北市,中山區,0912,314,503,817,26,843,1394,60.47%,22.53%,1
臺北市,中山區,0913,276,430,706,17,723,1336,54.12%,20.66%,1
臺北市,中山區,0914,281,389,670,35,705,1227,57.46%,22.9%,1
臺北市,中山區,0915,281,481,762,40,802,1382,58.03%,20.33%,1
臺北市,中山區,0916,263,510,773,48,821,1436,57.17%,18.31%,1
臺北市,中山區,0917,298,397,695,44,739,1405,52.6%,21.21%,1
臺北市,中山區,0918,262,442,704,24,728,1259,57.82%,20.81%,1
臺北市,中正區,1001,292,466,758,33,791,1308,60.47%,22.32%,1
臺北市,中正區,1002,269,432,701,43,744,1317,56.49%,20.43%,1
臺北市,中正區,1003,223,418,641,23,664,1069,62.11%,20.86%,1
臺北市,中正區,1004,228,373,601,31,632,1128,56.03%,20.21%,1
臺北市,中正區,1005,237,370,607,39,646,1053,61.35%,22.51%,1
臺北市,中正區,1006,225,386,611,11,622,1048,59.35%,21.47%,1
臺北市,中正區,1007,244,455,699,42,741,1297,57.13%,18.81%,1
臺北市,中正區,1008,255,448,703,20,723,1193,60.6%,21.37%,1
臺北市,中正區,1009,341,599,940,35,975,1500,65%,22.73%,1
臺北市,中正區,1010,294,440,734,31,765,1346,56.84%,21.84%,1
臺北市,中正區,1011,283,435,718,16,734,1283,57.21%,22.06%,1
臺北市,中正區,1012,339,459,798,31,829,1450,57.17%,23.38%,1
臺北市,中正區,1013,326,496,822,34,856,1433,59.73%,22.75%,1
臺北市,中正區,1014,325,493,818,44,862,1309,65.85%,24.83%,1
臺北市,中正區,1015,304,518,822,12,834,1386,60.17%,21.93%,1
臺北市,中正區,1016,265,429,694,34,728,1201,60.62%,22.06%,1
臺北市,中正區,1017,300,493,793,30,823,1336,61.6%,22.46%,1
臺北市,中正區,1018,307,492,799,31,830,1358,61.12%,22.61%,1
臺北市,中正區,1019,260,424,684,36,720,1177,61.17%,22.09%,1
臺北市,中正區,1020,263,493,756,27,783,1236,63.35%,21.28%,1
臺北市,中正區,1021,290,526,816,44,860,1478,58.19%,19.62%,1
臺北市,中正區,1022,322,533,855,26,881,1474,59.77%,21.85%,1
臺北市,中正區,1023,250,408,658,35,693,1172,59.13%,21.33%,1
臺北市,中正區,1024,276,447,723,48,771,1310,58.85%,21.07%,1
臺北市,中正區,1025,246,474,720,39,759,1263,60.1%,19.48%,1
臺北市,中正區,1026,261,411,672,36,708,1169,60.56%,22.33%,1
臺北市,中正區,1027,292,505,797,18,815,1391,58.59%,20.99%,1
臺北市,中正區,1028,225,435,660,19,679,1201,56.54%,18.73%,1
臺北市,中正區,1029,272,494,766,30,796,1324,60.12%,20.54%,1
臺北市,中正區,1030,221,426,647,43,690,1216,56.74%,18.17%,1
臺北市,中正區,1031,249,399,648,41,689,1183,58.24%,21.05%,1
臺北市,中正區,1032,325,508,833,59,892,1469,60.72%,22.12%,1
臺北市,中正區,1033,305,486,791,32,823,1411,58.33%,21.62%,1
臺北市,中正區,1034,284,486,770,75,845,1398,60.44%,20.31%,1
臺北市,中正區,1035,263,517,780,67,847,1479,57.27%,17.78%,1
臺北市,中正區,1036,319,544,863,51,914,1620,56.42%,19.69%,1
臺北市,中正區,1037,232,370,602,13,615,1041,59.08%,22.29%,1
臺北市,中正區,1038,244,355,599,16,615,1056,58.24%,23.11%,1
臺北市,中正區,1039,249,409,658,23,681,1063,64.06%,23.42%,1
臺北市,中正區,1040,244,467,711,38,749,1591,47.08%,15.34%,1
臺北市,中正區,1041,222,445,667,51,718,1502,47.8%,14.78%,1
臺北市,中正區,1042,236,432,668,47,715,1331,53.72%,17.73%,1
臺北市,中正區,1043,261,500,761,56,817,1441,56.7%,18.11%,1
臺北市,中正區,1044,300,468,768,31,799,1273,62.77%,23.57%,1
臺北市,中正區,1045,227,449,676,23,699,1133,61.69%,20.04%,1
臺北市,中正區,1046,199,468,667,26,693,1156,59.95%,17.21%,1
臺北市,中正區,1047,300,460,760,40,800,1377,58.1%,21.79%,1
臺北市,中正區,1048,254,480,734,50,784,1266,61.93%,20.06%,1
臺北市,中正區,1049,235,454,689,25,714,1111,64.27%,21.15%,1
臺北市,中正區,1050,263,390,653,26,679,1124,60.41%,23.4%,1
臺北市,中正區,1051,306,519,825,28,853,1373,62.13%,22.29%,1
臺北市,中正區,1052,292,519,811,27,838,1351,62.03%,21.61%,1
臺北市,中正區,1053,324,542,866,25,891,1495,59.6%,21.67%,1
臺北市,中正區,1054,341,545,886,33,919,1436,64%,23.75%,1
臺北市,中正區,1055,319,532,851,21,872,1516,57.52%,21.04%,1
臺北市,中正區,1056,284,491,775,32,807,1374,58.73%,20.67%,1
臺北市,中正區,1057,289,525,814,25,839,1522,55.12%,18.99%,1
臺北市,中正區,1058,291,582,873,27,900,1336,67.37%,21.78%,1
臺北市,中正區,1059,358,528,886,32,918,1551,59.19%,23.08%,1
臺北市,中正區,1060,339,571,910,46,956,1594,59.97%,21.27%,1
臺北市,中正區,1061,316,518,834,39,873,1503,58.08%,21.02%,1
臺北市,中正區,1062,289,552,841,23,864,1455,59.38%,19.86%,1
臺北市,中正區,1063,309,512,821,15,836,1439,58.1%,21.47%,1
臺北市,中正區,1064,306,521,827,38,865,1469,58.88%,20.83%,1
臺北市,中正區,1065,245,597,842,33,875,1430,61.19%,17.13%,1
臺北市,中正區,1066,316,547,863,29,892,1444,61.77%,21.88%,1
臺北市,中正區,1067,254,467,721,19,740,1254,59.01%,20.26%,1
臺北市,中正區,1068,206,328,534,38,572,932,61.37%,22.1%,1
臺北市,中正區,1069,235,378,613,32,645,1055,61.14%,22.27%,1
臺北市,中正區,1070,251,445,696,26,722,1226,58.89%,20.47%,1
臺北市,中正區,1071,236,465,701,34,735,1390,52.88%,16.98%,1
臺北市,中正區,1072,289,462,751,28,779,1336,58.31%,21.63%,1
臺北市,中正區,1073,285,430,715,29,744,1419,52.43%,20.08%,1
臺北市,中正區,1074,307,493,800,46,846,1361,62.16%,22.56%,1
臺北市,中正區,1075,302,567,869,43,912,2520,36.19%,11.98%,1
臺北市,中正區,1076,254,458,712,11,723,1224,59.07%,20.75%,1
臺北市,中正區,1077,254,416,670,5,675,1272,53.07%,19.97%,1
臺北市,中正區,1078,331,462,793,26,819,1400,58.5%,23.64%,1
臺北市,中正區,1079,273,445,718,31,749,1319,56.79%,20.7%,1
臺北市,中正區,1080,263,462,725,41,766,1232,62.18%,21.35%,1
臺北市,中正區,1081,308,477,785,24,809,1265,63.95%,24.35%,1
臺北市,中正區,1082,250,403,653,20,673,1055,63.79%,23.7%,1
臺北市,中正區,1083,207,333,540,26,566,954,59.33%,21.7%,1
臺北市,中正區,1084,206,373,579,39,618,1018,60.71%,20.24%,1
臺北市,中正區,1085,301,489,790,20,810,1431,56.6%,21.03%,1
臺北市,中正區,1086,276,366,642,34,676,1271,53.19%,21.72%,1
臺北市,中正區,1087,227,364,591,25,616,983,62.67%,23.09%,1
臺北市,中正區,1088,334,550,884,28,912,1594,57.21%,20.95%,1
臺北市,中正區,1089,345,564,909,39,948,1565,60.58%,22.04%,1
臺北市,中正區,1090,342,587,929,28,957,1650,58%,20.73%,1
臺北市,中正區,1091,314,533,847,36,883,1600,55.19%,19.63%,1
臺北市,中正區,1092,293,471,764,30,794,1391,57.08%,21.06%,1
臺北市,中正區,1093,373,598,971,28,999,1769,56.47%,21.09%,1
臺北市,中正區,1094,342,510,852,32,884,1487,59.45%,23%,1
臺北市,中正區,1095,275,474,749,34,783,1291,60.65%,21.3%,1
臺北市,中正區,1096,300,450,750,30,780,1289,60.51%,23.27%,1
臺北市,大同區,0919,300,410,710,43,753,1261,59.71%,23.79%,1
臺北市,大同區,0920,317,477,794,42,836,1352,61.83%,23.45%,1
臺北市,大同區,0921,315,490,805,34,839,1462,57.39%,21.55%,1
臺北市,大同區,0922,324,503,827,44,871,1510,57.68%,21.46%,1
臺北市,大同區,0923,321,451,772,30,802,1496,53.61%,21.46%,1
臺北市,大同區,0924,274,433,707,48,755,1329,56.81%,20.62%,1
臺北市,大同區,0925,265,432,697,72,769,1307,58.84%,20.28%,1
臺北市,大同區,0926,242,348,590,43,633,1065,59.44%,22.72%,1
臺北市,大同區,0927,259,354,613,18,631,1085,58.16%,23.87%,1
臺北市,大同區,0928,257,374,631,41,672,1047,64.18%,24.55%,1
臺北市,大同區,0929,293,333,626,30,656,1215,53.99%,24.12%,1
臺北市,大同區,0930,293,373,666,35,701,1117,62.76%,26.23%,1
臺北市,大同區,0931,279,413,692,39,731,1186,61.64%,23.52%,1
臺北市,大同區,0932,248,428,676,51,727,1185,61.35%,20.93%,1
臺北市,大同區,0933,277,478,755,37,792,1359,58.28%,20.38%,1
臺北市,大同區,0934,259,457,716,25,741,1273,58.21%,20.35%,1
臺北市,大同區,0935,339,374,713,40,753,1291,58.33%,26.26%,1
臺北市,大同區,0936,275,410,685,32,717,1288,55.67%,21.35%,1
臺北市,大同區,0937,299,455,754,31,785,1245,63.05%,24.02%,1
臺北市,大同區,0938,319,426,745,43,788,1261,62.49%,25.3%,1
臺北市,大同區,0939,293,432,725,28,753,1348,55.86%,21.74%,1
臺北市,大同區,0940,387,533,920,68,988,1676,58.95%,23.09%,1
臺北市,大同區,0941,276,497,773,33,806,1311,61.48%,21.05%,1
臺北市,大同區,0942,295,448,743,58,801,1316,60.87%,22.42%,1
臺北市,大同區,0943,332,438,770,57,827,1409,58.69%,23.56%,1
臺北市,大同區,0944,351,473,824,48,872,1436,60.72%,24.44%,1
臺北市,大同區,0945,307,477,784,45,829,1408,58.88%,21.8%,1
臺北市,大同區,0946,260,436,696,39,735,1276,57.6%,20.38%,1
臺北市,大同區,0947,219,398,617,20,637,1110,57.39%,19.73%,1
臺北市,大同區,0948,310,451,761,20,781,1324,58.99%,23.41%,1
臺北市,大同區,0949,195,360,555,44,599,1016,58.96%,19.19%,1
臺北市,大同區,0950,233,378,611,33,644,1028,62.65%,22.67%,1
臺北市,大同區,0951,231,429,660,39,699,1158,60.36%,19.95%,1
臺北市,大同區,0952,237,434,671,30,701,1138,61.6%,20.83%,1
臺北市,大同區,0953,254,453,707,29,736,1214,60.63%,20.92%,1
臺北市,大同區,0954,224,392,616,23,639,1090,58.62%,20.55%,1
臺北市,大同區,0955,308,419,727,47,774,1305,59.31%,23.6%,1
臺北市,大同區,0956,237,388,625,28,653,1167,55.96%,20.31%,1
臺北市,大同區,0957,252,387,639,39,678,1148,59.06%,21.95%,1
臺北市,大同區,0958,287,433,720,30,750,1203,62.34%,23.86%,1
臺北市,大同區,0959,320,452,772,37,809,1441,56.14%,22.21%,1
臺北市,大同區,0960,477,294,771,51,822,1315,62.51%,36.27%,1
臺北市,大同區,0961,315,450,765,40,805,1393,57.79%,22.61%,1
臺北市,大同區,0962,214,520,734,39,773,1278,60.49%,16.74%,1
臺北市,大同區,0963,355,299,654,38,692,1246,55.54%,28.49%,1
臺北市,大同區,0964,232,380,612,53,665,1142,58.23%,20.32%,1
臺北市,大同區,0965,297,478,775,47,822,1336,61.53%,22.23%,1
臺北市,大同區,0966,325,471,796,41,837,1363,61.41%,23.84%,1
臺北市,大同區,0967,303,547,850,28,878,1476,59.49%,20.53%,1
臺北市,大同區,0968,357,438,795,47,842,1418,59.38%,25.18%,1
臺北市,大同區,0969,294,479,773,30,803,1460,55%,20.14%,1
臺北市,大同區,0970,252,347,599,38,637,1222,52.13%,20.62%,1
臺北市,大同區,0971,222,356,578,73,651,1246,52.25%,17.82%,1
臺北市,大同區,0972,279,460,739,47,786,1256,62.58%,22.21%,1
臺北市,大同區,0973,280,444,724,28,752,1289,58.34%,21.72%,1
臺北市,大同區,0974,291,429,720,24,744,1340,55.52%,21.72%,1
臺北市,大同區,0975,322,473,795,42,837,1555,53.83%,20.71%,1
臺北市,大同區,0976,274,508,782,56,838,2459,34.08%,11.14%,1
臺北市,大同區,0977,176,305,481,56,537,1108,48.47%,15.88%,1
臺北市,大同區,0978,160,288,448,37,485,867,55.94%,18.45%,1
臺北市,大同區,0979,326,440,766,56,822,1329,61.85%,24.53%,1
臺北市,大同區,0980,281,358,639,37,676,1162,58.18%,24.18%,1
臺北市,大同區,0981,272,454,726,66,792,1434,55.23%,18.97%,1
臺北市,大同區,0982,315,428,743,51,794,1351,58.77%,23.32%,1
臺北市,大同區,0983,321,465,786,48,834,1531,54.47%,20.97%,1
臺北市,大同區,0984,328,420,748,24,772,1507,51.23%,21.77%,1
臺北市,大同區,0985,338,454,792,49,841,1488,56.52%,22.72%,1
臺北市,大同區,0986,325,472,797,58,855,1384,61.78%,23.48%,1
臺北市,大同區,0987,278,523,801,53,854,1460,58.49%,19.04%,1
臺北市,大同區,0988,310,478,788,45,833,1371,60.76%,22.61%,1
臺北市,大同區,0989,310,463,773,27,800,1439,55.59%,21.54%,1
臺北市,大同區,0990,335,443,778,58,836,1376,60.76%,24.35%,1
臺北市,大同區,0991,271,445,716,67,783,1366,57.32%,19.84%,1
臺北市,大同區,0992,297,440,737,49,786,1218,64.53%,24.38%,1
臺北市,大同區,0993,247,439,686,44,730,1235,59.11%,20%,1
臺北市,大同區,0994,234,486,720,19,739,1364,54.18%,17.16%,1
臺北市,大同區,0995,345,514,859,52,911,1408,64.7%,24.5%,1
臺北市,大同區,0996,326,473,799,52,851,1450,58.69%,22.48%,1
臺北市,大同區,0997,318,514,832,56,888,1429,62.14%,22.25%,1
臺北市,大同區,0998,259,399,658,58,716,1170,61.2%,22.14%,1
臺北市,大同區,0999,271,462,733,5,738,1245,59.28%,21.77%,1
臺北市,大同區,1000,302,428,730,60,790,1215,65.02%,24.86%,1
臺北市,萬華區,1097,291,446,737,47,784,1305,60.08%,22.3%,1
臺北市,萬華區,1098,192,357,549,55,604,1183,51.06%,16.23%,1
臺北市,萬華區,1099,228,406,634,22,656,1176,55.78%,19.39%,1
臺北市,萬華區,1100,239,346,585,26,611,1169,52.27%,20.44%,1
臺北市,萬華區,1101,231,473,704,37,741,1457,50.86%,15.85%,1
臺北市,萬華區,1102,266,438,704,56,760,1563,48.62%,17.02%,1
臺北市,萬華區,1103,341,505,846,23,869,1771,49.07%,19.25%,1
臺北市,萬華區,1104,331,464,795,39,834,1615,51.64%,20.5%,1
臺北市,萬華區,1105,314,451,765,67,832,1478,56.29%,21.24%,1
臺北市,萬華區,1106,293,481,774,27,801,1462,54.79%,20.04%,1
臺北市,萬華區,1107,226,467,693,43,736,1507,48.84%,15%,1
臺北市,萬華區,1108,287,455,742,47,789,1347,58.57%,21.31%,1
臺北市,萬華區,1109,263,427,690,43,733,1367,53.62%,19.24%,1
臺北市,萬華區,1110,296,449,745,39,784,1277,61.39%,23.18%,1
臺北市,萬華區,1111,332,458,790,49,839,1395,60.14%,23.8%,1
臺北市,萬華區,1112,304,434,738,46,784,1450,54.07%,20.97%,1
臺北市,萬華區,1113,261,401,662,35,697,1340,52.01%,19.48%,1
臺北市,萬華區,1114,243,382,625,40,665,1242,53.54%,19.57%,1
臺北市,萬華區,1115,235,423,658,56,714,1286,55.52%,18.27%,1
臺北市,萬華區,1116,234,451,685,39,724,1324,54.68%,17.67%,1
臺北市,萬華區,1117,327,469,796,59,855,1619,52.81%,20.2%,1
臺北市,萬華區,1118,235,382,617,59,676,1352,50%,17.38%,1
臺北市,萬華區,1119,269,471,740,39,779,1440,54.1%,18.68%,1
臺北市,萬華區,1120,290,382,672,48,720,1194,60.3%,24.29%,1
臺北市,萬華區,1121,228,419,647,43,690,1083,63.71%,21.05%,1
臺北市,萬華區,1122,260,369,629,54,683,1237,55.21%,21.02%,1
臺北市,萬華區,1123,361,489,850,36,886,1625,54.52%,22.22%,1
臺北市,萬華區,1124,290,467,757,47,804,1324,60.73%,21.9%,1
臺北市,萬華區,1125,321,433,754,52,806,1352,59.62%,23.74%,1
臺北市,萬華區,1126,279,426,705,35,740,2630,28.14%,10.61%,1
臺北市,萬華區,1127,336,513,849,62,911,1504,60.57%,22.34%,1
臺北市,萬華區,1128,296,449,745,48,793,1425,55.65%,20.77%,1
臺北市,萬華區,1129,287,470,757,61,818,1591,51.41%,18.04%,1
臺北市,萬華區,1130,282,473,755,60,815,1474,55.29%,19.13%,1
臺北市,萬華區,1131,325,465,790,59,849,1612,52.67%,20.16%,1
臺北市,萬華區,1132,267,483,750,56,806,1447,55.7%,18.45%,1
臺北市,萬華區,1133,285,525,810,56,866,1491,58.08%,19.11%,1
臺北市,萬華區,1134,322,533,855,43,898,1500,59.87%,21.47%,1
臺北市,萬華區,1135,323,561,884,48,932,1582,58.91%,20.42%,1
臺北市,萬華區,1136,296,478,774,54,828,1623,51.02%,18.24%,1
臺北市,萬華區,1137,260,390,650,25,675,1228,54.97%,21.17%,1
臺北市,萬華區,1138,236,434,670,54,724,1268,57.1%,18.61%,1
臺北市,萬華區,1139,253,429,682,53,735,1207,60.89%,20.96%,1
臺北市,萬華區,1140,397,282,679,36,715,1188,60.19%,33.42%,1
臺北市,萬華區,1141,281,472,753,42,795,1474,53.93%,19.06%,1
臺北市,萬華區,1142,221,393,614,22,636,1304,48.77%,16.95%,1
臺北市,萬華區,1143,156,275,431,47,478,1082,44.18%,14.42%,1
臺北市,萬華區,1144,217,316,533,32,565,1052,53.71%,20.63%,1
臺北市,萬華區,1145,243,364,607,36,643,1135,56.65%,21.41%,1
臺北市,萬華區,1146,235,403,638,55,693,1225,56.57%,19.18%,1
臺北市,萬華區,1147,293,502,795,43,838,1583,52.94%,18.51%,1
臺北市,萬華區,1148,311,423,734,51,785,1403,55.95%,22.17%,1
臺北市,萬華區,1149,306,461,767,47,814,1406,57.89%,21.76%,1
臺北市,萬華區,1150,284,481,765,51,816,1401,58.24%,20.27%,1
臺北市,萬華區,1151,284,381,665,47,712,1188,59.93%,23.91%,1
臺北市,萬華區,1152,306,498,804,61,865,1597,54.16%,19.16%,1
臺北市,萬華區,1153,276,453,729,70,799,1290,61.94%,21.4%,1
臺北市,萬華區,1154,319,517,836,34,870,1746,49.83%,18.27%,1
臺北市,萬華區,1155,281,441,722,39,761,1595,47.71%,17.62%,1
臺北市,萬華區,1156,332,522,854,81,935,1701,54.97%,19.52%,1
臺北市,萬華區,1157,228,380,608,57,665,1339,49.66%,17.03%,1
臺北市,萬華區,1158,245,439,684,69,753,1484,50.74%,16.51%,1
臺北市,萬華區,1159,312,536,848,63,911,1604,56.8%,19.45%,1
臺北市,萬華區,1160,253,417,670,31,701,1197,58.56%,21.14%,1
臺北市,萬華區,1161,274,401,675,67,742,1347,55.09%,20.34%,1
臺北市,萬華區,1162,305,438,743,43,786,1223,64.27%,24.94%,1
臺北市,萬華區,1163,232,374,606,26,632,1036,61%,22.39%,1
臺北市,萬華區,1164,249,380,629,38,667,1035,64.44%,24.06%,1
臺北市,萬華區,1165,256,409,665,39,704,1141,61.7%,22.44%,1
臺北市,萬華區,1166,259,462,721,30,751,1271,59.09%,20.38%,1
臺北市,萬華區,1167,293,456,749,60,809,1328,60.92%,22.06%,1
臺北市,萬華區,1168,261,455,716,46,762,1286,59.25%,20.3%,1
臺北市,萬華區,1169,363,563,926,64,990,1679,58.96%,21.62%,1
臺北市,萬華區,1170,339,519,858,55,913,1619,56.39%,20.94%,1
臺北市,萬華區,1171,306,480,786,37,823,1625,50.65%,18.83%,1
臺北市,萬華區,1172,304,597,901,52,953,1623,58.72%,18.73%,1
臺北市,萬華區,1173,235,430,665,56,721,1280,56.33%,18.36%,1
臺北市,萬華區,1174,325,587,912,62,974,1608,60.57%,20.21%,1
臺北市,萬華區,1175,306,493,799,53,852,1453,58.64%,21.06%,1
臺北市,萬華區,1176,321,548,869,43,912,1472,61.96%,21.81%,1
臺北市,萬華區,1177,318,446,764,33,797,1373,58.05%,23.16%,1
臺北市,萬華區,1178,266,455,721,54,775,1394,55.6%,19.08%,1
臺北市,萬華區,1179,275,458,733,27,760,1427,53.26%,19.27%,1
臺北市,萬華區,1180,296,494,790,41,831,1342,61.92%,22.06%,1
臺北市,萬華區,1181,318,555,873,70,943,1569,60.1%,20.27%,1
臺北市,萬華區,1182,238,472,710,50,760,1514,50.2%,15.72%,1
臺北市,萬華區,1183,303,501,804,37,841,1720,48.9%,17.62%,1
臺北市,萬華區,1184,317,545,862,60,922,1461,63.11%,21.7%,1
臺北市,萬華區,1185,255,419,674,32,706,1264,55.85%,20.17%,1
臺北市,萬華區,1186,274,500,774,58,832,1334,62.37%,20.54%,1
臺北市,萬華區,1187,336,487,823,34,857,1446,59.27%,23.24%,1
臺北市,萬華區,1188,226,426,652,34,686,1307,52.49%,17.29%,1
臺北市,萬華區,1189,273,510,783,61,844,1420,59.44%,19.23%,1
臺北市,萬華區,1190,278,428,706,44,750,1427,52.56%,19.48%,1
臺北市,萬華區,1191,165,339,504,42,546,956,57.11%,17.26%,1
臺北市,萬華區,1192,246,474,720,77,797,1352,58.95%,18.2%,1
臺北市,萬華區,1193,239,495,734,47,781,1370,57.01%,17.45%,1
臺北市,萬華區,1194,205,496,701,29,730,1222,59.74%,16.78%,1
臺北市,萬華區,1195,205,553,758,37,795,1375,57.82%,14.91%,1
臺北市,萬華區,1196,248,559,807,43,850,1463,58.1%,16.95%,1
臺北市,萬華區,1197,257,523,780,42,822,1527,53.83%,16.83%,1
臺北市,萬華區,1198,238,542,780,36,816,1485,54.95%,16.03%,1
臺北市,萬華區,1199,237,705,942,37,979,1591,61.53%,14.9%,1
臺北市,萬華區,1200,275,597,872,38,910,1394,65.28%,19.73%,1
臺北市,萬華區,1201,283,612,895,28,923,1522,60.64%,18.59%,1
臺北市,萬華區,1202,278,696,974,32,1006,1661,60.57%,16.74%,1
臺北市,萬華區,1203,300,530,830,39,869,1561,55.67%,19.22%,1
臺北市,萬華區,1204,297,569,866,41,907,1406,64.51%,21.12%,1
臺北市,萬華區,1205,256,413,669,40,709,1498,47.33%,17.09%,1
臺北市,萬華區,1206,218,443,661,48,709,1478,47.97%,14.75%,1
臺北市,萬華區,1207,217,387,604,46,650,1170,55.56%,18.55%,1
臺北市,萬華區,1208,244,529,773,43,816,1376,59.3%,17.73%,1
臺北市,萬華區,1209,219,386,605,19,624,1093,57.09%,20.04%,1
臺北市,萬華區,1210,227,403,630,54,684,1084,63.1%,20.94%,1
臺北市,萬華區,1211,218,409,627,50,677,1119,60.5%,19.48%,1
臺北市,萬華區,1212,281,552,833,23,856,1381,61.98%,20.35%,1
臺北市,萬華區,1213,302,489,791,32,823,1396,58.95%,21.63%,1
臺北市,文山區,1402,310,519,829,39,868,1539,56.4%,20.14%,1
臺北市,文山區,1403,274,543,817,26,843,1548,54.46%,17.7%,1
臺北市,文山區,1404,309,542,851,56,907,1493,60.75%,20.7%,1
臺北市,文山區,1405,362,600,962,39,1001,1648,60.74%,21.97%,1
臺北市,文山區,1406,306,546,852,43,895,1544,57.97%,19.82%,1
臺北市,文山區,1407,304,563,867,41,908,1557,58.32%,19.52%,1
臺北市,文山區,1408,289,530,819,34,853,1514,56.34%,19.09%,1
臺北市,文山區,1409,319,624,943,44,987,1540,64.09%,20.71%,1
臺北市,文山區,1410,337,546,883,26,909,1466,62.01%,22.99%,1
臺北市,文山區,1411,297,550,847,39,886,1444,61.36%,20.57%,1
臺北市,文山區,1412,296,545,841,46,887,1455,60.96%,20.34%,1
臺北市,文山區,1413,260,513,773,32,805,1440,55.9%,18.06%,1
臺北市,文山區,1414,271,551,822,43,865,1398,61.87%,19.38%,1
臺北市,文山區,1415,323,466,789,13,802,1412,56.8%,22.88%,1
臺北市,文山區,1416,282,511,793,40,833,1426,58.42%,19.78%,1
臺北市,文山區,1417,302,519,821,35,856,1437,59.57%,21.02%,1
臺北市,文山區,1418,265,503,768,44,812,1340,60.6%,19.78%,1
臺北市,文山區,1419,335,552,887,27,914,1568,58.29%,21.36%,1
臺北市,文山區,1420,256,514,770,23,793,1372,57.8%,18.66%,1
臺北市,文山區,1421,225,367,592,25,617,1046,58.99%,21.51%,1
臺北市,文山區,1422,276,444,720,45,765,1274,60.05%,21.66%,1
臺北市,文山區,1423,272,486,758,24,782,1324,59.06%,20.54%,1
臺北市,文山區,1424,334,611,945,42,987,1722,57.32%,19.4%,1
臺北市,文山區,1425,347,635,982,52,1034,1737,59.53%,19.98%,1
臺北市,文山區,1426,328,509,837,23,860,1370,62.77%,23.94%,1
臺北市,文山區,1427,331,513,844,35,879,1495,58.8%,22.14%,1
臺北市,文山區,1428,296,463,759,42,801,1328,60.32%,22.29%,1
臺北市,文山區,1429,248,428,676,27,703,1138,61.78%,21.79%,1
臺北市,文山區,1430,302,563,865,25,890,1471,60.5%,20.53%,1
臺北市,文山區,1431,243,446,689,28,717,1144,62.67%,21.24%,1
臺北市,文山區,1432,261,462,723,39,762,1176,64.8%,22.19%,1
臺北市,文山區,1433,249,484,733,38,771,1212,63.61%,20.54%,1
臺北市,文山區,1434,270,472,742,36,778,1214,64.09%,22.24%,1
臺北市,文山區,1435,246,389,635,36,671,1170,57.35%,21.03%,1
臺北市,文山區,1436,269,482,751,38,789,1308,60.32%,20.57%,1
臺北市,文山區,1437,242,429,671,57,728,1190,61.18%,20.34%,1
臺北市,文山區,1438,232,401,633,35,668,1110,60.18%,20.9%,1
臺北市,文山區,1439,307,561,868,36,904,1512,59.79%,20.3%,1
臺北市,文山區,1440,258,562,820,33,853,1387,61.5%,18.6%,1
臺北市,文山區,1441,297,478,775,38,813,1355,60%,21.92%,1
臺北市,文山區,1442,302,475,777,56,833,1370,60.8%,22.04%,1
臺北市,文山區,1443,316,539,855,43,898,1484,60.51%,21.29%,1
臺北市,文山區,1444,371,622,993,53,1046,1786,58.57%,20.77%,1
臺北市,文山區,1445,248,460,708,48,756,1260,60%,19.68%,1
臺北市,文山區,1446,286,474,760,25,785,1194,65.75%,23.95%,1
臺北市,文山區,1447,274,564,838,30,868,1444,60.11%,18.98%,1
臺北市,文山區,1448,320,546,866,39,905,1495,60.54%,21.4%,1
臺北市,文山區,1449,280,569,849,40,889,1446,61.48%,19.36%,1
臺北市,文山區,1450,307,493,800,54,854,1450,58.9%,21.17%,1
臺北市,文山區,1451,328,560,888,33,921,1486,61.98%,22.07%,1
臺北市,文山區,1452,270,481,751,30,781,1259,62.03%,21.45%,1
臺北市,文山區,1453,285,509,794,20,814,1317,61.81%,21.64%,1
臺北市,文山區,1454,296,498,794,37,831,1321,62.91%,22.41%,1
臺北市,文山區,1455,300,532,832,35,867,1475,58.78%,20.34%,1
臺北市,文山區,1456,263,451,714,23,737,1271,57.99%,20.69%,1
臺北市,文山區,1457,357,575,932,40,972,1609,60.41%,22.19%,1
臺北市,文山區,1458,263,555,818,23,841,1501,56.03%,17.52%,1
臺北市,文山區,1459,189,338,527,28,555,997,55.67%,18.96%,1
臺北市,文山區,1460,247,396,643,40,683,1052,64.92%,23.48%,1
臺北市,文山區,1461,268,452,720,46,766,1247,61.43%,21.49%,1
臺北市,文山區,1462,265,426,691,38,729,1167,62.47%,22.71%,1
臺北市,文山區,1463,276,487,763,30,793,1280,61.95%,21.56%,1
臺北市,文山區,1464,238,435,673,42,715,1153,62.01%,20.64%,1
臺北市,文山區,1465,336,559,895,34,929,1557,59.67%,21.58%,1
臺北市,文山區,1466,253,559,812,47,859,1444,59.49%,17.52%,1
臺北市,文山區,1467,348,568,916,29,945,1459,64.77%,23.85%,1
臺北市,文山區,1468,277,557,834,34,868,1357,63.96%,20.41%,1
臺北市,文山區,1469,269,494,763,29,792,1194,66.33%,22.53%,1
臺北市,文山區,1470,280,440,720,45,765,1184,64.61%,23.65%,1
臺北市,文山區,1471,264,429,693,26,719,1119,64.25%,23.59%,1
臺北市,文山區,1472,309,507,816,46,862,1350,63.85%,22.89%,1
臺北市,文山區,1473,268,546,814,27,841,1502,55.99%,17.84%,1
臺北市,文山區,1474,300,589,889,33,922,1511,61.02%,19.85%,1
臺北市,文山區,1475,351,554,905,31,936,1481,63.2%,23.7%,1
臺北市,文山區,1476,214,697,911,30,941,1477,63.71%,14.49%,1
臺北市,文山區,1477,282,498,780,24,804,1294,62.13%,21.79%,1
臺北市,文山區,1478,244,440,684,25,709,1040,68.17%,23.46%,1
臺北市,文山區,1479,282,515,797,38,835,1323,63.11%,21.32%,1
臺北市,文山區,1480,278,396,674,40,714,1153,61.93%,24.11%,1
臺北市,文山區,1481,308,578,886,20,906,1525,59.41%,20.2%,1
臺北市,文山區,1482,250,503,753,39,792,1412,56.09%,17.71%,1
臺北市,文山區,1483,372,522,894,39,933,1473,63.34%,25.25%,1
臺北市,文山區,1484,271,597,868,31,899,1486,60.5%,18.24%,1
臺北市,文山區,1485,338,636,974,41,1015,1616,62.81%,20.92%,1
臺北市,文山區,1486,301,590,891,39,930,1489,62.46%,20.21%,1
臺北市,文山區,1487,276,534,810,32,842,1414,59.55%,19.52%,1
臺北市,文山區,1488,358,567,925,38,963,1494,64.46%,23.96%,1
臺北市,文山區,1489,328,593,921,39,960,1547,62.06%,21.2%,1
臺北市,文山區,1490,322,601,923,45,968,1587,61%,20.29%,1
臺北市,文山區,1491,348,600,948,20,968,1515,63.89%,22.97%,1
臺北市,文山區,1492,346,605,951,39,990,1573,62.94%,22%,1
臺北市,文山區,1493,345,566,911,40,951,1542,61.67%,22.37%,1
臺北市,文山區,1494,286,481,767,44,811,1465,55.36%,19.52%,1
臺北市,文山區,1495,130,178,308,38,346,699,49.5%,18.6%,1
臺北市,文山區,1496,256,416,672,42,714,1372,52.04%,18.66%,1
臺北市,文山區,1497,254,452,706,42,748,1448,51.66%,17.54%,1
臺北市,文山區,1498,297,572,869,48,917,1548,59.24%,19.19%,1
臺北市,文山區,1499,343,529,872,33,905,1501,60.29%,22.85%,1
臺北市,文山區,1500,356,574,930,33,963,1560,61.73%,22.82%,1
臺北市,文山區,1501,328,555,883,36,919,1567,58.65%,20.93%,1
臺北市,文山區,1502,352,539,891,28,919,1554,59.14%,22.65%,1
臺北市,文山區,1503,300,572,872,45,917,1544,59.39%,19.43%,1
臺北市,文山區,1504,316,574,890,34,924,1528,60.47%,20.68%,1
臺北市,文山區,1505,316,626,942,23,965,1543,62.54%,20.48%,1
臺北市,文山區,1506,350,572,922,43,965,2754,35.04%,12.71%,1
臺北市,文山區,1507,314,529,843,50,893,1709,52.25%,18.37%,1
臺北市,文山區,1508,289,518,807,63,870,1515,57.43%,19.08%,1
臺北市,文山區,1509,302,520,822,40,862,1571,54.87%,19.22%,1
臺北市,文山區,1510,332,532,864,45,909,1578,57.6%,21.04%,1
臺北市,文山區,1511,291,492,783,39,822,1454,56.53%,20.01%,1
臺北市,文山區,1512,291,519,810,49,859,1436,59.82%,20.26%,1
臺北市,文山區,1513,289,554,843,39,882,1402,62.91%,20.61%,1
臺北市,文山區,1514,243,420,663,40,703,1117,62.94%,21.75%,1
臺北市,文山區,1515,229,393,622,31,653,1094,59.69%,20.93%,1
臺北市,文山區,1516,201,448,649,39,688,1070,64.3%,18.79%,1
臺北市,文山區,1517,258,551,809,37,846,1319,64.14%,19.56%,1
臺北市,文山區,1518,253,501,754,36,790,1226,64.44%,20.64%,1
臺北市,文山區,1519,258,496,754,31,785,1385,56.68%,18.63%,1
臺北市,文山區,1520,328,491,819,43,862,1416,60.88%,23.16%,1
臺北市,文山區,1521,294,576,870,37,907,1412,64.24%,20.82%,1
臺北市,文山區,1522,284,546,830,56,886,1535,57.72%,18.5%,1
臺北市,文山區,1523,327,663,990,56,1046,1654,63.24%,19.77%,1
臺北市,文山區,1524,263,450,713,25,738,1156,63.84%,22.75%,1
臺北市,文山區,1525,288,464,752,26,778,1231,63.2%,23.4%,1
臺北市,文山區,1526,219,477,696,32,728,1218,59.77%,17.98%,1
臺北市,文山區,1527,295,443,738,24,762,1176,64.8%,25.09%,1
臺北市,文山區,1528,308,537,845,5,850,1392,61.06%,22.13%,1
臺北市,文山區,1529,280,444,724,61,785,1323,59.33%,21.16%,1
臺北市,文山區,1530,256,474,730,34,764,1297,58.91%,19.74%,1
臺北市,文山區,1531,289,484,773,41,814,1296,62.81%,22.3%,1
臺北市,文山區,1532,330,576,906,39,945,1613,58.59%,20.46%,1
臺北市,文山區,1533,315,657,972,59,1031,1697,60.75%,18.56%,1
臺北市,文山區,1534,340,560,900,45,945,1579,59.85%,21.53%,1
臺北市,文山區,1535,298,499,797,45,842,1320,63.79%,22.58%,1
臺北市,文山區,1536,310,526,836,26,862,1438,59.94%,21.56%,1
臺北市,文山區,1537,275,505,780,27,807,1465,55.09%,18.77%,1
臺北市,文山區,1538,414,534,948,39,987,1646,59.96%,25.15%,1
臺北市,文山區,1539,263,487,750,38,788,1286,61.28%,20.45%,1
臺北市,文山區,1540,282,432,714,27,741,1219,60.79%,23.13%,1
臺北市,文山區,1541,276,491,767,30,797,1292,61.69%,21.36%,1
臺北市,文山區,1542,273,541,814,48,862,1489,57.89%,18.33%,1
臺北市,文山區,1543,428,525,953,36,989,1611,61.39%,26.57%,1
臺北市,文山區,1544,293,481,774,36,810,1549,52.29%,18.92%,1
臺北市,文山區,1545,314,582,896,55,951,1678,56.67%,18.71%,1
臺北市,文山區,1546,337,569,906,36,942,1660,56.75%,20.3%,1
臺北市,文山區,1547,359,525,884,23,907,1816,49.94%,19.77%,1
臺北市,文山區,1548,217,323,540,26,566,985,57.46%,22.03%,1
臺北市,文山區,1549,293,487,780,24,804,1314,61.19%,22.3%,1
臺北市,文山區,1550,416,217,633,34,667,1018,65.52%,40.86%,1
臺北市,文山區,1551,351,560,911,32,943,1578,59.76%,22.24%,1
臺北市,文山區,1552,316,510,826,30,856,1457,58.75%,21.69%,1
臺北市,文山區,1553,283,496,779,41,820,1326,61.84%,21.34%,1
臺北市,文山區,1554,305,523,828,34,862,1393,61.88%,21.9%,1
臺北市,文山區,1555,303,452,755,36,791,1377,57.44%,22%,1
臺北市,文山區,1556,366,481,847,28,875,1448,60.43%,25.28%,1
臺北市,文山區,1557,347,533,880,41,921,1447,63.65%,23.98%,1
臺北市,文山區,1558,458,636,1094,41,1135,1739,65.27%,26.34%,1
臺北市,文山區,1559,371,485,856,29,885,1457,60.74%,25.46%,1
臺北市,文山區,1560,305,453,758,38,796,1288,61.8%,23.68%,1
臺北市,文山區,1561,270,414,684,34,718,1301,55.19%,20.75%,1
臺北市,文山區,1562,148,281,429,48,477,865,55.14%,17.11%,1
臺北市,文山區,1563,150,257,407,34,441,789,55.89%,19.01%,1
臺北市,南港區,0455,248,443,691,26,717,1280,56.02%,19.38%,1
臺北市,南港區,0456,291,467,758,20,778,1351,57.59%,21.54%,1
臺北市,南港區,0457,308,455,763,30,793,1345,58.96%,22.9%,1
臺北市,南港區,0458,277,445,722,38,760,1679,45.27%,16.5%,1
臺北市,南港區,0459,343,520,863,43,906,1680,53.93%,20.42%,1
臺北市,南港區,0460,287,513,800,49,849,1635,51.93%,17.55%,1
臺北市,南港區,0461,276,507,783,40,823,1459,56.41%,18.92%,1
臺北市,南港區,0462,384,574,958,23,981,1706,57.5%,22.51%,1
臺北市,南港區,0463,304,560,864,41,905,1674,54.06%,18.16%,1
臺北市,南港區,0464,322,503,825,13,838,1491,56.2%,21.6%,1
臺北市,南港區,0465,238,431,669,31,700,1086,64.46%,21.92%,1
臺北市,南港區,0466,285,445,730,46,776,1202,64.56%,23.71%,1
臺北市,南港區,0467,289,399,688,40,728,1198,60.77%,24.12%,1
臺北市,南港區,0468,316,438,754,28,782,1430,54.69%,22.1%,1
臺北市,南港區,0469,340,414,754,41,795,1275,62.35%,26.67%,1
臺北市,南港區,0470,392,438,830,42,872,1344,64.88%,29.17%,1
臺北市,南港區,0471,354,456,810,27,837,1391,60.17%,25.45%,1
臺北市,南港區,0472,347,450,797,25,822,1342,61.25%,25.86%,1
臺北市,南港區,0473,302,428,730,32,762,1389,54.86%,21.74%,1
臺北市,南港區,0474,332,509,841,29,870,1426,61.01%,23.28%,1
臺北市,南港區,0475,234,554,788,24,812,1359,59.75%,17.22%,1
臺北市,南港區,0476,276,478,754,41,795,1366,58.2%,20.2%,1
臺北市,南港區,0477,297,530,827,26,853,1441,59.2%,20.61%,1
臺北市,南港區,0478,287,500,787,50,837,1529,54.74%,18.77%,1
臺北市,南港區,0479,321,506,827,44,871,1618,53.83%,19.84%,1
臺北市,南港區,0480,268,448,716,44,760,1545,49.19%,17.35%,1
臺北市,南港區,0481,332,534,866,38,904,1569,57.62%,21.16%,1
臺北市,南港區,0482,318,491,809,36,845,1661,50.87%,19.15%,1
臺北市,南港區,0483,315,448,763,39,802,1518,52.83%,20.75%,1
臺北市,南港區,0484,365,555,920,41,961,1552,61.92%,23.52%,1
臺北市,南港區,0485,340,528,868,25,893,1658,53.86%,20.51%,1
臺北市,南港區,0486,327,549,876,57,933,1608,58.02%,20.34%,1
臺北市,南港區,0487,305,480,785,28,813,1475,55.12%,20.68%,1
臺北市,南港區,0488,421,610,1031,40,1071,1722,62.2%,24.45%,1
臺北市,南港區,0489,329,534,863,37,900,1383,65.08%,23.79%,1
臺北市,南港區,0490,301,490,791,39,830,1397,59.41%,21.55%,1
臺北市,南港區,0491,262,525,787,34,821,1352,60.72%,19.38%,1
臺北市,南港區,0492,293,477,770,40,810,1344,60.27%,21.8%,1
臺北市,南港區,0493,313,425,738,26,764,1385,55.16%,22.6%,1
臺北市,南港區,0494,295,466,761,41,802,1399,57.33%,21.09%,1
臺北市,南港區,0495,290,439,729,35,764,1381,55.32%,21%,1
臺北市,南港區,0496,293,529,822,40,862,1548,55.68%,18.93%,1
臺北市,南港區,0497,261,395,656,20,676,1190,56.81%,21.93%,1
臺北市,南港區,0498,345,501,846,34,880,1490,59.06%,23.15%,1
臺北市,南港區,0499,252,394,646,28,674,1096,61.5%,22.99%,1
臺北市,南港區,0500,288,453,741,25,766,1238,61.87%,23.26%,1
臺北市,南港區,0501,281,475,756,34,790,1271,62.16%,22.11%,1
臺北市,南港區,0502,231,408,639,31,670,1146,58.46%,20.16%,1
臺北市,南港區,0503,258,424,682,30,712,1232,57.79%,20.94%,1
臺北市,南港區,0504,279,527,806,29,835,1649,50.64%,16.92%,1
臺北市,南港區,0505,338,622,960,34,994,1688,58.89%,20.02%,1
臺北市,南港區,0506,309,571,880,30,910,1503,60.55%,20.56%,1
臺北市,南港區,0507,364,496,860,34,894,1542,57.98%,23.61%,1
臺北市,南港區,0508,276,570,846,37,883,1463,60.36%,18.87%,1
臺北市,南港區,0509,273,445,718,47,765,1195,64.02%,22.85%,1
臺北市,南港區,0510,302,438,740,9,749,1254,59.73%,24.08%,1
臺北市,南港區,0511,284,495,779,27,806,1356,59.44%,20.94%,1
臺北市,南港區,0512,341,436,777,67,844,1363,61.92%,25.02%,1
臺北市,南港區,0513,311,482,793,35,828,1317,62.87%,23.61%,1
臺北市,南港區,0514,290,480,770,20,790,1331,59.35%,21.79%,1
臺北市,南港區,0515,330,564,894,46,940,1610,58.39%,20.5%,1
臺北市,南港區,0516,309,532,841,27,868,1542,56.29%,20.04%,1
臺北市,南港區,0517,328,571,899,43,942,1581,59.58%,20.75%,1
臺北市,南港區,0518,273,469,742,29,771,1225,62.94%,22.29%,1
臺北市,南港區,0519,299,449,748,54,802,1264,63.45%,23.66%,1
臺北市,南港區,0520,360,594,954,56,1010,1649,61.25%,21.83%,1
臺北市,南港區,0521,306,438,744,24,768,1267,60.62%,24.15%,1
臺北市,南港區,0522,261,498,759,74,833,1336,62.35%,19.54%,1
臺北市,南港區,0523,271,428,699,30,729,1162,62.74%,23.32%,1
臺北市,南港區,0524,225,371,596,26,622,1045,59.52%,21.53%,1
臺北市,南港區,0525,320,553,873,37,910,1351,67.36%,23.69%,1
臺北市,南港區,0526,272,503,775,24,799,1358,58.84%,20.03%,1
臺北市,內湖區,0305,323,532,855,17,872,1661,52.5%,19.45%,1
臺北市,內湖區,0306,340,494,834,56,890,1602,55.56%,21.22%,1
臺北市,內湖區,0307,343,608,951,62,1013,1655,61.21%,20.73%,1
臺北市,內湖區,0308,385,540,925,33,958,1582,60.56%,24.34%,1
臺北市,內湖區,0309,357,543,900,33,933,1688,55.27%,21.15%,1
臺北市,內湖區,0310,413,535,948,51,999,1737,57.51%,23.78%,1
臺北市,內湖區,0311,426,601,1027,51,1078,1809,59.59%,23.55%,1
臺北市,內湖區,0312,289,472,761,28,789,1376,57.34%,21%,1
臺北市,內湖區,0313,450,539,989,72,1061,1747,60.73%,25.76%,1
臺北市,內湖區,0314,327,495,822,29,851,1389,61.27%,23.54%,1
臺北市,內湖區,0315,383,509,892,26,918,1454,63.14%,26.34%,1
臺北市,內湖區,0316,379,510,889,32,921,1468,62.74%,25.82%,1
臺北市,內湖區,0317,362,610,972,38,1010,1603,63.01%,22.58%,1
臺北市,內湖區,0318,368,614,982,28,1010,1795,56.27%,20.5%,1
臺北市,內湖區,0319,432,610,1042,46,1088,1737,62.64%,24.87%,1
臺北市,內湖區,0320,389,617,1006,45,1051,1744,60.26%,22.31%,1
臺北市,內湖區,0321,356,585,941,41,982,1661,59.12%,21.43%,1
臺北市,內湖區,0322,369,518,887,31,918,1577,58.21%,23.4%,1
臺北市,內湖區,0323,354,546,900,22,922,1494,61.71%,23.69%,1
臺北市,內湖區,0324,339,579,918,38,956,1626,58.79%,20.85%,1
臺北市,內湖區,0325,343,576,919,58,977,1641,59.54%,20.9%,1
臺北市,內湖區,0326,353,536,889,29,918,1554,59.07%,22.72%,1
臺北市,內湖區,0327,393,601,994,52,1046,1728,60.53%,22.74%,1
臺北市,內湖區,0328,345,618,963,35,998,1736,57.49%,19.87%,1
臺北市,內湖區,0329,339,566,905,38,943,1461,64.54%,23.2%,1
臺北市,內湖區,0330,314,556,870,34,904,1509,59.91%,20.81%,1
臺北市,內湖區,0331,304,459,763,21,784,1358,57.73%,22.39%,1
臺北市,內湖區,0332,388,577,965,34,999,1761,56.73%,22.03%,1
臺北市,內湖區,0333,379,574,953,25,978,1651,59.24%,22.96%,1
臺北市,內湖區,0334,373,654,1027,59,1086,1809,60.03%,20.62%,1
臺北市,內湖區,0335,383,614,997,39,1036,1773,58.43%,21.6%,1
臺北市,內湖區,0336,367,657,1024,36,1060,1890,56.08%,19.42%,1
臺北市,內湖區,0337,438,647,1085,49,1134,1760,64.43%,24.89%,1
臺北市,內湖區,0338,356,601,957,24,981,1645,59.64%,21.64%,1
臺北市,內湖區,0339,310,500,810,20,830,1324,62.69%,23.41%,1
臺北市,內湖區,0340,200,442,642,30,672,1072,62.69%,18.66%,1
臺北市,內湖區,0341,305,524,829,29,858,1509,56.86%,20.21%,1
臺北市,內湖區,0342,374,588,962,43,1005,1715,58.6%,21.81%,1
臺北市,內湖區,0343,381,632,1013,41,1054,1774,59.41%,21.48%,1
臺北市,內湖區,0344,414,684,1098,35,1133,1796,63.08%,23.05%,1
臺北市,內湖區,0345,324,668,992,31,1023,1784,57.34%,18.16%,1
臺北市,內湖區,0346,345,488,833,50,883,1417,62.31%,24.35%,1
臺北市,內湖區,0347,435,522,957,26,983,1699,57.86%,25.6%,1
臺北市,內湖區,0348,446,602,1048,33,1081,1719,62.89%,25.95%,1
臺北市,內湖區,0349,395,581,976,34,1010,1715,58.89%,23.03%,1
臺北市,內湖區,0350,317,523,840,26,866,1634,53%,19.4%,1
臺北市,內湖區,0351,269,482,751,45,796,1435,55.47%,18.75%,1
臺北市,內湖區,0352,300,509,809,22,831,1440,57.71%,20.83%,1
臺北市,內湖區,0353,353,516,869,28,897,1446,62.03%,24.41%,1
臺北市,內湖區,0354,339,517,856,43,899,1657,54.25%,20.46%,1
臺北市,內湖區,0355,272,451,723,59,782,1261,62.01%,21.57%,1
臺北市,內湖區,0356,73,143,216,24,240,456,52.63%,16.01%,1
臺北市,內湖區,0357,370,543,913,30,943,1433,65.81%,25.82%,1
臺北市,內湖區,0358,315,548,863,32,895,1485,60.27%,21.21%,1
臺北市,內湖區,0359,346,538,884,35,919,1590,57.8%,21.76%,1
臺北市,內湖區,0360,298,445,743,49,792,1219,64.97%,24.45%,1
臺北市,內湖區,0361,328,603,931,46,977,1732,56.41%,18.94%,1
臺北市,內湖區,0362,347,654,1001,28,1029,1727,59.58%,20.09%,1
臺北市,內湖區,0363,344,578,922,46,968,1637,59.13%,21.01%,1
臺北市,內湖區,0364,322,489,811,28,839,1453,57.74%,22.16%,1
臺北市,內湖區,0365,325,559,884,33,917,1617,56.71%,20.1%,1
臺北市,內湖區,0366,331,538,869,37,906,1604,56.48%,20.64%,1
臺北市,內湖區,0367,340,548,888,10,898,1406,63.87%,24.18%,1
臺北市,內湖區,0368,336,450,786,32,818,1353,60.46%,24.83%,1
臺北市,內湖區,0369,383,629,1012,34,1046,1724,60.67%,22.22%,1
臺北市,內湖區,0370,317,491,808,30,838,1378,60.81%,23%,1
臺北市,內湖區,0371,320,524,844,21,865,1403,61.65%,22.81%,1
臺北市,內湖區,0372,345,515,860,21,881,1547,56.95%,22.3%,1
臺北市,內湖區,0373,424,582,1006,30,1036,1718,60.3%,24.68%,1
臺北市,內湖區,0374,397,607,1004,38,1042,1813,57.47%,21.9%,1
臺北市,內湖區,0375,659,420,1079,39,1118,1791,62.42%,36.8%,1
臺北市,內湖區,0376,434,658,1092,45,1137,1855,61.29%,23.4%,1
臺北市,內湖區,0377,260,730,990,25,1015,1731,58.64%,15.02%,1
臺北市,內湖區,0378,405,567,972,51,1023,1593,64.22%,25.42%,1
臺北市,內湖區,0379,341,627,968,40,1008,1869,53.93%,18.25%,1
臺北市,內湖區,0380,388,582,970,48,1018,1687,60.34%,23%,1
臺北市,內湖區,0381,350,547,897,21,918,1530,60%,22.88%,1
臺北市,內湖區,0382,281,486,767,35,802,1300,61.69%,21.62%,1
臺北市,內湖區,0383,233,577,810,35,845,1314,64.31%,17.73%,1
臺北市,內湖區,0384,293,454,747,13,760,1433,53.04%,20.45%,1
臺北市,內湖區,0385,315,457,772,26,798,1450,55.03%,21.72%,1
臺北市,內湖區,0386,348,529,877,44,921,1608,57.28%,21.64%,1
臺北市,內湖區,0387,328,481,809,35,844,1414,59.69%,23.2%,1
臺北市,內湖區,0388,371,490,861,29,890,1492,59.65%,24.87%,1
臺北市,內湖區,0389,320,480,800,27,827,1528,54.12%,20.94%,1
臺北市,內湖區,0390,370,579,949,33,982,1692,58.04%,21.87%,1
臺北市,內湖區,0391,331,544,875,45,920,1556,59.13%,21.27%,1
臺北市,內湖區,0392,349,544,893,22,915,1637,55.89%,21.32%,1
臺北市,內湖區,0393,389,546,935,33,968,1749,55.35%,22.24%,1
臺北市,內湖區,0394,237,422,659,28,687,1220,56.31%,19.43%,1
臺北市,內湖區,0395,344,539,883,42,925,1600,57.81%,21.5%,1
臺北市,內湖區,0396,319,498,817,38,855,1473,58.04%,21.66%,1
臺北市,內湖區,0397,320,486,806,50,856,1498,57.14%,21.36%,1
臺北市,內湖區,0398,333,529,862,36,898,1557,57.68%,21.39%,1
臺北市,內湖區,0399,327,548,875,25,900,1674,53.76%,19.53%,1
臺北市,內湖區,0400,379,624,1003,39,1042,1728,60.3%,21.93%,1
臺北市,內湖區,0401,123,250,373,35,408,788,51.78%,15.61%,1
臺北市,內湖區,0402,350,479,829,44,873,1542,56.61%,22.7%,1
臺北市,內湖區,0403,322,480,802,50,852,1676,50.84%,19.21%,1
臺北市,內湖區,0404,297,416,713,19,732,1360,53.82%,21.84%,1
臺北市,內湖區,0405,279,500,779,22,801,1259,63.62%,22.16%,1
臺北市,內湖區,0406,265,445,710,14,724,1301,55.65%,20.37%,1
臺北市,內湖區,0407,252,359,611,36,647,1251,51.72%,20.14%,1
臺北市,內湖區,0408,299,507,806,53,859,1502,57.19%,19.91%,1
臺北市,內湖區,0409,298,568,866,32,898,1596,56.27%,18.67%,1
臺北市,內湖區,0410,338,592,930,16,946,1649,57.37%,20.5%,1
臺北市,內湖區,0411,348,595,943,39,982,1774,55.36%,19.62%,1
臺北市,內湖區,0412,364,566,930,26,956,1746,54.75%,20.85%,1
臺北市,內湖區,0413,301,505,806,25,831,1473,56.42%,20.43%,1
臺北市,內湖區,0414,364,571,935,35,970,2824,34.35%,12.89%,1
臺北市,內湖區,0415,424,507,931,31,962,1849,52.03%,22.93%,1
臺北市,內湖區,0416,316,492,808,58,866,1530,56.6%,20.65%,1
臺北市,內湖區,0417,366,543,909,43,952,1656,57.49%,22.1%,1
臺北市,內湖區,0418,341,492,833,29,862,1457,59.16%,23.4%,1
臺北市,內湖區,0419,351,626,977,41,1018,1695,60.06%,20.71%,1
臺北市,內湖區,0420,380,574,954,31,985,1663,59.23%,22.85%,1
臺北市,內湖區,0421,341,572,913,38,951,1654,57.5%,20.62%,1
臺北市,內湖區,0422,375,562,937,48,985,1642,59.99%,22.84%,1
臺北市,內湖區,0423,397,556,953,23,976,1685,57.92%,23.56%,1
臺北市,內湖區,0424,371,630,1001,42,1043,1862,56.02%,19.92%,1
臺北市,內湖區,0425,453,648,1101,39,1140,1900,60%,23.84%,1
臺北市,內湖區,0426,394,697,1091,48,1139,1790,63.63%,22.01%,1
臺北市,內湖區,0427,301,469,770,47,817,1417,57.66%,21.24%,1
臺北市,內湖區,0428,335,597,932,39,971,1694,57.32%,19.78%,1
臺北市,內湖區,0429,319,537,856,48,904,1676,53.94%,19.03%,1
臺北市,內湖區,0430,381,531,912,21,933,1643,56.79%,23.19%,1
臺北市,內湖區,0431,384,531,915,32,947,1588,59.63%,24.18%,1
臺北市,內湖區,0432,364,553,917,46,963,1603,60.07%,22.71%,1
臺北市,內湖區,0433,372,546,918,37,955,1629,58.62%,22.84%,1
臺北市,內湖區,0434,389,590,979,40,1019,1646,61.91%,23.63%,1
臺北市,內湖區,0435,361,652,1013,33,1046,1883,55.55%,19.17%,1
臺北市,內湖區,0436,312,490,802,35,837,1434,58.37%,21.76%,1
臺北市,內湖區,0437,315,482,797,18,815,1418,57.48%,22.21%,1
臺北市,內湖區,0438,290,491,781,46,827,1373,60.23%,21.12%,1
臺北市,內湖區,0439,301,469,770,48,818,1349,60.64%,22.31%,1
臺北市,內湖區,0440,344,556,900,31,931,1511,61.61%,22.77%,1
臺北市,內湖區,0441,359,582,941,38,979,1563,62.64%,22.97%,1
臺北市,內湖區,0442,342,536,878,31,909,1550,58.65%,22.06%,1
臺北市,內湖區,0443,221,390,611,41,652,1157,56.35%,19.1%,1
臺北市,內湖區,0444,447,571,1018,32,1050,1768,59.39%,25.28%,1
臺北市,內湖區,0445,362,574,936,42,978,1664,58.77%,21.75%,1
臺北市,內湖區,0446,410,580,990,38,1028,1743,58.98%,23.52%,1
臺北市,內湖區,0447,335,531,866,19,885,1480,59.8%,22.64%,1
臺北市,內湖區,0448,405,539,944,36,980,1589,61.67%,25.49%,1
臺北市,內湖區,0449,288,477,765,30,795,1371,57.99%,21.01%,1
臺北市,內湖區,0450,383,575,958,26,984,1575,62.48%,24.32%,1
臺北市,內湖區,0451,301,490,791,17,808,1377,58.68%,21.86%,1
臺北市,內湖區,0452,403,526,929,40,969,1469,65.96%,27.43%,1
臺北市,內湖區,0453,394,554,948,20,968,1529,63.31%,25.77%,1
臺北市,內湖區,0454,425,557,982,34,1016,1649,61.61%,25.77%,1
臺北市,士林區,0142,362,544,906,55,961,1695,56.7%,21.36%,1
臺北市,士林區,0143,362,584,946,79,1025,1720,59.59%,21.05%,1
臺北市,士林區,0144,239,442,681,62,743,1288,57.69%,18.56%,1
臺北市,士林區,0145,314,508,822,46,868,1546,56.14%,20.31%,1
臺北市,士林區,0146,148,241,389,22,411,652,63.04%,22.7%,1
臺北市,士林區,0147,176,281,457,23,480,870,55.17%,20.23%,1
臺北市,士林區,0148,248,430,678,41,719,1137,63.24%,21.81%,1
臺北市,士林區,0149,223,402,625,40,665,1050,63.33%,21.24%,1
臺北市,士林區,0150,209,387,596,46,642,1031,62.27%,20.27%,1
臺北市,士林區,0151,246,397,643,18,661,1075,61.49%,22.88%,1
臺北市,士林區,0152,201,284,485,36,521,2175,23.95%,9.24%,1
臺北市,士林區,0153,324,566,890,66,956,1775,53.86%,18.25%,1
臺北市,士林區,0154,352,586,938,45,983,1669,58.9%,21.09%,1
臺北市,士林區,0155,394,557,951,60,1011,1665,60.72%,23.66%,1
臺北市,士林區,0156,391,588,979,47,1026,1648,62.26%,23.73%,1
臺北市,士林區,0157,241,462,703,23,726,1246,58.27%,19.34%,1
臺北市,士林區,0158,308,459,767,53,820,1419,57.79%,21.71%,1
臺北市,士林區,0159,286,436,722,58,780,1327,58.78%,21.55%,1
臺北市,士林區,0160,359,557,916,62,978,1573,62.17%,22.82%,1
臺北市,士林區,0161,303,516,819,55,874,1470,59.46%,20.61%,1
臺北市,士林區,0162,361,625,986,34,1020,1775,57.46%,20.34%,1
臺北市,士林區,0163,390,569,959,37,996,1692,58.87%,23.05%,1
臺北市,士林區,0164,365,657,1022,53,1075,1842,58.36%,19.82%,1
臺北市,士林區,0165,248,426,674,42,716,1166,61.41%,21.27%,1
臺北市,士林區,0166,309,513,822,68,890,1687,52.76%,18.32%,1
臺北市,士林區,0167,350,530,880,49,929,1624,57.2%,21.55%,1
臺北市,士林區,0168,328,523,851,77,928,1477,62.83%,22.21%,1
臺北市,士林區,0169,295,435,730,39,769,1250,61.52%,23.6%,1
臺北市,士林區,0170,313,477,790,66,856,1434,59.69%,21.83%,1
臺北市,士林區,0171,319,493,812,61,873,1452,60.12%,21.97%,1
臺北市,士林區,0172,351,556,907,54,961,1533,62.69%,22.9%,1
臺北市,士林區,0173,328,540,868,62,930,1515,61.39%,21.65%,1
臺北市,士林區,0174,291,396,687,44,731,1203,60.76%,24.19%,1
臺北市,士林區,0175,357,510,867,60,927,1487,62.34%,24.01%,1
臺北市,士林區,0176,255,437,692,37,729,1252,58.23%,20.37%,1
臺北市,士林區,0177,300,543,843,39,882,1536,57.42%,19.53%,1
臺北市,士林區,0178,326,575,901,48,949,1556,60.99%,20.95%,1
臺北市,士林區,0179,340,503,843,61,904,1511,59.83%,22.5%,1
臺北市,士林區,0180,400,542,942,55,997,1572,63.42%,25.45%,1
臺北市,士林區,0181,319,593,912,57,969,1668,58.09%,19.12%,1
臺北市,士林區,0182,319,568,887,82,969,1685,57.51%,18.93%,1
臺北市,士林區,0183,347,507,854,53,907,1568,57.84%,22.13%,1
臺北市,士林區,0184,261,422,683,49,732,1327,55.16%,19.67%,1
臺北市,士林區,0185,260,443,703,60,763,1338,57.03%,19.43%,1
臺北市,士林區,0186,288,457,745,61,806,1515,53.2%,19.01%,1
臺北市,士林區,0187,325,503,828,48,876,1452,60.33%,22.38%,1
臺北市,士林區,0188,307,487,794,44,838,1448,57.87%,21.2%,1
臺北市,士林區,0189,320,557,877,35,912,1521,59.96%,21.04%,1
臺北市,士林區,0190,329,482,811,33,844,1461,57.77%,22.52%,1
臺北市,士林區,0191,327,458,785,54,839,1541,54.45%,21.22%,1
臺北市,士林區,0192,307,413,720,43,763,1611,47.36%,19.06%,1
臺北市,士林區,0193,312,526,838,60,898,1595,56.3%,19.56%,1
臺北市,士林區,0194,323,527,850,33,883,1685,52.4%,19.17%,1
臺北市,士林區,0195,315,550,865,62,927,1816,51.05%,17.35%,1
臺北市,士林區,0196,327,575,902,61,963,1687,57.08%,19.38%,1
臺北市,士林區,0197,320,556,876,61,937,1646,56.93%,19.44%,1
臺北市,士林區,0198,306,536,842,44,886,1643,53.93%,18.62%,1
臺北市,士林區,0199,321,610,931,43,974,1687,57.74%,19.03%,1
臺北市,士林區,0200,333,581,914,54,968,1655,58.49%,20.12%,1
臺北市,士林區,0201,461,460,921,40,961,1779,54.02%,25.91%,1
臺北市,士林區,0202,415,626,1041,48,1089,1855,58.71%,22.37%,1
臺北市,士林區,0203,298,446,744,43,787,1350,58.3%,22.07%,1
臺北市,士林區,0204,260,470,730,34,764,1455,52.51%,17.87%,1
臺北市,士林區,0205,262,405,667,56,723,1497,48.3%,17.5%,1
臺北市,士林區,0206,245,388,633,41,674,1398,48.21%,17.53%,1
臺北市,士林區,0207,349,622,971,56,1027,1747,58.79%,19.98%,1
臺北市,士林區,0208,287,460,747,73,820,1465,55.97%,19.59%,1
臺北市,士林區,0209,288,513,801,65,866,1530,56.6%,18.82%,1
臺北市,士林區,0210,346,563,909,62,971,1855,52.35%,18.65%,1
臺北市,士林區,0211,312,461,773,57,830,1444,57.48%,21.61%,1
臺北市,士林區,0212,317,469,786,49,835,1563,53.42%,20.28%,1
臺北市,士林區,0213,305,486,791,67,858,1482,57.89%,20.58%,1
臺北市,士林區,0214,326,474,800,69,869,1552,55.99%,21.01%,1
臺北市,士林區,0215,349,608,957,58,1015,1790,56.7%,19.5%,1
臺北市,士林區,0216,281,502,783,75,858,1628,52.7%,17.26%,1
臺北市,士林區,0217,258,441,699,59,758,1337,56.69%,19.3%,1
臺北市,士林區,0218,353,576,929,65,994,1750,56.8%,20.17%,1
臺北市,士林區,0219,309,496,805,95,900,1668,53.96%,18.53%,1
臺北市,士林區,0220,238,369,607,60,667,1403,47.54%,16.96%,1
臺北市,士林區,0221,262,396,658,42,700,1468,47.68%,17.85%,1
臺北市,士林區,0222,224,463,687,41,728,1471,49.49%,15.23%,1
臺北市,士林區,0223,305,504,809,65,874,1666,52.46%,18.31%,1
臺北市,士林區,0224,307,476,783,50,833,1587,52.49%,19.34%,1
臺北市,士林區,0225,322,556,878,68,946,1987,47.61%,16.21%,1
臺北市,士林區,0226,299,334,633,21,654,1271,51.46%,23.52%,1
臺北市,士林區,0227,363,617,980,58,1038,1728,60.07%,21.01%,1
臺北市,士林區,0228,337,587,924,55,979,1630,60.06%,20.67%,1
臺北市,士林區,0229,362,568,930,40,970,1619,59.91%,22.36%,1
臺北市,士林區,0230,294,504,798,14,812,1425,56.98%,20.63%,1
臺北市,士林區,0231,389,572,961,50,1011,1623,62.29%,23.97%,1
臺北市,士林區,0232,344,530,874,53,927,1564,59.27%,21.99%,1
臺北市,士林區,0233,265,590,855,42,897,1376,65.19%,19.26%,1
臺北市,士林區,0234,314,596,910,31,941,1517,62.03%,20.7%,1
臺北市,士林區,0235,344,546,890,39,929,1729,53.73%,19.9%,1
臺北市,士林區,0236,349,542,891,37,928,1511,61.42%,23.1%,1
臺北市,士林區,0237,389,655,1044,39,1083,1811,59.8%,21.48%,1
臺北市,士林區,0238,368,513,881,31,912,1533,59.49%,24.01%,1
臺北市,士林區,0239,381,644,1025,49,1074,1657,64.82%,22.99%,1
臺北市,士林區,0240,317,510,827,32,859,1499,57.3%,21.15%,1
臺北市,士林區,0241,249,513,762,47,809,1402,57.7%,17.76%,1
臺北市,士林區,0242,308,460,768,62,830,1273,65.2%,24.19%,1
臺北市,士林區,0243,297,433,730,37,767,1273,60.25%,23.33%,1
臺北市,士林區,0244,308,437,745,40,785,1316,59.65%,23.4%,1
臺北市,士林區,0245,343,568,911,52,963,1659,58.05%,20.68%,1
臺北市,士林區,0246,420,521,941,48,989,1749,56.55%,24.01%,1
臺北市,士林區,0247,328,504,832,57,889,1552,57.28%,21.13%,1
臺北市,士林區,0248,296,576,872,41,913,1529,59.71%,19.36%,1
臺北市,士林區,0249,272,612,884,35,919,1644,55.9%,16.55%,1
臺北市,士林區,0250,363,603,966,40,1006,1779,56.55%,20.4%,1
臺北市,士林區,0251,359,520,879,39,918,1597,57.48%,22.48%,1
臺北市,士林區,0252,321,487,808,36,844,1454,58.05%,22.08%,1
臺北市,士林區,0253,381,531,912,55,967,1582,61.13%,24.08%,1
臺北市,士林區,0254,357,510,867,41,908,1518,59.82%,23.52%,1
臺北市,士林區,0255,323,463,786,25,811,1501,54.03%,21.52%,1
臺北市,士林區,0256,323,495,818,42,860,1420,60.56%,22.75%,1
臺北市,士林區,0257,337,495,832,45,877,1494,58.7%,22.56%,1
臺北市,士林區,0258,370,570,940,35,975,1568,62.18%,23.6%,1
臺北市,士林區,0259,306,425,731,38,769,1208,63.66%,25.33%,1
臺北市,士林區,0260,372,615,987,49,1036,1826,56.74%,20.37%,1
臺北市,士林區,0261,369,534,903,40,943,1647,57.26%,22.4%,1
臺北市,士林區,0262,351,537,888,53,941,1654,56.89%,21.22%,1
臺北市,士林區,0263,363,538,901,34,935,1550,60.32%,23.42%,1
臺北市,士林區,0264,338,455,793,27,820,1298,63.17%,26.04%,1
臺北市,士林區,0265,300,471,771,40,811,1297,62.53%,23.13%,1
臺北市,士林區,0266,313,413,726,42,768,1352,56.8%,23.15%,1
臺北市,士林區,0267,313,525,838,38,876,1522,57.56%,20.57%,1
臺北市,士林區,0268,383,474,857,67,924,1602,57.68%,23.91%,1
臺北市,士林區,0269,343,461,804,36,840,1441,58.29%,23.8%,1
臺北市,士林區,0270,316,392,708,15,723,1325,54.57%,23.85%,1
臺北市,士林區,0271,342,522,864,42,906,1567,57.82%,21.83%,1
臺北市,士林區,0272,332,496,828,14,842,1518,55.47%,21.87%,1
臺北市,士林區,0273,357,554,911,36,947,1549,61.14%,23.05%,1
臺北市,士林區,0274,386,545,931,26,957,1652,57.93%,23.37%,1
臺北市,士林區,0275,417,574,991,50,1041,1766,58.95%,23.61%,1
臺北市,士林區,0276,360,525,885,26,911,1638,55.62%,21.98%,1
臺北市,士林區,0277,306,479,785,40,825,1491,55.33%,20.52%,1
臺北市,士林區,0278,328,540,868,22,890,1521,58.51%,21.56%,1
臺北市,士林區,0279,291,483,774,49,823,1351,60.92%,21.54%,1
臺北市,士林區,0280,349,566,915,21,936,1742,53.73%,20.03%,1
臺北市,士林區,0281,493,387,880,32,912,1585,57.54%,31.1%,1
臺北市,士林區,0282,302,551,853,38,891,1521,58.58%,19.86%,1
臺北市,士林區,0283,335,490,825,30,855,1543,55.41%,21.71%,1
臺北市,士林區,0284,297,519,816,21,837,1404,59.62%,21.15%,1
臺北市,士林區,0285,332,527,859,35,894,1541,58.01%,21.54%,1
臺北市,士林區,0286,300,545,845,39,884,1584,55.81%,18.94%,1
臺北市,士林區,0287,349,519,868,43,911,1519,59.97%,22.98%,1
臺北市,士林區,0288,295,469,764,18,782,1482,52.77%,19.91%,1
臺北市,士林區,0289,273,447,720,34,754,1243,60.66%,21.96%,1
臺北市,士林區,0290,209,415,624,41,665,1156,57.53%,18.08%,1
臺北市,士林區,0291,251,355,606,76,682,1262,54.04%,19.89%,1
臺北市,士林區,0292,181,319,500,33,533,889,59.96%,20.36%,1
臺北市,士林區,0293,211,287,498,41,539,858,62.82%,24.59%,1
臺北市,士林區,0294,184,295,479,55,534,945,56.51%,19.47%,1
臺北市,士林區,0295,192,316,508,48,556,960,57.92%,20%,1
臺北市,士林區,0296,154,295,449,43,492,876,56.16%,17.58%,1
臺北市,士林區,0297,129,200,329,34,363,556,65.29%,23.2%,1
臺北市,士林區,0298,158,364,522,55,577,919,62.79%,17.19%,1
臺北市,士林區,0299,291,531,822,80,902,1360,66.32%,21.4%,1
臺北市,士林區,0300,257,514,771,63,834,1355,61.55%,18.97%,1
臺北市,士林區,0301,260,452,712,32,744,1252,59.42%,20.77%,1
臺北市,士林區,0302,239,462,701,40,741,1182,62.69%,20.22%,1
臺北市,士林區,0303,255,418,673,29,702,1431,49.06%,17.82%,1
臺北市,士林區,0304,249,397,646,36,682,1240,55%,20.08%,1
臺北市,北投區,0001,276,474,750,53,803,1313,61.16%,21.02%,1
臺北市,北投區,0002,335,500,835,35,870,1403,62.01%,23.88%,1
臺北市,北投區,0003,269,362,631,35,666,1081,61.61%,24.88%,1
臺北市,北投區,0004,276,405,681,50,731,1209,60.46%,22.83%,1
臺北市,北投區,0005,301,429,730,48,778,1326,58.67%,22.7%,1
臺北市,北投區,0006,295,431,726,43,769,1263,60.89%,23.36%,1
臺北市,北投區,0007,362,550,912,55,967,1580,61.2%,22.91%,1
臺北市,北投區,0008,322,569,891,43,934,1577,59.23%,20.42%,1
臺北市,北投區,0009,324,512,836,50,886,1483,59.74%,21.85%,1
臺北市,北投區,0010,307,485,792,32,824,1461,56.4%,21.01%,1
臺北市,北投區,0011,310,476,786,51,837,1466,57.09%,21.15%,1
臺北市,北投區,0012,335,587,922,45,967,1620,59.69%,20.68%,1
臺北市,北投區,0013,294,500,794,32,826,1543,53.53%,19.05%,1
臺北市,北投區,0014,273,493,766,56,822,1513,54.33%,18.04%,1
臺北市,北投區,0015,300,560,860,33,893,1534,58.21%,19.56%,1
臺北市,北投區,0016,339,584,923,61,984,1650,59.64%,20.55%,1
臺北市,北投區,0017,338,519,857,39,896,1533,58.45%,22.05%,1
臺北市,北投區,0018,344,557,901,37,938,1702,55.11%,20.21%,1
臺北市,北投區,0019,432,511,943,35,978,1721,56.83%,25.1%,1
臺北市,北投區,0020,402,519,921,44,965,1575,61.27%,25.52%,1
臺北市,北投區,0021,314,258,572,62,634,1530,41.44%,20.52%,1
臺北市,北投區,0022,359,605,964,50,1014,1728,58.68%,20.78%,1
臺北市,北投區,0023,328,580,908,58,966,1702,56.76%,19.27%,1
臺北市,北投區,0024,350,556,906,57,963,1696,56.78%,20.64%,1
臺北市,北投區,0025,260,498,758,34,792,1684,47.03%,15.44%,1
臺北市,北投區,0026,382,609,991,39,1030,1717,59.99%,22.25%,1
臺北市,北投區,0027,359,545,904,38,942,1605,58.69%,22.37%,1
臺北市,北投區,0028,324,608,932,58,990,1723,57.46%,18.8%,1
臺北市,北投區,0029,367,585,952,39,991,1597,62.05%,22.98%,1
臺北市,北投區,0030,349,594,943,36,979,1700,57.59%,20.53%,1
臺北市,北投區,0031,346,430,776,35,811,1544,52.53%,22.41%,1
臺北市,北投區,0032,318,519,837,39,876,1635,53.58%,19.45%,1
臺北市,北投區,0033,330,520,850,23,873,1495,58.39%,22.07%,1
臺北市,北投區,0034,343,552,895,43,938,1619,57.94%,21.19%,1
臺北市,北投區,0035,407,517,924,35,959,1683,56.98%,24.18%,1
臺北市,北投區,0036,339,525,864,38,902,1662,54.27%,20.4%,1
臺北市,北投區,0037,358,525,883,24,907,1850,49.03%,19.35%,1
臺北市,北投區,0038,370,487,857,19,876,1674,52.33%,22.1%,1
臺北市,北投區,0039,314,557,871,47,918,1511,60.75%,20.78%,1
臺北市,北投區,0040,268,503,771,19,790,1393,56.71%,19.24%,1
臺北市,北投區,0041,290,475,765,45,810,1279,63.33%,22.67%,1
臺北市,北投區,0042,241,366,607,29,636,1122,56.68%,21.48%,1
臺北市,北投區,0043,296,509,805,47,852,1238,68.82%,23.91%,1
臺北市,北投區,0044,334,526,860,59,919,1477,62.22%,22.61%,1
臺北市,北投區,0045,331,538,869,43,912,1495,61%,22.14%,1
臺北市,北投區,0046,337,551,888,40,928,1469,63.17%,22.94%,1
臺北市,北投區,0047,274,540,814,45,859,1462,58.76%,18.74%,1
臺北市,北投區,0048,275,531,806,47,853,1431,59.61%,19.22%,1
臺北市,北投區,0049,356,477,833,32,865,1486,58.21%,23.96%,1
臺北市,北投區,0050,321,507,828,55,883,1449,60.94%,22.15%,1
臺北市,北投區,0051,342,489,831,28,859,1456,59%,23.49%,1
臺北市,北投區,0052,274,453,727,36,763,1311,58.2%,20.9%,1
臺北市,北投區,0053,272,483,755,51,806,1356,59.44%,20.06%,1
臺北市,北投區,0054,299,456,755,27,782,1338,58.45%,22.35%,1
臺北市,北投區,0055,324,524,848,34,882,1525,57.84%,21.25%,1
臺北市,北投區,0056,338,522,860,31,891,1620,55%,20.86%,1
臺北市,北投區,0057,308,484,792,20,812,1499,54.17%,20.55%,1
臺北市,北投區,0058,299,566,865,31,896,1497,59.85%,19.97%,1
臺北市,北投區,0059,355,520,875,43,918,1624,56.53%,21.86%,1
臺北市,北投區,0060,305,493,798,56,854,1536,55.6%,19.86%,1
臺北市,北投區,0061,346,517,863,59,922,1469,62.76%,23.55%,1
臺北市,北投區,0062,318,529,847,45,892,1598,55.82%,19.9%,1
臺北市,北投區,0063,348,551,899,34,933,1690,55.21%,20.59%,1
臺北市,北投區,0064,255,526,781,82,863,1599,53.97%,15.95%,1
臺北市,北投區,0065,355,533,888,49,937,1634,57.34%,21.73%,1
臺北市,北投區,0066,335,509,844,42,886,1660,53.37%,20.18%,1
臺北市,北投區,0067,403,548,951,50,1001,1900,52.68%,21.21%,1
臺北市,北投區,0068,399,585,984,50,1034,1797,57.54%,22.2%,1
臺北市,北投區,0069,392,628,1020,46,1066,1832,58.19%,21.4%,1
臺北市,北投區,0070,370,619,989,56,1045,1784,58.58%,20.74%,1
臺北市,北投區,0071,366,593,959,57,1016,1732,58.66%,21.13%,1
臺北市,北投區,0072,206,317,523,38,561,2035,27.57%,10.12%,1
臺北市,北投區,0073,329,472,801,57,858,1504,57.05%,21.88%,1
臺北市,北投區,0074,317,624,941,63,1004,1683,59.66%,18.84%,1
臺北市,北投區,0075,318,516,834,70,904,1635,55.29%,19.45%,1
臺北市,北投區,0076,336,524,860,57,917,1613,56.85%,20.83%,1
臺北市,北投區,0077,303,471,774,26,800,1483,53.94%,20.43%,1
臺北市,北投區,0078,301,505,806,41,847,1500,56.47%,20.07%,1
臺北市,北投區,0079,334,494,828,45,873,1483,58.87%,22.52%,1
臺北市,北投區,0080,313,496,809,65,874,1544,56.61%,20.27%,1
臺北市,北投區,0081,278,448,726,50,776,1532,50.65%,18.15%,1
臺北市,北投區,0082,372,589,961,66,1027,1819,56.46%,20.45%,1
臺北市,北投區,0083,306,589,895,62,957,1863,51.37%,16.43%,1
臺北市,北投區,0084,377,537,914,25,939,1872,50.16%,20.14%,1
臺北市,北投區,0085,309,588,897,48,945,1627,58.08%,18.99%,1
臺北市,北投區,0086,316,559,875,25,900,1696,53.07%,18.63%,1
臺北市,北投區,0087,401,583,984,43,1027,1841,55.78%,21.78%,1
臺北市,北投區,0088,303,411,714,39,753,1324,56.87%,22.89%,1
臺北市,北投區,0089,285,511,796,26,822,1504,54.65%,18.95%,1
臺北市,北投區,0090,305,519,824,35,859,1511,56.85%,20.19%,1
臺北市,北投區,0091,352,563,915,40,955,1615,59.13%,21.8%,1
臺北市,北投區,0092,245,395,640,31,671,1270,52.83%,19.29%,1
臺北市,北投區,0093,294,420,714,34,748,1492,50.13%,19.71%,1
臺北市,北投區,0094,318,438,756,26,782,1429,54.72%,22.25%,1
臺北市,北投區,0095,330,467,797,21,818,1567,52.2%,21.06%,1
臺北市,北投區,0096,286,466,752,34,786,1388,56.63%,20.61%,1
臺北市,北投區,0097,295,458,753,15,768,1448,53.04%,20.37%,1
臺北市,北投區,0098,261,433,694,39,733,1356,54.06%,19.25%,1
臺北市,北投區,0099,253,450,703,34,737,1308,56.35%,19.34%,1
臺北市,北投區,0100,256,416,672,41,713,1165,61.2%,21.97%,1
臺北市,北投區,0101,281,528,809,57,866,1429,60.6%,19.66%,1
臺北市,北投區,0102,260,523,783,23,806,1472,54.76%,17.66%,1
臺北市,北投區,0103,350,563,913,35,948,1508,62.86%,23.21%,1
臺北市,北投區,0104,268,525,793,47,840,1480,56.76%,18.11%,1
臺北市,北投區,0105,237,352,589,32,621,1142,54.38%,20.75%,1
臺北市,北投區,0106,304,496,800,29,829,1554,53.35%,19.56%,1
臺北市,北投區,0107,357,582,939,63,1002,1669,60.04%,21.39%,1
臺北市,北投區,0108,327,640,967,50,1017,1823,55.79%,17.94%,1
臺北市,北投區,0109,338,575,913,51,964,1739,55.43%,19.44%,1
臺北市,北投區,0110,321,566,887,56,943,1771,53.25%,18.13%,1
臺北市,北投區,0111,240,489,729,48,777,1468,52.93%,16.35%,1
臺北市,北投區,0112,282,511,793,32,825,1469,56.16%,19.2%,1
臺北市,北投區,0113,222,459,681,30,711,1094,64.99%,20.29%,1
臺北市,北投區,0114,198,461,659,35,694,1101,63.03%,17.98%,1
臺北市,北投區,0115,296,536,832,35,867,1422,60.97%,20.82%,1
臺北市,北投區,0116,328,404,732,46,778,1390,55.97%,23.6%,1
臺北市,北投區,0117,278,463,741,42,783,1307,59.91%,21.27%,1
臺北市,北投區,0118,284,429,713,59,772,1215,63.54%,23.37%,1
臺北市,北投區,0119,316,528,844,58,902,1642,54.93%,19.24%,1
臺北市,北投區,0120,288,531,819,43,862,1623,53.11%,17.74%,1
臺北市,北投區,0121,334,520,854,51,905,1621,55.83%,20.6%,1
臺北市,北投區,0122,314,428,742,19,761,1367,55.67%,22.97%,1
臺北市,北投區,0123,284,403,687,37,724,1309,55.31%,21.7%,1
臺北市,北投區,0124,313,447,760,27,787,1356,58.04%,23.08%,1
臺北市,北投區,0125,287,444,731,37,768,1365,56.26%,21.03%,1
臺北市,北投區,0126,347,499,846,29,875,1613,54.25%,21.51%,1
臺北市,北投區,0127,308,441,749,34,783,1590,49.25%,19.37%,1
臺北市,北投區,0128,339,584,923,48,971,1662,58.42%,20.4%,1
臺北市,北投區,0129,370,511,881,57,938,1622,57.83%,22.81%,1
臺北市,北投區,0130,404,569,973,29,1002,1820,55.05%,22.2%,1
臺北市,北投區,0131,312,583,895,52,947,1615,58.64%,19.32%,1
臺北市,北投區,0132,243,448,691,64,755,1612,46.84%,15.07%,1
臺北市,北投區,0133,342,521,863,61,924,1652,55.93%,20.7%,1
臺北市,北投區,0134,345,576,921,21,942,1666,56.54%,20.71%,1
臺北市,北投區,0135,328,528,856,45,901,1641,54.91%,19.99%,1
臺北市,北投區,0136,141,163,304,19,323,528,61.17%,26.7%,1
臺北市,北投區,0137,274,452,726,61,787,1642,47.93%,16.69%,1
臺北市,北投區,0138,156,278,434,37,471,829,56.82%,18.82%,1
臺北市,北投區,0139,101,256,357,26,383,690,55.51%,14.64%,1
臺北市,北投區,0140,180,361,541,43,584,1067,54.73%,16.87%,1
臺北市,北投區,0141,153,302,455,52,507,892,56.84%,17.15%,1
新北市,板橋區,0894,279,424,703,73,776,1388,55.91%,20.1%,1
新北市,板橋區,0895,300,426,726,35,761,1294,58.81%,23.18%,1
新北市,板橋區,0896,171,233,404,15,419,667,62.82%,25.64%,1
新北市,板橋區,0897,163,295,458,28,486,898,54.12%,18.15%,1
新北市,板橋區,0898,168,310,478,28,506,829,61.04%,20.27%,1
新北市,板橋區,0899,135,294,429,33,462,739,62.52%,18.27%,1
新北市,板橋區,0900,215,379,594,43,637,1035,61.55%,20.77%,1
新北市,板橋區,0901,310,463,773,25,798,1713,46.58%,18.1%,1
新北市,板橋區,0902,110,217,327,13,340,658,51.67%,16.72%,1
新北市,板橋區,0903,226,432,658,79,737,1312,56.17%,17.23%,1
新北市,板橋區,0904,243,484,727,46,773,1492,51.81%,16.29%,1
新北市,板橋區,0905,216,450,666,57,723,1393,51.9%,15.51%,1
新北市,板橋區,0906,403,535,938,40,978,4742,20.62%,8.5%,1
新北市,板橋區,0907,280,467,747,39,786,1439,54.62%,19.46%,1
新北市,板橋區,0908,251,408,659,69,728,1187,61.33%,21.15%,1
新北市,板橋區,0909,226,367,593,34,627,1122,55.88%,20.14%,1
新北市,板橋區,0910,255,484,739,61,800,1363,58.69%,18.71%,1
新北市,板橋區,0911,215,380,595,52,647,1093,59.19%,19.67%,1
新北市,板橋區,0912,297,465,762,42,804,1331,60.41%,22.31%,1
新北市,板橋區,0913,216,387,603,39,642,1026,62.57%,21.05%,1
新北市,板橋區,0914,251,421,672,58,730,1244,58.68%,20.18%,1
新北市,板橋區,0915,233,385,618,70,688,1268,54.26%,18.38%,1
新北市,板橋區,0916,217,442,659,33,692,1313,52.7%,16.53%,1
新北市,板橋區,0917,279,410,689,43,732,1196,61.2%,23.33%,1
新北市,板橋區,0918,276,470,746,31,777,1137,68.34%,24.27%,1
新北市,板橋區,0919,300,473,773,38,811,1269,63.91%,23.64%,1
新北市,板橋區,0920,228,431,659,31,690,1117,61.77%,20.41%,1
新北市,板橋區,0921,209,417,626,36,662,1042,63.53%,20.06%,1
新北市,板橋區,0922,234,452,686,76,762,1257,60.62%,18.62%,1
新北市,板橋區,0923,222,454,676,49,725,1216,59.62%,18.26%,1
新北市,板橋區,0924,249,357,606,54,660,1126,58.61%,22.11%,1
新北市,板橋區,0925,293,502,795,47,842,1290,65.27%,22.71%,1
新北市,板橋區,0926,227,389,616,14,630,1215,51.85%,18.68%,1
新北市,板橋區,0927,194,388,582,26,608,1099,55.32%,17.65%,1
新北市,板橋區,0928,251,564,815,34,849,1329,63.88%,18.89%,1
新北市,板橋區,0929,161,420,581,23,604,996,60.64%,16.16%,1
新北市,板橋區,0930,209,391,600,30,630,1047,60.17%,19.96%,1
新北市,板橋區,0931,237,478,715,54,769,1272,60.46%,18.63%,1
新北市,板橋區,0932,344,377,721,36,757,1252,60.46%,27.48%,1
新北市,板橋區,0933,220,457,677,54,731,1238,59.05%,17.77%,1
新北市,板橋區,0934,310,510,820,63,883,1389,63.57%,22.32%,1
新北市,板橋區,0935,252,441,693,53,746,1194,62.48%,21.11%,1
新北市,板橋區,0936,198,348,546,53,599,1093,54.8%,18.12%,1
新北市,板橋區,0937,210,388,598,70,668,1148,58.19%,18.29%,1
新北市,板橋區,0938,257,462,719,48,767,1268,60.49%,20.27%,1
新北市,板橋區,0939,236,415,651,67,718,1230,58.37%,19.19%,1
新北市,板橋區,0940,161,381,542,36,578,1012,57.11%,15.91%,1
新北市,板橋區,0941,158,290,448,41,489,811,60.3%,19.48%,1
新北市,板橋區,0942,253,452,705,51,756,1197,63.16%,21.14%,1
新北市,板橋區,0943,207,413,620,30,650,1142,56.92%,18.13%,1
新北市,板橋區,0944,236,436,672,37,709,1222,58.02%,19.31%,1
新北市,板橋區,0945,145,324,469,38,507,796,63.69%,18.22%,1
新北市,板橋區,0946,232,348,580,67,647,997,64.89%,23.27%,1
新北市,板橋區,0947,213,352,565,33,598,1011,59.15%,21.07%,1
新北市,板橋區,0948,241,387,628,54,682,1157,58.95%,20.83%,1
新北市,板橋區,0949,200,385,585,49,634,1040,60.96%,19.23%,1
新北市,板橋區,0950,237,431,668,37,705,1173,60.1%,20.2%,1
新北市,板橋區,0951,132,390,522,26,548,1193,45.93%,11.06%,1
新北市,板橋區,0952,246,477,723,40,763,1255,60.8%,19.6%,1
新北市,板橋區,0953,294,446,740,35,775,1306,59.34%,22.51%,1
新北市,板橋區,0954,217,391,608,17,625,1050,59.52%,20.67%,1
新北市,板橋區,0955,195,337,532,30,562,942,59.66%,20.7%,1
新北市,板橋區,0956,212,460,672,44,716,1133,63.2%,18.71%,1
新北市,板橋區,0957,235,470,705,33,738,1251,58.99%,18.78%,1
新北市,板橋區,0958,256,489,745,36,781,1293,60.4%,19.8%,1
新北市,板橋區,0959,219,384,603,57,660,1208,54.64%,18.13%,1
新北市,板橋區,0960,234,424,658,55,713,1223,58.3%,19.13%,1
新北市,板橋區,0961,203,352,555,49,604,1061,56.93%,19.13%,1
新北市,板橋區,0962,310,527,837,45,882,1515,58.22%,20.46%,1
新北市,板橋區,0963,230,481,711,44,755,1225,61.63%,18.78%,1
新北市,板橋區,0964,214,468,682,35,717,1120,64.02%,19.11%,1
新北市,板橋區,0965,228,425,653,42,695,1091,63.7%,20.9%,1
新北市,板橋區,0966,240,579,819,29,848,1385,61.23%,17.33%,1
新北市,板橋區,0967,260,485,745,50,795,1283,61.96%,20.27%,1
新北市,板橋區,0968,234,421,655,68,723,1204,60.05%,19.44%,1
新北市,板橋區,0969,253,461,714,42,756,1191,63.48%,21.24%,1
新北市,板橋區,0970,208,431,639,47,686,1078,63.64%,19.29%,1
新北市,板橋區,0971,248,493,741,64,805,1351,59.59%,18.36%,1
新北市,板橋區,0972,277,456,733,47,780,1322,59%,20.95%,1
新北市,板橋區,0973,154,320,474,51,525,868,60.48%,17.74%,1
新北市,板橋區,0974,226,410,636,55,691,1029,67.15%,21.96%,1
新北市,板橋區,0975,309,585,894,35,929,1602,57.99%,19.29%,1
新北市,板橋區,0976,255,516,771,54,825,1362,60.57%,18.72%,1
新北市,板橋區,0977,344,553,897,68,965,1698,56.83%,20.26%,1
新北市,板橋區,0978,297,527,824,28,852,1495,56.99%,19.87%,1
新北市,板橋區,0979,319,474,793,58,851,1522,55.91%,20.96%,1
新北市,板橋區,0980,256,443,699,58,757,1279,59.19%,20.02%,1
新北市,板橋區,0981,260,453,713,44,757,1559,48.56%,16.68%,1
新北市,板橋區,0982,282,473,755,74,829,1537,53.94%,18.35%,1
新北市,板橋區,0983,282,461,743,59,802,1531,52.38%,18.42%,1
新北市,板橋區,0984,328,570,898,28,926,1720,53.84%,19.07%,1
新北市,板橋區,0985,210,393,603,37,640,1165,54.94%,18.03%,1
新北市,板橋區,0986,386,625,1011,50,1061,1857,57.14%,20.79%,1
新北市,板橋區,0987,209,359,568,62,630,1078,58.44%,19.39%,1
新北市,板橋區,0988,221,395,616,20,636,1177,54.04%,18.78%,1
新北市,板橋區,0989,371,620,991,55,1046,1798,58.18%,20.63%,1
新北市,板橋區,0990,284,524,808,72,880,1455,60.48%,19.52%,1
新北市,板橋區,0991,254,449,703,59,762,1245,61.2%,20.4%,1
新北市,板橋區,0992,342,528,870,70,940,1704,55.16%,20.07%,1
新北市,板橋區,0993,362,506,868,31,899,1600,56.19%,22.63%,1
新北市,板橋區,0994,233,470,703,30,733,1409,52.02%,16.54%,1
新北市,板橋區,0995,252,445,697,45,742,1286,57.7%,19.6%,1
新北市,板橋區,0996,193,387,580,92,672,1359,49.45%,14.2%,1
新北市,板橋區,0997,220,374,594,34,628,1188,52.86%,18.52%,1
新北市,板橋區,0998,298,518,816,55,871,1627,53.53%,18.32%,1
新北市,板橋區,0999,314,478,792,35,827,1633,50.64%,19.23%,1
新北市,板橋區,1000,402,626,1028,54,1082,1814,59.65%,22.16%,1
新北市,板橋區,1001,358,624,982,55,1037,1810,57.29%,19.78%,1
新北市,板橋區,1002,203,407,610,52,662,1133,58.43%,17.92%,1
新北市,板橋區,1003,155,299,454,34,488,841,58.03%,18.43%,1
新北市,板橋區,1004,206,397,603,51,654,1050,62.29%,19.62%,1
新北市,板橋區,1005,211,371,582,56,638,1130,56.46%,18.67%,1
新北市,板橋區,1006,229,371,600,60,660,1056,62.5%,21.69%,1
新北市,板橋區,1007,217,356,573,31,604,1129,53.5%,19.22%,1
新北市,板橋區,1008,316,590,906,69,975,1713,56.92%,18.45%,1
新北市,板橋區,1009,302,573,875,62,937,1622,57.77%,18.62%,1
新北市,板橋區,1010,312,540,852,47,899,1427,63%,21.86%,1
新北市,板橋區,1011,319,571,890,27,917,1471,62.34%,21.69%,1
新北市,板橋區,1012,192,390,582,16,598,1076,55.58%,17.84%,1
新北市,板橋區,1013,184,305,489,20,509,979,51.99%,18.79%,1
新北市,板橋區,1014,199,464,663,22,685,1079,63.48%,18.44%,1
新北市,板橋區,1015,163,288,451,36,487,828,58.82%,19.69%,1
新北市,板橋區,1016,149,308,457,60,517,820,63.05%,18.17%,1
新北市,板橋區,1017,210,358,568,34,602,989,60.87%,21.23%,1
新北市,板橋區,1018,192,354,546,55,601,1023,58.75%,18.77%,1
新北市,板橋區,1019,200,349,549,32,581,1044,55.65%,19.16%,1
新北市,板橋區,1020,174,349,523,50,573,968,59.19%,17.98%,1
新北市,板橋區,1021,422,266,688,30,718,1222,58.76%,34.53%,1
新北市,板橋區,1022,255,473,728,41,769,1385,55.52%,18.41%,1
新北市,板橋區,1023,314,501,815,55,870,1585,54.89%,19.81%,1
新北市,板橋區,1024,350,615,965,62,1027,1840,55.82%,19.02%,1
新北市,板橋區,1025,367,688,1055,69,1124,1806,62.24%,20.32%,1
新北市,板橋區,1026,286,506,792,68,860,1506,57.1%,18.99%,1
新北市,板橋區,1027,275,491,766,61,827,1476,56.03%,18.63%,1
新北市,板橋區,1028,315,514,829,54,883,1500,58.87%,21%,1
新北市,板橋區,1029,223,405,628,64,692,1096,63.14%,20.35%,1
新北市,板橋區,1030,196,357,553,49,602,963,62.51%,20.35%,1
新北市,板橋區,1031,307,542,849,44,893,1601,55.78%,19.18%,1
新北市,板橋區,1032,336,542,878,54,932,1507,61.84%,22.3%,1
新北市,板橋區,1033,280,480,760,56,816,1315,62.05%,21.29%,1
新北市,板橋區,1034,217,422,639,31,670,1178,56.88%,18.42%,1
新北市,板橋區,1035,396,636,1032,74,1106,1822,60.7%,21.73%,1
新北市,板橋區,1036,340,599,939,64,1003,1605,62.49%,21.18%,1
新北市,板橋區,1037,314,569,883,23,906,1549,58.49%,20.27%,1
新北市,板橋區,1038,460,676,1136,26,1162,1948,59.65%,23.61%,1
新北市,板橋區,1039,370,664,1034,40,1074,1935,55.5%,19.12%,1
新北市,板橋區,1040,193,349,542,48,590,1097,53.78%,17.59%,1
新北市,板橋區,1041,214,361,575,36,611,1095,55.8%,19.54%,1
新北市,板橋區,1042,270,574,844,77,921,1678,54.89%,16.09%,1
新北市,板橋區,1043,316,589,905,75,980,1750,56%,18.06%,1
新北市,板橋區,1044,214,399,613,51,664,1187,55.94%,18.03%,1
新北市,板橋區,1045,248,403,651,29,680,1154,58.93%,21.49%,1
新北市,板橋區,1046,285,445,730,32,762,1262,60.38%,22.58%,1
新北市,板橋區,1047,200,444,644,78,722,1271,56.81%,15.74%,1
新北市,板橋區,1048,481,261,742,64,806,1410,57.16%,34.11%,1
新北市,板橋區,1049,339,522,861,71,932,1745,53.41%,19.43%,1
新北市,板橋區,1050,318,639,957,100,1057,1867,56.61%,17.03%,1
新北市,板橋區,1051,349,624,973,73,1046,1753,59.67%,19.91%,1
新北市,板橋區,1052,235,429,664,62,726,1204,60.3%,19.52%,1
新北市,板橋區,1053,297,525,822,58,880,1614,54.52%,18.4%,1
新北市,板橋區,1054,266,432,698,44,742,1237,59.98%,21.5%,1
新北市,板橋區,1055,295,461,756,54,810,1361,59.52%,21.68%,1
新北市,板橋區,1056,278,421,699,27,726,1243,58.41%,22.37%,1
新北市,板橋區,1057,281,474,755,29,784,1515,51.75%,18.55%,1
新北市,板橋區,1058,317,541,858,52,910,1515,60.07%,20.92%,1
新北市,板橋區,1059,172,368,540,45,585,949,61.64%,18.12%,1
新北市,板橋區,1060,292,547,839,60,899,1629,55.19%,17.93%,1
新北市,板橋區,1061,237,451,688,37,725,1238,58.56%,19.14%,1
新北市,板橋區,1062,130,238,368,29,397,901,44.06%,14.43%,1
新北市,板橋區,1063,296,508,804,62,866,1475,58.71%,20.07%,1
新北市,板橋區,1064,281,496,777,55,832,1481,56.18%,18.97%,1
新北市,板橋區,1065,300,588,888,68,956,1800,53.11%,16.67%,1
新北市,板橋區,1066,303,514,817,51,868,1630,53.25%,18.59%,1
新北市,板橋區,1067,272,471,743,36,779,1298,60.02%,20.96%,1
新北市,板橋區,1068,191,308,499,26,525,874,60.07%,21.85%,1
新北市,板橋區,1069,199,353,552,17,569,992,57.36%,20.06%,1
新北市,板橋區,1070,227,424,651,16,667,1034,64.51%,21.95%,1
新北市,板橋區,1071,314,486,800,63,863,1451,59.48%,21.64%,1
新北市,板橋區,1072,225,423,648,41,689,1130,60.97%,19.91%,1
新北市,板橋區,1073,261,548,809,39,848,1440,58.89%,18.13%,1
新北市,板橋區,1074,301,531,832,76,908,1531,59.31%,19.66%,1
新北市,板橋區,1075,290,517,807,62,869,1349,64.42%,21.5%,1
新北市,板橋區,1076,200,622,822,31,853,1593,53.55%,12.55%,1
新北市,板橋區,1077,221,441,662,25,687,1174,58.52%,18.82%,1
新北市,板橋區,1078,199,472,671,42,713,1228,58.06%,16.21%,1
新北市,板橋區,1079,231,445,676,32,708,1187,59.65%,19.46%,1
新北市,板橋區,1080,151,346,497,43,540,870,62.07%,17.36%,1
新北市,板橋區,1081,448,745,1193,26,1219,2033,59.96%,22.04%,1
新北市,板橋區,1082,269,452,721,46,767,1418,54.09%,18.97%,1
新北市,板橋區,1083,200,391,591,30,621,1075,57.77%,18.6%,1
新北市,板橋區,1084,286,515,801,34,835,1515,55.12%,18.88%,1
新北市,板橋區,1085,246,478,724,33,757,1182,64.04%,20.81%,1
新北市,板橋區,1086,396,587,983,65,1048,1893,55.36%,20.92%,1
新北市,板橋區,1087,237,437,674,50,724,1302,55.61%,18.2%,1
新北市,板橋區,1088,265,433,698,36,734,1366,53.73%,19.4%,1
新北市,板橋區,1089,275,479,754,76,830,1318,62.97%,20.86%,1
新北市,板橋區,1090,249,393,642,45,687,1200,57.25%,20.75%,1
新北市,板橋區,1091,439,660,1099,44,1143,2028,56.36%,21.65%,1
新北市,板橋區,1092,323,610,933,91,1024,1746,58.65%,18.5%,1
新北市,板橋區,1093,369,607,976,28,1004,1954,51.38%,18.88%,1
新北市,板橋區,1094,296,495,791,42,833,1474,56.51%,20.08%,1
新北市,板橋區,1095,272,493,765,39,804,1418,56.7%,19.18%,1
新北市,板橋區,1096,349,554,903,72,975,1563,62.38%,22.33%,1
新北市,板橋區,1097,304,608,912,75,987,1780,55.45%,17.08%,1
新北市,板橋區,1098,334,569,903,45,948,1707,55.54%,19.57%,1
新北市,板橋區,1099,114,244,358,10,368,906,40.62%,12.58%,1
新北市,板橋區,1100,185,349,534,59,593,1030,57.57%,17.96%,1
新北市,板橋區,1101,216,397,613,45,658,1115,59.01%,19.37%,1
新北市,板橋區,1102,326,677,1003,24,1027,1836,55.94%,17.76%,1
新北市,板橋區,1103,330,646,976,64,1040,1881,55.29%,17.54%,1
新北市,板橋區,1104,335,564,899,31,930,1688,55.09%,19.85%,1
新北市,板橋區,1105,371,635,1006,34,1040,1760,59.09%,21.08%,1
新北市,板橋區,1106,217,398,615,42,657,1044,62.93%,20.79%,1
新北市,板橋區,1107,227,391,618,37,655,1043,62.8%,21.76%,1
新北市,板橋區,1108,227,410,637,54,691,1099,62.88%,20.66%,1
新北市,板橋區,1109,225,454,679,48,727,1260,57.7%,17.86%,1
新北市,板橋區,1110,194,426,620,37,657,1131,58.09%,17.15%,1
新北市,板橋區,1111,224,456,680,41,721,1225,58.86%,18.29%,1
新北市,板橋區,1112,311,553,864,43,907,1455,62.34%,21.37%,1
新北市,板橋區,1113,220,442,662,62,724,1267,57.14%,17.36%,1
新北市,板橋區,1114,199,342,541,53,594,972,61.11%,20.47%,1
新北市,板橋區,1115,204,367,571,30,601,994,60.46%,20.52%,1
新北市,板橋區,1116,223,398,621,19,640,1111,57.61%,20.07%,1
新北市,板橋區,1117,247,463,710,71,781,1177,66.36%,20.99%,1
新北市,板橋區,1118,307,498,805,57,862,1544,55.83%,19.88%,1
新北市,板橋區,1119,161,378,539,56,595,1021,58.28%,15.77%,1
新北市,板橋區,1120,176,359,535,54,589,1040,56.63%,16.92%,1
新北市,板橋區,1121,319,481,800,29,829,1504,55.12%,21.21%,1
新北市,板橋區,1122,256,455,711,35,746,1373,54.33%,18.65%,1
新北市,板橋區,1123,266,440,706,20,726,1210,60%,21.98%,1
新北市,板橋區,1124,309,599,908,60,968,1809,53.51%,17.08%,1
新北市,板橋區,1125,258,587,845,68,913,1551,58.87%,16.63%,1
新北市,板橋區,1126,285,521,806,27,833,1408,59.16%,20.24%,1
新北市,板橋區,1127,271,470,741,28,769,1285,59.84%,21.09%,1
新北市,板橋區,1128,238,432,670,35,705,1102,63.97%,21.6%,1
新北市,板橋區,1129,241,471,712,31,743,1399,53.11%,17.23%,1
新北市,板橋區,1130,312,579,891,74,965,1692,57.03%,18.44%,1
新北市,板橋區,1131,336,635,971,27,998,1625,61.42%,20.68%,1
新北市,板橋區,1132,341,597,938,61,999,1712,58.35%,19.92%,1
新北市,板橋區,1133,240,451,691,32,723,1246,58.03%,19.26%,1
新北市,板橋區,1134,373,446,819,40,859,1471,58.4%,25.36%,1
新北市,板橋區,1135,326,642,968,54,1022,1761,58.04%,18.51%,1
新北市,板橋區,1136,308,509,817,51,868,1499,57.91%,20.55%,1
新北市,板橋區,1137,300,492,792,42,834,1528,54.58%,19.63%,1
新北市,板橋區,1138,327,546,873,47,920,1536,59.9%,21.29%,1
新北市,板橋區,1139,308,558,866,35,901,1550,58.13%,19.87%,1
新北市,板橋區,1140,382,715,1097,78,1175,2050,57.32%,18.63%,1
新北市,板橋區,1141,491,246,737,37,774,1300,59.54%,37.77%,1
新北市,板橋區,1142,266,570,836,52,888,1537,57.77%,17.31%,1
新北市,板橋區,1143,267,415,682,23,705,1341,52.57%,19.91%,1
新北市,板橋區,1144,343,551,894,28,922,1606,57.41%,21.36%,1
新北市,板橋區,1145,263,463,726,33,759,1433,52.97%,18.35%,1
新北市,板橋區,1146,298,551,849,39,888,1685,52.7%,17.69%,1
新北市,板橋區,1147,250,479,729,45,774,1248,62.02%,20.03%,1
新北市,板橋區,1148,209,411,620,40,660,1172,56.31%,17.83%,1
新北市,板橋區,1149,290,504,794,30,824,1640,50.24%,17.68%,1
新北市,板橋區,1150,259,502,761,38,799,1428,55.95%,18.14%,1
新北市,板橋區,1151,296,527,823,62,885,1527,57.96%,19.38%,1
新北市,板橋區,1152,255,510,765,27,792,1350,58.67%,18.89%,1
新北市,板橋區,1153,264,575,839,56,895,1582,56.57%,16.69%,1
新北市,板橋區,1154,190,380,570,35,605,919,65.83%,20.67%,1
新北市,板橋區,1155,191,332,523,22,545,930,58.6%,20.54%,1
新北市,板橋區,1156,189,402,591,24,615,974,63.14%,19.4%,1
新北市,板橋區,1157,327,650,977,32,1009,1732,58.26%,18.88%,1
新北市,板橋區,1158,275,478,753,56,809,1438,56.26%,19.12%,1
新北市,板橋區,1159,326,586,912,64,976,1777,54.92%,18.35%,1
新北市,板橋區,1160,287,552,839,44,883,1764,50.06%,16.27%,1
新北市,板橋區,1161,225,482,707,23,730,1289,56.63%,17.46%,1
新北市,板橋區,1162,225,432,657,37,694,1182,58.71%,19.04%,1
新北市,板橋區,1163,219,434,653,55,708,1174,60.31%,18.65%,1
新北市,板橋區,1164,358,568,926,83,1009,1870,53.96%,19.14%,1
新北市,板橋區,1165,387,629,1016,58,1074,1842,58.31%,21.01%,1
新北市,板橋區,1166,195,397,592,45,637,1094,58.23%,17.82%,1
新北市,板橋區,1167,209,426,635,38,673,1228,54.8%,17.02%,1
新北市,板橋區,1168,214,404,618,46,664,998,66.53%,21.44%,1
新北市,板橋區,1169,219,313,532,37,569,862,66.01%,25.41%,1
新北市,板橋區,1170,291,520,811,50,861,1622,53.08%,17.94%,1
新北市,板橋區,1171,192,478,670,57,727,1205,60.33%,15.93%,1
新北市,板橋區,1172,296,561,857,53,910,1787,50.92%,16.56%,1
新北市,板橋區,1173,349,533,882,30,912,1610,56.65%,21.68%,1
新北市,板橋區,1174,474,799,1273,38,1311,2216,59.16%,21.39%,1
新北市,板橋區,1175,471,771,1242,42,1284,2294,55.97%,20.53%,1
新北市,板橋區,1176,371,701,1072,64,1136,2090,54.35%,17.75%,1
新北市,板橋區,1177,220,432,652,30,682,1356,50.29%,16.22%,1
新北市,板橋區,1178,187,397,584,33,617,1067,57.83%,17.53%,1
新北市,板橋區,1179,250,472,722,39,761,1319,57.7%,18.95%,1
新北市,板橋區,1180,245,440,685,44,729,1316,55.4%,18.62%,1
新北市,板橋區,1181,201,389,590,61,651,1195,54.48%,16.82%,1
新北市,板橋區,1182,165,302,467,23,490,857,57.18%,19.25%,1
新北市,板橋區,1183,251,460,711,63,774,1417,54.62%,17.71%,1
新北市,板橋區,1184,220,620,840,64,904,1560,57.95%,14.1%,1
新北市,板橋區,1185,337,587,924,76,1000,1747,57.24%,19.29%,1
新北市,板橋區,1186,237,464,701,43,744,1176,63.27%,20.15%,1
新北市,板橋區,1187,229,395,624,26,650,1101,59.04%,20.8%,1
新北市,板橋區,1188,316,508,824,24,848,1458,58.16%,21.67%,1
新北市,板橋區,1189,154,614,768,56,824,1630,50.55%,9.45%,1
新北市,板橋區,1190,300,490,790,100,890,1611,55.25%,18.62%,1
新北市,板橋區,1191,188,406,594,26,620,1139,54.43%,16.51%,1
新北市,板橋區,1192,204,388,592,35,627,1120,55.98%,18.21%,1
新北市,板橋區,1193,192,379,571,76,647,1022,63.31%,18.79%,1
新北市,板橋區,1194,199,365,564,79,643,1049,61.3%,18.97%,1
新北市,板橋區,1195,205,378,583,20,603,1007,59.88%,20.36%,1
新北市,板橋區,1196,247,514,761,29,790,1393,56.71%,17.73%,1
新北市,板橋區,1197,56,114,170,30,200,474,42.19%,11.81%,1
新北市,板橋區,1198,110,165,275,24,299,500,59.8%,22%,1
新北市,板橋區,1199,215,423,638,38,676,1177,57.43%,18.27%,1
新北市,板橋區,1200,205,427,632,33,665,1186,56.07%,17.28%,1
新北市,板橋區,1201,226,423,649,52,701,1139,61.55%,19.84%,1
新北市,板橋區,1202,287,630,917,52,969,1750,55.37%,16.4%,1
新北市,板橋區,1203,393,758,1151,33,1184,3451,34.31%,11.39%,1
新北市,板橋區,1204,277,516,793,70,863,1620,53.27%,17.1%,1
新北市,板橋區,1205,161,270,431,24,455,903,50.39%,17.83%,1
新北市,板橋區,1206,239,442,681,40,721,1232,58.52%,19.4%,1
新北市,板橋區,1207,178,297,475,22,497,975,50.97%,18.26%,1
新北市,板橋區,1208,220,419,639,34,673,1224,54.98%,17.97%,1
新北市,板橋區,1209,238,465,703,28,731,1291,56.62%,18.44%,1
新北市,板橋區,1210,302,572,874,46,920,1828,50.33%,16.52%,1
新北市,板橋區,1211,316,511,827,47,874,1725,50.67%,18.32%,1
新北市,板橋區,1212,184,337,521,24,545,1085,50.23%,16.96%,1
新北市,板橋區,1213,416,752,1168,53,1221,2357,51.8%,17.65%,1
新北市,板橋區,1214,298,521,819,27,846,1560,54.23%,19.1%,1
新北市,板橋區,1215,332,622,954,35,989,2201,44.93%,15.08%,1
新北市,板橋區,1216,281,522,803,50,853,1626,52.46%,17.28%,1
新北市,板橋區,1217,259,530,789,35,824,1786,46.14%,14.5%,1
新北市,板橋區,1218,295,607,902,49,951,1763,53.94%,16.73%,1
新北市,板橋區,1219,312,540,852,27,879,1744,50.4%,17.89%,1
新北市,板橋區,1220,288,547,835,48,883,1645,53.68%,17.51%,1
新北市,板橋區,1221,303,584,887,40,927,1861,49.81%,16.28%,1
新北市,板橋區,1222,215,562,777,31,808,1596,50.63%,13.47%,1
新北市,板橋區,1223,325,638,963,45,1008,1871,53.87%,17.37%,1
新北市,板橋區,1224,361,652,1013,54,1067,1938,55.06%,18.63%,1
新北市,板橋區,1225,348,616,964,48,1012,1827,55.39%,19.05%,1
新北市,板橋區,1226,240,440,680,37,717,1359,52.76%,17.66%,1
新北市,板橋區,1227,279,570,849,43,892,1613,55.3%,17.3%,1
新北市,板橋區,1228,255,554,809,62,871,1566,55.62%,16.28%,1
新北市,板橋區,1229,341,556,897,46,943,1552,60.76%,21.97%,1
新北市,板橋區,1230,383,569,952,38,990,1885,52.52%,20.32%,1
新北市,板橋區,1231,334,619,953,53,1006,1893,53.14%,17.64%,1
新北市,三重區,0659,272,485,757,52,809,1509,53.61%,18.03%,1
新北市,三重區,0660,288,578,866,52,918,1591,57.7%,18.1%,1
新北市,三重區,0661,316,577,893,69,962,1653,58.2%,19.12%,1
新北市,三重區,0662,253,507,760,68,828,1392,59.48%,18.18%,1
新北市,三重區,0663,281,533,814,64,878,1451,60.51%,19.37%,1
新北市,三重區,0664,253,456,709,63,772,1329,58.09%,19.04%,1
新北市,三重區,0665,261,528,789,52,841,1459,57.64%,17.89%,1
新北市,三重區,0666,189,380,569,53,622,1024,60.74%,18.46%,1
新北市,三重區,0667,196,386,582,60,642,1066,60.23%,18.39%,1
新北市,三重區,0668,201,303,504,59,563,856,65.77%,23.48%,1
新北市,三重區,0669,142,251,393,42,435,764,56.94%,18.59%,1
新北市,三重區,0670,161,304,465,45,510,821,62.12%,19.61%,1
新北市,三重區,0671,419,504,923,66,989,1887,52.41%,22.2%,1
新北市,三重區,0672,321,505,826,60,886,1646,53.83%,19.5%,1
新北市,三重區,0673,74,132,206,12,218,358,60.89%,20.67%,1
新北市,三重區,0674,219,366,585,41,626,1039,60.25%,21.08%,1
新北市,三重區,0675,231,386,617,29,646,1114,57.99%,20.74%,1
新北市,三重區,0676,334,571,905,32,937,1588,59.01%,21.03%,1
新北市,三重區,0677,292,576,868,36,904,1702,53.11%,17.16%,1
新北市,三重區,0678,272,463,735,52,787,1288,61.1%,21.12%,1
新北市,三重區,0679,330,593,923,54,977,1629,59.98%,20.26%,1
新北市,三重區,0680,362,639,1001,50,1051,1861,56.48%,19.45%,1
新北市,三重區,0681,300,561,861,46,907,1727,52.52%,17.37%,1
新北市,三重區,0682,353,616,969,41,1010,1813,55.71%,19.47%,1
新北市,三重區,0683,276,563,839,64,903,1595,56.61%,17.3%,1
新北市,三重區,0684,302,514,816,68,884,1513,58.43%,19.96%,1
新北市,三重區,0685,290,426,716,43,759,4433,17.12%,6.54%,1
新北市,三重區,0686,232,467,699,50,749,1283,58.38%,18.08%,1
新北市,三重區,0687,265,553,818,54,872,1430,60.98%,18.53%,1
新北市,三重區,0688,286,499,785,26,811,1357,59.76%,21.08%,1
新北市,三重區,0689,189,347,536,35,571,963,59.29%,19.63%,1
新北市,三重區,0690,190,296,486,42,528,883,59.8%,21.52%,1
新北市,三重區,0691,261,502,763,88,851,1494,56.96%,17.47%,1
新北市,三重區,0692,336,544,880,63,943,1616,58.35%,20.79%,1
新北市,三重區,0693,273,434,707,53,760,1329,57.19%,20.54%,1
新北市,三重區,0694,268,493,761,47,808,1289,62.68%,20.79%,1
新北市,三重區,0695,262,480,742,63,805,1380,58.33%,18.99%,1
新北市,三重區,0696,377,556,933,34,967,1668,57.97%,22.6%,1
新北市,三重區,0697,256,453,709,67,776,1226,63.3%,20.88%,1
新北市,三重區,0698,285,533,818,42,860,1421,60.52%,20.06%,1
新北市,三重區,0699,258,498,756,53,809,1364,59.31%,18.91%,1
新北市,三重區,0700,239,447,686,46,732,1232,59.42%,19.4%,1
新北市,三重區,0701,252,479,731,51,782,1248,62.66%,20.19%,1
新北市,三重區,0702,280,421,701,52,753,1256,59.95%,22.29%,1
新北市,三重區,0703,327,564,891,43,934,1506,62.02%,21.71%,1
新北市,三重區,0704,347,589,936,49,985,1669,59.02%,20.79%,1
新北市,三重區,0705,251,453,704,64,768,1308,58.72%,19.19%,1
新北市,三重區,0706,276,490,766,62,828,1263,65.56%,21.85%,1
新北市,三重區,0707,301,473,774,64,838,1471,56.97%,20.46%,1
新北市,三重區,0708,309,486,795,81,876,1447,60.54%,21.35%,1
新北市,三重區,0709,372,412,784,51,835,1693,49.32%,21.97%,1
新北市,三重區,0710,393,644,1037,51,1088,2015,54%,19.5%,1
新北市,三重區,0711,284,606,890,68,958,1812,52.87%,15.67%,1
新北市,三重區,0712,307,460,767,30,797,1509,52.82%,20.34%,1
新北市,三重區,0713,285,503,788,49,837,1439,58.17%,19.81%,1
新北市,三重區,0714,278,504,782,41,823,1437,57.27%,19.35%,1
新北市,三重區,0715,346,518,864,57,921,1697,54.27%,20.39%,1
新北市,三重區,0716,340,564,904,33,937,1793,52.26%,18.96%,1
新北市,三重區,0717,340,593,933,28,961,1603,59.95%,21.21%,1
新北市,三重區,0718,243,372,615,19,634,1166,54.37%,20.84%,1
新北市,三重區,0719,243,380,623,44,667,1126,59.24%,21.58%,1
新北市,三重區,0720,182,412,594,56,650,1291,50.35%,14.1%,1
新北市,三重區,0721,316,530,846,55,901,1597,56.42%,19.79%,1
新北市,三重區,0722,219,389,608,57,665,1081,61.52%,20.26%,1
新北市,三重區,0723,363,184,547,42,589,911,64.65%,39.85%,1
新北市,三重區,0724,297,514,811,45,856,1719,49.8%,17.28%,1
新北市,三重區,0725,266,390,656,71,727,1289,56.4%,20.64%,1
新北市,三重區,0726,259,485,744,60,804,1318,61%,19.65%,1
新北市,三重區,0727,357,553,910,50,960,1822,52.69%,19.59%,1
新北市,三重區,0728,212,395,607,84,691,1185,58.31%,17.89%,1
新北市,三重區,0729,427,236,663,59,722,1369,52.74%,31.19%,1
新北市,三重區,0730,285,519,804,57,861,1507,57.13%,18.91%,1
新北市,三重區,0731,189,311,500,55,555,926,59.94%,20.41%,1
新北市,三重區,0732,170,294,464,22,486,950,51.16%,17.89%,1
新北市,三重區,0733,306,513,819,70,889,1678,52.98%,18.24%,1
新北市,三重區,0734,209,361,570,68,638,1117,57.12%,18.71%,1
新北市,三重區,0735,256,404,660,51,711,1318,53.95%,19.42%,1
新北市,三重區,0736,299,483,782,33,815,1388,58.72%,21.54%,1
新北市,三重區,0737,224,309,533,65,598,1026,58.28%,21.83%,1
新北市,三重區,0738,231,403,634,46,680,1096,62.04%,21.08%,1
新北市,三重區,0739,199,340,539,33,572,967,59.15%,20.58%,1
新北市,三重區,0740,350,595,945,44,989,1871,52.86%,18.71%,1
新北市,三重區,0741,326,548,874,62,936,1663,56.28%,19.6%,1
新北市,三重區,0742,217,419,636,26,662,1208,54.8%,17.96%,1
新北市,三重區,0743,275,397,672,66,738,1398,52.79%,19.67%,1
新北市,三重區,0744,213,342,555,28,583,1078,54.08%,19.76%,1
新北市,三重區,0745,166,372,538,61,599,1102,54.36%,15.06%,1
新北市,三重區,0746,267,423,690,77,767,1393,55.06%,19.17%,1
新北市,三重區,0747,230,440,670,71,741,1251,59.23%,18.39%,1
新北市,三重區,0748,276,448,724,63,787,1234,63.78%,22.37%,1
新北市,三重區,0749,332,559,891,69,960,1661,57.8%,19.99%,1
新北市,三重區,0750,313,531,844,65,909,1590,57.17%,19.69%,1
新北市,三重區,0751,229,415,644,58,702,1182,59.39%,19.37%,1
新北市,三重區,0752,272,474,746,72,818,1369,59.75%,19.87%,1
新北市,三重區,0753,265,447,712,46,758,1222,62.03%,21.69%,1
新北市,三重區,0754,237,426,663,81,744,1304,57.06%,18.17%,1
新北市,三重區,0755,175,353,528,36,564,1054,53.51%,16.6%,1
新北市,三重區,0756,301,550,851,69,920,1635,56.27%,18.41%,1
新北市,三重區,0757,319,561,880,60,940,1779,52.84%,17.93%,1
新北市,三重區,0758,310,545,855,78,933,1633,57.13%,18.98%,1
新北市,三重區,0759,224,380,604,38,642,1107,57.99%,20.23%,1
新北市,三重區,0760,200,299,499,40,539,1021,52.79%,19.59%,1
新北市,三重區,0761,265,503,768,83,851,1649,51.61%,16.07%,1
新北市,三重區,0762,166,297,463,32,495,874,56.64%,18.99%,1
新北市,三重區,0763,260,469,729,95,824,1402,58.77%,18.54%,1
新北市,三重區,0764,274,524,798,72,870,1713,50.79%,16%,1
新北市,三重區,0765,163,284,447,43,490,973,50.36%,16.75%,1
新北市,三重區,0766,219,346,565,49,614,1038,59.15%,21.1%,1
新北市,三重區,0767,298,523,821,124,945,1833,51.55%,16.26%,1
新北市,三重區,0768,158,270,428,35,463,817,56.67%,19.34%,1
新北市,三重區,0769,271,497,768,55,823,1387,59.34%,19.54%,1
新北市,三重區,0770,165,282,447,32,479,784,61.1%,21.05%,1
新北市,三重區,0771,211,332,543,34,577,1096,52.65%,19.25%,1
新北市,三重區,0772,229,396,625,65,690,1163,59.33%,19.69%,1
新北市,三重區,0773,326,599,925,52,977,1868,52.3%,17.45%,1
新北市,三重區,0774,187,372,559,56,615,1117,55.06%,16.74%,1
新北市,三重區,0775,167,297,464,33,497,934,53.21%,17.88%,1
新北市,三重區,0776,240,444,684,61,745,1412,52.76%,17%,1
新北市,三重區,0777,209,416,625,46,671,1062,63.18%,19.68%,1
新北市,三重區,0778,160,293,453,58,511,891,57.35%,17.96%,1
新北市,三重區,0779,199,360,559,82,641,936,68.48%,21.26%,1
新北市,三重區,0780,183,344,527,66,593,1085,54.65%,16.87%,1
新北市,三重區,0781,215,293,508,24,532,1065,49.95%,20.19%,1
新北市,三重區,0782,269,473,742,59,801,1398,57.3%,19.24%,1
新北市,三重區,0783,289,542,831,47,878,1550,56.65%,18.65%,1
新北市,三重區,0784,289,556,845,65,910,1674,54.36%,17.26%,1
新北市,三重區,0785,216,428,644,53,697,1215,57.37%,17.78%,1
新北市,三重區,0786,288,531,819,66,885,1606,55.11%,17.93%,1
新北市,三重區,0787,222,395,617,47,664,1182,56.18%,18.78%,1
新北市,三重區,0788,218,451,669,62,731,1238,59.05%,17.61%,1
新北市,三重區,0789,262,472,734,67,801,1342,59.69%,19.52%,1
新北市,三重區,0790,279,494,773,46,819,1408,58.17%,19.82%,1
新北市,三重區,0791,326,594,920,76,996,1770,56.27%,18.42%,1
新北市,三重區,0792,214,290,504,47,551,940,58.62%,22.77%,1
新北市,三重區,0793,191,322,513,24,537,975,55.08%,19.59%,1
新北市,三重區,0794,295,459,754,48,802,1507,53.22%,19.58%,1
新北市,三重區,0795,263,486,749,64,813,1419,57.29%,18.53%,1
新北市,三重區,0796,198,465,663,57,720,1257,57.28%,15.75%,1
新北市,三重區,0797,311,544,855,67,922,1619,56.95%,19.21%,1
新北市,三重區,0798,300,576,876,66,942,1745,53.98%,17.19%,1
新北市,三重區,0799,306,478,784,74,858,1519,56.48%,20.14%,1
新北市,三重區,0800,272,569,841,48,889,1682,52.85%,16.17%,1
新北市,三重區,0801,442,597,1039,69,1108,1697,65.29%,26.05%,1
新北市,三重區,0802,134,303,437,46,483,1073,45.01%,12.49%,1
新北市,三重區,0803,146,322,468,44,512,924,55.41%,15.8%,1
新北市,三重區,0804,231,504,735,57,792,1613,49.1%,14.32%,1
新北市,三重區,0805,159,412,571,57,628,1034,60.74%,15.38%,1
新北市,三重區,0806,299,299,598,58,656,1118,58.68%,26.74%,1
新北市,三重區,0807,224,418,642,76,718,1269,56.58%,17.65%,1
新北市,三重區,0808,189,321,510,49,559,990,56.46%,19.09%,1
新北市,三重區,0809,241,463,704,58,762,1336,57.04%,18.04%,1
新北市,三重區,0810,287,562,849,52,901,1601,56.28%,17.93%,1
新北市,三重區,0811,312,590,902,59,961,1581,60.78%,19.73%,1
新北市,三重區,0812,261,463,724,59,783,1345,58.22%,19.41%,1
新北市,三重區,0813,245,474,719,37,756,1226,61.66%,19.98%,1
新北市,三重區,0814,263,514,777,87,864,1650,52.36%,15.94%,1
新北市,三重區,0815,200,406,606,50,656,1140,57.54%,17.54%,1
新北市,三重區,0816,274,521,795,47,842,1639,51.37%,16.72%,1
新北市,三重區,0817,305,593,898,59,957,1699,56.33%,17.95%,1
新北市,三重區,0818,310,616,926,68,994,1501,66.22%,20.65%,1
新北市,三重區,0819,291,517,808,60,868,1538,56.44%,18.92%,1
新北市,三重區,0820,256,526,782,62,844,1540,54.81%,16.62%,1
新北市,三重區,0821,204,467,671,48,719,1276,56.35%,15.99%,1
新北市,三重區,0822,267,491,758,63,821,1539,53.35%,17.35%,1
新北市,三重區,0823,257,408,665,40,705,1170,60.26%,21.97%,1
新北市,三重區,0824,228,359,587,51,638,1120,56.96%,20.36%,1
新北市,三重區,0825,331,615,946,63,1009,1789,56.4%,18.5%,1
新北市,三重區,0826,300,448,748,62,810,1520,53.29%,19.74%,1
新北市,三重區,0827,352,595,947,67,1014,1821,55.68%,19.33%,1
新北市,三重區,0828,264,470,734,63,797,1407,56.65%,18.76%,1
新北市,三重區,0829,277,492,769,63,832,1491,55.8%,18.58%,1
新北市,三重區,0830,273,495,768,54,822,1381,59.52%,19.77%,1
新北市,三重區,0831,230,418,648,65,713,1222,58.35%,18.82%,1
新北市,三重區,0832,321,630,951,130,1081,1938,55.78%,16.56%,1
新北市,三重區,0833,299,576,875,37,912,1639,55.64%,18.24%,1
新北市,三重區,0834,302,529,831,78,909,1614,56.32%,18.71%,1
新北市,三重區,0835,298,593,891,46,937,1709,54.83%,17.44%,1
新北市,三重區,0836,263,574,837,61,898,1753,51.23%,15%,1
新北市,三重區,0837,262,488,750,68,818,1398,58.51%,18.74%,1
新北市,三重區,0838,320,539,859,68,927,1706,54.34%,18.76%,1
新北市,三重區,0839,296,565,861,64,925,1614,57.31%,18.34%,1
新北市,三重區,0840,316,547,863,68,931,1591,58.52%,19.86%,1
新北市,三重區,0841,330,501,831,50,881,1627,54.15%,20.28%,1
新北市,三重區,0842,288,505,793,71,864,1505,57.41%,19.14%,1
新北市,三重區,0843,260,458,718,43,761,1331,57.18%,19.53%,1
新北市,三重區,0844,327,503,830,53,883,1678,52.62%,19.49%,1
新北市,三重區,0845,297,498,795,53,848,1498,56.61%,19.83%,1
新北市,三重區,0846,389,601,990,65,1055,1800,58.61%,21.61%,1
新北市,三重區,0847,295,490,785,49,834,1703,48.97%,17.32%,1
新北市,三重區,0848,361,582,943,44,987,1975,49.97%,18.28%,1
新北市,三重區,0849,321,605,926,57,983,1894,51.9%,16.95%,1
新北市,三重區,0850,259,511,770,53,823,1405,58.58%,18.43%,1
新北市,三重區,0851,251,474,725,25,750,1293,58%,19.41%,1
新北市,三重區,0852,263,433,696,37,733,1259,58.22%,20.89%,1
新北市,三重區,0853,225,417,642,67,709,1144,61.98%,19.67%,1
新北市,三重區,0854,258,446,704,62,766,1254,61.08%,20.57%,1
新北市,三重區,0855,277,423,700,48,748,1313,56.97%,21.1%,1
新北市,三重區,0856,302,499,801,77,878,1594,55.08%,18.95%,1
新北市,三重區,0857,349,565,914,63,977,1775,55.04%,19.66%,1
新北市,三重區,0858,248,521,769,80,849,1516,56%,16.36%,1
新北市,三重區,0859,264,519,783,74,857,1315,65.17%,20.08%,1
新北市,三重區,0860,177,293,470,49,519,843,61.57%,21%,1
新北市,三重區,0861,179,374,553,54,607,1160,52.33%,15.43%,1
新北市,三重區,0862,174,388,562,50,612,1052,58.17%,16.54%,1
新北市,三重區,0863,218,398,616,51,667,1054,63.28%,20.68%,1
新北市,三重區,0864,191,346,537,55,592,997,59.38%,19.16%,1
新北市,三重區,0865,168,306,474,41,515,936,55.02%,17.95%,1
新北市,三重區,0866,302,531,833,84,917,1658,55.31%,18.21%,1
新北市,三重區,0867,265,486,751,59,810,1496,54.14%,17.71%,1
新北市,三重區,0868,212,400,612,43,655,1064,61.56%,19.92%,1
新北市,三重區,0869,213,440,653,51,704,1152,61.11%,18.49%,1
新北市,三重區,0870,283,497,780,43,823,1532,53.72%,18.47%,1
新北市,三重區,0871,222,415,637,31,668,1338,49.93%,16.59%,1
新北市,三重區,0872,268,434,702,54,756,1303,58.02%,20.57%,1
新北市,三重區,0873,253,493,746,76,822,1369,60.04%,18.48%,1
新北市,三重區,0874,256,504,760,64,824,1491,55.26%,17.17%,1
新北市,三重區,0875,296,562,858,90,948,1821,52.06%,16.25%,1
新北市,三重區,0876,342,586,928,41,969,1906,50.84%,17.94%,1
新北市,三重區,0877,364,630,994,54,1048,1842,56.89%,19.76%,1
新北市,三重區,0878,133,309,442,35,477,878,54.33%,15.15%,1
新北市,三重區,0879,220,351,571,46,617,963,64.07%,22.85%,1
新北市,三重區,0880,244,412,656,28,684,1381,49.53%,17.67%,1
新北市,三重區,0881,279,495,774,69,843,1681,50.15%,16.6%,1
新北市,三重區,0882,286,490,776,32,808,1548,52.2%,18.48%,1
新北市,三重區,0883,339,505,844,50,894,1542,57.98%,21.98%,1
新北市,三重區,0884,295,499,794,68,862,1557,55.36%,18.95%,1
新北市,三重區,0885,306,553,859,40,899,1661,54.12%,18.42%,1
新北市,三重區,0886,391,677,1068,30,1098,2024,54.25%,19.32%,1
新北市,三重區,0887,247,498,745,54,799,1588,50.31%,15.55%,1
新北市,三重區,0888,267,570,837,91,928,1706,54.4%,15.65%,1
新北市,三重區,0889,277,469,746,39,785,1341,58.54%,20.66%,1
新北市,三重區,0890,174,351,525,40,565,1025,55.12%,16.98%,1
新北市,三重區,0891,245,459,704,57,761,1339,56.83%,18.3%,1
新北市,三重區,0892,306,569,875,80,955,1725,55.36%,17.74%,1
新北市,三重區,0893,347,587,934,65,999,1826,54.71%,19%,1
新北市,中和區,1232,286,507,793,51,844,1630,51.78%,17.55%,1
新北市,中和區,1233,340,600,940,49,989,1775,55.72%,19.15%,1
新北市,中和區,1234,317,596,913,27,940,1844,50.98%,17.19%,1
新北市,中和區,1235,226,393,619,20,639,1019,62.71%,22.18%,1
新北市,中和區,1236,215,457,672,22,694,1138,60.98%,18.89%,1
新北市,中和區,1237,305,608,913,40,953,1878,50.75%,16.24%,1
新北市,中和區,1238,301,784,1085,37,1122,1980,56.67%,15.2%,1
新北市,中和區,1239,333,634,967,70,1037,1844,56.24%,18.06%,1
新北市,中和區,1240,506,595,1101,37,1138,2085,54.58%,24.27%,1
新北市,中和區,1241,231,559,790,43,833,1498,55.61%,15.42%,1
新北市,中和區,1242,323,605,928,27,955,1761,54.23%,18.34%,1
新北市,中和區,1243,262,396,658,40,698,1254,55.66%,20.89%,1
新北市,中和區,1244,267,485,752,36,788,1343,58.67%,19.88%,1
新北市,中和區,1245,380,584,964,34,998,1789,55.79%,21.24%,1
新北市,中和區,1246,404,675,1079,37,1116,2000,55.8%,20.2%,1
新北市,中和區,1247,382,551,933,35,968,1953,49.56%,19.56%,1
新北市,中和區,1248,339,559,898,61,959,1712,56.02%,19.8%,1
新北市,中和區,1249,278,585,863,45,908,1582,57.4%,17.57%,1
新北市,中和區,1250,321,582,903,55,958,1742,54.99%,18.43%,1
新北市,中和區,1251,294,583,877,49,926,1493,62.02%,19.69%,1
新北市,中和區,1252,257,421,678,47,725,1352,53.62%,19.01%,1
新北市,中和區,1253,210,491,701,40,741,1244,59.57%,16.88%,1
新北市,中和區,1254,204,496,700,56,756,1394,54.23%,14.63%,1
新北市,中和區,1255,309,516,825,30,855,1917,44.6%,16.12%,1
新北市,中和區,1256,315,579,894,63,957,1830,52.3%,17.21%,1
新北市,中和區,1257,241,391,632,32,664,1124,59.07%,21.44%,1
新北市,中和區,1258,252,421,673,48,721,1412,51.06%,17.85%,1
新北市,中和區,1259,253,453,706,43,749,1356,55.24%,18.66%,1
新北市,中和區,1260,205,503,708,37,745,1425,52.28%,14.39%,1
新北市,中和區,1261,244,452,696,63,759,1259,60.29%,19.38%,1
新北市,中和區,1262,229,446,675,60,735,1256,58.52%,18.23%,1
新北市,中和區,1263,253,505,758,44,802,1423,56.36%,17.78%,1
新北市,中和區,1264,242,454,696,45,741,1221,60.69%,19.82%,1
新北市,中和區,1265,315,575,890,48,938,1858,50.48%,16.95%,1
新北市,中和區,1266,308,590,898,48,946,1804,52.44%,17.07%,1
新北市,中和區,1267,336,582,918,42,960,1669,57.52%,20.13%,1
新北市,中和區,1268,252,531,783,54,837,1485,56.36%,16.97%,1
新北市,中和區,1269,193,381,574,39,613,1005,61%,19.2%,1
新北市,中和區,1270,259,445,704,49,753,1175,64.09%,22.04%,1
新北市,中和區,1271,216,431,647,45,692,1171,59.09%,18.45%,1
新北市,中和區,1272,294,544,838,38,876,1746,50.17%,16.84%,1
新北市,中和區,1273,262,472,734,41,775,1555,49.84%,16.85%,1
新北市,中和區,1274,188,413,601,33,634,1112,57.01%,16.91%,1
新北市,中和區,1275,363,648,1011,43,1054,1780,59.21%,20.39%,1
新北市,中和區,1276,386,646,1032,27,1059,1918,55.21%,20.13%,1
新北市,中和區,1277,269,474,743,25,768,1689,45.47%,15.93%,1
新北市,中和區,1278,350,629,979,32,1011,1781,56.77%,19.65%,1
新北市,中和區,1279,274,496,770,37,807,1419,56.87%,19.31%,1
新北市,中和區,1280,230,463,693,33,726,1344,54.02%,17.11%,1
新北市,中和區,1281,366,712,1078,46,1124,1804,62.31%,20.29%,1
新北市,中和區,1282,337,556,893,68,961,1788,53.75%,18.85%,1
新北市,中和區,1283,323,646,969,44,1013,1793,56.5%,18.01%,1
新北市,中和區,1284,259,456,715,69,784,1352,57.99%,19.16%,1
新北市,中和區,1285,444,625,1069,57,1126,1813,62.11%,24.49%,1
新北市,中和區,1286,266,525,791,26,817,1288,63.43%,20.65%,1
新北市,中和區,1287,229,409,638,39,677,1186,57.08%,19.31%,1
新北市,中和區,1288,196,435,631,13,644,1237,52.06%,15.84%,1
新北市,中和區,1289,252,484,736,52,788,1406,56.05%,17.92%,1
新北市,中和區,1290,272,485,757,51,808,1442,56.03%,18.86%,1
新北市,中和區,1291,229,382,611,42,653,1040,62.79%,22.02%,1
新北市,中和區,1292,232,509,741,44,785,1292,60.76%,17.96%,1
新北市,中和區,1293,302,630,932,54,986,1811,54.45%,16.68%,1
新北市,中和區,1294,338,593,931,70,1001,1789,55.95%,18.89%,1
新北市,中和區,1295,167,367,534,29,563,859,65.54%,19.44%,1
新北市,中和區,1296,154,452,606,21,627,972,64.51%,15.84%,1
新北市,中和區,1297,231,496,727,40,767,1346,56.98%,17.16%,1
新北市,中和區,1298,207,357,564,30,594,1034,57.45%,20.02%,1
新北市,中和區,1299,255,514,769,34,803,1387,57.89%,18.39%,1
新北市,中和區,1300,371,737,1108,66,1174,2067,56.8%,17.95%,1
新北市,中和區,1301,261,497,758,48,806,1670,48.26%,15.63%,1
新北市,中和區,1302,202,428,630,42,672,1166,57.63%,17.32%,1
新北市,中和區,1303,155,381,536,38,574,963,59.61%,16.1%,1
新北市,中和區,1304,159,373,532,40,572,1070,53.46%,14.86%,1
新北市,中和區,1305,228,480,708,41,749,1319,56.79%,17.29%,1
新北市,中和區,1306,257,559,816,67,883,1438,61.4%,17.87%,1
新北市,中和區,1307,300,592,892,34,926,1808,51.22%,16.59%,1
新北市,中和區,1308,170,444,614,20,634,1191,53.23%,14.27%,1
新北市,中和區,1309,278,567,845,63,908,1632,55.64%,17.03%,1
新北市,中和區,1310,267,602,869,34,903,1765,51.16%,15.13%,1
新北市,中和區,1311,190,468,658,26,684,1168,58.56%,16.27%,1
新北市,中和區,1312,190,452,642,18,660,1176,56.12%,16.16%,1
新北市,中和區,1313,262,681,943,53,996,1565,63.64%,16.74%,1
新北市,中和區,1314,253,512,765,45,810,1578,51.33%,16.03%,1
新北市,中和區,1315,364,708,1072,28,1100,2029,54.21%,17.94%,1
新北市,中和區,1316,163,335,498,23,521,905,57.57%,18.01%,1
新北市,中和區,1317,113,306,419,24,443,839,52.8%,13.47%,1
新北市,中和區,1318,134,285,419,25,444,762,58.27%,17.59%,1
新北市,中和區,1319,237,531,768,53,821,1420,57.82%,16.69%,1
新北市,中和區,1320,201,445,646,52,698,1272,54.87%,15.8%,1
新北市,中和區,1321,342,659,1001,50,1051,1976,53.19%,17.31%,1
新北市,中和區,1322,287,660,947,22,969,1779,54.47%,16.13%,1
新北市,中和區,1323,229,455,684,37,721,1454,49.59%,15.75%,1
新北市,中和區,1324,179,513,692,39,731,1374,53.2%,13.03%,1
新北市,中和區,1325,218,430,648,49,697,1369,50.91%,15.92%,1
新北市,中和區,1326,297,472,769,52,821,1501,54.7%,19.79%,1
新北市,中和區,1327,171,377,548,54,602,920,65.43%,18.59%,1
新北市,中和區,1328,199,402,601,48,649,1050,61.81%,18.95%,1
新北市,中和區,1329,64,119,183,14,197,321,61.37%,19.94%,1
新北市,中和區,1330,237,490,727,61,788,1474,53.46%,16.08%,1
新北市,中和區,1331,253,516,769,74,843,1461,57.7%,17.32%,1
新北市,中和區,1332,260,563,823,42,865,1621,53.36%,16.04%,1
新北市,中和區,1333,259,520,779,54,833,1327,62.77%,19.52%,1
新北市,中和區,1334,147,283,430,21,451,775,58.19%,18.97%,1
新北市,中和區,1335,352,597,949,69,1018,1916,53.13%,18.37%,1
新北市,中和區,1336,310,613,923,63,986,1901,51.87%,16.31%,1
新北市,中和區,1337,241,519,760,35,795,4411,18.02%,5.46%,1
新北市,中和區,1338,217,427,644,37,681,1212,56.19%,17.9%,1
新北市,中和區,1339,204,424,628,22,650,1126,57.73%,18.12%,1
新北市,中和區,1340,270,506,776,27,803,1507,53.28%,17.92%,1
新北市,中和區,1341,293,526,819,22,841,1519,55.37%,19.29%,1
新北市,中和區,1342,294,520,814,32,846,1467,57.67%,20.04%,1
新北市,中和區,1343,266,564,830,58,888,1453,61.11%,18.31%,1
新北市,中和區,1344,260,528,788,35,823,1364,60.34%,19.06%,1
新北市,中和區,1345,237,462,699,36,735,1302,56.45%,18.2%,1
新北市,中和區,1346,249,473,722,28,750,1627,46.1%,15.3%,1
新北市,中和區,1347,253,527,780,30,810,1503,53.89%,16.83%,1
新北市,中和區,1348,212,509,721,24,745,1392,53.52%,15.23%,1
新北市,中和區,1349,196,416,612,26,638,1067,59.79%,18.37%,1
新北市,中和區,1350,261,553,814,45,859,1623,52.93%,16.08%,1
新北市,中和區,1351,254,428,682,27,709,1208,58.69%,21.03%,1
新北市,中和區,1352,260,590,850,38,888,1991,44.6%,13.06%,1
新北市,中和區,1353,296,577,873,36,909,1932,47.05%,15.32%,1
新北市,中和區,1354,222,392,614,16,630,947,66.53%,23.44%,1
新北市,中和區,1355,292,620,912,51,963,1660,58.01%,17.59%,1
新北市,中和區,1356,242,504,746,44,790,1574,50.19%,15.37%,1
新北市,中和區,1357,360,677,1037,48,1085,2136,50.8%,16.85%,1
新北市,中和區,1358,256,478,734,48,782,1462,53.49%,17.51%,1
新北市,中和區,1359,242,512,754,59,813,1548,52.52%,15.63%,1
新北市,中和區,1360,139,297,436,21,457,692,66.04%,20.09%,1
新北市,中和區,1361,224,504,728,40,768,1221,62.9%,18.35%,1
新北市,中和區,1362,267,506,773,46,819,1331,61.53%,20.06%,1
新北市,中和區,1363,190,396,586,37,623,984,63.31%,19.31%,1
新北市,中和區,1364,296,608,904,36,940,1871,50.24%,15.82%,1
新北市,中和區,1365,203,476,679,30,709,1279,55.43%,15.87%,1
新北市,中和區,1366,302,574,876,49,925,1629,56.78%,18.54%,1
新北市,中和區,1367,300,509,809,36,845,1482,57.02%,20.24%,1
新北市,中和區,1368,310,644,954,45,999,1715,58.25%,18.08%,1
新北市,中和區,1369,329,712,1041,51,1092,1952,55.94%,16.85%,1
新北市,中和區,1370,124,249,373,28,401,686,58.45%,18.08%,1
新北市,中和區,1371,231,471,702,36,738,1577,46.8%,14.65%,1
新北市,中和區,1372,161,467,628,33,661,1158,57.08%,13.9%,1
新北市,中和區,1373,256,484,740,19,759,1195,63.51%,21.42%,1
新北市,中和區,1374,231,416,647,28,675,1054,64.04%,21.92%,1
新北市,中和區,1375,136,242,378,18,396,612,64.71%,22.22%,1
新北市,中和區,1376,294,632,926,31,957,1668,57.37%,17.63%,1
新北市,中和區,1377,208,435,643,48,691,1071,64.52%,19.42%,1
新北市,中和區,1378,262,489,751,50,801,1169,68.52%,22.41%,1
新北市,中和區,1379,239,482,721,33,754,1370,55.04%,17.45%,1
新北市,中和區,1380,295,587,882,64,946,1574,60.1%,18.74%,1
新北市,中和區,1381,389,763,1152,28,1180,2614,45.14%,14.88%,1
新北市,中和區,1382,261,583,844,37,881,1477,59.65%,17.67%,1
新北市,中和區,1383,218,348,566,46,612,1041,58.79%,20.94%,1
新北市,中和區,1384,265,491,756,56,812,1538,52.8%,17.23%,1
新北市,中和區,1385,306,523,829,48,877,1599,54.85%,19.14%,1
新北市,中和區,1386,299,572,871,67,938,1586,59.14%,18.85%,1
新北市,中和區,1387,324,668,992,53,1045,1726,60.54%,18.77%,1
新北市,中和區,1388,391,668,1059,74,1133,1854,61.11%,21.09%,1
新北市,中和區,1389,280,547,827,56,883,1472,59.99%,19.02%,1
新北市,中和區,1390,278,544,822,52,874,1430,61.12%,19.44%,1
新北市,中和區,1391,305,549,854,47,901,1488,60.55%,20.5%,1
新北市,中和區,1392,245,417,662,31,693,1251,55.4%,19.58%,1
新北市,中和區,1393,279,542,821,41,862,1487,57.97%,18.76%,1
新北市,中和區,1394,347,326,673,70,743,1328,55.95%,26.13%,1
新北市,中和區,1395,243,417,660,38,698,1128,61.88%,21.54%,1
新北市,中和區,1396,184,445,629,32,661,1008,65.58%,18.25%,1
新北市,中和區,1397,355,642,997,34,1031,1786,57.73%,19.88%,1
新北市,中和區,1398,384,758,1142,54,1196,2219,53.9%,17.31%,1
新北市,中和區,1399,210,453,663,32,695,1322,52.57%,15.89%,1
新北市,中和區,1400,271,515,786,18,804,1495,53.78%,18.13%,1
新北市,中和區,1401,259,480,739,44,783,1414,55.37%,18.32%,1
新北市,中和區,1402,256,655,911,58,969,1681,57.64%,15.23%,1
新北市,中和區,1403,256,474,730,43,773,1361,56.8%,18.81%,1
新北市,中和區,1404,255,500,755,49,804,1442,55.76%,17.68%,1
新北市,中和區,1405,262,466,728,28,756,1383,54.66%,18.94%,1
新北市,中和區,1406,224,468,692,35,727,1264,57.52%,17.72%,1
新北市,中和區,1407,317,682,999,83,1082,1810,59.78%,17.51%,1
新北市,中和區,1408,328,594,922,38,960,1951,49.21%,16.81%,1
新北市,中和區,1409,260,506,766,37,803,1582,50.76%,16.43%,1
新北市,中和區,1410,354,741,1095,57,1152,1945,59.23%,18.2%,1
新北市,中和區,1411,235,532,767,40,807,1390,58.06%,16.91%,1
新北市,中和區,1412,224,420,644,24,668,1161,57.54%,19.29%,1
新北市,中和區,1413,191,568,759,32,791,1399,56.54%,13.65%,1
新北市,中和區,1414,167,400,567,41,608,1070,56.82%,15.61%,1
新北市,中和區,1415,184,434,618,26,644,1169,55.09%,15.74%,1
新北市,中和區,1416,211,504,715,54,769,1214,63.34%,17.38%,1
新北市,中和區,1417,275,510,785,47,832,1398,59.51%,19.67%,1
新北市,中和區,1418,193,391,584,34,618,1049,58.91%,18.4%,1
新北市,中和區,1419,267,521,788,41,829,1324,62.61%,20.17%,1
新北市,中和區,1420,296,526,822,26,848,1765,48.05%,16.77%,1
新北市,中和區,1421,278,557,835,54,889,1709,52.02%,16.27%,1
新北市,中和區,1422,183,453,636,60,696,1186,58.68%,15.43%,1
新北市,中和區,1423,224,511,735,48,783,1318,59.41%,17%,1
新北市,中和區,1424,307,494,801,39,840,1430,58.74%,21.47%,1
新北市,中和區,1425,255,424,679,46,725,1637,44.29%,15.58%,1
新北市,中和區,1426,253,437,690,45,735,1283,57.29%,19.72%,1
新北市,中和區,1427,244,450,694,39,733,1310,55.95%,18.63%,1
新北市,中和區,1428,260,453,713,43,756,1301,58.11%,19.98%,1
新北市,中和區,1429,339,562,901,64,965,1681,57.41%,20.17%,1
新北市,中和區,1430,280,500,780,35,815,1384,58.89%,20.23%,1
新北市,中和區,1431,242,410,652,34,686,1187,57.79%,20.39%,1
新北市,中和區,1432,287,497,784,6,790,1779,44.41%,16.13%,1
新北市,中和區,1433,298,636,934,39,973,1712,56.83%,17.41%,1
新北市,中和區,1434,284,476,760,43,803,1462,54.92%,19.43%,1
新北市,中和區,1435,323,616,939,28,967,1824,53.02%,17.71%,1
新北市,中和區,1436,272,475,747,38,785,1389,56.52%,19.58%,1
新北市,中和區,1437,289,525,814,31,845,1434,58.93%,20.15%,1
新北市,中和區,1438,303,692,995,60,1055,1953,54.02%,15.51%,1
新北市,中和區,1439,398,676,1074,52,1126,2002,56.24%,19.88%,1
新北市,中和區,1440,306,670,976,24,1000,1858,53.82%,16.47%,1
新北市,中和區,1441,346,583,929,26,955,1801,53.03%,19.21%,1
新北市,中和區,1442,301,629,930,46,976,1691,57.72%,17.8%,1
新北市,中和區,1443,282,503,785,28,813,1363,59.65%,20.69%,1
新北市,中和區,1444,249,488,737,27,764,1220,62.62%,20.41%,1
新北市,中和區,1445,284,559,843,23,866,1365,63.44%,20.81%,1
新北市,中和區,1446,204,453,657,26,683,1178,57.98%,17.32%,1
新北市,中和區,1447,161,312,473,33,506,830,60.96%,19.4%,1
新北市,中和區,1448,208,367,575,55,630,1197,52.63%,17.38%,1
新北市,中和區,1449,231,523,754,48,802,1369,58.58%,16.87%,1
新北市,中和區,1450,242,506,748,53,801,1336,59.96%,18.11%,1
新北市,中和區,1451,257,555,812,51,863,1377,62.67%,18.66%,1
新北市,中和區,1452,277,552,829,54,883,1499,58.91%,18.48%,1
新北市,中和區,1453,325,628,953,43,996,1689,58.97%,19.24%,1
新北市,中和區,1454,263,481,744,53,797,1323,60.24%,19.88%,1
新北市,中和區,1455,219,428,647,34,681,1079,63.11%,20.3%,1
新北市,中和區,1456,301,556,857,48,905,1545,58.58%,19.48%,1
新北市,中和區,1457,263,426,689,52,741,1326,55.88%,19.83%,1
新北市,中和區,1458,273,494,767,32,799,1443,55.37%,18.92%,1
新北市,中和區,1459,301,621,922,32,954,1712,55.72%,17.58%,1
新北市,中和區,1460,317,668,985,58,1043,1916,54.44%,16.54%,1
新北市,中和區,1461,167,340,507,34,541,863,62.69%,19.35%,1
新北市,中和區,1462,260,468,728,8,736,1203,61.18%,21.61%,1
新北市,中和區,1463,275,511,786,12,798,1483,53.81%,18.54%,1
新北市,中和區,1464,258,560,818,25,843,1575,53.52%,16.38%,1
新北市,中和區,1465,201,476,677,43,720,1432,50.28%,14.04%,1
新北市,中和區,1466,264,496,760,48,808,1441,56.07%,18.32%,1
新北市,中和區,1467,245,468,713,43,756,1269,59.57%,19.31%,1
新北市,中和區,1468,250,525,775,32,807,1363,59.21%,18.34%,1
新北市,中和區,1469,176,437,613,23,636,1089,58.4%,16.16%,1
新北市,中和區,1470,223,379,602,25,627,1171,53.54%,19.04%,1
新北市,中和區,1471,205,424,629,43,672,1150,58.43%,17.83%,1
新北市,中和區,1472,224,465,689,26,715,1154,61.96%,19.41%,1
新北市,中和區,1473,180,450,630,33,663,1067,62.14%,16.87%,1
新北市,中和區,1474,333,524,857,40,897,1526,58.78%,21.82%,1
新北市,中和區,1475,290,523,813,30,843,1447,58.26%,20.04%,1
新北市,永和區,1476,318,541,859,60,919,1554,59.14%,20.46%,1
新北市,永和區,1477,178,432,610,20,630,1065,59.15%,16.71%,1
新北市,永和區,1478,166,353,519,23,542,854,63.47%,19.44%,1
新北市,永和區,1479,239,485,724,35,759,1253,60.57%,19.07%,1
新北市,永和區,1480,362,584,946,31,977,1733,56.38%,20.89%,1
新北市,永和區,1481,304,546,850,46,896,1581,56.67%,19.23%,1
新北市,永和區,1482,296,616,912,40,952,1735,54.87%,17.06%,1
新北市,永和區,1483,267,556,823,26,849,1563,54.32%,17.08%,1
新北市,永和區,1484,340,614,954,50,1004,1650,60.85%,20.61%,1
新北市,永和區,1485,254,551,805,28,833,1454,57.29%,17.47%,1
新北市,永和區,1486,305,484,789,41,830,1568,52.93%,19.45%,1
新北市,永和區,1487,264,502,766,35,801,1444,55.47%,18.28%,1
新北市,永和區,1488,219,375,594,43,637,1140,55.88%,19.21%,1
新北市,永和區,1489,227,473,700,38,738,1188,62.12%,19.11%,1
新北市,永和區,1490,272,521,793,59,852,1516,56.2%,17.94%,1
新北市,永和區,1491,254,480,734,43,777,1397,55.62%,18.18%,1
新北市,永和區,1492,287,500,787,28,815,1438,56.68%,19.96%,1
新北市,永和區,1493,204,428,632,21,653,1084,60.24%,18.82%,1
新北市,永和區,1494,178,350,528,26,554,941,58.87%,18.92%,1
新北市,永和區,1495,312,533,845,28,873,1598,54.63%,19.52%,1
新北市,永和區,1496,316,522,838,26,864,2842,30.4%,11.12%,1
新北市,永和區,1497,267,480,747,43,790,1261,62.65%,21.17%,1
新北市,永和區,1498,317,575,892,36,928,1449,64.04%,21.88%,1
新北市,永和區,1499,281,564,845,40,885,1511,58.57%,18.6%,1
新北市,永和區,1500,300,591,891,37,928,1470,63.13%,20.41%,1
新北市,永和區,1501,294,580,874,37,911,1580,57.66%,18.61%,1
新北市,永和區,1502,282,594,876,29,905,1438,62.93%,19.61%,1
新北市,永和區,1503,259,538,797,30,827,1305,63.37%,19.85%,1
新北市,永和區,1504,195,437,632,19,651,1046,62.24%,18.64%,1
新北市,永和區,1505,320,571,891,20,911,1566,58.17%,20.43%,1
新北市,永和區,1506,309,517,826,35,861,1468,58.65%,21.05%,1
新北市,永和區,1507,289,523,812,40,852,1305,65.29%,22.15%,1
新北市,永和區,1508,225,473,698,34,732,1181,61.98%,19.05%,1
新北市,永和區,1509,346,557,903,41,944,1720,54.88%,20.12%,1
新北市,永和區,1510,264,411,675,22,697,1103,63.19%,23.93%,1
新北市,永和區,1511,335,568,903,68,971,1649,58.88%,20.32%,1
新北市,永和區,1512,269,456,725,29,754,1206,62.52%,22.31%,1
新北市,永和區,1513,337,539,876,35,911,1506,60.49%,22.38%,1
新北市,永和區,1514,289,536,825,41,866,1488,58.2%,19.42%,1
新北市,永和區,1515,259,498,757,48,805,1288,62.5%,20.11%,1
新北市,永和區,1516,269,455,724,37,761,1413,53.86%,19.04%,1
新北市,永和區,1517,213,520,733,43,776,1329,58.39%,16.03%,1
新北市,永和區,1518,80,779,859,31,890,1436,61.98%,5.57%,1
新北市,永和區,1519,206,418,624,41,665,1112,59.8%,18.53%,1
新北市,永和區,1520,236,476,712,32,744,1100,67.64%,21.45%,1
新北市,永和區,1521,318,605,923,39,962,1545,62.27%,20.58%,1
新北市,永和區,1522,243,554,797,23,820,1436,57.1%,16.92%,1
新北市,永和區,1523,340,678,1018,60,1078,1731,62.28%,19.64%,1
新北市,永和區,1524,375,658,1033,57,1090,1762,61.86%,21.28%,1
新北市,永和區,1525,247,462,709,39,748,1320,56.67%,18.71%,1
新北市,永和區,1526,222,403,625,19,644,1297,49.65%,17.12%,1
新北市,永和區,1527,354,595,949,49,998,1798,55.51%,19.69%,1
新北市,永和區,1528,310,558,868,44,912,1491,61.17%,20.79%,1
新北市,永和區,1529,229,458,687,20,707,1223,57.81%,18.72%,1
新北市,永和區,1530,204,428,632,36,668,1108,60.29%,18.41%,1
新北市,永和區,1531,287,531,818,42,860,1408,61.08%,20.38%,1
新北市,永和區,1532,240,492,732,39,771,1265,60.95%,18.97%,1
新北市,永和區,1533,213,397,610,17,627,1115,56.23%,19.1%,1
新北市,永和區,1534,234,450,684,45,729,1133,64.34%,20.65%,1
新北市,永和區,1535,224,461,685,53,738,1217,60.64%,18.41%,1
新北市,永和區,1536,312,615,927,42,969,1713,56.57%,18.21%,1
新北市,永和區,1537,330,582,912,35,947,1721,55.03%,19.17%,1
新北市,永和區,1538,239,475,714,39,753,1327,56.74%,18.01%,1
新北市,永和區,1539,253,506,759,25,784,1257,62.37%,20.13%,1
新北市,永和區,1540,269,549,818,34,852,1348,63.2%,19.96%,1
新北市,永和區,1541,305,593,898,27,925,1461,63.31%,20.88%,1
新北市,永和區,1542,257,509,766,51,817,1368,59.72%,18.79%,1
新北市,永和區,1543,219,451,670,62,732,1234,59.32%,17.75%,1
新北市,永和區,1544,266,458,724,43,767,1303,58.86%,20.41%,1
新北市,永和區,1545,269,557,826,28,854,1516,56.33%,17.74%,1
新北市,永和區,1546,256,559,815,59,874,1422,61.46%,18%,1
新北市,永和區,1547,199,393,592,20,612,991,61.76%,20.08%,1
新北市,永和區,1548,206,413,619,22,641,1016,63.09%,20.28%,1
新北市,永和區,1549,205,453,658,36,694,1146,60.56%,17.89%,1
新北市,永和區,1550,158,456,614,21,635,1043,60.88%,15.15%,1
新北市,永和區,1551,255,469,724,18,742,1210,61.32%,21.07%,1
新北市,永和區,1552,309,619,928,23,951,1630,58.34%,18.96%,1
新北市,永和區,1553,216,426,642,20,662,1092,60.62%,19.78%,1
新北市,永和區,1554,362,694,1056,53,1109,1872,59.24%,19.34%,1
新北市,永和區,1555,338,654,992,27,1019,1781,57.22%,18.98%,1
新北市,永和區,1556,213,405,618,32,650,1049,61.96%,20.31%,1
新北市,永和區,1557,266,515,781,32,813,1285,63.27%,20.7%,1
新北市,永和區,1558,263,463,726,26,752,1209,62.2%,21.75%,1
新北市,永和區,1559,249,439,688,25,713,1132,62.99%,22%,1
新北市,永和區,1560,262,518,780,35,815,1287,63.33%,20.36%,1
新北市,永和區,1561,226,410,636,36,672,1068,62.92%,21.16%,1
新北市,永和區,1562,240,421,661,38,699,1098,63.66%,21.86%,1
新北市,永和區,1563,219,518,737,28,765,1222,62.6%,17.92%,1
新北市,永和區,1564,218,447,665,48,713,1157,61.62%,18.84%,1
新北市,永和區,1565,297,436,733,35,768,1168,65.75%,25.43%,1
新北市,永和區,1566,259,455,714,38,752,1283,58.61%,20.19%,1
新北市,永和區,1567,248,517,765,39,804,1372,58.6%,18.08%,1
新北市,永和區,1568,373,715,1088,47,1135,1876,60.5%,19.88%,1
新北市,永和區,1569,297,643,940,63,1003,1576,63.64%,18.85%,1
新北市,永和區,1570,316,636,952,36,988,1661,59.48%,19.02%,1
新北市,永和區,1571,327,675,1002,29,1031,1808,57.02%,18.09%,1
新北市,永和區,1572,374,662,1036,49,1085,1898,57.17%,19.7%,1
新北市,永和區,1573,320,580,900,31,931,1508,61.74%,21.22%,1
新北市,永和區,1574,251,522,773,54,827,1341,61.67%,18.72%,1
新北市,永和區,1575,262,505,767,56,823,1422,57.88%,18.42%,1
新北市,永和區,1576,225,429,654,37,691,1177,58.71%,19.12%,1
新北市,永和區,1577,299,572,871,52,923,1557,59.28%,19.2%,1
新北市,永和區,1578,277,511,788,38,826,1491,55.4%,18.58%,1
新北市,永和區,1579,301,569,870,39,909,1586,57.31%,18.98%,1
新北市,永和區,1580,237,452,689,21,710,1313,54.07%,18.05%,1
新北市,永和區,1581,331,557,888,54,942,1636,57.58%,20.23%,1
新北市,永和區,1582,321,558,879,43,922,1598,57.7%,20.09%,1
新北市,永和區,1583,351,581,932,41,973,1609,60.47%,21.81%,1
新北市,永和區,1584,307,513,820,32,852,1375,61.96%,22.33%,1
新北市,永和區,1585,370,632,1002,36,1038,1648,62.99%,22.45%,1
新北市,永和區,1586,229,395,624,28,652,1077,60.54%,21.26%,1
新北市,永和區,1587,235,449,684,19,703,1157,60.76%,20.31%,1
新北市,永和區,1588,308,519,827,26,853,1339,63.7%,23%,1
新北市,永和區,1589,267,517,784,22,806,1306,61.72%,20.44%,1
新北市,永和區,1590,257,509,766,14,780,1236,63.11%,20.79%,1
新北市,永和區,1591,236,450,686,18,704,1133,62.14%,20.83%,1
新北市,永和區,1592,285,552,837,30,867,1425,60.84%,20%,1
新北市,永和區,1593,354,696,1050,68,1118,1938,57.69%,18.27%,1
新北市,永和區,1594,325,588,913,46,959,1607,59.68%,20.22%,1
新北市,永和區,1595,133,370,503,22,525,853,61.55%,15.59%,1
新北市,永和區,1596,114,275,389,40,429,768,55.86%,14.84%,1
新北市,永和區,1597,117,300,417,24,441,893,49.38%,13.1%,1
新北市,永和區,1598,123,282,405,31,436,743,58.68%,16.55%,1
新北市,永和區,1599,232,457,689,31,720,1155,62.34%,20.09%,1
新北市,永和區,1600,266,492,758,31,789,1263,62.47%,21.06%,1
新北市,永和區,1601,246,467,713,26,739,1189,62.15%,20.69%,1
新北市,永和區,1602,218,500,718,43,761,1346,56.54%,16.2%,1
新北市,永和區,1603,250,492,742,36,778,1368,56.87%,18.27%,1
新北市,永和區,1604,206,395,601,15,616,1043,59.06%,19.75%,1
新北市,永和區,1605,350,644,994,36,1030,1709,60.27%,20.48%,1
新北市,永和區,1606,169,300,469,13,482,879,54.84%,19.23%,1
新北市,永和區,1607,197,316,513,28,541,904,59.85%,21.79%,1
新北市,永和區,1608,236,494,730,38,768,1221,62.9%,19.33%,1
新北市,永和區,1609,198,402,600,36,636,1018,62.48%,19.45%,1
新北市,永和區,1610,214,636,850,38,888,1551,57.25%,13.8%,1
新北市,永和區,1611,288,535,823,36,859,1428,60.15%,20.17%,1
新北市,永和區,1612,215,399,614,39,653,1044,62.55%,20.59%,1
新北市,永和區,1613,202,368,570,39,609,967,62.98%,20.89%,1
新北市,新莊區,0302,216,392,608,55,663,1123,59.04%,19.23%,1
新北市,新莊區,0303,243,468,711,55,766,1278,59.94%,19.01%,1
新北市,新莊區,0304,251,438,689,48,737,1163,63.37%,21.58%,1
新北市,新莊區,0305,240,469,709,48,757,1228,61.64%,19.54%,1
新北市,新莊區,0306,239,417,656,55,711,1211,58.71%,19.74%,1
新北市,新莊區,0307,230,421,651,52,703,1176,59.78%,19.56%,1
新北市,新莊區,0308,318,577,895,48,943,1536,61.39%,20.7%,1
新北市,新莊區,0309,305,587,892,41,933,1486,62.79%,20.52%,1
新北市,新莊區,0310,310,588,898,65,963,1513,63.65%,20.49%,1
新北市,新莊區,0311,284,542,826,63,889,1395,63.73%,20.36%,1
新北市,新莊區,0312,236,481,717,53,770,1353,56.91%,17.44%,1
新北市,新莊區,0313,284,527,811,63,874,1409,62.03%,20.16%,1
新北市,新莊區,0314,248,548,796,29,825,1478,55.82%,16.78%,1
新北市,新莊區,0315,194,340,534,45,579,921,62.87%,21.06%,1
新北市,新莊區,0316,198,387,585,39,624,971,64.26%,20.39%,1
新北市,新莊區,0317,298,603,901,65,966,1534,62.97%,19.43%,1
新北市,新莊區,0318,259,546,805,39,844,1516,55.67%,17.08%,1
新北市,新莊區,0319,145,243,388,23,411,697,58.97%,20.8%,1
新北市,新莊區,0320,243,450,693,29,722,1235,58.46%,19.68%,1
新北市,新莊區,0321,211,413,624,37,661,1138,58.08%,18.54%,1
新北市,新莊區,0322,189,360,549,21,570,1063,53.62%,17.78%,1
新北市,新莊區,0323,292,518,810,36,846,3399,24.89%,8.59%,1
新北市,新莊區,0324,296,570,866,68,934,1575,59.3%,18.79%,1
新北市,新莊區,0325,377,581,958,55,1013,1615,62.72%,23.34%,1
新北市,新莊區,0326,269,523,792,61,853,1612,52.92%,16.69%,1
新北市,新莊區,0327,271,519,790,50,840,1514,55.48%,17.9%,1
新北市,新莊區,0328,270,401,671,32,703,1382,50.87%,19.54%,1
新北市,新莊區,0329,348,438,786,45,831,1475,56.34%,23.59%,1
新北市,新莊區,0330,306,506,812,35,847,1462,57.93%,20.93%,1
新北市,新莊區,0331,291,462,753,34,787,1426,55.19%,20.41%,1
新北市,新莊區,0332,262,475,737,54,791,1421,55.67%,18.44%,1
新北市,新莊區,0333,294,536,830,30,860,1536,55.99%,19.14%,1
新北市,新莊區,0334,343,531,874,48,922,1587,58.1%,21.61%,1
新北市,新莊區,0335,135,252,387,16,403,749,53.81%,18.02%,1
新北市,新莊區,0336,233,492,725,43,768,1276,60.19%,18.26%,1
新北市,新莊區,0337,267,427,694,34,728,1303,55.87%,20.49%,1
新北市,新莊區,0338,241,477,718,55,773,1259,61.4%,19.14%,1
新北市,新莊區,0339,267,477,744,37,781,1291,60.5%,20.68%,1
新北市,新莊區,0340,315,515,830,12,842,1493,56.4%,21.1%,1
新北市,新莊區,0341,280,550,830,48,878,1507,58.26%,18.58%,1
新北市,新莊區,0342,296,502,798,20,818,1456,56.18%,20.33%,1
新北市,新莊區,0343,283,516,799,20,819,1396,58.67%,20.27%,1
新北市,新莊區,0344,238,414,652,53,705,1351,52.18%,17.62%,1
新北市,新莊區,0345,296,439,735,64,799,1403,56.95%,21.1%,1
新北市,新莊區,0346,277,502,779,57,836,1497,55.85%,18.5%,1
新北市,新莊區,0347,267,443,710,66,776,1272,61.01%,20.99%,1
新北市,新莊區,0348,218,372,590,31,621,1269,48.94%,17.18%,1
新北市,新莊區,0349,276,450,726,66,792,1335,59.33%,20.67%,1
新北市,新莊區,0350,294,460,754,38,792,1300,60.92%,22.62%,1
新北市,新莊區,0351,263,457,720,53,773,1286,60.11%,20.45%,1
新北市,新莊區,0352,276,501,777,46,823,1255,65.58%,21.99%,1
新北市,新莊區,0353,277,554,831,68,899,1558,57.7%,17.78%,1
新北市,新莊區,0354,286,500,786,71,857,1567,54.69%,18.25%,1
新北市,新莊區,0355,289,609,898,55,953,1603,59.45%,18.03%,1
新北市,新莊區,0356,321,517,838,31,869,1538,56.5%,20.87%,1
新北市,新莊區,0357,345,582,927,40,967,1671,57.87%,20.65%,1
新北市,新莊區,0358,296,568,864,34,898,1698,52.89%,17.43%,1
新北市,新莊區,0359,353,548,901,45,946,1545,61.23%,22.85%,1
新北市,新莊區,0360,322,621,943,93,1036,1696,61.08%,18.99%,1
新北市,新莊區,0361,246,566,812,81,893,1626,54.92%,15.13%,1
新北市,新莊區,0362,187,389,576,60,636,1170,54.36%,15.98%,1
新北市,新莊區,0363,229,417,646,76,722,1236,58.41%,18.53%,1
新北市,新莊區,0364,168,376,544,55,599,1071,55.93%,15.69%,1
新北市,新莊區,0365,210,403,613,35,648,1129,57.4%,18.6%,1
新北市,新莊區,0366,325,597,922,34,956,1586,60.28%,20.49%,1
新北市,新莊區,0367,256,507,763,62,825,1597,51.66%,16.03%,1
新北市,新莊區,0368,239,490,729,91,820,1573,52.13%,15.19%,1
新北市,新莊區,0369,219,437,656,43,699,1225,57.06%,17.88%,1
新北市,新莊區,0370,185,419,604,32,636,1217,52.26%,15.2%,1
新北市,新莊區,0371,283,505,788,59,847,1571,53.91%,18.01%,1
新北市,新莊區,0372,283,521,804,58,862,1594,54.08%,17.75%,1
新北市,新莊區,0373,286,527,813,57,870,1583,54.96%,18.07%,1
新北市,新莊區,0374,208,502,710,60,770,1245,61.85%,16.71%,1
新北市,新莊區,0375,437,339,776,38,814,1203,67.66%,36.33%,1
新北市,新莊區,0376,276,480,756,41,797,1265,63%,21.82%,1
新北市,新莊區,0377,227,466,693,65,758,1255,60.4%,18.09%,1
新北市,新莊區,0378,257,464,721,36,757,1287,58.82%,19.97%,1
新北市,新莊區,0379,235,439,674,58,732,1167,62.72%,20.14%,1
新北市,新莊區,0380,223,447,670,50,720,1299,55.43%,17.17%,1
新北市,新莊區,0381,251,406,657,40,697,1207,57.75%,20.8%,1
新北市,新莊區,0382,274,513,787,45,832,1415,58.8%,19.36%,1
新北市,新莊區,0383,262,437,699,61,760,1342,56.63%,19.52%,1
新北市,新莊區,0384,268,442,710,59,769,1341,57.35%,19.99%,1
新北市,新莊區,0385,254,405,659,58,717,1247,57.5%,20.37%,1
新北市,新莊區,0386,182,471,653,21,674,984,68.5%,18.5%,1
新北市,新莊區,0387,198,354,552,38,590,1043,56.57%,18.98%,1
新北市,新莊區,0388,256,460,716,38,754,1135,66.43%,22.56%,1
新北市,新莊區,0389,252,417,669,33,702,1185,59.24%,21.27%,1
新北市,新莊區,0390,290,462,752,33,785,1346,58.32%,21.55%,1
新北市,新莊區,0391,261,500,761,57,818,1372,59.62%,19.02%,1
新北市,新莊區,0392,257,520,777,54,831,1350,61.56%,19.04%,1
新北市,新莊區,0393,252,427,679,49,728,1307,55.7%,19.28%,1
新北市,新莊區,0394,244,476,720,64,784,1353,57.95%,18.03%,1
新北市,新莊區,0395,234,478,712,53,765,1287,59.44%,18.18%,1
新北市,新莊區,0396,256,454,710,32,742,1567,47.35%,16.34%,1
新北市,新莊區,0397,351,614,965,56,1021,1709,59.74%,20.54%,1
新北市,新莊區,0398,284,521,805,39,844,1616,52.23%,17.57%,1
新北市,新莊區,0399,308,481,789,55,844,1628,51.84%,18.92%,1
新北市,新莊區,0400,225,425,650,58,708,1148,61.67%,19.6%,1
新北市,新莊區,0401,226,439,665,7,672,1201,55.95%,18.82%,1
新北市,新莊區,0402,246,448,694,39,733,1135,64.58%,21.67%,1
新北市,新莊區,0403,315,552,867,86,953,1495,63.75%,21.07%,1
新北市,新莊區,0404,295,553,848,61,909,1486,61.17%,19.85%,1
新北市,新莊區,0405,336,555,891,38,929,1483,62.64%,22.66%,1
新北市,新莊區,0406,276,532,808,29,837,1553,53.9%,17.77%,1
新北市,新莊區,0407,365,618,983,23,1006,1625,61.91%,22.46%,1
新北市,新莊區,0408,343,579,922,32,954,1671,57.09%,20.53%,1
新北市,新莊區,0409,281,531,812,58,870,1389,62.63%,20.23%,1
新北市,新莊區,0410,243,448,691,49,740,1272,58.18%,19.1%,1
新北市,新莊區,0411,311,526,837,34,871,1409,61.82%,22.07%,1
新北市,新莊區,0412,302,506,808,35,843,1372,61.44%,22.01%,1
新北市,新莊區,0413,177,342,519,34,553,955,57.91%,18.53%,1
新北市,新莊區,0414,147,350,497,44,541,952,56.83%,15.44%,1
新北市,新莊區,0415,287,488,775,31,806,1412,57.08%,20.33%,1
新北市,新莊區,0416,243,527,770,54,824,1415,58.23%,17.17%,1
新北市,新莊區,0417,279,518,797,62,859,1421,60.45%,19.63%,1
新北市,新莊區,0418,287,480,767,42,809,1293,62.57%,22.2%,1
新北市,新莊區,0419,283,492,775,23,798,1475,54.1%,19.19%,1
新北市,新莊區,0420,251,512,763,61,824,1429,57.66%,17.56%,1
新北市,新莊區,0421,275,528,803,43,846,1481,57.12%,18.57%,1
新北市,新莊區,0422,266,559,825,64,889,1472,60.39%,18.07%,1
新北市,新莊區,0423,309,535,844,27,871,1474,59.09%,20.96%,1
新北市,新莊區,0424,321,527,848,21,869,1462,59.44%,21.96%,1
新北市,新莊區,0425,533,328,861,18,879,1484,59.23%,35.92%,1
新北市,新莊區,0426,280,533,813,30,843,1461,57.7%,19.16%,1
新北市,新莊區,0427,315,507,822,28,850,1444,58.86%,21.81%,1
新北市,新莊區,0428,290,532,822,34,856,1437,59.57%,20.18%,1
新北市,新莊區,0429,301,500,801,35,836,1641,50.94%,18.34%,1
新北市,新莊區,0430,318,504,822,46,868,1633,53.15%,19.47%,1
新北市,新莊區,0431,292,556,848,25,873,1531,57.02%,19.07%,1
新北市,新莊區,0432,306,553,859,46,905,1517,59.66%,20.17%,1
新北市,新莊區,0433,253,503,756,51,807,1487,54.27%,17.01%,1
新北市,新莊區,0434,305,549,854,35,889,1560,56.99%,19.55%,1
新北市,新莊區,0435,301,0,301,46,347,1584,21.91%,19%,1
新北市,新莊區,0436,292,545,837,32,869,1602,54.24%,18.23%,1
新北市,新莊區,0437,152,287,439,42,481,818,58.8%,18.58%,1
新北市,新莊區,0438,254,496,750,54,804,1633,49.23%,15.55%,1
新北市,新莊區,0439,275,567,842,51,893,1652,54.06%,16.65%,1
新北市,新莊區,0440,271,514,785,45,830,1498,55.41%,18.09%,1
新北市,新莊區,0441,256,473,729,50,779,1379,56.49%,18.56%,1
新北市,新莊區,0442,251,529,780,34,814,1381,58.94%,18.18%,1
新北市,新莊區,0443,278,555,833,72,905,1535,58.96%,18.11%,1
新北市,新莊區,0444,282,622,904,46,950,1492,63.67%,18.9%,1
新北市,新莊區,0445,314,543,857,62,919,1450,63.38%,21.66%,1
新北市,新莊區,0446,227,386,613,46,659,1107,59.53%,20.51%,1
新北市,新莊區,0447,220,401,621,25,646,1063,60.77%,20.7%,1
新北市,新莊區,0448,222,419,641,47,688,1143,60.19%,19.42%,1
新北市,新莊區,0449,244,429,673,79,752,1341,56.08%,18.2%,1
新北市,新莊區,0450,208,373,581,38,619,1063,58.23%,19.57%,1
新北市,新莊區,0451,224,406,630,35,665,1096,60.68%,20.44%,1
新北市,新莊區,0452,237,486,723,27,750,1309,57.3%,18.11%,1
新北市,新莊區,0453,248,447,695,46,741,1216,60.94%,20.39%,1
新北市,新莊區,0454,201,438,639,50,689,1278,53.91%,15.73%,1
新北市,新莊區,0455,256,457,713,63,776,1352,57.4%,18.93%,1
新北市,新莊區,0456,238,391,629,49,678,1298,52.23%,18.34%,1
新北市,新莊區,0457,187,377,564,47,611,1042,58.64%,17.95%,1
新北市,新莊區,0458,159,283,442,26,468,881,53.12%,18.05%,1
新北市,新莊區,0459,222,445,667,52,719,1109,64.83%,20.02%,1
新北市,新莊區,0460,238,440,678,41,719,1291,55.69%,18.44%,1
新北市,新莊區,0461,259,426,685,20,705,1293,54.52%,20.03%,1
新北市,新莊區,0462,267,475,742,46,788,1336,58.98%,19.99%,1
新北市,新莊區,0463,232,473,705,40,745,1384,53.83%,16.76%,1
新北市,新莊區,0464,197,402,599,29,628,1231,51.02%,16%,1
新北市,新莊區,0465,272,333,605,26,631,940,67.13%,28.94%,1
新北市,新莊區,0466,237,450,687,78,765,1369,55.88%,17.31%,1
新北市,新莊區,0467,212,490,702,75,777,1384,56.14%,15.32%,1
新北市,新莊區,0468,238,449,687,58,745,1272,58.57%,18.71%,1
新北市,新莊區,0469,195,409,604,36,640,1073,59.65%,18.17%,1
新北市,新莊區,0470,358,226,584,40,624,1058,58.98%,33.84%,1
新北市,新莊區,0471,314,506,820,20,840,1528,54.97%,20.55%,1
新北市,新莊區,0472,183,454,637,41,678,1244,54.5%,14.71%,1
新北市,新莊區,0473,202,488,690,37,727,1356,53.61%,14.9%,1
新北市,新莊區,0474,169,420,589,19,608,1164,52.23%,14.52%,1
新北市,新莊區,0475,257,535,792,48,840,1423,59.03%,18.06%,1
新北市,新莊區,0476,278,468,746,31,777,1250,62.16%,22.24%,1
新北市,新莊區,0477,240,417,657,24,681,1252,54.39%,19.17%,1
新北市,新莊區,0478,179,360,539,21,560,1022,54.79%,17.51%,1
新北市,新莊區,0479,182,349,531,37,568,959,59.23%,18.98%,1
新北市,新莊區,0480,351,550,901,56,957,1646,58.14%,21.32%,1
新北市,新莊區,0481,328,491,819,53,872,1551,56.22%,21.15%,1
新北市,新莊區,0482,317,567,884,35,919,1526,60.22%,20.77%,1
新北市,新莊區,0483,322,517,839,27,866,1518,57.05%,21.21%,1
新北市,新莊區,0484,338,532,870,36,906,1547,58.56%,21.85%,1
新北市,新莊區,0485,245,510,755,70,825,1505,54.82%,16.28%,1
新北市,新莊區,0486,251,508,759,65,824,1527,53.96%,16.44%,1
新北市,新莊區,0487,245,493,738,42,780,1482,52.63%,16.53%,1
新北市,新莊區,0488,266,498,764,65,829,1586,52.27%,16.77%,1
新北市,新莊區,0489,174,383,557,66,623,1065,58.5%,16.34%,1
新北市,新莊區,0490,207,421,628,47,675,1040,64.9%,19.9%,1
新北市,新莊區,0491,206,361,567,43,610,1090,55.96%,18.9%,1
新北市,新莊區,0492,193,383,576,43,619,1071,57.8%,18.02%,1
新北市,新莊區,0493,309,529,838,40,878,1704,51.53%,18.13%,1
新北市,新莊區,0494,293,530,823,29,852,1698,50.18%,17.26%,1
新北市,新莊區,0495,292,520,812,41,853,1362,62.63%,21.44%,1
新北市,新莊區,0496,296,488,784,30,814,1350,60.3%,21.93%,1
新北市,新莊區,0497,313,593,906,63,969,1689,57.37%,18.53%,1
新北市,新莊區,0498,287,577,864,72,936,1612,58.06%,17.8%,1
新北市,新莊區,0499,208,434,642,44,686,1130,60.71%,18.41%,1
新北市,新莊區,0500,226,426,652,48,700,1111,63.01%,20.34%,1
新北市,新莊區,0501,273,518,791,47,838,1539,54.45%,17.74%,1
新北市,新莊區,0502,312,551,863,37,900,1586,56.75%,19.67%,1
新北市,新莊區,0503,318,565,883,50,933,1631,57.2%,19.5%,1
新北市,新莊區,0504,313,516,829,38,867,1540,56.3%,20.32%,1
新北市,新莊區,0505,240,426,666,45,711,1388,51.22%,17.29%,1
新北市,新莊區,0506,508,127,635,77,712,1388,51.3%,36.6%,1
新北市,新莊區,0507,229,423,652,46,698,1387,50.32%,16.51%,1
新北市,新莊區,0508,217,377,594,43,637,1181,53.94%,18.37%,1
新北市,新莊區,0509,201,403,604,54,658,1135,57.97%,17.71%,1
新北市,新莊區,0510,237,413,650,36,686,1173,58.48%,20.2%,1
新北市,新莊區,0511,282,380,662,40,702,1215,57.78%,23.21%,1
新北市,新莊區,0512,312,499,811,55,866,1488,58.2%,20.97%,1
新北市,新莊區,0513,295,488,783,39,822,1444,56.93%,20.43%,1
新北市,新莊區,0514,273,527,800,29,829,1499,55.3%,18.21%,1
新北市,新莊區,0515,280,496,776,27,803,1449,55.42%,19.32%,1
新北市,新莊區,0516,312,559,871,55,926,1640,56.46%,19.02%,1
新北市,新莊區,0517,313,538,851,54,905,1648,54.92%,18.99%,1
新北市,新莊區,0518,243,425,668,54,722,1371,52.66%,17.72%,1
新北市,新莊區,0519,269,451,720,50,770,1400,55%,19.21%,1
新北市,新莊區,0520,246,512,758,64,822,1457,56.42%,16.88%,1
新北市,新莊區,0521,274,496,770,58,828,1502,55.13%,18.24%,1
新北市,新莊區,0522,264,457,721,63,784,1412,55.52%,18.7%,1
新北市,新莊區,0523,225,467,692,46,738,1318,55.99%,17.07%,1
新北市,新莊區,0524,282,508,790,40,830,1411,58.82%,19.99%,1
新北市,新莊區,0525,259,446,705,30,735,1262,58.24%,20.52%,1
新北市,新莊區,0526,253,473,726,22,748,1228,60.91%,20.6%,1
新北市,新莊區,0527,422,542,964,62,1026,1748,58.7%,24.14%,1
新北市,新莊區,0528,332,621,953,74,1027,1761,58.32%,18.85%,1
新北市,新莊區,0529,219,442,661,47,708,1326,53.39%,16.52%,1
新北市,新莊區,0530,201,436,637,46,683,1344,50.82%,14.96%,1
新北市,新莊區,0531,233,498,731,38,769,1355,56.75%,17.2%,1
新北市,新莊區,0532,218,471,689,68,757,1306,57.96%,16.69%,1
新北市,新莊區,0533,286,471,757,40,797,1349,59.08%,21.2%,1
新北市,新莊區,0534,248,447,695,31,726,1265,57.39%,19.6%,1
新北市,新莊區,0535,244,492,736,43,779,1282,60.76%,19.03%,1
新北市,新莊區,0536,217,488,705,41,746,1237,60.31%,17.54%,1
新北市,新莊區,0537,230,497,727,20,747,1301,57.42%,17.68%,1
新北市,新莊區,0538,234,449,683,43,726,1262,57.53%,18.54%,1
新北市,新莊區,0539,224,464,688,35,723,1270,56.93%,17.64%,1
新北市,新莊區,0540,253,421,674,58,732,1245,58.8%,20.32%,1
新北市,新莊區,0541,207,418,625,59,684,1220,56.07%,16.97%,1
新北市,新莊區,0542,204,419,623,44,667,1245,53.57%,16.39%,1
新北市,新莊區,0543,216,396,612,47,659,1212,54.37%,17.82%,1
新北市,新莊區,0544,214,420,634,47,681,1253,54.35%,17.08%,1
新北市,新莊區,0545,211,421,632,45,677,1272,53.22%,16.59%,1
新北市,新莊區,0546,254,448,702,30,732,1227,59.66%,20.7%,1
新北市,新莊區,0547,213,434,647,30,677,1126,60.12%,18.92%,1
新北市,新莊區,0548,243,447,690,34,724,1240,58.39%,19.6%,1
新北市,新莊區,0549,276,498,774,38,812,1460,55.62%,18.9%,1
新北市,新莊區,0550,201,373,574,26,600,1072,55.97%,18.75%,1
新北市,新莊區,0551,210,352,562,31,593,1127,52.62%,18.63%,1
新北市,新莊區,0552,253,501,754,26,780,1332,58.56%,18.99%,1
新北市,新莊區,0553,290,395,685,21,706,1341,52.65%,21.63%,1
新北市,新莊區,0554,160,337,497,19,516,1140,45.26%,14.04%,1
新北市,新店區,1987,307,553,860,40,900,1603,56.14%,19.15%,1
新北市,新店區,1988,366,675,1041,45,1086,1921,56.53%,19.05%,1
新北市,新店區,1989,191,386,577,19,596,1082,55.08%,17.65%,1
新北市,新店區,1990,227,456,683,36,719,1235,58.22%,18.38%,1
新北市,新店區,1991,269,626,895,23,918,1568,58.55%,17.16%,1
新北市,新店區,1992,166,271,437,29,466,771,60.44%,21.53%,1
新北市,新店區,1993,271,417,688,30,718,1256,57.17%,21.58%,1
新北市,新店區,1994,192,372,564,40,604,1008,59.92%,19.05%,1
新北市,新店區,1995,271,584,855,42,897,1515,59.21%,17.89%,1
新北市,新店區,1996,288,689,977,39,1016,1637,62.06%,17.59%,1
新北市,新店區,1997,302,565,867,37,904,1549,58.36%,19.5%,1
新北市,新店區,1998,399,805,1204,49,1253,2011,62.31%,19.84%,1
新北市,新店區,1999,270,588,858,50,908,1554,58.43%,17.37%,1
新北市,新店區,2000,342,598,940,50,990,1770,55.93%,19.32%,1
新北市,新店區,2001,248,492,740,42,782,1316,59.42%,18.84%,1
新北市,新店區,2002,182,419,601,45,646,1126,57.37%,16.16%,1
新北市,新店區,2003,257,497,754,47,801,1460,54.86%,17.6%,1
新北市,新店區,2004,309,587,896,52,948,1584,59.85%,19.51%,1
新北市,新店區,2005,277,512,789,44,833,1449,57.49%,19.12%,1
新北市,新店區,2006,292,645,937,33,970,1520,63.82%,19.21%,1
新北市,新店區,2007,345,692,1037,35,1072,1821,58.87%,18.95%,1
新北市,新店區,2008,414,681,1095,29,1124,1956,57.46%,21.17%,1
新北市,新店區,2009,312,627,939,41,980,1665,58.86%,18.74%,1
新北市,新店區,2010,320,616,936,33,969,1588,61.02%,20.15%,1
新北市,新店區,2011,297,533,830,22,852,1519,56.09%,19.55%,1
新北市,新店區,2012,289,426,715,31,746,1185,62.95%,24.39%,1
新北市,新店區,2013,263,418,681,21,702,1095,64.11%,24.02%,1
新北市,新店區,2014,200,443,643,46,689,1106,62.3%,18.08%,1
新北市,新店區,2015,147,246,393,17,410,2700,15.19%,5.44%,1
新北市,新店區,2016,186,404,590,18,608,995,61.11%,18.69%,1
新北市,新店區,2017,227,413,640,37,677,1168,57.96%,19.43%,1
新北市,新店區,2018,232,491,723,40,763,1123,67.94%,20.66%,1
新北市,新店區,2019,232,454,686,21,707,1085,65.16%,21.38%,1
新北市,新店區,2020,290,557,847,40,887,1412,62.82%,20.54%,1
新北市,新店區,2021,80,853,933,44,977,1659,58.89%,4.82%,1
新北市,新店區,2022,232,492,724,39,763,1198,63.69%,19.37%,1
新北市,新店區,2023,207,510,717,28,745,1376,54.14%,15.04%,1
新北市,新店區,2024,211,487,698,22,720,1300,55.38%,16.23%,1
新北市,新店區,2025,200,493,693,32,725,1238,58.56%,16.16%,1
新北市,新店區,2026,238,497,735,23,758,1388,54.61%,17.15%,1
新北市,新店區,2027,194,364,558,34,592,933,63.45%,20.79%,1
新北市,新店區,2028,170,384,554,26,580,908,63.88%,18.72%,1
新北市,新店區,2029,266,600,866,47,913,1582,57.71%,16.81%,1
新北市,新店區,2030,244,500,744,36,780,1247,62.55%,19.57%,1
新北市,新店區,2031,185,379,564,39,603,971,62.1%,19.05%,1
新北市,新店區,2032,217,458,675,37,712,1145,62.18%,18.95%,1
新北市,新店區,2033,266,532,798,40,838,1392,60.2%,19.11%,1
新北市,新店區,2034,247,618,865,53,918,1452,63.22%,17.01%,1
新北市,新店區,2035,253,548,801,36,837,1440,58.13%,17.57%,1
新北市,新店區,2036,330,628,958,63,1021,1786,57.17%,18.48%,1
新北市,新店區,2037,332,695,1027,44,1071,1825,58.68%,18.19%,1
新北市,新店區,2038,280,587,867,27,894,1477,60.53%,18.96%,1
新北市,新店區,2039,347,639,986,45,1031,1750,58.91%,19.83%,1
新北市,新店區,2040,284,694,978,41,1019,1792,56.86%,15.85%,1
新北市,新店區,2041,332,757,1089,36,1125,1979,56.85%,16.78%,1
新北市,新店區,2042,165,325,490,16,506,826,61.26%,19.98%,1
新北市,新店區,2043,332,771,1103,35,1138,1924,59.15%,17.26%,1
新北市,新店區,2044,287,566,853,19,872,1383,63.05%,20.75%,1
新北市,新店區,2045,137,262,399,32,431,830,51.93%,16.51%,1
新北市,新店區,2046,335,703,1038,32,1070,1759,60.83%,19.04%,1
新北市,新店區,2047,351,774,1125,40,1165,1957,59.53%,17.94%,1
新北市,新店區,2048,311,569,880,22,902,1481,60.9%,21%,1
新北市,新店區,2049,307,553,860,56,916,1552,59.02%,19.78%,1
新北市,新店區,2050,246,532,778,70,848,1467,57.81%,16.77%,1
新北市,新店區,2051,252,515,767,35,802,1371,58.5%,18.38%,1
新北市,新店區,2052,183,391,574,26,600,991,60.54%,18.47%,1
新北市,新店區,2053,471,254,725,31,756,1231,61.41%,38.26%,1
新北市,新店區,2054,331,632,963,32,995,1701,58.5%,19.46%,1
新北市,新店區,2055,324,624,948,45,993,1707,58.17%,18.98%,1
新北市,新店區,2056,335,634,969,36,1005,1773,56.68%,18.89%,1
新北市,新店區,2057,424,525,949,37,986,1866,52.84%,22.72%,1
新北市,新店區,2058,355,652,1007,27,1034,1735,59.6%,20.46%,1
新北市,新店區,2059,350,651,1001,41,1042,1632,63.85%,21.45%,1
新北市,新店區,2060,300,595,895,50,945,1591,59.4%,18.86%,1
新北市,新店區,2061,242,517,759,59,818,1495,54.72%,16.19%,1
新北市,新店區,2062,235,536,771,19,790,1511,52.28%,15.55%,1
新北市,新店區,2063,230,457,687,49,736,1260,58.41%,18.25%,1
新北市,新店區,2064,364,763,1127,38,1165,1948,59.8%,18.69%,1
新北市,新店區,2065,321,624,945,41,986,1582,62.33%,20.29%,1
新北市,新店區,2066,241,489,730,35,765,1315,58.17%,18.33%,1
新北市,新店區,2067,307,515,822,48,870,1562,55.7%,19.65%,1
新北市,新店區,2068,379,781,1160,24,1184,1982,59.74%,19.12%,1
新北市,新店區,2069,293,560,853,50,903,1518,59.49%,19.3%,1
新北市,新店區,2070,320,640,960,24,984,1735,56.71%,18.44%,1
新北市,新店區,2071,305,632,937,33,970,1716,56.53%,17.77%,1
新北市,新店區,2072,315,570,885,41,926,1580,58.61%,19.94%,1
新北市,新店區,2073,305,516,821,28,849,1358,62.52%,22.46%,1
新北市,新店區,2074,332,616,948,54,1002,1610,62.24%,20.62%,1
新北市,新店區,2075,262,486,748,29,777,1383,56.18%,18.94%,1
新北市,新店區,2076,312,603,915,34,949,1596,59.46%,19.55%,1
新北市,新店區,2077,219,471,690,39,729,1360,53.6%,16.1%,1
新北市,新店區,2078,160,442,602,14,616,1160,53.1%,13.79%,1
新北市,新店區,2079,200,584,784,34,818,1236,66.18%,16.18%,1
新北市,新店區,2080,243,535,778,19,797,1234,64.59%,19.69%,1
新北市,新店區,2081,291,546,837,78,915,1579,57.95%,18.43%,1
新北市,新店區,2082,203,462,665,46,711,1241,57.29%,16.36%,1
新北市,新店區,2083,220,482,702,21,723,1275,56.71%,17.25%,1
新北市,新店區,2084,177,441,618,28,646,1214,53.21%,14.58%,1
新北市,新店區,2085,222,501,723,70,793,1578,50.25%,14.07%,1
新北市,新店區,2086,296,458,754,42,796,1442,55.2%,20.53%,1
新北市,新店區,2087,224,485,709,62,771,1475,52.27%,15.19%,1
新北市,新店區,2088,295,587,882,48,930,1580,58.86%,18.67%,1
新北市,新店區,2089,268,590,858,25,883,1585,55.71%,16.91%,1
新北市,新店區,2090,287,550,837,57,894,1586,56.37%,18.1%,1
新北市,新店區,2091,361,663,1024,53,1077,1931,55.77%,18.69%,1
新北市,新店區,2092,211,449,660,23,683,1239,55.13%,17.03%,1
新北市,新店區,2093,328,684,1012,36,1048,1892,55.39%,17.34%,1
新北市,新店區,2094,226,538,764,45,809,1529,52.91%,14.78%,1
新北市,新店區,2095,221,533,754,35,789,1358,58.1%,16.27%,1
新北市,新店區,2096,341,615,956,36,992,1905,52.07%,17.9%,1
新北市,新店區,2097,324,654,978,36,1014,1885,53.79%,17.19%,1
新北市,新店區,2098,202,484,686,48,734,1345,54.57%,15.02%,1
新北市,新店區,2099,227,531,758,42,800,1387,57.68%,16.37%,1
新北市,新店區,2100,361,687,1048,33,1081,1960,55.15%,18.42%,1
新北市,新店區,2101,339,618,957,74,1031,1837,56.12%,18.45%,1
新北市,新店區,2102,321,598,919,33,952,1662,57.28%,19.31%,1
新北市,新店區,2103,330,618,948,48,996,1617,61.6%,20.41%,1
新北市,新店區,2104,300,644,944,34,978,1704,57.39%,17.61%,1
新北市,新店區,2105,310,620,930,62,992,1835,54.06%,16.89%,1
新北市,新店區,2106,353,673,1026,58,1084,2009,53.96%,17.57%,1
新北市,新店區,2107,224,541,765,47,812,1450,56%,15.45%,1
新北市,新店區,2108,315,609,924,37,961,1726,55.68%,18.25%,1
新北市,新店區,2109,309,619,928,47,975,1797,54.26%,17.2%,1
新北市,新店區,2110,293,651,944,31,975,1739,56.07%,16.85%,1
新北市,新店區,2111,245,586,831,26,857,1523,56.27%,16.09%,1
新北市,新店區,2112,280,587,867,25,892,1642,54.32%,17.05%,1
新北市,新店區,2113,329,590,919,19,938,1644,57.06%,20.01%,1
新北市,新店區,2114,274,563,837,22,859,1662,51.68%,16.49%,1
新北市,新店區,2115,396,741,1137,46,1183,2067,57.23%,19.16%,1
新北市,新店區,2116,293,541,834,39,873,1870,46.68%,15.67%,1
新北市,新店區,2117,371,671,1042,37,1079,1982,54.44%,18.72%,1
新北市,新店區,2118,280,565,845,41,886,1546,57.31%,18.11%,1
新北市,新店區,2119,305,697,1002,32,1034,1712,60.4%,17.82%,1
新北市,新店區,2120,292,566,858,27,885,1423,62.19%,20.52%,1
新北市,新店區,2121,319,628,947,59,1006,1666,60.38%,19.15%,1
新北市,新店區,2122,332,723,1055,43,1098,1769,62.07%,18.77%,1
新北市,新店區,2123,158,347,505,39,544,1079,50.42%,14.64%,1
新北市,新店區,2124,187,411,598,22,620,1140,54.39%,16.4%,1
新北市,新店區,2125,335,648,983,20,1003,1825,54.96%,18.36%,1
新北市,新店區,2126,254,428,682,34,716,1178,60.78%,21.56%,1
新北市,新店區,2127,271,496,767,33,800,1463,54.68%,18.52%,1
新北市,新店區,2128,209,431,640,23,663,1152,57.55%,18.14%,1
新北市,新店區,2129,189,714,903,34,937,2008,46.66%,9.41%,1
新北市,新店區,2130,318,614,932,33,965,2120,45.52%,15%,1
新北市,新店區,2131,230,447,677,16,693,1153,60.1%,19.95%,1
新北市,新店區,2132,258,548,806,23,829,1573,52.7%,16.4%,1
新北市,新店區,2133,274,627,901,63,964,1992,48.39%,13.76%,1
新北市,新店區,2134,264,511,775,51,826,1668,49.52%,15.83%,1
新北市,新店區,2135,177,597,774,39,813,1617,50.28%,10.95%,1
新北市,新店區,2136,320,639,959,119,1078,2013,53.55%,15.9%,1
新北市,新店區,2137,345,656,1001,40,1041,1791,58.12%,19.26%,1
新北市,新店區,2138,298,592,890,38,928,1624,57.14%,18.35%,1
新北市,新店區,2139,201,481,682,34,716,1178,60.78%,17.06%,1
新北市,新店區,2140,226,505,731,24,755,1277,59.12%,17.7%,1
新北市,新店區,2141,370,663,1033,30,1063,1879,56.57%,19.69%,1
新北市,新店區,2142,114,310,424,31,455,939,48.46%,12.14%,1
新北市,新店區,2143,196,331,527,20,547,960,56.98%,20.42%,1
新北市,新店區,2144,248,545,793,90,883,1434,61.58%,17.29%,1
新北市,新店區,2145,320,597,917,41,958,1838,52.12%,17.41%,1
新北市,新店區,2146,262,515,777,39,816,1453,56.16%,18.03%,1
新北市,新店區,2147,245,542,787,44,831,1549,53.65%,15.82%,1
新北市,新店區,2148,360,677,1037,42,1079,1860,58.01%,19.35%,1
新北市,新店區,2149,279,589,868,42,910,1743,52.21%,16.01%,1
新北市,新店區,2150,224,479,703,35,738,1122,65.78%,19.96%,1
新北市,新店區,2151,199,574,773,43,816,1468,55.59%,13.56%,1
新北市,新店區,2152,327,615,942,32,974,1763,55.25%,18.55%,1
新北市,新店區,2153,243,463,706,26,732,1344,54.46%,18.08%,1
新北市,新店區,2154,93,282,375,32,407,753,54.05%,12.35%,1
新北市,新店區,2155,130,196,326,11,337,602,55.98%,21.59%,1
新北市,新店區,2156,462,665,1127,48,1175,2237,52.53%,20.65%,1
新北市,新店區,2157,192,383,575,34,609,1096,55.57%,17.52%,1
新北市,新店區,2158,181,322,503,35,538,1143,47.07%,15.84%,1
新北市,新店區,2159,263,593,856,71,927,1569,59.08%,16.76%,1
新北市,新店區,2160,176,467,643,62,705,1284,54.91%,13.71%,1
新北市,新店區,2161,55,88,143,13,156,439,35.54%,12.53%,1
新北市,新店區,2162,155,251,406,31,437,750,58.27%,20.67%,1
新北市,樹林區,1614,240,451,691,50,741,1408,52.63%,17.05%,1
新北市,樹林區,1615,228,451,679,26,705,1310,53.82%,17.4%,1
新北市,樹林區,1616,239,471,710,49,759,1534,49.48%,15.58%,1
新北市,樹林區,1617,183,445,628,45,673,1211,55.57%,15.11%,1
新北市,樹林區,1618,206,414,620,41,661,1125,58.76%,18.31%,1
新北市,樹林區,1619,187,462,649,34,683,1134,60.23%,16.49%,1
新北市,樹林區,1620,295,521,816,77,893,1897,47.07%,15.55%,1
新北市,樹林區,1621,324,536,860,53,913,1716,53.21%,18.88%,1
新北市,樹林區,1622,151,272,423,35,458,736,62.23%,20.52%,1
新北市,樹林區,1623,240,437,677,20,697,1137,61.3%,21.11%,1
新北市,樹林區,1624,289,483,772,37,809,1542,52.46%,18.74%,1
新北市,樹林區,1625,271,488,759,54,813,1470,55.31%,18.44%,1
新北市,樹林區,1626,270,422,692,23,715,1456,49.11%,18.54%,1
新北市,樹林區,1627,217,401,618,24,642,1124,57.12%,19.31%,1
新北市,樹林區,1628,210,420,630,25,655,1235,53.04%,17%,1
新北市,樹林區,1629,232,426,658,20,678,1212,55.94%,19.14%,1
新北市,樹林區,1630,186,390,576,41,617,1223,50.45%,15.21%,1
新北市,樹林區,1631,216,459,675,59,734,1335,54.98%,16.18%,1
新北市,樹林區,1632,232,398,630,34,664,1206,55.06%,19.24%,1
新北市,樹林區,1633,229,427,656,54,710,1927,36.84%,11.88%,1
新北市,樹林區,1634,161,318,479,44,523,914,57.22%,17.61%,1
新北市,樹林區,1635,276,512,788,46,834,1456,57.28%,18.96%,1
新北市,樹林區,1636,236,429,665,47,712,1409,50.53%,16.75%,1
新北市,樹林區,1637,278,557,835,66,901,1500,60.07%,18.53%,1
新北市,樹林區,1638,309,501,810,55,865,1545,55.99%,20%,1
新北市,樹林區,1639,283,493,776,30,806,1483,54.35%,19.08%,1
新北市,樹林區,1640,277,523,800,30,830,1524,54.46%,18.18%,1
新北市,樹林區,1641,290,473,763,38,801,1431,55.97%,20.27%,1
新北市,樹林區,1642,212,404,616,40,656,1181,55.55%,17.95%,1
新北市,樹林區,1643,190,416,606,45,651,1116,58.33%,17.03%,1
新北市,樹林區,1644,186,347,533,32,565,1077,52.46%,17.27%,1
新北市,樹林區,1645,190,356,546,21,567,1103,51.41%,17.23%,1
新北市,樹林區,1646,258,468,726,50,776,1385,56.03%,18.63%,1
新北市,樹林區,1647,117,522,639,32,671,1266,53%,9.24%,1
新北市,樹林區,1648,220,395,615,39,654,1195,54.73%,18.41%,1
新北市,樹林區,1649,238,400,638,47,685,1254,54.63%,18.98%,1
新北市,樹林區,1650,274,428,702,29,731,1263,57.88%,21.69%,1
新北市,樹林區,1651,304,529,833,69,902,1473,61.24%,20.64%,1
新北市,樹林區,1652,142,333,475,26,501,870,57.59%,16.32%,1
新北市,樹林區,1653,246,520,766,53,819,1338,61.21%,18.39%,1
新北市,樹林區,1654,174,331,505,41,546,1010,54.06%,17.23%,1
新北市,樹林區,1655,348,559,907,71,978,1658,58.99%,20.99%,1
新北市,樹林區,1656,345,547,892,58,950,1538,61.77%,22.43%,1
新北市,樹林區,1657,304,515,819,62,881,1405,62.7%,21.64%,1
新北市,樹林區,1658,292,540,832,55,887,1587,55.89%,18.4%,1
新北市,樹林區,1659,335,516,851,34,885,1566,56.51%,21.39%,1
新北市,樹林區,1660,178,343,521,14,535,997,53.66%,17.85%,1
新北市,樹林區,1661,233,393,626,55,681,1187,57.37%,19.63%,1
新北市,樹林區,1662,188,346,534,46,580,1061,54.67%,17.72%,1
新北市,樹林區,1663,281,654,935,36,971,1701,57.08%,16.52%,1
新北市,樹林區,1664,217,469,686,39,725,1278,56.73%,16.98%,1
新北市,樹林區,1665,492,521,1013,53,1066,1433,74.39%,34.33%,1
新北市,樹林區,1666,266,481,747,50,797,1306,61.03%,20.37%,1
新北市,樹林區,1667,262,459,721,58,779,1268,61.44%,20.66%,1
新北市,樹林區,1668,244,470,714,31,745,1281,58.16%,19.05%,1
新北市,樹林區,1669,245,428,673,42,715,1200,59.58%,20.42%,1
新北市,樹林區,1670,238,513,751,41,792,1491,53.12%,15.96%,1
新北市,樹林區,1671,186,376,562,22,584,1066,54.78%,17.45%,1
新北市,樹林區,1672,160,335,495,60,555,877,63.28%,18.24%,1
新北市,樹林區,1673,270,563,833,45,878,1616,54.33%,16.71%,1
新北市,樹林區,1674,246,456,702,57,759,1589,47.77%,15.48%,1
新北市,樹林區,1675,238,511,749,48,797,1367,58.3%,17.41%,1
新北市,樹林區,1676,205,452,657,31,688,1144,60.14%,17.92%,1
新北市,樹林區,1677,252,288,540,30,570,1059,53.82%,23.8%,1
新北市,樹林區,1678,226,393,619,58,677,1224,55.31%,18.46%,1
新北市,樹林區,1679,222,317,539,34,573,1141,50.22%,19.46%,1
新北市,樹林區,1680,216,407,623,18,641,1396,45.92%,15.47%,1
新北市,樹林區,1681,251,350,601,35,636,1157,54.97%,21.69%,1
新北市,樹林區,1682,246,460,706,67,773,1498,51.6%,16.42%,1
新北市,樹林區,1683,251,532,783,53,836,1514,55.22%,16.58%,1
新北市,樹林區,1684,249,505,754,27,781,1546,50.52%,16.11%,1
新北市,樹林區,1685,267,461,728,48,776,1392,55.75%,19.18%,1
新北市,樹林區,1686,271,565,836,35,871,1566,55.62%,17.31%,1
新北市,樹林區,1687,294,537,831,30,861,1566,54.98%,18.77%,1
新北市,樹林區,1688,285,495,780,49,829,1517,54.65%,18.79%,1
新北市,樹林區,1689,284,513,797,29,826,1481,55.77%,19.18%,1
新北市,樹林區,1690,199,450,649,38,687,1261,54.48%,15.78%,1
新北市,樹林區,1691,187,398,585,30,615,1163,52.88%,16.08%,1
新北市,樹林區,1692,320,601,921,71,992,1661,59.72%,19.27%,1
新北市,樹林區,1693,323,542,865,36,901,1585,56.85%,20.38%,1
新北市,樹林區,1694,190,388,578,37,615,1018,60.41%,18.66%,1
新北市,樹林區,1695,215,431,646,55,701,1247,56.21%,17.24%,1
新北市,樹林區,1696,219,475,694,61,755,1390,54.32%,15.76%,1
新北市,樹林區,1697,227,482,709,37,746,1293,57.7%,17.56%,1
新北市,樹林區,1698,217,447,664,26,690,1301,53.04%,16.68%,1
新北市,樹林區,1699,299,510,809,46,855,1606,53.24%,18.62%,1
新北市,樹林區,1700,206,432,638,68,706,1277,55.29%,16.13%,1
新北市,樹林區,1701,240,403,643,54,697,1219,57.18%,19.69%,1
新北市,樹林區,1702,234,485,719,36,755,1454,51.93%,16.09%,1
新北市,樹林區,1703,196,475,671,31,702,1314,53.42%,14.92%,1
新北市,樹林區,1704,189,428,617,24,641,1008,63.59%,18.75%,1
新北市,樹林區,1705,279,516,795,54,849,1574,53.94%,17.73%,1
新北市,樹林區,1706,242,516,758,28,786,1364,57.62%,17.74%,1
新北市,樹林區,1707,251,544,795,58,853,1677,50.86%,14.97%,1
新北市,樹林區,1708,242,497,739,27,766,1683,45.51%,14.38%,1
新北市,樹林區,1709,245,546,791,46,837,1452,57.64%,16.87%,1
新北市,樹林區,1710,345,558,903,26,929,1592,58.35%,21.67%,1
新北市,樹林區,1711,304,606,910,30,940,1619,58.06%,18.78%,1
新北市,樹林區,1712,341,635,976,23,999,1642,60.84%,20.77%,1
新北市,樹林區,1713,277,476,753,16,769,1357,56.67%,20.41%,1
新北市,樹林區,1714,280,572,852,70,922,1638,56.29%,17.09%,1
新北市,樹林區,1715,319,528,847,29,876,1592,55.03%,20.04%,1
新北市,樹林區,1716,258,598,856,36,892,1521,58.65%,16.96%,1
新北市,樹林區,1717,328,671,999,40,1039,1707,60.87%,19.21%,1
新北市,樹林區,1718,348,623,971,47,1018,1741,58.47%,19.99%,1
新北市,樹林區,1719,356,546,902,26,928,1655,56.07%,21.51%,1
新北市,樹林區,1720,301,557,858,54,912,1775,51.38%,16.96%,1
新北市,樹林區,1721,240,690,930,43,973,1781,54.63%,13.48%,1
新北市,樹林區,1722,256,445,701,39,740,1565,47.28%,16.36%,1
新北市,樹林區,1723,155,315,470,34,504,936,53.85%,16.56%,1
新北市,樹林區,1724,192,375,567,17,584,1030,56.7%,18.64%,1
新北市,鶯歌區,1725,80,203,283,15,298,515,57.86%,15.53%,1
新北市,鶯歌區,1726,191,350,541,41,582,965,60.31%,19.79%,1
新北市,鶯歌區,1727,348,643,991,73,1064,1931,55.1%,18.02%,1
新北市,鶯歌區,1728,310,528,838,51,889,1797,49.47%,17.25%,1
新北市,鶯歌區,1729,167,393,560,43,603,1057,57.05%,15.8%,1
新北市,鶯歌區,1730,165,320,485,14,499,962,51.87%,17.15%,1
新北市,鶯歌區,1731,194,361,555,32,587,934,62.85%,20.77%,1
新北市,鶯歌區,1732,334,658,992,52,1044,1742,59.93%,19.17%,1
新北市,鶯歌區,1733,297,541,838,37,875,1634,53.55%,18.18%,1
新北市,鶯歌區,1734,306,524,830,25,855,1676,51.01%,18.26%,1
新北市,鶯歌區,1735,392,682,1074,53,1127,2052,54.92%,19.1%,1
新北市,鶯歌區,1736,346,568,914,27,941,1977,47.6%,17.5%,1
新北市,鶯歌區,1737,394,640,1034,19,1053,1957,53.81%,20.13%,1
新北市,鶯歌區,1738,126,264,390,19,409,850,48.12%,14.82%,1
新北市,鶯歌區,1739,273,598,871,44,915,1782,51.35%,15.32%,1
新北市,鶯歌區,1740,279,475,754,44,798,1496,53.34%,18.65%,1
新北市,鶯歌區,1741,316,674,990,35,1025,2071,49.49%,15.26%,1
新北市,鶯歌區,1742,282,467,749,44,793,1753,45.24%,16.09%,1
新北市,鶯歌區,1743,277,579,856,34,890,1737,51.24%,15.95%,1
新北市,鶯歌區,1744,269,524,793,52,845,1669,50.63%,16.12%,1
新北市,鶯歌區,1745,295,506,801,36,837,1842,45.44%,16.02%,1
新北市,鶯歌區,1746,232,460,692,49,741,1454,50.96%,15.96%,1
新北市,鶯歌區,1747,175,297,472,35,507,942,53.82%,18.58%,1
新北市,鶯歌區,1748,233,420,653,48,701,1317,53.23%,17.69%,1
新北市,鶯歌區,1749,147,314,461,18,479,949,50.47%,15.49%,1
新北市,鶯歌區,1750,278,522,800,42,842,1440,58.47%,19.31%,1
新北市,鶯歌區,1751,318,620,938,56,994,1809,54.95%,17.58%,1
新北市,鶯歌區,1752,328,609,937,54,991,1758,56.37%,18.66%,1
新北市,鶯歌區,1753,268,564,832,36,868,1589,54.63%,16.87%,1
新北市,鶯歌區,1754,211,399,610,29,639,1067,59.89%,19.78%,1
新北市,鶯歌區,1755,202,410,612,34,646,1092,59.16%,18.5%,1
新北市,鶯歌區,1756,297,627,924,42,966,1730,55.84%,17.17%,1
新北市,鶯歌區,1757,208,478,686,29,715,1281,55.82%,16.24%,1
新北市,鶯歌區,1758,224,501,725,41,766,1238,61.87%,18.09%,1
新北市,鶯歌區,1759,253,563,816,53,869,1568,55.42%,16.14%,1
新北市,鶯歌區,1760,216,426,642,44,686,1271,53.97%,16.99%,1
新北市,鶯歌區,1761,171,319,490,33,523,1183,44.21%,14.45%,1
新北市,鶯歌區,1762,158,327,485,21,506,1026,49.32%,15.4%,1
新北市,鶯歌區,1763,279,536,815,44,859,1721,49.91%,16.21%,1
新北市,鶯歌區,1764,209,415,624,66,690,1317,52.39%,15.87%,1
新北市,鶯歌區,1765,190,396,586,41,627,1046,59.94%,18.16%,1
新北市,鶯歌區,1766,231,406,637,53,690,1144,60.31%,20.19%,1
新北市,鶯歌區,1767,210,430,640,45,685,1336,51.27%,15.72%,1
新北市,鶯歌區,1768,201,465,666,48,714,1479,48.28%,13.59%,1
新北市,鶯歌區,1769,296,553,849,51,900,1736,51.84%,17.05%,1
新北市,鶯歌區,1770,262,497,759,54,813,1389,58.53%,18.86%,1
新北市,鶯歌區,1771,287,766,1053,61,1114,1956,56.95%,14.67%,1
新北市,鶯歌區,1772,241,476,717,39,756,1371,55.14%,17.58%,1
新北市,鶯歌區,1773,227,464,691,27,718,1810,39.67%,12.54%,1
新北市,鶯歌區,1774,42,84,126,2,128,227,56.39%,18.5%,1
新北市,三峽區,1917,57,108,165,22,187,274,68.25%,20.8%,1
新北市,三峽區,1918,105,192,297,25,322,583,55.23%,18.01%,1
新北市,三峽區,1919,289,501,790,22,812,1765,46.01%,16.37%,1
新北市,三峽區,1920,305,555,860,48,908,1714,52.98%,17.79%,1
新北市,三峽區,1921,219,457,676,23,699,1355,51.59%,16.16%,1
新北市,三峽區,1922,261,462,723,32,755,1329,56.81%,19.64%,1
新北市,三峽區,1923,180,347,527,40,567,1059,53.54%,17%,1
新北市,三峽區,1924,261,475,736,50,786,1364,57.62%,19.13%,1
新北市,三峽區,1925,229,370,599,47,646,1098,58.83%,20.86%,1
新北市,三峽區,1926,227,442,669,45,714,1296,55.09%,17.52%,1
新北市,三峽區,1927,231,405,636,34,670,1240,54.03%,18.63%,1
新北市,三峽區,1928,301,472,773,41,814,1531,53.17%,19.66%,1
新北市,三峽區,1929,221,466,687,25,712,1444,49.31%,15.3%,1
新北市,三峽區,1930,253,411,664,69,733,1347,54.42%,18.78%,1
新北市,三峽區,1931,240,503,743,45,788,1455,54.16%,16.49%,1
新北市,三峽區,1932,239,467,706,31,737,1556,47.37%,15.36%,1
新北市,三峽區,1933,213,380,593,27,620,1390,44.6%,15.32%,1
新北市,三峽區,1934,267,514,781,39,820,1532,53.52%,17.43%,1
新北市,三峽區,1935,187,438,625,48,673,1377,48.87%,13.58%,1
新北市,三峽區,1936,279,576,855,43,898,1731,51.88%,16.12%,1
新北市,三峽區,1937,285,544,829,34,863,1705,50.62%,16.72%,1
新北市,三峽區,1938,318,536,854,23,877,1590,55.16%,20%,1
新北市,三峽區,1939,290,630,920,22,942,1650,57.09%,17.58%,1
新北市,三峽區,1940,272,495,767,30,797,1441,55.31%,18.88%,1
新北市,三峽區,1941,265,527,792,25,817,1404,58.19%,18.87%,1
新北市,三峽區,1942,279,467,746,23,769,1295,59.38%,21.54%,1
新北市,三峽區,1943,213,428,641,27,668,1348,49.55%,15.8%,1
新北市,三峽區,1944,291,578,869,10,879,1579,55.67%,18.43%,1
新北市,三峽區,1945,257,495,752,19,771,1435,53.73%,17.91%,1
新北市,三峽區,1946,294,652,946,28,974,1659,58.71%,17.72%,1
新北市,三峽區,1947,335,554,889,27,916,1512,60.58%,22.16%,1
新北市,三峽區,1948,262,560,822,31,853,1463,58.3%,17.91%,1
新北市,三峽區,1949,286,557,843,20,863,1465,58.91%,19.52%,1
新北市,三峽區,1950,280,553,833,18,851,1463,58.17%,19.14%,1
新北市,三峽區,1951,266,543,809,26,835,1443,57.87%,18.43%,1
新北市,三峽區,1952,270,525,795,38,833,1634,50.98%,16.52%,1
新北市,三峽區,1953,298,595,893,39,932,1716,54.31%,17.37%,1
新北市,三峽區,1954,272,554,826,46,872,1675,52.06%,16.24%,1
新北市,三峽區,1955,241,468,709,37,746,1649,45.24%,14.61%,1
新北市,三峽區,1956,257,487,744,45,789,1489,52.99%,17.26%,1
新北市,三峽區,1957,302,500,802,39,841,1771,47.49%,17.05%,1
新北市,三峽區,1958,367,559,926,25,951,1726,55.1%,21.26%,1
新北市,三峽區,1959,229,456,685,47,732,1363,53.71%,16.8%,1
新北市,三峽區,1960,298,543,841,35,876,1624,53.94%,18.35%,1
新北市,三峽區,1961,269,454,723,35,758,1352,56.07%,19.9%,1
新北市,三峽區,1962,220,413,633,17,650,1608,40.42%,13.68%,1
新北市,三峽區,1963,248,490,738,45,783,1458,53.7%,17.01%,1
新北市,三峽區,1964,275,491,766,34,800,1641,48.75%,16.76%,1
新北市,三峽區,1965,258,478,736,76,812,1530,53.07%,16.86%,1
新北市,三峽區,1966,187,401,588,45,633,1389,45.57%,13.46%,1
新北市,三峽區,1967,203,406,609,58,667,1315,50.72%,15.44%,1
新北市,三峽區,1968,138,402,540,29,569,934,60.92%,14.78%,1
新北市,三峽區,1969,189,394,583,32,615,1270,48.43%,14.88%,1
新北市,三峽區,1970,122,300,422,36,458,929,49.3%,13.13%,1
新北市,三峽區,1971,168,353,521,15,536,1035,51.79%,16.23%,1
新北市,三峽區,1972,78,157,235,8,243,502,48.41%,15.54%,1
新北市,三峽區,1973,97,270,367,46,413,836,49.4%,11.6%,1
新北市,三峽區,1974,81,200,281,48,329,669,49.18%,12.11%,1
新北市,三峽區,1975,112,276,388,53,441,733,60.16%,15.28%,1
新北市,三峽區,1976,256,635,891,43,934,1560,59.87%,16.41%,1
新北市,三峽區,1977,158,645,803,42,845,1638,51.59%,9.65%,1
新北市,三峽區,1978,186,507,693,28,721,1394,51.72%,13.34%,1
新北市,三峽區,1979,140,272,412,34,446,771,57.85%,18.16%,1
新北市,三峽區,1980,215,460,675,24,699,1367,51.13%,15.73%,1
新北市,三峽區,1981,180,423,603,44,647,1241,52.14%,14.5%,1
新北市,三峽區,1982,227,482,709,30,739,1520,48.62%,14.93%,1
新北市,三峽區,1983,134,389,523,34,557,873,63.8%,15.35%,1
新北市,三峽區,1984,104,216,320,53,373,768,48.57%,13.54%,1
新北市,三峽區,1985,139,351,490,30,520,1097,47.4%,12.67%,1
新北市,三峽區,1986,164,367,531,55,586,1322,44.33%,12.41%,1
新北市,淡水區,0029,90,172,262,30,292,544,53.68%,16.54%,1
新北市,淡水區,0030,152,374,526,55,581,1044,55.65%,14.56%,1
新北市,淡水區,0031,213,480,693,53,746,1462,51.03%,14.57%,1
新北市,淡水區,0032,232,496,728,71,799,1525,52.39%,15.21%,1
新北市,淡水區,0033,140,297,437,41,478,986,48.48%,14.2%,1
新北市,淡水區,0034,112,307,419,42,461,806,57.2%,13.9%,1
新北市,淡水區,0035,176,416,592,65,657,1173,56.01%,15%,1
新北市,淡水區,0036,179,431,610,38,648,1343,48.25%,13.33%,1
新北市,淡水區,0037,165,328,493,21,514,1153,44.58%,14.31%,1
新北市,淡水區,0038,118,295,413,31,444,874,50.8%,13.5%,1
新北市,淡水區,0039,249,279,528,69,597,1063,56.16%,23.42%,1
新北市,淡水區,0040,194,436,630,31,661,1309,50.5%,14.82%,1
新北市,淡水區,0041,232,428,660,45,705,1290,54.65%,17.98%,1
新北市,淡水區,0042,300,624,924,27,951,1675,56.78%,17.91%,1
新北市,淡水區,0043,291,542,833,45,878,1589,55.25%,18.31%,1
新北市,淡水區,0044,343,558,901,41,942,1624,58%,21.12%,1
新北市,淡水區,0045,238,398,636,25,661,1241,53.26%,19.18%,1
新北市,淡水區,0046,217,447,664,41,705,1317,53.53%,16.48%,1
新北市,淡水區,0047,231,451,682,25,707,1225,57.71%,18.86%,1
新北市,淡水區,0048,276,483,759,29,788,1426,55.26%,19.35%,1
新北市,淡水區,0049,359,534,893,42,935,1610,58.07%,22.3%,1
新北市,淡水區,0050,400,670,1070,36,1106,1982,55.8%,20.18%,1
新北市,淡水區,0051,304,550,854,46,900,1924,46.78%,15.8%,1
新北市,淡水區,0052,340,537,877,42,919,1822,50.44%,18.66%,1
新北市,淡水區,0053,250,415,665,73,738,1232,59.9%,20.29%,1
新北市,淡水區,0054,254,593,847,63,910,1588,57.3%,15.99%,1
新北市,淡水區,0055,348,520,868,29,897,1784,50.28%,19.51%,1
新北市,淡水區,0056,331,529,860,67,927,1762,52.61%,18.79%,1
新北市,淡水區,0057,315,479,794,30,824,1546,53.3%,20.38%,1
新北市,淡水區,0058,379,600,979,43,1022,1897,53.87%,19.98%,1
新北市,淡水區,0059,286,480,766,33,799,1489,53.66%,19.21%,1
新北市,淡水區,0060,283,535,818,40,858,1679,51.1%,16.86%,1
新北市,淡水區,0061,300,508,808,32,840,1693,49.62%,17.72%,1
新北市,淡水區,0062,266,544,810,19,829,1674,49.52%,15.89%,1
新北市,淡水區,0063,237,463,700,28,728,1330,54.74%,17.82%,1
新北市,淡水區,0064,266,486,752,16,768,1467,52.35%,18.13%,1
新北市,淡水區,0065,287,660,947,33,980,1837,53.35%,15.62%,1
新北市,淡水區,0066,235,401,636,15,651,1924,33.84%,12.21%,1
新北市,淡水區,0067,414,736,1150,30,1180,2340,50.43%,17.69%,1
新北市,淡水區,0068,263,498,761,46,807,1704,47.36%,15.43%,1
新北市,淡水區,0069,246,436,682,38,720,1363,52.82%,18.05%,1
新北市,淡水區,0070,469,924,1393,27,1420,3068,46.28%,15.29%,1
新北市,淡水區,0071,228,491,719,38,757,1528,49.54%,14.92%,1
新北市,淡水區,0072,285,504,789,44,833,1600,52.06%,17.81%,1
新北市,淡水區,0073,317,681,998,55,1053,1874,56.19%,16.92%,1
新北市,淡水區,0074,568,210,778,56,834,1567,53.22%,36.25%,1
新北市,淡水區,0075,279,393,672,31,703,1245,56.47%,22.41%,1
新北市,淡水區,0076,233,379,612,16,628,1211,51.86%,19.24%,1
新北市,淡水區,0077,399,681,1080,41,1121,1992,56.28%,20.03%,1
新北市,淡水區,0078,388,681,1069,26,1095,2028,53.99%,19.13%,1
新北市,淡水區,0079,214,529,743,38,781,1373,56.88%,15.59%,1
新北市,淡水區,0080,325,582,907,38,945,1732,54.56%,18.76%,1
新北市,淡水區,0081,286,447,733,33,766,1519,50.43%,18.83%,1
新北市,淡水區,0082,285,531,816,20,836,1727,48.41%,16.5%,1
新北市,淡水區,0083,225,474,699,28,727,1297,56.05%,17.35%,1
新北市,淡水區,0084,182,342,524,47,571,1066,53.56%,17.07%,1
新北市,淡水區,0085,237,506,743,35,778,1387,56.09%,17.09%,1
新北市,淡水區,0086,326,683,1009,34,1043,1909,54.64%,17.08%,1
新北市,淡水區,0087,301,614,915,42,957,1770,54.07%,17.01%,1
新北市,淡水區,0088,335,661,996,39,1035,2049,50.51%,16.35%,1
新北市,淡水區,0089,418,458,876,30,906,1680,53.93%,24.88%,1
新北市,淡水區,0090,287,509,796,50,846,1433,59.04%,20.03%,1
新北市,淡水區,0091,239,438,677,28,705,1365,51.65%,17.51%,1
新北市,淡水區,0092,275,491,766,44,810,1452,55.79%,18.94%,1
新北市,淡水區,0093,304,619,923,38,961,1804,53.27%,16.85%,1
新北市,淡水區,0094,245,452,697,40,737,1322,55.75%,18.53%,1
新北市,淡水區,0095,392,642,1034,37,1071,2019,53.05%,19.42%,1
新北市,淡水區,0096,330,610,940,41,981,1696,57.84%,19.46%,1
新北市,淡水區,0097,572,285,857,21,878,1576,55.71%,36.29%,1
新北市,淡水區,0098,343,615,958,36,994,1781,55.81%,19.26%,1
新北市,淡水區,0099,339,567,906,60,966,1665,58.02%,20.36%,1
新北市,淡水區,0100,362,668,1030,47,1077,2013,53.5%,17.98%,1
新北市,淡水區,0101,203,353,556,38,594,1108,53.61%,18.32%,1
新北市,淡水區,0102,237,440,677,41,718,1305,55.02%,18.16%,1
新北市,淡水區,0103,221,416,637,15,652,1199,54.38%,18.43%,1
新北市,淡水區,0104,672,359,1031,38,1069,2017,53%,33.32%,1
新北市,淡水區,0105,371,627,998,44,1042,2125,49.04%,17.46%,1
新北市,淡水區,0106,192,386,578,23,601,1289,46.63%,14.9%,1
新北市,淡水區,0107,263,488,751,34,785,1319,59.51%,19.94%,1
新北市,淡水區,0108,198,383,581,22,603,1051,57.37%,18.84%,1
新北市,淡水區,0109,231,472,703,35,738,1348,54.75%,17.14%,1
新北市,淡水區,0110,188,373,561,30,591,1106,53.44%,17%,1
新北市,淡水區,0111,129,263,392,28,420,717,58.58%,17.99%,1
新北市,淡水區,0112,247,453,700,34,734,1385,53%,17.83%,1
新北市,淡水區,0113,296,164,460,42,502,841,59.69%,35.2%,1
新北市,淡水區,0114,132,230,362,25,387,665,58.2%,19.85%,1
新北市,淡水區,0115,80,159,239,12,251,419,59.9%,19.09%,1
新北市,淡水區,0116,282,596,878,25,903,1599,56.47%,17.64%,1
新北市,淡水區,0117,291,541,832,51,883,1670,52.87%,17.43%,1
新北市,淡水區,0118,321,592,913,50,963,1683,57.22%,19.07%,1
新北市,淡水區,0119,246,514,760,45,805,1577,51.05%,15.6%,1
新北市,淡水區,0120,244,517,761,52,813,1618,50.25%,15.08%,1
新北市,淡水區,0121,344,671,1015,19,1034,2214,46.7%,15.54%,1
新北市,淡水區,0122,328,585,913,46,959,1832,52.35%,17.9%,1
新北市,淡水區,0123,363,716,1079,48,1127,2123,53.09%,17.1%,1
新北市,淡水區,0124,383,900,1283,25,1308,2998,43.63%,12.78%,1
新北市,汐止區,2336,275,528,803,58,861,1595,53.98%,17.24%,1
新北市,汐止區,2337,225,440,665,41,706,1262,55.94%,17.83%,1
新北市,汐止區,2338,192,302,494,47,541,917,59%,20.94%,1
新北市,汐止區,2339,378,658,1036,37,1073,1929,55.62%,19.6%,1
新北市,汐止區,2340,433,699,1132,51,1183,2227,53.12%,19.44%,1
新北市,汐止區,2341,233,365,598,41,639,1143,55.91%,20.38%,1
新北市,汐止區,2342,240,482,722,31,753,1367,55.08%,17.56%,1
新北市,汐止區,2343,61,100,161,15,176,322,54.66%,18.94%,1
新北市,汐止區,2344,293,486,779,14,793,1460,54.32%,20.07%,1
新北市,汐止區,2345,335,515,850,34,884,1719,51.43%,19.49%,1
新北市,汐止區,2346,278,532,810,54,864,1661,52.02%,16.74%,1
新北市,汐止區,2347,319,535,854,48,902,1590,56.73%,20.06%,1
新北市,汐止區,2348,305,536,841,43,884,1599,55.28%,19.07%,1
新北市,汐止區,2349,314,614,928,41,969,1749,55.4%,17.95%,1
新北市,汐止區,2350,138,192,330,26,356,1809,19.68%,7.63%,1
新北市,汐止區,2351,279,464,743,22,765,1601,47.78%,17.43%,1
新北市,汐止區,2352,236,445,681,57,738,1387,53.21%,17.02%,1
新北市,汐止區,2353,378,562,940,56,996,1779,55.99%,21.25%,1
新北市,汐止區,2354,354,755,1109,47,1156,2074,55.74%,17.07%,1
新北市,汐止區,2355,373,699,1072,46,1118,2072,53.96%,18%,1
新北市,汐止區,2356,753,441,1194,50,1244,2120,58.68%,35.52%,1
新北市,汐止區,2357,396,631,1027,37,1064,1952,54.51%,20.29%,1
新北市,汐止區,2358,296,538,834,46,880,1654,53.2%,17.9%,1
新北市,汐止區,2359,250,455,705,56,761,1444,52.7%,17.31%,1
新北市,汐止區,2360,369,559,928,36,964,1627,59.25%,22.68%,1
新北市,汐止區,2361,322,521,843,61,904,1751,51.63%,18.39%,1
新北市,汐止區,2362,423,619,1042,43,1085,2066,52.52%,20.47%,1
新北市,汐止區,2363,269,554,823,52,875,1941,45.08%,13.86%,1
新北市,汐止區,2364,324,540,864,44,908,1906,47.64%,17%,1
新北市,汐止區,2365,233,423,656,62,718,1363,52.68%,17.09%,1
新北市,汐止區,2366,232,449,681,30,711,1368,51.97%,16.96%,1
新北市,汐止區,2367,210,363,573,40,613,1233,49.72%,17.03%,1
新北市,汐止區,2368,298,485,783,24,807,1554,51.93%,19.18%,1
新北市,汐止區,2369,295,539,834,37,871,1700,51.24%,17.35%,1
新北市,汐止區,2370,244,371,615,18,633,1124,56.32%,21.71%,1
新北市,汐止區,2371,376,663,1039,48,1087,1900,57.21%,19.79%,1
新北市,汐止區,2372,388,654,1042,57,1099,2050,53.61%,18.93%,1
新北市,汐止區,2373,264,355,619,51,670,1244,53.86%,21.22%,1
新北市,汐止區,2374,221,420,641,27,668,1320,50.61%,16.74%,1
新北市,汐止區,2375,306,495,801,33,834,1473,56.62%,20.77%,1
新北市,汐止區,2376,293,645,938,55,993,1802,55.11%,16.26%,1
新北市,汐止區,2377,224,483,707,36,743,1266,58.69%,17.69%,1
新北市,汐止區,2378,240,441,681,54,735,1481,49.63%,16.21%,1
新北市,汐止區,2379,293,424,717,54,771,1497,51.5%,19.57%,1
新北市,汐止區,2380,86,214,300,16,316,556,56.83%,15.47%,1
新北市,汐止區,2381,333,574,907,48,955,1913,49.92%,17.41%,1
新北市,汐止區,2382,372,611,983,35,1018,2027,50.22%,18.35%,1
新北市,汐止區,2383,347,561,908,39,947,1927,49.14%,18.01%,1
新北市,汐止區,2384,111,238,349,40,389,696,55.89%,15.95%,1
新北市,汐止區,2385,365,635,1000,56,1056,2127,49.65%,17.16%,1
新北市,汐止區,2386,277,452,729,48,777,1642,47.32%,16.87%,1
新北市,汐止區,2387,321,617,938,67,1005,1912,52.56%,16.79%,1
新北市,汐止區,2388,300,527,827,55,882,1893,46.59%,15.85%,1
新北市,汐止區,2389,244,414,658,57,715,1466,48.77%,16.64%,1
新北市,汐止區,2390,260,471,731,61,792,1538,51.5%,16.91%,1
新北市,汐止區,2391,275,470,745,45,790,1550,50.97%,17.74%,1
新北市,汐止區,2392,218,477,695,55,750,1456,51.51%,14.97%,1
新北市,汐止區,2393,154,377,531,37,568,947,59.98%,16.26%,1
新北市,汐止區,2394,195,300,495,29,524,923,56.77%,21.13%,1
新北市,汐止區,2395,306,627,933,96,1029,2043,50.37%,14.98%,1
新北市,汐止區,2396,339,558,897,65,962,2012,47.81%,16.85%,1
新北市,汐止區,2397,233,427,660,27,687,1471,46.7%,15.84%,1
新北市,汐止區,2398,272,504,776,40,816,1603,50.9%,16.97%,1
新北市,汐止區,2399,244,526,770,53,823,1530,53.79%,15.95%,1
新北市,汐止區,2400,281,573,854,32,886,1988,44.57%,14.13%,1
新北市,汐止區,2401,405,640,1045,45,1090,2198,49.59%,18.43%,1
新北市,汐止區,2402,277,548,825,44,869,1712,50.76%,16.18%,1
新北市,汐止區,2403,365,597,962,44,1006,1806,55.7%,20.21%,1
新北市,汐止區,2404,269,518,787,54,841,1576,53.36%,17.07%,1
新北市,汐止區,2405,246,516,762,29,791,1511,52.35%,16.28%,1
新北市,汐止區,2406,277,520,797,37,834,1691,49.32%,16.38%,1
新北市,汐止區,2407,280,559,839,32,871,1636,53.24%,17.11%,1
新北市,汐止區,2408,276,548,824,46,870,1676,51.91%,16.47%,1
新北市,汐止區,2409,218,413,631,29,660,1264,52.22%,17.25%,1
新北市,汐止區,2410,185,405,590,20,610,1165,52.36%,15.88%,1
新北市,汐止區,2411,279,577,856,41,897,1765,50.82%,15.81%,1
新北市,汐止區,2412,248,535,783,24,807,1815,44.46%,13.66%,1
新北市,汐止區,2413,297,522,819,67,886,1778,49.83%,16.7%,1
新北市,汐止區,2414,292,525,817,56,873,1580,55.25%,18.48%,1
新北市,汐止區,2415,290,469,759,50,809,1516,53.36%,19.13%,1
新北市,汐止區,2416,227,440,667,40,707,1425,49.61%,15.93%,1
新北市,汐止區,2417,246,476,722,39,761,1388,54.83%,17.72%,1
新北市,汐止區,2418,238,491,729,54,783,1436,54.53%,16.57%,1
新北市,汐止區,2419,320,482,802,36,838,1591,52.67%,20.11%,1
新北市,汐止區,2420,280,503,783,32,815,1639,49.73%,17.08%,1
新北市,汐止區,2421,265,421,686,19,705,1394,50.57%,19.01%,1
新北市,汐止區,2422,383,580,963,32,995,2035,48.89%,18.82%,1
新北市,汐止區,2423,323,618,941,46,987,1895,52.08%,17.04%,1
新北市,汐止區,2424,290,469,759,26,785,1374,57.13%,21.11%,1
新北市,汐止區,2425,258,350,608,18,626,1061,59%,24.32%,1
新北市,汐止區,2426,308,494,802,25,827,1312,63.03%,23.48%,1
新北市,汐止區,2427,294,531,825,29,854,1548,55.17%,18.99%,1
新北市,汐止區,2428,260,485,745,28,773,1350,57.26%,19.26%,1
新北市,汐止區,2429,287,497,784,31,815,1499,54.37%,19.15%,1
新北市,汐止區,2430,247,505,752,39,791,1366,57.91%,18.08%,1
新北市,汐止區,2431,258,457,715,50,765,1335,57.3%,19.33%,1
新北市,汐止區,2432,254,517,771,37,808,1324,61.03%,19.18%,1
新北市,汐止區,2433,275,458,733,52,785,1286,61.04%,21.38%,1
新北市,汐止區,2434,237,363,600,38,638,1155,55.24%,20.52%,1
新北市,汐止區,2435,423,600,1023,30,1053,1682,62.6%,25.15%,1
新北市,汐止區,2436,285,588,873,51,924,1494,61.85%,19.08%,1
新北市,汐止區,2437,208,441,649,55,704,1166,60.38%,17.84%,1
新北市,汐止區,2438,409,706,1115,96,1211,2184,55.45%,18.73%,1
新北市,汐止區,2439,346,697,1043,66,1109,2031,54.6%,17.04%,1
新北市,汐止區,2440,320,603,923,54,977,1759,55.54%,18.19%,1
新北市,汐止區,2441,334,525,859,42,901,1577,57.13%,21.18%,1
新北市,汐止區,2442,257,458,715,24,739,1364,54.18%,18.84%,1
新北市,汐止區,2443,270,510,780,40,820,1401,58.53%,19.27%,1
新北市,汐止區,2444,249,396,645,52,697,1173,59.42%,21.23%,1
新北市,汐止區,2445,164,365,529,21,550,993,55.39%,16.52%,1
新北市,汐止區,2446,267,550,817,26,843,1587,53.12%,16.82%,1
新北市,瑞芳區,2220,107,280,387,35,422,725,58.21%,14.76%,1
新北市,瑞芳區,2221,182,384,566,43,609,1074,56.7%,16.95%,1
新北市,瑞芳區,2222,115,289,404,24,428,825,51.88%,13.94%,1
新北市,瑞芳區,2223,216,407,623,75,698,1242,56.2%,17.39%,1
新北市,瑞芳區,2224,85,216,301,26,327,598,54.68%,14.21%,1
新北市,瑞芳區,2225,161,280,441,28,469,872,53.78%,18.46%,1
新北市,瑞芳區,2226,110,225,335,31,366,760,48.16%,14.47%,1
新北市,瑞芳區,2227,205,373,578,46,624,1330,46.92%,15.41%,1
新北市,瑞芳區,2228,245,497,742,45,787,1683,46.76%,14.56%,1
新北市,瑞芳區,2229,147,316,463,54,517,980,52.76%,15%,1
新北市,瑞芳區,2230,144,319,463,38,501,946,52.96%,15.22%,1
新北市,瑞芳區,2231,174,418,592,31,623,1375,45.31%,12.65%,1
新北市,瑞芳區,2232,237,547,784,42,826,1671,49.43%,14.18%,1
新北市,瑞芳區,2233,131,280,411,26,437,978,44.68%,13.39%,1
新北市,瑞芳區,2234,86,201,287,27,314,645,48.68%,13.33%,1
新北市,瑞芳區,2235,162,337,499,58,557,1089,51.15%,14.88%,1
新北市,瑞芳區,2236,42,65,107,17,124,286,43.36%,14.69%,1
新北市,瑞芳區,2237,64,157,221,25,246,461,53.36%,13.88%,1
新北市,瑞芳區,2238,37,81,118,19,137,274,50%,13.5%,1
新北市,瑞芳區,2239,30,56,86,9,95,155,61.29%,19.35%,1
新北市,瑞芳區,2240,153,272,425,28,453,817,55.45%,18.73%,1
新北市,瑞芳區,2241,152,262,414,57,471,884,53.28%,17.19%,1
新北市,瑞芳區,2242,195,370,565,56,621,1333,46.59%,14.63%,1
新北市,瑞芳區,2243,92,161,253,6,259,607,42.67%,15.16%,1
新北市,瑞芳區,2244,167,346,513,38,551,1045,52.73%,15.98%,1
新北市,瑞芳區,2245,118,217,335,33,368,673,54.68%,17.53%,1
新北市,瑞芳區,2246,72,157,229,10,239,618,38.67%,11.65%,1
新北市,瑞芳區,2247,154,313,467,29,496,1063,46.66%,14.49%,1
新北市,瑞芳區,2248,133,288,421,46,467,860,54.3%,15.47%,1
新北市,瑞芳區,2249,43,89,132,4,136,432,31.48%,9.95%,1
新北市,瑞芳區,2250,36,123,159,13,172,445,38.65%,8.09%,1
新北市,瑞芳區,2251,32,94,126,12,138,318,43.4%,10.06%,1
新北市,瑞芳區,2252,13,57,70,7,77,159,48.43%,8.18%,1
新北市,瑞芳區,2253,41,96,137,10,147,337,43.62%,12.17%,1
新北市,瑞芳區,2254,31,58,89,10,99,180,55%,17.22%,1
新北市,瑞芳區,2255,20,51,71,10,81,187,43.32%,10.7%,1
新北市,瑞芳區,2256,48,129,177,13,190,369,51.49%,13.01%,1
新北市,瑞芳區,2257,47,118,165,21,186,335,55.52%,14.03%,1
新北市,瑞芳區,2258,63,128,191,13,204,470,43.4%,13.4%,1
新北市,瑞芳區,2259,38,71,109,8,117,297,39.39%,12.79%,1
新北市,瑞芳區,2260,48,124,172,5,177,267,66.29%,17.98%,1
新北市,瑞芳區,2261,53,176,229,13,242,876,27.63%,6.05%,1
新北市,瑞芳區,2262,121,321,442,30,472,1241,38.03%,9.75%,1
新北市,瑞芳區,2263,134,339,473,60,533,998,53.41%,13.43%,1
新北市,瑞芳區,2264,122,327,449,53,502,948,52.95%,12.87%,1
新北市,瑞芳區,2265,131,346,477,33,510,1308,38.99%,10.02%,1
新北市,土城區,1775,251,497,748,58,806,1505,53.55%,16.68%,1
新北市,土城區,1776,260,459,719,29,748,1242,60.23%,20.93%,1
新北市,土城區,1777,229,466,695,21,716,1206,59.37%,18.99%,1
新北市,土城區,1778,260,490,750,60,810,1474,54.95%,17.64%,1
新北市,土城區,1779,235,494,729,42,771,1489,51.78%,15.78%,1
新北市,土城區,1780,254,554,808,49,857,1675,51.16%,15.16%,1
新北市,土城區,1781,269,510,779,44,823,1499,54.9%,17.95%,1
新北市,土城區,1782,224,514,738,30,768,1495,51.37%,14.98%,1
新北市,土城區,1783,278,481,759,61,820,1411,58.11%,19.7%,1
新北市,土城區,1784,257,414,671,39,710,1378,51.52%,18.65%,1
新北市,土城區,1785,236,401,637,31,668,1256,53.18%,18.79%,1
新北市,土城區,1786,259,483,742,49,791,1379,57.36%,18.78%,1
新北市,土城區,1787,218,480,698,42,740,1424,51.97%,15.31%,1
新北市,土城區,1788,232,505,737,48,785,1455,53.95%,15.95%,1
新北市,土城區,1789,244,474,718,21,739,1419,52.08%,17.2%,1
新北市,土城區,1790,286,494,780,33,813,1357,59.91%,21.08%,1
新北市,土城區,1791,275,482,757,42,799,1501,53.23%,18.32%,1
新北市,土城區,1792,233,410,643,51,694,1206,57.55%,19.32%,1
新北市,土城區,1793,268,435,703,27,730,1255,58.17%,21.35%,1
新北市,土城區,1794,312,603,915,53,968,1869,51.79%,16.69%,1
新北市,土城區,1795,237,451,688,24,712,1292,55.11%,18.34%,1
新北市,土城區,1796,227,422,649,27,676,1324,51.06%,17.15%,1
新北市,土城區,1797,185,389,574,41,615,1155,53.25%,16.02%,1
新北市,土城區,1798,209,405,614,40,654,1183,55.28%,17.67%,1
新北市,土城區,1799,183,329,512,33,545,2518,21.64%,7.27%,1
新北市,土城區,1800,213,420,633,32,665,1218,54.6%,17.49%,1
新北市,土城區,1801,201,399,600,47,647,1133,57.11%,17.74%,1
新北市,土城區,1802,167,315,482,26,508,894,56.82%,18.68%,1
新北市,土城區,1803,191,313,504,42,546,931,58.65%,20.52%,1
新北市,土城區,1804,337,775,1112,39,1151,1820,63.24%,18.52%,1
新北市,土城區,1805,216,466,682,32,714,1320,54.09%,16.36%,1
新北市,土城區,1806,232,397,629,31,660,1241,53.18%,18.69%,1
新北市,土城區,1807,270,474,744,34,778,1414,55.02%,19.09%,1
新北市,土城區,1808,277,465,742,44,786,1378,57.04%,20.1%,1
新北市,土城區,1809,286,497,783,48,831,1421,58.48%,20.13%,1
新北市,土城區,1810,210,475,685,46,731,1340,54.55%,15.67%,1
新北市,土城區,1811,239,408,647,32,679,1144,59.35%,20.89%,1
新北市,土城區,1812,235,438,673,50,723,1268,57.02%,18.53%,1
新北市,土城區,1813,198,441,639,53,692,1196,57.86%,16.56%,1
新北市,土城區,1814,277,477,754,25,779,1308,59.56%,21.18%,1
新北市,土城區,1815,216,421,637,38,675,1175,57.45%,18.38%,1
新北市,土城區,1816,212,444,656,46,702,1230,57.07%,17.24%,1
新北市,土城區,1817,265,456,721,48,769,1342,57.3%,19.75%,1
新北市,土城區,1818,243,460,703,42,745,1268,58.75%,19.16%,1
新北市,土城區,1819,238,494,732,51,783,1227,63.81%,19.4%,1
新北市,土城區,1820,229,481,710,69,779,1356,57.45%,16.89%,1
新北市,土城區,1821,262,528,790,47,837,1496,55.95%,17.51%,1
新北市,土城區,1822,231,458,689,56,745,1309,56.91%,17.65%,1
新北市,土城區,1823,246,409,655,49,704,1175,59.91%,20.94%,1
新北市,土城區,1824,227,432,659,45,704,1237,56.91%,18.35%,1
新北市,土城區,1825,217,460,677,44,721,1256,57.4%,17.28%,1
新北市,土城區,1826,235,416,651,19,670,1228,54.56%,19.14%,1
新北市,土城區,1827,230,379,609,60,669,1182,56.6%,19.46%,1
新北市,土城區,1828,299,522,821,37,858,1558,55.07%,19.19%,1
新北市,土城區,1829,236,395,631,33,664,1160,57.24%,20.34%,1
新北市,土城區,1830,272,441,713,47,760,1357,56.01%,20.04%,1
新北市,土城區,1831,287,447,734,69,803,1464,54.85%,19.6%,1
新北市,土城區,1832,228,432,660,42,702,1335,52.58%,17.08%,1
新北市,土城區,1833,248,449,697,57,754,1346,56.02%,18.42%,1
新北市,土城區,1834,321,511,832,37,869,1435,60.56%,22.37%,1
新北市,土城區,1835,314,548,862,40,902,1639,55.03%,19.16%,1
新北市,土城區,1836,378,568,946,42,988,1728,57.18%,21.88%,1
新北市,土城區,1837,279,455,734,27,761,1665,45.71%,16.76%,1
新北市,土城區,1838,269,485,754,61,815,1333,61.14%,20.18%,1
新北市,土城區,1839,309,561,870,37,907,1567,57.88%,19.72%,1
新北市,土城區,1840,292,523,815,54,869,1576,55.14%,18.53%,1
新北市,土城區,1841,282,502,784,49,833,1458,57.13%,19.34%,1
新北市,土城區,1842,275,527,802,67,869,1517,57.28%,18.13%,1
新北市,土城區,1843,281,570,851,26,877,1489,58.9%,18.87%,1
新北市,土城區,1844,349,496,845,23,868,1463,59.33%,23.86%,1
新北市,土城區,1845,307,563,870,20,890,1584,56.19%,19.38%,1
新北市,土城區,1846,280,479,759,44,803,1464,54.85%,19.13%,1
新北市,土城區,1847,322,523,845,53,898,1598,56.2%,20.15%,1
新北市,土城區,1848,309,432,741,64,805,1500,53.67%,20.6%,1
新北市,土城區,1849,289,514,803,38,841,1542,54.54%,18.74%,1
新北市,土城區,1850,346,577,923,43,966,1619,59.67%,21.37%,1
新北市,土城區,1851,269,500,769,24,793,1521,52.14%,17.69%,1
新北市,土城區,1852,373,527,900,21,921,1691,54.46%,22.06%,1
新北市,土城區,1853,323,519,842,41,883,1657,53.29%,19.49%,1
新北市,土城區,1854,408,591,999,33,1032,1772,58.24%,23.02%,1
新北市,土城區,1855,276,521,797,14,811,1423,56.99%,19.4%,1
新北市,土城區,1856,288,488,776,44,820,1321,62.07%,21.8%,1
新北市,土城區,1857,313,517,830,43,873,1429,61.09%,21.9%,1
新北市,土城區,1858,247,497,744,34,778,1445,53.84%,17.09%,1
新北市,土城區,1859,279,562,841,43,884,1520,58.16%,18.36%,1
新北市,土城區,1860,242,448,690,12,702,1484,47.3%,16.31%,1
新北市,土城區,1861,262,441,703,24,727,1362,53.38%,19.24%,1
新北市,土城區,1862,218,440,658,31,689,1262,54.6%,17.27%,1
新北市,土城區,1863,271,458,729,42,771,1343,57.41%,20.18%,1
新北市,土城區,1864,238,388,626,29,655,1337,48.99%,17.8%,1
新北市,土城區,1865,194,360,554,36,590,1325,44.53%,14.64%,1
新北市,土城區,1866,247,422,669,39,708,1390,50.94%,17.77%,1
新北市,土城區,1867,288,501,789,42,831,1534,54.17%,18.77%,1
新北市,土城區,1868,252,470,722,66,788,1484,53.1%,16.98%,1
新北市,土城區,1869,255,494,749,46,795,1532,51.89%,16.64%,1
新北市,土城區,1870,272,532,804,45,849,1507,56.34%,18.05%,1
新北市,土城區,1871,294,537,831,42,873,1550,56.32%,18.97%,1
新北市,土城區,1872,262,551,813,44,857,1567,54.69%,16.72%,1
新北市,土城區,1873,260,487,747,41,788,1367,57.64%,19.02%,1
新北市,土城區,1874,215,434,649,45,694,1293,53.67%,16.63%,1
新北市,土城區,1875,248,490,738,51,789,1402,56.28%,17.69%,1
新北市,土城區,1876,268,459,727,37,764,1379,55.4%,19.43%,1
新北市,土城區,1877,257,473,730,42,772,1471,52.48%,17.47%,1
新北市,土城區,1878,248,475,723,34,757,1410,53.69%,17.59%,1
新北市,土城區,1879,279,523,802,33,835,1542,54.15%,18.09%,1
新北市,土城區,1880,219,422,641,42,683,1238,55.17%,17.69%,1
新北市,土城區,1881,227,427,654,36,690,1301,53.04%,17.45%,1
新北市,土城區,1882,287,532,819,22,841,1311,64.15%,21.89%,1
新北市,土城區,1883,223,484,707,32,739,1511,48.91%,14.76%,1
新北市,土城區,1884,248,519,767,47,814,1531,53.17%,16.2%,1
新北市,土城區,1885,311,490,801,55,856,1638,52.26%,18.99%,1
新北市,土城區,1886,240,516,756,34,790,1335,59.18%,17.98%,1
新北市,土城區,1887,253,512,765,41,806,1459,55.24%,17.34%,1
新北市,土城區,1888,294,483,777,23,800,1489,53.73%,19.74%,1
新北市,土城區,1889,407,523,930,71,1001,1774,56.43%,22.94%,1
新北市,土城區,1890,321,627,948,34,982,1792,54.8%,17.91%,1
新北市,土城區,1891,284,658,942,12,954,1798,53.06%,15.8%,1
新北市,土城區,1892,223,428,651,57,708,1312,53.96%,17%,1
新北市,土城區,1893,217,419,636,44,680,1301,52.27%,16.68%,1
新北市,土城區,1894,222,403,625,40,665,1254,53.03%,17.7%,1
新北市,土城區,1895,235,394,629,34,663,1215,54.57%,19.34%,1
新北市,土城區,1896,212,508,720,32,752,1448,51.93%,14.64%,1
新北市,土城區,1897,209,444,653,54,707,1321,53.52%,15.82%,1
新北市,土城區,1898,206,332,538,62,600,1150,52.17%,17.91%,1
新北市,土城區,1899,270,396,666,40,706,1425,49.54%,18.95%,1
新北市,土城區,1900,238,518,756,57,813,1366,59.52%,17.42%,1
新北市,土城區,1901,251,465,716,42,758,1292,58.67%,19.43%,1
新北市,土城區,1902,205,470,675,45,720,1317,54.67%,15.57%,1
新北市,土城區,1903,246,468,714,39,753,1324,56.87%,18.58%,1
新北市,土城區,1904,215,396,611,37,648,1189,54.5%,18.08%,1
新北市,土城區,1905,240,427,667,46,713,1223,58.3%,19.62%,1
新北市,土城區,1906,270,511,781,53,834,1550,53.81%,17.42%,1
新北市,土城區,1907,326,529,855,66,921,1606,57.35%,20.3%,1
新北市,土城區,1908,280,514,794,39,833,1509,55.2%,18.56%,1
新北市,土城區,1909,272,510,782,46,828,1529,54.15%,17.79%,1
新北市,土城區,1910,222,492,714,55,769,1458,52.74%,15.23%,1
新北市,土城區,1911,294,488,782,53,835,1468,56.88%,20.03%,1
新北市,土城區,1912,291,471,762,43,805,1495,53.85%,19.46%,1
新北市,土城區,1913,225,443,668,75,743,1303,57.02%,17.27%,1
新北市,土城區,1914,266,472,738,32,770,1365,56.41%,19.49%,1
新北市,土城區,1915,267,489,756,64,820,1476,55.56%,18.09%,1
新北市,土城區,1916,292,521,813,30,843,1519,55.5%,19.22%,1
新北市,蘆洲區,0555,323,526,849,74,923,1600,57.69%,20.19%,1
新北市,蘆洲區,0556,279,526,805,56,861,1549,55.58%,18.01%,1
新北市,蘆洲區,0557,297,529,826,66,892,1516,58.84%,19.59%,1
新北市,蘆洲區,0558,243,480,723,52,775,1404,55.2%,17.31%,1
新北市,蘆洲區,0559,233,459,692,65,757,1381,54.82%,16.87%,1
新北市,蘆洲區,0560,286,525,811,30,841,1485,56.63%,19.26%,1
新北市,蘆洲區,0561,213,430,643,43,686,1779,38.56%,11.97%,1
新北市,蘆洲區,0562,216,699,915,50,965,1797,53.7%,12.02%,1
新北市,蘆洲區,0563,251,487,738,50,788,1364,57.77%,18.4%,1
新北市,蘆洲區,0564,306,563,869,57,926,1635,56.64%,18.72%,1
新北市,蘆洲區,0565,234,490,724,32,756,1567,48.25%,14.93%,1
新北市,蘆洲區,0566,267,505,772,41,813,1524,53.35%,17.52%,1
新北市,蘆洲區,0567,275,503,778,58,836,1612,51.86%,17.06%,1
新北市,蘆洲區,0568,289,556,845,32,877,1674,52.39%,17.26%,1
新北市,蘆洲區,0569,311,559,870,45,915,1838,49.78%,16.92%,1
新北市,蘆洲區,0570,274,524,798,31,829,1814,45.7%,15.1%,1
新北市,蘆洲區,0571,300,489,789,40,829,1473,56.28%,20.37%,1
新北市,蘆洲區,0572,372,382,754,43,797,1465,54.4%,25.39%,1
新北市,蘆洲區,0573,324,540,864,50,914,1652,55.33%,19.61%,1
新北市,蘆洲區,0574,330,518,848,64,912,1650,55.27%,20%,1
新北市,蘆洲區,0575,279,590,869,47,916,1656,55.31%,16.85%,1
新北市,蘆洲區,0576,282,498,780,45,825,1571,52.51%,17.95%,1
新北市,蘆洲區,0577,295,471,766,50,816,1523,53.58%,19.37%,1
新北市,蘆洲區,0578,288,474,762,38,800,1475,54.24%,19.53%,1
新北市,蘆洲區,0579,252,432,684,42,726,1367,53.11%,18.43%,1
新北市,蘆洲區,0580,279,538,817,44,861,1514,56.87%,18.43%,1
新北市,蘆洲區,0581,380,646,1026,33,1059,1791,59.13%,21.22%,1
新北市,蘆洲區,0582,374,632,1006,39,1045,1714,60.97%,21.82%,1
新北市,蘆洲區,0583,376,613,989,28,1017,1780,57.13%,21.12%,1
新北市,蘆洲區,0584,331,601,932,29,961,1713,56.1%,19.32%,1
新北市,蘆洲區,0585,321,637,958,32,990,1720,57.56%,18.66%,1
新北市,蘆洲區,0586,327,615,942,41,983,1766,55.66%,18.52%,1
新北市,蘆洲區,0587,272,566,838,49,887,1623,54.65%,16.76%,1
新北市,蘆洲區,0588,392,572,964,31,995,1740,57.18%,22.53%,1
新北市,蘆洲區,0589,344,616,960,60,1020,1759,57.99%,19.56%,1
新北市,蘆洲區,0590,365,597,962,64,1026,1775,57.8%,20.56%,1
新北市,蘆洲區,0591,378,668,1046,42,1088,1909,56.99%,19.8%,1
新北市,蘆洲區,0592,364,615,979,71,1050,1805,58.17%,20.17%,1
新北市,蘆洲區,0593,309,525,834,40,874,1642,53.23%,18.82%,1
新北市,蘆洲區,0594,329,543,872,59,931,1713,54.35%,19.21%,1
新北市,蘆洲區,0595,317,518,835,57,892,1746,51.09%,18.16%,1
新北市,蘆洲區,0596,307,521,828,49,877,1596,54.95%,19.24%,1
新北市,蘆洲區,0597,244,472,716,47,763,1434,53.21%,17.02%,1
新北市,蘆洲區,0598,289,476,765,45,810,1450,55.86%,19.93%,1
新北市,蘆洲區,0599,296,469,765,15,780,1543,50.55%,19.18%,1
新北市,蘆洲區,0600,287,485,772,44,816,1525,53.51%,18.82%,1
新北市,蘆洲區,0601,257,424,681,54,735,1419,51.8%,18.11%,1
新北市,蘆洲區,0602,262,443,705,35,740,1298,57.01%,20.18%,1
新北市,蘆洲區,0603,229,434,663,45,708,1304,54.29%,17.56%,1
新北市,蘆洲區,0604,324,596,920,41,961,1806,53.21%,17.94%,1
新北市,蘆洲區,0605,334,598,932,64,996,1910,52.15%,17.49%,1
新北市,蘆洲區,0606,282,533,815,52,867,1873,46.29%,15.06%,1
新北市,蘆洲區,0607,297,533,830,44,874,1785,48.96%,16.64%,1
新北市,蘆洲區,0608,273,559,832,56,888,1760,50.45%,15.51%,1
新北市,蘆洲區,0609,333,643,976,36,1012,1841,54.97%,18.09%,1
新北市,蘆洲區,0610,318,579,897,37,934,1855,50.35%,17.14%,1
新北市,蘆洲區,0611,249,426,675,55,730,1450,50.34%,17.17%,1
新北市,蘆洲區,0612,275,497,772,58,830,1585,52.37%,17.35%,1
新北市,蘆洲區,0613,245,462,707,83,790,1541,51.27%,15.9%,1
新北市,蘆洲區,0614,294,524,818,54,872,1626,53.63%,18.08%,1
新北市,蘆洲區,0615,253,414,667,51,718,1241,57.86%,20.39%,1
新北市,蘆洲區,0616,289,558,847,42,889,1634,54.41%,17.69%,1
新北市,蘆洲區,0617,284,536,820,51,871,1573,55.37%,18.05%,1
新北市,蘆洲區,0618,297,577,874,40,914,1619,56.45%,18.34%,1
新北市,蘆洲區,0619,334,597,931,82,1013,1878,53.94%,17.78%,1
新北市,蘆洲區,0620,287,605,892,67,959,1797,53.37%,15.97%,1
新北市,蘆洲區,0621,359,621,980,42,1022,1816,56.28%,19.77%,1
新北市,蘆洲區,0622,244,482,726,67,793,1344,59%,18.15%,1
新北市,蘆洲區,0623,290,531,821,58,879,1492,58.91%,19.44%,1
新北市,蘆洲區,0624,318,644,962,92,1054,1959,53.8%,16.23%,1
新北市,蘆洲區,0625,280,530,810,74,884,1611,54.87%,17.38%,1
新北市,蘆洲區,0626,323,575,898,45,943,1574,59.91%,20.52%,1
新北市,蘆洲區,0627,313,564,877,52,929,1653,56.2%,18.94%,1
新北市,蘆洲區,0628,357,656,1013,47,1060,3085,34.36%,11.57%,1
新北市,蘆洲區,0629,337,577,914,58,972,1812,53.64%,18.6%,1
新北市,蘆洲區,0630,263,419,682,54,736,1332,55.26%,19.74%,1
新北市,蘆洲區,0631,297,481,778,66,844,1648,51.21%,18.02%,1
新北市,蘆洲區,0632,245,444,689,32,721,1355,53.21%,18.08%,1
新北市,蘆洲區,0633,235,456,691,35,726,1371,52.95%,17.14%,1
新北市,蘆洲區,0634,233,348,581,61,642,1111,57.79%,20.97%,1
新北市,蘆洲區,0635,197,443,640,59,699,1176,59.44%,16.75%,1
新北市,蘆洲區,0636,331,527,858,46,904,1602,56.43%,20.66%,1
新北市,蘆洲區,0637,223,420,643,48,691,1361,50.77%,16.39%,1
新北市,蘆洲區,0638,251,523,774,61,835,1530,54.58%,16.41%,1
新北市,蘆洲區,0639,150,311,461,66,527,925,56.97%,16.22%,1
新北市,蘆洲區,0640,328,637,965,55,1020,1851,55.11%,17.72%,1
新北市,蘆洲區,0641,284,557,841,41,882,1791,49.25%,15.86%,1
新北市,蘆洲區,0642,332,532,864,58,922,1853,49.76%,17.92%,1
新北市,蘆洲區,0643,288,536,824,38,862,1758,49.03%,16.38%,1
新北市,蘆洲區,0644,344,572,916,52,968,1798,53.84%,19.13%,1
新北市,蘆洲區,0645,324,528,852,56,908,1645,55.2%,19.7%,1
新北市,蘆洲區,0646,271,469,740,52,792,1612,49.13%,16.81%,1
新北市,蘆洲區,0647,320,501,821,44,865,1784,48.49%,17.94%,1
新北市,蘆洲區,0648,260,476,736,56,792,1701,46.56%,15.29%,1
新北市,蘆洲區,0649,351,430,781,30,811,1581,51.3%,22.2%,1
新北市,蘆洲區,0650,318,481,799,47,846,1534,55.15%,20.73%,1
新北市,蘆洲區,0651,326,554,880,49,929,1620,57.35%,20.12%,1
新北市,蘆洲區,0652,295,542,837,52,889,1494,59.5%,19.75%,1
新北市,蘆洲區,0653,251,379,630,29,659,1183,55.71%,21.22%,1
新北市,蘆洲區,0654,212,327,539,32,571,985,57.97%,21.52%,1
新北市,蘆洲區,0655,295,516,811,65,876,1673,52.36%,17.63%,1
新北市,蘆洲區,0656,324,555,879,67,946,1688,56.04%,19.19%,1
新北市,蘆洲區,0657,216,427,643,39,682,1249,54.6%,17.29%,1
新北市,蘆洲區,0658,257,486,743,54,797,1476,54%,17.41%,1
新北市,五股區,0207,269,459,728,74,802,1456,55.08%,18.48%,1
新北市,五股區,0208,258,484,742,44,786,1482,53.04%,17.41%,1
新北市,五股區,0209,249,439,688,37,725,1287,56.33%,19.35%,1
新北市,五股區,0210,210,332,542,33,575,1106,51.99%,18.99%,1
新北市,五股區,0211,202,417,619,63,682,1283,53.16%,15.74%,1
新北市,五股區,0212,319,595,914,46,960,1833,52.37%,17.4%,1
新北市,五股區,0213,229,389,618,38,656,1141,57.49%,20.07%,1
新北市,五股區,0214,73,173,246,38,284,463,61.34%,15.77%,1
新北市,五股區,0215,291,632,923,50,973,1786,54.48%,16.29%,1
新北市,五股區,0216,304,520,824,41,865,1660,52.11%,18.31%,1
新北市,五股區,0217,294,479,773,70,843,1534,54.95%,19.17%,1
新北市,五股區,0218,224,454,678,57,735,1285,57.2%,17.43%,1
新北市,五股區,0219,314,569,883,83,966,1832,52.73%,17.14%,1
新北市,五股區,0220,280,513,793,28,821,1542,53.24%,18.16%,1
新北市,五股區,0221,287,564,851,45,896,1897,47.23%,15.13%,1
新北市,五股區,0222,308,565,873,89,962,1964,48.98%,15.68%,1
新北市,五股區,0223,284,545,829,56,885,1779,49.75%,15.96%,1
新北市,五股區,0224,288,549,837,64,901,1735,51.93%,16.6%,1
新北市,五股區,0225,420,683,1103,31,1134,2299,49.33%,18.27%,1
新北市,五股區,0226,256,547,803,52,855,1755,48.72%,14.59%,1
新北市,五股區,0227,281,589,870,56,926,1674,55.32%,16.79%,1
新北市,五股區,0228,263,584,847,71,918,1661,55.27%,15.83%,1
新北市,五股區,0229,238,349,587,33,620,1281,48.4%,18.58%,1
新北市,五股區,0230,245,549,794,54,848,1566,54.15%,15.64%,1
新北市,五股區,0231,219,509,728,33,761,1560,48.78%,14.04%,1
新北市,五股區,0232,284,559,843,33,876,1622,54.01%,17.51%,1
新北市,五股區,0233,306,616,922,38,960,1779,53.96%,17.2%,1
新北市,五股區,0234,241,475,716,61,777,1487,52.25%,16.21%,1
新北市,五股區,0235,295,513,808,50,858,1567,54.75%,18.83%,1
新北市,五股區,0236,198,300,498,34,532,1333,39.91%,14.85%,1
新北市,五股區,0237,285,427,712,48,760,1263,60.17%,22.57%,1
新北市,五股區,0238,382,458,840,61,901,1314,68.57%,29.07%,1
新北市,五股區,0239,269,486,755,32,787,1513,52.02%,17.78%,1
新北市,五股區,0240,259,569,828,32,860,1517,56.69%,17.07%,1
新北市,五股區,0241,285,523,808,65,873,1613,54.12%,17.67%,1
新北市,五股區,0242,254,564,818,56,874,1616,54.08%,15.72%,1
新北市,五股區,0243,304,515,819,48,867,1616,53.65%,18.81%,1
新北市,五股區,0244,292,575,867,52,919,1689,54.41%,17.29%,1
新北市,五股區,0245,371,581,952,28,980,1894,51.74%,19.59%,1
新北市,五股區,0246,237,473,710,53,763,1210,63.06%,19.59%,1
新北市,五股區,0247,271,540,811,32,843,1643,51.31%,16.49%,1
新北市,五股區,0248,247,488,735,27,762,1441,52.88%,17.14%,1
新北市,五股區,0249,234,489,723,32,755,1305,57.85%,17.93%,1
新北市,五股區,0250,222,455,677,42,719,1170,61.45%,18.97%,1
新北市,五股區,0251,209,585,794,59,853,1397,61.06%,14.96%,1
新北市,五股區,0252,212,555,767,43,810,1312,61.74%,16.16%,1
新北市,五股區,0253,146,403,549,22,571,1127,50.67%,12.95%,1
新北市,五股區,0254,155,414,569,33,602,1154,52.17%,13.43%,1
新北市,泰山區,0255,97,208,305,21,326,643,50.7%,15.09%,1
新北市,泰山區,0256,43,68,111,5,116,186,62.37%,23.12%,1
新北市,泰山區,0257,223,494,717,30,747,1457,51.27%,15.31%,1
新北市,泰山區,0258,277,558,835,56,891,1594,55.9%,17.38%,1
新北市,泰山區,0259,218,547,765,41,806,1598,50.44%,13.64%,1
新北市,泰山區,0260,273,468,741,26,767,1503,51.03%,18.16%,1
新北市,泰山區,0261,231,455,686,63,749,1436,52.16%,16.09%,1
新北市,泰山區,0262,232,498,730,39,769,1384,55.56%,16.76%,1
新北市,泰山區,0263,209,455,664,38,702,1231,57.03%,16.98%,1
新北市,泰山區,0264,213,438,651,33,684,1295,52.82%,16.45%,1
新北市,泰山區,0265,314,538,852,48,900,1563,57.58%,20.09%,1
新北市,泰山區,0266,282,599,881,54,935,1610,58.07%,17.52%,1
新北市,泰山區,0267,231,416,647,29,676,1253,53.95%,18.44%,1
新北市,泰山區,0268,184,452,636,30,666,1294,51.47%,14.22%,1
新北市,泰山區,0269,266,474,740,50,790,1354,58.35%,19.65%,1
新北市,泰山區,0270,223,442,665,25,690,1259,54.81%,17.71%,1
新北市,泰山區,0271,254,439,693,26,719,1252,57.43%,20.29%,1
新北市,泰山區,0272,185,372,557,32,589,1094,53.84%,16.91%,1
新北市,泰山區,0273,295,560,855,37,892,1590,56.1%,18.55%,1
新北市,泰山區,0274,274,572,846,67,913,1634,55.88%,16.77%,1
新北市,泰山區,0275,246,448,694,35,729,1536,47.46%,16.02%,1
新北市,泰山區,0276,308,550,858,30,888,1534,57.89%,20.08%,1
新北市,泰山區,0277,257,653,910,40,950,1545,61.49%,16.63%,1
新北市,泰山區,0278,246,501,747,37,784,1399,56.04%,17.58%,1
新北市,泰山區,0279,238,452,690,20,710,1315,53.99%,18.1%,1
新北市,泰山區,0280,274,418,692,42,734,1201,61.12%,22.81%,1
新北市,泰山區,0281,232,386,618,45,663,1182,56.09%,19.63%,1
新北市,泰山區,0282,284,540,824,57,881,1665,52.91%,17.06%,1
新北市,泰山區,0283,305,653,958,52,1010,1855,54.45%,16.44%,1
新北市,泰山區,0284,329,620,949,81,1030,1866,55.2%,17.63%,1
新北市,泰山區,0285,364,619,983,52,1035,1935,53.49%,18.81%,1
新北市,泰山區,0286,283,502,785,34,819,1589,51.54%,17.81%,1
新北市,泰山區,0287,196,389,585,31,616,1152,53.47%,17.01%,1
新北市,泰山區,0288,234,367,601,23,624,1114,56.01%,21.01%,1
新北市,泰山區,0289,200,415,615,34,649,1040,62.4%,19.23%,1
新北市,泰山區,0290,208,359,567,38,605,1003,60.32%,20.74%,1
新北市,泰山區,0291,222,356,578,21,599,975,61.44%,22.77%,1
新北市,泰山區,0292,239,503,742,44,786,1440,54.58%,16.6%,1
新北市,泰山區,0293,260,488,748,37,785,1480,53.04%,17.57%,1
新北市,泰山區,0294,227,432,659,29,688,1211,56.81%,18.74%,1
新北市,泰山區,0295,233,457,690,23,713,1237,57.64%,18.84%,1
新北市,泰山區,0296,184,381,565,25,590,1069,55.19%,17.21%,1
新北市,泰山區,0297,317,622,939,50,989,1680,58.87%,18.87%,1
新北市,泰山區,0298,307,602,909,30,939,1651,56.87%,18.59%,1
新北市,泰山區,0299,232,481,713,34,747,1420,52.61%,16.34%,1
新北市,泰山區,0300,259,473,732,51,783,1337,58.56%,19.37%,1
新北市,泰山區,0301,275,594,869,44,913,1591,57.39%,17.28%,1
新北市,林口區,0145,195,445,640,43,683,1268,53.86%,15.38%,1
新北市,林口區,0146,209,363,572,35,607,1171,51.84%,17.85%,1
新北市,林口區,0147,223,425,648,52,700,1218,57.47%,18.31%,1
新北市,林口區,0148,323,556,879,41,920,1788,51.45%,18.06%,1
新北市,林口區,0149,279,485,764,56,820,1625,50.46%,17.17%,1
新北市,林口區,0150,256,448,704,55,759,1448,52.42%,17.68%,1
新北市,林口區,0151,198,422,620,65,685,1328,51.58%,14.91%,1
新北市,林口區,0152,224,431,655,51,706,1523,46.36%,14.71%,1
新北市,林口區,0153,218,429,647,36,683,1245,54.86%,17.51%,1
新北市,林口區,0154,261,536,797,29,826,1329,62.15%,19.64%,1
新北市,林口區,0155,303,514,817,39,856,1465,58.43%,20.68%,1
新北市,林口區,0156,289,499,788,24,812,1369,59.31%,21.11%,1
新北市,林口區,0157,264,491,755,35,790,1346,58.69%,19.61%,1
新北市,林口區,0158,203,389,592,57,649,1181,54.95%,17.19%,1
新北市,林口區,0159,261,514,775,26,801,1291,62.04%,20.22%,1
新北市,林口區,0160,209,420,629,44,673,1213,55.48%,17.23%,1
新北市,林口區,0161,231,473,704,30,734,1256,58.44%,18.39%,1
新北市,林口區,0162,200,409,609,38,647,1185,54.6%,16.88%,1
新北市,林口區,0163,218,493,711,47,758,1361,55.69%,16.02%,1
新北市,林口區,0164,290,590,880,21,901,1756,51.31%,16.51%,1
新北市,林口區,0165,274,570,844,23,867,1676,51.73%,16.35%,1
新北市,林口區,0166,290,562,852,17,869,1540,56.43%,18.83%,1
新北市,林口區,0167,290,530,820,30,850,1569,54.17%,18.48%,1
新北市,林口區,0168,303,510,813,24,837,1514,55.28%,20.01%,1
新北市,林口區,0169,268,405,673,20,693,1193,58.09%,22.46%,1
新北市,林口區,0170,308,581,889,23,912,1610,56.65%,19.13%,1
新北市,林口區,0171,287,456,743,34,777,1338,58.07%,21.45%,1
新北市,林口區,0172,201,416,617,31,648,1141,56.79%,17.62%,1
新北市,林口區,0173,271,443,714,27,741,1307,56.69%,20.73%,1
新北市,林口區,0174,256,475,731,32,763,1327,57.5%,19.29%,1
新北市,林口區,0175,273,445,718,28,746,1285,58.05%,21.25%,1
新北市,林口區,0176,275,529,804,34,838,1481,56.58%,18.57%,1
新北市,林口區,0177,334,516,850,16,866,1510,57.35%,22.12%,1
新北市,林口區,0178,339,574,913,41,954,1785,53.45%,18.99%,1
新北市,林口區,0179,342,603,945,25,970,1792,54.13%,19.08%,1
新北市,林口區,0180,315,526,841,17,858,1517,56.56%,20.76%,1
新北市,林口區,0181,311,557,868,29,897,1564,57.35%,19.88%,1
新北市,林口區,0182,290,582,872,22,894,1560,57.31%,18.59%,1
新北市,林口區,0183,326,483,809,30,839,1544,54.34%,21.11%,1
新北市,林口區,0184,308,528,836,26,862,1593,54.11%,19.33%,1
新北市,林口區,0185,300,478,778,25,803,1431,56.11%,20.96%,1
新北市,林口區,0186,320,492,812,28,840,1571,53.47%,20.37%,1
新北市,林口區,0187,314,486,800,30,830,1439,57.68%,21.82%,1
新北市,林口區,0188,305,506,811,33,844,1451,58.17%,21.02%,1
新北市,林口區,0189,315,491,806,35,841,1391,60.46%,22.65%,1
新北市,林口區,0190,273,502,775,38,813,1461,55.65%,18.69%,1
新北市,林口區,0191,338,560,898,18,916,1691,54.17%,19.99%,1
新北市,林口區,0192,297,503,800,46,846,1524,55.51%,19.49%,1
新北市,林口區,0193,271,532,803,36,839,1343,62.47%,20.18%,1
新北市,林口區,0194,303,514,817,23,840,1398,60.09%,21.67%,1
新北市,林口區,0195,270,525,795,25,820,1380,59.42%,19.57%,1
新北市,林口區,0196,242,481,723,45,768,1367,56.18%,17.7%,1
新北市,林口區,0197,256,482,738,41,779,1350,57.7%,18.96%,1
新北市,林口區,0198,238,421,659,44,703,1194,58.88%,19.93%,1
新北市,林口區,0199,226,460,686,51,737,1344,54.84%,16.82%,1
新北市,林口區,0200,214,408,622,31,653,1154,56.59%,18.54%,1
新北市,林口區,0201,241,429,670,27,697,1119,62.29%,21.54%,1
新北市,林口區,0202,142,317,459,45,504,1026,49.12%,13.84%,1
新北市,林口區,0203,214,405,619,58,677,1210,55.95%,17.69%,1
新北市,林口區,0204,159,290,449,68,517,912,56.69%,17.43%,1
新北市,林口區,0205,173,277,450,34,484,824,58.74%,21%,1
新北市,林口區,0206,261,496,757,74,831,1411,58.89%,18.5%,1
新北市,深坑區,2163,209,364,573,29,602,1142,52.71%,18.3%,1
新北市,深坑區,2164,196,432,628,42,670,1139,58.82%,17.21%,1
新北市,深坑區,2165,180,351,531,45,576,1065,54.08%,16.9%,1
新北市,深坑區,2166,231,444,675,40,715,1400,51.07%,16.5%,1
新北市,深坑區,2167,232,415,647,44,691,1330,51.95%,17.44%,1
新北市,深坑區,2168,236,435,671,26,697,1380,50.51%,17.1%,1
新北市,深坑區,2169,261,426,687,15,702,1496,46.93%,17.45%,1
新北市,深坑區,2170,288,529,817,50,867,1508,57.49%,19.1%,1
新北市,深坑區,2171,322,564,886,43,929,1624,57.2%,19.83%,1
新北市,深坑區,2172,382,742,1124,44,1168,2165,53.95%,17.64%,1
新北市,深坑區,2173,355,651,1006,53,1059,1790,59.16%,19.83%,1
新北市,深坑區,2174,137,243,380,23,403,782,51.53%,17.52%,1
新北市,深坑區,2175,241,412,653,29,682,1164,58.59%,20.7%,1
新北市,深坑區,2176,260,488,748,53,801,1344,59.6%,19.35%,1
新北市,深坑區,2177,148,279,427,28,455,739,61.57%,20.03%,1
新北市,深坑區,2178,101,216,317,23,340,556,61.15%,18.17%,1
新北市,石碇區,2179,79,145,224,20,244,391,62.4%,20.2%,1
新北市,石碇區,2180,106,258,364,40,404,789,51.2%,13.43%,1
新北市,石碇區,2181,76,176,252,26,278,662,41.99%,11.48%,1
新北市,石碇區,2182,39,110,149,12,161,310,51.94%,12.58%,1
新北市,石碇區,2183,33,100,133,15,148,280,52.86%,11.79%,1
新北市,石碇區,2184,10,23,33,5,38,93,40.86%,10.75%,1
新北市,石碇區,2185,94,174,268,35,303,683,44.36%,13.76%,1
新北市,石碇區,2186,63,127,190,17,207,323,64.09%,19.5%,1
新北市,石碇區,2187,92,178,270,16,286,726,39.39%,12.67%,1
新北市,石碇區,2188,82,217,299,17,316,591,53.47%,13.87%,1
新北市,石碇區,2189,55,109,164,26,190,282,67.38%,19.5%,1
新北市,石碇區,2190,104,218,322,17,339,788,43.02%,13.2%,1
新北市,石碇區,2191,182,320,502,54,556,943,58.96%,19.3%,1
新北市,坪林區,2192,201,432,633,44,677,1248,54.25%,16.11%,1
新北市,坪林區,2193,81,171,252,40,292,612,47.71%,13.24%,1
新北市,坪林區,2194,146,438,584,71,655,1141,57.41%,12.8%,1
新北市,坪林區,2195,66,100,166,9,175,417,41.97%,15.83%,1
新北市,坪林區,2196,95,204,299,33,332,595,55.8%,15.97%,1
新北市,坪林區,2197,38,92,130,25,155,248,62.5%,15.32%,1
新北市,坪林區,2198,51,101,152,16,168,338,49.7%,15.09%,1
新北市,坪林區,2199,58,126,184,24,208,478,43.51%,12.13%,1
新北市,坪林區,2200,50,101,151,9,160,390,41.03%,12.82%,1
新北市,坪林區,2201,42,139,181,22,203,424,47.88%,9.91%,1
新北市,三芝區,0011,46,90,136,12,148,312,47.44%,14.74%,1
新北市,三芝區,0012,239,429,668,32,700,1421,49.26%,16.82%,1
新北市,三芝區,0013,268,487,755,50,805,1557,51.7%,17.21%,1
新北市,三芝區,0014,310,561,871,64,935,1828,51.15%,16.96%,1
新北市,三芝區,0015,172,329,501,42,543,1060,51.23%,16.23%,1
新北市,三芝區,0016,110,206,316,40,356,819,43.47%,13.43%,1
新北市,三芝區,0017,214,469,683,36,719,1701,42.27%,12.58%,1
新北市,三芝區,0018,281,505,786,53,839,1740,48.22%,16.15%,1
新北市,三芝區,0019,214,426,640,47,687,1451,47.35%,14.75%,1
新北市,三芝區,0020,161,374,535,40,575,1248,46.07%,12.9%,1
新北市,三芝區,0021,100,221,321,13,334,629,53.1%,15.9%,1
新北市,三芝區,0022,55,160,215,19,234,504,46.43%,10.91%,1
新北市,三芝區,0023,95,200,295,23,318,698,45.56%,13.61%,1
新北市,三芝區,0024,307,621,928,46,974,2069,47.08%,14.84%,1
新北市,三芝區,0025,140,247,387,30,417,784,53.19%,17.86%,1
新北市,三芝區,0026,70,167,237,29,266,522,50.96%,13.41%,1
新北市,三芝區,0027,90,174,264,44,308,587,52.47%,15.33%,1
新北市,三芝區,0028,201,360,561,51,612,1189,51.47%,16.9%,1
新北市,石門區,0001,197,333,530,51,581,1121,51.83%,17.57%,1
新北市,石門區,0002,195,317,512,161,673,1389,48.45%,14.04%,1
新北市,石門區,0003,128,319,447,46,493,933,52.84%,13.72%,1
新北市,石門區,0004,182,378,560,59,619,1244,49.76%,14.63%,1
新北市,石門區,0005,122,303,425,60,485,883,54.93%,13.82%,1
新北市,石門區,0006,240,555,795,46,841,1564,53.77%,15.35%,1
新北市,石門區,0007,229,518,747,50,797,1500,53.13%,15.27%,1
新北市,石門區,0008,34,102,136,15,151,328,46.04%,10.37%,1
新北市,石門區,0009,116,258,374,31,405,651,62.21%,17.82%,1
新北市,石門區,0010,92,269,361,51,412,915,45.03%,10.05%,1
新北市,八里區,0125,243,454,697,46,743,1498,49.6%,16.22%,1
新北市,八里區,0126,330,535,865,34,899,1939,46.36%,17.02%,1
新北市,八里區,0127,237,521,758,55,813,1516,53.63%,15.63%,1
新北市,八里區,0128,304,579,883,55,938,1642,57.13%,18.51%,1
新北市,八里區,0129,326,549,875,67,942,1927,48.88%,16.92%,1
新北市,八里區,0130,222,435,657,36,693,1276,54.31%,17.4%,1
新北市,八里區,0131,263,487,750,39,789,1349,58.49%,19.5%,1
新北市,八里區,0132,248,492,740,46,786,1403,56.02%,17.68%,1
新北市,八里區,0133,270,575,845,44,889,1644,54.08%,16.42%,1
新北市,八里區,0134,299,635,934,61,995,1853,53.7%,16.14%,1
新北市,八里區,0135,314,668,982,64,1046,1793,58.34%,17.51%,1
新北市,八里區,0136,277,569,846,37,883,1644,53.71%,16.85%,1
新北市,八里區,0137,307,620,927,36,963,1846,52.17%,16.63%,1
新北市,八里區,0138,231,441,672,47,719,1346,53.42%,17.16%,1
新北市,八里區,0139,298,527,825,50,875,1621,53.98%,18.38%,1
新北市,八里區,0140,250,621,871,69,940,2110,44.55%,11.85%,1
新北市,八里區,0141,326,622,948,59,1007,1967,51.19%,16.57%,1
新北市,八里區,0142,287,553,840,53,893,1626,54.92%,17.65%,1
新北市,八里區,0143,250,518,768,65,833,1514,55.02%,16.51%,1
新北市,八里區,0144,336,418,754,84,838,1456,57.55%,23.08%,1
新北市,平溪區,2208,43,130,173,23,196,384,51.04%,11.2%,1
新北市,平溪區,2209,29,69,98,3,101,232,43.53%,12.5%,1
新北市,平溪區,2210,43,88,131,9,140,249,56.22%,17.27%,1
新北市,平溪區,2211,66,151,217,35,252,458,55.02%,14.41%,1
新北市,平溪區,2212,25,81,106,21,127,232,54.74%,10.78%,1
新北市,平溪區,2213,88,157,245,18,263,635,41.42%,13.86%,1
新北市,平溪區,2214,54,162,216,31,247,427,57.85%,12.65%,1
新北市,平溪區,2215,105,227,332,36,368,862,42.69%,12.18%,1
新北市,平溪區,2216,21,50,71,2,73,147,49.66%,14.29%,1
新北市,平溪區,2217,20,106,126,12,138,365,37.81%,5.48%,1
新北市,平溪區,2218,13,44,57,7,64,153,41.83%,8.5%,1
新北市,平溪區,2219,16,83,99,10,109,177,61.58%,9.04%,1
新北市,雙溪區,2266,52,145,197,17,214,455,47.03%,11.43%,1
新北市,雙溪區,2267,99,37,136,12,148,286,51.75%,34.62%,1
新北市,雙溪區,2268,68,174,242,32,274,496,55.24%,13.71%,1
新北市,雙溪區,2269,46,103,149,16,165,383,43.08%,12.01%,1
新北市,雙溪區,2270,94,245,339,39,378,887,42.62%,10.6%,1
新北市,雙溪區,2271,79,167,246,30,276,652,42.33%,12.12%,1
新北市,雙溪區,2272,40,116,156,13,169,333,50.75%,12.01%,1
新北市,雙溪區,2273,80,210,290,32,322,642,50.16%,12.46%,1
新北市,雙溪區,2274,44,81,125,12,137,282,48.58%,15.6%,1
新北市,雙溪區,2275,72,172,244,27,271,621,43.64%,11.59%,1
新北市,雙溪區,2276,52,107,159,13,172,422,40.76%,12.32%,1
新北市,雙溪區,2277,31,85,116,21,137,369,37.13%,8.4%,1
新北市,雙溪區,2278,20,36,56,9,65,120,54.17%,16.67%,1
新北市,雙溪區,2279,31,89,120,14,134,271,49.45%,11.44%,1
新北市,雙溪區,2280,57,135,192,21,213,362,58.84%,15.75%,1
新北市,雙溪區,2281,51,120,171,22,193,371,52.02%,13.75%,1
新北市,雙溪區,2282,135,434,569,46,615,1047,58.74%,12.89%,1
新北市,貢寮區,2283,110,278,388,49,437,876,49.89%,12.56%,1
新北市,貢寮區,2284,70,126,196,21,217,433,50.12%,16.17%,1
新北市,貢寮區,2285,70,144,214,11,225,516,43.6%,13.57%,1
新北市,貢寮區,2286,46,84,130,23,153,373,41.02%,12.33%,1
新北市,貢寮區,2287,38,85,123,26,149,313,47.6%,12.14%,1
新北市,貢寮區,2288,52,174,226,15,241,485,49.69%,10.72%,1
新北市,貢寮區,2289,62,125,187,24,211,415,50.84%,14.94%,1
新北市,貢寮區,2290,86,232,318,23,341,812,42%,10.59%,1
新北市,貢寮區,2291,123,251,374,42,416,861,48.32%,14.29%,1
新北市,貢寮區,2292,80,156,236,29,265,676,39.2%,11.83%,1
新北市,貢寮區,2293,123,254,377,30,407,1091,37.31%,11.27%,1
新北市,貢寮區,2294,112,221,333,60,393,955,41.15%,11.73%,1
新北市,貢寮區,2295,88,201,289,16,305,769,39.66%,11.44%,1
新北市,貢寮區,2296,142,285,427,36,463,962,48.13%,14.76%,1
新北市,貢寮區,2297,43,166,209,13,222,390,56.92%,11.03%,1
新北市,貢寮區,2298,32,117,149,5,154,349,44.13%,9.17%,1
新北市,貢寮區,2299,51,131,182,22,204,508,40.16%,10.04%,1
新北市,貢寮區,2300,51,103,154,10,164,495,33.13%,10.3%,1
新北市,金山區,2301,54,183,237,25,262,481,54.47%,11.23%,1
新北市,金山區,2302,108,240,348,33,381,715,53.29%,15.1%,1
新北市,金山區,2303,57,138,195,20,215,481,44.7%,11.85%,1
新北市,金山區,2304,206,364,570,266,836,1792,46.65%,11.5%,1
新北市,金山區,2305,264,578,842,71,913,1781,51.26%,14.82%,1
新北市,金山區,2306,327,682,1009,74,1083,2010,53.88%,16.27%,1
新北市,金山區,2307,214,489,703,71,774,1572,49.24%,13.61%,1
新北市,金山區,2308,267,566,833,80,913,1777,51.38%,15.03%,1
新北市,金山區,2309,224,487,711,68,779,1631,47.76%,13.73%,1
新北市,金山區,2310,141,267,408,28,436,828,52.66%,17.03%,1
新北市,金山區,2311,140,301,441,27,468,888,52.7%,15.77%,1
新北市,金山區,2312,169,389,558,54,612,1211,50.54%,13.96%,1
新北市,金山區,2313,53,169,222,17,239,416,57.45%,12.74%,1
新北市,金山區,2314,117,229,346,52,398,682,58.36%,17.16%,1
新北市,金山區,2315,86,209,295,54,349,644,54.19%,13.35%,1
新北市,金山區,2316,89,280,369,40,409,830,49.28%,10.72%,1
新北市,金山區,2317,23,66,89,11,100,188,53.19%,12.23%,1
新北市,金山區,2318,62,172,234,26,260,469,55.44%,13.22%,1
新北市,金山區,2319,53,135,188,29,217,582,37.29%,9.11%,1
新北市,萬里區,2320,183,463,646,50,696,1286,54.12%,14.23%,1
新北市,萬里區,2321,274,529,803,55,858,1576,54.44%,17.39%,1
新北市,萬里區,2322,190,466,656,44,700,1447,48.38%,13.13%,1
新北市,萬里區,2323,154,452,606,66,672,1466,45.84%,10.5%,1
新北市,萬里區,2324,147,406,553,41,594,1369,43.39%,10.74%,1
新北市,萬里區,2325,125,305,430,46,476,1215,39.18%,10.29%,1
新北市,萬里區,2326,165,475,640,52,692,1317,52.54%,12.53%,1
新北市,萬里區,2327,183,491,674,54,728,1676,43.44%,10.92%,1
新北市,萬里區,2328,182,477,659,80,739,1550,47.68%,11.74%,1
新北市,萬里區,2329,166,376,542,50,592,945,62.65%,17.57%,1
新北市,萬里區,2330,252,621,873,89,962,1760,54.66%,14.32%,1
新北市,萬里區,2331,50,215,265,22,287,570,50.35%,8.77%,1
新北市,萬里區,2332,122,319,441,25,466,952,48.95%,12.82%,1
新北市,萬里區,2333,91,254,345,50,395,674,58.61%,13.5%,1
新北市,萬里區,2334,59,137,196,16,212,405,52.35%,14.57%,1
新北市,萬里區,2335,128,366,494,55,549,1089,50.41%,11.75%,1
新北市,烏來區,2202,283,634,917,40,957,1568,61.03%,18.05%,1
新北市,烏來區,2203,171,411,582,15,597,1198,49.83%,14.27%,1
新北市,烏來區,2204,169,408,577,18,595,1169,50.9%,14.46%,1
新北市,烏來區,2205,41,82,123,1,124,228,54.39%,17.98%,1
新北市,烏來區,2206,61,191,252,19,271,486,55.76%,12.55%,1
新北市,烏來區,2207,85,212,297,19,316,615,51.38%,13.82%,1
桃園市,桃園區,0001,240,526,766,41,807,1593,50.66%,15.07%,1
桃園市,桃園區,0002,283,543,826,26,852,1934,44.05%,14.63%,1
桃園市,桃園區,0003,284,580,864,49,913,1661,54.97%,17.1%,1
桃園市,桃園區,0004,215,440,655,19,674,1448,46.55%,14.85%,1
桃園市,桃園區,0005,310,599,909,41,950,1974,48.13%,15.7%,1
桃園市,桃園區,0006,259,554,813,51,864,1882,45.91%,13.76%,1
桃園市,桃園區,0007,323,527,850,32,882,1800,49%,17.94%,1
桃園市,桃園區,0008,301,530,831,41,872,1598,54.57%,18.84%,1
桃園市,桃園區,0009,248,463,711,59,770,1626,47.36%,15.25%,1
桃園市,桃園區,0010,264,487,751,42,793,1590,49.87%,16.6%,1
桃園市,桃園區,0011,282,512,794,39,833,1637,50.89%,17.23%,1
桃園市,桃園區,0012,316,579,895,52,947,1943,48.74%,16.26%,1
桃園市,桃園區,0013,266,470,736,40,776,1482,52.36%,17.95%,1
桃園市,桃園區,0014,249,490,739,43,782,1423,54.95%,17.5%,1
桃園市,桃園區,0015,307,488,795,35,830,1509,55%,20.34%,1
桃園市,桃園區,0016,266,555,821,28,849,1567,54.18%,16.98%,1
桃園市,桃園區,0017,238,442,680,38,718,1305,55.02%,18.24%,1
桃園市,桃園區,0018,224,435,659,29,688,1416,48.59%,15.82%,1
桃園市,桃園區,0019,287,492,779,30,809,1439,56.22%,19.94%,1
桃園市,桃園區,0020,237,509,746,43,789,1399,56.4%,16.94%,1
桃園市,桃園區,0021,282,540,822,39,861,1540,55.91%,18.31%,1
桃園市,桃園區,0022,258,525,783,23,806,1638,49.21%,15.75%,1
桃園市,桃園區,0023,182,451,633,27,660,1228,53.75%,14.82%,1
桃園市,桃園區,0024,244,516,760,66,826,1649,50.09%,14.8%,1
桃園市,桃園區,0025,264,533,797,36,833,1601,52.03%,16.49%,1
桃園市,桃園區,0026,248,430,678,78,756,1477,51.18%,16.79%,1
桃園市,桃園區,0027,252,523,775,41,816,1503,54.29%,16.77%,1
桃園市,桃園區,0028,256,481,737,63,800,1375,58.18%,18.62%,1
桃園市,桃園區,0029,299,601,900,43,943,1743,54.1%,17.15%,1
桃園市,桃園區,0030,300,569,869,43,912,1862,48.98%,16.11%,1
桃園市,桃園區,0031,307,569,876,28,904,1728,52.31%,17.77%,1
桃園市,桃園區,0032,139,211,350,13,363,690,52.61%,20.14%,1
桃園市,桃園區,0033,176,311,487,29,516,852,60.56%,20.66%,1
桃園市,桃園區,0034,256,455,711,60,771,1353,56.98%,18.92%,1
桃園市,桃園區,0035,224,407,631,27,658,1698,38.75%,13.19%,1
桃園市,桃園區,0036,249,445,694,46,740,1452,50.96%,17.15%,1
桃園市,桃園區,0037,289,527,816,58,874,1681,51.99%,17.19%,1
桃園市,桃園區,0038,290,523,813,47,860,1669,51.53%,17.38%,1
桃園市,桃園區,0039,214,618,832,43,875,1530,57.19%,13.99%,1
桃園市,桃園區,0040,334,490,824,39,863,1582,54.55%,21.11%,1
桃園市,桃園區,0041,251,486,737,27,764,1587,48.14%,15.82%,1
桃園市,桃園區,0042,256,496,752,45,797,1451,54.93%,17.64%,1
桃園市,桃園區,0043,240,443,683,45,728,1582,46.02%,15.17%,1
桃園市,桃園區,0044,207,344,551,34,585,1028,56.91%,20.14%,1
桃園市,桃園區,0045,299,628,927,38,965,1934,49.9%,15.46%,1
桃園市,桃園區,0046,163,344,507,45,552,1016,54.33%,16.04%,1
桃園市,桃園區,0047,198,348,546,34,580,1079,53.75%,18.35%,1
桃園市,桃園區,0048,367,577,944,16,960,1837,52.26%,19.98%,1
桃園市,桃園區,0049,222,495,717,44,761,1390,54.75%,15.97%,1
桃園市,桃園區,0050,247,531,778,22,800,1489,53.73%,16.59%,1
桃園市,桃園區,0051,379,621,1000,20,1020,1821,56.01%,20.81%,1
桃園市,桃園區,0052,250,486,736,21,757,1563,48.43%,15.99%,1
桃園市,桃園區,0053,321,551,872,38,910,1697,53.62%,18.92%,1
桃園市,桃園區,0054,290,615,905,34,939,1740,53.97%,16.67%,1
桃園市,桃園區,0055,270,542,812,47,859,1626,52.83%,16.61%,1
桃園市,桃園區,0056,243,429,672,22,694,1239,56.01%,19.61%,1
桃園市,桃園區,0057,312,598,910,29,939,1766,53.17%,17.67%,1
桃園市,桃園區,0058,258,540,798,39,837,1555,53.83%,16.59%,1
桃園市,桃園區,0059,339,587,926,35,961,1831,52.48%,18.51%,1
桃園市,桃園區,0060,201,438,639,30,669,1115,60%,18.03%,1
桃園市,桃園區,0061,295,531,826,34,860,1562,55.06%,18.89%,1
桃園市,桃園區,0062,272,599,871,27,898,1744,51.49%,15.6%,1
桃園市,桃園區,0063,289,537,826,37,863,1838,46.95%,15.72%,1
桃園市,桃園區,0064,340,636,976,42,1018,1889,53.89%,18%,1
桃園市,桃園區,0065,306,579,885,54,939,1985,47.3%,15.42%,1
桃園市,桃園區,0066,299,537,836,35,871,1524,57.15%,19.62%,1
桃園市,桃園區,0067,263,581,844,31,875,1425,61.4%,18.46%,1
桃園市,桃園區,0068,296,591,887,37,924,1606,57.53%,18.43%,1
桃園市,桃園區,0069,374,729,1103,27,1130,2056,54.96%,18.19%,1
桃園市,桃園區,0070,357,715,1072,40,1112,2010,55.32%,17.76%,1
桃園市,桃園區,0071,345,702,1047,60,1107,2245,49.31%,15.37%,1
桃園市,桃園區,0072,322,491,813,33,846,1590,53.21%,20.25%,1
桃園市,桃園區,0073,294,594,888,21,909,1536,59.18%,19.14%,1
桃園市,桃園區,0074,317,585,902,43,945,1949,48.49%,16.26%,1
桃園市,桃園區,0075,318,613,931,45,976,1965,49.67%,16.18%,1
桃園市,桃園區,0076,358,667,1025,53,1078,2414,44.66%,14.83%,1
桃園市,桃園區,0077,306,631,937,43,980,1942,50.46%,15.76%,1
桃園市,桃園區,0078,335,713,1048,62,1110,2156,51.48%,15.54%,1
桃園市,桃園區,0079,254,493,747,45,792,1404,56.41%,18.09%,1
桃園市,桃園區,0080,227,460,687,33,720,1194,60.3%,19.01%,1
桃園市,桃園區,0081,273,506,779,56,835,1449,57.63%,18.84%,1
桃園市,桃園區,0082,273,549,822,60,882,1803,48.92%,15.14%,1
桃園市,桃園區,0083,286,571,857,42,899,1692,53.13%,16.9%,1
桃園市,桃園區,0084,351,615,966,42,1008,1913,52.69%,18.35%,1
桃園市,桃園區,0085,308,603,911,40,951,1815,52.4%,16.97%,1
桃園市,桃園區,0086,196,359,555,34,589,1173,50.21%,16.71%,1
桃園市,桃園區,0087,186,372,558,20,578,1162,49.74%,16.01%,1
桃園市,桃園區,0088,136,365,501,56,557,1194,46.65%,11.39%,1
桃園市,桃園區,0089,302,561,863,43,906,1695,53.45%,17.82%,1
桃園市,桃園區,0090,307,576,883,15,898,1797,49.97%,17.08%,1
桃園市,桃園區,0091,252,550,802,19,821,1592,51.57%,15.83%,1
桃園市,桃園區,0092,274,558,832,66,898,1780,50.45%,15.39%,1
桃園市,桃園區,0093,309,539,848,29,877,1904,46.06%,16.23%,1
桃園市,桃園區,0094,327,634,961,29,990,2021,48.99%,16.18%,1
桃園市,桃園區,0095,222,531,753,46,799,1545,51.72%,14.37%,1
桃園市,桃園區,0096,241,514,755,28,783,1617,48.42%,14.9%,1
桃園市,桃園區,0097,279,544,823,31,854,1683,50.74%,16.58%,1
桃園市,桃園區,0098,305,652,957,46,1003,1834,54.69%,16.63%,1
桃園市,桃園區,0099,330,608,938,33,971,2055,47.25%,16.06%,1
桃園市,桃園區,0100,279,570,849,23,872,1828,47.7%,15.26%,1
桃園市,桃園區,0101,303,574,877,36,913,1873,48.75%,16.18%,1
桃園市,桃園區,0102,256,479,735,35,770,3687,20.88%,6.94%,1
桃園市,桃園區,0103,317,598,915,29,944,1850,51.03%,17.14%,1
桃園市,桃園區,0104,297,600,897,28,925,1827,50.63%,16.26%,1
桃園市,桃園區,0105,192,466,658,36,694,1149,60.4%,16.71%,1
桃園市,桃園區,0106,201,379,580,43,623,1061,58.72%,18.94%,1
桃園市,桃園區,0107,296,548,844,28,872,1831,47.62%,16.17%,1
桃園市,桃園區,0108,370,673,1043,38,1081,2168,49.86%,17.07%,1
桃園市,桃園區,0109,332,576,908,14,922,1874,49.2%,17.72%,1
桃園市,桃園區,0110,242,442,684,21,705,1524,46.26%,15.88%,1
桃園市,桃園區,0111,267,478,745,23,768,1528,50.26%,17.47%,1
桃園市,桃園區,0112,288,515,803,30,833,1489,55.94%,19.34%,1
桃園市,桃園區,0113,344,285,629,50,679,1308,51.91%,26.3%,1
桃園市,桃園區,0114,243,533,776,41,817,1583,51.61%,15.35%,1
桃園市,桃園區,0115,280,564,844,41,885,1618,54.7%,17.31%,1
桃園市,桃園區,0116,354,628,982,53,1035,2127,48.66%,16.64%,1
桃園市,桃園區,0117,328,626,954,30,984,2033,48.4%,16.13%,1
桃園市,桃園區,0118,340,690,1030,22,1052,2098,50.14%,16.21%,1
桃園市,桃園區,0119,362,715,1077,72,1149,2126,54.05%,17.03%,1
桃園市,桃園區,0120,285,628,913,39,952,1917,49.66%,14.87%,1
桃園市,桃園區,0121,343,603,946,32,978,1997,48.97%,17.18%,1
桃園市,桃園區,0122,316,659,975,30,1005,1929,52.1%,16.38%,1
桃園市,桃園區,0123,314,512,826,34,860,1691,50.86%,18.57%,1
桃園市,桃園區,0124,329,508,837,24,861,1900,45.32%,17.32%,1
桃園市,桃園區,0125,291,578,869,64,933,1761,52.98%,16.52%,1
桃園市,桃園區,0126,332,619,951,21,972,1922,50.57%,17.27%,1
桃園市,桃園區,0127,292,641,933,56,989,1995,49.57%,14.64%,1
桃園市,桃園區,0128,193,367,560,29,589,1063,55.41%,18.16%,1
桃園市,桃園區,0129,247,460,707,29,736,1412,52.12%,17.49%,1
桃園市,桃園區,0130,342,572,914,32,946,1746,54.18%,19.59%,1
桃園市,桃園區,0131,261,493,754,46,800,1689,47.37%,15.45%,1
桃園市,桃園區,0132,222,446,668,25,693,1542,44.94%,14.4%,1
桃園市,桃園區,0133,213,466,679,44,723,1437,50.31%,14.82%,1
桃園市,桃園區,0134,260,573,833,30,863,1679,51.4%,15.49%,1
桃園市,桃園區,0135,289,539,828,50,878,1886,46.55%,15.32%,1
桃園市,桃園區,0136,316,518,834,52,886,1657,53.47%,19.07%,1
桃園市,桃園區,0137,247,455,702,24,726,1349,53.82%,18.31%,1
桃園市,桃園區,0138,308,601,909,32,941,1805,52.13%,17.06%,1
桃園市,桃園區,0139,319,575,894,45,939,1846,50.87%,17.28%,1
桃園市,桃園區,0140,258,477,735,42,777,1644,47.26%,15.69%,1
桃園市,桃園區,0141,261,513,774,32,806,1674,48.15%,15.59%,1
桃園市,桃園區,0142,283,566,849,36,885,1737,50.95%,16.29%,1
桃園市,桃園區,0143,245,547,792,47,839,1566,53.58%,15.64%,1
桃園市,桃園區,0144,272,496,768,42,810,1517,53.39%,17.93%,1
桃園市,桃園區,0145,268,451,719,32,751,1619,46.39%,16.55%,1
桃園市,桃園區,0146,328,552,880,31,911,1774,51.35%,18.49%,1
桃園市,桃園區,0147,269,569,838,34,872,1666,52.34%,16.15%,1
桃園市,桃園區,0148,268,518,786,13,799,1528,52.29%,17.54%,1
桃園市,桃園區,0149,311,508,819,45,864,1709,50.56%,18.2%,1
桃園市,桃園區,0150,314,524,838,19,857,1719,49.85%,18.27%,1
桃園市,桃園區,0151,80,618,698,33,731,1569,46.59%,5.1%,1
桃園市,桃園區,0152,217,506,723,22,745,1505,49.5%,14.42%,1
桃園市,桃園區,0153,232,487,719,40,759,1496,50.74%,15.51%,1
桃園市,桃園區,0154,281,487,768,36,804,1505,53.42%,18.67%,1
桃園市,桃園區,0155,309,567,876,36,912,1807,50.47%,17.1%,1
桃園市,桃園區,0156,405,510,915,36,951,1857,51.21%,21.81%,1
桃園市,桃園區,0157,240,596,836,57,893,1589,56.2%,15.1%,1
桃園市,桃園區,0158,365,659,1024,35,1059,2088,50.72%,17.48%,1
桃園市,桃園區,0159,321,589,910,41,951,1893,50.24%,16.96%,1
桃園市,桃園區,0160,179,384,563,32,595,1303,45.66%,13.74%,1
桃園市,桃園區,0161,262,463,725,31,756,1416,53.39%,18.5%,1
桃園市,桃園區,0162,221,415,636,30,666,1351,49.3%,16.36%,1
桃園市,桃園區,0163,284,517,801,20,821,1659,49.49%,17.12%,1
桃園市,桃園區,0164,314,667,981,34,1015,2103,48.26%,14.93%,1
桃園市,桃園區,0165,306,616,922,40,962,1943,49.51%,15.75%,1
桃園市,桃園區,0166,340,610,950,34,984,1927,51.06%,17.64%,1
桃園市,桃園區,0167,282,565,847,37,884,1929,45.83%,14.62%,1
桃園市,桃園區,0168,428,776,1204,29,1233,2204,55.94%,19.42%,1
桃園市,桃園區,0169,360,541,901,29,930,2033,45.75%,17.71%,1
桃園市,桃園區,0170,268,558,826,16,842,1656,50.85%,16.18%,1
桃園市,桃園區,0171,324,505,829,43,872,1712,50.93%,18.93%,1
桃園市,桃園區,0172,325,524,849,30,879,1738,50.58%,18.7%,1
桃園市,桃園區,0173,280,559,839,24,863,1432,60.27%,19.55%,1
桃園市,桃園區,0174,277,510,787,35,822,1421,57.85%,19.49%,1
桃園市,桃園區,0175,242,439,681,22,703,1344,52.31%,18.01%,1
桃園市,桃園區,0176,306,577,883,21,904,1942,46.55%,15.76%,1
桃園市,桃園區,0177,342,638,980,28,1008,2001,50.37%,17.09%,1
桃園市,桃園區,0178,323,551,874,22,896,1941,46.16%,16.64%,1
桃園市,桃園區,0179,328,549,877,35,912,1702,53.58%,19.27%,1
桃園市,桃園區,0180,292,487,779,43,822,1589,51.73%,18.38%,1
桃園市,桃園區,0181,267,464,731,34,765,1544,49.55%,17.29%,1
桃園市,桃園區,0182,251,520,771,41,812,1860,43.66%,13.49%,1
桃園市,桃園區,0183,281,539,820,50,870,1726,50.41%,16.28%,1
桃園市,桃園區,0184,278,554,832,38,870,1798,48.39%,15.46%,1
桃園市,桃園區,0185,348,612,960,22,982,1925,51.01%,18.08%,1
桃園市,桃園區,0186,347,586,933,34,967,1945,49.72%,17.84%,1
桃園市,桃園區,0187,282,519,801,33,834,1764,47.28%,15.99%,1
桃園市,桃園區,0188,288,685,973,60,1033,1899,54.4%,15.17%,1
桃園市,桃園區,0189,237,474,711,17,728,1415,51.45%,16.75%,1
桃園市,桃園區,0190,282,545,827,28,855,1790,47.77%,15.75%,1
桃園市,桃園區,0191,275,505,780,35,815,1693,48.14%,16.24%,1
桃園市,桃園區,0192,265,609,874,40,914,1916,47.7%,13.83%,1
桃園市,桃園區,0193,243,415,658,23,681,1434,47.49%,16.95%,1
桃園市,桃園區,0194,284,516,800,48,848,1494,56.76%,19.01%,1
桃園市,桃園區,0195,212,464,676,47,723,1311,55.15%,16.17%,1
桃園市,桃園區,0196,242,491,733,42,775,1476,52.51%,16.4%,1
桃園市,桃園區,0197,311,483,794,40,834,1484,56.2%,20.96%,1
桃園市,桃園區,0198,268,479,747,32,779,1514,51.45%,17.7%,1
桃園市,桃園區,0199,233,479,712,43,755,1446,52.21%,16.11%,1
桃園市,桃園區,0200,236,507,743,21,764,1573,48.57%,15%,1
桃園市,桃園區,0201,212,479,691,34,725,1564,46.36%,13.55%,1
桃園市,桃園區,0202,201,345,546,28,574,1015,56.55%,19.8%,1
桃園市,桃園區,0203,165,287,452,34,486,955,50.89%,17.28%,1
桃園市,桃園區,0204,294,572,866,30,896,1796,49.89%,16.37%,1
桃園市,桃園區,0205,334,561,895,16,911,1878,48.51%,17.78%,1
桃園市,桃園區,0206,284,539,823,30,853,1729,49.33%,16.43%,1
桃園市,桃園區,0207,271,561,832,24,856,1843,46.45%,14.7%,1
桃園市,桃園區,0208,476,279,755,25,780,1817,42.93%,26.2%,1
桃園市,桃園區,0209,172,357,529,24,553,979,56.49%,17.57%,1
桃園市,桃園區,0210,248,468,716,17,733,1363,53.78%,18.2%,1
桃園市,桃園區,0211,276,493,769,16,785,1546,50.78%,17.85%,1
桃園市,桃園區,0212,251,387,638,23,661,1308,50.54%,19.19%,1
桃園市,桃園區,0213,324,699,1023,50,1073,2164,49.58%,14.97%,1
桃園市,桃園區,0214,317,623,940,39,979,2020,48.47%,15.69%,1
桃園市,桃園區,0215,277,562,839,22,861,1924,44.75%,14.4%,1
桃園市,桃園區,0216,276,590,866,38,904,2088,43.3%,13.22%,1
桃園市,中壢區,0591,210,489,699,41,740,1401,52.82%,14.99%,1
桃園市,中壢區,0592,283,580,863,37,900,1798,50.06%,15.74%,1
桃園市,中壢區,0593,263,479,742,32,774,1642,47.14%,16.02%,1
桃園市,中壢區,0594,281,564,845,35,880,1670,52.69%,16.83%,1
桃園市,中壢區,0595,263,512,775,26,801,1456,55.01%,18.06%,1
桃園市,中壢區,0596,286,607,893,26,919,1531,60.03%,18.68%,1
桃園市,中壢區,0597,244,662,906,33,939,1623,57.86%,15.03%,1
桃園市,中壢區,0598,241,627,868,25,893,1953,45.72%,12.34%,1
桃園市,中壢區,0599,208,431,639,21,660,1155,57.14%,18.01%,1
桃園市,中壢區,0600,231,556,787,33,820,1800,45.56%,12.83%,1
桃園市,中壢區,0601,250,572,822,27,849,1757,48.32%,14.23%,1
桃園市,中壢區,0602,209,504,713,45,758,1281,59.17%,16.32%,1
桃園市,中壢區,0603,242,566,808,24,832,1462,56.91%,16.55%,1
桃園市,中壢區,0604,187,518,705,46,751,1560,48.14%,11.99%,1
桃園市,中壢區,0605,272,650,922,22,944,1602,58.93%,16.98%,1
桃園市,中壢區,0606,162,455,617,29,646,1006,64.21%,16.1%,1
桃園市,中壢區,0607,246,561,807,25,832,1474,56.45%,16.69%,1
桃園市,中壢區,0608,210,622,832,65,897,1627,55.13%,12.91%,1
桃園市,中壢區,0609,228,590,818,41,859,1519,56.55%,15.01%,1
桃園市,中壢區,0610,212,583,795,58,853,1526,55.9%,13.89%,1
桃園市,中壢區,0611,214,595,809,64,873,1618,53.96%,13.23%,1
桃園市,中壢區,0612,232,625,857,49,906,1554,58.3%,14.93%,1
桃園市,中壢區,0613,214,636,850,62,912,1706,53.46%,12.54%,1
桃園市,中壢區,0614,301,697,998,40,1038,1818,57.1%,16.56%,1
桃園市,中壢區,0615,274,683,957,39,996,1991,50.03%,13.76%,1
桃園市,中壢區,0616,229,600,829,34,863,1609,53.64%,14.23%,1
桃園市,中壢區,0617,162,470,632,24,656,1329,49.36%,12.19%,1
桃園市,中壢區,0618,205,517,722,71,793,1587,49.97%,12.92%,1
桃園市,中壢區,0619,272,699,971,21,992,1955,50.74%,13.91%,1
桃園市,中壢區,0620,258,577,835,52,887,1711,51.84%,15.08%,1
桃園市,中壢區,0621,270,567,837,42,879,1712,51.34%,15.77%,1
桃園市,中壢區,0622,221,571,792,42,834,1448,57.6%,15.26%,1
桃園市,中壢區,0623,241,538,779,40,819,1605,51.03%,15.02%,1
桃園市,中壢區,0624,224,544,768,10,778,1633,47.64%,13.72%,1
桃園市,中壢區,0625,301,679,980,48,1028,1795,57.27%,16.77%,1
桃園市,中壢區,0626,224,672,896,19,915,1689,54.17%,13.26%,1
桃園市,中壢區,0627,182,470,652,19,671,1201,55.87%,15.15%,1
桃園市,中壢區,0628,242,452,694,31,725,1353,53.58%,17.89%,1
桃園市,中壢區,0629,234,534,768,31,799,1587,50.35%,14.74%,1
桃園市,中壢區,0630,294,670,964,40,1004,1883,53.32%,15.61%,1
桃園市,中壢區,0631,248,475,723,23,746,1448,51.52%,17.13%,1
桃園市,中壢區,0632,313,600,913,42,955,1810,52.76%,17.29%,1
桃園市,中壢區,0633,309,631,940,39,979,1916,51.1%,16.13%,1
桃園市,中壢區,0634,184,470,654,25,679,1177,57.69%,15.63%,1
桃園市,中壢區,0635,250,554,804,40,844,1410,59.86%,17.73%,1
桃園市,中壢區,0636,234,458,692,28,720,1368,52.63%,17.11%,1
桃園市,中壢區,0637,233,574,807,45,852,1424,59.83%,16.36%,1
桃園市,中壢區,0638,281,573,854,23,877,1573,55.75%,17.86%,1
桃園市,中壢區,0639,208,423,631,26,657,1152,57.03%,18.06%,1
桃園市,中壢區,0640,220,423,643,17,660,1178,56.03%,18.68%,1
桃園市,中壢區,0641,316,700,1016,31,1047,1966,53.26%,16.07%,1
桃園市,中壢區,0642,227,462,689,25,714,3474,20.55%,6.53%,1
桃園市,中壢區,0643,382,708,1090,42,1132,2099,53.93%,18.2%,1
桃園市,中壢區,0644,193,444,637,25,662,1178,56.2%,16.38%,1
桃園市,中壢區,0645,262,552,814,42,856,1397,61.27%,18.75%,1
桃園市,中壢區,0646,286,598,884,43,927,1669,55.54%,17.14%,1
桃園市,中壢區,0647,325,648,973,44,1017,2087,48.73%,15.57%,1
桃園市,中壢區,0648,306,630,936,43,979,1900,51.53%,16.11%,1
桃園市,中壢區,0649,256,448,704,18,722,1640,44.02%,15.61%,1
桃園市,中壢區,0650,164,402,566,30,596,994,59.96%,16.5%,1
桃園市,中壢區,0651,168,521,689,37,726,1131,64.19%,14.85%,1
桃園市,中壢區,0652,632,291,923,33,956,1625,58.83%,38.89%,1
桃園市,中壢區,0653,252,573,825,35,860,1384,62.14%,18.21%,1
桃園市,中壢區,0654,266,552,818,35,853,1588,53.72%,16.75%,1
桃園市,中壢區,0655,192,560,752,38,790,1445,54.67%,13.29%,1
桃園市,中壢區,0656,178,544,722,31,753,1743,43.2%,10.21%,1
桃園市,中壢區,0657,256,578,834,24,858,1812,47.35%,14.13%,1
桃園市,中壢區,0658,236,512,748,41,789,1546,51.03%,15.27%,1
桃園市,中壢區,0659,176,479,655,32,687,1290,53.26%,13.64%,1
桃園市,中壢區,0660,262,727,989,60,1049,2145,48.9%,12.21%,1
桃園市,中壢區,0661,208,480,688,32,720,1451,49.62%,14.33%,1
桃園市,中壢區,0662,210,531,741,38,779,1489,52.32%,14.1%,1
桃園市,中壢區,0663,150,290,440,21,461,827,55.74%,18.14%,1
桃園市,中壢區,0664,219,489,708,30,738,1442,51.18%,15.19%,1
桃園市,中壢區,0665,288,567,855,18,873,1842,47.39%,15.64%,1
桃園市,中壢區,0666,238,475,713,22,735,1520,48.36%,15.66%,1
桃園市,中壢區,0667,256,534,790,32,822,1764,46.6%,14.51%,1
桃園市,中壢區,0668,231,574,805,17,822,1488,55.24%,15.52%,1
桃園市,中壢區,0669,245,571,816,32,848,1593,53.23%,15.38%,1
桃園市,中壢區,0670,261,517,778,25,803,1505,53.36%,17.34%,1
桃園市,中壢區,0671,252,585,837,22,859,1661,51.72%,15.17%,1
桃園市,中壢區,0672,242,544,786,40,826,1492,55.36%,16.22%,1
桃園市,中壢區,0673,192,399,591,26,617,1249,49.4%,15.37%,1
桃園市,中壢區,0674,215,466,681,26,707,1257,56.25%,17.1%,1
桃園市,中壢區,0675,251,559,810,55,865,1659,52.14%,15.13%,1
桃園市,中壢區,0676,330,639,969,29,998,1815,54.99%,18.18%,1
桃園市,中壢區,0677,266,566,832,30,862,1702,50.65%,15.63%,1
桃園市,中壢區,0678,282,519,801,25,826,1541,53.6%,18.3%,1
桃園市,中壢區,0679,238,543,781,36,817,1659,49.25%,14.35%,1
桃園市,中壢區,0680,239,666,905,67,972,1874,51.87%,12.75%,1
桃園市,中壢區,0681,184,589,773,31,804,1603,50.16%,11.48%,1
桃園市,中壢區,0682,277,562,839,39,878,1735,50.61%,15.97%,1
桃園市,中壢區,0683,315,573,888,32,920,1815,50.69%,17.36%,1
桃園市,中壢區,0684,200,614,814,26,840,1873,44.85%,10.68%,1
桃園市,中壢區,0685,220,697,917,46,963,1739,55.38%,12.65%,1
桃園市,中壢區,0686,263,549,812,35,847,1709,49.56%,15.39%,1
桃園市,中壢區,0687,246,620,866,45,911,1655,55.05%,14.86%,1
桃園市,中壢區,0688,224,636,860,30,890,1664,53.49%,13.46%,1
桃園市,中壢區,0689,146,397,543,12,555,1087,51.06%,13.43%,1
桃園市,中壢區,0690,171,386,557,43,600,1065,56.34%,16.06%,1
桃園市,中壢區,0691,289,637,926,63,989,1844,53.63%,15.67%,1
桃園市,中壢區,0692,166,377,543,38,581,1220,47.62%,13.61%,1
桃園市,中壢區,0693,204,422,626,29,655,1219,53.73%,16.74%,1
桃園市,中壢區,0694,201,454,655,42,697,1260,55.32%,15.95%,1
桃園市,中壢區,0695,250,631,881,47,928,1594,58.22%,15.68%,1
桃園市,中壢區,0696,309,573,882,60,942,1733,54.36%,17.83%,1
桃園市,中壢區,0697,323,675,998,44,1042,1979,52.65%,16.32%,1
桃園市,中壢區,0698,314,547,861,27,888,1621,54.78%,19.37%,1
桃園市,中壢區,0699,237,507,744,41,785,1391,56.43%,17.04%,1
桃園市,中壢區,0700,266,570,836,15,851,1531,55.58%,17.37%,1
桃園市,中壢區,0701,255,657,912,29,941,1943,48.43%,13.12%,1
桃園市,中壢區,0702,232,469,701,15,716,1363,52.53%,17.02%,1
桃園市,中壢區,0703,324,624,948,39,987,2172,45.44%,14.92%,1
桃園市,中壢區,0704,246,594,840,39,879,1798,48.89%,13.68%,1
桃園市,中壢區,0705,250,556,806,23,829,1671,49.61%,14.96%,1
桃園市,中壢區,0706,282,600,882,52,934,1969,47.44%,14.32%,1
桃園市,中壢區,0707,295,662,957,41,998,1563,63.85%,18.87%,1
桃園市,中壢區,0708,320,626,946,32,978,1762,55.51%,18.16%,1
桃園市,中壢區,0709,235,563,798,30,828,1923,43.06%,12.22%,1
桃園市,中壢區,0710,272,572,844,52,896,1572,57%,17.3%,1
桃園市,中壢區,0711,307,676,983,31,1014,1850,54.81%,16.59%,1
桃園市,中壢區,0712,266,514,780,42,822,1583,51.93%,16.8%,1
桃園市,中壢區,0713,297,561,858,39,897,1735,51.7%,17.12%,1
桃園市,中壢區,0714,202,454,656,31,687,1292,53.17%,15.63%,1
桃園市,中壢區,0715,204,464,668,18,686,1265,54.23%,16.13%,1
桃園市,中壢區,0716,258,643,901,34,935,1798,52%,14.35%,1
桃園市,中壢區,0717,290,700,990,53,1043,1822,57.24%,15.92%,1
桃園市,中壢區,0718,255,576,831,24,855,1613,53.01%,15.81%,1
桃園市,中壢區,0719,259,465,724,34,758,1405,53.95%,18.43%,1
桃園市,中壢區,0720,531,397,928,55,983,1730,56.82%,30.69%,1
桃園市,中壢區,0721,241,576,817,33,850,1384,61.42%,17.41%,1
桃園市,中壢區,0722,202,422,624,14,638,1122,56.86%,18%,1
桃園市,中壢區,0723,184,379,563,41,604,992,60.89%,18.55%,1
桃園市,中壢區,0724,318,592,910,36,946,1820,51.98%,17.47%,1
桃園市,中壢區,0725,360,536,896,43,939,1847,50.84%,19.49%,1
桃園市,中壢區,0726,219,504,723,47,770,1302,59.14%,16.82%,1
桃園市,中壢區,0727,206,446,652,44,696,1203,57.86%,17.12%,1
桃園市,中壢區,0728,242,510,752,37,789,1226,64.36%,19.74%,1
桃園市,中壢區,0729,197,503,700,33,733,1234,59.4%,15.96%,1
桃園市,中壢區,0730,273,634,907,43,950,2023,46.96%,13.49%,1
桃園市,中壢區,0731,210,506,716,21,737,1555,47.4%,13.5%,1
桃園市,中壢區,0732,314,622,936,48,984,1951,50.44%,16.09%,1
桃園市,中壢區,0733,237,488,725,45,770,1383,55.68%,17.14%,1
桃園市,中壢區,0734,186,479,665,39,704,1164,60.48%,15.98%,1
桃園市,中壢區,0735,244,538,782,32,814,1482,54.93%,16.46%,1
桃園市,中壢區,0736,252,653,905,39,944,1770,53.33%,14.24%,1
桃園市,中壢區,0737,303,629,932,56,988,1703,58.02%,17.79%,1
桃園市,中壢區,0738,266,659,925,51,976,1841,53.01%,14.45%,1
桃園市,中壢區,0739,359,678,1037,28,1065,1941,54.87%,18.5%,1
桃園市,中壢區,0740,339,740,1079,38,1117,2029,55.05%,16.71%,1
桃園市,中壢區,0741,301,627,928,27,955,1636,58.37%,18.4%,1
桃園市,中壢區,0742,243,590,833,39,872,1528,57.07%,15.9%,1
桃園市,中壢區,0743,332,712,1044,62,1106,2289,48.32%,14.5%,1
桃園市,中壢區,0744,328,636,964,34,998,2020,49.41%,16.24%,1
桃園市,中壢區,0745,326,709,1035,59,1094,2027,53.97%,16.08%,1
桃園市,中壢區,0746,281,535,816,22,838,1883,44.5%,14.92%,1
桃園市,中壢區,0747,315,677,992,48,1040,2080,50%,15.14%,1
桃園市,中壢區,0748,121,223,344,12,356,646,55.11%,18.73%,1
桃園市,中壢區,0749,315,751,1066,50,1116,1780,62.7%,17.7%,1
桃園市,中壢區,0750,99,537,636,17,653,1372,47.59%,7.22%,1
桃園市,中壢區,0751,276,645,921,34,955,1668,57.25%,16.55%,1
桃園市,中壢區,0752,340,622,962,30,992,1987,49.92%,17.11%,1
桃園市,中壢區,0753,266,544,810,17,827,1520,54.41%,17.5%,1
桃園市,中壢區,0754,160,278,438,27,465,852,54.58%,18.78%,1
桃園市,中壢區,0755,247,406,653,19,672,1209,55.58%,20.43%,1
桃園市,中壢區,0756,445,304,749,56,805,1481,54.36%,30.05%,1
桃園市,中壢區,0757,248,484,732,14,746,1564,47.7%,15.86%,1
桃園市,中壢區,0758,322,683,1005,54,1059,1957,54.11%,16.45%,1
桃園市,中壢區,0759,275,468,743,43,786,1223,64.27%,22.49%,1
桃園市,中壢區,0760,219,444,663,32,695,1182,58.8%,18.53%,1
桃園市,中壢區,0761,187,401,588,39,627,1066,58.82%,17.54%,1
桃園市,中壢區,0762,271,660,931,39,970,1701,57.03%,15.93%,1
桃園市,中壢區,0763,156,315,471,32,503,943,53.34%,16.54%,1
桃園市,中壢區,0764,135,281,416,26,442,731,60.47%,18.47%,1
桃園市,中壢區,0765,155,307,462,32,494,851,58.05%,18.21%,1
桃園市,中壢區,0766,202,337,539,18,557,1011,55.09%,19.98%,1
桃園市,中壢區,0767,268,571,839,41,880,1532,57.44%,17.49%,1
桃園市,中壢區,0768,165,356,521,38,559,1028,54.38%,16.05%,1
桃園市,中壢區,0769,190,440,630,40,670,1157,57.91%,16.42%,1
桃園市,中壢區,0770,260,526,786,42,828,1591,52.04%,16.34%,1
桃園市,中壢區,0771,314,662,976,50,1026,2156,47.59%,14.56%,1
桃園市,中壢區,0772,220,468,688,19,707,1479,47.8%,14.87%,1
桃園市,中壢區,0773,291,608,899,42,941,1780,52.87%,16.35%,1
桃園市,中壢區,0774,259,586,845,48,893,1651,54.09%,15.69%,1
桃園市,中壢區,0775,347,632,979,37,1016,1870,54.33%,18.56%,1
桃園市,中壢區,0776,288,564,852,27,879,1913,45.95%,15.05%,1
桃園市,中壢區,0777,214,511,725,37,762,1609,47.36%,13.3%,1
桃園市,中壢區,0778,229,526,755,29,784,1539,50.94%,14.88%,1
桃園市,中壢區,0779,228,504,732,32,764,1426,53.58%,15.99%,1
桃園市,中壢區,0780,219,541,760,28,788,1618,48.7%,13.54%,1
桃園市,中壢區,0781,220,525,745,39,784,1441,54.41%,15.27%,1
桃園市,中壢區,0782,299,516,815,29,844,1528,55.24%,19.57%,1
桃園市,中壢區,0783,277,579,856,48,904,1683,53.71%,16.46%,1
桃園市,中壢區,0784,294,716,1010,64,1074,1945,55.22%,15.12%,1
桃園市,中壢區,0785,233,541,774,48,822,1534,53.59%,15.19%,1
桃園市,中壢區,0786,271,593,864,46,910,1810,50.28%,14.97%,1
桃園市,中壢區,0787,184,334,518,44,562,1097,51.23%,16.77%,1
桃園市,中壢區,0788,344,559,903,31,934,1917,48.72%,17.94%,1
桃園市,中壢區,0789,358,572,930,28,958,1858,51.56%,19.27%,1
桃園市,中壢區,0790,278,565,843,33,876,1576,55.58%,17.64%,1
桃園市,中壢區,0791,258,540,798,46,844,1478,57.1%,17.46%,1
桃園市,中壢區,0792,278,528,806,34,840,1589,52.86%,17.5%,1
桃園市,中壢區,0793,335,702,1037,70,1107,2037,54.34%,16.45%,1
桃園市,中壢區,0794,206,460,666,34,700,1158,60.45%,17.79%,1
桃園市,中壢區,0795,202,797,999,67,1066,1967,54.19%,10.27%,1
桃園市,中壢區,0796,274,587,861,67,928,1830,50.71%,14.97%,1
桃園市,中壢區,0797,257,675,932,47,979,1856,52.75%,13.85%,1
桃園市,中壢區,0798,304,672,976,61,1037,2068,50.15%,14.7%,1
桃園市,中壢區,0799,300,558,858,33,891,2152,41.4%,13.94%,1
桃園市,中壢區,0800,358,592,950,40,990,2158,45.88%,16.59%,1
桃園市,大溪區,0522,265,516,781,51,832,1477,56.33%,17.94%,1
桃園市,大溪區,0523,168,357,525,34,559,1006,55.57%,16.7%,1
桃園市,大溪區,0524,223,526,749,67,816,1553,52.54%,14.36%,1
桃園市,大溪區,0525,294,514,808,63,871,1597,54.54%,18.41%,1
桃園市,大溪區,0526,224,460,684,38,722,1358,53.17%,16.49%,1
桃園市,大溪區,0527,232,497,729,34,763,1585,48.14%,14.64%,1
桃園市,大溪區,0528,284,509,793,47,840,1612,52.11%,17.62%,1
桃園市,大溪區,0529,191,501,692,35,727,1555,46.75%,12.28%,1
桃園市,大溪區,0530,220,514,734,37,771,1282,60.14%,17.16%,1
桃園市,大溪區,0531,198,486,684,48,732,1392,52.59%,14.22%,1
桃園市,大溪區,0532,210,469,679,42,721,1422,50.7%,14.77%,1
桃園市,大溪區,0533,252,468,720,66,786,1448,54.28%,17.4%,1
桃園市,大溪區,0534,243,487,730,46,776,1269,61.15%,19.15%,1
桃園市,大溪區,0535,156,371,527,64,591,977,60.49%,15.97%,1
桃園市,大溪區,0536,217,512,729,41,770,1359,56.66%,15.97%,1
桃園市,大溪區,0537,206,415,621,63,684,1135,60.26%,18.15%,1
桃園市,大溪區,0538,120,188,308,44,352,660,53.33%,18.18%,1
桃園市,大溪區,0539,161,329,490,41,531,1056,50.28%,15.25%,1
桃園市,大溪區,0540,189,410,599,53,652,1263,51.62%,14.96%,1
桃園市,大溪區,0541,91,267,358,42,400,717,55.79%,12.69%,1
桃園市,大溪區,0542,168,375,543,20,563,1299,43.34%,12.93%,1
桃園市,大溪區,0543,162,319,481,62,543,976,55.64%,16.6%,1
桃園市,大溪區,0544,128,325,453,55,508,938,54.16%,13.65%,1
桃園市,大溪區,0545,116,282,398,24,422,832,50.72%,13.94%,1
桃園市,大溪區,0546,114,256,370,26,396,866,45.73%,13.16%,1
桃園市,大溪區,0547,112,195,307,33,340,694,48.99%,16.14%,1
桃園市,大溪區,0548,213,440,653,49,702,1410,49.79%,15.11%,1
桃園市,大溪區,0549,143,453,596,51,647,1303,49.65%,10.97%,1
桃園市,大溪區,0550,184,377,561,28,589,1125,52.36%,16.36%,1
桃園市,大溪區,0551,211,410,621,23,644,1170,55.04%,18.03%,1
桃園市,大溪區,0552,226,497,723,42,765,1308,58.49%,17.28%,1
桃園市,大溪區,0553,179,366,545,71,616,1094,56.31%,16.36%,1
桃園市,大溪區,0554,331,763,1094,52,1146,2153,53.23%,15.37%,1
桃園市,大溪區,0555,142,495,637,41,678,1173,57.8%,12.11%,1
桃園市,大溪區,0556,182,500,682,22,704,1369,51.42%,13.29%,1
桃園市,大溪區,0557,199,474,673,72,745,1446,51.52%,13.76%,1
桃園市,大溪區,0558,147,437,584,53,637,1406,45.31%,10.46%,1
桃園市,大溪區,0559,238,600,838,22,860,1592,54.02%,14.95%,1
桃園市,大溪區,0560,246,550,796,61,857,1497,57.25%,16.43%,1
桃園市,大溪區,0561,266,549,815,75,890,1559,57.09%,17.06%,1
桃園市,大溪區,0562,258,575,833,25,858,1684,50.95%,15.32%,1
桃園市,大溪區,0563,312,706,1018,65,1083,1959,55.28%,15.93%,1
桃園市,大溪區,0564,211,498,709,69,778,1369,56.83%,15.41%,1
桃園市,大溪區,0565,231,518,749,53,802,1431,56.04%,16.14%,1
桃園市,大溪區,0566,196,467,663,30,693,1657,41.82%,11.83%,1
桃園市,大溪區,0567,184,400,584,30,614,1387,44.27%,13.27%,1
桃園市,大溪區,0568,167,355,522,49,571,1085,52.63%,15.39%,1
桃園市,大溪區,0569,214,536,750,40,790,1403,56.31%,15.25%,1
桃園市,大溪區,0570,241,473,714,70,784,1511,51.89%,15.95%,1
桃園市,大溪區,0571,251,472,723,76,799,1719,46.48%,14.6%,1
桃園市,大溪區,0572,213,503,716,77,793,1717,46.19%,12.41%,1
桃園市,大溪區,0573,162,414,576,73,649,1207,53.77%,13.42%,1
桃園市,大溪區,0574,171,429,600,74,674,1188,56.73%,14.39%,1
桃園市,大溪區,0575,213,500,713,22,735,1514,48.55%,14.07%,1
桃園市,大溪區,0576,234,556,790,65,855,1529,55.92%,15.3%,1
桃園市,大溪區,0577,199,510,709,34,743,1260,58.97%,15.79%,1
桃園市,大溪區,0578,120,341,461,18,479,831,57.64%,14.44%,1
桃園市,大溪區,0579,217,516,733,47,780,1407,55.44%,15.42%,1
桃園市,大溪區,0580,199,483,682,63,745,1494,49.87%,13.32%,1
桃園市,楊梅區,0926,178,478,656,52,708,1269,55.79%,14.03%,1
桃園市,楊梅區,0927,100,619,719,53,772,1246,61.96%,8.03%,1
桃園市,楊梅區,0928,223,556,779,37,816,1408,57.95%,15.84%,1
桃園市,楊梅區,0929,116,646,762,41,803,1434,56%,8.09%,1
桃園市,楊梅區,0930,191,538,729,52,781,1515,51.55%,12.61%,1
桃園市,楊梅區,0931,208,552,760,53,813,1657,49.06%,12.55%,1
桃園市,楊梅區,0932,163,464,627,35,662,1137,58.22%,14.34%,1
桃園市,楊梅區,0933,323,748,1071,36,1107,2211,50.07%,14.61%,1
桃園市,楊梅區,0934,288,692,980,31,1011,2008,50.35%,14.34%,1
桃園市,楊梅區,0935,317,659,976,29,1005,1911,52.59%,16.59%,1
桃園市,楊梅區,0936,216,554,770,47,817,1449,56.38%,14.91%,1
桃園市,楊梅區,0937,245,575,820,47,867,1877,46.19%,13.05%,1
桃園市,楊梅區,0938,257,665,922,35,957,1988,48.14%,12.93%,1
桃園市,楊梅區,0939,318,663,981,25,1006,1931,52.1%,16.47%,1
桃園市,楊梅區,0940,248,549,797,61,858,1938,44.27%,12.8%,1
桃園市,楊梅區,0941,233,626,859,25,884,1677,52.71%,13.89%,1
桃園市,楊梅區,0942,296,604,900,21,921,1848,49.84%,16.02%,1
桃園市,楊梅區,0943,322,635,957,28,985,1882,52.34%,17.11%,1
桃園市,楊梅區,0944,193,429,622,11,633,1541,41.08%,12.52%,1
桃園市,楊梅區,0945,273,634,907,36,943,1938,48.66%,14.09%,1
桃園市,楊梅區,0946,211,498,709,15,724,1562,46.35%,13.51%,1
桃園市,楊梅區,0947,425,712,1137,39,1176,2125,55.34%,20%,1
桃園市,楊梅區,0948,237,602,839,48,887,1516,58.51%,15.63%,1
桃園市,楊梅區,0949,253,619,872,24,896,1807,49.58%,14%,1
桃園市,楊梅區,0950,317,651,968,34,1002,2101,47.69%,15.09%,1
桃園市,楊梅區,0951,309,709,1018,54,1072,2054,52.19%,15.04%,1
桃園市,楊梅區,0952,304,709,1013,22,1035,2226,46.5%,13.66%,1
桃園市,楊梅區,0953,229,506,735,12,747,1405,53.17%,16.3%,1
桃園市,楊梅區,0954,282,568,850,25,875,1843,47.48%,15.3%,1
桃園市,楊梅區,0955,310,685,995,42,1037,2324,44.62%,13.34%,1
桃園市,楊梅區,0956,260,612,872,27,899,1713,52.48%,15.18%,1
桃園市,楊梅區,0957,246,649,895,42,937,1587,59.04%,15.5%,1
桃園市,楊梅區,0958,224,563,787,30,817,1416,57.7%,15.82%,1
桃園市,楊梅區,0959,244,606,850,22,872,1591,54.81%,15.34%,1
桃園市,楊梅區,0960,267,692,959,40,999,1943,51.42%,13.74%,1
桃園市,楊梅區,0961,249,642,891,40,931,1762,52.84%,14.13%,1
桃園市,楊梅區,0962,161,388,549,35,584,1083,53.92%,14.87%,1
桃園市,楊梅區,0963,278,731,1009,36,1045,2027,51.55%,13.71%,1
桃園市,楊梅區,0964,184,488,672,57,729,1274,57.22%,14.44%,1
桃園市,楊梅區,0965,197,536,733,52,785,1359,57.76%,14.5%,1
桃園市,楊梅區,0966,256,566,822,41,863,2444,35.31%,10.47%,1
桃園市,楊梅區,0967,282,717,999,38,1037,2298,45.13%,12.27%,1
桃園市,楊梅區,0968,303,758,1061,34,1095,2222,49.28%,13.64%,1
桃園市,楊梅區,0969,228,555,783,70,853,1610,52.98%,14.16%,1
桃園市,楊梅區,0970,235,561,796,71,867,1627,53.29%,14.44%,1
桃園市,楊梅區,0971,193,765,958,46,1004,1589,63.18%,12.15%,1
桃園市,楊梅區,0972,270,616,886,54,940,1758,53.47%,15.36%,1
桃園市,楊梅區,0973,207,522,729,48,777,1776,43.75%,11.66%,1
桃園市,楊梅區,0974,143,325,468,26,494,1000,49.4%,14.3%,1
桃園市,楊梅區,0975,273,694,967,69,1036,2290,45.24%,11.92%,1
桃園市,楊梅區,0976,228,537,765,51,816,1551,52.61%,14.7%,1
桃園市,楊梅區,0977,226,655,881,52,933,1861,50.13%,12.14%,1
桃園市,楊梅區,0978,149,350,499,36,535,1141,46.89%,13.06%,1
桃園市,楊梅區,0979,221,598,819,44,863,1785,48.35%,12.38%,1
桃園市,楊梅區,0980,205,542,747,53,800,1498,53.4%,13.68%,1
桃園市,楊梅區,0981,170,397,567,58,625,1187,52.65%,14.32%,1
桃園市,楊梅區,0982,192,468,660,49,709,1270,55.83%,15.12%,1
桃園市,楊梅區,0983,187,522,709,45,754,1424,52.95%,13.13%,1
桃園市,楊梅區,0984,225,528,753,23,776,1273,60.96%,17.67%,1
桃園市,楊梅區,0985,218,463,681,31,712,1534,46.41%,14.21%,1
桃園市,楊梅區,0986,241,509,750,70,820,1783,45.99%,13.52%,1
桃園市,楊梅區,0987,212,582,794,24,818,1709,47.86%,12.4%,1
桃園市,楊梅區,0988,234,590,824,61,885,1920,46.09%,12.19%,1
桃園市,楊梅區,0989,185,432,617,33,650,1194,54.44%,15.49%,1
桃園市,楊梅區,0990,206,551,757,18,775,1408,55.04%,14.63%,1
桃園市,楊梅區,0991,192,556,748,40,788,1737,45.37%,11.05%,1
桃園市,楊梅區,0992,249,673,922,33,955,1920,49.74%,12.97%,1
桃園市,楊梅區,0993,199,429,628,25,653,1234,52.92%,16.13%,1
桃園市,楊梅區,0994,214,557,771,59,830,1491,55.67%,14.35%,1
桃園市,楊梅區,0995,281,626,907,41,948,2020,46.93%,13.91%,1
桃園市,楊梅區,0996,264,567,831,33,864,1863,46.38%,14.17%,1
桃園市,楊梅區,0997,225,634,859,57,916,1692,54.14%,13.3%,1
桃園市,楊梅區,0998,262,579,841,29,870,1686,51.6%,15.54%,1
桃園市,楊梅區,0999,254,549,803,83,886,1626,54.49%,15.62%,1
桃園市,楊梅區,1000,252,572,824,24,848,1557,54.46%,16.18%,1
桃園市,楊梅區,1001,270,596,866,60,926,1603,57.77%,16.84%,1
桃園市,楊梅區,1002,272,594,866,62,928,1889,49.13%,14.4%,1
桃園市,楊梅區,1003,230,549,779,28,807,1448,55.73%,15.88%,1
桃園市,楊梅區,1004,175,546,721,36,757,1351,56.03%,12.95%,1
桃園市,楊梅區,1005,194,527,721,42,763,1313,58.11%,14.78%,1
桃園市,楊梅區,1006,228,614,842,39,881,1689,52.16%,13.5%,1
桃園市,楊梅區,1007,273,677,950,28,978,2063,47.41%,13.23%,1
桃園市,蘆竹區,0396,197,452,649,63,712,1358,52.43%,14.51%,1
桃園市,蘆竹區,0397,216,489,705,66,771,1538,50.13%,14.04%,1
桃園市,蘆竹區,0398,241,593,834,61,895,2118,42.26%,11.38%,1
桃園市,蘆竹區,0399,257,622,879,60,939,1673,56.13%,15.36%,1
桃園市,蘆竹區,0400,261,523,784,30,814,1500,54.27%,17.4%,1
桃園市,蘆竹區,0401,281,574,855,50,905,1699,53.27%,16.54%,1
桃園市,蘆竹區,0402,341,765,1106,43,1149,2250,51.07%,15.16%,1
桃園市,蘆竹區,0403,365,668,1033,23,1056,2354,44.86%,15.51%,1
桃園市,蘆竹區,0404,206,459,665,24,689,1446,47.65%,14.25%,1
桃園市,蘆竹區,0405,248,458,706,57,763,1623,47.01%,15.28%,1
桃園市,蘆竹區,0406,275,542,817,30,847,1747,48.48%,15.74%,1
桃園市,蘆竹區,0407,316,650,966,57,1023,1988,51.46%,15.9%,1
桃園市,蘆竹區,0408,238,485,723,31,754,1437,52.47%,16.56%,1
桃園市,蘆竹區,0409,241,571,812,53,865,1532,56.46%,15.73%,1
桃園市,蘆竹區,0410,201,484,685,30,715,1447,49.41%,13.89%,1
桃園市,蘆竹區,0411,338,715,1053,49,1102,2189,50.34%,15.44%,1
桃園市,蘆竹區,0412,342,776,1118,51,1169,2498,46.8%,13.69%,1
桃園市,蘆竹區,0413,227,462,689,29,718,1322,54.31%,17.17%,1
桃園市,蘆竹區,0414,254,519,773,77,850,1991,42.69%,12.76%,1
桃園市,蘆竹區,0415,313,615,928,59,987,2097,47.07%,14.93%,1
桃園市,蘆竹區,0416,305,497,802,46,848,1558,54.43%,19.58%,1
桃園市,蘆竹區,0417,366,594,960,30,990,1891,52.35%,19.35%,1
桃園市,蘆竹區,0418,268,476,744,29,773,1590,48.62%,16.86%,1
桃園市,蘆竹區,0419,335,697,1032,50,1082,2404,45.01%,13.94%,1
桃園市,蘆竹區,0420,413,796,1209,41,1250,2522,49.56%,16.38%,1
桃園市,蘆竹區,0421,270,551,821,23,844,1633,51.68%,16.53%,1
桃園市,蘆竹區,0422,311,536,847,39,886,1715,51.66%,18.13%,1
桃園市,蘆竹區,0423,324,677,1001,27,1028,2215,46.41%,14.63%,1
桃園市,蘆竹區,0424,222,713,935,41,976,2029,48.1%,10.94%,1
桃園市,蘆竹區,0425,282,530,812,30,842,1731,48.64%,16.29%,1
桃園市,蘆竹區,0426,295,595,890,29,919,1820,50.49%,16.21%,1
桃園市,蘆竹區,0427,283,554,837,49,886,1633,54.26%,17.33%,1
桃園市,蘆竹區,0428,221,510,731,22,753,1668,45.14%,13.25%,1
桃園市,蘆竹區,0429,280,305,585,31,616,1493,41.26%,18.75%,1
桃園市,蘆竹區,0430,265,664,929,40,969,1864,51.98%,14.22%,1
桃園市,蘆竹區,0431,314,493,807,29,836,1703,49.09%,18.44%,1
桃園市,蘆竹區,0432,320,606,926,32,958,1893,50.61%,16.9%,1
桃園市,蘆竹區,0433,367,658,1025,34,1059,1922,55.1%,19.09%,1
桃園市,蘆竹區,0434,240,486,726,23,749,1393,53.77%,17.23%,1
桃園市,蘆竹區,0435,237,482,719,18,737,1338,55.08%,17.71%,1
桃園市,蘆竹區,0436,261,569,830,27,857,1688,50.77%,15.46%,1
桃園市,蘆竹區,0437,226,473,699,49,748,1462,51.16%,15.46%,1
桃園市,蘆竹區,0438,172,459,631,22,653,1232,53%,13.96%,1
桃園市,蘆竹區,0439,188,435,623,25,648,1356,47.79%,13.86%,1
桃園市,蘆竹區,0440,224,456,680,36,716,1181,60.63%,18.97%,1
桃園市,蘆竹區,0441,185,392,577,27,604,1199,50.38%,15.43%,1
桃園市,蘆竹區,0442,305,577,882,28,910,1710,53.22%,17.84%,1
桃園市,蘆竹區,0443,234,448,682,18,700,1423,49.19%,16.44%,1
桃園市,蘆竹區,0444,295,494,789,26,815,1522,53.55%,19.38%,1
桃園市,蘆竹區,0445,271,574,845,34,879,1639,53.63%,16.53%,1
桃園市,蘆竹區,0446,340,640,980,40,1020,2055,49.64%,16.55%,1
桃園市,蘆竹區,0447,400,559,959,35,994,2178,45.64%,18.37%,1
桃園市,蘆竹區,0448,328,574,902,29,931,1709,54.48%,19.19%,1
桃園市,蘆竹區,0449,284,594,878,38,916,1667,54.95%,17.04%,1
桃園市,蘆竹區,0450,322,593,915,31,946,1745,54.21%,18.45%,1
桃園市,蘆竹區,0451,371,659,1030,45,1075,1967,54.65%,18.86%,1
桃園市,蘆竹區,0452,329,658,987,21,1008,1802,55.94%,18.26%,1
桃園市,蘆竹區,0453,433,849,1282,36,1318,2727,48.33%,15.88%,1
桃園市,蘆竹區,0454,320,531,851,26,877,1868,46.95%,17.13%,1
桃園市,蘆竹區,0455,264,480,744,36,780,1537,50.75%,17.18%,1
桃園市,蘆竹區,0456,292,526,818,28,846,1616,52.35%,18.07%,1
桃園市,蘆竹區,0457,276,547,823,35,858,1483,57.86%,18.61%,1
桃園市,蘆竹區,0458,273,524,797,52,849,1689,50.27%,16.16%,1
桃園市,蘆竹區,0459,160,361,521,43,564,1318,42.79%,12.14%,1
桃園市,蘆竹區,0460,193,494,687,74,761,1203,63.26%,16.04%,1
桃園市,蘆竹區,0461,274,522,796,28,824,1771,46.53%,15.47%,1
桃園市,蘆竹區,0462,244,549,793,62,855,1832,46.67%,13.32%,1
桃園市,蘆竹區,0463,259,546,805,85,890,1763,50.48%,14.69%,1
桃園市,蘆竹區,0464,231,406,637,15,652,1497,43.55%,15.43%,1
桃園市,蘆竹區,0465,258,628,886,107,993,1671,59.43%,15.44%,1
桃園市,蘆竹區,0466,160,322,482,56,538,929,57.91%,17.22%,1
桃園市,蘆竹區,0467,255,533,788,89,877,1559,56.25%,16.36%,1
桃園市,蘆竹區,0468,231,540,771,22,793,1497,52.97%,15.43%,1
桃園市,蘆竹區,0469,233,624,857,55,912,1441,63.29%,16.17%,1
桃園市,蘆竹區,0470,201,496,697,49,746,1465,50.92%,13.72%,1
桃園市,蘆竹區,0471,137,362,499,37,536,1029,52.09%,13.31%,1
桃園市,大園區,0472,222,449,671,34,705,1538,45.84%,14.43%,1
桃園市,大園區,0473,203,419,622,33,655,1616,40.53%,12.56%,1
桃園市,大園區,0474,265,510,775,36,811,1437,56.44%,18.44%,1
桃園市,大園區,0475,241,575,816,36,852,1554,54.83%,15.51%,1
桃園市,大園區,0476,208,402,610,33,643,1237,51.98%,16.81%,1
桃園市,大園區,0477,213,436,649,49,698,1347,51.82%,15.81%,1
桃園市,大園區,0478,213,415,628,21,649,1261,51.47%,16.89%,1
桃園市,大園區,0479,189,416,605,34,639,1256,50.88%,15.05%,1
桃園市,大園區,0480,197,427,624,22,646,1370,47.15%,14.38%,1
桃園市,大園區,0481,209,506,715,41,756,1610,46.96%,12.98%,1
桃園市,大園區,0482,188,483,671,34,705,1419,49.68%,13.25%,1
桃園市,大園區,0483,173,461,634,21,655,1588,41.25%,10.89%,1
桃園市,大園區,0484,257,515,772,42,814,1612,50.5%,15.94%,1
桃園市,大園區,0485,201,481,682,34,716,1440,49.72%,13.96%,1
桃園市,大園區,0486,210,395,605,42,647,1326,48.79%,15.84%,1
桃園市,大園區,0487,230,534,764,55,819,1455,56.29%,15.81%,1
桃園市,大園區,0488,271,527,798,43,841,1562,53.84%,17.35%,1
桃園市,大園區,0489,223,473,696,31,727,1284,56.62%,17.37%,1
桃園市,大園區,0490,252,424,676,16,692,1454,47.59%,17.33%,1
桃園市,大園區,0491,299,443,742,15,757,1490,50.81%,20.07%,1
桃園市,大園區,0492,225,498,723,32,755,1617,46.69%,13.91%,1
桃園市,大園區,0493,269,501,770,58,828,1594,51.94%,16.88%,1
桃園市,大園區,0494,229,565,794,55,849,1650,51.45%,13.88%,1
桃園市,大園區,0495,205,473,678,21,699,1467,47.65%,13.97%,1
桃園市,大園區,0496,222,501,723,32,755,1494,50.54%,14.86%,1
桃園市,大園區,0497,224,503,727,49,776,1538,50.46%,14.56%,1
桃園市,大園區,0498,206,470,676,27,703,1397,50.32%,14.75%,1
桃園市,大園區,0499,237,509,746,32,778,1637,47.53%,14.48%,1
桃園市,大園區,0500,199,453,652,57,709,1452,48.83%,13.71%,1
桃園市,大園區,0501,239,565,804,47,851,1414,60.18%,16.9%,1
桃園市,大園區,0502,246,572,818,34,852,1670,51.02%,14.73%,1
桃園市,大園區,0503,258,507,765,19,784,1701,46.09%,15.17%,1
桃園市,大園區,0504,230,515,745,37,782,1813,43.13%,12.69%,1
桃園市,大園區,0505,256,518,774,31,805,1687,47.72%,15.17%,1
桃園市,大園區,0506,287,551,838,10,848,1650,51.39%,17.39%,1
桃園市,大園區,0507,289,548,837,50,887,1556,57.01%,18.57%,1
桃園市,大園區,0508,254,541,795,26,821,1844,44.52%,13.77%,1
桃園市,大園區,0509,181,418,599,54,653,1336,48.88%,13.55%,1
桃園市,大園區,0510,205,528,733,52,785,1414,55.52%,14.5%,1
桃園市,大園區,0511,214,485,699,42,741,1238,59.85%,17.29%,1
桃園市,大園區,0512,207,507,714,30,744,1227,60.64%,16.87%,1
桃園市,大園區,0513,202,376,578,27,605,1199,50.46%,16.85%,1
桃園市,大園區,0514,270,337,607,27,634,1349,47%,20.01%,1
桃園市,大園區,0515,175,375,550,25,575,1120,51.34%,15.63%,1
桃園市,大園區,0516,173,372,545,23,568,1080,52.59%,16.02%,1
桃園市,大園區,0517,199,423,622,37,659,1341,49.14%,14.84%,1
桃園市,大園區,0518,211,478,689,22,711,1345,52.86%,15.69%,1
桃園市,大園區,0519,196,466,662,46,708,1565,45.24%,12.52%,1
桃園市,大園區,0520,194,436,630,29,659,1519,43.38%,12.77%,1
桃園市,大園區,0521,275,662,937,50,987,2130,46.34%,12.91%,1
桃園市,龜山區,0217,123,338,461,23,484,874,55.38%,14.07%,1
桃園市,龜山區,0218,262,732,994,60,1054,2014,52.33%,13.01%,1
桃園市,龜山區,0219,392,633,1025,25,1050,2145,48.95%,18.28%,1
桃園市,龜山區,0220,222,683,905,41,946,1744,54.24%,12.73%,1
桃園市,龜山區,0221,263,688,951,69,1020,1885,54.11%,13.95%,1
桃園市,龜山區,0222,219,485,704,48,752,1546,48.64%,14.17%,1
桃園市,龜山區,0223,270,510,780,56,836,1684,49.64%,16.03%,1
桃園市,龜山區,0224,206,429,635,45,680,1477,46.04%,13.95%,1
桃園市,龜山區,0225,191,630,821,41,862,1528,56.41%,12.5%,1
桃園市,龜山區,0226,90,178,268,23,291,1428,20.38%,6.3%,1
桃園市,龜山區,0227,245,527,772,62,834,1525,54.69%,16.07%,1
桃園市,龜山區,0228,196,368,564,44,608,1041,58.41%,18.83%,1
桃園市,龜山區,0229,237,425,662,32,694,1404,49.43%,16.88%,1
桃園市,龜山區,0230,242,531,773,44,817,1478,55.28%,16.37%,1
桃園市,龜山區,0231,337,739,1076,53,1129,2178,51.84%,15.47%,1
桃園市,龜山區,0232,261,586,847,52,899,1672,53.77%,15.61%,1
桃園市,龜山區,0233,194,461,655,26,681,1376,49.49%,14.1%,1
桃園市,龜山區,0234,237,475,712,41,753,1480,50.88%,16.01%,1
桃園市,龜山區,0235,228,423,651,40,691,1258,54.93%,18.12%,1
桃園市,龜山區,0236,250,469,719,29,748,1464,51.09%,17.08%,1
桃園市,龜山區,0237,285,588,873,68,941,1844,51.03%,15.46%,1
桃園市,龜山區,0238,214,373,587,23,610,1169,52.18%,18.31%,1
桃園市,龜山區,0239,243,488,731,39,770,1921,40.08%,12.65%,1
桃園市,龜山區,0240,247,535,782,32,814,1694,48.05%,14.58%,1
桃園市,龜山區,0241,323,607,930,57,987,1771,55.73%,18.24%,1
桃園市,龜山區,0242,236,506,742,44,786,1665,47.21%,14.17%,1
桃園市,龜山區,0243,254,440,694,54,748,1439,51.98%,17.65%,1
桃園市,龜山區,0244,211,525,736,53,789,1728,45.66%,12.21%,1
桃園市,龜山區,0245,276,603,879,44,923,1788,51.62%,15.44%,1
桃園市,龜山區,0246,210,449,659,41,700,1465,47.78%,14.33%,1
桃園市,龜山區,0247,195,443,638,54,692,1659,41.71%,11.75%,1
桃園市,龜山區,0248,238,466,704,32,736,1693,43.47%,14.06%,1
桃園市,龜山區,0249,250,439,689,18,707,1818,38.89%,13.75%,1
桃園市,龜山區,0250,305,545,850,35,885,1752,50.51%,17.41%,1
桃園市,龜山區,0251,310,594,904,23,927,1818,50.99%,17.05%,1
桃園市,龜山區,0252,274,465,739,22,761,1499,50.77%,18.28%,1
桃園市,龜山區,0253,313,610,923,45,968,1916,50.52%,16.34%,1
桃園市,龜山區,0254,328,549,877,34,911,1804,50.5%,18.18%,1
桃園市,龜山區,0255,362,626,988,27,1015,2127,47.72%,17.02%,1
桃園市,龜山區,0256,162,330,492,48,540,1005,53.73%,16.12%,1
桃園市,龜山區,0257,243,476,719,40,759,1449,52.38%,16.77%,1
桃園市,龜山區,0258,256,412,668,57,725,1498,48.4%,17.09%,1
桃園市,龜山區,0259,301,616,917,57,974,2149,45.32%,14.01%,1
桃園市,龜山區,0260,211,431,642,46,688,1771,38.85%,11.91%,1
桃園市,龜山區,0261,141,272,413,21,434,841,51.61%,16.77%,1
桃園市,龜山區,0262,292,702,994,52,1046,2284,45.8%,12.78%,1
桃園市,龜山區,0263,176,412,588,67,655,1228,53.34%,14.33%,1
桃園市,龜山區,0264,255,612,867,49,916,1979,46.29%,12.89%,1
桃園市,龜山區,0265,171,441,612,32,644,1378,46.73%,12.41%,1
桃園市,龜山區,0266,164,332,496,36,532,1061,50.14%,15.46%,1
桃園市,龜山區,0267,271,592,863,58,921,1917,48.04%,14.14%,1
桃園市,龜山區,0268,267,605,872,29,901,1540,58.51%,17.34%,1
桃園市,龜山區,0269,247,503,750,27,777,1433,54.22%,17.24%,1
桃園市,龜山區,0270,242,474,716,27,743,1455,51.07%,16.63%,1
桃園市,龜山區,0271,393,767,1160,59,1219,2280,53.46%,17.24%,1
桃園市,龜山區,0272,221,530,751,39,790,1668,47.36%,13.25%,1
桃園市,龜山區,0273,309,587,896,32,928,1885,49.23%,16.39%,1
桃園市,龜山區,0274,420,466,886,21,907,1849,49.05%,22.71%,1
桃園市,龜山區,0275,441,493,934,14,948,1704,55.63%,25.88%,1
桃園市,龜山區,0276,194,386,580,41,621,1156,53.72%,16.78%,1
桃園市,龜山區,0277,285,560,845,46,891,2114,42.15%,13.48%,1
桃園市,龜山區,0278,296,523,819,36,855,1943,44%,15.23%,1
桃園市,龜山區,0279,312,494,806,32,838,1800,46.56%,17.33%,1
桃園市,龜山區,0280,369,563,932,43,975,2020,48.27%,18.27%,1
桃園市,龜山區,0281,239,463,702,30,732,1319,55.5%,18.12%,1
桃園市,龜山區,0282,408,729,1137,47,1184,2229,53.12%,18.3%,1
桃園市,龜山區,0283,332,593,925,30,955,1992,47.94%,16.67%,1
桃園市,龜山區,0284,371,630,1001,50,1051,2237,46.98%,16.58%,1
桃園市,龜山區,0285,468,529,997,32,1029,2133,48.24%,21.94%,1
桃園市,龜山區,0286,482,581,1063,41,1104,2187,50.48%,22.04%,1
桃園市,龜山區,0287,301,608,909,42,951,1959,48.55%,15.36%,1
桃園市,龜山區,0288,341,506,847,34,881,1910,46.13%,17.85%,1
桃園市,龜山區,0289,310,594,904,77,981,1840,53.32%,16.85%,1
桃園市,龜山區,0290,336,759,1095,38,1133,2266,50%,14.83%,1
桃園市,龜山區,0291,332,711,1043,30,1073,2387,44.95%,13.91%,1
桃園市,龜山區,0292,275,514,789,22,811,1692,47.93%,16.25%,1
桃園市,龜山區,0293,182,282,464,8,472,904,52.21%,20.13%,1
桃園市,龜山區,0294,284,476,760,25,785,1469,53.44%,19.33%,1
桃園市,八德區,0295,243,516,759,71,830,1761,47.13%,13.8%,1
桃園市,八德區,0296,273,444,717,14,731,1804,40.52%,15.13%,1
桃園市,八德區,0297,169,322,491,22,513,1813,28.3%,9.32%,1
桃園市,八德區,0298,261,537,798,27,825,1784,46.24%,14.63%,1
桃園市,八德區,0299,305,620,925,23,948,2257,42%,13.51%,1
桃園市,八德區,0300,237,532,769,27,796,1857,42.86%,12.76%,1
桃園市,八德區,0301,446,526,972,32,1004,2261,44.41%,19.73%,1
桃園市,八德區,0302,291,655,946,42,988,1903,51.92%,15.29%,1
桃園市,八德區,0303,259,663,922,58,980,1955,50.13%,13.25%,1
桃園市,八德區,0304,264,447,711,18,729,1665,43.78%,15.86%,1
桃園市,八德區,0305,273,457,730,56,786,1431,54.93%,19.08%,1
桃園市,八德區,0306,204,459,663,34,697,1263,55.19%,16.15%,1
桃園市,八德區,0307,261,560,821,55,876,1583,55.34%,16.49%,1
桃園市,八德區,0308,200,456,656,28,684,1246,54.9%,16.05%,1
桃園市,八德區,0309,204,490,694,38,732,1356,53.98%,15.04%,1
桃園市,八德區,0310,263,573,836,66,902,1630,55.34%,16.13%,1
桃園市,八德區,0311,219,535,754,38,792,1586,49.94%,13.81%,1
桃園市,八德區,0312,263,543,806,63,869,1649,52.7%,15.95%,1
桃園市,八德區,0313,243,571,814,81,895,1910,46.86%,12.72%,1
桃園市,八德區,0314,232,595,827,74,901,1612,55.89%,14.39%,1
桃園市,八德區,0315,241,569,810,46,856,1640,52.2%,14.7%,1
桃園市,八德區,0316,219,419,638,41,679,1303,52.11%,16.81%,1
桃園市,八德區,0317,255,507,762,45,807,1413,57.11%,18.05%,1
桃園市,八德區,0318,243,587,830,42,872,1711,50.96%,14.2%,1
桃園市,八德區,0319,221,514,735,70,805,1562,51.54%,14.15%,1
桃園市,八德區,0320,239,585,824,61,885,1735,51.01%,13.78%,1
桃園市,八德區,0321,269,548,817,31,848,1658,51.15%,16.22%,1
桃園市,八德區,0322,161,414,575,36,611,1022,59.78%,15.75%,1
桃園市,八德區,0323,215,510,725,42,767,1673,45.85%,12.85%,1
桃園市,八德區,0324,248,577,825,37,862,1741,49.51%,14.24%,1
桃園市,八德區,0325,288,719,1007,58,1065,2110,50.47%,13.65%,1
桃園市,八德區,0326,144,446,590,27,617,1145,53.89%,12.58%,1
桃園市,八德區,0327,143,439,582,28,610,1010,60.4%,14.16%,1
桃園市,八德區,0328,270,519,789,31,820,1848,44.37%,14.61%,1
桃園市,八德區,0329,219,463,682,38,720,1334,53.97%,16.42%,1
桃園市,八德區,0330,187,381,568,23,591,1349,43.81%,13.86%,1
桃園市,八德區,0331,254,482,736,30,766,1341,57.12%,18.94%,1
桃園市,八德區,0332,178,492,670,9,679,1178,57.64%,15.11%,1
桃園市,八德區,0333,216,486,702,43,745,1374,54.22%,15.72%,1
桃園市,八德區,0334,245,439,684,58,742,1462,50.75%,16.76%,1
桃園市,八德區,0335,237,561,798,60,858,1943,44.16%,12.2%,1
桃園市,八德區,0336,254,438,692,71,763,1928,39.57%,13.17%,1
桃園市,八德區,0337,217,440,657,26,683,1403,48.68%,15.47%,1
桃園市,八德區,0338,242,509,751,56,807,1672,48.27%,14.47%,1
桃園市,八德區,0339,301,574,875,32,907,1947,46.58%,15.46%,1
桃園市,八德區,0340,184,429,613,45,658,1200,54.83%,15.33%,1
桃園市,八德區,0341,264,579,843,56,899,1895,47.44%,13.93%,1
桃園市,八德區,0342,303,553,856,59,915,1988,46.03%,15.24%,1
桃園市,八德區,0343,310,674,984,65,1049,2006,52.29%,15.45%,1
桃園市,八德區,0344,281,616,897,11,908,2061,44.06%,13.63%,1
桃園市,八德區,0345,274,652,926,50,976,2108,46.3%,13%,1
桃園市,八德區,0346,263,579,842,51,893,1862,47.96%,14.12%,1
桃園市,八德區,0347,263,500,763,23,786,1681,46.76%,15.65%,1
桃園市,八德區,0348,195,459,654,57,711,1317,53.99%,14.81%,1
桃園市,八德區,0349,412,747,1159,53,1212,2093,57.91%,19.68%,1
桃園市,八德區,0350,228,574,802,51,853,1499,56.9%,15.21%,1
桃園市,八德區,0351,258,597,855,52,907,1782,50.9%,14.48%,1
桃園市,八德區,0352,281,574,855,31,886,1763,50.26%,15.94%,1
桃園市,八德區,0353,198,421,619,51,670,1226,54.65%,16.15%,1
桃園市,八德區,0354,241,450,691,30,721,1311,55%,18.38%,1
桃園市,八德區,0355,219,413,632,34,666,1170,56.92%,18.72%,1
桃園市,八德區,0356,201,490,691,30,721,1313,54.91%,15.31%,1
桃園市,八德區,0357,202,421,623,30,653,1186,55.06%,17.03%,1
桃園市,八德區,0358,234,449,683,41,724,1481,48.89%,15.8%,1
桃園市,八德區,0359,321,643,964,63,1027,1998,51.4%,16.07%,1
桃園市,八德區,0360,155,334,489,26,515,916,56.22%,16.92%,1
桃園市,八德區,0361,272,609,881,44,925,1943,47.61%,14%,1
桃園市,八德區,0362,298,657,955,35,990,2076,47.69%,14.35%,1
桃園市,八德區,0363,206,473,679,54,733,1363,53.78%,15.11%,1
桃園市,八德區,0364,227,512,739,51,790,1491,52.98%,15.22%,1
桃園市,八德區,0365,220,476,696,66,762,1474,51.7%,14.93%,1
桃園市,八德區,0366,27,134,161,13,174,718,24.23%,3.76%,1
桃園市,八德區,0367,223,450,673,58,731,1386,52.74%,16.09%,1
桃園市,八德區,0368,211,492,703,70,773,1487,51.98%,14.19%,1
桃園市,八德區,0369,195,534,729,83,812,1552,52.32%,12.56%,1
桃園市,八德區,0370,150,407,557,64,621,1255,49.48%,11.95%,1
桃園市,八德區,0371,250,543,793,56,849,1505,56.41%,16.61%,1
桃園市,八德區,0372,201,452,653,50,703,1436,48.96%,14%,1
桃園市,八德區,0373,291,528,819,60,879,1618,54.33%,17.99%,1
桃園市,八德區,0374,223,580,803,54,857,1685,50.86%,13.23%,1
桃園市,八德區,0375,273,526,799,44,843,1835,45.94%,14.88%,1
桃園市,八德區,0376,304,592,896,56,952,1881,50.61%,16.16%,1
桃園市,八德區,0377,254,579,833,36,869,1766,49.21%,14.38%,1
桃園市,八德區,0378,265,593,858,66,924,1817,50.85%,14.58%,1
桃園市,八德區,0379,349,754,1103,26,1129,2198,51.36%,15.88%,1
桃園市,八德區,0380,304,580,884,25,909,1732,52.48%,17.55%,1
桃園市,八德區,0381,372,677,1049,25,1074,2089,51.41%,17.81%,1
桃園市,八德區,0382,212,454,666,31,697,1257,55.45%,16.87%,1
桃園市,八德區,0383,212,408,620,36,656,1267,51.78%,16.73%,1
桃園市,八德區,0384,258,498,756,19,775,1427,54.31%,18.08%,1
桃園市,八德區,0385,301,622,923,46,969,1685,57.51%,17.86%,1
桃園市,八德區,0386,287,608,895,51,946,1748,54.12%,16.42%,1
桃園市,八德區,0387,313,793,1106,39,1145,1650,69.39%,18.97%,1
桃園市,八德區,0388,276,480,756,55,811,1478,54.87%,18.67%,1
桃園市,八德區,0389,242,584,826,48,874,1607,54.39%,15.06%,1
桃園市,八德區,0390,290,645,935,88,1023,1841,55.57%,15.75%,1
桃園市,八德區,0391,352,646,998,53,1051,2082,50.48%,16.91%,1
桃園市,八德區,0392,256,603,859,46,905,1959,46.2%,13.07%,1
桃園市,八德區,0393,372,701,1073,54,1127,2209,51.02%,16.84%,1
桃園市,八德區,0394,318,613,931,38,969,1864,51.98%,17.06%,1
桃園市,八德區,0395,331,589,920,41,961,2000,48.05%,16.55%,1
桃園市,龍潭區,1008,205,534,739,23,762,1482,51.42%,13.83%,1
桃園市,龍潭區,1009,229,509,738,34,772,1528,50.52%,14.99%,1
桃園市,龍潭區,1010,214,539,753,41,794,1503,52.83%,14.24%,1
桃園市,龍潭區,1011,205,536,741,53,794,1568,50.64%,13.07%,1
桃園市,龍潭區,1012,169,398,567,64,631,1216,51.89%,13.9%,1
桃園市,龍潭區,1013,273,612,885,64,949,2088,45.45%,13.07%,1
桃園市,龍潭區,1014,295,753,1048,65,1113,1987,56.01%,14.85%,1
桃園市,龍潭區,1015,270,624,894,37,931,1586,58.7%,17.02%,1
桃園市,龍潭區,1016,183,410,593,35,628,1221,51.43%,14.99%,1
桃園市,龍潭區,1017,154,453,607,39,646,1134,56.97%,13.58%,1
桃園市,龍潭區,1018,261,682,943,55,998,2081,47.96%,12.54%,1
桃園市,龍潭區,1019,254,638,892,28,920,1925,47.79%,13.19%,1
桃園市,龍潭區,1020,354,756,1110,29,1139,2095,54.37%,16.9%,1
桃園市,龍潭區,1021,344,767,1111,50,1161,2040,56.91%,16.86%,1
桃園市,龍潭區,1022,249,586,835,52,887,1790,49.55%,13.91%,1
桃園市,龍潭區,1023,273,666,939,80,1019,1872,54.43%,14.58%,1
桃園市,龍潭區,1024,263,653,916,57,973,1726,56.37%,15.24%,1
桃園市,龍潭區,1025,252,670,922,55,977,1792,54.52%,14.06%,1
桃園市,龍潭區,1026,213,507,720,33,753,1398,53.86%,15.24%,1
桃園市,龍潭區,1027,181,473,654,30,684,1345,50.86%,13.46%,1
桃園市,龍潭區,1028,210,517,727,44,771,1409,54.72%,14.9%,1
桃園市,龍潭區,1029,231,410,641,17,658,1362,48.31%,16.96%,1
桃園市,龍潭區,1030,289,607,896,43,939,1650,56.91%,17.52%,1
桃園市,龍潭區,1031,205,573,778,55,833,1597,52.16%,12.84%,1
桃園市,龍潭區,1032,216,506,722,26,748,1410,53.05%,15.32%,1
桃園市,龍潭區,1033,194,472,666,41,707,1275,55.45%,15.22%,1
桃園市,龍潭區,1034,329,724,1053,58,1111,1909,58.2%,17.23%,1
桃園市,龍潭區,1035,292,776,1068,42,1110,2024,54.84%,14.43%,1
桃園市,龍潭區,1036,277,755,1032,46,1078,2002,53.85%,13.84%,1
桃園市,龍潭區,1037,296,684,980,35,1015,1786,56.83%,16.57%,1
桃園市,龍潭區,1038,284,629,913,43,956,1756,54.44%,16.17%,1
桃園市,龍潭區,1039,287,710,997,26,1023,1830,55.9%,15.68%,1
桃園市,龍潭區,1040,270,694,964,35,999,1697,58.87%,15.91%,1
桃園市,龍潭區,1041,231,597,828,28,856,1519,56.35%,15.21%,1
桃園市,龍潭區,1042,233,619,852,40,892,1805,49.42%,12.91%,1
桃園市,龍潭區,1043,211,570,781,28,809,1792,45.15%,11.77%,1
桃園市,龍潭區,1044,205,618,823,54,877,1500,58.47%,13.67%,1
桃園市,龍潭區,1045,195,489,684,32,716,1427,50.18%,13.67%,1
桃園市,龍潭區,1046,169,443,612,42,654,1444,45.29%,11.7%,1
桃園市,龍潭區,1047,173,448,621,51,672,1321,50.87%,13.1%,1
桃園市,龍潭區,1048,252,438,690,31,721,1215,59.34%,20.74%,1
桃園市,龍潭區,1049,174,476,650,45,695,1297,53.59%,13.42%,1
桃園市,龍潭區,1050,190,482,672,17,689,1407,48.97%,13.5%,1
桃園市,龍潭區,1051,215,523,738,36,774,1564,49.49%,13.75%,1
桃園市,龍潭區,1052,177,482,659,41,700,1317,53.15%,13.44%,1
桃園市,龍潭區,1053,123,350,473,35,508,1023,49.66%,12.02%,1
桃園市,龍潭區,1054,258,627,885,50,935,1721,54.33%,14.99%,1
桃園市,龍潭區,1055,267,657,924,44,968,1764,54.88%,15.14%,1
桃園市,龍潭區,1056,195,573,768,58,826,1499,55.1%,13.01%,1
桃園市,龍潭區,1057,260,706,966,40,1006,2151,46.77%,12.09%,1
桃園市,龍潭區,1058,229,600,829,33,862,1524,56.56%,15.03%,1
桃園市,龍潭區,1059,228,618,846,29,875,1456,60.1%,15.66%,1
桃園市,龍潭區,1060,275,807,1082,30,1112,1847,60.21%,14.89%,1
桃園市,龍潭區,1061,295,821,1116,27,1143,1899,60.19%,15.53%,1
桃園市,龍潭區,1062,208,695,903,34,937,1725,54.32%,12.06%,1
桃園市,龍潭區,1063,238,725,963,50,1013,1665,60.84%,14.29%,1
桃園市,龍潭區,1064,247,549,796,34,830,1649,50.33%,14.98%,1
桃園市,龍潭區,1065,188,519,707,39,746,1539,48.47%,12.22%,1
桃園市,龍潭區,1066,236,606,842,43,885,1541,57.43%,15.31%,1
桃園市,龍潭區,1067,239,476,715,39,754,1375,54.84%,17.38%,1
桃園市,龍潭區,1068,230,522,752,30,782,1453,53.82%,15.83%,1
桃園市,龍潭區,1069,181,387,568,42,610,1074,56.8%,16.85%,1
桃園市,龍潭區,1070,242,494,736,20,756,1299,58.2%,18.63%,1
桃園市,龍潭區,1071,97,216,313,14,327,678,48.23%,14.31%,1
桃園市,平鎮區,0801,206,487,693,35,728,1487,48.96%,13.85%,1
桃園市,平鎮區,0802,203,523,726,37,763,1453,52.51%,13.97%,1
桃園市,平鎮區,0803,255,525,780,33,813,1491,54.53%,17.1%,1
桃園市,平鎮區,0804,194,473,667,37,704,1346,52.3%,14.41%,1
桃園市,平鎮區,0805,218,595,813,30,843,1660,50.78%,13.13%,1
桃園市,平鎮區,0806,234,665,899,27,926,1921,48.2%,12.18%,1
桃園市,平鎮區,0807,276,747,1023,50,1073,1974,54.36%,13.98%,1
桃園市,平鎮區,0808,267,632,899,37,936,1867,50.13%,14.3%,1
桃園市,平鎮區,0809,254,646,900,28,928,1786,51.96%,14.22%,1
桃園市,平鎮區,0810,202,456,658,26,684,1634,41.86%,12.36%,1
桃園市,平鎮區,0811,167,408,575,29,604,1080,55.93%,15.46%,1
桃園市,平鎮區,0812,254,514,768,30,798,1514,52.71%,16.78%,1
桃園市,平鎮區,0813,237,580,817,44,861,1918,44.89%,12.36%,1
桃園市,平鎮區,0814,151,433,584,73,657,1182,55.58%,12.77%,1
桃園市,平鎮區,0815,228,540,768,36,804,1667,48.23%,13.68%,1
桃園市,平鎮區,0816,215,520,735,27,762,1640,46.46%,13.11%,1
桃園市,平鎮區,0817,255,547,802,28,830,1603,51.78%,15.91%,1
桃園市,平鎮區,0818,227,626,853,18,871,1556,55.98%,14.59%,1
桃園市,平鎮區,0819,235,588,823,32,855,1697,50.38%,13.85%,1
桃園市,平鎮區,0820,160,391,551,20,571,1130,50.53%,14.16%,1
桃園市,平鎮區,0821,282,423,705,25,730,1196,61.04%,23.58%,1
桃園市,平鎮區,0822,238,617,855,29,884,1685,52.46%,14.12%,1
桃園市,平鎮區,0823,239,598,837,33,870,1532,56.79%,15.6%,1
桃園市,平鎮區,0824,233,548,781,36,817,1564,52.24%,14.9%,1
桃園市,平鎮區,0825,209,553,762,33,795,1824,43.59%,11.46%,1
桃園市,平鎮區,0826,283,638,921,25,946,1912,49.48%,14.8%,1
桃園市,平鎮區,0827,131,385,516,48,564,1048,53.82%,12.5%,1
桃園市,平鎮區,0828,188,479,667,41,708,1259,56.24%,14.93%,1
桃園市,平鎮區,0829,150,391,541,26,567,1061,53.44%,14.14%,1
桃園市,平鎮區,0830,159,459,618,25,643,1072,59.98%,14.83%,1
桃園市,平鎮區,0831,246,629,875,45,920,1788,51.45%,13.76%,1
桃園市,平鎮區,0832,224,552,776,17,793,1510,52.52%,14.83%,1
桃園市,平鎮區,0833,196,494,690,50,740,1403,52.74%,13.97%,1
桃園市,平鎮區,0834,217,503,720,47,767,1407,54.51%,15.42%,1
桃園市,平鎮區,0835,306,665,971,45,1016,1901,53.45%,16.1%,1
桃園市,平鎮區,0836,270,625,895,26,921,1994,46.19%,13.54%,1
桃園市,平鎮區,0837,270,602,872,29,901,1730,52.08%,15.61%,1
桃園市,平鎮區,0838,327,638,965,43,1008,1905,52.91%,17.17%,1
桃園市,平鎮區,0839,303,626,929,11,940,1723,54.56%,17.59%,1
桃園市,平鎮區,0840,505,181,686,48,734,1307,56.16%,38.64%,1
桃園市,平鎮區,0841,225,492,717,33,750,1337,56.1%,16.83%,1
桃園市,平鎮區,0842,191,426,617,23,640,980,65.31%,19.49%,1
桃園市,平鎮區,0843,299,586,885,49,934,1818,51.38%,16.45%,1
桃園市,平鎮區,0844,253,516,769,38,807,1463,55.16%,17.29%,1
桃園市,平鎮區,0845,233,452,685,35,720,1213,59.36%,19.21%,1
桃園市,平鎮區,0846,196,411,607,28,635,1085,58.53%,18.06%,1
桃園市,平鎮區,0847,180,528,708,31,739,1458,50.69%,12.35%,1
桃園市,平鎮區,0848,214,521,735,45,780,1408,55.4%,15.2%,1
桃園市,平鎮區,0849,232,435,667,46,713,1396,51.07%,16.62%,1
桃園市,平鎮區,0850,232,414,646,23,669,1044,64.08%,22.22%,1
桃園市,平鎮區,0851,198,421,619,14,633,1124,56.32%,17.62%,1
桃園市,平鎮區,0852,278,529,807,16,823,1517,54.25%,18.33%,1
桃園市,平鎮區,0853,288,522,810,21,831,1571,52.9%,18.33%,1
桃園市,平鎮區,0854,300,665,965,28,993,1752,56.68%,17.12%,1
桃園市,平鎮區,0855,255,581,836,32,868,1434,60.53%,17.78%,1
桃園市,平鎮區,0856,314,637,951,33,984,1710,57.54%,18.36%,1
桃園市,平鎮區,0857,266,569,835,30,865,1555,55.63%,17.11%,1
桃園市,平鎮區,0858,338,617,955,35,990,2051,48.27%,16.48%,1
桃園市,平鎮區,0859,261,504,765,29,794,1477,53.76%,17.67%,1
桃園市,平鎮區,0860,252,525,777,32,809,1501,53.9%,16.79%,1
桃園市,平鎮區,0861,232,502,734,47,781,1405,55.59%,16.51%,1
桃園市,平鎮區,0862,250,576,826,50,876,1656,52.9%,15.1%,1
桃園市,平鎮區,0863,300,572,872,32,904,1921,47.06%,15.62%,1
桃園市,平鎮區,0864,247,472,719,24,743,1717,43.27%,14.39%,1
桃園市,平鎮區,0865,230,451,681,40,721,1319,54.66%,17.44%,1
桃園市,平鎮區,0866,271,581,852,41,893,1745,51.17%,15.53%,1
桃園市,平鎮區,0867,266,614,880,53,933,1721,54.21%,15.46%,1
桃園市,平鎮區,0868,196,453,649,24,673,1206,55.8%,16.25%,1
桃園市,平鎮區,0869,255,493,748,30,778,1202,64.73%,21.21%,1
桃園市,平鎮區,0870,183,492,675,30,705,1208,58.36%,15.15%,1
桃園市,平鎮區,0871,214,523,737,25,762,1267,60.14%,16.89%,1
桃園市,平鎮區,0872,188,398,586,24,610,1094,55.76%,17.18%,1
桃園市,平鎮區,0873,247,531,778,45,823,1394,59.04%,17.72%,1
桃園市,平鎮區,0874,252,464,716,14,730,1215,60.08%,20.74%,1
桃園市,平鎮區,0875,179,373,552,33,585,1010,57.92%,17.72%,1
桃園市,平鎮區,0876,223,479,702,23,725,1261,57.49%,17.68%,1
桃園市,平鎮區,0877,220,525,745,31,776,1314,59.06%,16.74%,1
桃園市,平鎮區,0878,117,276,393,28,421,722,58.31%,16.2%,1
桃園市,平鎮區,0879,131,296,427,22,449,839,53.52%,15.61%,1
桃園市,平鎮區,0880,222,521,743,29,772,1399,55.18%,15.87%,1
桃園市,平鎮區,0881,330,613,943,43,986,1968,50.1%,16.77%,1
桃園市,平鎮區,0882,267,600,867,29,896,1672,53.59%,15.97%,1
桃園市,平鎮區,0883,181,447,628,23,651,2213,29.42%,8.18%,1
桃園市,平鎮區,0884,224,354,578,12,590,949,62.17%,23.6%,1
桃園市,平鎮區,0885,323,613,936,34,970,1621,59.84%,19.93%,1
桃園市,平鎮區,0886,275,533,808,33,841,1643,51.19%,16.74%,1
桃園市,平鎮區,0887,332,636,968,41,1009,1844,54.72%,18%,1
桃園市,平鎮區,0888,294,609,903,41,944,1752,53.88%,16.78%,1
桃園市,平鎮區,0889,239,504,743,48,791,1577,50.16%,15.16%,1
桃園市,平鎮區,0890,252,548,800,29,829,1517,54.65%,16.61%,1
桃園市,平鎮區,0891,171,414,585,27,612,1039,58.9%,16.46%,1
桃園市,平鎮區,0892,214,533,747,31,778,1318,59.03%,16.24%,1
桃園市,平鎮區,0893,236,601,837,38,875,1636,53.48%,14.43%,1
桃園市,平鎮區,0894,245,469,714,33,747,1316,56.76%,18.62%,1
桃園市,平鎮區,0895,275,524,799,27,826,1474,56.04%,18.66%,1
桃園市,平鎮區,0896,192,474,666,45,711,1480,48.04%,12.97%,1
桃園市,平鎮區,0897,185,507,692,19,711,1330,53.46%,13.91%,1
桃園市,平鎮區,0898,202,445,647,33,680,1228,55.37%,16.45%,1
桃園市,平鎮區,0899,246,533,779,33,812,1377,58.97%,17.86%,1
桃園市,平鎮區,0900,218,484,702,27,729,1198,60.85%,18.2%,1
桃園市,平鎮區,0901,205,515,720,27,747,1231,60.68%,16.65%,1
桃園市,平鎮區,0902,215,451,666,48,714,1243,57.44%,17.3%,1
桃園市,平鎮區,0903,224,578,802,39,841,1590,52.89%,14.09%,1
桃園市,平鎮區,0904,189,509,698,37,735,1366,53.81%,13.84%,1
桃園市,平鎮區,0905,187,506,693,45,738,1332,55.41%,14.04%,1
桃園市,平鎮區,0906,163,401,564,19,583,1201,48.54%,13.57%,1
桃園市,平鎮區,0907,234,524,758,26,784,1668,47%,14.03%,1
桃園市,平鎮區,0908,192,459,651,54,705,1351,52.18%,14.21%,1
桃園市,平鎮區,0909,196,484,680,21,701,1460,48.01%,13.42%,1
桃園市,平鎮區,0910,354,541,895,30,925,1841,50.24%,19.23%,1
桃園市,平鎮區,0911,216,478,694,18,712,1475,48.27%,14.64%,1
桃園市,平鎮區,0912,140,400,540,19,559,1011,55.29%,13.85%,1
桃園市,平鎮區,0913,138,348,486,34,520,1052,49.43%,13.12%,1
桃園市,平鎮區,0914,198,466,664,42,706,1154,61.18%,17.16%,1
桃園市,平鎮區,0915,231,572,803,21,824,1645,50.09%,14.04%,1
桃園市,平鎮區,0916,217,497,714,60,774,1539,50.29%,14.1%,1
桃園市,平鎮區,0917,210,495,705,47,752,1385,54.3%,15.16%,1
桃園市,平鎮區,0918,308,398,706,38,744,1395,53.33%,22.08%,1
桃園市,平鎮區,0919,226,607,833,36,869,1711,50.79%,13.21%,1
桃園市,平鎮區,0920,233,559,792,42,834,1631,51.13%,14.29%,1
桃園市,平鎮區,0921,199,401,600,21,621,1110,55.95%,17.93%,1
桃園市,平鎮區,0922,235,786,1021,37,1058,1931,54.79%,12.17%,1
桃園市,平鎮區,0923,161,435,596,25,621,1127,55.1%,14.29%,1
桃園市,平鎮區,0924,217,514,731,47,778,1414,55.02%,15.35%,1
桃園市,平鎮區,0925,214,576,790,51,841,1609,52.27%,13.3%,1
桃園市,新屋區,1072,212,533,745,30,775,1306,59.34%,16.23%,1
桃園市,新屋區,1073,250,574,824,39,863,1556,55.46%,16.07%,1
桃園市,新屋區,1074,311,746,1057,54,1111,1849,60.09%,16.82%,1
桃園市,新屋區,1075,375,779,1154,70,1224,2096,58.4%,17.89%,1
桃園市,新屋區,1076,203,547,750,47,797,1517,52.54%,13.38%,1
桃園市,新屋區,1077,325,814,1139,65,1204,2095,57.47%,15.51%,1
桃園市,新屋區,1078,242,579,821,40,861,1856,46.39%,13.04%,1
桃園市,新屋區,1079,275,757,1032,67,1099,1986,55.34%,13.85%,1
桃園市,新屋區,1080,189,466,655,49,704,1425,49.4%,13.26%,1
桃園市,新屋區,1081,179,471,650,35,685,1385,49.46%,12.92%,1
桃園市,新屋區,1082,231,497,728,53,781,1271,61.45%,18.17%,1
桃園市,新屋區,1083,168,473,641,41,682,1271,53.66%,13.22%,1
桃園市,新屋區,1084,202,457,659,43,702,1234,56.89%,16.37%,1
桃園市,新屋區,1085,168,393,561,45,606,1085,55.85%,15.48%,1
桃園市,新屋區,1086,280,813,1093,40,1133,1992,56.88%,14.06%,1
桃園市,新屋區,1087,318,800,1118,74,1192,2032,58.66%,15.65%,1
桃園市,新屋區,1088,172,472,644,61,705,1291,54.61%,13.32%,1
桃園市,新屋區,1089,177,511,688,40,728,1401,51.96%,12.63%,1
桃園市,新屋區,1090,171,434,605,42,647,1106,58.5%,15.46%,1
桃園市,新屋區,1091,140,334,474,17,491,908,54.07%,15.42%,1
桃園市,新屋區,1092,102,264,366,42,408,663,61.54%,15.38%,1
桃園市,新屋區,1093,133,405,538,47,585,1088,53.77%,12.22%,1
桃園市,新屋區,1094,158,455,613,56,669,1050,63.71%,15.05%,1
桃園市,新屋區,1095,121,374,495,27,522,896,58.26%,13.5%,1
桃園市,新屋區,1096,218,537,755,62,817,1369,59.68%,15.92%,1
桃園市,新屋區,1097,119,350,469,31,500,995,50.25%,11.96%,1
桃園市,新屋區,1098,102,289,391,32,423,741,57.09%,13.77%,1
桃園市,新屋區,1099,155,370,525,57,582,943,61.72%,16.44%,1
桃園市,新屋區,1100,208,609,817,82,899,1714,52.45%,12.14%,1
桃園市,新屋區,1101,182,544,726,21,747,1340,55.75%,13.58%,1
桃園市,觀音區,1102,194,435,629,40,669,1371,48.8%,14.15%,1
桃園市,觀音區,1103,164,394,558,28,586,1362,43.02%,12.04%,1
桃園市,觀音區,1104,156,314,470,63,533,997,53.46%,15.65%,1
桃園市,觀音區,1105,179,460,639,27,666,1407,47.33%,12.72%,1
桃園市,觀音區,1106,270,588,858,30,888,1692,52.48%,15.96%,1
桃園市,觀音區,1107,179,461,640,32,672,1279,52.54%,14%,1
桃園市,觀音區,1108,111,289,400,15,415,791,52.47%,14.03%,1
桃園市,觀音區,1109,154,322,476,30,506,892,56.73%,17.26%,1
桃園市,觀音區,1110,149,362,511,20,531,886,59.93%,16.82%,1
桃園市,觀音區,1111,105,258,363,35,398,712,55.9%,14.75%,1
桃園市,觀音區,1112,237,490,727,87,814,1609,50.59%,14.73%,1
桃園市,觀音區,1113,195,458,653,52,705,1274,55.34%,15.31%,1
桃園市,觀音區,1114,166,403,569,33,602,1351,44.56%,12.29%,1
桃園市,觀音區,1115,236,455,691,38,729,1262,57.77%,18.7%,1
桃園市,觀音區,1116,209,437,646,61,707,1242,56.92%,16.83%,1
桃園市,觀音區,1117,247,483,730,44,774,1461,52.98%,16.91%,1
桃園市,觀音區,1118,253,545,798,44,842,1613,52.2%,15.69%,1
桃園市,觀音區,1119,217,520,737,52,789,1479,53.35%,14.67%,1
桃園市,觀音區,1120,218,463,681,60,741,1552,47.74%,14.05%,1
桃園市,觀音區,1121,237,507,744,30,774,1517,51.02%,15.62%,1
桃園市,觀音區,1122,244,534,778,58,836,1691,49.44%,14.43%,1
桃園市,觀音區,1123,204,421,625,20,645,1157,55.75%,17.63%,1
桃園市,觀音區,1124,206,496,702,46,748,1455,51.41%,14.16%,1
桃園市,觀音區,1125,175,396,571,39,610,1150,53.04%,15.22%,1
桃園市,觀音區,1126,162,426,588,37,625,1112,56.21%,14.57%,1
桃園市,觀音區,1127,177,417,594,22,616,1251,49.24%,14.15%,1
桃園市,觀音區,1128,225,487,712,70,782,1446,54.08%,15.56%,1
桃園市,觀音區,1129,243,473,716,74,790,1493,52.91%,16.28%,1
桃園市,觀音區,1130,190,451,641,60,701,1339,52.35%,14.19%,1
桃園市,觀音區,1131,189,445,634,36,670,1137,58.93%,16.62%,1
桃園市,觀音區,1132,129,359,488,38,526,1043,50.43%,12.37%,1
桃園市,觀音區,1133,142,290,432,30,462,993,46.53%,14.3%,1
桃園市,觀音區,1134,152,309,461,37,498,975,51.08%,15.59%,1
桃園市,觀音區,1135,272,591,863,45,908,2029,44.75%,13.41%,1
桃園市,觀音區,1136,297,628,925,39,964,1765,54.62%,16.83%,1
桃園市,觀音區,1137,265,618,883,41,924,1809,51.08%,14.65%,1
桃園市,觀音區,1138,267,606,873,32,905,1869,48.42%,14.29%,1
桃園市,觀音區,1139,219,542,761,48,809,1870,43.26%,11.71%,1
桃園市,觀音區,1140,215,427,642,49,691,1932,35.77%,11.13%,1
桃園市,觀音區,1141,103,281,384,13,397,899,44.16%,11.46%,1
桃園市,觀音區,1142,124,293,417,14,431,985,43.76%,12.59%,1
桃園市,復興區,0581,197,834,1031,85,1116,1991,56.05%,9.89%,1
桃園市,復興區,0582,143,611,754,47,801,1392,57.54%,10.27%,1
桃園市,復興區,0583,67,229,296,20,316,564,56.03%,11.88%,1
桃園市,復興區,0584,93,279,372,18,390,716,54.47%,12.99%,1
桃園市,復興區,0585,132,464,596,49,645,1016,63.48%,12.99%,1
桃園市,復興區,0586,82,214,296,8,304,669,45.44%,12.26%,1
桃園市,復興區,0587,71,305,376,9,385,760,50.66%,9.34%,1
桃園市,復興區,0588,54,344,398,17,415,751,55.26%,7.19%,1
桃園市,復興區,0589,42,215,257,7,264,683,38.65%,6.15%,1
桃園市,復興區,0590,86,565,651,31,682,1224,55.72%,7.03%,1
臺中市,中區,1070,336,615,951,73,1024,1652,61.99%,20.34%,1
臺中市,中區,1071,261,543,804,47,851,1531,55.58%,17.05%,1
臺中市,中區,1072,228,557,785,30,815,1431,56.95%,15.93%,1
臺中市,中區,1073,173,407,580,36,616,1060,58.11%,16.32%,1
臺中市,中區,1074,168,348,516,34,550,982,56.01%,17.11%,1
臺中市,中區,1075,211,424,635,53,688,1191,57.77%,17.72%,1
臺中市,中區,1076,160,293,453,41,494,855,57.78%,18.71%,1
臺中市,中區,1077,152,364,516,28,544,1135,47.93%,13.39%,1
臺中市,中區,1078,106,300,406,14,420,705,59.57%,15.04%,1
臺中市,中區,1079,174,405,579,31,610,1009,60.46%,17.24%,1
臺中市,中區,1080,221,442,663,65,728,1304,55.83%,16.95%,1
臺中市,中區,1081,261,631,892,37,929,1841,50.46%,14.18%,1
臺中市,東區,1148,147,285,432,17,449,1138,39.46%,12.92%,1
臺中市,東區,1149,169,401,570,20,590,984,59.96%,17.17%,1
臺中市,東區,1150,145,346,491,30,521,877,59.41%,16.53%,1
臺中市,東區,1151,215,430,645,43,688,1070,64.3%,20.09%,1
臺中市,東區,1152,207,434,641,47,688,1106,62.21%,18.72%,1
臺中市,東區,1153,171,361,532,47,579,953,60.76%,17.94%,1
臺中市,東區,1154,228,478,706,26,732,1195,61.26%,19.08%,1
臺中市,東區,1155,206,472,678,39,717,1251,57.31%,16.47%,1
臺中市,東區,1156,217,458,675,33,708,1190,59.5%,18.24%,1
臺中市,東區,1157,325,423,748,45,793,1394,56.89%,23.31%,1
臺中市,東區,1158,302,573,875,54,929,1443,64.38%,20.93%,1
臺中市,東區,1159,116,305,421,33,454,762,59.58%,15.22%,1
臺中市,東區,1160,212,473,685,47,732,1140,64.21%,18.6%,1
臺中市,東區,1161,483,205,688,66,754,1211,62.26%,39.88%,1
臺中市,東區,1162,149,310,459,25,484,755,64.11%,19.74%,1
臺中市,東區,1163,243,538,781,61,842,1491,56.47%,16.3%,1
臺中市,東區,1164,164,376,540,17,557,1000,55.7%,16.4%,1
臺中市,東區,1165,228,412,640,40,680,1114,61.04%,20.47%,1
臺中市,東區,1166,203,408,611,31,642,1101,58.31%,18.44%,1
臺中市,東區,1167,221,484,705,45,750,1169,64.16%,18.91%,1
臺中市,東區,1168,237,511,748,63,811,1283,63.21%,18.47%,1
臺中市,東區,1169,230,489,719,28,747,1168,63.96%,19.69%,1
臺中市,東區,1170,234,506,740,35,775,1386,55.92%,16.88%,1
臺中市,東區,1171,329,553,882,44,926,1557,59.47%,21.13%,1
臺中市,東區,1172,264,488,752,61,813,1380,58.91%,19.13%,1
臺中市,東區,1173,319,625,944,44,988,1674,59.02%,19.06%,1
臺中市,東區,1174,328,641,969,31,1000,1604,62.34%,20.45%,1
臺中市,東區,1175,367,691,1058,38,1096,1815,60.39%,20.22%,1
臺中市,東區,1176,287,633,920,40,960,1700,56.47%,16.88%,1
臺中市,東區,1177,273,591,864,48,912,1592,57.29%,17.15%,1
臺中市,東區,1178,318,645,963,58,1021,1850,55.19%,17.19%,1
臺中市,東區,1179,199,532,731,32,763,1252,60.94%,15.89%,1
臺中市,東區,1180,265,498,763,34,797,1250,63.76%,21.2%,1
臺中市,東區,1181,200,517,717,37,754,1241,60.76%,16.12%,1
臺中市,東區,1182,247,422,669,42,711,1318,53.95%,18.74%,1
臺中市,東區,1183,206,492,698,45,743,1288,57.69%,15.99%,1
臺中市,東區,1184,266,594,860,46,906,1442,62.83%,18.45%,1
臺中市,東區,1185,203,473,676,43,719,1202,59.82%,16.89%,1
臺中市,東區,1186,223,586,809,47,856,1452,58.95%,15.36%,1
臺中市,東區,1187,239,543,782,44,826,1480,55.81%,16.15%,1
臺中市,東區,1188,264,692,956,31,987,1736,56.85%,15.21%,1
臺中市,東區,1189,158,312,470,27,497,867,57.32%,18.22%,1
臺中市,東區,1190,223,626,849,47,896,1693,52.92%,13.17%,1
臺中市,東區,1191,276,630,906,47,953,1538,61.96%,17.95%,1
臺中市,東區,1192,295,636,931,77,1008,1593,63.28%,18.52%,1
臺中市,東區,1193,261,524,785,25,810,1481,54.69%,17.62%,1
臺中市,東區,1194,280,559,839,37,876,1414,61.95%,19.8%,1
臺中市,東區,1195,236,466,702,41,743,1297,57.29%,18.2%,1
臺中市,東區,1196,239,545,784,45,829,1394,59.47%,17.14%,1
臺中市,南區,1197,181,364,545,29,574,937,61.26%,19.32%,1
臺中市,南區,1198,196,422,618,40,658,1001,65.73%,19.58%,1
臺中市,南區,1199,244,513,757,68,825,1249,66.05%,19.54%,1
臺中市,南區,1200,240,536,776,44,820,1202,68.22%,19.97%,1
臺中市,南區,1201,218,431,649,73,722,1130,63.89%,19.29%,1
臺中市,南區,1202,222,509,731,53,784,1239,63.28%,17.92%,1
臺中市,南區,1203,234,449,683,48,731,1238,59.05%,18.9%,1
臺中市,南區,1204,252,481,733,55,788,1272,61.95%,19.81%,1
臺中市,南區,1205,224,492,716,56,772,1273,60.64%,17.6%,1
臺中市,南區,1206,253,483,736,71,807,1317,61.28%,19.21%,1
臺中市,南區,1207,256,496,752,40,792,1160,68.28%,22.07%,1
臺中市,南區,1208,267,479,746,45,791,1205,65.64%,22.16%,1
臺中市,南區,1209,230,432,662,33,695,1111,62.56%,20.7%,1
臺中市,南區,1210,307,576,883,51,934,1407,66.38%,21.82%,1
臺中市,南區,1211,265,545,810,46,856,1419,60.32%,18.68%,1
臺中市,南區,1212,221,464,685,52,737,1157,63.7%,19.1%,1
臺中市,南區,1213,281,501,782,46,828,1415,58.52%,19.86%,1
臺中市,南區,1214,245,558,803,45,848,1289,65.79%,19.01%,1
臺中市,南區,1215,276,559,835,41,876,1454,60.25%,18.98%,1
臺中市,南區,1216,265,567,832,38,870,1491,58.35%,17.77%,1
臺中市,南區,1217,263,527,790,33,823,1394,59.04%,18.87%,1
臺中市,南區,1218,281,528,809,48,857,1430,59.93%,19.65%,1
臺中市,南區,1219,249,506,755,85,840,1342,62.59%,18.55%,1
臺中市,南區,1220,277,532,809,73,882,1304,67.64%,21.24%,1
臺中市,南區,1221,245,489,734,30,764,1190,64.2%,20.59%,1
臺中市,南區,1222,193,508,701,57,758,1273,59.54%,15.16%,1
臺中市,南區,1223,281,568,849,54,903,1387,65.1%,20.26%,1
臺中市,南區,1224,257,520,777,40,817,1356,60.25%,18.95%,1
臺中市,南區,1225,253,523,776,48,824,1304,63.19%,19.4%,1
臺中市,南區,1226,255,529,784,24,808,1256,64.33%,20.3%,1
臺中市,南區,1227,302,530,832,31,863,1364,63.27%,22.14%,1
臺中市,南區,1228,276,504,780,69,849,1361,62.38%,20.28%,1
臺中市,南區,1229,309,553,862,13,875,1407,62.19%,21.96%,1
臺中市,南區,1230,236,514,750,47,797,1308,60.93%,18.04%,1
臺中市,南區,1231,232,467,699,40,739,1250,59.12%,18.56%,1
臺中市,南區,1232,249,459,708,33,741,1284,57.71%,19.39%,1
臺中市,南區,1233,249,449,698,57,755,1175,64.26%,21.19%,1
臺中市,南區,1234,224,507,731,38,769,1158,66.41%,19.34%,1
臺中市,南區,1235,256,424,680,37,717,1168,61.39%,21.92%,1
臺中市,南區,1236,315,681,996,44,1040,1626,63.96%,19.37%,1
臺中市,南區,1237,305,562,867,27,894,2115,42.27%,14.42%,1
臺中市,南區,1238,330,653,983,31,1014,1805,56.18%,18.28%,1
臺中市,南區,1239,305,616,921,24,945,1695,55.75%,17.99%,1
臺中市,南區,1240,346,673,1019,33,1052,1643,64.03%,21.06%,1
臺中市,南區,1241,277,576,853,40,893,1423,62.75%,19.47%,1
臺中市,南區,1242,294,580,874,51,925,1542,59.99%,19.07%,1
臺中市,南區,1243,341,563,904,26,930,1533,60.67%,22.24%,1
臺中市,南區,1244,316,623,939,49,988,1531,64.53%,20.64%,1
臺中市,南區,1245,211,529,740,31,771,1392,55.39%,15.16%,1
臺中市,南區,1246,317,563,880,35,915,1592,57.47%,19.91%,1
臺中市,南區,1247,305,536,841,53,894,1431,62.47%,21.31%,1
臺中市,南區,1248,320,626,946,37,983,1799,54.64%,17.79%,1
臺中市,南區,1249,314,718,1032,56,1088,1708,63.7%,18.38%,1
臺中市,南區,1250,654,284,938,51,989,1700,58.18%,38.47%,1
臺中市,南區,1251,304,753,1057,38,1095,1751,62.54%,17.36%,1
臺中市,南區,1252,426,785,1211,67,1278,2109,60.6%,20.2%,1
臺中市,南區,1253,334,613,947,55,1002,1697,59.05%,19.68%,1
臺中市,南區,1254,303,516,819,45,864,1456,59.34%,20.81%,1
臺中市,南區,1255,370,737,1107,41,1148,1726,66.51%,21.44%,1
臺中市,南區,1256,348,680,1028,54,1082,1723,62.8%,20.2%,1
臺中市,南區,1257,323,611,934,38,972,1569,61.95%,20.59%,1
臺中市,南區,1258,266,489,755,50,805,1274,63.19%,20.88%,1
臺中市,南區,1259,287,603,890,30,920,1390,66.19%,20.65%,1
臺中市,南區,1260,287,530,817,30,847,1295,65.41%,22.16%,1
臺中市,南區,1261,234,533,767,44,811,1312,61.81%,17.84%,1
臺中市,南區,1262,289,591,880,26,906,1417,63.94%,20.4%,1
臺中市,南區,1263,271,546,817,37,854,1230,69.43%,22.03%,1
臺中市,南區,1264,237,518,755,30,785,1308,60.02%,18.12%,1
臺中市,南區,1265,276,549,825,59,884,1467,60.26%,18.81%,1
臺中市,南區,1266,284,535,819,37,856,1399,61.19%,20.3%,1
臺中市,南區,1267,214,464,678,53,731,1207,60.56%,17.73%,1
臺中市,南區,1268,259,495,754,37,791,1317,60.06%,19.67%,1
臺中市,南區,1269,338,547,885,28,913,1563,58.41%,21.63%,1
臺中市,南區,1270,247,490,737,35,772,1221,63.23%,20.23%,1
臺中市,西區,1082,141,349,490,26,516,1400,36.86%,10.07%,1
臺中市,西區,1083,181,362,543,19,562,861,65.27%,21.02%,1
臺中市,西區,1084,268,546,814,34,848,1416,59.89%,18.93%,1
臺中市,西區,1085,223,380,603,39,642,1020,62.94%,21.86%,1
臺中市,西區,1086,159,327,486,27,513,778,65.94%,20.44%,1
臺中市,西區,1087,268,539,807,39,846,1465,57.75%,18.29%,1
臺中市,西區,1088,190,400,590,17,607,1017,59.69%,18.68%,1
臺中市,西區,1089,184,321,505,28,533,868,61.41%,21.2%,1
臺中市,西區,1090,266,505,771,37,808,1251,64.59%,21.26%,1
臺中市,西區,1091,238,420,658,31,689,1044,66%,22.8%,1
臺中市,西區,1092,282,544,826,39,865,1487,58.17%,18.96%,1
臺中市,西區,1093,323,562,885,45,930,1573,59.12%,20.53%,1
臺中市,西區,1094,343,659,1002,44,1046,1731,60.43%,19.82%,1
臺中市,西區,1095,206,499,705,31,736,1209,60.88%,17.04%,1
臺中市,西區,1096,301,573,874,35,909,1564,58.12%,19.25%,1
臺中市,西區,1097,277,435,712,25,737,1175,62.72%,23.57%,1
臺中市,西區,1098,317,514,831,36,867,1505,57.61%,21.06%,1
臺中市,西區,1099,305,525,830,31,861,1418,60.72%,21.51%,1
臺中市,西區,1100,215,467,682,60,742,1497,49.57%,14.36%,1
臺中市,西區,1101,255,471,726,42,768,1260,60.95%,20.24%,1
臺中市,西區,1102,280,521,801,47,848,1399,60.61%,20.01%,1
臺中市,西區,1103,285,508,793,46,839,1447,57.98%,19.7%,1
臺中市,西區,1104,337,595,932,51,983,1683,58.41%,20.02%,1
臺中市,西區,1105,325,591,916,53,969,1585,61.14%,20.5%,1
臺中市,西區,1106,330,568,898,34,932,1557,59.86%,21.19%,1
臺中市,西區,1107,275,584,859,49,908,1663,54.6%,16.54%,1
臺中市,西區,1108,421,660,1081,44,1125,1921,58.56%,21.92%,1
臺中市,西區,1109,357,663,1020,28,1048,1952,53.69%,18.29%,1
臺中市,西區,1110,338,590,928,42,970,1708,56.79%,19.79%,1
臺中市,西區,1111,266,434,700,27,727,1131,64.28%,23.52%,1
臺中市,西區,1112,362,676,1038,25,1063,1916,55.48%,18.89%,1
臺中市,西區,1113,255,502,757,24,781,1275,61.25%,20%,1
臺中市,西區,1114,287,620,907,57,964,1822,52.91%,15.75%,1
臺中市,西區,1115,276,490,766,41,807,1374,58.73%,20.09%,1
臺中市,西區,1116,205,395,600,60,660,1129,58.46%,18.16%,1
臺中市,西區,1117,211,421,632,42,674,1201,56.12%,17.57%,1
臺中市,西區,1118,304,601,905,57,962,1639,58.69%,18.55%,1
臺中市,西區,1119,372,661,1033,58,1091,1863,58.56%,19.97%,1
臺中市,西區,1120,225,561,786,39,825,1287,64.1%,17.48%,1
臺中市,西區,1121,324,558,882,43,925,1504,61.5%,21.54%,1
臺中市,西區,1122,251,482,733,33,766,1308,58.56%,19.19%,1
臺中市,西區,1123,276,515,791,54,845,1433,58.97%,19.26%,1
臺中市,西區,1124,275,516,791,34,825,1450,56.9%,18.97%,1
臺中市,西區,1125,319,545,864,60,924,1465,63.07%,21.77%,1
臺中市,西區,1126,296,646,942,51,993,1818,54.62%,16.28%,1
臺中市,西區,1127,326,662,988,49,1037,1782,58.19%,18.29%,1
臺中市,西區,1128,305,525,830,49,879,1428,61.55%,21.36%,1
臺中市,西區,1129,216,477,693,37,730,1366,53.44%,15.81%,1
臺中市,西區,1130,292,535,827,30,857,1498,57.21%,19.49%,1
臺中市,西區,1131,286,515,801,24,825,1350,61.11%,21.19%,1
臺中市,西區,1132,282,509,791,27,818,1339,61.09%,21.06%,1
臺中市,西區,1133,316,616,932,34,966,1613,59.89%,19.59%,1
臺中市,西區,1134,301,526,827,30,857,1454,58.94%,20.7%,1
臺中市,西區,1135,356,602,958,27,985,1597,61.68%,22.29%,1
臺中市,西區,1136,309,529,838,57,895,1411,63.43%,21.9%,1
臺中市,西區,1137,283,555,838,54,892,1493,59.75%,18.96%,1
臺中市,西區,1138,279,670,949,36,985,1600,61.56%,17.44%,1
臺中市,西區,1139,344,598,942,36,978,1710,57.19%,20.12%,1
臺中市,西區,1140,237,419,656,25,681,1139,59.79%,20.81%,1
臺中市,西區,1141,218,439,657,27,684,1105,61.9%,19.73%,1
臺中市,西區,1142,280,540,820,46,866,1498,57.81%,18.69%,1
臺中市,西區,1143,313,629,942,41,983,1921,51.17%,16.29%,1
臺中市,西區,1144,253,494,747,39,786,1340,58.66%,18.88%,1
臺中市,西區,1145,310,612,922,38,960,1536,62.5%,20.18%,1
臺中市,西區,1146,270,486,756,49,805,1361,59.15%,19.84%,1
臺中市,西區,1147,305,550,855,38,893,1430,62.45%,21.33%,1
臺中市,北區,0983,252,499,751,39,790,1437,54.98%,17.54%,1
臺中市,北區,0984,283,567,850,62,912,1708,53.4%,16.57%,1
臺中市,北區,0985,172,352,524,34,558,1051,53.09%,16.37%,1
臺中市,北區,0986,188,362,550,34,584,996,58.63%,18.88%,1
臺中市,北區,0987,221,619,840,26,866,1504,57.58%,14.69%,1
臺中市,北區,0988,179,379,558,51,609,975,62.46%,18.36%,1
臺中市,北區,0989,161,336,497,27,524,886,59.14%,18.17%,1
臺中市,北區,0990,210,366,576,31,607,1276,47.57%,16.46%,1
臺中市,北區,0991,166,308,474,37,511,938,54.48%,17.7%,1
臺中市,北區,0992,240,486,726,52,778,1404,55.41%,17.09%,1
臺中市,北區,0993,193,349,542,19,561,996,56.33%,19.38%,1
臺中市,北區,0994,169,286,455,44,499,869,57.42%,19.45%,1
臺中市,北區,0995,128,296,424,22,446,704,63.35%,18.18%,1
臺中市,北區,0996,156,364,520,26,546,979,55.77%,15.93%,1
臺中市,北區,0997,127,268,395,17,412,773,53.3%,16.43%,1
臺中市,北區,0998,144,297,441,21,462,759,60.87%,18.97%,1
臺中市,北區,0999,189,605,794,48,842,1438,58.55%,13.14%,1
臺中市,北區,1000,169,453,622,23,645,1212,53.22%,13.94%,1
臺中市,北區,1001,353,599,952,42,994,1731,57.42%,20.39%,1
臺中市,北區,1002,254,616,870,35,905,1445,62.63%,17.58%,1
臺中市,北區,1003,347,657,1004,40,1044,1855,56.28%,18.71%,1
臺中市,北區,1004,268,561,829,51,880,1728,50.93%,15.51%,1
臺中市,北區,1005,303,627,930,44,974,1878,51.86%,16.13%,1
臺中市,北區,1006,255,613,868,74,942,1793,52.54%,14.22%,1
臺中市,北區,1007,259,587,846,62,908,1555,58.39%,16.66%,1
臺中市,北區,1008,309,566,875,27,902,1761,51.22%,17.55%,1
臺中市,北區,1009,251,578,829,47,876,1579,55.48%,15.9%,1
臺中市,北區,1010,357,742,1099,75,1174,2192,53.56%,16.29%,1
臺中市,北區,1011,307,602,909,41,950,1560,60.9%,19.68%,1
臺中市,北區,1012,256,569,825,36,861,1476,58.33%,17.34%,1
臺中市,北區,1013,191,405,596,25,621,1006,61.73%,18.99%,1
臺中市,北區,1014,222,554,776,39,815,1403,58.09%,15.82%,1
臺中市,北區,1015,236,520,756,28,784,1446,54.22%,16.32%,1
臺中市,北區,1016,275,516,791,38,829,1460,56.78%,18.84%,1
臺中市,北區,1017,252,454,706,20,726,1233,58.88%,20.44%,1
臺中市,北區,1018,236,416,652,24,676,1027,65.82%,22.98%,1
臺中市,北區,1019,243,453,696,18,714,1207,59.15%,20.13%,1
臺中市,北區,1020,239,456,695,31,726,1167,62.21%,20.48%,1
臺中市,北區,1021,227,408,635,25,660,1150,57.39%,19.74%,1
臺中市,北區,1022,204,383,587,38,625,1061,58.91%,19.23%,1
臺中市,北區,1023,220,374,594,24,618,1005,61.49%,21.89%,1
臺中市,北區,1024,256,436,692,22,714,1250,57.12%,20.48%,1
臺中市,北區,1025,281,547,828,47,875,1448,60.43%,19.41%,1
臺中市,北區,1026,266,514,780,47,827,1379,59.97%,19.29%,1
臺中市,北區,1027,313,597,910,50,960,1652,58.11%,18.95%,1
臺中市,北區,1028,260,715,975,40,1015,1867,54.37%,13.93%,1
臺中市,北區,1029,190,379,569,21,590,2078,28.39%,9.14%,1
臺中市,北區,1030,272,651,923,41,964,1562,61.72%,17.41%,1
臺中市,北區,1031,280,519,799,28,827,1430,57.83%,19.58%,1
臺中市,北區,1032,377,757,1134,39,1173,2018,58.13%,18.68%,1
臺中市,北區,1033,266,570,836,27,863,1710,50.47%,15.56%,1
臺中市,北區,1034,243,527,770,25,795,1432,55.52%,16.97%,1
臺中市,北區,1035,214,456,670,33,703,1157,60.76%,18.5%,1
臺中市,北區,1036,250,450,700,18,718,1188,60.44%,21.04%,1
臺中市,北區,1037,223,550,773,35,808,1419,56.94%,15.72%,1
臺中市,北區,1038,308,555,863,33,896,1653,54.2%,18.63%,1
臺中市,北區,1039,245,451,696,35,731,1233,59.29%,19.87%,1
臺中市,北區,1040,236,474,710,21,731,1243,58.81%,18.99%,1
臺中市,北區,1041,208,427,635,15,650,1219,53.32%,17.06%,1
臺中市,北區,1042,246,472,718,44,762,1272,59.91%,19.34%,1
臺中市,北區,1043,273,475,748,17,765,1285,59.53%,21.25%,1
臺中市,北區,1044,346,665,1011,39,1050,1780,58.99%,19.44%,1
臺中市,北區,1045,235,489,724,36,760,1461,52.02%,16.08%,1
臺中市,北區,1046,219,552,771,42,813,1310,62.06%,16.72%,1
臺中市,北區,1047,350,546,896,27,923,1669,55.3%,20.97%,1
臺中市,北區,1048,405,673,1078,52,1130,1932,58.49%,20.96%,1
臺中市,北區,1049,323,593,916,32,948,1682,56.36%,19.2%,1
臺中市,北區,1050,370,622,992,29,1021,1891,53.99%,19.57%,1
臺中市,北區,1051,345,666,1011,55,1066,1882,56.64%,18.33%,1
臺中市,北區,1052,211,428,639,26,665,1159,57.38%,18.21%,1
臺中市,北區,1053,200,642,842,45,887,1553,57.12%,12.88%,1
臺中市,北區,1054,299,566,865,33,898,1607,55.88%,18.61%,1
臺中市,北區,1055,336,626,962,39,1001,1773,56.46%,18.95%,1
臺中市,北區,1056,276,555,831,45,876,1524,57.48%,18.11%,1
臺中市,北區,1057,309,645,954,57,1011,1613,62.68%,19.16%,1
臺中市,北區,1058,359,706,1065,44,1109,1877,59.08%,19.13%,1
臺中市,北區,1059,345,639,984,45,1029,1792,57.42%,19.25%,1
臺中市,北區,1060,236,552,788,42,830,1392,59.63%,16.95%,1
臺中市,北區,1061,250,467,717,33,750,1297,57.83%,19.28%,1
臺中市,北區,1062,350,561,911,31,942,1556,60.54%,22.49%,1
臺中市,北區,1063,513,289,802,32,834,1497,55.71%,34.27%,1
臺中市,北區,1064,254,569,823,43,866,1550,55.87%,16.39%,1
臺中市,北區,1065,296,465,761,31,792,1434,55.23%,20.64%,1
臺中市,北區,1066,350,651,1001,51,1052,1793,58.67%,19.52%,1
臺中市,北區,1067,361,658,1019,39,1058,1866,56.7%,19.35%,1
臺中市,北區,1068,228,537,765,36,801,1346,59.51%,16.94%,1
臺中市,北區,1069,204,479,683,47,730,1267,57.62%,16.1%,1
臺中市,西屯區,0625,349,621,970,52,1022,1638,62.39%,21.31%,1
臺中市,西屯區,0626,294,457,751,35,786,1335,58.88%,22.02%,1
臺中市,西屯區,0627,340,657,997,36,1033,1776,58.16%,19.14%,1
臺中市,西屯區,0628,263,486,749,34,783,1351,57.96%,19.47%,1
臺中市,西屯區,0629,276,500,776,43,819,1338,61.21%,20.63%,1
臺中市,西屯區,0630,301,585,886,33,919,1582,58.09%,19.03%,1
臺中市,西屯區,0631,264,618,882,35,917,1710,53.63%,15.44%,1
臺中市,西屯區,0632,283,527,810,45,855,1595,53.61%,17.74%,1
臺中市,西屯區,0633,244,648,892,44,936,1585,59.05%,15.39%,1
臺中市,西屯區,0634,283,635,918,62,980,1749,56.03%,16.18%,1
臺中市,西屯區,0635,313,718,1031,46,1077,1877,57.38%,16.68%,1
臺中市,西屯區,0636,321,559,880,43,923,1697,54.39%,18.92%,1
臺中市,西屯區,0637,272,590,862,45,907,1480,61.28%,18.38%,1
臺中市,西屯區,0638,336,580,916,59,975,1483,65.75%,22.66%,1
臺中市,西屯區,0639,308,561,869,37,906,2484,36.47%,12.4%,1
臺中市,西屯區,0640,138,358,496,31,527,781,67.48%,17.67%,1
臺中市,西屯區,0641,252,597,849,47,896,1477,60.66%,17.06%,1
臺中市,西屯區,0642,345,624,969,30,999,1784,56%,19.34%,1
臺中市,西屯區,0643,303,624,927,34,961,1686,57%,17.97%,1
臺中市,西屯區,0644,337,600,937,29,966,1692,57.09%,19.92%,1
臺中市,西屯區,0645,283,591,874,31,905,1659,54.55%,17.06%,1
臺中市,西屯區,0646,327,508,835,17,852,1648,51.7%,19.84%,1
臺中市,西屯區,0647,336,578,914,26,940,1536,61.2%,21.88%,1
臺中市,西屯區,0648,299,652,951,47,998,1666,59.9%,17.95%,1
臺中市,西屯區,0649,284,530,814,37,851,1428,59.59%,19.89%,1
臺中市,西屯區,0650,315,628,943,46,989,1810,54.64%,17.4%,1
臺中市,西屯區,0651,313,547,860,33,893,1574,56.73%,19.89%,1
臺中市,西屯區,0652,321,604,925,14,939,1650,56.91%,19.45%,1
臺中市,西屯區,0653,323,592,915,56,971,1681,57.76%,19.21%,1
臺中市,西屯區,0654,335,569,904,40,944,1656,57%,20.23%,1
臺中市,西屯區,0655,210,504,714,50,764,1243,61.46%,16.89%,1
臺中市,西屯區,0656,313,586,899,40,939,1471,63.83%,21.28%,1
臺中市,西屯區,0657,309,553,862,35,897,1431,62.68%,21.59%,1
臺中市,西屯區,0658,329,617,946,34,980,1714,57.18%,19.19%,1
臺中市,西屯區,0659,223,567,790,51,841,1424,59.06%,15.66%,1
臺中市,西屯區,0660,200,471,671,29,700,1176,59.52%,17.01%,1
臺中市,西屯區,0661,289,554,843,35,878,1456,60.3%,19.85%,1
臺中市,西屯區,0662,292,590,882,25,907,1451,62.51%,20.12%,1
臺中市,西屯區,0663,227,443,670,25,695,1063,65.38%,21.35%,1
臺中市,西屯區,0664,211,550,761,31,792,1357,58.36%,15.55%,1
臺中市,西屯區,0665,202,580,782,59,841,1355,62.07%,14.91%,1
臺中市,西屯區,0666,233,586,819,24,843,1384,60.91%,16.84%,1
臺中市,西屯區,0667,317,605,922,42,964,1613,59.76%,19.65%,1
臺中市,西屯區,0668,283,568,851,58,909,1562,58.19%,18.12%,1
臺中市,西屯區,0669,245,523,768,36,804,1219,65.96%,20.1%,1
臺中市,西屯區,0670,253,439,692,40,732,1235,59.27%,20.49%,1
臺中市,西屯區,0671,215,413,628,52,680,1131,60.12%,19.01%,1
臺中市,西屯區,0672,315,597,912,23,935,1494,62.58%,21.08%,1
臺中市,西屯區,0673,305,458,763,28,791,1325,59.7%,23.02%,1
臺中市,西屯區,0674,283,504,787,44,831,1386,59.96%,20.42%,1
臺中市,西屯區,0675,379,638,1017,60,1077,1816,59.31%,20.87%,1
臺中市,西屯區,0676,324,600,924,26,950,1734,54.79%,18.69%,1
臺中市,西屯區,0677,376,626,1002,58,1060,1777,59.65%,21.16%,1
臺中市,西屯區,0678,350,597,947,48,995,1818,54.73%,19.25%,1
臺中市,西屯區,0679,312,591,903,62,965,1699,56.8%,18.36%,1
臺中市,西屯區,0680,289,583,872,36,908,1715,52.94%,16.85%,1
臺中市,西屯區,0681,310,551,861,43,904,1654,54.66%,18.74%,1
臺中市,西屯區,0682,310,578,888,25,913,1636,55.81%,18.95%,1
臺中市,西屯區,0683,240,471,711,27,738,1298,56.86%,18.49%,1
臺中市,西屯區,0684,245,549,794,46,840,1391,60.39%,17.61%,1
臺中市,西屯區,0685,350,700,1050,48,1098,1853,59.26%,18.89%,1
臺中市,西屯區,0686,309,662,971,45,1016,1820,55.82%,16.98%,1
臺中市,西屯區,0687,344,666,1010,52,1062,1809,58.71%,19.02%,1
臺中市,西屯區,0688,258,546,804,46,850,1352,62.87%,19.08%,1
臺中市,西屯區,0689,259,586,845,48,893,1521,58.71%,17.03%,1
臺中市,西屯區,0690,291,587,878,35,913,1486,61.44%,19.58%,1
臺中市,西屯區,0691,302,649,951,40,991,1674,59.2%,18.04%,1
臺中市,西屯區,0692,334,624,958,51,1009,1610,62.67%,20.75%,1
臺中市,西屯區,0693,340,600,940,52,992,1695,58.53%,20.06%,1
臺中市,西屯區,0694,327,575,902,44,946,1684,56.18%,19.42%,1
臺中市,西屯區,0695,249,473,722,31,753,1221,61.67%,20.39%,1
臺中市,西屯區,0696,240,549,789,63,852,1252,68.05%,19.17%,1
臺中市,西屯區,0697,267,505,772,44,816,1301,62.72%,20.52%,1
臺中市,西屯區,0698,133,510,643,28,671,1049,63.97%,12.68%,1
臺中市,西屯區,0699,152,495,647,34,681,1113,61.19%,13.66%,1
臺中市,西屯區,0700,216,602,818,39,857,1557,55.04%,13.87%,1
臺中市,西屯區,0701,256,617,873,38,911,1640,55.55%,15.61%,1
臺中市,西屯區,0702,262,587,849,86,935,1402,66.69%,18.69%,1
臺中市,西屯區,0703,259,587,846,61,907,1717,52.82%,15.08%,1
臺中市,西屯區,0704,289,617,906,54,960,1688,56.87%,17.12%,1
臺中市,西屯區,0705,176,452,628,93,721,1168,61.73%,15.07%,1
臺中市,西屯區,0706,271,620,891,56,947,1729,54.77%,15.67%,1
臺中市,西屯區,0707,336,689,1025,49,1074,2007,53.51%,16.74%,1
臺中市,西屯區,0708,225,496,721,81,802,1296,61.88%,17.36%,1
臺中市,西屯區,0709,173,374,547,26,573,1068,53.65%,16.2%,1
臺中市,西屯區,0710,239,594,833,79,912,1707,53.43%,14%,1
臺中市,西屯區,0711,313,618,931,35,966,1636,59.05%,19.13%,1
臺中市,西屯區,0712,230,559,789,37,826,1761,46.91%,13.06%,1
臺中市,西屯區,0713,245,509,754,35,789,1314,60.05%,18.65%,1
臺中市,西屯區,0714,251,503,754,37,791,1233,64.15%,20.36%,1
臺中市,西屯區,0715,266,552,818,40,858,1549,55.39%,17.17%,1
臺中市,西屯區,0716,285,592,877,24,901,1639,54.97%,17.39%,1
臺中市,西屯區,0717,210,560,770,38,808,1486,54.37%,14.13%,1
臺中市,西屯區,0718,381,576,957,27,984,1806,54.49%,21.1%,1
臺中市,西屯區,0719,306,466,772,20,792,1451,54.58%,21.09%,1
臺中市,西屯區,0720,217,536,753,22,775,1302,59.52%,16.67%,1
臺中市,西屯區,0721,288,516,804,46,850,1353,62.82%,21.29%,1
臺中市,西屯區,0722,406,798,1204,53,1257,2162,58.14%,18.78%,1
臺中市,西屯區,0723,272,558,830,32,862,1520,56.71%,17.89%,1
臺中市,西屯區,0724,347,686,1033,42,1075,1935,55.56%,17.93%,1
臺中市,西屯區,0725,353,658,1011,42,1053,1847,57.01%,19.11%,1
臺中市,西屯區,0726,357,614,971,37,1008,1738,58%,20.54%,1
臺中市,西屯區,0727,320,646,966,40,1006,1640,61.34%,19.51%,1
臺中市,西屯區,0728,378,688,1066,39,1105,1908,57.91%,19.81%,1
臺中市,西屯區,0729,296,493,789,30,819,1402,58.42%,21.11%,1
臺中市,西屯區,0730,290,494,784,37,821,1515,54.19%,19.14%,1
臺中市,西屯區,0731,235,481,716,40,756,1541,49.06%,15.25%,1
臺中市,西屯區,0732,302,503,805,29,834,1502,55.53%,20.11%,1
臺中市,西屯區,0733,304,544,848,55,903,1526,59.17%,19.92%,1
臺中市,西屯區,0734,284,545,829,47,876,1425,61.47%,19.93%,1
臺中市,西屯區,0735,283,502,785,49,834,1334,62.52%,21.21%,1
臺中市,西屯區,0736,336,628,964,45,1009,1649,61.19%,20.38%,1
臺中市,西屯區,0737,308,547,855,27,882,1566,56.32%,19.67%,1
臺中市,西屯區,0738,361,598,959,36,995,1629,61.08%,22.16%,1
臺中市,西屯區,0739,328,575,903,56,959,1628,58.91%,20.15%,1
臺中市,西屯區,0740,318,551,869,24,893,1442,61.93%,22.05%,1
臺中市,西屯區,0741,216,402,618,50,668,1206,55.39%,17.91%,1
臺中市,西屯區,0742,182,446,628,61,689,1086,63.44%,16.76%,1
臺中市,西屯區,0743,178,464,642,43,685,1088,62.96%,16.36%,1
臺中市,西屯區,0744,221,439,660,29,689,1140,60.44%,19.39%,1
臺中市,南屯區,0745,234,519,753,54,807,1321,61.09%,17.71%,1
臺中市,南屯區,0746,297,501,798,46,844,1346,62.7%,22.07%,1
臺中市,南屯區,0747,251,576,827,45,872,1428,61.06%,17.58%,1
臺中市,南屯區,0748,274,533,807,29,836,1442,57.98%,19%,1
臺中市,南屯區,0749,301,575,876,29,905,1408,64.28%,21.38%,1
臺中市,南屯區,0750,281,563,844,20,864,1404,61.54%,20.01%,1
臺中市,南屯區,0751,268,550,818,46,864,1354,63.81%,19.79%,1
臺中市,南屯區,0752,269,533,802,37,839,1332,62.99%,20.2%,1
臺中市,南屯區,0753,315,575,890,34,924,1463,63.16%,21.53%,1
臺中市,南屯區,0754,290,528,818,39,857,1413,60.65%,20.52%,1
臺中市,南屯區,0755,277,479,756,28,784,1218,64.37%,22.74%,1
臺中市,南屯區,0756,258,504,762,35,797,1308,60.93%,19.72%,1
臺中市,南屯區,0757,300,632,932,36,968,1527,63.39%,19.65%,1
臺中市,南屯區,0758,271,512,783,35,818,1294,63.21%,20.94%,1
臺中市,南屯區,0759,239,535,774,43,817,1516,53.89%,15.77%,1
臺中市,南屯區,0760,294,587,881,71,952,1529,62.26%,19.23%,1
臺中市,南屯區,0761,249,558,807,56,863,1397,61.78%,17.82%,1
臺中市,南屯區,0762,224,534,758,41,799,1406,56.83%,15.93%,1
臺中市,南屯區,0763,225,559,784,41,825,1497,55.11%,15.03%,1
臺中市,南屯區,0764,249,511,760,56,816,1424,57.3%,17.49%,1
臺中市,南屯區,0765,271,446,717,44,761,1488,51.14%,18.21%,1
臺中市,南屯區,0766,126,243,369,38,407,608,66.94%,20.72%,1
臺中市,南屯區,0767,144,330,474,62,536,813,65.93%,17.71%,1
臺中市,南屯區,0768,213,470,683,53,736,1190,61.85%,17.9%,1
臺中市,南屯區,0769,180,466,646,31,677,1174,57.67%,15.33%,1
臺中市,南屯區,0770,205,504,709,15,724,1224,59.15%,16.75%,1
臺中市,南屯區,0771,212,481,693,48,741,1466,50.55%,14.46%,1
臺中市,南屯區,0772,143,402,545,28,573,1333,42.99%,10.73%,1
臺中市,南屯區,0773,162,320,482,40,522,814,64.13%,19.9%,1
臺中市,南屯區,0774,199,549,748,52,800,1436,55.71%,13.86%,1
臺中市,南屯區,0775,294,563,857,49,906,1515,59.8%,19.41%,1
臺中市,南屯區,0776,246,516,762,36,798,1545,51.65%,15.92%,1
臺中市,南屯區,0777,258,519,777,38,815,1383,58.93%,18.66%,1
臺中市,南屯區,0778,243,574,817,38,855,1433,59.67%,16.96%,1
臺中市,南屯區,0779,228,377,605,22,627,1134,55.29%,20.11%,1
臺中市,南屯區,0780,226,505,731,31,762,1216,62.66%,18.59%,1
臺中市,南屯區,0781,213,450,663,75,738,1271,58.06%,16.76%,1
臺中市,南屯區,0782,221,426,647,21,668,1203,55.53%,18.37%,1
臺中市,南屯區,0783,227,500,727,20,747,1268,58.91%,17.9%,1
臺中市,南屯區,0784,242,551,793,41,834,1390,60%,17.41%,1
臺中市,南屯區,0785,245,517,762,45,807,1397,57.77%,17.54%,1
臺中市,南屯區,0786,278,585,863,60,923,1607,57.44%,17.3%,1
臺中市,南屯區,0787,290,624,914,38,952,1582,60.18%,18.33%,1
臺中市,南屯區,0788,278,629,907,49,956,1611,59.34%,17.26%,1
臺中市,南屯區,0789,275,535,810,33,843,1322,63.77%,20.8%,1
臺中市,南屯區,0790,283,545,828,35,863,1321,65.33%,21.42%,1
臺中市,南屯區,0791,251,541,792,40,832,1360,61.18%,18.46%,1
臺中市,南屯區,0792,279,548,827,12,839,1361,61.65%,20.5%,1
臺中市,南屯區,0793,288,479,767,30,797,1257,63.4%,22.91%,1
臺中市,南屯區,0794,256,504,760,23,783,1207,64.87%,21.21%,1
臺中市,南屯區,0795,399,395,794,28,822,1282,64.12%,31.12%,1
臺中市,南屯區,0796,272,523,795,27,822,1248,65.87%,21.79%,1
臺中市,南屯區,0797,292,521,813,38,851,1304,65.26%,22.39%,1
臺中市,南屯區,0798,279,424,703,42,745,1214,61.37%,22.98%,1
臺中市,南屯區,0799,245,432,677,37,714,1102,64.79%,22.23%,1
臺中市,南屯區,0800,330,684,1014,38,1052,1630,64.54%,20.25%,1
臺中市,南屯區,0801,302,495,797,34,831,1333,62.34%,22.66%,1
臺中市,南屯區,0802,289,491,780,26,806,1292,62.38%,22.37%,1
臺中市,南屯區,0803,260,495,755,35,790,1272,62.11%,20.44%,1
臺中市,南屯區,0804,283,512,795,26,821,1345,61.04%,21.04%,1
臺中市,南屯區,0805,216,448,664,25,689,981,70.23%,22.02%,1
臺中市,南屯區,0806,195,459,654,48,702,1097,63.99%,17.78%,1
臺中市,南屯區,0807,177,452,629,20,649,991,65.49%,17.86%,1
臺中市,南屯區,0808,220,481,701,23,724,1170,61.88%,18.8%,1
臺中市,南屯區,0809,244,473,717,33,750,1171,64.05%,20.84%,1
臺中市,南屯區,0810,284,477,761,46,807,1349,59.82%,21.05%,1
臺中市,南屯區,0811,287,556,843,29,872,1368,63.74%,20.98%,1
臺中市,南屯區,0812,282,507,789,31,820,1263,64.92%,22.33%,1
臺中市,南屯區,0813,334,587,921,37,958,1547,61.93%,21.59%,1
臺中市,南屯區,0814,335,606,941,49,990,1649,60.04%,20.32%,1
臺中市,南屯區,0815,306,600,906,31,937,1629,57.52%,18.78%,1
臺中市,南屯區,0816,295,519,814,35,849,1580,53.73%,18.67%,1
臺中市,南屯區,0817,309,600,909,39,948,1444,65.65%,21.4%,1
臺中市,南屯區,0818,267,544,811,26,837,1413,59.24%,18.9%,1
臺中市,南屯區,0819,238,541,779,31,810,1377,58.82%,17.28%,1
臺中市,南屯區,0820,365,546,911,24,935,1527,61.23%,23.9%,1
臺中市,南屯區,0821,290,519,809,29,838,1335,62.77%,21.72%,1
臺中市,南屯區,0822,355,647,1002,29,1031,1544,66.77%,22.99%,1
臺中市,南屯區,0823,323,608,931,33,964,1482,65.05%,21.79%,1
臺中市,南屯區,0824,275,599,874,59,933,1488,62.7%,18.48%,1
臺中市,南屯區,0825,270,507,777,38,815,1538,52.99%,17.56%,1
臺中市,南屯區,0826,325,684,1009,51,1060,1674,63.32%,19.41%,1
臺中市,南屯區,0827,288,533,821,46,867,1996,43.44%,14.43%,1
臺中市,南屯區,0828,286,582,868,54,922,1514,60.9%,18.89%,1
臺中市,南屯區,0829,221,513,734,51,785,1217,64.5%,18.16%,1
臺中市,南屯區,0830,279,493,772,33,805,1347,59.76%,20.71%,1
臺中市,南屯區,0831,199,468,667,32,699,1109,63.03%,17.94%,1
臺中市,南屯區,0832,311,562,873,30,903,1546,58.41%,20.12%,1
臺中市,南屯區,0833,286,580,866,41,907,1408,64.42%,20.31%,1
臺中市,南屯區,0834,134,448,582,24,606,1057,57.33%,12.68%,1
臺中市,南屯區,0835,224,422,646,47,693,1133,61.17%,19.77%,1
臺中市,南屯區,0836,270,481,751,26,777,1278,60.8%,21.13%,1
臺中市,南屯區,0837,245,474,719,37,756,1144,66.08%,21.42%,1
臺中市,南屯區,0838,243,418,661,41,702,1140,61.58%,21.32%,1
臺中市,南屯區,0839,235,480,715,29,744,1171,63.54%,20.07%,1
臺中市,南屯區,0840,252,559,811,34,845,1303,64.85%,19.34%,1
臺中市,南屯區,0841,262,501,763,35,798,1402,56.92%,18.69%,1
臺中市,南屯區,0842,273,584,857,56,913,1571,58.12%,17.38%,1
臺中市,南屯區,0843,268,443,711,25,736,1139,64.62%,23.53%,1
臺中市,南屯區,0844,242,519,761,25,786,1216,64.64%,19.9%,1
臺中市,南屯區,0845,217,487,704,38,742,1162,63.86%,18.67%,1
臺中市,北屯區,0846,314,673,987,45,1032,1670,61.8%,18.8%,1
臺中市,北屯區,0847,272,617,889,43,932,1706,54.63%,15.94%,1
臺中市,北屯區,0848,276,531,807,60,867,1507,57.53%,18.31%,1
臺中市,北屯區,0849,318,626,944,44,988,1652,59.81%,19.25%,1
臺中市,北屯區,0850,188,407,595,21,616,1107,55.65%,16.98%,1
臺中市,北屯區,0851,301,797,1098,64,1162,2151,54.02%,13.99%,1
臺中市,北屯區,0852,299,650,949,31,980,1612,60.79%,18.55%,1
臺中市,北屯區,0853,295,661,956,37,993,1743,56.97%,16.92%,1
臺中市,北屯區,0854,368,698,1066,37,1103,2099,52.55%,17.53%,1
臺中市,北屯區,0855,287,615,902,25,927,1595,58.12%,17.99%,1
臺中市,北屯區,0856,300,673,973,49,1022,1923,53.15%,15.6%,1
臺中市,北屯區,0857,234,616,850,50,900,1641,54.84%,14.26%,1
臺中市,北屯區,0858,241,476,717,34,751,1157,64.91%,20.83%,1
臺中市,北屯區,0859,202,430,632,32,664,1041,63.78%,19.4%,1
臺中市,北屯區,0860,261,542,803,42,845,1563,54.06%,16.7%,1
臺中市,北屯區,0861,209,588,797,46,843,1559,54.07%,13.41%,1
臺中市,北屯區,0862,192,517,709,19,728,1411,51.59%,13.61%,1
臺中市,北屯區,0863,360,659,1019,30,1049,1761,59.57%,20.44%,1
臺中市,北屯區,0864,255,553,808,56,864,1361,63.48%,18.74%,1
臺中市,北屯區,0865,297,699,996,58,1054,1852,56.91%,16.04%,1
臺中市,北屯區,0866,329,760,1089,38,1127,1928,58.45%,17.06%,1
臺中市,北屯區,0867,294,630,924,39,963,1492,64.54%,19.71%,1
臺中市,北屯區,0868,319,729,1048,53,1101,1998,55.11%,15.97%,1
臺中市,北屯區,0869,246,540,786,41,827,1272,65.02%,19.34%,1
臺中市,北屯區,0870,248,532,780,41,821,1317,62.34%,18.83%,1
臺中市,北屯區,0871,203,463,666,53,719,1327,54.18%,15.3%,1
臺中市,北屯區,0872,200,479,679,26,705,1280,55.08%,15.63%,1
臺中市,北屯區,0873,289,659,948,44,992,1865,53.19%,15.5%,1
臺中市,北屯區,0874,228,531,759,36,795,1230,64.63%,18.54%,1
臺中市,北屯區,0875,271,447,718,27,745,1356,54.94%,19.99%,1
臺中市,北屯區,0876,314,640,954,34,988,1732,57.04%,18.13%,1
臺中市,北屯區,0877,286,620,906,37,943,1586,59.46%,18.03%,1
臺中市,北屯區,0878,278,503,781,28,809,1441,56.14%,19.29%,1
臺中市,北屯區,0879,338,709,1047,62,1109,2045,54.23%,16.53%,1
臺中市,北屯區,0880,305,660,965,40,1005,1914,52.51%,15.94%,1
臺中市,北屯區,0881,332,736,1068,38,1106,1918,57.66%,17.31%,1
臺中市,北屯區,0882,326,728,1054,30,1084,2079,52.14%,15.68%,1
臺中市,北屯區,0883,359,658,1017,42,1059,2040,51.91%,17.6%,1
臺中市,北屯區,0884,337,632,969,40,1009,2027,49.78%,16.63%,1
臺中市,北屯區,0885,204,544,748,40,788,1402,56.21%,14.55%,1
臺中市,北屯區,0886,317,718,1035,39,1074,1826,58.82%,17.36%,1
臺中市,北屯區,0887,355,708,1063,24,1087,2162,50.28%,16.42%,1
臺中市,北屯區,0888,398,698,1096,16,1112,2332,47.68%,17.07%,1
臺中市,北屯區,0889,116,428,544,38,582,985,59.09%,11.78%,1
臺中市,北屯區,0890,309,717,1026,38,1064,2037,52.23%,15.17%,1
臺中市,北屯區,0891,166,430,596,36,632,1032,61.24%,16.09%,1
臺中市,北屯區,0892,184,403,587,32,619,1062,58.29%,17.33%,1
臺中市,北屯區,0893,132,365,497,31,528,909,58.09%,14.52%,1
臺中市,北屯區,0894,269,569,838,46,884,1445,61.18%,18.62%,1
臺中市,北屯區,0895,290,662,952,44,996,1842,54.07%,15.74%,1
臺中市,北屯區,0896,230,460,690,30,720,1187,60.66%,19.38%,1
臺中市,北屯區,0897,247,577,824,38,862,1456,59.2%,16.96%,1
臺中市,北屯區,0898,339,685,1024,56,1080,1866,57.88%,18.17%,1
臺中市,北屯區,0899,264,586,850,54,904,1667,54.23%,15.84%,1
臺中市,北屯區,0900,299,669,968,24,992,1683,58.94%,17.77%,1
臺中市,北屯區,0901,324,583,907,20,927,1642,56.46%,19.73%,1
臺中市,北屯區,0902,278,565,843,29,872,1475,59.12%,18.85%,1
臺中市,北屯區,0903,259,625,884,25,909,1644,55.29%,15.75%,1
臺中市,北屯區,0904,296,640,936,26,962,1603,60.01%,18.47%,1
臺中市,北屯區,0905,329,783,1112,60,1172,1949,60.13%,16.88%,1
臺中市,北屯區,0906,326,755,1081,38,1119,1790,62.51%,18.21%,1
臺中市,北屯區,0907,293,538,831,24,855,1440,59.38%,20.35%,1
臺中市,北屯區,0908,302,636,938,44,982,1601,61.34%,18.86%,1
臺中市,北屯區,0909,253,557,810,48,858,1527,56.19%,16.57%,1
臺中市,北屯區,0910,278,568,846,40,886,1675,52.9%,16.6%,1
臺中市,北屯區,0911,249,529,778,34,812,1579,51.42%,15.77%,1
臺中市,北屯區,0912,249,602,851,57,908,1524,59.58%,16.34%,1
臺中市,北屯區,0913,286,591,877,43,920,1677,54.86%,17.05%,1
臺中市,北屯區,0914,295,570,865,42,907,1599,56.72%,18.45%,1
臺中市,北屯區,0915,310,534,844,43,887,1458,60.84%,21.26%,1
臺中市,北屯區,0916,304,607,911,42,953,1571,60.66%,19.35%,1
臺中市,北屯區,0917,310,602,912,36,948,1579,60.04%,19.63%,1
臺中市,北屯區,0918,364,686,1050,42,1092,1849,59.06%,19.69%,1
臺中市,北屯區,0919,334,601,935,28,963,1682,57.25%,19.86%,1
臺中市,北屯區,0920,301,648,949,22,971,1760,55.17%,17.1%,1
臺中市,北屯區,0921,315,617,932,58,990,1699,58.27%,18.54%,1
臺中市,北屯區,0922,332,650,982,47,1029,1626,63.28%,20.42%,1
臺中市,北屯區,0923,326,558,884,8,892,1491,59.83%,21.86%,1
臺中市,北屯區,0924,303,594,897,35,932,1640,56.83%,18.48%,1
臺中市,北屯區,0925,341,733,1074,58,1132,2052,55.17%,16.62%,1
臺中市,北屯區,0926,353,686,1039,42,1081,1875,57.65%,18.83%,1
臺中市,北屯區,0927,297,562,859,26,885,1559,56.77%,19.05%,1
臺中市,北屯區,0928,276,552,828,58,886,1480,59.86%,18.65%,1
臺中市,北屯區,0929,263,539,802,41,843,1397,60.34%,18.83%,1
臺中市,北屯區,0930,353,692,1045,48,1093,1889,57.86%,18.69%,1
臺中市,北屯區,0931,321,597,918,57,975,1728,56.42%,18.58%,1
臺中市,北屯區,0932,281,572,853,47,900,1592,56.53%,17.65%,1
臺中市,北屯區,0933,319,557,876,44,920,1656,55.56%,19.26%,1
臺中市,北屯區,0934,268,515,783,42,825,1524,54.13%,17.59%,1
臺中市,北屯區,0935,309,559,868,31,899,1502,59.85%,20.57%,1
臺中市,北屯區,0936,287,668,955,37,992,1772,55.98%,16.2%,1
臺中市,北屯區,0937,282,558,840,33,873,1461,59.75%,19.3%,1
臺中市,北屯區,0938,282,621,903,18,921,1769,52.06%,15.94%,1
臺中市,北屯區,0939,408,672,1080,50,1130,1894,59.66%,21.54%,1
臺中市,北屯區,0940,342,693,1035,44,1079,2033,53.07%,16.82%,1
臺中市,北屯區,0941,354,669,1023,45,1068,1947,54.85%,18.18%,1
臺中市,北屯區,0942,418,786,1204,52,1256,2188,57.4%,19.1%,1
臺中市,北屯區,0943,331,622,953,55,1008,1661,60.69%,19.93%,1
臺中市,北屯區,0944,301,648,949,28,977,1667,58.61%,18.06%,1
臺中市,北屯區,0945,319,621,940,42,982,1728,56.83%,18.46%,1
臺中市,北屯區,0946,305,609,914,37,951,1688,56.34%,18.07%,1
臺中市,北屯區,0947,273,545,818,23,841,1475,57.02%,18.51%,1
臺中市,北屯區,0948,368,663,1031,18,1049,1681,62.4%,21.89%,1
臺中市,北屯區,0949,368,822,1190,43,1233,2078,59.34%,17.71%,1
臺中市,北屯區,0950,337,791,1128,39,1167,2059,56.68%,16.37%,1
臺中市,北屯區,0951,334,675,1009,45,1054,1792,58.82%,18.64%,1
臺中市,北屯區,0952,366,671,1037,36,1073,2974,36.08%,12.31%,1
臺中市,北屯區,0953,187,404,591,42,633,1072,59.05%,17.44%,1
臺中市,北屯區,0954,383,865,1248,34,1282,2099,61.08%,18.25%,1
臺中市,北屯區,0955,373,753,1126,45,1171,1823,64.23%,20.46%,1
臺中市,北屯區,0956,389,773,1162,76,1238,2022,61.23%,19.24%,1
臺中市,北屯區,0957,353,765,1118,36,1154,1992,57.93%,17.72%,1
臺中市,北屯區,0958,292,632,924,54,978,1585,61.7%,18.42%,1
臺中市,北屯區,0959,282,633,915,47,962,1565,61.47%,18.02%,1
臺中市,北屯區,0960,271,644,915,37,952,1780,53.48%,15.22%,1
臺中市,北屯區,0961,349,759,1108,47,1155,1874,61.63%,18.62%,1
臺中市,北屯區,0962,286,743,1029,34,1063,1755,60.57%,16.3%,1
臺中市,北屯區,0963,337,680,1017,28,1045,1497,69.81%,22.51%,1
臺中市,北屯區,0964,289,640,929,50,979,1567,62.48%,18.44%,1
臺中市,北屯區,0965,263,621,884,39,923,1624,56.83%,16.19%,1
臺中市,北屯區,0966,265,682,947,45,992,1614,61.46%,16.42%,1
臺中市,北屯區,0967,293,594,887,30,917,1595,57.49%,18.37%,1
臺中市,北屯區,0968,271,632,903,55,958,1782,53.76%,15.21%,1
臺中市,北屯區,0969,200,490,690,34,724,1357,53.35%,14.74%,1
臺中市,北屯區,0970,174,402,576,50,626,1071,58.45%,16.25%,1
臺中市,北屯區,0971,220,495,715,47,762,1372,55.54%,16.03%,1
臺中市,北屯區,0972,244,567,811,50,861,1415,60.85%,17.24%,1
臺中市,北屯區,0973,337,716,1053,47,1100,1789,61.49%,18.84%,1
臺中市,北屯區,0974,309,807,1116,72,1188,1907,62.3%,16.2%,1
臺中市,北屯區,0975,339,801,1140,48,1188,2008,59.16%,16.88%,1
臺中市,北屯區,0976,252,577,829,51,880,1541,57.11%,16.35%,1
臺中市,北屯區,0977,290,666,956,44,1000,1669,59.92%,17.38%,1
臺中市,北屯區,0978,290,660,950,31,981,1685,58.22%,17.21%,1
臺中市,北屯區,0979,306,701,1007,100,1107,1785,62.02%,17.14%,1
臺中市,北屯區,0980,270,663,933,52,985,1596,61.72%,16.92%,1
臺中市,北屯區,0981,336,647,983,63,1046,1731,60.43%,19.41%,1
臺中市,北屯區,0982,233,558,791,60,851,1496,56.89%,15.57%,1
臺中市,豐原區,0394,157,366,523,43,566,983,57.58%,15.97%,1
臺中市,豐原區,0395,226,541,767,34,801,1309,61.19%,17.27%,1
臺中市,豐原區,0396,225,411,636,48,684,1116,61.29%,20.16%,1
臺中市,豐原區,0397,169,382,551,57,608,945,64.34%,17.88%,1
臺中市,豐原區,0398,168,328,496,56,552,850,64.94%,19.76%,1
臺中市,豐原區,0399,141,316,457,39,496,760,65.26%,18.55%,1
臺中市,豐原區,0400,283,625,908,11,919,1617,56.83%,17.5%,1
臺中市,豐原區,0401,236,615,851,44,895,1677,53.37%,14.07%,1
臺中市,豐原區,0402,324,771,1095,39,1134,1771,64.03%,18.29%,1
臺中市,豐原區,0403,165,461,626,42,668,1145,58.34%,14.41%,1
臺中市,豐原區,0404,261,501,762,33,795,1362,58.37%,19.16%,1
臺中市,豐原區,0405,234,566,800,45,845,1389,60.84%,16.85%,1
臺中市,豐原區,0406,268,631,899,41,940,1530,61.44%,17.52%,1
臺中市,豐原區,0407,231,587,818,64,882,1471,59.96%,15.7%,1
臺中市,豐原區,0408,229,565,794,69,863,1410,61.21%,16.24%,1
臺中市,豐原區,0409,179,459,638,44,682,1162,58.69%,15.4%,1
臺中市,豐原區,0410,261,658,919,35,954,1656,57.61%,15.76%,1
臺中市,豐原區,0411,259,744,1003,42,1045,1838,56.86%,14.09%,1
臺中市,豐原區,0412,263,636,899,54,953,1666,57.2%,15.79%,1
臺中市,豐原區,0413,370,650,1020,77,1097,1821,60.24%,20.32%,1
臺中市,豐原區,0414,341,796,1137,76,1213,1821,66.61%,18.73%,1
臺中市,豐原區,0415,311,596,907,36,943,1647,57.26%,18.88%,1
臺中市,豐原區,0416,268,498,766,77,843,1256,67.12%,21.34%,1
臺中市,豐原區,0417,265,680,945,45,990,1552,63.79%,17.07%,1
臺中市,豐原區,0418,307,709,1016,39,1055,1793,58.84%,17.12%,1
臺中市,豐原區,0419,161,338,499,35,534,759,70.36%,21.21%,1
臺中市,豐原區,0420,142,257,399,25,424,642,66.04%,22.12%,1
臺中市,豐原區,0421,297,610,907,33,940,1528,61.52%,19.44%,1
臺中市,豐原區,0422,319,767,1086,53,1139,1788,63.7%,17.84%,1
臺中市,豐原區,0423,349,668,1017,67,1084,1663,65.18%,20.99%,1
臺中市,豐原區,0424,251,567,818,57,875,1260,69.44%,19.92%,1
臺中市,豐原區,0425,150,345,495,40,535,902,59.31%,16.63%,1
臺中市,豐原區,0426,213,518,731,31,762,1357,56.15%,15.7%,1
臺中市,豐原區,0427,664,272,936,46,982,1592,61.68%,41.71%,1
臺中市,豐原區,0428,291,742,1033,70,1103,1873,58.89%,15.54%,1
臺中市,豐原區,0429,296,734,1030,61,1091,1867,58.44%,15.85%,1
臺中市,豐原區,0430,297,697,994,66,1060,1823,58.15%,16.29%,1
臺中市,豐原區,0431,325,669,994,50,1044,1962,53.21%,16.56%,1
臺中市,豐原區,0432,447,904,1351,62,1413,2313,61.09%,19.33%,1
臺中市,豐原區,0433,272,603,875,63,938,1510,62.12%,18.01%,1
臺中市,豐原區,0434,317,711,1028,68,1096,1824,60.09%,17.38%,1
臺中市,豐原區,0435,241,548,789,39,828,1363,60.75%,17.68%,1
臺中市,豐原區,0436,268,650,918,49,967,1535,63%,17.46%,1
臺中市,豐原區,0437,301,557,858,46,904,1457,62.05%,20.66%,1
臺中市,豐原區,0438,225,474,699,35,734,1184,61.99%,19%,1
臺中市,豐原區,0439,375,700,1075,47,1122,2299,48.8%,16.31%,1
臺中市,豐原區,0440,317,756,1073,83,1156,1940,59.59%,16.34%,1
臺中市,豐原區,0441,354,777,1131,48,1179,2067,57.04%,17.13%,1
臺中市,豐原區,0442,344,740,1084,68,1152,2038,56.53%,16.88%,1
臺中市,豐原區,0443,329,685,1014,53,1067,1835,58.15%,17.93%,1
臺中市,豐原區,0444,308,761,1069,78,1147,1979,57.96%,15.56%,1
臺中市,豐原區,0445,327,749,1076,67,1143,2014,56.75%,16.24%,1
臺中市,豐原區,0446,346,887,1233,89,1322,2257,58.57%,15.33%,1
臺中市,豐原區,0447,230,612,842,51,893,1406,63.51%,16.36%,1
臺中市,豐原區,0448,270,558,828,42,870,1418,61.35%,19.04%,1
臺中市,豐原區,0449,279,776,1055,67,1122,1772,63.32%,15.74%,1
臺中市,豐原區,0450,236,514,750,30,780,1202,64.89%,19.63%,1
臺中市,豐原區,0451,255,611,866,33,899,1447,62.13%,17.62%,1
臺中市,豐原區,0452,276,731,1007,80,1087,1758,61.83%,15.7%,1
臺中市,豐原區,0453,279,669,948,42,990,1546,64.04%,18.05%,1
臺中市,豐原區,0454,298,775,1073,56,1129,1815,62.2%,16.42%,1
臺中市,豐原區,0455,373,730,1103,65,1168,1932,60.46%,19.31%,1
臺中市,豐原區,0456,322,769,1091,49,1140,1770,64.41%,18.19%,1
臺中市,豐原區,0457,236,608,844,28,872,1560,55.9%,15.13%,1
臺中市,豐原區,0458,323,695,1018,49,1067,1810,58.95%,17.85%,1
臺中市,豐原區,0459,344,666,1010,41,1051,1653,63.58%,20.81%,1
臺中市,豐原區,0460,200,614,814,54,868,1444,60.11%,13.85%,1
臺中市,豐原區,0461,251,562,813,27,840,1318,63.73%,19.04%,1
臺中市,豐原區,0462,309,583,892,69,961,1566,61.37%,19.73%,1
臺中市,豐原區,0463,290,688,978,45,1023,1748,58.52%,16.59%,1
臺中市,豐原區,0464,272,624,896,70,966,1772,54.51%,15.35%,1
臺中市,豐原區,0465,259,695,954,58,1012,1721,58.8%,15.05%,1
臺中市,豐原區,0466,258,648,906,49,955,1578,60.52%,16.35%,1
臺中市,豐原區,0467,351,656,1007,87,1094,1859,58.85%,18.88%,1
臺中市,豐原區,0468,285,548,833,45,878,1479,59.36%,19.27%,1
臺中市,豐原區,0469,305,765,1070,57,1127,1889,59.66%,16.15%,1
臺中市,豐原區,0470,280,692,972,63,1035,1803,57.4%,15.53%,1
臺中市,豐原區,0471,250,478,728,57,785,1421,55.24%,17.59%,1
臺中市,豐原區,0472,194,758,952,55,1007,1585,63.53%,12.24%,1
臺中市,豐原區,0473,312,731,1043,73,1116,1774,62.91%,17.59%,1
臺中市,豐原區,0474,201,991,1192,68,1260,2132,59.1%,9.43%,1
臺中市,豐原區,0475,228,617,845,62,907,1515,59.87%,15.05%,1
臺中市,豐原區,0476,212,501,713,32,745,1359,54.82%,15.6%,1
臺中市,豐原區,0477,182,381,563,40,603,948,63.61%,19.2%,1
臺中市,豐原區,0478,203,471,674,40,714,1134,62.96%,17.9%,1
臺中市,豐原區,0479,198,493,691,58,749,1114,67.24%,17.77%,1
臺中市,豐原區,0480,172,414,586,53,639,1050,60.86%,16.38%,1
臺中市,豐原區,0481,253,471,724,52,776,1182,65.65%,21.4%,1
臺中市,東勢區,1513,146,513,659,67,726,1299,55.89%,11.24%,1
臺中市,東勢區,1514,118,407,525,58,583,1007,57.89%,11.72%,1
臺中市,東勢區,1515,93,335,428,52,480,859,55.88%,10.83%,1
臺中市,東勢區,1516,154,430,584,63,647,991,65.29%,15.54%,1
臺中市,東勢區,1517,118,322,440,22,462,863,53.53%,13.67%,1
臺中市,東勢區,1518,201,627,828,98,926,1628,56.88%,12.35%,1
臺中市,東勢區,1519,213,450,663,55,718,1335,53.78%,15.96%,1
臺中市,東勢區,1520,193,449,642,58,700,1092,64.1%,17.67%,1
臺中市,東勢區,1521,174,465,639,41,680,1050,64.76%,16.57%,1
臺中市,東勢區,1522,185,597,782,47,829,1431,57.93%,12.93%,1
臺中市,東勢區,1523,190,584,774,49,823,1372,59.99%,13.85%,1
臺中市,東勢區,1524,259,590,849,38,887,1412,62.82%,18.34%,1
臺中市,東勢區,1525,107,358,465,54,519,878,59.11%,12.19%,1
臺中市,東勢區,1526,160,539,699,65,764,1475,51.8%,10.85%,1
臺中市,東勢區,1527,95,352,447,26,473,872,54.24%,10.89%,1
臺中市,東勢區,1528,121,390,511,61,572,1006,56.86%,12.03%,1
臺中市,東勢區,1529,184,482,666,30,696,1222,56.96%,15.06%,1
臺中市,東勢區,1530,183,589,772,49,821,1228,66.86%,14.9%,1
臺中市,東勢區,1531,159,454,613,34,647,1036,62.45%,15.35%,1
臺中市,東勢區,1532,166,428,594,26,620,977,63.46%,16.99%,1
臺中市,東勢區,1533,214,540,754,44,798,1395,57.2%,15.34%,1
臺中市,東勢區,1534,182,490,672,69,741,1169,63.39%,15.57%,1
臺中市,東勢區,1535,136,451,587,57,644,1027,62.71%,13.24%,1
臺中市,東勢區,1536,143,427,570,29,599,984,60.87%,14.53%,1
臺中市,東勢區,1537,144,405,549,36,585,866,67.55%,16.63%,1
臺中市,東勢區,1538,150,440,590,51,641,1031,62.17%,14.55%,1
臺中市,東勢區,1539,128,393,521,56,577,865,66.71%,14.8%,1
臺中市,東勢區,1540,190,620,810,53,863,1357,63.6%,14%,1
臺中市,東勢區,1541,108,311,419,34,453,736,61.55%,14.67%,1
臺中市,東勢區,1542,177,539,716,62,778,1314,59.21%,13.47%,1
臺中市,東勢區,1543,237,581,818,100,918,1677,54.74%,14.13%,1
臺中市,東勢區,1544,137,428,565,22,587,950,61.79%,14.42%,1
臺中市,東勢區,1545,146,438,584,46,630,1007,62.56%,14.5%,1
臺中市,東勢區,1546,153,437,590,46,636,1214,52.39%,12.6%,1
臺中市,東勢區,1547,108,373,481,43,524,907,57.77%,11.91%,1
臺中市,東勢區,1548,132,320,452,44,496,902,54.99%,14.63%,1
臺中市,東勢區,1549,73,239,312,18,330,720,45.83%,10.14%,1
臺中市,東勢區,1550,78,236,314,15,329,666,49.4%,11.71%,1
臺中市,東勢區,1551,183,517,700,47,747,1361,54.89%,13.45%,1
臺中市,大甲區,0001,228,518,746,67,813,1356,59.96%,16.81%,1
臺中市,大甲區,0002,217,411,628,37,665,1059,62.8%,20.49%,1
臺中市,大甲區,0003,132,278,410,32,442,694,63.69%,19.02%,1
臺中市,大甲區,0004,147,359,506,25,531,874,60.76%,16.82%,1
臺中市,大甲區,0005,116,296,412,18,430,763,56.36%,15.2%,1
臺中市,大甲區,0006,151,369,520,29,549,856,64.14%,17.64%,1
臺中市,大甲區,0007,218,492,710,34,744,1249,59.57%,17.45%,1
臺中市,大甲區,0008,157,333,490,32,522,922,56.62%,17.03%,1
臺中市,大甲區,0009,221,456,677,35,712,1189,59.88%,18.59%,1
臺中市,大甲區,0010,195,435,630,50,680,1065,63.85%,18.31%,1
臺中市,大甲區,0011,201,535,736,74,810,1252,64.7%,16.05%,1
臺中市,大甲區,0012,156,425,581,38,619,1057,58.56%,14.76%,1
臺中市,大甲區,0013,151,420,571,36,607,1031,58.87%,14.65%,1
臺中市,大甲區,0014,187,442,629,40,669,1060,63.11%,17.64%,1
臺中市,大甲區,0015,216,504,720,50,770,1311,58.73%,16.48%,1
臺中市,大甲區,0016,209,571,780,38,818,1424,57.44%,14.68%,1
臺中市,大甲區,0017,205,639,844,57,901,1670,53.95%,12.28%,1
臺中市,大甲區,0018,143,306,449,34,483,812,59.48%,17.61%,1
臺中市,大甲區,0019,118,387,505,29,534,863,61.88%,13.67%,1
臺中市,大甲區,0020,262,636,898,51,949,1598,59.39%,16.4%,1
臺中市,大甲區,0021,233,626,859,44,903,1588,56.86%,14.67%,1
臺中市,大甲區,0022,200,448,648,50,698,1197,58.31%,16.71%,1
臺中市,大甲區,0023,167,380,547,70,617,1106,55.79%,15.1%,1
臺中市,大甲區,0024,167,367,534,35,569,903,63.01%,18.49%,1
臺中市,大甲區,0025,144,360,504,37,541,869,62.26%,16.57%,1
臺中市,大甲區,0026,247,511,758,29,787,1350,58.3%,18.3%,1
臺中市,大甲區,0027,167,434,601,89,690,1144,60.31%,14.6%,1
臺中市,大甲區,0028,286,424,710,40,750,1208,62.09%,23.68%,1
臺中市,大甲區,0029,298,595,893,42,935,1567,59.67%,19.02%,1
臺中市,大甲區,0030,261,506,767,33,800,1246,64.21%,20.95%,1
臺中市,大甲區,0031,125,303,428,39,467,767,60.89%,16.3%,1
臺中市,大甲區,0032,126,325,451,31,482,790,61.01%,15.95%,1
臺中市,大甲區,0033,149,399,548,47,595,972,61.21%,15.33%,1
臺中市,大甲區,0034,188,519,707,61,768,1388,55.33%,13.54%,1
臺中市,大甲區,0035,197,479,676,38,714,1331,53.64%,14.8%,1
臺中市,大甲區,0036,196,485,681,47,728,1167,62.38%,16.8%,1
臺中市,大甲區,0037,324,762,1086,45,1131,1934,58.48%,16.75%,1
臺中市,大甲區,0038,185,416,601,61,662,1263,52.41%,14.65%,1
臺中市,大甲區,0039,212,541,753,43,796,1390,57.27%,15.25%,1
臺中市,大甲區,0040,149,408,557,35,592,1186,49.92%,12.56%,1
臺中市,大甲區,0041,232,521,753,42,795,1397,56.91%,16.61%,1
臺中市,大甲區,0042,157,364,521,20,541,1173,46.12%,13.38%,1
臺中市,大甲區,0043,225,483,708,66,774,1398,55.36%,16.09%,1
臺中市,大甲區,0044,199,387,586,53,639,1228,52.04%,16.21%,1
臺中市,大甲區,0045,197,444,641,40,681,1258,54.13%,15.66%,1
臺中市,大甲區,0046,207,545,752,36,788,1435,54.91%,14.43%,1
臺中市,大甲區,0047,248,541,789,55,844,1532,55.09%,16.19%,1
臺中市,大甲區,0048,93,259,352,30,382,652,58.59%,14.26%,1
臺中市,大甲區,0049,135,279,414,27,441,870,50.69%,15.52%,1
臺中市,大甲區,0050,118,340,458,21,479,891,53.76%,13.24%,1
臺中市,大甲區,0051,119,313,432,34,466,784,59.44%,15.18%,1
臺中市,大甲區,0052,166,508,674,77,751,1368,54.9%,12.13%,1
臺中市,大甲區,0053,159,394,553,53,606,1126,53.82%,14.12%,1
臺中市,大甲區,0054,205,465,670,70,740,1486,49.8%,13.8%,1
臺中市,清水區,0091,189,375,564,23,587,1076,54.55%,17.57%,1
臺中市,清水區,0092,205,379,584,41,625,953,65.58%,21.51%,1
臺中市,清水區,0093,179,348,527,47,574,914,62.8%,19.58%,1
臺中市,清水區,0094,217,469,686,46,732,1143,64.04%,18.99%,1
臺中市,清水區,0095,149,255,404,27,431,680,63.38%,21.91%,1
臺中市,清水區,0096,144,376,520,43,563,904,62.28%,15.93%,1
臺中市,清水區,0097,165,380,545,35,580,893,64.95%,18.48%,1
臺中市,清水區,0098,293,579,872,46,918,1577,58.21%,18.58%,1
臺中市,清水區,0099,116,263,379,29,408,690,59.13%,16.81%,1
臺中市,清水區,0100,65,164,229,18,247,403,61.29%,16.13%,1
臺中市,清水區,0101,244,537,781,59,840,1413,59.45%,17.27%,1
臺中市,清水區,0102,121,305,426,36,462,777,59.46%,15.57%,1
臺中市,清水區,0103,210,552,762,33,795,1313,60.55%,15.99%,1
臺中市,清水區,0104,242,601,843,48,891,1439,61.92%,16.82%,1
臺中市,清水區,0105,210,443,653,37,690,1265,54.55%,16.6%,1
臺中市,清水區,0106,247,523,770,34,804,1277,62.96%,19.34%,1
臺中市,清水區,0107,223,508,731,44,775,1276,60.74%,17.48%,1
臺中市,清水區,0108,281,553,834,28,862,1376,62.65%,20.42%,1
臺中市,清水區,0109,234,550,784,35,819,1291,63.44%,18.13%,1
臺中市,清水區,0110,291,554,845,76,921,1510,60.99%,19.27%,1
臺中市,清水區,0111,235,573,808,8,816,1524,53.54%,15.42%,1
臺中市,清水區,0112,240,511,751,44,795,1474,53.93%,16.28%,1
臺中市,清水區,0113,240,564,804,51,855,1507,56.74%,15.93%,1
臺中市,清水區,0114,240,562,802,60,862,1321,65.25%,18.17%,1
臺中市,清水區,0115,178,395,573,39,612,1157,52.9%,15.38%,1
臺中市,清水區,0116,225,494,719,39,758,1255,60.4%,17.93%,1
臺中市,清水區,0117,135,350,485,28,513,881,58.23%,15.32%,1
臺中市,清水區,0118,192,427,619,50,669,1083,61.77%,17.73%,1
臺中市,清水區,0119,156,407,563,28,591,951,62.15%,16.4%,1
臺中市,清水區,0120,224,513,737,46,783,1424,54.99%,15.73%,1
臺中市,清水區,0121,198,418,616,59,675,1233,54.74%,16.06%,1
臺中市,清水區,0122,184,404,588,45,633,1288,49.15%,14.29%,1
臺中市,清水區,0123,198,477,675,44,719,1200,59.92%,16.5%,1
臺中市,清水區,0124,201,732,933,32,965,1609,59.98%,12.49%,1
臺中市,清水區,0125,236,469,705,20,725,1136,63.82%,20.77%,1
臺中市,清水區,0126,169,502,671,69,740,1302,56.84%,12.98%,1
臺中市,清水區,0127,214,483,697,85,782,1373,56.96%,15.59%,1
臺中市,清水區,0128,184,396,580,76,656,1257,52.19%,14.64%,1
臺中市,清水區,0129,177,391,568,51,619,1184,52.28%,14.95%,1
臺中市,清水區,0130,171,512,683,66,749,1322,56.66%,12.93%,1
臺中市,清水區,0131,182,396,578,56,634,1193,53.14%,15.26%,1
臺中市,清水區,0132,151,316,467,76,543,927,58.58%,16.29%,1
臺中市,清水區,0133,203,416,619,51,670,1073,62.44%,18.92%,1
臺中市,清水區,0134,219,434,653,71,724,1163,62.25%,18.83%,1
臺中市,清水區,0135,124,319,443,35,478,855,55.91%,14.5%,1
臺中市,清水區,0136,121,320,441,60,501,902,55.54%,13.41%,1
臺中市,清水區,0137,151,620,771,48,819,1415,57.88%,10.67%,1
臺中市,清水區,0138,155,390,545,44,589,1066,55.25%,14.54%,1
臺中市,清水區,0139,199,516,715,68,783,1391,56.29%,14.31%,1
臺中市,清水區,0140,190,528,718,48,766,1449,52.86%,13.11%,1
臺中市,清水區,0141,226,556,782,52,834,1377,60.57%,16.41%,1
臺中市,清水區,0142,252,552,804,44,848,1423,59.59%,17.71%,1
臺中市,清水區,0143,635,279,914,33,947,1624,58.31%,39.1%,1
臺中市,清水區,0144,198,488,686,67,753,1358,55.45%,14.58%,1
臺中市,清水區,0145,221,556,777,78,855,1464,58.4%,15.1%,1
臺中市,清水區,0146,219,462,681,59,740,1211,61.11%,18.08%,1
臺中市,清水區,0147,202,584,786,23,809,1456,55.56%,13.87%,1
臺中市,清水區,0148,167,506,673,54,727,1162,62.56%,14.37%,1
臺中市,清水區,0149,193,624,817,60,877,1368,64.11%,14.11%,1
臺中市,沙鹿區,0186,251,453,704,37,741,1380,53.7%,18.19%,1
臺中市,沙鹿區,0187,138,351,489,32,521,852,61.15%,16.2%,1
臺中市,沙鹿區,0188,295,399,694,33,727,1176,61.82%,25.09%,1
臺中市,沙鹿區,0189,202,385,587,59,646,958,67.43%,21.09%,1
臺中市,沙鹿區,0190,93,222,315,24,339,488,69.47%,19.06%,1
臺中市,沙鹿區,0191,223,427,650,40,690,1177,58.62%,18.95%,1
臺中市,沙鹿區,0192,218,470,688,51,739,1285,57.51%,16.96%,1
臺中市,沙鹿區,0193,262,620,882,62,944,1736,54.38%,15.09%,1
臺中市,沙鹿區,0194,295,614,909,68,977,1628,60.01%,18.12%,1
臺中市,沙鹿區,0195,218,558,776,23,799,1469,54.39%,14.84%,1
臺中市,沙鹿區,0196,225,598,823,48,871,1423,61.21%,15.81%,1
臺中市,沙鹿區,0197,207,588,795,67,862,1444,59.7%,14.34%,1
臺中市,沙鹿區,0198,238,564,802,62,864,1469,58.82%,16.2%,1
臺中市,沙鹿區,0199,355,684,1039,56,1095,1902,57.57%,18.66%,1
臺中市,沙鹿區,0200,293,649,942,47,989,1675,59.04%,17.49%,1
臺中市,沙鹿區,0201,225,362,587,48,635,1098,57.83%,20.49%,1
臺中市,沙鹿區,0202,291,598,889,49,938,1539,60.95%,18.91%,1
臺中市,沙鹿區,0203,241,543,784,26,810,1329,60.95%,18.13%,1
臺中市,沙鹿區,0204,205,472,677,32,709,1255,56.49%,16.33%,1
臺中市,沙鹿區,0205,303,554,857,46,903,1507,59.92%,20.11%,1
臺中市,沙鹿區,0206,246,559,805,56,861,1463,58.85%,16.81%,1
臺中市,沙鹿區,0207,205,452,657,50,707,1279,55.28%,16.03%,1
臺中市,沙鹿區,0208,146,358,504,42,546,1024,53.32%,14.26%,1
臺中市,沙鹿區,0209,194,513,707,53,760,1388,54.76%,13.98%,1
臺中市,沙鹿區,0210,196,432,628,26,654,1074,60.89%,18.25%,1
臺中市,沙鹿區,0211,183,444,627,31,658,1072,61.38%,17.07%,1
臺中市,沙鹿區,0212,164,481,645,45,690,1107,62.33%,14.81%,1
臺中市,沙鹿區,0213,281,662,943,48,991,1947,50.9%,14.43%,1
臺中市,沙鹿區,0214,236,618,854,53,907,1682,53.92%,14.03%,1
臺中市,沙鹿區,0215,284,634,918,34,952,1633,58.3%,17.39%,1
臺中市,沙鹿區,0216,222,562,784,44,828,1533,54.01%,14.48%,1
臺中市,沙鹿區,0217,225,423,648,130,778,1605,48.47%,14.02%,1
臺中市,沙鹿區,0218,242,624,866,35,901,1694,53.19%,14.29%,1
臺中市,沙鹿區,0219,271,561,832,45,877,1628,53.87%,16.65%,1
臺中市,沙鹿區,0220,296,657,953,26,979,1665,58.8%,17.78%,1
臺中市,沙鹿區,0221,265,608,873,39,912,1651,55.24%,16.05%,1
臺中市,沙鹿區,0222,170,480,650,32,682,1108,61.55%,15.34%,1
臺中市,沙鹿區,0223,178,483,661,39,700,1142,61.3%,15.59%,1
臺中市,沙鹿區,0224,178,393,571,32,603,1039,58.04%,17.13%,1
臺中市,沙鹿區,0225,310,644,954,58,1012,1840,55%,16.85%,1
臺中市,沙鹿區,0226,319,679,998,42,1040,1872,55.56%,17.04%,1
臺中市,沙鹿區,0227,253,538,791,45,836,1558,53.66%,16.24%,1
臺中市,沙鹿區,0228,219,646,865,40,905,1739,52.04%,12.59%,1
臺中市,沙鹿區,0229,238,552,790,53,843,1672,50.42%,14.23%,1
臺中市,沙鹿區,0230,269,613,882,26,908,1634,55.57%,16.46%,1
臺中市,沙鹿區,0231,257,525,782,48,830,1616,51.36%,15.9%,1
臺中市,沙鹿區,0232,251,598,849,38,887,1593,55.68%,15.76%,1
臺中市,沙鹿區,0233,130,395,525,16,541,981,55.15%,13.25%,1
臺中市,沙鹿區,0234,280,713,993,52,1045,1740,60.06%,16.09%,1
臺中市,沙鹿區,0235,222,490,712,53,765,1247,61.35%,17.8%,1
臺中市,沙鹿區,0236,147,462,609,16,625,1047,59.69%,14.04%,1
臺中市,沙鹿區,0237,173,438,611,51,662,1119,59.16%,15.46%,1
臺中市,沙鹿區,0238,137,425,562,22,584,1025,56.98%,13.37%,1
臺中市,梧棲區,0150,260,554,814,57,871,1541,56.52%,16.87%,1
臺中市,梧棲區,0151,253,577,830,56,886,1581,56.04%,16%,1
臺中市,梧棲區,0152,201,398,599,43,642,1083,59.28%,18.56%,1
臺中市,梧棲區,0153,153,360,513,17,530,876,60.5%,17.47%,1
臺中市,梧棲區,0154,193,374,567,57,624,1043,59.83%,18.5%,1
臺中市,梧棲區,0155,230,516,746,35,781,1502,52%,15.31%,1
臺中市,梧棲區,0156,210,540,750,50,800,1384,57.8%,15.17%,1
臺中市,梧棲區,0157,90,233,323,29,352,517,68.09%,17.41%,1
臺中市,梧棲區,0158,197,509,706,49,755,1169,64.59%,16.85%,1
臺中市,梧棲區,0159,165,324,489,35,524,863,60.72%,19.12%,1
臺中市,梧棲區,0160,191,404,595,45,640,1277,50.12%,14.96%,1
臺中市,梧棲區,0161,294,607,901,45,946,1742,54.31%,16.88%,1
臺中市,梧棲區,0162,224,508,732,62,794,1342,59.17%,16.69%,1
臺中市,梧棲區,0163,301,646,947,76,1023,1767,57.89%,17.03%,1
臺中市,梧棲區,0164,240,481,721,59,780,1542,50.58%,15.56%,1
臺中市,梧棲區,0165,242,611,853,44,897,1636,54.83%,14.79%,1
臺中市,梧棲區,0166,269,637,906,48,954,1796,53.12%,14.98%,1
臺中市,梧棲區,0167,219,545,764,37,801,1450,55.24%,15.1%,1
臺中市,梧棲區,0168,231,537,768,89,857,1548,55.36%,14.92%,1
臺中市,梧棲區,0169,245,531,776,31,807,1366,59.08%,17.94%,1
臺中市,梧棲區,0170,181,417,598,21,619,955,64.82%,18.95%,1
臺中市,梧棲區,0171,178,501,679,39,718,1305,55.02%,13.64%,1
臺中市,梧棲區,0172,202,491,693,39,732,1239,59.08%,16.3%,1
臺中市,梧棲區,0173,182,432,614,55,669,1079,62%,16.87%,1
臺中市,梧棲區,0174,176,477,653,40,693,1220,56.8%,14.43%,1
臺中市,梧棲區,0175,247,624,871,58,929,1544,60.17%,16%,1
臺中市,梧棲區,0176,284,554,838,46,884,1460,60.55%,19.45%,1
臺中市,梧棲區,0177,219,517,736,51,787,1292,60.91%,16.95%,1
臺中市,梧棲區,0178,209,492,701,38,739,1300,56.85%,16.08%,1
臺中市,梧棲區,0179,238,557,795,44,839,1555,53.95%,15.31%,1
臺中市,梧棲區,0180,157,376,533,43,576,1031,55.87%,15.23%,1
臺中市,梧棲區,0181,213,500,713,57,770,1277,60.3%,16.68%,1
臺中市,梧棲區,0182,169,372,541,41,582,1037,56.12%,16.3%,1
臺中市,梧棲區,0183,188,465,653,58,711,1187,59.9%,15.84%,1
臺中市,梧棲區,0184,195,510,705,53,758,1399,54.18%,13.94%,1
臺中市,梧棲區,0185,157,445,602,38,640,1135,56.39%,13.83%,1
臺中市,后里區,0357,134,361,495,51,546,852,64.08%,15.73%,1
臺中市,后里區,0358,161,431,592,58,650,1135,57.27%,14.19%,1
臺中市,后里區,0359,158,377,535,53,588,1079,54.49%,14.64%,1
臺中市,后里區,0360,247,604,851,58,909,1539,59.06%,16.05%,1
臺中市,后里區,0361,270,599,869,59,928,1591,58.33%,16.97%,1
臺中市,后里區,0362,211,477,688,27,715,1376,51.96%,15.33%,1
臺中市,后里區,0363,206,509,715,24,739,1298,56.93%,15.87%,1
臺中市,后里區,0364,246,532,778,79,857,1428,60.01%,17.23%,1
臺中市,后里區,0365,218,520,738,45,783,1178,66.47%,18.51%,1
臺中市,后里區,0366,170,457,627,29,656,1095,59.91%,15.53%,1
臺中市,后里區,0367,159,366,525,25,550,963,57.11%,16.51%,1
臺中市,后里區,0368,193,439,632,40,672,1163,57.78%,16.6%,1
臺中市,后里區,0369,166,417,583,36,619,1018,60.81%,16.31%,1
臺中市,后里區,0370,147,372,519,35,554,854,64.87%,17.21%,1
臺中市,后里區,0371,208,549,757,59,816,1485,54.95%,14.01%,1
臺中市,后里區,0372,220,578,798,60,858,1355,63.32%,16.24%,1
臺中市,后里區,0373,129,288,417,50,467,840,55.6%,15.36%,1
臺中市,后里區,0374,179,460,639,48,687,1146,59.95%,15.62%,1
臺中市,后里區,0375,263,691,954,72,1026,1669,61.47%,15.76%,1
臺中市,后里區,0376,344,600,944,99,1043,1673,62.34%,20.56%,1
臺中市,后里區,0377,241,583,824,47,871,1493,58.34%,16.14%,1
臺中市,后里區,0378,193,401,594,61,655,1052,62.26%,18.35%,1
臺中市,后里區,0379,143,336,479,19,498,909,54.79%,15.73%,1
臺中市,后里區,0380,181,423,604,65,669,1091,61.32%,16.59%,1
臺中市,后里區,0381,212,548,760,73,833,1342,62.07%,15.8%,1
臺中市,后里區,0382,181,396,577,68,645,1138,56.68%,15.91%,1
臺中市,后里區,0383,144,404,548,42,590,977,60.39%,14.74%,1
臺中市,后里區,0384,203,544,747,38,785,1584,49.56%,12.82%,1
臺中市,后里區,0385,129,368,497,43,540,915,59.02%,14.1%,1
臺中市,后里區,0386,190,476,666,72,738,1225,60.24%,15.51%,1
臺中市,后里區,0387,248,591,839,40,879,1552,56.64%,15.98%,1
臺中市,后里區,0388,231,644,875,33,908,1600,56.75%,14.44%,1
臺中市,后里區,0389,148,356,504,30,534,942,56.69%,15.71%,1
臺中市,后里區,0390,145,354,499,29,528,943,55.99%,15.38%,1
臺中市,后里區,0391,169,347,516,46,562,1055,53.27%,16.02%,1
臺中市,后里區,0392,188,385,573,58,631,1067,59.14%,17.62%,1
臺中市,后里區,0393,180,484,664,48,712,1340,53.13%,13.43%,1
臺中市,神岡區,0482,284,688,972,56,1028,1684,61.05%,16.86%,1
臺中市,神岡區,0483,221,654,875,47,922,1559,59.14%,14.18%,1
臺中市,神岡區,0484,179,420,599,42,641,1095,58.54%,16.35%,1
臺中市,神岡區,0485,205,468,673,38,711,1044,68.1%,19.64%,1
臺中市,神岡區,0486,224,572,796,58,854,1310,65.19%,17.1%,1
臺中市,神岡區,0487,231,516,747,79,826,1294,63.83%,17.85%,1
臺中市,神岡區,0488,199,441,640,55,695,1143,60.8%,17.41%,1
臺中市,神岡區,0489,165,417,582,56,638,1022,62.43%,16.14%,1
臺中市,神岡區,0490,166,511,677,42,719,1269,56.66%,13.08%,1
臺中市,神岡區,0491,129,383,512,28,540,1085,49.77%,11.89%,1
臺中市,神岡區,0492,182,388,570,31,601,942,63.8%,19.32%,1
臺中市,神岡區,0493,191,447,638,39,677,1154,58.67%,16.55%,1
臺中市,神岡區,0494,228,511,739,48,787,1390,56.62%,16.4%,1
臺中市,神岡區,0495,218,569,787,82,869,1372,63.34%,15.89%,1
臺中市,神岡區,0496,194,501,695,40,735,1328,55.35%,14.61%,1
臺中市,神岡區,0497,183,379,562,32,594,1038,57.23%,17.63%,1
臺中市,神岡區,0498,211,568,779,42,821,1452,56.54%,14.53%,1
臺中市,神岡區,0499,259,643,902,153,1055,1551,68.02%,16.7%,1
臺中市,神岡區,0500,244,572,816,52,868,1567,55.39%,15.57%,1
臺中市,神岡區,0501,239,571,810,32,842,1449,58.11%,16.49%,1
臺中市,神岡區,0502,174,468,642,29,671,1246,53.85%,13.96%,1
臺中市,神岡區,0503,228,574,802,43,845,1431,59.05%,15.93%,1
臺中市,神岡區,0504,220,455,675,59,734,1163,63.11%,18.92%,1
臺中市,神岡區,0505,286,559,845,64,909,1402,64.84%,20.4%,1
臺中市,神岡區,0506,211,521,732,34,766,1271,60.27%,16.6%,1
臺中市,神岡區,0507,274,416,690,54,744,1198,62.1%,22.87%,1
臺中市,神岡區,0508,199,549,748,57,805,1312,61.36%,15.17%,1
臺中市,神岡區,0509,242,607,849,57,906,1590,56.98%,15.22%,1
臺中市,神岡區,0510,198,520,718,26,744,1324,56.19%,14.95%,1
臺中市,神岡區,0511,257,498,755,33,788,1415,55.69%,18.16%,1
臺中市,神岡區,0512,244,663,907,50,957,1483,64.53%,16.45%,1
臺中市,神岡區,0513,208,522,730,35,765,1402,54.56%,14.84%,1
臺中市,神岡區,0514,199,474,673,41,714,1275,56%,15.61%,1
臺中市,神岡區,0515,192,469,661,44,705,1288,54.74%,14.91%,1
臺中市,神岡區,0516,147,411,558,53,611,1080,56.57%,13.61%,1
臺中市,神岡區,0517,221,507,728,31,759,1344,56.47%,16.44%,1
臺中市,神岡區,0518,178,446,624,43,667,1061,62.87%,16.78%,1
臺中市,神岡區,0519,214,480,694,54,748,1176,63.61%,18.2%,1
臺中市,神岡區,0520,218,509,727,53,780,1244,62.7%,17.52%,1
臺中市,神岡區,0521,225,565,790,60,850,1318,64.49%,17.07%,1
臺中市,神岡區,0522,225,573,798,33,831,1471,56.49%,15.3%,1
臺中市,神岡區,0523,208,596,804,75,879,1323,66.44%,15.72%,1
臺中市,潭子區,0570,227,537,764,40,804,1306,61.56%,17.38%,1
臺中市,潭子區,0571,201,454,655,44,699,1128,61.97%,17.82%,1
臺中市,潭子區,0572,198,490,688,55,743,1159,64.11%,17.08%,1
臺中市,潭子區,0573,287,648,935,71,1006,1630,61.72%,17.61%,1
臺中市,潭子區,0574,238,613,851,41,892,1532,58.22%,15.54%,1
臺中市,潭子區,0575,256,592,848,40,888,1677,52.95%,15.27%,1
臺中市,潭子區,0576,263,608,871,57,928,1744,53.21%,15.08%,1
臺中市,潭子區,0577,302,644,946,90,1036,1795,57.72%,16.82%,1
臺中市,潭子區,0578,199,437,636,46,682,1171,58.24%,16.99%,1
臺中市,潭子區,0579,246,552,798,23,821,1427,57.53%,17.24%,1
臺中市,潭子區,0580,257,675,932,53,985,1709,57.64%,15.04%,1
臺中市,潭子區,0581,287,645,932,40,972,1723,56.41%,16.66%,1
臺中市,潭子區,0582,267,680,947,46,993,1782,55.72%,14.98%,1
臺中市,潭子區,0583,205,538,743,27,770,1407,54.73%,14.57%,1
臺中市,潭子區,0584,361,653,1014,39,1053,1771,59.46%,20.38%,1
臺中市,潭子區,0585,282,723,1005,82,1087,1795,60.56%,15.71%,1
臺中市,潭子區,0586,293,664,957,54,1011,1612,62.72%,18.18%,1
臺中市,潭子區,0587,336,708,1044,30,1074,1894,56.71%,17.74%,1
臺中市,潭子區,0588,289,646,935,41,976,1689,57.79%,17.11%,1
臺中市,潭子區,0589,243,537,780,42,822,1525,53.9%,15.93%,1
臺中市,潭子區,0590,280,606,886,36,922,1622,56.84%,17.26%,1
臺中市,潭子區,0591,200,503,703,48,751,1200,62.58%,16.67%,1
臺中市,潭子區,0592,214,505,719,19,738,1355,54.46%,15.79%,1
臺中市,潭子區,0593,301,642,943,32,975,1777,54.87%,16.94%,1
臺中市,潭子區,0594,294,755,1049,49,1098,1923,57.1%,15.29%,1
臺中市,潭子區,0595,247,612,859,64,923,1674,55.14%,14.76%,1
臺中市,潭子區,0596,273,592,865,46,911,1451,62.78%,18.81%,1
臺中市,潭子區,0597,247,578,825,59,884,1486,59.49%,16.62%,1
臺中市,潭子區,0598,262,615,877,42,919,1511,60.82%,17.34%,1
臺中市,潭子區,0599,282,672,954,46,1000,1666,60.02%,16.93%,1
臺中市,潭子區,0600,290,653,943,46,989,1750,56.51%,16.57%,1
臺中市,潭子區,0601,221,560,781,36,817,1437,56.85%,15.38%,1
臺中市,潭子區,0602,291,661,952,31,983,1735,56.66%,16.77%,1
臺中市,潭子區,0603,284,579,863,34,897,1612,55.65%,17.62%,1
臺中市,潭子區,0604,223,458,681,25,706,1143,61.77%,19.51%,1
臺中市,潭子區,0605,305,804,1109,44,1153,2096,55.01%,14.55%,1
臺中市,潭子區,0606,267,623,890,53,943,1549,60.88%,17.24%,1
臺中市,潭子區,0607,256,634,890,36,926,1573,58.87%,16.27%,1
臺中市,潭子區,0608,213,628,841,40,881,1585,55.58%,13.44%,1
臺中市,潭子區,0609,288,568,856,24,880,1572,55.98%,18.32%,1
臺中市,潭子區,0610,291,722,1013,33,1046,1738,60.18%,16.74%,1
臺中市,潭子區,0611,298,689,987,65,1052,1883,55.87%,15.83%,1
臺中市,潭子區,0612,596,234,830,36,866,1401,61.81%,42.54%,1
臺中市,潭子區,0613,237,560,797,35,832,1352,61.54%,17.53%,1
臺中市,潭子區,0614,320,841,1161,76,1237,2085,59.33%,15.35%,1
臺中市,潭子區,0615,340,836,1176,66,1242,2047,60.67%,16.61%,1
臺中市,潭子區,0616,275,621,896,26,922,1673,55.11%,16.44%,1
臺中市,潭子區,0617,331,698,1029,84,1113,1874,59.39%,17.66%,1
臺中市,潭子區,0618,183,411,594,37,631,1051,60.04%,17.41%,1
臺中市,潭子區,0619,782,93,875,30,905,1674,54.06%,46.71%,1
臺中市,潭子區,0620,292,726,1018,60,1078,1831,58.87%,15.95%,1
臺中市,潭子區,0621,311,734,1045,57,1102,2003,55.02%,15.53%,1
臺中市,潭子區,0622,243,605,848,33,881,1535,57.39%,15.83%,1
臺中市,潭子區,0623,298,779,1077,89,1166,2286,51.01%,13.04%,1
臺中市,潭子區,0624,245,699,944,58,1002,1861,53.84%,13.16%,1
臺中市,大雅區,0524,315,802,1117,51,1168,2027,57.62%,15.54%,1
臺中市,大雅區,0525,309,686,995,28,1023,1967,52.01%,15.71%,1
臺中市,大雅區,0526,326,685,1011,38,1049,1912,54.86%,17.05%,1
臺中市,大雅區,0527,288,620,908,32,940,1537,61.16%,18.74%,1
臺中市,大雅區,0528,254,610,864,33,897,1439,62.33%,17.65%,1
臺中市,大雅區,0529,249,536,785,52,837,1402,59.7%,17.76%,1
臺中市,大雅區,0530,352,710,1062,44,1106,2013,54.94%,17.49%,1
臺中市,大雅區,0531,333,736,1069,63,1132,1917,59.05%,17.37%,1
臺中市,大雅區,0532,346,727,1073,48,1121,2011,55.74%,17.21%,1
臺中市,大雅區,0533,286,775,1061,48,1109,1887,58.77%,15.16%,1
臺中市,大雅區,0534,293,568,861,46,907,1480,61.28%,19.8%,1
臺中市,大雅區,0535,321,681,1002,40,1042,1816,57.38%,17.68%,1
臺中市,大雅區,0536,300,621,921,62,983,1898,51.79%,15.81%,1
臺中市,大雅區,0537,285,807,1092,60,1152,2008,57.37%,14.19%,1
臺中市,大雅區,0538,336,761,1097,52,1149,1976,58.15%,17%,1
臺中市,大雅區,0539,291,645,936,49,985,1673,58.88%,17.39%,1
臺中市,大雅區,0540,243,601,844,36,880,1409,62.46%,17.25%,1
臺中市,大雅區,0541,242,566,808,15,823,1382,59.55%,17.51%,1
臺中市,大雅區,0542,228,633,861,72,933,1635,57.06%,13.94%,1
臺中市,大雅區,0543,263,618,881,54,935,1565,59.74%,16.81%,1
臺中市,大雅區,0544,247,566,813,34,847,1528,55.43%,16.16%,1
臺中市,大雅區,0545,280,752,1032,37,1069,1963,54.46%,14.26%,1
臺中市,大雅區,0546,320,735,1055,43,1098,2073,52.97%,15.44%,1
臺中市,大雅區,0547,314,718,1032,68,1100,1984,55.44%,15.83%,1
臺中市,大雅區,0548,271,635,906,43,949,1688,56.22%,16.05%,1
臺中市,大雅區,0549,237,546,783,26,809,1387,58.33%,17.09%,1
臺中市,大雅區,0550,279,679,958,80,1038,1701,61.02%,16.4%,1
臺中市,大雅區,0551,62,865,927,47,974,1721,56.6%,3.6%,1
臺中市,大雅區,0552,253,610,863,40,903,1879,48.06%,13.46%,1
臺中市,大雅區,0553,274,681,955,44,999,1568,63.71%,17.47%,1
臺中市,大雅區,0554,315,649,964,69,1033,1761,58.66%,17.89%,1
臺中市,大雅區,0555,289,721,1010,63,1073,1752,61.24%,16.5%,1
臺中市,大雅區,0556,212,512,724,34,758,1264,59.97%,16.77%,1
臺中市,大雅區,0557,207,559,766,43,809,1302,62.14%,15.9%,1
臺中市,大雅區,0558,238,538,776,58,834,1449,57.56%,16.43%,1
臺中市,大雅區,0559,285,645,930,65,995,1621,61.38%,17.58%,1
臺中市,大雅區,0560,231,631,862,60,922,1647,55.98%,14.03%,1
臺中市,大雅區,0561,252,542,794,28,822,1441,57.04%,17.49%,1
臺中市,大雅區,0562,240,557,797,30,827,1460,56.64%,16.44%,1
臺中市,大雅區,0563,296,754,1050,77,1127,1832,61.52%,16.16%,1
臺中市,大雅區,0564,232,579,811,60,871,1371,63.53%,16.92%,1
臺中市,大雅區,0565,202,539,741,11,752,1418,53.03%,14.25%,1
臺中市,大雅區,0566,246,623,869,30,899,1473,61.03%,16.7%,1
臺中市,大雅區,0567,234,494,728,56,784,1335,58.73%,17.53%,1
臺中市,大雅區,0568,211,717,928,61,989,1733,57.07%,12.18%,1
臺中市,大雅區,0569,221,644,865,99,964,1884,51.17%,11.73%,1
臺中市,新社區,1562,165,389,554,28,582,1011,57.57%,16.32%,1
臺中市,新社區,1563,171,490,661,40,701,1195,58.66%,14.31%,1
臺中市,新社區,1564,180,444,624,25,649,1053,61.63%,17.09%,1
臺中市,新社區,1565,97,309,406,28,434,961,45.16%,10.09%,1
臺中市,新社區,1566,119,350,469,17,486,919,52.88%,12.95%,1
臺中市,新社區,1567,195,596,791,54,845,1367,61.81%,14.26%,1
臺中市,新社區,1568,150,373,523,28,551,1010,54.55%,14.85%,1
臺中市,新社區,1569,150,396,546,52,598,1169,51.15%,12.83%,1
臺中市,新社區,1570,142,374,516,47,563,989,56.93%,14.36%,1
臺中市,新社區,1571,137,350,487,15,502,894,56.15%,15.32%,1
臺中市,新社區,1572,114,438,552,20,572,1033,55.37%,11.04%,1
臺中市,新社區,1573,115,325,440,29,469,1058,44.33%,10.87%,1
臺中市,新社區,1574,115,301,416,20,436,845,51.6%,13.61%,1
臺中市,新社區,1575,91,265,356,29,385,576,66.84%,15.8%,1
臺中市,新社區,1576,156,429,585,42,627,1229,51.02%,12.69%,1
臺中市,新社區,1577,137,288,425,17,442,890,49.66%,15.39%,1
臺中市,新社區,1578,108,279,387,26,413,781,52.88%,13.83%,1
臺中市,新社區,1579,165,473,638,44,682,1244,54.82%,13.26%,1
臺中市,新社區,1580,17,54,71,9,80,213,37.56%,7.98%,1
臺中市,新社區,1581,78,212,290,28,318,676,47.04%,11.54%,1
臺中市,新社區,1582,42,218,260,24,284,585,48.55%,7.18%,1
臺中市,新社區,1583,112,384,496,40,536,938,57.14%,11.94%,1
臺中市,新社區,1584,23,82,105,5,110,224,49.11%,10.27%,1
臺中市,石岡區,1552,201,493,694,40,734,1244,59%,16.16%,1
臺中市,石岡區,1553,157,656,813,62,875,1539,56.86%,10.2%,1
臺中市,石岡區,1554,184,485,669,46,715,1202,59.48%,15.31%,1
臺中市,石岡區,1555,192,440,632,65,697,1272,54.8%,15.09%,1
臺中市,石岡區,1556,88,266,354,35,389,652,59.66%,13.5%,1
臺中市,石岡區,1557,246,656,902,55,957,1457,65.68%,16.88%,1
臺中市,石岡區,1558,276,688,964,75,1039,1836,56.59%,15.03%,1
臺中市,石岡區,1559,134,399,533,48,581,1001,58.04%,13.39%,1
臺中市,石岡區,1560,209,627,836,63,899,1448,62.09%,14.43%,1
臺中市,石岡區,1561,203,519,722,42,764,1229,62.16%,16.52%,1
臺中市,外埔區,0071,144,407,551,51,602,1059,56.85%,13.6%,1
臺中市,外埔區,0072,145,439,584,24,608,1013,60.02%,14.31%,1
臺中市,外埔區,0073,179,501,680,39,719,1150,62.52%,15.57%,1
臺中市,外埔區,0074,288,843,1131,53,1184,1855,63.83%,15.53%,1
臺中市,外埔區,0075,192,568,760,40,800,1327,60.29%,14.47%,1
臺中市,外埔區,0076,214,623,837,49,886,1453,60.98%,14.73%,1
臺中市,外埔區,0077,216,636,852,72,924,1653,55.9%,13.07%,1
臺中市,外埔區,0078,214,615,829,46,875,1615,54.18%,13.25%,1
臺中市,外埔區,0079,214,562,776,34,810,1470,55.1%,14.56%,1
臺中市,外埔區,0080,246,636,882,54,936,1559,60.04%,15.78%,1
臺中市,外埔區,0081,273,724,997,74,1071,1902,56.31%,14.35%,1
臺中市,外埔區,0082,193,493,686,45,731,1138,64.24%,16.96%,1
臺中市,外埔區,0083,153,466,619,62,681,1065,63.94%,14.37%,1
臺中市,外埔區,0084,204,536,740,40,780,1243,62.75%,16.41%,1
臺中市,外埔區,0085,156,324,480,48,528,962,54.89%,16.22%,1
臺中市,外埔區,0086,179,425,604,52,656,1169,56.12%,15.31%,1
臺中市,外埔區,0087,191,553,744,47,791,1216,65.05%,15.71%,1
臺中市,外埔區,0088,182,554,736,47,783,1391,56.29%,13.08%,1
臺中市,外埔區,0089,209,622,831,83,914,1616,56.56%,12.93%,1
臺中市,外埔區,0090,173,379,552,39,591,1203,49.13%,14.38%,1
臺中市,大安區,0055,132,371,503,67,570,1068,53.37%,12.36%,1
臺中市,大安區,0056,157,397,554,60,614,1050,58.48%,14.95%,1
臺中市,大安區,0057,213,486,699,59,758,1246,60.83%,17.09%,1
臺中市,大安區,0058,197,537,734,50,784,1397,56.12%,14.1%,1
臺中市,大安區,0059,188,507,695,63,758,1227,61.78%,15.32%,1
臺中市,大安區,0060,160,475,635,58,693,1170,59.23%,13.68%,1
臺中市,大安區,0061,159,389,548,47,595,914,65.1%,17.4%,1
臺中市,大安區,0062,85,230,315,30,345,667,51.72%,12.74%,1
臺中市,大安區,0063,127,315,442,44,486,890,54.61%,14.27%,1
臺中市,大安區,0064,178,485,663,71,734,1289,56.94%,13.81%,1
臺中市,大安區,0065,66,162,228,17,245,455,53.85%,14.51%,1
臺中市,大安區,0066,141,407,548,45,593,1028,57.68%,13.72%,1
臺中市,大安區,0067,230,559,789,77,866,1446,59.89%,15.91%,1
臺中市,大安區,0068,113,302,415,30,445,688,64.68%,16.42%,1
臺中市,大安區,0069,156,437,593,55,648,1062,61.02%,14.69%,1
臺中市,大安區,0070,176,387,563,37,600,923,65.01%,19.07%,1
臺中市,烏日區,0317,266,620,886,48,934,1480,63.11%,17.97%,1
臺中市,烏日區,0318,352,717,1069,67,1136,1841,61.71%,19.12%,1
臺中市,烏日區,0319,294,649,943,62,1005,1751,57.4%,16.79%,1
臺中市,烏日區,0320,273,623,896,64,960,1547,62.06%,17.65%,1
臺中市,烏日區,0321,332,691,1023,46,1069,1836,58.22%,18.08%,1
臺中市,烏日區,0322,281,456,737,93,830,1239,66.99%,22.68%,1
臺中市,烏日區,0323,227,459,686,60,746,1295,57.61%,17.53%,1
臺中市,烏日區,0324,230,445,675,42,717,1263,56.77%,18.21%,1
臺中市,烏日區,0325,315,557,872,33,905,1622,55.8%,19.42%,1
臺中市,烏日區,0326,260,692,952,84,1036,1822,56.86%,14.27%,1
臺中市,烏日區,0327,320,719,1039,52,1091,1966,55.49%,16.28%,1
臺中市,烏日區,0328,271,623,894,58,952,1615,58.95%,16.78%,1
臺中市,烏日區,0329,244,499,743,30,773,1232,62.74%,19.81%,1
臺中市,烏日區,0330,200,526,726,28,754,1347,55.98%,14.85%,1
臺中市,烏日區,0331,195,399,594,32,626,1165,53.73%,16.74%,1
臺中市,烏日區,0332,298,666,964,41,1005,1664,60.4%,17.91%,1
臺中市,烏日區,0333,204,531,735,44,779,1230,63.33%,16.59%,1
臺中市,烏日區,0334,268,646,914,78,992,1574,63.02%,17.03%,1
臺中市,烏日區,0335,278,612,890,35,925,1452,63.71%,19.15%,1
臺中市,烏日區,0336,250,697,947,60,1007,1879,53.59%,13.3%,1
臺中市,烏日區,0337,294,597,891,37,928,1601,57.96%,18.36%,1
臺中市,烏日區,0338,288,616,904,43,947,1546,61.25%,18.63%,1
臺中市,烏日區,0339,292,617,909,39,948,1866,50.8%,15.65%,1
臺中市,烏日區,0340,319,780,1099,68,1167,1938,60.22%,16.46%,1
臺中市,烏日區,0341,310,650,960,63,1023,1759,58.16%,17.62%,1
臺中市,烏日區,0342,347,748,1095,59,1154,2061,55.99%,16.84%,1
臺中市,烏日區,0343,282,683,965,39,1004,1691,59.37%,16.68%,1
臺中市,烏日區,0344,193,449,642,37,679,1039,65.35%,18.58%,1
臺中市,烏日區,0345,197,515,712,38,750,1221,61.43%,16.13%,1
臺中市,烏日區,0346,288,648,936,66,1002,1650,60.73%,17.45%,1
臺中市,烏日區,0347,170,374,544,36,580,937,61.9%,18.14%,1
臺中市,烏日區,0348,219,465,684,44,728,1220,59.67%,17.95%,1
臺中市,烏日區,0349,313,744,1057,95,1152,2139,53.86%,14.63%,1
臺中市,烏日區,0350,230,602,832,56,888,1371,64.77%,16.78%,1
臺中市,烏日區,0351,179,519,698,53,751,1277,58.81%,14.02%,1
臺中市,烏日區,0352,272,627,899,53,952,1708,55.74%,15.93%,1
臺中市,烏日區,0353,290,772,1062,84,1146,2048,55.96%,14.16%,1
臺中市,烏日區,0354,250,589,839,66,905,1632,55.45%,15.32%,1
臺中市,烏日區,0355,223,519,742,63,805,1327,60.66%,16.8%,1
臺中市,烏日區,0356,115,330,445,55,500,854,58.55%,13.47%,1
臺中市,大肚區,0284,214,545,759,47,806,1415,56.96%,15.12%,1
臺中市,大肚區,0285,195,498,693,54,747,1392,53.66%,14.01%,1
臺中市,大肚區,0286,235,631,866,56,922,1520,60.66%,15.46%,1
臺中市,大肚區,0287,365,151,516,67,583,862,67.63%,42.34%,1
臺中市,大肚區,0288,205,536,741,41,782,1256,62.26%,16.32%,1
臺中市,大肚區,0289,196,509,705,44,749,1292,57.97%,15.17%,1
臺中市,大肚區,0290,154,423,577,40,617,1010,61.09%,15.25%,1
臺中市,大肚區,0291,259,581,840,78,918,1485,61.82%,17.44%,1
臺中市,大肚區,0292,198,504,702,67,769,1190,64.62%,16.64%,1
臺中市,大肚區,0293,206,472,678,64,742,1250,59.36%,16.48%,1
臺中市,大肚區,0294,220,518,738,42,780,1310,59.54%,16.79%,1
臺中市,大肚區,0295,212,483,695,39,734,1294,56.72%,16.38%,1
臺中市,大肚區,0296,273,756,1029,62,1091,1734,62.92%,15.74%,1
臺中市,大肚區,0297,186,525,711,53,764,1316,58.05%,14.13%,1
臺中市,大肚區,0298,149,329,478,32,510,854,59.72%,17.45%,1
臺中市,大肚區,0299,241,544,785,35,820,1273,64.41%,18.93%,1
臺中市,大肚區,0300,152,370,522,24,546,851,64.16%,17.86%,1
臺中市,大肚區,0301,241,645,886,36,922,1629,56.6%,14.79%,1
臺中市,大肚區,0302,242,636,878,77,955,1709,55.88%,14.16%,1
臺中市,大肚區,0303,148,350,498,32,530,953,55.61%,15.53%,1
臺中市,大肚區,0304,206,555,761,53,814,1336,60.93%,15.42%,1
臺中市,大肚區,0305,312,764,1076,70,1146,2113,54.24%,14.77%,1
臺中市,大肚區,0306,271,666,937,81,1018,1730,58.84%,15.66%,1
臺中市,大肚區,0307,289,641,930,29,959,1692,56.68%,17.08%,1
臺中市,大肚區,0308,277,693,970,35,1005,1747,57.53%,15.86%,1
臺中市,大肚區,0309,268,626,894,66,960,1672,57.42%,16.03%,1
臺中市,大肚區,0310,251,613,864,43,907,1675,54.15%,14.99%,1
臺中市,大肚區,0311,236,663,899,63,962,1673,57.5%,14.11%,1
臺中市,大肚區,0312,276,641,917,50,967,1636,59.11%,16.87%,1
臺中市,大肚區,0313,265,629,894,59,953,1753,54.36%,15.12%,1
臺中市,大肚區,0314,202,481,683,30,713,1343,53.09%,15.04%,1
臺中市,大肚區,0315,304,669,973,50,1023,1822,56.15%,16.68%,1
臺中市,大肚區,0316,263,675,938,92,1030,1670,61.68%,15.75%,1
臺中市,龍井區,0239,296,708,1004,53,1057,1758,60.13%,16.84%,1
臺中市,龍井區,0240,188,529,717,15,732,1275,57.41%,14.75%,1
臺中市,龍井區,0241,178,472,650,32,682,1379,49.46%,12.91%,1
臺中市,龍井區,0242,183,521,704,43,747,1403,53.24%,13.04%,1
臺中市,龍井區,0243,158,371,529,41,570,974,58.52%,16.22%,1
臺中市,龍井區,0244,132,391,523,42,565,901,62.71%,14.65%,1
臺中市,龍井區,0245,299,624,923,68,991,1779,55.71%,16.81%,1
臺中市,龍井區,0246,301,597,898,62,960,1609,59.66%,18.71%,1
臺中市,龍井區,0247,388,135,523,24,547,1038,52.7%,37.38%,1
臺中市,龍井區,0248,222,520,742,59,801,1328,60.32%,16.72%,1
臺中市,龍井區,0249,146,393,539,37,576,921,62.54%,15.85%,1
臺中市,龍井區,0250,231,545,776,70,846,1609,52.58%,14.36%,1
臺中市,龍井區,0251,165,424,589,33,622,1227,50.69%,13.45%,1
臺中市,龍井區,0252,166,502,668,56,724,1278,56.65%,12.99%,1
臺中市,龍井區,0253,124,292,416,13,429,914,46.94%,13.57%,1
臺中市,龍井區,0254,252,551,803,31,834,1678,49.7%,15.02%,1
臺中市,龍井區,0255,189,422,611,32,643,1233,52.15%,15.33%,1
臺中市,龍井區,0256,243,571,814,47,861,1520,56.64%,15.99%,1
臺中市,龍井區,0257,261,687,948,43,991,1905,52.02%,13.7%,1
臺中市,龍井區,0258,260,599,859,54,913,1520,60.07%,17.11%,1
臺中市,龍井區,0259,206,492,698,56,754,1385,54.44%,14.87%,1
臺中市,龍井區,0260,210,431,641,37,678,1212,55.94%,17.33%,1
臺中市,龍井區,0261,227,572,799,24,823,1432,57.47%,15.85%,1
臺中市,龍井區,0262,247,587,834,39,873,1663,52.5%,14.85%,1
臺中市,龍井區,0263,540,248,788,33,821,1422,57.74%,37.97%,1
臺中市,龍井區,0264,237,519,756,59,815,1616,50.43%,14.67%,1
臺中市,龍井區,0265,210,585,795,45,840,1422,59.07%,14.77%,1
臺中市,龍井區,0266,214,456,670,23,693,1165,59.48%,18.37%,1
臺中市,龍井區,0267,302,585,887,13,900,1624,55.42%,18.6%,1
臺中市,龍井區,0268,233,622,855,52,907,1613,56.23%,14.45%,1
臺中市,龍井區,0269,152,395,547,45,592,943,62.78%,16.12%,1
臺中市,龍井區,0270,225,586,811,56,867,1595,54.36%,14.11%,1
臺中市,龍井區,0271,253,550,803,86,889,1508,58.95%,16.78%,1
臺中市,龍井區,0272,227,541,768,35,803,1479,54.29%,15.35%,1
臺中市,龍井區,0273,243,583,826,46,872,1509,57.79%,16.1%,1
臺中市,龍井區,0274,249,656,905,63,968,1582,61.19%,15.74%,1
臺中市,龍井區,0275,308,612,920,55,975,1725,56.52%,17.86%,1
臺中市,龍井區,0276,263,642,905,28,933,1616,57.74%,16.27%,1
臺中市,龍井區,0277,301,633,934,45,979,1657,59.08%,18.17%,1
臺中市,龍井區,0278,381,606,987,46,1033,1774,58.23%,21.48%,1
臺中市,龍井區,0279,381,606,987,49,1036,1701,60.91%,22.4%,1
臺中市,龍井區,0280,203,427,630,33,663,1121,59.14%,18.11%,1
臺中市,龍井區,0281,187,392,579,44,623,987,63.12%,18.95%,1
臺中市,龍井區,0282,219,450,669,43,712,1206,59.04%,18.16%,1
臺中市,龍井區,0283,245,564,809,36,845,1378,61.32%,17.78%,1
臺中市,霧峰區,1470,213,499,712,34,746,1205,61.91%,17.68%,1
臺中市,霧峰區,1471,257,624,881,45,926,1620,57.16%,15.86%,1
臺中市,霧峰區,1472,288,622,910,56,966,1559,61.96%,18.47%,1
臺中市,霧峰區,1473,275,617,892,65,957,1660,57.65%,16.57%,1
臺中市,霧峰區,1474,282,658,940,48,988,1602,61.67%,17.6%,1
臺中市,霧峰區,1475,194,494,688,45,733,1325,55.32%,14.64%,1
臺中市,霧峰區,1476,223,613,836,59,895,1515,59.08%,14.72%,1
臺中市,霧峰區,1477,302,507,809,66,875,1561,56.05%,19.35%,1
臺中市,霧峰區,1478,250,620,870,44,914,1691,54.05%,14.78%,1
臺中市,霧峰區,1479,225,587,812,51,863,1486,58.08%,15.14%,1
臺中市,霧峰區,1480,155,415,570,43,613,975,62.87%,15.9%,1
臺中市,霧峰區,1481,207,590,797,52,849,1358,62.52%,15.24%,1
臺中市,霧峰區,1482,203,533,736,26,762,1141,66.78%,17.79%,1
臺中市,霧峰區,1483,143,380,523,43,566,855,66.2%,16.73%,1
臺中市,霧峰區,1484,206,467,673,52,725,1202,60.32%,17.14%,1
臺中市,霧峰區,1485,168,402,570,43,613,1078,56.86%,15.58%,1
臺中市,霧峰區,1486,262,575,837,59,896,1456,61.54%,17.99%,1
臺中市,霧峰區,1487,297,609,906,52,958,1573,60.9%,18.88%,1
臺中市,霧峰區,1488,238,674,912,41,953,1591,59.9%,14.96%,1
臺中市,霧峰區,1489,194,539,733,49,782,1214,64.42%,15.98%,1
臺中市,霧峰區,1490,188,494,682,49,731,1267,57.7%,14.84%,1
臺中市,霧峰區,1491,202,508,710,50,760,1277,59.51%,15.82%,1
臺中市,霧峰區,1492,227,507,734,53,787,1366,57.61%,16.62%,1
臺中市,霧峰區,1493,193,450,643,47,690,994,69.42%,19.42%,1
臺中市,霧峰區,1494,156,362,518,33,551,863,63.85%,18.08%,1
臺中市,霧峰區,1495,206,488,694,41,735,1274,57.69%,16.17%,1
臺中市,霧峰區,1496,175,441,616,70,686,1162,59.04%,15.06%,1
臺中市,霧峰區,1497,182,530,712,67,779,1252,62.22%,14.54%,1
臺中市,霧峰區,1498,219,517,736,52,788,1322,59.61%,16.57%,1
臺中市,霧峰區,1499,191,470,661,51,712,1116,63.8%,17.11%,1
臺中市,霧峰區,1500,201,464,665,72,737,1156,63.75%,17.39%,1
臺中市,霧峰區,1501,175,501,676,53,729,1147,63.56%,15.26%,1
臺中市,霧峰區,1502,129,453,582,48,630,928,67.89%,13.9%,1
臺中市,霧峰區,1503,189,495,684,47,731,1296,56.4%,14.58%,1
臺中市,霧峰區,1504,198,466,664,62,726,1314,55.25%,15.07%,1
臺中市,霧峰區,1505,200,550,750,61,811,1328,61.07%,15.06%,1
臺中市,霧峰區,1506,182,350,532,57,589,989,59.56%,18.4%,1
臺中市,霧峰區,1507,175,446,621,62,683,1088,62.78%,16.08%,1
臺中市,霧峰區,1508,203,606,809,51,860,1363,63.1%,14.89%,1
臺中市,霧峰區,1509,246,656,902,64,966,1573,61.41%,15.64%,1
臺中市,霧峰區,1510,149,438,587,61,648,1117,58.01%,13.34%,1
臺中市,霧峰區,1511,211,587,798,73,871,1342,64.9%,15.72%,1
臺中市,霧峰區,1512,190,428,618,64,682,1024,66.6%,18.55%,1
臺中市,太平區,1271,282,648,930,69,999,1821,54.86%,15.49%,1
臺中市,太平區,1272,246,587,833,34,867,1680,51.61%,14.64%,1
臺中市,太平區,1273,310,740,1050,81,1131,1947,58.09%,15.92%,1
臺中市,太平區,1274,330,739,1069,72,1141,1910,59.74%,17.28%,1
臺中市,太平區,1275,307,670,977,45,1022,1894,53.96%,16.21%,1
臺中市,太平區,1276,317,732,1049,50,1099,1953,56.27%,16.23%,1
臺中市,太平區,1277,306,680,986,72,1058,1846,57.31%,16.58%,1
臺中市,太平區,1278,241,600,841,49,890,1493,59.61%,16.14%,1
臺中市,太平區,1279,221,620,841,54,895,1605,55.76%,13.77%,1
臺中市,太平區,1280,253,665,918,44,962,1619,59.42%,15.63%,1
臺中市,太平區,1281,300,756,1056,49,1105,2011,54.95%,14.92%,1
臺中市,太平區,1282,315,739,1054,35,1089,2056,52.97%,15.32%,1
臺中市,太平區,1283,309,664,973,48,1021,1876,54.42%,16.47%,1
臺中市,太平區,1284,270,645,915,75,990,1815,54.55%,14.88%,1
臺中市,太平區,1285,192,486,678,39,717,1281,55.97%,14.99%,1
臺中市,太平區,1286,169,418,587,63,650,1004,64.74%,16.83%,1
臺中市,太平區,1287,327,732,1059,71,1130,1886,59.92%,17.34%,1
臺中市,太平區,1288,214,582,796,66,862,1431,60.24%,14.95%,1
臺中市,太平區,1289,308,667,975,71,1046,1930,54.2%,15.96%,1
臺中市,太平區,1290,342,714,1056,63,1119,2164,51.71%,15.8%,1
臺中市,太平區,1291,288,764,1052,61,1113,2048,54.35%,14.06%,1
臺中市,太平區,1292,284,742,1026,62,1088,2035,53.46%,13.96%,1
臺中市,太平區,1293,280,572,852,79,931,1685,55.25%,16.62%,1
臺中市,太平區,1294,328,681,1009,72,1081,2185,49.47%,15.01%,1
臺中市,太平區,1295,182,432,614,24,638,1176,54.25%,15.48%,1
臺中市,太平區,1296,264,575,839,29,868,1597,54.35%,16.53%,1
臺中市,太平區,1297,485,206,691,62,753,1378,54.64%,35.2%,1
臺中市,太平區,1298,233,610,843,26,869,1546,56.21%,15.07%,1
臺中市,太平區,1299,173,721,894,64,958,1890,50.69%,9.15%,1
臺中市,太平區,1300,151,404,555,42,597,1053,56.7%,14.34%,1
臺中市,太平區,1301,247,638,885,75,960,1582,60.68%,15.61%,1
臺中市,太平區,1302,266,707,973,44,1017,1699,59.86%,15.66%,1
臺中市,太平區,1303,242,515,757,58,815,1493,54.59%,16.21%,1
臺中市,太平區,1304,156,388,544,35,579,1063,54.47%,14.68%,1
臺中市,太平區,1305,182,457,639,48,687,1117,61.5%,16.29%,1
臺中市,太平區,1306,170,444,614,39,653,1084,60.24%,15.68%,1
臺中市,太平區,1307,286,629,915,40,955,1776,53.77%,16.1%,1
臺中市,太平區,1308,275,612,887,48,935,1729,54.08%,15.91%,1
臺中市,太平區,1309,245,538,783,55,838,1658,50.54%,14.78%,1
臺中市,太平區,1310,264,746,1010,55,1065,2010,52.99%,13.13%,1
臺中市,太平區,1311,254,636,890,44,934,1752,53.31%,14.5%,1
臺中市,太平區,1312,272,682,954,49,1003,1654,60.64%,16.44%,1
臺中市,太平區,1313,231,528,759,31,790,1951,40.49%,11.84%,1
臺中市,太平區,1314,384,890,1274,84,1358,2170,62.58%,17.7%,1
臺中市,太平區,1315,373,903,1276,65,1341,2231,60.11%,16.72%,1
臺中市,太平區,1316,282,633,915,40,955,1623,58.84%,17.38%,1
臺中市,太平區,1317,195,529,724,53,777,1548,50.19%,12.6%,1
臺中市,太平區,1318,213,527,740,60,800,1442,55.48%,14.77%,1
臺中市,太平區,1319,206,511,717,36,753,1501,50.17%,13.72%,1
臺中市,太平區,1320,117,853,970,28,998,2025,49.28%,5.78%,1
臺中市,太平區,1321,330,638,968,44,1012,1885,53.69%,17.51%,1
臺中市,太平區,1322,327,658,985,67,1052,2155,48.82%,15.17%,1
臺中市,太平區,1323,269,582,851,58,909,1775,51.21%,15.15%,1
臺中市,太平區,1324,266,615,881,57,938,2021,46.41%,13.16%,1
臺中市,太平區,1325,323,796,1119,73,1192,2075,57.45%,15.57%,1
臺中市,太平區,1326,289,572,861,43,904,1723,52.47%,16.77%,1
臺中市,太平區,1327,349,751,1100,44,1144,2049,55.83%,17.03%,1
臺中市,太平區,1328,232,518,750,28,778,1415,54.98%,16.4%,1
臺中市,太平區,1329,304,616,920,87,1007,1778,56.64%,17.1%,1
臺中市,太平區,1330,265,580,845,46,891,1706,52.23%,15.53%,1
臺中市,太平區,1331,364,735,1099,37,1136,2090,54.35%,17.42%,1
臺中市,太平區,1332,306,683,989,52,1041,2093,49.74%,14.62%,1
臺中市,太平區,1333,222,556,778,33,811,1688,48.05%,13.15%,1
臺中市,太平區,1334,245,476,721,30,751,1488,50.47%,16.47%,1
臺中市,太平區,1335,282,652,934,44,978,1667,58.67%,16.92%,1
臺中市,太平區,1336,295,677,972,57,1029,1793,57.39%,16.45%,1
臺中市,太平區,1337,343,693,1036,33,1069,1903,56.17%,18.02%,1
臺中市,太平區,1338,286,683,969,53,1022,1834,55.73%,15.59%,1
臺中市,太平區,1339,218,579,797,38,835,1526,54.72%,14.29%,1
臺中市,太平區,1340,321,592,913,17,930,1483,62.71%,21.65%,1
臺中市,太平區,1341,335,600,935,25,960,1694,56.67%,19.78%,1
臺中市,太平區,1342,310,629,939,28,967,1952,49.54%,15.88%,1
臺中市,太平區,1343,350,699,1049,45,1094,1995,54.84%,17.54%,1
臺中市,太平區,1344,249,490,739,19,758,1311,57.82%,18.99%,1
臺中市,太平區,1345,390,591,981,38,1019,1537,66.3%,25.37%,1
臺中市,太平區,1346,301,625,926,41,967,1974,48.99%,15.25%,1
臺中市,太平區,1347,328,672,1000,39,1039,1828,56.84%,17.94%,1
臺中市,太平區,1348,351,688,1039,44,1083,2191,49.43%,16.02%,1
臺中市,太平區,1349,214,680,894,76,970,1825,53.15%,11.73%,1
臺中市,太平區,1350,207,566,773,17,790,1559,50.67%,13.28%,1
臺中市,太平區,1351,177,460,637,52,689,1225,56.24%,14.45%,1
臺中市,太平區,1352,227,669,896,54,950,1678,56.62%,13.53%,1
臺中市,太平區,1353,241,489,730,73,803,1501,53.5%,16.06%,1
臺中市,太平區,1354,271,593,864,60,924,1450,63.72%,18.69%,1
臺中市,太平區,1355,336,716,1052,69,1121,2126,52.73%,15.8%,1
臺中市,太平區,1356,87,322,409,38,447,699,63.95%,12.45%,1
臺中市,太平區,1357,233,472,705,36,741,1428,51.89%,16.32%,1
臺中市,太平區,1358,284,716,1000,71,1071,1666,64.29%,17.05%,1
臺中市,太平區,1359,204,466,670,44,714,1241,57.53%,16.44%,1
臺中市,太平區,1360,212,509,721,43,764,1266,60.35%,16.75%,1
臺中市,太平區,1361,167,458,625,44,669,1166,57.38%,14.32%,1
臺中市,太平區,1362,271,695,966,79,1045,1790,58.38%,15.14%,1
臺中市,太平區,1363,207,551,758,47,805,1754,45.9%,11.8%,1
臺中市,大里區,1364,238,554,792,48,840,1614,52.04%,14.75%,1
臺中市,大里區,1365,225,560,785,27,812,1599,50.78%,14.07%,1
臺中市,大里區,1366,293,529,822,52,874,1715,50.96%,17.08%,1
臺中市,大里區,1367,193,514,707,32,739,1264,58.47%,15.27%,1
臺中市,大里區,1368,245,474,719,39,758,1416,53.53%,17.3%,1
臺中市,大里區,1369,180,433,613,31,644,1188,54.21%,15.15%,1
臺中市,大里區,1370,218,450,668,50,718,1359,52.83%,16.04%,1
臺中市,大里區,1371,217,574,791,52,843,1457,57.86%,14.89%,1
臺中市,大里區,1372,220,568,788,45,833,1403,59.37%,15.68%,1
臺中市,大里區,1373,263,641,904,50,954,1697,56.22%,15.5%,1
臺中市,大里區,1374,319,694,1013,81,1094,1811,60.41%,17.61%,1
臺中市,大里區,1375,279,649,928,57,985,1830,53.83%,15.25%,1
臺中市,大里區,1376,261,634,895,70,965,2228,43.31%,11.71%,1
臺中市,大里區,1377,318,760,1078,60,1138,1997,56.99%,15.92%,1
臺中市,大里區,1378,400,866,1266,34,1300,2033,63.94%,19.68%,1
臺中市,大里區,1379,350,691,1041,37,1078,1835,58.75%,19.07%,1
臺中市,大里區,1380,217,497,714,19,733,1268,57.81%,17.11%,1
臺中市,大里區,1381,273,643,916,42,958,1645,58.24%,16.6%,1
臺中市,大里區,1382,288,615,903,28,931,1561,59.64%,18.45%,1
臺中市,大里區,1383,242,584,826,23,849,1301,65.26%,18.6%,1
臺中市,大里區,1384,274,547,821,66,887,1621,54.72%,16.9%,1
臺中市,大里區,1385,281,633,914,58,972,1797,54.09%,15.64%,1
臺中市,大里區,1386,199,454,653,26,679,1230,55.2%,16.18%,1
臺中市,大里區,1387,214,558,772,52,824,1488,55.38%,14.38%,1
臺中市,大里區,1388,268,467,735,60,795,1459,54.49%,18.37%,1
臺中市,大里區,1389,281,621,902,42,944,1647,57.32%,17.06%,1
臺中市,大里區,1390,193,438,631,70,701,1100,63.73%,17.55%,1
臺中市,大里區,1391,234,534,768,45,813,1410,57.66%,16.6%,1
臺中市,大里區,1392,260,645,905,55,960,1807,53.13%,14.39%,1
臺中市,大里區,1393,239,560,799,48,847,1331,63.64%,17.96%,1
臺中市,大里區,1394,316,627,943,27,970,1801,53.86%,17.55%,1
臺中市,大里區,1395,298,639,937,35,972,1909,50.92%,15.61%,1
臺中市,大里區,1396,221,588,809,56,865,1699,50.91%,13.01%,1
臺中市,大里區,1397,274,620,894,47,941,1627,57.84%,16.84%,1
臺中市,大里區,1398,353,645,998,45,1043,1912,54.55%,18.46%,1
臺中市,大里區,1399,269,614,883,60,943,1753,53.79%,15.35%,1
臺中市,大里區,1400,250,588,838,47,885,1602,55.24%,15.61%,1
臺中市,大里區,1401,202,416,618,55,673,1144,58.83%,17.66%,1
臺中市,大里區,1402,271,641,912,64,976,1655,58.97%,16.37%,1
臺中市,大里區,1403,247,527,774,40,814,1438,56.61%,17.18%,1
臺中市,大里區,1404,182,369,551,47,598,1000,59.8%,18.2%,1
臺中市,大里區,1405,273,637,910,53,963,1711,56.28%,15.96%,1
臺中市,大里區,1406,256,655,911,16,927,1698,54.59%,15.08%,1
臺中市,大里區,1407,293,702,995,82,1077,1914,56.27%,15.31%,1
臺中市,大里區,1408,261,558,819,36,855,1465,58.36%,17.82%,1
臺中市,大里區,1409,245,590,835,66,901,1581,56.99%,15.5%,1
臺中市,大里區,1410,233,621,854,43,897,1509,59.44%,15.44%,1
臺中市,大里區,1411,238,589,827,27,854,1570,54.39%,15.16%,1
臺中市,大里區,1412,261,537,798,33,831,1425,58.32%,18.32%,1
臺中市,大里區,1413,250,520,770,51,821,1384,59.32%,18.06%,1
臺中市,大里區,1414,156,401,557,37,594,1204,49.34%,12.96%,1
臺中市,大里區,1415,248,617,865,26,891,1761,50.6%,14.08%,1
臺中市,大里區,1416,209,476,685,34,719,1473,48.81%,14.19%,1
臺中市,大里區,1417,346,548,894,55,949,1675,56.66%,20.66%,1
臺中市,大里區,1418,259,675,934,58,992,1755,56.52%,14.76%,1
臺中市,大里區,1419,267,616,883,74,957,1593,60.08%,16.76%,1
臺中市,大里區,1420,275,663,938,61,999,1799,55.53%,15.29%,1
臺中市,大里區,1421,257,609,866,55,921,1606,57.35%,16%,1
臺中市,大里區,1422,305,684,989,40,1029,1875,54.88%,16.27%,1
臺中市,大里區,1423,282,626,908,50,958,1670,57.37%,16.89%,1
臺中市,大里區,1424,338,655,993,40,1033,1898,54.43%,17.81%,1
臺中市,大里區,1425,263,595,858,37,895,1679,53.31%,15.66%,1
臺中市,大里區,1426,207,506,713,45,758,1373,55.21%,15.08%,1
臺中市,大里區,1427,222,485,707,45,752,1299,57.89%,17.09%,1
臺中市,大里區,1428,260,522,782,34,816,1430,57.06%,18.18%,1
臺中市,大里區,1429,335,774,1109,36,1145,1805,63.43%,18.56%,1
臺中市,大里區,1430,401,747,1148,25,1173,1806,64.95%,22.2%,1
臺中市,大里區,1431,355,794,1149,48,1197,1826,65.55%,19.44%,1
臺中市,大里區,1432,321,816,1137,38,1175,1805,65.1%,17.78%,1
臺中市,大里區,1433,372,740,1112,37,1149,1907,60.25%,19.51%,1
臺中市,大里區,1434,187,477,664,25,689,1103,62.47%,16.95%,1
臺中市,大里區,1435,218,526,744,49,793,1419,55.88%,15.36%,1
臺中市,大里區,1436,177,590,767,52,819,1434,57.11%,12.34%,1
臺中市,大里區,1437,268,651,919,33,952,1875,50.77%,14.29%,1
臺中市,大里區,1438,319,658,977,55,1032,1862,55.42%,17.13%,1
臺中市,大里區,1439,317,646,963,35,998,1850,53.95%,17.14%,1
臺中市,大里區,1440,269,602,871,61,932,1622,57.46%,16.58%,1
臺中市,大里區,1441,301,669,970,45,1015,1638,61.97%,18.38%,1
臺中市,大里區,1442,294,671,965,51,1016,1633,62.22%,18%,1
臺中市,大里區,1443,302,618,920,39,959,1662,57.7%,18.17%,1
臺中市,大里區,1444,390,705,1095,31,1126,1917,58.74%,20.34%,1
臺中市,大里區,1445,244,605,849,58,907,1701,53.32%,14.34%,1
臺中市,大里區,1446,237,522,759,63,822,1549,53.07%,15.3%,1
臺中市,大里區,1447,258,636,894,50,944,1567,60.24%,16.46%,1
臺中市,大里區,1448,277,616,893,40,933,1614,57.81%,17.16%,1
臺中市,大里區,1449,308,662,970,72,1042,1811,57.54%,17.01%,1
臺中市,大里區,1450,484,237,721,38,759,1336,56.81%,36.23%,1
臺中市,大里區,1451,261,654,915,48,963,1759,54.75%,14.84%,1
臺中市,大里區,1452,266,615,881,61,942,1783,52.83%,14.92%,1
臺中市,大里區,1453,239,600,839,49,888,1736,51.15%,13.77%,1
臺中市,大里區,1454,293,729,1022,42,1064,1874,56.78%,15.64%,1
臺中市,大里區,1455,314,691,1005,66,1071,1889,56.7%,16.62%,1
臺中市,大里區,1456,269,743,1012,59,1071,1947,55.01%,13.82%,1
臺中市,大里區,1457,302,789,1091,41,1132,1938,58.41%,15.58%,1
臺中市,大里區,1458,291,676,967,55,1022,1836,55.66%,15.85%,1
臺中市,大里區,1459,303,728,1031,57,1088,1913,56.87%,15.84%,1
臺中市,大里區,1460,260,670,930,90,1020,1913,53.32%,13.59%,1
臺中市,大里區,1461,235,721,956,51,1007,1937,51.99%,12.13%,1
臺中市,大里區,1462,226,546,772,50,822,1508,54.51%,14.99%,1
臺中市,大里區,1463,220,555,775,29,804,1340,60%,16.42%,1
臺中市,大里區,1464,256,665,921,47,968,1656,58.45%,15.46%,1
臺中市,大里區,1465,192,494,686,36,722,1290,55.97%,14.88%,1
臺中市,大里區,1466,260,620,880,39,919,1655,55.53%,15.71%,1
臺中市,大里區,1467,220,386,606,28,634,1260,50.32%,17.46%,1
臺中市,大里區,1468,227,485,712,32,744,1247,59.66%,18.2%,1
臺中市,大里區,1469,411,400,811,56,867,1548,56.01%,26.55%,1
臺中市,和平區,1585,163,417,580,32,612,956,64.02%,17.05%,1
臺中市,和平區,1586,116,477,593,39,632,963,65.63%,12.05%,1
臺中市,和平區,1587,65,187,252,19,271,456,59.43%,14.25%,1
臺中市,和平區,1588,115,495,610,50,660,1011,65.28%,11.37%,1
臺中市,和平區,1589,76,295,371,14,385,636,60.53%,11.95%,1
臺中市,和平區,1590,25,152,177,6,183,270,67.78%,9.26%,1
臺中市,和平區,1591,47,295,342,15,357,460,77.61%,10.22%,1
臺中市,和平區,1592,46,179,225,18,243,321,75.7%,14.33%,1
臺中市,和平區,1593,128,367,495,21,516,783,65.9%,16.35%,1
臺中市,和平區,1594,47,170,217,14,231,336,68.75%,13.99%,1
臺中市,和平區,1595,79,231,310,11,321,451,71.18%,17.52%,1
臺中市,和平區,1596,28,166,194,11,205,366,56.01%,7.65%,1
臺中市,和平區,1597,73,283,356,10,366,771,47.47%,9.47%,1
臺中市,和平區,1598,60,238,298,23,321,574,55.92%,10.45%,1
臺中市,和平區,1599,31,126,157,14,171,274,62.41%,11.31%,1
臺中市,和平區,1600,18,63,81,5,86,157,54.78%,11.46%,1
臺中市,和平區,1601,73,345,418,25,443,713,62.13%,10.24%,1
臺南市,新營區,0116,234,505,739,55,794,1693,46.9%,13.82%,1
臺南市,新營區,0117,238,568,806,66,872,1561,55.86%,15.25%,1
臺南市,新營區,0118,233,532,765,42,807,1487,54.27%,15.67%,1
臺南市,新營區,0119,186,436,622,20,642,1232,52.11%,15.1%,1
臺南市,新營區,0120,183,346,529,20,549,1067,51.45%,17.15%,1
臺南市,新營區,0121,223,407,630,30,660,1419,46.51%,15.72%,1
臺南市,新營區,0122,258,513,771,32,803,1466,54.77%,17.6%,1
臺南市,新營區,0123,180,350,530,44,574,932,61.59%,19.31%,1
臺南市,新營區,0124,151,332,483,22,505,1099,45.95%,13.74%,1
臺南市,新營區,0125,97,236,333,27,360,757,47.56%,12.81%,1
臺南市,新營區,0126,158,307,465,37,502,888,56.53%,17.79%,1
臺南市,新營區,0127,206,352,558,13,571,1115,51.21%,18.48%,1
臺南市,新營區,0128,146,287,433,21,454,937,48.45%,15.58%,1
臺南市,新營區,0129,214,432,646,40,686,1387,49.46%,15.43%,1
臺南市,新營區,0130,213,500,713,46,759,1526,49.74%,13.96%,1
臺南市,新營區,0131,232,474,706,28,734,1301,56.42%,17.83%,1
臺南市,新營區,0132,268,564,832,37,869,1538,56.5%,17.43%,1
臺南市,新營區,0133,281,534,815,40,855,1584,53.98%,17.74%,1
臺南市,新營區,0134,300,567,867,25,892,1583,56.35%,18.95%,1
臺南市,新營區,0135,307,510,817,25,842,1530,55.03%,20.07%,1
臺南市,新營區,0136,230,428,658,41,699,1193,58.59%,19.28%,1
臺南市,新營區,0137,198,358,556,17,573,1439,39.82%,13.76%,1
臺南市,新營區,0138,223,548,771,37,808,1438,56.19%,15.51%,1
臺南市,新營區,0139,58,132,190,20,210,359,58.5%,16.16%,1
臺南市,新營區,0140,167,331,498,28,526,1233,42.66%,13.54%,1
臺南市,新營區,0141,132,370,502,25,527,1227,42.95%,10.76%,1
臺南市,新營區,0142,176,403,579,27,606,1320,45.91%,13.33%,1
臺南市,新營區,0143,283,514,797,26,823,1930,42.64%,14.66%,1
臺南市,新營區,0144,238,511,749,41,790,1501,52.63%,15.86%,1
臺南市,新營區,0145,207,486,693,30,723,1475,49.02%,14.03%,1
臺南市,新營區,0146,302,594,896,38,934,1753,53.28%,17.23%,1
臺南市,新營區,0147,292,532,824,39,863,1748,49.37%,16.7%,1
臺南市,新營區,0148,265,584,849,41,890,1741,51.12%,15.22%,1
臺南市,新營區,0149,217,460,677,21,698,1433,48.71%,15.14%,1
臺南市,新營區,0150,253,538,791,38,829,1595,51.97%,15.86%,1
臺南市,新營區,0151,138,285,423,15,438,959,45.67%,14.39%,1
臺南市,新營區,0152,270,579,849,54,903,1865,48.42%,14.48%,1
臺南市,新營區,0153,228,486,714,71,785,1678,46.78%,13.59%,1
臺南市,新營區,0154,165,398,563,57,620,1373,45.16%,12.02%,1
臺南市,新營區,0155,178,338,516,28,544,1431,38.02%,12.44%,1
臺南市,新營區,0156,39,65,104,3,107,291,36.77%,13.4%,1
臺南市,新營區,0157,283,517,800,53,853,1749,48.77%,16.18%,1
臺南市,新營區,0158,250,561,811,36,847,1862,45.49%,13.43%,1
臺南市,新營區,0159,306,596,902,83,985,1821,54.09%,16.8%,1
臺南市,新營區,0160,248,557,805,55,860,1845,46.61%,13.44%,1
臺南市,新營區,0161,56,143,199,8,207,542,38.19%,10.33%,1
臺南市,新營區,0162,61,83,144,3,147,402,36.57%,15.17%,1
臺南市,新營區,0163,118,238,356,55,411,703,58.46%,16.79%,1
臺南市,新營區,0164,113,272,385,37,422,941,44.85%,12.01%,1
臺南市,鹽水區,0085,145,345,490,69,559,1037,53.91%,13.98%,1
臺南市,鹽水區,0086,79,155,234,22,256,480,53.33%,16.46%,1
臺南市,鹽水區,0087,129,223,352,30,382,636,60.06%,20.28%,1
臺南市,鹽水區,0088,52,109,161,9,170,321,52.96%,16.2%,1
臺南市,鹽水區,0089,77,192,269,28,297,497,59.76%,15.49%,1
臺南市,鹽水區,0090,150,267,417,22,439,759,57.84%,19.76%,1
臺南市,鹽水區,0091,46,106,152,12,164,341,48.09%,13.49%,1
臺南市,鹽水區,0092,73,184,257,22,279,507,55.03%,14.4%,1
臺南市,鹽水區,0093,114,241,355,24,379,863,43.92%,13.21%,1
臺南市,鹽水區,0094,210,425,635,26,661,1373,48.14%,15.29%,1
臺南市,鹽水區,0095,217,471,688,65,753,1507,49.97%,14.4%,1
臺南市,鹽水區,0096,232,443,675,53,728,1374,52.98%,16.89%,1
臺南市,鹽水區,0097,194,349,543,36,579,1244,46.54%,15.59%,1
臺南市,鹽水區,0098,139,346,485,55,540,1022,52.84%,13.6%,1
臺南市,鹽水區,0099,109,205,314,36,350,921,38%,11.83%,1
臺南市,鹽水區,0100,145,268,413,45,458,847,54.07%,17.12%,1
臺南市,鹽水區,0101,87,153,240,9,249,736,33.83%,11.82%,1
臺南市,鹽水區,0102,103,265,368,15,383,761,50.33%,13.53%,1
臺南市,鹽水區,0103,36,90,126,10,136,285,47.72%,12.63%,1
臺南市,鹽水區,0104,66,138,204,22,226,493,45.84%,13.39%,1
臺南市,鹽水區,0105,61,155,216,24,240,621,38.65%,9.82%,1
臺南市,鹽水區,0106,42,93,135,8,143,392,36.48%,10.71%,1
臺南市,鹽水區,0107,115,303,418,32,450,925,48.65%,12.43%,1
臺南市,鹽水區,0108,75,210,285,33,318,728,43.68%,10.3%,1
臺南市,鹽水區,0109,16,48,64,16,80,214,37.38%,7.48%,1
臺南市,鹽水區,0110,41,124,165,12,177,387,45.74%,10.59%,1
臺南市,鹽水區,0111,40,95,135,19,154,301,51.16%,13.29%,1
臺南市,鹽水區,0112,94,167,261,30,291,755,38.54%,12.45%,1
臺南市,鹽水區,0113,38,88,126,22,148,365,40.55%,10.41%,1
臺南市,鹽水區,0114,141,252,393,29,422,935,45.13%,15.08%,1
臺南市,鹽水區,0115,76,123,199,23,222,494,44.94%,15.38%,1
臺南市,白河區,0030,197,368,565,62,627,1176,53.32%,16.75%,1
臺南市,白河區,0031,92,164,256,18,274,546,50.18%,16.85%,1
臺南市,白河區,0032,164,276,440,26,466,859,54.25%,19.09%,1
臺南市,白河區,0033,139,347,486,36,522,946,55.18%,14.69%,1
臺南市,白河區,0034,165,382,547,28,575,1116,51.52%,14.78%,1
臺南市,白河區,0035,167,350,517,35,552,1397,39.51%,11.95%,1
臺南市,白河區,0036,99,186,285,20,305,756,40.34%,13.1%,1
臺南市,白河區,0037,125,252,377,48,425,871,48.79%,14.35%,1
臺南市,白河區,0038,135,280,415,32,447,897,49.83%,15.05%,1
臺南市,白河區,0039,83,158,241,36,277,784,35.33%,10.59%,1
臺南市,白河區,0040,81,138,219,17,236,572,41.26%,14.16%,1
臺南市,白河區,0041,38,106,144,8,152,457,33.26%,8.32%,1
臺南市,白河區,0042,54,142,196,11,207,600,34.5%,9%,1
臺南市,白河區,0043,29,80,109,4,113,375,30.13%,7.73%,1
臺南市,白河區,0044,38,88,126,7,133,508,26.18%,7.48%,1
臺南市,白河區,0045,63,129,192,9,201,631,31.85%,9.98%,1
臺南市,白河區,0046,32,76,108,8,116,391,29.67%,8.18%,1
臺南市,白河區,0047,67,189,256,16,272,799,34.04%,8.39%,1
臺南市,白河區,0048,39,111,150,19,169,506,33.4%,7.71%,1
臺南市,白河區,0049,124,222,346,26,372,832,44.71%,14.9%,1
臺南市,白河區,0050,162,363,525,30,555,1179,47.07%,13.74%,1
臺南市,白河區,0051,88,155,243,14,257,744,34.54%,11.83%,1
臺南市,白河區,0052,71,176,247,19,266,699,38.05%,10.16%,1
臺南市,白河區,0053,70,143,213,11,224,633,35.39%,11.06%,1
臺南市,白河區,0054,154,244,398,62,460,859,53.55%,17.93%,1
臺南市,白河區,0055,110,226,336,51,387,884,43.78%,12.44%,1
臺南市,白河區,0056,52,145,197,12,209,740,28.24%,7.03%,1
臺南市,白河區,0057,157,354,511,49,560,1334,41.98%,11.77%,1
臺南市,白河區,0058,98,195,293,60,353,723,48.82%,13.55%,1
臺南市,白河區,0059,102,227,329,52,381,682,55.87%,14.96%,1
臺南市,白河區,0060,132,259,391,47,438,855,51.23%,15.44%,1
臺南市,白河區,0061,55,140,195,28,223,543,41.07%,10.13%,1
臺南市,柳營區,0165,179,351,530,47,577,1166,49.49%,15.35%,1
臺南市,柳營區,0166,111,224,335,12,347,625,55.52%,17.76%,1
臺南市,柳營區,0167,82,211,293,32,325,738,44.04%,11.11%,1
臺南市,柳營區,0168,135,307,442,23,465,834,55.76%,16.19%,1
臺南市,柳營區,0169,160,318,478,33,511,1104,46.29%,14.49%,1
臺南市,柳營區,0170,153,296,449,24,473,1015,46.6%,15.07%,1
臺南市,柳營區,0171,200,646,846,98,944,1720,54.88%,11.63%,1
臺南市,柳營區,0172,190,404,594,65,659,1391,47.38%,13.66%,1
臺南市,柳營區,0173,63,129,192,10,202,425,47.53%,14.82%,1
臺南市,柳營區,0174,36,94,130,9,139,318,43.71%,11.32%,1
臺南市,柳營區,0175,112,224,336,37,373,753,49.54%,14.87%,1
臺南市,柳營區,0176,100,200,300,45,345,730,47.26%,13.7%,1
臺南市,柳營區,0177,109,207,316,40,356,725,49.1%,15.03%,1
臺南市,柳營區,0178,109,277,386,36,422,787,53.62%,13.85%,1
臺南市,柳營區,0179,48,100,148,22,170,297,57.24%,16.16%,1
臺南市,柳營區,0180,87,247,334,40,374,673,55.57%,12.93%,1
臺南市,柳營區,0181,97,203,300,59,359,640,56.09%,15.16%,1
臺南市,柳營區,0182,102,162,264,31,295,660,44.7%,15.45%,1
臺南市,柳營區,0183,164,320,484,47,531,1212,43.81%,13.53%,1
臺南市,柳營區,0184,24,60,84,7,91,202,45.05%,11.88%,1
臺南市,柳營區,0185,127,305,432,77,509,1049,48.52%,12.11%,1
臺南市,柳營區,0186,21,51,72,3,75,158,47.47%,13.29%,1
臺南市,柳營區,0187,118,292,410,54,464,921,50.38%,12.81%,1
臺南市,柳營區,0188,67,155,222,12,234,504,46.43%,13.29%,1
臺南市,柳營區,0189,13,51,64,3,67,157,42.68%,8.28%,1
臺南市,後壁區,0001,112,271,383,43,426,743,57.34%,15.07%,1
臺南市,後壁區,0002,141,279,420,28,448,898,49.89%,15.7%,1
臺南市,後壁區,0003,108,220,328,42,370,786,47.07%,13.74%,1
臺南市,後壁區,0004,77,166,243,32,275,534,51.5%,14.42%,1
臺南市,後壁區,0005,147,325,472,57,529,1034,51.16%,14.22%,1
臺南市,後壁區,0006,40,46,86,20,106,232,45.69%,17.24%,1
臺南市,後壁區,0007,56,143,199,36,235,479,49.06%,11.69%,1
臺南市,後壁區,0008,105,249,354,34,388,837,46.36%,12.54%,1
臺南市,後壁區,0009,149,255,404,41,445,1085,41.01%,13.73%,1
臺南市,後壁區,0010,142,264,406,14,420,1157,36.3%,12.27%,1
臺南市,後壁區,0011,82,250,332,54,386,755,51.13%,10.86%,1
臺南市,後壁區,0012,90,131,221,29,250,458,54.59%,19.65%,1
臺南市,後壁區,0013,29,120,149,25,174,371,46.9%,7.82%,1
臺南市,後壁區,0014,99,194,293,35,328,676,48.52%,14.64%,1
臺南市,後壁區,0015,46,114,160,30,190,428,44.39%,10.75%,1
臺南市,後壁區,0016,60,144,204,9,213,547,38.94%,10.97%,1
臺南市,後壁區,0017,55,139,194,41,235,455,51.65%,12.09%,1
臺南市,後壁區,0018,93,246,339,67,406,984,41.26%,9.45%,1
臺南市,後壁區,0019,66,124,190,35,225,483,46.58%,13.66%,1
臺南市,後壁區,0020,53,143,196,29,225,536,41.98%,9.89%,1
臺南市,後壁區,0021,106,234,340,14,354,958,36.95%,11.06%,1
臺南市,後壁區,0022,68,162,230,21,251,441,56.92%,15.42%,1
臺南市,後壁區,0023,100,196,296,66,362,677,53.47%,14.77%,1
臺南市,後壁區,0024,140,341,481,48,529,996,53.11%,14.06%,1
臺南市,後壁區,0025,169,355,524,32,556,1255,44.3%,13.47%,1
臺南市,後壁區,0026,97,179,276,15,291,678,42.92%,14.31%,1
臺南市,後壁區,0027,57,163,220,14,234,553,42.31%,10.31%,1
臺南市,後壁區,0028,78,133,211,18,229,616,37.18%,12.66%,1
臺南市,後壁區,0029,168,352,520,35,555,1189,46.68%,14.13%,1
臺南市,東山區,0062,166,405,571,47,618,1401,44.11%,11.85%,1
臺南市,東山區,0063,148,292,440,45,485,1185,40.93%,12.49%,1
臺南市,東山區,0064,148,331,479,57,536,1303,41.14%,11.36%,1
臺南市,東山區,0065,79,186,265,29,294,732,40.16%,10.79%,1
臺南市,東山區,0066,79,162,241,35,276,721,38.28%,10.96%,1
臺南市,東山區,0067,112,230,342,55,397,1104,35.96%,10.14%,1
臺南市,東山區,0068,97,263,360,27,387,943,41.04%,10.29%,1
臺南市,東山區,0069,46,113,159,4,163,653,24.96%,7.04%,1
臺南市,東山區,0070,85,149,234,59,293,596,49.16%,14.26%,1
臺南市,東山區,0071,120,225,345,52,397,878,45.22%,13.67%,1
臺南市,東山區,0072,98,185,283,38,321,771,41.63%,12.71%,1
臺南市,東山區,0073,63,129,192,22,214,483,44.31%,13.04%,1
臺南市,東山區,0074,100,182,282,36,318,640,49.69%,15.63%,1
臺南市,東山區,0075,29,69,98,2,100,425,23.53%,6.82%,1
臺南市,東山區,0076,33,105,138,7,145,394,36.8%,8.38%,1
臺南市,東山區,0077,44,115,159,28,187,373,50.13%,11.8%,1
臺南市,東山區,0078,92,308,400,39,439,1257,34.92%,7.32%,1
臺南市,東山區,0079,56,157,213,7,220,887,24.8%,6.31%,1
臺南市,東山區,0080,39,129,168,9,177,658,26.9%,5.93%,1
臺南市,東山區,0081,92,207,299,24,323,1101,29.34%,8.36%,1
臺南市,東山區,0082,72,194,266,18,284,1057,26.87%,6.81%,1
臺南市,東山區,0083,69,200,269,35,304,639,47.57%,10.8%,1
臺南市,東山區,0084,37,69,106,11,117,270,43.33%,13.7%,1
臺南市,麻豆區,0381,86,486,572,42,614,1205,50.95%,7.14%,1
臺南市,麻豆區,0382,116,230,346,23,369,660,55.91%,17.58%,1
臺南市,麻豆區,0383,97,181,278,13,291,523,55.64%,18.55%,1
臺南市,麻豆區,0384,273,488,761,33,794,1597,49.72%,17.09%,1
臺南市,麻豆區,0385,227,434,661,41,702,1262,55.63%,17.99%,1
臺南市,麻豆區,0386,228,480,708,39,747,1325,56.38%,17.21%,1
臺南市,麻豆區,0387,260,411,671,23,694,1384,50.14%,18.79%,1
臺南市,麻豆區,0388,196,353,549,24,573,1121,51.12%,17.48%,1
臺南市,麻豆區,0389,173,305,478,12,490,1021,47.99%,16.94%,1
臺南市,麻豆區,0390,169,288,457,21,478,954,50.1%,17.71%,1
臺南市,麻豆區,0391,234,427,661,24,685,1513,45.27%,15.47%,1
臺南市,麻豆區,0392,236,500,736,33,769,1726,44.55%,13.67%,1
臺南市,麻豆區,0393,275,568,843,64,907,1804,50.28%,15.24%,1
臺南市,麻豆區,0394,151,343,494,32,526,1106,47.56%,13.65%,1
臺南市,麻豆區,0395,256,488,744,40,784,1503,52.16%,17.03%,1
臺南市,麻豆區,0396,204,419,623,43,666,1302,51.15%,15.67%,1
臺南市,麻豆區,0397,104,197,301,13,314,645,48.68%,16.12%,1
臺南市,麻豆區,0398,128,274,402,34,436,777,56.11%,16.47%,1
臺南市,麻豆區,0399,246,480,726,39,765,1612,47.46%,15.26%,1
臺南市,麻豆區,0400,113,193,306,11,317,718,44.15%,15.74%,1
臺南市,麻豆區,0401,246,444,690,15,705,1656,42.57%,14.86%,1
臺南市,麻豆區,0402,238,369,607,57,664,1355,49%,17.56%,1
臺南市,麻豆區,0403,133,252,385,23,408,977,41.76%,13.61%,1
臺南市,麻豆區,0404,159,270,429,26,455,1012,44.96%,15.71%,1
臺南市,麻豆區,0405,126,204,330,18,348,626,55.59%,20.13%,1
臺南市,麻豆區,0406,48,100,148,3,151,467,32.33%,10.28%,1
臺南市,麻豆區,0407,182,361,543,21,564,1260,44.76%,14.44%,1
臺南市,麻豆區,0408,185,366,551,36,587,1111,52.84%,16.65%,1
臺南市,麻豆區,0409,104,172,276,20,296,550,53.82%,18.91%,1
臺南市,麻豆區,0410,140,233,373,39,412,798,51.63%,17.54%,1
臺南市,麻豆區,0411,164,288,452,57,509,852,59.74%,19.25%,1
臺南市,麻豆區,0412,130,208,338,12,350,830,42.17%,15.66%,1
臺南市,麻豆區,0413,150,237,387,17,404,941,42.93%,15.94%,1
臺南市,麻豆區,0414,198,363,561,36,597,1158,51.55%,17.1%,1
臺南市,麻豆區,0415,79,194,273,7,280,612,45.75%,12.91%,1
臺南市,下營區,0343,192,441,633,48,681,1558,43.71%,12.32%,1
臺南市,下營區,0344,160,264,424,33,457,1112,41.1%,14.39%,1
臺南市,下營區,0345,127,252,379,45,424,893,47.48%,14.22%,1
臺南市,下營區,0346,183,437,620,53,673,1623,41.47%,11.28%,1
臺南市,下營區,0347,229,481,710,63,773,1568,49.3%,14.6%,1
臺南市,下營區,0348,127,349,476,29,505,985,51.27%,12.89%,1
臺南市,下營區,0349,137,279,416,18,434,953,45.54%,14.38%,1
臺南市,下營區,0350,152,308,460,22,482,1031,46.75%,14.74%,1
臺南市,下營區,0351,173,363,536,65,601,1077,55.8%,16.06%,1
臺南市,下營區,0352,98,165,263,35,298,703,42.39%,13.94%,1
臺南市,下營區,0353,102,240,342,19,361,854,42.27%,11.94%,1
臺南市,下營區,0354,171,369,540,46,586,1164,50.34%,14.69%,1
臺南市,下營區,0355,155,307,462,19,481,1091,44.09%,14.21%,1
臺南市,下營區,0356,128,318,446,47,493,959,51.41%,13.35%,1
臺南市,下營區,0357,154,261,415,30,445,935,47.59%,16.47%,1
臺南市,下營區,0358,157,264,421,41,462,893,51.74%,17.58%,1
臺南市,下營區,0359,199,408,607,72,679,1293,52.51%,15.39%,1
臺南市,下營區,0360,198,320,518,108,626,1185,52.83%,16.71%,1
臺南市,下營區,0361,126,253,379,18,397,1070,37.1%,11.78%,1
臺南市,六甲區,0362,137,279,416,53,469,819,57.26%,16.73%,1
臺南市,六甲區,0363,105,201,306,20,326,645,50.54%,16.28%,1
臺南市,六甲區,0364,228,387,615,40,655,1444,45.36%,15.79%,1
臺南市,六甲區,0365,203,414,617,44,661,1554,42.54%,13.06%,1
臺南市,六甲區,0366,166,301,467,34,501,1171,42.78%,14.18%,1
臺南市,六甲區,0367,197,391,588,60,648,1351,47.96%,14.58%,1
臺南市,六甲區,0368,121,271,392,77,469,1010,46.44%,11.98%,1
臺南市,六甲區,0369,131,249,380,54,434,919,47.23%,14.25%,1
臺南市,六甲區,0370,217,396,613,51,664,1369,48.5%,15.85%,1
臺南市,六甲區,0371,154,301,455,54,509,976,52.15%,15.78%,1
臺南市,六甲區,0372,163,347,510,50,560,1015,55.17%,16.06%,1
臺南市,六甲區,0373,169,330,499,28,527,1176,44.81%,14.37%,1
臺南市,六甲區,0374,135,302,437,46,483,939,51.44%,14.38%,1
臺南市,六甲區,0375,117,211,328,45,373,712,52.39%,16.43%,1
臺南市,六甲區,0376,153,273,426,32,458,881,51.99%,17.37%,1
臺南市,六甲區,0377,216,416,632,55,687,1184,58.02%,18.24%,1
臺南市,六甲區,0378,99,242,341,24,365,599,60.93%,16.53%,1
臺南市,六甲區,0379,69,169,238,7,245,759,32.28%,9.09%,1
臺南市,六甲區,0380,66,150,216,31,247,621,39.77%,10.63%,1
臺南市,官田區,0416,148,327,475,19,494,1104,44.75%,13.41%,1
臺南市,官田區,0417,150,288,438,36,474,965,49.12%,15.54%,1
臺南市,官田區,0418,230,430,660,41,701,1402,50%,16.41%,1
臺南市,官田區,0419,278,500,778,130,908,1653,54.93%,16.82%,1
臺南市,官田區,0420,130,265,395,57,452,966,46.79%,13.46%,1
臺南市,官田區,0421,36,78,114,11,125,284,44.01%,12.68%,1
臺南市,官田區,0422,55,60,115,7,122,402,30.35%,13.68%,1
臺南市,官田區,0423,169,309,478,9,487,982,49.59%,17.21%,1
臺南市,官田區,0424,320,76,396,30,426,975,43.69%,32.82%,1
臺南市,官田區,0425,126,251,377,21,398,802,49.63%,15.71%,1
臺南市,官田區,0426,188,381,569,36,605,1118,54.11%,16.82%,1
臺南市,官田區,0427,245,441,686,31,717,1455,49.28%,16.84%,1
臺南市,官田區,0428,184,390,574,32,606,1208,50.17%,15.23%,1
臺南市,官田區,0429,186,377,563,57,620,1293,47.95%,14.39%,1
臺南市,官田區,0430,86,133,219,24,243,607,40.03%,14.17%,1
臺南市,官田區,0431,73,145,218,22,240,501,47.9%,14.57%,1
臺南市,官田區,0432,127,221,348,53,401,728,55.08%,17.45%,1
臺南市,官田區,0433,153,233,386,24,410,842,48.69%,18.17%,1
臺南市,官田區,0434,72,170,242,36,278,515,53.98%,13.98%,1
臺南市,官田區,0435,118,249,367,16,383,873,43.87%,13.52%,1
臺南市,大內區,0436,87,204,291,41,332,759,43.74%,11.46%,1
臺南市,大內區,0437,16,70,86,2,88,262,33.59%,6.11%,1
臺南市,大內區,0438,82,146,228,17,245,646,37.93%,12.69%,1
臺南市,大內區,0439,165,378,543,57,600,1473,40.73%,11.2%,1
臺南市,大內區,0440,109,322,431,66,497,915,54.32%,11.91%,1
臺南市,大內區,0441,137,261,398,41,439,779,56.35%,17.59%,1
臺南市,大內區,0442,126,211,337,51,388,637,60.91%,19.78%,1
臺南市,大內區,0443,123,293,416,30,446,993,44.91%,12.39%,1
臺南市,大內區,0444,77,298,375,35,410,766,53.52%,10.05%,1
臺南市,大內區,0445,96,289,385,37,422,841,50.18%,11.41%,1
臺南市,大內區,0446,58,186,244,42,286,583,49.06%,9.95%,1
臺南市,佳里區,0282,233,502,735,42,777,1391,55.86%,16.75%,1
臺南市,佳里區,0283,157,303,460,31,491,829,59.23%,18.94%,1
臺南市,佳里區,0284,187,417,604,39,643,1401,45.9%,13.35%,1
臺南市,佳里區,0285,188,428,616,20,636,1452,43.8%,12.95%,1
臺南市,佳里區,0286,229,462,691,44,735,1382,53.18%,16.57%,1
臺南市,佳里區,0287,224,503,727,48,775,1463,52.97%,15.31%,1
臺南市,佳里區,0288,188,412,600,39,639,1280,49.92%,14.69%,1
臺南市,佳里區,0289,244,504,748,69,817,1486,54.98%,16.42%,1
臺南市,佳里區,0290,257,454,711,52,763,1378,55.37%,18.65%,1
臺南市,佳里區,0291,231,540,771,49,820,1505,54.49%,15.35%,1
臺南市,佳里區,0292,265,647,912,55,967,1860,51.99%,14.25%,1
臺南市,佳里區,0293,190,377,567,66,633,1134,55.82%,16.75%,1
臺南市,佳里區,0294,165,577,742,17,759,1426,53.23%,11.57%,1
臺南市,佳里區,0295,299,570,869,66,935,1779,52.56%,16.81%,1
臺南市,佳里區,0296,322,675,997,45,1042,1906,54.67%,16.89%,1
臺南市,佳里區,0297,225,462,687,38,725,1425,50.88%,15.79%,1
臺南市,佳里區,0298,199,422,621,37,658,1255,52.43%,15.86%,1
臺南市,佳里區,0299,241,459,700,47,747,1524,49.02%,15.81%,1
臺南市,佳里區,0300,275,526,801,30,831,1631,50.95%,16.86%,1
臺南市,佳里區,0301,243,569,812,53,865,1546,55.95%,15.72%,1
臺南市,佳里區,0302,221,447,668,42,710,1187,59.81%,18.62%,1
臺南市,佳里區,0303,240,465,705,26,731,1381,52.93%,17.38%,1
臺南市,佳里區,0304,206,456,662,26,688,1364,50.44%,15.1%,1
臺南市,佳里區,0305,228,457,685,21,706,1314,53.73%,17.35%,1
臺南市,佳里區,0306,281,324,605,45,650,1164,55.84%,24.14%,1
臺南市,佳里區,0307,135,333,468,48,516,961,53.69%,14.05%,1
臺南市,佳里區,0308,173,409,582,43,625,1218,51.31%,14.2%,1
臺南市,佳里區,0309,154,325,479,18,497,919,54.08%,16.76%,1
臺南市,佳里區,0310,109,228,337,24,361,689,52.39%,15.82%,1
臺南市,佳里區,0311,62,105,167,10,177,383,46.21%,16.19%,1
臺南市,佳里區,0312,201,481,682,42,724,1507,48.04%,13.34%,1
臺南市,佳里區,0313,93,220,313,33,346,702,49.29%,13.25%,1
臺南市,佳里區,0314,128,340,468,36,504,907,55.57%,14.11%,1
臺南市,佳里區,0315,170,348,518,47,565,937,60.3%,18.14%,1
臺南市,佳里區,0316,180,312,492,73,565,1030,54.85%,17.48%,1
臺南市,佳里區,0317,145,324,469,42,511,981,52.09%,14.78%,1
臺南市,佳里區,0318,108,241,349,28,377,787,47.9%,13.72%,1
臺南市,佳里區,0319,194,518,712,63,775,1513,51.22%,12.82%,1
臺南市,佳里區,0320,99,190,289,19,308,714,43.14%,13.87%,1
臺南市,佳里區,0321,123,201,324,44,368,745,49.4%,16.51%,1
臺南市,佳里區,0322,150,268,418,27,445,951,46.79%,15.77%,1
臺南市,學甲區,0208,140,299,439,45,484,862,56.15%,16.24%,1
臺南市,學甲區,0209,108,226,334,9,343,611,56.14%,17.68%,1
臺南市,學甲區,0210,142,311,453,23,476,936,50.85%,15.17%,1
臺南市,學甲區,0211,150,329,479,35,514,1066,48.22%,14.07%,1
臺南市,學甲區,0212,151,301,452,27,479,869,55.12%,17.38%,1
臺南市,學甲區,0213,99,204,303,27,330,635,51.97%,15.59%,1
臺南市,學甲區,0214,98,260,358,25,383,822,46.59%,11.92%,1
臺南市,學甲區,0215,45,133,178,14,192,443,43.34%,10.16%,1
臺南市,學甲區,0216,192,469,661,33,694,1370,50.66%,14.01%,1
臺南市,學甲區,0217,184,384,568,43,611,1117,54.7%,16.47%,1
臺南市,學甲區,0218,184,433,617,62,679,1365,49.74%,13.48%,1
臺南市,學甲區,0219,182,462,644,69,713,1489,47.88%,12.22%,1
臺南市,學甲區,0220,69,166,235,30,265,627,42.26%,11%,1
臺南市,學甲區,0221,170,330,500,26,526,1052,50%,16.16%,1
臺南市,學甲區,0222,184,350,534,26,560,1183,47.34%,15.55%,1
臺南市,學甲區,0223,111,274,385,29,414,979,42.29%,11.34%,1
臺南市,學甲區,0224,172,337,509,48,557,1241,44.88%,13.86%,1
臺南市,學甲區,0225,92,205,297,23,320,843,37.96%,10.91%,1
臺南市,學甲區,0226,62,189,251,30,281,580,48.45%,10.69%,1
臺南市,學甲區,0227,90,209,299,18,317,832,38.1%,10.82%,1
臺南市,學甲區,0228,40,104,144,7,151,406,37.19%,9.85%,1
臺南市,學甲區,0229,124,265,389,36,425,818,51.96%,15.16%,1
臺南市,學甲區,0230,123,271,394,13,407,1052,38.69%,11.69%,1
臺南市,學甲區,0231,71,158,229,13,242,578,41.87%,12.28%,1
臺南市,學甲區,0232,49,110,159,19,178,430,41.4%,11.4%,1
臺南市,學甲區,0233,38,120,158,9,167,361,46.26%,10.53%,1
臺南市,西港區,0323,143,303,446,20,466,933,49.95%,15.33%,1
臺南市,西港區,0324,157,290,447,25,472,901,52.39%,17.43%,1
臺南市,西港區,0325,206,391,597,25,622,1314,47.34%,15.68%,1
臺南市,西港區,0326,211,422,633,59,692,1349,51.3%,15.64%,1
臺南市,西港區,0327,174,346,520,43,563,1014,55.52%,17.16%,1
臺南市,西港區,0328,230,506,736,31,767,1900,40.37%,12.11%,1
臺南市,西港區,0329,270,430,700,45,745,1663,44.8%,16.24%,1
臺南市,西港區,0330,109,193,302,15,317,738,42.95%,14.77%,1
臺南市,西港區,0331,187,424,611,35,646,1211,53.34%,15.44%,1
臺南市,西港區,0332,55,112,167,18,185,382,48.43%,14.4%,1
臺南市,西港區,0333,100,256,356,22,378,786,48.09%,12.72%,1
臺南市,西港區,0334,107,277,384,16,400,838,47.73%,12.77%,1
臺南市,西港區,0335,203,369,572,42,614,1449,42.37%,14.01%,1
臺南市,西港區,0336,175,415,590,32,622,1479,42.06%,11.83%,1
臺南市,西港區,0337,110,265,375,48,423,763,55.44%,14.42%,1
臺南市,西港區,0338,158,410,568,21,589,1297,45.41%,12.18%,1
臺南市,西港區,0339,198,417,615,33,648,1393,46.52%,14.21%,1
臺南市,西港區,0340,124,250,374,13,387,958,40.4%,12.94%,1
臺南市,西港區,0341,66,129,195,21,216,391,55.24%,16.88%,1
臺南市,西港區,0342,111,268,379,44,423,805,52.55%,13.79%,1
臺南市,七股區,0258,76,169,245,13,258,534,48.31%,14.23%,1
臺南市,七股區,0259,80,180,260,12,272,508,53.54%,15.75%,1
臺南市,七股區,0260,68,185,253,5,258,665,38.8%,10.23%,1
臺南市,七股區,0261,102,242,344,20,364,834,43.65%,12.23%,1
臺南市,七股區,0262,87,261,348,10,358,810,44.2%,10.74%,1
臺南市,七股區,0263,33,126,159,12,171,480,35.63%,6.88%,1
臺南市,七股區,0264,42,119,161,12,173,445,38.88%,9.44%,1
臺南市,七股區,0265,44,134,178,17,195,680,28.68%,6.47%,1
臺南市,七股區,0266,97,240,337,11,348,838,41.53%,11.58%,1
臺南市,七股區,0267,77,206,283,17,300,780,38.46%,9.87%,1
臺南市,七股區,0268,64,123,187,9,196,350,56%,18.29%,1
臺南市,七股區,0269,171,301,472,48,520,907,57.33%,18.85%,1
臺南市,七股區,0270,86,241,327,17,344,780,44.1%,11.03%,1
臺南市,七股區,0271,235,463,698,37,735,1658,44.33%,14.17%,1
臺南市,七股區,0272,121,274,395,19,414,913,45.35%,13.25%,1
臺南市,七股區,0273,200,354,554,50,604,1202,50.25%,16.64%,1
臺南市,七股區,0274,78,173,251,9,260,696,37.36%,11.21%,1
臺南市,七股區,0275,84,201,285,36,321,647,49.61%,12.98%,1
臺南市,七股區,0276,106,253,359,31,390,622,62.7%,17.04%,1
臺南市,七股區,0277,172,435,607,66,673,1175,57.28%,14.64%,1
臺南市,七股區,0278,108,185,293,21,314,698,44.99%,15.47%,1
臺南市,七股區,0279,131,322,453,60,513,983,52.19%,13.33%,1
臺南市,七股區,0280,162,348,510,34,544,1366,39.82%,11.86%,1
臺南市,七股區,0281,179,363,542,65,607,1379,44.02%,12.98%,1
臺南市,將軍區,0234,188,407,595,41,636,1110,57.3%,16.94%,1
臺南市,將軍區,0235,189,463,652,23,675,1418,47.6%,13.33%,1
臺南市,將軍區,0236,131,312,443,22,465,969,47.99%,13.52%,1
臺南市,將軍區,0237,93,180,273,30,303,519,58.38%,17.92%,1
臺南市,將軍區,0238,157,364,521,18,539,1106,48.73%,14.2%,1
臺南市,將軍區,0239,86,156,242,28,270,542,49.82%,15.87%,1
臺南市,將軍區,0240,30,95,125,6,131,315,41.59%,9.52%,1
臺南市,將軍區,0241,64,154,218,23,241,584,41.27%,10.96%,1
臺南市,將軍區,0242,65,116,181,7,188,398,47.24%,16.33%,1
臺南市,將軍區,0243,84,158,242,16,258,608,42.43%,13.82%,1
臺南市,將軍區,0244,71,141,212,14,226,442,51.13%,16.06%,1
臺南市,將軍區,0245,67,168,235,9,244,650,37.54%,10.31%,1
臺南市,將軍區,0246,60,138,198,10,208,573,36.3%,10.47%,1
臺南市,將軍區,0247,65,163,228,7,235,617,38.09%,10.53%,1
臺南市,將軍區,0248,69,179,248,23,271,573,47.29%,12.04%,1
臺南市,將軍區,0249,43,157,200,19,219,434,50.46%,9.91%,1
臺南市,將軍區,0250,106,227,333,13,346,849,40.75%,12.49%,1
臺南市,將軍區,0251,62,175,237,22,259,645,40.16%,9.61%,1
臺南市,將軍區,0252,66,198,264,18,282,690,40.87%,9.57%,1
臺南市,將軍區,0253,48,145,193,8,201,663,30.32%,7.24%,1
臺南市,將軍區,0254,139,355,494,27,521,1175,44.34%,11.83%,1
臺南市,將軍區,0255,79,196,275,32,307,837,36.68%,9.44%,1
臺南市,將軍區,0256,134,332,466,89,555,1061,52.31%,12.63%,1
臺南市,將軍區,0257,97,246,343,12,355,976,36.37%,9.94%,1
臺南市,北門區,0190,78,137,215,14,229,484,47.31%,16.12%,1
臺南市,北門區,0191,42,113,155,11,166,401,41.4%,10.47%,1
臺南市,北門區,0192,38,132,170,6,176,456,38.6%,8.33%,1
臺南市,北門區,0193,71,120,191,17,208,382,54.45%,18.59%,1
臺南市,北門區,0194,45,113,158,24,182,356,51.12%,12.64%,1
臺南市,北門區,0195,49,87,136,8,144,389,37.02%,12.6%,1
臺南市,北門區,0196,69,233,302,7,309,742,41.64%,9.3%,1
臺南市,北門區,0197,67,196,263,10,273,599,45.58%,11.19%,1
臺南市,北門區,0198,64,157,221,27,248,594,41.75%,10.77%,1
臺南市,北門區,0199,61,168,229,16,245,572,42.83%,10.66%,1
臺南市,北門區,0200,37,65,102,4,106,318,33.33%,11.64%,1
臺南市,北門區,0201,52,114,166,11,177,473,37.42%,10.99%,1
臺南市,北門區,0202,238,75,313,16,329,954,34.49%,24.95%,1
臺南市,北門區,0203,94,279,373,24,397,737,53.87%,12.75%,1
臺南市,北門區,0204,50,180,230,9,239,679,35.2%,7.36%,1
臺南市,北門區,0205,49,124,173,26,199,521,38.2%,9.4%,1
臺南市,北門區,0206,59,150,209,18,227,632,35.92%,9.34%,1
臺南市,北門區,0207,74,157,231,10,241,636,37.89%,11.64%,1
臺南市,新化區,0581,125,303,428,23,451,746,60.46%,16.76%,1
臺南市,新化區,0582,209,404,613,40,653,1102,59.26%,18.97%,1
臺南市,新化區,0583,59,144,203,14,217,370,58.65%,15.95%,1
臺南市,新化區,0584,182,327,509,58,567,947,59.87%,19.22%,1
臺南市,新化區,0585,155,398,553,58,611,1154,52.95%,13.43%,1
臺南市,新化區,0586,206,342,548,59,607,1082,56.1%,19.04%,1
臺南市,新化區,0587,190,378,568,43,611,1075,56.84%,17.67%,1
臺南市,新化區,0588,88,228,316,22,338,640,52.81%,13.75%,1
臺南市,新化區,0589,65,132,197,19,216,410,52.68%,15.85%,1
臺南市,新化區,0590,72,176,248,29,277,533,51.97%,13.51%,1
臺南市,新化區,0591,170,281,451,15,466,836,55.74%,20.33%,1
臺南市,新化區,0592,109,285,394,26,420,978,42.94%,11.15%,1
臺南市,新化區,0593,253,445,698,37,735,1348,54.53%,18.77%,1
臺南市,新化區,0594,173,331,504,34,538,1015,53%,17.04%,1
臺南市,新化區,0595,185,368,553,33,586,1228,47.72%,15.07%,1
臺南市,新化區,0596,145,270,415,39,454,789,57.54%,18.38%,1
臺南市,新化區,0597,165,351,516,27,543,1022,53.13%,16.14%,1
臺南市,新化區,0598,145,350,495,24,519,1021,50.83%,14.2%,1
臺南市,新化區,0599,237,421,658,49,707,1229,57.53%,19.28%,1
臺南市,新化區,0600,199,380,579,21,600,1153,52.04%,17.26%,1
臺南市,新化區,0601,141,274,415,29,444,1012,43.87%,13.93%,1
臺南市,新化區,0602,255,495,750,53,803,1458,55.08%,17.49%,1
臺南市,新化區,0603,271,590,861,55,916,1645,55.68%,16.47%,1
臺南市,新化區,0604,188,356,544,46,590,1016,58.07%,18.5%,1
臺南市,新化區,0605,104,172,276,10,286,559,51.16%,18.6%,1
臺南市,新化區,0606,207,445,652,29,681,1222,55.73%,16.94%,1
臺南市,新化區,0607,219,749,968,47,1015,1562,64.98%,14.02%,1
臺南市,新化區,0608,149,303,452,22,474,994,47.69%,14.99%,1
臺南市,新化區,0609,158,339,497,66,563,1013,55.58%,15.6%,1
臺南市,新化區,0610,191,427,618,54,672,1197,56.14%,15.96%,1
臺南市,新化區,0611,124,347,471,39,510,1021,49.95%,12.14%,1
臺南市,新化區,0612,189,402,591,59,650,1428,45.52%,13.24%,1
臺南市,新化區,0613,58,129,187,29,216,456,47.37%,12.72%,1
臺南市,新化區,0614,163,374,537,46,583,1037,56.22%,15.72%,1
臺南市,新化區,0615,160,402,562,52,614,1097,55.97%,14.59%,1
臺南市,新化區,0616,149,307,456,46,502,902,55.65%,16.52%,1
臺南市,新化區,0617,130,289,419,91,510,999,51.05%,13.01%,1
臺南市,善化區,0492,165,343,508,12,520,1132,45.94%,14.58%,1
臺南市,善化區,0493,300,562,862,52,914,1845,49.54%,16.26%,1
臺南市,善化區,0494,349,649,998,52,1050,2090,50.24%,16.7%,1
臺南市,善化區,0495,286,539,825,51,876,1582,55.37%,18.08%,1
臺南市,善化區,0496,371,616,987,67,1054,1901,55.44%,19.52%,1
臺南市,善化區,0497,288,608,896,53,949,1818,52.2%,15.84%,1
臺南市,善化區,0498,273,540,813,46,859,1639,52.41%,16.66%,1
臺南市,善化區,0499,204,366,570,32,602,1061,56.74%,19.23%,1
臺南市,善化區,0500,298,630,928,69,997,1786,55.82%,16.69%,1
臺南市,善化區,0501,163,408,571,40,611,1147,53.27%,14.21%,1
臺南市,善化區,0502,260,472,732,56,788,1581,49.84%,16.45%,1
臺南市,善化區,0503,224,362,586,70,656,1240,52.9%,18.06%,1
臺南市,善化區,0504,248,458,706,33,739,1743,42.4%,14.23%,1
臺南市,善化區,0505,260,398,658,41,699,1246,56.1%,20.87%,1
臺南市,善化區,0506,153,302,455,22,477,961,49.64%,15.92%,1
臺南市,善化區,0507,134,290,424,14,438,938,46.7%,14.29%,1
臺南市,善化區,0508,122,232,354,13,367,722,50.83%,16.9%,1
臺南市,善化區,0509,148,312,460,35,495,1062,46.61%,13.94%,1
臺南市,善化區,0510,285,510,795,80,875,1715,51.02%,16.62%,1
臺南市,善化區,0511,170,334,504,44,548,1120,48.93%,15.18%,1
臺南市,善化區,0512,134,263,397,38,435,865,50.29%,15.49%,1
臺南市,善化區,0513,291,467,758,62,820,1574,52.1%,18.49%,1
臺南市,善化區,0514,210,418,628,67,695,1535,45.28%,13.68%,1
臺南市,善化區,0515,192,333,525,58,583,1106,52.71%,17.36%,1
臺南市,善化區,0516,222,439,661,28,689,1402,49.14%,15.83%,1
臺南市,善化區,0517,256,549,805,62,867,1458,59.47%,17.56%,1
臺南市,善化區,0518,227,384,611,35,646,1380,46.81%,16.45%,1
臺南市,善化區,0519,268,365,633,10,643,1232,52.19%,21.75%,1
臺南市,善化區,0520,252,319,571,12,583,1069,54.54%,23.57%,1
臺南市,新市區,0545,132,314,446,26,472,960,49.17%,13.75%,1
臺南市,新市區,0546,210,407,617,36,653,1118,58.41%,18.78%,1
臺南市,新市區,0547,123,277,400,16,416,850,48.94%,14.47%,1
臺南市,新市區,0548,197,422,619,42,661,1241,53.26%,15.87%,1
臺南市,新市區,0549,228,443,671,34,705,1297,54.36%,17.58%,1
臺南市,新市區,0550,161,343,504,38,542,962,56.34%,16.74%,1
臺南市,新市區,0551,215,443,658,41,699,1237,56.51%,17.38%,1
臺南市,新市區,0552,232,436,668,45,713,1326,53.77%,17.5%,1
臺南市,新市區,0553,205,424,629,48,677,1211,55.9%,16.93%,1
臺南市,新市區,0554,219,412,631,33,664,1305,50.88%,16.78%,1
臺南市,新市區,0555,104,238,342,35,377,688,54.8%,15.12%,1
臺南市,新市區,0556,170,319,489,26,515,911,56.53%,18.66%,1
臺南市,新市區,0557,153,548,701,37,738,1525,48.39%,10.03%,1
臺南市,新市區,0558,164,285,449,5,454,1091,41.61%,15.03%,1
臺南市,新市區,0559,173,375,548,19,567,1122,50.53%,15.42%,1
臺南市,新市區,0560,150,355,505,30,535,1049,51%,14.3%,1
臺南市,新市區,0561,268,428,696,19,715,1564,45.72%,17.14%,1
臺南市,新市區,0562,234,534,768,45,813,1515,53.66%,15.45%,1
臺南市,新市區,0563,200,478,678,38,716,1378,51.96%,14.51%,1
臺南市,新市區,0564,170,306,476,39,515,827,62.27%,20.56%,1
臺南市,新市區,0565,183,352,535,77,612,960,63.75%,19.06%,1
臺南市,新市區,0566,127,333,460,40,500,951,52.58%,13.35%,1
臺南市,新市區,0567,205,448,653,43,696,1264,55.06%,16.22%,1
臺南市,新市區,0568,208,382,590,33,623,1173,53.11%,17.73%,1
臺南市,新市區,0569,134,232,366,25,391,684,57.16%,19.59%,1
臺南市,新市區,0570,189,410,599,50,649,1055,61.52%,17.91%,1
臺南市,新市區,0571,227,427,654,37,691,1122,61.59%,20.23%,1
臺南市,安定區,0521,212,475,687,85,772,1251,61.71%,16.95%,1
臺南市,安定區,0522,136,321,457,40,497,899,55.28%,15.13%,1
臺南市,安定區,0523,177,361,538,71,609,1106,55.06%,16%,1
臺南市,安定區,0524,128,352,480,48,528,948,55.7%,13.5%,1
臺南市,安定區,0525,222,427,649,50,699,1442,48.47%,15.4%,1
臺南市,安定區,0526,220,409,629,66,695,1385,50.18%,15.88%,1
臺南市,安定區,0527,117,293,410,48,458,801,57.18%,14.61%,1
臺南市,安定區,0528,105,212,317,27,344,736,46.74%,14.27%,1
臺南市,安定區,0529,120,248,368,35,403,781,51.6%,15.36%,1
臺南市,安定區,0530,139,278,417,17,434,795,54.59%,17.48%,1
臺南市,安定區,0531,147,318,465,44,509,862,59.05%,17.05%,1
臺南市,安定區,0532,202,502,704,33,737,1487,49.56%,13.58%,1
臺南市,安定區,0533,192,474,666,39,705,1385,50.9%,13.86%,1
臺南市,安定區,0534,226,474,700,31,731,1518,48.16%,14.89%,1
臺南市,安定區,0535,185,416,601,40,641,1094,58.59%,16.91%,1
臺南市,安定區,0536,234,557,791,93,884,1590,55.6%,14.72%,1
臺南市,安定區,0537,107,284,391,37,428,754,56.76%,14.19%,1
臺南市,安定區,0538,112,255,367,44,411,716,57.4%,15.64%,1
臺南市,安定區,0539,245,512,757,57,814,1492,54.56%,16.42%,1
臺南市,安定區,0540,160,324,484,37,521,943,55.25%,16.97%,1
臺南市,安定區,0541,186,419,605,29,634,1157,54.8%,16.08%,1
臺南市,安定區,0542,212,478,690,79,769,1384,55.56%,15.32%,1
臺南市,安定區,0543,154,310,464,62,526,967,54.4%,15.93%,1
臺南市,安定區,0544,110,202,312,20,332,611,54.34%,18%,1
臺南市,山上區,0572,99,215,314,48,362,855,42.34%,11.58%,1
臺南市,山上區,0573,84,210,294,35,329,836,39.35%,10.05%,1
臺南市,山上區,0574,114,211,325,50,375,753,49.8%,15.14%,1
臺南市,山上區,0575,110,222,332,39,371,788,47.08%,13.96%,1
臺南市,山上區,0576,164,288,452,41,493,984,50.1%,16.67%,1
臺南市,山上區,0577,136,277,413,14,427,972,43.93%,13.99%,1
臺南市,山上區,0578,44,124,168,4,172,553,31.1%,7.96%,1
臺南市,山上區,0579,44,107,151,5,156,378,41.27%,11.64%,1
臺南市,山上區,0580,57,112,169,19,188,392,47.96%,14.54%,1
臺南市,玉井區,0466,163,412,575,32,607,1242,48.87%,13.12%,1
臺南市,玉井區,0467,141,423,564,33,597,1141,52.32%,12.36%,1
臺南市,玉井區,0468,97,226,323,20,343,698,49.14%,13.9%,1
臺南市,玉井區,0469,126,273,399,26,425,849,50.06%,14.84%,1
臺南市,玉井區,0470,119,348,467,43,510,949,53.74%,12.54%,1
臺南市,玉井區,0471,78,216,294,21,315,618,50.97%,12.62%,1
臺南市,玉井區,0472,70,166,236,15,251,594,42.26%,11.78%,1
臺南市,玉井區,0473,113,259,372,18,390,927,42.07%,12.19%,1
臺南市,玉井區,0474,64,174,238,37,275,512,53.71%,12.5%,1
臺南市,玉井區,0475,58,164,222,20,242,509,47.54%,11.39%,1
臺南市,玉井區,0476,64,179,243,25,268,496,54.03%,12.9%,1
臺南市,玉井區,0477,88,249,337,17,354,759,46.64%,11.59%,1
臺南市,玉井區,0478,60,191,251,9,260,669,38.86%,8.97%,1
臺南市,玉井區,0479,77,246,323,56,379,787,48.16%,9.78%,1
臺南市,玉井區,0480,79,175,254,40,294,620,47.42%,12.74%,1
臺南市,玉井區,0481,146,300,446,57,503,987,50.96%,14.79%,1
臺南市,楠西區,0447,101,326,427,49,476,978,48.67%,10.33%,1
臺南市,楠西區,0448,123,303,426,50,476,870,54.71%,14.14%,1
臺南市,楠西區,0449,91,286,377,15,392,1160,33.79%,7.84%,1
臺南市,楠西區,0450,69,213,282,22,304,699,43.49%,9.87%,1
臺南市,楠西區,0451,82,282,364,22,386,990,38.99%,8.28%,1
臺南市,楠西區,0452,102,279,381,33,414,928,44.61%,10.99%,1
臺南市,楠西區,0453,68,207,275,44,319,660,48.33%,10.3%,1
臺南市,楠西區,0454,138,385,523,64,587,1187,49.45%,11.63%,1
臺南市,楠西區,0455,118,340,458,35,493,1056,46.69%,11.17%,1
臺南市,南化區,0456,111,224,335,39,374,690,54.2%,16.09%,1
臺南市,南化區,0457,104,227,331,56,387,695,55.68%,14.96%,1
臺南市,南化區,0458,84,246,330,32,362,806,44.91%,10.42%,1
臺南市,南化區,0459,53,188,241,30,271,654,41.44%,8.1%,1
臺南市,南化區,0460,81,169,250,35,285,783,36.4%,10.34%,1
臺南市,南化區,0461,59,137,196,10,206,425,48.47%,13.88%,1
臺南市,南化區,0462,69,178,247,29,276,559,49.37%,12.34%,1
臺南市,南化區,0463,155,349,504,24,528,1189,44.41%,13.04%,1
臺南市,南化區,0464,135,365,500,43,543,1044,52.01%,12.93%,1
臺南市,南化區,0465,123,334,457,29,486,941,51.65%,13.07%,1
臺南市,左鎮區,0482,39,124,163,26,189,392,48.21%,9.95%,1
臺南市,左鎮區,0483,78,220,298,40,338,644,52.48%,12.11%,1
臺南市,左鎮區,0484,47,124,171,15,186,468,39.74%,10.04%,1
臺南市,左鎮區,0485,69,216,285,42,327,753,43.43%,9.16%,1
臺南市,左鎮區,0486,33,112,145,14,159,345,46.09%,9.57%,1
臺南市,左鎮區,0487,48,106,154,16,170,393,43.26%,12.21%,1
臺南市,左鎮區,0488,43,142,185,18,203,420,48.33%,10.24%,1
臺南市,左鎮區,0489,26,82,108,12,120,313,38.34%,8.31%,1
臺南市,左鎮區,0490,13,52,65,3,68,186,36.56%,6.99%,1
臺南市,左鎮區,0491,51,130,181,45,226,504,44.84%,10.12%,1
臺南市,仁德區,1188,226,454,680,51,731,1318,55.46%,17.15%,1
臺南市,仁德區,1189,230,492,722,47,769,1406,54.69%,16.36%,1
臺南市,仁德區,1190,215,498,713,53,766,1465,52.29%,14.68%,1
臺南市,仁德區,1191,237,436,673,47,720,1192,60.4%,19.88%,1
臺南市,仁德區,1192,239,530,769,54,823,1429,57.59%,16.72%,1
臺南市,仁德區,1193,234,411,645,78,723,1320,54.77%,17.73%,1
臺南市,仁德區,1194,234,536,770,63,833,1373,60.67%,17.04%,1
臺南市,仁德區,1195,203,526,729,40,769,1330,57.82%,15.26%,1
臺南市,仁德區,1196,339,577,916,31,947,1687,56.14%,20.09%,1
臺南市,仁德區,1197,247,453,700,56,756,1491,50.7%,16.57%,1
臺南市,仁德區,1198,149,370,519,25,544,1151,47.26%,12.95%,1
臺南市,仁德區,1199,211,499,710,18,728,1407,51.74%,15%,1
臺南市,仁德區,1200,239,548,787,44,831,1465,56.72%,16.31%,1
臺南市,仁德區,1201,239,493,732,26,758,1335,56.78%,17.9%,1
臺南市,仁德區,1202,240,501,741,47,788,1490,52.89%,16.11%,1
臺南市,仁德區,1203,263,548,811,42,853,1453,58.71%,18.1%,1
臺南市,仁德區,1204,158,329,487,19,506,990,51.11%,15.96%,1
臺南市,仁德區,1205,243,600,843,45,888,1573,56.45%,15.45%,1
臺南市,仁德區,1206,150,372,522,47,569,1031,55.19%,14.55%,1
臺南市,仁德區,1207,189,427,616,29,645,1194,54.02%,15.83%,1
臺南市,仁德區,1208,206,410,616,37,653,1268,51.5%,16.25%,1
臺南市,仁德區,1209,178,318,496,31,527,929,56.73%,19.16%,1
臺南市,仁德區,1210,175,358,533,11,544,1145,47.51%,15.28%,1
臺南市,仁德區,1211,241,462,703,38,741,1413,52.44%,17.06%,1
臺南市,仁德區,1212,229,479,708,79,787,1465,53.72%,15.63%,1
臺南市,仁德區,1213,251,503,754,41,795,1390,57.19%,18.06%,1
臺南市,仁德區,1214,233,470,703,63,766,1396,54.87%,16.69%,1
臺南市,仁德區,1215,343,610,953,45,998,1906,52.36%,18%,1
臺南市,仁德區,1216,227,521,748,25,773,1546,50%,14.68%,1
臺南市,仁德區,1217,228,441,669,26,695,1546,44.95%,14.75%,1
臺南市,仁德區,1218,228,480,708,41,749,1399,53.54%,16.3%,1
臺南市,仁德區,1219,303,547,850,79,929,1748,53.15%,17.33%,1
臺南市,仁德區,1220,192,422,614,22,636,1140,55.79%,16.84%,1
臺南市,仁德區,1221,203,436,639,25,664,1277,52%,15.9%,1
臺南市,仁德區,1222,188,423,611,36,647,1019,63.49%,18.45%,1
臺南市,仁德區,1223,210,465,675,31,706,1414,49.93%,14.85%,1
臺南市,仁德區,1224,198,416,614,18,632,1349,46.85%,14.68%,1
臺南市,仁德區,1225,232,487,719,18,737,1471,50.1%,15.77%,1
臺南市,仁德區,1226,221,453,674,22,696,1324,52.57%,16.69%,1
臺南市,仁德區,1227,158,431,589,49,638,1310,48.7%,12.06%,1
臺南市,仁德區,1228,106,182,288,23,311,554,56.14%,19.13%,1
臺南市,仁德區,1229,171,549,720,30,750,1395,53.76%,12.26%,1
臺南市,仁德區,1230,187,440,627,17,644,1264,50.95%,14.79%,1
臺南市,仁德區,1231,184,394,578,62,640,1180,54.24%,15.59%,1
臺南市,仁德區,1232,135,287,422,26,448,928,48.28%,14.55%,1
臺南市,仁德區,1233,152,290,442,15,457,965,47.36%,15.75%,1
臺南市,仁德區,1234,181,355,536,29,565,1119,50.49%,16.18%,1
臺南市,仁德區,1235,175,432,607,50,657,1206,54.48%,14.51%,1
臺南市,仁德區,1236,222,469,691,35,726,1466,49.52%,15.14%,1
臺南市,歸仁區,1237,235,523,758,51,809,1560,51.86%,15.06%,1
臺南市,歸仁區,1238,253,537,790,47,837,1383,60.52%,18.29%,1
臺南市,歸仁區,1239,257,502,759,32,791,1491,53.05%,17.24%,1
臺南市,歸仁區,1240,234,475,709,45,754,1482,50.88%,15.79%,1
臺南市,歸仁區,1241,230,464,694,23,717,1330,53.91%,17.29%,1
臺南市,歸仁區,1242,268,479,747,41,788,1399,56.33%,19.16%,1
臺南市,歸仁區,1243,245,433,678,35,713,1416,50.35%,17.3%,1
臺南市,歸仁區,1244,186,364,550,34,584,1336,43.71%,13.92%,1
臺南市,歸仁區,1245,176,361,537,52,589,1183,49.79%,14.88%,1
臺南市,歸仁區,1246,205,376,581,25,606,1237,48.99%,16.57%,1
臺南市,歸仁區,1247,206,385,591,45,636,1133,56.13%,18.18%,1
臺南市,歸仁區,1248,197,364,561,34,595,1149,51.78%,17.15%,1
臺南市,歸仁區,1249,177,378,555,9,564,1105,51.04%,16.02%,1
臺南市,歸仁區,1250,199,365,564,38,602,1099,54.78%,18.11%,1
臺南市,歸仁區,1251,175,395,570,64,634,1082,58.6%,16.17%,1
臺南市,歸仁區,1252,557,247,804,41,845,1519,55.63%,36.67%,1
臺南市,歸仁區,1253,267,535,802,39,841,1467,57.33%,18.2%,1
臺南市,歸仁區,1254,185,352,537,37,574,1090,52.66%,16.97%,1
臺南市,歸仁區,1255,186,376,562,24,586,1131,51.81%,16.45%,1
臺南市,歸仁區,1256,169,360,529,27,556,1080,51.48%,15.65%,1
臺南市,歸仁區,1257,158,336,494,24,518,1121,46.21%,14.09%,1
臺南市,歸仁區,1258,226,445,671,54,725,1336,54.27%,16.92%,1
臺南市,歸仁區,1259,189,376,565,52,617,1128,54.7%,16.76%,1
臺南市,歸仁區,1260,168,371,539,18,557,1055,52.8%,15.92%,1
臺南市,歸仁區,1261,174,383,557,32,589,1102,53.45%,15.79%,1
臺南市,歸仁區,1262,185,373,558,33,591,1068,55.34%,17.32%,1
臺南市,歸仁區,1263,185,365,550,43,593,1033,57.41%,17.91%,1
臺南市,歸仁區,1264,240,476,716,19,735,1772,41.48%,13.54%,1
臺南市,歸仁區,1265,235,475,710,62,772,1399,55.18%,16.8%,1
臺南市,歸仁區,1266,282,526,808,21,829,1544,53.69%,18.26%,1
臺南市,歸仁區,1267,89,210,299,10,309,684,45.18%,13.01%,1
臺南市,歸仁區,1268,164,312,476,28,504,839,60.07%,19.55%,1
臺南市,歸仁區,1269,215,333,548,48,596,1014,58.78%,21.2%,1
臺南市,歸仁區,1270,241,450,691,22,713,1906,37.41%,12.64%,1
臺南市,歸仁區,1271,213,468,681,34,715,1245,57.43%,17.11%,1
臺南市,歸仁區,1272,170,360,530,27,557,1048,53.15%,16.22%,1
臺南市,歸仁區,1273,185,409,594,18,612,1175,52.09%,15.74%,1
臺南市,歸仁區,1274,228,436,664,26,690,1411,48.9%,16.16%,1
臺南市,歸仁區,1275,288,530,818,38,856,1514,56.54%,19.02%,1
臺南市,歸仁區,1276,306,541,847,57,904,1678,53.87%,18.24%,1
臺南市,歸仁區,1277,166,329,495,27,522,949,55.01%,17.49%,1
臺南市,歸仁區,1278,173,386,559,44,603,1009,59.76%,17.15%,1
臺南市,歸仁區,1279,217,385,602,3,605,984,61.48%,22.05%,1
臺南市,歸仁區,1280,126,300,426,26,452,756,59.79%,16.67%,1
臺南市,歸仁區,1281,277,560,837,43,880,1478,59.54%,18.74%,1
臺南市,歸仁區,1282,278,541,819,51,870,1467,59.3%,18.95%,1
臺南市,關廟區,1283,172,327,499,23,522,982,53.16%,17.52%,1
臺南市,關廟區,1284,216,439,655,34,689,1156,59.6%,18.69%,1
臺南市,關廟區,1285,130,341,471,22,493,1006,49.01%,12.92%,1
臺南市,關廟區,1286,203,385,588,45,633,1043,60.69%,19.46%,1
臺南市,關廟區,1287,179,339,518,69,587,1012,58%,17.69%,1
臺南市,關廟區,1288,101,351,452,15,467,1013,46.1%,9.97%,1
臺南市,關廟區,1289,194,423,617,27,644,1294,49.77%,14.99%,1
臺南市,關廟區,1290,195,390,585,48,633,1264,50.08%,15.43%,1
臺南市,關廟區,1291,185,407,592,31,623,1166,53.43%,15.87%,1
臺南市,關廟區,1292,173,315,488,17,505,1018,49.61%,16.99%,1
臺南市,關廟區,1293,92,215,307,36,343,733,46.79%,12.55%,1
臺南市,關廟區,1294,160,456,616,27,643,1093,58.83%,14.64%,1
臺南市,關廟區,1295,169,400,569,37,606,1081,56.06%,15.63%,1
臺南市,關廟區,1296,162,372,534,41,575,978,58.79%,16.56%,1
臺南市,關廟區,1297,169,336,505,25,530,1116,47.49%,15.14%,1
臺南市,關廟區,1298,123,361,484,37,521,972,53.6%,12.65%,1
臺南市,關廟區,1299,175,366,541,64,605,1045,57.89%,16.75%,1
臺南市,關廟區,1300,165,281,446,25,471,872,54.01%,18.92%,1
臺南市,關廟區,1301,174,375,549,40,589,1007,58.49%,17.28%,1
臺南市,關廟區,1302,133,290,423,34,457,763,59.9%,17.43%,1
臺南市,關廟區,1303,94,211,305,29,334,630,53.02%,14.92%,1
臺南市,關廟區,1304,151,344,495,60,555,959,57.87%,15.75%,1
臺南市,關廟區,1305,164,397,561,27,588,1123,52.36%,14.6%,1
臺南市,關廟區,1306,126,272,398,62,460,804,57.21%,15.67%,1
臺南市,關廟區,1307,117,233,350,12,362,720,50.28%,16.25%,1
臺南市,關廟區,1308,107,260,367,22,389,843,46.14%,12.69%,1
臺南市,關廟區,1309,43,120,163,12,175,358,48.88%,12.01%,1
臺南市,關廟區,1310,106,271,377,51,428,797,53.7%,13.3%,1
臺南市,關廟區,1311,76,223,299,18,317,709,44.71%,10.72%,1
臺南市,關廟區,1312,127,270,397,17,414,904,45.8%,14.05%,1
臺南市,關廟區,1313,140,344,484,21,505,963,52.44%,14.54%,1
臺南市,關廟區,1314,95,170,265,11,276,489,56.44%,19.43%,1
臺南市,龍崎區,1315,158,321,479,56,535,1047,51.1%,15.09%,1
臺南市,龍崎區,1316,74,217,291,16,307,630,48.73%,11.75%,1
臺南市,龍崎區,1317,16,37,53,4,57,141,40.43%,11.35%,1
臺南市,龍崎區,1318,47,120,167,13,180,367,49.05%,12.81%,1
臺南市,龍崎區,1319,52,115,167,16,183,337,54.3%,15.43%,1
臺南市,龍崎區,1320,41,96,137,6,143,318,44.97%,12.89%,1
臺南市,龍崎區,1321,45,150,195,19,214,427,50.12%,10.54%,1
臺南市,龍崎區,1322,50,124,174,21,195,446,43.72%,11.21%,1
臺南市,永康區,0708,253,454,707,56,763,1398,54.58%,18.1%,1
臺南市,永康區,0709,227,409,636,29,665,1478,44.99%,15.36%,1
臺南市,永康區,0710,262,443,705,17,722,1442,50.07%,18.17%,1
臺南市,永康區,0711,186,452,638,29,667,1353,49.3%,13.75%,1
臺南市,永康區,0712,192,389,581,23,604,1160,52.07%,16.55%,1
臺南市,永康區,0713,196,394,590,32,622,1122,55.44%,17.47%,1
臺南市,永康區,0714,192,383,575,13,588,1165,50.47%,16.48%,1
臺南市,永康區,0715,236,390,626,32,658,1317,49.96%,17.92%,1
臺南市,永康區,0716,206,466,672,34,706,1376,51.31%,14.97%,1
臺南市,永康區,0717,252,452,704,25,729,1361,53.56%,18.52%,1
臺南市,永康區,0718,301,481,782,20,802,1374,58.37%,21.91%,1
臺南市,永康區,0719,265,519,784,51,835,1709,48.86%,15.51%,1
臺南市,永康區,0720,270,524,794,42,836,1717,48.69%,15.73%,1
臺南市,永康區,0721,269,537,806,41,847,1759,48.15%,15.29%,1
臺南市,永康區,0722,279,538,817,36,853,1636,52.14%,17.05%,1
臺南市,永康區,0723,246,462,708,47,755,1442,52.36%,17.06%,1
臺南市,永康區,0724,261,483,744,31,775,1545,50.16%,16.89%,1
臺南市,永康區,0725,214,538,752,45,797,1565,50.93%,13.67%,1
臺南市,永康區,0726,275,506,781,34,815,1684,48.4%,16.33%,1
臺南市,永康區,0727,239,498,737,22,759,1548,49.03%,15.44%,1
臺南市,永康區,0728,237,498,735,28,763,1389,54.93%,17.06%,1
臺南市,永康區,0729,254,428,682,44,726,1369,53.03%,18.55%,1
臺南市,永康區,0730,216,497,713,60,773,1415,54.63%,15.27%,1
臺南市,永康區,0731,184,434,618,14,632,1386,45.6%,13.28%,1
臺南市,永康區,0732,115,299,414,6,420,1747,24.04%,6.58%,1
臺南市,永康區,0733,253,476,729,40,769,1485,51.78%,17.04%,1
臺南市,永康區,0734,291,542,833,58,891,1747,51%,16.66%,1
臺南市,永康區,0735,264,487,751,45,796,1744,45.64%,15.14%,1
臺南市,永康區,0736,257,557,814,38,852,1797,47.41%,14.3%,1
臺南市,永康區,0737,306,609,915,51,966,1800,53.67%,17%,1
臺南市,永康區,0738,244,568,812,20,832,1720,48.37%,14.19%,1
臺南市,永康區,0739,305,580,885,34,919,1708,53.81%,17.86%,1
臺南市,永康區,0740,265,560,825,25,850,1519,55.96%,17.45%,1
臺南市,永康區,0741,224,558,782,59,841,1497,56.18%,14.96%,1
臺南市,永康區,0742,224,557,781,28,809,1509,53.61%,14.84%,1
臺南市,永康區,0743,263,585,848,61,909,1542,58.95%,17.06%,1
臺南市,永康區,0744,321,497,818,22,840,1536,54.69%,20.9%,1
臺南市,永康區,0745,298,487,785,38,823,1531,53.76%,19.46%,1
臺南市,永康區,0746,249,483,732,33,765,1327,57.65%,18.76%,1
臺南市,永康區,0747,252,489,741,19,760,1456,52.2%,17.31%,1
臺南市,永康區,0748,291,467,758,20,778,1396,55.73%,20.85%,1
臺南市,永康區,0749,271,535,806,41,847,1636,51.77%,16.56%,1
臺南市,永康區,0750,318,509,827,36,863,1592,54.21%,19.97%,1
臺南市,永康區,0751,406,538,944,16,960,2017,47.6%,20.13%,1
臺南市,永康區,0752,117,239,356,13,369,672,54.91%,17.41%,1
臺南市,永康區,0753,259,490,749,21,770,1611,47.8%,16.08%,1
臺南市,永康區,0754,291,466,757,36,793,1502,52.8%,19.37%,1
臺南市,永康區,0755,272,450,722,20,742,1660,44.7%,16.39%,1
臺南市,永康區,0756,269,395,664,27,691,1561,44.27%,17.23%,1
臺南市,永康區,0757,269,481,750,27,777,1590,48.87%,16.92%,1
臺南市,永康區,0758,186,280,466,17,483,924,52.27%,20.13%,1
臺南市,永康區,0759,183,334,517,28,545,938,58.1%,19.51%,1
臺南市,永康區,0760,182,335,517,24,541,957,56.53%,19.02%,1
臺南市,永康區,0761,91,159,250,27,277,496,55.85%,18.35%,1
臺南市,永康區,0762,299,544,843,66,909,1717,52.94%,17.41%,1
臺南市,永康區,0763,244,484,728,40,768,1615,47.55%,15.11%,1
臺南市,永康區,0764,232,516,748,25,773,1554,49.74%,14.93%,1
臺南市,永康區,0765,182,395,577,24,601,1196,50.25%,15.22%,1
臺南市,永康區,0766,227,415,642,27,669,1274,52.51%,17.82%,1
臺南市,永康區,0767,221,406,627,26,653,1215,53.74%,18.19%,1
臺南市,永康區,0768,246,497,743,18,761,1457,52.23%,16.88%,1
臺南市,永康區,0769,255,501,756,26,782,1451,53.89%,17.57%,1
臺南市,永康區,0770,230,424,654,36,690,1423,48.49%,16.16%,1
臺南市,永康區,0771,222,506,728,29,757,1394,54.3%,15.93%,1
臺南市,永康區,0772,155,317,472,45,517,890,58.09%,17.42%,1
臺南市,永康區,0773,208,374,582,33,615,1018,60.41%,20.43%,1
臺南市,永康區,0774,61,135,196,19,215,368,58.42%,16.58%,1
臺南市,永康區,0775,208,475,683,37,720,1208,59.6%,17.22%,1
臺南市,永康區,0776,210,353,563,36,599,1187,50.46%,17.69%,1
臺南市,永康區,0777,239,436,675,25,700,1381,50.69%,17.31%,1
臺南市,永康區,0778,237,457,694,39,733,1405,52.17%,16.87%,1
臺南市,永康區,0779,241,422,663,64,727,1445,50.31%,16.68%,1
臺南市,永康區,0780,301,509,810,42,852,1687,50.5%,17.84%,1
臺南市,永康區,0781,237,433,670,31,701,1535,45.67%,15.44%,1
臺南市,永康區,0782,256,542,798,39,837,1542,54.28%,16.6%,1
臺南市,永康區,0783,262,541,803,32,835,1618,51.61%,16.19%,1
臺南市,永康區,0784,239,481,720,22,742,1338,55.46%,17.86%,1
臺南市,永康區,0785,229,449,678,65,743,1285,57.82%,17.82%,1
臺南市,永康區,0786,200,420,620,28,648,1240,52.26%,16.13%,1
臺南市,永康區,0787,207,425,632,46,678,1343,50.48%,15.41%,1
臺南市,永康區,0788,252,480,732,34,766,1327,57.72%,18.99%,1
臺南市,永康區,0789,269,515,784,33,817,1565,52.2%,17.19%,1
臺南市,永康區,0790,256,497,753,69,822,1476,55.69%,17.34%,1
臺南市,永康區,0791,256,478,734,39,773,1476,52.37%,17.34%,1
臺南市,永康區,0792,279,526,805,38,843,1463,57.62%,19.07%,1
臺南市,永康區,0793,182,322,504,72,576,983,58.6%,18.51%,1
臺南市,永康區,0794,188,412,600,53,653,1116,58.51%,16.85%,1
臺南市,永康區,0795,180,357,537,55,592,1117,53%,16.11%,1
臺南市,永康區,0796,171,327,498,25,523,1069,48.92%,16%,1
臺南市,永康區,0797,217,441,658,39,697,1180,59.07%,18.39%,1
臺南市,永康區,0798,176,394,570,78,648,1176,55.1%,14.97%,1
臺南市,永康區,0799,208,363,571,37,608,1158,52.5%,17.96%,1
臺南市,永康區,0800,216,444,660,51,711,1208,58.86%,17.88%,1
臺南市,永康區,0801,255,492,747,60,807,1501,53.76%,16.99%,1
臺南市,永康區,0802,229,485,714,27,741,1298,57.09%,17.64%,1
臺南市,永康區,0803,275,514,789,26,815,1542,52.85%,17.83%,1
臺南市,永康區,0804,298,532,830,32,862,1537,56.08%,19.39%,1
臺南市,永康區,0805,281,501,782,44,826,1359,60.78%,20.68%,1
臺南市,永康區,0806,172,332,504,35,539,1139,47.32%,15.1%,1
臺南市,永康區,0807,174,366,540,34,574,1158,49.57%,15.03%,1
臺南市,永康區,0808,263,465,728,55,783,1538,50.91%,17.1%,1
臺南市,永康區,0809,158,400,558,22,580,1166,49.74%,13.55%,1
臺南市,永康區,0810,204,394,598,25,623,1228,50.73%,16.61%,1
臺南市,永康區,0811,213,431,644,41,685,1200,57.08%,17.75%,1
臺南市,永康區,0812,231,380,611,29,640,1131,56.59%,20.42%,1
臺南市,永康區,0813,214,380,594,21,615,1147,53.62%,18.66%,1
臺南市,永康區,0814,231,455,686,47,733,1442,50.83%,16.02%,1
臺南市,永康區,0815,238,408,646,27,673,1325,50.79%,17.96%,1
臺南市,永康區,0816,190,378,568,31,599,1260,47.54%,15.08%,1
臺南市,永康區,0817,238,508,746,55,801,1631,49.11%,14.59%,1
臺南市,永康區,0818,243,493,736,34,770,1549,49.71%,15.69%,1
臺南市,永康區,0819,269,538,807,26,833,1666,50%,16.15%,1
臺南市,永康區,0820,130,324,454,43,497,1012,49.11%,12.85%,1
臺南市,永康區,0821,127,312,439,15,454,976,46.52%,13.01%,1
臺南市,永康區,0822,79,199,278,11,289,531,54.43%,14.88%,1
臺南市,永康區,0823,140,312,452,34,486,859,56.58%,16.3%,1
臺南市,永康區,0824,172,269,441,30,471,937,50.27%,18.36%,1
臺南市,永康區,0825,207,459,666,38,704,1307,53.86%,15.84%,1
臺南市,永康區,0826,212,418,630,18,648,1482,43.72%,14.3%,1
臺南市,永康區,0827,200,409,609,22,631,1341,47.05%,14.91%,1
臺南市,永康區,0828,242,420,662,39,701,1376,50.94%,17.59%,1
臺南市,永康區,0829,217,440,657,35,692,1390,49.78%,15.61%,1
臺南市,永康區,0830,263,536,799,35,834,1534,54.37%,17.14%,1
臺南市,永康區,0831,233,539,772,34,806,1460,55.21%,15.96%,1
臺南市,永康區,0832,214,475,689,16,705,1383,50.98%,15.47%,1
臺南市,永康區,0833,229,335,564,35,599,1299,46.11%,17.63%,1
臺南市,永康區,0834,223,457,680,20,700,1264,55.38%,17.64%,1
臺南市,永康區,0835,266,474,740,32,772,1355,56.97%,19.63%,1
臺南市,永康區,0836,236,449,685,20,705,1414,49.86%,16.69%,1
臺南市,永康區,0837,206,398,604,23,627,1109,56.54%,18.58%,1
臺南市,永康區,0838,160,394,554,35,589,1151,51.17%,13.9%,1
臺南市,永康區,0839,214,408,622,38,660,1026,64.33%,20.86%,1
臺南市,永康區,0840,147,382,529,24,553,1071,51.63%,13.73%,1
臺南市,永康區,0841,258,567,825,47,872,1387,62.87%,18.6%,1
臺南市,永康區,0842,279,503,782,32,814,1377,59.11%,20.26%,1
臺南市,永康區,0843,269,587,856,51,907,1687,53.76%,15.95%,1
臺南市,永康區,0844,391,411,802,36,838,1700,49.29%,23%,1
臺南市,永康區,0845,247,527,774,25,799,1444,55.33%,17.11%,1
臺南市,永康區,0846,236,490,726,35,761,1485,51.25%,15.89%,1
臺南市,永康區,0847,242,544,786,37,823,1717,47.93%,14.09%,1
臺南市,永康區,0848,289,472,761,40,801,1701,47.09%,16.99%,1
臺南市,永康區,0849,222,470,692,15,707,1382,51.16%,16.06%,1
臺南市,東區,1095,325,705,1030,40,1070,2681,39.91%,12.12%,1
臺南市,東區,1096,338,581,919,38,957,1811,52.84%,18.66%,1
臺南市,東區,1097,296,583,879,59,938,1491,62.91%,19.85%,1
臺南市,東區,1098,256,467,723,32,755,1378,54.79%,18.58%,1
臺南市,東區,1099,323,530,853,42,895,1552,57.67%,20.81%,1
臺南市,東區,1100,248,511,759,14,773,1326,58.3%,18.7%,1
臺南市,東區,1101,305,552,857,44,901,1594,56.52%,19.13%,1
臺南市,東區,1102,327,585,912,36,948,1639,57.84%,19.95%,1
臺南市,東區,1103,328,570,898,45,943,1724,54.7%,19.03%,1
臺南市,東區,1104,275,576,851,57,908,1629,55.74%,16.88%,1
臺南市,東區,1105,292,471,763,23,786,1399,56.18%,20.87%,1
臺南市,東區,1106,293,527,820,32,852,1534,55.54%,19.1%,1
臺南市,東區,1107,380,529,909,27,936,1656,56.52%,22.95%,1
臺南市,東區,1108,222,471,693,38,731,1322,55.3%,16.79%,1
臺南市,東區,1109,310,551,861,27,888,1620,54.81%,19.14%,1
臺南市,東區,1110,266,521,787,28,815,1331,61.23%,19.98%,1
臺南市,東區,1111,162,402,564,35,599,1039,57.65%,15.59%,1
臺南市,東區,1112,194,420,614,27,641,1257,50.99%,15.43%,1
臺南市,東區,1113,326,667,993,70,1063,2067,51.43%,15.77%,1
臺南市,東區,1114,333,805,1138,26,1164,2153,54.06%,15.47%,1
臺南市,東區,1115,399,803,1202,44,1246,2363,52.73%,16.89%,1
臺南市,東區,1116,222,517,739,44,783,1427,54.87%,15.56%,1
臺南市,東區,1117,288,574,862,38,900,1555,57.88%,18.52%,1
臺南市,東區,1118,306,622,928,41,969,2115,45.82%,14.47%,1
臺南市,東區,1119,400,709,1109,53,1162,2340,49.66%,17.09%,1
臺南市,東區,1120,449,930,1379,36,1415,2474,57.19%,18.15%,1
臺南市,東區,1121,377,812,1189,51,1240,2391,51.86%,15.77%,1
臺南市,東區,1122,331,574,905,26,931,1673,55.65%,19.78%,1
臺南市,東區,1123,287,538,825,38,863,1594,54.14%,18.01%,1
臺南市,東區,1124,289,581,870,50,920,1607,57.25%,17.98%,1
臺南市,東區,1125,431,753,1184,25,1209,2087,57.93%,20.65%,1
臺南市,東區,1126,449,861,1310,29,1339,2369,56.52%,18.95%,1
臺南市,東區,1127,275,572,847,65,912,1696,53.77%,16.21%,1
臺南市,東區,1128,295,568,863,34,897,1612,55.65%,18.3%,1
臺南市,東區,1129,302,556,858,36,894,1708,52.34%,17.68%,1
臺南市,東區,1130,284,544,828,32,860,1560,55.13%,18.21%,1
臺南市,東區,1131,350,601,951,50,1001,1854,53.99%,18.88%,1
臺南市,東區,1132,396,699,1095,36,1131,2278,49.65%,17.38%,1
臺南市,東區,1133,376,685,1061,32,1093,2093,52.22%,17.96%,1
臺南市,東區,1134,431,809,1240,36,1276,2242,56.91%,19.22%,1
臺南市,東區,1135,234,427,661,35,696,1152,60.42%,20.31%,1
臺南市,東區,1136,269,504,773,21,794,1318,60.24%,20.41%,1
臺南市,東區,1137,432,760,1192,41,1233,2200,56.05%,19.64%,1
臺南市,東區,1138,405,708,1113,31,1144,1960,58.37%,20.66%,1
臺南市,東區,1139,277,494,771,41,812,1489,54.53%,18.6%,1
臺南市,東區,1140,282,463,745,50,795,1443,55.09%,19.54%,1
臺南市,東區,1141,343,536,879,32,911,1498,60.81%,22.9%,1
臺南市,東區,1142,306,585,891,19,910,1622,56.1%,18.87%,1
臺南市,東區,1143,341,603,944,25,969,1738,55.75%,19.62%,1
臺南市,東區,1144,284,468,752,42,794,1501,52.9%,18.92%,1
臺南市,東區,1145,248,554,802,36,838,1482,56.55%,16.73%,1
臺南市,東區,1146,297,568,865,37,902,1829,49.32%,16.24%,1
臺南市,東區,1147,365,554,919,42,961,1764,54.48%,20.69%,1
臺南市,東區,1148,251,553,804,29,833,1427,58.37%,17.59%,1
臺南市,東區,1149,261,464,725,47,772,1427,54.1%,18.29%,1
臺南市,東區,1150,258,485,743,39,782,1388,56.34%,18.59%,1
臺南市,東區,1151,271,402,673,22,695,1131,61.45%,23.96%,1
臺南市,東區,1152,176,344,520,27,547,1000,54.7%,17.6%,1
臺南市,東區,1153,161,373,534,20,554,996,55.62%,16.16%,1
臺南市,東區,1154,148,329,477,25,502,935,53.69%,15.83%,1
臺南市,東區,1155,186,320,506,40,546,947,57.66%,19.64%,1
臺南市,東區,1156,225,355,580,15,595,1090,54.59%,20.64%,1
臺南市,東區,1157,157,287,444,38,482,896,53.79%,17.52%,1
臺南市,東區,1158,298,533,831,25,856,1589,53.87%,18.75%,1
臺南市,東區,1159,302,514,816,36,852,1497,56.91%,20.17%,1
臺南市,東區,1160,232,458,690,40,730,1386,52.67%,16.74%,1
臺南市,東區,1161,190,412,602,15,617,1101,56.04%,17.26%,1
臺南市,東區,1162,258,461,719,54,773,1332,58.03%,19.37%,1
臺南市,東區,1163,218,425,643,31,674,1185,56.88%,18.4%,1
臺南市,東區,1164,221,485,706,41,747,1262,59.19%,17.51%,1
臺南市,東區,1165,217,510,727,47,774,1517,51.02%,14.3%,1
臺南市,東區,1166,222,429,651,64,715,1287,55.56%,17.25%,1
臺南市,東區,1167,318,558,876,47,923,1657,55.7%,19.19%,1
臺南市,東區,1168,395,759,1154,62,1216,2238,54.33%,17.65%,1
臺南市,東區,1169,413,723,1136,43,1179,2246,52.49%,18.39%,1
臺南市,東區,1170,387,731,1118,41,1159,2191,52.9%,17.66%,1
臺南市,東區,1171,368,684,1052,42,1094,2063,53.03%,17.84%,1
臺南市,東區,1172,403,789,1192,68,1260,2177,57.88%,18.51%,1
臺南市,東區,1173,334,712,1046,42,1088,1863,58.4%,17.93%,1
臺南市,東區,1174,292,883,1175,39,1214,2185,55.56%,13.36%,1
臺南市,東區,1175,260,537,797,35,832,1721,48.34%,15.11%,1
臺南市,東區,1176,266,521,787,77,864,1556,55.53%,17.1%,1
臺南市,東區,1177,312,570,882,38,920,1602,57.43%,19.48%,1
臺南市,東區,1178,250,508,758,50,808,1523,53.05%,16.41%,1
臺南市,東區,1179,242,433,675,33,708,1382,51.23%,17.51%,1
臺南市,東區,1180,266,507,773,30,803,1486,54.04%,17.9%,1
臺南市,東區,1181,298,538,836,43,879,1560,56.35%,19.1%,1
臺南市,東區,1182,293,493,786,55,841,1684,49.94%,17.4%,1
臺南市,東區,1183,331,549,880,37,917,1653,55.47%,20.02%,1
臺南市,東區,1184,342,504,846,12,858,1554,55.21%,22.01%,1
臺南市,東區,1185,298,485,783,19,802,1408,56.96%,21.16%,1
臺南市,東區,1186,367,793,1160,33,1193,2084,57.25%,17.61%,1
臺南市,東區,1187,395,604,999,32,1031,1896,54.38%,20.83%,1
臺南市,南區,1015,221,439,660,43,703,1221,57.58%,18.1%,1
臺南市,南區,1016,304,648,952,61,1013,2171,46.66%,14%,1
臺南市,南區,1017,200,427,627,32,659,1150,57.3%,17.39%,1
臺南市,南區,1018,197,419,616,32,648,1122,57.75%,17.56%,1
臺南市,南區,1019,198,479,677,38,715,1444,49.52%,13.71%,1
臺南市,南區,1020,299,537,836,24,860,1765,48.73%,16.94%,1
臺南市,南區,1021,230,481,711,43,754,1298,58.09%,17.72%,1
臺南市,南區,1022,206,553,759,43,802,1458,55.01%,14.13%,1
臺南市,南區,1023,300,639,939,29,968,1940,49.9%,15.46%,1
臺南市,南區,1024,265,555,820,50,870,1637,53.15%,16.19%,1
臺南市,南區,1025,147,239,386,10,396,871,45.46%,16.88%,1
臺南市,南區,1026,128,191,319,22,341,589,57.89%,21.73%,1
臺南市,南區,1027,168,319,487,42,529,801,66.04%,20.97%,1
臺南市,南區,1028,146,375,521,47,568,990,57.37%,14.75%,1
臺南市,南區,1029,200,507,707,35,742,1222,60.72%,16.37%,1
臺南市,南區,1030,187,354,541,58,599,997,60.08%,18.76%,1
臺南市,南區,1031,200,389,589,26,615,1204,51.08%,16.61%,1
臺南市,南區,1032,265,451,716,31,747,1570,47.58%,16.88%,1
臺南市,南區,1033,235,400,635,43,678,1222,55.48%,19.23%,1
臺南市,南區,1034,181,338,519,16,535,1076,49.72%,16.82%,1
臺南市,南區,1035,212,389,601,21,622,1127,55.19%,18.81%,1
臺南市,南區,1036,214,385,599,40,639,1135,56.3%,18.85%,1
臺南市,南區,1037,207,412,619,51,670,1263,53.05%,16.39%,1
臺南市,南區,1038,170,326,496,23,519,1014,51.18%,16.77%,1
臺南市,南區,1039,246,544,790,48,838,1491,56.2%,16.5%,1
臺南市,南區,1040,324,600,924,47,971,1815,53.5%,17.85%,1
臺南市,南區,1041,254,454,708,19,727,1398,52%,18.17%,1
臺南市,南區,1042,285,602,887,31,918,2107,43.57%,13.53%,1
臺南市,南區,1043,299,605,904,44,948,1587,59.74%,18.84%,1
臺南市,南區,1044,269,555,824,53,877,1626,53.94%,16.54%,1
臺南市,南區,1045,282,549,831,38,869,1761,49.35%,16.01%,1
臺南市,南區,1046,301,515,816,53,869,1630,53.31%,18.47%,1
臺南市,南區,1047,255,532,787,46,833,1542,54.02%,16.54%,1
臺南市,南區,1048,268,436,704,75,779,1464,53.21%,18.31%,1
臺南市,南區,1049,249,578,827,84,911,1727,52.75%,14.42%,1
臺南市,南區,1050,213,391,604,52,656,1085,60.46%,19.63%,1
臺南市,南區,1051,147,321,468,22,490,939,52.18%,15.65%,1
臺南市,南區,1052,193,427,620,62,682,1419,48.06%,13.6%,1
臺南市,南區,1053,218,414,632,38,670,1333,50.26%,16.35%,1
臺南市,南區,1054,249,445,694,44,738,1465,50.38%,17%,1
臺南市,南區,1055,196,371,567,26,593,1099,53.96%,17.83%,1
臺南市,南區,1056,166,373,539,22,561,1133,49.51%,14.65%,1
臺南市,南區,1057,192,450,642,73,715,1375,52%,13.96%,1
臺南市,南區,1058,282,510,792,28,820,1781,46.04%,15.83%,1
臺南市,南區,1059,264,571,835,41,876,1542,56.81%,17.12%,1
臺南市,南區,1060,219,474,693,35,728,1486,48.99%,14.74%,1
臺南市,南區,1061,264,589,853,62,915,1640,55.79%,16.1%,1
臺南市,南區,1062,241,492,733,39,772,1701,45.39%,14.17%,1
臺南市,南區,1063,215,484,699,58,757,1541,49.12%,13.95%,1
臺南市,南區,1064,308,627,935,89,1024,2027,50.52%,15.19%,1
臺南市,南區,1065,326,650,976,62,1038,1774,58.51%,18.38%,1
臺南市,南區,1066,253,531,784,52,836,1613,51.83%,15.69%,1
臺南市,南區,1067,252,568,820,22,842,1707,49.33%,14.76%,1
臺南市,南區,1068,180,388,568,22,590,1657,35.61%,10.86%,1
臺南市,南區,1069,174,377,551,33,584,1077,54.22%,16.16%,1
臺南市,南區,1070,203,394,597,36,633,1185,53.42%,17.13%,1
臺南市,南區,1071,226,391,617,41,658,1249,52.68%,18.09%,1
臺南市,南區,1072,268,592,860,32,892,1985,44.94%,13.5%,1
臺南市,南區,1073,310,560,870,48,918,2017,45.51%,15.37%,1
臺南市,南區,1074,269,504,773,79,852,1717,49.62%,15.67%,1
臺南市,南區,1075,168,328,496,28,524,929,56.4%,18.08%,1
臺南市,南區,1076,135,233,368,26,394,695,56.69%,19.42%,1
臺南市,南區,1077,124,329,453,23,476,997,47.74%,12.44%,1
臺南市,南區,1078,114,257,371,15,386,784,49.23%,14.54%,1
臺南市,南區,1079,142,450,592,61,653,1119,58.36%,12.69%,1
臺南市,南區,1080,155,301,456,23,479,1054,45.45%,14.71%,1
臺南市,南區,1081,194,379,573,72,645,1245,51.81%,15.58%,1
臺南市,南區,1082,284,638,922,46,968,2064,46.9%,13.76%,1
臺南市,南區,1083,279,532,811,27,838,2056,40.76%,13.57%,1
臺南市,南區,1084,194,422,616,26,642,1373,46.76%,14.13%,1
臺南市,南區,1085,139,294,433,32,465,1002,46.41%,13.87%,1
臺南市,南區,1086,142,245,387,56,443,760,58.29%,18.68%,1
臺南市,南區,1087,191,324,515,54,569,1031,55.19%,18.53%,1
臺南市,南區,1088,137,234,371,43,414,744,55.65%,18.41%,1
臺南市,南區,1089,219,369,588,59,647,1186,54.55%,18.47%,1
臺南市,南區,1090,243,447,690,54,744,1358,54.79%,17.89%,1
臺南市,南區,1091,120,280,400,29,429,897,47.83%,13.38%,1
臺南市,南區,1092,206,418,624,40,664,1265,52.49%,16.28%,1
臺南市,南區,1093,159,330,489,34,523,1093,47.85%,14.55%,1
臺南市,南區,1094,206,334,540,32,572,1016,56.3%,20.28%,1
臺南市,北區,0850,276,573,849,61,910,1793,50.75%,15.39%,1
臺南市,北區,0851,259,532,791,45,836,1708,48.95%,15.16%,1
臺南市,北區,0852,203,295,498,17,515,997,51.65%,20.36%,1
臺南市,北區,0853,267,368,635,19,654,1452,45.04%,18.39%,1
臺南市,北區,0854,254,408,662,22,684,1351,50.63%,18.8%,1
臺南市,北區,0855,262,523,785,44,829,1323,62.66%,19.8%,1
臺南市,北區,0856,171,424,595,20,615,1073,57.32%,15.94%,1
臺南市,北區,0857,208,433,641,23,664,1138,58.35%,18.28%,1
臺南市,北區,0858,195,419,614,20,634,1189,53.32%,16.4%,1
臺南市,北區,0859,256,483,739,31,770,1262,61.01%,20.29%,1
臺南市,北區,0860,206,385,591,19,610,1017,59.98%,20.26%,1
臺南市,北區,0861,163,291,454,13,467,847,55.14%,19.24%,1
臺南市,北區,0862,419,167,586,36,622,1076,57.81%,38.94%,1
臺南市,北區,0863,182,362,544,25,569,954,59.64%,19.08%,1
臺南市,北區,0864,188,453,641,52,693,1300,53.31%,14.46%,1
臺南市,北區,0865,195,508,703,32,735,1390,52.88%,14.03%,1
臺南市,北區,0866,215,497,712,32,744,1318,56.45%,16.31%,1
臺南市,北區,0867,160,340,500,16,516,974,52.98%,16.43%,1
臺南市,北區,0868,169,357,526,19,545,990,55.05%,17.07%,1
臺南市,北區,0869,223,382,605,20,625,1016,61.52%,21.95%,1
臺南市,北區,0870,179,386,565,26,591,1053,56.13%,17%,1
臺南市,北區,0871,252,461,713,52,765,1466,52.18%,17.19%,1
臺南市,北區,0872,300,500,800,53,853,1535,55.57%,19.54%,1
臺南市,北區,0873,216,547,763,52,815,1544,52.78%,13.99%,1
臺南市,北區,0874,292,642,934,49,983,1760,55.85%,16.59%,1
臺南市,北區,0875,234,446,680,24,704,1372,51.31%,17.06%,1
臺南市,北區,0876,184,378,562,25,587,1002,58.58%,18.36%,1
臺南市,北區,0877,207,441,648,32,680,1171,58.07%,17.68%,1
臺南市,北區,0878,194,418,612,23,635,1285,49.42%,15.1%,1
臺南市,北區,0879,138,373,511,34,545,1036,52.61%,13.32%,1
臺南市,北區,0880,222,485,707,41,748,1392,53.74%,15.95%,1
臺南市,北區,0881,180,425,605,35,640,1147,55.8%,15.69%,1
臺南市,北區,0882,202,464,666,26,692,1526,45.35%,13.24%,1
臺南市,北區,0883,264,531,795,34,829,1559,53.18%,16.93%,1
臺南市,北區,0884,143,323,466,48,514,892,57.62%,16.03%,1
臺南市,北區,0885,170,279,449,40,489,937,52.19%,18.14%,1
臺南市,北區,0886,272,504,776,59,835,1449,57.63%,18.77%,1
臺南市,北區,0887,213,374,587,28,615,1160,53.02%,18.36%,1
臺南市,北區,0888,207,351,558,37,595,1567,37.97%,13.21%,1
臺南市,北區,0889,234,435,669,46,715,1346,53.12%,17.38%,1
臺南市,北區,0890,251,429,680,15,695,1451,47.9%,17.3%,1
臺南市,北區,0891,270,473,743,40,783,1522,51.45%,17.74%,1
臺南市,北區,0892,198,441,639,24,663,1278,51.88%,15.49%,1
臺南市,北區,0893,177,384,561,45,606,1164,52.06%,15.21%,1
臺南市,北區,0894,192,315,507,20,527,1091,48.3%,17.6%,1
臺南市,北區,0895,161,334,495,23,518,993,52.17%,16.21%,1
臺南市,北區,0896,176,322,498,32,530,1119,47.36%,15.73%,1
臺南市,北區,0897,298,571,869,60,929,1685,55.13%,17.69%,1
臺南市,北區,0898,257,452,709,21,730,1368,53.36%,18.79%,1
臺南市,北區,0899,253,463,716,39,755,1389,54.36%,18.21%,1
臺南市,北區,0900,294,527,821,27,848,1469,57.73%,20.01%,1
臺南市,北區,0901,337,571,908,43,951,1655,57.46%,20.36%,1
臺南市,北區,0902,247,455,702,19,721,1261,57.18%,19.59%,1
臺南市,北區,0903,270,493,763,17,780,1490,52.35%,18.12%,1
臺南市,北區,0904,301,504,805,27,832,1436,57.94%,20.96%,1
臺南市,北區,0905,241,502,743,51,794,1340,59.25%,17.99%,1
臺南市,北區,0906,282,491,773,37,810,1464,55.33%,19.26%,1
臺南市,北區,0907,309,535,844,28,872,1513,57.63%,20.42%,1
臺南市,北區,0908,366,582,948,19,967,1709,56.58%,21.42%,1
臺南市,北區,0909,335,539,874,35,909,1517,59.92%,22.08%,1
臺南市,北區,0910,315,512,827,24,851,1598,53.25%,19.71%,1
臺南市,北區,0911,296,401,697,41,738,1399,52.75%,21.16%,1
臺南市,北區,0912,210,389,599,48,647,1214,53.29%,17.3%,1
臺南市,北區,0913,225,359,584,16,600,1064,56.39%,21.15%,1
臺南市,北區,0914,260,412,672,33,705,1148,61.41%,22.65%,1
臺南市,北區,0915,252,492,744,36,780,1391,56.07%,18.12%,1
臺南市,北區,0916,293,559,852,40,892,1584,56.31%,18.5%,1
臺南市,北區,0917,288,567,855,35,890,1595,55.8%,18.06%,1
臺南市,北區,0918,244,468,712,29,741,1397,53.04%,17.47%,1
臺南市,北區,0919,321,525,846,43,889,1662,53.49%,19.31%,1
臺南市,北區,0920,318,483,801,39,840,1634,51.41%,19.46%,1
臺南市,北區,0921,320,650,970,46,1016,1793,56.66%,17.85%,1
臺南市,北區,0922,349,651,1000,42,1042,1872,55.66%,18.64%,1
臺南市,北區,0923,327,631,958,57,1015,1874,54.16%,17.45%,1
臺南市,北區,0924,288,569,857,56,913,1760,51.88%,16.36%,1
臺南市,北區,0925,285,568,853,53,906,1753,51.68%,16.26%,1
臺南市,北區,0926,239,418,657,22,679,1502,45.21%,15.91%,1
臺南市,北區,0927,254,501,755,39,794,1470,54.01%,17.28%,1
臺南市,北區,0928,253,390,643,64,707,1319,53.6%,19.18%,1
臺南市,北區,0929,331,675,1006,44,1050,1876,55.97%,17.64%,1
臺南市,北區,0930,306,581,887,16,903,1720,52.5%,17.79%,1
臺南市,安南區,0618,510,794,1304,39,1343,2549,52.69%,20.01%,1
臺南市,安南區,0619,368,777,1145,52,1197,2321,51.57%,15.86%,1
臺南市,安南區,0620,370,766,1136,59,1195,2156,55.43%,17.16%,1
臺南市,安南區,0621,287,622,909,62,971,1662,58.42%,17.27%,1
臺南市,安南區,0622,236,562,798,90,888,1512,58.73%,15.61%,1
臺南市,安南區,0623,231,534,765,60,825,1625,50.77%,14.22%,1
臺南市,安南區,0624,321,623,944,55,999,2143,46.62%,14.98%,1
臺南市,安南區,0625,425,830,1255,72,1327,2457,54.01%,17.3%,1
臺南市,安南區,0626,412,698,1110,91,1201,2148,55.91%,19.18%,1
臺南市,安南區,0627,439,722,1161,71,1232,2364,52.12%,18.57%,1
臺南市,安南區,0628,297,567,864,47,911,1868,48.77%,15.9%,1
臺南市,安南區,0629,333,660,993,51,1044,1797,58.1%,18.53%,1
臺南市,安南區,0630,351,808,1159,61,1220,2268,53.79%,15.48%,1
臺南市,安南區,0631,360,611,971,68,1039,2291,45.35%,15.71%,1
臺南市,安南區,0632,375,733,1108,49,1157,2255,51.31%,16.63%,1
臺南市,安南區,0633,308,579,887,53,940,1940,48.45%,15.88%,1
臺南市,安南區,0634,371,685,1056,31,1087,2013,54%,18.43%,1
臺南市,安南區,0635,327,649,976,69,1045,2024,51.63%,16.16%,1
臺南市,安南區,0636,328,588,916,71,987,1613,61.19%,20.33%,1
臺南市,安南區,0637,186,378,564,45,609,1178,51.7%,15.79%,1
臺南市,安南區,0638,349,717,1066,76,1142,2143,53.29%,16.29%,1
臺南市,安南區,0639,340,559,899,66,965,1721,56.07%,19.76%,1
臺南市,安南區,0640,336,613,949,58,1007,1773,56.8%,18.95%,1
臺南市,安南區,0641,260,464,724,42,766,1428,53.64%,18.21%,1
臺南市,安南區,0642,263,580,843,48,891,1626,54.8%,16.17%,1
臺南市,安南區,0643,264,432,696,39,735,1358,54.12%,19.44%,1
臺南市,安南區,0644,266,540,806,44,850,1447,58.74%,18.38%,1
臺南市,安南區,0645,227,468,695,76,771,1358,56.77%,16.72%,1
臺南市,安南區,0646,329,682,1011,35,1046,2116,49.43%,15.55%,1
臺南市,安南區,0647,340,733,1073,43,1116,2321,48.08%,14.65%,1
臺南市,安南區,0648,322,694,1016,38,1054,2117,49.79%,15.21%,1
臺南市,安南區,0649,306,599,905,54,959,1927,49.77%,15.88%,1
臺南市,安南區,0650,378,679,1057,88,1145,2242,51.07%,16.86%,1
臺南市,安南區,0651,344,733,1077,60,1137,2334,48.71%,14.74%,1
臺南市,安南區,0652,302,629,931,60,991,1822,54.39%,16.58%,1
臺南市,安南區,0653,305,640,945,70,1015,1813,55.98%,16.82%,1
臺南市,安南區,0654,364,724,1088,79,1167,2188,53.34%,16.64%,1
臺南市,安南區,0655,377,719,1096,77,1173,2399,48.9%,15.71%,1
臺南市,安南區,0656,358,636,994,67,1061,2247,47.22%,15.93%,1
臺南市,安南區,0657,211,447,658,61,719,1165,61.72%,18.11%,1
臺南市,安南區,0658,248,473,721,56,777,1539,50.49%,16.11%,1
臺南市,安南區,0659,297,644,941,93,1034,1835,56.35%,16.19%,1
臺南市,安南區,0660,290,611,901,76,977,1797,54.37%,16.14%,1
臺南市,安南區,0661,333,688,1021,75,1096,2223,49.3%,14.98%,1
臺南市,安南區,0662,184,375,559,63,622,977,63.66%,18.83%,1
臺南市,安南區,0663,235,499,734,33,767,1642,46.71%,14.31%,1
臺南市,安南區,0664,282,599,881,58,939,1697,55.33%,16.62%,1
臺南市,安南區,0665,284,613,897,52,949,1966,48.27%,14.45%,1
臺南市,安南區,0666,210,418,628,73,701,1319,53.15%,15.92%,1
臺南市,安南區,0667,338,543,881,54,935,1909,48.98%,17.71%,1
臺南市,安南區,0668,297,593,890,58,948,1763,53.77%,16.85%,1
臺南市,安南區,0669,160,308,468,50,518,965,53.68%,16.58%,1
臺南市,安南區,0670,214,444,658,52,710,1547,45.9%,13.83%,1
臺南市,安南區,0671,289,560,849,54,903,1784,50.62%,16.2%,1
臺南市,安南區,0672,321,655,976,50,1026,2145,47.83%,14.97%,1
臺南市,安南區,0673,411,842,1253,55,1308,2443,53.54%,16.82%,1
臺南市,安南區,0674,320,769,1089,41,1130,2565,44.05%,12.48%,1
臺南市,安南區,0675,392,827,1219,71,1290,2480,52.02%,15.81%,1
臺南市,安南區,0676,337,642,979,82,1061,2349,45.17%,14.35%,1
臺南市,安南區,0677,374,709,1083,78,1161,2168,53.55%,17.25%,1
臺南市,安南區,0678,258,541,799,46,845,1630,51.84%,15.83%,1
臺南市,安南區,0679,241,502,743,43,786,1675,46.93%,14.39%,1
臺南市,安南區,0680,281,650,931,88,1019,1627,62.63%,17.27%,1
臺南市,安南區,0681,242,509,751,67,818,1493,54.79%,16.21%,1
臺南市,安南區,0682,244,476,720,67,787,1397,56.34%,17.47%,1
臺南市,安南區,0683,231,463,694,50,744,1416,52.54%,16.31%,1
臺南市,安南區,0684,246,499,745,30,775,1460,53.08%,16.85%,1
臺南市,安南區,0685,328,641,969,42,1011,2222,45.5%,14.76%,1
臺南市,安南區,0686,349,685,1034,64,1098,2070,53.04%,16.86%,1
臺南市,安南區,0687,300,612,912,40,952,1739,54.74%,17.25%,1
臺南市,安南區,0688,275,577,852,82,934,1830,51.04%,15.03%,1
臺南市,安南區,0689,341,645,986,70,1056,1803,58.57%,18.91%,1
臺南市,安南區,0690,348,610,958,57,1015,1800,56.39%,19.33%,1
臺南市,安南區,0691,271,515,786,66,852,1815,46.94%,14.93%,1
臺南市,安南區,0692,283,574,857,35,892,1846,48.32%,15.33%,1
臺南市,安南區,0693,179,333,512,44,556,905,61.44%,19.78%,1
臺南市,安南區,0694,210,394,604,59,663,1073,61.79%,19.57%,1
臺南市,安南區,0695,234,611,845,67,912,1579,57.76%,14.82%,1
臺南市,安南區,0696,270,604,874,99,973,1876,51.87%,14.39%,1
臺南市,安南區,0697,203,373,576,41,617,1194,51.68%,17%,1
臺南市,安南區,0698,170,412,582,17,599,1475,40.61%,11.53%,1
臺南市,安南區,0699,202,462,664,18,682,1380,49.42%,14.64%,1
臺南市,安南區,0700,244,449,693,31,724,1462,49.52%,16.69%,1
臺南市,安南區,0701,263,303,566,53,619,1044,59.29%,25.19%,1
臺南市,安南區,0702,126,225,351,44,395,603,65.51%,20.9%,1
臺南市,安南區,0703,120,255,375,23,398,690,57.68%,17.39%,1
臺南市,安南區,0704,238,439,677,46,723,1447,49.97%,16.45%,1
臺南市,安南區,0705,157,405,562,35,597,910,65.6%,17.25%,1
臺南市,安南區,0706,268,561,829,66,895,1850,48.38%,14.49%,1
臺南市,安南區,0707,253,578,831,50,881,1501,58.69%,16.86%,1
臺南市,安平區,0983,307,613,920,42,962,1753,54.88%,17.51%,1
臺南市,安平區,0984,335,587,922,42,964,1859,51.86%,18.02%,1
臺南市,安平區,0985,249,543,792,28,820,1382,59.33%,18.02%,1
臺南市,安平區,0986,399,831,1230,49,1279,2547,50.22%,15.67%,1
臺南市,安平區,0987,431,780,1211,44,1255,2407,52.14%,17.91%,1
臺南市,安平區,0988,347,586,933,38,971,2070,46.91%,16.76%,1
臺南市,安平區,0989,349,749,1098,28,1126,2132,52.81%,16.37%,1
臺南市,安平區,0990,274,512,786,14,800,1450,55.17%,18.9%,1
臺南市,安平區,0991,294,493,787,21,808,1605,50.34%,18.32%,1
臺南市,安平區,0992,308,596,904,43,947,1755,53.96%,17.55%,1
臺南市,安平區,0993,279,504,783,33,816,1728,47.22%,16.15%,1
臺南市,安平區,0994,258,458,716,32,748,1754,42.65%,14.71%,1
臺南市,安平區,0995,319,499,818,54,872,1686,51.72%,18.92%,1
臺南市,安平區,0996,310,653,963,35,998,1843,54.15%,16.82%,1
臺南市,安平區,0997,288,562,850,35,885,1565,56.55%,18.4%,1
臺南市,安平區,0998,236,444,680,21,701,1288,54.43%,18.32%,1
臺南市,安平區,0999,309,482,791,17,808,1653,48.88%,18.69%,1
臺南市,安平區,1000,284,527,811,19,830,1697,48.91%,16.74%,1
臺南市,安平區,1001,342,638,980,37,1017,2154,47.21%,15.88%,1
臺南市,安平區,1002,343,657,1000,30,1030,2107,48.88%,16.28%,1
臺南市,安平區,1003,321,568,889,41,930,1675,55.52%,19.16%,1
臺南市,安平區,1004,389,592,981,46,1027,1979,51.89%,19.66%,1
臺南市,安平區,1005,278,490,768,31,799,1602,49.88%,17.35%,1
臺南市,安平區,1006,281,485,766,37,803,1586,50.63%,17.72%,1
臺南市,安平區,1007,59,132,191,6,197,438,44.98%,13.47%,1
臺南市,安平區,1008,336,516,852,47,899,1780,50.51%,18.88%,1
臺南市,安平區,1009,287,483,770,32,802,1623,49.41%,17.68%,1
臺南市,安平區,1010,325,666,991,75,1066,2157,49.42%,15.07%,1
臺南市,安平區,1011,203,421,624,39,663,1286,51.56%,15.79%,1
臺南市,安平區,1012,226,509,735,53,788,1492,52.82%,15.15%,1
臺南市,安平區,1013,172,425,597,31,628,1325,47.4%,12.98%,1
臺南市,安平區,1014,284,625,909,83,992,2001,49.58%,14.19%,1
臺南市,中西區,0931,260,425,685,55,740,1332,55.56%,19.52%,1
臺南市,中西區,0932,213,475,688,43,731,1246,58.67%,17.09%,1
臺南市,中西區,0933,190,450,640,36,676,1276,52.98%,14.89%,1
臺南市,中西區,0934,328,544,872,28,900,1583,56.85%,20.72%,1
臺南市,中西區,0935,313,496,809,28,837,1464,57.17%,21.38%,1
臺南市,中西區,0936,229,408,637,12,649,1234,52.59%,18.56%,1
臺南市,中西區,0937,247,498,745,44,789,1368,57.68%,18.06%,1
臺南市,中西區,0938,213,416,629,24,653,1322,49.39%,16.11%,1
臺南市,中西區,0939,229,373,602,39,641,1216,52.71%,18.83%,1
臺南市,中西區,0940,247,418,665,30,695,1289,53.92%,19.16%,1
臺南市,中西區,0941,202,473,675,31,706,1237,57.07%,16.33%,1
臺南市,中西區,0942,193,340,533,33,566,1189,47.6%,16.23%,1
臺南市,中西區,0943,212,413,625,59,684,1201,56.95%,17.65%,1
臺南市,中西區,0944,207,389,596,41,637,1065,59.81%,19.44%,1
臺南市,中西區,0945,188,394,582,36,618,1055,58.58%,17.82%,1
臺南市,中西區,0946,267,420,687,31,718,1170,61.37%,22.82%,1
臺南市,中西區,0947,241,530,771,25,796,1280,62.19%,18.83%,1
臺南市,中西區,0948,241,425,666,29,695,1223,56.83%,19.71%,1
臺南市,中西區,0949,214,483,697,46,743,1292,57.51%,16.56%,1
臺南市,中西區,0950,217,349,566,16,582,993,58.61%,21.85%,1
臺南市,中西區,0951,295,516,811,35,846,1541,54.9%,19.14%,1
臺南市,中西區,0952,344,585,929,58,987,1652,59.75%,20.82%,1
臺南市,中西區,0953,232,435,667,23,690,1212,56.93%,19.14%,1
臺南市,中西區,0954,314,564,878,43,921,1621,56.82%,19.37%,1
臺南市,中西區,0955,340,561,901,35,936,1660,56.39%,20.48%,1
臺南市,中西區,0956,274,547,821,45,866,1595,54.29%,17.18%,1
臺南市,中西區,0957,246,481,727,42,769,1436,53.55%,17.13%,1
臺南市,中西區,0958,224,456,680,46,726,1265,57.39%,17.71%,1
臺南市,中西區,0959,164,334,498,28,526,856,61.45%,19.16%,1
臺南市,中西區,0960,205,390,595,34,629,1168,53.85%,17.55%,1
臺南市,中西區,0961,227,402,629,40,669,1134,58.99%,20.02%,1
臺南市,中西區,0962,212,376,588,36,624,995,62.71%,21.31%,1
臺南市,中西區,0963,234,556,790,25,815,1313,62.07%,17.82%,1
臺南市,中西區,0964,253,470,723,37,760,1265,60.08%,20%,1
臺南市,中西區,0965,216,397,613,37,650,1215,53.5%,17.78%,1
臺南市,中西區,0966,208,439,647,41,688,1248,55.13%,16.67%,1
臺南市,中西區,0967,137,215,352,29,381,687,55.46%,19.94%,1
臺南市,中西區,0968,210,375,585,54,639,1139,56.1%,18.44%,1
臺南市,中西區,0969,183,342,525,42,567,971,58.39%,18.85%,1
臺南市,中西區,0970,165,339,504,46,550,1254,43.86%,13.16%,1
臺南市,中西區,0971,172,357,529,38,567,979,57.92%,17.57%,1
臺南市,中西區,0972,294,559,853,47,900,1745,51.58%,16.85%,1
臺南市,中西區,0973,179,374,553,34,587,1074,54.66%,16.67%,1
臺南市,中西區,0974,231,467,698,29,727,1436,50.63%,16.09%,1
臺南市,中西區,0975,171,296,467,37,504,865,58.27%,19.77%,1
臺南市,中西區,0976,377,216,593,47,640,1164,54.98%,32.39%,1
臺南市,中西區,0977,241,366,607,28,635,1285,49.42%,18.75%,1
臺南市,中西區,0978,169,386,555,39,594,1078,55.1%,15.68%,1
臺南市,中西區,0979,238,497,735,42,777,1704,45.6%,13.97%,1
臺南市,中西區,0980,233,471,704,53,757,1296,58.41%,17.98%,1
臺南市,中西區,0981,194,399,593,36,629,1128,55.76%,17.2%,1
臺南市,中西區,0982,230,430,660,29,689,1245,55.34%,18.47%,1
高雄市,鹽埕區,0845,292,503,795,41,836,1304,64.11%,22.39%,1
高雄市,鹽埕區,0846,74,125,199,23,222,357,62.18%,20.73%,1
高雄市,鹽埕區,0847,138,227,365,23,388,651,59.6%,21.2%,1
高雄市,鹽埕區,0848,220,434,654,20,674,1322,50.98%,16.64%,1
高雄市,鹽埕區,0849,216,417,633,22,655,1056,62.03%,20.45%,1
高雄市,鹽埕區,0850,224,327,551,16,567,904,62.72%,24.78%,1
高雄市,鹽埕區,0851,230,395,625,24,649,1130,57.43%,20.35%,1
高雄市,鹽埕區,0852,153,344,497,19,516,840,61.43%,18.21%,1
高雄市,鹽埕區,0853,151,272,423,17,440,616,71.43%,24.51%,1
高雄市,鹽埕區,0854,294,420,714,27,741,1397,53.04%,21.05%,1
高雄市,鹽埕區,0855,164,276,440,12,452,766,59.01%,21.41%,1
高雄市,鹽埕區,0856,182,303,485,33,518,839,61.74%,21.69%,1
高雄市,鹽埕區,0857,169,319,488,16,504,805,62.61%,20.99%,1
高雄市,鹽埕區,0858,140,257,397,18,415,750,55.33%,18.67%,1
高雄市,鹽埕區,0859,291,244,535,28,563,986,57.1%,29.51%,1
高雄市,鹽埕區,0860,193,368,561,9,570,1068,53.37%,18.07%,1
高雄市,鹽埕區,0861,227,379,606,34,640,1060,60.38%,21.42%,1
高雄市,鹽埕區,0862,166,271,437,23,460,805,57.14%,20.62%,1
高雄市,鹽埕區,0863,203,336,539,15,554,1073,51.63%,18.92%,1
高雄市,鹽埕區,0864,175,285,460,23,483,921,52.44%,19%,1
高雄市,鹽埕區,0865,327,315,642,21,663,1171,56.62%,27.92%,1
高雄市,鹽埕區,0866,129,216,345,9,354,594,59.6%,21.72%,1
高雄市,鹽埕區,0867,123,230,353,15,368,592,62.16%,20.78%,1
高雄市,鹽埕區,0868,120,191,311,13,324,610,53.11%,19.67%,1
高雄市,鼓山區,0768,152,339,491,24,515,959,53.7%,15.85%,1
高雄市,鼓山區,0769,209,410,619,46,665,1000,66.5%,20.9%,1
高雄市,鼓山區,0770,140,381,521,14,535,910,58.79%,15.38%,1
高雄市,鼓山區,0771,202,460,662,47,709,1085,65.35%,18.62%,1
高雄市,鼓山區,0772,211,484,695,45,740,1484,49.87%,14.22%,1
高雄市,鼓山區,0773,231,586,817,26,843,1393,60.52%,16.58%,1
高雄市,鼓山區,0774,261,542,803,46,849,1270,66.85%,20.55%,1
高雄市,鼓山區,0775,192,394,586,35,621,1055,58.86%,18.2%,1
高雄市,鼓山區,0776,221,444,665,27,692,1172,59.04%,18.86%,1
高雄市,鼓山區,0777,207,497,704,51,755,1175,64.26%,17.62%,1
高雄市,鼓山區,0778,246,493,739,32,771,1274,60.52%,19.31%,1
高雄市,鼓山區,0779,189,347,536,42,578,1085,53.27%,17.42%,1
高雄市,鼓山區,0780,272,535,807,45,852,1470,57.96%,18.5%,1
高雄市,鼓山區,0781,199,408,607,39,646,974,66.32%,20.43%,1
高雄市,鼓山區,0782,260,471,731,61,792,1275,62.12%,20.39%,1
高雄市,鼓山區,0783,215,446,661,55,716,1206,59.37%,17.83%,1
高雄市,鼓山區,0784,229,490,719,28,747,1238,60.34%,18.5%,1
高雄市,鼓山區,0785,101,391,492,7,499,721,69.21%,14.01%,1
高雄市,鼓山區,0786,227,452,679,28,707,1220,57.95%,18.61%,1
高雄市,鼓山區,0787,328,613,941,39,980,1966,49.85%,16.68%,1
高雄市,鼓山區,0788,283,600,883,76,959,1722,55.69%,16.43%,1
高雄市,鼓山區,0789,286,611,897,36,933,1720,54.24%,16.63%,1
高雄市,鼓山區,0790,255,495,750,76,826,1287,64.18%,19.81%,1
高雄市,鼓山區,0791,230,373,603,30,633,1369,46.24%,16.8%,1
高雄市,鼓山區,0792,228,517,745,25,770,1222,63.01%,18.66%,1
高雄市,鼓山區,0793,309,638,947,51,998,1770,56.38%,17.46%,1
高雄市,鼓山區,0794,469,678,1147,29,1176,1860,63.23%,25.22%,1
高雄市,鼓山區,0795,367,664,1031,39,1070,1857,57.62%,19.76%,1
高雄市,鼓山區,0796,382,680,1062,31,1093,1841,59.37%,20.75%,1
高雄市,鼓山區,0797,378,705,1083,47,1130,1830,61.75%,20.66%,1
高雄市,鼓山區,0798,346,687,1033,51,1084,1809,59.92%,19.13%,1
高雄市,鼓山區,0799,393,735,1128,37,1165,1894,61.51%,20.75%,1
高雄市,鼓山區,0800,377,759,1136,22,1158,1882,61.53%,20.03%,1
高雄市,鼓山區,0801,437,738,1175,35,1210,1894,63.89%,23.07%,1
高雄市,鼓山區,0802,302,671,973,38,1011,1745,57.94%,17.31%,1
高雄市,鼓山區,0803,403,645,1048,16,1064,1887,56.39%,21.36%,1
高雄市,鼓山區,0804,442,746,1188,47,1235,1891,65.31%,23.37%,1
高雄市,鼓山區,0805,397,738,1135,38,1173,1903,61.64%,20.86%,1
高雄市,鼓山區,0806,470,717,1187,34,1221,1998,61.11%,23.52%,1
高雄市,鼓山區,0807,388,755,1143,31,1174,1912,61.4%,20.29%,1
高雄市,鼓山區,0808,342,764,1106,52,1158,1923,60.22%,17.78%,1
高雄市,鼓山區,0809,431,733,1164,22,1186,1888,62.82%,22.83%,1
高雄市,鼓山區,0810,403,742,1145,26,1171,1873,62.52%,21.52%,1
高雄市,鼓山區,0811,491,792,1283,28,1311,1959,66.92%,25.06%,1
高雄市,鼓山區,0812,402,800,1202,37,1239,1897,65.31%,21.19%,1
高雄市,鼓山區,0813,577,825,1402,40,1442,2362,61.05%,24.43%,1
高雄市,鼓山區,0814,358,740,1098,53,1151,1850,62.22%,19.35%,1
高雄市,鼓山區,0815,417,749,1166,25,1191,1928,61.77%,21.63%,1
高雄市,鼓山區,0816,348,721,1069,32,1101,1937,56.84%,17.97%,1
高雄市,鼓山區,0817,426,798,1224,51,1275,2123,60.06%,20.07%,1
高雄市,鼓山區,0818,355,775,1130,32,1162,1861,62.44%,19.08%,1
高雄市,鼓山區,0819,352,748,1100,22,1122,1892,59.3%,18.6%,1
高雄市,鼓山區,0820,485,805,1290,42,1332,2147,62.04%,22.59%,1
高雄市,鼓山區,0821,349,796,1145,33,1178,1897,62.1%,18.4%,1
高雄市,鼓山區,0822,410,771,1181,31,1212,2041,59.38%,20.09%,1
高雄市,鼓山區,0823,250,497,747,41,788,1309,60.2%,19.1%,1
高雄市,鼓山區,0824,344,737,1081,48,1129,1867,60.47%,18.43%,1
高雄市,鼓山區,0825,234,529,763,25,788,1152,68.4%,20.31%,1
高雄市,鼓山區,0826,253,610,863,49,912,1404,64.96%,18.02%,1
高雄市,鼓山區,0827,143,356,499,23,522,1210,43.14%,11.82%,1
高雄市,鼓山區,0828,218,415,633,31,664,1135,58.5%,19.21%,1
高雄市,鼓山區,0829,199,396,595,77,672,1831,36.7%,10.87%,1
高雄市,鼓山區,0830,220,491,711,52,763,1288,59.24%,17.08%,1
高雄市,鼓山區,0831,203,462,665,35,700,1241,56.41%,16.36%,1
高雄市,鼓山區,0832,252,517,769,56,825,1342,61.48%,18.78%,1
高雄市,鼓山區,0833,259,519,778,96,874,1422,61.46%,18.21%,1
高雄市,鼓山區,0834,288,531,819,82,901,1453,62.01%,19.82%,1
高雄市,鼓山區,0835,117,251,368,37,405,616,65.75%,18.99%,1
高雄市,鼓山區,0836,136,303,439,56,495,834,59.35%,16.31%,1
高雄市,鼓山區,0837,168,300,468,57,525,969,54.18%,17.34%,1
高雄市,鼓山區,0838,170,343,513,72,585,978,59.82%,17.38%,1
高雄市,鼓山區,0839,160,288,448,52,500,760,65.79%,21.05%,1
高雄市,鼓山區,0840,231,453,684,13,697,1248,55.85%,18.51%,1
高雄市,鼓山區,0841,211,386,597,23,620,1143,54.24%,18.46%,1
高雄市,鼓山區,0842,216,408,624,72,696,1358,51.25%,15.91%,1
高雄市,鼓山區,0843,153,378,531,14,545,1036,52.61%,14.77%,1
高雄市,鼓山區,0844,91,222,313,9,322,580,55.52%,15.69%,1
高雄市,左營區,0534,287,577,864,51,915,2604,35.14%,11.02%,1
高雄市,左營區,0535,196,382,578,67,645,1037,62.2%,18.9%,1
高雄市,左營區,0536,116,200,316,41,357,542,65.87%,21.4%,1
高雄市,左營區,0537,115,231,346,46,392,635,61.73%,18.11%,1
高雄市,左營區,0538,81,170,251,12,263,518,50.77%,15.64%,1
高雄市,左營區,0539,148,270,418,49,467,813,57.44%,18.2%,1
高雄市,左營區,0540,170,303,473,68,541,889,60.85%,19.12%,1
高雄市,左營區,0541,145,266,411,60,471,731,64.43%,19.84%,1
高雄市,左營區,0542,268,517,785,38,823,1592,51.7%,16.83%,1
高雄市,左營區,0543,342,640,982,35,1017,1709,59.51%,20.01%,1
高雄市,左營區,0544,194,659,853,65,918,1588,57.81%,12.22%,1
高雄市,左營區,0545,45,155,200,4,204,358,56.98%,12.57%,1
高雄市,左營區,0546,81,360,441,16,457,666,68.62%,12.16%,1
高雄市,左營區,0547,271,686,957,57,1014,1748,58.01%,15.5%,1
高雄市,左營區,0548,184,529,713,54,767,1196,64.13%,15.38%,1
高雄市,左營區,0549,227,523,750,45,795,1240,64.11%,18.31%,1
高雄市,左營區,0550,166,665,831,45,876,1402,62.48%,11.84%,1
高雄市,左營區,0551,128,592,720,29,749,1173,63.85%,10.91%,1
高雄市,左營區,0552,114,329,443,18,461,641,71.92%,17.78%,1
高雄市,左營區,0553,184,326,510,38,548,951,57.62%,19.35%,1
高雄市,左營區,0554,141,256,397,33,430,732,58.74%,19.26%,1
高雄市,左營區,0555,60,117,177,9,186,339,54.87%,17.7%,1
高雄市,左營區,0556,102,191,293,14,307,519,59.15%,19.65%,1
高雄市,左營區,0557,111,181,292,50,342,514,66.54%,21.6%,1
高雄市,左營區,0558,115,298,413,51,464,720,64.44%,15.97%,1
高雄市,左營區,0559,80,152,232,37,269,411,65.45%,19.46%,1
高雄市,左營區,0560,138,217,355,48,403,603,66.83%,22.89%,1
高雄市,左營區,0561,168,321,489,64,553,904,61.17%,18.58%,1
高雄市,左營區,0562,158,514,672,33,705,1318,53.49%,11.99%,1
高雄市,左營區,0563,184,324,508,22,530,966,54.87%,19.05%,1
高雄市,左營區,0564,246,599,845,32,877,1440,60.9%,17.08%,1
高雄市,左營區,0565,251,826,1077,37,1114,1990,55.98%,12.61%,1
高雄市,左營區,0566,52,595,647,35,682,1090,62.57%,4.77%,1
高雄市,左營區,0567,160,587,747,52,799,1272,62.81%,12.58%,1
高雄市,左營區,0568,334,648,982,29,1011,1558,64.89%,21.44%,1
高雄市,左營區,0569,324,616,940,29,969,1501,64.56%,21.59%,1
高雄市,左營區,0570,80,163,243,7,250,360,69.44%,22.22%,1
高雄市,左營區,0571,155,607,762,30,792,1335,59.33%,11.61%,1
高雄市,左營區,0572,196,589,785,21,806,1359,59.31%,14.42%,1
高雄市,左營區,0573,245,641,886,51,937,1487,63.01%,16.48%,1
高雄市,左營區,0574,208,692,900,94,994,1637,60.72%,12.71%,1
高雄市,左營區,0575,317,621,938,34,972,1553,62.59%,20.41%,1
高雄市,左營區,0576,323,637,960,55,1015,1564,64.9%,20.65%,1
高雄市,左營區,0577,385,733,1118,46,1164,1788,65.1%,21.53%,1
高雄市,左營區,0578,390,772,1162,83,1245,2028,61.39%,19.23%,1
高雄市,左營區,0579,425,714,1139,67,1206,2037,59.2%,20.86%,1
高雄市,左營區,0580,428,833,1261,44,1305,2101,62.11%,20.37%,1
高雄市,左營區,0581,317,898,1215,48,1263,2018,62.59%,15.71%,1
高雄市,左營區,0582,407,789,1196,62,1258,1925,65.35%,21.14%,1
高雄市,左營區,0583,393,721,1114,46,1160,1989,58.32%,19.76%,1
高雄市,左營區,0584,325,621,946,28,974,1780,54.72%,18.26%,1
高雄市,左營區,0585,354,715,1069,31,1100,1778,61.87%,19.91%,1
高雄市,左營區,0586,290,599,889,31,920,1496,61.5%,19.39%,1
高雄市,左營區,0587,339,603,942,30,972,1538,63.2%,22.04%,1
高雄市,左營區,0588,404,822,1226,37,1263,2058,61.37%,19.63%,1
高雄市,左營區,0589,433,752,1185,35,1220,1992,61.24%,21.74%,1
高雄市,左營區,0590,436,791,1227,57,1284,2058,62.39%,21.19%,1
高雄市,左營區,0591,426,813,1239,38,1277,2090,61.1%,20.38%,1
高雄市,左營區,0592,448,820,1268,34,1302,2157,60.36%,20.77%,1
高雄市,左營區,0593,421,857,1278,38,1316,2096,62.79%,20.09%,1
高雄市,左營區,0594,467,807,1274,56,1330,2101,63.3%,22.23%,1
高雄市,左營區,0595,295,632,927,64,991,1649,60.1%,17.89%,1
高雄市,左營區,0596,256,570,826,74,900,1516,59.37%,16.89%,1
高雄市,左營區,0597,304,704,1008,68,1076,1678,64.12%,18.12%,1
高雄市,左營區,0598,342,735,1077,73,1150,1898,60.59%,18.02%,1
高雄市,左營區,0599,362,739,1101,47,1148,1837,62.49%,19.71%,1
高雄市,左營區,0600,333,727,1060,37,1097,1922,57.08%,17.33%,1
高雄市,左營區,0601,360,719,1079,50,1129,1785,63.25%,20.17%,1
高雄市,左營區,0602,342,758,1100,25,1125,1886,59.65%,18.13%,1
高雄市,左營區,0603,367,771,1138,37,1175,1895,62.01%,19.37%,1
高雄市,左營區,0604,393,739,1132,24,1156,1831,63.13%,21.46%,1
高雄市,左營區,0605,374,789,1163,45,1208,2050,58.93%,18.24%,1
高雄市,左營區,0606,480,964,1444,38,1482,2251,65.84%,21.32%,1
高雄市,左營區,0607,451,888,1339,31,1370,2126,64.44%,21.21%,1
高雄市,左營區,0608,335,729,1064,26,1090,1928,56.54%,17.38%,1
高雄市,左營區,0609,405,831,1236,34,1270,2166,58.63%,18.7%,1
高雄市,左營區,0610,385,802,1187,41,1228,2031,60.46%,18.96%,1
高雄市,左營區,0611,367,834,1201,34,1235,1987,62.15%,18.47%,1
高雄市,左營區,0612,446,889,1335,31,1366,2166,63.07%,20.59%,1
高雄市,左營區,0613,380,712,1092,56,1148,1856,61.85%,20.47%,1
高雄市,左營區,0614,467,932,1399,26,1425,2289,62.25%,20.4%,1
高雄市,左營區,0615,348,825,1173,36,1209,1973,61.28%,17.64%,1
高雄市,左營區,0616,359,712,1071,57,1128,1818,62.05%,19.75%,1
高雄市,左營區,0617,301,592,893,25,918,1565,58.66%,19.23%,1
高雄市,左營區,0618,341,686,1027,22,1049,1608,65.24%,21.21%,1
高雄市,左營區,0619,375,759,1134,43,1177,1812,64.96%,20.7%,1
高雄市,左營區,0620,341,685,1026,19,1045,1821,57.39%,18.73%,1
高雄市,左營區,0621,386,768,1154,39,1193,1907,62.56%,20.24%,1
高雄市,左營區,0622,287,703,990,36,1026,1812,56.62%,15.84%,1
高雄市,左營區,0623,367,764,1131,39,1170,1833,63.83%,20.02%,1
高雄市,左營區,0624,400,727,1127,35,1162,1850,62.81%,21.62%,1
高雄市,左營區,0625,305,682,987,47,1034,1738,59.49%,17.55%,1
高雄市,左營區,0626,374,805,1179,43,1222,1864,65.56%,20.06%,1
高雄市,左營區,0627,389,776,1165,30,1195,1887,63.33%,20.61%,1
高雄市,左營區,0628,349,697,1046,27,1073,1870,57.38%,18.66%,1
高雄市,左營區,0629,359,744,1103,22,1125,1866,60.29%,19.24%,1
高雄市,左營區,0630,354,727,1081,21,1102,1862,59.18%,19.01%,1
高雄市,左營區,0631,355,745,1100,24,1124,1816,61.89%,19.55%,1
高雄市,左營區,0632,317,794,1111,36,1147,1833,62.58%,17.29%,1
高雄市,左營區,0633,330,685,1015,44,1059,1676,63.19%,19.69%,1
高雄市,左營區,0634,336,769,1105,37,1142,1843,61.96%,18.23%,1
高雄市,左營區,0635,374,769,1143,24,1167,1872,62.34%,19.98%,1
高雄市,左營區,0636,381,919,1300,48,1348,2259,59.67%,16.87%,1
高雄市,楠梓區,0435,274,522,796,38,834,1309,63.71%,20.93%,1
高雄市,楠梓區,0436,294,535,829,29,858,1408,60.94%,20.88%,1
高雄市,楠梓區,0437,356,703,1059,45,1104,1851,59.64%,19.23%,1
高雄市,楠梓區,0438,290,632,922,55,977,1578,61.91%,18.38%,1
高雄市,楠梓區,0439,433,609,1042,28,1070,1715,62.39%,25.25%,1
高雄市,楠梓區,0440,298,587,885,18,903,1611,56.05%,18.5%,1
高雄市,楠梓區,0441,314,738,1052,59,1111,2024,54.89%,15.51%,1
高雄市,楠梓區,0442,353,641,994,29,1023,1890,54.13%,18.68%,1
高雄市,楠梓區,0443,289,605,894,21,915,1762,51.93%,16.4%,1
高雄市,楠梓區,0444,327,665,992,48,1040,1888,55.08%,17.32%,1
高雄市,楠梓區,0445,347,610,957,75,1032,1822,56.64%,19.05%,1
高雄市,楠梓區,0446,376,630,1006,37,1043,1846,56.5%,20.37%,1
高雄市,楠梓區,0447,250,500,750,59,809,1268,63.8%,19.72%,1
高雄市,楠梓區,0448,247,522,769,43,812,1240,65.48%,19.92%,1
高雄市,楠梓區,0449,305,556,861,26,887,1432,61.94%,21.3%,1
高雄市,楠梓區,0450,296,567,863,43,906,1490,60.81%,19.87%,1
高雄市,楠梓區,0451,254,622,876,47,923,1464,63.05%,17.35%,1
高雄市,楠梓區,0452,246,515,761,59,820,1435,57.14%,17.14%,1
高雄市,楠梓區,0453,252,578,830,67,897,1602,55.99%,15.73%,1
高雄市,楠梓區,0454,289,518,807,44,851,1500,56.73%,19.27%,1
高雄市,楠梓區,0455,314,551,865,61,926,1591,58.2%,19.74%,1
高雄市,楠梓區,0456,225,399,624,39,663,1669,39.72%,13.48%,1
高雄市,楠梓區,0457,288,572,860,47,907,1469,61.74%,19.61%,1
高雄市,楠梓區,0458,285,547,832,63,895,1559,57.41%,18.28%,1
高雄市,楠梓區,0459,296,577,873,64,937,1638,57.2%,18.07%,1
高雄市,楠梓區,0460,361,726,1087,84,1171,1960,59.74%,18.42%,1
高雄市,楠梓區,0461,365,703,1068,82,1150,1912,60.15%,19.09%,1
高雄市,楠梓區,0462,255,589,844,50,894,1559,57.34%,16.36%,1
高雄市,楠梓區,0463,262,509,771,38,809,1423,56.85%,18.41%,1
高雄市,楠梓區,0464,327,665,992,25,1017,1696,59.96%,19.28%,1
高雄市,楠梓區,0465,266,506,772,114,886,1493,59.34%,17.82%,1
高雄市,楠梓區,0466,266,571,837,84,921,1527,60.31%,17.42%,1
高雄市,楠梓區,0467,171,428,599,55,654,1020,64.12%,16.76%,1
高雄市,楠梓區,0468,255,395,650,75,725,1197,60.57%,21.3%,1
高雄市,楠梓區,0469,288,486,774,71,845,1528,55.3%,18.85%,1
高雄市,楠梓區,0470,320,603,923,70,993,1918,51.77%,16.68%,1
高雄市,楠梓區,0471,261,511,772,82,854,1458,58.57%,17.9%,1
高雄市,楠梓區,0472,330,670,1000,76,1076,1790,60.11%,18.44%,1
高雄市,楠梓區,0473,341,721,1062,81,1143,1845,61.95%,18.48%,1
高雄市,楠梓區,0474,401,790,1191,52,1243,2037,61.02%,19.69%,1
高雄市,楠梓區,0475,363,694,1057,52,1109,1964,56.47%,18.48%,1
高雄市,楠梓區,0476,361,773,1134,24,1158,2006,57.73%,18%,1
高雄市,楠梓區,0477,355,718,1073,41,1114,1951,57.1%,18.2%,1
高雄市,楠梓區,0478,343,506,849,255,1104,1951,56.59%,17.58%,1
高雄市,楠梓區,0479,347,805,1152,54,1206,2008,60.06%,17.28%,1
高雄市,楠梓區,0480,330,768,1098,72,1170,1923,60.84%,17.16%,1
高雄市,楠梓區,0481,375,737,1112,39,1151,1921,59.92%,19.52%,1
高雄市,楠梓區,0482,160,390,550,32,582,832,69.95%,19.23%,1
高雄市,楠梓區,0483,291,429,720,50,770,1156,66.61%,25.17%,1
高雄市,楠梓區,0484,215,439,654,60,714,1125,63.47%,19.11%,1
高雄市,楠梓區,0485,225,445,670,49,719,1060,67.83%,21.23%,1
高雄市,楠梓區,0486,256,629,885,39,924,1502,61.52%,17.04%,1
高雄市,楠梓區,0487,260,513,773,85,858,1404,61.11%,18.52%,1
高雄市,楠梓區,0488,235,529,764,60,824,1552,53.09%,15.14%,1
高雄市,楠梓區,0489,253,535,788,54,842,1460,57.67%,17.33%,1
高雄市,楠梓區,0490,181,503,684,51,735,1315,55.89%,13.76%,1
高雄市,楠梓區,0491,211,404,615,55,670,1062,63.09%,19.87%,1
高雄市,楠梓區,0492,183,423,606,49,655,1078,60.76%,16.98%,1
高雄市,楠梓區,0493,167,372,539,73,612,914,66.96%,18.27%,1
高雄市,楠梓區,0494,209,422,631,70,701,1064,65.88%,19.64%,1
高雄市,楠梓區,0495,292,705,997,55,1052,1705,61.7%,17.13%,1
高雄市,楠梓區,0496,289,705,994,50,1044,1728,60.42%,16.72%,1
高雄市,楠梓區,0497,352,764,1116,39,1155,1917,60.25%,18.36%,1
高雄市,楠梓區,0498,198,563,761,60,821,1439,57.05%,13.76%,1
高雄市,楠梓區,0499,228,531,759,58,817,1287,63.48%,17.72%,1
高雄市,楠梓區,0500,258,650,908,58,966,1504,64.23%,17.15%,1
高雄市,楠梓區,0501,268,597,865,64,929,1405,66.12%,19.07%,1
高雄市,楠梓區,0502,246,469,715,76,791,1287,61.46%,19.11%,1
高雄市,楠梓區,0503,252,522,774,36,810,1295,62.55%,19.46%,1
高雄市,楠梓區,0504,286,588,874,56,930,1483,62.71%,19.29%,1
高雄市,楠梓區,0505,308,741,1049,43,1092,1649,66.22%,18.68%,1
高雄市,楠梓區,0506,209,401,610,40,650,998,65.13%,20.94%,1
高雄市,楠梓區,0507,206,411,617,49,666,1025,64.98%,20.1%,1
高雄市,楠梓區,0508,306,740,1046,60,1106,1671,66.19%,18.31%,1
高雄市,楠梓區,0509,266,619,885,71,956,1453,65.79%,18.31%,1
高雄市,楠梓區,0510,322,625,947,72,1019,1673,60.91%,19.25%,1
高雄市,楠梓區,0511,280,653,933,41,974,1653,58.92%,16.94%,1
高雄市,楠梓區,0512,184,407,591,52,643,1034,62.19%,17.79%,1
高雄市,楠梓區,0513,235,499,734,43,777,1127,68.94%,20.85%,1
高雄市,楠梓區,0514,288,570,858,64,922,1575,58.54%,18.29%,1
高雄市,楠梓區,0515,254,653,907,48,955,1559,61.26%,16.29%,1
高雄市,楠梓區,0516,248,516,764,40,804,1378,58.35%,18%,1
高雄市,楠梓區,0517,286,690,976,54,1030,1714,60.09%,16.69%,1
高雄市,楠梓區,0518,281,702,983,73,1056,1721,61.36%,16.33%,1
高雄市,楠梓區,0519,273,646,919,64,983,1628,60.38%,16.77%,1
高雄市,楠梓區,0520,308,685,993,69,1062,1590,66.79%,19.37%,1
高雄市,楠梓區,0521,290,650,940,55,995,1628,61.12%,17.81%,1
高雄市,楠梓區,0522,363,745,1108,26,1134,1739,65.21%,20.87%,1
高雄市,楠梓區,0523,310,713,1023,37,1060,1642,64.56%,18.88%,1
高雄市,楠梓區,0524,300,624,924,66,990,1766,56.06%,16.99%,1
高雄市,楠梓區,0525,262,550,812,47,859,1482,57.96%,17.68%,1
高雄市,楠梓區,0526,268,629,897,26,923,1749,52.77%,15.32%,1
高雄市,楠梓區,0527,331,605,936,31,967,1591,60.78%,20.8%,1
高雄市,楠梓區,0528,329,642,971,23,994,1545,64.34%,21.29%,1
高雄市,楠梓區,0529,331,711,1042,34,1076,1651,65.17%,20.05%,1
高雄市,楠梓區,0530,329,664,993,48,1041,1646,63.24%,19.99%,1
高雄市,楠梓區,0531,303,599,902,68,970,1496,64.84%,20.25%,1
高雄市,楠梓區,0532,222,522,744,72,816,1403,58.16%,15.82%,1
高雄市,楠梓區,0533,355,543,898,39,937,1624,57.7%,21.86%,1
高雄市,三民區,0887,336,691,1027,69,1096,1893,57.9%,17.75%,1
高雄市,三民區,0888,298,693,991,84,1075,1982,54.24%,15.04%,1
高雄市,三民區,0889,279,629,908,66,974,1661,58.64%,16.8%,1
高雄市,三民區,0890,351,697,1048,24,1072,1894,56.6%,18.53%,1
高雄市,三民區,0891,311,684,995,44,1039,1839,56.5%,16.91%,1
高雄市,三民區,0892,373,699,1072,80,1152,2014,57.2%,18.52%,1
高雄市,三民區,0893,312,707,1019,105,1124,1897,59.25%,16.45%,1
高雄市,三民區,0894,387,649,1036,39,1075,2016,53.32%,19.2%,1
高雄市,三民區,0895,315,705,1020,44,1064,1924,55.3%,16.37%,1
高雄市,三民區,0896,300,691,991,44,1035,1749,59.18%,17.15%,1
高雄市,三民區,0897,370,710,1080,78,1158,1845,62.76%,20.05%,1
高雄市,三民區,0898,335,592,927,39,966,1724,56.03%,19.43%,1
高雄市,三民區,0899,368,696,1064,35,1099,1889,58.18%,19.48%,1
高雄市,三民區,0900,322,587,909,50,959,1622,59.12%,19.85%,1
高雄市,三民區,0901,354,738,1092,29,1121,1870,59.95%,18.93%,1
高雄市,三民區,0902,497,413,910,54,964,1523,63.3%,32.63%,1
高雄市,三民區,0903,317,695,1012,57,1069,2006,53.29%,15.8%,1
高雄市,三民區,0904,474,785,1259,56,1315,2076,63.34%,22.83%,1
高雄市,三民區,0905,458,713,1171,19,1190,2073,57.4%,22.09%,1
高雄市,三民區,0906,395,785,1180,34,1214,2045,59.36%,19.32%,1
高雄市,三民區,0907,361,646,1007,53,1060,2070,51.21%,17.44%,1
高雄市,三民區,0908,364,733,1097,44,1141,2035,56.07%,17.89%,1
高雄市,三民區,0909,462,795,1257,33,1290,2075,62.17%,22.27%,1
高雄市,三民區,0910,388,800,1188,35,1223,2053,59.57%,18.9%,1
高雄市,三民區,0911,473,833,1306,36,1342,2063,65.05%,22.93%,1
高雄市,三民區,0912,423,873,1296,41,1337,2143,62.39%,19.74%,1
高雄市,三民區,0913,324,756,1080,54,1134,1746,64.95%,18.56%,1
高雄市,三民區,0914,306,583,889,23,912,1735,52.56%,17.64%,1
高雄市,三民區,0915,306,563,869,56,925,1655,55.89%,18.49%,1
高雄市,三民區,0916,330,564,894,54,948,1583,59.89%,20.85%,1
高雄市,三民區,0917,357,633,990,39,1029,1800,57.17%,19.83%,1
高雄市,三民區,0918,318,698,1016,30,1046,1730,60.46%,18.38%,1
高雄市,三民區,0919,321,645,966,30,996,1715,58.08%,18.72%,1
高雄市,三民區,0920,313,665,978,37,1015,1691,60.02%,18.51%,1
高雄市,三民區,0921,388,688,1076,38,1114,1865,59.73%,20.8%,1
高雄市,三民區,0922,222,451,673,24,697,1073,64.96%,20.69%,1
高雄市,三民區,0923,182,395,577,62,639,917,69.68%,19.85%,1
高雄市,三民區,0924,301,640,941,42,983,1647,59.68%,18.28%,1
高雄市,三民區,0925,331,632,963,51,1014,1654,61.31%,20.01%,1
高雄市,三民區,0926,313,668,981,46,1027,1639,62.66%,19.1%,1
高雄市,三民區,0927,351,719,1070,42,1112,1833,60.67%,19.15%,1
高雄市,三民區,0928,307,550,857,33,890,1362,65.35%,22.54%,1
高雄市,三民區,0929,333,612,945,54,999,1557,64.16%,21.39%,1
高雄市,三民區,0930,272,634,906,24,930,1482,62.75%,18.35%,1
高雄市,三民區,0931,319,638,957,37,994,1563,63.6%,20.41%,1
高雄市,三民區,0932,220,684,904,32,936,1497,62.53%,14.7%,1
高雄市,三民區,0933,317,633,950,25,975,1523,64.02%,20.81%,1
高雄市,三民區,0934,262,565,827,42,869,1293,67.21%,20.26%,1
高雄市,三民區,0935,386,627,1013,37,1050,1662,63.18%,23.23%,1
高雄市,三民區,0936,264,565,829,36,865,1441,60.03%,18.32%,1
高雄市,三民區,0937,288,574,862,41,903,1326,68.1%,21.72%,1
高雄市,三民區,0938,333,610,943,27,970,1476,65.72%,22.56%,1
高雄市,三民區,0939,367,670,1037,39,1076,1968,54.67%,18.65%,1
高雄市,三民區,0940,288,557,845,23,868,1618,53.65%,17.8%,1
高雄市,三民區,0941,400,644,1044,46,1090,1873,58.2%,21.36%,1
高雄市,三民區,0942,287,563,850,52,902,1487,60.66%,19.3%,1
高雄市,三民區,0943,616,311,927,32,959,1640,58.48%,37.56%,1
高雄市,三民區,0944,345,716,1061,19,1080,1889,57.17%,18.26%,1
高雄市,三民區,0945,380,678,1058,44,1102,1969,55.97%,19.3%,1
高雄市,三民區,0946,287,520,807,79,886,1466,60.44%,19.58%,1
高雄市,三民區,0947,341,625,966,48,1014,1697,59.75%,20.09%,1
高雄市,三民區,0948,308,667,975,45,1020,1663,61.33%,18.52%,1
高雄市,三民區,0949,342,591,933,37,970,1649,58.82%,20.74%,1
高雄市,三民區,0950,276,561,837,0,837,1486,56.33%,18.57%,1
高雄市,三民區,0951,268,553,821,25,846,1495,56.59%,17.93%,1
高雄市,三民區,0952,348,619,967,25,992,1548,64.08%,22.48%,1
高雄市,三民區,0953,312,541,853,31,884,1493,59.21%,20.9%,1
高雄市,三民區,0954,291,594,885,27,912,1445,63.11%,20.14%,1
高雄市,三民區,0955,279,574,853,36,889,1529,58.14%,18.25%,1
高雄市,三民區,0956,277,583,860,30,890,1506,59.1%,18.39%,1
高雄市,三民區,0957,329,619,948,31,979,1549,63.2%,21.24%,1
高雄市,三民區,0958,361,633,994,41,1035,1620,63.89%,22.28%,1
高雄市,三民區,0959,306,631,937,56,993,1550,64.06%,19.74%,1
高雄市,三民區,0960,275,632,907,35,942,1488,63.31%,18.48%,1
高雄市,三民區,0961,282,502,784,40,824,1335,61.72%,21.12%,1
高雄市,三民區,0962,220,560,780,38,818,1332,61.41%,16.52%,1
高雄市,三民區,0963,358,656,1014,68,1082,1764,61.34%,20.29%,1
高雄市,三民區,0964,338,697,1035,36,1071,1811,59.14%,18.66%,1
高雄市,三民區,0965,355,682,1037,48,1085,1693,64.09%,20.97%,1
高雄市,三民區,0966,355,696,1051,56,1107,1684,65.74%,21.08%,1
高雄市,三民區,0967,287,534,821,42,863,1464,58.95%,19.6%,1
高雄市,三民區,0968,387,710,1097,27,1124,1719,65.39%,22.51%,1
高雄市,三民區,0969,353,662,1015,17,1032,1749,59.01%,20.18%,1
高雄市,三民區,0970,366,678,1044,34,1078,1908,56.5%,19.18%,1
高雄市,三民區,0971,308,603,911,61,972,1573,61.79%,19.58%,1
高雄市,三民區,0972,313,599,912,27,939,1628,57.68%,19.23%,1
高雄市,三民區,0973,237,457,694,55,749,1377,54.39%,17.21%,1
高雄市,三民區,0974,310,637,947,30,977,1530,63.86%,20.26%,1
高雄市,三民區,0975,207,465,672,44,716,1188,60.27%,17.42%,1
高雄市,三民區,0976,263,552,815,35,850,2791,30.46%,9.42%,1
高雄市,三民區,0977,362,686,1048,46,1094,1840,59.46%,19.67%,1
高雄市,三民區,0978,226,751,977,59,1036,1671,62%,13.52%,1
高雄市,三民區,0979,334,597,931,56,987,1624,60.78%,20.57%,1
高雄市,三民區,0980,358,664,1022,38,1060,1555,68.17%,23.02%,1
高雄市,三民區,0981,327,619,946,38,984,1489,66.08%,21.96%,1
高雄市,三民區,0982,342,658,1000,37,1037,1662,62.39%,20.58%,1
高雄市,三民區,0983,298,619,917,28,945,1639,57.66%,18.18%,1
高雄市,三民區,0984,348,701,1049,53,1102,1872,58.87%,18.59%,1
高雄市,三民區,0985,355,738,1093,39,1132,1968,57.52%,18.04%,1
高雄市,三民區,0986,226,487,713,73,786,1471,53.43%,15.36%,1
高雄市,三民區,0987,276,552,828,53,881,1534,57.43%,17.99%,1
高雄市,三民區,0988,272,563,835,71,906,1659,54.61%,16.4%,1
高雄市,三民區,0989,283,627,910,34,944,1815,52.01%,15.59%,1
高雄市,三民區,0990,350,614,964,41,1005,1808,55.59%,19.36%,1
高雄市,三民區,0991,204,431,635,32,667,1224,54.49%,16.67%,1
高雄市,三民區,0992,260,525,785,20,805,1406,57.25%,18.49%,1
高雄市,三民區,0993,162,338,500,37,537,945,56.83%,17.14%,1
高雄市,三民區,0994,179,404,583,27,610,944,64.62%,18.96%,1
高雄市,三民區,0995,303,636,939,68,1007,1669,60.34%,18.15%,1
高雄市,三民區,0996,244,612,856,71,927,1473,62.93%,16.56%,1
高雄市,三民區,0997,324,586,910,47,957,1876,51.01%,17.27%,1
高雄市,三民區,0998,217,410,627,43,670,1682,39.83%,12.9%,1
高雄市,三民區,0999,357,579,936,35,971,1791,54.22%,19.93%,1
高雄市,三民區,1000,363,694,1057,37,1094,1808,60.51%,20.08%,1
高雄市,三民區,1001,308,651,959,43,1002,1798,55.73%,17.13%,1
高雄市,三民區,1002,454,705,1159,37,1196,2030,58.92%,22.36%,1
高雄市,三民區,1003,402,772,1174,21,1195,2034,58.75%,19.76%,1
高雄市,三民區,1004,393,748,1141,22,1163,1998,58.21%,19.67%,1
高雄市,三民區,1005,346,682,1028,26,1054,1914,55.07%,18.08%,1
高雄市,三民區,1006,441,669,1110,40,1150,1965,58.52%,22.44%,1
高雄市,三民區,1007,391,650,1041,60,1101,1885,58.41%,20.74%,1
高雄市,三民區,1008,238,513,751,19,770,1220,63.11%,19.51%,1
高雄市,三民區,1009,184,404,588,58,646,1057,61.12%,17.41%,1
高雄市,三民區,1010,173,421,594,29,623,1434,43.44%,12.06%,1
高雄市,三民區,1011,208,455,663,30,693,1350,51.33%,15.41%,1
高雄市,三民區,1012,147,278,425,23,448,872,51.38%,16.86%,1
高雄市,三民區,1013,195,296,491,18,509,954,53.35%,20.44%,1
高雄市,三民區,1014,636,337,973,16,989,1689,58.56%,37.66%,1
高雄市,三民區,1015,299,493,792,16,808,1390,58.13%,21.51%,1
高雄市,三民區,1016,278,499,777,62,839,1336,62.8%,20.81%,1
高雄市,三民區,1017,333,584,917,42,959,1437,66.74%,23.17%,1
高雄市,三民區,1018,306,548,854,28,882,1452,60.74%,21.07%,1
高雄市,三民區,1019,323,551,874,59,933,1513,61.67%,21.35%,1
高雄市,三民區,1020,317,577,894,69,963,1467,65.64%,21.61%,1
高雄市,三民區,1021,294,574,868,78,946,1381,68.5%,21.29%,1
高雄市,三民區,1022,228,398,626,48,674,1117,60.34%,20.41%,1
高雄市,三民區,1023,290,513,803,35,838,1327,63.15%,21.85%,1
高雄市,三民區,1024,256,533,789,27,816,1304,62.58%,19.63%,1
高雄市,三民區,1025,283,532,815,27,842,1483,56.78%,19.08%,1
高雄市,三民區,1026,291,616,907,31,938,1473,63.68%,19.76%,1
高雄市,三民區,1027,203,359,562,41,603,980,61.53%,20.71%,1
高雄市,三民區,1028,348,475,823,55,878,1409,62.31%,24.7%,1
高雄市,三民區,1029,246,478,724,39,763,1230,62.03%,20%,1
高雄市,三民區,1030,218,424,642,42,684,1024,66.8%,21.29%,1
高雄市,三民區,1031,229,429,658,59,717,1130,63.45%,20.27%,1
高雄市,三民區,1032,320,653,973,33,1006,1889,53.26%,16.94%,1
高雄市,三民區,1033,270,545,815,27,842,1427,59%,18.92%,1
高雄市,三民區,1034,119,356,475,21,496,791,62.71%,15.04%,1
高雄市,三民區,1035,205,487,692,74,766,1079,70.99%,19%,1
高雄市,三民區,1036,287,551,838,64,902,1492,60.46%,19.24%,1
高雄市,三民區,1037,213,416,629,37,666,1020,65.29%,20.88%,1
高雄市,三民區,1038,209,412,621,11,632,1001,63.14%,20.88%,1
高雄市,三民區,1039,287,623,910,42,952,1581,60.22%,18.15%,1
高雄市,三民區,1040,278,565,843,36,879,1471,59.76%,18.9%,1
高雄市,三民區,1041,258,453,711,16,727,1151,63.16%,22.42%,1
高雄市,三民區,1042,267,563,830,46,876,1334,65.67%,20.01%,1
高雄市,三民區,1043,227,505,732,41,773,1275,60.63%,17.8%,1
高雄市,三民區,1044,259,478,737,34,771,1688,45.68%,15.34%,1
高雄市,三民區,1045,245,466,711,29,740,1214,60.96%,20.18%,1
高雄市,三民區,1046,248,478,726,16,742,1149,64.58%,21.58%,1
高雄市,三民區,1047,316,626,942,71,1013,1667,60.77%,18.96%,1
高雄市,三民區,1048,352,584,936,28,964,1786,53.98%,19.71%,1
高雄市,三民區,1049,158,377,535,20,555,896,61.94%,17.63%,1
高雄市,三民區,1050,165,372,537,44,581,925,62.81%,17.84%,1
高雄市,三民區,1051,138,285,423,44,467,684,68.27%,20.18%,1
高雄市,三民區,1052,411,187,598,60,658,981,67.07%,41.9%,1
高雄市,三民區,1053,221,476,697,66,763,1383,55.17%,15.98%,1
高雄市,三民區,1054,261,537,798,39,837,1382,60.56%,18.89%,1
高雄市,三民區,1055,157,299,456,19,475,808,58.79%,19.43%,1
高雄市,三民區,1056,252,456,708,22,730,1197,60.99%,21.05%,1
高雄市,三民區,1057,219,526,745,39,784,1344,58.33%,16.29%,1
高雄市,三民區,1058,269,515,784,54,838,1344,62.35%,20.01%,1
高雄市,三民區,1059,267,540,807,14,821,1359,60.41%,19.65%,1
高雄市,三民區,1060,221,414,635,48,683,1073,63.65%,20.6%,1
高雄市,三民區,1061,220,421,641,37,678,1186,57.17%,18.55%,1
高雄市,三民區,1062,335,635,970,66,1036,1749,59.23%,19.15%,1
高雄市,三民區,1063,154,313,467,16,483,877,55.07%,17.56%,1
高雄市,三民區,1064,268,578,846,81,927,1402,66.12%,19.12%,1
高雄市,三民區,1065,142,338,480,23,503,769,65.41%,18.47%,1
高雄市,三民區,1066,228,495,723,43,766,1207,63.46%,18.89%,1
高雄市,三民區,1067,224,417,641,40,681,1270,53.62%,17.64%,1
高雄市,三民區,1068,253,450,703,40,743,1248,59.54%,20.27%,1
高雄市,三民區,1069,247,493,740,54,794,1263,62.87%,19.56%,1
高雄市,三民區,1070,196,448,644,33,677,1101,61.49%,17.8%,1
高雄市,三民區,1071,236,436,672,23,695,1116,62.28%,21.15%,1
高雄市,三民區,1072,225,451,676,37,713,1152,61.89%,19.53%,1
高雄市,三民區,1073,214,407,621,46,667,1057,63.1%,20.25%,1
高雄市,三民區,1074,157,361,518,46,564,971,58.08%,16.17%,1
高雄市,三民區,1075,193,410,603,16,619,1062,58.29%,18.17%,1
高雄市,新興區,1098,162,307,469,26,495,828,59.78%,19.57%,1
高雄市,新興區,1099,202,389,591,47,638,963,66.25%,20.98%,1
高雄市,新興區,1100,190,390,580,23,603,1075,56.09%,17.67%,1
高雄市,新興區,1101,323,546,869,18,887,1488,59.61%,21.71%,1
高雄市,新興區,1102,307,538,845,29,874,1438,60.78%,21.35%,1
高雄市,新興區,1103,216,390,606,36,642,1049,61.2%,20.59%,1
高雄市,新興區,1104,276,572,848,73,921,1378,66.84%,20.03%,1
高雄市,新興區,1105,129,288,417,25,442,666,66.37%,19.37%,1
高雄市,新興區,1106,202,381,583,15,598,981,60.96%,20.59%,1
高雄市,新興區,1107,194,395,589,30,619,933,66.35%,20.79%,1
高雄市,新興區,1108,174,389,563,22,585,987,59.27%,17.63%,1
高雄市,新興區,1109,185,415,600,29,629,988,63.66%,18.72%,1
高雄市,新興區,1110,150,312,462,32,494,735,67.21%,20.41%,1
高雄市,新興區,1111,282,485,767,28,795,1317,60.36%,21.41%,1
高雄市,新興區,1112,142,293,435,16,451,800,56.38%,17.75%,1
高雄市,新興區,1113,176,410,586,32,618,968,63.84%,18.18%,1
高雄市,新興區,1114,174,380,554,16,570,913,62.43%,19.06%,1
高雄市,新興區,1115,336,536,872,20,892,1389,64.22%,24.19%,1
高雄市,新興區,1116,287,507,794,40,834,1228,67.92%,23.37%,1
高雄市,新興區,1117,245,465,710,56,766,1211,63.25%,20.23%,1
高雄市,新興區,1118,223,443,666,24,690,1101,62.67%,20.25%,1
高雄市,新興區,1119,221,250,471,14,485,752,64.49%,29.39%,1
高雄市,新興區,1120,223,368,591,30,621,873,71.13%,25.54%,1
高雄市,新興區,1121,323,607,930,38,968,1609,60.16%,20.07%,1
高雄市,新興區,1122,374,678,1052,51,1103,1736,63.54%,21.54%,1
高雄市,新興區,1123,231,488,719,26,745,1258,59.22%,18.36%,1
高雄市,新興區,1124,259,391,650,42,692,1105,62.62%,23.44%,1
高雄市,新興區,1125,152,343,495,43,538,851,63.22%,17.86%,1
高雄市,新興區,1126,207,402,609,35,644,1011,63.7%,20.47%,1
高雄市,新興區,1127,191,376,567,53,620,888,69.82%,21.51%,1
高雄市,新興區,1128,209,381,590,31,621,1005,61.79%,20.8%,1
高雄市,新興區,1129,201,419,620,13,633,1375,46.04%,14.62%,1
高雄市,新興區,1130,313,506,819,38,857,1388,61.74%,22.55%,1
高雄市,新興區,1131,125,266,391,44,435,719,60.5%,17.39%,1
高雄市,新興區,1132,210,399,609,51,660,1077,61.28%,19.5%,1
高雄市,新興區,1133,160,278,438,16,454,875,51.89%,18.29%,1
高雄市,新興區,1134,186,330,516,18,534,936,57.05%,19.87%,1
高雄市,新興區,1135,191,324,515,49,564,944,59.75%,20.23%,1
高雄市,新興區,1136,156,278,434,30,464,833,55.7%,18.73%,1
高雄市,新興區,1137,138,282,420,16,436,708,61.58%,19.49%,1
高雄市,新興區,1138,158,264,422,17,439,741,59.24%,21.32%,1
高雄市,新興區,1139,217,421,638,27,665,1235,53.85%,17.57%,1
高雄市,前金區,1076,127,246,373,18,391,673,58.1%,18.87%,1
高雄市,前金區,1077,194,415,609,27,636,1022,62.23%,18.98%,1
高雄市,前金區,1078,226,501,727,34,761,1324,57.48%,17.07%,1
高雄市,前金區,1079,165,313,478,35,513,839,61.14%,19.67%,1
高雄市,前金區,1080,203,356,559,51,610,975,62.56%,20.82%,1
高雄市,前金區,1081,358,666,1024,48,1072,1806,59.36%,19.82%,1
高雄市,前金區,1082,345,682,1027,35,1062,1781,59.63%,19.37%,1
高雄市,前金區,1083,146,290,436,20,456,717,63.6%,20.36%,1
高雄市,前金區,1084,215,414,629,14,643,1097,58.61%,19.6%,1
高雄市,前金區,1085,317,623,940,21,961,1633,58.85%,19.41%,1
高雄市,前金區,1086,169,321,490,27,517,759,68.12%,22.27%,1
高雄市,前金區,1087,210,375,585,37,622,948,65.61%,22.15%,1
高雄市,前金區,1088,177,322,499,62,561,1009,55.6%,17.54%,1
高雄市,前金區,1089,185,379,564,23,587,945,62.12%,19.58%,1
高雄市,前金區,1090,165,293,458,15,473,772,61.27%,21.37%,1
高雄市,前金區,1091,157,311,468,25,493,757,65.13%,20.74%,1
高雄市,前金區,1092,211,431,642,28,670,1047,63.99%,20.15%,1
高雄市,前金區,1093,178,410,588,39,627,985,63.65%,18.07%,1
高雄市,前金區,1094,295,627,922,27,949,1674,56.69%,17.62%,1
高雄市,前金區,1095,192,420,612,29,641,1088,58.92%,17.65%,1
高雄市,前金區,1096,187,372,559,45,604,893,67.64%,20.94%,1
高雄市,前金區,1097,227,449,676,25,701,1184,59.21%,19.17%,1
高雄市,苓雅區,1140,140,294,434,17,451,718,62.81%,19.5%,1
高雄市,苓雅區,1141,257,573,830,36,866,1492,58.04%,17.23%,1
高雄市,苓雅區,1142,220,482,702,42,744,1210,61.49%,18.18%,1
高雄市,苓雅區,1143,279,565,844,25,869,1617,53.74%,17.25%,1
高雄市,苓雅區,1144,270,576,846,49,895,1428,62.68%,18.91%,1
高雄市,苓雅區,1145,250,498,748,36,784,1444,54.29%,17.31%,1
高雄市,苓雅區,1146,264,542,806,57,863,1452,59.44%,18.18%,1
高雄市,苓雅區,1147,105,221,326,28,354,554,63.9%,18.95%,1
高雄市,苓雅區,1148,164,374,538,15,553,950,58.21%,17.26%,1
高雄市,苓雅區,1149,171,358,529,17,546,978,55.83%,17.48%,1
高雄市,苓雅區,1150,269,602,871,37,908,1673,54.27%,16.08%,1
高雄市,苓雅區,1151,382,686,1068,50,1118,2045,54.67%,18.68%,1
高雄市,苓雅區,1152,165,382,547,48,595,939,63.37%,17.57%,1
高雄市,苓雅區,1153,244,426,670,38,708,1284,55.14%,19%,1
高雄市,苓雅區,1154,174,366,540,25,565,908,62.22%,19.16%,1
高雄市,苓雅區,1155,182,276,458,19,477,838,56.92%,21.72%,1
高雄市,苓雅區,1156,252,499,751,36,787,1267,62.12%,19.89%,1
高雄市,苓雅區,1157,200,408,608,51,659,994,66.3%,20.12%,1
高雄市,苓雅區,1158,125,294,419,15,434,774,56.07%,16.15%,1
高雄市,苓雅區,1159,242,411,653,26,679,1121,60.57%,21.59%,1
高雄市,苓雅區,1160,288,569,857,40,897,1474,60.85%,19.54%,1
高雄市,苓雅區,1161,277,589,866,64,930,1525,60.98%,18.16%,1
高雄市,苓雅區,1162,227,449,676,27,703,1147,61.29%,19.79%,1
高雄市,苓雅區,1163,222,398,620,38,658,1014,64.89%,21.89%,1
高雄市,苓雅區,1164,322,550,872,46,918,1496,61.36%,21.52%,1
高雄市,苓雅區,1165,289,615,904,51,955,1499,63.71%,19.28%,1
高雄市,苓雅區,1166,228,457,685,28,713,1138,62.65%,20.04%,1
高雄市,苓雅區,1167,163,382,545,37,582,839,69.37%,19.43%,1
高雄市,苓雅區,1168,235,475,710,33,743,2088,35.58%,11.25%,1
高雄市,苓雅區,1169,342,650,992,23,1015,1648,61.59%,20.75%,1
高雄市,苓雅區,1170,290,624,914,43,957,1623,58.96%,17.87%,1
高雄市,苓雅區,1171,402,817,1219,45,1264,1932,65.42%,20.81%,1
高雄市,苓雅區,1172,250,520,770,16,786,1127,69.74%,22.18%,1
高雄市,苓雅區,1173,267,526,793,17,810,1156,70.07%,23.1%,1
高雄市,苓雅區,1174,303,606,909,29,938,1465,64.03%,20.68%,1
高雄市,苓雅區,1175,116,243,359,21,380,690,55.07%,16.81%,1
高雄市,苓雅區,1176,227,461,688,73,761,1283,59.31%,17.69%,1
高雄市,苓雅區,1177,270,548,818,63,881,1432,61.52%,18.85%,1
高雄市,苓雅區,1178,246,541,787,28,815,1313,62.07%,18.74%,1
高雄市,苓雅區,1179,289,569,858,33,891,1579,56.43%,18.3%,1
高雄市,苓雅區,1180,260,553,813,53,866,1385,62.53%,18.77%,1
高雄市,苓雅區,1181,268,606,874,43,917,1449,63.29%,18.5%,1
高雄市,苓雅區,1182,390,743,1133,36,1169,1834,63.74%,21.26%,1
高雄市,苓雅區,1183,301,553,854,53,907,1436,63.16%,20.96%,1
高雄市,苓雅區,1184,303,601,904,25,929,1431,64.92%,21.17%,1
高雄市,苓雅區,1185,360,439,799,22,821,1248,65.79%,28.85%,1
高雄市,苓雅區,1186,329,572,901,43,944,1470,64.22%,22.38%,1
高雄市,苓雅區,1187,294,676,970,52,1022,1540,66.36%,19.09%,1
高雄市,苓雅區,1188,293,569,862,21,883,1374,64.26%,21.32%,1
高雄市,苓雅區,1189,185,358,543,18,561,839,66.87%,22.05%,1
高雄市,苓雅區,1190,242,444,686,23,709,1022,69.37%,23.68%,1
高雄市,苓雅區,1191,201,476,677,17,694,1062,65.35%,18.93%,1
高雄市,苓雅區,1192,252,423,675,11,686,1078,63.64%,23.38%,1
高雄市,苓雅區,1193,226,485,711,18,729,1117,65.26%,20.23%,1
高雄市,苓雅區,1194,270,635,905,45,950,1516,62.66%,17.81%,1
高雄市,苓雅區,1195,297,487,784,107,891,1440,61.88%,20.63%,1
高雄市,苓雅區,1196,167,308,475,43,518,839,61.74%,19.9%,1
高雄市,苓雅區,1197,153,343,496,22,518,888,58.33%,17.23%,1
高雄市,苓雅區,1198,257,437,694,29,723,1101,65.67%,23.34%,1
高雄市,苓雅區,1199,229,444,673,38,711,1004,70.82%,22.81%,1
高雄市,苓雅區,1200,256,591,847,43,890,1427,62.37%,17.94%,1
高雄市,苓雅區,1201,221,475,696,24,720,1168,61.64%,18.92%,1
高雄市,苓雅區,1202,276,489,765,35,800,1184,67.57%,23.31%,1
高雄市,苓雅區,1203,203,400,603,26,629,974,64.58%,20.84%,1
高雄市,苓雅區,1204,153,306,459,9,468,849,55.12%,18.02%,1
高雄市,苓雅區,1205,545,535,1080,40,1120,1821,61.5%,29.93%,1
高雄市,苓雅區,1206,267,472,739,45,784,1306,60.03%,20.44%,1
高雄市,苓雅區,1207,260,490,750,18,768,1185,64.81%,21.94%,1
高雄市,苓雅區,1208,288,534,822,39,861,1415,60.85%,20.35%,1
高雄市,苓雅區,1209,225,379,604,38,642,962,66.74%,23.39%,1
高雄市,苓雅區,1210,171,377,548,45,593,964,61.51%,17.74%,1
高雄市,苓雅區,1211,315,595,910,29,939,1524,61.61%,20.67%,1
高雄市,苓雅區,1212,236,644,880,23,903,1455,62.06%,16.22%,1
高雄市,苓雅區,1213,223,436,659,38,697,1272,54.8%,17.53%,1
高雄市,苓雅區,1214,267,437,704,21,725,1256,57.72%,21.26%,1
高雄市,苓雅區,1215,191,482,673,26,699,1203,58.1%,15.88%,1
高雄市,苓雅區,1216,184,464,648,28,676,1062,63.65%,17.33%,1
高雄市,苓雅區,1217,180,338,518,60,578,850,68%,21.18%,1
高雄市,苓雅區,1218,218,408,626,69,695,1010,68.81%,21.58%,1
高雄市,苓雅區,1219,194,439,633,23,656,1118,58.68%,17.35%,1
高雄市,苓雅區,1220,192,282,474,37,511,937,54.54%,20.49%,1
高雄市,苓雅區,1221,232,541,773,23,796,1493,53.32%,15.54%,1
高雄市,苓雅區,1222,254,476,730,21,751,1183,63.48%,21.47%,1
高雄市,苓雅區,1223,227,465,692,23,715,1318,54.25%,17.22%,1
高雄市,苓雅區,1224,249,524,773,50,823,1362,60.43%,18.28%,1
高雄市,苓雅區,1225,202,431,633,50,683,1102,61.98%,18.33%,1
高雄市,苓雅區,1226,265,580,845,40,885,1481,59.76%,17.89%,1
高雄市,苓雅區,1227,179,367,546,38,584,878,66.51%,20.39%,1
高雄市,苓雅區,1228,153,324,477,18,495,908,54.52%,16.85%,1
高雄市,苓雅區,1229,227,419,646,54,700,1056,66.29%,21.5%,1
高雄市,苓雅區,1230,185,417,602,29,631,1091,57.84%,16.96%,1
高雄市,苓雅區,1231,206,388,594,23,617,976,63.22%,21.11%,1
高雄市,苓雅區,1232,235,455,690,27,717,1063,67.45%,22.11%,1
高雄市,苓雅區,1233,332,562,894,45,939,1484,63.27%,22.37%,1
高雄市,苓雅區,1234,270,494,764,35,799,1290,61.94%,20.93%,1
高雄市,苓雅區,1235,329,695,1024,53,1077,1740,61.9%,18.91%,1
高雄市,苓雅區,1236,273,658,931,43,974,1594,61.1%,17.13%,1
高雄市,苓雅區,1237,340,606,946,21,967,1648,58.68%,20.63%,1
高雄市,苓雅區,1238,228,542,770,42,812,1236,65.7%,18.45%,1
高雄市,苓雅區,1239,220,491,711,40,751,1211,62.01%,18.17%,1
高雄市,苓雅區,1240,226,531,757,20,777,1283,60.56%,17.61%,1
高雄市,苓雅區,1241,332,748,1080,68,1148,1804,63.64%,18.4%,1
高雄市,苓雅區,1242,316,713,1029,49,1078,1718,62.75%,18.39%,1
高雄市,苓雅區,1243,269,519,788,33,821,1297,63.3%,20.74%,1
高雄市,苓雅區,1244,200,637,837,55,892,1449,61.56%,13.8%,1
高雄市,苓雅區,1245,226,542,768,26,794,1307,60.75%,17.29%,1
高雄市,苓雅區,1246,250,456,706,47,753,1184,63.6%,21.11%,1
高雄市,苓雅區,1247,280,478,758,61,819,1250,65.52%,22.4%,1
高雄市,苓雅區,1248,234,478,712,27,739,1248,59.21%,18.75%,1
高雄市,苓雅區,1249,220,539,759,20,779,1283,60.72%,17.15%,1
高雄市,苓雅區,1250,190,488,678,25,703,1121,62.71%,16.95%,1
高雄市,苓雅區,1251,228,518,746,21,767,1258,60.97%,18.12%,1
高雄市,苓雅區,1252,266,521,787,27,814,1339,60.79%,19.87%,1
高雄市,苓雅區,1253,344,763,1107,49,1156,1986,58.21%,17.32%,1
高雄市,苓雅區,1254,183,317,500,27,527,1028,51.26%,17.8%,1
高雄市,苓雅區,1255,202,378,580,13,593,948,62.55%,21.31%,1
高雄市,前鎮區,1484,279,627,906,98,1004,1809,55.5%,15.42%,1
高雄市,前鎮區,1485,289,654,943,60,1003,1835,54.66%,15.75%,1
高雄市,前鎮區,1486,291,503,794,50,844,1890,44.66%,15.4%,1
高雄市,前鎮區,1487,324,640,964,53,1017,2013,50.52%,16.1%,1
高雄市,前鎮區,1488,279,623,902,51,953,1776,53.66%,15.71%,1
高雄市,前鎮區,1489,279,492,771,71,842,1705,49.38%,16.36%,1
高雄市,前鎮區,1490,129,231,360,61,421,672,62.65%,19.2%,1
高雄市,前鎮區,1491,251,524,775,80,855,1726,49.54%,14.54%,1
高雄市,前鎮區,1492,305,500,805,104,909,1597,56.92%,19.1%,1
高雄市,前鎮區,1493,352,582,934,74,1008,1690,59.64%,20.83%,1
高雄市,前鎮區,1494,180,458,638,54,692,1080,64.07%,16.67%,1
高雄市,前鎮區,1495,218,498,716,57,773,1159,66.7%,18.81%,1
高雄市,前鎮區,1496,219,463,682,59,741,1314,56.39%,16.67%,1
高雄市,前鎮區,1497,159,364,523,42,565,896,63.06%,17.75%,1
高雄市,前鎮區,1498,183,370,553,44,597,1002,59.58%,18.26%,1
高雄市,前鎮區,1499,339,654,993,83,1076,2765,38.92%,12.26%,1
高雄市,前鎮區,1500,98,330,428,57,485,600,80.83%,16.33%,1
高雄市,前鎮區,1501,187,337,524,33,557,1466,37.99%,12.76%,1
高雄市,前鎮區,1502,239,522,761,51,812,1449,56.04%,16.49%,1
高雄市,前鎮區,1503,151,361,512,48,560,991,56.51%,15.24%,1
高雄市,前鎮區,1504,208,486,694,72,766,1248,61.38%,16.67%,1
高雄市,前鎮區,1505,204,390,594,92,686,1066,64.35%,19.14%,1
高雄市,前鎮區,1506,132,240,372,27,399,706,56.52%,18.7%,1
高雄市,前鎮區,1507,101,264,365,27,392,713,54.98%,14.17%,1
高雄市,前鎮區,1508,244,449,693,35,728,1344,54.17%,18.15%,1
高雄市,前鎮區,1509,154,328,482,46,528,856,61.68%,17.99%,1
高雄市,前鎮區,1510,156,284,440,47,487,873,55.78%,17.87%,1
高雄市,前鎮區,1511,176,381,557,43,600,1114,53.86%,15.8%,1
高雄市,前鎮區,1512,210,357,567,13,580,1112,52.16%,18.88%,1
高雄市,前鎮區,1513,191,352,543,58,601,1044,57.57%,18.3%,1
高雄市,前鎮區,1514,166,320,486,33,519,940,55.21%,17.66%,1
高雄市,前鎮區,1515,202,441,643,70,713,1342,53.13%,15.05%,1
高雄市,前鎮區,1516,317,566,883,48,931,1402,66.41%,22.61%,1
高雄市,前鎮區,1517,278,500,778,36,814,1320,61.67%,21.06%,1
高雄市,前鎮區,1518,178,359,537,42,579,958,60.44%,18.58%,1
高雄市,前鎮區,1519,269,568,837,40,877,1276,68.73%,21.08%,1
高雄市,前鎮區,1520,288,566,854,65,919,1459,62.99%,19.74%,1
高雄市,前鎮區,1521,131,249,380,11,391,761,51.38%,17.21%,1
高雄市,前鎮區,1522,204,387,591,18,609,1093,55.72%,18.66%,1
高雄市,前鎮區,1523,221,715,936,30,966,1521,63.51%,14.53%,1
高雄市,前鎮區,1524,242,709,951,21,972,1557,62.43%,15.54%,1
高雄市,前鎮區,1525,302,656,958,30,988,1821,54.26%,16.58%,1
高雄市,前鎮區,1526,150,560,710,27,737,1066,69.14%,14.07%,1
高雄市,前鎮區,1527,174,494,668,12,680,1046,65.01%,16.63%,1
高雄市,前鎮區,1528,323,639,962,40,1002,1709,58.63%,18.9%,1
高雄市,前鎮區,1529,309,686,995,69,1064,1723,61.75%,17.93%,1
高雄市,前鎮區,1530,260,498,758,33,791,1202,65.81%,21.63%,1
高雄市,前鎮區,1531,291,540,831,34,865,1279,67.63%,22.75%,1
高雄市,前鎮區,1532,301,642,943,37,980,1513,64.77%,19.89%,1
高雄市,前鎮區,1533,231,506,737,16,753,1260,59.76%,18.33%,1
高雄市,前鎮區,1534,226,458,684,72,756,1139,66.37%,19.84%,1
高雄市,前鎮區,1535,260,473,733,33,766,1140,67.19%,22.81%,1
高雄市,前鎮區,1536,295,600,895,68,963,1462,65.87%,20.18%,1
高雄市,前鎮區,1537,263,554,817,31,848,1359,62.4%,19.35%,1
高雄市,前鎮區,1538,344,681,1025,56,1081,2037,53.07%,16.89%,1
高雄市,前鎮區,1539,264,525,789,14,803,1410,56.95%,18.72%,1
高雄市,前鎮區,1540,243,506,749,17,766,1307,58.61%,18.59%,1
高雄市,前鎮區,1541,264,551,815,71,886,1512,58.6%,17.46%,1
高雄市,前鎮區,1542,299,557,856,60,916,1491,61.44%,20.05%,1
高雄市,前鎮區,1543,277,619,896,59,955,1621,58.91%,17.09%,1
高雄市,前鎮區,1544,262,503,765,49,814,1522,53.48%,17.21%,1
高雄市,前鎮區,1545,300,611,911,51,962,1593,60.39%,18.83%,1
高雄市,前鎮區,1546,379,712,1091,67,1158,1885,61.43%,20.11%,1
高雄市,前鎮區,1547,382,710,1092,70,1162,1870,62.14%,20.43%,1
高雄市,前鎮區,1548,278,549,827,23,850,1388,61.24%,20.03%,1
高雄市,前鎮區,1549,244,534,778,53,831,1348,61.65%,18.1%,1
高雄市,前鎮區,1550,198,493,691,89,780,1341,58.17%,14.77%,1
高雄市,前鎮區,1551,287,563,850,33,883,1364,64.74%,21.04%,1
高雄市,前鎮區,1552,265,512,777,58,835,1367,61.08%,19.39%,1
高雄市,前鎮區,1553,231,482,713,70,783,1326,59.05%,17.42%,1
高雄市,前鎮區,1554,202,385,587,33,620,1059,58.55%,19.07%,1
高雄市,前鎮區,1555,224,452,676,20,696,1119,62.2%,20.02%,1
高雄市,前鎮區,1556,306,542,848,32,880,1565,56.23%,19.55%,1
高雄市,前鎮區,1557,288,562,850,65,915,1549,59.07%,18.59%,1
高雄市,前鎮區,1558,376,702,1078,19,1097,1691,64.87%,22.24%,1
高雄市,前鎮區,1559,362,708,1070,27,1097,1837,59.72%,19.71%,1
高雄市,前鎮區,1560,208,466,674,15,689,1092,63.1%,19.05%,1
高雄市,前鎮區,1561,227,438,665,49,714,1126,63.41%,20.16%,1
高雄市,前鎮區,1562,208,435,643,64,707,1215,58.19%,17.12%,1
高雄市,前鎮區,1563,296,541,837,39,876,1443,60.71%,20.51%,1
高雄市,前鎮區,1564,304,666,970,16,986,1448,68.09%,20.99%,1
高雄市,前鎮區,1565,319,635,954,60,1014,1648,61.53%,19.36%,1
高雄市,前鎮區,1566,253,593,846,60,906,1603,56.52%,15.78%,1
高雄市,前鎮區,1567,285,502,787,30,817,1596,51.19%,17.86%,1
高雄市,前鎮區,1568,207,538,745,27,772,1450,53.24%,14.28%,1
高雄市,前鎮區,1569,253,516,769,81,850,1510,56.29%,16.75%,1
高雄市,前鎮區,1570,323,651,974,67,1041,1647,63.21%,19.61%,1
高雄市,前鎮區,1571,220,506,726,57,783,1342,58.35%,16.39%,1
高雄市,前鎮區,1572,249,467,716,41,757,1384,54.7%,17.99%,1
高雄市,前鎮區,1573,261,531,792,53,845,1479,57.13%,17.65%,1
高雄市,前鎮區,1574,212,672,884,27,911,1546,58.93%,13.71%,1
高雄市,前鎮區,1575,372,567,939,35,974,1595,61.07%,23.32%,1
高雄市,前鎮區,1576,207,491,698,50,748,1201,62.28%,17.24%,1
高雄市,前鎮區,1577,183,377,560,22,582,1082,53.79%,16.91%,1
高雄市,前鎮區,1578,161,356,517,31,548,996,55.02%,16.16%,1
高雄市,前鎮區,1579,167,346,513,71,584,932,62.66%,17.92%,1
高雄市,前鎮區,1580,208,449,657,42,699,1146,60.99%,18.15%,1
高雄市,前鎮區,1581,232,413,645,28,673,1096,61.41%,21.17%,1
高雄市,前鎮區,1582,293,539,832,22,854,1332,64.11%,22%,1
高雄市,前鎮區,1583,238,432,670,32,702,1175,59.74%,20.26%,1
高雄市,前鎮區,1584,182,376,558,46,604,986,61.26%,18.46%,1
高雄市,前鎮區,1585,275,494,769,56,825,1316,62.69%,20.9%,1
高雄市,前鎮區,1586,263,512,775,58,833,1559,53.43%,16.87%,1
高雄市,前鎮區,1587,304,633,937,64,1001,1622,61.71%,18.74%,1
高雄市,前鎮區,1588,227,506,733,27,760,1310,58.02%,17.33%,1
高雄市,前鎮區,1589,254,505,759,60,819,1299,63.05%,19.55%,1
高雄市,前鎮區,1590,223,520,743,54,797,1191,66.92%,18.72%,1
高雄市,前鎮區,1591,235,517,752,28,780,1375,56.73%,17.09%,1
高雄市,前鎮區,1592,241,520,761,28,789,1338,58.97%,18.01%,1
高雄市,前鎮區,1593,234,418,652,22,674,1175,57.36%,19.91%,1
高雄市,前鎮區,1594,247,578,825,28,853,1357,62.86%,18.2%,1
高雄市,前鎮區,1595,136,595,731,50,781,1187,65.8%,11.46%,1
高雄市,前鎮區,1596,189,465,654,35,689,1164,59.19%,16.24%,1
高雄市,前鎮區,1597,154,562,716,62,778,1219,63.82%,12.63%,1
高雄市,前鎮區,1598,267,517,784,16,800,1428,56.02%,18.7%,1
高雄市,前鎮區,1599,272,534,806,75,881,1495,58.93%,18.19%,1
高雄市,前鎮區,1600,348,563,911,37,948,1531,61.92%,22.73%,1
高雄市,前鎮區,1601,308,549,857,48,905,1509,59.97%,20.41%,1
高雄市,前鎮區,1602,258,598,856,58,914,1591,57.45%,16.22%,1
高雄市,旗津區,0869,246,414,660,85,745,1177,63.3%,20.9%,1
高雄市,旗津區,0870,153,384,537,47,584,1109,52.66%,13.8%,1
高雄市,旗津區,0871,279,487,766,23,789,1642,48.05%,16.99%,1
高雄市,旗津區,0872,190,408,598,73,671,1209,55.5%,15.72%,1
高雄市,旗津區,0873,198,317,515,45,560,1112,50.36%,17.81%,1
高雄市,旗津區,0874,267,524,791,75,866,1483,58.4%,18%,1
高雄市,旗津區,0875,191,451,642,31,673,1460,46.1%,13.08%,1
高雄市,旗津區,0876,300,530,830,115,945,1572,60.11%,19.08%,1
高雄市,旗津區,0877,209,441,650,30,680,1384,49.13%,15.1%,1
高雄市,旗津區,0878,194,466,660,33,693,1390,49.86%,13.96%,1
高雄市,旗津區,0879,192,388,580,44,624,1239,50.36%,15.5%,1
高雄市,旗津區,0880,241,750,991,99,1090,2045,53.3%,11.78%,1
高雄市,旗津區,0881,127,308,435,22,457,893,51.18%,14.22%,1
高雄市,旗津區,0882,292,605,897,82,979,1866,52.47%,15.65%,1
高雄市,旗津區,0883,270,509,779,43,822,1874,43.86%,14.41%,1
高雄市,旗津區,0884,128,274,402,58,460,893,51.51%,14.33%,1
高雄市,旗津區,0885,240,416,656,32,688,1215,56.63%,19.75%,1
高雄市,旗津區,0886,217,406,623,32,655,1297,50.5%,16.73%,1
高雄市,小港區,1603,228,478,706,24,730,1108,65.88%,20.58%,1
高雄市,小港區,1604,204,484,688,54,742,1171,63.36%,17.42%,1
高雄市,小港區,1605,356,617,973,16,989,1557,63.52%,22.86%,1
高雄市,小港區,1606,253,622,875,23,898,1668,53.84%,15.17%,1
高雄市,小港區,1607,215,513,728,21,749,1183,63.31%,18.17%,1
高雄市,小港區,1608,255,557,812,30,842,1372,61.37%,18.59%,1
高雄市,小港區,1609,304,703,1007,56,1063,1737,61.2%,17.5%,1
高雄市,小港區,1610,297,545,842,64,906,1586,57.12%,18.73%,1
高雄市,小港區,1611,233,574,807,56,863,1558,55.39%,14.96%,1
高雄市,小港區,1612,262,538,800,59,859,1284,66.9%,20.4%,1
高雄市,小港區,1613,243,497,740,40,780,1249,62.45%,19.46%,1
高雄市,小港區,1614,370,665,1035,82,1117,2400,46.54%,15.42%,1
高雄市,小港區,1615,225,477,702,32,734,1181,62.15%,19.05%,1
高雄市,小港區,1616,190,410,600,28,628,1079,58.2%,17.61%,1
高雄市,小港區,1617,276,468,744,45,789,1335,59.1%,20.67%,1
高雄市,小港區,1618,230,490,720,48,768,1241,61.89%,18.53%,1
高雄市,小港區,1619,256,580,836,45,881,1513,58.23%,16.92%,1
高雄市,小港區,1620,229,564,793,50,843,1349,62.49%,16.98%,1
高雄市,小港區,1621,252,562,814,41,855,1483,57.65%,16.99%,1
高雄市,小港區,1622,298,541,839,24,863,1451,59.48%,20.54%,1
高雄市,小港區,1623,212,442,654,26,680,1241,54.79%,17.08%,1
高雄市,小港區,1624,261,527,788,57,845,1262,66.96%,20.68%,1
高雄市,小港區,1625,315,728,1043,65,1108,1813,61.11%,17.37%,1
高雄市,小港區,1626,312,614,926,37,963,1877,51.31%,16.62%,1
高雄市,小港區,1627,248,530,778,26,804,1391,57.8%,17.83%,1
高雄市,小港區,1628,280,586,866,35,901,1453,62.01%,19.27%,1
高雄市,小港區,1629,246,539,785,32,817,1374,59.46%,17.9%,1
高雄市,小港區,1630,236,520,756,39,795,1348,58.98%,17.51%,1
高雄市,小港區,1631,237,554,791,46,837,1334,62.74%,17.77%,1
高雄市,小港區,1632,290,522,812,27,839,1433,58.55%,20.24%,1
高雄市,小港區,1633,279,481,760,18,778,1448,53.73%,19.27%,1
高雄市,小港區,1634,306,601,907,53,960,1488,64.52%,20.56%,1
高雄市,小港區,1635,231,519,750,50,800,1278,62.6%,18.08%,1
高雄市,小港區,1636,275,583,858,38,896,1306,68.61%,21.06%,1
高雄市,小港區,1637,290,642,932,68,1000,1625,61.54%,17.85%,1
高雄市,小港區,1638,304,686,990,63,1053,1640,64.21%,18.54%,1
高雄市,小港區,1639,243,597,840,46,886,1506,58.83%,16.14%,1
高雄市,小港區,1640,240,506,746,55,801,1438,55.7%,16.69%,1
高雄市,小港區,1641,229,482,711,32,743,1105,67.24%,20.72%,1
高雄市,小港區,1642,189,446,635,22,657,1167,56.3%,16.2%,1
高雄市,小港區,1643,261,600,861,31,892,1420,62.82%,18.38%,1
高雄市,小港區,1644,284,575,859,51,910,1380,65.94%,20.58%,1
高雄市,小港區,1645,221,478,699,29,728,1239,58.76%,17.84%,1
高雄市,小港區,1646,620,314,934,40,974,1563,62.32%,39.67%,1
高雄市,小港區,1647,257,682,939,53,992,1644,60.34%,15.63%,1
高雄市,小港區,1648,595,440,1035,64,1099,1895,57.99%,31.4%,1
高雄市,小港區,1649,287,640,927,79,1006,1748,57.55%,16.42%,1
高雄市,小港區,1650,267,630,897,57,954,1579,60.42%,16.91%,1
高雄市,小港區,1651,391,756,1147,38,1185,2135,55.5%,18.31%,1
高雄市,小港區,1652,277,686,963,55,1018,1728,58.91%,16.03%,1
高雄市,小港區,1653,361,692,1053,43,1096,2022,54.2%,17.85%,1
高雄市,小港區,1654,178,461,639,28,667,1329,50.19%,13.39%,1
高雄市,小港區,1655,220,515,735,30,765,1320,57.95%,16.67%,1
高雄市,小港區,1656,219,491,710,71,781,1267,61.64%,17.28%,1
高雄市,小港區,1657,245,509,754,76,830,1298,63.94%,18.88%,1
高雄市,小港區,1658,270,520,790,28,818,1289,63.46%,20.95%,1
高雄市,小港區,1659,263,634,897,47,944,1534,61.54%,17.14%,1
高雄市,小港區,1660,247,619,866,31,897,1494,60.04%,16.53%,1
高雄市,小港區,1661,218,557,775,61,836,1377,60.71%,15.83%,1
高雄市,小港區,1662,261,553,814,49,863,1344,64.21%,19.42%,1
高雄市,小港區,1663,277,559,836,39,875,1508,58.02%,18.37%,1
高雄市,小港區,1664,247,498,745,26,771,1400,55.07%,17.64%,1
高雄市,小港區,1665,261,587,848,48,896,1457,61.5%,17.91%,1
高雄市,小港區,1666,223,538,761,25,786,1392,56.47%,16.02%,1
高雄市,小港區,1667,281,770,1051,48,1099,1983,55.42%,14.17%,1
高雄市,小港區,1668,225,448,673,28,701,1204,58.22%,18.69%,1
高雄市,小港區,1669,262,466,728,33,761,1300,58.54%,20.15%,1
高雄市,小港區,1670,302,763,1065,91,1156,1857,62.25%,16.26%,1
高雄市,小港區,1671,488,393,881,31,912,1566,58.24%,31.16%,1
高雄市,小港區,1672,276,564,840,50,890,1343,66.27%,20.55%,1
高雄市,小港區,1673,259,498,757,66,823,1236,66.59%,20.95%,1
高雄市,小港區,1674,297,624,921,71,992,1564,63.43%,18.99%,1
高雄市,小港區,1675,261,572,833,23,856,1484,57.68%,17.59%,1
高雄市,小港區,1676,256,572,828,29,857,1477,58.02%,17.33%,1
高雄市,小港區,1677,340,570,910,19,929,1482,62.69%,22.94%,1
高雄市,小港區,1678,310,600,910,29,939,1708,54.98%,18.15%,1
高雄市,小港區,1679,304,720,1024,63,1087,1867,58.22%,16.28%,1
高雄市,小港區,1680,335,596,931,17,948,1709,55.47%,19.6%,1
高雄市,小港區,1681,218,517,735,50,785,1425,55.09%,15.3%,1
高雄市,小港區,1682,225,579,804,35,839,1696,49.47%,13.27%,1
高雄市,小港區,1683,242,496,738,40,778,1522,51.12%,15.9%,1
高雄市,小港區,1684,258,577,835,69,904,1531,59.05%,16.85%,1
高雄市,小港區,1685,351,781,1132,103,1235,2215,55.76%,15.85%,1
高雄市,小港區,1686,266,541,807,38,845,1515,55.78%,17.56%,1
高雄市,小港區,1687,276,512,788,27,815,1535,53.09%,17.98%,1
高雄市,小港區,1688,237,453,690,25,715,1276,56.03%,18.57%,1
高雄市,小港區,1689,216,393,609,31,640,1217,52.59%,17.75%,1
高雄市,小港區,1690,246,545,791,65,856,1707,50.15%,14.41%,1
高雄市,小港區,1691,288,641,929,99,1028,1920,53.54%,15%,1
高雄市,鳳山區,1256,219,455,674,45,719,1080,66.57%,20.28%,1
高雄市,鳳山區,1257,159,326,485,33,518,819,63.25%,19.41%,1
高雄市,鳳山區,1258,139,349,488,45,533,851,62.63%,16.33%,1
高雄市,鳳山區,1259,246,398,644,35,679,1075,63.16%,22.88%,1
高雄市,鳳山區,1260,202,533,735,41,776,1223,63.45%,16.52%,1
高雄市,鳳山區,1261,216,511,727,31,758,1207,62.8%,17.9%,1
高雄市,鳳山區,1262,231,475,706,34,740,1339,55.27%,17.25%,1
高雄市,鳳山區,1263,210,400,610,27,637,1188,53.62%,17.68%,1
高雄市,鳳山區,1264,175,423,598,47,645,1055,61.14%,16.59%,1
高雄市,鳳山區,1265,188,400,588,57,645,1109,58.16%,16.95%,1
高雄市,鳳山區,1266,162,315,477,34,511,756,67.59%,21.43%,1
高雄市,鳳山區,1267,196,446,642,33,675,1182,57.11%,16.58%,1
高雄市,鳳山區,1268,269,563,832,67,899,1496,60.09%,17.98%,1
高雄市,鳳山區,1269,357,644,1001,47,1048,2094,50.05%,17.05%,1
高雄市,鳳山區,1270,299,615,914,22,936,1672,55.98%,17.88%,1
高雄市,鳳山區,1271,330,620,950,21,971,1761,55.14%,18.74%,1
高雄市,鳳山區,1272,253,550,803,62,865,1450,59.66%,17.45%,1
高雄市,鳳山區,1273,259,471,730,32,762,1455,52.37%,17.8%,1
高雄市,鳳山區,1274,193,497,690,49,739,1234,59.89%,15.64%,1
高雄市,鳳山區,1275,350,668,1018,50,1068,1713,62.35%,20.43%,1
高雄市,鳳山區,1276,276,596,872,34,906,1698,53.36%,16.25%,1
高雄市,鳳山區,1277,250,469,719,55,774,1247,62.07%,20.05%,1
高雄市,鳳山區,1278,233,402,635,35,670,1087,61.64%,21.44%,1
高雄市,鳳山區,1279,,,,,,,,,
高雄市,鳳山區,1280,226,629,855,45,900,1559,57.73%,14.5%,1
高雄市,鳳山區,1281,228,508,736,28,764,1233,61.96%,18.49%,1
高雄市,鳳山區,1282,256,489,745,47,792,1277,62.02%,20.05%,1
高雄市,鳳山區,1283,264,583,847,21,868,1481,58.61%,17.83%,1
高雄市,鳳山區,1284,240,490,730,24,754,1154,65.34%,20.8%,1
高雄市,鳳山區,1285,314,599,913,17,930,1475,63.05%,21.29%,1
高雄市,鳳山區,1286,205,448,653,29,682,1247,54.69%,16.44%,1
高雄市,鳳山區,1287,346,457,803,52,855,1538,55.59%,22.5%,1
高雄市,鳳山區,1288,195,429,624,32,656,1097,59.8%,17.78%,1
高雄市,鳳山區,1289,242,398,640,21,661,1221,54.14%,19.82%,1
高雄市,鳳山區,1290,265,425,690,41,731,1075,68%,24.65%,1
高雄市,鳳山區,1291,351,682,1033,40,1073,1751,61.28%,20.05%,1
高雄市,鳳山區,1292,346,696,1042,32,1074,1758,61.09%,19.68%,1
高雄市,鳳山區,1293,281,683,964,76,1040,1749,59.46%,16.07%,1
高雄市,鳳山區,1294,309,648,957,19,976,1746,55.9%,17.7%,1
高雄市,鳳山區,1295,297,648,945,31,976,1712,57.01%,17.35%,1
高雄市,鳳山區,1296,232,497,729,23,752,1247,60.3%,18.6%,1
高雄市,鳳山區,1297,276,544,820,46,866,1409,61.46%,19.59%,1
高雄市,鳳山區,1298,277,502,779,35,814,1347,60.43%,20.56%,1
高雄市,鳳山區,1299,326,668,994,22,1016,1771,57.37%,18.41%,1
高雄市,鳳山區,1300,328,562,890,17,907,1537,59.01%,21.34%,1
高雄市,鳳山區,1301,300,641,941,25,966,1605,60.19%,18.69%,1
高雄市,鳳山區,1302,332,466,798,38,836,1375,60.8%,24.15%,1
高雄市,鳳山區,1303,274,565,839,42,881,1393,63.24%,19.67%,1
高雄市,鳳山區,1304,303,546,849,34,883,1584,55.74%,19.13%,1
高雄市,鳳山區,1305,114,235,349,21,370,618,59.87%,18.45%,1
高雄市,鳳山區,1306,83,176,259,9,268,423,63.36%,19.62%,1
高雄市,鳳山區,1307,218,518,736,48,784,1312,59.76%,16.62%,1
高雄市,鳳山區,1308,143,294,437,31,468,769,60.86%,18.6%,1
高雄市,鳳山區,1309,252,519,771,18,789,1213,65.05%,20.77%,1
高雄市,鳳山區,1310,214,487,701,34,735,1107,66.4%,19.33%,1
高雄市,鳳山區,1311,223,466,689,36,725,1188,61.03%,18.77%,1
高雄市,鳳山區,1312,275,447,722,27,749,1183,63.31%,23.25%,1
高雄市,鳳山區,1313,233,510,743,43,786,1264,62.18%,18.43%,1
高雄市,鳳山區,1314,151,346,497,36,533,882,60.43%,17.12%,1
高雄市,鳳山區,1315,219,449,668,39,707,1007,70.21%,21.75%,1
高雄市,鳳山區,1316,152,334,486,60,546,853,64.01%,17.82%,1
高雄市,鳳山區,1317,137,305,442,37,479,1660,28.86%,8.25%,1
高雄市,鳳山區,1318,222,434,656,37,693,1124,61.65%,19.75%,1
高雄市,鳳山區,1319,235,406,641,54,695,1112,62.5%,21.13%,1
高雄市,鳳山區,1320,201,453,654,37,691,1182,58.46%,17.01%,1
高雄市,鳳山區,1321,214,364,578,44,622,875,71.09%,24.46%,1
高雄市,鳳山區,1322,228,373,601,47,648,1040,62.31%,21.92%,1
高雄市,鳳山區,1323,246,440,686,19,705,1094,64.44%,22.49%,1
高雄市,鳳山區,1324,244,465,709,50,759,1217,62.37%,20.05%,1
高雄市,鳳山區,1325,216,421,637,28,665,974,68.28%,22.18%,1
高雄市,鳳山區,1326,177,397,574,31,605,987,61.3%,17.93%,1
高雄市,鳳山區,1327,238,531,769,20,789,1210,65.21%,19.67%,1
高雄市,鳳山區,1328,279,511,790,45,835,1391,60.03%,20.06%,1
高雄市,鳳山區,1329,228,392,620,24,644,1241,51.89%,18.37%,1
高雄市,鳳山區,1330,208,414,622,32,654,1000,65.4%,20.8%,1
高雄市,鳳山區,1331,207,448,655,26,681,1092,62.36%,18.96%,1
高雄市,鳳山區,1332,227,551,778,41,819,1308,62.61%,17.35%,1
高雄市,鳳山區,1333,187,410,597,52,649,1031,62.95%,18.14%,1
高雄市,鳳山區,1334,250,467,717,49,766,1159,66.09%,21.57%,1
高雄市,鳳山區,1335,453,174,627,47,674,1127,59.8%,40.2%,1
高雄市,鳳山區,1336,243,519,762,34,796,1109,71.78%,21.91%,1
高雄市,鳳山區,1337,342,806,1148,46,1194,1879,63.54%,18.2%,1
高雄市,鳳山區,1338,345,809,1154,47,1201,1803,66.61%,19.13%,1
高雄市,鳳山區,1339,288,761,1049,65,1114,2045,54.47%,14.08%,1
高雄市,鳳山區,1340,234,537,771,47,818,1432,57.12%,16.34%,1
高雄市,鳳山區,1341,155,407,562,12,574,1033,55.57%,15%,1
高雄市,鳳山區,1342,205,522,727,72,799,1253,63.77%,16.36%,1
高雄市,鳳山區,1343,225,484,709,22,731,1217,60.07%,18.49%,1
高雄市,鳳山區,1344,223,558,781,41,822,1267,64.88%,17.6%,1
高雄市,鳳山區,1345,219,458,677,37,714,1251,57.07%,17.51%,1
高雄市,鳳山區,1346,269,625,894,61,955,1563,61.1%,17.21%,1
高雄市,鳳山區,1347,343,799,1142,44,1186,1888,62.82%,18.17%,1
高雄市,鳳山區,1348,266,521,787,49,836,1368,61.11%,19.44%,1
高雄市,鳳山區,1349,264,574,838,38,876,1588,55.16%,16.62%,1
高雄市,鳳山區,1350,168,589,757,44,801,1255,63.82%,13.39%,1
高雄市,鳳山區,1351,210,489,699,59,758,1264,59.97%,16.61%,1
高雄市,鳳山區,1352,194,530,724,65,789,1291,61.12%,15.03%,1
高雄市,鳳山區,1353,185,520,705,33,738,1224,60.29%,15.11%,1
高雄市,鳳山區,1354,221,517,738,24,762,1296,58.8%,17.05%,1
高雄市,鳳山區,1355,175,352,527,31,558,826,67.55%,21.19%,1
高雄市,鳳山區,1356,184,541,725,26,751,1229,61.11%,14.97%,1
高雄市,鳳山區,1357,273,588,861,36,897,1467,61.15%,18.61%,1
高雄市,鳳山區,1358,204,494,698,47,745,1218,61.17%,16.75%,1
高雄市,鳳山區,1359,299,850,1149,58,1207,2173,55.55%,13.76%,1
高雄市,鳳山區,1360,371,899,1270,54,1324,2255,58.71%,16.45%,1
高雄市,鳳山區,1361,257,656,913,35,948,1556,60.93%,16.52%,1
高雄市,鳳山區,1362,275,534,809,40,849,1521,55.82%,18.08%,1
高雄市,鳳山區,1363,187,519,706,38,744,1407,52.88%,13.29%,1
高雄市,鳳山區,1364,251,628,879,59,938,1542,60.83%,16.28%,1
高雄市,鳳山區,1365,230,564,794,16,810,1502,53.93%,15.31%,1
高雄市,鳳山區,1366,232,537,769,52,821,1320,62.2%,17.58%,1
高雄市,鳳山區,1367,151,658,809,27,836,1507,55.47%,10.02%,1
高雄市,鳳山區,1368,151,634,785,45,830,1284,64.64%,11.76%,1
高雄市,鳳山區,1369,252,512,764,34,798,1441,55.38%,17.49%,1
高雄市,鳳山區,1370,241,617,858,64,922,1485,62.09%,16.23%,1
高雄市,鳳山區,1371,160,495,655,55,710,1205,58.92%,13.28%,1
高雄市,鳳山區,1372,209,500,709,22,731,1284,56.93%,16.28%,1
高雄市,鳳山區,1373,512,274,786,48,834,1326,62.9%,38.61%,1
高雄市,鳳山區,1374,199,422,621,32,653,1096,59.58%,18.16%,1
高雄市,鳳山區,1375,250,465,715,55,770,1182,65.14%,21.15%,1
高雄市,鳳山區,1376,203,441,644,51,695,1017,68.34%,19.96%,1
高雄市,鳳山區,1377,216,438,654,68,722,1198,60.27%,18.03%,1
高雄市,鳳山區,1378,222,449,671,30,701,1281,54.72%,17.33%,1
高雄市,鳳山區,1379,280,556,836,33,869,1358,63.99%,20.62%,1
高雄市,鳳山區,1380,272,514,786,35,821,1226,66.97%,22.19%,1
高雄市,鳳山區,1381,218,447,665,52,717,1098,65.3%,19.85%,1
高雄市,鳳山區,1382,238,476,714,25,739,1200,61.58%,19.83%,1
高雄市,鳳山區,1383,188,345,533,44,577,942,61.25%,19.96%,1
高雄市,鳳山區,1384,214,477,691,22,713,1206,59.12%,17.74%,1
高雄市,鳳山區,1385,265,471,736,25,761,1159,65.66%,22.86%,1
高雄市,鳳山區,1386,302,527,829,47,876,1401,62.53%,21.56%,1
高雄市,鳳山區,1387,287,548,835,23,858,1525,56.26%,18.82%,1
高雄市,鳳山區,1388,224,533,757,39,796,1345,59.18%,16.65%,1
高雄市,鳳山區,1389,213,511,724,36,760,1180,64.41%,18.05%,1
高雄市,鳳山區,1390,201,400,601,23,624,1106,56.42%,18.17%,1
高雄市,鳳山區,1391,286,566,852,59,911,1442,63.18%,19.83%,1
高雄市,鳳山區,1392,316,504,820,42,862,1376,62.65%,22.97%,1
高雄市,鳳山區,1393,255,489,744,13,757,1243,60.9%,20.51%,1
高雄市,鳳山區,1394,255,535,790,23,813,1361,59.74%,18.74%,1
高雄市,鳳山區,1395,281,558,839,50,889,1416,62.78%,19.84%,1
高雄市,鳳山區,1396,335,625,960,46,1006,1536,65.49%,21.81%,1
高雄市,鳳山區,1397,234,511,745,29,774,1388,55.76%,16.86%,1
高雄市,鳳山區,1398,220,488,708,82,790,1241,63.66%,17.73%,1
高雄市,鳳山區,1399,285,550,835,50,885,1394,63.49%,20.44%,1
高雄市,鳳山區,1400,236,534,770,18,788,1188,66.33%,19.87%,1
高雄市,鳳山區,1401,208,467,675,27,702,1112,63.13%,18.71%,1
高雄市,鳳山區,1402,266,493,759,39,798,1198,66.61%,22.2%,1
高雄市,鳳山區,1403,298,545,843,25,868,1475,58.85%,20.2%,1
高雄市,鳳山區,1404,218,435,653,34,687,1216,56.5%,17.93%,1
高雄市,鳳山區,1405,243,447,690,38,728,1318,55.24%,18.44%,1
高雄市,鳳山區,1406,273,561,834,19,853,1465,58.23%,18.63%,1
高雄市,鳳山區,1407,214,475,689,41,730,1314,55.56%,16.29%,1
高雄市,鳳山區,1408,256,565,821,29,850,1649,51.55%,15.52%,1
高雄市,鳳山區,1409,264,556,820,94,914,1601,57.09%,16.49%,1
高雄市,鳳山區,1410,225,449,674,24,698,1155,60.43%,19.48%,1
高雄市,鳳山區,1411,183,421,604,43,647,1050,61.62%,17.43%,1
高雄市,鳳山區,1412,233,501,734,16,750,1417,52.93%,16.44%,1
高雄市,鳳山區,1413,256,576,832,55,887,1525,58.16%,16.79%,1
高雄市,鳳山區,1414,267,605,872,55,927,1514,61.23%,17.64%,1
高雄市,鳳山區,1415,225,438,663,43,706,1190,59.33%,18.91%,1
高雄市,鳳山區,1416,221,491,712,29,741,1325,55.92%,16.68%,1
高雄市,鳳山區,1417,198,413,611,50,661,1049,63.01%,18.88%,1
高雄市,鳳山區,1418,182,411,593,27,620,1026,60.43%,17.74%,1
高雄市,鳳山區,1419,221,457,678,45,723,1152,62.76%,19.18%,1
高雄市,鳳山區,1420,216,437,653,13,666,1254,53.11%,17.22%,1
高雄市,鳳山區,1421,254,619,873,41,914,1688,54.15%,15.05%,1
高雄市,鳳山區,1422,267,662,929,54,983,1657,59.32%,16.11%,1
高雄市,鳳山區,1423,283,603,886,34,920,1729,53.21%,16.37%,1
高雄市,鳳山區,1424,311,633,944,47,991,1628,60.87%,19.1%,1
高雄市,鳳山區,1425,311,642,953,12,965,1891,51.03%,16.45%,1
高雄市,鳳山區,1426,214,730,944,34,978,1594,61.36%,13.43%,1
高雄市,鳳山區,1427,254,593,847,20,867,1342,64.61%,18.93%,1
高雄市,鳳山區,1428,275,640,915,36,951,1448,65.68%,18.99%,1
高雄市,鳳山區,1429,262,555,817,61,878,1405,62.49%,18.65%,1
高雄市,鳳山區,1430,215,440,655,67,722,1097,65.82%,19.6%,1
高雄市,鳳山區,1431,227,519,746,71,817,1248,65.46%,18.19%,1
高雄市,鳳山區,1432,250,444,694,70,764,1225,62.37%,20.41%,1
高雄市,鳳山區,1433,204,495,699,26,725,1214,59.72%,16.8%,1
高雄市,鳳山區,1434,328,842,1170,84,1254,2032,61.71%,16.14%,1
高雄市,鳳山區,1435,417,691,1108,50,1158,1927,60.09%,21.64%,1
高雄市,鳳山區,1436,380,876,1256,45,1301,2097,62.04%,18.12%,1
高雄市,鳳山區,1437,141,383,524,42,566,968,58.47%,14.57%,1
高雄市,鳳山區,1438,196,440,636,47,683,1200,56.92%,16.33%,1
高雄市,鳳山區,1439,199,428,627,47,674,1101,61.22%,18.07%,1
高雄市,鳳山區,1440,215,501,716,43,759,1369,55.44%,15.7%,1
高雄市,鳳山區,1441,262,598,860,52,912,1542,59.14%,16.99%,1
高雄市,鳳山區,1442,277,635,912,46,958,1536,62.37%,18.03%,1
高雄市,鳳山區,1443,263,480,743,37,780,1382,56.44%,19.03%,1
高雄市,鳳山區,1444,294,541,835,67,902,1452,62.12%,20.25%,1
高雄市,鳳山區,1445,154,453,607,34,641,1058,60.59%,14.56%,1
高雄市,鳳山區,1446,172,423,595,46,641,976,65.68%,17.62%,1
高雄市,鳳山區,1447,269,523,792,30,822,1545,53.2%,17.41%,1
高雄市,鳳山區,1448,215,412,627,50,677,1143,59.23%,18.81%,1
高雄市,鳳山區,1449,110,224,334,17,351,1301,26.98%,8.46%,1
高雄市,鳳山區,1450,189,429,618,32,650,1250,52%,15.12%,1
高雄市,鳳山區,1451,220,444,664,48,712,1208,58.94%,18.21%,1
高雄市,鳳山區,1452,227,460,687,56,743,1202,61.81%,18.89%,1
高雄市,鳳山區,1453,296,511,807,62,869,1499,57.97%,19.75%,1
高雄市,鳳山區,1454,260,534,794,43,837,1522,54.99%,17.08%,1
高雄市,鳳山區,1455,217,475,692,45,737,1125,65.51%,19.29%,1
高雄市,鳳山區,1456,244,527,771,19,790,1307,60.44%,18.67%,1
高雄市,鳳山區,1457,286,516,802,57,859,1405,61.14%,20.36%,1
高雄市,鳳山區,1458,226,489,715,50,765,1252,61.1%,18.05%,1
高雄市,鳳山區,1459,231,568,799,25,824,1291,63.83%,17.89%,1
高雄市,鳳山區,1460,192,361,553,50,603,938,64.29%,20.47%,1
高雄市,鳳山區,1461,298,728,1026,29,1055,1783,59.17%,16.71%,1
高雄市,鳳山區,1462,216,439,655,36,691,1105,62.53%,19.55%,1
高雄市,鳳山區,1463,523,237,760,72,832,1392,59.77%,37.57%,1
高雄市,鳳山區,1464,236,556,792,43,835,1244,67.12%,18.97%,1
高雄市,鳳山區,1465,219,406,625,43,668,1154,57.89%,18.98%,1
高雄市,鳳山區,1466,233,426,659,47,706,1153,61.23%,20.21%,1
高雄市,鳳山區,1467,178,407,585,18,603,1148,52.53%,15.51%,1
高雄市,鳳山區,1468,321,379,700,127,827,1432,57.75%,22.42%,1
高雄市,鳳山區,1469,222,389,611,25,636,1429,44.51%,15.54%,1
高雄市,鳳山區,1470,251,554,805,31,836,1479,56.52%,16.97%,1
高雄市,鳳山區,1471,180,445,625,35,660,1026,64.33%,17.54%,1
高雄市,鳳山區,1472,193,399,592,91,683,993,68.78%,19.44%,1
高雄市,鳳山區,1473,182,380,562,58,620,947,65.47%,19.22%,1
高雄市,鳳山區,1474,185,393,578,46,624,1042,59.88%,17.75%,1
高雄市,鳳山區,1475,195,415,610,55,665,1098,60.56%,17.76%,1
高雄市,鳳山區,1476,222,450,672,18,690,1284,53.74%,17.29%,1
高雄市,鳳山區,1477,212,428,640,45,685,1242,55.15%,17.07%,1
高雄市,鳳山區,1478,212,412,624,69,693,1093,63.4%,19.4%,1
高雄市,鳳山區,1479,352,371,723,43,766,1353,56.61%,26.02%,1
高雄市,鳳山區,1480,232,485,717,46,763,1353,56.39%,17.15%,1
高雄市,鳳山區,1481,234,529,763,38,801,1309,61.19%,17.88%,1
高雄市,鳳山區,1482,342,574,916,47,963,1627,59.19%,21.02%,1
高雄市,鳳山區,1483,234,548,782,68,850,1372,61.95%,17.06%,1
高雄市,林園區,1773,227,480,707,60,767,1262,60.78%,17.99%,1
高雄市,林園區,1774,252,550,802,50,852,1562,54.55%,16.13%,1
高雄市,林園區,1775,204,400,604,17,621,1078,57.61%,18.92%,1
高雄市,林園區,1776,194,397,591,37,628,979,64.15%,19.82%,1
高雄市,林園區,1777,196,432,628,57,685,1195,57.32%,16.4%,1
高雄市,林園區,1778,217,478,695,60,755,1380,54.71%,15.72%,1
高雄市,林園區,1779,200,462,662,73,735,1280,57.42%,15.63%,1
高雄市,林園區,1780,182,475,657,22,679,1269,53.51%,14.34%,1
高雄市,林園區,1781,227,433,660,20,680,1568,43.37%,14.48%,1
高雄市,林園區,1782,209,483,692,44,736,1226,60.03%,17.05%,1
高雄市,林園區,1783,229,543,772,47,819,1480,55.34%,15.47%,1
高雄市,林園區,1784,223,588,811,52,863,1459,59.15%,15.28%,1
高雄市,林園區,1785,265,544,809,45,854,1593,53.61%,16.64%,1
高雄市,林園區,1786,155,317,472,73,545,895,60.89%,17.32%,1
高雄市,林園區,1787,165,386,551,30,581,1110,52.34%,14.86%,1
高雄市,林園區,1788,214,472,686,48,734,1348,54.45%,15.88%,1
高雄市,林園區,1789,163,335,498,49,547,912,59.98%,17.87%,1
高雄市,林園區,1790,198,461,659,44,703,1085,64.79%,18.25%,1
高雄市,林園區,1791,358,167,525,19,544,955,56.96%,37.49%,1
高雄市,林園區,1792,148,364,512,37,549,879,62.46%,16.84%,1
高雄市,林園區,1793,193,390,583,58,641,1103,58.11%,17.5%,1
高雄市,林園區,1794,205,425,630,54,684,1054,64.9%,19.45%,1
高雄市,林園區,1795,198,449,647,14,661,1292,51.16%,15.33%,1
高雄市,林園區,1796,268,531,799,21,820,1683,48.72%,15.92%,1
高雄市,林園區,1797,90,237,327,26,353,607,58.15%,14.83%,1
高雄市,林園區,1798,161,374,535,60,595,1012,58.79%,15.91%,1
高雄市,林園區,1799,173,398,571,49,620,1046,59.27%,16.54%,1
高雄市,林園區,1800,111,309,420,21,441,914,48.25%,12.14%,1
高雄市,林園區,1801,289,496,785,48,833,1405,59.29%,20.57%,1
高雄市,林園區,1802,258,483,741,55,796,1299,61.28%,19.86%,1
高雄市,林園區,1803,103,433,536,29,565,1170,48.29%,8.8%,1
高雄市,林園區,1804,192,391,583,36,619,1299,47.65%,14.78%,1
高雄市,林園區,1805,179,385,564,25,589,1031,57.13%,17.36%,1
高雄市,林園區,1806,132,301,433,18,451,849,53.12%,15.55%,1
高雄市,林園區,1807,156,259,415,43,458,838,54.65%,18.62%,1
高雄市,林園區,1808,146,364,510,29,539,938,57.46%,15.57%,1
高雄市,林園區,1809,169,349,518,25,543,1051,51.67%,16.08%,1
高雄市,林園區,1810,144,294,438,46,484,786,61.58%,18.32%,1
高雄市,林園區,1811,140,360,500,57,557,894,62.3%,15.66%,1
高雄市,林園區,1812,99,205,304,19,323,749,43.12%,13.22%,1
高雄市,林園區,1813,258,605,863,27,890,1485,59.93%,17.37%,1
高雄市,林園區,1814,256,588,844,61,905,1478,61.23%,17.32%,1
高雄市,林園區,1815,169,535,704,63,767,1345,57.03%,12.57%,1
高雄市,林園區,1816,170,367,537,41,578,1038,55.68%,16.38%,1
高雄市,林園區,1817,227,452,679,22,701,1203,58.27%,18.87%,1
高雄市,林園區,1818,184,458,642,16,658,1138,57.82%,16.17%,1
高雄市,林園區,1819,157,347,504,13,517,1025,50.44%,15.32%,1
高雄市,林園區,1820,224,497,721,69,790,1341,58.91%,16.7%,1
高雄市,林園區,1821,174,400,574,8,582,1218,47.78%,14.29%,1
高雄市,林園區,1822,149,353,502,19,521,1147,45.42%,12.99%,1
高雄市,林園區,1823,148,384,532,18,550,1176,46.77%,12.59%,1
高雄市,大寮區,1692,225,121,346,27,373,727,51.31%,30.95%,1
高雄市,大寮區,1693,116,226,342,15,357,718,49.72%,16.16%,1
高雄市,大寮區,1694,214,457,671,36,707,1340,52.76%,15.97%,1
高雄市,大寮區,1695,217,481,698,46,744,1575,47.24%,13.78%,1
高雄市,大寮區,1696,60,188,248,15,263,444,59.23%,13.51%,1
高雄市,大寮區,1697,294,726,1020,42,1062,2374,44.73%,12.38%,1
高雄市,大寮區,1698,211,461,672,62,734,1291,56.86%,16.34%,1
高雄市,大寮區,1699,293,449,742,72,814,1400,58.14%,20.93%,1
高雄市,大寮區,1700,216,520,736,23,759,1390,54.6%,15.54%,1
高雄市,大寮區,1701,230,495,725,58,783,1401,55.89%,16.42%,1
高雄市,大寮區,1702,185,423,608,29,637,1199,53.13%,15.43%,1
高雄市,大寮區,1703,198,387,585,25,610,1210,50.41%,16.36%,1
高雄市,大寮區,1704,196,440,636,41,677,1195,56.65%,16.4%,1
高雄市,大寮區,1705,188,415,603,19,622,1166,53.34%,16.12%,1
高雄市,大寮區,1706,246,484,730,33,763,1353,56.39%,18.18%,1
高雄市,大寮區,1707,221,371,592,56,648,1052,61.6%,21.01%,1
高雄市,大寮區,1708,164,315,479,14,493,1024,48.14%,16.02%,1
高雄市,大寮區,1709,198,460,658,24,682,1189,57.36%,16.65%,1
高雄市,大寮區,1710,263,580,843,74,917,1512,60.65%,17.39%,1
高雄市,大寮區,1711,257,567,824,56,880,1633,53.89%,15.74%,1
高雄市,大寮區,1712,213,480,693,54,747,1214,61.53%,17.55%,1
高雄市,大寮區,1713,237,524,761,60,821,1258,65.26%,18.84%,1
高雄市,大寮區,1714,260,508,768,32,800,1323,60.47%,19.65%,1
高雄市,大寮區,1715,516,213,729,36,765,1253,61.05%,41.18%,1
高雄市,大寮區,1716,175,420,595,53,648,1035,62.61%,16.91%,1
高雄市,大寮區,1717,170,429,599,36,635,1106,57.41%,15.37%,1
高雄市,大寮區,1718,172,479,651,38,689,1195,57.66%,14.39%,1
高雄市,大寮區,1719,198,413,611,26,637,1051,60.61%,18.84%,1
高雄市,大寮區,1720,263,535,798,58,856,1425,60.07%,18.46%,1
高雄市,大寮區,1721,262,590,852,52,904,1635,55.29%,16.02%,1
高雄市,大寮區,1722,229,538,767,48,815,1359,59.97%,16.85%,1
高雄市,大寮區,1723,240,522,762,57,819,1361,60.18%,17.63%,1
高雄市,大寮區,1724,256,643,899,33,932,1629,57.21%,15.72%,1
高雄市,大寮區,1725,210,632,842,41,883,1518,58.17%,13.83%,1
高雄市,大寮區,1726,257,579,836,60,896,1620,55.31%,15.86%,1
高雄市,大寮區,1727,263,596,859,14,873,1648,52.97%,15.96%,1
高雄市,大寮區,1728,235,532,767,46,813,1385,58.7%,16.97%,1
高雄市,大寮區,1729,230,535,765,27,792,1435,55.19%,16.03%,1
高雄市,大寮區,1730,164,402,566,24,590,1046,56.41%,15.68%,1
高雄市,大寮區,1731,118,282,400,26,426,789,53.99%,14.96%,1
高雄市,大寮區,1732,168,293,461,31,492,909,54.13%,18.48%,1
高雄市,大寮區,1733,129,275,404,33,437,733,59.62%,17.6%,1
高雄市,大寮區,1734,267,513,780,60,840,1553,54.09%,17.19%,1
高雄市,大寮區,1735,165,326,491,28,519,922,56.29%,17.9%,1
高雄市,大寮區,1736,158,365,523,65,588,1012,58.1%,15.61%,1
高雄市,大寮區,1737,177,307,484,58,542,968,55.99%,18.29%,1
高雄市,大寮區,1738,182,377,559,35,594,1021,58.18%,17.83%,1
高雄市,大寮區,1739,232,470,702,60,762,1554,49.03%,14.93%,1
高雄市,大寮區,1740,187,459,646,41,687,1120,61.34%,16.7%,1
高雄市,大寮區,1741,233,498,731,43,774,1225,63.18%,19.02%,1
高雄市,大寮區,1742,139,352,491,21,512,1320,38.79%,10.53%,1
高雄市,大寮區,1743,227,485,712,39,751,1317,57.02%,17.24%,1
高雄市,大寮區,1744,203,398,601,24,625,1119,55.85%,18.14%,1
高雄市,大寮區,1745,203,478,681,42,723,1190,60.76%,17.06%,1
高雄市,大寮區,1746,212,503,715,41,756,1229,61.51%,17.25%,1
高雄市,大寮區,1747,206,510,716,37,753,1178,63.92%,17.49%,1
高雄市,大寮區,1748,226,534,760,31,791,1272,62.19%,17.77%,1
高雄市,大寮區,1749,248,521,769,24,793,1413,56.12%,17.55%,1
高雄市,大寮區,1750,209,484,693,48,741,1185,62.53%,17.64%,1
高雄市,大寮區,1751,77,236,313,10,323,553,58.41%,13.92%,1
高雄市,大寮區,1752,164,409,573,57,630,1121,56.2%,14.63%,1
高雄市,大寮區,1753,228,454,682,24,706,1227,57.54%,18.58%,1
高雄市,大寮區,1754,205,449,654,59,713,1058,67.39%,19.38%,1
高雄市,大寮區,1755,204,469,673,24,697,1209,57.65%,16.87%,1
高雄市,大寮區,1756,178,462,640,18,658,1100,59.82%,16.18%,1
高雄市,大寮區,1757,195,392,587,26,613,1122,54.63%,17.38%,1
高雄市,大寮區,1758,180,412,592,52,644,983,65.51%,18.31%,1
高雄市,大寮區,1759,155,443,598,24,622,1192,52.18%,13%,1
高雄市,大寮區,1760,101,281,382,24,406,719,56.47%,14.05%,1
高雄市,大寮區,1761,123,377,500,28,528,829,63.69%,14.84%,1
高雄市,大寮區,1762,129,344,473,60,533,771,69.13%,16.73%,1
高雄市,大寮區,1763,226,406,632,49,681,1075,63.35%,21.02%,1
高雄市,大寮區,1764,220,506,726,72,798,1280,62.34%,17.19%,1
高雄市,大寮區,1765,173,446,619,77,696,1179,59.03%,14.67%,1
高雄市,大寮區,1766,295,339,634,31,665,1210,54.96%,24.38%,1
高雄市,大寮區,1767,28,81,109,6,115,189,60.85%,14.81%,1
高雄市,大寮區,1768,189,521,710,45,755,1228,61.48%,15.39%,1
高雄市,大寮區,1769,162,477,639,37,676,1170,57.78%,13.85%,1
高雄市,大寮區,1770,249,581,830,43,873,1416,61.65%,17.58%,1
高雄市,大寮區,1771,267,605,872,33,905,1482,61.07%,18.02%,1
高雄市,大寮區,1772,246,523,769,51,820,1478,55.48%,16.64%,1
高雄市,大樹區,0736,240,504,744,27,771,1386,55.63%,17.32%,1
高雄市,大樹區,0737,232,581,813,32,845,1315,64.26%,17.64%,1
高雄市,大樹區,0738,338,950,1288,58,1346,2461,54.69%,13.73%,1
高雄市,大樹區,0739,205,488,693,26,719,1274,56.44%,16.09%,1
高雄市,大樹區,0740,209,449,658,59,717,1265,56.68%,16.52%,1
高雄市,大樹區,0741,233,545,778,61,839,1504,55.78%,15.49%,1
高雄市,大樹區,0742,179,350,529,15,544,1049,51.86%,17.06%,1
高雄市,大樹區,0743,283,529,812,46,858,1573,54.55%,17.99%,1
高雄市,大樹區,0744,155,367,522,33,555,1121,49.51%,13.83%,1
高雄市,大樹區,0745,183,493,676,40,716,1207,59.32%,15.16%,1
高雄市,大樹區,0746,178,443,621,22,643,1134,56.7%,15.7%,1
高雄市,大樹區,0747,187,477,664,23,687,1124,61.12%,16.64%,1
高雄市,大樹區,0748,205,441,646,76,722,1259,57.35%,16.28%,1
高雄市,大樹區,0749,219,421,640,56,696,1105,62.99%,19.82%,1
高雄市,大樹區,0750,198,390,588,61,649,1128,57.54%,17.55%,1
高雄市,大樹區,0751,162,357,519,77,596,1079,55.24%,15.01%,1
高雄市,大樹區,0752,169,335,504,44,548,1025,53.46%,16.49%,1
高雄市,大樹區,0753,149,334,483,49,532,950,56%,15.68%,1
高雄市,大樹區,0754,251,480,731,81,812,1433,56.66%,17.52%,1
高雄市,大樹區,0755,117,268,385,23,408,794,51.39%,14.74%,1
高雄市,大樹區,0756,116,218,334,15,349,781,44.69%,14.85%,1
高雄市,大樹區,0757,218,414,632,21,653,1318,49.54%,16.54%,1
高雄市,大樹區,0758,119,258,377,34,411,736,55.84%,16.17%,1
高雄市,大樹區,0759,158,312,470,23,493,1047,47.09%,15.09%,1
高雄市,大樹區,0760,218,442,660,57,717,1271,56.41%,17.15%,1
高雄市,大樹區,0761,152,430,582,31,613,1186,51.69%,12.82%,1
高雄市,大樹區,0762,172,371,543,48,591,1007,58.69%,17.08%,1
高雄市,大樹區,0763,157,321,478,41,519,859,60.42%,18.28%,1
高雄市,大樹區,0764,109,225,334,18,352,735,47.89%,14.83%,1
高雄市,大樹區,0765,186,396,582,65,647,1046,61.85%,17.78%,1
高雄市,大樹區,0766,102,521,623,28,651,880,73.98%,11.59%,1
高雄市,大樹區,0767,68,288,356,20,376,720,52.22%,9.44%,1
高雄市,大社區,0637,143,332,475,60,535,950,56.32%,15.05%,1
高雄市,大社區,0638,210,448,658,23,681,1306,52.14%,16.08%,1
高雄市,大社區,0639,257,553,810,31,841,1856,45.31%,13.85%,1
高雄市,大社區,0640,208,378,586,49,635,986,64.4%,21.1%,1
高雄市,大社區,0641,179,349,528,45,573,1116,51.34%,16.04%,1
高雄市,大社區,0642,272,477,749,58,807,1253,64.41%,21.71%,1
高雄市,大社區,0643,271,640,911,45,956,1613,59.27%,16.8%,1
高雄市,大社區,0644,223,513,736,39,775,1455,53.26%,15.33%,1
高雄市,大社區,0645,318,634,952,50,1002,1674,59.86%,19%,1
高雄市,大社區,0646,160,394,554,55,609,1004,60.66%,15.94%,1
高雄市,大社區,0647,164,321,485,36,521,879,59.27%,18.66%,1
高雄市,大社區,0648,162,256,418,18,436,778,56.04%,20.82%,1
高雄市,大社區,0649,219,411,630,45,675,1110,60.81%,19.73%,1
高雄市,大社區,0650,263,509,772,46,818,1432,57.12%,18.37%,1
高雄市,大社區,0651,273,562,835,38,873,1466,59.55%,18.62%,1
高雄市,大社區,0652,290,549,839,73,912,1383,65.94%,20.97%,1
高雄市,大社區,0653,302,572,874,61,935,1645,56.84%,18.36%,1
高雄市,大社區,0654,280,477,757,46,803,1555,51.64%,18.01%,1
高雄市,大社區,0655,426,531,957,51,1008,1750,57.6%,24.34%,1
高雄市,大社區,0656,198,414,612,54,666,1111,59.95%,17.82%,1
高雄市,大社區,0657,209,420,629,65,694,1133,61.25%,18.45%,1
高雄市,大社區,0658,166,353,519,34,553,912,60.64%,18.2%,1
高雄市,大社區,0659,108,226,334,15,349,745,46.85%,14.5%,1
高雄市,大社區,0660,194,343,537,25,562,934,60.17%,20.77%,1
高雄市,仁武區,0661,319,816,1135,34,1169,1777,65.79%,17.95%,1
高雄市,仁武區,0662,403,917,1320,59,1379,2273,60.67%,17.73%,1
高雄市,仁武區,0663,271,592,863,55,918,1384,66.33%,19.58%,1
高雄市,仁武區,0664,199,445,644,46,690,1170,58.97%,17.01%,1
高雄市,仁武區,0665,255,516,771,47,818,1216,67.27%,20.97%,1
高雄市,仁武區,0666,274,602,876,23,899,1598,56.26%,17.15%,1
高雄市,仁武區,0667,372,935,1307,26,1333,2143,62.2%,17.36%,1
高雄市,仁武區,0668,243,461,704,51,755,1300,58.08%,18.69%,1
高雄市,仁武區,0669,260,510,770,54,824,1338,61.58%,19.43%,1
高雄市,仁武區,0670,223,427,650,16,666,1217,54.72%,18.32%,1
高雄市,仁武區,0671,168,394,562,55,617,1202,51.33%,13.98%,1
高雄市,仁武區,0672,245,485,730,36,766,1404,54.56%,17.45%,1
高雄市,仁武區,0673,117,331,448,34,482,830,58.07%,14.1%,1
高雄市,仁武區,0674,224,540,764,40,804,1802,44.62%,12.43%,1
高雄市,仁武區,0675,302,656,958,53,1011,1877,53.86%,16.09%,1
高雄市,仁武區,0676,258,559,817,32,849,1738,48.85%,14.84%,1
高雄市,仁武區,0677,296,533,829,48,877,1549,56.62%,19.11%,1
高雄市,仁武區,0678,280,611,891,49,940,1579,59.53%,17.73%,1
高雄市,仁武區,0679,200,549,749,32,781,1406,55.55%,14.22%,1
高雄市,仁武區,0680,239,595,834,28,862,1461,59%,16.36%,1
高雄市,仁武區,0681,516,264,780,41,821,1311,62.62%,39.36%,1
高雄市,仁武區,0682,236,531,767,23,790,1373,57.54%,17.19%,1
高雄市,仁武區,0683,205,321,526,18,544,1035,52.56%,19.81%,1
高雄市,仁武區,0684,197,435,632,32,664,1181,56.22%,16.68%,1
高雄市,仁武區,0685,341,563,904,32,936,1670,56.05%,20.42%,1
高雄市,仁武區,0686,293,575,868,29,897,1576,56.92%,18.59%,1
高雄市,仁武區,0687,294,641,935,43,978,1576,62.06%,18.65%,1
高雄市,仁武區,0688,331,829,1160,28,1188,1915,62.04%,17.28%,1
高雄市,仁武區,0689,289,679,968,32,1000,1758,56.88%,16.44%,1
高雄市,仁武區,0690,366,783,1149,44,1193,1892,63.05%,19.34%,1
高雄市,仁武區,0691,358,815,1173,62,1235,2025,60.99%,17.68%,1
高雄市,仁武區,0692,370,842,1212,39,1251,2014,62.12%,18.37%,1
高雄市,仁武區,0693,306,627,933,34,967,1473,65.65%,20.77%,1
高雄市,仁武區,0694,171,349,520,26,546,979,55.77%,17.47%,1
高雄市,仁武區,0695,175,365,540,17,557,944,59%,18.54%,1
高雄市,仁武區,0696,187,450,637,65,702,1153,60.88%,16.22%,1
高雄市,仁武區,0697,198,510,708,39,747,1328,56.25%,14.91%,1
高雄市,仁武區,0698,275,652,927,71,998,1657,60.23%,16.6%,1
高雄市,仁武區,0699,239,545,784,45,829,1545,53.66%,15.47%,1
高雄市,仁武區,0700,259,595,854,35,889,1417,62.74%,18.28%,1
高雄市,仁武區,0701,398,592,990,41,1031,1602,64.36%,24.84%,1
高雄市,仁武區,0702,337,788,1125,49,1174,1823,64.4%,18.49%,1
高雄市,仁武區,0703,355,711,1066,26,1092,1914,57.05%,18.55%,1
高雄市,仁武區,0704,370,762,1132,47,1179,1992,59.19%,18.57%,1
高雄市,仁武區,0705,202,837,1039,34,1073,2045,52.47%,9.88%,1
高雄市,仁武區,0706,385,800,1185,42,1227,1982,61.91%,19.42%,1
高雄市,仁武區,0707,344,785,1129,39,1168,2167,53.9%,15.87%,1
高雄市,鳥松區,0708,307,635,942,48,990,1678,59%,18.3%,1
高雄市,鳥松區,0709,288,573,861,55,916,1682,54.46%,17.12%,1
高雄市,鳥松區,0710,253,479,732,37,769,1225,62.78%,20.65%,1
高雄市,鳥松區,0711,233,449,682,50,732,1322,55.37%,17.62%,1
高雄市,鳥松區,0712,219,482,701,37,738,1215,60.74%,18.02%,1
高雄市,鳥松區,0713,322,620,942,46,988,1779,55.54%,18.1%,1
高雄市,鳥松區,0714,364,365,729,14,743,1129,65.81%,32.24%,1
高雄市,鳥松區,0715,239,574,813,44,857,1374,62.37%,17.39%,1
高雄市,鳥松區,0716,218,405,623,31,654,1089,60.06%,20.02%,1
高雄市,鳥松區,0717,468,853,1321,44,1365,2219,61.51%,21.09%,1
高雄市,鳥松區,0718,331,620,951,28,979,1634,59.91%,20.26%,1
高雄市,鳥松區,0719,296,640,936,51,987,1553,63.55%,19.06%,1
高雄市,鳥松區,0720,316,644,960,43,1003,1572,63.8%,20.1%,1
高雄市,鳥松區,0721,361,666,1027,37,1064,1688,63.03%,21.39%,1
高雄市,鳥松區,0722,363,637,1000,82,1082,1626,66.54%,22.32%,1
高雄市,鳥松區,0723,369,711,1080,48,1128,1744,64.68%,21.16%,1
高雄市,鳥松區,0724,175,489,664,38,702,1230,57.07%,14.23%,1
高雄市,鳥松區,0725,205,509,714,63,777,1201,64.7%,17.07%,1
高雄市,鳥松區,0726,195,499,694,34,728,1117,65.17%,17.46%,1
高雄市,鳥松區,0727,195,486,681,58,739,1255,58.88%,15.54%,1
高雄市,鳥松區,0728,224,520,744,29,773,1432,53.98%,15.64%,1
高雄市,鳥松區,0729,691,7,698,31,729,1370,53.21%,50.44%,1
高雄市,鳥松區,0730,243,541,784,68,852,1364,62.46%,17.82%,1
高雄市,鳥松區,0731,176,450,626,44,670,1041,64.36%,16.91%,1
高雄市,鳥松區,0732,139,336,475,34,509,702,72.51%,19.8%,1
高雄市,鳥松區,0733,200,489,689,49,738,1212,60.89%,16.5%,1
高雄市,鳥松區,0734,195,512,707,44,751,1289,58.26%,15.13%,1
高雄市,鳥松區,0735,287,624,911,28,939,1449,64.8%,19.81%,1
高雄市,岡山區,0261,259,588,847,34,881,1345,65.5%,19.26%,1
高雄市,岡山區,0262,145,331,476,24,500,1045,47.85%,13.88%,1
高雄市,岡山區,0263,184,440,624,20,644,1051,61.27%,17.51%,1
高雄市,岡山區,0264,189,356,545,20,565,917,61.61%,20.61%,1
高雄市,岡山區,0265,210,370,580,29,609,934,65.2%,22.48%,1
高雄市,岡山區,0266,176,486,662,34,696,1097,63.45%,16.04%,1
高雄市,岡山區,0267,208,559,767,37,804,1208,66.56%,17.22%,1
高雄市,岡山區,0268,212,520,732,40,772,1159,66.61%,18.29%,1
高雄市,岡山區,0269,182,412,594,36,630,1018,61.89%,17.88%,1
高雄市,岡山區,0270,227,461,688,37,725,1316,55.09%,17.25%,1
高雄市,岡山區,0271,235,528,763,28,791,1345,58.81%,17.47%,1
高雄市,岡山區,0272,237,528,765,42,807,1295,62.32%,18.3%,1
高雄市,岡山區,0273,243,566,809,38,847,1425,59.44%,17.05%,1
高雄市,岡山區,0274,231,514,745,27,772,1328,58.13%,17.39%,1
高雄市,岡山區,0275,251,560,811,17,828,1382,59.91%,18.16%,1
高雄市,岡山區,0276,256,575,831,18,849,1381,61.48%,18.54%,1
高雄市,岡山區,0277,236,475,711,64,775,1282,60.45%,18.41%,1
高雄市,岡山區,0278,225,477,702,15,717,1240,57.82%,18.15%,1
高雄市,岡山區,0279,237,515,752,49,801,1327,60.36%,17.86%,1
高雄市,岡山區,0280,308,613,921,42,963,1736,55.47%,17.74%,1
高雄市,岡山區,0281,273,634,907,43,950,1566,60.66%,17.43%,1
高雄市,岡山區,0282,294,596,890,35,925,1779,52%,16.53%,1
高雄市,岡山區,0283,273,628,901,58,959,1593,60.2%,17.14%,1
高雄市,岡山區,0284,268,600,868,56,924,1480,62.43%,18.11%,1
高雄市,岡山區,0285,228,564,792,34,826,1364,60.56%,16.72%,1
高雄市,岡山區,0286,587,242,829,39,868,1410,61.56%,41.63%,1
高雄市,岡山區,0287,187,556,743,50,793,1148,69.08%,16.29%,1
高雄市,岡山區,0288,114,249,363,45,408,625,65.28%,18.24%,1
高雄市,岡山區,0289,171,403,574,27,601,969,62.02%,17.65%,1
高雄市,岡山區,0290,177,352,529,19,548,861,63.65%,20.56%,1
高雄市,岡山區,0291,132,296,428,28,456,823,55.41%,16.04%,1
高雄市,岡山區,0292,177,380,557,43,600,889,67.49%,19.91%,1
高雄市,岡山區,0293,223,520,743,33,776,1283,60.48%,17.38%,1
高雄市,岡山區,0294,256,568,824,33,857,1512,56.68%,16.93%,1
高雄市,岡山區,0295,200,425,625,47,672,983,68.36%,20.35%,1
高雄市,岡山區,0296,222,497,719,37,756,1262,59.9%,17.59%,1
高雄市,岡山區,0297,193,457,650,40,690,1096,62.96%,17.61%,1
高雄市,岡山區,0298,195,419,614,35,649,1066,60.88%,18.29%,1
高雄市,岡山區,0299,195,444,639,30,669,1188,56.31%,16.41%,1
高雄市,岡山區,0300,274,541,815,36,851,1360,62.57%,20.15%,1
高雄市,岡山區,0301,253,570,823,32,855,1363,62.73%,18.56%,1
高雄市,岡山區,0302,178,657,835,42,877,1352,64.87%,13.17%,1
高雄市,岡山區,0303,266,560,826,44,870,1460,59.59%,18.22%,1
高雄市,岡山區,0304,237,514,751,34,785,1272,61.71%,18.63%,1
高雄市,岡山區,0305,195,456,651,45,696,1080,64.44%,18.06%,1
高雄市,岡山區,0306,228,498,726,53,779,1255,62.07%,18.17%,1
高雄市,岡山區,0307,159,423,582,47,629,938,67.06%,16.95%,1
高雄市,岡山區,0308,208,544,752,41,793,1237,64.11%,16.81%,1
高雄市,岡山區,0309,250,511,761,26,787,1413,55.7%,17.69%,1
高雄市,岡山區,0310,158,293,451,16,467,765,61.05%,20.65%,1
高雄市,岡山區,0311,211,450,661,25,686,1043,65.77%,20.23%,1
高雄市,岡山區,0312,119,306,425,32,457,844,54.15%,14.1%,1
高雄市,岡山區,0313,204,495,699,30,729,993,73.41%,20.54%,1
高雄市,岡山區,0314,203,414,617,57,674,1038,64.93%,19.56%,1
高雄市,岡山區,0315,184,422,606,60,666,1070,62.24%,17.2%,1
高雄市,岡山區,0316,202,435,637,58,695,1023,67.94%,19.75%,1
高雄市,岡山區,0317,232,543,775,27,802,1349,59.45%,17.2%,1
高雄市,岡山區,0318,239,534,773,36,809,1452,55.72%,16.46%,1
高雄市,岡山區,0319,61,125,186,19,205,301,68.11%,20.27%,1
高雄市,岡山區,0320,130,307,437,79,516,756,68.25%,17.2%,1
高雄市,岡山區,0321,109,281,390,13,403,733,54.98%,14.87%,1
高雄市,岡山區,0322,158,376,534,63,597,854,69.91%,18.5%,1
高雄市,岡山區,0323,102,313,415,17,432,866,49.88%,11.78%,1
高雄市,岡山區,0324,131,398,529,45,574,978,58.69%,13.39%,1
高雄市,岡山區,0325,200,565,765,52,817,1336,61.15%,14.97%,1
高雄市,岡山區,0326,154,604,758,13,771,1218,63.3%,12.64%,1
高雄市,岡山區,0327,81,170,251,7,258,341,75.66%,23.75%,1
高雄市,岡山區,0328,132,556,688,27,715,955,74.87%,13.82%,1
高雄市,岡山區,0329,124,514,638,15,653,940,69.47%,13.19%,1
高雄市,岡山區,0330,158,381,539,35,574,851,67.45%,18.57%,1
高雄市,岡山區,0331,142,380,522,15,537,762,70.47%,18.64%,1
高雄市,岡山區,0332,74,158,232,8,240,318,75.47%,23.27%,1
高雄市,橋頭區,0404,210,408,618,58,676,1005,67.26%,20.9%,1
高雄市,橋頭區,0405,212,429,641,47,688,1073,64.12%,19.76%,1
高雄市,橋頭區,0406,200,475,675,27,702,1129,62.18%,17.71%,1
高雄市,橋頭區,0407,234,485,719,68,787,1244,63.26%,18.81%,1
高雄市,橋頭區,0408,193,417,610,31,641,1091,58.75%,17.69%,1
高雄市,橋頭區,0409,277,552,829,49,878,1329,66.06%,20.84%,1
高雄市,橋頭區,0410,217,450,667,45,712,1140,62.46%,19.04%,1
高雄市,橋頭區,0411,229,472,701,56,757,1220,62.05%,18.77%,1
高雄市,橋頭區,0412,204,458,662,52,714,1047,68.19%,19.48%,1
高雄市,橋頭區,0413,220,490,710,82,792,1315,60.23%,16.73%,1
高雄市,橋頭區,0414,133,250,383,29,412,691,59.62%,19.25%,1
高雄市,橋頭區,0415,123,304,427,51,478,720,66.39%,17.08%,1
高雄市,橋頭區,0416,247,427,674,67,741,1192,62.16%,20.72%,1
高雄市,橋頭區,0417,250,544,794,54,848,1318,64.34%,18.97%,1
高雄市,橋頭區,0418,127,334,461,32,493,761,64.78%,16.69%,1
高雄市,橋頭區,0419,195,352,547,27,574,973,58.99%,20.04%,1
高雄市,橋頭區,0420,127,220,347,19,366,587,62.35%,21.64%,1
高雄市,橋頭區,0421,167,328,495,36,531,812,65.39%,20.57%,1
高雄市,橋頭區,0422,75,135,210,11,221,343,64.43%,21.87%,1
高雄市,橋頭區,0423,294,509,803,22,825,1266,65.17%,23.22%,1
高雄市,橋頭區,0424,188,485,673,73,746,1128,66.13%,16.67%,1
高雄市,橋頭區,0425,137,389,526,39,565,884,63.91%,15.5%,1
高雄市,橋頭區,0426,189,443,632,63,695,1187,58.55%,15.92%,1
高雄市,橋頭區,0427,202,530,732,52,784,1259,62.27%,16.04%,1
高雄市,橋頭區,0428,213,477,690,66,756,1361,55.55%,15.65%,1
高雄市,橋頭區,0429,118,222,340,21,361,671,53.8%,17.59%,1
高雄市,橋頭區,0430,239,483,722,51,773,1215,63.62%,19.67%,1
高雄市,橋頭區,0431,224,502,726,78,804,1255,64.06%,17.85%,1
高雄市,橋頭區,0432,247,493,740,49,789,1219,64.73%,20.26%,1
高雄市,橋頭區,0433,249,510,759,35,794,1372,57.87%,18.15%,1
高雄市,橋頭區,0434,128,207,335,10,345,758,45.51%,16.89%,1
高雄市,燕巢區,0333,155,427,582,75,657,1152,57.03%,13.45%,1
高雄市,燕巢區,0334,191,435,626,30,656,1120,58.57%,17.05%,1
高雄市,燕巢區,0335,159,438,597,50,647,974,66.43%,16.32%,1
高雄市,燕巢區,0336,174,388,562,12,574,1019,56.33%,17.08%,1
高雄市,燕巢區,0337,172,380,552,52,604,1058,57.09%,16.26%,1
高雄市,燕巢區,0338,154,317,471,28,499,1017,49.07%,15.14%,1
高雄市,燕巢區,0339,6,34,40,1,41,259,15.83%,2.32%,1
高雄市,燕巢區,0340,166,405,571,39,610,926,65.87%,17.93%,1
高雄市,燕巢區,0341,85,232,317,16,333,624,53.37%,13.62%,1
高雄市,燕巢區,0342,196,476,672,49,721,1102,65.43%,17.79%,1
高雄市,燕巢區,0343,166,372,538,37,575,1072,53.64%,15.49%,1
高雄市,燕巢區,0344,266,464,730,63,793,1361,58.27%,19.54%,1
高雄市,燕巢區,0345,61,200,261,27,288,472,61.02%,12.92%,1
高雄市,燕巢區,0346,177,421,598,44,642,1197,53.63%,14.79%,1
高雄市,燕巢區,0347,192,478,670,66,736,1134,64.9%,16.93%,1
高雄市,燕巢區,0348,201,414,615,25,640,1148,55.75%,17.51%,1
高雄市,燕巢區,0349,176,415,591,66,657,1207,54.43%,14.58%,1
高雄市,燕巢區,0350,267,607,874,32,906,1402,64.62%,19.04%,1
高雄市,燕巢區,0351,207,345,552,56,608,1000,60.8%,20.7%,1
高雄市,燕巢區,0352,215,408,623,58,681,1110,61.35%,19.37%,1
高雄市,燕巢區,0353,229,472,701,45,746,1291,57.78%,17.74%,1
高雄市,燕巢區,0354,135,288,423,68,491,797,61.61%,16.94%,1
高雄市,燕巢區,0355,150,390,540,38,578,1098,52.64%,13.66%,1
高雄市,燕巢區,0356,211,485,696,57,753,1393,54.06%,15.15%,1
高雄市,燕巢區,0357,127,343,470,24,494,1079,45.78%,11.77%,1
高雄市,田寮區,0237,43,117,160,6,166,369,44.99%,11.65%,1
高雄市,田寮區,0238,83,178,261,20,281,656,42.84%,12.65%,1
高雄市,田寮區,0239,28,85,113,12,125,406,30.79%,6.9%,1
高雄市,田寮區,0240,114,54,168,24,192,380,50.53%,30%,1
高雄市,田寮區,0241,39,148,187,16,203,379,53.56%,10.29%,1
高雄市,田寮區,0242,70,236,306,50,356,625,56.96%,11.2%,1
高雄市,田寮區,0243,144,300,444,23,467,946,49.37%,15.22%,1
高雄市,田寮區,0244,86,253,339,41,380,794,47.86%,10.83%,1
高雄市,田寮區,0245,44,105,149,20,169,382,44.24%,11.52%,1
高雄市,田寮區,0246,59,106,165,35,200,513,38.99%,11.5%,1
高雄市,田寮區,0247,85,207,292,17,309,601,51.41%,14.14%,1
高雄市,田寮區,0248,108,218,326,38,364,620,58.71%,17.42%,1
高雄市,阿蓮區,0216,204,389,593,35,628,1299,48.34%,15.7%,1
高雄市,阿蓮區,0217,180,398,578,28,606,1107,54.74%,16.26%,1
高雄市,阿蓮區,0218,124,320,444,18,462,898,51.45%,13.81%,1
高雄市,阿蓮區,0219,202,428,630,58,688,1259,54.65%,16.04%,1
高雄市,阿蓮區,0220,258,539,797,50,847,1579,53.64%,16.34%,1
高雄市,阿蓮區,0221,88,232,320,9,329,564,58.33%,15.6%,1
高雄市,阿蓮區,0222,142,309,451,47,498,768,64.84%,18.49%,1
高雄市,阿蓮區,0223,184,412,596,41,637,1092,58.33%,16.85%,1
高雄市,阿蓮區,0224,171,404,575,52,627,1099,57.05%,15.56%,1
高雄市,阿蓮區,0225,190,425,615,25,640,1134,56.44%,16.75%,1
高雄市,阿蓮區,0226,251,544,795,15,810,1561,51.89%,16.08%,1
高雄市,阿蓮區,0227,273,551,824,80,904,1533,58.97%,17.81%,1
高雄市,阿蓮區,0228,186,358,544,25,569,1116,50.99%,16.67%,1
高雄市,阿蓮區,0229,177,377,554,30,584,1054,55.41%,16.79%,1
高雄市,阿蓮區,0230,211,432,643,44,687,1260,54.52%,16.75%,1
高雄市,阿蓮區,0231,233,503,736,61,797,1504,52.99%,15.49%,1
高雄市,阿蓮區,0232,118,268,386,20,406,848,47.88%,13.92%,1
高雄市,阿蓮區,0233,118,301,419,19,438,823,53.22%,14.34%,1
高雄市,阿蓮區,0234,143,412,555,31,586,1021,57.39%,14.01%,1
高雄市,阿蓮區,0235,290,562,852,26,878,1715,51.2%,16.91%,1
高雄市,阿蓮區,0236,203,442,645,42,687,1300,52.85%,15.62%,1
高雄市,路竹區,0175,151,376,527,19,546,1026,53.22%,14.72%,1
高雄市,路竹區,0176,186,392,578,53,631,1069,59.03%,17.4%,1
高雄市,路竹區,0177,209,427,636,55,691,1127,61.31%,18.54%,1
高雄市,路竹區,0178,159,472,631,45,676,1179,57.34%,13.49%,1
高雄市,路竹區,0179,194,450,644,58,702,1237,56.75%,15.68%,1
高雄市,路竹區,0180,212,397,609,51,660,1096,60.22%,19.34%,1
高雄市,路竹區,0181,212,528,740,65,805,1272,63.29%,16.67%,1
高雄市,路竹區,0182,193,462,655,47,702,1182,59.39%,16.33%,1
高雄市,路竹區,0183,157,451,608,47,655,1127,58.12%,13.93%,1
高雄市,路竹區,0184,187,351,538,37,575,956,60.15%,19.56%,1
高雄市,路竹區,0185,192,413,605,60,665,1132,58.75%,16.96%,1
高雄市,路竹區,0186,190,401,591,65,656,1025,64%,18.54%,1
高雄市,路竹區,0187,152,394,546,21,567,1007,56.31%,15.09%,1
高雄市,路竹區,0188,209,445,654,50,704,1301,54.11%,16.06%,1
高雄市,路竹區,0189,146,335,481,32,513,885,57.97%,16.5%,1
高雄市,路竹區,0190,132,268,400,14,414,837,49.46%,15.77%,1
高雄市,路竹區,0191,170,349,519,45,564,930,60.65%,18.28%,1
高雄市,路竹區,0192,130,238,368,39,407,781,52.11%,16.65%,1
高雄市,路竹區,0193,176,379,555,58,613,1023,59.92%,17.2%,1
高雄市,路竹區,0194,306,686,992,68,1060,1763,60.12%,17.36%,1
高雄市,路竹區,0195,261,618,879,52,931,1637,56.87%,15.94%,1
高雄市,路竹區,0196,383,178,561,48,609,1070,56.92%,35.79%,1
高雄市,路竹區,0197,201,476,677,49,726,1177,61.68%,17.08%,1
高雄市,路竹區,0198,172,382,554,39,593,1007,58.89%,17.08%,1
高雄市,路竹區,0199,196,365,561,37,598,1026,58.28%,19.1%,1
高雄市,路竹區,0200,175,391,566,33,599,1017,58.9%,17.21%,1
高雄市,路竹區,0201,227,478,705,36,741,1264,58.62%,17.96%,1
高雄市,路竹區,0202,186,441,627,42,669,1089,61.43%,17.08%,1
高雄市,路竹區,0203,128,333,461,34,495,851,58.17%,15.04%,1
高雄市,路竹區,0204,192,385,577,52,629,1011,62.22%,18.99%,1
高雄市,路竹區,0205,170,407,577,30,607,937,64.78%,18.14%,1
高雄市,路竹區,0206,126,286,412,15,427,820,52.07%,15.37%,1
高雄市,路竹區,0207,182,359,541,31,572,910,62.86%,20%,1
高雄市,路竹區,0208,153,300,453,41,494,867,56.98%,17.65%,1
高雄市,路竹區,0209,160,371,531,21,552,937,58.91%,17.08%,1
高雄市,路竹區,0210,197,296,493,30,523,900,58.11%,21.89%,1
高雄市,路竹區,0211,149,367,516,42,558,900,62%,16.56%,1
高雄市,路竹區,0212,136,394,530,32,562,918,61.22%,14.81%,1
高雄市,路竹區,0213,162,366,528,36,564,870,64.83%,18.62%,1
高雄市,路竹區,0214,216,469,685,37,722,1150,62.78%,18.78%,1
高雄市,路竹區,0215,272,664,936,49,985,1537,64.09%,17.7%,1
高雄市,湖內區,0151,143,398,541,30,571,1112,51.35%,12.86%,1
高雄市,湖內區,0152,158,365,523,66,589,1017,57.92%,15.54%,1
高雄市,湖內區,0153,142,259,401,26,427,796,53.64%,17.84%,1
高雄市,湖內區,0154,216,432,648,23,671,1079,62.19%,20.02%,1
高雄市,湖內區,0155,196,412,608,26,634,1115,56.86%,17.58%,1
高雄市,湖內區,0156,203,495,698,29,727,1311,55.45%,15.48%,1
高雄市,湖內區,0157,225,433,658,32,690,1319,52.31%,17.06%,1
高雄市,湖內區,0158,223,512,735,56,791,1244,63.59%,17.93%,1
高雄市,湖內區,0159,207,536,743,37,780,1227,63.57%,16.87%,1
高雄市,湖內區,0160,201,465,666,47,713,1163,61.31%,17.28%,1
高雄市,湖內區,0161,179,391,570,29,599,981,61.06%,18.25%,1
高雄市,湖內區,0162,117,288,405,19,424,780,54.36%,15%,1
高雄市,湖內區,0163,132,299,431,43,474,832,56.97%,15.87%,1
高雄市,湖內區,0164,199,406,605,37,642,1017,63.13%,19.57%,1
高雄市,湖內區,0165,213,385,598,19,617,1051,58.71%,20.27%,1
高雄市,湖內區,0166,141,351,492,27,519,941,55.15%,14.98%,1
高雄市,湖內區,0167,123,326,449,38,487,863,56.43%,14.25%,1
高雄市,湖內區,0168,213,380,593,37,630,1160,54.31%,18.36%,1
高雄市,湖內區,0169,163,295,458,28,486,1090,44.59%,14.95%,1
高雄市,湖內區,0170,210,391,601,47,648,1122,57.75%,18.72%,1
高雄市,湖內區,0171,185,338,523,28,551,1123,49.07%,16.47%,1
高雄市,湖內區,0172,101,261,362,24,386,684,56.43%,14.77%,1
高雄市,湖內區,0173,178,425,603,23,626,1249,50.12%,14.25%,1
高雄市,湖內區,0174,222,472,694,37,731,1453,50.31%,15.28%,1
高雄市,茄萣區,0130,149,305,454,18,472,976,48.36%,15.27%,1
高雄市,茄萣區,0131,147,288,435,51,486,887,54.79%,16.57%,1
高雄市,茄萣區,0132,253,602,855,35,890,1710,52.05%,14.8%,1
高雄市,茄萣區,0133,181,374,555,37,592,1280,46.25%,14.14%,1
高雄市,茄萣區,0134,217,513,730,31,761,1314,57.91%,16.51%,1
高雄市,茄萣區,0135,217,489,706,23,729,1157,63.01%,18.76%,1
高雄市,茄萣區,0136,275,630,905,83,988,1785,55.35%,15.41%,1
高雄市,茄萣區,0137,159,293,452,36,488,838,58.23%,18.97%,1
高雄市,茄萣區,0138,236,514,750,65,815,1249,65.25%,18.9%,1
高雄市,茄萣區,0139,194,354,548,67,615,1116,55.11%,17.38%,1
高雄市,茄萣區,0140,151,315,466,49,515,978,52.66%,15.44%,1
高雄市,茄萣區,0141,155,339,494,33,527,1125,46.84%,13.78%,1
高雄市,茄萣區,0142,183,384,567,56,623,1139,54.7%,16.07%,1
高雄市,茄萣區,0143,222,470,692,72,764,1363,56.05%,16.29%,1
高雄市,茄萣區,0144,253,617,870,76,946,1598,59.2%,15.83%,1
高雄市,茄萣區,0145,159,383,542,54,596,1111,53.65%,14.31%,1
高雄市,茄萣區,0146,116,285,401,36,437,925,47.24%,12.54%,1
高雄市,茄萣區,0147,177,403,580,45,625,1148,54.44%,15.42%,1
高雄市,茄萣區,0148,187,469,656,35,691,1353,51.07%,13.82%,1
高雄市,茄萣區,0149,190,487,677,54,731,1331,54.92%,14.27%,1
高雄市,茄萣區,0150,271,567,838,60,898,1829,49.1%,14.82%,1
高雄市,永安區,0249,131,338,469,35,504,756,66.67%,17.33%,1
高雄市,永安區,0250,144,334,478,45,523,818,63.94%,17.6%,1
高雄市,永安區,0251,170,401,571,31,602,866,69.52%,19.63%,1
高雄市,永安區,0252,158,402,560,53,613,951,64.46%,16.61%,1
高雄市,永安區,0253,160,421,581,52,633,992,63.81%,16.13%,1
高雄市,永安區,0254,112,205,317,17,334,682,48.97%,16.42%,1
高雄市,永安區,0255,106,278,384,18,402,665,60.45%,15.94%,1
高雄市,永安區,0256,65,127,192,11,203,371,54.72%,17.52%,1
高雄市,永安區,0257,190,485,675,57,732,1114,65.71%,17.06%,1
高雄市,永安區,0258,266,577,843,42,885,1418,62.41%,18.76%,1
高雄市,永安區,0259,254,623,877,76,953,1477,64.52%,17.2%,1
高雄市,永安區,0260,359,769,1128,64,1192,1891,63.04%,18.98%,1
高雄市,彌陀區,0358,180,512,692,56,748,1246,60.03%,14.45%,1
高雄市,彌陀區,0359,153,353,506,45,551,885,62.26%,17.29%,1
高雄市,彌陀區,0360,196,391,587,65,652,955,68.27%,20.52%,1
高雄市,彌陀區,0361,96,190,286,32,318,534,59.55%,17.98%,1
高雄市,彌陀區,0362,117,305,422,27,449,738,60.84%,15.85%,1
高雄市,彌陀區,0363,146,395,541,36,577,855,67.49%,17.08%,1
高雄市,彌陀區,0364,173,354,527,42,569,877,64.88%,19.73%,1
高雄市,彌陀區,0365,132,329,461,47,508,781,65.04%,16.9%,1
高雄市,彌陀區,0366,135,305,440,40,480,808,59.41%,16.71%,1
高雄市,彌陀區,0367,112,330,442,28,470,904,51.99%,12.39%,1
高雄市,彌陀區,0368,304,146,450,54,504,825,61.09%,36.85%,1
高雄市,彌陀區,0369,341,130,471,60,531,941,56.43%,36.24%,1
高雄市,彌陀區,0370,182,363,545,36,581,1013,57.35%,17.97%,1
高雄市,彌陀區,0371,158,451,609,54,663,1024,64.75%,15.43%,1
高雄市,彌陀區,0372,130,314,444,15,459,861,53.31%,15.1%,1
高雄市,彌陀區,0373,305,351,656,74,730,1163,62.77%,26.23%,1
高雄市,彌陀區,0374,204,534,738,59,797,1216,65.54%,16.78%,1
高雄市,彌陀區,0375,167,394,561,67,628,861,72.94%,19.4%,1
高雄市,梓官區,0376,156,465,621,60,681,1061,64.18%,14.7%,1
高雄市,梓官區,0377,184,395,579,58,637,1063,59.92%,17.31%,1
高雄市,梓官區,0378,177,380,557,22,579,969,59.75%,18.27%,1
高雄市,梓官區,0379,175,362,537,25,562,1078,52.13%,16.23%,1
高雄市,梓官區,0380,203,276,479,42,521,838,62.17%,24.22%,1
高雄市,梓官區,0381,105,247,352,41,393,611,64.32%,17.18%,1
高雄市,梓官區,0382,147,295,442,24,466,782,59.59%,18.8%,1
高雄市,梓官區,0383,244,635,879,67,946,1451,65.2%,16.82%,1
高雄市,梓官區,0384,213,403,616,22,638,1144,55.77%,18.62%,1
高雄市,梓官區,0385,139,367,506,21,527,975,54.05%,14.26%,1
高雄市,梓官區,0386,221,502,723,39,762,1317,57.86%,16.78%,1
高雄市,梓官區,0387,212,478,690,66,756,1218,62.07%,17.41%,1
高雄市,梓官區,0388,422,183,605,33,638,1073,59.46%,39.33%,1
高雄市,梓官區,0389,152,389,541,40,581,1112,52.25%,13.67%,1
高雄市,梓官區,0390,133,239,372,36,408,715,57.06%,18.6%,1
高雄市,梓官區,0391,202,470,672,49,721,1311,55%,15.41%,1
高雄市,梓官區,0392,169,365,534,25,559,939,59.53%,18%,1
高雄市,梓官區,0393,149,349,498,17,515,824,62.5%,18.08%,1
高雄市,梓官區,0394,184,451,635,67,702,1052,66.73%,17.49%,1
高雄市,梓官區,0395,155,416,571,80,651,1020,63.82%,15.2%,1
高雄市,梓官區,0396,205,455,660,31,691,1260,54.84%,16.27%,1
高雄市,梓官區,0397,250,586,836,36,872,1595,54.67%,15.67%,1
高雄市,梓官區,0398,125,335,460,40,500,829,60.31%,15.08%,1
高雄市,梓官區,0399,223,587,810,24,834,1532,54.44%,14.56%,1
高雄市,梓官區,0400,197,542,739,46,785,1195,65.69%,16.49%,1
高雄市,梓官區,0401,165,481,646,63,709,1143,62.03%,14.44%,1
高雄市,梓官區,0402,200,497,697,45,742,1186,62.56%,16.86%,1
高雄市,梓官區,0403,226,580,806,36,842,1732,48.61%,13.05%,1
高雄市,旗山區,0060,176,427,603,36,639,1060,60.28%,16.6%,1
高雄市,旗山區,0061,152,399,551,44,595,1125,52.89%,13.51%,1
高雄市,旗山區,0062,181,455,636,35,671,1100,61%,16.45%,1
高雄市,旗山區,0063,225,405,630,22,652,1238,52.67%,18.17%,1
高雄市,旗山區,0064,146,394,540,17,557,933,59.7%,15.65%,1
高雄市,旗山區,0065,111,248,359,16,375,727,51.58%,15.27%,1
高雄市,旗山區,0066,181,377,558,48,606,1071,56.58%,16.9%,1
高雄市,旗山區,0067,118,244,362,29,391,744,52.55%,15.86%,1
高雄市,旗山區,0068,142,368,510,27,537,1100,48.82%,12.91%,1
高雄市,旗山區,0069,53,126,179,16,195,369,52.85%,14.36%,1
高雄市,旗山區,0070,99,287,386,15,401,888,45.16%,11.15%,1
高雄市,旗山區,0071,66,145,211,11,222,510,43.53%,12.94%,1
高雄市,旗山區,0072,147,427,574,77,651,1042,62.48%,14.11%,1
高雄市,旗山區,0073,90,298,388,44,432,791,54.61%,11.38%,1
高雄市,旗山區,0074,150,348,498,67,565,939,60.17%,15.97%,1
高雄市,旗山區,0075,172,400,572,43,615,1218,50.49%,14.12%,1
高雄市,旗山區,0076,19,60,79,19,98,178,55.06%,10.67%,1
高雄市,旗山區,0077,174,375,549,42,591,946,62.47%,18.39%,1
高雄市,旗山區,0078,353,174,527,39,566,1025,55.22%,34.44%,1
高雄市,旗山區,0079,173,401,574,57,631,1040,60.67%,16.63%,1
高雄市,旗山區,0080,176,354,530,45,575,900,63.89%,19.56%,1
高雄市,旗山區,0081,117,214,331,19,350,663,52.79%,17.65%,1
高雄市,旗山區,0082,160,342,502,38,540,954,56.6%,16.77%,1
高雄市,旗山區,0083,181,362,543,31,574,1060,54.15%,17.08%,1
高雄市,旗山區,0084,196,425,621,46,667,1110,60.09%,17.66%,1
高雄市,旗山區,0085,190,394,584,48,632,1062,59.51%,17.89%,1
高雄市,旗山區,0086,183,436,619,43,662,1151,57.52%,15.9%,1
高雄市,旗山區,0087,46,98,144,22,166,266,62.41%,17.29%,1
高雄市,旗山區,0088,106,264,370,23,393,633,62.09%,16.75%,1
高雄市,旗山區,0089,182,424,606,41,647,1307,49.5%,13.93%,1
高雄市,旗山區,0090,120,249,369,63,432,754,57.29%,15.92%,1
高雄市,旗山區,0091,185,459,644,99,743,1296,57.33%,14.27%,1
高雄市,旗山區,0092,107,260,367,18,385,839,45.89%,12.75%,1
高雄市,旗山區,0093,193,510,703,56,759,1329,57.11%,14.52%,1
高雄市,旗山區,0094,91,251,342,30,372,628,59.24%,14.49%,1
高雄市,美濃區,0095,187,423,610,73,683,1175,58.13%,15.91%,1
高雄市,美濃區,0096,171,509,680,36,716,1438,49.79%,11.89%,1
高雄市,美濃區,0097,111,360,471,40,511,989,51.67%,11.22%,1
高雄市,美濃區,0098,212,548,760,63,823,1427,57.67%,14.86%,1
高雄市,美濃區,0099,243,483,726,61,787,1309,60.12%,18.56%,1
高雄市,美濃區,0100,177,541,718,57,775,1263,61.36%,14.01%,1
高雄市,美濃區,0101,138,424,562,44,606,997,60.78%,13.84%,1
高雄市,美濃區,0102,132,427,559,56,615,1064,57.8%,12.41%,1
高雄市,美濃區,0103,215,551,766,64,830,1498,55.41%,14.35%,1
高雄市,美濃區,0104,143,451,594,64,658,1119,58.8%,12.78%,1
高雄市,美濃區,0105,113,435,548,58,606,1031,58.78%,10.96%,1
高雄市,美濃區,0106,166,561,727,69,796,1437,55.39%,11.55%,1
高雄市,美濃區,0107,155,405,560,47,607,1071,56.68%,14.47%,1
高雄市,美濃區,0108,81,271,352,34,386,687,56.19%,11.79%,1
高雄市,美濃區,0109,74,248,322,20,342,775,44.13%,9.55%,1
高雄市,美濃區,0110,149,478,627,72,699,1353,51.66%,11.01%,1
高雄市,美濃區,0111,163,402,565,40,605,1191,50.8%,13.69%,1
高雄市,美濃區,0112,113,298,411,34,445,906,49.12%,12.47%,1
高雄市,美濃區,0113,162,492,654,42,696,1178,59.08%,13.75%,1
高雄市,美濃區,0114,159,433,592,24,616,1252,49.2%,12.7%,1
高雄市,美濃區,0115,206,626,832,48,880,1549,56.81%,13.3%,1
高雄市,美濃區,0116,110,413,523,45,568,1088,52.21%,10.11%,1
高雄市,美濃區,0117,156,435,591,44,635,1116,56.9%,13.98%,1
高雄市,美濃區,0118,153,335,488,37,525,977,53.74%,15.66%,1
高雄市,美濃區,0119,142,318,460,53,513,816,62.87%,17.4%,1
高雄市,美濃區,0120,107,319,426,28,454,955,47.54%,11.2%,1
高雄市,美濃區,0121,126,368,494,57,551,943,58.43%,13.36%,1
高雄市,美濃區,0122,175,484,659,44,703,1371,51.28%,12.76%,1
高雄市,美濃區,0123,225,234,459,54,513,919,55.82%,24.48%,1
高雄市,美濃區,0124,139,385,524,40,564,915,61.64%,15.19%,1
高雄市,美濃區,0125,93,293,386,71,457,828,55.19%,11.23%,1
高雄市,美濃區,0126,67,204,271,49,320,674,47.48%,9.94%,1
高雄市,六龜區,0020,111,238,349,30,379,760,49.87%,14.61%,1
高雄市,六龜區,0021,74,202,276,31,307,666,46.1%,11.11%,1
高雄市,六龜區,0022,108,243,351,53,404,704,57.39%,15.34%,1
高雄市,六龜區,0023,127,341,468,42,510,1003,50.85%,12.66%,1
高雄市,六龜區,0024,132,436,568,99,667,1382,48.26%,9.55%,1
高雄市,六龜區,0025,106,247,353,63,416,986,42.19%,10.75%,1
高雄市,六龜區,0026,134,359,493,36,529,1046,50.57%,12.81%,1
高雄市,六龜區,0027,99,228,327,52,379,812,46.67%,12.19%,1
高雄市,六龜區,0028,161,445,606,53,659,1431,46.05%,11.25%,1
高雄市,六龜區,0029,78,344,422,60,482,912,52.85%,8.55%,1
高雄市,六龜區,0030,254,300,554,52,606,1472,41.17%,17.26%,1
高雄市,六龜區,0031,30,93,123,20,143,327,43.73%,9.17%,1
高雄市,甲仙區,0013,42,123,165,7,172,472,36.44%,8.9%,1
高雄市,甲仙區,0014,138,362,500,54,554,882,62.81%,15.65%,1
高雄市,甲仙區,0015,90,239,329,27,356,668,53.29%,13.47%,1
高雄市,甲仙區,0016,200,496,696,98,794,1581,50.22%,12.65%,1
高雄市,甲仙區,0017,64,168,232,10,242,673,35.96%,9.51%,1
高雄市,甲仙區,0018,57,201,258,35,293,607,48.27%,9.39%,1
高雄市,甲仙區,0019,90,170,260,14,274,534,51.31%,16.85%,1
高雄市,杉林區,0032,75,193,268,50,318,640,49.69%,11.72%,1
高雄市,杉林區,0033,60,228,288,27,315,696,45.26%,8.62%,1
高雄市,杉林區,0034,115,331,446,43,489,1284,38.08%,8.96%,1
高雄市,杉林區,0035,110,303,413,34,447,1027,43.52%,10.71%,1
高雄市,杉林區,0036,45,168,213,22,235,482,48.76%,9.34%,1
高雄市,杉林區,0037,223,581,804,105,909,1627,55.87%,13.71%,1
高雄市,杉林區,0038,178,538,716,24,740,1630,45.4%,10.92%,1
高雄市,杉林區,0039,106,336,442,24,466,973,47.89%,10.89%,1
高雄市,杉林區,0040,116,276,392,21,413,987,41.84%,11.75%,1
高雄市,杉林區,0041,152,432,584,82,666,1261,52.82%,12.05%,1
高雄市,內門區,0042,89,318,407,52,459,969,47.37%,9.18%,1
高雄市,內門區,0043,83,159,242,22,264,652,40.49%,12.73%,1
高雄市,內門區,0044,123,310,433,79,512,961,53.28%,12.8%,1
高雄市,內門區,0045,33,141,174,6,180,426,42.25%,7.75%,1
高雄市,內門區,0046,30,133,163,21,184,398,46.23%,7.54%,1
高雄市,內門區,0047,62,152,214,16,230,508,45.28%,12.2%,1
高雄市,內門區,0048,130,393,523,50,573,980,58.47%,13.27%,1
高雄市,內門區,0049,132,367,499,37,536,1225,43.76%,10.78%,1
高雄市,內門區,0050,267,565,832,122,954,1722,55.4%,15.51%,1
高雄市,內門區,0051,78,171,249,26,275,560,49.11%,13.93%,1
高雄市,內門區,0052,92,233,325,20,345,801,43.07%,11.49%,1
高雄市,內門區,0053,55,145,200,16,216,423,51.06%,13%,1
高雄市,內門區,0054,54,157,211,25,236,497,47.48%,10.87%,1
高雄市,內門區,0055,85,220,305,24,329,677,48.6%,12.56%,1
高雄市,內門區,0056,46,169,215,13,228,593,38.45%,7.76%,1
高雄市,內門區,0057,73,154,227,44,271,597,45.39%,12.23%,1
高雄市,內門區,0058,30,112,142,7,149,343,43.44%,8.75%,1
高雄市,內門區,0059,99,143,242,34,276,670,41.19%,14.78%,1
高雄市,茂林區,0127,79,264,343,13,356,507,70.22%,15.58%,1
高雄市,茂林區,0128,66,189,255,15,270,382,70.68%,17.28%,1
高雄市,茂林區,0129,88,384,472,15,487,726,67.08%,12.12%,1
高雄市,桃源區,0001,40,72,112,2,114,264,43.18%,15.15%,1
高雄市,桃源區,0002,31,128,159,13,172,233,73.82%,13.3%,1
高雄市,桃源區,0003,25,162,187,6,193,279,69.18%,8.96%,1
高雄市,桃源區,0004,24,89,113,5,118,223,52.91%,10.76%,1
高雄市,桃源區,0005,82,291,373,8,381,783,48.66%,10.47%,1
高雄市,桃源區,0006,66,123,189,7,196,632,31.01%,10.44%,1
高雄市,桃源區,0007,69,331,400,16,416,612,67.97%,11.27%,1
高雄市,桃源區,0008,58,180,238,18,256,472,54.24%,12.29%,1
高雄市,那瑪夏區,0009,106,277,383,23,406,741,54.79%,14.3%,1
高雄市,那瑪夏區,0010,75,295,370,51,421,585,71.97%,12.82%,1
高雄市,那瑪夏區,0011,67,376,443,29,472,609,77.5%,11%,1
高雄市,那瑪夏區,0012,37,253,290,14,304,489,62.17%,7.57%,1
新竹縣,竹北市,0001,277,556,833,20,853,1319,64.67%,21%,1
新竹縣,竹北市,0002,298,490,788,18,806,1321,61.01%,22.56%,1
新竹縣,竹北市,0003,264,512,776,22,798,1272,62.74%,20.75%,1
新竹縣,竹北市,0004,290,539,829,20,849,1467,57.87%,19.77%,1
新竹縣,竹北市,0005,264,434,698,17,715,1226,58.32%,21.53%,1
新竹縣,竹北市,0006,303,488,791,15,806,1412,57.08%,21.46%,1
新竹縣,竹北市,0007,351,528,879,11,890,1400,63.57%,25.07%,1
新竹縣,竹北市,0008,367,483,850,28,878,1415,62.05%,25.94%,1
新竹縣,竹北市,0009,314,468,782,19,801,1361,58.85%,23.07%,1
新竹縣,竹北市,0010,389,439,828,13,841,1515,55.51%,25.68%,1
新竹縣,竹北市,0011,370,508,878,23,901,1495,60.27%,24.75%,1
新竹縣,竹北市,0012,458,364,822,20,842,1417,59.42%,32.32%,1
新竹縣,竹北市,0013,396,471,867,22,889,1548,57.43%,25.58%,1
新竹縣,竹北市,0014,382,402,784,14,798,1434,55.65%,26.64%,1
新竹縣,竹北市,0015,300,486,786,30,816,1385,58.92%,21.66%,1
新竹縣,竹北市,0016,311,478,789,7,796,1247,63.83%,24.94%,1
新竹縣,竹北市,0017,309,456,765,30,795,1373,57.9%,22.51%,1
新竹縣,竹北市,0018,367,478,845,15,860,1345,63.94%,27.29%,1
新竹縣,竹北市,0019,203,446,649,24,673,1165,57.77%,17.42%,1
新竹縣,竹北市,0020,291,435,726,25,751,1164,64.52%,25%,1
新竹縣,竹北市,0021,294,436,730,26,756,1212,62.38%,24.26%,1
新竹縣,竹北市,0022,199,545,744,17,761,1507,50.5%,13.21%,1
新竹縣,竹北市,0023,215,582,797,34,831,1576,52.73%,13.64%,1
新竹縣,竹北市,0024,295,507,802,26,828,1464,56.56%,20.15%,1
新竹縣,竹北市,0025,332,461,793,23,816,1428,57.14%,23.25%,1
新竹縣,竹北市,0026,370,342,712,18,730,1442,50.62%,25.66%,1
新竹縣,竹北市,0027,282,513,795,49,844,1415,59.65%,19.93%,1
新竹縣,竹北市,0028,351,468,819,13,832,1666,49.94%,21.07%,1
新竹縣,竹北市,0029,375,547,922,19,941,1751,53.74%,21.42%,1
新竹縣,竹北市,0030,270,456,726,14,740,1196,61.87%,22.58%,1
新竹縣,竹北市,0031,258,461,719,24,743,1235,60.16%,20.89%,1
新竹縣,竹北市,0032,260,412,672,14,686,1204,56.98%,21.59%,1
新竹縣,竹北市,0033,264,510,774,29,803,1308,61.39%,20.18%,1
新竹縣,竹北市,0034,271,431,702,15,717,1233,58.15%,21.98%,1
新竹縣,竹北市,0035,233,428,661,14,675,1129,59.79%,20.64%,1
新竹縣,竹北市,0036,227,414,641,19,660,1069,61.74%,21.23%,1
新竹縣,竹北市,0037,242,445,687,23,710,1114,63.73%,21.72%,1
新竹縣,竹北市,0038,239,429,668,24,692,1103,62.74%,21.67%,1
新竹縣,竹北市,0039,234,417,651,17,668,1029,64.92%,22.74%,1
新竹縣,竹北市,0040,258,451,709,19,728,1133,64.25%,22.77%,1
新竹縣,竹北市,0041,272,472,744,13,757,1301,58.19%,20.91%,1
新竹縣,竹北市,0042,408,609,1017,27,1044,1798,58.06%,22.69%,1
新竹縣,竹北市,0043,280,538,818,34,852,1427,59.71%,19.62%,1
新竹縣,竹北市,0044,305,577,882,28,910,1462,62.24%,20.86%,1
新竹縣,竹北市,0045,278,553,831,14,845,1342,62.97%,20.72%,1
新竹縣,竹北市,0046,421,453,874,25,899,1480,60.74%,28.45%,1
新竹縣,竹北市,0047,346,560,906,24,930,1645,56.53%,21.03%,1
新竹縣,竹北市,0048,262,517,779,25,804,1256,64.01%,20.86%,1
新竹縣,竹北市,0049,242,454,696,26,722,1181,61.13%,20.49%,1
新竹縣,竹北市,0050,236,601,837,23,860,1329,64.71%,17.76%,1
新竹縣,竹北市,0051,240,531,771,25,796,1228,64.82%,19.54%,1
新竹縣,竹北市,0052,340,512,852,24,876,1552,56.44%,21.91%,1
新竹縣,竹北市,0053,260,611,871,21,892,1480,60.27%,17.57%,1
新竹縣,竹北市,0054,266,538,804,14,818,1487,55.01%,17.89%,1
新竹縣,竹北市,0055,239,536,775,33,808,1470,54.97%,16.26%,1
新竹縣,竹北市,0056,228,537,765,23,788,1477,53.35%,15.44%,1
新竹縣,竹北市,0057,325,616,941,40,981,1611,60.89%,20.17%,1
新竹縣,竹北市,0058,290,579,869,39,908,1555,58.39%,18.65%,1
新竹縣,竹北市,0059,251,520,771,31,802,1468,54.63%,17.1%,1
新竹縣,竹北市,0060,268,610,878,23,901,1509,59.71%,17.76%,1
新竹縣,竹北市,0061,260,602,862,28,890,1602,55.56%,16.23%,1
新竹縣,竹北市,0062,257,571,828,41,869,1448,60.01%,17.75%,1
新竹縣,竹北市,0063,233,536,769,30,799,1318,60.62%,17.68%,1
新竹縣,竹北市,0064,328,645,973,36,1009,1634,61.75%,20.07%,1
新竹縣,竹北市,0065,198,519,717,58,775,1345,57.62%,14.72%,1
新竹縣,竹北市,0066,183,417,600,18,618,958,64.51%,19.1%,1
新竹縣,竹北市,0067,194,482,676,29,705,1112,63.4%,17.45%,1
新竹縣,竹北市,0068,180,451,631,40,671,1134,59.17%,15.87%,1
新竹縣,竹北市,0069,263,564,827,33,860,1483,57.99%,17.73%,1
新竹縣,竹北市,0070,231,470,701,48,749,1332,56.23%,17.34%,1
新竹縣,竹北市,0071,232,507,739,28,767,1482,51.75%,15.65%,1
新竹縣,竹北市,0072,196,405,601,20,621,1449,42.86%,13.53%,1
新竹縣,竹北市,0073,223,480,703,17,720,1319,54.59%,16.91%,1
新竹縣,竹北市,0074,213,486,699,30,729,1332,54.73%,15.99%,1
新竹縣,竹北市,0075,251,470,721,28,749,1412,53.05%,17.78%,1
新竹縣,竹北市,0076,249,598,847,37,884,1640,53.9%,15.18%,1
新竹縣,竹北市,0077,228,522,750,31,781,1323,59.03%,17.23%,1
新竹縣,竹北市,0078,274,529,803,45,848,1428,59.38%,19.19%,1
新竹縣,竹北市,0079,263,594,857,35,892,1533,58.19%,17.16%,1
新竹縣,竹北市,0080,238,455,693,23,716,1346,53.19%,17.68%,1
新竹縣,竹北市,0081,163,472,635,34,669,1219,54.88%,13.37%,1
新竹縣,竹北市,0082,267,580,847,50,897,1466,61.19%,18.21%,1
新竹縣,竹北市,0083,223,377,600,32,632,1147,55.1%,19.44%,1
新竹縣,竹北市,0084,246,464,710,39,749,1529,48.99%,16.09%,1
新竹縣,竹北市,0085,242,601,843,36,879,1522,57.75%,15.9%,1
新竹縣,竹北市,0086,224,555,779,52,831,1383,60.09%,16.2%,1
新竹縣,竹北市,0087,278,597,875,38,913,1569,58.19%,17.72%,1
新竹縣,竹北市,0088,242,547,789,18,807,1506,53.59%,16.07%,1
新竹縣,竹北市,0089,128,347,475,31,506,877,57.7%,14.6%,1
新竹縣,竹北市,0090,196,403,599,28,627,1074,58.38%,18.25%,1
新竹縣,竹北市,0091,201,464,665,40,705,1089,64.74%,18.46%,1
新竹縣,竹北市,0092,232,509,741,52,793,1336,59.36%,17.37%,1
新竹縣,竹北市,0093,185,384,569,35,604,1058,57.09%,17.49%,1
新竹縣,竹北市,0094,191,400,591,34,625,937,66.7%,20.38%,1
新竹縣,竹北市,0095,186,460,646,43,689,1206,57.13%,15.42%,1
新竹縣,竹北市,0096,206,457,663,40,703,1205,58.34%,17.1%,1
新竹縣,竹北市,0097,315,642,957,72,1029,1718,59.9%,18.34%,1
新竹縣,竹北市,0098,143,340,483,44,527,917,57.47%,15.59%,1
新竹縣,竹北市,0099,123,257,380,24,404,668,60.48%,18.41%,1
新竹縣,竹北市,0100,133,300,433,28,461,824,55.95%,16.14%,1
新竹縣,竹北市,0101,244,163,407,58,465,782,59.46%,31.2%,1
新竹縣,竹北市,0102,164,378,542,60,602,977,61.62%,16.79%,1
新竹縣,竹北市,0103,137,326,463,19,482,937,51.44%,14.62%,1
新竹縣,竹東鎮,0104,27,115,142,14,156,309,50.49%,8.74%,1
新竹縣,竹東鎮,0105,62,130,192,23,215,416,51.68%,14.9%,1
新竹縣,竹東鎮,0106,54,137,191,7,198,386,51.3%,13.99%,1
新竹縣,竹東鎮,0107,124,328,452,27,479,950,50.42%,13.05%,1
新竹縣,竹東鎮,0108,187,481,668,12,680,1275,53.33%,14.67%,1
新竹縣,竹東鎮,0109,168,456,624,33,657,1213,54.16%,13.85%,1
新竹縣,竹東鎮,0110,250,589,839,33,872,1548,56.33%,16.15%,1
新竹縣,竹東鎮,0111,189,414,603,28,631,1246,50.64%,15.17%,1
新竹縣,竹東鎮,0112,143,402,545,31,576,1252,46.01%,11.42%,1
新竹縣,竹東鎮,0113,163,521,684,36,720,1359,52.98%,11.99%,1
新竹縣,竹東鎮,0114,186,453,639,35,674,1255,53.71%,14.82%,1
新竹縣,竹東鎮,0115,207,520,727,23,750,1304,57.52%,15.87%,1
新竹縣,竹東鎮,0116,212,472,684,44,728,1292,56.35%,16.41%,1
新竹縣,竹東鎮,0117,133,417,550,18,568,1111,51.13%,11.97%,1
新竹縣,竹東鎮,0118,127,355,482,43,525,880,59.66%,14.43%,1
新竹縣,竹東鎮,0119,114,261,375,19,394,670,58.81%,17.01%,1
新竹縣,竹東鎮,0120,188,499,687,38,725,1244,58.28%,15.11%,1
新竹縣,竹東鎮,0121,144,422,566,45,611,1126,54.26%,12.79%,1
新竹縣,竹東鎮,0122,157,407,564,26,590,1073,54.99%,14.63%,1
新竹縣,竹東鎮,0123,194,475,669,26,695,1215,57.2%,15.97%,1
新竹縣,竹東鎮,0124,181,467,648,14,662,1155,57.32%,15.67%,1
新竹縣,竹東鎮,0125,135,318,453,35,488,852,57.28%,15.85%,1
新竹縣,竹東鎮,0126,158,345,503,23,526,875,60.11%,18.06%,1
新竹縣,竹東鎮,0127,144,476,620,32,652,1070,60.93%,13.46%,1
新竹縣,竹東鎮,0128,121,247,368,21,389,704,55.26%,17.19%,1
新竹縣,竹東鎮,0129,81,274,355,27,382,951,40.17%,8.52%,1
新竹縣,竹東鎮,0130,187,356,543,18,561,984,57.01%,19%,1
新竹縣,竹東鎮,0131,180,301,481,10,491,1113,44.12%,16.17%,1
新竹縣,竹東鎮,0132,84,253,337,20,357,595,60%,14.12%,1
新竹縣,竹東鎮,0133,120,312,432,37,469,762,61.55%,15.75%,1
新竹縣,竹東鎮,0134,140,270,410,20,430,763,56.36%,18.35%,1
新竹縣,竹東鎮,0135,124,271,395,24,419,813,51.54%,15.25%,1
新竹縣,竹東鎮,0136,158,466,624,20,644,1310,49.16%,12.06%,1
新竹縣,竹東鎮,0137,193,472,665,40,705,1434,49.16%,13.46%,1
新竹縣,竹東鎮,0138,190,424,614,23,637,1131,56.32%,16.8%,1
新竹縣,竹東鎮,0139,161,352,513,19,532,967,55.02%,16.65%,1
新竹縣,竹東鎮,0140,162,419,581,31,612,1196,51.17%,13.55%,1
新竹縣,竹東鎮,0141,179,448,627,27,654,1154,56.67%,15.51%,1
新竹縣,竹東鎮,0142,126,277,403,36,439,715,61.4%,17.62%,1
新竹縣,竹東鎮,0143,108,281,389,12,401,685,58.54%,15.77%,1
新竹縣,竹東鎮,0144,210,470,680,39,719,1352,53.18%,15.53%,1
新竹縣,竹東鎮,0145,206,565,771,35,806,1407,57.29%,14.64%,1
新竹縣,竹東鎮,0146,194,532,726,21,747,1362,54.85%,14.24%,1
新竹縣,竹東鎮,0147,204,533,737,27,764,1330,57.44%,15.34%,1
新竹縣,竹東鎮,0148,221,519,740,42,782,1441,54.27%,15.34%,1
新竹縣,竹東鎮,0149,208,426,634,12,646,1248,51.76%,16.67%,1
新竹縣,竹東鎮,0150,204,348,552,18,570,1263,45.13%,16.15%,1
新竹縣,竹東鎮,0151,161,430,591,25,616,1232,50%,13.07%,1
新竹縣,竹東鎮,0152,151,368,519,25,544,1143,47.59%,13.21%,1
新竹縣,竹東鎮,0153,249,561,810,26,836,1529,54.68%,16.29%,1
新竹縣,竹東鎮,0154,183,421,604,24,628,1140,55.09%,16.05%,1
新竹縣,竹東鎮,0155,99,244,343,23,366,570,64.21%,17.37%,1
新竹縣,竹東鎮,0156,198,430,628,28,656,1345,48.77%,14.72%,1
新竹縣,竹東鎮,0157,251,436,687,48,735,1381,53.22%,18.18%,1
新竹縣,竹東鎮,0158,245,477,722,43,765,1379,55.47%,17.77%,1
新竹縣,竹東鎮,0159,168,397,565,40,605,1033,58.57%,16.26%,1
新竹縣,竹東鎮,0160,165,395,560,25,585,1066,54.88%,15.48%,1
新竹縣,竹東鎮,0161,146,370,516,40,556,938,59.28%,15.57%,1
新竹縣,竹東鎮,0162,165,384,549,38,587,952,61.66%,17.33%,1
新竹縣,竹東鎮,0163,285,554,839,44,883,1468,60.15%,19.41%,1
新竹縣,竹東鎮,0164,454,501,955,24,979,1915,51.12%,23.71%,1
新竹縣,竹東鎮,0165,186,409,595,43,638,1220,52.3%,15.25%,1
新竹縣,竹東鎮,0166,162,356,518,14,532,1166,45.63%,13.89%,1
新竹縣,竹東鎮,0167,208,507,715,20,735,1492,49.26%,13.94%,1
新竹縣,竹東鎮,0168,195,439,634,24,658,1245,52.85%,15.66%,1
新竹縣,竹東鎮,0169,187,398,585,40,625,1083,57.71%,17.27%,1
新竹縣,竹東鎮,0170,194,386,580,26,606,1102,54.99%,17.6%,1
新竹縣,竹東鎮,0171,178,393,571,26,597,1068,55.9%,16.67%,1
新竹縣,竹東鎮,0172,192,406,598,28,626,1097,57.06%,17.5%,1
新竹縣,竹東鎮,0173,125,366,491,22,513,962,53.33%,12.99%,1
新竹縣,竹東鎮,0174,138,362,500,25,525,909,57.76%,15.18%,1
新竹縣,竹東鎮,0175,82,196,278,25,303,603,50.25%,13.6%,1
新竹縣,新埔鎮,0176,151,415,566,22,588,983,59.82%,15.36%,1
新竹縣,新埔鎮,0177,137,210,347,22,369,597,61.81%,22.95%,1
新竹縣,新埔鎮,0178,163,412,575,24,599,1070,55.98%,15.23%,1
新竹縣,新埔鎮,0179,132,363,495,27,522,935,55.83%,14.12%,1
新竹縣,新埔鎮,0180,108,308,416,19,435,753,57.77%,14.34%,1
新竹縣,新埔鎮,0181,142,386,528,23,551,838,65.75%,16.95%,1
新竹縣,新埔鎮,0182,129,389,518,23,541,924,58.55%,13.96%,1
新竹縣,新埔鎮,0183,134,304,438,21,459,905,50.72%,14.81%,1
新竹縣,新埔鎮,0184,128,385,513,25,538,948,56.75%,13.5%,1
新竹縣,新埔鎮,0185,133,418,551,45,596,1017,58.6%,13.08%,1
新竹縣,新埔鎮,0186,209,479,688,28,716,1176,60.88%,17.77%,1
新竹縣,新埔鎮,0187,195,465,660,39,699,1122,62.3%,17.38%,1
新竹縣,新埔鎮,0188,140,324,464,15,479,1022,46.87%,13.7%,1
新竹縣,新埔鎮,0189,189,487,676,37,713,1429,49.9%,13.23%,1
新竹縣,新埔鎮,0190,68,204,272,33,305,451,67.63%,15.08%,1
新竹縣,新埔鎮,0191,109,279,388,25,413,724,57.04%,15.06%,1
新竹縣,新埔鎮,0192,79,287,366,28,394,617,63.86%,12.8%,1
新竹縣,新埔鎮,0193,167,463,630,49,679,1144,59.35%,14.6%,1
新竹縣,新埔鎮,0194,162,459,621,38,659,1139,57.86%,14.22%,1
新竹縣,新埔鎮,0195,108,364,472,24,496,861,57.61%,12.54%,1
新竹縣,新埔鎮,0196,147,386,533,24,557,1093,50.96%,13.45%,1
新竹縣,新埔鎮,0197,131,349,480,27,507,978,51.84%,13.39%,1
新竹縣,新埔鎮,0198,136,360,496,17,513,1040,49.33%,13.08%,1
新竹縣,新埔鎮,0199,184,405,589,32,621,1160,53.53%,15.86%,1
新竹縣,新埔鎮,0200,172,367,539,37,576,950,60.63%,18.11%,1
新竹縣,新埔鎮,0201,117,357,474,25,499,882,56.58%,13.27%,1
新竹縣,新埔鎮,0202,226,468,694,46,740,1281,57.77%,17.64%,1
新竹縣,新埔鎮,0203,187,427,614,37,651,1212,53.71%,15.43%,1
新竹縣,新埔鎮,0204,127,323,450,35,485,1013,47.88%,12.54%,1
新竹縣,新埔鎮,0205,113,266,379,23,402,630,63.81%,17.94%,1
新竹縣,關西鎮,0206,64,229,293,16,309,480,64.38%,13.33%,1
新竹縣,關西鎮,0207,160,353,513,27,540,903,59.8%,17.72%,1
新竹縣,關西鎮,0208,152,406,558,36,594,1020,58.24%,14.9%,1
新竹縣,關西鎮,0209,110,279,389,17,406,705,57.59%,15.6%,1
新竹縣,關西鎮,0210,136,419,555,26,581,1056,55.02%,12.88%,1
新竹縣,關西鎮,0211,181,479,660,39,699,1275,54.82%,14.2%,1
新竹縣,關西鎮,0212,195,524,719,47,766,1287,59.52%,15.15%,1
新竹縣,關西鎮,0213,108,322,430,36,466,771,60.44%,14.01%,1
新竹縣,關西鎮,0214,250,276,526,47,573,1046,54.78%,23.9%,1
新竹縣,關西鎮,0215,148,414,562,41,603,1030,58.54%,14.37%,1
新竹縣,關西鎮,0216,184,469,653,31,684,1208,56.62%,15.23%,1
新竹縣,關西鎮,0217,135,382,517,15,532,1095,48.58%,12.33%,1
新竹縣,關西鎮,0218,190,474,664,48,712,1350,52.74%,14.07%,1
新竹縣,關西鎮,0219,150,360,510,26,536,846,63.36%,17.73%,1
新竹縣,關西鎮,0220,186,521,707,41,748,1362,54.92%,13.66%,1
新竹縣,關西鎮,0221,92,337,429,25,454,903,50.28%,10.19%,1
新竹縣,關西鎮,0222,69,179,248,19,267,551,48.46%,12.52%,1
新竹縣,關西鎮,0223,53,123,176,15,191,461,41.43%,11.5%,1
新竹縣,關西鎮,0224,69,223,292,27,319,572,55.77%,12.06%,1
新竹縣,關西鎮,0225,94,382,476,30,506,943,53.66%,9.97%,1
新竹縣,關西鎮,0226,130,305,435,36,471,808,58.29%,16.09%,1
新竹縣,關西鎮,0227,148,412,560,23,583,923,63.16%,16.03%,1
新竹縣,關西鎮,0228,135,374,509,26,535,903,59.25%,14.95%,1
新竹縣,關西鎮,0229,132,424,556,23,579,977,59.26%,13.51%,1
新竹縣,關西鎮,0230,132,358,490,24,514,824,62.38%,16.02%,1
新竹縣,關西鎮,0231,80,268,348,14,362,559,64.76%,14.31%,1
新竹縣,關西鎮,0232,140,363,503,31,534,854,62.53%,16.39%,1
新竹縣,湖口鄉,0233,205,487,692,31,723,1393,51.9%,14.72%,1
新竹縣,湖口鄉,0234,240,591,831,40,871,1505,57.87%,15.95%,1
新竹縣,湖口鄉,0235,206,530,736,29,765,1188,64.39%,17.34%,1
新竹縣,湖口鄉,0236,165,531,696,34,730,1267,57.62%,13.02%,1
新竹縣,湖口鄉,0237,253,658,911,41,952,1668,57.07%,15.17%,1
新竹縣,湖口鄉,0238,280,669,949,48,997,1719,58%,16.29%,1
新竹縣,湖口鄉,0239,191,486,677,39,716,1162,61.62%,16.44%,1
新竹縣,湖口鄉,0240,227,673,900,42,942,1833,51.39%,12.38%,1
新竹縣,湖口鄉,0241,252,532,784,37,821,1444,56.86%,17.45%,1
新竹縣,湖口鄉,0242,216,578,794,41,835,1347,61.99%,16.04%,1
新竹縣,湖口鄉,0243,192,519,711,21,732,1202,60.9%,15.97%,1
新竹縣,湖口鄉,0244,138,342,480,47,527,851,61.93%,16.22%,1
新竹縣,湖口鄉,0245,218,521,739,35,774,1272,60.85%,17.14%,1
新竹縣,湖口鄉,0246,187,515,702,37,739,1275,57.96%,14.67%,1
新竹縣,湖口鄉,0247,250,669,919,50,969,1560,62.12%,16.03%,1
新竹縣,湖口鄉,0248,192,479,671,64,735,1147,64.08%,16.74%,1
新竹縣,湖口鄉,0249,240,703,943,37,980,1729,56.68%,13.88%,1
新竹縣,湖口鄉,0250,239,473,712,43,755,1402,53.85%,17.05%,1
新竹縣,湖口鄉,0251,183,484,667,40,707,1183,59.76%,15.47%,1
新竹縣,湖口鄉,0252,245,400,645,33,678,1282,52.89%,19.11%,1
新竹縣,湖口鄉,0253,224,540,764,39,803,1335,60.15%,16.78%,1
新竹縣,湖口鄉,0254,248,649,897,34,931,1493,62.36%,16.61%,1
新竹縣,湖口鄉,0255,255,733,988,23,1011,1877,53.86%,13.59%,1
新竹縣,湖口鄉,0256,160,469,629,43,672,1082,62.11%,14.79%,1
新竹縣,湖口鄉,0257,172,464,636,49,685,1115,61.43%,15.43%,1
新竹縣,湖口鄉,0258,166,422,588,31,619,1193,51.89%,13.91%,1
新竹縣,湖口鄉,0259,245,764,1009,38,1047,1947,53.78%,12.58%,1
新竹縣,湖口鄉,0260,165,452,617,56,673,1125,59.82%,14.67%,1
新竹縣,湖口鄉,0261,140,438,578,34,612,1050,58.29%,13.33%,1
新竹縣,湖口鄉,0262,283,681,964,38,1002,1733,57.82%,16.33%,1
新竹縣,湖口鄉,0263,208,518,726,32,758,1284,59.03%,16.2%,1
新竹縣,湖口鄉,0264,161,439,600,33,633,1062,59.6%,15.16%,1
新竹縣,湖口鄉,0265,210,586,796,55,851,1547,55.01%,13.57%,1
新竹縣,湖口鄉,0266,202,516,718,33,751,1494,50.27%,13.52%,1
新竹縣,湖口鄉,0267,215,535,750,36,786,1634,48.1%,13.16%,1
新竹縣,湖口鄉,0268,207,449,656,26,682,1444,47.23%,14.34%,1
新竹縣,湖口鄉,0269,219,464,683,20,703,1324,53.1%,16.54%,1
新竹縣,湖口鄉,0270,162,413,575,26,601,1058,56.81%,15.31%,1
新竹縣,湖口鄉,0271,360,155,515,19,534,1220,43.77%,29.51%,1
新竹縣,湖口鄉,0272,232,489,721,30,751,1333,56.34%,17.4%,1
新竹縣,湖口鄉,0273,193,528,721,45,766,1461,52.43%,13.21%,1
新竹縣,湖口鄉,0274,209,557,766,22,788,1429,55.14%,14.63%,1
新竹縣,湖口鄉,0275,199,489,688,27,715,1506,47.48%,13.21%,1
新竹縣,湖口鄉,0276,168,467,635,45,680,1103,61.65%,15.23%,1
新竹縣,湖口鄉,0277,200,507,707,35,742,1495,49.63%,13.38%,1
新竹縣,湖口鄉,0278,101,299,400,34,434,752,57.71%,13.43%,1
新竹縣,湖口鄉,0279,144,380,524,20,544,986,55.17%,14.6%,1
新竹縣,新豐鄉,0280,148,392,540,44,584,1080,54.07%,13.7%,1
新竹縣,新豐鄉,0281,131,314,445,23,468,887,52.76%,14.77%,1
新竹縣,新豐鄉,0282,149,361,510,29,539,954,56.5%,15.62%,1
新竹縣,新豐鄉,0283,166,371,537,36,573,1003,57.13%,16.55%,1
新竹縣,新豐鄉,0284,147,419,566,38,604,1106,54.61%,13.29%,1
新竹縣,新豐鄉,0285,183,437,620,39,659,1123,58.68%,16.3%,1
新竹縣,新豐鄉,0286,141,344,485,42,527,891,59.15%,15.82%,1
新竹縣,新豐鄉,0287,117,301,418,22,440,874,50.34%,13.39%,1
新竹縣,新豐鄉,0288,132,299,431,30,461,824,55.95%,16.02%,1
新竹縣,新豐鄉,0289,130,332,462,28,490,975,50.26%,13.33%,1
新竹縣,新豐鄉,0290,140,294,434,40,474,847,55.96%,16.53%,1
新竹縣,新豐鄉,0291,223,555,778,52,830,1477,56.19%,15.1%,1
新竹縣,新豐鄉,0292,214,407,621,47,668,1266,52.76%,16.9%,1
新竹縣,新豐鄉,0293,133,371,504,57,561,1029,54.52%,12.93%,1
新竹縣,新豐鄉,0294,148,385,533,43,576,1063,54.19%,13.92%,1
新竹縣,新豐鄉,0295,160,412,572,16,588,1055,55.73%,15.17%,1
新竹縣,新豐鄉,0296,227,556,783,28,811,1445,56.12%,15.71%,1
新竹縣,新豐鄉,0297,261,585,846,22,868,1413,61.43%,18.47%,1
新竹縣,新豐鄉,0298,179,421,600,20,620,971,63.85%,18.43%,1
新竹縣,新豐鄉,0299,185,473,658,22,680,1135,59.91%,16.3%,1
新竹縣,新豐鄉,0300,201,447,648,35,683,1269,53.82%,15.84%,1
新竹縣,新豐鄉,0301,179,496,675,37,712,1257,56.64%,14.24%,1
新竹縣,新豐鄉,0302,284,634,918,33,951,1662,57.22%,17.09%,1
新竹縣,新豐鄉,0303,225,538,763,18,781,1486,52.56%,15.14%,1
新竹縣,新豐鄉,0304,162,462,624,45,669,1067,62.7%,15.18%,1
新竹縣,新豐鄉,0305,207,551,758,30,788,1302,60.52%,15.9%,1
新竹縣,新豐鄉,0306,200,559,759,33,792,1410,56.17%,14.18%,1
新竹縣,新豐鄉,0307,189,477,666,28,694,1267,54.78%,14.92%,1
新竹縣,新豐鄉,0308,189,404,593,37,630,1258,50.08%,15.02%,1
新竹縣,新豐鄉,0309,180,415,595,17,612,1217,50.29%,14.79%,1
新竹縣,新豐鄉,0310,197,582,779,25,804,1456,55.22%,13.53%,1
新竹縣,新豐鄉,0311,189,465,654,25,679,1157,58.69%,16.34%,1
新竹縣,新豐鄉,0312,153,396,549,26,575,1089,52.8%,14.05%,1
新竹縣,新豐鄉,0313,188,466,654,8,662,1160,57.07%,16.21%,1
新竹縣,新豐鄉,0314,168,429,597,16,613,976,62.81%,17.21%,1
新竹縣,新豐鄉,0315,245,535,780,33,813,1443,56.34%,16.98%,1
新竹縣,新豐鄉,0316,188,428,616,22,638,1247,51.16%,15.08%,1
新竹縣,新豐鄉,0317,230,546,776,16,792,1411,56.13%,16.3%,1
新竹縣,新豐鄉,0318,204,495,699,37,736,1238,59.45%,16.48%,1
新竹縣,芎林鄉,0319,61,167,228,14,242,417,58.03%,14.63%,1
新竹縣,芎林鄉,0320,99,263,362,19,381,534,71.35%,18.54%,1
新竹縣,芎林鄉,0321,163,377,540,25,565,963,58.67%,16.93%,1
新竹縣,芎林鄉,0322,83,170,253,17,270,418,64.59%,19.86%,1
新竹縣,芎林鄉,0323,174,509,683,39,722,1312,55.03%,13.26%,1
新竹縣,芎林鄉,0324,207,444,651,31,682,1354,50.37%,15.29%,1
新竹縣,芎林鄉,0325,143,301,444,31,475,785,60.51%,18.22%,1
新竹縣,芎林鄉,0326,112,321,433,56,489,797,61.36%,14.05%,1
新竹縣,芎林鄉,0327,84,292,376,19,395,623,63.4%,13.48%,1
新竹縣,芎林鄉,0328,108,297,405,37,442,759,58.23%,14.23%,1
新竹縣,芎林鄉,0329,188,421,609,39,648,1272,50.94%,14.78%,1
新竹縣,芎林鄉,0330,168,479,647,26,673,1129,59.61%,14.88%,1
新竹縣,芎林鄉,0331,115,302,417,27,444,713,62.27%,16.13%,1
新竹縣,芎林鄉,0332,148,345,493,31,524,839,62.46%,17.64%,1
新竹縣,芎林鄉,0333,190,520,710,29,739,1123,65.81%,16.92%,1
新竹縣,芎林鄉,0334,165,407,572,18,590,981,60.14%,16.82%,1
新竹縣,芎林鄉,0335,232,386,618,41,659,1078,61.13%,21.52%,1
新竹縣,芎林鄉,0336,161,413,574,24,598,1094,54.66%,14.72%,1
新竹縣,芎林鄉,0337,166,441,607,48,655,1102,59.44%,15.06%,1
新竹縣,橫山鄉,0338,197,506,703,48,751,1231,61.01%,16%,1
新竹縣,橫山鄉,0339,157,425,582,47,629,1041,60.42%,15.08%,1
新竹縣,橫山鄉,0340,158,494,652,35,687,1132,60.69%,13.96%,1
新竹縣,橫山鄉,0341,132,346,478,41,519,859,60.42%,15.37%,1
新竹縣,橫山鄉,0342,18,83,101,16,117,204,57.35%,8.82%,1
新竹縣,橫山鄉,0343,24,68,92,9,101,222,45.5%,10.81%,1
新竹縣,橫山鄉,0344,52,129,181,37,218,338,64.5%,15.38%,1
新竹縣,橫山鄉,0345,110,363,473,19,492,916,53.71%,12.01%,1
新竹縣,橫山鄉,0346,64,159,223,17,240,573,41.88%,11.17%,1
新竹縣,橫山鄉,0347,48,131,179,10,189,275,68.73%,17.45%,1
新竹縣,橫山鄉,0348,56,161,217,14,231,463,49.89%,12.1%,1
新竹縣,橫山鄉,0349,98,296,394,48,442,690,64.06%,14.2%,1
新竹縣,橫山鄉,0350,37,102,139,10,149,288,51.74%,12.85%,1
新竹縣,橫山鄉,0351,119,289,408,33,441,685,64.38%,17.37%,1
新竹縣,橫山鄉,0352,135,369,504,34,538,868,61.98%,15.55%,1
新竹縣,橫山鄉,0353,219,687,906,61,967,1561,61.95%,14.03%,1
新竹縣,北埔鄉,0354,182,406,588,17,605,1158,52.25%,15.72%,1
新竹縣,北埔鄉,0355,225,465,690,50,740,1238,59.77%,18.17%,1
新竹縣,北埔鄉,0356,85,232,317,23,340,580,58.62%,14.66%,1
新竹縣,北埔鄉,0357,142,379,521,24,545,931,58.54%,15.25%,1
新竹縣,北埔鄉,0358,242,635,877,57,934,1653,56.5%,14.64%,1
新竹縣,北埔鄉,0359,116,342,458,27,485,845,57.4%,13.73%,1
新竹縣,北埔鄉,0360,50,152,202,12,214,384,55.73%,13.02%,1
新竹縣,北埔鄉,0361,109,312,421,15,436,763,57.14%,14.29%,1
新竹縣,北埔鄉,0362,52,115,167,16,183,333,54.95%,15.62%,1
新竹縣,北埔鄉,0363,26,127,153,7,160,295,54.24%,8.81%,1
新竹縣,寶山鄉,0364,205,401,606,14,620,1158,53.54%,17.7%,1
新竹縣,寶山鄉,0365,281,519,800,17,817,1437,56.85%,19.55%,1
新竹縣,寶山鄉,0366,246,550,796,43,839,1470,57.07%,16.73%,1
新竹縣,寶山鄉,0367,226,442,668,46,714,1170,61.03%,19.32%,1
新竹縣,寶山鄉,0368,379,679,1058,43,1101,1900,57.95%,19.95%,1
新竹縣,寶山鄉,0369,175,347,522,19,541,1056,51.23%,16.57%,1
新竹縣,寶山鄉,0370,176,527,703,53,756,1205,62.74%,14.61%,1
新竹縣,寶山鄉,0371,97,317,414,30,444,766,57.96%,12.66%,1
新竹縣,寶山鄉,0372,127,365,492,28,520,846,61.47%,15.01%,1
新竹縣,寶山鄉,0373,135,324,459,29,488,804,60.7%,16.79%,1
新竹縣,寶山鄉,0374,103,255,358,13,371,607,61.12%,16.97%,1
新竹縣,寶山鄉,0375,112,234,346,12,358,554,64.62%,20.22%,1
新竹縣,峨眉鄉,0376,131,387,518,49,567,879,64.51%,14.9%,1
新竹縣,峨眉鄉,0377,110,276,386,45,431,683,63.1%,16.11%,1
新竹縣,峨眉鄉,0378,91,245,336,31,367,604,60.76%,15.07%,1
新竹縣,峨眉鄉,0379,39,140,179,19,198,339,58.41%,11.5%,1
新竹縣,峨眉鄉,0380,21,92,113,6,119,276,43.12%,7.61%,1
新竹縣,峨眉鄉,0381,188,610,798,60,858,1406,61.02%,13.37%,1
新竹縣,峨眉鄉,0382,56,207,263,26,289,462,62.55%,12.12%,1
新竹縣,峨眉鄉,0383,53,157,210,17,227,419,54.18%,12.65%,1
新竹縣,尖石鄉,0384,48,171,219,6,225,474,47.47%,10.13%,1
新竹縣,尖石鄉,0385,50,137,187,4,191,357,53.5%,14.01%,1
新竹縣,尖石鄉,0386,20,75,95,16,111,225,49.33%,8.89%,1
新竹縣,尖石鄉,0387,31,142,173,15,188,374,50.27%,8.29%,1
新竹縣,尖石鄉,0388,73,258,331,6,337,773,43.6%,9.44%,1
新竹縣,尖石鄉,0389,38,225,263,16,279,490,56.94%,7.76%,1
新竹縣,尖石鄉,0390,43,180,223,4,227,531,42.75%,8.1%,1
新竹縣,尖石鄉,0391,43,302,345,17,362,660,54.85%,6.52%,1
新竹縣,尖石鄉,0392,62,311,373,43,416,613,67.86%,10.11%,1
新竹縣,尖石鄉,0393,68,220,288,4,292,593,49.24%,11.47%,1
新竹縣,尖石鄉,0394,37,270,307,19,326,575,56.7%,6.43%,1
新竹縣,尖石鄉,0395,11,68,79,5,84,126,66.67%,8.73%,1
新竹縣,尖石鄉,0396,38,190,228,9,237,499,47.49%,7.62%,1
新竹縣,尖石鄉,0397,69,220,289,23,312,785,39.75%,8.79%,1
新竹縣,尖石鄉,0398,50,120,170,11,181,289,62.63%,17.3%,1
新竹縣,五峰鄉,0399,63,313,376,21,397,672,59.08%,9.38%,1
新竹縣,五峰鄉,0400,75,231,306,13,319,713,44.74%,10.52%,1
新竹縣,五峰鄉,0401,46,193,239,4,243,594,40.91%,7.74%,1
新竹縣,五峰鄉,0402,87,357,444,22,466,896,52.01%,9.71%,1
新竹縣,五峰鄉,0403,79,294,373,9,382,727,52.54%,10.87%,1
新竹縣,五峰鄉,0404,43,125,168,9,177,395,44.81%,10.89%,1
苗栗縣,苗栗市,0001,160,440,600,29,629,1087,57.87%,14.72%,1
苗栗縣,苗栗市,0002,152,395,547,23,570,1018,55.99%,14.93%,1
苗栗縣,苗栗市,0003,182,440,622,20,642,1156,55.54%,15.74%,1
苗栗縣,苗栗市,0004,149,435,584,29,613,1118,54.83%,13.33%,1
苗栗縣,苗栗市,0005,179,420,599,41,640,1084,59.04%,16.51%,1
苗栗縣,苗栗市,0006,197,495,692,29,721,1203,59.93%,16.38%,1
苗栗縣,苗栗市,0007,191,543,734,43,777,1306,59.49%,14.62%,1
苗栗縣,苗栗市,0008,183,491,674,38,712,1193,59.68%,15.34%,1
苗栗縣,苗栗市,0009,169,472,641,19,660,1115,59.19%,15.16%,1
苗栗縣,苗栗市,0010,159,498,657,32,689,1119,61.57%,14.21%,1
苗栗縣,苗栗市,0011,185,466,651,46,697,1132,61.57%,16.34%,1
苗栗縣,苗栗市,0012,193,504,697,42,739,1289,57.33%,14.97%,1
苗栗縣,苗栗市,0013,202,521,723,35,758,1264,59.97%,15.98%,1
苗栗縣,苗栗市,0014,115,358,473,20,493,870,56.67%,13.22%,1
苗栗縣,苗栗市,0015,132,345,477,39,516,1008,51.19%,13.1%,1
苗栗縣,苗栗市,0016,172,370,542,31,573,1078,53.15%,15.96%,1
苗栗縣,苗栗市,0017,170,454,624,26,650,1077,60.35%,15.78%,1
苗栗縣,苗栗市,0018,134,358,492,18,510,880,57.95%,15.23%,1
苗栗縣,苗栗市,0019,125,340,465,38,503,894,56.26%,13.98%,1
苗栗縣,苗栗市,0020,71,215,286,19,305,522,58.43%,13.6%,1
苗栗縣,苗栗市,0021,250,570,820,52,872,1376,63.37%,18.17%,1
苗栗縣,苗栗市,0022,197,529,726,33,759,1391,54.57%,14.16%,1
苗栗縣,苗栗市,0023,173,429,602,46,648,1081,59.94%,16%,1
苗栗縣,苗栗市,0024,199,470,669,41,710,1272,55.82%,15.64%,1
苗栗縣,苗栗市,0025,190,473,663,54,717,1112,64.48%,17.09%,1
苗栗縣,苗栗市,0026,147,382,529,17,546,813,67.16%,18.08%,1
苗栗縣,苗栗市,0027,115,296,411,27,438,767,57.11%,14.99%,1
苗栗縣,苗栗市,0028,161,401,562,20,582,1010,57.62%,15.94%,1
苗栗縣,苗栗市,0029,174,482,656,13,669,1182,56.6%,14.72%,1
苗栗縣,苗栗市,0030,132,402,534,17,551,965,57.1%,13.68%,1
苗栗縣,苗栗市,0031,95,258,353,14,367,607,60.46%,15.65%,1
苗栗縣,苗栗市,0032,193,395,588,27,615,990,62.12%,19.49%,1
苗栗縣,苗栗市,0033,178,418,596,72,668,1230,54.31%,14.47%,1
苗栗縣,苗栗市,0034,217,549,766,30,796,1372,58.02%,15.82%,1
苗栗縣,苗栗市,0035,207,472,679,26,705,1213,58.12%,17.07%,1
苗栗縣,苗栗市,0036,205,482,687,38,725,1272,57%,16.12%,1
苗栗縣,苗栗市,0037,194,516,710,34,744,1221,60.93%,15.89%,1
苗栗縣,苗栗市,0038,187,427,614,30,644,1104,58.33%,16.94%,1
苗栗縣,苗栗市,0039,164,453,617,11,628,1171,53.63%,14.01%,1
苗栗縣,苗栗市,0040,201,553,754,29,783,1392,56.25%,14.44%,1
苗栗縣,苗栗市,0041,207,557,764,33,797,1356,58.78%,15.27%,1
苗栗縣,苗栗市,0042,235,524,759,43,802,1387,57.82%,16.94%,1
苗栗縣,苗栗市,0043,198,445,643,34,677,1206,56.14%,16.42%,1
苗栗縣,苗栗市,0044,171,444,615,25,640,1004,63.75%,17.03%,1
苗栗縣,苗栗市,0045,196,447,643,31,674,1202,56.07%,16.31%,1
苗栗縣,苗栗市,0046,194,416,610,31,641,1052,60.93%,18.44%,1
苗栗縣,苗栗市,0047,144,376,520,22,542,873,62.08%,16.49%,1
苗栗縣,苗栗市,0048,159,462,621,32,653,975,66.97%,16.31%,1
苗栗縣,苗栗市,0049,171,443,614,27,641,1003,63.91%,17.05%,1
苗栗縣,苗栗市,0050,179,384,563,20,583,1000,58.3%,17.9%,1
苗栗縣,苗栗市,0051,161,409,570,22,592,1047,56.54%,15.38%,1
苗栗縣,苗栗市,0052,166,434,600,29,629,1025,61.37%,16.2%,1
苗栗縣,苗栗市,0053,147,442,589,22,611,1130,54.07%,13.01%,1
苗栗縣,苗栗市,0054,187,439,626,27,653,1146,56.98%,16.32%,1
苗栗縣,苗栗市,0055,240,559,799,35,834,1432,58.24%,16.76%,1
苗栗縣,苗栗市,0056,156,525,681,30,711,1492,47.65%,10.46%,1
苗栗縣,苗栗市,0057,178,479,657,33,690,1125,61.33%,15.82%,1
苗栗縣,苗栗市,0058,198,470,668,27,695,1241,56%,15.95%,1
苗栗縣,苗栗市,0059,231,503,734,38,772,1278,60.41%,18.08%,1
苗栗縣,苗栗市,0060,187,513,700,23,723,1293,55.92%,14.46%,1
苗栗縣,苗栗市,0061,200,485,685,25,710,1342,52.91%,14.9%,1
苗栗縣,苗栗市,0062,122,327,449,29,478,857,55.78%,14.24%,1
苗栗縣,苗栗市,0063,147,464,611,36,647,1180,54.83%,12.46%,1
苗栗縣,苗栗市,0064,176,435,611,25,636,1072,59.33%,16.42%,1
苗栗縣,苗栗市,0065,108,364,472,32,504,912,55.26%,11.84%,1
苗栗縣,苗栗市,0066,96,306,402,24,426,796,53.52%,12.06%,1
苗栗縣,苗栗市,0067,146,280,426,16,442,869,50.86%,16.8%,1
苗栗縣,苑裡鎮,0183,124,358,482,41,523,873,59.91%,14.2%,1
苗栗縣,苑裡鎮,0184,213,533,746,46,792,1346,58.84%,15.82%,1
苗栗縣,苑裡鎮,0185,177,419,596,38,634,951,66.67%,18.61%,1
苗栗縣,苑裡鎮,0186,85,257,342,8,350,615,56.91%,13.82%,1
苗栗縣,苑裡鎮,0187,137,357,494,57,551,878,62.76%,15.6%,1
苗栗縣,苑裡鎮,0188,138,297,435,39,474,767,61.8%,17.99%,1
苗栗縣,苑裡鎮,0189,122,291,413,31,444,776,57.22%,15.72%,1
苗栗縣,苑裡鎮,0190,165,439,604,55,659,1231,53.53%,13.4%,1
苗栗縣,苑裡鎮,0191,180,455,635,47,682,1145,59.56%,15.72%,1
苗栗縣,苑裡鎮,0192,122,319,441,34,475,850,55.88%,14.35%,1
苗栗縣,苑裡鎮,0193,143,379,522,61,583,1052,55.42%,13.59%,1
苗栗縣,苑裡鎮,0194,164,427,591,48,639,1114,57.36%,14.72%,1
苗栗縣,苑裡鎮,0195,199,425,624,51,675,1136,59.42%,17.52%,1
苗栗縣,苑裡鎮,0196,166,474,640,38,678,1194,56.78%,13.9%,1
苗栗縣,苑裡鎮,0197,256,604,860,43,903,1579,57.19%,16.21%,1
苗栗縣,苑裡鎮,0198,217,451,668,48,716,1149,62.32%,18.89%,1
苗栗縣,苑裡鎮,0199,176,411,587,55,642,1057,60.74%,16.65%,1
苗栗縣,苑裡鎮,0200,148,412,560,20,580,1101,52.68%,13.44%,1
苗栗縣,苑裡鎮,0201,118,297,415,39,454,912,49.78%,12.94%,1
苗栗縣,苑裡鎮,0202,83,246,329,38,367,652,56.29%,12.73%,1
苗栗縣,苑裡鎮,0203,194,524,718,69,787,1348,58.38%,14.39%,1
苗栗縣,苑裡鎮,0204,113,236,349,22,371,733,50.61%,15.42%,1
苗栗縣,苑裡鎮,0205,87,242,329,12,341,662,51.51%,13.14%,1
苗栗縣,苑裡鎮,0206,136,347,483,36,519,893,58.12%,15.23%,1
苗栗縣,苑裡鎮,0207,149,351,500,46,546,910,60%,16.37%,1
苗栗縣,苑裡鎮,0208,172,475,647,54,701,1270,55.2%,13.54%,1
苗栗縣,苑裡鎮,0209,64,205,269,25,294,545,53.94%,11.74%,1
苗栗縣,苑裡鎮,0210,100,350,450,51,501,792,63.26%,12.63%,1
苗栗縣,苑裡鎮,0211,118,271,389,28,417,726,57.44%,16.25%,1
苗栗縣,苑裡鎮,0212,93,256,349,14,363,827,43.89%,11.25%,1
苗栗縣,苑裡鎮,0213,130,296,426,44,470,782,60.1%,16.62%,1
苗栗縣,苑裡鎮,0214,107,280,387,44,431,788,54.7%,13.58%,1
苗栗縣,苑裡鎮,0215,111,315,426,37,463,846,54.73%,13.12%,1
苗栗縣,苑裡鎮,0216,126,345,471,34,505,828,60.99%,15.22%,1
苗栗縣,苑裡鎮,0217,107,397,504,47,551,943,58.43%,11.35%,1
苗栗縣,苑裡鎮,0218,149,470,619,28,647,1082,59.8%,13.77%,1
苗栗縣,苑裡鎮,0219,187,510,697,51,748,1234,60.62%,15.15%,1
苗栗縣,苑裡鎮,0220,183,560,743,47,790,1434,55.09%,12.76%,1
苗栗縣,苑裡鎮,0221,150,384,534,36,570,987,57.75%,15.2%,1
苗栗縣,苑裡鎮,0222,149,367,516,48,564,882,63.95%,16.89%,1
苗栗縣,通霄鎮,0149,191,410,601,63,664,1142,58.14%,16.73%,1
苗栗縣,通霄鎮,0150,187,337,524,53,577,884,65.27%,21.15%,1
苗栗縣,通霄鎮,0151,140,410,550,55,605,1068,56.65%,13.11%,1
苗栗縣,通霄鎮,0152,177,375,552,38,590,1009,58.47%,17.54%,1
苗栗縣,通霄鎮,0153,166,354,520,41,561,859,65.31%,19.32%,1
苗栗縣,通霄鎮,0154,201,371,572,37,609,1040,58.56%,19.33%,1
苗栗縣,通霄鎮,0155,113,302,415,25,440,1008,43.65%,11.21%,1
苗栗縣,通霄鎮,0156,95,255,350,58,408,686,59.48%,13.85%,1
苗栗縣,通霄鎮,0157,133,330,463,46,509,761,66.89%,17.48%,1
苗栗縣,通霄鎮,0158,102,270,372,30,402,790,50.89%,12.91%,1
苗栗縣,通霄鎮,0159,133,356,489,45,534,966,55.28%,13.77%,1
苗栗縣,通霄鎮,0160,132,309,441,63,504,972,51.85%,13.58%,1
苗栗縣,通霄鎮,0161,110,284,394,34,428,771,55.51%,14.27%,1
苗栗縣,通霄鎮,0162,103,230,333,22,355,758,46.83%,13.59%,1
苗栗縣,通霄鎮,0163,164,372,536,48,584,1078,54.17%,15.21%,1
苗栗縣,通霄鎮,0164,40,137,177,23,200,459,43.57%,8.71%,1
苗栗縣,通霄鎮,0165,102,304,406,43,449,894,50.22%,11.41%,1
苗栗縣,通霄鎮,0166,43,108,151,8,159,402,39.55%,10.7%,1
苗栗縣,通霄鎮,0167,103,297,400,33,433,802,53.99%,12.84%,1
苗栗縣,通霄鎮,0168,108,229,337,12,349,684,51.02%,15.79%,1
苗栗縣,通霄鎮,0169,112,301,413,31,444,943,47.08%,11.88%,1
苗栗縣,通霄鎮,0170,114,319,433,47,480,790,60.76%,14.43%,1
苗栗縣,通霄鎮,0171,65,211,276,14,290,673,43.09%,9.66%,1
苗栗縣,通霄鎮,0172,162,448,610,45,655,1232,53.17%,13.15%,1
苗栗縣,通霄鎮,0173,163,538,701,55,756,1286,58.79%,12.67%,1
苗栗縣,通霄鎮,0174,102,247,349,38,387,649,59.63%,15.72%,1
苗栗縣,通霄鎮,0175,115,245,360,26,386,769,50.2%,14.95%,1
苗栗縣,通霄鎮,0176,172,394,566,64,630,1148,54.88%,14.98%,1
苗栗縣,通霄鎮,0177,158,344,502,74,576,1138,50.62%,13.88%,1
苗栗縣,通霄鎮,0178,159,362,521,49,570,1121,50.85%,14.18%,1
苗栗縣,通霄鎮,0179,113,287,400,27,427,769,55.53%,14.69%,1
苗栗縣,通霄鎮,0180,92,194,286,17,303,616,49.19%,14.94%,1
苗栗縣,通霄鎮,0181,140,254,394,41,435,799,54.44%,17.52%,1
苗栗縣,通霄鎮,0182,107,243,350,31,381,743,51.28%,14.4%,1
苗栗縣,竹南鎮,0270,218,414,632,23,655,1086,60.31%,20.07%,1
苗栗縣,竹南鎮,0271,124,334,458,32,490,826,59.32%,15.01%,1
苗栗縣,竹南鎮,0272,195,331,526,31,557,1051,53%,18.55%,1
苗栗縣,竹南鎮,0273,200,495,695,36,731,1235,59.19%,16.19%,1
苗栗縣,竹南鎮,0274,186,371,557,60,617,1016,60.73%,18.31%,1
苗栗縣,竹南鎮,0275,258,490,748,49,797,1472,54.14%,17.53%,1
苗栗縣,竹南鎮,0276,207,414,621,18,639,1301,49.12%,15.91%,1
苗栗縣,竹南鎮,0277,269,483,752,30,782,1544,50.65%,17.42%,1
苗栗縣,竹南鎮,0278,250,554,804,27,831,1512,54.96%,16.53%,1
苗栗縣,竹南鎮,0279,250,494,744,36,780,1463,53.32%,17.09%,1
苗栗縣,竹南鎮,0280,164,274,438,27,465,1073,43.34%,15.28%,1
苗栗縣,竹南鎮,0281,243,563,806,28,834,1453,57.4%,16.72%,1
苗栗縣,竹南鎮,0282,228,499,727,28,755,1245,60.64%,18.31%,1
苗栗縣,竹南鎮,0283,236,633,869,20,889,1487,59.78%,15.87%,1
苗栗縣,竹南鎮,0284,177,395,572,33,605,1018,59.43%,17.39%,1
苗栗縣,竹南鎮,0285,212,424,636,20,656,1105,59.37%,19.19%,1
苗栗縣,竹南鎮,0286,217,449,666,34,700,1322,52.95%,16.41%,1
苗栗縣,竹南鎮,0287,171,469,640,23,663,1140,58.16%,15%,1
苗栗縣,竹南鎮,0288,184,440,624,31,655,1067,61.39%,17.24%,1
苗栗縣,竹南鎮,0289,194,482,676,41,717,1136,63.12%,17.08%,1
苗栗縣,竹南鎮,0290,172,453,625,28,653,1253,52.11%,13.73%,1
苗栗縣,竹南鎮,0291,150,322,472,42,514,963,53.37%,15.58%,1
苗栗縣,竹南鎮,0292,173,347,520,37,557,1021,54.55%,16.94%,1
苗栗縣,竹南鎮,0293,214,450,664,32,696,1154,60.31%,18.54%,1
苗栗縣,竹南鎮,0294,195,377,572,27,599,1042,57.49%,18.71%,1
苗栗縣,竹南鎮,0295,201,510,711,33,744,1293,57.54%,15.55%,1
苗栗縣,竹南鎮,0296,139,339,478,12,490,816,60.05%,17.03%,1
苗栗縣,竹南鎮,0297,157,355,512,51,563,989,56.93%,15.87%,1
苗栗縣,竹南鎮,0298,172,473,645,35,680,1122,60.61%,15.33%,1
苗栗縣,竹南鎮,0299,153,347,500,28,528,1111,47.52%,13.77%,1
苗栗縣,竹南鎮,0300,149,424,573,41,614,1036,59.27%,14.38%,1
苗栗縣,竹南鎮,0301,142,394,536,24,560,1112,50.36%,12.77%,1
苗栗縣,竹南鎮,0302,214,471,685,20,705,1348,52.3%,15.88%,1
苗栗縣,竹南鎮,0303,207,424,631,26,657,1114,58.98%,18.58%,1
苗栗縣,竹南鎮,0304,209,426,635,38,673,1119,60.14%,18.68%,1
苗栗縣,竹南鎮,0305,114,360,474,23,497,878,56.61%,12.98%,1
苗栗縣,竹南鎮,0306,183,424,607,44,651,1059,61.47%,17.28%,1
苗栗縣,竹南鎮,0307,162,330,492,34,526,869,60.53%,18.64%,1
苗栗縣,竹南鎮,0308,118,298,416,29,445,800,55.63%,14.75%,1
苗栗縣,竹南鎮,0309,215,464,679,34,713,1165,61.2%,18.45%,1
苗栗縣,竹南鎮,0310,132,297,429,35,464,791,58.66%,16.69%,1
苗栗縣,竹南鎮,0311,103,257,360,23,383,677,56.57%,15.21%,1
苗栗縣,竹南鎮,0312,140,334,474,43,517,797,64.87%,17.57%,1
苗栗縣,竹南鎮,0313,176,453,629,33,662,1191,55.58%,14.78%,1
苗栗縣,竹南鎮,0314,164,362,526,14,540,1027,52.58%,15.97%,1
苗栗縣,竹南鎮,0315,228,515,743,46,789,1341,58.84%,17%,1
苗栗縣,竹南鎮,0316,202,453,655,48,703,1378,51.02%,14.66%,1
苗栗縣,竹南鎮,0317,207,447,654,30,684,1216,56.25%,17.02%,1
苗栗縣,竹南鎮,0318,222,579,801,33,834,1570,53.12%,14.14%,1
苗栗縣,竹南鎮,0319,97,207,304,26,330,538,61.34%,18.03%,1
苗栗縣,竹南鎮,0320,132,386,518,33,551,1166,47.26%,11.32%,1
苗栗縣,竹南鎮,0321,276,477,753,31,784,1488,52.69%,18.55%,1
苗栗縣,竹南鎮,0322,210,491,701,31,732,1449,50.52%,14.49%,1
苗栗縣,竹南鎮,0323,185,433,618,45,663,1182,56.09%,15.65%,1
苗栗縣,竹南鎮,0324,166,431,597,71,668,1175,56.85%,14.13%,1
苗栗縣,竹南鎮,0325,153,381,534,36,570,983,57.99%,15.56%,1
苗栗縣,竹南鎮,0326,71,223,294,15,309,492,62.8%,14.43%,1
苗栗縣,竹南鎮,0327,214,389,603,19,622,1074,57.91%,19.93%,1
苗栗縣,竹南鎮,0328,129,307,436,34,470,852,55.16%,15.14%,1
苗栗縣,竹南鎮,0329,220,426,646,31,677,1297,52.2%,16.96%,1
苗栗縣,竹南鎮,0330,146,375,521,38,559,1028,54.38%,14.2%,1
苗栗縣,頭份市,0331,114,345,459,41,500,915,54.64%,12.46%,1
苗栗縣,頭份市,0332,165,514,679,56,735,1292,56.89%,12.77%,1
苗栗縣,頭份市,0333,129,390,519,34,553,928,59.59%,13.9%,1
苗栗縣,頭份市,0334,106,310,416,11,427,835,51.14%,12.69%,1
苗栗縣,頭份市,0335,143,409,552,37,589,1070,55.05%,13.36%,1
苗栗縣,頭份市,0336,109,332,441,17,458,879,52.1%,12.4%,1
苗栗縣,頭份市,0337,181,327,508,31,539,1039,51.88%,17.42%,1
苗栗縣,頭份市,0338,161,444,605,51,656,1129,58.1%,14.26%,1
苗栗縣,頭份市,0339,151,382,533,39,572,1041,54.95%,14.51%,1
苗栗縣,頭份市,0340,191,560,751,46,797,1546,51.55%,12.35%,1
苗栗縣,頭份市,0341,146,409,555,32,587,935,62.78%,15.61%,1
苗栗縣,頭份市,0342,175,407,582,35,617,1180,52.29%,14.83%,1
苗栗縣,頭份市,0343,215,534,749,21,770,1499,51.37%,14.34%,1
苗栗縣,頭份市,0344,143,249,392,13,405,747,54.22%,19.14%,1
苗栗縣,頭份市,0345,196,537,733,28,761,1406,54.13%,13.94%,1
苗栗縣,頭份市,0346,162,459,621,52,673,1193,56.41%,13.58%,1
苗栗縣,頭份市,0347,162,360,522,35,557,948,58.76%,17.09%,1
苗栗縣,頭份市,0348,114,339,453,16,469,869,53.97%,13.12%,1
苗栗縣,頭份市,0349,175,461,636,29,665,1142,58.23%,15.32%,1
苗栗縣,頭份市,0350,214,472,686,23,709,1286,55.13%,16.64%,1
苗栗縣,頭份市,0351,148,366,514,26,540,903,59.8%,16.39%,1
苗栗縣,頭份市,0352,190,515,705,30,735,1186,61.97%,16.02%,1
苗栗縣,頭份市,0353,166,417,583,17,600,1016,59.06%,16.34%,1
苗栗縣,頭份市,0354,150,374,524,35,559,985,56.75%,15.23%,1
苗栗縣,頭份市,0355,135,406,541,20,561,1037,54.1%,13.02%,1
苗栗縣,頭份市,0356,128,315,443,21,464,947,49%,13.52%,1
苗栗縣,頭份市,0357,145,351,496,21,517,890,58.09%,16.29%,1
苗栗縣,頭份市,0358,127,256,383,25,408,646,63.16%,19.66%,1
苗栗縣,頭份市,0359,150,395,545,39,584,975,59.9%,15.38%,1
苗栗縣,頭份市,0360,102,281,383,14,397,1015,39.11%,10.05%,1
苗栗縣,頭份市,0361,237,571,808,55,863,1399,61.69%,16.94%,1
苗栗縣,頭份市,0362,176,464,640,49,689,1143,60.28%,15.4%,1
苗栗縣,頭份市,0363,156,471,627,43,670,1030,65.05%,15.15%,1
苗栗縣,頭份市,0364,222,515,737,34,771,1338,57.62%,16.59%,1
苗栗縣,頭份市,0365,237,527,764,21,785,1450,54.14%,16.34%,1
苗栗縣,頭份市,0366,169,427,596,14,610,1042,58.54%,16.22%,1
苗栗縣,頭份市,0367,230,540,770,25,795,1326,59.95%,17.35%,1
苗栗縣,頭份市,0368,228,540,768,34,802,1270,63.15%,17.95%,1
苗栗縣,頭份市,0369,205,486,691,34,725,1288,56.29%,15.92%,1
苗栗縣,頭份市,0370,237,487,724,21,745,1243,59.94%,19.07%,1
苗栗縣,頭份市,0371,193,541,734,22,756,1280,59.06%,15.08%,1
苗栗縣,頭份市,0372,266,601,867,46,913,1618,56.43%,16.44%,1
苗栗縣,頭份市,0373,281,631,912,35,947,1759,53.84%,15.97%,1
苗栗縣,頭份市,0374,206,515,721,34,755,1264,59.73%,16.3%,1
苗栗縣,頭份市,0375,240,503,743,25,768,1326,57.92%,18.1%,1
苗栗縣,頭份市,0376,250,614,864,25,889,1551,57.32%,16.12%,1
苗栗縣,頭份市,0377,223,549,772,41,813,1574,51.65%,14.17%,1
苗栗縣,頭份市,0378,208,480,688,43,731,1262,57.92%,16.48%,1
苗栗縣,頭份市,0379,179,471,650,37,687,1171,58.67%,15.29%,1
苗栗縣,頭份市,0380,204,460,664,32,696,1074,64.8%,18.99%,1
苗栗縣,頭份市,0381,188,474,662,28,690,1141,60.47%,16.48%,1
苗栗縣,頭份市,0382,205,496,701,31,732,1259,58.14%,16.28%,1
苗栗縣,頭份市,0383,190,448,638,20,658,1186,55.48%,16.02%,1
苗栗縣,頭份市,0384,139,425,564,19,583,1121,52.01%,12.4%,1
苗栗縣,頭份市,0385,121,343,464,22,486,847,57.38%,14.29%,1
苗栗縣,頭份市,0386,187,383,570,29,599,993,60.32%,18.83%,1
苗栗縣,頭份市,0387,166,382,548,24,572,1055,54.22%,15.73%,1
苗栗縣,頭份市,0388,203,592,795,38,833,1655,50.33%,12.27%,1
苗栗縣,頭份市,0389,238,696,934,55,989,1799,54.97%,13.23%,1
苗栗縣,頭份市,0390,182,449,631,31,662,1141,58.02%,15.95%,1
苗栗縣,頭份市,0391,239,497,736,45,781,1431,54.58%,16.7%,1
苗栗縣,頭份市,0392,177,471,648,16,664,1412,47.03%,12.54%,1
苗栗縣,頭份市,0393,140,406,546,21,567,1074,52.79%,13.04%,1
苗栗縣,頭份市,0394,196,512,708,34,742,1245,59.6%,15.74%,1
苗栗縣,頭份市,0395,224,532,756,53,809,1344,60.19%,16.67%,1
苗栗縣,頭份市,0396,223,562,785,58,843,1363,61.85%,16.36%,1
苗栗縣,頭份市,0397,137,411,548,25,573,898,63.81%,15.26%,1
苗栗縣,頭份市,0398,194,456,650,63,713,1182,60.32%,16.41%,1
苗栗縣,頭份市,0399,191,552,743,37,780,1413,55.2%,13.52%,1
苗栗縣,頭份市,0400,159,421,580,36,616,991,62.16%,16.04%,1
苗栗縣,頭份市,0401,183,470,653,43,696,1180,58.98%,15.51%,1
苗栗縣,後龍鎮,0223,99,217,316,28,344,590,58.31%,16.78%,1
苗栗縣,後龍鎮,0224,161,352,513,46,559,883,63.31%,18.23%,1
苗栗縣,後龍鎮,0225,146,314,460,37,497,793,62.67%,18.41%,1
苗栗縣,後龍鎮,0226,131,284,415,26,441,732,60.25%,17.9%,1
苗栗縣,後龍鎮,0227,100,239,339,23,362,592,61.15%,16.89%,1
苗栗縣,後龍鎮,0228,282,336,618,47,665,1113,59.75%,25.34%,1
苗栗縣,後龍鎮,0229,217,425,642,35,677,1195,56.65%,18.16%,1
苗栗縣,後龍鎮,0230,168,415,583,45,628,997,62.99%,16.85%,1
苗栗縣,後龍鎮,0231,125,310,435,20,455,913,49.84%,13.69%,1
苗栗縣,後龍鎮,0232,85,226,311,26,337,641,52.57%,13.26%,1
苗栗縣,後龍鎮,0233,138,286,424,27,451,848,53.18%,16.27%,1
苗栗縣,後龍鎮,0234,176,454,630,70,700,1264,55.38%,13.92%,1
苗栗縣,後龍鎮,0235,137,331,468,35,503,965,52.12%,14.2%,1
苗栗縣,後龍鎮,0236,198,602,800,52,852,1216,70.07%,16.28%,1
苗栗縣,後龍鎮,0237,132,363,495,38,533,977,54.55%,13.51%,1
苗栗縣,後龍鎮,0238,119,323,442,33,475,943,50.37%,12.62%,1
苗栗縣,後龍鎮,0239,129,332,461,61,522,910,57.36%,14.18%,1
苗栗縣,後龍鎮,0240,112,321,433,41,474,851,55.7%,13.16%,1
苗栗縣,後龍鎮,0241,160,278,438,21,459,725,63.31%,22.07%,1
苗栗縣,後龍鎮,0242,121,231,352,36,388,650,59.69%,18.62%,1
苗栗縣,後龍鎮,0243,106,219,325,42,367,706,51.98%,15.01%,1
苗栗縣,後龍鎮,0244,112,290,402,34,436,748,58.29%,14.97%,1
苗栗縣,後龍鎮,0245,103,245,348,31,379,801,47.32%,12.86%,1
苗栗縣,後龍鎮,0246,146,445,591,36,627,1107,56.64%,13.19%,1
苗栗縣,後龍鎮,0247,174,421,595,63,658,1197,54.97%,14.54%,1
苗栗縣,後龍鎮,0248,118,358,476,52,528,1036,50.97%,11.39%,1
苗栗縣,後龍鎮,0249,112,281,393,33,426,913,46.66%,12.27%,1
苗栗縣,後龍鎮,0250,110,291,401,39,440,719,61.2%,15.3%,1
苗栗縣,後龍鎮,0251,136,395,531,68,599,1037,57.76%,13.11%,1
苗栗縣,後龍鎮,0252,93,195,288,19,307,601,51.08%,15.47%,1
苗栗縣,後龍鎮,0253,162,384,546,34,580,1269,45.71%,12.77%,1
苗栗縣,後龍鎮,0254,93,244,337,28,365,735,49.66%,12.65%,1
苗栗縣,後龍鎮,0255,33,102,135,10,145,422,34.36%,7.82%,1
苗栗縣,後龍鎮,0256,83,256,339,20,359,625,57.44%,13.28%,1
苗栗縣,後龍鎮,0257,107,408,515,60,575,1234,46.6%,8.67%,1
苗栗縣,卓蘭鎮,0442,152,394,546,42,588,961,61.19%,15.82%,1
苗栗縣,卓蘭鎮,0443,164,370,534,44,578,1017,56.83%,16.13%,1
苗栗縣,卓蘭鎮,0444,195,459,654,51,705,1095,64.38%,17.81%,1
苗栗縣,卓蘭鎮,0445,114,321,435,25,460,745,61.74%,15.3%,1
苗栗縣,卓蘭鎮,0446,102,302,404,27,431,783,55.04%,13.03%,1
苗栗縣,卓蘭鎮,0447,108,259,367,10,377,745,50.6%,14.5%,1
苗栗縣,卓蘭鎮,0448,137,362,499,25,524,999,52.45%,13.71%,1
苗栗縣,卓蘭鎮,0449,104,279,383,35,418,671,62.3%,15.5%,1
苗栗縣,卓蘭鎮,0450,117,309,426,57,483,734,65.8%,15.94%,1
苗栗縣,卓蘭鎮,0451,134,365,499,38,537,865,62.08%,15.49%,1
苗栗縣,卓蘭鎮,0452,116,360,476,46,522,828,63.04%,14.01%,1
苗栗縣,卓蘭鎮,0453,53,167,220,24,244,386,63.21%,13.73%,1
苗栗縣,卓蘭鎮,0454,119,292,411,33,444,688,64.53%,17.3%,1
苗栗縣,卓蘭鎮,0455,148,313,461,31,492,792,62.12%,18.69%,1
苗栗縣,卓蘭鎮,0456,115,298,413,21,434,729,59.53%,15.78%,1
苗栗縣,卓蘭鎮,0457,164,338,502,24,526,1093,48.12%,15%,1
苗栗縣,卓蘭鎮,0458,79,259,338,18,356,615,57.89%,12.85%,1
苗栗縣,卓蘭鎮,0459,4,43,47,2,49,86,56.98%,4.65%,1
苗栗縣,卓蘭鎮,0460,122,383,505,14,519,940,55.21%,12.98%,1
苗栗縣,大湖鄉,0420,113,263,376,32,408,744,54.84%,15.19%,1
苗栗縣,大湖鄉,0421,129,328,457,30,487,881,55.28%,14.64%,1
苗栗縣,大湖鄉,0422,88,223,311,29,340,596,57.05%,14.77%,1
苗栗縣,大湖鄉,0423,179,427,606,49,655,1260,51.98%,14.21%,1
苗栗縣,大湖鄉,0424,105,317,422,32,454,867,52.36%,12.11%,1
苗栗縣,大湖鄉,0425,116,363,479,34,513,923,55.58%,12.57%,1
苗栗縣,大湖鄉,0426,172,498,670,66,736,1395,52.76%,12.33%,1
苗栗縣,大湖鄉,0427,63,132,195,21,216,561,38.5%,11.23%,1
苗栗縣,大湖鄉,0428,85,271,356,17,373,638,58.46%,13.32%,1
苗栗縣,大湖鄉,0429,101,268,369,31,400,754,53.05%,13.4%,1
苗栗縣,大湖鄉,0430,41,195,236,12,248,501,49.5%,8.18%,1
苗栗縣,大湖鄉,0431,108,217,325,34,359,652,55.06%,16.56%,1
苗栗縣,大湖鄉,0432,102,284,386,30,416,843,49.35%,12.1%,1
苗栗縣,大湖鄉,0433,149,377,526,55,581,1020,56.96%,14.61%,1
苗栗縣,大湖鄉,0434,128,410,538,41,579,1018,56.88%,12.57%,1
苗栗縣,公館鄉,0068,130,352,482,42,524,789,66.41%,16.48%,1
苗栗縣,公館鄉,0069,136,358,494,29,523,792,66.04%,17.17%,1
苗栗縣,公館鄉,0070,169,485,654,61,715,1117,64.01%,15.13%,1
苗栗縣,公館鄉,0071,202,534,736,52,788,1255,62.79%,16.1%,1
苗栗縣,公館鄉,0072,174,476,650,33,683,1141,59.86%,15.25%,1
苗栗縣,公館鄉,0073,205,437,642,45,687,1172,58.62%,17.49%,1
苗栗縣,公館鄉,0074,173,480,653,42,695,1100,63.18%,15.73%,1
苗栗縣,公館鄉,0075,166,456,622,29,651,1232,52.84%,13.47%,1
苗栗縣,公館鄉,0076,145,377,522,47,569,1081,52.64%,13.41%,1
苗栗縣,公館鄉,0077,210,525,735,42,777,1250,62.16%,16.8%,1
苗栗縣,公館鄉,0078,160,437,597,34,631,1081,58.37%,14.8%,1
苗栗縣,公館鄉,0079,127,370,497,56,553,964,57.37%,13.17%,1
苗栗縣,公館鄉,0080,158,418,576,54,630,1038,60.69%,15.22%,1
苗栗縣,公館鄉,0081,65,143,208,18,226,360,62.78%,18.06%,1
苗栗縣,公館鄉,0082,117,344,461,36,497,865,57.46%,13.53%,1
苗栗縣,公館鄉,0083,196,419,615,38,653,1166,56%,16.81%,1
苗栗縣,公館鄉,0084,97,303,400,28,428,719,59.53%,13.49%,1
苗栗縣,公館鄉,0085,123,278,401,34,435,788,55.2%,15.61%,1
苗栗縣,公館鄉,0086,43,140,183,20,203,303,67%,14.19%,1
苗栗縣,公館鄉,0087,217,532,749,46,795,1322,60.14%,16.41%,1
苗栗縣,公館鄉,0088,112,389,501,35,536,933,57.45%,12%,1
苗栗縣,公館鄉,0089,188,530,718,73,791,1455,54.36%,12.92%,1
苗栗縣,公館鄉,0090,266,644,910,88,998,1615,61.8%,16.47%,1
苗栗縣,公館鄉,0091,191,559,750,53,803,1451,55.34%,13.16%,1
苗栗縣,公館鄉,0092,225,604,829,53,882,1462,60.33%,15.39%,1
苗栗縣,公館鄉,0093,175,505,680,57,737,1317,55.96%,13.29%,1
苗栗縣,公館鄉,0094,26,97,123,8,131,221,59.28%,11.76%,1
苗栗縣,公館鄉,0095,39,120,159,16,175,329,53.19%,11.85%,1
苗栗縣,銅鑼鄉,0108,125,390,515,33,548,887,61.78%,14.09%,1
苗栗縣,銅鑼鄉,0109,151,448,599,33,632,1052,60.08%,14.35%,1
苗栗縣,銅鑼鄉,0110,253,538,791,34,825,1347,61.25%,18.78%,1
苗栗縣,銅鑼鄉,0111,166,474,640,33,673,1177,57.18%,14.1%,1
苗栗縣,銅鑼鄉,0112,200,459,659,23,682,1268,53.79%,15.77%,1
苗栗縣,銅鑼鄉,0113,168,387,555,30,585,1185,49.37%,14.18%,1
苗栗縣,銅鑼鄉,0114,151,423,574,23,597,1029,58.02%,14.67%,1
苗栗縣,銅鑼鄉,0115,113,382,495,30,525,905,58.01%,12.49%,1
苗栗縣,銅鑼鄉,0116,125,322,447,21,468,750,62.4%,16.67%,1
苗栗縣,銅鑼鄉,0117,122,394,516,38,554,1080,51.3%,11.3%,1
苗栗縣,銅鑼鄉,0118,145,409,554,48,602,1108,54.33%,13.09%,1
苗栗縣,銅鑼鄉,0119,100,326,426,30,456,862,52.9%,11.6%,1
苗栗縣,銅鑼鄉,0120,174,439,613,34,647,1216,53.21%,14.31%,1
苗栗縣,銅鑼鄉,0121,63,213,276,28,304,588,51.7%,10.71%,1
苗栗縣,銅鑼鄉,0122,54,152,206,29,235,429,54.78%,12.59%,1
苗栗縣,銅鑼鄉,0123,78,220,298,19,317,541,58.6%,14.42%,1
苗栗縣,南庄鄉,0411,159,432,591,53,644,1155,55.76%,13.77%,1
苗栗縣,南庄鄉,0412,95,258,353,18,371,650,57.08%,14.62%,1
苗栗縣,南庄鄉,0413,161,482,643,56,699,1353,51.66%,11.9%,1
苗栗縣,南庄鄉,0414,84,249,333,22,355,813,43.67%,10.33%,1
苗栗縣,南庄鄉,0415,78,247,325,34,359,837,42.89%,9.32%,1
苗栗縣,南庄鄉,0416,142,398,540,32,572,1093,52.33%,12.99%,1
苗栗縣,南庄鄉,0417,156,376,532,41,573,1048,54.68%,14.89%,1
苗栗縣,南庄鄉,0418,130,290,420,26,446,872,51.15%,14.91%,1
苗栗縣,南庄鄉,0419,83,224,307,13,320,963,33.23%,8.62%,1
苗栗縣,頭屋鄉,0096,331,503,834,58,892,1335,66.82%,24.79%,1
苗栗縣,頭屋鄉,0097,190,575,765,63,828,1168,70.89%,16.27%,1
苗栗縣,頭屋鄉,0098,127,364,491,29,520,792,65.66%,16.04%,1
苗栗縣,頭屋鄉,0099,194,431,625,33,658,918,71.68%,21.13%,1
苗栗縣,頭屋鄉,0100,96,342,438,26,464,725,64%,13.24%,1
苗栗縣,頭屋鄉,0101,131,393,524,31,555,899,61.74%,14.57%,1
苗栗縣,頭屋鄉,0102,43,133,176,6,182,369,49.32%,11.65%,1
苗栗縣,頭屋鄉,0103,149,331,480,24,504,844,59.72%,17.65%,1
苗栗縣,頭屋鄉,0104,191,401,592,32,624,1007,61.97%,18.97%,1
苗栗縣,頭屋鄉,0105,51,434,485,16,501,794,63.1%,6.42%,1
苗栗縣,頭屋鄉,0106,36,106,142,14,156,211,73.93%,17.06%,1
苗栗縣,頭屋鄉,0107,47,174,221,17,238,328,72.56%,14.33%,1
苗栗縣,三義鄉,0124,75,429,504,18,522,853,61.2%,8.79%,1
苗栗縣,三義鄉,0125,147,440,587,24,611,983,62.16%,14.95%,1
苗栗縣,三義鄉,0126,158,453,611,37,648,1080,60%,14.63%,1
苗栗縣,三義鄉,0127,177,457,634,17,651,1216,53.54%,14.56%,1
苗栗縣,三義鄉,0128,143,432,575,29,604,1017,59.39%,14.06%,1
苗栗縣,三義鄉,0129,167,442,609,23,632,1180,53.56%,14.15%,1
苗栗縣,三義鄉,0130,174,489,663,21,684,1198,57.1%,14.52%,1
苗栗縣,三義鄉,0131,51,181,232,10,242,417,58.03%,12.23%,1
苗栗縣,三義鄉,0132,114,383,497,26,523,991,52.77%,11.5%,1
苗栗縣,三義鄉,0133,107,361,468,19,487,834,58.39%,12.83%,1
苗栗縣,三義鄉,0134,94,254,348,19,367,622,59%,15.11%,1
苗栗縣,三義鄉,0135,111,312,423,36,459,749,61.28%,14.82%,1
苗栗縣,三義鄉,0136,113,327,440,20,460,692,66.47%,16.33%,1
苗栗縣,三義鄉,0137,145,355,500,35,535,759,70.49%,19.1%,1
苗栗縣,三義鄉,0138,82,232,314,22,336,629,53.42%,13.04%,1
苗栗縣,三義鄉,0139,113,249,362,25,387,669,57.85%,16.89%,1
苗栗縣,西湖鄉,0140,94,218,312,19,331,601,55.07%,15.64%,1
苗栗縣,西湖鄉,0141,80,239,319,22,341,566,60.25%,14.13%,1
苗栗縣,西湖鄉,0142,122,324,446,45,491,843,58.24%,14.47%,1
苗栗縣,西湖鄉,0143,95,232,327,17,344,648,53.09%,14.66%,1
苗栗縣,西湖鄉,0144,149,297,446,27,473,936,50.53%,15.92%,1
苗栗縣,西湖鄉,0145,64,169,233,15,248,461,53.8%,13.88%,1
苗栗縣,西湖鄉,0146,77,196,273,21,294,515,57.09%,14.95%,1
苗栗縣,西湖鄉,0147,142,432,574,41,615,1141,53.9%,12.45%,1
苗栗縣,西湖鄉,0148,104,270,374,23,397,671,59.17%,15.5%,1
苗栗縣,造橋鄉,0258,206,511,717,49,766,1171,65.41%,17.59%,1
苗栗縣,造橋鄉,0259,104,388,492,36,528,889,59.39%,11.7%,1
苗栗縣,造橋鄉,0260,60,161,221,16,237,479,49.48%,12.53%,1
苗栗縣,造橋鄉,0261,142,420,562,40,602,1024,58.79%,13.87%,1
苗栗縣,造橋鄉,0262,179,417,596,61,657,1214,54.12%,14.74%,1
苗栗縣,造橋鄉,0263,142,378,520,40,560,1071,52.29%,13.26%,1
苗栗縣,造橋鄉,0264,155,396,551,56,607,1157,52.46%,13.4%,1
苗栗縣,造橋鄉,0265,79,201,280,21,301,512,58.79%,15.43%,1
苗栗縣,造橋鄉,0266,76,216,292,18,310,491,63.14%,15.48%,1
苗栗縣,造橋鄉,0267,188,529,717,49,766,1272,60.22%,14.78%,1
苗栗縣,造橋鄉,0268,113,298,411,40,451,785,57.45%,14.39%,1
苗栗縣,造橋鄉,0269,169,388,557,77,634,962,65.9%,17.57%,1
苗栗縣,三灣鄉,0402,145,436,581,15,596,996,59.84%,14.56%,1
苗栗縣,三灣鄉,0403,187,456,643,46,689,1205,57.18%,15.52%,1
苗栗縣,三灣鄉,0404,86,264,350,35,385,635,60.63%,13.54%,1
苗栗縣,三灣鄉,0405,114,349,463,35,498,862,57.77%,13.23%,1
苗栗縣,三灣鄉,0406,19,86,105,13,118,238,49.58%,7.98%,1
苗栗縣,三灣鄉,0407,69,203,272,22,294,541,54.34%,12.75%,1
苗栗縣,三灣鄉,0408,73,204,277,21,298,578,51.56%,12.63%,1
苗栗縣,三灣鄉,0409,62,187,249,30,279,405,68.89%,15.31%,1
苗栗縣,三灣鄉,0410,45,160,205,19,224,392,57.14%,11.48%,1
苗栗縣,獅潭鄉,0435,21,102,123,7,130,328,39.63%,6.4%,1
苗栗縣,獅潭鄉,0436,49,175,224,28,252,565,44.6%,8.67%,1
苗栗縣,獅潭鄉,0437,123,344,467,56,523,911,57.41%,13.5%,1
苗栗縣,獅潭鄉,0438,66,179,245,23,268,568,47.18%,11.62%,1
苗栗縣,獅潭鄉,0439,60,251,311,31,342,580,58.97%,10.34%,1
苗栗縣,獅潭鄉,0440,42,115,157,12,169,333,50.75%,12.61%,1
苗栗縣,獅潭鄉,0441,75,255,330,26,356,683,52.12%,10.98%,1
苗栗縣,泰安鄉,0461,31,118,149,6,155,325,47.69%,9.54%,1
苗栗縣,泰安鄉,0462,57,209,266,23,289,484,59.71%,11.78%,1
苗栗縣,泰安鄉,0463,104,351,455,35,490,666,73.57%,15.62%,1
苗栗縣,泰安鄉,0464,71,280,351,39,390,574,67.94%,12.37%,1
苗栗縣,泰安鄉,0465,38,127,165,10,175,333,52.55%,11.41%,1
苗栗縣,泰安鄉,0466,71,265,336,11,347,495,70.1%,14.34%,1
苗栗縣,泰安鄉,0467,121,246,367,27,394,544,72.43%,22.24%,1
苗栗縣,泰安鄉,0468,62,221,283,16,299,500,59.8%,12.4%,1
苗栗縣,泰安鄉,0469,100,352,452,28,480,670,71.64%,14.93%,1
苗栗縣,泰安鄉,0470,72,373,445,5,450,589,76.4%,12.22%,1
彰化縣,彰化市,0001,154,348,502,29,531,871,60.96%,17.68%,1
彰化縣,彰化市,0002,92,243,335,31,366,751,48.74%,12.25%,1
彰化縣,彰化市,0003,210,368,578,32,610,923,66.09%,22.75%,1
彰化縣,彰化市,0004,159,288,447,38,485,779,62.26%,20.41%,1
彰化縣,彰化市,0005,145,293,438,33,471,779,60.46%,18.61%,1
彰化縣,彰化市,0006,136,283,419,17,436,720,60.56%,18.89%,1
彰化縣,彰化市,0007,138,289,427,21,448,749,59.81%,18.42%,1
彰化縣,彰化市,0008,142,330,472,32,504,767,65.71%,18.51%,1
彰化縣,彰化市,0009,167,438,605,55,660,1047,63.04%,15.95%,1
彰化縣,彰化市,0010,187,372,559,30,589,1027,57.35%,18.21%,1
彰化縣,彰化市,0011,202,464,666,50,716,1249,57.33%,16.17%,1
彰化縣,彰化市,0012,446,207,653,25,678,1136,59.68%,39.26%,1
彰化縣,彰化市,0013,199,485,684,41,725,1169,62.02%,17.02%,1
彰化縣,彰化市,0014,160,309,469,19,488,766,63.71%,20.89%,1
彰化縣,彰化市,0015,89,279,368,20,388,643,60.34%,13.84%,1
彰化縣,彰化市,0016,207,493,700,45,745,1251,59.55%,16.55%,1
彰化縣,彰化市,0017,173,315,488,24,512,1301,39.35%,13.3%,1
彰化縣,彰化市,0018,231,514,745,27,772,1280,60.31%,18.05%,1
彰化縣,彰化市,0019,203,495,698,29,727,1179,61.66%,17.22%,1
彰化縣,彰化市,0020,206,467,673,16,689,1168,58.99%,17.64%,1
彰化縣,彰化市,0021,180,502,682,36,718,1218,58.95%,14.78%,1
彰化縣,彰化市,0022,258,603,861,20,881,1351,65.21%,19.1%,1
彰化縣,彰化市,0023,233,406,639,27,666,1204,55.32%,19.35%,1
彰化縣,彰化市,0024,220,480,700,17,717,1189,60.3%,18.5%,1
彰化縣,彰化市,0025,204,459,663,36,699,1207,57.91%,16.9%,1
彰化縣,彰化市,0026,195,469,664,30,694,1161,59.78%,16.8%,1
彰化縣,彰化市,0027,251,390,641,25,666,1166,57.12%,21.53%,1
彰化縣,彰化市,0028,264,530,794,40,834,1362,61.23%,19.38%,1
彰化縣,彰化市,0029,247,491,738,36,774,1236,62.62%,19.98%,1
彰化縣,彰化市,0030,206,403,609,33,642,1065,60.28%,19.34%,1
彰化縣,彰化市,0031,242,448,690,32,722,1199,60.22%,20.18%,1
彰化縣,彰化市,0032,251,465,716,30,746,1233,60.5%,20.36%,1
彰化縣,彰化市,0033,211,481,692,29,721,1245,57.91%,16.95%,1
彰化縣,彰化市,0034,226,468,694,24,718,1153,62.27%,19.6%,1
彰化縣,彰化市,0035,226,378,604,29,633,1045,60.57%,21.63%,1
彰化縣,彰化市,0036,227,404,631,15,646,1097,58.89%,20.69%,1
彰化縣,彰化市,0037,217,446,663,30,693,1190,58.24%,18.24%,1
彰化縣,彰化市,0038,227,431,658,36,694,1106,62.75%,20.52%,1
彰化縣,彰化市,0039,190,452,642,21,663,1097,60.44%,17.32%,1
彰化縣,彰化市,0040,199,409,608,33,641,1048,61.16%,18.99%,1
彰化縣,彰化市,0041,190,389,579,33,612,980,62.45%,19.39%,1
彰化縣,彰化市,0042,139,294,433,15,448,707,63.37%,19.66%,1
彰化縣,彰化市,0043,160,306,466,25,491,809,60.69%,19.78%,1
彰化縣,彰化市,0044,209,379,588,45,633,1008,62.8%,20.73%,1
彰化縣,彰化市,0045,166,308,474,42,516,901,57.27%,18.42%,1
彰化縣,彰化市,0046,152,373,525,25,550,951,57.83%,15.98%,1
彰化縣,彰化市,0047,225,391,616,31,647,1076,60.13%,20.91%,1
彰化縣,彰化市,0048,179,364,543,23,566,1022,55.38%,17.51%,1
彰化縣,彰化市,0049,183,337,520,26,546,894,61.07%,20.47%,1
彰化縣,彰化市,0050,180,416,596,39,635,1016,62.5%,17.72%,1
彰化縣,彰化市,0051,149,323,472,26,498,771,64.59%,19.33%,1
彰化縣,彰化市,0052,170,334,504,31,535,868,61.64%,19.59%,1
彰化縣,彰化市,0053,203,434,637,50,687,1135,60.53%,17.89%,1
彰化縣,彰化市,0054,175,339,514,49,563,910,61.87%,19.23%,1
彰化縣,彰化市,0055,215,398,613,22,635,1004,63.25%,21.41%,1
彰化縣,彰化市,0056,420,213,633,40,673,1077,62.49%,39%,1
彰化縣,彰化市,0057,235,542,777,50,827,1258,65.74%,18.68%,1
彰化縣,彰化市,0058,194,440,634,21,655,1025,63.9%,18.93%,1
彰化縣,彰化市,0059,222,477,699,47,746,1177,63.38%,18.86%,1
彰化縣,彰化市,0060,209,486,695,27,722,1262,57.21%,16.56%,1
彰化縣,彰化市,0061,205,510,715,37,752,1209,62.2%,16.96%,1
彰化縣,彰化市,0062,206,417,623,38,661,1041,63.5%,19.79%,1
彰化縣,彰化市,0063,166,487,653,28,681,1075,63.35%,15.44%,1
彰化縣,彰化市,0064,158,393,551,38,589,1029,57.24%,15.35%,1
彰化縣,彰化市,0065,196,472,668,37,705,1203,58.6%,16.29%,1
彰化縣,彰化市,0066,164,395,559,33,592,1014,58.38%,16.17%,1
彰化縣,彰化市,0067,190,429,619,27,646,1069,60.43%,17.77%,1
彰化縣,彰化市,0068,155,350,505,20,525,969,54.18%,16%,1
彰化縣,彰化市,0069,162,413,575,21,596,1105,53.94%,14.66%,1
彰化縣,彰化市,0070,166,430,596,36,632,981,64.42%,16.92%,1
彰化縣,彰化市,0071,217,434,651,43,694,1095,63.38%,19.82%,1
彰化縣,彰化市,0072,175,479,654,25,679,1087,62.47%,16.1%,1
彰化縣,彰化市,0073,208,418,626,19,645,1050,61.43%,19.81%,1
彰化縣,彰化市,0074,236,496,732,38,770,1252,61.5%,18.85%,1
彰化縣,彰化市,0075,196,408,604,26,630,1113,56.6%,17.61%,1
彰化縣,彰化市,0076,206,403,609,25,634,1009,62.83%,20.42%,1
彰化縣,彰化市,0077,162,381,543,36,579,999,57.96%,16.22%,1
彰化縣,彰化市,0078,190,385,575,16,591,997,59.28%,19.06%,1
彰化縣,彰化市,0079,243,476,719,27,746,1145,65.15%,21.22%,1
彰化縣,彰化市,0080,225,492,717,21,738,1227,60.15%,18.34%,1
彰化縣,彰化市,0081,249,476,725,27,752,1208,62.25%,20.61%,1
彰化縣,彰化市,0082,281,631,912,17,929,1598,58.14%,17.58%,1
彰化縣,彰化市,0083,151,368,519,30,549,890,61.69%,16.97%,1
彰化縣,彰化市,0084,215,460,675,31,706,1104,63.95%,19.47%,1
彰化縣,彰化市,0085,196,414,610,20,630,1097,57.43%,17.87%,1
彰化縣,彰化市,0086,114,330,444,28,472,799,59.07%,14.27%,1
彰化縣,彰化市,0087,160,422,582,38,620,1000,62%,16%,1
彰化縣,彰化市,0088,172,454,626,57,683,1153,59.24%,14.92%,1
彰化縣,彰化市,0089,178,380,558,49,607,977,62.13%,18.22%,1
彰化縣,彰化市,0090,230,422,652,44,696,1201,57.95%,19.15%,1
彰化縣,彰化市,0091,220,399,619,45,664,1057,62.82%,20.81%,1
彰化縣,彰化市,0092,183,484,667,61,728,1238,58.8%,14.78%,1
彰化縣,彰化市,0093,189,518,707,40,747,1210,61.74%,15.62%,1
彰化縣,彰化市,0094,182,420,602,34,636,1026,61.99%,17.74%,1
彰化縣,彰化市,0095,213,446,659,35,694,1061,65.41%,20.08%,1
彰化縣,彰化市,0096,230,452,682,43,725,1213,59.77%,18.96%,1
彰化縣,彰化市,0097,275,470,745,30,775,1264,61.31%,21.76%,1
彰化縣,彰化市,0098,159,286,445,24,469,691,67.87%,23.01%,1
彰化縣,彰化市,0099,172,373,545,31,576,893,64.5%,19.26%,1
彰化縣,彰化市,0100,129,295,424,33,457,733,62.35%,17.6%,1
彰化縣,彰化市,0101,119,296,415,30,445,692,64.31%,17.2%,1
彰化縣,彰化市,0102,147,263,410,28,438,728,60.16%,20.19%,1
彰化縣,彰化市,0103,162,317,479,22,501,773,64.81%,20.96%,1
彰化縣,彰化市,0104,153,370,523,11,534,975,54.77%,15.69%,1
彰化縣,彰化市,0105,150,372,522,34,556,908,61.23%,16.52%,1
彰化縣,彰化市,0106,209,500,709,7,716,1156,61.94%,18.08%,1
彰化縣,彰化市,0107,211,505,716,38,754,1235,61.05%,17.09%,1
彰化縣,彰化市,0108,235,501,736,47,783,1376,56.9%,17.08%,1
彰化縣,彰化市,0109,249,520,769,12,781,1389,56.23%,17.93%,1
彰化縣,彰化市,0110,151,380,531,29,560,846,66.19%,17.85%,1
彰化縣,彰化市,0111,401,137,538,22,560,859,65.19%,46.68%,1
彰化縣,彰化市,0112,163,300,463,21,484,781,61.97%,20.87%,1
彰化縣,彰化市,0113,156,336,492,32,524,875,59.89%,17.83%,1
彰化縣,彰化市,0114,137,327,464,23,487,816,59.68%,16.79%,1
彰化縣,彰化市,0115,122,285,407,32,439,687,63.9%,17.76%,1
彰化縣,彰化市,0116,148,297,445,30,475,727,65.34%,20.36%,1
彰化縣,彰化市,0117,125,277,402,23,425,662,64.2%,18.88%,1
彰化縣,彰化市,0118,103,286,389,17,406,633,64.14%,16.27%,1
彰化縣,彰化市,0119,180,380,560,30,590,906,65.12%,19.87%,1
彰化縣,彰化市,0120,129,334,463,32,495,853,58.03%,15.12%,1
彰化縣,彰化市,0121,195,426,621,27,648,1027,63.1%,18.99%,1
彰化縣,彰化市,0122,165,441,606,31,637,993,64.15%,16.62%,1
彰化縣,彰化市,0123,141,356,497,29,526,848,62.03%,16.63%,1
彰化縣,彰化市,0124,215,474,689,18,707,1118,63.24%,19.23%,1
彰化縣,彰化市,0125,230,506,736,33,769,1263,60.89%,18.21%,1
彰化縣,彰化市,0126,219,543,762,39,801,1268,63.17%,17.27%,1
彰化縣,彰化市,0127,202,534,736,33,769,1258,61.13%,16.06%,1
彰化縣,彰化市,0128,223,514,737,22,759,1212,62.62%,18.4%,1
彰化縣,彰化市,0129,160,375,535,38,573,924,62.01%,17.32%,1
彰化縣,彰化市,0130,179,395,574,24,598,939,63.68%,19.06%,1
彰化縣,彰化市,0131,189,405,594,48,642,953,67.37%,19.83%,1
彰化縣,彰化市,0132,186,439,625,25,650,981,66.26%,18.96%,1
彰化縣,彰化市,0133,205,540,745,47,792,1249,63.41%,16.41%,1
彰化縣,彰化市,0134,132,341,473,41,514,817,62.91%,16.16%,1
彰化縣,彰化市,0135,168,337,505,28,533,872,61.12%,19.27%,1
彰化縣,彰化市,0136,119,263,382,26,408,689,59.22%,17.27%,1
彰化縣,彰化市,0137,201,500,701,26,727,1156,62.89%,17.39%,1
彰化縣,彰化市,0138,217,506,723,20,743,1291,57.55%,16.81%,1
彰化縣,彰化市,0139,181,466,647,22,669,1139,58.74%,15.89%,1
彰化縣,彰化市,0140,195,466,661,38,699,1125,62.13%,17.33%,1
彰化縣,彰化市,0141,186,494,680,43,723,1258,57.47%,14.79%,1
彰化縣,彰化市,0142,179,461,640,27,667,1123,59.39%,15.94%,1
彰化縣,彰化市,0143,200,467,667,37,704,1175,59.91%,17.02%,1
彰化縣,彰化市,0144,158,387,545,26,571,862,66.24%,18.33%,1
彰化縣,彰化市,0145,176,336,512,18,530,872,60.78%,20.18%,1
彰化縣,彰化市,0146,159,395,554,25,579,897,64.55%,17.73%,1
彰化縣,彰化市,0147,167,385,552,20,572,1003,57.03%,16.65%,1
彰化縣,彰化市,0148,149,355,504,19,523,915,57.16%,16.28%,1
彰化縣,彰化市,0149,207,429,636,32,668,1158,57.69%,17.88%,1
彰化縣,彰化市,0150,189,457,646,38,684,1084,63.1%,17.44%,1
彰化縣,彰化市,0151,231,503,734,44,778,1372,56.71%,16.84%,1
彰化縣,彰化市,0152,159,485,644,34,678,1113,60.92%,14.29%,1
彰化縣,彰化市,0153,116,362,478,29,507,800,63.38%,14.5%,1
彰化縣,彰化市,0154,244,263,507,32,539,885,60.9%,27.57%,1
彰化縣,彰化市,0155,198,410,608,19,627,1000,62.7%,19.8%,1
彰化縣,彰化市,0156,212,419,631,23,654,1159,56.43%,18.29%,1
彰化縣,彰化市,0157,186,426,612,31,643,1123,57.26%,16.56%,1
彰化縣,彰化市,0158,179,381,560,43,603,907,66.48%,19.74%,1
彰化縣,彰化市,0159,154,366,520,42,562,989,56.83%,15.57%,1
彰化縣,彰化市,0160,415,177,592,37,629,1012,62.15%,41.01%,1
彰化縣,彰化市,0161,152,398,550,20,570,1033,55.18%,14.71%,1
彰化縣,彰化市,0162,198,453,651,30,681,1116,61.02%,17.74%,1
彰化縣,彰化市,0163,193,499,692,20,712,1154,61.7%,16.72%,1
彰化縣,彰化市,0164,206,429,635,27,662,1064,62.22%,19.36%,1
彰化縣,彰化市,0165,131,339,470,35,505,770,65.58%,17.01%,1
彰化縣,彰化市,0166,184,341,525,32,557,889,62.65%,20.7%,1
彰化縣,彰化市,0167,117,338,455,47,502,786,63.87%,14.89%,1
彰化縣,彰化市,0168,172,407,579,42,621,1120,55.45%,15.36%,1
彰化縣,彰化市,0169,209,460,669,33,702,1269,55.32%,16.47%,1
彰化縣,彰化市,0170,187,461,648,56,704,1159,60.74%,16.13%,1
彰化縣,彰化市,0171,180,491,671,56,727,1184,61.4%,15.2%,1
彰化縣,彰化市,0172,192,405,597,37,634,1089,58.22%,17.63%,1
彰化縣,彰化市,0173,158,400,558,45,603,968,62.29%,16.32%,1
彰化縣,彰化市,0174,148,371,519,27,546,930,58.71%,15.91%,1
彰化縣,彰化市,0175,161,416,577,20,597,973,61.36%,16.55%,1
彰化縣,彰化市,0176,188,402,590,24,614,1184,51.86%,15.88%,1
彰化縣,彰化市,0177,177,388,565,52,617,1002,61.58%,17.66%,1
彰化縣,彰化市,0178,177,456,633,21,654,1148,56.97%,15.42%,1
彰化縣,彰化市,0179,170,450,620,26,646,1112,58.09%,15.29%,1
彰化縣,彰化市,0180,159,425,584,38,622,907,68.58%,17.53%,1
彰化縣,彰化市,0181,184,443,627,51,678,1112,60.97%,16.55%,1
彰化縣,彰化市,0182,134,291,425,27,452,823,54.92%,16.28%,1
彰化縣,彰化市,0183,209,494,703,53,756,1276,59.25%,16.38%,1
彰化縣,彰化市,0184,172,461,633,30,663,1161,57.11%,14.81%,1
彰化縣,鹿港鎮,0243,219,455,674,44,718,1140,62.98%,19.21%,1
彰化縣,鹿港鎮,0244,100,187,287,18,305,511,59.69%,19.57%,1
彰化縣,鹿港鎮,0245,131,276,407,22,429,857,50.06%,15.29%,1
彰化縣,鹿港鎮,0246,162,402,564,43,607,946,64.16%,17.12%,1
彰化縣,鹿港鎮,0247,162,370,532,32,564,945,59.68%,17.14%,1
彰化縣,鹿港鎮,0248,174,445,619,36,655,1097,59.71%,15.86%,1
彰化縣,鹿港鎮,0249,236,470,706,29,735,1479,49.7%,15.96%,1
彰化縣,鹿港鎮,0250,230,580,810,48,858,1425,60.21%,16.14%,1
彰化縣,鹿港鎮,0251,153,352,505,52,557,880,63.3%,17.39%,1
彰化縣,鹿港鎮,0252,186,443,629,40,669,1183,56.55%,15.72%,1
彰化縣,鹿港鎮,0253,167,431,598,45,643,1047,61.41%,15.95%,1
彰化縣,鹿港鎮,0254,173,416,589,21,610,1097,55.61%,15.77%,1
彰化縣,鹿港鎮,0255,155,388,543,50,593,1030,57.57%,15.05%,1
彰化縣,鹿港鎮,0256,172,464,636,37,673,1161,57.97%,14.81%,1
彰化縣,鹿港鎮,0257,89,214,303,38,341,540,63.15%,16.48%,1
彰化縣,鹿港鎮,0258,223,381,604,44,648,1135,57.09%,19.65%,1
彰化縣,鹿港鎮,0259,168,455,623,48,671,1155,58.1%,14.55%,1
彰化縣,鹿港鎮,0260,212,450,662,36,698,1127,61.93%,18.81%,1
彰化縣,鹿港鎮,0261,166,417,583,38,621,1045,59.43%,15.89%,1
彰化縣,鹿港鎮,0262,174,443,617,49,666,1127,59.09%,15.44%,1
彰化縣,鹿港鎮,0263,219,501,720,37,757,1178,64.26%,18.59%,1
彰化縣,鹿港鎮,0264,43,114,157,12,169,284,59.51%,15.14%,1
彰化縣,鹿港鎮,0265,101,220,321,26,347,584,59.42%,17.29%,1
彰化縣,鹿港鎮,0266,114,291,405,30,435,659,66.01%,17.3%,1
彰化縣,鹿港鎮,0267,276,251,527,20,547,915,59.78%,30.16%,1
彰化縣,鹿港鎮,0268,194,438,632,49,681,1079,63.11%,17.98%,1
彰化縣,鹿港鎮,0269,207,468,675,57,732,1129,64.84%,18.33%,1
彰化縣,鹿港鎮,0270,154,509,663,43,706,1273,55.46%,12.1%,1
彰化縣,鹿港鎮,0271,87,263,350,29,379,706,53.68%,12.32%,1
彰化縣,鹿港鎮,0272,191,361,552,79,631,1137,55.5%,16.8%,1
彰化縣,鹿港鎮,0273,185,438,623,39,662,1195,55.4%,15.48%,1
彰化縣,鹿港鎮,0274,173,437,610,52,662,1225,54.04%,14.12%,1
彰化縣,鹿港鎮,0275,158,429,587,43,630,957,65.83%,16.51%,1
彰化縣,鹿港鎮,0276,84,276,360,48,408,758,53.83%,11.08%,1
彰化縣,鹿港鎮,0277,98,299,397,41,438,723,60.58%,13.55%,1
彰化縣,鹿港鎮,0278,142,379,521,26,547,984,55.59%,14.43%,1
彰化縣,鹿港鎮,0279,139,447,586,33,619,1018,60.81%,13.65%,1
彰化縣,鹿港鎮,0280,175,435,610,35,645,1165,55.36%,15.02%,1
彰化縣,鹿港鎮,0281,145,410,555,59,614,1161,52.89%,12.49%,1
彰化縣,鹿港鎮,0282,141,373,514,46,560,1020,54.9%,13.82%,1
彰化縣,鹿港鎮,0283,135,419,554,52,606,1068,56.74%,12.64%,1
彰化縣,鹿港鎮,0284,153,442,595,30,625,1024,61.04%,14.94%,1
彰化縣,鹿港鎮,0285,155,384,539,64,603,974,61.91%,15.91%,1
彰化縣,鹿港鎮,0286,228,527,755,64,819,1505,54.42%,15.15%,1
彰化縣,鹿港鎮,0287,158,397,555,50,605,1092,55.4%,14.47%,1
彰化縣,鹿港鎮,0288,188,503,691,51,742,1223,60.67%,15.37%,1
彰化縣,鹿港鎮,0289,194,564,758,35,793,1572,50.45%,12.34%,1
彰化縣,鹿港鎮,0290,162,419,581,37,618,1003,61.62%,16.15%,1
彰化縣,鹿港鎮,0291,138,390,528,31,559,933,59.91%,14.79%,1
彰化縣,鹿港鎮,0292,173,451,624,39,663,1093,60.66%,15.83%,1
彰化縣,鹿港鎮,0293,148,350,498,17,515,907,56.78%,16.32%,1
彰化縣,鹿港鎮,0294,161,466,627,45,672,1219,55.13%,13.21%,1
彰化縣,鹿港鎮,0295,210,629,839,41,880,1397,62.99%,15.03%,1
彰化縣,鹿港鎮,0296,172,507,679,37,716,1229,58.26%,14%,1
彰化縣,鹿港鎮,0297,161,591,752,45,797,1444,55.19%,11.15%,1
彰化縣,鹿港鎮,0298,184,509,693,43,736,1227,59.98%,15%,1
彰化縣,鹿港鎮,0299,166,500,666,50,716,1187,60.32%,13.98%,1
彰化縣,鹿港鎮,0300,184,496,680,34,714,1296,55.09%,14.2%,1
彰化縣,鹿港鎮,0301,235,479,714,42,756,1451,52.1%,16.2%,1
彰化縣,鹿港鎮,0302,204,471,675,58,733,1299,56.43%,15.7%,1
彰化縣,鹿港鎮,0303,212,562,774,30,804,1298,61.94%,16.33%,1
彰化縣,鹿港鎮,0304,216,590,806,34,840,1458,57.61%,14.81%,1
彰化縣,鹿港鎮,0305,195,440,635,51,686,1138,60.28%,17.14%,1
彰化縣,鹿港鎮,0306,196,439,635,50,685,1170,58.55%,16.75%,1
彰化縣,鹿港鎮,0307,183,540,723,20,743,1221,60.85%,14.99%,1
彰化縣,和美鎮,0373,230,471,701,36,737,1341,54.96%,17.15%,1
彰化縣,和美鎮,0374,263,462,725,47,772,1480,52.16%,17.77%,1
彰化縣,和美鎮,0375,239,584,823,37,860,1529,56.25%,15.63%,1
彰化縣,和美鎮,0376,264,599,863,15,878,1711,51.32%,15.43%,1
彰化縣,和美鎮,0377,184,400,584,32,616,1057,58.28%,17.41%,1
彰化縣,和美鎮,0378,227,365,592,28,620,1032,60.08%,22%,1
彰化縣,和美鎮,0379,160,429,589,34,623,1015,61.38%,15.76%,1
彰化縣,和美鎮,0380,214,477,691,33,724,1209,59.88%,17.7%,1
彰化縣,和美鎮,0381,102,133,235,15,250,430,58.14%,23.72%,1
彰化縣,和美鎮,0382,142,329,471,13,484,856,56.54%,16.59%,1
彰化縣,和美鎮,0383,146,404,550,29,579,966,59.94%,15.11%,1
彰化縣,和美鎮,0384,171,383,554,28,582,1059,54.96%,16.15%,1
彰化縣,和美鎮,0385,202,409,611,27,638,1117,57.12%,18.08%,1
彰化縣,和美鎮,0386,167,389,556,37,593,1066,55.63%,15.67%,1
彰化縣,和美鎮,0387,196,438,634,50,684,1252,54.63%,15.65%,1
彰化縣,和美鎮,0388,235,526,761,45,806,1528,52.75%,15.38%,1
彰化縣,和美鎮,0389,162,308,470,26,496,826,60.05%,19.61%,1
彰化縣,和美鎮,0390,114,346,460,24,484,854,56.67%,13.35%,1
彰化縣,和美鎮,0391,202,498,700,45,745,1387,53.71%,14.56%,1
彰化縣,和美鎮,0392,117,351,468,12,480,765,62.75%,15.29%,1
彰化縣,和美鎮,0393,193,520,713,41,754,1438,52.43%,13.42%,1
彰化縣,和美鎮,0394,227,555,782,49,831,1396,59.53%,16.26%,1
彰化縣,和美鎮,0395,101,271,372,15,387,658,58.81%,15.35%,1
彰化縣,和美鎮,0396,140,352,492,23,515,809,63.66%,17.31%,1
彰化縣,和美鎮,0397,151,334,485,13,498,932,53.43%,16.2%,1
彰化縣,和美鎮,0398,137,324,461,26,487,888,54.84%,15.43%,1
彰化縣,和美鎮,0399,172,499,671,31,702,1144,61.36%,15.03%,1
彰化縣,和美鎮,0400,158,430,588,27,615,1077,57.1%,14.67%,1
彰化縣,和美鎮,0401,217,443,660,50,710,1349,52.63%,16.09%,1
彰化縣,和美鎮,0402,489,195,684,38,722,1155,62.51%,42.34%,1
彰化縣,和美鎮,0403,181,483,664,34,698,1253,55.71%,14.45%,1
彰化縣,和美鎮,0404,176,482,658,33,691,1252,55.19%,14.06%,1
彰化縣,和美鎮,0405,239,532,771,30,801,1474,54.34%,16.21%,1
彰化縣,和美鎮,0406,203,491,694,21,715,1396,51.22%,14.54%,1
彰化縣,和美鎮,0407,210,495,705,29,734,1348,54.45%,15.58%,1
彰化縣,和美鎮,0408,148,453,601,22,623,999,62.36%,14.81%,1
彰化縣,和美鎮,0409,138,370,508,35,543,911,59.6%,15.15%,1
彰化縣,和美鎮,0410,189,377,566,29,595,1005,59.2%,18.81%,1
彰化縣,和美鎮,0411,149,384,533,32,565,967,58.43%,15.41%,1
彰化縣,和美鎮,0412,186,544,730,38,768,1308,58.72%,14.22%,1
彰化縣,和美鎮,0413,209,502,711,40,751,1324,56.72%,15.79%,1
彰化縣,和美鎮,0414,187,425,612,46,658,1102,59.71%,16.97%,1
彰化縣,和美鎮,0415,169,399,568,51,619,1124,55.07%,15.04%,1
彰化縣,和美鎮,0416,266,401,667,38,705,1211,58.22%,21.97%,1
彰化縣,和美鎮,0417,152,402,554,39,593,884,67.08%,17.19%,1
彰化縣,和美鎮,0418,167,436,603,47,650,1119,58.09%,14.92%,1
彰化縣,和美鎮,0419,226,479,705,30,735,1300,56.54%,17.38%,1
彰化縣,和美鎮,0420,165,413,578,26,604,1104,54.71%,14.95%,1
彰化縣,和美鎮,0421,201,503,704,37,741,1213,61.09%,16.57%,1
彰化縣,和美鎮,0422,162,373,535,43,578,1127,51.29%,14.37%,1
彰化縣,和美鎮,0423,144,345,489,38,527,919,57.34%,15.67%,1
彰化縣,和美鎮,0424,151,398,549,45,594,987,60.18%,15.3%,1
彰化縣,和美鎮,0425,151,405,556,36,592,958,61.8%,15.76%,1
彰化縣,和美鎮,0426,214,548,762,33,795,1362,58.37%,15.71%,1
彰化縣,和美鎮,0427,242,549,791,23,814,1461,55.72%,16.56%,1
彰化縣,和美鎮,0428,242,545,787,23,810,1405,57.65%,17.22%,1
彰化縣,和美鎮,0429,146,345,491,29,520,860,60.47%,16.98%,1
彰化縣,和美鎮,0430,119,355,474,19,493,875,56.34%,13.6%,1
彰化縣,和美鎮,0431,147,330,477,30,507,871,58.21%,16.88%,1
彰化縣,和美鎮,0432,140,379,519,32,551,883,62.4%,15.86%,1
彰化縣,和美鎮,0433,218,418,636,52,688,1224,56.21%,17.81%,1
彰化縣,和美鎮,0434,172,392,564,39,603,1075,56.09%,16%,1
彰化縣,和美鎮,0435,155,360,515,29,544,956,56.9%,16.21%,1
彰化縣,和美鎮,0436,162,381,543,38,581,1037,56.03%,15.62%,1
彰化縣,和美鎮,0437,176,380,556,22,578,1011,57.17%,17.41%,1
彰化縣,和美鎮,0438,177,366,543,37,580,1023,56.7%,17.3%,1
彰化縣,和美鎮,0439,103,272,375,21,396,719,55.08%,14.33%,1
彰化縣,和美鎮,0440,136,344,480,36,516,913,56.52%,14.9%,1
彰化縣,線西鄉,0469,166,424,590,27,617,1071,57.61%,15.5%,1
彰化縣,線西鄉,0470,207,469,676,23,699,1166,59.95%,17.75%,1
彰化縣,線西鄉,0471,194,504,698,58,756,1269,59.57%,15.29%,1
彰化縣,線西鄉,0472,170,444,614,39,653,1138,57.38%,14.94%,1
彰化縣,線西鄉,0473,178,494,672,50,722,1128,64.01%,15.78%,1
彰化縣,線西鄉,0474,187,521,708,60,768,1275,60.24%,14.67%,1
彰化縣,線西鄉,0475,203,460,663,45,708,1187,59.65%,17.1%,1
彰化縣,線西鄉,0476,140,409,549,54,603,991,60.85%,14.13%,1
彰化縣,線西鄉,0477,148,368,516,48,564,938,60.13%,15.78%,1
彰化縣,線西鄉,0478,175,464,639,49,688,1276,53.92%,13.71%,1
彰化縣,線西鄉,0479,181,527,708,51,759,1285,59.07%,14.09%,1
彰化縣,線西鄉,0480,591,200,791,57,848,1341,63.24%,44.07%,1
彰化縣,伸港鄉,0441,169,398,567,39,606,1182,51.27%,14.3%,1
彰化縣,伸港鄉,0442,191,497,688,32,720,1166,61.75%,16.38%,1
彰化縣,伸港鄉,0443,152,378,530,34,564,966,58.39%,15.73%,1
彰化縣,伸港鄉,0444,142,316,458,32,490,873,56.13%,16.27%,1
彰化縣,伸港鄉,0445,119,339,458,34,492,812,60.59%,14.66%,1
彰化縣,伸港鄉,0446,118,338,456,35,491,875,56.11%,13.49%,1
彰化縣,伸港鄉,0447,147,330,477,36,513,904,56.75%,16.26%,1
彰化縣,伸港鄉,0448,160,360,520,40,560,1008,55.56%,15.87%,1
彰化縣,伸港鄉,0449,191,451,642,43,685,1154,59.36%,16.55%,1
彰化縣,伸港鄉,0450,225,500,725,57,782,1486,52.62%,15.14%,1
彰化縣,伸港鄉,0451,145,426,571,39,610,1095,55.71%,13.24%,1
彰化縣,伸港鄉,0452,141,399,540,16,556,1087,51.15%,12.97%,1
彰化縣,伸港鄉,0453,172,421,593,55,648,1085,59.72%,15.85%,1
彰化縣,伸港鄉,0454,158,358,516,27,543,908,59.8%,17.4%,1
彰化縣,伸港鄉,0455,200,537,737,38,775,1264,61.31%,15.82%,1
彰化縣,伸港鄉,0456,127,302,429,46,475,854,55.62%,14.87%,1
彰化縣,伸港鄉,0457,104,296,400,27,427,846,50.47%,12.29%,1
彰化縣,伸港鄉,0458,153,375,528,82,610,1143,53.37%,13.39%,1
彰化縣,伸港鄉,0459,237,498,735,28,763,1357,56.23%,17.46%,1
彰化縣,伸港鄉,0460,208,492,700,52,752,1349,55.74%,15.42%,1
彰化縣,伸港鄉,0461,175,457,632,47,679,1154,58.84%,15.16%,1
彰化縣,伸港鄉,0462,224,446,670,26,696,1279,54.42%,17.51%,1
彰化縣,伸港鄉,0463,230,492,722,52,774,1317,58.77%,17.46%,1
彰化縣,伸港鄉,0464,162,407,569,38,607,990,61.31%,16.36%,1
彰化縣,伸港鄉,0465,152,324,476,32,508,852,59.62%,17.84%,1
彰化縣,伸港鄉,0466,146,526,672,13,685,1178,58.15%,12.39%,1
彰化縣,伸港鄉,0467,141,411,552,67,619,1088,56.89%,12.96%,1
彰化縣,伸港鄉,0468,201,390,591,56,647,1135,57%,17.71%,1
彰化縣,福興鄉,0308,256,439,695,50,745,1363,54.66%,18.78%,1
彰化縣,福興鄉,0309,114,329,443,25,468,821,57%,13.89%,1
彰化縣,福興鄉,0310,173,436,609,54,663,1256,52.79%,13.77%,1
彰化縣,福興鄉,0311,175,388,563,76,639,1166,54.8%,15.01%,1
彰化縣,福興鄉,0312,190,523,713,50,763,1464,52.12%,12.98%,1
彰化縣,福興鄉,0313,185,436,621,41,662,1251,52.92%,14.79%,1
彰化縣,福興鄉,0314,212,514,726,53,779,1465,53.17%,14.47%,1
彰化縣,福興鄉,0315,125,328,453,27,480,960,50%,13.02%,1
彰化縣,福興鄉,0316,218,440,658,59,717,1323,54.2%,16.48%,1
彰化縣,福興鄉,0317,211,500,711,43,754,1365,55.24%,15.46%,1
彰化縣,福興鄉,0318,186,456,642,30,672,1458,46.09%,12.76%,1
彰化縣,福興鄉,0319,198,529,727,58,785,1492,52.61%,13.27%,1
彰化縣,福興鄉,0320,134,310,444,21,465,888,52.36%,15.09%,1
彰化縣,福興鄉,0321,183,398,581,53,634,1054,60.15%,17.36%,1
彰化縣,福興鄉,0322,140,341,481,39,520,1043,49.86%,13.42%,1
彰化縣,福興鄉,0323,182,499,681,63,744,1340,55.52%,13.58%,1
彰化縣,福興鄉,0324,182,349,531,44,575,1085,53%,16.77%,1
彰化縣,福興鄉,0325,195,508,703,37,740,1392,53.16%,14.01%,1
彰化縣,福興鄉,0326,188,524,712,63,775,1316,58.89%,14.29%,1
彰化縣,福興鄉,0327,185,532,717,36,753,1255,60%,14.74%,1
彰化縣,福興鄉,0328,169,473,642,34,676,1101,61.4%,15.35%,1
彰化縣,福興鄉,0329,154,445,599,57,656,1167,56.21%,13.2%,1
彰化縣,福興鄉,0330,188,495,683,53,736,1393,52.84%,13.5%,1
彰化縣,福興鄉,0331,175,483,658,39,697,1216,57.32%,14.39%,1
彰化縣,福興鄉,0332,143,393,536,37,573,1063,53.9%,13.45%,1
彰化縣,福興鄉,0333,194,477,671,35,706,1306,54.06%,14.85%,1
彰化縣,福興鄉,0334,157,398,555,44,599,1287,46.54%,12.2%,1
彰化縣,福興鄉,0335,134,390,524,35,559,994,56.24%,13.48%,1
彰化縣,福興鄉,0336,177,506,683,61,744,1311,56.75%,13.5%,1
彰化縣,福興鄉,0337,109,412,521,33,554,926,59.83%,11.77%,1
彰化縣,福興鄉,0338,146,339,485,36,521,995,52.36%,14.67%,1
彰化縣,福興鄉,0339,151,453,604,66,670,1079,62.09%,13.99%,1
彰化縣,福興鄉,0340,141,400,541,65,606,1150,52.7%,12.26%,1
彰化縣,秀水鄉,0341,163,445,608,62,670,1066,62.85%,15.29%,1
彰化縣,秀水鄉,0342,108,254,362,35,397,620,64.03%,17.42%,1
彰化縣,秀水鄉,0343,131,304,435,12,447,876,51.03%,14.95%,1
彰化縣,秀水鄉,0344,208,499,707,30,737,1196,61.62%,17.39%,1
彰化縣,秀水鄉,0345,232,528,760,30,790,1369,57.71%,16.95%,1
彰化縣,秀水鄉,0346,197,516,713,44,757,1273,59.47%,15.48%,1
彰化縣,秀水鄉,0347,200,567,767,36,803,1433,56.04%,13.96%,1
彰化縣,秀水鄉,0348,173,379,552,24,576,967,59.57%,17.89%,1
彰化縣,秀水鄉,0349,149,377,526,20,546,921,59.28%,16.18%,1
彰化縣,秀水鄉,0350,111,300,411,23,434,689,62.99%,16.11%,1
彰化縣,秀水鄉,0351,209,176,385,34,419,688,60.9%,30.38%,1
彰化縣,秀水鄉,0352,243,490,733,50,783,1252,62.54%,19.41%,1
彰化縣,秀水鄉,0353,216,460,676,32,708,1281,55.27%,16.86%,1
彰化縣,秀水鄉,0354,107,291,398,28,426,754,56.5%,14.19%,1
彰化縣,秀水鄉,0355,188,358,546,41,587,1024,57.32%,18.36%,1
彰化縣,秀水鄉,0356,206,549,755,28,783,1433,54.64%,14.38%,1
彰化縣,秀水鄉,0357,230,598,828,55,883,1366,64.64%,16.84%,1
彰化縣,秀水鄉,0358,131,372,503,43,546,895,61.01%,14.64%,1
彰化縣,秀水鄉,0359,214,497,711,44,755,1386,54.47%,15.44%,1
彰化縣,秀水鄉,0360,146,340,486,59,545,896,60.83%,16.29%,1
彰化縣,秀水鄉,0361,151,358,509,26,535,804,66.54%,18.78%,1
彰化縣,秀水鄉,0362,123,379,502,20,522,827,63.12%,14.87%,1
彰化縣,秀水鄉,0363,173,382,555,39,594,996,59.64%,17.37%,1
彰化縣,秀水鄉,0364,165,407,572,48,620,931,66.6%,17.72%,1
彰化縣,秀水鄉,0365,119,259,378,28,406,715,56.78%,16.64%,1
彰化縣,秀水鄉,0366,187,531,718,51,769,1229,62.57%,15.22%,1
彰化縣,秀水鄉,0367,121,318,439,25,464,890,52.13%,13.6%,1
彰化縣,秀水鄉,0368,146,331,477,32,509,811,62.76%,18%,1
彰化縣,秀水鄉,0369,124,332,456,31,487,786,61.96%,15.78%,1
彰化縣,秀水鄉,0370,133,381,514,28,542,931,58.22%,14.29%,1
彰化縣,秀水鄉,0371,213,503,716,57,773,1265,61.11%,16.84%,1
彰化縣,秀水鄉,0372,122,299,421,42,463,824,56.19%,14.81%,1
彰化縣,花壇鄉,0185,144,374,518,32,550,901,61.04%,15.98%,1
彰化縣,花壇鄉,0186,206,417,623,30,653,1042,62.67%,19.77%,1
彰化縣,花壇鄉,0187,226,478,704,14,718,1314,54.64%,17.2%,1
彰化縣,花壇鄉,0188,111,350,461,36,497,808,61.51%,13.74%,1
彰化縣,花壇鄉,0189,150,403,553,35,588,1019,57.7%,14.72%,1
彰化縣,花壇鄉,0190,188,472,660,50,710,1144,62.06%,16.43%,1
彰化縣,花壇鄉,0191,162,489,651,87,738,1240,59.52%,13.06%,1
彰化縣,花壇鄉,0192,192,634,826,54,880,1425,61.75%,13.47%,1
彰化縣,花壇鄉,0193,180,480,660,45,705,1095,64.38%,16.44%,1
彰化縣,花壇鄉,0194,143,376,519,28,547,910,60.11%,15.71%,1
彰化縣,花壇鄉,0195,172,325,497,21,518,982,52.75%,17.52%,1
彰化縣,花壇鄉,0196,185,410,595,18,613,1070,57.29%,17.29%,1
彰化縣,花壇鄉,0197,122,243,365,19,384,700,54.86%,17.43%,1
彰化縣,花壇鄉,0198,148,330,478,28,506,764,66.23%,19.37%,1
彰化縣,花壇鄉,0199,166,402,568,37,605,953,63.48%,17.42%,1
彰化縣,花壇鄉,0200,159,380,539,18,557,974,57.19%,16.32%,1
彰化縣,花壇鄉,0201,169,429,598,49,647,1111,58.24%,15.21%,1
彰化縣,花壇鄉,0202,153,471,624,50,674,1101,61.22%,13.9%,1
彰化縣,花壇鄉,0203,149,439,588,33,621,1110,55.95%,13.42%,1
彰化縣,花壇鄉,0204,219,472,691,45,736,1262,58.32%,17.35%,1
彰化縣,花壇鄉,0205,223,403,626,27,653,1103,59.2%,20.22%,1
彰化縣,花壇鄉,0206,191,469,660,47,707,1347,52.49%,14.18%,1
彰化縣,花壇鄉,0207,153,438,591,43,634,1169,54.23%,13.09%,1
彰化縣,花壇鄉,0208,201,531,732,36,768,1274,60.28%,15.78%,1
彰化縣,花壇鄉,0209,180,576,756,30,786,1280,61.41%,14.06%,1
彰化縣,花壇鄉,0210,174,524,698,32,730,1244,58.68%,13.99%,1
彰化縣,花壇鄉,0211,452,190,642,41,683,1159,58.93%,39%,1
彰化縣,花壇鄉,0212,181,441,622,36,658,1042,63.15%,17.37%,1
彰化縣,花壇鄉,0213,154,435,589,42,631,1111,56.8%,13.86%,1
彰化縣,花壇鄉,0214,140,385,525,44,569,893,63.72%,15.68%,1
彰化縣,花壇鄉,0215,147,367,514,53,567,953,59.5%,15.42%,1
彰化縣,花壇鄉,0216,169,340,509,30,539,987,54.61%,17.12%,1
彰化縣,花壇鄉,0217,163,396,559,45,604,925,65.3%,17.62%,1
彰化縣,花壇鄉,0218,110,411,521,31,552,951,58.04%,11.57%,1
彰化縣,花壇鄉,0219,138,380,518,27,545,955,57.07%,14.45%,1
彰化縣,花壇鄉,0220,134,368,502,16,518,895,57.88%,14.97%,1
彰化縣,花壇鄉,0221,102,301,403,18,421,711,59.21%,14.35%,1
彰化縣,芬園鄉,0222,126,373,499,37,536,958,55.95%,13.15%,1
彰化縣,芬園鄉,0223,134,289,423,36,459,794,57.81%,16.88%,1
彰化縣,芬園鄉,0224,275,398,673,74,747,1415,52.79%,19.43%,1
彰化縣,芬園鄉,0225,392,146,538,27,565,927,60.95%,42.29%,1
彰化縣,芬園鄉,0226,110,331,441,33,474,831,57.04%,13.24%,1
彰化縣,芬園鄉,0227,96,219,315,17,332,570,58.25%,16.84%,1
彰化縣,芬園鄉,0228,200,414,614,42,656,1227,53.46%,16.3%,1
彰化縣,芬園鄉,0229,161,471,632,51,683,1238,55.17%,13%,1
彰化縣,芬園鄉,0230,206,517,723,64,787,1362,57.78%,15.12%,1
彰化縣,芬園鄉,0231,142,382,524,65,589,989,59.56%,14.36%,1
彰化縣,芬園鄉,0232,209,454,663,8,671,1054,63.66%,19.83%,1
彰化縣,芬園鄉,0233,97,276,373,25,398,607,65.57%,15.98%,1
彰化縣,芬園鄉,0234,117,374,491,41,532,882,60.32%,13.27%,1
彰化縣,芬園鄉,0235,141,389,530,31,561,1143,49.08%,12.34%,1
彰化縣,芬園鄉,0236,78,237,315,13,328,661,49.62%,11.8%,1
彰化縣,芬園鄉,0237,102,314,416,7,423,838,50.48%,12.17%,1
彰化縣,芬園鄉,0238,128,294,422,24,446,847,52.66%,15.11%,1
彰化縣,芬園鄉,0239,140,407,547,45,592,987,59.98%,14.18%,1
彰化縣,芬園鄉,0240,173,420,593,50,643,1217,52.83%,14.22%,1
彰化縣,芬園鄉,0241,104,308,412,43,455,865,52.6%,12.02%,1
彰化縣,芬園鄉,0242,144,328,472,42,514,996,51.61%,14.46%,1
彰化縣,員林市,0481,118,430,548,23,571,1087,52.53%,10.86%,1
彰化縣,員林市,0482,200,487,687,22,709,1353,52.4%,14.78%,1
彰化縣,員林市,0483,203,454,657,46,703,1313,53.54%,15.46%,1
彰化縣,員林市,0484,161,457,618,22,640,1328,48.19%,12.12%,1
彰化縣,員林市,0485,186,388,574,26,600,1055,56.87%,17.63%,1
彰化縣,員林市,0486,150,349,499,30,529,959,55.16%,15.64%,1
彰化縣,員林市,0487,120,286,406,45,451,772,58.42%,15.54%,1
彰化縣,員林市,0488,132,339,471,38,509,831,61.25%,15.88%,1
彰化縣,員林市,0489,97,266,363,13,376,854,44.03%,11.36%,1
彰化縣,員林市,0490,130,381,511,33,544,1190,45.71%,10.92%,1
彰化縣,員林市,0491,93,286,379,19,398,726,54.82%,12.81%,1
彰化縣,員林市,0492,100,505,605,29,634,1124,56.41%,8.9%,1
彰化縣,員林市,0493,137,282,419,35,454,860,52.79%,15.93%,1
彰化縣,員林市,0494,197,467,664,31,695,1122,61.94%,17.56%,1
彰化縣,員林市,0495,166,438,604,36,640,1075,59.53%,15.44%,1
彰化縣,員林市,0496,125,379,504,46,550,993,55.39%,12.59%,1
彰化縣,員林市,0497,121,378,499,33,532,967,55.02%,12.51%,1
彰化縣,員林市,0498,172,372,544,38,582,1008,57.74%,17.06%,1
彰化縣,員林市,0499,120,300,420,38,458,804,56.97%,14.93%,1
彰化縣,員林市,0500,140,321,461,23,484,867,55.82%,16.15%,1
彰化縣,員林市,0501,134,337,471,16,487,885,55.03%,15.14%,1
彰化縣,員林市,0502,147,368,515,16,531,1097,48.4%,13.4%,1
彰化縣,員林市,0503,207,452,659,25,684,1255,54.5%,16.49%,1
彰化縣,員林市,0504,179,408,587,31,618,1063,58.14%,16.84%,1
彰化縣,員林市,0505,413,87,500,19,519,925,56.11%,44.65%,1
彰化縣,員林市,0506,152,374,526,33,559,947,59.03%,16.05%,1
彰化縣,員林市,0507,133,391,524,21,545,916,59.5%,14.52%,1
彰化縣,員林市,0508,141,316,457,26,483,862,56.03%,16.36%,1
彰化縣,員林市,0509,170,378,548,16,564,987,57.14%,17.22%,1
彰化縣,員林市,0510,135,403,538,39,577,1085,53.18%,12.44%,1
彰化縣,員林市,0511,178,435,613,21,634,1110,57.12%,16.04%,1
彰化縣,員林市,0512,166,387,553,25,578,1095,52.79%,15.16%,1
彰化縣,員林市,0513,244,509,753,32,785,1278,61.42%,19.09%,1
彰化縣,員林市,0514,169,450,619,36,655,1109,59.06%,15.24%,1
彰化縣,員林市,0515,144,407,551,52,603,1055,57.16%,13.65%,1
彰化縣,員林市,0516,163,311,474,39,513,876,58.56%,18.61%,1
彰化縣,員林市,0517,168,362,530,26,556,1115,49.87%,15.07%,1
彰化縣,員林市,0518,205,460,665,24,689,1186,58.09%,17.28%,1
彰化縣,員林市,0519,170,395,565,36,601,995,60.4%,17.09%,1
彰化縣,員林市,0520,151,385,536,18,554,999,55.46%,15.12%,1
彰化縣,員林市,0521,186,453,639,23,662,1201,55.12%,15.49%,1
彰化縣,員林市,0522,188,514,702,33,735,1342,54.77%,14.01%,1
彰化縣,員林市,0523,171,393,564,27,591,1086,54.42%,15.75%,1
彰化縣,員林市,0524,117,306,423,31,454,854,53.16%,13.7%,1
彰化縣,員林市,0525,167,417,584,26,610,1064,57.33%,15.7%,1
彰化縣,員林市,0526,163,355,518,8,526,879,59.84%,18.54%,1
彰化縣,員林市,0527,164,381,545,18,563,827,68.08%,19.83%,1
彰化縣,員林市,0528,140,330,470,13,483,867,55.71%,16.15%,1
彰化縣,員林市,0529,192,461,653,28,681,1201,56.7%,15.99%,1
彰化縣,員林市,0530,192,425,617,28,645,1106,58.32%,17.36%,1
彰化縣,員林市,0531,132,344,476,31,507,845,60%,15.62%,1
彰化縣,員林市,0532,168,331,499,28,527,894,58.95%,18.79%,1
彰化縣,員林市,0533,149,330,479,25,504,849,59.36%,17.55%,1
彰化縣,員林市,0534,155,294,449,24,473,747,63.32%,20.75%,1
彰化縣,員林市,0535,179,342,521,29,550,884,62.22%,20.25%,1
彰化縣,員林市,0536,134,319,453,27,480,900,53.33%,14.89%,1
彰化縣,員林市,0537,138,391,529,19,548,1040,52.69%,13.27%,1
彰化縣,員林市,0538,147,291,438,18,456,831,54.87%,17.69%,1
彰化縣,員林市,0539,121,239,360,29,389,591,65.82%,20.47%,1
彰化縣,員林市,0540,210,486,696,24,720,1330,54.14%,15.79%,1
彰化縣,員林市,0541,222,485,707,27,734,1295,56.68%,17.14%,1
彰化縣,員林市,0542,206,454,660,56,716,1283,55.81%,16.06%,1
彰化縣,員林市,0543,158,394,552,22,574,943,60.87%,16.76%,1
彰化縣,員林市,0544,277,544,821,42,863,1388,62.18%,19.96%,1
彰化縣,員林市,0545,195,464,659,29,688,1176,58.5%,16.58%,1
彰化縣,員林市,0546,132,300,432,9,441,867,50.87%,15.22%,1
彰化縣,員林市,0547,211,381,592,27,619,1121,55.22%,18.82%,1
彰化縣,員林市,0548,195,405,600,29,629,1190,52.86%,16.39%,1
彰化縣,員林市,0549,130,401,531,34,565,945,59.79%,13.76%,1
彰化縣,員林市,0550,146,378,524,21,545,906,60.15%,16.11%,1
彰化縣,員林市,0551,176,392,568,32,600,978,61.35%,18%,1
彰化縣,員林市,0552,152,373,525,32,557,949,58.69%,16.02%,1
彰化縣,員林市,0553,142,392,534,39,573,949,60.38%,14.96%,1
彰化縣,員林市,0554,162,389,551,24,575,1006,57.16%,16.1%,1
彰化縣,員林市,0555,165,330,495,33,528,889,59.39%,18.56%,1
彰化縣,員林市,0556,173,380,553,17,570,923,61.76%,18.74%,1
彰化縣,員林市,0557,215,493,708,38,746,1209,61.7%,17.78%,1
彰化縣,員林市,0558,170,450,620,29,649,1075,60.37%,15.81%,1
彰化縣,員林市,0559,254,537,791,36,827,1342,61.62%,18.93%,1
彰化縣,員林市,0560,236,427,663,30,693,1039,66.7%,22.71%,1
彰化縣,員林市,0561,173,399,572,60,632,1131,55.88%,15.3%,1
彰化縣,員林市,0562,214,465,679,25,704,1356,51.92%,15.78%,1
彰化縣,員林市,0563,249,486,735,45,780,1370,56.93%,18.18%,1
彰化縣,員林市,0564,202,398,600,34,634,1090,58.17%,18.53%,1
彰化縣,員林市,0565,171,343,514,19,533,821,64.92%,20.83%,1
彰化縣,員林市,0566,352,165,517,26,543,910,59.67%,38.68%,1
彰化縣,員林市,0567,182,479,661,22,683,1203,56.77%,15.13%,1
彰化縣,員林市,0568,248,494,742,30,772,1378,56.02%,18%,1
彰化縣,員林市,0569,193,542,735,38,773,1352,57.17%,14.28%,1
彰化縣,員林市,0570,191,438,629,29,658,1060,62.08%,18.02%,1
彰化縣,員林市,0571,224,452,676,44,720,1317,54.67%,17.01%,1
彰化縣,員林市,0572,169,419,588,26,614,1120,54.82%,15.09%,1
彰化縣,員林市,0573,97,431,528,25,553,1025,53.95%,9.46%,1
彰化縣,員林市,0574,156,436,592,42,634,1097,57.79%,14.22%,1
彰化縣,員林市,0575,151,337,488,41,529,859,61.58%,17.58%,1
彰化縣,員林市,0576,140,326,466,24,490,837,58.54%,16.73%,1
彰化縣,員林市,0577,175,479,654,31,685,1090,62.84%,16.06%,1
彰化縣,員林市,0578,172,392,564,52,616,1073,57.41%,16.03%,1
彰化縣,溪湖鎮,0640,206,436,642,36,678,1221,55.53%,16.87%,1
彰化縣,溪湖鎮,0641,116,261,377,32,409,638,64.11%,18.18%,1
彰化縣,溪湖鎮,0642,134,316,450,35,485,817,59.36%,16.4%,1
彰化縣,溪湖鎮,0643,135,420,555,29,584,968,60.33%,13.95%,1
彰化縣,溪湖鎮,0644,88,192,280,15,295,448,65.85%,19.64%,1
彰化縣,溪湖鎮,0645,144,448,592,27,619,1123,55.12%,12.82%,1
彰化縣,溪湖鎮,0646,188,444,632,30,662,1166,56.78%,16.12%,1
彰化縣,溪湖鎮,0647,154,465,619,19,638,1151,55.43%,13.38%,1
彰化縣,溪湖鎮,0648,199,498,697,26,723,1249,57.89%,15.93%,1
彰化縣,溪湖鎮,0649,179,469,648,31,679,1146,59.25%,15.62%,1
彰化縣,溪湖鎮,0650,168,492,660,55,715,1199,59.63%,14.01%,1
彰化縣,溪湖鎮,0651,142,341,483,39,522,895,58.32%,15.87%,1
彰化縣,溪湖鎮,0652,137,427,564,14,578,964,59.96%,14.21%,1
彰化縣,溪湖鎮,0653,178,301,479,25,504,851,59.22%,20.92%,1
彰化縣,溪湖鎮,0654,262,316,578,30,608,1072,56.72%,24.44%,1
彰化縣,溪湖鎮,0655,175,458,633,36,669,1113,60.11%,15.72%,1
彰化縣,溪湖鎮,0656,183,444,627,29,656,1090,60.18%,16.79%,1
彰化縣,溪湖鎮,0657,182,505,687,32,719,1193,60.27%,15.26%,1
彰化縣,溪湖鎮,0658,122,437,559,34,593,952,62.29%,12.82%,1
彰化縣,溪湖鎮,0659,157,479,636,39,675,1172,57.59%,13.4%,1
彰化縣,溪湖鎮,0660,181,380,561,31,592,1027,57.64%,17.62%,1
彰化縣,溪湖鎮,0661,206,507,713,33,746,1188,62.79%,17.34%,1
彰化縣,溪湖鎮,0662,208,503,711,44,755,1403,53.81%,14.83%,1
彰化縣,溪湖鎮,0663,240,450,690,61,751,1397,53.76%,17.18%,1
彰化縣,溪湖鎮,0664,259,645,904,36,940,1636,57.46%,15.83%,1
彰化縣,溪湖鎮,0665,218,503,721,56,777,1298,59.86%,16.8%,1
彰化縣,溪湖鎮,0666,173,475,648,55,703,1214,57.91%,14.25%,1
彰化縣,溪湖鎮,0667,214,523,737,38,775,1297,59.75%,16.5%,1
彰化縣,溪湖鎮,0668,170,406,576,29,605,968,62.5%,17.56%,1
彰化縣,溪湖鎮,0669,128,347,475,25,500,839,59.59%,15.26%,1
彰化縣,溪湖鎮,0670,158,351,509,40,549,907,60.53%,17.42%,1
彰化縣,溪湖鎮,0671,117,341,458,20,478,898,53.23%,13.03%,1
彰化縣,溪湖鎮,0672,125,296,421,28,449,650,69.08%,19.23%,1
彰化縣,溪湖鎮,0673,171,504,675,62,737,1279,57.62%,13.37%,1
彰化縣,溪湖鎮,0674,118,315,433,37,470,730,64.38%,16.16%,1
彰化縣,溪湖鎮,0675,190,578,768,51,819,1407,58.21%,13.5%,1
彰化縣,溪湖鎮,0676,177,406,583,63,646,1273,50.75%,13.9%,1
彰化縣,溪湖鎮,0677,144,373,517,25,542,988,54.86%,14.57%,1
彰化縣,溪湖鎮,0678,122,325,447,34,481,754,63.79%,16.18%,1
彰化縣,溪湖鎮,0679,129,357,486,41,527,1052,50.1%,12.26%,1
彰化縣,溪湖鎮,0680,156,431,587,32,619,1149,53.87%,13.58%,1
彰化縣,溪湖鎮,0681,245,549,794,70,864,1365,63.3%,17.95%,1
彰化縣,田中鎮,0742,126,310,436,47,483,854,56.56%,14.75%,1
彰化縣,田中鎮,0743,32,418,450,42,492,963,51.09%,3.32%,1
彰化縣,田中鎮,0744,13,29,42,3,45,175,25.71%,7.43%,1
彰化縣,田中鎮,0745,86,277,363,31,394,739,53.32%,11.64%,1
彰化縣,田中鎮,0746,114,309,423,25,448,826,54.24%,13.8%,1
彰化縣,田中鎮,0747,120,294,414,33,447,741,60.32%,16.19%,1
彰化縣,田中鎮,0748,58,175,233,12,245,506,48.42%,11.46%,1
彰化縣,田中鎮,0749,135,339,474,49,523,1001,52.25%,13.49%,1
彰化縣,田中鎮,0750,173,508,681,65,746,1281,58.24%,13.51%,1
彰化縣,田中鎮,0751,148,411,559,33,592,1035,57.2%,14.3%,1
彰化縣,田中鎮,0752,203,535,738,42,780,1327,58.78%,15.3%,1
彰化縣,田中鎮,0753,138,357,495,27,522,844,61.85%,16.35%,1
彰化縣,田中鎮,0754,132,356,488,37,525,913,57.5%,14.46%,1
彰化縣,田中鎮,0755,92,277,369,37,406,613,66.23%,15.01%,1
彰化縣,田中鎮,0756,203,560,763,55,818,1382,59.19%,14.69%,1
彰化縣,田中鎮,0757,178,459,637,37,674,1034,65.18%,17.21%,1
彰化縣,田中鎮,0758,163,430,593,24,617,935,65.99%,17.43%,1
彰化縣,田中鎮,0759,203,515,718,35,753,1301,57.88%,15.6%,1
彰化縣,田中鎮,0760,165,455,620,35,655,1100,59.55%,15%,1
彰化縣,田中鎮,0761,189,426,615,38,653,1071,60.97%,17.65%,1
彰化縣,田中鎮,0762,198,501,699,31,730,1163,62.77%,17.02%,1
彰化縣,田中鎮,0763,134,363,497,38,535,809,66.13%,16.56%,1
彰化縣,田中鎮,0764,196,479,675,40,715,1155,61.9%,16.97%,1
彰化縣,田中鎮,0765,208,470,678,59,737,1270,58.03%,16.38%,1
彰化縣,田中鎮,0766,137,321,458,29,487,870,55.98%,15.75%,1
彰化縣,田中鎮,0767,101,279,380,46,426,736,57.88%,13.72%,1
彰化縣,田中鎮,0768,164,489,653,45,698,1335,52.28%,12.28%,1
彰化縣,田中鎮,0769,121,347,468,33,501,876,57.19%,13.81%,1
彰化縣,田中鎮,0770,140,315,455,47,502,898,55.9%,15.59%,1
彰化縣,田中鎮,0771,208,531,739,23,762,1298,58.71%,16.02%,1
彰化縣,田中鎮,0772,219,527,746,63,809,1451,55.75%,15.09%,1
彰化縣,田中鎮,0773,235,550,785,48,833,1475,56.47%,15.93%,1
彰化縣,田中鎮,0774,105,257,362,41,403,766,52.61%,13.71%,1
彰化縣,田中鎮,0775,91,327,418,22,440,810,54.32%,11.23%,1
彰化縣,田中鎮,0776,164,369,533,44,577,953,60.55%,17.21%,1
彰化縣,田中鎮,0777,141,364,505,54,559,885,63.16%,15.93%,1
彰化縣,大村鄉,0579,236,618,854,50,904,1426,63.39%,16.55%,1
彰化縣,大村鄉,0580,279,737,1016,59,1075,1726,62.28%,16.16%,1
彰化縣,大村鄉,0581,140,318,458,45,503,797,63.11%,17.57%,1
彰化縣,大村鄉,0582,126,306,432,19,451,745,60.54%,16.91%,1
彰化縣,大村鄉,0583,158,488,646,50,696,1125,61.87%,14.04%,1
彰化縣,大村鄉,0584,219,586,805,61,866,1486,58.28%,14.74%,1
彰化縣,大村鄉,0585,230,569,799,35,834,1426,58.49%,16.13%,1
彰化縣,大村鄉,0586,128,366,494,30,524,824,63.59%,15.53%,1
彰化縣,大村鄉,0587,160,421,581,35,616,1177,52.34%,13.59%,1
彰化縣,大村鄉,0588,223,603,826,55,881,1478,59.61%,15.09%,1
彰化縣,大村鄉,0589,108,295,403,21,424,779,54.43%,13.86%,1
彰化縣,大村鄉,0590,142,339,481,39,520,812,64.04%,17.49%,1
彰化縣,大村鄉,0591,158,457,615,32,647,1161,55.73%,13.61%,1
彰化縣,大村鄉,0592,168,475,643,30,673,1238,54.36%,13.57%,1
彰化縣,大村鄉,0593,190,493,683,44,727,1259,57.74%,15.09%,1
彰化縣,大村鄉,0594,234,540,774,47,821,1412,58.14%,16.57%,1
彰化縣,大村鄉,0595,223,547,770,27,797,1401,56.89%,15.92%,1
彰化縣,大村鄉,0596,194,585,779,60,839,1395,60.14%,13.91%,1
彰化縣,大村鄉,0597,156,416,572,29,601,996,60.34%,15.66%,1
彰化縣,大村鄉,0598,181,400,581,31,612,1047,58.45%,17.29%,1
彰化縣,大村鄉,0599,141,424,565,30,595,985,60.41%,14.31%,1
彰化縣,大村鄉,0600,192,424,616,43,659,1054,62.52%,18.22%,1
彰化縣,大村鄉,0601,163,526,689,29,718,1200,59.83%,13.58%,1
彰化縣,大村鄉,0602,147,413,560,58,618,1003,61.62%,14.66%,1
彰化縣,大村鄉,0603,159,372,531,42,573,1046,54.78%,15.2%,1
彰化縣,大村鄉,0604,198,478,676,37,713,1189,59.97%,16.65%,1
彰化縣,大村鄉,0605,173,460,633,44,677,1305,51.88%,13.26%,1
彰化縣,埔鹽鄉,0682,128,434,562,31,593,958,61.9%,13.36%,1
彰化縣,埔鹽鄉,0683,115,354,469,24,493,754,65.38%,15.25%,1
彰化縣,埔鹽鄉,0684,136,332,468,33,501,757,66.18%,17.97%,1
彰化縣,埔鹽鄉,0685,122,357,479,26,505,806,62.66%,15.14%,1
彰化縣,埔鹽鄉,0686,169,553,722,35,757,1280,59.14%,13.2%,1
彰化縣,埔鹽鄉,0687,122,386,508,37,545,928,58.73%,13.15%,1
彰化縣,埔鹽鄉,0688,157,387,544,46,590,895,65.92%,17.54%,1
彰化縣,埔鹽鄉,0689,125,365,490,38,528,815,64.79%,15.34%,1
彰化縣,埔鹽鄉,0690,147,377,524,36,560,957,58.52%,15.36%,1
彰化縣,埔鹽鄉,0691,175,516,691,102,793,1338,59.27%,13.08%,1
彰化縣,埔鹽鄉,0692,137,456,593,49,642,1106,58.05%,12.39%,1
彰化縣,埔鹽鄉,0693,122,330,452,23,475,690,68.84%,17.68%,1
彰化縣,埔鹽鄉,0694,100,563,663,41,704,1230,57.24%,8.13%,1
彰化縣,埔鹽鄉,0695,128,350,478,25,503,847,59.39%,15.11%,1
彰化縣,埔鹽鄉,0696,132,398,530,33,563,897,62.76%,14.72%,1
彰化縣,埔鹽鄉,0697,123,363,486,46,532,882,60.32%,13.95%,1
彰化縣,埔鹽鄉,0698,159,515,674,41,715,1180,60.59%,13.47%,1
彰化縣,埔鹽鄉,0699,176,464,640,65,705,1215,58.02%,14.49%,1
彰化縣,埔鹽鄉,0700,53,210,263,18,281,422,66.59%,12.56%,1
彰化縣,埔鹽鄉,0701,145,427,572,49,621,1106,56.15%,13.11%,1
彰化縣,埔鹽鄉,0702,123,400,523,46,569,874,65.1%,14.07%,1
彰化縣,埔鹽鄉,0703,249,536,785,73,858,1445,59.38%,17.23%,1
彰化縣,埔鹽鄉,0704,119,389,508,43,551,875,62.97%,13.6%,1
彰化縣,埔鹽鄉,0705,105,307,412,34,446,837,53.29%,12.54%,1
彰化縣,埔鹽鄉,0706,91,283,374,38,412,685,60.15%,13.28%,1
彰化縣,埔鹽鄉,0707,127,320,447,23,470,733,64.12%,17.33%,1
彰化縣,埔鹽鄉,0708,130,327,457,41,498,798,62.41%,16.29%,1
彰化縣,埔鹽鄉,0709,167,581,748,49,797,1381,57.71%,12.09%,1
彰化縣,埔鹽鄉,0710,169,507,676,40,716,1335,53.63%,12.66%,1
彰化縣,埔心鄉,0711,186,468,654,58,712,1139,62.51%,16.33%,1
彰化縣,埔心鄉,0712,165,510,675,44,719,1217,59.08%,13.56%,1
彰化縣,埔心鄉,0713,191,547,738,39,777,1248,62.26%,15.3%,1
彰化縣,埔心鄉,0714,217,527,744,60,804,1248,64.42%,17.39%,1
彰化縣,埔心鄉,0715,163,373,536,31,567,916,61.9%,17.79%,1
彰化縣,埔心鄉,0716,134,256,390,22,412,625,65.92%,21.44%,1
彰化縣,埔心鄉,0717,205,479,684,50,734,1271,57.75%,16.13%,1
彰化縣,埔心鄉,0718,103,264,367,26,393,608,64.64%,16.94%,1
彰化縣,埔心鄉,0719,181,492,673,59,732,1132,64.66%,15.99%,1
彰化縣,埔心鄉,0720,159,435,594,38,632,1027,61.54%,15.48%,1
彰化縣,埔心鄉,0721,162,390,552,35,587,926,63.39%,17.49%,1
彰化縣,埔心鄉,0722,109,318,427,55,482,778,61.95%,14.01%,1
彰化縣,埔心鄉,0723,105,296,401,30,431,660,65.3%,15.91%,1
彰化縣,埔心鄉,0724,204,574,778,40,818,1330,61.5%,15.34%,1
彰化縣,埔心鄉,0725,179,386,565,24,589,991,59.43%,18.06%,1
彰化縣,埔心鄉,0726,172,406,578,33,611,985,62.03%,17.46%,1
彰化縣,埔心鄉,0727,179,380,559,34,593,1034,57.35%,17.31%,1
彰化縣,埔心鄉,0728,105,259,364,35,399,612,65.2%,17.16%,1
彰化縣,埔心鄉,0729,194,546,740,46,786,1236,63.59%,15.7%,1
彰化縣,埔心鄉,0730,33,427,460,32,492,775,63.48%,4.26%,1
彰化縣,埔心鄉,0731,133,332,465,32,497,738,67.34%,18.02%,1
彰化縣,埔心鄉,0732,197,413,610,30,640,1036,61.78%,19.02%,1
彰化縣,埔心鄉,0733,160,359,519,44,563,975,57.74%,16.41%,1
彰化縣,埔心鄉,0734,143,344,487,26,513,885,57.97%,16.16%,1
彰化縣,埔心鄉,0735,164,382,546,47,593,939,63.15%,17.47%,1
彰化縣,埔心鄉,0736,70,324,394,13,407,689,59.07%,10.16%,1
彰化縣,埔心鄉,0737,88,295,383,26,409,659,62.06%,13.35%,1
彰化縣,埔心鄉,0738,142,328,470,26,496,910,54.51%,15.6%,1
彰化縣,埔心鄉,0739,245,588,833,60,893,1352,66.05%,18.12%,1
彰化縣,埔心鄉,0740,131,281,412,30,442,759,58.23%,17.26%,1
彰化縣,埔心鄉,0741,352,176,528,41,569,942,60.4%,37.37%,1
彰化縣,永靖鄉,0606,160,447,607,55,662,1255,52.75%,12.75%,1
彰化縣,永靖鄉,0607,146,361,507,42,549,889,61.75%,16.42%,1
彰化縣,永靖鄉,0608,149,399,548,30,578,1026,56.34%,14.52%,1
彰化縣,永靖鄉,0609,108,301,409,41,450,724,62.15%,14.92%,1
彰化縣,永靖鄉,0610,511,0,511,43,554,924,59.96%,55.3%,1
彰化縣,永靖鄉,0611,119,270,389,32,421,659,63.88%,18.06%,1
彰化縣,永靖鄉,0612,143,272,415,19,434,734,59.13%,19.48%,1
彰化縣,永靖鄉,0613,114,253,367,7,374,758,49.34%,15.04%,1
彰化縣,永靖鄉,0614,132,383,515,36,551,848,64.98%,15.57%,1
彰化縣,永靖鄉,0615,192,491,683,78,761,1404,54.2%,13.68%,1
彰化縣,永靖鄉,0616,159,360,519,29,548,792,69.19%,20.08%,1
彰化縣,永靖鄉,0617,148,270,418,28,446,695,64.17%,21.29%,1
彰化縣,永靖鄉,0618,134,354,488,21,509,821,62%,16.32%,1
彰化縣,永靖鄉,0619,176,439,615,53,668,1064,62.78%,16.54%,1
彰化縣,永靖鄉,0620,139,321,460,28,488,840,58.1%,16.55%,1
彰化縣,永靖鄉,0621,174,458,632,33,665,1079,61.63%,16.13%,1
彰化縣,永靖鄉,0622,193,427,620,35,655,1048,62.5%,18.42%,1
彰化縣,永靖鄉,0623,151,433,584,28,612,960,63.75%,15.73%,1
彰化縣,永靖鄉,0624,148,322,470,28,498,798,62.41%,18.55%,1
彰化縣,永靖鄉,0625,137,355,492,37,529,796,66.46%,17.21%,1
彰化縣,永靖鄉,0626,100,255,355,31,386,662,58.31%,15.11%,1
彰化縣,永靖鄉,0627,157,412,569,40,609,1040,58.56%,15.1%,1
彰化縣,永靖鄉,0628,165,395,560,27,587,1025,57.27%,16.1%,1
彰化縣,永靖鄉,0629,230,612,842,38,880,1357,64.85%,16.95%,1
彰化縣,永靖鄉,0630,207,505,712,41,753,1236,60.92%,16.75%,1
彰化縣,永靖鄉,0631,142,351,493,30,523,871,60.05%,16.3%,1
彰化縣,永靖鄉,0632,89,265,354,33,387,706,54.82%,12.61%,1
彰化縣,永靖鄉,0633,138,324,462,27,489,770,63.51%,17.92%,1
彰化縣,永靖鄉,0634,104,316,420,19,439,669,65.62%,15.55%,1
彰化縣,永靖鄉,0635,107,340,447,50,497,862,57.66%,12.41%,1
彰化縣,永靖鄉,0636,118,333,451,26,477,847,56.32%,13.93%,1
彰化縣,永靖鄉,0637,107,278,385,44,429,668,64.22%,16.02%,1
彰化縣,永靖鄉,0638,138,413,551,24,575,1073,53.59%,12.86%,1
彰化縣,永靖鄉,0639,177,445,622,50,672,1339,50.19%,13.22%,1
彰化縣,社頭鄉,0778,136,297,433,34,467,791,59.04%,17.19%,1
彰化縣,社頭鄉,0779,146,386,532,32,564,984,57.32%,14.84%,1
彰化縣,社頭鄉,0780,132,383,515,19,534,990,53.94%,13.33%,1
彰化縣,社頭鄉,0781,171,425,596,36,632,1016,62.2%,16.83%,1
彰化縣,社頭鄉,0782,187,436,623,36,659,1091,60.4%,17.14%,1
彰化縣,社頭鄉,0783,221,473,694,49,743,1236,60.11%,17.88%,1
彰化縣,社頭鄉,0784,187,462,649,26,675,1203,56.11%,15.54%,1
彰化縣,社頭鄉,0785,114,290,404,23,427,753,56.71%,15.14%,1
彰化縣,社頭鄉,0786,98,256,354,33,387,725,53.38%,13.52%,1
彰化縣,社頭鄉,0787,169,401,570,54,624,1023,61%,16.52%,1
彰化縣,社頭鄉,0788,131,233,364,20,384,562,68.33%,23.31%,1
彰化縣,社頭鄉,0789,147,410,557,32,589,1049,56.15%,14.01%,1
彰化縣,社頭鄉,0790,136,399,535,26,561,933,60.13%,14.58%,1
彰化縣,社頭鄉,0791,165,400,565,40,605,990,61.11%,16.67%,1
彰化縣,社頭鄉,0792,149,401,550,32,582,1076,54.09%,13.85%,1
彰化縣,社頭鄉,0793,117,326,443,11,454,742,61.19%,15.77%,1
彰化縣,社頭鄉,0794,91,264,355,21,376,672,55.95%,13.54%,1
彰化縣,社頭鄉,0795,148,445,593,35,628,1235,50.85%,11.98%,1
彰化縣,社頭鄉,0796,135,282,417,36,453,750,60.4%,18%,1
彰化縣,社頭鄉,0797,134,324,458,29,487,895,54.41%,14.97%,1
彰化縣,社頭鄉,0798,114,275,389,16,405,688,58.87%,16.57%,1
彰化縣,社頭鄉,0799,124,337,461,29,490,870,56.32%,14.25%,1
彰化縣,社頭鄉,0800,193,462,655,26,681,1140,59.74%,16.93%,1
彰化縣,社頭鄉,0801,141,403,544,38,582,985,59.09%,14.31%,1
彰化縣,社頭鄉,0802,186,556,742,47,789,1266,62.32%,14.69%,1
彰化縣,社頭鄉,0803,152,377,529,26,555,937,59.23%,16.22%,1
彰化縣,社頭鄉,0804,166,490,656,35,691,1219,56.69%,13.62%,1
彰化縣,社頭鄉,0805,178,446,624,46,670,1165,57.51%,15.28%,1
彰化縣,社頭鄉,0806,161,381,542,48,590,986,59.84%,16.33%,1
彰化縣,社頭鄉,0807,115,316,431,27,458,724,63.26%,15.88%,1
彰化縣,社頭鄉,0808,127,436,563,28,591,1015,58.23%,12.51%,1
彰化縣,社頭鄉,0809,153,392,545,27,572,1116,51.25%,13.71%,1
彰化縣,社頭鄉,0810,151,388,539,36,575,1061,54.19%,14.23%,1
彰化縣,社頭鄉,0811,164,396,560,40,600,992,60.48%,16.53%,1
彰化縣,社頭鄉,0812,180,414,594,22,616,1092,56.41%,16.48%,1
彰化縣,社頭鄉,0813,133,340,473,37,510,828,61.59%,16.06%,1
彰化縣,社頭鄉,0814,121,258,379,45,424,787,53.88%,15.37%,1
彰化縣,社頭鄉,0815,86,248,334,26,360,719,50.07%,11.96%,1
彰化縣,二水鄉,0816,171,389,560,48,608,1028,59.14%,16.63%,1
彰化縣,二水鄉,0817,90,299,389,44,433,689,62.84%,13.06%,1
彰化縣,二水鄉,0818,115,314,429,45,474,871,54.42%,13.2%,1
彰化縣,二水鄉,0819,132,389,521,45,566,953,59.39%,13.85%,1
彰化縣,二水鄉,0820,76,225,301,41,342,624,54.81%,12.18%,1
彰化縣,二水鄉,0821,112,280,392,37,429,645,66.51%,17.36%,1
彰化縣,二水鄉,0822,139,461,600,45,645,986,65.42%,14.1%,1
彰化縣,二水鄉,0823,165,404,569,55,624,943,66.17%,17.5%,1
彰化縣,二水鄉,0824,66,209,275,10,285,455,62.64%,14.51%,1
彰化縣,二水鄉,0825,152,385,537,21,558,831,67.15%,18.29%,1
彰化縣,二水鄉,0826,125,349,474,36,510,831,61.37%,15.04%,1
彰化縣,二水鄉,0827,153,403,556,21,577,1013,56.96%,15.1%,1
彰化縣,二水鄉,0828,129,325,454,51,505,796,63.44%,16.21%,1
彰化縣,二水鄉,0829,306,98,404,52,456,781,58.39%,39.18%,1
彰化縣,二水鄉,0830,100,239,339,21,360,692,52.02%,14.45%,1
彰化縣,二水鄉,0831,98,250,348,26,374,635,58.9%,15.43%,1
彰化縣,二水鄉,0832,81,214,295,33,328,566,57.95%,14.31%,1
彰化縣,北斗鎮,0833,128,350,478,44,522,925,56.43%,13.84%,1
彰化縣,北斗鎮,0834,146,338,484,45,529,869,60.87%,16.8%,1
彰化縣,北斗鎮,0835,142,380,522,31,553,855,64.68%,16.61%,1
彰化縣,北斗鎮,0836,178,458,636,35,671,1065,63%,16.71%,1
彰化縣,北斗鎮,0837,100,371,471,39,510,828,61.59%,12.08%,1
彰化縣,北斗鎮,0838,169,465,634,40,674,1124,59.96%,15.04%,1
彰化縣,北斗鎮,0839,196,440,636,37,673,1096,61.41%,17.88%,1
彰化縣,北斗鎮,0840,184,494,678,34,712,1213,58.7%,15.17%,1
彰化縣,北斗鎮,0841,158,427,585,61,646,1164,55.5%,13.57%,1
彰化縣,北斗鎮,0842,117,277,394,21,415,730,56.85%,16.03%,1
彰化縣,北斗鎮,0843,114,354,468,25,493,878,56.15%,12.98%,1
彰化縣,北斗鎮,0844,121,365,486,28,514,833,61.7%,14.53%,1
彰化縣,北斗鎮,0845,177,368,545,23,568,957,59.35%,18.5%,1
彰化縣,北斗鎮,0846,119,295,414,26,440,783,56.19%,15.2%,1
彰化縣,北斗鎮,0847,95,198,293,27,320,573,55.85%,16.58%,1
彰化縣,北斗鎮,0848,111,258,369,21,390,672,58.04%,16.52%,1
彰化縣,北斗鎮,0849,123,222,345,36,381,695,54.82%,17.7%,1
彰化縣,北斗鎮,0850,94,280,374,29,403,747,53.95%,12.58%,1
彰化縣,北斗鎮,0851,116,281,397,14,411,643,63.92%,18.04%,1
彰化縣,北斗鎮,0852,101,267,368,33,401,662,60.57%,15.26%,1
彰化縣,北斗鎮,0853,173,478,651,44,695,1085,64.06%,15.94%,1
彰化縣,北斗鎮,0854,174,441,615,56,671,1121,59.86%,15.52%,1
彰化縣,北斗鎮,0855,136,346,482,28,510,830,61.45%,16.39%,1
彰化縣,北斗鎮,0856,145,374,519,25,544,975,55.79%,14.87%,1
彰化縣,北斗鎮,0857,202,429,631,31,662,1212,54.62%,16.67%,1
彰化縣,北斗鎮,0858,210,528,738,44,782,1302,60.06%,16.13%,1
彰化縣,北斗鎮,0859,138,368,506,39,545,1077,50.6%,12.81%,1
彰化縣,北斗鎮,0860,330,127,457,48,505,917,55.07%,35.99%,1
彰化縣,北斗鎮,0861,122,323,445,20,465,825,56.36%,14.79%,1
彰化縣,北斗鎮,0862,149,375,524,35,559,937,59.66%,15.9%,1
彰化縣,二林鎮,0942,71,223,294,22,316,731,43.23%,9.71%,1
彰化縣,二林鎮,0943,146,405,551,38,589,1025,57.46%,14.24%,1
彰化縣,二林鎮,0944,120,317,437,16,453,784,57.78%,15.31%,1
彰化縣,二林鎮,0945,142,344,486,33,519,892,58.18%,15.92%,1
彰化縣,二林鎮,0946,216,469,685,39,724,1256,57.64%,17.2%,1
彰化縣,二林鎮,0947,138,389,527,45,572,1043,54.84%,13.23%,1
彰化縣,二林鎮,0948,197,421,618,31,649,1076,60.32%,18.31%,1
彰化縣,二林鎮,0949,151,447,598,39,637,1082,58.87%,13.96%,1
彰化縣,二林鎮,0950,206,527,733,43,776,1427,54.38%,14.44%,1
彰化縣,二林鎮,0951,145,337,482,49,531,1030,51.55%,14.08%,1
彰化縣,二林鎮,0952,150,345,495,47,542,1033,52.47%,14.52%,1
彰化縣,二林鎮,0953,124,356,480,49,529,977,54.15%,12.69%,1
彰化縣,二林鎮,0954,84,242,326,26,352,683,51.54%,12.3%,1
彰化縣,二林鎮,0955,108,342,450,63,513,975,52.62%,11.08%,1
彰化縣,二林鎮,0956,161,393,554,52,606,1336,45.36%,12.05%,1
彰化縣,二林鎮,0957,128,314,442,42,484,1019,47.5%,12.56%,1
彰化縣,二林鎮,0958,100,302,402,52,454,1003,45.26%,9.97%,1
彰化縣,二林鎮,0959,127,485,612,37,649,1151,56.39%,11.03%,1
彰化縣,二林鎮,0960,237,600,837,75,912,1598,57.07%,14.83%,1
彰化縣,二林鎮,0961,207,546,753,47,800,1488,53.76%,13.91%,1
彰化縣,二林鎮,0962,274,686,960,45,1005,1771,56.75%,15.47%,1
彰化縣,二林鎮,0963,154,389,543,41,584,1360,42.94%,11.32%,1
彰化縣,二林鎮,0964,171,527,698,57,755,1613,46.81%,10.6%,1
彰化縣,二林鎮,0965,159,418,577,62,639,1228,52.04%,12.95%,1
彰化縣,二林鎮,0966,102,325,427,18,445,771,57.72%,13.23%,1
彰化縣,二林鎮,0967,138,328,466,38,504,858,58.74%,16.08%,1
彰化縣,二林鎮,0968,74,225,299,0,299,661,45.23%,11.2%,1
彰化縣,二林鎮,0969,148,415,563,72,635,1268,50.08%,11.67%,1
彰化縣,二林鎮,0970,128,390,518,19,537,1081,49.68%,11.84%,1
彰化縣,二林鎮,0971,157,417,574,24,598,1213,49.3%,12.94%,1
彰化縣,二林鎮,0972,184,515,699,41,740,1328,55.72%,13.86%,1
彰化縣,二林鎮,0973,106,356,462,72,534,1118,47.76%,9.48%,1
彰化縣,二林鎮,0974,128,359,487,47,534,1157,46.15%,11.06%,1
彰化縣,二林鎮,0975,101,352,453,26,479,972,49.28%,10.39%,1
彰化縣,二林鎮,0976,135,321,456,33,489,902,54.21%,14.97%,1
彰化縣,二林鎮,0977,170,591,761,46,807,1273,63.39%,13.35%,1
彰化縣,二林鎮,0978,138,413,551,23,574,1087,52.81%,12.7%,1
彰化縣,二林鎮,0979,135,397,532,59,591,987,59.88%,13.68%,1
彰化縣,二林鎮,0980,94,226,320,20,340,719,47.29%,13.07%,1
彰化縣,田尾鄉,0863,184,447,631,41,672,1284,52.34%,14.33%,1
彰化縣,田尾鄉,0864,176,498,674,54,728,1187,61.33%,14.83%,1
彰化縣,田尾鄉,0865,178,427,605,30,635,1033,61.47%,17.23%,1
彰化縣,田尾鄉,0866,88,300,388,38,426,696,61.21%,12.64%,1
彰化縣,田尾鄉,0867,146,370,516,27,543,872,62.27%,16.74%,1
彰化縣,田尾鄉,0868,83,269,352,18,370,680,54.41%,12.21%,1
彰化縣,田尾鄉,0869,180,350,530,27,557,875,63.66%,20.57%,1
彰化縣,田尾鄉,0870,208,487,695,35,730,1337,54.6%,15.56%,1
彰化縣,田尾鄉,0871,235,567,802,43,845,1376,61.41%,17.08%,1
彰化縣,田尾鄉,0872,175,519,694,44,738,1186,62.23%,14.76%,1
彰化縣,田尾鄉,0873,144,420,564,43,607,874,69.45%,16.48%,1
彰化縣,田尾鄉,0874,84,258,342,25,367,647,56.72%,12.98%,1
彰化縣,田尾鄉,0875,99,447,546,28,574,959,59.85%,10.32%,1
彰化縣,田尾鄉,0876,31,104,135,9,144,263,54.75%,11.79%,1
彰化縣,田尾鄉,0877,81,230,311,24,335,618,54.21%,13.11%,1
彰化縣,田尾鄉,0878,181,392,573,25,598,938,63.75%,19.3%,1
彰化縣,田尾鄉,0879,138,384,522,41,563,880,63.98%,15.68%,1
彰化縣,田尾鄉,0880,120,287,407,21,428,804,53.23%,14.93%,1
彰化縣,田尾鄉,0881,105,199,304,25,329,592,55.57%,17.74%,1
彰化縣,田尾鄉,0882,174,449,623,62,685,1079,63.48%,16.13%,1
彰化縣,田尾鄉,0883,222,515,737,43,780,1336,58.38%,16.62%,1
彰化縣,田尾鄉,0884,175,435,610,41,651,1198,54.34%,14.61%,1
彰化縣,田尾鄉,0885,95,227,322,32,354,621,57%,15.3%,1
彰化縣,田尾鄉,0886,117,271,388,23,411,760,54.08%,15.39%,1
彰化縣,田尾鄉,0887,185,454,639,62,701,1084,64.67%,17.07%,1
彰化縣,埤頭鄉,0888,152,369,521,59,580,1178,49.24%,12.9%,1
彰化縣,埤頭鄉,0889,111,546,657,32,689,1290,53.41%,8.6%,1
彰化縣,埤頭鄉,0890,152,329,481,52,533,973,54.78%,15.62%,1
彰化縣,埤頭鄉,0891,108,289,397,26,423,783,54.02%,13.79%,1
彰化縣,埤頭鄉,0892,107,269,376,43,419,733,57.16%,14.6%,1
彰化縣,埤頭鄉,0893,145,316,461,66,527,899,58.62%,16.13%,1
彰化縣,埤頭鄉,0894,125,368,493,51,544,965,56.37%,12.95%,1
彰化縣,埤頭鄉,0895,151,504,655,56,711,1356,52.43%,11.14%,1
彰化縣,埤頭鄉,0896,186,435,621,68,689,1265,54.47%,14.7%,1
彰化縣,埤頭鄉,0897,134,360,494,48,542,877,61.8%,15.28%,1
彰化縣,埤頭鄉,0898,105,240,345,37,382,705,54.18%,14.89%,1
彰化縣,埤頭鄉,0899,169,447,616,39,655,1062,61.68%,15.91%,1
彰化縣,埤頭鄉,0900,214,489,703,50,753,1300,57.92%,16.46%,1
彰化縣,埤頭鄉,0901,125,363,488,52,540,923,58.5%,13.54%,1
彰化縣,埤頭鄉,0902,151,381,532,24,556,1085,51.24%,13.92%,1
彰化縣,埤頭鄉,0903,165,436,601,53,654,1103,59.29%,14.96%,1
彰化縣,埤頭鄉,0904,93,267,360,21,381,735,51.84%,12.65%,1
彰化縣,埤頭鄉,0905,82,198,280,36,316,574,55.05%,14.29%,1
彰化縣,埤頭鄉,0906,78,269,347,39,386,767,50.33%,10.17%,1
彰化縣,埤頭鄉,0907,95,274,369,41,410,737,55.63%,12.89%,1
彰化縣,埤頭鄉,0908,145,307,452,54,506,1058,47.83%,13.71%,1
彰化縣,埤頭鄉,0909,101,271,372,57,429,826,51.94%,12.23%,1
彰化縣,埤頭鄉,0910,341,134,475,72,547,1082,50.55%,31.52%,1
彰化縣,埤頭鄉,0911,89,313,402,44,446,737,60.52%,12.08%,1
彰化縣,埤頭鄉,0912,80,276,356,21,377,711,53.02%,11.25%,1
彰化縣,埤頭鄉,0913,181,352,533,59,592,1043,56.76%,17.35%,1
彰化縣,埤頭鄉,0914,112,328,440,27,467,910,51.32%,12.31%,1
彰化縣,芳苑鄉,0998,92,209,301,34,335,940,35.64%,9.79%,1
彰化縣,芳苑鄉,0999,39,104,143,19,162,403,40.2%,9.68%,1
彰化縣,芳苑鄉,1000,80,266,346,30,376,756,49.74%,10.58%,1
彰化縣,芳苑鄉,1001,51,105,156,22,178,548,32.48%,9.31%,1
彰化縣,芳苑鄉,1002,108,360,468,52,520,997,52.16%,10.83%,1
彰化縣,芳苑鄉,1003,166,369,535,55,590,1300,45.38%,12.77%,1
彰化縣,芳苑鄉,1004,108,300,408,35,443,859,51.57%,12.57%,1
彰化縣,芳苑鄉,1005,90,255,345,16,361,734,49.18%,12.26%,1
彰化縣,芳苑鄉,1006,75,206,281,24,305,636,47.96%,11.79%,1
彰化縣,芳苑鄉,1007,88,231,319,55,374,808,46.29%,10.89%,1
彰化縣,芳苑鄉,1008,74,182,256,39,295,668,44.16%,11.08%,1
彰化縣,芳苑鄉,1009,110,219,329,24,353,744,47.45%,14.78%,1
彰化縣,芳苑鄉,1010,115,296,411,76,487,1026,47.47%,11.21%,1
彰化縣,芳苑鄉,1011,57,168,225,8,233,586,39.76%,9.73%,1
彰化縣,芳苑鄉,1012,66,225,291,24,315,593,53.12%,11.13%,1
彰化縣,芳苑鄉,1013,132,380,512,67,579,1071,54.06%,12.32%,1
彰化縣,芳苑鄉,1014,120,369,489,66,555,1060,52.36%,11.32%,1
彰化縣,芳苑鄉,1015,79,266,345,21,366,708,51.69%,11.16%,1
彰化縣,芳苑鄉,1016,88,227,315,48,363,735,49.39%,11.97%,1
彰化縣,芳苑鄉,1017,74,222,296,37,333,571,58.32%,12.96%,1
彰化縣,芳苑鄉,1018,73,220,293,26,319,729,43.76%,10.01%,1
彰化縣,芳苑鄉,1019,87,223,310,41,351,674,52.08%,12.91%,1
彰化縣,芳苑鄉,1020,103,293,396,37,433,846,51.18%,12.17%,1
彰化縣,芳苑鄉,1021,110,326,436,33,469,806,58.19%,13.65%,1
彰化縣,芳苑鄉,1022,46,125,171,11,182,470,38.72%,9.79%,1
彰化縣,芳苑鄉,1023,123,443,566,49,615,1124,54.72%,10.94%,1
彰化縣,芳苑鄉,1024,36,105,141,11,152,317,47.95%,11.36%,1
彰化縣,芳苑鄉,1025,102,373,475,50,525,1158,45.34%,8.81%,1
彰化縣,芳苑鄉,1026,120,322,442,26,468,967,48.4%,12.41%,1
彰化縣,芳苑鄉,1027,98,281,379,30,409,762,53.67%,12.86%,1
彰化縣,芳苑鄉,1028,100,339,439,41,480,1086,44.2%,9.21%,1
彰化縣,芳苑鄉,1029,85,261,346,21,367,747,49.13%,11.38%,1
彰化縣,芳苑鄉,1030,62,187,249,17,266,653,40.74%,9.49%,1
彰化縣,芳苑鄉,1031,111,368,479,35,514,872,58.94%,12.73%,1
彰化縣,芳苑鄉,1032,100,600,700,45,745,1235,60.32%,8.1%,1
彰化縣,芳苑鄉,1033,134,421,555,42,597,1102,54.17%,12.16%,1
彰化縣,大城鄉,0981,93,346,439,24,463,1288,35.95%,7.22%,1
彰化縣,大城鄉,0982,98,269,367,61,428,1104,38.77%,8.88%,1
彰化縣,大城鄉,0983,119,361,480,57,537,964,55.71%,12.34%,1
彰化縣,大城鄉,0984,132,434,566,41,607,1312,46.27%,10.06%,1
彰化縣,大城鄉,0985,80,249,329,38,367,853,43.02%,9.38%,1
彰化縣,大城鄉,0986,34,134,168,15,183,518,35.33%,6.56%,1
彰化縣,大城鄉,0987,65,163,228,23,251,574,43.73%,11.32%,1
彰化縣,大城鄉,0988,59,181,240,30,270,702,38.46%,8.4%,1
彰化縣,大城鄉,0989,29,79,108,12,120,376,31.91%,7.71%,1
彰化縣,大城鄉,0990,33,161,194,21,215,693,31.02%,4.76%,1
彰化縣,大城鄉,0991,80,264,344,41,385,877,43.9%,9.12%,1
彰化縣,大城鄉,0992,50,147,197,12,209,655,31.91%,7.63%,1
彰化縣,大城鄉,0993,91,305,396,18,414,1103,37.53%,8.25%,1
彰化縣,大城鄉,0994,102,289,391,25,416,1192,34.9%,8.56%,1
彰化縣,大城鄉,0995,76,250,326,35,361,917,39.37%,8.29%,1
彰化縣,大城鄉,0996,52,156,208,21,229,686,33.38%,7.58%,1
彰化縣,大城鄉,0997,75,202,277,21,298,899,33.15%,8.34%,1
彰化縣,竹塘鄉,1034,167,447,614,58,672,1168,57.53%,14.3%,1
彰化縣,竹塘鄉,1035,130,417,547,23,570,965,59.07%,13.47%,1
彰化縣,竹塘鄉,1036,146,417,563,37,600,960,62.5%,15.21%,1
彰化縣,竹塘鄉,1037,125,302,427,54,481,743,64.74%,16.82%,1
彰化縣,竹塘鄉,1038,92,219,311,29,340,751,45.27%,12.25%,1
彰化縣,竹塘鄉,1039,77,269,346,38,384,792,48.48%,9.72%,1
彰化縣,竹塘鄉,1040,97,238,335,14,349,733,47.61%,13.23%,1
彰化縣,竹塘鄉,1041,87,238,325,30,355,657,54.03%,13.24%,1
彰化縣,竹塘鄉,1042,135,380,515,35,550,1063,51.74%,12.7%,1
彰化縣,竹塘鄉,1043,145,438,583,57,640,1114,57.45%,13.02%,1
彰化縣,竹塘鄉,1044,85,230,315,29,344,506,67.98%,16.8%,1
彰化縣,竹塘鄉,1045,114,276,390,36,426,823,51.76%,13.85%,1
彰化縣,竹塘鄉,1046,71,251,322,19,341,654,52.14%,10.86%,1
彰化縣,竹塘鄉,1047,70,170,240,19,259,577,44.89%,12.13%,1
彰化縣,竹塘鄉,1048,101,261,362,47,409,772,52.98%,13.08%,1
彰化縣,竹塘鄉,1049,66,160,226,26,252,543,46.41%,12.15%,1
彰化縣,溪州鄉,0915,102,292,394,37,431,778,55.4%,13.11%,1
彰化縣,溪州鄉,0916,131,367,498,29,527,1061,49.67%,12.35%,1
彰化縣,溪州鄉,0917,77,231,308,32,340,701,48.5%,10.98%,1
彰化縣,溪州鄉,0918,143,351,494,40,534,879,60.75%,16.27%,1
彰化縣,溪州鄉,0919,105,289,394,36,430,654,65.75%,16.06%,1
彰化縣,溪州鄉,0920,125,346,471,34,505,878,57.52%,14.24%,1
彰化縣,溪州鄉,0921,127,407,534,43,577,942,61.25%,13.48%,1
彰化縣,溪州鄉,0922,154,298,452,32,484,871,55.57%,17.68%,1
彰化縣,溪州鄉,0923,362,154,516,20,536,1047,51.19%,34.57%,1
彰化縣,溪州鄉,0924,128,340,468,40,508,858,59.21%,14.92%,1
彰化縣,溪州鄉,0925,171,424,595,58,653,1409,46.34%,12.14%,1
彰化縣,溪州鄉,0926,106,294,400,16,416,792,52.53%,13.38%,1
彰化縣,溪州鄉,0927,94,243,337,49,386,714,54.06%,13.17%,1
彰化縣,溪州鄉,0928,122,370,492,50,542,1109,48.87%,11%,1
彰化縣,溪州鄉,0929,110,292,402,37,439,962,45.63%,11.43%,1
彰化縣,溪州鄉,0930,136,345,481,51,532,1157,45.98%,11.75%,1
彰化縣,溪州鄉,0931,126,330,456,35,491,952,51.58%,13.24%,1
彰化縣,溪州鄉,0932,136,307,443,33,476,887,53.66%,15.33%,1
彰化縣,溪州鄉,0933,102,236,338,43,381,866,44%,11.78%,1
彰化縣,溪州鄉,0934,116,319,435,55,490,1010,48.51%,11.49%,1
彰化縣,溪州鄉,0935,102,303,405,18,423,853,49.59%,11.96%,1
彰化縣,溪州鄉,0936,124,270,394,51,445,843,52.79%,14.71%,1
彰化縣,溪州鄉,0937,81,178,259,12,271,711,38.12%,11.39%,1
彰化縣,溪州鄉,0938,123,288,411,59,470,851,55.23%,14.45%,1
彰化縣,溪州鄉,0939,304,113,417,26,443,883,50.17%,34.43%,1
彰化縣,溪州鄉,0940,126,428,554,55,609,1247,48.84%,10.1%,1
彰化縣,溪州鄉,0941,253,514,767,63,830,1490,55.7%,16.98%,1
南投縣,南投市,0001,173,352,525,29,554,927,59.76%,18.66%,1
南投縣,南投市,0002,120,308,428,26,454,667,68.07%,17.99%,1
南投縣,南投市,0003,140,342,482,23,505,773,65.33%,18.11%,1
南投縣,南投市,0004,145,348,493,23,516,818,63.08%,17.73%,1
南投縣,南投市,0005,108,230,338,19,357,525,68%,20.57%,1
南投縣,南投市,0006,97,263,360,28,388,575,67.48%,16.87%,1
南投縣,南投市,0007,80,162,242,12,254,368,69.02%,21.74%,1
南投縣,南投市,0008,141,448,589,44,633,956,66.21%,14.75%,1
南投縣,南投市,0009,186,459,645,23,668,1245,53.65%,14.94%,1
南投縣,南投市,0010,243,600,843,24,867,1484,58.42%,16.37%,1
南投縣,南投市,0011,193,558,751,30,781,1191,65.58%,16.2%,1
南投縣,南投市,0012,255,616,871,45,916,1506,60.82%,16.93%,1
南投縣,南投市,0013,190,462,652,28,680,1070,63.55%,17.76%,1
南投縣,南投市,0014,112,295,407,20,427,670,63.73%,16.72%,1
南投縣,南投市,0015,201,454,655,44,699,1050,66.57%,19.14%,1
南投縣,南投市,0016,162,413,575,36,611,1122,54.46%,14.44%,1
南投縣,南投市,0017,156,374,530,28,558,984,56.71%,15.85%,1
南投縣,南投市,0018,196,479,675,31,706,1062,66.48%,18.46%,1
南投縣,南投市,0019,145,455,600,46,646,1053,61.35%,13.77%,1
南投縣,南投市,0020,208,459,667,35,702,1104,63.59%,18.84%,1
南投縣,南投市,0021,200,458,658,35,693,1192,58.14%,16.78%,1
南投縣,南投市,0022,137,389,526,33,559,960,58.23%,14.27%,1
南投縣,南投市,0023,153,376,529,30,559,906,61.7%,16.89%,1
南投縣,南投市,0024,174,393,567,31,598,957,62.49%,18.18%,1
南投縣,南投市,0025,158,450,608,43,651,997,65.3%,15.85%,1
南投縣,南投市,0026,186,413,599,30,629,1008,62.4%,18.45%,1
南投縣,南投市,0027,219,444,663,21,684,1164,58.76%,18.81%,1
南投縣,南投市,0028,90,232,322,27,349,587,59.45%,15.33%,1
南投縣,南投市,0029,118,266,384,31,415,734,56.54%,16.08%,1
南投縣,南投市,0030,113,277,390,40,430,724,59.39%,15.61%,1
南投縣,南投市,0031,145,432,577,25,602,1003,60.02%,14.46%,1
南投縣,南投市,0032,215,528,743,47,790,1356,58.26%,15.86%,1
南投縣,南投市,0033,233,492,725,44,769,1373,56.01%,16.97%,1
南投縣,南投市,0034,226,562,788,30,818,1452,56.34%,15.56%,1
南投縣,南投市,0035,40,162,202,8,210,362,58.01%,11.05%,1
南投縣,南投市,0036,51,160,211,24,235,389,60.41%,13.11%,1
南投縣,南投市,0037,228,561,789,41,830,1276,65.05%,17.87%,1
南投縣,南投市,0038,205,474,679,29,708,1089,65.01%,18.82%,1
南投縣,南投市,0039,174,375,549,44,593,921,64.39%,18.89%,1
南投縣,南投市,0040,168,413,581,21,602,892,67.49%,18.83%,1
南投縣,南投市,0041,180,487,667,24,691,1050,65.81%,17.14%,1
南投縣,南投市,0042,181,481,662,20,682,1078,63.27%,16.79%,1
南投縣,南投市,0043,164,479,643,25,668,1078,61.97%,15.21%,1
南投縣,南投市,0044,177,417,594,29,623,861,72.36%,20.56%,1
南投縣,南投市,0045,165,519,684,52,736,1221,60.28%,13.51%,1
南投縣,南投市,0046,186,451,637,23,660,1105,59.73%,16.83%,1
南投縣,南投市,0047,203,533,736,20,756,1230,61.46%,16.5%,1
南投縣,南投市,0048,172,473,645,30,675,1092,61.81%,15.75%,1
南投縣,南投市,0049,227,572,799,22,821,1286,63.84%,17.65%,1
南投縣,南投市,0050,121,302,423,30,453,655,69.16%,18.47%,1
南投縣,南投市,0051,129,323,452,23,475,719,66.06%,17.94%,1
南投縣,南投市,0052,130,276,406,24,430,720,59.72%,18.06%,1
南投縣,南投市,0053,67,264,331,13,344,509,67.58%,13.16%,1
南投縣,南投市,0054,39,226,265,15,280,492,56.91%,7.93%,1
南投縣,南投市,0055,67,297,364,11,375,616,60.88%,10.88%,1
南投縣,南投市,0056,133,485,618,22,640,1010,63.37%,13.17%,1
南投縣,南投市,0057,99,380,479,27,506,848,59.67%,11.67%,1
南投縣,南投市,0058,225,599,824,57,881,1387,63.52%,16.22%,1
南投縣,南投市,0059,216,549,765,43,808,1245,64.9%,17.35%,1
南投縣,南投市,0060,185,493,678,24,702,1199,58.55%,15.43%,1
南投縣,南投市,0061,212,546,758,45,803,1288,62.34%,16.46%,1
南投縣,南投市,0062,170,414,584,40,624,1040,60%,16.35%,1
南投縣,南投市,0063,176,455,631,36,667,1070,62.34%,16.45%,1
南投縣,南投市,0064,229,550,779,46,825,1299,63.51%,17.63%,1
南投縣,南投市,0065,213,522,735,32,767,1122,68.36%,18.98%,1
南投縣,南投市,0066,209,597,806,37,843,1414,59.62%,14.78%,1
南投縣,南投市,0067,174,453,627,39,666,1121,59.41%,15.52%,1
南投縣,南投市,0068,232,577,809,20,829,1434,57.81%,16.18%,1
南投縣,南投市,0069,176,559,735,38,773,1393,55.49%,12.63%,1
南投縣,南投市,0070,146,447,593,22,615,1059,58.07%,13.79%,1
南投縣,南投市,0071,171,509,680,26,706,1218,57.96%,14.04%,1
南投縣,南投市,0072,213,482,695,20,715,1293,55.3%,16.47%,1
南投縣,南投市,0073,154,491,645,32,677,1337,50.64%,11.52%,1
南投縣,南投市,0074,150,382,532,26,558,876,63.7%,17.12%,1
南投縣,南投市,0075,154,384,538,25,563,971,57.98%,15.86%,1
南投縣,南投市,0076,166,401,567,28,595,1012,58.79%,16.4%,1
南投縣,南投市,0077,122,396,518,32,550,973,56.53%,12.54%,1
南投縣,南投市,0078,171,420,591,36,627,1002,62.57%,17.07%,1
南投縣,南投市,0079,177,407,584,27,611,1024,59.67%,17.29%,1
南投縣,南投市,0080,156,351,507,85,592,1122,52.76%,13.9%,1
南投縣,南投市,0081,109,263,372,28,400,790,50.63%,13.8%,1
南投縣,南投市,0082,76,214,290,10,300,647,46.37%,11.75%,1
南投縣,南投市,0083,139,346,485,50,535,950,56.32%,14.63%,1
南投縣,南投市,0084,154,354,508,19,527,980,53.78%,15.71%,1
南投縣,埔里鎮,0085,129,338,467,35,502,828,60.63%,15.58%,1
南投縣,埔里鎮,0086,128,332,460,35,495,786,62.98%,16.28%,1
南投縣,埔里鎮,0087,125,451,576,32,608,1062,57.25%,11.77%,1
南投縣,埔里鎮,0088,194,515,709,44,753,1201,62.7%,16.15%,1
南投縣,埔里鎮,0089,185,769,954,23,977,1415,69.05%,13.07%,1
南投縣,埔里鎮,0090,179,517,696,30,726,1282,56.63%,13.96%,1
南投縣,埔里鎮,0091,106,366,472,36,508,859,59.14%,12.34%,1
南投縣,埔里鎮,0092,187,487,674,72,746,1288,57.92%,14.52%,1
南投縣,埔里鎮,0093,207,522,729,21,750,1330,56.39%,15.56%,1
南投縣,埔里鎮,0094,201,522,723,42,765,1416,54.03%,14.19%,1
南投縣,埔里鎮,0095,169,455,624,22,646,1283,50.35%,13.17%,1
南投縣,埔里鎮,0096,153,486,639,61,700,1151,60.82%,13.29%,1
南投縣,埔里鎮,0097,166,441,607,28,635,1193,53.23%,13.91%,1
南投縣,埔里鎮,0098,132,659,791,53,844,1471,57.38%,8.97%,1
南投縣,埔里鎮,0099,112,351,463,70,533,1044,51.05%,10.73%,1
南投縣,埔里鎮,0100,145,475,620,52,672,1122,59.89%,12.92%,1
南投縣,埔里鎮,0101,172,527,699,31,730,1129,64.66%,15.23%,1
南投縣,埔里鎮,0102,116,371,487,18,505,901,56.05%,12.87%,1
南投縣,埔里鎮,0103,134,370,504,41,545,997,54.66%,13.44%,1
南投縣,埔里鎮,0104,177,460,637,12,649,1209,53.68%,14.64%,1
南投縣,埔里鎮,0105,126,309,435,24,459,838,54.77%,15.04%,1
南投縣,埔里鎮,0106,158,425,583,31,614,1226,50.08%,12.89%,1
南投縣,埔里鎮,0107,214,527,741,53,794,1263,62.87%,16.94%,1
南投縣,埔里鎮,0108,182,434,616,21,637,1045,60.96%,17.42%,1
南投縣,埔里鎮,0109,178,487,665,32,697,1120,62.23%,15.89%,1
南投縣,埔里鎮,0110,185,472,657,36,693,1062,65.25%,17.42%,1
南投縣,埔里鎮,0111,156,413,569,28,597,1022,58.41%,15.26%,1
南投縣,埔里鎮,0112,155,419,574,21,595,1051,56.61%,14.75%,1
南投縣,埔里鎮,0113,161,443,604,24,628,1106,56.78%,14.56%,1
南投縣,埔里鎮,0114,155,470,625,13,638,1098,58.11%,14.12%,1
南投縣,埔里鎮,0115,158,442,600,32,632,1067,59.23%,14.81%,1
南投縣,埔里鎮,0116,274,114,388,41,429,725,59.17%,37.79%,1
南投縣,埔里鎮,0117,147,378,525,28,553,905,61.1%,16.24%,1
南投縣,埔里鎮,0118,174,429,603,42,645,1179,54.71%,14.76%,1
南投縣,埔里鎮,0119,111,361,472,26,498,944,52.75%,11.76%,1
南投縣,埔里鎮,0120,58,179,237,32,269,465,57.85%,12.47%,1
南投縣,埔里鎮,0121,155,452,607,35,642,1133,56.66%,13.68%,1
南投縣,埔里鎮,0122,148,421,569,36,605,1100,55%,13.45%,1
南投縣,埔里鎮,0123,169,457,626,45,671,1155,58.1%,14.63%,1
南投縣,埔里鎮,0124,175,445,620,55,675,1254,53.83%,13.96%,1
南投縣,埔里鎮,0125,174,483,657,43,700,1296,54.01%,13.43%,1
南投縣,埔里鎮,0126,175,456,631,33,664,1023,64.91%,17.11%,1
南投縣,埔里鎮,0127,99,375,474,15,489,964,50.73%,10.27%,1
南投縣,埔里鎮,0128,152,403,555,27,582,986,59.03%,15.42%,1
南投縣,埔里鎮,0129,153,434,587,26,613,1016,60.33%,15.06%,1
南投縣,埔里鎮,0130,135,368,503,33,536,898,59.69%,15.03%,1
南投縣,埔里鎮,0131,150,415,565,35,600,980,61.22%,15.31%,1
南投縣,埔里鎮,0132,127,411,538,22,560,933,60.02%,13.61%,1
南投縣,埔里鎮,0133,176,435,611,36,647,929,69.64%,18.95%,1
南投縣,埔里鎮,0134,149,399,548,40,588,1032,56.98%,14.44%,1
南投縣,埔里鎮,0135,32,126,158,9,167,315,53.02%,10.16%,1
南投縣,埔里鎮,0136,172,498,670,73,743,1363,54.51%,12.62%,1
南投縣,埔里鎮,0137,112,305,417,24,441,725,60.83%,15.45%,1
南投縣,埔里鎮,0138,94,309,403,24,427,705,60.57%,13.33%,1
南投縣,埔里鎮,0139,127,332,459,31,490,751,65.25%,16.91%,1
南投縣,埔里鎮,0140,136,360,496,38,534,932,57.3%,14.59%,1
南投縣,埔里鎮,0141,149,383,532,27,559,956,58.47%,15.59%,1
南投縣,埔里鎮,0142,51,153,204,19,223,376,59.31%,13.56%,1
南投縣,埔里鎮,0143,102,277,379,29,408,682,59.82%,14.96%,1
南投縣,埔里鎮,0144,67,533,600,46,646,990,65.25%,6.77%,1
南投縣,埔里鎮,0145,172,435,607,65,672,1324,50.76%,12.99%,1
南投縣,埔里鎮,0146,40,92,132,16,148,298,49.66%,13.42%,1
南投縣,埔里鎮,0147,113,484,597,57,654,1170,55.9%,9.66%,1
南投縣,埔里鎮,0148,83,259,342,19,361,604,59.77%,13.74%,1
南投縣,埔里鎮,0149,129,394,523,28,551,999,55.16%,12.91%,1
南投縣,埔里鎮,0150,219,250,469,17,486,923,52.65%,23.73%,1
南投縣,埔里鎮,0151,131,374,505,30,535,887,60.32%,14.77%,1
南投縣,埔里鎮,0152,122,383,505,29,534,981,54.43%,12.44%,1
南投縣,草屯鎮,0153,187,424,611,19,630,998,63.13%,18.74%,1
南投縣,草屯鎮,0154,183,425,608,22,630,1127,55.9%,16.24%,1
南投縣,草屯鎮,0155,203,529,732,30,762,1401,54.39%,14.49%,1
南投縣,草屯鎮,0156,168,428,596,30,626,1110,56.4%,15.14%,1
南投縣,草屯鎮,0157,170,575,745,43,788,1285,61.32%,13.23%,1
南投縣,草屯鎮,0158,131,382,513,30,543,936,58.01%,14%,1
南投縣,草屯鎮,0159,190,433,623,42,665,1141,58.28%,16.65%,1
南投縣,草屯鎮,0160,135,285,420,25,445,705,63.12%,19.15%,1
南投縣,草屯鎮,0161,221,467,688,19,707,1121,63.07%,19.71%,1
南投縣,草屯鎮,0162,153,404,557,25,582,877,66.36%,17.45%,1
南投縣,草屯鎮,0163,249,530,779,41,820,1401,58.53%,17.77%,1
南投縣,草屯鎮,0164,149,503,652,44,696,1267,54.93%,11.76%,1
南投縣,草屯鎮,0165,190,476,666,56,722,1214,59.47%,15.65%,1
南投縣,草屯鎮,0166,187,511,698,52,750,1259,59.57%,14.85%,1
南投縣,草屯鎮,0167,265,578,843,32,875,1442,60.68%,18.38%,1
南投縣,草屯鎮,0168,180,554,734,31,765,1273,60.09%,14.14%,1
南投縣,草屯鎮,0169,199,436,635,24,659,1145,57.55%,17.38%,1
南投縣,草屯鎮,0170,192,512,704,20,724,1279,56.61%,15.01%,1
南投縣,草屯鎮,0171,164,466,630,23,653,1158,56.39%,14.16%,1
南投縣,草屯鎮,0172,232,615,847,32,879,1335,65.84%,17.38%,1
南投縣,草屯鎮,0173,229,508,737,30,767,1178,65.11%,19.44%,1
南投縣,草屯鎮,0174,260,502,762,27,789,1327,59.46%,19.59%,1
南投縣,草屯鎮,0175,165,420,585,21,606,1000,60.6%,16.5%,1
南投縣,草屯鎮,0176,198,496,694,37,731,1257,58.15%,15.75%,1
南投縣,草屯鎮,0177,143,405,548,22,570,883,64.55%,16.19%,1
南投縣,草屯鎮,0178,155,444,599,23,622,1121,55.49%,13.83%,1
南投縣,草屯鎮,0179,163,428,591,30,621,1043,59.54%,15.63%,1
南投縣,草屯鎮,0180,174,417,591,14,605,979,61.8%,17.77%,1
南投縣,草屯鎮,0181,145,383,528,17,545,1048,52%,13.84%,1
南投縣,草屯鎮,0182,135,412,547,31,578,1009,57.28%,13.38%,1
南投縣,草屯鎮,0183,147,444,591,26,617,1138,54.22%,12.92%,1
南投縣,草屯鎮,0184,196,459,655,16,671,1197,56.06%,16.37%,1
南投縣,草屯鎮,0185,215,562,777,34,811,1364,59.46%,15.76%,1
南投縣,草屯鎮,0186,253,355,608,34,642,1059,60.62%,23.89%,1
南投縣,草屯鎮,0187,189,438,627,34,661,1108,59.66%,17.06%,1
南投縣,草屯鎮,0188,126,348,474,31,505,879,57.45%,14.33%,1
南投縣,草屯鎮,0189,138,390,528,40,568,957,59.35%,14.42%,1
南投縣,草屯鎮,0190,190,469,659,17,676,1395,48.46%,13.62%,1
南投縣,草屯鎮,0191,177,477,654,29,683,1101,62.03%,16.08%,1
南投縣,草屯鎮,0192,203,474,677,22,699,1297,53.89%,15.65%,1
南投縣,草屯鎮,0193,128,264,392,20,412,877,46.98%,14.6%,1
南投縣,草屯鎮,0194,192,439,631,50,681,1376,49.49%,13.95%,1
南投縣,草屯鎮,0195,166,441,607,42,649,1008,64.38%,16.47%,1
南投縣,草屯鎮,0196,174,457,631,37,668,1080,61.85%,16.11%,1
南投縣,草屯鎮,0197,153,379,532,37,569,1017,55.95%,15.04%,1
南投縣,草屯鎮,0198,146,421,567,46,613,961,63.79%,15.19%,1
南投縣,草屯鎮,0199,194,481,675,38,713,1160,61.47%,16.72%,1
南投縣,草屯鎮,0200,175,457,632,31,663,1121,59.14%,15.61%,1
南投縣,草屯鎮,0201,173,513,686,34,720,1243,57.92%,13.92%,1
南投縣,草屯鎮,0202,152,378,530,28,558,932,59.87%,16.31%,1
南投縣,草屯鎮,0203,250,576,826,39,865,1323,65.38%,18.9%,1
南投縣,草屯鎮,0204,188,584,772,31,803,1518,52.9%,12.38%,1
南投縣,草屯鎮,0205,176,369,545,42,587,923,63.6%,19.07%,1
南投縣,草屯鎮,0206,161,338,499,35,534,970,55.05%,16.6%,1
南投縣,草屯鎮,0207,182,391,573,30,603,1026,58.77%,17.74%,1
南投縣,草屯鎮,0208,246,547,793,39,832,1466,56.75%,16.78%,1
南投縣,草屯鎮,0209,180,469,649,27,676,1180,57.29%,15.25%,1
南投縣,草屯鎮,0210,175,420,595,18,613,1006,60.93%,17.4%,1
南投縣,草屯鎮,0211,142,333,475,32,507,1000,50.7%,14.2%,1
南投縣,草屯鎮,0212,214,474,688,14,702,1128,62.23%,18.97%,1
南投縣,草屯鎮,0213,106,235,341,16,357,623,57.3%,17.01%,1
南投縣,草屯鎮,0214,105,277,382,37,419,707,59.26%,14.85%,1
南投縣,草屯鎮,0215,104,262,366,27,393,719,54.66%,14.46%,1
南投縣,草屯鎮,0216,74,165,239,19,258,527,48.96%,14.04%,1
南投縣,草屯鎮,0217,199,460,659,49,708,1183,59.85%,16.82%,1
南投縣,草屯鎮,0218,145,365,510,25,535,869,61.57%,16.69%,1
南投縣,草屯鎮,0219,197,367,564,20,584,1132,51.59%,17.4%,1
南投縣,草屯鎮,0220,147,382,529,39,568,949,59.85%,15.49%,1
南投縣,草屯鎮,0221,157,401,558,26,584,965,60.52%,16.27%,1
南投縣,草屯鎮,0222,168,392,560,31,591,1068,55.34%,15.73%,1
南投縣,草屯鎮,0223,153,419,572,51,623,1024,60.84%,14.94%,1
南投縣,草屯鎮,0224,71,265,336,18,354,642,55.14%,11.06%,1
南投縣,草屯鎮,0225,132,373,505,32,537,1017,52.8%,12.98%,1
南投縣,草屯鎮,0226,143,462,605,20,625,1092,57.23%,13.1%,1
南投縣,草屯鎮,0227,167,446,613,41,654,1170,55.9%,14.27%,1
南投縣,草屯鎮,0228,160,472,632,33,665,1106,60.13%,14.47%,1
南投縣,竹山鎮,0229,174,487,661,42,703,1170,60.09%,14.87%,1
南投縣,竹山鎮,0230,136,350,486,46,532,850,62.59%,16%,1
南投縣,竹山鎮,0231,77,241,318,24,342,621,55.07%,12.4%,1
南投縣,竹山鎮,0232,146,342,488,30,518,905,57.24%,16.13%,1
南投縣,竹山鎮,0233,123,392,515,41,556,1099,50.59%,11.19%,1
南投縣,竹山鎮,0234,126,478,604,42,646,1214,53.21%,10.38%,1
南投縣,竹山鎮,0235,209,521,730,49,779,1287,60.53%,16.24%,1
南投縣,竹山鎮,0236,164,462,626,46,672,1191,56.42%,13.77%,1
南投縣,竹山鎮,0237,173,408,581,53,634,1118,56.71%,15.47%,1
南投縣,竹山鎮,0238,212,501,713,23,736,1278,57.59%,16.59%,1
南投縣,竹山鎮,0239,200,433,633,43,676,1153,58.63%,17.35%,1
南投縣,竹山鎮,0240,179,434,613,49,662,1243,53.26%,14.4%,1
南投縣,竹山鎮,0241,203,501,704,39,743,1308,56.8%,15.52%,1
南投縣,竹山鎮,0242,175,516,691,34,725,1358,53.39%,12.89%,1
南投縣,竹山鎮,0243,142,392,534,42,576,1044,55.17%,13.6%,1
南投縣,竹山鎮,0244,86,211,297,24,321,511,62.82%,16.83%,1
南投縣,竹山鎮,0245,102,252,354,16,370,682,54.25%,14.96%,1
南投縣,竹山鎮,0246,132,335,467,24,491,989,49.65%,13.35%,1
南投縣,竹山鎮,0247,169,553,722,39,761,1378,55.22%,12.26%,1
南投縣,竹山鎮,0248,33,84,117,2,119,217,54.84%,15.21%,1
南投縣,竹山鎮,0249,71,196,267,21,288,479,60.13%,14.82%,1
南投縣,竹山鎮,0250,41,157,198,13,211,430,49.07%,9.53%,1
南投縣,竹山鎮,0251,222,542,764,43,807,1437,56.16%,15.45%,1
南投縣,竹山鎮,0252,199,537,736,39,775,1286,60.26%,15.47%,1
南投縣,竹山鎮,0253,158,464,622,34,656,1080,60.74%,14.63%,1
南投縣,竹山鎮,0254,175,393,568,31,599,1070,55.98%,16.36%,1
南投縣,竹山鎮,0255,187,531,718,32,750,1295,57.92%,14.44%,1
南投縣,竹山鎮,0256,128,435,563,37,600,1047,57.31%,12.23%,1
南投縣,竹山鎮,0257,177,507,684,44,728,1300,56%,13.62%,1
南投縣,竹山鎮,0258,104,306,410,23,433,908,47.69%,11.45%,1
南投縣,竹山鎮,0259,123,244,367,55,422,821,51.4%,14.98%,1
南投縣,竹山鎮,0260,200,517,717,49,766,1320,58.03%,15.15%,1
南投縣,竹山鎮,0261,141,352,493,30,523,967,54.08%,14.58%,1
南投縣,竹山鎮,0262,64,223,287,22,309,595,51.93%,10.76%,1
南投縣,竹山鎮,0263,111,311,422,55,477,859,55.53%,12.92%,1
南投縣,竹山鎮,0264,164,431,595,53,648,1196,54.18%,13.71%,1
南投縣,竹山鎮,0265,95,242,337,33,370,649,57.01%,14.64%,1
南投縣,竹山鎮,0266,197,509,706,47,753,1341,56.15%,14.69%,1
南投縣,竹山鎮,0267,143,436,579,53,632,1222,51.72%,11.7%,1
南投縣,竹山鎮,0268,93,237,330,19,349,602,57.97%,15.45%,1
南投縣,竹山鎮,0269,90,234,324,22,346,617,56.08%,14.59%,1
南投縣,竹山鎮,0270,133,327,460,28,488,793,61.54%,16.77%,1
南投縣,竹山鎮,0271,141,364,505,31,536,922,58.13%,15.29%,1
南投縣,竹山鎮,0272,34,140,174,21,195,366,53.28%,9.29%,1
南投縣,竹山鎮,0273,41,195,236,8,244,509,47.94%,8.06%,1
南投縣,竹山鎮,0274,20,83,103,6,109,193,56.48%,10.36%,1
南投縣,竹山鎮,0275,73,160,233,19,252,406,62.07%,17.98%,1
南投縣,竹山鎮,0276,62,167,229,23,252,495,50.91%,12.53%,1
南投縣,竹山鎮,0277,25,84,109,9,118,307,38.44%,8.14%,1
南投縣,竹山鎮,0278,38,166,204,33,237,440,53.86%,8.64%,1
南投縣,竹山鎮,0279,63,219,282,32,314,577,54.42%,10.92%,1
南投縣,竹山鎮,0280,43,139,182,30,212,486,43.62%,8.85%,1
南投縣,竹山鎮,0281,31,106,137,11,148,403,36.72%,7.69%,1
南投縣,集集鎮,0282,165,458,623,33,656,1070,61.31%,15.42%,1
南投縣,集集鎮,0283,129,390,519,40,559,918,60.89%,14.05%,1
南投縣,集集鎮,0284,94,228,322,33,355,581,61.1%,16.18%,1
南投縣,集集鎮,0285,176,492,668,48,716,1194,59.97%,14.74%,1
南投縣,集集鎮,0286,59,148,207,15,222,488,45.49%,12.09%,1
南投縣,集集鎮,0287,75,209,284,29,313,504,62.1%,14.88%,1
南投縣,集集鎮,0288,135,355,490,73,563,910,61.87%,14.84%,1
南投縣,集集鎮,0289,134,311,445,36,481,773,62.23%,17.34%,1
南投縣,集集鎮,0290,125,261,386,16,402,709,56.7%,17.63%,1
南投縣,集集鎮,0291,166,371,537,16,553,960,57.6%,17.29%,1
南投縣,集集鎮,0292,76,180,256,20,276,503,54.87%,15.11%,1
南投縣,集集鎮,0293,67,132,199,13,212,419,50.6%,15.99%,1
南投縣,集集鎮,0294,67,191,258,13,271,582,46.56%,11.51%,1
南投縣,名間鄉,0295,189,491,680,51,731,1050,69.62%,18%,1
南投縣,名間鄉,0296,130,378,508,48,556,920,60.43%,14.13%,1
南投縣,名間鄉,0297,102,347,449,29,478,727,65.75%,14.03%,1
南投縣,名間鄉,0298,133,400,533,21,554,861,64.34%,15.45%,1
南投縣,名間鄉,0299,130,363,493,36,529,897,58.97%,14.49%,1
南投縣,名間鄉,0300,157,452,609,40,649,1055,61.52%,14.88%,1
南投縣,名間鄉,0301,174,471,645,52,697,1184,58.87%,14.7%,1
南投縣,名間鄉,0302,109,300,409,37,446,783,56.96%,13.92%,1
南投縣,名間鄉,0303,106,351,457,32,489,781,62.61%,13.57%,1
南投縣,名間鄉,0304,141,384,525,36,561,977,57.42%,14.43%,1
南投縣,名間鄉,0305,158,379,537,36,573,1015,56.45%,15.57%,1
南投縣,名間鄉,0306,142,388,530,33,563,914,61.6%,15.54%,1
南投縣,名間鄉,0307,170,377,547,14,561,1028,54.57%,16.54%,1
南投縣,名間鄉,0308,145,438,583,33,616,1018,60.51%,14.24%,1
南投縣,名間鄉,0309,280,422,702,54,756,1274,59.34%,21.98%,1
南投縣,名間鄉,0310,112,315,427,29,456,755,60.4%,14.83%,1
南投縣,名間鄉,0311,137,418,555,37,592,895,66.15%,15.31%,1
南投縣,名間鄉,0312,138,367,505,22,527,892,59.08%,15.47%,1
南投縣,名間鄉,0313,142,363,505,47,552,951,58.04%,14.93%,1
南投縣,名間鄉,0314,153,528,681,45,726,1261,57.57%,12.13%,1
南投縣,名間鄉,0315,117,294,411,33,444,768,57.81%,15.23%,1
南投縣,名間鄉,0316,143,397,540,45,585,962,60.81%,14.86%,1
南投縣,名間鄉,0317,124,369,493,42,535,867,61.71%,14.3%,1
南投縣,名間鄉,0318,163,344,507,61,568,930,61.08%,17.53%,1
南投縣,名間鄉,0319,91,257,348,40,388,641,60.53%,14.2%,1
南投縣,名間鄉,0320,60,205,265,17,282,530,53.21%,11.32%,1
南投縣,名間鄉,0321,162,347,509,52,561,931,60.26%,17.4%,1
南投縣,名間鄉,0322,154,475,629,41,670,1127,59.45%,13.66%,1
南投縣,名間鄉,0323,71,195,266,29,295,443,66.59%,16.03%,1
南投縣,名間鄉,0324,126,373,499,35,534,870,61.38%,14.48%,1
南投縣,名間鄉,0325,108,254,362,33,395,621,63.61%,17.39%,1
南投縣,名間鄉,0326,176,441,617,26,643,1179,54.54%,14.93%,1
南投縣,名間鄉,0327,149,378,527,36,563,881,63.9%,16.91%,1
南投縣,名間鄉,0328,135,434,569,27,596,876,68.04%,15.41%,1
南投縣,名間鄉,0329,107,335,442,34,476,783,60.79%,13.67%,1
南投縣,名間鄉,0330,84,308,392,32,424,778,54.5%,10.8%,1
南投縣,名間鄉,0331,141,362,503,40,543,983,55.24%,14.34%,1
南投縣,鹿谷鄉,0332,94,358,452,32,484,934,51.82%,10.06%,1
南投縣,鹿谷鄉,0333,367,141,508,33,541,940,57.55%,39.04%,1
南投縣,鹿谷鄉,0334,135,297,432,25,457,852,53.64%,15.85%,1
南投縣,鹿谷鄉,0335,68,132,200,18,218,451,48.34%,15.08%,1
南投縣,鹿谷鄉,0336,331,145,476,20,496,810,61.23%,40.86%,1
南投縣,鹿谷鄉,0337,169,505,674,38,712,1142,62.35%,14.8%,1
南投縣,鹿谷鄉,0338,98,266,364,16,380,766,49.61%,12.79%,1
南投縣,鹿谷鄉,0339,115,362,477,41,518,884,58.6%,13.01%,1
南投縣,鹿谷鄉,0340,129,299,428,32,460,811,56.72%,15.91%,1
南投縣,鹿谷鄉,0341,70,184,254,22,276,581,47.5%,12.05%,1
南投縣,鹿谷鄉,0342,73,199,272,23,295,578,51.04%,12.63%,1
南投縣,鹿谷鄉,0343,64,189,253,26,279,467,59.74%,13.7%,1
南投縣,鹿谷鄉,0344,66,259,325,21,346,622,55.63%,10.61%,1
南投縣,鹿谷鄉,0345,93,266,359,25,384,740,51.89%,12.57%,1
南投縣,鹿谷鄉,0346,84,317,401,32,433,767,56.45%,10.95%,1
南投縣,鹿谷鄉,0347,114,381,495,36,531,909,58.42%,12.54%,1
南投縣,鹿谷鄉,0348,99,156,255,19,274,713,38.43%,13.88%,1
南投縣,鹿谷鄉,0349,84,233,317,21,338,717,47.14%,11.72%,1
南投縣,鹿谷鄉,0350,105,272,377,31,408,794,51.39%,13.22%,1
南投縣,鹿谷鄉,0351,100,250,350,14,364,726,50.14%,13.77%,1
南投縣,鹿谷鄉,0352,83,220,303,27,330,737,44.78%,11.26%,1
南投縣,中寮鄉,0353,128,351,479,28,507,822,61.68%,15.57%,1
南投縣,中寮鄉,0354,39,103,142,13,155,253,61.26%,15.42%,1
南投縣,中寮鄉,0355,24,67,91,4,95,221,42.99%,10.86%,1
南投縣,中寮鄉,0356,39,122,161,6,167,353,47.31%,11.05%,1
南投縣,中寮鄉,0357,58,169,227,9,236,427,55.27%,13.58%,1
南投縣,中寮鄉,0358,45,176,221,11,232,406,57.14%,11.08%,1
南投縣,中寮鄉,0359,27,110,137,24,161,307,52.44%,8.79%,1
南投縣,中寮鄉,0360,71,305,376,27,403,661,60.97%,10.74%,1
南投縣,中寮鄉,0361,50,133,183,10,193,290,66.55%,17.24%,1
南投縣,中寮鄉,0362,163,374,537,38,575,973,59.1%,16.75%,1
南投縣,中寮鄉,0363,119,317,436,20,456,754,60.48%,15.78%,1
南投縣,中寮鄉,0364,73,270,343,25,368,662,55.59%,11.03%,1
南投縣,中寮鄉,0365,41,185,226,10,236,490,48.16%,8.37%,1
南投縣,中寮鄉,0366,40,121,161,15,176,335,52.54%,11.94%,1
南投縣,中寮鄉,0367,132,412,544,31,575,990,58.08%,13.33%,1
南投縣,中寮鄉,0368,58,217,275,21,296,461,64.21%,12.58%,1
南投縣,中寮鄉,0369,98,265,363,18,381,614,62.05%,15.96%,1
南投縣,中寮鄉,0370,113,356,469,43,512,895,57.21%,12.63%,1
南投縣,中寮鄉,0371,57,182,239,26,265,465,56.99%,12.26%,1
南投縣,中寮鄉,0372,106,251,357,45,402,682,58.94%,15.54%,1
南投縣,中寮鄉,0373,201,77,278,25,303,490,61.84%,41.02%,1
南投縣,中寮鄉,0374,82,277,359,35,394,643,61.28%,12.75%,1
南投縣,中寮鄉,0375,60,209,269,15,284,459,61.87%,13.07%,1
南投縣,中寮鄉,0376,57,189,246,19,265,528,50.19%,10.8%,1
南投縣,魚池鄉,0377,150,344,494,37,531,922,57.59%,16.27%,1
南投縣,魚池鄉,0378,190,410,600,49,649,1098,59.11%,17.3%,1
南投縣,魚池鄉,0379,91,270,361,26,387,720,53.75%,12.64%,1
南投縣,魚池鄉,0380,127,347,474,34,508,860,59.07%,14.77%,1
南投縣,魚池鄉,0381,50,189,239,24,263,514,51.17%,9.73%,1
南投縣,魚池鄉,0382,76,204,280,11,291,574,50.7%,13.24%,1
南投縣,魚池鄉,0383,173,454,627,49,676,1249,54.12%,13.85%,1
南投縣,魚池鄉,0384,49,140,189,5,194,293,66.21%,16.72%,1
南投縣,魚池鄉,0385,67,195,262,17,279,513,54.39%,13.06%,1
南投縣,魚池鄉,0386,27,70,97,6,103,186,55.38%,14.52%,1
南投縣,魚池鄉,0387,104,313,417,26,443,841,52.68%,12.37%,1
南投縣,魚池鄉,0388,52,102,154,16,170,270,62.96%,19.26%,1
南投縣,魚池鄉,0389,32,108,140,15,155,275,56.36%,11.64%,1
南投縣,魚池鄉,0390,26,97,123,8,131,282,46.45%,9.22%,1
南投縣,魚池鄉,0391,52,139,191,6,197,392,50.26%,13.27%,1
南投縣,魚池鄉,0392,76,202,278,28,306,556,55.04%,13.67%,1
南投縣,魚池鄉,0393,18,73,91,7,98,176,55.68%,10.23%,1
南投縣,魚池鄉,0394,173,74,247,25,272,578,47.06%,29.93%,1
南投縣,魚池鄉,0395,61,143,204,20,224,439,51.03%,13.9%,1
南投縣,魚池鄉,0396,123,348,471,25,496,844,58.77%,14.57%,1
南投縣,魚池鄉,0397,317,130,447,22,469,868,54.03%,36.52%,1
南投縣,魚池鄉,0398,44,136,180,10,190,405,46.91%,10.86%,1
南投縣,魚池鄉,0399,85,205,290,17,307,537,57.17%,15.83%,1
南投縣,魚池鄉,0400,35,134,169,14,183,335,54.63%,10.45%,1
南投縣,魚池鄉,0401,17,77,94,10,104,231,45.02%,7.36%,1
南投縣,國姓鄉,0402,118,429,547,56,603,964,62.55%,12.24%,1
南投縣,國姓鄉,0403,88,305,393,23,416,736,56.52%,11.96%,1
南投縣,國姓鄉,0404,89,338,427,48,475,801,59.3%,11.11%,1
南投縣,國姓鄉,0405,145,391,536,17,553,964,57.37%,15.04%,1
南投縣,國姓鄉,0406,94,265,359,27,386,686,56.27%,13.7%,1
南投縣,國姓鄉,0407,253,88,341,21,362,661,54.77%,38.28%,1
南投縣,國姓鄉,0408,79,270,349,30,379,730,51.92%,10.82%,1
南投縣,國姓鄉,0409,102,296,398,37,435,774,56.2%,13.18%,1
南投縣,國姓鄉,0410,101,300,401,18,419,706,59.35%,14.31%,1
南投縣,國姓鄉,0411,124,415,539,36,575,1012,56.82%,12.25%,1
南投縣,國姓鄉,0412,102,294,396,15,411,868,47.35%,11.75%,1
南投縣,國姓鄉,0413,122,416,538,23,561,918,61.11%,13.29%,1
南投縣,國姓鄉,0414,120,373,493,42,535,937,57.1%,12.81%,1
南投縣,國姓鄉,0415,95,313,408,42,450,815,55.21%,11.66%,1
南投縣,國姓鄉,0416,159,492,651,35,686,1134,60.49%,14.02%,1
南投縣,國姓鄉,0417,95,275,370,24,394,714,55.18%,13.31%,1
南投縣,國姓鄉,0418,174,447,621,35,656,1095,59.91%,15.89%,1
南投縣,國姓鄉,0419,55,162,217,20,237,448,52.9%,12.28%,1
南投縣,國姓鄉,0420,102,422,524,47,571,1064,53.67%,9.59%,1
南投縣,國姓鄉,0421,61,222,283,17,300,570,52.63%,10.7%,1
南投縣,水里鄉,0422,91,305,396,27,423,757,55.88%,12.02%,1
南投縣,水里鄉,0423,68,211,279,35,314,554,56.68%,12.27%,1
南投縣,水里鄉,0424,159,376,535,44,579,999,57.96%,15.92%,1
南投縣,水里鄉,0425,80,239,319,19,338,616,54.87%,12.99%,1
南投縣,水里鄉,0426,134,367,501,24,525,875,60%,15.31%,1
南投縣,水里鄉,0427,75,207,282,12,294,480,61.25%,15.63%,1
南投縣,水里鄉,0428,68,161,229,19,248,450,55.11%,15.11%,1
南投縣,水里鄉,0429,91,232,323,32,355,643,55.21%,14.15%,1
南投縣,水里鄉,0430,142,417,559,28,587,1004,58.47%,14.14%,1
南投縣,水里鄉,0431,107,290,397,13,410,741,55.33%,14.44%,1
南投縣,水里鄉,0432,155,302,457,12,469,802,58.48%,19.33%,1
南投縣,水里鄉,0433,213,378,591,50,641,998,64.23%,21.34%,1
南投縣,水里鄉,0434,126,279,405,38,443,800,55.38%,15.75%,1
南投縣,水里鄉,0435,73,274,347,19,366,589,62.14%,12.39%,1
南投縣,水里鄉,0436,104,315,419,52,471,887,53.1%,11.72%,1
南投縣,水里鄉,0437,155,448,603,32,635,1217,52.18%,12.74%,1
南投縣,水里鄉,0438,23,56,79,3,82,205,40%,11.22%,1
南投縣,水里鄉,0439,42,144,186,23,209,330,63.33%,12.73%,1
南投縣,水里鄉,0440,124,425,549,33,582,1100,52.91%,11.27%,1
南投縣,水里鄉,0441,29,70,99,4,103,275,37.45%,10.55%,1
南投縣,水里鄉,0442,51,88,139,1,140,318,44.03%,16.04%,1
南投縣,水里鄉,0443,99,303,402,44,446,818,54.52%,12.1%,1
南投縣,信義鄉,0444,146,466,612,67,679,1201,56.54%,12.16%,1
南投縣,信義鄉,0445,28,135,163,14,177,329,53.8%,8.51%,1
南投縣,信義鄉,0446,66,187,253,18,271,516,52.52%,12.79%,1
南投縣,信義鄉,0447,50,135,185,19,204,424,48.11%,11.79%,1
南投縣,信義鄉,0448,44,119,163,6,169,321,52.65%,13.71%,1
南投縣,信義鄉,0449,81,307,388,28,416,648,64.2%,12.5%,1
南投縣,信義鄉,0450,60,342,402,36,438,584,75%,10.27%,1
南投縣,信義鄉,0451,107,624,731,26,757,1376,55.01%,7.78%,1
南投縣,信義鄉,0452,423,99,522,25,547,979,55.87%,43.21%,1
南投縣,信義鄉,0453,56,302,358,36,394,530,74.34%,10.57%,1
南投縣,信義鄉,0454,121,356,477,33,510,961,53.07%,12.59%,1
南投縣,信義鄉,0455,47,196,243,14,257,464,55.39%,10.13%,1
南投縣,信義鄉,0456,68,210,278,27,305,517,58.99%,13.15%,1
南投縣,信義鄉,0457,24,59,83,6,89,149,59.73%,16.11%,1
南投縣,信義鄉,0458,91,608,699,63,762,1020,74.71%,8.92%,1
南投縣,信義鄉,0459,74,506,580,58,638,929,68.68%,7.97%,1
南投縣,信義鄉,0460,25,95,120,9,129,274,47.08%,9.12%,1
南投縣,信義鄉,0461,98,502,600,37,637,900,70.78%,10.89%,1
南投縣,信義鄉,0462,72,346,418,33,451,617,73.1%,11.67%,1
南投縣,信義鄉,0463,71,290,361,28,389,560,69.46%,12.68%,1
南投縣,仁愛鄉,0464,399,124,523,25,548,973,56.32%,41.01%,1
南投縣,仁愛鄉,0465,34,101,135,15,150,296,50.68%,11.49%,1
南投縣,仁愛鄉,0466,111,327,438,17,455,900,50.56%,12.33%,1
南投縣,仁愛鄉,0467,77,206,283,15,298,460,64.78%,16.74%,1
南投縣,仁愛鄉,0468,35,138,173,10,183,305,60%,11.48%,1
南投縣,仁愛鄉,0469,2,16,18,2,20,58,34.48%,3.45%,1
南投縣,仁愛鄉,0470,96,417,513,11,524,952,55.04%,10.08%,1
南投縣,仁愛鄉,0471,59,244,303,6,309,679,45.51%,8.69%,1
南投縣,仁愛鄉,0472,78,251,329,40,369,623,59.23%,12.52%,1
南投縣,仁愛鄉,0473,44,171,215,4,219,597,36.68%,7.37%,1
南投縣,仁愛鄉,0474,31,192,223,25,248,384,64.58%,8.07%,1
南投縣,仁愛鄉,0475,7,51,58,4,62,121,51.24%,5.79%,1
南投縣,仁愛鄉,0476,32,136,168,4,172,264,65.15%,12.12%,1
南投縣,仁愛鄉,0477,52,314,366,17,383,509,75.25%,10.22%,1
南投縣,仁愛鄉,0478,26,164,190,17,207,338,61.24%,7.69%,1
南投縣,仁愛鄉,0479,17,68,85,3,88,169,52.07%,10.06%,1
南投縣,仁愛鄉,0480,71,203,274,19,293,613,47.8%,11.58%,1
南投縣,仁愛鄉,0481,42,141,183,7,190,404,47.03%,10.4%,1
南投縣,仁愛鄉,0482,15,62,77,1,78,134,58.21%,11.19%,1
南投縣,仁愛鄉,0483,66,308,374,34,408,630,64.76%,10.48%,1
南投縣,仁愛鄉,0484,78,288,366,14,380,763,49.8%,10.22%,1
南投縣,仁愛鄉,0485,77,471,548,30,578,889,65.02%,8.66%,1
南投縣,仁愛鄉,0486,83,320,403,35,438,672,65.18%,12.35%,1
南投縣,仁愛鄉,0487,63,197,260,14,274,447,61.3%,14.09%,1
南投縣,仁愛鄉,0488,238,61,299,6,305,409,74.57%,58.19%,1
雲林縣,斗六市,0411,160,186,346,13,359,644,55.75%,24.84%,1
雲林縣,斗六市,0412,96,233,329,21,350,617,56.73%,15.56%,1
雲林縣,斗六市,0413,167,310,477,26,503,764,65.84%,21.86%,1
雲林縣,斗六市,0414,141,328,469,21,490,784,62.5%,17.98%,1
雲林縣,斗六市,0415,126,305,431,21,452,760,59.47%,16.58%,1
雲林縣,斗六市,0416,331,757,1088,51,1139,1881,60.55%,17.6%,1
雲林縣,斗六市,0417,276,686,962,49,1011,1829,55.28%,15.09%,1
雲林縣,斗六市,0418,221,554,775,24,799,1255,63.67%,17.61%,1
雲林縣,斗六市,0419,194,490,684,19,703,1090,64.5%,17.8%,1
雲林縣,斗六市,0420,181,462,643,32,675,1103,61.2%,16.41%,1
雲林縣,斗六市,0421,157,497,654,33,687,1176,58.42%,13.35%,1
雲林縣,斗六市,0422,249,603,852,15,867,1529,56.7%,16.29%,1
雲林縣,斗六市,0423,213,538,751,36,787,1335,58.95%,15.96%,1
雲林縣,斗六市,0424,285,712,997,35,1032,1770,58.31%,16.1%,1
雲林縣,斗六市,0425,226,492,718,33,751,1308,57.42%,17.28%,1
雲林縣,斗六市,0426,319,771,1090,66,1156,2171,53.25%,14.69%,1
雲林縣,斗六市,0427,188,495,683,32,715,1193,59.93%,15.76%,1
雲林縣,斗六市,0428,251,685,936,35,971,1572,61.77%,15.97%,1
雲林縣,斗六市,0429,166,386,552,24,576,1009,57.09%,16.45%,1
雲林縣,斗六市,0430,220,493,713,33,746,1195,62.43%,18.41%,1
雲林縣,斗六市,0431,225,568,793,50,843,1415,59.58%,15.9%,1
雲林縣,斗六市,0432,185,464,649,29,678,1101,61.58%,16.8%,1
雲林縣,斗六市,0433,272,615,887,37,924,1648,56.07%,16.5%,1
雲林縣,斗六市,0434,233,575,808,24,832,1588,52.39%,14.67%,1
雲林縣,斗六市,0435,275,529,804,19,823,1392,59.12%,19.76%,1
雲林縣,斗六市,0436,245,566,811,24,835,1422,58.72%,17.23%,1
雲林縣,斗六市,0437,139,421,560,34,594,1187,50.04%,11.71%,1
雲林縣,斗六市,0438,189,380,569,26,595,1142,52.1%,16.55%,1
雲林縣,斗六市,0439,244,606,850,30,880,1421,61.93%,17.17%,1
雲林縣,斗六市,0440,210,484,694,33,727,1261,57.65%,16.65%,1
雲林縣,斗六市,0441,227,550,777,28,805,1506,53.45%,15.07%,1
雲林縣,斗六市,0442,236,472,708,28,736,1214,60.63%,19.44%,1
雲林縣,斗六市,0443,317,400,717,33,750,1362,55.07%,23.27%,1
雲林縣,斗六市,0444,179,403,582,17,599,1097,54.6%,16.32%,1
雲林縣,斗六市,0445,181,520,701,28,729,1262,57.77%,14.34%,1
雲林縣,斗六市,0446,191,426,617,18,635,1154,55.03%,16.55%,1
雲林縣,斗六市,0447,138,331,469,36,505,847,59.62%,16.29%,1
雲林縣,斗六市,0448,284,554,838,30,868,1439,60.32%,19.74%,1
雲林縣,斗六市,0449,326,691,1017,49,1066,1747,61.02%,18.66%,1
雲林縣,斗六市,0450,283,492,775,41,816,1418,57.55%,19.96%,1
雲林縣,斗六市,0451,154,455,609,27,636,1112,57.19%,13.85%,1
雲林縣,斗六市,0452,223,503,726,24,750,1302,57.6%,17.13%,1
雲林縣,斗六市,0453,114,302,416,18,434,669,64.87%,17.04%,1
雲林縣,斗六市,0454,127,281,408,27,435,752,57.85%,16.89%,1
雲林縣,斗六市,0455,226,541,767,21,788,1450,54.34%,15.59%,1
雲林縣,斗六市,0456,84,210,294,31,325,555,58.56%,15.14%,1
雲林縣,斗六市,0457,238,495,733,35,768,1470,52.24%,16.19%,1
雲林縣,斗六市,0458,144,388,532,21,553,927,59.65%,15.53%,1
雲林縣,斗六市,0459,333,722,1055,46,1101,1893,58.16%,17.59%,1
雲林縣,斗六市,0460,258,650,908,72,980,1708,57.38%,15.11%,1
雲林縣,斗六市,0461,257,575,832,53,885,1773,49.92%,14.5%,1
雲林縣,斗六市,0462,261,557,818,23,841,1412,59.56%,18.48%,1
雲林縣,斗六市,0463,250,578,828,24,852,1354,62.92%,18.46%,1
雲林縣,斗六市,0464,217,484,701,21,722,1267,56.99%,17.13%,1
雲林縣,斗六市,0465,229,445,674,22,696,1273,54.67%,17.99%,1
雲林縣,斗六市,0466,211,623,834,78,912,1748,52.17%,12.07%,1
雲林縣,斗六市,0467,184,502,686,48,734,1238,59.29%,14.86%,1
雲林縣,斗六市,0468,236,583,819,37,856,1648,51.94%,14.32%,1
雲林縣,斗六市,0469,260,608,868,50,918,1520,60.39%,17.11%,1
雲林縣,斗六市,0470,135,426,561,26,587,1087,54%,12.42%,1
雲林縣,斗六市,0471,297,720,1017,66,1083,1904,56.88%,15.6%,1
雲林縣,斗六市,0472,113,289,402,32,434,702,61.82%,16.1%,1
雲林縣,斗六市,0473,193,416,609,51,660,1111,59.41%,17.37%,1
雲林縣,斗六市,0474,135,383,518,37,555,1123,49.42%,12.02%,1
雲林縣,斗六市,0475,169,425,594,26,620,1146,54.1%,14.75%,1
雲林縣,斗六市,0476,292,632,924,36,960,1786,53.75%,16.35%,1
雲林縣,斗六市,0477,180,363,543,49,592,1023,57.87%,17.6%,1
雲林縣,斗六市,0478,325,752,1077,71,1148,2072,55.41%,15.69%,1
雲林縣,斗六市,0479,178,414,592,23,615,1128,54.52%,15.78%,1
雲林縣,斗南鎮,0498,195,478,673,40,713,1166,61.15%,16.72%,1
雲林縣,斗南鎮,0499,194,472,666,34,700,1135,61.67%,17.09%,1
雲林縣,斗南鎮,0500,178,403,581,26,607,975,62.26%,18.26%,1
雲林縣,斗南鎮,0501,265,565,830,42,872,1459,59.77%,18.16%,1
雲林縣,斗南鎮,0502,236,513,749,48,797,1351,58.99%,17.47%,1
雲林縣,斗南鎮,0503,306,404,710,38,748,1321,56.62%,23.16%,1
雲林縣,斗南鎮,0504,153,313,466,33,499,907,55.02%,16.87%,1
雲林縣,斗南鎮,0505,228,634,862,60,922,1473,62.59%,15.48%,1
雲林縣,斗南鎮,0506,225,525,750,53,803,1277,62.88%,17.62%,1
雲林縣,斗南鎮,0507,221,476,697,67,764,1333,57.31%,16.58%,1
雲林縣,斗南鎮,0508,124,270,394,30,424,777,54.57%,15.96%,1
雲林縣,斗南鎮,0509,139,310,449,32,481,877,54.85%,15.85%,1
雲林縣,斗南鎮,0510,111,343,454,41,495,899,55.06%,12.35%,1
雲林縣,斗南鎮,0511,84,200,284,37,321,688,46.66%,12.21%,1
雲林縣,斗南鎮,0512,169,392,561,27,588,1147,51.26%,14.73%,1
雲林縣,斗南鎮,0513,254,628,882,74,956,1709,55.94%,14.86%,1
雲林縣,斗南鎮,0514,175,424,599,39,638,1042,61.23%,16.79%,1
雲林縣,斗南鎮,0515,282,567,849,43,892,1631,54.69%,17.29%,1
雲林縣,斗南鎮,0516,276,682,958,73,1031,1702,60.58%,16.22%,1
雲林縣,斗南鎮,0517,244,617,861,61,922,1564,58.95%,15.6%,1
雲林縣,斗南鎮,0518,106,302,408,23,431,910,47.36%,11.65%,1
雲林縣,斗南鎮,0519,234,506,740,43,783,1276,61.36%,18.34%,1
雲林縣,斗南鎮,0520,103,228,331,19,350,897,39.02%,11.48%,1
雲林縣,斗南鎮,0521,130,279,409,29,438,803,54.55%,16.19%,1
雲林縣,斗南鎮,0522,113,347,460,45,505,866,58.31%,13.05%,1
雲林縣,斗南鎮,0523,142,317,459,44,503,852,59.04%,16.67%,1
雲林縣,斗南鎮,0524,192,148,340,42,382,671,56.93%,28.61%,1
雲林縣,斗南鎮,0525,161,345,506,27,533,981,54.33%,16.41%,1
雲林縣,斗南鎮,0526,161,361,522,20,542,1129,48.01%,14.26%,1
雲林縣,斗南鎮,0527,266,604,870,71,941,1586,59.33%,16.77%,1
雲林縣,斗南鎮,0528,219,493,712,50,762,1243,61.3%,17.62%,1
雲林縣,斗南鎮,0529,122,337,459,23,482,984,48.98%,12.4%,1
雲林縣,斗南鎮,0530,237,558,795,61,856,1507,56.8%,15.73%,1
雲林縣,虎尾鎮,0109,218,483,701,43,744,1347,55.23%,16.18%,1
雲林縣,虎尾鎮,0110,248,475,723,29,752,1258,59.78%,19.71%,1
雲林縣,虎尾鎮,0111,123,295,418,20,438,785,55.8%,15.67%,1
雲林縣,虎尾鎮,0112,131,279,410,28,438,890,49.21%,14.72%,1
雲林縣,虎尾鎮,0113,243,549,792,39,831,1413,58.81%,17.2%,1
雲林縣,虎尾鎮,0114,246,585,831,39,870,1431,60.8%,17.19%,1
雲林縣,虎尾鎮,0115,192,421,613,47,660,1224,53.92%,15.69%,1
雲林縣,虎尾鎮,0116,172,449,621,28,649,1325,48.98%,12.98%,1
雲林縣,虎尾鎮,0117,173,344,517,55,572,941,60.79%,18.38%,1
雲林縣,虎尾鎮,0118,249,600,849,24,873,1613,54.12%,15.44%,1
雲林縣,虎尾鎮,0119,250,594,844,28,872,1641,53.14%,15.23%,1
雲林縣,虎尾鎮,0120,208,474,682,33,715,1200,59.58%,17.33%,1
雲林縣,虎尾鎮,0121,237,475,712,47,759,1294,58.66%,18.32%,1
雲林縣,虎尾鎮,0122,224,481,705,20,725,1273,56.95%,17.6%,1
雲林縣,虎尾鎮,0123,224,630,854,35,889,1438,61.82%,15.58%,1
雲林縣,虎尾鎮,0124,206,546,752,26,778,1361,57.16%,15.14%,1
雲林縣,虎尾鎮,0125,246,591,837,28,865,1444,59.9%,17.04%,1
雲林縣,虎尾鎮,0126,248,649,897,35,932,1490,62.55%,16.64%,1
雲林縣,虎尾鎮,0127,281,517,798,37,835,1307,63.89%,21.5%,1
雲林縣,虎尾鎮,0128,154,313,467,20,487,967,50.36%,15.93%,1
雲林縣,虎尾鎮,0129,268,707,975,28,1003,1865,53.78%,14.37%,1
雲林縣,虎尾鎮,0130,329,699,1028,27,1055,1880,56.12%,17.5%,1
雲林縣,虎尾鎮,0131,152,400,552,27,579,1099,52.68%,13.83%,1
雲林縣,虎尾鎮,0132,157,342,499,22,521,901,57.82%,17.43%,1
雲林縣,虎尾鎮,0133,182,384,566,35,601,1120,53.66%,16.25%,1
雲林縣,虎尾鎮,0134,64,168,232,9,241,545,44.22%,11.74%,1
雲林縣,虎尾鎮,0135,230,484,714,49,763,1420,53.73%,16.2%,1
雲林縣,虎尾鎮,0136,193,419,612,21,633,1248,50.72%,15.46%,1
雲林縣,虎尾鎮,0137,119,296,415,24,439,799,54.94%,14.89%,1
雲林縣,虎尾鎮,0138,119,283,402,46,448,836,53.59%,14.23%,1
雲林縣,虎尾鎮,0139,153,262,415,34,449,924,48.59%,16.56%,1
雲林縣,虎尾鎮,0140,202,500,702,22,724,1648,43.93%,12.26%,1
雲林縣,虎尾鎮,0141,215,479,694,83,777,1616,48.08%,13.3%,1
雲林縣,虎尾鎮,0142,216,506,722,53,775,1546,50.13%,13.97%,1
雲林縣,虎尾鎮,0143,167,470,637,28,665,1283,51.83%,13.02%,1
雲林縣,虎尾鎮,0144,153,373,526,27,553,1078,51.3%,14.19%,1
雲林縣,虎尾鎮,0145,187,416,603,35,638,1313,48.59%,14.24%,1
雲林縣,虎尾鎮,0146,171,443,614,28,642,1284,50%,13.32%,1
雲林縣,虎尾鎮,0147,187,468,655,73,728,1356,53.69%,13.79%,1
雲林縣,虎尾鎮,0148,223,545,768,57,825,1504,54.85%,14.83%,1
雲林縣,虎尾鎮,0149,148,376,524,34,558,1224,45.59%,12.09%,1
雲林縣,虎尾鎮,0150,190,462,652,59,711,1509,47.12%,12.59%,1
雲林縣,虎尾鎮,0151,115,202,317,49,366,855,42.81%,13.45%,1
雲林縣,虎尾鎮,0152,214,444,658,62,720,1549,46.48%,13.82%,1
雲林縣,虎尾鎮,0153,116,266,382,21,403,851,47.36%,13.63%,1
雲林縣,虎尾鎮,0154,151,430,581,56,637,1272,50.08%,11.87%,1
雲林縣,西螺鎮,0340,271,513,784,46,830,1590,52.2%,17.04%,1
雲林縣,西螺鎮,0341,293,609,902,58,960,1741,55.14%,16.83%,1
雲林縣,西螺鎮,0342,206,452,658,43,701,1080,64.91%,19.07%,1
雲林縣,西螺鎮,0343,195,415,610,45,655,1040,62.98%,18.75%,1
雲林縣,西螺鎮,0344,201,532,733,26,759,1346,56.39%,14.93%,1
雲林縣,西螺鎮,0345,222,628,850,42,892,1625,54.89%,13.66%,1
雲林縣,西螺鎮,0346,60,159,219,10,229,354,64.69%,16.95%,1
雲林縣,西螺鎮,0347,82,208,290,26,316,580,54.48%,14.14%,1
雲林縣,西螺鎮,0348,115,241,356,19,375,591,63.45%,19.46%,1
雲林縣,西螺鎮,0349,186,387,573,49,622,1050,59.24%,17.71%,1
雲林縣,西螺鎮,0350,193,456,649,56,705,1147,61.46%,16.83%,1
雲林縣,西螺鎮,0351,267,523,790,71,861,1602,53.75%,16.67%,1
雲林縣,西螺鎮,0352,226,511,737,37,774,1452,53.31%,15.56%,1
雲林縣,西螺鎮,0353,243,577,820,62,882,1578,55.89%,15.4%,1
雲林縣,西螺鎮,0354,182,457,639,33,672,1305,51.49%,13.95%,1
雲林縣,西螺鎮,0355,204,390,594,52,646,1327,48.68%,15.37%,1
雲林縣,西螺鎮,0356,218,528,746,50,796,1516,52.51%,14.38%,1
雲林縣,西螺鎮,0357,111,220,331,21,352,828,42.51%,13.41%,1
雲林縣,西螺鎮,0358,85,218,303,20,323,788,40.99%,10.79%,1
雲林縣,西螺鎮,0359,134,271,405,49,454,863,52.61%,15.53%,1
雲林縣,西螺鎮,0360,149,301,450,72,522,984,53.05%,15.14%,1
雲林縣,西螺鎮,0361,220,406,626,125,751,1514,49.6%,14.53%,1
雲林縣,西螺鎮,0362,116,307,423,45,468,870,53.79%,13.33%,1
雲林縣,西螺鎮,0363,145,314,459,59,518,971,53.35%,14.93%,1
雲林縣,西螺鎮,0364,174,379,553,50,603,1304,46.24%,13.34%,1
雲林縣,西螺鎮,0365,122,207,329,25,354,726,48.76%,16.8%,1
雲林縣,西螺鎮,0366,97,314,411,38,449,823,54.56%,11.79%,1
雲林縣,西螺鎮,0367,106,250,356,13,369,886,41.65%,11.96%,1
雲林縣,西螺鎮,0368,202,408,610,76,686,1373,49.96%,14.71%,1
雲林縣,西螺鎮,0369,150,328,478,61,539,983,54.83%,15.26%,1
雲林縣,西螺鎮,0370,141,360,501,45,546,1014,53.85%,13.91%,1
雲林縣,西螺鎮,0371,119,283,402,67,469,939,49.95%,12.67%,1
雲林縣,西螺鎮,0372,122,284,406,42,448,866,51.73%,14.09%,1
雲林縣,西螺鎮,0373,182,467,649,76,725,1486,48.79%,12.25%,1
雲林縣,土庫鎮,0080,138,325,463,48,511,809,63.16%,17.06%,1
雲林縣,土庫鎮,0081,155,345,500,38,538,896,60.04%,17.3%,1
雲林縣,土庫鎮,0082,107,262,369,34,403,687,58.66%,15.57%,1
雲林縣,土庫鎮,0083,128,317,445,27,472,702,67.24%,18.23%,1
雲林縣,土庫鎮,0084,180,431,611,26,637,1032,61.72%,17.44%,1
雲林縣,土庫鎮,0085,118,214,332,44,376,697,53.95%,16.93%,1
雲林縣,土庫鎮,0086,54,136,190,33,223,427,52.22%,12.65%,1
雲林縣,土庫鎮,0087,231,566,797,46,843,1451,58.1%,15.92%,1
雲林縣,土庫鎮,0088,206,504,710,21,731,1283,56.98%,16.06%,1
雲林縣,土庫鎮,0089,101,186,287,9,296,634,46.69%,15.93%,1
雲林縣,土庫鎮,0090,147,259,406,29,435,796,54.65%,18.47%,1
雲林縣,土庫鎮,0091,99,191,290,43,333,745,44.7%,13.29%,1
雲林縣,土庫鎮,0092,65,194,259,29,288,576,50%,11.28%,1
雲林縣,土庫鎮,0093,62,244,306,48,354,743,47.64%,8.34%,1
雲林縣,土庫鎮,0094,74,152,226,9,235,534,44.01%,13.86%,1
雲林縣,土庫鎮,0095,154,322,476,71,547,1199,45.62%,12.84%,1
雲林縣,土庫鎮,0096,133,347,480,61,541,1077,50.23%,12.35%,1
雲林縣,土庫鎮,0097,91,236,327,27,354,819,43.22%,11.11%,1
雲林縣,土庫鎮,0098,110,224,334,36,370,684,54.09%,16.08%,1
雲林縣,土庫鎮,0099,117,302,419,46,465,843,55.16%,13.88%,1
雲林縣,土庫鎮,0100,124,310,434,55,489,916,53.38%,13.54%,1
雲林縣,土庫鎮,0101,117,323,440,36,476,948,50.21%,12.34%,1
雲林縣,土庫鎮,0102,125,333,458,33,491,914,53.72%,13.68%,1
雲林縣,土庫鎮,0103,124,297,421,55,476,860,55.35%,14.42%,1
雲林縣,土庫鎮,0104,151,279,430,44,474,929,51.02%,16.25%,1
雲林縣,土庫鎮,0105,117,256,373,51,424,875,48.46%,13.37%,1
雲林縣,土庫鎮,0106,104,244,348,38,386,896,43.08%,11.61%,1
雲林縣,土庫鎮,0107,86,220,306,39,345,757,45.57%,11.36%,1
雲林縣,土庫鎮,0108,103,201,304,29,333,683,48.76%,15.08%,1
雲林縣,北港鎮,0256,105,269,374,53,427,724,58.98%,14.5%,1
雲林縣,北港鎮,0257,144,257,401,54,455,688,66.13%,20.93%,1
雲林縣,北港鎮,0258,50,178,228,37,265,452,58.63%,11.06%,1
雲林縣,北港鎮,0259,142,316,458,51,509,866,58.78%,16.4%,1
雲林縣,北港鎮,0260,56,104,160,19,179,336,53.27%,16.67%,1
雲林縣,北港鎮,0261,39,153,192,24,216,395,54.68%,9.87%,1
雲林縣,北港鎮,0262,47,166,213,25,238,376,63.3%,12.5%,1
雲林縣,北港鎮,0263,172,336,508,37,545,950,57.37%,18.11%,1
雲林縣,北港鎮,0264,89,203,292,35,327,512,63.87%,17.38%,1
雲林縣,北港鎮,0265,55,117,172,26,198,324,61.11%,16.98%,1
雲林縣,北港鎮,0266,79,187,266,34,300,546,54.95%,14.47%,1
雲林縣,北港鎮,0267,81,163,244,19,263,433,60.74%,18.71%,1
雲林縣,北港鎮,0268,105,280,385,47,432,751,57.52%,13.98%,1
雲林縣,北港鎮,0269,64,191,255,18,273,442,61.76%,14.48%,1
雲林縣,北港鎮,0270,182,436,618,50,668,1151,58.04%,15.81%,1
雲林縣,北港鎮,0271,205,471,676,41,717,1224,58.58%,16.75%,1
雲林縣,北港鎮,0272,190,436,626,42,668,1211,55.16%,15.69%,1
雲林縣,北港鎮,0273,217,479,696,62,758,1326,57.16%,16.37%,1
雲林縣,北港鎮,0274,319,128,447,34,481,744,64.65%,42.88%,1
雲林縣,北港鎮,0275,171,420,591,34,625,977,63.97%,17.5%,1
雲林縣,北港鎮,0276,163,319,482,57,539,960,56.15%,16.98%,1
雲林縣,北港鎮,0277,50,134,184,10,194,494,39.27%,10.12%,1
雲林縣,北港鎮,0278,230,520,750,39,789,1364,57.84%,16.86%,1
雲林縣,北港鎮,0279,205,395,600,57,657,1123,58.5%,18.25%,1
雲林縣,北港鎮,0280,242,542,784,43,827,1451,57%,16.68%,1
雲林縣,北港鎮,0281,213,441,654,43,697,1162,59.98%,18.33%,1
雲林縣,北港鎮,0282,169,372,541,50,591,1130,52.3%,14.96%,1
雲林縣,北港鎮,0283,158,405,563,32,595,1149,51.78%,13.75%,1
雲林縣,北港鎮,0284,62,155,217,22,239,533,44.84%,11.63%,1
雲林縣,北港鎮,0285,91,165,256,29,285,433,65.82%,21.02%,1
雲林縣,北港鎮,0286,39,137,176,8,184,377,48.81%,10.34%,1
雲林縣,北港鎮,0287,87,246,333,22,355,809,43.88%,10.75%,1
雲林縣,北港鎮,0288,187,390,577,74,651,1397,46.6%,13.39%,1
雲林縣,北港鎮,0289,113,347,460,69,529,1145,46.2%,9.87%,1
雲林縣,北港鎮,0290,71,193,264,50,314,828,37.92%,8.57%,1
雲林縣,北港鎮,0291,48,164,212,13,225,557,40.39%,8.62%,1
雲林縣,北港鎮,0292,159,305,464,44,508,1060,47.92%,15%,1
雲林縣,北港鎮,0293,80,167,247,33,280,577,48.53%,13.86%,1
雲林縣,北港鎮,0294,130,213,343,66,409,931,43.93%,13.96%,1
雲林縣,北港鎮,0295,158,358,516,36,552,1018,54.22%,15.52%,1
雲林縣,北港鎮,0296,188,384,572,20,592,1032,57.36%,18.22%,1
雲林縣,古坑鄉,0531,171,404,575,50,625,1126,55.51%,15.19%,1
雲林縣,古坑鄉,0532,155,322,477,49,526,994,52.92%,15.59%,1
雲林縣,古坑鄉,0533,267,488,755,52,807,1517,53.2%,17.6%,1
雲林縣,古坑鄉,0534,174,513,687,38,725,1302,55.68%,13.36%,1
雲林縣,古坑鄉,0535,238,608,846,48,894,1772,50.45%,13.43%,1
雲林縣,古坑鄉,0536,146,431,577,67,644,1122,57.4%,13.01%,1
雲林縣,古坑鄉,0537,24,79,103,6,109,304,35.86%,7.89%,1
雲林縣,古坑鄉,0538,140,464,604,80,684,1169,58.51%,11.98%,1
雲林縣,古坑鄉,0539,175,423,598,54,652,1255,51.95%,13.94%,1
雲林縣,古坑鄉,0540,197,414,611,42,653,1078,60.58%,18.27%,1
雲林縣,古坑鄉,0541,121,318,439,26,465,943,49.31%,12.83%,1
雲林縣,古坑鄉,0542,187,418,605,63,668,1300,51.38%,14.38%,1
雲林縣,古坑鄉,0543,118,345,463,35,498,964,51.66%,12.24%,1
雲林縣,古坑鄉,0544,164,414,578,42,620,1144,54.2%,14.34%,1
雲林縣,古坑鄉,0545,196,545,741,47,788,1482,53.17%,13.23%,1
雲林縣,古坑鄉,0546,101,256,357,29,386,688,56.1%,14.68%,1
雲林縣,古坑鄉,0547,147,325,472,33,505,998,50.6%,14.73%,1
雲林縣,古坑鄉,0548,163,449,612,40,652,1140,57.19%,14.3%,1
雲林縣,古坑鄉,0549,167,383,550,43,593,1102,53.81%,15.15%,1
雲林縣,古坑鄉,0550,129,345,474,27,501,956,52.41%,13.49%,1
雲林縣,古坑鄉,0551,107,243,350,27,377,695,54.24%,15.4%,1
雲林縣,古坑鄉,0552,158,405,563,33,596,1233,48.34%,12.81%,1
雲林縣,古坑鄉,0553,31,83,114,7,121,285,42.46%,10.88%,1
雲林縣,古坑鄉,0554,73,210,283,12,295,734,40.19%,9.95%,1
雲林縣,古坑鄉,0555,171,397,568,68,636,1150,55.3%,14.87%,1
雲林縣,古坑鄉,0556,51,177,228,16,244,453,53.86%,11.26%,1
雲林縣,古坑鄉,0557,52,194,246,32,278,571,48.69%,9.11%,1
雲林縣,大埤鄉,0480,111,254,365,32,397,750,52.93%,14.8%,1
雲林縣,大埤鄉,0481,105,236,341,28,369,719,51.32%,14.6%,1
雲林縣,大埤鄉,0482,69,227,296,21,317,603,52.57%,11.44%,1
雲林縣,大埤鄉,0483,136,339,475,54,529,1106,47.83%,12.3%,1
雲林縣,大埤鄉,0484,249,439,688,51,739,1495,49.43%,16.66%,1
雲林縣,大埤鄉,0485,94,233,327,30,357,600,59.5%,15.67%,1
雲林縣,大埤鄉,0486,156,390,546,45,591,1004,58.86%,15.54%,1
雲林縣,大埤鄉,0487,134,231,365,26,391,948,41.24%,14.14%,1
雲林縣,大埤鄉,0488,216,563,779,52,831,1539,54%,14.04%,1
雲林縣,大埤鄉,0489,174,457,631,65,696,1430,48.67%,12.17%,1
雲林縣,大埤鄉,0490,51,168,219,21,240,465,51.61%,10.97%,1
雲林縣,大埤鄉,0491,172,439,611,40,651,1307,49.81%,13.16%,1
雲林縣,大埤鄉,0492,84,149,233,16,249,474,52.53%,17.72%,1
雲林縣,大埤鄉,0493,203,441,644,84,728,1220,59.67%,16.64%,1
雲林縣,大埤鄉,0494,87,264,351,17,368,733,50.2%,11.87%,1
雲林縣,大埤鄉,0495,97,252,349,28,377,681,55.36%,14.24%,1
雲林縣,大埤鄉,0496,100,175,275,27,302,712,42.42%,14.04%,1
雲林縣,大埤鄉,0497,88,214,302,48,350,723,48.41%,12.17%,1
雲林縣,莿桐鄉,0374,246,558,804,66,870,1507,57.73%,16.32%,1
雲林縣,莿桐鄉,0375,206,472,678,33,711,1300,54.69%,15.85%,1
雲林縣,莿桐鄉,0376,197,462,659,97,756,1272,59.43%,15.49%,1
雲林縣,莿桐鄉,0377,148,257,405,58,463,861,53.77%,17.19%,1
雲林縣,莿桐鄉,0378,222,405,627,70,697,1565,44.54%,14.19%,1
雲林縣,莿桐鄉,0379,93,186,279,17,296,577,51.3%,16.12%,1
雲林縣,莿桐鄉,0380,90,176,266,33,299,636,47.01%,14.15%,1
雲林縣,莿桐鄉,0381,182,334,516,63,579,1110,52.16%,16.4%,1
雲林縣,莿桐鄉,0382,175,362,537,53,590,973,60.64%,17.99%,1
雲林縣,莿桐鄉,0383,216,270,486,62,548,985,55.63%,21.93%,1
雲林縣,莿桐鄉,0384,277,645,922,91,1013,1707,59.34%,16.23%,1
雲林縣,莿桐鄉,0385,202,459,661,62,723,1284,56.31%,15.73%,1
雲林縣,莿桐鄉,0386,213,469,682,53,735,1293,56.84%,16.47%,1
雲林縣,莿桐鄉,0387,124,345,469,41,510,900,56.67%,13.78%,1
雲林縣,莿桐鄉,0388,100,430,530,101,631,1040,60.67%,9.62%,1
雲林縣,莿桐鄉,0389,167,402,569,25,594,1165,50.99%,14.33%,1
雲林縣,莿桐鄉,0390,133,308,441,55,496,871,56.95%,15.27%,1
雲林縣,莿桐鄉,0391,137,361,498,45,543,885,61.36%,15.48%,1
雲林縣,莿桐鄉,0392,180,489,669,60,729,1489,48.96%,12.09%,1
雲林縣,莿桐鄉,0393,166,442,608,64,672,1347,49.89%,12.32%,1
雲林縣,莿桐鄉,0394,228,424,652,14,666,1150,57.91%,19.83%,1
雲林縣,莿桐鄉,0395,104,256,360,30,390,653,59.72%,15.93%,1
雲林縣,林內鄉,0396,157,446,603,54,657,1036,63.42%,15.15%,1
雲林縣,林內鄉,0397,214,564,778,60,838,1490,56.24%,14.36%,1
雲林縣,林內鄉,0398,209,530,739,65,804,1491,53.92%,14.02%,1
雲林縣,林內鄉,0399,77,229,306,51,357,671,53.2%,11.48%,1
雲林縣,林內鄉,0400,214,551,765,100,865,1436,60.24%,14.9%,1
雲林縣,林內鄉,0401,116,282,398,47,445,751,59.25%,15.45%,1
雲林縣,林內鄉,0402,84,192,276,20,296,535,55.33%,15.7%,1
雲林縣,林內鄉,0403,256,81,337,50,387,811,47.72%,31.57%,1
雲林縣,林內鄉,0404,205,478,683,88,771,1339,57.58%,15.31%,1
雲林縣,林內鄉,0405,188,459,647,65,712,1286,55.37%,14.62%,1
雲林縣,林內鄉,0406,107,216,323,36,359,646,55.57%,16.56%,1
雲林縣,林內鄉,0407,153,436,589,59,648,1158,55.96%,13.21%,1
雲林縣,林內鄉,0408,182,384,566,53,619,1090,56.79%,16.7%,1
雲林縣,林內鄉,0409,141,379,520,64,584,950,61.47%,14.84%,1
雲林縣,林內鄉,0410,148,297,445,33,478,861,55.52%,17.19%,1
雲林縣,二崙鄉,0317,182,458,640,34,674,1463,46.07%,12.44%,1
雲林縣,二崙鄉,0318,230,502,732,61,793,1738,45.63%,13.23%,1
雲林縣,二崙鄉,0319,77,178,255,46,301,625,48.16%,12.32%,1
雲林縣,二崙鄉,0320,140,312,452,56,508,1018,49.9%,13.75%,1
雲林縣,二崙鄉,0321,45,124,169,4,173,448,38.62%,10.04%,1
雲林縣,二崙鄉,0322,98,269,367,43,410,1048,39.12%,9.35%,1
雲林縣,二崙鄉,0323,180,400,580,53,633,1161,54.52%,15.5%,1
雲林縣,二崙鄉,0324,161,310,471,34,505,991,50.96%,16.25%,1
雲林縣,二崙鄉,0325,133,318,451,51,502,849,59.13%,15.67%,1
雲林縣,二崙鄉,0326,119,288,407,43,450,890,50.56%,13.37%,1
雲林縣,二崙鄉,0327,213,434,647,63,710,1427,49.75%,14.93%,1
雲林縣,二崙鄉,0328,111,303,414,24,438,891,49.16%,12.46%,1
雲林縣,二崙鄉,0329,85,220,305,25,330,757,43.59%,11.23%,1
雲林縣,二崙鄉,0330,193,406,599,134,733,1497,48.96%,12.89%,1
雲林縣,二崙鄉,0331,155,336,491,67,558,1171,47.65%,13.24%,1
雲林縣,二崙鄉,0332,109,252,361,42,403,686,58.75%,15.89%,1
雲林縣,二崙鄉,0333,105,208,313,74,387,864,44.79%,12.15%,1
雲林縣,二崙鄉,0334,161,385,546,69,615,1073,57.32%,15%,1
雲林縣,二崙鄉,0335,88,179,267,25,292,696,41.95%,12.64%,1
雲林縣,二崙鄉,0336,124,301,425,52,477,1271,37.53%,9.76%,1
雲林縣,二崙鄉,0337,94,270,364,42,406,912,44.52%,10.31%,1
雲林縣,二崙鄉,0338,110,247,357,32,389,861,45.18%,12.78%,1
雲林縣,二崙鄉,0339,103,307,410,48,458,1030,44.47%,10%,1
雲林縣,崙背鄉,0297,187,412,599,58,657,1176,55.87%,15.9%,1
雲林縣,崙背鄉,0298,203,481,684,38,722,1439,50.17%,14.11%,1
雲林縣,崙背鄉,0299,139,428,567,41,608,1027,59.2%,13.53%,1
雲林縣,崙背鄉,0300,193,472,665,43,708,1259,56.24%,15.33%,1
雲林縣,崙背鄉,0301,336,145,481,31,512,1058,48.39%,31.76%,1
雲林縣,崙背鄉,0302,118,306,424,33,457,998,45.79%,11.82%,1
雲林縣,崙背鄉,0303,120,317,437,26,463,968,47.83%,12.4%,1
雲林縣,崙背鄉,0304,156,343,499,52,551,1055,52.23%,14.79%,1
雲林縣,崙背鄉,0305,194,369,563,62,625,1315,47.53%,14.75%,1
雲林縣,崙背鄉,0306,82,228,310,24,334,1027,32.52%,7.98%,1
雲林縣,崙背鄉,0307,127,370,497,83,580,997,58.17%,12.74%,1
雲林縣,崙背鄉,0308,100,299,399,29,428,807,53.04%,12.39%,1
雲林縣,崙背鄉,0309,86,183,269,17,286,698,40.97%,12.32%,1
雲林縣,崙背鄉,0310,98,239,337,41,378,804,47.01%,12.19%,1
雲林縣,崙背鄉,0311,115,281,396,23,419,867,48.33%,13.26%,1
雲林縣,崙背鄉,0312,98,243,341,29,370,886,41.76%,11.06%,1
雲林縣,崙背鄉,0313,138,401,539,77,616,1476,41.73%,9.35%,1
雲林縣,崙背鄉,0314,109,271,380,28,408,1159,35.2%,9.4%,1
雲林縣,崙背鄉,0315,178,449,627,66,693,1220,56.8%,14.59%,1
雲林縣,崙背鄉,0316,123,273,396,28,424,814,52.09%,15.11%,1
雲林縣,麥寮鄉,0001,159,446,605,52,657,1497,43.89%,10.62%,1
雲林縣,麥寮鄉,0002,230,593,823,50,873,1738,50.23%,13.23%,1
雲林縣,麥寮鄉,0003,248,653,901,55,956,1921,49.77%,12.91%,1
雲林縣,麥寮鄉,0004,241,586,827,55,882,1832,48.14%,13.16%,1
雲林縣,麥寮鄉,0005,188,369,557,55,612,1340,45.67%,14.03%,1
雲林縣,麥寮鄉,0006,151,351,502,50,552,1138,48.51%,13.27%,1
雲林縣,麥寮鄉,0007,187,522,709,48,757,1551,48.81%,12.06%,1
雲林縣,麥寮鄉,0008,78,209,287,25,312,715,43.64%,10.91%,1
雲林縣,麥寮鄉,0009,144,325,469,51,520,1194,43.55%,12.06%,1
雲林縣,麥寮鄉,0010,119,337,456,32,488,1023,47.7%,11.63%,1
雲林縣,麥寮鄉,0011,167,402,569,36,605,1558,38.83%,10.72%,1
雲林縣,麥寮鄉,0012,146,307,453,25,478,1187,40.27%,12.3%,1
雲林縣,麥寮鄉,0013,117,285,402,20,422,983,42.93%,11.9%,1
雲林縣,麥寮鄉,0014,270,355,625,61,686,1363,50.33%,19.81%,1
雲林縣,麥寮鄉,0015,182,525,707,61,768,1596,48.12%,11.4%,1
雲林縣,麥寮鄉,0016,230,559,789,73,862,1469,58.68%,15.66%,1
雲林縣,麥寮鄉,0017,125,262,387,45,432,964,44.81%,12.97%,1
雲林縣,麥寮鄉,0018,121,292,413,33,446,1038,42.97%,11.66%,1
雲林縣,麥寮鄉,0019,146,423,569,52,621,1230,50.49%,11.87%,1
雲林縣,麥寮鄉,0020,164,443,607,46,653,1329,49.13%,12.34%,1
雲林縣,麥寮鄉,0021,130,403,533,72,605,1129,53.59%,11.51%,1
雲林縣,麥寮鄉,0022,195,431,626,74,700,1241,56.41%,15.71%,1
雲林縣,麥寮鄉,0023,208,505,713,93,806,1471,54.79%,14.14%,1
雲林縣,麥寮鄉,0024,169,410,579,60,639,1107,57.72%,15.27%,1
雲林縣,麥寮鄉,0025,227,606,833,67,900,1636,55.01%,13.88%,1
雲林縣,麥寮鄉,0026,227,585,812,44,856,1755,48.77%,12.93%,1
雲林縣,麥寮鄉,0027,157,430,587,35,622,1158,53.71%,13.56%,1
雲林縣,麥寮鄉,0028,166,318,484,32,516,956,53.97%,17.36%,1
雲林縣,東勢鄉,0051,319,185,504,37,541,1207,44.82%,26.43%,1
雲林縣,東勢鄉,0052,83,220,303,27,330,540,61.11%,15.37%,1
雲林縣,東勢鄉,0053,110,265,375,23,398,896,44.42%,12.28%,1
雲林縣,東勢鄉,0054,110,248,358,36,394,728,54.12%,15.11%,1
雲林縣,東勢鄉,0055,215,607,822,51,873,1533,56.95%,14.02%,1
雲林縣,東勢鄉,0056,178,476,654,66,720,1203,59.85%,14.8%,1
雲林縣,東勢鄉,0057,89,259,348,45,393,817,48.1%,10.89%,1
雲林縣,東勢鄉,0058,82,215,297,28,325,546,59.52%,15.02%,1
雲林縣,東勢鄉,0059,100,271,371,67,438,853,51.35%,11.72%,1
雲林縣,東勢鄉,0060,87,232,319,52,371,856,43.34%,10.16%,1
雲林縣,東勢鄉,0061,113,281,394,51,445,923,48.21%,12.24%,1
雲林縣,東勢鄉,0062,132,348,480,37,517,1022,50.59%,12.92%,1
雲林縣,東勢鄉,0063,46,179,225,17,242,634,38.17%,7.26%,1
雲林縣,東勢鄉,0064,49,112,161,15,176,394,44.67%,12.44%,1
雲林縣,東勢鄉,0065,92,294,386,48,434,1087,39.93%,8.46%,1
雲林縣,褒忠鄉,0066,128,349,477,44,521,923,56.45%,13.87%,1
雲林縣,褒忠鄉,0067,184,373,557,27,584,993,58.81%,18.53%,1
雲林縣,褒忠鄉,0068,125,248,373,22,395,748,52.81%,16.71%,1
雲林縣,褒忠鄉,0069,115,231,346,11,357,702,50.85%,16.38%,1
雲林縣,褒忠鄉,0070,94,272,366,20,386,752,51.33%,12.5%,1
雲林縣,褒忠鄉,0071,130,255,385,20,405,756,53.57%,17.2%,1
雲林縣,褒忠鄉,0072,75,171,246,12,258,490,52.65%,15.31%,1
雲林縣,褒忠鄉,0073,135,304,439,32,471,1034,45.55%,13.06%,1
雲林縣,褒忠鄉,0074,63,150,213,22,235,470,50%,13.4%,1
雲林縣,褒忠鄉,0075,131,216,347,24,371,737,50.34%,17.77%,1
雲林縣,褒忠鄉,0076,111,297,408,28,436,878,49.66%,12.64%,1
雲林縣,褒忠鄉,0077,103,248,351,39,390,778,50.13%,13.24%,1
雲林縣,褒忠鄉,0078,191,395,586,45,631,1224,51.55%,15.6%,1
雲林縣,褒忠鄉,0079,105,258,363,64,427,896,47.66%,11.72%,1
雲林縣,臺西鄉,0029,174,454,628,54,682,1238,55.09%,14.05%,1
雲林縣,臺西鄉,0030,120,358,478,38,516,1091,47.3%,11%,1
雲林縣,臺西鄉,0031,145,384,529,52,581,1098,52.91%,13.21%,1
雲林縣,臺西鄉,0032,124,299,423,30,453,1048,43.23%,11.83%,1
雲林縣,臺西鄉,0033,111,335,446,48,494,1025,48.2%,10.83%,1
雲林縣,臺西鄉,0034,107,285,392,37,429,850,50.47%,12.59%,1
雲林縣,臺西鄉,0035,135,445,580,67,647,1460,44.32%,9.25%,1
雲林縣,臺西鄉,0036,96,275,371,66,437,1180,37.03%,8.14%,1
雲林縣,臺西鄉,0037,49,168,217,22,239,710,33.66%,6.9%,1
雲林縣,臺西鄉,0038,60,181,241,14,255,620,41.13%,9.68%,1
雲林縣,臺西鄉,0039,61,125,186,27,213,449,47.44%,13.59%,1
雲林縣,臺西鄉,0040,65,171,236,39,275,687,40.03%,9.46%,1
雲林縣,臺西鄉,0041,140,373,513,49,562,1247,45.07%,11.23%,1
雲林縣,臺西鄉,0042,49,150,199,11,210,583,36.02%,8.4%,1
雲林縣,臺西鄉,0043,134,342,476,47,523,1042,50.19%,12.86%,1
雲林縣,臺西鄉,0044,56,147,203,16,219,472,46.4%,11.86%,1
雲林縣,臺西鄉,0045,136,430,566,31,597,1409,42.37%,9.65%,1
雲林縣,臺西鄉,0046,132,366,498,64,562,1061,52.97%,12.44%,1
雲林縣,臺西鄉,0047,110,287,397,30,427,993,43%,11.08%,1
雲林縣,臺西鄉,0048,98,321,419,73,492,1013,48.57%,9.67%,1
雲林縣,臺西鄉,0049,139,434,573,31,604,1233,48.99%,11.27%,1
雲林縣,臺西鄉,0050,67,181,248,16,264,616,42.86%,10.88%,1
雲林縣,元長鄉,0180,127,313,440,25,465,915,50.82%,13.88%,1
雲林縣,元長鄉,0181,181,408,589,21,610,1284,47.51%,14.1%,1
雲林縣,元長鄉,0182,146,357,503,39,542,1150,47.13%,12.7%,1
雲林縣,元長鄉,0183,91,203,294,36,330,744,44.35%,12.23%,1
雲林縣,元長鄉,0184,98,250,348,44,392,790,49.62%,12.41%,1
雲林縣,元長鄉,0185,114,379,493,66,559,1356,41.22%,8.41%,1
雲林縣,元長鄉,0186,85,229,314,44,358,739,48.44%,11.5%,1
雲林縣,元長鄉,0187,99,249,348,40,388,965,40.21%,10.26%,1
雲林縣,元長鄉,0188,100,302,402,62,464,1080,42.96%,9.26%,1
雲林縣,元長鄉,0189,107,243,350,34,384,948,40.51%,11.29%,1
雲林縣,元長鄉,0190,59,162,221,23,244,762,32.02%,7.74%,1
雲林縣,元長鄉,0191,80,174,254,18,272,582,46.74%,13.75%,1
雲林縣,元長鄉,0192,80,226,306,13,319,865,36.88%,9.25%,1
雲林縣,元長鄉,0193,19,57,76,6,82,362,22.65%,5.25%,1
雲林縣,元長鄉,0194,130,290,420,27,447,1162,38.47%,11.19%,1
雲林縣,元長鄉,0195,172,459,631,31,662,1527,43.35%,11.26%,1
雲林縣,元長鄉,0196,133,300,433,54,487,1006,48.41%,13.22%,1
雲林縣,元長鄉,0197,96,249,345,19,364,855,42.57%,11.23%,1
雲林縣,元長鄉,0198,143,348,491,66,557,1181,47.16%,12.11%,1
雲林縣,元長鄉,0199,95,234,329,31,360,864,41.67%,11%,1
雲林縣,元長鄉,0200,78,159,237,30,267,667,40.03%,11.69%,1
雲林縣,元長鄉,0201,109,214,323,32,355,878,40.43%,12.41%,1
雲林縣,元長鄉,0202,48,137,185,6,191,610,31.31%,7.87%,1
雲林縣,元長鄉,0203,103,246,349,51,400,837,47.79%,12.31%,1
雲林縣,元長鄉,0204,87,234,321,30,351,701,50.07%,12.41%,1
雲林縣,四湖鄉,0155,115,319,434,49,483,1082,44.64%,10.63%,1
雲林縣,四湖鄉,0156,73,255,328,38,366,676,54.14%,10.8%,1
雲林縣,四湖鄉,0157,105,309,414,18,432,862,50.12%,12.18%,1
雲林縣,四湖鄉,0158,44,112,156,22,178,477,37.32%,9.22%,1
雲林縣,四湖鄉,0159,133,370,503,30,533,952,55.99%,13.97%,1
雲林縣,四湖鄉,0160,55,175,230,20,250,650,38.46%,8.46%,1
雲林縣,四湖鄉,0161,117,289,406,23,429,969,44.27%,12.07%,1
雲林縣,四湖鄉,0162,97,229,326,49,375,925,40.54%,10.49%,1
雲林縣,四湖鄉,0163,88,288,376,28,404,914,44.2%,9.63%,1
雲林縣,四湖鄉,0164,71,133,204,39,243,759,32.02%,9.35%,1
雲林縣,四湖鄉,0165,120,315,435,44,479,1219,39.29%,9.84%,1
雲林縣,四湖鄉,0166,80,213,293,31,324,937,34.58%,8.54%,1
雲林縣,四湖鄉,0167,67,150,217,15,232,773,30.01%,8.67%,1
雲林縣,四湖鄉,0168,46,149,195,30,225,555,40.54%,8.29%,1
雲林縣,四湖鄉,0169,72,195,267,31,298,876,34.02%,8.22%,1
雲林縣,四湖鄉,0170,38,86,124,15,139,360,38.61%,10.56%,1
雲林縣,四湖鄉,0171,69,157,226,38,264,885,29.83%,7.8%,1
雲林縣,四湖鄉,0172,79,175,254,32,286,833,34.33%,9.48%,1
雲林縣,四湖鄉,0173,89,196,285,33,318,785,40.51%,11.34%,1
雲林縣,四湖鄉,0174,68,243,311,27,338,705,47.94%,9.65%,1
雲林縣,四湖鄉,0175,85,192,277,25,302,927,32.58%,9.17%,1
雲林縣,四湖鄉,0176,98,221,319,60,379,1058,35.82%,9.26%,1
雲林縣,四湖鄉,0177,94,263,357,52,409,1071,38.19%,8.78%,1
雲林縣,四湖鄉,0178,82,197,279,18,297,1022,29.06%,8.02%,1
雲林縣,四湖鄉,0179,61,211,272,33,305,711,42.9%,8.58%,1
雲林縣,口湖鄉,0205,155,369,524,64,588,1134,51.85%,13.67%,1
雲林縣,口湖鄉,0206,194,395,589,75,664,1225,54.2%,15.84%,1
雲林縣,口湖鄉,0207,54,178,232,45,277,647,42.81%,8.35%,1
雲林縣,口湖鄉,0208,89,231,320,30,350,709,49.37%,12.55%,1
雲林縣,口湖鄉,0209,119,245,364,65,429,900,47.67%,13.22%,1
雲林縣,口湖鄉,0210,127,305,432,65,497,1011,49.16%,12.56%,1
雲林縣,口湖鄉,0211,153,393,546,36,582,1437,40.5%,10.65%,1
雲林縣,口湖鄉,0212,81,180,261,13,274,848,32.31%,9.55%,1
雲林縣,口湖鄉,0213,110,345,455,26,481,1193,40.32%,9.22%,1
雲林縣,口湖鄉,0214,71,178,249,39,288,759,37.94%,9.35%,1
雲林縣,口湖鄉,0215,86,239,325,43,368,815,45.15%,10.55%,1
雲林縣,口湖鄉,0216,196,431,627,77,704,1460,48.22%,13.42%,1
雲林縣,口湖鄉,0217,65,117,182,7,189,556,33.99%,11.69%,1
雲林縣,口湖鄉,0218,169,482,651,53,704,1532,45.95%,11.03%,1
雲林縣,口湖鄉,0219,85,282,367,17,384,847,45.34%,10.04%,1
雲林縣,口湖鄉,0220,49,112,161,21,182,374,48.66%,13.1%,1
雲林縣,口湖鄉,0221,199,470,669,156,825,1508,54.71%,13.2%,1
雲林縣,口湖鄉,0222,112,363,475,53,528,951,55.52%,11.78%,1
雲林縣,口湖鄉,0223,128,331,459,67,526,910,57.8%,14.07%,1
雲林縣,口湖鄉,0224,129,351,480,36,516,879,58.7%,14.68%,1
雲林縣,口湖鄉,0225,150,337,487,104,591,1213,48.72%,12.37%,1
雲林縣,口湖鄉,0226,94,326,420,59,479,952,50.32%,9.87%,1
雲林縣,口湖鄉,0227,110,237,347,43,390,720,54.17%,15.28%,1
雲林縣,口湖鄉,0228,113,260,373,34,407,1006,40.46%,11.23%,1
雲林縣,口湖鄉,0229,51,186,237,12,249,607,41.02%,8.4%,1
雲林縣,水林鄉,0230,181,387,568,59,627,1355,46.27%,13.36%,1
雲林縣,水林鄉,0231,142,286,428,19,447,887,50.39%,16.01%,1
雲林縣,水林鄉,0232,188,431,619,44,663,1234,53.73%,15.24%,1
雲林縣,水林鄉,0233,108,243,351,19,370,763,48.49%,14.15%,1
雲林縣,水林鄉,0234,97,167,264,42,306,721,42.44%,13.45%,1
雲林縣,水林鄉,0235,63,166,229,10,239,647,36.94%,9.74%,1
雲林縣,水林鄉,0236,117,268,385,53,438,989,44.29%,11.83%,1
雲林縣,水林鄉,0237,94,203,297,31,328,837,39.19%,11.23%,1
雲林縣,水林鄉,0238,115,278,393,16,409,1081,37.84%,10.64%,1
雲林縣,水林鄉,0239,104,177,281,37,318,704,45.17%,14.77%,1
雲林縣,水林鄉,0240,133,286,419,75,494,1006,49.11%,13.22%,1
雲林縣,水林鄉,0241,75,175,250,13,263,651,40.4%,11.52%,1
雲林縣,水林鄉,0242,62,171,233,10,243,607,40.03%,10.21%,1
雲林縣,水林鄉,0243,107,265,372,60,432,1033,41.82%,10.36%,1
雲林縣,水林鄉,0244,47,141,188,17,205,631,32.49%,7.45%,1
雲林縣,水林鄉,0245,89,264,353,47,400,961,41.62%,9.26%,1
雲林縣,水林鄉,0246,274,94,368,55,423,951,44.48%,28.81%,1
雲林縣,水林鄉,0247,99,229,328,36,364,838,43.44%,11.81%,1
雲林縣,水林鄉,0248,113,307,420,81,501,1055,47.49%,10.71%,1
雲林縣,水林鄉,0249,40,108,148,28,176,512,34.38%,7.81%,1
雲林縣,水林鄉,0250,56,173,229,16,245,671,36.51%,8.35%,1
雲林縣,水林鄉,0251,60,123,183,39,222,693,32.03%,8.66%,1
雲林縣,水林鄉,0252,53,151,204,35,239,689,34.69%,7.69%,1
雲林縣,水林鄉,0253,148,286,434,62,496,1022,48.53%,14.48%,1
雲林縣,水林鄉,0254,123,343,466,33,499,1191,41.9%,10.33%,1
雲林縣,水林鄉,0255,101,285,386,36,422,779,54.17%,12.97%,1
嘉義縣,太保市,0001,179,435,614,65,679,1210,56.12%,14.79%,1
嘉義縣,太保市,0002,171,385,556,36,592,1076,55.02%,15.89%,1
嘉義縣,太保市,0003,84,145,229,14,243,488,49.8%,17.21%,1
嘉義縣,太保市,0004,197,460,657,73,730,1475,49.49%,13.36%,1
嘉義縣,太保市,0005,94,227,321,27,348,790,44.05%,11.9%,1
嘉義縣,太保市,0006,121,287,408,34,442,883,50.06%,13.7%,1
嘉義縣,太保市,0007,102,251,353,43,396,758,52.24%,13.46%,1
嘉義縣,太保市,0008,41,108,149,10,159,389,40.87%,10.54%,1
嘉義縣,太保市,0009,143,326,469,43,512,1101,46.5%,12.99%,1
嘉義縣,太保市,0010,118,305,423,17,440,853,51.58%,13.83%,1
嘉義縣,太保市,0011,35,50,85,7,92,224,41.07%,15.63%,1
嘉義縣,太保市,0012,87,188,275,47,322,662,48.64%,13.14%,1
嘉義縣,太保市,0013,253,681,934,36,970,1630,59.51%,15.52%,1
嘉義縣,太保市,0014,121,286,407,31,438,913,47.97%,13.25%,1
嘉義縣,太保市,0015,145,275,420,14,434,779,55.71%,18.61%,1
嘉義縣,太保市,0016,209,396,605,106,711,1278,55.63%,16.35%,1
嘉義縣,太保市,0017,116,248,364,33,397,819,48.47%,14.16%,1
嘉義縣,太保市,0018,230,546,776,29,805,1573,51.18%,14.62%,1
嘉義縣,太保市,0019,58,181,239,25,264,481,54.89%,12.06%,1
嘉義縣,太保市,0020,34,110,144,5,149,245,60.82%,13.88%,1
嘉義縣,太保市,0021,112,56,168,10,178,317,56.15%,35.33%,1
嘉義縣,太保市,0022,43,86,129,8,137,258,53.1%,16.67%,1
嘉義縣,太保市,0023,71,220,291,42,333,611,54.5%,11.62%,1
嘉義縣,太保市,0024,257,596,853,37,890,1526,58.32%,16.84%,1
嘉義縣,太保市,0025,207,441,648,29,677,1196,56.61%,17.31%,1
嘉義縣,太保市,0026,239,520,759,86,845,1536,55.01%,15.56%,1
嘉義縣,太保市,0027,245,521,766,58,824,1481,55.64%,16.54%,1
嘉義縣,太保市,0028,229,525,754,40,794,1450,54.76%,15.79%,1
嘉義縣,太保市,0029,129,274,403,20,423,840,50.36%,15.36%,1
嘉義縣,太保市,0030,187,332,519,26,545,989,55.11%,18.91%,1
嘉義縣,太保市,0031,218,568,786,62,848,1529,55.46%,14.26%,1
嘉義縣,太保市,0032,279,522,801,50,851,1511,56.32%,18.46%,1
嘉義縣,太保市,0033,93,212,305,35,340,697,48.78%,13.34%,1
嘉義縣,朴子市,0233,205,406,611,32,643,1183,54.35%,17.33%,1
嘉義縣,朴子市,0234,118,259,377,42,419,755,55.5%,15.63%,1
嘉義縣,朴子市,0235,179,466,645,35,680,1253,54.27%,14.29%,1
嘉義縣,朴子市,0236,195,408,603,45,648,1078,60.11%,18.09%,1
嘉義縣,朴子市,0237,210,416,626,59,685,1117,61.32%,18.8%,1
嘉義縣,朴子市,0238,75,137,212,19,231,387,59.69%,19.38%,1
嘉義縣,朴子市,0239,94,216,310,49,359,633,56.71%,14.85%,1
嘉義縣,朴子市,0240,106,234,340,27,367,650,56.46%,16.31%,1
嘉義縣,朴子市,0241,138,353,491,34,525,825,63.64%,16.73%,1
嘉義縣,朴子市,0242,127,279,406,40,446,810,55.06%,15.68%,1
嘉義縣,朴子市,0243,142,368,510,41,551,940,58.62%,15.11%,1
嘉義縣,朴子市,0244,123,316,439,48,487,905,53.81%,13.59%,1
嘉義縣,朴子市,0245,231,499,730,38,768,1605,47.85%,14.39%,1
嘉義縣,朴子市,0246,279,539,818,39,857,1479,57.94%,18.86%,1
嘉義縣,朴子市,0247,196,456,652,50,702,1218,57.64%,16.09%,1
嘉義縣,朴子市,0248,225,573,798,58,856,1496,57.22%,15.04%,1
嘉義縣,朴子市,0249,95,240,335,29,364,667,54.57%,14.24%,1
嘉義縣,朴子市,0250,68,168,236,18,254,627,40.51%,10.85%,1
嘉義縣,朴子市,0251,80,270,350,45,395,791,49.94%,10.11%,1
嘉義縣,朴子市,0252,133,352,485,88,573,1034,55.42%,12.86%,1
嘉義縣,朴子市,0253,283,527,810,22,832,1710,48.65%,16.55%,1
嘉義縣,朴子市,0254,224,537,761,35,796,1671,47.64%,13.41%,1
嘉義縣,朴子市,0255,181,442,623,47,670,1547,43.31%,11.7%,1
嘉義縣,朴子市,0256,177,418,595,62,657,1602,41.01%,11.05%,1
嘉義縣,朴子市,0257,201,517,718,20,738,1302,56.68%,15.44%,1
嘉義縣,朴子市,0258,92,240,332,44,376,740,50.81%,12.43%,1
嘉義縣,朴子市,0259,161,402,563,58,621,1054,58.92%,15.28%,1
嘉義縣,朴子市,0260,97,255,352,17,369,907,40.68%,10.69%,1
嘉義縣,朴子市,0261,94,196,290,23,313,720,43.47%,13.06%,1
嘉義縣,朴子市,0262,36,80,116,31,147,251,58.57%,14.34%,1
嘉義縣,朴子市,0263,73,212,285,49,334,767,43.55%,9.52%,1
嘉義縣,朴子市,0264,91,255,346,44,390,702,55.56%,12.96%,1
嘉義縣,朴子市,0265,109,315,424,66,490,1038,47.21%,10.5%,1
嘉義縣,朴子市,0266,114,268,382,28,410,1228,33.39%,9.28%,1
嘉義縣,朴子市,0267,51,157,208,49,257,499,51.5%,10.22%,1
嘉義縣,布袋鎮,0325,82,195,277,23,300,614,48.86%,13.36%,1
嘉義縣,布袋鎮,0326,38,110,148,21,169,372,45.43%,10.22%,1
嘉義縣,布袋鎮,0327,139,307,446,65,511,914,55.91%,15.21%,1
嘉義縣,布袋鎮,0328,159,407,566,69,635,1198,53.01%,13.27%,1
嘉義縣,布袋鎮,0329,108,365,473,51,524,1113,47.08%,9.7%,1
嘉義縣,布袋鎮,0330,143,333,476,62,538,992,54.23%,14.42%,1
嘉義縣,布袋鎮,0331,72,253,325,19,344,689,49.93%,10.45%,1
嘉義縣,布袋鎮,0332,113,283,396,65,461,882,52.27%,12.81%,1
嘉義縣,布袋鎮,0333,96,258,354,28,382,731,52.26%,13.13%,1
嘉義縣,布袋鎮,0334,87,302,389,34,423,779,54.3%,11.17%,1
嘉義縣,布袋鎮,0335,75,227,302,38,340,762,44.62%,9.84%,1
嘉義縣,布袋鎮,0336,123,356,479,55,534,1184,45.1%,10.39%,1
嘉義縣,布袋鎮,0337,139,362,501,71,572,1423,40.2%,9.77%,1
嘉義縣,布袋鎮,0338,141,344,485,66,551,1351,40.78%,10.44%,1
嘉義縣,布袋鎮,0339,25,91,116,7,123,275,44.73%,9.09%,1
嘉義縣,布袋鎮,0340,27,75,102,13,115,243,47.33%,11.11%,1
嘉義縣,布袋鎮,0341,77,210,287,76,363,661,54.92%,11.65%,1
嘉義縣,布袋鎮,0342,134,359,493,46,539,1145,47.07%,11.7%,1
嘉義縣,布袋鎮,0343,116,294,410,30,440,936,47.01%,12.39%,1
嘉義縣,布袋鎮,0344,142,277,419,37,456,958,47.6%,14.82%,1
嘉義縣,布袋鎮,0345,34,85,119,16,135,298,45.3%,11.41%,1
嘉義縣,布袋鎮,0346,64,154,218,30,248,428,57.94%,14.95%,1
嘉義縣,布袋鎮,0347,14,38,52,1,53,121,43.8%,11.57%,1
嘉義縣,布袋鎮,0348,13,32,45,6,51,174,29.31%,7.47%,1
嘉義縣,布袋鎮,0349,111,303,414,39,453,953,47.53%,11.65%,1
嘉義縣,布袋鎮,0350,167,478,645,47,692,1292,53.56%,12.93%,1
嘉義縣,布袋鎮,0351,127,436,563,45,608,1127,53.95%,11.27%,1
嘉義縣,布袋鎮,0352,166,407,573,30,603,1244,48.47%,13.34%,1
嘉義縣,布袋鎮,0353,146,338,484,21,505,1106,45.66%,13.2%,1
嘉義縣,大林鎮,0169,75,171,246,22,268,483,55.49%,15.53%,1
嘉義縣,大林鎮,0170,290,673,963,58,1021,1823,56.01%,15.91%,1
嘉義縣,大林鎮,0171,139,381,520,23,543,955,56.86%,14.55%,1
嘉義縣,大林鎮,0172,229,484,713,33,746,1436,51.95%,15.95%,1
嘉義縣,大林鎮,0173,251,452,703,60,763,1390,54.89%,18.06%,1
嘉義縣,大林鎮,0174,241,549,790,62,852,1512,56.35%,15.94%,1
嘉義縣,大林鎮,0175,271,559,830,46,876,1536,57.03%,17.64%,1
嘉義縣,大林鎮,0176,154,369,523,39,562,1165,48.24%,13.22%,1
嘉義縣,大林鎮,0177,362,603,965,56,1021,1730,59.02%,20.92%,1
嘉義縣,大林鎮,0178,63,182,245,16,261,602,43.36%,10.47%,1
嘉義縣,大林鎮,0179,107,208,315,41,356,716,49.72%,14.94%,1
嘉義縣,大林鎮,0180,65,174,239,12,251,625,40.16%,10.4%,1
嘉義縣,大林鎮,0181,21,50,71,3,74,193,38.34%,10.88%,1
嘉義縣,大林鎮,0182,208,484,692,69,761,1642,46.35%,12.67%,1
嘉義縣,大林鎮,0183,178,519,697,62,759,1465,51.81%,12.15%,1
嘉義縣,大林鎮,0184,101,267,368,42,410,928,44.18%,10.88%,1
嘉義縣,大林鎮,0185,35,102,137,23,160,361,44.32%,9.7%,1
嘉義縣,大林鎮,0186,115,265,380,15,395,814,48.53%,14.13%,1
嘉義縣,大林鎮,0187,212,509,721,40,761,1579,48.2%,13.43%,1
嘉義縣,大林鎮,0188,279,689,968,74,1042,2041,51.05%,13.67%,1
嘉義縣,大林鎮,0189,117,304,421,53,474,931,50.91%,12.57%,1
嘉義縣,大林鎮,0190,89,222,311,36,347,675,51.41%,13.19%,1
嘉義縣,大林鎮,0191,71,231,302,25,327,655,49.92%,10.84%,1
嘉義縣,大林鎮,0192,114,263,377,34,411,833,49.34%,13.69%,1
嘉義縣,大林鎮,0193,133,323,456,44,500,832,60.1%,15.99%,1
嘉義縣,民雄鄉,0093,227,468,695,37,732,1267,57.77%,17.92%,1
嘉義縣,民雄鄉,0094,159,331,490,35,525,1030,50.97%,15.44%,1
嘉義縣,民雄鄉,0095,262,604,866,82,948,1590,59.62%,16.48%,1
嘉義縣,民雄鄉,0096,272,558,830,29,859,1673,51.34%,16.26%,1
嘉義縣,民雄鄉,0097,292,629,921,62,983,1718,57.22%,17%,1
嘉義縣,民雄鄉,0098,184,380,564,51,615,1040,59.13%,17.69%,1
嘉義縣,民雄鄉,0099,150,395,545,48,593,1100,53.91%,13.64%,1
嘉義縣,民雄鄉,0100,228,498,726,71,797,1559,51.12%,14.62%,1
嘉義縣,民雄鄉,0101,267,603,870,76,946,1862,50.81%,14.34%,1
嘉義縣,民雄鄉,0102,249,490,739,70,809,1435,56.38%,17.35%,1
嘉義縣,民雄鄉,0103,282,496,778,139,917,1751,52.37%,16.11%,1
嘉義縣,民雄鄉,0104,143,350,493,39,532,933,57.02%,15.33%,1
嘉義縣,民雄鄉,0105,151,327,478,39,517,827,62.52%,18.26%,1
嘉義縣,民雄鄉,0106,119,241,360,43,403,843,47.81%,14.12%,1
嘉義縣,民雄鄉,0107,259,615,874,62,936,1774,52.76%,14.6%,1
嘉義縣,民雄鄉,0108,55,110,165,17,182,385,47.27%,14.29%,1
嘉義縣,民雄鄉,0109,244,484,728,32,760,1306,58.19%,18.68%,1
嘉義縣,民雄鄉,0110,83,204,287,33,320,535,59.81%,15.51%,1
嘉義縣,民雄鄉,0111,165,397,562,54,616,1055,58.39%,15.64%,1
嘉義縣,民雄鄉,0112,207,542,749,52,801,1476,54.27%,14.02%,1
嘉義縣,民雄鄉,0113,202,550,752,44,796,1583,50.28%,12.76%,1
嘉義縣,民雄鄉,0114,102,226,328,29,357,758,47.1%,13.46%,1
嘉義縣,民雄鄉,0115,196,441,637,38,675,1354,49.85%,14.48%,1
嘉義縣,民雄鄉,0116,194,435,629,63,692,1202,57.57%,16.14%,1
嘉義縣,民雄鄉,0117,193,409,602,45,647,1175,55.06%,16.43%,1
嘉義縣,民雄鄉,0118,237,461,698,36,734,1423,51.58%,16.65%,1
嘉義縣,民雄鄉,0119,242,579,821,29,850,1612,52.73%,15.01%,1
嘉義縣,民雄鄉,0120,262,646,908,31,939,1695,55.4%,15.46%,1
嘉義縣,民雄鄉,0121,214,527,741,48,789,1665,47.39%,12.85%,1
嘉義縣,民雄鄉,0122,111,334,445,51,496,1019,48.68%,10.89%,1
嘉義縣,民雄鄉,0123,186,458,644,62,706,1352,52.22%,13.76%,1
嘉義縣,民雄鄉,0124,200,617,817,82,899,1620,55.49%,12.35%,1
嘉義縣,民雄鄉,0125,140,301,441,33,474,943,50.27%,14.85%,1
嘉義縣,民雄鄉,0126,209,539,748,49,797,1720,46.34%,12.15%,1
嘉義縣,民雄鄉,0127,235,650,885,77,962,1875,51.31%,12.53%,1
嘉義縣,民雄鄉,0128,217,456,673,54,727,1305,55.71%,16.63%,1
嘉義縣,民雄鄉,0129,223,472,695,56,751,1441,52.12%,15.48%,1
嘉義縣,民雄鄉,0130,224,510,734,53,787,1413,55.7%,15.85%,1
嘉義縣,民雄鄉,0131,238,532,770,59,829,1560,53.14%,15.26%,1
嘉義縣,民雄鄉,0132,715,314,1029,88,1117,2004,55.74%,35.68%,1
嘉義縣,民雄鄉,0133,220,516,736,63,799,1354,59.01%,16.25%,1
嘉義縣,民雄鄉,0134,161,412,573,24,597,1076,55.48%,14.96%,1
嘉義縣,民雄鄉,0135,221,580,801,112,913,1629,56.05%,13.57%,1
嘉義縣,民雄鄉,0136,268,668,936,70,1006,1977,50.89%,13.56%,1
嘉義縣,民雄鄉,0137,200,402,602,87,689,1295,53.2%,15.44%,1
嘉義縣,溪口鄉,0194,195,468,663,91,754,1318,57.21%,14.8%,1
嘉義縣,溪口鄉,0195,111,235,346,48,394,677,58.2%,16.4%,1
嘉義縣,溪口鄉,0196,56,137,193,19,212,417,50.84%,13.43%,1
嘉義縣,溪口鄉,0197,48,88,136,20,156,273,57.14%,17.58%,1
嘉義縣,溪口鄉,0198,145,321,466,64,530,908,58.37%,15.97%,1
嘉義縣,溪口鄉,0199,58,104,162,11,173,386,44.82%,15.03%,1
嘉義縣,溪口鄉,0200,178,347,525,52,577,1039,55.53%,17.13%,1
嘉義縣,溪口鄉,0201,90,191,281,47,328,708,46.33%,12.71%,1
嘉義縣,溪口鄉,0202,138,270,408,22,430,909,47.3%,15.18%,1
嘉義縣,溪口鄉,0203,127,260,387,46,433,786,55.09%,16.16%,1
嘉義縣,溪口鄉,0204,106,235,341,49,390,807,48.33%,13.14%,1
嘉義縣,溪口鄉,0205,195,266,461,26,487,1168,41.7%,16.7%,1
嘉義縣,溪口鄉,0206,179,327,506,80,586,1052,55.7%,17.02%,1
嘉義縣,溪口鄉,0207,80,164,244,41,285,565,50.44%,14.16%,1
嘉義縣,溪口鄉,0208,49,134,183,26,209,388,53.87%,12.63%,1
嘉義縣,溪口鄉,0209,83,183,266,28,294,701,41.94%,11.84%,1
嘉義縣,溪口鄉,0210,107,283,390,40,430,1003,42.87%,10.67%,1
嘉義縣,新港鄉,0138,176,376,552,30,582,1087,53.54%,16.19%,1
嘉義縣,新港鄉,0139,206,485,691,53,744,1116,66.67%,18.46%,1
嘉義縣,新港鄉,0140,116,252,368,43,411,740,55.54%,15.68%,1
嘉義縣,新港鄉,0141,129,246,375,65,440,827,53.2%,15.6%,1
嘉義縣,新港鄉,0142,131,254,385,48,433,704,61.51%,18.61%,1
嘉義縣,新港鄉,0143,141,287,428,44,472,768,61.46%,18.36%,1
嘉義縣,新港鄉,0144,145,270,415,42,457,761,60.05%,19.05%,1
嘉義縣,新港鄉,0145,123,276,399,49,448,850,52.71%,14.47%,1
嘉義縣,新港鄉,0146,185,462,647,54,701,1327,52.83%,13.94%,1
嘉義縣,新港鄉,0147,118,245,363,54,417,756,55.16%,15.61%,1
嘉義縣,新港鄉,0148,129,253,382,81,463,816,56.74%,15.81%,1
嘉義縣,新港鄉,0149,95,189,284,33,317,667,47.53%,14.24%,1
嘉義縣,新港鄉,0150,144,316,460,42,502,942,53.29%,15.29%,1
嘉義縣,新港鄉,0151,91,284,375,67,442,918,48.15%,9.91%,1
嘉義縣,新港鄉,0152,66,166,232,9,241,554,43.5%,11.91%,1
嘉義縣,新港鄉,0153,138,284,422,33,455,929,48.98%,14.85%,1
嘉義縣,新港鄉,0154,67,103,170,35,205,487,42.09%,13.76%,1
嘉義縣,新港鄉,0155,59,166,225,45,270,487,55.44%,12.11%,1
嘉義縣,新港鄉,0156,135,244,379,45,424,836,50.72%,16.15%,1
嘉義縣,新港鄉,0157,137,288,425,47,472,845,55.86%,16.21%,1
嘉義縣,新港鄉,0158,151,262,413,49,462,834,55.4%,18.11%,1
嘉義縣,新港鄉,0159,142,239,381,44,425,753,56.44%,18.86%,1
嘉義縣,新港鄉,0160,207,436,643,62,705,1328,53.09%,15.59%,1
嘉義縣,新港鄉,0161,160,356,516,40,556,969,57.38%,16.51%,1
嘉義縣,新港鄉,0162,163,393,556,64,620,1043,59.44%,15.63%,1
嘉義縣,新港鄉,0163,226,556,782,63,845,1400,60.36%,16.14%,1
嘉義縣,新港鄉,0164,102,242,344,23,367,1017,36.09%,10.03%,1
嘉義縣,新港鄉,0165,143,336,479,44,523,1132,46.2%,12.63%,1
嘉義縣,新港鄉,0166,156,331,487,53,540,1037,52.07%,15.04%,1
嘉義縣,新港鄉,0167,79,204,283,50,333,563,59.15%,14.03%,1
嘉義縣,新港鄉,0168,121,278,399,25,424,849,49.94%,14.25%,1
嘉義縣,六腳鄉,0268,132,350,482,34,516,1165,44.29%,11.33%,1
嘉義縣,六腳鄉,0269,75,199,274,16,290,825,35.15%,9.09%,1
嘉義縣,六腳鄉,0270,121,241,362,26,388,850,45.65%,14.24%,1
嘉義縣,六腳鄉,0271,44,74,118,14,132,222,59.46%,19.82%,1
嘉義縣,六腳鄉,0272,170,363,533,62,595,1216,48.93%,13.98%,1
嘉義縣,六腳鄉,0273,118,303,421,47,468,1200,39%,9.83%,1
嘉義縣,六腳鄉,0274,109,260,369,41,410,877,46.75%,12.43%,1
嘉義縣,六腳鄉,0275,87,148,235,40,275,644,42.7%,13.51%,1
嘉義縣,六腳鄉,0276,63,139,202,17,219,594,36.87%,10.61%,1
嘉義縣,六腳鄉,0277,11,30,41,1,42,167,25.15%,6.59%,1
嘉義縣,六腳鄉,0278,24,45,69,1,70,204,34.31%,11.76%,1
嘉義縣,六腳鄉,0279,35,54,89,1,90,234,38.46%,14.96%,1
嘉義縣,六腳鄉,0280,36,104,140,6,146,361,40.44%,9.97%,1
嘉義縣,六腳鄉,0281,87,202,289,43,332,592,56.08%,14.7%,1
嘉義縣,六腳鄉,0282,81,194,275,36,311,619,50.24%,13.09%,1
嘉義縣,六腳鄉,0283,70,169,239,41,280,714,39.22%,9.8%,1
嘉義縣,六腳鄉,0284,123,331,454,64,518,1051,49.29%,11.7%,1
嘉義縣,六腳鄉,0285,119,305,424,60,484,934,51.82%,12.74%,1
嘉義縣,六腳鄉,0286,129,330,459,57,516,1044,49.43%,12.36%,1
嘉義縣,六腳鄉,0287,183,410,593,39,632,1476,42.82%,12.4%,1
嘉義縣,六腳鄉,0288,65,144,209,19,228,618,36.89%,10.52%,1
嘉義縣,六腳鄉,0289,33,95,128,34,162,478,33.89%,6.9%,1
嘉義縣,六腳鄉,0290,62,138,200,36,236,642,36.76%,9.66%,1
嘉義縣,六腳鄉,0291,82,194,276,16,292,883,33.07%,9.29%,1
嘉義縣,六腳鄉,0292,55,181,236,5,241,739,32.61%,7.44%,1
嘉義縣,六腳鄉,0293,65,132,197,22,219,554,39.53%,11.73%,1
嘉義縣,六腳鄉,0294,63,131,194,25,219,649,33.74%,9.71%,1
嘉義縣,六腳鄉,0295,69,160,229,19,248,689,35.99%,10.01%,1
嘉義縣,六腳鄉,0296,37,118,155,21,176,455,38.68%,8.13%,1
嘉義縣,六腳鄉,0297,7,28,35,3,38,125,30.4%,5.6%,1
嘉義縣,東石鄉,0298,201,603,804,84,888,1915,46.37%,10.5%,1
嘉義縣,東石鄉,0299,99,234,333,43,376,938,40.09%,10.55%,1
嘉義縣,東石鄉,0300,106,268,374,30,404,1366,29.58%,7.76%,1
嘉義縣,東石鄉,0301,148,483,631,9,640,1676,38.19%,8.83%,1
嘉義縣,東石鄉,0302,112,286,398,78,476,1151,41.36%,9.73%,1
嘉義縣,東石鄉,0303,75,189,264,57,321,716,44.83%,10.47%,1
嘉義縣,東石鄉,0304,30,88,118,15,133,387,34.37%,7.75%,1
嘉義縣,東石鄉,0305,58,175,233,15,248,864,28.7%,6.71%,1
嘉義縣,東石鄉,0306,71,206,277,20,297,910,32.64%,7.8%,1
嘉義縣,東石鄉,0307,59,186,245,14,259,760,34.08%,7.76%,1
嘉義縣,東石鄉,0308,11,61,72,15,87,166,52.41%,6.63%,1
嘉義縣,東石鄉,0309,15,55,70,10,80,212,37.74%,7.08%,1
嘉義縣,東石鄉,0310,68,226,294,37,331,993,33.33%,6.85%,1
嘉義縣,東石鄉,0311,20,93,113,9,122,306,39.87%,6.54%,1
嘉義縣,東石鄉,0312,82,265,347,64,411,1046,39.29%,7.84%,1
嘉義縣,東石鄉,0313,13,65,78,12,90,235,38.3%,5.53%,1
嘉義縣,東石鄉,0314,118,370,488,70,558,1226,45.51%,9.62%,1
嘉義縣,東石鄉,0315,88,222,310,55,365,843,43.3%,10.44%,1
嘉義縣,東石鄉,0316,76,184,260,30,290,693,41.85%,10.97%,1
嘉義縣,東石鄉,0317,83,283,366,46,412,839,49.11%,9.89%,1
嘉義縣,東石鄉,0318,33,117,150,15,165,363,45.45%,9.09%,1
嘉義縣,東石鄉,0319,33,69,102,10,112,321,34.89%,10.28%,1
嘉義縣,東石鄉,0320,133,372,505,91,596,1083,55.03%,12.28%,1
嘉義縣,東石鄉,0321,119,243,362,53,415,901,46.06%,13.21%,1
嘉義縣,東石鄉,0322,86,282,368,36,404,1216,33.22%,7.07%,1
嘉義縣,東石鄉,0323,62,149,211,38,249,418,59.57%,14.83%,1
嘉義縣,東石鄉,0324,33,115,148,7,155,371,41.78%,8.89%,1
嘉義縣,義竹鄉,0354,62,144,206,26,232,482,48.13%,12.86%,1
嘉義縣,義竹鄉,0355,26,83,109,21,130,223,58.3%,11.66%,1
嘉義縣,義竹鄉,0356,233,507,740,84,824,1529,53.89%,15.24%,1
嘉義縣,義竹鄉,0357,173,427,600,59,659,1175,56.09%,14.72%,1
嘉義縣,義竹鄉,0358,151,332,483,64,547,886,61.74%,17.04%,1
嘉義縣,義竹鄉,0359,91,214,305,31,336,743,45.22%,12.25%,1
嘉義縣,義竹鄉,0360,184,406,590,91,681,1236,55.1%,14.89%,1
嘉義縣,義竹鄉,0361,53,116,169,25,194,377,51.46%,14.06%,1
嘉義縣,義竹鄉,0362,38,92,130,23,153,338,45.27%,11.24%,1
嘉義縣,義竹鄉,0363,12,45,57,2,59,102,57.84%,11.76%,1
嘉義縣,義竹鄉,0364,101,212,313,23,336,763,44.04%,13.24%,1
嘉義縣,義竹鄉,0365,62,157,219,29,248,429,57.81%,14.45%,1
嘉義縣,義竹鄉,0366,57,141,198,14,212,427,49.65%,13.35%,1
嘉義縣,義竹鄉,0367,90,194,284,47,331,607,54.53%,14.83%,1
嘉義縣,義竹鄉,0368,200,438,638,46,684,1486,46.03%,13.46%,1
嘉義縣,義竹鄉,0369,104,317,421,57,478,835,57.25%,12.46%,1
嘉義縣,義竹鄉,0370,94,201,295,59,354,816,43.38%,11.52%,1
嘉義縣,義竹鄉,0371,117,214,331,54,385,833,46.22%,14.05%,1
嘉義縣,義竹鄉,0372,42,160,202,12,214,433,49.42%,9.7%,1
嘉義縣,義竹鄉,0373,63,176,239,5,244,558,43.73%,11.29%,1
嘉義縣,義竹鄉,0374,91,187,278,35,313,602,51.99%,15.12%,1
嘉義縣,義竹鄉,0375,13,42,55,2,57,140,40.71%,9.29%,1
嘉義縣,義竹鄉,0376,48,111,159,20,179,393,45.55%,12.21%,1
嘉義縣,義竹鄉,0377,75,194,269,22,291,585,49.74%,12.82%,1
嘉義縣,義竹鄉,0378,41,135,176,7,183,526,34.79%,7.79%,1
嘉義縣,義竹鄉,0379,18,49,67,7,74,123,60.16%,14.63%,1
嘉義縣,鹿草鄉,0034,80,128,208,33,241,522,46.17%,15.33%,1
嘉義縣,鹿草鄉,0035,98,177,275,30,305,563,54.17%,17.41%,1
嘉義縣,鹿草鄉,0036,188,383,571,75,646,1304,49.54%,14.42%,1
嘉義縣,鹿草鄉,0037,200,412,612,48,660,1312,50.3%,15.24%,1
嘉義縣,鹿草鄉,0038,44,98,142,3,145,320,45.31%,13.75%,1
嘉義縣,鹿草鄉,0039,25,80,105,5,110,418,26.32%,5.98%,1
嘉義縣,鹿草鄉,0040,118,271,389,56,445,1025,43.41%,11.51%,1
嘉義縣,鹿草鄉,0041,56,111,167,19,186,451,41.24%,12.42%,1
嘉義縣,鹿草鄉,0042,79,289,368,78,446,830,53.73%,9.52%,1
嘉義縣,鹿草鄉,0043,143,280,423,68,491,1050,46.76%,13.62%,1
嘉義縣,鹿草鄉,0044,110,223,333,65,398,972,40.95%,11.32%,1
嘉義縣,鹿草鄉,0045,129,270,399,47,446,962,46.36%,13.41%,1
嘉義縣,鹿草鄉,0046,113,193,306,45,351,678,51.77%,16.67%,1
嘉義縣,鹿草鄉,0047,31,86,117,17,134,262,51.15%,11.83%,1
嘉義縣,鹿草鄉,0048,127,222,349,42,391,906,43.16%,14.02%,1
嘉義縣,鹿草鄉,0049,24,74,98,9,107,306,34.97%,7.84%,1
嘉義縣,鹿草鄉,0050,150,334,484,60,544,1062,51.22%,14.12%,1
嘉義縣,鹿草鄉,0051,49,129,178,18,196,373,52.55%,13.14%,1
嘉義縣,鹿草鄉,0052,42,111,153,22,175,324,54.01%,12.96%,1
嘉義縣,鹿草鄉,0053,33,102,135,15,150,297,50.51%,11.11%,1
嘉義縣,水上鄉,0054,123,366,489,27,516,1024,50.39%,12.01%,1
嘉義縣,水上鄉,0055,179,389,568,47,615,1015,60.59%,17.64%,1
嘉義縣,水上鄉,0056,258,619,877,69,946,1932,48.96%,13.35%,1
嘉義縣,水上鄉,0057,202,437,639,45,684,1170,58.46%,17.26%,1
嘉義縣,水上鄉,0058,206,497,703,63,766,1305,58.7%,15.79%,1
嘉義縣,水上鄉,0059,277,295,572,46,618,1242,49.76%,22.3%,1
嘉義縣,水上鄉,0060,49,94,143,16,159,324,49.07%,15.12%,1
嘉義縣,水上鄉,0061,87,216,303,23,326,622,52.41%,13.99%,1
嘉義縣,水上鄉,0062,180,392,572,57,629,1216,51.73%,14.8%,1
嘉義縣,水上鄉,0063,159,376,535,23,558,1020,54.71%,15.59%,1
嘉義縣,水上鄉,0064,137,310,447,34,481,771,62.39%,17.77%,1
嘉義縣,水上鄉,0065,114,144,258,19,277,441,62.81%,25.85%,1
嘉義縣,水上鄉,0066,128,235,363,50,413,626,65.97%,20.45%,1
嘉義縣,水上鄉,0067,104,201,305,34,339,570,59.47%,18.25%,1
嘉義縣,水上鄉,0068,43,124,167,25,192,368,52.17%,11.68%,1
嘉義縣,水上鄉,0069,147,304,451,86,537,1037,51.78%,14.18%,1
嘉義縣,水上鄉,0070,167,353,520,60,580,1065,54.46%,15.68%,1
嘉義縣,水上鄉,0071,136,285,421,89,510,802,63.59%,16.96%,1
嘉義縣,水上鄉,0072,279,652,931,44,975,1948,50.05%,14.32%,1
嘉義縣,水上鄉,0073,136,332,468,54,522,1028,50.78%,13.23%,1
嘉義縣,水上鄉,0074,100,248,348,25,373,641,58.19%,15.6%,1
嘉義縣,水上鄉,0075,62,169,231,10,241,408,59.07%,15.2%,1
嘉義縣,水上鄉,0076,140,276,416,42,458,794,57.68%,17.63%,1
嘉義縣,水上鄉,0077,71,177,248,23,271,569,47.63%,12.48%,1
嘉義縣,水上鄉,0078,122,296,418,32,450,806,55.83%,15.14%,1
嘉義縣,水上鄉,0079,129,381,510,43,553,960,57.6%,13.44%,1
嘉義縣,水上鄉,0080,334,709,1043,73,1116,2035,54.84%,16.41%,1
嘉義縣,水上鄉,0081,301,670,971,88,1059,1987,53.3%,15.15%,1
嘉義縣,水上鄉,0082,162,435,597,29,626,1154,54.25%,14.04%,1
嘉義縣,水上鄉,0083,305,741,1046,70,1116,2208,50.54%,13.81%,1
嘉義縣,水上鄉,0084,259,625,884,57,941,2102,44.77%,12.32%,1
嘉義縣,水上鄉,0085,155,445,600,57,657,1309,50.19%,11.84%,1
嘉義縣,水上鄉,0086,258,570,828,79,907,1671,54.28%,15.44%,1
嘉義縣,水上鄉,0087,109,298,407,41,448,822,54.5%,13.26%,1
嘉義縣,水上鄉,0088,230,617,847,46,893,1772,50.4%,12.98%,1
嘉義縣,水上鄉,0089,262,663,925,82,1007,1919,52.48%,13.65%,1
嘉義縣,水上鄉,0090,114,283,397,17,414,912,45.39%,12.5%,1
嘉義縣,水上鄉,0091,127,344,471,25,496,992,50%,12.8%,1
嘉義縣,水上鄉,0092,158,364,522,48,570,1270,44.88%,12.44%,1
嘉義縣,中埔鄉,0380,100,299,399,26,425,1046,40.63%,9.56%,1
嘉義縣,中埔鄉,0381,252,510,762,82,844,1788,47.2%,14.09%,1
嘉義縣,中埔鄉,0382,225,522,747,42,789,1730,45.61%,13.01%,1
嘉義縣,中埔鄉,0383,224,500,724,52,776,1581,49.08%,14.17%,1
嘉義縣,中埔鄉,0384,189,453,642,39,681,1594,42.72%,11.86%,1
嘉義縣,中埔鄉,0385,279,605,884,33,917,1801,50.92%,15.49%,1
嘉義縣,中埔鄉,0386,236,619,855,55,910,1862,48.87%,12.67%,1
嘉義縣,中埔鄉,0387,229,568,797,28,825,1803,45.76%,12.7%,1
嘉義縣,中埔鄉,0388,211,506,717,54,771,1481,52.06%,14.25%,1
嘉義縣,中埔鄉,0389,200,468,668,56,724,1366,53%,14.64%,1
嘉義縣,中埔鄉,0390,184,474,658,58,716,1599,44.78%,11.51%,1
嘉義縣,中埔鄉,0391,182,383,565,38,603,1196,50.42%,15.22%,1
嘉義縣,中埔鄉,0392,228,508,736,92,828,1809,45.77%,12.6%,1
嘉義縣,中埔鄉,0393,130,305,435,23,458,953,48.06%,13.64%,1
嘉義縣,中埔鄉,0394,180,436,616,55,671,1441,46.56%,12.49%,1
嘉義縣,中埔鄉,0395,202,597,799,67,866,1882,46.01%,10.73%,1
嘉義縣,中埔鄉,0396,160,378,538,18,556,1470,37.82%,10.88%,1
嘉義縣,中埔鄉,0397,186,494,680,76,756,1699,44.5%,10.95%,1
嘉義縣,中埔鄉,0398,37,120,157,18,175,422,41.47%,8.77%,1
嘉義縣,中埔鄉,0399,140,315,455,58,513,1030,49.81%,13.59%,1
嘉義縣,中埔鄉,0400,125,267,392,31,423,879,48.12%,14.22%,1
嘉義縣,中埔鄉,0401,94,249,343,20,363,828,43.84%,11.35%,1
嘉義縣,中埔鄉,0402,119,325,444,62,506,881,57.43%,13.51%,1
嘉義縣,中埔鄉,0403,39,98,137,11,148,296,50%,13.18%,1
嘉義縣,中埔鄉,0404,118,296,414,65,479,979,48.93%,12.05%,1
嘉義縣,中埔鄉,0405,143,378,521,40,561,1268,44.24%,11.28%,1
嘉義縣,中埔鄉,0406,66,130,196,10,206,670,30.75%,9.85%,1
嘉義縣,中埔鄉,0407,115,257,372,59,431,754,57.16%,15.25%,1
嘉義縣,中埔鄉,0408,122,200,322,35,357,648,55.09%,18.83%,1
嘉義縣,中埔鄉,0409,86,188,274,25,299,741,40.35%,11.61%,1
嘉義縣,中埔鄉,0410,67,154,221,12,233,518,44.98%,12.93%,1
嘉義縣,中埔鄉,0411,66,149,215,27,242,482,50.21%,13.69%,1
嘉義縣,中埔鄉,0412,39,100,139,8,147,348,42.24%,11.21%,1
嘉義縣,中埔鄉,0413,40,97,137,11,148,294,50.34%,13.61%,1
嘉義縣,竹崎鄉,0414,207,445,652,37,689,1312,52.52%,15.78%,1
嘉義縣,竹崎鄉,0415,178,455,633,22,655,1210,54.13%,14.71%,1
嘉義縣,竹崎鄉,0416,128,390,518,35,553,991,55.8%,12.92%,1
嘉義縣,竹崎鄉,0417,168,432,600,30,630,1207,52.2%,13.92%,1
嘉義縣,竹崎鄉,0418,110,216,326,12,338,752,44.95%,14.63%,1
嘉義縣,竹崎鄉,0419,129,302,431,54,485,833,58.22%,15.49%,1
嘉義縣,竹崎鄉,0420,162,470,632,62,694,1220,56.89%,13.28%,1
嘉義縣,竹崎鄉,0421,93,243,336,19,355,616,57.63%,15.1%,1
嘉義縣,竹崎鄉,0422,120,360,480,49,529,1031,51.31%,11.64%,1
嘉義縣,竹崎鄉,0423,155,464,619,50,669,1292,51.78%,12%,1
嘉義縣,竹崎鄉,0424,281,763,1044,58,1102,1995,55.24%,14.09%,1
嘉義縣,竹崎鄉,0425,248,659,907,27,934,1996,46.79%,12.42%,1
嘉義縣,竹崎鄉,0426,307,380,687,71,758,1449,52.31%,21.19%,1
嘉義縣,竹崎鄉,0427,190,514,704,34,738,1420,51.97%,13.38%,1
嘉義縣,竹崎鄉,0428,219,601,820,46,866,1590,54.47%,13.77%,1
嘉義縣,竹崎鄉,0429,99,264,363,28,391,771,50.71%,12.84%,1
嘉義縣,竹崎鄉,0430,140,290,430,50,480,1014,47.34%,13.81%,1
嘉義縣,竹崎鄉,0431,27,86,113,5,118,327,36.09%,8.26%,1
嘉義縣,竹崎鄉,0432,71,274,345,22,367,687,53.42%,10.33%,1
嘉義縣,竹崎鄉,0433,73,223,296,19,315,641,49.14%,11.39%,1
嘉義縣,竹崎鄉,0434,70,180,250,10,260,474,54.85%,14.77%,1
嘉義縣,竹崎鄉,0435,43,136,179,15,194,383,50.65%,11.23%,1
嘉義縣,竹崎鄉,0436,81,256,337,41,378,619,61.07%,13.09%,1
嘉義縣,竹崎鄉,0437,29,63,92,8,100,214,46.73%,13.55%,1
嘉義縣,竹崎鄉,0438,206,526,732,83,815,1568,51.98%,13.14%,1
嘉義縣,竹崎鄉,0439,58,218,276,26,302,658,45.9%,8.81%,1
嘉義縣,竹崎鄉,0440,62,161,223,31,254,434,58.53%,14.29%,1
嘉義縣,竹崎鄉,0441,124,328,452,46,498,917,54.31%,13.52%,1
嘉義縣,竹崎鄉,0442,129,303,432,46,478,981,48.73%,13.15%,1
嘉義縣,竹崎鄉,0443,91,260,351,18,369,789,46.77%,11.53%,1
嘉義縣,竹崎鄉,0444,6,20,26,4,30,108,27.78%,5.56%,1
嘉義縣,竹崎鄉,0445,24,37,61,2,63,235,26.81%,10.21%,1
嘉義縣,竹崎鄉,0446,41,104,145,4,149,331,45.02%,12.39%,1
嘉義縣,竹崎鄉,0447,77,189,266,8,274,450,60.89%,17.11%,1
嘉義縣,竹崎鄉,0448,40,147,187,7,194,462,41.99%,8.66%,1
嘉義縣,竹崎鄉,0449,21,72,93,13,106,251,42.23%,8.37%,1
嘉義縣,梅山鄉,0211,170,338,508,28,536,1041,51.49%,16.33%,1
嘉義縣,梅山鄉,0212,187,464,651,91,742,1245,59.6%,15.02%,1
嘉義縣,梅山鄉,0213,166,333,499,48,547,917,59.65%,18.1%,1
嘉義縣,梅山鄉,0214,195,398,593,51,644,1189,54.16%,16.4%,1
嘉義縣,梅山鄉,0215,228,494,722,67,789,1388,56.84%,16.43%,1
嘉義縣,梅山鄉,0216,279,644,923,54,977,1827,53.48%,15.27%,1
嘉義縣,梅山鄉,0217,113,190,303,41,344,545,63.12%,20.73%,1
嘉義縣,梅山鄉,0218,61,92,153,30,183,407,44.96%,14.99%,1
嘉義縣,梅山鄉,0219,91,236,327,34,361,636,56.76%,14.31%,1
嘉義縣,梅山鄉,0220,82,217,299,36,335,576,58.16%,14.24%,1
嘉義縣,梅山鄉,0221,231,614,845,81,926,1674,55.32%,13.8%,1
嘉義縣,梅山鄉,0222,90,283,373,11,384,858,44.76%,10.49%,1
嘉義縣,梅山鄉,0223,79,228,307,24,331,526,62.93%,15.02%,1
嘉義縣,梅山鄉,0224,50,100,150,30,180,372,48.39%,13.44%,1
嘉義縣,梅山鄉,0225,73,154,227,26,253,506,50%,14.43%,1
嘉義縣,梅山鄉,0226,62,207,269,40,309,433,71.36%,14.32%,1
嘉義縣,梅山鄉,0227,36,123,159,6,165,404,40.84%,8.91%,1
嘉義縣,梅山鄉,0228,39,99,138,11,149,293,50.85%,13.31%,1
嘉義縣,梅山鄉,0229,84,293,377,70,447,712,62.78%,11.8%,1
嘉義縣,梅山鄉,0230,77,260,337,36,373,602,61.96%,12.79%,1
嘉義縣,梅山鄉,0231,47,177,224,27,251,515,48.74%,9.13%,1
嘉義縣,梅山鄉,0232,33,117,150,14,164,417,39.33%,7.91%,1
嘉義縣,番路鄉,0450,198,451,649,61,710,1174,60.48%,16.87%,1
嘉義縣,番路鄉,0451,71,192,263,9,272,449,60.58%,15.81%,1
嘉義縣,番路鄉,0452,105,311,416,37,453,753,60.16%,13.94%,1
嘉義縣,番路鄉,0453,61,176,237,27,264,551,47.91%,11.07%,1
嘉義縣,番路鄉,0454,282,657,939,66,1005,1791,56.11%,15.75%,1
嘉義縣,番路鄉,0455,134,358,492,46,538,849,63.37%,15.78%,1
嘉義縣,番路鄉,0456,139,335,474,26,500,866,57.74%,16.05%,1
嘉義縣,番路鄉,0457,79,331,410,29,439,800,54.88%,9.88%,1
嘉義縣,番路鄉,0458,74,160,234,24,258,444,58.11%,16.67%,1
嘉義縣,番路鄉,0459,59,193,252,11,263,635,41.42%,9.29%,1
嘉義縣,番路鄉,0460,32,106,138,9,147,319,46.08%,10.03%,1
嘉義縣,番路鄉,0461,60,308,368,20,388,642,60.44%,9.35%,1
嘉義縣,番路鄉,0462,38,175,213,19,232,509,45.58%,7.47%,1
嘉義縣,番路鄉,0463,13,77,90,1,91,162,56.17%,8.02%,1
嘉義縣,番路鄉,0464,19,93,112,9,121,212,57.08%,8.96%,1
嘉義縣,大埔鄉,0465,241,507,748,61,809,1468,55.11%,16.42%,1
嘉義縣,大埔鄉,0466,33,92,125,3,128,320,40%,10.31%,1
嘉義縣,大埔鄉,0467,52,114,166,8,174,304,57.24%,17.11%,1
嘉義縣,大埔鄉,0468,21,70,91,2,93,184,50.54%,11.41%,1
嘉義縣,大埔鄉,0469,45,108,153,6,159,234,67.95%,19.23%,1
嘉義縣,大埔鄉,0470,76,165,241,9,250,495,50.51%,15.35%,1
嘉義縣,大埔鄉,0471,32,78,110,5,115,199,57.79%,16.08%,1
嘉義縣,大埔鄉,0472,28,76,104,7,111,226,49.12%,12.39%,1
嘉義縣,大埔鄉,0473,84,244,328,20,348,569,61.16%,14.76%,1
嘉義縣,阿里山鄉,0474,40,136,176,9,185,371,49.87%,10.78%,1
嘉義縣,阿里山鄉,0475,17,66,83,4,87,197,44.16%,8.63%,1
嘉義縣,阿里山鄉,0476,11,56,67,2,69,152,45.39%,7.24%,1
嘉義縣,阿里山鄉,0477,19,54,73,6,79,231,34.2%,8.23%,1
嘉義縣,阿里山鄉,0478,3,18,21,0,21,72,29.17%,4.17%,1
嘉義縣,阿里山鄉,0479,27,110,137,4,141,311,45.34%,8.68%,1
嘉義縣,阿里山鄉,0480,28,126,154,9,163,306,53.27%,9.15%,1
嘉義縣,阿里山鄉,0481,100,341,441,15,456,970,47.01%,10.31%,1
嘉義縣,阿里山鄉,0482,94,330,424,30,454,827,54.9%,11.37%,1
嘉義縣,阿里山鄉,0483,23,103,126,1,127,238,53.36%,9.66%,1
嘉義縣,阿里山鄉,0484,20,105,125,11,136,479,28.39%,4.18%,1
嘉義縣,阿里山鄉,0485,28,77,105,7,112,291,38.49%,9.62%,1
嘉義縣,阿里山鄉,0486,27,117,144,14,158,246,64.23%,10.98%,1
屏東縣,屏東市,0001,79,44,123,5,128,237,54.01%,33.33%,1
屏東縣,屏東市,0002,53,94,147,19,166,294,56.46%,18.03%,1
屏東縣,屏東市,0003,132,167,299,17,316,582,54.3%,22.68%,1
屏東縣,屏東市,0004,145,239,384,24,408,713,57.22%,20.34%,1
屏東縣,屏東市,0005,106,186,292,26,318,572,55.59%,18.53%,1
屏東縣,屏東市,0006,84,194,278,5,283,455,62.2%,18.46%,1
屏東縣,屏東市,0007,51,89,140,0,140,249,56.22%,20.48%,1
屏東縣,屏東市,0008,181,422,603,24,627,1315,47.68%,13.76%,1
屏東縣,屏東市,0009,243,387,630,36,666,1373,48.51%,17.7%,1
屏東縣,屏東市,0010,145,283,428,31,459,713,64.38%,20.34%,1
屏東縣,屏東市,0011,122,215,337,29,366,573,63.87%,21.29%,1
屏東縣,屏東市,0012,65,121,186,16,202,297,68.01%,21.89%,1
屏東縣,屏東市,0013,83,185,268,15,283,409,69.19%,20.29%,1
屏東縣,屏東市,0014,50,91,141,19,160,286,55.94%,17.48%,1
屏東縣,屏東市,0015,81,159,240,9,249,421,59.14%,19.24%,1
屏東縣,屏東市,0016,119,190,309,14,323,569,56.77%,20.91%,1
屏東縣,屏東市,0017,105,133,238,11,249,459,54.25%,22.88%,1
屏東縣,屏東市,0018,157,254,411,20,431,672,64.14%,23.36%,1
屏東縣,屏東市,0019,154,235,389,35,424,668,63.47%,23.05%,1
屏東縣,屏東市,0020,89,135,224,12,236,411,57.42%,21.65%,1
屏東縣,屏東市,0021,126,288,414,25,439,768,57.16%,16.41%,1
屏東縣,屏東市,0022,135,271,406,31,437,786,55.6%,17.18%,1
屏東縣,屏東市,0023,169,323,492,33,525,890,58.99%,18.99%,1
屏東縣,屏東市,0024,214,508,722,38,760,1353,56.17%,15.82%,1
屏東縣,屏東市,0025,205,514,719,19,738,1386,53.25%,14.79%,1
屏東縣,屏東市,0026,249,487,736,29,765,1413,54.14%,17.62%,1
屏東縣,屏東市,0027,182,477,659,28,687,1272,54.01%,14.31%,1
屏東縣,屏東市,0028,234,452,686,20,706,1287,54.86%,18.18%,1
屏東縣,屏東市,0029,244,461,705,31,736,1311,56.14%,18.61%,1
屏東縣,屏東市,0030,211,485,696,19,715,1285,55.64%,16.42%,1
屏東縣,屏東市,0031,240,475,715,30,745,1297,57.44%,18.5%,1
屏東縣,屏東市,0032,216,489,705,20,725,1361,53.27%,15.87%,1
屏東縣,屏東市,0033,194,479,673,39,712,1381,51.56%,14.05%,1
屏東縣,屏東市,0034,222,474,696,47,743,1258,59.06%,17.65%,1
屏東縣,屏東市,0035,215,459,674,40,714,1259,56.71%,17.08%,1
屏東縣,屏東市,0036,168,392,560,31,591,1076,54.93%,15.61%,1
屏東縣,屏東市,0037,217,428,645,25,670,1162,57.66%,18.67%,1
屏東縣,屏東市,0038,246,484,730,21,751,1318,56.98%,18.66%,1
屏東縣,屏東市,0039,163,333,496,30,526,939,56.02%,17.36%,1
屏東縣,屏東市,0040,176,366,542,20,562,972,57.82%,18.11%,1
屏東縣,屏東市,0041,286,554,840,32,872,1535,56.81%,18.63%,1
屏東縣,屏東市,0042,188,470,658,30,688,1419,48.48%,13.25%,1
屏東縣,屏東市,0043,193,479,672,13,685,1398,49%,13.81%,1
屏東縣,屏東市,0044,239,469,708,46,754,1405,53.67%,17.01%,1
屏東縣,屏東市,0045,247,540,787,28,815,1486,54.85%,16.62%,1
屏東縣,屏東市,0046,196,337,533,58,591,1061,55.7%,18.47%,1
屏東縣,屏東市,0047,227,455,682,75,757,1540,49.16%,14.74%,1
屏東縣,屏東市,0048,191,345,536,17,553,1141,48.47%,16.74%,1
屏東縣,屏東市,0049,218,369,587,37,624,1247,50.04%,17.48%,1
屏東縣,屏東市,0050,243,460,703,31,734,1446,50.76%,16.8%,1
屏東縣,屏東市,0051,212,512,724,26,750,1303,57.56%,16.27%,1
屏東縣,屏東市,0052,187,473,660,30,690,1253,55.07%,14.92%,1
屏東縣,屏東市,0053,206,473,679,36,715,1315,54.37%,15.67%,1
屏東縣,屏東市,0054,240,454,694,33,727,1425,51.02%,16.84%,1
屏東縣,屏東市,0055,218,502,720,15,735,1423,51.65%,15.32%,1
屏東縣,屏東市,0056,223,528,751,45,796,1400,56.86%,15.93%,1
屏東縣,屏東市,0057,265,484,749,38,787,1359,57.91%,19.5%,1
屏東縣,屏東市,0058,176,524,700,18,718,1328,54.07%,13.25%,1
屏東縣,屏東市,0059,216,592,808,28,836,1539,54.32%,14.04%,1
屏東縣,屏東市,0060,48,93,141,4,145,391,37.08%,12.28%,1
屏東縣,屏東市,0061,32,73,105,12,117,200,58.5%,16%,1
屏東縣,屏東市,0062,48,97,145,22,167,328,50.91%,14.63%,1
屏東縣,屏東市,0063,30,87,117,4,121,231,52.38%,12.99%,1
屏東縣,屏東市,0064,121,328,449,54,503,945,53.23%,12.8%,1
屏東縣,屏東市,0065,181,335,516,38,554,1053,52.61%,17.19%,1
屏東縣,屏東市,0066,139,341,480,58,538,1043,51.58%,13.33%,1
屏東縣,屏東市,0067,153,348,501,53,554,1061,52.21%,14.42%,1
屏東縣,屏東市,0068,132,281,413,39,452,876,51.6%,15.07%,1
屏東縣,屏東市,0069,176,512,688,86,774,1468,52.72%,11.99%,1
屏東縣,屏東市,0070,214,457,671,57,728,1454,50.07%,14.72%,1
屏東縣,屏東市,0071,225,418,643,22,665,1205,55.19%,18.67%,1
屏東縣,屏東市,0072,216,420,636,29,665,1284,51.79%,16.82%,1
屏東縣,屏東市,0073,188,387,575,40,615,1219,50.45%,15.42%,1
屏東縣,屏東市,0074,257,545,802,73,875,1544,56.67%,16.65%,1
屏東縣,屏東市,0075,238,494,732,76,808,1485,54.41%,16.03%,1
屏東縣,屏東市,0076,229,507,736,34,770,1387,55.52%,16.51%,1
屏東縣,屏東市,0077,134,343,477,19,496,953,52.05%,14.06%,1
屏東縣,屏東市,0078,289,564,853,35,888,1603,55.4%,18.03%,1
屏東縣,屏東市,0079,105,166,271,27,298,535,55.7%,19.63%,1
屏東縣,屏東市,0080,169,379,548,42,590,1119,52.73%,15.1%,1
屏東縣,屏東市,0081,134,312,446,31,477,847,56.32%,15.82%,1
屏東縣,屏東市,0082,177,312,489,61,550,923,59.59%,19.18%,1
屏東縣,屏東市,0083,208,391,599,32,631,1227,51.43%,16.95%,1
屏東縣,屏東市,0084,140,385,525,45,570,1039,54.86%,13.47%,1
屏東縣,屏東市,0085,215,493,708,86,794,1485,53.47%,14.48%,1
屏東縣,屏東市,0086,146,289,435,43,478,867,55.13%,16.84%,1
屏東縣,屏東市,0087,138,331,469,37,506,918,55.12%,15.03%,1
屏東縣,屏東市,0088,86,222,308,36,344,663,51.89%,12.97%,1
屏東縣,屏東市,0089,177,371,548,24,572,1215,47.08%,14.57%,1
屏東縣,屏東市,0090,261,462,723,63,786,1628,48.28%,16.03%,1
屏東縣,屏東市,0091,222,407,629,46,675,1209,55.83%,18.36%,1
屏東縣,屏東市,0092,180,500,680,19,699,1110,62.97%,16.22%,1
屏東縣,屏東市,0093,83,222,305,18,323,684,47.22%,12.13%,1
屏東縣,屏東市,0094,199,383,582,33,615,1349,45.59%,14.75%,1
屏東縣,屏東市,0095,204,458,662,60,722,1457,49.55%,14%,1
屏東縣,屏東市,0096,243,517,760,33,793,1447,54.8%,16.79%,1
屏東縣,屏東市,0097,238,418,656,26,682,1354,50.37%,17.58%,1
屏東縣,屏東市,0098,273,564,837,54,891,1583,56.29%,17.25%,1
屏東縣,屏東市,0099,235,631,866,17,883,1707,51.73%,13.77%,1
屏東縣,屏東市,0100,221,528,749,17,766,1637,46.79%,13.5%,1
屏東縣,屏東市,0101,195,504,699,32,731,1459,50.1%,13.37%,1
屏東縣,屏東市,0102,275,647,922,35,957,1759,54.41%,15.63%,1
屏東縣,屏東市,0103,292,680,972,35,1007,1950,51.64%,14.97%,1
屏東縣,屏東市,0104,241,648,889,28,917,1729,53.04%,13.94%,1
屏東縣,屏東市,0105,239,550,789,24,813,1592,51.07%,15.01%,1
屏東縣,屏東市,0106,211,478,689,24,713,1437,49.62%,14.68%,1
屏東縣,屏東市,0107,143,443,586,30,616,1204,51.16%,11.88%,1
屏東縣,屏東市,0108,177,630,807,27,834,1340,62.24%,13.21%,1
屏東縣,屏東市,0109,198,487,685,33,718,1322,54.31%,14.98%,1
屏東縣,屏東市,0110,197,514,711,38,749,1462,51.23%,13.47%,1
屏東縣,屏東市,0111,465,1076,1541,48,1589,3241,49.03%,14.35%,1
屏東縣,屏東市,0112,206,504,710,15,725,1477,49.09%,13.95%,1
屏東縣,屏東市,0113,111,273,384,17,401,821,48.84%,13.52%,1
屏東縣,屏東市,0114,143,333,476,21,497,1099,45.22%,13.01%,1
屏東縣,屏東市,0115,193,640,833,39,872,1688,51.66%,11.43%,1
屏東縣,屏東市,0116,197,369,566,30,596,1167,51.07%,16.88%,1
屏東縣,屏東市,0117,136,317,453,37,490,915,53.55%,14.86%,1
屏東縣,屏東市,0118,147,353,500,27,527,1683,31.31%,8.73%,1
屏東縣,屏東市,0119,156,584,740,17,757,1497,50.57%,10.42%,1
屏東縣,屏東市,0120,157,400,557,27,584,1129,51.73%,13.91%,1
屏東縣,屏東市,0121,185,455,640,27,667,1232,54.14%,15.02%,1
屏東縣,屏東市,0122,132,312,444,21,465,853,54.51%,15.47%,1
屏東縣,屏東市,0123,153,335,488,21,509,869,58.57%,17.61%,1
屏東縣,屏東市,0124,190,442,632,38,670,1169,57.31%,16.25%,1
屏東縣,屏東市,0125,173,389,562,31,593,1058,56.05%,16.35%,1
屏東縣,屏東市,0126,205,437,642,29,671,1344,49.93%,15.25%,1
屏東縣,屏東市,0127,218,459,677,23,700,1299,53.89%,16.78%,1
屏東縣,屏東市,0128,191,390,581,30,611,1204,50.75%,15.86%,1
屏東縣,屏東市,0129,180,387,567,26,593,1123,52.8%,16.03%,1
屏東縣,屏東市,0130,197,394,591,32,623,1318,47.27%,14.95%,1
屏東縣,屏東市,0131,155,317,472,44,516,865,59.65%,17.92%,1
屏東縣,屏東市,0132,137,351,488,24,512,1100,46.55%,12.45%,1
屏東縣,屏東市,0133,184,386,570,24,594,1215,48.89%,15.14%,1
屏東縣,屏東市,0134,200,496,696,30,726,1370,52.99%,14.6%,1
屏東縣,屏東市,0135,176,461,637,20,657,1240,52.98%,14.19%,1
屏東縣,屏東市,0136,219,416,635,34,669,1168,57.28%,18.75%,1
屏東縣,屏東市,0137,173,400,573,16,589,1079,54.59%,16.03%,1
屏東縣,屏東市,0138,231,462,693,50,743,1289,57.64%,17.92%,1
屏東縣,屏東市,0139,188,384,572,20,592,1115,53.09%,16.86%,1
屏東縣,屏東市,0140,259,530,789,47,836,1491,56.07%,17.37%,1
屏東縣,屏東市,0141,199,464,663,19,682,1411,48.33%,14.1%,1
屏東縣,屏東市,0142,288,605,893,22,915,1803,50.75%,15.97%,1
屏東縣,屏東市,0143,112,295,407,20,427,744,57.39%,15.05%,1
屏東縣,屏東市,0144,112,234,346,25,371,678,54.72%,16.52%,1
屏東縣,屏東市,0145,116,269,385,16,401,681,58.88%,17.03%,1
屏東縣,屏東市,0146,116,535,651,36,687,1535,44.76%,7.56%,1
屏東縣,屏東市,0147,142,342,484,62,546,954,57.23%,14.88%,1
屏東縣,屏東市,0148,183,396,579,36,615,1018,60.41%,17.98%,1
屏東縣,屏東市,0149,209,422,631,24,655,1154,56.76%,18.11%,1
屏東縣,潮州鎮,0150,87,188,275,30,305,504,60.52%,17.26%,1
屏東縣,潮州鎮,0151,252,527,779,38,817,1711,47.75%,14.73%,1
屏東縣,潮州鎮,0152,240,570,810,24,834,1634,51.04%,14.69%,1
屏東縣,潮州鎮,0153,191,452,643,24,667,1414,47.17%,13.51%,1
屏東縣,潮州鎮,0154,110,224,334,44,378,603,62.69%,18.24%,1
屏東縣,潮州鎮,0155,132,303,435,55,490,896,54.69%,14.73%,1
屏東縣,潮州鎮,0156,183,447,630,46,676,1285,52.61%,14.24%,1
屏東縣,潮州鎮,0157,238,587,825,41,866,1744,49.66%,13.65%,1
屏東縣,潮州鎮,0158,168,412,580,36,616,1071,57.52%,15.69%,1
屏東縣,潮州鎮,0159,179,481,660,54,714,1209,59.06%,14.81%,1
屏東縣,潮州鎮,0160,182,406,588,33,621,1159,53.58%,15.7%,1
屏東縣,潮州鎮,0161,190,436,626,41,667,1296,51.47%,14.66%,1
屏東縣,潮州鎮,0162,220,510,730,51,781,1466,53.27%,15.01%,1
屏東縣,潮州鎮,0163,170,435,605,44,649,1130,57.43%,15.04%,1
屏東縣,潮州鎮,0164,230,504,734,45,779,1439,54.13%,15.98%,1
屏東縣,潮州鎮,0165,127,358,485,42,527,897,58.75%,14.16%,1
屏東縣,潮州鎮,0166,175,478,653,42,695,1225,56.73%,14.29%,1
屏東縣,潮州鎮,0167,174,361,535,50,585,1158,50.52%,15.03%,1
屏東縣,潮州鎮,0168,64,125,189,28,217,481,45.11%,13.31%,1
屏東縣,潮州鎮,0169,169,352,521,37,558,972,57.41%,17.39%,1
屏東縣,潮州鎮,0170,200,484,684,46,730,1245,58.63%,16.06%,1
屏東縣,潮州鎮,0171,205,507,712,41,753,1415,53.22%,14.49%,1
屏東縣,潮州鎮,0172,200,369,569,17,586,1255,46.69%,15.94%,1
屏東縣,潮州鎮,0173,118,287,405,25,430,1058,40.64%,11.15%,1
屏東縣,潮州鎮,0174,174,407,581,33,614,1187,51.73%,14.66%,1
屏東縣,潮州鎮,0175,159,397,556,55,611,1083,56.42%,14.68%,1
屏東縣,潮州鎮,0176,222,505,727,33,760,1590,47.8%,13.96%,1
屏東縣,潮州鎮,0177,215,585,800,50,850,1543,55.09%,13.93%,1
屏東縣,潮州鎮,0178,244,521,765,45,810,1631,49.66%,14.96%,1
屏東縣,潮州鎮,0179,167,438,605,22,627,1159,54.1%,14.41%,1
屏東縣,潮州鎮,0180,171,424,595,25,620,1099,56.41%,15.56%,1
屏東縣,潮州鎮,0181,157,383,540,50,590,1200,49.17%,13.08%,1
屏東縣,潮州鎮,0182,154,503,657,46,703,1391,50.54%,11.07%,1
屏東縣,潮州鎮,0183,135,327,462,44,506,881,57.43%,15.32%,1
屏東縣,潮州鎮,0184,46,144,190,20,210,454,46.26%,10.13%,1
屏東縣,潮州鎮,0185,240,587,827,66,893,1658,53.86%,14.48%,1
屏東縣,潮州鎮,0186,110,264,374,28,402,822,48.91%,13.38%,1
屏東縣,潮州鎮,0187,191,201,392,32,424,948,44.73%,20.15%,1
屏東縣,潮州鎮,0188,136,335,471,27,498,1194,41.71%,11.39%,1
屏東縣,潮州鎮,0189,51,112,163,28,191,337,56.68%,15.13%,1
屏東縣,東港鎮,0190,156,382,538,46,584,981,59.53%,15.9%,1
屏東縣,東港鎮,0191,180,402,582,55,637,1070,59.53%,16.82%,1
屏東縣,東港鎮,0192,73,236,309,38,347,527,65.84%,13.85%,1
屏東縣,東港鎮,0193,61,161,222,18,240,395,60.76%,15.44%,1
屏東縣,東港鎮,0194,88,219,307,31,338,659,51.29%,13.35%,1
屏東縣,東港鎮,0195,84,177,261,23,284,513,55.36%,16.37%,1
屏東縣,東港鎮,0196,262,579,841,50,891,1732,51.44%,15.13%,1
屏東縣,東港鎮,0197,266,636,902,51,953,1779,53.57%,14.95%,1
屏東縣,東港鎮,0198,176,431,607,36,643,1270,50.63%,13.86%,1
屏東縣,東港鎮,0199,185,465,650,47,697,1327,52.52%,13.94%,1
屏東縣,東港鎮,0200,200,444,644,56,700,1242,56.36%,16.1%,1
屏東縣,東港鎮,0201,234,583,817,67,884,1607,55.01%,14.56%,1
屏東縣,東港鎮,0202,195,400,595,45,640,1305,49.04%,14.94%,1
屏東縣,東港鎮,0203,102,257,359,32,391,695,56.26%,14.68%,1
屏東縣,東港鎮,0204,176,415,591,69,660,1076,61.34%,16.36%,1
屏東縣,東港鎮,0205,76,186,262,29,291,567,51.32%,13.4%,1
屏東縣,東港鎮,0206,115,264,379,32,411,806,50.99%,14.27%,1
屏東縣,東港鎮,0207,176,440,616,67,683,1227,55.66%,14.34%,1
屏東縣,東港鎮,0208,70,200,270,55,325,599,54.26%,11.69%,1
屏東縣,東港鎮,0209,147,391,538,38,576,1354,42.54%,10.86%,1
屏東縣,東港鎮,0210,150,196,346,45,391,734,53.27%,20.44%,1
屏東縣,東港鎮,0211,152,372,524,111,635,1107,57.36%,13.73%,1
屏東縣,東港鎮,0212,165,359,524,74,598,1198,49.92%,13.77%,1
屏東縣,東港鎮,0213,223,493,716,98,814,1614,50.43%,13.82%,1
屏東縣,東港鎮,0214,114,267,381,42,423,826,51.21%,13.8%,1
屏東縣,東港鎮,0215,129,337,466,54,520,912,57.02%,14.14%,1
屏東縣,東港鎮,0216,57,147,204,24,228,432,52.78%,13.19%,1
屏東縣,東港鎮,0217,181,412,593,88,681,1204,56.56%,15.03%,1
屏東縣,東港鎮,0218,185,480,665,54,719,1304,55.14%,14.19%,1
屏東縣,東港鎮,0219,201,492,693,54,747,1317,56.72%,15.26%,1
屏東縣,東港鎮,0220,189,482,671,37,708,1387,51.05%,13.63%,1
屏東縣,東港鎮,0221,160,408,568,37,605,1310,46.18%,12.21%,1
屏東縣,東港鎮,0222,191,377,568,37,605,1228,49.27%,15.55%,1
屏東縣,東港鎮,0223,108,224,332,41,373,766,48.69%,14.1%,1
屏東縣,東港鎮,0224,150,285,435,45,480,823,58.32%,18.23%,1
屏東縣,東港鎮,0225,77,196,273,16,289,755,38.28%,10.2%,1
屏東縣,東港鎮,0226,159,402,561,66,627,1094,57.31%,14.53%,1
屏東縣,東港鎮,0227,86,259,345,27,372,753,49.4%,11.42%,1
屏東縣,恆春鎮,0228,98,295,393,32,425,902,47.12%,10.86%,1
屏東縣,恆春鎮,0229,165,356,521,33,554,969,57.17%,17.03%,1
屏東縣,恆春鎮,0230,195,391,586,44,630,1280,49.22%,15.23%,1
屏東縣,恆春鎮,0231,175,413,588,22,610,1133,53.84%,15.45%,1
屏東縣,恆春鎮,0232,203,440,643,15,658,1552,42.4%,13.08%,1
屏東縣,恆春鎮,0233,182,394,576,47,623,1485,41.95%,12.26%,1
屏東縣,恆春鎮,0234,110,330,440,42,482,896,53.79%,12.28%,1
屏東縣,恆春鎮,0235,68,161,229,21,250,531,47.08%,12.81%,1
屏東縣,恆春鎮,0236,59,150,209,10,219,478,45.82%,12.34%,1
屏東縣,恆春鎮,0237,139,310,449,40,489,1020,47.94%,13.63%,1
屏東縣,恆春鎮,0238,151,274,425,21,446,924,48.27%,16.34%,1
屏東縣,恆春鎮,0239,134,313,447,26,473,1079,43.84%,12.42%,1
屏東縣,恆春鎮,0240,74,229,303,20,323,775,41.68%,9.55%,1
屏東縣,恆春鎮,0241,89,319,408,45,453,813,55.72%,10.95%,1
屏東縣,恆春鎮,0242,133,344,477,46,523,1104,47.37%,12.05%,1
屏東縣,恆春鎮,0243,150,300,450,46,496,1110,44.68%,13.51%,1
屏東縣,恆春鎮,0244,84,164,248,49,297,692,42.92%,12.14%,1
屏東縣,恆春鎮,0245,73,177,250,10,260,708,36.72%,10.31%,1
屏東縣,恆春鎮,0246,427,282,709,17,726,1505,48.24%,28.37%,1
屏東縣,恆春鎮,0247,140,332,472,44,516,1111,46.44%,12.6%,1
屏東縣,恆春鎮,0248,182,491,673,34,707,1543,45.82%,11.8%,1
屏東縣,恆春鎮,0249,117,203,320,17,337,828,40.7%,14.13%,1
屏東縣,恆春鎮,0250,137,278,415,29,444,844,52.61%,16.23%,1
屏東縣,恆春鎮,0251,190,381,571,38,609,1253,48.6%,15.16%,1
屏東縣,恆春鎮,0252,138,337,475,38,513,1126,45.56%,12.26%,1
屏東縣,萬丹鄉,0253,185,440,625,47,672,1527,44.01%,12.12%,1
屏東縣,萬丹鄉,0254,157,351,508,61,569,1147,49.61%,13.69%,1
屏東縣,萬丹鄉,0255,145,278,423,37,460,949,48.47%,15.28%,1
屏東縣,萬丹鄉,0256,139,300,439,40,479,990,48.38%,14.04%,1
屏東縣,萬丹鄉,0257,132,337,469,13,482,1022,47.16%,12.92%,1
屏東縣,萬丹鄉,0258,101,217,318,50,368,545,67.52%,18.53%,1
屏東縣,萬丹鄉,0259,170,450,620,86,706,1159,60.91%,14.67%,1
屏東縣,萬丹鄉,0260,150,287,437,64,501,837,59.86%,17.92%,1
屏東縣,萬丹鄉,0261,58,123,181,17,198,392,50.51%,14.8%,1
屏東縣,萬丹鄉,0262,130,320,450,37,487,847,57.5%,15.35%,1
屏東縣,萬丹鄉,0263,160,390,550,39,589,1149,51.26%,13.93%,1
屏東縣,萬丹鄉,0264,176,387,563,45,608,1131,53.76%,15.56%,1
屏東縣,萬丹鄉,0265,185,377,562,48,610,1178,51.78%,15.7%,1
屏東縣,萬丹鄉,0266,116,286,402,23,425,711,59.77%,16.32%,1
屏東縣,萬丹鄉,0267,116,225,341,22,363,595,61.01%,19.5%,1
屏東縣,萬丹鄉,0268,241,515,756,52,808,1403,57.59%,17.18%,1
屏東縣,萬丹鄉,0269,137,377,514,30,544,1094,49.73%,12.52%,1
屏東縣,萬丹鄉,0270,185,435,620,31,651,1158,56.22%,15.98%,1
屏東縣,萬丹鄉,0271,174,378,552,52,604,963,62.72%,18.07%,1
屏東縣,萬丹鄉,0272,179,367,546,38,584,1062,54.99%,16.85%,1
屏東縣,萬丹鄉,0273,234,578,812,73,885,1684,52.55%,13.9%,1
屏東縣,萬丹鄉,0274,244,556,800,29,829,1702,48.71%,14.34%,1
屏東縣,萬丹鄉,0275,152,354,506,33,539,976,55.23%,15.57%,1
屏東縣,萬丹鄉,0276,151,346,497,61,558,1013,55.08%,14.91%,1
屏東縣,萬丹鄉,0277,94,250,344,42,386,847,45.57%,11.1%,1
屏東縣,萬丹鄉,0278,244,553,797,115,912,1570,58.09%,15.54%,1
屏東縣,萬丹鄉,0279,170,466,636,60,696,1411,49.33%,12.05%,1
屏東縣,萬丹鄉,0280,189,340,529,71,600,1046,57.36%,18.07%,1
屏東縣,萬丹鄉,0281,212,454,666,30,696,1385,50.25%,15.31%,1
屏東縣,萬丹鄉,0282,107,306,413,33,446,804,55.47%,13.31%,1
屏東縣,萬丹鄉,0283,202,423,625,78,703,1284,54.75%,15.73%,1
屏東縣,萬丹鄉,0284,205,450,655,48,703,1430,49.16%,14.34%,1
屏東縣,萬丹鄉,0285,169,373,542,58,600,960,62.5%,17.6%,1
屏東縣,萬丹鄉,0286,128,309,437,42,479,786,60.94%,16.28%,1
屏東縣,萬丹鄉,0287,206,371,577,71,648,1158,55.96%,17.79%,1
屏東縣,萬丹鄉,0288,196,447,643,68,711,1647,43.17%,11.9%,1
屏東縣,萬丹鄉,0289,228,483,711,65,776,1666,46.58%,13.69%,1
屏東縣,萬丹鄉,0290,170,396,566,60,626,1023,61.19%,16.62%,1
屏東縣,萬丹鄉,0291,201,468,669,48,717,1227,58.44%,16.38%,1
屏東縣,長治鄉,0292,134,387,521,47,568,1018,55.8%,13.16%,1
屏東縣,長治鄉,0293,562,253,815,67,882,1614,54.65%,34.82%,1
屏東縣,長治鄉,0294,316,694,1010,60,1070,1848,57.9%,17.1%,1
屏東縣,長治鄉,0295,259,609,868,56,924,1707,54.13%,15.17%,1
屏東縣,長治鄉,0296,166,359,525,23,548,972,56.38%,17.08%,1
屏東縣,長治鄉,0297,159,365,524,46,570,989,57.63%,16.08%,1
屏東縣,長治鄉,0298,114,283,397,48,445,735,60.54%,15.51%,1
屏東縣,長治鄉,0299,286,549,835,60,895,1813,49.37%,15.77%,1
屏東縣,長治鄉,0300,183,415,598,53,651,1073,60.67%,17.05%,1
屏東縣,長治鄉,0301,244,562,806,66,872,1654,52.72%,14.75%,1
屏東縣,長治鄉,0302,217,389,606,56,662,1205,54.94%,18.01%,1
屏東縣,長治鄉,0303,122,284,406,27,433,758,57.12%,16.09%,1
屏東縣,長治鄉,0304,242,489,731,83,814,1492,54.56%,16.22%,1
屏東縣,長治鄉,0305,139,321,460,50,510,884,57.69%,15.72%,1
屏東縣,長治鄉,0306,176,393,569,55,624,1090,57.25%,16.15%,1
屏東縣,長治鄉,0307,192,429,621,68,689,1422,48.45%,13.5%,1
屏東縣,長治鄉,0308,123,292,415,51,466,845,55.15%,14.56%,1
屏東縣,長治鄉,0309,135,313,448,87,535,925,57.84%,14.59%,1
屏東縣,長治鄉,0310,145,408,553,69,622,1138,54.66%,12.74%,1
屏東縣,長治鄉,0311,179,443,622,77,699,1242,56.28%,14.41%,1
屏東縣,長治鄉,0312,195,366,561,21,582,1159,50.22%,16.82%,1
屏東縣,長治鄉,0313,103,267,370,32,402,673,59.73%,15.3%,1
屏東縣,麟洛鄉,0314,131,283,414,34,448,788,56.85%,16.62%,1
屏東縣,麟洛鄉,0315,200,598,798,31,829,1386,59.81%,14.43%,1
屏東縣,麟洛鄉,0316,167,387,554,34,588,957,61.44%,17.45%,1
屏東縣,麟洛鄉,0317,117,288,405,43,448,731,61.29%,16.01%,1
屏東縣,麟洛鄉,0318,159,297,456,48,504,806,62.53%,19.73%,1
屏東縣,麟洛鄉,0319,209,375,584,22,606,1207,50.21%,17.32%,1
屏東縣,麟洛鄉,0320,253,490,743,70,813,1340,60.67%,18.88%,1
屏東縣,麟洛鄉,0321,200,420,620,58,678,1221,55.53%,16.38%,1
屏東縣,麟洛鄉,0322,153,284,437,20,457,851,53.7%,17.98%,1
屏東縣,麟洛鄉,0323,106,238,344,11,355,683,51.98%,15.52%,1
屏東縣,九如鄉,0324,249,512,761,76,837,1491,56.14%,16.7%,1
屏東縣,九如鄉,0325,221,442,663,75,738,1375,53.67%,16.07%,1
屏東縣,九如鄉,0326,224,550,774,57,831,1678,49.52%,13.35%,1
屏東縣,九如鄉,0327,194,420,614,71,685,1166,58.75%,16.64%,1
屏東縣,九如鄉,0328,185,348,533,37,570,1276,44.67%,14.5%,1
屏東縣,九如鄉,0329,167,356,523,60,583,1033,56.44%,16.17%,1
屏東縣,九如鄉,0330,108,245,353,44,397,577,68.8%,18.72%,1
屏東縣,九如鄉,0331,107,234,341,57,398,649,61.33%,16.49%,1
屏東縣,九如鄉,0332,303,650,953,140,1093,1999,54.68%,15.16%,1
屏東縣,九如鄉,0333,261,564,825,92,917,1766,51.93%,14.78%,1
屏東縣,九如鄉,0334,254,490,744,89,833,1600,52.06%,15.88%,1
屏東縣,九如鄉,0335,174,430,604,76,680,1248,54.49%,13.94%,1
屏東縣,九如鄉,0336,251,632,883,159,1042,1792,58.15%,14.01%,1
屏東縣,九如鄉,0337,172,565,737,80,817,1482,55.13%,11.61%,1
屏東縣,里港鄉,0338,261,579,840,76,916,1552,59.02%,16.82%,1
屏東縣,里港鄉,0339,245,474,719,67,786,1480,53.11%,16.55%,1
屏東縣,里港鄉,0340,209,434,643,40,683,1534,44.52%,13.62%,1
屏東縣,里港鄉,0341,256,510,766,89,855,1578,54.18%,16.22%,1
屏東縣,里港鄉,0342,201,424,625,47,672,1127,59.63%,17.83%,1
屏東縣,里港鄉,0343,145,304,449,49,498,845,58.93%,17.16%,1
屏東縣,里港鄉,0344,299,319,618,59,677,1282,52.81%,23.32%,1
屏東縣,里港鄉,0345,150,367,517,49,566,981,57.7%,15.29%,1
屏東縣,里港鄉,0346,172,371,543,54,597,1031,57.9%,16.68%,1
屏東縣,里港鄉,0347,255,455,710,93,803,1423,56.43%,17.92%,1
屏東縣,里港鄉,0348,49,95,144,23,167,363,46.01%,13.5%,1
屏東縣,里港鄉,0349,212,385,597,104,701,1203,58.27%,17.62%,1
屏東縣,里港鄉,0350,162,409,571,66,637,1027,62.03%,15.77%,1
屏東縣,里港鄉,0351,217,418,635,63,698,1384,50.43%,15.68%,1
屏東縣,里港鄉,0352,231,463,694,88,782,1512,51.72%,15.28%,1
屏東縣,里港鄉,0353,63,228,291,17,308,522,59%,12.07%,1
屏東縣,里港鄉,0354,124,266,390,67,457,822,55.6%,15.09%,1
屏東縣,里港鄉,0355,150,307,457,71,528,1007,52.43%,14.9%,1
屏東縣,里港鄉,0356,155,300,455,82,537,956,56.17%,16.21%,1
屏東縣,里港鄉,0357,91,170,261,21,282,499,56.51%,18.24%,1
屏東縣,鹽埔鄉,0358,126,336,462,35,497,951,52.26%,13.25%,1
屏東縣,鹽埔鄉,0359,131,294,425,21,446,899,49.61%,14.57%,1
屏東縣,鹽埔鄉,0360,139,335,474,27,501,1116,44.89%,12.46%,1
屏東縣,鹽埔鄉,0361,166,425,591,38,629,1241,50.68%,13.38%,1
屏東縣,鹽埔鄉,0362,116,244,360,43,403,770,52.34%,15.06%,1
屏東縣,鹽埔鄉,0363,155,323,478,34,512,962,53.22%,16.11%,1
屏東縣,鹽埔鄉,0364,166,403,569,64,633,1041,60.81%,15.95%,1
屏東縣,鹽埔鄉,0365,268,431,699,9,708,1367,51.79%,19.6%,1
屏東縣,鹽埔鄉,0366,173,442,615,65,680,1465,46.42%,11.81%,1
屏東縣,鹽埔鄉,0367,119,266,385,37,422,894,47.2%,13.31%,1
屏東縣,鹽埔鄉,0368,115,303,418,4,422,958,44.05%,12%,1
屏東縣,鹽埔鄉,0369,123,296,419,72,491,924,53.14%,13.31%,1
屏東縣,鹽埔鄉,0370,189,511,700,39,739,1598,46.25%,11.83%,1
屏東縣,鹽埔鄉,0371,259,487,746,84,830,1550,53.55%,16.71%,1
屏東縣,鹽埔鄉,0372,158,389,547,57,604,1127,53.59%,14.02%,1
屏東縣,鹽埔鄉,0373,178,437,615,55,670,1150,58.26%,15.48%,1
屏東縣,鹽埔鄉,0374,210,428,638,37,675,1233,54.74%,17.03%,1
屏東縣,鹽埔鄉,0375,148,371,519,73,592,984,60.16%,15.04%,1
屏東縣,鹽埔鄉,0376,254,576,830,52,882,1619,54.48%,15.69%,1
屏東縣,鹽埔鄉,0377,70,203,273,34,307,553,55.52%,12.66%,1
屏東縣,高樹鄉,0378,167,310,477,72,549,883,62.17%,18.91%,1
屏東縣,高樹鄉,0379,152,298,450,25,475,1255,37.85%,12.11%,1
屏東縣,高樹鄉,0380,198,411,609,39,648,1278,50.7%,15.49%,1
屏東縣,高樹鄉,0381,72,239,311,25,336,738,45.53%,9.76%,1
屏東縣,高樹鄉,0382,89,168,257,14,271,585,46.32%,15.21%,1
屏東縣,高樹鄉,0383,175,302,477,110,587,1012,58%,17.29%,1
屏東縣,高樹鄉,0384,176,337,513,69,582,1148,50.7%,15.33%,1
屏東縣,高樹鄉,0385,81,183,264,36,300,591,50.76%,13.71%,1
屏東縣,高樹鄉,0386,108,201,309,51,360,786,45.8%,13.74%,1
屏東縣,高樹鄉,0387,58,203,261,20,281,649,43.3%,8.94%,1
屏東縣,高樹鄉,0388,136,311,447,67,514,1229,41.82%,11.07%,1
屏東縣,高樹鄉,0389,167,410,577,57,634,1446,43.85%,11.55%,1
屏東縣,高樹鄉,0390,145,195,340,17,357,899,39.71%,16.13%,1
屏東縣,高樹鄉,0391,122,299,421,57,478,922,51.84%,13.23%,1
屏東縣,高樹鄉,0392,178,359,537,67,604,1259,47.97%,14.14%,1
屏東縣,高樹鄉,0393,119,274,393,22,415,1056,39.3%,11.27%,1
屏東縣,高樹鄉,0394,173,358,531,71,602,1116,53.94%,15.5%,1
屏東縣,高樹鄉,0395,174,331,505,65,570,1020,55.88%,17.06%,1
屏東縣,高樹鄉,0396,155,345,500,73,573,1055,54.31%,14.69%,1
屏東縣,高樹鄉,0397,126,275,401,39,440,738,59.62%,17.07%,1
屏東縣,高樹鄉,0398,57,155,212,27,239,493,48.48%,11.56%,1
屏東縣,高樹鄉,0399,236,540,776,94,870,1539,56.53%,15.33%,1
屏東縣,萬巒鄉,0400,285,282,567,42,609,1239,49.15%,23%,1
屏東縣,萬巒鄉,0401,135,262,397,45,442,759,58.23%,17.79%,1
屏東縣,萬巒鄉,0402,142,335,477,79,556,932,59.66%,15.24%,1
屏東縣,萬巒鄉,0403,131,274,405,59,464,769,60.34%,17.04%,1
屏東縣,萬巒鄉,0404,137,304,441,65,506,920,55%,14.89%,1
屏東縣,萬巒鄉,0405,106,183,289,35,324,560,57.86%,18.93%,1
屏東縣,萬巒鄉,0406,140,348,488,33,521,1120,46.52%,12.5%,1
屏東縣,萬巒鄉,0407,134,347,481,30,511,1048,48.76%,12.79%,1
屏東縣,萬巒鄉,0408,163,443,606,41,647,1438,44.99%,11.34%,1
屏東縣,萬巒鄉,0409,112,239,351,64,415,834,49.76%,13.43%,1
屏東縣,萬巒鄉,0410,91,268,359,66,425,813,52.28%,11.19%,1
屏東縣,萬巒鄉,0411,103,337,440,35,475,1020,46.57%,10.1%,1
屏東縣,萬巒鄉,0412,188,339,527,63,590,1007,58.59%,18.67%,1
屏東縣,萬巒鄉,0413,221,424,645,84,729,1648,44.24%,13.41%,1
屏東縣,萬巒鄉,0414,204,459,663,62,725,1437,50.45%,14.2%,1
屏東縣,萬巒鄉,0415,148,374,522,26,548,1228,44.63%,12.05%,1
屏東縣,萬巒鄉,0416,70,251,321,40,361,597,60.47%,11.73%,1
屏東縣,萬巒鄉,0417,81,206,287,31,318,576,55.21%,14.06%,1
屏東縣,內埔鄉,0418,154,427,581,25,606,1305,46.44%,11.8%,1
屏東縣,內埔鄉,0419,152,428,580,31,611,1287,47.47%,11.81%,1
屏東縣,內埔鄉,0420,275,353,628,14,642,1387,46.29%,19.83%,1
屏東縣,內埔鄉,0421,233,469,702,28,730,1540,47.4%,15.13%,1
屏東縣,內埔鄉,0422,231,495,726,48,774,1605,48.22%,14.39%,1
屏東縣,內埔鄉,0423,185,428,613,51,664,1326,50.08%,13.95%,1
屏東縣,內埔鄉,0424,96,193,289,44,333,591,56.35%,16.24%,1
屏東縣,內埔鄉,0425,154,346,500,39,539,1123,48%,13.71%,1
屏東縣,內埔鄉,0426,134,369,503,20,523,1079,48.47%,12.42%,1
屏東縣,內埔鄉,0427,205,498,703,64,767,1485,51.65%,13.8%,1
屏東縣,內埔鄉,0428,178,492,670,37,707,1248,56.65%,14.26%,1
屏東縣,內埔鄉,0429,239,509,748,48,796,1569,50.73%,15.23%,1
屏東縣,內埔鄉,0430,211,448,659,53,712,1493,47.69%,14.13%,1
屏東縣,內埔鄉,0431,194,452,646,10,656,1420,46.2%,13.66%,1
屏東縣,內埔鄉,0432,176,453,629,64,693,1334,51.95%,13.19%,1
屏東縣,內埔鄉,0433,207,480,687,53,740,1519,48.72%,13.63%,1
屏東縣,內埔鄉,0434,112,271,383,38,421,784,53.7%,14.29%,1
屏東縣,內埔鄉,0435,136,317,453,47,500,888,56.31%,15.32%,1
屏東縣,內埔鄉,0436,92,183,275,21,296,747,39.63%,12.32%,1
屏東縣,內埔鄉,0437,144,327,471,27,498,1168,42.64%,12.33%,1
屏東縣,內埔鄉,0438,87,183,270,42,312,546,57.14%,15.93%,1
屏東縣,內埔鄉,0439,191,401,592,46,638,1278,49.92%,14.95%,1
屏東縣,內埔鄉,0440,174,384,558,43,601,1348,44.58%,12.91%,1
屏東縣,內埔鄉,0441,178,400,578,79,657,1550,42.39%,11.48%,1
屏東縣,內埔鄉,0442,141,377,518,61,579,947,61.14%,14.89%,1
屏東縣,內埔鄉,0443,155,338,493,72,565,1097,51.5%,14.13%,1
屏東縣,內埔鄉,0444,166,261,427,51,478,1128,42.38%,14.72%,1
屏東縣,內埔鄉,0445,128,290,418,24,442,1253,35.28%,10.22%,1
屏東縣,內埔鄉,0446,170,413,583,29,612,1525,40.13%,11.15%,1
屏東縣,內埔鄉,0447,164,400,564,74,638,1215,52.51%,13.5%,1
屏東縣,內埔鄉,0448,129,364,493,27,520,1216,42.76%,10.61%,1
屏東縣,內埔鄉,0449,160,418,578,39,617,1353,45.6%,11.83%,1
屏東縣,內埔鄉,0450,133,341,474,38,512,1026,49.9%,12.96%,1
屏東縣,內埔鄉,0451,118,260,378,29,407,862,47.22%,13.69%,1
屏東縣,內埔鄉,0452,106,226,332,40,372,921,40.39%,11.51%,1
屏東縣,內埔鄉,0453,127,274,401,21,422,854,49.41%,14.87%,1
屏東縣,內埔鄉,0454,144,364,508,37,545,1230,44.31%,11.71%,1
屏東縣,內埔鄉,0455,132,384,516,21,537,1204,44.6%,10.96%,1
屏東縣,內埔鄉,0456,65,406,471,33,504,1301,38.74%,5%,1
屏東縣,內埔鄉,0457,249,165,414,39,453,806,56.2%,30.89%,1
屏東縣,竹田鄉,0458,208,558,766,78,844,1503,56.15%,13.84%,1
屏東縣,竹田鄉,0459,169,346,515,35,550,899,61.18%,18.8%,1
屏東縣,竹田鄉,0460,117,295,412,40,452,716,63.13%,16.34%,1
屏東縣,竹田鄉,0461,115,220,335,48,383,581,65.92%,19.79%,1
屏東縣,竹田鄉,0462,193,456,649,92,741,1327,55.84%,14.54%,1
屏東縣,竹田鄉,0463,158,373,531,87,618,997,61.99%,15.85%,1
屏東縣,竹田鄉,0464,109,217,326,32,358,649,55.16%,16.8%,1
屏東縣,竹田鄉,0465,92,240,332,15,347,476,72.9%,19.33%,1
屏東縣,竹田鄉,0466,206,467,673,64,737,1259,58.54%,16.36%,1
屏東縣,竹田鄉,0467,161,417,578,63,641,1227,52.24%,13.12%,1
屏東縣,竹田鄉,0468,91,190,281,41,322,504,63.89%,18.06%,1
屏東縣,竹田鄉,0469,112,302,414,49,463,860,53.84%,13.02%,1
屏東縣,竹田鄉,0470,268,130,398,28,426,800,53.25%,33.5%,1
屏東縣,竹田鄉,0471,172,403,575,84,659,1134,58.11%,15.17%,1
屏東縣,竹田鄉,0472,73,437,510,59,569,1229,46.3%,5.94%,1
屏東縣,竹田鄉,0473,193,387,580,50,630,1192,52.85%,16.19%,1
屏東縣,新埤鄉,0474,229,539,768,46,814,1712,47.55%,13.38%,1
屏東縣,新埤鄉,0475,34,111,145,30,175,314,55.73%,10.83%,1
屏東縣,新埤鄉,0476,104,267,371,37,408,752,54.26%,13.83%,1
屏東縣,新埤鄉,0477,42,124,166,19,185,334,55.39%,12.57%,1
屏東縣,新埤鄉,0478,134,352,486,54,540,957,56.43%,14%,1
屏東縣,新埤鄉,0479,128,284,412,39,451,764,59.03%,16.75%,1
屏東縣,新埤鄉,0480,53,141,194,20,214,373,57.37%,14.21%,1
屏東縣,新埤鄉,0481,83,203,286,30,316,678,46.61%,12.24%,1
屏東縣,新埤鄉,0482,92,204,296,31,327,701,46.65%,13.12%,1
屏東縣,新埤鄉,0483,153,340,493,52,545,1323,41.19%,11.56%,1
屏東縣,新埤鄉,0484,82,203,285,27,312,541,57.67%,15.16%,1
屏東縣,新埤鄉,0485,67,185,252,22,274,584,46.92%,11.47%,1
屏東縣,枋寮鄉,0486,180,438,618,66,684,1213,56.39%,14.84%,1
屏東縣,枋寮鄉,0487,127,339,466,54,520,891,58.36%,14.25%,1
屏東縣,枋寮鄉,0488,119,309,428,69,497,970,51.24%,12.27%,1
屏東縣,枋寮鄉,0489,75,226,301,32,333,629,52.94%,11.92%,1
屏東縣,枋寮鄉,0490,84,307,391,47,438,840,52.14%,10%,1
屏東縣,枋寮鄉,0491,103,304,407,38,445,774,57.49%,13.31%,1
屏東縣,枋寮鄉,0492,184,474,658,56,714,1379,51.78%,13.34%,1
屏東縣,枋寮鄉,0493,214,554,768,51,819,1502,54.53%,14.25%,1
屏東縣,枋寮鄉,0494,159,434,593,72,665,1276,52.12%,12.46%,1
屏東縣,枋寮鄉,0495,134,325,459,56,515,964,53.42%,13.9%,1
屏東縣,枋寮鄉,0496,127,403,530,81,611,1005,60.8%,12.64%,1
屏東縣,枋寮鄉,0497,102,250,352,22,374,734,50.95%,13.9%,1
屏東縣,枋寮鄉,0498,116,248,364,45,409,725,56.41%,16%,1
屏東縣,枋寮鄉,0499,148,329,477,58,535,1046,51.15%,14.15%,1
屏東縣,枋寮鄉,0500,141,396,537,75,612,1067,57.36%,13.21%,1
屏東縣,枋寮鄉,0501,71,156,227,57,284,718,39.55%,9.89%,1
屏東縣,枋寮鄉,0502,105,264,369,54,423,903,46.84%,11.63%,1
屏東縣,枋寮鄉,0503,201,415,616,81,697,1387,50.25%,14.49%,1
屏東縣,枋寮鄉,0504,212,462,674,80,754,1367,55.16%,15.51%,1
屏東縣,枋寮鄉,0505,132,203,335,52,387,618,62.62%,21.36%,1
屏東縣,枋寮鄉,0506,114,236,350,41,391,959,40.77%,11.89%,1
屏東縣,枋寮鄉,0507,68,138,206,31,237,427,55.5%,15.93%,1
屏東縣,新園鄉,0508,137,293,430,42,472,820,57.56%,16.71%,1
屏東縣,新園鄉,0509,179,283,462,44,506,843,60.02%,21.23%,1
屏東縣,新園鄉,0510,185,406,591,52,643,1242,51.77%,14.9%,1
屏東縣,新園鄉,0511,223,464,687,55,742,1290,57.52%,17.29%,1
屏東縣,新園鄉,0512,164,362,526,42,568,1073,52.94%,15.28%,1
屏東縣,新園鄉,0513,165,392,557,89,646,1088,59.38%,15.17%,1
屏東縣,新園鄉,0514,111,274,385,35,420,845,49.7%,13.14%,1
屏東縣,新園鄉,0515,145,268,413,54,467,862,54.18%,16.82%,1
屏東縣,新園鄉,0516,152,368,520,68,588,1183,49.7%,12.85%,1
屏東縣,新園鄉,0517,139,398,537,76,613,1109,55.28%,12.53%,1
屏東縣,新園鄉,0518,164,336,500,12,512,1119,45.76%,14.66%,1
屏東縣,新園鄉,0519,181,353,534,40,574,1152,49.83%,15.71%,1
屏東縣,新園鄉,0520,150,379,529,42,571,1030,55.44%,14.56%,1
屏東縣,新園鄉,0521,161,352,513,76,589,1104,53.35%,14.58%,1
屏東縣,新園鄉,0522,158,376,534,38,572,1240,46.13%,12.74%,1
屏東縣,新園鄉,0523,154,278,432,25,457,1120,40.8%,13.75%,1
屏東縣,新園鄉,0524,165,393,558,66,624,1074,58.1%,15.36%,1
屏東縣,新園鄉,0525,102,258,360,37,397,849,46.76%,12.01%,1
屏東縣,新園鄉,0526,110,244,354,56,410,749,54.74%,14.69%,1
屏東縣,新園鄉,0527,210,425,635,87,722,1416,50.99%,14.83%,1
屏東縣,新園鄉,0528,128,318,446,35,481,895,53.74%,14.3%,1
屏東縣,新園鄉,0529,123,329,452,69,521,933,55.84%,13.18%,1
屏東縣,新園鄉,0530,141,346,487,33,520,972,53.5%,14.51%,1
屏東縣,新園鄉,0531,175,430,605,58,663,1454,45.6%,12.04%,1
屏東縣,新園鄉,0532,216,671,887,78,965,1653,58.38%,13.07%,1
屏東縣,新園鄉,0533,156,418,574,66,640,1270,50.39%,12.28%,1
屏東縣,新園鄉,0534,156,440,596,100,696,1123,61.98%,13.89%,1
屏東縣,新園鄉,0535,151,413,564,60,624,1198,52.09%,12.6%,1
屏東縣,崁頂鄉,0536,164,380,544,53,597,1190,50.17%,13.78%,1
屏東縣,崁頂鄉,0537,195,347,542,57,599,1044,57.38%,18.68%,1
屏東縣,崁頂鄉,0538,142,261,403,49,452,818,55.26%,17.36%,1
屏東縣,崁頂鄉,0539,207,372,579,51,630,1214,51.89%,17.05%,1
屏東縣,崁頂鄉,0540,165,437,602,30,632,1325,47.7%,12.45%,1
屏東縣,崁頂鄉,0541,212,445,657,53,710,1253,56.66%,16.92%,1
屏東縣,崁頂鄉,0542,170,315,485,44,529,1039,50.91%,16.36%,1
屏東縣,崁頂鄉,0543,113,224,337,55,392,813,48.22%,13.9%,1
屏東縣,崁頂鄉,0544,105,237,342,23,365,736,49.59%,14.27%,1
屏東縣,崁頂鄉,0545,154,327,481,44,525,934,56.21%,16.49%,1
屏東縣,崁頂鄉,0546,130,274,404,69,473,900,52.56%,14.44%,1
屏東縣,崁頂鄉,0547,147,343,490,42,532,1004,52.99%,14.64%,1
屏東縣,林邊鄉,0548,224,547,771,94,865,1458,59.33%,15.36%,1
屏東縣,林邊鄉,0549,153,323,476,53,529,891,59.37%,17.17%,1
屏東縣,林邊鄉,0550,120,269,389,35,424,695,61.01%,17.27%,1
屏東縣,林邊鄉,0551,168,373,541,63,604,1015,59.51%,16.55%,1
屏東縣,林邊鄉,0552,200,429,629,50,679,1171,57.98%,17.08%,1
屏東縣,林邊鄉,0553,157,337,494,45,539,1003,53.74%,15.65%,1
屏東縣,林邊鄉,0554,158,262,420,41,461,725,63.59%,21.79%,1
屏東縣,林邊鄉,0555,138,301,439,62,501,841,59.57%,16.41%,1
屏東縣,林邊鄉,0556,134,296,430,43,473,793,59.65%,16.9%,1
屏東縣,林邊鄉,0557,160,336,496,51,547,919,59.52%,17.41%,1
屏東縣,林邊鄉,0558,204,408,612,57,669,1283,52.14%,15.9%,1
屏東縣,林邊鄉,0559,122,219,341,41,382,783,48.79%,15.58%,1
屏東縣,林邊鄉,0560,124,305,429,47,476,1033,46.08%,12%,1
屏東縣,林邊鄉,0561,155,401,556,83,639,1186,53.88%,13.07%,1
屏東縣,林邊鄉,0562,99,265,364,56,420,773,54.33%,12.81%,1
屏東縣,林邊鄉,0563,35,460,495,39,534,1122,47.59%,3.12%,1
屏東縣,南州鄉,0564,117,285,402,53,455,872,52.18%,13.42%,1
屏東縣,南州鄉,0565,121,283,404,34,438,794,55.16%,15.24%,1
屏東縣,南州鄉,0566,160,352,512,46,558,962,58%,16.63%,1
屏東縣,南州鄉,0567,176,338,514,65,579,1033,56.05%,17.04%,1
屏東縣,南州鄉,0568,176,292,468,50,518,1007,51.44%,17.48%,1
屏東縣,南州鄉,0569,59,192,251,26,277,466,59.44%,12.66%,1
屏東縣,南州鄉,0570,119,271,390,26,416,708,58.76%,16.81%,1
屏東縣,南州鄉,0571,168,358,526,65,591,1044,56.61%,16.09%,1
屏東縣,南州鄉,0572,156,256,412,39,451,1071,42.11%,14.57%,1
屏東縣,南州鄉,0573,266,166,432,31,463,979,47.29%,27.17%,1
屏東縣,南州鄉,0574,74,175,249,27,276,543,50.83%,13.63%,1
屏東縣,佳冬鄉,0575,210,405,615,72,687,1472,46.67%,14.27%,1
屏東縣,佳冬鄉,0576,163,372,535,68,603,1360,44.34%,11.99%,1
屏東縣,佳冬鄉,0577,123,271,394,69,463,804,57.59%,15.3%,1
屏東縣,佳冬鄉,0578,153,261,414,72,486,925,52.54%,16.54%,1
屏東縣,佳冬鄉,0579,108,279,387,16,403,855,47.13%,12.63%,1
屏東縣,佳冬鄉,0580,164,268,432,55,487,981,49.64%,16.72%,1
屏東縣,佳冬鄉,0581,156,285,441,54,495,1007,49.16%,15.49%,1
屏東縣,佳冬鄉,0582,137,231,368,49,417,872,47.82%,15.71%,1
屏東縣,佳冬鄉,0583,179,320,499,73,572,1255,45.58%,14.26%,1
屏東縣,佳冬鄉,0584,126,320,446,109,555,995,55.78%,12.66%,1
屏東縣,佳冬鄉,0585,87,175,262,30,292,734,39.78%,11.85%,1
屏東縣,佳冬鄉,0586,147,321,468,38,506,1178,42.95%,12.48%,1
屏東縣,佳冬鄉,0587,188,277,465,59,524,1095,47.85%,17.17%,1
屏東縣,佳冬鄉,0588,156,401,557,88,645,1097,58.8%,14.22%,1
屏東縣,佳冬鄉,0589,156,432,588,75,663,1273,52.08%,12.25%,1
屏東縣,佳冬鄉,0590,169,431,600,54,654,1160,56.38%,14.57%,1
屏東縣,琉球鄉,0591,128,314,442,24,466,1111,41.94%,11.52%,1
屏東縣,琉球鄉,0592,109,287,396,39,435,972,44.75%,11.21%,1
屏東縣,琉球鄉,0593,143,489,632,33,665,1278,52.03%,11.19%,1
屏東縣,琉球鄉,0594,101,344,445,50,495,976,50.72%,10.35%,1
屏東縣,琉球鄉,0595,146,572,718,70,788,1658,47.53%,8.81%,1
屏東縣,琉球鄉,0596,106,298,404,33,437,1146,38.13%,9.25%,1
屏東縣,琉球鄉,0597,80,312,392,28,420,1079,38.92%,7.41%,1
屏東縣,琉球鄉,0598,139,438,577,21,598,1613,37.07%,8.62%,1
屏東縣,琉球鄉,0599,110,287,397,47,444,873,50.86%,12.6%,1
屏東縣,車城鄉,0600,97,178,275,33,308,737,41.79%,13.16%,1
屏東縣,車城鄉,0601,79,133,212,29,241,647,37.25%,12.21%,1
屏東縣,車城鄉,0602,78,130,208,19,227,491,46.23%,15.89%,1
屏東縣,車城鄉,0603,126,248,374,32,406,856,47.43%,14.72%,1
屏東縣,車城鄉,0604,78,149,227,9,236,554,42.6%,14.08%,1
屏東縣,車城鄉,0605,42,100,142,1,143,388,36.86%,10.82%,1
屏東縣,車城鄉,0606,125,206,331,55,386,922,41.87%,13.56%,1
屏東縣,車城鄉,0607,65,126,191,6,197,597,33%,10.89%,1
屏東縣,車城鄉,0608,61,132,193,12,205,623,32.91%,9.79%,1
屏東縣,車城鄉,0609,56,119,175,20,195,425,45.88%,13.18%,1
屏東縣,車城鄉,0610,51,153,204,17,221,428,51.64%,11.92%,1
屏東縣,車城鄉,0611,50,114,164,9,173,504,34.33%,9.92%,1
屏東縣,車城鄉,0612,60,125,185,24,209,423,49.41%,14.18%,1
屏東縣,滿州鄉,0613,236,437,673,49,722,1575,45.84%,14.98%,1
屏東縣,滿州鄉,0614,61,129,190,10,200,420,47.62%,14.52%,1
屏東縣,滿州鄉,0615,85,235,320,30,350,602,58.14%,14.12%,1
屏東縣,滿州鄉,0616,128,363,491,18,509,1302,39.09%,9.83%,1
屏東縣,滿州鄉,0617,170,382,552,52,604,1314,45.97%,12.94%,1
屏東縣,滿州鄉,0618,132,243,375,17,392,1308,29.97%,10.09%,1
屏東縣,滿州鄉,0619,44,76,120,16,136,367,37.06%,11.99%,1
屏東縣,滿州鄉,0620,31,117,148,18,166,318,52.2%,9.75%,1
屏東縣,枋山鄉,0621,59,240,299,37,336,604,55.63%,9.77%,1
屏東縣,枋山鄉,0622,66,172,238,22,260,428,60.75%,15.42%,1
屏東縣,枋山鄉,0623,166,360,526,51,577,928,62.18%,17.89%,1
屏東縣,枋山鄉,0624,140,328,468,23,491,972,50.51%,14.4%,1
屏東縣,枋山鄉,0625,142,274,416,55,471,1041,45.24%,13.64%,1
屏東縣,枋山鄉,0626,109,194,303,24,327,883,37.03%,12.34%,1
屏東縣,三地門鄉,0627,50,242,292,16,308,616,50%,8.12%,1
屏東縣,三地門鄉,0628,79,211,290,65,355,572,62.06%,13.81%,1
屏東縣,三地門鄉,0629,30,117,147,14,161,323,49.85%,9.29%,1
屏東縣,三地門鄉,0630,271,575,846,44,890,1448,61.46%,18.72%,1
屏東縣,三地門鄉,0631,74,178,252,8,260,726,35.81%,10.19%,1
屏東縣,三地門鄉,0632,81,188,269,24,293,554,52.89%,14.62%,1
屏東縣,三地門鄉,0633,68,134,202,14,216,346,62.43%,19.65%,1
屏東縣,三地門鄉,0634,50,184,234,5,239,458,52.18%,10.92%,1
屏東縣,三地門鄉,0635,119,303,422,15,437,692,63.15%,17.2%,1
屏東縣,三地門鄉,0636,116,331,447,25,472,638,73.98%,18.18%,1
屏東縣,霧臺鄉,0637,65,176,241,26,267,346,77.17%,18.79%,1
屏東縣,霧臺鄉,0638,85,293,378,11,389,677,57.46%,12.56%,1
屏東縣,霧臺鄉,0639,13,46,59,0,59,162,36.42%,8.02%,1
屏東縣,霧臺鄉,0640,20,71,91,6,97,189,51.32%,10.58%,1
屏東縣,霧臺鄉,0641,37,149,186,27,213,296,71.96%,12.5%,1
屏東縣,霧臺鄉,0642,70,244,314,14,328,483,67.91%,14.49%,1
屏東縣,霧臺鄉,0643,52,142,194,8,202,347,58.21%,14.99%,1
屏東縣,霧臺鄉,0644,72,170,242,19,261,450,58%,16%,1
屏東縣,瑪家鄉,0645,78,167,245,2,247,455,54.29%,17.14%,1
屏東縣,瑪家鄉,0646,136,362,498,47,545,821,66.38%,16.57%,1
屏東縣,瑪家鄉,0647,109,307,416,53,469,635,73.86%,17.17%,1
屏東縣,瑪家鄉,0648,95,401,496,27,523,695,75.25%,13.67%,1
屏東縣,瑪家鄉,0649,100,328,428,24,452,671,67.36%,14.9%,1
屏東縣,瑪家鄉,0650,154,399,553,17,570,1057,53.93%,14.57%,1
屏東縣,瑪家鄉,0651,132,362,494,27,521,900,57.89%,14.67%,1
屏東縣,瑪家鄉,0652,58,181,239,2,241,429,56.18%,13.52%,1
屏東縣,泰武鄉,0653,123,256,379,23,402,669,60.09%,18.39%,1
屏東縣,泰武鄉,0654,25,67,92,9,101,190,53.16%,13.16%,1
屏東縣,泰武鄉,0655,140,411,551,56,607,922,65.84%,15.18%,1
屏東縣,泰武鄉,0656,90,323,413,39,452,598,75.59%,15.05%,1
屏東縣,泰武鄉,0657,106,358,464,39,503,771,65.24%,13.75%,1
屏東縣,泰武鄉,0658,42,229,271,32,303,414,73.19%,10.14%,1
屏東縣,泰武鄉,0659,105,304,409,30,439,780,56.28%,13.46%,1
屏東縣,來義鄉,0660,106,439,545,70,615,917,67.07%,11.56%,1
屏東縣,來義鄉,0661,55,149,204,7,211,361,58.45%,15.24%,1
屏東縣,來義鄉,0662,22,96,118,4,122,216,56.48%,10.19%,1
屏東縣,來義鄉,0663,47,264,311,25,336,445,75.51%,10.56%,1
屏東縣,來義鄉,0664,25,146,171,11,182,280,65%,8.93%,1
屏東縣,來義鄉,0665,115,489,604,44,648,1097,59.07%,10.48%,1
屏東縣,來義鄉,0666,96,438,534,30,564,840,67.14%,11.43%,1
屏東縣,來義鄉,0667,133,306,439,23,462,889,51.97%,14.96%,1
屏東縣,來義鄉,0668,189,365,554,40,594,1212,49.01%,15.59%,1
屏東縣,春日鄉,0669,97,189,286,8,294,909,32.34%,10.67%,1
屏東縣,春日鄉,0670,90,146,236,13,249,663,37.56%,13.57%,1
屏東縣,春日鄉,0671,21,61,82,2,84,304,27.63%,6.91%,1
屏東縣,春日鄉,0672,103,292,395,15,410,928,44.18%,11.1%,1
屏東縣,春日鄉,0673,63,123,186,9,195,641,30.42%,9.83%,1
屏東縣,春日鄉,0674,58,86,144,5,149,478,31.17%,12.13%,1
屏東縣,獅子鄉,0675,73,307,380,10,390,751,51.93%,9.72%,1
屏東縣,獅子鄉,0676,106,321,427,26,453,776,58.38%,13.66%,1
屏東縣,獅子鄉,0677,63,262,325,8,333,711,46.84%,8.86%,1
屏東縣,獅子鄉,0678,47,112,159,29,188,243,77.37%,19.34%,1
屏東縣,獅子鄉,0679,45,143,188,7,195,325,60%,13.85%,1
屏東縣,獅子鄉,0680,53,137,190,5,195,476,40.97%,11.13%,1
屏東縣,獅子鄉,0681,84,276,360,8,368,602,61.13%,13.95%,1
屏東縣,獅子鄉,0682,44,116,160,7,167,346,48.27%,12.72%,1
屏東縣,牡丹鄉,0683,37,100,137,6,143,342,41.81%,10.82%,1
屏東縣,牡丹鄉,0684,194,432,626,37,663,1306,50.77%,14.85%,1
屏東縣,牡丹鄉,0685,60,112,172,4,176,693,25.4%,8.66%,1
屏東縣,牡丹鄉,0686,48,122,170,6,176,437,40.27%,10.98%,1
屏東縣,牡丹鄉,0687,57,133,190,7,197,392,50.26%,14.54%,1
屏東縣,牡丹鄉,0688,99,201,300,10,310,593,52.28%,16.69%,1
屏東縣,牡丹鄉,0689,32,96,128,6,134,551,24.32%,5.81%,1
宜蘭縣,宜蘭市,0001,161,360,521,16,537,982,54.68%,16.4%,1
宜蘭縣,宜蘭市,0002,197,453,650,52,702,1270,55.28%,15.51%,1
宜蘭縣,宜蘭市,0003,170,283,453,17,470,849,55.36%,20.02%,1
宜蘭縣,宜蘭市,0004,137,280,417,20,437,756,57.8%,18.12%,1
宜蘭縣,宜蘭市,0005,163,368,531,29,560,1107,50.59%,14.72%,1
宜蘭縣,宜蘭市,0006,130,324,454,43,497,893,55.66%,14.56%,1
宜蘭縣,宜蘭市,0007,169,310,479,26,505,912,55.37%,18.53%,1
宜蘭縣,宜蘭市,0008,248,467,715,37,752,1335,56.33%,18.58%,1
宜蘭縣,宜蘭市,0009,102,245,347,20,367,686,53.5%,14.87%,1
宜蘭縣,宜蘭市,0010,275,524,799,27,826,1366,60.47%,20.13%,1
宜蘭縣,宜蘭市,0011,307,442,749,27,776,1363,56.93%,22.52%,1
宜蘭縣,宜蘭市,0012,299,553,852,36,888,1540,57.66%,19.42%,1
宜蘭縣,宜蘭市,0013,239,490,729,17,746,1341,55.63%,17.82%,1
宜蘭縣,宜蘭市,0014,209,433,642,43,685,1209,56.66%,17.29%,1
宜蘭縣,宜蘭市,0015,164,308,472,40,512,900,56.89%,18.22%,1
宜蘭縣,宜蘭市,0016,163,323,486,26,512,980,52.24%,16.63%,1
宜蘭縣,宜蘭市,0017,242,375,617,33,650,1165,55.79%,20.77%,1
宜蘭縣,宜蘭市,0018,146,338,484,22,506,904,55.97%,16.15%,1
宜蘭縣,宜蘭市,0019,139,304,443,23,466,813,57.32%,17.1%,1
宜蘭縣,宜蘭市,0020,159,358,517,26,543,978,55.52%,16.26%,1
宜蘭縣,宜蘭市,0021,178,382,560,21,581,1282,45.32%,13.88%,1
宜蘭縣,宜蘭市,0022,89,174,263,13,276,465,59.35%,19.14%,1
宜蘭縣,宜蘭市,0023,114,254,368,30,398,669,59.49%,17.04%,1
宜蘭縣,宜蘭市,0024,151,356,507,20,527,923,57.1%,16.36%,1
宜蘭縣,宜蘭市,0025,169,344,513,23,536,1006,53.28%,16.8%,1
宜蘭縣,宜蘭市,0026,159,306,465,35,500,762,65.62%,20.87%,1
宜蘭縣,宜蘭市,0027,141,297,438,29,467,727,64.24%,19.39%,1
宜蘭縣,宜蘭市,0028,172,328,500,53,553,833,66.39%,20.65%,1
宜蘭縣,宜蘭市,0029,213,406,619,32,651,1143,56.96%,18.64%,1
宜蘭縣,宜蘭市,0030,180,346,526,17,543,979,55.46%,18.39%,1
宜蘭縣,宜蘭市,0031,196,442,638,44,682,1214,56.18%,16.14%,1
宜蘭縣,宜蘭市,0032,220,468,688,51,739,1283,57.6%,17.15%,1
宜蘭縣,宜蘭市,0033,171,352,523,28,551,946,58.25%,18.08%,1
宜蘭縣,宜蘭市,0034,175,375,550,35,585,1090,53.67%,16.06%,1
宜蘭縣,宜蘭市,0035,210,335,545,18,563,943,59.7%,22.27%,1
宜蘭縣,宜蘭市,0036,208,260,468,28,496,774,64.08%,26.87%,1
宜蘭縣,宜蘭市,0037,207,352,559,32,591,968,61.05%,21.38%,1
宜蘭縣,宜蘭市,0038,206,348,554,18,572,926,61.77%,22.25%,1
宜蘭縣,宜蘭市,0039,211,368,579,33,612,1019,60.06%,20.71%,1
宜蘭縣,宜蘭市,0040,184,392,576,41,617,1084,56.92%,16.97%,1
宜蘭縣,宜蘭市,0041,204,367,571,24,595,1095,54.34%,18.63%,1
宜蘭縣,宜蘭市,0042,224,377,601,21,622,1083,57.43%,20.68%,1
宜蘭縣,宜蘭市,0043,191,377,568,24,592,1108,53.43%,17.24%,1
宜蘭縣,宜蘭市,0044,172,311,483,10,493,848,58.14%,20.28%,1
宜蘭縣,宜蘭市,0045,209,370,579,25,604,1095,55.16%,19.09%,1
宜蘭縣,宜蘭市,0046,200,402,602,27,629,1110,56.67%,18.02%,1
宜蘭縣,宜蘭市,0047,195,416,611,35,646,1104,58.51%,17.66%,1
宜蘭縣,宜蘭市,0048,199,416,615,33,648,1134,57.14%,17.55%,1
宜蘭縣,宜蘭市,0049,208,428,636,25,661,1146,57.68%,18.15%,1
宜蘭縣,宜蘭市,0050,165,324,489,44,533,876,60.84%,18.84%,1
宜蘭縣,宜蘭市,0051,133,329,462,45,507,905,56.02%,14.7%,1
宜蘭縣,宜蘭市,0052,173,326,499,35,534,910,58.68%,19.01%,1
宜蘭縣,宜蘭市,0053,229,445,674,30,704,1434,49.09%,15.97%,1
宜蘭縣,宜蘭市,0054,211,379,590,47,637,1152,55.3%,18.32%,1
宜蘭縣,宜蘭市,0055,204,344,548,30,578,966,59.83%,21.12%,1
宜蘭縣,宜蘭市,0056,140,253,393,24,417,711,58.65%,19.69%,1
宜蘭縣,宜蘭市,0057,189,311,500,36,536,884,60.63%,21.38%,1
宜蘭縣,宜蘭市,0058,225,500,725,41,766,1326,57.77%,16.97%,1
宜蘭縣,宜蘭市,0059,161,289,450,24,474,909,52.15%,17.71%,1
宜蘭縣,宜蘭市,0060,158,305,463,29,492,894,55.03%,17.67%,1
宜蘭縣,宜蘭市,0061,200,404,604,35,639,1259,50.75%,15.89%,1
宜蘭縣,宜蘭市,0062,125,275,400,17,417,789,52.85%,15.84%,1
宜蘭縣,宜蘭市,0063,146,310,456,28,484,867,55.82%,16.84%,1
宜蘭縣,宜蘭市,0064,238,501,739,71,810,1454,55.71%,16.37%,1
宜蘭縣,宜蘭市,0065,190,478,668,22,690,1130,61.06%,16.81%,1
宜蘭縣,宜蘭市,0066,151,351,502,16,518,1087,47.65%,13.89%,1
宜蘭縣,宜蘭市,0067,161,365,526,52,578,938,61.62%,17.16%,1
宜蘭縣,宜蘭市,0068,232,443,675,45,720,1285,56.03%,18.05%,1
宜蘭縣,宜蘭市,0069,175,308,483,25,508,952,53.36%,18.38%,1
宜蘭縣,宜蘭市,0070,163,362,525,47,572,948,60.34%,17.19%,1
宜蘭縣,宜蘭市,0071,201,367,568,44,612,1160,52.76%,17.33%,1
宜蘭縣,宜蘭市,0072,163,391,554,50,604,1015,59.51%,16.06%,1
宜蘭縣,宜蘭市,0073,91,157,248,13,261,424,61.56%,21.46%,1
宜蘭縣,宜蘭市,0074,170,361,531,38,569,964,59.02%,17.63%,1
宜蘭縣,宜蘭市,0075,163,306,469,47,516,959,53.81%,17%,1
宜蘭縣,宜蘭市,0076,140,329,469,42,511,814,62.78%,17.2%,1
宜蘭縣,宜蘭市,0077,143,350,493,33,526,885,59.44%,16.16%,1
宜蘭縣,宜蘭市,0078,226,360,586,58,644,1162,55.42%,19.45%,1
宜蘭縣,羅東鎮,0079,143,235,378,30,408,689,59.22%,20.75%,1
宜蘭縣,羅東鎮,0080,118,255,373,27,400,718,55.71%,16.43%,1
宜蘭縣,羅東鎮,0081,257,497,754,65,819,1475,55.53%,17.42%,1
宜蘭縣,羅東鎮,0082,271,466,737,61,798,1466,54.43%,18.49%,1
宜蘭縣,羅東鎮,0083,189,391,580,24,604,1075,56.19%,17.58%,1
宜蘭縣,羅東鎮,0084,174,330,504,33,537,963,55.76%,18.07%,1
宜蘭縣,羅東鎮,0085,251,482,733,82,815,1511,53.94%,16.61%,1
宜蘭縣,羅東鎮,0086,196,409,605,28,633,1166,54.29%,16.81%,1
宜蘭縣,羅東鎮,0087,241,441,682,54,736,1273,57.82%,18.93%,1
宜蘭縣,羅東鎮,0088,320,567,887,29,916,1735,52.8%,18.44%,1
宜蘭縣,羅東鎮,0089,261,551,812,37,849,1487,57.09%,17.55%,1
宜蘭縣,羅東鎮,0090,178,286,464,40,504,837,60.22%,21.27%,1
宜蘭縣,羅東鎮,0091,249,484,733,53,786,1312,59.91%,18.98%,1
宜蘭縣,羅東鎮,0092,239,505,744,37,781,1502,52%,15.91%,1
宜蘭縣,羅東鎮,0093,212,367,579,25,604,1138,53.08%,18.63%,1
宜蘭縣,羅東鎮,0094,183,332,515,47,562,1010,55.64%,18.12%,1
宜蘭縣,羅東鎮,0095,232,487,719,74,793,1373,57.76%,16.9%,1
宜蘭縣,羅東鎮,0096,209,377,586,31,617,1089,56.66%,19.19%,1
宜蘭縣,羅東鎮,0097,218,454,672,38,710,1304,54.45%,16.72%,1
宜蘭縣,羅東鎮,0098,226,415,641,55,696,1288,54.04%,17.55%,1
宜蘭縣,羅東鎮,0099,211,378,589,53,642,1036,61.97%,20.37%,1
宜蘭縣,羅東鎮,0100,190,388,578,40,618,969,63.78%,19.61%,1
宜蘭縣,羅東鎮,0101,193,356,549,41,590,985,59.9%,19.59%,1
宜蘭縣,羅東鎮,0102,255,514,769,67,836,1420,58.87%,17.96%,1
宜蘭縣,羅東鎮,0103,253,526,779,40,819,1430,57.27%,17.69%,1
宜蘭縣,羅東鎮,0104,197,371,568,62,630,1075,58.6%,18.33%,1
宜蘭縣,羅東鎮,0105,189,309,498,31,529,879,60.18%,21.5%,1
宜蘭縣,羅東鎮,0106,173,289,462,14,476,850,56%,20.35%,1
宜蘭縣,羅東鎮,0107,253,387,640,25,665,1111,59.86%,22.77%,1
宜蘭縣,羅東鎮,0108,230,455,685,29,714,1139,62.69%,20.19%,1
宜蘭縣,羅東鎮,0109,241,418,659,38,697,1130,61.68%,21.33%,1
宜蘭縣,羅東鎮,0110,191,361,552,28,580,980,59.18%,19.49%,1
宜蘭縣,羅東鎮,0111,264,500,764,42,806,1431,56.32%,18.45%,1
宜蘭縣,羅東鎮,0112,211,391,602,30,632,1109,56.99%,19.03%,1
宜蘭縣,羅東鎮,0113,189,394,583,27,610,1083,56.33%,17.45%,1
宜蘭縣,羅東鎮,0114,266,500,766,48,814,1404,57.98%,18.95%,1
宜蘭縣,羅東鎮,0115,248,446,694,48,742,1288,57.61%,19.25%,1
宜蘭縣,羅東鎮,0116,176,336,512,34,546,1183,46.15%,14.88%,1
宜蘭縣,羅東鎮,0117,202,421,623,36,659,1105,59.64%,18.28%,1
宜蘭縣,羅東鎮,0118,202,369,571,34,605,987,61.3%,20.47%,1
宜蘭縣,羅東鎮,0119,147,293,440,34,474,773,61.32%,19.02%,1
宜蘭縣,羅東鎮,0120,293,540,833,34,867,1366,63.47%,21.45%,1
宜蘭縣,羅東鎮,0121,187,371,558,28,586,907,64.61%,20.62%,1
宜蘭縣,羅東鎮,0122,216,467,683,36,719,1158,62.09%,18.65%,1
宜蘭縣,羅東鎮,0123,202,319,521,46,567,977,58.03%,20.68%,1
宜蘭縣,羅東鎮,0124,176,311,487,45,532,972,54.73%,18.11%,1
宜蘭縣,羅東鎮,0125,188,356,544,37,581,977,59.47%,19.24%,1
宜蘭縣,羅東鎮,0126,274,505,779,46,825,1398,59.01%,19.6%,1
宜蘭縣,羅東鎮,0127,197,351,548,28,576,1022,56.36%,19.28%,1
宜蘭縣,羅東鎮,0128,196,465,661,33,694,1131,61.36%,17.33%,1
宜蘭縣,蘇澳鎮,0129,202,415,617,56,673,1194,56.37%,16.92%,1
宜蘭縣,蘇澳鎮,0130,182,387,569,39,608,1128,53.9%,16.13%,1
宜蘭縣,蘇澳鎮,0131,236,364,600,44,644,1042,61.8%,22.65%,1
宜蘭縣,蘇澳鎮,0132,224,332,556,32,588,997,58.98%,22.47%,1
宜蘭縣,蘇澳鎮,0133,234,441,675,59,734,1303,56.33%,17.96%,1
宜蘭縣,蘇澳鎮,0134,240,448,688,59,747,1260,59.29%,19.05%,1
宜蘭縣,蘇澳鎮,0135,185,376,561,54,615,1130,54.42%,16.37%,1
宜蘭縣,蘇澳鎮,0136,91,187,278,39,317,559,56.71%,16.28%,1
宜蘭縣,蘇澳鎮,0137,56,111,167,20,187,351,53.28%,15.95%,1
宜蘭縣,蘇澳鎮,0138,149,292,441,54,495,889,55.68%,16.76%,1
宜蘭縣,蘇澳鎮,0139,74,152,226,17,243,434,55.99%,17.05%,1
宜蘭縣,蘇澳鎮,0140,151,329,480,26,506,835,60.6%,18.08%,1
宜蘭縣,蘇澳鎮,0141,185,333,518,42,560,975,57.44%,18.97%,1
宜蘭縣,蘇澳鎮,0142,160,450,610,65,675,1135,59.47%,14.1%,1
宜蘭縣,蘇澳鎮,0143,181,298,479,35,514,788,65.23%,22.97%,1
宜蘭縣,蘇澳鎮,0144,78,152,230,25,255,469,54.37%,16.63%,1
宜蘭縣,蘇澳鎮,0145,127,273,400,39,439,811,54.13%,15.66%,1
宜蘭縣,蘇澳鎮,0146,131,328,459,17,476,867,54.9%,15.11%,1
宜蘭縣,蘇澳鎮,0147,187,412,599,44,643,1139,56.45%,16.42%,1
宜蘭縣,蘇澳鎮,0148,171,393,564,39,603,1146,52.62%,14.92%,1
宜蘭縣,蘇澳鎮,0149,177,425,602,49,651,1154,56.41%,15.34%,1
宜蘭縣,蘇澳鎮,0150,157,283,440,17,457,908,50.33%,17.29%,1
宜蘭縣,蘇澳鎮,0151,92,243,335,28,363,656,55.34%,14.02%,1
宜蘭縣,蘇澳鎮,0152,158,328,486,37,523,834,62.71%,18.94%,1
宜蘭縣,蘇澳鎮,0153,169,406,575,39,614,1025,59.9%,16.49%,1
宜蘭縣,蘇澳鎮,0154,96,154,250,14,264,455,58.02%,21.1%,1
宜蘭縣,蘇澳鎮,0155,101,184,285,28,313,535,58.5%,18.88%,1
宜蘭縣,蘇澳鎮,0156,98,217,315,28,343,536,63.99%,18.28%,1
宜蘭縣,蘇澳鎮,0157,82,175,257,17,274,451,60.75%,18.18%,1
宜蘭縣,蘇澳鎮,0158,111,186,297,36,333,593,56.16%,18.72%,1
宜蘭縣,蘇澳鎮,0159,64,170,234,22,256,441,58.05%,14.51%,1
宜蘭縣,蘇澳鎮,0160,140,370,510,47,557,954,58.39%,14.68%,1
宜蘭縣,蘇澳鎮,0161,149,330,479,39,518,952,54.41%,15.65%,1
宜蘭縣,蘇澳鎮,0162,160,357,517,75,592,1125,52.62%,14.22%,1
宜蘭縣,蘇澳鎮,0163,108,257,365,65,430,763,56.36%,14.15%,1
宜蘭縣,蘇澳鎮,0164,125,166,291,31,322,706,45.61%,17.71%,1
宜蘭縣,蘇澳鎮,0165,131,326,457,62,519,1068,48.6%,12.27%,1
宜蘭縣,蘇澳鎮,0166,106,236,342,46,388,666,58.26%,15.92%,1
宜蘭縣,蘇澳鎮,0167,82,186,268,61,329,574,57.32%,14.29%,1
宜蘭縣,蘇澳鎮,0168,52,94,146,8,154,351,43.87%,14.81%,1
宜蘭縣,蘇澳鎮,0169,113,247,360,45,405,717,56.49%,15.76%,1
宜蘭縣,蘇澳鎮,0170,36,104,140,13,153,373,41.02%,9.65%,1
宜蘭縣,蘇澳鎮,0171,35,50,85,9,94,223,42.15%,15.7%,1
宜蘭縣,頭城鎮,0172,30,65,95,10,105,292,35.96%,10.27%,1
宜蘭縣,頭城鎮,0173,109,230,339,33,372,688,54.07%,15.84%,1
宜蘭縣,頭城鎮,0174,108,252,360,36,396,688,57.56%,15.7%,1
宜蘭縣,頭城鎮,0175,128,278,406,44,450,879,51.19%,14.56%,1
宜蘭縣,頭城鎮,0176,59,123,182,22,204,335,60.9%,17.61%,1
宜蘭縣,頭城鎮,0177,107,249,356,37,393,624,62.98%,17.15%,1
宜蘭縣,頭城鎮,0178,109,207,316,27,343,732,46.86%,14.89%,1
宜蘭縣,頭城鎮,0179,136,253,389,31,420,892,47.09%,15.25%,1
宜蘭縣,頭城鎮,0180,110,170,280,33,313,690,45.36%,15.94%,1
宜蘭縣,頭城鎮,0181,136,292,428,24,452,842,53.68%,16.15%,1
宜蘭縣,頭城鎮,0182,134,243,377,34,411,736,55.84%,18.21%,1
宜蘭縣,頭城鎮,0183,127,246,373,28,401,788,50.89%,16.12%,1
宜蘭縣,頭城鎮,0184,91,178,269,16,285,560,50.89%,16.25%,1
宜蘭縣,頭城鎮,0185,132,259,391,33,424,712,59.55%,18.54%,1
宜蘭縣,頭城鎮,0186,94,207,301,21,322,502,64.14%,18.73%,1
宜蘭縣,頭城鎮,0187,116,217,333,26,359,569,63.09%,20.39%,1
宜蘭縣,頭城鎮,0188,99,232,331,30,361,633,57.03%,15.64%,1
宜蘭縣,頭城鎮,0189,172,322,494,41,535,1132,47.26%,15.19%,1
宜蘭縣,頭城鎮,0190,146,315,461,35,496,1035,47.92%,14.11%,1
宜蘭縣,頭城鎮,0191,148,317,465,39,504,847,59.5%,17.47%,1
宜蘭縣,頭城鎮,0192,237,383,620,39,659,1172,56.23%,20.22%,1
宜蘭縣,頭城鎮,0193,164,282,446,25,471,896,52.57%,18.3%,1
宜蘭縣,頭城鎮,0194,198,407,605,19,624,1075,58.05%,18.42%,1
宜蘭縣,頭城鎮,0195,158,330,488,58,546,931,58.65%,16.97%,1
宜蘭縣,頭城鎮,0196,160,363,523,39,562,1021,55.04%,15.67%,1
宜蘭縣,頭城鎮,0197,97,221,318,33,351,709,49.51%,13.68%,1
宜蘭縣,頭城鎮,0198,102,301,403,39,442,689,64.15%,14.8%,1
宜蘭縣,頭城鎮,0199,112,245,357,28,385,615,62.6%,18.21%,1
宜蘭縣,頭城鎮,0200,117,260,377,38,415,759,54.68%,15.42%,1
宜蘭縣,頭城鎮,0201,149,366,515,49,564,917,61.5%,16.25%,1
宜蘭縣,頭城鎮,0202,169,374,543,59,602,1045,57.61%,16.17%,1
宜蘭縣,頭城鎮,0203,190,392,582,52,634,1130,56.11%,16.81%,1
宜蘭縣,礁溪鄉,0204,145,353,498,45,543,1122,48.4%,12.92%,1
宜蘭縣,礁溪鄉,0205,79,161,240,28,268,505,53.07%,15.64%,1
宜蘭縣,礁溪鄉,0206,142,341,483,28,511,988,51.72%,14.37%,1
宜蘭縣,礁溪鄉,0207,151,337,488,33,521,971,53.66%,15.55%,1
宜蘭縣,礁溪鄉,0208,188,399,587,33,620,1246,49.76%,15.09%,1
宜蘭縣,礁溪鄉,0209,248,503,751,28,779,1655,47.07%,14.98%,1
宜蘭縣,礁溪鄉,0210,157,322,479,31,510,1132,45.05%,13.87%,1
宜蘭縣,礁溪鄉,0211,144,274,418,24,442,783,56.45%,18.39%,1
宜蘭縣,礁溪鄉,0212,156,323,479,19,498,928,53.66%,16.81%,1
宜蘭縣,礁溪鄉,0213,116,306,422,34,456,848,53.77%,13.68%,1
宜蘭縣,礁溪鄉,0214,131,255,386,27,413,663,62.29%,19.76%,1
宜蘭縣,礁溪鄉,0215,99,223,322,17,339,608,55.76%,16.28%,1
宜蘭縣,礁溪鄉,0216,144,300,444,28,472,833,56.66%,17.29%,1
宜蘭縣,礁溪鄉,0217,198,377,575,14,589,1233,47.77%,16.06%,1
宜蘭縣,礁溪鄉,0218,198,246,444,36,480,854,56.21%,23.19%,1
宜蘭縣,礁溪鄉,0219,104,203,307,17,324,575,56.35%,18.09%,1
宜蘭縣,礁溪鄉,0220,138,294,432,37,469,835,56.17%,16.53%,1
宜蘭縣,礁溪鄉,0221,237,459,696,53,749,1305,57.39%,18.16%,1
宜蘭縣,礁溪鄉,0222,146,277,423,39,462,830,55.66%,17.59%,1
宜蘭縣,礁溪鄉,0223,138,248,386,41,427,649,65.79%,21.26%,1
宜蘭縣,礁溪鄉,0224,119,291,410,50,460,923,49.84%,12.89%,1
宜蘭縣,礁溪鄉,0225,153,353,506,39,545,1177,46.3%,13%,1
宜蘭縣,礁溪鄉,0226,131,296,427,34,461,840,54.88%,15.6%,1
宜蘭縣,礁溪鄉,0227,185,372,557,32,589,1051,56.04%,17.6%,1
宜蘭縣,礁溪鄉,0228,200,431,631,34,665,1339,49.66%,14.94%,1
宜蘭縣,礁溪鄉,0229,182,479,661,48,709,1194,59.38%,15.24%,1
宜蘭縣,礁溪鄉,0230,217,489,706,68,774,1314,58.9%,16.51%,1
宜蘭縣,礁溪鄉,0231,228,383,611,28,639,1125,56.8%,20.27%,1
宜蘭縣,礁溪鄉,0232,233,427,660,60,720,1207,59.65%,19.3%,1
宜蘭縣,礁溪鄉,0233,170,317,487,62,549,979,56.08%,17.36%,1
宜蘭縣,礁溪鄉,0234,171,361,532,52,584,954,61.22%,17.92%,1
宜蘭縣,礁溪鄉,0235,66,160,226,9,235,418,56.22%,15.79%,1
宜蘭縣,壯圍鄉,0236,295,500,795,80,875,1435,60.98%,20.56%,1
宜蘭縣,壯圍鄉,0237,388,193,581,48,629,1049,59.96%,36.99%,1
宜蘭縣,壯圍鄉,0238,197,410,607,48,655,1068,61.33%,18.45%,1
宜蘭縣,壯圍鄉,0239,137,281,418,82,500,868,57.6%,15.78%,1
宜蘭縣,壯圍鄉,0240,155,337,492,33,525,967,54.29%,16.03%,1
宜蘭縣,壯圍鄉,0241,185,331,516,58,574,940,61.06%,19.68%,1
宜蘭縣,壯圍鄉,0242,155,292,447,26,473,975,48.51%,15.9%,1
宜蘭縣,壯圍鄉,0243,136,306,442,58,500,797,62.74%,17.06%,1
宜蘭縣,壯圍鄉,0244,119,296,415,52,467,808,57.8%,14.73%,1
宜蘭縣,壯圍鄉,0245,183,287,470,75,545,911,59.82%,20.09%,1
宜蘭縣,壯圍鄉,0246,86,198,284,32,316,612,51.63%,14.05%,1
宜蘭縣,壯圍鄉,0247,139,319,458,46,504,790,63.8%,17.59%,1
宜蘭縣,壯圍鄉,0248,146,322,468,56,524,878,59.68%,16.63%,1
宜蘭縣,壯圍鄉,0249,154,285,439,37,476,723,65.84%,21.3%,1
宜蘭縣,壯圍鄉,0250,124,238,362,24,386,737,52.37%,16.82%,1
宜蘭縣,壯圍鄉,0251,127,237,364,49,413,686,60.2%,18.51%,1
宜蘭縣,壯圍鄉,0252,153,298,451,11,462,895,51.62%,17.09%,1
宜蘭縣,壯圍鄉,0253,212,477,689,67,756,1237,61.12%,17.14%,1
宜蘭縣,壯圍鄉,0254,206,385,591,60,651,1134,57.41%,18.17%,1
宜蘭縣,壯圍鄉,0255,189,377,566,48,614,1107,55.47%,17.07%,1
宜蘭縣,壯圍鄉,0256,181,401,582,41,623,1057,58.94%,17.12%,1
宜蘭縣,壯圍鄉,0257,159,345,504,37,541,1051,51.47%,15.13%,1
宜蘭縣,壯圍鄉,0258,140,214,354,48,402,722,55.68%,19.39%,1
宜蘭縣,員山鄉,0259,228,452,680,36,716,1393,51.4%,16.37%,1
宜蘭縣,員山鄉,0260,180,263,443,21,464,895,51.84%,20.11%,1
宜蘭縣,員山鄉,0261,319,275,594,52,646,1231,52.48%,25.91%,1
宜蘭縣,員山鄉,0262,170,373,543,22,565,1098,51.46%,15.48%,1
宜蘭縣,員山鄉,0263,167,339,506,31,537,1031,52.09%,16.2%,1
宜蘭縣,員山鄉,0264,151,342,493,63,556,1030,53.98%,14.66%,1
宜蘭縣,員山鄉,0265,164,352,516,39,555,1168,47.52%,14.04%,1
宜蘭縣,員山鄉,0266,126,292,418,44,462,809,57.11%,15.57%,1
宜蘭縣,員山鄉,0267,142,272,414,34,448,778,57.58%,18.25%,1
宜蘭縣,員山鄉,0268,255,532,787,58,845,1465,57.68%,17.41%,1
宜蘭縣,員山鄉,0269,176,347,523,58,581,979,59.35%,17.98%,1
宜蘭縣,員山鄉,0270,131,311,442,37,479,860,55.7%,15.23%,1
宜蘭縣,員山鄉,0271,164,377,541,59,600,1205,49.79%,13.61%,1
宜蘭縣,員山鄉,0272,187,361,548,63,611,1082,56.47%,17.28%,1
宜蘭縣,員山鄉,0273,71,143,214,30,244,412,59.22%,17.23%,1
宜蘭縣,員山鄉,0274,56,117,173,19,192,403,47.64%,13.9%,1
宜蘭縣,員山鄉,0275,18,74,92,12,104,232,44.83%,7.76%,1
宜蘭縣,員山鄉,0276,166,305,471,41,512,944,54.24%,17.58%,1
宜蘭縣,員山鄉,0277,172,287,459,41,500,894,55.93%,19.24%,1
宜蘭縣,員山鄉,0278,200,510,710,49,759,1356,55.97%,14.75%,1
宜蘭縣,員山鄉,0279,123,287,410,44,454,780,58.21%,15.77%,1
宜蘭縣,員山鄉,0280,175,351,526,61,587,932,62.98%,18.78%,1
宜蘭縣,員山鄉,0281,93,170,263,38,301,583,51.63%,15.95%,1
宜蘭縣,員山鄉,0282,122,322,444,54,498,900,55.33%,13.56%,1
宜蘭縣,員山鄉,0283,117,259,376,29,405,747,54.22%,15.66%,1
宜蘭縣,員山鄉,0284,127,256,383,48,431,788,54.7%,16.12%,1
宜蘭縣,員山鄉,0285,145,274,419,34,453,884,51.24%,16.4%,1
宜蘭縣,員山鄉,0286,123,290,413,27,440,857,51.34%,14.35%,1
宜蘭縣,員山鄉,0287,177,313,490,28,518,1016,50.98%,17.42%,1
宜蘭縣,員山鄉,0288,91,191,282,27,309,690,44.78%,13.19%,1
宜蘭縣,員山鄉,0289,124,184,308,57,365,689,52.98%,18%,1
宜蘭縣,冬山鄉,0290,165,270,435,51,486,807,60.22%,20.45%,1
宜蘭縣,冬山鄉,0291,179,283,462,16,478,817,58.51%,21.91%,1
宜蘭縣,冬山鄉,0292,217,403,620,40,660,1156,57.09%,18.77%,1
宜蘭縣,冬山鄉,0293,134,316,450,34,484,892,54.26%,15.02%,1
宜蘭縣,冬山鄉,0294,154,329,483,45,528,897,58.86%,17.17%,1
宜蘭縣,冬山鄉,0295,245,543,788,52,840,1392,60.34%,17.6%,1
宜蘭縣,冬山鄉,0296,351,453,804,35,839,1471,57.04%,23.86%,1
宜蘭縣,冬山鄉,0297,198,445,643,34,677,1435,47.18%,13.8%,1
宜蘭縣,冬山鄉,0298,242,500,742,39,781,1519,51.42%,15.93%,1
宜蘭縣,冬山鄉,0299,280,535,815,22,837,1456,57.49%,19.23%,1
宜蘭縣,冬山鄉,0300,127,270,397,37,434,711,61.04%,17.86%,1
宜蘭縣,冬山鄉,0301,117,267,384,20,404,694,58.21%,16.86%,1
宜蘭縣,冬山鄉,0302,274,622,896,64,960,1526,62.91%,17.96%,1
宜蘭縣,冬山鄉,0303,141,318,459,33,492,884,55.66%,15.95%,1
宜蘭縣,冬山鄉,0304,250,420,670,58,728,1465,49.69%,17.06%,1
宜蘭縣,冬山鄉,0305,78,178,256,22,278,488,56.97%,15.98%,1
宜蘭縣,冬山鄉,0306,181,417,598,52,650,1218,53.37%,14.86%,1
宜蘭縣,冬山鄉,0307,198,414,612,49,661,1291,51.2%,15.34%,1
宜蘭縣,冬山鄉,0308,198,437,635,28,663,1324,50.08%,14.95%,1
宜蘭縣,冬山鄉,0309,160,376,536,37,573,1160,49.4%,13.79%,1
宜蘭縣,冬山鄉,0310,188,436,624,46,670,1246,53.77%,15.09%,1
宜蘭縣,冬山鄉,0311,297,563,860,40,900,1754,51.31%,16.93%,1
宜蘭縣,冬山鄉,0312,195,408,603,44,647,1217,53.16%,16.02%,1
宜蘭縣,冬山鄉,0313,217,453,670,50,720,1495,48.16%,14.52%,1
宜蘭縣,冬山鄉,0314,167,303,470,41,511,937,54.54%,17.82%,1
宜蘭縣,冬山鄉,0315,187,347,534,33,567,1101,51.5%,16.98%,1
宜蘭縣,冬山鄉,0316,178,359,537,47,584,1118,52.24%,15.92%,1
宜蘭縣,冬山鄉,0317,230,489,719,30,749,1301,57.57%,17.68%,1
宜蘭縣,冬山鄉,0318,212,410,622,33,655,1225,53.47%,17.31%,1
宜蘭縣,冬山鄉,0319,229,444,673,35,708,1206,58.71%,18.99%,1
宜蘭縣,冬山鄉,0320,181,424,605,31,636,1278,49.77%,14.16%,1
宜蘭縣,冬山鄉,0321,170,398,568,33,601,1151,52.22%,14.77%,1
宜蘭縣,冬山鄉,0322,141,359,500,37,537,1094,49.09%,12.89%,1
宜蘭縣,冬山鄉,0323,242,425,667,37,704,1247,56.46%,19.41%,1
宜蘭縣,冬山鄉,0324,181,412,593,37,630,1247,50.52%,14.51%,1
宜蘭縣,冬山鄉,0325,171,335,506,32,538,979,54.95%,17.47%,1
宜蘭縣,冬山鄉,0326,128,277,405,16,421,698,60.32%,18.34%,1
宜蘭縣,冬山鄉,0327,289,583,872,37,909,1726,52.67%,16.74%,1
宜蘭縣,冬山鄉,0328,107,226,333,18,351,782,44.88%,13.68%,1
宜蘭縣,五結鄉,0329,158,335,493,50,543,1076,50.46%,14.68%,1
宜蘭縣,五結鄉,0330,167,304,471,27,498,944,52.75%,17.69%,1
宜蘭縣,五結鄉,0331,144,316,460,20,480,836,57.42%,17.22%,1
宜蘭縣,五結鄉,0332,175,317,492,33,525,937,56.03%,18.68%,1
宜蘭縣,五結鄉,0333,207,417,624,35,659,1255,52.51%,16.49%,1
宜蘭縣,五結鄉,0334,221,401,622,63,685,1270,53.94%,17.4%,1
宜蘭縣,五結鄉,0335,106,274,380,25,405,801,50.56%,13.23%,1
宜蘭縣,五結鄉,0336,136,249,385,33,418,802,52.12%,16.96%,1
宜蘭縣,五結鄉,0337,205,411,616,34,650,1306,49.77%,15.7%,1
宜蘭縣,五結鄉,0338,218,371,589,38,627,1190,52.69%,18.32%,1
宜蘭縣,五結鄉,0339,225,452,677,19,696,1316,52.89%,17.1%,1
宜蘭縣,五結鄉,0340,171,343,514,23,537,965,55.65%,17.72%,1
宜蘭縣,五結鄉,0341,130,282,412,27,439,814,53.93%,15.97%,1
宜蘭縣,五結鄉,0342,191,430,621,34,655,1254,52.23%,15.23%,1
宜蘭縣,五結鄉,0343,170,396,566,40,606,1060,57.17%,16.04%,1
宜蘭縣,五結鄉,0344,250,456,706,27,733,1323,55.4%,18.9%,1
宜蘭縣,五結鄉,0345,182,405,587,52,639,1120,57.05%,16.25%,1
宜蘭縣,五結鄉,0346,146,316,462,20,482,893,53.98%,16.35%,1
宜蘭縣,五結鄉,0347,208,398,606,38,644,1220,52.79%,17.05%,1
宜蘭縣,五結鄉,0348,162,347,509,27,536,924,58.01%,17.53%,1
宜蘭縣,五結鄉,0349,168,350,518,45,563,933,60.34%,18.01%,1
宜蘭縣,五結鄉,0350,152,346,498,30,528,986,53.55%,15.42%,1
宜蘭縣,五結鄉,0351,127,243,370,38,408,748,54.55%,16.98%,1
宜蘭縣,五結鄉,0352,286,489,775,62,837,1550,54%,18.45%,1
宜蘭縣,五結鄉,0353,91,247,338,27,365,629,58.03%,14.47%,1
宜蘭縣,五結鄉,0354,142,261,403,37,440,806,54.59%,17.62%,1
宜蘭縣,五結鄉,0355,185,264,449,52,501,956,52.41%,19.35%,1
宜蘭縣,五結鄉,0356,150,380,530,37,567,1066,53.19%,14.07%,1
宜蘭縣,五結鄉,0357,234,458,692,58,750,1513,49.57%,15.47%,1
宜蘭縣,五結鄉,0358,232,540,772,53,825,1566,52.68%,14.81%,1
宜蘭縣,五結鄉,0359,162,280,442,54,496,894,55.48%,18.12%,1
宜蘭縣,五結鄉,0360,198,334,532,50,582,1235,47.13%,16.03%,1
宜蘭縣,五結鄉,0361,106,249,355,44,399,704,56.68%,15.06%,1
宜蘭縣,三星鄉,0362,28,72,100,17,117,215,54.42%,13.02%,1
宜蘭縣,三星鄉,0363,74,137,211,29,240,523,45.89%,14.15%,1
宜蘭縣,三星鄉,0364,134,213,347,43,390,745,52.35%,17.99%,1
宜蘭縣,三星鄉,0365,85,205,290,27,317,617,51.38%,13.78%,1
宜蘭縣,三星鄉,0366,70,165,235,30,265,497,53.32%,14.08%,1
宜蘭縣,三星鄉,0367,116,244,360,51,411,735,55.92%,15.78%,1
宜蘭縣,三星鄉,0368,87,204,291,35,326,583,55.92%,14.92%,1
宜蘭縣,三星鄉,0369,49,160,209,26,235,436,53.9%,11.24%,1
宜蘭縣,三星鄉,0370,179,398,577,60,637,1224,52.04%,14.62%,1
宜蘭縣,三星鄉,0371,190,305,495,61,556,1151,48.31%,16.51%,1
宜蘭縣,三星鄉,0372,135,317,452,30,482,870,55.4%,15.52%,1
宜蘭縣,三星鄉,0373,140,356,496,38,534,1284,41.59%,10.9%,1
宜蘭縣,三星鄉,0374,157,330,487,44,531,897,59.2%,17.5%,1
宜蘭縣,三星鄉,0375,213,515,728,51,779,1439,54.13%,14.8%,1
宜蘭縣,三星鄉,0376,226,455,681,55,736,1445,50.93%,15.64%,1
宜蘭縣,三星鄉,0377,189,510,699,39,738,1402,52.64%,13.48%,1
宜蘭縣,三星鄉,0378,225,384,609,39,648,1230,52.68%,18.29%,1
宜蘭縣,三星鄉,0379,101,285,386,46,432,774,55.81%,13.05%,1
宜蘭縣,三星鄉,0380,145,296,441,39,480,827,58.04%,17.53%,1
宜蘭縣,三星鄉,0381,137,235,372,22,394,736,53.53%,18.61%,1
宜蘭縣,三星鄉,0382,225,449,674,66,740,1421,52.08%,15.83%,1
宜蘭縣,大同鄉,0383,108,292,400,43,443,893,49.61%,12.09%,1
宜蘭縣,大同鄉,0384,82,345,427,34,461,632,72.94%,12.97%,1
宜蘭縣,大同鄉,0385,89,330,419,17,436,684,63.74%,13.01%,1
宜蘭縣,大同鄉,0386,43,112,155,20,175,264,66.29%,16.29%,1
宜蘭縣,大同鄉,0387,29,141,170,6,176,337,52.23%,8.61%,1
宜蘭縣,大同鄉,0388,35,197,232,8,240,404,59.41%,8.66%,1
宜蘭縣,大同鄉,0389,4,21,25,2,27,55,49.09%,7.27%,1
宜蘭縣,大同鄉,0390,24,115,139,15,154,199,77.39%,12.06%,1
宜蘭縣,大同鄉,0391,79,241,320,12,332,787,42.19%,10.04%,1
宜蘭縣,大同鄉,0392,63,347,410,35,445,680,65.44%,9.26%,1
宜蘭縣,南澳鄉,0393,65,174,239,8,247,444,55.63%,14.64%,1
宜蘭縣,南澳鄉,0394,125,481,606,20,626,1210,51.74%,10.33%,1
宜蘭縣,南澳鄉,0395,72,514,586,61,647,962,67.26%,7.48%,1
宜蘭縣,南澳鄉,0396,36,152,188,6,194,411,47.2%,8.76%,1
宜蘭縣,南澳鄉,0397,56,232,288,21,309,447,69.13%,12.53%,1
宜蘭縣,南澳鄉,0398,64,279,343,29,372,475,78.32%,13.47%,1
宜蘭縣,南澳鄉,0399,68,319,387,30,417,695,60%,9.78%,1
花蓮縣,花蓮市,0001,264,581,845,23,868,1522,57.03%,17.35%,1
花蓮縣,花蓮市,0002,171,456,627,24,651,1114,58.44%,15.35%,1
花蓮縣,花蓮市,0003,100,256,356,21,377,670,56.27%,14.93%,1
花蓮縣,花蓮市,0004,217,501,718,20,738,1397,52.83%,15.53%,1
花蓮縣,花蓮市,0005,59,158,217,22,239,470,50.85%,12.55%,1
花蓮縣,花蓮市,0006,97,308,405,27,432,838,51.55%,11.58%,1
花蓮縣,花蓮市,0007,65,224,289,18,307,721,42.58%,9.02%,1
花蓮縣,花蓮市,0008,140,351,491,41,532,918,57.95%,15.25%,1
花蓮縣,花蓮市,0009,247,531,778,31,809,1539,52.57%,16.05%,1
花蓮縣,花蓮市,0010,191,521,712,35,747,1403,53.24%,13.61%,1
花蓮縣,花蓮市,0011,143,395,538,26,564,1068,52.81%,13.39%,1
花蓮縣,花蓮市,0012,172,450,622,25,647,1167,55.44%,14.74%,1
花蓮縣,花蓮市,0013,190,508,698,54,752,1259,59.73%,15.09%,1
花蓮縣,花蓮市,0014,152,390,542,54,596,1071,55.65%,14.19%,1
花蓮縣,花蓮市,0015,148,354,502,27,529,925,57.19%,16%,1
花蓮縣,花蓮市,0016,184,479,663,50,713,1141,62.49%,16.13%,1
花蓮縣,花蓮市,0017,162,435,597,17,614,1163,52.79%,13.93%,1
花蓮縣,花蓮市,0018,185,523,708,38,746,1279,58.33%,14.46%,1
花蓮縣,花蓮市,0019,216,509,725,20,745,1512,49.27%,14.29%,1
花蓮縣,花蓮市,0020,99,213,312,22,334,615,54.31%,16.1%,1
花蓮縣,花蓮市,0021,113,226,339,19,358,606,59.08%,18.65%,1
花蓮縣,花蓮市,0022,71,205,276,13,289,559,51.7%,12.7%,1
花蓮縣,花蓮市,0023,64,173,237,10,247,442,55.88%,14.48%,1
花蓮縣,花蓮市,0024,163,385,548,26,574,1114,51.53%,14.63%,1
花蓮縣,花蓮市,0025,59,170,229,10,239,416,57.45%,14.18%,1
花蓮縣,花蓮市,0026,94,246,340,15,355,577,61.53%,16.29%,1
花蓮縣,花蓮市,0027,154,313,467,28,495,810,61.11%,19.01%,1
花蓮縣,花蓮市,0028,80,212,292,17,309,538,57.43%,14.87%,1
花蓮縣,花蓮市,0029,77,207,284,26,310,566,54.77%,13.6%,1
花蓮縣,花蓮市,0030,81,172,253,8,261,469,55.65%,17.27%,1
花蓮縣,花蓮市,0031,95,206,301,23,324,565,57.35%,16.81%,1
花蓮縣,花蓮市,0032,98,286,384,25,409,816,50.12%,12.01%,1
花蓮縣,花蓮市,0033,124,332,456,24,480,911,52.69%,13.61%,1
花蓮縣,花蓮市,0034,114,384,498,41,539,1029,52.38%,11.08%,1
花蓮縣,花蓮市,0035,165,417,582,33,615,1043,58.96%,15.82%,1
花蓮縣,花蓮市,0036,138,345,483,12,495,856,57.83%,16.12%,1
花蓮縣,花蓮市,0037,159,361,520,18,538,979,54.95%,16.24%,1
花蓮縣,花蓮市,0038,217,498,715,37,752,1331,56.5%,16.3%,1
花蓮縣,花蓮市,0039,198,472,670,25,695,1228,56.6%,16.12%,1
花蓮縣,花蓮市,0040,141,386,527,20,547,955,57.28%,14.76%,1
花蓮縣,花蓮市,0041,181,433,614,27,641,1268,50.55%,14.27%,1
花蓮縣,花蓮市,0042,166,448,614,30,644,1230,52.36%,13.5%,1
花蓮縣,花蓮市,0043,205,541,746,29,775,1369,56.61%,14.97%,1
花蓮縣,花蓮市,0044,189,442,631,36,667,1435,46.48%,13.17%,1
花蓮縣,花蓮市,0045,173,443,616,23,639,1164,54.9%,14.86%,1
花蓮縣,花蓮市,0046,188,510,698,42,740,1249,59.25%,15.05%,1
花蓮縣,花蓮市,0047,180,422,602,54,656,1184,55.41%,15.2%,1
花蓮縣,花蓮市,0048,225,530,755,18,773,1490,51.88%,15.1%,1
花蓮縣,花蓮市,0049,165,437,602,42,644,1022,63.01%,16.14%,1
花蓮縣,花蓮市,0050,151,444,595,46,641,1135,56.48%,13.3%,1
花蓮縣,花蓮市,0051,129,454,583,27,610,1084,56.27%,11.9%,1
花蓮縣,花蓮市,0052,145,329,474,25,499,1339,37.27%,10.83%,1
花蓮縣,花蓮市,0053,82,205,287,15,302,501,60.28%,16.37%,1
花蓮縣,花蓮市,0054,134,352,486,18,504,904,55.75%,14.82%,1
花蓮縣,花蓮市,0055,88,202,290,14,304,490,62.04%,17.96%,1
花蓮縣,花蓮市,0056,152,397,549,27,576,1192,48.32%,12.75%,1
花蓮縣,花蓮市,0057,116,290,406,29,435,869,50.06%,13.35%,1
花蓮縣,花蓮市,0058,189,458,647,29,676,1267,53.35%,14.92%,1
花蓮縣,花蓮市,0059,148,379,527,29,556,959,57.98%,15.43%,1
花蓮縣,花蓮市,0060,120,392,512,32,544,993,54.78%,12.08%,1
花蓮縣,花蓮市,0061,156,360,516,36,552,982,56.21%,15.89%,1
花蓮縣,花蓮市,0062,181,438,619,24,643,1311,49.05%,13.81%,1
花蓮縣,花蓮市,0063,202,509,711,37,748,1455,51.41%,13.88%,1
花蓮縣,花蓮市,0064,130,381,511,25,536,1151,46.57%,11.29%,1
花蓮縣,花蓮市,0065,161,435,596,18,614,1237,49.64%,13.02%,1
花蓮縣,花蓮市,0066,215,400,615,29,644,1339,48.1%,16.06%,1
花蓮縣,花蓮市,0067,117,280,397,18,415,715,58.04%,16.36%,1
花蓮縣,花蓮市,0068,160,372,532,26,558,1000,55.8%,16%,1
花蓮縣,花蓮市,0069,163,492,655,45,700,1410,49.65%,11.56%,1
花蓮縣,花蓮市,0070,119,496,615,61,676,1303,51.88%,9.13%,1
花蓮縣,花蓮市,0071,162,482,644,27,671,1256,53.42%,12.9%,1
花蓮縣,花蓮市,0072,146,475,621,16,637,1105,57.65%,13.21%,1
花蓮縣,花蓮市,0073,156,380,536,21,557,1089,51.15%,14.33%,1
花蓮縣,花蓮市,0074,136,361,497,31,528,1043,50.62%,13.04%,1
花蓮縣,花蓮市,0075,146,455,601,18,619,1080,57.31%,13.52%,1
花蓮縣,花蓮市,0076,149,349,498,32,530,971,54.58%,15.35%,1
花蓮縣,花蓮市,0077,187,392,579,33,612,1068,57.3%,17.51%,1
花蓮縣,花蓮市,0078,180,477,657,35,692,1379,50.18%,13.05%,1
花蓮縣,花蓮市,0079,195,497,692,25,717,1362,52.64%,14.32%,1
花蓮縣,花蓮市,0080,227,503,730,26,756,1323,57.14%,17.16%,1
花蓮縣,花蓮市,0081,177,474,651,28,679,1482,45.82%,11.94%,1
花蓮縣,鳳林鎮,0195,156,526,682,51,733,1192,61.49%,13.09%,1
花蓮縣,鳳林鎮,0196,67,240,307,18,325,639,50.86%,10.49%,1
花蓮縣,鳳林鎮,0197,96,270,366,35,401,601,66.72%,15.97%,1
花蓮縣,鳳林鎮,0198,183,505,688,43,731,1137,64.29%,16.09%,1
花蓮縣,鳳林鎮,0199,101,276,377,41,418,742,56.33%,13.61%,1
花蓮縣,鳳林鎮,0200,79,250,329,22,351,610,57.54%,12.95%,1
花蓮縣,鳳林鎮,0201,38,115,153,39,192,295,65.08%,12.88%,1
花蓮縣,鳳林鎮,0202,17,44,61,6,67,218,30.73%,7.8%,1
花蓮縣,鳳林鎮,0203,82,215,297,17,314,720,43.61%,11.39%,1
花蓮縣,鳳林鎮,0204,72,189,261,29,290,528,54.92%,13.64%,1
花蓮縣,鳳林鎮,0205,83,189,272,19,291,560,51.96%,14.82%,1
花蓮縣,鳳林鎮,0206,67,179,246,45,291,541,53.79%,12.38%,1
花蓮縣,鳳林鎮,0207,95,318,413,51,464,818,56.72%,11.61%,1
花蓮縣,鳳林鎮,0208,93,296,389,41,430,984,43.7%,9.45%,1
花蓮縣,鳳林鎮,0209,13,26,39,11,50,91,54.95%,14.29%,1
花蓮縣,玉里鎮,0254,141,373,514,35,549,1008,54.46%,13.99%,1
花蓮縣,玉里鎮,0255,121,399,520,38,558,939,59.42%,12.89%,1
花蓮縣,玉里鎮,0256,152,447,599,59,658,1256,52.39%,12.1%,1
花蓮縣,玉里鎮,0257,122,347,469,37,506,929,54.47%,13.13%,1
花蓮縣,玉里鎮,0258,129,365,494,41,535,979,54.65%,13.18%,1
花蓮縣,玉里鎮,0259,193,499,692,36,728,1244,58.52%,15.51%,1
花蓮縣,玉里鎮,0260,97,278,375,43,418,847,49.35%,11.45%,1
花蓮縣,玉里鎮,0261,93,238,331,49,380,772,49.22%,12.05%,1
花蓮縣,玉里鎮,0262,68,192,260,19,279,558,50%,12.19%,1
花蓮縣,玉里鎮,0263,49,187,236,24,260,800,32.5%,6.13%,1
花蓮縣,玉里鎮,0264,113,415,528,68,596,1286,46.35%,8.79%,1
花蓮縣,玉里鎮,0265,152,375,527,71,598,1246,47.99%,12.2%,1
花蓮縣,玉里鎮,0266,80,212,292,56,348,647,53.79%,12.36%,1
花蓮縣,玉里鎮,0267,53,170,223,20,243,990,24.55%,5.35%,1
花蓮縣,玉里鎮,0268,57,146,203,59,262,530,49.43%,10.75%,1
花蓮縣,玉里鎮,0269,77,258,335,39,374,979,38.2%,7.87%,1
花蓮縣,玉里鎮,0270,58,186,244,76,320,557,57.45%,10.41%,1
花蓮縣,玉里鎮,0271,36,121,157,20,177,434,40.78%,8.29%,1
花蓮縣,玉里鎮,0272,94,217,311,70,381,1065,35.77%,8.83%,1
花蓮縣,玉里鎮,0273,91,286,377,94,471,866,54.39%,10.51%,1
花蓮縣,玉里鎮,0274,72,211,283,52,335,769,43.56%,9.36%,1
花蓮縣,玉里鎮,0275,109,227,336,36,372,869,42.81%,12.54%,1
花蓮縣,玉里鎮,0276,122,283,405,41,446,1080,41.3%,11.3%,1
花蓮縣,新城鄉,0082,61,134,195,16,211,367,57.49%,16.62%,1
花蓮縣,新城鄉,0083,119,334,453,16,469,929,50.48%,12.81%,1
花蓮縣,新城鄉,0084,96,209,305,50,355,590,60.17%,16.27%,1
花蓮縣,新城鄉,0085,47,105,152,21,173,307,56.35%,15.31%,1
花蓮縣,新城鄉,0086,30,113,143,17,160,260,61.54%,11.54%,1
花蓮縣,新城鄉,0087,202,455,657,62,719,1283,56.04%,15.74%,1
花蓮縣,新城鄉,0088,83,342,425,25,450,885,50.85%,9.38%,1
花蓮縣,新城鄉,0089,98,314,412,34,446,770,57.92%,12.73%,1
花蓮縣,新城鄉,0090,170,518,688,53,741,1363,54.37%,12.47%,1
花蓮縣,新城鄉,0091,55,124,179,18,197,366,53.83%,15.03%,1
花蓮縣,新城鄉,0092,149,396,545,49,594,1163,51.07%,12.81%,1
花蓮縣,新城鄉,0093,224,593,817,31,848,1605,52.83%,13.96%,1
花蓮縣,新城鄉,0094,166,453,619,38,657,1194,55.03%,13.9%,1
花蓮縣,新城鄉,0095,139,377,516,36,552,979,56.38%,14.2%,1
花蓮縣,新城鄉,0096,207,578,785,44,829,1485,55.82%,13.94%,1
花蓮縣,新城鄉,0097,145,383,528,30,558,1070,52.15%,13.55%,1
花蓮縣,新城鄉,0098,179,433,612,21,633,1164,54.38%,15.38%,1
花蓮縣,新城鄉,0099,113,308,421,47,468,880,53.18%,12.84%,1
花蓮縣,新城鄉,0100,53,124,177,9,186,369,50.41%,14.36%,1
花蓮縣,吉安鄉,0115,150,378,528,33,561,1059,52.97%,14.16%,1
花蓮縣,吉安鄉,0116,147,372,519,28,547,983,55.65%,14.95%,1
花蓮縣,吉安鄉,0117,138,399,537,27,564,1031,54.7%,13.39%,1
花蓮縣,吉安鄉,0118,158,382,540,31,571,1105,51.67%,14.3%,1
花蓮縣,吉安鄉,0119,165,384,549,29,578,1107,52.21%,14.91%,1
花蓮縣,吉安鄉,0120,155,405,560,30,590,1179,50.04%,13.15%,1
花蓮縣,吉安鄉,0121,167,447,614,51,665,1453,45.77%,11.49%,1
花蓮縣,吉安鄉,0122,229,572,801,39,840,1432,58.66%,15.99%,1
花蓮縣,吉安鄉,0123,190,516,706,21,727,1320,55.08%,14.39%,1
花蓮縣,吉安鄉,0124,189,493,682,21,703,1356,51.84%,13.94%,1
花蓮縣,吉安鄉,0125,164,483,647,31,678,1295,52.36%,12.66%,1
花蓮縣,吉安鄉,0126,190,547,737,61,798,1467,54.4%,12.95%,1
花蓮縣,吉安鄉,0127,195,569,764,28,792,1515,52.28%,12.87%,1
花蓮縣,吉安鄉,0128,159,428,587,44,631,1063,59.36%,14.96%,1
花蓮縣,吉安鄉,0129,165,393,558,19,577,1284,44.94%,12.85%,1
花蓮縣,吉安鄉,0130,209,540,749,24,773,1380,56.01%,15.14%,1
花蓮縣,吉安鄉,0131,191,501,692,49,741,1297,57.13%,14.73%,1
花蓮縣,吉安鄉,0132,247,544,791,65,856,1662,51.5%,14.86%,1
花蓮縣,吉安鄉,0133,163,526,689,65,754,1563,48.24%,10.43%,1
花蓮縣,吉安鄉,0134,128,446,574,49,623,1288,48.37%,9.94%,1
花蓮縣,吉安鄉,0135,133,354,487,28,515,907,56.78%,14.66%,1
花蓮縣,吉安鄉,0136,102,333,435,38,473,917,51.58%,11.12%,1
花蓮縣,吉安鄉,0137,132,360,492,34,526,1021,51.52%,12.93%,1
花蓮縣,吉安鄉,0138,160,423,583,31,614,1033,59.44%,15.49%,1
花蓮縣,吉安鄉,0139,135,374,509,43,552,966,57.14%,13.98%,1
花蓮縣,吉安鄉,0140,153,423,576,48,624,1188,52.53%,12.88%,1
花蓮縣,吉安鄉,0141,180,563,743,30,773,1480,52.23%,12.16%,1
花蓮縣,吉安鄉,0142,149,489,638,36,674,1393,48.38%,10.7%,1
花蓮縣,吉安鄉,0143,150,432,582,32,614,1193,51.47%,12.57%,1
花蓮縣,吉安鄉,0144,179,498,677,25,702,1445,48.58%,12.39%,1
花蓮縣,吉安鄉,0145,158,491,649,73,722,1301,55.5%,12.14%,1
花蓮縣,吉安鄉,0146,171,464,635,55,690,1215,56.79%,14.07%,1
花蓮縣,吉安鄉,0147,170,415,585,25,610,1135,53.74%,14.98%,1
花蓮縣,吉安鄉,0148,165,501,666,29,695,1223,56.83%,13.49%,1
花蓮縣,吉安鄉,0149,156,519,675,29,704,1274,55.26%,12.24%,1
花蓮縣,吉安鄉,0150,145,422,567,27,594,1124,52.85%,12.9%,1
花蓮縣,吉安鄉,0151,190,436,626,25,651,1158,56.22%,16.41%,1
花蓮縣,吉安鄉,0152,177,456,633,14,647,1157,55.92%,15.3%,1
花蓮縣,吉安鄉,0153,175,487,662,31,693,1258,55.09%,13.91%,1
花蓮縣,吉安鄉,0154,166,470,636,36,672,1257,53.46%,13.21%,1
花蓮縣,吉安鄉,0155,166,461,627,26,653,1245,52.45%,13.33%,1
花蓮縣,吉安鄉,0156,178,458,636,14,650,1166,55.75%,15.27%,1
花蓮縣,吉安鄉,0157,162,498,660,54,714,1358,52.58%,11.93%,1
花蓮縣,吉安鄉,0158,127,469,596,33,629,1214,51.81%,10.46%,1
花蓮縣,吉安鄉,0159,147,438,585,35,620,1151,53.87%,12.77%,1
花蓮縣,吉安鄉,0160,153,464,617,26,643,1157,55.57%,13.22%,1
花蓮縣,吉安鄉,0161,168,457,625,30,655,1161,56.42%,14.47%,1
花蓮縣,吉安鄉,0162,177,517,694,43,737,1304,56.52%,13.57%,1
花蓮縣,吉安鄉,0163,188,484,672,45,717,1367,52.45%,13.75%,1
花蓮縣,吉安鄉,0164,157,472,629,37,666,1411,47.2%,11.13%,1
花蓮縣,吉安鄉,0165,146,482,628,39,667,1409,47.34%,10.36%,1
花蓮縣,吉安鄉,0166,129,379,508,31,539,1125,47.91%,11.47%,1
花蓮縣,吉安鄉,0167,144,468,612,59,671,1213,55.32%,11.87%,1
花蓮縣,吉安鄉,0168,142,453,595,31,626,1141,54.86%,12.45%,1
花蓮縣,吉安鄉,0169,117,401,518,25,543,1156,46.97%,10.12%,1
花蓮縣,吉安鄉,0170,130,405,535,33,568,1092,52.01%,11.9%,1
花蓮縣,吉安鄉,0171,108,320,428,40,468,1026,45.61%,10.53%,1
花蓮縣,吉安鄉,0172,81,334,415,14,429,804,53.36%,10.07%,1
花蓮縣,吉安鄉,0173,128,467,595,32,627,1132,55.39%,11.31%,1
花蓮縣,壽豐鄉,0174,120,350,470,46,516,1052,49.05%,11.41%,1
花蓮縣,壽豐鄉,0175,47,138,185,33,218,357,61.06%,13.17%,1
花蓮縣,壽豐鄉,0176,115,348,463,52,515,1022,50.39%,11.25%,1
花蓮縣,壽豐鄉,0177,134,373,507,41,548,875,62.63%,15.31%,1
花蓮縣,壽豐鄉,0178,115,277,392,32,424,691,61.36%,16.64%,1
花蓮縣,壽豐鄉,0179,81,240,321,24,345,708,48.73%,11.44%,1
花蓮縣,壽豐鄉,0180,129,296,425,49,474,894,53.02%,14.43%,1
花蓮縣,壽豐鄉,0181,109,275,384,26,410,746,54.96%,14.61%,1
花蓮縣,壽豐鄉,0182,101,328,429,40,469,881,53.23%,11.46%,1
花蓮縣,壽豐鄉,0183,113,294,407,30,437,695,62.88%,16.26%,1
花蓮縣,壽豐鄉,0184,112,345,457,64,521,816,63.85%,13.73%,1
花蓮縣,壽豐鄉,0185,100,255,355,40,395,773,51.1%,12.94%,1
花蓮縣,壽豐鄉,0186,153,395,548,40,588,1029,57.14%,14.87%,1
花蓮縣,壽豐鄉,0187,48,186,234,24,258,407,63.39%,11.79%,1
花蓮縣,壽豐鄉,0188,160,454,614,39,653,1139,57.33%,14.05%,1
花蓮縣,壽豐鄉,0189,205,337,542,32,574,996,57.63%,20.58%,1
花蓮縣,壽豐鄉,0190,52,125,177,11,188,414,45.41%,12.56%,1
花蓮縣,壽豐鄉,0191,29,115,144,13,157,270,58.15%,10.74%,1
花蓮縣,壽豐鄉,0192,97,342,439,50,489,836,58.49%,11.6%,1
花蓮縣,壽豐鄉,0193,76,208,284,25,309,507,60.95%,14.99%,1
花蓮縣,壽豐鄉,0194,65,204,269,47,316,739,42.76%,8.8%,1
花蓮縣,光復鄉,0210,162,495,657,75,732,1295,56.53%,12.51%,1
花蓮縣,光復鄉,0211,119,341,460,41,501,859,58.32%,13.85%,1
花蓮縣,光復鄉,0212,102,366,468,102,570,958,59.5%,10.65%,1
花蓮縣,光復鄉,0213,106,394,500,88,588,1011,58.16%,10.48%,1
花蓮縣,光復鄉,0214,121,413,534,69,603,1041,57.93%,11.62%,1
花蓮縣,光復鄉,0215,89,280,369,81,450,821,54.81%,10.84%,1
花蓮縣,光復鄉,0216,8,33,41,3,44,188,23.4%,4.26%,1
花蓮縣,光復鄉,0217,55,190,245,36,281,514,54.67%,10.7%,1
花蓮縣,光復鄉,0218,41,127,168,7,175,446,39.24%,9.19%,1
花蓮縣,光復鄉,0219,78,301,379,52,431,851,50.65%,9.17%,1
花蓮縣,光復鄉,0220,98,226,324,20,344,932,36.91%,10.52%,1
花蓮縣,光復鄉,0221,62,191,253,17,270,471,57.32%,13.16%,1
花蓮縣,光復鄉,0222,91,228,319,36,355,640,55.47%,14.22%,1
花蓮縣,光復鄉,0223,8,34,42,3,45,116,38.79%,6.9%,1
花蓮縣,光復鄉,0224,40,118,158,7,165,496,33.27%,8.06%,1
花蓮縣,光復鄉,0225,38,100,138,8,146,324,45.06%,11.73%,1
花蓮縣,光復鄉,0226,28,129,157,24,181,454,39.87%,6.17%,1
花蓮縣,豐濱鄉,0227,68,206,274,70,344,717,47.98%,9.48%,1
花蓮縣,豐濱鄉,0228,89,176,265,47,312,751,41.54%,11.85%,1
花蓮縣,豐濱鄉,0229,65,178,243,49,292,613,47.63%,10.6%,1
花蓮縣,豐濱鄉,0230,100,283,383,30,413,809,51.05%,12.36%,1
花蓮縣,豐濱鄉,0231,23,63,86,2,88,357,24.65%,6.44%,1
花蓮縣,豐濱鄉,0232,77,200,277,64,341,669,50.97%,11.51%,1
花蓮縣,豐濱鄉,0233,63,142,205,11,216,479,45.09%,13.15%,1
花蓮縣,瑞穗鄉,0241,98,345,443,32,475,813,58.43%,12.05%,1
花蓮縣,瑞穗鄉,0242,121,434,555,54,609,1091,55.82%,11.09%,1
花蓮縣,瑞穗鄉,0243,99,343,442,35,477,839,56.85%,11.8%,1
花蓮縣,瑞穗鄉,0244,97,396,493,64,557,975,57.13%,9.95%,1
花蓮縣,瑞穗鄉,0245,54,184,238,22,260,546,47.62%,9.89%,1
花蓮縣,瑞穗鄉,0246,139,365,504,68,572,1002,57.09%,13.87%,1
花蓮縣,瑞穗鄉,0247,65,187,252,28,280,593,47.22%,10.96%,1
花蓮縣,瑞穗鄉,0248,118,338,456,76,532,965,55.13%,12.23%,1
花蓮縣,瑞穗鄉,0249,94,323,417,60,477,863,55.27%,10.89%,1
花蓮縣,瑞穗鄉,0250,14,63,77,8,85,340,25%,4.12%,1
花蓮縣,瑞穗鄉,0251,66,247,313,41,354,764,46.34%,8.64%,1
花蓮縣,瑞穗鄉,0252,33,158,191,13,204,868,23.5%,3.8%,1
花蓮縣,瑞穗鄉,0253,31,149,180,15,195,620,31.45%,5%,1
花蓮縣,富里鄉,0277,39,146,185,15,200,467,42.83%,8.35%,1
花蓮縣,富里鄉,0278,103,257,360,52,412,1032,39.92%,9.98%,1
花蓮縣,富里鄉,0279,38,217,255,24,279,638,43.73%,5.96%,1
花蓮縣,富里鄉,0280,72,188,260,61,321,591,54.31%,12.18%,1
花蓮縣,富里鄉,0281,120,416,536,58,594,1087,54.65%,11.04%,1
花蓮縣,富里鄉,0282,63,149,212,12,224,431,51.97%,14.62%,1
花蓮縣,富里鄉,0283,115,282,397,39,436,893,48.82%,12.88%,1
花蓮縣,富里鄉,0284,32,101,133,16,149,361,41.27%,8.86%,1
花蓮縣,富里鄉,0285,129,383,512,35,547,1362,40.16%,9.47%,1
花蓮縣,富里鄉,0286,45,167,212,27,239,458,52.18%,9.83%,1
花蓮縣,富里鄉,0287,32,138,170,37,207,621,33.33%,5.15%,1
花蓮縣,富里鄉,0288,50,170,220,24,244,493,49.49%,10.14%,1
花蓮縣,富里鄉,0289,75,196,271,34,305,631,48.34%,11.89%,1
花蓮縣,秀林鄉,0101,80,349,429,22,451,867,52.02%,9.23%,1
花蓮縣,秀林鄉,0102,87,187,274,26,300,575,52.17%,15.13%,1
花蓮縣,秀林鄉,0103,135,409,544,35,579,1373,42.17%,9.83%,1
花蓮縣,秀林鄉,0104,173,547,720,71,791,1644,48.11%,10.52%,1
花蓮縣,秀林鄉,0105,15,70,85,5,90,162,55.56%,9.26%,1
花蓮縣,秀林鄉,0106,48,124,172,23,195,384,50.78%,12.5%,1
花蓮縣,秀林鄉,0107,174,437,611,44,655,1382,47.4%,12.59%,1
花蓮縣,秀林鄉,0108,150,364,514,38,552,1125,49.07%,13.33%,1
花蓮縣,秀林鄉,0109,108,185,293,17,310,627,49.44%,17.22%,1
花蓮縣,秀林鄉,0110,145,412,557,49,606,987,61.4%,14.69%,1
花蓮縣,秀林鄉,0111,183,440,623,78,701,1139,61.55%,16.07%,1
花蓮縣,秀林鄉,0112,165,482,647,11,658,1213,54.25%,13.6%,1
花蓮縣,秀林鄉,0113,109,274,383,23,406,754,53.85%,14.46%,1
花蓮縣,秀林鄉,0114,30,122,152,7,159,330,48.18%,9.09%,1
花蓮縣,萬榮鄉,0234,155,379,534,67,601,1072,56.06%,14.46%,1
花蓮縣,萬榮鄉,0235,69,190,259,4,263,560,46.96%,12.32%,1
花蓮縣,萬榮鄉,0236,107,339,446,28,474,773,61.32%,13.84%,1
花蓮縣,萬榮鄉,0237,70,192,262,15,277,661,41.91%,10.59%,1
花蓮縣,萬榮鄉,0238,41,186,227,12,239,442,54.07%,9.28%,1
花蓮縣,萬榮鄉,0239,53,247,300,49,349,675,51.7%,7.85%,1
花蓮縣,萬榮鄉,0240,172,481,653,87,740,1086,68.14%,15.84%,1
花蓮縣,卓溪鄉,0290,58,220,278,25,303,533,56.85%,10.88%,1
花蓮縣,卓溪鄉,0291,75,203,278,54,332,522,63.6%,14.37%,1
花蓮縣,卓溪鄉,0292,77,183,260,20,280,493,56.8%,15.62%,1
花蓮縣,卓溪鄉,0293,57,344,401,40,441,701,62.91%,8.13%,1
花蓮縣,卓溪鄉,0294,85,313,398,45,443,746,59.38%,11.39%,1
花蓮縣,卓溪鄉,0295,73,261,334,56,390,616,63.31%,11.85%,1
花蓮縣,卓溪鄉,0296,35,104,139,12,151,405,37.28%,8.64%,1
花蓮縣,卓溪鄉,0297,39,129,168,11,179,329,54.41%,11.85%,1
花蓮縣,卓溪鄉,0298,37,175,212,20,232,428,54.21%,8.64%,1
花蓮縣,卓溪鄉,0299,15,75,90,8,98,174,56.32%,8.62%,1
臺東縣,臺東市,0001,101,316,417,19,436,874,49.89%,11.56%,1
臺東縣,臺東市,0002,242,609,851,56,907,1469,61.74%,16.47%,1
臺東縣,臺東市,0003,175,499,674,23,697,1259,55.36%,13.9%,1
臺東縣,臺東市,0004,228,532,760,30,790,1399,56.47%,16.3%,1
臺東縣,臺東市,0005,235,579,814,28,842,1363,61.78%,17.24%,1
臺東縣,臺東市,0006,200,674,874,29,903,1651,54.69%,12.11%,1
臺東縣,臺東市,0007,220,658,878,41,919,1490,61.68%,14.77%,1
臺東縣,臺東市,0008,120,309,429,29,458,859,53.32%,13.97%,1
臺東縣,臺東市,0009,169,346,515,29,544,890,61.12%,18.99%,1
臺東縣,臺東市,0010,86,258,344,32,376,651,57.76%,13.21%,1
臺東縣,臺東市,0011,204,591,795,64,859,1650,52.06%,12.36%,1
臺東縣,臺東市,0012,122,308,430,23,453,724,62.57%,16.85%,1
臺東縣,臺東市,0013,108,244,352,31,383,632,60.6%,17.09%,1
臺東縣,臺東市,0014,121,306,427,36,463,771,60.05%,15.69%,1
臺東縣,臺東市,0015,127,271,398,14,412,798,51.63%,15.91%,1
臺東縣,臺東市,0016,178,465,643,76,719,1299,55.35%,13.7%,1
臺東縣,臺東市,0017,131,329,460,28,488,811,60.17%,16.15%,1
臺東縣,臺東市,0018,131,335,466,25,491,764,64.27%,17.15%,1
臺東縣,臺東市,0019,131,266,397,13,410,784,52.3%,16.71%,1
臺東縣,臺東市,0020,59,149,208,10,218,427,51.05%,13.82%,1
臺東縣,臺東市,0021,114,528,642,31,673,1292,52.09%,8.82%,1
臺東縣,臺東市,0022,233,624,857,12,869,1501,57.89%,15.52%,1
臺東縣,臺東市,0023,88,204,292,13,305,601,50.75%,14.64%,1
臺東縣,臺東市,0024,69,137,206,8,214,417,51.32%,16.55%,1
臺東縣,臺東市,0025,136,390,526,41,567,1001,56.64%,13.59%,1
臺東縣,臺東市,0026,241,679,920,33,953,1638,58.18%,14.71%,1
臺東縣,臺東市,0027,202,633,835,38,873,1576,55.39%,12.82%,1
臺東縣,臺東市,0028,228,617,845,52,897,1595,56.24%,14.29%,1
臺東縣,臺東市,0029,246,691,937,34,971,1734,56%,14.19%,1
臺東縣,臺東市,0030,223,584,807,45,852,1476,57.72%,15.11%,1
臺東縣,臺東市,0031,269,625,894,30,924,1545,59.81%,17.41%,1
臺東縣,臺東市,0032,189,569,758,40,798,1313,60.78%,14.39%,1
臺東縣,臺東市,0033,188,594,782,35,817,1338,61.06%,14.05%,1
臺東縣,臺東市,0034,184,516,700,28,728,1312,55.49%,14.02%,1
臺東縣,臺東市,0035,194,514,708,33,741,1265,58.58%,15.34%,1
臺東縣,臺東市,0036,185,444,629,51,680,1407,48.33%,13.15%,1
臺東縣,臺東市,0037,175,542,717,41,758,1552,48.84%,11.28%,1
臺東縣,臺東市,0038,179,575,754,60,814,1445,56.33%,12.39%,1
臺東縣,臺東市,0039,327,832,1159,56,1215,2098,57.91%,15.59%,1
臺東縣,臺東市,0040,182,552,734,59,793,1324,59.89%,13.75%,1
臺東縣,臺東市,0041,202,639,841,29,870,1598,54.44%,12.64%,1
臺東縣,臺東市,0042,206,576,782,23,805,1513,53.21%,13.62%,1
臺東縣,臺東市,0043,246,574,820,63,883,1679,52.59%,14.65%,1
臺東縣,臺東市,0044,209,502,711,41,752,1414,53.18%,14.78%,1
臺東縣,臺東市,0045,243,657,900,50,950,1798,52.84%,13.52%,1
臺東縣,臺東市,0046,217,563,780,48,828,1749,47.34%,12.41%,1
臺東縣,臺東市,0047,226,649,875,63,938,1709,54.89%,13.22%,1
臺東縣,臺東市,0048,198,620,818,44,862,1629,52.92%,12.15%,1
臺東縣,臺東市,0049,149,393,542,54,596,1116,53.41%,13.35%,1
臺東縣,臺東市,0050,156,388,544,30,574,1259,45.59%,12.39%,1
臺東縣,臺東市,0051,146,383,529,40,569,1232,46.19%,11.85%,1
臺東縣,臺東市,0052,154,525,679,98,777,1505,51.63%,10.23%,1
臺東縣,臺東市,0053,89,263,352,52,404,836,48.33%,10.65%,1
臺東縣,臺東市,0054,165,532,697,39,736,1294,56.88%,12.75%,1
臺東縣,臺東市,0055,174,498,672,51,723,1350,53.56%,12.89%,1
臺東縣,臺東市,0056,258,877,1135,60,1195,2162,55.27%,11.93%,1
臺東縣,臺東市,0057,269,648,917,47,964,1627,59.25%,16.53%,1
臺東縣,臺東市,0058,161,491,652,30,682,1140,59.82%,14.12%,1
臺東縣,臺東市,0059,186,514,700,32,732,1359,53.86%,13.69%,1
臺東縣,臺東市,0060,194,499,693,46,739,1329,55.61%,14.6%,1
臺東縣,臺東市,0061,115,372,487,28,515,990,52.02%,11.62%,1
臺東縣,臺東市,0062,127,416,543,46,589,1038,56.74%,12.24%,1
臺東縣,臺東市,0063,198,581,779,63,842,1597,52.72%,12.4%,1
臺東縣,臺東市,0064,216,470,686,59,745,1385,53.79%,15.6%,1
臺東縣,臺東市,0065,133,291,424,13,437,939,46.54%,14.16%,1
臺東縣,臺東市,0066,141,382,523,48,571,1258,45.39%,11.21%,1
臺東縣,臺東市,0067,194,461,655,6,661,1350,48.96%,14.37%,1
臺東縣,臺東市,0068,124,340,464,33,497,1058,46.98%,11.72%,1
臺東縣,臺東市,0069,81,292,373,28,401,895,44.8%,9.05%,1
臺東縣,成功鎮,0070,45,167,212,46,258,516,50%,8.72%,1
臺東縣,成功鎮,0071,112,410,522,57,579,960,60.31%,11.67%,1
臺東縣,成功鎮,0072,18,104,122,16,138,365,37.81%,4.93%,1
臺東縣,成功鎮,0073,60,236,296,49,345,747,46.18%,8.03%,1
臺東縣,成功鎮,0074,19,121,140,20,160,339,47.2%,5.6%,1
臺東縣,成功鎮,0075,112,336,448,23,471,995,47.34%,11.26%,1
臺東縣,成功鎮,0076,106,329,435,47,482,863,55.85%,12.28%,1
臺東縣,成功鎮,0077,116,364,480,28,508,931,54.56%,12.46%,1
臺東縣,成功鎮,0078,105,365,470,24,494,970,50.93%,10.82%,1
臺東縣,成功鎮,0079,121,505,626,68,694,1365,50.84%,8.86%,1
臺東縣,成功鎮,0080,124,517,641,74,715,1366,52.34%,9.08%,1
臺東縣,成功鎮,0081,39,175,214,46,260,516,50.39%,7.56%,1
臺東縣,成功鎮,0082,82,255,337,60,397,887,44.76%,9.24%,1
臺東縣,成功鎮,0083,39,142,181,38,219,488,44.88%,7.99%,1
臺東縣,成功鎮,0084,47,120,167,28,195,481,40.54%,9.77%,1
臺東縣,成功鎮,0085,15,72,87,1,88,373,23.59%,4.02%,1
臺東縣,成功鎮,0086,29,91,120,24,144,264,54.55%,10.98%,1
臺東縣,關山鎮,0087,143,370,513,27,540,909,59.41%,15.73%,1
臺東縣,關山鎮,0088,91,229,320,21,341,790,43.16%,11.52%,1
臺東縣,關山鎮,0089,129,339,468,33,501,828,60.51%,15.58%,1
臺東縣,關山鎮,0090,90,282,372,23,395,887,44.53%,10.15%,1
臺東縣,關山鎮,0091,152,442,594,30,624,1137,54.88%,13.37%,1
臺東縣,關山鎮,0092,78,246,324,30,354,732,48.36%,10.66%,1
臺東縣,關山鎮,0093,102,339,441,32,473,912,51.86%,11.18%,1
臺東縣,關山鎮,0094,77,219,296,17,313,779,40.18%,9.88%,1
臺東縣,關山鎮,0095,62,130,192,14,206,535,38.5%,11.59%,1
臺東縣,卑南鄉,0096,145,404,549,50,599,1041,57.54%,13.93%,1
臺東縣,卑南鄉,0097,142,404,546,30,576,1165,49.44%,12.19%,1
臺東縣,卑南鄉,0098,23,55,78,19,97,219,44.29%,10.5%,1
臺東縣,卑南鄉,0099,61,136,197,25,222,460,48.26%,13.26%,1
臺東縣,卑南鄉,0100,36,107,143,12,155,387,40.05%,9.3%,1
臺東縣,卑南鄉,0101,82,239,321,28,349,767,45.5%,10.69%,1
臺東縣,卑南鄉,0102,68,170,238,34,272,503,54.08%,13.52%,1
臺東縣,卑南鄉,0103,94,211,305,47,352,727,48.42%,12.93%,1
臺東縣,卑南鄉,0104,41,154,195,32,227,436,52.06%,9.4%,1
臺東縣,卑南鄉,0105,26,58,84,12,96,261,36.78%,9.96%,1
臺東縣,卑南鄉,0106,28,79,107,11,118,215,54.88%,13.02%,1
臺東縣,卑南鄉,0107,203,549,752,52,804,1442,55.76%,14.08%,1
臺東縣,卑南鄉,0108,66,183,249,14,263,527,49.91%,12.52%,1
臺東縣,卑南鄉,0109,143,396,539,43,582,1046,55.64%,13.67%,1
臺東縣,卑南鄉,0110,179,374,553,52,605,1110,54.5%,16.13%,1
臺東縣,卑南鄉,0111,175,418,593,39,632,1105,57.19%,15.84%,1
臺東縣,卑南鄉,0112,163,461,624,103,727,1167,62.3%,13.97%,1
臺東縣,卑南鄉,0113,117,307,424,47,471,968,48.66%,12.09%,1
臺東縣,卑南鄉,0114,20,41,61,4,65,159,40.88%,12.58%,1
臺東縣,卑南鄉,0115,43,156,199,19,218,488,44.67%,8.81%,1
臺東縣,卑南鄉,0116,47,139,186,16,202,347,58.21%,13.54%,1
臺東縣,卑南鄉,0117,54,163,217,19,236,436,54.13%,12.39%,1
臺東縣,鹿野鄉,0118,57,134,191,5,196,522,37.55%,10.92%,1
臺東縣,鹿野鄉,0119,84,205,289,19,308,574,53.66%,14.63%,1
臺東縣,鹿野鄉,0120,124,265,389,24,413,1055,39.15%,11.75%,1
臺東縣,鹿野鄉,0121,151,337,488,30,518,1104,46.92%,13.68%,1
臺東縣,鹿野鄉,0122,33,112,145,10,155,342,45.32%,9.65%,1
臺東縣,鹿野鄉,0123,102,305,407,18,425,895,47.49%,11.4%,1
臺東縣,鹿野鄉,0124,123,261,384,38,422,864,48.84%,14.24%,1
臺東縣,鹿野鄉,0125,74,176,250,38,288,675,42.67%,10.96%,1
臺東縣,鹿野鄉,0126,52,146,198,17,215,435,49.43%,11.95%,1
臺東縣,鹿野鄉,0127,64,103,167,21,188,470,40%,13.62%,1
臺東縣,池上鄉,0128,120,332,452,28,480,992,48.39%,12.1%,1
臺東縣,池上鄉,0129,139,334,473,39,512,929,55.11%,14.96%,1
臺東縣,池上鄉,0130,51,136,187,24,211,434,48.62%,11.75%,1
臺東縣,池上鄉,0131,86,190,276,30,306,703,43.53%,12.23%,1
臺東縣,池上鄉,0132,64,203,267,21,288,654,44.04%,9.79%,1
臺東縣,池上鄉,0133,25,87,112,17,129,324,39.81%,7.72%,1
臺東縣,池上鄉,0134,89,245,334,26,360,794,45.34%,11.21%,1
臺東縣,池上鄉,0135,94,268,362,50,412,856,48.13%,10.98%,1
臺東縣,池上鄉,0136,35,89,124,17,141,344,40.99%,10.17%,1
臺東縣,池上鄉,0137,42,119,161,17,178,311,57.23%,13.5%,1
臺東縣,池上鄉,0138,35,89,124,13,137,386,35.49%,9.07%,1
臺東縣,池上鄉,0139,38,95,133,19,152,435,34.94%,8.74%,1
臺東縣,東河鄉,0140,38,69,107,17,124,290,42.76%,13.1%,1
臺東縣,東河鄉,0141,102,206,308,42,350,620,56.45%,16.45%,1
臺東縣,東河鄉,0142,199,458,657,82,739,1196,61.79%,16.64%,1
臺東縣,東河鄉,0143,87,268,355,80,435,918,47.39%,9.48%,1
臺東縣,東河鄉,0144,48,173,221,39,260,555,46.85%,8.65%,1
臺東縣,東河鄉,0145,103,294,397,29,426,977,43.6%,10.54%,1
臺東縣,東河鄉,0146,81,278,359,10,369,1197,30.83%,6.77%,1
臺東縣,東河鄉,0147,29,162,191,20,211,867,24.34%,3.34%,1
臺東縣,東河鄉,0148,38,97,135,13,148,345,42.9%,11.01%,1
臺東縣,東河鄉,0149,36,120,156,17,173,408,42.4%,8.82%,1
臺東縣,東河鄉,0150,27,78,105,9,114,262,43.51%,10.31%,1
臺東縣,長濱鄉,0151,82,171,253,56,309,536,57.65%,15.3%,1
臺東縣,長濱鄉,0152,45,161,206,25,231,689,33.53%,6.53%,1
臺東縣,長濱鄉,0153,108,299,407,85,492,913,53.89%,11.83%,1
臺東縣,長濱鄉,0154,102,330,432,28,460,1268,36.28%,8.04%,1
臺東縣,長濱鄉,0155,59,231,290,51,341,725,47.03%,8.14%,1
臺東縣,長濱鄉,0156,37,104,141,8,149,532,28.01%,6.95%,1
臺東縣,長濱鄉,0157,51,167,218,61,279,660,42.27%,7.73%,1
臺東縣,長濱鄉,0158,15,93,108,4,112,336,33.33%,4.46%,1
臺東縣,長濱鄉,0159,13,39,52,12,64,195,32.82%,6.67%,1
臺東縣,長濱鄉,0160,4,8,12,1,13,25,52%,16%,1
臺東縣,長濱鄉,0161,46,190,236,32,268,605,44.3%,7.6%,1
臺東縣,太麻里鄉,0162,95,254,349,35,384,722,53.19%,13.16%,1
臺東縣,太麻里鄉,0163,51,220,271,24,295,575,51.3%,8.87%,1
臺東縣,太麻里鄉,0164,80,208,288,26,314,623,50.4%,12.84%,1
臺東縣,太麻里鄉,0165,55,213,268,35,303,622,48.71%,8.84%,1
臺東縣,太麻里鄉,0166,56,157,213,12,225,560,40.18%,10%,1
臺東縣,太麻里鄉,0167,109,360,469,71,540,957,56.43%,11.39%,1
臺東縣,太麻里鄉,0168,96,251,347,39,386,809,47.71%,11.87%,1
臺東縣,太麻里鄉,0169,122,261,383,32,415,673,61.66%,18.13%,1
臺東縣,太麻里鄉,0170,81,262,343,36,379,737,51.42%,10.99%,1
臺東縣,太麻里鄉,0171,53,161,214,27,241,424,56.84%,12.5%,1
臺東縣,太麻里鄉,0172,46,112,158,21,179,374,47.86%,12.3%,1
臺東縣,太麻里鄉,0173,88,231,319,14,333,829,40.17%,10.62%,1
臺東縣,太麻里鄉,0174,79,268,347,6,353,869,40.62%,9.09%,1
臺東縣,太麻里鄉,0175,13,60,73,3,76,223,34.08%,5.83%,1
臺東縣,太麻里鄉,0176,75,250,325,39,364,669,54.41%,11.21%,1
臺東縣,大武鄉,0177,52,253,305,38,343,568,60.39%,9.15%,1
臺東縣,大武鄉,0178,185,442,627,104,731,1474,49.59%,12.55%,1
臺東縣,大武鄉,0179,171,450,621,87,708,1327,53.35%,12.89%,1
臺東縣,大武鄉,0180,138,326,464,71,535,1134,47.18%,12.17%,1
臺東縣,大武鄉,0181,35,121,156,57,213,386,55.18%,9.07%,1
臺東縣,大武鄉,0182,40,121,161,19,180,377,47.75%,10.61%,1
臺東縣,綠島鄉,0183,169,433,602,21,623,1474,42.27%,11.47%,1
臺東縣,綠島鄉,0184,149,305,454,19,473,1082,43.72%,13.77%,1
臺東縣,綠島鄉,0185,126,238,364,17,381,813,46.86%,15.5%,1
臺東縣,綠島鄉,0186,37,64,101,1,102,210,48.57%,17.62%,1
臺東縣,海端鄉,0187,48,195,243,20,263,497,52.92%,9.66%,1
臺東縣,海端鄉,0188,51,265,316,14,330,569,58%,8.96%,1
臺東縣,海端鄉,0189,126,322,448,35,483,971,49.74%,12.98%,1
臺東縣,海端鄉,0190,65,300,365,28,393,728,53.98%,8.93%,1
臺東縣,海端鄉,0191,33,98,131,16,147,259,56.76%,12.74%,1
臺東縣,海端鄉,0192,28,101,129,11,140,254,55.12%,11.02%,1
臺東縣,延平鄉,0193,132,386,518,29,547,1014,53.94%,13.02%,1
臺東縣,延平鄉,0194,58,202,260,38,298,426,69.95%,13.62%,1
臺東縣,延平鄉,0195,36,156,192,17,209,315,66.35%,11.43%,1
臺東縣,延平鄉,0196,65,195,260,15,275,579,47.5%,11.23%,1
臺東縣,延平鄉,0197,61,196,257,18,275,596,46.14%,10.23%,1
臺東縣,金峰鄉,0198,154,406,560,43,603,1241,48.59%,12.41%,1
臺東縣,金峰鄉,0199,95,278,373,26,399,601,66.39%,15.81%,1
臺東縣,金峰鄉,0200,125,241,366,27,393,520,75.58%,24.04%,1
臺東縣,金峰鄉,0201,34,138,172,21,193,336,57.44%,10.12%,1
臺東縣,金峰鄉,0202,45,154,199,28,227,330,68.79%,13.64%,1
臺東縣,達仁鄉,0203,33,114,147,7,154,246,62.6%,13.41%,1
臺東縣,達仁鄉,0204,24,174,198,20,218,340,64.12%,7.06%,1
臺東縣,達仁鄉,0205,40,139,179,16,195,296,65.88%,13.51%,1
臺東縣,達仁鄉,0206,54,213,267,14,281,429,65.5%,12.59%,1
臺東縣,達仁鄉,0207,37,157,194,24,218,331,65.86%,11.18%,1
臺東縣,達仁鄉,0208,69,197,266,21,287,628,45.7%,10.99%,1
臺東縣,達仁鄉,0209,116,318,434,42,476,867,54.9%,13.38%,1
臺東縣,蘭嶼鄉,0210,84,284,368,18,386,943,40.93%,8.91%,1
臺東縣,蘭嶼鄉,0211,141,357,498,30,528,1238,42.65%,11.39%,1
臺東縣,蘭嶼鄉,0212,105,286,391,16,407,1240,32.82%,8.47%,1
臺東縣,蘭嶼鄉,0213,87,166,253,26,279,760,36.71%,11.45%,1
澎湖縣,馬公市,0001,68,149,217,10,227,481,47.19%,14.14%,1
澎湖縣,馬公市,0002,69,204,273,18,291,558,52.15%,12.37%,1
澎湖縣,馬公市,0003,52,173,225,38,263,533,49.34%,9.76%,1
澎湖縣,馬公市,0004,135,300,435,30,465,922,50.43%,14.64%,1
澎湖縣,馬公市,0005,171,341,512,35,547,1021,53.57%,16.75%,1
澎湖縣,馬公市,0006,125,252,377,29,406,793,51.2%,15.76%,1
澎湖縣,馬公市,0007,125,344,469,41,510,954,53.46%,13.1%,1
澎湖縣,馬公市,0008,145,338,483,21,504,1001,50.35%,14.49%,1
澎湖縣,馬公市,0009,152,354,506,28,534,1192,44.8%,12.75%,1
澎湖縣,馬公市,0010,154,459,613,49,662,1402,47.22%,10.98%,1
澎湖縣,馬公市,0011,198,494,692,25,717,1389,51.62%,14.25%,1
澎湖縣,馬公市,0012,173,485,658,38,696,1339,51.98%,12.92%,1
澎湖縣,馬公市,0013,152,412,564,38,602,1254,48.01%,12.12%,1
澎湖縣,馬公市,0014,149,410,559,42,601,1194,50.34%,12.48%,1
澎湖縣,馬公市,0015,173,457,630,43,673,1393,48.31%,12.42%,1
澎湖縣,馬公市,0016,207,520,727,27,754,1440,52.36%,14.38%,1
澎湖縣,馬公市,0017,170,382,552,44,596,1215,49.05%,13.99%,1
澎湖縣,馬公市,0018,145,441,586,46,632,1284,49.22%,11.29%,1
澎湖縣,馬公市,0019,196,500,696,53,749,1512,49.54%,12.96%,1
澎湖縣,馬公市,0020,148,373,521,47,568,1181,48.09%,12.53%,1
澎湖縣,馬公市,0021,162,470,632,44,676,1348,50.15%,12.02%,1
澎湖縣,馬公市,0022,238,459,697,20,717,1391,51.55%,17.11%,1
澎湖縣,馬公市,0023,650,274,924,14,938,2124,44.16%,30.6%,1
澎湖縣,馬公市,0024,174,532,706,42,748,1500,49.87%,11.6%,1
澎湖縣,馬公市,0025,180,568,748,32,780,1582,49.3%,11.38%,1
澎湖縣,馬公市,0026,197,578,775,22,797,1638,48.66%,12.03%,1
澎湖縣,馬公市,0027,212,563,775,36,811,1554,52.19%,13.64%,1
澎湖縣,馬公市,0028,100,260,360,23,383,980,39.08%,10.2%,1
澎湖縣,馬公市,0029,118,310,428,24,452,892,50.67%,13.23%,1
澎湖縣,馬公市,0030,101,208,309,13,322,778,41.39%,12.98%,1
澎湖縣,馬公市,0031,119,332,451,22,473,930,50.86%,12.8%,1
澎湖縣,馬公市,0032,226,605,831,31,862,1481,58.2%,15.26%,1
澎湖縣,馬公市,0033,158,429,587,14,601,1128,53.28%,14.01%,1
澎湖縣,馬公市,0034,43,161,204,20,224,415,53.98%,10.36%,1
澎湖縣,馬公市,0035,148,379,527,32,559,1120,49.91%,13.21%,1
澎湖縣,馬公市,0036,116,382,498,17,515,950,54.21%,12.21%,1
澎湖縣,馬公市,0037,69,193,262,20,282,627,44.98%,11%,1
澎湖縣,馬公市,0038,128,389,517,20,537,1055,50.9%,12.13%,1
澎湖縣,馬公市,0039,121,363,484,33,517,989,52.28%,12.23%,1
澎湖縣,馬公市,0040,87,208,295,35,330,591,55.84%,14.72%,1
澎湖縣,馬公市,0041,171,427,598,59,657,1387,47.37%,12.33%,1
澎湖縣,馬公市,0042,125,295,420,47,467,1079,43.28%,11.58%,1
澎湖縣,馬公市,0043,82,279,361,37,398,797,49.94%,10.29%,1
澎湖縣,馬公市,0044,112,279,391,23,414,903,45.85%,12.4%,1
澎湖縣,馬公市,0045,67,91,158,19,177,376,47.07%,17.82%,1
澎湖縣,馬公市,0046,52,131,183,12,195,371,52.56%,14.02%,1
澎湖縣,馬公市,0047,98,338,436,19,455,1173,38.79%,8.35%,1
澎湖縣,馬公市,0048,132,327,459,21,480,1389,34.56%,9.5%,1
澎湖縣,馬公市,0049,56,103,159,54,213,761,27.99%,7.36%,1
澎湖縣,馬公市,0050,50,111,161,15,176,288,61.11%,17.36%,1
澎湖縣,湖西鄉,0051,135,405,540,48,588,1120,52.5%,12.05%,1
澎湖縣,湖西鄉,0052,40,96,136,6,142,332,42.77%,12.05%,1
澎湖縣,湖西鄉,0053,25,64,89,6,95,242,39.26%,10.33%,1
澎湖縣,湖西鄉,0054,36,63,99,6,105,293,35.84%,12.29%,1
澎湖縣,湖西鄉,0055,56,177,233,41,274,666,41.14%,8.41%,1
澎湖縣,湖西鄉,0056,39,109,148,14,162,326,49.69%,11.96%,1
澎湖縣,湖西鄉,0057,88,197,285,12,297,732,40.57%,12.02%,1
澎湖縣,湖西鄉,0058,62,221,283,18,301,651,46.24%,9.52%,1
澎湖縣,湖西鄉,0059,88,224,312,12,324,744,43.55%,11.83%,1
澎湖縣,湖西鄉,0060,23,49,72,1,73,134,54.48%,17.16%,1
澎湖縣,湖西鄉,0061,83,167,250,24,274,794,34.51%,10.45%,1
澎湖縣,湖西鄉,0062,21,54,75,3,78,216,36.11%,9.72%,1
澎湖縣,湖西鄉,0063,54,140,194,4,198,664,29.82%,8.13%,1
澎湖縣,湖西鄉,0064,32,93,125,7,132,279,47.31%,11.47%,1
澎湖縣,湖西鄉,0065,27,118,145,5,150,296,50.68%,9.12%,1
澎湖縣,湖西鄉,0066,42,76,118,4,122,257,47.47%,16.34%,1
澎湖縣,湖西鄉,0067,2,26,28,1,29,89,32.58%,2.25%,1
澎湖縣,湖西鄉,0068,119,240,359,31,390,815,47.85%,14.6%,1
澎湖縣,湖西鄉,0069,94,276,370,19,389,975,39.9%,9.64%,1
澎湖縣,湖西鄉,0070,84,204,288,28,316,648,48.77%,12.96%,1
澎湖縣,湖西鄉,0071,103,246,349,25,374,893,41.88%,11.53%,1
澎湖縣,湖西鄉,0072,113,276,389,49,438,846,51.77%,13.36%,1
澎湖縣,湖西鄉,0073,79,180,259,14,273,729,37.45%,10.84%,1
澎湖縣,白沙鄉,0074,64,176,240,16,256,514,49.81%,12.45%,1
澎湖縣,白沙鄉,0075,83,242,325,14,339,657,51.6%,12.63%,1
澎湖縣,白沙鄉,0076,13,55,68,4,72,109,66.06%,11.93%,1
澎湖縣,白沙鄉,0077,16,47,63,3,66,156,42.31%,10.26%,1
澎湖縣,白沙鄉,0078,31,85,116,5,121,293,41.3%,10.58%,1
澎湖縣,白沙鄉,0079,19,53,72,1,73,231,31.6%,8.23%,1
澎湖縣,白沙鄉,0080,27,53,80,7,87,161,54.04%,16.77%,1
澎湖縣,白沙鄉,0081,183,566,749,42,791,1705,46.39%,10.73%,1
澎湖縣,白沙鄉,0082,31,88,119,6,125,285,43.86%,10.88%,1
澎湖縣,白沙鄉,0083,56,152,208,13,221,723,30.57%,7.75%,1
澎湖縣,白沙鄉,0084,79,178,257,29,286,774,36.95%,10.21%,1
澎湖縣,白沙鄉,0085,140,284,424,77,501,1429,35.06%,9.8%,1
澎湖縣,白沙鄉,0086,76,374,450,50,500,1084,46.13%,7.01%,1
澎湖縣,白沙鄉,0087,36,83,119,7,126,251,50.2%,14.34%,1
澎湖縣,白沙鄉,0088,32,47,79,13,92,253,36.36%,12.65%,1
澎湖縣,西嶼鄉,0089,14,33,47,0,47,283,16.61%,4.95%,1
澎湖縣,西嶼鄉,0090,42,70,112,12,124,424,29.25%,9.91%,1
澎湖縣,西嶼鄉,0091,82,160,242,42,284,826,34.38%,9.93%,1
澎湖縣,西嶼鄉,0092,24,77,101,10,111,282,39.36%,8.51%,1
澎湖縣,西嶼鄉,0093,75,148,223,38,261,661,39.49%,11.35%,1
澎湖縣,西嶼鄉,0094,8,20,28,2,30,141,21.28%,5.67%,1
澎湖縣,西嶼鄉,0095,46,139,185,12,197,635,31.02%,7.24%,1
澎湖縣,西嶼鄉,0096,18,51,69,5,74,216,34.26%,8.33%,1
澎湖縣,西嶼鄉,0097,41,78,119,23,142,572,24.83%,7.17%,1
澎湖縣,西嶼鄉,0098,118,348,466,53,519,1267,40.96%,9.31%,1
澎湖縣,西嶼鄉,0099,71,218,289,26,315,942,33.44%,7.54%,1
澎湖縣,西嶼鄉,0100,127,276,403,47,450,1133,39.72%,11.21%,1
澎湖縣,望安鄉,0101,95,202,297,35,332,734,45.23%,12.94%,1
澎湖縣,望安鄉,0102,30,146,176,14,190,454,41.85%,6.61%,1
澎湖縣,望安鄉,0103,24,71,95,9,104,300,34.67%,8%,1
澎湖縣,望安鄉,0104,54,155,209,30,239,471,50.74%,11.46%,1
澎湖縣,望安鄉,0105,69,137,206,14,220,672,32.74%,10.27%,1
澎湖縣,望安鄉,0106,84,186,270,32,302,742,40.7%,11.32%,1
澎湖縣,望安鄉,0107,33,62,95,14,109,264,41.29%,12.5%,1
澎湖縣,望安鄉,0108,64,135,199,2,201,476,42.23%,13.45%,1
澎湖縣,望安鄉,0109,21,32,53,3,56,208,26.92%,10.1%,1
澎湖縣,望安鄉,0110,21,67,88,3,91,307,29.64%,6.84%,1
澎湖縣,七美鄉,0111,26,38,64,3,67,248,27.02%,10.48%,1
澎湖縣,七美鄉,0112,59,124,183,21,204,581,35.11%,10.15%,1
澎湖縣,七美鄉,0113,77,125,202,25,227,641,35.41%,12.01%,1
澎湖縣,七美鄉,0114,32,82,114,4,118,382,30.89%,8.38%,1
澎湖縣,七美鄉,0115,23,56,79,6,85,351,24.22%,6.55%,1
澎湖縣,七美鄉,0116,100,200,300,20,320,1171,27.33%,8.54%,1
金門縣,金城鎮,0001,110,373,483,25,508,1396,36.39%,7.88%,1
金門縣,金城鎮,0002,158,519,677,20,697,1831,38.07%,8.63%,1
金門縣,金城鎮,0003,134,468,602,40,642,1750,36.69%,7.66%,1
金門縣,金城鎮,0004,157,508,665,52,717,1889,37.96%,8.31%,1
金門縣,金城鎮,0005,146,364,510,26,536,1675,32%,8.72%,1
金門縣,金城鎮,0006,160,591,751,29,780,1901,41.03%,8.42%,1
金門縣,金城鎮,0007,135,384,519,38,557,1610,34.6%,8.39%,1
金門縣,金城鎮,0008,129,451,580,22,602,1687,35.68%,7.65%,1
金門縣,金城鎮,0009,115,443,558,23,581,1594,36.45%,7.21%,1
金門縣,金城鎮,0010,126,465,591,23,614,1726,35.57%,7.3%,1
金門縣,金城鎮,0011,466,145,611,20,631,1733,36.41%,26.89%,1
金門縣,金城鎮,0012,127,477,604,20,624,1532,40.73%,8.29%,1
金門縣,金城鎮,0013,171,504,675,46,721,2079,34.68%,8.23%,1
金門縣,金城鎮,0014,162,461,623,30,653,2033,32.12%,7.97%,1
金門縣,金城鎮,0015,206,638,844,38,882,2517,35.04%,8.18%,1
金門縣,金城鎮,0016,144,541,685,44,729,2083,35%,6.91%,1
金門縣,金城鎮,0017,141,557,698,33,731,2140,34.16%,6.59%,1
金門縣,金城鎮,0018,157,521,678,42,720,2435,29.57%,6.45%,1
金門縣,金城鎮,0019,72,255,327,18,345,1353,25.5%,5.32%,1
金門縣,金城鎮,0020,94,381,475,16,491,1574,31.19%,5.97%,1
金門縣,金城鎮,0021,106,324,430,48,478,1277,37.43%,8.3%,1
金門縣,金沙鎮,0066,125,498,623,37,660,1909,34.57%,6.55%,1
金門縣,金沙鎮,0067,111,470,581,44,625,1524,41.01%,7.28%,1
金門縣,金沙鎮,0068,90,430,520,27,547,1673,32.7%,5.38%,1
金門縣,金沙鎮,0069,93,525,618,42,660,2003,32.95%,4.64%,1
金門縣,金沙鎮,0070,98,381,479,15,494,1212,40.76%,8.09%,1
金門縣,金沙鎮,0071,74,312,386,23,409,1126,36.32%,6.57%,1
金門縣,金沙鎮,0072,103,353,456,23,479,1540,31.1%,6.69%,1
金門縣,金沙鎮,0073,74,287,361,17,378,1216,31.09%,6.09%,1
金門縣,金沙鎮,0074,39,206,245,14,259,950,27.26%,4.11%,1
金門縣,金沙鎮,0075,108,564,672,29,701,1895,36.99%,5.7%,1
金門縣,金沙鎮,0076,109,327,436,27,463,1135,40.79%,9.6%,1
金門縣,金沙鎮,0077,90,327,417,21,438,1252,34.98%,7.19%,1
金門縣,金沙鎮,0078,77,369,446,17,463,1125,41.16%,6.84%,1
金門縣,金湖鎮,0049,150,360,510,30,540,1348,40.06%,11.13%,1
金門縣,金湖鎮,0050,118,343,461,27,488,1386,35.21%,8.51%,1
金門縣,金湖鎮,0051,123,455,578,27,605,1403,43.12%,8.77%,1
金門縣,金湖鎮,0052,157,490,647,27,674,1771,38.06%,8.87%,1
金門縣,金湖鎮,0053,142,379,521,35,556,1493,37.24%,9.51%,1
金門縣,金湖鎮,0054,103,394,497,39,536,1510,35.5%,6.82%,1
金門縣,金湖鎮,0055,107,465,572,37,609,1607,37.9%,6.66%,1
金門縣,金湖鎮,0056,131,507,638,36,674,2006,33.6%,6.53%,1
金門縣,金湖鎮,0057,189,436,625,18,643,1780,36.12%,10.62%,1
金門縣,金湖鎮,0058,153,466,619,16,635,1739,36.52%,8.8%,1
金門縣,金湖鎮,0059,106,353,459,20,479,1384,34.61%,7.66%,1
金門縣,金湖鎮,0060,127,380,507,21,528,1400,37.71%,9.07%,1
金門縣,金湖鎮,0061,132,437,569,18,587,1325,44.3%,9.96%,1
金門縣,金湖鎮,0062,95,300,395,19,414,1236,33.5%,7.69%,1
金門縣,金湖鎮,0063,108,342,450,30,480,1382,34.73%,7.81%,1
金門縣,金湖鎮,0064,96,450,546,14,560,1631,34.33%,5.89%,1
金門縣,金湖鎮,0065,84,371,455,38,493,1514,32.56%,5.55%,1
金門縣,金寧鄉,0022,87,394,481,60,541,1735,31.18%,5.01%,1
金門縣,金寧鄉,0023,100,356,456,30,486,1537,31.62%,6.51%,1
金門縣,金寧鄉,0024,179,380,559,33,592,1766,33.52%,10.14%,1
金門縣,金寧鄉,0025,88,270,358,17,375,1015,36.95%,8.67%,1
金門縣,金寧鄉,0026,119,467,586,29,615,1726,35.63%,6.89%,1
金門縣,金寧鄉,0027,107,407,514,24,538,1691,31.82%,6.33%,1
金門縣,金寧鄉,0028,531,316,847,19,866,2044,42.37%,25.98%,1
金門縣,金寧鄉,0029,174,568,742,22,764,1848,41.34%,9.42%,1
金門縣,金寧鄉,0030,143,456,599,15,614,1735,35.39%,8.24%,1
金門縣,金寧鄉,0031,152,447,599,28,627,1795,34.93%,8.47%,1
金門縣,金寧鄉,0032,97,445,542,38,580,1834,31.62%,5.29%,1
金門縣,金寧鄉,0033,125,361,486,28,514,1528,33.64%,8.18%,1
金門縣,金寧鄉,0034,108,441,549,19,568,1473,38.56%,7.33%,1
金門縣,金寧鄉,0035,127,446,573,29,602,1679,35.85%,7.56%,1
金門縣,金寧鄉,0036,663,256,919,14,933,1921,48.57%,34.51%,1
金門縣,金寧鄉,0037,121,334,455,13,468,1298,36.06%,9.32%,1
金門縣,金寧鄉,0038,105,381,486,20,506,1537,32.92%,6.83%,1
金門縣,烈嶼鄉,0039,137,560,697,25,722,1647,43.84%,8.32%,1
金門縣,烈嶼鄉,0040,118,473,591,26,617,1733,35.6%,6.81%,1
金門縣,烈嶼鄉,0041,132,451,583,24,607,1635,37.13%,8.07%,1
金門縣,烈嶼鄉,0042,91,328,419,21,440,1296,33.95%,7.02%,1
金門縣,烈嶼鄉,0043,49,282,331,25,356,1099,32.39%,4.46%,1
金門縣,烈嶼鄉,0044,104,353,457,28,485,1425,34.04%,7.3%,1
金門縣,烈嶼鄉,0045,91,418,509,16,525,1412,37.18%,6.44%,1
金門縣,烈嶼鄉,0046,101,378,479,28,507,1429,35.48%,7.07%,1
金門縣,烏坵鄉,0047,20,56,76,2,78,275,28.36%,7.27%,1
金門縣,烏坵鄉,0048,17,68,85,2,87,292,29.79%,5.82%,1
連江縣,南竿鄉,0001,274,712,986,28,1014,1967,51.55%,13.93%,1
連江縣,南竿鄉,0002,208,637,845,38,883,1837,48.07%,11.32%,1
連江縣,南竿鄉,0003,151,418,569,18,587,1114,52.69%,13.55%,1
連江縣,南竿鄉,0004,157,630,787,17,804,1543,52.11%,10.17%,1
連江縣,北竿鄉,0005,178,606,784,29,813,1515,53.66%,11.75%,1
連江縣,北竿鄉,0006,69,223,292,5,297,610,48.69%,11.31%,1
連江縣,莒光鄉,0007,84,247,331,11,342,698,49%,12.03%,1
連江縣,莒光鄉,0008,101,325,426,16,442,783,56.45%,12.9%,1
連江縣,東引鄉,0009,271,285,556,21,577,1138,50.7%,23.81%,1
基隆市,中正區,0001,72,165,237,19,256,466,54.94%,15.45%,1
基隆市,中正區,0002,155,365,520,24,544,1262,43.11%,12.28%,1
基隆市,中正區,0003,151,360,511,45,556,1171,47.48%,12.89%,1
基隆市,中正區,0004,353,686,1039,18,1057,2823,37.44%,12.5%,1
基隆市,中正區,0005,212,388,600,47,647,1474,43.89%,14.38%,1
基隆市,中正區,0006,173,329,502,56,558,1271,43.9%,13.61%,1
基隆市,中正區,0007,353,753,1106,64,1170,2707,43.22%,13.04%,1
基隆市,中正區,0008,188,489,677,80,757,1545,49%,12.17%,1
基隆市,中正區,0009,96,196,292,13,305,761,40.08%,12.61%,1
基隆市,中正區,0010,220,417,637,18,655,1352,48.45%,16.27%,1
基隆市,中正區,0011,181,459,640,22,662,1413,46.85%,12.81%,1
基隆市,中正區,0012,370,740,1110,40,1150,2665,43.15%,13.88%,1
基隆市,中正區,0013,175,348,523,64,587,1261,46.55%,13.88%,1
基隆市,中正區,0014,182,620,802,74,876,1753,49.97%,10.38%,1
基隆市,中正區,0015,116,277,393,48,441,984,44.82%,11.79%,1
基隆市,中正區,0016,142,380,522,31,553,1166,47.43%,12.18%,1
基隆市,中正區,0017,149,294,443,28,471,973,48.41%,15.31%,1
基隆市,中正區,0018,230,380,610,18,628,1694,37.07%,13.58%,1
基隆市,中正區,0019,194,416,610,27,637,1270,50.16%,15.28%,1
基隆市,中正區,0020,151,389,540,37,577,1090,52.94%,13.85%,1
基隆市,中正區,0021,135,304,439,18,457,870,52.53%,15.52%,1
基隆市,中正區,0022,179,353,532,41,573,1138,50.35%,15.73%,1
基隆市,中正區,0023,120,268,388,35,423,862,49.07%,13.92%,1
基隆市,中正區,0024,229,454,683,56,739,1341,55.11%,17.08%,1
基隆市,中正區,0025,138,276,414,38,452,859,52.62%,16.07%,1
基隆市,中正區,0026,199,448,647,22,669,1457,45.92%,13.66%,1
基隆市,中正區,0027,326,278,604,51,655,1594,41.09%,20.45%,1
基隆市,中正區,0028,128,263,391,38,429,802,53.49%,15.96%,1
基隆市,中正區,0029,165,417,582,42,624,1267,49.25%,13.02%,1
基隆市,中正區,0030,210,354,564,58,622,1175,52.94%,17.87%,1
基隆市,中正區,0031,188,441,629,42,671,1210,55.45%,15.54%,1
基隆市,中正區,0032,176,329,505,42,547,1037,52.75%,16.97%,1
基隆市,中正區,0033,192,404,596,43,639,1219,52.42%,15.75%,1
基隆市,中正區,0034,149,281,430,27,457,904,50.55%,16.48%,1
基隆市,中正區,0035,100,312,412,29,441,709,62.2%,14.1%,1
基隆市,七堵區,0219,198,470,668,48,716,1258,56.92%,15.74%,1
基隆市,七堵區,0220,193,447,640,51,691,1237,55.86%,15.6%,1
基隆市,七堵區,0221,213,413,626,24,650,1259,51.63%,16.92%,1
基隆市,七堵區,0222,165,353,518,48,566,1120,50.54%,14.73%,1
基隆市,七堵區,0223,186,415,601,41,642,1344,47.77%,13.84%,1
基隆市,七堵區,0224,192,399,591,28,619,1011,61.23%,18.99%,1
基隆市,七堵區,0225,152,317,469,16,485,925,52.43%,16.43%,1
基隆市,七堵區,0226,261,653,914,59,973,1735,56.08%,15.04%,1
基隆市,七堵區,0227,321,659,980,55,1035,1833,56.46%,17.51%,1
基隆市,七堵區,0228,167,340,507,14,521,938,55.54%,17.8%,1
基隆市,七堵區,0229,170,357,527,45,572,962,59.46%,17.67%,1
基隆市,七堵區,0230,208,443,651,26,677,1191,56.84%,17.46%,1
基隆市,七堵區,0231,143,399,542,33,575,999,57.56%,14.31%,1
基隆市,七堵區,0232,44,87,131,8,139,282,49.29%,15.6%,1
基隆市,七堵區,0233,222,385,607,34,641,1243,51.57%,17.86%,1
基隆市,七堵區,0234,182,344,526,44,570,1092,52.2%,16.67%,1
基隆市,七堵區,0235,201,429,630,43,673,1246,54.01%,16.13%,1
基隆市,七堵區,0236,297,532,829,38,867,1722,50.35%,17.25%,1
基隆市,七堵區,0237,210,468,678,33,711,1318,53.95%,15.93%,1
基隆市,七堵區,0238,126,315,441,20,461,975,47.28%,12.92%,1
基隆市,七堵區,0239,219,418,637,38,675,1285,52.53%,17.04%,1
基隆市,七堵區,0240,163,328,491,31,522,1077,48.47%,15.13%,1
基隆市,七堵區,0241,155,288,443,30,473,989,47.83%,15.67%,1
基隆市,七堵區,0242,187,379,566,34,600,1193,50.29%,15.67%,1
基隆市,七堵區,0243,222,411,633,31,664,1273,52.16%,17.44%,1
基隆市,七堵區,0244,294,586,880,72,952,1774,53.66%,16.57%,1
基隆市,七堵區,0245,304,544,848,58,906,1689,53.64%,18%,1
基隆市,七堵區,0246,216,423,639,51,690,1355,50.92%,15.94%,1
基隆市,七堵區,0247,281,447,728,38,766,1512,50.66%,18.58%,1
基隆市,七堵區,0248,231,477,708,17,725,1486,48.79%,15.55%,1
基隆市,七堵區,0249,276,550,826,27,853,1706,50%,16.18%,1
基隆市,七堵區,0250,426,288,714,42,756,1384,54.62%,30.78%,1
基隆市,七堵區,0251,216,372,588,38,626,1045,59.9%,20.67%,1
基隆市,七堵區,0252,249,445,694,39,733,1374,53.35%,18.12%,1
基隆市,七堵區,0253,76,147,223,8,231,428,53.97%,17.76%,1
基隆市,七堵區,0254,53,116,169,28,197,326,60.43%,16.26%,1
基隆市,七堵區,0255,65,170,235,16,251,351,71.51%,18.52%,1
基隆市,七堵區,0256,291,583,874,21,895,1871,47.84%,15.55%,1
基隆市,七堵區,0257,50,145,195,13,208,448,46.43%,11.16%,1
基隆市,暖暖區,0191,226,453,679,31,710,1431,49.62%,15.79%,1
基隆市,暖暖區,0192,60,153,213,5,218,456,47.81%,13.16%,1
基隆市,暖暖區,0193,112,218,330,28,358,637,56.2%,17.58%,1
基隆市,暖暖區,0194,136,277,413,22,435,735,59.18%,18.5%,1
基隆市,暖暖區,0195,152,346,498,21,519,1078,48.14%,14.1%,1
基隆市,暖暖區,0196,212,391,603,33,636,1238,51.37%,17.12%,1
基隆市,暖暖區,0197,217,428,645,30,675,1325,50.94%,16.38%,1
基隆市,暖暖區,0198,472,488,960,28,988,1475,66.98%,32%,1
基隆市,暖暖區,0199,214,332,546,18,564,1179,47.84%,18.15%,1
基隆市,暖暖區,0200,218,410,628,29,657,1110,59.19%,19.64%,1
基隆市,暖暖區,0201,222,426,648,24,672,1443,46.57%,15.38%,1
基隆市,暖暖區,0202,72,132,204,20,224,415,53.98%,17.35%,1
基隆市,暖暖區,0203,249,415,664,15,679,1378,49.27%,18.07%,1
基隆市,暖暖區,0204,272,515,787,28,815,1570,51.91%,17.32%,1
基隆市,暖暖區,0205,301,582,883,53,936,1603,58.39%,18.78%,1
基隆市,暖暖區,0206,230,474,704,28,732,1267,57.77%,18.15%,1
基隆市,暖暖區,0207,213,467,680,34,714,1359,52.54%,15.67%,1
基隆市,暖暖區,0208,139,411,550,20,570,970,58.76%,14.33%,1
基隆市,暖暖區,0209,177,343,520,13,533,1002,53.19%,17.66%,1
基隆市,暖暖區,0210,166,288,454,27,481,944,50.95%,17.58%,1
基隆市,暖暖區,0211,279,541,820,24,844,1500,56.27%,18.6%,1
基隆市,暖暖區,0212,173,399,572,21,593,1442,41.12%,12%,1
基隆市,暖暖區,0213,214,406,620,12,632,1165,54.25%,18.37%,1
基隆市,暖暖區,0214,265,521,786,33,819,1610,50.87%,16.46%,1
基隆市,暖暖區,0215,259,445,704,27,731,1328,55.05%,19.5%,1
基隆市,暖暖區,0216,207,394,601,17,618,1173,52.69%,17.65%,1
基隆市,暖暖區,0217,218,332,550,51,601,1019,58.98%,21.39%,1
基隆市,暖暖區,0218,245,478,723,21,744,1373,54.19%,17.84%,1
基隆市,仁愛區,0072,264,486,750,78,828,1782,46.46%,14.81%,1
基隆市,仁愛區,0073,179,376,555,44,599,1055,56.78%,16.97%,1
基隆市,仁愛區,0074,217,482,699,34,733,1558,47.05%,13.93%,1
基隆市,仁愛區,0075,248,591,839,43,882,1736,50.81%,14.29%,1
基隆市,仁愛區,0076,210,489,699,34,733,1243,58.97%,16.89%,1
基隆市,仁愛區,0077,187,408,595,28,623,1109,56.18%,16.86%,1
基隆市,仁愛區,0078,281,643,924,42,966,1684,57.36%,16.69%,1
基隆市,仁愛區,0079,168,311,479,29,508,919,55.28%,18.28%,1
基隆市,仁愛區,0080,181,310,491,14,505,991,50.96%,18.26%,1
基隆市,仁愛區,0081,154,306,460,10,470,876,53.65%,17.58%,1
基隆市,仁愛區,0082,182,391,573,39,612,1046,58.51%,17.4%,1
基隆市,仁愛區,0083,78,165,243,20,263,434,60.6%,17.97%,1
基隆市,仁愛區,0084,142,160,302,46,348,764,45.55%,18.59%,1
基隆市,仁愛區,0085,186,291,477,27,504,968,52.07%,19.21%,1
基隆市,仁愛區,0086,210,427,637,47,684,1326,51.58%,15.84%,1
基隆市,仁愛區,0087,172,365,537,36,573,1315,43.57%,13.08%,1
基隆市,仁愛區,0088,138,273,411,38,449,775,57.94%,17.81%,1
基隆市,仁愛區,0089,113,211,324,50,374,652,57.36%,17.33%,1
基隆市,仁愛區,0090,124,234,358,20,378,674,56.08%,18.4%,1
基隆市,仁愛區,0091,128,245,373,36,409,789,51.84%,16.22%,1
基隆市,仁愛區,0092,284,559,843,59,902,1715,52.59%,16.56%,1
基隆市,仁愛區,0093,143,277,420,39,459,849,54.06%,16.84%,1
基隆市,仁愛區,0094,137,328,465,20,485,875,55.43%,15.66%,1
基隆市,仁愛區,0095,148,248,396,40,436,851,51.23%,17.39%,1
基隆市,仁愛區,0096,140,253,393,34,427,735,58.1%,19.05%,1
基隆市,仁愛區,0097,152,329,481,56,537,1009,53.22%,15.06%,1
基隆市,仁愛區,0098,159,327,486,46,532,1082,49.17%,14.7%,1
基隆市,仁愛區,0099,212,386,598,64,662,1278,51.8%,16.59%,1
基隆市,仁愛區,0100,284,546,830,42,872,1519,57.41%,18.7%,1
基隆市,仁愛區,0101,198,366,564,36,600,1336,44.91%,14.82%,1
基隆市,仁愛區,0102,209,451,660,41,701,1178,59.51%,17.74%,1
基隆市,仁愛區,0103,128,222,350,33,383,708,54.1%,18.08%,1
基隆市,仁愛區,0104,113,219,332,24,356,567,62.79%,19.93%,1
基隆市,仁愛區,0105,153,221,374,40,414,751,55.13%,20.37%,1
基隆市,仁愛區,0106,129,204,333,20,353,589,59.93%,21.9%,1
基隆市,中山區,0107,128,258,386,23,409,796,51.38%,16.08%,1
基隆市,中山區,0108,192,403,595,45,640,1036,61.78%,18.53%,1
基隆市,中山區,0109,128,271,399,37,436,756,57.67%,16.93%,1
基隆市,中山區,0110,164,254,418,20,438,957,45.77%,17.14%,1
基隆市,中山區,0111,138,283,421,17,438,802,54.61%,17.21%,1
基隆市,中山區,0112,214,419,633,37,670,1263,53.05%,16.94%,1
基隆市,中山區,0113,143,283,426,19,445,778,57.2%,18.38%,1
基隆市,中山區,0114,191,387,578,83,661,1180,56.02%,16.19%,1
基隆市,中山區,0115,150,305,455,23,478,990,48.28%,15.15%,1
基隆市,中山區,0116,181,350,531,23,554,1332,41.59%,13.59%,1
基隆市,中山區,0117,128,255,383,21,404,848,47.64%,15.09%,1
基隆市,中山區,0118,146,273,419,20,439,922,47.61%,15.84%,1
基隆市,中山區,0119,79,183,262,11,273,459,59.48%,17.21%,1
基隆市,中山區,0120,73,193,266,21,287,574,50%,12.72%,1
基隆市,中山區,0121,147,269,416,39,455,877,51.88%,16.76%,1
基隆市,中山區,0122,246,437,683,34,717,1584,45.27%,15.53%,1
基隆市,中山區,0123,145,323,468,26,494,1319,37.45%,10.99%,1
基隆市,中山區,0124,293,611,904,66,970,1938,50.05%,15.12%,1
基隆市,中山區,0125,348,539,887,21,908,1877,48.38%,18.54%,1
基隆市,中山區,0126,373,714,1087,31,1118,2088,53.54%,17.86%,1
基隆市,中山區,0127,351,673,1024,29,1053,1946,54.11%,18.04%,1
基隆市,中山區,0128,234,486,720,49,769,1353,56.84%,17.29%,1
基隆市,中山區,0129,202,438,640,46,686,1317,52.09%,15.34%,1
基隆市,中山區,0130,155,312,467,30,497,870,57.13%,17.82%,1
基隆市,中山區,0131,211,484,695,28,723,1322,54.69%,15.96%,1
基隆市,中山區,0132,218,365,583,24,607,1295,46.87%,16.83%,1
基隆市,中山區,0133,145,291,436,24,460,756,60.85%,19.18%,1
基隆市,中山區,0134,227,470,697,26,723,1602,45.13%,14.17%,1
基隆市,中山區,0135,234,475,709,32,741,1568,47.26%,14.92%,1
基隆市,中山區,0136,242,459,701,38,739,1404,52.64%,17.24%,1
基隆市,中山區,0137,277,611,888,25,913,1909,47.83%,14.51%,1
基隆市,中山區,0138,221,471,692,66,758,1642,46.16%,13.46%,1
基隆市,中山區,0139,132,292,424,22,446,932,47.85%,14.16%,1
基隆市,中山區,0140,145,328,473,40,513,849,60.42%,17.08%,1
基隆市,中山區,0141,148,231,379,45,424,715,59.3%,20.7%,1
基隆市,安樂區,0142,176,442,618,52,670,1361,49.23%,12.93%,1
基隆市,安樂區,0143,161,403,564,26,590,1213,48.64%,13.27%,1
基隆市,安樂區,0144,115,325,440,26,466,1026,45.42%,11.21%,1
基隆市,安樂區,0145,188,386,574,55,629,1038,60.6%,18.11%,1
基隆市,安樂區,0146,177,291,468,47,515,897,57.41%,19.73%,1
基隆市,安樂區,0147,227,461,688,57,745,1401,53.18%,16.2%,1
基隆市,安樂區,0148,68,158,226,11,237,641,36.97%,10.61%,1
基隆市,安樂區,0149,224,478,702,44,746,1472,50.68%,15.22%,1
基隆市,安樂區,0150,75,175,250,13,263,472,55.72%,15.89%,1
基隆市,安樂區,0151,154,320,474,26,500,841,59.45%,18.31%,1
基隆市,安樂區,0152,99,177,276,29,305,571,53.42%,17.34%,1
基隆市,安樂區,0153,292,587,879,38,917,1901,48.24%,15.36%,1
基隆市,安樂區,0154,224,428,652,47,699,1349,51.82%,16.6%,1
基隆市,安樂區,0155,168,428,596,32,628,1225,51.27%,13.71%,1
基隆市,安樂區,0156,231,464,695,53,748,1351,55.37%,17.1%,1
基隆市,安樂區,0157,317,573,890,21,911,1601,56.9%,19.8%,1
基隆市,安樂區,0158,360,896,1256,34,1290,2513,51.33%,14.33%,1
基隆市,安樂區,0159,280,560,840,32,872,1613,54.06%,17.36%,1
基隆市,安樂區,0160,497,416,913,28,941,1731,54.36%,28.71%,1
基隆市,安樂區,0161,296,526,822,24,846,1424,59.41%,20.79%,1
基隆市,安樂區,0162,265,607,872,54,926,1806,51.27%,14.67%,1
基隆市,安樂區,0163,280,608,888,49,937,1679,55.81%,16.68%,1
基隆市,安樂區,0164,347,626,973,42,1015,1902,53.36%,18.24%,1
基隆市,安樂區,0165,513,562,1075,13,1088,2040,53.33%,25.15%,1
基隆市,安樂區,0166,217,459,676,33,709,1313,54%,16.53%,1
基隆市,安樂區,0167,189,406,595,30,625,1243,50.28%,15.21%,1
基隆市,安樂區,0168,322,541,863,36,899,1759,51.11%,18.31%,1
基隆市,安樂區,0169,157,265,422,16,438,694,63.11%,22.62%,1
基隆市,安樂區,0170,212,317,529,22,551,866,63.63%,24.48%,1
基隆市,安樂區,0171,226,426,652,23,675,1557,43.35%,14.52%,1
基隆市,安樂區,0172,235,466,701,16,717,1411,50.82%,16.65%,1
基隆市,安樂區,0173,309,558,867,23,890,1568,56.76%,19.71%,1
基隆市,安樂區,0174,238,453,691,34,725,1400,51.79%,17%,1
基隆市,安樂區,0175,265,507,772,16,788,1531,51.47%,17.31%,1
基隆市,安樂區,0176,271,533,804,15,819,1673,48.95%,16.2%,1
基隆市,安樂區,0177,163,365,528,32,560,1054,53.13%,15.46%,1
基隆市,安樂區,0178,273,526,799,31,830,1923,43.16%,14.2%,1
基隆市,安樂區,0179,659,336,995,56,1051,1960,53.62%,33.62%,1
基隆市,安樂區,0180,301,634,935,43,978,1962,49.85%,15.34%,1
基隆市,安樂區,0181,321,719,1040,57,1097,2117,51.82%,15.16%,1
基隆市,安樂區,0182,294,564,858,32,890,1829,48.66%,16.07%,1
基隆市,安樂區,0183,251,467,718,20,738,1529,48.27%,16.42%,1
基隆市,安樂區,0184,310,612,922,27,949,1869,50.78%,16.59%,1
基隆市,安樂區,0185,189,440,629,11,640,1140,56.14%,16.58%,1
基隆市,安樂區,0186,285,524,809,37,846,1641,51.55%,17.37%,1
基隆市,安樂區,0187,207,416,623,37,660,1279,51.6%,16.18%,1
基隆市,安樂區,0188,267,409,676,23,699,1360,51.4%,19.63%,1
基隆市,安樂區,0189,271,469,740,24,764,1399,54.61%,19.37%,1
基隆市,安樂區,0190,228,391,619,23,642,1251,51.32%,18.23%,1
基隆市,信義區,0036,223,367,590,27,617,1096,56.3%,20.35%,1
基隆市,信義區,0037,239,459,698,33,731,1232,59.33%,19.4%,1
基隆市,信義區,0038,249,388,637,21,658,1184,55.57%,21.03%,1
基隆市,信義區,0039,183,443,626,39,665,1133,58.69%,16.15%,1
基隆市,信義區,0040,210,427,637,29,666,1188,56.06%,17.68%,1
基隆市,信義區,0041,133,261,394,31,425,725,58.62%,18.34%,1
基隆市,信義區,0042,214,474,688,36,724,1524,47.51%,14.04%,1
基隆市,信義區,0043,140,248,388,24,412,736,55.98%,19.02%,1
基隆市,信義區,0044,97,213,310,15,325,611,53.19%,15.88%,1
基隆市,信義區,0045,135,301,436,13,449,951,47.21%,14.2%,1
基隆市,信義區,0046,265,557,822,31,853,1616,52.78%,16.4%,1
基隆市,信義區,0047,241,553,794,28,822,1516,54.22%,15.9%,1
基隆市,信義區,0048,168,343,511,28,539,1049,51.38%,16.02%,1
基隆市,信義區,0049,206,334,540,18,558,1069,52.2%,19.27%,1
基隆市,信義區,0050,125,276,401,22,423,727,58.18%,17.19%,1
基隆市,信義區,0051,177,354,531,18,549,929,59.1%,19.05%,1
基隆市,信義區,0052,240,430,670,19,689,1118,61.63%,21.47%,1
基隆市,信義區,0053,269,449,718,33,751,1339,56.09%,20.09%,1
基隆市,信義區,0054,169,331,500,18,518,999,51.85%,16.92%,1
基隆市,信義區,0055,126,253,379,13,392,764,51.31%,16.49%,1
基隆市,信義區,0056,223,492,715,36,751,1555,48.3%,14.34%,1
基隆市,信義區,0057,332,626,958,25,983,2015,48.78%,16.48%,1
基隆市,信義區,0058,219,464,683,39,722,1268,56.94%,17.27%,1
基隆市,信義區,0059,259,546,805,29,834,1569,53.15%,16.51%,1
基隆市,信義區,0060,309,615,924,32,956,1985,48.16%,15.57%,1
基隆市,信義區,0061,232,562,794,18,812,1476,55.01%,15.72%,1
基隆市,信義區,0062,309,503,812,26,838,1493,56.13%,20.7%,1
基隆市,信義區,0063,265,478,743,17,760,1249,60.85%,21.22%,1
基隆市,信義區,0064,256,512,768,22,790,1559,50.67%,16.42%,1
基隆市,信義區,0065,196,363,559,10,569,1168,48.72%,16.78%,1
基隆市,信義區,0066,237,566,803,26,829,1602,51.75%,14.79%,1
基隆市,信義區,0067,199,451,650,37,687,1485,46.26%,13.4%,1
基隆市,信義區,0068,160,340,500,22,522,1009,51.73%,15.86%,1
基隆市,信義區,0069,263,563,826,41,867,2016,43.01%,13.05%,1
基隆市,信義區,0070,221,497,718,32,750,1764,42.52%,12.53%,1
基隆市,信義區,0071,199,466,665,36,701,1295,54.13%,15.37%,1
新竹市,東區,0001,178,324,502,14,516,1512,34.13%,11.77%,1
新竹市,東區,0002,213,356,569,16,585,953,61.39%,22.35%,1
新竹市,東區,0003,140,268,408,15,423,729,58.02%,19.2%,1
新竹市,東區,0004,111,219,330,23,353,566,62.37%,19.61%,1
新竹市,東區,0005,126,240,366,12,378,640,59.06%,19.69%,1
新竹市,東區,0006,65,92,157,16,173,305,56.72%,21.31%,1
新竹市,東區,0007,106,216,322,24,346,563,61.46%,18.83%,1
新竹市,東區,0008,128,278,406,15,421,741,56.82%,17.27%,1
新竹市,東區,0009,233,356,589,18,607,1041,58.31%,22.38%,1
新竹市,東區,0010,302,548,850,29,879,1615,54.43%,18.7%,1
新竹市,東區,0011,245,464,709,38,747,1287,58.04%,19.04%,1
新竹市,東區,0012,261,596,857,26,883,1554,56.82%,16.8%,1
新竹市,東區,0013,286,520,806,16,822,1388,59.22%,20.61%,1
新竹市,東區,0014,274,538,812,33,845,1419,59.55%,19.31%,1
新竹市,東區,0015,265,453,718,38,756,1355,55.79%,19.56%,1
新竹市,東區,0016,284,530,814,27,841,1490,56.44%,19.06%,1
新竹市,東區,0017,304,593,897,23,920,1615,56.97%,18.82%,1
新竹市,東區,0018,454,479,933,37,970,1672,58.01%,27.15%,1
新竹市,東區,0019,234,363,597,25,622,1062,58.57%,22.03%,1
新竹市,東區,0020,273,451,724,30,754,1315,57.34%,20.76%,1
新竹市,東區,0021,183,381,564,33,597,1000,59.7%,18.3%,1
新竹市,東區,0022,265,498,763,36,799,1337,59.76%,19.82%,1
新竹市,東區,0023,372,551,923,26,949,1747,54.32%,21.29%,1
新竹市,東區,0024,376,558,934,25,959,1600,59.94%,23.5%,1
新竹市,東區,0025,210,414,624,32,656,1158,56.65%,18.13%,1
新竹市,東區,0026,191,327,518,22,540,828,65.22%,23.07%,1
新竹市,東區,0027,309,525,834,39,873,1573,55.5%,19.64%,1
新竹市,東區,0028,297,562,859,30,889,1550,57.35%,19.16%,1
新竹市,東區,0029,244,483,727,29,756,1317,57.4%,18.53%,1
新竹市,東區,0030,254,361,615,32,647,1040,62.21%,24.42%,1
新竹市,東區,0031,162,381,543,21,564,935,60.32%,17.33%,1
新竹市,東區,0032,209,385,594,19,613,1074,57.08%,19.46%,1
新竹市,東區,0033,213,447,660,35,695,1133,61.34%,18.8%,1
新竹市,東區,0034,251,468,719,35,754,1262,59.75%,19.89%,1
新竹市,東區,0035,221,452,673,18,691,1199,57.63%,18.43%,1
新竹市,東區,0036,257,477,734,28,762,1226,62.15%,20.96%,1
新竹市,東區,0037,327,531,858,31,889,1377,64.56%,23.75%,1
新竹市,東區,0038,233,385,618,17,635,991,64.08%,23.51%,1
新竹市,東區,0039,267,445,712,52,764,1271,60.11%,21.01%,1
新竹市,東區,0040,240,393,633,19,652,1012,64.43%,23.72%,1
新竹市,東區,0041,187,356,543,44,587,1001,58.64%,18.68%,1
新竹市,東區,0042,339,482,821,43,864,1603,53.9%,21.15%,1
新竹市,東區,0043,204,464,668,28,696,1236,56.31%,16.5%,1
新竹市,東區,0044,206,499,705,37,742,1532,48.43%,13.45%,1
新竹市,東區,0045,217,498,715,23,738,1306,56.51%,16.62%,1
新竹市,東區,0046,190,387,577,55,632,1073,58.9%,17.71%,1
新竹市,東區,0047,193,332,525,11,536,952,56.3%,20.27%,1
新竹市,東區,0048,207,400,607,44,651,1298,50.15%,15.95%,1
新竹市,東區,0049,121,303,424,14,438,778,56.3%,15.55%,1
新竹市,東區,0050,275,396,671,35,706,1195,59.08%,23.01%,1
新竹市,東區,0051,292,531,823,45,868,1569,55.32%,18.61%,1
新竹市,東區,0052,367,573,940,26,966,1533,63.01%,23.94%,1
新竹市,東區,0053,204,578,782,32,814,1336,60.93%,15.27%,1
新竹市,東區,0054,243,541,784,25,809,1367,59.18%,17.78%,1
新竹市,東區,0055,274,493,767,21,788,1289,61.13%,21.26%,1
新竹市,東區,0056,174,344,518,24,542,960,56.46%,18.13%,1
新竹市,東區,0057,182,338,520,19,539,843,63.94%,21.59%,1
新竹市,東區,0058,166,373,539,37,576,948,60.76%,17.51%,1
新竹市,東區,0059,135,359,494,23,517,915,56.5%,14.75%,1
新竹市,東區,0060,314,703,1017,29,1046,1801,58.08%,17.43%,1
新竹市,東區,0061,195,417,612,24,636,1079,58.94%,18.07%,1
新竹市,東區,0062,139,278,417,9,426,676,63.02%,20.56%,1
新竹市,東區,0063,237,401,638,38,676,1132,59.72%,20.94%,1
新竹市,東區,0064,64,78,142,10,152,251,60.56%,25.5%,1
新竹市,東區,0065,340,559,899,34,933,1620,57.59%,20.99%,1
新竹市,東區,0066,325,450,775,26,801,1479,54.16%,21.97%,1
新竹市,東區,0067,325,408,733,23,756,1402,53.92%,23.18%,1
新竹市,東區,0068,278,415,693,37,730,1280,57.03%,21.72%,1
新竹市,東區,0069,345,375,720,13,733,1228,59.69%,28.09%,1
新竹市,東區,0070,342,284,626,5,631,1157,54.54%,29.56%,1
新竹市,東區,0071,272,464,736,31,767,1354,56.65%,20.09%,1
新竹市,東區,0072,333,515,848,29,877,1334,65.74%,24.96%,1
新竹市,東區,0073,290,438,728,24,752,1234,60.94%,23.5%,1
新竹市,東區,0074,311,564,875,21,896,1398,64.09%,22.25%,1
新竹市,東區,0075,246,306,552,18,570,928,61.42%,26.51%,1
新竹市,東區,0076,296,527,823,26,849,1368,62.06%,21.64%,1
新竹市,東區,0077,224,417,641,25,666,1215,54.81%,18.44%,1
新竹市,東區,0078,170,355,525,31,556,1067,52.11%,15.93%,1
新竹市,東區,0079,349,304,653,9,662,1194,55.44%,29.23%,1
新竹市,東區,0080,321,304,625,17,642,1193,53.81%,26.91%,1
新竹市,東區,0081,289,471,760,45,805,1388,58%,20.82%,1
新竹市,東區,0082,247,480,727,25,752,1267,59.35%,19.49%,1
新竹市,東區,0083,261,453,714,22,736,1299,56.66%,20.09%,1
新竹市,東區,0084,292,420,712,29,741,1288,57.53%,22.67%,1
新竹市,東區,0085,350,380,730,19,749,1228,60.99%,28.5%,1
新竹市,東區,0086,335,341,676,14,690,1135,60.79%,29.52%,1
新竹市,東區,0087,359,407,766,21,787,1237,63.62%,29.02%,1
新竹市,東區,0088,199,371,570,37,607,1135,53.48%,17.53%,1
新竹市,東區,0089,191,391,582,25,607,1165,52.1%,16.39%,1
新竹市,東區,0090,212,391,603,28,631,1124,56.14%,18.86%,1
新竹市,東區,0091,242,441,683,29,712,1210,58.84%,20%,1
新竹市,東區,0092,250,435,685,29,714,1323,53.97%,18.9%,1
新竹市,東區,0093,178,453,631,26,657,1207,54.43%,14.75%,1
新竹市,東區,0094,211,389,600,29,629,1264,49.76%,16.69%,1
新竹市,東區,0095,278,391,669,17,686,1248,54.97%,22.28%,1
新竹市,東區,0096,308,525,833,38,871,1400,62.21%,22%,1
新竹市,東區,0097,343,514,857,27,884,1473,60.01%,23.29%,1
新竹市,東區,0098,305,437,742,27,769,1367,56.25%,22.31%,1
新竹市,東區,0099,256,454,710,15,725,1233,58.8%,20.76%,1
新竹市,東區,0100,93,172,265,9,274,507,54.04%,18.34%,1
新竹市,東區,0101,131,261,392,30,422,714,59.1%,18.35%,1
新竹市,東區,0102,156,327,483,34,517,875,59.09%,17.83%,1
新竹市,東區,0103,236,513,749,41,790,1396,56.59%,16.91%,1
新竹市,東區,0104,242,389,631,28,659,1232,53.49%,19.64%,1
新竹市,東區,0105,279,403,682,35,717,1323,54.2%,21.09%,1
新竹市,東區,0106,253,456,709,17,726,1516,47.89%,16.69%,1
新竹市,東區,0107,281,435,716,30,746,1453,51.34%,19.34%,1
新竹市,東區,0108,160,323,483,34,517,880,58.75%,18.18%,1
新竹市,東區,0109,129,393,522,25,547,1058,51.7%,12.19%,1
新竹市,東區,0110,187,384,571,28,599,1061,56.46%,17.62%,1
新竹市,東區,0111,119,256,375,36,411,710,57.89%,16.76%,1
新竹市,東區,0112,155,262,417,38,455,752,60.51%,20.61%,1
新竹市,東區,0113,83,207,290,12,302,475,63.58%,17.47%,1
新竹市,東區,0114,170,278,448,30,478,880,54.32%,19.32%,1
新竹市,東區,0115,209,339,548,28,576,989,58.24%,21.13%,1
新竹市,東區,0116,191,385,576,35,611,1059,57.7%,18.04%,1
新竹市,東區,0117,128,210,338,34,372,607,61.29%,21.09%,1
新竹市,東區,0118,164,280,444,32,476,815,58.4%,20.12%,1
新竹市,東區,0119,150,299,449,33,482,777,62.03%,19.31%,1
新竹市,東區,0120,239,431,670,31,701,1399,50.11%,17.08%,1
新竹市,東區,0121,243,398,641,36,677,1216,55.67%,19.98%,1
新竹市,東區,0122,175,350,525,33,558,1062,52.54%,16.48%,1
新竹市,東區,0123,196,394,590,21,611,1046,58.41%,18.74%,1
新竹市,東區,0124,208,464,672,21,693,1332,52.03%,15.62%,1
新竹市,東區,0125,252,487,739,41,780,1350,57.78%,18.67%,1
新竹市,東區,0126,237,490,727,29,756,1438,52.57%,16.48%,1
新竹市,東區,0127,211,502,713,30,743,1414,52.55%,14.92%,1
新竹市,東區,0128,307,525,832,26,858,1476,58.13%,20.8%,1
新竹市,東區,0129,259,506,765,45,810,1326,61.09%,19.53%,1
新竹市,東區,0130,238,341,579,17,596,927,64.29%,25.67%,1
新竹市,東區,0131,238,475,713,21,734,1273,57.66%,18.7%,1
新竹市,東區,0132,229,434,663,35,698,1315,53.08%,17.41%,1
新竹市,東區,0133,292,496,788,26,814,1413,57.61%,20.67%,1
新竹市,東區,0134,225,362,587,26,613,1064,57.61%,21.15%,1
新竹市,東區,0135,305,467,772,15,787,1244,63.26%,24.52%,1
新竹市,東區,0136,183,422,605,9,614,1160,52.93%,15.78%,1
新竹市,東區,0137,230,452,682,14,696,1398,49.79%,16.45%,1
新竹市,東區,0138,197,355,552,20,572,1384,41.33%,14.23%,1
新竹市,東區,0139,153,354,507,35,542,874,62.01%,17.51%,1
新竹市,北區,0140,87,163,250,10,260,477,54.51%,18.24%,1
新竹市,北區,0141,101,205,306,17,323,535,60.37%,18.88%,1
新竹市,北區,0142,137,273,410,34,444,746,59.52%,18.36%,1
新竹市,北區,0143,91,190,281,17,298,546,54.58%,16.67%,1
新竹市,北區,0144,119,296,415,28,443,711,62.31%,16.74%,1
新竹市,北區,0145,184,376,560,30,590,1143,51.62%,16.1%,1
新竹市,北區,0146,236,452,688,31,719,1370,52.48%,17.23%,1
新竹市,北區,0147,252,469,721,34,755,1390,54.32%,18.13%,1
新竹市,北區,0148,184,351,535,20,555,962,57.69%,19.13%,1
新竹市,北區,0149,262,408,670,16,686,1237,55.46%,21.18%,1
新竹市,北區,0150,278,484,762,34,796,1604,49.63%,17.33%,1
新竹市,北區,0151,115,249,364,18,382,758,50.4%,15.17%,1
新竹市,北區,0152,210,463,673,24,697,1320,52.8%,15.91%,1
新竹市,北區,0153,238,484,722,47,769,1519,50.63%,15.67%,1
新竹市,北區,0154,44,85,129,4,133,347,38.33%,12.68%,1
新竹市,北區,0155,126,554,680,35,715,1212,58.99%,10.4%,1
新竹市,北區,0156,259,498,757,38,795,1484,53.57%,17.45%,1
新竹市,北區,0157,261,480,741,45,786,1428,55.04%,18.28%,1
新竹市,北區,0158,170,429,599,39,638,1128,56.56%,15.07%,1
新竹市,北區,0159,109,239,348,13,361,638,56.58%,17.08%,1
新竹市,北區,0160,195,478,673,41,714,1222,58.43%,15.96%,1
新竹市,北區,0161,206,350,556,16,572,1076,53.16%,19.14%,1
新竹市,北區,0162,181,395,576,25,601,937,64.14%,19.32%,1
新竹市,北區,0163,218,522,740,35,775,1394,55.6%,15.64%,1
新竹市,北區,0164,262,508,770,32,802,1568,51.15%,16.71%,1
新竹市,北區,0165,236,435,671,34,705,1159,60.83%,20.36%,1
新竹市,北區,0166,36,69,105,0,105,252,41.67%,14.29%,1
新竹市,北區,0167,163,298,461,20,481,761,63.21%,21.42%,1
新竹市,北區,0168,155,285,440,31,471,788,59.77%,19.67%,1
新竹市,北區,0169,108,228,336,26,362,561,64.53%,19.25%,1
新竹市,北區,0170,265,507,772,51,823,1558,52.82%,17.01%,1
新竹市,北區,0171,263,410,673,32,705,1398,50.43%,18.81%,1
新竹市,北區,0172,163,343,506,31,537,957,56.11%,17.03%,1
新竹市,北區,0173,211,450,661,26,687,1195,57.49%,17.66%,1
新竹市,北區,0174,227,363,590,23,613,1236,49.6%,18.37%,1
新竹市,北區,0175,191,439,630,39,669,1255,53.31%,15.22%,1
新竹市,北區,0176,210,409,619,22,641,1114,57.54%,18.85%,1
新竹市,北區,0177,262,492,754,26,780,1396,55.87%,18.77%,1
新竹市,北區,0178,259,540,799,41,840,1456,57.69%,17.79%,1
新竹市,北區,0179,245,471,716,27,743,1374,54.08%,17.83%,1
新竹市,北區,0180,178,369,547,32,579,1070,54.11%,16.64%,1
新竹市,北區,0181,174,422,596,45,641,1142,56.13%,15.24%,1
新竹市,北區,0182,184,382,566,21,587,1103,53.22%,16.68%,1
新竹市,北區,0183,212,420,632,49,681,1190,57.23%,17.82%,1
新竹市,北區,0184,198,459,657,21,678,1089,62.26%,18.18%,1
新竹市,北區,0185,212,386,598,21,619,1272,48.66%,16.67%,1
新竹市,北區,0186,203,500,703,44,747,1306,57.2%,15.54%,1
新竹市,北區,0187,259,456,715,32,747,1328,56.25%,19.5%,1
新竹市,北區,0188,259,483,742,28,770,1457,52.85%,17.78%,1
新竹市,北區,0189,279,519,798,34,832,1492,55.76%,18.7%,1
新竹市,北區,0190,225,439,664,40,704,1160,60.69%,19.4%,1
新竹市,北區,0191,158,370,528,46,574,971,59.11%,16.27%,1
新竹市,北區,0192,161,283,444,17,461,1401,32.91%,11.49%,1
新竹市,北區,0193,296,459,755,24,779,1340,58.13%,22.09%,1
新竹市,北區,0194,278,503,781,28,809,1371,59.01%,20.28%,1
新竹市,北區,0195,242,434,676,27,703,1267,55.49%,19.1%,1
新竹市,北區,0196,234,421,655,25,680,1073,63.37%,21.81%,1
新竹市,北區,0197,212,442,654,25,679,1159,58.58%,18.29%,1
新竹市,北區,0198,279,428,707,15,722,1294,55.8%,21.56%,1
新竹市,北區,0199,286,494,780,25,805,1442,55.83%,19.83%,1
新竹市,北區,0200,259,457,716,27,743,1270,58.5%,20.39%,1
新竹市,北區,0201,145,569,714,46,760,1179,64.46%,12.3%,1
新竹市,北區,0202,189,377,566,31,597,949,62.91%,19.92%,1
新竹市,北區,0203,249,396,645,30,675,1163,58.04%,21.41%,1
新竹市,北區,0204,273,453,726,16,742,1334,55.62%,20.46%,1
新竹市,北區,0205,301,460,761,34,795,1415,56.18%,21.27%,1
新竹市,北區,0206,321,454,775,21,796,1305,61%,24.6%,1
新竹市,北區,0207,256,406,662,20,682,1200,56.83%,21.33%,1
新竹市,北區,0208,222,392,614,22,636,1106,57.5%,20.07%,1
新竹市,北區,0209,209,399,608,22,630,1044,60.34%,20.02%,1
新竹市,北區,0210,225,379,604,26,630,1061,59.38%,21.21%,1
新竹市,北區,0211,290,552,842,57,899,1518,59.22%,19.1%,1
新竹市,北區,0212,247,475,722,38,760,1220,62.3%,20.25%,1
新竹市,北區,0213,321,517,838,16,854,1475,57.9%,21.76%,1
新竹市,北區,0214,215,496,711,39,750,1373,54.62%,15.66%,1
新竹市,北區,0215,253,560,813,22,835,1450,57.59%,17.45%,1
新竹市,北區,0216,271,529,800,30,830,1423,58.33%,19.04%,1
新竹市,北區,0217,157,417,574,23,597,1059,56.37%,14.83%,1
新竹市,北區,0218,175,476,651,35,686,1130,60.71%,15.49%,1
新竹市,北區,0219,226,493,719,31,750,1208,62.09%,18.71%,1
新竹市,北區,0220,185,563,748,15,763,1226,62.23%,15.09%,1
新竹市,北區,0221,243,407,650,29,679,1175,57.79%,20.68%,1
新竹市,北區,0222,283,486,769,23,792,1371,57.77%,20.64%,1
新竹市,北區,0223,211,465,676,46,722,1306,55.28%,16.16%,1
新竹市,北區,0224,203,489,692,25,717,1340,53.51%,15.15%,1
新竹市,北區,0225,227,412,639,46,685,1111,61.66%,20.43%,1
新竹市,北區,0226,242,494,736,31,767,1197,64.08%,20.22%,1
新竹市,北區,0227,143,405,548,30,578,1008,57.34%,14.19%,1
新竹市,北區,0228,173,329,502,21,523,946,55.29%,18.29%,1
新竹市,北區,0229,122,268,390,33,423,705,60%,17.3%,1
新竹市,北區,0230,138,314,452,55,507,848,59.79%,16.27%,1
新竹市,北區,0231,220,448,668,25,693,1295,53.51%,16.99%,1
新竹市,北區,0232,222,499,721,33,754,1467,51.4%,15.13%,1
新竹市,北區,0233,254,497,751,30,781,1659,47.08%,15.31%,1
新竹市,北區,0234,216,436,652,34,686,1297,52.89%,16.65%,1
新竹市,北區,0235,249,482,731,60,791,1374,57.57%,18.12%,1
新竹市,北區,0236,274,520,794,52,846,1457,58.06%,18.81%,1
新竹市,北區,0237,180,421,601,29,630,1072,58.77%,16.79%,1
新竹市,北區,0238,228,456,684,43,727,1350,53.85%,16.89%,1
新竹市,北區,0239,209,381,590,21,611,971,62.92%,21.52%,1
新竹市,北區,0240,234,558,792,59,851,1450,58.69%,16.14%,1
新竹市,北區,0241,135,351,486,27,513,895,57.32%,15.08%,1
新竹市,北區,0242,239,484,723,33,756,1378,54.86%,17.34%,1
新竹市,北區,0243,246,530,776,69,845,1609,52.52%,15.29%,1
新竹市,北區,0244,101,216,317,30,347,594,58.42%,17%,1
新竹市,香山區,0245,243,494,737,47,784,1443,54.33%,16.84%,1
新竹市,香山區,0246,300,359,659,26,685,1241,55.2%,24.17%,1
新竹市,香山區,0247,204,428,632,27,659,1194,55.19%,17.09%,1
新竹市,香山區,0248,220,373,593,12,605,1081,55.97%,20.35%,1
新竹市,香山區,0249,145,309,454,21,475,807,58.86%,17.97%,1
新竹市,香山區,0250,281,632,913,47,960,1760,54.55%,15.97%,1
新竹市,香山區,0251,293,582,875,39,914,1635,55.9%,17.92%,1
新竹市,香山區,0252,273,540,813,42,855,1473,58.04%,18.53%,1
新竹市,香山區,0253,271,546,817,15,832,1408,59.09%,19.25%,1
新竹市,香山區,0254,196,419,615,25,640,1318,48.56%,14.87%,1
新竹市,香山區,0255,254,471,725,26,751,1337,56.17%,19%,1
新竹市,香山區,0256,285,627,912,25,937,1862,50.32%,15.31%,1
新竹市,香山區,0257,204,370,574,21,595,1067,55.76%,19.12%,1
新竹市,香山區,0258,162,333,495,36,531,863,61.53%,18.77%,1
新竹市,香山區,0259,220,466,686,55,741,1198,61.85%,18.36%,1
新竹市,香山區,0260,211,437,648,46,694,1138,60.98%,18.54%,1
新竹市,香山區,0261,177,398,575,48,623,957,65.1%,18.5%,1
新竹市,香山區,0262,220,516,736,65,801,1348,59.42%,16.32%,1
新竹市,香山區,0263,205,428,633,54,687,1023,67.16%,20.04%,1
新竹市,香山區,0264,145,377,522,32,554,970,57.11%,14.95%,1
新竹市,香山區,0265,231,489,720,43,763,1318,57.89%,17.53%,1
新竹市,香山區,0266,166,401,567,41,608,1088,55.88%,15.26%,1
新竹市,香山區,0267,153,289,442,16,458,903,50.72%,16.94%,1
新竹市,香山區,0268,192,363,555,36,591,1012,58.4%,18.97%,1
新竹市,香山區,0269,146,384,530,40,570,1014,56.21%,14.4%,1
新竹市,香山區,0270,215,472,687,27,714,1238,57.67%,17.37%,1
新竹市,香山區,0271,187,411,598,60,658,1182,55.67%,15.82%,1
新竹市,香山區,0272,225,572,797,57,854,1331,64.16%,16.9%,1
新竹市,香山區,0273,245,366,611,21,632,976,64.75%,25.1%,1
新竹市,香山區,0274,142,297,439,15,454,834,54.44%,17.03%,1
新竹市,香山區,0275,161,339,500,29,529,919,57.56%,17.52%,1
新竹市,香山區,0276,250,418,668,35,703,1188,59.18%,21.04%,1
新竹市,香山區,0277,174,409,583,44,627,1086,57.73%,16.02%,1
新竹市,香山區,0278,234,445,679,33,712,1144,62.24%,20.45%,1
新竹市,香山區,0279,208,414,622,30,652,1112,58.63%,18.71%,1
新竹市,香山區,0280,275,542,817,37,854,1476,57.86%,18.63%,1
新竹市,香山區,0281,221,468,689,32,721,1291,55.85%,17.12%,1
新竹市,香山區,0282,269,585,854,50,904,1464,61.75%,18.37%,1
新竹市,香山區,0283,231,566,797,51,848,1427,59.43%,16.19%,1
新竹市,香山區,0284,135,477,612,31,643,1336,48.13%,10.1%,1
新竹市,香山區,0285,173,359,532,35,567,1131,50.13%,15.3%,1
新竹市,香山區,0286,195,398,593,56,649,1070,60.65%,18.22%,1
新竹市,香山區,0287,164,399,563,57,620,1006,61.63%,16.3%,1
新竹市,香山區,0288,157,393,550,30,580,1223,47.42%,12.84%,1
新竹市,香山區,0289,195,415,610,24,634,1119,56.66%,17.43%,1
新竹市,香山區,0290,212,447,659,40,699,1400,49.93%,15.14%,1
新竹市,香山區,0291,234,513,747,31,778,1627,47.82%,14.38%,1
新竹市,香山區,0292,207,403,610,40,650,1289,50.43%,16.06%,1
新竹市,香山區,0293,213,456,669,46,715,1409,50.75%,15.12%,1
新竹市,香山區,0294,126,268,394,29,423,814,51.97%,15.48%,1
新竹市,香山區,0295,107,271,378,26,404,719,56.19%,14.88%,1
新竹市,香山區,0296,174,330,504,16,520,1065,48.83%,16.34%,1
新竹市,香山區,0297,121,278,399,35,434,776,55.93%,15.59%,1
新竹市,香山區,0298,154,335,489,26,515,890,57.87%,17.3%,1
新竹市,香山區,0299,127,319,446,22,468,896,52.23%,14.17%,1
嘉義市,東區,0001,207,362,569,22,591,1025,57.66%,20.2%,1
嘉義市,東區,0002,235,431,666,15,681,1276,53.37%,18.42%,1
嘉義市,東區,0003,137,332,469,30,499,974,51.23%,14.07%,1
嘉義市,東區,0004,224,466,690,32,722,1175,61.45%,19.06%,1
嘉義市,東區,0005,143,273,416,22,438,702,62.39%,20.37%,1
嘉義市,東區,0006,195,382,577,27,604,1092,55.31%,17.86%,1
嘉義市,東區,0007,145,316,461,21,482,1023,47.12%,14.17%,1
嘉義市,東區,0008,277,613,890,46,936,1816,51.54%,15.25%,1
嘉義市,東區,0009,370,659,1029,37,1066,1936,55.06%,19.11%,1
嘉義市,東區,0010,363,584,947,16,963,1698,56.71%,21.38%,1
嘉義市,東區,0011,248,454,702,19,721,1221,59.05%,20.31%,1
嘉義市,東區,0012,216,399,615,13,628,1113,56.42%,19.41%,1
嘉義市,東區,0013,278,528,806,23,829,1452,57.09%,19.15%,1
嘉義市,東區,0014,277,552,829,29,858,1395,61.51%,19.86%,1
嘉義市,東區,0015,243,459,702,42,744,1453,51.2%,16.72%,1
嘉義市,東區,0016,175,397,572,19,591,1094,54.02%,16%,1
嘉義市,東區,0017,236,534,770,30,800,1420,56.34%,16.62%,1
嘉義市,東區,0018,273,603,876,38,914,1552,58.89%,17.59%,1
嘉義市,東區,0019,296,547,843,48,891,1558,57.19%,19%,1
嘉義市,東區,0020,181,411,592,30,622,1062,58.57%,17.04%,1
嘉義市,東區,0021,174,438,612,39,651,1199,54.3%,14.51%,1
嘉義市,東區,0022,180,480,660,25,685,1236,55.42%,14.56%,1
嘉義市,東區,0023,151,323,474,18,492,890,55.28%,16.97%,1
嘉義市,東區,0024,153,353,506,29,535,880,60.8%,17.39%,1
嘉義市,東區,0025,230,416,646,14,660,1189,55.51%,19.34%,1
嘉義市,東區,0026,123,260,383,14,397,669,59.34%,18.39%,1
嘉義市,東區,0027,271,486,757,32,789,1435,54.98%,18.89%,1
嘉義市,東區,0028,265,522,787,28,815,1349,60.42%,19.64%,1
嘉義市,東區,0029,260,488,748,22,770,1455,52.92%,17.87%,1
嘉義市,東區,0030,163,347,510,24,534,915,58.36%,17.81%,1
嘉義市,東區,0031,174,340,514,22,536,952,56.3%,18.28%,1
嘉義市,東區,0032,153,335,488,43,531,941,56.43%,16.26%,1
嘉義市,東區,0033,208,349,557,25,582,1080,53.89%,19.26%,1
嘉義市,東區,0034,173,384,557,24,581,1157,50.22%,14.95%,1
嘉義市,東區,0035,214,370,584,25,609,1053,57.83%,20.32%,1
嘉義市,東區,0036,161,307,468,22,490,967,50.67%,16.65%,1
嘉義市,東區,0037,303,258,561,25,586,1091,53.71%,27.77%,1
嘉義市,東區,0038,160,386,546,31,577,961,60.04%,16.65%,1
嘉義市,東區,0039,111,224,335,20,355,863,41.14%,12.86%,1
嘉義市,東區,0040,188,385,573,41,614,1023,60.02%,18.38%,1
嘉義市,東區,0041,180,397,577,66,643,1078,59.65%,16.7%,1
嘉義市,東區,0042,167,324,491,16,507,938,54.05%,17.8%,1
嘉義市,東區,0043,182,381,563,20,583,1049,55.58%,17.35%,1
嘉義市,東區,0044,206,445,651,61,712,1360,52.35%,15.15%,1
嘉義市,東區,0045,273,465,738,63,801,1615,49.6%,16.9%,1
嘉義市,東區,0046,222,425,647,34,681,1267,53.75%,17.52%,1
嘉義市,東區,0047,215,499,714,50,764,1579,48.39%,13.62%,1
嘉義市,東區,0048,317,554,871,71,942,1831,51.45%,17.31%,1
嘉義市,東區,0049,164,382,546,26,572,977,58.55%,16.79%,1
嘉義市,東區,0050,208,390,598,28,626,1169,53.55%,17.79%,1
嘉義市,東區,0051,220,452,672,66,738,1238,59.61%,17.77%,1
嘉義市,東區,0052,221,471,692,18,710,1266,56.08%,17.46%,1
嘉義市,東區,0053,175,464,639,43,682,1429,47.73%,12.25%,1
嘉義市,東區,0054,215,485,700,14,714,1288,55.43%,16.69%,1
嘉義市,東區,0055,185,320,505,37,542,980,55.31%,18.88%,1
嘉義市,東區,0056,157,304,461,20,481,922,52.17%,17.03%,1
嘉義市,東區,0057,192,439,631,32,663,1133,58.52%,16.95%,1
嘉義市,東區,0058,231,422,653,42,695,1235,56.28%,18.7%,1
嘉義市,東區,0059,281,509,790,19,809,1525,53.05%,18.43%,1
嘉義市,東區,0060,198,364,562,44,606,1170,51.79%,16.92%,1
嘉義市,東區,0061,232,459,691,51,742,1177,63.04%,19.71%,1
嘉義市,東區,0062,197,436,633,50,683,1207,56.59%,16.32%,1
嘉義市,東區,0063,298,400,698,33,731,1272,57.47%,23.43%,1
嘉義市,東區,0064,193,416,609,67,676,1188,56.9%,16.25%,1
嘉義市,東區,0065,200,373,573,21,594,1172,50.68%,17.06%,1
嘉義市,東區,0066,191,369,560,42,602,1020,59.02%,18.73%,1
嘉義市,東區,0067,269,461,730,35,765,1332,57.43%,20.2%,1
嘉義市,東區,0068,211,377,588,35,623,1011,61.62%,20.87%,1
嘉義市,東區,0069,267,555,822,60,882,1682,52.44%,15.87%,1
嘉義市,東區,0070,260,551,811,52,863,1567,55.07%,16.59%,1
嘉義市,東區,0071,243,416,659,17,676,1207,56.01%,20.13%,1
嘉義市,東區,0072,183,388,571,21,592,981,60.35%,18.65%,1
嘉義市,東區,0073,268,450,718,32,750,1395,53.76%,19.21%,1
嘉義市,東區,0074,234,436,670,22,692,1434,48.26%,16.32%,1
嘉義市,東區,0075,231,396,627,18,645,1404,45.94%,16.45%,1
嘉義市,東區,0076,261,515,776,20,796,1428,55.74%,18.28%,1
嘉義市,東區,0077,270,495,765,18,783,1823,42.95%,14.81%,1
嘉義市,東區,0078,260,484,744,36,780,1570,49.68%,16.56%,1
嘉義市,東區,0079,215,426,641,48,689,1282,53.74%,16.77%,1
嘉義市,東區,0080,269,612,881,44,925,1571,58.88%,17.12%,1
嘉義市,東區,0081,262,508,770,25,795,1533,51.86%,17.09%,1
嘉義市,西區,0082,137,329,466,18,484,885,54.69%,15.48%,1
嘉義市,西區,0083,187,358,545,60,605,1109,54.55%,16.86%,1
嘉義市,西區,0084,146,345,491,44,535,1020,52.45%,14.31%,1
嘉義市,西區,0085,158,383,541,42,583,925,63.03%,17.08%,1
嘉義市,西區,0086,266,478,744,27,771,1671,46.14%,15.92%,1
嘉義市,西區,0087,212,445,657,22,679,1215,55.88%,17.45%,1
嘉義市,西區,0088,199,342,541,20,561,1036,54.15%,19.21%,1
嘉義市,西區,0089,190,365,555,28,583,1129,51.64%,16.83%,1
嘉義市,西區,0090,180,394,574,30,604,1127,53.59%,15.97%,1
嘉義市,西區,0091,275,478,753,42,795,1415,56.18%,19.43%,1
嘉義市,西區,0092,197,488,685,24,709,1366,51.9%,14.42%,1
嘉義市,西區,0093,178,419,597,48,645,1053,61.25%,16.9%,1
嘉義市,西區,0094,161,411,572,18,590,1067,55.3%,15.09%,1
嘉義市,西區,0095,231,502,733,28,761,1575,48.32%,14.67%,1
嘉義市,西區,0096,310,633,943,39,982,1865,52.65%,16.62%,1
嘉義市,西區,0097,206,387,593,31,624,1196,52.17%,17.22%,1
嘉義市,西區,0098,215,400,615,21,636,1280,49.69%,16.8%,1
嘉義市,西區,0099,268,566,834,44,878,1629,53.9%,16.45%,1
嘉義市,西區,0100,247,491,738,55,793,1393,56.93%,17.73%,1
嘉義市,西區,0101,200,409,609,39,648,1077,60.17%,18.57%,1
嘉義市,西區,0102,296,488,784,17,801,1694,47.28%,17.47%,1
嘉義市,西區,0103,173,275,448,78,526,841,62.54%,20.57%,1
嘉義市,西區,0104,182,405,587,4,591,1183,49.96%,15.38%,1
嘉義市,西區,0105,194,418,612,17,629,1000,62.9%,19.4%,1
嘉義市,西區,0106,203,431,634,22,656,1095,59.91%,18.54%,1
嘉義市,西區,0107,258,466,724,27,751,1256,59.79%,20.54%,1
嘉義市,西區,0108,169,350,519,43,562,962,58.42%,17.57%,1
嘉義市,西區,0109,188,358,546,10,556,865,64.28%,21.73%,1
嘉義市,西區,0110,203,564,767,53,820,1396,58.74%,14.54%,1
嘉義市,西區,0111,300,641,941,47,988,1799,54.92%,16.68%,1
嘉義市,西區,0112,223,519,742,20,762,1505,50.63%,14.82%,1
嘉義市,西區,0113,257,600,857,43,900,1698,53%,15.14%,1
嘉義市,西區,0114,289,688,977,28,1005,1854,54.21%,15.59%,1
嘉義市,西區,0115,225,452,677,9,686,1537,44.63%,14.64%,1
嘉義市,西區,0116,270,498,768,56,824,1604,51.37%,16.83%,1
嘉義市,西區,0117,163,388,551,48,599,944,63.45%,17.27%,1
嘉義市,西區,0118,251,625,876,55,931,1627,57.22%,15.43%,1
嘉義市,西區,0119,207,445,652,28,680,1144,59.44%,18.09%,1
嘉義市,西區,0120,217,486,703,45,748,1362,54.92%,15.93%,1
嘉義市,西區,0121,231,475,706,32,738,1279,57.7%,18.06%,1
嘉義市,西區,0122,266,626,892,54,946,1702,55.58%,15.63%,1
嘉義市,西區,0123,255,508,763,41,804,1358,59.2%,18.78%,1
嘉義市,西區,0124,234,526,760,72,832,1360,61.18%,17.21%,1
嘉義市,西區,0125,248,606,854,54,908,1589,57.14%,15.61%,1
嘉義市,西區,0126,217,513,730,35,765,1280,59.77%,16.95%,1
嘉義市,西區,0127,186,397,583,26,609,1220,49.92%,15.25%,1
嘉義市,西區,0128,199,468,667,23,690,1172,58.87%,16.98%,1
嘉義市,西區,0129,241,463,704,38,742,1320,56.21%,18.26%,1
嘉義市,西區,0130,243,494,737,29,766,1185,64.64%,20.51%,1
嘉義市,西區,0131,242,513,755,32,787,1278,61.58%,18.94%,1
嘉義市,西區,0132,210,396,606,25,631,1394,45.27%,15.06%,1
嘉義市,西區,0133,270,571,841,41,882,1540,57.27%,17.53%,1
嘉義市,西區,0134,263,548,811,63,874,1548,56.46%,16.99%,1
嘉義市,西區,0135,224,435,659,38,697,1295,53.82%,17.3%,1
嘉義市,西區,0136,225,528,753,44,797,1318,60.47%,17.07%,1
嘉義市,西區,0137,247,568,815,46,861,1545,55.73%,15.99%,1
嘉義市,西區,0138,144,215,359,21,380,736,51.63%,19.57%,1
嘉義市,西區,0139,174,409,583,28,611,1168,52.31%,14.9%,1
嘉義市,西區,0140,146,313,459,27,486,756,64.29%,19.31%,1
嘉義市,西區,0141,121,353,474,18,492,869,56.62%,13.92%,1
嘉義市,西區,0142,182,363,545,41,586,983,59.61%,18.51%,1
嘉義市,西區,0143,119,329,448,29,477,828,57.61%,14.37%,1
嘉義市,西區,0144,144,791,935,42,977,1775,55.04%,8.11%,1
嘉義市,西區,0145,185,550,735,31,766,1419,53.98%,13.04%,1
嘉義市,西區,0146,129,266,395,21,416,779,53.4%,16.56%,1
嘉義市,西區,0147,136,297,433,14,447,855,52.28%,15.91%,1
嘉義市,西區,0148,206,418,624,49,673,1146,58.73%,17.98%,1
嘉義市,西區,0149,169,433,602,34,636,1111,57.25%,15.21%,1
嘉義市,西區,0150,142,316,458,38,496,767,64.67%,18.51%,1
嘉義市,西區,0151,131,265,396,19,415,817,50.8%,16.03%,1
嘉義市,西區,0152,132,285,417,35,452,770,58.7%,17.14%,1
嘉義市,西區,0153,156,357,513,14,527,1135,46.43%,13.74%,1
嘉義市,西區,0154,150,243,393,63,456,835,54.61%,17.96%,1
嘉義市,西區,0155,154,392,546,32,578,1182,48.9%,13.03%,1
嘉義市,西區,0156,132,316,448,27,475,944,50.32%,13.98%,1
嘉義市,西區,0157,181,309,490,39,529,997,53.06%,18.15%,1
嘉義市,西區,0158,180,390,570,26,596,1074,55.49%,16.76%,1
嘉義市,西區,0159,235,410,645,16,661,1460,45.27%,16.1%,1
嘉義市,西區,0160,207,466,673,48,721,1352,53.33%,15.31%,1
嘉義市,西區,0161,273,500,773,37,810,1499,54.04%,18.21%,1
嘉義市,西區,0162,234,417,651,66,717,1262,56.81%,18.54%,1
嘉義市,西區,0163,214,461,675,25,700,1299,53.89%,16.47%,1
嘉義市,西區,0164,259,599,858,44,902,1734,52.02%,14.94%,1
嘉義市,西區,0165,234,561,795,28,823,1674,49.16%,13.98%,1
嘉義市,西區,0166,294,475,769,23,792,1540,51.43%,19.09%,1
嘉義市,西區,0167,189,426,615,17,632,1056,59.85%,17.9%,1
嘉義市,西區,0168,260,528,788,70,858,1467,58.49%,17.72%,1
嘉義市,西區,0169,226,463,689,56,745,1431,52.06%,15.79%,1
嘉義市,西區,0170,223,494,717,57,774,1234,62.72%,18.07%,1
嘉義市,西區,0171,211,444,655,22,677,1266,53.48%,16.67%,1
嘉義市,西區,0172,231,441,672,18,690,1211,56.98%,19.08%,1
嘉義市,西區,0173,208,422,630,14,644,1121,57.45%,18.55%,1
嘉義市,西區,0174,172,396,568,21,589,1155,51%,14.89%,1
嘉義市,西區,0175,269,559,828,77,905,1546,58.54%,17.4%,1
嘉義市,西區,0176,204,468,672,24,696,1322,52.65%,15.43%,1
嘉義市,西區,0177,231,578,809,76,885,1549,57.13%,14.91%,1
