縣市,鄉鎮市區,開票所,同意票,不同意票,有效票,無效票,投票數,投票權人數,投票率,投票權人數百分比,總數
臺北市,松山區,0527,491,421,912,42,954,1583,60.27%,31.02%,1
臺北市,松山區,0528,369,566,935,46,981,1691,58.01%,21.82%,1
臺北市,松山區,0529,239,507,746,46,792,1386,57.14%,17.24%,1
臺北市,松山區,0530,299,475,774,50,824,1362,60.5%,21.95%,1
臺北市,松山區,0531,318,485,803,42,845,1399,60.4%,22.73%,1
臺北市,松山區,0532,312,463,775,40,815,1324,61.56%,23.56%,1
臺北市,松山區,0533,317,476,793,38,831,1296,64.12%,24.46%,1
臺北市,松山區,0534,316,508,824,31,855,1386,61.69%,22.8%,1
臺北市,松山區,0535,245,669,914,62,976,1529,63.83%,16.02%,1
臺北市,松山區,0536,295,495,790,36,826,1416,58.33%,20.83%,1
臺北市,松山區,0537,358,503,861,43,904,1619,55.84%,22.11%,1
臺北市,松山區,0538,357,453,810,30,840,1386,60.61%,25.76%,1
臺北市,松山區,0539,374,489,863,28,891,1380,64.57%,27.1%,1
臺北市,松山區,0540,310,472,782,40,822,1357,60.57%,22.84%,1
臺北市,松山區,0541,299,486,785,28,813,1296,62.73%,23.07%,1
臺北市,松山區,0542,368,558,926,57,983,1632,60.23%,22.55%,1
臺北市,松山區,0543,315,477,792,39,831,1414,58.77%,22.28%,1
臺北市,松山區,0544,315,518,833,24,857,1404,61.04%,22.44%,1
臺北市,松山區,0545,266,527,793,58,851,1365,62.34%,19.49%,1
臺北市,松山區,0546,313,502,815,49,864,1431,60.38%,21.87%,1
臺北市,松山區,0547,345,530,875,32,907,1483,61.16%,23.26%,1
臺北市,松山區,0548,309,463,772,43,815,1293,63.03%,23.9%,1
臺北市,松山區,0549,306,469,775,32,807,1410,57.23%,21.7%,1
臺北市,松山區,0550,269,489,758,35,793,1307,60.67%,20.58%,1
臺北市,松山區,0551,304,455,759,32,791,1242,63.69%,24.48%,1
臺北市,松山區,0552,272,446,718,20,738,1192,61.91%,22.82%,1
臺北市,松山區,0553,276,494,770,36,806,1276,63.17%,21.63%,1
臺北市,松山區,0554,151,545,696,16,712,1201,59.28%,12.57%,1
臺北市,松山區,0555,289,479,768,31,799,1318,60.62%,21.93%,1
臺北市,松山區,0556,300,400,700,27,727,1157,62.83%,25.93%,1
臺北市,松山區,0557,248,404,652,20,672,1157,58.08%,21.43%,1
臺北市,松山區,0558,303,507,810,30,840,1357,61.9%,22.33%,1
臺北市,松山區,0559,249,381,630,28,658,1215,54.16%,20.49%,1
臺北市,松山區,0560,279,470,749,35,784,1345,58.29%,20.74%,1
臺北市,松山區,0561,272,425,697,52,749,1237,60.55%,21.99%,1
臺北市,松山區,0562,257,585,842,33,875,1393,62.81%,18.45%,1
臺北市,松山區,0563,355,470,825,39,864,1331,64.91%,26.67%,1
臺北市,松山區,0564,377,560,937,42,979,1550,63.16%,24.32%,1
臺北市,松山區,0565,202,522,724,15,739,1308,56.5%,15.44%,1
臺北市,松山區,0566,266,576,842,34,876,1490,58.79%,17.85%,1
臺北市,松山區,0567,313,554,867,27,894,1406,63.58%,22.26%,1
臺北市,松山區,0568,307,434,741,24,765,1191,64.23%,25.78%,1
臺北市,松山區,0569,246,386,632,35,667,1095,60.91%,22.47%,1
臺北市,松山區,0570,240,440,680,48,728,1198,60.77%,20.03%,1
臺北市,松山區,0571,268,447,715,37,752,1265,59.45%,21.19%,1
臺北市,松山區,0572,268,424,692,29,721,1225,58.86%,21.88%,1
臺北市,松山區,0573,387,611,998,55,1053,1698,62.01%,22.79%,1
臺北市,松山區,0574,316,671,987,30,1017,1819,55.91%,17.37%,1
臺北市,松山區,0575,400,607,1007,50,1057,1754,60.26%,22.81%,1
臺北市,松山區,0576,348,462,810,39,849,1361,62.38%,25.57%,1
臺北市,松山區,0577,278,444,722,23,745,1189,62.66%,23.38%,1
臺北市,松山區,0578,286,428,714,33,747,1214,61.53%,23.56%,1
臺北市,松山區,0579,317,424,741,31,772,1284,60.12%,24.69%,1
臺北市,松山區,0580,300,467,767,44,811,1297,62.53%,23.13%,1
臺北市,松山區,0581,302,458,760,30,790,1330,59.4%,22.71%,1
臺北市,松山區,0582,309,508,817,44,861,1396,61.68%,22.13%,1
臺北市,松山區,0583,276,543,819,27,846,1480,57.16%,18.65%,1
臺北市,松山區,0584,317,511,828,34,862,1419,60.75%,22.34%,1
臺北市,松山區,0585,314,492,806,42,848,1390,61.01%,22.59%,1
臺北市,松山區,0586,370,516,886,34,920,1525,60.33%,24.26%,1
臺北市,松山區,0587,348,510,858,46,904,1633,55.36%,21.31%,1
臺北市,松山區,0588,354,520,874,24,898,2677,33.55%,13.22%,1
臺北市,松山區,0589,316,415,731,49,780,1281,60.89%,24.67%,1
臺北市,松山區,0590,281,396,677,40,717,1469,48.81%,19.13%,1
臺北市,松山區,0591,455,467,922,63,985,1700,57.94%,26.76%,1
臺北市,松山區,0592,333,458,791,37,828,1503,55.09%,22.16%,1
臺北市,松山區,0593,317,413,730,33,763,1309,58.29%,24.22%,1
臺北市,松山區,0594,290,493,783,53,836,1376,60.76%,21.08%,1
臺北市,松山區,0595,356,584,940,27,967,1654,58.46%,21.52%,1
臺北市,松山區,0596,346,510,856,56,912,1601,56.96%,21.61%,1
臺北市,松山區,0597,331,529,860,25,885,1496,59.16%,22.13%,1
臺北市,松山區,0598,375,582,957,57,1014,1598,63.45%,23.47%,1
臺北市,松山區,0599,409,612,1021,39,1060,1751,60.54%,23.36%,1
臺北市,松山區,0600,324,606,930,40,970,1557,62.3%,20.81%,1
臺北市,松山區,0601,361,718,1079,27,1106,1686,65.6%,21.41%,1
臺北市,松山區,0602,267,743,1010,39,1049,1707,61.45%,15.64%,1
臺北市,松山區,0603,385,775,1160,36,1196,1854,64.51%,20.77%,1
臺北市,松山區,0604,366,597,963,33,996,1740,57.24%,21.03%,1
臺北市,松山區,0605,324,518,842,49,891,1494,59.64%,21.69%,1
臺北市,松山區,0606,328,508,836,41,877,1453,60.36%,22.57%,1
臺北市,松山區,0607,331,506,837,38,875,1458,60.01%,22.7%,1
臺北市,松山區,0608,378,487,865,35,900,1536,58.59%,24.61%,1
臺北市,松山區,0609,317,532,849,27,876,1463,59.88%,21.67%,1
臺北市,松山區,0610,378,554,932,27,959,1790,53.58%,21.12%,1
臺北市,松山區,0611,392,575,967,48,1015,1679,60.45%,23.35%,1
臺北市,松山區,0612,337,554,891,43,934,1785,52.32%,18.88%,1
臺北市,松山區,0613,391,581,972,46,1018,1793,56.78%,21.81%,1
臺北市,松山區,0614,284,497,781,42,823,1381,59.59%,20.56%,1
臺北市,松山區,0615,297,452,749,26,775,1279,60.59%,23.22%,1
臺北市,松山區,0616,367,579,946,63,1009,1681,60.02%,21.83%,1
臺北市,松山區,0617,305,437,742,37,779,1232,63.23%,24.76%,1
臺北市,松山區,0618,347,511,858,33,891,1533,58.12%,22.64%,1
臺北市,松山區,0619,365,547,912,38,950,1540,61.69%,23.7%,1
臺北市,松山區,0620,377,570,947,33,980,1716,57.11%,21.97%,1
臺北市,松山區,0621,375,517,892,30,922,1664,55.41%,22.54%,1
臺北市,松山區,0622,282,474,756,23,779,1350,57.7%,20.89%,1
臺北市,松山區,0623,381,626,1007,37,1044,1837,56.83%,20.74%,1
臺北市,松山區,0624,334,468,802,53,855,1558,54.88%,21.44%,1
臺北市,松山區,0625,319,517,836,43,879,1420,61.9%,22.46%,1
臺北市,松山區,0626,294,517,811,38,849,1474,57.6%,19.95%,1
臺北市,松山區,0627,326,529,855,58,913,1591,57.39%,20.49%,1
臺北市,松山區,0628,345,629,974,36,1010,1726,58.52%,19.99%,1
臺北市,松山區,0629,349,465,814,23,837,1452,57.64%,24.04%,1
臺北市,松山區,0630,338,481,819,29,848,1482,57.22%,22.81%,1
臺北市,松山區,0631,329,512,841,31,872,1460,59.73%,22.53%,1
臺北市,松山區,0632,464,297,761,48,809,1398,57.87%,33.19%,1
臺北市,松山區,0633,327,505,832,37,869,1423,61.07%,22.98%,1
臺北市,松山區,0634,261,454,715,23,738,1226,60.2%,21.29%,1
臺北市,松山區,0635,251,424,675,31,706,1158,60.97%,21.68%,1
臺北市,松山區,0636,332,460,792,32,824,1426,57.78%,23.28%,1
臺北市,松山區,0637,254,426,680,20,700,1177,59.47%,21.58%,1
臺北市,松山區,0638,320,434,754,38,792,1363,58.11%,23.48%,1
臺北市,松山區,0639,260,467,727,43,770,1240,62.1%,20.97%,1
臺北市,松山區,0640,314,501,815,36,851,1375,61.89%,22.84%,1
臺北市,松山區,0641,335,459,794,28,822,1377,59.69%,24.33%,1
臺北市,松山區,0642,251,412,663,26,689,1225,56.24%,20.49%,1
臺北市,松山區,0643,258,372,630,23,653,1017,64.21%,25.37%,1
臺北市,信義區,0644,281,492,773,32,805,2476,32.51%,11.35%,1
臺北市,信義區,0645,265,601,866,16,882,1381,63.87%,19.19%,1
臺北市,信義區,0646,275,505,780,37,817,1294,63.14%,21.25%,1
臺北市,信義區,0647,288,471,759,43,802,1351,59.36%,21.32%,1
臺北市,信義區,0648,267,486,753,23,776,1296,59.88%,20.6%,1
臺北市,信義區,0649,284,499,783,34,817,1302,62.75%,21.81%,1
臺北市,信義區,0650,188,345,533,53,586,1025,57.17%,18.34%,1
臺北市,信義區,0651,297,463,760,23,783,1421,55.1%,20.9%,1
臺北市,信義區,0652,315,505,820,36,856,1501,57.03%,20.99%,1
臺北市,信義區,0653,326,477,803,27,830,1575,52.7%,20.7%,1
臺北市,信義區,0654,329,523,852,28,880,1516,58.05%,21.7%,1
臺北市,信義區,0655,327,484,811,28,839,1382,60.71%,23.66%,1
臺北市,信義區,0656,235,389,624,37,661,1128,58.6%,20.83%,1
臺北市,信義區,0657,275,479,754,46,800,1397,57.27%,19.69%,1
臺北市,信義區,0658,270,417,687,40,727,1161,62.62%,23.26%,1
臺北市,信義區,0659,308,470,778,33,811,1368,59.28%,22.51%,1
臺北市,信義區,0660,233,384,617,15,632,1049,60.25%,22.21%,1
臺北市,信義區,0661,275,467,742,39,781,1308,59.71%,21.02%,1
臺北市,信義區,0662,281,412,693,38,731,1154,63.34%,24.35%,1
臺北市,信義區,0663,293,349,642,19,661,1078,61.32%,27.18%,1
臺北市,信義區,0664,299,479,778,36,814,1375,59.2%,21.75%,1
臺北市,信義區,0665,272,556,828,35,863,1448,59.6%,18.78%,1
臺北市,信義區,0666,287,458,745,16,761,1250,60.88%,22.96%,1
臺北市,信義區,0667,330,474,804,21,825,1381,59.74%,23.9%,1
臺北市,信義區,0668,271,441,712,37,749,1213,61.75%,22.34%,1
臺北市,信義區,0669,304,547,851,34,885,1373,64.46%,22.14%,1
臺北市,信義區,0670,264,461,725,29,754,1226,61.5%,21.53%,1
臺北市,信義區,0671,259,403,662,16,678,1117,60.7%,23.19%,1
臺北市,信義區,0672,257,412,669,35,704,1123,62.69%,22.89%,1
臺北市,信義區,0673,243,457,700,27,727,1200,60.58%,20.25%,1
臺北市,信義區,0674,259,430,689,23,712,1335,53.33%,19.4%,1
臺北市,信義區,0675,251,463,714,21,735,1332,55.18%,18.84%,1
臺北市,信義區,0676,33,593,626,57,683,1648,41.44%,2%,1
臺北市,信義區,0677,316,508,824,65,889,1542,57.65%,20.49%,1
臺北市,信義區,0678,272,401,673,62,735,1228,59.85%,22.15%,1
臺北市,信義區,0679,371,591,962,36,998,1731,57.65%,21.43%,1
臺北市,信義區,0680,319,490,809,33,842,1403,60.01%,22.74%,1
臺北市,信義區,0681,371,643,1014,60,1074,1929,55.68%,19.23%,1
臺北市,信義區,0682,302,461,763,36,799,1300,61.46%,23.23%,1
臺北市,信義區,0683,306,465,771,23,794,1486,53.43%,20.59%,1
臺北市,信義區,0684,308,437,745,42,787,1532,51.37%,20.1%,1
臺北市,信義區,0685,273,552,825,45,870,1387,62.73%,19.68%,1
臺北市,信義區,0686,223,393,616,44,660,1195,55.23%,18.66%,1
臺北市,信義區,0687,228,339,567,39,606,1068,56.74%,21.35%,1
臺北市,信義區,0688,250,411,661,35,696,1273,54.67%,19.64%,1
臺北市,信義區,0689,319,478,797,44,841,1329,63.28%,24%,1
臺北市,信義區,0690,285,414,699,40,739,1311,56.37%,21.74%,1
臺北市,信義區,0691,252,410,662,44,706,1258,56.12%,20.03%,1
臺北市,信義區,0692,311,407,718,56,774,1277,60.61%,24.35%,1
臺北市,信義區,0693,292,471,763,53,816,1285,63.5%,22.72%,1
臺北市,信義區,0694,284,421,705,38,743,1161,64%,24.46%,1
臺北市,信義區,0695,313,396,709,39,748,1299,57.58%,24.1%,1
臺北市,信義區,0696,253,429,682,36,718,1243,57.76%,20.35%,1
臺北市,信義區,0697,257,408,665,24,689,1197,57.56%,21.47%,1
臺北市,信義區,0698,310,452,762,23,785,1224,64.13%,25.33%,1
臺北市,信義區,0699,239,390,629,25,654,1147,57.02%,20.84%,1
臺北市,信義區,0700,256,359,615,13,628,1045,60.1%,24.5%,1
臺北市,信義區,0701,235,425,660,29,689,1096,62.86%,21.44%,1
臺北市,信義區,0702,256,369,625,17,642,1115,57.58%,22.96%,1
臺北市,信義區,0703,228,382,610,38,648,1117,58.01%,20.41%,1
臺北市,信義區,0704,233,285,518,21,539,1019,52.89%,22.87%,1
臺北市,信義區,0705,283,473,756,42,798,1346,59.29%,21.03%,1
臺北市,信義區,0706,298,488,786,21,807,1405,57.44%,21.21%,1
臺北市,信義區,0707,288,479,767,34,801,1356,59.07%,21.24%,1
臺北市,信義區,0708,299,483,782,26,808,1250,64.64%,23.92%,1
臺北市,信義區,0709,484,261,745,31,776,1254,61.88%,38.6%,1
臺北市,信義區,0710,304,439,743,24,767,1317,58.24%,23.08%,1
臺北市,信義區,0711,285,483,768,45,813,1271,63.97%,22.42%,1
臺北市,信義區,0712,203,324,527,33,560,979,57.2%,20.74%,1
臺北市,信義區,0713,208,332,540,35,575,1025,56.1%,20.29%,1
臺北市,信義區,0714,296,452,748,23,771,1512,50.99%,19.58%,1
臺北市,信義區,0715,348,511,859,32,891,1483,60.08%,23.47%,1
臺北市,信義區,0716,321,489,810,26,836,1359,61.52%,23.62%,1
臺北市,信義區,0717,302,534,836,14,850,1387,61.28%,21.77%,1
臺北市,信義區,0718,306,486,792,24,816,1455,56.08%,21.03%,1
臺北市,信義區,0719,330,498,828,26,854,1461,58.45%,22.59%,1
臺北市,信義區,0720,335,538,873,42,915,1532,59.73%,21.87%,1
臺北市,信義區,0721,274,362,636,36,672,1043,64.43%,26.27%,1
臺北市,信義區,0722,206,317,523,32,555,875,63.43%,23.54%,1
臺北市,信義區,0723,198,322,520,17,537,927,57.93%,21.36%,1
臺北市,信義區,0724,247,392,639,48,687,1119,61.39%,22.07%,1
臺北市,信義區,0725,307,495,802,52,854,1463,58.37%,20.98%,1
臺北市,信義區,0726,325,464,789,43,832,1293,64.35%,25.14%,1
臺北市,信義區,0727,327,514,841,43,884,1553,56.92%,21.06%,1
臺北市,信義區,0728,321,423,744,25,769,1360,56.54%,23.6%,1
臺北市,信義區,0729,329,466,795,38,833,1392,59.84%,23.64%,1
臺北市,信義區,0730,293,503,796,14,810,1377,58.82%,21.28%,1
臺北市,信義區,0731,329,461,790,18,808,1377,58.68%,23.89%,1
臺北市,信義區,0732,246,407,653,30,683,1269,53.82%,19.39%,1
臺北市,信義區,0733,277,511,788,65,853,1407,60.63%,19.69%,1
臺北市,信義區,0734,248,404,652,40,692,1172,59.04%,21.16%,1
臺北市,信義區,0735,246,429,675,25,700,1182,59.22%,20.81%,1
臺北市,信義區,0736,273,445,718,39,757,1255,60.32%,21.75%,1
臺北市,信義區,0737,333,547,880,32,912,1689,54%,19.72%,1
臺北市,信義區,0738,318,547,865,23,888,1605,55.33%,19.81%,1
臺北市,信義區,0739,187,444,631,25,656,1143,57.39%,16.36%,1
臺北市,信義區,0740,289,457,746,35,781,1440,54.24%,20.07%,1
臺北市,信義區,0741,294,524,818,41,859,1495,57.46%,19.67%,1
臺北市,信義區,0742,280,585,865,50,915,1514,60.44%,18.49%,1
臺北市,信義區,0743,286,495,781,33,814,1449,56.18%,19.74%,1
臺北市,信義區,0744,311,502,813,45,858,1401,61.24%,22.2%,1
臺北市,信義區,0745,249,393,642,16,658,1181,55.72%,21.08%,1
臺北市,信義區,0746,317,539,856,15,871,1376,63.3%,23.04%,1
臺北市,信義區,0747,269,562,831,44,875,1422,61.53%,18.92%,1
臺北市,信義區,0748,254,460,714,24,738,1267,58.25%,20.05%,1
臺北市,信義區,0749,275,382,657,13,670,1220,54.92%,22.54%,1
臺北市,信義區,0750,283,515,798,27,825,1562,52.82%,18.12%,1
臺北市,信義區,0751,340,470,810,22,832,1455,57.18%,23.37%,1
臺北市,信義區,0752,324,534,858,33,891,1605,55.51%,20.19%,1
臺北市,信義區,0753,354,636,990,25,1015,1626,62.42%,21.77%,1
臺北市,信義區,0754,377,529,906,35,941,1561,60.28%,24.15%,1
臺北市,信義區,0755,275,467,742,24,766,1547,49.52%,17.78%,1
臺北市,信義區,0756,286,454,740,28,768,1336,57.49%,21.41%,1
臺北市,信義區,0757,251,392,643,42,685,1314,52.13%,19.1%,1
臺北市,信義區,0758,259,431,690,27,717,1297,55.28%,19.97%,1
臺北市,信義區,0759,251,473,724,43,767,1366,56.15%,18.37%,1
臺北市,信義區,0760,314,482,796,57,853,1472,57.95%,21.33%,1
臺北市,信義區,0761,287,516,803,41,844,1450,58.21%,19.79%,1
臺北市,信義區,0762,280,445,725,49,774,1328,58.28%,21.08%,1
臺北市,信義區,0763,308,503,811,46,857,1399,61.26%,22.02%,1
臺北市,信義區,0764,308,487,795,53,848,1373,61.76%,22.43%,1
臺北市,信義區,0765,196,406,602,13,615,1099,55.96%,17.83%,1
臺北市,信義區,0766,266,409,675,37,712,1226,58.08%,21.7%,1
臺北市,信義區,0767,251,428,679,21,700,1267,55.25%,19.81%,1
臺北市,信義區,0768,249,576,825,48,873,1531,57.02%,16.26%,1
臺北市,信義區,0769,275,560,835,40,875,1438,60.85%,19.12%,1
臺北市,信義區,0770,342,557,899,20,919,1657,55.46%,20.64%,1
臺北市,信義區,0771,346,574,920,43,963,1621,59.41%,21.34%,1
臺北市,信義區,0772,343,512,855,24,879,1508,58.29%,22.75%,1
臺北市,信義區,0773,309,468,777,31,808,1334,60.57%,23.16%,1
臺北市,信義區,0774,205,357,562,32,594,1246,47.67%,16.45%,1
臺北市,信義區,0775,295,439,734,29,763,1196,63.8%,24.67%,1
臺北市,信義區,0776,286,429,715,23,738,1220,60.49%,23.44%,1
臺北市,信義區,0777,311,528,839,25,864,1538,56.18%,20.22%,1
臺北市,信義區,0778,338,547,885,54,939,1565,60%,21.6%,1
臺北市,信義區,0779,313,505,818,62,880,1621,54.29%,19.31%,1
臺北市,信義區,0780,307,487,794,45,839,1486,56.46%,20.66%,1
臺北市,信義區,0781,306,479,785,33,818,1507,54.28%,20.31%,1
臺北市,信義區,0782,330,531,861,40,901,1516,59.43%,21.77%,1
臺北市,信義區,0783,258,496,754,50,804,1287,62.47%,20.05%,1
臺北市,信義區,0784,189,332,521,41,562,1050,53.52%,18%,1
臺北市,信義區,0785,122,345,467,31,498,801,62.17%,15.23%,1
臺北市,大安區,1214,241,388,629,23,652,1184,55.07%,20.35%,1
臺北市,大安區,1215,222,407,629,31,660,1197,55.14%,18.55%,1
臺北市,大安區,1216,264,429,693,20,713,1221,58.39%,21.62%,1
臺北市,大安區,1217,267,455,722,24,746,1246,59.87%,21.43%,1
臺北市,大安區,1218,362,487,849,29,878,1478,59.4%,24.49%,1
臺北市,大安區,1219,319,390,709,49,758,1314,57.69%,24.28%,1
臺北市,大安區,1220,370,554,924,37,961,1594,60.29%,23.21%,1
臺北市,大安區,1221,340,489,829,28,857,1429,59.97%,23.79%,1
臺北市,大安區,1222,313,545,858,27,885,1452,60.95%,21.56%,1
臺北市,大安區,1223,377,505,882,22,904,1551,58.28%,24.31%,1
臺北市,大安區,1224,288,492,780,32,812,1335,60.82%,21.57%,1
臺北市,大安區,1225,253,385,638,23,661,1196,55.27%,21.15%,1
臺北市,大安區,1226,283,427,710,24,734,1339,54.82%,21.14%,1
臺北市,大安區,1227,356,453,809,20,829,1448,57.25%,24.59%,1
臺北市,大安區,1228,286,482,768,28,796,1373,57.98%,20.83%,1
臺北市,大安區,1229,302,495,797,45,842,1439,58.51%,20.99%,1
臺北市,大安區,1230,249,375,624,12,636,1174,54.17%,21.21%,1
臺北市,大安區,1231,211,382,593,24,617,1144,53.93%,18.44%,1
臺北市,大安區,1232,165,407,572,29,601,1119,53.71%,14.75%,1
臺北市,大安區,1233,181,300,481,25,506,1024,49.41%,17.68%,1
臺北市,大安區,1234,205,411,616,12,628,1032,60.85%,19.86%,1
臺北市,大安區,1235,224,539,763,28,791,1319,59.97%,16.98%,1
臺北市,大安區,1236,311,507,818,28,846,1369,61.8%,22.72%,1
臺北市,大安區,1237,332,430,762,41,803,1347,59.61%,24.65%,1
臺北市,大安區,1238,361,483,844,24,868,1655,52.45%,21.81%,1
臺北市,大安區,1239,287,507,794,21,815,1595,51.1%,17.99%,1
臺北市,大安區,1240,296,462,758,28,786,1429,55%,20.71%,1
臺北市,大安區,1241,269,413,682,21,703,1309,53.71%,20.55%,1
臺北市,大安區,1242,298,507,805,21,826,1508,54.77%,19.76%,1
臺北市,大安區,1243,307,390,697,31,728,1310,55.57%,23.44%,1
臺北市,大安區,1244,245,387,632,25,657,1233,53.28%,19.87%,1
臺北市,大安區,1245,272,390,662,33,695,1287,54%,21.13%,1
臺北市,大安區,1246,231,355,586,29,615,1147,53.62%,20.14%,1
臺北市,大安區,1247,241,416,657,22,679,1260,53.89%,19.13%,1
臺北市,大安區,1248,257,470,727,31,758,1377,55.05%,18.66%,1
臺北市,大安區,1249,281,391,672,44,716,1284,55.76%,21.88%,1
臺北市,大安區,1250,256,415,671,27,698,1314,53.12%,19.48%,1
臺北市,大安區,1251,258,392,650,28,678,1273,53.26%,20.27%,1
臺北市,大安區,1252,288,372,660,19,679,1146,59.25%,25.13%,1
臺北市,大安區,1253,294,454,748,18,766,1285,59.61%,22.88%,1
臺北市,大安區,1254,333,443,776,20,796,1297,61.37%,25.67%,1
臺北市,大安區,1255,259,398,657,21,678,1101,61.58%,23.52%,1
臺北市,大安區,1256,305,411,716,43,759,1310,57.94%,23.28%,1
臺北市,大安區,1257,320,478,798,44,842,1365,61.68%,23.44%,1
臺北市,大安區,1258,310,453,763,28,791,1372,57.65%,22.59%,1
臺北市,大安區,1259,294,410,704,27,731,1189,61.48%,24.73%,1
臺北市,大安區,1260,296,439,735,25,760,1256,60.51%,23.57%,1
臺北市,大安區,1261,275,380,655,40,695,1151,60.38%,23.89%,1
臺北市,大安區,1262,365,542,907,27,934,1501,62.23%,24.32%,1
臺北市,大安區,1263,382,519,901,23,924,1520,60.79%,25.13%,1
臺北市,大安區,1264,354,568,922,36,958,1529,62.66%,23.15%,1
臺北市,大安區,1265,383,544,927,30,957,1579,60.61%,24.26%,1
臺北市,大安區,1266,264,400,664,18,682,2619,26.04%,10.08%,1
臺北市,大安區,1267,283,450,733,23,756,1290,58.6%,21.94%,1
臺北市,大安區,1268,317,478,795,22,817,1307,62.51%,24.25%,1
臺北市,大安區,1269,375,512,887,29,916,1489,61.52%,25.18%,1
臺北市,大安區,1270,268,389,657,28,685,1097,62.44%,24.43%,1
臺北市,大安區,1271,322,434,756,24,780,1328,58.73%,24.25%,1
臺北市,大安區,1272,277,394,671,17,688,1189,57.86%,23.3%,1
臺北市,大安區,1273,302,436,738,15,753,1270,59.29%,23.78%,1
臺北市,大安區,1274,339,433,772,16,788,1349,58.41%,25.13%,1
臺北市,大安區,1275,295,414,709,24,733,1292,56.73%,22.83%,1
臺北市,大安區,1276,309,468,777,35,812,1314,61.8%,23.52%,1
臺北市,大安區,1277,289,414,703,31,734,1200,61.17%,24.08%,1
臺北市,大安區,1278,346,518,864,40,904,1558,58.02%,22.21%,1
臺北市,大安區,1279,338,532,870,28,898,1561,57.53%,21.65%,1
臺北市,大安區,1280,314,509,823,39,862,1446,59.61%,21.72%,1
臺北市,大安區,1281,344,525,869,25,894,1499,59.64%,22.95%,1
臺北市,大安區,1282,300,539,839,25,864,1467,58.9%,20.45%,1
臺北市,大安區,1283,314,513,827,29,856,1511,56.65%,20.78%,1
臺北市,大安區,1284,353,568,921,44,965,1600,60.31%,22.06%,1
臺北市,大安區,1285,345,571,916,25,941,1573,59.82%,21.93%,1
臺北市,大安區,1286,352,536,888,33,921,1467,62.78%,23.99%,1
臺北市,大安區,1287,282,490,772,34,806,1358,59.35%,20.77%,1
臺北市,大安區,1288,338,533,871,35,906,1568,57.78%,21.56%,1
臺北市,大安區,1289,333,483,816,33,849,1411,60.17%,23.6%,1
臺北市,大安區,1290,331,532,863,16,879,1554,56.56%,21.3%,1
臺北市,大安區,1291,308,485,793,34,827,1345,61.49%,22.9%,1
臺北市,大安區,1292,332,496,828,14,842,1435,58.68%,23.14%,1
臺北市,大安區,1293,327,579,906,22,928,1481,62.66%,22.08%,1
臺北市,大安區,1294,302,603,905,27,932,1451,64.23%,20.81%,1
臺北市,大安區,1295,342,546,888,48,936,1566,59.77%,21.84%,1
臺北市,大安區,1296,337,542,879,24,903,1525,59.21%,22.1%,1
臺北市,大安區,1297,282,460,742,33,775,1336,58.01%,21.11%,1
臺北市,大安區,1298,309,533,842,47,889,1483,59.95%,20.84%,1
臺北市,大安區,1299,285,427,712,22,734,1396,52.58%,20.42%,1
臺北市,大安區,1300,350,476,826,41,867,1406,61.66%,24.89%,1
臺北市,大安區,1301,327,511,838,27,865,1434,60.32%,22.8%,1
臺北市,大安區,1302,270,450,720,35,755,1288,58.62%,20.96%,1
臺北市,大安區,1303,305,499,804,36,840,1407,59.7%,21.68%,1
臺北市,大安區,1304,309,497,806,27,833,1514,55.02%,20.41%,1
臺北市,大安區,1305,261,465,726,50,776,1550,50.06%,16.84%,1
臺北市,大安區,1306,302,534,836,39,875,1490,58.72%,20.27%,1
臺北市,大安區,1307,302,404,706,23,729,1284,56.78%,23.52%,1
臺北市,大安區,1308,251,413,664,19,683,1129,60.5%,22.23%,1
臺北市,大安區,1309,268,422,690,20,710,1193,59.51%,22.46%,1
臺北市,大安區,1310,215,362,577,25,602,1057,56.95%,20.34%,1
臺北市,大安區,1311,319,432,751,32,783,1361,57.53%,23.44%,1
臺北市,大安區,1312,265,485,750,47,797,1412,56.44%,18.77%,1
臺北市,大安區,1313,285,381,666,22,688,1423,48.35%,20.03%,1
臺北市,大安區,1314,272,396,668,69,737,1257,58.63%,21.64%,1
臺北市,大安區,1315,227,448,675,28,703,1133,62.05%,20.04%,1
臺北市,大安區,1316,249,355,604,27,631,1077,58.59%,23.12%,1
臺北市,大安區,1317,299,450,749,35,784,1300,60.31%,23%,1
臺北市,大安區,1318,285,498,783,39,822,1319,62.32%,21.61%,1
臺北市,大安區,1319,255,438,693,61,754,1265,59.6%,20.16%,1
臺北市,大安區,1320,235,421,656,32,688,1265,54.39%,18.58%,1
臺北市,大安區,1321,245,394,639,29,668,1103,60.56%,22.21%,1
臺北市,大安區,1322,312,472,784,26,810,1341,60.4%,23.27%,1
臺北市,大安區,1323,281,510,791,36,827,1357,60.94%,20.71%,1
臺北市,大安區,1324,284,435,719,32,751,1260,59.6%,22.54%,1
臺北市,大安區,1325,315,427,742,31,773,1295,59.69%,24.32%,1
臺北市,大安區,1326,302,429,731,23,754,1399,53.9%,21.59%,1
臺北市,大安區,1327,246,389,635,30,665,1150,57.83%,21.39%,1
臺北市,大安區,1328,278,416,694,17,711,1351,52.63%,20.58%,1
臺北市,大安區,1329,313,442,755,39,794,1341,59.21%,23.34%,1
臺北市,大安區,1330,207,405,612,16,628,1129,55.62%,18.33%,1
臺北市,大安區,1331,252,471,723,39,762,1328,57.38%,18.98%,1
臺北市,大安區,1332,307,655,962,28,990,1557,63.58%,19.72%,1
臺北市,大安區,1333,322,572,894,32,926,1461,63.38%,22.04%,1
臺北市,大安區,1334,300,500,800,25,825,1589,51.92%,18.88%,1
臺北市,大安區,1335,280,531,811,21,832,1473,56.48%,19.01%,1
臺北市,大安區,1336,329,470,799,38,837,1479,56.59%,22.24%,1
臺北市,大安區,1337,163,331,494,30,524,833,62.91%,19.57%,1
臺北市,大安區,1338,205,338,543,29,572,999,57.26%,20.52%,1
臺北市,大安區,1339,389,629,1018,31,1049,1757,59.7%,22.14%,1
臺北市,大安區,1340,320,589,909,36,945,1573,60.08%,20.34%,1
臺北市,大安區,1341,375,572,947,35,982,1587,61.88%,23.63%,1
臺北市,大安區,1342,348,530,878,36,914,1496,61.1%,23.26%,1
臺北市,大安區,1343,384,457,841,28,869,1440,60.35%,26.67%,1
臺北市,大安區,1344,370,553,923,40,963,1578,61.03%,23.45%,1
臺北市,大安區,1345,301,413,714,15,729,1223,59.61%,24.61%,1
臺北市,大安區,1346,296,354,650,18,668,1119,59.7%,26.45%,1
臺北市,大安區,1347,307,450,757,15,772,1252,61.66%,24.52%,1
臺北市,大安區,1348,377,536,913,34,947,1576,60.09%,23.92%,1
臺北市,大安區,1349,307,489,796,29,825,1425,57.89%,21.54%,1
臺北市,大安區,1350,317,464,781,17,798,1450,55.03%,21.86%,1
臺北市,大安區,1351,200,516,716,31,747,1444,51.73%,13.85%,1
臺北市,大安區,1352,344,474,818,30,848,1337,63.43%,25.73%,1
臺北市,大安區,1353,299,479,778,20,798,1417,56.32%,21.1%,1
臺北市,大安區,1354,258,432,690,41,731,1250,58.48%,20.64%,1
臺北市,大安區,1355,252,405,657,27,684,1176,58.16%,21.43%,1
臺北市,大安區,1356,274,476,750,36,786,1257,62.53%,21.8%,1
臺北市,大安區,1357,246,448,694,39,733,1257,58.31%,19.57%,1
臺北市,大安區,1358,267,390,657,28,685,1148,59.67%,23.26%,1
臺北市,大安區,1359,305,476,781,35,816,1418,57.55%,21.51%,1
臺北市,大安區,1360,226,345,571,23,594,1028,57.78%,21.98%,1
臺北市,大安區,1361,356,484,840,29,869,1445,60.14%,24.64%,1
臺北市,大安區,1362,321,458,779,36,815,1361,59.88%,23.59%,1
臺北市,大安區,1363,268,527,795,33,828,1343,61.65%,19.96%,1
臺北市,大安區,1364,287,430,717,39,756,1267,59.67%,22.65%,1
臺北市,大安區,1365,300,441,741,24,765,1380,55.43%,21.74%,1
臺北市,大安區,1366,307,523,830,37,867,1524,56.89%,20.14%,1
臺北市,大安區,1367,319,531,850,29,879,1470,59.8%,21.7%,1
臺北市,大安區,1368,240,412,652,48,700,1318,53.11%,18.21%,1
臺北市,大安區,1369,297,449,746,33,779,1430,54.48%,20.77%,1
臺北市,大安區,1370,292,476,768,34,802,1386,57.86%,21.07%,1
臺北市,大安區,1371,278,472,750,25,775,1438,53.89%,19.33%,1
臺北市,大安區,1372,236,412,648,22,670,1270,52.76%,18.58%,1
臺北市,大安區,1373,290,451,741,40,781,1395,55.99%,20.79%,1
臺北市,大安區,1374,253,469,722,23,745,1292,57.66%,19.58%,1
臺北市,大安區,1375,303,399,702,34,736,1310,56.18%,23.13%,1
臺北市,大安區,1376,270,456,726,32,758,1319,57.47%,20.47%,1
臺北市,大安區,1377,309,455,764,25,789,1355,58.23%,22.8%,1
臺北市,大安區,1378,261,432,693,18,711,1312,54.19%,19.89%,1
臺北市,大安區,1379,282,452,734,27,761,1335,57%,21.12%,1
臺北市,大安區,1380,296,471,767,29,796,1489,53.46%,19.88%,1
臺北市,大安區,1381,291,455,746,24,770,1307,58.91%,22.26%,1
臺北市,大安區,1382,251,430,681,21,702,1328,52.86%,18.9%,1
臺北市,大安區,1383,269,418,687,7,694,1277,54.35%,21.06%,1
臺北市,大安區,1384,296,433,729,32,761,1314,57.91%,22.53%,1
臺北市,大安區,1385,291,446,737,31,768,1270,60.47%,22.91%,1
臺北市,大安區,1386,302,420,722,39,761,1308,58.18%,23.09%,1
臺北市,大安區,1387,272,395,667,20,687,1138,60.37%,23.9%,1
臺北市,大安區,1388,268,446,714,31,745,1333,55.89%,20.11%,1
臺北市,大安區,1389,275,383,658,30,688,1176,58.5%,23.38%,1
臺北市,大安區,1390,275,443,718,40,758,1311,57.82%,20.98%,1
臺北市,大安區,1391,227,475,702,20,722,1295,55.75%,17.53%,1
臺北市,大安區,1392,289,505,794,41,835,1421,58.76%,20.34%,1
臺北市,大安區,1393,284,467,751,32,783,1409,55.57%,20.16%,1
臺北市,大安區,1394,301,506,807,34,841,1434,58.65%,20.99%,1
臺北市,大安區,1395,285,438,723,59,782,1449,53.97%,19.67%,1
臺北市,大安區,1396,298,438,736,24,760,1284,59.19%,23.21%,1
臺北市,大安區,1397,269,429,698,19,717,1248,57.45%,21.55%,1
臺北市,大安區,1398,273,445,718,22,740,1119,66.13%,24.4%,1
臺北市,大安區,1399,196,315,511,27,538,883,60.93%,22.2%,1
臺北市,大安區,1400,92,231,323,39,362,630,57.46%,14.6%,1
臺北市,大安區,1401,183,267,450,34,484,814,59.46%,22.48%,1
臺北市,中山區,0786,351,501,852,33,885,1522,58.15%,23.06%,1
臺北市,中山區,0787,297,522,819,26,845,1332,63.44%,22.3%,1
臺北市,中山區,0788,341,457,798,40,838,1656,50.6%,20.59%,1
臺北市,中山區,0789,280,394,674,35,709,1367,51.87%,20.48%,1
臺北市,中山區,0790,351,503,854,36,890,1732,51.39%,20.27%,1
臺北市,中山區,0791,359,533,892,44,936,1634,57.28%,21.97%,1
臺北市,中山區,0792,355,495,850,45,895,1650,54.24%,21.52%,1
臺北市,中山區,0793,312,479,791,33,824,1392,59.2%,22.41%,1
臺北市,中山區,0794,300,401,701,29,730,1177,62.02%,25.49%,1
臺北市,中山區,0795,357,489,846,41,887,1477,60.05%,24.17%,1
臺北市,中山區,0796,234,308,542,39,581,1063,54.66%,22.01%,1
臺北市,中山區,0797,243,445,688,31,719,1296,55.48%,18.75%,1
臺北市,中山區,0798,271,409,680,35,715,1330,53.76%,20.38%,1
臺北市,中山區,0799,290,465,755,49,804,1483,54.21%,19.55%,1
臺北市,中山區,0800,342,453,795,27,822,1542,53.31%,22.18%,1
臺北市,中山區,0801,348,492,840,50,890,1710,52.05%,20.35%,1
臺北市,中山區,0802,261,405,666,22,688,1315,52.32%,19.85%,1
臺北市,中山區,0803,246,405,651,50,701,1245,56.31%,19.76%,1
臺北市,中山區,0804,216,425,641,38,679,1262,53.8%,17.12%,1
臺北市,中山區,0805,352,480,832,53,885,1518,58.3%,23.19%,1
臺北市,中山區,0806,325,499,824,56,880,1522,57.82%,21.35%,1
臺北市,中山區,0807,311,478,789,42,831,1580,52.59%,19.68%,1
臺北市,中山區,0808,390,498,888,30,918,1529,60.04%,25.51%,1
臺北市,中山區,0809,279,375,654,34,688,1221,56.35%,22.85%,1
臺北市,中山區,0810,291,412,703,26,729,1221,59.71%,23.83%,1
臺北市,中山區,0811,217,332,549,27,576,1139,50.57%,19.05%,1
臺北市,中山區,0812,284,461,745,59,804,1407,57.14%,20.18%,1
臺北市,中山區,0813,322,406,728,30,758,1321,57.38%,24.38%,1
臺北市,中山區,0814,295,476,771,24,795,1578,50.38%,18.69%,1
臺北市,中山區,0815,312,537,849,40,889,1739,51.12%,17.94%,1
臺北市,中山區,0816,325,496,821,38,859,1637,52.47%,19.85%,1
臺北市,中山區,0817,327,465,792,49,841,1541,54.57%,21.22%,1
臺北市,中山區,0818,269,415,684,36,720,1210,59.5%,22.23%,1
臺北市,中山區,0819,299,405,704,33,737,1331,55.37%,22.46%,1
臺北市,中山區,0820,256,354,610,41,651,1224,53.19%,20.92%,1
臺北市,中山區,0821,312,556,868,43,911,1585,57.48%,19.68%,1
臺北市,中山區,0822,336,553,889,61,950,1523,62.38%,22.06%,1
臺北市,中山區,0823,313,479,792,36,828,1368,60.53%,22.88%,1
臺北市,中山區,0824,287,703,990,53,1043,1805,57.78%,15.9%,1
臺北市,中山區,0825,238,569,807,23,830,1404,59.12%,16.95%,1
臺北市,中山區,0826,432,591,1023,39,1062,1708,62.18%,25.29%,1
臺北市,中山區,0827,360,518,878,37,915,1451,63.06%,24.81%,1
臺北市,中山區,0828,380,604,984,59,1043,1684,61.94%,22.57%,1
臺北市,中山區,0829,306,567,873,20,893,1585,56.34%,19.31%,1
臺北市,中山區,0830,297,471,768,73,841,1391,60.46%,21.35%,1
臺北市,中山區,0831,328,539,867,49,916,1375,66.62%,23.85%,1
臺北市,中山區,0832,359,526,885,16,901,1472,61.21%,24.39%,1
臺北市,中山區,0833,282,435,717,22,739,1327,55.69%,21.25%,1
臺北市,中山區,0834,321,488,809,20,829,1401,59.17%,22.91%,1
臺北市,中山區,0835,301,511,812,34,846,1423,59.45%,21.15%,1
臺北市,中山區,0836,367,537,904,25,929,1569,59.21%,23.39%,1
臺北市,中山區,0837,361,557,918,19,937,1651,56.75%,21.87%,1
臺北市,中山區,0838,487,394,881,26,907,1624,55.85%,29.99%,1
臺北市,中山區,0839,432,575,1007,44,1051,1713,61.35%,25.22%,1
臺北市,中山區,0840,366,583,949,41,990,1647,60.11%,22.22%,1
臺北市,中山區,0841,363,565,928,30,958,1762,54.37%,20.6%,1
臺北市,中山區,0842,370,462,832,33,865,1399,61.83%,26.45%,1
臺北市,中山區,0843,337,558,895,32,927,1489,62.26%,22.63%,1
臺北市,中山區,0844,286,477,763,23,786,1269,61.94%,22.54%,1
臺北市,中山區,0845,188,408,596,27,623,998,62.42%,18.84%,1
臺北市,中山區,0846,322,463,785,44,829,1472,56.32%,21.88%,1
臺北市,中山區,0847,335,433,768,53,821,1517,54.12%,22.08%,1
臺北市,中山區,0848,357,621,978,50,1028,1704,60.33%,20.95%,1
臺北市,中山區,0849,380,523,903,41,944,1603,58.89%,23.71%,1
臺北市,中山區,0850,272,459,731,64,795,1432,55.52%,18.99%,1
臺北市,中山區,0851,349,494,843,66,909,1500,60.6%,23.27%,1
臺北市,中山區,0852,302,478,780,33,813,1332,61.04%,22.67%,1
臺北市,中山區,0853,330,516,846,44,890,1450,61.38%,22.76%,1
臺北市,中山區,0854,358,483,841,35,876,1434,61.09%,24.97%,1
臺北市,中山區,0855,276,481,757,33,790,1419,55.67%,19.45%,1
臺北市,中山區,0856,278,423,701,31,732,1292,56.66%,21.52%,1
臺北市,中山區,0857,344,466,810,39,849,1526,55.64%,22.54%,1
臺北市,中山區,0858,313,429,742,40,782,1582,49.43%,19.79%,1
臺北市,中山區,0859,333,455,788,44,832,1588,52.39%,20.97%,1
臺北市,中山區,0860,290,506,796,59,855,1463,58.44%,19.82%,1
臺北市,中山區,0861,326,429,755,45,800,1533,52.19%,21.27%,1
臺北市,中山區,0862,117,390,507,36,543,944,57.52%,12.39%,1
臺北市,中山區,0863,394,643,1037,50,1087,1745,62.29%,22.58%,1
臺北市,中山區,0864,355,453,808,37,845,1679,50.33%,21.14%,1
臺北市,中山區,0865,326,453,779,35,814,3419,23.81%,9.53%,1
臺北市,中山區,0866,337,449,786,50,836,1387,60.27%,24.3%,1
臺北市,中山區,0867,380,596,976,49,1025,1672,61.3%,22.73%,1
臺北市,中山區,0868,290,437,727,48,775,1319,58.76%,21.99%,1
臺北市,中山區,0869,292,434,726,46,772,1364,56.6%,21.41%,1
臺北市,中山區,0870,330,436,766,51,817,1461,55.92%,22.59%,1
臺北市,中山區,0871,274,382,656,38,694,1173,59.16%,23.36%,1
臺北市,中山區,0872,252,366,618,41,659,1171,56.28%,21.52%,1
臺北市,中山區,0873,304,412,716,39,755,1310,57.63%,23.21%,1
臺北市,中山區,0874,311,491,802,31,833,1373,60.67%,22.65%,1
臺北市,中山區,0875,289,482,771,26,797,1290,61.78%,22.4%,1
臺北市,中山區,0876,323,469,792,38,830,1346,61.66%,24%,1
臺北市,中山區,0877,380,470,850,43,893,1468,60.83%,25.89%,1
臺北市,中山區,0878,274,410,684,22,706,1178,59.93%,23.26%,1
臺北市,中山區,0879,386,566,952,37,989,1654,59.79%,23.34%,1
臺北市,中山區,0880,336,482,818,43,861,1464,58.81%,22.95%,1
臺北市,中山區,0881,310,473,783,37,820,1450,56.55%,21.38%,1
臺北市,中山區,0882,340,505,845,40,885,1534,57.69%,22.16%,1
臺北市,中山區,0883,381,560,941,33,974,1703,57.19%,22.37%,1
臺北市,中山區,0884,354,541,895,60,955,1610,59.32%,21.99%,1
臺北市,中山區,0885,345,518,863,51,914,1653,55.29%,20.87%,1
臺北市,中山區,0886,407,566,973,56,1029,1694,60.74%,24.03%,1
臺北市,中山區,0887,361,502,863,37,900,1623,55.45%,22.24%,1
臺北市,中山區,0888,387,510,897,46,943,1618,58.28%,23.92%,1
臺北市,中山區,0889,350,505,855,41,896,1583,56.6%,22.11%,1
臺北市,中山區,0890,408,513,921,49,970,1605,60.44%,25.42%,1
臺北市,中山區,0891,365,469,834,50,884,1398,63.23%,26.11%,1
臺北市,中山區,0892,390,563,953,55,1008,1526,66.06%,25.56%,1
臺北市,中山區,0893,357,511,868,47,915,1555,58.84%,22.96%,1
臺北市,中山區,0894,335,523,858,34,892,1597,55.85%,20.98%,1
臺北市,中山區,0895,373,501,874,62,936,1587,58.98%,23.5%,1
臺北市,中山區,0896,385,537,922,42,964,1587,60.74%,24.26%,1
臺北市,中山區,0897,368,535,903,47,950,1546,61.45%,23.8%,1
臺北市,中山區,0898,255,466,721,40,761,1322,57.56%,19.29%,1
臺北市,中山區,0899,288,425,713,28,741,1267,58.48%,22.73%,1
臺北市,中山區,0900,267,399,666,22,688,1210,56.86%,22.07%,1
臺北市,中山區,0901,252,456,708,42,750,1295,57.92%,19.46%,1
臺北市,中山區,0902,322,517,839,47,886,1467,60.4%,21.95%,1
臺北市,中山區,0903,272,623,895,33,928,1491,62.24%,18.24%,1
臺北市,中山區,0904,324,625,949,42,991,1516,65.37%,21.37%,1
臺北市,中山區,0905,306,419,725,27,752,1384,54.34%,22.11%,1
臺北市,中山區,0906,308,376,684,44,728,1138,63.97%,27.07%,1
臺北市,中山區,0907,322,465,787,26,813,1513,53.73%,21.28%,1
臺北市,中山區,0908,358,521,879,48,927,1559,59.46%,22.96%,1
臺北市,中山區,0909,322,513,835,56,891,1429,62.35%,22.53%,1
臺北市,中山區,0910,308,437,745,26,771,1245,61.93%,24.74%,1
臺北市,中山區,0911,274,455,729,42,771,1214,63.51%,22.57%,1
臺北市,中山區,0912,332,475,807,25,832,1394,59.68%,23.82%,1
臺北市,中山區,0913,272,431,703,14,717,1336,53.67%,20.36%,1
臺北市,中山區,0914,287,388,675,32,707,1227,57.62%,23.39%,1
臺北市,中山區,0915,296,487,783,37,820,1382,59.33%,21.42%,1
臺北市,中山區,0916,287,498,785,43,828,1436,57.66%,19.99%,1
臺北市,中山區,0917,303,398,701,38,739,1405,52.6%,21.57%,1
臺北市,中山區,0918,275,436,711,25,736,1259,58.46%,21.84%,1
臺北市,中正區,1001,302,453,755,28,783,1308,59.86%,23.09%,1
臺北市,中正區,1002,280,421,701,39,740,1317,56.19%,21.26%,1
臺北市,中正區,1003,223,409,632,32,664,1069,62.11%,20.86%,1
臺北市,中正區,1004,221,384,605,30,635,1128,56.29%,19.59%,1
臺北市,中正區,1005,247,366,613,35,648,1053,61.54%,23.46%,1
臺北市,中正區,1006,233,279,512,10,522,1048,49.81%,22.23%,1
臺北市,中正區,1007,241,453,694,40,734,1297,56.59%,18.58%,1
臺北市,中正區,1008,258,444,702,21,723,1193,60.6%,21.63%,1
臺北市,中正區,1009,354,591,945,33,978,1500,65.2%,23.6%,1
臺北市,中正區,1010,288,442,730,30,760,1346,56.46%,21.4%,1
臺北市,中正區,1011,275,429,704,25,729,1283,56.82%,21.43%,1
臺北市,中正區,1012,349,446,795,33,828,1450,57.1%,24.07%,1
臺北市,中正區,1013,341,478,819,36,855,1433,59.67%,23.8%,1
臺北市,中正區,1014,350,475,825,36,861,1309,65.78%,26.74%,1
臺北市,中正區,1015,308,512,820,12,832,1386,60.03%,22.22%,1
臺北市,中正區,1016,265,421,686,44,730,1201,60.78%,22.06%,1
臺北市,中正區,1017,313,478,791,34,825,1336,61.75%,23.43%,1
臺北市,中正區,1018,325,474,799,36,835,1358,61.49%,23.93%,1
臺北市,中正區,1019,267,419,686,33,719,1177,61.09%,22.68%,1
臺北市,中正區,1020,296,472,768,28,796,1236,64.4%,23.95%,1
臺北市,中正區,1021,302,517,819,42,861,1478,58.25%,20.43%,1
臺北市,中正區,1022,326,514,840,32,872,1474,59.16%,22.12%,1
臺北市,中正區,1023,262,399,661,32,693,1172,59.13%,22.35%,1
臺北市,中正區,1024,282,448,730,41,771,1310,58.85%,21.53%,1
臺北市,中正區,1025,268,467,735,31,766,1263,60.65%,21.22%,1
臺北市,中正區,1026,246,423,669,36,705,1169,60.31%,21.04%,1
臺北市,中正區,1027,299,500,799,22,821,1391,59.02%,21.5%,1
臺北市,中正區,1028,236,424,660,22,682,1201,56.79%,19.65%,1
臺北市,中正區,1029,270,479,749,41,790,1324,59.67%,20.39%,1
臺北市,中正區,1030,238,407,645,47,692,1216,56.91%,19.57%,1
臺北市,中正區,1031,269,382,651,35,686,1183,57.99%,22.74%,1
臺北市,中正區,1032,339,503,842,55,897,1469,61.06%,23.08%,1
臺北市,中正區,1033,336,459,795,36,831,1411,58.89%,23.81%,1
臺北市,中正區,1034,312,466,778,67,845,1398,60.44%,22.32%,1
臺北市,中正區,1035,289,494,783,64,847,1479,57.27%,19.54%,1
臺北市,中正區,1036,337,527,864,50,914,1620,56.42%,20.8%,1
臺北市,中正區,1037,228,367,595,16,611,1041,58.69%,21.9%,1
臺北市,中正區,1038,246,352,598,17,615,1056,58.24%,23.3%,1
臺北市,中正區,1039,250,423,673,29,702,1063,66.04%,23.52%,1
臺北市,中正區,1040,266,450,716,43,759,1591,47.71%,16.72%,1
臺北市,中正區,1041,225,431,656,48,704,1502,46.87%,14.98%,1
臺北市,中正區,1042,241,434,675,41,716,1331,53.79%,18.11%,1
臺北市,中正區,1043,275,495,770,48,818,1441,56.77%,19.08%,1
臺北市,中正區,1044,315,456,771,23,794,1273,62.37%,24.74%,1
臺北市,中正區,1045,250,422,672,25,697,1133,61.52%,22.07%,1
臺北市,中正區,1046,215,451,666,23,689,1156,59.6%,18.6%,1
臺北市,中正區,1047,300,460,760,42,802,1377,58.24%,21.79%,1
臺北市,中正區,1048,270,468,738,45,783,1266,61.85%,21.33%,1
臺北市,中正區,1049,244,437,681,33,714,1111,64.27%,21.96%,1
臺北市,中正區,1050,278,376,654,30,684,1124,60.85%,24.73%,1
臺北市,中正區,1051,319,507,826,24,850,1373,61.91%,23.23%,1
臺北市,中正區,1052,302,513,815,23,838,1351,62.03%,22.35%,1
臺北市,中正區,1053,334,533,867,23,890,1495,59.53%,22.34%,1
臺北市,中正區,1054,352,532,884,32,916,1436,63.79%,24.51%,1
臺北市,中正區,1055,331,527,858,15,873,1516,57.59%,21.83%,1
臺北市,中正區,1056,286,490,776,31,807,1374,58.73%,20.82%,1
臺北市,中正區,1057,279,533,812,27,839,1522,55.12%,18.33%,1
臺北市,中正區,1058,294,482,776,25,801,1336,59.96%,22.01%,1
臺北市,中正區,1059,343,542,885,33,918,1551,59.19%,22.11%,1
臺北市,中正區,1060,355,556,911,46,957,1594,60.04%,22.27%,1
臺北市,中正區,1061,325,514,839,36,875,1503,58.22%,21.62%,1
臺北市,中正區,1062,295,552,847,20,867,1455,59.59%,20.27%,1
臺北市,中正區,1063,304,552,856,12,868,1439,60.32%,21.13%,1
臺北市,中正區,1064,309,526,835,36,871,1469,59.29%,21.03%,1
臺北市,中正區,1065,259,581,840,33,873,1430,61.05%,18.11%,1
臺北市,中正區,1066,328,540,868,21,889,1444,61.57%,22.71%,1
臺北市,中正區,1067,267,456,723,10,733,1254,58.45%,21.29%,1
臺北市,中正區,1068,200,334,534,40,574,932,61.59%,21.46%,1
臺北市,中正區,1069,256,356,612,33,645,1055,61.14%,24.27%,1
臺北市,中正區,1070,260,438,698,24,722,1226,58.89%,21.21%,1
臺北市,中正區,1071,257,447,704,35,739,1390,53.17%,18.49%,1
臺北市,中正區,1072,307,460,767,26,793,1336,59.36%,22.98%,1
臺北市,中正區,1073,285,442,727,30,757,1419,53.35%,20.08%,1
臺北市,中正區,1074,320,491,811,40,851,1361,62.53%,23.51%,1
臺北市,中正區,1075,318,548,866,33,899,2520,35.67%,12.62%,1
臺北市,中正區,1076,253,452,705,15,720,1224,58.82%,20.67%,1
臺北市,中正區,1077,266,403,669,6,675,1272,53.07%,20.91%,1
臺北市,中正區,1078,336,447,783,35,818,1400,58.43%,24%,1
臺北市,中正區,1079,277,442,719,30,749,1319,56.79%,21%,1
臺北市,中正區,1080,272,466,738,31,769,1232,62.42%,22.08%,1
臺北市,中正區,1081,307,475,782,27,809,1265,63.95%,24.27%,1
臺北市,中正區,1082,250,403,653,21,674,1055,63.89%,23.7%,1
臺北市,中正區,1083,196,346,542,24,566,954,59.33%,20.55%,1
臺北市,中正區,1084,208,382,590,30,620,1018,60.9%,20.43%,1
臺北市,中正區,1085,308,485,793,18,811,1431,56.67%,21.52%,1
臺北市,中正區,1086,276,370,646,30,676,1271,53.19%,21.72%,1
臺北市,中正區,1087,232,352,584,32,616,983,62.67%,23.6%,1
臺北市,中正區,1088,340,546,886,26,912,1594,57.21%,21.33%,1
臺北市,中正區,1089,355,566,921,39,960,1565,61.34%,22.68%,1
臺北市,中正區,1090,346,577,923,32,955,1650,57.88%,20.97%,1
臺北市,中正區,1091,339,518,857,28,885,1600,55.31%,21.19%,1
臺北市,中正區,1092,305,457,762,29,791,1391,56.87%,21.93%,1
臺北市,中正區,1093,370,594,964,32,996,1769,56.3%,20.92%,1
臺北市,中正區,1094,355,473,828,35,863,1487,58.04%,23.87%,1
臺北市,中正區,1095,303,452,755,41,796,1291,61.66%,23.47%,1
臺北市,中正區,1096,305,451,756,23,779,1289,60.43%,23.66%,1
臺北市,大同區,0919,308,397,705,48,753,1261,59.71%,24.43%,1
臺北市,大同區,0920,333,457,790,46,836,1352,61.83%,24.63%,1
臺北市,大同區,0921,328,479,807,37,844,1462,57.73%,22.44%,1
臺北市,大同區,0922,299,494,793,43,836,1510,55.36%,19.8%,1
臺北市,大同區,0923,329,436,765,34,799,1496,53.41%,21.99%,1
臺北市,大同區,0924,271,434,705,46,751,1329,56.51%,20.39%,1
臺北市,大同區,0925,289,408,697,73,770,1307,58.91%,22.11%,1
臺北市,大同區,0926,247,344,591,42,633,1065,59.44%,23.19%,1
臺北市,大同區,0927,265,347,612,20,632,1085,58.25%,24.42%,1
臺北市,大同區,0928,271,350,621,42,663,1047,63.32%,25.88%,1
臺北市,大同區,0929,294,325,619,28,647,1215,53.25%,24.2%,1
臺北市,大同區,0930,292,381,673,27,700,1117,62.67%,26.14%,1
臺北市,大同區,0931,313,393,706,36,742,1186,62.56%,26.39%,1
臺北市,大同區,0932,273,408,681,47,728,1185,61.43%,23.04%,1
臺北市,大同區,0933,292,459,751,38,789,1359,58.06%,21.49%,1
臺北市,大同區,0934,271,446,717,23,740,1273,58.13%,21.29%,1
臺北市,大同區,0935,348,419,767,36,803,1291,62.2%,26.96%,1
臺北市,大同區,0936,282,404,686,31,717,1288,55.67%,21.89%,1
臺北市,大同區,0937,276,472,748,31,779,1245,62.57%,22.17%,1
臺北市,大同區,0938,326,428,754,40,794,1261,62.97%,25.85%,1
臺北市,大同區,0939,297,424,721,26,747,1348,55.42%,22.03%,1
臺北市,大同區,0940,392,523,915,69,984,1676,58.71%,23.39%,1
臺北市,大同區,0941,290,480,770,36,806,1311,61.48%,22.12%,1
臺北市,大同區,0942,316,429,745,53,798,1316,60.64%,24.01%,1
臺北市,大同區,0943,318,452,770,61,831,1409,58.98%,22.57%,1
臺北市,大同區,0944,354,472,826,45,871,1436,60.65%,24.65%,1
臺北市,大同區,0945,325,462,787,53,840,1408,59.66%,23.08%,1
臺北市,大同區,0946,274,423,697,36,733,1276,57.45%,21.47%,1
臺北市,大同區,0947,238,362,600,19,619,1110,55.77%,21.44%,1
臺北市,大同區,0948,319,441,760,22,782,1324,59.06%,24.09%,1
臺北市,大同區,0949,218,341,559,40,599,1016,58.96%,21.46%,1
臺北市,大同區,0950,240,369,609,35,644,1028,62.65%,23.35%,1
臺北市,大同區,0951,220,444,664,40,704,1158,60.79%,19%,1
臺北市,大同區,0952,242,426,668,37,705,1138,61.95%,21.27%,1
臺北市,大同區,0953,262,436,698,34,732,1214,60.3%,21.58%,1
臺北市,大同區,0954,220,400,620,22,642,1090,58.9%,20.18%,1
臺北市,大同區,0955,330,458,788,46,834,1305,63.91%,25.29%,1
臺北市,大同區,0956,259,372,631,27,658,1167,56.38%,22.19%,1
臺北市,大同區,0957,249,376,625,45,670,1148,58.36%,21.69%,1
臺北市,大同區,0958,282,432,714,34,748,1203,62.18%,23.44%,1
臺北市,大同區,0959,310,460,770,38,808,1441,56.07%,21.51%,1
臺北市,大同區,0960,298,475,773,48,821,1315,62.43%,22.66%,1
臺北市,大同區,0961,335,427,762,40,802,1393,57.57%,24.05%,1
臺北市,大同區,0962,303,427,730,42,772,1278,60.41%,23.71%,1
臺北市,大同區,0963,285,368,653,35,688,1246,55.22%,22.87%,1
臺北市,大同區,0964,256,350,606,61,667,1142,58.41%,22.42%,1
臺北市,大同區,0965,308,482,790,53,843,1336,63.1%,23.05%,1
臺北市,大同區,0966,326,468,794,43,837,1363,61.41%,23.92%,1
臺北市,大同區,0967,320,517,837,23,860,1476,58.27%,21.68%,1
臺北市,大同區,0968,343,446,789,51,840,1418,59.24%,24.19%,1
臺北市,大同區,0969,294,500,794,33,827,1460,56.64%,20.14%,1
臺北市,大同區,0970,250,349,599,41,640,1222,52.37%,20.46%,1
臺北市,大同區,0971,230,346,576,75,651,1246,52.25%,18.46%,1
臺北市,大同區,0972,285,447,732,52,784,1256,62.42%,22.69%,1
臺北市,大同區,0973,299,427,726,29,755,1289,58.57%,23.2%,1
臺北市,大同區,0974,298,419,717,20,737,1340,55%,22.24%,1
臺北市,大同區,0975,348,429,777,47,824,1555,52.99%,22.38%,1
臺北市,大同區,0976,262,504,766,66,832,2459,33.83%,10.65%,1
臺北市,大同區,0977,192,298,490,55,545,1108,49.19%,17.33%,1
臺北市,大同區,0978,188,268,456,38,494,867,56.98%,21.68%,1
臺北市,大同區,0979,311,461,772,54,826,1329,62.15%,23.4%,1
臺北市,大同區,0980,291,353,644,35,679,1162,58.43%,25.04%,1
臺北市,大同區,0981,290,442,732,62,794,1434,55.37%,20.22%,1
臺北市,大同區,0982,321,420,741,54,795,1351,58.85%,23.76%,1
臺北市,大同區,0983,326,408,734,43,777,1531,50.75%,21.29%,1
臺北市,大同區,0984,325,410,735,34,769,1507,51.03%,21.57%,1
臺北市,大同區,0985,356,423,779,53,832,1488,55.91%,23.92%,1
臺北市,大同區,0986,321,469,790,62,852,1384,61.56%,23.19%,1
臺北市,大同區,0987,290,519,809,51,860,1460,58.9%,19.86%,1
臺北市,大同區,0988,313,479,792,52,844,1371,61.56%,22.83%,1
臺北市,大同區,0989,343,440,783,17,800,1439,55.59%,23.84%,1
臺北市,大同區,0990,357,426,783,49,832,1376,60.47%,25.94%,1
臺北市,大同區,0991,288,428,716,68,784,1366,57.39%,21.08%,1
臺北市,大同區,0992,296,433,729,58,787,1218,64.61%,24.3%,1
臺北市,大同區,0993,265,421,686,45,731,1235,59.19%,21.46%,1
臺北市,大同區,0994,248,477,725,19,744,1364,54.55%,18.18%,1
臺北市,大同區,0995,350,495,845,53,898,1408,63.78%,24.86%,1
臺北市,大同區,0996,309,486,795,52,847,1450,58.41%,21.31%,1
臺北市,大同區,0997,327,497,824,61,885,1429,61.93%,22.88%,1
臺北市,大同區,0998,284,378,662,57,719,1170,61.45%,24.27%,1
臺北市,大同區,0999,288,392,680,58,738,1245,59.28%,23.13%,1
臺北市,大同區,1000,313,418,731,62,793,1215,65.27%,25.76%,1
臺北市,萬華區,1097,315,428,743,45,788,1305,60.38%,24.14%,1
臺北市,萬華區,1098,205,344,549,59,608,1183,51.39%,17.33%,1
臺北市,萬華區,1099,244,385,629,25,654,1176,55.61%,20.75%,1
臺北市,萬華區,1100,246,336,582,26,608,1169,52.01%,21.04%,1
臺北市,萬華區,1101,235,472,707,34,741,1457,50.86%,16.13%,1
臺北市,萬華區,1102,275,426,701,54,755,1563,48.3%,17.59%,1
臺北市,萬華區,1103,341,505,846,22,868,1771,49.01%,19.25%,1
臺北市,萬華區,1104,348,453,801,38,839,1615,51.95%,21.55%,1
臺北市,萬華區,1105,318,445,763,69,832,1478,56.29%,21.52%,1
臺北市,萬華區,1106,300,475,775,24,799,1462,54.65%,20.52%,1
臺北市,萬華區,1107,243,437,680,55,735,1507,48.77%,16.12%,1
臺北市,萬華區,1108,318,427,745,45,790,1347,58.65%,23.61%,1
臺北市,萬華區,1109,272,410,682,51,733,1367,53.62%,19.9%,1
臺北市,萬華區,1110,293,453,746,42,788,1277,61.71%,22.94%,1
臺北市,萬華區,1111,360,421,781,50,831,1395,59.57%,25.81%,1
臺北市,萬華區,1112,319,421,740,41,781,1450,53.86%,22%,1
臺北市,萬華區,1113,255,409,664,34,698,1340,52.09%,19.03%,1
臺北市,萬華區,1114,249,381,630,37,667,1242,53.7%,20.05%,1
臺北市,萬華區,1115,264,388,652,62,714,1286,55.52%,20.53%,1
臺北市,萬華區,1116,235,437,672,49,721,1324,54.46%,17.75%,1
臺北市,萬華區,1117,330,473,803,59,862,1619,53.24%,20.38%,1
臺北市,萬華區,1118,240,382,622,56,678,1352,50.15%,17.75%,1
臺北市,萬華區,1119,284,451,735,43,778,1440,54.03%,19.72%,1
臺北市,萬華區,1120,284,386,670,49,719,1194,60.22%,23.79%,1
臺北市,萬華區,1121,235,409,644,48,692,1083,63.9%,21.7%,1
臺北市,萬華區,1122,249,383,632,54,686,1237,55.46%,20.13%,1
臺北市,萬華區,1123,362,481,843,39,882,1625,54.28%,22.28%,1
臺北市,萬華區,1124,300,459,759,43,802,1324,60.57%,22.66%,1
臺北市,萬華區,1125,339,413,752,54,806,1352,59.62%,25.07%,1
臺北市,萬華區,1126,282,421,703,47,750,2630,28.52%,10.72%,1
臺北市,萬華區,1127,366,493,859,50,909,1504,60.44%,24.34%,1
臺北市,萬華區,1128,325,430,755,38,793,1425,55.65%,22.81%,1
臺北市,萬華區,1129,312,446,758,62,820,1591,51.54%,19.61%,1
臺北市,萬華區,1130,317,445,762,51,813,1474,55.16%,21.51%,1
臺北市,萬華區,1131,333,453,786,66,852,1612,52.85%,20.66%,1
臺北市,萬華區,1132,290,451,741,52,793,1447,54.8%,20.04%,1
臺北市,萬華區,1133,306,518,824,42,866,1491,58.08%,20.52%,1
臺北市,萬華區,1134,324,531,855,40,895,1500,59.67%,21.6%,1
臺北市,萬華區,1135,438,531,969,45,1014,1582,64.1%,27.69%,1
臺北市,萬華區,1136,325,482,807,42,849,1623,52.31%,20.02%,1
臺北市,萬華區,1137,282,371,653,20,673,1228,54.8%,22.96%,1
臺北市,萬華區,1138,251,422,673,48,721,1268,56.86%,19.79%,1
臺北市,萬華區,1139,272,403,675,54,729,1207,60.4%,22.54%,1
臺北市,萬華區,1140,287,390,677,39,716,1188,60.27%,24.16%,1
臺北市,萬華區,1141,292,465,757,40,797,1474,54.07%,19.81%,1
臺北市,萬華區,1142,197,412,609,26,635,1304,48.7%,15.11%,1
臺北市,萬華區,1143,152,276,428,48,476,1082,43.99%,14.05%,1
臺北市,萬華區,1144,213,316,529,34,563,1052,53.52%,20.25%,1
臺北市,萬華區,1145,262,345,607,40,647,1135,57%,23.08%,1
臺北市,萬華區,1146,245,392,637,54,691,1225,56.41%,20%,1
臺北市,萬華區,1147,315,482,797,40,837,1583,52.87%,19.9%,1
臺北市,萬華區,1148,324,404,728,54,782,1403,55.74%,23.09%,1
臺北市,萬華區,1149,307,459,766,48,814,1406,57.89%,21.83%,1
臺北市,萬華區,1150,271,495,766,48,814,1401,58.1%,19.34%,1
臺北市,萬華區,1151,287,376,663,48,711,1188,59.85%,24.16%,1
臺北市,萬華區,1152,326,479,805,63,868,1597,54.35%,20.41%,1
臺北市,萬華區,1153,272,464,736,61,797,1290,61.78%,21.09%,1
臺北市,萬華區,1154,339,506,845,28,873,1746,50%,19.42%,1
臺北市,萬華區,1155,286,448,734,29,763,1595,47.84%,17.93%,1
臺北市,萬華區,1156,334,519,853,85,938,1701,55.14%,19.64%,1
臺北市,萬華區,1157,235,365,600,65,665,1339,49.66%,17.55%,1
臺北市,萬華區,1158,234,421,655,66,721,1484,48.58%,15.77%,1
臺北市,萬華區,1159,317,522,839,72,911,1604,56.8%,19.76%,1
臺北市,萬華區,1160,282,382,664,38,702,1197,58.65%,23.56%,1
臺北市,萬華區,1161,283,391,674,73,747,1347,55.46%,21.01%,1
臺北市,萬華區,1162,308,438,746,39,785,1223,64.19%,25.18%,1
臺北市,萬華區,1163,248,353,601,29,630,1036,60.81%,23.94%,1
臺北市,萬華區,1164,251,365,616,45,661,1035,63.86%,24.25%,1
臺北市,萬華區,1165,285,386,671,39,710,1141,62.23%,24.98%,1
臺北市,萬華區,1166,269,444,713,37,750,1271,59.01%,21.16%,1
臺北市,萬華區,1167,299,441,740,69,809,1328,60.92%,22.52%,1
臺北市,萬華區,1168,303,421,724,39,763,1286,59.33%,23.56%,1
臺北市,萬華區,1169,346,549,895,67,962,1679,57.3%,20.61%,1
臺北市,萬華區,1170,353,494,847,64,911,1619,56.27%,21.8%,1
臺北市,萬華區,1171,283,491,774,44,818,1625,50.34%,17.42%,1
臺北市,萬華區,1172,322,586,908,49,957,1623,58.96%,19.84%,1
臺北市,萬華區,1173,223,441,664,60,724,1280,56.56%,17.42%,1
臺北市,萬華區,1174,339,500,839,63,902,1608,56.09%,21.08%,1
臺北市,萬華區,1175,324,473,797,54,851,1453,58.57%,22.3%,1
臺北市,萬華區,1176,340,532,872,40,912,1472,61.96%,23.1%,1
臺北市,萬華區,1177,316,446,762,37,799,1373,58.19%,23.02%,1
臺北市,萬華區,1178,279,445,724,54,778,1394,55.81%,20.01%,1
臺北市,萬華區,1179,283,455,738,29,767,1427,53.75%,19.83%,1
臺北市,萬華區,1180,296,493,789,46,835,1342,62.22%,22.06%,1
臺北市,萬華區,1181,289,573,862,72,934,1569,59.53%,18.42%,1
臺北市,萬華區,1182,243,471,714,45,759,1514,50.13%,16.05%,1
臺北市,萬華區,1183,312,492,804,39,843,1720,49.01%,18.14%,1
臺北市,萬華區,1184,348,509,857,59,916,1461,62.7%,23.82%,1
臺北市,萬華區,1185,261,408,669,34,703,1264,55.62%,20.65%,1
臺北市,萬華區,1186,279,494,773,57,830,1334,62.22%,20.91%,1
臺北市,萬華區,1187,415,344,759,61,820,1446,56.71%,28.7%,1
臺北市,萬華區,1188,232,421,653,33,686,1307,52.49%,17.75%,1
臺北市,萬華區,1189,284,495,779,60,839,1420,59.08%,20%,1
臺北市,萬華區,1190,281,429,710,37,747,1427,52.35%,19.69%,1
臺北市,萬華區,1191,177,339,516,30,546,956,57.11%,18.51%,1
臺北市,萬華區,1192,245,490,735,56,791,1352,58.51%,18.12%,1
臺北市,萬華區,1193,244,500,744,37,781,1370,57.01%,17.81%,1
臺北市,萬華區,1194,219,486,705,27,732,1222,59.9%,17.92%,1
臺北市,萬華區,1195,212,546,758,36,794,1375,57.75%,15.42%,1
臺北市,萬華區,1196,252,571,823,37,860,1463,58.78%,17.22%,1
臺北市,萬華區,1197,275,495,770,37,807,1527,52.85%,18.01%,1
臺北市,萬華區,1198,250,523,773,40,813,1485,54.75%,16.84%,1
臺北市,萬華區,1199,272,676,948,32,980,1591,61.6%,17.1%,1
臺北市,萬華區,1200,286,575,861,36,897,1394,64.35%,20.52%,1
臺北市,萬華區,1201,291,553,844,29,873,1522,57.36%,19.12%,1
臺北市,萬華區,1202,306,673,979,24,1003,1661,60.39%,18.42%,1
臺北市,萬華區,1203,300,618,918,33,951,1561,60.92%,19.22%,1
臺北市,萬華區,1204,287,583,870,35,905,1406,64.37%,20.41%,1
臺北市,萬華區,1205,248,419,667,39,706,1498,47.13%,16.56%,1
臺北市,萬華區,1206,230,426,656,52,708,1478,47.9%,15.56%,1
臺北市,萬華區,1207,226,383,609,47,656,1170,56.07%,19.32%,1
臺北市,萬華區,1208,275,516,791,30,821,1376,59.67%,19.99%,1
臺北市,萬華區,1209,236,372,608,16,624,1093,57.09%,21.59%,1
臺北市,萬華區,1210,244,383,627,57,684,1084,63.1%,22.51%,1
臺北市,萬華區,1211,231,398,629,45,674,1119,60.23%,20.64%,1
臺北市,萬華區,1212,287,541,828,27,855,1381,61.91%,20.78%,1
臺北市,萬華區,1213,293,494,787,36,823,1396,58.95%,20.99%,1
臺北市,文山區,1402,328,508,836,35,871,1539,56.6%,21.31%,1
臺北市,文山區,1403,289,530,819,22,841,1548,54.33%,18.67%,1
臺北市,文山區,1404,314,535,849,57,906,1493,60.68%,21.03%,1
臺北市,文山區,1405,360,598,958,41,999,1648,60.62%,21.84%,1
臺北市,文山區,1406,321,538,859,40,899,1544,58.23%,20.79%,1
臺北市,文山區,1407,298,575,873,36,909,1557,58.38%,19.14%,1
臺北市,文山區,1408,314,517,831,34,865,1514,57.13%,20.74%,1
臺北市,文山區,1409,339,607,946,43,989,1540,64.22%,22.01%,1
臺北市,文山區,1410,325,552,877,30,907,1466,61.87%,22.17%,1
臺北市,文山區,1411,327,531,858,39,897,1444,62.12%,22.65%,1
臺北市,文山區,1412,303,532,835,51,886,1455,60.89%,20.82%,1
臺北市,文山區,1413,264,514,778,30,808,1440,56.11%,18.33%,1
臺北市,文山區,1414,276,551,827,35,862,1398,61.66%,19.74%,1
臺北市,文山區,1415,309,472,781,19,800,1412,56.66%,21.88%,1
臺北市,文山區,1416,292,499,791,43,834,1426,58.49%,20.48%,1
臺北市,文山區,1417,325,496,821,36,857,1437,59.64%,22.62%,1
臺北市,文山區,1418,284,494,778,31,809,1340,60.37%,21.19%,1
臺北市,文山區,1419,345,549,894,24,918,1568,58.55%,22%,1
臺北市,文山區,1420,256,510,766,29,795,1372,57.94%,18.66%,1
臺北市,文山區,1421,227,360,587,30,617,1046,58.99%,21.7%,1
臺北市,文山區,1422,281,434,715,48,763,1274,59.89%,22.06%,1
臺北市,文山區,1423,265,491,756,25,781,1324,58.99%,20.02%,1
臺北市,文山區,1424,336,603,939,43,982,1722,57.03%,19.51%,1
臺北市,文山區,1425,367,638,1005,43,1048,1737,60.33%,21.13%,1
臺北市,文山區,1426,323,511,834,24,858,1370,62.63%,23.58%,1
臺北市,文山區,1427,341,498,839,43,882,1495,59%,22.81%,1
臺北市,文山區,1428,297,475,772,35,807,1328,60.77%,22.36%,1
臺北市,文山區,1429,257,442,699,35,734,1138,64.5%,22.58%,1
臺北市,文山區,1430,306,561,867,30,897,1471,60.98%,20.8%,1
臺北市,文山區,1431,260,437,697,22,719,1144,62.85%,22.73%,1
臺北市,文山區,1432,271,444,715,39,754,1176,64.12%,23.04%,1
臺北市,文山區,1433,265,466,731,36,767,1212,63.28%,21.86%,1
臺北市,文山區,1434,271,474,745,32,777,1214,64%,22.32%,1
臺北市,文山區,1435,259,384,643,30,673,1170,57.52%,22.14%,1
臺北市,文山區,1436,296,474,770,33,803,1308,61.39%,22.63%,1
臺北市,文山區,1437,272,425,697,34,731,1190,61.43%,22.86%,1
臺北市,文山區,1438,235,400,635,28,663,1110,59.73%,21.17%,1
臺北市,文山區,1439,313,543,856,44,900,1512,59.52%,20.7%,1
臺北市,文山區,1440,256,567,823,38,861,1387,62.08%,18.46%,1
臺北市,文山區,1441,297,469,766,44,810,1355,59.78%,21.92%,1
臺北市,文山區,1442,318,462,780,47,827,1370,60.36%,23.21%,1
臺北市,文山區,1443,304,543,847,32,879,1484,59.23%,20.49%,1
臺北市,文山區,1444,372,618,990,46,1036,1786,58.01%,20.83%,1
臺北市,文山區,1445,248,478,726,45,771,1260,61.19%,19.68%,1
臺北市,文山區,1446,310,452,762,22,784,1194,65.66%,25.96%,1
臺北市,文山區,1447,265,554,819,39,858,1444,59.42%,18.35%,1
臺北市,文山區,1448,317,546,863,34,897,1495,60%,21.2%,1
臺北市,文山區,1449,297,554,851,42,893,1446,61.76%,20.54%,1
臺北市,文山區,1450,302,494,796,60,856,1450,59.03%,20.83%,1
臺北市,文山區,1451,330,558,888,30,918,1486,61.78%,22.21%,1
臺北市,文山區,1452,282,456,738,29,767,1259,60.92%,22.4%,1
臺北市,文山區,1453,274,517,791,26,817,1317,62.03%,20.8%,1
臺北市,文山區,1454,304,494,798,31,829,1321,62.76%,23.01%,1
臺北市,文山區,1455,318,511,829,35,864,1475,58.58%,21.56%,1
臺北市,文山區,1456,269,436,705,30,735,1271,57.83%,21.16%,1
臺北市,文山區,1457,354,578,932,40,972,1609,60.41%,22%,1
臺北市,文山區,1458,288,532,820,21,841,1501,56.03%,19.19%,1
臺北市,文山區,1459,198,327,525,29,554,997,55.57%,19.86%,1
臺北市,文山區,1460,254,391,645,38,683,1052,64.92%,24.14%,1
臺北市,文山區,1461,266,475,741,26,767,1247,61.51%,21.33%,1
臺北市,文山區,1462,264,432,696,36,732,1167,62.72%,22.62%,1
臺北市,文山區,1463,264,507,771,25,796,1280,62.19%,20.63%,1
臺北市,文山區,1464,244,434,678,38,716,1153,62.1%,21.16%,1
臺北市,文山區,1465,360,555,915,41,956,1557,61.4%,23.12%,1
臺北市,文山區,1466,248,567,815,48,863,1444,59.76%,17.17%,1
臺北市,文山區,1467,344,569,913,34,947,1459,64.91%,23.58%,1
臺北市,文山區,1468,282,557,839,28,867,1357,63.89%,20.78%,1
臺北市,文山區,1469,281,479,760,26,786,1194,65.83%,23.53%,1
臺北市,文山區,1470,270,349,619,45,664,1184,56.08%,22.8%,1
臺北市,文山區,1471,269,428,697,22,719,1119,64.25%,24.04%,1
臺北市,文山區,1472,304,534,838,41,879,1350,65.11%,22.52%,1
臺北市,文山區,1473,266,548,814,33,847,1502,56.39%,17.71%,1
臺北市,文山區,1474,308,571,879,35,914,1511,60.49%,20.38%,1
臺北市,文山區,1475,359,549,908,29,937,1481,63.27%,24.24%,1
臺北市,文山區,1476,321,600,921,21,942,1477,63.78%,21.73%,1
臺北市,文山區,1477,282,498,780,24,804,1294,62.13%,21.79%,1
臺北市,文山區,1478,239,445,684,25,709,1040,68.17%,22.98%,1
臺北市,文山區,1479,293,511,804,32,836,1323,63.19%,22.15%,1
臺北市,文山區,1480,279,401,680,42,722,1153,62.62%,24.2%,1
臺北市,文山區,1481,300,576,876,25,901,1525,59.08%,19.67%,1
臺北市,文山區,1482,258,499,757,35,792,1412,56.09%,18.27%,1
臺北市,文山區,1483,377,522,899,33,932,1473,63.27%,25.59%,1
臺北市,文山區,1484,400,473,873,28,901,1486,60.63%,26.92%,1
臺北市,文山區,1485,353,621,974,41,1015,1616,62.81%,21.84%,1
臺北市,文山區,1486,306,595,901,45,946,1489,63.53%,20.55%,1
臺北市,文山區,1487,287,516,803,38,841,1414,59.48%,20.3%,1
臺北市,文山區,1488,367,549,916,41,957,1494,64.06%,24.56%,1
臺北市,文山區,1489,339,583,922,40,962,1547,62.18%,21.91%,1
臺北市,文山區,1490,338,584,922,50,972,1587,61.25%,21.3%,1
臺北市,文山區,1491,337,606,943,26,969,1515,63.96%,22.24%,1
臺北市,文山區,1492,360,597,957,32,989,1573,62.87%,22.89%,1
臺北市,文山區,1493,363,552,915,41,956,1542,62%,23.54%,1
臺北市,文山區,1494,284,479,763,45,808,1465,55.15%,19.39%,1
臺北市,文山區,1495,132,174,306,38,344,699,49.21%,18.88%,1
臺北市,文山區,1496,263,400,663,52,715,1372,52.11%,19.17%,1
臺北市,文山區,1497,283,424,707,40,747,1448,51.59%,19.54%,1
臺北市,文山區,1498,293,573,866,43,909,1548,58.72%,18.93%,1
臺北市,文山區,1499,342,531,873,28,901,1501,60.03%,22.78%,1
臺北市,文山區,1500,361,562,923,45,968,1560,62.05%,23.14%,1
臺北市,文山區,1501,336,568,904,33,937,1567,59.8%,21.44%,1
臺北市,文山區,1502,367,525,892,26,918,1554,59.07%,23.62%,1
臺北市,文山區,1503,306,567,873,44,917,1544,59.39%,19.82%,1
臺北市,文山區,1504,335,574,909,43,952,1528,62.3%,21.92%,1
臺北市,文山區,1505,317,626,943,23,966,1543,62.61%,20.54%,1
臺北市,文山區,1506,365,551,916,47,963,2754,34.97%,13.25%,1
臺北市,文山區,1507,322,520,842,54,896,1709,52.43%,18.84%,1
臺北市,文山區,1508,290,522,812,58,870,1515,57.43%,19.14%,1
臺北市,文山區,1509,305,521,826,37,863,1571,54.93%,19.41%,1
臺北市,文山區,1510,370,502,872,38,910,1578,57.67%,23.45%,1
臺北市,文山區,1511,282,498,780,43,823,1454,56.6%,19.39%,1
臺北市,文山區,1512,298,518,816,41,857,1436,59.68%,20.75%,1
臺北市,文山區,1513,304,530,834,46,880,1402,62.77%,21.68%,1
臺北市,文山區,1514,256,410,666,37,703,1117,62.94%,22.92%,1
臺北市,文山區,1515,245,369,614,40,654,1094,59.78%,22.39%,1
臺北市,文山區,1516,225,423,648,41,689,1070,64.39%,21.03%,1
臺北市,文山區,1517,284,539,823,28,851,1319,64.52%,21.53%,1
臺北市,文山區,1518,266,481,747,31,778,1226,63.46%,21.7%,1
臺北市,文山區,1519,284,464,748,25,773,1385,55.81%,20.51%,1
臺北市,文山區,1520,330,483,813,41,854,1416,60.31%,23.31%,1
臺北市,文山區,1521,310,559,869,37,906,1412,64.16%,21.95%,1
臺北市,文山區,1522,299,512,811,59,870,1535,56.68%,19.48%,1
臺北市,文山區,1523,339,653,992,52,1044,1654,63.12%,20.5%,1
臺北市,文山區,1524,262,451,713,23,736,1156,63.67%,22.66%,1
臺北市,文山區,1525,297,462,759,24,783,1231,63.61%,24.13%,1
臺北市,文山區,1526,233,462,695,35,730,1218,59.93%,19.13%,1
臺北市,文山區,1527,289,446,735,25,760,1176,64.63%,24.57%,1
臺北市,文山區,1528,421,431,852,5,857,1392,61.57%,30.24%,1
臺北市,文山區,1529,287,424,711,73,784,1323,59.26%,21.69%,1
臺北市,文山區,1530,263,458,721,31,752,1297,57.98%,20.28%,1
臺北市,文山區,1531,298,475,773,40,813,1296,62.73%,22.99%,1
臺北市,文山區,1532,300,580,880,37,917,1613,56.85%,18.6%,1
臺北市,文山區,1533,373,610,983,49,1032,1697,60.81%,21.98%,1
臺北市,文山區,1534,359,544,903,42,945,1579,59.85%,22.74%,1
臺北市,文山區,1535,322,478,800,41,841,1320,63.71%,24.39%,1
臺北市,文山區,1536,323,509,832,26,858,1438,59.67%,22.46%,1
臺北市,文山區,1537,275,508,783,26,809,1465,55.22%,18.77%,1
臺北市,文山區,1538,398,547,945,34,979,1646,59.48%,24.18%,1
臺北市,文山區,1539,278,467,745,39,784,1286,60.96%,21.62%,1
臺北市,文山區,1540,296,426,722,24,746,1219,61.2%,24.28%,1
臺北市,文山區,1541,284,485,769,33,802,1292,62.07%,21.98%,1
臺北市,文山區,1542,283,535,818,44,862,1489,57.89%,19.01%,1
臺北市,文山區,1543,429,526,955,34,989,1611,61.39%,26.63%,1
臺北市,文山區,1544,294,476,770,37,807,1549,52.1%,18.98%,1
臺北市,文山區,1545,333,585,918,37,955,1678,56.91%,19.85%,1
臺北市,文山區,1546,334,570,904,40,944,1660,56.87%,20.12%,1
臺北市,文山區,1547,363,527,890,25,915,1816,50.39%,19.99%,1
臺北市,文山區,1548,220,322,542,22,564,985,57.26%,22.34%,1
臺北市,文山區,1549,303,492,795,19,814,1314,61.95%,23.06%,1
臺北市,文山區,1550,395,241,636,28,664,1018,65.23%,38.8%,1
臺北市,文山區,1551,362,552,914,28,942,1578,59.7%,22.94%,1
臺北市,文山區,1552,328,500,828,26,854,1457,58.61%,22.51%,1
臺北市,文山區,1553,275,511,786,38,824,1326,62.14%,20.74%,1
臺北市,文山區,1554,306,524,830,33,863,1393,61.95%,21.97%,1
臺北市,文山區,1555,305,440,745,46,791,1377,57.44%,22.15%,1
臺北市,文山區,1556,378,459,837,35,872,1448,60.22%,26.1%,1
臺北市,文山區,1557,353,532,885,35,920,1447,63.58%,24.4%,1
臺北市,文山區,1558,460,634,1094,42,1136,1739,65.32%,26.45%,1
臺北市,文山區,1559,381,486,867,19,886,1457,60.81%,26.15%,1
臺北市,文山區,1560,313,464,777,39,816,1288,63.35%,24.3%,1
臺北市,文山區,1561,269,411,680,38,718,1301,55.19%,20.68%,1
臺北市,文山區,1562,158,277,435,44,479,865,55.38%,18.27%,1
臺北市,文山區,1563,144,268,412,29,441,789,55.89%,18.25%,1
臺北市,南港區,0455,254,420,674,24,698,1280,54.53%,19.84%,1
臺北市,南港區,0456,292,460,752,22,774,1351,57.29%,21.61%,1
臺北市,南港區,0457,300,450,750,42,792,1345,58.88%,22.3%,1
臺北市,南港區,0458,292,435,727,28,755,1679,44.97%,17.39%,1
臺北市,南港區,0459,357,510,867,36,903,1680,53.75%,21.25%,1
臺北市,南港區,0460,320,489,809,49,858,1635,52.48%,19.57%,1
臺北市,南港區,0461,277,495,772,43,815,1459,55.86%,18.99%,1
臺北市,南港區,0462,384,573,957,21,978,1706,57.33%,22.51%,1
臺北市,南港區,0463,305,546,851,47,898,1674,53.64%,18.22%,1
臺北市,南港區,0464,333,493,826,10,836,1491,56.07%,22.33%,1
臺北市,南港區,0465,256,420,676,24,700,1086,64.46%,23.57%,1
臺北市,南港區,0466,292,438,730,46,776,1202,64.56%,24.29%,1
臺北市,南港區,0467,293,388,681,39,720,1198,60.1%,24.46%,1
臺北市,南港區,0468,330,428,758,23,781,1430,54.62%,23.08%,1
臺北市,南港區,0469,334,413,747,39,786,1275,61.65%,26.2%,1
臺北市,南港區,0470,390,436,826,44,870,1344,64.73%,29.02%,1
臺北市,南港區,0471,373,435,808,31,839,1391,60.32%,26.82%,1
臺北市,南港區,0472,363,441,804,19,823,1342,61.33%,27.05%,1
臺北市,南港區,0473,315,416,731,31,762,1389,54.86%,22.68%,1
臺北市,南港區,0474,354,483,837,34,871,1426,61.08%,24.82%,1
臺北市,南港區,0475,237,547,784,29,813,1359,59.82%,17.44%,1
臺北市,南港區,0476,261,484,745,47,792,1366,57.98%,19.11%,1
臺北市,南港區,0477,324,511,835,19,854,1441,59.26%,22.48%,1
臺北市,南港區,0478,298,496,794,49,843,1529,55.13%,19.49%,1
臺北市,南港區,0479,344,481,825,39,864,1618,53.4%,21.26%,1
臺北市,南港區,0480,281,427,708,52,760,1545,49.19%,18.19%,1
臺北市,南港區,0481,312,557,869,35,904,1569,57.62%,19.89%,1
臺北市,南港區,0482,340,463,803,40,843,1661,50.75%,20.47%,1
臺北市,南港區,0483,323,434,757,47,804,1518,52.96%,21.28%,1
臺北市,南港區,0484,370,560,930,38,968,1552,62.37%,23.84%,1
臺北市,南港區,0485,332,555,887,23,910,1658,54.89%,20.02%,1
臺北市,南港區,0486,335,546,881,58,939,1608,58.4%,20.83%,1
臺北市,南港區,0487,302,479,781,31,812,1475,55.05%,20.47%,1
臺北市,南港區,0488,416,581,997,32,1029,1722,59.76%,24.16%,1
臺北市,南港區,0489,336,542,878,21,899,1383,65%,24.3%,1
臺北市,南港區,0490,297,485,782,39,821,1397,58.77%,21.26%,1
臺北市,南港區,0491,276,503,779,43,822,1352,60.8%,20.41%,1
臺北市,南港區,0492,294,487,781,31,812,1344,60.42%,21.88%,1
臺北市,南港區,0493,314,424,738,22,760,1385,54.87%,22.67%,1
臺北市,南港區,0494,291,461,752,48,800,1399,57.18%,20.8%,1
臺北市,南港區,0495,306,430,736,28,764,1381,55.32%,22.16%,1
臺北市,南港區,0496,312,513,825,36,861,1548,55.62%,20.16%,1
臺北市,南港區,0497,268,384,652,19,671,1190,56.39%,22.52%,1
臺北市,南港區,0498,357,492,849,29,878,1490,58.93%,23.96%,1
臺北市,南港區,0499,257,390,647,25,672,1096,61.31%,23.45%,1
臺北市,南港區,0500,289,459,748,29,777,1238,62.76%,23.34%,1
臺北市,南港區,0501,296,468,764,25,789,1271,62.08%,23.29%,1
臺北市,南港區,0502,227,400,627,41,668,1146,58.29%,19.81%,1
臺北市,南港區,0503,266,413,679,32,711,1232,57.71%,21.59%,1
臺北市,南港區,0504,322,483,805,28,833,1649,50.52%,19.53%,1
臺北市,南港區,0505,347,617,964,32,996,1688,59%,20.56%,1
臺北市,南港區,0506,325,549,874,32,906,1503,60.28%,21.62%,1
臺北市,南港區,0507,243,622,865,28,893,1542,57.91%,15.76%,1
臺北市,南港區,0508,287,536,823,42,865,1463,59.13%,19.62%,1
臺北市,南港區,0509,273,433,706,57,763,1195,63.85%,22.85%,1
臺北市,南港區,0510,306,436,742,11,753,1254,60.05%,24.4%,1
臺北市,南港區,0511,280,497,777,28,805,1356,59.37%,20.65%,1
臺北市,南港區,0512,295,460,755,78,833,1363,61.12%,21.64%,1
臺北市,南港區,0513,311,488,799,36,835,1317,63.4%,23.61%,1
臺北市,南港區,0514,316,452,768,22,790,1331,59.35%,23.74%,1
臺北市,南港區,0515,339,548,887,48,935,1610,58.07%,21.06%,1
臺北市,南港區,0516,318,520,838,25,863,1542,55.97%,20.62%,1
臺北市,南港區,0517,329,568,897,45,942,1581,59.58%,20.81%,1
臺北市,南港區,0518,269,479,748,27,775,1225,63.27%,21.96%,1
臺北市,南港區,0519,313,442,755,54,809,1264,64%,24.76%,1
臺北市,南港區,0520,384,576,960,61,1021,1649,61.92%,23.29%,1
臺北市,南港區,0521,299,440,739,25,764,1267,60.3%,23.6%,1
臺北市,南港區,0522,276,491,767,21,788,1336,58.98%,20.66%,1
臺北市,南港區,0523,264,443,707,24,731,1162,62.91%,22.72%,1
臺北市,南港區,0524,240,368,608,22,630,1045,60.29%,22.97%,1
臺北市,南港區,0525,417,439,856,42,898,1351,66.47%,30.87%,1
臺北市,南港區,0526,284,489,773,32,805,1358,59.28%,20.91%,1
臺北市,內湖區,0305,323,529,852,18,870,1661,52.38%,19.45%,1
臺北市,內湖區,0306,342,499,841,52,893,1602,55.74%,21.35%,1
臺北市,內湖區,0307,342,596,938,71,1009,1655,60.97%,20.66%,1
臺北市,內湖區,0308,387,542,929,31,960,1582,60.68%,24.46%,1
臺北市,內湖區,0309,383,532,915,24,939,1688,55.63%,22.69%,1
臺北市,內湖區,0310,423,534,957,52,1009,1737,58.09%,24.35%,1
臺北市,內湖區,0311,429,594,1023,44,1067,1809,58.98%,23.71%,1
臺北市,內湖區,0312,288,477,765,22,787,1376,57.19%,20.93%,1
臺北市,內湖區,0313,357,635,992,67,1059,1747,60.62%,20.44%,1
臺北市,內湖區,0314,310,512,822,23,845,1389,60.84%,22.32%,1
臺北市,內湖區,0315,380,501,881,31,912,1454,62.72%,26.13%,1
臺北市,內湖區,0316,365,536,901,34,935,1468,63.69%,24.86%,1
臺北市,內湖區,0317,375,595,970,39,1009,1603,62.94%,23.39%,1
臺北市,內湖區,0318,373,603,976,28,1004,1795,55.93%,20.78%,1
臺北市,內湖區,0319,432,618,1050,39,1089,1737,62.69%,24.87%,1
臺北市,內湖區,0320,394,609,1003,50,1053,1744,60.38%,22.59%,1
臺北市,內湖區,0321,355,570,925,41,966,1661,58.16%,21.37%,1
臺北市,內湖區,0322,382,507,889,31,920,1577,58.34%,24.22%,1
臺北市,內湖區,0323,365,547,912,26,938,1494,62.78%,24.43%,1
臺北市,內湖區,0324,332,603,935,33,968,1626,59.53%,20.42%,1
臺北市,內湖區,0325,328,596,924,55,979,1641,59.66%,19.99%,1
臺北市,內湖區,0326,357,532,889,30,919,1554,59.14%,22.97%,1
臺北市,內湖區,0327,412,582,994,59,1053,1728,60.94%,23.84%,1
臺北市,內湖區,0328,355,600,955,41,996,1736,57.37%,20.45%,1
臺北市,內湖區,0329,344,555,899,39,938,1461,64.2%,23.55%,1
臺北市,內湖區,0330,319,564,883,22,905,1509,59.97%,21.14%,1
臺北市,內湖區,0331,319,438,757,24,781,1358,57.51%,23.49%,1
臺北市,內湖區,0332,393,593,986,31,1017,1761,57.75%,22.32%,1
臺北市,內湖區,0333,384,550,934,33,967,1651,58.57%,23.26%,1
臺北市,內湖區,0334,396,636,1032,53,1085,1809,59.98%,21.89%,1
臺北市,內湖區,0335,384,611,995,42,1037,1773,58.49%,21.66%,1
臺北市,內湖區,0336,289,612,901,29,930,1890,49.21%,15.29%,1
臺北市,內湖區,0337,436,640,1076,43,1119,1760,63.58%,24.77%,1
臺北市,內湖區,0338,345,594,939,37,976,1645,59.33%,20.97%,1
臺北市,內湖區,0339,321,472,793,22,815,1324,61.56%,24.24%,1
臺北市,內湖區,0340,213,428,641,27,668,1072,62.31%,19.87%,1
臺北市,內湖區,0341,309,523,832,29,861,1509,57.06%,20.48%,1
臺北市,內湖區,0342,374,566,940,68,1008,1715,58.78%,21.81%,1
臺北市,內湖區,0343,280,738,1018,32,1050,1774,59.19%,15.78%,1
臺北市,內湖區,0344,422,699,1121,32,1153,1796,64.2%,23.5%,1
臺北市,內湖區,0345,356,629,985,31,1016,1784,56.95%,19.96%,1
臺北市,內湖區,0346,344,489,833,50,883,1417,62.31%,24.28%,1
臺北市,內湖區,0347,435,524,959,21,980,1699,57.68%,25.6%,1
臺北市,內湖區,0348,448,599,1047,34,1081,1719,62.89%,26.06%,1
臺北市,內湖區,0349,400,576,976,38,1014,1715,59.13%,23.32%,1
臺北市,內湖區,0350,347,496,843,23,866,1634,53%,21.24%,1
臺北市,內湖區,0351,276,493,769,43,812,1435,56.59%,19.23%,1
臺北市,內湖區,0352,324,483,807,30,837,1440,58.13%,22.5%,1
臺北市,內湖區,0353,355,520,875,24,899,1446,62.17%,24.55%,1
臺北市,內湖區,0354,346,515,861,43,904,1657,54.56%,20.88%,1
臺北市,內湖區,0355,281,450,731,52,783,1261,62.09%,22.28%,1
臺北市,內湖區,0356,83,128,211,27,238,456,52.19%,18.2%,1
臺北市,內湖區,0357,367,555,922,23,945,1433,65.95%,25.61%,1
臺北市,內湖區,0358,333,533,866,25,891,1485,60%,22.42%,1
臺北市,內湖區,0359,362,516,878,31,909,1590,57.17%,22.77%,1
臺北市,內湖區,0360,293,448,741,51,792,1219,64.97%,24.04%,1
臺北市,內湖區,0361,326,600,926,49,975,1732,56.29%,18.82%,1
臺北市,內湖區,0362,367,627,994,32,1026,1727,59.41%,21.25%,1
臺北市,內湖區,0363,330,597,927,45,972,1637,59.38%,20.16%,1
臺北市,內湖區,0364,307,494,801,31,832,1453,57.26%,21.13%,1
臺北市,內湖區,0365,331,558,889,28,917,1617,56.71%,20.47%,1
臺北市,內湖區,0366,356,525,881,30,911,1604,56.8%,22.19%,1
臺北市,內湖區,0367,362,513,875,22,897,1406,63.8%,25.75%,1
臺北市,內湖區,0368,345,455,800,31,831,1353,61.42%,25.5%,1
臺北市,內湖區,0369,641,376,1017,32,1049,1724,60.85%,37.18%,1
臺北市,內湖區,0370,322,484,806,29,835,1378,60.6%,23.37%,1
臺北市,內湖區,0371,327,512,839,22,861,1403,61.37%,23.31%,1
臺北市,內湖區,0372,321,527,848,30,878,1547,56.76%,20.75%,1
臺北市,內湖區,0373,410,590,1000,38,1038,1718,60.42%,23.86%,1
臺北市,內湖區,0374,406,593,999,44,1043,1813,57.53%,22.39%,1
臺北市,內湖區,0375,404,676,1080,46,1126,1791,62.87%,22.56%,1
臺北市,內湖區,0376,435,663,1098,39,1137,1855,61.29%,23.45%,1
臺北市,內湖區,0377,356,635,991,23,1014,1731,58.58%,20.57%,1
臺北市,內湖區,0378,412,569,981,42,1023,1593,64.22%,25.86%,1
臺北市,內湖區,0379,347,659,1006,42,1048,1869,56.07%,18.57%,1
臺北市,內湖區,0380,388,587,975,46,1021,1687,60.52%,23%,1
臺北市,內湖區,0381,359,542,901,15,916,1530,59.87%,23.46%,1
臺北市,內湖區,0382,283,477,760,43,803,1300,61.77%,21.77%,1
臺北市,內湖區,0383,254,554,808,37,845,1314,64.31%,19.33%,1
臺北市,內湖區,0384,309,430,739,19,758,1433,52.9%,21.56%,1
臺北市,內湖區,0385,317,455,772,25,797,1450,54.97%,21.86%,1
臺北市,內湖區,0386,344,529,873,49,922,1608,57.34%,21.39%,1
臺北市,內湖區,0387,336,477,813,32,845,1414,59.76%,23.76%,1
臺北市,內湖區,0388,359,103,462,23,485,1492,32.51%,24.06%,1
臺北市,內湖區,0389,305,498,803,25,828,1528,54.19%,19.96%,1
臺北市,內湖區,0390,365,586,951,30,981,1692,57.98%,21.57%,1
臺北市,內湖區,0391,356,523,879,39,918,1556,59%,22.88%,1
臺北市,內湖區,0392,343,542,885,31,916,1637,55.96%,20.95%,1
臺北市,內湖區,0393,403,532,935,30,965,1749,55.17%,23.04%,1
臺北市,內湖區,0394,238,419,657,28,685,1220,56.15%,19.51%,1
臺北市,內湖區,0395,330,543,873,51,924,1600,57.75%,20.63%,1
臺北市,內湖區,0396,325,489,814,40,854,1473,57.98%,22.06%,1
臺北市,內湖區,0397,328,478,806,51,857,1498,57.21%,21.9%,1
臺北市,內湖區,0398,341,523,864,34,898,1557,57.68%,21.9%,1
臺北市,內湖區,0399,337,534,871,28,899,1674,53.7%,20.13%,1
臺北市,內湖區,0400,387,622,1009,33,1042,1728,60.3%,22.4%,1
臺北市,內湖區,0401,129,224,353,55,408,788,51.78%,16.37%,1
臺北市,內湖區,0402,339,487,826,46,872,1542,56.55%,21.98%,1
臺北市,內湖區,0403,343,453,796,55,851,1676,50.78%,20.47%,1
臺北市,內湖區,0404,276,419,695,37,732,1360,53.82%,20.29%,1
臺北市,內湖區,0405,280,508,788,16,804,1259,63.86%,22.24%,1
臺北市,內湖區,0406,248,465,713,10,723,1301,55.57%,19.06%,1
臺北市,內湖區,0407,244,370,614,29,643,1251,51.4%,19.5%,1
臺北市,內湖區,0408,321,483,804,56,860,1502,57.26%,21.37%,1
臺北市,內湖區,0409,307,561,868,35,903,1596,56.58%,19.24%,1
臺北市,內湖區,0410,366,563,929,19,948,1649,57.49%,22.2%,1
臺北市,內湖區,0411,375,569,944,37,981,1774,55.3%,21.14%,1
臺北市,內湖區,0412,351,586,937,24,961,1746,55.04%,20.1%,1
臺北市,內湖區,0413,301,506,807,23,830,1473,56.35%,20.43%,1
臺北市,內湖區,0414,374,558,932,37,969,2824,34.31%,13.24%,1
臺北市,內湖區,0415,409,523,932,31,963,1849,52.08%,22.12%,1
臺北市,內湖區,0416,318,489,807,59,866,1530,56.6%,20.78%,1
臺北市,內湖區,0417,372,537,909,40,949,1656,57.31%,22.46%,1
臺北市,內湖區,0418,353,481,834,30,864,1457,59.3%,24.23%,1
臺北市,內湖區,0419,351,632,983,36,1019,1695,60.12%,20.71%,1
臺北市,內湖區,0420,382,577,959,27,986,1663,59.29%,22.97%,1
臺北市,內湖區,0421,339,572,911,37,948,1654,57.32%,20.5%,1
臺北市,內湖區,0422,394,556,950,36,986,1642,60.05%,24%,1
臺北市,內湖區,0423,398,557,955,25,980,1685,58.16%,23.62%,1
臺北市,內湖區,0424,371,632,1003,46,1049,1862,56.34%,19.92%,1
臺北市,內湖區,0425,454,646,1100,40,1140,1900,60%,23.89%,1
臺北市,內湖區,0426,395,705,1100,46,1146,1790,64.02%,22.07%,1
臺北市,內湖區,0427,304,473,777,41,818,1417,57.73%,21.45%,1
臺北市,內湖區,0428,347,587,934,36,970,1694,57.26%,20.48%,1
臺北市,內湖區,0429,307,555,862,59,921,1676,54.95%,18.32%,1
臺北市,內湖區,0430,388,532,920,15,935,1643,56.91%,23.62%,1
臺北市,內湖區,0431,364,540,904,36,940,1588,59.19%,22.92%,1
臺北市,內湖區,0432,365,539,904,53,957,1603,59.7%,22.77%,1
臺北市,內湖區,0433,371,550,921,31,952,1629,58.44%,22.77%,1
臺北市,內湖區,0434,395,584,979,39,1018,1646,61.85%,24%,1
臺北市,內湖區,0435,369,645,1014,30,1044,1883,55.44%,19.6%,1
臺北市,內湖區,0436,318,494,812,27,839,1434,58.51%,22.18%,1
臺北市,內湖區,0437,312,486,798,18,816,1418,57.55%,22%,1
臺北市,內湖區,0438,296,488,784,40,824,1373,60.01%,21.56%,1
臺北市,內湖區,0439,307,471,778,39,817,1349,60.56%,22.76%,1
臺北市,內湖區,0440,341,555,896,36,932,1511,61.68%,22.57%,1
臺北市,內湖區,0441,382,566,948,28,976,1563,62.44%,24.44%,1
臺北市,內湖區,0442,345,523,868,31,899,1550,58%,22.26%,1
臺北市,內湖區,0443,266,349,615,39,654,1157,56.53%,22.99%,1
臺北市,內湖區,0444,429,576,1005,32,1037,1768,58.65%,24.26%,1
臺北市,內湖區,0445,362,571,933,46,979,1664,58.83%,21.75%,1
臺北市,內湖區,0446,422,560,982,46,1028,1743,58.98%,24.21%,1
臺北市,內湖區,0447,333,530,863,20,883,1480,59.66%,22.5%,1
臺北市,內湖區,0448,398,541,939,43,982,1589,61.8%,25.05%,1
臺北市,內湖區,0449,299,459,758,27,785,1371,57.26%,21.81%,1
臺北市,內湖區,0450,376,586,962,18,980,1575,62.22%,23.87%,1
臺北市,內湖區,0451,329,464,793,18,811,1377,58.9%,23.89%,1
臺北市,內湖區,0452,402,524,926,44,970,1469,66.03%,27.37%,1
臺北市,內湖區,0453,388,564,952,15,967,1529,63.24%,25.38%,1
臺北市,內湖區,0454,434,547,981,30,1011,1649,61.31%,26.32%,1
臺北市,士林區,0142,350,549,899,63,962,1695,56.76%,20.65%,1
臺北市,士林區,0143,378,563,941,87,1028,1720,59.77%,21.98%,1
臺北市,士林區,0144,259,418,677,66,743,1288,57.69%,20.11%,1
臺北市,士林區,0145,326,495,821,47,868,1546,56.14%,21.09%,1
臺北市,士林區,0146,162,227,389,22,411,652,63.04%,24.85%,1
臺北市,士林區,0147,166,282,448,30,478,870,54.94%,19.08%,1
臺北市,士林區,0148,266,405,671,43,714,1137,62.8%,23.39%,1
臺北市,士林區,0149,235,385,620,41,661,1050,62.95%,22.38%,1
臺北市,士林區,0150,222,378,600,42,642,1031,62.27%,21.53%,1
臺北市,士林區,0151,241,388,629,13,642,1075,59.72%,22.42%,1
臺北市,士林區,0152,197,283,480,41,521,2175,23.95%,9.06%,1
臺北市,士林區,0153,322,548,870,76,946,1775,53.3%,18.14%,1
臺北市,士林區,0154,348,593,941,36,977,1669,58.54%,20.85%,1
臺北市,士林區,0155,405,551,956,56,1012,1665,60.78%,24.32%,1
臺北市,士林區,0156,382,592,974,52,1026,1648,62.26%,23.18%,1
臺北市,士林區,0157,246,458,704,21,725,1246,58.19%,19.74%,1
臺北市,士林區,0158,320,444,764,55,819,1419,57.72%,22.55%,1
臺北市,士林區,0159,294,420,714,68,782,1327,58.93%,22.16%,1
臺北市,士林區,0160,378,545,923,53,976,1573,62.05%,24.03%,1
臺北市,士林區,0161,300,516,816,58,874,1470,59.46%,20.41%,1
臺北市,士林區,0162,357,631,988,32,1020,1775,57.46%,20.11%,1
臺北市,士林區,0163,340,612,952,35,987,1692,58.33%,20.09%,1
臺北市,士林區,0164,392,638,1030,45,1075,1842,58.36%,21.28%,1
臺北市,士林區,0165,254,426,680,38,718,1166,61.58%,21.78%,1
臺北市,士林區,0166,319,501,820,66,886,1687,52.52%,18.91%,1
臺北市,士林區,0167,371,513,884,51,935,1624,57.57%,22.84%,1
臺北市,士林區,0168,330,532,862,68,930,1477,62.97%,22.34%,1
臺北市,士林區,0169,287,450,737,36,773,1250,61.84%,22.96%,1
臺北市,士林區,0170,325,470,795,57,852,1434,59.41%,22.66%,1
臺北市,士林區,0171,336,485,821,54,875,1452,60.26%,23.14%,1
臺北市,士林區,0172,347,568,915,48,963,1533,62.82%,22.64%,1
臺北市,士林區,0173,332,539,871,61,932,1515,61.52%,21.91%,1
臺北市,士林區,0174,295,401,696,37,733,1203,60.93%,24.52%,1
臺北市,士林區,0175,355,513,868,59,927,1487,62.34%,23.87%,1
臺北市,士林區,0176,262,435,697,28,725,1252,57.91%,20.93%,1
臺北市,士林區,0177,318,527,845,40,885,1536,57.62%,20.7%,1
臺北市,士林區,0178,324,573,897,49,946,1556,60.8%,20.82%,1
臺北市,士林區,0179,338,509,847,49,896,1511,59.3%,22.37%,1
臺北市,士林區,0180,379,536,915,48,963,1572,61.26%,24.11%,1
臺北市,士林區,0181,325,584,909,63,972,1668,58.27%,19.48%,1
臺北市,士林區,0182,358,642,1000,90,1090,1685,64.69%,21.25%,1
臺北市,士林區,0183,356,500,856,48,904,1568,57.65%,22.7%,1
臺北市,士林區,0184,272,415,687,45,732,1327,55.16%,20.5%,1
臺北市,士林區,0185,250,442,692,62,754,1338,56.35%,18.68%,1
臺北市,士林區,0186,292,450,742,54,796,1515,52.54%,19.27%,1
臺北市,士林區,0187,330,472,802,51,853,1452,58.75%,22.73%,1
臺北市,士林區,0188,320,490,810,37,847,1448,58.49%,22.1%,1
臺北市,士林區,0189,419,442,861,50,911,1521,59.89%,27.55%,1
臺北市,士林區,0190,334,471,805,36,841,1461,57.56%,22.86%,1
臺北市,士林區,0191,330,445,775,65,840,1541,54.51%,21.41%,1
臺北市,士林區,0192,303,418,721,36,757,1611,46.99%,18.81%,1
臺北市,士林區,0193,321,523,844,57,901,1595,56.49%,20.13%,1
臺北市,士林區,0194,321,517,838,45,883,1685,52.4%,19.05%,1
臺北市,士林區,0195,350,573,923,61,984,1816,54.19%,19.27%,1
臺北市,士林區,0196,330,554,884,80,964,1687,57.14%,19.56%,1
臺北市,士林區,0197,314,552,866,71,937,1646,56.93%,19.08%,1
臺北市,士林區,0198,302,544,846,44,890,1643,54.17%,18.38%,1
臺北市,士林區,0199,321,598,919,51,970,1687,57.5%,19.03%,1
臺北市,士林區,0200,339,587,926,53,979,1655,59.15%,20.48%,1
臺北市,士林區,0201,369,549,918,36,954,1779,53.63%,20.74%,1
臺北市,士林區,0202,419,623,1042,44,1086,1855,58.54%,22.59%,1
臺北市,士林區,0203,298,448,746,41,787,1350,58.3%,22.07%,1
臺北市,士林區,0204,252,474,726,34,760,1455,52.23%,17.32%,1
臺北市,士林區,0205,280,391,671,53,724,1497,48.36%,18.7%,1
臺北市,士林區,0206,390,246,636,39,675,1398,48.28%,27.9%,1
臺北市,士林區,0207,358,606,964,63,1027,1747,58.79%,20.49%,1
臺北市,士林區,0208,304,452,756,70,826,1465,56.38%,20.75%,1
臺北市,士林區,0209,287,505,792,64,856,1530,55.95%,18.76%,1
臺北市,士林區,0210,350,557,907,65,972,1855,52.4%,18.87%,1
臺北市,士林區,0211,306,459,765,70,835,1444,57.83%,21.19%,1
臺北市,士林區,0212,317,459,776,54,830,1563,53.1%,20.28%,1
臺北市,士林區,0213,296,500,796,59,855,1482,57.69%,19.97%,1
臺北市,士林區,0214,339,470,809,74,883,1552,56.89%,21.84%,1
臺北市,士林區,0215,355,596,951,62,1013,1790,56.59%,19.83%,1
臺北市,士林區,0216,289,505,794,68,862,1628,52.95%,17.75%,1
臺北市,士林區,0217,282,434,716,53,769,1337,57.52%,21.09%,1
臺北市,士林區,0218,361,560,921,73,994,1750,56.8%,20.63%,1
臺北市,士林區,0219,310,503,813,87,900,1668,53.96%,18.59%,1
臺北市,士林區,0220,221,384,605,60,665,1403,47.4%,15.75%,1
臺北市,士林區,0221,263,397,660,40,700,1468,47.68%,17.92%,1
臺北市,士林區,0222,243,437,680,46,726,1471,49.35%,16.52%,1
臺北市,士林區,0223,281,523,804,66,870,1666,52.22%,16.87%,1
臺北市,士林區,0224,308,463,771,64,835,1587,52.61%,19.41%,1
臺北市,士林區,0225,327,560,887,63,950,1987,47.81%,16.46%,1
臺北市,士林區,0226,252,384,636,20,656,1271,51.61%,19.83%,1
臺北市,士林區,0227,387,603,990,47,1037,1728,60.01%,22.4%,1
臺北市,士林區,0228,360,562,922,57,979,1630,60.06%,22.09%,1
臺北市,士林區,0229,355,568,923,40,963,1619,59.48%,21.93%,1
臺北市,士林區,0230,300,493,793,42,835,1425,58.6%,21.05%,1
臺北市,士林區,0231,390,575,965,45,1010,1623,62.23%,24.03%,1
臺北市,士林區,0232,350,524,874,56,930,1564,59.46%,22.38%,1
臺北市,士林區,0233,366,490,856,36,892,1376,64.83%,26.6%,1
臺北市,士林區,0234,320,593,913,27,940,1517,61.96%,21.09%,1
臺北市,士林區,0235,358,526,884,39,923,1729,53.38%,20.71%,1
臺北市,士林區,0236,344,550,894,35,929,1511,61.48%,22.77%,1
臺北市,士林區,0237,413,641,1054,36,1090,1811,60.19%,22.81%,1
臺北市,士林區,0238,361,517,878,30,908,1533,59.23%,23.55%,1
臺北市,士林區,0239,415,615,1030,43,1073,1657,64.76%,25.05%,1
臺北市,士林區,0240,329,501,830,25,855,1499,57.04%,21.95%,1
臺北市,士林區,0241,235,529,764,49,813,1402,57.99%,16.76%,1
臺北市,士林區,0242,321,449,770,60,830,1273,65.2%,25.22%,1
臺北市,士林區,0243,282,448,730,39,769,1273,60.41%,22.15%,1
臺北市,士林區,0244,300,443,743,41,784,1316,59.57%,22.8%,1
臺北市,士林區,0245,354,545,899,65,964,1659,58.11%,21.34%,1
臺北市,士林區,0246,423,527,950,41,991,1749,56.66%,24.19%,1
臺北市,士林區,0247,338,495,833,53,886,1552,57.09%,21.78%,1
臺北市,士林區,0248,294,573,867,45,912,1529,59.65%,19.23%,1
臺北市,士林區,0249,289,587,876,39,915,1644,55.66%,17.58%,1
臺北市,士林區,0250,376,584,960,50,1010,1779,56.77%,21.14%,1
臺北市,士林區,0251,353,522,875,38,913,1597,57.17%,22.1%,1
臺北市,士林區,0252,326,471,797,40,837,1454,57.57%,22.42%,1
臺北市,士林區,0253,390,524,914,52,966,1582,61.06%,24.65%,1
臺北市,士林區,0254,358,495,853,44,897,1518,59.09%,23.58%,1
臺北市,士林區,0255,318,462,780,19,799,1501,53.23%,21.19%,1
臺北市,士林區,0256,335,487,822,38,860,1420,60.56%,23.59%,1
臺北市,士林區,0257,335,498,833,51,884,1494,59.17%,22.42%,1
臺北市,士林區,0258,398,551,949,37,986,1568,62.88%,25.38%,1
臺北市,士林區,0259,320,410,730,39,769,1208,63.66%,26.49%,1
臺北市,士林區,0260,367,615,982,58,1040,1826,56.96%,20.1%,1
臺北市,士林區,0261,370,533,903,39,942,1647,57.19%,22.47%,1
臺北市,士林區,0262,362,531,893,51,944,1654,57.07%,21.89%,1
臺北市,士林區,0263,368,532,900,37,937,1550,60.45%,23.74%,1
臺北市,士林區,0264,365,427,792,27,819,1298,63.1%,28.12%,1
臺北市,士林區,0265,312,452,764,49,813,1297,62.68%,24.06%,1
臺北市,士林區,0266,312,408,720,49,769,1352,56.88%,23.08%,1
臺北市,士林區,0267,317,520,837,40,877,1522,57.62%,20.83%,1
臺北市,士林區,0268,389,463,852,58,910,1602,56.8%,24.28%,1
臺北市,士林區,0269,332,472,804,38,842,1441,58.43%,23.04%,1
臺北市,士林區,0270,320,390,710,15,725,1325,54.72%,24.15%,1
臺北市,士林區,0271,352,506,858,48,906,1567,57.82%,22.46%,1
臺北市,士林區,0272,447,375,822,27,849,1518,55.93%,29.45%,1
臺北市,士林區,0273,357,554,911,36,947,1549,61.14%,23.05%,1
臺北市,士林區,0274,403,509,912,25,937,1652,56.72%,24.39%,1
臺北市,士林區,0275,406,599,1005,59,1064,1766,60.25%,22.99%,1
臺北市,士林區,0276,360,525,885,24,909,1638,55.49%,21.98%,1
臺北市,士林區,0277,312,556,868,36,904,1491,60.63%,20.93%,1
臺北市,士林區,0278,336,531,867,24,891,1521,58.58%,22.09%,1
臺北市,士林區,0279,294,488,782,45,827,1351,61.21%,21.76%,1
臺北市,士林區,0280,361,546,907,27,934,1742,53.62%,20.72%,1
臺北市,士林區,0281,370,477,847,39,886,1585,55.9%,23.34%,1
臺北市,士林區,0282,318,545,863,31,894,1521,58.78%,20.91%,1
臺北市,士林區,0283,360,484,844,22,866,1543,56.12%,23.33%,1
臺北市,士林區,0284,295,513,808,29,837,1404,59.62%,21.01%,1
臺北市,士林區,0285,487,358,845,48,893,1541,57.95%,31.6%,1
臺北市,士林區,0286,323,527,850,30,880,1584,55.56%,20.39%,1
臺北市,士林區,0287,341,528,869,41,910,1519,59.91%,22.45%,1
臺北市,士林區,0288,304,458,762,24,786,1482,53.04%,20.51%,1
臺北市,士林區,0289,271,397,668,40,708,1243,56.96%,21.8%,1
臺北市,士林區,0290,229,387,616,47,663,1156,57.35%,19.81%,1
臺北市,士林區,0291,241,366,607,76,683,1262,54.12%,19.1%,1
臺北市,士林區,0292,179,319,498,35,533,889,59.96%,20.13%,1
臺北市,士林區,0293,205,293,498,29,527,858,61.42%,23.89%,1
臺北市,士林區,0294,199,279,478,51,529,945,55.98%,21.06%,1
臺北市,士林區,0295,185,303,488,47,535,960,55.73%,19.27%,1
臺北市,士林區,0296,161,295,456,39,495,876,56.51%,18.38%,1
臺北市,士林區,0297,137,194,331,33,364,556,65.47%,24.64%,1
臺北市,士林區,0298,171,347,518,56,574,919,62.46%,18.61%,1
臺北市,士林區,0299,309,505,814,88,902,1360,66.32%,22.72%,1
臺北市,士林區,0300,274,498,772,61,833,1355,61.48%,20.22%,1
臺北市,士林區,0301,273,441,714,26,740,1252,59.11%,21.81%,1
臺北市,士林區,0302,276,427,703,37,740,1182,62.61%,23.35%,1
臺北市,士林區,0303,262,412,674,31,705,1431,49.27%,18.31%,1
臺北市,士林區,0304,248,398,646,34,680,1240,54.84%,20%,1
臺北市,北投區,0001,462,286,748,55,803,1313,61.16%,35.19%,1
臺北市,北投區,0002,319,506,825,45,870,1403,62.01%,22.74%,1
臺北市,北投區,0003,274,352,626,34,660,1081,61.05%,25.35%,1
臺北市,北投區,0004,292,389,681,48,729,1209,60.3%,24.15%,1
臺北市,北投區,0005,303,441,744,38,782,1326,58.97%,22.85%,1
臺北市,北投區,0006,296,430,726,42,768,1263,60.81%,23.44%,1
臺北市,北投區,0007,370,531,901,62,963,1580,60.95%,23.42%,1
臺北市,北投區,0008,330,557,887,44,931,1577,59.04%,20.93%,1
臺北市,北投區,0009,331,504,835,58,893,1483,60.22%,22.32%,1
臺北市,北投區,0010,310,475,785,38,823,1461,56.33%,21.22%,1
臺北市,北投區,0011,321,455,776,51,827,1466,56.41%,21.9%,1
臺北市,北投區,0012,320,600,920,48,968,1620,59.75%,19.75%,1
臺北市,北投區,0013,280,528,808,30,838,1543,54.31%,18.15%,1
臺北市,北投區,0014,282,490,772,55,827,1513,54.66%,18.64%,1
臺北市,北投區,0015,300,548,848,40,888,1534,57.89%,19.56%,1
臺北市,北投區,0016,337,588,925,59,984,1650,59.64%,20.42%,1
臺北市,北投區,0017,331,526,857,40,897,1533,58.51%,21.59%,1
臺北市,北投區,0018,367,549,916,30,946,1702,55.58%,21.56%,1
臺北市,北投區,0019,438,508,946,33,979,1721,56.89%,25.45%,1
臺北市,北投區,0020,415,504,919,45,964,1575,61.21%,26.35%,1
臺北市,北投區,0021,353,487,840,57,897,1530,58.63%,23.07%,1
臺北市,北投區,0022,361,600,961,47,1008,1728,58.33%,20.89%,1
臺北市,北投區,0023,350,587,937,44,981,1702,57.64%,20.56%,1
臺北市,北投區,0024,363,544,907,55,962,1696,56.72%,21.4%,1
臺北市,北投區,0025,291,481,772,30,802,1684,47.62%,17.28%,1
臺北市,北投區,0026,384,604,988,44,1032,1717,60.1%,22.36%,1
臺北市,北投區,0027,350,570,920,25,945,1605,58.88%,21.81%,1
臺北市,北投區,0028,320,612,932,59,991,1723,57.52%,18.57%,1
臺北市,北投區,0029,362,591,953,40,993,1597,62.18%,22.67%,1
臺北市,北投區,0030,350,595,945,33,978,1700,57.53%,20.59%,1
臺北市,北投區,0031,434,337,771,32,803,1544,52.01%,28.11%,1
臺北市,北投區,0032,329,525,854,37,891,1635,54.5%,20.12%,1
臺北市,北投區,0033,327,523,850,27,877,1495,58.66%,21.87%,1
臺北市,北投區,0034,354,546,900,41,941,1619,58.12%,21.87%,1
臺北市,北投區,0035,35,511,546,38,584,1683,34.7%,2.08%,1
臺北市,北投區,0036,330,495,825,45,870,1662,52.35%,19.86%,1
臺北市,北投區,0037,340,548,888,21,909,1850,49.14%,18.38%,1
臺北市,北投區,0038,373,485,858,20,878,1674,52.45%,22.28%,1
臺北市,北投區,0039,298,562,860,60,920,1511,60.89%,19.72%,1
臺北市,北投區,0040,279,496,775,26,801,1393,57.5%,20.03%,1
臺北市,北投區,0041,289,473,762,47,809,1279,63.25%,22.6%,1
臺北市,北投區,0042,254,352,606,28,634,1122,56.51%,22.64%,1
臺北市,北投區,0043,312,519,831,48,879,1238,71%,25.2%,1
臺北市,北投區,0044,334,540,874,45,919,1477,62.22%,22.61%,1
臺北市,北投區,0045,327,545,872,45,917,1495,61.34%,21.87%,1
臺北市,北投區,0046,318,580,898,32,930,1469,63.31%,21.65%,1
臺北市,北投區,0047,273,540,813,45,858,1462,58.69%,18.67%,1
臺北市,北投區,0048,279,525,804,45,849,1431,59.33%,19.5%,1
臺北市,北投區,0049,348,483,831,37,868,1486,58.41%,23.42%,1
臺北市,北投區,0050,328,513,841,44,885,1449,61.08%,22.64%,1
臺北市,北投區,0051,350,478,828,32,860,1456,59.07%,24.04%,1
臺北市,北投區,0052,277,455,732,31,763,1311,58.2%,21.13%,1
臺北市,北投區,0053,293,473,766,46,812,1356,59.88%,21.61%,1
臺北市,北投區,0054,281,463,744,37,781,1338,58.37%,21%,1
臺北市,北投區,0055,324,535,859,31,890,1525,58.36%,21.25%,1
臺北市,北投區,0056,344,503,847,44,891,1620,55%,21.23%,1
臺北市,北投區,0057,290,496,786,21,807,1499,53.84%,19.35%,1
臺北市,北投區,0058,300,567,867,28,895,1497,59.79%,20.04%,1
臺北市,北投區,0059,362,521,883,43,926,1624,57.02%,22.29%,1
臺北市,北投區,0060,294,484,778,62,840,1536,54.69%,19.14%,1
臺北市,北投區,0061,330,508,838,58,896,1469,60.99%,22.46%,1
臺北市,北投區,0062,335,509,844,48,892,1598,55.82%,20.96%,1
臺北市,北投區,0063,370,531,901,27,928,1690,54.91%,21.89%,1
臺北市,北投區,0064,291,527,818,92,910,1599,56.91%,18.2%,1
臺北市,北投區,0065,370,510,880,42,922,1634,56.43%,22.64%,1
臺北市,北投區,0066,346,505,851,34,885,1660,53.31%,20.84%,1
臺北市,北投區,0067,378,564,942,58,1000,1900,52.63%,19.89%,1
臺北市,北投區,0068,402,568,970,50,1020,1797,56.76%,22.37%,1
臺北市,北投區,0069,413,612,1025,42,1067,1832,58.24%,22.54%,1
臺北市,北投區,0070,363,634,997,49,1046,1784,58.63%,20.35%,1
臺北市,北投區,0071,366,592,958,50,1008,1732,58.2%,21.13%,1
臺北市,北投區,0072,220,295,515,46,561,2035,27.57%,10.81%,1
臺北市,北投區,0073,333,469,802,57,859,1504,57.11%,22.14%,1
臺北市,北投區,0074,333,633,966,55,1021,1683,60.67%,19.79%,1
臺北市,北投區,0075,315,527,842,62,904,1635,55.29%,19.27%,1
臺北市,北投區,0076,329,520,849,60,909,1613,56.35%,20.4%,1
臺北市,北投區,0077,322,465,787,29,816,1483,55.02%,21.71%,1
臺北市,北投區,0078,331,484,815,43,858,1500,57.2%,22.07%,1
臺北市,北投區,0079,327,493,820,53,873,1483,58.87%,22.05%,1
臺北市,北投區,0080,321,495,816,57,873,1544,56.54%,20.79%,1
臺北市,北投區,0081,282,431,713,59,772,1532,50.39%,18.41%,1
臺北市,北投區,0082,367,606,973,49,1022,1819,56.18%,20.18%,1
臺北市,北投區,0083,389,502,891,62,953,1863,51.15%,20.88%,1
臺北市,北投區,0084,375,537,912,22,934,1872,49.89%,20.03%,1
臺北市,北投區,0085,320,541,861,41,902,1627,55.44%,19.67%,1
臺北市,北投區,0086,333,528,861,39,900,1696,53.07%,19.63%,1
臺北市,北投區,0087,424,541,965,39,1004,1841,54.54%,23.03%,1
臺北市,北投區,0088,305,410,715,38,753,1324,56.87%,23.04%,1
臺北市,北投區,0089,292,495,787,34,821,1504,54.59%,19.41%,1
臺北市,北投區,0090,305,509,814,38,852,1511,56.39%,20.19%,1
臺北市,北投區,0091,380,535,915,39,954,1615,59.07%,23.53%,1
臺北市,北投區,0092,241,400,641,30,671,1270,52.83%,18.98%,1
臺北市,北投區,0093,305,415,720,27,747,1492,50.07%,20.44%,1
臺北市,北投區,0094,331,416,747,30,777,1429,54.37%,23.16%,1
臺北市,北投區,0095,339,461,800,16,816,1567,52.07%,21.63%,1
臺北市,北投區,0096,303,451,754,33,787,1388,56.7%,21.83%,1
臺北市,北投區,0097,298,444,742,20,762,1448,52.62%,20.58%,1
臺北市,北投區,0098,267,417,684,41,725,1356,53.47%,19.69%,1
臺北市,北投區,0099,269,429,698,38,736,1308,56.27%,20.57%,1
臺北市,北投區,0100,256,415,671,43,714,1165,61.29%,21.97%,1
臺北市,北投區,0101,297,507,804,54,858,1429,60.04%,20.78%,1
臺北市,北投區,0102,269,515,784,22,806,1472,54.76%,18.27%,1
臺北市,北投區,0103,348,550,898,49,947,1508,62.8%,23.08%,1
臺北市,北投區,0104,285,524,809,43,852,1480,57.57%,19.26%,1
臺北市,北投區,0105,255,350,605,31,636,1142,55.69%,22.33%,1
臺北市,北投區,0106,300,494,794,28,822,1554,52.9%,19.31%,1
臺北市,北投區,0107,351,588,939,64,1003,1669,60.1%,21.03%,1
臺北市,北投區,0108,334,634,968,49,1017,1823,55.79%,18.32%,1
臺北市,北投區,0109,343,559,902,52,954,1739,54.86%,19.72%,1
臺北市,北投區,0110,313,578,891,57,948,1771,53.53%,17.67%,1
臺北市,北投區,0111,246,478,724,53,777,1468,52.93%,16.76%,1
臺北市,北投區,0112,292,501,793,31,824,1469,56.09%,19.88%,1
臺北市,北投區,0113,236,446,682,28,710,1094,64.9%,21.57%,1
臺北市,北投區,0114,197,466,663,44,707,1101,64.21%,17.89%,1
臺北市,北投區,0115,323,497,820,46,866,1422,60.9%,22.71%,1
臺北市,北投區,0116,229,503,732,48,780,1390,56.12%,16.47%,1
臺北市,北投區,0117,263,477,740,44,784,1307,59.98%,20.12%,1
臺北市,北投區,0118,290,426,716,55,771,1215,63.46%,23.87%,1
臺北市,北投區,0119,326,531,857,45,902,1642,54.93%,19.85%,1
臺北市,北投區,0120,292,539,831,32,863,1623,53.17%,17.99%,1
臺北市,北投區,0121,326,516,842,56,898,1621,55.4%,20.11%,1
臺北市,北投區,0122,310,423,733,23,756,1367,55.3%,22.68%,1
臺北市,北投區,0123,293,397,690,37,727,1309,55.54%,22.38%,1
臺北市,北投區,0124,309,450,759,33,792,1356,58.41%,22.79%,1
臺北市,北投區,0125,281,446,727,41,768,1365,56.26%,20.59%,1
臺北市,北投區,0126,353,488,841,34,875,1613,54.25%,21.88%,1
臺北市,北投區,0127,311,441,752,30,782,1590,49.18%,19.56%,1
臺北市,北投區,0128,343,564,907,57,964,1662,58%,20.64%,1
臺北市,北投區,0129,386,503,889,50,939,1622,57.89%,23.8%,1
臺北市,北投區,0130,417,549,966,29,995,1820,54.67%,22.91%,1
臺北市,北投區,0131,339,550,889,56,945,1615,58.51%,20.99%,1
臺北市,北投區,0132,252,442,694,60,754,1612,46.77%,15.63%,1
臺北市,北投區,0133,338,515,853,62,915,1652,55.39%,20.46%,1
臺北市,北投區,0134,352,566,918,26,944,1666,56.66%,21.13%,1
臺北市,北投區,0135,316,532,848,51,899,1641,54.78%,19.26%,1
臺北市,北投區,0136,132,163,295,27,322,528,60.98%,25%,1
臺北市,北投區,0137,285,435,720,67,787,1642,47.93%,17.36%,1
臺北市,北投區,0138,162,273,435,36,471,829,56.82%,19.54%,1
臺北市,北投區,0139,110,243,353,29,382,690,55.36%,15.94%,1
臺北市,北投區,0140,190,343,533,51,584,1067,54.73%,17.81%,1
臺北市,北投區,0141,170,277,447,60,507,892,56.84%,19.06%,1
新北市,板橋區,0894,286,420,706,71,777,1388,55.98%,20.61%,1
新北市,板橋區,0895,298,430,728,34,762,1294,58.89%,23.03%,1
新北市,板橋區,0896,170,222,392,13,405,667,60.72%,25.49%,1
新北市,板橋區,0897,154,294,448,36,484,898,53.9%,17.15%,1
新北市,板橋區,0898,170,306,476,30,506,829,61.04%,20.51%,1
新北市,板橋區,0899,135,303,438,25,463,739,62.65%,18.27%,1
新北市,板橋區,0900,242,343,585,45,630,1035,60.87%,23.38%,1
新北市,板橋區,0901,302,459,761,39,800,1713,46.7%,17.63%,1
新北市,板橋區,0902,114,213,327,12,339,658,51.52%,17.33%,1
新北市,板橋區,0903,234,422,656,81,737,1312,56.17%,17.84%,1
新北市,板橋區,0904,249,471,720,54,774,1492,51.88%,16.69%,1
新北市,板橋區,0905,235,438,673,56,729,1393,52.33%,16.87%,1
新北市,板橋區,0906,304,526,830,44,874,4742,18.43%,6.41%,1
新北市,板橋區,0907,273,465,738,45,783,1439,54.41%,18.97%,1
新北市,板橋區,0908,239,413,652,68,720,1187,60.66%,20.13%,1
新北市,板橋區,0909,218,375,593,38,631,1122,56.24%,19.43%,1
新北市,板橋區,0910,261,473,734,58,792,1363,58.11%,19.15%,1
新北市,板橋區,0911,220,376,596,51,647,1093,59.19%,20.13%,1
新北市,板橋區,0912,288,466,754,40,794,1331,59.65%,21.64%,1
新北市,板橋區,0913,222,375,597,47,644,1026,62.77%,21.64%,1
新北市,板橋區,0914,283,418,701,73,774,1244,62.22%,22.75%,1
新北市,板橋區,0915,235,381,616,75,691,1268,54.5%,18.53%,1
新北市,板橋區,0916,238,421,659,27,686,1313,52.25%,18.13%,1
新北市,板橋區,0917,277,421,698,34,732,1196,61.2%,23.16%,1
新北市,板橋區,0918,288,451,739,38,777,1137,68.34%,25.33%,1
新北市,板橋區,0919,305,468,773,38,811,1269,63.91%,24.03%,1
新北市,板橋區,0920,242,411,653,34,687,1117,61.5%,21.67%,1
新北市,板橋區,0921,208,416,624,38,662,1042,63.53%,19.96%,1
新北市,板橋區,0922,243,439,682,79,761,1257,60.54%,19.33%,1
新北市,板橋區,0923,225,445,670,56,726,1216,59.7%,18.5%,1
新北市,板橋區,0924,239,368,607,51,658,1126,58.44%,21.23%,1
新北市,板橋區,0925,300,492,792,55,847,1290,65.66%,23.26%,1
新北市,板橋區,0926,231,390,621,13,634,1215,52.18%,19.01%,1
新北市,板橋區,0927,205,369,574,26,600,1099,54.6%,18.65%,1
新北市,板橋區,0928,263,545,808,28,836,1329,62.9%,19.79%,1
新北市,板橋區,0929,162,420,582,22,604,996,60.64%,16.27%,1
新北市,板橋區,0930,210,394,604,28,632,1047,60.36%,20.06%,1
新北市,板橋區,0931,260,494,754,58,812,1272,63.84%,20.44%,1
新北市,板橋區,0932,252,459,711,41,752,1252,60.06%,20.13%,1
新北市,板橋區,0933,217,445,662,69,731,1238,59.05%,17.53%,1
新北市,板橋區,0934,319,496,815,65,880,1389,63.35%,22.97%,1
新北市,板橋區,0935,244,446,690,61,751,1194,62.9%,20.44%,1
新北市,板橋區,0936,192,341,533,54,587,1093,53.71%,17.57%,1
新北市,板橋區,0937,210,386,596,72,668,1148,58.19%,18.29%,1
新北市,板橋區,0938,265,453,718,51,769,1268,60.65%,20.9%,1
新北市,板橋區,0939,247,397,644,74,718,1230,58.37%,20.08%,1
新北市,板橋區,0940,178,361,539,39,578,1012,57.11%,17.59%,1
新北市,板橋區,0941,164,281,445,44,489,811,60.3%,20.22%,1
新北市,板橋區,0942,271,431,702,54,756,1197,63.16%,22.64%,1
新北市,板橋區,0943,202,415,617,30,647,1142,56.65%,17.69%,1
新北市,板橋區,0944,249,427,676,38,714,1222,58.43%,20.38%,1
新北市,板橋區,0945,149,325,474,38,512,796,64.32%,18.72%,1
新北市,板橋區,0946,233,346,579,69,648,997,64.99%,23.37%,1
新北市,板橋區,0947,230,348,578,36,614,1011,60.73%,22.75%,1
新北市,板橋區,0948,243,370,613,68,681,1157,58.86%,21%,1
新北市,板橋區,0949,209,370,579,57,636,1040,61.15%,20.1%,1
新北市,板橋區,0950,248,434,682,32,714,1173,60.87%,21.14%,1
新北市,板橋區,0951,218,408,626,29,655,1193,54.9%,18.27%,1
新北市,板橋區,0952,252,463,715,39,754,1255,60.08%,20.08%,1
新北市,板橋區,0953,297,450,747,32,779,1306,59.65%,22.74%,1
新北市,板橋區,0954,224,384,608,18,626,1050,59.62%,21.33%,1
新北市,板橋區,0955,181,337,518,36,554,942,58.81%,19.21%,1
新北市,板橋區,0956,227,454,681,37,718,1133,63.37%,20.04%,1
新北市,板橋區,0957,249,455,704,31,735,1251,58.75%,19.9%,1
新北市,板橋區,0958,264,473,737,41,778,1293,60.17%,20.42%,1
新北市,板橋區,0959,220,381,601,55,656,1208,54.3%,18.21%,1
新北市,板橋區,0960,244,417,661,53,714,1223,58.38%,19.95%,1
新北市,板橋區,0961,211,341,552,52,604,1061,56.93%,19.89%,1
新北市,板橋區,0962,316,520,836,40,876,1515,57.82%,20.86%,1
新北市,板橋區,0963,231,460,691,64,755,1225,61.63%,18.86%,1
新北市,板橋區,0964,220,463,683,34,717,1120,64.02%,19.64%,1
新北市,板橋區,0965,230,426,656,39,695,1091,63.7%,21.08%,1
新北市,板橋區,0966,239,609,848,21,869,1385,62.74%,17.26%,1
新北市,板橋區,0967,259,472,731,60,791,1283,61.65%,20.19%,1
新北市,板橋區,0968,249,413,662,72,734,1204,60.96%,20.68%,1
新北市,板橋區,0969,260,454,714,43,757,1191,63.56%,21.83%,1
新北市,板橋區,0970,225,406,631,55,686,1078,63.64%,20.87%,1
新北市,板橋區,0971,245,490,735,66,801,1351,59.29%,18.13%,1
新北市,板橋區,0972,274,450,724,56,780,1322,59%,20.73%,1
新北市,板橋區,0973,168,213,381,49,430,868,49.54%,19.35%,1
新北市,板橋區,0974,227,407,634,56,690,1029,67.06%,22.06%,1
新北市,板橋區,0975,330,584,914,34,948,1602,59.18%,20.6%,1
新北市,板橋區,0976,269,499,768,57,825,1362,60.57%,19.75%,1
新北市,板橋區,0977,341,558,899,66,965,1698,56.83%,20.08%,1
新北市,板橋區,0978,319,500,819,33,852,1495,56.99%,21.34%,1
新北市,板橋區,0979,330,444,774,78,852,1522,55.98%,21.68%,1
新北市,板橋區,0980,254,443,697,60,757,1279,59.19%,19.86%,1
新北市,板橋區,0981,251,452,703,54,757,1559,48.56%,16.1%,1
新北市,板橋區,0982,281,461,742,85,827,1537,53.81%,18.28%,1
新北市,板橋區,0983,292,456,748,57,805,1531,52.58%,19.07%,1
新北市,板橋區,0984,352,522,874,29,903,1720,52.5%,20.47%,1
新北市,板橋區,0985,214,384,598,39,637,1165,54.68%,18.37%,1
新北市,板橋區,0986,382,633,1015,45,1060,1857,57.08%,20.57%,1
新北市,板橋區,0987,201,357,558,68,626,1078,58.07%,18.65%,1
新北市,板橋區,0988,226,380,606,26,632,1177,53.7%,19.2%,1
新北市,板橋區,0989,433,600,1033,6,1039,1798,57.79%,24.08%,1
新北市,板橋區,0990,300,506,806,79,885,1455,60.82%,20.62%,1
新北市,板橋區,0991,251,448,699,65,764,1245,61.37%,20.16%,1
新北市,板橋區,0992,345,511,856,82,938,1704,55.05%,20.25%,1
新北市,板橋區,0993,382,509,891,25,916,1600,57.25%,23.88%,1
新北市,板橋區,0994,238,448,686,47,733,1409,52.02%,16.89%,1
新北市,板橋區,0995,240,445,685,53,738,1286,57.39%,18.66%,1
新北市,板橋區,0996,192,387,579,96,675,1359,49.67%,14.13%,1
新北市,板橋區,0997,250,347,597,45,642,1188,54.04%,21.04%,1
新北市,板橋區,0998,317,495,812,55,867,1627,53.29%,19.48%,1
新北市,板橋區,0999,344,359,703,40,743,1633,45.5%,21.07%,1
新北市,板橋區,1000,407,633,1040,64,1104,1814,60.86%,22.44%,1
新北市,板橋區,1001,353,638,991,59,1050,1810,58.01%,19.5%,1
新北市,板橋區,1002,216,385,601,59,660,1133,58.25%,19.06%,1
新北市,板橋區,1003,157,299,456,32,488,841,58.03%,18.67%,1
新北市,板橋區,1004,207,394,601,55,656,1050,62.48%,19.71%,1
新北市,板橋區,1005,224,341,565,70,635,1130,56.19%,19.82%,1
新北市,板橋區,1006,233,364,597,62,659,1056,62.41%,22.06%,1
新北市,板橋區,1007,228,330,558,48,606,1129,53.68%,20.19%,1
新北市,板橋區,1008,305,567,872,100,972,1713,56.74%,17.81%,1
新北市,板橋區,1009,292,587,879,67,946,1622,58.32%,18%,1
新北市,板橋區,1010,323,530,853,46,899,1427,63%,22.63%,1
新北市,板橋區,1011,334,564,898,26,924,1471,62.81%,22.71%,1
新北市,板橋區,1012,208,367,575,16,591,1076,54.93%,19.33%,1
新北市,板橋區,1013,189,293,482,22,504,979,51.48%,19.31%,1
新北市,板橋區,1014,213,445,658,28,686,1079,63.58%,19.74%,1
新北市,板橋區,1015,147,279,426,50,476,828,57.49%,17.75%,1
新北市,板橋區,1016,163,301,464,55,519,820,63.29%,19.88%,1
新北市,板橋區,1017,229,337,566,35,601,989,60.77%,23.15%,1
新北市,板橋區,1018,203,337,540,58,598,1023,58.46%,19.84%,1
新北市,板橋區,1019,193,362,555,34,589,1044,56.42%,18.49%,1
新北市,板橋區,1020,183,334,517,56,573,968,59.19%,18.9%,1
新北市,板橋區,1021,268,415,683,33,716,1222,58.59%,21.93%,1
新北市,板橋區,1022,260,469,729,37,766,1385,55.31%,18.77%,1
新北市,板橋區,1023,321,507,828,45,873,1585,55.08%,20.25%,1
新北市,板橋區,1024,347,612,959,60,1019,1840,55.38%,18.86%,1
新北市,板橋區,1025,366,685,1051,73,1124,1806,62.24%,20.27%,1
新北市,板橋區,1026,292,506,798,60,858,1506,56.97%,19.39%,1
新北市,板橋區,1027,276,490,766,61,827,1476,56.03%,18.7%,1
新北市,板橋區,1028,305,524,829,53,882,1500,58.8%,20.33%,1
新北市,板橋區,1029,219,405,624,70,694,1096,63.32%,19.98%,1
新北市,板橋區,1030,197,351,548,55,603,963,62.62%,20.46%,1
新北市,板橋區,1031,312,541,853,41,894,1601,55.84%,19.49%,1
新北市,板橋區,1032,346,529,875,65,940,1507,62.38%,22.96%,1
新北市,板橋區,1033,280,475,755,61,816,1315,62.05%,21.29%,1
新北市,板橋區,1034,233,409,642,24,666,1178,56.54%,19.78%,1
新北市,板橋區,1035,389,643,1032,71,1103,1822,60.54%,21.35%,1
新北市,板橋區,1036,334,613,947,57,1004,1605,62.55%,20.81%,1
新北市,板橋區,1037,232,644,876,26,902,1549,58.23%,14.98%,1
新北市,板橋區,1038,442,692,1134,27,1161,1948,59.6%,22.69%,1
新北市,板橋區,1039,397,654,1051,28,1079,1935,55.76%,20.52%,1
新北市,板橋區,1040,204,336,540,49,589,1097,53.69%,18.6%,1
新北市,板橋區,1041,215,344,559,42,601,1095,54.89%,19.63%,1
新北市,板橋區,1042,291,548,839,83,922,1678,54.95%,17.34%,1
新北市,板橋區,1043,294,589,883,85,968,1750,55.31%,16.8%,1
新北市,板橋區,1044,221,389,610,54,664,1187,55.94%,18.62%,1
新北市,板橋區,1045,243,402,645,37,682,1154,59.1%,21.06%,1
新北市,板橋區,1046,281,448,729,36,765,1262,60.62%,22.27%,1
新北市,板橋區,1047,200,441,641,74,715,1271,56.25%,15.74%,1
新北市,板橋區,1048,269,626,895,60,955,1410,67.73%,19.08%,1
新北市,板橋區,1049,324,519,843,72,915,1745,52.44%,18.57%,1
新北市,板橋區,1050,323,630,953,94,1047,1867,56.08%,17.3%,1
新北市,板橋區,1051,334,645,979,77,1056,1753,60.24%,19.05%,1
新北市,板橋區,1052,239,435,674,52,726,1204,60.3%,19.85%,1
新北市,板橋區,1053,305,525,830,58,888,1614,55.02%,18.9%,1
新北市,板橋區,1054,261,429,690,49,739,1237,59.74%,21.1%,1
新北市,板橋區,1055,292,444,736,69,805,1361,59.15%,21.45%,1
新北市,板橋區,1056,280,426,706,28,734,1243,59.05%,22.53%,1
新北市,板橋區,1057,287,460,747,34,781,1515,51.55%,18.94%,1
新北市,板橋區,1058,324,528,852,58,910,1515,60.07%,21.39%,1
新北市,板橋區,1059,173,356,529,56,585,949,61.64%,18.23%,1
新北市,板橋區,1060,298,532,830,72,902,1629,55.37%,18.29%,1
新北市,板橋區,1061,252,430,682,45,727,1238,58.72%,20.36%,1
新北市,板橋區,1062,128,235,363,32,395,901,43.84%,14.21%,1
新北市,板橋區,1063,303,498,801,71,872,1475,59.12%,20.54%,1
新北市,板橋區,1064,261,504,765,67,832,1481,56.18%,17.62%,1
新北市,板橋區,1065,295,574,869,84,953,1800,52.94%,16.39%,1
新北市,板橋區,1066,304,527,831,66,897,1630,55.03%,18.65%,1
新北市,板橋區,1067,280,450,730,46,776,1298,59.78%,21.57%,1
新北市,板橋區,1068,198,295,493,32,525,874,60.07%,22.65%,1
新北市,板橋區,1069,190,365,555,16,571,992,57.56%,19.15%,1
新北市,板橋區,1070,248,394,642,14,656,1034,63.44%,23.98%,1
新北市,板橋區,1071,335,456,791,75,866,1451,59.68%,23.09%,1
新北市,板橋區,1072,254,388,642,49,691,1130,61.15%,22.48%,1
新北市,板橋區,1073,265,533,798,49,847,1440,58.82%,18.4%,1
新北市,板橋區,1074,322,517,839,69,908,1531,59.31%,21.03%,1
新北市,板橋區,1075,313,488,801,59,860,1349,63.75%,23.2%,1
新北市,板橋區,1076,312,508,820,39,859,1593,53.92%,19.59%,1
新北市,板橋區,1077,219,434,653,22,675,1174,57.5%,18.65%,1
新北市,板橋區,1078,210,460,670,43,713,1228,58.06%,17.1%,1
新北市,板橋區,1079,152,522,674,27,701,1187,59.06%,12.81%,1
新北市,板橋區,1080,159,329,488,51,539,870,61.95%,18.28%,1
新北市,板橋區,1081,437,745,1182,35,1217,2033,59.86%,21.5%,1
新北市,板橋區,1082,287,430,717,51,768,1418,54.16%,20.24%,1
新北市,板橋區,1083,200,384,584,37,621,1075,57.77%,18.6%,1
新北市,板橋區,1084,273,531,804,36,840,1515,55.45%,18.02%,1
新北市,板橋區,1085,258,466,724,33,757,1182,64.04%,21.83%,1
新北市,板橋區,1086,396,593,989,65,1054,1893,55.68%,20.92%,1
新北市,板橋區,1087,239,402,641,46,687,1302,52.76%,18.36%,1
新北市,板橋區,1088,253,433,686,43,729,1366,53.37%,18.52%,1
新北市,板橋區,1089,286,475,761,70,831,1318,63.05%,21.7%,1
新北市,板橋區,1090,238,405,643,44,687,1200,57.25%,19.83%,1
新北市,板橋區,1091,464,636,1100,43,1143,2028,56.36%,22.88%,1
新北市,板橋區,1092,321,604,925,100,1025,1746,58.71%,18.38%,1
新北市,板橋區,1093,382,591,973,22,995,1954,50.92%,19.55%,1
新北市,板橋區,1094,299,486,785,47,832,1474,56.45%,20.28%,1
新北市,板橋區,1095,279,464,743,55,798,1418,56.28%,19.68%,1
新北市,板橋區,1096,356,547,903,69,972,1563,62.19%,22.78%,1
新北市,板橋區,1097,313,581,894,93,987,1780,55.45%,17.58%,1
新北市,板橋區,1098,351,547,898,47,945,1707,55.36%,20.56%,1
新北市,板橋區,1099,119,229,348,11,359,906,39.62%,13.13%,1
新北市,板橋區,1100,192,344,536,56,592,1030,57.48%,18.64%,1
新北市,板橋區,1101,226,383,609,48,657,1115,58.92%,20.27%,1
新北市,板橋區,1102,344,623,967,34,1001,1836,54.52%,18.74%,1
新北市,板橋區,1103,392,565,957,79,1036,1881,55.08%,20.84%,1
新北市,板橋區,1104,337,559,896,33,929,1688,55.04%,19.96%,1
新北市,板橋區,1105,382,620,1002,38,1040,1760,59.09%,21.7%,1
新北市,板橋區,1106,209,386,595,58,653,1044,62.55%,20.02%,1
新北市,板橋區,1107,214,391,605,38,643,1043,61.65%,20.52%,1
新北市,板橋區,1108,227,400,627,64,691,1099,62.88%,20.66%,1
新北市,板橋區,1109,239,428,667,52,719,1260,57.06%,18.97%,1
新北市,板橋區,1110,201,421,622,45,667,1131,58.97%,17.77%,1
新北市,板橋區,1111,229,453,682,40,722,1225,58.94%,18.69%,1
新北市,板橋區,1112,323,546,869,37,906,1455,62.27%,22.2%,1
新北市,板橋區,1113,218,442,660,62,722,1267,56.99%,17.21%,1
新北市,板橋區,1114,206,341,547,47,594,972,61.11%,21.19%,1
新北市,板橋區,1115,203,370,573,27,600,994,60.36%,20.42%,1
新北市,板橋區,1116,239,384,623,23,646,1111,58.15%,21.51%,1
新北市,板橋區,1117,239,472,711,70,781,1177,66.36%,20.31%,1
新北市,板橋區,1118,295,505,800,62,862,1544,55.83%,19.11%,1
新北市,板橋區,1119,175,391,566,61,627,1021,61.41%,17.14%,1
新北市,板橋區,1120,180,350,530,57,587,1040,56.44%,17.31%,1
新北市,板橋區,1121,307,488,795,32,827,1504,54.99%,20.41%,1
新北市,板橋區,1122,270,441,711,35,746,1373,54.33%,19.66%,1
新北市,板橋區,1123,264,337,601,25,626,1210,51.74%,21.82%,1
新北市,板橋區,1124,300,587,887,69,956,1809,52.85%,16.58%,1
新北市,板橋區,1125,275,568,843,67,910,1551,58.67%,17.73%,1
新北市,板橋區,1126,302,514,816,19,835,1408,59.3%,21.45%,1
新北市,板橋區,1127,283,452,735,33,768,1285,59.77%,22.02%,1
新北市,板橋區,1128,241,417,658,42,700,1102,63.52%,21.87%,1
新北市,板橋區,1129,246,460,706,40,746,1399,53.32%,17.58%,1
新北市,板橋區,1130,327,560,887,79,966,1692,57.09%,19.33%,1
新北市,板橋區,1131,343,592,935,32,967,1625,59.51%,21.11%,1
新北市,板橋區,1132,329,596,925,73,998,1712,58.29%,19.22%,1
新北市,板橋區,1133,253,437,690,34,724,1246,58.11%,20.3%,1
新北市,板橋區,1134,315,497,812,48,860,1471,58.46%,21.41%,1
新北市,板橋區,1135,311,646,957,65,1022,1761,58.04%,17.66%,1
新北市,板橋區,1136,302,504,806,56,862,1499,57.51%,20.15%,1
新北市,板橋區,1137,267,488,755,46,801,1528,52.42%,17.47%,1
新北市,板橋區,1138,333,532,865,49,914,1536,59.51%,21.68%,1
新北市,板橋區,1139,340,512,852,45,897,1550,57.87%,21.94%,1
新北市,板橋區,1140,396,703,1099,65,1164,2050,56.78%,19.32%,1
新北市,板橋區,1141,259,482,741,35,776,1300,59.69%,19.92%,1
新北市,板橋區,1142,258,582,840,48,888,1537,57.77%,16.79%,1
新北市,板橋區,1143,258,419,677,29,706,1341,52.65%,19.24%,1
新北市,板橋區,1144,327,530,857,61,918,1606,57.16%,20.36%,1
新北市,板橋區,1145,254,468,722,37,759,1433,52.97%,17.73%,1
新北市,板橋區,1146,293,554,847,40,887,1685,52.64%,17.39%,1
新北市,板橋區,1147,252,470,722,52,774,1248,62.02%,20.19%,1
新北市,板橋區,1148,210,400,610,45,655,1172,55.89%,17.92%,1
新北市,板橋區,1149,308,480,788,35,823,1640,50.18%,18.78%,1
新北市,板橋區,1150,270,471,741,42,783,1428,54.83%,18.91%,1
新北市,板橋區,1151,306,501,807,64,871,1527,57.04%,20.04%,1
新北市,板橋區,1152,267,506,773,22,795,1350,58.89%,19.78%,1
新北市,板橋區,1153,278,541,819,75,894,1582,56.51%,17.57%,1
新北市,板橋區,1154,171,397,568,32,600,919,65.29%,18.61%,1
新北市,板橋區,1155,184,331,515,27,542,930,58.28%,19.78%,1
新北市,板橋區,1156,184,403,587,28,615,974,63.14%,18.89%,1
新北市,板橋區,1157,342,630,972,40,1012,1732,58.43%,19.75%,1
新北市,板橋區,1158,275,470,745,66,811,1438,56.4%,19.12%,1
新北市,板橋區,1159,338,567,905,71,976,1777,54.92%,19.02%,1
新北市,板橋區,1160,279,547,826,53,879,1764,49.83%,15.82%,1
新北市,板橋區,1161,243,454,697,30,727,1289,56.4%,18.85%,1
新北市,板橋區,1162,218,420,638,54,692,1182,58.54%,18.44%,1
新北市,板橋區,1163,227,412,639,66,705,1174,60.05%,19.34%,1
新北市,板橋區,1164,348,578,926,82,1008,1870,53.9%,18.61%,1
新北市,板橋區,1165,403,627,1030,51,1081,1842,58.69%,21.88%,1
新北市,板橋區,1166,224,369,593,48,641,1094,58.59%,20.48%,1
新北市,板橋區,1167,207,416,623,51,674,1228,54.89%,16.86%,1
新北市,板橋區,1168,222,396,618,44,662,998,66.33%,22.24%,1
新北市,板橋區,1169,223,313,536,37,573,862,66.47%,25.87%,1
新北市,板橋區,1170,309,492,801,46,847,1622,52.22%,19.05%,1
新北市,板橋區,1171,204,464,668,58,726,1205,60.25%,16.93%,1
新北市,板橋區,1172,309,552,861,50,911,1787,50.98%,17.29%,1
新北市,板橋區,1173,336,551,887,34,921,1610,57.2%,20.87%,1
新北市,板橋區,1174,491,779,1270,42,1312,2216,59.21%,22.16%,1
新北市,板橋區,1175,478,756,1234,45,1279,2294,55.75%,20.84%,1
新北市,板橋區,1176,393,677,1070,67,1137,2090,54.4%,18.8%,1
新北市,板橋區,1177,225,429,654,28,682,1356,50.29%,16.59%,1
新北市,板橋區,1178,216,386,602,31,633,1067,59.33%,20.24%,1
新北市,板橋區,1179,257,480,737,46,783,1319,59.36%,19.48%,1
新北市,板橋區,1180,246,440,686,42,728,1316,55.32%,18.69%,1
新北市,板橋區,1181,210,382,592,58,650,1195,54.39%,17.57%,1
新北市,板橋區,1182,178,285,463,24,487,857,56.83%,20.77%,1
新北市,板橋區,1183,266,435,701,70,771,1417,54.41%,18.77%,1
新北市,板橋區,1184,340,488,828,77,905,1560,58.01%,21.79%,1
新北市,板橋區,1185,337,575,912,93,1005,1747,57.53%,19.29%,1
新北市,板橋區,1186,251,457,708,40,748,1176,63.61%,21.34%,1
新北市,板橋區,1187,241,381,622,27,649,1101,58.95%,21.89%,1
新北市,板橋區,1188,333,490,823,24,847,1458,58.09%,22.84%,1
新北市,板橋區,1189,380,393,773,49,822,1630,50.43%,23.31%,1
新北市,板橋區,1190,314,500,814,87,901,1611,55.93%,19.49%,1
新北市,板橋區,1191,189,416,605,38,643,1139,56.45%,16.59%,1
新北市,板橋區,1192,240,355,595,31,626,1120,55.89%,21.43%,1
新北市,板橋區,1193,192,378,570,83,653,1022,63.89%,18.79%,1
新北市,板橋區,1194,197,372,569,72,641,1049,61.11%,18.78%,1
新北市,板橋區,1195,189,388,577,15,592,1007,58.79%,18.77%,1
新北市,板橋區,1196,244,520,764,26,790,1393,56.71%,17.52%,1
新北市,板橋區,1197,59,102,161,38,199,474,41.98%,12.45%,1
新北市,板橋區,1198,104,165,269,30,299,500,59.8%,20.8%,1
新北市,板橋區,1199,236,401,637,44,681,1177,57.86%,20.05%,1
新北市,板橋區,1200,197,439,636,29,665,1186,56.07%,16.61%,1
新北市,板橋區,1201,229,416,645,56,701,1139,61.55%,20.11%,1
新北市,板橋區,1202,274,639,913,60,973,1750,55.6%,15.66%,1
新北市,板橋區,1203,413,753,1166,40,1206,3451,34.95%,11.97%,1
新北市,板橋區,1204,291,490,781,70,851,1620,52.53%,17.96%,1
新北市,板橋區,1205,167,266,433,21,454,903,50.28%,18.49%,1
新北市,板橋區,1206,236,449,685,39,724,1232,58.77%,19.16%,1
新北市,板橋區,1207,185,284,469,23,492,975,50.46%,18.97%,1
新北市,板橋區,1208,223,414,637,35,672,1224,54.9%,18.22%,1
新北市,板橋區,1209,235,454,689,42,731,1291,56.62%,18.2%,1
新北市,板橋區,1210,334,537,871,47,918,1828,50.22%,18.27%,1
新北市,板橋區,1211,320,502,822,58,880,1725,51.01%,18.55%,1
新北市,板橋區,1212,178,329,507,26,533,1085,49.12%,16.41%,1
新北市,板橋區,1213,417,744,1161,58,1219,2357,51.72%,17.69%,1
新北市,板橋區,1214,311,492,803,37,840,1560,53.85%,19.94%,1
新北市,板橋區,1215,350,606,956,32,988,2201,44.89%,15.9%,1
新北市,板橋區,1216,306,512,818,48,866,1626,53.26%,18.82%,1
新北市,板橋區,1217,269,530,799,31,830,1786,46.47%,15.06%,1
新北市,板橋區,1218,300,597,897,52,949,1763,53.83%,17.02%,1
新北市,板橋區,1219,322,533,855,27,882,1744,50.57%,18.46%,1
新北市,板橋區,1220,290,538,828,51,879,1645,53.43%,17.63%,1
新北市,板橋區,1221,319,571,890,33,923,1861,49.6%,17.14%,1
新北市,板橋區,1222,255,519,774,34,808,1596,50.63%,15.98%,1
新北市,板橋區,1223,338,617,955,59,1014,1871,54.2%,18.07%,1
新北市,板橋區,1224,370,645,1015,48,1063,1938,54.85%,19.09%,1
新北市,板橋區,1225,367,607,974,42,1016,1827,55.61%,20.09%,1
新北市,板橋區,1226,242,447,689,34,723,1359,53.2%,17.81%,1
新北市,板橋區,1227,282,561,843,48,891,1613,55.24%,17.48%,1
新北市,板橋區,1228,287,533,820,68,888,1566,56.7%,18.33%,1
新北市,板橋區,1229,337,550,887,50,937,1552,60.37%,21.71%,1
新北市,板橋區,1230,391,580,971,29,1000,1885,53.05%,20.74%,1
新北市,板橋區,1231,329,596,925,79,1004,1893,53.04%,17.38%,1
新北市,三重區,0659,296,468,764,45,809,1509,53.61%,19.62%,1
新北市,三重區,0660,305,557,862,58,920,1591,57.83%,19.17%,1
新北市,三重區,0661,353,554,907,56,963,1653,58.26%,21.36%,1
新北市,三重區,0662,283,462,745,65,810,1392,58.19%,20.33%,1
新北市,三重區,0663,271,542,813,70,883,1451,60.85%,18.68%,1
新北市,三重區,0664,278,432,710,66,776,1329,58.39%,20.92%,1
新北市,三重區,0665,289,512,801,39,840,1459,57.57%,19.81%,1
新北市,三重區,0666,208,371,579,51,630,1024,61.52%,20.31%,1
新北市,三重區,0667,209,381,590,51,641,1066,60.13%,19.61%,1
新北市,三重區,0668,197,315,512,51,563,856,65.77%,23.01%,1
新北市,三重區,0669,154,244,398,37,435,764,56.94%,20.16%,1
新北市,三重區,0670,165,309,474,39,513,821,62.48%,20.1%,1
新北市,三重區,0671,360,608,968,52,1020,1887,54.05%,19.08%,1
新北市,三重區,0672,347,481,828,47,875,1646,53.16%,21.08%,1
新北市,三重區,0673,86,114,200,18,218,358,60.89%,24.02%,1
新北市,三重區,0674,215,360,575,51,626,1039,60.25%,20.69%,1
新北市,三重區,0675,268,379,647,29,676,1114,60.68%,24.06%,1
新北市,三重區,0676,347,554,901,30,931,1588,58.63%,21.85%,1
新北市,三重區,0677,295,585,880,30,910,1702,53.47%,17.33%,1
新北市,三重區,0678,294,437,731,58,789,1288,61.26%,22.83%,1
新北市,三重區,0679,356,568,924,62,986,1629,60.53%,21.85%,1
新北市,三重區,0680,375,631,1006,44,1050,1861,56.42%,20.15%,1
新北市,三重區,0681,306,555,861,50,911,1727,52.75%,17.72%,1
新北市,三重區,0682,371,600,971,38,1009,1813,55.65%,20.46%,1
新北市,三重區,0683,295,538,833,67,900,1595,56.43%,18.5%,1
新北市,三重區,0684,305,509,814,70,884,1513,58.43%,20.16%,1
新北市,三重區,0685,413,365,778,48,826,4433,18.63%,9.32%,1
新北市,三重區,0686,230,471,701,45,746,1283,58.14%,17.93%,1
新北市,三重區,0687,297,521,818,54,872,1430,60.98%,20.77%,1
新北市,三重區,0688,299,491,790,24,814,1357,59.99%,22.03%,1
新北市,三重區,0689,201,336,537,35,572,963,59.4%,20.87%,1
新北市,三重區,0690,190,292,482,45,527,883,59.68%,21.52%,1
新北市,三重區,0691,397,350,747,75,822,1494,55.02%,26.57%,1
新北市,三重區,0692,356,534,890,62,952,1616,58.91%,22.03%,1
新北市,三重區,0693,293,414,707,50,757,1329,56.96%,22.05%,1
新北市,三重區,0694,287,476,763,44,807,1289,62.61%,22.27%,1
新北市,三重區,0695,276,473,749,59,808,1380,58.55%,20%,1
新北市,三重區,0696,365,540,905,41,946,1668,56.71%,21.88%,1
新北市,三重區,0697,272,440,712,64,776,1226,63.3%,22.19%,1
新北市,三重區,0698,306,516,822,37,859,1421,60.45%,21.53%,1
新北市,三重區,0699,273,486,759,51,810,1364,59.38%,20.01%,1
新北市,三重區,0700,244,434,678,52,730,1232,59.25%,19.81%,1
新北市,三重區,0701,260,456,716,57,773,1248,61.94%,20.83%,1
新北市,三重區,0702,265,435,700,54,754,1256,60.03%,21.1%,1
新北市,三重區,0703,342,545,887,46,933,1506,61.95%,22.71%,1
新北市,三重區,0704,368,575,943,47,990,1669,59.32%,22.05%,1
新北市,三重區,0705,254,443,697,68,765,1308,58.49%,19.42%,1
新北市,三重區,0706,303,479,782,46,828,1263,65.56%,23.99%,1
新北市,三重區,0707,299,469,768,70,838,1471,56.97%,20.33%,1
新北市,三重區,0708,306,476,782,90,872,1447,60.26%,21.15%,1
新北市,三重區,0709,295,484,779,55,834,1693,49.26%,17.42%,1
新北市,三重區,0710,411,635,1046,48,1094,2015,54.29%,20.4%,1
新北市,三重區,0711,279,612,891,66,957,1812,52.81%,15.4%,1
新北市,三重區,0712,306,452,758,32,790,1509,52.35%,20.28%,1
新北市,三重區,0713,373,407,780,54,834,1439,57.96%,25.92%,1
新北市,三重區,0714,284,489,773,47,820,1437,57.06%,19.76%,1
新北市,三重區,0715,357,506,863,62,925,1697,54.51%,21.04%,1
新北市,三重區,0716,346,565,911,32,943,1793,52.59%,19.3%,1
新北市,三重區,0717,347,581,928,35,963,1603,60.07%,21.65%,1
新北市,三重區,0718,249,362,611,24,635,1166,54.46%,21.36%,1
新北市,三重區,0719,240,387,627,40,667,1126,59.24%,21.31%,1
新北市,三重區,0720,192,405,597,51,648,1291,50.19%,14.87%,1
新北市,三重區,0721,338,510,848,56,904,1597,56.61%,21.16%,1
新北市,三重區,0722,216,387,603,62,665,1081,61.52%,19.98%,1
新北市,三重區,0723,184,361,545,43,588,911,64.54%,20.2%,1
新北市,三重區,0724,309,513,822,35,857,1719,49.85%,17.98%,1
新北市,三重區,0725,254,409,663,65,728,1289,56.48%,19.71%,1
新北市,三重區,0726,250,489,739,65,804,1318,61%,18.97%,1
新北市,三重區,0727,366,536,902,56,958,1822,52.58%,20.09%,1
新北市,三重區,0728,213,402,615,79,694,1185,58.57%,17.97%,1
新北市,三重區,0729,421,235,656,66,722,1369,52.74%,30.75%,1
新北市,三重區,0730,300,487,787,58,845,1507,56.07%,19.91%,1
新北市,三重區,0731,201,296,497,58,555,926,59.94%,21.71%,1
新北市,三重區,0732,169,299,468,23,491,950,51.68%,17.79%,1
新北市,三重區,0733,318,503,821,68,889,1678,52.98%,18.95%,1
新北市,三重區,0734,212,355,567,71,638,1117,57.12%,18.98%,1
新北市,三重區,0735,246,416,662,51,713,1318,54.1%,18.66%,1
新北市,三重區,0736,298,467,765,31,796,1388,57.35%,21.47%,1
新北市,三重區,0737,234,315,549,50,599,1026,58.38%,22.81%,1
新北市,三重區,0738,248,385,633,48,681,1096,62.14%,22.63%,1
新北市,三重區,0739,207,339,546,27,573,967,59.26%,21.41%,1
新北市,三重區,0740,336,500,836,43,879,1871,46.98%,17.96%,1
新北市,三重區,0741,330,530,860,70,930,1663,55.92%,19.84%,1
新北市,三重區,0742,214,430,644,26,670,1208,55.46%,17.72%,1
新北市,三重區,0743,292,399,691,52,743,1398,53.15%,20.89%,1
新北市,三重區,0744,212,349,561,22,583,1078,54.08%,19.67%,1
新北市,三重區,0745,187,370,557,63,620,1102,56.26%,16.97%,1
新北市,三重區,0746,285,411,696,71,767,1393,55.06%,20.46%,1
新北市,三重區,0747,237,442,679,61,740,1251,59.15%,18.94%,1
新北市,三重區,0748,266,475,741,46,787,1234,63.78%,21.56%,1
新北市,三重區,0749,373,524,897,63,960,1661,57.8%,22.46%,1
新北市,三重區,0750,320,521,841,67,908,1590,57.11%,20.13%,1
新北市,三重區,0751,246,397,643,59,702,1182,59.39%,20.81%,1
新北市,三重區,0752,289,464,753,65,818,1369,59.75%,21.11%,1
新北市,三重區,0753,288,424,712,45,757,1222,61.95%,23.57%,1
新北市,三重區,0754,255,408,663,81,744,1304,57.06%,19.56%,1
新北市,三重區,0755,167,355,522,42,564,1054,53.51%,15.84%,1
新北市,三重區,0756,319,527,846,70,916,1635,56.02%,19.51%,1
新北市,三重區,0757,319,557,876,64,940,1779,52.84%,17.93%,1
新北市,三重區,0758,320,534,854,79,933,1633,57.13%,19.6%,1
新北市,三重區,0759,240,364,604,38,642,1107,57.99%,21.68%,1
新北市,三重區,0760,209,391,600,41,641,1021,62.78%,20.47%,1
新北市,三重區,0761,294,479,773,82,855,1649,51.85%,17.83%,1
新北市,三重區,0762,171,289,460,35,495,874,56.64%,19.57%,1
新北市,三重區,0763,275,449,724,100,824,1402,58.77%,19.61%,1
新北市,三重區,0764,277,526,803,69,872,1713,50.9%,16.17%,1
新北市,三重區,0765,177,274,451,39,490,973,50.36%,18.19%,1
新北市,三重區,0766,214,359,573,44,617,1038,59.44%,20.62%,1
新北市,三重區,0767,287,510,797,124,921,1833,50.25%,15.66%,1
新北市,三重區,0768,168,266,434,30,464,817,56.79%,20.56%,1
新北市,三重區,0769,287,487,774,51,825,1387,59.48%,20.69%,1
新北市,三重區,0770,169,279,448,27,475,784,60.59%,21.56%,1
新北市,三重區,0771,217,331,548,33,581,1096,53.01%,19.8%,1
新北市,三重區,0772,252,379,631,56,687,1163,59.07%,21.67%,1
新北市,三重區,0773,337,578,915,64,979,1868,52.41%,18.04%,1
新北市,三重區,0774,194,350,544,71,615,1117,55.06%,17.37%,1
新北市,三重區,0775,165,295,460,38,498,934,53.32%,17.67%,1
新北市,三重區,0776,263,423,686,59,745,1412,52.76%,18.63%,1
新北市,三重區,0777,215,416,631,46,677,1062,63.75%,20.24%,1
新北市,三重區,0778,164,293,457,55,512,891,57.46%,18.41%,1
新北市,三重區,0779,211,361,572,70,642,936,68.59%,22.54%,1
新北市,三重區,0780,198,334,532,68,600,1085,55.3%,18.25%,1
新北市,三重區,0781,207,312,519,14,533,1065,50.05%,19.44%,1
新北市,三重區,0782,314,425,739,64,803,1398,57.44%,22.46%,1
新北市,三重區,0783,289,545,834,41,875,1550,56.45%,18.65%,1
新北市,三重區,0784,311,537,848,63,911,1674,54.42%,18.58%,1
新北市,三重區,0785,232,424,656,55,711,1215,58.52%,19.09%,1
新北市,三重區,0786,311,513,824,59,883,1606,54.98%,19.36%,1
新北市,三重區,0787,242,378,620,45,665,1182,56.26%,20.47%,1
新北市,三重區,0788,234,433,667,64,731,1238,59.05%,18.9%,1
新北市,三重區,0789,293,454,747,56,803,1342,59.84%,21.83%,1
新北市,三重區,0790,292,485,777,43,820,1408,58.24%,20.74%,1
新北市,三重區,0791,328,569,897,83,980,1770,55.37%,18.53%,1
新北市,三重區,0792,208,299,507,47,554,940,58.94%,22.13%,1
新北市,三重區,0793,185,323,508,28,536,975,54.97%,18.97%,1
新北市,三重區,0794,302,456,758,46,804,1507,53.35%,20.04%,1
新北市,三重區,0795,274,478,752,61,813,1419,57.29%,19.31%,1
新北市,三重區,0796,235,431,666,51,717,1257,57.04%,18.7%,1
新北市,三重區,0797,314,546,860,61,921,1619,56.89%,19.39%,1
新北市,三重區,0798,297,598,895,66,961,1745,55.07%,17.02%,1
新北市,三重區,0799,310,470,780,79,859,1519,56.55%,20.41%,1
新北市,三重區,0800,292,542,834,55,889,1682,52.85%,17.36%,1
新北市,三重區,0801,353,581,934,63,997,1697,58.75%,20.8%,1
新北市,三重區,0802,179,383,562,56,618,1073,57.6%,16.68%,1
新北市,三重區,0803,151,318,469,43,512,924,55.41%,16.34%,1
新北市,三重區,0804,229,508,737,51,788,1613,48.85%,14.2%,1
新北市,三重區,0805,173,336,509,45,554,1034,53.58%,16.73%,1
新北市,三重區,0806,200,399,599,56,655,1118,58.59%,17.89%,1
新北市,三重區,0807,210,418,628,63,691,1269,54.45%,16.55%,1
新北市,三重區,0808,174,332,506,54,560,990,56.57%,17.58%,1
新北市,三重區,0809,252,461,713,50,763,1336,57.11%,18.86%,1
新北市,三重區,0810,572,297,869,37,906,1601,56.59%,35.73%,1
新北市,三重區,0811,311,584,895,65,960,1581,60.72%,19.67%,1
新北市,三重區,0812,260,465,725,56,781,1345,58.07%,19.33%,1
新北市,三重區,0813,248,463,711,47,758,1226,61.83%,20.23%,1
新北市,三重區,0814,273,502,775,86,861,1650,52.18%,16.55%,1
新北市,三重區,0815,213,398,611,44,655,1140,57.46%,18.68%,1
新北市,三重區,0816,294,526,820,38,858,1639,52.35%,17.94%,1
新北市,三重區,0817,323,574,897,59,956,1699,56.27%,19.01%,1
新北市,三重區,0818,318,603,921,73,994,1501,66.22%,21.19%,1
新北市,三重區,0819,291,517,808,62,870,1538,56.57%,18.92%,1
新北市,三重區,0820,284,490,774,70,844,1540,54.81%,18.44%,1
新北市,三重區,0821,215,453,668,51,719,1276,56.35%,16.85%,1
新北市,三重區,0822,264,513,777,51,828,1539,53.8%,17.15%,1
新北市,三重區,0823,264,408,672,33,705,1170,60.26%,22.56%,1
新北市,三重區,0824,235,363,598,43,641,1120,57.23%,20.98%,1
新北市,三重區,0825,351,449,800,63,863,1789,48.24%,19.62%,1
新北市,三重區,0826,312,436,748,75,823,1520,54.14%,20.53%,1
新北市,三重區,0827,361,588,949,70,1019,1821,55.96%,19.82%,1
新北市,三重區,0828,200,538,738,70,808,1407,57.43%,14.21%,1
新北市,三重區,0829,282,494,776,59,835,1491,56%,18.91%,1
新北市,三重區,0830,290,481,771,52,823,1381,59.59%,21%,1
新北市,三重區,0831,238,399,637,69,706,1222,57.77%,19.48%,1
新北市,三重區,0832,351,635,986,0,986,1938,50.88%,18.11%,1
新北市,三重區,0833,317,549,866,40,906,1639,55.28%,19.34%,1
新北市,三重區,0834,317,518,835,72,907,1614,56.2%,19.64%,1
新北市,三重區,0835,311,580,891,46,937,1709,54.83%,18.2%,1
新北市,三重區,0836,273,578,851,61,912,1753,52.03%,15.57%,1
新北市,三重區,0837,290,466,756,62,818,1398,58.51%,20.74%,1
新北市,三重區,0838,346,519,865,63,928,1706,54.4%,20.28%,1
新北市,三重區,0839,310,554,864,63,927,1614,57.43%,19.21%,1
新北市,三重區,0840,323,513,836,100,936,1591,58.83%,20.3%,1
新北市,三重區,0841,339,520,859,45,904,1627,55.56%,20.84%,1
新北市,三重區,0842,307,500,807,63,870,1505,57.81%,20.4%,1
新北市,三重區,0843,263,439,702,57,759,1331,57.02%,19.76%,1
新北市,三重區,0844,280,494,774,53,827,1678,49.28%,16.69%,1
新北市,三重區,0845,312,492,804,45,849,1498,56.68%,20.83%,1
新北市,三重區,0846,382,626,1008,54,1062,1800,59%,21.22%,1
新北市,三重區,0847,321,460,781,44,825,1703,48.44%,18.85%,1
新北市,三重區,0848,372,567,939,45,984,1975,49.82%,18.84%,1
新北市,三重區,0849,308,627,935,42,977,1894,51.58%,16.26%,1
新北市,三重區,0850,294,486,780,43,823,1405,58.58%,20.93%,1
新北市,三重區,0851,249,470,719,32,751,1293,58.08%,19.26%,1
新北市,三重區,0852,280,412,692,37,729,1259,57.9%,22.24%,1
新北市,三重區,0853,241,406,647,62,709,1144,61.98%,21.07%,1
新北市,三重區,0854,284,429,713,52,765,1254,61%,22.65%,1
新北市,三重區,0855,274,426,700,42,742,1313,56.51%,20.87%,1
新北市,三重區,0856,301,498,799,78,877,1594,55.02%,18.88%,1
新北市,三重區,0857,344,574,918,56,974,1775,54.87%,19.38%,1
新北市,三重區,0858,260,510,770,79,849,1516,56%,17.15%,1
新北市,三重區,0859,281,475,756,73,829,1315,63.04%,21.37%,1
新北市,三重區,0860,179,281,460,59,519,843,61.57%,21.23%,1
新北市,三重區,0861,181,378,559,55,614,1160,52.93%,15.6%,1
新北市,三重區,0862,173,390,563,55,618,1052,58.75%,16.44%,1
新北市,三重區,0863,232,386,618,56,674,1054,63.95%,22.01%,1
新北市,三重區,0864,193,350,543,44,587,997,58.88%,19.36%,1
新北市,三重區,0865,179,301,480,34,514,936,54.91%,19.12%,1
新北市,三重區,0866,294,536,830,78,908,1658,54.76%,17.73%,1
新北市,三重區,0867,276,488,764,57,821,1496,54.88%,18.45%,1
新北市,三重區,0868,231,380,611,50,661,1064,62.12%,21.71%,1
新北市,三重區,0869,223,435,658,46,704,1152,61.11%,19.36%,1
新北市,三重區,0870,291,489,780,41,821,1532,53.59%,18.99%,1
新北市,三重區,0871,222,410,632,33,665,1338,49.7%,16.59%,1
新北市,三重區,0872,263,435,698,54,752,1303,57.71%,20.18%,1
新北市,三重區,0873,251,483,734,87,821,1369,59.97%,18.33%,1
新北市,三重區,0874,272,497,769,69,838,1491,56.2%,18.24%,1
新北市,三重區,0875,283,577,860,88,948,1821,52.06%,15.54%,1
新北市,三重區,0876,329,596,925,43,968,1906,50.79%,17.26%,1
新北市,三重區,0877,377,621,998,45,1043,1842,56.62%,20.47%,1
新北市,三重區,0878,139,294,433,44,477,878,54.33%,15.83%,1
新北市,三重區,0879,231,341,572,45,617,963,64.07%,23.99%,1
新北市,三重區,0880,232,419,651,29,680,1381,49.24%,16.8%,1
新北市,三重區,0881,298,482,780,71,851,1681,50.62%,17.73%,1
新北市,三重區,0882,298,482,780,30,810,1548,52.33%,19.25%,1
新北市,三重區,0883,344,489,833,61,894,1542,57.98%,22.31%,1
新北市,三重區,0884,326,483,809,62,871,1557,55.94%,20.94%,1
新北市,三重區,0885,311,540,851,47,898,1661,54.06%,18.72%,1
新北市,三重區,0886,391,684,1075,26,1101,2024,54.4%,19.32%,1
新北市,三重區,0887,271,477,748,54,802,1588,50.5%,17.07%,1
新北市,三重區,0888,272,578,850,92,942,1706,55.22%,15.94%,1
新北市,三重區,0889,262,478,740,47,787,1341,58.69%,19.54%,1
新北市,三重區,0890,185,346,531,35,566,1025,55.22%,18.05%,1
新北市,三重區,0891,260,452,712,56,768,1339,57.36%,19.42%,1
新北市,三重區,0892,322,560,882,77,959,1725,55.59%,18.67%,1
新北市,三重區,0893,351,570,921,71,992,1826,54.33%,19.22%,1
新北市,中和區,1232,292,489,781,63,844,1630,51.78%,17.91%,1
新北市,中和區,1233,361,586,947,42,989,1775,55.72%,20.34%,1
新北市,中和區,1234,317,587,904,30,934,1844,50.65%,17.19%,1
新北市,中和區,1235,229,396,625,16,641,1019,62.9%,22.47%,1
新北市,中和區,1236,220,457,677,18,695,1138,61.07%,19.33%,1
新北市,中和區,1237,326,607,933,31,964,1878,51.33%,17.36%,1
新北市,中和區,1238,290,793,1083,43,1126,1980,56.87%,14.65%,1
新北市,中和區,1239,342,621,963,74,1037,1844,56.24%,18.55%,1
新北市,中和區,1240,460,706,1166,31,1197,2085,57.41%,22.06%,1
新北市,中和區,1241,253,537,790,43,833,1498,55.61%,16.89%,1
新北市,中和區,1242,331,596,927,25,952,1761,54.06%,18.8%,1
新北市,中和區,1243,273,385,658,36,694,1254,55.34%,21.77%,1
新北市,中和區,1244,267,495,762,26,788,1343,58.67%,19.88%,1
新北市,中和區,1245,376,589,965,34,999,1789,55.84%,21.02%,1
新北市,中和區,1246,419,665,1084,30,1114,2000,55.7%,20.95%,1
新北市,中和區,1247,367,558,925,34,959,1953,49.1%,18.79%,1
新北市,中和區,1248,330,566,896,60,956,1712,55.84%,19.28%,1
新北市,中和區,1249,269,615,884,43,927,1582,58.6%,17%,1
新北市,中和區,1250,323,592,915,42,957,1742,54.94%,18.54%,1
新北市,中和區,1251,318,566,884,41,925,1493,61.96%,21.3%,1
新北市,中和區,1252,257,437,694,34,728,1352,53.85%,19.01%,1
新北市,中和區,1253,207,490,697,42,739,1244,59.41%,16.64%,1
新北市,中和區,1254,230,533,763,47,810,1394,58.11%,16.5%,1
新北市,中和區,1255,317,508,825,30,855,1917,44.6%,16.54%,1
新北市,中和區,1256,316,566,882,71,953,1830,52.08%,17.27%,1
新北市,中和區,1257,234,398,632,33,665,1124,59.16%,20.82%,1
新北市,中和區,1258,260,429,689,31,720,1412,50.99%,18.41%,1
新北市,中和區,1259,258,447,705,42,747,1356,55.09%,19.03%,1
新北市,中和區,1260,225,499,724,28,752,1425,52.77%,15.79%,1
新北市,中和區,1261,254,447,701,59,760,1259,60.37%,20.17%,1
新北市,中和區,1262,238,440,678,57,735,1256,58.52%,18.95%,1
新北市,中和區,1263,266,495,761,39,800,1423,56.22%,18.69%,1
新北市,中和區,1264,214,425,639,52,691,1221,56.59%,17.53%,1
新北市,中和區,1265,321,572,893,50,943,1858,50.75%,17.28%,1
新北市,中和區,1266,325,574,899,46,945,1804,52.38%,18.02%,1
新北市,中和區,1267,356,583,939,30,969,1669,58.06%,21.33%,1
新北市,中和區,1268,282,518,800,37,837,1485,56.36%,18.99%,1
新北市,中和區,1269,191,377,568,41,609,1005,60.6%,19%,1
新北市,中和區,1270,267,429,696,59,755,1175,64.26%,22.72%,1
新北市,中和區,1271,226,428,654,38,692,1171,59.09%,19.3%,1
新北市,中和區,1272,301,547,848,30,878,1746,50.29%,17.24%,1
新北市,中和區,1273,276,465,741,33,774,1555,49.77%,17.75%,1
新北市,中和區,1274,216,378,594,41,635,1112,57.1%,19.42%,1
新北市,中和區,1275,379,633,1012,43,1055,1780,59.27%,21.29%,1
新北市,中和區,1276,398,627,1025,31,1056,1918,55.06%,20.75%,1
新北市,中和區,1277,257,480,737,27,764,1689,45.23%,15.22%,1
新北市,中和區,1278,353,634,987,23,1010,1781,56.71%,19.82%,1
新北市,中和區,1279,284,496,780,40,820,1419,57.79%,20.01%,1
新北市,中和區,1280,247,447,694,31,725,1344,53.94%,18.38%,1
新北市,中和區,1281,383,706,1089,33,1122,1804,62.2%,21.23%,1
新北市,中和區,1282,353,545,898,63,961,1788,53.75%,19.74%,1
新北市,中和區,1283,310,644,954,46,1000,1793,55.77%,17.29%,1
新北市,中和區,1284,271,464,735,52,787,1352,58.21%,20.04%,1
新北市,中和區,1285,354,638,992,50,1042,1813,57.47%,19.53%,1
新北市,中和區,1286,265,525,790,30,820,1288,63.66%,20.57%,1
新北市,中和區,1287,243,394,637,41,678,1186,57.17%,20.49%,1
新北市,中和區,1288,194,438,632,8,640,1237,51.74%,15.68%,1
新北市,中和區,1289,248,489,737,50,787,1406,55.97%,17.64%,1
新北市,中和區,1290,279,480,759,54,813,1442,56.38%,19.35%,1
新北市,中和區,1291,229,385,614,36,650,1040,62.5%,22.02%,1
新北市,中和區,1292,237,497,734,49,783,1292,60.6%,18.34%,1
新北市,中和區,1293,317,618,935,51,986,1811,54.45%,17.5%,1
新北市,中和區,1294,330,628,958,72,1030,1789,57.57%,18.45%,1
新北市,中和區,1295,157,373,530,30,560,859,65.19%,18.28%,1
新北市,中和區,1296,168,432,600,27,627,972,64.51%,17.28%,1
新北市,中和區,1297,257,470,727,39,766,1346,56.91%,19.09%,1
新北市,中和區,1298,206,371,577,37,614,1034,59.38%,19.92%,1
新北市,中和區,1299,257,504,761,39,800,1387,57.68%,18.53%,1
新北市,中和區,1300,379,725,1104,70,1174,2067,56.8%,18.34%,1
新北市,中和區,1301,282,480,762,43,805,1670,48.2%,16.89%,1
新北市,中和區,1302,222,401,623,41,664,1166,56.95%,19.04%,1
新北市,中和區,1303,173,363,536,37,573,963,59.5%,17.96%,1
新北市,中和區,1304,160,378,538,33,571,1070,53.36%,14.95%,1
新北市,中和區,1305,215,482,697,39,736,1319,55.8%,16.3%,1
新北市,中和區,1306,261,571,832,47,879,1438,61.13%,18.15%,1
新北市,中和區,1307,299,596,895,36,931,1808,51.49%,16.54%,1
新北市,中和區,1308,182,432,614,16,630,1191,52.9%,15.28%,1
新北市,中和區,1309,280,556,836,63,899,1632,55.09%,17.16%,1
新北市,中和區,1310,275,601,876,46,922,1765,52.24%,15.58%,1
新北市,中和區,1311,193,484,677,22,699,1168,59.85%,16.52%,1
新北市,中和區,1312,185,448,633,28,661,1176,56.21%,15.73%,1
新北市,中和區,1313,273,668,941,51,992,1565,63.39%,17.44%,1
新北市,中和區,1314,245,520,765,45,810,1578,51.33%,15.53%,1
新北市,中和區,1315,402,668,1070,30,1100,2029,54.21%,19.81%,1
新北市,中和區,1316,170,318,488,33,521,905,57.57%,18.78%,1
新北市,中和區,1317,128,282,410,32,442,839,52.68%,15.26%,1
新北市,中和區,1318,129,292,421,23,444,762,58.27%,16.93%,1
新北市,中和區,1319,246,508,754,49,803,1420,56.55%,17.32%,1
新北市,中和區,1320,216,436,652,46,698,1272,54.87%,16.98%,1
新北市,中和區,1321,354,637,991,58,1049,1976,53.09%,17.91%,1
新北市,中和區,1322,269,668,937,37,974,1779,54.75%,15.12%,1
新北市,中和區,1323,231,439,670,48,718,1454,49.38%,15.89%,1
新北市,中和區,1324,182,512,694,35,729,1374,53.06%,13.25%,1
新北市,中和區,1325,225,428,653,43,696,1369,50.84%,16.44%,1
新北市,中和區,1326,280,495,775,47,822,1501,54.76%,18.65%,1
新北市,中和區,1327,173,375,548,54,602,920,65.43%,18.8%,1
新北市,中和區,1328,205,405,610,47,657,1050,62.57%,19.52%,1
新北市,中和區,1329,64,123,187,10,197,321,61.37%,19.94%,1
新北市,中和區,1330,240,480,720,58,778,1474,52.78%,16.28%,1
新北市,中和區,1331,252,517,769,75,844,1461,57.77%,17.25%,1
新北市,中和區,1332,275,550,825,37,862,1621,53.18%,16.96%,1
新北市,中和區,1333,242,522,764,58,822,1327,61.94%,18.24%,1
新北市,中和區,1334,140,287,427,23,450,775,58.06%,18.06%,1
新北市,中和區,1335,317,602,919,47,966,1916,50.42%,16.54%,1
新北市,中和區,1336,303,625,928,62,990,1901,52.08%,15.94%,1
新北市,中和區,1337,259,502,761,29,790,4411,17.91%,5.87%,1
新北市,中和區,1338,219,429,648,31,679,1212,56.02%,18.07%,1
新北市,中和區,1339,208,414,622,29,651,1126,57.82%,18.47%,1
新北市,中和區,1340,261,514,775,25,800,1507,53.09%,17.32%,1
新北市,中和區,1341,287,524,811,20,831,1519,54.71%,18.89%,1
新北市,中和區,1342,309,500,809,44,853,1467,58.15%,21.06%,1
新北市,中和區,1343,257,574,831,56,887,1453,61.05%,17.69%,1
新北市,中和區,1344,278,513,791,39,830,1364,60.85%,20.38%,1
新北市,中和區,1345,244,453,697,38,735,1302,56.45%,18.74%,1
新北市,中和區,1346,241,485,726,24,750,1627,46.1%,14.81%,1
新北市,中和區,1347,249,524,773,25,798,1503,53.09%,16.57%,1
新北市,中和區,1348,224,490,714,29,743,1392,53.38%,16.09%,1
新北市,中和區,1349,215,394,609,29,638,1067,59.79%,20.15%,1
新北市,中和區,1350,268,551,819,42,861,1623,53.05%,16.51%,1
新北市,中和區,1351,255,433,688,22,710,1208,58.77%,21.11%,1
新北市,中和區,1352,578,280,858,40,898,1991,45.1%,29.03%,1
新北市,中和區,1353,308,573,881,30,911,1932,47.15%,15.94%,1
新北市,中和區,1354,221,410,631,15,646,947,68.22%,23.34%,1
新北市,中和區,1355,296,607,903,57,960,1660,57.83%,17.83%,1
新北市,中和區,1356,247,482,729,57,786,1574,49.94%,15.69%,1
新北市,中和區,1357,364,677,1041,44,1085,2136,50.8%,17.04%,1
新北市,中和區,1358,258,467,725,56,781,1462,53.42%,17.65%,1
新北市,中和區,1359,232,514,746,69,815,1548,52.65%,14.99%,1
新北市,中和區,1360,146,296,442,15,457,692,66.04%,21.1%,1
新北市,中和區,1361,231,493,724,44,768,1221,62.9%,18.92%,1
新北市,中和區,1362,285,465,750,38,788,1331,59.2%,21.41%,1
新北市,中和區,1363,195,395,590,33,623,984,63.31%,19.82%,1
新北市,中和區,1364,315,598,913,37,950,1871,50.77%,16.84%,1
新北市,中和區,1365,217,453,670,32,702,1279,54.89%,16.97%,1
新北市,中和區,1366,318,571,889,42,931,1629,57.15%,19.52%,1
新北市,中和區,1367,313,502,815,29,844,1482,56.95%,21.12%,1
新北市,中和區,1368,300,659,959,41,1000,1715,58.31%,17.49%,1
新北市,中和區,1369,327,716,1043,60,1103,1952,56.51%,16.75%,1
新北市,中和區,1370,138,244,382,23,405,686,59.04%,20.12%,1
新北市,中和區,1371,267,475,742,33,775,1577,49.14%,16.93%,1
新北市,中和區,1372,261,396,657,25,682,1158,58.89%,22.54%,1
新北市,中和區,1373,263,476,739,16,755,1195,63.18%,22.01%,1
新北市,中和區,1374,221,423,644,31,675,1054,64.04%,20.97%,1
新北市,中和區,1375,133,245,378,18,396,612,64.71%,21.73%,1
新北市,中和區,1376,327,603,930,30,960,1668,57.55%,19.6%,1
新北市,中和區,1377,219,415,634,53,687,1071,64.15%,20.45%,1
新北市,中和區,1378,285,472,757,49,806,1169,68.95%,24.38%,1
新北市,中和區,1379,265,455,720,31,751,1370,54.82%,19.34%,1
新北市,中和區,1380,285,587,872,75,947,1574,60.17%,18.11%,1
新北市,中和區,1381,392,772,1164,26,1190,2614,45.52%,15%,1
新北市,中和區,1382,266,554,820,50,870,1477,58.9%,18.01%,1
新北市,中和區,1383,233,322,555,57,612,1041,58.79%,22.38%,1
新北市,中和區,1384,260,489,749,62,811,1538,52.73%,16.91%,1
新北市,中和區,1385,295,532,827,50,877,1599,54.85%,18.45%,1
新北市,中和區,1386,292,565,857,75,932,1586,58.76%,18.41%,1
新北市,中和區,1387,323,673,996,60,1056,1726,61.18%,18.71%,1
新北市,中和區,1388,402,671,1073,65,1138,1854,61.38%,21.68%,1
新北市,中和區,1389,295,552,847,48,895,1472,60.8%,20.04%,1
新北市,中和區,1390,276,541,817,56,873,1430,61.05%,19.3%,1
新北市,中和區,1391,302,551,853,48,901,1488,60.55%,20.3%,1
新北市,中和區,1392,252,411,663,32,695,1251,55.56%,20.14%,1
新北市,中和區,1393,275,549,824,38,862,1487,57.97%,18.49%,1
新北市,中和區,1394,247,422,669,75,744,1328,56.02%,18.6%,1
新北市,中和區,1395,246,420,666,34,700,1128,62.06%,21.81%,1
新北市,中和區,1396,199,433,632,28,660,1008,65.48%,19.74%,1
新北市,中和區,1397,358,630,988,41,1029,1786,57.61%,20.04%,1
新北市,中和區,1398,392,730,1122,60,1182,2219,53.27%,17.67%,1
新北市,中和區,1399,221,447,668,28,696,1322,52.65%,16.72%,1
新北市,中和區,1400,271,519,790,15,805,1495,53.85%,18.13%,1
新北市,中和區,1401,246,490,736,50,786,1414,55.59%,17.4%,1
新北市,中和區,1402,270,637,907,61,968,1681,57.58%,16.06%,1
新北市,中和區,1403,262,461,723,50,773,1361,56.8%,19.25%,1
新北市,中和區,1404,240,519,759,44,803,1442,55.69%,16.64%,1
新北市,中和區,1405,455,256,711,27,738,1383,53.36%,32.9%,1
新北市,中和區,1406,228,462,690,37,727,1264,57.52%,18.04%,1
新北市,中和區,1407,321,671,992,90,1082,1810,59.78%,17.73%,1
新北市,中和區,1408,349,570,919,45,964,1951,49.41%,17.89%,1
新北市,中和區,1409,276,487,763,41,804,1582,50.82%,17.45%,1
新北市,中和區,1410,364,726,1090,62,1152,1945,59.23%,18.71%,1
新北市,中和區,1411,237,530,767,43,810,1390,58.27%,17.05%,1
新北市,中和區,1412,238,410,648,19,667,1161,57.45%,20.5%,1
新北市,中和區,1413,206,553,759,33,792,1399,56.61%,14.72%,1
新北市,中和區,1414,182,393,575,34,609,1070,56.92%,17.01%,1
新北市,中和區,1415,211,398,609,32,641,1169,54.83%,18.05%,1
新北市,中和區,1416,224,496,720,49,769,1214,63.34%,18.45%,1
新北市,中和區,1417,278,505,783,48,831,1398,59.44%,19.89%,1
新北市,中和區,1418,205,377,582,32,614,1049,58.53%,19.54%,1
新北市,中和區,1419,285,503,788,40,828,1324,62.54%,21.53%,1
新北市,中和區,1420,426,395,821,28,849,1765,48.1%,24.14%,1
新北市,中和區,1421,271,547,818,51,869,1709,50.85%,15.86%,1
新北市,中和區,1422,187,436,623,73,696,1186,58.68%,15.77%,1
新北市,中和區,1423,234,499,733,49,782,1318,59.33%,17.75%,1
新北市,中和區,1424,312,493,805,34,839,1430,58.67%,21.82%,1
新北市,中和區,1425,265,422,687,43,730,1637,44.59%,16.19%,1
新北市,中和區,1426,263,426,689,51,740,1283,57.68%,20.5%,1
新北市,中和區,1427,259,451,710,44,754,1310,57.56%,19.77%,1
新北市,中和區,1428,267,451,718,47,765,1301,58.8%,20.52%,1
新北市,中和區,1429,335,566,901,67,968,1681,57.58%,19.93%,1
新北市,中和區,1430,279,509,788,27,815,1384,58.89%,20.16%,1
新北市,中和區,1431,251,402,653,32,685,1187,57.71%,21.15%,1
新北市,中和區,1432,293,495,788,7,795,1779,44.69%,16.47%,1
新北市,中和區,1433,302,622,924,46,970,1712,56.66%,17.64%,1
新北市,中和區,1434,285,475,760,37,797,1462,54.51%,19.49%,1
新北市,中和區,1435,347,598,945,27,972,1824,53.29%,19.02%,1
新北市,中和區,1436,282,441,723,46,769,1389,55.36%,20.3%,1
新北市,中和區,1437,290,521,811,37,848,1434,59.14%,20.22%,1
新北市,中和區,1438,305,690,995,58,1053,1953,53.92%,15.62%,1
新北市,中和區,1439,375,695,1070,54,1124,2002,56.14%,18.73%,1
新北市,中和區,1440,309,669,978,25,1003,1858,53.98%,16.63%,1
新北市,中和區,1441,331,612,943,20,963,1801,53.47%,18.38%,1
新北市,中和區,1442,323,610,933,42,975,1691,57.66%,19.1%,1
新北市,中和區,1443,290,497,787,31,818,1363,60.01%,21.28%,1
新北市,中和區,1444,258,479,737,26,763,1220,62.54%,21.15%,1
新北市,中和區,1445,289,549,838,25,863,1365,63.22%,21.17%,1
新北市,中和區,1446,225,433,658,25,683,1178,57.98%,19.1%,1
新北市,中和區,1447,166,310,476,30,506,830,60.96%,20%,1
新北市,中和區,1448,207,362,569,54,623,1197,52.05%,17.29%,1
新北市,中和區,1449,237,525,762,45,807,1369,58.95%,17.31%,1
新北市,中和區,1450,262,494,756,46,802,1336,60.03%,19.61%,1
新北市,中和區,1451,268,549,817,47,864,1377,62.75%,19.46%,1
新北市,中和區,1452,277,554,831,52,883,1499,58.91%,18.48%,1
新北市,中和區,1453,336,617,953,45,998,1689,59.09%,19.89%,1
新北市,中和區,1454,275,473,748,47,795,1323,60.09%,20.79%,1
新北市,中和區,1455,213,424,637,45,682,1079,63.21%,19.74%,1
新北市,中和區,1456,311,547,858,48,906,1545,58.64%,20.13%,1
新北市,中和區,1457,261,436,697,48,745,1326,56.18%,19.68%,1
新北市,中和區,1458,283,490,773,26,799,1443,55.37%,19.61%,1
新北市,中和區,1459,298,625,923,31,954,1712,55.72%,17.41%,1
新北市,中和區,1460,333,665,998,48,1046,1916,54.59%,17.38%,1
新北市,中和區,1461,169,338,507,34,541,863,62.69%,19.58%,1
新北市,中和區,1462,257,473,730,7,737,1203,61.26%,21.36%,1
新北市,中和區,1463,275,507,782,16,798,1483,53.81%,18.54%,1
新北市,中和區,1464,263,551,814,27,841,1575,53.4%,16.7%,1
新北市,中和區,1465,205,485,690,45,735,1432,51.33%,14.32%,1
新北市,中和區,1466,259,498,757,52,809,1441,56.14%,17.97%,1
新北市,中和區,1467,261,461,722,44,766,1269,60.36%,20.57%,1
新北市,中和區,1468,279,506,785,27,812,1363,59.57%,20.47%,1
新北市,中和區,1469,169,444,613,23,636,1089,58.4%,15.52%,1
新北市,中和區,1470,231,366,597,28,625,1171,53.37%,19.73%,1
新北市,中和區,1471,201,436,637,37,674,1150,58.61%,17.48%,1
新北市,中和區,1472,239,450,689,29,718,1154,62.22%,20.71%,1
新北市,中和區,1473,172,453,625,36,661,1067,61.95%,16.12%,1
新北市,中和區,1474,252,535,787,38,825,1526,54.06%,16.51%,1
新北市,中和區,1475,286,524,810,39,849,1447,58.67%,19.77%,1
新北市,永和區,1476,321,532,853,65,918,1554,59.07%,20.66%,1
新北市,永和區,1477,180,429,609,16,625,1065,58.69%,16.9%,1
新北市,永和區,1478,173,342,515,27,542,854,63.47%,20.26%,1
新北市,永和區,1479,233,473,706,45,751,1253,59.94%,18.6%,1
新北市,永和區,1480,375,572,947,36,983,1733,56.72%,21.64%,1
新北市,永和區,1481,304,544,848,46,894,1581,56.55%,19.23%,1
新北市,永和區,1482,296,608,904,57,961,1735,55.39%,17.06%,1
新北市,永和區,1483,269,555,824,25,849,1563,54.32%,17.21%,1
新北市,永和區,1484,335,603,938,49,987,1650,59.82%,20.3%,1
新北市,永和區,1485,279,526,805,28,833,1454,57.29%,19.19%,1
新北市,永和區,1486,318,486,804,36,840,1568,53.57%,20.28%,1
新北市,永和區,1487,256,492,748,38,786,1444,54.43%,17.73%,1
新北市,永和區,1488,240,361,601,39,640,1140,56.14%,21.05%,1
新北市,永和區,1489,227,469,696,40,736,1188,61.95%,19.11%,1
新北市,永和區,1490,269,520,789,60,849,1516,56%,17.74%,1
新北市,永和區,1491,267,469,736,49,785,1397,56.19%,19.11%,1
新北市,永和區,1492,286,504,790,24,814,1438,56.61%,19.89%,1
新北市,永和區,1493,209,420,629,25,654,1084,60.33%,19.28%,1
新北市,永和區,1494,186,339,525,26,551,941,58.55%,19.77%,1
新北市,永和區,1495,288,555,843,30,873,1598,54.63%,18.02%,1
新北市,永和區,1496,319,523,842,29,871,2842,30.65%,11.22%,1
新北市,永和區,1497,269,483,752,39,791,1261,62.73%,21.33%,1
新北市,永和區,1498,344,554,898,30,928,1449,64.04%,23.74%,1
新北市,永和區,1499,287,559,846,43,889,1511,58.84%,18.99%,1
新北市,永和區,1500,305,583,888,37,925,1470,62.93%,20.75%,1
新北市,永和區,1501,288,586,874,38,912,1580,57.72%,18.23%,1
新北市,永和區,1502,304,577,881,27,908,1438,63.14%,21.14%,1
新北市,永和區,1503,276,512,788,35,823,1305,63.07%,21.15%,1
新北市,永和區,1504,211,416,627,24,651,1046,62.24%,20.17%,1
新北市,永和區,1505,342,559,901,19,920,1566,58.75%,21.84%,1
新北市,永和區,1506,311,536,847,36,883,1468,60.15%,21.19%,1
新北市,永和區,1507,302,512,814,44,858,1305,65.75%,23.14%,1
新北市,永和區,1508,248,451,699,33,732,1181,61.98%,21%,1
新北市,永和區,1509,331,577,908,46,954,1720,55.47%,19.24%,1
新北市,永和區,1510,264,404,668,36,704,1103,63.83%,23.93%,1
新北市,永和區,1511,326,557,883,84,967,1649,58.64%,19.77%,1
新北市,永和區,1512,275,447,722,34,756,1206,62.69%,22.8%,1
新北市,永和區,1513,332,543,875,32,907,1506,60.23%,22.05%,1
新北市,永和區,1514,291,527,818,39,857,1488,57.59%,19.56%,1
新北市,永和區,1515,275,479,754,51,805,1288,62.5%,21.35%,1
新北市,永和區,1516,271,453,724,38,762,1413,53.93%,19.18%,1
新北市,永和區,1517,231,504,735,42,777,1329,58.47%,17.38%,1
新北市,永和區,1518,302,554,856,30,886,1436,61.7%,21.03%,1
新北市,永和區,1519,223,405,628,37,665,1112,59.8%,20.05%,1
新北市,永和區,1520,232,469,701,43,744,1100,67.64%,21.09%,1
新北市,永和區,1521,320,599,919,48,967,1545,62.59%,20.71%,1
新北市,永和區,1522,242,562,804,21,825,1436,57.45%,16.85%,1
新北市,永和區,1523,352,671,1023,60,1083,1731,62.56%,20.34%,1
新北市,永和區,1524,385,649,1034,59,1093,1762,62.03%,21.85%,1
新北市,永和區,1525,255,452,707,42,749,1320,56.74%,19.32%,1
新北市,永和區,1526,237,390,627,18,645,1297,49.73%,18.27%,1
新北市,永和區,1527,377,580,957,55,1012,1798,56.28%,20.97%,1
新北市,永和區,1528,309,549,858,53,911,1491,61.1%,20.72%,1
新北市,永和區,1529,235,455,690,16,706,1223,57.73%,19.22%,1
新北市,永和區,1530,205,415,620,48,668,1108,60.29%,18.5%,1
新北市,永和區,1531,304,518,822,40,862,1408,61.22%,21.59%,1
新北市,永和區,1532,249,477,726,46,772,1265,61.03%,19.68%,1
新北市,永和區,1533,200,412,612,14,626,1115,56.14%,17.94%,1
新北市,永和區,1534,234,447,681,48,729,1133,64.34%,20.65%,1
新北市,永和區,1535,239,453,692,48,740,1217,60.81%,19.64%,1
新北市,永和區,1536,332,585,917,52,969,1713,56.57%,19.38%,1
新北市,永和區,1537,337,576,913,37,950,1721,55.2%,19.58%,1
新北市,永和區,1538,236,476,712,43,755,1327,56.9%,17.78%,1
新北市,永和區,1539,261,497,758,26,784,1257,62.37%,20.76%,1
新北市,永和區,1540,267,536,803,35,838,1348,62.17%,19.81%,1
新北市,永和區,1541,311,585,896,37,933,1461,63.86%,21.29%,1
新北市,永和區,1542,276,483,759,57,816,1368,59.65%,20.18%,1
新北市,永和區,1543,232,426,658,65,723,1234,58.59%,18.8%,1
新北市,永和區,1544,267,459,726,40,766,1303,58.79%,20.49%,1
新北市,永和區,1545,271,552,823,33,856,1516,56.46%,17.88%,1
新北市,永和區,1546,263,558,821,54,875,1422,61.53%,18.5%,1
新北市,永和區,1547,220,378,598,19,617,991,62.26%,22.2%,1
新北市,永和區,1548,213,404,617,24,641,1016,63.09%,20.96%,1
新北市,永和區,1549,226,435,661,33,694,1146,60.56%,19.72%,1
新北市,永和區,1550,167,437,604,31,635,1043,60.88%,16.01%,1
新北市,永和區,1551,259,474,733,14,747,1210,61.74%,21.4%,1
新北市,永和區,1552,316,610,926,26,952,1630,58.4%,19.39%,1
新北市,永和區,1553,221,419,640,21,661,1092,60.53%,20.24%,1
新北市,永和區,1554,370,696,1066,46,1112,1872,59.4%,19.76%,1
新北市,永和區,1555,346,647,993,22,1015,1781,56.99%,19.43%,1
新北市,永和區,1556,214,403,617,33,650,1049,61.96%,20.4%,1
新北市,永和區,1557,277,501,778,38,816,1285,63.5%,21.56%,1
新北市,永和區,1558,270,448,718,35,753,1209,62.28%,22.33%,1
新北市,永和區,1559,247,437,684,30,714,1132,63.07%,21.82%,1
新北市,永和區,1560,264,529,793,33,826,1287,64.18%,20.51%,1
新北市,永和區,1561,234,400,634,37,671,1068,62.83%,21.91%,1
新北市,永和區,1562,258,400,658,41,699,1098,63.66%,23.5%,1
新北市,永和區,1563,215,517,732,33,765,1222,62.6%,17.59%,1
新北市,永和區,1564,232,445,677,37,714,1157,61.71%,20.05%,1
新北市,永和區,1565,288,437,725,38,763,1168,65.33%,24.66%,1
新北市,永和區,1566,266,445,711,41,752,1283,58.61%,20.73%,1
新北市,永和區,1567,271,506,777,30,807,1372,58.82%,19.75%,1
新北市,永和區,1568,376,707,1083,44,1127,1876,60.07%,20.04%,1
新北市,永和區,1569,302,639,941,62,1003,1576,63.64%,19.16%,1
新北市,永和區,1570,338,626,964,38,1002,1661,60.33%,20.35%,1
新北市,永和區,1571,316,688,1004,24,1028,1808,56.86%,17.48%,1
新北市,永和區,1572,373,668,1041,49,1090,1898,57.43%,19.65%,1
新北市,永和區,1573,329,568,897,39,936,1508,62.07%,21.82%,1
新北市,永和區,1574,273,492,765,61,826,1341,61.6%,20.36%,1
新北市,永和區,1575,280,511,791,46,837,1422,58.86%,19.69%,1
新北市,永和區,1576,239,420,659,31,690,1177,58.62%,20.31%,1
新北市,永和區,1577,316,556,872,52,924,1557,59.34%,20.3%,1
新北市,永和區,1578,291,499,790,39,829,1491,55.6%,19.52%,1
新北市,永和區,1579,313,552,865,42,907,1586,57.19%,19.74%,1
新北市,永和區,1580,250,438,688,23,711,1313,54.15%,19.04%,1
新北市,永和區,1581,354,533,887,51,938,1636,57.33%,21.64%,1
新北市,永和區,1582,326,553,879,45,924,1598,57.82%,20.4%,1
新北市,永和區,1583,360,570,930,43,973,1609,60.47%,22.37%,1
新北市,永和區,1584,318,501,819,34,853,1375,62.04%,23.13%,1
新北市,永和區,1585,391,619,1010,28,1038,1648,62.99%,23.73%,1
新北市,永和區,1586,235,385,620,32,652,1077,60.54%,21.82%,1
新北市,永和區,1587,252,426,678,25,703,1157,60.76%,21.78%,1
新北市,永和區,1588,311,518,829,22,851,1339,63.55%,23.23%,1
新北市,永和區,1589,280,508,788,15,803,1306,61.49%,21.44%,1
新北市,永和區,1590,274,486,760,15,775,1236,62.7%,22.17%,1
新北市,永和區,1591,221,462,683,21,704,1133,62.14%,19.51%,1
新北市,永和區,1592,295,549,844,24,868,1425,60.91%,20.7%,1
新北市,永和區,1593,389,662,1051,68,1119,1938,57.74%,20.07%,1
新北市,永和區,1594,352,563,915,43,958,1607,59.61%,21.9%,1
新北市,永和區,1595,131,361,492,33,525,853,61.55%,15.36%,1
新北市,永和區,1596,112,269,381,46,427,768,55.6%,14.58%,1
新北市,永和區,1597,119,290,409,30,439,893,49.16%,13.33%,1
新北市,永和區,1598,124,280,404,32,436,743,58.68%,16.69%,1
新北市,永和區,1599,262,433,695,39,734,1155,63.55%,22.68%,1
新北市,永和區,1600,271,484,755,34,789,1263,62.47%,21.46%,1
新北市,永和區,1601,243,470,713,22,735,1189,61.82%,20.44%,1
新北市,永和區,1602,223,500,723,36,759,1346,56.39%,16.57%,1
新北市,永和區,1603,268,477,745,37,782,1368,57.16%,19.59%,1
新北市,永和區,1604,212,388,600,15,615,1043,58.96%,20.33%,1
新北市,永和區,1605,381,607,988,42,1030,1709,60.27%,22.29%,1
新北市,永和區,1606,179,290,469,12,481,879,54.72%,20.36%,1
新北市,永和區,1607,209,304,513,28,541,904,59.85%,23.12%,1
新北市,永和區,1608,242,473,715,51,766,1221,62.74%,19.82%,1
新北市,永和區,1609,207,390,597,38,635,1018,62.38%,20.33%,1
新北市,永和區,1610,311,531,842,46,888,1551,57.25%,20.05%,1
新北市,永和區,1611,295,527,822,37,859,1428,60.15%,20.66%,1
新北市,永和區,1612,211,393,604,51,655,1044,62.74%,20.21%,1
新北市,永和區,1613,211,364,575,34,609,967,62.98%,21.82%,1
新北市,新莊區,0302,243,368,611,52,663,1123,59.04%,21.64%,1
新北市,新莊區,0303,245,470,715,55,770,1278,60.25%,19.17%,1
新北市,新莊區,0304,244,451,695,43,738,1163,63.46%,20.98%,1
新北市,新莊區,0305,244,457,701,53,754,1228,61.4%,19.87%,1
新北市,新莊區,0306,231,422,653,56,709,1211,58.55%,19.08%,1
新北市,新莊區,0307,241,436,677,42,719,1176,61.14%,20.49%,1
新北市,新莊區,0308,332,556,888,50,938,1536,61.07%,21.61%,1
新北市,新莊區,0309,342,538,880,51,931,1486,62.65%,23.01%,1
新北市,新莊區,0310,343,563,906,68,974,1513,64.38%,22.67%,1
新北市,新莊區,0311,326,507,833,55,888,1395,63.66%,23.37%,1
新北市,新莊區,0312,256,458,714,56,770,1353,56.91%,18.92%,1
新北市,新莊區,0313,279,530,809,60,869,1409,61.67%,19.8%,1
新北市,新莊區,0314,283,517,800,27,827,1478,55.95%,19.15%,1
新北市,新莊區,0315,204,330,534,45,579,921,62.87%,22.15%,1
新北市,新莊區,0316,206,361,567,37,604,971,62.2%,21.22%,1
新北市,新莊區,0317,301,596,897,66,963,1534,62.78%,19.62%,1
新北市,新莊區,0318,267,547,814,33,847,1516,55.87%,17.61%,1
新北市,新莊區,0319,150,236,386,26,412,697,59.11%,21.52%,1
新北市,新莊區,0320,251,442,693,26,719,1235,58.22%,20.32%,1
新北市,新莊區,0321,237,392,629,32,661,1138,58.08%,20.83%,1
新北市,新莊區,0322,196,357,553,19,572,1063,53.81%,18.44%,1
新北市,新莊區,0323,326,485,811,37,848,3399,24.95%,9.59%,1
新北市,新莊區,0324,313,558,871,64,935,1575,59.37%,19.87%,1
新北市,新莊區,0325,392,572,964,52,1016,1615,62.91%,24.27%,1
新北市,新莊區,0326,297,491,788,61,849,1612,52.67%,18.42%,1
新北市,新莊區,0327,277,517,794,50,844,1514,55.75%,18.3%,1
新北市,新莊區,0328,260,419,679,23,702,1382,50.8%,18.81%,1
新北市,新莊區,0329,350,450,800,40,840,1475,56.95%,23.73%,1
新北市,新莊區,0330,305,514,819,27,846,1462,57.87%,20.86%,1
新北市,新莊區,0331,305,448,753,36,789,1426,55.33%,21.39%,1
新北市,新莊區,0332,294,450,744,47,791,1421,55.67%,20.69%,1
新北市,新莊區,0333,307,522,829,37,866,1536,56.38%,19.99%,1
新北市,新莊區,0334,359,521,880,45,925,1587,58.29%,22.62%,1
新北市,新莊區,0335,143,246,389,12,401,749,53.54%,19.09%,1
新北市,新莊區,0336,239,479,718,43,761,1276,59.64%,18.73%,1
新北市,新莊區,0337,283,436,719,28,747,1303,57.33%,21.72%,1
新北市,新莊區,0338,256,463,719,49,768,1259,61%,20.33%,1
新北市,新莊區,0339,256,482,738,44,782,1291,60.57%,19.83%,1
新北市,新莊區,0340,302,535,837,12,849,1493,56.87%,20.23%,1
新北市,新莊區,0341,303,533,836,41,877,1507,58.2%,20.11%,1
新北市,新莊區,0342,315,494,809,12,821,1456,56.39%,21.63%,1
新北市,新莊區,0343,298,476,774,27,801,1396,57.38%,21.35%,1
新北市,新莊區,0344,251,400,651,53,704,1351,52.11%,18.58%,1
新北市,新莊區,0345,310,424,734,61,795,1403,56.66%,22.1%,1
新北市,新莊區,0346,292,486,778,58,836,1497,55.85%,19.51%,1
新北市,新莊區,0347,244,460,704,70,774,1272,60.85%,19.18%,1
新北市,新莊區,0348,228,397,625,29,654,1269,51.54%,17.97%,1
新北市,新莊區,0349,283,440,723,72,795,1335,59.55%,21.2%,1
新北市,新莊區,0350,300,462,762,32,794,1300,61.08%,23.08%,1
新北市,新莊區,0351,265,465,730,49,779,1286,60.58%,20.61%,1
新北市,新莊區,0352,280,510,790,40,830,1255,66.14%,22.31%,1
新北市,新莊區,0353,288,531,819,76,895,1558,57.45%,18.49%,1
新北市,新莊區,0354,275,507,782,71,853,1567,54.44%,17.55%,1
新北市,新莊區,0355,298,580,878,72,950,1603,59.26%,18.59%,1
新北市,新莊區,0356,324,511,835,25,860,1538,55.92%,21.07%,1
新北市,新莊區,0357,353,575,928,38,966,1671,57.81%,21.13%,1
新北市,新莊區,0358,315,553,868,39,907,1698,53.42%,18.55%,1
新北市,新莊區,0359,371,526,897,41,938,1545,60.71%,24.01%,1
新北市,新莊區,0360,347,588,935,90,1025,1696,60.44%,20.46%,1
新北市,新莊區,0361,254,550,804,88,892,1626,54.86%,15.62%,1
新北市,新莊區,0362,210,365,575,58,633,1170,54.1%,17.95%,1
新北市,新莊區,0363,236,416,652,69,721,1236,58.33%,19.09%,1
新北市,新莊區,0364,192,364,556,54,610,1071,56.96%,17.93%,1
新北市,新莊區,0365,224,385,609,37,646,1129,57.22%,19.84%,1
新北市,新莊區,0366,326,597,923,33,956,1586,60.28%,20.55%,1
新北市,新莊區,0367,245,526,771,59,830,1597,51.97%,15.34%,1
新北市,新莊區,0368,242,493,735,87,822,1573,52.26%,15.38%,1
新北市,新莊區,0369,221,450,671,35,706,1225,57.63%,18.04%,1
新北市,新莊區,0370,186,419,605,32,637,1217,52.34%,15.28%,1
新北市,新莊區,0371,308,525,833,56,889,1571,56.59%,19.61%,1
新北市,新莊區,0372,299,512,811,53,864,1594,54.2%,18.76%,1
新北市,新莊區,0373,279,534,813,57,870,1583,54.96%,17.62%,1
新北市,新莊區,0374,230,487,717,55,772,1245,62.01%,18.47%,1
新北市,新莊區,0375,261,424,685,30,715,1203,59.43%,21.7%,1
新北市,新莊區,0376,313,436,749,48,797,1265,63%,24.74%,1
新北市,新莊區,0377,236,459,695,63,758,1255,60.4%,18.8%,1
新北市,新莊區,0378,263,449,712,35,747,1287,58.04%,20.44%,1
新北市,新莊區,0379,243,426,669,63,732,1167,62.72%,20.82%,1
新北市,新莊區,0380,224,448,672,48,720,1299,55.43%,17.24%,1
新北市,新莊區,0381,244,423,667,38,705,1207,58.41%,20.22%,1
新北市,新莊區,0382,278,512,790,43,833,1415,58.87%,19.65%,1
新北市,新莊區,0383,258,421,679,62,741,1342,55.22%,19.23%,1
新北市,新莊區,0384,281,440,721,60,781,1341,58.24%,20.95%,1
新北市,新莊區,0385,264,399,663,54,717,1247,57.5%,21.17%,1
新北市,新莊區,0386,175,448,623,21,644,984,65.45%,17.78%,1
新北市,新莊區,0387,215,384,599,40,639,1043,61.27%,20.61%,1
新北市,新莊區,0388,279,442,721,36,757,1135,66.7%,24.58%,1
新北市,新莊區,0389,270,406,676,27,703,1185,59.32%,22.78%,1
新北市,新莊區,0390,303,444,747,39,786,1346,58.4%,22.51%,1
新北市,新莊區,0391,248,512,760,69,829,1372,60.42%,18.08%,1
新北市,新莊區,0392,261,517,778,54,832,1350,61.63%,19.33%,1
新北市,新莊區,0393,241,430,671,59,730,1307,55.85%,18.44%,1
新北市,新莊區,0394,253,455,708,68,776,1353,57.35%,18.7%,1
新北市,新莊區,0395,229,478,707,19,726,1287,56.41%,17.79%,1
新北市,新莊區,0396,257,455,712,31,743,1567,47.42%,16.4%,1
新北市,新莊區,0397,373,592,965,60,1025,1709,59.98%,21.83%,1
新北市,新莊區,0398,284,529,813,37,850,1616,52.6%,17.57%,1
新北市,新莊區,0399,324,470,794,51,845,1628,51.9%,19.9%,1
新北市,新莊區,0400,226,427,653,55,708,1148,61.67%,19.69%,1
新北市,新莊區,0401,245,432,677,4,681,1201,56.7%,20.4%,1
新北市,新莊區,0402,260,436,696,36,732,1135,64.49%,22.91%,1
新北市,新莊區,0403,314,555,869,55,924,1495,61.81%,21%,1
新北市,新莊區,0404,328,538,866,50,916,1486,61.64%,22.07%,1
新北市,新莊區,0405,312,575,887,33,920,1483,62.04%,21.04%,1
新北市,新莊區,0406,277,548,825,35,860,1553,55.38%,17.84%,1
新北市,新莊區,0407,384,599,983,23,1006,1625,61.91%,23.63%,1
新北市,新莊區,0408,346,588,934,27,961,1671,57.51%,20.71%,1
新北市,新莊區,0409,300,511,811,61,872,1389,62.78%,21.6%,1
新北市,新莊區,0410,258,439,697,40,737,1272,57.94%,20.28%,1
新北市,新莊區,0411,336,522,858,33,891,1409,63.24%,23.85%,1
新北市,新莊區,0412,314,502,816,28,844,1372,61.52%,22.89%,1
新北市,新莊區,0413,193,342,535,36,571,955,59.79%,20.21%,1
新北市,新莊區,0414,170,307,477,64,541,952,56.83%,17.86%,1
新北市,新莊區,0415,305,473,778,28,806,1412,57.08%,21.6%,1
新北市,新莊區,0416,268,500,768,56,824,1415,58.23%,18.94%,1
新北市,新莊區,0417,273,523,796,61,857,1421,60.31%,19.21%,1
新北市,新莊區,0418,297,469,766,43,809,1293,62.57%,22.97%,1
新北市,新莊區,0419,287,480,767,26,793,1475,53.76%,19.46%,1
新北市,新莊區,0420,277,487,764,57,821,1429,57.45%,19.38%,1
新北市,新莊區,0421,295,515,810,39,849,1481,57.33%,19.92%,1
新北市,新莊區,0422,267,561,828,63,891,1472,60.53%,18.14%,1
新北市,新莊區,0423,316,526,842,25,867,1474,58.82%,21.44%,1
新北市,新莊區,0424,333,526,859,14,873,1462,59.71%,22.78%,1
新北市,新莊區,0425,340,531,871,18,889,1484,59.91%,22.91%,1
新北市,新莊區,0426,282,528,810,30,840,1461,57.49%,19.3%,1
新北市,新莊區,0427,300,524,824,32,856,1444,59.28%,20.78%,1
新北市,新莊區,0428,306,525,831,24,855,1437,59.5%,21.29%,1
新北市,新莊區,0429,302,483,785,50,835,1641,50.88%,18.4%,1
新北市,新莊區,0430,339,486,825,42,867,1633,53.09%,20.76%,1
新北市,新莊區,0431,304,549,853,22,875,1531,57.15%,19.86%,1
新北市,新莊區,0432,317,534,851,52,903,1517,59.53%,20.9%,1
新北市,新莊區,0433,244,517,761,59,820,1487,55.14%,16.41%,1
新北市,新莊區,0434,317,538,855,35,890,1560,57.05%,20.32%,1
新北市,新莊區,0435,304,549,853,48,901,1584,56.88%,19.19%,1
新北市,新莊區,0436,296,542,838,33,871,1602,54.37%,18.48%,1
新北市,新莊區,0437,174,273,447,38,485,818,59.29%,21.27%,1
新北市,新莊區,0438,268,485,753,49,802,1633,49.11%,16.41%,1
新北市,新莊區,0439,280,575,855,50,905,1652,54.78%,16.95%,1
新北市,新莊區,0440,309,483,792,48,840,1498,56.07%,20.63%,1
新北市,新莊區,0441,257,457,714,46,760,1379,55.11%,18.64%,1
新北市,新莊區,0442,249,523,772,45,817,1381,59.16%,18.03%,1
新北市,新莊區,0443,290,543,833,73,906,1535,59.02%,18.89%,1
新北市,新莊區,0444,280,632,912,47,959,1492,64.28%,18.77%,1
新北市,新莊區,0445,307,540,847,69,916,1450,63.17%,21.17%,1
新北市,新莊區,0446,229,379,608,52,660,1107,59.62%,20.69%,1
新北市,新莊區,0447,228,412,640,33,673,1063,63.31%,21.45%,1
新北市,新莊區,0448,218,427,645,45,690,1143,60.37%,19.07%,1
新北市,新莊區,0449,251,417,668,81,749,1341,55.85%,18.72%,1
新北市,新莊區,0450,205,383,588,37,625,1063,58.8%,19.29%,1
新北市,新莊區,0451,222,399,621,40,661,1096,60.31%,20.26%,1
新北市,新莊區,0452,244,472,716,34,750,1309,57.3%,18.64%,1
新北市,新莊區,0453,247,447,694,43,737,1216,60.61%,20.31%,1
新北市,新莊區,0454,199,444,643,48,691,1278,54.07%,15.57%,1
新北市,新莊區,0455,292,418,710,65,775,1352,57.32%,21.6%,1
新北市,新莊區,0456,235,384,619,61,680,1298,52.39%,18.1%,1
新北市,新莊區,0457,199,369,568,44,612,1042,58.73%,19.1%,1
新北市,新莊區,0458,164,280,444,26,470,881,53.35%,18.62%,1
新北市,新莊區,0459,219,446,665,47,712,1109,64.2%,19.75%,1
新北市,新莊區,0460,221,451,672,49,721,1291,55.85%,17.12%,1
新北市,新莊區,0461,269,412,681,21,702,1293,54.29%,20.8%,1
新北市,新莊區,0462,290,442,732,57,789,1336,59.06%,21.71%,1
新北市,新莊區,0463,236,464,700,42,742,1384,53.61%,17.05%,1
新北市,新莊區,0464,215,387,602,35,637,1231,51.75%,17.47%,1
新北市,新莊區,0465,163,346,509,24,533,940,56.7%,17.34%,1
新北市,新莊區,0466,252,433,685,82,767,1369,56.03%,18.41%,1
新北市,新莊區,0467,220,488,708,67,775,1384,56%,15.9%,1
新北市,新莊區,0468,264,419,683,61,744,1272,58.49%,20.75%,1
新北市,新莊區,0469,216,390,606,29,635,1073,59.18%,20.13%,1
新北市,新莊區,0470,211,363,574,29,603,1058,56.99%,19.94%,1
新北市,新莊區,0471,309,516,825,22,847,1528,55.43%,20.22%,1
新北市,新莊區,0472,202,431,633,46,679,1244,54.58%,16.24%,1
新北市,新莊區,0473,198,483,681,48,729,1356,53.76%,14.6%,1
新北市,新莊區,0474,178,405,583,24,607,1164,52.15%,15.29%,1
新北市,新莊區,0475,272,514,786,54,840,1423,59.03%,19.11%,1
新北市,新莊區,0476,270,476,746,31,777,1250,62.16%,21.6%,1
新北市,新莊區,0477,251,413,664,30,694,1252,55.43%,20.05%,1
新北市,新莊區,0478,193,251,444,16,460,1022,45.01%,18.88%,1
新北市,新莊區,0479,185,337,522,44,566,959,59.02%,19.29%,1
新北市,新莊區,0480,352,559,911,42,953,1646,57.9%,21.39%,1
新北市,新莊區,0481,345,467,812,54,866,1551,55.83%,22.24%,1
新北市,新莊區,0482,310,556,866,42,908,1526,59.5%,20.31%,1
新北市,新莊區,0483,337,506,843,24,867,1518,57.11%,22.2%,1
新北市,新莊區,0484,345,526,871,31,902,1547,58.31%,22.3%,1
新北市,新莊區,0485,263,495,758,67,825,1505,54.82%,17.48%,1
新北市,新莊區,0486,267,487,754,70,824,1527,53.96%,17.49%,1
新北市,新莊區,0487,263,479,742,38,780,1482,52.63%,17.75%,1
新北市,新莊區,0488,271,491,762,67,829,1586,52.27%,17.09%,1
新北市,新莊區,0489,197,356,553,68,621,1065,58.31%,18.5%,1
新北市,新莊區,0490,216,421,637,39,676,1040,65%,20.77%,1
新北市,新莊區,0491,215,356,571,42,613,1090,56.24%,19.72%,1
新北市,新莊區,0492,206,378,584,46,630,1071,58.82%,19.23%,1
新北市,新莊區,0493,307,516,823,37,860,1704,50.47%,18.02%,1
新北市,新莊區,0494,311,512,823,30,853,1698,50.24%,18.32%,1
新北市,新莊區,0495,297,509,806,47,853,1362,62.63%,21.81%,1
新北市,新莊區,0496,323,452,775,38,813,1350,60.22%,23.93%,1
新北市,新莊區,0497,313,568,881,82,963,1689,57.02%,18.53%,1
新北市,新莊區,0498,315,549,864,74,938,1612,58.19%,19.54%,1
新北市,新莊區,0499,205,425,630,54,684,1130,60.53%,18.14%,1
新北市,新莊區,0500,233,416,649,49,698,1111,62.83%,20.97%,1
新北市,新莊區,0501,294,493,787,46,833,1539,54.13%,19.1%,1
新北市,新莊區,0502,342,521,863,38,901,1586,56.81%,21.56%,1
新北市,新莊區,0503,323,558,881,55,936,1631,57.39%,19.8%,1
新北市,新莊區,0504,336,488,824,33,857,1540,55.65%,21.82%,1
新北市,新莊區,0505,227,424,651,44,695,1388,50.07%,16.35%,1
新北市,新莊區,0506,240,404,644,73,717,1388,51.66%,17.29%,1
新北市,新莊區,0507,244,405,649,51,700,1387,50.47%,17.59%,1
新北市,新莊區,0508,217,370,587,33,620,1181,52.5%,18.37%,1
新北市,新莊區,0509,235,372,607,55,662,1135,58.33%,20.7%,1
新北市,新莊區,0510,254,391,645,30,675,1173,57.54%,21.65%,1
新北市,新莊區,0511,291,375,666,36,702,1215,57.78%,23.95%,1
新北市,新莊區,0512,318,502,820,48,868,1488,58.33%,21.37%,1
新北市,新莊區,0513,310,472,782,41,823,1444,56.99%,21.47%,1
新北市,新莊區,0514,308,500,808,29,837,1499,55.84%,20.55%,1
新北市,新莊區,0515,300,478,778,26,804,1449,55.49%,20.7%,1
新北市,新莊區,0516,332,540,872,55,927,1640,56.52%,20.24%,1
新北市,新莊區,0517,310,535,845,65,910,1648,55.22%,18.81%,1
新北市,新莊區,0518,250,414,664,58,722,1371,52.66%,18.23%,1
新北市,新莊區,0519,274,446,720,55,775,1400,55.36%,19.57%,1
新北市,新莊區,0520,260,489,749,73,822,1457,56.42%,17.84%,1
新北市,新莊區,0521,294,470,764,56,820,1502,54.59%,19.57%,1
新北市,新莊區,0522,269,455,724,61,785,1412,55.59%,19.05%,1
新北市,新莊區,0523,241,449,690,53,743,1318,56.37%,18.29%,1
新北市,新莊區,0524,212,470,682,54,736,1411,52.16%,15.02%,1
新北市,新莊區,0525,279,444,723,28,751,1262,59.51%,22.11%,1
新北市,新莊區,0526,254,471,725,18,743,1228,60.5%,20.68%,1
新北市,新莊區,0527,426,544,970,53,1023,1748,58.52%,24.37%,1
新北市,新莊區,0528,433,520,953,77,1030,1761,58.49%,24.59%,1
新北市,新莊區,0529,244,418,662,46,708,1326,53.39%,18.4%,1
新北市,新莊區,0530,201,430,631,42,673,1344,50.07%,14.96%,1
新北市,新莊區,0531,231,495,726,44,770,1355,56.83%,17.05%,1
新北市,新莊區,0532,227,470,697,65,762,1306,58.35%,17.38%,1
新北市,新莊區,0533,285,475,760,38,798,1349,59.15%,21.13%,1
新北市,新莊區,0534,253,436,689,38,727,1265,57.47%,20%,1
新北市,新莊區,0535,236,481,717,58,775,1282,60.45%,18.41%,1
新北市,新莊區,0536,243,468,711,39,750,1237,60.63%,19.64%,1
新北市,新莊區,0537,241,459,700,29,729,1301,56.03%,18.52%,1
新北市,新莊區,0538,232,445,677,50,727,1262,57.61%,18.38%,1
新北市,新莊區,0539,235,454,689,37,726,1270,57.17%,18.5%,1
新北市,新莊區,0540,266,403,669,63,732,1245,58.8%,21.37%,1
新北市,新莊區,0541,213,309,522,65,587,1220,48.11%,17.46%,1
新北市,新莊區,0542,226,398,624,40,664,1245,53.33%,18.15%,1
新北市,新莊區,0543,207,409,616,40,656,1212,54.13%,17.08%,1
新北市,新莊區,0544,229,399,628,57,685,1253,54.67%,18.28%,1
新北市,新莊區,0545,214,424,638,39,677,1272,53.22%,16.82%,1
新北市,新莊區,0546,255,448,703,27,730,1227,59.49%,20.78%,1
新北市,新莊區,0547,229,415,644,33,677,1126,60.12%,20.34%,1
新北市,新莊區,0548,248,442,690,31,721,1240,58.15%,20%,1
新北市,新莊區,0549,284,514,798,37,835,1460,57.19%,19.45%,1
新北市,新莊區,0550,214,353,567,33,600,1072,55.97%,19.96%,1
新北市,新莊區,0551,207,346,553,40,593,1127,52.62%,18.37%,1
新北市,新莊區,0552,262,491,753,23,776,1332,58.26%,19.67%,1
新北市,新莊區,0553,285,409,694,15,709,1341,52.87%,21.25%,1
新北市,新莊區,0554,191,298,489,29,518,1140,45.44%,16.75%,1
新北市,新店區,1987,306,546,852,47,899,1603,56.08%,19.09%,1
新北市,新店區,1988,272,665,937,47,984,1921,51.22%,14.16%,1
新北市,新店區,1989,193,378,571,24,595,1082,54.99%,17.84%,1
新北市,新店區,1990,251,433,684,35,719,1235,58.22%,20.32%,1
新北市,新店區,1991,283,602,885,31,916,1568,58.42%,18.05%,1
新北市,新店區,1992,180,251,431,33,464,771,60.18%,23.35%,1
新北市,新店區,1993,283,400,683,34,717,1256,57.09%,22.53%,1
新北市,新店區,1994,196,360,556,48,604,1008,59.92%,19.44%,1
新北市,新店區,1995,284,570,854,43,897,1515,59.21%,18.75%,1
新北市,新店區,1996,308,663,971,38,1009,1637,61.64%,18.81%,1
新北市,新店區,1997,330,538,868,36,904,1549,58.36%,21.3%,1
新北市,新店區,1998,402,812,1214,50,1264,2011,62.85%,19.99%,1
新北市,新店區,1999,285,559,844,62,906,1554,58.3%,18.34%,1
新北市,新店區,2000,337,603,940,49,989,1770,55.88%,19.04%,1
新北市,新店區,2001,265,464,729,53,782,1316,59.42%,20.14%,1
新北市,新店區,2002,193,408,601,43,644,1126,57.19%,17.14%,1
新北市,新店區,2003,261,501,762,40,802,1460,54.93%,17.88%,1
新北市,新店區,2004,310,594,904,45,949,1584,59.91%,19.57%,1
新北市,新店區,2005,278,513,791,41,832,1449,57.42%,19.19%,1
新北市,新店區,2006,287,632,919,35,954,1520,62.76%,18.88%,1
新北市,新店區,2007,334,710,1044,26,1070,1821,58.76%,18.34%,1
新北市,新店區,2008,398,684,1082,42,1124,1956,57.46%,20.35%,1
新北市,新店區,2009,331,599,930,49,979,1665,58.8%,19.88%,1
新北市,新店區,2010,183,768,951,16,967,1588,60.89%,11.52%,1
新北市,新店區,2011,321,516,837,12,849,1519,55.89%,21.13%,1
新北市,新店區,2012,284,440,724,26,750,1185,63.29%,23.97%,1
新北市,新店區,2013,264,410,674,22,696,1095,63.56%,24.11%,1
新北市,新店區,2014,207,442,649,46,695,1106,62.84%,18.72%,1
新北市,新店區,2015,150,242,392,18,410,2700,15.19%,5.56%,1
新北市,新店區,2016,195,396,591,19,610,995,61.31%,19.6%,1
新北市,新店區,2017,218,423,641,36,677,1168,57.96%,18.66%,1
新北市,新店區,2018,238,484,722,41,763,1123,67.94%,21.19%,1
新北市,新店區,2019,251,426,677,30,707,1085,65.16%,23.13%,1
新北市,新店區,2020,300,540,840,46,886,1412,62.75%,21.25%,1
新北市,新店區,2021,315,626,941,45,986,1659,59.43%,18.99%,1
新北市,新店區,2022,230,495,725,38,763,1198,63.69%,19.2%,1
新北市,新店區,2023,227,485,712,34,746,1376,54.22%,16.5%,1
新北市,新店區,2024,224,466,690,30,720,1300,55.38%,17.23%,1
新北市,新店區,2025,208,487,695,28,723,1238,58.4%,16.8%,1
新北市,新店區,2026,237,489,726,26,752,1388,54.18%,17.07%,1
新北市,新店區,2027,193,357,550,38,588,933,63.02%,20.69%,1
新北市,新店區,2028,187,377,564,20,584,908,64.32%,20.59%,1
新北市,新店區,2029,272,594,866,46,912,1582,57.65%,17.19%,1
新北市,新店區,2030,248,483,731,49,780,1247,62.55%,19.89%,1
新北市,新店區,2031,192,379,571,34,605,971,62.31%,19.77%,1
新北市,新店區,2032,228,440,668,41,709,1145,61.92%,19.91%,1
新北市,新店區,2033,268,522,790,46,836,1392,60.06%,19.25%,1
新北市,新店區,2034,266,599,865,52,917,1452,63.15%,18.32%,1
新北市,新店區,2035,267,525,792,46,838,1440,58.19%,18.54%,1
新北市,新店區,2036,341,613,954,57,1011,1786,56.61%,19.09%,1
新北市,新店區,2037,349,667,1016,51,1067,1825,58.47%,19.12%,1
新北市,新店區,2038,284,586,870,28,898,1477,60.8%,19.23%,1
新北市,新店區,2039,372,616,988,43,1031,1750,58.91%,21.26%,1
新北市,新店區,2040,272,710,982,39,1021,1792,56.98%,15.18%,1
新北市,新店區,2041,334,756,1090,35,1125,1979,56.85%,16.88%,1
新北市,新店區,2042,158,321,479,27,506,826,61.26%,19.13%,1
新北市,新店區,2043,335,762,1097,45,1142,1924,59.36%,17.41%,1
新北市,新店區,2044,277,579,856,18,874,1383,63.2%,20.03%,1
新北市,新店區,2045,137,261,398,31,429,830,51.69%,16.51%,1
新北市,新店區,2046,354,671,1025,39,1064,1759,60.49%,20.13%,1
新北市,新店區,2047,387,755,1142,44,1186,1957,60.6%,19.78%,1
新北市,新店區,2048,309,570,879,27,906,1481,61.17%,20.86%,1
新北市,新店區,2049,326,543,869,50,919,1552,59.21%,21.01%,1
新北市,新店區,2050,280,514,794,54,848,1467,57.81%,19.09%,1
新北市,新店區,2051,258,503,761,38,799,1371,58.28%,18.82%,1
新北市,新店區,2052,199,372,571,30,601,991,60.65%,20.08%,1
新北市,新店區,2053,258,452,710,42,752,1231,61.09%,20.96%,1
新北市,新店區,2054,336,607,943,52,995,1701,58.5%,19.75%,1
新北市,新店區,2055,340,605,945,52,997,1707,58.41%,19.92%,1
新北市,新店區,2056,329,639,968,36,1004,1773,56.63%,18.56%,1
新北市,新店區,2057,325,634,959,32,991,1866,53.11%,17.42%,1
新北市,新店區,2058,363,637,1000,33,1033,1735,59.54%,20.92%,1
新北市,新店區,2059,370,649,1019,31,1050,1632,64.34%,22.67%,1
新北市,新店區,2060,325,576,901,46,947,1591,59.52%,20.43%,1
新北市,新店區,2061,245,500,745,68,813,1495,54.38%,16.39%,1
新北市,新店區,2062,232,531,763,22,785,1511,51.95%,15.35%,1
新北市,新店區,2063,241,443,684,52,736,1260,58.41%,19.13%,1
新北市,新店區,2064,367,759,1126,40,1166,1948,59.86%,18.84%,1
新北市,新店區,2065,320,626,946,39,985,1582,62.26%,20.23%,1
新北市,新店區,2066,257,474,731,35,766,1315,58.25%,19.54%,1
新北市,新店區,2067,301,517,818,48,866,1562,55.44%,19.27%,1
新北市,新店區,2068,410,752,1162,21,1183,1982,59.69%,20.69%,1
新北市,新店區,2069,295,558,853,50,903,1518,59.49%,19.43%,1
新北市,新店區,2070,328,623,951,31,982,1735,56.6%,18.9%,1
新北市,新店區,2071,293,622,915,39,954,1716,55.59%,17.07%,1
新北市,新店區,2072,324,565,889,37,926,1580,58.61%,20.51%,1
新北市,新店區,2073,311,499,810,41,851,1358,62.67%,22.9%,1
新北市,新店區,2074,346,591,937,65,1002,1610,62.24%,21.49%,1
新北市,新店區,2075,257,490,747,37,784,1383,56.69%,18.58%,1
新北市,新店區,2076,303,597,900,34,934,1596,58.52%,18.98%,1
新北市,新店區,2077,224,465,689,38,727,1360,53.46%,16.47%,1
新北市,新店區,2078,168,431,599,13,612,1160,52.76%,14.48%,1
新北市,新店區,2079,192,594,786,34,820,1236,66.34%,15.53%,1
新北市,新店區,2080,260,521,781,17,798,1234,64.67%,21.07%,1
新北市,新店區,2081,292,548,840,76,916,1579,58.01%,18.49%,1
新北市,新店區,2082,207,463,670,41,711,1241,57.29%,16.68%,1
新北市,新店區,2083,239,455,694,28,722,1275,56.63%,18.75%,1
新北市,新店區,2084,192,420,612,33,645,1214,53.13%,15.82%,1
新北市,新店區,2085,252,466,718,72,790,1578,50.06%,15.97%,1
新北市,新店區,2086,292,464,756,39,795,1442,55.13%,20.25%,1
新北市,新店區,2087,230,475,705,67,772,1475,52.34%,15.59%,1
新北市,新店區,2088,301,586,887,45,932,1580,58.99%,19.05%,1
新北市,新店區,2089,224,630,854,28,882,1585,55.65%,14.13%,1
新北市,新店區,2090,301,534,835,58,893,1586,56.31%,18.98%,1
新北市,新店區,2091,358,664,1022,55,1077,1931,55.77%,18.54%,1
新北市,新店區,2092,218,440,658,25,683,1239,55.13%,17.59%,1
新北市,新店區,2093,320,681,1001,48,1049,1892,55.44%,16.91%,1
新北市,新店區,2094,231,521,752,56,808,1529,52.84%,15.11%,1
新北市,新店區,2095,228,523,751,41,792,1358,58.32%,16.79%,1
新北市,新店區,2096,347,608,955,42,997,1905,52.34%,18.22%,1
新北市,新店區,2097,318,595,913,102,1015,1885,53.85%,16.87%,1
新北市,新店區,2098,213,463,676,59,735,1345,54.65%,15.84%,1
新北市,新店區,2099,230,520,750,51,801,1387,57.75%,16.58%,1
新北市,新店區,2100,354,681,1035,43,1078,1960,55%,18.06%,1
新北市,新店區,2101,332,632,964,67,1031,1837,56.12%,18.07%,1
新北市,新店區,2102,326,581,907,41,948,1662,57.04%,19.61%,1
新北市,新店區,2103,337,603,940,55,995,1617,61.53%,20.84%,1
新北市,新店區,2104,324,620,944,34,978,1704,57.39%,19.01%,1
新北市,新店區,2105,313,619,932,59,991,1835,54.01%,17.06%,1
新北市,新店區,2106,339,686,1025,58,1083,2009,53.91%,16.87%,1
新北市,新店區,2107,240,519,759,53,812,1450,56%,16.55%,1
新北市,新店區,2108,316,608,924,37,961,1726,55.68%,18.31%,1
新北市,新店區,2109,332,591,923,53,976,1797,54.31%,18.48%,1
新北市,新店區,2110,313,622,935,37,972,1739,55.89%,18%,1
新北市,新店區,2111,252,579,831,28,859,1523,56.4%,16.55%,1
新北市,新店區,2112,297,578,875,21,896,1642,54.57%,18.09%,1
新北市,新店區,2113,335,573,908,19,927,1644,56.39%,20.38%,1
新北市,新店區,2114,284,536,820,38,858,1662,51.62%,17.09%,1
新北市,新店區,2115,410,713,1123,60,1183,2067,57.23%,19.84%,1
新北市,新店區,2116,300,522,822,48,870,1870,46.52%,16.04%,1
新北市,新店區,2117,364,691,1055,26,1081,1982,54.54%,18.37%,1
新北市,新店區,2118,292,549,841,32,873,1546,56.47%,18.89%,1
新北市,新店區,2119,322,679,1001,33,1034,1712,60.4%,18.81%,1
新北市,新店區,2120,298,562,860,23,883,1423,62.05%,20.94%,1
新北市,新店區,2121,360,594,954,55,1009,1666,60.56%,21.61%,1
新北市,新店區,2122,339,721,1060,38,1098,1769,62.07%,19.16%,1
新北市,新店區,2123,177,331,508,36,544,1079,50.42%,16.4%,1
新北市,新店區,2124,198,400,598,21,619,1140,54.3%,17.37%,1
新北市,新店區,2125,321,630,951,52,1003,1825,54.96%,17.59%,1
新北市,新店區,2126,241,432,673,42,715,1178,60.7%,20.46%,1
新北市,新店區,2127,264,502,766,31,797,1463,54.48%,18.05%,1
新北市,新店區,2128,214,416,630,37,667,1152,57.9%,18.58%,1
新北市,新店區,2129,298,608,906,36,942,2008,46.91%,14.84%,1
新北市,新店區,2130,315,611,926,43,969,2120,45.71%,14.86%,1
新北市,新店區,2131,241,442,683,10,693,1153,60.1%,20.9%,1
新北市,新店區,2132,262,550,812,21,833,1573,52.96%,16.66%,1
新北市,新店區,2133,287,616,903,69,972,1992,48.8%,14.41%,1
新北市,新店區,2134,255,509,764,53,817,1668,48.98%,15.29%,1
新北市,新店區,2135,254,508,762,38,800,1617,49.47%,15.71%,1
新北市,新店區,2136,343,657,1000,78,1078,2013,53.55%,17.04%,1
新北市,新店區,2137,350,658,1008,36,1044,1791,58.29%,19.54%,1
新北市,新店區,2138,288,597,885,43,928,1624,57.14%,17.73%,1
新北市,新店區,2139,208,468,676,40,716,1178,60.78%,17.66%,1
新北市,新店區,2140,242,488,730,24,754,1277,59.04%,18.95%,1
新北市,新店區,2141,342,689,1031,32,1063,1879,56.57%,18.2%,1
新北市,新店區,2142,125,288,413,38,451,939,48.03%,13.31%,1
新北市,新店區,2143,196,331,527,20,547,960,56.98%,20.42%,1
新北市,新店區,2144,241,547,788,91,879,1434,61.3%,16.81%,1
新北市,新店區,2145,306,592,898,51,949,1838,51.63%,16.65%,1
新北市,新店區,2146,272,505,777,39,816,1453,56.16%,18.72%,1
新北市,新店區,2147,263,521,784,47,831,1549,53.65%,16.98%,1
新北市,新店區,2148,354,687,1041,40,1081,1860,58.12%,19.03%,1
新北市,新店區,2149,277,594,871,37,908,1743,52.09%,15.89%,1
新北市,新店區,2150,240,469,709,28,737,1122,65.69%,21.39%,1
新北市,新店區,2151,215,562,777,38,815,1468,55.52%,14.65%,1
新北市,新店區,2152,340,580,920,32,952,1763,54%,19.29%,1
新北市,新店區,2153,253,423,676,29,705,1344,52.46%,18.82%,1
新北市,新店區,2154,90,275,365,43,408,753,54.18%,11.95%,1
新北市,新店區,2155,137,185,322,11,333,602,55.32%,22.76%,1
新北市,新店區,2156,466,663,1129,46,1175,2237,52.53%,20.83%,1
新北市,新店區,2157,203,374,577,32,609,1096,55.57%,18.52%,1
新北市,新店區,2158,173,333,506,33,539,1143,47.16%,15.14%,1
新北市,新店區,2159,261,483,744,75,819,1569,52.2%,16.63%,1
新北市,新店區,2160,211,344,555,60,615,1284,47.9%,16.43%,1
新北市,新店區,2161,53,91,144,12,156,439,35.54%,12.07%,1
新北市,新店區,2162,165,240,405,30,435,750,58%,22%,1
新北市,樹林區,1614,238,450,688,54,742,1408,52.7%,16.9%,1
新北市,樹林區,1615,221,453,674,15,689,1310,52.6%,16.87%,1
新北市,樹林區,1616,242,455,697,58,755,1534,49.22%,15.78%,1
新北市,樹林區,1617,214,411,625,48,673,1211,55.57%,17.67%,1
新北市,樹林區,1618,218,402,620,42,662,1125,58.84%,19.38%,1
新北市,樹林區,1619,199,481,680,33,713,1134,62.87%,17.55%,1
新北市,樹林區,1620,215,603,818,77,895,1897,47.18%,11.33%,1
新北市,樹林區,1621,329,522,851,59,910,1716,53.03%,19.17%,1
新北市,樹林區,1622,158,267,425,33,458,736,62.23%,21.47%,1
新北市,樹林區,1623,260,410,670,27,697,1137,61.3%,22.87%,1
新北市,樹林區,1624,311,447,758,47,805,1542,52.2%,20.17%,1
新北市,樹林區,1625,277,479,756,60,816,1470,55.51%,18.84%,1
新北市,樹林區,1626,257,426,683,26,709,1456,48.7%,17.65%,1
新北市,樹林區,1627,222,394,616,27,643,1124,57.21%,19.75%,1
新北市,樹林區,1628,211,415,626,32,658,1235,53.28%,17.09%,1
新北市,樹林區,1629,229,416,645,29,674,1212,55.61%,18.89%,1
新北市,樹林區,1630,196,385,581,36,617,1223,50.45%,16.03%,1
新北市,樹林區,1631,215,544,759,72,831,1335,62.25%,16.1%,1
新北市,樹林區,1632,240,387,627,36,663,1206,54.98%,19.9%,1
新北市,樹林區,1633,239,412,651,60,711,1927,36.9%,12.4%,1
新北市,樹林區,1634,165,307,472,49,521,914,57%,18.05%,1
新北市,樹林區,1635,284,500,784,50,834,1456,57.28%,19.51%,1
新北市,樹林區,1636,246,489,735,43,778,1409,55.22%,17.46%,1
新北市,樹林區,1637,270,568,838,64,902,1500,60.13%,18%,1
新北市,樹林區,1638,341,473,814,53,867,1545,56.12%,22.07%,1
新北市,樹林區,1639,287,467,754,26,780,1483,52.6%,19.35%,1
新北市,樹林區,1640,301,505,806,25,831,1524,54.53%,19.75%,1
新北市,樹林區,1641,285,462,747,51,798,1431,55.77%,19.92%,1
新北市,樹林區,1642,215,403,618,38,656,1181,55.55%,18.2%,1
新北市,樹林區,1643,216,384,600,51,651,1116,58.33%,19.35%,1
新北市,樹林區,1644,189,340,529,36,565,1077,52.46%,17.55%,1
新北市,樹林區,1645,195,353,548,15,563,1103,51.04%,17.68%,1
新北市,樹林區,1646,286,447,733,42,775,1385,55.96%,20.65%,1
新北市,樹林區,1647,236,400,636,35,671,1266,53%,18.64%,1
新北市,樹林區,1648,229,378,607,43,650,1195,54.39%,19.16%,1
新北市,樹林區,1649,238,389,627,56,683,1254,54.47%,18.98%,1
新北市,樹林區,1650,269,428,697,33,730,1263,57.8%,21.3%,1
新北市,樹林區,1651,319,531,850,62,912,1473,61.91%,21.66%,1
新北市,樹林區,1652,151,321,472,30,502,870,57.7%,17.36%,1
新北市,樹林區,1653,262,499,761,53,814,1338,60.84%,19.58%,1
新北市,樹林區,1654,187,325,512,34,546,1010,54.06%,18.51%,1
新北市,樹林區,1655,302,587,889,62,951,1658,57.36%,18.21%,1
新北市,樹林區,1656,372,531,903,62,965,1538,62.74%,24.19%,1
新北市,樹林區,1657,317,498,815,70,885,1405,62.99%,22.56%,1
新北市,樹林區,1658,321,517,838,51,889,1587,56.02%,20.23%,1
新北市,樹林區,1659,314,539,853,33,886,1566,56.58%,20.05%,1
新北市,樹林區,1660,178,326,504,27,531,997,53.26%,17.85%,1
新北市,樹林區,1661,230,394,624,55,679,1187,57.2%,19.38%,1
新北市,樹林區,1662,200,338,538,42,580,1061,54.67%,18.85%,1
新北市,樹林區,1663,309,619,928,43,971,1701,57.08%,18.17%,1
新北市,樹林區,1664,208,475,683,42,725,1278,56.73%,16.28%,1
新北市,樹林區,1665,316,503,819,46,865,1433,60.36%,22.05%,1
新北市,樹林區,1666,269,471,740,62,802,1306,61.41%,20.6%,1
新北市,樹林區,1667,262,454,716,61,777,1268,61.28%,20.66%,1
新北市,樹林區,1668,262,444,706,39,745,1281,58.16%,20.45%,1
新北市,樹林區,1669,266,406,672,45,717,1200,59.75%,22.17%,1
新北市,樹林區,1670,254,483,737,51,788,1491,52.85%,17.04%,1
新北市,樹林區,1671,179,363,542,38,580,1066,54.41%,16.79%,1
新北市,樹林區,1672,182,375,557,54,611,877,69.67%,20.75%,1
新北市,樹林區,1673,263,561,824,51,875,1616,54.15%,16.27%,1
新北市,樹林區,1674,260,438,698,53,751,1589,47.26%,16.36%,1
新北市,樹林區,1675,238,513,751,45,796,1367,58.23%,17.41%,1
新北市,樹林區,1676,209,436,645,46,691,1144,60.4%,18.27%,1
新北市,樹林區,1677,180,347,527,41,568,1059,53.64%,17%,1
新北市,樹林區,1678,224,377,601,78,679,1224,55.47%,18.3%,1
新北市,樹林區,1679,217,329,546,39,585,1141,51.27%,19.02%,1
新北市,樹林區,1680,222,390,612,23,635,1396,45.49%,15.9%,1
新北市,樹林區,1681,250,351,601,37,638,1157,55.14%,21.61%,1
新北市,樹林區,1682,255,442,697,78,775,1498,51.74%,17.02%,1
新北市,樹林區,1683,260,511,771,65,836,1514,55.22%,17.17%,1
新北市,樹林區,1684,270,480,750,33,783,1546,50.65%,17.46%,1
新北市,樹林區,1685,278,448,726,46,772,1392,55.46%,19.97%,1
新北市,樹林區,1686,270,576,846,39,885,1566,56.51%,17.24%,1
新北市,樹林區,1687,314,522,836,27,863,1566,55.11%,20.05%,1
新北市,樹林區,1688,300,485,785,50,835,1517,55.04%,19.78%,1
新北市,樹林區,1689,281,516,797,26,823,1481,55.57%,18.97%,1
新北市,樹林區,1690,213,431,644,43,687,1261,54.48%,16.89%,1
新北市,樹林區,1691,189,393,582,33,615,1163,52.88%,16.25%,1
新北市,樹林區,1692,353,578,931,74,1005,1661,60.51%,21.25%,1
新北市,樹林區,1693,322,535,857,39,896,1585,56.53%,20.32%,1
新北市,樹林區,1694,182,399,581,33,614,1018,60.31%,17.88%,1
新北市,樹林區,1695,218,428,646,53,699,1247,56.05%,17.48%,1
新北市,樹林區,1696,230,467,697,58,755,1390,54.32%,16.55%,1
新北市,樹林區,1697,241,461,702,43,745,1293,57.62%,18.64%,1
新北市,樹林區,1698,236,415,651,33,684,1301,52.57%,18.14%,1
新北市,樹林區,1699,310,492,802,54,856,1606,53.3%,19.3%,1
新北市,樹林區,1700,204,419,623,85,708,1277,55.44%,15.97%,1
新北市,樹林區,1701,248,394,642,56,698,1219,57.26%,20.34%,1
新北市,樹林區,1702,221,494,715,35,750,1454,51.58%,15.2%,1
新北市,樹林區,1703,210,461,671,30,701,1314,53.35%,15.98%,1
新北市,樹林區,1704,206,402,608,31,639,1008,63.39%,20.44%,1
新北市,樹林區,1705,282,505,787,63,850,1574,54%,17.92%,1
新北市,樹林區,1706,261,490,751,30,781,1364,57.26%,19.13%,1
新北市,樹林區,1707,273,515,788,65,853,1677,50.86%,16.28%,1
新北市,樹林區,1708,246,484,730,30,760,1683,45.16%,14.62%,1
新北市,樹林區,1709,262,525,787,50,837,1452,57.64%,18.04%,1
新北市,樹林區,1710,326,574,900,31,931,1592,58.48%,20.48%,1
新北市,樹林區,1711,307,609,916,25,941,1619,58.12%,18.96%,1
新北市,樹林區,1712,338,638,976,26,1002,1642,61.02%,20.58%,1
新北市,樹林區,1713,290,446,736,11,747,1357,55.05%,21.37%,1
新北市,樹林區,1714,300,574,874,68,942,1638,57.51%,18.32%,1
新北市,樹林區,1715,333,508,841,37,878,1592,55.15%,20.92%,1
新北市,樹林區,1716,259,603,862,35,897,1521,58.97%,17.03%,1
新北市,樹林區,1717,345,626,971,52,1023,1707,59.93%,20.21%,1
新北市,樹林區,1718,349,615,964,54,1018,1741,58.47%,20.05%,1
新北市,樹林區,1719,297,589,886,42,928,1655,56.07%,17.95%,1
新北市,樹林區,1720,307,554,861,54,915,1775,51.55%,17.3%,1
新北市,樹林區,1721,275,668,943,43,986,1781,55.36%,15.44%,1
新北市,樹林區,1722,286,415,701,42,743,1565,47.48%,18.27%,1
新北市,樹林區,1723,169,310,479,24,503,936,53.74%,18.06%,1
新北市,樹林區,1724,198,354,552,29,581,1030,56.41%,19.22%,1
新北市,鶯歌區,1725,99,185,284,14,298,515,57.86%,19.22%,1
新北市,鶯歌區,1726,205,334,539,42,581,965,60.21%,21.24%,1
新北市,鶯歌區,1727,369,634,1003,63,1066,1931,55.2%,19.11%,1
新北市,鶯歌區,1728,333,509,842,48,890,1797,49.53%,18.53%,1
新北市,鶯歌區,1729,181,373,554,44,598,1057,56.58%,17.12%,1
新北市,鶯歌區,1730,174,306,480,13,493,962,51.25%,18.09%,1
新北市,鶯歌區,1731,202,354,556,29,585,934,62.63%,21.63%,1
新北市,鶯歌區,1732,355,626,981,56,1037,1742,59.53%,20.38%,1
新北市,鶯歌區,1733,310,517,827,47,874,1634,53.49%,18.97%,1
新北市,鶯歌區,1734,302,507,809,36,845,1676,50.42%,18.02%,1
新北市,鶯歌區,1735,398,651,1049,85,1134,2052,55.26%,19.4%,1
新北市,鶯歌區,1736,357,555,912,29,941,1977,47.6%,18.06%,1
新北市,鶯歌區,1737,412,621,1033,20,1053,1957,53.81%,21.05%,1
新北市,鶯歌區,1738,133,252,385,5,390,850,45.88%,15.65%,1
新北市,鶯歌區,1739,285,570,855,54,909,1782,51.01%,15.99%,1
新北市,鶯歌區,1740,276,482,758,40,798,1496,53.34%,18.45%,1
新北市,鶯歌區,1741,330,653,983,43,1026,2071,49.54%,15.93%,1
新北市,鶯歌區,1742,279,453,732,57,789,1753,45.01%,15.92%,1
新北市,鶯歌區,1743,288,570,858,35,893,1737,51.41%,16.58%,1
新北市,鶯歌區,1744,248,507,755,48,803,1669,48.11%,14.86%,1
新北市,鶯歌區,1745,296,503,799,37,836,1842,45.39%,16.07%,1
新北市,鶯歌區,1746,255,437,692,48,740,1454,50.89%,17.54%,1
新北市,鶯歌區,1747,189,282,471,35,506,942,53.72%,20.06%,1
新北市,鶯歌區,1748,238,414,652,52,704,1317,53.45%,18.07%,1
新北市,鶯歌區,1749,154,295,449,17,466,949,49.1%,16.23%,1
新北市,鶯歌區,1750,275,525,800,45,845,1440,58.68%,19.1%,1
新北市,鶯歌區,1751,305,619,924,69,993,1809,54.89%,16.86%,1
新北市,鶯歌區,1752,324,600,924,64,988,1758,56.2%,18.43%,1
新北市,鶯歌區,1753,269,562,831,37,868,1589,54.63%,16.93%,1
新北市,鶯歌區,1754,215,386,601,38,639,1067,59.89%,20.15%,1
新北市,鶯歌區,1755,202,413,615,30,645,1092,59.07%,18.5%,1
新北市,鶯歌區,1756,311,614,925,41,966,1730,55.84%,17.98%,1
新北市,鶯歌區,1757,197,477,674,41,715,1281,55.82%,15.38%,1
新北市,鶯歌區,1758,239,484,723,45,768,1238,62.04%,19.31%,1
新北市,鶯歌區,1759,270,544,814,55,869,1568,55.42%,17.22%,1
新北市,鶯歌區,1760,233,406,639,46,685,1271,53.89%,18.33%,1
新北市,鶯歌區,1761,181,315,496,25,521,1183,44.04%,15.3%,1
新北市,鶯歌區,1762,161,313,474,27,501,1026,48.83%,15.69%,1
新北市,鶯歌區,1763,297,513,810,43,853,1721,49.56%,17.26%,1
新北市,鶯歌區,1764,231,394,625,68,693,1317,52.62%,17.54%,1
新北市,鶯歌區,1765,207,378,585,42,627,1046,59.94%,19.79%,1
新北市,鶯歌區,1766,236,397,633,56,689,1144,60.23%,20.63%,1
新北市,鶯歌區,1767,219,367,586,60,646,1336,48.35%,16.39%,1
新北市,鶯歌區,1768,221,438,659,55,714,1479,48.28%,14.94%,1
新北市,鶯歌區,1769,298,542,840,55,895,1736,51.56%,17.17%,1
新北市,鶯歌區,1770,257,500,757,53,810,1389,58.32%,18.5%,1
新北市,鶯歌區,1771,313,664,977,63,1040,1956,53.17%,16%,1
新北市,鶯歌區,1772,253,449,702,53,755,1371,55.07%,18.45%,1
新北市,鶯歌區,1773,236,468,704,29,733,1810,40.5%,13.04%,1
新北市,鶯歌區,1774,41,79,120,3,123,227,54.19%,18.06%,1
新北市,三峽區,1917,58,109,167,20,187,274,68.25%,21.17%,1
新北市,三峽區,1918,105,187,292,30,322,583,55.23%,18.01%,1
新北市,三峽區,1919,271,517,788,20,808,1765,45.78%,15.35%,1
新北市,三峽區,1920,317,548,865,42,907,1714,52.92%,18.49%,1
新北市,三峽區,1921,227,440,667,29,696,1355,51.37%,16.75%,1
新北市,三峽區,1922,248,461,709,45,754,1329,56.73%,18.66%,1
新北市,三峽區,1923,176,330,506,59,565,1059,53.35%,16.62%,1
新北市,三峽區,1924,289,450,739,47,786,1364,57.62%,21.19%,1
新北市,三峽區,1925,240,360,600,46,646,1098,58.83%,21.86%,1
新北市,三峽區,1926,251,417,668,45,713,1296,55.02%,19.37%,1
新北市,三峽區,1927,223,404,627,43,670,1240,54.03%,17.98%,1
新北市,三峽區,1928,317,459,776,38,814,1531,53.17%,20.71%,1
新北市,三峽區,1929,233,454,687,26,713,1444,49.38%,16.14%,1
新北市,三峽區,1930,232,425,657,71,728,1347,54.05%,17.22%,1
新北市,三峽區,1931,254,490,744,44,788,1455,54.16%,17.46%,1
新北市,三峽區,1932,249,457,706,35,741,1556,47.62%,16%,1
新北市,三峽區,1933,225,367,592,26,618,1390,44.46%,16.19%,1
新北市,三峽區,1934,283,496,779,42,821,1532,53.59%,18.47%,1
新北市,三峽區,1935,206,413,619,55,674,1377,48.95%,14.96%,1
新北市,三峽區,1936,302,556,858,41,899,1731,51.94%,17.45%,1
新北市,三峽區,1937,284,547,831,31,862,1705,50.56%,16.66%,1
新北市,三峽區,1938,328,517,845,34,879,1590,55.28%,20.63%,1
新北市,三峽區,1939,302,610,912,31,943,1650,57.15%,18.3%,1
新北市,三峽區,1940,269,504,773,25,798,1441,55.38%,18.67%,1
新北市,三峽區,1941,267,521,788,24,812,1404,57.83%,19.02%,1
新北市,三峽區,1942,278,463,741,32,773,1295,59.69%,21.47%,1
新北市,三峽區,1943,228,356,584,27,611,1348,45.33%,16.91%,1
新北市,三峽區,1944,282,572,854,21,875,1579,55.41%,17.86%,1
新北市,三峽區,1945,245,502,747,23,770,1435,53.66%,17.07%,1
新北市,三峽區,1946,292,650,942,27,969,1659,58.41%,17.6%,1
新北市,三峽區,1947,345,552,897,23,920,1512,60.85%,22.82%,1
新北市,三峽區,1948,267,553,820,28,848,1463,57.96%,18.25%,1
新北市,三峽區,1949,310,541,851,12,863,1465,58.91%,21.16%,1
新北市,三峽區,1950,272,574,846,11,857,1463,58.58%,18.59%,1
新北市,三峽區,1951,275,534,809,27,836,1443,57.93%,19.06%,1
新北市,三峽區,1952,281,512,793,37,830,1634,50.8%,17.2%,1
新北市,三峽區,1953,292,586,878,51,929,1716,54.14%,17.02%,1
新北市,三峽區,1954,282,553,835,32,867,1675,51.76%,16.84%,1
新北市,三峽區,1955,246,449,695,48,743,1649,45.06%,14.92%,1
新北市,三峽區,1956,257,482,739,50,789,1489,52.99%,17.26%,1
新北市,三峽區,1957,312,512,824,46,870,1771,49.12%,17.62%,1
新北市,三峽區,1958,366,554,920,28,948,1726,54.92%,21.21%,1
新北市,三峽區,1959,218,461,679,51,730,1363,53.56%,15.99%,1
新北市,三峽區,1960,314,523,837,36,873,1624,53.76%,19.33%,1
新北市,三峽區,1961,260,449,709,47,756,1352,55.92%,19.23%,1
新北市,三峽區,1962,234,401,635,16,651,1608,40.49%,14.55%,1
新北市,三峽區,1963,255,480,735,50,785,1458,53.84%,17.49%,1
新北市,三峽區,1964,278,479,757,42,799,1641,48.69%,16.94%,1
新北市,三峽區,1965,257,451,708,103,811,1530,53.01%,16.8%,1
新北市,三峽區,1966,185,388,573,62,635,1389,45.72%,13.32%,1
新北市,三峽區,1967,216,384,600,66,666,1315,50.65%,16.43%,1
新北市,三峽區,1968,136,393,529,39,568,934,60.81%,14.56%,1
新北市,三峽區,1969,202,382,584,28,612,1270,48.19%,15.91%,1
新北市,三峽區,1970,144,286,430,28,458,929,49.3%,15.5%,1
新北市,三峽區,1971,163,358,521,16,537,1035,51.88%,15.75%,1
新北市,三峽區,1972,79,151,230,13,243,502,48.41%,15.74%,1
新北市,三峽區,1973,98,266,364,49,413,836,49.4%,11.72%,1
新北市,三峽區,1974,85,190,275,54,329,669,49.18%,12.71%,1
新北市,三峽區,1975,119,258,377,63,440,733,60.03%,16.23%,1
新北市,三峽區,1976,268,611,879,55,934,1560,59.87%,17.18%,1
新北市,三峽區,1977,263,536,799,49,848,1638,51.77%,16.06%,1
新北市,三峽區,1978,188,497,685,31,716,1394,51.36%,13.49%,1
新北市,三峽區,1979,143,266,409,36,445,771,57.72%,18.55%,1
新北市,三峽區,1980,230,442,672,23,695,1367,50.84%,16.83%,1
新北市,三峽區,1981,183,409,592,55,647,1241,52.14%,14.75%,1
新北市,三峽區,1982,240,445,685,48,733,1520,48.22%,15.79%,1
新北市,三峽區,1983,142,378,520,37,557,873,63.8%,16.27%,1
新北市,三峽區,1984,105,179,284,90,374,768,48.7%,13.67%,1
新北市,三峽區,1985,155,331,486,32,518,1097,47.22%,14.13%,1
新北市,三峽區,1986,166,349,515,66,581,1322,43.95%,12.56%,1
新北市,淡水區,0029,97,172,269,23,292,544,53.68%,17.83%,1
新北市,淡水區,0030,176,353,529,52,581,1044,55.65%,16.86%,1
新北市,淡水區,0031,200,500,700,42,742,1462,50.75%,13.68%,1
新北市,淡水區,0032,237,483,720,79,799,1525,52.39%,15.54%,1
新北市,淡水區,0033,149,284,433,40,473,986,47.97%,15.11%,1
新北市,淡水區,0034,128,296,424,37,461,806,57.2%,15.88%,1
新北市,淡水區,0035,171,413,584,73,657,1173,56.01%,14.58%,1
新北市,淡水區,0036,190,417,607,39,646,1343,48.1%,14.15%,1
新北市,淡水區,0037,177,324,501,13,514,1153,44.58%,15.35%,1
新北市,淡水區,0038,136,276,412,35,447,874,51.14%,15.56%,1
新北市,淡水區,0039,155,364,519,76,595,1063,55.97%,14.58%,1
新北市,淡水區,0040,187,435,622,41,663,1309,50.65%,14.29%,1
新北市,淡水區,0041,219,423,642,51,693,1290,53.72%,16.98%,1
新北市,淡水區,0042,319,611,930,27,957,1675,57.13%,19.04%,1
新北市,淡水區,0043,308,518,826,48,874,1589,55%,19.38%,1
新北市,淡水區,0044,339,556,895,47,942,1624,58%,20.87%,1
新北市,淡水區,0045,253,374,627,34,661,1241,53.26%,20.39%,1
新北市,淡水區,0046,219,423,642,53,695,1317,52.77%,16.63%,1
新北市,淡水區,0047,237,432,669,26,695,1225,56.73%,19.35%,1
新北市,淡水區,0048,287,468,755,35,790,1426,55.4%,20.13%,1
新北市,淡水區,0049,350,546,896,39,935,1610,58.07%,21.74%,1
新北市,淡水區,0050,403,669,1072,35,1107,1982,55.85%,20.33%,1
新北市,淡水區,0051,313,542,855,50,905,1924,47.04%,16.27%,1
新北市,淡水區,0052,348,530,878,38,916,1822,50.27%,19.1%,1
新北市,淡水區,0053,280,383,663,74,737,1232,59.82%,22.73%,1
新北市,淡水區,0054,273,552,825,71,896,1588,56.42%,17.19%,1
新北市,淡水區,0055,360,515,875,30,905,1784,50.73%,20.18%,1
新北市,淡水區,0056,334,540,874,54,928,1762,52.67%,18.96%,1
新北市,淡水區,0057,311,483,794,28,822,1546,53.17%,20.12%,1
新北市,淡水區,0058,386,601,987,36,1023,1897,53.93%,20.35%,1
新北市,淡水區,0059,277,494,771,22,793,1489,53.26%,18.6%,1
新北市,淡水區,0060,312,514,826,38,864,1679,51.46%,18.58%,1
新北市,淡水區,0061,311,513,824,25,849,1693,50.15%,18.37%,1
新北市,淡水區,0062,256,554,810,19,829,1674,49.52%,15.29%,1
新北市,淡水區,0063,247,458,705,20,725,1330,54.51%,18.57%,1
新北市,淡水區,0064,265,487,752,19,771,1467,52.56%,18.06%,1
新北市,淡水區,0065,317,631,948,29,977,1837,53.18%,17.26%,1
新北市,淡水區,0066,233,403,636,15,651,1924,33.84%,12.11%,1
新北市,淡水區,0067,390,755,1145,25,1170,2340,50%,16.67%,1
新北市,淡水區,0068,251,486,737,58,795,1704,46.65%,14.73%,1
新北市,淡水區,0069,257,427,684,36,720,1363,52.82%,18.86%,1
新北市,淡水區,0070,495,906,1401,23,1424,3068,46.41%,16.13%,1
新北市,淡水區,0071,226,496,722,37,759,1528,49.67%,14.79%,1
新北市,淡水區,0072,313,473,786,50,836,1600,52.25%,19.56%,1
新北市,淡水區,0073,319,696,1015,56,1071,1874,57.15%,17.02%,1
新北市,淡水區,0074,276,506,782,52,834,1567,53.22%,17.61%,1
新北市,淡水區,0075,323,358,681,21,702,1245,56.39%,25.94%,1
新北市,淡水區,0076,244,376,620,16,636,1211,52.52%,20.15%,1
新北市,淡水區,0077,416,643,1059,39,1098,1992,55.12%,20.88%,1
新北市,淡水區,0078,401,476,877,29,906,2028,44.67%,19.77%,1
新北市,淡水區,0079,220,512,732,49,781,1373,56.88%,16.02%,1
新北市,淡水區,0080,321,592,913,30,943,1732,54.45%,18.53%,1
新北市,淡水區,0081,267,453,720,43,763,1519,50.23%,17.58%,1
新北市,淡水區,0082,286,522,808,23,831,1727,48.12%,16.56%,1
新北市,淡水區,0083,235,459,694,33,727,1297,56.05%,18.12%,1
新北市,淡水區,0084,193,333,526,45,571,1066,53.56%,18.11%,1
新北市,淡水區,0085,247,483,730,48,778,1387,56.09%,17.81%,1
新北市,淡水區,0086,337,664,1001,40,1041,1909,54.53%,17.65%,1
新北市,淡水區,0087,328,595,923,34,957,1770,54.07%,18.53%,1
新北市,淡水區,0088,338,655,993,44,1037,2049,50.61%,16.5%,1
新北市,淡水區,0089,344,541,885,26,911,1680,54.23%,20.48%,1
新北市,淡水區,0090,302,500,802,46,848,1433,59.18%,21.07%,1
新北市,淡水區,0091,264,442,706,25,731,1365,53.55%,19.34%,1
新北市,淡水區,0092,284,493,777,36,813,1452,55.99%,19.56%,1
新北市,淡水區,0093,303,615,918,42,960,1804,53.22%,16.8%,1
新北市,淡水區,0094,251,445,696,40,736,1322,55.67%,18.99%,1
新北市,淡水區,0095,414,626,1040,31,1071,2019,53.05%,20.51%,1
新北市,淡水區,0096,323,620,943,37,980,1696,57.78%,19.04%,1
新北市,淡水區,0097,308,553,861,24,885,1576,56.15%,19.54%,1
新北市,淡水區,0098,363,596,959,33,992,1781,55.7%,20.38%,1
新北市,淡水區,0099,356,563,919,55,974,1665,58.5%,21.38%,1
新北市,淡水區,0100,375,659,1034,47,1081,2013,53.7%,18.63%,1
新北市,淡水區,0101,212,341,553,41,594,1108,53.61%,19.13%,1
新北市,淡水區,0102,250,436,686,40,726,1305,55.63%,19.16%,1
新北市,淡水區,0103,216,416,632,21,653,1199,54.46%,18.02%,1
新北市,淡水區,0104,364,666,1030,38,1068,2017,52.95%,18.05%,1
新北市,淡水區,0105,386,611,997,43,1040,2125,48.94%,18.16%,1
新北市,淡水區,0106,199,378,577,27,604,1289,46.86%,15.44%,1
新北市,淡水區,0107,263,475,738,49,787,1319,59.67%,19.94%,1
新北市,淡水區,0108,195,380,575,28,603,1051,57.37%,18.55%,1
新北市,淡水區,0109,231,470,701,35,736,1348,54.6%,17.14%,1
新北市,淡水區,0110,210,346,556,35,591,1106,53.44%,18.99%,1
新北市,淡水區,0111,135,257,392,28,420,717,58.58%,18.83%,1
新北市,淡水區,0112,268,436,704,33,737,1385,53.21%,19.35%,1
新北市,淡水區,0113,173,290,463,39,502,841,59.69%,20.57%,1
新北市,淡水區,0114,135,228,363,23,386,665,58.05%,20.3%,1
新北市,淡水區,0115,86,151,237,14,251,419,59.9%,20.53%,1
新北市,淡水區,0116,306,570,876,25,901,1599,56.35%,19.14%,1
新北市,淡水區,0117,293,524,817,61,878,1670,52.57%,17.54%,1
新北市,淡水區,0118,321,586,907,52,959,1683,56.98%,19.07%,1
新北市,淡水區,0119,256,500,756,50,806,1577,51.11%,16.23%,1
新北市,淡水區,0120,275,500,775,38,813,1618,50.25%,17%,1
新北市,淡水區,0121,353,647,1000,37,1037,2214,46.84%,15.94%,1
新北市,淡水區,0122,321,593,914,40,954,1832,52.07%,17.52%,1
新北市,淡水區,0123,374,680,1054,61,1115,2123,52.52%,17.62%,1
新北市,淡水區,0124,400,881,1281,18,1299,2998,43.33%,13.34%,1
新北市,汐止區,2336,296,500,796,62,858,1595,53.79%,18.56%,1
新北市,汐止區,2337,248,416,664,42,706,1262,55.94%,19.65%,1
新北市,汐止區,2338,191,300,491,50,541,917,59%,20.83%,1
新北市,汐止區,2339,383,657,1040,35,1075,1929,55.73%,19.85%,1
新北市,汐止區,2340,437,697,1134,58,1192,2227,53.52%,19.62%,1
新北市,汐止區,2341,234,362,596,46,642,1143,56.17%,20.47%,1
新北市,汐止區,2342,277,509,786,29,815,1367,59.62%,20.26%,1
新北市,汐止區,2343,74,89,163,12,175,322,54.35%,22.98%,1
新北市,汐止區,2344,296,491,787,6,793,1460,54.32%,20.27%,1
新北市,汐止區,2345,343,501,844,39,883,1719,51.37%,19.95%,1
新北市,汐止區,2346,272,545,817,48,865,1661,52.08%,16.38%,1
新北市,汐止區,2347,327,532,859,45,904,1590,56.86%,20.57%,1
新北市,汐止區,2348,294,547,841,38,879,1599,54.97%,18.39%,1
新北市,汐止區,2349,596,337,933,39,972,1749,55.57%,34.08%,1
新北市,汐止區,2350,144,185,329,27,356,1809,19.68%,7.96%,1
新北市,汐止區,2351,281,460,741,28,769,1601,48.03%,17.55%,1
新北市,汐止區,2352,240,442,682,56,738,1387,53.21%,17.3%,1
新北市,汐止區,2353,370,574,944,54,998,1779,56.1%,20.8%,1
新北市,汐止區,2354,389,726,1115,46,1161,2074,55.98%,18.76%,1
新北市,汐止區,2355,417,660,1077,41,1118,2072,53.96%,20.13%,1
新北市,汐止區,2356,453,733,1186,56,1242,2120,58.58%,21.37%,1
新北市,汐止區,2357,447,626,1073,40,1113,1952,57.02%,22.9%,1
新北市,汐止區,2358,290,529,819,62,881,1654,53.26%,17.53%,1
新北市,汐止區,2359,261,448,709,54,763,1444,52.84%,18.07%,1
新北市,汐止區,2360,358,574,932,31,963,1627,59.19%,22%,1
新北市,汐止區,2361,329,522,851,61,912,1751,52.08%,18.79%,1
新北市,汐止區,2362,418,619,1037,49,1086,2066,52.57%,20.23%,1
新北市,汐止區,2363,291,535,826,49,875,1941,45.08%,14.99%,1
新北市,汐止區,2364,316,557,873,41,914,1906,47.95%,16.58%,1
新北市,汐止區,2365,227,430,657,61,718,1363,52.68%,16.65%,1
新北市,汐止區,2366,237,424,661,36,697,1368,50.95%,17.32%,1
新北市,汐止區,2367,215,351,566,48,614,1233,49.8%,17.44%,1
新北市,汐止區,2368,305,483,788,18,806,1554,51.87%,19.63%,1
新北市,汐止區,2369,295,538,833,40,873,1700,51.35%,17.35%,1
新北市,汐止區,2370,253,361,614,17,631,1124,56.14%,22.51%,1
新北市,汐止區,2371,403,631,1034,54,1088,1900,57.26%,21.21%,1
新北市,汐止區,2372,400,640,1040,58,1098,2050,53.56%,19.51%,1
新北市,汐止區,2373,275,345,620,52,672,1244,54.02%,22.11%,1
新北市,汐止區,2374,219,414,633,35,668,1320,50.61%,16.59%,1
新北市,汐止區,2375,297,499,796,38,834,1473,56.62%,20.16%,1
新北市,汐止區,2376,303,641,944,51,995,1802,55.22%,16.81%,1
新北市,汐止區,2377,252,458,710,31,741,1266,58.53%,19.91%,1
新北市,汐止區,2378,254,424,678,57,735,1481,49.63%,17.15%,1
新北市,汐止區,2379,301,412,713,59,772,1497,51.57%,20.11%,1
新北市,汐止區,2380,93,211,304,12,316,556,56.83%,16.73%,1
新北市,汐止區,2381,324,580,904,55,959,1913,50.13%,16.94%,1
新北市,汐止區,2382,368,616,984,32,1016,2027,50.12%,18.15%,1
新北市,汐止區,2383,362,548,910,37,947,1927,49.14%,18.79%,1
新北市,汐止區,2384,133,208,341,47,388,696,55.75%,19.11%,1
新北市,汐止區,2385,386,612,998,60,1058,2127,49.74%,18.15%,1
新北市,汐止區,2386,282,447,729,47,776,1642,47.26%,17.17%,1
新北市,汐止區,2387,334,594,928,65,993,1912,51.94%,17.47%,1
新北市,汐止區,2388,286,539,825,59,884,1893,46.7%,15.11%,1
新北市,汐止區,2389,244,419,663,53,716,1466,48.84%,16.64%,1
新北市,汐止區,2390,252,475,727,67,794,1538,51.63%,16.38%,1
新北市,汐止區,2391,299,449,748,41,789,1550,50.9%,19.29%,1
新北市,汐止區,2392,235,461,696,55,751,1456,51.58%,16.14%,1
新北市,汐止區,2393,180,357,537,38,575,947,60.72%,19.01%,1
新北市,汐止區,2394,196,304,500,20,520,923,56.34%,21.24%,1
新北市,汐止區,2395,321,578,899,128,1027,2043,50.27%,15.71%,1
新北市,汐止區,2396,351,551,902,53,955,2012,47.47%,17.45%,1
新北市,汐止區,2397,246,414,660,26,686,1471,46.63%,16.72%,1
新北市,汐止區,2398,274,502,776,38,814,1603,50.78%,17.09%,1
新北市,汐止區,2399,284,486,770,53,823,1530,53.79%,18.56%,1
新北市,汐止區,2400,288,562,850,34,884,1988,44.47%,14.49%,1
新北市,汐止區,2401,405,640,1045,47,1092,2198,49.68%,18.43%,1
新北市,汐止區,2402,284,543,827,42,869,1712,50.76%,16.59%,1
新北市,汐止區,2403,367,594,961,46,1007,1806,55.76%,20.32%,1
新北市,汐止區,2404,271,498,769,71,840,1576,53.3%,17.2%,1
新北市,汐止區,2405,268,488,756,37,793,1511,52.48%,17.74%,1
新北市,汐止區,2406,298,498,796,36,832,1691,49.2%,17.62%,1
新北市,汐止區,2407,276,552,828,42,870,1636,53.18%,16.87%,1
新北市,汐止區,2408,298,524,822,49,871,1676,51.97%,17.78%,1
新北市,汐止區,2409,216,413,629,30,659,1264,52.14%,17.09%,1
新北市,汐止區,2410,179,407,586,26,612,1165,52.53%,15.36%,1
新北市,汐止區,2411,298,554,852,42,894,1765,50.65%,16.88%,1
新北市,汐止區,2412,251,522,773,29,802,1815,44.19%,13.83%,1
新北市,汐止區,2413,289,519,808,67,875,1778,49.21%,16.25%,1
新北市,汐止區,2414,305,509,814,59,873,1580,55.25%,19.3%,1
新北市,汐止區,2415,302,461,763,46,809,1516,53.36%,19.92%,1
新北市,汐止區,2416,236,430,666,50,716,1425,50.25%,16.56%,1
新北市,汐止區,2417,234,494,728,36,764,1388,55.04%,16.86%,1
新北市,汐止區,2418,253,473,726,57,783,1436,54.53%,17.62%,1
新北市,汐止區,2419,321,476,797,41,838,1591,52.67%,20.18%,1
新北市,汐止區,2420,298,487,785,30,815,1639,49.73%,18.18%,1
新北市,汐止區,2421,258,429,687,17,704,1394,50.5%,18.51%,1
新北市,汐止區,2422,377,587,964,34,998,2035,49.04%,18.53%,1
新北市,汐止區,2423,316,621,937,46,983,1895,51.87%,16.68%,1
新北市,汐止區,2424,287,472,759,25,784,1374,57.06%,20.89%,1
新北市,汐止區,2425,252,353,605,23,628,1061,59.19%,23.75%,1
新北市,汐止區,2426,297,499,796,28,824,1312,62.8%,22.64%,1
新北市,汐止區,2427,291,531,822,31,853,1548,55.1%,18.8%,1
新北市,汐止區,2428,232,510,742,30,772,1350,57.19%,17.19%,1
新北市,汐止區,2429,300,481,781,35,816,1499,54.44%,20.01%,1
新北市,汐止區,2430,255,500,755,37,792,1366,57.98%,18.67%,1
新北市,汐止區,2431,265,457,722,44,766,1335,57.38%,19.85%,1
新北市,汐止區,2432,259,508,767,40,807,1324,60.95%,19.56%,1
新北市,汐止區,2433,266,460,726,55,781,1286,60.73%,20.68%,1
新北市,汐止區,2434,231,363,594,43,637,1155,55.15%,20%,1
新北市,汐止區,2435,331,678,1009,31,1040,1682,61.83%,19.68%,1
新北市,汐止區,2436,271,605,876,49,925,1494,61.91%,18.14%,1
新北市,汐止區,2437,212,420,632,72,704,1166,60.38%,18.18%,1
新北市,汐止區,2438,416,693,1109,104,1213,2184,55.54%,19.05%,1
新北市,汐止區,2439,347,627,974,55,1029,2031,50.66%,17.09%,1
新北市,汐止區,2440,335,581,916,57,973,1759,55.32%,19.04%,1
新北市,汐止區,2441,326,528,854,47,901,1577,57.13%,20.67%,1
新北市,汐止區,2442,252,465,717,22,739,1364,54.18%,18.48%,1
新北市,汐止區,2443,273,502,775,40,815,1401,58.17%,19.49%,1
新北市,汐止區,2444,266,384,650,46,696,1173,59.34%,22.68%,1
新北市,汐止區,2445,204,337,541,12,553,993,55.69%,20.54%,1
新北市,汐止區,2446,271,546,817,23,840,1587,52.93%,17.08%,1
新北市,瑞芳區,2220,125,264,389,31,420,725,57.93%,17.24%,1
新北市,瑞芳區,2221,204,368,572,37,609,1074,56.7%,18.99%,1
新北市,瑞芳區,2222,136,273,409,19,428,825,51.88%,16.48%,1
新北市,瑞芳區,2223,230,397,627,33,660,1242,53.14%,18.52%,1
新北市,瑞芳區,2224,89,216,305,26,331,598,55.35%,14.88%,1
新北市,瑞芳區,2225,152,287,439,30,469,872,53.78%,17.43%,1
新北市,瑞芳區,2226,114,220,334,32,366,760,48.16%,15%,1
新北市,瑞芳區,2227,224,356,580,45,625,1330,46.99%,16.84%,1
新北市,瑞芳區,2228,249,490,739,48,787,1683,46.76%,14.8%,1
新北市,瑞芳區,2229,159,310,469,48,517,980,52.76%,16.22%,1
新北市,瑞芳區,2230,141,317,458,43,501,946,52.96%,14.9%,1
新北市,瑞芳區,2231,189,407,596,30,626,1375,45.53%,13.75%,1
新北市,瑞芳區,2232,245,538,783,40,823,1671,49.25%,14.66%,1
新北市,瑞芳區,2233,132,279,411,25,436,978,44.58%,13.5%,1
新北市,瑞芳區,2234,92,192,284,30,314,645,48.68%,14.26%,1
新北市,瑞芳區,2235,181,323,504,55,559,1089,51.33%,16.62%,1
新北市,瑞芳區,2236,42,65,107,17,124,286,43.36%,14.69%,1
新北市,瑞芳區,2237,70,147,217,28,245,461,53.15%,15.18%,1
新北市,瑞芳區,2238,38,77,115,22,137,274,50%,13.87%,1
新北市,瑞芳區,2239,34,54,88,7,95,155,61.29%,21.94%,1
新北市,瑞芳區,2240,174,243,417,33,450,817,55.08%,21.3%,1
新北市,瑞芳區,2241,160,246,406,64,470,884,53.17%,18.1%,1
新北市,瑞芳區,2242,222,355,577,41,618,1333,46.36%,16.65%,1
新北市,瑞芳區,2243,96,150,246,8,254,607,41.85%,15.82%,1
新北市,瑞芳區,2244,170,344,514,37,551,1045,52.73%,16.27%,1
新北市,瑞芳區,2245,113,217,330,38,368,673,54.68%,16.79%,1
新北市,瑞芳區,2246,77,153,230,9,239,618,38.67%,12.46%,1
新北市,瑞芳區,2247,165,292,457,39,496,1063,46.66%,15.52%,1
新北市,瑞芳區,2248,136,287,423,44,467,860,54.3%,15.81%,1
新北市,瑞芳區,2249,47,86,133,3,136,432,31.48%,10.88%,1
新北市,瑞芳區,2250,46,117,163,9,172,445,38.65%,10.34%,1
新北市,瑞芳區,2251,34,95,129,9,138,318,43.4%,10.69%,1
新北市,瑞芳區,2252,13,57,70,7,77,159,48.43%,8.18%,1
新北市,瑞芳區,2253,41,95,136,11,147,337,43.62%,12.17%,1
新北市,瑞芳區,2254,31,61,92,7,99,180,55%,17.22%,1
新北市,瑞芳區,2255,21,45,66,15,81,187,43.32%,11.23%,1
新北市,瑞芳區,2256,55,123,178,12,190,369,51.49%,14.91%,1
新北市,瑞芳區,2257,54,112,166,20,186,335,55.52%,16.12%,1
新北市,瑞芳區,2258,58,128,186,18,204,470,43.4%,12.34%,1
新北市,瑞芳區,2259,36,74,110,8,118,297,39.73%,12.12%,1
新北市,瑞芳區,2260,48,125,173,3,176,267,65.92%,17.98%,1
新北市,瑞芳區,2261,51,175,226,15,241,876,27.51%,5.82%,1
新北市,瑞芳區,2262,112,336,448,21,469,1241,37.79%,9.02%,1
新北市,瑞芳區,2263,149,319,468,65,533,998,53.41%,14.93%,1
新北市,瑞芳區,2264,136,312,448,53,501,948,52.85%,14.35%,1
新北市,瑞芳區,2265,144,338,482,30,512,1308,39.14%,11.01%,1
新北市,土城區,1775,257,486,743,64,807,1505,53.62%,17.08%,1
新北市,土城區,1776,269,451,720,30,750,1242,60.39%,21.66%,1
新北市,土城區,1777,227,458,685,31,716,1206,59.37%,18.82%,1
新北市,土城區,1778,345,398,743,72,815,1474,55.29%,23.41%,1
新北市,土城區,1779,241,485,726,44,770,1489,51.71%,16.19%,1
新北市,土城區,1780,270,545,815,48,863,1675,51.52%,16.12%,1
新北市,土城區,1781,292,488,780,44,824,1499,54.97%,19.48%,1
新北市,土城區,1782,230,511,741,36,777,1495,51.97%,15.38%,1
新北市,土城區,1783,233,466,699,61,760,1411,53.86%,16.51%,1
新北市,土城區,1784,251,415,666,44,710,1378,51.52%,18.21%,1
新北市,土城區,1785,237,393,630,34,664,1256,52.87%,18.87%,1
新北市,土城區,1786,279,486,765,55,820,1379,59.46%,20.23%,1
新北市,土城區,1787,215,477,692,44,736,1424,51.69%,15.1%,1
新北市,土城區,1788,256,474,730,55,785,1455,53.95%,17.59%,1
新北市,土城區,1789,236,471,707,31,738,1419,52.01%,16.63%,1
新北市,土城區,1790,277,488,765,45,810,1357,59.69%,20.41%,1
新北市,土城區,1791,287,475,762,38,800,1501,53.3%,19.12%,1
新北市,土城區,1792,227,398,625,69,694,1206,57.55%,18.82%,1
新北市,土城區,1793,269,435,704,26,730,1255,58.17%,21.43%,1
新北市,土城區,1794,300,611,911,56,967,1869,51.74%,16.05%,1
新北市,土城區,1795,231,450,681,31,712,1292,55.11%,17.88%,1
新北市,土城區,1796,232,417,649,35,684,1324,51.66%,17.52%,1
新北市,土城區,1797,188,380,568,47,615,1155,53.25%,16.28%,1
新北市,土城區,1798,215,393,608,45,653,1183,55.2%,18.17%,1
新北市,土城區,1799,203,311,514,37,551,2518,21.88%,8.06%,1
新北市,土城區,1800,223,401,624,39,663,1218,54.43%,18.31%,1
新北市,土城區,1801,189,399,588,61,649,1133,57.28%,16.68%,1
新北市,土城區,1802,162,307,469,39,508,894,56.82%,18.12%,1
新北市,土城區,1803,200,297,497,49,546,931,58.65%,21.48%,1
新北市,土城區,1804,364,754,1118,37,1155,1820,63.46%,20%,1
新北市,土城區,1805,229,454,683,26,709,1320,53.71%,17.35%,1
新北市,土城區,1806,237,392,629,35,664,1241,53.51%,19.1%,1
新北市,土城區,1807,274,465,739,41,780,1414,55.16%,19.38%,1
新北市,土城區,1808,287,447,734,50,784,1378,56.89%,20.83%,1
新北市,土城區,1809,286,488,774,55,829,1421,58.34%,20.13%,1
新北市,土城區,1810,237,455,692,39,731,1340,54.55%,17.69%,1
新北市,土城區,1811,243,398,641,38,679,1144,59.35%,21.24%,1
新北市,土城區,1812,249,413,662,63,725,1268,57.18%,19.64%,1
新北市,土城區,1813,191,429,620,73,693,1196,57.94%,15.97%,1
新北市,土城區,1814,270,473,743,36,779,1308,59.56%,20.64%,1
新北市,土城區,1815,202,426,628,47,675,1175,57.45%,17.19%,1
新北市,土城區,1816,224,429,653,52,705,1230,57.32%,18.21%,1
新北市,土城區,1817,258,454,712,61,773,1342,57.6%,19.23%,1
新北市,土城區,1818,257,442,699,46,745,1268,58.75%,20.27%,1
新北市,土城區,1819,231,485,716,60,776,1227,63.24%,18.83%,1
新北市,土城區,1820,235,467,702,77,779,1356,57.45%,17.33%,1
新北市,土城區,1821,271,505,776,56,832,1496,55.61%,18.11%,1
新北市,土城區,1822,224,453,677,68,745,1309,56.91%,17.11%,1
新北市,土城區,1823,251,399,650,51,701,1175,59.66%,21.36%,1
新北市,土城區,1824,235,405,640,58,698,1237,56.43%,19%,1
新北市,土城區,1825,226,448,674,48,722,1256,57.48%,17.99%,1
新北市,土城區,1826,242,399,641,24,665,1228,54.15%,19.71%,1
新北市,土城區,1827,236,375,611,62,673,1182,56.94%,19.97%,1
新北市,土城區,1828,311,501,812,43,855,1558,54.88%,19.96%,1
新北市,土城區,1829,245,376,621,43,664,1160,57.24%,21.12%,1
新北市,土城區,1830,275,448,723,46,769,1357,56.67%,20.27%,1
新北市,土城區,1831,278,451,729,73,802,1464,54.78%,18.99%,1
新北市,土城區,1832,232,423,655,45,700,1335,52.43%,17.38%,1
新北市,土城區,1833,254,434,688,59,747,1346,55.5%,18.87%,1
新北市,土城區,1834,321,511,832,36,868,1435,60.49%,22.37%,1
新北市,土城區,1835,318,546,864,41,905,1639,55.22%,19.4%,1
新北市,土城區,1836,365,580,945,42,987,1728,57.12%,21.12%,1
新北市,土城區,1837,288,445,733,28,761,1665,45.71%,17.3%,1
新北市,土城區,1838,267,488,755,62,817,1333,61.29%,20.03%,1
新北市,土城區,1839,327,542,869,38,907,1567,57.88%,20.87%,1
新北市,土城區,1840,300,506,806,59,865,1576,54.89%,19.04%,1
新北市,土城區,1841,294,484,778,52,830,1458,56.93%,20.16%,1
新北市,土城區,1842,284,502,786,83,869,1517,57.28%,18.72%,1
新北市,土城區,1843,315,536,851,29,880,1489,59.1%,21.16%,1
新北市,土城區,1844,348,503,851,17,868,1463,59.33%,23.79%,1
新北市,土城區,1845,315,547,862,28,890,1584,56.19%,19.89%,1
新北市,土城區,1846,285,475,760,39,799,1464,54.58%,19.47%,1
新北市,土城區,1847,314,526,840,58,898,1598,56.2%,19.65%,1
新北市,土城區,1848,310,428,738,65,803,1500,53.53%,20.67%,1
新北市,土城區,1849,309,499,808,36,844,1542,54.73%,20.04%,1
新北市,土城區,1850,346,560,906,47,953,1619,58.86%,21.37%,1
新北市,土城區,1851,271,490,761,30,791,1521,52.01%,17.82%,1
新北市,土城區,1852,378,521,899,27,926,1691,54.76%,22.35%,1
新北市,土城區,1853,332,496,828,56,884,1657,53.35%,20.04%,1
新北市,土城區,1854,423,584,1007,26,1033,1772,58.3%,23.87%,1
新北市,土城區,1855,290,502,792,15,807,1423,56.71%,20.38%,1
新北市,土城區,1856,300,473,773,38,811,1321,61.39%,22.71%,1
新北市,土城區,1857,321,502,823,49,872,1429,61.02%,22.46%,1
新北市,土城區,1858,249,489,738,40,778,1445,53.84%,17.23%,1
新北市,土城區,1859,298,555,853,33,886,1520,58.29%,19.61%,1
新北市,土城區,1860,255,434,689,14,703,1484,47.37%,17.18%,1
新北市,土城區,1861,285,429,714,19,733,1362,53.82%,20.93%,1
新北市,土城區,1862,217,438,655,32,687,1262,54.44%,17.19%,1
新北市,土城區,1863,290,440,730,42,772,1343,57.48%,21.59%,1
新北市,土城區,1864,246,374,620,36,656,1337,49.07%,18.4%,1
新北市,土城區,1865,199,353,552,40,592,1325,44.68%,15.02%,1
新北市,土城區,1866,240,425,665,43,708,1390,50.94%,17.27%,1
新北市,土城區,1867,294,479,773,58,831,1534,54.17%,19.17%,1
新北市,土城區,1868,262,451,713,75,788,1484,53.1%,17.65%,1
新北市,土城區,1869,256,471,727,69,796,1532,51.96%,16.71%,1
新北市,土城區,1870,270,531,801,51,852,1507,56.54%,17.92%,1
新北市,土城區,1871,301,528,829,40,869,1550,56.06%,19.42%,1
新北市,土城區,1872,273,553,826,38,864,1567,55.14%,17.42%,1
新北市,土城區,1873,342,400,742,41,783,1367,57.28%,25.02%,1
新北市,土城區,1874,212,433,645,48,693,1293,53.6%,16.4%,1
新北市,土城區,1875,265,473,738,51,789,1402,56.28%,18.9%,1
新北市,土城區,1876,261,444,705,46,751,1379,54.46%,18.93%,1
新北市,土城區,1877,270,459,729,45,774,1471,52.62%,18.35%,1
新北市,土城區,1878,235,485,720,35,755,1410,53.55%,16.67%,1
新北市,土城區,1879,307,493,800,35,835,1542,54.15%,19.91%,1
新北市,土城區,1880,226,404,630,52,682,1238,55.09%,18.26%,1
新北市,土城區,1881,226,412,638,52,690,1301,53.04%,17.37%,1
新北市,土城區,1882,295,517,812,29,841,1311,64.15%,22.5%,1
新北市,土城區,1883,235,481,716,39,755,1511,49.97%,15.55%,1
新北市,土城區,1884,269,500,769,50,819,1531,53.49%,17.57%,1
新北市,土城區,1885,315,480,795,59,854,1638,52.14%,19.23%,1
新北市,土城區,1886,244,502,746,45,791,1335,59.25%,18.28%,1
新北市,土城區,1887,257,507,764,41,805,1459,55.17%,17.61%,1
新北市,土城區,1888,294,481,775,30,805,1489,54.06%,19.74%,1
新北市,土城區,1889,312,619,931,89,1020,1774,57.5%,17.59%,1
新北市,土城區,1890,354,586,940,42,982,1792,54.8%,19.75%,1
新北市,土城區,1891,285,653,938,60,998,1798,55.51%,15.85%,1
新北市,土城區,1892,233,410,643,74,717,1312,54.65%,17.76%,1
新北市,土城區,1893,233,393,626,55,681,1301,52.34%,17.91%,1
新北市,土城區,1894,229,383,612,53,665,1254,53.03%,18.26%,1
新北市,土城區,1895,240,382,622,33,655,1215,53.91%,19.75%,1
新北市,土城區,1896,267,479,746,44,790,1448,54.56%,18.44%,1
新北市,土城區,1897,210,442,652,58,710,1321,53.75%,15.9%,1
新北市,土城區,1898,207,335,542,61,603,1150,52.43%,18%,1
新北市,土城區,1899,276,383,659,47,706,1425,49.54%,19.37%,1
新北市,土城區,1900,262,484,746,66,812,1366,59.44%,19.18%,1
新北市,土城區,1901,261,450,711,43,754,1292,58.36%,20.2%,1
新北市,土城區,1902,221,449,670,45,715,1317,54.29%,16.78%,1
新北市,土城區,1903,232,478,710,45,755,1324,57.02%,17.52%,1
新北市,土城區,1904,225,373,598,50,648,1189,54.5%,18.92%,1
新北市,土城區,1905,221,435,656,57,713,1223,58.3%,18.07%,1
新北市,土城區,1906,184,589,773,56,829,1550,53.48%,11.87%,1
新北市,土城區,1907,328,526,854,67,921,1606,57.35%,20.42%,1
新北市,土城區,1908,281,495,776,54,830,1509,55%,18.62%,1
新北市,土城區,1909,280,488,768,59,827,1529,54.09%,18.31%,1
新北市,土城區,1910,240,469,709,60,769,1458,52.74%,16.46%,1
新北市,土城區,1911,317,461,778,65,843,1468,57.43%,21.59%,1
新北市,土城區,1912,306,452,758,42,800,1495,53.51%,20.47%,1
新北市,土城區,1913,235,438,673,72,745,1303,57.18%,18.04%,1
新北市,土城區,1914,255,469,724,47,771,1365,56.48%,18.68%,1
新北市,土城區,1915,274,482,756,64,820,1476,55.56%,18.56%,1
新北市,土城區,1916,293,525,818,33,851,1519,56.02%,19.29%,1
新北市,蘆洲區,0555,325,507,832,78,910,1600,56.88%,20.31%,1
新北市,蘆洲區,0556,281,526,807,55,862,1549,55.65%,18.14%,1
新北市,蘆洲區,0557,287,517,804,70,874,1516,57.65%,18.93%,1
新北市,蘆洲區,0558,249,476,725,50,775,1404,55.2%,17.74%,1
新北市,蘆洲區,0559,235,449,684,74,758,1381,54.89%,17.02%,1
新北市,蘆洲區,0560,295,498,793,44,837,1485,56.36%,19.87%,1
新北市,蘆洲區,0561,232,410,642,52,694,1779,39.01%,13.04%,1
新北市,蘆洲區,0562,314,580,894,63,957,1797,53.26%,17.47%,1
新北市,蘆洲區,0563,262,456,718,71,789,1364,57.84%,19.21%,1
新北市,蘆洲區,0564,311,539,850,58,908,1635,55.54%,19.02%,1
新北市,蘆洲區,0565,264,451,715,39,754,1567,48.12%,16.85%,1
新北市,蘆洲區,0566,270,496,766,49,815,1524,53.48%,17.72%,1
新北市,蘆洲區,0567,262,516,778,57,835,1612,51.8%,16.25%,1
新北市,蘆洲區,0568,297,541,838,39,877,1674,52.39%,17.74%,1
新北市,蘆洲區,0569,318,534,852,52,904,1838,49.18%,17.3%,1
新北市,蘆洲區,0570,307,484,791,36,827,1814,45.59%,16.92%,1
新北市,蘆洲區,0571,301,474,775,53,828,1473,56.21%,20.43%,1
新北市,蘆洲區,0572,276,472,748,48,796,1465,54.33%,18.84%,1
新北市,蘆洲區,0573,398,510,908,55,963,1652,58.29%,24.09%,1
新北市,蘆洲區,0574,300,546,846,67,913,1650,55.33%,18.18%,1
新北市,蘆洲區,0575,298,578,876,44,920,1656,55.56%,18%,1
新北市,蘆洲區,0576,271,492,763,57,820,1571,52.2%,17.25%,1
新北市,蘆洲區,0577,302,453,755,65,820,1523,53.84%,19.83%,1
新北市,蘆洲區,0578,281,465,746,48,794,1475,53.83%,19.05%,1
新北市,蘆洲區,0579,265,412,677,50,727,1367,53.18%,19.39%,1
新北市,蘆洲區,0580,289,522,811,45,856,1514,56.54%,19.09%,1
新北市,蘆洲區,0581,403,610,1013,47,1060,1791,59.18%,22.5%,1
新北市,蘆洲區,0582,352,633,985,58,1043,1714,60.85%,20.54%,1
新北市,蘆洲區,0583,373,609,982,37,1019,1780,57.25%,20.96%,1
新北市,蘆洲區,0584,354,581,935,38,973,1713,56.8%,20.67%,1
新北市,蘆洲區,0585,313,633,946,38,984,1720,57.21%,18.2%,1
新北市,蘆洲區,0586,340,610,950,44,994,1766,56.29%,19.25%,1
新北市,蘆洲區,0587,300,535,835,48,883,1623,54.41%,18.48%,1
新北市,蘆洲區,0588,273,641,914,36,950,1740,54.6%,15.69%,1
新北市,蘆洲區,0589,359,594,953,66,1019,1759,57.93%,20.41%,1
新北市,蘆洲區,0590,379,581,960,69,1029,1775,57.97%,21.35%,1
新北市,蘆洲區,0591,386,660,1046,43,1089,1909,57.05%,20.22%,1
新北市,蘆洲區,0592,372,609,981,69,1050,1805,58.17%,20.61%,1
新北市,蘆洲區,0593,330,502,832,40,872,1642,53.11%,20.1%,1
新北市,蘆洲區,0594,327,540,867,52,919,1713,53.65%,19.09%,1
新北市,蘆洲區,0595,330,499,829,65,894,1746,51.2%,18.9%,1
新北市,蘆洲區,0596,319,497,816,62,878,1596,55.01%,19.99%,1
新北市,蘆洲區,0597,244,463,707,56,763,1434,53.21%,17.02%,1
新北市,蘆洲區,0598,301,453,754,55,809,1450,55.79%,20.76%,1
新北市,蘆洲區,0599,302,461,763,22,785,1543,50.87%,19.57%,1
新北市,蘆洲區,0600,302,481,783,44,827,1525,54.23%,19.8%,1
新北市,蘆洲區,0601,252,412,664,49,713,1419,50.25%,17.76%,1
新北市,蘆洲區,0602,292,408,700,40,740,1298,57.01%,22.5%,1
新北市,蘆洲區,0603,243,412,655,55,710,1304,54.45%,18.63%,1
新北市,蘆洲區,0604,348,566,914,50,964,1806,53.38%,19.27%,1
新北市,蘆洲區,0605,320,597,917,75,992,1910,51.94%,16.75%,1
新北市,蘆洲區,0606,300,526,826,50,876,1873,46.77%,16.02%,1
新北市,蘆洲區,0607,291,531,822,48,870,1785,48.74%,16.3%,1
新北市,蘆洲區,0608,292,536,828,60,888,1760,50.45%,16.59%,1
新北市,蘆洲區,0609,345,624,969,56,1025,1841,55.68%,18.74%,1
新北市,蘆洲區,0610,337,546,883,49,932,1855,50.24%,18.17%,1
新北市,蘆洲區,0611,278,392,670,62,732,1450,50.48%,19.17%,1
新北市,蘆洲區,0612,287,470,757,77,834,1585,52.62%,18.11%,1
新北市,蘆洲區,0613,250,411,661,120,781,1541,50.68%,16.22%,1
新北市,蘆洲區,0614,306,511,817,55,872,1626,53.63%,18.82%,1
新北市,蘆洲區,0615,263,404,667,49,716,1241,57.7%,21.19%,1
新北市,蘆洲區,0616,305,533,838,54,892,1634,54.59%,18.67%,1
新北市,蘆洲區,0617,291,525,816,54,870,1573,55.31%,18.5%,1
新北市,蘆洲區,0618,336,541,877,31,908,1619,56.08%,20.75%,1
新北市,蘆洲區,0619,341,585,926,79,1005,1878,53.51%,18.16%,1
新北市,蘆洲區,0620,310,585,895,72,967,1797,53.81%,17.25%,1
新北市,蘆洲區,0621,370,607,977,40,1017,1816,56%,20.37%,1
新北市,蘆洲區,0622,253,473,726,67,793,1344,59%,18.82%,1
新北市,蘆洲區,0623,284,502,786,61,847,1492,56.77%,19.03%,1
新北市,蘆洲區,0624,323,623,946,101,1047,1959,53.45%,16.49%,1
新北市,蘆洲區,0625,294,518,812,72,884,1611,54.87%,18.25%,1
新北市,蘆洲區,0626,319,534,853,62,915,1574,58.13%,20.27%,1
新北市,蘆洲區,0627,309,553,862,64,926,1653,56.02%,18.69%,1
新北市,蘆洲區,0628,394,612,1006,53,1059,3085,34.33%,12.77%,1
新北市,蘆洲區,0629,342,558,900,71,971,1812,53.59%,18.87%,1
新北市,蘆洲區,0630,272,403,675,55,730,1332,54.8%,20.42%,1
新北市,蘆洲區,0631,266,476,742,68,810,1648,49.15%,16.14%,1
新北市,蘆洲區,0632,247,411,658,43,701,1355,51.73%,18.23%,1
新北市,蘆洲區,0633,232,459,691,37,728,1371,53.1%,16.92%,1
新北市,蘆洲區,0634,229,239,468,172,640,1111,57.61%,20.61%,1
新北市,蘆洲區,0635,210,424,634,64,698,1176,59.35%,17.86%,1
新北市,蘆洲區,0636,335,522,857,40,897,1602,55.99%,20.91%,1
新北市,蘆洲區,0637,240,408,648,47,695,1361,51.07%,17.63%,1
新北市,蘆洲區,0638,250,519,769,56,825,1530,53.92%,16.34%,1
新北市,蘆洲區,0639,163,290,453,74,527,925,56.97%,17.62%,1
新北市,蘆洲區,0640,344,627,971,59,1030,1851,55.65%,18.58%,1
新北市,蘆洲區,0641,306,529,835,46,881,1791,49.19%,17.09%,1
新北市,蘆洲區,0642,333,527,860,65,925,1853,49.92%,17.97%,1
新北市,蘆洲區,0643,308,507,815,49,864,1758,49.15%,17.52%,1
新北市,蘆洲區,0644,352,554,906,62,968,1798,53.84%,19.58%,1
新北市,蘆洲區,0645,320,532,852,54,906,1645,55.08%,19.45%,1
新北市,蘆洲區,0646,283,445,728,61,789,1612,48.95%,17.56%,1
新北市,蘆洲區,0647,332,472,804,61,865,1784,48.49%,18.61%,1
新北市,蘆洲區,0648,269,460,729,64,793,1701,46.62%,15.81%,1
新北市,蘆洲區,0649,267,508,775,39,814,1581,51.49%,16.89%,1
新北市,蘆洲區,0650,340,459,799,47,846,1534,55.15%,22.16%,1
新北市,蘆洲區,0651,346,525,871,60,931,1620,57.47%,21.36%,1
新北市,蘆洲區,0652,314,520,834,55,889,1494,59.5%,21.02%,1
新北市,蘆洲區,0653,273,348,621,37,658,1183,55.62%,23.08%,1
新北市,蘆洲區,0654,212,315,527,41,568,985,57.66%,21.52%,1
新北市,蘆洲區,0655,292,504,796,79,875,1673,52.3%,17.45%,1
新北市,蘆洲區,0656,340,533,873,73,946,1688,56.04%,20.14%,1
新北市,蘆洲區,0657,219,420,639,41,680,1249,54.44%,17.53%,1
新北市,蘆洲區,0658,273,444,717,58,775,1476,52.51%,18.5%,1
新北市,五股區,0207,277,424,701,96,797,1456,54.74%,19.02%,1
新北市,五股區,0208,252,483,735,51,786,1482,53.04%,17%,1
新北市,五股區,0209,256,426,682,43,725,1287,56.33%,19.89%,1
新北市,五股區,0210,218,324,542,34,576,1106,52.08%,19.71%,1
新北市,五股區,0211,199,407,606,75,681,1283,53.08%,15.51%,1
新北市,五股區,0212,345,563,908,51,959,1833,52.32%,18.82%,1
新北市,五股區,0213,230,381,611,45,656,1141,57.49%,20.16%,1
新北市,五股區,0214,88,162,250,34,284,463,61.34%,19.01%,1
新北市,五股區,0215,324,604,928,50,978,1786,54.76%,18.14%,1
新北市,五股區,0216,315,500,815,46,861,1660,51.87%,18.98%,1
新北市,五股區,0217,306,462,768,77,845,1534,55.08%,19.95%,1
新北市,五股區,0218,230,445,675,60,735,1285,57.2%,17.9%,1
新北市,五股區,0219,307,557,864,99,963,1832,52.57%,16.76%,1
新北市,五股區,0220,292,495,787,35,822,1542,53.31%,18.94%,1
新北市,五股區,0221,289,563,852,40,892,1897,47.02%,15.23%,1
新北市,五股區,0222,306,565,871,90,961,1964,48.93%,15.58%,1
新北市,五股區,0223,302,515,817,68,885,1779,49.75%,16.98%,1
新北市,五股區,0224,289,544,833,73,906,1735,52.22%,16.66%,1
新北市,五股區,0225,421,661,1082,29,1111,2299,48.33%,18.31%,1
新北市,五股區,0226,266,540,806,49,855,1755,48.72%,15.16%,1
新北市,五股區,0227,282,592,874,52,926,1674,55.32%,16.85%,1
新北市,五股區,0228,273,585,858,62,920,1661,55.39%,16.44%,1
新北市,五股區,0229,257,326,583,36,619,1281,48.32%,20.06%,1
新北市,五股區,0230,263,526,789,59,848,1566,54.15%,16.79%,1
新北市,五股區,0231,238,492,730,27,757,1560,48.53%,15.26%,1
新北市,五股區,0232,182,661,843,39,882,1622,54.38%,11.22%,1
新北市,五股區,0233,289,631,920,36,956,1779,53.74%,16.25%,1
新北市,五股區,0234,235,484,719,57,776,1487,52.19%,15.8%,1
新北市,五股區,0235,321,495,816,43,859,1567,54.82%,20.49%,1
新北市,五股區,0236,199,304,503,29,532,1333,39.91%,14.93%,1
新北市,五股區,0237,280,433,713,52,765,1263,60.57%,22.17%,1
新北市,五股區,0238,219,482,701,76,777,1314,59.13%,16.67%,1
新北市,五股區,0239,271,477,748,36,784,1513,51.82%,17.91%,1
新北市,五股區,0240,261,566,827,31,858,1517,56.56%,17.21%,1
新北市,五股區,0241,308,504,812,62,874,1613,54.18%,19.09%,1
新北市,五股區,0242,277,548,825,49,874,1616,54.08%,17.14%,1
新北市,五股區,0243,296,517,813,53,866,1616,53.59%,18.32%,1
新北市,五股區,0244,305,554,859,60,919,1689,54.41%,18.06%,1
新北市,五股區,0245,342,604,946,35,981,1894,51.8%,18.06%,1
新北市,五股區,0246,248,466,714,49,763,1210,63.06%,20.5%,1
新北市,五股區,0247,523,292,815,48,863,1643,52.53%,31.83%,1
新北市,五股區,0248,254,478,732,28,760,1441,52.74%,17.63%,1
新北市,五股區,0249,249,480,729,26,755,1305,57.85%,19.08%,1
新北市,五股區,0250,220,444,664,56,720,1170,61.54%,18.8%,1
新北市,五股區,0251,243,552,795,58,853,1397,61.06%,17.39%,1
新北市,五股區,0252,214,544,758,53,811,1312,61.81%,16.31%,1
新北市,五股區,0253,154,387,541,30,571,1127,50.67%,13.66%,1
新北市,五股區,0254,153,413,566,35,601,1154,52.08%,13.26%,1
新北市,泰山區,0255,96,202,298,27,325,643,50.54%,14.93%,1
新北市,泰山區,0256,42,69,111,5,116,186,62.37%,22.58%,1
新北市,泰山區,0257,237,479,716,30,746,1457,51.2%,16.27%,1
新北市,泰山區,0258,270,572,842,50,892,1594,55.96%,16.94%,1
新北市,泰山區,0259,227,536,763,44,807,1598,50.5%,14.21%,1
新北市,泰山區,0260,262,469,731,38,769,1503,51.16%,17.43%,1
新北市,泰山區,0261,240,446,686,64,750,1436,52.23%,16.71%,1
新北市,泰山區,0262,254,469,723,45,768,1384,55.49%,18.35%,1
新北市,泰山區,0263,196,464,660,42,702,1231,57.03%,15.92%,1
新北市,泰山區,0264,212,435,647,35,682,1295,52.66%,16.37%,1
新北市,泰山區,0265,318,521,839,60,899,1563,57.52%,20.35%,1
新北市,泰山區,0266,284,591,875,63,938,1610,58.26%,17.64%,1
新北市,泰山區,0267,213,430,643,33,676,1253,53.95%,17%,1
新北市,泰山區,0268,216,418,634,32,666,1294,51.47%,16.69%,1
新北市,泰山區,0269,276,470,746,43,789,1354,58.27%,20.38%,1
新北市,泰山區,0270,211,452,663,27,690,1259,54.81%,16.76%,1
新北市,泰山區,0271,268,432,700,22,722,1252,57.67%,21.41%,1
新北市,泰山區,0272,203,350,553,33,586,1094,53.56%,18.56%,1
新北市,泰山區,0273,294,558,852,40,892,1590,56.1%,18.49%,1
新北市,泰山區,0274,302,544,846,66,912,1634,55.81%,18.48%,1
新北市,泰山區,0275,256,445,701,28,729,1536,47.46%,16.67%,1
新北市,泰山區,0276,305,555,860,28,888,1534,57.89%,19.88%,1
新北市,泰山區,0277,270,641,911,41,952,1545,61.62%,17.48%,1
新北市,泰山區,0278,255,488,743,41,784,1399,56.04%,18.23%,1
新北市,泰山區,0279,245,439,684,25,709,1315,53.92%,18.63%,1
新北市,泰山區,0280,263,431,694,40,734,1201,61.12%,21.9%,1
新北市,泰山區,0281,239,368,607,55,662,1182,56.01%,20.22%,1
新北市,泰山區,0282,283,538,821,60,881,1665,52.91%,17%,1
新北市,泰山區,0283,319,626,945,65,1010,1855,54.45%,17.2%,1
新北市,泰山區,0284,338,622,960,71,1031,1866,55.25%,18.11%,1
新北市,泰山區,0285,387,605,992,43,1035,1935,53.49%,20%,1
新北市,泰山區,0286,274,501,775,42,817,1589,51.42%,17.24%,1
新北市,泰山區,0287,202,378,580,32,612,1152,53.13%,17.53%,1
新北市,泰山區,0288,244,354,598,30,628,1114,56.37%,21.9%,1
新北市,泰山區,0289,212,394,606,43,649,1040,62.4%,20.38%,1
新北市,泰山區,0290,199,357,556,42,598,1003,59.62%,19.84%,1
新北市,泰山區,0291,240,335,575,23,598,975,61.33%,24.62%,1
新北市,泰山區,0292,283,454,737,50,787,1440,54.65%,19.65%,1
新北市,泰山區,0293,263,506,769,16,785,1480,53.04%,17.77%,1
新北市,泰山區,0294,231,423,654,31,685,1211,56.56%,19.08%,1
新北市,泰山區,0295,234,450,684,28,712,1237,57.56%,18.92%,1
新北市,泰山區,0296,183,376,559,31,590,1069,55.19%,17.12%,1
新北市,泰山區,0297,344,599,943,55,998,1680,59.4%,20.48%,1
新北市,泰山區,0298,303,597,900,37,937,1651,56.75%,18.35%,1
新北市,泰山區,0299,249,458,707,42,749,1420,52.75%,17.54%,1
新北市,泰山區,0300,268,459,727,54,781,1337,58.41%,20.04%,1
新北市,泰山區,0301,283,590,873,41,914,1591,57.45%,17.79%,1
新北市,林口區,0145,203,426,629,53,682,1268,53.79%,16.01%,1
新北市,林口區,0146,211,354,565,42,607,1171,51.84%,18.02%,1
新北市,林口區,0147,233,414,647,50,697,1218,57.22%,19.13%,1
新北市,林口區,0148,317,555,872,43,915,1788,51.17%,17.73%,1
新北市,林口區,0149,283,480,763,65,828,1625,50.95%,17.42%,1
新北市,林口區,0150,280,420,700,59,759,1448,52.42%,19.34%,1
新北市,林口區,0151,217,402,619,66,685,1328,51.58%,16.34%,1
新北市,林口區,0152,238,415,653,54,707,1523,46.42%,15.63%,1
新北市,林口區,0153,227,417,644,39,683,1245,54.86%,18.23%,1
新北市,林口區,0154,278,522,800,26,826,1329,62.15%,20.92%,1
新北市,林口區,0155,313,509,822,37,859,1465,58.63%,21.37%,1
新北市,林口區,0156,300,479,779,27,806,1369,58.88%,21.91%,1
新北市,林口區,0157,280,461,741,49,790,1346,58.69%,20.8%,1
新北市,林口區,0158,212,377,589,60,649,1181,54.95%,17.95%,1
新北市,林口區,0159,291,478,769,32,801,1291,62.04%,22.54%,1
新北市,林口區,0160,210,413,623,51,674,1213,55.56%,17.31%,1
新北市,林口區,0161,243,456,699,34,733,1256,58.36%,19.35%,1
新北市,林口區,0162,207,393,600,47,647,1185,54.6%,17.47%,1
新北市,林口區,0163,213,483,696,60,756,1361,55.55%,15.65%,1
新北市,林口區,0164,292,585,877,22,899,1756,51.2%,16.63%,1
新北市,林口區,0165,256,587,843,20,863,1676,51.49%,15.27%,1
新北市,林口區,0166,304,553,857,15,872,1540,56.62%,19.74%,1
新北市,林口區,0167,291,528,819,32,851,1569,54.24%,18.55%,1
新北市,林口區,0168,286,525,811,27,838,1514,55.35%,18.89%,1
新北市,林口區,0169,265,409,674,18,692,1193,58.01%,22.21%,1
新北市,林口區,0170,332,556,888,23,911,1610,56.58%,20.62%,1
新北市,林口區,0171,290,452,742,34,776,1338,58%,21.67%,1
新北市,林口區,0172,217,432,649,27,676,1141,59.25%,19.02%,1
新北市,林口區,0173,259,450,709,32,741,1307,56.69%,19.82%,1
新北市,林口區,0174,272,468,740,24,764,1327,57.57%,20.5%,1
新北市,林口區,0175,277,441,718,32,750,1285,58.37%,21.56%,1
新北市,林口區,0176,339,466,805,40,845,1481,57.06%,22.89%,1
新北市,林口區,0177,339,503,842,23,865,1510,57.28%,22.45%,1
新北市,林口區,0178,341,564,905,40,945,1785,52.94%,19.1%,1
新北市,林口區,0179,351,595,946,28,974,1792,54.35%,19.59%,1
新北市,林口區,0180,315,517,832,28,860,1517,56.69%,20.76%,1
新北市,林口區,0181,334,539,873,26,899,1564,57.48%,21.36%,1
新北市,林口區,0182,286,586,872,23,895,1560,57.37%,18.33%,1
新北市,林口區,0183,324,485,809,30,839,1544,54.34%,20.98%,1
新北市,林口區,0184,301,534,835,27,862,1593,54.11%,18.9%,1
新北市,林口區,0185,284,481,765,30,795,1431,55.56%,19.85%,1
新北市,林口區,0186,325,487,812,32,844,1571,53.72%,20.69%,1
新北市,林口區,0187,310,485,795,32,827,1439,57.47%,21.54%,1
新北市,林口區,0188,306,498,804,35,839,1451,57.82%,21.09%,1
新北市,林口區,0189,326,471,797,44,841,1391,60.46%,23.44%,1
新北市,林口區,0190,277,492,769,45,814,1461,55.72%,18.96%,1
新北市,林口區,0191,340,553,893,21,914,1691,54.05%,20.11%,1
新北市,林口區,0192,304,500,804,43,847,1524,55.58%,19.95%,1
新北市,林口區,0193,278,527,805,34,839,1343,62.47%,20.7%,1
新北市,林口區,0194,317,493,810,31,841,1398,60.16%,22.68%,1
新北市,林口區,0195,270,520,790,31,821,1380,59.49%,19.57%,1
新北市,林口區,0196,258,463,721,49,770,1367,56.33%,18.87%,1
新北市,林口區,0197,272,477,749,35,784,1350,58.07%,20.15%,1
新北市,林口區,0198,254,403,657,45,702,1194,58.79%,21.27%,1
新北市,林口區,0199,250,435,685,52,737,1344,54.84%,18.6%,1
新北市,林口區,0200,215,398,613,39,652,1154,56.5%,18.63%,1
新北市,林口區,0201,253,416,669,28,697,1119,62.29%,22.61%,1
新北市,林口區,0202,160,295,455,49,504,1026,49.12%,15.59%,1
新北市,林口區,0203,226,383,609,64,673,1210,55.62%,18.68%,1
新北市,林口區,0204,166,284,450,67,517,912,56.69%,18.2%,1
新北市,林口區,0205,176,264,440,39,479,824,58.13%,21.36%,1
新北市,林口區,0206,287,481,768,66,834,1411,59.11%,20.34%,1
新北市,深坑區,2163,203,373,576,28,604,1142,52.89%,17.78%,1
新北市,深坑區,2164,214,417,631,39,670,1139,58.82%,18.79%,1
新北市,深坑區,2165,188,347,535,41,576,1065,54.08%,17.65%,1
新北市,深坑區,2166,249,424,673,42,715,1400,51.07%,17.79%,1
新北市,深坑區,2167,242,414,656,37,693,1330,52.11%,18.2%,1
新北市,深坑區,2168,237,431,668,38,706,1380,51.16%,17.17%,1
新北市,深坑區,2169,258,434,692,9,701,1496,46.86%,17.25%,1
新北市,深坑區,2170,293,525,818,51,869,1508,57.63%,19.43%,1
新北市,深坑區,2171,343,527,870,62,932,1624,57.39%,21.12%,1
新北市,深坑區,2172,377,747,1124,49,1173,2165,54.18%,17.41%,1
新北市,深坑區,2173,364,639,1003,60,1063,1790,59.39%,20.34%,1
新北市,深坑區,2174,133,234,367,32,399,782,51.02%,17.01%,1
新北市,深坑區,2175,236,421,657,23,680,1164,58.42%,20.27%,1
新北市,深坑區,2176,270,477,747,57,804,1344,59.82%,20.09%,1
新北市,深坑區,2177,147,278,425,30,455,739,61.57%,19.89%,1
新北市,深坑區,2178,107,206,313,27,340,556,61.15%,19.24%,1
新北市,石碇區,2179,90,132,222,21,243,391,62.15%,23.02%,1
新北市,石碇區,2180,108,258,366,39,405,789,51.33%,13.69%,1
新北市,石碇區,2181,76,179,255,24,279,662,42.15%,11.48%,1
新北市,石碇區,2182,48,103,151,10,161,310,51.94%,15.48%,1
新北市,石碇區,2183,43,93,136,12,148,280,52.86%,15.36%,1
新北市,石碇區,2184,10,22,32,6,38,93,40.86%,10.75%,1
新北市,石碇區,2185,111,160,271,32,303,683,44.36%,16.25%,1
新北市,石碇區,2186,68,131,199,8,207,323,64.09%,21.05%,1
新北市,石碇區,2187,83,189,272,14,286,726,39.39%,11.43%,1
新北市,石碇區,2188,95,201,296,20,316,591,53.47%,16.07%,1
新北市,石碇區,2189,61,95,156,34,190,282,67.38%,21.63%,1
新北市,石碇區,2190,105,213,318,21,339,788,43.02%,13.32%,1
新北市,石碇區,2191,196,306,502,52,554,943,58.75%,20.78%,1
新北市,坪林區,2192,211,429,640,33,673,1248,53.93%,16.91%,1
新北市,坪林區,2193,83,167,250,42,292,612,47.71%,13.56%,1
新北市,坪林區,2194,182,392,574,80,654,1141,57.32%,15.95%,1
新北市,坪林區,2195,65,104,169,7,176,417,42.21%,15.59%,1
新北市,坪林區,2196,99,191,290,41,331,595,55.63%,16.64%,1
新北市,坪林區,2197,42,87,129,26,155,248,62.5%,16.94%,1
新北市,坪林區,2198,54,105,159,10,169,338,50%,15.98%,1
新北市,坪林區,2199,59,125,184,22,206,478,43.1%,12.34%,1
新北市,坪林區,2200,52,99,151,9,160,390,41.03%,13.33%,1
新北市,坪林區,2201,51,130,181,21,202,424,47.64%,12.03%,1
新北市,三芝區,0011,44,93,137,11,148,312,47.44%,14.1%,1
新北市,三芝區,0012,248,421,669,33,702,1421,49.4%,17.45%,1
新北市,三芝區,0013,276,476,752,53,805,1557,51.7%,17.73%,1
新北市,三芝區,0014,311,562,873,61,934,1828,51.09%,17.01%,1
新北市,三芝區,0015,168,329,497,43,540,1060,50.94%,15.85%,1
新北市,三芝區,0016,105,209,314,42,356,819,43.47%,12.82%,1
新北市,三芝區,0017,244,437,681,39,720,1701,42.33%,14.34%,1
新北市,三芝區,0018,288,497,785,54,839,1740,48.22%,16.55%,1
新北市,三芝區,0019,211,422,633,43,676,1451,46.59%,14.54%,1
新北市,三芝區,0020,154,369,523,53,576,1248,46.15%,12.34%,1
新北市,三芝區,0021,115,201,316,18,334,629,53.1%,18.28%,1
新北市,三芝區,0022,62,151,213,22,235,504,46.63%,12.3%,1
新北市,三芝區,0023,106,191,297,23,320,698,45.85%,15.19%,1
新北市,三芝區,0024,314,608,922,55,977,2069,47.22%,15.18%,1
新北市,三芝區,0025,150,226,376,41,417,784,53.19%,19.13%,1
新北市,三芝區,0026,86,152,238,28,266,522,50.96%,16.48%,1
新北市,三芝區,0027,91,157,248,61,309,587,52.64%,15.5%,1
新北市,三芝區,0028,213,336,549,61,610,1189,51.3%,17.91%,1
新北市,石門區,0001,186,344,530,51,581,1121,51.83%,16.59%,1
新北市,石門區,0002,195,408,603,69,672,1389,48.38%,14.04%,1
新北市,石門區,0003,121,309,430,60,490,933,52.52%,12.97%,1
新北市,石門區,0004,182,372,554,66,620,1244,49.84%,14.63%,1
新北市,石門區,0005,123,279,402,83,485,883,54.93%,13.93%,1
新北市,石門區,0006,252,529,781,58,839,1564,53.64%,16.11%,1
新北市,石門區,0007,247,497,744,52,796,1500,53.07%,16.47%,1
新北市,石門區,0008,37,98,135,16,151,328,46.04%,11.28%,1
新北市,石門區,0009,120,250,370,35,405,651,62.21%,18.43%,1
新北市,石門區,0010,116,245,361,51,412,915,45.03%,12.68%,1
新北市,八里區,0125,251,442,693,51,744,1498,49.67%,16.76%,1
新北市,八里區,0126,330,535,865,34,899,1939,46.36%,17.02%,1
新北市,八里區,0127,239,509,748,61,809,1516,53.36%,15.77%,1
新北市,八里區,0128,335,561,896,46,942,1642,57.37%,20.4%,1
新北市,八里區,0129,348,520,868,74,942,1927,48.88%,18.06%,1
新北市,八里區,0130,234,415,649,44,693,1276,54.31%,18.34%,1
新北市,八里區,0131,247,502,749,40,789,1349,58.49%,18.31%,1
新北市,八里區,0132,253,495,748,38,786,1403,56.02%,18.03%,1
新北市,八里區,0133,294,547,841,48,889,1644,54.08%,17.88%,1
新北市,八里區,0134,307,635,942,55,997,1853,53.8%,16.57%,1
新北市,八里區,0135,321,667,988,56,1044,1793,58.23%,17.9%,1
新北市,八里區,0136,281,553,834,49,883,1644,53.71%,17.09%,1
新北市,八里區,0137,330,589,919,44,963,1846,52.17%,17.88%,1
新北市,八里區,0138,240,430,670,49,719,1346,53.42%,17.83%,1
新北市,八里區,0139,307,510,817,51,868,1621,53.55%,18.94%,1
新北市,八里區,0140,255,630,885,58,943,2110,44.69%,12.09%,1
新北市,八里區,0141,314,629,943,64,1007,1967,51.19%,15.96%,1
新北市,八里區,0142,292,538,830,67,897,1626,55.17%,17.96%,1
新北市,八里區,0143,256,518,774,60,834,1514,55.09%,16.91%,1
新北市,八里區,0144,256,496,752,87,839,1456,57.62%,17.58%,1
新北市,平溪區,2208,45,120,165,31,196,384,51.04%,11.72%,1
新北市,平溪區,2209,29,69,98,3,101,232,43.53%,12.5%,1
新北市,平溪區,2210,37,91,128,12,140,249,56.22%,14.86%,1
新北市,平溪區,2211,82,126,208,44,252,458,55.02%,17.9%,1
新北市,平溪區,2212,29,80,109,18,127,232,54.74%,12.5%,1
新北市,平溪區,2213,82,165,247,17,264,635,41.57%,12.91%,1
新北市,平溪區,2214,55,157,212,35,247,427,57.85%,12.88%,1
新北市,平溪區,2215,110,217,327,40,367,862,42.58%,12.76%,1
新北市,平溪區,2216,21,50,71,2,73,147,49.66%,14.29%,1
新北市,平溪區,2217,24,101,125,13,138,365,37.81%,6.58%,1
新北市,平溪區,2218,14,42,56,7,63,153,41.18%,9.15%,1
新北市,平溪區,2219,19,79,98,11,109,177,61.58%,10.73%,1
新北市,雙溪區,2266,54,141,195,20,215,455,47.25%,11.87%,1
新北市,雙溪區,2267,38,95,133,15,148,286,51.75%,13.29%,1
新北市,雙溪區,2268,73,176,249,25,274,496,55.24%,14.72%,1
新北市,雙溪區,2269,45,109,154,12,166,383,43.34%,11.75%,1
新北市,雙溪區,2270,97,238,335,43,378,887,42.62%,10.94%,1
新北市,雙溪區,2271,77,177,254,24,278,652,42.64%,11.81%,1
新北市,雙溪區,2272,46,113,159,10,169,333,50.75%,13.81%,1
新北市,雙溪區,2273,84,208,292,29,321,642,50%,13.08%,1
新北市,雙溪區,2274,46,74,120,17,137,282,48.58%,16.31%,1
新北市,雙溪區,2275,77,167,244,27,271,621,43.64%,12.4%,1
新北市,雙溪區,2276,55,107,162,10,172,422,40.76%,13.03%,1
新北市,雙溪區,2277,33,79,112,25,137,369,37.13%,8.94%,1
新北市,雙溪區,2278,18,40,58,7,65,120,54.17%,15%,1
新北市,雙溪區,2279,34,82,116,18,134,271,49.45%,12.55%,1
新北市,雙溪區,2280,52,133,185,28,213,362,58.84%,14.36%,1
新北市,雙溪區,2281,59,114,173,20,193,371,52.02%,15.9%,1
新北市,雙溪區,2282,149,419,568,44,612,1047,58.45%,14.23%,1
新北市,貢寮區,2283,126,253,379,55,434,876,49.54%,14.38%,1
新北市,貢寮區,2284,74,123,197,20,217,433,50.12%,17.09%,1
新北市,貢寮區,2285,73,139,212,14,226,516,43.8%,14.15%,1
新北市,貢寮區,2286,46,84,130,23,153,373,41.02%,12.33%,1
新北市,貢寮區,2287,36,79,115,34,149,313,47.6%,11.5%,1
新北市,貢寮區,2288,63,164,227,14,241,485,49.69%,12.99%,1
新北市,貢寮區,2289,61,121,182,29,211,415,50.84%,14.7%,1
新北市,貢寮區,2290,88,224,312,26,338,812,41.63%,10.84%,1
新北市,貢寮區,2291,118,252,370,46,416,861,48.32%,13.7%,1
新北市,貢寮區,2292,85,149,234,32,266,676,39.35%,12.57%,1
新北市,貢寮區,2293,132,242,374,31,405,1091,37.12%,12.1%,1
新北市,貢寮區,2294,98,240,338,55,393,955,41.15%,10.26%,1
新北市,貢寮區,2295,93,202,295,7,302,769,39.27%,12.09%,1
新北市,貢寮區,2296,151,277,428,35,463,962,48.13%,15.7%,1
新北市,貢寮區,2297,44,159,203,11,214,390,54.87%,11.28%,1
新北市,貢寮區,2298,33,111,144,10,154,349,44.13%,9.46%,1
新北市,貢寮區,2299,49,124,173,30,203,508,39.96%,9.65%,1
新北市,貢寮區,2300,48,106,154,10,164,495,33.13%,9.7%,1
新北市,金山區,2301,69,164,233,29,262,481,54.47%,14.35%,1
新北市,金山區,2302,106,236,342,39,381,715,53.29%,14.83%,1
新北市,金山區,2303,58,136,194,21,215,481,44.7%,12.06%,1
新北市,金山區,2304,200,566,766,69,835,1792,46.6%,11.16%,1
新北市,金山區,2305,277,553,830,82,912,1781,51.21%,15.55%,1
新北市,金山區,2306,748,248,996,85,1081,2010,53.78%,37.21%,1
新北市,金山區,2307,221,474,695,64,759,1572,48.28%,14.06%,1
新北市,金山區,2308,382,450,832,81,913,1777,51.38%,21.5%,1
新北市,金山區,2309,228,493,721,58,779,1631,47.76%,13.98%,1
新北市,金山區,2310,139,264,403,33,436,828,52.66%,16.79%,1
新北市,金山區,2311,148,281,429,40,469,888,52.82%,16.67%,1
新北市,金山區,2312,188,366,554,58,612,1211,50.54%,15.52%,1
新北市,金山區,2313,62,154,216,23,239,416,57.45%,14.9%,1
新北市,金山區,2314,122,228,350,48,398,682,58.36%,17.89%,1
新北市,金山區,2315,90,209,299,50,349,644,54.19%,13.98%,1
新北市,金山區,2316,89,278,367,42,409,830,49.28%,10.72%,1
新北市,金山區,2317,27,62,89,11,100,188,53.19%,14.36%,1
新北市,金山區,2318,63,172,235,26,261,469,55.65%,13.43%,1
新北市,金山區,2319,54,132,186,31,217,582,37.29%,9.28%,1
新北市,萬里區,2320,192,450,642,53,695,1286,54.04%,14.93%,1
新北市,萬里區,2321,263,535,798,61,859,1576,54.51%,16.69%,1
新北市,萬里區,2322,203,460,663,38,701,1447,48.45%,14.03%,1
新北市,萬里區,2323,182,425,607,64,671,1466,45.77%,12.41%,1
新北市,萬里區,2324,162,380,542,52,594,1369,43.39%,11.83%,1
新北市,萬里區,2325,137,292,429,47,476,1215,39.18%,11.28%,1
新北市,萬里區,2326,171,467,638,54,692,1317,52.54%,12.98%,1
新北市,萬里區,2327,186,389,575,152,727,1676,43.38%,11.1%,1
新北市,萬里區,2328,198,461,659,79,738,1550,47.61%,12.77%,1
新北市,萬里區,2329,170,356,526,59,585,945,61.9%,17.99%,1
新北市,萬里區,2330,256,620,876,85,961,1760,54.6%,14.55%,1
新北市,萬里區,2331,59,203,262,24,286,570,50.18%,10.35%,1
新北市,萬里區,2332,145,292,437,28,465,952,48.84%,15.23%,1
新北市,萬里區,2333,78,257,335,59,394,674,58.46%,11.57%,1
新北市,萬里區,2334,64,128,192,20,212,405,52.35%,15.8%,1
新北市,萬里區,2335,143,357,500,51,551,1089,50.6%,13.13%,1
新北市,烏來區,2202,301,609,910,36,946,1568,60.33%,19.2%,1
新北市,烏來區,2203,187,406,593,10,603,1198,50.33%,15.61%,1
新北市,烏來區,2204,160,412,572,19,591,1169,50.56%,13.69%,1
新北市,烏來區,2205,35,88,123,1,124,228,54.39%,15.35%,1
新北市,烏來區,2206,66,184,250,20,270,486,55.56%,13.58%,1
新北市,烏來區,2207,83,220,303,19,322,615,52.36%,13.5%,1
桃園市,桃園區,0001,275,492,767,41,808,1593,50.72%,17.26%,1
桃園市,桃園區,0002,295,522,817,31,848,1934,43.85%,15.25%,1
桃園市,桃園區,0003,308,549,857,54,911,1661,54.85%,18.54%,1
桃園市,桃園區,0004,230,440,670,14,684,1448,47.24%,15.88%,1
桃園市,桃園區,0005,340,580,920,39,959,1974,48.58%,17.22%,1
桃園市,桃園區,0006,271,542,813,55,868,1882,46.12%,14.4%,1
桃園市,桃園區,0007,329,519,848,32,880,1800,48.89%,18.28%,1
桃園市,桃園區,0008,308,521,829,45,874,1598,54.69%,19.27%,1
桃園市,桃園區,0009,252,463,715,49,764,1626,46.99%,15.5%,1
桃園市,桃園區,0010,272,475,747,42,789,1590,49.62%,17.11%,1
桃園市,桃園區,0011,302,489,791,44,835,1637,51.01%,18.45%,1
桃園市,桃園區,0012,522,373,895,52,947,1943,48.74%,26.87%,1
桃園市,桃園區,0013,280,454,734,43,777,1482,52.43%,18.89%,1
桃園市,桃園區,0014,254,496,750,35,785,1423,55.17%,17.85%,1
桃園市,桃園區,0015,320,482,802,33,835,1509,55.33%,21.21%,1
桃園市,桃園區,0016,298,522,820,28,848,1567,54.12%,19.02%,1
桃園市,桃園區,0017,239,435,674,36,710,1305,54.41%,18.31%,1
桃園市,桃園區,0018,249,409,658,30,688,1416,48.59%,17.58%,1
桃園市,桃園區,0019,298,481,779,31,810,1439,56.29%,20.71%,1
桃園市,桃園區,0020,267,477,744,45,789,1399,56.4%,19.09%,1
桃園市,桃園區,0021,288,535,823,40,863,1540,56.04%,18.7%,1
桃園市,桃園區,0022,249,535,784,24,808,1638,49.33%,15.2%,1
桃園市,桃園區,0023,219,422,641,26,667,1228,54.32%,17.83%,1
桃園市,桃園區,0024,260,509,769,59,828,1649,50.21%,15.77%,1
桃園市,桃園區,0025,267,533,800,38,838,1601,52.34%,16.68%,1
桃園市,桃園區,0026,277,425,702,101,803,1477,54.37%,18.75%,1
桃園市,桃園區,0027,264,519,783,31,814,1503,54.16%,17.56%,1
桃園市,桃園區,0028,274,463,737,58,795,1375,57.82%,19.93%,1
桃園市,桃園區,0029,291,611,902,42,944,1743,54.16%,16.7%,1
桃園市,桃園區,0030,301,563,864,51,915,1862,49.14%,16.17%,1
桃園市,桃園區,0031,301,564,865,38,903,1728,52.26%,17.42%,1
桃園市,桃園區,0032,147,198,345,17,362,690,52.46%,21.3%,1
桃園市,桃園區,0033,197,296,493,26,519,852,60.92%,23.12%,1
桃園市,桃園區,0034,281,469,750,46,796,1353,58.83%,20.77%,1
桃園市,桃園區,0035,239,395,634,24,658,1698,38.75%,14.08%,1
桃園市,桃園區,0036,281,415,696,42,738,1452,50.83%,19.35%,1
桃園市,桃園區,0037,299,517,816,58,874,1681,51.99%,17.79%,1
桃園市,桃園區,0038,603,199,802,53,855,1669,51.23%,36.13%,1
桃園市,桃園區,0039,277,549,826,48,874,1530,57.12%,18.1%,1
桃園市,桃園區,0040,344,475,819,44,863,1582,54.55%,21.74%,1
桃園市,桃園區,0041,235,485,720,42,762,1587,48.02%,14.81%,1
桃園市,桃園區,0042,263,489,752,49,801,1451,55.2%,18.13%,1
桃園市,桃園區,0043,273,415,688,44,732,1582,46.27%,17.26%,1
桃園市,桃園區,0044,213,332,545,39,584,1028,56.81%,20.72%,1
桃園市,桃園區,0045,309,621,930,36,966,1934,49.95%,15.98%,1
桃園市,桃園區,0046,180,319,499,52,551,1016,54.23%,17.72%,1
桃園市,桃園區,0047,217,340,557,27,584,1079,54.12%,20.11%,1
桃園市,桃園區,0048,370,508,878,16,894,1837,48.67%,20.14%,1
桃園市,桃園區,0049,246,483,729,47,776,1390,55.83%,17.7%,1
桃園市,桃園區,0050,259,518,777,24,801,1489,53.79%,17.39%,1
桃園市,桃園區,0051,389,608,997,18,1015,1821,55.74%,21.36%,1
桃園市,桃園區,0052,262,474,736,22,758,1563,48.5%,16.76%,1
桃園市,桃園區,0053,336,545,881,33,914,1697,53.86%,19.8%,1
桃園市,桃園區,0054,327,577,904,33,937,1740,53.85%,18.79%,1
桃園市,桃園區,0055,287,540,827,30,857,1626,52.71%,17.65%,1
桃園市,桃園區,0056,249,430,679,13,692,1239,55.85%,20.1%,1
桃園市,桃園區,0057,345,562,907,33,940,1766,53.23%,19.54%,1
桃園市,桃園區,0058,267,523,790,47,837,1555,53.83%,17.17%,1
桃園市,桃園區,0059,333,590,923,39,962,1831,52.54%,18.19%,1
桃園市,桃園區,0060,204,432,636,29,665,1115,59.64%,18.3%,1
桃園市,桃園區,0061,303,518,821,41,862,1562,55.19%,19.4%,1
桃園市,桃園區,0062,274,590,864,35,899,1744,51.55%,15.71%,1
桃園市,桃園區,0063,299,527,826,38,864,1838,47.01%,16.27%,1
桃園市,桃園區,0064,362,595,957,57,1014,1889,53.68%,19.16%,1
桃園市,桃園區,0065,303,582,885,57,942,1985,47.46%,15.26%,1
桃園市,桃園區,0066,296,539,835,40,875,1524,57.41%,19.42%,1
桃園市,桃園區,0067,282,564,846,28,874,1425,61.33%,19.79%,1
桃園市,桃園區,0068,325,562,887,32,919,1606,57.22%,20.24%,1
桃園市,桃園區,0069,362,762,1124,23,1147,2056,55.79%,17.61%,1
桃園市,桃園區,0070,385,693,1078,31,1109,2010,55.17%,19.15%,1
桃園市,桃園區,0071,364,692,1056,51,1107,2245,49.31%,16.21%,1
桃園市,桃園區,0072,330,492,822,34,856,1590,53.84%,20.75%,1
桃園市,桃園區,0073,314,578,892,22,914,1536,59.51%,20.44%,1
桃園市,桃園區,0074,345,564,909,39,948,1949,48.64%,17.7%,1
桃園市,桃園區,0075,320,615,935,43,978,1965,49.77%,16.28%,1
桃園市,桃園區,0076,330,699,1029,52,1081,2414,44.78%,13.67%,1
桃園市,桃園區,0077,319,624,943,51,994,1942,51.18%,16.43%,1
桃園市,桃園區,0078,346,717,1063,53,1116,2156,51.76%,16.05%,1
桃園市,桃園區,0079,272,474,746,45,791,1404,56.34%,19.37%,1
桃園市,桃園區,0080,242,452,694,31,725,1194,60.72%,20.27%,1
桃園市,桃園區,0081,347,440,787,49,836,1449,57.69%,23.95%,1
桃園市,桃園區,0082,286,521,807,67,874,1803,48.47%,15.86%,1
桃園市,桃園區,0083,291,565,856,43,899,1692,53.13%,17.2%,1
桃園市,桃園區,0084,365,593,958,40,998,1913,52.17%,19.08%,1
桃園市,桃園區,0085,342,571,913,36,949,1815,52.29%,18.84%,1
桃園市,桃園區,0086,210,339,549,38,587,1173,50.04%,17.9%,1
桃園市,桃園區,0087,196,361,557,18,575,1162,49.48%,16.87%,1
桃園市,桃園區,0088,142,346,488,64,552,1194,46.23%,11.89%,1
桃園市,桃園區,0089,324,510,834,49,883,1695,52.09%,19.12%,1
桃園市,桃園區,0090,316,561,877,29,906,1797,50.42%,17.58%,1
桃園市,桃園區,0091,259,538,797,21,818,1592,51.38%,16.27%,1
桃園市,桃園區,0092,268,576,844,57,901,1780,50.62%,15.06%,1
桃園市,桃園區,0093,322,527,849,27,876,1904,46.01%,16.91%,1
桃園市,桃園區,0094,347,613,960,26,986,2021,48.79%,17.17%,1
桃園市,桃園區,0095,219,534,753,46,799,1545,51.72%,14.17%,1
桃園市,桃園區,0096,254,517,771,23,794,1617,49.1%,15.71%,1
桃園市,桃園區,0097,276,544,820,30,850,1683,50.51%,16.4%,1
桃園市,桃園區,0098,332,615,947,54,1001,1834,54.58%,18.1%,1
桃園市,桃園區,0099,349,589,938,36,974,2055,47.4%,16.98%,1
桃園市,桃園區,0100,301,561,862,25,887,1828,48.52%,16.47%,1
桃園市,桃園區,0101,305,579,884,32,916,1873,48.91%,16.28%,1
桃園市,桃園區,0102,255,471,726,33,759,3687,20.59%,6.92%,1
桃園市,桃園區,0103,334,591,925,24,949,1850,51.3%,18.05%,1
桃園市,桃園區,0104,295,589,884,43,927,1827,50.74%,16.15%,1
桃園市,桃園區,0105,193,466,659,33,692,1149,60.23%,16.8%,1
桃園市,桃園區,0106,210,367,577,44,621,1061,58.53%,19.79%,1
桃園市,桃園區,0107,307,544,851,23,874,1831,47.73%,16.77%,1
桃園市,桃園區,0108,368,664,1032,39,1071,2168,49.4%,16.97%,1
桃園市,桃園區,0109,337,569,906,17,923,1874,49.25%,17.98%,1
桃園市,桃園區,0110,253,434,687,18,705,1524,46.26%,16.6%,1
桃園市,桃園區,0111,288,495,783,22,805,1528,52.68%,18.85%,1
桃園市,桃園區,0112,311,465,776,31,807,1489,54.2%,20.89%,1
桃園市,桃園區,0113,252,374,626,50,676,1308,51.68%,19.27%,1
桃園市,桃園區,0114,260,514,774,41,815,1583,51.48%,16.42%,1
桃園市,桃園區,0115,302,531,833,47,880,1618,54.39%,18.67%,1
桃園市,桃園區,0116,360,635,995,49,1044,2127,49.08%,16.93%,1
桃園市,桃園區,0117,334,633,967,17,984,2033,48.4%,16.43%,1
桃園市,桃園區,0118,353,686,1039,18,1057,2098,50.38%,16.83%,1
桃園市,桃園區,0119,285,710,995,57,1052,2126,49.48%,13.41%,1
桃園市,桃園區,0120,305,600,905,33,938,1917,48.93%,15.91%,1
桃園市,桃園區,0121,348,603,951,32,983,1997,49.22%,17.43%,1
桃園市,桃園區,0122,352,649,1001,27,1028,1929,53.29%,18.25%,1
桃園市,桃園區,0123,295,526,821,38,859,1691,50.8%,17.45%,1
桃園市,桃園區,0124,345,591,936,20,956,1900,50.32%,18.16%,1
桃園市,桃園區,0125,300,580,880,54,934,1761,53.04%,17.04%,1
桃園市,桃園區,0126,356,590,946,23,969,1922,50.42%,18.52%,1
桃園市,桃園區,0127,311,630,941,49,990,1995,49.62%,15.59%,1
桃園市,桃園區,0128,199,359,558,29,587,1063,55.22%,18.72%,1
桃園市,桃園區,0129,263,449,712,25,737,1412,52.2%,18.63%,1
桃園市,桃園區,0130,348,569,917,26,943,1746,54.01%,19.93%,1
桃園市,桃園區,0131,285,478,763,45,808,1689,47.84%,16.87%,1
桃園市,桃園區,0132,239,431,670,22,692,1542,44.88%,15.5%,1
桃園市,桃園區,0133,231,454,685,37,722,1437,50.24%,16.08%,1
桃園市,桃園區,0134,281,548,829,35,864,1679,51.46%,16.74%,1
桃園市,桃園區,0135,303,527,830,48,878,1886,46.55%,16.07%,1
桃園市,桃園區,0136,307,511,818,69,887,1657,53.53%,18.53%,1
桃園市,桃園區,0137,266,434,700,23,723,1349,53.6%,19.72%,1
桃園市,桃園區,0138,335,576,911,32,943,1805,52.24%,18.56%,1
桃園市,桃園區,0139,313,577,890,48,938,1846,50.81%,16.96%,1
桃園市,桃園區,0140,266,475,741,38,779,1644,47.38%,16.18%,1
桃園市,桃園區,0141,296,477,773,33,806,1674,48.15%,17.68%,1
桃園市,桃園區,0142,282,558,840,47,887,1737,51.07%,16.23%,1
桃園市,桃園區,0143,265,532,797,42,839,1566,53.58%,16.92%,1
桃園市,桃園區,0144,287,494,781,30,811,1517,53.46%,18.92%,1
桃園市,桃園區,0145,274,439,713,34,747,1619,46.14%,16.92%,1
桃園市,桃園區,0146,334,513,847,31,878,1774,49.49%,18.83%,1
桃園市,桃園區,0147,295,537,832,35,867,1666,52.04%,17.71%,1
桃園市,桃園區,0148,281,502,783,16,799,1528,52.29%,18.39%,1
桃園市,桃園區,0149,294,537,831,41,872,1709,51.02%,17.2%,1
桃園市,桃園區,0150,325,523,848,19,867,1719,50.44%,18.91%,1
桃園市,桃園區,0151,244,446,690,42,732,1569,46.65%,15.55%,1
桃園市,桃園區,0152,220,497,717,28,745,1505,49.5%,14.62%,1
桃園市,桃園區,0153,252,455,707,51,758,1496,50.67%,16.84%,1
桃園市,桃園區,0154,268,502,770,33,803,1505,53.36%,17.81%,1
桃園市,桃園區,0155,325,553,878,31,909,1807,50.3%,17.99%,1
桃園市,桃園區,0156,332,578,910,38,948,1857,51.05%,17.88%,1
桃園市,桃園區,0157,255,587,842,52,894,1589,56.26%,16.05%,1
桃園市,桃園區,0158,382,634,1016,39,1055,2088,50.53%,18.3%,1
桃園市,桃園區,0159,313,608,921,29,950,1893,50.18%,16.53%,1
桃園市,桃園區,0160,181,387,568,24,592,1303,45.43%,13.89%,1
桃園市,桃園區,0161,274,451,725,33,758,1416,53.53%,19.35%,1
桃園市,桃園區,0162,211,430,641,23,664,1351,49.15%,15.62%,1
桃園市,桃園區,0163,300,492,792,25,817,1659,49.25%,18.08%,1
桃園市,桃園區,0164,331,661,992,29,1021,2103,48.55%,15.74%,1
桃園市,桃園區,0165,331,604,935,28,963,1943,49.56%,17.04%,1
桃園市,桃園區,0166,363,591,954,30,984,1927,51.06%,18.84%,1
桃園市,桃園區,0167,317,530,847,34,881,1929,45.67%,16.43%,1
桃園市,桃園區,0168,450,760,1210,27,1237,2204,56.13%,20.42%,1
桃園市,桃園區,0169,414,500,914,20,934,2033,45.94%,20.36%,1
桃園市,桃園區,0170,262,571,833,14,847,1656,51.15%,15.82%,1
桃園市,桃園區,0171,317,512,829,44,873,1712,50.99%,18.52%,1
桃園市,桃園區,0172,331,513,844,30,874,1738,50.29%,19.04%,1
桃園市,桃園區,0173,287,546,833,25,858,1432,59.92%,20.04%,1
桃園市,桃園區,0174,316,470,786,35,821,1421,57.78%,22.24%,1
桃園市,桃園區,0175,264,430,694,11,705,1344,52.46%,19.64%,1
桃園市,桃園區,0176,316,562,878,22,900,1942,46.34%,16.27%,1
桃園市,桃園區,0177,346,633,979,29,1008,2001,50.37%,17.29%,1
桃園市,桃園區,0178,332,545,877,17,894,1941,46.06%,17.1%,1
桃園市,桃園區,0179,292,584,876,37,913,1702,53.64%,17.16%,1
桃園市,桃園區,0180,296,495,791,29,820,1589,51.6%,18.63%,1
桃園市,桃園區,0181,267,501,768,28,796,1544,51.55%,17.29%,1
桃園市,桃園區,0182,260,514,774,40,814,1860,43.76%,13.98%,1
桃園市,桃園區,0183,291,525,816,54,870,1726,50.41%,16.86%,1
桃園市,桃園區,0184,279,548,827,40,867,1798,48.22%,15.52%,1
桃園市,桃園區,0185,356,594,950,26,976,1925,50.7%,18.49%,1
桃園市,桃園區,0186,366,573,939,29,968,1945,49.77%,18.82%,1
桃園市,桃園區,0187,302,494,796,37,833,1764,47.22%,17.12%,1
桃園市,桃園區,0188,282,684,966,65,1031,1899,54.29%,14.85%,1
桃園市,桃園區,0189,250,460,710,20,730,1415,51.59%,17.67%,1
桃園市,桃園區,0190,303,528,831,24,855,1790,47.77%,16.93%,1
桃園市,桃園區,0191,280,512,792,29,821,1693,48.49%,16.54%,1
桃園市,桃園區,0192,311,590,901,43,944,1916,49.27%,16.23%,1
桃園市,桃園區,0193,250,413,663,19,682,1434,47.56%,17.43%,1
桃園市,桃園區,0194,309,496,805,42,847,1494,56.69%,20.68%,1
桃園市,桃園區,0195,230,436,666,56,722,1311,55.07%,17.54%,1
桃園市,桃園區,0196,258,477,735,38,773,1476,52.37%,17.48%,1
桃園市,桃園區,0197,325,475,800,31,831,1484,56%,21.9%,1
桃園市,桃園區,0198,288,452,740,38,778,1514,51.39%,19.02%,1
桃園市,桃園區,0199,248,466,714,43,757,1446,52.35%,17.15%,1
桃園市,桃園區,0200,259,482,741,24,765,1573,48.63%,16.47%,1
桃園市,桃園區,0201,233,465,698,30,728,1564,46.55%,14.9%,1
桃園市,桃園區,0202,207,334,541,34,575,1015,56.65%,20.39%,1
桃園市,桃園區,0203,172,286,458,31,489,955,51.2%,18.01%,1
桃園市,桃園區,0204,311,562,873,26,899,1796,50.06%,17.32%,1
桃園市,桃園區,0205,339,557,896,15,911,1878,48.51%,18.05%,1
桃園市,桃園區,0206,272,544,816,38,854,1729,49.39%,15.73%,1
桃園市,桃園區,0207,281,536,817,24,841,1843,45.63%,15.25%,1
桃園市,桃園區,0208,263,493,756,23,779,1817,42.87%,14.47%,1
桃園市,桃園區,0209,185,344,529,24,553,979,56.49%,18.9%,1
桃園市,桃園區,0210,300,403,703,21,724,1363,53.12%,22.01%,1
桃園市,桃園區,0211,281,497,778,13,791,1546,51.16%,18.18%,1
桃園市,桃園區,0212,248,391,639,23,662,1308,50.61%,18.96%,1
桃園市,桃園區,0213,366,656,1022,50,1072,2164,49.54%,16.91%,1
桃園市,桃園區,0214,329,619,948,38,986,2020,48.81%,16.29%,1
桃園市,桃園區,0215,292,543,835,26,861,1924,44.75%,15.18%,1
桃園市,桃園區,0216,280,584,864,34,898,2088,43.01%,13.41%,1
桃園市,中壢區,0591,236,471,707,36,743,1401,53.03%,16.85%,1
桃園市,中壢區,0592,296,562,858,42,900,1798,50.06%,16.46%,1
桃園市,中壢區,0593,265,479,744,29,773,1642,47.08%,16.14%,1
桃園市,中壢區,0594,296,553,849,40,889,1670,53.23%,17.72%,1
桃園市,中壢區,0595,273,504,777,23,800,1456,54.95%,18.75%,1
桃園市,中壢區,0596,296,609,905,25,930,1531,60.74%,19.33%,1
桃園市,中壢區,0597,259,646,905,33,938,1623,57.79%,15.96%,1
桃園市,中壢區,0598,239,630,869,27,896,1953,45.88%,12.24%,1
桃園市,中壢區,0599,197,440,637,22,659,1155,57.06%,17.06%,1
桃園市,中壢區,0600,238,570,808,30,838,1800,46.56%,13.22%,1
桃園市,中壢區,0601,259,565,824,23,847,1757,48.21%,14.74%,1
桃園市,中壢區,0602,215,510,725,36,761,1281,59.41%,16.78%,1
桃園市,中壢區,0603,249,561,810,23,833,1462,56.98%,17.03%,1
桃園市,中壢區,0604,200,525,725,48,773,1560,49.55%,12.82%,1
桃園市,中壢區,0605,289,621,910,26,936,1602,58.43%,18.04%,1
桃園市,中壢區,0606,161,458,619,26,645,1006,64.12%,16%,1
桃園市,中壢區,0607,241,574,815,22,837,1474,56.78%,16.35%,1
桃園市,中壢區,0608,216,593,809,77,886,1627,54.46%,13.28%,1
桃園市,中壢區,0609,252,571,823,36,859,1519,56.55%,16.59%,1
桃園市,中壢區,0610,210,575,785,55,840,1526,55.05%,13.76%,1
桃園市,中壢區,0611,207,600,807,66,873,1618,53.96%,12.79%,1
桃園市,中壢區,0612,245,605,850,56,906,1554,58.3%,15.77%,1
桃園市,中壢區,0613,223,636,859,64,923,1706,54.1%,13.07%,1
桃園市,中壢區,0614,306,689,995,42,1037,1818,57.04%,16.83%,1
桃園市,中壢區,0615,295,661,956,38,994,1991,49.92%,14.82%,1
桃園市,中壢區,0616,240,589,829,34,863,1609,53.64%,14.92%,1
桃園市,中壢區,0617,159,466,625,27,652,1329,49.06%,11.96%,1
桃園市,中壢區,0618,219,520,739,65,804,1587,50.66%,13.8%,1
桃園市,中壢區,0619,289,678,967,30,997,1955,51%,14.78%,1
桃園市,中壢區,0620,260,578,838,51,889,1711,51.96%,15.2%,1
桃園市,中壢區,0621,249,581,830,49,879,1712,51.34%,14.54%,1
桃園市,中壢區,0622,238,556,794,42,836,1448,57.73%,16.44%,1
桃園市,中壢區,0623,253,538,791,42,833,1605,51.9%,15.76%,1
桃園市,中壢區,0624,218,547,765,13,778,1633,47.64%,13.35%,1
桃園市,中壢區,0625,305,662,967,49,1016,1795,56.6%,16.99%,1
桃園市,中壢區,0626,239,654,893,21,914,1689,54.11%,14.15%,1
桃園市,中壢區,0627,208,438,646,25,671,1201,55.87%,17.32%,1
桃園市,中壢區,0628,257,445,702,25,727,1353,53.73%,18.99%,1
桃園市,中壢區,0629,252,522,774,25,799,1587,50.35%,15.88%,1
桃園市,中壢區,0630,311,656,967,37,1004,1883,53.32%,16.52%,1
桃園市,中壢區,0631,245,482,727,23,750,1448,51.8%,16.92%,1
桃園市,中壢區,0632,312,595,907,35,942,1810,52.04%,17.24%,1
桃園市,中壢區,0633,322,616,938,41,979,1916,51.1%,16.81%,1
桃園市,中壢區,0634,200,455,655,23,678,1177,57.6%,16.99%,1
桃園市,中壢區,0635,272,540,812,30,842,1410,59.72%,19.29%,1
桃園市,中壢區,0636,237,458,695,25,720,1368,52.63%,17.32%,1
桃園市,中壢區,0637,246,567,813,38,851,1424,59.76%,17.28%,1
桃園市,中壢區,0638,294,557,851,28,879,1573,55.88%,18.69%,1
桃園市,中壢區,0639,225,420,645,17,662,1152,57.47%,19.53%,1
桃園市,中壢區,0640,212,439,651,11,662,1178,56.2%,18%,1
桃園市,中壢區,0641,328,678,1006,38,1044,1966,53.1%,16.68%,1
桃園市,中壢區,0642,250,441,691,23,714,3474,20.55%,7.2%,1
桃園市,中壢區,0643,406,679,1085,44,1129,2099,53.79%,19.34%,1
桃園市,中壢區,0644,301,331,632,31,663,1178,56.28%,25.55%,1
桃園市,中壢區,0645,296,519,815,40,855,1397,61.2%,21.19%,1
桃園市,中壢區,0646,310,578,888,38,926,1669,55.48%,18.57%,1
桃園市,中壢區,0647,323,661,984,41,1025,2087,49.11%,15.48%,1
桃園市,中壢區,0648,311,626,937,38,975,1900,51.32%,16.37%,1
桃園市,中壢區,0649,256,449,705,18,723,1640,44.09%,15.61%,1
桃園市,中壢區,0650,177,389,566,24,590,994,59.36%,17.81%,1
桃園市,中壢區,0651,191,497,688,39,727,1131,64.28%,16.89%,1
桃園市,中壢區,0652,330,599,929,26,955,1625,58.77%,20.31%,1
桃園市,中壢區,0653,284,549,833,28,861,1384,62.21%,20.52%,1
桃園市,中壢區,0654,254,566,820,34,854,1588,53.78%,15.99%,1
桃園市,中壢區,0655,190,546,736,51,787,1445,54.46%,13.15%,1
桃園市,中壢區,0656,203,569,772,34,806,1743,46.24%,11.65%,1
桃園市,中壢區,0657,255,589,844,20,864,1812,47.68%,14.07%,1
桃園市,中壢區,0658,236,514,750,38,788,1546,50.97%,15.27%,1
桃園市,中壢區,0659,195,455,650,37,687,1290,53.26%,15.12%,1
桃園市,中壢區,0660,271,706,977,69,1046,2145,48.76%,12.63%,1
桃園市,中壢區,0661,226,462,688,31,719,1451,49.55%,15.58%,1
桃園市,中壢區,0662,221,514,735,41,776,1489,52.12%,14.84%,1
桃園市,中壢區,0663,156,282,438,23,461,827,55.74%,18.86%,1
桃園市,中壢區,0664,220,501,721,26,747,1442,51.8%,15.26%,1
桃園市,中壢區,0665,286,566,852,19,871,1842,47.29%,15.53%,1
桃園市,中壢區,0666,237,481,718,29,747,1520,49.14%,15.59%,1
桃園市,中壢區,0667,531,255,786,39,825,1764,46.77%,30.1%,1
桃園市,中壢區,0668,250,557,807,16,823,1488,55.31%,16.8%,1
桃園市,中壢區,0669,258,560,818,30,848,1593,53.23%,16.2%,1
桃園市,中壢區,0670,333,444,777,23,800,1505,53.16%,22.13%,1
桃園市,中壢區,0671,250,597,847,19,866,1661,52.14%,15.05%,1
桃園市,中壢區,0672,238,554,792,27,819,1492,54.89%,15.95%,1
桃園市,中壢區,0673,192,399,591,26,617,1249,49.4%,15.37%,1
桃園市,中壢區,0674,217,458,675,25,700,1257,55.69%,17.26%,1
桃園市,中壢區,0675,271,546,817,48,865,1659,52.14%,16.34%,1
桃園市,中壢區,0676,335,627,962,26,988,1815,54.44%,18.46%,1
桃園市,中壢區,0677,282,553,835,28,863,1702,50.71%,16.57%,1
桃園市,中壢區,0678,284,522,806,19,825,1541,53.54%,18.43%,1
桃園市,中壢區,0679,233,545,778,41,819,1659,49.37%,14.04%,1
桃園市,中壢區,0680,246,659,905,67,972,1874,51.87%,13.13%,1
桃園市,中壢區,0681,191,574,765,36,801,1603,49.97%,11.92%,1
桃園市,中壢區,0682,290,555,845,39,884,1735,50.95%,16.71%,1
桃園市,中壢區,0683,314,585,899,21,920,1815,50.69%,17.3%,1
桃園市,中壢區,0684,393,594,987,26,1013,1873,54.08%,20.98%,1
桃園市,中壢區,0685,249,662,911,56,967,1739,55.61%,14.32%,1
桃園市,中壢區,0686,265,542,807,37,844,1709,49.39%,15.51%,1
桃園市,中壢區,0687,277,597,874,38,912,1655,55.11%,16.74%,1
桃園市,中壢區,0688,227,631,858,31,889,1664,53.43%,13.64%,1
桃園市,中壢區,0689,151,387,538,21,559,1087,51.43%,13.89%,1
桃園市,中壢區,0690,179,381,560,39,599,1065,56.24%,16.81%,1
桃園市,中壢區,0691,300,634,934,57,991,1844,53.74%,16.27%,1
桃園市,中壢區,0692,167,382,549,31,580,1220,47.54%,13.69%,1
桃園市,中壢區,0693,227,400,627,30,657,1219,53.9%,18.62%,1
桃園市,中壢區,0694,216,440,656,39,695,1260,55.16%,17.14%,1
桃園市,中壢區,0695,279,601,880,47,927,1594,58.16%,17.5%,1
桃園市,中壢區,0696,329,548,877,66,943,1733,54.41%,18.98%,1
桃園市,中壢區,0697,336,664,1000,41,1041,1979,52.6%,16.98%,1
桃園市,中壢區,0698,325,534,859,23,882,1621,54.41%,20.05%,1
桃園市,中壢區,0699,247,508,755,31,786,1391,56.51%,17.76%,1
桃園市,中壢區,0700,280,555,835,16,851,1531,55.58%,18.29%,1
桃園市,中壢區,0701,258,646,904,35,939,1943,48.33%,13.28%,1
桃園市,中壢區,0702,223,474,697,17,714,1363,52.38%,16.36%,1
桃園市,中壢區,0703,321,615,936,41,977,2172,44.98%,14.78%,1
桃園市,中壢區,0704,241,601,842,37,879,1798,48.89%,13.4%,1
桃園市,中壢區,0705,230,580,810,18,828,1671,49.55%,13.76%,1
桃園市,中壢區,0706,302,622,924,61,985,1969,50.03%,15.34%,1
桃園市,中壢區,0707,295,641,936,48,984,1563,62.96%,18.87%,1
桃園市,中壢區,0708,314,632,946,32,978,1762,55.51%,17.82%,1
桃園市,中壢區,0709,245,436,681,34,715,1923,37.18%,12.74%,1
桃園市,中壢區,0710,290,559,849,52,901,1572,57.32%,18.45%,1
桃園市,中壢區,0711,304,683,987,27,1014,1850,54.81%,16.43%,1
桃園市,中壢區,0712,268,510,778,44,822,1583,51.93%,16.93%,1
桃園市,中壢區,0713,306,548,854,41,895,1735,51.59%,17.64%,1
桃園市,中壢區,0714,209,449,658,29,687,1292,53.17%,16.18%,1
桃園市,中壢區,0715,217,449,666,19,685,1265,54.15%,17.15%,1
桃園市,中壢區,0716,272,620,892,38,930,1798,51.72%,15.13%,1
桃園市,中壢區,0717,294,699,993,49,1042,1822,57.19%,16.14%,1
桃園市,中壢區,0718,263,569,832,28,860,1613,53.32%,16.31%,1
桃園市,中壢區,0719,281,441,722,36,758,1405,53.95%,20%,1
桃園市,中壢區,0720,319,603,922,62,984,1730,56.88%,18.44%,1
桃園市,中壢區,0721,273,525,798,34,832,1384,60.12%,19.73%,1
桃園市,中壢區,0722,222,400,622,12,634,1122,56.51%,19.79%,1
桃園市,中壢區,0723,212,354,566,38,604,992,60.89%,21.37%,1
桃園市,中壢區,0724,322,590,912,33,945,1820,51.92%,17.69%,1
桃園市,中壢區,0725,293,603,896,46,942,1847,51%,15.86%,1
桃園市,中壢區,0726,202,516,718,43,761,1302,58.45%,15.51%,1
桃園市,中壢區,0727,224,431,655,42,697,1203,57.94%,18.62%,1
桃園市,中壢區,0728,252,498,750,40,790,1226,64.44%,20.55%,1
桃園市,中壢區,0729,234,469,703,31,734,1234,59.48%,18.96%,1
桃園市,中壢區,0730,278,628,906,46,952,2023,47.06%,13.74%,1
桃園市,中壢區,0731,232,482,714,28,742,1555,47.72%,14.92%,1
桃園市,中壢區,0732,339,600,939,40,979,1951,50.18%,17.38%,1
桃園市,中壢區,0733,254,480,734,36,770,1383,55.68%,18.37%,1
桃園市,中壢區,0734,198,472,670,36,706,1164,60.65%,17.01%,1
桃園市,中壢區,0735,254,533,787,26,813,1482,54.86%,17.14%,1
桃園市,中壢區,0736,266,648,914,39,953,1770,53.84%,15.03%,1
桃園市,中壢區,0737,310,612,922,63,985,1703,57.84%,18.2%,1
桃園市,中壢區,0738,283,630,913,43,956,1841,51.93%,15.37%,1
桃園市,中壢區,0739,389,645,1034,32,1066,1941,54.92%,20.04%,1
桃園市,中壢區,0740,373,711,1084,33,1117,2029,55.05%,18.38%,1
桃園市,中壢區,0741,284,624,908,23,931,1636,56.91%,17.36%,1
桃園市,中壢區,0742,244,596,840,34,874,1528,57.2%,15.97%,1
桃園市,中壢區,0743,354,692,1046,57,1103,2289,48.19%,15.47%,1
桃園市,中壢區,0744,357,613,970,27,997,2020,49.36%,17.67%,1
桃園市,中壢區,0745,346,700,1046,26,1072,2027,52.89%,17.07%,1
桃園市,中壢區,0746,297,516,813,21,834,1883,44.29%,15.77%,1
桃園市,中壢區,0747,339,650,989,35,1024,2080,49.23%,16.3%,1
桃園市,中壢區,0748,124,215,339,12,351,646,54.33%,19.2%,1
桃園市,中壢區,0749,325,749,1074,42,1116,1780,62.7%,18.26%,1
桃園市,中壢區,0750,205,562,767,24,791,1372,57.65%,14.94%,1
桃園市,中壢區,0751,300,629,929,32,961,1668,57.61%,17.99%,1
桃園市,中壢區,0752,351,616,967,27,994,1987,50.03%,17.66%,1
桃園市,中壢區,0753,258,540,798,20,818,1520,53.82%,16.97%,1
桃園市,中壢區,0754,154,285,439,28,467,852,54.81%,18.08%,1
桃園市,中壢區,0755,261,386,647,23,670,1209,55.42%,21.59%,1
桃園市,中壢區,0756,257,491,748,55,803,1481,54.22%,17.35%,1
桃園市,中壢區,0757,259,473,732,16,748,1564,47.83%,16.56%,1
桃園市,中壢區,0758,341,664,1005,51,1056,1957,53.96%,17.42%,1
桃園市,中壢區,0759,247,441,688,41,729,1223,59.61%,20.2%,1
桃園市,中壢區,0760,232,432,664,29,693,1182,58.63%,19.63%,1
桃園市,中壢區,0761,190,409,599,31,630,1066,59.1%,17.82%,1
桃園市,中壢區,0762,296,650,946,37,983,1701,57.79%,17.4%,1
桃園市,中壢區,0763,164,313,477,29,506,943,53.66%,17.39%,1
桃園市,中壢區,0764,149,268,417,25,442,731,60.47%,20.38%,1
桃園市,中壢區,0765,166,287,453,38,491,851,57.7%,19.51%,1
桃園市,中壢區,0766,205,318,523,32,555,1011,54.9%,20.28%,1
桃園市,中壢區,0767,291,550,841,37,878,1532,57.31%,18.99%,1
桃園市,中壢區,0768,184,344,528,32,560,1028,54.47%,17.9%,1
桃園市,中壢區,0769,314,317,631,43,674,1157,58.25%,27.14%,1
桃園市,中壢區,0770,295,511,806,43,849,1591,53.36%,18.54%,1
桃園市,中壢區,0771,316,661,977,50,1027,2156,47.63%,14.66%,1
桃園市,中壢區,0772,223,458,681,27,708,1479,47.87%,15.08%,1
桃園市,中壢區,0773,325,582,907,32,939,1780,52.75%,18.26%,1
桃園市,中壢區,0774,279,559,838,55,893,1651,54.09%,16.9%,1
桃園市,中壢區,0775,379,604,983,27,1010,1870,54.01%,20.27%,1
桃園市,中壢區,0776,303,557,860,18,878,1913,45.9%,15.84%,1
桃園市,中壢區,0777,220,495,715,32,747,1609,46.43%,13.67%,1
桃園市,中壢區,0778,248,507,755,27,782,1539,50.81%,16.11%,1
桃園市,中壢區,0779,246,499,745,21,766,1426,53.72%,17.25%,1
桃園市,中壢區,0780,255,489,744,42,786,1618,48.58%,15.76%,1
桃園市,中壢區,0781,229,519,748,36,784,1441,54.41%,15.89%,1
桃園市,中壢區,0782,298,515,813,28,841,1528,55.04%,19.5%,1
桃園市,中壢區,0783,283,572,855,51,906,1683,53.83%,16.82%,1
桃園市,中壢區,0784,339,676,1015,59,1074,1945,55.22%,17.43%,1
桃園市,中壢區,0785,235,519,754,54,808,1534,52.67%,15.32%,1
桃園市,中壢區,0786,183,683,866,47,913,1810,50.44%,10.11%,1
桃園市,中壢區,0787,195,330,525,37,562,1097,51.23%,17.78%,1
桃園市,中壢區,0788,351,556,907,24,931,1917,48.57%,18.31%,1
桃園市,中壢區,0789,360,568,928,48,976,1858,52.53%,19.38%,1
桃園市,中壢區,0790,411,434,845,36,881,1576,55.9%,26.08%,1
桃園市,中壢區,0791,260,515,775,53,828,1478,56.02%,17.59%,1
桃園市,中壢區,0792,296,517,813,28,841,1589,52.93%,18.63%,1
桃園市,中壢區,0793,357,687,1044,79,1123,2037,55.13%,17.53%,1
桃園市,中壢區,0794,234,433,667,33,700,1158,60.45%,20.21%,1
桃園市,中壢區,0795,306,688,994,75,1069,1967,54.35%,15.56%,1
桃園市,中壢區,0796,285,580,865,62,927,1830,50.66%,15.57%,1
桃園市,中壢區,0797,294,659,953,31,984,1856,53.02%,15.84%,1
桃園市,中壢區,0798,310,665,975,63,1038,2068,50.19%,14.99%,1
桃園市,中壢區,0799,292,561,853,38,891,2152,41.4%,13.57%,1
桃園市,中壢區,0800,365,580,945,44,989,2158,45.83%,16.91%,1
桃園市,大溪區,0522,269,508,777,52,829,1477,56.13%,18.21%,1
桃園市,大溪區,0523,178,349,527,33,560,1006,55.67%,17.69%,1
桃園市,大溪區,0524,228,521,749,66,815,1553,52.48%,14.68%,1
桃園市,大溪區,0525,288,517,805,64,869,1597,54.41%,18.03%,1
桃園市,大溪區,0526,240,441,681,45,726,1358,53.46%,17.67%,1
桃園市,大溪區,0527,244,480,724,38,762,1585,48.08%,15.39%,1
桃園市,大溪區,0528,266,530,796,44,840,1612,52.11%,16.5%,1
桃園市,大溪區,0529,210,484,694,31,725,1555,46.62%,13.5%,1
桃園市,大溪區,0530,230,490,720,54,774,1282,60.37%,17.94%,1
桃園市,大溪區,0531,207,468,675,55,730,1392,52.44%,14.87%,1
桃園市,大溪區,0532,207,461,668,50,718,1422,50.49%,14.56%,1
桃園市,大溪區,0533,255,475,730,58,788,1448,54.42%,17.61%,1
桃園市,大溪區,0534,244,485,729,47,776,1269,61.15%,19.23%,1
桃園市,大溪區,0535,170,354,524,67,591,977,60.49%,17.4%,1
桃園市,大溪區,0536,228,490,718,48,766,1359,56.36%,16.78%,1
桃園市,大溪區,0537,222,398,620,66,686,1135,60.44%,19.56%,1
桃園市,大溪區,0538,112,184,296,56,352,660,53.33%,16.97%,1
桃園市,大溪區,0539,187,304,491,40,531,1056,50.28%,17.71%,1
桃園市,大溪區,0540,200,387,587,59,646,1263,51.15%,15.84%,1
桃園市,大溪區,0541,115,252,367,33,400,717,55.79%,16.04%,1
桃園市,大溪區,0542,176,356,532,27,559,1299,43.03%,13.55%,1
桃園市,大溪區,0543,169,323,492,50,542,976,55.53%,17.32%,1
桃園市,大溪區,0544,129,320,449,59,508,938,54.16%,13.75%,1
桃園市,大溪區,0545,107,288,395,28,423,832,50.84%,12.86%,1
桃園市,大溪區,0546,122,251,373,24,397,866,45.84%,14.09%,1
桃園市,大溪區,0547,133,183,316,31,347,694,50%,19.16%,1
桃園市,大溪區,0548,208,448,656,44,700,1410,49.65%,14.75%,1
桃園市,大溪區,0549,168,426,594,55,649,1303,49.81%,12.89%,1
桃園市,大溪區,0550,194,358,552,37,589,1125,52.36%,17.24%,1
桃園市,大溪區,0551,212,404,616,28,644,1170,55.04%,18.12%,1
桃園市,大溪區,0552,253,478,731,34,765,1308,58.49%,19.34%,1
桃園市,大溪區,0553,198,350,548,69,617,1094,56.4%,18.1%,1
桃園市,大溪區,0554,343,738,1081,65,1146,2153,53.23%,15.93%,1
桃園市,大溪區,0555,147,496,643,36,679,1173,57.89%,12.53%,1
桃園市,大溪區,0556,183,497,680,25,705,1369,51.5%,13.37%,1
桃園市,大溪區,0557,203,475,678,65,743,1446,51.38%,14.04%,1
桃園市,大溪區,0558,141,430,571,45,616,1406,43.81%,10.03%,1
桃園市,大溪區,0559,244,591,835,27,862,1592,54.15%,15.33%,1
桃園市,大溪區,0560,248,543,791,62,853,1497,56.98%,16.57%,1
桃園市,大溪區,0561,271,563,834,54,888,1559,56.96%,17.38%,1
桃園市,大溪區,0562,264,569,833,23,856,1684,50.83%,15.68%,1
桃園市,大溪區,0563,312,699,1011,73,1084,1959,55.33%,15.93%,1
桃園市,大溪區,0564,218,503,721,63,784,1369,57.27%,15.92%,1
桃園市,大溪區,0565,248,506,754,49,803,1431,56.11%,17.33%,1
桃園市,大溪區,0566,185,457,642,27,669,1657,40.37%,11.16%,1
桃園市,大溪區,0567,190,390,580,29,609,1387,43.91%,13.7%,1
桃園市,大溪區,0568,183,349,532,37,569,1085,52.44%,16.87%,1
桃園市,大溪區,0569,244,509,753,51,804,1403,57.31%,17.39%,1
桃園市,大溪區,0570,240,480,720,64,784,1511,51.89%,15.88%,1
桃園市,大溪區,0571,260,457,717,81,798,1719,46.42%,15.13%,1
桃園市,大溪區,0572,202,506,708,84,792,1717,46.13%,11.76%,1
桃園市,大溪區,0573,192,398,590,62,652,1207,54.02%,15.91%,1
桃園市,大溪區,0574,164,447,611,63,674,1188,56.73%,13.8%,1
桃園市,大溪區,0575,235,472,707,25,732,1514,48.35%,15.52%,1
桃園市,大溪區,0576,247,535,782,74,856,1529,55.98%,16.15%,1
桃園市,大溪區,0577,211,495,706,37,743,1260,58.97%,16.75%,1
桃園市,大溪區,0578,139,327,466,15,481,831,57.88%,16.73%,1
桃園市,大溪區,0579,229,505,734,49,783,1407,55.65%,16.28%,1
桃園市,大溪區,0580,217,481,698,47,745,1494,49.87%,14.52%,1
桃園市,楊梅區,0926,187,468,655,53,708,1269,55.79%,14.74%,1
桃園市,楊梅區,0927,190,537,727,43,770,1246,61.8%,15.25%,1
桃園市,楊梅區,0928,218,563,781,40,821,1408,58.31%,15.48%,1
桃園市,楊梅區,0929,225,536,761,45,806,1434,56.21%,15.69%,1
桃園市,楊梅區,0930,208,525,733,53,786,1515,51.88%,13.73%,1
桃園市,楊梅區,0931,206,562,768,46,814,1657,49.12%,12.43%,1
桃園市,楊梅區,0932,165,461,626,34,660,1137,58.05%,14.51%,1
桃園市,楊梅區,0933,323,742,1065,38,1103,2211,49.89%,14.61%,1
桃園市,楊梅區,0934,298,692,990,23,1013,2008,50.45%,14.84%,1
桃園市,楊梅區,0935,318,657,975,29,1004,1911,52.54%,16.64%,1
桃園市,楊梅區,0936,244,524,768,49,817,1449,56.38%,16.84%,1
桃園市,楊梅區,0937,267,551,818,48,866,1877,46.14%,14.22%,1
桃園市,楊梅區,0938,271,655,926,32,958,1988,48.19%,13.63%,1
桃園市,楊梅區,0939,315,751,1066,29,1095,1931,56.71%,16.31%,1
桃園市,楊梅區,0940,356,650,1006,48,1054,1938,54.39%,18.37%,1
桃園市,楊梅區,0941,246,615,861,22,883,1677,52.65%,14.67%,1
桃園市,楊梅區,0942,286,614,900,13,913,1848,49.4%,15.48%,1
桃園市,楊梅區,0943,316,636,952,26,978,1882,51.97%,16.79%,1
桃園市,楊梅區,0944,195,417,612,18,630,1541,40.88%,12.65%,1
桃園市,楊梅區,0945,281,624,905,40,945,1938,48.76%,14.5%,1
桃園市,楊梅區,0946,214,500,714,12,726,1562,46.48%,13.7%,1
桃園市,楊梅區,0947,432,714,1146,33,1179,2125,55.48%,20.33%,1
桃園市,楊梅區,0948,137,720,857,31,888,1516,58.58%,9.04%,1
桃園市,楊梅區,0949,248,623,871,28,899,1807,49.75%,13.72%,1
桃園市,楊梅區,0950,316,657,973,28,1001,2101,47.64%,15.04%,1
桃園市,楊梅區,0951,339,669,1008,42,1050,2054,51.12%,16.5%,1
桃園市,楊梅區,0952,304,714,1018,17,1035,2226,46.5%,13.66%,1
桃園市,楊梅區,0953,222,533,755,12,767,1405,54.59%,15.8%,1
桃園市,楊梅區,0954,294,556,850,27,877,1843,47.59%,15.95%,1
桃園市,楊梅區,0955,296,695,991,40,1031,2324,44.36%,12.74%,1
桃園市,楊梅區,0956,291,606,897,24,921,1713,53.77%,16.99%,1
桃園市,楊梅區,0957,233,598,831,52,883,1587,55.64%,14.68%,1
桃園市,楊梅區,0958,251,535,786,22,808,1416,57.06%,17.73%,1
桃園市,楊梅區,0959,248,606,854,18,872,1591,54.81%,15.59%,1
桃園市,楊梅區,0960,275,684,959,44,1003,1943,51.62%,14.15%,1
桃園市,楊梅區,0961,281,630,911,34,945,1762,53.63%,15.95%,1
桃園市,楊梅區,0962,167,395,562,27,589,1083,54.39%,15.42%,1
桃園市,楊梅區,0963,287,711,998,54,1052,2027,51.9%,14.16%,1
桃園市,楊梅區,0964,468,206,674,55,729,1274,57.22%,36.73%,1
桃園市,楊梅區,0965,201,536,737,47,784,1359,57.69%,14.79%,1
桃園市,楊梅區,0966,288,549,837,29,866,2444,35.43%,11.78%,1
桃園市,楊梅區,0967,258,738,996,34,1030,2298,44.82%,11.23%,1
桃園市,楊梅區,0968,292,763,1055,38,1093,2222,49.19%,13.14%,1
桃園市,楊梅區,0969,251,529,780,73,853,1610,52.98%,15.59%,1
桃園市,楊梅區,0970,250,545,795,72,867,1627,53.29%,15.37%,1
桃園市,楊梅區,0971,309,509,818,50,868,1589,54.63%,19.45%,1
桃園市,楊梅區,0972,271,611,882,55,937,1758,53.3%,15.42%,1
桃園市,楊梅區,0973,227,503,730,50,780,1776,43.92%,12.78%,1
桃園市,楊梅區,0974,159,311,470,23,493,1000,49.3%,15.9%,1
桃園市,楊梅區,0975,281,693,974,68,1042,2290,45.5%,12.27%,1
桃園市,楊梅區,0976,228,532,760,53,813,1551,52.42%,14.7%,1
桃園市,楊梅區,0977,270,610,880,53,933,1861,50.13%,14.51%,1
桃園市,楊梅區,0978,155,325,480,59,539,1141,47.24%,13.58%,1
桃園市,楊梅區,0979,222,597,819,45,864,1785,48.4%,12.44%,1
桃園市,楊梅區,0980,204,534,738,62,800,1498,53.4%,13.62%,1
桃園市,楊梅區,0981,177,386,563,61,624,1187,52.57%,14.91%,1
桃園市,楊梅區,0982,211,447,658,50,708,1270,55.75%,16.61%,1
桃園市,楊梅區,0983,205,508,713,33,746,1424,52.39%,14.4%,1
桃園市,楊梅區,0984,245,510,755,19,774,1273,60.8%,19.25%,1
桃園市,楊梅區,0985,229,451,680,31,711,1534,46.35%,14.93%,1
桃園市,楊梅區,0986,240,526,766,55,821,1783,46.05%,13.46%,1
桃園市,楊梅區,0987,225,579,804,18,822,1709,48.1%,13.17%,1
桃園市,楊梅區,0988,743,75,818,67,885,1920,46.09%,38.7%,1
桃園市,楊梅區,0989,193,426,619,29,648,1194,54.27%,16.16%,1
桃園市,楊梅區,0990,223,530,753,19,772,1408,54.83%,15.84%,1
桃園市,楊梅區,0991,220,531,751,27,778,1737,44.79%,12.67%,1
桃園市,楊梅區,0992,260,676,936,20,956,1920,49.79%,13.54%,1
桃園市,楊梅區,0993,209,404,613,33,646,1234,52.35%,16.94%,1
桃園市,楊梅區,0994,231,548,779,51,830,1491,55.67%,15.49%,1
桃園市,楊梅區,0995,282,631,913,39,952,2020,47.13%,13.96%,1
桃園市,楊梅區,0996,288,547,835,29,864,1863,46.38%,15.46%,1
桃園市,楊梅區,0997,246,620,866,45,911,1692,53.84%,14.54%,1
桃園市,楊梅區,0998,273,568,841,28,869,1686,51.54%,16.19%,1
桃園市,楊梅區,0999,269,551,820,68,888,1626,54.61%,16.54%,1
桃園市,楊梅區,1000,259,575,834,27,861,1557,55.3%,16.63%,1
桃園市,楊梅區,1001,286,586,872,55,927,1603,57.83%,17.84%,1
桃園市,楊梅區,1002,270,598,868,62,930,1889,49.23%,14.29%,1
桃園市,楊梅區,1003,220,648,868,30,898,1448,62.02%,15.19%,1
桃園市,楊梅區,1004,196,525,721,42,763,1351,56.48%,14.51%,1
桃園市,楊梅區,1005,212,505,717,46,763,1313,58.11%,16.15%,1
桃園市,楊梅區,1006,236,597,833,49,882,1689,52.22%,13.97%,1
桃園市,楊梅區,1007,278,668,946,34,980,2063,47.5%,13.48%,1
桃園市,蘆竹區,0396,206,426,632,79,711,1358,52.36%,15.17%,1
桃園市,蘆竹區,0397,216,492,708,68,776,1538,50.46%,14.04%,1
桃園市,蘆竹區,0398,214,598,812,51,863,2118,40.75%,10.1%,1
桃園市,蘆竹區,0399,284,595,879,61,940,1673,56.19%,16.98%,1
桃園市,蘆竹區,0400,263,512,775,28,803,1500,53.53%,17.53%,1
桃園市,蘆竹區,0401,282,581,863,41,904,1699,53.21%,16.6%,1
桃園市,蘆竹區,0402,352,758,1110,38,1148,2250,51.02%,15.64%,1
桃園市,蘆竹區,0403,383,653,1036,20,1056,2354,44.86%,16.27%,1
桃園市,蘆竹區,0404,212,448,660,27,687,1446,47.51%,14.66%,1
桃園市,蘆竹區,0405,253,456,709,53,762,1623,46.95%,15.59%,1
桃園市,蘆竹區,0406,285,529,814,33,847,1747,48.48%,16.31%,1
桃園市,蘆竹區,0407,310,658,968,55,1023,1988,51.46%,15.59%,1
桃園市,蘆竹區,0408,249,467,716,38,754,1437,52.47%,17.33%,1
桃園市,蘆竹區,0409,261,548,809,58,867,1532,56.59%,17.04%,1
桃園市,蘆竹區,0410,102,570,672,41,713,1447,49.27%,7.05%,1
桃園市,蘆竹區,0411,713,335,1048,53,1101,2189,50.3%,32.57%,1
桃園市,蘆竹區,0412,335,783,1118,48,1166,2498,46.68%,13.41%,1
桃園市,蘆竹區,0413,226,457,683,38,721,1322,54.54%,17.1%,1
桃園市,蘆竹區,0414,265,521,786,65,851,1991,42.74%,13.31%,1
桃園市,蘆竹區,0415,330,588,918,74,992,2097,47.31%,15.74%,1
桃園市,蘆竹區,0416,290,509,799,49,848,1558,54.43%,18.61%,1
桃園市,蘆竹區,0417,352,607,959,33,992,1891,52.46%,18.61%,1
桃園市,蘆竹區,0418,255,479,734,39,773,1590,48.62%,16.04%,1
桃園市,蘆竹區,0419,343,695,1038,45,1083,2404,45.05%,14.27%,1
桃園市,蘆竹區,0420,401,803,1204,46,1250,2522,49.56%,15.9%,1
桃園市,蘆竹區,0421,269,555,824,20,844,1633,51.68%,16.47%,1
桃園市,蘆竹區,0422,299,558,857,30,887,1715,51.72%,17.43%,1
桃園市,蘆竹區,0423,333,678,1011,23,1034,2215,46.68%,15.03%,1
桃園市,蘆竹區,0424,340,606,946,35,981,2029,48.35%,16.76%,1
桃園市,蘆竹區,0425,268,547,815,27,842,1731,48.64%,15.48%,1
桃園市,蘆竹區,0426,306,592,898,31,929,1820,51.04%,16.81%,1
桃園市,蘆竹區,0427,293,551,844,38,882,1633,54.01%,17.94%,1
桃園市,蘆竹區,0428,231,501,732,20,752,1668,45.08%,13.85%,1
桃園市,蘆竹區,0429,290,496,786,28,814,1493,54.52%,19.42%,1
桃園市,蘆竹區,0430,296,633,929,48,977,1864,52.41%,15.88%,1
桃園市,蘆竹區,0431,293,518,811,23,834,1703,48.97%,17.2%,1
桃園市,蘆竹區,0432,318,603,921,33,954,1893,50.4%,16.8%,1
桃園市,蘆竹區,0433,366,657,1023,34,1057,1922,54.99%,19.04%,1
桃園市,蘆竹區,0434,225,500,725,22,747,1393,53.63%,16.15%,1
桃園市,蘆竹區,0435,235,477,712,25,737,1338,55.08%,17.56%,1
桃園市,蘆竹區,0436,268,558,826,27,853,1688,50.53%,15.88%,1
桃園市,蘆竹區,0437,243,446,689,62,751,1462,51.37%,16.62%,1
桃園市,蘆竹區,0438,184,439,623,29,652,1232,52.92%,14.94%,1
桃園市,蘆竹區,0439,197,431,628,23,651,1356,48.01%,14.53%,1
桃園市,蘆竹區,0440,227,458,685,33,718,1181,60.8%,19.22%,1
桃園市,蘆竹區,0441,190,392,582,24,606,1199,50.54%,15.85%,1
桃園市,蘆竹區,0442,313,569,882,31,913,1710,53.39%,18.3%,1
桃園市,蘆竹區,0443,247,439,686,28,714,1423,50.18%,17.36%,1
桃園市,蘆竹區,0444,318,479,797,19,816,1522,53.61%,20.89%,1
桃園市,蘆竹區,0445,685,161,846,35,881,1639,53.75%,41.79%,1
桃園市,蘆竹區,0446,346,643,989,40,1029,2055,50.07%,16.84%,1
桃園市,蘆竹區,0447,409,665,1074,25,1099,2178,50.46%,18.78%,1
桃園市,蘆竹區,0448,335,554,889,29,918,1709,53.72%,19.6%,1
桃園市,蘆竹區,0449,292,581,873,43,916,1667,54.95%,17.52%,1
桃園市,蘆竹區,0450,319,597,916,30,946,1745,54.21%,18.28%,1
桃園市,蘆竹區,0451,362,680,1042,33,1075,1967,54.65%,18.4%,1
桃園市,蘆竹區,0452,330,652,982,24,1006,1802,55.83%,18.31%,1
桃園市,蘆竹區,0453,430,847,1277,38,1315,2727,48.22%,15.77%,1
桃園市,蘆竹區,0454,324,523,847,34,881,1868,47.16%,17.34%,1
桃園市,蘆竹區,0455,272,461,733,50,783,1537,50.94%,17.7%,1
桃園市,蘆竹區,0456,308,504,812,34,846,1616,52.35%,19.06%,1
桃園市,蘆竹區,0457,279,542,821,33,854,1483,57.59%,18.81%,1
桃園市,蘆竹區,0458,281,511,792,51,843,1689,49.91%,16.64%,1
桃園市,蘆竹區,0459,173,350,523,42,565,1318,42.87%,13.13%,1
桃園市,蘆竹區,0460,193,494,687,86,773,1203,64.26%,16.04%,1
桃園市,蘆竹區,0461,248,537,785,38,823,1771,46.47%,14%,1
桃園市,蘆竹區,0462,257,528,785,72,857,1832,46.78%,14.03%,1
桃園市,蘆竹區,0463,267,532,799,91,890,1763,50.48%,15.14%,1
桃園市,蘆竹區,0464,231,386,617,20,637,1497,42.55%,15.43%,1
桃園市,蘆竹區,0465,267,614,881,115,996,1671,59.61%,15.98%,1
桃園市,蘆竹區,0466,163,319,482,56,538,929,57.91%,17.55%,1
桃園市,蘆竹區,0467,251,540,791,88,879,1559,56.38%,16.1%,1
桃園市,蘆竹區,0468,228,539,767,25,792,1497,52.91%,15.23%,1
桃園市,蘆竹區,0469,245,608,853,59,912,1441,63.29%,17%,1
桃園市,蘆竹區,0470,211,492,703,51,754,1465,51.47%,14.4%,1
桃園市,蘆竹區,0471,150,352,502,32,534,1029,51.9%,14.58%,1
桃園市,大園區,0472,229,438,667,39,706,1538,45.9%,14.89%,1
桃園市,大園區,0473,203,429,632,31,663,1616,41.03%,12.56%,1
桃園市,大園區,0474,267,495,762,48,810,1437,56.37%,18.58%,1
桃園市,大園區,0475,248,569,817,34,851,1554,54.76%,15.96%,1
桃園市,大園區,0476,214,391,605,40,645,1237,52.14%,17.3%,1
桃園市,大園區,0477,211,435,646,52,698,1347,51.82%,15.66%,1
桃園市,大園區,0478,226,398,624,23,647,1261,51.31%,17.92%,1
桃園市,大園區,0479,212,388,600,39,639,1256,50.88%,16.88%,1
桃園市,大園區,0480,281,344,625,21,646,1370,47.15%,20.51%,1
桃園市,大園區,0481,207,503,710,35,745,1610,46.27%,12.86%,1
桃園市,大園區,0482,197,480,677,37,714,1419,50.32%,13.88%,1
桃園市,大園區,0483,204,428,632,20,652,1588,41.06%,12.85%,1
桃園市,大園區,0484,265,505,770,44,814,1612,50.5%,16.44%,1
桃園市,大園區,0485,221,452,673,45,718,1440,49.86%,15.35%,1
桃園市,大園區,0486,211,401,612,35,647,1326,48.79%,15.91%,1
桃園市,大園區,0487,241,520,761,57,818,1455,56.22%,16.56%,1
桃園市,大園區,0488,260,529,789,51,840,1562,53.78%,16.65%,1
桃園市,大園區,0489,231,465,696,31,727,1284,56.62%,17.99%,1
桃園市,大園區,0490,258,418,676,17,693,1454,47.66%,17.74%,1
桃園市,大園區,0491,285,454,739,20,759,1490,50.94%,19.13%,1
桃園市,大園區,0492,234,482,716,33,749,1617,46.32%,14.47%,1
桃園市,大園區,0493,250,505,755,73,828,1594,51.94%,15.68%,1
桃園市,大園區,0494,229,557,786,58,844,1650,51.15%,13.88%,1
桃園市,大園區,0495,208,467,675,20,695,1467,47.38%,14.18%,1
桃園市,大園區,0496,232,489,721,29,750,1494,50.2%,15.53%,1
桃園市,大園區,0497,246,480,726,48,774,1538,50.33%,15.99%,1
桃園市,大園區,0498,214,459,673,24,697,1397,49.89%,15.32%,1
桃園市,大園區,0499,243,512,755,28,783,1637,47.83%,14.84%,1
桃園市,大園區,0500,206,448,654,44,698,1452,48.07%,14.19%,1
桃園市,大園區,0501,240,556,796,45,841,1414,59.48%,16.97%,1
桃園市,大園區,0502,245,573,818,34,852,1670,51.02%,14.67%,1
桃園市,大園區,0503,269,497,766,18,784,1701,46.09%,15.81%,1
桃園市,大園區,0504,230,518,748,31,779,1813,42.97%,12.69%,1
桃園市,大園區,0505,252,519,771,35,806,1687,47.78%,14.94%,1
桃園市,大園區,0506,284,554,838,10,848,1650,51.39%,17.21%,1
桃園市,大園區,0507,313,533,846,39,885,1556,56.88%,20.12%,1
桃園市,大園區,0508,273,522,795,30,825,1844,44.74%,14.8%,1
桃園市,大園區,0509,191,403,594,59,653,1336,48.88%,14.3%,1
桃園市,大園區,0510,232,495,727,58,785,1414,55.52%,16.41%,1
桃園市,大園區,0511,221,474,695,47,742,1238,59.94%,17.85%,1
桃園市,大園區,0512,118,596,714,30,744,1227,60.64%,9.62%,1
桃園市,大園區,0513,207,373,580,24,604,1199,50.38%,17.26%,1
桃園市,大園區,0514,174,422,596,32,628,1349,46.55%,12.9%,1
桃園市,大園區,0515,184,362,546,29,575,1120,51.34%,16.43%,1
桃園市,大園區,0516,173,368,541,27,568,1080,52.59%,16.02%,1
桃園市,大園區,0517,194,433,627,32,659,1341,49.14%,14.47%,1
桃園市,大園區,0518,223,459,682,28,710,1345,52.79%,16.58%,1
桃園市,大園區,0519,203,461,664,45,709,1565,45.3%,12.97%,1
桃園市,大園區,0520,215,424,639,20,659,1519,43.38%,14.15%,1
桃園市,大園區,0521,270,661,931,49,980,2130,46.01%,12.68%,1
桃園市,龜山區,0217,131,329,460,25,485,874,55.49%,14.99%,1
桃園市,龜山區,0218,275,734,1009,65,1074,2014,53.33%,13.65%,1
桃園市,龜山區,0219,393,635,1028,22,1050,2145,48.95%,18.32%,1
桃園市,龜山區,0220,216,686,902,43,945,1744,54.19%,12.39%,1
桃園市,龜山區,0221,251,706,957,60,1017,1885,53.95%,13.32%,1
桃園市,龜山區,0222,248,457,705,46,751,1546,48.58%,16.04%,1
桃園市,龜山區,0223,300,478,778,55,833,1684,49.47%,17.81%,1
桃園市,龜山區,0224,128,509,637,40,677,1477,45.84%,8.67%,1
桃園市,龜山區,0225,266,548,814,42,856,1528,56.02%,17.41%,1
桃園市,龜山區,0226,95,180,275,16,291,1428,20.38%,6.65%,1
桃園市,龜山區,0227,246,507,753,47,800,1525,52.46%,16.13%,1
桃園市,龜山區,0228,201,363,564,45,609,1041,58.5%,19.31%,1
桃園市,龜山區,0229,239,422,661,35,696,1404,49.57%,17.02%,1
桃園市,龜山區,0230,258,514,772,45,817,1478,55.28%,17.46%,1
桃園市,龜山區,0231,336,731,1067,61,1128,2178,51.79%,15.43%,1
桃園市,龜山區,0232,299,543,842,64,906,1672,54.19%,17.88%,1
桃園市,龜山區,0233,102,454,556,28,584,1376,42.44%,7.41%,1
桃園市,龜山區,0234,245,467,712,41,753,1480,50.88%,16.55%,1
桃園市,龜山區,0235,250,410,660,36,696,1258,55.33%,19.87%,1
桃園市,龜山區,0236,248,477,725,24,749,1464,51.16%,16.94%,1
桃園市,龜山區,0237,318,550,868,73,941,1844,51.03%,17.25%,1
桃園市,龜山區,0238,228,361,589,21,610,1169,52.18%,19.5%,1
桃園市,龜山區,0239,240,490,730,40,770,1921,40.08%,12.49%,1
桃園市,龜山區,0240,261,519,780,34,814,1694,48.05%,15.41%,1
桃園市,龜山區,0241,335,600,935,48,983,1771,55.51%,18.92%,1
桃園市,龜山區,0242,258,485,743,49,792,1665,47.57%,15.5%,1
桃園市,龜山區,0243,251,434,685,52,737,1439,51.22%,17.44%,1
桃園市,龜山區,0244,236,500,736,59,795,1728,46.01%,13.66%,1
桃園市,龜山區,0245,306,576,882,41,923,1788,51.62%,17.11%,1
桃園市,龜山區,0246,208,449,657,46,703,1465,47.99%,14.2%,1
桃園市,龜山區,0247,311,442,753,46,799,1659,48.16%,18.75%,1
桃園市,龜山區,0248,278,430,708,27,735,1693,43.41%,16.42%,1
桃園市,龜山區,0249,263,423,686,20,706,1818,38.83%,14.47%,1
桃園市,龜山區,0250,272,556,828,62,890,1752,50.8%,15.53%,1
桃園市,龜山區,0251,341,531,872,17,889,1818,48.9%,18.76%,1
桃園市,龜山區,0252,257,472,729,23,752,1499,50.17%,17.14%,1
桃園市,龜山區,0253,350,570,920,50,970,1916,50.63%,18.27%,1
桃園市,龜山區,0254,327,563,890,36,926,1804,51.33%,18.13%,1
桃園市,龜山區,0255,375,610,985,27,1012,2127,47.58%,17.63%,1
桃園市,龜山區,0256,165,311,476,56,532,1005,52.94%,16.42%,1
桃園市,龜山區,0257,256,473,729,39,768,1449,53%,17.67%,1
桃園市,龜山區,0258,246,423,669,57,726,1498,48.46%,16.42%,1
桃園市,龜山區,0259,305,594,899,51,950,2149,44.21%,14.19%,1
桃園市,龜山區,0260,241,405,646,42,688,1771,38.85%,13.61%,1
桃園市,龜山區,0261,145,274,419,25,444,841,52.79%,17.24%,1
桃園市,龜山區,0262,404,587,991,55,1046,2284,45.8%,17.69%,1
桃園市,龜山區,0263,200,407,607,44,651,1228,53.01%,16.29%,1
桃園市,龜山區,0264,268,601,869,48,917,1979,46.34%,13.54%,1
桃園市,龜山區,0265,173,433,606,38,644,1378,46.73%,12.55%,1
桃園市,龜山區,0266,163,321,484,48,532,1061,50.14%,15.36%,1
桃園市,龜山區,0267,290,575,865,54,919,1917,47.94%,15.13%,1
桃園市,龜山區,0268,307,568,875,26,901,1540,58.51%,19.94%,1
桃園市,龜山區,0269,239,509,748,28,776,1433,54.15%,16.68%,1
桃園市,龜山區,0270,266,459,725,21,746,1455,51.27%,18.28%,1
桃園市,龜山區,0271,410,755,1165,58,1223,2280,53.64%,17.98%,1
桃園市,龜山區,0272,347,534,881,38,919,1668,55.1%,20.8%,1
桃園市,龜山區,0273,321,566,887,41,928,1885,49.23%,17.03%,1
桃園市,龜山區,0274,432,459,891,16,907,1849,49.05%,23.36%,1
桃園市,龜山區,0275,462,470,932,16,948,1704,55.63%,27.11%,1
桃園市,龜山區,0276,208,375,583,38,621,1156,53.72%,17.99%,1
桃園市,龜山區,0277,298,532,830,48,878,2114,41.53%,14.1%,1
桃園市,龜山區,0278,313,483,796,42,838,1943,43.13%,16.11%,1
桃園市,龜山區,0279,312,495,807,26,833,1800,46.28%,17.33%,1
桃園市,龜山區,0280,384,552,936,41,977,2020,48.37%,19.01%,1
桃園市,龜山區,0281,275,426,701,28,729,1319,55.27%,20.85%,1
桃園市,龜山區,0282,436,712,1148,36,1184,2229,53.12%,19.56%,1
桃園市,龜山區,0283,354,582,936,30,966,1992,48.49%,17.77%,1
桃園市,龜山區,0284,382,633,1015,41,1056,2237,47.21%,17.08%,1
桃園市,龜山區,0285,411,584,995,25,1020,2133,47.82%,19.27%,1
桃園市,龜山區,0286,423,647,1070,37,1107,2187,50.62%,19.34%,1
桃園市,龜山區,0287,340,567,907,42,949,1959,48.44%,17.36%,1
桃園市,龜山區,0288,338,518,856,22,878,1910,45.97%,17.7%,1
桃園市,龜山區,0289,721,173,894,84,978,1840,53.15%,39.18%,1
桃園市,龜山區,0290,352,743,1095,37,1132,2266,49.96%,15.53%,1
桃園市,龜山區,0291,344,711,1055,21,1076,2387,45.08%,14.41%,1
桃園市,龜山區,0292,278,520,798,19,817,1692,48.29%,16.43%,1
桃園市,龜山區,0293,178,275,453,13,466,904,51.55%,19.69%,1
桃園市,龜山區,0294,290,480,770,15,785,1469,53.44%,19.74%,1
桃園市,八德區,0295,250,508,758,70,828,1761,47.02%,14.2%,1
桃園市,八德區,0296,267,452,719,11,730,1804,40.47%,14.8%,1
桃園市,八德區,0297,188,312,500,14,514,1813,28.35%,10.37%,1
桃園市,八德區,0298,285,516,801,24,825,1784,46.24%,15.98%,1
桃園市,八德區,0299,302,641,943,24,967,2257,42.84%,13.38%,1
桃園市,八德區,0300,233,527,760,33,793,1857,42.7%,12.55%,1
桃園市,八德區,0301,299,643,942,34,976,2261,43.17%,13.22%,1
桃園市,八德區,0302,319,620,939,50,989,1903,51.97%,16.76%,1
桃園市,八德區,0303,283,631,914,69,983,1955,50.28%,14.48%,1
桃園市,八德區,0304,264,454,718,21,739,1665,44.38%,15.86%,1
桃園市,八德區,0305,265,464,729,54,783,1431,54.72%,18.52%,1
桃園市,八德區,0306,198,457,655,38,693,1263,54.87%,15.68%,1
桃園市,八德區,0307,275,561,836,48,884,1583,55.84%,17.37%,1
桃園市,八德區,0308,191,456,647,37,684,1246,54.9%,15.33%,1
桃園市,八德區,0309,224,469,693,36,729,1356,53.76%,16.52%,1
桃園市,八德區,0310,267,577,844,59,903,1630,55.4%,16.38%,1
桃園市,八德區,0311,228,502,730,53,783,1586,49.37%,14.38%,1
桃園市,八德區,0312,245,564,809,63,872,1649,52.88%,14.86%,1
桃園市,八德區,0313,250,566,816,78,894,1910,46.81%,13.09%,1
桃園市,八德區,0314,224,605,829,72,901,1612,55.89%,13.9%,1
桃園市,八德區,0315,248,553,801,53,854,1640,52.07%,15.12%,1
桃園市,八德區,0316,217,404,621,39,660,1303,50.65%,16.65%,1
桃園市,八德區,0317,271,500,771,45,816,1413,57.75%,19.18%,1
桃園市,八德區,0318,267,561,828,44,872,1711,50.96%,15.6%,1
桃園市,八德區,0319,236,530,766,80,846,1562,54.16%,15.11%,1
桃園市,八德區,0320,253,584,837,47,884,1735,50.95%,14.58%,1
桃園市,八德區,0321,275,545,820,28,848,1658,51.15%,16.59%,1
桃園市,八德區,0322,173,391,564,49,613,1022,59.98%,16.93%,1
桃園市,八德區,0323,241,478,719,46,765,1673,45.73%,14.41%,1
桃園市,八德區,0324,269,558,827,32,859,1741,49.34%,15.45%,1
桃園市,八德區,0325,307,701,1008,60,1068,2110,50.62%,14.55%,1
桃園市,八德區,0326,153,436,589,29,618,1145,53.97%,13.36%,1
桃園市,八德區,0327,150,400,550,38,588,1010,58.22%,14.85%,1
桃園市,八德區,0328,271,521,792,29,821,1848,44.43%,14.66%,1
桃園市,八德區,0329,223,474,697,29,726,1334,54.42%,16.72%,1
桃園市,八德區,0330,198,375,573,15,588,1349,43.59%,14.68%,1
桃園市,八德區,0331,255,470,725,31,756,1341,56.38%,19.02%,1
桃園市,八德區,0332,196,441,637,39,676,1178,57.39%,16.64%,1
桃園市,八德區,0333,247,462,709,39,748,1374,54.44%,17.98%,1
桃園市,八德區,0334,239,453,692,50,742,1462,50.75%,16.35%,1
桃園市,八德區,0335,237,555,792,68,860,1943,44.26%,12.2%,1
桃園市,八德區,0336,274,429,703,58,761,1928,39.47%,14.21%,1
桃園市,八德區,0337,233,439,672,29,701,1403,49.96%,16.61%,1
桃園市,八德區,0338,256,492,748,54,802,1672,47.97%,15.31%,1
桃園市,八德區,0339,313,554,867,40,907,1947,46.58%,16.08%,1
桃園市,八德區,0340,209,403,612,47,659,1200,54.92%,17.42%,1
桃園市,八德區,0341,270,556,826,61,887,1895,46.81%,14.25%,1
桃園市,八德區,0342,304,551,855,60,915,1988,46.03%,15.29%,1
桃園市,八德區,0343,336,647,983,66,1049,2006,52.29%,16.75%,1
桃園市,八德區,0344,306,603,909,10,919,2061,44.59%,14.85%,1
桃園市,八德區,0345,282,624,906,67,973,2108,46.16%,13.38%,1
桃園市,八德區,0346,263,560,823,55,878,1862,47.15%,14.12%,1
桃園市,八德區,0347,267,526,793,25,818,1681,48.66%,15.88%,1
桃園市,八德區,0348,219,457,676,57,733,1317,55.66%,16.63%,1
桃園市,八德區,0349,403,717,1120,45,1165,2093,55.66%,19.25%,1
桃園市,八德區,0350,261,539,800,53,853,1499,56.9%,17.41%,1
桃園市,八德區,0351,273,581,854,52,906,1782,50.84%,15.32%,1
桃園市,八德區,0352,293,576,869,32,901,1763,51.11%,16.62%,1
桃園市,八德區,0353,209,408,617,51,668,1226,54.49%,17.05%,1
桃園市,八德區,0354,267,426,693,28,721,1311,55%,20.37%,1
桃園市,八德區,0355,224,401,625,40,665,1170,56.84%,19.15%,1
桃園市,八德區,0356,212,472,684,34,718,1313,54.68%,16.15%,1
桃園市,八德區,0357,211,417,628,26,654,1186,55.14%,17.79%,1
桃園市,八德區,0358,243,434,677,47,724,1481,48.89%,16.41%,1
桃園市,八德區,0359,331,635,966,63,1029,1998,51.5%,16.57%,1
桃園市,八德區,0360,156,329,485,34,519,916,56.66%,17.03%,1
桃園市,八德區,0361,281,600,881,46,927,1943,47.71%,14.46%,1
桃園市,八德區,0362,288,668,956,29,985,2076,47.45%,13.87%,1
桃園市,八德區,0363,217,463,680,52,732,1363,53.71%,15.92%,1
桃園市,八德區,0364,234,502,736,56,792,1491,53.12%,15.69%,1
桃園市,八德區,0365,221,476,697,65,762,1474,51.7%,14.99%,1
桃園市,八德區,0366,30,130,160,15,175,718,24.37%,4.18%,1
桃園市,八德區,0367,216,468,684,48,732,1386,52.81%,15.58%,1
桃園市,八德區,0368,219,478,697,77,774,1487,52.05%,14.73%,1
桃園市,八德區,0369,212,502,714,76,790,1552,50.9%,13.66%,1
桃園市,八德區,0370,156,407,563,56,619,1255,49.32%,12.43%,1
桃園市,八德區,0371,292,471,763,48,811,1505,53.89%,19.4%,1
桃園市,八德區,0372,214,441,655,46,701,1436,48.82%,14.9%,1
桃園市,八德區,0373,304,515,819,59,878,1618,54.26%,18.79%,1
桃園市,八德區,0374,247,553,800,55,855,1685,50.74%,14.66%,1
桃園市,八德區,0375,297,508,805,46,851,1835,46.38%,16.19%,1
桃園市,八德區,0376,286,607,893,54,947,1881,50.35%,15.2%,1
桃園市,八德區,0377,271,561,832,32,864,1766,48.92%,15.35%,1
桃園市,八德區,0378,260,589,849,78,927,1817,51.02%,14.31%,1
桃園市,八德區,0379,362,740,1102,26,1128,2198,51.32%,16.47%,1
桃園市,八德區,0380,312,560,872,40,912,1732,52.66%,18.01%,1
桃園市,八德區,0381,389,769,1158,19,1177,2089,56.34%,18.62%,1
桃園市,八德區,0382,228,443,671,34,705,1257,56.09%,18.14%,1
桃園市,八德區,0383,232,381,613,43,656,1267,51.78%,18.31%,1
桃園市,八德區,0384,267,495,762,15,777,1427,54.45%,18.71%,1
桃園市,八德區,0385,311,603,914,56,970,1685,57.57%,18.46%,1
桃園市,八德區,0386,320,576,896,50,946,1748,54.12%,18.31%,1
桃園市,八德區,0387,311,795,1106,34,1140,1650,69.09%,18.85%,1
桃園市,八德區,0388,269,482,751,50,801,1478,54.19%,18.2%,1
桃園市,八德區,0389,240,569,809,39,848,1607,52.77%,14.93%,1
桃園市,八德區,0390,319,648,967,56,1023,1841,55.57%,17.33%,1
桃園市,八德區,0391,368,652,1020,47,1067,2082,51.25%,17.68%,1
桃園市,八德區,0392,470,379,849,56,905,1959,46.2%,23.99%,1
桃園市,八德區,0393,369,696,1065,45,1110,2209,50.25%,16.7%,1
桃園市,八德區,0394,313,624,937,36,973,1864,52.2%,16.79%,1
桃園市,八德區,0395,323,606,929,45,974,2000,48.7%,16.15%,1
桃園市,龍潭區,1008,199,536,735,28,763,1482,51.48%,13.43%,1
桃園市,龍潭區,1009,247,486,733,38,771,1528,50.46%,16.16%,1
桃園市,龍潭區,1010,231,517,748,45,793,1503,52.76%,15.37%,1
桃園市,龍潭區,1011,234,514,748,46,794,1568,50.64%,14.92%,1
桃園市,龍潭區,1012,168,404,572,59,631,1216,51.89%,13.82%,1
桃園市,龍潭區,1013,297,576,873,76,949,2088,45.45%,14.22%,1
桃園市,龍潭區,1014,290,752,1042,75,1117,1987,56.22%,14.59%,1
桃園市,龍潭區,1015,352,526,878,41,919,1586,57.94%,22.19%,1
桃園市,龍潭區,1016,195,400,595,32,627,1221,51.35%,15.97%,1
桃園市,龍潭區,1017,170,438,608,42,650,1134,57.32%,14.99%,1
桃園市,龍潭區,1018,262,677,939,56,995,2081,47.81%,12.59%,1
桃園市,龍潭區,1019,257,620,877,37,914,1925,47.48%,13.35%,1
桃園市,龍潭區,1020,331,776,1107,27,1134,2095,54.13%,15.8%,1
桃園市,龍潭區,1021,347,774,1121,43,1164,2040,57.06%,17.01%,1
桃園市,龍潭區,1022,267,561,828,54,882,1790,49.27%,14.92%,1
桃園市,龍潭區,1023,292,651,943,75,1018,1872,54.38%,15.6%,1
桃園市,龍潭區,1024,280,627,907,65,972,1726,56.32%,16.22%,1
桃園市,龍潭區,1025,251,664,915,53,968,1792,54.02%,14.01%,1
桃園市,龍潭區,1026,220,505,725,33,758,1398,54.22%,15.74%,1
桃園市,龍潭區,1027,186,474,660,31,691,1345,51.38%,13.83%,1
桃園市,龍潭區,1028,231,502,733,39,772,1409,54.79%,16.39%,1
桃園市,龍潭區,1029,233,416,649,16,665,1362,48.83%,17.11%,1
桃園市,龍潭區,1030,294,595,889,45,934,1650,56.61%,17.82%,1
桃園市,龍潭區,1031,232,548,780,51,831,1597,52.04%,14.53%,1
桃園市,龍潭區,1032,228,492,720,27,747,1410,52.98%,16.17%,1
桃園市,龍潭區,1033,209,462,671,36,707,1275,55.45%,16.39%,1
桃園市,龍潭區,1034,337,715,1052,60,1112,1909,58.25%,17.65%,1
桃園市,龍潭區,1035,298,761,1059,46,1105,2024,54.59%,14.72%,1
桃園市,龍潭區,1036,297,729,1026,52,1078,2002,53.85%,14.84%,1
桃園市,龍潭區,1037,301,683,984,32,1016,1786,56.89%,16.85%,1
桃園市,龍潭區,1038,292,571,863,37,900,1756,51.25%,16.63%,1
桃園市,龍潭區,1039,291,703,994,28,1022,1830,55.85%,15.9%,1
桃園市,龍潭區,1040,288,674,962,35,997,1697,58.75%,16.97%,1
桃園市,龍潭區,1041,220,596,816,31,847,1519,55.76%,14.48%,1
桃園市,龍潭區,1042,246,594,840,52,892,1805,49.42%,13.63%,1
桃園市,龍潭區,1043,222,553,775,34,809,1792,45.15%,12.39%,1
桃園市,龍潭區,1044,208,612,820,61,881,1500,58.73%,13.87%,1
桃園市,龍潭區,1045,216,463,679,36,715,1427,50.11%,15.14%,1
桃園市,龍潭區,1046,195,431,626,35,661,1444,45.78%,13.5%,1
桃園市,龍潭區,1047,184,445,629,43,672,1321,50.87%,13.93%,1
桃園市,龍潭區,1048,208,485,693,35,728,1215,59.92%,17.12%,1
桃園市,龍潭區,1049,174,466,640,54,694,1297,53.51%,13.42%,1
桃園市,龍潭區,1050,198,477,675,15,690,1407,49.04%,14.07%,1
桃園市,龍潭區,1051,230,499,729,40,769,1564,49.17%,14.71%,1
桃園市,龍潭區,1052,173,469,642,58,700,1317,53.15%,13.14%,1
桃園市,龍潭區,1053,126,343,469,39,508,1023,49.66%,12.32%,1
桃園市,龍潭區,1054,250,641,891,45,936,1721,54.39%,14.53%,1
桃園市,龍潭區,1055,259,674,933,45,978,1764,55.44%,14.68%,1
桃園市,龍潭區,1056,210,560,770,53,823,1499,54.9%,14.01%,1
桃園市,龍潭區,1057,276,689,965,48,1013,2151,47.09%,12.83%,1
桃園市,龍潭區,1058,236,603,839,23,862,1524,56.56%,15.49%,1
桃園市,龍潭區,1059,262,588,850,22,872,1456,59.89%,17.99%,1
桃園市,龍潭區,1060,276,804,1080,28,1108,1847,59.99%,14.94%,1
桃園市,龍潭區,1061,281,843,1124,21,1145,1899,60.29%,14.8%,1
桃園市,龍潭區,1062,249,651,900,37,937,1725,54.32%,14.43%,1
桃園市,龍潭區,1063,267,699,966,46,1012,1665,60.78%,16.04%,1
桃園市,龍潭區,1064,254,540,794,36,830,1649,50.33%,15.4%,1
桃園市,龍潭區,1065,202,500,702,46,748,1539,48.6%,13.13%,1
桃園市,龍潭區,1066,263,575,838,48,886,1541,57.5%,17.07%,1
桃園市,龍潭區,1067,242,472,714,40,754,1375,54.84%,17.6%,1
桃園市,龍潭區,1068,239,510,749,30,779,1453,53.61%,16.45%,1
桃園市,龍潭區,1069,188,378,566,43,609,1074,56.7%,17.5%,1
桃園市,龍潭區,1070,252,491,743,16,759,1299,58.43%,19.4%,1
桃園市,龍潭區,1071,105,210,315,15,330,678,48.67%,15.49%,1
桃園市,平鎮區,0801,228,485,713,46,759,1487,51.04%,15.33%,1
桃園市,平鎮區,0802,213,508,721,43,764,1453,52.58%,14.66%,1
桃園市,平鎮區,0803,238,533,771,39,810,1491,54.33%,15.96%,1
桃園市,平鎮區,0804,214,446,660,44,704,1346,52.3%,15.9%,1
桃園市,平鎮區,0805,252,573,825,25,850,1660,51.2%,15.18%,1
桃園市,平鎮區,0806,419,502,921,30,951,1921,49.51%,21.81%,1
桃園市,平鎮區,0807,310,720,1030,38,1068,1974,54.1%,15.7%,1
桃園市,平鎮區,0808,274,615,889,47,936,1867,50.13%,14.68%,1
桃園市,平鎮區,0809,257,645,902,29,931,1786,52.13%,14.39%,1
桃園市,平鎮區,0810,195,463,658,30,688,1634,42.11%,11.93%,1
桃園市,平鎮區,0811,170,409,579,26,605,1080,56.02%,15.74%,1
桃園市,平鎮區,0812,242,529,771,29,800,1514,52.84%,15.98%,1
桃園市,平鎮區,0813,268,574,842,41,883,1918,46.04%,13.97%,1
桃園市,平鎮區,0814,175,406,581,78,659,1182,55.75%,14.81%,1
桃園市,平鎮區,0815,233,543,776,29,805,1667,48.29%,13.98%,1
桃園市,平鎮區,0816,228,502,730,32,762,1640,46.46%,13.9%,1
桃園市,平鎮區,0817,253,549,802,24,826,1603,51.53%,15.78%,1
桃園市,平鎮區,0818,236,620,856,18,874,1556,56.17%,15.17%,1
桃園市,平鎮區,0819,239,586,825,30,855,1697,50.38%,14.08%,1
桃園市,平鎮區,0820,154,405,559,13,572,1130,50.62%,13.63%,1
桃園市,平鎮區,0821,185,438,623,25,648,1196,54.18%,15.47%,1
桃園市,平鎮區,0822,255,600,855,31,886,1685,52.58%,15.13%,1
桃園市,平鎮區,0823,255,576,831,30,861,1532,56.2%,16.64%,1
桃園市,平鎮區,0824,238,550,788,35,823,1564,52.62%,15.22%,1
桃園市,平鎮區,0825,203,545,748,43,791,1824,43.37%,11.13%,1
桃園市,平鎮區,0826,289,632,921,28,949,1912,49.63%,15.12%,1
桃園市,平鎮區,0827,143,376,519,48,567,1048,54.1%,13.65%,1
桃園市,平鎮區,0828,198,465,663,39,702,1259,55.76%,15.73%,1
桃園市,平鎮區,0829,158,384,542,23,565,1061,53.25%,14.89%,1
桃園市,平鎮區,0830,160,452,612,28,640,1072,59.7%,14.93%,1
桃園市,平鎮區,0831,254,625,879,48,927,1788,51.85%,14.21%,1
桃園市,平鎮區,0832,221,544,765,33,798,1510,52.85%,14.64%,1
桃園市,平鎮區,0833,213,487,700,41,741,1403,52.82%,15.18%,1
桃園市,平鎮區,0834,220,495,715,50,765,1407,54.37%,15.64%,1
桃園市,平鎮區,0835,415,561,976,40,1016,1901,53.45%,21.83%,1
桃園市,平鎮區,0836,272,622,894,16,910,1994,45.64%,13.64%,1
桃園市,平鎮區,0837,288,582,870,36,906,1730,52.37%,16.65%,1
桃園市,平鎮區,0838,343,635,978,32,1010,1905,53.02%,18.01%,1
桃園市,平鎮區,0839,303,625,928,17,945,1723,54.85%,17.59%,1
桃園市,平鎮區,0840,200,483,683,47,730,1307,55.85%,15.3%,1
桃園市,平鎮區,0841,229,491,720,31,751,1337,56.17%,17.13%,1
桃園市,平鎮區,0842,211,404,615,24,639,980,65.2%,21.53%,1
桃園市,平鎮區,0843,293,594,887,48,935,1818,51.43%,16.12%,1
桃園市,平鎮區,0844,275,501,776,31,807,1463,55.16%,18.8%,1
桃園市,平鎮區,0845,231,453,684,29,713,1213,58.78%,19.04%,1
桃園市,平鎮區,0846,203,407,610,25,635,1085,58.53%,18.71%,1
桃園市,平鎮區,0847,182,528,710,28,738,1458,50.62%,12.48%,1
桃園市,平鎮區,0848,209,521,730,52,782,1408,55.54%,14.84%,1
桃園市,平鎮區,0849,228,449,677,41,718,1396,51.43%,16.33%,1
桃園市,平鎮區,0850,234,412,646,24,670,1044,64.18%,22.41%,1
桃園市,平鎮區,0851,217,397,614,16,630,1124,56.05%,19.31%,1
桃園市,平鎮區,0852,288,518,806,21,827,1517,54.52%,18.98%,1
桃園市,平鎮區,0853,306,512,818,16,834,1571,53.09%,19.48%,1
桃園市,平鎮區,0854,330,630,960,30,990,1752,56.51%,18.84%,1
桃園市,平鎮區,0855,280,556,836,33,869,1434,60.6%,19.53%,1
桃園市,平鎮區,0856,335,623,958,28,986,1710,57.66%,19.59%,1
桃園市,平鎮區,0857,291,561,852,26,878,1555,56.46%,18.71%,1
桃園市,平鎮區,0858,324,625,949,33,982,2051,47.88%,15.8%,1
桃園市,平鎮區,0859,265,502,767,20,787,1477,53.28%,17.94%,1
桃園市,平鎮區,0860,254,536,790,22,812,1501,54.1%,16.92%,1
桃園市,平鎮區,0861,248,488,736,47,783,1405,55.73%,17.65%,1
桃園市,平鎮區,0862,252,569,821,52,873,1656,52.72%,15.22%,1
桃園市,平鎮區,0863,304,565,869,25,894,1921,46.54%,15.83%,1
桃園市,平鎮區,0864,254,561,815,23,838,1717,48.81%,14.79%,1
桃園市,平鎮區,0865,240,446,686,35,721,1319,54.66%,18.2%,1
桃園市,平鎮區,0866,302,570,872,34,906,1745,51.92%,17.31%,1
桃園市,平鎮區,0867,296,609,905,38,943,1721,54.79%,17.2%,1
桃園市,平鎮區,0868,220,430,650,22,672,1206,55.72%,18.24%,1
桃園市,平鎮區,0869,280,485,765,18,783,1202,65.14%,23.29%,1
桃園市,平鎮區,0870,209,463,672,33,705,1208,58.36%,17.3%,1
桃園市,平鎮區,0871,226,513,739,15,754,1267,59.51%,17.84%,1
桃園市,平鎮區,0872,197,393,590,20,610,1094,55.76%,18.01%,1
桃園市,平鎮區,0873,276,503,779,42,821,1394,58.9%,19.8%,1
桃園市,平鎮區,0874,285,452,737,13,750,1215,61.73%,23.46%,1
桃園市,平鎮區,0875,189,363,552,33,585,1010,57.92%,18.71%,1
桃園市,平鎮區,0876,228,468,696,24,720,1261,57.1%,18.08%,1
桃園市,平鎮區,0877,214,536,750,26,776,1314,59.06%,16.29%,1
桃園市,平鎮區,0878,122,265,387,34,421,722,58.31%,16.9%,1
桃園市,平鎮區,0879,151,276,427,21,448,839,53.4%,18%,1
桃園市,平鎮區,0880,240,505,745,28,773,1399,55.25%,17.16%,1
桃園市,平鎮區,0881,353,595,948,43,991,1968,50.36%,17.94%,1
桃園市,平鎮區,0882,276,591,867,30,897,1672,53.65%,16.51%,1
桃園市,平鎮區,0883,205,421,626,26,652,2213,29.46%,9.26%,1
桃園市,平鎮區,0884,215,362,577,16,593,949,62.49%,22.66%,1
桃園市,平鎮區,0885,336,601,937,30,967,1621,59.65%,20.73%,1
桃園市,平鎮區,0886,293,522,815,15,830,1643,50.52%,17.83%,1
桃園市,平鎮區,0887,360,620,980,32,1012,1844,54.88%,19.52%,1
桃園市,平鎮區,0888,316,600,916,32,948,1752,54.11%,18.04%,1
桃園市,平鎮區,0889,249,506,755,35,790,1577,50.1%,15.79%,1
桃園市,平鎮區,0890,266,558,824,25,849,1517,55.97%,17.53%,1
桃園市,平鎮區,0891,192,399,591,23,614,1039,59.1%,18.48%,1
桃園市,平鎮區,0892,226,519,745,32,777,1318,58.95%,17.15%,1
桃園市,平鎮區,0893,244,590,834,42,876,1636,53.55%,14.91%,1
桃園市,平鎮區,0894,243,471,714,31,745,1316,56.61%,18.47%,1
桃園市,平鎮區,0895,241,563,804,16,820,1474,55.63%,16.35%,1
桃園市,平鎮區,0896,206,463,669,47,716,1480,48.38%,13.92%,1
桃園市,平鎮區,0897,205,491,696,19,715,1330,53.76%,15.41%,1
桃園市,平鎮區,0898,196,455,651,30,681,1228,55.46%,15.96%,1
桃園市,平鎮區,0899,280,504,784,30,814,1377,59.11%,20.33%,1
桃園市,平鎮區,0900,234,472,706,25,731,1198,61.02%,19.53%,1
桃園市,平鎮區,0901,218,503,721,30,751,1231,61.01%,17.71%,1
桃園市,平鎮區,0902,225,425,650,64,714,1243,57.44%,18.1%,1
桃園市,平鎮區,0903,243,539,782,59,841,1590,52.89%,15.28%,1
桃園市,平鎮區,0904,210,490,700,37,737,1366,53.95%,15.37%,1
桃園市,平鎮區,0905,198,486,684,37,721,1332,54.13%,14.86%,1
桃園市,平鎮區,0906,169,392,561,20,581,1201,48.38%,14.07%,1
桃園市,平鎮區,0907,235,515,750,29,779,1668,46.7%,14.09%,1
桃園市,平鎮區,0908,190,462,652,52,704,1351,52.11%,14.06%,1
桃園市,平鎮區,0909,183,492,675,27,702,1460,48.08%,12.53%,1
桃園市,平鎮區,0910,259,634,893,31,924,1841,50.19%,14.07%,1
桃園市,平鎮區,0911,234,469,703,16,719,1475,48.75%,15.86%,1
桃園市,平鎮區,0912,154,383,537,22,559,1011,55.29%,15.23%,1
桃園市,平鎮區,0913,142,337,479,38,517,1052,49.14%,13.5%,1
桃園市,平鎮區,0914,216,441,657,49,706,1154,61.18%,18.72%,1
桃園市,平鎮區,0915,251,551,802,21,823,1645,50.03%,15.26%,1
桃園市,平鎮區,0916,216,479,695,79,774,1539,50.29%,14.04%,1
桃園市,平鎮區,0917,216,487,703,49,752,1385,54.3%,15.6%,1
桃園市,平鎮區,0918,210,506,716,29,745,1395,53.41%,15.05%,1
桃園市,平鎮區,0919,225,620,845,28,873,1711,51.02%,13.15%,1
桃園市,平鎮區,0920,234,560,794,42,836,1631,51.26%,14.35%,1
桃園市,平鎮區,0921,203,396,599,19,618,1110,55.68%,18.29%,1
桃園市,平鎮區,0922,259,762,1021,38,1059,1931,54.84%,13.41%,1
桃園市,平鎮區,0923,180,408,588,35,623,1127,55.28%,15.97%,1
桃園市,平鎮區,0924,204,527,731,48,779,1414,55.09%,14.43%,1
桃園市,平鎮區,0925,230,597,827,26,853,1609,53.01%,14.29%,1
桃園市,新屋區,1072,232,519,751,22,773,1306,59.19%,17.76%,1
桃園市,新屋區,1073,269,548,817,43,860,1556,55.27%,17.29%,1
桃園市,新屋區,1074,213,747,960,56,1016,1849,54.95%,11.52%,1
桃園市,新屋區,1075,383,778,1161,63,1224,2096,58.4%,18.27%,1
桃園市,新屋區,1076,211,533,744,54,798,1517,52.6%,13.91%,1
桃園市,新屋區,1077,339,782,1121,63,1184,2095,56.52%,16.18%,1
桃園市,新屋區,1078,265,551,816,47,863,1856,46.5%,14.28%,1
桃園市,新屋區,1079,306,744,1050,44,1094,1986,55.09%,15.41%,1
桃園市,新屋區,1080,188,451,639,64,703,1425,49.33%,13.19%,1
桃園市,新屋區,1081,192,461,653,30,683,1385,49.31%,13.86%,1
桃園市,新屋區,1082,239,493,732,49,781,1271,61.45%,18.8%,1
桃園市,新屋區,1083,192,454,646,36,682,1271,53.66%,15.11%,1
桃園市,新屋區,1084,211,457,668,40,708,1234,57.37%,17.1%,1
桃園市,新屋區,1085,188,367,555,52,607,1085,55.94%,17.33%,1
桃園市,新屋區,1086,317,779,1096,42,1138,1992,57.13%,15.91%,1
桃園市,新屋區,1087,340,777,1117,75,1192,2032,58.66%,16.73%,1
桃園市,新屋區,1088,197,455,652,57,709,1291,54.92%,15.26%,1
桃園市,新屋區,1089,202,484,686,38,724,1401,51.68%,14.42%,1
桃園市,新屋區,1090,163,440,603,44,647,1106,58.5%,14.74%,1
桃園市,新屋區,1091,147,322,469,17,486,908,53.52%,16.19%,1
桃園市,新屋區,1092,122,255,377,31,408,663,61.54%,18.4%,1
桃園市,新屋區,1093,152,389,541,47,588,1088,54.04%,13.97%,1
桃園市,新屋區,1094,168,437,605,63,668,1050,63.62%,16%,1
桃園市,新屋區,1095,131,364,495,25,520,896,58.04%,14.62%,1
桃園市,新屋區,1096,230,538,768,52,820,1369,59.9%,16.8%,1
桃園市,新屋區,1097,121,333,454,47,501,995,50.35%,12.16%,1
桃園市,新屋區,1098,112,285,397,29,426,741,57.49%,15.11%,1
桃園市,新屋區,1099,174,354,528,54,582,943,61.72%,18.45%,1
桃園市,新屋區,1100,203,586,789,83,872,1714,50.88%,11.84%,1
桃園市,新屋區,1101,201,519,720,27,747,1340,55.75%,15%,1
桃園市,觀音區,1102,196,432,628,40,668,1371,48.72%,14.3%,1
桃園市,觀音區,1103,186,374,560,26,586,1362,43.02%,13.66%,1
桃園市,觀音區,1104,167,306,473,61,534,997,53.56%,16.75%,1
桃園市,觀音區,1105,199,438,637,34,671,1407,47.69%,14.14%,1
桃園市,觀音區,1106,283,581,864,31,895,1692,52.9%,16.73%,1
桃園市,觀音區,1107,179,455,634,32,666,1279,52.07%,14%,1
桃園市,觀音區,1108,132,270,402,13,415,791,52.47%,16.69%,1
桃園市,觀音區,1109,149,329,478,28,506,892,56.73%,16.7%,1
桃園市,觀音區,1110,140,363,503,29,532,886,60.05%,15.8%,1
桃園市,觀音區,1111,111,247,358,39,397,712,55.76%,15.59%,1
桃園市,觀音區,1112,230,507,737,76,813,1609,50.53%,14.29%,1
桃園市,觀音區,1113,213,440,653,52,705,1274,55.34%,16.72%,1
桃園市,觀音區,1114,174,393,567,30,597,1351,44.19%,12.88%,1
桃園市,觀音區,1115,239,445,684,43,727,1262,57.61%,18.94%,1
桃園市,觀音區,1116,210,449,659,48,707,1242,56.92%,16.91%,1
桃園市,觀音區,1117,252,469,721,51,772,1461,52.84%,17.25%,1
桃園市,觀音區,1118,289,510,799,39,838,1613,51.95%,17.92%,1
桃園市,觀音區,1119,231,539,770,44,814,1479,55.04%,15.62%,1
桃園市,觀音區,1120,223,450,673,62,735,1552,47.36%,14.37%,1
桃園市,觀音區,1121,251,483,734,30,764,1517,50.36%,16.55%,1
桃園市,觀音區,1122,274,517,791,45,836,1691,49.44%,16.2%,1
桃園市,觀音區,1123,219,422,641,13,654,1157,56.53%,18.93%,1
桃園市,觀音區,1124,228,473,701,47,748,1455,51.41%,15.67%,1
桃園市,觀音區,1125,169,410,579,30,609,1150,52.96%,14.7%,1
桃園市,觀音區,1126,187,390,577,49,626,1112,56.29%,16.82%,1
桃園市,觀音區,1127,180,422,602,18,620,1251,49.56%,14.39%,1
桃園市,觀音區,1128,222,488,710,70,780,1446,53.94%,15.35%,1
桃園市,觀音區,1129,247,441,688,102,790,1493,52.91%,16.54%,1
桃園市,觀音區,1130,213,425,638,67,705,1339,52.65%,15.91%,1
桃園市,觀音區,1131,197,432,629,39,668,1137,58.75%,17.33%,1
桃園市,觀音區,1132,142,349,491,38,529,1043,50.72%,13.61%,1
桃園市,觀音區,1133,159,276,435,28,463,993,46.63%,16.01%,1
桃園市,觀音區,1134,156,312,468,26,494,975,50.67%,16%,1
桃園市,觀音區,1135,282,500,782,37,819,2029,40.36%,13.9%,1
桃園市,觀音區,1136,294,628,922,41,963,1765,54.56%,16.66%,1
桃園市,觀音區,1137,287,599,886,34,920,1809,50.86%,15.87%,1
桃園市,觀音區,1138,245,625,870,34,904,1869,48.37%,13.11%,1
桃園市,觀音區,1139,241,514,755,55,810,1870,43.32%,12.89%,1
桃園市,觀音區,1140,226,422,648,41,689,1932,35.66%,11.7%,1
桃園市,觀音區,1141,114,270,384,10,394,899,43.83%,12.68%,1
桃園市,觀音區,1142,139,275,414,15,429,985,43.55%,14.11%,1
桃園市,復興區,0581,210,824,1034,82,1116,1991,56.05%,10.55%,1
桃園市,復興區,0582,142,606,748,52,800,1392,57.47%,10.2%,1
桃園市,復興區,0583,67,229,296,18,314,564,55.67%,11.88%,1
桃園市,復興區,0584,82,290,372,18,390,716,54.47%,11.45%,1
桃園市,復興區,0585,134,466,600,44,644,1016,63.39%,13.19%,1
桃園市,復興區,0586,90,202,292,14,306,669,45.74%,13.45%,1
桃園市,復興區,0587,72,300,372,13,385,760,50.66%,9.47%,1
桃園市,復興區,0588,57,343,400,16,416,751,55.39%,7.59%,1
桃園市,復興區,0589,41,218,259,6,265,683,38.8%,6%,1
桃園市,復興區,0590,89,563,652,31,683,1224,55.8%,7.27%,1
臺中市,中區,1070,344,602,946,79,1025,1652,62.05%,20.82%,1
臺中市,中區,1071,222,551,773,47,820,1531,53.56%,14.5%,1
臺中市,中區,1072,215,568,783,27,810,1431,56.6%,15.02%,1
臺中市,中區,1073,171,406,577,39,616,1060,58.11%,16.13%,1
臺中市,中區,1074,161,357,518,34,552,982,56.21%,16.4%,1
臺中市,中區,1075,224,412,636,50,686,1191,57.6%,18.81%,1
臺中市,中區,1076,171,286,457,36,493,855,57.66%,20%,1
臺中市,中區,1077,161,354,515,28,543,1135,47.84%,14.19%,1
臺中市,中區,1078,110,298,408,16,424,705,60.14%,15.6%,1
臺中市,中區,1079,184,395,579,32,611,1009,60.56%,18.24%,1
臺中市,中區,1080,232,430,662,66,728,1304,55.83%,17.79%,1
臺中市,中區,1081,292,609,901,31,932,1841,50.62%,15.86%,1
臺中市,東區,1148,168,264,432,17,449,1138,39.46%,14.76%,1
臺中市,東區,1149,184,376,560,19,579,984,58.84%,18.7%,1
臺中市,東區,1150,155,339,494,28,522,877,59.52%,17.67%,1
臺中市,東區,1151,223,407,630,39,669,1070,62.52%,20.84%,1
臺中市,東區,1152,213,426,639,48,687,1106,62.12%,19.26%,1
臺中市,東區,1153,165,360,525,53,578,953,60.65%,17.31%,1
臺中市,東區,1154,220,479,699,34,733,1195,61.34%,18.41%,1
臺中市,東區,1155,211,469,680,33,713,1251,56.99%,16.87%,1
臺中市,東區,1156,223,435,658,49,707,1190,59.41%,18.74%,1
臺中市,東區,1157,255,482,737,56,793,1394,56.89%,18.29%,1
臺中市,東區,1158,285,547,832,61,893,1443,61.88%,19.75%,1
臺中市,東區,1159,121,297,418,36,454,762,59.58%,15.88%,1
臺中市,東區,1160,234,462,696,37,733,1140,64.3%,20.53%,1
臺中市,東區,1161,218,462,680,70,750,1211,61.93%,18%,1
臺中市,東區,1162,161,293,454,29,483,755,63.97%,21.32%,1
臺中市,東區,1163,261,518,779,63,842,1491,56.47%,17.51%,1
臺中市,東區,1164,162,372,534,21,555,1000,55.5%,16.2%,1
臺中市,東區,1165,225,409,634,48,682,1114,61.22%,20.2%,1
臺中市,東區,1166,199,408,607,33,640,1101,58.13%,18.07%,1
臺中市,東區,1167,234,478,712,49,761,1169,65.1%,20.02%,1
臺中市,東區,1168,235,505,740,73,813,1283,63.37%,18.32%,1
臺中市,東區,1169,229,480,709,32,741,1168,63.44%,19.61%,1
臺中市,東區,1170,248,485,733,38,771,1386,55.63%,17.89%,1
臺中市,東區,1171,345,536,881,43,924,1557,59.34%,22.16%,1
臺中市,東區,1172,264,490,754,58,812,1380,58.84%,19.13%,1
臺中市,東區,1173,328,609,937,58,995,1674,59.44%,19.59%,1
臺中市,東區,1174,349,611,960,40,1000,1604,62.34%,21.76%,1
臺中市,東區,1175,377,665,1042,52,1094,1815,60.28%,20.77%,1
臺中市,東區,1176,298,609,907,55,962,1700,56.59%,17.53%,1
臺中市,東區,1177,280,567,847,58,905,1592,56.85%,17.59%,1
臺中市,東區,1178,328,615,943,62,1005,1850,54.32%,17.73%,1
臺中市,東區,1179,208,521,729,32,761,1252,60.78%,16.61%,1
臺中市,東區,1180,275,473,748,48,796,1250,63.68%,22%,1
臺中市,東區,1181,213,502,715,36,751,1241,60.52%,17.16%,1
臺中市,東區,1182,246,422,668,42,710,1318,53.87%,18.66%,1
臺中市,東區,1183,213,464,677,65,742,1288,57.61%,16.54%,1
臺中市,東區,1184,267,580,847,55,902,1442,62.55%,18.52%,1
臺中市,東區,1185,215,455,670,50,720,1202,59.9%,17.89%,1
臺中市,東區,1186,230,572,802,54,856,1452,58.95%,15.84%,1
臺中市,東區,1187,264,540,804,39,843,1480,56.96%,17.84%,1
臺中市,東區,1188,259,710,969,31,1000,1736,57.6%,14.92%,1
臺中市,東區,1189,151,307,458,34,492,867,56.75%,17.42%,1
臺中市,東區,1190,242,606,848,42,890,1693,52.57%,14.29%,1
臺中市,東區,1191,282,599,881,70,951,1538,61.83%,18.34%,1
臺中市,東區,1192,315,594,909,101,1010,1593,63.4%,19.77%,1
臺中市,東區,1193,265,519,784,25,809,1481,54.63%,17.89%,1
臺中市,東區,1194,287,541,828,45,873,1414,61.74%,20.3%,1
臺中市,東區,1195,251,479,730,30,760,1297,58.6%,19.35%,1
臺中市,東區,1196,248,535,783,48,831,1394,59.61%,17.79%,1
臺中市,南區,1197,177,361,538,35,573,937,61.15%,18.89%,1
臺中市,南區,1198,206,412,618,40,658,1001,65.73%,20.58%,1
臺中市,南區,1199,262,507,769,52,821,1249,65.73%,20.98%,1
臺中市,南區,1200,256,530,786,33,819,1202,68.14%,21.3%,1
臺中市,南區,1201,237,418,655,67,722,1130,63.89%,20.97%,1
臺中市,南區,1202,220,507,727,57,784,1239,63.28%,17.76%,1
臺中市,南區,1203,240,450,690,42,732,1238,59.13%,19.39%,1
臺中市,南區,1204,254,481,735,54,789,1272,62.03%,19.97%,1
臺中市,南區,1205,251,476,727,45,772,1273,60.64%,19.72%,1
臺中市,南區,1206,267,468,735,72,807,1317,61.28%,20.27%,1
臺中市,南區,1207,278,485,763,33,796,1160,68.62%,23.97%,1
臺中市,南區,1208,290,447,737,54,791,1205,65.64%,24.07%,1
臺中市,南區,1209,254,399,653,39,692,1111,62.29%,22.86%,1
臺中市,南區,1210,338,515,853,48,901,1407,64.04%,24.02%,1
臺中市,南區,1211,279,538,817,39,856,1419,60.32%,19.66%,1
臺中市,南區,1212,237,458,695,44,739,1157,63.87%,20.48%,1
臺中市,南區,1213,273,515,788,40,828,1415,58.52%,19.29%,1
臺中市,南區,1214,263,539,802,49,851,1289,66.02%,20.4%,1
臺中市,南區,1215,290,547,837,36,873,1454,60.04%,19.94%,1
臺中市,南區,1216,276,548,824,43,867,1491,58.15%,18.51%,1
臺中市,南區,1217,286,524,810,25,835,1394,59.9%,20.52%,1
臺中市,南區,1218,306,499,805,56,861,1430,60.21%,21.4%,1
臺中市,南區,1219,267,474,741,101,842,1342,62.74%,19.9%,1
臺中市,南區,1220,272,532,804,78,882,1304,67.64%,20.86%,1
臺中市,南區,1221,258,471,729,37,766,1190,64.37%,21.68%,1
臺中市,南區,1222,203,500,703,52,755,1273,59.31%,15.95%,1
臺中市,南區,1223,296,558,854,51,905,1387,65.25%,21.34%,1
臺中市,南區,1224,292,494,786,33,819,1356,60.4%,21.53%,1
臺中市,南區,1225,267,506,773,50,823,1304,63.11%,20.48%,1
臺中市,南區,1226,269,519,788,30,818,1256,65.13%,21.42%,1
臺中市,南區,1227,327,506,833,32,865,1364,63.42%,23.97%,1
臺中市,南區,1228,288,491,779,71,850,1361,62.45%,21.16%,1
臺中市,南區,1229,291,557,848,27,875,1407,62.19%,20.68%,1
臺中市,南區,1230,218,525,743,55,798,1308,61.01%,16.67%,1
臺中市,南區,1231,257,451,708,36,744,1250,59.52%,20.56%,1
臺中市,南區,1232,269,449,718,24,742,1284,57.79%,20.95%,1
臺中市,南區,1233,253,434,687,62,749,1175,63.74%,21.53%,1
臺中市,南區,1234,221,506,727,41,768,1158,66.32%,19.08%,1
臺中市,南區,1235,258,422,680,38,718,1168,61.47%,22.09%,1
臺中市,南區,1236,326,666,992,47,1039,1626,63.9%,20.05%,1
臺中市,南區,1237,326,547,873,24,897,2115,42.41%,15.41%,1
臺中市,南區,1238,338,644,982,26,1008,1805,55.84%,18.73%,1
臺中市,南區,1239,317,614,931,25,956,1695,56.4%,18.7%,1
臺中市,南區,1240,344,675,1019,31,1050,1643,63.91%,20.94%,1
臺中市,南區,1241,304,540,844,49,893,1423,62.75%,21.36%,1
臺中市,南區,1242,292,583,875,46,921,1542,59.73%,18.94%,1
臺中市,南區,1243,337,568,905,24,929,1533,60.6%,21.98%,1
臺中市,南區,1244,345,586,931,56,987,1531,64.47%,22.53%,1
臺中市,南區,1245,219,505,724,46,770,1392,55.32%,15.73%,1
臺中市,南區,1246,317,560,877,42,919,1592,57.73%,19.91%,1
臺中市,南區,1247,311,537,848,47,895,1431,62.54%,21.73%,1
臺中市,南區,1248,307,626,933,49,982,1799,54.59%,17.07%,1
臺中市,南區,1249,331,698,1029,59,1088,1708,63.7%,19.38%,1
臺中市,南區,1250,305,606,911,60,971,1700,57.12%,17.94%,1
臺中市,南區,1251,322,740,1062,30,1092,1751,62.36%,18.39%,1
臺中市,南區,1252,447,755,1202,64,1266,2109,60.03%,21.19%,1
臺中市,南區,1253,334,618,952,64,1016,1697,59.87%,19.68%,1
臺中市,南區,1254,322,503,825,39,864,1456,59.34%,22.12%,1
臺中市,南區,1255,388,714,1102,47,1149,1726,66.57%,22.48%,1
臺中市,南區,1256,352,674,1026,48,1074,1723,62.33%,20.43%,1
臺中市,南區,1257,337,595,932,43,975,1569,62.14%,21.48%,1
臺中市,南區,1258,260,489,749,55,804,1274,63.11%,20.41%,1
臺中市,南區,1259,287,599,886,35,921,1390,66.26%,20.65%,1
臺中市,南區,1260,262,561,823,27,850,1295,65.64%,20.23%,1
臺中市,南區,1261,234,522,756,49,805,1312,61.36%,17.84%,1
臺中市,南區,1262,287,584,871,33,904,1417,63.8%,20.25%,1
臺中市,南區,1263,278,543,821,35,856,1230,69.59%,22.6%,1
臺中市,南區,1264,242,484,726,60,786,1308,60.09%,18.5%,1
臺中市,南區,1265,276,543,819,64,883,1467,60.19%,18.81%,1
臺中市,南區,1266,306,518,824,33,857,1399,61.26%,21.87%,1
臺中市,南區,1267,212,457,669,64,733,1207,60.73%,17.56%,1
臺中市,南區,1268,248,500,748,26,774,1317,58.77%,18.83%,1
臺中市,南區,1269,342,547,889,29,918,1563,58.73%,21.88%,1
臺中市,南區,1270,274,472,746,24,770,1221,63.06%,22.44%,1
臺中市,西區,1082,154,332,486,33,519,1400,37.07%,11%,1
臺中市,西區,1083,177,360,537,29,566,861,65.74%,20.56%,1
臺中市,西區,1084,306,523,829,35,864,1416,61.02%,21.61%,1
臺中市,西區,1085,221,383,604,38,642,1020,62.94%,21.67%,1
臺中市,西區,1086,175,315,490,23,513,778,65.94%,22.49%,1
臺中市,西區,1087,258,544,802,40,842,1465,57.47%,17.61%,1
臺中市,西區,1088,174,408,582,20,602,1017,59.19%,17.11%,1
臺中市,西區,1089,188,316,504,26,530,868,61.06%,21.66%,1
臺中市,西區,1090,281,486,767,44,811,1251,64.83%,22.46%,1
臺中市,西區,1091,245,409,654,34,688,1044,65.9%,23.47%,1
臺中市,西區,1092,312,512,824,38,862,1487,57.97%,20.98%,1
臺中市,西區,1093,338,548,886,42,928,1573,59%,21.49%,1
臺中市,西區,1094,360,646,1006,43,1049,1731,60.6%,20.8%,1
臺中市,西區,1095,219,496,715,28,743,1209,61.46%,18.11%,1
臺中市,西區,1096,296,568,864,40,904,1564,57.8%,18.93%,1
臺中市,西區,1097,264,446,710,26,736,1175,62.64%,22.47%,1
臺中市,西區,1098,333,502,835,32,867,1505,57.61%,22.13%,1
臺中市,西區,1099,291,541,832,34,866,1418,61.07%,20.52%,1
臺中市,西區,1100,213,458,671,3,674,1497,45.02%,14.23%,1
臺中市,西區,1101,279,450,729,40,769,1260,61.03%,22.14%,1
臺中市,西區,1102,292,515,807,43,850,1399,60.76%,20.87%,1
臺中市,西區,1103,290,499,789,46,835,1447,57.71%,20.04%,1
臺中市,西區,1104,349,594,943,41,984,1683,58.47%,20.74%,1
臺中市,西區,1105,337,578,915,47,962,1585,60.69%,21.26%,1
臺中市,西區,1106,393,535,928,31,959,1557,61.59%,25.24%,1
臺中市,西區,1107,292,562,854,54,908,1663,54.6%,17.56%,1
臺中市,西區,1108,433,644,1077,48,1125,1921,58.56%,22.54%,1
臺中市,西區,1109,377,639,1016,34,1050,1952,53.79%,19.31%,1
臺中市,西區,1110,348,587,935,34,969,1708,56.73%,20.37%,1
臺中市,西區,1111,273,432,705,22,727,1131,64.28%,24.14%,1
臺中市,西區,1112,378,654,1032,37,1069,1916,55.79%,19.73%,1
臺中市,西區,1113,266,490,756,25,781,1275,61.25%,20.86%,1
臺中市,西區,1114,298,615,913,51,964,1822,52.91%,16.36%,1
臺中市,西區,1115,287,477,764,43,807,1374,58.73%,20.89%,1
臺中市,西區,1116,209,375,584,71,655,1129,58.02%,18.51%,1
臺中市,西區,1117,222,419,641,34,675,1201,56.2%,18.48%,1
臺中市,西區,1118,290,595,885,54,939,1639,57.29%,17.69%,1
臺中市,西區,1119,390,645,1035,55,1090,1863,58.51%,20.93%,1
臺中市,西區,1120,239,539,778,49,827,1287,64.26%,18.57%,1
臺中市,西區,1121,331,546,877,45,922,1504,61.3%,22.01%,1
臺中市,西區,1122,268,466,734,32,766,1308,58.56%,20.49%,1
臺中市,西區,1123,273,515,788,54,842,1433,58.76%,19.05%,1
臺中市,西區,1124,294,493,787,37,824,1450,56.83%,20.28%,1
臺中市,西區,1125,331,540,871,50,921,1465,62.87%,22.59%,1
臺中市,西區,1126,314,628,942,52,994,1818,54.68%,17.27%,1
臺中市,西區,1127,348,636,984,52,1036,1782,58.14%,19.53%,1
臺中市,西區,1128,307,520,827,48,875,1428,61.27%,21.5%,1
臺中市,西區,1129,232,468,700,28,728,1366,53.29%,16.98%,1
臺中市,西區,1130,307,514,821,38,859,1498,57.34%,20.49%,1
臺中市,西區,1131,304,501,805,25,830,1350,61.48%,22.52%,1
臺中市,西區,1132,279,515,794,15,809,1339,60.42%,20.84%,1
臺中市,西區,1133,328,601,929,37,966,1613,59.89%,20.33%,1
臺中市,西區,1134,316,498,814,43,857,1454,58.94%,21.73%,1
臺中市,西區,1135,361,593,954,31,985,1597,61.68%,22.6%,1
臺中市,西區,1136,326,519,845,52,897,1411,63.57%,23.1%,1
臺中市,西區,1137,310,532,842,52,894,1493,59.88%,20.76%,1
臺中市,西區,1138,293,650,943,42,985,1600,61.56%,18.31%,1
臺中市,西區,1139,345,594,939,52,991,1710,57.95%,20.18%,1
臺中市,西區,1140,250,406,656,25,681,1139,59.79%,21.95%,1
臺中市,西區,1141,223,438,661,23,684,1105,61.9%,20.18%,1
臺中市,西區,1142,270,548,818,49,867,1498,57.88%,18.02%,1
臺中市,西區,1143,321,628,949,34,983,1921,51.17%,16.71%,1
臺中市,西區,1144,266,467,733,45,778,1340,58.06%,19.85%,1
臺中市,西區,1145,327,605,932,29,961,1536,62.57%,21.29%,1
臺中市,西區,1146,275,485,760,51,811,1361,59.59%,20.21%,1
臺中市,西區,1147,304,555,859,35,894,1430,62.52%,21.26%,1
臺中市,北區,0983,270,486,756,31,787,1437,54.77%,18.79%,1
臺中市,北區,0984,291,547,838,75,913,1708,53.45%,17.04%,1
臺中市,北區,0985,185,338,523,37,560,1051,53.28%,17.6%,1
臺中市,北區,0986,192,351,543,41,584,996,58.63%,19.28%,1
臺中市,北區,0987,248,619,867,20,887,1504,58.98%,16.49%,1
臺中市,北區,0988,193,364,557,48,605,975,62.05%,19.79%,1
臺中市,北區,0989,167,329,496,28,524,886,59.14%,18.85%,1
臺中市,北區,0990,233,339,572,34,606,1276,47.49%,18.26%,1
臺中市,北區,0991,185,300,485,27,512,938,54.58%,19.72%,1
臺中市,北區,0992,250,472,722,56,778,1404,55.41%,17.81%,1
臺中市,北區,0993,197,350,547,16,563,996,56.53%,19.78%,1
臺中市,北區,0994,183,276,459,41,500,869,57.54%,21.06%,1
臺中市,北區,0995,150,273,423,22,445,704,63.21%,21.31%,1
臺中市,北區,0996,168,354,522,22,544,979,55.57%,17.16%,1
臺中市,北區,0997,135,262,397,13,410,773,53.04%,17.46%,1
臺中市,北區,0998,148,306,454,16,470,759,61.92%,19.5%,1
臺中市,北區,0999,204,600,804,40,844,1438,58.69%,14.19%,1
臺中市,北區,1000,172,449,621,23,644,1212,53.14%,14.19%,1
臺中市,北區,1001,330,631,961,32,993,1731,57.37%,19.06%,1
臺中市,北區,1002,257,606,863,37,900,1445,62.28%,17.79%,1
臺中市,北區,1003,351,657,1008,44,1052,1855,56.71%,18.92%,1
臺中市,北區,1004,275,565,840,42,882,1728,51.04%,15.91%,1
臺中市,北區,1005,304,590,894,46,940,1878,50.05%,16.19%,1
臺中市,北區,1006,277,604,881,60,941,1793,52.48%,15.45%,1
臺中市,北區,1007,275,587,862,50,912,1555,58.65%,17.68%,1
臺中市,北區,1008,213,658,871,15,886,1761,50.31%,12.1%,1
臺中市,北區,1009,237,601,838,34,872,1579,55.22%,15.01%,1
臺中市,北區,1010,388,744,1132,56,1188,2192,54.2%,17.7%,1
臺中市,北區,1011,320,578,898,39,937,1560,60.06%,20.51%,1
臺中市,北區,1012,268,551,819,32,851,1476,57.66%,18.16%,1
臺中市,北區,1013,202,407,609,17,626,1006,62.23%,20.08%,1
臺中市,北區,1014,236,539,775,46,821,1403,58.52%,16.82%,1
臺中市,北區,1015,250,506,756,23,779,1446,53.87%,17.29%,1
臺中市,北區,1016,292,497,789,32,821,1460,56.23%,20%,1
臺中市,北區,1017,249,456,705,18,723,1233,58.64%,20.19%,1
臺中市,北區,1018,241,421,662,17,679,1027,66.11%,23.47%,1
臺中市,北區,1019,262,427,689,22,711,1207,58.91%,21.71%,1
臺中市,北區,1020,258,442,700,22,722,1167,61.87%,22.11%,1
臺中市,北區,1021,231,402,633,31,664,1150,57.74%,20.09%,1
臺中市,北區,1022,207,377,584,40,624,1061,58.81%,19.51%,1
臺中市,北區,1023,223,367,590,21,611,1005,60.8%,22.19%,1
臺中市,北區,1024,370,436,806,11,817,1250,65.36%,29.6%,1
臺中市,北區,1025,290,534,824,50,874,1448,60.36%,20.03%,1
臺中市,北區,1026,287,497,784,45,829,1379,60.12%,20.81%,1
臺中市,北區,1027,326,591,917,43,960,1652,58.11%,19.73%,1
臺中市,北區,1028,360,627,987,33,1020,1867,54.63%,19.28%,1
臺中市,北區,1029,207,365,572,19,591,2078,28.44%,9.96%,1
臺中市,北區,1030,280,630,910,34,944,1562,60.44%,17.93%,1
臺中市,北區,1031,272,537,809,20,829,1430,57.97%,19.02%,1
臺中市,北區,1032,403,737,1140,33,1173,2018,58.13%,19.97%,1
臺中市,北區,1033,274,578,852,18,870,1710,50.88%,16.02%,1
臺中市,北區,1034,244,515,759,30,789,1432,55.1%,17.04%,1
臺中市,北區,1035,221,470,691,17,708,1157,61.19%,19.1%,1
臺中市,北區,1036,257,427,684,30,714,1188,60.1%,21.63%,1
臺中市,北區,1037,244,535,779,28,807,1419,56.87%,17.2%,1
臺中市,北區,1038,312,562,874,33,907,1653,54.87%,18.87%,1
臺中市,北區,1039,263,436,699,35,734,1233,59.53%,21.33%,1
臺中市,北區,1040,255,452,707,19,726,1243,58.41%,20.51%,1
臺中市,北區,1041,218,416,634,17,651,1219,53.4%,17.88%,1
臺中市,北區,1042,270,455,725,33,758,1272,59.59%,21.23%,1
臺中市,北區,1043,263,483,746,19,765,1285,59.53%,20.47%,1
臺中市,北區,1044,364,652,1016,36,1052,1780,59.1%,20.45%,1
臺中市,北區,1045,261,472,733,28,761,1461,52.09%,17.86%,1
臺中市,北區,1046,234,526,760,30,790,1310,60.31%,17.86%,1
臺中市,北區,1047,357,532,889,28,917,1669,54.94%,21.39%,1
臺中市,北區,1048,395,677,1072,47,1119,1932,57.92%,20.45%,1
臺中市,北區,1049,319,600,919,30,949,1682,56.42%,18.97%,1
臺中市,北區,1050,381,615,996,35,1031,1891,54.52%,20.15%,1
臺中市,北區,1051,348,665,1013,51,1064,1882,56.54%,18.49%,1
臺中市,北區,1052,215,411,626,36,662,1159,57.12%,18.55%,1
臺中市,北區,1053,293,556,849,39,888,1553,57.18%,18.87%,1
臺中市,北區,1054,320,538,858,35,893,1607,55.57%,19.91%,1
臺中市,北區,1055,352,605,957,40,997,1773,56.23%,19.85%,1
臺中市,北區,1056,303,533,836,40,876,1524,57.48%,19.88%,1
臺中市,北區,1057,252,690,942,60,1002,1613,62.12%,15.62%,1
臺中市,北區,1058,359,708,1067,45,1112,1877,59.24%,19.13%,1
臺中市,北區,1059,352,633,985,48,1033,1792,57.65%,19.64%,1
臺中市,北區,1060,251,522,773,51,824,1392,59.2%,18.03%,1
臺中市,北區,1061,251,469,720,26,746,1297,57.52%,19.35%,1
臺中市,北區,1062,336,561,897,37,934,1556,60.03%,21.59%,1
臺中市,北區,1063,305,504,809,25,834,1497,55.71%,20.37%,1
臺中市,北區,1064,271,569,840,45,885,1550,57.1%,17.48%,1
臺中市,北區,1065,304,457,761,33,794,1434,55.37%,21.2%,1
臺中市,北區,1066,370,625,995,47,1042,1793,58.11%,20.64%,1
臺中市,北區,1067,385,641,1026,28,1054,1866,56.48%,20.63%,1
臺中市,北區,1068,221,539,760,44,804,1346,59.73%,16.42%,1
臺中市,北區,1069,239,450,689,46,735,1267,58.01%,18.86%,1
臺中市,西屯區,0625,359,625,984,38,1022,1638,62.39%,21.92%,1
臺中市,西屯區,0626,271,436,707,26,733,1335,54.91%,20.3%,1
臺中市,西屯區,0627,368,649,1017,40,1057,1776,59.52%,20.72%,1
臺中市,西屯區,0628,271,489,760,24,784,1351,58.03%,20.06%,1
臺中市,西屯區,0629,283,501,784,35,819,1338,61.21%,21.15%,1
臺中市,西屯區,0630,338,545,883,85,968,1582,61.19%,21.37%,1
臺中市,西屯區,0631,254,629,883,33,916,1710,53.57%,14.85%,1
臺中市,西屯區,0632,275,538,813,39,852,1595,53.42%,17.24%,1
臺中市,西屯區,0633,264,611,875,53,928,1585,58.55%,16.66%,1
臺中市,西屯區,0634,313,615,928,57,985,1749,56.32%,17.9%,1
臺中市,西屯區,0635,346,710,1056,39,1095,1877,58.34%,18.43%,1
臺中市,西屯區,0636,326,567,893,40,933,1697,54.98%,19.21%,1
臺中市,西屯區,0637,301,573,874,33,907,1480,61.28%,20.34%,1
臺中市,西屯區,0638,362,576,938,47,985,1483,66.42%,24.41%,1
臺中市,西屯區,0639,307,565,872,34,906,2484,36.47%,12.36%,1
臺中市,西屯區,0640,149,343,492,33,525,781,67.22%,19.08%,1
臺中市,西屯區,0641,282,571,853,44,897,1477,60.73%,19.09%,1
臺中市,西屯區,0642,340,632,972,31,1003,1784,56.22%,19.06%,1
臺中市,西屯區,0643,302,638,940,24,964,1686,57.18%,17.91%,1
臺中市,西屯區,0644,334,602,936,26,962,1692,56.86%,19.74%,1
臺中市,西屯區,0645,295,588,883,24,907,1659,54.67%,17.78%,1
臺中市,西屯區,0646,358,600,958,25,983,1648,59.65%,21.72%,1
臺中市,西屯區,0647,344,575,919,23,942,1536,61.33%,22.4%,1
臺中市,西屯區,0648,321,640,961,40,1001,1666,60.08%,19.27%,1
臺中市,西屯區,0649,292,528,820,37,857,1428,60.01%,20.45%,1
臺中市,西屯區,0650,330,611,941,45,986,1810,54.48%,18.23%,1
臺中市,西屯區,0651,310,559,869,28,897,1574,56.99%,19.7%,1
臺中市,西屯區,0652,330,606,936,18,954,1650,57.82%,20%,1
臺中市,西屯區,0653,341,583,924,48,972,1681,57.82%,20.29%,1
臺中市,西屯區,0654,322,567,889,37,926,1656,55.92%,19.44%,1
臺中市,西屯區,0655,231,489,720,44,764,1243,61.46%,18.58%,1
臺中市,西屯區,0656,410,482,892,55,947,1471,64.38%,27.87%,1
臺中市,西屯區,0657,311,550,861,34,895,1431,62.54%,21.73%,1
臺中市,西屯區,0658,326,627,953,27,980,1714,57.18%,19.02%,1
臺中市,西屯區,0659,233,570,803,41,844,1424,59.27%,16.36%,1
臺中市,西屯區,0660,260,401,661,39,700,1176,59.52%,22.11%,1
臺中市,西屯區,0661,293,548,841,42,883,1456,60.65%,20.12%,1
臺中市,西屯區,0662,329,561,890,24,914,1451,62.99%,22.67%,1
臺中市,西屯區,0663,237,442,679,18,697,1063,65.57%,22.3%,1
臺中市,西屯區,0664,220,537,757,41,798,1357,58.81%,16.21%,1
臺中市,西屯區,0665,120,579,699,55,754,1355,55.65%,8.86%,1
臺中市,西屯區,0666,220,610,830,26,856,1384,61.85%,15.9%,1
臺中市,西屯區,0667,326,598,924,43,967,1613,59.95%,20.21%,1
臺中市,西屯區,0668,292,575,867,39,906,1562,58%,18.69%,1
臺中市,西屯區,0669,269,498,767,36,803,1219,65.87%,22.07%,1
臺中市,西屯區,0670,276,437,713,28,741,1235,60%,22.35%,1
臺中市,西屯區,0671,249,388,637,39,676,1131,59.77%,22.02%,1
臺中市,西屯區,0672,332,580,912,28,940,1494,62.92%,22.22%,1
臺中市,西屯區,0673,302,463,765,23,788,1325,59.47%,22.79%,1
臺中市,西屯區,0674,309,485,794,38,832,1386,60.03%,22.29%,1
臺中市,西屯區,0675,475,542,1017,60,1077,1816,59.31%,26.16%,1
臺中市,西屯區,0676,327,592,919,24,943,1734,54.38%,18.86%,1
臺中市,西屯區,0677,398,612,1010,59,1069,1777,60.16%,22.4%,1
臺中市,西屯區,0678,363,587,950,45,995,1818,54.73%,19.97%,1
臺中市,西屯區,0679,313,591,904,60,964,1699,56.74%,18.42%,1
臺中市,西屯區,0680,285,593,878,34,912,1715,53.18%,16.62%,1
臺中市,西屯區,0681,323,549,872,32,904,1654,54.66%,19.53%,1
臺中市,西屯區,0682,316,580,896,16,912,1636,55.75%,19.32%,1
臺中市,西屯區,0683,283,438,721,17,738,1298,56.86%,21.8%,1
臺中市,西屯區,0684,276,519,795,46,841,1391,60.46%,19.84%,1
臺中市,西屯區,0685,366,694,1060,38,1098,1853,59.26%,19.75%,1
臺中市,西屯區,0686,330,632,962,46,1008,1820,55.38%,18.13%,1
臺中市,西屯區,0687,359,658,1017,39,1056,1809,58.37%,19.85%,1
臺中市,西屯區,0688,263,539,802,42,844,1352,62.43%,19.45%,1
臺中市,西屯區,0689,267,584,851,41,892,1521,58.65%,17.55%,1
臺中市,西屯區,0690,296,591,887,26,913,1486,61.44%,19.92%,1
臺中市,西屯區,0691,331,620,951,41,992,1674,59.26%,19.77%,1
臺中市,西屯區,0692,328,637,965,43,1008,1610,62.61%,20.37%,1
臺中市,西屯區,0693,345,598,943,43,986,1695,58.17%,20.35%,1
臺中市,西屯區,0694,341,555,896,36,932,1684,55.34%,20.25%,1
臺中市,西屯區,0695,236,488,724,27,751,1221,61.51%,19.33%,1
臺中市,西屯區,0696,249,563,812,42,854,1252,68.21%,19.89%,1
臺中市,西屯區,0697,270,498,768,51,819,1301,62.95%,20.75%,1
臺中市,西屯區,0698,146,493,639,29,668,1049,63.68%,13.92%,1
臺中市,西屯區,0699,161,485,646,30,676,1113,60.74%,14.47%,1
臺中市,西屯區,0700,217,588,805,51,856,1557,54.98%,13.94%,1
臺中市,西屯區,0701,274,592,866,43,909,1640,55.43%,16.71%,1
臺中市,西屯區,0702,288,591,879,61,940,1402,67.05%,20.54%,1
臺中市,西屯區,0703,276,576,852,56,908,1717,52.88%,16.07%,1
臺中市,西屯區,0704,289,621,910,60,970,1688,57.46%,17.12%,1
臺中市,西屯區,0705,197,437,634,89,723,1168,61.9%,16.87%,1
臺中市,西屯區,0706,283,628,911,43,954,1729,55.18%,16.37%,1
臺中市,西屯區,0707,338,698,1036,39,1075,2007,53.56%,16.84%,1
臺中市,西屯區,0708,268,462,730,69,799,1296,61.65%,20.68%,1
臺中市,西屯區,0709,180,370,550,21,571,1068,53.46%,16.85%,1
臺中市,西屯區,0710,270,578,848,61,909,1707,53.25%,15.82%,1
臺中市,西屯區,0711,329,606,935,36,971,1636,59.35%,20.11%,1
臺中市,西屯區,0712,294,540,834,25,859,1761,48.78%,16.7%,1
臺中市,西屯區,0713,274,478,752,29,781,1314,59.44%,20.85%,1
臺中市,西屯區,0714,267,502,769,23,792,1233,64.23%,21.65%,1
臺中市,西屯區,0715,264,558,822,32,854,1549,55.13%,17.04%,1
臺中市,西屯區,0716,285,591,876,21,897,1639,54.73%,17.39%,1
臺中市,西屯區,0717,205,577,782,29,811,1486,54.58%,13.8%,1
臺中市,西屯區,0718,374,588,962,24,986,1806,54.6%,20.71%,1
臺中市,西屯區,0719,303,476,779,12,791,1451,54.51%,20.88%,1
臺中市,西屯區,0720,242,516,758,17,775,1302,59.52%,18.59%,1
臺中市,西屯區,0721,300,502,802,45,847,1353,62.6%,22.17%,1
臺中市,西屯區,0722,411,802,1213,52,1265,2162,58.51%,19.01%,1
臺中市,西屯區,0723,280,546,826,34,860,1520,56.58%,18.42%,1
臺中市,西屯區,0724,352,691,1043,38,1081,1935,55.87%,18.19%,1
臺中市,西屯區,0725,369,659,1028,36,1064,1847,57.61%,19.98%,1
臺中市,西屯區,0726,406,597,1003,24,1027,1738,59.09%,23.36%,1
臺中市,西屯區,0727,345,630,975,34,1009,1640,61.52%,21.04%,1
臺中市,西屯區,0728,396,662,1058,33,1091,1908,57.18%,20.75%,1
臺中市,西屯區,0729,314,482,796,23,819,1402,58.42%,22.4%,1
臺中市,西屯區,0730,296,489,785,32,817,1515,53.93%,19.54%,1
臺中市,西屯區,0731,259,461,720,33,753,1541,48.86%,16.81%,1
臺中市,西屯區,0732,319,487,806,27,833,1502,55.46%,21.24%,1
臺中市,西屯區,0733,334,524,858,54,912,1526,59.76%,21.89%,1
臺中市,西屯區,0734,303,512,815,58,873,1425,61.26%,21.26%,1
臺中市,西屯區,0735,274,527,801,29,830,1334,62.22%,20.54%,1
臺中市,西屯區,0736,344,624,968,39,1007,1649,61.07%,20.86%,1
臺中市,西屯區,0737,307,576,883,33,916,1566,58.49%,19.6%,1
臺中市,西屯區,0738,348,624,972,26,998,1629,61.26%,21.36%,1
臺中市,西屯區,0739,341,595,936,32,968,1628,59.46%,20.95%,1
臺中市,西屯區,0740,315,546,861,29,890,1442,61.72%,21.84%,1
臺中市,西屯區,0741,241,399,640,34,674,1206,55.89%,19.98%,1
臺中市,西屯區,0742,185,446,631,59,690,1086,63.54%,17.03%,1
臺中市,西屯區,0743,209,473,682,35,717,1088,65.9%,19.21%,1
臺中市,西屯區,0744,239,428,667,23,690,1140,60.53%,20.96%,1
臺中市,南屯區,0745,256,513,769,41,810,1321,61.32%,19.38%,1
臺中市,南屯區,0746,292,498,790,56,846,1346,62.85%,21.69%,1
臺中市,南屯區,0747,257,571,828,43,871,1428,60.99%,18%,1
臺中市,南屯區,0748,278,528,806,28,834,1442,57.84%,19.28%,1
臺中市,南屯區,0749,292,594,886,20,906,1408,64.35%,20.74%,1
臺中市,南屯區,0750,287,553,840,23,863,1404,61.47%,20.44%,1
臺中市,南屯區,0751,268,556,824,39,863,1354,63.74%,19.79%,1
臺中市,南屯區,0752,309,493,802,36,838,1332,62.91%,23.2%,1
臺中市,南屯區,0753,331,568,899,27,926,1463,63.29%,22.62%,1
臺中市,南屯區,0754,305,497,802,49,851,1413,60.23%,21.59%,1
臺中市,南屯區,0755,292,472,764,25,789,1218,64.78%,23.97%,1
臺中市,南屯區,0756,262,500,762,31,793,1308,60.63%,20.03%,1
臺中市,南屯區,0757,335,604,939,37,976,1527,63.92%,21.94%,1
臺中市,南屯區,0758,304,485,789,33,822,1294,63.52%,23.49%,1
臺中市,南屯區,0759,264,522,786,27,813,1516,53.63%,17.41%,1
臺中市,南屯區,0760,297,589,886,63,949,1529,62.07%,19.42%,1
臺中市,南屯區,0761,248,565,813,50,863,1397,61.78%,17.75%,1
臺中市,南屯區,0762,234,530,764,32,796,1406,56.61%,16.64%,1
臺中市,南屯區,0763,251,542,793,34,827,1497,55.24%,16.77%,1
臺中市,南屯區,0764,257,515,772,58,830,1424,58.29%,18.05%,1
臺中市,南屯區,0765,273,448,721,46,767,1488,51.55%,18.35%,1
臺中市,南屯區,0766,123,234,357,50,407,608,66.94%,20.23%,1
臺中市,南屯區,0767,154,325,479,57,536,813,65.93%,18.94%,1
臺中市,南屯區,0768,230,459,689,49,738,1190,62.02%,19.33%,1
臺中市,南屯區,0769,189,454,643,34,677,1174,57.67%,16.1%,1
臺中市,南屯區,0770,237,470,707,13,720,1224,58.82%,19.36%,1
臺中市,南屯區,0771,212,475,687,47,734,1466,50.07%,14.46%,1
臺中市,南屯區,0772,143,408,551,24,575,1333,43.14%,10.73%,1
臺中市,南屯區,0773,157,321,478,44,522,814,64.13%,19.29%,1
臺中市,南屯區,0774,217,545,762,42,804,1436,55.99%,15.11%,1
臺中市,南屯區,0775,309,549,858,45,903,1515,59.6%,20.4%,1
臺中市,南屯區,0776,240,476,716,81,797,1545,51.59%,15.53%,1
臺中市,南屯區,0777,258,522,780,35,815,1383,58.93%,18.66%,1
臺中市,南屯區,0778,269,567,836,26,862,1433,60.15%,18.77%,1
臺中市,南屯區,0779,221,377,598,31,629,1134,55.47%,19.49%,1
臺中市,南屯區,0780,238,495,733,28,761,1216,62.58%,19.57%,1
臺中市,南屯區,0781,241,429,670,65,735,1271,57.83%,18.96%,1
臺中市,南屯區,0782,221,428,649,21,670,1203,55.69%,18.37%,1
臺中市,南屯區,0783,246,476,722,23,745,1268,58.75%,19.4%,1
臺中市,南屯區,0784,240,552,792,39,831,1390,59.78%,17.27%,1
臺中市,南屯區,0785,271,493,764,44,808,1397,57.84%,19.4%,1
臺中市,南屯區,0786,285,583,868,58,926,1607,57.62%,17.73%,1
臺中市,南屯區,0787,304,610,914,37,951,1582,60.11%,19.22%,1
臺中市,南屯區,0788,274,655,929,42,971,1611,60.27%,17.01%,1
臺中市,南屯區,0789,281,533,814,29,843,1322,63.77%,21.26%,1
臺中市,南屯區,0790,283,542,825,34,859,1321,65.03%,21.42%,1
臺中市,南屯區,0791,256,540,796,34,830,1360,61.03%,18.82%,1
臺中市,南屯區,0792,273,556,829,12,841,1361,61.79%,20.06%,1
臺中市,南屯區,0793,296,485,781,19,800,1257,63.64%,23.55%,1
臺中市,南屯區,0794,266,490,756,27,783,1207,64.87%,22.04%,1
臺中市,南屯區,0795,298,501,799,22,821,1282,64.04%,23.24%,1
臺中市,南屯區,0796,304,489,793,29,822,1248,65.87%,24.36%,1
臺中市,南屯區,0797,304,505,809,42,851,1304,65.26%,23.31%,1
臺中市,南屯區,0798,248,477,725,20,745,1214,61.37%,20.43%,1
臺中市,南屯區,0799,260,423,683,28,711,1102,64.52%,23.59%,1
臺中市,南屯區,0800,328,685,1013,39,1052,1630,64.54%,20.12%,1
臺中市,南屯區,0801,302,498,800,31,831,1333,62.34%,22.66%,1
臺中市,南屯區,0802,294,505,799,22,821,1292,63.54%,22.76%,1
臺中市,南屯區,0803,258,503,761,30,791,1272,62.19%,20.28%,1
臺中市,南屯區,0804,287,509,796,22,818,1345,60.82%,21.34%,1
臺中市,南屯區,0805,212,427,639,52,691,981,70.44%,21.61%,1
臺中市,南屯區,0806,200,446,646,55,701,1097,63.9%,18.23%,1
臺中市,南屯區,0807,189,433,622,27,649,991,65.49%,19.07%,1
臺中市,南屯區,0808,213,482,695,28,723,1170,61.79%,18.21%,1
臺中市,南屯區,0809,268,448,716,35,751,1171,64.13%,22.89%,1
臺中市,南屯區,0810,279,468,747,50,797,1349,59.08%,20.68%,1
臺中市,南屯區,0811,291,551,842,32,874,1368,63.89%,21.27%,1
臺中市,南屯區,0812,290,511,801,20,821,1263,65%,22.96%,1
臺中市,南屯區,0813,350,567,917,44,961,1547,62.12%,22.62%,1
臺中市,南屯區,0814,362,582,944,44,988,1649,59.92%,21.95%,1
臺中市,南屯區,0815,331,576,907,30,937,1629,57.52%,20.32%,1
臺中市,南屯區,0816,328,474,802,38,840,1580,53.16%,20.76%,1
臺中市,南屯區,0817,323,592,915,34,949,1444,65.72%,22.37%,1
臺中市,南屯區,0818,279,535,814,21,835,1413,59.09%,19.75%,1
臺中市,南屯區,0819,240,526,766,37,803,1377,58.32%,17.43%,1
臺中市,南屯區,0820,370,533,903,33,936,1527,61.3%,24.23%,1
臺中市,南屯區,0821,290,526,816,29,845,1335,63.3%,21.72%,1
臺中市,南屯區,0822,378,630,1008,28,1036,1544,67.1%,24.48%,1
臺中市,南屯區,0823,349,589,938,35,973,1482,65.65%,23.55%,1
臺中市,南屯區,0824,276,607,883,49,932,1488,62.63%,18.55%,1
臺中市,南屯區,0825,272,502,774,42,816,1538,53.06%,17.69%,1
臺中市,南屯區,0826,351,655,1006,54,1060,1674,63.32%,20.97%,1
臺中市,南屯區,0827,315,516,831,37,868,1996,43.49%,15.78%,1
臺中市,南屯區,0828,276,588,864,56,920,1514,60.77%,18.23%,1
臺中市,南屯區,0829,234,506,740,45,785,1217,64.5%,19.23%,1
臺中市,南屯區,0830,295,470,765,38,803,1347,59.61%,21.9%,1
臺中市,南屯區,0831,214,457,671,24,695,1109,62.67%,19.3%,1
臺中市,南屯區,0832,320,558,878,25,903,1546,58.41%,20.7%,1
臺中市,南屯區,0833,310,553,863,43,906,1408,64.35%,22.02%,1
臺中市,南屯區,0834,164,413,577,27,604,1057,57.14%,15.52%,1
臺中市,南屯區,0835,234,406,640,54,694,1133,61.25%,20.65%,1
臺中市,南屯區,0836,403,380,783,26,809,1278,63.3%,31.53%,1
臺中市,南屯區,0837,261,455,716,41,757,1144,66.17%,22.81%,1
臺中市,南屯區,0838,259,414,673,38,711,1140,62.37%,22.72%,1
臺中市,南屯區,0839,167,547,714,25,739,1171,63.11%,14.26%,1
臺中市,南屯區,0840,285,524,809,33,842,1303,64.62%,21.87%,1
臺中市,南屯區,0841,267,503,770,29,799,1402,56.99%,19.04%,1
臺中市,南屯區,0842,286,584,870,51,921,1571,58.63%,18.2%,1
臺中市,南屯區,0843,283,430,713,23,736,1139,64.62%,24.85%,1
臺中市,南屯區,0844,259,502,761,25,786,1216,64.64%,21.3%,1
臺中市,南屯區,0845,233,476,709,33,742,1162,63.86%,20.05%,1
臺中市,北屯區,0846,323,645,968,54,1022,1670,61.2%,19.34%,1
臺中市,北屯區,0847,606,285,891,47,938,1706,54.98%,35.52%,1
臺中市,北屯區,0848,292,539,831,51,882,1507,58.53%,19.38%,1
臺中市,北屯區,0849,336,602,938,51,989,1652,59.87%,20.34%,1
臺中市,北屯區,0850,204,398,602,17,619,1107,55.92%,18.43%,1
臺中市,北屯區,0851,271,844,1115,48,1163,2151,54.07%,12.6%,1
臺中市,北屯區,0852,309,642,951,30,981,1612,60.86%,19.17%,1
臺中市,北屯區,0853,306,641,947,42,989,1743,56.74%,17.56%,1
臺中市,北屯區,0854,375,741,1116,33,1149,2099,54.74%,17.87%,1
臺中市,北屯區,0855,297,599,896,22,918,1595,57.55%,18.62%,1
臺中市,北屯區,0856,322,654,976,40,1016,1923,52.83%,16.74%,1
臺中市,北屯區,0857,260,593,853,53,906,1641,55.21%,15.84%,1
臺中市,北屯區,0858,249,471,720,28,748,1157,64.65%,21.52%,1
臺中市,北屯區,0859,210,428,638,26,664,1041,63.78%,20.17%,1
臺中市,北屯區,0860,264,548,812,36,848,1563,54.25%,16.89%,1
臺中市,北屯區,0861,234,561,795,46,841,1559,53.94%,15.01%,1
臺中市,北屯區,0862,192,516,708,18,726,1411,51.45%,13.61%,1
臺中市,北屯區,0863,344,646,990,33,1023,1761,58.09%,19.53%,1
臺中市,北屯區,0864,248,564,812,53,865,1361,63.56%,18.22%,1
臺中市,北屯區,0865,292,706,998,53,1051,1852,56.75%,15.77%,1
臺中市,北屯區,0866,343,742,1085,38,1123,1928,58.25%,17.79%,1
臺中市,北屯區,0867,291,635,926,34,960,1492,64.34%,19.5%,1
臺中市,北屯區,0868,314,731,1045,56,1101,1998,55.11%,15.72%,1
臺中市,北屯區,0869,254,536,790,34,824,1272,64.78%,19.97%,1
臺中市,北屯區,0870,254,521,775,34,809,1317,61.43%,19.29%,1
臺中市,北屯區,0871,209,445,654,53,707,1327,53.28%,15.75%,1
臺中市,北屯區,0872,254,369,623,24,647,1280,50.55%,19.84%,1
臺中市,北屯區,0873,288,656,944,46,990,1865,53.08%,15.44%,1
臺中市,北屯區,0874,243,508,751,42,793,1230,64.47%,19.76%,1
臺中市,北屯區,0875,234,475,709,34,743,1356,54.79%,17.26%,1
臺中市,北屯區,0876,311,645,956,35,991,1732,57.22%,17.96%,1
臺中市,北屯區,0877,327,591,918,29,947,1586,59.71%,20.62%,1
臺中市,北屯區,0878,299,501,800,25,825,1441,57.25%,20.75%,1
臺中市,北屯區,0879,351,693,1044,65,1109,2045,54.23%,17.16%,1
臺中市,北屯區,0880,335,623,958,46,1004,1914,52.46%,17.5%,1
臺中市,北屯區,0881,331,729,1060,40,1100,1918,57.35%,17.26%,1
臺中市,北屯區,0882,328,724,1052,32,1084,2079,52.14%,15.78%,1
臺中市,北屯區,0883,380,747,1127,40,1167,2040,57.21%,18.63%,1
臺中市,北屯區,0884,340,628,968,42,1010,2027,49.83%,16.77%,1
臺中市,北屯區,0885,208,539,747,38,785,1402,55.99%,14.84%,1
臺中市,北屯區,0886,342,672,1014,47,1061,1826,58.11%,18.73%,1
臺中市,北屯區,0887,365,703,1068,29,1097,2162,50.74%,16.88%,1
臺中市,北屯區,0888,404,698,1102,18,1120,2332,48.03%,17.32%,1
臺中市,北屯區,0889,132,400,532,50,582,985,59.09%,13.4%,1
臺中市,北屯區,0890,315,711,1026,40,1066,2037,52.33%,15.46%,1
臺中市,北屯區,0891,174,421,595,35,630,1032,61.05%,16.86%,1
臺中市,北屯區,0892,192,410,602,31,633,1062,59.6%,18.08%,1
臺中市,北屯區,0893,151,332,483,33,516,909,56.77%,16.61%,1
臺中市,北屯區,0894,289,548,837,46,883,1445,61.11%,20%,1
臺中市,北屯區,0895,326,550,876,38,914,1842,49.62%,17.7%,1
臺中市,北屯區,0896,234,458,692,26,718,1187,60.49%,19.71%,1
臺中市,北屯區,0897,257,560,817,40,857,1456,58.86%,17.65%,1
臺中市,北屯區,0898,322,706,1028,52,1080,1866,57.88%,17.26%,1
臺中市,北屯區,0899,281,578,859,46,905,1667,54.29%,16.86%,1
臺中市,北屯區,0900,322,653,975,22,997,1683,59.24%,19.13%,1
臺中市,北屯區,0901,333,569,902,20,922,1642,56.15%,20.28%,1
臺中市,北屯區,0902,297,568,865,19,884,1475,59.93%,20.14%,1
臺中市,北屯區,0903,284,606,890,20,910,1644,55.35%,17.27%,1
臺中市,北屯區,0904,329,621,950,26,976,1603,60.89%,20.52%,1
臺中市,北屯區,0905,372,726,1098,67,1165,1949,59.77%,19.09%,1
臺中市,北屯區,0906,349,744,1093,35,1128,1790,63.02%,19.5%,1
臺中市,北屯區,0907,312,511,823,33,856,1440,59.44%,21.67%,1
臺中市,北屯區,0908,333,603,936,45,981,1601,61.27%,20.8%,1
臺中市,北屯區,0909,249,554,803,53,856,1527,56.06%,16.31%,1
臺中市,北屯區,0910,278,573,851,41,892,1675,53.25%,16.6%,1
臺中市,北屯區,0911,251,519,770,40,810,1579,51.3%,15.9%,1
臺中市,北屯區,0912,245,580,825,58,883,1524,57.94%,16.08%,1
臺中市,北屯區,0913,286,602,888,33,921,1677,54.92%,17.05%,1
臺中市,北屯區,0914,315,552,867,36,903,1599,56.47%,19.7%,1
臺中市,北屯區,0915,323,516,839,49,888,1458,60.91%,22.15%,1
臺中市,北屯區,0916,338,574,912,37,949,1571,60.41%,21.51%,1
臺中市,北屯區,0917,304,597,901,47,948,1579,60.04%,19.25%,1
臺中市,北屯區,0918,370,673,1043,44,1087,1849,58.79%,20.01%,1
臺中市,北屯區,0919,336,603,939,28,967,1682,57.49%,19.98%,1
臺中市,北屯區,0920,304,644,948,26,974,1760,55.34%,17.27%,1
臺中市,北屯區,0921,327,613,940,50,990,1699,58.27%,19.25%,1
臺中市,北屯區,0922,355,630,985,47,1032,1626,63.47%,21.83%,1
臺中市,北屯區,0923,329,560,889,6,895,1491,60.03%,22.07%,1
臺中市,北屯區,0924,316,582,898,30,928,1640,56.59%,19.27%,1
臺中市,北屯區,0925,378,615,993,0,993,2052,48.39%,18.42%,1
臺中市,北屯區,0926,319,660,979,49,1028,1875,54.83%,17.01%,1
臺中市,北屯區,0927,284,570,854,33,887,1559,56.9%,18.22%,1
臺中市,北屯區,0928,293,539,832,52,884,1480,59.73%,19.8%,1
臺中市,北屯區,0929,274,520,794,52,846,1397,60.56%,19.61%,1
臺中市,北屯區,0930,349,718,1067,30,1097,1889,58.07%,18.48%,1
臺中市,北屯區,0931,324,595,919,56,975,1728,56.42%,18.75%,1
臺中市,北屯區,0932,288,557,845,56,901,1592,56.6%,18.09%,1
臺中市,北屯區,0933,313,556,869,45,914,1656,55.19%,18.9%,1
臺中市,北屯區,0934,280,521,801,32,833,1524,54.66%,18.37%,1
臺中市,北屯區,0935,295,565,860,35,895,1502,59.59%,19.64%,1
臺中市,北屯區,0936,305,654,959,35,994,1772,56.09%,17.21%,1
臺中市,北屯區,0937,310,534,844,39,883,1461,60.44%,21.22%,1
臺中市,北屯區,0938,298,612,910,13,923,1769,52.18%,16.85%,1
臺中市,北屯區,0939,427,652,1079,51,1130,1894,59.66%,22.54%,1
臺中市,北屯區,0940,341,687,1028,49,1077,2033,52.98%,16.77%,1
臺中市,北屯區,0941,368,658,1026,40,1066,1947,54.75%,18.9%,1
臺中市,北屯區,0942,428,782,1210,60,1270,2188,58.04%,19.56%,1
臺中市,北屯區,0943,364,584,948,60,1008,1661,60.69%,21.91%,1
臺中市,北屯區,0944,319,629,948,32,980,1667,58.79%,19.14%,1
臺中市,北屯區,0945,302,638,940,38,978,1728,56.6%,17.48%,1
臺中市,北屯區,0946,287,621,908,36,944,1688,55.92%,17%,1
臺中市,北屯區,0947,301,524,825,23,848,1475,57.49%,20.41%,1
臺中市,北屯區,0948,371,648,1019,31,1050,1681,62.46%,22.07%,1
臺中市,北屯區,0949,418,765,1183,46,1229,2078,59.14%,20.12%,1
臺中市,北屯區,0950,358,764,1122,42,1164,2059,56.53%,17.39%,1
臺中市,北屯區,0951,361,631,992,55,1047,1792,58.43%,20.15%,1
臺中市,北屯區,0952,362,668,1030,29,1059,2974,35.61%,12.17%,1
臺中市,北屯區,0953,200,392,592,38,630,1072,58.77%,18.66%,1
臺中市,北屯區,0954,406,835,1241,39,1280,2099,60.98%,19.34%,1
臺中市,北屯區,0955,401,733,1134,47,1181,1823,64.78%,22%,1
臺中市,北屯區,0956,390,781,1171,72,1243,2022,61.47%,19.29%,1
臺中市,北屯區,0957,365,759,1124,30,1154,1992,57.93%,18.32%,1
臺中市,北屯區,0958,229,693,922,58,980,1585,61.83%,14.45%,1
臺中市,北屯區,0959,304,616,920,40,960,1565,61.34%,19.42%,1
臺中市,北屯區,0960,272,633,905,45,950,1780,53.37%,15.28%,1
臺中市,北屯區,0961,358,752,1110,45,1155,1874,61.63%,19.1%,1
臺中市,北屯區,0962,300,722,1022,41,1063,1755,60.57%,17.09%,1
臺中市,北屯區,0963,347,641,988,30,1018,1497,68%,23.18%,1
臺中市,北屯區,0964,286,656,942,52,994,1567,63.43%,18.25%,1
臺中市,北屯區,0965,279,613,892,28,920,1624,56.65%,17.18%,1
臺中市,北屯區,0966,286,658,944,48,992,1614,61.46%,17.72%,1
臺中市,北屯區,0967,303,590,893,25,918,1595,57.55%,19%,1
臺中市,北屯區,0968,345,549,894,64,958,1782,53.76%,19.36%,1
臺中市,北屯區,0969,222,476,698,32,730,1357,53.8%,16.36%,1
臺中市,北屯區,0970,165,400,565,60,625,1071,58.36%,15.41%,1
臺中市,北屯區,0971,227,500,727,41,768,1372,55.98%,16.55%,1
臺中市,北屯區,0972,255,543,798,52,850,1415,60.07%,18.02%,1
臺中市,北屯區,0973,346,724,1070,48,1118,1789,62.49%,19.34%,1
臺中市,北屯區,0974,228,899,1127,66,1193,1907,62.56%,11.96%,1
臺中市,北屯區,0975,348,798,1146,37,1183,2008,58.91%,17.33%,1
臺中市,北屯區,0976,262,577,839,47,886,1541,57.5%,17%,1
臺中市,北屯區,0977,308,652,960,39,999,1669,59.86%,18.45%,1
臺中市,北屯區,0978,285,664,949,33,982,1685,58.28%,16.91%,1
臺中市,北屯區,0979,331,673,1004,62,1066,1785,59.72%,18.54%,1
臺中市,北屯區,0980,254,679,933,49,982,1596,61.53%,15.91%,1
臺中市,北屯區,0981,347,642,989,62,1051,1731,60.72%,20.05%,1
臺中市,北屯區,0982,254,529,783,69,852,1496,56.95%,16.98%,1
臺中市,豐原區,0394,168,346,514,50,564,983,57.38%,17.09%,1
臺中市,豐原區,0395,231,522,753,42,795,1309,60.73%,17.65%,1
臺中市,豐原區,0396,264,383,647,55,702,1116,62.9%,23.66%,1
臺中市,豐原區,0397,188,375,563,48,611,945,64.66%,19.89%,1
臺中市,豐原區,0398,192,310,502,54,556,850,65.41%,22.59%,1
臺中市,豐原區,0399,165,293,458,38,496,760,65.26%,21.71%,1
臺中市,豐原區,0400,284,623,907,9,916,1617,56.65%,17.56%,1
臺中市,豐原區,0401,257,598,855,43,898,1677,53.55%,15.32%,1
臺中市,豐原區,0402,340,748,1088,41,1129,1771,63.75%,19.2%,1
臺中市,豐原區,0403,181,432,613,50,663,1145,57.9%,15.81%,1
臺中市,豐原區,0404,258,495,753,36,789,1362,57.93%,18.94%,1
臺中市,豐原區,0405,248,563,811,33,844,1389,60.76%,17.85%,1
臺中市,豐原區,0406,257,636,893,50,943,1530,61.63%,16.8%,1
臺中市,豐原區,0407,263,534,797,87,884,1471,60.1%,17.88%,1
臺中市,豐原區,0408,245,538,783,71,854,1410,60.57%,17.38%,1
臺中市,豐原區,0409,182,459,641,42,683,1162,58.78%,15.66%,1
臺中市,豐原區,0410,275,642,917,33,950,1656,57.37%,16.61%,1
臺中市,豐原區,0411,276,726,1002,42,1044,1838,56.8%,15.02%,1
臺中市,豐原區,0412,290,617,907,43,950,1666,57.02%,17.41%,1
臺中市,豐原區,0413,331,690,1021,81,1102,1821,60.52%,18.18%,1
臺中市,豐原區,0414,352,794,1146,67,1213,1821,66.61%,19.33%,1
臺中市,豐原區,0415,329,582,911,32,943,1647,57.26%,19.98%,1
臺中市,豐原區,0416,271,501,772,71,843,1256,67.12%,21.58%,1
臺中市,豐原區,0417,298,637,935,61,996,1552,64.18%,19.2%,1
臺中市,豐原區,0418,329,676,1005,50,1055,1793,58.84%,18.35%,1
臺中市,豐原區,0419,179,329,508,30,538,759,70.88%,23.58%,1
臺中市,豐原區,0420,141,247,388,36,424,642,66.04%,21.96%,1
臺中市,豐原區,0421,318,599,917,21,938,1528,61.39%,20.81%,1
臺中市,豐原區,0422,329,744,1073,64,1137,1788,63.59%,18.4%,1
臺中市,豐原區,0423,348,672,1020,75,1095,1663,65.84%,20.93%,1
臺中市,豐原區,0424,256,565,821,54,875,1260,69.44%,20.32%,1
臺中市,豐原區,0425,176,330,506,26,532,902,58.98%,19.51%,1
臺中市,豐原區,0426,231,506,737,29,766,1357,56.45%,17.02%,1
臺中市,豐原區,0427,275,654,929,37,966,1592,60.68%,17.27%,1
臺中市,豐原區,0428,305,749,1054,48,1102,1873,58.84%,16.28%,1
臺中市,豐原區,0429,317,728,1045,46,1091,1867,58.44%,16.98%,1
臺中市,豐原區,0430,295,694,989,77,1066,1823,58.48%,16.18%,1
臺中市,豐原區,0431,338,660,998,48,1046,1962,53.31%,17.23%,1
臺中市,豐原區,0432,468,891,1359,59,1418,2313,61.31%,20.23%,1
臺中市,豐原區,0433,281,598,879,60,939,1510,62.19%,18.61%,1
臺中市,豐原區,0434,321,717,1038,60,1098,1824,60.2%,17.6%,1
臺中市,豐原區,0435,247,541,788,33,821,1363,60.23%,18.12%,1
臺中市,豐原區,0436,291,632,923,45,968,1535,63.06%,18.96%,1
臺中市,豐原區,0437,310,562,872,41,913,1457,62.66%,21.28%,1
臺中市,豐原區,0438,233,469,702,32,734,1184,61.99%,19.68%,1
臺中市,豐原區,0439,388,678,1066,55,1121,2299,48.76%,16.88%,1
臺中市,豐原區,0440,328,742,1070,86,1156,1940,59.59%,16.91%,1
臺中市,豐原區,0441,382,731,1113,52,1165,2067,56.36%,18.48%,1
臺中市,豐原區,0442,360,741,1101,62,1163,2038,57.07%,17.66%,1
臺中市,豐原區,0443,354,663,1017,44,1061,1835,57.82%,19.29%,1
臺中市,豐原區,0444,331,736,1067,81,1148,1979,58.01%,16.73%,1
臺中市,豐原區,0445,340,733,1073,73,1146,2014,56.9%,16.88%,1
臺中市,豐原區,0446,393,842,1235,86,1321,2257,58.53%,17.41%,1
臺中市,豐原區,0447,245,583,828,62,890,1406,63.3%,17.43%,1
臺中市,豐原區,0448,280,540,820,48,868,1418,61.21%,19.75%,1
臺中市,豐原區,0449,313,753,1066,58,1124,1772,63.43%,17.66%,1
臺中市,豐原區,0450,257,496,753,26,779,1202,64.81%,21.38%,1
臺中市,豐原區,0451,257,603,860,36,896,1447,61.92%,17.76%,1
臺中市,豐原區,0452,319,693,1012,72,1084,1758,61.66%,18.15%,1
臺中市,豐原區,0453,300,638,938,52,990,1546,64.04%,19.4%,1
臺中市,豐原區,0454,288,796,1084,49,1133,1815,62.42%,15.87%,1
臺中市,豐原區,0455,392,719,1111,54,1165,1932,60.3%,20.29%,1
臺中市,豐原區,0456,358,700,1058,51,1109,1770,62.66%,20.23%,1
臺中市,豐原區,0457,240,609,849,31,880,1560,56.41%,15.38%,1
臺中市,豐原區,0458,323,693,1016,49,1065,1810,58.84%,17.85%,1
臺中市,豐原區,0459,365,640,1005,42,1047,1653,63.34%,22.08%,1
臺中市,豐原區,0460,572,242,814,54,868,1444,60.11%,39.61%,1
臺中市,豐原區,0461,267,538,805,31,836,1318,63.43%,20.26%,1
臺中市,豐原區,0462,337,554,891,67,958,1566,61.17%,21.52%,1
臺中市,豐原區,0463,325,651,976,50,1026,1748,58.7%,18.59%,1
臺中市,豐原區,0464,279,613,892,71,963,1772,54.35%,15.74%,1
臺中市,豐原區,0465,276,670,946,66,1012,1721,58.8%,16.04%,1
臺中市,豐原區,0466,274,636,910,47,957,1578,60.65%,17.36%,1
臺中市,豐原區,0467,358,676,1034,58,1092,1859,58.74%,19.26%,1
臺中市,豐原區,0468,298,549,847,37,884,1479,59.77%,20.15%,1
臺中市,豐原區,0469,345,739,1084,43,1127,1889,59.66%,18.26%,1
臺中市,豐原區,0470,333,662,995,46,1041,1803,57.74%,18.47%,1
臺中市,豐原區,0471,270,494,764,53,817,1421,57.49%,19%,1
臺中市,豐原區,0472,311,626,937,69,1006,1585,63.47%,19.62%,1
臺中市,豐原區,0473,313,727,1040,77,1117,1774,62.97%,17.64%,1
臺中市,豐原區,0474,336,854,1190,73,1263,2132,59.24%,15.76%,1
臺中市,豐原區,0475,250,589,839,67,906,1515,59.8%,16.5%,1
臺中市,豐原區,0476,207,507,714,30,744,1359,54.75%,15.23%,1
臺中市,豐原區,0477,189,367,556,43,599,948,63.19%,19.94%,1
臺中市,豐原區,0478,219,456,675,39,714,1134,62.96%,19.31%,1
臺中市,豐原區,0479,223,465,688,61,749,1114,67.24%,20.02%,1
臺中市,豐原區,0480,191,403,594,44,638,1050,60.76%,18.19%,1
臺中市,豐原區,0481,246,480,726,50,776,1182,65.65%,20.81%,1
臺中市,東勢區,1513,160,501,661,62,723,1299,55.66%,12.32%,1
臺中市,東勢區,1514,135,386,521,60,581,1007,57.7%,13.41%,1
臺中市,東勢區,1515,111,320,431,49,480,859,55.88%,12.92%,1
臺中市,東勢區,1516,173,408,581,65,646,991,65.19%,17.46%,1
臺中市,東勢區,1517,118,314,432,25,457,863,52.95%,13.67%,1
臺中市,東勢區,1518,220,613,833,95,928,1628,57%,13.51%,1
臺中市,東勢區,1519,213,441,654,60,714,1335,53.48%,15.96%,1
臺中市,東勢區,1520,200,441,641,60,701,1092,64.19%,18.32%,1
臺中市,東勢區,1521,137,497,634,44,678,1050,64.57%,13.05%,1
臺中市,東勢區,1522,196,591,787,42,829,1431,57.93%,13.7%,1
臺中市,東勢區,1523,588,196,784,42,826,1372,60.2%,42.86%,1
臺中市,東勢區,1524,216,530,746,47,793,1412,56.16%,15.3%,1
臺中市,東勢區,1525,113,349,462,57,519,878,59.11%,12.87%,1
臺中市,東勢區,1526,166,534,700,65,765,1475,51.86%,11.25%,1
臺中市,東勢區,1527,108,347,455,17,472,872,54.13%,12.39%,1
臺中市,東勢區,1528,133,373,506,66,572,1006,56.86%,13.22%,1
臺中市,東勢區,1529,185,477,662,30,692,1222,56.63%,15.14%,1
臺中市,東勢區,1530,204,557,761,46,807,1228,65.72%,16.61%,1
臺中市,東勢區,1531,164,455,619,27,646,1036,62.36%,15.83%,1
臺中市,東勢區,1532,160,442,602,30,632,977,64.69%,16.38%,1
臺中市,東勢區,1533,216,539,755,40,795,1395,56.99%,15.48%,1
臺中市,東勢區,1534,171,485,656,85,741,1169,63.39%,14.63%,1
臺中市,東勢區,1535,155,435,590,53,643,1027,62.61%,15.09%,1
臺中市,東勢區,1536,154,419,573,26,599,984,60.87%,15.65%,1
臺中市,東勢區,1537,146,409,555,31,586,866,67.67%,16.86%,1
臺中市,東勢區,1538,159,401,560,79,639,1031,61.98%,15.42%,1
臺中市,東勢區,1539,141,381,522,57,579,865,66.94%,16.3%,1
臺中市,東勢區,1540,197,623,820,46,866,1357,63.82%,14.52%,1
臺中市,東勢區,1541,120,303,423,33,456,736,61.96%,16.3%,1
臺中市,東勢區,1542,203,529,732,46,778,1314,59.21%,15.45%,1
臺中市,東勢區,1543,236,578,814,105,919,1677,54.8%,14.07%,1
臺中市,東勢區,1544,150,412,562,24,586,950,61.68%,15.79%,1
臺中市,東勢區,1545,147,439,586,42,628,1007,62.36%,14.6%,1
臺中市,東勢區,1546,170,425,595,38,633,1214,52.14%,14%,1
臺中市,東勢區,1547,106,375,481,43,524,907,57.77%,11.69%,1
臺中市,東勢區,1548,140,315,455,41,496,902,54.99%,15.52%,1
臺中市,東勢區,1549,92,226,318,12,330,720,45.83%,12.78%,1
臺中市,東勢區,1550,93,221,314,14,328,666,49.25%,13.96%,1
臺中市,東勢區,1551,200,496,696,51,747,1361,54.89%,14.7%,1
臺中市,大甲區,0001,234,516,750,63,813,1356,59.96%,17.26%,1
臺中市,大甲區,0002,217,406,623,42,665,1059,62.8%,20.49%,1
臺中市,大甲區,0003,139,274,413,30,443,694,63.83%,20.03%,1
臺中市,大甲區,0004,150,356,506,23,529,874,60.53%,17.16%,1
臺中市,大甲區,0005,113,294,407,22,429,763,56.23%,14.81%,1
臺中市,大甲區,0006,166,348,514,35,549,856,64.14%,19.39%,1
臺中市,大甲區,0007,215,496,711,43,754,1249,60.37%,17.21%,1
臺中市,大甲區,0008,154,337,491,29,520,922,56.4%,16.7%,1
臺中市,大甲區,0009,208,458,666,45,711,1189,59.8%,17.49%,1
臺中市,大甲區,0010,185,457,642,47,689,1065,64.69%,17.37%,1
臺中市,大甲區,0011,208,518,726,67,793,1252,63.34%,16.61%,1
臺中市,大甲區,0012,180,400,580,39,619,1057,58.56%,17.03%,1
臺中市,大甲區,0013,171,398,569,35,604,1031,58.58%,16.59%,1
臺中市,大甲區,0014,190,442,632,37,669,1060,63.11%,17.92%,1
臺中市,大甲區,0015,218,505,723,46,769,1311,58.66%,16.63%,1
臺中市,大甲區,0016,219,548,767,48,815,1424,57.23%,15.38%,1
臺中市,大甲區,0017,289,644,933,50,983,1670,58.86%,17.31%,1
臺中市,大甲區,0018,142,299,441,41,482,812,59.36%,17.49%,1
臺中市,大甲區,0019,134,370,504,29,533,863,61.76%,15.53%,1
臺中市,大甲區,0020,271,623,894,56,950,1598,59.45%,16.96%,1
臺中市,大甲區,0021,239,630,869,41,910,1588,57.3%,15.05%,1
臺中市,大甲區,0022,202,435,637,59,696,1197,58.15%,16.88%,1
臺中市,大甲區,0023,176,366,542,77,619,1106,55.97%,15.91%,1
臺中市,大甲區,0024,161,361,522,46,568,903,62.9%,17.83%,1
臺中市,大甲區,0025,142,368,510,38,548,869,63.06%,16.34%,1
臺中市,大甲區,0026,240,506,746,41,787,1350,58.3%,17.78%,1
臺中市,大甲區,0027,179,419,598,93,691,1144,60.4%,15.65%,1
臺中市,大甲區,0028,187,510,697,45,742,1208,61.42%,15.48%,1
臺中市,大甲區,0029,312,591,903,36,939,1567,59.92%,19.91%,1
臺中市,大甲區,0030,284,496,780,31,811,1246,65.09%,22.79%,1
臺中市,大甲區,0031,125,312,437,30,467,767,60.89%,16.3%,1
臺中市,大甲區,0032,136,310,446,36,482,790,61.01%,17.22%,1
臺中市,大甲區,0033,152,406,558,37,595,972,61.21%,15.64%,1
臺中市,大甲區,0034,222,494,716,54,770,1388,55.48%,15.99%,1
臺中市,大甲區,0035,195,485,680,36,716,1331,53.79%,14.65%,1
臺中市,大甲區,0036,212,475,687,40,727,1167,62.3%,18.17%,1
臺中市,大甲區,0037,622,466,1088,37,1125,1934,58.17%,32.16%,1
臺中市,大甲區,0038,200,400,600,61,661,1263,52.34%,15.84%,1
臺中市,大甲區,0039,240,508,748,47,795,1390,57.19%,17.27%,1
臺中市,大甲區,0040,166,384,550,44,594,1186,50.08%,14%,1
臺中市,大甲區,0041,234,528,762,31,793,1397,56.76%,16.75%,1
臺中市,大甲區,0042,142,367,509,21,530,1173,45.18%,12.11%,1
臺中市,大甲區,0043,243,477,720,53,773,1398,55.29%,17.38%,1
臺中市,大甲區,0044,204,385,589,51,640,1228,52.12%,16.61%,1
臺中市,大甲區,0045,200,442,642,40,682,1258,54.21%,15.9%,1
臺中市,大甲區,0046,225,522,747,42,789,1435,54.98%,15.68%,1
臺中市,大甲區,0047,268,536,804,40,844,1532,55.09%,17.49%,1
臺中市,大甲區,0048,102,249,351,31,382,652,58.59%,15.64%,1
臺中市,大甲區,0049,123,277,400,38,438,870,50.34%,14.14%,1
臺中市,大甲區,0050,124,328,452,26,478,891,53.65%,13.92%,1
臺中市,大甲區,0051,128,306,434,32,466,784,59.44%,16.33%,1
臺中市,大甲區,0052,190,474,664,87,751,1368,54.9%,13.89%,1
臺中市,大甲區,0053,165,387,552,53,605,1126,53.73%,14.65%,1
臺中市,大甲區,0054,226,447,673,67,740,1486,49.8%,15.21%,1
臺中市,清水區,0091,197,362,559,28,587,1076,54.55%,18.31%,1
臺中市,清水區,0092,211,373,584,41,625,953,65.58%,22.14%,1
臺中市,清水區,0093,189,326,515,60,575,914,62.91%,20.68%,1
臺中市,清水區,0094,228,452,680,52,732,1143,64.04%,19.95%,1
臺中市,清水區,0095,136,260,396,28,424,680,62.35%,20%,1
臺中市,清水區,0096,164,366,530,35,565,904,62.5%,18.14%,1
臺中市,清水區,0097,182,350,532,50,582,893,65.17%,20.38%,1
臺中市,清水區,0098,285,586,871,48,919,1577,58.28%,18.07%,1
臺中市,清水區,0099,119,248,367,41,408,690,59.13%,17.25%,1
臺中市,清水區,0100,84,151,235,12,247,403,61.29%,20.84%,1
臺中市,清水區,0101,266,516,782,63,845,1413,59.8%,18.83%,1
臺中市,清水區,0102,135,289,424,39,463,777,59.59%,17.37%,1
臺中市,清水區,0103,227,540,767,34,801,1313,61.01%,17.29%,1
臺中市,清水區,0104,249,596,845,48,893,1439,62.06%,17.3%,1
臺中市,清水區,0105,221,442,663,33,696,1265,55.02%,17.47%,1
臺中市,清水區,0106,251,516,767,38,805,1277,63.04%,19.66%,1
臺中市,清水區,0107,239,503,742,32,774,1276,60.66%,18.73%,1
臺中市,清水區,0108,284,558,842,25,867,1376,63.01%,20.64%,1
臺中市,清水區,0109,265,520,785,32,817,1291,63.28%,20.53%,1
臺中市,清水區,0110,318,545,863,54,917,1510,60.73%,21.06%,1
臺中市,清水區,0111,261,568,829,6,835,1524,54.79%,17.13%,1
臺中市,清水區,0112,251,508,759,38,797,1474,54.07%,17.03%,1
臺中市,清水區,0113,247,555,802,52,854,1507,56.67%,16.39%,1
臺中市,清水區,0114,247,546,793,69,862,1321,65.25%,18.7%,1
臺中市,清水區,0115,186,392,578,35,613,1157,52.98%,16.08%,1
臺中市,清水區,0116,247,468,715,46,761,1255,60.64%,19.68%,1
臺中市,清水區,0117,151,330,481,30,511,881,58%,17.14%,1
臺中市,清水區,0118,205,415,620,50,670,1083,61.87%,18.93%,1
臺中市,清水區,0119,177,388,565,29,594,951,62.46%,18.61%,1
臺中市,清水區,0120,238,505,743,40,783,1424,54.99%,16.71%,1
臺中市,清水區,0121,200,410,610,63,673,1233,54.58%,16.22%,1
臺中市,清水區,0122,204,381,585,49,634,1288,49.22%,15.84%,1
臺中市,清水區,0123,214,456,670,52,722,1200,60.17%,17.83%,1
臺中市,清水區,0124,214,721,935,25,960,1609,59.66%,13.3%,1
臺中市,清水區,0125,238,464,702,23,725,1136,63.82%,20.95%,1
臺中市,清水區,0126,189,483,672,65,737,1302,56.61%,14.52%,1
臺中市,清水區,0127,242,460,702,78,780,1373,56.81%,17.63%,1
臺中市,清水區,0128,211,379,590,66,656,1257,52.19%,16.79%,1
臺中市,清水區,0129,175,382,557,68,625,1184,52.79%,14.78%,1
臺中市,清水區,0130,188,497,685,64,749,1322,56.66%,14.22%,1
臺中市,清水區,0131,208,381,589,48,637,1193,53.39%,17.44%,1
臺中市,清水區,0132,159,300,459,88,547,927,59.01%,17.15%,1
臺中市,清水區,0133,212,393,605,64,669,1073,62.35%,19.76%,1
臺中市,清水區,0134,241,418,659,65,724,1163,62.25%,20.72%,1
臺中市,清水區,0135,124,319,443,35,478,855,55.91%,14.5%,1
臺中市,清水區,0136,140,301,441,61,502,902,55.65%,15.52%,1
臺中市,清水區,0137,268,503,771,48,819,1415,57.88%,18.94%,1
臺中市,清水區,0138,177,368,545,38,583,1066,54.69%,16.6%,1
臺中市,清水區,0139,250,480,730,68,798,1391,57.37%,17.97%,1
臺中市,清水區,0140,202,525,727,39,766,1449,52.86%,13.94%,1
臺中市,清水區,0141,246,538,784,51,835,1377,60.64%,17.86%,1
臺中市,清水區,0142,268,530,798,48,846,1423,59.45%,18.83%,1
臺中市,清水區,0143,280,619,899,42,941,1624,57.94%,17.24%,1
臺中市,清水區,0144,211,368,579,75,654,1358,48.16%,15.54%,1
臺中市,清水區,0145,231,558,789,66,855,1464,58.4%,15.78%,1
臺中市,清水區,0146,236,441,677,68,745,1211,61.52%,19.49%,1
臺中市,清水區,0147,198,585,783,24,807,1456,55.43%,13.6%,1
臺中市,清水區,0148,182,475,657,68,725,1162,62.39%,15.66%,1
臺中市,清水區,0149,206,619,825,51,876,1368,64.04%,15.06%,1
臺中市,沙鹿區,0186,258,447,705,34,739,1380,53.55%,18.7%,1
臺中市,沙鹿區,0187,160,335,495,27,522,852,61.27%,18.78%,1
臺中市,沙鹿區,0188,320,378,698,32,730,1176,62.07%,27.21%,1
臺中市,沙鹿區,0189,210,373,583,63,646,958,67.43%,21.92%,1
臺中市,沙鹿區,0190,91,207,298,37,335,488,68.65%,18.65%,1
臺中市,沙鹿區,0191,241,412,653,39,692,1177,58.79%,20.48%,1
臺中市,沙鹿區,0192,236,452,688,49,737,1285,57.35%,18.37%,1
臺中市,沙鹿區,0193,278,594,872,68,940,1736,54.15%,16.01%,1
臺中市,沙鹿區,0194,307,629,936,63,999,1628,61.36%,18.86%,1
臺中市,沙鹿區,0195,238,538,776,34,810,1469,55.14%,16.2%,1
臺中市,沙鹿區,0196,250,586,836,35,871,1423,61.21%,17.57%,1
臺中市,沙鹿區,0197,220,587,807,55,862,1444,59.7%,15.24%,1
臺中市,沙鹿區,0198,258,544,802,63,865,1469,58.88%,17.56%,1
臺中市,沙鹿區,0199,364,678,1042,62,1104,1902,58.04%,19.14%,1
臺中市,沙鹿區,0200,321,635,956,33,989,1675,59.04%,19.16%,1
臺中市,沙鹿區,0201,193,393,586,49,635,1098,57.83%,17.58%,1
臺中市,沙鹿區,0202,311,579,890,47,937,1539,60.88%,20.21%,1
臺中市,沙鹿區,0203,257,533,790,23,813,1329,61.17%,19.34%,1
臺中市,沙鹿區,0204,228,451,679,31,710,1255,56.57%,18.17%,1
臺中市,沙鹿區,0205,291,558,849,49,898,1507,59.59%,19.31%,1
臺中市,沙鹿區,0206,263,548,811,58,869,1463,59.4%,17.98%,1
臺中市,沙鹿區,0207,216,435,651,57,708,1279,55.36%,16.89%,1
臺中市,沙鹿區,0208,153,360,513,32,545,1024,53.22%,14.94%,1
臺中市,沙鹿區,0209,213,492,705,55,760,1388,54.76%,15.35%,1
臺中市,沙鹿區,0210,215,406,621,28,649,1074,60.43%,20.02%,1
臺中市,沙鹿區,0211,196,426,622,33,655,1072,61.1%,18.28%,1
臺中市,沙鹿區,0212,171,467,638,52,690,1107,62.33%,15.45%,1
臺中市,沙鹿區,0213,280,660,940,52,992,1947,50.95%,14.38%,1
臺中市,沙鹿區,0214,246,600,846,60,906,1682,53.86%,14.63%,1
臺中市,沙鹿區,0215,270,639,909,45,954,1633,58.42%,16.53%,1
臺中市,沙鹿區,0216,243,536,779,48,827,1533,53.95%,15.85%,1
臺中市,沙鹿區,0217,235,513,748,30,778,1605,48.47%,14.64%,1
臺中市,沙鹿區,0218,251,618,869,30,899,1694,53.07%,14.82%,1
臺中市,沙鹿區,0219,275,552,827,50,877,1628,53.87%,16.89%,1
臺中市,沙鹿區,0220,317,636,953,25,978,1665,58.74%,19.04%,1
臺中市,沙鹿區,0221,268,605,873,38,911,1651,55.18%,16.23%,1
臺中市,沙鹿區,0222,194,463,657,32,689,1108,62.18%,17.51%,1
臺中市,沙鹿區,0223,186,472,658,42,700,1142,61.3%,16.29%,1
臺中市,沙鹿區,0224,148,426,574,29,603,1039,58.04%,14.24%,1
臺中市,沙鹿區,0225,311,639,950,66,1016,1840,55.22%,16.9%,1
臺中市,沙鹿區,0226,325,679,1004,36,1040,1872,55.56%,17.36%,1
臺中市,沙鹿區,0227,265,525,790,48,838,1558,53.79%,17.01%,1
臺中市,沙鹿區,0228,283,584,867,38,905,1739,52.04%,16.27%,1
臺中市,沙鹿區,0229,248,546,794,51,845,1672,50.54%,14.83%,1
臺中市,沙鹿區,0230,268,611,879,31,910,1634,55.69%,16.4%,1
臺中市,沙鹿區,0231,248,530,778,49,827,1616,51.18%,15.35%,1
臺中市,沙鹿區,0232,270,593,863,44,907,1593,56.94%,16.95%,1
臺中市,沙鹿區,0233,133,384,517,23,540,981,55.05%,13.56%,1
臺中市,沙鹿區,0234,287,693,980,54,1034,1740,59.43%,16.49%,1
臺中市,沙鹿區,0235,240,481,721,47,768,1247,61.59%,19.25%,1
臺中市,沙鹿區,0236,153,455,608,16,624,1047,59.6%,14.61%,1
臺中市,沙鹿區,0237,166,434,600,66,666,1119,59.52%,14.83%,1
臺中市,沙鹿區,0238,142,415,557,22,579,1025,56.49%,13.85%,1
臺中市,梧棲區,0150,281,541,822,50,872,1541,56.59%,18.23%,1
臺中市,梧棲區,0151,291,549,840,48,888,1581,56.17%,18.41%,1
臺中市,梧棲區,0152,196,401,597,45,642,1083,59.28%,18.1%,1
臺中市,梧棲區,0153,166,342,508,22,530,876,60.5%,18.95%,1
臺中市,梧棲區,0154,183,382,565,50,615,1043,58.96%,17.55%,1
臺中市,梧棲區,0155,230,506,736,41,777,1502,51.73%,15.31%,1
臺中市,梧棲區,0156,238,509,747,54,801,1384,57.88%,17.2%,1
臺中市,梧棲區,0157,98,227,325,26,351,517,67.89%,18.96%,1
臺中市,梧棲區,0158,219,484,703,50,753,1169,64.41%,18.73%,1
臺中市,梧棲區,0159,163,321,484,40,524,863,60.72%,18.89%,1
臺中市,梧棲區,0160,207,393,600,41,641,1277,50.2%,16.21%,1
臺中市,梧棲區,0161,294,609,903,42,945,1742,54.25%,16.88%,1
臺中市,梧棲區,0162,229,503,732,61,793,1342,59.09%,17.06%,1
臺中市,梧棲區,0163,314,635,949,77,1026,1767,58.06%,17.77%,1
臺中市,梧棲區,0164,268,482,750,48,798,1542,51.75%,17.38%,1
臺中市,梧棲區,0165,244,609,853,44,897,1636,54.83%,14.91%,1
臺中市,梧棲區,0166,287,612,899,54,953,1796,53.06%,15.98%,1
臺中市,梧棲區,0167,221,540,761,39,800,1450,55.17%,15.24%,1
臺中市,梧棲區,0168,219,548,767,89,856,1548,55.3%,14.15%,1
臺中市,梧棲區,0169,239,531,770,37,807,1366,59.08%,17.5%,1
臺中市,梧棲區,0170,187,404,591,29,620,955,64.92%,19.58%,1
臺中市,梧棲區,0171,183,490,673,47,720,1305,55.17%,14.02%,1
臺中市,梧棲區,0172,164,543,707,28,735,1239,59.32%,13.24%,1
臺中市,梧棲區,0173,175,430,605,64,669,1079,62%,16.22%,1
臺中市,梧棲區,0174,193,466,659,36,695,1220,56.97%,15.82%,1
臺中市,梧棲區,0175,262,594,856,71,927,1544,60.04%,16.97%,1
臺中市,梧棲區,0176,290,549,839,47,886,1460,60.68%,19.86%,1
臺中市,梧棲區,0177,233,514,747,40,787,1292,60.91%,18.03%,1
臺中市,梧棲區,0178,219,477,696,43,739,1300,56.85%,16.85%,1
臺中市,梧棲區,0179,269,532,801,38,839,1555,53.95%,17.3%,1
臺中市,梧棲區,0180,176,360,536,42,578,1031,56.06%,17.07%,1
臺中市,梧棲區,0181,215,471,686,54,740,1277,57.95%,16.84%,1
臺中市,梧棲區,0182,174,370,544,38,582,1037,56.12%,16.78%,1
臺中市,梧棲區,0183,206,450,656,52,708,1187,59.65%,17.35%,1
臺中市,梧棲區,0184,204,510,714,44,758,1399,54.18%,14.58%,1
臺中市,梧棲區,0185,178,428,606,34,640,1135,56.39%,15.68%,1
臺中市,后里區,0357,154,351,505,42,547,852,64.2%,18.08%,1
臺中市,后里區,0358,164,424,588,62,650,1135,57.27%,14.45%,1
臺中市,后里區,0359,170,366,536,52,588,1079,54.49%,15.76%,1
臺中市,后里區,0360,248,613,861,51,912,1539,59.26%,16.11%,1
臺中市,后里區,0361,280,600,880,46,926,1591,58.2%,17.6%,1
臺中市,后里區,0362,196,488,684,39,723,1376,52.54%,14.24%,1
臺中市,后里區,0363,227,497,724,24,748,1298,57.63%,17.49%,1
臺中市,后里區,0364,254,542,796,59,855,1428,59.87%,17.79%,1
臺中市,后里區,0365,235,505,740,43,783,1178,66.47%,19.95%,1
臺中市,后里區,0366,162,458,620,36,656,1095,59.91%,14.79%,1
臺中市,后里區,0367,172,351,523,27,550,963,57.11%,17.86%,1
臺中市,后里區,0368,204,422,626,43,669,1163,57.52%,17.54%,1
臺中市,后里區,0369,191,399,590,29,619,1018,60.81%,18.76%,1
臺中市,后里區,0370,163,364,527,26,553,854,64.75%,19.09%,1
臺中市,后里區,0371,222,549,771,43,814,1485,54.81%,14.95%,1
臺中市,后里區,0372,244,563,807,51,858,1355,63.32%,18.01%,1
臺中市,后里區,0373,142,280,422,47,469,840,55.83%,16.9%,1
臺中市,后里區,0374,198,438,636,55,691,1146,60.3%,17.28%,1
臺中市,后里區,0375,289,671,960,66,1026,1669,61.47%,17.32%,1
臺中市,后里區,0376,284,678,962,85,1047,1673,62.58%,16.98%,1
臺中市,后里區,0377,279,556,835,39,874,1493,58.54%,18.69%,1
臺中市,后里區,0378,210,393,603,53,656,1052,62.36%,19.96%,1
臺中市,后里區,0379,148,333,481,17,498,909,54.79%,16.28%,1
臺中市,后里區,0380,194,421,615,64,679,1091,62.24%,17.78%,1
臺中市,后里區,0381,224,542,766,65,831,1342,61.92%,16.69%,1
臺中市,后里區,0382,183,398,581,65,646,1138,56.77%,16.08%,1
臺中市,后里區,0383,162,396,558,31,589,977,60.29%,16.58%,1
臺中市,后里區,0384,216,523,739,42,781,1584,49.31%,13.64%,1
臺中市,后里區,0385,131,375,506,33,539,915,58.91%,14.32%,1
臺中市,后里區,0386,205,462,667,71,738,1225,60.24%,16.73%,1
臺中市,后里區,0387,249,592,841,34,875,1552,56.38%,16.04%,1
臺中市,后里區,0388,252,604,856,31,887,1600,55.44%,15.75%,1
臺中市,后里區,0389,148,357,505,30,535,942,56.79%,15.71%,1
臺中市,后里區,0390,153,348,501,27,528,943,55.99%,16.22%,1
臺中市,后里區,0391,271,249,520,42,562,1055,53.27%,25.69%,1
臺中市,后里區,0392,189,387,576,55,631,1067,59.14%,17.71%,1
臺中市,后里區,0393,209,469,678,41,719,1340,53.66%,15.6%,1
臺中市,神岡區,0482,277,649,926,62,988,1684,58.67%,16.45%,1
臺中市,神岡區,0483,256,614,870,55,925,1559,59.33%,16.42%,1
臺中市,神岡區,0484,188,418,606,34,640,1095,58.45%,17.17%,1
臺中市,神岡區,0485,219,450,669,41,710,1044,68.01%,20.98%,1
臺中市,神岡區,0486,219,558,777,78,855,1310,65.27%,16.72%,1
臺中市,神岡區,0487,247,504,751,77,828,1294,63.99%,19.09%,1
臺中市,神岡區,0488,188,447,635,56,691,1143,60.45%,16.45%,1
臺中市,神岡區,0489,173,401,574,64,638,1022,62.43%,16.93%,1
臺中市,神岡區,0490,167,497,664,51,715,1269,56.34%,13.16%,1
臺中市,神岡區,0491,130,380,510,31,541,1085,49.86%,11.98%,1
臺中市,神岡區,0492,171,389,560,38,598,942,63.48%,18.15%,1
臺中市,神岡區,0493,180,459,639,41,680,1154,58.93%,15.6%,1
臺中市,神岡區,0494,215,523,738,50,788,1390,56.69%,15.47%,1
臺中市,神岡區,0495,229,573,802,66,868,1372,63.27%,16.69%,1
臺中市,神岡區,0496,192,498,690,40,730,1328,54.97%,14.46%,1
臺中市,神岡區,0497,191,372,563,17,580,1038,55.88%,18.4%,1
臺中市,神岡區,0498,214,562,776,40,816,1452,56.2%,14.74%,1
臺中市,神岡區,0499,268,627,895,60,955,1551,61.57%,17.28%,1
臺中市,神岡區,0500,262,538,800,61,861,1567,54.95%,16.72%,1
臺中市,神岡區,0501,260,543,803,38,841,1449,58.04%,17.94%,1
臺中市,神岡區,0502,188,452,640,29,669,1246,53.69%,15.09%,1
臺中市,神岡區,0503,224,582,806,54,860,1431,60.1%,15.65%,1
臺中市,神岡區,0504,236,434,670,64,734,1163,63.11%,20.29%,1
臺中市,神岡區,0505,279,559,838,74,912,1402,65.05%,19.9%,1
臺中市,神岡區,0506,231,480,711,55,766,1271,60.27%,18.17%,1
臺中市,神岡區,0507,196,480,676,59,735,1198,61.35%,16.36%,1
臺中市,神岡區,0508,197,543,740,66,806,1312,61.43%,15.02%,1
臺中市,神岡區,0509,257,589,846,61,907,1590,57.04%,16.16%,1
臺中市,神岡區,0510,214,501,715,31,746,1324,56.34%,16.16%,1
臺中市,神岡區,0511,251,506,757,31,788,1415,55.69%,17.74%,1
臺中市,神岡區,0512,254,644,898,59,957,1483,64.53%,17.13%,1
臺中市,神岡區,0513,220,509,729,36,765,1402,54.56%,15.69%,1
臺中市,神岡區,0514,208,458,666,51,717,1275,56.24%,16.31%,1
臺中市,神岡區,0515,197,467,664,41,705,1288,54.74%,15.3%,1
臺中市,神岡區,0516,147,414,561,56,617,1080,57.13%,13.61%,1
臺中市,神岡區,0517,228,502,730,30,760,1344,56.55%,16.96%,1
臺中市,神岡區,0518,200,419,619,49,668,1061,62.96%,18.85%,1
臺中市,神岡區,0519,240,456,696,50,746,1176,63.44%,20.41%,1
臺中市,神岡區,0520,218,504,722,58,780,1244,62.7%,17.52%,1
臺中市,神岡區,0521,229,553,782,66,848,1318,64.34%,17.37%,1
臺中市,神岡區,0522,225,540,765,47,812,1471,55.2%,15.3%,1
臺中市,神岡區,0523,236,563,799,77,876,1323,66.21%,17.84%,1
臺中市,潭子區,0570,222,541,763,43,806,1306,61.72%,17%,1
臺中市,潭子區,0571,211,446,657,42,699,1128,61.97%,18.71%,1
臺中市,潭子區,0572,209,489,698,48,746,1159,64.37%,18.03%,1
臺中市,潭子區,0573,308,615,923,78,1001,1630,61.41%,18.9%,1
臺中市,潭子區,0574,260,586,846,43,889,1532,58.03%,16.97%,1
臺中市,潭子區,0575,269,574,843,33,876,1677,52.24%,16.04%,1
臺中市,潭子區,0576,276,611,887,58,945,1744,54.19%,15.83%,1
臺中市,潭子區,0577,328,655,983,59,1042,1795,58.05%,18.27%,1
臺中市,潭子區,0578,213,429,642,40,682,1171,58.24%,18.19%,1
臺中市,潭子區,0579,263,532,795,25,820,1427,57.46%,18.43%,1
臺中市,潭子區,0580,258,678,936,54,990,1709,57.93%,15.1%,1
臺中市,潭子區,0581,286,651,937,49,986,1723,57.23%,16.6%,1
臺中市,潭子區,0582,244,690,934,52,986,1782,55.33%,13.69%,1
臺中市,潭子區,0583,218,499,717,50,767,1407,54.51%,15.49%,1
臺中市,潭子區,0584,343,675,1018,26,1044,1771,58.95%,19.37%,1
臺中市,潭子區,0585,336,672,1008,78,1086,1795,60.5%,18.72%,1
臺中市,潭子區,0586,296,647,943,67,1010,1612,62.66%,18.36%,1
臺中市,潭子區,0587,326,707,1033,36,1069,1894,56.44%,17.21%,1
臺中市,潭子區,0588,315,625,940,38,978,1689,57.9%,18.65%,1
臺中市,潭子區,0589,246,535,781,43,824,1525,54.03%,16.13%,1
臺中市,潭子區,0590,274,612,886,42,928,1622,57.21%,16.89%,1
臺中市,潭子區,0591,200,466,666,57,723,1200,60.25%,16.67%,1
臺中市,潭子區,0592,216,502,718,20,738,1355,54.46%,15.94%,1
臺中市,潭子區,0593,300,649,949,31,980,1777,55.15%,16.88%,1
臺中市,潭子區,0594,324,715,1039,39,1078,1923,56.06%,16.85%,1
臺中市,潭子區,0595,258,614,872,58,930,1674,55.56%,15.41%,1
臺中市,潭子區,0596,290,589,879,36,915,1451,63.06%,19.99%,1
臺中市,潭子區,0597,261,569,830,49,879,1486,59.15%,17.56%,1
臺中市,潭子區,0598,257,620,877,42,919,1511,60.82%,17.01%,1
臺中市,潭子區,0599,292,657,949,49,998,1666,59.9%,17.53%,1
臺中市,潭子區,0600,297,643,940,49,989,1750,56.51%,16.97%,1
臺中市,潭子區,0601,226,560,786,32,818,1437,56.92%,15.73%,1
臺中市,潭子區,0602,295,644,939,35,974,1735,56.14%,17%,1
臺中市,潭子區,0603,284,594,878,37,915,1612,56.76%,17.62%,1
臺中市,潭子區,0604,234,444,678,28,706,1143,61.77%,20.47%,1
臺中市,潭子區,0605,338,775,1113,41,1154,2096,55.06%,16.13%,1
臺中市,潭子區,0606,293,601,894,47,941,1549,60.75%,18.92%,1
臺中市,潭子區,0607,263,639,902,32,934,1573,59.38%,16.72%,1
臺中市,潭子區,0608,239,610,849,31,880,1585,55.52%,15.08%,1
臺中市,潭子區,0609,280,582,862,32,894,1572,56.87%,17.81%,1
臺中市,潭子區,0610,320,700,1020,35,1055,1738,60.7%,18.41%,1
臺中市,潭子區,0611,388,609,997,57,1054,1883,55.97%,20.61%,1
臺中市,潭子區,0612,239,591,830,32,862,1401,61.53%,17.06%,1
臺中市,潭子區,0613,224,578,802,44,846,1352,62.57%,16.57%,1
臺中市,潭子區,0614,329,833,1162,79,1241,2085,59.52%,15.78%,1
臺中市,潭子區,0615,340,836,1176,66,1242,2047,60.67%,16.61%,1
臺中市,潭子區,0616,300,581,881,32,913,1673,54.57%,17.93%,1
臺中市,潭子區,0617,349,684,1033,80,1113,1874,59.39%,18.62%,1
臺中市,潭子區,0618,200,386,586,54,640,1051,60.89%,19.03%,1
臺中市,潭子區,0619,283,581,864,38,902,1674,53.88%,16.91%,1
臺中市,潭子區,0620,308,711,1019,58,1077,1831,58.82%,16.82%,1
臺中市,潭子區,0621,325,705,1030,68,1098,2003,54.82%,16.23%,1
臺中市,潭子區,0622,252,585,837,43,880,1535,57.33%,16.42%,1
臺中市,潭子區,0623,301,791,1092,76,1168,2286,51.09%,13.17%,1
臺中市,潭子區,0624,251,690,941,61,1002,1861,53.84%,13.49%,1
臺中市,大雅區,0524,333,785,1118,53,1171,2027,57.77%,16.43%,1
臺中市,大雅區,0525,328,659,987,38,1025,1967,52.11%,16.68%,1
臺中市,大雅區,0526,506,494,1000,42,1042,1912,54.5%,26.46%,1
臺中市,大雅區,0527,295,609,904,45,949,1537,61.74%,19.19%,1
臺中市,大雅區,0528,262,595,857,40,897,1439,62.33%,18.21%,1
臺中市,大雅區,0529,251,534,785,54,839,1402,59.84%,17.9%,1
臺中市,大雅區,0530,353,709,1062,44,1106,2013,54.94%,17.54%,1
臺中市,大雅區,0531,717,339,1056,64,1120,1917,58.42%,37.4%,1
臺中市,大雅區,0532,359,707,1066,59,1125,2011,55.94%,17.85%,1
臺中市,大雅區,0533,293,757,1050,59,1109,1887,58.77%,15.53%,1
臺中市,大雅區,0534,302,562,864,46,910,1480,61.49%,20.41%,1
臺中市,大雅區,0535,300,697,997,48,1045,1816,57.54%,16.52%,1
臺中市,大雅區,0536,306,604,910,66,976,1898,51.42%,16.12%,1
臺中市,大雅區,0537,308,784,1092,61,1153,2008,57.42%,15.34%,1
臺中市,大雅區,0538,347,753,1100,53,1153,1976,58.35%,17.56%,1
臺中市,大雅區,0539,305,625,930,50,980,1673,58.58%,18.23%,1
臺中市,大雅區,0540,254,596,850,33,883,1409,62.67%,18.03%,1
臺中市,大雅區,0541,248,553,801,22,823,1382,59.55%,17.95%,1
臺中市,大雅區,0542,231,629,860,72,932,1635,57%,14.13%,1
臺中市,大雅區,0543,271,613,884,51,935,1565,59.74%,17.32%,1
臺中市,大雅區,0544,257,553,810,37,847,1528,55.43%,16.82%,1
臺中市,大雅區,0545,291,744,1035,34,1069,1963,54.46%,14.82%,1
臺中市,大雅區,0546,331,722,1053,38,1091,2073,52.63%,15.97%,1
臺中市,大雅區,0547,327,692,1019,82,1101,1984,55.49%,16.48%,1
臺中市,大雅區,0548,289,613,902,51,953,1688,56.46%,17.12%,1
臺中市,大雅區,0549,245,521,766,35,801,1387,57.75%,17.66%,1
臺中市,大雅區,0550,282,673,955,81,1036,1701,60.91%,16.58%,1
臺中市,大雅區,0551,278,637,915,60,975,1721,56.65%,16.15%,1
臺中市,大雅區,0552,286,578,864,39,903,1879,48.06%,15.22%,1
臺中市,大雅區,0553,294,666,960,39,999,1568,63.71%,18.75%,1
臺中市,大雅區,0554,320,622,942,86,1028,1761,58.38%,18.17%,1
臺中市,大雅區,0555,288,705,993,80,1073,1752,61.24%,16.44%,1
臺中市,大雅區,0556,219,506,725,31,756,1264,59.81%,17.33%,1
臺中市,大雅區,0557,211,559,770,37,807,1302,61.98%,16.21%,1
臺中市,大雅區,0558,255,534,789,46,835,1449,57.63%,17.6%,1
臺中市,大雅區,0559,253,673,926,81,1007,1621,62.12%,15.61%,1
臺中市,大雅區,0560,262,597,859,67,926,1647,56.22%,15.91%,1
臺中市,大雅區,0561,246,551,797,26,823,1441,57.11%,17.07%,1
臺中市,大雅區,0562,200,601,801,27,828,1460,56.71%,13.7%,1
臺中市,大雅區,0563,316,741,1057,74,1131,1832,61.74%,17.25%,1
臺中市,大雅區,0564,253,562,815,55,870,1371,63.46%,18.45%,1
臺中市,大雅區,0565,220,521,741,12,753,1418,53.1%,15.51%,1
臺中市,大雅區,0566,255,601,856,34,890,1473,60.42%,17.31%,1
臺中市,大雅區,0567,246,497,743,54,797,1335,59.7%,18.43%,1
臺中市,大雅區,0568,217,717,934,61,995,1733,57.41%,12.52%,1
臺中市,大雅區,0569,231,625,856,89,945,1884,50.16%,12.26%,1
臺中市,新社區,1562,159,397,556,28,584,1011,57.76%,15.73%,1
臺中市,新社區,1563,183,480,663,39,702,1195,58.74%,15.31%,1
臺中市,新社區,1564,191,422,613,22,635,1053,60.3%,18.14%,1
臺中市,新社區,1565,101,299,400,29,429,961,44.64%,10.51%,1
臺中市,新社區,1566,120,350,470,13,483,919,52.56%,13.06%,1
臺中市,新社區,1567,209,572,781,57,838,1367,61.3%,15.29%,1
臺中市,新社區,1568,172,345,517,30,547,1010,54.16%,17.03%,1
臺中市,新社區,1569,171,364,535,61,596,1169,50.98%,14.63%,1
臺中市,新社區,1570,179,339,518,47,565,989,57.13%,18.1%,1
臺中市,新社區,1571,138,343,481,20,501,894,56.04%,15.44%,1
臺中市,新社區,1572,134,387,521,18,539,1033,52.18%,12.97%,1
臺中市,新社區,1573,137,314,451,24,475,1058,44.9%,12.95%,1
臺中市,新社區,1574,121,289,410,15,425,845,50.3%,14.32%,1
臺中市,新社區,1575,91,266,357,28,385,576,66.84%,15.8%,1
臺中市,新社區,1576,159,420,579,50,629,1229,51.18%,12.94%,1
臺中市,新社區,1577,139,273,412,21,433,890,48.65%,15.62%,1
臺中市,新社區,1578,113,272,385,26,411,781,52.62%,14.47%,1
臺中市,新社區,1579,181,462,643,38,681,1244,54.74%,14.55%,1
臺中市,新社區,1580,22,49,71,8,79,213,37.09%,10.33%,1
臺中市,新社區,1581,81,207,288,29,317,676,46.89%,11.98%,1
臺中市,新社區,1582,56,205,261,23,284,585,48.55%,9.57%,1
臺中市,新社區,1583,106,380,486,50,536,938,57.14%,11.3%,1
臺中市,新社區,1584,21,82,103,8,111,224,49.55%,9.38%,1
臺中市,石岡區,1552,212,480,692,39,731,1244,58.76%,17.04%,1
臺中市,石岡區,1553,224,581,805,65,870,1539,56.53%,14.55%,1
臺中市,石岡區,1554,200,478,678,38,716,1202,59.57%,16.64%,1
臺中市,石岡區,1555,197,431,628,69,697,1272,54.8%,15.49%,1
臺中市,石岡區,1556,89,265,354,36,390,652,59.82%,13.65%,1
臺中市,石岡區,1557,281,606,887,71,958,1457,65.75%,19.29%,1
臺中市,石岡區,1558,316,650,966,66,1032,1836,56.21%,17.21%,1
臺中市,石岡區,1559,147,385,532,50,582,1001,58.14%,14.69%,1
臺中市,石岡區,1560,227,594,821,62,883,1448,60.98%,15.68%,1
臺中市,石岡區,1561,216,494,710,56,766,1229,62.33%,17.58%,1
臺中市,外埔區,0071,154,410,564,39,603,1059,56.94%,14.54%,1
臺中市,外埔區,0072,150,433,583,22,605,1013,59.72%,14.81%,1
臺中市,外埔區,0073,175,498,673,47,720,1150,62.61%,15.22%,1
臺中市,外埔區,0074,297,830,1127,53,1180,1855,63.61%,16.01%,1
臺中市,外埔區,0075,187,576,763,37,800,1327,60.29%,14.09%,1
臺中市,外埔區,0076,214,627,841,48,889,1453,61.18%,14.73%,1
臺中市,外埔區,0077,229,628,857,72,929,1653,56.2%,13.85%,1
臺中市,外埔區,0078,210,626,836,39,875,1615,54.18%,13%,1
臺中市,外埔區,0079,208,553,761,48,809,1470,55.03%,14.15%,1
臺中市,外埔區,0080,257,624,881,51,932,1559,59.78%,16.48%,1
臺中市,外埔區,0081,290,693,983,87,1070,1902,56.26%,15.25%,1
臺中市,外埔區,0082,204,481,685,46,731,1138,64.24%,17.93%,1
臺中市,外埔區,0083,168,442,610,70,680,1065,63.85%,15.77%,1
臺中市,外埔區,0084,230,505,735,45,780,1243,62.75%,18.5%,1
臺中市,外埔區,0085,153,321,474,54,528,962,54.89%,15.9%,1
臺中市,外埔區,0086,195,415,610,46,656,1169,56.12%,16.68%,1
臺中市,外埔區,0087,208,534,742,50,792,1216,65.13%,17.11%,1
臺中市,外埔區,0088,172,579,751,42,793,1391,57.01%,12.37%,1
臺中市,外埔區,0089,229,602,831,83,914,1616,56.56%,14.17%,1
臺中市,外埔區,0090,172,380,552,39,591,1203,49.13%,14.3%,1
臺中市,大安區,0055,149,366,515,55,570,1068,53.37%,13.95%,1
臺中市,大安區,0056,172,386,558,56,614,1050,58.48%,16.38%,1
臺中市,大安區,0057,239,453,692,68,760,1246,61%,19.18%,1
臺中市,大安區,0058,196,526,722,61,783,1397,56.05%,14.03%,1
臺中市,大安區,0059,213,498,711,57,768,1227,62.59%,17.36%,1
臺中市,大安區,0060,166,472,638,56,694,1170,59.32%,14.19%,1
臺中市,大安區,0061,160,355,515,80,595,914,65.1%,17.51%,1
臺中市,大安區,0062,87,226,313,32,345,667,51.72%,13.04%,1
臺中市,大安區,0063,143,299,442,44,486,890,54.61%,16.07%,1
臺中市,大安區,0064,210,466,676,60,736,1289,57.1%,16.29%,1
臺中市,大安區,0065,59,163,222,21,243,455,53.41%,12.97%,1
臺中市,大安區,0066,170,390,560,38,598,1028,58.17%,16.54%,1
臺中市,大安區,0067,227,559,786,80,866,1446,59.89%,15.7%,1
臺中市,大安區,0068,122,296,418,28,446,688,64.83%,17.73%,1
臺中市,大安區,0069,163,431,594,54,648,1062,61.02%,15.35%,1
臺中市,大安區,0070,189,372,561,39,600,923,65.01%,20.48%,1
臺中市,烏日區,0317,279,602,881,52,933,1480,63.04%,18.85%,1
臺中市,烏日區,0318,371,684,1055,79,1134,1841,61.6%,20.15%,1
臺中市,烏日區,0319,316,626,942,59,1001,1751,57.17%,18.05%,1
臺中市,烏日區,0320,289,600,889,67,956,1547,61.8%,18.68%,1
臺中市,烏日區,0321,313,714,1027,42,1069,1836,58.22%,17.05%,1
臺中市,烏日區,0322,282,453,735,96,831,1239,67.07%,22.76%,1
臺中市,烏日區,0323,224,448,672,68,740,1295,57.14%,17.3%,1
臺中市,烏日區,0324,231,436,667,53,720,1263,57.01%,18.29%,1
臺中市,烏日區,0325,316,547,863,43,906,1622,55.86%,19.48%,1
臺中市,烏日區,0326,268,688,956,82,1038,1822,56.97%,14.71%,1
臺中市,烏日區,0327,332,696,1028,59,1087,1966,55.29%,16.89%,1
臺中市,烏日區,0328,285,614,899,52,951,1615,58.89%,17.65%,1
臺中市,烏日區,0329,235,469,704,43,747,1232,60.63%,19.07%,1
臺中市,烏日區,0330,220,489,709,40,749,1347,55.61%,16.33%,1
臺中市,烏日區,0331,201,383,584,42,626,1165,53.73%,17.25%,1
臺中市,烏日區,0332,303,653,956,47,1003,1664,60.28%,18.21%,1
臺中市,烏日區,0333,224,504,728,43,771,1230,62.68%,18.21%,1
臺中市,烏日區,0334,267,627,894,92,986,1574,62.64%,16.96%,1
臺中市,烏日區,0335,285,596,881,43,924,1452,63.64%,19.63%,1
臺中市,烏日區,0336,286,685,971,58,1029,1879,54.76%,15.22%,1
臺中市,烏日區,0337,296,583,879,41,920,1601,57.46%,18.49%,1
臺中市,烏日區,0338,278,632,910,45,955,1546,61.77%,17.98%,1
臺中市,烏日區,0339,293,610,903,43,946,1866,50.7%,15.7%,1
臺中市,烏日區,0340,338,752,1090,63,1153,1938,59.49%,17.44%,1
臺中市,烏日區,0341,337,631,968,69,1037,1759,58.95%,19.16%,1
臺中市,烏日區,0342,348,687,1035,76,1111,2061,53.91%,16.89%,1
臺中市,烏日區,0343,293,658,951,54,1005,1691,59.43%,17.33%,1
臺中市,烏日區,0344,201,445,646,36,682,1039,65.64%,19.35%,1
臺中市,烏日區,0345,206,499,705,41,746,1221,61.1%,16.87%,1
臺中市,烏日區,0346,297,635,932,72,1004,1650,60.85%,18%,1
臺中市,烏日區,0347,184,353,537,44,581,937,62.01%,19.64%,1
臺中市,烏日區,0348,236,458,694,39,733,1220,60.08%,19.34%,1
臺中市,烏日區,0349,303,720,1023,121,1144,2139,53.48%,14.17%,1
臺中市,烏日區,0350,239,587,826,58,884,1371,64.48%,17.43%,1
臺中市,烏日區,0351,201,494,695,60,755,1277,59.12%,15.74%,1
臺中市,烏日區,0352,259,621,880,69,949,1708,55.56%,15.16%,1
臺中市,烏日區,0353,293,767,1060,89,1149,2048,56.1%,14.31%,1
臺中市,烏日區,0354,269,587,856,54,910,1632,55.76%,16.48%,1
臺中市,烏日區,0355,218,511,729,76,805,1327,60.66%,16.43%,1
臺中市,烏日區,0356,119,315,434,65,499,854,58.43%,13.93%,1
臺中市,大肚區,0284,212,557,769,33,802,1415,56.68%,14.98%,1
臺中市,大肚區,0285,215,480,695,51,746,1392,53.59%,15.45%,1
臺中市,大肚區,0286,256,620,876,46,922,1520,60.66%,16.84%,1
臺中市,大肚區,0287,165,362,527,56,583,862,67.63%,19.14%,1
臺中市,大肚區,0288,200,534,734,48,782,1256,62.26%,15.92%,1
臺中市,大肚區,0289,207,496,703,46,749,1292,57.97%,16.02%,1
臺中市,大肚區,0290,169,410,579,37,616,1010,60.99%,16.73%,1
臺中市,大肚區,0291,271,564,835,83,918,1485,61.82%,18.25%,1
臺中市,大肚區,0292,210,500,710,58,768,1190,64.54%,17.65%,1
臺中市,大肚區,0293,209,461,670,74,744,1250,59.52%,16.72%,1
臺中市,大肚區,0294,280,459,739,42,781,1310,59.62%,21.37%,1
臺中市,大肚區,0295,226,470,696,42,738,1294,57.03%,17.47%,1
臺中市,大肚區,0296,292,739,1031,60,1091,1734,62.92%,16.84%,1
臺中市,大肚區,0297,211,511,722,51,773,1316,58.74%,16.03%,1
臺中市,大肚區,0298,159,312,471,40,511,854,59.84%,18.62%,1
臺中市,大肚區,0299,247,539,786,35,821,1273,64.49%,19.4%,1
臺中市,大肚區,0300,150,369,519,23,542,851,63.69%,17.63%,1
臺中市,大肚區,0301,251,627,878,43,921,1629,56.54%,15.41%,1
臺中市,大肚區,0302,273,615,888,85,973,1709,56.93%,15.97%,1
臺中市,大肚區,0303,142,356,498,32,530,953,55.61%,14.9%,1
臺中市,大肚區,0304,202,556,758,54,812,1336,60.78%,15.12%,1
臺中市,大肚區,0305,349,711,1060,86,1146,2113,54.24%,16.52%,1
臺中市,大肚區,0306,290,633,923,98,1021,1730,59.02%,16.76%,1
臺中市,大肚區,0307,313,605,918,37,955,1692,56.44%,18.5%,1
臺中市,大肚區,0308,252,706,958,51,1009,1747,57.76%,14.42%,1
臺中市,大肚區,0309,290,604,894,65,959,1672,57.36%,17.34%,1
臺中市,大肚區,0310,256,607,863,40,903,1675,53.91%,15.28%,1
臺中市,大肚區,0311,227,674,901,62,963,1673,57.56%,13.57%,1
臺中市,大肚區,0312,298,618,916,52,968,1636,59.17%,18.22%,1
臺中市,大肚區,0313,270,618,888,66,954,1753,54.42%,15.4%,1
臺中市,大肚區,0314,203,482,685,29,714,1343,53.16%,15.12%,1
臺中市,大肚區,0315,314,654,968,56,1024,1822,56.2%,17.23%,1
臺中市,大肚區,0316,251,693,944,91,1035,1670,61.98%,15.03%,1
臺中市,龍井區,0239,324,677,1001,63,1064,1758,60.52%,18.43%,1
臺中市,龍井區,0240,204,488,692,47,739,1275,57.96%,16%,1
臺中市,龍井區,0241,196,455,651,32,683,1379,49.53%,14.21%,1
臺中市,龍井區,0242,208,488,696,54,750,1403,53.46%,14.83%,1
臺中市,龍井區,0243,150,376,526,44,570,974,58.52%,15.4%,1
臺中市,龍井區,0244,156,465,621,36,657,901,72.92%,17.31%,1
臺中市,龍井區,0245,315,604,919,79,998,1779,56.1%,17.71%,1
臺中市,龍井區,0246,321,568,889,71,960,1609,59.66%,19.95%,1
臺中市,龍井區,0247,150,367,517,29,546,1038,52.6%,14.45%,1
臺中市,龍井區,0248,234,527,761,57,818,1328,61.6%,17.62%,1
臺中市,龍井區,0249,151,388,539,37,576,921,62.54%,16.4%,1
臺中市,龍井區,0250,234,545,779,68,847,1609,52.64%,14.54%,1
臺中市,龍井區,0251,185,414,599,21,620,1227,50.53%,15.08%,1
臺中市,龍井區,0252,185,485,670,56,726,1278,56.81%,14.48%,1
臺中市,龍井區,0253,129,276,405,16,421,914,46.06%,14.11%,1
臺中市,龍井區,0254,246,545,791,41,832,1678,49.58%,14.66%,1
臺中市,龍井區,0255,189,422,611,37,648,1233,52.55%,15.33%,1
臺中市,龍井區,0256,258,544,802,59,861,1520,56.64%,16.97%,1
臺中市,龍井區,0257,280,664,944,43,987,1905,51.81%,14.7%,1
臺中市,龍井區,0258,264,588,852,58,910,1520,59.87%,17.37%,1
臺中市,龍井區,0259,202,488,690,62,752,1385,54.3%,14.58%,1
臺中市,龍井區,0260,224,423,647,35,682,1212,56.27%,18.48%,1
臺中市,龍井區,0261,230,564,794,27,821,1432,57.33%,16.06%,1
臺中市,龍井區,0262,262,585,847,42,889,1663,53.46%,15.75%,1
臺中市,龍井區,0263,230,491,721,42,763,1422,53.66%,16.17%,1
臺中市,龍井區,0264,249,498,747,70,817,1616,50.56%,15.41%,1
臺中市,龍井區,0265,241,546,787,56,843,1422,59.28%,16.95%,1
臺中市,龍井區,0266,221,433,654,38,692,1165,59.4%,18.97%,1
臺中市,龍井區,0267,323,571,894,6,900,1624,55.42%,19.89%,1
臺中市,龍井區,0268,257,596,853,57,910,1613,56.42%,15.93%,1
臺中市,龍井區,0269,159,388,547,45,592,943,62.78%,16.86%,1
臺中市,龍井區,0270,239,553,792,72,864,1595,54.17%,14.98%,1
臺中市,龍井區,0271,260,563,823,66,889,1508,58.95%,17.24%,1
臺中市,龍井區,0272,227,548,775,32,807,1479,54.56%,15.35%,1
臺中市,龍井區,0273,274,549,823,52,875,1509,57.99%,18.16%,1
臺中市,龍井區,0274,272,626,898,68,966,1582,61.06%,17.19%,1
臺中市,龍井區,0275,304,631,935,54,989,1725,57.33%,17.62%,1
臺中市,龍井區,0276,265,629,894,39,933,1616,57.74%,16.4%,1
臺中市,龍井區,0277,305,634,939,40,979,1657,59.08%,18.41%,1
臺中市,龍井區,0278,389,604,993,39,1032,1774,58.17%,21.93%,1
臺中市,龍井區,0279,364,619,983,55,1038,1701,61.02%,21.4%,1
臺中市,龍井區,0280,207,422,629,34,663,1121,59.14%,18.47%,1
臺中市,龍井區,0281,193,383,576,46,622,987,63.02%,19.55%,1
臺中市,龍井區,0282,222,439,661,50,711,1206,58.96%,18.41%,1
臺中市,龍井區,0283,246,560,806,41,847,1378,61.47%,17.85%,1
臺中市,霧峰區,1470,225,473,698,48,746,1205,61.91%,18.67%,1
臺中市,霧峰區,1471,269,599,868,49,917,1620,56.6%,16.6%,1
臺中市,霧峰區,1472,312,597,909,56,965,1559,61.9%,20.01%,1
臺中市,霧峰區,1473,296,596,892,65,957,1660,57.65%,17.83%,1
臺中市,霧峰區,1474,279,648,927,57,984,1602,61.42%,17.42%,1
臺中市,霧峰區,1475,216,470,686,47,733,1325,55.32%,16.3%,1
臺中市,霧峰區,1476,239,590,829,62,891,1515,58.81%,15.78%,1
臺中市,霧峰區,1477,248,564,812,54,866,1561,55.48%,15.89%,1
臺中市,霧峰區,1478,264,613,877,39,916,1691,54.17%,15.61%,1
臺中市,霧峰區,1479,239,566,805,57,862,1486,58.01%,16.08%,1
臺中市,霧峰區,1480,160,407,567,44,611,975,62.67%,16.41%,1
臺中市,霧峰區,1481,216,577,793,57,850,1358,62.59%,15.91%,1
臺中市,霧峰區,1482,224,494,718,31,749,1141,65.64%,19.63%,1
臺中市,霧峰區,1483,152,372,524,42,566,855,66.2%,17.78%,1
臺中市,霧峰區,1484,211,505,716,46,762,1202,63.39%,17.55%,1
臺中市,霧峰區,1485,165,407,572,36,608,1078,56.4%,15.31%,1
臺中市,霧峰區,1486,292,579,871,61,932,1456,64.01%,20.05%,1
臺中市,霧峰區,1487,300,615,915,41,956,1573,60.78%,19.07%,1
臺中市,霧峰區,1488,255,646,901,42,943,1591,59.27%,16.03%,1
臺中市,霧峰區,1489,222,508,730,52,782,1214,64.42%,18.29%,1
臺中市,霧峰區,1490,199,486,685,46,731,1267,57.7%,15.71%,1
臺中市,霧峰區,1491,229,485,714,47,761,1277,59.59%,17.93%,1
臺中市,霧峰區,1492,252,490,742,41,783,1366,57.32%,18.45%,1
臺中市,霧峰區,1493,219,423,642,48,690,994,69.42%,22.03%,1
臺中市,霧峰區,1494,159,367,526,27,553,863,64.08%,18.42%,1
臺中市,霧峰區,1495,222,468,690,49,739,1274,58.01%,17.43%,1
臺中市,霧峰區,1496,193,426,619,69,688,1162,59.21%,16.61%,1
臺中市,霧峰區,1497,197,608,805,70,875,1252,69.89%,15.73%,1
臺中市,霧峰區,1498,232,500,732,56,788,1322,59.61%,17.55%,1
臺中市,霧峰區,1499,207,460,667,44,711,1116,63.71%,18.55%,1
臺中市,霧峰區,1500,221,431,652,87,739,1156,63.93%,19.12%,1
臺中市,霧峰區,1501,169,512,681,48,729,1147,63.56%,14.73%,1
臺中市,霧峰區,1502,141,447,588,42,630,928,67.89%,15.19%,1
臺中市,霧峰區,1503,193,492,685,44,729,1296,56.25%,14.89%,1
臺中市,霧峰區,1504,225,426,651,68,719,1314,54.72%,17.12%,1
臺中市,霧峰區,1505,215,537,752,56,808,1328,60.84%,16.19%,1
臺中市,霧峰區,1506,196,331,527,59,586,989,59.25%,19.82%,1
臺中市,霧峰區,1507,200,418,618,63,681,1088,62.59%,18.38%,1
臺中市,霧峰區,1508,215,590,805,56,861,1363,63.17%,15.77%,1
臺中市,霧峰區,1509,269,632,901,63,964,1573,61.28%,17.1%,1
臺中市,霧峰區,1510,162,430,592,86,678,1117,60.7%,14.5%,1
臺中市,霧峰區,1511,227,563,790,74,864,1342,64.38%,16.92%,1
臺中市,霧峰區,1512,187,429,616,68,684,1024,66.8%,18.26%,1
臺中市,太平區,1271,301,629,930,72,1002,1821,55.02%,16.53%,1
臺中市,太平區,1272,233,595,828,42,870,1680,51.79%,13.87%,1
臺中市,太平區,1273,318,717,1035,96,1131,1947,58.09%,16.33%,1
臺中市,太平區,1274,322,740,1062,75,1137,1910,59.53%,16.86%,1
臺中市,太平區,1275,321,654,975,42,1017,1894,53.7%,16.95%,1
臺中市,太平區,1276,340,692,1032,53,1085,1953,55.56%,17.41%,1
臺中市,太平區,1277,316,674,990,73,1063,1846,57.58%,17.12%,1
臺中市,太平區,1278,255,588,843,50,893,1493,59.81%,17.08%,1
臺中市,太平區,1279,229,616,845,47,892,1605,55.58%,14.27%,1
臺中市,太平區,1280,286,634,920,48,968,1619,59.79%,17.67%,1
臺中市,太平區,1281,320,729,1049,67,1116,2011,55.49%,15.91%,1
臺中市,太平區,1282,348,708,1056,30,1086,2056,52.82%,16.93%,1
臺中市,太平區,1283,327,652,979,57,1036,1876,55.22%,17.43%,1
臺中市,太平區,1284,294,638,932,58,990,1815,54.55%,16.2%,1
臺中市,太平區,1285,208,467,675,46,721,1281,56.28%,16.24%,1
臺中市,太平區,1286,186,412,598,49,647,1004,64.44%,18.53%,1
臺中市,太平區,1287,348,707,1055,70,1125,1886,59.65%,18.45%,1
臺中市,太平區,1288,237,549,786,74,860,1431,60.1%,16.56%,1
臺中市,太平區,1289,334,663,997,63,1060,1930,54.92%,17.31%,1
臺中市,太平區,1290,331,739,1070,54,1124,2164,51.94%,15.3%,1
臺中市,太平區,1291,305,753,1058,62,1120,2048,54.69%,14.89%,1
臺中市,太平區,1292,311,723,1034,53,1087,2035,53.42%,15.28%,1
臺中市,太平區,1293,291,573,864,70,934,1685,55.43%,17.27%,1
臺中市,太平區,1294,318,678,996,85,1081,2185,49.47%,14.55%,1
臺中市,太平區,1295,186,420,606,24,630,1176,53.57%,15.82%,1
臺中市,太平區,1296,260,579,839,26,865,1597,54.16%,16.28%,1
臺中市,太平區,1297,218,475,693,57,750,1378,54.43%,15.82%,1
臺中市,太平區,1298,232,589,821,36,857,1546,55.43%,15.01%,1
臺中市,太平區,1299,301,601,902,60,962,1890,50.9%,15.93%,1
臺中市,太平區,1300,163,391,554,43,597,1053,56.7%,15.48%,1
臺中市,太平區,1301,262,624,886,78,964,1582,60.94%,16.56%,1
臺中市,太平區,1302,292,675,967,40,1007,1699,59.27%,17.19%,1
臺中市,太平區,1303,258,493,751,63,814,1493,54.52%,17.28%,1
臺中市,太平區,1304,166,371,537,35,572,1063,53.81%,15.62%,1
臺中市,太平區,1305,188,444,632,39,671,1117,60.07%,16.83%,1
臺中市,太平區,1306,197,425,622,33,655,1084,60.42%,18.17%,1
臺中市,太平區,1307,309,595,904,35,939,1776,52.87%,17.4%,1
臺中市,太平區,1308,279,601,880,57,937,1729,54.19%,16.14%,1
臺中市,太平區,1309,240,534,774,62,836,1658,50.42%,14.48%,1
臺中市,太平區,1310,277,738,1015,53,1068,2010,53.13%,13.78%,1
臺中市,太平區,1311,272,607,879,54,933,1752,53.25%,15.53%,1
臺中市,太平區,1312,294,640,934,56,990,1654,59.85%,17.78%,1
臺中市,太平區,1313,216,519,735,33,768,1951,39.36%,11.07%,1
臺中市,太平區,1314,411,868,1279,80,1359,2170,62.63%,18.94%,1
臺中市,太平區,1315,408,880,1288,58,1346,2231,60.33%,18.29%,1
臺中市,太平區,1316,287,615,902,39,941,1623,57.98%,17.68%,1
臺中市,太平區,1317,208,525,733,42,775,1548,50.06%,13.44%,1
臺中市,太平區,1318,232,517,749,48,797,1442,55.27%,16.09%,1
臺中市,太平區,1319,213,482,695,38,733,1501,48.83%,14.19%,1
臺中市,太平區,1320,325,654,979,29,1008,2025,49.78%,16.05%,1
臺中市,太平區,1321,308,653,961,58,1019,1885,54.06%,16.34%,1
臺中市,太平區,1322,336,649,985,71,1056,2155,49%,15.59%,1
臺中市,太平區,1323,272,587,859,49,908,1775,51.15%,15.32%,1
臺中市,太平區,1324,277,588,865,69,934,2021,46.21%,13.71%,1
臺中市,太平區,1325,346,785,1131,69,1200,2075,57.83%,16.67%,1
臺中市,太平區,1326,290,580,870,37,907,1723,52.64%,16.83%,1
臺中市,太平區,1327,348,746,1094,51,1145,2049,55.88%,16.98%,1
臺中市,太平區,1328,245,515,760,22,782,1415,55.27%,17.31%,1
臺中市,太平區,1329,305,662,967,38,1005,1778,56.52%,17.15%,1
臺中市,太平區,1330,283,587,870,36,906,1706,53.11%,16.59%,1
臺中市,太平區,1331,367,722,1089,38,1127,2090,53.92%,17.56%,1
臺中市,太平區,1332,329,638,967,78,1045,2093,49.93%,15.72%,1
臺中市,太平區,1333,219,566,785,32,817,1688,48.4%,12.97%,1
臺中市,太平區,1334,253,465,718,35,753,1488,50.6%,17%,1
臺中市,太平區,1335,275,649,924,47,971,1667,58.25%,16.5%,1
臺中市,太平區,1336,305,671,976,54,1030,1793,57.45%,17.01%,1
臺中市,太平區,1337,366,684,1050,33,1083,1903,56.91%,19.23%,1
臺中市,太平區,1338,285,679,964,63,1027,1834,56%,15.54%,1
臺中市,太平區,1339,241,560,801,33,834,1526,54.65%,15.79%,1
臺中市,太平區,1340,340,570,910,20,930,1483,62.71%,22.93%,1
臺中市,太平區,1341,343,592,935,26,961,1694,56.73%,20.25%,1
臺中市,太平區,1342,313,633,946,29,975,1952,49.95%,16.03%,1
臺中市,太平區,1343,346,698,1044,46,1090,1995,54.64%,17.34%,1
臺中市,太平區,1344,259,488,747,14,761,1311,58.05%,19.76%,1
臺中市,太平區,1345,398,583,981,37,1018,1537,66.23%,25.89%,1
臺中市,太平區,1346,296,649,945,52,997,1974,50.51%,14.99%,1
臺中市,太平區,1347,324,669,993,43,1036,1828,56.67%,17.72%,1
臺中市,太平區,1348,372,666,1038,47,1085,2191,49.52%,16.98%,1
臺中市,太平區,1349,234,662,896,80,976,1825,53.48%,12.82%,1
臺中市,太平區,1350,222,546,768,18,786,1559,50.42%,14.24%,1
臺中市,太平區,1351,196,444,640,53,693,1225,56.57%,16%,1
臺中市,太平區,1352,219,651,870,57,927,1678,55.24%,13.05%,1
臺中市,太平區,1353,229,490,719,83,802,1501,53.43%,15.26%,1
臺中市,太平區,1354,274,571,845,74,919,1450,63.38%,18.9%,1
臺中市,太平區,1355,333,712,1045,66,1111,2126,52.26%,15.66%,1
臺中市,太平區,1356,97,313,410,38,448,699,64.09%,13.88%,1
臺中市,太平區,1357,240,457,697,40,737,1428,51.61%,16.81%,1
臺中市,太平區,1358,387,407,794,77,871,1666,52.28%,23.23%,1
臺中市,太平區,1359,207,467,674,41,715,1241,57.61%,16.68%,1
臺中市,太平區,1360,208,487,695,61,756,1266,59.72%,16.43%,1
臺中市,太平區,1361,177,447,624,46,670,1166,57.46%,15.18%,1
臺中市,太平區,1362,300,687,987,69,1056,1790,58.99%,16.76%,1
臺中市,太平區,1363,212,556,768,47,815,1754,46.47%,12.09%,1
臺中市,大里區,1364,260,557,817,33,850,1614,52.66%,16.11%,1
臺中市,大里區,1365,236,533,769,38,807,1599,50.47%,14.76%,1
臺中市,大里區,1366,547,271,818,56,874,1715,50.96%,31.9%,1
臺中市,大里區,1367,216,498,714,22,736,1264,58.23%,17.09%,1
臺中市,大里區,1368,240,484,724,34,758,1416,53.53%,16.95%,1
臺中市,大里區,1369,191,432,623,33,656,1188,55.22%,16.08%,1
臺中市,大里區,1370,223,465,688,62,750,1359,55.19%,16.41%,1
臺中市,大里區,1371,242,561,803,47,850,1457,58.34%,16.61%,1
臺中市,大里區,1372,226,562,788,44,832,1403,59.3%,16.11%,1
臺中市,大里區,1373,285,628,913,40,953,1697,56.16%,16.79%,1
臺中市,大里區,1374,328,673,1001,87,1088,1811,60.08%,18.11%,1
臺中市,大里區,1375,297,689,986,50,1036,1830,56.61%,16.23%,1
臺中市,大里區,1376,265,602,867,99,966,2228,43.36%,11.89%,1
臺中市,大里區,1377,343,705,1048,64,1112,1997,55.68%,17.18%,1
臺中市,大里區,1378,438,830,1268,32,1300,2033,63.94%,21.54%,1
臺中市,大里區,1379,360,675,1035,43,1078,1835,58.75%,19.62%,1
臺中市,大里區,1380,237,471,708,25,733,1268,57.81%,18.69%,1
臺中市,大里區,1381,289,627,916,46,962,1645,58.48%,17.57%,1
臺中市,大里區,1382,312,594,906,29,935,1561,59.9%,19.99%,1
臺中市,大里區,1383,265,556,821,28,849,1301,65.26%,20.37%,1
臺中市,大里區,1384,270,571,841,61,902,1621,55.64%,16.66%,1
臺中市,大里區,1385,309,630,939,49,988,1797,54.98%,17.2%,1
臺中市,大里區,1386,198,451,649,26,675,1230,54.88%,16.1%,1
臺中市,大里區,1387,219,562,781,44,825,1488,55.44%,14.72%,1
臺中市,大里區,1388,266,464,730,68,798,1459,54.69%,18.23%,1
臺中市,大里區,1389,294,607,901,43,944,1647,57.32%,17.85%,1
臺中市,大里區,1390,198,436,634,55,689,1100,62.64%,18%,1
臺中市,大里區,1391,250,513,763,49,812,1410,57.59%,17.73%,1
臺中市,大里區,1392,265,627,892,69,961,1807,53.18%,14.67%,1
臺中市,大里區,1393,236,491,727,44,771,1331,57.93%,17.73%,1
臺中市,大里區,1394,227,714,941,29,970,1801,53.86%,12.6%,1
臺中市,大里區,1395,333,606,939,35,974,1909,51.02%,17.44%,1
臺中市,大里區,1396,307,506,813,55,868,1699,51.09%,18.07%,1
臺中市,大里區,1397,304,589,893,47,940,1627,57.78%,18.68%,1
臺中市,大里區,1398,354,644,998,44,1042,1912,54.5%,18.51%,1
臺中市,大里區,1399,261,613,874,68,942,1753,53.74%,14.89%,1
臺中市,大里區,1400,255,587,842,47,889,1602,55.49%,15.92%,1
臺中市,大里區,1401,215,408,623,48,671,1144,58.65%,18.79%,1
臺中市,大里區,1402,281,638,919,59,978,1655,59.09%,16.98%,1
臺中市,大里區,1403,262,498,760,48,808,1438,56.19%,18.22%,1
臺中市,大里區,1404,198,350,548,50,598,1000,59.8%,19.8%,1
臺中市,大里區,1405,295,613,908,56,964,1711,56.34%,17.24%,1
臺中市,大里區,1406,264,642,906,13,919,1698,54.12%,15.55%,1
臺中市,大里區,1407,305,693,998,77,1075,1914,56.17%,15.94%,1
臺中市,大里區,1408,297,535,832,31,863,1465,58.91%,20.27%,1
臺中市,大里區,1409,263,577,840,64,904,1581,57.18%,16.64%,1
臺中市,大里區,1410,230,613,843,57,900,1509,59.64%,15.24%,1
臺中市,大里區,1411,247,575,822,28,850,1570,54.14%,15.73%,1
臺中市,大里區,1412,276,516,792,35,827,1425,58.04%,19.37%,1
臺中市,大里區,1413,258,506,764,56,820,1384,59.25%,18.64%,1
臺中市,大里區,1414,181,387,568,26,594,1204,49.34%,15.03%,1
臺中市,大里區,1415,278,589,867,27,894,1761,50.77%,15.79%,1
臺中市,大里區,1416,216,470,686,30,716,1473,48.61%,14.66%,1
臺中市,大里區,1417,257,622,879,71,950,1675,56.72%,15.34%,1
臺中市,大里區,1418,274,656,930,56,986,1755,56.18%,15.61%,1
臺中市,大里區,1419,273,590,863,79,942,1593,59.13%,17.14%,1
臺中市,大里區,1420,203,720,923,67,990,1799,55.03%,11.28%,1
臺中市,大里區,1421,282,572,854,64,918,1606,57.16%,17.56%,1
臺中市,大里區,1422,318,666,984,41,1025,1875,54.67%,16.96%,1
臺中市,大里區,1423,300,605,905,52,957,1670,57.31%,17.96%,1
臺中市,大里區,1424,337,646,983,55,1038,1898,54.69%,17.76%,1
臺中市,大里區,1425,300,562,862,30,892,1679,53.13%,17.87%,1
臺中市,大里區,1426,219,481,700,57,757,1373,55.13%,15.95%,1
臺中市,大里區,1427,208,487,695,57,752,1299,57.89%,16.01%,1
臺中市,大里區,1428,247,533,780,36,816,1430,57.06%,17.27%,1
臺中市,大里區,1429,354,751,1105,39,1144,1805,63.38%,19.61%,1
臺中市,大里區,1430,426,730,1156,17,1173,1806,64.95%,23.59%,1
臺中市,大里區,1431,383,758,1141,45,1186,1826,64.95%,20.97%,1
臺中市,大里區,1432,329,801,1130,50,1180,1805,65.37%,18.23%,1
臺中市,大里區,1433,388,720,1108,40,1148,1907,60.2%,20.35%,1
臺中市,大里區,1434,107,564,671,26,697,1103,63.19%,9.7%,1
臺中市,大里區,1435,530,245,775,59,834,1419,58.77%,37.35%,1
臺中市,大里區,1436,185,574,759,60,819,1434,57.11%,12.9%,1
臺中市,大里區,1437,275,634,909,42,951,1875,50.72%,14.67%,1
臺中市,大里區,1438,335,647,982,50,1032,1862,55.42%,17.99%,1
臺中市,大里區,1439,328,635,963,32,995,1850,53.78%,17.73%,1
臺中市,大里區,1440,278,597,875,60,935,1622,57.64%,17.14%,1
臺中市,大里區,1441,302,663,965,52,1017,1638,62.09%,18.44%,1
臺中市,大里區,1442,302,655,957,62,1019,1633,62.4%,18.49%,1
臺中市,大里區,1443,321,591,912,41,953,1662,57.34%,19.31%,1
臺中市,大里區,1444,409,705,1114,33,1147,1917,59.83%,21.34%,1
臺中市,大里區,1445,262,574,836,58,894,1701,52.56%,15.4%,1
臺中市,大里區,1446,249,529,778,55,833,1549,53.78%,16.07%,1
臺中市,大里區,1447,276,627,903,43,946,1567,60.37%,17.61%,1
臺中市,大里區,1448,273,603,876,51,927,1614,57.43%,16.91%,1
臺中市,大里區,1449,316,653,969,78,1047,1811,57.81%,17.45%,1
臺中市,大里區,1450,231,486,717,42,759,1336,56.81%,17.29%,1
臺中市,大里區,1451,264,646,910,49,959,1759,54.52%,15.01%,1
臺中市,大里區,1452,264,624,888,58,946,1783,53.06%,14.81%,1
臺中市,大里區,1453,245,581,826,56,882,1736,50.81%,14.11%,1
臺中市,大里區,1454,300,713,1013,53,1066,1874,56.88%,16.01%,1
臺中市,大里區,1455,327,663,990,72,1062,1889,56.22%,17.31%,1
臺中市,大里區,1456,268,739,1007,63,1070,1947,54.96%,13.76%,1
臺中市,大里區,1457,327,768,1095,37,1132,1938,58.41%,16.87%,1
臺中市,大里區,1458,295,664,959,65,1024,1836,55.77%,16.07%,1
臺中市,大里區,1459,290,703,993,64,1057,1913,55.25%,15.16%,1
臺中市,大里區,1460,274,669,943,76,1019,1913,53.27%,14.32%,1
臺中市,大里區,1461,255,716,971,41,1012,1937,52.25%,13.16%,1
臺中市,大里區,1462,227,553,780,40,820,1508,54.38%,15.05%,1
臺中市,大里區,1463,234,533,767,34,801,1340,59.78%,17.46%,1
臺中市,大里區,1464,271,646,917,56,973,1656,58.76%,16.36%,1
臺中市,大里區,1465,203,500,703,31,734,1290,56.9%,15.74%,1
臺中市,大里區,1466,279,606,885,35,920,1655,55.59%,16.86%,1
臺中市,大里區,1467,213,401,614,23,637,1260,50.56%,16.9%,1
臺中市,大里區,1468,244,476,720,26,746,1247,59.82%,19.57%,1
臺中市,大里區,1469,239,543,782,86,868,1548,56.07%,15.44%,1
臺中市,和平區,1585,169,399,568,46,614,956,64.23%,17.68%,1
臺中市,和平區,1586,131,467,598,35,633,963,65.73%,13.6%,1
臺中市,和平區,1587,74,182,256,15,271,456,59.43%,16.23%,1
臺中市,和平區,1588,118,488,606,54,660,1011,65.28%,11.67%,1
臺中市,和平區,1589,71,298,369,15,384,636,60.38%,11.16%,1
臺中市,和平區,1590,27,147,174,7,181,270,67.04%,10%,1
臺中市,和平區,1591,55,282,337,20,357,460,77.61%,11.96%,1
臺中市,和平區,1592,50,176,226,17,243,321,75.7%,15.58%,1
臺中市,和平區,1593,143,337,480,36,516,783,65.9%,18.26%,1
臺中市,和平區,1594,57,160,217,14,231,336,68.75%,16.96%,1
臺中市,和平區,1595,85,224,309,12,321,451,71.18%,18.85%,1
臺中市,和平區,1596,35,158,193,15,208,366,56.83%,9.56%,1
臺中市,和平區,1597,79,271,350,12,362,771,46.95%,10.25%,1
臺中市,和平區,1598,61,231,292,29,321,574,55.92%,10.63%,1
臺中市,和平區,1599,32,125,157,14,171,274,62.41%,11.68%,1
臺中市,和平區,1600,20,60,80,7,87,157,55.41%,12.74%,1
臺中市,和平區,1601,73,343,416,28,444,713,62.27%,10.24%,1
臺南市,新營區,0116,248,503,751,44,795,1693,46.96%,14.65%,1
臺南市,新營區,0117,275,544,819,53,872,1561,55.86%,17.62%,1
臺南市,新營區,0118,248,526,774,33,807,1487,54.27%,16.68%,1
臺南市,新營區,0119,206,418,624,15,639,1232,51.87%,16.72%,1
臺南市,新營區,0120,196,329,525,20,545,1067,51.08%,18.37%,1
臺南市,新營區,0121,227,397,624,32,656,1419,46.23%,16%,1
臺南市,新營區,0122,271,501,772,30,802,1466,54.71%,18.49%,1
臺南市,新營區,0123,207,320,527,45,572,932,61.37%,22.21%,1
臺南市,新營區,0124,168,315,483,19,502,1099,45.68%,15.29%,1
臺南市,新營區,0125,114,225,339,22,361,757,47.69%,15.06%,1
臺南市,新營區,0126,177,292,469,32,501,888,56.42%,19.93%,1
臺南市,新營區,0127,219,341,560,9,569,1115,51.03%,19.64%,1
臺南市,新營區,0128,156,288,444,12,456,937,48.67%,16.65%,1
臺南市,新營區,0129,135,518,653,33,686,1387,49.46%,9.73%,1
臺南市,新營區,0130,249,467,716,43,759,1526,49.74%,16.32%,1
臺南市,新營區,0131,234,475,709,25,734,1301,56.42%,17.99%,1
臺南市,新營區,0132,285,552,837,33,870,1538,56.57%,18.53%,1
臺南市,新營區,0133,296,527,823,34,857,1584,54.1%,18.69%,1
臺南市,新營區,0134,339,532,871,21,892,1583,56.35%,21.42%,1
臺南市,新營區,0135,310,508,818,23,841,1530,54.97%,20.26%,1
臺南市,新營區,0136,242,419,661,34,695,1193,58.26%,20.28%,1
臺南市,新營區,0137,261,297,558,13,571,1439,39.68%,18.14%,1
臺南市,新營區,0138,252,525,777,34,811,1438,56.4%,17.52%,1
臺南市,新營區,0139,69,125,194,17,211,359,58.77%,19.22%,1
臺南市,新營區,0140,181,321,502,24,526,1233,42.66%,14.68%,1
臺南市,新營區,0141,150,359,509,17,526,1227,42.87%,12.22%,1
臺南市,新營區,0142,202,382,584,22,606,1320,45.91%,15.3%,1
臺南市,新營區,0143,299,493,792,24,816,1930,42.28%,15.49%,1
臺南市,新營區,0144,266,495,761,28,789,1501,52.56%,17.72%,1
臺南市,新營區,0145,238,458,696,27,723,1475,49.02%,16.14%,1
臺南市,新營區,0146,324,574,898,37,935,1753,53.34%,18.48%,1
臺南市,新營區,0147,319,519,838,26,864,1748,49.43%,18.25%,1
臺南市,新營區,0148,294,558,852,41,893,1741,51.29%,16.89%,1
臺南市,新營區,0149,235,443,678,15,693,1433,48.36%,16.4%,1
臺南市,新營區,0150,273,522,795,33,828,1595,51.91%,17.12%,1
臺南市,新營區,0151,143,277,420,20,440,959,45.88%,14.91%,1
臺南市,新營區,0152,299,556,855,53,908,1865,48.69%,16.03%,1
臺南市,新營區,0153,255,458,713,73,786,1678,46.84%,15.2%,1
臺南市,新營區,0154,190,379,569,53,622,1373,45.3%,13.84%,1
臺南市,新營區,0155,184,335,519,25,544,1431,38.02%,12.86%,1
臺南市,新營區,0156,45,60,105,1,106,291,36.43%,15.46%,1
臺南市,新營區,0157,312,511,823,33,856,1749,48.94%,17.84%,1
臺南市,新營區,0158,275,546,821,30,851,1862,45.7%,14.77%,1
臺南市,新營區,0159,325,584,909,73,982,1821,53.93%,17.85%,1
臺南市,新營區,0160,273,534,807,54,861,1845,46.67%,14.8%,1
臺南市,新營區,0161,56,140,196,9,205,542,37.82%,10.33%,1
臺南市,新營區,0162,58,87,145,1,146,402,36.32%,14.43%,1
臺南市,新營區,0163,131,224,355,56,411,703,58.46%,18.63%,1
臺南市,新營區,0164,130,259,389,30,419,941,44.53%,13.82%,1
臺南市,鹽水區,0085,162,337,499,59,558,1037,53.81%,15.62%,1
臺南市,鹽水區,0086,93,147,240,18,258,480,53.75%,19.38%,1
臺南市,鹽水區,0087,138,221,359,22,381,636,59.91%,21.7%,1
臺南市,鹽水區,0088,58,104,162,8,170,321,52.96%,18.07%,1
臺南市,鹽水區,0089,97,178,275,22,297,497,59.76%,19.52%,1
臺南市,鹽水區,0090,284,138,422,16,438,759,57.71%,37.42%,1
臺南市,鹽水區,0091,53,98,151,13,164,341,48.09%,15.54%,1
臺南市,鹽水區,0092,79,180,259,19,278,507,54.83%,15.58%,1
臺南市,鹽水區,0093,132,229,361,16,377,863,43.68%,15.3%,1
臺南市,鹽水區,0094,210,427,637,21,658,1373,47.92%,15.29%,1
臺南市,鹽水區,0095,243,452,695,55,750,1507,49.77%,16.12%,1
臺南市,鹽水區,0096,236,437,673,55,728,1374,52.98%,17.18%,1
臺南市,鹽水區,0097,191,348,539,40,579,1244,46.54%,15.35%,1
臺南市,鹽水區,0098,147,347,494,44,538,1022,52.64%,14.38%,1
臺南市,鹽水區,0099,110,203,313,36,349,921,37.89%,11.94%,1
臺南市,鹽水區,0100,152,270,422,36,458,847,54.07%,17.95%,1
臺南市,鹽水區,0101,100,140,240,7,247,736,33.56%,13.59%,1
臺南市,鹽水區,0102,114,246,360,18,378,761,49.67%,14.98%,1
臺南市,鹽水區,0103,45,82,127,9,136,285,47.72%,15.79%,1
臺南市,鹽水區,0104,72,133,205,21,226,493,45.84%,14.6%,1
臺南市,鹽水區,0105,65,151,216,21,237,621,38.16%,10.47%,1
臺南市,鹽水區,0106,43,86,129,7,136,392,34.69%,10.97%,1
臺南市,鹽水區,0107,143,275,418,22,440,925,47.57%,15.46%,1
臺南市,鹽水區,0108,75,210,285,32,317,728,43.54%,10.3%,1
臺南市,鹽水區,0109,15,47,62,18,80,214,37.38%,7.01%,1
臺南市,鹽水區,0110,44,118,162,15,177,387,45.74%,11.37%,1
臺南市,鹽水區,0111,43,92,135,18,153,301,50.83%,14.29%,1
臺南市,鹽水區,0112,97,167,264,29,293,755,38.81%,12.85%,1
臺南市,鹽水區,0113,44,78,122,26,148,365,40.55%,12.05%,1
臺南市,鹽水區,0114,150,241,391,28,419,935,44.81%,16.04%,1
臺南市,鹽水區,0115,73,125,198,23,221,494,44.74%,14.78%,1
臺南市,白河區,0030,200,358,558,69,627,1176,53.32%,17.01%,1
臺南市,白河區,0031,99,160,259,15,274,546,50.18%,18.13%,1
臺南市,白河區,0032,181,264,445,21,466,859,54.25%,21.07%,1
臺南市,白河區,0033,160,335,495,30,525,946,55.5%,16.91%,1
臺南市,白河區,0034,170,365,535,37,572,1116,51.25%,15.23%,1
臺南市,白河區,0035,173,350,523,25,548,1397,39.23%,12.38%,1
臺南市,白河區,0036,106,183,289,16,305,756,40.34%,14.02%,1
臺南市,白河區,0037,131,249,380,46,426,871,48.91%,15.04%,1
臺南市,白河區,0038,135,280,415,31,446,897,49.72%,15.05%,1
臺南市,白河區,0039,94,148,242,34,276,784,35.2%,11.99%,1
臺南市,白河區,0040,79,139,218,16,234,572,40.91%,13.81%,1
臺南市,白河區,0041,42,99,141,9,150,457,32.82%,9.19%,1
臺南市,白河區,0042,63,138,201,11,212,600,35.33%,10.5%,1
臺南市,白河區,0043,39,69,108,3,111,375,29.6%,10.4%,1
臺南市,白河區,0044,47,74,121,12,133,508,26.18%,9.25%,1
臺南市,白河區,0045,64,124,188,13,201,631,31.85%,10.14%,1
臺南市,白河區,0046,39,73,112,7,119,391,30.43%,9.97%,1
臺南市,白河區,0047,68,185,253,12,265,799,33.17%,8.51%,1
臺南市,白河區,0048,48,105,153,16,169,506,33.4%,9.49%,1
臺南市,白河區,0049,133,217,350,22,372,832,44.71%,15.99%,1
臺南市,白河區,0050,188,327,515,33,548,1179,46.48%,15.95%,1
臺南市,白河區,0051,100,144,244,11,255,744,34.27%,13.44%,1
臺南市,白河區,0052,85,164,249,14,263,699,37.63%,12.16%,1
臺南市,白河區,0053,76,132,208,12,220,633,34.76%,12.01%,1
臺南市,白河區,0054,162,244,406,54,460,859,53.55%,18.86%,1
臺南市,白河區,0055,124,223,347,40,387,884,43.78%,14.03%,1
臺南市,白河區,0056,56,139,195,14,209,740,28.24%,7.57%,1
臺南市,白河區,0057,165,348,513,51,564,1334,42.28%,12.37%,1
臺南市,白河區,0058,112,182,294,58,352,723,48.69%,15.49%,1
臺南市,白河區,0059,115,220,335,45,380,682,55.72%,16.86%,1
臺南市,白河區,0060,160,237,397,41,438,855,51.23%,18.71%,1
臺南市,白河區,0061,62,140,202,20,222,543,40.88%,11.42%,1
臺南市,柳營區,0165,197,337,534,43,577,1166,49.49%,16.9%,1
臺南市,柳營區,0166,124,215,339,7,346,625,55.36%,19.84%,1
臺南市,柳營區,0167,96,205,301,22,323,738,43.77%,13.01%,1
臺南市,柳營區,0168,158,283,441,23,464,834,55.64%,18.94%,1
臺南市,柳營區,0169,173,304,477,31,508,1104,46.01%,15.67%,1
臺南市,柳營區,0170,154,300,454,18,472,1015,46.5%,15.17%,1
臺南市,柳營區,0171,269,594,863,81,944,1720,54.88%,15.64%,1
臺南市,柳營區,0172,208,387,595,64,659,1391,47.38%,14.95%,1
臺南市,柳營區,0173,60,128,188,10,198,425,46.59%,14.12%,1
臺南市,柳營區,0174,37,91,128,10,138,318,43.4%,11.64%,1
臺南市,柳營區,0175,114,223,337,35,372,753,49.4%,15.14%,1
臺南市,柳營區,0176,104,205,309,37,346,730,47.4%,14.25%,1
臺南市,柳營區,0177,105,212,317,37,354,725,48.83%,14.48%,1
臺南市,柳營區,0178,124,267,391,35,426,787,54.13%,15.76%,1
臺南市,柳營區,0179,46,106,152,18,170,297,57.24%,15.49%,1
臺南市,柳營區,0180,102,238,340,34,374,673,55.57%,15.16%,1
臺南市,柳營區,0181,116,196,312,51,363,640,56.72%,18.13%,1
臺南市,柳營區,0182,105,158,263,32,295,660,44.7%,15.91%,1
臺南市,柳營區,0183,172,326,498,33,531,1212,43.81%,14.19%,1
臺南市,柳營區,0184,27,60,87,4,91,202,45.05%,13.37%,1
臺南市,柳營區,0185,134,305,439,70,509,1049,48.52%,12.77%,1
臺南市,柳營區,0186,28,46,74,1,75,158,47.47%,17.72%,1
臺南市,柳營區,0187,136,273,409,55,464,921,50.38%,14.77%,1
臺南市,柳營區,0188,68,152,220,12,232,504,46.03%,13.49%,1
臺南市,柳營區,0189,15,47,62,3,65,157,41.4%,9.55%,1
臺南市,後壁區,0001,122,264,386,40,426,743,57.34%,16.42%,1
臺南市,後壁區,0002,137,295,432,15,447,898,49.78%,15.26%,1
臺南市,後壁區,0003,120,214,334,35,369,786,46.95%,15.27%,1
臺南市,後壁區,0004,93,150,243,32,275,534,51.5%,17.42%,1
臺南市,後壁區,0005,157,310,467,64,531,1034,51.35%,15.18%,1
臺南市,後壁區,0006,55,34,89,17,106,232,45.69%,23.71%,1
臺南市,後壁區,0007,66,137,203,30,233,479,48.64%,13.78%,1
臺南市,後壁區,0008,122,237,359,27,386,837,46.12%,14.58%,1
臺南市,後壁區,0009,161,258,419,29,448,1085,41.29%,14.84%,1
臺南市,後壁區,0010,141,258,399,22,421,1157,36.39%,12.19%,1
臺南市,後壁區,0011,99,236,335,50,385,755,50.99%,13.11%,1
臺南市,後壁區,0012,100,127,227,23,250,458,54.59%,21.83%,1
臺南市,後壁區,0013,40,114,154,19,173,371,46.63%,10.78%,1
臺南市,後壁區,0014,108,182,290,37,327,676,48.37%,15.98%,1
臺南市,後壁區,0015,53,114,167,23,190,428,44.39%,12.38%,1
臺南市,後壁區,0016,66,137,203,8,211,547,38.57%,12.07%,1
臺南市,後壁區,0017,69,128,197,39,236,455,51.87%,15.16%,1
臺南市,後壁區,0018,109,240,349,55,404,984,41.06%,11.08%,1
臺南市,後壁區,0019,75,117,192,32,224,483,46.38%,15.53%,1
臺南市,後壁區,0020,54,149,203,22,225,536,41.98%,10.07%,1
臺南市,後壁區,0021,109,227,336,14,350,958,36.53%,11.38%,1
臺南市,後壁區,0022,63,163,226,25,251,441,56.92%,14.29%,1
臺南市,後壁區,0023,113,189,302,59,361,677,53.32%,16.69%,1
臺南市,後壁區,0024,148,323,471,58,529,996,53.11%,14.86%,1
臺南市,後壁區,0025,175,356,531,24,555,1255,44.22%,13.94%,1
臺南市,後壁區,0026,104,175,279,14,293,678,43.22%,15.34%,1
臺南市,後壁區,0027,60,164,224,7,231,553,41.77%,10.85%,1
臺南市,後壁區,0028,75,138,213,15,228,616,37.01%,12.18%,1
臺南市,後壁區,0029,181,339,520,32,552,1189,46.43%,15.22%,1
臺南市,東山區,0062,168,400,568,51,619,1401,44.18%,11.99%,1
臺南市,東山區,0063,107,300,407,30,437,1185,36.88%,9.03%,1
臺南市,東山區,0064,175,312,487,47,534,1303,40.98%,13.43%,1
臺南市,東山區,0065,83,183,266,28,294,732,40.16%,11.34%,1
臺南市,東山區,0066,84,158,242,33,275,721,38.14%,11.65%,1
臺南市,東山區,0067,127,221,348,51,399,1104,36.14%,11.5%,1
臺南市,東山區,0068,113,244,357,27,384,943,40.72%,11.98%,1
臺南市,東山區,0069,52,103,155,4,159,653,24.35%,7.96%,1
臺南市,東山區,0070,90,143,233,61,294,596,49.33%,15.1%,1
臺南市,東山區,0071,131,216,347,51,398,878,45.33%,14.92%,1
臺南市,東山區,0072,170,109,279,42,321,771,41.63%,22.05%,1
臺南市,東山區,0073,76,118,194,16,210,483,43.48%,15.73%,1
臺南市,東山區,0074,104,180,284,34,318,640,49.69%,16.25%,1
臺南市,東山區,0075,31,64,95,3,98,425,23.06%,7.29%,1
臺南市,東山區,0076,39,99,138,7,145,394,36.8%,9.9%,1
臺南市,東山區,0077,50,107,157,30,187,373,50.13%,13.4%,1
臺南市,東山區,0078,109,297,406,33,439,1257,34.92%,8.67%,1
臺南市,東山區,0079,61,150,211,7,218,887,24.58%,6.88%,1
臺南市,東山區,0080,39,131,170,7,177,658,26.9%,5.93%,1
臺南市,東山區,0081,87,213,300,23,323,1101,29.34%,7.9%,1
臺南市,東山區,0082,78,195,273,16,289,1057,27.34%,7.38%,1
臺南市,東山區,0083,80,196,276,29,305,639,47.73%,12.52%,1
臺南市,東山區,0084,35,65,100,17,117,270,43.33%,12.96%,1
臺南市,麻豆區,0381,213,363,576,38,614,1205,50.95%,17.68%,1
臺南市,麻豆區,0382,135,218,353,17,370,660,56.06%,20.45%,1
臺南市,麻豆區,0383,108,166,274,16,290,523,55.45%,20.65%,1
臺南市,麻豆區,0384,291,467,758,33,791,1597,49.53%,18.22%,1
臺南市,麻豆區,0385,256,395,651,51,702,1262,55.63%,20.29%,1
臺南市,麻豆區,0386,252,465,717,31,748,1325,56.45%,19.02%,1
臺南市,麻豆區,0387,265,406,671,25,696,1384,50.29%,19.15%,1
臺南市,麻豆區,0388,228,322,550,23,573,1121,51.12%,20.34%,1
臺南市,麻豆區,0389,190,287,477,12,489,1021,47.89%,18.61%,1
臺南市,麻豆區,0390,192,262,454,21,475,954,49.79%,20.13%,1
臺南市,麻豆區,0391,243,414,657,30,687,1513,45.41%,16.06%,1
臺南市,麻豆區,0392,246,490,736,31,767,1726,44.44%,14.25%,1
臺南市,麻豆區,0393,295,552,847,62,909,1804,50.39%,16.35%,1
臺南市,麻豆區,0394,172,326,498,27,525,1106,47.47%,15.55%,1
臺南市,麻豆區,0395,273,461,734,43,777,1503,51.7%,18.16%,1
臺南市,麻豆區,0396,223,396,619,47,666,1302,51.15%,17.13%,1
臺南市,麻豆區,0397,113,186,299,13,312,645,48.37%,17.52%,1
臺南市,麻豆區,0398,140,266,406,30,436,777,56.11%,18.02%,1
臺南市,麻豆區,0399,267,458,725,40,765,1612,47.46%,16.56%,1
臺南市,麻豆區,0400,123,175,298,15,313,718,43.59%,17.13%,1
臺南市,麻豆區,0401,249,433,682,25,707,1656,42.69%,15.04%,1
臺南市,麻豆區,0402,255,344,599,66,665,1355,49.08%,18.82%,1
臺南市,麻豆區,0403,151,230,381,27,408,977,41.76%,15.46%,1
臺南市,麻豆區,0404,163,267,430,26,456,1012,45.06%,16.11%,1
臺南市,麻豆區,0405,128,200,328,19,347,626,55.43%,20.45%,1
臺南市,麻豆區,0406,55,90,145,5,150,467,32.12%,11.78%,1
臺南市,麻豆區,0407,189,348,537,27,564,1260,44.76%,15%,1
臺南市,麻豆區,0408,182,355,537,45,582,1111,52.39%,16.38%,1
臺南市,麻豆區,0409,117,159,276,20,296,550,53.82%,21.27%,1
臺南市,麻豆區,0410,150,212,362,49,411,798,51.5%,18.8%,1
臺南市,麻豆區,0411,158,291,449,62,511,852,59.98%,18.54%,1
臺南市,麻豆區,0412,137,198,335,13,348,830,41.93%,16.51%,1
臺南市,麻豆區,0413,158,223,381,21,402,941,42.72%,16.79%,1
臺南市,麻豆區,0414,206,361,567,29,596,1158,51.47%,17.79%,1
臺南市,麻豆區,0415,98,174,272,9,281,612,45.92%,16.01%,1
臺南市,下營區,0343,210,423,633,45,678,1558,43.52%,13.48%,1
臺南市,下營區,0344,172,254,426,28,454,1112,40.83%,15.47%,1
臺南市,下營區,0345,123,259,382,42,424,893,47.48%,13.77%,1
臺南市,下營區,0346,190,439,629,49,678,1623,41.77%,11.71%,1
臺南市,下營區,0347,254,450,704,66,770,1568,49.11%,16.2%,1
臺南市,下營區,0348,132,335,467,38,505,985,51.27%,13.4%,1
臺南市,下營區,0349,144,272,416,16,432,953,45.33%,15.11%,1
臺南市,下營區,0350,164,202,366,112,478,1031,46.36%,15.91%,1
臺南市,下營區,0351,197,340,537,64,601,1077,55.8%,18.29%,1
臺南市,下營區,0352,100,159,259,36,295,703,41.96%,14.22%,1
臺南市,下營區,0353,99,244,343,16,359,854,42.04%,11.59%,1
臺南市,下營區,0354,192,346,538,50,588,1164,50.52%,16.49%,1
臺南市,下營區,0355,159,298,457,26,483,1091,44.27%,14.57%,1
臺南市,下營區,0356,134,311,445,48,493,959,51.41%,13.97%,1
臺南市,下營區,0357,145,266,411,33,444,935,47.49%,15.51%,1
臺南市,下營區,0358,152,263,415,46,461,893,51.62%,17.02%,1
臺南市,下營區,0359,193,408,601,74,675,1293,52.2%,14.93%,1
臺南市,下營區,0360,198,319,517,108,625,1185,52.74%,16.71%,1
臺南市,下營區,0361,133,244,377,16,393,1070,36.73%,12.43%,1
臺南市,六甲區,0362,149,269,418,51,469,819,57.26%,18.19%,1
臺南市,六甲區,0363,123,186,309,18,327,645,50.7%,19.07%,1
臺南市,六甲區,0364,248,361,609,46,655,1444,45.36%,17.17%,1
臺南市,六甲區,0365,235,381,616,40,656,1554,42.21%,15.12%,1
臺南市,六甲區,0366,169,290,459,40,499,1171,42.61%,14.43%,1
臺南市,六甲區,0367,198,385,583,65,648,1351,47.96%,14.66%,1
臺南市,六甲區,0368,138,258,396,72,468,1010,46.34%,13.66%,1
臺南市,六甲區,0369,145,240,385,48,433,919,47.12%,15.78%,1
臺南市,六甲區,0370,225,379,604,58,662,1369,48.36%,16.44%,1
臺南市,六甲區,0371,167,278,445,63,508,976,52.05%,17.11%,1
臺南市,六甲區,0372,171,331,502,47,549,1015,54.09%,16.85%,1
臺南市,六甲區,0373,317,185,502,25,527,1176,44.81%,26.96%,1
臺南市,六甲區,0374,143,287,430,52,482,939,51.33%,15.23%,1
臺南市,六甲區,0375,134,196,330,43,373,712,52.39%,18.82%,1
臺南市,六甲區,0376,164,253,417,41,458,881,51.99%,18.62%,1
臺南市,六甲區,0377,212,419,631,60,691,1184,58.36%,17.91%,1
臺南市,六甲區,0378,107,233,340,25,365,599,60.93%,17.86%,1
臺南市,六甲區,0379,74,162,236,9,245,759,32.28%,9.75%,1
臺南市,六甲區,0380,78,141,219,27,246,621,39.61%,12.56%,1
臺南市,官田區,0416,157,317,474,17,491,1104,44.47%,14.22%,1
臺南市,官田區,0417,156,278,434,40,474,965,49.12%,16.17%,1
臺南市,官田區,0418,265,393,658,42,700,1402,49.93%,18.9%,1
臺南市,官田區,0419,304,512,816,91,907,1653,54.87%,18.39%,1
臺南市,官田區,0420,151,254,405,47,452,966,46.79%,15.63%,1
臺南市,官田區,0421,39,73,112,13,125,284,44.01%,13.73%,1
臺南市,官田區,0422,48,65,113,8,121,402,30.1%,11.94%,1
臺南市,官田區,0423,186,293,479,10,489,982,49.8%,18.94%,1
臺南市,官田區,0424,136,259,395,29,424,975,43.49%,13.95%,1
臺南市,官田區,0425,130,246,376,23,399,802,49.75%,16.21%,1
臺南市,官田區,0426,190,379,569,37,606,1118,54.2%,16.99%,1
臺南市,官田區,0427,242,444,686,34,720,1455,49.48%,16.63%,1
臺南市,官田區,0428,185,389,574,32,606,1208,50.17%,15.31%,1
臺南市,官田區,0429,216,344,560,60,620,1293,47.95%,16.71%,1
臺南市,官田區,0430,98,130,228,20,248,607,40.86%,16.14%,1
臺南市,官田區,0431,69,142,211,27,238,501,47.5%,13.77%,1
臺南市,官田區,0432,133,213,346,55,401,728,55.08%,18.27%,1
臺南市,官田區,0433,160,223,383,29,412,842,48.93%,19%,1
臺南市,官田區,0434,82,161,243,34,277,515,53.79%,15.92%,1
臺南市,官田區,0435,121,236,357,21,378,873,43.3%,13.86%,1
臺南市,大內區,0436,91,188,279,49,328,759,43.21%,11.99%,1
臺南市,大內區,0437,20,64,84,5,89,262,33.97%,7.63%,1
臺南市,大內區,0438,75,150,225,17,242,646,37.46%,11.61%,1
臺南市,大內區,0439,188,355,543,57,600,1473,40.73%,12.76%,1
臺南市,大內區,0440,125,306,431,66,497,915,54.32%,13.66%,1
臺南市,大內區,0441,154,251,405,34,439,779,56.35%,19.77%,1
臺南市,大內區,0442,131,215,346,43,389,637,61.07%,20.57%,1
臺南市,大內區,0443,133,275,408,34,442,993,44.51%,13.39%,1
臺南市,大內區,0444,79,282,361,48,409,766,53.39%,10.31%,1
臺南市,大內區,0445,109,273,382,40,422,841,50.18%,12.96%,1
臺南市,大內區,0446,66,187,253,33,286,583,49.06%,11.32%,1
臺南市,佳里區,0282,240,489,729,48,777,1391,55.86%,17.25%,1
臺南市,佳里區,0283,172,294,466,25,491,829,59.23%,20.75%,1
臺南市,佳里區,0284,206,401,607,38,645,1401,46.04%,14.7%,1
臺南市,佳里區,0285,203,417,620,17,637,1452,43.87%,13.98%,1
臺南市,佳里區,0286,226,457,683,65,748,1382,54.12%,16.35%,1
臺南市,佳里區,0287,247,488,735,41,776,1463,53.04%,16.88%,1
臺南市,佳里區,0288,285,323,608,32,640,1280,50%,22.27%,1
臺南市,佳里區,0289,275,489,764,50,814,1486,54.78%,18.51%,1
臺南市,佳里區,0290,273,439,712,49,761,1378,55.22%,19.81%,1
臺南市,佳里區,0291,148,535,683,40,723,1505,48.04%,9.83%,1
臺南市,佳里區,0292,289,632,921,44,965,1860,51.88%,15.54%,1
臺南市,佳里區,0293,204,365,569,64,633,1134,55.82%,17.99%,1
臺南市,佳里區,0294,252,481,733,29,762,1426,53.44%,17.67%,1
臺南市,佳里區,0295,327,567,894,48,942,1779,52.95%,18.38%,1
臺南市,佳里區,0296,343,656,999,42,1041,1906,54.62%,18%,1
臺南市,佳里區,0297,235,457,692,30,722,1425,50.67%,16.49%,1
臺南市,佳里區,0298,215,407,622,37,659,1255,52.51%,17.13%,1
臺南市,佳里區,0299,235,468,703,47,750,1524,49.21%,15.42%,1
臺南市,佳里區,0300,307,503,810,22,832,1631,51.01%,18.82%,1
臺南市,佳里區,0301,271,552,823,42,865,1546,55.95%,17.53%,1
臺南市,佳里區,0302,230,449,679,32,711,1187,59.9%,19.38%,1
臺南市,佳里區,0303,243,461,704,26,730,1381,52.86%,17.6%,1
臺南市,佳里區,0304,224,448,672,16,688,1364,50.44%,16.42%,1
臺南市,佳里區,0305,219,472,691,13,704,1314,53.58%,16.67%,1
臺南市,佳里區,0306,186,414,600,50,650,1164,55.84%,15.98%,1
臺南市,佳里區,0307,150,339,489,32,521,961,54.21%,15.61%,1
臺南市,佳里區,0308,186,404,590,38,628,1218,51.56%,15.27%,1
臺南市,佳里區,0309,264,222,486,12,498,919,54.19%,28.73%,1
臺南市,佳里區,0310,116,217,333,23,356,689,51.67%,16.84%,1
臺南市,佳里區,0311,62,104,166,12,178,383,46.48%,16.19%,1
臺南市,佳里區,0312,199,480,679,42,721,1507,47.84%,13.21%,1
臺南市,佳里區,0313,107,210,317,29,346,702,49.29%,15.24%,1
臺南市,佳里區,0314,143,329,472,32,504,907,55.57%,15.77%,1
臺南市,佳里區,0315,175,338,513,39,552,937,58.91%,18.68%,1
臺南市,佳里區,0316,168,297,465,86,551,1030,53.5%,16.31%,1
臺南市,佳里區,0317,151,318,469,42,511,981,52.09%,15.39%,1
臺南市,佳里區,0318,113,242,355,20,375,787,47.65%,14.36%,1
臺南市,佳里區,0319,216,504,720,57,777,1513,51.35%,14.28%,1
臺南市,佳里區,0320,109,176,285,20,305,714,42.72%,15.27%,1
臺南市,佳里區,0321,135,192,327,41,368,745,49.4%,18.12%,1
臺南市,佳里區,0322,171,250,421,22,443,951,46.58%,17.98%,1
臺南市,學甲區,0208,156,288,444,40,484,862,56.15%,18.1%,1
臺南市,學甲區,0209,116,218,334,10,344,611,56.3%,18.99%,1
臺南市,學甲區,0210,153,295,448,28,476,936,50.85%,16.35%,1
臺南市,學甲區,0211,168,315,483,31,514,1066,48.22%,15.76%,1
臺南市,學甲區,0212,158,290,448,32,480,869,55.24%,18.18%,1
臺南市,學甲區,0213,108,201,309,23,332,635,52.28%,17.01%,1
臺南市,學甲區,0214,126,241,367,14,381,822,46.35%,15.33%,1
臺南市,學甲區,0215,58,122,180,12,192,443,43.34%,13.09%,1
臺南市,學甲區,0216,219,437,656,36,692,1370,50.51%,15.99%,1
臺南市,學甲區,0217,195,373,568,41,609,1117,54.52%,17.46%,1
臺南市,學甲區,0218,201,418,619,61,680,1365,49.82%,14.73%,1
臺南市,學甲區,0219,197,469,666,47,713,1489,47.88%,13.23%,1
臺南市,學甲區,0220,71,161,232,31,263,627,41.95%,11.32%,1
臺南市,學甲區,0221,195,309,504,22,526,1052,50%,18.54%,1
臺南市,學甲區,0222,188,353,541,19,560,1183,47.34%,15.89%,1
臺南市,學甲區,0223,119,275,394,21,415,979,42.39%,12.16%,1
臺南市,學甲區,0224,181,332,513,44,557,1241,44.88%,14.59%,1
臺南市,學甲區,0225,102,200,302,19,321,843,38.08%,12.1%,1
臺南市,學甲區,0226,86,168,254,27,281,580,48.45%,14.83%,1
臺南市,學甲區,0227,86,217,303,16,319,832,38.34%,10.34%,1
臺南市,學甲區,0228,44,101,145,5,150,406,36.95%,10.84%,1
臺南市,學甲區,0229,132,260,392,33,425,818,51.96%,16.14%,1
臺南市,學甲區,0230,130,260,390,16,406,1052,38.59%,12.36%,1
臺南市,學甲區,0231,73,155,228,14,242,578,41.87%,12.63%,1
臺南市,學甲區,0232,52,107,159,19,178,430,41.4%,12.09%,1
臺南市,學甲區,0233,43,117,160,7,167,361,46.26%,11.91%,1
臺南市,西港區,0323,155,297,452,13,465,933,49.84%,16.61%,1
臺南市,西港區,0324,158,289,447,25,472,901,52.39%,17.54%,1
臺南市,西港區,0325,202,392,594,24,618,1314,47.03%,15.37%,1
臺南市,西港區,0326,223,419,642,51,693,1349,51.37%,16.53%,1
臺南市,西港區,0327,180,347,527,36,563,1014,55.52%,17.75%,1
臺南市,西港區,0328,237,503,740,22,762,1900,40.11%,12.47%,1
臺南市,西港區,0329,278,427,705,43,748,1663,44.98%,16.72%,1
臺南市,西港區,0330,109,188,297,17,314,738,42.55%,14.77%,1
臺南市,西港區,0331,199,411,610,38,648,1211,53.51%,16.43%,1
臺南市,西港區,0332,69,97,166,19,185,382,48.43%,18.06%,1
臺南市,西港區,0333,104,250,354,20,374,786,47.58%,13.23%,1
臺南市,西港區,0334,115,273,388,15,403,838,48.09%,13.72%,1
臺南市,西港區,0335,229,337,566,45,611,1449,42.17%,15.8%,1
臺南市,西港區,0336,188,413,601,25,626,1479,42.33%,12.71%,1
臺南市,西港區,0337,111,266,377,47,424,763,55.57%,14.55%,1
臺南市,西港區,0338,177,388,565,16,581,1297,44.8%,13.65%,1
臺南市,西港區,0339,210,401,611,32,643,1393,46.16%,15.08%,1
臺南市,西港區,0340,126,244,370,13,383,958,39.98%,13.15%,1
臺南市,西港區,0341,73,122,195,21,216,391,55.24%,18.67%,1
臺南市,西港區,0342,113,264,377,46,423,805,52.55%,14.04%,1
臺南市,七股區,0258,83,159,242,12,254,534,47.57%,15.54%,1
臺南市,七股區,0259,86,170,256,15,271,508,53.35%,16.93%,1
臺南市,七股區,0260,83,173,256,5,261,665,39.25%,12.48%,1
臺南市,七股區,0261,108,236,344,18,362,834,43.41%,12.95%,1
臺南市,七股區,0262,88,255,343,10,353,810,43.58%,10.86%,1
臺南市,七股區,0263,41,121,162,8,170,480,35.42%,8.54%,1
臺南市,七股區,0264,45,119,164,10,174,445,39.1%,10.11%,1
臺南市,七股區,0265,48,132,180,14,194,680,28.53%,7.06%,1
臺南市,七股區,0266,104,220,324,15,339,838,40.45%,12.41%,1
臺南市,七股區,0267,85,194,279,18,297,780,38.08%,10.9%,1
臺南市,七股區,0268,67,115,182,13,195,350,55.71%,19.14%,1
臺南市,七股區,0269,166,307,473,49,522,907,57.55%,18.3%,1
臺南市,七股區,0270,86,239,325,19,344,780,44.1%,11.03%,1
臺南市,七股區,0271,242,467,709,26,735,1658,44.33%,14.6%,1
臺南市,七股區,0272,113,280,393,18,411,913,45.02%,12.38%,1
臺南市,七股區,0273,206,345,551,54,605,1202,50.33%,17.14%,1
臺南市,七股區,0274,71,178,249,7,256,696,36.78%,10.2%,1
臺南市,七股區,0275,100,191,291,29,320,647,49.46%,15.46%,1
臺南市,七股區,0276,116,245,361,31,392,622,63.02%,18.65%,1
臺南市,七股區,0277,179,423,602,71,673,1175,57.28%,15.23%,1
臺南市,七股區,0278,113,175,288,23,311,698,44.56%,16.19%,1
臺南市,七股區,0279,146,317,463,49,512,983,52.09%,14.85%,1
臺南市,七股區,0280,165,335,500,41,541,1366,39.6%,12.08%,1
臺南市,七股區,0281,182,361,543,65,608,1379,44.09%,13.2%,1
臺南市,將軍區,0234,200,387,587,51,638,1110,57.48%,18.02%,1
臺南市,將軍區,0235,101,450,551,23,574,1418,40.48%,7.12%,1
臺南市,將軍區,0236,136,309,445,25,470,969,48.5%,14.04%,1
臺南市,將軍區,0237,86,180,266,37,303,519,58.38%,16.57%,1
臺南市,將軍區,0238,180,348,528,13,541,1106,48.92%,16.27%,1
臺南市,將軍區,0239,94,149,243,27,270,542,49.82%,17.34%,1
臺南市,將軍區,0240,31,91,122,7,129,315,40.95%,9.84%,1
臺南市,將軍區,0241,69,150,219,23,242,584,41.44%,11.82%,1
臺南市,將軍區,0242,60,117,177,6,183,398,45.98%,15.08%,1
臺南市,將軍區,0243,15,151,166,87,253,608,41.61%,2.47%,1
臺南市,將軍區,0244,73,138,211,15,226,442,51.13%,16.52%,1
臺南市,將軍區,0245,70,163,233,8,241,650,37.08%,10.77%,1
臺南市,將軍區,0246,58,135,193,11,204,573,35.6%,10.12%,1
臺南市,將軍區,0247,68,163,231,4,235,617,38.09%,11.02%,1
臺南市,將軍區,0248,62,189,251,22,273,573,47.64%,10.82%,1
臺南市,將軍區,0249,45,155,200,20,220,434,50.69%,10.37%,1
臺南市,將軍區,0250,108,221,329,16,345,849,40.64%,12.72%,1
臺南市,將軍區,0251,65,172,237,22,259,645,40.16%,10.08%,1
臺南市,將軍區,0252,63,191,254,27,281,690,40.72%,9.13%,1
臺南市,將軍區,0253,44,149,193,8,201,663,30.32%,6.64%,1
臺南市,將軍區,0254,136,359,495,25,520,1175,44.26%,11.57%,1
臺南市,將軍區,0255,83,194,277,29,306,837,36.56%,9.92%,1
臺南市,將軍區,0256,144,321,465,90,555,1061,52.31%,13.57%,1
臺南市,將軍區,0257,102,232,334,13,347,976,35.55%,10.45%,1
臺南市,北門區,0190,82,129,211,14,225,484,46.49%,16.94%,1
臺南市,北門區,0191,45,110,155,11,166,401,41.4%,11.22%,1
臺南市,北門區,0192,41,130,171,5,176,456,38.6%,8.99%,1
臺南市,北門區,0193,74,115,189,17,206,382,53.93%,19.37%,1
臺南市,北門區,0194,46,114,160,21,181,356,50.84%,12.92%,1
臺南市,北門區,0195,48,91,139,4,143,389,36.76%,12.34%,1
臺南市,北門區,0196,76,226,302,7,309,742,41.64%,10.24%,1
臺南市,北門區,0197,67,189,256,10,266,599,44.41%,11.19%,1
臺南市,北門區,0198,70,154,224,26,250,594,42.09%,11.78%,1
臺南市,北門區,0199,69,161,230,15,245,572,42.83%,12.06%,1
臺南市,北門區,0200,36,68,104,4,108,318,33.96%,11.32%,1
臺南市,北門區,0201,57,111,168,9,177,473,37.42%,12.05%,1
臺南市,北門區,0202,86,222,308,17,325,954,34.07%,9.01%,1
臺南市,北門區,0203,93,274,367,30,397,737,53.87%,12.62%,1
臺南市,北門區,0204,59,166,225,12,237,679,34.9%,8.69%,1
臺南市,北門區,0205,51,118,169,29,198,521,38%,9.79%,1
臺南市,北門區,0206,64,144,208,18,226,632,35.76%,10.13%,1
臺南市,北門區,0207,75,155,230,11,241,636,37.89%,11.79%,1
臺南市,新化區,0581,121,305,426,25,451,746,60.46%,16.22%,1
臺南市,新化區,0582,219,401,620,33,653,1102,59.26%,19.87%,1
臺南市,新化區,0583,58,147,205,11,216,370,58.38%,15.68%,1
臺南市,新化區,0584,294,220,514,53,567,947,59.87%,31.05%,1
臺南市,新化區,0585,172,373,545,58,603,1154,52.25%,14.9%,1
臺南市,新化區,0586,214,335,549,58,607,1082,56.1%,19.78%,1
臺南市,新化區,0587,202,365,567,44,611,1075,56.84%,18.79%,1
臺南市,新化區,0588,91,224,315,23,338,640,52.81%,14.22%,1
臺南市,新化區,0589,72,128,200,15,215,410,52.44%,17.56%,1
臺南市,新化區,0590,75,178,253,24,277,533,51.97%,14.07%,1
臺南市,新化區,0591,171,275,446,21,467,836,55.86%,20.45%,1
臺南市,新化區,0592,126,273,399,21,420,978,42.94%,12.88%,1
臺南市,新化區,0593,270,432,702,31,733,1348,54.38%,20.03%,1
臺南市,新化區,0594,167,332,499,39,538,1015,53%,16.45%,1
臺南市,新化區,0595,189,359,548,33,581,1228,47.31%,15.39%,1
臺南市,新化區,0596,157,252,409,46,455,789,57.67%,19.9%,1
臺南市,新化區,0597,173,337,510,23,533,1022,52.15%,16.93%,1
臺南市,新化區,0598,163,343,506,16,522,1021,51.13%,15.96%,1
臺南市,新化區,0599,250,413,663,47,710,1229,57.77%,20.34%,1
臺南市,新化區,0600,207,370,577,24,601,1153,52.12%,17.95%,1
臺南市,新化區,0601,156,263,419,20,439,1012,43.38%,15.42%,1
臺南市,新化區,0602,272,476,748,53,801,1458,54.94%,18.66%,1
臺南市,新化區,0603,283,577,860,57,917,1645,55.74%,17.2%,1
臺南市,新化區,0604,188,354,542,47,589,1016,57.97%,18.5%,1
臺南市,新化區,0605,100,172,272,14,286,559,51.16%,17.89%,1
臺南市,新化區,0606,237,418,655,26,681,1222,55.73%,19.39%,1
臺南市,新化區,0607,336,539,875,42,917,1562,58.71%,21.51%,1
臺南市,新化區,0608,154,290,444,30,474,994,47.69%,15.49%,1
臺南市,新化區,0609,160,337,497,66,563,1013,55.58%,15.79%,1
臺南市,新化區,0610,209,405,614,58,672,1197,56.14%,17.46%,1
臺南市,新化區,0611,144,326,470,43,513,1021,50.24%,14.1%,1
臺南市,新化區,0612,197,389,586,60,646,1428,45.24%,13.8%,1
臺南市,新化區,0613,74,115,189,27,216,456,47.37%,16.23%,1
臺南市,新化區,0614,164,368,532,50,582,1037,56.12%,15.81%,1
臺南市,新化區,0615,176,384,560,54,614,1097,55.97%,16.04%,1
臺南市,新化區,0616,152,303,455,47,502,902,55.65%,16.85%,1
臺南市,新化區,0617,137,285,422,88,510,999,51.05%,13.71%,1
臺南市,善化區,0492,170,336,506,15,521,1132,46.02%,15.02%,1
臺南市,善化區,0493,312,543,855,57,912,1845,49.43%,16.91%,1
臺南市,善化區,0494,374,611,985,65,1050,2090,50.24%,17.89%,1
臺南市,善化區,0495,303,515,818,57,875,1582,55.31%,19.15%,1
臺南市,善化區,0496,394,604,998,56,1054,1901,55.44%,20.73%,1
臺南市,善化區,0497,338,574,912,40,952,1818,52.37%,18.59%,1
臺南市,善化區,0498,283,524,807,51,858,1639,52.35%,17.27%,1
臺南市,善化區,0499,215,350,565,32,597,1061,56.27%,20.26%,1
臺南市,善化區,0500,312,622,934,62,996,1786,55.77%,17.47%,1
臺南市,善化區,0501,175,402,577,34,611,1147,53.27%,15.26%,1
臺南市,善化區,0502,276,454,730,56,786,1581,49.72%,17.46%,1
臺南市,善化區,0503,234,334,568,88,656,1240,52.9%,18.87%,1
臺南市,善化區,0504,254,460,714,30,744,1743,42.69%,14.57%,1
臺南市,善化區,0505,263,389,652,47,699,1246,56.1%,21.11%,1
臺南市,善化區,0506,164,284,448,28,476,961,49.53%,17.07%,1
臺南市,善化區,0507,133,292,425,13,438,938,46.7%,14.18%,1
臺南市,善化區,0508,131,225,356,13,369,722,51.11%,18.14%,1
臺南市,善化區,0509,155,310,465,27,492,1062,46.33%,14.6%,1
臺南市,善化區,0510,280,517,797,79,876,1715,51.08%,16.33%,1
臺南市,善化區,0511,172,321,493,55,548,1120,48.93%,15.36%,1
臺南市,善化區,0512,137,266,403,31,434,865,50.17%,15.84%,1
臺南市,善化區,0513,297,457,754,67,821,1574,52.16%,18.87%,1
臺南市,善化區,0514,221,404,625,70,695,1535,45.28%,14.4%,1
臺南市,善化區,0515,204,319,523,60,583,1106,52.71%,18.44%,1
臺南市,善化區,0516,223,429,652,35,687,1402,49%,15.91%,1
臺南市,善化區,0517,268,536,804,63,867,1458,59.47%,18.38%,1
臺南市,善化區,0518,260,346,606,34,640,1380,46.38%,18.84%,1
臺南市,善化區,0519,282,354,636,7,643,1232,52.19%,22.89%,1
臺南市,善化區,0520,262,309,571,12,583,1069,54.54%,24.51%,1
臺南市,新市區,0545,155,286,441,29,470,960,48.96%,16.15%,1
臺南市,新市區,0546,216,401,617,36,653,1118,58.41%,19.32%,1
臺南市,新市區,0547,139,260,399,17,416,850,48.94%,16.35%,1
臺南市,新市區,0548,217,394,611,48,659,1241,53.1%,17.49%,1
臺南市,新市區,0549,234,438,672,33,705,1297,54.36%,18.04%,1
臺南市,新市區,0550,162,337,499,43,542,962,56.34%,16.84%,1
臺南市,新市區,0551,220,439,659,40,699,1237,56.51%,17.78%,1
臺南市,新市區,0552,237,424,661,51,712,1326,53.7%,17.87%,1
臺南市,新市區,0553,237,402,639,58,697,1211,57.56%,19.57%,1
臺南市,新市區,0554,237,393,630,32,662,1305,50.73%,18.16%,1
臺南市,新市區,0555,108,236,344,33,377,688,54.8%,15.7%,1
臺南市,新市區,0556,178,310,488,28,516,911,56.64%,19.54%,1
臺南市,新市區,0557,256,451,707,30,737,1525,48.33%,16.79%,1
臺南市,新市區,0558,169,279,448,7,455,1091,41.7%,15.49%,1
臺南市,新市區,0559,182,370,552,15,567,1122,50.53%,16.22%,1
臺南市,新市區,0560,174,331,505,25,530,1049,50.52%,16.59%,1
臺南市,新市區,0561,264,435,699,17,716,1564,45.78%,16.88%,1
臺南市,新市區,0562,254,514,768,44,812,1515,53.6%,16.77%,1
臺南市,新市區,0563,226,453,679,37,716,1378,51.96%,16.4%,1
臺南市,新市區,0564,179,295,474,41,515,827,62.27%,21.64%,1
臺南市,新市區,0565,195,331,526,87,613,960,63.85%,20.31%,1
臺南市,新市區,0566,141,319,460,40,500,951,52.58%,14.83%,1
臺南市,新市區,0567,218,433,651,43,694,1264,54.91%,17.25%,1
臺南市,新市區,0568,220,369,589,30,619,1173,52.77%,18.76%,1
臺南市,新市區,0569,125,248,373,18,391,684,57.16%,18.27%,1
臺南市,新市區,0570,190,412,602,46,648,1055,61.42%,18.01%,1
臺南市,新市區,0571,241,421,662,29,691,1122,61.59%,21.48%,1
臺南市,安定區,0521,236,473,709,61,770,1251,61.55%,18.86%,1
臺南市,安定區,0522,154,308,462,33,495,899,55.06%,17.13%,1
臺南市,安定區,0523,189,358,547,61,608,1106,54.97%,17.09%,1
臺南市,安定區,0524,133,354,487,41,528,948,55.7%,14.03%,1
臺南市,安定區,0525,252,415,667,31,698,1442,48.4%,17.48%,1
臺南市,安定區,0526,225,416,641,54,695,1385,50.18%,16.25%,1
臺南市,安定區,0527,115,306,421,37,458,801,57.18%,14.36%,1
臺南市,安定區,0528,112,207,319,24,343,736,46.6%,15.22%,1
臺南市,安定區,0529,127,239,366,37,403,781,51.6%,16.26%,1
臺南市,安定區,0530,141,278,419,16,435,795,54.72%,17.74%,1
臺南市,安定區,0531,144,327,471,38,509,862,59.05%,16.71%,1
臺南市,安定區,0532,202,484,686,29,715,1487,48.08%,13.58%,1
臺南市,安定區,0533,213,464,677,27,704,1385,50.83%,15.38%,1
臺南市,安定區,0534,250,51,301,28,329,1518,21.67%,16.47%,1
臺南市,安定區,0535,199,401,600,41,641,1094,58.59%,18.19%,1
臺南市,安定區,0536,243,553,796,86,882,1590,55.47%,15.28%,1
臺南市,安定區,0537,115,290,405,22,427,754,56.63%,15.25%,1
臺南市,安定區,0538,124,252,376,35,411,716,57.4%,17.32%,1
臺南市,安定區,0539,267,506,773,43,816,1492,54.69%,17.9%,1
臺南市,安定區,0540,179,313,492,26,518,943,54.93%,18.98%,1
臺南市,安定區,0541,187,419,606,29,635,1157,54.88%,16.16%,1
臺南市,安定區,0542,241,465,706,63,769,1384,55.56%,17.41%,1
臺南市,安定區,0543,176,310,486,40,526,967,54.4%,18.2%,1
臺南市,安定區,0544,113,200,313,17,330,611,54.01%,18.49%,1
臺南市,山上區,0572,103,203,306,56,362,855,42.34%,12.05%,1
臺南市,山上區,0573,97,200,297,32,329,836,39.35%,11.6%,1
臺南市,山上區,0574,128,209,337,39,376,753,49.93%,17%,1
臺南市,山上區,0575,113,226,339,32,371,788,47.08%,14.34%,1
臺南市,山上區,0576,158,303,461,33,494,984,50.2%,16.06%,1
臺南市,山上區,0577,166,247,413,10,423,972,43.52%,17.08%,1
臺南市,山上區,0578,46,120,166,3,169,553,30.56%,8.32%,1
臺南市,山上區,0579,58,93,151,6,157,378,41.53%,15.34%,1
臺南市,山上區,0580,59,112,171,17,188,392,47.96%,15.05%,1
臺南市,玉井區,0466,177,400,577,28,605,1242,48.71%,14.25%,1
臺南市,玉井區,0467,142,420,562,36,598,1141,52.41%,12.45%,1
臺南市,玉井區,0468,98,221,319,25,344,698,49.28%,14.04%,1
臺南市,玉井區,0469,140,259,399,27,426,849,50.18%,16.49%,1
臺南市,玉井區,0470,125,329,454,57,511,949,53.85%,13.17%,1
臺南市,玉井區,0471,95,199,294,21,315,618,50.97%,15.37%,1
臺南市,玉井區,0472,72,167,239,8,247,594,41.58%,12.12%,1
臺南市,玉井區,0473,123,251,374,16,390,927,42.07%,13.27%,1
臺南市,玉井區,0474,72,167,239,36,275,512,53.71%,14.06%,1
臺南市,玉井區,0475,69,149,218,24,242,509,47.54%,13.56%,1
臺南市,玉井區,0476,70,173,243,24,267,496,53.83%,14.11%,1
臺南市,玉井區,0477,101,238,339,13,352,759,46.38%,13.31%,1
臺南市,玉井區,0478,68,184,252,8,260,669,38.86%,10.16%,1
臺南市,玉井區,0479,84,242,326,53,379,787,48.16%,10.67%,1
臺南市,玉井區,0480,80,174,254,38,292,620,47.1%,12.9%,1
臺南市,玉井區,0481,149,305,454,48,502,987,50.86%,15.1%,1
臺南市,楠西區,0447,97,323,420,56,476,978,48.67%,9.92%,1
臺南市,楠西區,0448,134,299,433,43,476,870,54.71%,15.4%,1
臺南市,楠西區,0449,88,296,384,14,398,1160,34.31%,7.59%,1
臺南市,楠西區,0450,72,216,288,15,303,699,43.35%,10.3%,1
臺南市,楠西區,0451,102,272,374,14,388,990,39.19%,10.3%,1
臺南市,楠西區,0452,140,247,387,28,415,928,44.72%,15.09%,1
臺南市,楠西區,0453,71,209,280,39,319,660,48.33%,10.76%,1
臺南市,楠西區,0454,155,358,513,74,587,1187,49.45%,13.06%,1
臺南市,楠西區,0455,136,324,460,36,496,1056,46.97%,12.88%,1
臺南市,南化區,0456,120,218,338,37,375,690,54.35%,17.39%,1
臺南市,南化區,0457,123,219,342,45,387,695,55.68%,17.7%,1
臺南市,南化區,0458,93,228,321,37,358,806,44.42%,11.54%,1
臺南市,南化區,0459,65,168,233,39,272,654,41.59%,9.94%,1
臺南市,南化區,0460,97,154,251,33,284,783,36.27%,12.39%,1
臺南市,南化區,0461,56,136,192,13,205,425,48.24%,13.18%,1
臺南市,南化區,0462,76,170,246,30,276,559,49.37%,13.6%,1
臺南市,南化區,0463,156,335,491,33,524,1189,44.07%,13.12%,1
臺南市,南化區,0464,143,363,506,34,540,1044,51.72%,13.7%,1
臺南市,南化區,0465,125,340,465,22,487,941,51.75%,13.28%,1
臺南市,左鎮區,0482,51,114,165,24,189,392,48.21%,13.01%,1
臺南市,左鎮區,0483,92,207,299,39,338,644,52.48%,14.29%,1
臺南市,左鎮區,0484,51,121,172,16,188,468,40.17%,10.9%,1
臺南市,左鎮區,0485,72,216,288,39,327,753,43.43%,9.56%,1
臺南市,左鎮區,0486,39,98,137,24,161,345,46.67%,11.3%,1
臺南市,左鎮區,0487,47,106,153,16,169,393,43%,11.96%,1
臺南市,左鎮區,0488,46,132,178,17,195,420,46.43%,10.95%,1
臺南市,左鎮區,0489,28,78,106,12,118,313,37.7%,8.95%,1
臺南市,左鎮區,0490,19,44,63,4,67,186,36.02%,10.22%,1
臺南市,左鎮區,0491,56,129,185,41,226,504,44.84%,11.11%,1
臺南市,仁德區,1188,241,429,670,61,731,1318,55.46%,18.29%,1
臺南市,仁德區,1189,247,470,717,51,768,1406,54.62%,17.57%,1
臺南市,仁德區,1190,235,474,709,56,765,1465,52.22%,16.04%,1
臺南市,仁德區,1191,244,411,655,65,720,1192,60.4%,20.47%,1
臺南市,仁德區,1192,268,496,764,59,823,1429,57.59%,18.75%,1
臺南市,仁德區,1193,223,409,632,92,724,1320,54.85%,16.89%,1
臺南市,仁德區,1194,244,512,756,77,833,1373,60.67%,17.77%,1
臺南市,仁德區,1195,232,491,723,45,768,1330,57.74%,17.44%,1
臺南市,仁德區,1196,307,608,915,33,948,1687,56.19%,18.2%,1
臺南市,仁德區,1197,264,437,701,54,755,1491,50.64%,17.71%,1
臺南市,仁德區,1198,169,349,518,28,546,1151,47.44%,14.68%,1
臺南市,仁德區,1199,211,499,710,17,727,1407,51.67%,15%,1
臺南市,仁德區,1200,248,544,792,39,831,1465,56.72%,16.93%,1
臺南市,仁德區,1201,250,479,729,32,761,1335,57%,18.73%,1
臺南市,仁德區,1202,247,478,725,61,786,1490,52.75%,16.58%,1
臺南市,仁德區,1203,276,532,808,44,852,1453,58.64%,19%,1
臺南市,仁德區,1204,181,310,491,15,506,990,51.11%,18.28%,1
臺南市,仁德區,1205,256,588,844,43,887,1573,56.39%,16.27%,1
臺南市,仁德區,1206,166,346,512,54,566,1031,54.9%,16.1%,1
臺南市,仁德區,1207,201,415,616,29,645,1194,54.02%,16.83%,1
臺南市,仁德區,1208,216,390,606,45,651,1268,51.34%,17.03%,1
臺南市,仁德區,1209,186,302,488,36,524,929,56.4%,20.02%,1
臺南市,仁德區,1210,178,350,528,16,544,1145,47.51%,15.55%,1
臺南市,仁德區,1211,240,456,696,41,737,1413,52.16%,16.99%,1
臺南市,仁德區,1212,224,480,704,83,787,1465,53.72%,15.29%,1
臺南市,仁德區,1213,246,505,751,43,794,1390,57.12%,17.7%,1
臺南市,仁德區,1214,253,442,695,70,765,1396,54.8%,18.12%,1
臺南市,仁德區,1215,346,600,946,52,998,1906,52.36%,18.15%,1
臺南市,仁德區,1216,253,498,751,24,775,1546,50.13%,16.36%,1
臺南市,仁德區,1217,258,414,672,22,694,1546,44.89%,16.69%,1
臺南市,仁德區,1218,233,500,733,50,783,1399,55.97%,16.65%,1
臺南市,仁德區,1219,303,540,843,81,924,1748,52.86%,17.33%,1
臺南市,仁德區,1220,204,403,607,33,640,1140,56.14%,17.89%,1
臺南市,仁德區,1221,202,432,634,30,664,1277,52%,15.82%,1
臺南市,仁德區,1222,183,421,604,42,646,1019,63.4%,17.96%,1
臺南市,仁德區,1223,216,453,669,34,703,1414,49.72%,15.28%,1
臺南市,仁德區,1224,198,407,605,28,633,1349,46.92%,14.68%,1
臺南市,仁德區,1225,244,471,715,22,737,1471,50.1%,16.59%,1
臺南市,仁德區,1226,238,436,674,19,693,1324,52.34%,17.98%,1
臺南市,仁德區,1227,163,426,589,52,641,1310,48.93%,12.44%,1
臺南市,仁德區,1228,117,170,287,24,311,554,56.14%,21.12%,1
臺南市,仁德區,1229,170,549,719,31,750,1395,53.76%,12.19%,1
臺南市,仁德區,1230,177,451,628,15,643,1264,50.87%,14%,1
臺南市,仁德區,1231,172,406,578,60,638,1180,54.07%,14.58%,1
臺南市,仁德區,1232,151,270,421,25,446,928,48.06%,16.27%,1
臺南市,仁德區,1233,149,286,435,17,452,965,46.84%,15.44%,1
臺南市,仁德區,1234,186,347,533,29,562,1119,50.22%,16.62%,1
臺南市,仁德區,1235,187,418,605,51,656,1206,54.39%,15.51%,1
臺南市,仁德區,1236,216,460,676,44,720,1466,49.11%,14.73%,1
臺南市,歸仁區,1237,232,510,742,65,807,1560,51.73%,14.87%,1
臺南市,歸仁區,1238,255,524,779,58,837,1383,60.52%,18.44%,1
臺南市,歸仁區,1239,275,478,753,39,792,1491,53.12%,18.44%,1
臺南市,歸仁區,1240,237,469,706,45,751,1482,50.67%,15.99%,1
臺南市,歸仁區,1241,249,445,694,23,717,1330,53.91%,18.72%,1
臺南市,歸仁區,1242,274,464,738,48,786,1399,56.18%,19.59%,1
臺南市,歸仁區,1243,258,419,677,35,712,1416,50.28%,18.22%,1
臺南市,歸仁區,1244,202,342,544,37,581,1336,43.49%,15.12%,1
臺南市,歸仁區,1245,175,348,523,65,588,1183,49.7%,14.79%,1
臺南市,歸仁區,1246,206,369,575,22,597,1237,48.26%,16.65%,1
臺南市,歸仁區,1247,202,381,583,55,638,1133,56.31%,17.83%,1
臺南市,歸仁區,1248,199,361,560,33,593,1149,51.61%,17.32%,1
臺南市,歸仁區,1249,190,377,567,2,569,1105,51.49%,17.19%,1
臺南市,歸仁區,1250,201,362,563,39,602,1099,54.78%,18.29%,1
臺南市,歸仁區,1251,177,396,573,62,635,1082,58.69%,16.36%,1
臺南市,歸仁區,1252,258,551,809,38,847,1519,55.76%,16.98%,1
臺南市,歸仁區,1253,261,526,787,53,840,1467,57.26%,17.79%,1
臺南市,歸仁區,1254,185,349,534,38,572,1090,52.48%,16.97%,1
臺南市,歸仁區,1255,193,364,557,29,586,1131,51.81%,17.06%,1
臺南市,歸仁區,1256,168,361,529,27,556,1080,51.48%,15.56%,1
臺南市,歸仁區,1257,164,328,492,22,514,1121,45.85%,14.63%,1
臺南市,歸仁區,1258,239,431,670,54,724,1336,54.19%,17.89%,1
臺南市,歸仁區,1259,201,354,555,60,615,1128,54.52%,17.82%,1
臺南市,歸仁區,1260,180,352,532,23,555,1055,52.61%,17.06%,1
臺南市,歸仁區,1261,180,374,554,35,589,1102,53.45%,16.33%,1
臺南市,歸仁區,1262,206,344,550,42,592,1068,55.43%,19.29%,1
臺南市,歸仁區,1263,191,361,552,42,594,1033,57.5%,18.49%,1
臺南市,歸仁區,1264,245,467,712,20,732,1772,41.31%,13.83%,1
臺南市,歸仁區,1265,247,465,712,60,772,1399,55.18%,17.66%,1
臺南市,歸仁區,1266,282,523,805,32,837,1544,54.21%,18.26%,1
臺南市,歸仁區,1267,110,190,300,8,308,684,45.03%,16.08%,1
臺南市,歸仁區,1268,173,296,469,31,500,839,59.59%,20.62%,1
臺南市,歸仁區,1269,208,338,546,50,596,1014,58.78%,20.51%,1
臺南市,歸仁區,1270,232,443,675,32,707,1906,37.09%,12.17%,1
臺南市,歸仁區,1271,233,436,669,44,713,1245,57.27%,18.71%,1
臺南市,歸仁區,1272,174,355,529,28,557,1048,53.15%,16.6%,1
臺南市,歸仁區,1273,192,396,588,22,610,1175,51.91%,16.34%,1
臺南市,歸仁區,1274,231,424,655,31,686,1411,48.62%,16.37%,1
臺南市,歸仁區,1275,312,509,821,35,856,1514,56.54%,20.61%,1
臺南市,歸仁區,1276,321,521,842,62,904,1678,53.87%,19.13%,1
臺南市,歸仁區,1277,190,301,491,31,522,949,55.01%,20.02%,1
臺南市,歸仁區,1278,166,386,552,52,604,1009,59.86%,16.45%,1
臺南市,歸仁區,1279,218,375,593,5,598,984,60.77%,22.15%,1
臺南市,歸仁區,1280,134,287,421,30,451,756,59.66%,17.72%,1
臺南市,歸仁區,1281,280,558,838,43,881,1478,59.61%,18.94%,1
臺南市,歸仁區,1282,282,518,800,60,860,1467,58.62%,19.22%,1
臺南市,關廟區,1283,161,335,496,25,521,982,53.05%,16.4%,1
臺南市,關廟區,1284,228,426,654,34,688,1156,59.52%,19.72%,1
臺南市,關廟區,1285,154,321,475,18,493,1006,49.01%,15.31%,1
臺南市,關廟區,1286,207,370,577,56,633,1043,60.69%,19.85%,1
臺南市,關廟區,1287,183,322,505,82,587,1012,58%,18.08%,1
臺南市,關廟區,1288,156,294,450,15,465,1013,45.9%,15.4%,1
臺南市,關廟區,1289,215,398,613,32,645,1294,49.85%,16.62%,1
臺南市,關廟區,1290,200,396,596,42,638,1264,50.47%,15.82%,1
臺南市,關廟區,1291,196,396,592,30,622,1166,53.34%,16.81%,1
臺南市,關廟區,1292,183,302,485,15,500,1018,49.12%,17.98%,1
臺南市,關廟區,1293,89,213,302,42,344,733,46.93%,12.14%,1
臺南市,關廟區,1294,169,448,617,28,645,1093,59.01%,15.46%,1
臺南市,關廟區,1295,183,394,577,29,606,1081,56.06%,16.93%,1
臺南市,關廟區,1296,189,353,542,33,575,978,58.79%,19.33%,1
臺南市,關廟區,1297,167,345,512,17,529,1116,47.4%,14.96%,1
臺南市,關廟區,1298,138,343,481,40,521,972,53.6%,14.2%,1
臺南市,關廟區,1299,188,339,527,73,600,1045,57.42%,17.99%,1
臺南市,關廟區,1300,170,266,436,35,471,872,54.01%,19.5%,1
臺南市,關廟區,1301,194,353,547,42,589,1007,58.49%,19.27%,1
臺南市,關廟區,1302,145,272,417,41,458,763,60.03%,19%,1
臺南市,關廟區,1303,93,211,304,30,334,630,53.02%,14.76%,1
臺南市,關廟區,1304,150,344,494,62,556,959,57.98%,15.64%,1
臺南市,關廟區,1305,169,384,553,30,583,1123,51.91%,15.05%,1
臺南市,關廟區,1306,130,267,397,62,459,804,57.09%,16.17%,1
臺南市,關廟區,1307,122,228,350,14,364,720,50.56%,16.94%,1
臺南市,關廟區,1308,119,251,370,19,389,843,46.14%,14.12%,1
臺南市,關廟區,1309,49,113,162,13,175,358,48.88%,13.69%,1
臺南市,關廟區,1310,127,240,367,61,428,797,53.7%,15.93%,1
臺南市,關廟區,1311,90,208,298,18,316,709,44.57%,12.69%,1
臺南市,關廟區,1312,128,267,395,19,414,904,45.8%,14.16%,1
臺南市,關廟區,1313,152,324,476,25,501,963,52.02%,15.78%,1
臺南市,關廟區,1314,104,155,259,14,273,489,55.83%,21.27%,1
臺南市,龍崎區,1315,169,311,480,55,535,1047,51.1%,16.14%,1
臺南市,龍崎區,1316,67,217,284,16,300,630,47.62%,10.63%,1
臺南市,龍崎區,1317,12,40,52,4,56,141,39.72%,8.51%,1
臺南市,龍崎區,1318,51,112,163,17,180,367,49.05%,13.9%,1
臺南市,龍崎區,1319,46,121,167,13,180,337,53.41%,13.65%,1
臺南市,龍崎區,1320,42,95,137,3,140,318,44.03%,13.21%,1
臺南市,龍崎區,1321,44,148,192,22,214,427,50.12%,10.3%,1
臺南市,龍崎區,1322,54,123,177,20,197,446,44.17%,12.11%,1
臺南市,永康區,0708,233,470,703,61,764,1398,54.65%,16.67%,1
臺南市,永康區,0709,229,409,638,25,663,1478,44.86%,15.49%,1
臺南市,永康區,0710,261,446,707,18,725,1442,50.28%,18.1%,1
臺南市,永康區,0711,220,416,636,30,666,1353,49.22%,16.26%,1
臺南市,永康區,0712,201,371,572,28,600,1160,51.72%,17.33%,1
臺南市,永康區,0713,198,395,593,25,618,1122,55.08%,17.65%,1
臺南市,永康區,0714,194,381,575,10,585,1165,50.21%,16.65%,1
臺南市,永康區,0715,246,384,630,26,656,1317,49.81%,18.68%,1
臺南市,永康區,0716,215,459,674,31,705,1376,51.24%,15.63%,1
臺南市,永康區,0717,259,440,699,28,727,1361,53.42%,19.03%,1
臺南市,永康區,0718,309,471,780,23,803,1374,58.44%,22.49%,1
臺南市,永康區,0719,297,493,790,48,838,1709,49.03%,17.38%,1
臺南市,永康區,0720,277,517,794,38,832,1717,48.46%,16.13%,1
臺南市,永康區,0721,283,530,813,33,846,1759,48.1%,16.09%,1
臺南市,永康區,0722,275,552,827,31,858,1636,52.44%,16.81%,1
臺南市,永康區,0723,254,467,721,42,763,1442,52.91%,17.61%,1
臺南市,永康區,0724,270,486,756,20,776,1545,50.23%,17.48%,1
臺南市,永康區,0725,223,540,763,34,797,1565,50.93%,14.25%,1
臺南市,永康區,0726,281,505,786,28,814,1684,48.34%,16.69%,1
臺南市,永康區,0727,250,494,744,14,758,1548,48.97%,16.15%,1
臺南市,永康區,0728,240,499,739,25,764,1389,55%,17.28%,1
臺南市,永康區,0729,259,424,683,43,726,1369,53.03%,18.92%,1
臺南市,永康區,0730,227,486,713,60,773,1415,54.63%,16.04%,1
臺南市,永康區,0731,214,409,623,7,630,1386,45.45%,15.44%,1
臺南市,永康區,0732,147,269,416,7,423,1747,24.21%,8.41%,1
臺南市,永康區,0733,249,481,730,37,767,1485,51.65%,16.77%,1
臺南市,永康區,0734,308,532,840,53,893,1747,51.12%,17.63%,1
臺南市,永康區,0735,275,483,758,37,795,1744,45.58%,15.77%,1
臺南市,永康區,0736,274,547,821,33,854,1797,47.52%,15.25%,1
臺南市,永康區,0737,321,604,925,50,975,1800,54.17%,17.83%,1
臺南市,永康區,0738,245,576,821,15,836,1720,48.6%,14.24%,1
臺南市,永康區,0739,312,580,892,28,920,1708,53.86%,18.27%,1
臺南市,永康區,0740,280,562,842,17,859,1519,56.55%,18.43%,1
臺南市,永康區,0741,253,530,783,58,841,1497,56.18%,16.9%,1
臺南市,永康區,0742,237,559,796,15,811,1509,53.74%,15.71%,1
臺南市,永康區,0743,263,585,848,61,909,1542,58.95%,17.06%,1
臺南市,永康區,0744,326,493,819,22,841,1536,54.75%,21.22%,1
臺南市,永康區,0745,279,507,786,37,823,1531,53.76%,18.22%,1
臺南市,永康區,0746,250,465,715,29,744,1327,56.07%,18.84%,1
臺南市,永康區,0747,272,477,749,13,762,1456,52.34%,18.68%,1
臺南市,永康區,0748,298,452,750,28,778,1396,55.73%,21.35%,1
臺南市,永康區,0749,272,528,800,44,844,1636,51.59%,16.63%,1
臺南市,永康區,0750,322,517,839,25,864,1592,54.27%,20.23%,1
臺南市,永康區,0751,432,513,945,15,960,2017,47.6%,21.42%,1
臺南市,永康區,0752,120,233,353,14,367,672,54.61%,17.86%,1
臺南市,永康區,0753,257,499,756,22,778,1611,48.29%,15.95%,1
臺南市,永康區,0754,310,450,760,33,793,1502,52.8%,20.64%,1
臺南市,永康區,0755,272,452,724,17,741,1660,44.64%,16.39%,1
臺南市,永康區,0756,272,394,666,27,693,1561,44.39%,17.42%,1
臺南市,永康區,0757,296,460,756,25,781,1590,49.12%,18.62%,1
臺南市,永康區,0758,193,271,464,18,482,924,52.16%,20.89%,1
臺南市,永康區,0759,185,337,522,24,546,938,58.21%,19.72%,1
臺南市,永康區,0760,185,322,507,32,539,957,56.32%,19.33%,1
臺南市,永康區,0761,91,160,251,26,277,496,55.85%,18.35%,1
臺南市,永康區,0762,309,553,862,47,909,1717,52.94%,18%,1
臺南市,永康區,0763,276,474,750,31,781,1615,48.36%,17.09%,1
臺南市,永康區,0764,256,494,750,19,769,1554,49.49%,16.47%,1
臺南市,永康區,0765,189,394,583,18,601,1196,50.25%,15.8%,1
臺南市,永康區,0766,246,395,641,24,665,1274,52.2%,19.31%,1
臺南市,永康區,0767,223,403,626,26,652,1215,53.66%,18.35%,1
臺南市,永康區,0768,256,493,749,19,768,1457,52.71%,17.57%,1
臺南市,永康區,0769,265,500,765,15,780,1451,53.76%,18.26%,1
臺南市,永康區,0770,227,424,651,39,690,1423,48.49%,15.95%,1
臺南市,永康區,0771,218,511,729,28,757,1394,54.3%,15.64%,1
臺南市,永康區,0772,170,315,485,32,517,890,58.09%,19.1%,1
臺南市,永康區,0773,202,379,581,34,615,1018,60.41%,19.84%,1
臺南市,永康區,0774,64,132,196,19,215,368,58.42%,17.39%,1
臺南市,永康區,0775,238,439,677,43,720,1208,59.6%,19.7%,1
臺南市,永康區,0776,222,366,588,27,615,1187,51.81%,18.7%,1
臺南市,永康區,0777,261,422,683,20,703,1381,50.91%,18.9%,1
臺南市,永康區,0778,232,454,686,47,733,1405,52.17%,16.51%,1
臺南市,永康區,0779,250,427,677,51,728,1445,50.38%,17.3%,1
臺南市,永康區,0780,313,497,810,42,852,1687,50.5%,18.55%,1
臺南市,永康區,0781,243,425,668,29,697,1535,45.41%,15.83%,1
臺南市,永康區,0782,283,521,804,33,837,1542,54.28%,18.35%,1
臺南市,永康區,0783,273,526,799,25,824,1618,50.93%,16.87%,1
臺南市,永康區,0784,269,457,726,17,743,1338,55.53%,20.1%,1
臺南市,永康區,0785,246,445,691,53,744,1285,57.9%,19.14%,1
臺南市,永康區,0786,218,402,620,22,642,1240,51.77%,17.58%,1
臺南市,永康區,0787,216,417,633,46,679,1343,50.56%,16.08%,1
臺南市,永康區,0788,250,482,732,34,766,1327,57.72%,18.84%,1
臺南市,永康區,0789,300,484,784,32,816,1565,52.14%,19.17%,1
臺南市,永康區,0790,279,474,753,70,823,1476,55.76%,18.9%,1
臺南市,永康區,0791,475,264,739,36,775,1476,52.51%,32.18%,1
臺南市,永康區,0792,301,505,806,36,842,1463,57.55%,20.57%,1
臺南市,永康區,0793,198,309,507,69,576,983,58.6%,20.14%,1
臺南市,永康區,0794,192,409,601,53,654,1116,58.6%,17.2%,1
臺南市,永康區,0795,194,347,541,51,592,1117,53%,17.37%,1
臺南市,永康區,0796,177,328,505,18,523,1069,48.92%,16.56%,1
臺南市,永康區,0797,223,436,659,38,697,1180,59.07%,18.9%,1
臺南市,永康區,0798,197,386,583,67,650,1176,55.27%,16.75%,1
臺南市,永康區,0799,206,361,567,41,608,1158,52.5%,17.79%,1
臺南市,永康區,0800,241,425,666,48,714,1208,59.11%,19.95%,1
臺南市,永康區,0801,274,476,750,56,806,1501,53.7%,18.25%,1
臺南市,永康區,0802,245,454,699,22,721,1298,55.55%,18.88%,1
臺南市,永康區,0803,286,503,789,21,810,1542,52.53%,18.55%,1
臺南市,永康區,0804,304,526,830,31,861,1537,56.02%,19.78%,1
臺南市,永康區,0805,306,484,790,35,825,1359,60.71%,22.52%,1
臺南市,永康區,0806,178,333,511,26,537,1139,47.15%,15.63%,1
臺南市,永康區,0807,200,345,545,30,575,1158,49.65%,17.27%,1
臺南市,永康區,0808,286,441,727,56,783,1538,50.91%,18.6%,1
臺南市,永康區,0809,180,381,561,17,578,1166,49.57%,15.44%,1
臺南市,永康區,0810,213,385,598,22,620,1228,50.49%,17.35%,1
臺南市,永康區,0811,231,404,635,41,676,1200,56.33%,19.25%,1
臺南市,永康區,0812,248,359,607,31,638,1131,56.41%,21.93%,1
臺南市,永康區,0813,213,379,592,18,610,1147,53.18%,18.57%,1
臺南市,永康區,0814,237,442,679,53,732,1442,50.76%,16.44%,1
臺南市,永康區,0815,235,411,646,22,668,1325,50.42%,17.74%,1
臺南市,永康區,0816,193,373,566,30,596,1260,47.3%,15.32%,1
臺南市,永康區,0817,242,509,751,50,801,1631,49.11%,14.84%,1
臺南市,永康區,0818,246,495,741,29,770,1549,49.71%,15.88%,1
臺南市,永康區,0819,284,530,814,22,836,1666,50.18%,17.05%,1
臺南市,永康區,0820,124,339,463,34,497,1012,49.11%,12.25%,1
臺南市,永康區,0821,129,301,430,19,449,976,46%,13.22%,1
臺南市,永康區,0822,82,197,279,11,290,531,54.61%,15.44%,1
臺南市,永康區,0823,157,290,447,40,487,859,56.69%,18.28%,1
臺南市,永康區,0824,171,266,437,32,469,937,50.05%,18.25%,1
臺南市,永康區,0825,207,466,673,30,703,1307,53.79%,15.84%,1
臺南市,永康區,0826,215,471,686,24,710,1482,47.91%,14.51%,1
臺南市,永康區,0827,203,405,608,24,632,1341,47.13%,15.14%,1
臺南市,永康區,0828,228,442,670,31,701,1376,50.94%,16.57%,1
臺南市,永康區,0829,209,450,659,32,691,1390,49.71%,15.04%,1
臺南市,永康區,0830,263,541,804,28,832,1534,54.24%,17.14%,1
臺南市,永康區,0831,247,535,782,31,813,1460,55.68%,16.92%,1
臺南市,永康區,0832,227,462,689,14,703,1383,50.83%,16.41%,1
臺南市,永康區,0833,232,436,668,26,694,1299,53.43%,17.86%,1
臺南市,永康區,0834,247,448,695,15,710,1264,56.17%,19.54%,1
臺南市,永康區,0835,269,468,737,31,768,1355,56.68%,19.85%,1
臺南市,永康區,0836,220,463,683,23,706,1414,49.93%,15.56%,1
臺南市,永康區,0837,213,392,605,24,629,1109,56.72%,19.21%,1
臺南市,永康區,0838,166,388,554,35,589,1151,51.17%,14.42%,1
臺南市,永康區,0839,104,522,626,34,660,1026,64.33%,10.14%,1
臺南市,永康區,0840,147,381,528,22,550,1071,51.35%,13.73%,1
臺南市,永康區,0841,279,548,827,45,872,1387,62.87%,20.12%,1
臺南市,永康區,0842,264,521,785,30,815,1377,59.19%,19.17%,1
臺南市,永康區,0843,285,568,853,54,907,1687,53.76%,16.89%,1
臺南市,永康區,0844,295,507,802,41,843,1700,49.59%,17.35%,1
臺南市,永康區,0845,274,502,776,27,803,1444,55.61%,18.98%,1
臺南市,永康區,0846,239,496,735,27,762,1485,51.31%,16.09%,1
臺南市,永康區,0847,255,536,791,33,824,1717,47.99%,14.85%,1
臺南市,永康區,0848,272,491,763,38,801,1701,47.09%,15.99%,1
臺南市,永康區,0849,238,444,682,22,704,1382,50.94%,17.22%,1
臺南市,東區,1095,360,670,1030,41,1071,2681,39.95%,13.43%,1
臺南市,東區,1096,348,584,932,28,960,1811,53.01%,19.22%,1
臺南市,東區,1097,321,555,876,58,934,1491,62.64%,21.53%,1
臺南市,東區,1098,273,452,725,30,755,1378,54.79%,19.81%,1
臺南市,東區,1099,325,528,853,43,896,1552,57.73%,20.94%,1
臺南市,東區,1100,254,504,758,14,772,1326,58.22%,19.16%,1
臺南市,東區,1101,303,551,854,44,898,1594,56.34%,19.01%,1
臺南市,東區,1102,361,557,918,30,948,1639,57.84%,22.03%,1
臺南市,東區,1103,343,554,897,43,940,1724,54.52%,19.9%,1
臺南市,東區,1104,288,564,852,58,910,1629,55.86%,17.68%,1
臺南市,東區,1105,278,487,765,19,784,1399,56.04%,19.87%,1
臺南市,東區,1106,306,528,834,33,867,1534,56.52%,19.95%,1
臺南市,東區,1107,347,566,913,28,941,1656,56.82%,20.95%,1
臺南市,東區,1108,229,467,696,35,731,1322,55.3%,17.32%,1
臺南市,東區,1109,347,504,851,25,876,1620,54.07%,21.42%,1
臺南市,東區,1110,272,515,787,28,815,1331,61.23%,20.44%,1
臺南市,東區,1111,173,395,568,31,599,1039,57.65%,16.65%,1
臺南市,東區,1112,184,431,615,25,640,1257,50.91%,14.64%,1
臺南市,東區,1113,350,643,993,70,1063,2067,51.43%,16.93%,1
臺南市,東區,1114,341,799,1140,27,1167,2153,54.2%,15.84%,1
臺南市,東區,1115,415,792,1207,41,1248,2363,52.81%,17.56%,1
臺南市,東區,1116,246,499,745,40,785,1427,55.01%,17.24%,1
臺南市,東區,1117,297,573,870,28,898,1555,57.75%,19.1%,1
臺南市,東區,1118,316,611,927,42,969,2115,45.82%,14.94%,1
臺南市,東區,1119,408,699,1107,49,1156,2340,49.4%,17.44%,1
臺南市,東區,1120,476,799,1275,38,1313,2474,53.07%,19.24%,1
臺南市,東區,1121,383,808,1191,50,1241,2391,51.9%,16.02%,1
臺南市,東區,1122,335,568,903,33,936,1673,55.95%,20.02%,1
臺南市,東區,1123,298,538,836,28,864,1594,54.2%,18.7%,1
臺南市,東區,1124,304,572,876,44,920,1607,57.25%,18.92%,1
臺南市,東區,1125,453,735,1188,22,1210,2087,57.98%,21.71%,1
臺南市,東區,1126,507,823,1330,27,1357,2369,57.28%,21.4%,1
臺南市,東區,1127,277,567,844,67,911,1696,53.71%,16.33%,1
臺南市,東區,1128,316,549,865,31,896,1612,55.58%,19.6%,1
臺南市,東區,1129,311,542,853,36,889,1708,52.05%,18.21%,1
臺南市,東區,1130,292,535,827,32,859,1560,55.06%,18.72%,1
臺南市,東區,1131,356,589,945,46,991,1854,53.45%,19.2%,1
臺南市,東區,1132,392,704,1096,33,1129,2278,49.56%,17.21%,1
臺南市,東區,1133,402,667,1069,28,1097,2093,52.41%,19.21%,1
臺南市,東區,1134,463,781,1244,30,1274,2242,56.82%,20.65%,1
臺南市,東區,1135,248,414,662,30,692,1152,60.07%,21.53%,1
臺南市,東區,1136,282,502,784,14,798,1318,60.55%,21.4%,1
臺南市,東區,1137,457,744,1201,36,1237,2200,56.23%,20.77%,1
臺南市,東區,1138,411,707,1118,25,1143,1960,58.32%,20.97%,1
臺南市,東區,1139,277,489,766,45,811,1489,54.47%,18.6%,1
臺南市,東區,1140,282,457,739,55,794,1443,55.02%,19.54%,1
臺南市,東區,1141,374,506,880,30,910,1498,60.75%,24.97%,1
臺南市,東區,1142,339,551,890,19,909,1622,56.04%,20.9%,1
臺南市,東區,1143,353,577,930,38,968,1738,55.7%,20.31%,1
臺南市,東區,1144,282,467,749,48,797,1501,53.1%,18.79%,1
臺南市,東區,1145,255,543,798,37,835,1482,56.34%,17.21%,1
臺南市,東區,1146,308,558,866,33,899,1829,49.15%,16.84%,1
臺南市,東區,1147,307,616,923,42,965,1764,54.71%,17.4%,1
臺南市,東區,1148,311,496,807,24,831,1427,58.23%,21.79%,1
臺南市,東區,1149,272,450,722,50,772,1427,54.1%,19.06%,1
臺南市,東區,1150,277,467,744,38,782,1388,56.34%,19.96%,1
臺南市,東區,1151,289,385,674,21,695,1131,61.45%,25.55%,1
臺南市,東區,1152,195,320,515,30,545,1000,54.5%,19.5%,1
臺南市,東區,1153,181,354,535,22,557,996,55.92%,18.17%,1
臺南市,東區,1154,155,310,465,36,501,935,53.58%,16.58%,1
臺南市,東區,1155,196,310,506,39,545,947,57.55%,20.7%,1
臺南市,東區,1156,228,356,584,11,595,1090,54.59%,20.92%,1
臺南市,東區,1157,172,278,450,30,480,896,53.57%,19.2%,1
臺南市,東區,1158,320,510,830,26,856,1589,53.87%,20.14%,1
臺南市,東區,1159,321,499,820,32,852,1497,56.91%,21.44%,1
臺南市,東區,1160,243,448,691,47,738,1386,53.25%,17.53%,1
臺南市,東區,1161,226,375,601,16,617,1101,56.04%,20.53%,1
臺南市,東區,1162,271,457,728,46,774,1332,58.11%,20.35%,1
臺南市,東區,1163,223,425,648,25,673,1185,56.79%,18.82%,1
臺南市,東區,1164,236,474,710,35,745,1262,59.03%,18.7%,1
臺南市,東區,1165,228,498,726,52,778,1517,51.29%,15.03%,1
臺南市,東區,1166,241,404,645,70,715,1287,55.56%,18.73%,1
臺南市,東區,1167,326,549,875,49,924,1657,55.76%,19.67%,1
臺南市,東區,1168,749,405,1154,68,1222,2238,54.6%,33.47%,1
臺南市,東區,1169,449,682,1131,49,1180,2246,52.54%,19.99%,1
臺南市,東區,1170,428,690,1118,41,1159,2191,52.9%,19.53%,1
臺南市,東區,1171,374,663,1037,46,1083,2063,52.5%,18.13%,1
臺南市,東區,1172,408,783,1191,66,1257,2177,57.74%,18.74%,1
臺南市,東區,1173,333,719,1052,39,1091,1863,58.56%,17.87%,1
臺南市,東區,1174,403,779,1182,31,1213,2185,55.51%,18.44%,1
臺南市,東區,1175,270,525,795,39,834,1721,48.46%,15.69%,1
臺南市,東區,1176,275,511,786,78,864,1556,55.53%,17.67%,1
臺南市,東區,1177,354,534,888,32,920,1602,57.43%,22.1%,1
臺南市,東區,1178,268,492,760,50,810,1523,53.18%,17.6%,1
臺南市,東區,1179,253,411,664,34,698,1382,50.51%,18.31%,1
臺南市,東區,1180,280,490,770,35,805,1486,54.17%,18.84%,1
臺南市,東區,1181,285,547,832,45,877,1560,56.22%,18.27%,1
臺南市,東區,1182,313,484,797,49,846,1684,50.24%,18.59%,1
臺南市,東區,1183,351,534,885,30,915,1653,55.35%,21.23%,1
臺南市,東區,1184,372,475,847,11,858,1554,55.21%,23.94%,1
臺南市,東區,1185,302,486,788,15,803,1408,57.03%,21.45%,1
臺南市,東區,1186,394,791,1185,27,1212,2084,58.16%,18.91%,1
臺南市,東區,1187,419,588,1007,28,1035,1896,54.59%,22.1%,1
臺南市,南區,1015,216,447,663,39,702,1221,57.49%,17.69%,1
臺南市,南區,1016,333,619,952,61,1013,2171,46.66%,15.34%,1
臺南市,南區,1017,227,415,642,26,668,1150,58.09%,19.74%,1
臺南市,南區,1018,200,421,621,27,648,1122,57.75%,17.83%,1
臺南市,南區,1019,216,460,676,35,711,1444,49.24%,14.96%,1
臺南市,南區,1020,303,534,837,43,880,1765,49.86%,17.17%,1
臺南市,南區,1021,234,479,713,39,752,1298,57.94%,18.03%,1
臺南市,南區,1022,232,541,773,30,803,1458,55.08%,15.91%,1
臺南市,南區,1023,307,634,941,24,965,1940,49.74%,15.82%,1
臺南市,南區,1024,284,554,838,43,881,1637,53.82%,17.35%,1
臺南市,南區,1025,158,239,397,10,407,871,46.73%,18.14%,1
臺南市,南區,1026,132,191,323,18,341,589,57.89%,22.41%,1
臺南市,南區,1027,180,312,492,36,528,801,65.92%,22.47%,1
臺南市,南區,1028,166,363,529,39,568,990,57.37%,16.77%,1
臺南市,南區,1029,227,478,705,36,741,1222,60.64%,18.58%,1
臺南市,南區,1030,183,359,542,57,599,997,60.08%,18.36%,1
臺南市,南區,1031,209,380,589,26,615,1204,51.08%,17.36%,1
臺南市,南區,1032,267,458,725,24,749,1570,47.71%,17.01%,1
臺南市,南區,1033,255,379,634,46,680,1222,55.65%,20.87%,1
臺南市,南區,1034,172,341,513,19,532,1076,49.44%,15.99%,1
臺南市,南區,1035,198,396,594,26,620,1127,55.01%,17.57%,1
臺南市,南區,1036,205,390,595,45,640,1135,56.39%,18.06%,1
臺南市,南區,1037,230,394,624,47,671,1263,53.13%,18.21%,1
臺南市,南區,1038,186,311,497,25,522,1014,51.48%,18.34%,1
臺南市,南區,1039,273,521,794,45,839,1491,56.27%,18.31%,1
臺南市,南區,1040,331,607,938,35,973,1815,53.61%,18.24%,1
臺南市,南區,1041,269,431,700,16,716,1398,51.22%,19.24%,1
臺南市,南區,1042,296,588,884,33,917,2107,43.52%,14.05%,1
臺南市,南區,1043,321,585,906,38,944,1587,59.48%,20.23%,1
臺南市,南區,1044,203,546,749,55,804,1626,49.45%,12.48%,1
臺南市,南區,1045,288,547,835,30,865,1761,49.12%,16.35%,1
臺南市,南區,1046,291,511,802,67,869,1630,53.31%,17.85%,1
臺南市,南區,1047,251,540,791,44,835,1542,54.15%,16.28%,1
臺南市,南區,1048,273,436,709,71,780,1464,53.28%,18.65%,1
臺南市,南區,1049,259,572,831,78,909,1727,52.63%,15%,1
臺南市,南區,1050,232,371,603,53,656,1085,60.46%,21.38%,1
臺南市,南區,1051,157,308,465,23,488,939,51.97%,16.72%,1
臺南市,南區,1052,214,408,622,67,689,1419,48.56%,15.08%,1
臺南市,南區,1053,226,404,630,40,670,1333,50.26%,16.95%,1
臺南市,南區,1054,261,439,700,38,738,1465,50.38%,17.82%,1
臺南市,南區,1055,211,362,573,23,596,1099,54.23%,19.2%,1
臺南市,南區,1056,183,355,538,19,557,1133,49.16%,16.15%,1
臺南市,南區,1057,200,439,639,75,714,1375,51.93%,14.55%,1
臺南市,南區,1058,306,493,799,23,822,1781,46.15%,17.18%,1
臺南市,南區,1059,273,556,829,47,876,1542,56.81%,17.7%,1
臺南市,南區,1060,221,467,688,31,719,1486,48.38%,14.87%,1
臺南市,南區,1061,288,576,864,61,925,1640,56.4%,17.56%,1
臺南市,南區,1062,252,482,734,38,772,1701,45.39%,14.81%,1
臺南市,南區,1063,208,479,687,63,750,1541,48.67%,13.5%,1
臺南市,南區,1064,317,618,935,90,1025,2027,50.57%,15.64%,1
臺南市,南區,1065,315,667,982,57,1039,1774,58.57%,17.76%,1
臺南市,南區,1066,270,521,791,46,837,1613,51.89%,16.74%,1
臺南市,南區,1067,275,554,829,13,842,1707,49.33%,16.11%,1
臺南市,南區,1068,179,386,565,21,586,1657,35.37%,10.8%,1
臺南市,南區,1069,179,369,548,34,582,1077,54.04%,16.62%,1
臺南市,南區,1070,209,392,601,32,633,1185,53.42%,17.64%,1
臺南市,南區,1071,227,392,619,41,660,1249,52.84%,18.17%,1
臺南市,南區,1072,281,600,881,29,910,1985,45.84%,14.16%,1
臺南市,南區,1073,313,556,869,49,918,2017,45.51%,15.52%,1
臺南市,南區,1074,289,497,786,50,836,1717,48.69%,16.83%,1
臺南市,南區,1075,158,328,486,35,521,929,56.08%,17.01%,1
臺南市,南區,1076,146,226,372,22,394,695,56.69%,21.01%,1
臺南市,南區,1077,133,319,452,25,477,997,47.84%,13.34%,1
臺南市,南區,1078,103,263,366,16,382,784,48.72%,13.14%,1
臺南市,南區,1079,169,417,586,65,651,1119,58.18%,15.1%,1
臺南市,南區,1080,155,286,441,36,477,1054,45.26%,14.71%,1
臺南市,南區,1081,198,395,593,48,641,1245,51.49%,15.9%,1
臺南市,南區,1082,286,606,892,77,969,2064,46.95%,13.86%,1
臺南市,南區,1083,286,527,813,21,834,2056,40.56%,13.91%,1
臺南市,南區,1084,193,424,617,21,638,1373,46.47%,14.06%,1
臺南市,南區,1085,137,293,430,30,460,1002,45.91%,13.67%,1
臺南市,南區,1086,132,255,387,57,444,760,58.42%,17.37%,1
臺南市,南區,1087,190,322,512,57,569,1031,55.19%,18.43%,1
臺南市,南區,1088,143,238,381,33,414,744,55.65%,19.22%,1
臺南市,南區,1089,226,361,587,58,645,1186,54.38%,19.06%,1
臺南市,南區,1090,242,454,696,46,742,1358,54.64%,17.82%,1
臺南市,南區,1091,139,267,406,20,426,897,47.49%,15.5%,1
臺南市,南區,1092,214,407,621,42,663,1265,52.41%,16.92%,1
臺南市,南區,1093,159,341,500,28,528,1093,48.31%,14.55%,1
臺南市,南區,1094,206,333,539,33,572,1016,56.3%,20.28%,1
臺南市,北區,0850,289,558,847,64,911,1793,50.81%,16.12%,1
臺南市,北區,0851,268,528,796,39,835,1708,48.89%,15.69%,1
臺南市,北區,0852,211,294,505,9,514,997,51.55%,21.16%,1
臺南市,北區,0853,274,363,637,16,653,1452,44.97%,18.87%,1
臺南市,北區,0854,262,402,664,19,683,1351,50.56%,19.39%,1
臺南市,北區,0855,280,505,785,43,828,1323,62.59%,21.16%,1
臺南市,北區,0856,192,400,592,20,612,1073,57.04%,17.89%,1
臺南市,北區,0857,209,428,637,25,662,1138,58.17%,18.37%,1
臺南市,北區,0858,194,410,604,29,633,1189,53.24%,16.32%,1
臺南市,北區,0859,275,466,741,28,769,1262,60.94%,21.79%,1
臺南市,北區,0860,230,364,594,16,610,1017,59.98%,22.62%,1
臺南市,北區,0861,152,300,452,16,468,847,55.25%,17.95%,1
臺南市,北區,0862,165,426,591,31,622,1076,57.81%,15.33%,1
臺南市,北區,0863,182,364,546,23,569,954,59.64%,19.08%,1
臺南市,北區,0864,196,437,633,61,694,1300,53.38%,15.08%,1
臺南市,北區,0865,199,505,704,33,737,1390,53.02%,14.32%,1
臺南市,北區,0866,209,500,709,34,743,1318,56.37%,15.86%,1
臺南市,北區,0867,171,331,502,16,518,974,53.18%,17.56%,1
臺南市,北區,0868,184,341,525,18,543,990,54.85%,18.59%,1
臺南市,北區,0869,234,370,604,21,625,1016,61.52%,23.03%,1
臺南市,北區,0870,186,380,566,25,591,1053,56.13%,17.66%,1
臺南市,北區,0871,264,449,713,50,763,1466,52.05%,18.01%,1
臺南市,北區,0872,271,544,815,38,853,1535,55.57%,17.65%,1
臺南市,北區,0873,246,541,787,43,830,1544,53.76%,15.93%,1
臺南市,北區,0874,496,441,937,46,983,1760,55.85%,28.18%,1
臺南市,北區,0875,229,457,686,20,706,1372,51.46%,16.69%,1
臺南市,北區,0876,179,377,556,31,587,1002,58.58%,17.86%,1
臺南市,北區,0877,208,440,648,33,681,1171,58.16%,17.76%,1
臺南市,北區,0878,195,418,613,21,634,1285,49.34%,15.18%,1
臺南市,北區,0879,149,373,522,24,546,1036,52.7%,14.38%,1
臺南市,北區,0880,224,485,709,40,749,1392,53.81%,16.09%,1
臺南市,北區,0881,174,425,599,41,640,1147,55.8%,15.17%,1
臺南市,北區,0882,208,461,669,25,694,1526,45.48%,13.63%,1
臺南市,北區,0883,281,517,798,31,829,1559,53.18%,18.02%,1
臺南市,北區,0884,147,309,456,55,511,892,57.29%,16.48%,1
臺南市,北區,0885,182,272,454,35,489,937,52.19%,19.42%,1
臺南市,北區,0886,281,506,787,46,833,1449,57.49%,19.39%,1
臺南市,北區,0887,219,371,590,25,615,1160,53.02%,18.88%,1
臺南市,北區,0888,219,339,558,37,595,1567,37.97%,13.98%,1
臺南市,北區,0889,243,427,670,45,715,1346,53.12%,18.05%,1
臺南市,北區,0890,263,419,682,11,693,1451,47.76%,18.13%,1
臺南市,北區,0891,277,475,752,30,782,1522,51.38%,18.2%,1
臺南市,北區,0892,214,433,647,19,666,1278,52.11%,16.74%,1
臺南市,北區,0893,179,385,564,38,602,1164,51.72%,15.38%,1
臺南市,北區,0894,203,307,510,14,524,1091,48.03%,18.61%,1
臺南市,北區,0895,159,339,498,17,515,993,51.86%,16.01%,1
臺南市,北區,0896,175,327,502,26,528,1119,47.18%,15.64%,1
臺南市,北區,0897,327,552,879,49,928,1685,55.07%,19.41%,1
臺南市,北區,0898,283,436,719,11,730,1368,53.36%,20.69%,1
臺南市,北區,0899,259,461,720,35,755,1389,54.36%,18.65%,1
臺南市,北區,0900,326,500,826,20,846,1469,57.59%,22.19%,1
臺南市,北區,0901,345,570,915,36,951,1655,57.46%,20.85%,1
臺南市,北區,0902,256,444,700,21,721,1261,57.18%,20.3%,1
臺南市,北區,0903,270,494,764,13,777,1490,52.15%,18.12%,1
臺南市,北區,0904,303,506,809,24,833,1436,58.01%,21.1%,1
臺南市,北區,0905,252,491,743,51,794,1340,59.25%,18.81%,1
臺南市,北區,0906,313,466,779,31,810,1464,55.33%,21.38%,1
臺南市,北區,0907,324,521,845,26,871,1513,57.57%,21.41%,1
臺南市,北區,0908,385,556,941,15,956,1709,55.94%,22.53%,1
臺南市,北區,0909,382,496,878,31,909,1517,59.92%,25.18%,1
臺南市,北區,0910,317,507,824,25,849,1598,53.13%,19.84%,1
臺南市,北區,0911,294,411,705,33,738,1399,52.75%,21.02%,1
臺南市,北區,0912,219,383,602,46,648,1214,53.38%,18.04%,1
臺南市,北區,0913,239,346,585,15,600,1064,56.39%,22.46%,1
臺南市,北區,0914,278,390,668,36,704,1148,61.32%,24.22%,1
臺南市,北區,0915,260,485,745,35,780,1391,56.07%,18.69%,1
臺南市,北區,0916,320,541,861,33,894,1584,56.44%,20.2%,1
臺南市,北區,0917,297,571,868,24,892,1595,55.92%,18.62%,1
臺南市,北區,0918,241,473,714,27,741,1397,53.04%,17.25%,1
臺南市,北區,0919,325,528,853,34,887,1662,53.37%,19.55%,1
臺南市,北區,0920,322,493,815,23,838,1634,51.29%,19.71%,1
臺南市,北區,0921,336,627,963,53,1016,1793,56.66%,18.74%,1
臺南市,北區,0922,364,657,1021,34,1055,1872,56.36%,19.44%,1
臺南市,北區,0923,344,616,960,57,1017,1874,54.27%,18.36%,1
臺南市,北區,0924,304,576,880,42,922,1760,52.39%,17.27%,1
臺南市,北區,0925,301,543,844,62,906,1753,51.68%,17.17%,1
臺南市,北區,0926,248,409,657,21,678,1502,45.14%,16.51%,1
臺南市,北區,0927,270,489,759,34,793,1470,53.95%,18.37%,1
臺南市,北區,0928,265,388,653,56,709,1319,53.75%,20.09%,1
臺南市,北區,0929,334,681,1015,34,1049,1876,55.92%,17.8%,1
臺南市,北區,0930,330,560,890,13,903,1720,52.5%,19.19%,1
臺南市,安南區,0618,527,792,1319,26,1345,2549,52.77%,20.67%,1
臺南市,安南區,0619,372,764,1136,57,1193,2321,51.4%,16.03%,1
臺南市,安南區,0620,384,752,1136,58,1194,2156,55.38%,17.81%,1
臺南市,安南區,0621,292,621,913,58,971,1662,58.42%,17.57%,1
臺南市,安南區,0622,250,566,816,75,891,1512,58.93%,16.53%,1
臺南市,安南區,0623,255,519,774,51,825,1625,50.77%,15.69%,1
臺南市,安南區,0624,332,619,951,47,998,2143,46.57%,15.49%,1
臺南市,安南區,0625,462,795,1257,69,1326,2457,53.97%,18.8%,1
臺南市,安南區,0626,404,725,1129,72,1201,2148,55.91%,18.81%,1
臺南市,安南區,0627,455,710,1165,67,1232,2364,52.12%,19.25%,1
臺南市,安南區,0628,380,489,869,40,909,1868,48.66%,20.34%,1
臺南市,安南區,0629,353,639,992,56,1048,1797,58.32%,19.64%,1
臺南市,安南區,0630,367,814,1181,39,1220,2268,53.79%,16.18%,1
臺南市,安南區,0631,360,614,974,63,1037,2291,45.26%,15.71%,1
臺南市,安南區,0632,387,725,1112,40,1152,2255,51.09%,17.16%,1
臺南市,安南區,0633,338,545,883,57,940,1940,48.45%,17.42%,1
臺南市,安南區,0634,280,767,1047,43,1090,2013,54.15%,13.91%,1
臺南市,安南區,0635,340,658,998,47,1045,2024,51.63%,16.8%,1
臺南市,安南區,0636,349,569,918,65,983,1613,60.94%,21.64%,1
臺南市,安南區,0637,203,379,582,30,612,1178,51.95%,17.23%,1
臺南市,安南區,0638,349,728,1077,73,1150,2143,53.66%,16.29%,1
臺南市,安南區,0639,361,540,901,64,965,1721,56.07%,20.98%,1
臺南市,安南區,0640,345,613,958,50,1008,1773,56.85%,19.46%,1
臺南市,安南區,0641,291,458,749,18,767,1428,53.71%,20.38%,1
臺南市,安南區,0642,284,562,846,45,891,1626,54.8%,17.47%,1
臺南市,安南區,0643,275,425,700,34,734,1358,54.05%,20.25%,1
臺南市,安南區,0644,266,546,812,37,849,1447,58.67%,18.38%,1
臺南市,安南區,0645,266,439,705,66,771,1358,56.77%,19.59%,1
臺南市,安南區,0646,337,674,1011,32,1043,2116,49.29%,15.93%,1
臺南市,安南區,0647,254,819,1073,42,1115,2321,48.04%,10.94%,1
臺南市,安南區,0648,363,671,1034,30,1064,2117,50.26%,17.15%,1
臺南市,安南區,0649,323,582,905,54,959,1927,49.77%,16.76%,1
臺南市,安南區,0650,386,679,1065,82,1147,2242,51.16%,17.22%,1
臺南市,安南區,0651,361,729,1090,42,1132,2334,48.5%,15.47%,1
臺南市,安南區,0652,330,613,943,49,992,1822,54.45%,18.11%,1
臺南市,安南區,0653,324,622,946,70,1016,1813,56.04%,17.87%,1
臺南市,安南區,0654,377,709,1086,82,1168,2188,53.38%,17.23%,1
臺南市,安南區,0655,386,711,1097,76,1173,2399,48.9%,16.09%,1
臺南市,安南區,0656,356,647,1003,57,1060,2247,47.17%,15.84%,1
臺南市,安南區,0657,220,445,665,54,719,1165,61.72%,18.88%,1
臺南市,安南區,0658,251,484,735,42,777,1539,50.49%,16.31%,1
臺南市,安南區,0659,321,631,952,83,1035,1835,56.4%,17.49%,1
臺南市,安南區,0660,297,610,907,66,973,1797,54.15%,16.53%,1
臺南市,安南區,0661,370,659,1029,69,1098,2223,49.39%,16.64%,1
臺南市,安南區,0662,197,372,569,53,622,977,63.66%,20.16%,1
臺南市,安南區,0663,255,478,733,34,767,1642,46.71%,15.53%,1
臺南市,安南區,0664,313,574,887,53,940,1697,55.39%,18.44%,1
臺南市,安南區,0665,299,604,903,48,951,1966,48.37%,15.21%,1
臺南市,安南區,0666,225,422,647,53,700,1319,53.07%,17.06%,1
臺南市,安南區,0667,346,533,879,56,935,1909,48.98%,18.12%,1
臺南市,安南區,0668,300,600,900,48,948,1763,53.77%,17.02%,1
臺南市,安南區,0669,194,279,473,43,516,965,53.47%,20.1%,1
臺南市,安南區,0670,226,440,666,42,708,1547,45.77%,14.61%,1
臺南市,安南區,0671,311,549,860,44,904,1784,50.67%,17.43%,1
臺南市,安南區,0672,330,634,964,60,1024,2145,47.74%,15.38%,1
臺南市,安南區,0673,471,808,1279,51,1330,2443,54.44%,19.28%,1
臺南市,安南區,0674,379,716,1095,35,1130,2565,44.05%,14.78%,1
臺南市,安南區,0675,398,830,1228,60,1288,2480,51.94%,16.05%,1
臺南市,安南區,0676,363,620,983,76,1059,2349,45.08%,15.45%,1
臺南市,安南區,0677,398,699,1097,64,1161,2168,53.55%,18.36%,1
臺南市,安南區,0678,269,534,803,42,845,1630,51.84%,16.5%,1
臺南市,安南區,0679,255,504,759,30,789,1675,47.1%,15.22%,1
臺南市,安南區,0680,400,543,943,76,1019,1627,62.63%,24.59%,1
臺南市,安南區,0681,254,507,761,56,817,1493,54.72%,17.01%,1
臺南市,安南區,0682,240,484,724,63,787,1397,56.34%,17.18%,1
臺南市,安南區,0683,237,457,694,50,744,1416,52.54%,16.74%,1
臺南市,安南區,0684,264,475,739,36,775,1460,53.08%,18.08%,1
臺南市,安南區,0685,324,652,976,34,1010,2222,45.45%,14.58%,1
臺南市,安南區,0686,369,664,1033,65,1098,2070,53.04%,17.83%,1
臺南市,安南區,0687,312,615,927,32,959,1739,55.15%,17.94%,1
臺南市,安南區,0688,302,575,877,65,942,1830,51.48%,16.5%,1
臺南市,安南區,0689,327,666,993,63,1056,1803,58.57%,18.14%,1
臺南市,安南區,0690,353,610,963,52,1015,1800,56.39%,19.61%,1
臺南市,安南區,0691,297,500,797,55,852,1815,46.94%,16.36%,1
臺南市,安南區,0692,280,580,860,30,890,1846,48.21%,15.17%,1
臺南市,安南區,0693,180,330,510,47,557,905,61.55%,19.89%,1
臺南市,安南區,0694,220,384,604,60,664,1073,61.88%,20.5%,1
臺南市,安南區,0695,269,587,856,58,914,1579,57.88%,17.04%,1
臺南市,安南區,0696,300,589,889,84,973,1876,51.87%,15.99%,1
臺南市,安南區,0697,207,373,580,37,617,1194,51.68%,17.34%,1
臺南市,安南區,0698,178,392,570,25,595,1475,40.34%,12.07%,1
臺南市,安南區,0699,199,464,663,19,682,1380,49.42%,14.42%,1
臺南市,安南區,0700,256,432,688,33,721,1462,49.32%,17.51%,1
臺南市,安南區,0701,172,396,568,50,618,1044,59.2%,16.48%,1
臺南市,安南區,0702,134,223,357,38,395,603,65.51%,22.22%,1
臺南市,安南區,0703,120,259,379,20,399,690,57.83%,17.39%,1
臺南市,安南區,0704,238,442,680,43,723,1447,49.97%,16.45%,1
臺南市,安南區,0705,175,391,566,32,598,910,65.71%,19.23%,1
臺南市,安南區,0706,264,563,827,67,894,1850,48.32%,14.27%,1
臺南市,安南區,0707,263,570,833,47,880,1501,58.63%,17.52%,1
臺南市,安平區,0983,326,598,924,46,970,1753,55.33%,18.6%,1
臺南市,安平區,0984,355,571,926,36,962,1859,51.75%,19.1%,1
臺南市,安平區,0985,257,528,785,31,816,1382,59.04%,18.6%,1
臺南市,安平區,0986,394,816,1210,56,1266,2547,49.71%,15.47%,1
臺南市,安平區,0987,465,763,1228,31,1259,2407,52.31%,19.32%,1
臺南市,安平區,0988,355,582,937,32,969,2070,46.81%,17.15%,1
臺南市,安平區,0989,401,696,1097,26,1123,2132,52.67%,18.81%,1
臺南市,安平區,0990,261,524,785,14,799,1450,55.1%,18%,1
臺南市,安平區,0991,308,482,790,18,808,1605,50.34%,19.19%,1
臺南市,安平區,0992,310,591,901,46,947,1755,53.96%,17.66%,1
臺南市,安平區,0993,276,515,791,24,815,1728,47.16%,15.97%,1
臺南市,安平區,0994,262,459,721,27,748,1754,42.65%,14.94%,1
臺南市,安平區,0995,331,500,831,41,872,1686,51.72%,19.63%,1
臺南市,安平區,0996,329,630,959,39,998,1843,54.15%,17.85%,1
臺南市,安平區,0997,315,542,857,31,888,1565,56.74%,20.13%,1
臺南市,安平區,0998,254,434,688,14,702,1288,54.5%,19.72%,1
臺南市,安平區,0999,328,468,796,14,810,1653,49%,19.84%,1
臺南市,安平區,1000,271,544,815,16,831,1697,48.97%,15.97%,1
臺南市,安平區,1001,355,629,984,33,1017,2154,47.21%,16.48%,1
臺南市,安平區,1002,342,660,1002,27,1029,2107,48.84%,16.23%,1
臺南市,安平區,1003,349,545,894,32,926,1675,55.28%,20.84%,1
臺南市,安平區,1004,399,588,987,38,1025,1979,51.79%,20.16%,1
臺南市,安平區,1005,298,484,782,17,799,1602,49.88%,18.6%,1
臺南市,安平區,1006,306,472,778,27,805,1586,50.76%,19.29%,1
臺南市,安平區,1007,62,130,192,5,197,438,44.98%,14.16%,1
臺南市,安平區,1008,334,520,854,48,902,1780,50.67%,18.76%,1
臺南市,安平區,1009,291,476,767,34,801,1623,49.35%,17.93%,1
臺南市,安平區,1010,334,664,998,71,1069,2157,49.56%,15.48%,1
臺南市,安平區,1011,213,415,628,35,663,1286,51.56%,16.56%,1
臺南市,安平區,1012,230,515,745,44,789,1492,52.88%,15.42%,1
臺南市,安平區,1013,171,431,602,23,625,1325,47.17%,12.91%,1
臺南市,安平區,1014,297,621,918,72,990,2001,49.48%,14.84%,1
臺南市,中西區,0931,285,410,695,45,740,1332,55.56%,21.4%,1
臺南市,中西區,0932,227,466,693,28,721,1246,57.87%,18.22%,1
臺南市,中西區,0933,196,446,642,36,678,1276,53.13%,15.36%,1
臺南市,中西區,0934,352,516,868,35,903,1583,57.04%,22.24%,1
臺南市,中西區,0935,326,487,813,25,838,1464,57.24%,22.27%,1
臺南市,中西區,0936,252,385,637,11,648,1234,52.51%,20.42%,1
臺南市,中西區,0937,278,478,756,32,788,1368,57.6%,20.32%,1
臺南市,中西區,0938,130,386,516,30,546,1322,41.3%,9.83%,1
臺南市,中西區,0939,231,375,606,37,643,1216,52.88%,19%,1
臺南市,中西區,0940,249,416,665,28,693,1289,53.76%,19.32%,1
臺南市,中西區,0941,216,458,674,31,705,1237,56.99%,17.46%,1
臺南市,中西區,0942,202,341,543,27,570,1189,47.94%,16.99%,1
臺南市,中西區,0943,221,410,631,53,684,1201,56.95%,18.4%,1
臺南市,中西區,0944,220,376,596,40,636,1065,59.72%,20.66%,1
臺南市,中西區,0945,189,374,563,52,615,1055,58.29%,17.91%,1
臺南市,中西區,0946,280,406,686,28,714,1170,61.03%,23.93%,1
臺南市,中西區,0947,252,513,765,27,792,1280,61.88%,19.69%,1
臺南市,中西區,0948,249,422,671,24,695,1223,56.83%,20.36%,1
臺南市,中西區,0949,237,473,710,44,754,1292,58.36%,18.34%,1
臺南市,中西區,0950,213,361,574,15,589,993,59.32%,21.45%,1
臺南市,中西區,0951,321,487,808,38,846,1541,54.9%,20.83%,1
臺南市,中西區,0952,371,581,952,35,987,1652,59.75%,22.46%,1
臺南市,中西區,0953,253,418,671,17,688,1212,56.77%,20.87%,1
臺南市,中西區,0954,321,555,876,70,946,1621,58.36%,19.8%,1
臺南市,中西區,0955,350,556,906,30,936,1660,56.39%,21.08%,1
臺南市,中西區,0956,268,559,827,39,866,1595,54.29%,16.8%,1
臺南市,中西區,0957,275,461,736,32,768,1436,53.48%,19.15%,1
臺南市,中西區,0958,235,454,689,37,726,1265,57.39%,18.58%,1
臺南市,中西區,0959,150,350,500,27,527,856,61.57%,17.52%,1
臺南市,中西區,0960,202,395,597,31,628,1168,53.77%,17.29%,1
臺南市,中西區,0961,251,380,631,37,668,1134,58.91%,22.13%,1
臺南市,中西區,0962,219,367,586,38,624,995,62.71%,22.01%,1
臺南市,中西區,0963,256,535,791,23,814,1313,62%,19.5%,1
臺南市,中西區,0964,274,456,730,30,760,1265,60.08%,21.66%,1
臺南市,中西區,0965,233,384,617,34,651,1215,53.58%,19.18%,1
臺南市,中西區,0966,231,417,648,43,691,1248,55.37%,18.51%,1
臺南市,中西區,0967,141,208,349,33,382,687,55.6%,20.52%,1
臺南市,中西區,0968,214,367,581,58,639,1139,56.1%,18.79%,1
臺南市,中西區,0969,186,345,531,36,567,971,58.39%,19.16%,1
臺南市,中西區,0970,177,331,508,42,550,1254,43.86%,14.11%,1
臺南市,中西區,0971,187,345,532,35,567,979,57.92%,19.1%,1
臺南市,中西區,0972,317,542,859,36,895,1745,51.29%,18.17%,1
臺南市,中西區,0973,192,358,550,36,586,1074,54.56%,17.88%,1
臺南市,中西區,0974,253,438,691,36,727,1436,50.63%,17.62%,1
臺南市,中西區,0975,190,284,474,30,504,865,58.27%,21.97%,1
臺南市,中西區,0976,233,373,606,33,639,1164,54.9%,20.02%,1
臺南市,中西區,0977,239,365,604,29,633,1285,49.26%,18.6%,1
臺南市,中西區,0978,186,375,561,33,594,1078,55.1%,17.25%,1
臺南市,中西區,0979,261,480,741,34,775,1704,45.48%,15.32%,1
臺南市,中西區,0980,235,466,701,55,756,1296,58.33%,18.13%,1
臺南市,中西區,0981,208,383,591,36,627,1128,55.59%,18.44%,1
臺南市,中西區,0982,242,423,665,22,687,1245,55.18%,19.44%,1
高雄市,鹽埕區,0845,283,487,770,48,818,1304,62.73%,21.7%,1
高雄市,鹽埕區,0846,77,119,196,25,221,357,61.9%,21.57%,1
高雄市,鹽埕區,0847,138,223,361,26,387,651,59.45%,21.2%,1
高雄市,鹽埕區,0848,219,423,642,28,670,1322,50.68%,16.57%,1
高雄市,鹽埕區,0849,439,174,613,23,636,1056,60.23%,41.57%,1
高雄市,鹽埕區,0850,220,333,553,11,564,904,62.39%,24.34%,1
高雄市,鹽埕區,0851,202,408,610,31,641,1130,56.73%,17.88%,1
高雄市,鹽埕區,0852,163,336,499,18,517,840,61.55%,19.4%,1
高雄市,鹽埕區,0853,166,246,412,27,439,616,71.27%,26.95%,1
高雄市,鹽埕區,0854,294,410,704,36,740,1397,52.97%,21.05%,1
高雄市,鹽埕區,0855,159,272,431,16,447,766,58.36%,20.76%,1
高雄市,鹽埕區,0856,198,282,480,35,515,839,61.38%,23.6%,1
高雄市,鹽埕區,0857,160,327,487,20,507,805,62.98%,19.88%,1
高雄市,鹽埕區,0858,144,253,397,15,412,750,54.93%,19.2%,1
高雄市,鹽埕區,0859,199,338,537,26,563,986,57.1%,20.18%,1
高雄市,鹽埕區,0860,192,367,559,9,568,1068,53.18%,17.98%,1
高雄市,鹽埕區,0861,225,368,593,43,636,1060,60%,21.23%,1
高雄市,鹽埕區,0862,148,287,435,25,460,805,57.14%,18.39%,1
高雄市,鹽埕區,0863,205,321,526,22,548,1073,51.07%,19.11%,1
高雄市,鹽埕區,0864,177,278,455,25,480,921,52.12%,19.22%,1
高雄市,鹽埕區,0865,238,389,627,18,645,1171,55.08%,20.32%,1
高雄市,鹽埕區,0866,134,215,349,11,360,594,60.61%,22.56%,1
高雄市,鹽埕區,0867,120,228,348,19,367,592,61.99%,20.27%,1
高雄市,鹽埕區,0868,113,193,306,18,324,610,53.11%,18.52%,1
高雄市,鼓山區,0768,154,332,486,27,513,959,53.49%,16.06%,1
高雄市,鼓山區,0769,232,394,626,42,668,1000,66.8%,23.2%,1
高雄市,鼓山區,0770,144,376,520,11,531,910,58.35%,15.82%,1
高雄市,鼓山區,0771,210,464,674,37,711,1085,65.53%,19.35%,1
高雄市,鼓山區,0772,236,458,694,47,741,1484,49.93%,15.9%,1
高雄市,鼓山區,0773,246,572,818,22,840,1393,60.3%,17.66%,1
高雄市,鼓山區,0774,238,561,799,50,849,1270,66.85%,18.74%,1
高雄市,鼓山區,0775,205,384,589,29,618,1055,58.58%,19.43%,1
高雄市,鼓山區,0776,220,440,660,29,689,1172,58.79%,18.77%,1
高雄市,鼓山區,0777,220,487,707,46,753,1175,64.09%,18.72%,1
高雄市,鼓山區,0778,256,468,724,36,760,1274,59.65%,20.09%,1
高雄市,鼓山區,0779,191,350,541,37,578,1085,53.27%,17.6%,1
高雄市,鼓山區,0780,276,526,802,48,850,1470,57.82%,18.78%,1
高雄市,鼓山區,0781,204,401,605,41,646,974,66.32%,20.94%,1
高雄市,鼓山區,0782,256,475,731,66,797,1275,62.51%,20.08%,1
高雄市,鼓山區,0783,206,455,661,52,713,1206,59.12%,17.08%,1
高雄市,鼓山區,0784,237,483,720,27,747,1238,60.34%,19.14%,1
高雄市,鼓山區,0785,91,392,483,15,498,721,69.07%,12.62%,1
高雄市,鼓山區,0786,223,434,657,27,684,1220,56.07%,18.28%,1
高雄市,鼓山區,0787,323,618,941,41,982,1966,49.95%,16.43%,1
高雄市,鼓山區,0788,286,591,877,79,956,1722,55.52%,16.61%,1
高雄市,鼓山區,0789,313,590,903,27,930,1720,54.07%,18.2%,1
高雄市,鼓山區,0790,259,493,752,73,825,1287,64.1%,20.12%,1
高雄市,鼓山區,0791,128,478,606,29,635,1369,46.38%,9.35%,1
高雄市,鼓山區,0792,231,554,785,22,807,1222,66.04%,18.9%,1
高雄市,鼓山區,0793,323,630,953,42,995,1770,56.21%,18.25%,1
高雄市,鼓山區,0794,371,675,1046,30,1076,1860,57.85%,19.95%,1
高雄市,鼓山區,0795,376,654,1030,44,1074,1857,57.84%,20.25%,1
高雄市,鼓山區,0796,378,704,1082,29,1111,1841,60.35%,20.53%,1
高雄市,鼓山區,0797,384,701,1085,42,1127,1830,61.58%,20.98%,1
高雄市,鼓山區,0798,366,666,1032,51,1083,1809,59.87%,20.23%,1
高雄市,鼓山區,0799,413,713,1126,39,1165,1894,61.51%,21.81%,1
高雄市,鼓山區,0800,385,758,1143,18,1161,1882,61.69%,20.46%,1
高雄市,鼓山區,0801,418,763,1181,34,1215,1894,64.15%,22.07%,1
高雄市,鼓山區,0802,302,670,972,38,1010,1745,57.88%,17.31%,1
高雄市,鼓山區,0803,395,649,1044,18,1062,1887,56.28%,20.93%,1
高雄市,鼓山區,0804,442,751,1193,35,1228,1891,64.94%,23.37%,1
高雄市,鼓山區,0805,398,738,1136,35,1171,1903,61.53%,20.91%,1
高雄市,鼓山區,0806,451,738,1189,30,1219,1998,61.01%,22.57%,1
高雄市,鼓山區,0807,401,692,1093,35,1128,1912,59%,20.97%,1
高雄市,鼓山區,0808,406,751,1157,50,1207,1923,62.77%,21.11%,1
高雄市,鼓山區,0809,451,684,1135,26,1161,1888,61.49%,23.89%,1
高雄市,鼓山區,0810,403,747,1150,24,1174,1873,62.68%,21.52%,1
高雄市,鼓山區,0811,549,777,1326,23,1349,1959,68.86%,28.02%,1
高雄市,鼓山區,0812,396,801,1197,42,1239,1897,65.31%,20.88%,1
高雄市,鼓山區,0813,497,907,1404,35,1439,2362,60.92%,21.04%,1
高雄市,鼓山區,0814,381,741,1122,26,1148,1850,62.05%,20.59%,1
高雄市,鼓山區,0815,418,743,1161,30,1191,1928,61.77%,21.68%,1
高雄市,鼓山區,0816,365,727,1092,29,1121,1937,57.87%,18.84%,1
高雄市,鼓山區,0817,443,754,1197,50,1247,2123,58.74%,20.87%,1
高雄市,鼓山區,0818,356,785,1141,19,1160,1861,62.33%,19.13%,1
高雄市,鼓山區,0819,373,723,1096,25,1121,1892,59.25%,19.71%,1
高雄市,鼓山區,0820,481,780,1261,37,1298,2147,60.46%,22.4%,1
高雄市,鼓山區,0821,382,755,1137,32,1169,1897,61.62%,20.14%,1
高雄市,鼓山區,0822,405,767,1172,41,1213,2041,59.43%,19.84%,1
高雄市,鼓山區,0823,229,504,733,55,788,1309,60.2%,17.49%,1
高雄市,鼓山區,0824,350,732,1082,44,1126,1867,60.31%,18.75%,1
高雄市,鼓山區,0825,236,524,760,23,783,1152,67.97%,20.49%,1
高雄市,鼓山區,0826,260,605,865,46,911,1404,64.89%,18.52%,1
高雄市,鼓山區,0827,167,332,499,19,518,1210,42.81%,13.8%,1
高雄市,鼓山區,0828,223,400,623,41,664,1135,58.5%,19.65%,1
高雄市,鼓山區,0829,212,388,600,72,672,1831,36.7%,11.58%,1
高雄市,鼓山區,0830,231,476,707,59,766,1288,59.47%,17.93%,1
高雄市,鼓山區,0831,202,458,660,36,696,1241,56.08%,16.28%,1
高雄市,鼓山區,0832,273,493,766,55,821,1342,61.18%,20.34%,1
高雄市,鼓山區,0833,258,519,777,104,881,1422,61.95%,18.14%,1
高雄市,鼓山區,0834,265,564,829,92,921,1453,63.39%,18.24%,1
高雄市,鼓山區,0835,117,248,365,40,405,616,65.75%,18.99%,1
高雄市,鼓山區,0836,150,292,442,60,502,834,60.19%,17.99%,1
高雄市,鼓山區,0837,171,347,518,59,577,969,59.55%,17.65%,1
高雄市,鼓山區,0838,187,324,511,74,585,978,59.82%,19.12%,1
高雄市,鼓山區,0839,166,284,450,52,502,760,66.05%,21.84%,1
高雄市,鼓山區,0840,243,434,677,67,744,1248,59.62%,19.47%,1
高雄市,鼓山區,0841,199,388,587,25,612,1143,53.54%,17.41%,1
高雄市,鼓山區,0842,231,391,622,75,697,1358,51.33%,17.01%,1
高雄市,鼓山區,0843,162,361,523,20,543,1036,52.41%,15.64%,1
高雄市,鼓山區,0844,95,215,310,10,320,580,55.17%,16.38%,1
高雄市,左營區,0534,260,577,837,58,895,2604,34.37%,9.98%,1
高雄市,左營區,0535,190,383,573,72,645,1037,62.2%,18.32%,1
高雄市,左營區,0536,119,196,315,42,357,542,65.87%,21.96%,1
高雄市,左營區,0537,108,232,340,51,391,635,61.57%,17.01%,1
高雄市,左營區,0538,95,158,253,11,264,518,50.97%,18.34%,1
高雄市,左營區,0539,152,257,409,51,460,813,56.58%,18.7%,1
高雄市,左營區,0540,154,314,468,69,537,889,60.4%,17.32%,1
高雄市,左營區,0541,147,258,405,66,471,731,64.43%,20.11%,1
高雄市,左營區,0542,267,508,775,43,818,1592,51.38%,16.77%,1
高雄市,左營區,0543,329,648,977,38,1015,1709,59.39%,19.25%,1
高雄市,左營區,0544,212,642,854,69,923,1588,58.12%,13.35%,1
高雄市,左營區,0545,48,144,192,10,202,358,56.42%,13.41%,1
高雄市,左營區,0546,77,365,442,15,457,666,68.62%,11.56%,1
高雄市,左營區,0547,283,666,949,61,1010,1748,57.78%,16.19%,1
高雄市,左營區,0548,184,528,712,55,767,1196,64.13%,15.38%,1
高雄市,左營區,0549,231,505,736,60,796,1240,64.19%,18.63%,1
高雄市,左營區,0550,175,670,845,34,879,1402,62.7%,12.48%,1
高雄市,左營區,0551,120,597,717,33,750,1173,63.94%,10.23%,1
高雄市,左營區,0552,115,334,449,13,462,641,72.07%,17.94%,1
高雄市,左營區,0553,191,317,508,40,548,951,57.62%,20.08%,1
高雄市,左營區,0554,146,253,399,32,431,732,58.88%,19.95%,1
高雄市,左營區,0555,56,118,174,12,186,339,54.87%,16.52%,1
高雄市,左營區,0556,89,205,294,12,306,519,58.96%,17.15%,1
高雄市,左營區,0557,114,180,294,48,342,514,66.54%,22.18%,1
高雄市,左營區,0558,117,298,415,50,465,720,64.58%,16.25%,1
高雄市,左營區,0559,80,151,231,38,269,411,65.45%,19.46%,1
高雄市,左營區,0560,139,222,361,42,403,603,66.83%,23.05%,1
高雄市,左營區,0561,188,316,504,64,568,904,62.83%,20.8%,1
高雄市,左營區,0562,161,502,663,39,702,1318,53.26%,12.22%,1
高雄市,左營區,0563,179,325,504,24,528,966,54.66%,18.53%,1
高雄市,左營區,0564,246,542,788,30,818,1440,56.81%,17.08%,1
高雄市,左營區,0565,250,834,1084,37,1121,1990,56.33%,12.56%,1
高雄市,左營區,0566,144,508,652,31,683,1090,62.66%,13.21%,1
高雄市,左營區,0567,163,580,743,57,800,1272,62.89%,12.81%,1
高雄市,左營區,0568,230,752,982,22,1004,1558,64.44%,14.76%,1
高雄市,左營區,0569,344,603,947,21,968,1501,64.49%,22.92%,1
高雄市,左營區,0570,79,163,242,7,249,360,69.17%,21.94%,1
高雄市,左營區,0571,145,616,761,25,786,1335,58.88%,10.86%,1
高雄市,左營區,0572,197,596,793,17,810,1359,59.6%,14.5%,1
高雄市,左營區,0573,243,651,894,41,935,1487,62.88%,16.34%,1
高雄市,左營區,0574,195,714,909,49,958,1637,58.52%,11.91%,1
高雄市,左營區,0575,327,614,941,39,980,1553,63.1%,21.06%,1
高雄市,左營區,0576,351,610,961,50,1011,1564,64.64%,22.44%,1
高雄市,左營區,0577,387,743,1130,42,1172,1788,65.55%,21.64%,1
高雄市,左營區,0578,409,761,1170,74,1244,2028,61.34%,20.17%,1
高雄市,左營區,0579,443,715,1158,15,1173,2037,57.58%,21.75%,1
高雄市,左營區,0580,421,844,1265,44,1309,2101,62.3%,20.04%,1
高雄市,左營區,0581,408,797,1205,51,1256,2018,62.24%,20.22%,1
高雄市,左營區,0582,448,774,1222,58,1280,1925,66.49%,23.27%,1
高雄市,左營區,0583,411,700,1111,38,1149,1989,57.77%,20.66%,1
高雄市,左營區,0584,331,617,948,20,968,1780,54.38%,18.6%,1
高雄市,左營區,0585,375,689,1064,27,1091,1778,61.36%,21.09%,1
高雄市,左營區,0586,309,585,894,23,917,1496,61.3%,20.66%,1
高雄市,左營區,0587,325,613,938,37,975,1538,63.39%,21.13%,1
高雄市,左營區,0588,434,785,1219,41,1260,2058,61.22%,21.09%,1
高雄市,左營區,0589,437,752,1189,32,1221,1992,61.3%,21.94%,1
高雄市,左營區,0590,465,763,1228,57,1285,2058,62.44%,22.59%,1
高雄市,左營區,0591,444,796,1240,39,1279,2090,61.2%,21.24%,1
高雄市,左營區,0592,456,805,1261,37,1298,2157,60.18%,21.14%,1
高雄市,左營區,0593,441,834,1275,41,1316,2096,62.79%,21.04%,1
高雄市,左營區,0594,477,809,1286,56,1342,2101,63.87%,22.7%,1
高雄市,左營區,0595,295,627,922,73,995,1649,60.34%,17.89%,1
高雄市,左營區,0596,277,553,830,71,901,1516,59.43%,18.27%,1
高雄市,左營區,0597,414,683,1097,52,1149,1678,68.47%,24.67%,1
高雄市,左營區,0598,356,719,1075,76,1151,1898,60.64%,18.76%,1
高雄市,左營區,0599,345,741,1086,41,1127,1837,61.35%,18.78%,1
高雄市,左營區,0600,342,718,1060,28,1088,1922,56.61%,17.79%,1
高雄市,左營區,0601,368,708,1076,52,1128,1785,63.19%,20.62%,1
高雄市,左營區,0602,363,743,1106,18,1124,1886,59.6%,19.25%,1
高雄市,左營區,0603,384,765,1149,35,1184,1895,62.48%,20.26%,1
高雄市,左營區,0604,383,737,1120,28,1148,1831,62.7%,20.92%,1
高雄市,左營區,0605,318,848,1166,37,1203,2050,58.68%,15.51%,1
高雄市,左營區,0606,488,957,1445,36,1481,2251,65.79%,21.68%,1
高雄市,左營區,0607,455,888,1343,30,1373,2126,64.58%,21.4%,1
高雄市,左營區,0608,342,724,1066,27,1093,1928,56.69%,17.74%,1
高雄市,左營區,0609,417,827,1244,32,1276,2166,58.91%,19.25%,1
高雄市,左營區,0610,373,873,1246,42,1288,2031,63.42%,18.37%,1
高雄市,左營區,0611,397,801,1198,37,1235,1987,62.15%,19.98%,1
高雄市,左營區,0612,445,876,1321,32,1353,2166,62.47%,20.54%,1
高雄市,左營區,0613,396,693,1089,58,1147,1856,61.8%,21.34%,1
高雄市,左營區,0614,493,901,1394,29,1423,2289,62.17%,21.54%,1
高雄市,左營區,0615,364,792,1156,36,1192,1973,60.42%,18.45%,1
高雄市,左營區,0616,375,701,1076,52,1128,1818,62.05%,20.63%,1
高雄市,左營區,0617,312,590,902,20,922,1565,58.91%,19.94%,1
高雄市,左營區,0618,352,684,1036,24,1060,1608,65.92%,21.89%,1
高雄市,左營區,0619,405,737,1142,34,1176,1812,64.9%,22.35%,1
高雄市,左營區,0620,342,685,1027,20,1047,1821,57.5%,18.78%,1
高雄市,左營區,0621,413,769,1182,42,1224,1907,64.18%,21.66%,1
高雄市,左營區,0622,316,723,1039,34,1073,1812,59.22%,17.44%,1
高雄市,左營區,0623,371,761,1132,36,1168,1833,63.72%,20.24%,1
高雄市,左營區,0624,396,710,1106,40,1146,1850,61.95%,21.41%,1
高雄市,左營區,0625,319,671,990,50,1040,1738,59.84%,18.35%,1
高雄市,左營區,0626,382,805,1187,34,1221,1864,65.5%,20.49%,1
高雄市,左營區,0627,391,773,1164,33,1197,1887,63.43%,20.72%,1
高雄市,左營區,0628,328,706,1034,25,1059,1870,56.63%,17.54%,1
高雄市,左營區,0629,366,736,1102,21,1123,1866,60.18%,19.61%,1
高雄市,左營區,0630,366,719,1085,14,1099,1862,59.02%,19.66%,1
高雄市,左營區,0631,357,746,1103,21,1124,1816,61.89%,19.66%,1
高雄市,左營區,0632,337,771,1108,36,1144,1833,62.41%,18.39%,1
高雄市,左營區,0633,333,682,1015,44,1059,1676,63.19%,19.87%,1
高雄市,左營區,0634,327,777,1104,36,1140,1843,61.86%,17.74%,1
高雄市,左營區,0635,374,775,1149,27,1176,1872,62.82%,19.98%,1
高雄市,左營區,0636,367,937,1304,43,1347,2259,59.63%,16.25%,1
高雄市,楠梓區,0435,269,528,797,39,836,1309,63.87%,20.55%,1
高雄市,楠梓區,0436,285,549,834,28,862,1408,61.22%,20.24%,1
高雄市,楠梓區,0437,350,699,1049,50,1099,1851,59.37%,18.91%,1
高雄市,楠梓區,0438,308,624,932,51,983,1578,62.29%,19.52%,1
高雄市,楠梓區,0439,330,618,948,27,975,1715,56.85%,19.24%,1
高雄市,楠梓區,0440,286,598,884,19,903,1611,56.05%,17.75%,1
高雄市,楠梓區,0441,321,724,1045,63,1108,2024,54.74%,15.86%,1
高雄市,楠梓區,0442,341,631,972,34,1006,1890,53.23%,18.04%,1
高雄市,楠梓區,0443,312,608,920,23,943,1762,53.52%,17.71%,1
高雄市,楠梓區,0444,335,645,980,53,1033,1888,54.71%,17.74%,1
高雄市,楠梓區,0445,346,623,969,63,1032,1822,56.64%,18.99%,1
高雄市,楠梓區,0446,355,648,1003,43,1046,1846,56.66%,19.23%,1
高雄市,楠梓區,0447,243,492,735,61,796,1268,62.78%,19.16%,1
高雄市,楠梓區,0448,257,496,753,41,794,1240,64.03%,20.73%,1
高雄市,楠梓區,0449,305,450,755,33,788,1432,55.03%,21.3%,1
高雄市,楠梓區,0450,314,535,849,44,893,1490,59.93%,21.07%,1
高雄市,楠梓區,0451,278,581,859,50,909,1464,62.09%,18.99%,1
高雄市,楠梓區,0452,255,500,755,65,820,1435,57.14%,17.77%,1
高雄市,楠梓區,0453,255,575,830,68,898,1602,56.05%,15.92%,1
高雄市,楠梓區,0454,278,528,806,50,856,1500,57.07%,18.53%,1
高雄市,楠梓區,0455,317,536,853,74,927,1591,58.27%,19.92%,1
高雄市,楠梓區,0456,227,391,618,44,662,1669,39.66%,13.6%,1
高雄市,楠梓區,0457,296,568,864,42,906,1469,61.67%,20.15%,1
高雄市,楠梓區,0458,314,514,828,71,899,1559,57.67%,20.14%,1
高雄市,楠梓區,0459,297,572,869,69,938,1638,57.26%,18.13%,1
高雄市,楠梓區,0460,354,721,1075,82,1157,1960,59.03%,18.06%,1
高雄市,楠梓區,0461,366,690,1056,95,1151,1912,60.2%,19.14%,1
高雄市,楠梓區,0462,264,585,849,52,901,1559,57.79%,16.93%,1
高雄市,楠梓區,0463,257,505,762,45,807,1423,56.71%,18.06%,1
高雄市,楠梓區,0464,305,660,965,30,995,1696,58.67%,17.98%,1
高雄市,楠梓區,0465,261,492,753,131,884,1493,59.21%,17.48%,1
高雄市,楠梓區,0466,280,546,826,97,923,1527,60.45%,18.34%,1
高雄市,楠梓區,0467,174,415,589,58,647,1020,63.43%,17.06%,1
高雄市,楠梓區,0468,237,411,648,71,719,1197,60.07%,19.8%,1
高雄市,楠梓區,0469,310,466,776,72,848,1528,55.5%,20.29%,1
高雄市,楠梓區,0470,319,603,922,75,997,1918,51.98%,16.63%,1
高雄市,楠梓區,0471,259,512,771,78,849,1458,58.23%,17.76%,1
高雄市,楠梓區,0472,335,689,1024,81,1105,1790,61.73%,18.72%,1
高雄市,楠梓區,0473,348,718,1066,82,1148,1845,62.22%,18.86%,1
高雄市,楠梓區,0474,402,787,1189,55,1244,2037,61.07%,19.73%,1
高雄市,楠梓區,0475,351,706,1057,56,1113,1964,56.67%,17.87%,1
高雄市,楠梓區,0476,382,756,1138,28,1166,2006,58.13%,19.04%,1
高雄市,楠梓區,0477,367,698,1065,41,1106,1951,56.69%,18.81%,1
高雄市,楠梓區,0478,347,703,1050,60,1110,1951,56.89%,17.79%,1
高雄市,楠梓區,0479,352,790,1142,68,1210,2008,60.26%,17.53%,1
高雄市,楠梓區,0480,347,737,1084,81,1165,1923,60.58%,18.04%,1
高雄市,楠梓區,0481,366,732,1098,53,1151,1921,59.92%,19.05%,1
高雄市,楠梓區,0482,191,359,550,30,580,832,69.71%,22.96%,1
高雄市,楠梓區,0483,216,424,640,52,692,1156,59.86%,18.69%,1
高雄市,楠梓區,0484,232,420,652,60,712,1125,63.29%,20.62%,1
高雄市,楠梓區,0485,210,422,632,53,685,1060,64.62%,19.81%,1
高雄市,楠梓區,0486,275,608,883,43,926,1502,61.65%,18.31%,1
高雄市,楠梓區,0487,274,506,780,78,858,1404,61.11%,19.52%,1
高雄市,楠梓區,0488,251,520,771,57,828,1552,53.35%,16.17%,1
高雄市,楠梓區,0489,257,526,783,58,841,1460,57.6%,17.6%,1
高雄市,楠梓區,0490,179,493,672,52,724,1315,55.06%,13.61%,1
高雄市,楠梓區,0491,209,410,619,51,670,1062,63.09%,19.68%,1
高雄市,楠梓區,0492,194,414,608,50,658,1078,61.04%,18%,1
高雄市,楠梓區,0493,186,351,537,75,612,914,66.96%,20.35%,1
高雄市,楠梓區,0494,221,421,642,71,713,1064,67.01%,20.77%,1
高雄市,楠梓區,0495,320,664,984,62,1046,1705,61.35%,18.77%,1
高雄市,楠梓區,0496,286,701,987,58,1045,1728,60.47%,16.55%,1
高雄市,楠梓區,0497,369,741,1110,41,1151,1917,60.04%,19.25%,1
高雄市,楠梓區,0498,194,564,758,67,825,1439,57.33%,13.48%,1
高雄市,楠梓區,0499,231,528,759,63,822,1287,63.87%,17.95%,1
高雄市,楠梓區,0500,268,635,903,65,968,1504,64.36%,17.82%,1
高雄市,楠梓區,0501,256,614,870,53,923,1405,65.69%,18.22%,1
高雄市,楠梓區,0502,243,473,716,75,791,1287,61.46%,18.88%,1
高雄市,楠梓區,0503,275,530,805,42,847,1295,65.41%,21.24%,1
高雄市,楠梓區,0504,294,574,868,59,927,1483,62.51%,19.82%,1
高雄市,楠梓區,0505,338,729,1067,42,1109,1649,67.25%,20.5%,1
高雄市,楠梓區,0506,220,384,604,47,651,998,65.23%,22.04%,1
高雄市,楠梓區,0507,246,398,644,55,699,1025,68.2%,24%,1
高雄市,楠梓區,0508,330,740,1070,53,1123,1671,67.21%,19.75%,1
高雄市,楠梓區,0509,263,620,883,73,956,1453,65.79%,18.1%,1
高雄市,楠梓區,0510,302,629,931,72,1003,1673,59.95%,18.05%,1
高雄市,楠梓區,0511,272,648,920,50,970,1653,58.68%,16.45%,1
高雄市,楠梓區,0512,189,401,590,53,643,1034,62.19%,18.28%,1
高雄市,楠梓區,0513,259,469,728,49,777,1127,68.94%,22.98%,1
高雄市,楠梓區,0514,290,568,858,60,918,1575,58.29%,18.41%,1
高雄市,楠梓區,0515,276,626,902,47,949,1559,60.87%,17.7%,1
高雄市,楠梓區,0516,253,511,764,42,806,1378,58.49%,18.36%,1
高雄市,楠梓區,0517,298,704,1002,57,1059,1714,61.79%,17.39%,1
高雄市,楠梓區,0518,290,690,980,70,1050,1721,61.01%,16.85%,1
高雄市,楠梓區,0519,272,660,932,75,1007,1628,61.86%,16.71%,1
高雄市,楠梓區,0520,321,678,999,72,1071,1590,67.36%,20.19%,1
高雄市,楠梓區,0521,290,634,924,71,995,1628,61.12%,17.81%,1
高雄市,楠梓區,0522,361,754,1115,29,1144,1739,65.78%,20.76%,1
高雄市,楠梓區,0523,330,686,1016,44,1060,1642,64.56%,20.1%,1
高雄市,楠梓區,0524,317,603,920,49,969,1766,54.87%,17.95%,1
高雄市,楠梓區,0525,275,540,815,48,863,1482,58.23%,18.56%,1
高雄市,楠梓區,0526,279,616,895,27,922,1749,52.72%,15.95%,1
高雄市,楠梓區,0527,336,590,926,41,967,1591,60.78%,21.12%,1
高雄市,楠梓區,0528,327,643,970,26,996,1545,64.47%,21.17%,1
高雄市,楠梓區,0529,349,697,1046,31,1077,1651,65.23%,21.14%,1
高雄市,楠梓區,0530,338,653,991,47,1038,1646,63.06%,20.53%,1
高雄市,楠梓區,0531,310,590,900,63,963,1496,64.37%,20.72%,1
高雄市,楠梓區,0532,223,520,743,72,815,1403,58.09%,15.89%,1
高雄市,楠梓區,0533,343,548,891,36,927,1624,57.08%,21.12%,1
高雄市,三民區,0887,362,696,1058,77,1135,1893,59.96%,19.12%,1
高雄市,三民區,0888,299,682,981,94,1075,1982,54.24%,15.09%,1
高雄市,三民區,0889,285,612,897,77,974,1661,58.64%,17.16%,1
高雄市,三民區,0890,376,676,1052,21,1073,1894,56.65%,19.85%,1
高雄市,三民區,0891,327,684,1011,44,1055,1839,57.37%,17.78%,1
高雄市,三民區,0892,371,702,1073,71,1144,2014,56.8%,18.42%,1
高雄市,三民區,0893,322,696,1018,109,1127,1897,59.41%,16.97%,1
高雄市,三民區,0894,379,645,1024,46,1070,2016,53.08%,18.8%,1
高雄市,三民區,0895,280,688,968,57,1025,1924,53.27%,14.55%,1
高雄市,三民區,0896,313,667,980,50,1030,1749,58.89%,17.9%,1
高雄市,三民區,0897,381,724,1105,66,1171,1845,63.47%,20.65%,1
高雄市,三民區,0898,327,594,921,40,961,1724,55.74%,18.97%,1
高雄市,三民區,0899,352,697,1049,42,1091,1889,57.76%,18.63%,1
高雄市,三民區,0900,338,582,920,50,970,1622,59.8%,20.84%,1
高雄市,三民區,0901,375,713,1088,33,1121,1870,59.95%,20.05%,1
高雄市,三民區,0902,299,605,904,61,965,1523,63.36%,19.63%,1
高雄市,三民區,0903,323,687,1010,57,1067,2006,53.19%,16.1%,1
高雄市,三民區,0904,477,780,1257,58,1315,2076,63.34%,22.98%,1
高雄市,三民區,0905,452,716,1168,24,1192,2073,57.5%,21.8%,1
高雄市,三民區,0906,399,770,1169,41,1210,2045,59.17%,19.51%,1
高雄市,三民區,0907,360,640,1000,63,1063,2070,51.35%,17.39%,1
高雄市,三民區,0908,370,723,1093,52,1145,2035,56.27%,18.18%,1
高雄市,三民區,0909,488,756,1244,46,1290,2075,62.17%,23.52%,1
高雄市,三民區,0910,406,771,1177,42,1219,2053,59.38%,19.78%,1
高雄市,三民區,0911,465,803,1268,30,1298,2063,62.92%,22.54%,1
高雄市,三民區,0912,442,863,1305,31,1336,2143,62.34%,20.63%,1
高雄市,三民區,0913,333,609,942,65,1007,1746,57.67%,19.07%,1
高雄市,三民區,0914,303,582,885,25,910,1735,52.45%,17.46%,1
高雄市,三民區,0915,311,548,859,55,914,1655,55.23%,18.79%,1
高雄市,三民區,0916,336,562,898,50,948,1583,59.89%,21.23%,1
高雄市,三民區,0917,366,619,985,40,1025,1800,56.94%,20.33%,1
高雄市,三民區,0918,334,688,1022,24,1046,1730,60.46%,19.31%,1
高雄市,三民區,0919,134,846,980,26,1006,1715,58.66%,7.81%,1
高雄市,三民區,0920,337,642,979,40,1019,1691,60.26%,19.93%,1
高雄市,三民區,0921,389,685,1074,41,1115,1865,59.79%,20.86%,1
高雄市,三民區,0922,242,427,669,28,697,1073,64.96%,22.55%,1
高雄市,三民區,0923,186,392,578,63,641,917,69.9%,20.28%,1
高雄市,三民區,0924,310,623,933,48,981,1647,59.56%,18.82%,1
高雄市,三民區,0925,334,621,955,66,1021,1654,61.73%,20.19%,1
高雄市,三民區,0926,335,640,975,45,1020,1639,62.23%,20.44%,1
高雄市,三民區,0927,357,711,1068,43,1111,1833,60.61%,19.48%,1
高雄市,三民區,0928,327,527,854,38,892,1362,65.49%,24.01%,1
高雄市,三民區,0929,325,212,537,55,592,1557,38.02%,20.87%,1
高雄市,三民區,0930,298,599,897,24,921,1482,62.15%,20.11%,1
高雄市,三民區,0931,325,624,949,40,989,1563,63.28%,20.79%,1
高雄市,三民區,0932,338,572,910,28,938,1497,62.66%,22.58%,1
高雄市,三民區,0933,343,613,956,21,977,1523,64.15%,22.52%,1
高雄市,三民區,0934,281,551,832,40,872,1293,67.44%,21.73%,1
高雄市,三民區,0935,387,623,1010,46,1056,1662,63.54%,23.29%,1
高雄市,三民區,0936,274,552,826,44,870,1441,60.37%,19.01%,1
高雄市,三民區,0937,284,585,869,33,902,1326,68.02%,21.42%,1
高雄市,三民區,0938,320,624,944,27,971,1476,65.79%,21.68%,1
高雄市,三民區,0939,356,672,1028,34,1062,1968,53.96%,18.09%,1
高雄市,三民區,0940,290,548,838,26,864,1618,53.4%,17.92%,1
高雄市,三民區,0941,495,551,1046,39,1085,1873,57.93%,26.43%,1
高雄市,三民區,0942,295,548,843,56,899,1487,60.46%,19.84%,1
高雄市,三民區,0943,298,628,926,28,954,1640,58.17%,18.17%,1
高雄市,三民區,0944,350,706,1056,25,1081,1889,57.23%,18.53%,1
高雄市,三民區,0945,384,683,1067,37,1104,1969,56.07%,19.5%,1
高雄市,三民區,0946,279,523,802,92,894,1466,60.98%,19.03%,1
高雄市,三民區,0947,338,651,989,55,1044,1697,61.52%,19.92%,1
高雄市,三民區,0948,328,648,976,45,1021,1663,61.4%,19.72%,1
高雄市,三民區,0949,336,587,923,46,969,1649,58.76%,20.38%,1
高雄市,三民區,0950,274,565,839,32,871,1486,58.61%,18.44%,1
高雄市,三民區,0951,279,541,820,23,843,1495,56.39%,18.66%,1
高雄市,三民區,0952,360,604,964,28,992,1548,64.08%,23.26%,1
高雄市,三民區,0953,324,532,856,33,889,1493,59.54%,21.7%,1
高雄市,三民區,0954,293,593,886,25,911,1445,63.04%,20.28%,1
高雄市,三民區,0955,295,574,869,30,899,1529,58.8%,19.29%,1
高雄市,三民區,0956,282,573,855,31,886,1506,58.83%,18.73%,1
高雄市,三民區,0957,349,599,948,31,979,1549,63.2%,22.53%,1
高雄市,三民區,0958,389,589,978,54,1032,1620,63.7%,24.01%,1
高雄市,三民區,0959,322,606,928,63,991,1550,63.94%,20.77%,1
高雄市,三民區,0960,298,600,898,43,941,1488,63.24%,20.03%,1
高雄市,三民區,0961,280,515,795,44,839,1335,62.85%,20.97%,1
高雄市,三民區,0962,233,542,775,42,817,1332,61.34%,17.49%,1
高雄市,三民區,0963,385,634,1019,69,1088,1764,61.68%,21.83%,1
高雄市,三民區,0964,363,678,1041,35,1076,1811,59.41%,20.04%,1
高雄市,三民區,0965,373,659,1032,50,1082,1693,63.91%,22.03%,1
高雄市,三民區,0966,366,668,1034,68,1102,1684,65.44%,21.73%,1
高雄市,三民區,0967,303,508,811,51,862,1464,58.88%,20.7%,1
高雄市,三民區,0968,386,702,1088,33,1121,1719,65.21%,22.45%,1
高雄市,三民區,0969,362,639,1001,28,1029,1749,58.83%,20.7%,1
高雄市,三民區,0970,377,666,1043,41,1084,1908,56.81%,19.76%,1
高雄市,三民區,0971,308,602,910,62,972,1573,61.79%,19.58%,1
高雄市,三民區,0972,315,592,907,36,943,1628,57.92%,19.35%,1
高雄市,三民區,0973,240,451,691,57,748,1377,54.32%,17.43%,1
高雄市,三民區,0974,320,613,933,43,976,1530,63.79%,20.92%,1
高雄市,三民區,0975,202,454,656,51,707,1188,59.51%,17%,1
高雄市,三民區,0976,264,547,811,37,848,2791,30.38%,9.46%,1
高雄市,三民區,0977,357,689,1046,54,1100,1840,59.78%,19.4%,1
高雄市,三民區,0978,347,626,973,69,1042,1671,62.36%,20.77%,1
高雄市,三民區,0979,340,595,935,48,983,1624,60.53%,20.94%,1
高雄市,三民區,0980,382,637,1019,44,1063,1555,68.36%,24.57%,1
高雄市,三民區,0981,344,592,936,48,984,1489,66.08%,23.1%,1
高雄市,三民區,0982,347,646,993,46,1039,1662,62.52%,20.88%,1
高雄市,三民區,0983,310,606,916,26,942,1639,57.47%,18.91%,1
高雄市,三民區,0984,341,696,1037,63,1100,1872,58.76%,18.22%,1
高雄市,三民區,0985,356,740,1096,46,1142,1968,58.03%,18.09%,1
高雄市,三民區,0986,218,482,700,86,786,1471,53.43%,14.82%,1
高雄市,三民區,0987,281,544,825,62,887,1534,57.82%,18.32%,1
高雄市,三民區,0988,257,572,829,76,905,1659,54.55%,15.49%,1
高雄市,三民區,0989,290,615,905,32,937,1815,51.63%,15.98%,1
高雄市,三民區,0990,349,607,956,39,995,1808,55.03%,19.3%,1
高雄市,三民區,0991,203,427,630,39,669,1224,54.66%,16.58%,1
高雄市,三民區,0992,262,523,785,18,803,1406,57.11%,18.63%,1
高雄市,三民區,0993,177,321,498,36,534,945,56.51%,18.73%,1
高雄市,三民區,0994,181,395,576,34,610,944,64.62%,19.17%,1
高雄市,三民區,0995,327,602,929,81,1010,1669,60.52%,19.59%,1
高雄市,三民區,0996,270,593,863,64,927,1473,62.93%,18.33%,1
高雄市,三民區,0997,329,576,905,52,957,1876,51.01%,17.54%,1
高雄市,三民區,0998,214,410,624,46,670,1682,39.83%,12.72%,1
高雄市,三民區,0999,360,569,929,41,970,1791,54.16%,20.1%,1
高雄市,三民區,1000,370,680,1050,46,1096,1808,60.62%,20.46%,1
高雄市,三民區,1001,332,624,956,52,1008,1798,56.06%,18.46%,1
高雄市,三民區,1002,447,712,1159,42,1201,2030,59.16%,22.02%,1
高雄市,三民區,1003,407,771,1178,23,1201,2034,59.05%,20.01%,1
高雄市,三民區,1004,403,755,1158,16,1174,1998,58.76%,20.17%,1
高雄市,三民區,1005,360,659,1019,32,1051,1914,54.91%,18.81%,1
高雄市,三民區,1006,440,637,1077,38,1115,1965,56.74%,22.39%,1
高雄市,三民區,1007,406,636,1042,58,1100,1885,58.36%,21.54%,1
高雄市,三民區,1008,265,501,766,12,778,1220,63.77%,21.72%,1
高雄市,三民區,1009,187,390,577,64,641,1057,60.64%,17.69%,1
高雄市,三民區,1010,264,403,667,32,699,1434,48.74%,18.41%,1
高雄市,三民區,1011,315,342,657,34,691,1350,51.19%,23.33%,1
高雄市,三民區,1012,151,274,425,20,445,872,51.03%,17.32%,1
高雄市,三民區,1013,190,299,489,21,510,954,53.46%,19.92%,1
高雄市,三民區,1014,359,637,996,20,1016,1689,60.15%,21.26%,1
高雄市,三民區,1015,295,498,793,15,808,1390,58.13%,21.22%,1
高雄市,三民區,1016,279,502,781,57,838,1336,62.72%,20.88%,1
高雄市,三民區,1017,341,579,920,41,961,1437,66.88%,23.73%,1
高雄市,三民區,1018,304,545,849,29,878,1452,60.47%,20.94%,1
高雄市,三民區,1019,326,542,868,70,938,1513,62%,21.55%,1
高雄市,三民區,1020,335,547,882,81,963,1467,65.64%,22.84%,1
高雄市,三民區,1021,291,576,867,82,949,1381,68.72%,21.07%,1
高雄市,三民區,1022,229,395,624,47,671,1117,60.07%,20.5%,1
高雄市,三民區,1023,294,509,803,36,839,1327,63.23%,22.16%,1
高雄市,三民區,1024,256,528,784,33,817,1304,62.65%,19.63%,1
高雄市,三民區,1025,277,525,802,34,836,1483,56.37%,18.68%,1
高雄市,三民區,1026,307,584,891,34,925,1473,62.8%,20.84%,1
高雄市,三民區,1027,198,371,569,37,606,980,61.84%,20.2%,1
高雄市,三民區,1028,354,466,820,58,878,1409,62.31%,25.12%,1
高雄市,三民區,1029,260,461,721,39,760,1230,61.79%,21.14%,1
高雄市,三民區,1030,224,404,628,56,684,1024,66.8%,21.88%,1
高雄市,三民區,1031,231,436,667,47,714,1130,63.19%,20.44%,1
高雄市,三民區,1032,315,655,970,34,1004,1889,53.15%,16.68%,1
高雄市,三民區,1033,265,538,803,34,837,1427,58.65%,18.57%,1
高雄市,三民區,1034,122,352,474,25,499,791,63.08%,15.42%,1
高雄市,三民區,1035,219,477,696,72,768,1079,71.18%,20.3%,1
高雄市,三民區,1036,292,548,840,64,904,1492,60.59%,19.57%,1
高雄市,三民區,1037,208,401,609,54,663,1020,65%,20.39%,1
高雄市,三民區,1038,210,406,616,15,631,1001,63.04%,20.98%,1
高雄市,三民區,1039,302,609,911,42,953,1581,60.28%,19.1%,1
高雄市,三民區,1040,285,546,831,39,870,1471,59.14%,19.37%,1
高雄市,三民區,1041,243,465,708,17,725,1151,62.99%,21.11%,1
高雄市,三民區,1042,260,552,812,48,860,1334,64.47%,19.49%,1
高雄市,三民區,1043,225,501,726,47,773,1275,60.63%,17.65%,1
高雄市,三民區,1044,256,487,743,36,779,1688,46.15%,15.17%,1
高雄市,三民區,1045,250,449,699,37,736,1214,60.63%,20.59%,1
高雄市,三民區,1046,260,463,723,21,744,1149,64.75%,22.63%,1
高雄市,三民區,1047,311,631,942,79,1021,1667,61.25%,18.66%,1
高雄市,三民區,1048,360,575,935,31,966,1786,54.09%,20.16%,1
高雄市,三民區,1049,172,360,532,22,554,896,61.83%,19.2%,1
高雄市,三民區,1050,178,352,530,49,579,925,62.59%,19.24%,1
高雄市,三民區,1051,141,279,420,53,473,684,69.15%,20.61%,1
高雄市,三民區,1052,227,373,600,60,660,981,67.28%,23.14%,1
高雄市,三民區,1053,230,457,687,73,760,1383,54.95%,16.63%,1
高雄市,三民區,1054,266,532,798,39,837,1382,60.56%,19.25%,1
高雄市,三民區,1055,163,284,447,26,473,808,58.54%,20.17%,1
高雄市,三民區,1056,260,444,704,25,729,1197,60.9%,21.72%,1
高雄市,三民區,1057,220,525,745,43,788,1344,58.63%,16.37%,1
高雄市,三民區,1058,271,504,775,63,838,1344,62.35%,20.16%,1
高雄市,三民區,1059,270,533,803,23,826,1359,60.78%,19.87%,1
高雄市,三民區,1060,209,421,630,55,685,1073,63.84%,19.48%,1
高雄市,三民區,1061,214,423,637,43,680,1186,57.34%,18.04%,1
高雄市,三民區,1062,335,619,954,72,1026,1749,58.66%,19.15%,1
高雄市,三民區,1063,149,314,463,18,481,877,54.85%,16.99%,1
高雄市,三民區,1064,276,563,839,87,926,1402,66.05%,19.69%,1
高雄市,三民區,1065,151,328,479,23,502,769,65.28%,19.64%,1
高雄市,三民區,1066,229,491,720,46,766,1207,63.46%,18.97%,1
高雄市,三民區,1067,217,428,645,41,686,1270,54.02%,17.09%,1
高雄市,三民區,1068,266,434,700,46,746,1248,59.78%,21.31%,1
高雄市,三民區,1069,267,480,747,53,800,1263,63.34%,21.14%,1
高雄市,三民區,1070,197,444,641,33,674,1101,61.22%,17.89%,1
高雄市,三民區,1071,245,426,671,19,690,1116,61.83%,21.95%,1
高雄市,三民區,1072,221,446,667,41,708,1152,61.46%,19.18%,1
高雄市,三民區,1073,231,380,611,58,669,1057,63.29%,21.85%,1
高雄市,三民區,1074,164,351,515,42,557,971,57.36%,16.89%,1
高雄市,三民區,1075,197,400,597,21,618,1062,58.19%,18.55%,1
高雄市,新興區,1098,167,301,468,28,496,828,59.9%,20.17%,1
高雄市,新興區,1099,218,379,597,42,639,963,66.36%,22.64%,1
高雄市,新興區,1100,187,393,580,20,600,1075,55.81%,17.4%,1
高雄市,新興區,1101,327,537,864,23,887,1488,59.61%,21.98%,1
高雄市,新興區,1102,321,521,842,32,874,1438,60.78%,22.32%,1
高雄市,新興區,1103,235,380,615,29,644,1049,61.39%,22.4%,1
高雄市,新興區,1104,292,557,849,73,922,1378,66.91%,21.19%,1
高雄市,新興區,1105,125,290,415,27,442,666,66.37%,18.77%,1
高雄市,新興區,1106,218,365,583,16,599,981,61.06%,22.22%,1
高雄市,新興區,1107,197,391,588,29,617,933,66.13%,21.11%,1
高雄市,新興區,1108,175,387,562,22,584,987,59.17%,17.73%,1
高雄市,新興區,1109,206,390,596,30,626,988,63.36%,20.85%,1
高雄市,新興區,1110,166,294,460,34,494,735,67.21%,22.59%,1
高雄市,新興區,1111,289,472,761,32,793,1317,60.21%,21.94%,1
高雄市,新興區,1112,140,294,434,16,450,800,56.25%,17.5%,1
高雄市,新興區,1113,191,388,579,35,614,968,63.43%,19.73%,1
高雄市,新興區,1114,179,369,548,20,568,913,62.21%,19.61%,1
高雄市,新興區,1115,340,529,869,16,885,1389,63.71%,24.48%,1
高雄市,新興區,1116,493,298,791,41,832,1228,67.75%,40.15%,1
高雄市,新興區,1117,257,461,718,55,773,1211,63.83%,21.22%,1
高雄市,新興區,1118,220,443,663,25,688,1101,62.49%,19.98%,1
高雄市,新興區,1119,172,294,466,18,484,752,64.36%,22.87%,1
高雄市,新興區,1120,240,352,592,31,623,873,71.36%,27.49%,1
高雄市,新興區,1121,329,610,939,45,984,1609,61.16%,20.45%,1
高雄市,新興區,1122,391,671,1062,43,1105,1736,63.65%,22.52%,1
高雄市,新興區,1123,251,472,723,22,745,1258,59.22%,19.95%,1
高雄市,新興區,1124,248,409,657,38,695,1105,62.9%,22.44%,1
高雄市,新興區,1125,153,342,495,43,538,851,63.22%,17.98%,1
高雄市,新興區,1126,214,389,603,43,646,1011,63.9%,21.17%,1
高雄市,新興區,1127,201,365,566,55,621,888,69.93%,22.64%,1
高雄市,新興區,1128,213,369,582,35,617,1005,61.39%,21.19%,1
高雄市,新興區,1129,218,393,611,21,632,1375,45.96%,15.85%,1
高雄市,新興區,1130,326,499,825,37,862,1388,62.1%,23.49%,1
高雄市,新興區,1131,122,274,396,37,433,719,60.22%,16.97%,1
高雄市,新興區,1132,225,378,603,56,659,1077,61.19%,20.89%,1
高雄市,新興區,1133,166,274,440,16,456,875,52.11%,18.97%,1
高雄市,新興區,1134,187,328,515,18,533,936,56.94%,19.98%,1
高雄市,新興區,1135,186,314,500,64,564,944,59.75%,19.7%,1
高雄市,新興區,1136,160,277,437,24,461,833,55.34%,19.21%,1
高雄市,新興區,1137,138,280,418,9,427,708,60.31%,19.49%,1
高雄市,新興區,1138,146,276,422,14,436,741,58.84%,19.7%,1
高雄市,新興區,1139,216,423,639,22,661,1235,53.52%,17.49%,1
高雄市,前金區,1076,131,239,370,18,388,673,57.65%,19.47%,1
高雄市,前金區,1077,202,402,604,33,637,1022,62.33%,19.77%,1
高雄市,前金區,1078,242,489,731,30,761,1324,57.48%,18.28%,1
高雄市,前金區,1079,166,312,478,34,512,839,61.03%,19.79%,1
高雄市,前金區,1080,205,357,562,48,610,975,62.56%,21.03%,1
高雄市,前金區,1081,349,671,1020,52,1072,1806,59.36%,19.32%,1
高雄市,前金區,1082,343,682,1025,42,1067,1781,59.91%,19.26%,1
高雄市,前金區,1083,148,286,434,24,458,717,63.88%,20.64%,1
高雄市,前金區,1084,219,405,624,12,636,1097,57.98%,19.96%,1
高雄市,前金區,1085,341,591,932,25,957,1633,58.6%,20.88%,1
高雄市,前金區,1086,180,307,487,30,517,759,68.12%,23.72%,1
高雄市,前金區,1087,206,374,580,37,617,948,65.08%,21.73%,1
高雄市,前金區,1088,167,317,484,76,560,1009,55.5%,16.55%,1
高雄市,前金區,1089,204,359,563,24,587,945,62.12%,21.59%,1
高雄市,前金區,1090,167,288,455,14,469,772,60.75%,21.63%,1
高雄市,前金區,1091,165,293,458,32,490,757,64.73%,21.8%,1
高雄市,前金區,1092,222,419,641,28,669,1047,63.9%,21.2%,1
高雄市,前金區,1093,190,397,587,43,630,985,63.96%,19.29%,1
高雄市,前金區,1094,330,588,918,22,940,1674,56.15%,19.71%,1
高雄市,前金區,1095,186,413,599,43,642,1088,59.01%,17.1%,1
高雄市,前金區,1096,196,360,556,48,604,893,67.64%,21.95%,1
高雄市,前金區,1097,217,446,663,23,686,1184,57.94%,18.33%,1
高雄市,苓雅區,1140,170,261,431,20,451,718,62.81%,23.68%,1
高雄市,苓雅區,1141,263,562,825,40,865,1492,57.98%,17.63%,1
高雄市,苓雅區,1142,235,468,703,46,749,1210,61.9%,19.42%,1
高雄市,苓雅區,1143,283,553,836,28,864,1617,53.43%,17.5%,1
高雄市,苓雅區,1144,259,558,817,79,896,1428,62.75%,18.14%,1
高雄市,苓雅區,1145,265,480,745,35,780,1444,54.02%,18.35%,1
高雄市,苓雅區,1146,252,538,790,59,849,1452,58.47%,17.36%,1
高雄市,苓雅區,1147,98,227,325,29,354,554,63.9%,17.69%,1
高雄市,苓雅區,1148,184,354,538,15,553,950,58.21%,19.37%,1
高雄市,苓雅區,1149,178,350,528,13,541,978,55.32%,18.2%,1
高雄市,苓雅區,1150,283,576,859,41,900,1673,53.8%,16.92%,1
高雄市,苓雅區,1151,377,703,1080,40,1120,2045,54.77%,18.44%,1
高雄市,苓雅區,1152,177,369,546,52,598,939,63.68%,18.85%,1
高雄市,苓雅區,1153,263,408,671,38,709,1284,55.22%,20.48%,1
高雄市,苓雅區,1154,178,360,538,24,562,908,61.89%,19.6%,1
高雄市,苓雅區,1155,183,280,463,17,480,838,57.28%,21.84%,1
高雄市,苓雅區,1156,271,482,753,30,783,1267,61.8%,21.39%,1
高雄市,苓雅區,1157,204,395,599,53,652,994,65.59%,20.52%,1
高雄市,苓雅區,1158,122,291,413,20,433,774,55.94%,15.76%,1
高雄市,苓雅區,1159,237,421,658,19,677,1121,60.39%,21.14%,1
高雄市,苓雅區,1160,302,541,843,43,886,1474,60.11%,20.49%,1
高雄市,苓雅區,1161,307,569,876,68,944,1525,61.9%,20.13%,1
高雄市,苓雅區,1162,250,435,685,23,708,1147,61.73%,21.8%,1
高雄市,苓雅區,1163,237,387,624,35,659,1014,64.99%,23.37%,1
高雄市,苓雅區,1164,323,549,872,43,915,1496,61.16%,21.59%,1
高雄市,苓雅區,1165,307,596,903,52,955,1499,63.71%,20.48%,1
高雄市,苓雅區,1166,239,448,687,27,714,1138,62.74%,21%,1
高雄市,苓雅區,1167,181,367,548,34,582,839,69.37%,21.57%,1
高雄市,苓雅區,1168,252,459,711,31,742,2088,35.54%,12.07%,1
高雄市,苓雅區,1169,358,626,984,27,1011,1648,61.35%,21.72%,1
高雄市,苓雅區,1170,308,601,909,45,954,1623,58.78%,18.98%,1
高雄市,苓雅區,1171,430,788,1218,46,1264,1932,65.42%,22.26%,1
高雄市,苓雅區,1172,236,533,769,17,786,1127,69.74%,20.94%,1
高雄市,苓雅區,1173,273,517,790,19,809,1156,69.98%,23.62%,1
高雄市,苓雅區,1174,304,598,902,32,934,1465,63.75%,20.75%,1
高雄市,苓雅區,1175,119,236,355,22,377,690,54.64%,17.25%,1
高雄市,苓雅區,1176,122,571,693,77,770,1283,60.02%,9.51%,1
高雄市,苓雅區,1177,280,536,816,63,879,1432,61.38%,19.55%,1
高雄市,苓雅區,1178,250,530,780,32,812,1313,61.84%,19.04%,1
高雄市,苓雅區,1179,295,564,859,34,893,1579,56.55%,18.68%,1
高雄市,苓雅區,1180,291,513,804,60,864,1385,62.38%,21.01%,1
高雄市,苓雅區,1181,267,604,871,41,912,1449,62.94%,18.43%,1
高雄市,苓雅區,1182,398,721,1119,48,1167,1834,63.63%,21.7%,1
高雄市,苓雅區,1183,309,554,863,51,914,1436,63.65%,21.52%,1
高雄市,苓雅區,1184,303,597,900,27,927,1431,64.78%,21.17%,1
高雄市,苓雅區,1185,275,518,793,22,815,1248,65.3%,22.04%,1
高雄市,苓雅區,1186,340,572,912,32,944,1470,64.22%,23.13%,1
高雄市,苓雅區,1187,311,658,969,54,1023,1540,66.43%,20.19%,1
高雄市,苓雅區,1188,313,546,859,24,883,1374,64.26%,22.78%,1
高雄市,苓雅區,1189,193,359,552,9,561,839,66.87%,23%,1
高雄市,苓雅區,1190,249,427,676,20,696,1022,68.1%,24.36%,1
高雄市,苓雅區,1191,202,473,675,13,688,1062,64.78%,19.02%,1
高雄市,苓雅區,1192,244,427,671,13,684,1078,63.45%,22.63%,1
高雄市,苓雅區,1193,255,450,705,17,722,1117,64.64%,22.83%,1
高雄市,苓雅區,1194,278,624,902,48,950,1516,62.66%,18.34%,1
高雄市,苓雅區,1195,307,473,780,109,889,1440,61.74%,21.32%,1
高雄市,苓雅區,1196,183,300,483,34,517,839,61.62%,21.81%,1
高雄市,苓雅區,1197,163,336,499,20,519,888,58.45%,18.36%,1
高雄市,苓雅區,1198,266,427,693,28,721,1101,65.49%,24.16%,1
高雄市,苓雅區,1199,230,449,679,32,711,1004,70.82%,22.91%,1
高雄市,苓雅區,1200,270,567,837,48,885,1427,62.02%,18.92%,1
高雄市,苓雅區,1201,226,465,691,28,719,1168,61.56%,19.35%,1
高雄市,苓雅區,1202,277,480,757,43,800,1184,67.57%,23.4%,1
高雄市,苓雅區,1203,218,379,597,29,626,974,64.27%,22.38%,1
高雄市,苓雅區,1204,158,297,455,11,466,849,54.89%,18.61%,1
高雄市,苓雅區,1205,366,718,1084,35,1119,1821,61.45%,20.1%,1
高雄市,苓雅區,1206,263,524,787,44,831,1306,63.63%,20.14%,1
高雄市,苓雅區,1207,250,496,746,19,765,1185,64.56%,21.1%,1
高雄市,苓雅區,1208,296,533,829,27,856,1415,60.49%,20.92%,1
高雄市,苓雅區,1209,320,277,597,44,641,962,66.63%,33.26%,1
高雄市,苓雅區,1210,191,352,543,51,594,964,61.62%,19.81%,1
高雄市,苓雅區,1211,328,573,901,24,925,1524,60.7%,21.52%,1
高雄市,苓雅區,1212,318,559,877,23,900,1455,61.86%,21.86%,1
高雄市,苓雅區,1213,236,422,658,40,698,1272,54.87%,18.55%,1
高雄市,苓雅區,1214,261,446,707,15,722,1256,57.48%,20.78%,1
高雄市,苓雅區,1215,200,464,664,32,696,1203,57.86%,16.63%,1
高雄市,苓雅區,1216,194,450,644,29,673,1062,63.37%,18.27%,1
高雄市,苓雅區,1217,196,332,528,46,574,850,67.53%,23.06%,1
高雄市,苓雅區,1218,224,408,632,66,698,1010,69.11%,22.18%,1
高雄市,苓雅區,1219,109,471,580,27,607,1118,54.29%,9.75%,1
高雄市,苓雅區,1220,190,373,563,38,601,937,64.14%,20.28%,1
高雄市,苓雅區,1221,238,526,764,30,794,1493,53.18%,15.94%,1
高雄市,苓雅區,1222,268,453,721,25,746,1183,63.06%,22.65%,1
高雄市,苓雅區,1223,221,468,689,31,720,1318,54.63%,16.77%,1
高雄市,苓雅區,1224,262,515,777,42,819,1362,60.13%,19.24%,1
高雄市,苓雅區,1225,196,420,616,65,681,1102,61.8%,17.79%,1
高雄市,苓雅區,1226,283,556,839,45,884,1481,59.69%,19.11%,1
高雄市,苓雅區,1227,193,352,545,39,584,878,66.51%,21.98%,1
高雄市,苓雅區,1228,169,303,472,21,493,908,54.3%,18.61%,1
高雄市,苓雅區,1229,245,406,651,41,692,1056,65.53%,23.2%,1
高雄市,苓雅區,1230,186,407,593,31,624,1091,57.2%,17.05%,1
高雄市,苓雅區,1231,214,383,597,24,621,976,63.63%,21.93%,1
高雄市,苓雅區,1232,248,440,688,27,715,1063,67.26%,23.33%,1
高雄市,苓雅區,1233,300,577,877,51,928,1484,62.53%,20.22%,1
高雄市,苓雅區,1234,284,485,769,28,797,1290,61.78%,22.02%,1
高雄市,苓雅區,1235,355,659,1014,56,1070,1740,61.49%,20.4%,1
高雄市,苓雅區,1236,288,624,912,47,959,1594,60.16%,18.07%,1
高雄市,苓雅區,1237,342,609,951,20,971,1648,58.92%,20.75%,1
高雄市,苓雅區,1238,242,529,771,42,813,1236,65.78%,19.58%,1
高雄市,苓雅區,1239,240,475,715,35,750,1211,61.93%,19.82%,1
高雄市,苓雅區,1240,237,514,751,19,770,1283,60.02%,18.47%,1
高雄市,苓雅區,1241,362,625,987,59,1046,1804,57.98%,20.07%,1
高雄市,苓雅區,1242,330,699,1029,50,1079,1718,62.81%,19.21%,1
高雄市,苓雅區,1243,278,503,781,38,819,1297,63.15%,21.43%,1
高雄市,苓雅區,1244,294,550,844,58,902,1449,62.25%,20.29%,1
高雄市,苓雅區,1245,537,219,756,37,793,1307,60.67%,41.09%,1
高雄市,苓雅區,1246,244,467,711,40,751,1184,63.43%,20.61%,1
高雄市,苓雅區,1247,283,492,775,63,838,1250,67.04%,22.64%,1
高雄市,苓雅區,1248,253,456,709,26,735,1248,58.89%,20.27%,1
高雄市,苓雅區,1249,225,532,757,24,781,1283,60.87%,17.54%,1
高雄市,苓雅區,1250,200,481,681,30,711,1121,63.43%,17.84%,1
高雄市,苓雅區,1251,230,512,742,25,767,1258,60.97%,18.28%,1
高雄市,苓雅區,1252,370,413,783,26,809,1339,60.42%,27.63%,1
高雄市,苓雅區,1253,356,733,1089,57,1146,1986,57.7%,17.93%,1
高雄市,苓雅區,1254,190,379,569,27,596,1028,57.98%,18.48%,1
高雄市,苓雅區,1255,214,361,575,15,590,948,62.24%,22.57%,1
高雄市,前鎮區,1484,284,605,889,112,1001,1809,55.33%,15.7%,1
高雄市,前鎮區,1485,298,626,924,79,1003,1835,54.66%,16.24%,1
高雄市,前鎮區,1486,282,501,783,61,844,1890,44.66%,14.92%,1
高雄市,前鎮區,1487,338,623,961,51,1012,2013,50.27%,16.79%,1
高雄市,前鎮區,1488,600,299,899,54,953,1776,53.66%,33.78%,1
高雄市,前鎮區,1489,285,469,754,80,834,1705,48.91%,16.72%,1
高雄市,前鎮區,1490,132,216,348,73,421,672,62.65%,19.64%,1
高雄市,前鎮區,1491,264,502,766,88,854,1726,49.48%,15.3%,1
高雄市,前鎮區,1492,330,542,872,37,909,1597,56.92%,20.66%,1
高雄市,前鎮區,1493,332,585,917,88,1005,1690,59.47%,19.64%,1
高雄市,前鎮區,1494,192,435,627,64,691,1080,63.98%,17.78%,1
高雄市,前鎮區,1495,222,482,704,67,771,1159,66.52%,19.15%,1
高雄市,前鎮區,1496,226,446,672,68,740,1314,56.32%,17.2%,1
高雄市,前鎮區,1497,163,345,508,57,565,896,63.06%,18.19%,1
高雄市,前鎮區,1498,198,365,563,33,596,1002,59.48%,19.76%,1
高雄市,前鎮區,1499,341,645,986,91,1077,2765,38.95%,12.33%,1
高雄市,前鎮區,1500,104,222,326,57,383,600,63.83%,17.33%,1
高雄市,前鎮區,1501,172,348,520,34,554,1466,37.79%,11.73%,1
高雄市,前鎮區,1502,254,504,758,52,810,1449,55.9%,17.53%,1
高雄市,前鎮區,1503,141,365,506,51,557,991,56.21%,14.23%,1
高雄市,前鎮區,1504,215,473,688,78,766,1248,61.38%,17.23%,1
高雄市,前鎮區,1505,201,393,594,92,686,1066,64.35%,18.86%,1
高雄市,前鎮區,1506,133,229,362,31,393,706,55.67%,18.84%,1
高雄市,前鎮區,1507,103,248,351,37,388,713,54.42%,14.45%,1
高雄市,前鎮區,1508,240,444,684,46,730,1344,54.32%,17.86%,1
高雄市,前鎮區,1509,180,294,474,55,529,856,61.8%,21.03%,1
高雄市,前鎮區,1510,151,286,437,48,485,873,55.56%,17.3%,1
高雄市,前鎮區,1511,169,372,541,55,596,1114,53.5%,15.17%,1
高雄市,前鎮區,1512,204,353,557,16,573,1112,51.53%,18.35%,1
高雄市,前鎮區,1513,201,347,548,57,605,1044,57.95%,19.25%,1
高雄市,前鎮區,1514,163,322,485,34,519,940,55.21%,17.34%,1
高雄市,前鎮區,1515,198,442,640,72,712,1342,53.06%,14.75%,1
高雄市,前鎮區,1516,310,563,873,55,928,1402,66.19%,22.11%,1
高雄市,前鎮區,1517,279,489,768,43,811,1320,61.44%,21.14%,1
高雄市,前鎮區,1518,162,364,526,53,579,958,60.44%,16.91%,1
高雄市,前鎮區,1519,281,563,844,31,875,1276,68.57%,22.02%,1
高雄市,前鎮區,1520,295,554,849,69,918,1459,62.92%,20.22%,1
高雄市,前鎮區,1521,119,254,373,19,392,761,51.51%,15.64%,1
高雄市,前鎮區,1522,216,362,578,26,604,1093,55.26%,19.76%,1
高雄市,前鎮區,1523,234,703,937,39,976,1521,64.17%,15.38%,1
高雄市,前鎮區,1524,252,695,947,24,971,1557,62.36%,16.18%,1
高雄市,前鎮區,1525,287,667,954,30,984,1821,54.04%,15.76%,1
高雄市,前鎮區,1526,103,604,707,30,737,1066,69.14%,9.66%,1
高雄市,前鎮區,1527,169,499,668,13,681,1046,65.11%,16.16%,1
高雄市,前鎮區,1528,316,642,958,46,1004,1709,58.75%,18.49%,1
高雄市,前鎮區,1529,317,665,982,82,1064,1723,61.75%,18.4%,1
高雄市,前鎮區,1530,275,483,758,32,790,1202,65.72%,22.88%,1
高雄市,前鎮區,1531,296,531,827,39,866,1279,67.71%,23.14%,1
高雄市,前鎮區,1532,325,624,949,35,984,1513,65.04%,21.48%,1
高雄市,前鎮區,1533,238,502,740,21,761,1260,60.4%,18.89%,1
高雄市,前鎮區,1534,245,442,687,69,756,1139,66.37%,21.51%,1
高雄市,前鎮區,1535,259,469,728,38,766,1140,67.19%,22.72%,1
高雄市,前鎮區,1536,317,535,852,72,924,1462,63.2%,21.68%,1
高雄市,前鎮區,1537,276,536,812,36,848,1359,62.4%,20.31%,1
高雄市,前鎮區,1538,343,658,1001,72,1073,2037,52.68%,16.84%,1
高雄市,前鎮區,1539,271,522,793,12,805,1410,57.09%,19.22%,1
高雄市,前鎮區,1540,237,512,749,16,765,1307,58.53%,18.13%,1
高雄市,前鎮區,1541,282,541,823,72,895,1512,59.19%,18.65%,1
高雄市,前鎮區,1542,302,550,852,64,916,1491,61.44%,20.25%,1
高雄市,前鎮區,1543,286,608,894,62,956,1621,58.98%,17.64%,1
高雄市,前鎮區,1544,253,511,764,53,817,1522,53.68%,16.62%,1
高雄市,前鎮區,1545,318,590,908,54,962,1593,60.39%,19.96%,1
高雄市,前鎮區,1546,378,710,1088,71,1159,1885,61.49%,20.05%,1
高雄市,前鎮區,1547,387,705,1092,76,1168,1870,62.46%,20.7%,1
高雄市,前鎮區,1548,278,549,827,23,850,1388,61.24%,20.03%,1
高雄市,前鎮區,1549,240,545,785,46,831,1348,61.65%,17.8%,1
高雄市,前鎮區,1550,206,482,688,93,781,1341,58.24%,15.36%,1
高雄市,前鎮區,1551,286,558,844,41,885,1364,64.88%,20.97%,1
高雄市,前鎮區,1552,254,518,772,63,835,1367,61.08%,18.58%,1
高雄市,前鎮區,1553,236,477,713,72,785,1326,59.2%,17.8%,1
高雄市,前鎮區,1554,194,390,584,37,621,1059,58.64%,18.32%,1
高雄市,前鎮區,1555,234,450,684,16,700,1119,62.56%,20.91%,1
高雄市,前鎮區,1556,298,543,841,38,879,1565,56.17%,19.04%,1
高雄市,前鎮區,1557,284,558,842,68,910,1549,58.75%,18.33%,1
高雄市,前鎮區,1558,379,701,1080,17,1097,1691,64.87%,22.41%,1
高雄市,前鎮區,1559,376,698,1074,25,1099,1837,59.83%,20.47%,1
高雄市,前鎮區,1560,237,447,684,17,701,1092,64.19%,21.7%,1
高雄市,前鎮區,1561,221,437,658,53,711,1126,63.14%,19.63%,1
高雄市,前鎮區,1562,216,422,638,69,707,1215,58.19%,17.78%,1
高雄市,前鎮區,1563,314,530,844,32,876,1443,60.71%,21.76%,1
高雄市,前鎮區,1564,329,634,963,23,986,1448,68.09%,22.72%,1
高雄市,前鎮區,1565,329,614,943,71,1014,1648,61.53%,19.96%,1
高雄市,前鎮區,1566,284,553,837,67,904,1603,56.39%,17.72%,1
高雄市,前鎮區,1567,285,501,786,31,817,1596,51.19%,17.86%,1
高雄市,前鎮區,1568,219,526,745,27,772,1450,53.24%,15.1%,1
高雄市,前鎮區,1569,272,502,774,75,849,1510,56.23%,18.01%,1
高雄市,前鎮區,1570,328,642,970,73,1043,1647,63.33%,19.91%,1
高雄市,前鎮區,1571,242,484,726,55,781,1342,58.2%,18.03%,1
高雄市,前鎮區,1572,256,458,714,40,754,1384,54.48%,18.5%,1
高雄市,前鎮區,1573,260,530,790,57,847,1479,57.27%,17.58%,1
高雄市,前鎮區,1574,292,625,917,30,947,1546,61.25%,18.89%,1
高雄市,前鎮區,1575,362,566,928,45,973,1595,61%,22.7%,1
高雄市,前鎮區,1576,216,479,695,56,751,1201,62.53%,17.99%,1
高雄市,前鎮區,1577,183,389,572,26,598,1082,55.27%,16.91%,1
高雄市,前鎮區,1578,179,327,506,40,546,996,54.82%,17.97%,1
高雄市,前鎮區,1579,135,370,505,79,584,932,62.66%,14.48%,1
高雄市,前鎮區,1580,201,460,661,37,698,1146,60.91%,17.54%,1
高雄市,前鎮區,1581,230,408,638,29,667,1096,60.86%,20.99%,1
高雄市,前鎮區,1582,298,535,833,20,853,1332,64.04%,22.37%,1
高雄市,前鎮區,1583,234,429,663,37,700,1175,59.57%,19.91%,1
高雄市,前鎮區,1584,186,367,553,52,605,986,61.36%,18.86%,1
高雄市,前鎮區,1585,270,499,769,56,825,1316,62.69%,20.52%,1
高雄市,前鎮區,1586,285,480,765,62,827,1559,53.05%,18.28%,1
高雄市,前鎮區,1587,331,628,959,71,1030,1622,63.5%,20.41%,1
高雄市,前鎮區,1588,224,500,724,32,756,1310,57.71%,17.1%,1
高雄市,前鎮區,1589,264,483,747,68,815,1299,62.74%,20.32%,1
高雄市,前鎮區,1590,234,502,736,63,799,1191,67.09%,19.65%,1
高雄市,前鎮區,1591,238,500,738,32,770,1375,56%,17.31%,1
高雄市,前鎮區,1592,248,508,756,30,786,1338,58.74%,18.54%,1
高雄市,前鎮區,1593,215,427,642,29,671,1175,57.11%,18.3%,1
高雄市,前鎮區,1594,248,485,733,33,766,1357,56.45%,18.28%,1
高雄市,前鎮區,1595,240,464,704,54,758,1187,63.86%,20.22%,1
高雄市,前鎮區,1596,213,435,648,41,689,1164,59.19%,18.3%,1
高雄市,前鎮區,1597,269,455,724,54,778,1219,63.82%,22.07%,1
高雄市,前鎮區,1598,270,515,785,23,808,1428,56.58%,18.91%,1
高雄市,前鎮區,1599,279,525,804,82,886,1495,59.26%,18.66%,1
高雄市,前鎮區,1600,359,552,911,44,955,1531,62.38%,23.45%,1
高雄市,前鎮區,1601,302,544,846,57,903,1509,59.84%,20.01%,1
高雄市,前鎮區,1602,269,578,847,65,912,1591,57.32%,16.91%,1
高雄市,旗津區,0869,232,423,655,90,745,1177,63.3%,19.71%,1
高雄市,旗津區,0870,163,370,533,54,587,1109,52.93%,14.7%,1
高雄市,旗津區,0871,286,480,766,20,786,1642,47.87%,17.42%,1
高雄市,旗津區,0872,184,408,592,77,669,1209,55.33%,15.22%,1
高雄市,旗津區,0873,180,329,509,50,559,1112,50.27%,16.19%,1
高雄市,旗津區,0874,240,541,781,85,866,1483,58.4%,16.18%,1
高雄市,旗津區,0875,202,442,644,30,674,1460,46.16%,13.84%,1
高雄市,旗津區,0876,327,539,866,121,987,1572,62.79%,20.8%,1
高雄市,旗津區,0877,211,429,640,28,668,1384,48.27%,15.25%,1
高雄市,旗津區,0878,202,451,653,36,689,1390,49.57%,14.53%,1
高雄市,旗津區,0879,192,388,580,49,629,1239,50.77%,15.5%,1
高雄市,旗津區,0880,343,656,999,96,1095,2045,53.55%,16.77%,1
高雄市,旗津區,0881,116,311,427,23,450,893,50.39%,12.99%,1
高雄市,旗津區,0882,301,626,927,87,1014,1866,54.34%,16.13%,1
高雄市,旗津區,0883,258,477,735,43,778,1874,41.52%,13.77%,1
高雄市,旗津區,0884,129,269,398,63,461,893,51.62%,14.45%,1
高雄市,旗津區,0885,440,222,662,28,690,1215,56.79%,36.21%,1
高雄市,旗津區,0886,217,390,607,37,644,1297,49.65%,16.73%,1
高雄市,小港區,1603,237,450,687,27,714,1108,64.44%,21.39%,1
高雄市,小港區,1604,205,475,680,58,738,1171,63.02%,17.51%,1
高雄市,小港區,1605,364,606,970,15,985,1557,63.26%,23.38%,1
高雄市,小港區,1606,289,595,884,19,903,1668,54.14%,17.33%,1
高雄市,小港區,1607,233,515,748,19,767,1183,64.84%,19.7%,1
高雄市,小港區,1608,269,518,787,31,818,1372,59.62%,19.61%,1
高雄市,小港區,1609,340,678,1018,56,1074,1737,61.83%,19.57%,1
高雄市,小港區,1610,316,525,841,67,908,1586,57.25%,19.92%,1
高雄市,小港區,1611,234,561,795,43,838,1558,53.79%,15.02%,1
高雄市,小港區,1612,258,534,792,62,854,1284,66.51%,20.09%,1
高雄市,小港區,1613,233,503,736,45,781,1249,62.53%,18.65%,1
高雄市,小港區,1614,371,689,1060,86,1146,2400,47.75%,15.46%,1
高雄市,小港區,1615,243,459,702,31,733,1181,62.07%,20.58%,1
高雄市,小港區,1616,207,390,597,30,627,1079,58.11%,19.18%,1
高雄市,小港區,1617,276,471,747,42,789,1335,59.1%,20.67%,1
高雄市,小港區,1618,232,484,716,52,768,1241,61.89%,18.69%,1
高雄市,小港區,1619,160,651,811,43,854,1513,56.44%,10.58%,1
高雄市,小港區,1620,249,539,788,55,843,1349,62.49%,18.46%,1
高雄市,小港區,1621,253,552,805,46,851,1483,57.38%,17.06%,1
高雄市,小港區,1622,306,533,839,23,862,1451,59.41%,21.09%,1
高雄市,小港區,1623,212,443,655,26,681,1241,54.88%,17.08%,1
高雄市,小港區,1624,275,522,797,55,852,1262,67.51%,21.79%,1
高雄市,小港區,1625,316,674,990,84,1074,1813,59.24%,17.43%,1
高雄市,小港區,1626,300,622,922,37,959,1877,51.09%,15.98%,1
高雄市,小港區,1627,527,258,785,29,814,1391,58.52%,37.89%,1
高雄市,小港區,1628,281,590,871,28,899,1453,61.87%,19.34%,1
高雄市,小港區,1629,252,527,779,38,817,1374,59.46%,18.34%,1
高雄市,小港區,1630,232,526,758,39,797,1348,59.12%,17.21%,1
高雄市,小港區,1631,351,439,790,47,837,1334,62.74%,26.31%,1
高雄市,小港區,1632,292,521,813,25,838,1433,58.48%,20.38%,1
高雄市,小港區,1633,282,477,759,17,776,1448,53.59%,19.48%,1
高雄市,小港區,1634,320,578,898,63,961,1488,64.58%,21.51%,1
高雄市,小港區,1635,242,493,735,57,792,1278,61.97%,18.94%,1
高雄市,小港區,1636,300,558,858,42,900,1306,68.91%,22.97%,1
高雄市,小港區,1637,252,665,917,72,989,1625,60.86%,15.51%,1
高雄市,小港區,1638,359,631,990,60,1050,1640,64.02%,21.89%,1
高雄市,小港區,1639,256,588,844,42,886,1506,58.83%,17%,1
高雄市,小港區,1640,232,520,752,50,802,1438,55.77%,16.13%,1
高雄市,小港區,1641,215,506,721,32,753,1105,68.14%,19.46%,1
高雄市,小港區,1642,189,448,637,22,659,1167,56.47%,16.2%,1
高雄市,小港區,1643,274,594,868,27,895,1420,63.03%,19.3%,1
高雄市,小港區,1644,303,559,862,40,902,1380,65.36%,21.96%,1
高雄市,小港區,1645,222,478,700,28,728,1239,58.76%,17.92%,1
高雄市,小港區,1646,627,300,927,37,964,1563,61.68%,40.12%,1
高雄市,小港區,1647,319,619,938,53,991,1644,60.28%,19.4%,1
高雄市,小港區,1648,643,395,1038,62,1100,1895,58.05%,33.93%,1
高雄市,小港區,1649,287,630,917,89,1006,1748,57.55%,16.42%,1
高雄市,小港區,1650,309,613,922,54,976,1579,61.81%,19.57%,1
高雄市,小港區,1651,408,734,1142,43,1185,2135,55.5%,19.11%,1
高雄市,小港區,1652,221,740,961,56,1017,1728,58.85%,12.79%,1
高雄市,小港區,1653,366,682,1048,39,1087,2022,53.76%,18.1%,1
高雄市,小港區,1654,187,453,640,24,664,1329,49.96%,14.07%,1
高雄市,小港區,1655,213,500,713,44,757,1320,57.35%,16.14%,1
高雄市,小港區,1656,224,487,711,70,781,1267,61.64%,17.68%,1
高雄市,小港區,1657,254,501,755,76,831,1298,64.02%,19.57%,1
高雄市,小港區,1658,270,510,780,36,816,1289,63.3%,20.95%,1
高雄市,小港區,1659,270,624,894,45,939,1534,61.21%,17.6%,1
高雄市,小港區,1660,259,605,864,41,905,1494,60.58%,17.34%,1
高雄市,小港區,1661,213,546,759,77,836,1377,60.71%,15.47%,1
高雄市,小港區,1662,261,548,809,54,863,1344,64.21%,19.42%,1
高雄市,小港區,1663,287,546,833,49,882,1508,58.49%,19.03%,1
高雄市,小港區,1664,253,490,743,28,771,1400,55.07%,18.07%,1
高雄市,小港區,1665,273,592,865,48,913,1457,62.66%,18.74%,1
高雄市,小港區,1666,218,546,764,23,787,1392,56.54%,15.66%,1
高雄市,小港區,1667,374,659,1033,61,1094,1983,55.17%,18.86%,1
高雄市,小港區,1668,229,438,667,26,693,1204,57.56%,19.02%,1
高雄市,小港區,1669,174,444,618,39,657,1300,50.54%,13.38%,1
高雄市,小港區,1670,317,744,1061,96,1157,1857,62.3%,17.07%,1
高雄市,小港區,1671,297,593,890,22,912,1566,58.24%,18.97%,1
高雄市,小港區,1672,280,561,841,47,888,1343,66.12%,20.85%,1
高雄市,小港區,1673,259,486,745,68,813,1236,65.78%,20.95%,1
高雄市,小港區,1674,311,608,919,81,1000,1564,63.94%,19.88%,1
高雄市,小港區,1675,289,553,842,33,875,1484,58.96%,19.47%,1
高雄市,小港區,1676,275,555,830,28,858,1477,58.09%,18.62%,1
高雄市,小港區,1677,367,541,908,28,936,1482,63.16%,24.76%,1
高雄市,小港區,1678,306,601,907,37,944,1708,55.27%,17.92%,1
高雄市,小港區,1679,318,681,999,69,1068,1867,57.2%,17.03%,1
高雄市,小港區,1680,348,578,926,22,948,1709,55.47%,20.36%,1
高雄市,小港區,1681,239,486,725,60,785,1425,55.09%,16.77%,1
高雄市,小港區,1682,229,553,782,45,827,1696,48.76%,13.5%,1
高雄市,小港區,1683,268,472,740,35,775,1522,50.92%,17.61%,1
高雄市,小港區,1684,273,558,831,73,904,1531,59.05%,17.83%,1
高雄市,小港區,1685,357,732,1089,132,1221,2215,55.12%,16.12%,1
高雄市,小港區,1686,272,526,798,45,843,1515,55.64%,17.95%,1
高雄市,小港區,1687,287,493,780,39,819,1535,53.36%,18.7%,1
高雄市,小港區,1688,224,463,687,26,713,1276,55.88%,17.55%,1
高雄市,小港區,1689,217,391,608,33,641,1217,52.67%,17.83%,1
高雄市,小港區,1690,250,544,794,61,855,1707,50.09%,14.65%,1
高雄市,小港區,1691,300,638,938,90,1028,1920,53.54%,15.63%,1
高雄市,鳳山區,1256,241,430,671,47,718,1080,66.48%,22.31%,1
高雄市,鳳山區,1257,162,318,480,33,513,819,62.64%,19.78%,1
高雄市,鳳山區,1258,158,328,486,51,537,851,63.1%,18.57%,1
高雄市,鳳山區,1259,244,397,641,39,680,1075,63.26%,22.7%,1
高雄市,鳳山區,1260,228,509,737,35,772,1223,63.12%,18.64%,1
高雄市,鳳山區,1261,324,388,712,38,750,1207,62.14%,26.84%,1
高雄市,鳳山區,1262,231,477,708,32,740,1339,55.27%,17.25%,1
高雄市,鳳山區,1263,221,386,607,30,637,1188,53.62%,18.6%,1
高雄市,鳳山區,1264,176,419,595,49,644,1055,61.04%,16.68%,1
高雄市,鳳山區,1265,191,396,587,56,643,1109,57.98%,17.22%,1
高雄市,鳳山區,1266,151,336,487,33,520,756,68.78%,19.97%,1
高雄市,鳳山區,1267,202,441,643,34,677,1182,57.28%,17.09%,1
高雄市,鳳山區,1268,260,562,822,77,899,1496,60.09%,17.38%,1
高雄市,鳳山區,1269,360,634,994,54,1048,2094,50.05%,17.19%,1
高雄市,鳳山區,1270,300,620,920,20,940,1672,56.22%,17.94%,1
高雄市,鳳山區,1271,331,618,949,19,968,1761,54.97%,18.8%,1
高雄市,鳳山區,1272,252,550,802,63,865,1450,59.66%,17.38%,1
高雄市,鳳山區,1273,263,467,730,32,762,1455,52.37%,18.08%,1
高雄市,鳳山區,1274,209,468,677,59,736,1234,59.64%,16.94%,1
高雄市,鳳山區,1275,365,648,1013,57,1070,1713,62.46%,21.31%,1
高雄市,鳳山區,1276,254,623,877,31,908,1698,53.47%,14.96%,1
高雄市,鳳山區,1277,275,449,724,50,774,1247,62.07%,22.05%,1
高雄市,鳳山區,1278,234,397,631,37,668,1087,61.45%,21.53%,1
高雄市,鳳山區,1279,238,471,709,26,735,1199,61.3%,19.85%,1
高雄市,鳳山區,1280,227,625,852,47,899,1559,57.67%,14.56%,1
高雄市,鳳山區,1281,247,486,733,33,766,1233,62.12%,20.03%,1
高雄市,鳳山區,1282,266,469,735,49,784,1277,61.39%,20.83%,1
高雄市,鳳山區,1283,261,586,847,20,867,1481,58.54%,17.62%,1
高雄市,鳳山區,1284,253,479,732,23,755,1154,65.42%,21.92%,1
高雄市,鳳山區,1285,318,581,899,23,922,1475,62.51%,21.56%,1
高雄市,鳳山區,1286,205,438,643,33,676,1247,54.21%,16.44%,1
高雄市,鳳山區,1287,271,539,810,49,859,1538,55.85%,17.62%,1
高雄市,鳳山區,1288,199,415,614,35,649,1097,59.16%,18.14%,1
高雄市,鳳山區,1289,244,394,638,22,660,1221,54.05%,19.98%,1
高雄市,鳳山區,1290,268,423,691,41,732,1075,68.09%,24.93%,1
高雄市,鳳山區,1291,366,664,1030,43,1073,1751,61.28%,20.9%,1
高雄市,鳳山區,1292,352,685,1037,38,1075,1758,61.15%,20.02%,1
高雄市,鳳山區,1293,303,663,966,70,1036,1749,59.23%,17.32%,1
高雄市,鳳山區,1294,309,646,955,23,978,1746,56.01%,17.7%,1
高雄市,鳳山區,1295,322,642,964,24,988,1712,57.71%,18.81%,1
高雄市,鳳山區,1296,237,494,731,22,753,1247,60.38%,19.01%,1
高雄市,鳳山區,1297,304,528,832,39,871,1409,61.82%,21.58%,1
高雄市,鳳山區,1298,280,490,770,46,816,1347,60.58%,20.79%,1
高雄市,鳳山區,1299,353,643,996,24,1020,1771,57.59%,19.93%,1
高雄市,鳳山區,1300,336,576,912,15,927,1537,60.31%,21.86%,1
高雄市,鳳山區,1301,312,646,958,21,979,1605,61%,19.44%,1
高雄市,鳳山區,1302,248,551,799,39,838,1375,60.95%,18.04%,1
高雄市,鳳山區,1303,273,567,840,41,881,1393,63.24%,19.6%,1
高雄市,鳳山區,1304,307,555,862,21,883,1584,55.74%,19.38%,1
高雄市,鳳山區,1305,121,231,352,18,370,618,59.87%,19.58%,1
高雄市,鳳山區,1306,91,172,263,6,269,423,63.59%,21.51%,1
高雄市,鳳山區,1307,221,511,732,48,780,1312,59.45%,16.84%,1
高雄市,鳳山區,1308,166,278,444,24,468,769,60.86%,21.59%,1
高雄市,鳳山區,1309,262,506,768,20,788,1213,64.96%,21.6%,1
高雄市,鳳山區,1310,204,494,698,38,736,1107,66.49%,18.43%,1
高雄市,鳳山區,1311,211,480,691,34,725,1188,61.03%,17.76%,1
高雄市,鳳山區,1312,279,446,725,22,747,1183,63.14%,23.58%,1
高雄市,鳳山區,1313,240,495,735,51,786,1264,62.18%,18.99%,1
高雄市,鳳山區,1314,161,340,501,30,531,882,60.2%,18.25%,1
高雄市,鳳山區,1315,221,446,667,40,707,1007,70.21%,21.95%,1
高雄市,鳳山區,1316,166,305,471,64,535,853,62.72%,19.46%,1
高雄市,鳳山區,1317,142,301,443,35,478,1660,28.8%,8.55%,1
高雄市,鳳山區,1318,224,432,656,34,690,1124,61.39%,19.93%,1
高雄市,鳳山區,1319,238,396,634,61,695,1112,62.5%,21.4%,1
高雄市,鳳山區,1320,190,455,645,32,677,1182,57.28%,16.07%,1
高雄市,鳳山區,1321,209,370,579,44,623,875,71.2%,23.89%,1
高雄市,鳳山區,1322,224,379,603,43,646,1040,62.12%,21.54%,1
高雄市,鳳山區,1323,250,434,684,20,704,1094,64.35%,22.85%,1
高雄市,鳳山區,1324,257,458,715,46,761,1217,62.53%,21.12%,1
高雄市,鳳山區,1325,216,419,635,30,665,974,68.28%,22.18%,1
高雄市,鳳山區,1326,191,383,574,30,604,987,61.2%,19.35%,1
高雄市,鳳山區,1327,244,526,770,20,790,1210,65.29%,20.17%,1
高雄市,鳳山區,1328,284,497,781,48,829,1391,59.6%,20.42%,1
高雄市,鳳山區,1329,218,406,624,19,643,1241,51.81%,17.57%,1
高雄市,鳳山區,1330,217,401,618,37,655,1000,65.5%,21.7%,1
高雄市,鳳山區,1331,213,440,653,30,683,1092,62.55%,19.51%,1
高雄市,鳳山區,1332,252,530,782,37,819,1308,62.61%,19.27%,1
高雄市,鳳山區,1333,191,403,594,53,647,1031,62.75%,18.53%,1
高雄市,鳳山區,1334,264,464,728,49,777,1159,67.04%,22.78%,1
高雄市,鳳山區,1335,180,450,630,43,673,1127,59.72%,15.97%,1
高雄市,鳳山區,1336,249,508,757,39,796,1109,71.78%,22.45%,1
高雄市,鳳山區,1337,351,803,1154,49,1203,1879,64.02%,18.68%,1
高雄市,鳳山區,1338,656,502,1158,37,1195,1803,66.28%,36.38%,1
高雄市,鳳山區,1339,309,744,1053,62,1115,2045,54.52%,15.11%,1
高雄市,鳳山區,1340,232,540,772,46,818,1432,57.12%,16.2%,1
高雄市,鳳山區,1341,162,401,563,14,577,1033,55.86%,15.68%,1
高雄市,鳳山區,1342,220,506,726,69,795,1253,63.45%,17.56%,1
高雄市,鳳山區,1343,235,470,705,23,728,1217,59.82%,19.31%,1
高雄市,鳳山區,1344,228,550,778,42,820,1267,64.72%,18%,1
高雄市,鳳山區,1345,231,451,682,41,723,1251,57.79%,18.47%,1
高雄市,鳳山區,1346,251,615,866,70,936,1563,59.88%,16.06%,1
高雄市,鳳山區,1347,400,779,1179,15,1194,1888,63.24%,21.19%,1
高雄市,鳳山區,1348,278,518,796,40,836,1368,61.11%,20.32%,1
高雄市,鳳山區,1349,283,559,842,22,864,1588,54.41%,17.82%,1
高雄市,鳳山區,1350,173,580,753,48,801,1255,63.82%,13.78%,1
高雄市,鳳山區,1351,243,456,699,63,762,1264,60.28%,19.22%,1
高雄市,鳳山區,1352,210,505,715,65,780,1291,60.42%,16.27%,1
高雄市,鳳山區,1353,205,499,704,33,737,1224,60.21%,16.75%,1
高雄市,鳳山區,1354,231,505,736,26,762,1296,58.8%,17.82%,1
高雄市,鳳山區,1355,175,348,523,35,558,826,67.55%,21.19%,1
高雄市,鳳山區,1356,197,527,724,26,750,1229,61.03%,16.03%,1
高雄市,鳳山區,1357,267,601,868,36,904,1467,61.62%,18.2%,1
高雄市,鳳山區,1358,208,492,700,45,745,1218,61.17%,17.08%,1
高雄市,鳳山區,1359,257,910,1167,62,1229,2173,56.56%,11.83%,1
高雄市,鳳山區,1360,378,893,1271,51,1322,2255,58.63%,16.76%,1
高雄市,鳳山區,1361,212,693,905,41,946,1556,60.8%,13.62%,1
高雄市,鳳山區,1362,282,531,813,42,855,1521,56.21%,18.54%,1
高雄市,鳳山區,1363,202,499,701,42,743,1407,52.81%,14.36%,1
高雄市,鳳山區,1364,296,590,886,52,938,1542,60.83%,19.2%,1
高雄市,鳳山區,1365,221,560,781,25,806,1502,53.66%,14.71%,1
高雄市,鳳山區,1366,235,545,780,42,822,1320,62.27%,17.8%,1
高雄市,鳳山區,1367,146,660,806,33,839,1507,55.67%,9.69%,1
高雄市,鳳山區,1368,103,692,795,39,834,1284,64.95%,8.02%,1
高雄市,鳳山區,1369,259,499,758,40,798,1441,55.38%,17.97%,1
高雄市,鳳山區,1370,246,612,858,68,926,1485,62.36%,16.57%,1
高雄市,鳳山區,1371,177,475,652,62,714,1205,59.25%,14.69%,1
高雄市,鳳山區,1372,205,453,658,29,687,1284,53.5%,15.97%,1
高雄市,鳳山區,1373,279,500,779,55,834,1326,62.9%,21.04%,1
高雄市,鳳山區,1374,222,403,625,31,656,1096,59.85%,20.26%,1
高雄市,鳳山區,1375,268,442,710,60,770,1182,65.14%,22.67%,1
高雄市,鳳山區,1376,204,439,643,52,695,1017,68.34%,20.06%,1
高雄市,鳳山區,1377,221,425,646,73,719,1198,60.02%,18.45%,1
高雄市,鳳山區,1378,219,457,676,26,702,1281,54.8%,17.1%,1
高雄市,鳳山區,1379,286,554,840,30,870,1358,64.06%,21.06%,1
高雄市,鳳山區,1380,272,505,777,41,818,1226,66.72%,22.19%,1
高雄市,鳳山區,1381,215,457,672,44,716,1098,65.21%,19.58%,1
高雄市,鳳山區,1382,242,466,708,31,739,1200,61.58%,20.17%,1
高雄市,鳳山區,1383,182,350,532,42,574,942,60.93%,19.32%,1
高雄市,鳳山區,1384,218,474,692,20,712,1206,59.04%,18.08%,1
高雄市,鳳山區,1385,258,467,725,26,751,1159,64.8%,22.26%,1
高雄市,鳳山區,1386,301,545,846,38,884,1401,63.1%,21.48%,1
高雄市,鳳山區,1387,301,535,836,20,856,1525,56.13%,19.74%,1
高雄市,鳳山區,1388,227,526,753,41,794,1345,59.03%,16.88%,1
高雄市,鳳山區,1389,215,510,725,28,753,1180,63.81%,18.22%,1
高雄市,鳳山區,1390,202,384,586,19,605,1106,54.7%,18.26%,1
高雄市,鳳山區,1391,304,560,864,57,921,1442,63.87%,21.08%,1
高雄市,鳳山區,1392,297,532,829,32,861,1376,62.57%,21.58%,1
高雄市,鳳山區,1393,259,471,730,27,757,1243,60.9%,20.84%,1
高雄市,鳳山區,1394,269,525,794,18,812,1361,59.66%,19.76%,1
高雄市,鳳山區,1395,299,541,840,49,889,1416,62.78%,21.12%,1
高雄市,鳳山區,1396,326,615,941,51,992,1536,64.58%,21.22%,1
高雄市,鳳山區,1397,250,509,759,26,785,1388,56.56%,18.01%,1
高雄市,鳳山區,1398,234,469,703,81,784,1241,63.17%,18.86%,1
高雄市,鳳山區,1399,290,540,830,52,882,1394,63.27%,20.8%,1
高雄市,鳳山區,1400,243,522,765,22,787,1188,66.25%,20.45%,1
高雄市,鳳山區,1401,213,452,665,33,698,1112,62.77%,19.15%,1
高雄市,鳳山區,1402,173,384,557,36,593,1198,49.5%,14.44%,1
高雄市,鳳山區,1403,302,526,828,29,857,1475,58.1%,20.47%,1
高雄市,鳳山區,1404,231,410,641,31,672,1216,55.26%,19%,1
高雄市,鳳山區,1405,253,431,684,36,720,1318,54.63%,19.2%,1
高雄市,鳳山區,1406,292,544,836,18,854,1465,58.29%,19.93%,1
高雄市,鳳山區,1407,214,475,689,35,724,1314,55.1%,16.29%,1
高雄市,鳳山區,1408,258,567,825,27,852,1649,51.67%,15.65%,1
高雄市,鳳山區,1409,263,555,818,99,917,1601,57.28%,16.43%,1
高雄市,鳳山區,1410,241,406,647,18,665,1155,57.58%,20.87%,1
高雄市,鳳山區,1411,191,413,604,42,646,1050,61.52%,18.19%,1
高雄市,鳳山區,1412,231,504,735,16,751,1417,53%,16.3%,1
高雄市,鳳山區,1413,274,559,833,56,889,1525,58.3%,17.97%,1
高雄市,鳳山區,1414,277,523,800,53,853,1514,56.34%,18.3%,1
高雄市,鳳山區,1415,242,426,668,37,705,1190,59.24%,20.34%,1
高雄市,鳳山區,1416,221,498,719,24,743,1325,56.08%,16.68%,1
高雄市,鳳山區,1417,180,433,613,48,661,1049,63.01%,17.16%,1
高雄市,鳳山區,1418,410,182,592,30,622,1026,60.62%,39.96%,1
高雄市,鳳山區,1419,219,455,674,50,724,1152,62.85%,19.01%,1
高雄市,鳳山區,1420,209,441,650,15,665,1254,53.03%,16.67%,1
高雄市,鳳山區,1421,249,635,884,30,914,1688,54.15%,14.75%,1
高雄市,鳳山區,1422,280,644,924,52,976,1657,58.9%,16.9%,1
高雄市,鳳山區,1423,277,597,874,46,920,1729,53.21%,16.02%,1
高雄市,鳳山區,1424,314,630,944,45,989,1628,60.75%,19.29%,1
高雄市,鳳山區,1425,302,639,941,17,958,1891,50.66%,15.97%,1
高雄市,鳳山區,1426,153,706,859,35,894,1594,56.09%,9.6%,1
高雄市,鳳山區,1427,245,603,848,18,866,1342,64.53%,18.26%,1
高雄市,鳳山區,1428,281,638,919,32,951,1448,65.68%,19.41%,1
高雄市,鳳山區,1429,284,532,816,62,878,1405,62.49%,20.21%,1
高雄市,鳳山區,1430,224,436,660,56,716,1097,65.27%,20.42%,1
高雄市,鳳山區,1431,240,503,743,74,817,1248,65.46%,19.23%,1
高雄市,鳳山區,1432,264,437,701,63,764,1225,62.37%,21.55%,1
高雄市,鳳山區,1433,236,474,710,21,731,1214,60.21%,19.44%,1
高雄市,鳳山區,1434,412,825,1237,22,1259,2032,61.96%,20.28%,1
高雄市,鳳山區,1435,317,786,1103,53,1156,1927,59.99%,16.45%,1
高雄市,鳳山區,1436,380,872,1252,50,1302,2097,62.09%,18.12%,1
高雄市,鳳山區,1437,153,366,519,47,566,968,58.47%,15.81%,1
高雄市,鳳山區,1438,203,425,628,55,683,1200,56.92%,16.92%,1
高雄市,鳳山區,1439,205,406,611,61,672,1101,61.04%,18.62%,1
高雄市,鳳山區,1440,125,600,725,41,766,1369,55.95%,9.13%,1
高雄市,鳳山區,1441,295,563,858,53,911,1542,59.08%,19.13%,1
高雄市,鳳山區,1442,264,635,899,53,952,1536,61.98%,17.19%,1
高雄市,鳳山區,1443,265,480,745,34,779,1382,56.37%,19.18%,1
高雄市,鳳山區,1444,275,532,807,77,884,1452,60.88%,18.94%,1
高雄市,鳳山區,1445,170,431,601,39,640,1058,60.49%,16.07%,1
高雄市,鳳山區,1446,179,404,583,50,633,976,64.86%,18.34%,1
高雄市,鳳山區,1447,252,538,790,32,822,1545,53.2%,16.31%,1
高雄市,鳳山區,1448,220,416,636,48,684,1143,59.84%,19.25%,1
高雄市,鳳山區,1449,112,121,233,17,250,1301,19.22%,8.61%,1
高雄市,鳳山區,1450,195,423,618,32,650,1250,52%,15.6%,1
高雄市,鳳山區,1451,225,436,661,51,712,1208,58.94%,18.63%,1
高雄市,鳳山區,1452,208,459,667,76,743,1202,61.81%,17.3%,1
高雄市,鳳山區,1453,299,511,810,58,868,1499,57.91%,19.95%,1
高雄市,鳳山區,1454,288,542,830,35,865,1522,56.83%,18.92%,1
高雄市,鳳山區,1455,220,463,683,51,734,1125,65.24%,19.56%,1
高雄市,鳳山區,1456,251,520,771,19,790,1307,60.44%,19.2%,1
高雄市,鳳山區,1457,258,532,790,51,841,1405,59.86%,18.36%,1
高雄市,鳳山區,1458,240,468,708,59,767,1252,61.26%,19.17%,1
高雄市,鳳山區,1459,236,565,801,26,827,1291,64.06%,18.28%,1
高雄市,鳳山區,1460,198,355,553,50,603,938,64.29%,21.11%,1
高雄市,鳳山區,1461,303,727,1030,28,1058,1783,59.34%,16.99%,1
高雄市,鳳山區,1462,218,438,656,33,689,1105,62.35%,19.73%,1
高雄市,鳳山區,1463,241,514,755,79,834,1392,59.91%,17.31%,1
高雄市,鳳山區,1464,254,545,799,36,835,1244,67.12%,20.42%,1
高雄市,鳳山區,1465,217,403,620,47,667,1154,57.8%,18.8%,1
高雄市,鳳山區,1466,225,426,651,53,704,1153,61.06%,19.51%,1
高雄市,鳳山區,1467,185,392,577,23,600,1148,52.26%,16.11%,1
高雄市,鳳山區,1468,236,484,720,107,827,1432,57.75%,16.48%,1
高雄市,鳳山區,1469,222,394,616,23,639,1429,44.72%,15.54%,1
高雄市,鳳山區,1470,247,567,814,19,833,1479,56.32%,16.7%,1
高雄市,鳳山區,1471,192,432,624,33,657,1026,64.04%,18.71%,1
高雄市,鳳山區,1472,205,395,600,81,681,993,68.58%,20.64%,1
高雄市,鳳山區,1473,193,368,561,58,619,947,65.36%,20.38%,1
高雄市,鳳山區,1474,185,404,589,45,634,1042,60.84%,17.75%,1
高雄市,鳳山區,1475,198,408,606,57,663,1098,60.38%,18.03%,1
高雄市,鳳山區,1476,214,446,660,29,689,1284,53.66%,16.67%,1
高雄市,鳳山區,1477,225,423,648,43,691,1242,55.64%,18.12%,1
高雄市,鳳山區,1478,204,424,628,59,687,1093,62.85%,18.66%,1
高雄市,鳳山區,1479,266,459,725,42,767,1353,56.69%,19.66%,1
高雄市,鳳山區,1480,246,477,723,20,743,1353,54.92%,18.18%,1
高雄市,鳳山區,1481,237,522,759,43,802,1309,61.27%,18.11%,1
高雄市,鳳山區,1482,338,574,912,49,961,1627,59.07%,20.77%,1
高雄市,鳳山區,1483,237,542,779,70,849,1372,61.88%,17.27%,1
高雄市,林園區,1773,242,464,706,61,767,1262,60.78%,19.18%,1
高雄市,林園區,1774,257,542,799,52,851,1562,54.48%,16.45%,1
高雄市,林園區,1775,205,395,600,24,624,1078,57.88%,19.02%,1
高雄市,林園區,1776,204,382,586,43,629,979,64.25%,20.84%,1
高雄市,林園區,1777,212,411,623,56,679,1195,56.82%,17.74%,1
高雄市,林園區,1778,223,467,690,66,756,1380,54.78%,16.16%,1
高雄市,林園區,1779,210,458,668,66,734,1280,57.34%,16.41%,1
高雄市,林園區,1780,214,439,653,29,682,1269,53.74%,16.86%,1
高雄市,林園區,1781,228,428,656,27,683,1568,43.56%,14.54%,1
高雄市,林園區,1782,201,495,696,44,740,1226,60.36%,16.39%,1
高雄市,林園區,1783,234,534,768,51,819,1480,55.34%,15.81%,1
高雄市,林園區,1784,237,572,809,55,864,1459,59.22%,16.24%,1
高雄市,林園區,1785,267,531,798,52,850,1593,53.36%,16.76%,1
高雄市,林園區,1786,115,313,428,118,546,895,61.01%,12.85%,1
高雄市,林園區,1787,177,366,543,32,575,1110,51.8%,15.95%,1
高雄市,林園區,1788,240,436,676,55,731,1348,54.23%,17.8%,1
高雄市,林園區,1789,178,316,494,55,549,912,60.2%,19.52%,1
高雄市,林園區,1790,209,434,643,60,703,1085,64.79%,19.26%,1
高雄市,林園區,1791,164,353,517,24,541,955,56.65%,17.17%,1
高雄市,林園區,1792,141,359,500,47,547,879,62.23%,16.04%,1
高雄市,林園區,1793,194,346,540,59,599,1103,54.31%,17.59%,1
高雄市,林園區,1794,206,417,623,62,685,1054,64.99%,19.54%,1
高雄市,林園區,1795,212,427,639,17,656,1292,50.77%,16.41%,1
高雄市,林園區,1796,283,500,783,24,807,1683,47.95%,16.82%,1
高雄市,林園區,1797,96,227,323,29,352,607,57.99%,15.82%,1
高雄市,林園區,1798,171,360,531,64,595,1012,58.79%,16.9%,1
高雄市,林園區,1799,177,392,569,50,619,1046,59.18%,16.92%,1
高雄市,林園區,1800,124,289,413,23,436,914,47.7%,13.57%,1
高雄市,林園區,1801,285,505,790,51,841,1405,59.86%,20.28%,1
高雄市,林園區,1802,343,396,739,56,795,1299,61.2%,26.4%,1
高雄市,林園區,1803,213,417,630,37,667,1170,57.01%,18.21%,1
高雄市,林園區,1804,202,381,583,37,620,1299,47.73%,15.55%,1
高雄市,林園區,1805,184,377,561,25,586,1031,56.84%,17.85%,1
高雄市,林園區,1806,143,292,435,23,458,849,53.95%,16.84%,1
高雄市,林園區,1807,148,251,399,57,456,838,54.42%,17.66%,1
高雄市,林園區,1808,164,348,512,27,539,938,57.46%,17.48%,1
高雄市,林園區,1809,164,343,507,32,539,1051,51.28%,15.6%,1
高雄市,林園區,1810,145,286,431,51,482,786,61.32%,18.45%,1
高雄市,林園區,1811,164,335,499,61,560,894,62.64%,18.34%,1
高雄市,林園區,1812,109,180,289,17,306,749,40.85%,14.55%,1
高雄市,林園區,1813,273,583,856,33,889,1485,59.87%,18.38%,1
高雄市,林園區,1814,264,562,826,80,906,1478,61.3%,17.86%,1
高雄市,林園區,1815,278,520,798,58,856,1345,63.64%,20.67%,1
高雄市,林園區,1816,193,342,535,44,579,1038,55.78%,18.59%,1
高雄市,林園區,1817,229,434,663,24,687,1203,57.11%,19.04%,1
高雄市,林園區,1818,203,432,635,18,653,1138,57.38%,17.84%,1
高雄市,林園區,1819,155,355,510,10,520,1025,50.73%,15.12%,1
高雄市,林園區,1820,218,479,697,83,780,1341,58.17%,16.26%,1
高雄市,林園區,1821,168,394,562,19,581,1218,47.7%,13.79%,1
高雄市,林園區,1822,148,345,493,25,518,1147,45.16%,12.9%,1
高雄市,林園區,1823,160,350,510,21,531,1176,45.15%,13.61%,1
高雄市,大寮區,1692,120,225,345,25,370,727,50.89%,16.51%,1
高雄市,大寮區,1693,134,210,344,16,360,718,50.14%,18.66%,1
高雄市,大寮區,1694,200,451,651,37,688,1340,51.34%,14.93%,1
高雄市,大寮區,1695,230,477,707,37,744,1575,47.24%,14.6%,1
高雄市,大寮區,1696,66,179,245,18,263,444,59.23%,14.86%,1
高雄市,大寮區,1697,288,740,1028,34,1062,2374,44.73%,12.13%,1
高雄市,大寮區,1698,213,445,658,69,727,1291,56.31%,16.5%,1
高雄市,大寮區,1699,234,506,740,73,813,1400,58.07%,16.71%,1
高雄市,大寮區,1700,224,508,732,29,761,1390,54.75%,16.12%,1
高雄市,大寮區,1701,230,496,726,56,782,1401,55.82%,16.42%,1
高雄市,大寮區,1702,201,398,599,34,633,1199,52.79%,16.76%,1
高雄市,大寮區,1703,201,381,582,25,607,1210,50.17%,16.61%,1
高雄市,大寮區,1704,197,435,632,44,676,1195,56.57%,16.49%,1
高雄市,大寮區,1705,192,402,594,29,623,1166,53.43%,16.47%,1
高雄市,大寮區,1706,243,478,721,42,763,1353,56.39%,17.96%,1
高雄市,大寮區,1707,217,384,601,59,660,1052,62.74%,20.63%,1
高雄市,大寮區,1708,168,297,465,24,489,1024,47.75%,16.41%,1
高雄市,大寮區,1709,200,460,660,22,682,1189,57.36%,16.82%,1
高雄市,大寮區,1710,260,572,832,85,917,1512,60.65%,17.2%,1
高雄市,大寮區,1711,251,567,818,61,879,1633,53.83%,15.37%,1
高雄市,大寮區,1712,222,465,687,61,748,1214,61.61%,18.29%,1
高雄市,大寮區,1713,256,497,753,67,820,1258,65.18%,20.35%,1
高雄市,大寮區,1714,251,511,762,34,796,1323,60.17%,18.97%,1
高雄市,大寮區,1715,225,502,727,37,764,1253,60.97%,17.96%,1
高雄市,大寮區,1716,185,414,599,57,656,1035,63.38%,17.87%,1
高雄市,大寮區,1717,182,421,603,33,636,1106,57.5%,16.46%,1
高雄市,大寮區,1718,192,453,645,41,686,1195,57.41%,16.07%,1
高雄市,大寮區,1719,201,410,611,17,628,1051,59.75%,19.12%,1
高雄市,大寮區,1720,288,506,794,62,856,1425,60.07%,20.21%,1
高雄市,大寮區,1721,279,577,856,58,914,1635,55.9%,17.06%,1
高雄市,大寮區,1722,243,513,756,59,815,1359,59.97%,17.88%,1
高雄市,大寮區,1723,236,517,753,59,812,1361,59.66%,17.34%,1
高雄市,大寮區,1724,274,626,900,27,927,1629,56.91%,16.82%,1
高雄市,大寮區,1725,229,606,835,42,877,1518,57.77%,15.09%,1
高雄市,大寮區,1726,272,559,831,64,895,1620,55.25%,16.79%,1
高雄市,大寮區,1727,273,570,843,18,861,1648,52.25%,16.57%,1
高雄市,大寮區,1728,236,520,756,55,811,1385,58.56%,17.04%,1
高雄市,大寮區,1729,245,513,758,32,790,1435,55.05%,17.07%,1
高雄市,大寮區,1730,169,397,566,22,588,1046,56.21%,16.16%,1
高雄市,大寮區,1731,121,276,397,29,426,789,53.99%,15.34%,1
高雄市,大寮區,1732,167,293,460,33,493,909,54.24%,18.37%,1
高雄市,大寮區,1733,146,259,405,32,437,733,59.62%,19.92%,1
高雄市,大寮區,1734,278,507,785,61,846,1553,54.48%,17.9%,1
高雄市,大寮區,1735,162,327,489,27,516,922,55.97%,17.57%,1
高雄市,大寮區,1736,169,356,525,63,588,1012,58.1%,16.7%,1
高雄市,大寮區,1737,165,318,483,60,543,968,56.1%,17.05%,1
高雄市,大寮區,1738,200,361,561,35,596,1021,58.37%,19.59%,1
高雄市,大寮區,1739,215,475,690,69,759,1554,48.84%,13.84%,1
高雄市,大寮區,1740,206,434,640,46,686,1120,61.25%,18.39%,1
高雄市,大寮區,1741,231,489,720,44,764,1225,62.37%,18.86%,1
高雄市,大寮區,1742,156,334,490,22,512,1320,38.79%,11.82%,1
高雄市,大寮區,1743,231,478,709,42,751,1317,57.02%,17.54%,1
高雄市,大寮區,1744,213,397,610,14,624,1119,55.76%,19.03%,1
高雄市,大寮區,1745,217,459,676,51,727,1190,61.09%,18.24%,1
高雄市,大寮區,1746,215,493,708,47,755,1229,61.43%,17.49%,1
高雄市,大寮區,1747,213,497,710,43,753,1178,63.92%,18.08%,1
高雄市,大寮區,1748,245,520,765,27,792,1272,62.26%,19.26%,1
高雄市,大寮區,1749,268,503,771,24,795,1413,56.26%,18.97%,1
高雄市,大寮區,1750,206,483,689,54,743,1185,62.7%,17.38%,1
高雄市,大寮區,1751,77,232,309,9,318,553,57.5%,13.92%,1
高雄市,大寮區,1752,181,387,568,58,626,1121,55.84%,16.15%,1
高雄市,大寮區,1753,244,453,697,24,721,1227,58.76%,19.89%,1
高雄市,大寮區,1754,216,444,660,58,718,1058,67.86%,20.42%,1
高雄市,大寮區,1755,215,452,667,30,697,1209,57.65%,17.78%,1
高雄市,大寮區,1756,187,451,638,23,661,1100,60.09%,17%,1
高雄市,大寮區,1757,205,376,581,28,609,1122,54.28%,18.27%,1
高雄市,大寮區,1758,189,394,583,62,645,983,65.62%,19.23%,1
高雄市,大寮區,1759,156,443,599,22,621,1192,52.1%,13.09%,1
高雄市,大寮區,1760,112,266,378,26,404,719,56.19%,15.58%,1
高雄市,大寮區,1761,130,366,496,26,522,829,62.97%,15.68%,1
高雄市,大寮區,1762,132,340,472,60,532,771,69%,17.12%,1
高雄市,大寮區,1763,205,417,622,51,673,1075,62.6%,19.07%,1
高雄市,大寮區,1764,215,505,720,77,797,1280,62.27%,16.8%,1
高雄市,大寮區,1765,198,407,605,92,697,1179,59.12%,16.79%,1
高雄市,大寮區,1766,210,422,632,26,658,1210,54.38%,17.36%,1
高雄市,大寮區,1767,30,81,111,6,117,189,61.9%,15.87%,1
高雄市,大寮區,1768,198,504,702,50,752,1228,61.24%,16.12%,1
高雄市,大寮區,1769,171,471,642,36,678,1170,57.95%,14.62%,1
高雄市,大寮區,1770,244,582,826,48,874,1416,61.72%,17.23%,1
高雄市,大寮區,1771,278,581,859,45,904,1482,61%,18.76%,1
高雄市,大寮區,1772,244,530,774,47,821,1478,55.55%,16.51%,1
高雄市,大樹區,0736,245,493,738,30,768,1386,55.41%,17.68%,1
高雄市,大樹區,0737,243,573,816,29,845,1315,64.26%,18.48%,1
高雄市,大樹區,0738,348,940,1288,56,1344,2461,54.61%,14.14%,1
高雄市,大樹區,0739,211,478,689,27,716,1274,56.2%,16.56%,1
高雄市,大樹區,0740,207,447,654,64,718,1265,56.76%,16.36%,1
高雄市,大樹區,0741,254,524,778,64,842,1504,55.98%,16.89%,1
高雄市,大樹區,0742,182,340,522,22,544,1049,51.86%,17.35%,1
高雄市,大樹區,0743,289,523,812,46,858,1573,54.55%,18.37%,1
高雄市,大樹區,0744,163,365,528,29,557,1121,49.69%,14.54%,1
高雄市,大樹區,0745,188,488,676,46,722,1207,59.82%,15.58%,1
高雄市,大樹區,0746,186,419,605,32,637,1134,56.17%,16.4%,1
高雄市,大樹區,0747,212,441,653,35,688,1124,61.21%,18.86%,1
高雄市,大樹區,0748,199,423,622,86,708,1259,56.24%,15.81%,1
高雄市,大樹區,0749,226,408,634,62,696,1105,62.99%,20.45%,1
高雄市,大樹區,0750,200,390,590,68,658,1128,58.33%,17.73%,1
高雄市,大樹區,0751,161,359,520,77,597,1079,55.33%,14.92%,1
高雄市,大樹區,0752,276,241,517,31,548,1025,53.46%,26.93%,1
高雄市,大樹區,0753,160,321,481,52,533,950,56.11%,16.84%,1
高雄市,大樹區,0754,266,464,730,80,810,1433,56.52%,18.56%,1
高雄市,大樹區,0755,114,263,377,27,404,794,50.88%,14.36%,1
高雄市,大樹區,0756,118,205,323,17,340,781,43.53%,15.11%,1
高雄市,大樹區,0757,208,424,632,21,653,1318,49.54%,15.78%,1
高雄市,大樹區,0758,127,242,369,40,409,736,55.57%,17.26%,1
高雄市,大樹區,0759,166,302,468,25,493,1047,47.09%,15.85%,1
高雄市,大樹區,0760,231,459,690,62,752,1271,59.17%,18.17%,1
高雄市,大樹區,0761,175,405,580,36,616,1186,51.94%,14.76%,1
高雄市,大樹區,0762,179,361,540,57,597,1007,59.29%,17.78%,1
高雄市,大樹區,0763,158,307,465,55,520,859,60.54%,18.39%,1
高雄市,大樹區,0764,104,228,332,18,350,735,47.62%,14.15%,1
高雄市,大樹區,0765,191,381,572,79,651,1046,62.24%,18.26%,1
高雄市,大樹區,0766,109,512,621,31,652,880,74.09%,12.39%,1
高雄市,大樹區,0767,70,277,347,23,370,720,51.39%,9.72%,1
高雄市,大社區,0637,153,322,475,64,539,950,56.74%,16.11%,1
高雄市,大社區,0638,321,340,661,27,688,1306,52.68%,24.58%,1
高雄市,大社區,0639,255,556,811,33,844,1856,45.47%,13.74%,1
高雄市,大社區,0640,205,391,596,47,643,986,65.21%,20.79%,1
高雄市,大社區,0641,194,337,531,42,573,1116,51.34%,17.38%,1
高雄市,大社區,0642,273,472,745,62,807,1253,64.41%,21.79%,1
高雄市,大社區,0643,296,620,916,39,955,1613,59.21%,18.35%,1
高雄市,大社區,0644,254,484,738,38,776,1455,53.33%,17.46%,1
高雄市,大社區,0645,316,637,953,47,1000,1674,59.74%,18.88%,1
高雄市,大社區,0646,181,378,559,51,610,1004,60.76%,18.03%,1
高雄市,大社區,0647,160,323,483,41,524,879,59.61%,18.2%,1
高雄市,大社區,0648,169,240,409,26,435,778,55.91%,21.72%,1
高雄市,大社區,0649,224,391,615,60,675,1110,60.81%,20.18%,1
高雄市,大社區,0650,281,389,670,148,818,1432,57.12%,19.62%,1
高雄市,大社區,0651,280,553,833,40,873,1466,59.55%,19.1%,1
高雄市,大社區,0652,311,532,843,67,910,1383,65.8%,22.49%,1
高雄市,大社區,0653,325,592,917,69,986,1645,59.94%,19.76%,1
高雄市,大社區,0654,268,485,753,47,800,1555,51.45%,17.23%,1
高雄市,大社區,0655,373,601,974,56,1030,1750,58.86%,21.31%,1
高雄市,大社區,0656,214,398,612,52,664,1111,59.77%,19.26%,1
高雄市,大社區,0657,223,403,626,69,695,1133,61.34%,19.68%,1
高雄市,大社區,0658,172,346,518,41,559,912,61.29%,18.86%,1
高雄市,大社區,0659,126,206,332,15,347,745,46.58%,16.91%,1
高雄市,大社區,0660,179,357,536,24,560,934,59.96%,19.16%,1
高雄市,仁武區,0661,335,791,1126,38,1164,1777,65.5%,18.85%,1
高雄市,仁武區,0662,400,940,1340,59,1399,2273,61.55%,17.6%,1
高雄市,仁武區,0663,268,574,842,76,918,1384,66.33%,19.36%,1
高雄市,仁武區,0664,199,442,641,49,690,1170,58.97%,17.01%,1
高雄市,仁武區,0665,269,497,766,53,819,1216,67.35%,22.12%,1
高雄市,仁武區,0666,272,611,883,23,906,1598,56.7%,17.02%,1
高雄市,仁武區,0667,405,920,1325,31,1356,2143,63.28%,18.9%,1
高雄市,仁武區,0668,231,453,684,68,752,1300,57.85%,17.77%,1
高雄市,仁武區,0669,249,506,755,67,822,1338,61.43%,18.61%,1
高雄市,仁武區,0670,209,431,640,22,662,1217,54.4%,17.17%,1
高雄市,仁武區,0671,151,404,555,62,617,1202,51.33%,12.56%,1
高雄市,仁武區,0672,228,494,722,40,762,1404,54.27%,16.24%,1
高雄市,仁武區,0673,142,297,439,42,481,830,57.95%,17.11%,1
高雄市,仁武區,0674,228,536,764,45,809,1802,44.89%,12.65%,1
高雄市,仁武區,0675,307,642,949,59,1008,1877,53.7%,16.36%,1
高雄市,仁武區,0676,268,548,816,27,843,1738,48.5%,15.42%,1
高雄市,仁武區,0677,304,517,821,55,876,1549,56.55%,19.63%,1
高雄市,仁武區,0678,284,607,891,47,938,1579,59.4%,17.99%,1
高雄市,仁武區,0679,205,545,750,32,782,1406,55.62%,14.58%,1
高雄市,仁武區,0680,273,560,833,28,861,1461,58.93%,18.69%,1
高雄市,仁武區,0681,265,509,774,47,821,1311,62.62%,20.21%,1
高雄市,仁武區,0682,238,526,764,22,786,1373,57.25%,17.33%,1
高雄市,仁武區,0683,202,324,526,13,539,1035,52.08%,19.52%,1
高雄市,仁武區,0684,188,442,630,33,663,1181,56.14%,15.92%,1
高雄市,仁武區,0685,344,554,898,37,935,1670,55.99%,20.6%,1
高雄市,仁武區,0686,282,589,871,24,895,1576,56.79%,17.89%,1
高雄市,仁武區,0687,304,629,933,46,979,1576,62.12%,19.29%,1
高雄市,仁武區,0688,352,804,1156,31,1187,1915,61.98%,18.38%,1
高雄市,仁武區,0689,289,674,963,31,994,1758,56.54%,16.44%,1
高雄市,仁武區,0690,337,822,1159,45,1204,1892,63.64%,17.81%,1
高雄市,仁武區,0691,369,804,1173,52,1225,2025,60.49%,18.22%,1
高雄市,仁武區,0692,379,825,1204,48,1252,2014,62.16%,18.82%,1
高雄市,仁武區,0693,316,644,960,35,995,1473,67.55%,21.45%,1
高雄市,仁武區,0694,172,344,516,29,545,979,55.67%,17.57%,1
高雄市,仁武區,0695,174,364,538,19,557,944,59%,18.43%,1
高雄市,仁武區,0696,212,423,635,66,701,1153,60.8%,18.39%,1
高雄市,仁武區,0697,209,498,707,35,742,1328,55.87%,15.74%,1
高雄市,仁武區,0698,299,635,934,66,1000,1657,60.35%,18.04%,1
高雄市,仁武區,0699,259,519,778,50,828,1545,53.59%,16.76%,1
高雄市,仁武區,0700,250,599,849,41,890,1417,62.81%,17.64%,1
高雄市,仁武區,0701,303,699,1002,31,1033,1602,64.48%,18.91%,1
高雄市,仁武區,0702,343,779,1122,51,1173,1823,64.34%,18.82%,1
高雄市,仁武區,0703,365,718,1083,31,1114,1914,58.2%,19.07%,1
高雄市,仁武區,0704,349,765,1114,51,1165,1992,58.48%,17.52%,1
高雄市,仁武區,0705,305,730,1035,41,1076,2045,52.62%,14.91%,1
高雄市,仁武區,0706,378,800,1178,45,1223,1982,61.71%,19.07%,1
高雄市,仁武區,0707,358,760,1118,48,1166,2167,53.81%,16.52%,1
高雄市,鳥松區,0708,308,622,930,57,987,1678,58.82%,18.36%,1
高雄市,鳥松區,0709,284,571,855,61,916,1682,54.46%,16.88%,1
高雄市,鳥松區,0710,248,472,720,47,767,1225,62.61%,20.24%,1
高雄市,鳥松區,0711,236,449,685,49,734,1322,55.52%,17.85%,1
高雄市,鳥松區,0712,222,479,701,37,738,1215,60.74%,18.27%,1
高雄市,鳥松區,0713,313,615,928,47,975,1779,54.81%,17.59%,1
高雄市,鳥松區,0714,370,357,727,13,740,1129,65.54%,32.77%,1
高雄市,鳥松區,0715,274,539,813,46,859,1374,62.52%,19.94%,1
高雄市,鳥松區,0716,225,399,624,30,654,1089,60.06%,20.66%,1
高雄市,鳥松區,0717,484,835,1319,48,1367,2219,61.6%,21.81%,1
高雄市,鳥松區,0718,345,598,943,35,978,1634,59.85%,21.11%,1
高雄市,鳥松區,0719,304,631,935,52,987,1553,63.55%,19.58%,1
高雄市,鳥松區,0720,344,607,951,43,994,1572,63.23%,21.88%,1
高雄市,鳥松區,0721,375,655,1030,38,1068,1688,63.27%,22.22%,1
高雄市,鳥松區,0722,376,611,987,41,1028,1626,63.22%,23.12%,1
高雄市,鳥松區,0723,373,691,1064,64,1128,1744,64.68%,21.39%,1
高雄市,鳥松區,0724,193,458,651,43,694,1230,56.42%,15.69%,1
高雄市,鳥松區,0725,235,469,704,70,774,1201,64.45%,19.57%,1
高雄市,鳥松區,0726,205,479,684,42,726,1117,65%,18.35%,1
高雄市,鳥松區,0727,180,499,679,60,739,1255,58.88%,14.34%,1
高雄市,鳥松區,0728,227,510,737,33,770,1432,53.77%,15.85%,1
高雄市,鳥松區,0729,500,198,698,31,729,1370,53.21%,36.5%,1
高雄市,鳥松區,0730,222,557,779,77,856,1364,62.76%,16.28%,1
高雄市,鳥松區,0731,162,448,610,53,663,1041,63.69%,15.56%,1
高雄市,鳥松區,0732,150,329,479,61,540,702,76.92%,21.37%,1
高雄市,鳥松區,0733,215,471,686,50,736,1212,60.73%,17.74%,1
高雄市,鳥松區,0734,200,506,706,51,757,1289,58.73%,15.52%,1
高雄市,鳥松區,0735,307,606,913,26,939,1449,64.8%,21.19%,1
高雄市,岡山區,0261,285,562,847,30,877,1345,65.2%,21.19%,1
高雄市,岡山區,0262,161,319,480,18,498,1045,47.66%,15.41%,1
高雄市,岡山區,0263,178,439,617,27,644,1051,61.27%,16.94%,1
高雄市,岡山區,0264,194,355,549,16,565,917,61.61%,21.16%,1
高雄市,岡山區,0265,222,365,587,28,615,934,65.85%,23.77%,1
高雄市,岡山區,0266,168,486,654,41,695,1097,63.35%,15.31%,1
高雄市,岡山區,0267,207,560,767,37,804,1208,66.56%,17.14%,1
高雄市,岡山區,0268,224,506,730,44,774,1159,66.78%,19.33%,1
高雄市,岡山區,0269,204,383,587,39,626,1018,61.49%,20.04%,1
高雄市,岡山區,0270,239,437,676,28,704,1316,53.5%,18.16%,1
高雄市,岡山區,0271,243,513,756,35,791,1345,58.81%,18.07%,1
高雄市,岡山區,0272,248,518,766,40,806,1295,62.24%,19.15%,1
高雄市,岡山區,0273,254,557,811,35,846,1425,59.37%,17.82%,1
高雄市,岡山區,0274,229,513,742,30,772,1328,58.13%,17.24%,1
高雄市,岡山區,0275,249,563,812,16,828,1382,59.91%,18.02%,1
高雄市,岡山區,0276,263,570,833,15,848,1381,61.4%,19.04%,1
高雄市,岡山區,0277,248,468,716,60,776,1282,60.53%,19.34%,1
高雄市,岡山區,0278,222,479,701,15,716,1240,57.74%,17.9%,1
高雄市,岡山區,0279,239,523,762,39,801,1327,60.36%,18.01%,1
高雄市,岡山區,0280,330,604,934,36,970,1736,55.88%,19.01%,1
高雄市,岡山區,0281,294,610,904,45,949,1566,60.6%,18.77%,1
高雄市,岡山區,0282,177,590,767,53,820,1779,46.09%,9.95%,1
高雄市,岡山區,0283,267,630,897,65,962,1593,60.39%,16.76%,1
高雄市,岡山區,0284,258,604,862,63,925,1480,62.5%,17.43%,1
高雄市,岡山區,0285,215,583,798,28,826,1364,60.56%,15.76%,1
高雄市,岡山區,0286,239,585,824,43,867,1410,61.49%,16.95%,1
高雄市,岡山區,0287,213,536,749,45,794,1148,69.16%,18.55%,1
高雄市,岡山區,0288,126,245,371,40,411,625,65.76%,20.16%,1
高雄市,岡山區,0289,198,378,576,26,602,969,62.13%,20.43%,1
高雄市,岡山區,0290,177,350,527,21,548,861,63.65%,20.56%,1
高雄市,岡山區,0291,143,289,432,21,453,823,55.04%,17.38%,1
高雄市,岡山區,0292,193,357,550,48,598,889,67.27%,21.71%,1
高雄市,岡山區,0293,238,502,740,39,779,1283,60.72%,18.55%,1
高雄市,岡山區,0294,250,575,825,31,856,1512,56.61%,16.53%,1
高雄市,岡山區,0295,200,418,618,54,672,983,68.36%,20.35%,1
高雄市,岡山區,0296,227,504,731,36,767,1262,60.78%,17.99%,1
高雄市,岡山區,0297,215,428,643,46,689,1096,62.86%,19.62%,1
高雄市,岡山區,0298,204,413,617,34,651,1066,61.07%,19.14%,1
高雄市,岡山區,0299,204,432,636,32,668,1188,56.23%,17.17%,1
高雄市,岡山區,0300,280,536,816,35,851,1360,62.57%,20.59%,1
高雄市,岡山區,0301,254,579,833,21,854,1363,62.66%,18.64%,1
高雄市,岡山區,0302,327,513,840,38,878,1352,64.94%,24.19%,1
高雄市,岡山區,0303,254,564,818,52,870,1460,59.59%,17.4%,1
高雄市,岡山區,0304,248,501,749,34,783,1272,61.56%,19.5%,1
高雄市,岡山區,0305,206,440,646,50,696,1080,64.44%,19.07%,1
高雄市,岡山區,0306,231,491,722,56,778,1255,61.99%,18.41%,1
高雄市,岡山區,0307,162,423,585,44,629,938,67.06%,17.27%,1
高雄市,岡山區,0308,230,519,749,43,792,1237,64.03%,18.59%,1
高雄市,岡山區,0309,239,515,754,32,786,1413,55.63%,16.91%,1
高雄市,岡山區,0310,149,306,455,13,468,765,61.18%,19.48%,1
高雄市,岡山區,0311,211,445,656,29,685,1043,65.68%,20.23%,1
高雄市,岡山區,0312,126,294,420,35,455,844,53.91%,14.93%,1
高雄市,岡山區,0313,225,467,692,39,731,993,73.62%,22.66%,1
高雄市,岡山區,0314,229,379,608,67,675,1038,65.03%,22.06%,1
高雄市,岡山區,0315,169,414,583,77,660,1070,61.68%,15.79%,1
高雄市,岡山區,0316,217,415,632,61,693,1023,67.74%,21.21%,1
高雄市,岡山區,0317,233,527,760,37,797,1349,59.08%,17.27%,1
高雄市,岡山區,0318,130,522,652,46,698,1452,48.07%,8.95%,1
高雄市,岡山區,0319,70,120,190,14,204,301,67.77%,23.26%,1
高雄市,岡山區,0320,144,291,435,81,516,756,68.25%,19.05%,1
高雄市,岡山區,0321,106,275,381,23,404,733,55.12%,14.46%,1
高雄市,岡山區,0322,172,360,532,67,599,854,70.14%,20.14%,1
高雄市,岡山區,0323,110,296,406,20,426,866,49.19%,12.7%,1
高雄市,岡山區,0324,207,320,527,51,578,978,59.1%,21.17%,1
高雄市,岡山區,0325,198,584,782,35,817,1336,61.15%,14.82%,1
高雄市,岡山區,0326,153,607,760,12,772,1218,63.38%,12.56%,1
高雄市,岡山區,0327,94,155,249,10,259,341,75.95%,27.57%,1
高雄市,岡山區,0328,140,545,685,31,716,955,74.97%,14.66%,1
高雄市,岡山區,0329,132,509,641,12,653,940,69.47%,14.04%,1
高雄市,岡山區,0330,167,374,541,34,575,851,67.57%,19.62%,1
高雄市,岡山區,0331,155,369,524,12,536,762,70.34%,20.34%,1
高雄市,岡山區,0332,67,163,230,10,240,318,75.47%,21.07%,1
高雄市,橋頭區,0404,233,378,611,69,680,1005,67.66%,23.18%,1
高雄市,橋頭區,0405,223,423,646,42,688,1073,64.12%,20.78%,1
高雄市,橋頭區,0406,217,459,676,26,702,1129,62.18%,19.22%,1
高雄市,橋頭區,0407,244,469,713,73,786,1244,63.18%,19.61%,1
高雄市,橋頭區,0408,208,400,608,32,640,1091,58.66%,19.07%,1
高雄市,橋頭區,0409,281,544,825,52,877,1329,65.99%,21.14%,1
高雄市,橋頭區,0410,226,430,656,55,711,1140,62.37%,19.82%,1
高雄市,橋頭區,0411,224,467,691,68,759,1220,62.21%,18.36%,1
高雄市,橋頭區,0412,213,439,652,63,715,1047,68.29%,20.34%,1
高雄市,橋頭區,0413,250,454,704,88,792,1315,60.23%,19.01%,1
高雄市,橋頭區,0414,131,248,379,32,411,691,59.48%,18.96%,1
高雄市,橋頭區,0415,141,279,420,60,480,720,66.67%,19.58%,1
高雄市,橋頭區,0416,255,398,653,90,743,1192,62.33%,21.39%,1
高雄市,橋頭區,0417,266,501,767,83,850,1318,64.49%,20.18%,1
高雄市,橋頭區,0418,143,311,454,40,494,761,64.91%,18.79%,1
高雄市,橋頭區,0419,188,359,547,29,576,973,59.2%,19.32%,1
高雄市,橋頭區,0420,129,204,333,32,365,587,62.18%,21.98%,1
高雄市,橋頭區,0421,170,321,491,40,531,812,65.39%,20.94%,1
高雄市,橋頭區,0422,73,131,204,15,219,343,63.85%,21.28%,1
高雄市,橋頭區,0423,301,497,798,24,822,1266,64.93%,23.78%,1
高雄市,橋頭區,0424,198,468,666,79,745,1128,66.05%,17.55%,1
高雄市,橋頭區,0425,152,370,522,43,565,884,63.91%,17.19%,1
高雄市,橋頭區,0426,195,430,625,70,695,1187,58.55%,16.43%,1
高雄市,橋頭區,0427,218,501,719,63,782,1259,62.11%,17.32%,1
高雄市,橋頭區,0428,218,472,690,65,755,1361,55.47%,16.02%,1
高雄市,橋頭區,0429,105,230,335,29,364,671,54.25%,15.65%,1
高雄市,橋頭區,0430,265,461,726,50,776,1215,63.87%,21.81%,1
高雄市,橋頭區,0431,212,524,736,72,808,1255,64.38%,16.89%,1
高雄市,橋頭區,0432,258,467,725,65,790,1219,64.81%,21.16%,1
高雄市,橋頭區,0433,253,507,760,37,797,1372,58.09%,18.44%,1
高雄市,橋頭區,0434,131,203,334,8,342,758,45.12%,17.28%,1
高雄市,燕巢區,0333,171,415,586,71,657,1152,57.03%,14.84%,1
高雄市,燕巢區,0334,198,412,610,35,645,1120,57.59%,17.68%,1
高雄市,燕巢區,0335,170,426,596,51,647,974,66.43%,17.45%,1
高雄市,燕巢區,0336,188,371,559,17,576,1019,56.53%,18.45%,1
高雄市,燕巢區,0337,216,330,546,56,602,1058,56.9%,20.42%,1
高雄市,燕巢區,0338,160,309,469,29,498,1017,48.97%,15.73%,1
高雄市,燕巢區,0339,11,27,38,4,42,259,16.22%,4.25%,1
高雄市,燕巢區,0340,155,406,561,52,613,926,66.2%,16.74%,1
高雄市,燕巢區,0341,103,211,314,14,328,624,52.56%,16.51%,1
高雄市,燕巢區,0342,192,469,661,59,720,1102,65.34%,17.42%,1
高雄市,燕巢區,0343,166,368,534,47,581,1072,54.2%,15.49%,1
高雄市,燕巢區,0344,265,453,718,74,792,1361,58.19%,19.47%,1
高雄市,燕巢區,0345,68,189,257,31,288,472,61.02%,14.41%,1
高雄市,燕巢區,0346,169,428,597,45,642,1197,53.63%,14.12%,1
高雄市,燕巢區,0347,205,462,667,70,737,1134,64.99%,18.08%,1
高雄市,燕巢區,0348,189,413,602,36,638,1148,55.57%,16.46%,1
高雄市,燕巢區,0349,202,393,595,61,656,1207,54.35%,16.74%,1
高雄市,燕巢區,0350,277,586,863,40,903,1402,64.41%,19.76%,1
高雄市,燕巢區,0351,194,355,549,59,608,1000,60.8%,19.4%,1
高雄市,燕巢區,0352,233,389,622,59,681,1110,61.35%,20.99%,1
高雄市,燕巢區,0353,245,454,699,50,749,1291,58.02%,18.98%,1
高雄市,燕巢區,0354,130,288,418,72,490,797,61.48%,16.31%,1
高雄市,燕巢區,0355,158,372,530,46,576,1098,52.46%,14.39%,1
高雄市,燕巢區,0356,209,488,697,55,752,1393,53.98%,15%,1
高雄市,燕巢區,0357,124,341,465,26,491,1079,45.51%,11.49%,1
高雄市,田寮區,0237,42,114,156,8,164,369,44.44%,11.38%,1
高雄市,田寮區,0238,94,169,263,17,280,656,42.68%,14.33%,1
高雄市,田寮區,0239,36,74,110,15,125,406,30.79%,8.87%,1
高雄市,田寮區,0240,65,101,166,26,192,380,50.53%,17.11%,1
高雄市,田寮區,0241,42,146,188,15,203,379,53.56%,11.08%,1
高雄市,田寮區,0242,78,221,299,55,354,625,56.64%,12.48%,1
高雄市,田寮區,0243,154,295,449,18,467,946,49.37%,16.28%,1
高雄市,田寮區,0244,93,242,335,43,378,794,47.61%,11.71%,1
高雄市,田寮區,0245,42,106,148,21,169,382,44.24%,10.99%,1
高雄市,田寮區,0246,60,97,157,43,200,513,38.99%,11.7%,1
高雄市,田寮區,0247,92,195,287,21,308,601,51.25%,15.31%,1
高雄市,田寮區,0248,99,222,321,43,364,620,58.71%,15.97%,1
高雄市,阿蓮區,0216,372,222,594,37,631,1299,48.58%,28.64%,1
高雄市,阿蓮區,0217,178,396,574,28,602,1107,54.38%,16.08%,1
高雄市,阿蓮區,0218,135,305,440,22,462,898,51.45%,15.03%,1
高雄市,阿蓮區,0219,212,407,619,69,688,1259,54.65%,16.84%,1
高雄市,阿蓮區,0220,280,517,797,42,839,1579,53.13%,17.73%,1
高雄市,阿蓮區,0221,103,215,318,11,329,564,58.33%,18.26%,1
高雄市,阿蓮區,0222,162,288,450,48,498,768,64.84%,21.09%,1
高雄市,阿蓮區,0223,205,375,580,57,637,1092,58.33%,18.77%,1
高雄市,阿蓮區,0224,192,385,577,50,627,1099,57.05%,17.47%,1
高雄市,阿蓮區,0225,200,417,617,25,642,1134,56.61%,17.64%,1
高雄市,阿蓮區,0226,266,507,773,24,797,1561,51.06%,17.04%,1
高雄市,阿蓮區,0227,301,540,841,64,905,1533,59.03%,19.63%,1
高雄市,阿蓮區,0228,179,351,530,37,567,1116,50.81%,16.04%,1
高雄市,阿蓮區,0229,193,363,556,27,583,1054,55.31%,18.31%,1
高雄市,阿蓮區,0230,223,415,638,49,687,1260,54.52%,17.7%,1
高雄市,阿蓮區,0231,234,505,739,60,799,1504,53.13%,15.56%,1
高雄市,阿蓮區,0232,125,256,381,21,402,848,47.41%,14.74%,1
高雄市,阿蓮區,0233,124,294,418,18,436,823,52.98%,15.07%,1
高雄市,阿蓮區,0234,161,391,552,34,586,1021,57.39%,15.77%,1
高雄市,阿蓮區,0235,311,545,856,25,881,1715,51.37%,18.13%,1
高雄市,阿蓮區,0236,197,445,642,44,686,1300,52.77%,15.15%,1
高雄市,路竹區,0175,172,350,522,25,547,1026,53.31%,16.76%,1
高雄市,路竹區,0176,187,382,569,62,631,1069,59.03%,17.49%,1
高雄市,路竹區,0177,204,427,631,60,691,1127,61.31%,18.1%,1
高雄市,路竹區,0178,157,462,619,57,676,1179,57.34%,13.32%,1
高雄市,路竹區,0179,213,411,624,78,702,1237,56.75%,17.22%,1
高雄市,路竹區,0180,211,403,614,47,661,1096,60.31%,19.25%,1
高雄市,路竹區,0181,240,499,739,65,804,1272,63.21%,18.87%,1
高雄市,路竹區,0182,183,456,639,58,697,1182,58.97%,15.48%,1
高雄市,路竹區,0183,183,416,599,56,655,1127,58.12%,16.24%,1
高雄市,路竹區,0184,187,339,526,49,575,956,60.15%,19.56%,1
高雄市,路竹區,0185,210,392,602,64,666,1132,58.83%,18.55%,1
高雄市,路竹區,0186,193,377,570,86,656,1025,64%,18.83%,1
高雄市,路竹區,0187,172,367,539,27,566,1007,56.21%,17.08%,1
高雄市,路竹區,0188,214,425,639,60,699,1301,53.73%,16.45%,1
高雄市,路竹區,0189,141,333,474,39,513,885,57.97%,15.93%,1
高雄市,路竹區,0190,139,255,394,18,412,837,49.22%,16.61%,1
高雄市,路竹區,0191,184,334,518,47,565,930,60.75%,19.78%,1
高雄市,路竹區,0192,130,237,367,40,407,781,52.11%,16.65%,1
高雄市,路竹區,0193,181,375,556,57,613,1023,59.92%,17.69%,1
高雄市,路竹區,0194,335,648,983,73,1056,1763,59.9%,19%,1
高雄市,路竹區,0195,294,586,880,52,932,1637,56.93%,17.96%,1
高雄市,路竹區,0196,182,381,563,44,607,1070,56.73%,17.01%,1
高雄市,路竹區,0197,208,460,668,59,727,1177,61.77%,17.67%,1
高雄市,路竹區,0198,188,363,551,43,594,1007,58.99%,18.67%,1
高雄市,路竹區,0199,199,357,556,41,597,1026,58.19%,19.4%,1
高雄市,路竹區,0200,171,388,559,39,598,1017,58.8%,16.81%,1
高雄市,路竹區,0201,250,450,700,37,737,1264,58.31%,19.78%,1
高雄市,路竹區,0202,197,422,619,50,669,1089,61.43%,18.09%,1
高雄市,路竹區,0203,157,304,461,36,497,851,58.4%,18.45%,1
高雄市,路竹區,0204,186,367,553,77,630,1011,62.31%,18.4%,1
高雄市,路竹區,0205,173,398,571,36,607,937,64.78%,18.46%,1
高雄市,路竹區,0206,127,283,410,16,426,820,51.95%,15.49%,1
高雄市,路竹區,0207,204,346,550,24,574,910,63.08%,22.42%,1
高雄市,路竹區,0208,163,281,444,50,494,867,56.98%,18.8%,1
高雄市,路竹區,0209,171,347,518,31,549,937,58.59%,18.25%,1
高雄市,路竹區,0210,191,296,487,36,523,900,58.11%,21.22%,1
高雄市,路竹區,0211,152,357,509,49,558,900,62%,16.89%,1
高雄市,路竹區,0212,161,365,526,36,562,918,61.22%,17.54%,1
高雄市,路竹區,0213,180,343,523,40,563,870,64.71%,20.69%,1
高雄市,路竹區,0214,233,445,678,46,724,1150,62.96%,20.26%,1
高雄市,路竹區,0215,285,645,930,54,984,1537,64.02%,18.54%,1
高雄市,湖內區,0151,142,388,530,42,572,1112,51.44%,12.77%,1
高雄市,湖內區,0152,160,351,511,77,588,1017,57.82%,15.73%,1
高雄市,湖內區,0153,153,249,402,25,427,796,53.64%,19.22%,1
高雄市,湖內區,0154,231,412,643,30,673,1079,62.37%,21.41%,1
高雄市,湖內區,0155,199,398,597,34,631,1115,56.59%,17.85%,1
高雄市,湖內區,0156,100,575,675,38,713,1311,54.39%,7.63%,1
高雄市,湖內區,0157,223,438,661,30,691,1319,52.39%,16.91%,1
高雄市,湖內區,0158,226,509,735,56,791,1244,63.59%,18.17%,1
高雄市,湖內區,0159,214,522,736,42,778,1227,63.41%,17.44%,1
高雄市,湖內區,0160,197,460,657,56,713,1163,61.31%,16.94%,1
高雄市,湖內區,0161,181,371,552,46,598,981,60.96%,18.45%,1
高雄市,湖內區,0162,127,279,406,18,424,780,54.36%,16.28%,1
高雄市,湖內區,0163,127,303,430,44,474,832,56.97%,15.26%,1
高雄市,湖內區,0164,200,405,605,37,642,1017,63.13%,19.67%,1
高雄市,湖內區,0165,219,379,598,17,615,1051,58.52%,20.84%,1
高雄市,湖內區,0166,155,334,489,29,518,941,55.05%,16.47%,1
高雄市,湖內區,0167,131,307,438,49,487,863,56.43%,15.18%,1
高雄市,湖內區,0168,223,354,577,53,630,1160,54.31%,19.22%,1
高雄市,湖內區,0169,168,282,450,34,484,1090,44.4%,15.41%,1
高雄市,湖內區,0170,213,376,589,57,646,1122,57.58%,18.98%,1
高雄市,湖內區,0171,182,341,523,28,551,1123,49.07%,16.21%,1
高雄市,湖內區,0172,115,240,355,28,383,684,55.99%,16.81%,1
高雄市,湖內區,0173,183,418,601,24,625,1249,50.04%,14.65%,1
高雄市,湖內區,0174,220,457,677,48,725,1453,49.9%,15.14%,1
高雄市,茄萣區,0130,156,301,457,19,476,976,48.77%,15.98%,1
高雄市,茄萣區,0131,147,280,427,59,486,887,54.79%,16.57%,1
高雄市,茄萣區,0132,262,592,854,38,892,1710,52.16%,15.32%,1
高雄市,茄萣區,0133,152,385,537,48,585,1280,45.7%,11.88%,1
高雄市,茄萣區,0134,227,508,735,29,764,1314,58.14%,17.28%,1
高雄市,茄萣區,0135,219,480,699,25,724,1157,62.58%,18.93%,1
高雄市,茄萣區,0136,615,288,903,87,990,1785,55.46%,34.45%,1
高雄市,茄萣區,0137,133,290,423,65,488,838,58.23%,15.87%,1
高雄市,茄萣區,0138,247,508,755,47,802,1249,64.21%,19.78%,1
高雄市,茄萣區,0139,202,335,537,76,613,1116,54.93%,18.1%,1
高雄市,茄萣區,0140,165,297,462,51,513,978,52.45%,16.87%,1
高雄市,茄萣區,0141,157,333,490,35,525,1125,46.67%,13.96%,1
高雄市,茄萣區,0142,197,373,570,54,624,1139,54.78%,17.3%,1
高雄市,茄萣區,0143,219,461,680,86,766,1363,56.2%,16.07%,1
高雄市,茄萣區,0144,274,582,856,88,944,1598,59.07%,17.15%,1
高雄市,茄萣區,0145,167,377,544,52,596,1111,53.65%,15.03%,1
高雄市,茄萣區,0146,114,280,394,43,437,925,47.24%,12.32%,1
高雄市,茄萣區,0147,186,388,574,52,626,1148,54.53%,16.2%,1
高雄市,茄萣區,0148,186,468,654,35,689,1353,50.92%,13.75%,1
高雄市,茄萣區,0149,200,471,671,60,731,1331,54.92%,15.03%,1
高雄市,茄萣區,0150,285,549,834,62,896,1829,48.99%,15.58%,1
高雄市,永安區,0249,146,320,466,39,505,756,66.8%,19.31%,1
高雄市,永安區,0250,150,321,471,52,523,818,63.94%,18.34%,1
高雄市,永安區,0251,262,308,570,31,601,866,69.4%,30.25%,1
高雄市,永安區,0252,153,407,560,54,614,951,64.56%,16.09%,1
高雄市,永安區,0253,184,397,581,50,631,992,63.61%,18.55%,1
高雄市,永安區,0254,123,193,316,15,331,682,48.53%,18.04%,1
高雄市,永安區,0255,108,273,381,22,403,665,60.6%,16.24%,1
高雄市,永安區,0256,69,119,188,15,203,371,54.72%,18.6%,1
高雄市,永安區,0257,219,452,671,61,732,1114,65.71%,19.66%,1
高雄市,永安區,0258,255,588,843,40,883,1418,62.27%,17.98%,1
高雄市,永安區,0259,276,600,876,79,955,1477,64.66%,18.69%,1
高雄市,永安區,0260,378,745,1123,69,1192,1891,63.04%,19.99%,1
高雄市,彌陀區,0358,194,487,681,67,748,1246,60.03%,15.57%,1
高雄市,彌陀區,0359,164,334,498,56,554,885,62.6%,18.53%,1
高雄市,彌陀區,0360,190,399,589,64,653,955,68.38%,19.9%,1
高雄市,彌陀區,0361,92,190,282,34,316,534,59.18%,17.23%,1
高雄市,彌陀區,0362,122,300,422,28,450,738,60.98%,16.53%,1
高雄市,彌陀區,0363,157,383,540,37,577,855,67.49%,18.36%,1
高雄市,彌陀區,0364,157,363,520,48,568,877,64.77%,17.9%,1
高雄市,彌陀區,0365,143,308,451,55,506,781,64.79%,18.31%,1
高雄市,彌陀區,0366,164,289,453,34,487,808,60.27%,20.3%,1
高雄市,彌陀區,0367,126,313,439,31,470,904,51.99%,13.94%,1
高雄市,彌陀區,0368,155,293,448,55,503,825,60.97%,18.79%,1
高雄市,彌陀區,0369,129,340,469,60,529,941,56.22%,13.71%,1
高雄市,彌陀區,0370,203,350,553,29,582,1013,57.45%,20.04%,1
高雄市,彌陀區,0371,179,427,606,56,662,1024,64.65%,17.48%,1
高雄市,彌陀區,0372,135,305,440,17,457,861,53.08%,15.68%,1
高雄市,彌陀區,0373,215,433,648,82,730,1163,62.77%,18.49%,1
高雄市,彌陀區,0374,208,525,733,67,800,1216,65.79%,17.11%,1
高雄市,彌陀區,0375,160,399,559,69,628,861,72.94%,18.58%,1
高雄市,梓官區,0376,159,457,616,68,684,1061,64.47%,14.99%,1
高雄市,梓官區,0377,195,376,571,66,637,1063,59.92%,18.34%,1
高雄市,梓官區,0378,187,360,547,31,578,969,59.65%,19.3%,1
高雄市,梓官區,0379,183,349,532,29,561,1078,52.04%,16.98%,1
高雄市,梓官區,0380,165,297,462,62,524,838,62.53%,19.69%,1
高雄市,梓官區,0381,104,248,352,39,391,611,63.99%,17.02%,1
高雄市,梓官區,0382,148,199,347,20,367,782,46.93%,18.93%,1
高雄市,梓官區,0383,288,589,877,66,943,1451,64.99%,19.85%,1
高雄市,梓官區,0384,217,395,612,23,635,1144,55.51%,18.97%,1
高雄市,梓官區,0385,136,368,504,23,527,975,54.05%,13.95%,1
高雄市,梓官區,0386,209,506,715,45,760,1317,57.71%,15.87%,1
高雄市,梓官區,0387,218,455,673,83,756,1218,62.07%,17.9%,1
高雄市,梓官區,0388,184,411,595,37,632,1073,58.9%,17.15%,1
高雄市,梓官區,0389,264,386,650,31,681,1112,61.24%,23.74%,1
高雄市,梓官區,0390,135,230,365,38,403,715,56.36%,18.88%,1
高雄市,梓官區,0391,194,470,664,58,722,1311,55.07%,14.8%,1
高雄市,梓官區,0392,162,361,523,33,556,939,59.21%,17.25%,1
高雄市,梓官區,0393,136,357,493,23,516,824,62.62%,16.5%,1
高雄市,梓官區,0394,174,433,607,95,702,1052,66.73%,16.54%,1
高雄市,梓官區,0395,179,393,572,78,650,1020,63.73%,17.55%,1
高雄市,梓官區,0396,195,454,649,41,690,1260,54.76%,15.48%,1
高雄市,梓官區,0397,260,580,840,32,872,1595,54.67%,16.3%,1
高雄市,梓官區,0398,128,327,455,46,501,829,60.43%,15.44%,1
高雄市,梓官區,0399,214,585,799,27,826,1532,53.92%,13.97%,1
高雄市,梓官區,0400,206,532,738,45,783,1195,65.52%,17.24%,1
高雄市,梓官區,0401,166,450,616,79,695,1143,60.8%,14.52%,1
高雄市,梓官區,0402,193,495,688,48,736,1186,62.06%,16.27%,1
高雄市,梓官區,0403,239,561,800,38,838,1732,48.38%,13.8%,1
高雄市,旗山區,0060,196,393,589,49,638,1060,60.19%,18.49%,1
高雄市,旗山區,0061,160,390,550,41,591,1125,52.53%,14.22%,1
高雄市,旗山區,0062,198,436,634,38,672,1100,61.09%,18%,1
高雄市,旗山區,0063,238,486,724,26,750,1238,60.58%,19.22%,1
高雄市,旗山區,0064,163,368,531,22,553,933,59.27%,17.47%,1
高雄市,旗山區,0065,125,236,361,15,376,727,51.72%,17.19%,1
高雄市,旗山區,0066,180,375,555,51,606,1071,56.58%,16.81%,1
高雄市,旗山區,0067,130,231,361,30,391,744,52.55%,17.47%,1
高雄市,旗山區,0068,156,353,509,29,538,1100,48.91%,14.18%,1
高雄市,旗山區,0069,49,126,175,20,195,369,52.85%,13.28%,1
高雄市,旗山區,0070,105,283,388,11,399,888,44.93%,11.82%,1
高雄市,旗山區,0071,70,140,210,10,220,510,43.14%,13.73%,1
高雄市,旗山區,0072,167,394,561,89,650,1042,62.38%,16.03%,1
高雄市,旗山區,0073,103,284,387,45,432,791,54.61%,13.02%,1
高雄市,旗山區,0074,163,335,498,69,567,939,60.38%,17.36%,1
高雄市,旗山區,0075,200,375,575,50,625,1218,51.31%,16.42%,1
高雄市,旗山區,0076,21,57,78,20,98,178,55.06%,11.8%,1
高雄市,旗山區,0077,167,377,544,47,591,946,62.47%,17.65%,1
高雄市,旗山區,0078,185,345,530,40,570,1025,55.61%,18.05%,1
高雄市,旗山區,0079,479,98,577,123,700,1040,67.31%,46.06%,1
高雄市,旗山區,0080,188,338,526,50,576,900,64%,20.89%,1
高雄市,旗山區,0081,114,212,326,22,348,663,52.49%,17.19%,1
高雄市,旗山區,0082,157,335,492,48,540,954,56.6%,16.46%,1
高雄市,旗山區,0083,197,350,547,29,576,1060,54.34%,18.58%,1
高雄市,旗山區,0084,198,415,613,54,667,1110,60.09%,17.84%,1
高雄市,旗山區,0085,204,377,581,52,633,1062,59.6%,19.21%,1
高雄市,旗山區,0086,195,422,617,41,658,1151,57.17%,16.94%,1
高雄市,旗山區,0087,42,103,145,21,166,266,62.41%,15.79%,1
高雄市,旗山區,0088,115,255,370,23,393,633,62.09%,18.17%,1
高雄市,旗山區,0089,116,401,517,30,547,1307,41.85%,8.88%,1
高雄市,旗山區,0090,130,240,370,64,434,754,57.56%,17.24%,1
高雄市,旗山區,0091,215,416,631,109,740,1296,57.1%,16.59%,1
高雄市,旗山區,0092,120,246,366,19,385,839,45.89%,14.3%,1
高雄市,旗山區,0093,207,485,692,66,758,1329,57.04%,15.58%,1
高雄市,旗山區,0094,201,142,343,30,373,628,59.39%,32.01%,1
高雄市,美濃區,0095,186,429,615,79,694,1175,59.06%,15.83%,1
高雄市,美濃區,0096,189,496,685,29,714,1438,49.65%,13.14%,1
高雄市,美濃區,0097,116,354,470,42,512,989,51.77%,11.73%,1
高雄市,美濃區,0098,211,566,777,62,839,1427,58.79%,14.79%,1
高雄市,美濃區,0099,195,483,678,56,734,1309,56.07%,14.9%,1
高雄市,美濃區,0100,192,517,709,63,772,1263,61.12%,15.2%,1
高雄市,美濃區,0101,146,411,557,51,608,997,60.98%,14.64%,1
高雄市,美濃區,0102,157,390,547,67,614,1064,57.71%,14.76%,1
高雄市,美濃區,0103,211,558,769,65,834,1498,55.67%,14.09%,1
高雄市,美濃區,0104,145,436,581,76,657,1119,58.71%,12.96%,1
高雄市,美濃區,0105,128,409,537,65,602,1031,58.39%,12.42%,1
高雄市,美濃區,0106,179,512,691,72,763,1437,53.1%,12.46%,1
高雄市,美濃區,0107,174,391,565,43,608,1071,56.77%,16.25%,1
高雄市,美濃區,0108,73,278,351,35,386,687,56.19%,10.63%,1
高雄市,美濃區,0109,77,239,316,25,341,775,44%,9.94%,1
高雄市,美濃區,0110,182,442,624,75,699,1353,51.66%,13.45%,1
高雄市,美濃區,0111,172,372,544,48,592,1191,49.71%,14.44%,1
高雄市,美濃區,0112,114,289,403,41,444,906,49.01%,12.58%,1
高雄市,美濃區,0113,176,475,651,46,697,1178,59.17%,14.94%,1
高雄市,美濃區,0114,168,416,584,31,615,1252,49.12%,13.42%,1
高雄市,美濃區,0115,229,597,826,49,875,1549,56.49%,14.78%,1
高雄市,美濃區,0116,124,398,522,47,569,1088,52.3%,11.4%,1
高雄市,美濃區,0117,170,433,603,32,635,1116,56.9%,15.23%,1
高雄市,美濃區,0118,164,326,490,37,527,977,53.94%,16.79%,1
高雄市,美濃區,0119,148,309,457,55,512,816,62.75%,18.14%,1
高雄市,美濃區,0120,105,317,422,26,448,955,46.91%,10.99%,1
高雄市,美濃區,0121,142,350,492,59,551,943,58.43%,15.06%,1
高雄市,美濃區,0122,180,506,686,39,725,1371,52.88%,13.13%,1
高雄市,美濃區,0123,136,322,458,54,512,919,55.71%,14.8%,1
高雄市,美濃區,0124,141,377,518,46,564,915,61.64%,15.41%,1
高雄市,美濃區,0125,116,271,387,70,457,828,55.19%,14.01%,1
高雄市,美濃區,0126,76,189,265,56,321,674,47.63%,11.28%,1
高雄市,六龜區,0020,123,231,354,23,377,760,49.61%,16.18%,1
高雄市,六龜區,0021,79,190,269,38,307,666,46.1%,11.86%,1
高雄市,六龜區,0022,118,235,353,51,404,704,57.39%,16.76%,1
高雄市,六龜區,0023,138,314,452,58,510,1003,50.85%,13.76%,1
高雄市,六龜區,0024,145,414,559,108,667,1382,48.26%,10.49%,1
高雄市,六龜區,0025,111,244,355,63,418,986,42.39%,11.26%,1
高雄市,六龜區,0026,153,330,483,47,530,1046,50.67%,14.63%,1
高雄市,六龜區,0027,109,219,328,51,379,812,46.67%,13.42%,1
高雄市,六龜區,0028,171,429,600,64,664,1431,46.4%,11.95%,1
高雄市,六龜區,0029,91,320,411,69,480,912,52.63%,9.98%,1
高雄市,六龜區,0030,180,368,548,52,600,1472,40.76%,12.23%,1
高雄市,六龜區,0031,33,92,125,18,143,327,43.73%,10.09%,1
高雄市,甲仙區,0013,37,132,169,7,176,472,37.29%,7.84%,1
高雄市,甲仙區,0014,136,360,496,58,554,882,62.81%,15.42%,1
高雄市,甲仙區,0015,98,227,325,31,356,668,53.29%,14.67%,1
高雄市,甲仙區,0016,211,478,689,106,795,1581,50.28%,13.35%,1
高雄市,甲仙區,0017,65,161,226,15,241,673,35.81%,9.66%,1
高雄市,甲仙區,0018,69,183,252,41,293,607,48.27%,11.37%,1
高雄市,甲仙區,0019,90,161,251,21,272,534,50.94%,16.85%,1
高雄市,杉林區,0032,64,191,255,63,318,640,49.69%,10%,1
高雄市,杉林區,0033,63,225,288,27,315,696,45.26%,9.05%,1
高雄市,杉林區,0034,119,318,437,47,484,1284,37.69%,9.27%,1
高雄市,杉林區,0035,112,295,407,37,444,1027,43.23%,10.91%,1
高雄市,杉林區,0036,55,83,138,27,165,482,34.23%,11.41%,1
高雄市,杉林區,0037,237,562,799,112,911,1627,55.99%,14.57%,1
高雄市,杉林區,0038,183,511,694,31,725,1630,44.48%,11.23%,1
高雄市,杉林區,0039,110,231,341,21,362,973,37.2%,11.31%,1
高雄市,杉林區,0040,105,280,385,19,404,987,40.93%,10.64%,1
高雄市,杉林區,0041,389,202,591,76,667,1261,52.89%,30.85%,1
高雄市,內門區,0042,91,312,403,56,459,969,47.37%,9.39%,1
高雄市,內門區,0043,89,158,247,18,265,652,40.64%,13.65%,1
高雄市,內門區,0044,135,301,436,74,510,961,53.07%,14.05%,1
高雄市,內門區,0045,37,131,168,9,177,426,41.55%,8.69%,1
高雄市,內門區,0046,42,125,167,18,185,398,46.48%,10.55%,1
高雄市,內門區,0047,69,145,214,17,231,508,45.47%,13.58%,1
高雄市,內門區,0048,148,371,519,54,573,980,58.47%,15.1%,1
高雄市,內門區,0049,151,347,498,39,537,1225,43.84%,12.33%,1
高雄市,內門區,0050,279,532,811,144,955,1722,55.46%,16.2%,1
高雄市,內門區,0051,86,163,249,26,275,560,49.11%,15.36%,1
高雄市,內門區,0052,99,223,322,23,345,801,43.07%,12.36%,1
高雄市,內門區,0053,58,143,201,15,216,423,51.06%,13.71%,1
高雄市,內門區,0054,73,136,209,27,236,497,47.48%,14.69%,1
高雄市,內門區,0055,84,220,304,25,329,677,48.6%,12.41%,1
高雄市,內門區,0056,46,164,210,15,225,593,37.94%,7.76%,1
高雄市,內門區,0057,71,158,229,42,271,597,45.39%,11.89%,1
高雄市,內門區,0058,35,104,139,10,149,343,43.44%,10.2%,1
高雄市,內門區,0059,102,232,334,33,367,670,54.78%,15.22%,1
高雄市,茂林區,0127,76,259,335,21,356,507,70.22%,14.99%,1
高雄市,茂林區,0128,70,184,254,14,268,382,70.16%,18.32%,1
高雄市,茂林區,0129,100,369,469,17,486,726,66.94%,13.77%,1
高雄市,桃源區,0001,41,73,114,2,116,264,43.94%,15.53%,1
高雄市,桃源區,0002,26,133,159,13,172,233,73.82%,11.16%,1
高雄市,桃源區,0003,25,161,186,7,193,279,69.18%,8.96%,1
高雄市,桃源區,0004,19,94,113,5,118,223,52.91%,8.52%,1
高雄市,桃源區,0005,76,285,361,13,374,783,47.77%,9.71%,1
高雄市,桃源區,0006,64,218,282,7,289,632,45.73%,10.13%,1
高雄市,桃源區,0007,65,323,388,28,416,612,67.97%,10.62%,1
高雄市,桃源區,0008,69,163,232,25,257,472,54.45%,14.62%,1
高雄市,那瑪夏區,0009,94,273,367,31,398,741,53.71%,12.69%,1
高雄市,那瑪夏區,0010,92,276,368,54,422,585,72.14%,15.73%,1
高雄市,那瑪夏區,0011,65,377,442,30,472,609,77.5%,10.67%,1
高雄市,那瑪夏區,0012,32,258,290,7,297,489,60.74%,6.54%,1
新竹縣,竹北市,0001,286,543,829,23,852,1319,64.59%,21.68%,1
新竹縣,竹北市,0002,278,514,792,13,805,1321,60.94%,21.04%,1
新竹縣,竹北市,0003,262,514,776,25,801,1272,62.97%,20.6%,1
新竹縣,竹北市,0004,293,542,835,16,851,1467,58.01%,19.97%,1
新竹縣,竹北市,0005,268,426,694,19,713,1226,58.16%,21.86%,1
新竹縣,竹北市,0006,281,516,797,10,807,1412,57.15%,19.9%,1
新竹縣,竹北市,0007,348,532,880,10,890,1400,63.57%,24.86%,1
新竹縣,竹北市,0008,356,498,854,25,879,1415,62.12%,25.16%,1
新竹縣,竹北市,0009,314,475,789,14,803,1361,59%,23.07%,1
新竹縣,竹北市,0010,381,441,822,13,835,1515,55.12%,25.15%,1
新竹縣,竹北市,0011,519,337,856,38,894,1495,59.8%,34.72%,1
新竹縣,竹北市,0012,325,487,812,30,842,1417,59.42%,22.94%,1
新竹縣,竹北市,0013,407,470,877,12,889,1548,57.43%,26.29%,1
新竹縣,竹北市,0014,370,396,766,13,779,1434,54.32%,25.8%,1
新竹縣,竹北市,0015,289,500,789,27,816,1385,58.92%,20.87%,1
新竹縣,竹北市,0016,275,495,770,26,796,1247,63.83%,22.05%,1
新竹縣,竹北市,0017,303,470,773,22,795,1373,57.9%,22.07%,1
新竹縣,竹北市,0018,364,486,850,9,859,1345,63.87%,27.06%,1
新竹縣,竹北市,0019,212,435,647,26,673,1165,57.77%,18.2%,1
新竹縣,竹北市,0020,302,426,728,26,754,1164,64.78%,25.95%,1
新竹縣,竹北市,0021,285,446,731,25,756,1212,62.38%,23.51%,1
新竹縣,竹北市,0022,195,548,743,19,762,1507,50.56%,12.94%,1
新竹縣,竹北市,0023,216,589,805,32,837,1576,53.11%,13.71%,1
新竹縣,竹北市,0024,303,504,807,25,832,1464,56.83%,20.7%,1
新竹縣,竹北市,0025,325,469,794,24,818,1428,57.28%,22.76%,1
新竹縣,竹北市,0026,372,343,715,16,731,1442,50.69%,25.8%,1
新竹縣,竹北市,0027,287,509,796,47,843,1415,59.58%,20.28%,1
新竹縣,竹北市,0028,349,492,841,17,858,1666,51.5%,20.95%,1
新竹縣,竹北市,0029,398,526,924,19,943,1751,53.85%,22.73%,1
新竹縣,竹北市,0030,254,471,725,17,742,1196,62.04%,21.24%,1
新竹縣,竹北市,0031,241,482,723,20,743,1235,60.16%,19.51%,1
新竹縣,竹北市,0032,247,427,674,14,688,1204,57.14%,20.51%,1
新竹縣,竹北市,0033,261,520,781,21,802,1308,61.31%,19.95%,1
新竹縣,竹北市,0034,267,437,704,14,718,1233,58.23%,21.65%,1
新竹縣,竹北市,0035,216,444,660,13,673,1129,59.61%,19.13%,1
新竹縣,竹北市,0036,232,418,650,11,661,1069,61.83%,21.7%,1
新竹縣,竹北市,0037,235,446,681,29,710,1114,63.73%,21.1%,1
新竹縣,竹北市,0038,243,423,666,27,693,1103,62.83%,22.03%,1
新竹縣,竹北市,0039,252,401,653,16,669,1029,65.01%,24.49%,1
新竹縣,竹北市,0040,272,439,711,18,729,1133,64.34%,24.01%,1
新竹縣,竹北市,0041,266,477,743,14,757,1301,58.19%,20.45%,1
新竹縣,竹北市,0042,417,611,1028,18,1046,1798,58.18%,23.19%,1
新竹縣,竹北市,0043,403,426,829,22,851,1427,59.64%,28.24%,1
新竹縣,竹北市,0044,286,595,881,25,906,1462,61.97%,19.56%,1
新竹縣,竹北市,0045,294,543,837,16,853,1342,63.56%,21.91%,1
新竹縣,竹北市,0046,308,578,886,15,901,1480,60.88%,20.81%,1
新竹縣,竹北市,0047,333,579,912,18,930,1645,56.53%,20.24%,1
新竹縣,竹北市,0048,276,510,786,20,806,1256,64.17%,21.97%,1
新竹縣,竹北市,0049,267,438,705,18,723,1181,61.22%,22.61%,1
新竹縣,竹北市,0050,292,544,836,28,864,1329,65.01%,21.97%,1
新竹縣,竹北市,0051,232,539,771,25,796,1228,64.82%,18.89%,1
新竹縣,竹北市,0052,324,520,844,32,876,1552,56.44%,20.88%,1
新竹縣,竹北市,0053,291,578,869,24,893,1480,60.34%,19.66%,1
新竹縣,竹北市,0054,283,520,803,15,818,1487,55.01%,19.03%,1
新竹縣,竹北市,0055,373,403,776,33,809,1470,55.03%,25.37%,1
新竹縣,竹北市,0056,236,525,761,27,788,1477,53.35%,15.98%,1
新竹縣,竹北市,0057,340,600,940,33,973,1611,60.4%,21.1%,1
新竹縣,竹北市,0058,289,573,862,46,908,1555,58.39%,18.59%,1
新竹縣,竹北市,0059,257,510,767,35,802,1468,54.63%,17.51%,1
新竹縣,竹北市,0060,279,592,871,29,900,1509,59.64%,18.49%,1
新竹縣,竹北市,0061,268,593,861,29,890,1602,55.56%,16.73%,1
新竹縣,竹北市,0062,256,527,783,35,818,1448,56.49%,17.68%,1
新竹縣,竹北市,0063,253,514,767,31,798,1318,60.55%,19.2%,1
新竹縣,竹北市,0064,341,625,966,36,1002,1634,61.32%,20.87%,1
新竹縣,竹北市,0065,213,496,709,60,769,1345,57.17%,15.84%,1
新竹縣,竹北市,0066,100,486,586,22,608,958,63.47%,10.44%,1
新竹縣,竹北市,0067,233,446,679,26,705,1112,63.4%,20.95%,1
新竹縣,竹北市,0068,194,439,633,38,671,1134,59.17%,17.11%,1
新竹縣,竹北市,0069,271,555,826,35,861,1483,58.06%,18.27%,1
新竹縣,竹北市,0070,237,474,711,39,750,1332,56.31%,17.79%,1
新竹縣,竹北市,0071,237,502,739,28,767,1482,51.75%,15.99%,1
新竹縣,竹北市,0072,210,392,602,18,620,1449,42.79%,14.49%,1
新竹縣,竹北市,0073,219,484,703,17,720,1319,54.59%,16.6%,1
新竹縣,竹北市,0074,212,484,696,33,729,1332,54.73%,15.92%,1
新竹縣,竹北市,0075,266,452,718,31,749,1412,53.05%,18.84%,1
新竹縣,竹北市,0076,313,530,843,39,882,1640,53.78%,19.09%,1
新竹縣,竹北市,0077,237,491,728,30,758,1323,57.29%,17.91%,1
新竹縣,竹北市,0078,283,520,803,48,851,1428,59.59%,19.82%,1
新竹縣,竹北市,0079,280,576,856,41,897,1533,58.51%,18.26%,1
新竹縣,竹北市,0080,257,444,701,22,723,1346,53.71%,19.09%,1
新竹縣,竹北市,0081,180,453,633,36,669,1219,54.88%,14.77%,1
新竹縣,竹北市,0082,275,570,845,51,896,1466,61.12%,18.76%,1
新竹縣,竹北市,0083,244,354,598,34,632,1147,55.1%,21.27%,1
新竹縣,竹北市,0084,259,482,741,35,776,1529,50.75%,16.94%,1
新竹縣,竹北市,0085,268,576,844,35,879,1522,57.75%,17.61%,1
新竹縣,竹北市,0086,245,545,790,41,831,1383,60.09%,17.72%,1
新竹縣,竹北市,0087,287,581,868,42,910,1569,58%,18.29%,1
新竹縣,竹北市,0088,250,535,785,23,808,1506,53.65%,16.6%,1
新竹縣,竹北市,0089,135,351,486,21,507,877,57.81%,15.39%,1
新竹縣,竹北市,0090,209,379,588,39,627,1074,58.38%,19.46%,1
新竹縣,竹北市,0091,227,455,682,23,705,1089,64.74%,20.84%,1
新竹縣,竹北市,0092,248,496,744,49,793,1336,59.36%,18.56%,1
新竹縣,竹北市,0093,188,383,571,32,603,1058,56.99%,17.77%,1
新竹縣,竹北市,0094,301,285,586,42,628,937,67.02%,32.12%,1
新竹縣,竹北市,0095,209,436,645,44,689,1206,57.13%,17.33%,1
新竹縣,竹北市,0096,213,441,654,47,701,1205,58.17%,17.68%,1
新竹縣,竹北市,0097,336,628,964,65,1029,1718,59.9%,19.56%,1
新竹縣,竹北市,0098,148,341,489,37,526,917,57.36%,16.14%,1
新竹縣,竹北市,0099,144,240,384,20,404,668,60.48%,21.56%,1
新竹縣,竹北市,0100,143,279,422,39,461,824,55.95%,17.35%,1
新竹縣,竹北市,0101,146,259,405,60,465,782,59.46%,18.67%,1
新竹縣,竹北市,0102,155,378,533,67,600,977,61.41%,15.86%,1
新竹縣,竹北市,0103,317,140,457,20,477,937,50.91%,33.83%,1
新竹縣,竹東鎮,0104,29,114,143,13,156,309,50.49%,9.39%,1
新竹縣,竹東鎮,0105,61,127,188,26,214,416,51.44%,14.66%,1
新竹縣,竹東鎮,0106,53,138,191,7,198,386,51.3%,13.73%,1
新竹縣,竹東鎮,0107,128,326,454,25,479,950,50.42%,13.47%,1
新竹縣,竹東鎮,0108,191,467,658,18,676,1275,53.02%,14.98%,1
新竹縣,竹東鎮,0109,163,463,626,31,657,1213,54.16%,13.44%,1
新竹縣,竹東鎮,0110,257,582,839,32,871,1548,56.27%,16.6%,1
新竹縣,竹東鎮,0111,181,417,598,26,624,1246,50.08%,14.53%,1
新竹縣,竹東鎮,0112,163,385,548,27,575,1252,45.93%,13.02%,1
新竹縣,竹東鎮,0113,168,513,681,39,720,1359,52.98%,12.36%,1
新竹縣,竹東鎮,0114,186,456,642,35,677,1255,53.94%,14.82%,1
新竹縣,竹東鎮,0115,209,500,709,41,750,1304,57.52%,16.03%,1
新竹縣,竹東鎮,0116,214,467,681,39,720,1292,55.73%,16.56%,1
新竹縣,竹東鎮,0117,140,407,547,21,568,1111,51.13%,12.6%,1
新竹縣,竹東鎮,0118,144,341,485,41,526,880,59.77%,16.36%,1
新竹縣,竹東鎮,0119,120,257,377,17,394,670,58.81%,17.91%,1
新竹縣,竹東鎮,0120,196,498,694,32,726,1244,58.36%,15.76%,1
新竹縣,竹東鎮,0121,164,409,573,38,611,1126,54.26%,14.56%,1
新竹縣,竹東鎮,0122,158,393,551,40,591,1073,55.08%,14.73%,1
新竹縣,竹東鎮,0123,199,465,664,30,694,1215,57.12%,16.38%,1
新竹縣,竹東鎮,0124,190,458,648,13,661,1155,57.23%,16.45%,1
新竹縣,竹東鎮,0125,144,309,453,34,487,852,57.16%,16.9%,1
新竹縣,竹東鎮,0126,150,355,505,21,526,875,60.11%,17.14%,1
新竹縣,竹東鎮,0127,188,437,625,27,652,1070,60.93%,17.57%,1
新竹縣,竹東鎮,0128,118,249,367,22,389,704,55.26%,16.76%,1
新竹縣,竹東鎮,0129,99,264,363,19,382,951,40.17%,10.41%,1
新竹縣,竹東鎮,0130,188,356,544,19,563,984,57.22%,19.11%,1
新竹縣,竹東鎮,0131,138,344,482,8,490,1113,44.03%,12.4%,1
新竹縣,竹東鎮,0132,90,246,336,21,357,595,60%,15.13%,1
新竹縣,竹東鎮,0133,127,303,430,38,468,762,61.42%,16.67%,1
新竹縣,竹東鎮,0134,142,268,410,20,430,763,56.36%,18.61%,1
新竹縣,竹東鎮,0135,134,267,401,18,419,813,51.54%,16.48%,1
新竹縣,竹東鎮,0136,166,449,615,29,644,1310,49.16%,12.67%,1
新竹縣,竹東鎮,0137,191,476,667,38,705,1434,49.16%,13.32%,1
新竹縣,竹東鎮,0138,204,413,617,21,638,1131,56.41%,18.04%,1
新竹縣,竹東鎮,0139,163,352,515,16,531,967,54.91%,16.86%,1
新竹縣,竹東鎮,0140,176,411,587,25,612,1196,51.17%,14.72%,1
新竹縣,竹東鎮,0141,194,433,627,29,656,1154,56.85%,16.81%,1
新竹縣,竹東鎮,0142,117,284,401,38,439,715,61.4%,16.36%,1
新竹縣,竹東鎮,0143,118,268,386,15,401,685,58.54%,17.23%,1
新竹縣,竹東鎮,0144,210,470,680,39,719,1352,53.18%,15.53%,1
新竹縣,竹東鎮,0145,218,546,764,42,806,1407,57.29%,15.49%,1
新竹縣,竹東鎮,0146,220,501,721,26,747,1362,54.85%,16.15%,1
新竹縣,竹東鎮,0147,212,530,742,23,765,1330,57.52%,15.94%,1
新竹縣,竹東鎮,0148,214,523,737,45,782,1441,54.27%,14.85%,1
新竹縣,竹東鎮,0149,213,409,622,17,639,1248,51.2%,17.07%,1
新竹縣,竹東鎮,0150,203,361,564,15,579,1263,45.84%,16.07%,1
新竹縣,竹東鎮,0151,162,423,585,31,616,1232,50%,13.15%,1
新竹縣,竹東鎮,0152,158,363,521,23,544,1143,47.59%,13.82%,1
新竹縣,竹東鎮,0153,262,555,817,19,836,1529,54.68%,17.14%,1
新竹縣,竹東鎮,0154,184,410,594,34,628,1140,55.09%,16.14%,1
新竹縣,竹東鎮,0155,99,234,333,33,366,570,64.21%,17.37%,1
新竹縣,竹東鎮,0156,218,421,639,21,660,1345,49.07%,16.21%,1
新竹縣,竹東鎮,0157,258,428,686,49,735,1381,53.22%,18.68%,1
新竹縣,竹東鎮,0158,256,464,720,43,763,1379,55.33%,18.56%,1
新竹縣,竹東鎮,0159,160,406,566,37,603,1033,58.37%,15.49%,1
新竹縣,竹東鎮,0160,176,381,557,26,583,1066,54.69%,16.51%,1
新竹縣,竹東鎮,0161,142,373,515,40,555,938,59.17%,15.14%,1
新竹縣,竹東鎮,0162,167,378,545,42,587,952,61.66%,17.54%,1
新竹縣,竹東鎮,0163,292,554,846,36,882,1468,60.08%,19.89%,1
新竹縣,竹東鎮,0164,445,515,960,21,981,1915,51.23%,23.24%,1
新竹縣,竹東鎮,0165,191,414,605,34,639,1220,52.38%,15.66%,1
新竹縣,竹東鎮,0166,160,356,516,16,532,1166,45.63%,13.72%,1
新竹縣,竹東鎮,0167,229,488,717,16,733,1492,49.13%,15.35%,1
新竹縣,竹東鎮,0168,204,435,639,21,660,1245,53.01%,16.39%,1
新竹縣,竹東鎮,0169,195,399,594,30,624,1083,57.62%,18.01%,1
新竹縣,竹東鎮,0170,207,371,578,30,608,1102,55.17%,18.78%,1
新竹縣,竹東鎮,0171,179,400,579,21,600,1068,56.18%,16.76%,1
新竹縣,竹東鎮,0172,185,424,609,15,624,1097,56.88%,16.86%,1
新竹縣,竹東鎮,0173,142,352,494,18,512,962,53.22%,14.76%,1
新竹縣,竹東鎮,0174,159,339,498,25,523,909,57.54%,17.49%,1
新竹縣,竹東鎮,0175,82,203,285,18,303,603,50.25%,13.6%,1
新竹縣,新埔鎮,0176,155,402,557,30,587,983,59.72%,15.77%,1
新竹縣,新埔鎮,0177,134,214,348,20,368,597,61.64%,22.45%,1
新竹縣,新埔鎮,0178,177,410,587,19,606,1070,56.64%,16.54%,1
新竹縣,新埔鎮,0179,127,368,495,29,524,935,56.04%,13.58%,1
新竹縣,新埔鎮,0180,113,302,415,20,435,753,57.77%,15.01%,1
新竹縣,新埔鎮,0181,151,374,525,26,551,838,65.75%,18.02%,1
新竹縣,新埔鎮,0182,148,363,511,26,537,924,58.12%,16.02%,1
新竹縣,新埔鎮,0183,135,299,434,25,459,905,50.72%,14.92%,1
新竹縣,新埔鎮,0184,108,401,509,29,538,948,56.75%,11.39%,1
新竹縣,新埔鎮,0185,158,395,553,42,595,1017,58.51%,15.54%,1
新竹縣,新埔鎮,0186,215,475,690,28,718,1176,61.05%,18.28%,1
新竹縣,新埔鎮,0187,212,447,659,40,699,1122,62.3%,18.89%,1
新竹縣,新埔鎮,0188,152,316,468,11,479,1022,46.87%,14.87%,1
新竹縣,新埔鎮,0189,203,477,680,37,717,1429,50.17%,14.21%,1
新竹縣,新埔鎮,0190,73,197,270,34,304,451,67.41%,16.19%,1
新竹縣,新埔鎮,0191,130,256,386,24,410,724,56.63%,17.96%,1
新竹縣,新埔鎮,0192,97,264,361,33,394,617,63.86%,15.72%,1
新竹縣,新埔鎮,0193,204,422,626,53,679,1144,59.35%,17.83%,1
新竹縣,新埔鎮,0194,182,443,625,34,659,1139,57.86%,15.98%,1
新竹縣,新埔鎮,0195,116,367,483,11,494,861,57.38%,13.47%,1
新竹縣,新埔鎮,0196,162,379,541,23,564,1093,51.6%,14.82%,1
新竹縣,新埔鎮,0197,144,336,480,31,511,978,52.25%,14.72%,1
新竹縣,新埔鎮,0198,151,339,490,23,513,1040,49.33%,14.52%,1
新竹縣,新埔鎮,0199,185,405,590,31,621,1160,53.53%,15.95%,1
新竹縣,新埔鎮,0200,188,359,547,29,576,950,60.63%,19.79%,1
新竹縣,新埔鎮,0201,127,348,475,26,501,882,56.8%,14.4%,1
新竹縣,新埔鎮,0202,232,462,694,47,741,1281,57.85%,18.11%,1
新竹縣,新埔鎮,0203,198,412,610,40,650,1212,53.63%,16.34%,1
新竹縣,新埔鎮,0204,114,334,448,37,485,1013,47.88%,11.25%,1
新竹縣,新埔鎮,0205,120,251,371,31,402,630,63.81%,19.05%,1
新竹縣,關西鎮,0206,70,220,290,19,309,480,64.38%,14.58%,1
新竹縣,關西鎮,0207,167,350,517,23,540,903,59.8%,18.49%,1
新竹縣,關西鎮,0208,167,389,556,38,594,1020,58.24%,16.37%,1
新竹縣,關西鎮,0209,118,273,391,15,406,705,57.59%,16.74%,1
新竹縣,關西鎮,0210,151,399,550,30,580,1056,54.92%,14.3%,1
新竹縣,關西鎮,0211,177,489,666,36,702,1275,55.06%,13.88%,1
新竹縣,關西鎮,0212,205,512,717,39,756,1287,58.74%,15.93%,1
新竹縣,關西鎮,0213,130,301,431,35,466,771,60.44%,16.86%,1
新竹縣,關西鎮,0214,176,361,537,36,573,1046,54.78%,16.83%,1
新竹縣,關西鎮,0215,142,417,559,44,603,1030,58.54%,13.79%,1
新竹縣,關西鎮,0216,208,451,659,31,690,1208,57.12%,17.22%,1
新竹縣,關西鎮,0217,151,367,518,15,533,1095,48.68%,13.79%,1
新竹縣,關西鎮,0218,197,440,637,74,711,1350,52.67%,14.59%,1
新竹縣,關西鎮,0219,152,359,511,25,536,846,63.36%,17.97%,1
新竹縣,關西鎮,0220,201,500,701,47,748,1362,54.92%,14.76%,1
新竹縣,關西鎮,0221,105,318,423,27,450,903,49.83%,11.63%,1
新竹縣,關西鎮,0222,72,174,246,23,269,551,48.82%,13.07%,1
新竹縣,關西鎮,0223,54,122,176,15,191,461,41.43%,11.71%,1
新竹縣,關西鎮,0224,80,210,290,29,319,572,55.77%,13.99%,1
新竹縣,關西鎮,0225,99,382,481,25,506,943,53.66%,10.5%,1
新竹縣,關西鎮,0226,135,294,429,42,471,808,58.29%,16.71%,1
新竹縣,關西鎮,0227,153,398,551,31,582,923,63.06%,16.58%,1
新竹縣,關西鎮,0228,144,370,514,22,536,903,59.36%,15.95%,1
新竹縣,關西鎮,0229,129,396,525,41,566,977,57.93%,13.2%,1
新竹縣,關西鎮,0230,129,353,482,30,512,824,62.14%,15.66%,1
新竹縣,關西鎮,0231,92,254,346,14,360,559,64.4%,16.46%,1
新竹縣,關西鎮,0232,155,351,506,28,534,854,62.53%,18.15%,1
新竹縣,湖口鄉,0233,213,479,692,33,725,1393,52.05%,15.29%,1
新竹縣,湖口鄉,0234,249,584,833,41,874,1505,58.07%,16.54%,1
新竹縣,湖口鄉,0235,217,516,733,30,763,1188,64.23%,18.27%,1
新竹縣,湖口鄉,0236,166,531,697,32,729,1267,57.54%,13.1%,1
新竹縣,湖口鄉,0237,236,685,921,31,952,1668,57.07%,14.15%,1
新竹縣,湖口鄉,0238,310,638,948,50,998,1719,58.06%,18.03%,1
新竹縣,湖口鄉,0239,191,497,688,35,723,1162,62.22%,16.44%,1
新竹縣,湖口鄉,0240,240,654,894,46,940,1833,51.28%,13.09%,1
新竹縣,湖口鄉,0241,264,514,778,44,822,1444,56.93%,18.28%,1
新竹縣,湖口鄉,0242,224,575,799,45,844,1347,62.66%,16.63%,1
新竹縣,湖口鄉,0243,202,488,690,26,716,1202,59.57%,16.81%,1
新竹縣,湖口鄉,0244,143,341,484,32,516,851,60.63%,16.8%,1
新竹縣,湖口鄉,0245,240,493,733,37,770,1272,60.53%,18.87%,1
新竹縣,湖口鄉,0246,180,518,698,39,737,1275,57.8%,14.12%,1
新竹縣,湖口鄉,0247,265,650,915,53,968,1560,62.05%,16.99%,1
新竹縣,湖口鄉,0248,199,478,677,58,735,1147,64.08%,17.35%,1
新竹縣,湖口鄉,0249,254,687,941,32,973,1729,56.28%,14.69%,1
新竹縣,湖口鄉,0250,234,499,733,32,765,1402,54.56%,16.69%,1
新竹縣,湖口鄉,0251,191,474,665,39,704,1183,59.51%,16.15%,1
新竹縣,湖口鄉,0252,223,524,747,31,778,1282,60.69%,17.39%,1
新竹縣,湖口鄉,0253,232,537,769,35,804,1335,60.22%,17.38%,1
新竹縣,湖口鄉,0254,293,602,895,38,933,1493,62.49%,19.62%,1
新竹縣,湖口鄉,0255,289,708,997,19,1016,1877,54.13%,15.4%,1
新竹縣,湖口鄉,0256,162,472,634,37,671,1082,62.01%,14.97%,1
新竹縣,湖口鄉,0257,188,463,651,34,685,1115,61.43%,16.86%,1
新竹縣,湖口鄉,0258,179,395,574,39,613,1193,51.38%,15%,1
新竹縣,湖口鄉,0259,267,737,1004,38,1042,1947,53.52%,13.71%,1
新竹縣,湖口鄉,0260,194,429,623,59,682,1125,60.62%,17.24%,1
新竹縣,湖口鄉,0261,157,416,573,38,611,1050,58.19%,14.95%,1
新竹縣,湖口鄉,0262,297,666,963,39,1002,1733,57.82%,17.14%,1
新竹縣,湖口鄉,0263,231,498,729,31,760,1284,59.19%,17.99%,1
新竹縣,湖口鄉,0264,171,433,604,29,633,1062,59.6%,16.1%,1
新竹縣,湖口鄉,0265,214,615,829,56,885,1547,57.21%,13.83%,1
新竹縣,湖口鄉,0266,201,517,718,26,744,1494,49.8%,13.45%,1
新竹縣,湖口鄉,0267,540,215,755,29,784,1634,47.98%,33.05%,1
新竹縣,湖口鄉,0268,235,430,665,18,683,1444,47.3%,16.27%,1
新竹縣,湖口鄉,0269,216,471,687,15,702,1324,53.02%,16.31%,1
新竹縣,湖口鄉,0270,201,369,570,31,601,1058,56.81%,19%,1
新竹縣,湖口鄉,0271,163,347,510,17,527,1220,43.2%,13.36%,1
新竹縣,湖口鄉,0272,246,476,722,29,751,1333,56.34%,18.45%,1
新竹縣,湖口鄉,0273,198,517,715,51,766,1461,52.43%,13.55%,1
新竹縣,湖口鄉,0274,233,523,756,32,788,1429,55.14%,16.31%,1
新竹縣,湖口鄉,0275,205,481,686,26,712,1506,47.28%,13.61%,1
新竹縣,湖口鄉,0276,176,450,626,47,673,1103,61.02%,15.96%,1
新竹縣,湖口鄉,0277,213,499,712,29,741,1495,49.57%,14.25%,1
新竹縣,湖口鄉,0278,114,288,402,30,432,752,57.45%,15.16%,1
新竹縣,湖口鄉,0279,166,361,527,19,546,986,55.38%,16.84%,1
新竹縣,新豐鄉,0280,167,374,541,43,584,1080,54.07%,15.46%,1
新竹縣,新豐鄉,0281,138,308,446,22,468,887,52.76%,15.56%,1
新竹縣,新豐鄉,0282,141,355,496,40,536,954,56.18%,14.78%,1
新竹縣,新豐鄉,0283,172,368,540,35,575,1003,57.33%,17.15%,1
新竹縣,新豐鄉,0284,169,406,575,29,604,1106,54.61%,15.28%,1
新竹縣,新豐鄉,0285,205,415,620,40,660,1123,58.77%,18.25%,1
新竹縣,新豐鄉,0286,143,339,482,45,527,891,59.15%,16.05%,1
新竹縣,新豐鄉,0287,128,284,412,28,440,874,50.34%,14.65%,1
新竹縣,新豐鄉,0288,134,296,430,29,459,824,55.7%,16.26%,1
新竹縣,新豐鄉,0289,136,325,461,29,490,975,50.26%,13.95%,1
新竹縣,新豐鄉,0290,165,280,445,38,483,847,57.02%,19.48%,1
新竹縣,新豐鄉,0291,256,533,789,55,844,1477,57.14%,17.33%,1
新竹縣,新豐鄉,0292,220,393,613,52,665,1266,52.53%,17.38%,1
新竹縣,新豐鄉,0293,137,360,497,63,560,1029,54.42%,13.31%,1
新竹縣,新豐鄉,0294,141,393,534,43,577,1063,54.28%,13.26%,1
新竹縣,新豐鄉,0295,163,403,566,23,589,1055,55.83%,15.45%,1
新竹縣,新豐鄉,0296,241,548,789,20,809,1445,55.99%,16.68%,1
新竹縣,新豐鄉,0297,256,589,845,22,867,1413,61.36%,18.12%,1
新竹縣,新豐鄉,0298,186,420,606,16,622,971,64.06%,19.16%,1
新竹縣,新豐鄉,0299,189,459,648,26,674,1135,59.38%,16.65%,1
新竹縣,新豐鄉,0300,210,439,649,32,681,1269,53.66%,16.55%,1
新竹縣,新豐鄉,0301,195,481,676,34,710,1257,56.48%,15.51%,1
新竹縣,新豐鄉,0302,305,627,932,34,966,1662,58.12%,18.35%,1
新竹縣,新豐鄉,0303,113,620,733,39,772,1486,51.95%,7.6%,1
新竹縣,新豐鄉,0304,170,451,621,48,669,1067,62.7%,15.93%,1
新竹縣,新豐鄉,0305,209,544,753,34,787,1302,60.45%,16.05%,1
新竹縣,新豐鄉,0306,204,544,748,39,787,1410,55.82%,14.47%,1
新竹縣,新豐鄉,0307,199,469,668,27,695,1267,54.85%,15.71%,1
新竹縣,新豐鄉,0308,187,409,596,36,632,1258,50.24%,14.86%,1
新竹縣,新豐鄉,0309,183,409,592,19,611,1217,50.21%,15.04%,1
新竹縣,新豐鄉,0310,207,569,776,26,802,1456,55.08%,14.22%,1
新竹縣,新豐鄉,0311,177,478,655,24,679,1157,58.69%,15.3%,1
新竹縣,新豐鄉,0312,155,391,546,24,570,1089,52.34%,14.23%,1
新竹縣,新豐鄉,0313,195,456,651,10,661,1160,56.98%,16.81%,1
新竹縣,新豐鄉,0314,182,416,598,15,613,976,62.81%,18.65%,1
新竹縣,新豐鄉,0315,253,529,782,30,812,1443,56.27%,17.53%,1
新竹縣,新豐鄉,0316,204,410,614,21,635,1247,50.92%,16.36%,1
新竹縣,新豐鄉,0317,239,528,767,14,781,1411,55.35%,16.94%,1
新竹縣,新豐鄉,0318,222,481,703,35,738,1238,59.61%,17.93%,1
新竹縣,芎林鄉,0319,74,155,229,13,242,417,58.03%,17.75%,1
新竹縣,芎林鄉,0320,96,265,361,20,381,534,71.35%,17.98%,1
新竹縣,芎林鄉,0321,168,372,540,25,565,963,58.67%,17.45%,1
新竹縣,芎林鄉,0322,25,226,251,21,272,418,65.07%,5.98%,1
新竹縣,芎林鄉,0323,177,503,680,44,724,1312,55.18%,13.49%,1
新竹縣,芎林鄉,0324,200,450,650,34,684,1354,50.52%,14.77%,1
新竹縣,芎林鄉,0325,151,296,447,28,475,785,60.51%,19.24%,1
新竹縣,芎林鄉,0326,108,307,415,74,489,797,61.36%,13.55%,1
新竹縣,芎林鄉,0327,94,273,367,28,395,623,63.4%,15.09%,1
新竹縣,芎林鄉,0328,103,299,402,39,441,759,58.1%,13.57%,1
新竹縣,芎林鄉,0329,202,401,603,45,648,1272,50.94%,15.88%,1
新竹縣,芎林鄉,0330,175,464,639,34,673,1129,59.61%,15.5%,1
新竹縣,芎林鄉,0331,134,283,417,27,444,713,62.27%,18.79%,1
新竹縣,芎林鄉,0332,149,333,482,41,523,839,62.34%,17.76%,1
新竹縣,芎林鄉,0333,214,496,710,29,739,1123,65.81%,19.06%,1
新竹縣,芎林鄉,0334,188,384,572,19,591,981,60.24%,19.16%,1
新竹縣,芎林鄉,0335,235,373,608,52,660,1078,61.22%,21.8%,1
新竹縣,芎林鄉,0336,179,396,575,25,600,1094,54.84%,16.36%,1
新竹縣,芎林鄉,0337,183,426,609,47,656,1102,59.53%,16.61%,1
新竹縣,橫山鄉,0338,217,488,705,44,749,1231,60.84%,17.63%,1
新竹縣,橫山鄉,0339,168,418,586,42,628,1041,60.33%,16.14%,1
新竹縣,橫山鄉,0340,191,457,648,39,687,1132,60.69%,16.87%,1
新竹縣,橫山鄉,0341,131,351,482,36,518,859,60.3%,15.25%,1
新竹縣,橫山鄉,0342,23,81,104,13,117,204,57.35%,11.27%,1
新竹縣,橫山鄉,0343,21,69,90,10,100,222,45.05%,9.46%,1
新竹縣,橫山鄉,0344,51,137,188,30,218,338,64.5%,15.09%,1
新竹縣,橫山鄉,0345,111,360,471,21,492,916,53.71%,12.12%,1
新竹縣,橫山鄉,0346,65,162,227,13,240,573,41.88%,11.34%,1
新竹縣,橫山鄉,0347,56,122,178,11,189,275,68.73%,20.36%,1
新竹縣,橫山鄉,0348,50,161,211,20,231,463,49.89%,10.8%,1
新竹縣,橫山鄉,0349,98,291,389,49,438,690,63.48%,14.2%,1
新竹縣,橫山鄉,0350,39,98,137,12,149,288,51.74%,13.54%,1
新竹縣,橫山鄉,0351,129,284,413,28,441,685,64.38%,18.83%,1
新竹縣,橫山鄉,0352,145,364,509,28,537,868,61.87%,16.71%,1
新竹縣,橫山鄉,0353,247,664,911,56,967,1561,61.95%,15.82%,1
新竹縣,北埔鄉,0354,190,403,593,9,602,1158,51.99%,16.41%,1
新竹縣,北埔鄉,0355,236,453,689,51,740,1238,59.77%,19.06%,1
新竹縣,北埔鄉,0356,111,213,324,16,340,580,58.62%,19.14%,1
新竹縣,北埔鄉,0357,147,372,519,26,545,931,58.54%,15.79%,1
新竹縣,北埔鄉,0358,286,587,873,55,928,1653,56.14%,17.3%,1
新竹縣,北埔鄉,0359,129,324,453,32,485,845,57.4%,15.27%,1
新竹縣,北埔鄉,0360,54,147,201,14,215,384,55.99%,14.06%,1
新竹縣,北埔鄉,0361,303,123,426,10,436,763,57.14%,39.71%,1
新竹縣,北埔鄉,0362,61,105,166,17,183,333,54.95%,18.32%,1
新竹縣,北埔鄉,0363,32,120,152,8,160,295,54.24%,10.85%,1
新竹縣,寶山鄉,0364,206,403,609,53,662,1158,57.17%,17.79%,1
新竹縣,寶山鄉,0365,509,301,810,16,826,1437,57.48%,35.42%,1
新竹縣,寶山鄉,0366,266,526,792,47,839,1470,57.07%,18.1%,1
新竹縣,寶山鄉,0367,226,445,671,42,713,1170,60.94%,19.32%,1
新竹縣,寶山鄉,0368,383,679,1062,41,1103,1900,58.05%,20.16%,1
新竹縣,寶山鄉,0369,177,338,515,26,541,1056,51.23%,16.76%,1
新竹縣,寶山鄉,0370,188,502,690,62,752,1205,62.41%,15.6%,1
新竹縣,寶山鄉,0371,125,284,409,31,440,766,57.44%,16.32%,1
新竹縣,寶山鄉,0372,144,345,489,30,519,846,61.35%,17.02%,1
新竹縣,寶山鄉,0373,143,310,453,36,489,804,60.82%,17.79%,1
新竹縣,寶山鄉,0374,121,235,356,13,369,607,60.79%,19.93%,1
新竹縣,寶山鄉,0375,120,223,343,13,356,554,64.26%,21.66%,1
新竹縣,峨眉鄉,0376,139,377,516,56,572,879,65.07%,15.81%,1
新竹縣,峨眉鄉,0377,125,264,389,42,431,683,63.1%,18.3%,1
新竹縣,峨眉鄉,0378,102,232,334,33,367,604,60.76%,16.89%,1
新竹縣,峨眉鄉,0379,40,138,178,20,198,339,58.41%,11.8%,1
新竹縣,峨眉鄉,0380,21,92,113,5,118,276,42.75%,7.61%,1
新竹縣,峨眉鄉,0381,187,590,777,81,858,1406,61.02%,13.3%,1
新竹縣,峨眉鄉,0382,61,199,260,29,289,462,62.55%,13.2%,1
新竹縣,峨眉鄉,0383,67,147,214,13,227,419,54.18%,15.99%,1
新竹縣,尖石鄉,0384,52,166,218,7,225,474,47.47%,10.97%,1
新竹縣,尖石鄉,0385,50,132,182,5,187,357,52.38%,14.01%,1
新竹縣,尖石鄉,0386,19,73,92,19,111,225,49.33%,8.44%,1
新竹縣,尖石鄉,0387,37,142,179,9,188,374,50.27%,9.89%,1
新竹縣,尖石鄉,0388,66,253,319,17,336,773,43.47%,8.54%,1
新竹縣,尖石鄉,0389,37,223,260,17,277,490,56.53%,7.55%,1
新竹縣,尖石鄉,0390,42,183,225,5,230,531,43.31%,7.91%,1
新竹縣,尖石鄉,0391,53,295,348,12,360,660,54.55%,8.03%,1
新竹縣,尖石鄉,0392,64,304,368,48,416,613,67.86%,10.44%,1
新竹縣,尖石鄉,0393,72,218,290,4,294,593,49.58%,12.14%,1
新竹縣,尖石鄉,0394,41,260,301,20,321,575,55.83%,7.13%,1
新竹縣,尖石鄉,0395,8,72,80,4,84,126,66.67%,6.35%,1
新竹縣,尖石鄉,0396,40,188,228,3,231,499,46.29%,8.02%,1
新竹縣,尖石鄉,0397,78,205,283,29,312,785,39.75%,9.94%,1
新竹縣,尖石鄉,0398,51,112,163,18,181,289,62.63%,17.65%,1
新竹縣,五峰鄉,0399,70,300,370,27,397,672,59.08%,10.42%,1
新竹縣,五峰鄉,0400,70,236,306,14,320,713,44.88%,9.82%,1
新竹縣,五峰鄉,0401,52,186,238,3,241,594,40.57%,8.75%,1
新竹縣,五峰鄉,0402,90,337,427,36,463,896,51.67%,10.04%,1
新竹縣,五峰鄉,0403,74,294,368,5,373,727,51.31%,10.18%,1
新竹縣,五峰鄉,0404,31,134,165,9,174,395,44.05%,7.85%,1
苗栗縣,苗栗市,0001,189,413,602,28,630,1087,57.96%,17.39%,1
苗栗縣,苗栗市,0002,166,378,544,21,565,1018,55.5%,16.31%,1
苗栗縣,苗栗市,0003,183,447,630,16,646,1156,55.88%,15.83%,1
苗栗縣,苗栗市,0004,164,387,551,31,582,1118,52.06%,14.67%,1
苗栗縣,苗栗市,0005,189,409,598,43,641,1084,59.13%,17.44%,1
苗栗縣,苗栗市,0006,219,478,697,30,727,1203,60.43%,18.2%,1
苗栗縣,苗栗市,0007,207,531,738,40,778,1306,59.57%,15.85%,1
苗栗縣,苗栗市,0008,208,370,578,41,619,1193,51.89%,17.44%,1
苗栗縣,苗栗市,0009,177,456,633,27,660,1115,59.19%,15.87%,1
苗栗縣,苗栗市,0010,177,482,659,31,690,1119,61.66%,15.82%,1
苗栗縣,苗栗市,0011,216,445,661,36,697,1132,61.57%,19.08%,1
苗栗縣,苗栗市,0012,205,496,701,38,739,1289,57.33%,15.9%,1
苗栗縣,苗栗市,0013,241,480,721,35,756,1264,59.81%,19.07%,1
苗栗縣,苗栗市,0014,118,354,472,20,492,870,56.55%,13.56%,1
苗栗縣,苗栗市,0015,147,333,480,37,517,1008,51.29%,14.58%,1
苗栗縣,苗栗市,0016,166,384,550,23,573,1078,53.15%,15.4%,1
苗栗縣,苗栗市,0017,191,430,621,29,650,1077,60.35%,17.73%,1
苗栗縣,苗栗市,0018,143,342,485,25,510,880,57.95%,16.25%,1
苗栗縣,苗栗市,0019,137,324,461,41,502,894,56.15%,15.32%,1
苗栗縣,苗栗市,0020,77,206,283,23,306,522,58.62%,14.75%,1
苗栗縣,苗栗市,0021,274,544,818,52,870,1376,63.23%,19.91%,1
苗栗縣,苗栗市,0022,224,507,731,29,760,1391,54.64%,16.1%,1
苗栗縣,苗栗市,0023,182,427,609,39,648,1081,59.94%,16.84%,1
苗栗縣,苗栗市,0024,218,456,674,36,710,1272,55.82%,17.14%,1
苗栗縣,苗栗市,0025,190,467,657,50,707,1112,63.58%,17.09%,1
苗栗縣,苗栗市,0026,167,366,533,13,546,813,67.16%,20.54%,1
苗栗縣,苗栗市,0027,119,294,413,25,438,767,57.11%,15.51%,1
苗栗縣,苗栗市,0028,168,396,564,18,582,1010,57.62%,16.63%,1
苗栗縣,苗栗市,0029,200,453,653,15,668,1182,56.51%,16.92%,1
苗栗縣,苗栗市,0030,156,385,541,13,554,965,57.41%,16.17%,1
苗栗縣,苗栗市,0031,111,242,353,14,367,607,60.46%,18.29%,1
苗栗縣,苗栗市,0032,209,381,590,25,615,990,62.12%,21.11%,1
苗栗縣,苗栗市,0033,182,418,600,74,674,1230,54.8%,14.8%,1
苗栗縣,苗栗市,0034,232,534,766,30,796,1372,58.02%,16.91%,1
苗栗縣,苗栗市,0035,224,454,678,31,709,1213,58.45%,18.47%,1
苗栗縣,苗栗市,0036,228,467,695,30,725,1272,57%,17.92%,1
苗栗縣,苗栗市,0037,185,540,725,25,750,1221,61.43%,15.15%,1
苗栗縣,苗栗市,0038,194,414,608,42,650,1104,58.88%,17.57%,1
苗栗縣,苗栗市,0039,190,420,610,17,627,1171,53.54%,16.23%,1
苗栗縣,苗栗市,0040,210,535,745,41,786,1392,56.47%,15.09%,1
苗栗縣,苗栗市,0041,221,564,785,14,799,1356,58.92%,16.3%,1
苗栗縣,苗栗市,0042,249,511,760,52,812,1387,58.54%,17.95%,1
苗栗縣,苗栗市,0043,218,421,639,35,674,1206,55.89%,18.08%,1
苗栗縣,苗栗市,0044,176,440,616,25,641,1004,63.84%,17.53%,1
苗栗縣,苗栗市,0045,209,441,650,24,674,1202,56.07%,17.39%,1
苗栗縣,苗栗市,0046,204,411,615,26,641,1052,60.93%,19.39%,1
苗栗縣,苗栗市,0047,367,159,526,19,545,873,62.43%,42.04%,1
苗栗縣,苗栗市,0048,177,446,623,31,654,975,67.08%,18.15%,1
苗栗縣,苗栗市,0049,156,453,609,32,641,1003,63.91%,15.55%,1
苗栗縣,苗栗市,0050,190,359,549,21,570,1000,57%,19%,1
苗栗縣,苗栗市,0051,163,400,563,29,592,1047,56.54%,15.57%,1
苗栗縣,苗栗市,0052,189,411,600,30,630,1025,61.46%,18.44%,1
苗栗縣,苗栗市,0053,148,444,592,19,611,1130,54.07%,13.1%,1
苗栗縣,苗栗市,0054,207,424,631,22,653,1146,56.98%,18.06%,1
苗栗縣,苗栗市,0055,256,539,795,30,825,1432,57.61%,17.88%,1
苗栗縣,苗栗市,0056,159,515,674,35,709,1492,47.52%,10.66%,1
苗栗縣,苗栗市,0057,197,472,669,21,690,1125,61.33%,17.51%,1
苗栗縣,苗栗市,0058,214,452,666,29,695,1241,56%,17.24%,1
苗栗縣,苗栗市,0059,243,480,723,30,753,1278,58.92%,19.01%,1
苗栗縣,苗栗市,0060,209,498,707,18,725,1293,56.07%,16.16%,1
苗栗縣,苗栗市,0061,209,474,683,29,712,1342,53.06%,15.57%,1
苗栗縣,苗栗市,0062,123,319,442,37,479,857,55.89%,14.35%,1
苗栗縣,苗栗市,0063,168,447,615,33,648,1180,54.92%,14.24%,1
苗栗縣,苗栗市,0064,202,410,612,24,636,1072,59.33%,18.84%,1
苗栗縣,苗栗市,0065,358,118,476,28,504,912,55.26%,39.25%,1
苗栗縣,苗栗市,0066,103,300,403,23,426,796,53.52%,12.94%,1
苗栗縣,苗栗市,0067,156,265,421,21,442,869,50.86%,17.95%,1
苗栗縣,苑裡鎮,0183,143,343,486,38,524,873,60.02%,16.38%,1
苗栗縣,苑裡鎮,0184,233,509,742,50,792,1346,58.84%,17.31%,1
苗栗縣,苑裡鎮,0185,184,405,589,41,630,951,66.25%,19.35%,1
苗栗縣,苑裡鎮,0186,79,257,336,13,349,615,56.75%,12.85%,1
苗栗縣,苑裡鎮,0187,139,343,482,62,544,878,61.96%,15.83%,1
苗栗縣,苑裡鎮,0188,147,300,447,27,474,767,61.8%,19.17%,1
苗栗縣,苑裡鎮,0189,130,283,413,31,444,776,57.22%,16.75%,1
苗栗縣,苑裡鎮,0190,187,415,602,57,659,1231,53.53%,15.19%,1
苗栗縣,苑裡鎮,0191,202,446,648,36,684,1145,59.74%,17.64%,1
苗栗縣,苑裡鎮,0192,131,315,446,28,474,850,55.76%,15.41%,1
苗栗縣,苑裡鎮,0193,182,345,527,54,581,1052,55.23%,17.3%,1
苗栗縣,苑裡鎮,0194,177,418,595,44,639,1114,57.36%,15.89%,1
苗栗縣,苑裡鎮,0195,215,408,623,55,678,1136,59.68%,18.93%,1
苗栗縣,苑裡鎮,0196,180,458,638,39,677,1194,56.7%,15.08%,1
苗栗縣,苑裡鎮,0197,259,597,856,47,903,1579,57.19%,16.4%,1
苗栗縣,苑裡鎮,0198,219,443,662,50,712,1149,61.97%,19.06%,1
苗栗縣,苑裡鎮,0199,193,392,585,57,642,1057,60.74%,18.26%,1
苗栗縣,苑裡鎮,0200,161,396,557,18,575,1101,52.23%,14.62%,1
苗栗縣,苑裡鎮,0201,117,302,419,36,455,912,49.89%,12.83%,1
苗栗縣,苑裡鎮,0202,100,238,338,29,367,652,56.29%,15.34%,1
苗栗縣,苑裡鎮,0203,207,508,715,69,784,1348,58.16%,15.36%,1
苗栗縣,苑裡鎮,0204,122,229,351,18,369,733,50.34%,16.64%,1
苗栗縣,苑裡鎮,0205,98,232,330,13,343,662,51.81%,14.8%,1
苗栗縣,苑裡鎮,0206,144,337,481,35,516,893,57.78%,16.13%,1
苗栗縣,苑裡鎮,0207,176,326,502,45,547,910,60.11%,19.34%,1
苗栗縣,苑裡鎮,0208,191,452,643,57,700,1270,55.12%,15.04%,1
苗栗縣,苑裡鎮,0209,74,192,266,28,294,545,53.94%,13.58%,1
苗栗縣,苑裡鎮,0210,116,337,453,49,502,792,63.38%,14.65%,1
苗栗縣,苑裡鎮,0211,132,264,396,22,418,726,57.58%,18.18%,1
苗栗縣,苑裡鎮,0212,94,248,342,20,362,827,43.77%,11.37%,1
苗栗縣,苑裡鎮,0213,132,290,422,47,469,782,59.97%,16.88%,1
苗栗縣,苑裡鎮,0214,118,286,404,30,434,788,55.08%,14.97%,1
苗栗縣,苑裡鎮,0215,118,310,428,36,464,846,54.85%,13.95%,1
苗栗縣,苑裡鎮,0216,129,336,465,40,505,828,60.99%,15.58%,1
苗栗縣,苑裡鎮,0217,125,374,499,52,551,943,58.43%,13.26%,1
苗栗縣,苑裡鎮,0218,160,460,620,25,645,1082,59.61%,14.79%,1
苗栗縣,苑裡鎮,0219,203,487,690,58,748,1234,60.62%,16.45%,1
苗栗縣,苑裡鎮,0220,211,533,744,43,787,1434,54.88%,14.71%,1
苗栗縣,苑裡鎮,0221,156,376,532,39,571,987,57.85%,15.81%,1
苗栗縣,苑裡鎮,0222,161,358,519,45,564,882,63.95%,18.25%,1
苗栗縣,通霄鎮,0149,206,391,597,67,664,1142,58.14%,18.04%,1
苗栗縣,通霄鎮,0150,192,334,526,53,579,884,65.5%,21.72%,1
苗栗縣,通霄鎮,0151,167,385,552,52,604,1068,56.55%,15.64%,1
苗栗縣,通霄鎮,0152,182,370,552,38,590,1009,58.47%,18.04%,1
苗栗縣,通霄鎮,0153,165,347,512,49,561,859,65.31%,19.21%,1
苗栗縣,通霄鎮,0154,193,376,569,39,608,1040,58.46%,18.56%,1
苗栗縣,通霄鎮,0155,121,293,414,23,437,1008,43.35%,12%,1
苗栗縣,通霄鎮,0156,115,237,352,56,408,686,59.48%,16.76%,1
苗栗縣,通霄鎮,0157,145,330,475,37,512,761,67.28%,19.05%,1
苗栗縣,通霄鎮,0158,113,264,377,25,402,790,50.89%,14.3%,1
苗栗縣,通霄鎮,0159,136,347,483,51,534,966,55.28%,14.08%,1
苗栗縣,通霄鎮,0160,135,308,443,61,504,972,51.85%,13.89%,1
苗栗縣,通霄鎮,0161,106,294,400,37,437,771,56.68%,13.75%,1
苗栗縣,通霄鎮,0162,99,234,333,24,357,758,47.1%,13.06%,1
苗栗縣,通霄鎮,0163,162,369,531,53,584,1078,54.17%,15.03%,1
苗栗縣,通霄鎮,0164,32,137,169,31,200,459,43.57%,6.97%,1
苗栗縣,通霄鎮,0165,111,295,406,43,449,894,50.22%,12.42%,1
苗栗縣,通霄鎮,0166,50,101,151,8,159,402,39.55%,12.44%,1
苗栗縣,通霄鎮,0167,112,285,397,36,433,802,53.99%,13.97%,1
苗栗縣,通霄鎮,0168,114,222,336,14,350,684,51.17%,16.67%,1
苗栗縣,通霄鎮,0169,124,283,407,35,442,943,46.87%,13.15%,1
苗栗縣,通霄鎮,0170,123,314,437,43,480,790,60.76%,15.57%,1
苗栗縣,通霄鎮,0171,76,203,279,11,290,673,43.09%,11.29%,1
苗栗縣,通霄鎮,0172,174,426,600,52,652,1232,52.92%,14.12%,1
苗栗縣,通霄鎮,0173,166,523,689,68,757,1286,58.86%,12.91%,1
苗栗縣,通霄鎮,0174,106,250,356,29,385,649,59.32%,16.33%,1
苗栗縣,通霄鎮,0175,112,238,350,36,386,769,50.2%,14.56%,1
苗栗縣,通霄鎮,0176,192,373,565,66,631,1148,54.97%,16.72%,1
苗栗縣,通霄鎮,0177,163,354,517,59,576,1138,50.62%,14.32%,1
苗栗縣,通霄鎮,0178,164,359,523,43,566,1121,50.49%,14.63%,1
苗栗縣,通霄鎮,0179,139,267,406,21,427,769,55.53%,18.08%,1
苗栗縣,通霄鎮,0180,102,183,285,16,301,616,48.86%,16.56%,1
苗栗縣,通霄鎮,0181,147,252,399,37,436,799,54.57%,18.4%,1
苗栗縣,通霄鎮,0182,112,234,346,33,379,743,51.01%,15.07%,1
苗栗縣,竹南鎮,0270,244,389,633,21,654,1086,60.22%,22.47%,1
苗栗縣,竹南鎮,0271,129,335,464,26,490,826,59.32%,15.62%,1
苗栗縣,竹南鎮,0272,223,304,527,30,557,1051,53%,21.22%,1
苗栗縣,竹南鎮,0273,214,481,695,36,731,1235,59.19%,17.33%,1
苗栗縣,竹南鎮,0274,196,369,565,51,616,1016,60.63%,19.29%,1
苗栗縣,竹南鎮,0275,268,486,754,43,797,1472,54.14%,18.21%,1
苗栗縣,竹南鎮,0276,217,404,621,16,637,1301,48.96%,16.68%,1
苗栗縣,竹南鎮,0277,258,490,748,34,782,1544,50.65%,16.71%,1
苗栗縣,竹南鎮,0278,262,538,800,31,831,1512,54.96%,17.33%,1
苗栗縣,竹南鎮,0279,248,490,738,43,781,1463,53.38%,16.95%,1
苗栗縣,竹南鎮,0280,179,360,539,29,568,1073,52.94%,16.68%,1
苗栗縣,竹南鎮,0281,270,532,802,32,834,1453,57.4%,18.58%,1
苗栗縣,竹南鎮,0282,231,507,738,18,756,1245,60.72%,18.55%,1
苗栗縣,竹南鎮,0283,250,616,866,23,889,1487,59.78%,16.81%,1
苗栗縣,竹南鎮,0284,186,385,571,37,608,1018,59.72%,18.27%,1
苗栗縣,竹南鎮,0285,218,415,633,22,655,1105,59.28%,19.73%,1
苗栗縣,竹南鎮,0286,219,446,665,35,700,1322,52.95%,16.57%,1
苗栗縣,竹南鎮,0287,184,461,645,16,661,1140,57.98%,16.14%,1
苗栗縣,竹南鎮,0288,185,440,625,30,655,1067,61.39%,17.34%,1
苗栗縣,竹南鎮,0289,221,462,683,34,717,1136,63.12%,19.45%,1
苗栗縣,竹南鎮,0290,194,423,617,36,653,1253,52.11%,15.48%,1
苗栗縣,竹南鎮,0291,151,326,477,37,514,963,53.37%,15.68%,1
苗栗縣,竹南鎮,0292,179,347,526,31,557,1021,54.55%,17.53%,1
苗栗縣,竹南鎮,0293,220,441,661,36,697,1154,60.4%,19.06%,1
苗栗縣,竹南鎮,0294,192,379,571,25,596,1042,57.2%,18.43%,1
苗栗縣,竹南鎮,0295,213,498,711,33,744,1293,57.54%,16.47%,1
苗栗縣,竹南鎮,0296,135,343,478,12,490,816,60.05%,16.54%,1
苗栗縣,竹南鎮,0297,156,361,517,46,563,989,56.93%,15.77%,1
苗栗縣,竹南鎮,0298,168,479,647,33,680,1122,60.61%,14.97%,1
苗栗縣,竹南鎮,0299,176,335,511,30,541,1111,48.69%,15.84%,1
苗栗縣,竹南鎮,0300,172,409,581,34,615,1036,59.36%,16.6%,1
苗栗縣,竹南鎮,0301,148,393,541,19,560,1112,50.36%,13.31%,1
苗栗縣,竹南鎮,0302,211,472,683,22,705,1348,52.3%,15.65%,1
苗栗縣,竹南鎮,0303,214,413,627,32,659,1114,59.16%,19.21%,1
苗栗縣,竹南鎮,0304,205,427,632,42,674,1119,60.23%,18.32%,1
苗栗縣,竹南鎮,0305,127,347,474,24,498,878,56.72%,14.46%,1
苗栗縣,竹南鎮,0306,210,402,612,39,651,1059,61.47%,19.83%,1
苗栗縣,竹南鎮,0307,156,332,488,30,518,869,59.61%,17.95%,1
苗栗縣,竹南鎮,0308,125,289,414,32,446,800,55.75%,15.63%,1
苗栗縣,竹南鎮,0309,244,438,682,31,713,1165,61.2%,20.94%,1
苗栗縣,竹南鎮,0310,136,293,429,33,462,791,58.41%,17.19%,1
苗栗縣,竹南鎮,0311,111,254,365,18,383,677,56.57%,16.4%,1
苗栗縣,竹南鎮,0312,159,317,476,41,517,797,64.87%,19.95%,1
苗栗縣,竹南鎮,0313,175,456,631,26,657,1191,55.16%,14.69%,1
苗栗縣,竹南鎮,0314,183,344,527,16,543,1027,52.87%,17.82%,1
苗栗縣,竹南鎮,0315,230,514,744,46,790,1341,58.91%,17.15%,1
苗栗縣,竹南鎮,0316,215,440,655,48,703,1378,51.02%,15.6%,1
苗栗縣,竹南鎮,0317,207,449,656,27,683,1216,56.17%,17.02%,1
苗栗縣,竹南鎮,0318,227,580,807,29,836,1570,53.25%,14.46%,1
苗栗縣,竹南鎮,0319,98,192,290,40,330,538,61.34%,18.22%,1
苗栗縣,竹南鎮,0320,142,376,518,31,549,1166,47.08%,12.18%,1
苗栗縣,竹南鎮,0321,276,485,761,22,783,1488,52.62%,18.55%,1
苗栗縣,竹南鎮,0322,211,497,708,24,732,1449,50.52%,14.56%,1
苗栗縣,竹南鎮,0323,179,430,609,54,663,1182,56.09%,15.14%,1
苗栗縣,竹南鎮,0324,196,400,596,72,668,1175,56.85%,16.68%,1
苗栗縣,竹南鎮,0325,160,376,536,31,567,983,57.68%,16.28%,1
苗栗縣,竹南鎮,0326,70,219,289,20,309,492,62.8%,14.23%,1
苗栗縣,竹南鎮,0327,181,408,589,33,622,1074,57.91%,16.85%,1
苗栗縣,竹南鎮,0328,149,283,432,38,470,852,55.16%,17.49%,1
苗栗縣,竹南鎮,0329,226,433,659,33,692,1297,53.35%,17.42%,1
苗栗縣,竹南鎮,0330,168,337,505,54,559,1028,54.38%,16.34%,1
苗栗縣,頭份市,0331,117,327,444,56,500,915,54.64%,12.79%,1
苗栗縣,頭份市,0332,175,511,686,49,735,1292,56.89%,13.54%,1
苗栗縣,頭份市,0333,133,386,519,34,553,928,59.59%,14.33%,1
苗栗縣,頭份市,0334,115,303,418,12,430,835,51.5%,13.77%,1
苗栗縣,頭份市,0335,153,403,556,33,589,1070,55.05%,14.3%,1
苗栗縣,頭份市,0336,117,318,435,22,457,879,51.99%,13.31%,1
苗栗縣,頭份市,0337,179,324,503,36,539,1039,51.88%,17.23%,1
苗栗縣,頭份市,0338,170,453,623,36,659,1129,58.37%,15.06%,1
苗栗縣,頭份市,0339,159,376,535,37,572,1041,54.95%,15.27%,1
苗栗縣,頭份市,0340,183,561,744,50,794,1546,51.36%,11.84%,1
苗栗縣,頭份市,0341,165,394,559,29,588,935,62.89%,17.65%,1
苗栗縣,頭份市,0342,174,414,588,29,617,1180,52.29%,14.75%,1
苗栗縣,頭份市,0343,212,529,741,27,768,1499,51.23%,14.14%,1
苗栗縣,頭份市,0344,144,245,389,16,405,747,54.22%,19.28%,1
苗栗縣,頭份市,0345,204,525,729,31,760,1406,54.05%,14.51%,1
苗栗縣,頭份市,0346,171,458,629,45,674,1193,56.5%,14.33%,1
苗栗縣,頭份市,0347,160,356,516,41,557,948,58.76%,16.88%,1
苗栗縣,頭份市,0348,118,339,457,12,469,869,53.97%,13.58%,1
苗栗縣,頭份市,0349,197,441,638,27,665,1142,58.23%,17.25%,1
苗栗縣,頭份市,0350,230,464,694,17,711,1286,55.29%,17.88%,1
苗栗縣,頭份市,0351,152,356,508,31,539,903,59.69%,16.83%,1
苗栗縣,頭份市,0352,199,497,696,39,735,1186,61.97%,16.78%,1
苗栗縣,頭份市,0353,178,405,583,16,599,1016,58.96%,17.52%,1
苗栗縣,頭份市,0354,164,370,534,25,559,985,56.75%,16.65%,1
苗栗縣,頭份市,0355,159,383,542,23,565,1037,54.48%,15.33%,1
苗栗縣,頭份市,0356,128,317,445,19,464,947,49%,13.52%,1
苗栗縣,頭份市,0357,154,344,498,20,518,890,58.2%,17.3%,1
苗栗縣,頭份市,0358,131,255,386,22,408,646,63.16%,20.28%,1
苗栗縣,頭份市,0359,155,386,541,41,582,975,59.69%,15.9%,1
苗栗縣,頭份市,0360,101,284,385,12,397,1015,39.11%,9.95%,1
苗栗縣,頭份市,0361,227,584,811,50,861,1399,61.54%,16.23%,1
苗栗縣,頭份市,0362,186,465,651,37,688,1143,60.19%,16.27%,1
苗栗縣,頭份市,0363,173,462,635,35,670,1030,65.05%,16.8%,1
苗栗縣,頭份市,0364,241,505,746,34,780,1338,58.3%,18.01%,1
苗栗縣,頭份市,0365,234,524,758,26,784,1450,54.07%,16.14%,1
苗栗縣,頭份市,0366,185,413,598,12,610,1042,58.54%,17.75%,1
苗栗縣,頭份市,0367,247,520,767,30,797,1326,60.11%,18.63%,1
苗栗縣,頭份市,0368,225,543,768,34,802,1270,63.15%,17.72%,1
苗栗縣,頭份市,0369,225,471,696,31,727,1288,56.44%,17.47%,1
苗栗縣,頭份市,0370,219,498,717,27,744,1243,59.86%,17.62%,1
苗栗縣,頭份市,0371,198,540,738,18,756,1280,59.06%,15.47%,1
苗栗縣,頭份市,0372,275,595,870,45,915,1618,56.55%,17%,1
苗栗縣,頭份市,0373,289,625,914,33,947,1759,53.84%,16.43%,1
苗栗縣,頭份市,0374,224,502,726,27,753,1264,59.57%,17.72%,1
苗栗縣,頭份市,0375,238,510,748,20,768,1326,57.92%,17.95%,1
苗栗縣,頭份市,0376,263,601,864,29,893,1551,57.58%,16.96%,1
苗栗縣,頭份市,0377,245,537,782,31,813,1574,51.65%,15.57%,1
苗栗縣,頭份市,0378,219,477,696,34,730,1262,57.84%,17.35%,1
苗栗縣,頭份市,0379,210,439,649,39,688,1171,58.75%,17.93%,1
苗栗縣,頭份市,0380,199,461,660,35,695,1074,64.71%,18.53%,1
苗栗縣,頭份市,0381,195,472,667,22,689,1141,60.39%,17.09%,1
苗栗縣,頭份市,0382,191,510,701,33,734,1259,58.3%,15.17%,1
苗栗縣,頭份市,0383,206,425,631,27,658,1186,55.48%,17.37%,1
苗栗縣,頭份市,0384,153,410,563,20,583,1121,52.01%,13.65%,1
苗栗縣,頭份市,0385,132,332,464,22,486,847,57.38%,15.58%,1
苗栗縣,頭份市,0386,198,382,580,19,599,993,60.32%,19.94%,1
苗栗縣,頭份市,0387,171,375,546,26,572,1055,54.22%,16.21%,1
苗栗縣,頭份市,0388,216,582,798,35,833,1655,50.33%,13.05%,1
苗栗縣,頭份市,0389,261,669,930,59,989,1799,54.97%,14.51%,1
苗栗縣,頭份市,0390,190,443,633,29,662,1141,58.02%,16.65%,1
苗栗縣,頭份市,0391,238,508,746,35,781,1431,54.58%,16.63%,1
苗栗縣,頭份市,0392,188,457,645,17,662,1412,46.88%,13.31%,1
苗栗縣,頭份市,0393,149,395,544,23,567,1074,52.79%,13.87%,1
苗栗縣,頭份市,0394,213,494,707,35,742,1245,59.6%,17.11%,1
苗栗縣,頭份市,0395,244,517,761,50,811,1344,60.34%,18.15%,1
苗栗縣,頭份市,0396,234,546,780,63,843,1363,61.85%,17.17%,1
苗栗縣,頭份市,0397,144,400,544,29,573,898,63.81%,16.04%,1
苗栗縣,頭份市,0398,195,467,662,52,714,1182,60.41%,16.5%,1
苗栗縣,頭份市,0399,204,544,748,31,779,1413,55.13%,14.44%,1
苗栗縣,頭份市,0400,181,402,583,33,616,991,62.16%,18.26%,1
苗栗縣,頭份市,0401,195,457,652,44,696,1180,58.98%,16.53%,1
苗栗縣,後龍鎮,0223,110,210,320,23,343,590,58.14%,18.64%,1
苗栗縣,後龍鎮,0224,184,336,520,41,561,883,63.53%,20.84%,1
苗栗縣,後龍鎮,0225,151,309,460,35,495,793,62.42%,19.04%,1
苗栗縣,後龍鎮,0226,287,127,414,27,441,732,60.25%,39.21%,1
苗栗縣,後龍鎮,0227,98,235,333,28,361,592,60.98%,16.55%,1
苗栗縣,後龍鎮,0228,202,419,621,44,665,1113,59.75%,18.15%,1
苗栗縣,後龍鎮,0229,202,431,633,44,677,1195,56.65%,16.9%,1
苗栗縣,後龍鎮,0230,191,394,585,39,624,997,62.59%,19.16%,1
苗栗縣,後龍鎮,0231,132,302,434,17,451,913,49.4%,14.46%,1
苗栗縣,後龍鎮,0232,93,216,309,29,338,641,52.73%,14.51%,1
苗栗縣,後龍鎮,0233,146,275,421,31,452,848,53.3%,17.22%,1
苗栗縣,後龍鎮,0234,212,415,627,73,700,1264,55.38%,16.77%,1
苗栗縣,後龍鎮,0235,142,317,459,46,505,965,52.33%,14.72%,1
苗栗縣,後龍鎮,0236,211,583,794,57,851,1216,69.98%,17.35%,1
苗栗縣,後龍鎮,0237,156,342,498,35,533,977,54.55%,15.97%,1
苗栗縣,後龍鎮,0238,145,297,442,35,477,943,50.58%,15.38%,1
苗栗縣,後龍鎮,0239,131,330,461,61,522,910,57.36%,14.4%,1
苗栗縣,後龍鎮,0240,124,315,439,34,473,851,55.58%,14.57%,1
苗栗縣,後龍鎮,0241,169,268,437,22,459,725,63.31%,23.31%,1
苗栗縣,後龍鎮,0242,119,231,350,38,388,650,59.69%,18.31%,1
苗栗縣,後龍鎮,0243,101,220,321,46,367,706,51.98%,14.31%,1
苗栗縣,後龍鎮,0244,120,279,399,37,436,748,58.29%,16.04%,1
苗栗縣,後龍鎮,0245,104,241,345,34,379,801,47.32%,12.98%,1
苗栗縣,後龍鎮,0246,148,445,593,34,627,1107,56.64%,13.37%,1
苗栗縣,後龍鎮,0247,189,409,598,59,657,1197,54.89%,15.79%,1
苗栗縣,後龍鎮,0248,122,361,483,45,528,1036,50.97%,11.78%,1
苗栗縣,後龍鎮,0249,116,281,397,28,425,913,46.55%,12.71%,1
苗栗縣,後龍鎮,0250,114,286,400,40,440,719,61.2%,15.86%,1
苗栗縣,後龍鎮,0251,137,383,520,79,599,1037,57.76%,13.21%,1
苗栗縣,後龍鎮,0252,107,187,294,14,308,601,51.25%,17.8%,1
苗栗縣,後龍鎮,0253,170,376,546,35,581,1269,45.78%,13.4%,1
苗栗縣,後龍鎮,0254,98,240,338,29,367,735,49.93%,13.33%,1
苗栗縣,後龍鎮,0255,39,92,131,14,145,422,34.36%,9.24%,1
苗栗縣,後龍鎮,0256,106,231,337,22,359,625,57.44%,16.96%,1
苗栗縣,後龍鎮,0257,126,396,522,52,574,1234,46.52%,10.21%,1
苗栗縣,卓蘭鎮,0442,156,392,548,40,588,961,61.19%,16.23%,1
苗栗縣,卓蘭鎮,0443,169,355,524,54,578,1017,56.83%,16.62%,1
苗栗縣,卓蘭鎮,0444,204,440,644,59,703,1095,64.2%,18.63%,1
苗栗縣,卓蘭鎮,0445,121,313,434,25,459,745,61.61%,16.24%,1
苗栗縣,卓蘭鎮,0446,101,303,404,27,431,783,55.04%,12.9%,1
苗栗縣,卓蘭鎮,0447,120,243,363,12,375,745,50.34%,16.11%,1
苗栗縣,卓蘭鎮,0448,143,366,509,19,528,999,52.85%,14.31%,1
苗栗縣,卓蘭鎮,0449,110,275,385,33,418,671,62.3%,16.39%,1
苗栗縣,卓蘭鎮,0450,116,306,422,61,483,734,65.8%,15.8%,1
苗栗縣,卓蘭鎮,0451,131,366,497,39,536,865,61.97%,15.14%,1
苗栗縣,卓蘭鎮,0452,118,353,471,51,522,828,63.04%,14.25%,1
苗栗縣,卓蘭鎮,0453,66,156,222,21,243,386,62.95%,17.1%,1
苗栗縣,卓蘭鎮,0454,132,273,405,39,444,688,64.53%,19.19%,1
苗栗縣,卓蘭鎮,0455,156,300,456,36,492,792,62.12%,19.7%,1
苗栗縣,卓蘭鎮,0456,117,291,408,26,434,729,59.53%,16.05%,1
苗栗縣,卓蘭鎮,0457,161,337,498,30,528,1093,48.31%,14.73%,1
苗栗縣,卓蘭鎮,0458,83,258,341,14,355,615,57.72%,13.5%,1
苗栗縣,卓蘭鎮,0459,4,42,46,2,48,86,55.81%,4.65%,1
苗栗縣,卓蘭鎮,0460,133,373,506,16,522,940,55.53%,14.15%,1
苗栗縣,大湖鄉,0420,231,139,370,38,408,744,54.84%,31.05%,1
苗栗縣,大湖鄉,0421,142,314,456,31,487,881,55.28%,16.12%,1
苗栗縣,大湖鄉,0422,92,215,307,33,340,596,57.05%,15.44%,1
苗栗縣,大湖鄉,0423,191,411,602,52,654,1260,51.9%,15.16%,1
苗栗縣,大湖鄉,0424,112,322,434,22,456,867,52.6%,12.92%,1
苗栗縣,大湖鄉,0425,140,350,490,24,514,923,55.69%,15.17%,1
苗栗縣,大湖鄉,0426,179,473,652,84,736,1395,52.76%,12.83%,1
苗栗縣,大湖鄉,0427,62,134,196,19,215,561,38.32%,11.05%,1
苗栗縣,大湖鄉,0428,92,262,354,19,373,638,58.46%,14.42%,1
苗栗縣,大湖鄉,0429,120,245,365,34,399,754,52.92%,15.92%,1
苗栗縣,大湖鄉,0430,57,176,233,15,248,501,49.5%,11.38%,1
苗栗縣,大湖鄉,0431,111,219,330,29,359,652,55.06%,17.02%,1
苗栗縣,大湖鄉,0432,108,281,389,27,416,843,49.35%,12.81%,1
苗栗縣,大湖鄉,0433,132,369,501,76,577,1020,56.57%,12.94%,1
苗栗縣,大湖鄉,0434,129,419,548,31,579,1018,56.88%,12.67%,1
苗栗縣,公館鄉,0068,149,335,484,40,524,789,66.41%,18.88%,1
苗栗縣,公館鄉,0069,149,351,500,28,528,792,66.67%,18.81%,1
苗栗縣,公館鄉,0070,180,478,658,61,719,1117,64.37%,16.11%,1
苗栗縣,公館鄉,0071,215,521,736,52,788,1255,62.79%,17.13%,1
苗栗縣,公館鄉,0072,185,456,641,43,684,1141,59.95%,16.21%,1
苗栗縣,公館鄉,0073,212,441,653,34,687,1172,58.62%,18.09%,1
苗栗縣,公館鄉,0074,188,479,667,28,695,1100,63.18%,17.09%,1
苗栗縣,公館鄉,0075,172,437,609,42,651,1232,52.84%,13.96%,1
苗栗縣,公館鄉,0076,159,358,517,53,570,1081,52.73%,14.71%,1
苗栗縣,公館鄉,0077,209,528,737,39,776,1250,62.08%,16.72%,1
苗栗縣,公館鄉,0078,178,411,589,42,631,1081,58.37%,16.47%,1
苗栗縣,公館鄉,0079,154,356,510,44,554,964,57.47%,15.98%,1
苗栗縣,公館鄉,0080,164,405,569,61,630,1038,60.69%,15.8%,1
苗栗縣,公館鄉,0081,66,143,209,17,226,360,62.78%,18.33%,1
苗栗縣,公館鄉,0082,126,323,449,49,498,865,57.57%,14.57%,1
苗栗縣,公館鄉,0083,192,421,613,40,653,1166,56%,16.47%,1
苗栗縣,公館鄉,0084,111,293,404,26,430,719,59.81%,15.44%,1
苗栗縣,公館鄉,0085,136,269,405,31,436,788,55.33%,17.26%,1
苗栗縣,公館鄉,0086,53,121,174,29,203,303,67%,17.49%,1
苗栗縣,公館鄉,0087,230,526,756,40,796,1322,60.21%,17.4%,1
苗栗縣,公館鄉,0088,143,347,490,45,535,933,57.34%,15.33%,1
苗栗縣,公館鄉,0089,211,514,725,66,791,1455,54.36%,14.5%,1
苗栗縣,公館鄉,0090,288,633,921,77,998,1615,61.8%,17.83%,1
苗栗縣,公館鄉,0091,201,546,747,59,806,1451,55.55%,13.85%,1
苗栗縣,公館鄉,0092,249,575,824,58,882,1462,60.33%,17.03%,1
苗栗縣,公館鄉,0093,200,485,685,52,737,1317,55.96%,15.19%,1
苗栗縣,公館鄉,0094,39,85,124,7,131,221,59.28%,17.65%,1
苗栗縣,公館鄉,0095,36,126,162,13,175,329,53.19%,10.94%,1
苗栗縣,銅鑼鄉,0108,139,379,518,30,548,887,61.78%,15.67%,1
苗栗縣,銅鑼鄉,0109,163,438,601,31,632,1052,60.08%,15.49%,1
苗栗縣,銅鑼鄉,0110,250,536,786,39,825,1347,61.25%,18.56%,1
苗栗縣,銅鑼鄉,0111,172,462,634,38,672,1177,57.09%,14.61%,1
苗栗縣,銅鑼鄉,0112,193,452,645,38,683,1268,53.86%,15.22%,1
苗栗縣,銅鑼鄉,0113,189,362,551,32,583,1185,49.2%,15.95%,1
苗栗縣,銅鑼鄉,0114,140,426,566,31,597,1029,58.02%,13.61%,1
苗栗縣,銅鑼鄉,0115,147,357,504,20,524,905,57.9%,16.24%,1
苗栗縣,銅鑼鄉,0116,139,306,445,23,468,750,62.4%,18.53%,1
苗栗縣,銅鑼鄉,0117,120,401,521,35,556,1080,51.48%,11.11%,1
苗栗縣,銅鑼鄉,0118,156,398,554,48,602,1108,54.33%,14.08%,1
苗栗縣,銅鑼鄉,0119,145,283,428,28,456,862,52.9%,16.82%,1
苗栗縣,銅鑼鄉,0120,183,428,611,35,646,1216,53.13%,15.05%,1
苗栗縣,銅鑼鄉,0121,69,208,277,27,304,588,51.7%,11.73%,1
苗栗縣,銅鑼鄉,0122,59,151,210,25,235,429,54.78%,13.75%,1
苗栗縣,銅鑼鄉,0123,82,213,295,22,317,541,58.6%,15.16%,1
苗栗縣,南庄鄉,0411,179,410,589,55,644,1155,55.76%,15.5%,1
苗栗縣,南庄鄉,0412,111,239,350,22,372,650,57.23%,17.08%,1
苗栗縣,南庄鄉,0413,178,474,652,47,699,1353,51.66%,13.16%,1
苗栗縣,南庄鄉,0414,99,231,330,25,355,813,43.67%,12.18%,1
苗栗縣,南庄鄉,0415,82,244,326,33,359,837,42.89%,9.8%,1
苗栗縣,南庄鄉,0416,157,386,543,29,572,1093,52.33%,14.36%,1
苗栗縣,南庄鄉,0417,170,376,546,27,573,1048,54.68%,16.22%,1
苗栗縣,南庄鄉,0418,126,297,423,22,445,872,51.03%,14.45%,1
苗栗縣,南庄鄉,0419,87,223,310,10,320,963,33.23%,9.03%,1
苗栗縣,頭屋鄉,0096,222,619,841,52,893,1335,66.89%,16.63%,1
苗栗縣,頭屋鄉,0097,211,552,763,66,829,1168,70.98%,18.07%,1
苗栗縣,頭屋鄉,0098,136,350,486,34,520,792,65.66%,17.17%,1
苗栗縣,頭屋鄉,0099,208,410,618,40,658,918,71.68%,22.66%,1
苗栗縣,頭屋鄉,0100,105,330,435,29,464,725,64%,14.48%,1
苗栗縣,頭屋鄉,0101,145,391,536,19,555,899,61.74%,16.13%,1
苗栗縣,頭屋鄉,0102,51,124,175,7,182,369,49.32%,13.82%,1
苗栗縣,頭屋鄉,0103,160,323,483,21,504,844,59.72%,18.96%,1
苗栗縣,頭屋鄉,0104,204,397,601,22,623,1007,61.87%,20.26%,1
苗栗縣,頭屋鄉,0105,149,329,478,24,502,794,63.22%,18.77%,1
苗栗縣,頭屋鄉,0106,44,99,143,13,156,211,73.93%,20.85%,1
苗栗縣,頭屋鄉,0107,56,163,219,19,238,328,72.56%,17.07%,1
苗栗縣,三義鄉,0124,126,362,488,35,523,853,61.31%,14.77%,1
苗栗縣,三義鄉,0125,158,433,591,20,611,983,62.16%,16.07%,1
苗栗縣,三義鄉,0126,170,440,610,37,647,1080,59.91%,15.74%,1
苗栗縣,三義鄉,0127,181,449,630,21,651,1216,53.54%,14.88%,1
苗栗縣,三義鄉,0128,136,430,566,38,604,1017,59.39%,13.37%,1
苗栗縣,三義鄉,0129,171,446,617,15,632,1180,53.56%,14.49%,1
苗栗縣,三義鄉,0130,182,482,664,20,684,1198,57.1%,15.19%,1
苗栗縣,三義鄉,0131,56,176,232,10,242,417,58.03%,13.43%,1
苗栗縣,三義鄉,0132,146,348,494,30,524,991,52.88%,14.73%,1
苗栗縣,三義鄉,0133,122,349,471,19,490,834,58.75%,14.63%,1
苗栗縣,三義鄉,0134,105,234,339,28,367,622,59%,16.88%,1
苗栗縣,三義鄉,0135,129,293,422,37,459,749,61.28%,17.22%,1
苗栗縣,三義鄉,0136,128,309,437,23,460,692,66.47%,18.5%,1
苗栗縣,三義鄉,0137,146,366,512,23,535,759,70.49%,19.24%,1
苗栗縣,三義鄉,0138,95,216,311,25,336,629,53.42%,15.1%,1
苗栗縣,三義鄉,0139,115,250,365,21,386,669,57.7%,17.19%,1
苗栗縣,西湖鄉,0140,102,203,305,24,329,601,54.74%,16.97%,1
苗栗縣,西湖鄉,0141,90,228,318,23,341,566,60.25%,15.9%,1
苗栗縣,西湖鄉,0142,125,326,451,39,490,843,58.13%,14.83%,1
苗栗縣,西湖鄉,0143,102,215,317,25,342,648,52.78%,15.74%,1
苗栗縣,西湖鄉,0144,142,298,440,33,473,936,50.53%,15.17%,1
苗栗縣,西湖鄉,0145,82,153,235,13,248,461,53.8%,17.79%,1
苗栗縣,西湖鄉,0146,74,200,274,20,294,515,57.09%,14.37%,1
苗栗縣,西湖鄉,0147,149,417,566,49,615,1141,53.9%,13.06%,1
苗栗縣,西湖鄉,0148,121,248,369,27,396,671,59.02%,18.03%,1
苗栗縣,造橋鄉,0258,207,510,717,49,766,1171,65.41%,17.68%,1
苗栗縣,造橋鄉,0259,117,383,500,28,528,889,59.39%,13.16%,1
苗栗縣,造橋鄉,0260,54,165,219,18,237,479,49.48%,11.27%,1
苗栗縣,造橋鄉,0261,132,422,554,49,603,1024,58.89%,12.89%,1
苗栗縣,造橋鄉,0262,200,395,595,62,657,1214,54.12%,16.47%,1
苗栗縣,造橋鄉,0263,151,380,531,29,560,1071,52.29%,14.1%,1
苗栗縣,造橋鄉,0264,163,387,550,57,607,1157,52.46%,14.09%,1
苗栗縣,造橋鄉,0265,76,195,271,30,301,512,58.79%,14.84%,1
苗栗縣,造橋鄉,0266,84,210,294,16,310,491,63.14%,17.11%,1
苗栗縣,造橋鄉,0267,211,502,713,53,766,1272,60.22%,16.59%,1
苗栗縣,造橋鄉,0268,115,304,419,32,451,785,57.45%,14.65%,1
苗栗縣,造橋鄉,0269,186,371,557,76,633,962,65.8%,19.33%,1
苗栗縣,三灣鄉,0402,152,417,569,27,596,996,59.84%,15.26%,1
苗栗縣,三灣鄉,0403,191,451,642,51,693,1205,57.51%,15.85%,1
苗栗縣,三灣鄉,0404,92,254,346,41,387,635,60.94%,14.49%,1
苗栗縣,三灣鄉,0405,126,328,454,43,497,862,57.66%,14.62%,1
苗栗縣,三灣鄉,0406,26,80,106,12,118,238,49.58%,10.92%,1
苗栗縣,三灣鄉,0407,76,190,266,28,294,541,54.34%,14.05%,1
苗栗縣,三灣鄉,0408,79,196,275,25,300,578,51.9%,13.67%,1
苗栗縣,三灣鄉,0409,60,185,245,34,279,405,68.89%,14.81%,1
苗栗縣,三灣鄉,0410,53,152,205,19,224,392,57.14%,13.52%,1
苗栗縣,獅潭鄉,0435,23,100,123,7,130,328,39.63%,7.01%,1
苗栗縣,獅潭鄉,0436,56,167,223,28,251,565,44.42%,9.91%,1
苗栗縣,獅潭鄉,0437,139,331,470,52,522,911,57.3%,15.26%,1
苗栗縣,獅潭鄉,0438,77,172,249,19,268,568,47.18%,13.56%,1
苗栗縣,獅潭鄉,0439,77,235,312,30,342,580,58.97%,13.28%,1
苗栗縣,獅潭鄉,0440,41,122,163,7,170,333,51.05%,12.31%,1
苗栗縣,獅潭鄉,0441,84,254,338,18,356,683,52.12%,12.3%,1
苗栗縣,泰安鄉,0461,41,108,149,6,155,325,47.69%,12.62%,1
苗栗縣,泰安鄉,0462,67,205,272,16,288,484,59.5%,13.84%,1
苗栗縣,泰安鄉,0463,110,348,458,32,490,666,73.57%,16.52%,1
苗栗縣,泰安鄉,0464,84,266,350,40,390,574,67.94%,14.63%,1
苗栗縣,泰安鄉,0465,42,124,166,9,175,333,52.55%,12.61%,1
苗栗縣,泰安鄉,0466,71,260,331,11,342,495,69.09%,14.34%,1
苗栗縣,泰安鄉,0467,117,249,366,27,393,544,72.24%,21.51%,1
苗栗縣,泰安鄉,0468,60,216,276,20,296,500,59.2%,12%,1
苗栗縣,泰安鄉,0469,103,345,448,32,480,670,71.64%,15.37%,1
苗栗縣,泰安鄉,0470,82,369,451,6,457,589,77.59%,13.92%,1
彰化縣,彰化市,0001,121,343,464,26,490,871,56.26%,13.89%,1
彰化縣,彰化市,0002,109,228,337,29,366,751,48.74%,14.51%,1
彰化縣,彰化市,0003,215,361,576,32,608,923,65.87%,23.29%,1
彰化縣,彰化市,0004,167,278,445,40,485,779,62.26%,21.44%,1
彰化縣,彰化市,0005,177,276,453,28,481,779,61.75%,22.72%,1
彰化縣,彰化市,0006,139,272,411,20,431,720,59.86%,19.31%,1
彰化縣,彰化市,0007,152,275,427,21,448,749,59.81%,20.29%,1
彰化縣,彰化市,0008,143,330,473,29,502,767,65.45%,18.64%,1
彰化縣,彰化市,0009,189,422,611,49,660,1047,63.04%,18.05%,1
彰化縣,彰化市,0010,205,356,561,26,587,1027,57.16%,19.96%,1
彰化縣,彰化市,0011,211,452,663,49,712,1249,57.01%,16.89%,1
彰化縣,彰化市,0012,217,439,656,24,680,1136,59.86%,19.1%,1
彰化縣,彰化市,0013,206,479,685,41,726,1169,62.1%,17.62%,1
彰化縣,彰化市,0014,157,305,462,19,481,766,62.79%,20.5%,1
彰化縣,彰化市,0015,100,267,367,21,388,643,60.34%,15.55%,1
彰化縣,彰化市,0016,209,495,704,39,743,1251,59.39%,16.71%,1
彰化縣,彰化市,0017,169,322,491,21,512,1301,39.35%,12.99%,1
彰化縣,彰化市,0018,246,490,736,25,761,1280,59.45%,19.22%,1
彰化縣,彰化市,0019,213,486,699,30,729,1179,61.83%,18.07%,1
彰化縣,彰化市,0020,215,462,677,13,690,1168,59.08%,18.41%,1
彰化縣,彰化市,0021,177,509,686,32,718,1218,58.95%,14.53%,1
彰化縣,彰化市,0022,286,575,861,28,889,1351,65.8%,21.17%,1
彰化縣,彰化市,0023,251,440,691,25,716,1204,59.47%,20.85%,1
彰化縣,彰化市,0024,232,470,702,16,718,1189,60.39%,19.51%,1
彰化縣,彰化市,0025,213,439,652,41,693,1207,57.42%,17.65%,1
彰化縣,彰化市,0026,217,473,690,32,722,1161,62.19%,18.69%,1
彰化縣,彰化市,0027,249,391,640,25,665,1166,57.03%,21.36%,1
彰化縣,彰化市,0028,287,518,805,29,834,1362,61.23%,21.07%,1
彰化縣,彰化市,0029,274,455,729,40,769,1236,62.22%,22.17%,1
彰化縣,彰化市,0030,200,400,600,43,643,1065,60.38%,18.78%,1
彰化縣,彰化市,0031,274,419,693,30,723,1199,60.3%,22.85%,1
彰化縣,彰化市,0032,267,450,717,26,743,1233,60.26%,21.65%,1
彰化縣,彰化市,0033,230,368,598,23,621,1245,49.88%,18.47%,1
彰化縣,彰化市,0034,232,461,693,22,715,1153,62.01%,20.12%,1
彰化縣,彰化市,0035,189,372,561,32,593,1045,56.75%,18.09%,1
彰化縣,彰化市,0036,226,407,633,14,647,1097,58.98%,20.6%,1
彰化縣,彰化市,0037,228,432,660,33,693,1190,58.24%,19.16%,1
彰化縣,彰化市,0038,241,425,666,26,692,1106,62.57%,21.79%,1
彰化縣,彰化市,0039,193,450,643,20,663,1097,60.44%,17.59%,1
彰化縣,彰化市,0040,203,400,603,38,641,1048,61.16%,19.37%,1
彰化縣,彰化市,0041,215,378,593,25,618,980,63.06%,21.94%,1
彰化縣,彰化市,0042,145,288,433,14,447,707,63.22%,20.51%,1
彰化縣,彰化市,0043,160,304,464,26,490,809,60.57%,19.78%,1
彰化縣,彰化市,0044,217,378,595,37,632,1008,62.7%,21.53%,1
彰化縣,彰化市,0045,160,316,476,41,517,901,57.38%,17.76%,1
彰化縣,彰化市,0046,182,338,520,30,550,951,57.83%,19.14%,1
彰化縣,彰化市,0047,221,396,617,29,646,1076,60.04%,20.54%,1
彰化縣,彰化市,0048,170,398,568,20,588,1022,57.53%,16.63%,1
彰化縣,彰化市,0049,181,332,513,34,547,894,61.19%,20.25%,1
彰化縣,彰化市,0050,199,400,599,34,633,1016,62.3%,19.59%,1
彰化縣,彰化市,0051,162,303,465,34,499,771,64.72%,21.01%,1
彰化縣,彰化市,0052,180,320,500,33,533,868,61.41%,20.74%,1
彰化縣,彰化市,0053,218,422,640,48,688,1135,60.62%,19.21%,1
彰化縣,彰化市,0054,179,327,506,56,562,910,61.76%,19.67%,1
彰化縣,彰化市,0055,212,394,606,24,630,1004,62.75%,21.12%,1
彰化縣,彰化市,0056,227,406,633,41,674,1077,62.58%,21.08%,1
彰化縣,彰化市,0057,256,528,784,43,827,1258,65.74%,20.35%,1
彰化縣,彰化市,0058,188,447,635,21,656,1025,64%,18.34%,1
彰化縣,彰化市,0059,228,487,715,33,748,1177,63.55%,19.37%,1
彰化縣,彰化市,0060,216,483,699,25,724,1262,57.37%,17.12%,1
彰化縣,彰化市,0061,213,503,716,37,753,1209,62.28%,17.62%,1
彰化縣,彰化市,0062,221,406,627,34,661,1041,63.5%,21.23%,1
彰化縣,彰化市,0063,184,463,647,26,673,1075,62.6%,17.12%,1
彰化縣,彰化市,0064,166,389,555,38,593,1029,57.63%,16.13%,1
彰化縣,彰化市,0065,215,441,656,48,704,1203,58.52%,17.87%,1
彰化縣,彰化市,0066,158,408,566,26,592,1014,58.38%,15.58%,1
彰化縣,彰化市,0067,198,424,622,25,647,1069,60.52%,18.52%,1
彰化縣,彰化市,0068,157,347,504,20,524,969,54.08%,16.2%,1
彰化縣,彰化市,0069,171,399,570,24,594,1105,53.76%,15.48%,1
彰化縣,彰化市,0070,187,410,597,35,632,981,64.42%,19.06%,1
彰化縣,彰化市,0071,217,421,638,54,692,1095,63.2%,19.82%,1
彰化縣,彰化市,0072,192,465,657,22,679,1087,62.47%,17.66%,1
彰化縣,彰化市,0073,219,397,616,25,641,1050,61.05%,20.86%,1
彰化縣,彰化市,0074,43,693,736,35,771,1252,61.58%,3.43%,1
彰化縣,彰化市,0075,190,414,604,28,632,1113,56.78%,17.07%,1
彰化縣,彰化市,0076,213,405,618,21,639,1009,63.33%,21.11%,1
彰化縣,彰化市,0077,186,357,543,36,579,999,57.96%,18.62%,1
彰化縣,彰化市,0078,195,373,568,21,589,997,59.08%,19.56%,1
彰化縣,彰化市,0079,261,460,721,25,746,1145,65.15%,22.79%,1
彰化縣,彰化市,0080,232,484,716,19,735,1227,59.9%,18.91%,1
彰化縣,彰化市,0081,252,479,731,19,750,1208,62.09%,20.86%,1
彰化縣,彰化市,0082,286,622,908,21,929,1598,58.14%,17.9%,1
彰化縣,彰化市,0083,148,376,524,25,549,890,61.69%,16.63%,1
彰化縣,彰化市,0084,222,468,690,27,717,1104,64.95%,20.11%,1
彰化縣,彰化市,0085,203,411,614,19,633,1097,57.7%,18.51%,1
彰化縣,彰化市,0086,136,306,442,29,471,799,58.95%,17.02%,1
彰化縣,彰化市,0087,161,425,586,38,624,1000,62.4%,16.1%,1
彰化縣,彰化市,0088,176,455,631,55,686,1153,59.5%,15.26%,1
彰化縣,彰化市,0089,162,390,552,47,599,977,61.31%,16.58%,1
彰化縣,彰化市,0090,234,427,661,37,698,1201,58.12%,19.48%,1
彰化縣,彰化市,0091,232,392,624,40,664,1057,62.82%,21.95%,1
彰化縣,彰化市,0092,212,462,674,56,730,1238,58.97%,17.12%,1
彰化縣,彰化市,0093,206,501,707,40,747,1210,61.74%,17.02%,1
彰化縣,彰化市,0094,186,422,608,28,636,1026,61.99%,18.13%,1
彰化縣,彰化市,0095,227,425,652,42,694,1061,65.41%,21.39%,1
彰化縣,彰化市,0096,240,443,683,42,725,1213,59.77%,19.79%,1
彰化縣,彰化市,0097,276,464,740,35,775,1264,61.31%,21.84%,1
彰化縣,彰化市,0098,162,284,446,23,469,691,67.87%,23.44%,1
彰化縣,彰化市,0099,191,349,540,36,576,893,64.5%,21.39%,1
彰化縣,彰化市,0100,129,294,423,36,459,733,62.62%,17.6%,1
彰化縣,彰化市,0101,136,282,418,29,447,692,64.6%,19.65%,1
彰化縣,彰化市,0102,157,254,411,27,438,728,60.16%,21.57%,1
彰化縣,彰化市,0103,160,320,480,21,501,773,64.81%,20.7%,1
彰化縣,彰化市,0104,153,359,512,21,533,975,54.67%,15.69%,1
彰化縣,彰化市,0105,162,362,524,35,559,908,61.56%,17.84%,1
彰化縣,彰化市,0106,216,475,691,6,697,1156,60.29%,18.69%,1
彰化縣,彰化市,0107,213,501,714,39,753,1235,60.97%,17.25%,1
彰化縣,彰化市,0108,248,498,746,37,783,1376,56.9%,18.02%,1
彰化縣,彰化市,0109,258,516,774,7,781,1389,56.23%,18.57%,1
彰化縣,彰化市,0110,163,368,531,29,560,846,66.19%,19.27%,1
彰化縣,彰化市,0111,152,382,534,26,560,859,65.19%,17.69%,1
彰化縣,彰化市,0112,171,295,466,18,484,781,61.97%,21.9%,1
彰化縣,彰化市,0113,168,327,495,26,521,875,59.54%,19.2%,1
彰化縣,彰化市,0114,141,321,462,24,486,816,59.56%,17.28%,1
彰化縣,彰化市,0115,136,275,411,28,439,687,63.9%,19.8%,1
彰化縣,彰化市,0116,140,306,446,28,474,727,65.2%,19.26%,1
彰化縣,彰化市,0117,136,272,408,19,427,662,64.5%,20.54%,1
彰化縣,彰化市,0118,113,275,388,16,404,633,63.82%,17.85%,1
彰化縣,彰化市,0119,187,371,558,33,591,906,65.23%,20.64%,1
彰化縣,彰化市,0120,145,327,472,25,497,853,58.26%,17%,1
彰化縣,彰化市,0121,190,425,615,31,646,1027,62.9%,18.5%,1
彰化縣,彰化市,0122,186,420,606,32,638,993,64.25%,18.73%,1
彰化縣,彰化市,0123,148,339,487,34,521,848,61.44%,17.45%,1
彰化縣,彰化市,0124,218,479,697,12,709,1118,63.42%,19.5%,1
彰化縣,彰化市,0125,231,508,739,35,774,1263,61.28%,18.29%,1
彰化縣,彰化市,0126,218,545,763,35,798,1268,62.93%,17.19%,1
彰化縣,彰化市,0127,223,521,744,30,774,1258,61.53%,17.73%,1
彰化縣,彰化市,0128,223,518,741,16,757,1212,62.46%,18.4%,1
彰化縣,彰化市,0129,164,377,541,33,574,924,62.12%,17.75%,1
彰化縣,彰化市,0130,181,394,575,23,598,939,63.68%,19.28%,1
彰化縣,彰化市,0131,193,395,588,53,641,953,67.26%,20.25%,1
彰化縣,彰化市,0132,181,439,620,29,649,981,66.16%,18.45%,1
彰化縣,彰化市,0133,227,513,740,50,790,1249,63.25%,18.17%,1
彰化縣,彰化市,0134,139,327,466,43,509,817,62.3%,17.01%,1
彰化縣,彰化市,0135,163,339,502,30,532,872,61.01%,18.69%,1
彰化縣,彰化市,0136,125,262,387,20,407,689,59.07%,18.14%,1
彰化縣,彰化市,0137,217,484,701,26,727,1156,62.89%,18.77%,1
彰化縣,彰化市,0138,231,489,720,23,743,1291,57.55%,17.89%,1
彰化縣,彰化市,0139,193,449,642,26,668,1139,58.65%,16.94%,1
彰化縣,彰化市,0140,212,457,669,28,697,1125,61.96%,18.84%,1
彰化縣,彰化市,0141,196,485,681,37,718,1258,57.07%,15.58%,1
彰化縣,彰化市,0142,192,445,637,30,667,1123,59.39%,17.1%,1
彰化縣,彰化市,0143,197,458,655,49,704,1175,59.91%,16.77%,1
彰化縣,彰化市,0144,170,369,539,32,571,862,66.24%,19.72%,1
彰化縣,彰化市,0145,170,336,506,22,528,872,60.55%,19.5%,1
彰化縣,彰化市,0146,158,384,542,37,579,897,64.55%,17.61%,1
彰化縣,彰化市,0147,170,405,575,20,595,1003,59.32%,16.95%,1
彰化縣,彰化市,0148,157,350,507,19,526,915,57.49%,17.16%,1
彰化縣,彰化市,0149,211,420,631,37,668,1158,57.69%,18.22%,1
彰化縣,彰化市,0150,210,441,651,33,684,1084,63.1%,19.37%,1
彰化縣,彰化市,0151,239,487,726,51,777,1372,56.63%,17.42%,1
彰化縣,彰化市,0152,163,484,647,30,677,1113,60.83%,14.65%,1
彰化縣,彰化市,0153,122,347,469,38,507,800,63.38%,15.25%,1
彰化縣,彰化市,0154,155,342,497,40,537,885,60.68%,17.51%,1
彰化縣,彰化市,0155,184,426,610,8,618,1000,61.8%,18.4%,1
彰化縣,彰化市,0156,203,419,622,28,650,1159,56.08%,17.52%,1
彰化縣,彰化市,0157,195,419,614,29,643,1123,57.26%,17.36%,1
彰化縣,彰化市,0158,191,369,560,43,603,907,66.48%,21.06%,1
彰化縣,彰化市,0159,153,369,522,41,563,989,56.93%,15.47%,1
彰化縣,彰化市,0160,191,408,599,44,643,1012,63.54%,18.87%,1
彰化縣,彰化市,0161,150,401,551,20,571,1033,55.28%,14.52%,1
彰化縣,彰化市,0162,210,440,650,35,685,1116,61.38%,18.82%,1
彰化縣,彰化市,0163,205,485,690,22,712,1154,61.7%,17.76%,1
彰化縣,彰化市,0164,199,421,620,37,657,1064,61.75%,18.7%,1
彰化縣,彰化市,0165,129,341,470,36,506,770,65.71%,16.75%,1
彰化縣,彰化市,0166,194,334,528,29,557,889,62.65%,21.82%,1
彰化縣,彰化市,0167,133,320,453,49,502,786,63.87%,16.92%,1
彰化縣,彰化市,0168,175,407,582,37,619,1120,55.27%,15.63%,1
彰化縣,彰化市,0169,193,472,665,29,694,1269,54.69%,15.21%,1
彰化縣,彰化市,0170,192,477,669,37,706,1159,60.91%,16.57%,1
彰化縣,彰化市,0171,295,363,658,69,727,1184,61.4%,24.92%,1
彰化縣,彰化市,0172,191,405,596,38,634,1089,58.22%,17.54%,1
彰化縣,彰化市,0173,171,388,559,45,604,968,62.4%,17.67%,1
彰化縣,彰化市,0174,158,365,523,24,547,930,58.82%,16.99%,1
彰化縣,彰化市,0175,157,389,546,22,568,973,58.38%,16.14%,1
彰化縣,彰化市,0176,207,383,590,26,616,1184,52.03%,17.48%,1
彰化縣,彰化市,0177,165,396,561,52,613,1002,61.18%,16.47%,1
彰化縣,彰化市,0178,177,450,627,22,649,1148,56.53%,15.42%,1
彰化縣,彰化市,0179,191,424,615,31,646,1112,58.09%,17.18%,1
彰化縣,彰化市,0180,180,406,586,39,625,907,68.91%,19.85%,1
彰化縣,彰化市,0181,183,444,627,54,681,1112,61.24%,16.46%,1
彰化縣,彰化市,0182,124,294,418,32,450,823,54.68%,15.07%,1
彰化縣,彰化市,0183,220,478,698,61,759,1276,59.48%,17.24%,1
彰化縣,彰化市,0184,191,442,633,33,666,1161,57.36%,16.45%,1
彰化縣,鹿港鎮,0243,212,458,670,44,714,1140,62.63%,18.6%,1
彰化縣,鹿港鎮,0244,96,190,286,20,306,511,59.88%,18.79%,1
彰化縣,鹿港鎮,0245,241,172,413,16,429,857,50.06%,28.12%,1
彰化縣,鹿港鎮,0246,169,392,561,50,611,946,64.59%,17.86%,1
彰化縣,鹿港鎮,0247,177,354,531,33,564,945,59.68%,18.73%,1
彰化縣,鹿港鎮,0248,185,437,622,36,658,1097,59.98%,16.86%,1
彰化縣,鹿港鎮,0249,250,464,714,24,738,1479,49.9%,16.9%,1
彰化縣,鹿港鎮,0250,235,559,794,63,857,1425,60.14%,16.49%,1
彰化縣,鹿港鎮,0251,171,329,500,60,560,880,63.64%,19.43%,1
彰化縣,鹿港鎮,0252,195,423,618,52,670,1183,56.64%,16.48%,1
彰化縣,鹿港鎮,0253,189,409,598,49,647,1047,61.8%,18.05%,1
彰化縣,鹿港鎮,0254,282,300,582,23,605,1097,55.15%,25.71%,1
彰化縣,鹿港鎮,0255,152,387,539,54,593,1030,57.57%,14.76%,1
彰化縣,鹿港鎮,0256,199,435,634,37,671,1161,57.8%,17.14%,1
彰化縣,鹿港鎮,0257,97,209,306,35,341,540,63.15%,17.96%,1
彰化縣,鹿港鎮,0258,192,411,603,45,648,1135,57.09%,16.92%,1
彰化縣,鹿港鎮,0259,160,451,611,58,669,1155,57.92%,13.85%,1
彰化縣,鹿港鎮,0260,217,445,662,36,698,1127,61.93%,19.25%,1
彰化縣,鹿港鎮,0261,195,386,581,44,625,1045,59.81%,18.66%,1
彰化縣,鹿港鎮,0262,197,413,610,57,667,1127,59.18%,17.48%,1
彰化縣,鹿港鎮,0263,211,508,719,38,757,1178,64.26%,17.91%,1
彰化縣,鹿港鎮,0264,51,107,158,11,169,284,59.51%,17.96%,1
彰化縣,鹿港鎮,0265,112,212,324,23,347,584,59.42%,19.18%,1
彰化縣,鹿港鎮,0266,104,295,399,36,435,659,66.01%,15.78%,1
彰化縣,鹿港鎮,0267,177,339,516,21,537,915,58.69%,19.34%,1
彰化縣,鹿港鎮,0268,206,428,634,45,679,1079,62.93%,19.09%,1
彰化縣,鹿港鎮,0269,209,467,676,56,732,1129,64.84%,18.51%,1
彰化縣,鹿港鎮,0270,160,503,663,44,707,1273,55.54%,12.57%,1
彰化縣,鹿港鎮,0271,93,256,349,29,378,706,53.54%,13.17%,1
彰化縣,鹿港鎮,0272,190,354,544,87,631,1137,55.5%,16.71%,1
彰化縣,鹿港鎮,0273,199,421,620,41,661,1195,55.31%,16.65%,1
彰化縣,鹿港鎮,0274,178,437,615,47,662,1225,54.04%,14.53%,1
彰化縣,鹿港鎮,0275,164,421,585,45,630,957,65.83%,17.14%,1
彰化縣,鹿港鎮,0276,101,253,354,53,407,758,53.69%,13.32%,1
彰化縣,鹿港鎮,0277,112,279,391,47,438,723,60.58%,15.49%,1
彰化縣,鹿港鎮,0278,142,382,524,21,545,984,55.39%,14.43%,1
彰化縣,鹿港鎮,0279,148,467,615,27,642,1018,63.06%,14.54%,1
彰化縣,鹿港鎮,0280,181,424,605,40,645,1165,55.36%,15.54%,1
彰化縣,鹿港鎮,0281,157,407,564,46,610,1161,52.54%,13.52%,1
彰化縣,鹿港鎮,0282,152,365,517,45,562,1020,55.1%,14.9%,1
彰化縣,鹿港鎮,0283,148,414,562,54,616,1068,57.68%,13.86%,1
彰化縣,鹿港鎮,0284,139,456,595,28,623,1024,60.84%,13.57%,1
彰化縣,鹿港鎮,0285,170,369,539,62,601,974,61.7%,17.45%,1
彰化縣,鹿港鎮,0286,249,510,759,60,819,1505,54.42%,16.54%,1
彰化縣,鹿港鎮,0287,186,374,560,44,604,1092,55.31%,17.03%,1
彰化縣,鹿港鎮,0288,203,481,684,58,742,1223,60.67%,16.6%,1
彰化縣,鹿港鎮,0289,193,564,757,32,789,1572,50.19%,12.28%,1
彰化縣,鹿港鎮,0290,171,407,578,41,619,1003,61.71%,17.05%,1
彰化縣,鹿港鎮,0291,136,394,530,29,559,933,59.91%,14.58%,1
彰化縣,鹿港鎮,0292,168,447,615,48,663,1093,60.66%,15.37%,1
彰化縣,鹿港鎮,0293,143,352,495,20,515,907,56.78%,15.77%,1
彰化縣,鹿港鎮,0294,172,462,634,37,671,1219,55.05%,14.11%,1
彰化縣,鹿港鎮,0295,227,614,841,48,889,1397,63.64%,16.25%,1
彰化縣,鹿港鎮,0296,152,519,671,33,704,1229,57.28%,12.37%,1
彰化縣,鹿港鎮,0297,187,577,764,34,798,1444,55.26%,12.95%,1
彰化縣,鹿港鎮,0298,191,503,694,40,734,1227,59.82%,15.57%,1
彰化縣,鹿港鎮,0299,156,514,670,50,720,1187,60.66%,13.14%,1
彰化縣,鹿港鎮,0300,187,496,683,26,709,1296,54.71%,14.43%,1
彰化縣,鹿港鎮,0301,239,472,711,45,756,1451,52.1%,16.47%,1
彰化縣,鹿港鎮,0302,214,456,670,65,735,1299,56.58%,16.47%,1
彰化縣,鹿港鎮,0303,224,556,780,28,808,1298,62.25%,17.26%,1
彰化縣,鹿港鎮,0304,227,577,804,39,843,1458,57.82%,15.57%,1
彰化縣,鹿港鎮,0305,200,437,637,47,684,1138,60.11%,17.57%,1
彰化縣,鹿港鎮,0306,193,452,645,49,694,1170,59.32%,16.5%,1
彰化縣,鹿港鎮,0307,184,517,701,42,743,1221,60.85%,15.07%,1
彰化縣,和美鎮,0373,232,470,702,36,738,1341,55.03%,17.3%,1
彰化縣,和美鎮,0374,232,492,724,47,771,1480,52.09%,15.68%,1
彰化縣,和美鎮,0375,262,560,822,38,860,1529,56.25%,17.14%,1
彰化縣,和美鎮,0376,290,583,873,9,882,1711,51.55%,16.95%,1
彰化縣,和美鎮,0377,217,372,589,27,616,1057,58.28%,20.53%,1
彰化縣,和美鎮,0378,219,362,581,37,618,1032,59.88%,21.22%,1
彰化縣,和美鎮,0379,162,423,585,38,623,1015,61.38%,15.96%,1
彰化縣,和美鎮,0380,231,467,698,38,736,1209,60.88%,19.11%,1
彰化縣,和美鎮,0381,101,136,237,14,251,430,58.37%,23.49%,1
彰化縣,和美鎮,0382,153,315,468,16,484,856,56.54%,17.87%,1
彰化縣,和美鎮,0383,155,400,555,28,583,966,60.35%,16.05%,1
彰化縣,和美鎮,0384,185,372,557,25,582,1059,54.96%,17.47%,1
彰化縣,和美鎮,0385,215,397,612,27,639,1117,57.21%,19.25%,1
彰化縣,和美鎮,0386,156,396,552,39,591,1066,55.44%,14.63%,1
彰化縣,和美鎮,0387,235,423,658,25,683,1252,54.55%,18.77%,1
彰化縣,和美鎮,0388,257,510,767,40,807,1528,52.81%,16.82%,1
彰化縣,和美鎮,0389,158,312,470,25,495,826,59.93%,19.13%,1
彰化縣,和美鎮,0390,141,318,459,25,484,854,56.67%,16.51%,1
彰化縣,和美鎮,0391,223,486,709,39,748,1387,53.93%,16.08%,1
彰化縣,和美鎮,0392,120,344,464,15,479,765,62.61%,15.69%,1
彰化縣,和美鎮,0393,207,502,709,45,754,1438,52.43%,14.39%,1
彰化縣,和美鎮,0394,235,553,788,43,831,1396,59.53%,16.83%,1
彰化縣,和美鎮,0395,96,275,371,16,387,658,58.81%,14.59%,1
彰化縣,和美鎮,0396,143,346,489,26,515,809,63.66%,17.68%,1
彰化縣,和美鎮,0397,155,334,489,5,494,932,53%,16.63%,1
彰化縣,和美鎮,0398,132,322,454,32,486,888,54.73%,14.86%,1
彰化縣,和美鎮,0399,386,285,671,28,699,1144,61.1%,33.74%,1
彰化縣,和美鎮,0400,169,411,580,35,615,1077,57.1%,15.69%,1
彰化縣,和美鎮,0401,207,452,659,52,711,1349,52.71%,15.34%,1
彰化縣,和美鎮,0402,191,500,691,34,725,1155,62.77%,16.54%,1
彰化縣,和美鎮,0403,189,472,661,37,698,1253,55.71%,15.08%,1
彰化縣,和美鎮,0404,186,468,654,36,690,1252,55.11%,14.86%,1
彰化縣,和美鎮,0405,270,500,770,27,797,1474,54.07%,18.32%,1
彰化縣,和美鎮,0406,223,465,688,29,717,1396,51.36%,15.97%,1
彰化縣,和美鎮,0407,212,483,695,30,725,1348,53.78%,15.73%,1
彰化縣,和美鎮,0408,163,427,590,31,621,999,62.16%,16.32%,1
彰化縣,和美鎮,0409,165,348,513,34,547,911,60.04%,18.11%,1
彰化縣,和美鎮,0410,186,380,566,29,595,1005,59.2%,18.51%,1
彰化縣,和美鎮,0411,152,376,528,36,564,967,58.32%,15.72%,1
彰化縣,和美鎮,0412,204,526,730,38,768,1308,58.72%,15.6%,1
彰化縣,和美鎮,0413,213,501,714,37,751,1324,56.72%,16.09%,1
彰化縣,和美鎮,0414,205,410,615,43,658,1102,59.71%,18.6%,1
彰化縣,和美鎮,0415,179,389,568,45,613,1124,54.54%,15.93%,1
彰化縣,和美鎮,0416,200,455,655,50,705,1211,58.22%,16.52%,1
彰化縣,和美鎮,0417,154,400,554,39,593,884,67.08%,17.42%,1
彰化縣,和美鎮,0418,184,407,591,61,652,1119,58.27%,16.44%,1
彰化縣,和美鎮,0419,223,475,698,37,735,1300,56.54%,17.15%,1
彰化縣,和美鎮,0420,183,397,580,26,606,1104,54.89%,16.58%,1
彰化縣,和美鎮,0421,216,481,697,42,739,1213,60.92%,17.81%,1
彰化縣,和美鎮,0422,186,369,555,37,592,1127,52.53%,16.5%,1
彰化縣,和美鎮,0423,158,329,487,39,526,919,57.24%,17.19%,1
彰化縣,和美鎮,0424,170,392,562,34,596,987,60.39%,17.22%,1
彰化縣,和美鎮,0425,160,399,559,34,593,958,61.9%,16.7%,1
彰化縣,和美鎮,0426,220,541,761,33,794,1362,58.3%,16.15%,1
彰化縣,和美鎮,0427,263,525,788,23,811,1461,55.51%,18%,1
彰化縣,和美鎮,0428,258,534,792,20,812,1405,57.79%,18.36%,1
彰化縣,和美鎮,0429,161,339,500,20,520,860,60.47%,18.72%,1
彰化縣,和美鎮,0430,128,344,472,22,494,875,56.46%,14.63%,1
彰化縣,和美鎮,0431,157,305,462,44,506,871,58.09%,18.03%,1
彰化縣,和美鎮,0432,151,368,519,33,552,883,62.51%,17.1%,1
彰化縣,和美鎮,0433,226,407,633,56,689,1224,56.29%,18.46%,1
彰化縣,和美鎮,0434,178,384,562,40,602,1075,56%,16.56%,1
彰化縣,和美鎮,0435,170,343,513,31,544,956,56.9%,17.78%,1
彰化縣,和美鎮,0436,184,360,544,36,580,1037,55.93%,17.74%,1
彰化縣,和美鎮,0437,181,372,553,22,575,1011,56.87%,17.9%,1
彰化縣,和美鎮,0438,179,361,540,39,579,1023,56.6%,17.5%,1
彰化縣,和美鎮,0439,105,268,373,22,395,719,54.94%,14.6%,1
彰化縣,和美鎮,0440,144,333,477,39,516,913,56.52%,15.77%,1
彰化縣,線西鄉,0469,183,415,598,19,617,1071,57.61%,17.09%,1
彰化縣,線西鄉,0470,210,465,675,26,701,1166,60.12%,18.01%,1
彰化縣,線西鄉,0471,197,496,693,63,756,1269,59.57%,15.52%,1
彰化縣,線西鄉,0472,168,445,613,38,651,1138,57.21%,14.76%,1
彰化縣,線西鄉,0473,186,475,661,62,723,1128,64.1%,16.49%,1
彰化縣,線西鄉,0474,199,514,713,56,769,1275,60.31%,15.61%,1
彰化縣,線西鄉,0475,213,457,670,38,708,1187,59.65%,17.94%,1
彰化縣,線西鄉,0476,144,406,550,52,602,991,60.75%,14.53%,1
彰化縣,線西鄉,0477,178,338,516,47,563,938,60.02%,18.98%,1
彰化縣,線西鄉,0478,195,445,640,47,687,1276,53.84%,15.28%,1
彰化縣,線西鄉,0479,211,503,714,44,758,1285,58.99%,16.42%,1
彰化縣,線西鄉,0480,239,586,825,15,840,1341,62.64%,17.82%,1
彰化縣,伸港鄉,0441,178,373,551,53,604,1182,51.1%,15.06%,1
彰化縣,伸港鄉,0442,185,501,686,33,719,1166,61.66%,15.87%,1
彰化縣,伸港鄉,0443,155,374,529,33,562,966,58.18%,16.05%,1
彰化縣,伸港鄉,0444,154,303,457,33,490,873,56.13%,17.64%,1
彰化縣,伸港鄉,0445,125,328,453,38,491,812,60.47%,15.39%,1
彰化縣,伸港鄉,0446,123,328,451,40,491,875,56.11%,14.06%,1
彰化縣,伸港鄉,0447,148,317,465,47,512,904,56.64%,16.37%,1
彰化縣,伸港鄉,0448,164,359,523,37,560,1008,55.56%,16.27%,1
彰化縣,伸港鄉,0449,200,437,637,44,681,1154,59.01%,17.33%,1
彰化縣,伸港鄉,0450,219,497,716,66,782,1486,52.62%,14.74%,1
彰化縣,伸港鄉,0451,159,415,574,36,610,1095,55.71%,14.52%,1
彰化縣,伸港鄉,0452,139,401,540,18,558,1087,51.33%,12.79%,1
彰化縣,伸港鄉,0453,184,407,591,57,648,1085,59.72%,16.96%,1
彰化縣,伸港鄉,0454,162,355,517,26,543,908,59.8%,17.84%,1
彰化縣,伸港鄉,0455,201,520,721,41,762,1264,60.28%,15.9%,1
彰化縣,伸港鄉,0456,145,285,430,46,476,854,55.74%,16.98%,1
彰化縣,伸港鄉,0457,112,291,403,24,427,846,50.47%,13.24%,1
彰化縣,伸港鄉,0458,178,351,529,81,610,1143,53.37%,15.57%,1
彰化縣,伸港鄉,0459,240,492,732,28,760,1357,56.01%,17.69%,1
彰化縣,伸港鄉,0460,221,489,710,47,757,1349,56.12%,16.38%,1
彰化縣,伸港鄉,0461,191,446,637,42,679,1154,58.84%,16.55%,1
彰化縣,伸港鄉,0462,227,433,660,32,692,1279,54.1%,17.75%,1
彰化縣,伸港鄉,0463,240,479,719,55,774,1317,58.77%,18.22%,1
彰化縣,伸港鄉,0464,151,413,564,43,607,990,61.31%,15.25%,1
彰化縣,伸港鄉,0465,182,296,478,30,508,852,59.62%,21.36%,1
彰化縣,伸港鄉,0466,212,449,661,25,686,1178,58.23%,18%,1
彰化縣,伸港鄉,0467,151,404,555,64,619,1088,56.89%,13.88%,1
彰化縣,伸港鄉,0468,212,398,610,40,650,1135,57.27%,18.68%,1
彰化縣,福興鄉,0308,254,422,676,50,726,1363,53.26%,18.64%,1
彰化縣,福興鄉,0309,153,294,447,23,470,821,57.25%,18.64%,1
彰化縣,福興鄉,0310,182,424,606,57,663,1256,52.79%,14.49%,1
彰化縣,福興鄉,0311,188,377,565,73,638,1166,54.72%,16.12%,1
彰化縣,福興鄉,0312,203,509,712,52,764,1464,52.19%,13.87%,1
彰化縣,福興鄉,0313,199,424,623,39,662,1251,52.92%,15.91%,1
彰化縣,福興鄉,0314,227,504,731,48,779,1465,53.17%,15.49%,1
彰化縣,福興鄉,0315,140,319,459,21,480,960,50%,14.58%,1
彰化縣,福興鄉,0316,238,424,662,56,718,1323,54.27%,17.99%,1
彰化縣,福興鄉,0317,233,485,718,38,756,1365,55.38%,17.07%,1
彰化縣,福興鄉,0318,181,452,633,42,675,1458,46.3%,12.41%,1
彰化縣,福興鄉,0319,193,536,729,62,791,1492,53.02%,12.94%,1
彰化縣,福興鄉,0320,134,301,435,22,457,888,51.46%,15.09%,1
彰化縣,福興鄉,0321,186,394,580,54,634,1054,60.15%,17.65%,1
彰化縣,福興鄉,0322,134,340,474,46,520,1043,49.86%,12.85%,1
彰化縣,福興鄉,0323,190,489,679,61,740,1340,55.22%,14.18%,1
彰化縣,福興鄉,0324,202,332,534,38,572,1085,52.72%,18.62%,1
彰化縣,福興鄉,0325,186,515,701,38,739,1392,53.09%,13.36%,1
彰化縣,福興鄉,0326,216,499,715,59,774,1316,58.81%,16.41%,1
彰化縣,福興鄉,0327,193,523,716,39,755,1255,60.16%,15.38%,1
彰化縣,福興鄉,0328,460,184,644,31,675,1101,61.31%,41.78%,1
彰化縣,福興鄉,0329,157,439,596,62,658,1167,56.38%,13.45%,1
彰化縣,福興鄉,0330,289,380,669,66,735,1393,52.76%,20.75%,1
彰化縣,福興鄉,0331,178,474,652,45,697,1216,57.32%,14.64%,1
彰化縣,福興鄉,0332,142,400,542,33,575,1063,54.09%,13.36%,1
彰化縣,福興鄉,0333,195,467,662,42,704,1306,53.91%,14.93%,1
彰化縣,福興鄉,0334,165,386,551,53,604,1287,46.93%,12.82%,1
彰化縣,福興鄉,0335,137,394,531,28,559,994,56.24%,13.78%,1
彰化縣,福興鄉,0336,187,497,684,60,744,1311,56.75%,14.26%,1
彰化縣,福興鄉,0337,137,383,520,34,554,926,59.83%,14.79%,1
彰化縣,福興鄉,0338,159,330,489,32,521,995,52.36%,15.98%,1
彰化縣,福興鄉,0339,169,432,601,69,670,1079,62.09%,15.66%,1
彰化縣,福興鄉,0340,161,386,547,60,607,1150,52.78%,14%,1
彰化縣,秀水鄉,0341,171,416,587,82,669,1066,62.76%,16.04%,1
彰化縣,秀水鄉,0342,117,243,360,37,397,620,64.03%,18.87%,1
彰化縣,秀水鄉,0343,145,288,433,14,447,876,51.03%,16.55%,1
彰化縣,秀水鄉,0344,234,469,703,33,736,1196,61.54%,19.57%,1
彰化縣,秀水鄉,0345,246,509,755,35,790,1369,57.71%,17.97%,1
彰化縣,秀水鄉,0346,207,498,705,51,756,1273,59.39%,16.26%,1
彰化縣,秀水鄉,0347,127,639,766,40,806,1433,56.25%,8.86%,1
彰化縣,秀水鄉,0348,176,371,547,29,576,967,59.57%,18.2%,1
彰化縣,秀水鄉,0349,170,354,524,20,544,921,59.07%,18.46%,1
彰化縣,秀水鄉,0350,130,280,410,24,434,689,62.99%,18.87%,1
彰化縣,秀水鄉,0351,116,266,382,39,421,688,61.19%,16.86%,1
彰化縣,秀水鄉,0352,243,490,733,48,781,1252,62.38%,19.41%,1
彰化縣,秀水鄉,0353,220,457,677,32,709,1281,55.35%,17.17%,1
彰化縣,秀水鄉,0354,112,292,404,23,427,754,56.63%,14.85%,1
彰化縣,秀水鄉,0355,187,363,550,37,587,1024,57.32%,18.26%,1
彰化縣,秀水鄉,0356,222,541,763,20,783,1433,54.64%,15.49%,1
彰化縣,秀水鄉,0357,254,579,833,50,883,1366,64.64%,18.59%,1
彰化縣,秀水鄉,0358,138,366,504,42,546,895,61.01%,15.42%,1
彰化縣,秀水鄉,0359,225,467,692,54,746,1386,53.82%,16.23%,1
彰化縣,秀水鄉,0360,146,338,484,60,544,896,60.71%,16.29%,1
彰化縣,秀水鄉,0361,156,343,499,36,535,804,66.54%,19.4%,1
彰化縣,秀水鄉,0362,137,354,491,29,520,827,62.88%,16.57%,1
彰化縣,秀水鄉,0363,178,373,551,43,594,996,59.64%,17.87%,1
彰化縣,秀水鄉,0364,175,398,573,45,618,931,66.38%,18.8%,1
彰化縣,秀水鄉,0365,127,260,387,20,407,715,56.92%,17.76%,1
彰化縣,秀水鄉,0366,196,510,706,62,768,1229,62.49%,15.95%,1
彰化縣,秀水鄉,0367,111,321,432,32,464,890,52.13%,12.47%,1
彰化縣,秀水鄉,0368,360,124,484,25,509,811,62.76%,44.39%,1
彰化縣,秀水鄉,0369,124,331,455,32,487,786,61.96%,15.78%,1
彰化縣,秀水鄉,0370,136,374,510,32,542,931,58.22%,14.61%,1
彰化縣,秀水鄉,0371,170,552,722,51,773,1265,61.11%,13.44%,1
彰化縣,秀水鄉,0372,122,295,417,48,465,824,56.43%,14.81%,1
彰化縣,花壇鄉,0185,139,360,499,48,547,901,60.71%,15.43%,1
彰化縣,花壇鄉,0186,199,421,620,30,650,1042,62.38%,19.1%,1
彰化縣,花壇鄉,0187,220,488,708,11,719,1314,54.72%,16.74%,1
彰化縣,花壇鄉,0188,119,341,460,39,499,808,61.76%,14.73%,1
彰化縣,花壇鄉,0189,156,404,560,30,590,1019,57.9%,15.31%,1
彰化縣,花壇鄉,0190,192,466,658,52,710,1144,62.06%,16.78%,1
彰化縣,花壇鄉,0191,156,492,648,91,739,1240,59.6%,12.58%,1
彰化縣,花壇鄉,0192,192,635,827,54,881,1425,61.82%,13.47%,1
彰化縣,花壇鄉,0193,187,479,666,37,703,1095,64.2%,17.08%,1
彰化縣,花壇鄉,0194,139,369,508,36,544,910,59.78%,15.27%,1
彰化縣,花壇鄉,0195,164,431,595,23,618,982,62.93%,16.7%,1
彰化縣,花壇鄉,0196,201,411,612,14,626,1070,58.5%,18.79%,1
彰化縣,花壇鄉,0197,136,223,359,24,383,700,54.71%,19.43%,1
彰化縣,花壇鄉,0198,145,329,474,31,505,764,66.1%,18.98%,1
彰化縣,花壇鄉,0199,164,411,575,32,607,953,63.69%,17.21%,1
彰化縣,花壇鄉,0200,160,376,536,21,557,974,57.19%,16.43%,1
彰化縣,花壇鄉,0201,176,426,602,45,647,1111,58.24%,15.84%,1
彰化縣,花壇鄉,0202,154,460,614,59,673,1101,61.13%,13.99%,1
彰化縣,花壇鄉,0203,68,526,594,27,621,1110,55.95%,6.13%,1
彰化縣,花壇鄉,0204,233,467,700,39,739,1262,58.56%,18.46%,1
彰化縣,花壇鄉,0205,236,389,625,28,653,1103,59.2%,21.4%,1
彰化縣,花壇鄉,0206,198,457,655,51,706,1347,52.41%,14.7%,1
彰化縣,花壇鄉,0207,168,430,598,37,635,1169,54.32%,14.37%,1
彰化縣,花壇鄉,0208,211,511,722,46,768,1274,60.28%,16.56%,1
彰化縣,花壇鄉,0209,202,569,771,21,792,1280,61.88%,15.78%,1
彰化縣,花壇鄉,0210,177,515,692,37,729,1244,58.6%,14.23%,1
彰化縣,花壇鄉,0211,193,436,629,52,681,1159,58.76%,16.65%,1
彰化縣,花壇鄉,0212,211,417,628,30,658,1042,63.15%,20.25%,1
彰化縣,花壇鄉,0213,159,434,593,38,631,1111,56.8%,14.31%,1
彰化縣,花壇鄉,0214,160,370,530,38,568,893,63.61%,17.92%,1
彰化縣,花壇鄉,0215,155,371,526,45,571,953,59.92%,16.26%,1
彰化縣,花壇鄉,0216,167,339,506,27,533,987,54%,16.92%,1
彰化縣,花壇鄉,0217,172,394,566,37,603,925,65.19%,18.59%,1
彰化縣,花壇鄉,0218,139,384,523,25,548,951,57.62%,14.62%,1
彰化縣,花壇鄉,0219,149,371,520,25,545,955,57.07%,15.6%,1
彰化縣,花壇鄉,0220,120,367,487,29,516,895,57.65%,13.41%,1
彰化縣,花壇鄉,0221,107,293,400,20,420,711,59.07%,15.05%,1
彰化縣,芬園鄉,0222,146,353,499,37,536,958,55.95%,15.24%,1
彰化縣,芬園鄉,0223,119,296,415,42,457,794,57.56%,14.99%,1
彰化縣,芬園鄉,0224,214,452,666,81,747,1415,52.79%,15.12%,1
彰化縣,芬園鄉,0225,150,388,538,31,569,927,61.38%,16.18%,1
彰化縣,芬園鄉,0226,118,327,445,29,474,831,57.04%,14.2%,1
彰化縣,芬園鄉,0227,89,224,313,19,332,570,58.25%,15.61%,1
彰化縣,芬園鄉,0228,219,384,603,51,654,1227,53.3%,17.85%,1
彰化縣,芬園鄉,0229,176,442,618,65,683,1238,55.17%,14.22%,1
彰化縣,芬園鄉,0230,215,508,723,62,785,1362,57.64%,15.79%,1
彰化縣,芬園鄉,0231,141,377,518,67,585,989,59.15%,14.26%,1
彰化縣,芬園鄉,0232,176,445,621,50,671,1054,63.66%,16.7%,1
彰化縣,芬園鄉,0233,110,260,370,32,402,607,66.23%,18.12%,1
彰化縣,芬園鄉,0234,146,354,500,36,536,882,60.77%,16.55%,1
彰化縣,芬園鄉,0235,141,380,521,37,558,1143,48.82%,12.34%,1
彰化縣,芬園鄉,0236,89,219,308,12,320,661,48.41%,13.46%,1
彰化縣,芬園鄉,0237,109,302,411,7,418,838,49.88%,13.01%,1
彰化縣,芬園鄉,0238,126,292,418,28,446,847,52.66%,14.88%,1
彰化縣,芬園鄉,0239,133,409,542,50,592,987,59.98%,13.48%,1
彰化縣,芬園鄉,0240,167,413,580,62,642,1217,52.75%,13.72%,1
彰化縣,芬園鄉,0241,111,287,398,52,450,865,52.02%,12.83%,1
彰化縣,芬園鄉,0242,150,330,480,35,515,996,51.71%,15.06%,1
彰化縣,員林市,0481,129,424,553,20,573,1087,52.71%,11.87%,1
彰化縣,員林市,0482,194,484,678,31,709,1353,52.4%,14.34%,1
彰化縣,員林市,0483,211,448,659,40,699,1313,53.24%,16.07%,1
彰化縣,員林市,0484,176,433,609,29,638,1328,48.04%,13.25%,1
彰化縣,員林市,0485,181,393,574,26,600,1055,56.87%,17.16%,1
彰化縣,員林市,0486,154,340,494,36,530,959,55.27%,16.06%,1
彰化縣,員林市,0487,133,284,417,34,451,772,58.42%,17.23%,1
彰化縣,員林市,0488,143,339,482,29,511,831,61.49%,17.21%,1
彰化縣,員林市,0489,108,257,365,11,376,854,44.03%,12.65%,1
彰化縣,員林市,0490,134,375,509,55,564,1190,47.39%,11.26%,1
彰化縣,員林市,0491,98,276,374,23,397,726,54.68%,13.5%,1
彰化縣,員林市,0492,202,400,602,31,633,1124,56.32%,17.97%,1
彰化縣,員林市,0493,156,264,420,33,453,860,52.67%,18.14%,1
彰化縣,員林市,0494,202,451,653,31,684,1122,60.96%,18%,1
彰化縣,員林市,0495,180,413,593,46,639,1075,59.44%,16.74%,1
彰化縣,員林市,0496,128,369,497,53,550,993,55.39%,12.89%,1
彰化縣,員林市,0497,124,366,490,35,525,967,54.29%,12.82%,1
彰化縣,員林市,0498,164,389,553,33,586,1008,58.13%,16.27%,1
彰化縣,員林市,0499,130,295,425,33,458,804,56.97%,16.17%,1
彰化縣,員林市,0500,158,304,462,23,485,867,55.94%,18.22%,1
彰化縣,員林市,0501,158,315,473,12,485,885,54.8%,17.85%,1
彰化縣,員林市,0502,150,386,536,14,550,1097,50.14%,13.67%,1
彰化縣,員林市,0503,204,468,672,28,700,1255,55.78%,16.25%,1
彰化縣,員林市,0504,194,393,587,32,619,1063,58.23%,18.25%,1
彰化縣,員林市,0505,389,110,499,20,519,925,56.11%,42.05%,1
彰化縣,員林市,0506,148,370,518,41,559,947,59.03%,15.63%,1
彰化縣,員林市,0507,138,380,518,27,545,916,59.5%,15.07%,1
彰化縣,員林市,0508,146,308,454,24,478,862,55.45%,16.94%,1
彰化縣,員林市,0509,179,369,548,17,565,987,57.24%,18.14%,1
彰化縣,員林市,0510,177,387,564,34,598,1085,55.12%,16.31%,1
彰化縣,員林市,0511,188,426,614,23,637,1110,57.39%,16.94%,1
彰化縣,員林市,0512,170,386,556,23,579,1095,52.88%,15.53%,1
彰化縣,員林市,0513,251,503,754,31,785,1278,61.42%,19.64%,1
彰化縣,員林市,0514,190,433,623,32,655,1109,59.06%,17.13%,1
彰化縣,員林市,0515,162,392,554,42,596,1055,56.49%,15.36%,1
彰化縣,員林市,0516,177,310,487,24,511,876,58.33%,20.21%,1
彰化縣,員林市,0517,168,360,528,28,556,1115,49.87%,15.07%,1
彰化縣,員林市,0518,201,460,661,28,689,1186,58.09%,16.95%,1
彰化縣,員林市,0519,154,406,560,42,602,995,60.5%,15.48%,1
彰化縣,員林市,0520,0,536,536,15,551,999,55.16%,0%,1
彰化縣,員林市,0521,214,447,661,26,687,1201,57.2%,17.82%,1
彰化縣,員林市,0522,212,513,725,20,745,1342,55.51%,15.8%,1
彰化縣,員林市,0523,178,389,567,22,589,1086,54.24%,16.39%,1
彰化縣,員林市,0524,128,306,434,23,457,854,53.51%,14.99%,1
彰化縣,員林市,0525,167,418,585,22,607,1064,57.05%,15.7%,1
彰化縣,員林市,0526,167,346,513,14,527,879,59.95%,19%,1
彰化縣,員林市,0527,175,363,538,25,563,827,68.08%,21.16%,1
彰化縣,員林市,0528,154,310,464,14,478,867,55.13%,17.76%,1
彰化縣,員林市,0529,197,452,649,29,678,1201,56.45%,16.4%,1
彰化縣,員林市,0530,200,413,613,33,646,1106,58.41%,18.08%,1
彰化縣,員林市,0531,155,329,484,25,509,845,60.24%,18.34%,1
彰化縣,員林市,0532,173,334,507,20,527,894,58.95%,19.35%,1
彰化縣,員林市,0533,148,330,478,27,505,849,59.48%,17.43%,1
彰化縣,員林市,0534,162,278,440,34,474,747,63.45%,21.69%,1
彰化縣,員林市,0535,181,341,522,26,548,884,61.99%,20.48%,1
彰化縣,員林市,0536,138,312,450,27,477,900,53%,15.33%,1
彰化縣,員林市,0537,146,377,523,23,546,1040,52.5%,14.04%,1
彰化縣,員林市,0538,159,282,441,15,456,831,54.87%,19.13%,1
彰化縣,員林市,0539,125,233,358,30,388,591,65.65%,21.15%,1
彰化縣,員林市,0540,228,465,693,28,721,1330,54.21%,17.14%,1
彰化縣,員林市,0541,232,481,713,24,737,1295,56.91%,17.92%,1
彰化縣,員林市,0542,221,431,652,64,716,1283,55.81%,17.23%,1
彰化縣,員林市,0543,169,381,550,24,574,943,60.87%,17.92%,1
彰化縣,員林市,0544,280,538,818,50,868,1388,62.54%,20.17%,1
彰化縣,員林市,0545,217,444,661,27,688,1176,58.5%,18.45%,1
彰化縣,員林市,0546,132,302,434,7,441,867,50.87%,15.22%,1
彰化縣,員林市,0547,217,377,594,27,621,1121,55.4%,19.36%,1
彰化縣,員林市,0548,191,415,606,23,629,1190,52.86%,16.05%,1
彰化縣,員林市,0549,153,386,539,26,565,945,59.79%,16.19%,1
彰化縣,員林市,0550,154,366,520,25,545,906,60.15%,17%,1
彰化縣,員林市,0551,189,374,563,34,597,978,61.04%,19.33%,1
彰化縣,員林市,0552,133,442,575,30,605,949,63.75%,14.01%,1
彰化縣,員林市,0553,147,405,552,16,568,949,59.85%,15.49%,1
彰化縣,員林市,0554,170,379,549,25,574,1006,57.06%,16.9%,1
彰化縣,員林市,0555,182,310,492,36,528,889,59.39%,20.47%,1
彰化縣,員林市,0556,175,383,558,19,577,923,62.51%,18.96%,1
彰化縣,員林市,0557,244,465,709,39,748,1209,61.87%,20.18%,1
彰化縣,員林市,0558,198,428,626,23,649,1075,60.37%,18.42%,1
彰化縣,員林市,0559,275,515,790,39,829,1342,61.77%,20.49%,1
彰化縣,員林市,0560,234,420,654,39,693,1039,66.7%,22.52%,1
彰化縣,員林市,0561,162,407,569,63,632,1131,55.88%,14.32%,1
彰化縣,員林市,0562,220,456,676,29,705,1356,51.99%,16.22%,1
彰化縣,員林市,0563,243,484,727,44,771,1370,56.28%,17.74%,1
彰化縣,員林市,0564,197,407,604,34,638,1090,58.53%,18.07%,1
彰化縣,員林市,0565,174,338,512,21,533,821,64.92%,21.19%,1
彰化縣,員林市,0566,170,347,517,26,543,910,59.67%,18.68%,1
彰化縣,員林市,0567,194,469,663,24,687,1203,57.11%,16.13%,1
彰化縣,員林市,0568,269,488,757,26,783,1378,56.82%,19.52%,1
彰化縣,員林市,0569,220,523,743,27,770,1352,56.95%,16.27%,1
彰化縣,員林市,0570,194,439,633,20,653,1060,61.6%,18.3%,1
彰化縣,員林市,0571,188,481,669,44,713,1317,54.14%,14.27%,1
彰化縣,員林市,0572,172,411,583,28,611,1120,54.55%,15.36%,1
彰化縣,員林市,0573,133,382,515,39,554,1025,54.05%,12.98%,1
彰化縣,員林市,0574,171,430,601,32,633,1097,57.7%,15.59%,1
彰化縣,員林市,0575,136,362,498,38,536,859,62.4%,15.83%,1
彰化縣,員林市,0576,125,321,446,26,472,837,56.39%,14.93%,1
彰化縣,員林市,0577,210,439,649,35,684,1090,62.75%,19.27%,1
彰化縣,員林市,0578,174,389,563,51,614,1073,57.22%,16.22%,1
彰化縣,溪湖鎮,0640,209,428,637,41,678,1221,55.53%,17.12%,1
彰化縣,溪湖鎮,0641,124,261,385,24,409,638,64.11%,19.44%,1
彰化縣,溪湖鎮,0642,134,314,448,37,485,817,59.36%,16.4%,1
彰化縣,溪湖鎮,0643,160,398,558,27,585,968,60.43%,16.53%,1
彰化縣,溪湖鎮,0644,97,188,285,10,295,448,65.85%,21.65%,1
彰化縣,溪湖鎮,0645,157,440,597,18,615,1123,54.76%,13.98%,1
彰化縣,溪湖鎮,0646,183,438,621,39,660,1166,56.6%,15.69%,1
彰化縣,溪湖鎮,0647,176,437,613,26,639,1151,55.52%,15.29%,1
彰化縣,溪湖鎮,0648,216,488,704,18,722,1249,57.81%,17.29%,1
彰化縣,溪湖鎮,0649,188,445,633,42,675,1146,58.9%,16.4%,1
彰化縣,溪湖鎮,0650,182,481,663,49,712,1199,59.38%,15.18%,1
彰化縣,溪湖鎮,0651,158,320,478,44,522,895,58.32%,17.65%,1
彰化縣,溪湖鎮,0652,154,395,549,27,576,964,59.75%,15.98%,1
彰化縣,溪湖鎮,0653,175,295,470,28,498,851,58.52%,20.56%,1
彰化縣,溪湖鎮,0654,170,418,588,25,613,1072,57.18%,15.86%,1
彰化縣,溪湖鎮,0655,459,168,627,41,668,1113,60.02%,41.24%,1
彰化縣,溪湖鎮,0656,199,417,616,36,652,1090,59.82%,18.26%,1
彰化縣,溪湖鎮,0657,186,502,688,32,720,1193,60.35%,15.59%,1
彰化縣,溪湖鎮,0658,136,418,554,39,593,952,62.29%,14.29%,1
彰化縣,溪湖鎮,0659,184,452,636,41,677,1172,57.76%,15.7%,1
彰化縣,溪湖鎮,0660,194,366,560,32,592,1027,57.64%,18.89%,1
彰化縣,溪湖鎮,0661,211,498,709,37,746,1188,62.79%,17.76%,1
彰化縣,溪湖鎮,0662,221,488,709,49,758,1403,54.03%,15.75%,1
彰化縣,溪湖鎮,0663,190,448,638,60,698,1397,49.96%,13.6%,1
彰化縣,溪湖鎮,0664,289,603,892,44,936,1636,57.21%,17.67%,1
彰化縣,溪湖鎮,0665,215,506,721,55,776,1298,59.78%,16.56%,1
彰化縣,溪湖鎮,0666,177,485,662,53,715,1214,58.9%,14.58%,1
彰化縣,溪湖鎮,0667,233,503,736,40,776,1297,59.83%,17.96%,1
彰化縣,溪湖鎮,0668,177,399,576,29,605,968,62.5%,18.29%,1
彰化縣,溪湖鎮,0669,152,324,476,30,506,839,60.31%,18.12%,1
彰化縣,溪湖鎮,0670,163,346,509,43,552,907,60.86%,17.97%,1
彰化縣,溪湖鎮,0671,135,325,460,17,477,898,53.12%,15.03%,1
彰化縣,溪湖鎮,0672,121,300,421,28,449,650,69.08%,18.62%,1
彰化縣,溪湖鎮,0673,179,499,678,59,737,1279,57.62%,14%,1
彰化縣,溪湖鎮,0674,125,311,436,34,470,730,64.38%,17.12%,1
彰化縣,溪湖鎮,0675,209,567,776,42,818,1407,58.14%,14.85%,1
彰化縣,溪湖鎮,0676,177,412,589,58,647,1273,50.82%,13.9%,1
彰化縣,溪湖鎮,0677,151,366,517,25,542,988,54.86%,15.28%,1
彰化縣,溪湖鎮,0678,142,305,447,34,481,754,63.79%,18.83%,1
彰化縣,溪湖鎮,0679,132,351,483,44,527,1052,50.1%,12.55%,1
彰化縣,溪湖鎮,0680,175,408,583,37,620,1149,53.96%,15.23%,1
彰化縣,溪湖鎮,0681,280,510,790,73,863,1365,63.22%,20.51%,1
彰化縣,田中鎮,0742,128,297,425,55,480,854,56.21%,14.99%,1
彰化縣,田中鎮,0743,132,321,453,39,492,963,51.09%,13.71%,1
彰化縣,田中鎮,0744,11,31,42,3,45,175,25.71%,6.29%,1
彰化縣,田中鎮,0745,101,259,360,34,394,739,53.32%,13.67%,1
彰化縣,田中鎮,0746,119,302,421,25,446,826,54%,14.41%,1
彰化縣,田中鎮,0747,300,116,416,31,447,741,60.32%,40.49%,1
彰化縣,田中鎮,0748,67,166,233,9,242,506,47.83%,13.24%,1
彰化縣,田中鎮,0749,146,330,476,49,525,1001,52.45%,14.59%,1
彰化縣,田中鎮,0750,188,492,680,65,745,1281,58.16%,14.68%,1
彰化縣,田中鎮,0751,162,388,550,43,593,1035,57.29%,15.65%,1
彰化縣,田中鎮,0752,261,480,741,41,782,1327,58.93%,19.67%,1
彰化縣,田中鎮,0753,146,346,492,30,522,844,61.85%,17.3%,1
彰化縣,田中鎮,0754,132,368,500,35,535,913,58.6%,14.46%,1
彰化縣,田中鎮,0755,84,287,371,35,406,613,66.23%,13.7%,1
彰化縣,田中鎮,0756,218,550,768,45,813,1382,58.83%,15.77%,1
彰化縣,田中鎮,0757,177,459,636,37,673,1034,65.09%,17.12%,1
彰化縣,田中鎮,0758,162,418,580,37,617,935,65.99%,17.33%,1
彰化縣,田中鎮,0759,216,397,613,40,653,1301,50.19%,16.6%,1
彰化縣,田中鎮,0760,174,458,632,33,665,1100,60.45%,15.82%,1
彰化縣,田中鎮,0761,204,413,617,35,652,1071,60.88%,19.05%,1
彰化縣,田中鎮,0762,200,494,694,39,733,1163,63.03%,17.2%,1
彰化縣,田中鎮,0763,139,357,496,39,535,809,66.13%,17.18%,1
彰化縣,田中鎮,0764,197,468,665,47,712,1155,61.65%,17.06%,1
彰化縣,田中鎮,0765,209,470,679,57,736,1270,57.95%,16.46%,1
彰化縣,田中鎮,0766,140,322,462,27,489,870,56.21%,16.09%,1
彰化縣,田中鎮,0767,112,263,375,51,426,736,57.88%,15.22%,1
彰化縣,田中鎮,0768,191,465,656,42,698,1335,52.28%,14.31%,1
彰化縣,田中鎮,0769,131,339,470,33,503,876,57.42%,14.95%,1
彰化縣,田中鎮,0770,144,302,446,49,495,898,55.12%,16.04%,1
彰化縣,田中鎮,0771,230,510,740,21,761,1298,58.63%,17.72%,1
彰化縣,田中鎮,0772,214,528,742,66,808,1451,55.69%,14.75%,1
彰化縣,田中鎮,0773,233,557,790,48,838,1475,56.81%,15.8%,1
彰化縣,田中鎮,0774,108,259,367,35,402,766,52.48%,14.1%,1
彰化縣,田中鎮,0775,97,324,421,22,443,810,54.69%,11.98%,1
彰化縣,田中鎮,0776,166,352,518,49,567,953,59.5%,17.42%,1
彰化縣,田中鎮,0777,139,357,496,59,555,885,62.71%,15.71%,1
彰化縣,大村鄉,0579,253,592,845,60,905,1426,63.46%,17.74%,1
彰化縣,大村鄉,0580,306,706,1012,67,1079,1726,62.51%,17.73%,1
彰化縣,大村鄉,0581,139,318,457,47,504,797,63.24%,17.44%,1
彰化縣,大村鄉,0582,141,292,433,17,450,745,60.4%,18.93%,1
彰化縣,大村鄉,0583,168,480,648,47,695,1125,61.78%,14.93%,1
彰化縣,大村鄉,0584,236,560,796,69,865,1486,58.21%,15.88%,1
彰化縣,大村鄉,0585,239,545,784,51,835,1426,58.56%,16.76%,1
彰化縣,大村鄉,0586,127,371,498,26,524,824,63.59%,15.41%,1
彰化縣,大村鄉,0587,190,394,584,35,619,1177,52.59%,16.14%,1
彰化縣,大村鄉,0588,249,582,831,50,881,1478,59.61%,16.85%,1
彰化縣,大村鄉,0589,126,281,407,19,426,779,54.69%,16.17%,1
彰化縣,大村鄉,0590,149,329,478,40,518,812,63.79%,18.35%,1
彰化縣,大村鄉,0591,435,170,605,34,639,1161,55.04%,37.47%,1
彰化縣,大村鄉,0592,175,463,638,26,664,1238,53.63%,14.14%,1
彰化縣,大村鄉,0593,203,478,681,46,727,1259,57.74%,16.12%,1
彰化縣,大村鄉,0594,253,519,772,49,821,1412,58.14%,17.92%,1
彰化縣,大村鄉,0595,255,520,775,25,800,1401,57.1%,18.2%,1
彰化縣,大村鄉,0596,231,576,807,38,845,1395,60.57%,16.56%,1
彰化縣,大村鄉,0597,175,391,566,31,597,996,59.94%,17.57%,1
彰化縣,大村鄉,0598,181,405,586,26,612,1047,58.45%,17.29%,1
彰化縣,大村鄉,0599,157,411,568,28,596,985,60.51%,15.94%,1
彰化縣,大村鄉,0600,185,429,614,45,659,1054,62.52%,17.55%,1
彰化縣,大村鄉,0601,183,495,678,30,708,1200,59%,15.25%,1
彰化縣,大村鄉,0602,168,392,560,58,618,1003,61.62%,16.75%,1
彰化縣,大村鄉,0603,175,357,532,42,574,1046,54.88%,16.73%,1
彰化縣,大村鄉,0604,215,457,672,37,709,1189,59.63%,18.08%,1
彰化縣,大村鄉,0605,186,477,663,46,709,1305,54.33%,14.25%,1
彰化縣,埔鹽鄉,0682,137,419,556,37,593,958,61.9%,14.3%,1
彰化縣,埔鹽鄉,0683,120,348,468,26,494,754,65.52%,15.92%,1
彰化縣,埔鹽鄉,0684,146,331,477,24,501,757,66.18%,19.29%,1
彰化縣,埔鹽鄉,0685,130,345,475,30,505,806,62.66%,16.13%,1
彰化縣,埔鹽鄉,0686,192,539,731,39,770,1280,60.16%,15%,1
彰化縣,埔鹽鄉,0687,131,392,523,30,553,928,59.59%,14.12%,1
彰化縣,埔鹽鄉,0688,166,383,549,44,593,895,66.26%,18.55%,1
彰化縣,埔鹽鄉,0689,127,356,483,44,527,815,64.66%,15.58%,1
彰化縣,埔鹽鄉,0690,156,376,532,28,560,957,58.52%,16.3%,1
彰化縣,埔鹽鄉,0691,171,540,711,82,793,1338,59.27%,12.78%,1
彰化縣,埔鹽鄉,0692,165,429,594,46,640,1106,57.87%,14.92%,1
彰化縣,埔鹽鄉,0693,130,315,445,30,475,690,68.84%,18.84%,1
彰化縣,埔鹽鄉,0694,182,490,672,34,706,1230,57.4%,14.8%,1
彰化縣,埔鹽鄉,0695,149,329,478,24,502,847,59.27%,17.59%,1
彰化縣,埔鹽鄉,0696,151,386,537,26,563,897,62.76%,16.83%,1
彰化縣,埔鹽鄉,0697,149,337,486,46,532,882,60.32%,16.89%,1
彰化縣,埔鹽鄉,0698,166,505,671,44,715,1180,60.59%,14.07%,1
彰化縣,埔鹽鄉,0699,209,425,634,71,705,1215,58.02%,17.2%,1
彰化縣,埔鹽鄉,0700,53,210,263,18,281,422,66.59%,12.56%,1
彰化縣,埔鹽鄉,0701,146,428,574,45,619,1106,55.97%,13.2%,1
彰化縣,埔鹽鄉,0702,123,398,521,48,569,874,65.1%,14.07%,1
彰化縣,埔鹽鄉,0703,236,540,776,99,875,1445,60.55%,16.33%,1
彰化縣,埔鹽鄉,0704,100,390,490,46,536,875,61.26%,11.43%,1
彰化縣,埔鹽鄉,0705,109,302,411,37,448,837,53.52%,13.02%,1
彰化縣,埔鹽鄉,0706,92,288,380,32,412,685,60.15%,13.43%,1
彰化縣,埔鹽鄉,0707,137,302,439,31,470,733,64.12%,18.69%,1
彰化縣,埔鹽鄉,0708,121,335,456,43,499,798,62.53%,15.16%,1
彰化縣,埔鹽鄉,0709,200,545,745,46,791,1381,57.28%,14.48%,1
彰化縣,埔鹽鄉,0710,178,495,673,41,714,1335,53.48%,13.33%,1
彰化縣,埔心鄉,0711,187,467,654,59,713,1139,62.6%,16.42%,1
彰化縣,埔心鄉,0712,168,500,668,48,716,1217,58.83%,13.8%,1
彰化縣,埔心鄉,0713,225,511,736,36,772,1248,61.86%,18.03%,1
彰化縣,埔心鄉,0714,326,412,738,63,801,1248,64.18%,26.12%,1
彰化縣,埔心鄉,0715,165,366,531,36,567,916,61.9%,18.01%,1
彰化縣,埔心鄉,0716,141,249,390,20,410,625,65.6%,22.56%,1
彰化縣,埔心鄉,0717,204,465,669,63,732,1271,57.59%,16.05%,1
彰化縣,埔心鄉,0718,91,270,361,31,392,608,64.47%,14.97%,1
彰化縣,埔心鄉,0719,196,467,663,67,730,1132,64.49%,17.31%,1
彰化縣,埔心鄉,0720,173,425,598,46,644,1027,62.71%,16.85%,1
彰化縣,埔心鄉,0721,158,386,544,43,587,926,63.39%,17.06%,1
彰化縣,埔心鄉,0722,140,290,430,52,482,778,61.95%,17.99%,1
彰化縣,埔心鄉,0723,104,298,402,31,433,660,65.61%,15.76%,1
彰化縣,埔心鄉,0724,226,554,780,42,822,1330,61.8%,16.99%,1
彰化縣,埔心鄉,0725,192,381,573,20,593,991,59.84%,19.37%,1
彰化縣,埔心鄉,0726,183,445,628,31,659,985,66.9%,18.58%,1
彰化縣,埔心鄉,0727,192,367,559,32,591,1034,57.16%,18.57%,1
彰化縣,埔心鄉,0728,107,248,355,43,398,612,65.03%,17.48%,1
彰化縣,埔心鄉,0729,209,526,735,60,795,1236,64.32%,16.91%,1
彰化縣,埔心鄉,0730,132,322,454,40,494,775,63.74%,17.03%,1
彰化縣,埔心鄉,0731,137,327,464,30,494,738,66.94%,18.56%,1
彰化縣,埔心鄉,0732,219,384,603,37,640,1036,61.78%,21.14%,1
彰化縣,埔心鄉,0733,167,341,508,54,562,975,57.64%,17.13%,1
彰化縣,埔心鄉,0734,146,352,498,43,541,885,61.13%,16.5%,1
彰化縣,埔心鄉,0735,171,376,547,45,592,939,63.05%,18.21%,1
彰化縣,埔心鄉,0736,107,296,403,24,427,689,61.97%,15.53%,1
彰化縣,埔心鄉,0737,108,274,382,27,409,659,62.06%,16.39%,1
彰化縣,埔心鄉,0738,147,319,466,32,498,910,54.73%,16.15%,1
彰化縣,埔心鄉,0739,261,574,835,57,892,1352,65.98%,19.3%,1
彰化縣,埔心鄉,0740,135,277,412,36,448,759,59.03%,17.79%,1
彰化縣,埔心鄉,0741,165,358,523,46,569,942,60.4%,17.52%,1
彰化縣,永靖鄉,0606,173,433,606,58,664,1255,52.91%,13.78%,1
彰化縣,永靖鄉,0607,136,370,506,45,551,889,61.98%,15.3%,1
彰化縣,永靖鄉,0608,158,397,555,24,579,1026,56.43%,15.4%,1
彰化縣,永靖鄉,0609,119,289,408,42,450,724,62.15%,16.44%,1
彰化縣,永靖鄉,0610,407,107,514,39,553,924,59.85%,44.05%,1
彰化縣,永靖鄉,0611,132,260,392,28,420,659,63.73%,20.03%,1
彰化縣,永靖鄉,0612,154,258,412,23,435,734,59.26%,20.98%,1
彰化縣,永靖鄉,0613,109,252,361,10,371,758,48.94%,14.38%,1
彰化縣,永靖鄉,0614,137,388,525,37,562,848,66.27%,16.16%,1
彰化縣,永靖鄉,0615,206,478,684,66,750,1404,53.42%,14.67%,1
彰化縣,永靖鄉,0616,176,336,512,34,546,792,68.94%,22.22%,1
彰化縣,永靖鄉,0617,164,254,418,29,447,695,64.32%,23.6%,1
彰化縣,永靖鄉,0618,128,355,483,27,510,821,62.12%,15.59%,1
彰化縣,永靖鄉,0619,196,431,627,43,670,1064,62.97%,18.42%,1
彰化縣,永靖鄉,0620,163,297,460,29,489,840,58.21%,19.4%,1
彰化縣,永靖鄉,0621,205,435,640,26,666,1079,61.72%,19%,1
彰化縣,永靖鄉,0622,214,395,609,45,654,1048,62.4%,20.42%,1
彰化縣,永靖鄉,0623,167,414,581,34,615,960,64.06%,17.4%,1
彰化縣,永靖鄉,0624,164,298,462,27,489,798,61.28%,20.55%,1
彰化縣,永靖鄉,0625,145,334,479,50,529,796,66.46%,18.22%,1
彰化縣,永靖鄉,0626,113,245,358,28,386,662,58.31%,17.07%,1
彰化縣,永靖鄉,0627,173,402,575,33,608,1040,58.46%,16.63%,1
彰化縣,永靖鄉,0628,158,393,551,36,587,1025,57.27%,15.41%,1
彰化縣,永靖鄉,0629,236,600,836,40,876,1357,64.55%,17.39%,1
彰化縣,永靖鄉,0630,208,496,704,49,753,1236,60.92%,16.83%,1
彰化縣,永靖鄉,0631,148,334,482,42,524,871,60.16%,16.99%,1
彰化縣,永靖鄉,0632,97,226,323,33,356,706,50.42%,13.74%,1
彰化縣,永靖鄉,0633,137,330,467,33,500,770,64.94%,17.79%,1
彰化縣,永靖鄉,0634,181,242,423,18,441,669,65.92%,27.06%,1
彰化縣,永靖鄉,0635,176,303,479,20,499,862,57.89%,20.42%,1
彰化縣,永靖鄉,0636,120,333,453,22,475,847,56.08%,14.17%,1
彰化縣,永靖鄉,0637,116,269,385,43,428,668,64.07%,17.37%,1
彰化縣,永靖鄉,0638,140,402,542,27,569,1073,53.03%,13.05%,1
彰化縣,永靖鄉,0639,195,425,620,52,672,1339,50.19%,14.56%,1
彰化縣,社頭鄉,0778,144,292,436,31,467,791,59.04%,18.2%,1
彰化縣,社頭鄉,0779,170,355,525,33,558,984,56.71%,17.28%,1
彰化縣,社頭鄉,0780,153,358,511,24,535,990,54.04%,15.45%,1
彰化縣,社頭鄉,0781,180,420,600,32,632,1016,62.2%,17.72%,1
彰化縣,社頭鄉,0782,188,432,620,39,659,1091,60.4%,17.23%,1
彰化縣,社頭鄉,0783,226,463,689,54,743,1236,60.11%,18.28%,1
彰化縣,社頭鄉,0784,196,447,643,29,672,1203,55.86%,16.29%,1
彰化縣,社頭鄉,0785,124,274,398,29,427,753,56.71%,16.47%,1
彰化縣,社頭鄉,0786,100,254,354,32,386,725,53.24%,13.79%,1
彰化縣,社頭鄉,0787,176,396,572,52,624,1023,61%,17.2%,1
彰化縣,社頭鄉,0788,125,231,356,28,384,562,68.33%,22.24%,1
彰化縣,社頭鄉,0789,166,391,557,30,587,1049,55.96%,15.82%,1
彰化縣,社頭鄉,0790,141,394,535,25,560,933,60.02%,15.11%,1
彰化縣,社頭鄉,0791,178,381,559,46,605,990,61.11%,17.98%,1
彰化縣,社頭鄉,0792,161,389,550,33,583,1076,54.18%,14.96%,1
彰化縣,社頭鄉,0793,135,305,440,14,454,742,61.19%,18.19%,1
彰化縣,社頭鄉,0794,99,257,356,20,376,672,55.95%,14.73%,1
彰化縣,社頭鄉,0795,150,444,594,34,628,1235,50.85%,12.15%,1
彰化縣,社頭鄉,0796,142,276,418,35,453,750,60.4%,18.93%,1
彰化縣,社頭鄉,0797,137,317,454,33,487,895,54.41%,15.31%,1
彰化縣,社頭鄉,0798,104,282,386,18,404,688,58.72%,15.12%,1
彰化縣,社頭鄉,0799,114,348,462,28,490,870,56.32%,13.1%,1
彰化縣,社頭鄉,0800,203,451,654,27,681,1140,59.74%,17.81%,1
彰化縣,社頭鄉,0801,160,383,543,38,581,985,58.98%,16.24%,1
彰化縣,社頭鄉,0802,214,530,744,46,790,1266,62.4%,16.9%,1
彰化縣,社頭鄉,0803,148,384,532,23,555,937,59.23%,15.8%,1
彰化縣,社頭鄉,0804,182,476,658,32,690,1219,56.6%,14.93%,1
彰化縣,社頭鄉,0805,198,433,631,43,674,1165,57.85%,17%,1
彰化縣,社頭鄉,0806,169,380,549,41,590,986,59.84%,17.14%,1
彰化縣,社頭鄉,0807,138,303,441,18,459,724,63.4%,19.06%,1
彰化縣,社頭鄉,0808,140,419,559,32,591,1015,58.23%,13.79%,1
彰化縣,社頭鄉,0809,154,386,540,32,572,1116,51.25%,13.8%,1
彰化縣,社頭鄉,0810,155,385,540,32,572,1061,53.91%,14.61%,1
彰化縣,社頭鄉,0811,172,387,559,40,599,992,60.38%,17.34%,1
彰化縣,社頭鄉,0812,177,419,596,21,617,1092,56.5%,16.21%,1
彰化縣,社頭鄉,0813,144,330,474,36,510,828,61.59%,17.39%,1
彰化縣,社頭鄉,0814,134,244,378,46,424,787,53.88%,17.03%,1
彰化縣,社頭鄉,0815,111,233,344,18,362,719,50.35%,15.44%,1
彰化縣,二水鄉,0816,164,384,548,60,608,1028,59.14%,15.95%,1
彰化縣,二水鄉,0817,102,274,376,57,433,689,62.84%,14.8%,1
彰化縣,二水鄉,0818,119,300,419,54,473,871,54.31%,13.66%,1
彰化縣,二水鄉,0819,136,379,515,50,565,953,59.29%,14.27%,1
彰化縣,二水鄉,0820,82,221,303,38,341,624,54.65%,13.14%,1
彰化縣,二水鄉,0821,140,251,391,39,430,645,66.67%,21.71%,1
彰化縣,二水鄉,0822,160,501,661,37,698,986,70.79%,16.23%,1
彰化縣,二水鄉,0823,193,383,576,48,624,943,66.17%,20.47%,1
彰化縣,二水鄉,0824,80,196,276,9,285,455,62.64%,17.58%,1
彰化縣,二水鄉,0825,160,367,527,33,560,831,67.39%,19.25%,1
彰化縣,二水鄉,0826,140,341,481,36,517,831,62.21%,16.85%,1
彰化縣,二水鄉,0827,143,398,541,31,572,1013,56.47%,14.12%,1
彰化縣,二水鄉,0828,115,328,443,62,505,796,63.44%,14.45%,1
彰化縣,二水鄉,0829,119,285,404,46,450,781,57.62%,15.24%,1
彰化縣,二水鄉,0830,107,230,337,20,357,692,51.59%,15.46%,1
彰化縣,二水鄉,0831,104,246,350,23,373,635,58.74%,16.38%,1
彰化縣,二水鄉,0832,88,211,299,29,328,566,57.95%,15.55%,1
彰化縣,北斗鎮,0833,134,336,470,52,522,925,56.43%,14.49%,1
彰化縣,北斗鎮,0834,156,327,483,46,529,869,60.87%,17.95%,1
彰化縣,北斗鎮,0835,152,365,517,33,550,855,64.33%,17.78%,1
彰化縣,北斗鎮,0836,198,443,641,33,674,1065,63.29%,18.59%,1
彰化縣,北斗鎮,0837,127,331,458,48,506,828,61.11%,15.34%,1
彰化縣,北斗鎮,0838,187,444,631,42,673,1124,59.88%,16.64%,1
彰化縣,北斗鎮,0839,206,427,633,41,674,1096,61.5%,18.8%,1
彰化縣,北斗鎮,0840,195,484,679,36,715,1213,58.94%,16.08%,1
彰化縣,北斗鎮,0841,167,423,590,57,647,1164,55.58%,14.35%,1
彰化縣,北斗鎮,0842,117,272,389,24,413,730,56.58%,16.03%,1
彰化縣,北斗鎮,0843,424,44,468,24,492,878,56.04%,48.29%,1
彰化縣,北斗鎮,0844,126,351,477,34,511,833,61.34%,15.13%,1
彰化縣,北斗鎮,0845,173,370,543,26,569,957,59.46%,18.08%,1
彰化縣,北斗鎮,0846,115,281,396,27,423,783,54.02%,14.69%,1
彰化縣,北斗鎮,0847,93,189,282,37,319,573,55.67%,16.23%,1
彰化縣,北斗鎮,0848,131,239,370,18,388,672,57.74%,19.49%,1
彰化縣,北斗鎮,0849,133,216,349,33,382,695,54.96%,19.14%,1
彰化縣,北斗鎮,0850,109,264,373,28,401,747,53.68%,14.59%,1
彰化縣,北斗鎮,0851,116,280,396,17,413,643,64.23%,18.04%,1
彰化縣,北斗鎮,0852,102,264,366,35,401,662,60.57%,15.41%,1
彰化縣,北斗鎮,0853,190,449,639,50,689,1085,63.5%,17.51%,1
彰化縣,北斗鎮,0854,196,427,623,50,673,1121,60.04%,17.48%,1
彰化縣,北斗鎮,0855,139,339,478,32,510,830,61.45%,16.75%,1
彰化縣,北斗鎮,0856,146,375,521,23,544,975,55.79%,14.97%,1
彰化縣,北斗鎮,0857,210,426,636,26,662,1212,54.62%,17.33%,1
彰化縣,北斗鎮,0858,223,508,731,49,780,1302,59.91%,17.13%,1
彰化縣,北斗鎮,0859,151,352,503,36,539,1077,50.05%,14.02%,1
彰化縣,北斗鎮,0860,135,324,459,49,508,917,55.4%,14.72%,1
彰化縣,北斗鎮,0861,135,305,440,26,466,825,56.48%,16.36%,1
彰化縣,北斗鎮,0862,157,363,520,38,558,937,59.55%,16.76%,1
彰化縣,二林鎮,0942,84,211,295,22,317,731,43.37%,11.49%,1
彰化縣,二林鎮,0943,146,405,551,39,590,1025,57.56%,14.24%,1
彰化縣,二林鎮,0944,130,299,429,24,453,784,57.78%,16.58%,1
彰化縣,二林鎮,0945,154,333,487,32,519,892,58.18%,17.26%,1
彰化縣,二林鎮,0946,223,452,675,45,720,1256,57.32%,17.75%,1
彰化縣,二林鎮,0947,146,386,532,41,573,1043,54.94%,14%,1
彰化縣,二林鎮,0948,196,422,618,32,650,1076,60.41%,18.22%,1
彰化縣,二林鎮,0949,164,436,600,36,636,1082,58.78%,15.16%,1
彰化縣,二林鎮,0950,324,399,723,52,775,1427,54.31%,22.7%,1
彰化縣,二林鎮,0951,152,327,479,48,527,1030,51.17%,14.76%,1
彰化縣,二林鎮,0952,160,336,496,46,542,1033,52.47%,15.49%,1
彰化縣,二林鎮,0953,161,344,505,40,545,977,55.78%,16.48%,1
彰化縣,二林鎮,0954,91,244,335,17,352,683,51.54%,13.32%,1
彰化縣,二林鎮,0955,108,329,437,75,512,975,52.51%,11.08%,1
彰化縣,二林鎮,0956,423,109,532,64,596,1336,44.61%,31.66%,1
彰化縣,二林鎮,0957,113,316,429,51,480,1019,47.11%,11.09%,1
彰化縣,二林鎮,0958,132,273,405,40,445,1003,44.37%,13.16%,1
彰化縣,二林鎮,0959,155,450,605,44,649,1151,56.39%,13.47%,1
彰化縣,二林鎮,0960,251,568,819,90,909,1598,56.88%,15.71%,1
彰化縣,二林鎮,0961,211,542,753,46,799,1488,53.7%,14.18%,1
彰化縣,二林鎮,0962,303,666,969,48,1017,1771,57.43%,17.11%,1
彰化縣,二林鎮,0963,185,358,543,41,584,1360,42.94%,13.6%,1
彰化縣,二林鎮,0964,166,527,693,61,754,1613,46.75%,10.29%,1
彰化縣,二林鎮,0965,178,403,581,58,639,1228,52.04%,14.5%,1
彰化縣,二林鎮,0966,111,307,418,23,441,771,57.2%,14.4%,1
彰化縣,二林鎮,0967,134,339,473,32,505,858,58.86%,15.62%,1
彰化縣,二林鎮,0968,74,228,302,0,302,661,45.69%,11.2%,1
彰化縣,二林鎮,0969,164,386,550,83,633,1268,49.92%,12.93%,1
彰化縣,二林鎮,0970,128,388,516,24,540,1081,49.95%,11.84%,1
彰化縣,二林鎮,0971,162,404,566,32,598,1213,49.3%,13.36%,1
彰化縣,二林鎮,0972,197,506,703,38,741,1328,55.8%,14.83%,1
彰化縣,二林鎮,0973,117,347,464,70,534,1118,47.76%,10.47%,1
彰化縣,二林鎮,0974,140,352,492,42,534,1157,46.15%,12.1%,1
彰化縣,二林鎮,0975,118,328,446,33,479,972,49.28%,12.14%,1
彰化縣,二林鎮,0976,136,316,452,37,489,902,54.21%,15.08%,1
彰化縣,二林鎮,0977,175,582,757,49,806,1273,63.32%,13.75%,1
彰化縣,二林鎮,0978,158,385,543,30,573,1087,52.71%,14.54%,1
彰化縣,二林鎮,0979,144,380,524,67,591,987,59.88%,14.59%,1
彰化縣,二林鎮,0980,102,210,312,26,338,719,47.01%,14.19%,1
彰化縣,田尾鄉,0863,202,430,632,40,672,1284,52.34%,15.73%,1
彰化縣,田尾鄉,0864,177,499,676,49,725,1187,61.08%,14.91%,1
彰化縣,田尾鄉,0865,167,422,589,34,623,1033,60.31%,16.17%,1
彰化縣,田尾鄉,0866,97,297,394,33,427,696,61.35%,13.94%,1
彰化縣,田尾鄉,0867,148,367,515,29,544,872,62.39%,16.97%,1
彰化縣,田尾鄉,0868,107,247,354,15,369,680,54.26%,15.74%,1
彰化縣,田尾鄉,0869,173,353,526,31,557,875,63.66%,19.77%,1
彰化縣,田尾鄉,0870,222,477,699,33,732,1337,54.75%,16.6%,1
彰化縣,田尾鄉,0871,260,529,789,52,841,1376,61.12%,18.9%,1
彰化縣,田尾鄉,0872,190,498,688,49,737,1186,62.14%,16.02%,1
彰化縣,田尾鄉,0873,154,417,571,36,607,874,69.45%,17.62%,1
彰化縣,田尾鄉,0874,101,239,340,27,367,647,56.72%,15.61%,1
彰化縣,田尾鄉,0875,127,425,552,21,573,959,59.75%,13.24%,1
彰化縣,田尾鄉,0876,32,102,134,10,144,263,54.75%,12.17%,1
彰化縣,田尾鄉,0877,87,223,310,26,336,618,54.37%,14.08%,1
彰化縣,田尾鄉,0878,199,375,574,20,594,938,63.33%,21.22%,1
彰化縣,田尾鄉,0879,154,360,514,49,563,880,63.98%,17.5%,1
彰化縣,田尾鄉,0880,125,281,406,28,434,804,53.98%,15.55%,1
彰化縣,田尾鄉,0881,115,194,309,21,330,592,55.74%,19.43%,1
彰化縣,田尾鄉,0882,186,444,630,56,686,1079,63.58%,17.24%,1
彰化縣,田尾鄉,0883,230,501,731,49,780,1336,58.38%,17.22%,1
彰化縣,田尾鄉,0884,186,418,604,46,650,1198,54.26%,15.53%,1
彰化縣,田尾鄉,0885,98,208,306,48,354,621,57%,15.78%,1
彰化縣,田尾鄉,0886,124,259,383,28,411,760,54.08%,16.32%,1
彰化縣,田尾鄉,0887,206,432,638,63,701,1084,64.67%,19%,1
彰化縣,埤頭鄉,0888,181,349,530,56,586,1178,49.75%,15.37%,1
彰化縣,埤頭鄉,0889,182,468,650,47,697,1290,54.03%,14.11%,1
彰化縣,埤頭鄉,0890,147,353,500,44,544,973,55.91%,15.11%,1
彰化縣,埤頭鄉,0891,112,277,389,29,418,783,53.38%,14.3%,1
彰化縣,埤頭鄉,0892,116,251,367,46,413,733,56.34%,15.83%,1
彰化縣,埤頭鄉,0893,156,303,459,69,528,899,58.73%,17.35%,1
彰化縣,埤頭鄉,0894,138,355,493,54,547,965,56.68%,14.3%,1
彰化縣,埤頭鄉,0895,182,478,660,54,714,1356,52.65%,13.42%,1
彰化縣,埤頭鄉,0896,206,430,636,54,690,1265,54.55%,16.28%,1
彰化縣,埤頭鄉,0897,153,341,494,47,541,877,61.69%,17.45%,1
彰化縣,埤頭鄉,0898,118,227,345,37,382,705,54.18%,16.74%,1
彰化縣,埤頭鄉,0899,170,443,613,32,645,1062,60.73%,16.01%,1
彰化縣,埤頭鄉,0900,206,508,714,28,742,1300,57.08%,15.85%,1
彰化縣,埤頭鄉,0901,119,368,487,56,543,923,58.83%,12.89%,1
彰化縣,埤頭鄉,0902,57,375,432,30,462,1085,42.58%,5.25%,1
彰化縣,埤頭鄉,0903,171,436,607,47,654,1103,59.29%,15.5%,1
彰化縣,埤頭鄉,0904,98,252,350,31,381,735,51.84%,13.33%,1
彰化縣,埤頭鄉,0905,98,177,275,41,316,574,55.05%,17.07%,1
彰化縣,埤頭鄉,0906,70,271,341,45,386,767,50.33%,9.13%,1
彰化縣,埤頭鄉,0907,98,275,373,37,410,737,55.63%,13.3%,1
彰化縣,埤頭鄉,0908,162,305,467,48,515,1058,48.68%,15.31%,1
彰化縣,埤頭鄉,0909,103,254,357,68,425,826,51.45%,12.47%,1
彰化縣,埤頭鄉,0910,140,328,468,76,544,1082,50.28%,12.94%,1
彰化縣,埤頭鄉,0911,285,112,397,49,446,737,60.52%,38.67%,1
彰化縣,埤頭鄉,0912,85,270,355,20,375,711,52.74%,11.95%,1
彰化縣,埤頭鄉,0913,194,343,537,53,590,1043,56.57%,18.6%,1
彰化縣,埤頭鄉,0914,124,316,440,23,463,910,50.88%,13.63%,1
彰化縣,芳苑鄉,0998,93,207,300,36,336,940,35.74%,9.89%,1
彰化縣,芳苑鄉,0999,32,103,135,27,162,403,40.2%,7.94%,1
彰化縣,芳苑鄉,1000,103,236,339,36,375,756,49.6%,13.62%,1
彰化縣,芳苑鄉,1001,43,110,153,25,178,548,32.48%,7.85%,1
彰化縣,芳苑鄉,1002,121,360,481,41,522,997,52.36%,12.14%,1
彰化縣,芳苑鄉,1003,178,352,530,61,591,1300,45.46%,13.69%,1
彰化縣,芳苑鄉,1004,123,283,406,37,443,859,51.57%,14.32%,1
彰化縣,芳苑鄉,1005,90,251,341,19,360,734,49.05%,12.26%,1
彰化縣,芳苑鄉,1006,105,178,283,22,305,636,47.96%,16.51%,1
彰化縣,芳苑鄉,1007,94,219,313,60,373,808,46.16%,11.63%,1
彰化縣,芳苑鄉,1008,84,169,253,42,295,668,44.16%,12.57%,1
彰化縣,芳苑鄉,1009,119,229,348,30,378,744,50.81%,15.99%,1
彰化縣,芳苑鄉,1010,128,294,422,78,500,1026,48.73%,12.48%,1
彰化縣,芳苑鄉,1011,57,156,213,12,225,586,38.4%,9.73%,1
彰化縣,芳苑鄉,1012,86,206,292,22,314,593,52.95%,14.5%,1
彰化縣,芳苑鄉,1013,121,374,495,79,574,1071,53.59%,11.3%,1
彰化縣,芳苑鄉,1014,141,265,406,55,461,1060,43.49%,13.3%,1
彰化縣,芳苑鄉,1015,78,260,338,21,359,708,50.71%,11.02%,1
彰化縣,芳苑鄉,1016,87,225,312,49,361,735,49.12%,11.84%,1
彰化縣,芳苑鄉,1017,80,210,290,45,335,571,58.67%,14.01%,1
彰化縣,芳苑鄉,1018,84,209,293,26,319,729,43.76%,11.52%,1
彰化縣,芳苑鄉,1019,95,209,304,48,352,674,52.23%,14.09%,1
彰化縣,芳苑鄉,1020,107,291,398,36,434,846,51.3%,12.65%,1
彰化縣,芳苑鄉,1021,104,324,428,41,469,806,58.19%,12.9%,1
彰化縣,芳苑鄉,1022,51,117,168,13,181,470,38.51%,10.85%,1
彰化縣,芳苑鄉,1023,126,444,570,42,612,1124,54.45%,11.21%,1
彰化縣,芳苑鄉,1024,41,99,140,12,152,317,47.95%,12.93%,1
彰化縣,芳苑鄉,1025,106,334,440,59,499,1158,43.09%,9.15%,1
彰化縣,芳苑鄉,1026,121,317,438,26,464,967,47.98%,12.51%,1
彰化縣,芳苑鄉,1027,105,263,368,35,403,762,52.89%,13.78%,1
彰化縣,芳苑鄉,1028,118,320,438,42,480,1086,44.2%,10.87%,1
彰化縣,芳苑鄉,1029,96,245,341,27,368,747,49.26%,12.85%,1
彰化縣,芳苑鄉,1030,68,176,244,22,266,653,40.74%,10.41%,1
彰化縣,芳苑鄉,1031,117,361,478,36,514,872,58.94%,13.42%,1
彰化縣,芳苑鄉,1032,210,490,700,45,745,1235,60.32%,17%,1
彰化縣,芳苑鄉,1033,162,391,553,43,596,1102,54.08%,14.7%,1
彰化縣,大城鄉,0981,97,332,429,24,453,1288,35.17%,7.53%,1
彰化縣,大城鄉,0982,104,260,364,65,429,1104,38.86%,9.42%,1
彰化縣,大城鄉,0983,131,349,480,57,537,964,55.71%,13.59%,1
彰化縣,大城鄉,0984,162,400,562,45,607,1312,46.27%,12.35%,1
彰化縣,大城鄉,0985,83,241,324,43,367,853,43.02%,9.73%,1
彰化縣,大城鄉,0986,30,141,171,12,183,518,35.33%,5.79%,1
彰化縣,大城鄉,0987,69,155,224,27,251,574,43.73%,12.02%,1
彰化縣,大城鄉,0988,55,178,233,37,270,702,38.46%,7.83%,1
彰化縣,大城鄉,0989,32,76,108,12,120,376,31.91%,8.51%,1
彰化縣,大城鄉,0990,39,156,195,20,215,693,31.02%,5.63%,1
彰化縣,大城鄉,0991,102,247,349,37,386,877,44.01%,11.63%,1
彰化縣,大城鄉,0992,47,147,194,15,209,655,31.91%,7.18%,1
彰化縣,大城鄉,0993,90,307,397,19,416,1103,37.72%,8.16%,1
彰化縣,大城鄉,0994,117,275,392,24,416,1192,34.9%,9.82%,1
彰化縣,大城鄉,0995,97,235,332,29,361,917,39.37%,10.58%,1
彰化縣,大城鄉,0996,58,147,205,24,229,686,33.38%,8.45%,1
彰化縣,大城鄉,0997,68,203,271,25,296,899,32.93%,7.56%,1
彰化縣,竹塘鄉,1034,162,447,609,63,672,1168,57.53%,13.87%,1
彰化縣,竹塘鄉,1035,152,390,542,27,569,965,58.96%,15.75%,1
彰化縣,竹塘鄉,1036,150,411,561,39,600,960,62.5%,15.63%,1
彰化縣,竹塘鄉,1037,120,304,424,57,481,743,64.74%,16.15%,1
彰化縣,竹塘鄉,1038,97,212,309,30,339,751,45.14%,12.92%,1
彰化縣,竹塘鄉,1039,94,241,335,40,375,792,47.35%,11.87%,1
彰化縣,竹塘鄉,1040,102,230,332,16,348,733,47.48%,13.92%,1
彰化縣,竹塘鄉,1041,93,234,327,29,356,657,54.19%,14.16%,1
彰化縣,竹塘鄉,1042,130,386,516,34,550,1063,51.74%,12.23%,1
彰化縣,竹塘鄉,1043,169,422,591,47,638,1114,57.27%,15.17%,1
彰化縣,竹塘鄉,1044,93,215,308,33,341,506,67.39%,18.38%,1
彰化縣,竹塘鄉,1045,122,268,390,35,425,823,51.64%,14.82%,1
彰化縣,竹塘鄉,1046,105,207,312,26,338,654,51.68%,16.06%,1
彰化縣,竹塘鄉,1047,67,168,235,25,260,577,45.06%,11.61%,1
彰化縣,竹塘鄉,1048,111,248,359,49,408,772,52.85%,14.38%,1
彰化縣,竹塘鄉,1049,65,156,221,31,252,543,46.41%,11.97%,1
彰化縣,溪州鄉,0915,115,281,396,35,431,778,55.4%,14.78%,1
彰化縣,溪州鄉,0916,150,356,506,24,530,1061,49.95%,14.14%,1
彰化縣,溪州鄉,0917,80,225,305,31,336,701,47.93%,11.41%,1
彰化縣,溪州鄉,0918,151,346,497,38,535,879,60.86%,17.18%,1
彰化縣,溪州鄉,0919,280,112,392,37,429,654,65.6%,42.81%,1
彰化縣,溪州鄉,0920,132,338,470,35,505,878,57.52%,15.03%,1
彰化縣,溪州鄉,0921,141,402,543,42,585,942,62.1%,14.97%,1
彰化縣,溪州鄉,0922,152,303,455,29,484,871,55.57%,17.45%,1
彰化縣,溪州鄉,0923,154,361,515,19,534,1047,51%,14.71%,1
彰化縣,溪州鄉,0924,143,321,464,43,507,858,59.09%,16.67%,1
彰化縣,溪州鄉,0925,175,410,585,65,650,1409,46.13%,12.42%,1
彰化縣,溪州鄉,0926,111,288,399,19,418,792,52.78%,14.02%,1
彰化縣,溪州鄉,0927,110,234,344,43,387,714,54.2%,15.41%,1
彰化縣,溪州鄉,0928,121,362,483,57,540,1109,48.69%,10.91%,1
彰化縣,溪州鄉,0929,124,272,396,47,443,962,46.05%,12.89%,1
彰化縣,溪州鄉,0930,151,325,476,55,531,1157,45.89%,13.05%,1
彰化縣,溪州鄉,0931,140,306,446,44,490,952,51.47%,14.71%,1
彰化縣,溪州鄉,0932,148,289,437,39,476,887,53.66%,16.69%,1
彰化縣,溪州鄉,0933,109,224,333,47,380,866,43.88%,12.59%,1
彰化縣,溪州鄉,0934,119,315,434,56,490,1010,48.51%,11.78%,1
彰化縣,溪州鄉,0935,130,274,404,21,425,853,49.82%,15.24%,1
彰化縣,溪州鄉,0936,121,262,383,61,444,843,52.67%,14.35%,1
彰化縣,溪州鄉,0937,83,176,259,9,268,711,37.69%,11.67%,1
彰化縣,溪州鄉,0938,139,267,406,63,469,851,55.11%,16.33%,1
彰化縣,溪州鄉,0939,116,287,403,29,432,883,48.92%,13.14%,1
彰化縣,溪州鄉,0940,130,427,557,50,607,1247,48.68%,10.43%,1
彰化縣,溪州鄉,0941,250,517,767,60,827,1490,55.5%,16.78%,1
南投縣,南投市,0001,193,343,536,18,554,927,59.76%,20.82%,1
南投縣,南投市,0002,131,299,430,24,454,667,68.07%,19.64%,1
南投縣,南投市,0003,149,327,476,29,505,773,65.33%,19.28%,1
南投縣,南投市,0004,155,333,488,26,514,818,62.84%,18.95%,1
南投縣,南投市,0005,117,225,342,15,357,525,68%,22.29%,1
南投縣,南投市,0006,103,261,364,23,387,575,67.3%,17.91%,1
南投縣,南投市,0007,80,165,245,9,254,368,69.02%,21.74%,1
南投縣,南投市,0008,155,434,589,43,632,956,66.11%,16.21%,1
南投縣,南投市,0009,199,458,657,19,676,1245,54.3%,15.98%,1
南投縣,南投市,0010,261,576,837,25,862,1484,58.09%,17.59%,1
南投縣,南投市,0011,213,536,749,35,784,1191,65.83%,17.88%,1
南投縣,南投市,0012,270,609,879,41,920,1506,61.09%,17.93%,1
南投縣,南投市,0013,222,427,649,30,679,1070,63.46%,20.75%,1
南投縣,南投市,0014,123,285,408,19,427,670,63.73%,18.36%,1
南投縣,南投市,0015,218,435,653,46,699,1050,66.57%,20.76%,1
南投縣,南投市,0016,188,411,599,36,635,1122,56.6%,16.76%,1
南投縣,南投市,0017,170,356,526,32,558,984,56.71%,17.28%,1
南投縣,南投市,0018,213,467,680,28,708,1062,66.67%,20.06%,1
南投縣,南投市,0019,170,436,606,38,644,1053,61.16%,16.14%,1
南投縣,南投市,0020,220,445,665,37,702,1104,63.59%,19.93%,1
南投縣,南投市,0021,223,439,662,32,694,1192,58.22%,18.71%,1
南投縣,南投市,0022,147,378,525,28,553,960,57.6%,15.31%,1
南投縣,南投市,0023,146,377,523,36,559,906,61.7%,16.11%,1
南投縣,南投市,0024,188,381,569,28,597,957,62.38%,19.64%,1
南投縣,南投市,0025,174,437,611,41,652,997,65.4%,17.45%,1
南投縣,南投市,0026,182,413,595,34,629,1008,62.4%,18.06%,1
南投縣,南投市,0027,225,438,663,21,684,1164,58.76%,19.33%,1
南投縣,南投市,0028,87,240,327,21,348,587,59.28%,14.82%,1
南投縣,南投市,0029,115,269,384,31,415,734,56.54%,15.67%,1
南投縣,南投市,0030,128,265,393,34,427,724,58.98%,17.68%,1
南投縣,南投市,0031,147,423,570,31,601,1003,59.92%,14.66%,1
南投縣,南投市,0032,239,518,757,34,791,1356,58.33%,17.63%,1
南投縣,南投市,0033,243,477,720,39,759,1373,55.28%,17.7%,1
南投縣,南投市,0034,221,554,775,40,815,1452,56.13%,15.22%,1
南投縣,南投市,0035,45,159,204,6,210,362,58.01%,12.43%,1
南投縣,南投市,0036,63,150,213,23,236,389,60.67%,16.2%,1
南投縣,南投市,0037,253,535,788,42,830,1276,65.05%,19.83%,1
南投縣,南投市,0038,217,458,675,34,709,1089,65.11%,19.93%,1
南投縣,南投市,0039,187,366,553,40,593,921,64.39%,20.3%,1
南投縣,南投市,0040,181,423,604,19,623,892,69.84%,20.29%,1
南投縣,南投市,0041,195,471,666,27,693,1050,66%,18.57%,1
南投縣,南投市,0042,190,466,656,20,676,1078,62.71%,17.63%,1
南投縣,南投市,0043,179,470,649,19,668,1078,61.97%,16.6%,1
南投縣,南投市,0044,193,399,592,31,623,861,72.36%,22.42%,1
南投縣,南投市,0045,189,505,694,42,736,1221,60.28%,15.48%,1
南投縣,南投市,0046,186,449,635,21,656,1105,59.37%,16.83%,1
南投縣,南投市,0047,206,533,739,18,757,1230,61.54%,16.75%,1
南投縣,南投市,0048,179,478,657,18,675,1092,61.81%,16.39%,1
南投縣,南投市,0049,237,565,802,19,821,1286,63.84%,18.43%,1
南投縣,南投市,0050,124,295,419,32,451,655,68.85%,18.93%,1
南投縣,南投市,0051,125,325,450,25,475,719,66.06%,17.39%,1
南投縣,南投市,0052,129,288,417,18,435,720,60.42%,17.92%,1
南投縣,南投市,0053,82,251,333,13,346,509,67.98%,16.11%,1
南投縣,南投市,0054,54,214,268,13,281,492,57.11%,10.98%,1
南投縣,南投市,0055,73,291,364,11,375,616,60.88%,11.85%,1
南投縣,南投市,0056,149,470,619,21,640,1010,63.37%,14.75%,1
南投縣,南投市,0057,114,373,487,22,509,848,60.02%,13.44%,1
南投縣,南投市,0058,240,601,841,48,889,1387,64.1%,17.3%,1
南投縣,南投市,0059,241,539,780,28,808,1245,64.9%,19.36%,1
南投縣,南投市,0060,201,483,684,20,704,1199,58.72%,16.76%,1
南投縣,南投市,0061,218,546,764,38,802,1288,62.27%,16.93%,1
南投縣,南投市,0062,173,415,588,32,620,1040,59.62%,16.63%,1
南投縣,南投市,0063,192,439,631,35,666,1070,62.24%,17.94%,1
南投縣,南投市,0064,252,538,790,36,826,1299,63.59%,19.4%,1
南投縣,南投市,0065,232,461,693,23,716,1122,63.81%,20.68%,1
南投縣,南投市,0066,240,565,805,33,838,1414,59.26%,16.97%,1
南投縣,南投市,0067,180,448,628,38,666,1121,59.41%,16.06%,1
南投縣,南投市,0068,159,551,710,18,728,1434,50.77%,11.09%,1
南投縣,南投市,0069,192,540,732,41,773,1393,55.49%,13.78%,1
南投縣,南投市,0070,156,442,598,17,615,1059,58.07%,14.73%,1
南投縣,南投市,0071,193,495,688,21,709,1218,58.21%,15.85%,1
南投縣,南投市,0072,224,470,694,23,717,1293,55.45%,17.32%,1
南投縣,南投市,0073,168,486,654,23,677,1337,50.64%,12.57%,1
南投縣,南投市,0074,160,371,531,34,565,876,64.5%,18.26%,1
南投縣,南投市,0075,150,394,544,20,564,971,58.08%,15.45%,1
南投縣,南投市,0076,173,395,568,27,595,1012,58.79%,17.09%,1
南投縣,南投市,0077,147,372,519,30,549,973,56.42%,15.11%,1
南投縣,南投市,0078,185,415,600,26,626,1002,62.48%,18.46%,1
南投縣,南投市,0079,200,386,586,26,612,1024,59.77%,19.53%,1
南投縣,南投市,0080,171,343,514,78,592,1122,52.76%,15.24%,1
南投縣,南投市,0081,112,257,369,31,400,790,50.63%,14.18%,1
南投縣,南投市,0082,79,208,287,13,300,647,46.37%,12.21%,1
南投縣,南投市,0083,143,346,489,43,532,950,56%,15.05%,1
南投縣,南投市,0084,145,353,498,24,522,980,53.27%,14.8%,1
南投縣,埔里鎮,0085,141,327,468,34,502,828,60.63%,17.03%,1
南投縣,埔里鎮,0086,138,320,458,36,494,786,62.85%,17.56%,1
南投縣,埔里鎮,0087,145,435,580,33,613,1062,57.72%,13.65%,1
南投縣,埔里鎮,0088,206,493,699,48,747,1201,62.2%,17.15%,1
南投縣,埔里鎮,0089,200,555,755,31,786,1415,55.55%,14.13%,1
南投縣,埔里鎮,0090,197,503,700,25,725,1282,56.55%,15.37%,1
南投縣,埔里鎮,0091,131,334,465,42,507,859,59.02%,15.25%,1
南投縣,埔里鎮,0092,204,481,685,63,748,1288,58.07%,15.84%,1
南投縣,埔里鎮,0093,234,506,740,23,763,1330,57.37%,17.59%,1
南投縣,埔里鎮,0094,216,509,725,43,768,1416,54.24%,15.25%,1
南投縣,埔里鎮,0095,171,445,616,29,645,1283,50.27%,13.33%,1
南投縣,埔里鎮,0096,117,519,636,62,698,1151,60.64%,10.17%,1
南投縣,埔里鎮,0097,179,429,608,25,633,1193,53.06%,15%,1
南投縣,埔里鎮,0098,245,552,797,55,852,1471,57.92%,16.66%,1
南投縣,埔里鎮,0099,122,338,460,73,533,1044,51.05%,11.69%,1
南投縣,埔里鎮,0100,171,441,612,54,666,1122,59.36%,15.24%,1
南投縣,埔里鎮,0101,176,512,688,39,727,1129,64.39%,15.59%,1
南投縣,埔里鎮,0102,136,355,491,11,502,901,55.72%,15.09%,1
南投縣,埔里鎮,0103,125,350,475,54,529,997,53.06%,12.54%,1
南投縣,埔里鎮,0104,212,438,650,30,680,1209,56.24%,17.54%,1
南投縣,埔里鎮,0105,131,395,526,26,552,838,65.87%,15.63%,1
南投縣,埔里鎮,0106,174,405,579,36,615,1226,50.16%,14.19%,1
南投縣,埔里鎮,0107,232,502,734,58,792,1263,62.71%,18.37%,1
南投縣,埔里鎮,0108,195,425,620,17,637,1045,60.96%,18.66%,1
南投縣,埔里鎮,0109,188,465,653,28,681,1120,60.8%,16.79%,1
南投縣,埔里鎮,0110,200,454,654,39,693,1062,65.25%,18.83%,1
南投縣,埔里鎮,0111,168,399,567,32,599,1022,58.61%,16.44%,1
南投縣,埔里鎮,0112,167,412,579,18,597,1051,56.8%,15.89%,1
南投縣,埔里鎮,0113,178,423,601,26,627,1106,56.69%,16.09%,1
南投縣,埔里鎮,0114,172,448,620,18,638,1098,58.11%,15.66%,1
南投縣,埔里鎮,0115,164,450,614,27,641,1067,60.07%,15.37%,1
南投縣,埔里鎮,0116,265,122,387,40,427,725,58.9%,36.55%,1
南投縣,埔里鎮,0117,157,357,514,23,537,905,59.34%,17.35%,1
南投縣,埔里鎮,0118,176,418,594,42,636,1179,53.94%,14.93%,1
南投縣,埔里鎮,0119,109,361,470,28,498,944,52.75%,11.55%,1
南投縣,埔里鎮,0120,73,162,235,33,268,465,57.63%,15.7%,1
南投縣,埔里鎮,0121,158,436,594,41,635,1133,56.05%,13.95%,1
南投縣,埔里鎮,0122,153,414,567,37,604,1100,54.91%,13.91%,1
南投縣,埔里鎮,0123,182,445,627,52,679,1155,58.79%,15.76%,1
南投縣,埔里鎮,0124,202,379,581,41,622,1254,49.6%,16.11%,1
南投縣,埔里鎮,0125,200,441,641,44,685,1296,52.85%,15.43%,1
南投縣,埔里鎮,0126,198,433,631,33,664,1023,64.91%,19.35%,1
南投縣,埔里鎮,0127,102,369,471,20,491,964,50.93%,10.58%,1
南投縣,埔里鎮,0128,173,380,553,28,581,986,58.92%,17.55%,1
南投縣,埔里鎮,0129,163,440,603,15,618,1016,60.83%,16.04%,1
南投縣,埔里鎮,0130,134,371,505,31,536,898,59.69%,14.92%,1
南投縣,埔里鎮,0131,159,399,558,38,596,980,60.82%,16.22%,1
南投縣,埔里鎮,0132,145,404,549,15,564,933,60.45%,15.54%,1
南投縣,埔里鎮,0133,195,415,610,41,651,929,70.08%,20.99%,1
南投縣,埔里鎮,0134,146,384,530,60,590,1032,57.17%,14.15%,1
南投縣,埔里鎮,0135,37,119,156,9,165,315,52.38%,11.75%,1
南投縣,埔里鎮,0136,189,491,680,64,744,1363,54.59%,13.87%,1
南投縣,埔里鎮,0137,130,282,412,29,441,725,60.83%,17.93%,1
南投縣,埔里鎮,0138,101,310,411,16,427,705,60.57%,14.33%,1
南投縣,埔里鎮,0139,140,325,465,25,490,751,65.25%,18.64%,1
南投縣,埔里鎮,0140,130,374,504,30,534,932,57.3%,13.95%,1
南投縣,埔里鎮,0141,168,370,538,33,571,956,59.73%,17.57%,1
南投縣,埔里鎮,0142,50,149,199,15,214,376,56.91%,13.3%,1
南投縣,埔里鎮,0143,111,265,376,32,408,682,59.82%,16.28%,1
南投縣,埔里鎮,0144,83,520,603,42,645,990,65.15%,8.38%,1
南投縣,埔里鎮,0145,172,500,672,0,672,1324,50.76%,12.99%,1
南投縣,埔里鎮,0146,53,77,130,18,148,298,49.66%,17.79%,1
南投縣,埔里鎮,0147,142,451,593,58,651,1170,55.64%,12.14%,1
南投縣,埔里鎮,0148,103,241,344,17,361,604,59.77%,17.05%,1
南投縣,埔里鎮,0149,147,373,520,31,551,999,55.16%,14.71%,1
南投縣,埔里鎮,0150,338,129,467,19,486,923,52.65%,36.62%,1
南投縣,埔里鎮,0151,139,365,504,33,537,887,60.54%,15.67%,1
南投縣,埔里鎮,0152,146,363,509,27,536,981,54.64%,14.88%,1
南投縣,草屯鎮,0153,200,399,599,25,624,998,62.53%,20.04%,1
南投縣,草屯鎮,0154,186,416,602,26,628,1127,55.72%,16.5%,1
南投縣,草屯鎮,0155,220,509,729,25,754,1401,53.82%,15.7%,1
南投縣,草屯鎮,0156,184,411,595,28,623,1110,56.13%,16.58%,1
南投縣,草屯鎮,0157,522,205,727,38,765,1285,59.53%,40.62%,1
南投縣,草屯鎮,0158,141,373,514,26,540,936,57.69%,15.06%,1
南投縣,草屯鎮,0159,215,415,630,41,671,1141,58.81%,18.84%,1
南投縣,草屯鎮,0160,135,285,420,25,445,705,63.12%,19.15%,1
南投縣,草屯鎮,0161,211,477,688,12,700,1121,62.44%,18.82%,1
南投縣,草屯鎮,0162,175,389,564,19,583,877,66.48%,19.95%,1
南投縣,草屯鎮,0163,230,521,751,40,791,1401,56.46%,16.42%,1
南投縣,草屯鎮,0164,186,472,658,38,696,1267,54.93%,14.68%,1
南投縣,草屯鎮,0165,202,465,667,55,722,1214,59.47%,16.64%,1
南投縣,草屯鎮,0166,210,495,705,47,752,1259,59.73%,16.68%,1
南投縣,草屯鎮,0167,292,563,855,15,870,1442,60.33%,20.25%,1
南投縣,草屯鎮,0168,212,521,733,30,763,1273,59.94%,16.65%,1
南投縣,草屯鎮,0169,191,438,629,29,658,1145,57.47%,16.68%,1
南投縣,草屯鎮,0170,202,490,692,21,713,1279,55.75%,15.79%,1
南投縣,草屯鎮,0171,183,453,636,20,656,1158,56.65%,15.8%,1
南投縣,草屯鎮,0172,247,589,836,37,873,1335,65.39%,18.5%,1
南投縣,草屯鎮,0173,251,487,738,25,763,1178,64.77%,21.31%,1
南投縣,草屯鎮,0174,264,482,746,36,782,1327,58.93%,19.89%,1
南投縣,草屯鎮,0175,183,401,584,19,603,1000,60.3%,18.3%,1
南投縣,草屯鎮,0176,202,498,700,24,724,1257,57.6%,16.07%,1
南投縣,草屯鎮,0177,155,394,549,24,573,883,64.89%,17.55%,1
南投縣,草屯鎮,0178,124,479,603,23,626,1121,55.84%,11.06%,1
南投縣,草屯鎮,0179,177,417,594,26,620,1043,59.44%,16.97%,1
南投縣,草屯鎮,0180,186,405,591,14,605,979,61.8%,19%,1
南投縣,草屯鎮,0181,178,346,524,20,544,1048,51.91%,16.98%,1
南投縣,草屯鎮,0182,163,387,550,29,579,1009,57.38%,16.15%,1
南投縣,草屯鎮,0183,160,433,593,22,615,1138,54.04%,14.06%,1
南投縣,草屯鎮,0184,189,462,651,19,670,1197,55.97%,15.79%,1
南投縣,草屯鎮,0185,221,547,768,38,806,1364,59.09%,16.2%,1
南投縣,草屯鎮,0186,171,430,601,32,633,1059,59.77%,16.15%,1
南投縣,草屯鎮,0187,206,411,617,44,661,1108,59.66%,18.59%,1
南投縣,草屯鎮,0188,144,331,475,29,504,879,57.34%,16.38%,1
南投縣,草屯鎮,0189,140,377,517,48,565,957,59.04%,14.63%,1
南投縣,草屯鎮,0190,208,447,655,23,678,1395,48.6%,14.91%,1
南投縣,草屯鎮,0191,199,463,662,21,683,1101,62.03%,18.07%,1
南投縣,草屯鎮,0192,227,460,687,23,710,1297,54.74%,17.5%,1
南投縣,草屯鎮,0193,135,256,391,24,415,877,47.32%,15.39%,1
南投縣,草屯鎮,0194,199,432,631,52,683,1376,49.64%,14.46%,1
南投縣,草屯鎮,0195,186,426,612,41,653,1008,64.78%,18.45%,1
南投縣,草屯鎮,0196,185,450,635,32,667,1080,61.76%,17.13%,1
南投縣,草屯鎮,0197,175,347,522,43,565,1017,55.56%,17.21%,1
南投縣,草屯鎮,0198,176,409,585,29,614,961,63.89%,18.31%,1
南投縣,草屯鎮,0199,227,436,663,47,710,1160,61.21%,19.57%,1
南投縣,草屯鎮,0200,181,453,634,29,663,1121,59.14%,16.15%,1
南投縣,草屯鎮,0201,186,495,681,37,718,1243,57.76%,14.96%,1
南投縣,草屯鎮,0202,163,375,538,21,559,932,59.98%,17.49%,1
南投縣,草屯鎮,0203,255,560,815,48,863,1323,65.23%,19.27%,1
南投縣,草屯鎮,0204,201,567,768,31,799,1518,52.64%,13.24%,1
南投縣,草屯鎮,0205,187,363,550,34,584,923,63.27%,20.26%,1
南投縣,草屯鎮,0206,159,335,494,40,534,970,55.05%,16.39%,1
南投縣,草屯鎮,0207,212,371,583,24,607,1026,59.16%,20.66%,1
南投縣,草屯鎮,0208,250,530,780,51,831,1466,56.68%,17.05%,1
南投縣,草屯鎮,0209,206,452,658,22,680,1180,57.63%,17.46%,1
南投縣,草屯鎮,0210,189,411,600,15,615,1006,61.13%,18.79%,1
南投縣,草屯鎮,0211,170,310,480,29,509,1000,50.9%,17%,1
南投縣,草屯鎮,0212,221,448,669,22,691,1128,61.26%,19.59%,1
南投縣,草屯鎮,0213,106,235,341,17,358,623,57.46%,17.01%,1
南投縣,草屯鎮,0214,132,246,378,42,420,707,59.41%,18.67%,1
南投縣,草屯鎮,0215,111,255,366,26,392,719,54.52%,15.44%,1
南投縣,草屯鎮,0216,72,171,243,15,258,527,48.96%,13.66%,1
南投縣,草屯鎮,0217,216,447,663,48,711,1183,60.1%,18.26%,1
南投縣,草屯鎮,0218,167,348,515,19,534,869,61.45%,19.22%,1
南投縣,草屯鎮,0219,201,350,551,23,574,1132,50.71%,17.76%,1
南投縣,草屯鎮,0220,165,362,527,38,565,949,59.54%,17.39%,1
南投縣,草屯鎮,0221,178,381,559,26,585,965,60.62%,18.45%,1
南投縣,草屯鎮,0222,179,374,553,31,584,1068,54.68%,16.76%,1
南投縣,草屯鎮,0223,178,407,585,41,626,1024,61.13%,17.38%,1
南投縣,草屯鎮,0224,78,252,330,24,354,642,55.14%,12.15%,1
南投縣,草屯鎮,0225,140,367,507,30,537,1017,52.8%,13.77%,1
南投縣,草屯鎮,0226,168,440,608,24,632,1092,57.88%,15.38%,1
南投縣,草屯鎮,0227,178,446,624,39,663,1170,56.67%,15.21%,1
南投縣,草屯鎮,0228,172,456,628,35,663,1106,59.95%,15.55%,1
南投縣,竹山鎮,0229,170,489,659,44,703,1170,60.09%,14.53%,1
南投縣,竹山鎮,0230,340,147,487,45,532,850,62.59%,40%,1
南投縣,竹山鎮,0231,95,222,317,25,342,621,55.07%,15.3%,1
南投縣,竹山鎮,0232,154,322,476,33,509,905,56.24%,17.02%,1
南投縣,竹山鎮,0233,148,367,515,41,556,1099,50.59%,13.47%,1
南投縣,竹山鎮,0234,151,448,599,49,648,1214,53.38%,12.44%,1
南投縣,竹山鎮,0235,222,506,728,50,778,1287,60.45%,17.25%,1
南投縣,竹山鎮,0236,173,450,623,51,674,1191,56.59%,14.53%,1
南投縣,竹山鎮,0237,152,432,584,56,640,1118,57.25%,13.6%,1
南投縣,竹山鎮,0238,216,487,703,32,735,1278,57.51%,16.9%,1
南投縣,竹山鎮,0239,202,430,632,43,675,1153,58.54%,17.52%,1
南投縣,竹山鎮,0240,410,207,617,45,662,1243,53.26%,32.98%,1
南投縣,竹山鎮,0241,210,485,695,43,738,1308,56.42%,16.06%,1
南投縣,竹山鎮,0242,194,486,680,37,717,1358,52.8%,14.29%,1
南投縣,竹山鎮,0243,164,373,537,39,576,1044,55.17%,15.71%,1
南投縣,竹山鎮,0244,93,203,296,25,321,511,62.82%,18.2%,1
南投縣,竹山鎮,0245,105,250,355,15,370,682,54.25%,15.4%,1
南投縣,竹山鎮,0246,140,327,467,24,491,989,49.65%,14.16%,1
南投縣,竹山鎮,0247,181,538,719,40,759,1378,55.08%,13.13%,1
南投縣,竹山鎮,0248,39,78,117,2,119,217,54.84%,17.97%,1
南投縣,竹山鎮,0249,81,180,261,27,288,479,60.13%,16.91%,1
南投縣,竹山鎮,0250,40,156,196,14,210,430,48.84%,9.3%,1
南投縣,竹山鎮,0251,227,534,761,49,810,1437,56.37%,15.8%,1
南投縣,竹山鎮,0252,228,508,736,40,776,1286,60.34%,17.73%,1
南投縣,竹山鎮,0253,184,437,621,35,656,1080,60.74%,17.04%,1
南投縣,竹山鎮,0254,175,378,553,44,597,1070,55.79%,16.36%,1
南投縣,竹山鎮,0255,213,502,715,29,744,1295,57.45%,16.45%,1
南投縣,竹山鎮,0256,160,405,565,34,599,1047,57.21%,15.28%,1
南投縣,竹山鎮,0257,200,498,698,39,737,1300,56.69%,15.38%,1
南投縣,竹山鎮,0258,118,290,408,25,433,908,47.69%,13%,1
南投縣,竹山鎮,0259,126,250,376,46,422,821,51.4%,15.35%,1
南投縣,竹山鎮,0260,209,503,712,54,766,1320,58.03%,15.83%,1
南投縣,竹山鎮,0261,153,341,494,25,519,967,53.67%,15.82%,1
南投縣,竹山鎮,0262,80,209,289,18,307,595,51.6%,13.45%,1
南投縣,竹山鎮,0263,129,289,418,59,477,859,55.53%,15.02%,1
南投縣,竹山鎮,0264,178,414,592,54,646,1196,54.01%,14.88%,1
南投縣,竹山鎮,0265,105,230,335,35,370,649,57.01%,16.18%,1
南投縣,竹山鎮,0266,223,486,709,50,759,1341,56.6%,16.63%,1
南投縣,竹山鎮,0267,155,412,567,61,628,1222,51.39%,12.68%,1
南投縣,竹山鎮,0268,98,232,330,19,349,602,57.97%,16.28%,1
南投縣,竹山鎮,0269,100,223,323,23,346,617,56.08%,16.21%,1
南投縣,竹山鎮,0270,151,296,447,37,484,793,61.03%,19.04%,1
南投縣,竹山鎮,0271,149,356,505,19,524,922,56.83%,16.16%,1
南投縣,竹山鎮,0272,46,130,176,19,195,366,53.28%,12.57%,1
南投縣,竹山鎮,0273,46,186,232,13,245,509,48.13%,9.04%,1
南投縣,竹山鎮,0274,25,79,104,6,110,193,56.99%,12.95%,1
南投縣,竹山鎮,0275,73,161,234,18,252,406,62.07%,17.98%,1
南投縣,竹山鎮,0276,63,162,225,27,252,495,50.91%,12.73%,1
南投縣,竹山鎮,0277,26,78,104,13,117,307,38.11%,8.47%,1
南投縣,竹山鎮,0278,52,161,213,24,237,440,53.86%,11.82%,1
南投縣,竹山鎮,0279,78,198,276,37,313,577,54.25%,13.52%,1
南投縣,竹山鎮,0280,56,107,163,36,199,486,40.95%,11.52%,1
南投縣,竹山鎮,0281,37,99,136,12,148,403,36.72%,9.18%,1
南投縣,集集鎮,0282,173,454,627,28,655,1070,61.21%,16.17%,1
南投縣,集集鎮,0283,146,385,531,30,561,918,61.11%,15.9%,1
南投縣,集集鎮,0284,102,226,328,26,354,581,60.93%,17.56%,1
南投縣,集集鎮,0285,193,482,675,39,714,1194,59.8%,16.16%,1
南投縣,集集鎮,0286,66,138,204,18,222,488,45.49%,13.52%,1
南投縣,集集鎮,0287,88,202,290,24,314,504,62.3%,17.46%,1
南投縣,集集鎮,0288,142,341,483,82,565,910,62.09%,15.6%,1
南投縣,集集鎮,0289,128,322,450,34,484,773,62.61%,16.56%,1
南投縣,集集鎮,0290,131,250,381,21,402,709,56.7%,18.48%,1
南投縣,集集鎮,0291,174,358,532,21,553,960,57.6%,18.13%,1
南投縣,集集鎮,0292,77,172,249,27,276,503,54.87%,15.31%,1
南投縣,集集鎮,0293,66,131,197,15,212,419,50.6%,15.75%,1
南投縣,集集鎮,0294,76,181,257,13,270,582,46.39%,13.06%,1
南投縣,名間鄉,0295,204,475,679,50,729,1050,69.43%,19.43%,1
南投縣,名間鄉,0296,143,365,508,48,556,920,60.43%,15.54%,1
南投縣,名間鄉,0297,131,317,448,30,478,727,65.75%,18.02%,1
南投縣,名間鄉,0298,152,380,532,22,554,861,64.34%,17.65%,1
南投縣,名間鄉,0299,142,350,492,35,527,897,58.75%,15.83%,1
南投縣,名間鄉,0300,215,400,615,34,649,1055,61.52%,20.38%,1
南投縣,名間鄉,0301,186,464,650,51,701,1184,59.21%,15.71%,1
南投縣,名間鄉,0302,119,290,409,37,446,783,56.96%,15.2%,1
南投縣,名間鄉,0303,117,331,448,42,490,781,62.74%,14.98%,1
南投縣,名間鄉,0304,145,374,519,40,559,977,57.22%,14.84%,1
南投縣,名間鄉,0305,155,368,523,47,570,1015,56.16%,15.27%,1
南投縣,名間鄉,0306,162,376,538,25,563,914,61.6%,17.72%,1
南投縣,名間鄉,0307,180,300,480,16,496,1028,48.25%,17.51%,1
南投縣,名間鄉,0308,153,430,583,34,617,1018,60.61%,15.03%,1
南投縣,名間鄉,0309,205,493,698,59,757,1274,59.42%,16.09%,1
南投縣,名間鄉,0310,125,299,424,32,456,755,60.4%,16.56%,1
南投縣,名間鄉,0311,153,398,551,41,592,895,66.15%,17.09%,1
南投縣,名間鄉,0312,134,371,505,22,527,892,59.08%,15.02%,1
南投縣,名間鄉,0313,149,353,502,50,552,951,58.04%,15.67%,1
南投縣,名間鄉,0314,185,498,683,43,726,1261,57.57%,14.67%,1
南投縣,名間鄉,0315,128,281,409,34,443,768,57.68%,16.67%,1
南投縣,名間鄉,0316,160,372,532,52,584,962,60.71%,16.63%,1
南投縣,名間鄉,0317,133,351,484,51,535,867,61.71%,15.34%,1
南投縣,名間鄉,0318,161,343,504,65,569,930,61.18%,17.31%,1
南投縣,名間鄉,0319,94,249,343,45,388,641,60.53%,14.66%,1
南投縣,名間鄉,0320,61,197,258,23,281,530,53.02%,11.51%,1
南投縣,名間鄉,0321,180,326,506,52,558,931,59.94%,19.33%,1
南投縣,名間鄉,0322,180,440,620,50,670,1127,59.45%,15.97%,1
南投縣,名間鄉,0323,78,187,265,30,295,443,66.59%,17.61%,1
南投縣,名間鄉,0324,133,360,493,41,534,870,61.38%,15.29%,1
南投縣,名間鄉,0325,119,241,360,35,395,621,63.61%,19.16%,1
南投縣,名間鄉,0326,189,420,609,32,641,1179,54.37%,16.03%,1
南投縣,名間鄉,0327,147,364,511,44,555,881,63%,16.69%,1
南投縣,名間鄉,0328,133,426,559,37,596,876,68.04%,15.18%,1
南投縣,名間鄉,0329,112,319,431,46,477,783,60.92%,14.3%,1
南投縣,名間鄉,0330,91,302,393,30,423,778,54.37%,11.7%,1
南投縣,名間鄉,0331,151,350,501,42,543,983,55.24%,15.36%,1
南投縣,鹿谷鄉,0332,100,332,432,52,484,934,51.82%,10.71%,1
南投縣,鹿谷鄉,0333,145,364,509,33,542,940,57.66%,15.43%,1
南投縣,鹿谷鄉,0334,138,294,432,25,457,852,53.64%,16.2%,1
南投縣,鹿谷鄉,0335,80,110,190,30,220,451,48.78%,17.74%,1
南投縣,鹿谷鄉,0336,127,350,477,19,496,810,61.23%,15.68%,1
南投縣,鹿谷鄉,0337,172,504,676,36,712,1142,62.35%,15.06%,1
南投縣,鹿谷鄉,0338,106,253,359,19,378,766,49.35%,13.84%,1
南投縣,鹿谷鄉,0339,120,359,479,39,518,884,58.6%,13.57%,1
南投縣,鹿谷鄉,0340,146,283,429,31,460,811,56.72%,18%,1
南投縣,鹿谷鄉,0341,70,184,254,22,276,581,47.5%,12.05%,1
南投縣,鹿谷鄉,0342,85,194,279,17,296,578,51.21%,14.71%,1
南投縣,鹿谷鄉,0343,78,179,257,22,279,467,59.74%,16.7%,1
南投縣,鹿谷鄉,0344,69,249,318,28,346,622,55.63%,11.09%,1
南投縣,鹿谷鄉,0345,100,264,364,19,383,740,51.76%,13.51%,1
南投縣,鹿谷鄉,0346,93,305,398,35,433,767,56.45%,12.13%,1
南投縣,鹿谷鄉,0347,123,378,501,30,531,909,58.42%,13.53%,1
南投縣,鹿谷鄉,0348,114,239,353,20,373,713,52.31%,15.99%,1
南投縣,鹿谷鄉,0349,95,224,319,19,338,717,47.14%,13.25%,1
南投縣,鹿谷鄉,0350,119,265,384,24,408,794,51.39%,14.99%,1
南投縣,鹿谷鄉,0351,108,238,346,15,361,726,49.72%,14.88%,1
南投縣,鹿谷鄉,0352,88,210,298,31,329,737,44.64%,11.94%,1
南投縣,中寮鄉,0353,128,340,468,37,505,822,61.44%,15.57%,1
南投縣,中寮鄉,0354,40,103,143,12,155,253,61.26%,15.81%,1
南投縣,中寮鄉,0355,25,66,91,4,95,221,42.99%,11.31%,1
南投縣,中寮鄉,0356,52,110,162,4,166,353,47.03%,14.73%,1
南投縣,中寮鄉,0357,64,155,219,17,236,427,55.27%,14.99%,1
南投縣,中寮鄉,0358,48,169,217,15,232,406,57.14%,11.82%,1
南投縣,中寮鄉,0359,35,108,143,18,161,307,52.44%,11.4%,1
南投縣,中寮鄉,0360,103,272,375,28,403,661,60.97%,15.58%,1
南投縣,中寮鄉,0361,47,133,180,12,192,290,66.21%,16.21%,1
南投縣,中寮鄉,0362,163,365,528,44,572,973,58.79%,16.75%,1
南投縣,中寮鄉,0363,123,312,435,21,456,754,60.48%,16.31%,1
南投縣,中寮鄉,0364,86,254,340,28,368,662,55.59%,12.99%,1
南投縣,中寮鄉,0365,53,173,226,10,236,490,48.16%,10.82%,1
南投縣,中寮鄉,0366,56,107,163,13,176,335,52.54%,16.72%,1
南投縣,中寮鄉,0367,153,389,542,34,576,990,58.18%,15.45%,1
南投縣,中寮鄉,0368,68,210,278,18,296,461,64.21%,14.75%,1
南投縣,中寮鄉,0369,101,257,358,23,381,614,62.05%,16.45%,1
南投縣,中寮鄉,0370,117,349,466,44,510,895,56.98%,13.07%,1
南投縣,中寮鄉,0371,61,177,238,27,265,465,56.99%,13.12%,1
南投縣,中寮鄉,0372,121,230,351,51,402,682,58.94%,17.74%,1
南投縣,中寮鄉,0373,74,198,272,31,303,490,61.84%,15.1%,1
南投縣,中寮鄉,0374,92,272,364,31,395,643,61.43%,14.31%,1
南投縣,中寮鄉,0375,68,197,265,19,284,459,61.87%,14.81%,1
南投縣,中寮鄉,0376,65,185,250,15,265,528,50.19%,12.31%,1
南投縣,魚池鄉,0377,155,341,496,35,531,922,57.59%,16.81%,1
南投縣,魚池鄉,0378,191,406,597,52,649,1098,59.11%,17.4%,1
南投縣,魚池鄉,0379,129,229,358,29,387,720,53.75%,17.92%,1
南投縣,魚池鄉,0380,128,337,465,42,507,860,58.95%,14.88%,1
南投縣,魚池鄉,0381,58,181,239,24,263,514,51.17%,11.28%,1
南投縣,魚池鄉,0382,90,188,278,12,290,574,50.52%,15.68%,1
南投縣,魚池鄉,0383,195,442,637,47,684,1249,54.76%,15.61%,1
南投縣,魚池鄉,0384,55,133,188,6,194,293,66.21%,18.77%,1
南投縣,魚池鄉,0385,75,183,258,21,279,513,54.39%,14.62%,1
南投縣,魚池鄉,0386,43,53,96,7,103,186,55.38%,23.12%,1
南投縣,魚池鄉,0387,124,283,407,26,433,841,51.49%,14.74%,1
南投縣,魚池鄉,0388,49,107,156,14,170,270,62.96%,18.15%,1
南投縣,魚池鄉,0389,42,95,137,17,154,275,56%,15.27%,1
南投縣,魚池鄉,0390,27,97,124,7,131,282,46.45%,9.57%,1
南投縣,魚池鄉,0391,60,125,185,9,194,392,49.49%,15.31%,1
南投縣,魚池鄉,0392,72,201,273,33,306,556,55.04%,12.95%,1
南投縣,魚池鄉,0393,17,74,91,6,97,176,55.11%,9.66%,1
南投縣,魚池鄉,0394,80,166,246,26,272,578,47.06%,13.84%,1
南投縣,魚池鄉,0395,67,135,202,22,224,439,51.03%,15.26%,1
南投縣,魚池鄉,0396,130,335,465,24,489,844,57.94%,15.4%,1
南投縣,魚池鄉,0397,129,308,437,33,470,868,54.15%,14.86%,1
南投縣,魚池鄉,0398,58,119,177,13,190,405,46.91%,14.32%,1
南投縣,魚池鄉,0399,90,201,291,16,307,537,57.17%,16.76%,1
南投縣,魚池鄉,0400,43,127,170,13,183,335,54.63%,12.84%,1
南投縣,魚池鄉,0401,16,76,92,12,104,231,45.02%,6.93%,1
南投縣,國姓鄉,0402,125,428,553,50,603,964,62.55%,12.97%,1
南投縣,國姓鄉,0403,89,307,396,20,416,736,56.52%,12.09%,1
南投縣,國姓鄉,0404,100,325,425,52,477,801,59.55%,12.48%,1
南投縣,國姓鄉,0405,137,398,535,17,552,964,57.26%,14.21%,1
南投縣,國姓鄉,0406,100,255,355,32,387,686,56.41%,14.58%,1
南投縣,國姓鄉,0407,91,251,342,20,362,661,54.77%,13.77%,1
南投縣,國姓鄉,0408,82,272,354,25,379,730,51.92%,11.23%,1
南投縣,國姓鄉,0409,107,284,391,45,436,774,56.33%,13.82%,1
南投縣,國姓鄉,0410,119,283,402,18,420,706,59.49%,16.86%,1
南投縣,國姓鄉,0411,127,418,545,32,577,1012,57.02%,12.55%,1
南投縣,國姓鄉,0412,95,299,394,20,414,868,47.7%,10.94%,1
南投縣,國姓鄉,0413,135,400,535,21,556,918,60.57%,14.71%,1
南投縣,國姓鄉,0414,132,365,497,39,536,937,57.2%,14.09%,1
南投縣,國姓鄉,0415,125,290,415,35,450,815,55.21%,15.34%,1
南投縣,國姓鄉,0416,167,481,648,37,685,1134,60.41%,14.73%,1
南投縣,國姓鄉,0417,117,256,373,24,397,714,55.6%,16.39%,1
南投縣,國姓鄉,0418,174,432,606,42,648,1095,59.18%,15.89%,1
南投縣,國姓鄉,0419,61,154,215,22,237,448,52.9%,13.62%,1
南投縣,國姓鄉,0420,112,406,518,53,571,1064,53.67%,10.53%,1
南投縣,國姓鄉,0421,73,206,279,21,300,570,52.63%,12.81%,1
南投縣,水里鄉,0422,110,287,397,25,422,757,55.75%,14.53%,1
南投縣,水里鄉,0423,84,195,279,34,313,554,56.5%,15.16%,1
南投縣,水里鄉,0424,161,378,539,40,579,999,57.96%,16.12%,1
南投縣,水里鄉,0425,85,236,321,16,337,616,54.71%,13.8%,1
南投縣,水里鄉,0426,146,357,503,22,525,875,60%,16.69%,1
南投縣,水里鄉,0427,82,204,286,8,294,480,61.25%,17.08%,1
南投縣,水里鄉,0428,83,148,231,17,248,450,55.11%,18.44%,1
南投縣,水里鄉,0429,112,206,318,37,355,643,55.21%,17.42%,1
南投縣,水里鄉,0430,146,416,562,25,587,1004,58.47%,14.54%,1
南投縣,水里鄉,0431,98,320,418,22,440,741,59.38%,13.23%,1
南投縣,水里鄉,0432,165,293,458,11,469,802,58.48%,20.57%,1
南投縣,水里鄉,0433,168,419,587,54,641,998,64.23%,16.83%,1
南投縣,水里鄉,0434,115,285,400,42,442,800,55.25%,14.38%,1
南投縣,水里鄉,0435,90,258,348,19,367,589,62.31%,15.28%,1
南投縣,水里鄉,0436,118,299,417,47,464,887,52.31%,13.3%,1
南投縣,水里鄉,0437,158,444,602,35,637,1217,52.34%,12.98%,1
南投縣,水里鄉,0438,26,54,80,1,81,205,39.51%,12.68%,1
南投縣,水里鄉,0439,50,135,185,24,209,330,63.33%,15.15%,1
南投縣,水里鄉,0440,149,398,547,32,579,1100,52.64%,13.55%,1
南投縣,水里鄉,0441,22,75,97,8,105,275,38.18%,8%,1
南投縣,水里鄉,0442,57,80,137,2,139,318,43.71%,17.92%,1
南投縣,水里鄉,0443,101,297,398,48,446,818,54.52%,12.35%,1
南投縣,信義鄉,0444,138,471,609,70,679,1201,56.54%,11.49%,1
南投縣,信義鄉,0445,31,132,163,15,178,329,54.1%,9.42%,1
南投縣,信義鄉,0446,75,169,244,27,271,516,52.52%,14.53%,1
南投縣,信義鄉,0447,44,141,185,17,202,424,47.64%,10.38%,1
南投縣,信義鄉,0448,42,123,165,4,169,321,52.65%,13.08%,1
南投縣,信義鄉,0449,84,310,394,22,416,648,64.2%,12.96%,1
南投縣,信義鄉,0450,58,348,406,33,439,584,75.17%,9.93%,1
南投縣,信義鄉,0451,110,611,721,26,747,1376,54.29%,7.99%,1
南投縣,信義鄉,0452,96,432,528,22,550,979,56.18%,9.81%,1
南投縣,信義鄉,0453,66,290,356,39,395,530,74.53%,12.45%,1
南投縣,信義鄉,0454,119,348,467,39,506,961,52.65%,12.38%,1
南投縣,信義鄉,0455,55,184,239,18,257,464,55.39%,11.85%,1
南投縣,信義鄉,0456,77,194,271,34,305,517,58.99%,14.89%,1
南投縣,信義鄉,0457,23,58,81,8,89,149,59.73%,15.44%,1
南投縣,信義鄉,0458,103,593,696,67,763,1020,74.8%,10.1%,1
南投縣,信義鄉,0459,77,501,578,61,639,929,68.78%,8.29%,1
南投縣,信義鄉,0460,27,95,122,7,129,274,47.08%,9.85%,1
南投縣,信義鄉,0461,96,503,599,35,634,900,70.44%,10.67%,1
南投縣,信義鄉,0462,73,346,419,32,451,617,73.1%,11.83%,1
南投縣,信義鄉,0463,67,284,351,26,377,560,67.32%,11.96%,1
南投縣,仁愛鄉,0464,395,136,531,20,551,973,56.63%,40.6%,1
南投縣,仁愛鄉,0465,43,97,140,10,150,296,50.68%,14.53%,1
南投縣,仁愛鄉,0466,115,324,439,14,453,900,50.33%,12.78%,1
南投縣,仁愛鄉,0467,75,202,277,20,297,460,64.57%,16.3%,1
南投縣,仁愛鄉,0468,45,128,173,10,183,305,60%,14.75%,1
南投縣,仁愛鄉,0469,1,17,18,2,20,58,34.48%,1.72%,1
南投縣,仁愛鄉,0470,96,406,502,9,511,952,53.68%,10.08%,1
南投縣,仁愛鄉,0471,64,234,298,7,305,679,44.92%,9.43%,1
南投縣,仁愛鄉,0472,77,246,323,46,369,623,59.23%,12.36%,1
南投縣,仁愛鄉,0473,47,159,206,10,216,597,36.18%,7.87%,1
南投縣,仁愛鄉,0474,28,194,222,27,249,384,64.84%,7.29%,1
南投縣,仁愛鄉,0475,4,54,58,4,62,121,51.24%,3.31%,1
南投縣,仁愛鄉,0476,31,138,169,2,171,264,64.77%,11.74%,1
南投縣,仁愛鄉,0477,54,312,366,16,382,509,75.05%,10.61%,1
南投縣,仁愛鄉,0478,25,162,187,20,207,338,61.24%,7.4%,1
南投縣,仁愛鄉,0479,23,60,83,1,84,169,49.7%,13.61%,1
南投縣,仁愛鄉,0480,80,193,273,20,293,613,47.8%,13.05%,1
南投縣,仁愛鄉,0481,52,126,178,12,190,404,47.03%,12.87%,1
南投縣,仁愛鄉,0482,13,61,74,4,78,134,58.21%,9.7%,1
南投縣,仁愛鄉,0483,69,306,375,32,407,630,64.6%,10.95%,1
南投縣,仁愛鄉,0484,82,285,367,13,380,763,49.8%,10.75%,1
南投縣,仁愛鄉,0485,66,483,549,29,578,889,65.02%,7.42%,1
南投縣,仁愛鄉,0486,79,326,405,33,438,672,65.18%,11.76%,1
南投縣,仁愛鄉,0487,69,185,254,20,274,447,61.3%,15.44%,1
南投縣,仁愛鄉,0488,62,236,298,7,305,409,74.57%,15.16%,1
雲林縣,斗六市,0411,127,217,344,15,359,644,55.75%,19.72%,1
雲林縣,斗六市,0412,104,220,324,21,345,617,55.92%,16.86%,1
雲林縣,斗六市,0413,174,320,494,28,522,764,68.32%,22.77%,1
雲林縣,斗六市,0414,153,312,465,25,490,784,62.5%,19.52%,1
雲林縣,斗六市,0415,138,259,397,47,444,760,58.42%,18.16%,1
雲林縣,斗六市,0416,345,747,1092,49,1141,1881,60.66%,18.34%,1
雲林縣,斗六市,0417,302,655,957,53,1010,1829,55.22%,16.51%,1
雲林縣,斗六市,0418,242,539,781,28,809,1255,64.46%,19.28%,1
雲林縣,斗六市,0419,227,456,683,20,703,1090,64.5%,20.83%,1
雲林縣,斗六市,0420,213,430,643,29,672,1103,60.92%,19.31%,1
雲林縣,斗六市,0421,202,469,671,38,709,1176,60.29%,17.18%,1
雲林縣,斗六市,0422,261,595,856,17,873,1529,57.1%,17.07%,1
雲林縣,斗六市,0423,209,537,746,43,789,1335,59.1%,15.66%,1
雲林縣,斗六市,0424,297,703,1000,46,1046,1770,59.1%,16.78%,1
雲林縣,斗六市,0425,238,478,716,36,752,1308,57.49%,18.2%,1
雲林縣,斗六市,0426,349,758,1107,68,1175,2171,54.12%,16.08%,1
雲林縣,斗六市,0427,211,485,696,31,727,1193,60.94%,17.69%,1
雲林縣,斗六市,0428,288,651,939,40,979,1572,62.28%,18.32%,1
雲林縣,斗六市,0429,181,374,555,18,573,1009,56.79%,17.94%,1
雲林縣,斗六市,0430,226,470,696,40,736,1195,61.59%,18.91%,1
雲林縣,斗六市,0431,260,565,825,52,877,1415,61.98%,18.37%,1
雲林縣,斗六市,0432,196,442,638,37,675,1101,61.31%,17.8%,1
雲林縣,斗六市,0433,276,601,877,45,922,1648,55.95%,16.75%,1
雲林縣,斗六市,0434,247,550,797,21,818,1588,51.51%,15.55%,1
雲林縣,斗六市,0435,284,522,806,21,827,1392,59.41%,20.4%,1
雲林縣,斗六市,0436,274,537,811,22,833,1422,58.58%,19.27%,1
雲林縣,斗六市,0437,155,409,564,31,595,1187,50.13%,13.06%,1
雲林縣,斗六市,0438,208,366,574,37,611,1142,53.5%,18.21%,1
雲林縣,斗六市,0439,264,583,847,33,880,1421,61.93%,18.58%,1
雲林縣,斗六市,0440,202,492,694,32,726,1261,57.57%,16.02%,1
雲林縣,斗六市,0441,249,528,777,26,803,1506,53.32%,16.53%,1
雲林縣,斗六市,0442,257,445,702,28,730,1214,60.13%,21.17%,1
雲林縣,斗六市,0443,242,574,816,55,871,1362,63.95%,17.77%,1
雲林縣,斗六市,0444,207,389,596,22,618,1097,56.34%,18.87%,1
雲林縣,斗六市,0445,211,490,701,29,730,1262,57.84%,16.72%,1
雲林縣,斗六市,0446,200,407,607,27,634,1154,54.94%,17.33%,1
雲林縣,斗六市,0447,149,328,477,32,509,847,60.09%,17.59%,1
雲林縣,斗六市,0448,260,552,812,24,836,1439,58.1%,18.07%,1
雲林縣,斗六市,0449,352,664,1016,49,1065,1747,60.96%,20.15%,1
雲林縣,斗六市,0450,282,488,770,39,809,1418,57.05%,19.89%,1
雲林縣,斗六市,0451,165,436,601,32,633,1112,56.92%,14.84%,1
雲林縣,斗六市,0452,242,483,725,31,756,1302,58.06%,18.59%,1
雲林縣,斗六市,0453,129,284,413,20,433,669,64.72%,19.28%,1
雲林縣,斗六市,0454,141,258,399,31,430,752,57.18%,18.75%,1
雲林縣,斗六市,0455,258,508,766,25,791,1450,54.55%,17.79%,1
雲林縣,斗六市,0456,91,197,288,34,322,555,58.02%,16.4%,1
雲林縣,斗六市,0457,240,490,730,39,769,1470,52.31%,16.33%,1
雲林縣,斗六市,0458,165,371,536,22,558,927,60.19%,17.8%,1
雲林縣,斗六市,0459,360,702,1062,45,1107,1893,58.48%,19.02%,1
雲林縣,斗六市,0460,264,630,894,80,974,1708,57.03%,15.46%,1
雲林縣,斗六市,0461,247,590,837,56,893,1773,50.37%,13.93%,1
雲林縣,斗六市,0462,265,550,815,25,840,1412,59.49%,18.77%,1
雲林縣,斗六市,0463,257,552,809,28,837,1354,61.82%,18.98%,1
雲林縣,斗六市,0464,253,449,702,20,722,1267,56.99%,19.97%,1
雲林縣,斗六市,0465,224,448,672,21,693,1273,54.44%,17.6%,1
雲林縣,斗六市,0466,131,600,731,77,808,1748,46.22%,7.49%,1
雲林縣,斗六市,0467,200,469,669,64,733,1238,59.21%,16.16%,1
雲林縣,斗六市,0468,239,613,852,39,891,1648,54.07%,14.5%,1
雲林縣,斗六市,0469,272,595,867,51,918,1520,60.39%,17.89%,1
雲林縣,斗六市,0470,144,418,562,21,583,1087,53.63%,13.25%,1
雲林縣,斗六市,0471,313,703,1016,68,1084,1904,56.93%,16.44%,1
雲林縣,斗六市,0472,121,285,406,28,434,702,61.82%,17.24%,1
雲林縣,斗六市,0473,204,398,602,56,658,1111,59.23%,18.36%,1
雲林縣,斗六市,0474,131,389,520,34,554,1123,49.33%,11.67%,1
雲林縣,斗六市,0475,164,424,588,32,620,1146,54.1%,14.31%,1
雲林縣,斗六市,0476,309,611,920,36,956,1786,53.53%,17.3%,1
雲林縣,斗六市,0477,171,364,535,53,588,1023,57.48%,16.72%,1
雲林縣,斗六市,0478,340,731,1071,72,1143,2072,55.16%,16.41%,1
雲林縣,斗六市,0479,195,382,577,34,611,1128,54.17%,17.29%,1
雲林縣,斗南鎮,0498,202,458,660,42,702,1166,60.21%,17.32%,1
雲林縣,斗南鎮,0499,211,454,665,34,699,1135,61.59%,18.59%,1
雲林縣,斗南鎮,0500,195,385,580,27,607,975,62.26%,20%,1
雲林縣,斗南鎮,0501,291,539,830,39,869,1459,59.56%,19.95%,1
雲林縣,斗南鎮,0502,260,496,756,42,798,1351,59.07%,19.25%,1
雲林縣,斗南鎮,0503,220,485,705,41,746,1321,56.47%,16.65%,1
雲林縣,斗南鎮,0504,139,316,455,44,499,907,55.02%,15.33%,1
雲林縣,斗南鎮,0505,234,633,867,55,922,1473,62.59%,15.89%,1
雲林縣,斗南鎮,0506,241,506,747,55,802,1277,62.8%,18.87%,1
雲林縣,斗南鎮,0507,214,474,688,67,755,1333,56.64%,16.05%,1
雲林縣,斗南鎮,0508,123,268,391,33,424,777,54.57%,15.83%,1
雲林縣,斗南鎮,0509,153,301,454,28,482,877,54.96%,17.45%,1
雲林縣,斗南鎮,0510,123,328,451,43,494,899,54.95%,13.68%,1
雲林縣,斗南鎮,0511,89,195,284,37,321,688,46.66%,12.94%,1
雲林縣,斗南鎮,0512,168,381,549,27,576,1147,50.22%,14.65%,1
雲林縣,斗南鎮,0513,296,583,879,69,948,1709,55.47%,17.32%,1
雲林縣,斗南鎮,0514,194,405,599,39,638,1042,61.23%,18.62%,1
雲林縣,斗南鎮,0515,383,460,843,45,888,1631,54.45%,23.48%,1
雲林縣,斗南鎮,0516,311,653,964,65,1029,1702,60.46%,18.27%,1
雲林縣,斗南鎮,0517,278,586,864,57,921,1564,58.89%,17.77%,1
雲林縣,斗南鎮,0518,112,290,402,25,427,910,46.92%,12.31%,1
雲林縣,斗南鎮,0519,245,516,761,41,802,1276,62.85%,19.2%,1
雲林縣,斗南鎮,0520,120,279,399,17,416,897,46.38%,13.38%,1
雲林縣,斗南鎮,0521,140,274,414,24,438,803,54.55%,17.43%,1
雲林縣,斗南鎮,0522,135,327,462,43,505,866,58.31%,15.59%,1
雲林縣,斗南鎮,0523,146,304,450,53,503,852,59.04%,17.14%,1
雲林縣,斗南鎮,0524,95,243,338,42,380,671,56.63%,14.16%,1
雲林縣,斗南鎮,0525,173,332,505,24,529,981,53.92%,17.64%,1
雲林縣,斗南鎮,0526,176,333,509,29,538,1129,47.65%,15.59%,1
雲林縣,斗南鎮,0527,287,580,867,71,938,1586,59.14%,18.1%,1
雲林縣,斗南鎮,0528,247,474,721,52,773,1243,62.19%,19.87%,1
雲林縣,斗南鎮,0529,131,322,453,27,480,984,48.78%,13.31%,1
雲林縣,斗南鎮,0530,251,533,784,68,852,1507,56.54%,16.66%,1
雲林縣,虎尾鎮,0109,232,471,703,41,744,1347,55.23%,17.22%,1
雲林縣,虎尾鎮,0110,239,469,708,33,741,1258,58.9%,19%,1
雲林縣,虎尾鎮,0111,136,276,412,26,438,785,55.8%,17.32%,1
雲林縣,虎尾鎮,0112,130,277,407,31,438,890,49.21%,14.61%,1
雲林縣,虎尾鎮,0113,270,525,795,44,839,1413,59.38%,19.11%,1
雲林縣,虎尾鎮,0114,254,578,832,38,870,1431,60.8%,17.75%,1
雲林縣,虎尾鎮,0115,190,420,610,51,661,1224,54%,15.52%,1
雲林縣,虎尾鎮,0116,187,428,615,34,649,1325,48.98%,14.11%,1
雲林縣,虎尾鎮,0117,193,323,516,55,571,941,60.68%,20.51%,1
雲林縣,虎尾鎮,0118,270,580,850,24,874,1613,54.18%,16.74%,1
雲林縣,虎尾鎮,0119,280,555,835,28,863,1641,52.59%,17.06%,1
雲林縣,虎尾鎮,0120,224,439,663,44,707,1200,58.92%,18.67%,1
雲林縣,虎尾鎮,0121,225,472,697,63,760,1294,58.73%,17.39%,1
雲林縣,虎尾鎮,0122,218,481,699,23,722,1273,56.72%,17.12%,1
雲林縣,虎尾鎮,0123,257,605,862,25,887,1438,61.68%,17.87%,1
雲林縣,虎尾鎮,0124,237,523,760,25,785,1361,57.68%,17.41%,1
雲林縣,虎尾鎮,0125,328,500,828,36,864,1444,59.83%,22.71%,1
雲林縣,虎尾鎮,0126,289,618,907,26,933,1490,62.62%,19.4%,1
雲林縣,虎尾鎮,0127,345,445,790,37,827,1307,63.27%,26.4%,1
雲林縣,虎尾鎮,0128,163,300,463,28,491,967,50.78%,16.86%,1
雲林縣,虎尾鎮,0129,298,676,974,24,998,1865,53.51%,15.98%,1
雲林縣,虎尾鎮,0130,338,676,1014,32,1046,1880,55.64%,17.98%,1
雲林縣,虎尾鎮,0131,166,373,539,35,574,1099,52.23%,15.1%,1
雲林縣,虎尾鎮,0132,158,342,500,19,519,901,57.6%,17.54%,1
雲林縣,虎尾鎮,0133,195,370,565,33,598,1120,53.39%,17.41%,1
雲林縣,虎尾鎮,0134,84,168,252,8,260,545,47.71%,15.41%,1
雲林縣,虎尾鎮,0135,240,459,699,57,756,1420,53.24%,16.9%,1
雲林縣,虎尾鎮,0136,204,402,606,24,630,1248,50.48%,16.35%,1
雲林縣,虎尾鎮,0137,118,300,418,21,439,799,54.94%,14.77%,1
雲林縣,虎尾鎮,0138,125,273,398,50,448,836,53.59%,14.95%,1
雲林縣,虎尾鎮,0139,153,259,412,34,446,924,48.27%,16.56%,1
雲林縣,虎尾鎮,0140,209,481,690,29,719,1648,43.63%,12.68%,1
雲林縣,虎尾鎮,0141,244,444,688,85,773,1616,47.83%,15.1%,1
雲林縣,虎尾鎮,0142,229,504,733,46,779,1546,50.39%,14.81%,1
雲林縣,虎尾鎮,0143,171,459,630,33,663,1283,51.68%,13.33%,1
雲林縣,虎尾鎮,0144,169,353,522,31,553,1078,51.3%,15.68%,1
雲林縣,虎尾鎮,0145,183,402,585,45,630,1313,47.98%,13.94%,1
雲林縣,虎尾鎮,0146,188,420,608,33,641,1284,49.92%,14.64%,1
雲林縣,虎尾鎮,0147,205,450,655,73,728,1356,53.69%,15.12%,1
雲林縣,虎尾鎮,0148,231,531,762,53,815,1504,54.19%,15.36%,1
雲林縣,虎尾鎮,0149,181,381,562,27,589,1224,48.12%,14.79%,1
雲林縣,虎尾鎮,0150,205,451,656,53,709,1509,46.98%,13.59%,1
雲林縣,虎尾鎮,0151,128,193,321,47,368,855,43.04%,14.97%,1
雲林縣,虎尾鎮,0152,222,432,654,66,720,1549,46.48%,14.33%,1
雲林縣,虎尾鎮,0153,121,260,381,21,402,851,47.24%,14.22%,1
雲林縣,虎尾鎮,0154,164,411,575,62,637,1272,50.08%,12.89%,1
雲林縣,西螺鎮,0340,274,489,763,61,824,1590,51.82%,17.23%,1
雲林縣,西螺鎮,0341,301,600,901,52,953,1741,54.74%,17.29%,1
雲林縣,西螺鎮,0342,220,439,659,44,703,1080,65.09%,20.37%,1
雲林縣,西螺鎮,0343,213,398,611,44,655,1040,62.98%,20.48%,1
雲林縣,西螺鎮,0344,214,511,725,36,761,1346,56.54%,15.9%,1
雲林縣,西螺鎮,0345,256,598,854,36,890,1625,54.77%,15.75%,1
雲林縣,西螺鎮,0346,67,152,219,9,228,354,64.41%,18.93%,1
雲林縣,西螺鎮,0347,101,195,296,25,321,580,55.34%,17.41%,1
雲林縣,西螺鎮,0348,120,236,356,19,375,591,63.45%,20.3%,1
雲林縣,西螺鎮,0349,204,366,570,51,621,1050,59.14%,19.43%,1
雲林縣,西螺鎮,0350,214,435,649,60,709,1147,61.81%,18.66%,1
雲林縣,西螺鎮,0351,265,528,793,68,861,1602,53.75%,16.54%,1
雲林縣,西螺鎮,0352,238,497,735,41,776,1452,53.44%,16.39%,1
雲林縣,西螺鎮,0353,255,553,808,68,876,1578,55.51%,16.16%,1
雲林縣,西螺鎮,0354,195,444,639,28,667,1305,51.11%,14.94%,1
雲林縣,西螺鎮,0355,182,371,553,51,604,1327,45.52%,13.72%,1
雲林縣,西螺鎮,0356,248,493,741,56,797,1516,52.57%,16.36%,1
雲林縣,西螺鎮,0357,122,205,327,26,353,828,42.63%,14.73%,1
雲林縣,西螺鎮,0358,101,203,304,17,321,788,40.74%,12.82%,1
雲林縣,西螺鎮,0359,131,258,389,58,447,863,51.8%,15.18%,1
雲林縣,西螺鎮,0360,156,281,437,87,524,984,53.25%,15.85%,1
雲林縣,西螺鎮,0361,212,466,678,223,901,1514,59.51%,14%,1
雲林縣,西螺鎮,0362,130,288,418,53,471,870,54.14%,14.94%,1
雲林縣,西螺鎮,0363,172,292,464,53,517,971,53.24%,17.71%,1
雲林縣,西螺鎮,0364,191,360,551,51,602,1304,46.17%,14.65%,1
雲林縣,西螺鎮,0365,125,200,325,28,353,726,48.62%,17.22%,1
雲林縣,西螺鎮,0366,104,302,406,39,445,823,54.07%,12.64%,1
雲林縣,西螺鎮,0367,97,246,343,21,364,886,41.08%,10.95%,1
雲林縣,西螺鎮,0368,218,382,600,86,686,1373,49.96%,15.88%,1
雲林縣,西螺鎮,0369,176,297,473,67,540,983,54.93%,17.9%,1
雲林縣,西螺鎮,0370,165,326,491,55,546,1014,53.85%,16.27%,1
雲林縣,西螺鎮,0371,143,256,399,77,476,939,50.69%,15.23%,1
雲林縣,西螺鎮,0372,121,277,398,44,442,866,51.04%,13.97%,1
雲林縣,西螺鎮,0373,197,440,637,85,722,1486,48.59%,13.26%,1
雲林縣,土庫鎮,0080,143,322,465,50,515,809,63.66%,17.68%,1
雲林縣,土庫鎮,0081,161,378,539,41,580,896,64.73%,17.97%,1
雲林縣,土庫鎮,0082,124,250,374,31,405,687,58.95%,18.05%,1
雲林縣,土庫鎮,0083,150,295,445,27,472,702,67.24%,21.37%,1
雲林縣,土庫鎮,0084,181,429,610,25,635,1032,61.53%,17.54%,1
雲林縣,土庫鎮,0085,116,210,326,44,370,697,53.08%,16.64%,1
雲林縣,土庫鎮,0086,57,137,194,31,225,427,52.69%,13.35%,1
雲林縣,土庫鎮,0087,244,548,792,49,841,1451,57.96%,16.82%,1
雲林縣,土庫鎮,0088,209,505,714,19,733,1283,57.13%,16.29%,1
雲林縣,土庫鎮,0089,109,172,281,16,297,634,46.85%,17.19%,1
雲林縣,土庫鎮,0090,159,252,411,24,435,796,54.65%,19.97%,1
雲林縣,土庫鎮,0091,100,189,289,42,331,745,44.43%,13.42%,1
雲林縣,土庫鎮,0092,77,184,261,27,288,576,50%,13.37%,1
雲林縣,土庫鎮,0093,79,217,296,58,354,743,47.64%,10.63%,1
雲林縣,土庫鎮,0094,89,138,227,9,236,534,44.19%,16.67%,1
雲林縣,土庫鎮,0095,247,226,473,75,548,1199,45.7%,20.6%,1
雲林縣,土庫鎮,0096,160,309,469,71,540,1077,50.14%,14.86%,1
雲林縣,土庫鎮,0097,103,227,330,25,355,819,43.35%,12.58%,1
雲林縣,土庫鎮,0098,107,224,331,38,369,684,53.95%,15.64%,1
雲林縣,土庫鎮,0099,116,300,416,48,464,843,55.04%,13.76%,1
雲林縣,土庫鎮,0100,121,305,426,63,489,916,53.38%,13.21%,1
雲林縣,土庫鎮,0101,135,301,436,42,478,948,50.42%,14.24%,1
雲林縣,土庫鎮,0102,141,316,457,31,488,914,53.39%,15.43%,1
雲林縣,土庫鎮,0103,128,282,410,64,474,860,55.12%,14.88%,1
雲林縣,土庫鎮,0104,145,280,425,47,472,929,50.81%,15.61%,1
雲林縣,土庫鎮,0105,123,249,372,53,425,875,48.57%,14.06%,1
雲林縣,土庫鎮,0106,115,231,346,38,384,896,42.86%,12.83%,1
雲林縣,土庫鎮,0107,89,206,295,50,345,757,45.57%,11.76%,1
雲林縣,土庫鎮,0108,96,209,305,28,333,683,48.76%,14.06%,1
雲林縣,北港鎮,0256,106,266,372,56,428,724,59.12%,14.64%,1
雲林縣,北港鎮,0257,149,232,381,48,429,688,62.35%,21.66%,1
雲林縣,北港鎮,0258,61,166,227,38,265,452,58.63%,13.5%,1
雲林縣,北港鎮,0259,146,305,451,57,508,866,58.66%,16.86%,1
雲林縣,北港鎮,0260,58,103,161,17,178,336,52.98%,17.26%,1
雲林縣,北港鎮,0261,44,151,195,21,216,395,54.68%,11.14%,1
雲林縣,北港鎮,0262,54,158,212,26,238,376,63.3%,14.36%,1
雲林縣,北港鎮,0263,168,340,508,38,546,950,57.47%,17.68%,1
雲林縣,北港鎮,0264,101,185,286,40,326,512,63.67%,19.73%,1
雲林縣,北港鎮,0265,55,114,169,29,198,324,61.11%,16.98%,1
雲林縣,北港鎮,0266,84,178,262,39,301,546,55.13%,15.38%,1
雲林縣,北港鎮,0267,79,165,244,20,264,433,60.97%,18.24%,1
雲林縣,北港鎮,0268,106,273,379,53,432,751,57.52%,14.11%,1
雲林縣,北港鎮,0269,58,191,249,24,273,442,61.76%,13.12%,1
雲林縣,北港鎮,0270,195,410,605,63,668,1151,58.04%,16.94%,1
雲林縣,北港鎮,0271,208,463,671,46,717,1224,58.58%,16.99%,1
雲林縣,北港鎮,0272,200,426,626,45,671,1211,55.41%,16.52%,1
雲林縣,北港鎮,0273,233,452,685,74,759,1326,57.24%,17.57%,1
雲林縣,北港鎮,0274,135,311,446,35,481,744,64.65%,18.15%,1
雲林縣,北港鎮,0275,179,406,585,38,623,977,63.77%,18.32%,1
雲林縣,北港鎮,0276,174,308,482,57,539,960,56.15%,18.13%,1
雲林縣,北港鎮,0277,56,127,183,10,193,494,39.07%,11.34%,1
雲林縣,北港鎮,0278,244,498,742,47,789,1364,57.84%,17.89%,1
雲林縣,北港鎮,0279,199,394,593,62,655,1123,58.33%,17.72%,1
雲林縣,北港鎮,0280,268,521,789,40,829,1451,57.13%,18.47%,1
雲林縣,北港鎮,0281,228,420,648,51,699,1162,60.15%,19.62%,1
雲林縣,北港鎮,0282,171,371,542,47,589,1130,52.12%,15.13%,1
雲林縣,北港鎮,0283,165,399,564,31,595,1149,51.78%,14.36%,1
雲林縣,北港鎮,0284,56,157,213,27,240,533,45.03%,10.51%,1
雲林縣,北港鎮,0285,202,78,280,12,292,433,67.44%,46.65%,1
雲林縣,北港鎮,0286,39,134,173,12,185,377,49.07%,10.34%,1
雲林縣,北港鎮,0287,91,242,333,20,353,809,43.63%,11.25%,1
雲林縣,北港鎮,0288,182,400,582,86,668,1397,47.82%,13.03%,1
雲林縣,北港鎮,0289,129,326,455,74,529,1145,46.2%,11.27%,1
雲林縣,北港鎮,0290,82,174,256,58,314,828,37.92%,9.9%,1
雲林縣,北港鎮,0291,61,153,214,11,225,557,40.39%,10.95%,1
雲林縣,北港鎮,0292,163,303,466,43,509,1060,48.02%,15.38%,1
雲林縣,北港鎮,0293,76,166,242,37,279,577,48.35%,13.17%,1
雲林縣,北港鎮,0294,144,197,341,70,411,931,44.15%,15.47%,1
雲林縣,北港鎮,0295,153,364,517,32,549,1018,53.93%,15.03%,1
雲林縣,北港鎮,0296,184,377,561,30,591,1032,57.27%,17.83%,1
雲林縣,古坑鄉,0531,176,394,570,55,625,1126,55.51%,15.63%,1
雲林縣,古坑鄉,0532,161,313,474,52,526,994,52.92%,16.2%,1
雲林縣,古坑鄉,0533,277,461,738,67,805,1517,53.07%,18.26%,1
雲林縣,古坑鄉,0534,187,487,674,41,715,1302,54.92%,14.36%,1
雲林縣,古坑鄉,0535,263,578,841,54,895,1772,50.51%,14.84%,1
雲林縣,古坑鄉,0536,155,416,571,75,646,1122,57.58%,13.81%,1
雲林縣,古坑鄉,0537,24,83,107,3,110,304,36.18%,7.89%,1
雲林縣,古坑鄉,0538,165,446,611,73,684,1169,58.51%,14.11%,1
雲林縣,古坑鄉,0539,198,396,594,58,652,1255,51.95%,15.78%,1
雲林縣,古坑鄉,0540,211,406,617,36,653,1078,60.58%,19.57%,1
雲林縣,古坑鄉,0541,134,302,436,26,462,943,48.99%,14.21%,1
雲林縣,古坑鄉,0542,206,400,606,63,669,1300,51.46%,15.85%,1
雲林縣,古坑鄉,0543,121,336,457,41,498,964,51.66%,12.55%,1
雲林縣,古坑鄉,0544,174,401,575,45,620,1144,54.2%,15.21%,1
雲林縣,古坑鄉,0545,239,495,734,58,792,1482,53.44%,16.13%,1
雲林縣,古坑鄉,0546,113,239,352,35,387,688,56.25%,16.42%,1
雲林縣,古坑鄉,0547,152,315,467,39,506,998,50.7%,15.23%,1
雲林縣,古坑鄉,0548,186,424,610,42,652,1140,57.19%,16.32%,1
雲林縣,古坑鄉,0549,186,363,549,43,592,1102,53.72%,16.88%,1
雲林縣,古坑鄉,0550,141,335,476,27,503,956,52.62%,14.75%,1
雲林縣,古坑鄉,0551,114,231,345,32,377,695,54.24%,16.4%,1
雲林縣,古坑鄉,0552,180,406,586,33,619,1233,50.2%,14.6%,1
雲林縣,古坑鄉,0553,30,79,109,11,120,285,42.11%,10.53%,1
雲林縣,古坑鄉,0554,78,200,278,16,294,734,40.05%,10.63%,1
雲林縣,古坑鄉,0555,182,384,566,70,636,1150,55.3%,15.83%,1
雲林縣,古坑鄉,0556,58,168,226,18,244,453,53.86%,12.8%,1
雲林縣,古坑鄉,0557,53,202,255,23,278,571,48.69%,9.28%,1
雲林縣,大埤鄉,0480,125,237,362,38,400,750,53.33%,16.67%,1
雲林縣,大埤鄉,0481,123,220,343,26,369,719,51.32%,17.11%,1
雲林縣,大埤鄉,0482,70,223,293,25,318,603,52.74%,11.61%,1
雲林縣,大埤鄉,0483,161,320,481,47,528,1106,47.74%,14.56%,1
雲林縣,大埤鄉,0484,270,468,738,45,783,1495,52.37%,18.06%,1
雲林縣,大埤鄉,0485,108,224,332,26,358,600,59.67%,18%,1
雲林縣,大埤鄉,0486,177,365,542,51,593,1004,59.06%,17.63%,1
雲林縣,大埤鄉,0487,134,232,366,23,389,948,41.03%,14.14%,1
雲林縣,大埤鄉,0488,226,558,784,47,831,1539,54%,14.68%,1
雲林縣,大埤鄉,0489,196,436,632,56,688,1430,48.11%,13.71%,1
雲林縣,大埤鄉,0490,54,162,216,23,239,465,51.4%,11.61%,1
雲林縣,大埤鄉,0491,168,432,600,46,646,1307,49.43%,12.85%,1
雲林縣,大埤鄉,0492,89,140,229,20,249,474,52.53%,18.78%,1
雲林縣,大埤鄉,0493,233,418,651,79,730,1220,59.84%,19.1%,1
雲林縣,大埤鄉,0494,102,248,350,21,371,733,50.61%,13.92%,1
雲林縣,大埤鄉,0495,99,253,352,25,377,681,55.36%,14.54%,1
雲林縣,大埤鄉,0496,99,179,278,22,300,712,42.13%,13.9%,1
雲林縣,大埤鄉,0497,104,195,299,51,350,723,48.41%,14.38%,1
雲林縣,莿桐鄉,0374,243,539,782,67,849,1507,56.34%,16.12%,1
雲林縣,莿桐鄉,0375,216,459,675,35,710,1300,54.62%,16.62%,1
雲林縣,莿桐鄉,0376,209,453,662,98,760,1272,59.75%,16.43%,1
雲林縣,莿桐鄉,0377,161,242,403,58,461,861,53.54%,18.7%,1
雲林縣,莿桐鄉,0378,256,430,686,64,750,1565,47.92%,16.36%,1
雲林縣,莿桐鄉,0379,94,184,278,19,297,577,51.47%,16.29%,1
雲林縣,莿桐鄉,0380,95,170,265,34,299,636,47.01%,14.94%,1
雲林縣,莿桐鄉,0381,199,309,508,73,581,1110,52.34%,17.93%,1
雲林縣,莿桐鄉,0382,184,345,529,56,585,973,60.12%,18.91%,1
雲林縣,莿桐鄉,0383,195,296,491,59,550,985,55.84%,19.8%,1
雲林縣,莿桐鄉,0384,283,638,921,94,1015,1707,59.46%,16.58%,1
雲林縣,莿桐鄉,0385,199,445,644,75,719,1284,56%,15.5%,1
雲林縣,莿桐鄉,0386,217,461,678,58,736,1293,56.92%,16.78%,1
雲林縣,莿桐鄉,0387,133,333,466,44,510,900,56.67%,14.78%,1
雲林縣,莿桐鄉,0388,171,365,536,85,621,1040,59.71%,16.44%,1
雲林縣,莿桐鄉,0389,183,380,563,31,594,1165,50.99%,15.71%,1
雲林縣,莿桐鄉,0390,158,280,438,58,496,871,56.95%,18.14%,1
雲林縣,莿桐鄉,0391,146,349,495,48,543,885,61.36%,16.5%,1
雲林縣,莿桐鄉,0392,204,487,691,69,760,1489,51.04%,13.7%,1
雲林縣,莿桐鄉,0393,183,431,614,64,678,1347,50.33%,13.59%,1
雲林縣,莿桐鄉,0394,191,411,602,64,666,1150,57.91%,16.61%,1
雲林縣,莿桐鄉,0395,107,245,352,38,390,653,59.72%,16.39%,1
雲林縣,林內鄉,0396,174,431,605,52,657,1036,63.42%,16.8%,1
雲林縣,林內鄉,0397,249,525,774,64,838,1490,56.24%,16.71%,1
雲林縣,林內鄉,0398,210,523,733,69,802,1491,53.79%,14.08%,1
雲林縣,林內鄉,0399,73,239,312,45,357,671,53.2%,10.88%,1
雲林縣,林內鄉,0400,236,523,759,106,865,1436,60.24%,16.43%,1
雲林縣,林內鄉,0401,133,260,393,51,444,751,59.12%,17.71%,1
雲林縣,林內鄉,0402,96,178,274,22,296,535,55.33%,17.94%,1
雲林縣,林內鄉,0403,150,184,334,51,385,811,47.47%,18.5%,1
雲林縣,林內鄉,0404,240,444,684,86,770,1339,57.51%,17.92%,1
雲林縣,林內鄉,0405,176,446,622,81,703,1286,54.67%,13.69%,1
雲林縣,林內鄉,0406,115,212,327,32,359,646,55.57%,17.8%,1
雲林縣,林內鄉,0407,168,422,590,55,645,1158,55.7%,14.51%,1
雲林縣,林內鄉,0408,195,369,564,56,620,1090,56.88%,17.89%,1
雲林縣,林內鄉,0409,167,347,514,69,583,950,61.37%,17.58%,1
雲林縣,林內鄉,0410,157,283,440,38,478,861,55.52%,18.23%,1
雲林縣,二崙鄉,0317,213,475,688,36,724,1463,49.49%,14.56%,1
雲林縣,二崙鄉,0318,250,475,725,68,793,1738,45.63%,14.38%,1
雲林縣,二崙鄉,0319,81,171,252,44,296,625,47.36%,12.96%,1
雲林縣,二崙鄉,0320,150,288,438,67,505,1018,49.61%,14.73%,1
雲林縣,二崙鄉,0321,47,117,164,6,170,448,37.95%,10.49%,1
雲林縣,二崙鄉,0322,118,241,359,49,408,1048,38.93%,11.26%,1
雲林縣,二崙鄉,0323,194,377,571,63,634,1161,54.61%,16.71%,1
雲林縣,二崙鄉,0324,157,315,472,43,515,991,51.97%,15.84%,1
雲林縣,二崙鄉,0325,135,313,448,54,502,849,59.13%,15.9%,1
雲林縣,二崙鄉,0326,128,275,403,47,450,890,50.56%,14.38%,1
雲林縣,二崙鄉,0327,224,433,657,76,733,1427,51.37%,15.7%,1
雲林縣,二崙鄉,0328,120,294,414,21,435,891,48.82%,13.47%,1
雲林縣,二崙鄉,0329,85,226,311,22,333,757,43.99%,11.23%,1
雲林縣,二崙鄉,0330,216,402,618,115,733,1497,48.96%,14.43%,1
雲林縣,二崙鄉,0331,180,315,495,61,556,1171,47.48%,15.37%,1
雲林縣,二崙鄉,0332,110,240,350,54,404,686,58.89%,16.03%,1
雲林縣,二崙鄉,0333,116,200,316,71,387,864,44.79%,13.43%,1
雲林縣,二崙鄉,0334,171,369,540,25,565,1073,52.66%,15.94%,1
雲林縣,二崙鄉,0335,99,162,261,29,290,696,41.67%,14.22%,1
雲林縣,二崙鄉,0336,127,287,414,61,475,1271,37.37%,9.99%,1
雲林縣,二崙鄉,0337,121,242,363,44,407,912,44.63%,13.27%,1
雲林縣,二崙鄉,0338,115,236,351,35,386,861,44.83%,13.36%,1
雲林縣,二崙鄉,0339,118,285,403,55,458,1030,44.47%,11.46%,1
雲林縣,崙背鄉,0297,190,409,599,57,656,1176,55.78%,16.16%,1
雲林縣,崙背鄉,0298,222,456,678,46,724,1439,50.31%,15.43%,1
雲林縣,崙背鄉,0299,163,404,567,46,613,1027,59.69%,15.87%,1
雲林縣,崙背鄉,0300,201,456,657,44,701,1259,55.68%,15.97%,1
雲林縣,崙背鄉,0301,146,352,498,15,513,1058,48.49%,13.8%,1
雲林縣,崙背鄉,0302,127,297,424,34,458,998,45.89%,12.73%,1
雲林縣,崙背鄉,0303,157,275,432,30,462,968,47.73%,16.22%,1
雲林縣,崙背鄉,0304,171,332,503,50,553,1055,52.42%,16.21%,1
雲林縣,崙背鄉,0305,186,365,551,77,628,1315,47.76%,14.14%,1
雲林縣,崙背鄉,0306,90,210,300,34,334,1027,32.52%,8.76%,1
雲林縣,崙背鄉,0307,146,359,505,86,591,997,59.28%,14.64%,1
雲林縣,崙背鄉,0308,101,286,387,37,424,807,52.54%,12.52%,1
雲林縣,崙背鄉,0309,85,172,257,30,287,698,41.12%,12.18%,1
雲林縣,崙背鄉,0310,107,229,336,42,378,804,47.01%,13.31%,1
雲林縣,崙背鄉,0311,118,271,389,32,421,867,48.56%,13.61%,1
雲林縣,崙背鄉,0312,100,236,336,31,367,886,41.42%,11.29%,1
雲林縣,崙背鄉,0313,159,362,521,93,614,1476,41.6%,10.77%,1
雲林縣,崙背鄉,0314,103,267,370,29,399,1159,34.43%,8.89%,1
雲林縣,崙背鄉,0315,165,462,627,73,700,1220,57.38%,13.52%,1
雲林縣,崙背鄉,0316,143,138,281,41,322,814,39.56%,17.57%,1
雲林縣,麥寮鄉,0001,165,439,604,50,654,1497,43.69%,11.02%,1
雲林縣,麥寮鄉,0002,243,583,826,47,873,1738,50.23%,13.98%,1
雲林縣,麥寮鄉,0003,274,633,907,50,957,1921,49.82%,14.26%,1
雲林縣,麥寮鄉,0004,244,576,820,54,874,1832,47.71%,13.32%,1
雲林縣,麥寮鄉,0005,180,376,556,55,611,1340,45.6%,13.43%,1
雲林縣,麥寮鄉,0006,139,357,496,56,552,1138,48.51%,12.21%,1
雲林縣,麥寮鄉,0007,190,523,713,50,763,1551,49.19%,12.25%,1
雲林縣,麥寮鄉,0008,82,207,289,23,312,715,43.64%,11.47%,1
雲林縣,麥寮鄉,0009,136,337,473,49,522,1194,43.72%,11.39%,1
雲林縣,麥寮鄉,0010,134,313,447,41,488,1023,47.7%,13.1%,1
雲林縣,麥寮鄉,0011,168,391,559,43,602,1558,38.64%,10.78%,1
雲林縣,麥寮鄉,0012,146,308,454,24,478,1187,40.27%,12.3%,1
雲林縣,麥寮鄉,0013,116,278,394,28,422,983,42.93%,11.8%,1
雲林縣,麥寮鄉,0014,161,438,599,61,660,1363,48.42%,11.81%,1
雲林縣,麥寮鄉,0015,197,430,627,66,693,1596,43.42%,12.34%,1
雲林縣,麥寮鄉,0016,239,552,791,71,862,1469,58.68%,16.27%,1
雲林縣,麥寮鄉,0017,139,251,390,42,432,964,44.81%,14.42%,1
雲林縣,麥寮鄉,0018,116,295,411,34,445,1038,42.87%,11.18%,1
雲林縣,麥寮鄉,0019,147,418,565,55,620,1230,50.41%,11.95%,1
雲林縣,麥寮鄉,0020,162,435,597,48,645,1329,48.53%,12.19%,1
雲林縣,麥寮鄉,0021,152,383,535,72,607,1129,53.76%,13.46%,1
雲林縣,麥寮鄉,0022,205,414,619,78,697,1241,56.16%,16.52%,1
雲林縣,麥寮鄉,0023,216,494,710,94,804,1471,54.66%,14.68%,1
雲林縣,麥寮鄉,0024,181,389,570,69,639,1107,57.72%,16.35%,1
雲林縣,麥寮鄉,0025,243,587,830,69,899,1636,54.95%,14.85%,1
雲林縣,麥寮鄉,0026,228,584,812,47,859,1755,48.95%,12.99%,1
雲林縣,麥寮鄉,0027,169,417,586,31,617,1158,53.28%,14.59%,1
雲林縣,麥寮鄉,0028,155,323,478,36,514,956,53.77%,16.21%,1
雲林縣,東勢鄉,0051,153,331,484,56,540,1207,44.74%,12.68%,1
雲林縣,東勢鄉,0052,87,218,305,25,330,540,61.11%,16.11%,1
雲林縣,東勢鄉,0053,118,249,367,28,395,896,44.08%,13.17%,1
雲林縣,東勢鄉,0054,113,240,353,41,394,728,54.12%,15.52%,1
雲林縣,東勢鄉,0055,237,592,829,45,874,1533,57.01%,15.46%,1
雲林縣,東勢鄉,0056,194,456,650,69,719,1203,59.77%,16.13%,1
雲林縣,東勢鄉,0057,98,245,343,50,393,817,48.1%,12%,1
雲林縣,東勢鄉,0058,96,207,303,22,325,546,59.52%,17.58%,1
雲林縣,東勢鄉,0059,113,264,377,61,438,853,51.35%,13.25%,1
雲林縣,東勢鄉,0060,100,221,321,50,371,856,43.34%,11.68%,1
雲林縣,東勢鄉,0061,132,262,394,51,445,923,48.21%,14.3%,1
雲林縣,東勢鄉,0062,130,339,469,44,513,1022,50.2%,12.72%,1
雲林縣,東勢鄉,0063,46,171,217,24,241,634,38.01%,7.26%,1
雲林縣,東勢鄉,0064,50,108,158,16,174,394,44.16%,12.69%,1
雲林縣,東勢鄉,0065,94,297,391,43,434,1087,39.93%,8.65%,1
雲林縣,褒忠鄉,0066,139,330,469,50,519,923,56.23%,15.06%,1
雲林縣,褒忠鄉,0067,200,361,561,23,584,993,58.81%,20.14%,1
雲林縣,褒忠鄉,0068,127,249,376,19,395,748,52.81%,16.98%,1
雲林縣,褒忠鄉,0069,101,244,345,12,357,702,50.85%,14.39%,1
雲林縣,褒忠鄉,0070,112,250,362,18,380,752,50.53%,14.89%,1
雲林縣,褒忠鄉,0071,141,247,388,19,407,756,53.84%,18.65%,1
雲林縣,褒忠鄉,0072,75,167,242,15,257,490,52.45%,15.31%,1
雲林縣,褒忠鄉,0073,136,298,434,32,466,1034,45.07%,13.15%,1
雲林縣,褒忠鄉,0074,68,143,211,25,236,470,50.21%,14.47%,1
雲林縣,褒忠鄉,0075,144,196,340,36,376,737,51.02%,19.54%,1
雲林縣,褒忠鄉,0076,119,284,403,33,436,878,49.66%,13.55%,1
雲林縣,褒忠鄉,0077,104,247,351,39,390,778,50.13%,13.37%,1
雲林縣,褒忠鄉,0078,207,384,591,40,631,1224,51.55%,16.91%,1
雲林縣,褒忠鄉,0079,117,241,358,69,427,896,47.66%,13.06%,1
雲林縣,臺西鄉,0029,187,429,616,64,680,1238,54.93%,15.11%,1
雲林縣,臺西鄉,0030,268,222,490,30,520,1091,47.66%,24.56%,1
雲林縣,臺西鄉,0031,137,386,523,59,582,1098,53.01%,12.48%,1
雲林縣,臺西鄉,0032,120,304,424,30,454,1048,43.32%,11.45%,1
雲林縣,臺西鄉,0033,111,324,435,59,494,1025,48.2%,10.83%,1
雲林縣,臺西鄉,0034,110,288,398,33,431,850,50.71%,12.94%,1
雲林縣,臺西鄉,0035,150,432,582,60,642,1460,43.97%,10.27%,1
雲林縣,臺西鄉,0036,108,259,367,69,436,1180,36.95%,9.15%,1
雲林縣,臺西鄉,0037,37,171,208,30,238,710,33.52%,5.21%,1
雲林縣,臺西鄉,0038,68,167,235,17,252,620,40.65%,10.97%,1
雲林縣,臺西鄉,0039,62,123,185,28,213,449,47.44%,13.81%,1
雲林縣,臺西鄉,0040,71,160,231,46,277,687,40.32%,10.33%,1
雲林縣,臺西鄉,0041,138,371,509,52,561,1247,44.99%,11.07%,1
雲林縣,臺西鄉,0042,50,149,199,11,210,583,36.02%,8.58%,1
雲林縣,臺西鄉,0043,142,331,473,51,524,1042,50.29%,13.63%,1
雲林縣,臺西鄉,0044,65,136,201,18,219,472,46.4%,13.77%,1
雲林縣,臺西鄉,0045,133,433,566,31,597,1409,42.37%,9.44%,1
雲林縣,臺西鄉,0046,145,351,496,66,562,1061,52.97%,13.67%,1
雲林縣,臺西鄉,0047,98,296,394,29,423,993,42.6%,9.87%,1
雲林縣,臺西鄉,0048,96,324,420,72,492,1013,48.57%,9.48%,1
雲林縣,臺西鄉,0049,155,412,567,35,602,1233,48.82%,12.57%,1
雲林縣,臺西鄉,0050,73,169,242,22,264,616,42.86%,11.85%,1
雲林縣,元長鄉,0180,124,309,433,32,465,915,50.82%,13.55%,1
雲林縣,元長鄉,0181,173,411,584,24,608,1284,47.35%,13.47%,1
雲林縣,元長鄉,0182,168,327,495,46,541,1150,47.04%,14.61%,1
雲林縣,元長鄉,0183,89,201,290,42,332,744,44.62%,11.96%,1
雲林縣,元長鄉,0184,105,245,350,43,393,790,49.75%,13.29%,1
雲林縣,元長鄉,0185,134,353,487,73,560,1356,41.3%,9.88%,1
雲林縣,元長鄉,0186,90,212,302,56,358,739,48.44%,12.18%,1
雲林縣,元長鄉,0187,100,250,350,36,386,965,40%,10.36%,1
雲林縣,元長鄉,0188,125,283,408,56,464,1080,42.96%,11.57%,1
雲林縣,元長鄉,0189,101,236,337,43,380,948,40.08%,10.65%,1
雲林縣,元長鄉,0190,69,143,212,30,242,762,31.76%,9.06%,1
雲林縣,元長鄉,0191,72,174,246,26,272,582,46.74%,12.37%,1
雲林縣,元長鄉,0192,85,225,310,16,326,865,37.69%,9.83%,1
雲林縣,元長鄉,0193,23,54,77,5,82,362,22.65%,6.35%,1
雲林縣,元長鄉,0194,130,283,413,31,444,1162,38.21%,11.19%,1
雲林縣,元長鄉,0195,183,443,626,37,663,1527,43.42%,11.98%,1
雲林縣,元長鄉,0196,137,285,422,65,487,1006,48.41%,13.62%,1
雲林縣,元長鄉,0197,105,232,337,24,361,855,42.22%,12.28%,1
雲林縣,元長鄉,0198,149,336,485,72,557,1181,47.16%,12.62%,1
雲林縣,元長鄉,0199,107,218,325,33,358,864,41.44%,12.38%,1
雲林縣,元長鄉,0200,78,159,237,30,267,667,40.03%,11.69%,1
雲林縣,元長鄉,0201,102,212,314,37,351,878,39.98%,11.62%,1
雲林縣,元長鄉,0202,53,130,183,8,191,610,31.31%,8.69%,1
雲林縣,元長鄉,0203,101,243,344,53,397,837,47.43%,12.07%,1
雲林縣,元長鄉,0204,114,213,327,27,354,701,50.5%,16.26%,1
雲林縣,四湖鄉,0155,127,305,432,51,483,1082,44.64%,11.74%,1
雲林縣,四湖鄉,0156,75,250,325,41,366,676,54.14%,11.09%,1
雲林縣,四湖鄉,0157,114,291,405,26,431,862,50%,13.23%,1
雲林縣,四湖鄉,0158,45,111,156,22,178,477,37.32%,9.43%,1
雲林縣,四湖鄉,0159,137,362,499,33,532,952,55.88%,14.39%,1
雲林縣,四湖鄉,0160,61,168,229,18,247,650,38%,9.38%,1
雲林縣,四湖鄉,0161,124,278,402,21,423,969,43.65%,12.8%,1
雲林縣,四湖鄉,0162,113,211,324,51,375,925,40.54%,12.22%,1
雲林縣,四湖鄉,0163,103,270,373,30,403,914,44.09%,11.27%,1
雲林縣,四湖鄉,0164,81,118,199,45,244,759,32.15%,10.67%,1
雲林縣,四湖鄉,0165,122,319,441,37,478,1219,39.21%,10.01%,1
雲林縣,四湖鄉,0166,87,200,287,37,324,937,34.58%,9.28%,1
雲林縣,四湖鄉,0167,64,155,219,13,232,773,30.01%,8.28%,1
雲林縣,四湖鄉,0168,55,135,190,35,225,555,40.54%,9.91%,1
雲林縣,四湖鄉,0169,96,179,275,22,297,876,33.9%,10.96%,1
雲林縣,四湖鄉,0170,38,83,121,18,139,360,38.61%,10.56%,1
雲林縣,四湖鄉,0171,74,148,222,41,263,885,29.72%,8.36%,1
雲林縣,四湖鄉,0172,79,172,251,35,286,833,34.33%,9.48%,1
雲林縣,四湖鄉,0173,90,195,285,35,320,785,40.76%,11.46%,1
雲林縣,四湖鄉,0174,71,238,309,26,335,705,47.52%,10.07%,1
雲林縣,四湖鄉,0175,93,179,272,29,301,927,32.47%,10.03%,1
雲林縣,四湖鄉,0176,102,210,312,67,379,1058,35.82%,9.64%,1
雲林縣,四湖鄉,0177,94,271,365,51,416,1071,38.84%,8.78%,1
雲林縣,四湖鄉,0178,74,199,273,18,291,1022,28.47%,7.24%,1
雲林縣,四湖鄉,0179,73,204,277,27,304,711,42.76%,10.27%,1
雲林縣,口湖鄉,0205,168,364,532,60,592,1134,52.2%,14.81%,1
雲林縣,口湖鄉,0206,167,410,577,89,666,1225,54.37%,13.63%,1
雲林縣,口湖鄉,0207,58,181,239,38,277,647,42.81%,8.96%,1
雲林縣,口湖鄉,0208,97,226,323,26,349,709,49.22%,13.68%,1
雲林縣,口湖鄉,0209,133,230,363,67,430,900,47.78%,14.78%,1
雲林縣,口湖鄉,0210,132,299,431,65,496,1011,49.06%,13.06%,1
雲林縣,口湖鄉,0211,146,383,529,39,568,1437,39.53%,10.16%,1
雲林縣,口湖鄉,0212,88,175,263,13,276,848,32.55%,10.38%,1
雲林縣,口湖鄉,0213,122,330,452,27,479,1193,40.15%,10.23%,1
雲林縣,口湖鄉,0214,78,167,245,43,288,759,37.94%,10.28%,1
雲林縣,口湖鄉,0215,91,234,325,43,368,815,45.15%,11.17%,1
雲林縣,口湖鄉,0216,200,438,638,82,720,1460,49.32%,13.7%,1
雲林縣,口湖鄉,0217,68,105,173,7,180,556,32.37%,12.23%,1
雲林縣,口湖鄉,0218,182,463,645,56,701,1532,45.76%,11.88%,1
雲林縣,口湖鄉,0219,96,273,369,14,383,847,45.22%,11.33%,1
雲林縣,口湖鄉,0220,52,108,160,22,182,374,48.66%,13.9%,1
雲林縣,口湖鄉,0221,191,482,673,161,834,1508,55.31%,12.67%,1
雲林縣,口湖鄉,0222,119,344,463,67,530,951,55.73%,12.51%,1
雲林縣,口湖鄉,0223,134,322,456,68,524,910,57.58%,14.73%,1
雲林縣,口湖鄉,0224,144,333,477,39,516,879,58.7%,16.38%,1
雲林縣,口湖鄉,0225,146,335,481,109,590,1213,48.64%,12.04%,1
雲林縣,口湖鄉,0226,110,316,426,51,477,952,50.11%,11.55%,1
雲林縣,口湖鄉,0227,104,238,342,46,388,720,53.89%,14.44%,1
雲林縣,口湖鄉,0228,120,252,372,34,406,1006,40.36%,11.93%,1
雲林縣,口湖鄉,0229,44,187,231,14,245,607,40.36%,7.25%,1
雲林縣,水林鄉,0230,190,380,570,59,629,1355,46.42%,14.02%,1
雲林縣,水林鄉,0231,144,278,422,16,438,887,49.38%,16.23%,1
雲林縣,水林鄉,0232,188,437,625,40,665,1234,53.89%,15.24%,1
雲林縣,水林鄉,0233,114,238,352,18,370,763,48.49%,14.94%,1
雲林縣,水林鄉,0234,104,153,257,48,305,721,42.3%,14.42%,1
雲林縣,水林鄉,0235,69,162,231,8,239,647,36.94%,10.66%,1
雲林縣,水林鄉,0236,120,256,376,64,440,989,44.49%,12.13%,1
雲林縣,水林鄉,0237,86,202,288,33,321,837,38.35%,10.27%,1
雲林縣,水林鄉,0238,109,279,388,16,404,1081,37.37%,10.08%,1
雲林縣,水林鄉,0239,93,186,279,39,318,704,45.17%,13.21%,1
雲林縣,水林鄉,0240,142,272,414,81,495,1006,49.2%,14.12%,1
雲林縣,水林鄉,0241,68,181,249,14,263,651,40.4%,10.45%,1
雲林縣,水林鄉,0242,66,164,230,19,249,607,41.02%,10.87%,1
雲林縣,水林鄉,0243,125,238,363,67,430,1033,41.63%,12.1%,1
雲林縣,水林鄉,0244,51,140,191,15,206,631,32.65%,8.08%,1
雲林縣,水林鄉,0245,95,299,394,15,409,961,42.56%,9.89%,1
雲林縣,水林鄉,0246,108,243,351,72,423,951,44.48%,11.36%,1
雲林縣,水林鄉,0247,98,226,324,40,364,838,43.44%,11.69%,1
雲林縣,水林鄉,0248,112,287,399,100,499,1055,47.3%,10.62%,1
雲林縣,水林鄉,0249,37,110,147,30,177,512,34.57%,7.23%,1
雲林縣,水林鄉,0250,81,148,229,16,245,671,36.51%,12.07%,1
雲林縣,水林鄉,0251,64,123,187,37,224,693,32.32%,9.24%,1
雲林縣,水林鄉,0252,62,136,198,41,239,689,34.69%,9%,1
雲林縣,水林鄉,0253,141,281,422,74,496,1022,48.53%,13.8%,1
雲林縣,水林鄉,0254,124,331,455,41,496,1191,41.65%,10.41%,1
雲林縣,水林鄉,0255,98,284,382,37,419,779,53.79%,12.58%,1
嘉義縣,太保市,0001,200,425,625,54,679,1210,56.12%,16.53%,1
嘉義縣,太保市,0002,180,381,561,31,592,1076,55.02%,16.73%,1
嘉義縣,太保市,0003,86,135,221,20,241,488,49.39%,17.62%,1
嘉義縣,太保市,0004,225,421,646,80,726,1475,49.22%,15.25%,1
嘉義縣,太保市,0005,117,219,336,30,366,790,46.33%,14.81%,1
嘉義縣,太保市,0006,120,289,409,34,443,883,50.17%,13.59%,1
嘉義縣,太保市,0007,105,247,352,47,399,758,52.64%,13.85%,1
嘉義縣,太保市,0008,37,112,149,10,159,389,40.87%,9.51%,1
嘉義縣,太保市,0009,160,303,463,50,513,1101,46.59%,14.53%,1
嘉義縣,太保市,0010,122,308,430,13,443,853,51.93%,14.3%,1
嘉義縣,太保市,0011,40,43,83,9,92,224,41.07%,17.86%,1
嘉義縣,太保市,0012,93,183,276,46,322,662,48.64%,14.05%,1
嘉義縣,太保市,0013,269,671,940,32,972,1630,59.63%,16.5%,1
嘉義縣,太保市,0014,114,291,405,29,434,913,47.54%,12.49%,1
嘉義縣,太保市,0015,161,262,423,11,434,779,55.71%,20.67%,1
嘉義縣,太保市,0016,228,374,602,107,709,1278,55.48%,17.84%,1
嘉義縣,太保市,0017,122,240,362,32,394,819,48.11%,14.9%,1
嘉義縣,太保市,0018,248,506,754,32,786,1573,49.97%,15.77%,1
嘉義縣,太保市,0019,71,158,229,33,262,481,54.47%,14.76%,1
嘉義縣,太保市,0020,45,98,143,5,148,245,60.41%,18.37%,1
嘉義縣,太保市,0021,107,57,164,14,178,317,56.15%,33.75%,1
嘉義縣,太保市,0022,46,80,126,7,133,258,51.55%,17.83%,1
嘉義縣,太保市,0023,85,199,284,49,333,611,54.5%,13.91%,1
嘉義縣,太保市,0024,260,590,850,41,891,1526,58.39%,17.04%,1
嘉義縣,太保市,0025,242,413,655,21,676,1196,56.52%,20.23%,1
嘉義縣,太保市,0026,265,491,756,93,849,1536,55.27%,17.25%,1
嘉義縣,太保市,0027,262,500,762,61,823,1481,55.57%,17.69%,1
嘉義縣,太保市,0028,241,512,753,41,794,1450,54.76%,16.62%,1
嘉義縣,太保市,0029,135,259,394,25,419,840,49.88%,16.07%,1
嘉義縣,太保市,0030,201,311,512,30,542,989,54.8%,20.32%,1
嘉義縣,太保市,0031,237,596,833,65,898,1529,58.73%,15.5%,1
嘉義縣,太保市,0032,284,518,802,49,851,1511,56.32%,18.8%,1
嘉義縣,太保市,0033,109,193,302,35,337,697,48.35%,15.64%,1
嘉義縣,朴子市,0233,232,375,607,33,640,1183,54.1%,19.61%,1
嘉義縣,朴子市,0234,117,259,376,38,414,755,54.83%,15.5%,1
嘉義縣,朴子市,0235,220,427,647,33,680,1253,54.27%,17.56%,1
嘉義縣,朴子市,0236,207,395,602,48,650,1078,60.3%,19.2%,1
嘉義縣,朴子市,0237,229,392,621,64,685,1117,61.32%,20.5%,1
嘉義縣,朴子市,0238,84,128,212,19,231,387,59.69%,21.71%,1
嘉義縣,朴子市,0239,96,220,316,43,359,633,56.71%,15.17%,1
嘉義縣,朴子市,0240,126,219,345,23,368,650,56.62%,19.38%,1
嘉義縣,朴子市,0241,141,347,488,34,522,825,63.27%,17.09%,1
嘉義縣,朴子市,0242,145,262,407,39,446,810,55.06%,17.9%,1
嘉義縣,朴子市,0243,145,361,506,45,551,940,58.62%,15.43%,1
嘉義縣,朴子市,0244,132,301,433,54,487,905,53.81%,14.59%,1
嘉義縣,朴子市,0245,248,477,725,37,762,1605,47.48%,15.45%,1
嘉義縣,朴子市,0246,288,523,811,38,849,1479,57.4%,19.47%,1
嘉義縣,朴子市,0247,218,443,661,41,702,1218,57.64%,17.9%,1
嘉義縣,朴子市,0248,250,549,799,56,855,1496,57.15%,16.71%,1
嘉義縣,朴子市,0249,99,243,342,22,364,667,54.57%,14.84%,1
嘉義縣,朴子市,0250,71,167,238,16,254,627,40.51%,11.32%,1
嘉義縣,朴子市,0251,90,261,351,44,395,791,49.94%,11.38%,1
嘉義縣,朴子市,0252,153,328,481,92,573,1034,55.42%,14.8%,1
嘉義縣,朴子市,0253,297,513,810,26,836,1710,48.89%,17.37%,1
嘉義縣,朴子市,0254,226,528,754,39,793,1671,47.46%,13.52%,1
嘉義縣,朴子市,0255,187,439,626,42,668,1547,43.18%,12.09%,1
嘉義縣,朴子市,0256,180,422,602,54,656,1602,40.95%,11.24%,1
嘉義縣,朴子市,0257,223,497,720,21,741,1302,56.91%,17.13%,1
嘉義縣,朴子市,0258,91,243,334,42,376,740,50.81%,12.3%,1
嘉義縣,朴子市,0259,171,389,560,61,621,1054,58.92%,16.22%,1
嘉義縣,朴子市,0260,96,251,347,20,367,907,40.46%,10.58%,1
嘉義縣,朴子市,0261,102,180,282,30,312,720,43.33%,14.17%,1
嘉義縣,朴子市,0262,40,76,116,30,146,251,58.17%,15.94%,1
嘉義縣,朴子市,0263,103,181,284,51,335,767,43.68%,13.43%,1
嘉義縣,朴子市,0264,105,235,340,50,390,702,55.56%,14.96%,1
嘉義縣,朴子市,0265,127,297,424,65,489,1038,47.11%,12.24%,1
嘉義縣,朴子市,0266,127,254,381,28,409,1228,33.31%,10.34%,1
嘉義縣,朴子市,0267,60,147,207,50,257,499,51.5%,12.02%,1
嘉義縣,布袋鎮,0325,81,196,277,22,299,614,48.7%,13.19%,1
嘉義縣,布袋鎮,0326,37,109,146,23,169,372,45.43%,9.95%,1
嘉義縣,布袋鎮,0327,139,300,439,72,511,914,55.91%,15.21%,1
嘉義縣,布袋鎮,0328,171,390,561,75,636,1198,53.09%,14.27%,1
嘉義縣,布袋鎮,0329,120,343,463,60,523,1113,46.99%,10.78%,1
嘉義縣,布袋鎮,0330,150,307,457,58,515,992,51.92%,15.12%,1
嘉義縣,布袋鎮,0331,82,247,329,12,341,689,49.49%,11.9%,1
嘉義縣,布袋鎮,0332,124,282,406,54,460,882,52.15%,14.06%,1
嘉義縣,布袋鎮,0333,95,242,337,44,381,731,52.12%,13%,1
嘉義縣,布袋鎮,0334,94,293,387,35,422,779,54.17%,12.07%,1
嘉義縣,布袋鎮,0335,90,215,305,35,340,762,44.62%,11.81%,1
嘉義縣,布袋鎮,0336,142,334,476,57,533,1184,45.02%,11.99%,1
嘉義縣,布袋鎮,0337,136,361,497,73,570,1423,40.06%,9.56%,1
嘉義縣,布袋鎮,0338,170,322,492,60,552,1351,40.86%,12.58%,1
嘉義縣,布袋鎮,0339,27,88,115,5,120,275,43.64%,9.82%,1
嘉義縣,布袋鎮,0340,34,67,101,14,115,243,47.33%,13.99%,1
嘉義縣,布袋鎮,0341,89,184,273,90,363,661,54.92%,13.46%,1
嘉義縣,布袋鎮,0342,138,354,492,45,537,1145,46.9%,12.05%,1
嘉義縣,布袋鎮,0343,119,284,403,35,438,936,46.79%,12.71%,1
嘉義縣,布袋鎮,0344,141,272,413,41,454,958,47.39%,14.72%,1
嘉義縣,布袋鎮,0345,42,80,122,13,135,298,45.3%,14.09%,1
嘉義縣,布袋鎮,0346,63,146,209,39,248,428,57.94%,14.72%,1
嘉義縣,布袋鎮,0347,15,38,53,1,54,121,44.63%,12.4%,1
嘉義縣,布袋鎮,0348,6,39,45,6,51,174,29.31%,3.45%,1
嘉義縣,布袋鎮,0349,120,290,410,43,453,953,47.53%,12.59%,1
嘉義縣,布袋鎮,0350,175,460,635,55,690,1292,53.41%,13.54%,1
嘉義縣,布袋鎮,0351,142,414,556,51,607,1127,53.86%,12.6%,1
嘉義縣,布袋鎮,0352,157,406,563,39,602,1244,48.39%,12.62%,1
嘉義縣,布袋鎮,0353,149,332,481,23,504,1106,45.57%,13.47%,1
嘉義縣,大林鎮,0169,80,160,240,28,268,483,55.49%,16.56%,1
嘉義縣,大林鎮,0170,312,639,951,67,1018,1823,55.84%,17.11%,1
嘉義縣,大林鎮,0171,152,363,515,20,535,955,56.02%,15.92%,1
嘉義縣,大林鎮,0172,243,467,710,37,747,1436,52.02%,16.92%,1
嘉義縣,大林鎮,0173,260,435,695,70,765,1390,55.04%,18.71%,1
嘉義縣,大林鎮,0174,274,498,772,73,845,1512,55.89%,18.12%,1
嘉義縣,大林鎮,0175,292,532,824,51,875,1536,56.97%,19.01%,1
嘉義縣,大林鎮,0176,159,360,519,40,559,1165,47.98%,13.65%,1
嘉義縣,大林鎮,0177,275,685,960,58,1018,1730,58.84%,15.9%,1
嘉義縣,大林鎮,0178,66,173,239,21,260,602,43.19%,10.96%,1
嘉義縣,大林鎮,0179,121,188,309,49,358,716,50%,16.9%,1
嘉義縣,大林鎮,0180,71,165,236,9,245,625,39.2%,11.36%,1
嘉義縣,大林鎮,0181,26,43,69,5,74,193,38.34%,13.47%,1
嘉義縣,大林鎮,0182,219,458,677,77,754,1642,45.92%,13.34%,1
嘉義縣,大林鎮,0183,206,496,702,61,763,1465,52.08%,14.06%,1
嘉義縣,大林鎮,0184,110,255,365,46,411,928,44.29%,11.85%,1
嘉義縣,大林鎮,0185,36,98,134,26,160,361,44.32%,9.97%,1
嘉義縣,大林鎮,0186,108,264,372,19,391,814,48.03%,13.27%,1
嘉義縣,大林鎮,0187,237,466,703,49,752,1579,47.63%,15.01%,1
嘉義縣,大林鎮,0188,389,559,948,100,1048,2041,51.35%,19.06%,1
嘉義縣,大林鎮,0189,119,293,412,62,474,931,50.91%,12.78%,1
嘉義縣,大林鎮,0190,109,195,304,43,347,675,51.41%,16.15%,1
嘉義縣,大林鎮,0191,76,225,301,24,325,655,49.62%,11.6%,1
嘉義縣,大林鎮,0192,113,261,374,36,410,833,49.22%,13.57%,1
嘉義縣,大林鎮,0193,138,316,454,46,500,832,60.1%,16.59%,1
嘉義縣,民雄鄉,0093,237,442,679,54,733,1267,57.85%,18.71%,1
嘉義縣,民雄鄉,0094,159,336,495,30,525,1030,50.97%,15.44%,1
嘉義縣,民雄鄉,0095,274,586,860,89,949,1590,59.69%,17.23%,1
嘉義縣,民雄鄉,0096,548,283,831,26,857,1673,51.23%,32.76%,1
嘉義縣,民雄鄉,0097,334,586,920,66,986,1718,57.39%,19.44%,1
嘉義縣,民雄鄉,0098,191,376,567,47,614,1040,59.04%,18.37%,1
嘉義縣,民雄鄉,0099,189,340,529,52,581,1100,52.82%,17.18%,1
嘉義縣,民雄鄉,0100,238,483,721,76,797,1559,51.12%,15.27%,1
嘉義縣,民雄鄉,0101,294,573,867,79,946,1862,50.81%,15.79%,1
嘉義縣,民雄鄉,0102,264,472,736,73,809,1435,56.38%,18.4%,1
嘉義縣,民雄鄉,0103,277,507,784,168,952,1751,54.37%,15.82%,1
嘉義縣,民雄鄉,0104,142,330,472,60,532,933,57.02%,15.22%,1
嘉義縣,民雄鄉,0105,161,312,473,44,517,827,62.52%,19.47%,1
嘉義縣,民雄鄉,0106,120,228,348,55,403,843,47.81%,14.23%,1
嘉義縣,民雄鄉,0107,279,588,867,69,936,1774,52.76%,15.73%,1
嘉義縣,民雄鄉,0108,54,112,166,16,182,385,47.27%,14.03%,1
嘉義縣,民雄鄉,0109,250,476,726,33,759,1306,58.12%,19.14%,1
嘉義縣,民雄鄉,0110,83,196,279,41,320,535,59.81%,15.51%,1
嘉義縣,民雄鄉,0111,187,358,545,72,617,1055,58.48%,17.73%,1
嘉義縣,民雄鄉,0112,225,528,753,46,799,1476,54.13%,15.24%,1
嘉義縣,民雄鄉,0113,212,534,746,49,795,1583,50.22%,13.39%,1
嘉義縣,民雄鄉,0114,111,215,326,28,354,758,46.7%,14.64%,1
嘉義縣,民雄鄉,0115,210,421,631,44,675,1354,49.85%,15.51%,1
嘉義縣,民雄鄉,0116,182,409,591,101,692,1202,57.57%,15.14%,1
嘉義縣,民雄鄉,0117,206,397,603,44,647,1175,55.06%,17.53%,1
嘉義縣,民雄鄉,0118,238,441,679,45,724,1423,50.88%,16.73%,1
嘉義縣,民雄鄉,0119,240,573,813,37,850,1612,52.73%,14.89%,1
嘉義縣,民雄鄉,0120,286,615,901,34,935,1695,55.16%,16.87%,1
嘉義縣,民雄鄉,0121,238,495,733,54,787,1665,47.27%,14.29%,1
嘉義縣,民雄鄉,0122,121,318,439,57,496,1019,48.68%,11.87%,1
嘉義縣,民雄鄉,0123,190,447,637,63,700,1352,51.78%,14.05%,1
嘉義縣,民雄鄉,0124,297,523,820,77,897,1620,55.37%,18.33%,1
嘉義縣,民雄鄉,0125,150,281,431,43,474,943,50.27%,15.91%,1
嘉義縣,民雄鄉,0126,215,522,737,60,797,1720,46.34%,12.5%,1
嘉義縣,民雄鄉,0127,235,643,878,82,960,1875,51.2%,12.53%,1
嘉義縣,民雄鄉,0128,230,456,686,45,731,1305,56.02%,17.62%,1
嘉義縣,民雄鄉,0129,255,436,691,61,752,1441,52.19%,17.7%,1
嘉義縣,民雄鄉,0130,228,492,720,63,783,1413,55.41%,16.14%,1
嘉義縣,民雄鄉,0131,244,519,763,69,832,1560,53.33%,15.64%,1
嘉義縣,民雄鄉,0132,334,671,1005,101,1106,2004,55.19%,16.67%,1
嘉義縣,民雄鄉,0133,246,485,731,67,798,1354,58.94%,18.17%,1
嘉義縣,民雄鄉,0134,180,388,568,29,597,1076,55.48%,16.73%,1
嘉義縣,民雄鄉,0135,234,553,787,128,915,1629,56.17%,14.36%,1
嘉義縣,民雄鄉,0136,285,643,928,76,1004,1977,50.78%,14.42%,1
嘉義縣,民雄鄉,0137,206,395,601,71,672,1295,51.89%,15.91%,1
嘉義縣,溪口鄉,0194,221,433,654,99,753,1318,57.13%,16.77%,1
嘉義縣,溪口鄉,0195,128,219,347,48,395,677,58.35%,18.91%,1
嘉義縣,溪口鄉,0196,60,134,194,17,211,417,50.6%,14.39%,1
嘉義縣,溪口鄉,0197,45,90,135,18,153,273,56.04%,16.48%,1
嘉義縣,溪口鄉,0198,154,310,464,66,530,908,58.37%,16.96%,1
嘉義縣,溪口鄉,0199,69,95,164,10,174,386,45.08%,17.88%,1
嘉義縣,溪口鄉,0200,192,327,519,57,576,1039,55.44%,18.48%,1
嘉義縣,溪口鄉,0201,102,181,283,48,331,708,46.75%,14.41%,1
嘉義縣,溪口鄉,0202,137,259,396,22,418,909,45.98%,15.07%,1
嘉義縣,溪口鄉,0203,132,257,389,44,433,786,55.09%,16.79%,1
嘉義縣,溪口鄉,0204,119,223,342,44,386,807,47.83%,14.75%,1
嘉義縣,溪口鄉,0205,144,286,430,24,454,1168,38.87%,12.33%,1
嘉義縣,溪口鄉,0206,176,313,489,99,588,1052,55.89%,16.73%,1
嘉義縣,溪口鄉,0207,87,157,244,41,285,565,50.44%,15.4%,1
嘉義縣,溪口鄉,0208,52,128,180,29,209,388,53.87%,13.4%,1
嘉義縣,溪口鄉,0209,97,176,273,23,296,701,42.23%,13.84%,1
嘉義縣,溪口鄉,0210,109,282,391,37,428,1003,42.67%,10.87%,1
嘉義縣,新港鄉,0138,176,371,547,35,582,1087,53.54%,16.19%,1
嘉義縣,新港鄉,0139,228,449,677,62,739,1116,66.22%,20.43%,1
嘉義縣,新港鄉,0140,115,244,359,53,412,740,55.68%,15.54%,1
嘉義縣,新港鄉,0141,141,234,375,65,440,827,53.2%,17.05%,1
嘉義縣,新港鄉,0142,122,255,377,55,432,704,61.36%,17.33%,1
嘉義縣,新港鄉,0143,161,263,424,52,476,768,61.98%,20.96%,1
嘉義縣,新港鄉,0144,155,254,409,47,456,761,59.92%,20.37%,1
嘉義縣,新港鄉,0145,127,257,384,62,446,850,52.47%,14.94%,1
嘉義縣,新港鄉,0146,198,440,638,63,701,1327,52.83%,14.92%,1
嘉義縣,新港鄉,0147,124,234,358,61,419,756,55.42%,16.4%,1
嘉義縣,新港鄉,0148,136,236,372,92,464,816,56.86%,16.67%,1
嘉義縣,新港鄉,0149,99,185,284,26,310,667,46.48%,14.84%,1
嘉義縣,新港鄉,0150,151,293,444,58,502,942,53.29%,16.03%,1
嘉義縣,新港鄉,0151,109,262,371,71,442,918,48.15%,11.87%,1
嘉義縣,新港鄉,0152,60,161,221,18,239,554,43.14%,10.83%,1
嘉義縣,新港鄉,0153,39,270,309,46,355,929,38.21%,4.2%,1
嘉義縣,新港鄉,0154,70,91,161,44,205,487,42.09%,14.37%,1
嘉義縣,新港鄉,0155,64,161,225,45,270,487,55.44%,13.14%,1
嘉義縣,新港鄉,0156,143,233,376,47,423,836,50.6%,17.11%,1
嘉義縣,新港鄉,0157,149,267,416,53,469,845,55.5%,17.63%,1
嘉義縣,新港鄉,0158,168,248,416,46,462,834,55.4%,20.14%,1
嘉義縣,新港鄉,0159,143,234,377,48,425,753,56.44%,18.99%,1
嘉義縣,新港鄉,0160,207,409,616,87,703,1328,52.94%,15.59%,1
嘉義縣,新港鄉,0161,177,333,510,46,556,969,57.38%,18.27%,1
嘉義縣,新港鄉,0162,187,366,553,67,620,1043,59.44%,17.93%,1
嘉義縣,新港鄉,0163,244,547,791,56,847,1400,60.5%,17.43%,1
嘉義縣,新港鄉,0164,112,223,335,30,365,1017,35.89%,11.01%,1
嘉義縣,新港鄉,0165,152,315,467,52,519,1132,45.85%,13.43%,1
嘉義縣,新港鄉,0166,161,306,467,73,540,1037,52.07%,15.53%,1
嘉義縣,新港鄉,0167,82,188,270,63,333,563,59.15%,14.56%,1
嘉義縣,新港鄉,0168,130,268,398,25,423,849,49.82%,15.31%,1
嘉義縣,六腳鄉,0268,146,331,477,35,512,1165,43.95%,12.53%,1
嘉義縣,六腳鄉,0269,76,187,263,21,284,825,34.42%,9.21%,1
嘉義縣,六腳鄉,0270,120,235,355,30,385,850,45.29%,14.12%,1
嘉義縣,六腳鄉,0271,38,76,114,18,132,222,59.46%,17.12%,1
嘉義縣,六腳鄉,0272,200,337,537,57,594,1216,48.85%,16.45%,1
嘉義縣,六腳鄉,0273,141,280,421,44,465,1200,38.75%,11.75%,1
嘉義縣,六腳鄉,0274,122,247,369,41,410,877,46.75%,13.91%,1
嘉義縣,六腳鄉,0275,93,143,236,37,273,644,42.39%,14.44%,1
嘉義縣,六腳鄉,0276,69,129,198,16,214,594,36.03%,11.62%,1
嘉義縣,六腳鄉,0277,10,28,38,2,40,167,23.95%,5.99%,1
嘉義縣,六腳鄉,0278,28,42,70,2,72,204,35.29%,13.73%,1
嘉義縣,六腳鄉,0279,38,48,86,3,89,234,38.03%,16.24%,1
嘉義縣,六腳鄉,0280,35,106,141,4,145,361,40.17%,9.7%,1
嘉義縣,六腳鄉,0281,91,196,287,46,333,592,56.25%,15.37%,1
嘉義縣,六腳鄉,0282,86,191,277,35,312,619,50.4%,13.89%,1
嘉義縣,六腳鄉,0283,75,158,233,47,280,714,39.22%,10.5%,1
嘉義縣,六腳鄉,0284,138,311,449,65,514,1051,48.91%,13.13%,1
嘉義縣,六腳鄉,0285,142,281,423,61,484,934,51.82%,15.2%,1
嘉義縣,六腳鄉,0286,147,310,457,57,514,1044,49.23%,14.08%,1
嘉義縣,六腳鄉,0287,187,404,591,38,629,1476,42.62%,12.67%,1
嘉義縣,六腳鄉,0288,69,134,203,21,224,618,36.25%,11.17%,1
嘉義縣,六腳鄉,0289,42,82,124,38,162,478,33.89%,8.79%,1
嘉義縣,六腳鄉,0290,61,131,192,44,236,642,36.76%,9.5%,1
嘉義縣,六腳鄉,0291,91,186,277,9,286,883,32.39%,10.31%,1
嘉義縣,六腳鄉,0292,59,170,229,11,240,739,32.48%,7.98%,1
嘉義縣,六腳鄉,0293,72,120,192,26,218,554,39.35%,13%,1
嘉義縣,六腳鄉,0294,59,135,194,25,219,649,33.74%,9.09%,1
嘉義縣,六腳鄉,0295,75,148,223,21,244,689,35.41%,10.89%,1
嘉義縣,六腳鄉,0296,46,113,159,17,176,455,38.68%,10.11%,1
嘉義縣,六腳鄉,0297,12,23,35,2,37,125,29.6%,9.6%,1
嘉義縣,東石鄉,0298,212,600,812,68,880,1915,45.95%,11.07%,1
嘉義縣,東石鄉,0299,107,221,328,50,378,938,40.3%,11.41%,1
嘉義縣,東石鄉,0300,112,259,371,30,401,1366,29.36%,8.2%,1
嘉義縣,東石鄉,0301,146,486,632,5,637,1676,38.01%,8.71%,1
嘉義縣,東石鄉,0302,119,280,399,75,474,1151,41.18%,10.34%,1
嘉義縣,東石鄉,0303,74,189,263,58,321,716,44.83%,10.34%,1
嘉義縣,東石鄉,0304,19,95,114,17,131,387,33.85%,4.91%,1
嘉義縣,東石鄉,0305,58,174,232,16,248,864,28.7%,6.71%,1
嘉義縣,東石鄉,0306,86,191,277,20,297,910,32.64%,9.45%,1
嘉義縣,東石鄉,0307,64,186,250,15,265,760,34.87%,8.42%,1
嘉義縣,東石鄉,0308,14,59,73,14,87,166,52.41%,8.43%,1
嘉義縣,東石鄉,0309,17,51,68,12,80,212,37.74%,8.02%,1
嘉義縣,東石鄉,0310,80,212,292,39,331,993,33.33%,8.06%,1
嘉義縣,東石鄉,0311,26,80,106,13,119,306,38.89%,8.5%,1
嘉義縣,東石鄉,0312,99,252,351,60,411,1046,39.29%,9.46%,1
嘉義縣,東石鄉,0313,16,58,74,16,90,235,38.3%,6.81%,1
嘉義縣,東石鄉,0314,140,342,482,74,556,1226,45.35%,11.42%,1
嘉義縣,東石鄉,0315,101,204,305,62,367,843,43.53%,11.98%,1
嘉義縣,東石鄉,0316,81,178,259,30,289,693,41.7%,11.69%,1
嘉義縣,東石鄉,0317,95,272,367,45,412,839,49.11%,11.32%,1
嘉義縣,東石鄉,0318,38,111,149,14,163,363,44.9%,10.47%,1
嘉義縣,東石鄉,0319,34,66,100,12,112,321,34.89%,10.59%,1
嘉義縣,東石鄉,0320,132,373,505,91,596,1083,55.03%,12.19%,1
嘉義縣,東石鄉,0321,118,248,366,50,416,901,46.17%,13.1%,1
嘉義縣,東石鄉,0322,91,275,366,40,406,1216,33.39%,7.48%,1
嘉義縣,東石鄉,0323,60,142,202,47,249,418,59.57%,14.35%,1
嘉義縣,東石鄉,0324,40,103,143,12,155,371,41.78%,10.78%,1
嘉義縣,義竹鄉,0354,65,141,206,25,231,482,47.93%,13.49%,1
嘉義縣,義竹鄉,0355,33,78,111,19,130,223,58.3%,14.8%,1
嘉義縣,義竹鄉,0356,256,467,723,101,824,1529,53.89%,16.74%,1
嘉義縣,義竹鄉,0357,194,395,589,70,659,1175,56.09%,16.51%,1
嘉義縣,義竹鄉,0358,150,344,494,53,547,886,61.74%,16.93%,1
嘉義縣,義竹鄉,0359,99,204,303,32,335,743,45.09%,13.32%,1
嘉義縣,義竹鄉,0360,203,387,590,90,680,1236,55.02%,16.42%,1
嘉義縣,義竹鄉,0361,58,115,173,21,194,377,51.46%,15.38%,1
嘉義縣,義竹鄉,0362,44,85,129,25,154,338,45.56%,13.02%,1
嘉義縣,義竹鄉,0363,15,40,55,4,59,102,57.84%,14.71%,1
嘉義縣,義竹鄉,0364,112,201,313,22,335,763,43.91%,14.68%,1
嘉義縣,義竹鄉,0365,69,147,216,31,247,429,57.58%,16.08%,1
嘉義縣,義竹鄉,0366,55,136,191,21,212,427,49.65%,12.88%,1
嘉義縣,義竹鄉,0367,96,189,285,46,331,607,54.53%,15.82%,1
嘉義縣,義竹鄉,0368,206,432,638,45,683,1486,45.96%,13.86%,1
嘉義縣,義竹鄉,0369,129,289,418,62,480,835,57.49%,15.45%,1
嘉義縣,義竹鄉,0370,106,188,294,60,354,816,43.38%,12.99%,1
嘉義縣,義竹鄉,0371,124,199,323,61,384,833,46.1%,14.89%,1
嘉義縣,義竹鄉,0372,50,150,200,14,214,433,49.42%,11.55%,1
嘉義縣,義竹鄉,0373,87,152,239,6,245,558,43.91%,15.59%,1
嘉義縣,義竹鄉,0374,94,177,271,42,313,602,51.99%,15.61%,1
嘉義縣,義竹鄉,0375,10,41,51,1,52,140,37.14%,7.14%,1
嘉義縣,義竹鄉,0376,58,100,158,21,179,393,45.55%,14.76%,1
嘉義縣,義竹鄉,0377,77,190,267,24,291,585,49.74%,13.16%,1
嘉義縣,義竹鄉,0378,48,127,175,7,182,526,34.6%,9.13%,1
嘉義縣,義竹鄉,0379,20,47,67,7,74,123,60.16%,16.26%,1
嘉義縣,鹿草鄉,0034,84,126,210,31,241,522,46.17%,16.09%,1
嘉義縣,鹿草鄉,0035,112,151,263,41,304,563,54%,19.89%,1
嘉義縣,鹿草鄉,0036,191,381,572,73,645,1304,49.46%,14.65%,1
嘉義縣,鹿草鄉,0037,198,409,607,53,660,1312,50.3%,15.09%,1
嘉義縣,鹿草鄉,0038,44,95,139,7,146,320,45.63%,13.75%,1
嘉義縣,鹿草鄉,0039,32,75,107,3,110,418,26.32%,7.66%,1
嘉義縣,鹿草鄉,0040,128,258,386,59,445,1025,43.41%,12.49%,1
嘉義縣,鹿草鄉,0041,65,101,166,20,186,451,41.24%,14.41%,1
嘉義縣,鹿草鄉,0042,95,256,351,94,445,830,53.61%,11.45%,1
嘉義縣,鹿草鄉,0043,145,276,421,69,490,1050,46.67%,13.81%,1
嘉義縣,鹿草鄉,0044,108,218,326,72,398,972,40.95%,11.11%,1
嘉義縣,鹿草鄉,0045,140,252,392,54,446,962,46.36%,14.55%,1
嘉義縣,鹿草鄉,0046,124,169,293,53,346,678,51.03%,18.29%,1
嘉義縣,鹿草鄉,0047,27,90,117,20,137,262,52.29%,10.31%,1
嘉義縣,鹿草鄉,0048,124,219,343,48,391,906,43.16%,13.69%,1
嘉義縣,鹿草鄉,0049,29,69,98,10,108,306,35.29%,9.48%,1
嘉義縣,鹿草鄉,0050,149,323,472,72,544,1062,51.22%,14.03%,1
嘉義縣,鹿草鄉,0051,52,122,174,23,197,373,52.82%,13.94%,1
嘉義縣,鹿草鄉,0052,49,103,152,23,175,324,54.01%,15.12%,1
嘉義縣,鹿草鄉,0053,100,33,133,16,149,297,50.17%,33.67%,1
嘉義縣,水上鄉,0054,154,332,486,29,515,1024,50.29%,15.04%,1
嘉義縣,水上鄉,0055,190,369,559,56,615,1015,60.59%,18.72%,1
嘉義縣,水上鄉,0056,280,596,876,70,946,1932,48.96%,14.49%,1
嘉義縣,水上鄉,0057,214,434,648,35,683,1170,58.38%,18.29%,1
嘉義縣,水上鄉,0058,203,490,693,73,766,1305,58.7%,15.56%,1
嘉義縣,水上鄉,0059,190,377,567,52,619,1242,49.84%,15.3%,1
嘉義縣,水上鄉,0060,52,89,141,18,159,324,49.07%,16.05%,1
嘉義縣,水上鄉,0061,89,211,300,25,325,622,52.25%,14.31%,1
嘉義縣,水上鄉,0062,185,398,583,61,644,1216,52.96%,15.21%,1
嘉義縣,水上鄉,0063,161,368,529,29,558,1020,54.71%,15.78%,1
嘉義縣,水上鄉,0064,159,290,449,32,481,771,62.39%,20.62%,1
嘉義縣,水上鄉,0065,66,189,255,22,277,441,62.81%,14.97%,1
嘉義縣,水上鄉,0066,133,224,357,56,413,626,65.97%,21.25%,1
嘉義縣,水上鄉,0067,118,190,308,31,339,570,59.47%,20.7%,1
嘉義縣,水上鄉,0068,49,120,169,23,192,368,52.17%,13.32%,1
嘉義縣,水上鄉,0069,160,284,444,92,536,1037,51.69%,15.43%,1
嘉義縣,水上鄉,0070,189,330,519,61,580,1065,54.46%,17.75%,1
嘉義縣,水上鄉,0071,144,294,438,72,510,802,63.59%,17.96%,1
嘉義縣,水上鄉,0072,332,595,927,46,973,1948,49.95%,17.04%,1
嘉義縣,水上鄉,0073,149,315,464,65,529,1028,51.46%,14.49%,1
嘉義縣,水上鄉,0074,109,232,341,32,373,641,58.19%,17%,1
嘉義縣,水上鄉,0075,68,156,224,16,240,408,58.82%,16.67%,1
嘉義縣,水上鄉,0076,146,263,409,49,458,794,57.68%,18.39%,1
嘉義縣,水上鄉,0077,77,176,253,19,272,569,47.8%,13.53%,1
嘉義縣,水上鄉,0078,120,294,414,37,451,806,55.96%,14.89%,1
嘉義縣,水上鄉,0079,130,343,473,80,553,960,57.6%,13.54%,1
嘉義縣,水上鄉,0080,349,690,1039,75,1114,2035,54.74%,17.15%,1
嘉義縣,水上鄉,0081,314,655,969,90,1059,1987,53.3%,15.8%,1
嘉義縣,水上鄉,0082,186,402,588,36,624,1154,54.07%,16.12%,1
嘉義縣,水上鄉,0083,280,752,1032,81,1113,2208,50.41%,12.68%,1
嘉義縣,水上鄉,0084,261,611,872,65,937,2102,44.58%,12.42%,1
嘉義縣,水上鄉,0085,163,437,600,57,657,1309,50.19%,12.45%,1
嘉義縣,水上鄉,0086,274,573,847,60,907,1671,54.28%,16.4%,1
嘉義縣,水上鄉,0087,121,280,401,46,447,822,54.38%,14.72%,1
嘉義縣,水上鄉,0088,240,591,831,62,893,1772,50.4%,13.54%,1
嘉義縣,水上鄉,0089,266,651,917,87,1004,1919,52.32%,13.86%,1
嘉義縣,水上鄉,0090,93,299,392,21,413,912,45.29%,10.2%,1
嘉義縣,水上鄉,0091,132,351,483,22,505,992,50.91%,13.31%,1
嘉義縣,水上鄉,0092,166,358,524,45,569,1270,44.8%,13.07%,1
嘉義縣,中埔鄉,0380,125,280,405,18,423,1046,40.44%,11.95%,1
嘉義縣,中埔鄉,0381,267,502,769,77,846,1788,47.32%,14.93%,1
嘉義縣,中埔鄉,0382,252,493,745,42,787,1730,45.49%,14.57%,1
嘉義縣,中埔鄉,0383,248,470,718,57,775,1581,49.02%,15.69%,1
嘉義縣,中埔鄉,0384,193,432,625,54,679,1594,42.6%,12.11%,1
嘉義縣,中埔鄉,0385,268,611,879,37,916,1801,50.86%,14.88%,1
嘉義縣,中埔鄉,0386,231,632,863,62,925,1862,49.68%,12.41%,1
嘉義縣,中埔鄉,0387,249,542,791,38,829,1803,45.98%,13.81%,1
嘉義縣,中埔鄉,0388,211,514,725,46,771,1481,52.06%,14.25%,1
嘉義縣,中埔鄉,0389,223,445,668,56,724,1366,53%,16.33%,1
嘉義縣,中埔鄉,0390,191,444,635,80,715,1599,44.72%,11.94%,1
嘉義縣,中埔鄉,0391,186,381,567,35,602,1196,50.33%,15.55%,1
嘉義縣,中埔鄉,0392,245,492,737,91,828,1809,45.77%,13.54%,1
嘉義縣,中埔鄉,0393,144,292,436,23,459,953,48.16%,15.11%,1
嘉義縣,中埔鄉,0394,178,421,599,68,667,1441,46.29%,12.35%,1
嘉義縣,中埔鄉,0395,230,562,792,75,867,1882,46.07%,12.22%,1
嘉義縣,中埔鄉,0396,164,368,532,17,549,1470,37.35%,11.16%,1
嘉義縣,中埔鄉,0397,195,486,681,75,756,1699,44.5%,11.48%,1
嘉義縣,中埔鄉,0398,51,108,159,16,175,422,41.47%,12.09%,1
嘉義縣,中埔鄉,0399,152,291,443,69,512,1030,49.71%,14.76%,1
嘉義縣,中埔鄉,0400,126,264,390,32,422,879,48.01%,14.33%,1
嘉義縣,中埔鄉,0401,92,245,337,19,356,828,43%,11.11%,1
嘉義縣,中埔鄉,0402,133,315,448,55,503,881,57.09%,15.1%,1
嘉義縣,中埔鄉,0403,47,85,132,16,148,296,50%,15.88%,1
嘉義縣,中埔鄉,0404,116,287,403,76,479,979,48.93%,11.85%,1
嘉義縣,中埔鄉,0405,164,350,514,44,558,1268,44.01%,12.93%,1
嘉義縣,中埔鄉,0406,69,132,201,7,208,670,31.04%,10.3%,1
嘉義縣,中埔鄉,0407,119,245,364,67,431,754,57.16%,15.78%,1
嘉義縣,中埔鄉,0408,124,192,316,39,355,648,54.78%,19.14%,1
嘉義縣,中埔鄉,0409,110,164,274,23,297,741,40.08%,14.84%,1
嘉義縣,中埔鄉,0410,70,153,223,9,232,518,44.79%,13.51%,1
嘉義縣,中埔鄉,0411,66,151,217,25,242,482,50.21%,13.69%,1
嘉義縣,中埔鄉,0412,50,89,139,8,147,348,42.24%,14.37%,1
嘉義縣,中埔鄉,0413,39,99,138,10,148,294,50.34%,13.27%,1
嘉義縣,竹崎鄉,0414,221,424,645,40,685,1312,52.21%,16.84%,1
嘉義縣,竹崎鄉,0415,196,433,629,26,655,1210,54.13%,16.2%,1
嘉義縣,竹崎鄉,0416,142,369,511,42,553,991,55.8%,14.33%,1
嘉義縣,竹崎鄉,0417,171,423,594,35,629,1207,52.11%,14.17%,1
嘉義縣,竹崎鄉,0418,128,193,321,15,336,752,44.68%,17.02%,1
嘉義縣,竹崎鄉,0419,140,279,419,66,485,833,58.22%,16.81%,1
嘉義縣,竹崎鄉,0420,174,445,619,75,694,1220,56.89%,14.26%,1
嘉義縣,竹崎鄉,0421,111,226,337,17,354,616,57.47%,18.02%,1
嘉義縣,竹崎鄉,0422,125,353,478,50,528,1031,51.21%,12.12%,1
嘉義縣,竹崎鄉,0423,160,448,608,61,669,1292,51.78%,12.38%,1
嘉義縣,竹崎鄉,0424,315,722,1037,65,1102,1995,55.24%,15.79%,1
嘉義縣,竹崎鄉,0425,271,636,907,25,932,1996,46.69%,13.58%,1
嘉義縣,竹崎鄉,0426,212,470,682,72,754,1449,52.04%,14.63%,1
嘉義縣,竹崎鄉,0427,190,500,690,41,731,1420,51.48%,13.38%,1
嘉義縣,竹崎鄉,0428,235,575,810,57,867,1590,54.53%,14.78%,1
嘉義縣,竹崎鄉,0429,102,263,365,32,397,771,51.49%,13.23%,1
嘉義縣,竹崎鄉,0430,144,286,430,50,480,1014,47.34%,14.2%,1
嘉義縣,竹崎鄉,0431,34,78,112,8,120,327,36.7%,10.4%,1
嘉義縣,竹崎鄉,0432,78,262,340,24,364,687,52.98%,11.35%,1
嘉義縣,竹崎鄉,0433,83,215,298,18,316,641,49.3%,12.95%,1
嘉義縣,竹崎鄉,0434,71,180,251,8,259,474,54.64%,14.98%,1
嘉義縣,竹崎鄉,0435,49,132,181,14,195,383,50.91%,12.79%,1
嘉義縣,竹崎鄉,0436,90,250,340,37,377,619,60.9%,14.54%,1
嘉義縣,竹崎鄉,0437,30,64,94,6,100,214,46.73%,14.02%,1
嘉義縣,竹崎鄉,0438,225,490,715,90,805,1568,51.34%,14.35%,1
嘉義縣,竹崎鄉,0439,73,200,273,29,302,658,45.9%,11.09%,1
嘉義縣,竹崎鄉,0440,73,153,226,28,254,434,58.53%,16.82%,1
嘉義縣,竹崎鄉,0441,137,309,446,54,500,917,54.53%,14.94%,1
嘉義縣,竹崎鄉,0442,134,297,431,46,477,981,48.62%,13.66%,1
嘉義縣,竹崎鄉,0443,88,260,348,20,368,789,46.64%,11.15%,1
嘉義縣,竹崎鄉,0444,8,19,27,3,30,108,27.78%,7.41%,1
嘉義縣,竹崎鄉,0445,23,37,60,2,62,235,26.38%,9.79%,1
嘉義縣,竹崎鄉,0446,48,97,145,4,149,331,45.02%,14.5%,1
嘉義縣,竹崎鄉,0447,86,177,263,11,274,450,60.89%,19.11%,1
嘉義縣,竹崎鄉,0448,46,139,185,5,190,462,41.13%,9.96%,1
嘉義縣,竹崎鄉,0449,19,69,88,18,106,251,42.23%,7.57%,1
嘉義縣,梅山鄉,0211,170,336,506,29,535,1041,51.39%,16.33%,1
嘉義縣,梅山鄉,0212,220,430,650,92,742,1245,59.6%,17.67%,1
嘉義縣,梅山鄉,0213,176,331,507,63,570,917,62.16%,19.19%,1
嘉義縣,梅山鄉,0214,190,406,596,43,639,1189,53.74%,15.98%,1
嘉義縣,梅山鄉,0215,223,483,706,62,768,1388,55.33%,16.07%,1
嘉義縣,梅山鄉,0216,295,623,918,54,972,1827,53.2%,16.15%,1
嘉義縣,梅山鄉,0217,116,180,296,48,344,545,63.12%,21.28%,1
嘉義縣,梅山鄉,0218,58,95,153,30,183,407,44.96%,14.25%,1
嘉義縣,梅山鄉,0219,89,239,328,32,360,636,56.6%,13.99%,1
嘉義縣,梅山鄉,0220,94,192,286,48,334,576,57.99%,16.32%,1
嘉義縣,梅山鄉,0221,251,587,838,87,925,1674,55.26%,14.99%,1
嘉義縣,梅山鄉,0222,100,268,368,16,384,858,44.76%,11.66%,1
嘉義縣,梅山鄉,0223,79,226,305,22,327,526,62.17%,15.02%,1
嘉義縣,梅山鄉,0224,48,102,150,30,180,372,48.39%,12.9%,1
嘉義縣,梅山鄉,0225,76,155,231,22,253,506,50%,15.02%,1
嘉義縣,梅山鄉,0226,70,199,269,39,308,433,71.13%,16.17%,1
嘉義縣,梅山鄉,0227,41,114,155,9,164,404,40.59%,10.15%,1
嘉義縣,梅山鄉,0228,45,93,138,10,148,293,50.51%,15.36%,1
嘉義縣,梅山鄉,0229,97,292,389,62,451,712,63.34%,13.62%,1
嘉義縣,梅山鄉,0230,76,259,335,38,373,602,61.96%,12.62%,1
嘉義縣,梅山鄉,0231,58,164,222,29,251,515,48.74%,11.26%,1
嘉義縣,梅山鄉,0232,40,114,154,10,164,417,39.33%,9.59%,1
嘉義縣,番路鄉,0450,196,446,642,67,709,1174,60.39%,16.7%,1
嘉義縣,番路鄉,0451,79,185,264,9,273,449,60.8%,17.59%,1
嘉義縣,番路鄉,0452,108,308,416,36,452,753,60.03%,14.34%,1
嘉義縣,番路鄉,0453,68,162,230,34,264,551,47.91%,12.34%,1
嘉義縣,番路鄉,0454,296,633,929,77,1006,1791,56.17%,16.53%,1
嘉義縣,番路鄉,0455,147,337,484,54,538,849,63.37%,17.31%,1
嘉義縣,番路鄉,0456,140,323,463,37,500,866,57.74%,16.17%,1
嘉義縣,番路鄉,0457,91,315,406,33,439,800,54.88%,11.38%,1
嘉義縣,番路鄉,0458,77,156,233,24,257,444,57.88%,17.34%,1
嘉義縣,番路鄉,0459,60,190,250,13,263,635,41.42%,9.45%,1
嘉義縣,番路鄉,0460,29,105,134,13,147,319,46.08%,9.09%,1
嘉義縣,番路鄉,0461,73,281,354,24,378,642,58.88%,11.37%,1
嘉義縣,番路鄉,0462,45,164,209,22,231,509,45.38%,8.84%,1
嘉義縣,番路鄉,0463,10,78,88,1,89,162,54.94%,6.17%,1
嘉義縣,番路鄉,0464,17,95,112,9,121,212,57.08%,8.02%,1
嘉義縣,大埔鄉,0465,249,484,733,78,811,1468,55.25%,16.96%,1
嘉義縣,大埔鄉,0466,37,84,121,5,126,320,39.38%,11.56%,1
嘉義縣,大埔鄉,0467,50,114,164,10,174,304,57.24%,16.45%,1
嘉義縣,大埔鄉,0468,23,69,92,1,93,184,50.54%,12.5%,1
嘉義縣,大埔鄉,0469,45,102,147,12,159,234,67.95%,19.23%,1
嘉義縣,大埔鄉,0470,70,169,239,13,252,495,50.91%,14.14%,1
嘉義縣,大埔鄉,0471,37,74,111,4,115,199,57.79%,18.59%,1
嘉義縣,大埔鄉,0472,38,67,105,6,111,226,49.12%,16.81%,1
嘉義縣,大埔鄉,0473,85,234,319,28,347,569,60.98%,14.94%,1
嘉義縣,阿里山鄉,0474,48,128,176,9,185,371,49.87%,12.94%,1
嘉義縣,阿里山鄉,0475,19,63,82,5,87,197,44.16%,9.64%,1
嘉義縣,阿里山鄉,0476,15,50,65,4,69,152,45.39%,9.87%,1
嘉義縣,阿里山鄉,0477,17,55,72,7,79,231,34.2%,7.36%,1
嘉義縣,阿里山鄉,0478,4,17,21,0,21,72,29.17%,5.56%,1
嘉義縣,阿里山鄉,0479,31,103,134,2,136,311,43.73%,9.97%,1
嘉義縣,阿里山鄉,0480,26,124,150,13,163,306,53.27%,8.5%,1
嘉義縣,阿里山鄉,0481,110,334,444,12,456,970,47.01%,11.34%,1
嘉義縣,阿里山鄉,0482,66,344,410,44,454,827,54.9%,7.98%,1
嘉義縣,阿里山鄉,0483,23,93,116,4,120,238,50.42%,9.66%,1
嘉義縣,阿里山鄉,0484,21,105,126,9,135,479,28.18%,4.38%,1
嘉義縣,阿里山鄉,0485,24,81,105,6,111,291,38.14%,8.25%,1
嘉義縣,阿里山鄉,0486,26,113,139,19,158,246,64.23%,10.57%,1
屏東縣,屏東市,0001,47,75,122,6,128,237,54.01%,19.83%,1
屏東縣,屏東市,0002,56,88,144,22,166,294,56.46%,19.05%,1
屏東縣,屏東市,0003,138,169,307,11,318,582,54.64%,23.71%,1
屏東縣,屏東市,0004,135,249,384,23,407,713,57.08%,18.93%,1
屏東縣,屏東市,0005,118,175,293,25,318,572,55.59%,20.63%,1
屏東縣,屏東市,0006,95,177,272,10,282,455,61.98%,20.88%,1
屏東縣,屏東市,0007,65,80,145,0,145,249,58.23%,26.1%,1
屏東縣,屏東市,0008,192,407,599,22,621,1315,47.22%,14.6%,1
屏東縣,屏東市,0009,231,387,618,43,661,1373,48.14%,16.82%,1
屏東縣,屏東市,0010,159,249,408,28,436,713,61.15%,22.3%,1
屏東縣,屏東市,0011,133,203,336,32,368,573,64.22%,23.21%,1
屏東縣,屏東市,0012,76,113,189,13,202,297,68.01%,25.59%,1
屏東縣,屏東市,0013,82,184,266,17,283,409,69.19%,20.05%,1
屏東縣,屏東市,0014,47,99,146,14,160,286,55.94%,16.43%,1
屏東縣,屏東市,0015,90,152,242,9,251,421,59.62%,21.38%,1
屏東縣,屏東市,0016,113,197,310,12,322,569,56.59%,19.86%,1
屏東縣,屏東市,0017,109,125,234,15,249,459,54.25%,23.75%,1
屏東縣,屏東市,0018,158,250,408,23,431,672,64.14%,23.51%,1
屏東縣,屏東市,0019,156,226,382,43,425,668,63.62%,23.35%,1
屏東縣,屏東市,0020,89,136,225,10,235,411,57.18%,21.65%,1
屏東縣,屏東市,0021,139,277,416,25,441,768,57.42%,18.1%,1
屏東縣,屏東市,0022,141,270,411,26,437,786,55.6%,17.94%,1
屏東縣,屏東市,0023,169,323,492,31,523,890,58.76%,18.99%,1
屏東縣,屏東市,0024,209,512,721,40,761,1353,56.25%,15.45%,1
屏東縣,屏東市,0025,232,489,721,19,740,1386,53.39%,16.74%,1
屏東縣,屏東市,0026,243,471,714,23,737,1413,52.16%,17.2%,1
屏東縣,屏東市,0027,194,466,660,31,691,1272,54.32%,15.25%,1
屏東縣,屏東市,0028,247,427,674,26,700,1287,54.39%,19.19%,1
屏東縣,屏東市,0029,267,464,731,30,761,1311,58.05%,20.37%,1
屏東縣,屏東市,0030,238,467,705,15,720,1285,56.03%,18.52%,1
屏東縣,屏東市,0031,254,452,706,40,746,1297,57.52%,19.58%,1
屏東縣,屏東市,0032,238,479,717,13,730,1361,53.64%,17.49%,1
屏東縣,屏東市,0033,207,470,677,37,714,1381,51.7%,14.99%,1
屏東縣,屏東市,0034,238,453,691,46,737,1258,58.59%,18.92%,1
屏東縣,屏東市,0035,219,451,670,41,711,1259,56.47%,17.39%,1
屏東縣,屏東市,0036,189,375,564,28,592,1076,55.02%,17.57%,1
屏東縣,屏東市,0037,222,421,643,26,669,1162,57.57%,19.1%,1
屏東縣,屏東市,0038,272,458,730,24,754,1318,57.21%,20.64%,1
屏東縣,屏東市,0039,169,321,490,35,525,939,55.91%,18%,1
屏東縣,屏東市,0040,199,345,544,19,563,972,57.92%,20.47%,1
屏東縣,屏東市,0041,281,586,867,31,898,1535,58.5%,18.31%,1
屏東縣,屏東市,0042,210,446,656,31,687,1419,48.41%,14.8%,1
屏東縣,屏東市,0043,197,470,667,18,685,1398,49%,14.09%,1
屏東縣,屏東市,0044,251,463,714,34,748,1405,53.24%,17.86%,1
屏東縣,屏東市,0045,271,514,785,33,818,1486,55.05%,18.24%,1
屏東縣,屏東市,0046,230,310,540,51,591,1061,55.7%,21.68%,1
屏東縣,屏東市,0047,253,428,681,75,756,1540,49.09%,16.43%,1
屏東縣,屏東市,0048,189,331,520,18,538,1141,47.15%,16.56%,1
屏東縣,屏東市,0049,218,373,591,31,622,1247,49.88%,17.48%,1
屏東縣,屏東市,0050,261,444,705,29,734,1446,50.76%,18.05%,1
屏東縣,屏東市,0051,217,486,703,36,739,1303,56.72%,16.65%,1
屏東縣,屏東市,0052,211,446,657,33,690,1253,55.07%,16.84%,1
屏東縣,屏東市,0053,229,450,679,35,714,1315,54.3%,17.41%,1
屏東縣,屏東市,0054,255,440,695,33,728,1425,51.09%,17.89%,1
屏東縣,屏東市,0055,249,466,715,18,733,1423,51.51%,17.5%,1
屏東縣,屏東市,0056,237,520,757,38,795,1400,56.79%,16.93%,1
屏東縣,屏東市,0057,260,489,749,37,786,1359,57.84%,19.13%,1
屏東縣,屏東市,0058,172,526,698,20,718,1328,54.07%,12.95%,1
屏東縣,屏東市,0059,204,585,789,26,815,1539,52.96%,13.26%,1
屏東縣,屏東市,0060,41,99,140,3,143,391,36.57%,10.49%,1
屏東縣,屏東市,0061,38,67,105,12,117,200,58.5%,19%,1
屏東縣,屏東市,0062,53,90,143,24,167,328,50.91%,16.16%,1
屏東縣,屏東市,0063,32,85,117,4,121,231,52.38%,13.85%,1
屏東縣,屏東市,0064,181,322,503,43,546,945,57.78%,19.15%,1
屏東縣,屏東市,0065,198,310,508,40,548,1053,52.04%,18.8%,1
屏東縣,屏東市,0066,156,330,486,52,538,1043,51.58%,14.96%,1
屏東縣,屏東市,0067,174,327,501,54,555,1061,52.31%,16.4%,1
屏東縣,屏東市,0068,150,264,414,39,453,876,51.71%,17.12%,1
屏東縣,屏東市,0069,186,501,687,89,776,1468,52.86%,12.67%,1
屏東縣,屏東市,0070,218,453,671,52,723,1454,49.72%,14.99%,1
屏東縣,屏東市,0071,235,408,643,21,664,1205,55.1%,19.5%,1
屏東縣,屏東市,0072,221,411,632,29,661,1284,51.48%,17.21%,1
屏東縣,屏東市,0073,180,402,582,33,615,1219,50.45%,14.77%,1
屏東縣,屏東市,0074,259,532,791,82,873,1544,56.54%,16.77%,1
屏東縣,屏東市,0075,233,506,739,70,809,1485,54.48%,15.69%,1
屏東縣,屏東市,0076,241,487,728,39,767,1387,55.3%,17.38%,1
屏東縣,屏東市,0077,157,321,478,18,496,953,52.05%,16.47%,1
屏東縣,屏東市,0078,310,532,842,33,875,1603,54.59%,19.34%,1
屏東縣,屏東市,0079,97,174,271,24,295,535,55.14%,18.13%,1
屏東縣,屏東市,0080,184,371,555,34,589,1119,52.64%,16.44%,1
屏東縣,屏東市,0081,137,303,440,37,477,847,56.32%,16.17%,1
屏東縣,屏東市,0082,191,300,491,59,550,923,59.59%,20.69%,1
屏東縣,屏東市,0083,217,389,606,36,642,1227,52.32%,17.69%,1
屏東縣,屏東市,0084,153,380,533,37,570,1039,54.86%,14.73%,1
屏東縣,屏東市,0085,224,482,706,87,793,1485,53.4%,15.08%,1
屏東縣,屏東市,0086,126,293,419,41,460,867,53.06%,14.53%,1
屏東縣,屏東市,0087,151,337,488,31,519,918,56.54%,16.45%,1
屏東縣,屏東市,0088,103,211,314,30,344,663,51.89%,15.54%,1
屏東縣,屏東市,0089,199,349,548,24,572,1215,47.08%,16.38%,1
屏東縣,屏東市,0090,286,457,743,57,800,1628,49.14%,17.57%,1
屏東縣,屏東市,0091,237,399,636,39,675,1209,55.83%,19.6%,1
屏東縣,屏東市,0092,440,242,682,18,700,1110,63.06%,39.64%,1
屏東縣,屏東市,0093,90,219,309,15,324,684,47.37%,13.16%,1
屏東縣,屏東市,0094,196,383,579,28,607,1349,45%,14.53%,1
屏東縣,屏東市,0095,222,443,665,55,720,1457,49.42%,15.24%,1
屏東縣,屏東市,0096,246,466,712,36,748,1447,51.69%,17%,1
屏東縣,屏東市,0097,254,403,657,23,680,1354,50.22%,18.76%,1
屏東縣,屏東市,0098,275,557,832,52,884,1583,55.84%,17.37%,1
屏東縣,屏東市,0099,249,613,862,24,886,1707,51.9%,14.59%,1
屏東縣,屏東市,0100,234,552,786,18,804,1637,49.11%,14.29%,1
屏東縣,屏東市,0101,205,496,701,34,735,1459,50.38%,14.05%,1
屏東縣,屏東市,0102,277,645,922,27,949,1759,53.95%,15.75%,1
屏東縣,屏東市,0103,294,676,970,32,1002,1950,51.38%,15.08%,1
屏東縣,屏東市,0104,259,643,902,33,935,1729,54.08%,14.98%,1
屏東縣,屏東市,0105,248,534,782,27,809,1592,50.82%,15.58%,1
屏東縣,屏東市,0106,218,481,699,27,726,1437,50.52%,15.17%,1
屏東縣,屏東市,0107,166,428,594,19,613,1204,50.91%,13.79%,1
屏東縣,屏東市,0108,189,517,706,26,732,1340,54.63%,14.1%,1
屏東縣,屏東市,0109,218,465,683,34,717,1322,54.24%,16.49%,1
屏東縣,屏東市,0110,225,494,719,23,742,1462,50.75%,15.39%,1
屏東縣,屏東市,0111,480,1064,1544,40,1584,3241,48.87%,14.81%,1
屏東縣,屏東市,0112,221,491,712,12,724,1477,49.02%,14.96%,1
屏東縣,屏東市,0113,110,276,386,15,401,821,48.84%,13.4%,1
屏東縣,屏東市,0114,246,229,475,22,497,1099,45.22%,22.38%,1
屏東縣,屏東市,0115,629,209,838,36,874,1688,51.78%,37.26%,1
屏東縣,屏東市,0116,192,371,563,33,596,1167,51.07%,16.45%,1
屏東縣,屏東市,0117,148,302,450,40,490,915,53.55%,16.17%,1
屏東縣,屏東市,0118,171,334,505,24,529,1683,31.43%,10.16%,1
屏東縣,屏東市,0119,232,508,740,17,757,1497,50.57%,15.5%,1
屏東縣,屏東市,0120,185,369,554,30,584,1129,51.73%,16.39%,1
屏東縣,屏東市,0121,182,457,639,29,668,1232,54.22%,14.77%,1
屏東縣,屏東市,0122,147,291,438,22,460,853,53.93%,17.23%,1
屏東縣,屏東市,0123,154,333,487,21,508,869,58.46%,17.72%,1
屏東縣,屏東市,0124,196,437,633,37,670,1169,57.31%,16.77%,1
屏東縣,屏東市,0125,175,348,523,70,593,1058,56.05%,16.54%,1
屏東縣,屏東市,0126,217,429,646,23,669,1344,49.78%,16.15%,1
屏東縣,屏東市,0127,280,449,729,23,752,1299,57.89%,21.56%,1
屏東縣,屏東市,0128,202,373,575,38,613,1204,50.91%,16.78%,1
屏東縣,屏東市,0129,190,374,564,30,594,1123,52.89%,16.92%,1
屏東縣,屏東市,0130,203,384,587,31,618,1318,46.89%,15.4%,1
屏東縣,屏東市,0131,179,294,473,43,516,865,59.65%,20.69%,1
屏東縣,屏東市,0132,162,321,483,27,510,1100,46.36%,14.73%,1
屏東縣,屏東市,0133,187,384,571,22,593,1215,48.81%,15.39%,1
屏東縣,屏東市,0134,190,501,691,36,727,1370,53.07%,13.87%,1
屏東縣,屏東市,0135,189,456,645,13,658,1240,53.06%,15.24%,1
屏東縣,屏東市,0136,225,421,646,26,672,1168,57.53%,19.26%,1
屏東縣,屏東市,0137,178,381,559,31,590,1079,54.68%,16.5%,1
屏東縣,屏東市,0138,240,456,696,47,743,1289,57.64%,18.62%,1
屏東縣,屏東市,0139,200,368,568,19,587,1115,52.65%,17.94%,1
屏東縣,屏東市,0140,281,507,788,42,830,1491,55.67%,18.85%,1
屏東縣,屏東市,0141,207,463,670,12,682,1411,48.33%,14.67%,1
屏東縣,屏東市,0142,306,593,899,16,915,1803,50.75%,16.97%,1
屏東縣,屏東市,0143,138,268,406,21,427,744,57.39%,18.55%,1
屏東縣,屏東市,0144,119,228,347,24,371,678,54.72%,17.55%,1
屏東縣,屏東市,0145,126,259,385,15,400,681,58.74%,18.5%,1
屏東縣,屏東市,0146,238,431,669,33,702,1535,45.73%,15.5%,1
屏東縣,屏東市,0147,160,324,484,60,544,954,57.02%,16.77%,1
屏東縣,屏東市,0148,202,371,573,42,615,1018,60.41%,19.84%,1
屏東縣,屏東市,0149,231,404,635,21,656,1154,56.85%,20.02%,1
屏東縣,潮州鎮,0150,96,179,275,30,305,504,60.52%,19.05%,1
屏東縣,潮州鎮,0151,271,504,775,43,818,1711,47.81%,15.84%,1
屏東縣,潮州鎮,0152,259,557,816,21,837,1634,51.22%,15.85%,1
屏東縣,潮州鎮,0153,192,439,631,23,654,1414,46.25%,13.58%,1
屏東縣,潮州鎮,0154,117,220,337,42,379,603,62.85%,19.4%,1
屏東縣,潮州鎮,0155,132,304,436,54,490,896,54.69%,14.73%,1
屏東縣,潮州鎮,0156,206,412,618,52,670,1285,52.14%,16.03%,1
屏東縣,潮州鎮,0157,258,572,830,39,869,1744,49.83%,14.79%,1
屏東縣,潮州鎮,0158,195,382,577,40,617,1071,57.61%,18.21%,1
屏東縣,潮州鎮,0159,204,456,660,53,713,1209,58.97%,16.87%,1
屏東縣,潮州鎮,0160,205,379,584,34,618,1159,53.32%,17.69%,1
屏東縣,潮州鎮,0161,196,445,641,46,687,1296,53.01%,15.12%,1
屏東縣,潮州鎮,0162,224,521,745,38,783,1466,53.41%,15.28%,1
屏東縣,潮州鎮,0163,180,426,606,46,652,1130,57.7%,15.93%,1
屏東縣,潮州鎮,0164,240,488,728,41,769,1439,53.44%,16.68%,1
屏東縣,潮州鎮,0165,134,345,479,46,525,897,58.53%,14.94%,1
屏東縣,潮州鎮,0166,189,475,664,32,696,1225,56.82%,15.43%,1
屏東縣,潮州鎮,0167,195,338,533,52,585,1158,50.52%,16.84%,1
屏東縣,潮州鎮,0168,63,120,183,34,217,481,45.11%,13.1%,1
屏東縣,潮州鎮,0169,177,336,513,36,549,972,56.48%,18.21%,1
屏東縣,潮州鎮,0170,201,476,677,47,724,1245,58.15%,16.14%,1
屏東縣,潮州鎮,0171,162,545,707,45,752,1415,53.14%,11.45%,1
屏東縣,潮州鎮,0172,215,358,573,15,588,1255,46.85%,17.13%,1
屏東縣,潮州鎮,0173,193,209,402,24,426,1058,40.26%,18.24%,1
屏東縣,潮州鎮,0174,190,386,576,36,612,1187,51.56%,16.01%,1
屏東縣,潮州鎮,0175,160,388,548,57,605,1083,55.86%,14.77%,1
屏東縣,潮州鎮,0176,233,495,728,32,760,1590,47.8%,14.65%,1
屏東縣,潮州鎮,0177,232,565,797,49,846,1543,54.83%,15.04%,1
屏東縣,潮州鎮,0178,258,509,767,45,812,1631,49.79%,15.82%,1
屏東縣,潮州鎮,0179,173,433,606,24,630,1159,54.36%,14.93%,1
屏東縣,潮州鎮,0180,190,401,591,26,617,1099,56.14%,17.29%,1
屏東縣,潮州鎮,0181,170,377,547,45,592,1200,49.33%,14.17%,1
屏東縣,潮州鎮,0182,171,475,646,58,704,1391,50.61%,12.29%,1
屏東縣,潮州鎮,0183,144,314,458,46,504,881,57.21%,16.35%,1
屏東縣,潮州鎮,0184,51,139,190,20,210,454,46.26%,11.23%,1
屏東縣,潮州鎮,0185,240,577,817,73,890,1658,53.68%,14.48%,1
屏東縣,潮州鎮,0186,136,234,370,31,401,822,48.78%,16.55%,1
屏東縣,潮州鎮,0187,149,248,397,25,422,948,44.51%,15.72%,1
屏東縣,潮州鎮,0188,145,320,465,32,497,1194,41.62%,12.14%,1
屏東縣,潮州鎮,0189,51,113,164,27,191,337,56.68%,15.13%,1
屏東縣,東港鎮,0190,160,381,541,47,588,981,59.94%,16.31%,1
屏東縣,東港鎮,0191,182,394,576,58,634,1070,59.25%,17.01%,1
屏東縣,東港鎮,0192,90,220,310,36,346,527,65.65%,17.08%,1
屏東縣,東港鎮,0193,72,149,221,19,240,395,60.76%,18.23%,1
屏東縣,東港鎮,0194,99,213,312,26,338,659,51.29%,15.02%,1
屏東縣,東港鎮,0195,79,171,250,25,275,513,53.61%,15.4%,1
屏東縣,東港鎮,0196,271,568,839,51,890,1732,51.39%,15.65%,1
屏東縣,東港鎮,0197,276,631,907,45,952,1779,53.51%,15.51%,1
屏東縣,東港鎮,0198,202,411,613,31,644,1270,50.71%,15.91%,1
屏東縣,東港鎮,0199,199,446,645,52,697,1327,52.52%,15%,1
屏東縣,東港鎮,0200,215,422,637,57,694,1242,55.88%,17.31%,1
屏東縣,東港鎮,0201,266,558,824,61,885,1607,55.07%,16.55%,1
屏東縣,東港鎮,0202,213,384,597,42,639,1305,48.97%,16.32%,1
屏東縣,東港鎮,0203,119,245,364,27,391,695,56.26%,17.12%,1
屏東縣,東港鎮,0204,199,388,587,73,660,1076,61.34%,18.49%,1
屏東縣,東港鎮,0205,40,219,259,31,290,567,51.15%,7.05%,1
屏東縣,東港鎮,0206,129,265,394,33,427,806,52.98%,16%,1
屏東縣,東港鎮,0207,200,427,627,57,684,1227,55.75%,16.3%,1
屏東縣,東港鎮,0208,79,199,278,47,325,599,54.26%,13.19%,1
屏東縣,東港鎮,0209,160,373,533,40,573,1354,42.32%,11.82%,1
屏東縣,東港鎮,0210,101,244,345,46,391,734,53.27%,13.76%,1
屏東縣,東港鎮,0211,184,350,534,101,635,1107,57.36%,16.62%,1
屏東縣,東港鎮,0212,180,353,533,72,605,1198,50.5%,15.03%,1
屏東縣,東港鎮,0213,247,491,738,83,821,1614,50.87%,15.3%,1
屏東縣,東港鎮,0214,118,260,378,45,423,826,51.21%,14.29%,1
屏東縣,東港鎮,0215,148,322,470,50,520,912,57.02%,16.23%,1
屏東縣,東港鎮,0216,62,136,198,30,228,432,52.78%,14.35%,1
屏東縣,東港鎮,0217,183,423,606,84,690,1204,57.31%,15.2%,1
屏東縣,東港鎮,0218,202,465,667,55,722,1304,55.37%,15.49%,1
屏東縣,東港鎮,0219,196,468,664,61,725,1317,55.05%,14.88%,1
屏東縣,東港鎮,0220,202,474,676,33,709,1387,51.12%,14.56%,1
屏東縣,東港鎮,0221,161,412,573,32,605,1310,46.18%,12.29%,1
屏東縣,東港鎮,0222,203,341,544,51,595,1228,48.45%,16.53%,1
屏東縣,東港鎮,0223,113,207,320,53,373,766,48.69%,14.75%,1
屏東縣,東港鎮,0224,157,263,420,61,481,823,58.44%,19.08%,1
屏東縣,東港鎮,0225,80,190,270,19,289,755,38.28%,10.6%,1
屏東縣,東港鎮,0226,186,357,543,83,626,1094,57.22%,17%,1
屏東縣,東港鎮,0227,89,258,347,25,372,753,49.4%,11.82%,1
屏東縣,恆春鎮,0228,108,295,403,37,440,902,48.78%,11.97%,1
屏東縣,恆春鎮,0229,180,338,518,36,554,969,57.17%,18.58%,1
屏東縣,恆春鎮,0230,212,380,592,38,630,1280,49.22%,16.56%,1
屏東縣,恆春鎮,0231,187,395,582,28,610,1133,53.84%,16.5%,1
屏東縣,恆春鎮,0232,219,422,641,15,656,1552,42.27%,14.11%,1
屏東縣,恆春鎮,0233,197,373,570,50,620,1485,41.75%,13.27%,1
屏東縣,恆春鎮,0234,142,306,448,33,481,896,53.68%,15.85%,1
屏東縣,恆春鎮,0235,78,147,225,25,250,531,47.08%,14.69%,1
屏東縣,恆春鎮,0236,72,138,210,11,221,478,46.23%,15.06%,1
屏東縣,恆春鎮,0237,156,289,445,44,489,1020,47.94%,15.29%,1
屏東縣,恆春鎮,0238,159,270,429,17,446,924,48.27%,17.21%,1
屏東縣,恆春鎮,0239,139,305,444,29,473,1079,43.84%,12.88%,1
屏東縣,恆春鎮,0240,88,214,302,16,318,775,41.03%,11.35%,1
屏東縣,恆春鎮,0241,88,322,410,42,452,813,55.6%,10.82%,1
屏東縣,恆春鎮,0242,143,330,473,50,523,1104,47.37%,12.95%,1
屏東縣,恆春鎮,0243,147,303,450,45,495,1110,44.59%,13.24%,1
屏東縣,恆春鎮,0244,93,147,240,57,297,692,42.92%,13.44%,1
屏東縣,恆春鎮,0245,79,172,251,11,262,708,37.01%,11.16%,1
屏東縣,恆春鎮,0246,232,465,697,29,726,1505,48.24%,15.42%,1
屏東縣,恆春鎮,0247,145,329,474,46,520,1111,46.8%,13.05%,1
屏東縣,恆春鎮,0248,195,480,675,40,715,1543,46.34%,12.64%,1
屏東縣,恆春鎮,0249,114,203,317,14,331,828,39.98%,13.77%,1
屏東縣,恆春鎮,0250,137,273,410,34,444,844,52.61%,16.23%,1
屏東縣,恆春鎮,0251,207,367,574,37,611,1253,48.76%,16.52%,1
屏東縣,恆春鎮,0252,151,324,475,38,513,1126,45.56%,13.41%,1
屏東縣,萬丹鄉,0253,193,431,624,45,669,1527,43.81%,12.64%,1
屏東縣,萬丹鄉,0254,178,329,507,60,567,1147,49.43%,15.52%,1
屏東縣,萬丹鄉,0255,143,278,421,43,464,949,48.89%,15.07%,1
屏東縣,萬丹鄉,0256,158,291,449,30,479,990,48.38%,15.96%,1
屏東縣,萬丹鄉,0257,133,351,484,10,494,1022,48.34%,13.01%,1
屏東縣,萬丹鄉,0258,97,223,320,48,368,545,67.52%,17.8%,1
屏東縣,萬丹鄉,0259,170,422,592,91,683,1159,58.93%,14.67%,1
屏東縣,萬丹鄉,0260,150,280,430,60,490,837,58.54%,17.92%,1
屏東縣,萬丹鄉,0261,64,120,184,13,197,392,50.26%,16.33%,1
屏東縣,萬丹鄉,0262,149,303,452,34,486,847,57.38%,17.59%,1
屏東縣,萬丹鄉,0263,166,383,549,38,587,1149,51.09%,14.45%,1
屏東縣,萬丹鄉,0264,182,378,560,47,607,1131,53.67%,16.09%,1
屏東縣,萬丹鄉,0265,184,368,552,58,610,1178,51.78%,15.62%,1
屏東縣,萬丹鄉,0266,131,266,397,28,425,711,59.77%,18.42%,1
屏東縣,萬丹鄉,0267,136,211,347,16,363,595,61.01%,22.86%,1
屏東縣,萬丹鄉,0268,503,248,751,56,807,1403,57.52%,35.85%,1
屏東縣,萬丹鄉,0269,156,362,518,28,546,1094,49.91%,14.26%,1
屏東縣,萬丹鄉,0270,202,415,617,33,650,1158,56.13%,17.44%,1
屏東縣,萬丹鄉,0271,184,353,537,60,597,963,61.99%,19.11%,1
屏東縣,萬丹鄉,0272,172,368,540,42,582,1062,54.8%,16.2%,1
屏東縣,萬丹鄉,0273,264,545,809,83,892,1684,52.97%,15.68%,1
屏東縣,萬丹鄉,0274,293,507,800,26,826,1702,48.53%,17.22%,1
屏東縣,萬丹鄉,0275,173,328,501,36,537,976,55.02%,17.73%,1
屏東縣,萬丹鄉,0276,158,338,496,62,558,1013,55.08%,15.6%,1
屏東縣,萬丹鄉,0277,113,237,350,35,385,847,45.45%,13.34%,1
屏東縣,萬丹鄉,0278,257,530,787,125,912,1570,58.09%,16.37%,1
屏東縣,萬丹鄉,0279,184,440,624,73,697,1411,49.4%,13.04%,1
屏東縣,萬丹鄉,0280,209,309,518,82,600,1046,57.36%,19.98%,1
屏東縣,萬丹鄉,0281,217,435,652,36,688,1385,49.68%,15.67%,1
屏東縣,萬丹鄉,0282,107,298,405,41,446,804,55.47%,13.31%,1
屏東縣,萬丹鄉,0283,216,416,632,68,700,1284,54.52%,16.82%,1
屏東縣,萬丹鄉,0284,206,449,655,51,706,1430,49.37%,14.41%,1
屏東縣,萬丹鄉,0285,186,355,541,59,600,960,62.5%,19.38%,1
屏東縣,萬丹鄉,0286,135,298,433,46,479,786,60.94%,17.18%,1
屏東縣,萬丹鄉,0287,210,361,571,77,648,1158,55.96%,18.13%,1
屏東縣,萬丹鄉,0288,205,454,659,72,731,1647,44.38%,12.45%,1
屏東縣,萬丹鄉,0289,234,480,714,62,776,1666,46.58%,14.05%,1
屏東縣,萬丹鄉,0290,185,381,566,62,628,1023,61.39%,18.08%,1
屏東縣,萬丹鄉,0291,208,460,668,52,720,1227,58.68%,16.95%,1
屏東縣,長治鄉,0292,146,366,512,55,567,1018,55.7%,14.34%,1
屏東縣,長治鄉,0293,274,527,801,80,881,1614,54.58%,16.98%,1
屏東縣,長治鄉,0294,547,451,998,68,1066,1848,57.68%,29.6%,1
屏東縣,長治鄉,0295,258,598,856,68,924,1707,54.13%,15.11%,1
屏東縣,長治鄉,0296,180,353,533,18,551,972,56.69%,18.52%,1
屏東縣,長治鄉,0297,172,360,532,40,572,989,57.84%,17.39%,1
屏東縣,長治鄉,0298,131,278,409,36,445,735,60.54%,17.82%,1
屏東縣,長治鄉,0299,322,518,840,55,895,1813,49.37%,17.76%,1
屏東縣,長治鄉,0300,197,402,599,52,651,1073,60.67%,18.36%,1
屏東縣,長治鄉,0301,264,550,814,69,883,1654,53.39%,15.96%,1
屏東縣,長治鄉,0302,231,406,637,59,696,1205,57.76%,19.17%,1
屏東縣,長治鄉,0303,140,267,407,26,433,758,57.12%,18.47%,1
屏東縣,長治鄉,0304,237,486,723,88,811,1492,54.36%,15.88%,1
屏東縣,長治鄉,0305,129,334,463,48,511,884,57.81%,14.59%,1
屏東縣,長治鄉,0306,169,388,557,66,623,1090,57.16%,15.5%,1
屏東縣,長治鄉,0307,204,407,611,79,690,1422,48.52%,14.35%,1
屏東縣,長治鄉,0308,132,278,410,55,465,845,55.03%,15.62%,1
屏東縣,長治鄉,0309,151,302,453,85,538,925,58.16%,16.32%,1
屏東縣,長治鄉,0310,192,357,549,73,622,1138,54.66%,16.87%,1
屏東縣,長治鄉,0311,199,412,611,88,699,1242,56.28%,16.02%,1
屏東縣,長治鄉,0312,141,369,510,24,534,1159,46.07%,12.17%,1
屏東縣,長治鄉,0313,111,253,364,38,402,673,59.73%,16.49%,1
屏東縣,麟洛鄉,0314,144,270,414,33,447,788,56.73%,18.27%,1
屏東縣,麟洛鄉,0315,256,549,805,27,832,1386,60.03%,18.47%,1
屏東縣,麟洛鄉,0316,184,367,551,37,588,957,61.44%,19.23%,1
屏東縣,麟洛鄉,0317,130,276,406,43,449,731,61.42%,17.78%,1
屏東縣,麟洛鄉,0318,282,173,455,49,504,806,62.53%,34.99%,1
屏東縣,麟洛鄉,0319,208,371,579,19,598,1207,49.54%,17.23%,1
屏東縣,麟洛鄉,0320,267,473,740,74,814,1340,60.75%,19.93%,1
屏東縣,麟洛鄉,0321,270,398,668,53,721,1221,59.05%,22.11%,1
屏東縣,麟洛鄉,0322,164,273,437,17,454,851,53.35%,19.27%,1
屏東縣,麟洛鄉,0323,116,231,347,10,357,683,52.27%,16.98%,1
屏東縣,九如鄉,0324,256,501,757,77,834,1491,55.94%,17.17%,1
屏東縣,九如鄉,0325,235,450,685,55,740,1375,53.82%,17.09%,1
屏東縣,九如鄉,0326,235,547,782,48,830,1678,49.46%,14%,1
屏東縣,九如鄉,0327,195,427,622,63,685,1166,58.75%,16.72%,1
屏東縣,九如鄉,0328,196,333,529,45,574,1276,44.98%,15.36%,1
屏東縣,九如鄉,0329,175,338,513,70,583,1033,56.44%,16.94%,1
屏東縣,九如鄉,0330,109,256,365,32,397,577,68.8%,18.89%,1
屏東縣,九如鄉,0331,110,237,347,52,399,649,61.48%,16.95%,1
屏東縣,九如鄉,0332,218,742,960,133,1093,1999,54.68%,10.91%,1
屏東縣,九如鄉,0333,274,555,829,89,918,1766,51.98%,15.52%,1
屏東縣,九如鄉,0334,269,477,746,89,835,1600,52.19%,16.81%,1
屏東縣,九如鄉,0335,183,409,592,88,680,1248,54.49%,14.66%,1
屏東縣,九如鄉,0336,276,609,885,153,1038,1792,57.92%,15.4%,1
屏東縣,九如鄉,0337,219,516,735,81,816,1482,55.06%,14.78%,1
屏東縣,里港鄉,0338,269,565,834,81,915,1552,58.96%,17.33%,1
屏東縣,里港鄉,0339,263,465,728,60,788,1480,53.24%,17.77%,1
屏東縣,里港鄉,0340,209,428,637,54,691,1534,45.05%,13.62%,1
屏東縣,里港鄉,0341,273,496,769,86,855,1578,54.18%,17.3%,1
屏東縣,里港鄉,0342,215,411,626,46,672,1127,59.63%,19.08%,1
屏東縣,里港鄉,0343,153,300,453,46,499,845,59.05%,18.11%,1
屏東縣,里港鄉,0344,202,415,617,59,676,1282,52.73%,15.76%,1
屏東縣,里港鄉,0345,167,337,504,62,566,981,57.7%,17.02%,1
屏東縣,里港鄉,0346,180,357,537,59,596,1031,57.81%,17.46%,1
屏東縣,里港鄉,0347,182,445,627,73,700,1423,49.19%,12.79%,1
屏東縣,里港鄉,0348,53,92,145,21,166,363,45.73%,14.6%,1
屏東縣,里港鄉,0349,219,377,596,105,701,1203,58.27%,18.2%,1
屏東縣,里港鄉,0350,166,393,559,79,638,1027,62.12%,16.16%,1
屏東縣,里港鄉,0351,223,416,639,58,697,1384,50.36%,16.11%,1
屏東縣,里港鄉,0352,237,464,701,86,787,1512,52.05%,15.67%,1
屏東縣,里港鄉,0353,65,230,295,13,308,522,59%,12.45%,1
屏東縣,里港鄉,0354,121,268,389,68,457,822,55.6%,14.72%,1
屏東縣,里港鄉,0355,158,292,450,79,529,1007,52.53%,15.69%,1
屏東縣,里港鄉,0356,169,303,472,65,537,956,56.17%,17.68%,1
屏東縣,里港鄉,0357,92,172,264,18,282,499,56.51%,18.44%,1
屏東縣,鹽埔鄉,0358,139,331,470,26,496,951,52.16%,14.62%,1
屏東縣,鹽埔鄉,0359,131,293,424,19,443,899,49.28%,14.57%,1
屏東縣,鹽埔鄉,0360,160,313,473,24,497,1116,44.53%,14.34%,1
屏東縣,鹽埔鄉,0361,177,413,590,35,625,1241,50.36%,14.26%,1
屏東縣,鹽埔鄉,0362,119,249,368,35,403,770,52.34%,15.45%,1
屏東縣,鹽埔鄉,0363,165,307,472,39,511,962,53.12%,17.15%,1
屏東縣,鹽埔鄉,0364,177,397,574,57,631,1041,60.61%,17%,1
屏東縣,鹽埔鄉,0365,231,414,645,62,707,1367,51.72%,16.9%,1
屏東縣,鹽埔鄉,0366,178,434,612,67,679,1465,46.35%,12.15%,1
屏東縣,鹽埔鄉,0367,140,243,383,43,426,894,47.65%,15.66%,1
屏東縣,鹽埔鄉,0368,135,278,413,2,415,958,43.32%,14.09%,1
屏東縣,鹽埔鄉,0369,132,293,425,72,497,924,53.79%,14.29%,1
屏東縣,鹽埔鄉,0370,218,483,701,34,735,1598,45.99%,13.64%,1
屏東縣,鹽埔鄉,0371,260,483,743,87,830,1550,53.55%,16.77%,1
屏東縣,鹽埔鄉,0372,179,366,545,60,605,1127,53.68%,15.88%,1
屏東縣,鹽埔鄉,0373,184,419,603,67,670,1150,58.26%,16%,1
屏東縣,鹽埔鄉,0374,211,421,632,43,675,1233,54.74%,17.11%,1
屏東縣,鹽埔鄉,0375,119,404,523,69,592,984,60.16%,12.09%,1
屏東縣,鹽埔鄉,0376,289,550,839,39,878,1619,54.23%,17.85%,1
屏東縣,鹽埔鄉,0377,86,193,279,28,307,553,55.52%,15.55%,1
屏東縣,高樹鄉,0378,176,303,479,72,551,883,62.4%,19.93%,1
屏東縣,高樹鄉,0379,163,284,447,23,470,1255,37.45%,12.99%,1
屏東縣,高樹鄉,0380,201,411,612,33,645,1278,50.47%,15.73%,1
屏東縣,高樹鄉,0381,84,229,313,22,335,738,45.39%,11.38%,1
屏東縣,高樹鄉,0382,91,158,249,16,265,585,45.3%,15.56%,1
屏東縣,高樹鄉,0383,186,300,486,110,596,1012,58.89%,18.38%,1
屏東縣,高樹鄉,0384,179,316,495,78,573,1148,49.91%,15.59%,1
屏東縣,高樹鄉,0385,92,174,266,34,300,591,50.76%,15.57%,1
屏東縣,高樹鄉,0386,117,198,315,47,362,786,46.06%,14.89%,1
屏東縣,高樹鄉,0387,78,184,262,18,280,649,43.14%,12.02%,1
屏東縣,高樹鄉,0388,135,314,449,66,515,1229,41.9%,10.98%,1
屏東縣,高樹鄉,0389,173,406,579,53,632,1446,43.71%,11.96%,1
屏東縣,高樹鄉,0390,159,185,344,15,359,899,39.93%,17.69%,1
屏東縣,高樹鄉,0391,146,284,430,46,476,922,51.63%,15.84%,1
屏東縣,高樹鄉,0392,184,341,525,72,597,1259,47.42%,14.61%,1
屏東縣,高樹鄉,0393,121,270,391,24,415,1056,39.3%,11.46%,1
屏東縣,高樹鄉,0394,156,369,525,72,597,1116,53.49%,13.98%,1
屏東縣,高樹鄉,0395,179,334,513,60,573,1020,56.18%,17.55%,1
屏東縣,高樹鄉,0396,167,325,492,82,574,1055,54.41%,15.83%,1
屏東縣,高樹鄉,0397,136,260,396,45,441,738,59.76%,18.43%,1
屏東縣,高樹鄉,0398,66,141,207,30,237,493,48.07%,13.39%,1
屏東縣,高樹鄉,0399,257,510,767,103,870,1539,56.53%,16.7%,1
屏東縣,萬巒鄉,0400,205,361,566,40,606,1239,48.91%,16.55%,1
屏東縣,萬巒鄉,0401,155,231,386,55,441,759,58.1%,20.42%,1
屏東縣,萬巒鄉,0402,158,313,471,86,557,932,59.76%,16.95%,1
屏東縣,萬巒鄉,0403,155,257,412,52,464,769,60.34%,20.16%,1
屏東縣,萬巒鄉,0404,154,271,425,81,506,920,55%,16.74%,1
屏東縣,萬巒鄉,0405,116,176,292,35,327,560,58.39%,20.71%,1
屏東縣,萬巒鄉,0406,148,336,484,31,515,1120,45.98%,13.21%,1
屏東縣,萬巒鄉,0407,143,341,484,25,509,1048,48.57%,13.65%,1
屏東縣,萬巒鄉,0408,188,404,592,50,642,1438,44.65%,13.07%,1
屏東縣,萬巒鄉,0409,125,227,352,63,415,834,49.76%,14.99%,1
屏東縣,萬巒鄉,0410,116,244,360,65,425,813,52.28%,14.27%,1
屏東縣,萬巒鄉,0411,116,327,443,31,474,1020,46.47%,11.37%,1
屏東縣,萬巒鄉,0412,206,318,524,68,592,1007,58.79%,20.46%,1
屏東縣,萬巒鄉,0413,229,426,655,74,729,1648,44.24%,13.9%,1
屏東縣,萬巒鄉,0414,234,424,658,64,722,1437,50.24%,16.28%,1
屏東縣,萬巒鄉,0415,200,322,522,24,546,1228,44.46%,16.29%,1
屏東縣,萬巒鄉,0416,76,246,322,40,362,597,60.64%,12.73%,1
屏東縣,萬巒鄉,0417,89,193,282,36,318,576,55.21%,15.45%,1
屏東縣,內埔鄉,0418,160,407,567,36,603,1305,46.21%,12.26%,1
屏東縣,內埔鄉,0419,166,409,575,37,612,1287,47.55%,12.9%,1
屏東縣,內埔鄉,0420,198,424,622,19,641,1387,46.21%,14.28%,1
屏東縣,內埔鄉,0421,236,458,694,33,727,1540,47.21%,15.32%,1
屏東縣,內埔鄉,0422,262,475,737,51,788,1605,49.1%,16.32%,1
屏東縣,內埔鄉,0423,198,410,608,57,665,1326,50.15%,14.93%,1
屏東縣,內埔鄉,0424,98,193,291,43,334,591,56.51%,16.58%,1
屏東縣,內埔鄉,0425,174,325,499,40,539,1123,48%,15.49%,1
屏東縣,內埔鄉,0426,149,361,510,14,524,1079,48.56%,13.81%,1
屏東縣,內埔鄉,0427,223,485,708,58,766,1485,51.58%,15.02%,1
屏東縣,內埔鄉,0428,201,472,673,34,707,1248,56.65%,16.11%,1
屏東縣,內埔鄉,0429,278,475,753,44,797,1569,50.8%,17.72%,1
屏東縣,內埔鄉,0430,213,435,648,71,719,1493,48.16%,14.27%,1
屏東縣,內埔鄉,0431,223,421,644,9,653,1420,45.99%,15.7%,1
屏東縣,內埔鄉,0432,186,437,623,70,693,1334,51.95%,13.94%,1
屏東縣,內埔鄉,0433,229,440,669,70,739,1519,48.65%,15.08%,1
屏東縣,內埔鄉,0434,135,248,383,38,421,784,53.7%,17.22%,1
屏東縣,內埔鄉,0435,148,300,448,53,501,888,56.42%,16.67%,1
屏東縣,內埔鄉,0436,98,173,271,18,289,747,38.69%,13.12%,1
屏東縣,內埔鄉,0437,155,302,457,30,487,1168,41.7%,13.27%,1
屏東縣,內埔鄉,0438,104,176,280,32,312,546,57.14%,19.05%,1
屏東縣,內埔鄉,0439,195,394,589,44,633,1278,49.53%,15.26%,1
屏東縣,內埔鄉,0440,193,355,548,48,596,1348,44.21%,14.32%,1
屏東縣,內埔鄉,0441,199,374,573,81,654,1550,42.19%,12.84%,1
屏東縣,內埔鄉,0442,158,356,514,59,573,947,60.51%,16.68%,1
屏東縣,內埔鄉,0443,176,311,487,77,564,1097,51.41%,16.04%,1
屏東縣,內埔鄉,0444,169,251,420,58,478,1128,42.38%,14.98%,1
屏東縣,內埔鄉,0445,141,284,425,19,444,1253,35.43%,11.25%,1
屏東縣,內埔鄉,0446,174,403,577,27,604,1525,39.61%,11.41%,1
屏東縣,內埔鄉,0447,174,397,571,69,640,1215,52.67%,14.32%,1
屏東縣,內埔鄉,0448,136,347,483,30,513,1216,42.19%,11.18%,1
屏東縣,內埔鄉,0449,164,416,580,36,616,1353,45.53%,12.12%,1
屏東縣,內埔鄉,0450,138,344,482,31,513,1026,50%,13.45%,1
屏東縣,內埔鄉,0451,119,252,371,30,401,862,46.52%,13.81%,1
屏東縣,內埔鄉,0452,113,224,337,32,369,921,40.07%,12.27%,1
屏東縣,內埔鄉,0453,139,269,408,18,426,854,49.88%,16.28%,1
屏東縣,內埔鄉,0454,147,355,502,43,545,1230,44.31%,11.95%,1
屏東縣,內埔鄉,0455,141,380,521,16,537,1204,44.6%,11.71%,1
屏東縣,內埔鄉,0456,163,401,564,32,596,1301,45.81%,12.53%,1
屏東縣,內埔鄉,0457,102,309,411,42,453,806,56.2%,12.66%,1
屏東縣,竹田鄉,0458,214,548,762,80,842,1503,56.02%,14.24%,1
屏東縣,竹田鄉,0459,176,336,512,40,552,899,61.4%,19.58%,1
屏東縣,竹田鄉,0460,143,268,411,42,453,716,63.27%,19.97%,1
屏東縣,竹田鄉,0461,133,212,345,38,383,581,65.92%,22.89%,1
屏東縣,竹田鄉,0462,520,126,646,93,739,1327,55.69%,39.19%,1
屏東縣,竹田鄉,0463,182,371,553,69,622,997,62.39%,18.25%,1
屏東縣,竹田鄉,0464,120,202,322,30,352,649,54.24%,18.49%,1
屏東縣,竹田鄉,0465,110,218,328,19,347,476,72.9%,23.11%,1
屏東縣,竹田鄉,0466,461,215,676,63,739,1259,58.7%,36.62%,1
屏東縣,竹田鄉,0467,195,386,581,62,643,1227,52.4%,15.89%,1
屏東縣,竹田鄉,0468,101,190,291,31,322,504,63.89%,20.04%,1
屏東縣,竹田鄉,0469,122,290,412,51,463,860,53.84%,14.19%,1
屏東縣,竹田鄉,0470,136,265,401,23,424,800,53%,17%,1
屏東縣,竹田鄉,0471,190,395,585,71,656,1134,57.85%,16.75%,1
屏東縣,竹田鄉,0472,190,425,615,49,664,1229,54.03%,15.46%,1
屏東縣,竹田鄉,0473,169,409,578,51,629,1192,52.77%,14.18%,1
屏東縣,新埤鄉,0474,263,506,769,42,811,1712,47.37%,15.36%,1
屏東縣,新埤鄉,0475,41,101,142,33,175,314,55.73%,13.06%,1
屏東縣,新埤鄉,0476,129,250,379,28,407,752,54.12%,17.15%,1
屏東縣,新埤鄉,0477,45,116,161,23,184,334,55.09%,13.47%,1
屏東縣,新埤鄉,0478,135,349,484,58,542,957,56.64%,14.11%,1
屏東縣,新埤鄉,0479,133,259,392,59,451,764,59.03%,17.41%,1
屏東縣,新埤鄉,0480,60,132,192,22,214,373,57.37%,16.09%,1
屏東縣,新埤鄉,0481,92,196,288,29,317,678,46.76%,13.57%,1
屏東縣,新埤鄉,0482,99,204,303,26,329,701,46.93%,14.12%,1
屏東縣,新埤鄉,0483,148,326,474,71,545,1323,41.19%,11.19%,1
屏東縣,新埤鄉,0484,85,195,280,32,312,541,57.67%,15.71%,1
屏東縣,新埤鄉,0485,71,178,249,22,271,584,46.4%,12.16%,1
屏東縣,枋寮鄉,0486,191,431,622,59,681,1213,56.14%,15.75%,1
屏東縣,枋寮鄉,0487,147,321,468,51,519,891,58.25%,16.5%,1
屏東縣,枋寮鄉,0488,120,303,423,73,496,970,51.13%,12.37%,1
屏東縣,枋寮鄉,0489,95,212,307,30,337,629,53.58%,15.1%,1
屏東縣,枋寮鄉,0490,165,274,439,47,486,840,57.86%,19.64%,1
屏東縣,枋寮鄉,0491,111,301,412,38,450,774,58.14%,14.34%,1
屏東縣,枋寮鄉,0492,284,370,654,61,715,1379,51.85%,20.59%,1
屏東縣,枋寮鄉,0493,150,523,673,57,730,1502,48.6%,9.99%,1
屏東縣,枋寮鄉,0494,165,329,494,71,565,1276,44.28%,12.93%,1
屏東縣,枋寮鄉,0495,153,305,458,59,517,964,53.63%,15.87%,1
屏東縣,枋寮鄉,0496,158,370,528,83,611,1005,60.8%,15.72%,1
屏東縣,枋寮鄉,0497,96,252,348,21,369,734,50.27%,13.08%,1
屏東縣,枋寮鄉,0498,109,256,365,43,408,725,56.28%,15.03%,1
屏東縣,枋寮鄉,0499,165,309,474,53,527,1046,50.38%,15.77%,1
屏東縣,枋寮鄉,0500,165,371,536,75,611,1067,57.26%,15.46%,1
屏東縣,枋寮鄉,0501,68,157,225,52,277,718,38.58%,9.47%,1
屏東縣,枋寮鄉,0502,114,255,369,49,418,903,46.29%,12.62%,1
屏東縣,枋寮鄉,0503,195,411,606,88,694,1387,50.04%,14.06%,1
屏東縣,枋寮鄉,0504,219,448,667,89,756,1367,55.3%,16.02%,1
屏東縣,枋寮鄉,0505,127,209,336,53,389,618,62.94%,20.55%,1
屏東縣,枋寮鄉,0506,128,229,357,34,391,959,40.77%,13.35%,1
屏東縣,枋寮鄉,0507,71,137,208,28,236,427,55.27%,16.63%,1
屏東縣,新園鄉,0508,154,281,435,37,472,820,57.56%,18.78%,1
屏東縣,新園鄉,0509,165,300,465,43,508,843,60.26%,19.57%,1
屏東縣,新園鄉,0510,195,405,600,43,643,1242,51.77%,15.7%,1
屏東縣,新園鄉,0511,220,469,689,53,742,1290,57.52%,17.05%,1
屏東縣,新園鄉,0512,183,344,527,37,564,1073,52.56%,17.05%,1
屏東縣,新園鄉,0513,168,385,553,92,645,1088,59.28%,15.44%,1
屏東縣,新園鄉,0514,120,261,381,36,417,845,49.35%,14.2%,1
屏東縣,新園鄉,0515,160,262,422,49,471,862,54.64%,18.56%,1
屏東縣,新園鄉,0516,167,346,513,75,588,1183,49.7%,14.12%,1
屏東縣,新園鄉,0517,155,370,525,83,608,1109,54.82%,13.98%,1
屏東縣,新園鄉,0518,163,337,500,12,512,1119,45.76%,14.57%,1
屏東縣,新園鄉,0519,181,356,537,36,573,1152,49.74%,15.71%,1
屏東縣,新園鄉,0520,152,373,525,44,569,1030,55.24%,14.76%,1
屏東縣,新園鄉,0521,177,332,509,79,588,1104,53.26%,16.03%,1
屏東縣,新園鄉,0522,212,299,511,35,546,1240,44.03%,17.1%,1
屏東縣,新園鄉,0523,153,278,431,22,453,1120,40.45%,13.66%,1
屏東縣,新園鄉,0524,182,372,554,70,624,1074,58.1%,16.95%,1
屏東縣,新園鄉,0525,134,228,362,35,397,849,46.76%,15.78%,1
屏東縣,新園鄉,0526,122,240,362,49,411,749,54.87%,16.29%,1
屏東縣,新園鄉,0527,210,429,639,81,720,1416,50.85%,14.83%,1
屏東縣,新園鄉,0528,130,299,429,53,482,895,53.85%,14.53%,1
屏東縣,新園鄉,0529,142,314,456,63,519,933,55.63%,15.22%,1
屏東縣,新園鄉,0530,139,341,480,42,522,972,53.7%,14.3%,1
屏東縣,新園鄉,0531,192,407,599,63,662,1454,45.53%,13.2%,1
屏東縣,新園鄉,0532,229,646,875,90,965,1653,58.38%,13.85%,1
屏東縣,新園鄉,0533,149,422,571,69,640,1270,50.39%,11.73%,1
屏東縣,新園鄉,0534,268,319,587,94,681,1123,60.64%,23.86%,1
屏東縣,新園鄉,0535,165,384,549,74,623,1198,52%,13.77%,1
屏東縣,崁頂鄉,0536,175,365,540,53,593,1190,49.83%,14.71%,1
屏東縣,崁頂鄉,0537,188,346,534,63,597,1044,57.18%,18.01%,1
屏東縣,崁頂鄉,0538,151,252,403,49,452,818,55.26%,18.46%,1
屏東縣,崁頂鄉,0539,174,413,587,43,630,1214,51.89%,14.33%,1
屏東縣,崁頂鄉,0540,191,417,608,26,634,1325,47.85%,14.42%,1
屏東縣,崁頂鄉,0541,232,426,658,51,709,1253,56.58%,18.52%,1
屏東縣,崁頂鄉,0542,186,300,486,43,529,1039,50.91%,17.9%,1
屏東縣,崁頂鄉,0543,118,227,345,47,392,813,48.22%,14.51%,1
屏東縣,崁頂鄉,0544,117,228,345,21,366,736,49.73%,15.9%,1
屏東縣,崁頂鄉,0545,172,309,481,45,526,934,56.32%,18.42%,1
屏東縣,崁頂鄉,0546,147,262,409,64,473,900,52.56%,16.33%,1
屏東縣,崁頂鄉,0547,163,320,483,48,531,1004,52.89%,16.24%,1
屏東縣,林邊鄉,0548,231,539,770,88,858,1458,58.85%,15.84%,1
屏東縣,林邊鄉,0549,156,329,485,44,529,891,59.37%,17.51%,1
屏東縣,林邊鄉,0550,122,268,390,33,423,695,60.86%,17.55%,1
屏東縣,林邊鄉,0551,180,368,548,57,605,1015,59.61%,17.73%,1
屏東縣,林邊鄉,0552,224,406,630,46,676,1171,57.73%,19.13%,1
屏東縣,林邊鄉,0553,157,335,492,48,540,1003,53.84%,15.65%,1
屏東縣,林邊鄉,0554,157,265,422,38,460,725,63.45%,21.66%,1
屏東縣,林邊鄉,0555,158,285,443,56,499,841,59.33%,18.79%,1
屏東縣,林邊鄉,0556,144,288,432,42,474,793,59.77%,18.16%,1
屏東縣,林邊鄉,0557,343,152,495,52,547,919,59.52%,37.32%,1
屏東縣,林邊鄉,0558,207,394,601,65,666,1283,51.91%,16.13%,1
屏東縣,林邊鄉,0559,123,215,338,44,382,783,48.79%,15.71%,1
屏東縣,林邊鄉,0560,127,296,423,49,472,1033,45.69%,12.29%,1
屏東縣,林邊鄉,0561,171,381,552,87,639,1186,53.88%,14.42%,1
屏東縣,林邊鄉,0562,115,249,364,56,420,773,54.33%,14.88%,1
屏東縣,林邊鄉,0563,148,339,487,44,531,1122,47.33%,13.19%,1
屏東縣,南州鄉,0564,128,269,397,62,459,872,52.64%,14.68%,1
屏東縣,南州鄉,0565,142,261,403,35,438,794,55.16%,17.88%,1
屏東縣,南州鄉,0566,178,332,510,48,558,962,58%,18.5%,1
屏東縣,南州鄉,0567,193,324,517,64,581,1033,56.24%,18.68%,1
屏東縣,南州鄉,0568,178,286,464,52,516,1007,51.24%,17.68%,1
屏東縣,南州鄉,0569,81,173,254,23,277,466,59.44%,17.38%,1
屏東縣,南州鄉,0570,128,254,382,25,407,708,57.49%,18.08%,1
屏東縣,南州鄉,0571,168,348,516,75,591,1044,56.61%,16.09%,1
屏東縣,南州鄉,0572,160,257,417,34,451,1071,42.11%,14.94%,1
屏東縣,南州鄉,0573,183,245,428,34,462,979,47.19%,18.69%,1
屏東縣,南州鄉,0574,79,172,251,24,275,543,50.64%,14.55%,1
屏東縣,佳冬鄉,0575,231,380,611,76,687,1472,46.67%,15.69%,1
屏東縣,佳冬鄉,0576,169,365,534,67,601,1360,44.19%,12.43%,1
屏東縣,佳冬鄉,0577,130,263,393,72,465,804,57.84%,16.17%,1
屏東縣,佳冬鄉,0578,156,264,420,64,484,925,52.32%,16.86%,1
屏東縣,佳冬鄉,0579,123,245,368,17,385,855,45.03%,14.39%,1
屏東縣,佳冬鄉,0580,155,265,420,59,479,981,48.83%,15.8%,1
屏東縣,佳冬鄉,0581,172,273,445,53,498,1007,49.45%,17.08%,1
屏東縣,佳冬鄉,0582,134,233,367,53,420,872,48.17%,15.37%,1
屏東縣,佳冬鄉,0583,178,321,499,79,578,1255,46.06%,14.18%,1
屏東縣,佳冬鄉,0584,146,295,441,106,547,995,54.97%,14.67%,1
屏東縣,佳冬鄉,0585,83,185,268,25,293,734,39.92%,11.31%,1
屏東縣,佳冬鄉,0586,160,314,474,35,509,1178,43.21%,13.58%,1
屏東縣,佳冬鄉,0587,191,275,466,59,525,1095,47.95%,17.44%,1
屏東縣,佳冬鄉,0588,144,398,542,101,643,1097,58.61%,13.13%,1
屏東縣,佳冬鄉,0589,171,424,595,63,658,1273,51.69%,13.43%,1
屏東縣,佳冬鄉,0590,177,418,595,59,654,1160,56.38%,15.26%,1
屏東縣,琉球鄉,0591,130,313,443,23,466,1111,41.94%,11.7%,1
屏東縣,琉球鄉,0592,96,301,397,36,433,972,44.55%,9.88%,1
屏東縣,琉球鄉,0593,142,497,639,41,680,1278,53.21%,11.11%,1
屏東縣,琉球鄉,0594,109,342,451,44,495,976,50.72%,11.17%,1
屏東縣,琉球鄉,0595,157,572,729,58,787,1658,47.47%,9.47%,1
屏東縣,琉球鄉,0596,117,292,409,32,441,1146,38.48%,10.21%,1
屏東縣,琉球鄉,0597,40,349,389,31,420,1079,38.92%,3.71%,1
屏東縣,琉球鄉,0598,128,436,564,25,589,1613,36.52%,7.94%,1
屏東縣,琉球鄉,0599,122,285,407,37,444,873,50.86%,13.97%,1
屏東縣,車城鄉,0600,109,162,271,38,309,737,41.93%,14.79%,1
屏東縣,車城鄉,0601,78,132,210,31,241,647,37.25%,12.06%,1
屏東縣,車城鄉,0602,85,120,205,20,225,491,45.82%,17.31%,1
屏東縣,車城鄉,0603,116,263,379,27,406,856,47.43%,13.55%,1
屏東縣,車城鄉,0604,81,143,224,8,232,554,41.88%,14.62%,1
屏東縣,車城鄉,0605,48,93,141,2,143,388,36.86%,12.37%,1
屏東縣,車城鄉,0606,136,204,340,44,384,922,41.65%,14.75%,1
屏東縣,車城鄉,0607,78,107,185,11,196,597,32.83%,13.07%,1
屏東縣,車城鄉,0608,60,132,192,10,202,623,32.42%,9.63%,1
屏東縣,車城鄉,0609,62,109,171,24,195,425,45.88%,14.59%,1
屏東縣,車城鄉,0610,50,148,198,21,219,428,51.17%,11.68%,1
屏東縣,車城鄉,0611,56,109,165,7,172,504,34.13%,11.11%,1
屏東縣,車城鄉,0612,61,122,183,26,209,423,49.41%,14.42%,1
屏東縣,滿州鄉,0613,270,419,689,40,729,1575,46.29%,17.14%,1
屏東縣,滿州鄉,0614,65,122,187,10,197,420,46.9%,15.48%,1
屏東縣,滿州鄉,0615,83,241,324,26,350,602,58.14%,13.79%,1
屏東縣,滿州鄉,0616,130,349,479,25,504,1302,38.71%,9.98%,1
屏東縣,滿州鄉,0617,197,359,556,48,604,1314,45.97%,14.99%,1
屏東縣,滿州鄉,0618,130,243,373,19,392,1308,29.97%,9.94%,1
屏東縣,滿州鄉,0619,53,72,125,14,139,367,37.87%,14.44%,1
屏東縣,滿州鄉,0620,43,108,151,15,166,318,52.2%,13.52%,1
屏東縣,枋山鄉,0621,101,231,332,34,366,604,60.6%,16.72%,1
屏東縣,枋山鄉,0622,62,172,234,26,260,428,60.75%,14.49%,1
屏東縣,枋山鄉,0623,166,358,524,49,573,928,61.75%,17.89%,1
屏東縣,枋山鄉,0624,134,334,468,20,488,972,50.21%,13.79%,1
屏東縣,枋山鄉,0625,136,276,412,68,480,1041,46.11%,13.06%,1
屏東縣,枋山鄉,0626,108,192,300,23,323,883,36.58%,12.23%,1
屏東縣,三地門鄉,0627,59,232,291,17,308,616,50%,9.58%,1
屏東縣,三地門鄉,0628,78,206,284,70,354,572,61.89%,13.64%,1
屏東縣,三地門鄉,0629,34,116,150,12,162,323,50.15%,10.53%,1
屏東縣,三地門鄉,0630,282,554,836,53,889,1448,61.4%,19.48%,1
屏東縣,三地門鄉,0631,71,177,248,9,257,726,35.4%,9.78%,1
屏東縣,三地門鄉,0632,84,183,267,27,294,554,53.07%,15.16%,1
屏東縣,三地門鄉,0633,67,135,202,12,214,346,61.85%,19.36%,1
屏東縣,三地門鄉,0634,56,178,234,4,238,458,51.97%,12.23%,1
屏東縣,三地門鄉,0635,126,283,409,18,427,692,61.71%,18.21%,1
屏東縣,三地門鄉,0636,128,317,445,27,472,638,73.98%,20.06%,1
屏東縣,霧臺鄉,0637,65,180,245,23,268,346,77.46%,18.79%,1
屏東縣,霧臺鄉,0638,92,286,378,10,388,677,57.31%,13.59%,1
屏東縣,霧臺鄉,0639,18,41,59,0,59,162,36.42%,11.11%,1
屏東縣,霧臺鄉,0640,21,71,92,5,97,189,51.32%,11.11%,1
屏東縣,霧臺鄉,0641,40,142,182,29,211,296,71.28%,13.51%,1
屏東縣,霧臺鄉,0642,78,236,314,13,327,483,67.7%,16.15%,1
屏東縣,霧臺鄉,0643,50,146,196,5,201,347,57.93%,14.41%,1
屏東縣,霧臺鄉,0644,69,166,235,23,258,450,57.33%,15.33%,1
屏東縣,瑪家鄉,0645,78,165,243,3,246,455,54.07%,17.14%,1
屏東縣,瑪家鄉,0646,143,370,513,32,545,821,66.38%,17.42%,1
屏東縣,瑪家鄉,0647,121,298,419,46,465,635,73.23%,19.06%,1
屏東縣,瑪家鄉,0648,99,401,500,23,523,695,75.25%,14.24%,1
屏東縣,瑪家鄉,0649,112,321,433,21,454,671,67.66%,16.69%,1
屏東縣,瑪家鄉,0650,144,398,542,25,567,1057,53.64%,13.62%,1
屏東縣,瑪家鄉,0651,133,370,503,21,524,900,58.22%,14.78%,1
屏東縣,瑪家鄉,0652,50,182,232,7,239,429,55.71%,11.66%,1
屏東縣,泰武鄉,0653,134,252,386,16,402,669,60.09%,20.03%,1
屏東縣,泰武鄉,0654,25,71,96,6,102,190,53.68%,13.16%,1
屏東縣,泰武鄉,0655,162,394,556,51,607,922,65.84%,17.57%,1
屏東縣,泰武鄉,0656,109,307,416,36,452,598,75.59%,18.23%,1
屏東縣,泰武鄉,0657,107,361,468,35,503,771,65.24%,13.88%,1
屏東縣,泰武鄉,0658,51,225,276,27,303,414,73.19%,12.32%,1
屏東縣,泰武鄉,0659,111,305,416,24,440,780,56.41%,14.23%,1
屏東縣,來義鄉,0660,107,427,534,80,614,917,66.96%,11.67%,1
屏東縣,來義鄉,0661,60,143,203,8,211,361,58.45%,16.62%,1
屏東縣,來義鄉,0662,23,96,119,2,121,216,56.02%,10.65%,1
屏東縣,來義鄉,0663,59,252,311,25,336,445,75.51%,13.26%,1
屏東縣,來義鄉,0664,31,141,172,10,182,280,65%,11.07%,1
屏東縣,來義鄉,0665,117,482,599,49,648,1097,59.07%,10.67%,1
屏東縣,來義鄉,0666,101,432,533,31,564,840,67.14%,12.02%,1
屏東縣,來義鄉,0667,134,307,441,21,462,889,51.97%,15.07%,1
屏東縣,來義鄉,0668,190,359,549,45,594,1212,49.01%,15.68%,1
屏東縣,春日鄉,0669,99,185,284,4,288,909,31.68%,10.89%,1
屏東縣,春日鄉,0670,96,139,235,12,247,663,37.25%,14.48%,1
屏東縣,春日鄉,0671,20,62,82,3,85,304,27.96%,6.58%,1
屏東縣,春日鄉,0672,110,277,387,14,401,928,43.21%,11.85%,1
屏東縣,春日鄉,0673,62,123,185,8,193,641,30.11%,9.67%,1
屏東縣,春日鄉,0674,53,91,144,2,146,478,30.54%,11.09%,1
屏東縣,獅子鄉,0675,74,306,380,9,389,751,51.8%,9.85%,1
屏東縣,獅子鄉,0676,107,317,424,27,451,776,58.12%,13.79%,1
屏東縣,獅子鄉,0677,62,259,321,6,327,711,45.99%,8.72%,1
屏東縣,獅子鄉,0678,45,118,163,25,188,243,77.37%,18.52%,1
屏東縣,獅子鄉,0679,50,139,189,6,195,325,60%,15.38%,1
屏東縣,獅子鄉,0680,63,129,192,4,196,476,41.18%,13.24%,1
屏東縣,獅子鄉,0681,81,272,353,10,363,602,60.3%,13.46%,1
屏東縣,獅子鄉,0682,43,115,158,6,164,346,47.4%,12.43%,1
屏東縣,牡丹鄉,0683,40,99,139,4,143,342,41.81%,11.7%,1
屏東縣,牡丹鄉,0684,210,407,617,46,663,1306,50.77%,16.08%,1
屏東縣,牡丹鄉,0685,59,108,167,5,172,693,24.82%,8.51%,1
屏東縣,牡丹鄉,0686,45,121,166,10,176,437,40.27%,10.3%,1
屏東縣,牡丹鄉,0687,57,134,191,5,196,392,50%,14.54%,1
屏東縣,牡丹鄉,0688,119,179,298,9,307,593,51.77%,20.07%,1
屏東縣,牡丹鄉,0689,40,89,129,5,134,551,24.32%,7.26%,1
宜蘭縣,宜蘭市,0001,165,352,517,17,534,982,54.38%,16.8%,1
宜蘭縣,宜蘭市,0002,216,438,654,47,701,1270,55.2%,17.01%,1
宜蘭縣,宜蘭市,0003,180,278,458,14,472,849,55.59%,21.2%,1
宜蘭縣,宜蘭市,0004,150,269,419,20,439,756,58.07%,19.84%,1
宜蘭縣,宜蘭市,0005,162,363,525,38,563,1107,50.86%,14.63%,1
宜蘭縣,宜蘭市,0006,147,308,455,42,497,893,55.66%,16.46%,1
宜蘭縣,宜蘭市,0007,177,301,478,32,510,912,55.92%,19.41%,1
宜蘭縣,宜蘭市,0008,253,459,712,40,752,1335,56.33%,18.95%,1
宜蘭縣,宜蘭市,0009,108,236,344,23,367,686,53.5%,15.74%,1
宜蘭縣,宜蘭市,0010,307,493,800,26,826,1366,60.47%,22.47%,1
宜蘭縣,宜蘭市,0011,317,441,758,18,776,1363,56.93%,23.26%,1
宜蘭縣,宜蘭市,0012,312,541,853,36,889,1540,57.73%,20.26%,1
宜蘭縣,宜蘭市,0013,264,477,741,13,754,1341,56.23%,19.69%,1
宜蘭縣,宜蘭市,0014,224,421,645,42,687,1209,56.82%,18.53%,1
宜蘭縣,宜蘭市,0015,179,300,479,34,513,900,57%,19.89%,1
宜蘭縣,宜蘭市,0016,164,320,484,28,512,980,52.24%,16.73%,1
宜蘭縣,宜蘭市,0017,243,381,624,27,651,1165,55.88%,20.86%,1
宜蘭縣,宜蘭市,0018,144,331,475,28,503,904,55.64%,15.93%,1
宜蘭縣,宜蘭市,0019,153,292,445,21,466,813,57.32%,18.82%,1
宜蘭縣,宜蘭市,0020,196,315,511,32,543,978,55.52%,20.04%,1
宜蘭縣,宜蘭市,0021,186,366,552,31,583,1282,45.48%,14.51%,1
宜蘭縣,宜蘭市,0022,92,175,267,10,277,465,59.57%,19.78%,1
宜蘭縣,宜蘭市,0023,121,245,366,32,398,669,59.49%,18.09%,1
宜蘭縣,宜蘭市,0024,170,334,504,23,527,923,57.1%,18.42%,1
宜蘭縣,宜蘭市,0025,181,333,514,25,539,1006,53.58%,17.99%,1
宜蘭縣,宜蘭市,0026,156,298,454,46,500,762,65.62%,20.47%,1
宜蘭縣,宜蘭市,0027,141,290,431,35,466,727,64.1%,19.39%,1
宜蘭縣,宜蘭市,0028,169,340,509,50,559,833,67.11%,20.29%,1
宜蘭縣,宜蘭市,0029,217,399,616,31,647,1143,56.61%,18.99%,1
宜蘭縣,宜蘭市,0030,196,330,526,16,542,979,55.36%,20.02%,1
宜蘭縣,宜蘭市,0031,209,418,627,55,682,1214,56.18%,17.22%,1
宜蘭縣,宜蘭市,0032,246,435,681,58,739,1283,57.6%,19.17%,1
宜蘭縣,宜蘭市,0033,183,343,526,25,551,946,58.25%,19.34%,1
宜蘭縣,宜蘭市,0034,183,371,554,31,585,1090,53.67%,16.79%,1
宜蘭縣,宜蘭市,0035,214,323,537,24,561,943,59.49%,22.69%,1
宜蘭縣,宜蘭市,0036,224,249,473,25,498,774,64.34%,28.94%,1
宜蘭縣,宜蘭市,0037,201,359,560,31,591,968,61.05%,20.76%,1
宜蘭縣,宜蘭市,0038,210,335,545,27,572,926,61.77%,22.68%,1
宜蘭縣,宜蘭市,0039,224,354,578,34,612,1019,60.06%,21.98%,1
宜蘭縣,宜蘭市,0040,193,377,570,48,618,1084,57.01%,17.8%,1
宜蘭縣,宜蘭市,0041,208,360,568,28,596,1095,54.43%,19%,1
宜蘭縣,宜蘭市,0042,227,368,595,27,622,1083,57.43%,20.96%,1
宜蘭縣,宜蘭市,0043,196,360,556,36,592,1108,53.43%,17.69%,1
宜蘭縣,宜蘭市,0044,178,303,481,12,493,848,58.14%,20.99%,1
宜蘭縣,宜蘭市,0045,204,375,579,25,604,1095,55.16%,18.63%,1
宜蘭縣,宜蘭市,0046,220,382,602,26,628,1110,56.58%,19.82%,1
宜蘭縣,宜蘭市,0047,224,391,615,31,646,1104,58.51%,20.29%,1
宜蘭縣,宜蘭市,0048,212,404,616,32,648,1134,57.14%,18.69%,1
宜蘭縣,宜蘭市,0049,209,424,633,28,661,1146,57.68%,18.24%,1
宜蘭縣,宜蘭市,0050,173,316,489,44,533,876,60.84%,19.75%,1
宜蘭縣,宜蘭市,0051,152,317,469,38,507,905,56.02%,16.8%,1
宜蘭縣,宜蘭市,0052,173,327,500,34,534,910,58.68%,19.01%,1
宜蘭縣,宜蘭市,0053,233,431,664,39,703,1434,49.02%,16.25%,1
宜蘭縣,宜蘭市,0054,209,374,583,54,637,1152,55.3%,18.14%,1
宜蘭縣,宜蘭市,0055,211,334,545,33,578,966,59.83%,21.84%,1
宜蘭縣,宜蘭市,0056,160,230,390,27,417,711,58.65%,22.5%,1
宜蘭縣,宜蘭市,0057,185,315,500,36,536,884,60.63%,20.93%,1
宜蘭縣,宜蘭市,0058,251,475,726,39,765,1326,57.69%,18.93%,1
宜蘭縣,宜蘭市,0059,165,288,453,21,474,909,52.15%,18.15%,1
宜蘭縣,宜蘭市,0060,161,300,461,30,491,894,54.92%,18.01%,1
宜蘭縣,宜蘭市,0061,212,396,608,31,639,1259,50.75%,16.84%,1
宜蘭縣,宜蘭市,0062,126,269,395,22,417,789,52.85%,15.97%,1
宜蘭縣,宜蘭市,0063,154,300,454,31,485,867,55.94%,17.76%,1
宜蘭縣,宜蘭市,0064,249,482,731,77,808,1454,55.57%,17.13%,1
宜蘭縣,宜蘭市,0065,188,479,667,25,692,1130,61.24%,16.64%,1
宜蘭縣,宜蘭市,0066,157,345,502,16,518,1087,47.65%,14.44%,1
宜蘭縣,宜蘭市,0067,173,350,523,55,578,938,61.62%,18.44%,1
宜蘭縣,宜蘭市,0068,237,450,687,37,724,1285,56.34%,18.44%,1
宜蘭縣,宜蘭市,0069,184,299,483,26,509,952,53.47%,19.33%,1
宜蘭縣,宜蘭市,0070,180,344,524,48,572,948,60.34%,18.99%,1
宜蘭縣,宜蘭市,0071,202,367,569,42,611,1160,52.67%,17.41%,1
宜蘭縣,宜蘭市,0072,175,376,551,51,602,1015,59.31%,17.24%,1
宜蘭縣,宜蘭市,0073,91,158,249,12,261,424,61.56%,21.46%,1
宜蘭縣,宜蘭市,0074,196,337,533,36,569,964,59.02%,20.33%,1
宜蘭縣,宜蘭市,0075,170,305,475,40,515,959,53.7%,17.73%,1
宜蘭縣,宜蘭市,0076,165,320,485,35,520,814,63.88%,20.27%,1
宜蘭縣,宜蘭市,0077,143,352,495,31,526,885,59.44%,16.16%,1
宜蘭縣,宜蘭市,0078,267,411,678,59,737,1162,63.43%,22.98%,1
宜蘭縣,羅東鎮,0079,153,226,379,29,408,689,59.22%,22.21%,1
宜蘭縣,羅東鎮,0080,133,247,380,19,399,718,55.57%,18.52%,1
宜蘭縣,羅東鎮,0081,284,477,761,62,823,1475,55.8%,19.25%,1
宜蘭縣,羅東鎮,0082,283,448,731,66,797,1466,54.37%,19.3%,1
宜蘭縣,羅東鎮,0083,215,363,578,28,606,1075,56.37%,20%,1
宜蘭縣,羅東鎮,0084,183,322,505,32,537,963,55.76%,19%,1
宜蘭縣,羅東鎮,0085,270,471,741,74,815,1511,53.94%,17.87%,1
宜蘭縣,羅東鎮,0086,235,373,608,28,636,1166,54.55%,20.15%,1
宜蘭縣,羅東鎮,0087,262,329,591,48,639,1273,50.2%,20.58%,1
宜蘭縣,羅東鎮,0088,314,571,885,30,915,1735,52.74%,18.1%,1
宜蘭縣,羅東鎮,0089,281,530,811,37,848,1487,57.03%,18.9%,1
宜蘭縣,羅東鎮,0090,185,286,471,33,504,837,60.22%,22.1%,1
宜蘭縣,羅東鎮,0091,265,464,729,57,786,1312,59.91%,20.2%,1
宜蘭縣,羅東鎮,0092,284,467,751,46,797,1502,53.06%,18.91%,1
宜蘭縣,羅東鎮,0093,225,358,583,21,604,1138,53.08%,19.77%,1
宜蘭縣,羅東鎮,0094,184,339,523,37,560,1010,55.45%,18.22%,1
宜蘭縣,羅東鎮,0095,241,470,711,82,793,1373,57.76%,17.55%,1
宜蘭縣,羅東鎮,0096,202,377,579,34,613,1089,56.29%,18.55%,1
宜蘭縣,羅東鎮,0097,207,461,668,42,710,1304,54.45%,15.87%,1
宜蘭縣,羅東鎮,0098,237,395,632,63,695,1288,53.96%,18.4%,1
宜蘭縣,羅東鎮,0099,220,375,595,46,641,1036,61.87%,21.24%,1
宜蘭縣,羅東鎮,0100,179,402,581,37,618,969,63.78%,18.47%,1
宜蘭縣,羅東鎮,0101,200,346,546,46,592,985,60.1%,20.3%,1
宜蘭縣,羅東鎮,0102,266,496,762,69,831,1420,58.52%,18.73%,1
宜蘭縣,羅東鎮,0103,270,506,776,43,819,1430,57.27%,18.88%,1
宜蘭縣,羅東鎮,0104,214,372,586,47,633,1075,58.88%,19.91%,1
宜蘭縣,羅東鎮,0105,182,308,490,40,530,879,60.3%,20.71%,1
宜蘭縣,羅東鎮,0106,173,282,455,20,475,850,55.88%,20.35%,1
宜蘭縣,羅東鎮,0107,258,378,636,29,665,1111,59.86%,23.22%,1
宜蘭縣,羅東鎮,0108,230,444,674,40,714,1139,62.69%,20.19%,1
宜蘭縣,羅東鎮,0109,254,410,664,33,697,1130,61.68%,22.48%,1
宜蘭縣,羅東鎮,0110,198,357,555,25,580,980,59.18%,20.2%,1
宜蘭縣,羅東鎮,0111,292,478,770,35,805,1431,56.25%,20.41%,1
宜蘭縣,羅東鎮,0112,226,372,598,35,633,1109,57.08%,20.38%,1
宜蘭縣,羅東鎮,0113,206,377,583,27,610,1083,56.33%,19.02%,1
宜蘭縣,羅東鎮,0114,261,511,772,41,813,1404,57.91%,18.59%,1
宜蘭縣,羅東鎮,0115,264,442,706,36,742,1288,57.61%,20.5%,1
宜蘭縣,羅東鎮,0116,182,319,501,45,546,1183,46.15%,15.38%,1
宜蘭縣,羅東鎮,0117,208,420,628,31,659,1105,59.64%,18.82%,1
宜蘭縣,羅東鎮,0118,209,360,569,35,604,987,61.2%,21.18%,1
宜蘭縣,羅東鎮,0119,158,282,440,34,474,773,61.32%,20.44%,1
宜蘭縣,羅東鎮,0120,302,525,827,38,865,1366,63.32%,22.11%,1
宜蘭縣,羅東鎮,0121,208,356,564,21,585,907,64.5%,22.93%,1
宜蘭縣,羅東鎮,0122,241,447,688,31,719,1158,62.09%,20.81%,1
宜蘭縣,羅東鎮,0123,204,307,511,58,569,977,58.24%,20.88%,1
宜蘭縣,羅東鎮,0124,180,302,482,49,531,972,54.63%,18.52%,1
宜蘭縣,羅東鎮,0125,195,353,548,33,581,977,59.47%,19.96%,1
宜蘭縣,羅東鎮,0126,267,509,776,50,826,1398,59.08%,19.1%,1
宜蘭縣,羅東鎮,0127,195,352,547,28,575,1022,56.26%,19.08%,1
宜蘭縣,羅東鎮,0128,227,435,662,32,694,1131,61.36%,20.07%,1
宜蘭縣,蘇澳鎮,0129,217,403,620,54,674,1194,56.45%,18.17%,1
宜蘭縣,蘇澳鎮,0130,189,391,580,30,610,1128,54.08%,16.76%,1
宜蘭縣,蘇澳鎮,0131,238,360,598,45,643,1042,61.71%,22.84%,1
宜蘭縣,蘇澳鎮,0132,217,335,552,35,587,997,58.88%,21.77%,1
宜蘭縣,蘇澳鎮,0133,268,413,681,56,737,1303,56.56%,20.57%,1
宜蘭縣,蘇澳鎮,0134,265,422,687,58,745,1260,59.13%,21.03%,1
宜蘭縣,蘇澳鎮,0135,203,385,588,63,651,1130,57.61%,17.96%,1
宜蘭縣,蘇澳鎮,0136,98,177,275,41,316,559,56.53%,17.53%,1
宜蘭縣,蘇澳鎮,0137,62,101,163,24,187,351,53.28%,17.66%,1
宜蘭縣,蘇澳鎮,0138,161,278,439,56,495,889,55.68%,18.11%,1
宜蘭縣,蘇澳鎮,0139,69,147,216,25,241,434,55.53%,15.9%,1
宜蘭縣,蘇澳鎮,0140,174,307,481,29,510,835,61.08%,20.84%,1
宜蘭縣,蘇澳鎮,0141,194,324,518,41,559,975,57.33%,19.9%,1
宜蘭縣,蘇澳鎮,0142,225,377,602,73,675,1135,59.47%,19.82%,1
宜蘭縣,蘇澳鎮,0143,198,282,480,34,514,788,65.23%,25.13%,1
宜蘭縣,蘇澳鎮,0144,79,162,241,21,262,469,55.86%,16.84%,1
宜蘭縣,蘇澳鎮,0145,126,279,405,33,438,811,54.01%,15.54%,1
宜蘭縣,蘇澳鎮,0146,128,323,451,22,473,867,54.56%,14.76%,1
宜蘭縣,蘇澳鎮,0147,198,411,609,33,642,1139,56.37%,17.38%,1
宜蘭縣,蘇澳鎮,0148,174,378,552,50,602,1146,52.53%,15.18%,1
宜蘭縣,蘇澳鎮,0149,193,412,605,49,654,1154,56.67%,16.72%,1
宜蘭縣,蘇澳鎮,0150,158,283,441,18,459,908,50.55%,17.4%,1
宜蘭縣,蘇澳鎮,0151,97,245,342,21,363,656,55.34%,14.79%,1
宜蘭縣,蘇澳鎮,0152,152,324,476,45,521,834,62.47%,18.23%,1
宜蘭縣,蘇澳鎮,0153,196,381,577,37,614,1025,59.9%,19.12%,1
宜蘭縣,蘇澳鎮,0154,89,163,252,12,264,455,58.02%,19.56%,1
宜蘭縣,蘇澳鎮,0155,112,172,284,29,313,535,58.5%,20.93%,1
宜蘭縣,蘇澳鎮,0156,105,219,324,20,344,536,64.18%,19.59%,1
宜蘭縣,蘇澳鎮,0157,82,174,256,19,275,451,60.98%,18.18%,1
宜蘭縣,蘇澳鎮,0158,101,193,294,38,332,593,55.99%,17.03%,1
宜蘭縣,蘇澳鎮,0159,73,162,235,21,256,441,58.05%,16.55%,1
宜蘭縣,蘇澳鎮,0160,169,338,507,44,551,954,57.76%,17.71%,1
宜蘭縣,蘇澳鎮,0161,153,316,469,49,518,952,54.41%,16.07%,1
宜蘭縣,蘇澳鎮,0162,162,357,519,72,591,1125,52.53%,14.4%,1
宜蘭縣,蘇澳鎮,0163,114,256,370,63,433,763,56.75%,14.94%,1
宜蘭縣,蘇澳鎮,0164,89,200,289,31,320,706,45.33%,12.61%,1
宜蘭縣,蘇澳鎮,0165,146,305,451,62,513,1068,48.03%,13.67%,1
宜蘭縣,蘇澳鎮,0166,119,220,339,49,388,666,58.26%,17.87%,1
宜蘭縣,蘇澳鎮,0167,88,184,272,58,330,574,57.49%,15.33%,1
宜蘭縣,蘇澳鎮,0168,54,88,142,9,151,351,43.02%,15.38%,1
宜蘭縣,蘇澳鎮,0169,117,238,355,50,405,717,56.49%,16.32%,1
宜蘭縣,蘇澳鎮,0170,37,106,143,13,156,373,41.82%,9.92%,1
宜蘭縣,蘇澳鎮,0171,41,43,84,10,94,223,42.15%,18.39%,1
宜蘭縣,頭城鎮,0172,28,65,93,12,105,292,35.96%,9.59%,1
宜蘭縣,頭城鎮,0173,111,223,334,38,372,688,54.07%,16.13%,1
宜蘭縣,頭城鎮,0174,101,253,354,42,396,688,57.56%,14.68%,1
宜蘭縣,頭城鎮,0175,130,271,401,48,449,879,51.08%,14.79%,1
宜蘭縣,頭城鎮,0176,59,121,180,24,204,335,60.9%,17.61%,1
宜蘭縣,頭城鎮,0177,107,245,352,41,393,624,62.98%,17.15%,1
宜蘭縣,頭城鎮,0178,109,207,316,27,343,732,46.86%,14.89%,1
宜蘭縣,頭城鎮,0179,149,234,383,35,418,892,46.86%,16.7%,1
宜蘭縣,頭城鎮,0180,110,166,276,37,313,690,45.36%,15.94%,1
宜蘭縣,頭城鎮,0181,141,282,423,29,452,842,53.68%,16.75%,1
宜蘭縣,頭城鎮,0182,145,232,377,34,411,736,55.84%,19.7%,1
宜蘭縣,頭城鎮,0183,134,239,373,28,401,788,50.89%,17.01%,1
宜蘭縣,頭城鎮,0184,86,179,265,21,286,560,51.07%,15.36%,1
宜蘭縣,頭城鎮,0185,133,259,392,32,424,712,59.55%,18.68%,1
宜蘭縣,頭城鎮,0186,97,204,301,21,322,502,64.14%,19.32%,1
宜蘭縣,頭城鎮,0187,122,208,330,28,358,569,62.92%,21.44%,1
宜蘭縣,頭城鎮,0188,110,224,334,27,361,633,57.03%,17.38%,1
宜蘭縣,頭城鎮,0189,181,310,491,44,535,1132,47.26%,15.99%,1
宜蘭縣,頭城鎮,0190,157,300,457,38,495,1035,47.83%,15.17%,1
宜蘭縣,頭城鎮,0191,156,305,461,43,504,847,59.5%,18.42%,1
宜蘭縣,頭城鎮,0192,238,384,622,39,661,1172,56.4%,20.31%,1
宜蘭縣,頭城鎮,0193,171,273,444,27,471,896,52.57%,19.08%,1
宜蘭縣,頭城鎮,0194,213,412,625,23,648,1075,60.28%,19.81%,1
宜蘭縣,頭城鎮,0195,155,335,490,57,547,931,58.75%,16.65%,1
宜蘭縣,頭城鎮,0196,158,359,517,45,562,1021,55.04%,15.48%,1
宜蘭縣,頭城鎮,0197,97,215,312,39,351,709,49.51%,13.68%,1
宜蘭縣,頭城鎮,0198,118,279,397,45,442,689,64.15%,17.13%,1
宜蘭縣,頭城鎮,0199,122,232,354,31,385,615,62.6%,19.84%,1
宜蘭縣,頭城鎮,0200,138,238,376,39,415,759,54.68%,18.18%,1
宜蘭縣,頭城鎮,0201,175,337,512,54,566,917,61.72%,19.08%,1
宜蘭縣,頭城鎮,0202,179,363,542,59,601,1045,57.51%,17.13%,1
宜蘭縣,頭城鎮,0203,202,388,590,52,642,1130,56.81%,17.88%,1
宜蘭縣,礁溪鄉,0204,176,327,503,40,543,1122,48.4%,15.69%,1
宜蘭縣,礁溪鄉,0205,86,158,244,24,268,505,53.07%,17.03%,1
宜蘭縣,礁溪鄉,0206,164,314,478,33,511,988,51.72%,16.6%,1
宜蘭縣,礁溪鄉,0207,159,325,484,36,520,971,53.55%,16.37%,1
宜蘭縣,礁溪鄉,0208,200,379,579,41,620,1246,49.76%,16.05%,1
宜蘭縣,礁溪鄉,0209,257,485,742,39,781,1655,47.19%,15.53%,1
宜蘭縣,礁溪鄉,0210,163,324,487,29,516,1132,45.58%,14.4%,1
宜蘭縣,礁溪鄉,0211,156,261,417,25,442,783,56.45%,19.92%,1
宜蘭縣,礁溪鄉,0212,154,316,470,28,498,928,53.66%,16.59%,1
宜蘭縣,礁溪鄉,0213,142,279,421,35,456,848,53.77%,16.75%,1
宜蘭縣,礁溪鄉,0214,145,247,392,30,422,663,63.65%,21.87%,1
宜蘭縣,礁溪鄉,0215,99,223,322,18,340,608,55.92%,16.28%,1
宜蘭縣,礁溪鄉,0216,140,301,441,29,470,833,56.42%,16.81%,1
宜蘭縣,礁溪鄉,0217,221,358,579,20,599,1233,48.58%,17.92%,1
宜蘭縣,礁溪鄉,0218,160,281,441,39,480,854,56.21%,18.74%,1
宜蘭縣,礁溪鄉,0219,104,181,285,15,300,575,52.17%,18.09%,1
宜蘭縣,礁溪鄉,0220,147,285,432,37,469,835,56.17%,17.6%,1
宜蘭縣,礁溪鄉,0221,253,441,694,56,750,1305,57.47%,19.39%,1
宜蘭縣,礁溪鄉,0222,140,272,412,49,461,830,55.54%,16.87%,1
宜蘭縣,礁溪鄉,0223,144,236,380,47,427,649,65.79%,22.19%,1
宜蘭縣,礁溪鄉,0224,137,265,402,44,446,923,48.32%,14.84%,1
宜蘭縣,礁溪鄉,0225,153,351,504,40,544,1177,46.22%,13%,1
宜蘭縣,礁溪鄉,0226,139,282,421,40,461,840,54.88%,16.55%,1
宜蘭縣,礁溪鄉,0227,187,382,569,27,596,1051,56.71%,17.79%,1
宜蘭縣,礁溪鄉,0228,233,404,637,45,682,1339,50.93%,17.4%,1
宜蘭縣,礁溪鄉,0229,192,475,667,41,708,1194,59.3%,16.08%,1
宜蘭縣,礁溪鄉,0230,219,480,699,73,772,1314,58.75%,16.67%,1
宜蘭縣,礁溪鄉,0231,232,370,602,20,622,1125,55.29%,20.62%,1
宜蘭縣,礁溪鄉,0232,231,434,665,56,721,1207,59.73%,19.14%,1
宜蘭縣,礁溪鄉,0233,186,299,485,64,549,979,56.08%,19%,1
宜蘭縣,礁溪鄉,0234,171,302,473,112,585,954,61.32%,17.92%,1
宜蘭縣,礁溪鄉,0235,70,160,230,6,236,418,56.46%,16.75%,1
宜蘭縣,壯圍鄉,0236,264,526,790,75,865,1435,60.28%,18.4%,1
宜蘭縣,壯圍鄉,0237,200,378,578,49,627,1049,59.77%,19.07%,1
宜蘭縣,壯圍鄉,0238,229,385,614,43,657,1068,61.52%,21.44%,1
宜蘭縣,壯圍鄉,0239,140,285,425,76,501,868,57.72%,16.13%,1
宜蘭縣,壯圍鄉,0240,167,332,499,29,528,967,54.6%,17.27%,1
宜蘭縣,壯圍鄉,0241,195,315,510,62,572,940,60.85%,20.74%,1
宜蘭縣,壯圍鄉,0242,154,297,451,23,474,975,48.62%,15.79%,1
宜蘭縣,壯圍鄉,0243,148,278,426,63,489,797,61.36%,18.57%,1
宜蘭縣,壯圍鄉,0244,121,289,410,51,461,808,57.05%,14.98%,1
宜蘭縣,壯圍鄉,0245,204,274,478,65,543,911,59.6%,22.39%,1
宜蘭縣,壯圍鄉,0246,94,183,277,39,316,612,51.63%,15.36%,1
宜蘭縣,壯圍鄉,0247,152,288,440,56,496,790,62.78%,19.24%,1
宜蘭縣,壯圍鄉,0248,159,302,461,63,524,878,59.68%,18.11%,1
宜蘭縣,壯圍鄉,0249,153,279,432,43,475,723,65.7%,21.16%,1
宜蘭縣,壯圍鄉,0250,121,234,355,31,386,737,52.37%,16.42%,1
宜蘭縣,壯圍鄉,0251,138,218,356,57,413,686,60.2%,20.12%,1
宜蘭縣,壯圍鄉,0252,161,291,452,9,461,895,51.51%,17.99%,1
宜蘭縣,壯圍鄉,0253,215,452,667,89,756,1237,61.12%,17.38%,1
宜蘭縣,壯圍鄉,0254,218,388,606,45,651,1134,57.41%,19.22%,1
宜蘭縣,壯圍鄉,0255,187,379,566,46,612,1107,55.28%,16.89%,1
宜蘭縣,壯圍鄉,0256,203,377,580,43,623,1057,58.94%,19.21%,1
宜蘭縣,壯圍鄉,0257,162,342,504,34,538,1051,51.19%,15.41%,1
宜蘭縣,壯圍鄉,0258,150,210,360,42,402,722,55.68%,20.78%,1
宜蘭縣,員山鄉,0259,247,433,680,36,716,1393,51.4%,17.73%,1
宜蘭縣,員山鄉,0260,176,264,440,24,464,895,51.84%,19.66%,1
宜蘭縣,員山鄉,0261,189,426,615,52,667,1231,54.18%,15.35%,1
宜蘭縣,員山鄉,0262,182,364,546,18,564,1098,51.37%,16.58%,1
宜蘭縣,員山鄉,0263,186,326,512,24,536,1031,51.99%,18.04%,1
宜蘭縣,員山鄉,0264,148,336,484,72,556,1030,53.98%,14.37%,1
宜蘭縣,員山鄉,0265,162,346,508,47,555,1168,47.52%,13.87%,1
宜蘭縣,員山鄉,0266,136,283,419,43,462,809,57.11%,16.81%,1
宜蘭縣,員山鄉,0267,142,270,412,36,448,778,57.58%,18.25%,1
宜蘭縣,員山鄉,0268,200,582,782,64,846,1465,57.75%,13.65%,1
宜蘭縣,員山鄉,0269,199,330,529,52,581,979,59.35%,20.33%,1
宜蘭縣,員山鄉,0270,138,303,441,38,479,860,55.7%,16.05%,1
宜蘭縣,員山鄉,0271,175,361,536,63,599,1205,49.71%,14.52%,1
宜蘭縣,員山鄉,0272,185,359,544,68,612,1082,56.56%,17.1%,1
宜蘭縣,員山鄉,0273,71,146,217,27,244,412,59.22%,17.23%,1
宜蘭縣,員山鄉,0274,58,116,174,18,192,403,47.64%,14.39%,1
宜蘭縣,員山鄉,0275,20,77,97,7,104,232,44.83%,8.62%,1
宜蘭縣,員山鄉,0276,178,296,474,38,512,944,54.24%,18.86%,1
宜蘭縣,員山鄉,0277,175,281,456,44,500,894,55.93%,19.57%,1
宜蘭縣,員山鄉,0278,215,487,702,59,761,1356,56.12%,15.86%,1
宜蘭縣,員山鄉,0279,133,275,408,46,454,780,58.21%,17.05%,1
宜蘭縣,員山鄉,0280,180,337,517,69,586,932,62.88%,19.31%,1
宜蘭縣,員山鄉,0281,95,169,264,35,299,583,51.29%,16.3%,1
宜蘭縣,員山鄉,0282,133,316,449,55,504,900,56%,14.78%,1
宜蘭縣,員山鄉,0283,119,248,367,38,405,747,54.22%,15.93%,1
宜蘭縣,員山鄉,0284,124,248,372,59,431,788,54.7%,15.74%,1
宜蘭縣,員山鄉,0285,153,265,418,46,464,884,52.49%,17.31%,1
宜蘭縣,員山鄉,0286,132,279,411,27,438,857,51.11%,15.4%,1
宜蘭縣,員山鄉,0287,193,296,489,26,515,1016,50.69%,19%,1
宜蘭縣,員山鄉,0288,96,182,278,31,309,690,44.78%,13.91%,1
宜蘭縣,員山鄉,0289,111,181,292,71,363,689,52.69%,16.11%,1
宜蘭縣,冬山鄉,0290,181,259,440,46,486,807,60.22%,22.43%,1
宜蘭縣,冬山鄉,0291,180,282,462,15,477,817,58.38%,22.03%,1
宜蘭縣,冬山鄉,0292,215,402,617,43,660,1156,57.09%,18.6%,1
宜蘭縣,冬山鄉,0293,163,282,445,41,486,892,54.48%,18.27%,1
宜蘭縣,冬山鄉,0294,169,313,482,42,524,897,58.42%,18.84%,1
宜蘭縣,冬山鄉,0295,268,523,791,44,835,1392,59.99%,19.25%,1
宜蘭縣,冬山鄉,0296,349,454,803,34,837,1471,56.9%,23.73%,1
宜蘭縣,冬山鄉,0297,212,418,630,37,667,1435,46.48%,14.77%,1
宜蘭縣,冬山鄉,0298,260,486,746,35,781,1519,51.42%,17.12%,1
宜蘭縣,冬山鄉,0299,285,543,828,41,869,1456,59.68%,19.57%,1
宜蘭縣,冬山鄉,0300,144,254,398,36,434,711,61.04%,20.25%,1
宜蘭縣,冬山鄉,0301,118,260,378,25,403,694,58.07%,17%,1
宜蘭縣,冬山鄉,0302,277,627,904,59,963,1526,63.11%,18.15%,1
宜蘭縣,冬山鄉,0303,167,290,457,35,492,884,55.66%,18.89%,1
宜蘭縣,冬山鄉,0304,268,418,686,49,735,1465,50.17%,18.29%,1
宜蘭縣,冬山鄉,0305,81,170,251,27,278,488,56.97%,16.6%,1
宜蘭縣,冬山鄉,0306,197,414,611,43,654,1218,53.69%,16.17%,1
宜蘭縣,冬山鄉,0307,207,410,617,42,659,1291,51.05%,16.03%,1
宜蘭縣,冬山鄉,0308,215,422,637,28,665,1324,50.23%,16.24%,1
宜蘭縣,冬山鄉,0309,173,365,538,35,573,1160,49.4%,14.91%,1
宜蘭縣,冬山鄉,0310,219,408,627,46,673,1246,54.01%,17.58%,1
宜蘭縣,冬山鄉,0311,333,531,864,33,897,1754,51.14%,18.99%,1
宜蘭縣,冬山鄉,0312,208,399,607,42,649,1217,53.33%,17.09%,1
宜蘭縣,冬山鄉,0313,221,448,669,50,719,1495,48.09%,14.78%,1
宜蘭縣,冬山鄉,0314,172,302,474,37,511,937,54.54%,18.36%,1
宜蘭縣,冬山鄉,0315,195,348,543,36,579,1101,52.59%,17.71%,1
宜蘭縣,冬山鄉,0316,172,360,532,52,584,1118,52.24%,15.38%,1
宜蘭縣,冬山鄉,0317,257,470,727,22,749,1301,57.57%,19.75%,1
宜蘭縣,冬山鄉,0318,223,403,626,28,654,1225,53.39%,18.2%,1
宜蘭縣,冬山鄉,0319,244,429,673,30,703,1206,58.29%,20.23%,1
宜蘭縣,冬山鄉,0320,196,406,602,36,638,1278,49.92%,15.34%,1
宜蘭縣,冬山鄉,0321,191,375,566,34,600,1151,52.13%,16.59%,1
宜蘭縣,冬山鄉,0322,141,357,498,40,538,1094,49.18%,12.89%,1
宜蘭縣,冬山鄉,0323,261,410,671,32,703,1247,56.38%,20.93%,1
宜蘭縣,冬山鄉,0324,205,386,591,40,631,1247,50.6%,16.44%,1
宜蘭縣,冬山鄉,0325,181,336,517,21,538,979,54.95%,18.49%,1
宜蘭縣,冬山鄉,0326,140,257,397,27,424,698,60.74%,20.06%,1
宜蘭縣,冬山鄉,0327,303,566,869,39,908,1726,52.61%,17.56%,1
宜蘭縣,冬山鄉,0328,108,212,320,18,338,782,43.22%,13.81%,1
宜蘭縣,五結鄉,0329,177,340,517,40,557,1076,51.77%,16.45%,1
宜蘭縣,五結鄉,0330,185,291,476,22,498,944,52.75%,19.6%,1
宜蘭縣,五結鄉,0331,157,302,459,19,478,836,57.18%,18.78%,1
宜蘭縣,五結鄉,0332,172,326,498,35,533,937,56.88%,18.36%,1
宜蘭縣,五結鄉,0333,214,414,628,29,657,1255,52.35%,17.05%,1
宜蘭縣,五結鄉,0334,243,380,623,60,683,1270,53.78%,19.13%,1
宜蘭縣,五結鄉,0335,139,243,382,22,404,801,50.44%,17.35%,1
宜蘭縣,五結鄉,0336,146,239,385,32,417,802,52%,18.2%,1
宜蘭縣,五結鄉,0337,218,396,614,36,650,1306,49.77%,16.69%,1
宜蘭縣,五結鄉,0338,230,366,596,32,628,1190,52.77%,19.33%,1
宜蘭縣,五結鄉,0339,240,433,673,24,697,1316,52.96%,18.24%,1
宜蘭縣,五結鄉,0340,184,322,506,29,535,965,55.44%,19.07%,1
宜蘭縣,五結鄉,0341,135,274,409,30,439,814,53.93%,16.58%,1
宜蘭縣,五結鄉,0342,209,421,630,27,657,1254,52.39%,16.67%,1
宜蘭縣,五結鄉,0343,163,407,570,38,608,1060,57.36%,15.38%,1
宜蘭縣,五結鄉,0344,255,447,702,31,733,1323,55.4%,19.27%,1
宜蘭縣,五結鄉,0345,215,383,598,42,640,1120,57.14%,19.2%,1
宜蘭縣,五結鄉,0346,169,292,461,22,483,893,54.09%,18.92%,1
宜蘭縣,五結鄉,0347,216,385,601,41,642,1220,52.62%,17.7%,1
宜蘭縣,五結鄉,0348,168,346,514,22,536,924,58.01%,18.18%,1
宜蘭縣,五結鄉,0349,188,331,519,44,563,933,60.34%,20.15%,1
宜蘭縣,五結鄉,0350,152,347,499,29,528,986,53.55%,15.42%,1
宜蘭縣,五結鄉,0351,131,235,366,41,407,748,54.41%,17.51%,1
宜蘭縣,五結鄉,0352,264,502,766,71,837,1550,54%,17.03%,1
宜蘭縣,五結鄉,0353,110,232,342,22,364,629,57.87%,17.49%,1
宜蘭縣,五結鄉,0354,146,258,404,37,441,806,54.71%,18.11%,1
宜蘭縣,五結鄉,0355,186,271,457,44,501,956,52.41%,19.46%,1
宜蘭縣,五結鄉,0356,164,364,528,39,567,1066,53.19%,15.38%,1
宜蘭縣,五結鄉,0357,256,438,694,56,750,1513,49.57%,16.92%,1
宜蘭縣,五結鄉,0358,279,504,783,41,824,1566,52.62%,17.82%,1
宜蘭縣,五結鄉,0359,169,264,433,64,497,894,55.59%,18.9%,1
宜蘭縣,五結鄉,0360,197,326,523,59,582,1235,47.13%,15.95%,1
宜蘭縣,五結鄉,0361,111,250,361,37,398,704,56.53%,15.77%,1
宜蘭縣,三星鄉,0362,32,70,102,15,117,215,54.42%,14.88%,1
宜蘭縣,三星鄉,0363,73,131,204,36,240,523,45.89%,13.96%,1
宜蘭縣,三星鄉,0364,134,211,345,43,388,745,52.08%,17.99%,1
宜蘭縣,三星鄉,0365,111,180,291,25,316,617,51.22%,17.99%,1
宜蘭縣,三星鄉,0366,80,155,235,30,265,497,53.32%,16.1%,1
宜蘭縣,三星鄉,0367,127,235,362,49,411,735,55.92%,17.28%,1
宜蘭縣,三星鄉,0368,96,200,296,28,324,583,55.57%,16.47%,1
宜蘭縣,三星鄉,0369,50,159,209,26,235,436,53.9%,11.47%,1
宜蘭縣,三星鄉,0370,198,399,597,47,644,1224,52.61%,16.18%,1
宜蘭縣,三星鄉,0371,167,356,523,31,554,1151,48.13%,14.51%,1
宜蘭縣,三星鄉,0372,139,310,449,33,482,870,55.4%,15.98%,1
宜蘭縣,三星鄉,0373,153,347,500,34,534,1284,41.59%,11.92%,1
宜蘭縣,三星鄉,0374,153,327,480,51,531,897,59.2%,17.06%,1
宜蘭縣,三星鄉,0375,240,482,722,55,777,1439,54%,16.68%,1
宜蘭縣,三星鄉,0376,257,433,690,47,737,1445,51%,17.79%,1
宜蘭縣,三星鄉,0377,223,479,702,34,736,1402,52.5%,15.91%,1
宜蘭縣,三星鄉,0378,223,379,602,46,648,1230,52.68%,18.13%,1
宜蘭縣,三星鄉,0379,115,279,394,38,432,774,55.81%,14.86%,1
宜蘭縣,三星鄉,0380,158,280,438,42,480,827,58.04%,19.11%,1
宜蘭縣,三星鄉,0381,144,228,372,22,394,736,53.53%,19.57%,1
宜蘭縣,三星鄉,0382,245,436,681,65,746,1421,52.5%,17.24%,1
宜蘭縣,大同鄉,0383,101,298,399,42,441,893,49.38%,11.31%,1
宜蘭縣,大同鄉,0384,85,341,426,34,460,632,72.78%,13.45%,1
宜蘭縣,大同鄉,0385,77,335,412,23,435,684,63.6%,11.26%,1
宜蘭縣,大同鄉,0386,44,106,150,25,175,264,66.29%,16.67%,1
宜蘭縣,大同鄉,0387,27,145,172,4,176,337,52.23%,8.01%,1
宜蘭縣,大同鄉,0388,32,200,232,8,240,404,59.41%,7.92%,1
宜蘭縣,大同鄉,0389,4,20,24,3,27,55,49.09%,7.27%,1
宜蘭縣,大同鄉,0390,25,109,134,20,154,199,77.39%,12.56%,1
宜蘭縣,大同鄉,0391,73,244,317,12,329,787,41.8%,9.28%,1
宜蘭縣,大同鄉,0392,60,339,399,46,445,680,65.44%,8.82%,1
宜蘭縣,南澳鄉,0393,66,175,241,6,247,444,55.63%,14.86%,1
宜蘭縣,南澳鄉,0394,138,464,602,24,626,1210,51.74%,11.4%,1
宜蘭縣,南澳鄉,0395,108,475,583,61,644,962,66.94%,11.23%,1
宜蘭縣,南澳鄉,0396,36,152,188,5,193,411,46.96%,8.76%,1
宜蘭縣,南澳鄉,0397,66,227,293,16,309,447,69.13%,14.77%,1
宜蘭縣,南澳鄉,0398,61,276,337,36,373,475,78.53%,12.84%,1
宜蘭縣,南澳鄉,0399,63,319,382,35,417,695,60%,9.06%,1
花蓮縣,花蓮市,0001,279,564,843,25,868,1522,57.03%,18.33%,1
花蓮縣,花蓮市,0002,192,439,631,20,651,1114,58.44%,17.24%,1
花蓮縣,花蓮市,0003,119,240,359,17,376,670,56.12%,17.76%,1
花蓮縣,花蓮市,0004,225,495,720,18,738,1397,52.83%,16.11%,1
花蓮縣,花蓮市,0005,68,152,220,19,239,470,50.85%,14.47%,1
花蓮縣,花蓮市,0006,105,300,405,27,432,838,51.55%,12.53%,1
花蓮縣,花蓮市,0007,69,223,292,16,308,721,42.72%,9.57%,1
花蓮縣,花蓮市,0008,155,345,500,32,532,918,57.95%,16.88%,1
花蓮縣,花蓮市,0009,260,521,781,29,810,1539,52.63%,16.89%,1
花蓮縣,花蓮市,0010,211,500,711,36,747,1403,53.24%,15.04%,1
花蓮縣,花蓮市,0011,149,395,544,22,566,1068,53%,13.95%,1
花蓮縣,花蓮市,0012,177,450,627,19,646,1167,55.36%,15.17%,1
花蓮縣,花蓮市,0013,211,502,713,40,753,1259,59.81%,16.76%,1
花蓮縣,花蓮市,0014,155,384,539,57,596,1071,55.65%,14.47%,1
花蓮縣,花蓮市,0015,155,350,505,24,529,925,57.19%,16.76%,1
花蓮縣,花蓮市,0016,191,478,669,44,713,1141,62.49%,16.74%,1
花蓮縣,花蓮市,0017,176,425,601,15,616,1163,52.97%,15.13%,1
花蓮縣,花蓮市,0018,213,503,716,31,747,1279,58.41%,16.65%,1
花蓮縣,花蓮市,0019,231,496,727,18,745,1512,49.27%,15.28%,1
花蓮縣,花蓮市,0020,111,203,314,20,334,615,54.31%,18.05%,1
花蓮縣,花蓮市,0021,114,230,344,14,358,606,59.08%,18.81%,1
花蓮縣,花蓮市,0022,75,199,274,10,284,559,50.81%,13.42%,1
花蓮縣,花蓮市,0023,62,173,235,13,248,442,56.11%,14.03%,1
花蓮縣,花蓮市,0024,153,393,546,26,572,1114,51.35%,13.73%,1
花蓮縣,花蓮市,0025,61,167,228,12,240,416,57.69%,14.66%,1
花蓮縣,花蓮市,0026,105,235,340,15,355,577,61.53%,18.2%,1
花蓮縣,花蓮市,0027,155,316,471,24,495,810,61.11%,19.14%,1
花蓮縣,花蓮市,0028,89,203,292,17,309,538,57.43%,16.54%,1
花蓮縣,花蓮市,0029,85,201,286,24,310,566,54.77%,15.02%,1
花蓮縣,花蓮市,0030,76,176,252,9,261,469,55.65%,16.2%,1
花蓮縣,花蓮市,0031,100,206,306,17,323,565,57.17%,17.7%,1
花蓮縣,花蓮市,0032,107,275,382,24,406,816,49.75%,13.11%,1
花蓮縣,花蓮市,0033,141,301,442,39,481,911,52.8%,15.48%,1
花蓮縣,花蓮市,0034,129,376,505,34,539,1029,52.38%,12.54%,1
花蓮縣,花蓮市,0035,180,401,581,35,616,1043,59.06%,17.26%,1
花蓮縣,花蓮市,0036,151,324,475,19,494,856,57.71%,17.64%,1
花蓮縣,花蓮市,0037,168,358,526,15,541,979,55.26%,17.16%,1
花蓮縣,花蓮市,0038,213,491,704,46,750,1331,56.35%,16%,1
花蓮縣,花蓮市,0039,303,367,670,27,697,1228,56.76%,24.67%,1
花蓮縣,花蓮市,0040,145,381,526,21,547,955,57.28%,15.18%,1
花蓮縣,花蓮市,0041,191,425,616,27,643,1268,50.71%,15.06%,1
花蓮縣,花蓮市,0042,185,432,617,26,643,1230,52.28%,15.04%,1
花蓮縣,花蓮市,0043,213,528,741,34,775,1369,56.61%,15.56%,1
花蓮縣,花蓮市,0044,202,442,644,22,666,1435,46.41%,14.08%,1
花蓮縣,花蓮市,0045,173,443,616,23,639,1164,54.9%,14.86%,1
花蓮縣,花蓮市,0046,201,501,702,36,738,1249,59.09%,16.09%,1
花蓮縣,花蓮市,0047,196,413,609,47,656,1184,55.41%,16.55%,1
花蓮縣,花蓮市,0048,150,613,763,19,782,1490,52.48%,10.07%,1
花蓮縣,花蓮市,0049,177,431,608,36,644,1022,63.01%,17.32%,1
花蓮縣,花蓮市,0050,179,426,605,33,638,1135,56.21%,15.77%,1
花蓮縣,花蓮市,0051,143,442,585,25,610,1084,56.27%,13.19%,1
花蓮縣,花蓮市,0052,150,330,480,19,499,1339,37.27%,11.2%,1
花蓮縣,花蓮市,0053,89,195,284,18,302,501,60.28%,17.76%,1
花蓮縣,花蓮市,0054,145,340,485,19,504,904,55.75%,16.04%,1
花蓮縣,花蓮市,0055,95,195,290,14,304,490,62.04%,19.39%,1
花蓮縣,花蓮市,0056,152,394,546,28,574,1192,48.15%,12.75%,1
花蓮縣,花蓮市,0057,126,286,412,25,437,869,50.29%,14.5%,1
花蓮縣,花蓮市,0058,201,449,650,26,676,1267,53.35%,15.86%,1
花蓮縣,花蓮市,0059,161,367,528,29,557,959,58.08%,16.79%,1
花蓮縣,花蓮市,0060,152,365,517,27,544,993,54.78%,15.31%,1
花蓮縣,花蓮市,0061,149,366,515,37,552,982,56.21%,15.17%,1
花蓮縣,花蓮市,0062,201,427,628,14,642,1311,48.97%,15.33%,1
花蓮縣,花蓮市,0063,217,493,710,38,748,1455,51.41%,14.91%,1
花蓮縣,花蓮市,0064,124,385,509,27,536,1151,46.57%,10.77%,1
花蓮縣,花蓮市,0065,171,420,591,22,613,1237,49.56%,13.82%,1
花蓮縣,花蓮市,0066,226,399,625,21,646,1339,48.24%,16.88%,1
花蓮縣,花蓮市,0067,124,271,395,20,415,715,58.04%,17.34%,1
花蓮縣,花蓮市,0068,163,369,532,27,559,1000,55.9%,16.3%,1
花蓮縣,花蓮市,0069,179,475,654,45,699,1410,49.57%,12.7%,1
花蓮縣,花蓮市,0070,177,493,670,13,683,1303,52.42%,13.58%,1
花蓮縣,花蓮市,0071,195,452,647,25,672,1256,53.5%,15.53%,1
花蓮縣,花蓮市,0072,144,459,603,33,636,1105,57.56%,13.03%,1
花蓮縣,花蓮市,0073,168,367,535,22,557,1089,51.15%,15.43%,1
花蓮縣,花蓮市,0074,139,371,510,22,532,1043,51.01%,13.33%,1
花蓮縣,花蓮市,0075,147,444,591,31,622,1080,57.59%,13.61%,1
花蓮縣,花蓮市,0076,146,377,523,23,546,971,56.23%,15.04%,1
花蓮縣,花蓮市,0077,195,398,593,19,612,1068,57.3%,18.26%,1
花蓮縣,花蓮市,0078,198,472,670,24,694,1379,50.33%,14.36%,1
花蓮縣,花蓮市,0079,241,445,686,31,717,1362,52.64%,17.69%,1
花蓮縣,花蓮市,0080,242,493,735,21,756,1323,57.14%,18.29%,1
花蓮縣,花蓮市,0081,181,465,646,36,682,1482,46.02%,12.21%,1
花蓮縣,鳳林鎮,0195,175,506,681,55,736,1192,61.74%,14.68%,1
花蓮縣,鳳林鎮,0196,74,231,305,20,325,639,50.86%,11.58%,1
花蓮縣,鳳林鎮,0197,91,272,363,38,401,601,66.72%,15.14%,1
花蓮縣,鳳林鎮,0198,189,500,689,39,728,1137,64.03%,16.62%,1
花蓮縣,鳳林鎮,0199,106,267,373,45,418,742,56.33%,14.29%,1
花蓮縣,鳳林鎮,0200,78,257,335,16,351,610,57.54%,12.79%,1
花蓮縣,鳳林鎮,0201,52,104,156,36,192,295,65.08%,17.63%,1
花蓮縣,鳳林鎮,0202,12,52,64,3,67,218,30.73%,5.5%,1
花蓮縣,鳳林鎮,0203,87,205,292,19,311,720,43.19%,12.08%,1
花蓮縣,鳳林鎮,0204,81,181,262,27,289,528,54.73%,15.34%,1
花蓮縣,鳳林鎮,0205,89,183,272,18,290,560,51.79%,15.89%,1
花蓮縣,鳳林鎮,0206,68,181,249,42,291,541,53.79%,12.57%,1
花蓮縣,鳳林鎮,0207,99,312,411,53,464,818,56.72%,12.1%,1
花蓮縣,鳳林鎮,0208,112,272,384,44,428,984,43.5%,11.38%,1
花蓮縣,鳳林鎮,0209,14,24,38,11,49,91,53.85%,15.38%,1
花蓮縣,玉里鎮,0254,146,365,511,30,541,1008,53.67%,14.48%,1
花蓮縣,玉里鎮,0255,129,392,521,37,558,939,59.42%,13.74%,1
花蓮縣,玉里鎮,0256,168,429,597,61,658,1256,52.39%,13.38%,1
花蓮縣,玉里鎮,0257,139,332,471,34,505,929,54.36%,14.96%,1
花蓮縣,玉里鎮,0258,140,362,502,32,534,979,54.55%,14.3%,1
花蓮縣,玉里鎮,0259,98,601,699,31,730,1244,58.68%,7.88%,1
花蓮縣,玉里鎮,0260,97,283,380,38,418,847,49.35%,11.45%,1
花蓮縣,玉里鎮,0261,100,241,341,39,380,772,49.22%,12.95%,1
花蓮縣,玉里鎮,0262,78,179,257,21,278,558,49.82%,13.98%,1
花蓮縣,玉里鎮,0263,66,172,238,22,260,800,32.5%,8.25%,1
花蓮縣,玉里鎮,0264,122,410,532,64,596,1286,46.35%,9.49%,1
花蓮縣,玉里鎮,0265,186,373,559,39,598,1246,47.99%,14.93%,1
花蓮縣,玉里鎮,0266,88,203,291,59,350,647,54.1%,13.6%,1
花蓮縣,玉里鎮,0267,65,163,228,14,242,990,24.44%,6.57%,1
花蓮縣,玉里鎮,0268,64,141,205,57,262,530,49.43%,12.08%,1
花蓮縣,玉里鎮,0269,90,244,334,36,370,979,37.79%,9.19%,1
花蓮縣,玉里鎮,0270,62,183,245,75,320,557,57.45%,11.13%,1
花蓮縣,玉里鎮,0271,38,119,157,20,177,434,40.78%,8.76%,1
花蓮縣,玉里鎮,0272,99,210,309,72,381,1065,35.77%,9.3%,1
花蓮縣,玉里鎮,0273,99,281,380,90,470,866,54.27%,11.43%,1
花蓮縣,玉里鎮,0274,77,206,283,52,335,769,43.56%,10.01%,1
花蓮縣,玉里鎮,0275,123,218,341,31,372,869,42.81%,14.15%,1
花蓮縣,玉里鎮,0276,128,275,403,43,446,1080,41.3%,11.85%,1
花蓮縣,新城鄉,0082,73,121,194,18,212,367,57.77%,19.89%,1
花蓮縣,新城鄉,0083,116,334,450,18,468,929,50.38%,12.49%,1
花蓮縣,新城鄉,0084,112,193,305,50,355,590,60.17%,18.98%,1
花蓮縣,新城鄉,0085,52,99,151,22,173,307,56.35%,16.94%,1
花蓮縣,新城鄉,0086,36,111,147,13,160,260,61.54%,13.85%,1
花蓮縣,新城鄉,0087,221,439,660,59,719,1283,56.04%,17.23%,1
花蓮縣,新城鄉,0088,95,332,427,22,449,885,50.73%,10.73%,1
花蓮縣,新城鄉,0089,109,307,416,30,446,770,57.92%,14.16%,1
花蓮縣,新城鄉,0090,167,523,690,54,744,1363,54.59%,12.25%,1
花蓮縣,新城鄉,0091,63,123,186,12,198,366,54.1%,17.21%,1
花蓮縣,新城鄉,0092,151,395,546,48,594,1163,51.07%,12.98%,1
花蓮縣,新城鄉,0093,220,590,810,37,847,1605,52.77%,13.71%,1
花蓮縣,新城鄉,0094,176,446,622,35,657,1194,55.03%,14.74%,1
花蓮縣,新城鄉,0095,151,371,522,30,552,979,56.38%,15.42%,1
花蓮縣,新城鄉,0096,205,585,790,40,830,1485,55.89%,13.8%,1
花蓮縣,新城鄉,0097,157,380,537,23,560,1070,52.34%,14.67%,1
花蓮縣,新城鄉,0098,189,421,610,24,634,1164,54.47%,16.24%,1
花蓮縣,新城鄉,0099,119,306,425,43,468,880,53.18%,13.52%,1
花蓮縣,新城鄉,0100,61,117,178,8,186,369,50.41%,16.53%,1
花蓮縣,吉安鄉,0115,158,376,534,26,560,1059,52.88%,14.92%,1
花蓮縣,吉安鄉,0116,150,369,519,29,548,983,55.75%,15.26%,1
花蓮縣,吉安鄉,0117,150,391,541,23,564,1031,54.7%,14.55%,1
花蓮縣,吉安鄉,0118,164,383,547,24,571,1105,51.67%,14.84%,1
花蓮縣,吉安鄉,0119,179,374,553,26,579,1107,52.3%,16.17%,1
花蓮縣,吉安鄉,0120,179,385,564,26,590,1179,50.04%,15.18%,1
花蓮縣,吉安鄉,0121,192,423,615,50,665,1453,45.77%,13.21%,1
花蓮縣,吉安鄉,0122,243,562,805,36,841,1432,58.73%,16.97%,1
花蓮縣,吉安鄉,0123,209,496,705,22,727,1320,55.08%,15.83%,1
花蓮縣,吉安鄉,0124,200,479,679,21,700,1356,51.62%,14.75%,1
花蓮縣,吉安鄉,0125,173,481,654,23,677,1295,52.28%,13.36%,1
花蓮縣,吉安鄉,0126,226,525,751,47,798,1467,54.4%,15.41%,1
花蓮縣,吉安鄉,0127,226,541,767,25,792,1515,52.28%,14.92%,1
花蓮縣,吉安鄉,0128,183,412,595,35,630,1063,59.27%,17.22%,1
花蓮縣,吉安鄉,0129,172,389,561,13,574,1284,44.7%,13.4%,1
花蓮縣,吉安鄉,0130,224,527,751,22,773,1380,56.01%,16.23%,1
花蓮縣,吉安鄉,0131,197,487,684,50,734,1297,56.59%,15.19%,1
花蓮縣,吉安鄉,0132,242,555,797,65,862,1662,51.87%,14.56%,1
花蓮縣,吉安鄉,0133,181,513,694,60,754,1563,48.24%,11.58%,1
花蓮縣,吉安鄉,0134,145,441,586,36,622,1288,48.29%,11.26%,1
花蓮縣,吉安鄉,0135,149,338,487,27,514,907,56.67%,16.43%,1
花蓮縣,吉安鄉,0136,126,321,447,26,473,917,51.58%,13.74%,1
花蓮縣,吉安鄉,0137,157,347,504,21,525,1021,51.42%,15.38%,1
花蓮縣,吉安鄉,0138,172,414,586,28,614,1033,59.44%,16.65%,1
花蓮縣,吉安鄉,0139,156,355,511,41,552,966,57.14%,16.15%,1
花蓮縣,吉安鄉,0140,155,428,583,42,625,1188,52.61%,13.05%,1
花蓮縣,吉安鄉,0141,189,557,746,27,773,1480,52.23%,12.77%,1
花蓮縣,吉安鄉,0142,164,482,646,29,675,1393,48.46%,11.77%,1
花蓮縣,吉安鄉,0143,174,412,586,27,613,1193,51.38%,14.59%,1
花蓮縣,吉安鄉,0144,180,493,673,29,702,1445,48.58%,12.46%,1
花蓮縣,吉安鄉,0145,190,454,644,70,714,1301,54.88%,14.6%,1
花蓮縣,吉安鄉,0146,193,450,643,48,691,1215,56.87%,15.88%,1
花蓮縣,吉安鄉,0147,180,400,580,30,610,1135,53.74%,15.86%,1
花蓮縣,吉安鄉,0148,171,495,666,25,691,1223,56.5%,13.98%,1
花蓮縣,吉安鄉,0149,161,513,674,23,697,1274,54.71%,12.64%,1
花蓮縣,吉安鄉,0150,161,404,565,29,594,1124,52.85%,14.32%,1
花蓮縣,吉安鄉,0151,199,427,626,25,651,1158,56.22%,17.18%,1
花蓮縣,吉安鄉,0152,196,434,630,17,647,1157,55.92%,16.94%,1
花蓮縣,吉安鄉,0153,196,478,674,21,695,1258,55.25%,15.58%,1
花蓮縣,吉安鄉,0154,187,453,640,32,672,1257,53.46%,14.88%,1
花蓮縣,吉安鄉,0155,183,448,631,21,652,1245,52.37%,14.7%,1
花蓮縣,吉安鄉,0156,195,447,642,8,650,1166,55.75%,16.72%,1
花蓮縣,吉安鄉,0157,191,470,661,50,711,1358,52.36%,14.06%,1
花蓮縣,吉安鄉,0158,137,465,602,26,628,1214,51.73%,11.29%,1
花蓮縣,吉安鄉,0159,169,414,583,38,621,1151,53.95%,14.68%,1
花蓮縣,吉安鄉,0160,166,446,612,28,640,1157,55.32%,14.35%,1
花蓮縣,吉安鄉,0161,189,441,630,24,654,1161,56.33%,16.28%,1
花蓮縣,吉安鄉,0162,207,497,704,33,737,1304,56.52%,15.87%,1
花蓮縣,吉安鄉,0163,184,492,676,43,719,1367,52.6%,13.46%,1
花蓮縣,吉安鄉,0164,169,469,638,28,666,1411,47.2%,11.98%,1
花蓮縣,吉安鄉,0165,145,480,625,41,666,1409,47.27%,10.29%,1
花蓮縣,吉安鄉,0166,139,369,508,30,538,1125,47.82%,12.36%,1
花蓮縣,吉安鄉,0167,164,453,617,48,665,1213,54.82%,13.52%,1
花蓮縣,吉安鄉,0168,134,461,595,31,626,1141,54.86%,11.74%,1
花蓮縣,吉安鄉,0169,134,384,518,20,538,1156,46.54%,11.59%,1
花蓮縣,吉安鄉,0170,116,425,541,30,571,1092,52.29%,10.62%,1
花蓮縣,吉安鄉,0171,115,324,439,28,467,1026,45.52%,11.21%,1
花蓮縣,吉安鄉,0172,99,317,416,13,429,804,53.36%,12.31%,1
花蓮縣,吉安鄉,0173,147,449,596,31,627,1132,55.39%,12.99%,1
花蓮縣,壽豐鄉,0174,133,349,482,34,516,1052,49.05%,12.64%,1
花蓮縣,壽豐鄉,0175,51,139,190,28,218,357,61.06%,14.29%,1
花蓮縣,壽豐鄉,0176,140,325,465,50,515,1022,50.39%,13.7%,1
花蓮縣,壽豐鄉,0177,143,372,515,33,548,875,62.63%,16.34%,1
花蓮縣,壽豐鄉,0178,121,276,397,27,424,691,61.36%,17.51%,1
花蓮縣,壽豐鄉,0179,80,244,324,21,345,708,48.73%,11.3%,1
花蓮縣,壽豐鄉,0180,132,301,433,41,474,894,53.02%,14.77%,1
花蓮縣,壽豐鄉,0181,137,250,387,23,410,746,54.96%,18.36%,1
花蓮縣,壽豐鄉,0182,126,306,432,37,469,881,53.23%,14.3%,1
花蓮縣,壽豐鄉,0183,121,287,408,28,436,695,62.73%,17.41%,1
花蓮縣,壽豐鄉,0184,120,331,451,70,521,816,63.85%,14.71%,1
花蓮縣,壽豐鄉,0185,100,253,353,42,395,773,51.1%,12.94%,1
花蓮縣,壽豐鄉,0186,171,372,543,46,589,1029,57.24%,16.62%,1
花蓮縣,壽豐鄉,0187,54,182,236,22,258,407,63.39%,13.27%,1
花蓮縣,壽豐鄉,0188,173,429,602,48,650,1139,57.07%,15.19%,1
花蓮縣,壽豐鄉,0189,215,325,540,33,573,996,57.53%,21.59%,1
花蓮縣,壽豐鄉,0190,57,117,174,14,188,414,45.41%,13.77%,1
花蓮縣,壽豐鄉,0191,39,107,146,11,157,270,58.15%,14.44%,1
花蓮縣,壽豐鄉,0192,98,338,436,53,489,836,58.49%,11.72%,1
花蓮縣,壽豐鄉,0193,79,202,281,28,309,507,60.95%,15.58%,1
花蓮縣,壽豐鄉,0194,73,198,271,45,316,739,42.76%,9.88%,1
花蓮縣,光復鄉,0210,178,479,657,74,731,1295,56.45%,13.75%,1
花蓮縣,光復鄉,0211,119,349,468,32,500,859,58.21%,13.85%,1
花蓮縣,光復鄉,0212,120,345,465,106,571,958,59.6%,12.53%,1
花蓮縣,光復鄉,0213,108,403,511,88,599,1011,59.25%,10.68%,1
花蓮縣,光復鄉,0214,142,396,538,64,602,1041,57.83%,13.64%,1
花蓮縣,光復鄉,0215,98,274,372,79,451,821,54.93%,11.94%,1
花蓮縣,光復鄉,0216,10,31,41,4,45,188,23.94%,5.32%,1
花蓮縣,光復鄉,0217,59,187,246,35,281,514,54.67%,11.48%,1
花蓮縣,光復鄉,0218,34,128,162,10,172,446,38.57%,7.62%,1
花蓮縣,光復鄉,0219,86,290,376,56,432,851,50.76%,10.11%,1
花蓮縣,光復鄉,0220,106,222,328,20,348,932,37.34%,11.37%,1
花蓮縣,光復鄉,0221,62,185,247,22,269,471,57.11%,13.16%,1
花蓮縣,光復鄉,0222,96,224,320,35,355,640,55.47%,15%,1
花蓮縣,光復鄉,0223,6,32,38,7,45,116,38.79%,5.17%,1
花蓮縣,光復鄉,0224,42,115,157,5,162,496,32.66%,8.47%,1
花蓮縣,光復鄉,0225,43,90,133,13,146,324,45.06%,13.27%,1
花蓮縣,光復鄉,0226,36,121,157,24,181,454,39.87%,7.93%,1
花蓮縣,豐濱鄉,0227,67,200,267,75,342,717,47.7%,9.34%,1
花蓮縣,豐濱鄉,0228,92,166,258,52,310,751,41.28%,12.25%,1
花蓮縣,豐濱鄉,0229,81,169,250,42,292,613,47.63%,13.21%,1
花蓮縣,豐濱鄉,0230,107,283,390,20,410,809,50.68%,13.23%,1
花蓮縣,豐濱鄉,0231,24,62,86,5,91,357,25.49%,6.72%,1
花蓮縣,豐濱鄉,0232,85,190,275,66,341,669,50.97%,12.71%,1
花蓮縣,豐濱鄉,0233,64,137,201,11,212,479,44.26%,13.36%,1
花蓮縣,瑞穗鄉,0241,112,335,447,27,474,813,58.3%,13.78%,1
花蓮縣,瑞穗鄉,0242,132,431,563,49,612,1091,56.1%,12.1%,1
花蓮縣,瑞穗鄉,0243,113,321,434,43,477,839,56.85%,13.47%,1
花蓮縣,瑞穗鄉,0244,113,383,496,61,557,975,57.13%,11.59%,1
花蓮縣,瑞穗鄉,0245,56,180,236,24,260,546,47.62%,10.26%,1
花蓮縣,瑞穗鄉,0246,136,363,499,71,570,1002,56.89%,13.57%,1
花蓮縣,瑞穗鄉,0247,70,187,257,23,280,593,47.22%,11.8%,1
花蓮縣,瑞穗鄉,0248,137,336,473,83,556,965,57.62%,14.2%,1
花蓮縣,瑞穗鄉,0249,98,316,414,63,477,863,55.27%,11.36%,1
花蓮縣,瑞穗鄉,0250,15,61,76,7,83,340,24.41%,4.41%,1
花蓮縣,瑞穗鄉,0251,78,242,320,34,354,764,46.34%,10.21%,1
花蓮縣,瑞穗鄉,0252,39,151,190,10,200,868,23.04%,4.49%,1
花蓮縣,瑞穗鄉,0253,36,145,181,14,195,620,31.45%,5.81%,1
花蓮縣,富里鄉,0277,40,140,180,18,198,467,42.4%,8.57%,1
花蓮縣,富里鄉,0278,111,252,363,49,412,1032,39.92%,10.76%,1
花蓮縣,富里鄉,0279,48,202,250,28,278,638,43.57%,7.52%,1
花蓮縣,富里鄉,0280,68,186,254,66,320,591,54.15%,11.51%,1
花蓮縣,富里鄉,0281,134,407,541,53,594,1087,54.65%,12.33%,1
花蓮縣,富里鄉,0282,69,137,206,18,224,431,51.97%,16.01%,1
花蓮縣,富里鄉,0283,128,275,403,33,436,893,48.82%,14.33%,1
花蓮縣,富里鄉,0284,36,97,133,16,149,361,41.27%,9.97%,1
花蓮縣,富里鄉,0285,150,358,508,39,547,1362,40.16%,11.01%,1
花蓮縣,富里鄉,0286,59,157,216,23,239,458,52.18%,12.88%,1
花蓮縣,富里鄉,0287,46,132,178,29,207,621,33.33%,7.41%,1
花蓮縣,富里鄉,0288,68,156,224,20,244,493,49.49%,13.79%,1
花蓮縣,富里鄉,0289,77,194,271,32,303,631,48.02%,12.2%,1
花蓮縣,秀林鄉,0101,100,327,427,23,450,867,51.9%,11.53%,1
花蓮縣,秀林鄉,0102,88,187,275,24,299,575,52%,15.3%,1
花蓮縣,秀林鄉,0103,127,418,545,31,576,1373,41.95%,9.25%,1
花蓮縣,秀林鄉,0104,177,549,726,65,791,1644,48.11%,10.77%,1
花蓮縣,秀林鄉,0105,19,67,86,4,90,162,55.56%,11.73%,1
花蓮縣,秀林鄉,0106,50,127,177,17,194,384,50.52%,13.02%,1
花蓮縣,秀林鄉,0107,186,427,613,39,652,1382,47.18%,13.46%,1
花蓮縣,秀林鄉,0108,166,349,515,37,552,1125,49.07%,14.76%,1
花蓮縣,秀林鄉,0109,106,186,292,13,305,627,48.64%,16.91%,1
花蓮縣,秀林鄉,0110,154,409,563,38,601,987,60.89%,15.6%,1
花蓮縣,秀林鄉,0111,182,437,619,82,701,1139,61.55%,15.98%,1
花蓮縣,秀林鄉,0112,186,459,645,13,658,1213,54.25%,15.33%,1
花蓮縣,秀林鄉,0113,113,273,386,21,407,754,53.98%,14.99%,1
花蓮縣,秀林鄉,0114,40,111,151,8,159,330,48.18%,12.12%,1
花蓮縣,萬榮鄉,0234,152,379,531,67,598,1072,55.78%,14.18%,1
花蓮縣,萬榮鄉,0235,75,179,254,6,260,560,46.43%,13.39%,1
花蓮縣,萬榮鄉,0236,119,326,445,28,473,773,61.19%,15.39%,1
花蓮縣,萬榮鄉,0237,68,188,256,15,271,661,41%,10.29%,1
花蓮縣,萬榮鄉,0238,35,193,228,11,239,442,54.07%,7.92%,1
花蓮縣,萬榮鄉,0239,53,245,298,51,349,675,51.7%,7.85%,1
花蓮縣,萬榮鄉,0240,166,476,642,101,743,1086,68.42%,15.29%,1
花蓮縣,卓溪鄉,0290,66,214,280,23,303,533,56.85%,12.38%,1
花蓮縣,卓溪鄉,0291,78,213,291,41,332,522,63.6%,14.94%,1
花蓮縣,卓溪鄉,0292,83,182,265,13,278,493,56.39%,16.84%,1
花蓮縣,卓溪鄉,0293,68,327,395,46,441,701,62.91%,9.7%,1
花蓮縣,卓溪鄉,0294,82,321,403,40,443,746,59.38%,10.99%,1
花蓮縣,卓溪鄉,0295,68,273,341,49,390,616,63.31%,11.04%,1
花蓮縣,卓溪鄉,0296,38,103,141,10,151,405,37.28%,9.38%,1
花蓮縣,卓溪鄉,0297,41,125,166,13,179,329,54.41%,12.46%,1
花蓮縣,卓溪鄉,0298,42,174,216,14,230,428,53.74%,9.81%,1
花蓮縣,卓溪鄉,0299,19,70,89,9,98,174,56.32%,10.92%,1
臺東縣,臺東市,0001,119,298,417,17,434,874,49.66%,13.62%,1
臺東縣,臺東市,0002,256,583,839,57,896,1469,60.99%,17.43%,1
臺東縣,臺東市,0003,192,472,664,40,704,1259,55.92%,15.25%,1
臺東縣,臺東市,0004,232,509,741,38,779,1399,55.68%,16.58%,1
臺東縣,臺東市,0005,264,544,808,34,842,1363,61.78%,19.37%,1
臺東縣,臺東市,0006,232,635,867,38,905,1651,54.82%,14.05%,1
臺東縣,臺東市,0007,233,656,889,40,929,1490,62.35%,15.64%,1
臺東縣,臺東市,0008,128,300,428,31,459,859,53.43%,14.9%,1
臺東縣,臺東市,0009,170,337,507,37,544,890,61.12%,19.1%,1
臺東縣,臺東市,0010,89,249,338,38,376,651,57.76%,13.67%,1
臺東縣,臺東市,0011,337,414,751,63,814,1650,49.33%,20.42%,1
臺東縣,臺東市,0012,131,292,423,28,451,724,62.29%,18.09%,1
臺東縣,臺東市,0013,116,235,351,32,383,632,60.6%,18.35%,1
臺東縣,臺東市,0014,122,303,425,37,462,771,59.92%,15.82%,1
臺東縣,臺東市,0015,128,258,386,24,410,798,51.38%,16.04%,1
臺東縣,臺東市,0016,173,467,640,80,720,1299,55.43%,13.32%,1
臺東縣,臺東市,0017,134,319,453,32,485,811,59.8%,16.52%,1
臺東縣,臺東市,0018,140,319,459,32,491,764,64.27%,18.32%,1
臺東縣,臺東市,0019,144,247,391,19,410,784,52.3%,18.37%,1
臺東縣,臺東市,0020,64,143,207,11,218,427,51.05%,14.99%,1
臺東縣,臺東市,0021,210,436,646,27,673,1292,52.09%,16.25%,1
臺東縣,臺東市,0022,257,597,854,10,864,1501,57.56%,17.12%,1
臺東縣,臺東市,0023,83,205,288,14,302,601,50.25%,13.81%,1
臺東縣,臺東市,0024,71,133,204,9,213,417,51.08%,17.03%,1
臺東縣,臺東市,0025,142,387,529,37,566,1001,56.54%,14.19%,1
臺東縣,臺東市,0026,255,651,906,48,954,1638,58.24%,15.57%,1
臺東縣,臺東市,0027,229,598,827,45,872,1576,55.33%,14.53%,1
臺東縣,臺東市,0028,246,689,935,59,994,1595,62.32%,15.42%,1
臺東縣,臺東市,0029,270,656,926,40,966,1734,55.71%,15.57%,1
臺東縣,臺東市,0030,238,563,801,51,852,1476,57.72%,16.12%,1
臺東縣,臺東市,0031,283,614,897,34,931,1545,60.26%,18.32%,1
臺東縣,臺東市,0032,162,562,724,41,765,1313,58.26%,12.34%,1
臺東縣,臺東市,0033,190,597,787,38,825,1338,61.66%,14.2%,1
臺東縣,臺東市,0034,192,506,698,32,730,1312,55.64%,14.63%,1
臺東縣,臺東市,0035,220,478,698,40,738,1265,58.34%,17.39%,1
臺東縣,臺東市,0036,198,413,611,68,679,1407,48.26%,14.07%,1
臺東縣,臺東市,0037,189,520,709,49,758,1552,48.84%,12.18%,1
臺東縣,臺東市,0038,194,535,729,82,811,1445,56.12%,13.43%,1
臺東縣,臺東市,0039,352,776,1128,68,1196,2098,57.01%,16.78%,1
臺東縣,臺東市,0040,186,525,711,80,791,1324,59.74%,14.05%,1
臺東縣,臺東市,0041,197,644,841,31,872,1598,54.57%,12.33%,1
臺東縣,臺東市,0042,207,567,774,33,807,1513,53.34%,13.68%,1
臺東縣,臺東市,0043,235,585,820,37,857,1679,51.04%,14%,1
臺東縣,臺東市,0044,218,479,697,49,746,1414,52.76%,15.42%,1
臺東縣,臺東市,0045,265,649,914,51,965,1798,53.67%,14.74%,1
臺東縣,臺東市,0046,229,533,762,57,819,1749,46.83%,13.09%,1
臺東縣,臺東市,0047,226,634,860,81,941,1709,55.06%,13.22%,1
臺東縣,臺東市,0048,216,596,812,50,862,1629,52.92%,13.26%,1
臺東縣,臺東市,0049,149,384,533,63,596,1116,53.41%,13.35%,1
臺東縣,臺東市,0050,123,405,528,41,569,1259,45.19%,9.77%,1
臺東縣,臺東市,0051,161,369,530,48,578,1232,46.92%,13.07%,1
臺東縣,臺東市,0052,145,517,662,112,774,1505,51.43%,9.63%,1
臺東縣,臺東市,0053,104,245,349,55,404,836,48.33%,12.44%,1
臺東縣,臺東市,0054,194,498,692,44,736,1294,56.88%,14.99%,1
臺東縣,臺東市,0055,181,455,636,85,721,1350,53.41%,13.41%,1
臺東縣,臺東市,0056,304,806,1110,86,1196,2162,55.32%,14.06%,1
臺東縣,臺東市,0057,313,609,922,41,963,1627,59.19%,19.24%,1
臺東縣,臺東市,0058,173,455,628,34,662,1140,58.07%,15.18%,1
臺東縣,臺東市,0059,183,503,686,40,726,1359,53.42%,13.47%,1
臺東縣,臺東市,0060,213,479,692,47,739,1329,55.61%,16.03%,1
臺東縣,臺東市,0061,117,368,485,30,515,990,52.02%,11.82%,1
臺東縣,臺東市,0062,135,407,542,49,591,1038,56.94%,13.01%,1
臺東縣,臺東市,0063,207,562,769,81,850,1597,53.22%,12.96%,1
臺東縣,臺東市,0064,222,431,653,89,742,1385,53.57%,16.03%,1
臺東縣,臺東市,0065,143,270,413,18,431,939,45.9%,15.23%,1
臺東縣,臺東市,0066,146,364,510,55,565,1258,44.91%,11.61%,1
臺東縣,臺東市,0067,221,427,648,8,656,1350,48.59%,16.37%,1
臺東縣,臺東市,0068,112,336,448,49,497,1058,46.98%,10.59%,1
臺東縣,臺東市,0069,82,283,365,36,401,895,44.8%,9.16%,1
臺東縣,成功鎮,0070,47,159,206,53,259,516,50.19%,9.11%,1
臺東縣,成功鎮,0071,115,335,450,95,545,960,56.77%,11.98%,1
臺東縣,成功鎮,0072,21,95,116,18,134,365,36.71%,5.75%,1
臺東縣,成功鎮,0073,61,211,272,73,345,747,46.18%,8.17%,1
臺東縣,成功鎮,0074,27,109,136,24,160,339,47.2%,7.96%,1
臺東縣,成功鎮,0075,119,333,452,24,476,995,47.84%,11.96%,1
臺東縣,成功鎮,0076,106,315,421,61,482,863,55.85%,12.28%,1
臺東縣,成功鎮,0077,108,368,476,34,510,931,54.78%,11.6%,1
臺東縣,成功鎮,0078,107,356,463,32,495,970,51.03%,11.03%,1
臺東縣,成功鎮,0079,127,481,608,90,698,1365,51.14%,9.3%,1
臺東縣,成功鎮,0080,129,521,650,76,726,1366,53.15%,9.44%,1
臺東縣,成功鎮,0081,40,172,212,49,261,516,50.58%,7.75%,1
臺東縣,成功鎮,0082,88,235,323,87,410,887,46.22%,9.92%,1
臺東縣,成功鎮,0083,38,140,178,41,219,488,44.88%,7.79%,1
臺東縣,成功鎮,0084,43,120,163,32,195,481,40.54%,8.94%,1
臺東縣,成功鎮,0085,12,73,85,2,87,373,23.32%,3.22%,1
臺東縣,成功鎮,0086,29,87,116,27,143,264,54.17%,10.98%,1
臺東縣,關山鎮,0087,147,366,513,27,540,909,59.41%,16.17%,1
臺東縣,關山鎮,0088,105,212,317,24,341,790,43.16%,13.29%,1
臺東縣,關山鎮,0089,137,329,466,35,501,828,60.51%,16.55%,1
臺東縣,關山鎮,0090,108,260,368,24,392,887,44.19%,12.18%,1
臺東縣,關山鎮,0091,170,419,589,37,626,1137,55.06%,14.95%,1
臺東縣,關山鎮,0092,81,241,322,34,356,732,48.63%,11.07%,1
臺東縣,關山鎮,0093,123,300,423,48,471,912,51.64%,13.49%,1
臺東縣,關山鎮,0094,93,202,295,18,313,779,40.18%,11.94%,1
臺東縣,關山鎮,0095,68,113,181,23,204,535,38.13%,12.71%,1
臺東縣,卑南鄉,0096,159,382,541,58,599,1041,57.54%,15.27%,1
臺東縣,卑南鄉,0097,170,387,557,22,579,1165,49.7%,14.59%,1
臺東縣,卑南鄉,0098,30,45,75,22,97,219,44.29%,13.7%,1
臺東縣,卑南鄉,0099,65,121,186,36,222,460,48.26%,14.13%,1
臺東縣,卑南鄉,0100,39,98,137,18,155,387,40.05%,10.08%,1
臺東縣,卑南鄉,0101,104,224,328,15,343,767,44.72%,13.56%,1
臺東縣,卑南鄉,0102,62,177,239,33,272,503,54.08%,12.33%,1
臺東縣,卑南鄉,0103,97,203,300,51,351,727,48.28%,13.34%,1
臺東縣,卑南鄉,0104,50,143,193,36,229,436,52.52%,11.47%,1
臺東縣,卑南鄉,0105,29,53,82,14,96,261,36.78%,11.11%,1
臺東縣,卑南鄉,0106,27,78,105,13,118,215,54.88%,12.56%,1
臺東縣,卑南鄉,0107,224,526,750,61,811,1442,56.24%,15.53%,1
臺東縣,卑南鄉,0108,70,180,250,13,263,527,49.91%,13.28%,1
臺東縣,卑南鄉,0109,146,385,531,51,582,1046,55.64%,13.96%,1
臺東縣,卑南鄉,0110,174,362,536,69,605,1110,54.5%,15.68%,1
臺東縣,卑南鄉,0111,180,395,575,54,629,1105,56.92%,16.29%,1
臺東縣,卑南鄉,0112,166,439,605,122,727,1167,62.3%,14.22%,1
臺東縣,卑南鄉,0113,136,286,422,48,470,968,48.55%,14.05%,1
臺東縣,卑南鄉,0114,25,35,60,3,63,159,39.62%,15.72%,1
臺東縣,卑南鄉,0115,50,148,198,20,218,488,44.67%,10.25%,1
臺東縣,卑南鄉,0116,55,127,182,20,202,347,58.21%,15.85%,1
臺東縣,卑南鄉,0117,54,158,212,24,236,436,54.13%,12.39%,1
臺東縣,鹿野鄉,0118,52,136,188,8,196,522,37.55%,9.96%,1
臺東縣,鹿野鄉,0119,83,202,285,21,306,574,53.31%,14.46%,1
臺東縣,鹿野鄉,0120,147,239,386,28,414,1055,39.24%,13.93%,1
臺東縣,鹿野鄉,0121,155,320,475,38,513,1104,46.47%,14.04%,1
臺東縣,鹿野鄉,0122,31,115,146,9,155,342,45.32%,9.06%,1
臺東縣,鹿野鄉,0123,99,287,386,39,425,895,47.49%,11.06%,1
臺東縣,鹿野鄉,0124,119,265,384,39,423,864,48.96%,13.77%,1
臺東縣,鹿野鄉,0125,81,165,246,42,288,675,42.67%,12%,1
臺東縣,鹿野鄉,0126,65,133,198,17,215,435,49.43%,14.94%,1
臺東縣,鹿野鄉,0127,64,103,167,18,185,470,39.36%,13.62%,1
臺東縣,池上鄉,0128,143,307,450,30,480,992,48.39%,14.42%,1
臺東縣,池上鄉,0129,150,328,478,34,512,929,55.11%,16.15%,1
臺東縣,池上鄉,0130,57,127,184,27,211,434,48.62%,13.13%,1
臺東縣,池上鄉,0131,86,190,276,32,308,703,43.81%,12.23%,1
臺東縣,池上鄉,0132,72,190,262,24,286,654,43.73%,11.01%,1
臺東縣,池上鄉,0133,33,75,108,21,129,324,39.81%,10.19%,1
臺東縣,池上鄉,0134,95,224,319,40,359,794,45.21%,11.96%,1
臺東縣,池上鄉,0135,101,252,353,59,412,856,48.13%,11.8%,1
臺東縣,池上鄉,0136,34,93,127,15,142,344,41.28%,9.88%,1
臺東縣,池上鄉,0137,47,109,156,21,177,311,56.91%,15.11%,1
臺東縣,池上鄉,0138,36,87,123,14,137,386,35.49%,9.33%,1
臺東縣,池上鄉,0139,40,93,133,19,152,435,34.94%,9.2%,1
臺東縣,東河鄉,0140,36,65,101,23,124,290,42.76%,12.41%,1
臺東縣,東河鄉,0141,108,201,309,41,350,620,56.45%,17.42%,1
臺東縣,東河鄉,0142,186,435,621,113,734,1196,61.37%,15.55%,1
臺東縣,東河鄉,0143,113,241,354,82,436,918,47.49%,12.31%,1
臺東縣,東河鄉,0144,59,166,225,34,259,555,46.67%,10.63%,1
臺東縣,東河鄉,0145,108,287,395,28,423,977,43.3%,11.05%,1
臺東縣,東河鄉,0146,77,269,346,22,368,1197,30.74%,6.43%,1
臺東縣,東河鄉,0147,34,155,189,22,211,867,24.34%,3.92%,1
臺東縣,東河鄉,0148,42,87,129,19,148,345,42.9%,12.17%,1
臺東縣,東河鄉,0149,37,110,147,25,172,408,42.16%,9.07%,1
臺東縣,東河鄉,0150,31,72,103,11,114,262,43.51%,11.83%,1
臺東縣,長濱鄉,0151,83,175,258,51,309,536,57.65%,15.49%,1
臺東縣,長濱鄉,0152,49,155,204,28,232,689,33.67%,7.11%,1
臺東縣,長濱鄉,0153,103,285,388,103,491,913,53.78%,11.28%,1
臺東縣,長濱鄉,0154,109,325,434,26,460,1268,36.28%,8.6%,1
臺東縣,長濱鄉,0155,66,215,281,60,341,725,47.03%,9.1%,1
臺東縣,長濱鄉,0156,41,93,134,13,147,532,27.63%,7.71%,1
臺東縣,長濱鄉,0157,61,155,216,63,279,660,42.27%,9.24%,1
臺東縣,長濱鄉,0158,15,87,102,5,107,336,31.85%,4.46%,1
臺東縣,長濱鄉,0159,11,39,50,14,64,195,32.82%,5.64%,1
臺東縣,長濱鄉,0160,4,7,11,2,13,25,52%,16%,1
臺東縣,長濱鄉,0161,51,181,232,36,268,605,44.3%,8.43%,1
臺東縣,太麻里鄉,0162,95,247,342,42,384,722,53.19%,13.16%,1
臺東縣,太麻里鄉,0163,64,207,271,23,294,575,51.13%,11.13%,1
臺東縣,太麻里鄉,0164,91,196,287,26,313,623,50.24%,14.61%,1
臺東縣,太麻里鄉,0165,67,202,269,35,304,622,48.87%,10.77%,1
臺東縣,太麻里鄉,0166,58,154,212,15,227,560,40.54%,10.36%,1
臺東縣,太麻里鄉,0167,104,354,458,82,540,957,56.43%,10.87%,1
臺東縣,太麻里鄉,0168,103,240,343,43,386,809,47.71%,12.73%,1
臺東縣,太麻里鄉,0169,129,248,377,38,415,673,61.66%,19.17%,1
臺東縣,太麻里鄉,0170,89,253,342,38,380,737,51.56%,12.08%,1
臺東縣,太麻里鄉,0171,56,159,215,26,241,424,56.84%,13.21%,1
臺東縣,太麻里鄉,0172,51,98,149,30,179,374,47.86%,13.64%,1
臺東縣,太麻里鄉,0173,80,233,313,15,328,829,39.57%,9.65%,1
臺東縣,太麻里鄉,0174,63,276,339,8,347,869,39.93%,7.25%,1
臺東縣,太麻里鄉,0175,16,52,68,5,73,223,32.74%,7.17%,1
臺東縣,太麻里鄉,0176,81,229,310,54,364,669,54.41%,12.11%,1
臺東縣,大武鄉,0177,60,242,302,41,343,568,60.39%,10.56%,1
臺東縣,大武鄉,0178,179,436,615,115,730,1474,49.53%,12.14%,1
臺東縣,大武鄉,0179,177,444,621,87,708,1327,53.35%,13.34%,1
臺東縣,大武鄉,0180,150,306,456,76,532,1134,46.91%,13.23%,1
臺東縣,大武鄉,0181,36,117,153,60,213,386,55.18%,9.33%,1
臺東縣,大武鄉,0182,34,125,159,20,179,377,47.48%,9.02%,1
臺東縣,綠島鄉,0183,176,423,599,26,625,1474,42.4%,11.94%,1
臺東縣,綠島鄉,0184,140,306,446,27,473,1082,43.72%,12.94%,1
臺東縣,綠島鄉,0185,121,242,363,18,381,813,46.86%,14.88%,1
臺東縣,綠島鄉,0186,30,68,98,2,100,210,47.62%,14.29%,1
臺東縣,海端鄉,0187,54,183,237,26,263,497,52.92%,10.87%,1
臺東縣,海端鄉,0188,56,259,315,15,330,569,58%,9.84%,1
臺東縣,海端鄉,0189,124,310,434,47,481,971,49.54%,12.77%,1
臺東縣,海端鄉,0190,67,288,355,38,393,728,53.98%,9.2%,1
臺東縣,海端鄉,0191,41,90,131,16,147,259,56.76%,15.83%,1
臺東縣,海端鄉,0192,31,96,127,13,140,254,55.12%,12.2%,1
臺東縣,延平鄉,0193,130,381,511,32,543,1014,53.55%,12.82%,1
臺東縣,延平鄉,0194,52,195,247,50,297,426,69.72%,12.21%,1
臺東縣,延平鄉,0195,36,151,187,22,209,315,66.35%,11.43%,1
臺東縣,延平鄉,0196,58,196,254,21,275,579,47.5%,10.02%,1
臺東縣,延平鄉,0197,59,195,254,21,275,596,46.14%,9.9%,1
臺東縣,金峰鄉,0198,149,405,554,45,599,1241,48.27%,12.01%,1
臺東縣,金峰鄉,0199,104,260,364,32,396,601,65.89%,17.3%,1
臺東縣,金峰鄉,0200,109,244,353,40,393,520,75.58%,20.96%,1
臺東縣,金峰鄉,0201,44,123,167,22,189,336,56.25%,13.1%,1
臺東縣,金峰鄉,0202,48,144,192,31,223,330,67.58%,14.55%,1
臺東縣,達仁鄉,0203,30,115,145,9,154,246,62.6%,12.2%,1
臺東縣,達仁鄉,0204,25,168,193,25,218,340,64.12%,7.35%,1
臺東縣,達仁鄉,0205,43,135,178,17,195,296,65.88%,14.53%,1
臺東縣,達仁鄉,0206,57,204,261,20,281,429,65.5%,13.29%,1
臺東縣,達仁鄉,0207,33,154,187,29,216,331,65.26%,9.97%,1
臺東縣,達仁鄉,0208,74,191,265,19,284,628,45.22%,11.78%,1
臺東縣,達仁鄉,0209,120,294,414,69,483,867,55.71%,13.84%,1
臺東縣,蘭嶼鄉,0210,83,275,358,27,385,943,40.83%,8.8%,1
臺東縣,蘭嶼鄉,0211,146,342,488,41,529,1238,42.73%,11.79%,1
臺東縣,蘭嶼鄉,0212,122,266,388,20,408,1240,32.9%,9.84%,1
臺東縣,蘭嶼鄉,0213,101,149,250,29,279,760,36.71%,13.29%,1
澎湖縣,馬公市,0001,68,147,215,10,225,481,46.78%,14.14%,1
澎湖縣,馬公市,0002,70,203,273,18,291,558,52.15%,12.54%,1
澎湖縣,馬公市,0003,60,165,225,38,263,533,49.34%,11.26%,1
澎湖縣,馬公市,0004,137,298,435,32,467,922,50.65%,14.86%,1
澎湖縣,馬公市,0005,191,328,519,30,549,1021,53.77%,18.71%,1
澎湖縣,馬公市,0006,131,247,378,29,407,793,51.32%,16.52%,1
澎湖縣,馬公市,0007,149,322,471,40,511,954,53.56%,15.62%,1
澎湖縣,馬公市,0008,147,332,479,26,505,1001,50.45%,14.69%,1
澎湖縣,馬公市,0009,165,338,503,32,535,1192,44.88%,13.84%,1
澎湖縣,馬公市,0010,163,450,613,50,663,1402,47.29%,11.63%,1
澎湖縣,馬公市,0011,207,481,688,25,713,1389,51.33%,14.9%,1
澎湖縣,馬公市,0012,193,465,658,37,695,1339,51.9%,14.41%,1
澎湖縣,馬公市,0013,152,409,561,37,598,1254,47.69%,12.12%,1
澎湖縣,馬公市,0014,166,392,558,43,601,1194,50.34%,13.9%,1
澎湖縣,馬公市,0015,180,452,632,40,672,1393,48.24%,12.92%,1
澎湖縣,馬公市,0016,235,494,729,25,754,1440,52.36%,16.32%,1
澎湖縣,馬公市,0017,173,376,549,47,596,1215,49.05%,14.24%,1
澎湖縣,馬公市,0018,161,423,584,48,632,1284,49.22%,12.54%,1
澎湖縣,馬公市,0019,196,492,688,58,746,1512,49.34%,12.96%,1
澎湖縣,馬公市,0020,156,365,521,46,567,1181,48.01%,13.21%,1
澎湖縣,馬公市,0021,191,447,638,41,679,1348,50.37%,14.17%,1
澎湖縣,馬公市,0022,233,464,697,22,719,1391,51.69%,16.75%,1
澎湖縣,馬公市,0023,688,246,934,15,949,2124,44.68%,32.39%,1
澎湖縣,馬公市,0024,202,502,704,43,747,1500,49.8%,13.47%,1
澎湖縣,馬公市,0025,199,544,743,36,779,1582,49.24%,12.58%,1
澎湖縣,馬公市,0026,211,560,771,27,798,1638,48.72%,12.88%,1
澎湖縣,馬公市,0027,214,553,767,43,810,1554,52.12%,13.77%,1
澎湖縣,馬公市,0028,102,264,366,17,383,980,39.08%,10.41%,1
澎湖縣,馬公市,0029,131,299,430,23,453,892,50.78%,14.69%,1
澎湖縣,馬公市,0030,107,202,309,13,322,778,41.39%,13.75%,1
澎湖縣,馬公市,0031,133,314,447,26,473,930,50.86%,14.3%,1
澎湖縣,馬公市,0032,228,599,827,32,859,1481,58%,15.4%,1
澎湖縣,馬公市,0033,144,438,582,17,599,1128,53.1%,12.77%,1
澎湖縣,馬公市,0034,46,157,203,21,224,415,53.98%,11.08%,1
澎湖縣,馬公市,0035,142,375,517,41,558,1120,49.82%,12.68%,1
澎湖縣,馬公市,0036,126,370,496,19,515,950,54.21%,13.26%,1
澎湖縣,馬公市,0037,72,189,261,21,282,627,44.98%,11.48%,1
澎湖縣,馬公市,0038,137,381,518,20,538,1055,51%,12.99%,1
澎湖縣,馬公市,0039,118,358,476,42,518,989,52.38%,11.93%,1
澎湖縣,馬公市,0040,89,208,297,33,330,591,55.84%,15.06%,1
澎湖縣,馬公市,0041,190,413,603,53,656,1387,47.3%,13.7%,1
澎湖縣,馬公市,0042,123,290,413,54,467,1079,43.28%,11.4%,1
澎湖縣,馬公市,0043,86,276,362,38,400,797,50.19%,10.79%,1
澎湖縣,馬公市,0044,105,290,395,18,413,903,45.74%,11.63%,1
澎湖縣,馬公市,0045,62,100,162,15,177,376,47.07%,16.49%,1
澎湖縣,馬公市,0046,50,129,179,16,195,371,52.56%,13.48%,1
澎湖縣,馬公市,0047,99,337,436,19,455,1173,38.79%,8.44%,1
澎湖縣,馬公市,0048,140,325,465,19,484,1389,34.85%,10.08%,1
澎湖縣,馬公市,0049,53,100,153,60,213,761,27.99%,6.96%,1
澎湖縣,馬公市,0050,51,109,160,16,176,288,61.11%,17.71%,1
澎湖縣,湖西鄉,0051,136,400,536,52,588,1120,52.5%,12.14%,1
澎湖縣,湖西鄉,0052,37,98,135,7,142,332,42.77%,11.14%,1
澎湖縣,湖西鄉,0053,28,61,89,6,95,242,39.26%,11.57%,1
澎湖縣,湖西鄉,0054,27,70,97,5,102,293,34.81%,9.22%,1
澎湖縣,湖西鄉,0055,57,179,236,38,274,666,41.14%,8.56%,1
澎湖縣,湖西鄉,0056,33,113,146,16,162,326,49.69%,10.12%,1
澎湖縣,湖西鄉,0057,83,198,281,16,297,732,40.57%,11.34%,1
澎湖縣,湖西鄉,0058,73,198,271,29,300,651,46.08%,11.21%,1
澎湖縣,湖西鄉,0059,96,217,313,12,325,744,43.68%,12.9%,1
澎湖縣,湖西鄉,0060,18,52,70,3,73,134,54.48%,13.43%,1
澎湖縣,湖西鄉,0061,91,160,251,24,275,794,34.63%,11.46%,1
澎湖縣,湖西鄉,0062,23,52,75,3,78,216,36.11%,10.65%,1
澎湖縣,湖西鄉,0063,51,139,190,9,199,664,29.97%,7.68%,1
澎湖縣,湖西鄉,0064,39,86,125,7,132,279,47.31%,13.98%,1
澎湖縣,湖西鄉,0065,32,113,145,5,150,296,50.68%,10.81%,1
澎湖縣,湖西鄉,0066,39,79,118,4,122,257,47.47%,15.18%,1
澎湖縣,湖西鄉,0067,4,23,27,2,29,89,32.58%,4.49%,1
澎湖縣,湖西鄉,0068,128,235,363,27,390,815,47.85%,15.71%,1
澎湖縣,湖西鄉,0069,100,271,371,19,390,975,40%,10.26%,1
澎湖縣,湖西鄉,0070,84,202,286,29,315,648,48.61%,12.96%,1
澎湖縣,湖西鄉,0071,104,242,346,28,374,893,41.88%,11.65%,1
澎湖縣,湖西鄉,0072,113,271,384,54,438,846,51.77%,13.36%,1
澎湖縣,湖西鄉,0073,77,181,258,12,270,729,37.04%,10.56%,1
澎湖縣,白沙鄉,0074,77,161,238,17,255,514,49.61%,14.98%,1
澎湖縣,白沙鄉,0075,86,239,325,15,340,657,51.75%,13.09%,1
澎湖縣,白沙鄉,0076,13,55,68,4,72,109,66.06%,11.93%,1
澎湖縣,白沙鄉,0077,16,47,63,3,66,156,42.31%,10.26%,1
澎湖縣,白沙鄉,0078,36,80,116,5,121,293,41.3%,12.29%,1
澎湖縣,白沙鄉,0079,22,50,72,0,72,231,31.17%,9.52%,1
澎湖縣,白沙鄉,0080,29,52,81,6,87,161,54.04%,18.01%,1
澎湖縣,白沙鄉,0081,200,537,737,48,785,1705,46.04%,11.73%,1
澎湖縣,白沙鄉,0082,30,88,118,7,125,285,43.86%,10.53%,1
澎湖縣,白沙鄉,0083,67,140,207,16,223,723,30.84%,9.27%,1
澎湖縣,白沙鄉,0084,86,170,256,30,286,774,36.95%,11.11%,1
澎湖縣,白沙鄉,0085,138,276,414,87,501,1429,35.06%,9.66%,1
澎湖縣,白沙鄉,0086,71,380,451,49,500,1084,46.13%,6.55%,1
澎湖縣,白沙鄉,0087,41,77,118,8,126,251,50.2%,16.33%,1
澎湖縣,白沙鄉,0088,35,43,78,14,92,253,36.36%,13.83%,1
澎湖縣,西嶼鄉,0089,11,34,45,1,46,283,16.25%,3.89%,1
澎湖縣,西嶼鄉,0090,48,62,110,14,124,424,29.25%,11.32%,1
澎湖縣,西嶼鄉,0091,88,148,236,49,285,826,34.5%,10.65%,1
澎湖縣,西嶼鄉,0092,22,77,99,10,109,282,38.65%,7.8%,1
澎湖縣,西嶼鄉,0093,73,145,218,43,261,661,39.49%,11.04%,1
澎湖縣,西嶼鄉,0094,9,17,26,3,29,141,20.57%,6.38%,1
澎湖縣,西嶼鄉,0095,45,142,187,10,197,635,31.02%,7.09%,1
澎湖縣,西嶼鄉,0096,15,55,70,3,73,216,33.8%,6.94%,1
澎湖縣,西嶼鄉,0097,39,81,120,20,140,572,24.48%,6.82%,1
澎湖縣,西嶼鄉,0098,115,354,469,49,518,1267,40.88%,9.08%,1
澎湖縣,西嶼鄉,0099,84,214,298,28,326,942,34.61%,8.92%,1
澎湖縣,西嶼鄉,0100,135,269,404,46,450,1133,39.72%,11.92%,1
澎湖縣,望安鄉,0101,99,203,302,30,332,734,45.23%,13.49%,1
澎湖縣,望安鄉,0102,35,141,176,14,190,454,41.85%,7.71%,1
澎湖縣,望安鄉,0103,27,71,98,7,105,300,35%,9%,1
澎湖縣,望安鄉,0104,60,145,205,34,239,471,50.74%,12.74%,1
澎湖縣,望安鄉,0105,64,138,202,18,220,672,32.74%,9.52%,1
澎湖縣,望安鄉,0106,69,195,264,38,302,742,40.7%,9.3%,1
澎湖縣,望安鄉,0107,26,68,94,15,109,264,41.29%,9.85%,1
澎湖縣,望安鄉,0108,58,137,195,1,196,476,41.18%,12.18%,1
澎湖縣,望安鄉,0109,24,29,53,3,56,208,26.92%,11.54%,1
澎湖縣,望安鄉,0110,25,59,84,7,91,307,29.64%,8.14%,1
澎湖縣,七美鄉,0111,29,33,62,4,66,248,26.61%,11.69%,1
澎湖縣,七美鄉,0112,61,122,183,21,204,581,35.11%,10.5%,1
澎湖縣,七美鄉,0113,78,119,197,29,226,641,35.26%,12.17%,1
澎湖縣,七美鄉,0114,31,85,116,2,118,382,30.89%,8.12%,1
澎湖縣,七美鄉,0115,24,55,79,6,85,351,24.22%,6.84%,1
澎湖縣,七美鄉,0116,103,200,303,16,319,1171,27.24%,8.8%,1
金門縣,金城鎮,0001,115,358,473,30,503,1396,36.03%,8.24%,1
金門縣,金城鎮,0002,170,501,671,24,695,1831,37.96%,9.28%,1
金門縣,金城鎮,0003,146,464,610,32,642,1750,36.69%,8.34%,1
金門縣,金城鎮,0004,167,495,662,55,717,1889,37.96%,8.84%,1
金門縣,金城鎮,0005,165,346,511,25,536,1675,32%,9.85%,1
金門縣,金城鎮,0006,163,592,755,23,778,1901,40.93%,8.57%,1
金門縣,金城鎮,0007,163,352,515,42,557,1610,34.6%,10.12%,1
金門縣,金城鎮,0008,143,428,571,31,602,1687,35.68%,8.48%,1
金門縣,金城鎮,0009,225,339,564,17,581,1594,36.45%,14.12%,1
金門縣,金城鎮,0010,156,449,605,13,618,1726,35.81%,9.04%,1
金門縣,金城鎮,0011,153,461,614,17,631,1733,36.41%,8.83%,1
金門縣,金城鎮,0012,140,449,589,27,616,1532,40.21%,9.14%,1
金門縣,金城鎮,0013,168,511,679,42,721,2079,34.68%,8.08%,1
金門縣,金城鎮,0014,177,451,628,25,653,2033,32.12%,8.71%,1
金門縣,金城鎮,0015,220,614,834,48,882,2517,35.04%,8.74%,1
金門縣,金城鎮,0016,172,521,693,37,730,2083,35.05%,8.26%,1
金門縣,金城鎮,0017,148,554,702,33,735,2140,34.35%,6.92%,1
金門縣,金城鎮,0018,163,507,670,50,720,2435,29.57%,6.69%,1
金門縣,金城鎮,0019,67,259,326,19,345,1353,25.5%,4.95%,1
金門縣,金城鎮,0020,100,374,474,19,493,1574,31.32%,6.35%,1
金門縣,金城鎮,0021,120,322,442,36,478,1277,37.43%,9.4%,1
金門縣,金沙鎮,0066,120,498,618,42,660,1909,34.57%,6.29%,1
金門縣,金沙鎮,0067,125,468,593,32,625,1524,41.01%,8.2%,1
金門縣,金沙鎮,0068,96,422,518,29,547,1673,32.7%,5.74%,1
金門縣,金沙鎮,0069,112,516,628,30,658,2003,32.85%,5.59%,1
金門縣,金沙鎮,0070,106,361,467,26,493,1212,40.68%,8.75%,1
金門縣,金沙鎮,0071,90,292,382,27,409,1126,36.32%,7.99%,1
金門縣,金沙鎮,0072,97,354,451,28,479,1540,31.1%,6.3%,1
金門縣,金沙鎮,0073,73,285,358,20,378,1216,31.09%,6%,1
金門縣,金沙鎮,0074,46,202,248,11,259,950,27.26%,4.84%,1
金門縣,金沙鎮,0075,122,547,669,32,701,1895,36.99%,6.44%,1
金門縣,金沙鎮,0076,84,346,430,32,462,1135,40.7%,7.4%,1
金門縣,金沙鎮,0077,96,317,413,25,438,1252,34.98%,7.67%,1
金門縣,金沙鎮,0078,91,359,450,13,463,1125,41.16%,8.09%,1
金門縣,金湖鎮,0049,144,368,512,28,540,1348,40.06%,10.68%,1
金門縣,金湖鎮,0050,119,344,463,26,489,1386,35.28%,8.59%,1
金門縣,金湖鎮,0051,130,449,579,26,605,1403,43.12%,9.27%,1
金門縣,金湖鎮,0052,155,493,648,26,674,1771,38.06%,8.75%,1
金門縣,金湖鎮,0053,143,368,511,45,556,1493,37.24%,9.58%,1
金門縣,金湖鎮,0054,99,382,481,54,535,1510,35.43%,6.56%,1
金門縣,金湖鎮,0055,131,448,579,30,609,1607,37.9%,8.15%,1
金門縣,金湖鎮,0056,140,498,638,32,670,2006,33.4%,6.98%,1
金門縣,金湖鎮,0057,196,416,612,30,642,1780,36.07%,11.01%,1
金門縣,金湖鎮,0058,176,442,618,17,635,1739,36.52%,10.12%,1
金門縣,金湖鎮,0059,115,340,455,24,479,1384,34.61%,8.31%,1
金門縣,金湖鎮,0060,139,363,502,26,528,1400,37.71%,9.93%,1
金門縣,金湖鎮,0061,151,420,571,16,587,1325,44.3%,11.4%,1
金門縣,金湖鎮,0062,102,292,394,20,414,1236,33.5%,8.25%,1
金門縣,金湖鎮,0063,112,333,445,35,480,1382,34.73%,8.1%,1
金門縣,金湖鎮,0064,99,441,540,20,560,1631,34.33%,6.07%,1
金門縣,金湖鎮,0065,99,359,458,35,493,1514,32.56%,6.54%,1
金門縣,金寧鄉,0022,99,385,484,57,541,1735,31.18%,5.71%,1
金門縣,金寧鄉,0023,112,352,464,22,486,1537,31.62%,7.29%,1
金門縣,金寧鄉,0024,178,382,560,35,595,1766,33.69%,10.08%,1
金門縣,金寧鄉,0025,93,264,357,18,375,1015,36.95%,9.16%,1
金門縣,金寧鄉,0026,117,460,577,33,610,1726,35.34%,6.78%,1
金門縣,金寧鄉,0027,121,396,517,21,538,1691,31.82%,7.16%,1
金門縣,金寧鄉,0028,538,307,845,21,866,2044,42.37%,26.32%,1
金門縣,金寧鄉,0029,191,545,736,28,764,1848,41.34%,10.34%,1
金門縣,金寧鄉,0030,156,437,593,27,620,1735,35.73%,8.99%,1
金門縣,金寧鄉,0031,162,434,596,31,627,1795,34.93%,9.03%,1
金門縣,金寧鄉,0032,97,446,543,38,581,1834,31.68%,5.29%,1
金門縣,金寧鄉,0033,126,367,493,19,512,1528,33.51%,8.25%,1
金門縣,金寧鄉,0034,120,424,544,24,568,1473,38.56%,8.15%,1
金門縣,金寧鄉,0035,147,429,576,26,602,1679,35.85%,8.76%,1
金門縣,金寧鄉,0036,674,245,919,14,933,1921,48.57%,35.09%,1
金門縣,金寧鄉,0037,126,326,452,15,467,1298,35.98%,9.71%,1
金門縣,金寧鄉,0038,113,374,487,19,506,1537,32.92%,7.35%,1
金門縣,烈嶼鄉,0039,149,553,702,20,722,1647,43.84%,9.05%,1
金門縣,烈嶼鄉,0040,121,462,583,34,617,1733,35.6%,6.98%,1
金門縣,烈嶼鄉,0041,128,455,583,24,607,1635,37.13%,7.83%,1
金門縣,烈嶼鄉,0042,103,319,422,18,440,1296,33.95%,7.95%,1
金門縣,烈嶼鄉,0043,63,273,336,20,356,1099,32.39%,5.73%,1
金門縣,烈嶼鄉,0044,108,347,455,28,483,1425,33.89%,7.58%,1
金門縣,烈嶼鄉,0045,96,413,509,16,525,1412,37.18%,6.8%,1
金門縣,烈嶼鄉,0046,101,380,481,26,507,1429,35.48%,7.07%,1
金門縣,烏坵鄉,0047,22,54,76,2,78,275,28.36%,8%,1
金門縣,烏坵鄉,0048,16,71,87,0,87,292,29.79%,5.48%,1
連江縣,南竿鄉,0001,296,690,986,28,1014,1967,51.55%,15.05%,1
連江縣,南竿鄉,0002,224,622,846,38,884,1837,48.12%,12.19%,1
連江縣,南竿鄉,0003,163,407,570,18,588,1114,52.78%,14.63%,1
連江縣,南竿鄉,0004,166,623,789,14,803,1543,52.04%,10.76%,1
連江縣,北竿鄉,0005,189,599,788,26,814,1515,53.73%,12.48%,1
連江縣,北竿鄉,0006,77,212,289,7,296,610,48.52%,12.62%,1
連江縣,莒光鄉,0007,96,235,331,11,342,698,49%,13.75%,1
連江縣,莒光鄉,0008,104,325,429,14,443,783,56.58%,13.28%,1
連江縣,東引鄉,0009,165,397,562,15,577,1138,50.7%,14.5%,1
基隆市,中正區,0001,85,159,244,14,258,466,55.36%,18.24%,1
基隆市,中正區,0002,175,341,516,24,540,1262,42.79%,13.87%,1
基隆市,中正區,0003,160,355,515,41,556,1171,47.48%,13.66%,1
基隆市,中正區,0004,332,711,1043,18,1061,2823,37.58%,11.76%,1
基隆市,中正區,0005,195,388,583,49,632,1474,42.88%,13.23%,1
基隆市,中正區,0006,192,312,504,50,554,1271,43.59%,15.11%,1
基隆市,中正區,0007,364,742,1106,61,1167,2707,43.11%,13.45%,1
基隆市,中正區,0008,202,472,674,76,750,1545,48.54%,13.07%,1
基隆市,中正區,0009,85,204,289,16,305,761,40.08%,11.17%,1
基隆市,中正區,0010,228,405,633,22,655,1352,48.45%,16.86%,1
基隆市,中正區,0011,184,458,642,15,657,1413,46.5%,13.02%,1
基隆市,中正區,0012,360,756,1116,36,1152,2665,43.23%,13.51%,1
基隆市,中正區,0013,168,351,519,59,578,1261,45.84%,13.32%,1
基隆市,中正區,0014,466,331,797,82,879,1753,50.14%,26.58%,1
基隆市,中正區,0015,116,275,391,53,444,984,45.12%,11.79%,1
基隆市,中正區,0016,137,388,525,29,554,1166,47.51%,11.75%,1
基隆市,中正區,0017,157,288,445,25,470,973,48.3%,16.14%,1
基隆市,中正區,0018,262,354,616,23,639,1694,37.72%,15.47%,1
基隆市,中正區,0019,217,391,608,30,638,1270,50.24%,17.09%,1
基隆市,中正區,0020,164,372,536,42,578,1090,53.03%,15.05%,1
基隆市,中正區,0021,140,303,443,16,459,870,52.76%,16.09%,1
基隆市,中正區,0022,191,344,535,38,573,1138,50.35%,16.78%,1
基隆市,中正區,0023,129,249,378,44,422,862,48.96%,14.97%,1
基隆市,中正區,0024,245,439,684,54,738,1341,55.03%,18.27%,1
基隆市,中正區,0025,135,295,430,35,465,859,54.13%,15.72%,1
基隆市,中正區,0026,214,436,650,23,673,1457,46.19%,14.69%,1
基隆市,中正區,0027,222,392,614,37,651,1594,40.84%,13.93%,1
基隆市,中正區,0028,147,247,394,35,429,802,53.49%,18.33%,1
基隆市,中正區,0029,182,407,589,34,623,1267,49.17%,14.36%,1
基隆市,中正區,0030,213,362,575,49,624,1175,53.11%,18.13%,1
基隆市,中正區,0031,217,422,639,45,684,1210,56.53%,17.93%,1
基隆市,中正區,0032,181,321,502,45,547,1037,52.75%,17.45%,1
基隆市,中正區,0033,211,385,596,43,639,1219,52.42%,17.31%,1
基隆市,中正區,0034,160,266,426,26,452,904,50%,17.7%,1
基隆市,中正區,0035,147,260,407,35,442,709,62.34%,20.73%,1
基隆市,七堵區,0219,209,436,645,63,708,1258,56.28%,16.61%,1
基隆市,七堵區,0220,214,433,647,42,689,1237,55.7%,17.3%,1
基隆市,七堵區,0221,239,384,623,26,649,1259,51.55%,18.98%,1
基隆市,七堵區,0222,178,337,515,52,567,1120,50.63%,15.89%,1
基隆市,七堵區,0223,202,398,600,43,643,1344,47.84%,15.03%,1
基隆市,七堵區,0224,203,378,581,38,619,1011,61.23%,20.08%,1
基隆市,七堵區,0225,172,295,467,13,480,925,51.89%,18.59%,1
基隆市,七堵區,0226,270,649,919,53,972,1735,56.02%,15.56%,1
基隆市,七堵區,0227,343,656,999,37,1036,1833,56.52%,18.71%,1
基隆市,七堵區,0228,172,325,497,18,515,938,54.9%,18.34%,1
基隆市,七堵區,0229,173,351,524,48,572,962,59.46%,17.98%,1
基隆市,七堵區,0230,209,439,648,27,675,1191,56.68%,17.55%,1
基隆市,七堵區,0231,143,381,524,44,568,999,56.86%,14.31%,1
基隆市,七堵區,0232,45,81,126,12,138,282,48.94%,15.96%,1
基隆市,七堵區,0233,223,376,599,41,640,1243,51.49%,17.94%,1
基隆市,七堵區,0234,176,352,528,43,571,1092,52.29%,16.12%,1
基隆市,七堵區,0235,212,423,635,38,673,1246,54.01%,17.01%,1
基隆市,七堵區,0236,326,512,838,29,867,1722,50.35%,18.93%,1
基隆市,七堵區,0237,212,467,679,32,711,1318,53.95%,16.08%,1
基隆市,七堵區,0238,146,298,444,19,463,975,47.49%,14.97%,1
基隆市,七堵區,0239,225,421,646,29,675,1285,52.53%,17.51%,1
基隆市,七堵區,0240,165,321,486,37,523,1077,48.56%,15.32%,1
基隆市,七堵區,0241,179,266,445,25,470,989,47.52%,18.1%,1
基隆市,七堵區,0242,197,371,568,30,598,1193,50.13%,16.51%,1
基隆市,七堵區,0243,213,424,637,32,669,1273,52.55%,16.73%,1
基隆市,七堵區,0244,307,575,882,68,950,1774,53.55%,17.31%,1
基隆市,七堵區,0245,314,526,840,64,904,1689,53.52%,18.59%,1
基隆市,七堵區,0246,234,406,640,49,689,1355,50.85%,17.27%,1
基隆市,七堵區,0247,288,439,727,40,767,1512,50.73%,19.05%,1
基隆市,七堵區,0248,246,461,707,18,725,1486,48.79%,16.55%,1
基隆市,七堵區,0249,314,512,826,33,859,1706,50.35%,18.41%,1
基隆市,七堵區,0250,230,480,710,48,758,1384,54.77%,16.62%,1
基隆市,七堵區,0251,219,369,588,39,627,1045,60%,20.96%,1
基隆市,七堵區,0252,255,448,703,30,733,1374,53.35%,18.56%,1
基隆市,七堵區,0253,83,133,216,12,228,428,53.27%,19.39%,1
基隆市,七堵區,0254,50,118,168,29,197,326,60.43%,15.34%,1
基隆市,七堵區,0255,77,157,234,16,250,351,71.23%,21.94%,1
基隆市,七堵區,0256,298,566,864,30,894,1871,47.78%,15.93%,1
基隆市,七堵區,0257,56,143,199,9,208,448,46.43%,12.5%,1
基隆市,暖暖區,0191,222,449,671,34,705,1431,49.27%,15.51%,1
基隆市,暖暖區,0192,68,146,214,6,220,456,48.25%,14.91%,1
基隆市,暖暖區,0193,122,216,338,20,358,637,56.2%,19.15%,1
基隆市,暖暖區,0194,136,271,407,24,431,735,58.64%,18.5%,1
基隆市,暖暖區,0195,163,325,488,28,516,1078,47.87%,15.12%,1
基隆市,暖暖區,0196,216,400,616,35,651,1238,52.58%,17.45%,1
基隆市,暖暖區,0197,228,426,654,25,679,1325,51.25%,17.21%,1
基隆市,暖暖區,0198,291,461,752,25,777,1475,52.68%,19.73%,1
基隆市,暖暖區,0199,110,421,531,28,559,1179,47.41%,9.33%,1
基隆市,暖暖區,0200,223,404,627,29,656,1110,59.1%,20.09%,1
基隆市,暖暖區,0201,223,429,652,17,669,1443,46.36%,15.45%,1
基隆市,暖暖區,0202,64,144,208,16,224,415,53.98%,15.42%,1
基隆市,暖暖區,0203,255,407,662,20,682,1378,49.49%,18.51%,1
基隆市,暖暖區,0204,293,511,804,26,830,1570,52.87%,18.66%,1
基隆市,暖暖區,0205,306,574,880,55,935,1603,58.33%,19.09%,1
基隆市,暖暖區,0206,227,472,699,30,729,1267,57.54%,17.92%,1
基隆市,暖暖區,0207,225,458,683,31,714,1359,52.54%,16.56%,1
基隆市,暖暖區,0208,155,394,549,20,569,970,58.66%,15.98%,1
基隆市,暖暖區,0209,176,340,516,17,533,1002,53.19%,17.56%,1
基隆市,暖暖區,0210,170,288,458,23,481,944,50.95%,18.01%,1
基隆市,暖暖區,0211,373,447,820,23,843,1500,56.2%,24.87%,1
基隆市,暖暖區,0212,188,385,573,20,593,1442,41.12%,13.04%,1
基隆市,暖暖區,0213,216,400,616,15,631,1165,54.16%,18.54%,1
基隆市,暖暖區,0214,266,531,797,22,819,1610,50.87%,16.52%,1
基隆市,暖暖區,0215,254,448,702,27,729,1328,54.89%,19.13%,1
基隆市,暖暖區,0216,216,384,600,16,616,1173,52.51%,18.41%,1
基隆市,暖暖區,0217,221,354,575,27,602,1019,59.08%,21.69%,1
基隆市,暖暖區,0218,262,463,725,20,745,1373,54.26%,19.08%,1
基隆市,仁愛區,0072,246,489,735,88,823,1782,46.18%,13.8%,1
基隆市,仁愛區,0073,186,369,555,43,598,1055,56.68%,17.63%,1
基隆市,仁愛區,0074,230,474,704,29,733,1558,47.05%,14.76%,1
基隆市,仁愛區,0075,273,571,844,50,894,1736,51.5%,15.73%,1
基隆市,仁愛區,0076,208,488,696,37,733,1243,58.97%,16.73%,1
基隆市,仁愛區,0077,175,415,590,32,622,1109,56.09%,15.78%,1
基隆市,仁愛區,0078,288,638,926,36,962,1684,57.13%,17.1%,1
基隆市,仁愛區,0079,185,287,472,36,508,919,55.28%,20.13%,1
基隆市,仁愛區,0080,198,289,487,17,504,991,50.86%,19.98%,1
基隆市,仁愛區,0081,153,294,447,25,472,876,53.88%,17.47%,1
基隆市,仁愛區,0082,188,394,582,29,611,1046,58.41%,17.97%,1
基隆市,仁愛區,0083,79,162,241,22,263,434,60.6%,18.2%,1
基隆市,仁愛區,0084,141,258,399,47,446,764,58.38%,18.46%,1
基隆市,仁愛區,0085,181,300,481,20,501,968,51.76%,18.7%,1
基隆市,仁愛區,0086,217,425,642,44,686,1326,51.73%,16.37%,1
基隆市,仁愛區,0087,189,346,535,38,573,1315,43.57%,14.37%,1
基隆市,仁愛區,0088,134,280,414,35,449,775,57.94%,17.29%,1
基隆市,仁愛區,0089,120,206,326,48,374,652,57.36%,18.4%,1
基隆市,仁愛區,0090,139,210,349,28,377,674,55.93%,20.62%,1
基隆市,仁愛區,0091,144,239,383,27,410,789,51.96%,18.25%,1
基隆市,仁愛區,0092,280,555,835,68,903,1715,52.65%,16.33%,1
基隆市,仁愛區,0093,176,242,418,41,459,849,54.06%,20.73%,1
基隆市,仁愛區,0094,146,207,353,18,371,875,42.4%,16.69%,1
基隆市,仁愛區,0095,159,243,402,34,436,851,51.23%,18.68%,1
基隆市,仁愛區,0096,150,245,395,32,427,735,58.1%,20.41%,1
基隆市,仁愛區,0097,163,316,479,58,537,1009,53.22%,16.15%,1
基隆市,仁愛區,0098,163,316,479,53,532,1082,49.17%,15.06%,1
基隆市,仁愛區,0099,213,384,597,64,661,1278,51.72%,16.67%,1
基隆市,仁愛區,0100,293,543,836,31,867,1519,57.08%,19.29%,1
基隆市,仁愛區,0101,225,342,567,34,601,1336,44.99%,16.84%,1
基隆市,仁愛區,0102,216,415,631,41,672,1178,57.05%,18.34%,1
基隆市,仁愛區,0103,129,218,347,35,382,708,53.95%,18.22%,1
基隆市,仁愛區,0104,122,203,325,30,355,567,62.61%,21.52%,1
基隆市,仁愛區,0105,154,222,376,38,414,751,55.13%,20.51%,1
基隆市,仁愛區,0106,127,208,335,18,353,589,59.93%,21.56%,1
基隆市,中山區,0107,137,248,385,25,410,796,51.51%,17.21%,1
基隆市,中山區,0108,193,405,598,42,640,1036,61.78%,18.63%,1
基隆市,中山區,0109,133,259,392,44,436,756,57.67%,17.59%,1
基隆市,中山區,0110,174,241,415,18,433,957,45.25%,18.18%,1
基隆市,中山區,0111,149,276,425,8,433,802,53.99%,18.58%,1
基隆市,中山區,0112,222,416,638,37,675,1263,53.44%,17.58%,1
基隆市,中山區,0113,124,305,429,20,449,778,57.71%,15.94%,1
基隆市,中山區,0114,212,371,583,72,655,1180,55.51%,17.97%,1
基隆市,中山區,0115,150,299,449,27,476,990,48.08%,15.15%,1
基隆市,中山區,0116,185,346,531,17,548,1332,41.14%,13.89%,1
基隆市,中山區,0117,146,240,386,23,409,848,48.23%,17.22%,1
基隆市,中山區,0118,139,300,439,20,459,922,49.78%,15.08%,1
基隆市,中山區,0119,77,182,259,13,272,459,59.26%,16.78%,1
基隆市,中山區,0120,81,180,261,23,284,574,49.48%,14.11%,1
基隆市,中山區,0121,148,273,421,34,455,877,51.88%,16.88%,1
基隆市,中山區,0122,238,446,684,33,717,1584,45.27%,15.03%,1
基隆市,中山區,0123,130,323,453,29,482,1319,36.54%,9.86%,1
基隆市,中山區,0124,321,599,920,65,985,1938,50.83%,16.56%,1
基隆市,中山區,0125,344,531,875,29,904,1877,48.16%,18.33%,1
基隆市,中山區,0126,357,734,1091,28,1119,2088,53.59%,17.1%,1
基隆市,中山區,0127,354,676,1030,16,1046,1946,53.75%,18.19%,1
基隆市,中山區,0128,236,486,722,47,769,1353,56.84%,17.44%,1
基隆市,中山區,0129,206,429,635,48,683,1317,51.86%,15.64%,1
基隆市,中山區,0130,162,312,474,22,496,870,57.01%,18.62%,1
基隆市,中山區,0131,221,481,702,21,723,1322,54.69%,16.72%,1
基隆市,中山區,0132,198,384,582,22,604,1295,46.64%,15.29%,1
基隆市,中山區,0133,137,299,436,24,460,756,60.85%,18.12%,1
基隆市,中山區,0134,240,458,698,29,727,1602,45.38%,14.98%,1
基隆市,中山區,0135,231,480,711,38,749,1568,47.77%,14.73%,1
基隆市,中山區,0136,244,457,701,37,738,1404,52.56%,17.38%,1
基隆市,中山區,0137,292,587,879,24,903,1909,47.3%,15.3%,1
基隆市,中山區,0138,249,548,797,63,860,1642,52.38%,15.16%,1
基隆市,中山區,0139,152,275,427,21,448,932,48.07%,16.31%,1
基隆市,中山區,0140,173,299,472,43,515,849,60.66%,20.38%,1
基隆市,中山區,0141,174,217,391,35,426,715,59.58%,24.34%,1
基隆市,安樂區,0142,194,421,615,50,665,1361,48.86%,14.25%,1
基隆市,安樂區,0143,177,383,560,30,590,1213,48.64%,14.59%,1
基隆市,安樂區,0144,135,315,450,17,467,1026,45.52%,13.16%,1
基隆市,安樂區,0145,169,385,554,73,627,1038,60.4%,16.28%,1
基隆市,安樂區,0146,187,277,464,51,515,897,57.41%,20.85%,1
基隆市,安樂區,0147,227,453,680,65,745,1401,53.18%,16.2%,1
基隆市,安樂區,0148,76,150,226,11,237,641,36.97%,11.86%,1
基隆市,安樂區,0149,234,463,697,45,742,1472,50.41%,15.9%,1
基隆市,安樂區,0150,84,163,247,16,263,472,55.72%,17.8%,1
基隆市,安樂區,0151,161,315,476,25,501,841,59.57%,19.14%,1
基隆市,安樂區,0152,108,169,277,26,303,571,53.06%,18.91%,1
基隆市,安樂區,0153,312,568,880,46,926,1901,48.71%,16.41%,1
基隆市,安樂區,0154,236,419,655,44,699,1349,51.82%,17.49%,1
基隆市,安樂區,0155,178,413,591,37,628,1225,51.27%,14.53%,1
基隆市,安樂區,0156,253,444,697,51,748,1351,55.37%,18.73%,1
基隆市,安樂區,0157,318,564,882,25,907,1601,56.65%,19.86%,1
基隆市,安樂區,0158,676,584,1260,29,1289,2513,51.29%,26.9%,1
基隆市,安樂區,0159,287,547,834,38,872,1613,54.06%,17.79%,1
基隆市,安樂區,0160,302,606,908,36,944,1731,54.53%,17.45%,1
基隆市,安樂區,0161,306,515,821,27,848,1424,59.55%,21.49%,1
基隆市,安樂區,0162,279,601,880,49,929,1806,51.44%,15.45%,1
基隆市,安樂區,0163,296,588,884,51,935,1679,55.69%,17.63%,1
基隆市,安樂區,0164,360,621,981,42,1023,1902,53.79%,18.93%,1
基隆市,安樂區,0165,361,641,1002,36,1038,2040,50.88%,17.7%,1
基隆市,安樂區,0166,240,432,672,38,710,1313,54.07%,18.28%,1
基隆市,安樂區,0167,197,392,589,34,623,1243,50.12%,15.85%,1
基隆市,安樂區,0168,327,545,872,31,903,1759,51.34%,18.59%,1
基隆市,安樂區,0169,154,266,420,18,438,694,63.11%,22.19%,1
基隆市,安樂區,0170,214,317,531,20,551,866,63.63%,24.71%,1
基隆市,安樂區,0171,221,430,651,25,676,1557,43.42%,14.19%,1
基隆市,安樂區,0172,240,461,701,18,719,1411,50.96%,17.01%,1
基隆市,安樂區,0173,302,565,867,23,890,1568,56.76%,19.26%,1
基隆市,安樂區,0174,243,449,692,31,723,1400,51.64%,17.36%,1
基隆市,安樂區,0175,257,519,776,12,788,1531,51.47%,16.79%,1
基隆市,安樂區,0176,257,542,799,23,822,1673,49.13%,15.36%,1
基隆市,安樂區,0177,167,363,530,30,560,1054,53.13%,15.84%,1
基隆市,安樂區,0178,282,508,790,29,819,1923,42.59%,14.66%,1
基隆市,安樂區,0179,333,669,1002,49,1051,1960,53.62%,16.99%,1
基隆市,安樂區,0180,298,607,905,43,948,1962,48.32%,15.19%,1
基隆市,安樂區,0181,349,688,1037,62,1099,2117,51.91%,16.49%,1
基隆市,安樂區,0182,306,546,852,38,890,1829,48.66%,16.73%,1
基隆市,安樂區,0183,250,467,717,21,738,1529,48.27%,16.35%,1
基隆市,安樂區,0184,304,629,933,20,953,1869,50.99%,16.27%,1
基隆市,安樂區,0185,205,424,629,9,638,1140,55.96%,17.98%,1
基隆市,安樂區,0186,304,508,812,32,844,1641,51.43%,18.53%,1
基隆市,安樂區,0187,203,423,626,35,661,1279,51.68%,15.87%,1
基隆市,安樂區,0188,243,432,675,23,698,1360,51.32%,17.87%,1
基隆市,安樂區,0189,277,461,738,26,764,1399,54.61%,19.8%,1
基隆市,安樂區,0190,223,378,601,23,624,1251,49.88%,17.83%,1
基隆市,信義區,0036,217,366,583,33,616,1096,56.2%,19.8%,1
基隆市,信義區,0037,258,435,693,37,730,1232,59.25%,20.94%,1
基隆市,信義區,0038,244,394,638,20,658,1184,55.57%,20.61%,1
基隆市,信義區,0039,189,424,613,52,665,1133,58.69%,16.68%,1
基隆市,信義區,0040,215,426,641,25,666,1188,56.06%,18.1%,1
基隆市,信義區,0041,138,259,397,28,425,725,58.62%,19.03%,1
基隆市,信義區,0042,211,475,686,38,724,1524,47.51%,13.85%,1
基隆市,信義區,0043,142,248,390,26,416,736,56.52%,19.29%,1
基隆市,信義區,0044,103,199,302,21,323,611,52.86%,16.86%,1
基隆市,信義區,0045,129,304,433,16,449,951,47.21%,13.56%,1
基隆市,信義區,0046,264,552,816,34,850,1616,52.6%,16.34%,1
基隆市,信義區,0047,276,511,787,35,822,1516,54.22%,18.21%,1
基隆市,信義區,0048,184,330,514,27,541,1049,51.57%,17.54%,1
基隆市,信義區,0049,195,337,532,25,557,1069,52.1%,18.24%,1
基隆市,信義區,0050,141,262,403,19,422,727,58.05%,19.39%,1
基隆市,信義區,0051,194,333,527,23,550,929,59.2%,20.88%,1
基隆市,信義區,0052,246,417,663,26,689,1118,61.63%,22%,1
基隆市,信義區,0053,281,438,719,32,751,1339,56.09%,20.99%,1
基隆市,信義區,0054,169,332,501,22,523,999,52.35%,16.92%,1
基隆市,信義區,0055,135,248,383,10,393,764,51.44%,17.67%,1
基隆市,信義區,0056,240,466,706,44,750,1555,48.23%,15.43%,1
基隆市,信義區,0057,336,625,961,24,985,2015,48.88%,16.67%,1
基隆市,信義區,0058,244,435,679,42,721,1268,56.86%,19.24%,1
基隆市,信義區,0059,262,532,794,40,834,1569,53.15%,16.7%,1
基隆市,信義區,0060,321,596,917,37,954,1985,48.06%,16.17%,1
基隆市,信義區,0061,213,579,792,21,813,1476,55.08%,14.43%,1
基隆市,信義區,0062,305,509,814,26,840,1493,56.26%,20.43%,1
基隆市,信義區,0063,271,473,744,14,758,1249,60.69%,21.7%,1
基隆市,信義區,0064,260,498,758,21,779,1559,49.97%,16.68%,1
基隆市,信義區,0065,201,355,556,13,569,1168,48.72%,17.21%,1
基隆市,信義區,0066,234,570,804,24,828,1602,51.69%,14.61%,1
基隆市,信義區,0067,193,457,650,35,685,1485,46.13%,13%,1
基隆市,信義區,0068,153,343,496,26,522,1009,51.73%,15.16%,1
基隆市,信義區,0069,262,567,829,43,872,2016,43.25%,13%,1
基隆市,信義區,0070,227,500,727,23,750,1764,42.52%,12.87%,1
基隆市,信義區,0071,216,456,672,30,702,1295,54.21%,16.68%,1
新竹市,東區,0001,191,310,501,10,511,1512,33.8%,12.63%,1
新竹市,東區,0002,222,352,574,12,586,953,61.49%,23.29%,1
新竹市,東區,0003,143,262,405,18,423,729,58.02%,19.62%,1
新竹市,東區,0004,118,210,328,25,353,566,62.37%,20.85%,1
新竹市,東區,0005,128,233,361,14,375,640,58.59%,20%,1
新竹市,東區,0006,60,98,158,15,173,305,56.72%,19.67%,1
新竹市,東區,0007,108,218,326,20,346,563,61.46%,19.18%,1
新竹市,東區,0008,151,262,413,8,421,741,56.82%,20.38%,1
新竹市,東區,0009,234,348,582,17,599,1041,57.54%,22.48%,1
新竹市,東區,0010,291,553,844,30,874,1615,54.12%,18.02%,1
新竹市,東區,0011,259,449,708,39,747,1287,58.04%,20.12%,1
新竹市,東區,0012,190,677,867,26,893,1554,57.46%,12.23%,1
新竹市,東區,0013,293,514,807,13,820,1388,59.08%,21.11%,1
新竹市,東區,0014,290,526,816,24,840,1419,59.2%,20.44%,1
新竹市,東區,0015,277,439,716,39,755,1355,55.72%,20.44%,1
新竹市,東區,0016,279,526,805,38,843,1490,56.58%,18.72%,1
新竹市,東區,0017,310,577,887,31,918,1615,56.84%,19.2%,1
新竹市,東區,0018,329,605,934,33,967,1672,57.83%,19.68%,1
新竹市,東區,0019,234,360,594,26,620,1062,58.38%,22.03%,1
新竹市,東區,0020,277,447,724,29,753,1315,57.26%,21.06%,1
新竹市,東區,0021,175,361,536,59,595,1000,59.5%,17.5%,1
新竹市,東區,0022,266,493,759,37,796,1337,59.54%,19.9%,1
新竹市,東區,0023,380,546,926,26,952,1747,54.49%,21.75%,1
新竹市,東區,0024,392,548,940,20,960,1600,60%,24.5%,1
新竹市,東區,0025,223,395,618,38,656,1158,56.65%,19.26%,1
新竹市,東區,0026,192,326,518,23,541,828,65.34%,23.19%,1
新竹市,東區,0027,330,508,838,35,873,1573,55.5%,20.98%,1
新竹市,東區,0028,283,570,853,36,889,1550,57.35%,18.26%,1
新竹市,東區,0029,258,465,723,28,751,1317,57.02%,19.59%,1
新竹市,東區,0030,253,358,611,36,647,1040,62.21%,24.33%,1
新竹市,東區,0031,174,371,545,18,563,935,60.21%,18.61%,1
新竹市,東區,0032,218,372,590,23,613,1074,57.08%,20.3%,1
新竹市,東區,0033,231,422,653,41,694,1133,61.25%,20.39%,1
新竹市,東區,0034,261,459,720,36,756,1262,59.9%,20.68%,1
新竹市,東區,0035,226,450,676,15,691,1199,57.63%,18.85%,1
新竹市,東區,0036,267,473,740,22,762,1226,62.15%,21.78%,1
新竹市,東區,0037,321,538,859,28,887,1377,64.42%,23.31%,1
新竹市,東區,0038,234,384,618,17,635,991,64.08%,23.61%,1
新竹市,東區,0039,262,445,707,57,764,1271,60.11%,20.61%,1
新竹市,東區,0040,231,400,631,20,651,1012,64.33%,22.83%,1
新竹市,東區,0041,188,352,540,48,588,1001,58.74%,18.78%,1
新竹市,東區,0042,316,490,806,51,857,1603,53.46%,19.71%,1
新竹市,東區,0043,218,446,664,32,696,1236,56.31%,17.64%,1
新竹市,東區,0044,201,500,701,39,740,1532,48.3%,13.12%,1
新竹市,東區,0045,216,492,708,27,735,1306,56.28%,16.54%,1
新竹市,東區,0046,203,381,584,45,629,1073,58.62%,18.92%,1
新竹市,東區,0047,202,318,520,16,536,952,56.3%,21.22%,1
新竹市,東區,0048,192,407,599,46,645,1298,49.69%,14.79%,1
新竹市,東區,0049,125,293,418,18,436,778,56.04%,16.07%,1
新竹市,東區,0050,278,394,672,34,706,1195,59.08%,23.26%,1
新竹市,東區,0051,280,537,817,51,868,1569,55.32%,17.85%,1
新竹市,東區,0052,384,557,941,23,964,1533,62.88%,25.05%,1
新竹市,東區,0053,187,589,776,38,814,1336,60.93%,14%,1
新竹市,東區,0054,243,535,778,27,805,1367,58.89%,17.78%,1
新竹市,東區,0055,296,475,771,17,788,1289,61.13%,22.96%,1
新竹市,東區,0056,173,345,518,22,540,960,56.25%,18.02%,1
新竹市,東區,0057,195,335,530,9,539,843,63.94%,23.13%,1
新竹市,東區,0058,175,350,525,43,568,948,59.92%,18.46%,1
新竹市,東區,0059,139,354,493,27,520,915,56.83%,15.19%,1
新竹市,東區,0060,294,723,1017,30,1047,1801,58.13%,16.32%,1
新竹市,東區,0061,189,406,595,29,624,1079,57.83%,17.52%,1
新竹市,東區,0062,136,279,415,10,425,676,62.87%,20.12%,1
新竹市,東區,0063,236,404,640,37,677,1132,59.81%,20.85%,1
新竹市,東區,0064,68,75,143,9,152,251,60.56%,27.09%,1
新竹市,東區,0065,342,560,902,33,935,1620,57.72%,21.11%,1
新竹市,東區,0066,338,436,774,27,801,1479,54.16%,22.85%,1
新竹市,東區,0067,316,417,733,23,756,1402,53.92%,22.54%,1
新竹市,東區,0068,273,419,692,32,724,1280,56.56%,21.33%,1
新竹市,東區,0069,338,381,719,13,732,1228,59.61%,27.52%,1
新竹市,東區,0070,331,302,633,2,635,1157,54.88%,28.61%,1
新竹市,東區,0071,264,479,743,26,769,1354,56.79%,19.5%,1
新竹市,東區,0072,352,504,856,26,882,1334,66.12%,26.39%,1
新竹市,東區,0073,248,479,727,20,747,1234,60.53%,20.1%,1
新竹市,東區,0074,309,558,867,25,892,1398,63.81%,22.1%,1
新竹市,東區,0075,232,323,555,17,572,928,61.64%,25%,1
新竹市,東區,0076,302,535,837,27,864,1368,63.16%,22.08%,1
新竹市,東區,0077,228,429,657,18,675,1215,55.56%,18.77%,1
新竹市,東區,0078,165,357,522,31,553,1067,51.83%,15.46%,1
新竹市,東區,0079,330,315,645,15,660,1194,55.28%,27.64%,1
新竹市,東區,0080,311,314,625,19,644,1193,53.98%,26.07%,1
新竹市,東區,0081,291,461,752,53,805,1388,58%,20.97%,1
新竹市,東區,0082,258,467,725,26,751,1267,59.27%,20.36%,1
新竹市,東區,0083,259,462,721,22,743,1299,57.2%,19.94%,1
新竹市,東區,0084,300,419,719,21,740,1288,57.45%,23.29%,1
新竹市,東區,0085,349,385,734,17,751,1228,61.16%,28.42%,1
新竹市,東區,0086,311,369,680,11,691,1135,60.88%,27.4%,1
新竹市,東區,0087,358,411,769,19,788,1237,63.7%,28.94%,1
新竹市,東區,0088,209,367,576,32,608,1135,53.57%,18.41%,1
新竹市,東區,0089,187,397,584,25,609,1165,52.27%,16.05%,1
新竹市,東區,0090,207,402,609,21,630,1124,56.05%,18.42%,1
新竹市,東區,0091,240,446,686,27,713,1210,58.93%,19.83%,1
新竹市,東區,0092,233,454,687,28,715,1323,54.04%,17.61%,1
新竹市,東區,0093,181,449,630,20,650,1207,53.85%,15%,1
新竹市,東區,0094,223,384,607,25,632,1264,50%,17.64%,1
新竹市,東區,0095,277,394,671,14,685,1248,54.89%,22.2%,1
新竹市,東區,0096,308,526,834,33,867,1400,61.93%,22%,1
新竹市,東區,0097,346,519,865,18,883,1473,59.95%,23.49%,1
新竹市,東區,0098,294,439,733,35,768,1367,56.18%,21.51%,1
新竹市,東區,0099,265,444,709,15,724,1233,58.72%,21.49%,1
新竹市,東區,0100,91,173,264,9,273,507,53.85%,17.95%,1
新竹市,東區,0101,147,250,397,24,421,714,58.96%,20.59%,1
新竹市,東區,0102,162,320,482,37,519,875,59.31%,18.51%,1
新竹市,東區,0103,248,511,759,40,799,1396,57.23%,17.77%,1
新竹市,東區,0104,239,396,635,29,664,1232,53.9%,19.4%,1
新竹市,東區,0105,284,399,683,38,721,1323,54.5%,21.47%,1
新竹市,東區,0106,271,434,705,18,723,1516,47.69%,17.88%,1
新竹市,東區,0107,300,416,716,29,745,1453,51.27%,20.65%,1
新竹市,東區,0108,61,421,482,35,517,880,58.75%,6.93%,1
新竹市,東區,0109,171,381,552,26,578,1058,54.63%,16.16%,1
新竹市,東區,0110,193,380,573,26,599,1061,56.46%,18.19%,1
新竹市,東區,0111,117,259,376,32,408,710,57.46%,16.48%,1
新竹市,東區,0112,141,275,416,39,455,752,60.51%,18.75%,1
新竹市,東區,0113,85,202,287,15,302,475,63.58%,17.89%,1
新竹市,東區,0114,178,274,452,29,481,880,54.66%,20.23%,1
新竹市,東區,0115,217,337,554,26,580,989,58.65%,21.94%,1
新竹市,東區,0116,208,369,577,35,612,1059,57.79%,19.64%,1
新竹市,東區,0117,135,207,342,30,372,607,61.29%,22.24%,1
新竹市,東區,0118,177,264,441,35,476,815,58.4%,21.72%,1
新竹市,東區,0119,141,304,445,37,482,777,62.03%,18.15%,1
新竹市,東區,0120,225,448,673,27,700,1399,50.04%,16.08%,1
新竹市,東區,0121,242,407,649,27,676,1216,55.59%,19.9%,1
新竹市,東區,0122,175,341,516,38,554,1062,52.17%,16.48%,1
新竹市,東區,0123,208,381,589,21,610,1046,58.32%,19.89%,1
新竹市,東區,0124,226,448,674,17,691,1332,51.88%,16.97%,1
新竹市,東區,0125,253,489,742,40,782,1350,57.93%,18.74%,1
新竹市,東區,0126,244,489,733,23,756,1438,52.57%,16.97%,1
新竹市,東區,0127,216,495,711,31,742,1414,52.48%,15.28%,1
新竹市,東區,0128,315,520,835,24,859,1476,58.2%,21.34%,1
新竹市,東區,0129,259,520,779,40,819,1326,61.76%,19.53%,1
新竹市,東區,0130,238,342,580,16,596,927,64.29%,25.67%,1
新竹市,東區,0131,258,456,714,16,730,1273,57.34%,20.27%,1
新竹市,東區,0132,238,432,670,29,699,1315,53.16%,18.1%,1
新竹市,東區,0133,301,487,788,27,815,1413,57.68%,21.3%,1
新竹市,東區,0134,216,368,584,26,610,1064,57.33%,20.3%,1
新竹市,東區,0135,297,473,770,16,786,1244,63.18%,23.87%,1
新竹市,東區,0136,192,407,599,8,607,1160,52.33%,16.55%,1
新竹市,東區,0137,236,434,670,12,682,1398,48.78%,16.88%,1
新竹市,東區,0138,208,345,553,18,571,1384,41.26%,15.03%,1
新竹市,東區,0139,170,346,516,25,541,874,61.9%,19.45%,1
新竹市,北區,0140,107,142,249,10,259,477,54.3%,22.43%,1
新竹市,北區,0141,111,196,307,15,322,535,60.19%,20.75%,1
新竹市,北區,0142,149,261,410,34,444,746,59.52%,19.97%,1
新竹市,北區,0143,104,178,282,16,298,546,54.58%,19.05%,1
新竹市,北區,0144,144,273,417,26,443,711,62.31%,20.25%,1
新竹市,北區,0145,192,369,561,29,590,1143,51.62%,16.8%,1
新竹市,北區,0146,243,443,686,33,719,1370,52.48%,17.74%,1
新竹市,北區,0147,246,472,718,36,754,1390,54.24%,17.7%,1
新竹市,北區,0148,195,342,537,17,554,962,57.59%,20.27%,1
新竹市,北區,0149,276,397,673,16,689,1237,55.7%,22.31%,1
新竹市,北區,0150,279,455,734,62,796,1604,49.63%,17.39%,1
新竹市,北區,0151,116,252,368,13,381,758,50.26%,15.3%,1
新竹市,北區,0152,226,439,665,20,685,1320,51.89%,17.12%,1
新竹市,北區,0153,247,463,710,58,768,1519,50.56%,16.26%,1
新竹市,北區,0154,47,83,130,3,133,347,38.33%,13.54%,1
新竹市,北區,0155,210,460,670,30,700,1212,57.76%,17.33%,1
新竹市,北區,0156,274,493,767,27,794,1484,53.5%,18.46%,1
新竹市,北區,0157,272,456,728,57,785,1428,54.97%,19.05%,1
新竹市,北區,0158,181,440,621,24,645,1128,57.18%,16.05%,1
新竹市,北區,0159,60,283,343,18,361,638,56.58%,9.4%,1
新竹市,北區,0160,182,487,669,46,715,1222,58.51%,14.89%,1
新竹市,北區,0161,215,351,566,26,592,1076,55.02%,19.98%,1
新竹市,北區,0162,197,386,583,21,604,937,64.46%,21.02%,1
新竹市,北區,0163,232,505,737,29,766,1394,54.95%,16.64%,1
新竹市,北區,0164,271,495,766,35,801,1568,51.08%,17.28%,1
新竹市,北區,0165,251,420,671,35,706,1159,60.91%,21.66%,1
新竹市,北區,0166,34,70,104,1,105,252,41.67%,13.49%,1
新竹市,北區,0167,169,290,459,21,480,761,63.07%,22.21%,1
新竹市,北區,0168,167,269,436,33,469,788,59.52%,21.19%,1
新竹市,北區,0169,125,208,333,30,363,561,64.71%,22.28%,1
新竹市,北區,0170,277,482,759,68,827,1558,53.08%,17.78%,1
新竹市,北區,0171,260,407,667,33,700,1398,50.07%,18.6%,1
新竹市,北區,0172,164,332,496,40,536,957,56.01%,17.14%,1
新竹市,北區,0173,212,442,654,31,685,1195,57.32%,17.74%,1
新竹市,北區,0174,235,351,586,28,614,1236,49.68%,19.01%,1
新竹市,北區,0175,206,416,622,46,668,1255,53.23%,16.41%,1
新竹市,北區,0176,225,400,625,16,641,1114,57.54%,20.2%,1
新竹市,北區,0177,263,489,752,27,779,1396,55.8%,18.84%,1
新竹市,北區,0178,270,527,797,42,839,1456,57.62%,18.54%,1
新竹市,北區,0179,268,453,721,24,745,1374,54.22%,19.51%,1
新竹市,北區,0180,186,354,540,31,571,1070,53.36%,17.38%,1
新竹市,北區,0181,172,427,599,42,641,1142,56.13%,15.06%,1
新竹市,北區,0182,202,366,568,18,586,1103,53.13%,18.31%,1
新竹市,北區,0183,198,425,623,58,681,1190,57.23%,16.64%,1
新竹市,北區,0184,192,464,656,20,676,1089,62.08%,17.63%,1
新竹市,北區,0185,205,393,598,20,618,1272,48.58%,16.12%,1
新竹市,北區,0186,235,447,682,44,726,1306,55.59%,17.99%,1
新竹市,北區,0187,261,445,706,36,742,1328,55.87%,19.65%,1
新竹市,北區,0188,274,466,740,26,766,1457,52.57%,18.81%,1
新竹市,北區,0189,301,496,797,34,831,1492,55.7%,20.17%,1
新竹市,北區,0190,229,429,658,44,702,1160,60.52%,19.74%,1
新竹市,北區,0191,164,339,503,71,574,971,59.11%,16.89%,1
新竹市,北區,0192,158,289,447,13,460,1401,32.83%,11.28%,1
新竹市,北區,0193,288,459,747,28,775,1340,57.84%,21.49%,1
新竹市,北區,0194,278,500,778,30,808,1371,58.94%,20.28%,1
新竹市,北區,0195,258,315,573,26,599,1267,47.28%,20.36%,1
新竹市,北區,0196,247,411,658,22,680,1073,63.37%,23.02%,1
新竹市,北區,0197,228,429,657,22,679,1159,58.58%,19.67%,1
新竹市,北區,0198,278,426,704,19,723,1294,55.87%,21.48%,1
新竹市,北區,0199,275,499,774,31,805,1442,55.83%,19.07%,1
新竹市,北區,0200,265,450,715,28,743,1270,58.5%,20.87%,1
新竹市,北區,0201,255,461,716,39,755,1179,64.04%,21.63%,1
新竹市,北區,0202,190,379,569,29,598,949,63.01%,20.02%,1
新竹市,北區,0203,228,420,648,29,677,1163,58.21%,19.6%,1
新竹市,北區,0204,290,433,723,14,737,1334,55.25%,21.74%,1
新竹市,北區,0205,329,441,770,26,796,1415,56.25%,23.25%,1
新竹市,北區,0206,326,454,780,16,796,1305,61%,24.98%,1
新竹市,北區,0207,245,414,659,23,682,1200,56.83%,20.42%,1
新竹市,北區,0208,240,379,619,15,634,1106,57.32%,21.7%,1
新竹市,北區,0209,323,286,609,21,630,1044,60.34%,30.94%,1
新竹市,北區,0210,233,373,606,24,630,1061,59.38%,21.96%,1
新竹市,北區,0211,315,529,844,52,896,1518,59.03%,20.75%,1
新竹市,北區,0212,256,473,729,29,758,1220,62.13%,20.98%,1
新竹市,北區,0213,315,524,839,15,854,1475,57.9%,21.36%,1
新竹市,北區,0214,221,490,711,38,749,1373,54.55%,16.1%,1
新竹市,北區,0215,262,549,811,25,836,1450,57.66%,18.07%,1
新竹市,北區,0216,274,532,806,23,829,1423,58.26%,19.26%,1
新竹市,北區,0217,162,434,596,17,613,1059,57.88%,15.3%,1
新竹市,北區,0218,189,468,657,29,686,1130,60.71%,16.73%,1
新竹市,北區,0219,222,528,750,31,781,1208,64.65%,18.38%,1
新竹市,北區,0220,172,569,741,22,763,1226,62.23%,14.03%,1
新竹市,北區,0221,247,400,647,30,677,1175,57.62%,21.02%,1
新竹市,北區,0222,277,496,773,21,794,1371,57.91%,20.2%,1
新竹市,北區,0223,225,448,673,51,724,1306,55.44%,17.23%,1
新竹市,北區,0224,213,485,698,21,719,1340,53.66%,15.9%,1
新竹市,北區,0225,242,404,646,38,684,1111,61.57%,21.78%,1
新竹市,北區,0226,244,496,740,27,767,1197,64.08%,20.38%,1
新竹市,北區,0227,144,407,551,28,579,1008,57.44%,14.29%,1
新竹市,北區,0228,171,327,498,23,521,946,55.07%,18.08%,1
新竹市,北區,0229,124,271,395,29,424,705,60.14%,17.59%,1
新竹市,北區,0230,145,287,432,73,505,848,59.55%,17.1%,1
新竹市,北區,0231,233,439,672,21,693,1295,53.51%,17.99%,1
新竹市,北區,0232,215,519,734,23,757,1467,51.6%,14.66%,1
新竹市,北區,0233,256,482,738,38,776,1659,46.78%,15.43%,1
新竹市,北區,0234,231,439,670,32,702,1297,54.12%,17.81%,1
新竹市,北區,0235,254,483,737,54,791,1374,57.57%,18.49%,1
新竹市,北區,0236,283,506,789,58,847,1457,58.13%,19.42%,1
新竹市,北區,0237,187,420,607,26,633,1072,59.05%,17.44%,1
新竹市,北區,0238,231,459,690,35,725,1350,53.7%,17.11%,1
新竹市,北區,0239,195,401,596,17,613,971,63.13%,20.08%,1
新竹市,北區,0240,247,546,793,59,852,1450,58.76%,17.03%,1
新竹市,北區,0241,150,336,486,27,513,895,57.32%,16.76%,1
新竹市,北區,0242,238,489,727,31,758,1378,55.01%,17.27%,1
新竹市,北區,0243,226,510,736,70,806,1609,50.09%,14.05%,1
新竹市,北區,0244,104,208,312,35,347,594,58.42%,17.51%,1
新竹市,香山區,0245,240,496,736,48,784,1443,54.33%,16.63%,1
新竹市,香山區,0246,244,411,655,30,685,1241,55.2%,19.66%,1
新竹市,香山區,0247,224,422,646,15,661,1194,55.36%,18.76%,1
新竹市,香山區,0248,222,372,594,11,605,1081,55.97%,20.54%,1
新竹市,香山區,0249,146,307,453,22,475,807,58.86%,18.09%,1
新竹市,香山區,0250,314,596,910,50,960,1760,54.55%,17.84%,1
新竹市,香山區,0251,295,581,876,37,913,1635,55.84%,18.04%,1
新竹市,香山區,0252,282,532,814,41,855,1473,58.04%,19.14%,1
新竹市,香山區,0253,253,521,774,26,800,1408,56.82%,17.97%,1
新竹市,香山區,0254,201,420,621,20,641,1318,48.63%,15.25%,1
新竹市,香山區,0255,233,480,713,41,754,1337,56.39%,17.43%,1
新竹市,香山區,0256,317,610,927,27,954,1862,51.24%,17.02%,1
新竹市,香山區,0257,210,364,574,22,596,1067,55.86%,19.68%,1
新竹市,香山區,0258,173,325,498,31,529,863,61.3%,20.05%,1
新竹市,香山區,0259,249,438,687,53,740,1198,61.77%,20.78%,1
新竹市,香山區,0260,313,330,643,50,693,1138,60.9%,27.5%,1
新竹市,香山區,0261,190,378,568,54,622,957,64.99%,19.85%,1
新竹市,香山區,0262,238,507,745,55,800,1348,59.35%,17.66%,1
新竹市,香山區,0263,231,403,634,56,690,1023,67.45%,22.58%,1
新竹市,香山區,0264,140,381,521,32,553,970,57.01%,14.43%,1
新竹市,香山區,0265,250,476,726,39,765,1318,58.04%,18.97%,1
新竹市,香山區,0266,177,384,561,47,608,1088,55.88%,16.27%,1
新竹市,香山區,0267,157,283,440,19,459,903,50.83%,17.39%,1
新竹市,香山區,0268,175,380,555,36,591,1012,58.4%,17.29%,1
新竹市,香山區,0269,146,396,542,41,583,1014,57.5%,14.4%,1
新竹市,香山區,0270,211,480,691,23,714,1238,57.67%,17.04%,1
新竹市,香山區,0271,187,409,596,60,656,1182,55.5%,15.82%,1
新竹市,香山區,0272,238,560,798,57,855,1331,64.24%,17.88%,1
新竹市,香山區,0273,253,366,619,14,633,976,64.86%,25.92%,1
新竹市,香山區,0274,146,291,437,18,455,834,54.56%,17.51%,1
新竹市,香山區,0275,155,342,497,33,530,919,57.67%,16.87%,1
新竹市,香山區,0276,273,400,673,30,703,1188,59.18%,22.98%,1
新竹市,香山區,0277,183,404,587,43,630,1086,58.01%,16.85%,1
新竹市,香山區,0278,246,431,677,37,714,1144,62.41%,21.5%,1
新竹市,香山區,0279,211,416,627,32,659,1112,59.26%,18.97%,1
新竹市,香山區,0280,274,536,810,45,855,1476,57.93%,18.56%,1
新竹市,香山區,0281,226,469,695,24,719,1291,55.69%,17.51%,1
新竹市,香山區,0282,260,602,862,42,904,1464,61.75%,17.76%,1
新竹市,香山區,0283,222,563,785,60,845,1427,59.22%,15.56%,1
新竹市,香山區,0284,231,479,710,15,725,1336,54.27%,17.29%,1
新竹市,香山區,0285,179,357,536,32,568,1131,50.22%,15.83%,1
新竹市,香山區,0286,190,409,599,50,649,1070,60.65%,17.76%,1
新竹市,香山區,0287,170,381,551,69,620,1006,61.63%,16.9%,1
新竹市,香山區,0288,157,385,542,35,577,1223,47.18%,12.84%,1
新竹市,香山區,0289,198,415,613,23,636,1119,56.84%,17.69%,1
新竹市,香山區,0290,228,438,666,37,703,1400,50.21%,16.29%,1
新竹市,香山區,0291,251,489,740,36,776,1627,47.7%,15.43%,1
新竹市,香山區,0292,209,399,608,41,649,1289,50.35%,16.21%,1
新竹市,香山區,0293,210,459,669,46,715,1409,50.75%,14.9%,1
新竹市,香山區,0294,129,262,391,30,421,814,51.72%,15.85%,1
新竹市,香山區,0295,111,267,378,24,402,719,55.91%,15.44%,1
新竹市,香山區,0296,170,336,506,16,522,1065,49.01%,15.96%,1
新竹市,香山區,0297,121,266,387,50,437,776,56.31%,15.59%,1
新竹市,香山區,0298,156,331,487,29,516,890,57.98%,17.53%,1
新竹市,香山區,0299,138,305,443,21,464,896,51.79%,15.4%,1
嘉義市,東區,0001,201,366,567,24,591,1025,57.66%,19.61%,1
嘉義市,東區,0002,241,418,659,22,681,1276,53.37%,18.89%,1
嘉義市,東區,0003,156,313,469,28,497,974,51.03%,16.02%,1
嘉義市,東區,0004,241,456,697,26,723,1175,61.53%,20.51%,1
嘉義市,東區,0005,153,267,420,18,438,702,62.39%,21.79%,1
嘉義市,東區,0006,198,379,577,27,604,1092,55.31%,18.13%,1
嘉義市,東區,0007,149,312,461,20,481,1023,47.02%,14.57%,1
嘉義市,東區,0008,297,605,902,37,939,1816,51.71%,16.35%,1
嘉義市,東區,0009,404,636,1040,30,1070,1936,55.27%,20.87%,1
嘉義市,東區,0010,388,559,947,13,960,1698,56.54%,22.85%,1
嘉義市,東區,0011,271,434,705,14,719,1221,58.89%,22.19%,1
嘉義市,東區,0012,228,382,610,17,627,1113,56.33%,20.49%,1
嘉義市,東區,0013,285,519,804,27,831,1452,57.23%,19.63%,1
嘉義市,東區,0014,302,533,835,25,860,1395,61.65%,21.65%,1
嘉義市,東區,0015,256,455,711,31,742,1453,51.07%,17.62%,1
嘉義市,東區,0016,178,394,572,14,586,1094,53.56%,16.27%,1
嘉義市,東區,0017,262,520,782,26,808,1420,56.9%,18.45%,1
嘉義市,東區,0018,299,576,875,40,915,1552,58.96%,19.27%,1
嘉義市,東區,0019,316,528,844,46,890,1558,57.12%,20.28%,1
嘉義市,東區,0020,406,188,594,30,624,1062,58.76%,38.23%,1
嘉義市,東區,0021,195,423,618,37,655,1199,54.63%,16.26%,1
嘉義市,東區,0022,184,488,672,20,692,1236,55.99%,14.89%,1
嘉義市,東區,0023,162,308,470,21,491,890,55.17%,18.2%,1
嘉義市,東區,0024,169,332,501,34,535,880,60.8%,19.2%,1
嘉義市,東區,0025,239,405,644,14,658,1189,55.34%,20.1%,1
嘉義市,東區,0026,135,250,385,13,398,669,59.49%,20.18%,1
嘉義市,東區,0027,276,483,759,29,788,1435,54.91%,19.23%,1
嘉義市,東區,0028,192,598,790,24,814,1349,60.34%,14.23%,1
嘉義市,東區,0029,251,490,741,29,770,1455,52.92%,17.25%,1
嘉義市,東區,0030,182,327,509,24,533,915,58.25%,19.89%,1
嘉義市,東區,0031,191,320,511,22,533,952,55.99%,20.06%,1
嘉義市,東區,0032,175,316,491,40,531,941,56.43%,18.6%,1
嘉義市,東區,0033,204,346,550,25,575,1080,53.24%,18.89%,1
嘉義市,東區,0034,183,373,556,24,580,1157,50.13%,15.82%,1
嘉義市,東區,0035,222,357,579,31,610,1053,57.93%,21.08%,1
嘉義市,東區,0036,171,290,461,27,488,967,50.47%,17.68%,1
嘉義市,東區,0037,205,356,561,25,586,1091,53.71%,18.79%,1
嘉義市,東區,0038,172,365,537,41,578,961,60.15%,17.9%,1
嘉義市,東區,0039,119,212,331,24,355,863,41.14%,13.79%,1
嘉義市,東區,0040,200,371,571,44,615,1023,60.12%,19.55%,1
嘉義市,東區,0041,175,403,578,64,642,1078,59.55%,16.23%,1
嘉義市,東區,0042,167,325,492,14,506,938,53.94%,17.8%,1
嘉義市,東區,0043,204,356,560,22,582,1049,55.48%,19.45%,1
嘉義市,東區,0044,228,428,656,55,711,1360,52.28%,16.76%,1
嘉義市,東區,0045,169,143,312,76,388,1615,24.02%,10.46%,1
嘉義市,東區,0046,244,406,650,31,681,1267,53.75%,19.26%,1
嘉義市,東區,0047,230,481,711,53,764,1579,48.39%,14.57%,1
嘉義市,東區,0048,323,559,882,62,944,1831,51.56%,17.64%,1
嘉義市,東區,0049,173,374,547,25,572,977,58.55%,17.71%,1
嘉義市,東區,0050,230,357,587,4,591,1169,50.56%,19.67%,1
嘉義市,東區,0051,249,418,667,71,738,1238,59.61%,20.11%,1
嘉義市,東區,0052,233,457,690,19,709,1266,56%,18.4%,1
嘉義市,東區,0053,180,459,639,40,679,1429,47.52%,12.6%,1
嘉義市,東區,0054,237,441,678,25,703,1288,54.58%,18.4%,1
嘉義市,東區,0055,202,303,505,36,541,980,55.2%,20.61%,1
嘉義市,東區,0056,156,306,462,18,480,922,52.06%,16.92%,1
嘉義市,東區,0057,199,431,630,33,663,1133,58.52%,17.56%,1
嘉義市,東區,0058,229,433,662,34,696,1235,56.36%,18.54%,1
嘉義市,東區,0059,293,491,784,20,804,1525,52.72%,19.21%,1
嘉義市,東區,0060,198,378,576,32,608,1170,51.97%,16.92%,1
嘉義市,東區,0061,251,446,697,45,742,1177,63.04%,21.33%,1
嘉義市,東區,0062,215,425,640,46,686,1207,56.84%,17.81%,1
嘉義市,東區,0063,219,463,682,37,719,1272,56.53%,17.22%,1
嘉義市,東區,0064,201,393,594,80,674,1188,56.73%,16.92%,1
嘉義市,東區,0065,198,376,574,19,593,1172,50.6%,16.89%,1
嘉義市,東區,0066,205,363,568,34,602,1020,59.02%,20.1%,1
嘉義市,東區,0067,279,446,725,41,766,1332,57.51%,20.95%,1
嘉義市,東區,0068,229,363,592,31,623,1011,61.62%,22.65%,1
嘉義市,東區,0069,280,540,820,62,882,1682,52.44%,16.65%,1
嘉義市,東區,0070,245,565,810,52,862,1567,55.01%,15.63%,1
嘉義市,東區,0071,238,430,668,18,686,1207,56.84%,19.72%,1
嘉義市,東區,0072,200,369,569,21,590,981,60.14%,20.39%,1
嘉義市,東區,0073,261,449,710,39,749,1395,53.69%,18.71%,1
嘉義市,東區,0074,245,426,671,18,689,1434,48.05%,17.09%,1
嘉義市,東區,0075,237,388,625,20,645,1404,45.94%,16.88%,1
嘉義市,東區,0076,270,502,772,26,798,1428,55.88%,18.91%,1
嘉義市,東區,0077,272,491,763,19,782,1823,42.9%,14.92%,1
嘉義市,東區,0078,264,481,745,33,778,1570,49.55%,16.82%,1
嘉義市,東區,0079,214,424,638,49,687,1282,53.59%,16.69%,1
嘉義市,東區,0080,279,605,884,47,931,1571,59.26%,17.76%,1
嘉義市,東區,0081,295,475,770,26,796,1533,51.92%,19.24%,1
嘉義市,西區,0082,151,320,471,12,483,885,54.58%,17.06%,1
嘉義市,西區,0083,196,357,553,50,603,1109,54.37%,17.67%,1
嘉義市,西區,0084,168,317,485,46,531,1020,52.06%,16.47%,1
嘉義市,西區,0085,168,377,545,38,583,925,63.03%,18.16%,1
嘉義市,西區,0086,291,449,740,30,770,1671,46.08%,17.41%,1
嘉義市,西區,0087,250,415,665,13,678,1215,55.8%,20.58%,1
嘉義市,西區,0088,193,342,535,25,560,1036,54.05%,18.63%,1
嘉義市,西區,0089,193,359,552,28,580,1129,51.37%,17.09%,1
嘉義市,西區,0090,196,385,581,27,608,1127,53.95%,17.39%,1
嘉義市,西區,0091,269,488,757,39,796,1415,56.25%,19.01%,1
嘉義市,西區,0092,201,486,687,21,708,1366,51.83%,14.71%,1
嘉義市,西區,0093,192,404,596,49,645,1053,61.25%,18.23%,1
嘉義市,西區,0094,165,403,568,21,589,1067,55.2%,15.46%,1
嘉義市,西區,0095,253,483,736,23,759,1575,48.19%,16.06%,1
嘉義市,西區,0096,325,617,942,36,978,1865,52.44%,17.43%,1
嘉義市,西區,0097,217,372,589,33,622,1196,52.01%,18.14%,1
嘉義市,西區,0098,394,221,615,21,636,1280,49.69%,30.78%,1
嘉義市,西區,0099,287,544,831,47,878,1629,53.9%,17.62%,1
嘉義市,西區,0100,243,501,744,55,799,1393,57.36%,17.44%,1
嘉義市,西區,0101,214,396,610,35,645,1077,59.89%,19.87%,1
嘉義市,西區,0102,306,483,789,12,801,1694,47.28%,18.06%,1
嘉義市,西區,0103,178,270,448,78,526,841,62.54%,21.17%,1
嘉義市,西區,0104,100,480,580,4,584,1183,49.37%,8.45%,1
嘉義市,西區,0105,209,405,614,18,632,1000,63.2%,20.9%,1
嘉義市,西區,0106,214,420,634,21,655,1095,59.82%,19.54%,1
嘉義市,西區,0107,40,676,716,32,748,1256,59.55%,3.18%,1
嘉義市,西區,0108,172,349,521,40,561,962,58.32%,17.88%,1
嘉義市,西區,0109,198,336,534,22,556,865,64.28%,22.89%,1
嘉義市,西區,0110,217,453,670,49,719,1396,51.5%,15.54%,1
嘉義市,西區,0111,338,603,941,47,988,1799,54.92%,18.79%,1
嘉義市,西區,0112,225,516,741,19,760,1505,50.5%,14.95%,1
嘉義市,西區,0113,275,577,852,48,900,1698,53%,16.2%,1
嘉義市,西區,0114,313,672,985,20,1005,1854,54.21%,16.88%,1
嘉義市,西區,0115,236,444,680,8,688,1537,44.76%,15.35%,1
嘉義市,西區,0116,292,489,781,42,823,1604,51.31%,18.2%,1
嘉義市,西區,0117,194,342,536,59,595,944,63.03%,20.55%,1
嘉義市,西區,0118,256,624,880,52,932,1627,57.28%,15.73%,1
嘉義市,西區,0119,215,431,646,33,679,1144,59.35%,18.79%,1
嘉義市,西區,0120,225,481,706,41,747,1362,54.85%,16.52%,1
嘉義市,西區,0121,249,463,712,28,740,1279,57.86%,19.47%,1
嘉義市,西區,0122,280,597,877,67,944,1702,55.46%,16.45%,1
嘉義市,西區,0123,269,493,762,40,802,1358,59.06%,19.81%,1
嘉義市,西區,0124,264,512,776,56,832,1360,61.18%,19.41%,1
嘉義市,西區,0125,249,610,859,52,911,1589,57.33%,15.67%,1
嘉義市,西區,0126,235,503,738,27,765,1280,59.77%,18.36%,1
嘉義市,西區,0127,201,379,580,29,609,1220,49.92%,16.48%,1
嘉義市,西區,0128,214,457,671,21,692,1172,59.04%,18.26%,1
嘉義市,西區,0129,249,460,709,33,742,1320,56.21%,18.86%,1
嘉義市,西區,0130,235,502,737,28,765,1185,64.56%,19.83%,1
嘉義市,西區,0131,247,504,751,35,786,1278,61.5%,19.33%,1
嘉義市,西區,0132,238,374,612,18,630,1394,45.19%,17.07%,1
嘉義市,西區,0133,284,562,846,34,880,1540,57.14%,18.44%,1
嘉義市,西區,0134,278,540,818,55,873,1548,56.4%,17.96%,1
嘉義市,西區,0135,230,437,667,30,697,1295,53.82%,17.76%,1
嘉義市,西區,0136,249,503,752,45,797,1318,60.47%,18.89%,1
嘉義市,西區,0137,271,549,820,40,860,1545,55.66%,17.54%,1
嘉義市,西區,0138,144,208,352,26,378,736,51.36%,19.57%,1
嘉義市,西區,0139,180,414,594,24,618,1168,52.91%,15.41%,1
嘉義市,西區,0140,148,308,456,29,485,756,64.15%,19.58%,1
嘉義市,西區,0141,123,357,480,12,492,869,56.62%,14.15%,1
嘉義市,西區,0142,187,363,550,37,587,983,59.72%,19.02%,1
嘉義市,西區,0143,140,307,447,32,479,828,57.85%,16.91%,1
嘉義市,西區,0144,243,699,942,34,976,1775,54.99%,13.69%,1
嘉義市,西區,0145,192,550,742,16,758,1419,53.42%,13.53%,1
嘉義市,西區,0146,139,263,402,13,415,779,53.27%,17.84%,1
嘉義市,西區,0147,134,296,430,15,445,855,52.05%,15.67%,1
嘉義市,西區,0148,220,404,624,49,673,1146,58.73%,19.2%,1
嘉義市,西區,0149,204,406,610,23,633,1111,56.98%,18.36%,1
嘉義市,西區,0150,133,329,462,34,496,767,64.67%,17.34%,1
嘉義市,西區,0151,138,259,397,17,414,817,50.67%,16.89%,1
嘉義市,西區,0152,147,274,421,30,451,770,58.57%,19.09%,1
嘉義市,西區,0153,166,338,504,17,521,1135,45.9%,14.63%,1
嘉義市,西區,0154,153,239,392,64,456,835,54.61%,18.32%,1
嘉義市,西區,0155,177,368,545,32,577,1182,48.82%,14.97%,1
嘉義市,西區,0156,145,293,438,30,468,944,49.58%,15.36%,1
嘉義市,西區,0157,172,325,497,30,527,997,52.86%,17.25%,1
嘉義市,西區,0158,204,372,576,22,598,1074,55.68%,18.99%,1
嘉義市,西區,0159,233,408,641,20,661,1460,45.27%,15.96%,1
嘉義市,西區,0160,228,450,678,39,717,1352,53.03%,16.86%,1
嘉義市,西區,0161,281,480,761,36,797,1499,53.17%,18.75%,1
嘉義市,西區,0162,233,419,652,62,714,1262,56.58%,18.46%,1
嘉義市,西區,0163,229,446,675,26,701,1299,53.96%,17.63%,1
嘉義市,西區,0164,276,576,852,44,896,1734,51.67%,15.92%,1
嘉義市,西區,0165,244,550,794,29,823,1674,49.16%,14.58%,1
嘉義市,西區,0166,182,590,772,24,796,1540,51.69%,11.82%,1
嘉義市,西區,0167,205,401,606,24,630,1056,59.66%,19.41%,1
嘉義市,西區,0168,272,522,794,64,858,1467,58.49%,18.54%,1
嘉義市,西區,0169,242,453,695,51,746,1431,52.13%,16.91%,1
嘉義市,西區,0170,243,478,721,52,773,1234,62.64%,19.69%,1
嘉義市,西區,0171,226,440,666,12,678,1266,53.55%,17.85%,1
嘉義市,西區,0172,233,435,668,20,688,1211,56.81%,19.24%,1
嘉義市,西區,0173,207,425,632,12,644,1121,57.45%,18.47%,1
嘉義市,西區,0174,180,392,572,17,589,1155,51%,15.58%,1
嘉義市,西區,0175,287,533,820,75,895,1546,57.89%,18.56%,1
嘉義市,西區,0176,208,467,675,23,698,1322,52.8%,15.73%,1
嘉義市,西區,0177,266,558,824,73,897,1549,57.91%,17.17%,1
